Meetpunt surrogate key,Meetpunt locatie,Datum,Tijd,Aantal fietsers,Aantal fietsers van,Aantal fietsers naar,Meetpunt code
642,Herenthoutsesteenweg 2,2021-09-17,02:00:00,9,7,2,ECO_300019380
642,Herenthoutsesteenweg 2,2021-09-17,03:00:00,3,3,0,ECO_300019380
642,Herenthoutsesteenweg 2,2021-09-17,04:00:00,2,2,0,ECO_300019380
642,Herenthoutsesteenweg 2,2021-09-17,05:00:00,0,0,0,ECO_300019380
642,Herenthoutsesteenweg 2,2021-09-17,06:00:00,6,4,2,ECO_300019380
642,Herenthoutsesteenweg 2,2021-09-17,07:00:00,12,12,0,ECO_300019380
642,Herenthoutsesteenweg 2,2021-09-17,08:00:00,33,27,6,ECO_300019380
642,Herenthoutsesteenweg 2,2021-09-17,09:00:00,167,165,2,ECO_300019380
642,Herenthoutsesteenweg 2,2021-09-17,10:00:00,621,613,8,ECO_300019380
642,Herenthoutsesteenweg 2,2021-09-17,11:00:00,124,122,2,ECO_300019380
642,Herenthoutsesteenweg 2,2021-09-17,12:00:00,104,99,5,ECO_300019380
642,Herenthoutsesteenweg 2,2021-09-17,13:00:00,84,81,3,ECO_300019380
642,Herenthoutsesteenweg 2,2021-09-17,14:00:00,81,75,6,ECO_300019380
642,Herenthoutsesteenweg 2,2021-09-17,15:00:00,117,108,9,ECO_300019380
642,Herenthoutsesteenweg 2,2021-09-17,16:00:00,132,122,10,ECO_300019380
642,Herenthoutsesteenweg 2,2021-09-17,17:00:00,181,176,5,ECO_300019380
642,Herenthoutsesteenweg 2,2021-09-17,18:00:00,175,157,18,ECO_300019380
642,Herenthoutsesteenweg 2,2021-09-17,19:00:00,95,86,9,ECO_300019380
642,Herenthoutsesteenweg 2,2021-09-17,20:00:00,68,65,3,ECO_300019380
642,Herenthoutsesteenweg 2,2021-09-17,21:00:00,57,52,5,ECO_300019380
642,Herenthoutsesteenweg 2,2021-09-17,22:00:00,57,50,7,ECO_300019380
642,Herenthoutsesteenweg 2,2021-09-17,23:00:00,23,23,0,ECO_300019380
642,Herenthoutsesteenweg 2,2021-09-18,00:00:00,16,15,1,ECO_300019380
642,Herenthoutsesteenweg 2,2021-09-18,01:00:00,14,7,7,ECO_300019380
642,Herenthoutsesteenweg 2,2021-09-18,02:00:00,9,7,2,ECO_300019380
642,Herenthoutsesteenweg 2,2021-09-18,03:00:00,11,8,3,ECO_300019380
642,Herenthoutsesteenweg 2,2021-09-18,04:00:00,6,5,1,ECO_300019380
642,Herenthoutsesteenweg 2,2021-09-18,05:00:00,27,27,0,ECO_300019380
642,Herenthoutsesteenweg 2,2021-09-18,06:00:00,11,11,0,ECO_300019380
642,Herenthoutsesteenweg 2,2021-09-18,07:00:00,6,6,0,ECO_300019380
642,Herenthoutsesteenweg 2,2021-09-18,08:00:00,12,12,0,ECO_300019380
642,Herenthoutsesteenweg 2,2021-09-18,09:00:00,14,9,5,ECO_300019380
642,Herenthoutsesteenweg 2,2021-09-18,10:00:00,47,47,0,ECO_300019380
642,Herenthoutsesteenweg 2,2021-09-18,11:00:00,67,67,0,ECO_300019380
642,Herenthoutsesteenweg 2,2021-09-18,12:00:00,85,82,3,ECO_300019380
642,Herenthoutsesteenweg 2,2021-09-18,13:00:00,109,105,4,ECO_300019380
642,Herenthoutsesteenweg 2,2021-09-18,14:00:00,104,99,5,ECO_300019380
642,Herenthoutsesteenweg 2,2021-09-18,15:00:00,171,161,10,ECO_300019380
642,Herenthoutsesteenweg 2,2021-09-18,16:00:00,158,153,5,ECO_300019380
642,Herenthoutsesteenweg 2,2021-09-18,17:00:00,159,145,14,ECO_300019380
642,Herenthoutsesteenweg 2,2021-09-18,18:00:00,94,81,13,ECO_300019380
642,Herenthoutsesteenweg 2,2021-09-18,19:00:00,80,78,2,ECO_300019380
642,Herenthoutsesteenweg 2,2021-09-18,20:00:00,63,54,9,ECO_300019380
642,Herenthoutsesteenweg 2,2021-09-18,21:00:00,69,64,5,ECO_300019380
642,Herenthoutsesteenweg 2,2021-09-18,22:00:00,45,44,1,ECO_300019380
642,Herenthoutsesteenweg 2,2021-09-18,23:00:00,27,24,3,ECO_300019380
642,Herenthoutsesteenweg 2,2021-09-19,00:00:00,18,12,6,ECO_300019380
642,Herenthoutsesteenweg 2,2021-09-19,01:00:00,17,13,4,ECO_300019380
642,Herenthoutsesteenweg 2,2021-09-19,02:00:00,7,5,2,ECO_300019380
642,Herenthoutsesteenweg 2,2021-09-19,03:00:00,3,1,2,ECO_300019380
642,Herenthoutsesteenweg 2,2021-09-19,04:00:00,2,2,0,ECO_300019380
642,Herenthoutsesteenweg 2,2021-09-19,05:00:00,7,6,1,ECO_300019380
642,Herenthoutsesteenweg 2,2021-09-19,06:00:00,6,6,0,ECO_300019380
642,Herenthoutsesteenweg 2,2021-09-19,07:00:00,3,3,0,ECO_300019380
642,Herenthoutsesteenweg 2,2021-09-19,08:00:00,7,7,0,ECO_300019380
642,Herenthoutsesteenweg 2,2021-09-19,09:00:00,18,17,1,ECO_300019380
642,Herenthoutsesteenweg 2,2021-09-19,10:00:00,54,51,3,ECO_300019380
642,Herenthoutsesteenweg 2,2021-09-19,11:00:00,112,106,6,ECO_300019380
642,Herenthoutsesteenweg 2,2021-09-19,12:00:00,150,144,6,ECO_300019380
642,Herenthoutsesteenweg 2,2021-09-19,13:00:00,123,99,24,ECO_300019380
642,Herenthoutsesteenweg 2,2021-09-19,14:00:00,99,90,9,ECO_300019380
642,Herenthoutsesteenweg 2,2021-09-19,15:00:00,143,136,7,ECO_300019380
642,Herenthoutsesteenweg 2,2021-09-19,16:00:00,163,154,9,ECO_300019380
642,Herenthoutsesteenweg 2,2021-09-19,17:00:00,117,113,4,ECO_300019380
642,Herenthoutsesteenweg 2,2021-09-19,18:00:00,114,104,10,ECO_300019380
642,Herenthoutsesteenweg 2,2021-09-19,19:00:00,67,60,7,ECO_300019380
642,Herenthoutsesteenweg 2,2021-09-19,20:00:00,45,38,7,ECO_300019380
642,Herenthoutsesteenweg 2,2021-09-19,21:00:00,46,39,7,ECO_300019380
642,Herenthoutsesteenweg 2,2021-09-19,22:00:00,27,27,0,ECO_300019380
642,Herenthoutsesteenweg 2,2021-09-19,23:00:00,13,12,1,ECO_300019380
642,Herenthoutsesteenweg 2,2021-09-20,00:00:00,9,5,4,ECO_300019380
642,Herenthoutsesteenweg 2,2021-09-20,01:00:00,8,7,1,ECO_300019380
642,Herenthoutsesteenweg 2,2021-09-20,02:00:00,0,0,0,ECO_300019380
642,Herenthoutsesteenweg 2,2021-09-20,03:00:00,0,0,0,ECO_300019380
642,Herenthoutsesteenweg 2,2021-09-20,04:00:00,0,0,0,ECO_300019380
642,Herenthoutsesteenweg 2,2021-09-20,05:00:00,1,0,1,ECO_300019380
642,Herenthoutsesteenweg 2,2021-09-20,06:00:00,1,1,0,ECO_300019380
642,Herenthoutsesteenweg 2,2021-09-20,07:00:00,19,18,1,ECO_300019380
642,Herenthoutsesteenweg 2,2021-09-20,08:00:00,33,29,4,ECO_300019380
642,Herenthoutsesteenweg 2,2021-09-20,09:00:00,188,187,1,ECO_300019380
642,Herenthoutsesteenweg 2,2021-09-20,10:00:00,611,603,8,ECO_300019380
642,Herenthoutsesteenweg 2,2021-09-20,11:00:00,54,51,3,ECO_300019380
642,Herenthoutsesteenweg 2,2021-09-20,12:00:00,62,60,2,ECO_300019380
642,Herenthoutsesteenweg 2,2021-09-20,13:00:00,69,62,7,ECO_300019380
642,Herenthoutsesteenweg 2,2021-09-20,14:00:00,84,80,4,ECO_300019380
642,Herenthoutsesteenweg 2,2021-09-20,15:00:00,112,106,6,ECO_300019380
642,Herenthoutsesteenweg 2,2021-09-20,16:00:00,114,108,6,ECO_300019380
642,Herenthoutsesteenweg 2,2021-09-20,17:00:00,145,138,7,ECO_300019380
642,Herenthoutsesteenweg 2,2021-09-20,18:00:00,136,131,5,ECO_300019380
642,Herenthoutsesteenweg 2,2021-09-20,19:00:00,87,83,4,ECO_300019380
642,Herenthoutsesteenweg 2,2021-09-20,20:00:00,62,58,4,ECO_300019380
642,Herenthoutsesteenweg 2,2021-09-20,21:00:00,48,45,3,ECO_300019380
642,Herenthoutsesteenweg 2,2021-09-20,22:00:00,26,23,3,ECO_300019380
642,Herenthoutsesteenweg 2,2021-09-20,23:00:00,10,8,2,ECO_300019380
642,Herenthoutsesteenweg 2,2021-09-21,00:00:00,11,9,2,ECO_300019380
642,Herenthoutsesteenweg 2,2021-09-21,01:00:00,5,4,1,ECO_300019380
642,Herenthoutsesteenweg 2,2021-09-21,02:00:00,2,1,1,ECO_300019380
642,Herenthoutsesteenweg 2,2021-09-21,03:00:00,4,4,0,ECO_300019380
642,Herenthoutsesteenweg 2,2021-09-21,04:00:00,0,0,0,ECO_300019380
642,Herenthoutsesteenweg 2,2021-09-21,05:00:00,0,0,0,ECO_300019380
642,Herenthoutsesteenweg 2,2021-09-21,06:00:00,6,3,3,ECO_300019380
642,Herenthoutsesteenweg 2,2021-09-21,07:00:00,19,17,2,ECO_300019380
642,Herenthoutsesteenweg 2,2021-09-21,08:00:00,49,47,2,ECO_300019380
642,Herenthoutsesteenweg 2,2021-09-21,09:00:00,214,211,3,ECO_300019380
642,Herenthoutsesteenweg 2,2021-09-21,10:00:00,585,577,8,ECO_300019380
642,Herenthoutsesteenweg 2,2021-09-21,11:00:00,90,84,6,ECO_300019380
642,Herenthoutsesteenweg 2,2021-09-21,12:00:00,82,80,2,ECO_300019380
642,Herenthoutsesteenweg 2,2021-09-21,13:00:00,61,59,2,ECO_300019380
642,Herenthoutsesteenweg 2,2021-09-21,14:00:00,96,88,8,ECO_300019380
642,Herenthoutsesteenweg 2,2021-09-21,15:00:00,152,145,7,ECO_300019380
642,Herenthoutsesteenweg 2,2021-09-21,16:00:00,154,145,9,ECO_300019380
642,Herenthoutsesteenweg 2,2021-09-21,17:00:00,137,132,5,ECO_300019380
642,Herenthoutsesteenweg 2,2021-09-21,18:00:00,136,130,6,ECO_300019380
642,Herenthoutsesteenweg 2,2021-09-21,19:00:00,108,102,6,ECO_300019380
642,Herenthoutsesteenweg 2,2021-09-21,20:00:00,67,65,2,ECO_300019380
642,Herenthoutsesteenweg 2,2021-09-21,21:00:00,50,49,1,ECO_300019380
642,Herenthoutsesteenweg 2,2021-09-21,22:00:00,33,32,1,ECO_300019380
642,Herenthoutsesteenweg 2,2021-09-21,23:00:00,14,13,1,ECO_300019380
642,Herenthoutsesteenweg 2,2021-09-22,00:00:00,18,14,4,ECO_300019380
642,Herenthoutsesteenweg 2,2021-09-22,01:00:00,5,5,0,ECO_300019380
642,Herenthoutsesteenweg 2,2021-09-22,02:00:00,1,0,1,ECO_300019380
642,Herenthoutsesteenweg 2,2021-09-22,03:00:00,2,2,0,ECO_300019380
642,Herenthoutsesteenweg 2,2021-09-22,04:00:00,1,0,1,ECO_300019380
642,Herenthoutsesteenweg 2,2021-09-22,05:00:00,1,1,0,ECO_300019380
642,Herenthoutsesteenweg 2,2021-09-22,06:00:00,3,3,0,ECO_300019380
642,Herenthoutsesteenweg 2,2021-09-22,07:00:00,15,14,1,ECO_300019380
642,Herenthoutsesteenweg 2,2021-09-22,08:00:00,46,43,3,ECO_300019380
642,Herenthoutsesteenweg 2,2021-09-22,09:00:00,178,176,2,ECO_300019380
642,Herenthoutsesteenweg 2,2021-09-22,10:00:00,569,567,2,ECO_300019380
642,Herenthoutsesteenweg 2,2021-09-22,11:00:00,97,94,3,ECO_300019380
642,Herenthoutsesteenweg 2,2021-09-22,12:00:00,86,75,11,ECO_300019380
642,Herenthoutsesteenweg 2,2021-09-22,13:00:00,75,73,2,ECO_300019380
642,Herenthoutsesteenweg 2,2021-09-22,14:00:00,173,166,7,ECO_300019380
642,Herenthoutsesteenweg 2,2021-09-22,15:00:00,129,119,10,ECO_300019380
642,Herenthoutsesteenweg 2,2021-09-22,16:00:00,167,162,5,ECO_300019380
642,Herenthoutsesteenweg 2,2021-09-22,17:00:00,103,97,6,ECO_300019380
642,Herenthoutsesteenweg 2,2021-09-22,18:00:00,146,141,5,ECO_300019380
642,Herenthoutsesteenweg 2,2021-09-22,19:00:00,120,111,9,ECO_300019380
642,Herenthoutsesteenweg 2,2021-09-22,20:00:00,86,74,12,ECO_300019380
642,Herenthoutsesteenweg 2,2021-09-22,21:00:00,52,44,8,ECO_300019380
642,Herenthoutsesteenweg 2,2021-09-22,22:00:00,41,37,4,ECO_300019380
642,Herenthoutsesteenweg 2,2021-09-22,23:00:00,11,9,2,ECO_300019380
642,Herenthoutsesteenweg 2,2021-09-23,00:00:00,15,12,3,ECO_300019380
642,Herenthoutsesteenweg 2,2021-09-23,01:00:00,3,1,2,ECO_300019380
642,Herenthoutsesteenweg 2,2021-09-23,02:00:00,0,0,0,ECO_300019380
642,Herenthoutsesteenweg 2,2021-09-23,03:00:00,1,1,0,ECO_300019380
642,Herenthoutsesteenweg 2,2021-09-23,04:00:00,0,0,0,ECO_300019380
642,Herenthoutsesteenweg 2,2021-09-23,05:00:00,0,0,0,ECO_300019380
642,Herenthoutsesteenweg 2,2021-09-23,06:00:00,5,5,0,ECO_300019380
642,Herenthoutsesteenweg 2,2021-09-23,07:00:00,14,13,1,ECO_300019380
642,Herenthoutsesteenweg 2,2021-09-23,08:00:00,35,32,3,ECO_300019380
642,Herenthoutsesteenweg 2,2021-09-23,09:00:00,173,172,1,ECO_300019380
642,Herenthoutsesteenweg 2,2021-09-23,10:00:00,582,573,9,ECO_300019380
642,Herenthoutsesteenweg 2,2021-09-23,11:00:00,63,61,2,ECO_300019380
642,Herenthoutsesteenweg 2,2021-09-23,12:00:00,68,66,2,ECO_300019380
642,Herenthoutsesteenweg 2,2021-09-23,13:00:00,69,67,2,ECO_300019380
642,Herenthoutsesteenweg 2,2021-09-23,14:00:00,69,66,3,ECO_300019380
642,Herenthoutsesteenweg 2,2021-09-23,15:00:00,103,95,8,ECO_300019380
642,Herenthoutsesteenweg 2,2021-09-23,16:00:00,110,105,5,ECO_300019380
642,Herenthoutsesteenweg 2,2021-09-23,17:00:00,138,135,3,ECO_300019380
642,Herenthoutsesteenweg 2,2021-09-23,18:00:00,137,130,7,ECO_300019380
642,Herenthoutsesteenweg 2,2021-09-23,19:00:00,85,79,6,ECO_300019380
642,Herenthoutsesteenweg 2,2021-09-23,20:00:00,70,67,3,ECO_300019380
642,Herenthoutsesteenweg 2,2021-09-23,21:00:00,37,37,0,ECO_300019380
642,Herenthoutsesteenweg 2,2021-09-23,22:00:00,26,22,4,ECO_300019380
642,Herenthoutsesteenweg 2,2021-09-23,23:00:00,20,17,3,ECO_300019380
642,Herenthoutsesteenweg 2,2021-09-24,00:00:00,16,12,4,ECO_300019380
642,Herenthoutsesteenweg 2,2021-09-24,01:00:00,8,7,1,ECO_300019380
642,Herenthoutsesteenweg 2,2021-09-24,02:00:00,0,0,0,ECO_300019380
642,Herenthoutsesteenweg 2,2021-09-24,03:00:00,4,3,1,ECO_300019380
642,Herenthoutsesteenweg 2,2021-09-24,04:00:00,1,1,0,ECO_300019380
642,Herenthoutsesteenweg 2,2021-09-24,05:00:00,1,0,1,ECO_300019380
642,Herenthoutsesteenweg 2,2021-09-24,06:00:00,2,2,0,ECO_300019380
642,Herenthoutsesteenweg 2,2021-09-24,07:00:00,10,9,1,ECO_300019380
642,Herenthoutsesteenweg 2,2021-09-24,08:00:00,35,32,3,ECO_300019380
642,Herenthoutsesteenweg 2,2021-09-24,09:00:00,175,173,2,ECO_300019380
642,Herenthoutsesteenweg 2,2021-09-24,10:00:00,583,574,9,ECO_300019380
642,Herenthoutsesteenweg 2,2021-09-24,11:00:00,117,115,2,ECO_300019380
642,Herenthoutsesteenweg 2,2021-09-24,12:00:00,82,79,3,ECO_300019380
642,Herenthoutsesteenweg 2,2021-09-24,13:00:00,58,58,0,ECO_300019380
642,Herenthoutsesteenweg 2,2021-09-24,14:00:00,64,60,4,ECO_300019380
642,Herenthoutsesteenweg 2,2021-09-24,15:00:00,100,90,10,ECO_300019380
642,Herenthoutsesteenweg 2,2021-09-24,16:00:00,109,95,14,ECO_300019380
642,Herenthoutsesteenweg 2,2021-09-24,17:00:00,138,132,6,ECO_300019380
642,Herenthoutsesteenweg 2,2021-09-24,18:00:00,132,122,10,ECO_300019380
642,Herenthoutsesteenweg 2,2021-09-24,19:00:00,81,77,4,ECO_300019380
642,Herenthoutsesteenweg 2,2021-09-24,20:00:00,75,67,8,ECO_300019380
642,Herenthoutsesteenweg 2,2021-09-24,21:00:00,55,49,6,ECO_300019380
642,Herenthoutsesteenweg 2,2021-09-24,22:00:00,42,39,3,ECO_300019380
642,Herenthoutsesteenweg 2,2021-09-24,23:00:00,20,19,1,ECO_300019380
642,Herenthoutsesteenweg 2,2021-09-25,00:00:00,26,22,4,ECO_300019380
642,Herenthoutsesteenweg 2,2021-09-25,01:00:00,11,10,1,ECO_300019380
642,Herenthoutsesteenweg 2,2021-09-25,02:00:00,6,5,1,ECO_300019380
642,Herenthoutsesteenweg 2,2021-09-25,03:00:00,7,5,2,ECO_300019380
642,Herenthoutsesteenweg 2,2021-09-25,04:00:00,3,2,1,ECO_300019380
642,Herenthoutsesteenweg 2,2021-09-25,05:00:00,2,0,2,ECO_300019380
642,Herenthoutsesteenweg 2,2021-09-25,06:00:00,2,2,0,ECO_300019380
642,Herenthoutsesteenweg 2,2021-09-25,07:00:00,4,4,0,ECO_300019380
642,Herenthoutsesteenweg 2,2021-09-25,08:00:00,8,8,0,ECO_300019380
642,Herenthoutsesteenweg 2,2021-09-25,09:00:00,19,19,0,ECO_300019380
642,Herenthoutsesteenweg 2,2021-09-25,10:00:00,50,50,0,ECO_300019380
642,Herenthoutsesteenweg 2,2021-09-25,11:00:00,86,82,4,ECO_300019380
642,Herenthoutsesteenweg 2,2021-09-25,12:00:00,111,106,5,ECO_300019380
642,Herenthoutsesteenweg 2,2021-09-25,13:00:00,94,90,4,ECO_300019380
642,Herenthoutsesteenweg 2,2021-09-25,14:00:00,116,112,4,ECO_300019380
642,Herenthoutsesteenweg 2,2021-09-25,15:00:00,185,169,16,ECO_300019380
642,Herenthoutsesteenweg 2,2021-09-25,16:00:00,162,155,7,ECO_300019380
642,Herenthoutsesteenweg 2,2021-09-25,17:00:00,154,146,8,ECO_300019380
642,Herenthoutsesteenweg 2,2021-09-25,18:00:00,113,104,9,ECO_300019380
642,Herenthoutsesteenweg 2,2021-09-25,19:00:00,87,82,5,ECO_300019380
642,Herenthoutsesteenweg 2,2021-09-25,20:00:00,85,78,7,ECO_300019380
642,Herenthoutsesteenweg 2,2021-09-25,21:00:00,46,45,1,ECO_300019380
642,Herenthoutsesteenweg 2,2021-09-25,22:00:00,37,34,3,ECO_300019380
642,Herenthoutsesteenweg 2,2021-09-25,23:00:00,25,21,4,ECO_300019380
642,Herenthoutsesteenweg 2,2021-09-26,00:00:00,24,19,5,ECO_300019380
642,Herenthoutsesteenweg 2,2021-09-26,01:00:00,13,13,0,ECO_300019380
642,Herenthoutsesteenweg 2,2021-09-26,02:00:00,9,5,4,ECO_300019380
642,Herenthoutsesteenweg 2,2021-09-26,03:00:00,4,3,1,ECO_300019380
642,Herenthoutsesteenweg 2,2021-09-26,04:00:00,3,2,1,ECO_300019380
642,Herenthoutsesteenweg 2,2021-09-26,05:00:00,9,3,6,ECO_300019380
642,Herenthoutsesteenweg 2,2021-09-26,06:00:00,5,1,4,ECO_300019380
642,Herenthoutsesteenweg 2,2021-09-26,07:00:00,5,3,2,ECO_300019380
642,Herenthoutsesteenweg 2,2021-09-26,08:00:00,8,8,0,ECO_300019380
642,Herenthoutsesteenweg 2,2021-09-26,09:00:00,18,16,2,ECO_300019380
642,Herenthoutsesteenweg 2,2021-09-26,10:00:00,68,58,10,ECO_300019380
642,Herenthoutsesteenweg 2,2021-09-26,11:00:00,137,118,19,ECO_300019380
642,Herenthoutsesteenweg 2,2021-09-26,12:00:00,114,104,10,ECO_300019380
642,Herenthoutsesteenweg 2,2021-09-26,13:00:00,88,80,8,ECO_300019380
642,Herenthoutsesteenweg 2,2021-09-26,14:00:00,93,90,3,ECO_300019380
642,Herenthoutsesteenweg 2,2021-09-26,15:00:00,128,122,6,ECO_300019380
642,Herenthoutsesteenweg 2,2021-09-26,16:00:00,88,79,9,ECO_300019380
642,Herenthoutsesteenweg 2,2021-09-26,17:00:00,62,57,5,ECO_300019380
642,Herenthoutsesteenweg 2,2021-09-26,18:00:00,40,36,4,ECO_300019380
642,Herenthoutsesteenweg 2,2021-09-26,19:00:00,45,41,4,ECO_300019380
642,Herenthoutsesteenweg 2,2021-09-26,20:00:00,68,64,4,ECO_300019380
642,Herenthoutsesteenweg 2,2021-09-26,21:00:00,41,32,9,ECO_300019380
642,Herenthoutsesteenweg 2,2021-09-26,22:00:00,24,21,3,ECO_300019380
642,Herenthoutsesteenweg 2,2021-09-26,23:00:00,2,1,1,ECO_300019380
642,Herenthoutsesteenweg 2,2021-09-27,00:00:00,3,3,0,ECO_300019380
642,Herenthoutsesteenweg 2,2021-09-27,01:00:00,2,2,0,ECO_300019380
642,Herenthoutsesteenweg 2,2021-09-27,02:00:00,2,2,0,ECO_300019380
642,Herenthoutsesteenweg 2,2021-09-27,03:00:00,0,0,0,ECO_300019380
642,Herenthoutsesteenweg 2,2021-09-27,04:00:00,2,2,0,ECO_300019380
642,Herenthoutsesteenweg 2,2021-09-27,05:00:00,0,0,0,ECO_300019380
642,Herenthoutsesteenweg 2,2021-09-27,06:00:00,3,2,1,ECO_300019380
642,Herenthoutsesteenweg 2,2021-09-27,07:00:00,13,12,1,ECO_300019380
642,Herenthoutsesteenweg 2,2021-09-27,08:00:00,38,36,2,ECO_300019380
642,Herenthoutsesteenweg 2,2021-09-27,09:00:00,170,168,2,ECO_300019380
642,Herenthoutsesteenweg 2,2021-09-27,10:00:00,475,472,3,ECO_300019380
642,Herenthoutsesteenweg 2,2021-09-27,11:00:00,92,85,7,ECO_300019380
642,Herenthoutsesteenweg 2,2021-09-27,12:00:00,60,58,2,ECO_300019380
642,Herenthoutsesteenweg 2,2021-09-27,13:00:00,62,56,6,ECO_300019380
642,Herenthoutsesteenweg 2,2021-09-27,14:00:00,37,37,0,ECO_300019380
642,Herenthoutsesteenweg 2,2021-09-27,15:00:00,60,57,3,ECO_300019380
642,Herenthoutsesteenweg 2,2021-09-27,16:00:00,44,43,1,ECO_300019380
642,Herenthoutsesteenweg 2,2021-09-27,17:00:00,48,45,3,ECO_300019380
642,Herenthoutsesteenweg 2,2021-09-27,18:00:00,75,68,7,ECO_300019380
642,Herenthoutsesteenweg 2,2021-09-27,19:00:00,58,56,2,ECO_300019380
642,Herenthoutsesteenweg 2,2021-09-27,20:00:00,37,33,4,ECO_300019380
642,Herenthoutsesteenweg 2,2021-09-27,21:00:00,32,30,2,ECO_300019380
642,Herenthoutsesteenweg 2,2021-09-27,22:00:00,15,13,2,ECO_300019380
642,Herenthoutsesteenweg 2,2021-09-27,23:00:00,13,11,2,ECO_300019380
642,Herenthoutsesteenweg 2,2021-09-28,00:00:00,13,13,0,ECO_300019380
642,Herenthoutsesteenweg 2,2021-09-28,01:00:00,4,2,2,ECO_300019380
642,Herenthoutsesteenweg 2,2021-09-28,02:00:00,1,0,1,ECO_300019380
642,Herenthoutsesteenweg 2,2021-09-28,03:00:00,1,1,0,ECO_300019380
642,Herenthoutsesteenweg 2,2021-09-28,04:00:00,1,0,1,ECO_300019380
642,Herenthoutsesteenweg 2,2021-09-28,05:00:00,0,0,0,ECO_300019380
642,Herenthoutsesteenweg 2,2021-09-28,06:00:00,2,2,0,ECO_300019380
642,Herenthoutsesteenweg 2,2021-09-28,07:00:00,13,11,2,ECO_300019380
642,Herenthoutsesteenweg 2,2021-09-28,08:00:00,42,36,6,ECO_300019380
642,Herenthoutsesteenweg 2,2021-09-28,09:00:00,205,202,3,ECO_300019380
642,Herenthoutsesteenweg 2,2021-09-28,10:00:00,486,481,5,ECO_300019380
642,Herenthoutsesteenweg 2,2021-09-28,11:00:00,81,79,2,ECO_300019380
642,Herenthoutsesteenweg 2,2021-09-28,12:00:00,81,72,9,ECO_300019380
642,Herenthoutsesteenweg 2,2021-09-28,13:00:00,64,55,9,ECO_300019380
642,Herenthoutsesteenweg 2,2021-09-28,14:00:00,100,96,4,ECO_300019380
642,Herenthoutsesteenweg 2,2021-09-28,15:00:00,119,116,3,ECO_300019380
642,Herenthoutsesteenweg 2,2021-09-28,16:00:00,120,117,3,ECO_300019380
642,Herenthoutsesteenweg 2,2021-09-28,17:00:00,128,118,10,ECO_300019380
642,Herenthoutsesteenweg 2,2021-09-28,18:00:00,165,156,9,ECO_300019380
642,Herenthoutsesteenweg 2,2021-09-28,19:00:00,96,92,4,ECO_300019380
642,Herenthoutsesteenweg 2,2021-09-28,20:00:00,56,53,3,ECO_300019380
642,Herenthoutsesteenweg 2,2021-09-28,21:00:00,39,31,8,ECO_300019380
642,Herenthoutsesteenweg 2,2021-09-28,22:00:00,24,23,1,ECO_300019380
642,Herenthoutsesteenweg 2,2021-09-28,23:00:00,18,16,2,ECO_300019380
642,Herenthoutsesteenweg 2,2021-09-29,00:00:00,15,13,2,ECO_300019380
642,Herenthoutsesteenweg 2,2021-09-29,01:00:00,4,4,0,ECO_300019380
642,Herenthoutsesteenweg 2,2021-09-29,02:00:00,1,1,0,ECO_300019380
642,Herenthoutsesteenweg 2,2021-09-29,03:00:00,1,1,0,ECO_300019380
642,Herenthoutsesteenweg 2,2021-09-29,04:00:00,0,0,0,ECO_300019380
642,Herenthoutsesteenweg 2,2021-09-29,05:00:00,0,0,0,ECO_300019380
642,Herenthoutsesteenweg 2,2021-09-29,06:00:00,2,2,0,ECO_300019380
642,Herenthoutsesteenweg 2,2021-09-29,07:00:00,7,6,1,ECO_300019380
642,Herenthoutsesteenweg 2,2021-09-29,08:00:00,30,26,4,ECO_300019380
642,Herenthoutsesteenweg 2,2021-09-29,09:00:00,133,131,2,ECO_300019380
642,Herenthoutsesteenweg 2,2021-09-29,10:00:00,355,353,2,ECO_300019380
642,Herenthoutsesteenweg 2,2021-09-29,11:00:00,54,53,1,ECO_300019380
642,Herenthoutsesteenweg 2,2021-09-29,12:00:00,53,50,3,ECO_300019380
642,Herenthoutsesteenweg 2,2021-09-29,13:00:00,38,38,0,ECO_300019380
642,Herenthoutsesteenweg 2,2021-09-29,14:00:00,47,42,5,ECO_300019380
642,Herenthoutsesteenweg 2,2021-09-29,15:00:00,37,35,2,ECO_300019380
642,Herenthoutsesteenweg 2,2021-09-29,16:00:00,32,31,1,ECO_300019380
642,Herenthoutsesteenweg 2,2021-09-29,17:00:00,27,26,1,ECO_300019380
642,Herenthoutsesteenweg 2,2021-09-29,18:00:00,71,65,6,ECO_300019380
642,Herenthoutsesteenweg 2,2021-09-29,19:00:00,37,33,4,ECO_300019380
642,Herenthoutsesteenweg 2,2021-09-29,20:00:00,23,21,2,ECO_300019380
642,Herenthoutsesteenweg 2,2021-09-29,21:00:00,18,16,2,ECO_300019380
642,Herenthoutsesteenweg 2,2021-09-29,22:00:00,15,14,1,ECO_300019380
642,Herenthoutsesteenweg 2,2021-09-29,23:00:00,9,7,2,ECO_300019380
642,Herenthoutsesteenweg 2,2021-09-30,00:00:00,10,8,2,ECO_300019380
642,Herenthoutsesteenweg 2,2021-09-30,01:00:00,0,0,0,ECO_300019380
642,Herenthoutsesteenweg 2,2021-09-30,02:00:00,1,1,0,ECO_300019380
642,Herenthoutsesteenweg 2,2021-09-30,03:00:00,2,2,0,ECO_300019380
642,Herenthoutsesteenweg 2,2021-09-30,04:00:00,0,0,0,ECO_300019380
642,Herenthoutsesteenweg 2,2021-09-30,05:00:00,0,0,0,ECO_300019380
642,Herenthoutsesteenweg 2,2021-09-30,06:00:00,3,3,0,ECO_300019380
642,Herenthoutsesteenweg 2,2021-09-30,07:00:00,10,8,2,ECO_300019380
642,Herenthoutsesteenweg 2,2021-09-30,08:00:00,38,36,2,ECO_300019380
642,Herenthoutsesteenweg 2,2021-09-30,09:00:00,179,174,5,ECO_300019380
642,Herenthoutsesteenweg 2,2021-09-30,10:00:00,561,554,7,ECO_300019380
642,Herenthoutsesteenweg 2,2021-09-30,11:00:00,71,68,3,ECO_300019380
642,Herenthoutsesteenweg 2,2021-09-30,12:00:00,71,58,13,ECO_300019380
642,Herenthoutsesteenweg 2,2021-09-30,13:00:00,56,50,6,ECO_300019380
642,Herenthoutsesteenweg 2,2021-09-30,14:00:00,64,58,6,ECO_300019380
642,Herenthoutsesteenweg 2,2021-09-30,15:00:00,106,102,4,ECO_300019380
642,Herenthoutsesteenweg 2,2021-09-30,16:00:00,70,66,4,ECO_300019380
642,Herenthoutsesteenweg 2,2021-09-30,17:00:00,99,92,7,ECO_300019380
642,Herenthoutsesteenweg 2,2021-09-30,18:00:00,129,114,15,ECO_300019380
642,Herenthoutsesteenweg 2,2021-09-30,19:00:00,91,79,12,ECO_300019380
642,Herenthoutsesteenweg 2,2021-09-30,20:00:00,48,44,4,ECO_300019380
642,Herenthoutsesteenweg 2,2021-09-30,21:00:00,33,32,1,ECO_300019380
642,Herenthoutsesteenweg 2,2021-09-30,22:00:00,24,21,3,ECO_300019380
642,Herenthoutsesteenweg 2,2021-09-30,23:00:00,22,19,3,ECO_300019380
642,Herenthoutsesteenweg 2,2021-10-01,00:00:00,16,12,4,ECO_300019380
642,Herenthoutsesteenweg 2,2021-10-01,01:00:00,4,2,2,ECO_300019380
642,Herenthoutsesteenweg 2,2021-10-01,02:00:00,0,0,0,ECO_300019380
642,Herenthoutsesteenweg 2,2021-10-01,03:00:00,1,1,0,ECO_300019380
642,Herenthoutsesteenweg 2,2021-10-01,04:00:00,0,0,0,ECO_300019380
642,Herenthoutsesteenweg 2,2021-10-01,05:00:00,0,0,0,ECO_300019380
642,Herenthoutsesteenweg 2,2021-10-01,06:00:00,1,1,0,ECO_300019380
642,Herenthoutsesteenweg 2,2021-10-01,07:00:00,11,10,1,ECO_300019380
642,Herenthoutsesteenweg 2,2021-10-01,08:00:00,36,35,1,ECO_300019380
642,Herenthoutsesteenweg 2,2021-10-01,09:00:00,168,165,3,ECO_300019380
642,Herenthoutsesteenweg 2,2021-10-01,10:00:00,365,362,3,ECO_300019380
642,Herenthoutsesteenweg 2,2021-10-01,11:00:00,99,96,3,ECO_300019380
642,Herenthoutsesteenweg 2,2021-10-01,12:00:00,66,59,7,ECO_300019380
642,Herenthoutsesteenweg 2,2021-10-01,13:00:00,56,52,4,ECO_300019380
642,Herenthoutsesteenweg 2,2021-10-01,14:00:00,39,36,3,ECO_300019380
642,Herenthoutsesteenweg 2,2021-10-01,15:00:00,61,59,2,ECO_300019380
642,Herenthoutsesteenweg 2,2021-10-01,16:00:00,60,55,5,ECO_300019380
642,Herenthoutsesteenweg 2,2021-10-01,17:00:00,116,106,10,ECO_300019380
642,Herenthoutsesteenweg 2,2021-10-01,18:00:00,104,96,8,ECO_300019380
642,Herenthoutsesteenweg 2,2021-10-01,19:00:00,36,31,5,ECO_300019380
642,Herenthoutsesteenweg 2,2021-10-01,20:00:00,32,30,2,ECO_300019380
642,Herenthoutsesteenweg 2,2021-10-01,21:00:00,19,18,1,ECO_300019380
642,Herenthoutsesteenweg 2,2021-10-01,22:00:00,21,14,7,ECO_300019380
642,Herenthoutsesteenweg 2,2021-10-01,23:00:00,14,13,1,ECO_300019380
642,Herenthoutsesteenweg 2,2021-10-02,00:00:00,11,9,2,ECO_300019380
642,Herenthoutsesteenweg 2,2021-10-02,01:00:00,5,4,1,ECO_300019380
642,Herenthoutsesteenweg 2,2021-10-02,02:00:00,5,2,3,ECO_300019380
642,Herenthoutsesteenweg 2,2021-10-02,03:00:00,3,2,1,ECO_300019380
642,Herenthoutsesteenweg 2,2021-10-02,04:00:00,0,0,0,ECO_300019380
642,Herenthoutsesteenweg 2,2021-10-02,05:00:00,1,1,0,ECO_300019380
642,Herenthoutsesteenweg 2,2021-10-02,06:00:00,0,0,0,ECO_300019380
642,Herenthoutsesteenweg 2,2021-10-02,07:00:00,4,4,0,ECO_300019380
642,Herenthoutsesteenweg 2,2021-10-02,08:00:00,6,5,1,ECO_300019380
642,Herenthoutsesteenweg 2,2021-10-02,09:00:00,9,9,0,ECO_300019380
642,Herenthoutsesteenweg 2,2021-10-02,10:00:00,43,42,1,ECO_300019380
642,Herenthoutsesteenweg 2,2021-10-02,11:00:00,53,52,1,ECO_300019380
642,Herenthoutsesteenweg 2,2021-10-02,12:00:00,79,71,8,ECO_300019380
642,Herenthoutsesteenweg 2,2021-10-02,13:00:00,60,54,6,ECO_300019380
642,Herenthoutsesteenweg 2,2021-10-02,14:00:00,61,54,7,ECO_300019380
642,Herenthoutsesteenweg 2,2021-10-02,15:00:00,75,69,6,ECO_300019380
642,Herenthoutsesteenweg 2,2021-10-02,16:00:00,59,55,4,ECO_300019380
642,Herenthoutsesteenweg 2,2021-10-02,17:00:00,68,60,8,ECO_300019380
642,Herenthoutsesteenweg 2,2021-10-02,18:00:00,37,33,4,ECO_300019380
642,Herenthoutsesteenweg 2,2021-10-02,19:00:00,27,25,2,ECO_300019380
642,Herenthoutsesteenweg 2,2021-10-02,20:00:00,26,21,5,ECO_300019380
642,Herenthoutsesteenweg 2,2021-10-02,21:00:00,18,18,0,ECO_300019380
642,Herenthoutsesteenweg 2,2021-10-02,22:00:00,12,12,0,ECO_300019380
642,Herenthoutsesteenweg 2,2021-10-02,23:00:00,9,6,3,ECO_300019380
642,Herenthoutsesteenweg 2,2021-10-03,00:00:00,4,3,1,ECO_300019380
642,Herenthoutsesteenweg 2,2021-10-03,01:00:00,1,1,0,ECO_300019380
642,Herenthoutsesteenweg 2,2021-10-03,02:00:00,2,1,1,ECO_300019380
642,Herenthoutsesteenweg 2,2021-10-03,03:00:00,5,3,2,ECO_300019380
642,Herenthoutsesteenweg 2,2021-10-03,04:00:00,1,1,0,ECO_300019380
642,Herenthoutsesteenweg 2,2021-10-03,05:00:00,2,1,1,ECO_300019380
642,Herenthoutsesteenweg 2,2021-10-03,06:00:00,0,0,0,ECO_300019380
642,Herenthoutsesteenweg 2,2021-10-03,07:00:00,3,3,0,ECO_300019380
642,Herenthoutsesteenweg 2,2021-10-03,08:00:00,3,3,0,ECO_300019380
642,Herenthoutsesteenweg 2,2021-10-03,09:00:00,4,4,0,ECO_300019380
642,Herenthoutsesteenweg 2,2021-10-03,10:00:00,10,10,0,ECO_300019380
642,Herenthoutsesteenweg 2,2021-10-03,11:00:00,4,3,1,ECO_300019380
642,Herenthoutsesteenweg 2,2021-10-03,12:00:00,13,12,1,ECO_300019380
642,Herenthoutsesteenweg 2,2021-10-03,13:00:00,10,8,2,ECO_300019380
642,Herenthoutsesteenweg 2,2021-10-03,14:00:00,6,6,0,ECO_300019380
642,Herenthoutsesteenweg 2,2021-10-03,15:00:00,8,7,1,ECO_300019380
642,Herenthoutsesteenweg 2,2021-10-03,16:00:00,4,3,1,ECO_300019380
642,Herenthoutsesteenweg 2,2021-10-03,17:00:00,14,14,0,ECO_300019380
642,Herenthoutsesteenweg 2,2021-10-03,18:00:00,11,10,1,ECO_300019380
642,Herenthoutsesteenweg 2,2021-10-03,19:00:00,14,11,3,ECO_300019380
642,Herenthoutsesteenweg 2,2021-10-03,20:00:00,26,24,2,ECO_300019380
642,Herenthoutsesteenweg 2,2021-10-03,21:00:00,14,10,4,ECO_300019380
642,Herenthoutsesteenweg 2,2021-10-03,22:00:00,7,3,4,ECO_300019380
642,Herenthoutsesteenweg 2,2021-10-03,23:00:00,5,5,0,ECO_300019380
642,Herenthoutsesteenweg 2,2021-10-04,00:00:00,5,5,0,ECO_300019380
642,Herenthoutsesteenweg 2,2021-10-04,01:00:00,2,2,0,ECO_300019380
642,Herenthoutsesteenweg 2,2021-10-04,02:00:00,0,0,0,ECO_300019380
642,Herenthoutsesteenweg 2,2021-10-04,03:00:00,0,0,0,ECO_300019380
642,Herenthoutsesteenweg 2,2021-10-04,04:00:00,0,0,0,ECO_300019380
642,Herenthoutsesteenweg 2,2021-10-04,05:00:00,0,0,0,ECO_300019380
642,Herenthoutsesteenweg 2,2021-10-04,06:00:00,2,2,0,ECO_300019380
642,Herenthoutsesteenweg 2,2021-10-04,07:00:00,16,15,1,ECO_300019380
642,Herenthoutsesteenweg 2,2021-10-04,08:00:00,31,28,3,ECO_300019380
642,Herenthoutsesteenweg 2,2021-10-04,09:00:00,111,108,3,ECO_300019380
642,Herenthoutsesteenweg 2,2021-10-04,10:00:00,131,128,3,ECO_300019380
642,Herenthoutsesteenweg 2,2021-10-04,11:00:00,69,69,0,ECO_300019380
642,Herenthoutsesteenweg 2,2021-10-04,12:00:00,60,56,4,ECO_300019380
642,Herenthoutsesteenweg 2,2021-10-04,13:00:00,50,50,0,ECO_300019380
642,Herenthoutsesteenweg 2,2021-10-04,14:00:00,59,58,1,ECO_300019380
642,Herenthoutsesteenweg 2,2021-10-04,15:00:00,86,83,3,ECO_300019380
642,Herenthoutsesteenweg 2,2021-10-04,16:00:00,86,79,7,ECO_300019380
642,Herenthoutsesteenweg 2,2021-10-04,17:00:00,89,83,6,ECO_300019380
642,Herenthoutsesteenweg 2,2021-10-04,18:00:00,100,93,7,ECO_300019380
642,Herenthoutsesteenweg 2,2021-10-04,19:00:00,84,73,11,ECO_300019380
642,Herenthoutsesteenweg 2,2021-10-04,20:00:00,61,51,10,ECO_300019380
642,Herenthoutsesteenweg 2,2021-10-04,21:00:00,34,30,4,ECO_300019380
642,Herenthoutsesteenweg 2,2021-10-04,22:00:00,19,18,1,ECO_300019380
642,Herenthoutsesteenweg 2,2021-10-04,23:00:00,8,8,0,ECO_300019380
642,Herenthoutsesteenweg 2,2021-10-05,00:00:00,12,10,2,ECO_300019380
642,Herenthoutsesteenweg 2,2021-10-05,01:00:00,2,1,1,ECO_300019380
642,Herenthoutsesteenweg 2,2021-10-05,02:00:00,2,2,0,ECO_300019380
642,Herenthoutsesteenweg 2,2021-10-05,03:00:00,0,0,0,ECO_300019380
642,Herenthoutsesteenweg 2,2021-10-05,04:00:00,0,0,0,ECO_300019380
642,Herenthoutsesteenweg 2,2021-10-05,05:00:00,0,0,0,ECO_300019380
642,Herenthoutsesteenweg 2,2021-10-05,06:00:00,2,2,0,ECO_300019380
642,Herenthoutsesteenweg 2,2021-10-05,07:00:00,13,13,0,ECO_300019380
642,Herenthoutsesteenweg 2,2021-10-05,08:00:00,38,38,0,ECO_300019380
642,Herenthoutsesteenweg 2,2021-10-05,09:00:00,162,158,4,ECO_300019380
642,Herenthoutsesteenweg 2,2021-10-05,10:00:00,548,541,7,ECO_300019380
642,Herenthoutsesteenweg 2,2021-10-05,11:00:00,71,69,2,ECO_300019380
642,Herenthoutsesteenweg 2,2021-10-05,12:00:00,58,57,1,ECO_300019380
642,Herenthoutsesteenweg 2,2021-10-05,13:00:00,53,50,3,ECO_300019380
642,Herenthoutsesteenweg 2,2021-10-05,14:00:00,43,37,6,ECO_300019380
642,Herenthoutsesteenweg 2,2021-10-05,15:00:00,25,23,2,ECO_300019380
642,Herenthoutsesteenweg 2,2021-10-05,16:00:00,17,13,4,ECO_300019380
642,Herenthoutsesteenweg 2,2021-10-05,17:00:00,62,59,3,ECO_300019380
642,Herenthoutsesteenweg 2,2021-10-05,18:00:00,86,80,6,ECO_300019380
642,Herenthoutsesteenweg 2,2021-10-05,19:00:00,65,54,11,ECO_300019380
642,Herenthoutsesteenweg 2,2021-10-05,20:00:00,44,40,4,ECO_300019380
642,Herenthoutsesteenweg 2,2021-10-05,21:00:00,14,14,0,ECO_300019380
642,Herenthoutsesteenweg 2,2021-10-05,22:00:00,17,16,1,ECO_300019380
642,Herenthoutsesteenweg 2,2021-10-05,23:00:00,7,5,2,ECO_300019380
642,Herenthoutsesteenweg 2,2021-10-06,00:00:00,8,7,1,ECO_300019380
642,Herenthoutsesteenweg 2,2021-10-06,01:00:00,3,2,1,ECO_300019380
642,Herenthoutsesteenweg 2,2021-10-06,02:00:00,1,1,0,ECO_300019380
642,Herenthoutsesteenweg 2,2021-10-06,03:00:00,1,1,0,ECO_300019380
642,Herenthoutsesteenweg 2,2021-10-06,04:00:00,1,1,0,ECO_300019380
642,Herenthoutsesteenweg 2,2021-10-06,05:00:00,0,0,0,ECO_300019380
642,Herenthoutsesteenweg 2,2021-10-06,06:00:00,2,2,0,ECO_300019380
642,Herenthoutsesteenweg 2,2021-10-06,07:00:00,14,14,0,ECO_300019380
642,Herenthoutsesteenweg 2,2021-10-06,08:00:00,22,19,3,ECO_300019380
642,Herenthoutsesteenweg 2,2021-10-06,09:00:00,83,80,3,ECO_300019380
642,Herenthoutsesteenweg 2,2021-10-06,10:00:00,313,307,6,ECO_300019380
642,Herenthoutsesteenweg 2,2021-10-06,11:00:00,31,30,1,ECO_300019380
642,Herenthoutsesteenweg 2,2021-10-06,12:00:00,18,17,1,ECO_300019380
642,Herenthoutsesteenweg 2,2021-10-06,13:00:00,10,10,0,ECO_300019380
642,Herenthoutsesteenweg 2,2021-10-06,14:00:00,46,41,5,ECO_300019380
642,Herenthoutsesteenweg 2,2021-10-06,15:00:00,46,41,5,ECO_300019380
642,Herenthoutsesteenweg 2,2021-10-06,16:00:00,46,40,6,ECO_300019380
642,Herenthoutsesteenweg 2,2021-10-06,17:00:00,34,32,2,ECO_300019380
642,Herenthoutsesteenweg 2,2021-10-06,18:00:00,65,60,5,ECO_300019380
642,Herenthoutsesteenweg 2,2021-10-06,19:00:00,25,20,5,ECO_300019380
642,Herenthoutsesteenweg 2,2021-10-06,20:00:00,24,21,3,ECO_300019380
642,Herenthoutsesteenweg 2,2021-10-06,21:00:00,37,34,3,ECO_300019380
642,Herenthoutsesteenweg 2,2021-10-06,22:00:00,12,11,1,ECO_300019380
642,Herenthoutsesteenweg 2,2021-10-06,23:00:00,16,15,1,ECO_300019380
642,Herenthoutsesteenweg 2,2021-10-07,00:00:00,9,7,2,ECO_300019380
642,Herenthoutsesteenweg 2,2021-10-07,01:00:00,1,1,0,ECO_300019380
642,Herenthoutsesteenweg 2,2021-10-07,02:00:00,2,2,0,ECO_300019380
642,Herenthoutsesteenweg 2,2021-10-07,03:00:00,3,3,0,ECO_300019380
642,Herenthoutsesteenweg 2,2021-10-07,04:00:00,0,0,0,ECO_300019380
642,Herenthoutsesteenweg 2,2021-10-07,05:00:00,0,0,0,ECO_300019380
642,Herenthoutsesteenweg 2,2021-10-07,06:00:00,3,3,0,ECO_300019380
642,Herenthoutsesteenweg 2,2021-10-07,07:00:00,12,10,2,ECO_300019380
642,Herenthoutsesteenweg 2,2021-10-07,08:00:00,37,33,4,ECO_300019380
642,Herenthoutsesteenweg 2,2021-10-07,09:00:00,180,174,6,ECO_300019380
642,Herenthoutsesteenweg 2,2021-10-07,10:00:00,625,616,9,ECO_300019380
642,Herenthoutsesteenweg 2,2021-10-07,11:00:00,45,44,1,ECO_300019380
642,Herenthoutsesteenweg 2,2021-10-07,12:00:00,57,53,4,ECO_300019380
642,Herenthoutsesteenweg 2,2021-10-07,13:00:00,60,57,3,ECO_300019380
642,Herenthoutsesteenweg 2,2021-10-07,14:00:00,65,61,4,ECO_300019380
642,Herenthoutsesteenweg 2,2021-10-07,15:00:00,104,102,2,ECO_300019380
642,Herenthoutsesteenweg 2,2021-10-07,16:00:00,92,80,12,ECO_300019380
642,Herenthoutsesteenweg 2,2021-10-07,17:00:00,132,126,6,ECO_300019380
642,Herenthoutsesteenweg 2,2021-10-07,18:00:00,122,119,3,ECO_300019380
642,Herenthoutsesteenweg 2,2021-10-07,19:00:00,75,73,2,ECO_300019380
642,Herenthoutsesteenweg 2,2021-10-07,20:00:00,56,52,4,ECO_300019380
642,Herenthoutsesteenweg 2,2021-10-07,21:00:00,37,33,4,ECO_300019380
642,Herenthoutsesteenweg 2,2021-10-07,22:00:00,32,29,3,ECO_300019380
642,Herenthoutsesteenweg 2,2021-10-07,23:00:00,14,13,1,ECO_300019380
642,Herenthoutsesteenweg 2,2021-10-08,00:00:00,18,16,2,ECO_300019380
642,Herenthoutsesteenweg 2,2021-10-08,01:00:00,5,4,1,ECO_300019380
642,Herenthoutsesteenweg 2,2021-10-08,02:00:00,1,0,1,ECO_300019380
642,Herenthoutsesteenweg 2,2021-10-08,03:00:00,2,2,0,ECO_300019380
642,Herenthoutsesteenweg 2,2021-10-08,04:00:00,3,1,2,ECO_300019380
642,Herenthoutsesteenweg 2,2021-10-08,05:00:00,0,0,0,ECO_300019380
642,Herenthoutsesteenweg 2,2021-10-08,06:00:00,2,2,0,ECO_300019380
642,Herenthoutsesteenweg 2,2021-10-08,07:00:00,16,14,2,ECO_300019380
642,Herenthoutsesteenweg 2,2021-10-08,08:00:00,33,32,1,ECO_300019380
642,Herenthoutsesteenweg 2,2021-10-08,09:00:00,161,157,4,ECO_300019380
642,Herenthoutsesteenweg 2,2021-10-08,10:00:00,653,641,12,ECO_300019380
642,Herenthoutsesteenweg 2,2021-10-08,11:00:00,90,88,2,ECO_300019380
642,Herenthoutsesteenweg 2,2021-10-08,12:00:00,79,75,4,ECO_300019380
642,Herenthoutsesteenweg 2,2021-10-08,13:00:00,53,49,4,ECO_300019380
642,Herenthoutsesteenweg 2,2021-10-08,14:00:00,89,85,4,ECO_300019380
642,Herenthoutsesteenweg 2,2021-10-08,15:00:00,152,146,6,ECO_300019380
642,Herenthoutsesteenweg 2,2021-10-08,16:00:00,113,104,9,ECO_300019380
642,Herenthoutsesteenweg 2,2021-10-08,17:00:00,185,173,12,ECO_300019380
642,Herenthoutsesteenweg 2,2021-10-08,18:00:00,159,139,20,ECO_300019380
642,Herenthoutsesteenweg 2,2021-10-08,19:00:00,87,81,6,ECO_300019380
642,Herenthoutsesteenweg 2,2021-10-08,20:00:00,84,78,6,ECO_300019380
642,Herenthoutsesteenweg 2,2021-10-08,21:00:00,48,47,1,ECO_300019380
642,Herenthoutsesteenweg 2,2021-10-08,22:00:00,25,23,2,ECO_300019380
642,Herenthoutsesteenweg 2,2021-10-08,23:00:00,19,15,4,ECO_300019380
642,Herenthoutsesteenweg 2,2021-10-09,00:00:00,13,12,1,ECO_300019380
642,Herenthoutsesteenweg 2,2021-10-09,01:00:00,6,4,2,ECO_300019380
642,Herenthoutsesteenweg 2,2021-10-09,02:00:00,7,7,0,ECO_300019380
642,Herenthoutsesteenweg 2,2021-10-09,03:00:00,3,1,2,ECO_300019380
642,Herenthoutsesteenweg 2,2021-10-09,04:00:00,0,0,0,ECO_300019380
642,Herenthoutsesteenweg 2,2021-10-09,05:00:00,3,3,0,ECO_300019380
642,Herenthoutsesteenweg 2,2021-10-09,06:00:00,0,0,0,ECO_300019380
642,Herenthoutsesteenweg 2,2021-10-09,07:00:00,4,4,0,ECO_300019380
642,Herenthoutsesteenweg 2,2021-10-09,08:00:00,7,6,1,ECO_300019380
642,Herenthoutsesteenweg 2,2021-10-09,09:00:00,8,7,1,ECO_300019380
642,Herenthoutsesteenweg 2,2021-10-09,10:00:00,40,37,3,ECO_300019380
642,Herenthoutsesteenweg 2,2021-10-09,11:00:00,70,70,0,ECO_300019380
642,Herenthoutsesteenweg 2,2021-10-09,12:00:00,73,71,2,ECO_300019380
642,Herenthoutsesteenweg 2,2021-10-09,13:00:00,118,106,12,ECO_300019380
642,Herenthoutsesteenweg 2,2021-10-09,14:00:00,129,114,15,ECO_300019380
642,Herenthoutsesteenweg 2,2021-10-09,15:00:00,198,188,10,ECO_300019380
642,Herenthoutsesteenweg 2,2021-10-09,16:00:00,181,163,18,ECO_300019380
642,Herenthoutsesteenweg 2,2021-10-09,17:00:00,156,137,19,ECO_300019380
642,Herenthoutsesteenweg 2,2021-10-09,18:00:00,104,91,13,ECO_300019380
642,Herenthoutsesteenweg 2,2021-10-09,19:00:00,77,70,7,ECO_300019380
642,Herenthoutsesteenweg 2,2021-10-09,20:00:00,47,42,5,ECO_300019380
642,Herenthoutsesteenweg 2,2021-10-09,21:00:00,50,43,7,ECO_300019380
642,Herenthoutsesteenweg 2,2021-10-09,22:00:00,24,22,2,ECO_300019380
642,Herenthoutsesteenweg 2,2021-10-09,23:00:00,16,12,4,ECO_300019380
642,Herenthoutsesteenweg 2,2021-10-10,00:00:00,9,9,0,ECO_300019380
642,Herenthoutsesteenweg 2,2021-10-10,01:00:00,7,4,3,ECO_300019380
642,Herenthoutsesteenweg 2,2021-10-10,02:00:00,5,5,0,ECO_300019380
642,Herenthoutsesteenweg 2,2021-10-10,03:00:00,5,4,1,ECO_300019380
642,Herenthoutsesteenweg 2,2021-10-10,04:00:00,1,1,0,ECO_300019380
642,Herenthoutsesteenweg 2,2021-10-10,05:00:00,1,0,1,ECO_300019380
642,Herenthoutsesteenweg 2,2021-10-10,06:00:00,2,1,1,ECO_300019380
642,Herenthoutsesteenweg 2,2021-10-10,07:00:00,6,6,0,ECO_300019380
642,Herenthoutsesteenweg 2,2021-10-10,08:00:00,5,5,0,ECO_300019380
642,Herenthoutsesteenweg 2,2021-10-10,09:00:00,11,10,1,ECO_300019380
642,Herenthoutsesteenweg 2,2021-10-10,10:00:00,52,45,7,ECO_300019380
642,Herenthoutsesteenweg 2,2021-10-10,11:00:00,90,81,9,ECO_300019380
642,Herenthoutsesteenweg 2,2021-10-10,12:00:00,76,68,8,ECO_300019380
642,Herenthoutsesteenweg 2,2021-10-10,13:00:00,69,52,17,ECO_300019380
642,Herenthoutsesteenweg 2,2021-10-10,14:00:00,61,58,3,ECO_300019380
642,Herenthoutsesteenweg 2,2021-10-10,15:00:00,94,83,11,ECO_300019380
642,Herenthoutsesteenweg 2,2021-10-10,16:00:00,135,120,15,ECO_300019380
642,Herenthoutsesteenweg 2,2021-10-10,17:00:00,102,94,8,ECO_300019380
642,Herenthoutsesteenweg 2,2021-10-10,18:00:00,88,82,6,ECO_300019380
642,Herenthoutsesteenweg 2,2021-10-10,19:00:00,44,41,3,ECO_300019380
642,Herenthoutsesteenweg 2,2021-10-10,20:00:00,39,35,4,ECO_300019380
642,Herenthoutsesteenweg 2,2021-10-10,21:00:00,17,13,4,ECO_300019380
642,Herenthoutsesteenweg 2,2021-10-10,22:00:00,7,7,0,ECO_300019380
642,Herenthoutsesteenweg 2,2021-10-10,23:00:00,4,4,0,ECO_300019380
642,Herenthoutsesteenweg 2,2021-10-11,00:00:00,8,7,1,ECO_300019380
642,Herenthoutsesteenweg 2,2021-10-11,01:00:00,3,3,0,ECO_300019380
642,Herenthoutsesteenweg 2,2021-10-11,02:00:00,0,0,0,ECO_300019380
642,Herenthoutsesteenweg 2,2021-10-11,03:00:00,3,1,2,ECO_300019380
642,Herenthoutsesteenweg 2,2021-10-11,04:00:00,2,1,1,ECO_300019380
642,Herenthoutsesteenweg 2,2021-10-11,05:00:00,0,0,0,ECO_300019380
642,Herenthoutsesteenweg 2,2021-10-11,06:00:00,2,2,0,ECO_300019380
642,Herenthoutsesteenweg 2,2021-10-11,07:00:00,15,13,2,ECO_300019380
642,Herenthoutsesteenweg 2,2021-10-11,08:00:00,44,39,5,ECO_300019380
642,Herenthoutsesteenweg 2,2021-10-11,09:00:00,189,181,8,ECO_300019380
642,Herenthoutsesteenweg 2,2021-10-11,10:00:00,609,601,8,ECO_300019380
642,Herenthoutsesteenweg 2,2021-10-11,11:00:00,76,73,3,ECO_300019380
642,Herenthoutsesteenweg 2,2021-10-11,12:00:00,56,52,4,ECO_300019380
642,Herenthoutsesteenweg 2,2021-10-11,13:00:00,44,40,4,ECO_300019380
642,Herenthoutsesteenweg 2,2021-10-11,14:00:00,51,48,3,ECO_300019380
642,Herenthoutsesteenweg 2,2021-10-11,15:00:00,103,97,6,ECO_300019380
642,Herenthoutsesteenweg 2,2021-10-11,16:00:00,93,89,4,ECO_300019380
642,Herenthoutsesteenweg 2,2021-10-11,17:00:00,98,91,7,ECO_300019380
642,Herenthoutsesteenweg 2,2021-10-11,18:00:00,132,120,12,ECO_300019380
642,Herenthoutsesteenweg 2,2021-10-11,19:00:00,85,77,8,ECO_300019380
642,Herenthoutsesteenweg 2,2021-10-11,20:00:00,49,45,4,ECO_300019380
642,Herenthoutsesteenweg 2,2021-10-11,21:00:00,25,23,2,ECO_300019380
642,Herenthoutsesteenweg 2,2021-10-11,22:00:00,16,13,3,ECO_300019380
642,Herenthoutsesteenweg 2,2021-10-11,23:00:00,9,8,1,ECO_300019380
642,Herenthoutsesteenweg 2,2021-10-12,00:00:00,12,8,4,ECO_300019380
642,Herenthoutsesteenweg 2,2021-10-12,01:00:00,3,2,1,ECO_300019380
642,Herenthoutsesteenweg 2,2021-10-12,02:00:00,1,1,0,ECO_300019380
642,Herenthoutsesteenweg 2,2021-10-12,03:00:00,0,0,0,ECO_300019380
642,Herenthoutsesteenweg 2,2021-10-12,04:00:00,0,0,0,ECO_300019380
642,Herenthoutsesteenweg 2,2021-10-12,05:00:00,0,0,0,ECO_300019380
642,Herenthoutsesteenweg 2,2021-10-12,06:00:00,4,4,0,ECO_300019380
642,Herenthoutsesteenweg 2,2021-10-12,07:00:00,11,9,2,ECO_300019380
642,Herenthoutsesteenweg 2,2021-10-12,08:00:00,36,35,1,ECO_300019380
642,Herenthoutsesteenweg 2,2021-10-12,09:00:00,160,151,9,ECO_300019380
642,Herenthoutsesteenweg 2,2021-10-12,10:00:00,511,495,16,ECO_300019380
642,Herenthoutsesteenweg 2,2021-10-12,11:00:00,101,98,3,ECO_300019380
642,Herenthoutsesteenweg 2,2021-10-12,12:00:00,23,23,0,ECO_300019380
642,Herenthoutsesteenweg 2,2021-10-12,13:00:00,11,9,2,ECO_300019380
642,Herenthoutsesteenweg 2,2021-10-12,14:00:00,27,26,1,ECO_300019380
642,Herenthoutsesteenweg 2,2021-10-12,15:00:00,33,32,1,ECO_300019380
642,Herenthoutsesteenweg 2,2021-10-12,16:00:00,25,23,2,ECO_300019380
642,Herenthoutsesteenweg 2,2021-10-12,17:00:00,35,30,5,ECO_300019380
642,Herenthoutsesteenweg 2,2021-10-12,18:00:00,88,81,7,ECO_300019380
642,Herenthoutsesteenweg 2,2021-10-12,19:00:00,51,51,0,ECO_300019380
642,Herenthoutsesteenweg 2,2021-10-12,20:00:00,25,23,2,ECO_300019380
642,Herenthoutsesteenweg 2,2021-10-12,21:00:00,25,23,2,ECO_300019380
642,Herenthoutsesteenweg 2,2021-10-12,22:00:00,18,17,1,ECO_300019380
642,Herenthoutsesteenweg 2,2021-10-12,23:00:00,6,5,1,ECO_300019380
642,Herenthoutsesteenweg 2,2021-10-13,00:00:00,5,4,1,ECO_300019380
642,Herenthoutsesteenweg 2,2021-10-13,01:00:00,3,2,1,ECO_300019380
642,Herenthoutsesteenweg 2,2021-10-13,02:00:00,2,2,0,ECO_300019380
642,Herenthoutsesteenweg 2,2021-10-13,03:00:00,1,0,1,ECO_300019380
642,Herenthoutsesteenweg 2,2021-10-13,04:00:00,1,1,0,ECO_300019380
642,Herenthoutsesteenweg 2,2021-10-13,05:00:00,0,0,0,ECO_300019380
642,Herenthoutsesteenweg 2,2021-10-13,06:00:00,3,3,0,ECO_300019380
642,Herenthoutsesteenweg 2,2021-10-13,07:00:00,16,12,4,ECO_300019380
642,Herenthoutsesteenweg 2,2021-10-13,08:00:00,44,43,1,ECO_300019380
642,Herenthoutsesteenweg 2,2021-10-13,09:00:00,140,132,8,ECO_300019380
642,Herenthoutsesteenweg 2,2021-10-13,10:00:00,462,454,8,ECO_300019380
642,Herenthoutsesteenweg 2,2021-10-13,11:00:00,81,78,3,ECO_300019380
642,Herenthoutsesteenweg 2,2021-10-13,12:00:00,62,61,1,ECO_300019380
642,Herenthoutsesteenweg 2,2021-10-13,13:00:00,51,46,5,ECO_300019380
642,Herenthoutsesteenweg 2,2021-10-13,14:00:00,115,110,5,ECO_300019380
642,Herenthoutsesteenweg 2,2021-10-13,15:00:00,98,82,16,ECO_300019380
642,Herenthoutsesteenweg 2,2021-10-13,16:00:00,89,79,10,ECO_300019380
642,Herenthoutsesteenweg 2,2021-10-13,17:00:00,76,68,8,ECO_300019380
642,Herenthoutsesteenweg 2,2021-10-13,18:00:00,103,94,9,ECO_300019380
642,Herenthoutsesteenweg 2,2021-10-13,19:00:00,82,75,7,ECO_300019380
642,Herenthoutsesteenweg 2,2021-10-13,20:00:00,43,39,4,ECO_300019380
642,Herenthoutsesteenweg 2,2021-10-13,21:00:00,52,47,5,ECO_300019380
642,Herenthoutsesteenweg 2,2021-10-13,22:00:00,23,20,3,ECO_300019380
642,Herenthoutsesteenweg 2,2021-10-13,23:00:00,12,9,3,ECO_300019380
642,Herenthoutsesteenweg 2,2021-10-14,00:00:00,12,8,4,ECO_300019380
642,Herenthoutsesteenweg 2,2021-10-14,01:00:00,0,0,0,ECO_300019380
642,Herenthoutsesteenweg 2,2021-10-14,02:00:00,1,1,0,ECO_300019380
642,Herenthoutsesteenweg 2,2021-10-14,03:00:00,2,2,0,ECO_300019380
642,Herenthoutsesteenweg 2,2021-10-14,04:00:00,1,0,1,ECO_300019380
642,Herenthoutsesteenweg 2,2021-10-14,05:00:00,0,0,0,ECO_300019380
642,Herenthoutsesteenweg 2,2021-10-14,06:00:00,4,4,0,ECO_300019380
642,Herenthoutsesteenweg 2,2021-10-14,07:00:00,19,16,3,ECO_300019380
642,Herenthoutsesteenweg 2,2021-10-14,08:00:00,39,38,1,ECO_300019380
642,Herenthoutsesteenweg 2,2021-10-14,09:00:00,150,148,2,ECO_300019380
642,Herenthoutsesteenweg 2,2021-10-14,10:00:00,469,462,7,ECO_300019380
642,Herenthoutsesteenweg 2,2021-10-14,11:00:00,79,78,1,ECO_300019380
642,Herenthoutsesteenweg 2,2021-10-14,12:00:00,51,50,1,ECO_300019380
642,Herenthoutsesteenweg 2,2021-10-14,13:00:00,50,46,4,ECO_300019380
642,Herenthoutsesteenweg 2,2021-10-14,14:00:00,224,213,11,ECO_300019380
642,Herenthoutsesteenweg 2,2021-10-14,15:00:00,98,91,7,ECO_300019380
642,Herenthoutsesteenweg 2,2021-10-14,16:00:00,104,89,15,ECO_300019380
642,Herenthoutsesteenweg 2,2021-10-14,17:00:00,134,126,8,ECO_300019380
642,Herenthoutsesteenweg 2,2021-10-14,18:00:00,140,128,12,ECO_300019380
642,Herenthoutsesteenweg 2,2021-10-14,19:00:00,96,87,9,ECO_300019380
642,Herenthoutsesteenweg 2,2021-10-14,20:00:00,50,42,8,ECO_300019380
642,Herenthoutsesteenweg 2,2021-10-14,21:00:00,36,28,8,ECO_300019380
642,Herenthoutsesteenweg 2,2021-10-14,22:00:00,20,17,3,ECO_300019380
642,Herenthoutsesteenweg 2,2021-10-14,23:00:00,10,8,2,ECO_300019380
642,Herenthoutsesteenweg 2,2021-10-15,00:00:00,13,10,3,ECO_300019380
642,Herenthoutsesteenweg 2,2021-10-15,01:00:00,3,2,1,ECO_300019380
642,Herenthoutsesteenweg 2,2021-10-15,02:00:00,1,0,1,ECO_300019380
642,Herenthoutsesteenweg 2,2021-10-15,03:00:00,1,1,0,ECO_300019380
642,Herenthoutsesteenweg 2,2021-10-15,04:00:00,2,1,1,ECO_300019380
642,Herenthoutsesteenweg 2,2021-10-15,05:00:00,0,0,0,ECO_300019380
642,Herenthoutsesteenweg 2,2021-10-15,06:00:00,2,2,0,ECO_300019380
642,Herenthoutsesteenweg 2,2021-10-15,07:00:00,15,13,2,ECO_300019380
642,Herenthoutsesteenweg 2,2021-10-15,08:00:00,33,29,4,ECO_300019380
642,Herenthoutsesteenweg 2,2021-10-15,09:00:00,168,166,2,ECO_300019380
642,Herenthoutsesteenweg 2,2021-10-15,10:00:00,569,559,10,ECO_300019380
642,Herenthoutsesteenweg 2,2021-10-15,11:00:00,104,99,5,ECO_300019380
642,Herenthoutsesteenweg 2,2021-10-15,12:00:00,46,41,5,ECO_300019380
642,Herenthoutsesteenweg 2,2021-10-15,13:00:00,19,18,1,ECO_300019380
642,Herenthoutsesteenweg 2,2021-10-15,14:00:00,24,24,0,ECO_300019380
642,Herenthoutsesteenweg 2,2021-10-15,15:00:00,65,63,2,ECO_300019380
642,Herenthoutsesteenweg 2,2021-10-15,16:00:00,70,57,13,ECO_300019380
642,Herenthoutsesteenweg 2,2021-10-15,17:00:00,133,108,25,ECO_300019380
642,Herenthoutsesteenweg 2,2021-10-15,18:00:00,102,92,10,ECO_300019380
642,Herenthoutsesteenweg 2,2021-10-15,19:00:00,74,71,3,ECO_300019380
642,Herenthoutsesteenweg 2,2021-10-15,20:00:00,50,47,3,ECO_300019380
642,Herenthoutsesteenweg 2,2021-10-15,21:00:00,39,34,5,ECO_300019380
642,Herenthoutsesteenweg 2,2021-10-15,22:00:00,36,34,2,ECO_300019380
642,Herenthoutsesteenweg 2,2021-10-15,23:00:00,13,11,2,ECO_300019380
642,Herenthoutsesteenweg 2,2021-10-16,00:00:00,15,13,2,ECO_300019380
642,Herenthoutsesteenweg 2,2021-10-16,01:00:00,7,5,2,ECO_300019380
642,Herenthoutsesteenweg 2,2021-10-16,02:00:00,6,6,0,ECO_300019380
642,Herenthoutsesteenweg 2,2021-10-16,03:00:00,4,2,2,ECO_300019380
642,Herenthoutsesteenweg 2,2021-10-16,04:00:00,4,3,1,ECO_300019380
642,Herenthoutsesteenweg 2,2021-10-16,05:00:00,4,2,2,ECO_300019380
642,Herenthoutsesteenweg 2,2021-10-16,06:00:00,2,2,0,ECO_300019380
642,Herenthoutsesteenweg 2,2021-10-16,07:00:00,4,4,0,ECO_300019380
642,Herenthoutsesteenweg 2,2021-10-16,08:00:00,6,6,0,ECO_300019380
642,Herenthoutsesteenweg 2,2021-10-16,09:00:00,10,10,0,ECO_300019380
642,Herenthoutsesteenweg 2,2021-10-16,10:00:00,35,35,0,ECO_300019380
642,Herenthoutsesteenweg 2,2021-10-16,11:00:00,73,66,7,ECO_300019380
642,Herenthoutsesteenweg 2,2021-10-16,12:00:00,74,65,9,ECO_300019380
642,Herenthoutsesteenweg 2,2021-10-16,13:00:00,72,67,5,ECO_300019380
642,Herenthoutsesteenweg 2,2021-10-16,14:00:00,89,81,8,ECO_300019380
642,Herenthoutsesteenweg 2,2021-10-16,15:00:00,162,153,9,ECO_300019380
642,Herenthoutsesteenweg 2,2021-10-16,16:00:00,157,151,6,ECO_300019380
642,Herenthoutsesteenweg 2,2021-10-16,17:00:00,120,95,25,ECO_300019380
642,Herenthoutsesteenweg 2,2021-10-16,18:00:00,96,84,12,ECO_300019380
642,Herenthoutsesteenweg 2,2021-10-16,19:00:00,79,73,6,ECO_300019380
642,Herenthoutsesteenweg 2,2021-10-16,20:00:00,44,36,8,ECO_300019380
642,Herenthoutsesteenweg 2,2021-10-16,21:00:00,49,42,7,ECO_300019380
642,Herenthoutsesteenweg 2,2021-10-16,22:00:00,25,22,3,ECO_300019380
642,Herenthoutsesteenweg 2,2021-10-16,23:00:00,8,8,0,ECO_300019380
642,Herenthoutsesteenweg 2,2021-10-17,00:00:00,10,9,1,ECO_300019380
642,Herenthoutsesteenweg 2,2021-10-17,01:00:00,3,1,2,ECO_300019380
642,Herenthoutsesteenweg 2,2021-10-17,02:00:00,6,4,2,ECO_300019380
642,Herenthoutsesteenweg 2,2021-10-17,03:00:00,5,5,0,ECO_300019380
642,Herenthoutsesteenweg 2,2021-10-17,04:00:00,1,0,1,ECO_300019380
642,Herenthoutsesteenweg 2,2021-10-17,05:00:00,4,4,0,ECO_300019380
642,Herenthoutsesteenweg 2,2021-10-17,06:00:00,2,1,1,ECO_300019380
642,Herenthoutsesteenweg 2,2021-10-17,07:00:00,3,3,0,ECO_300019380
642,Herenthoutsesteenweg 2,2021-10-17,08:00:00,8,8,0,ECO_300019380
642,Herenthoutsesteenweg 2,2021-10-17,09:00:00,8,8,0,ECO_300019380
642,Herenthoutsesteenweg 2,2021-10-17,10:00:00,45,42,3,ECO_300019380
642,Herenthoutsesteenweg 2,2021-10-17,11:00:00,108,101,7,ECO_300019380
642,Herenthoutsesteenweg 2,2021-10-17,12:00:00,114,102,12,ECO_300019380
642,Herenthoutsesteenweg 2,2021-10-17,13:00:00,98,80,18,ECO_300019380
642,Herenthoutsesteenweg 2,2021-10-17,14:00:00,68,56,12,ECO_300019380
642,Herenthoutsesteenweg 2,2021-10-17,15:00:00,90,89,1,ECO_300019380
642,Herenthoutsesteenweg 2,2021-10-17,16:00:00,101,90,11,ECO_300019380
642,Herenthoutsesteenweg 2,2021-10-17,17:00:00,88,77,11,ECO_300019380
642,Herenthoutsesteenweg 2,2021-10-17,18:00:00,87,79,8,ECO_300019380
642,Herenthoutsesteenweg 2,2021-10-17,19:00:00,46,44,2,ECO_300019380
642,Herenthoutsesteenweg 2,2021-10-17,20:00:00,29,26,3,ECO_300019380
642,Herenthoutsesteenweg 2,2021-10-17,21:00:00,26,19,7,ECO_300019380
642,Herenthoutsesteenweg 2,2021-10-17,22:00:00,16,12,4,ECO_300019380
642,Herenthoutsesteenweg 2,2021-10-17,23:00:00,9,7,2,ECO_300019380
642,Herenthoutsesteenweg 2,2021-10-18,00:00:00,4,3,1,ECO_300019380
642,Herenthoutsesteenweg 2,2021-10-18,01:00:00,3,3,0,ECO_300019380
642,Herenthoutsesteenweg 2,2021-10-18,02:00:00,2,2,0,ECO_300019380
642,Herenthoutsesteenweg 2,2021-10-18,03:00:00,1,0,1,ECO_300019380
642,Herenthoutsesteenweg 2,2021-10-18,04:00:00,0,0,0,ECO_300019380
642,Herenthoutsesteenweg 2,2021-10-18,05:00:00,0,0,0,ECO_300019380
642,Herenthoutsesteenweg 2,2021-10-18,06:00:00,1,1,0,ECO_300019380
642,Herenthoutsesteenweg 2,2021-10-18,07:00:00,19,19,0,ECO_300019380
642,Herenthoutsesteenweg 2,2021-10-18,08:00:00,43,40,3,ECO_300019380
642,Herenthoutsesteenweg 2,2021-10-18,09:00:00,154,150,4,ECO_300019380
642,Herenthoutsesteenweg 2,2021-10-18,10:00:00,569,564,5,ECO_300019380
642,Herenthoutsesteenweg 2,2021-10-18,11:00:00,85,82,3,ECO_300019380
642,Herenthoutsesteenweg 2,2021-10-18,12:00:00,74,71,3,ECO_300019380
642,Herenthoutsesteenweg 2,2021-10-18,13:00:00,66,62,4,ECO_300019380
642,Herenthoutsesteenweg 2,2021-10-18,14:00:00,52,50,2,ECO_300019380
642,Herenthoutsesteenweg 2,2021-10-18,15:00:00,129,120,9,ECO_300019380
642,Herenthoutsesteenweg 2,2021-10-18,16:00:00,105,96,9,ECO_300019380
642,Herenthoutsesteenweg 2,2021-10-18,17:00:00,125,109,16,ECO_300019380
642,Herenthoutsesteenweg 2,2021-10-18,18:00:00,124,116,8,ECO_300019380
642,Herenthoutsesteenweg 2,2021-10-18,19:00:00,88,80,8,ECO_300019380
642,Herenthoutsesteenweg 2,2021-10-18,20:00:00,40,35,5,ECO_300019380
642,Herenthoutsesteenweg 2,2021-10-18,21:00:00,37,31,6,ECO_300019380
642,Herenthoutsesteenweg 2,2021-10-18,22:00:00,14,12,2,ECO_300019380
642,Herenthoutsesteenweg 2,2021-10-18,23:00:00,6,6,0,ECO_300019380
642,Herenthoutsesteenweg 2,2021-10-19,00:00:00,16,15,1,ECO_300019380
642,Herenthoutsesteenweg 2,2021-10-19,01:00:00,2,1,1,ECO_300019380
642,Herenthoutsesteenweg 2,2021-10-19,02:00:00,0,0,0,ECO_300019380
642,Herenthoutsesteenweg 2,2021-10-19,03:00:00,1,0,1,ECO_300019380
642,Herenthoutsesteenweg 2,2021-10-19,04:00:00,2,2,0,ECO_300019380
642,Herenthoutsesteenweg 2,2021-10-19,05:00:00,0,0,0,ECO_300019380
642,Herenthoutsesteenweg 2,2021-10-19,06:00:00,3,3,0,ECO_300019380
642,Herenthoutsesteenweg 2,2021-10-19,07:00:00,18,15,3,ECO_300019380
642,Herenthoutsesteenweg 2,2021-10-19,08:00:00,36,33,3,ECO_300019380
642,Herenthoutsesteenweg 2,2021-10-19,09:00:00,142,137,5,ECO_300019380
642,Herenthoutsesteenweg 2,2021-10-19,10:00:00,419,411,8,ECO_300019380
642,Herenthoutsesteenweg 2,2021-10-19,11:00:00,89,88,1,ECO_300019380
642,Herenthoutsesteenweg 2,2021-10-19,12:00:00,58,56,2,ECO_300019380
642,Herenthoutsesteenweg 2,2021-10-19,13:00:00,29,25,4,ECO_300019380
642,Herenthoutsesteenweg 2,2021-10-19,14:00:00,55,53,2,ECO_300019380
642,Herenthoutsesteenweg 2,2021-10-19,15:00:00,109,102,7,ECO_300019380
642,Herenthoutsesteenweg 2,2021-10-19,16:00:00,62,59,3,ECO_300019380
642,Herenthoutsesteenweg 2,2021-10-19,17:00:00,104,99,5,ECO_300019380
642,Herenthoutsesteenweg 2,2021-10-19,18:00:00,101,95,6,ECO_300019380
642,Herenthoutsesteenweg 2,2021-10-19,19:00:00,67,60,7,ECO_300019380
642,Herenthoutsesteenweg 2,2021-10-19,20:00:00,38,33,5,ECO_300019380
642,Herenthoutsesteenweg 2,2021-10-19,21:00:00,28,27,1,ECO_300019380
642,Herenthoutsesteenweg 2,2021-10-19,22:00:00,19,18,1,ECO_300019380
642,Herenthoutsesteenweg 2,2021-10-19,23:00:00,15,12,3,ECO_300019380
642,Herenthoutsesteenweg 2,2021-10-20,00:00:00,17,15,2,ECO_300019380
642,Herenthoutsesteenweg 2,2021-10-20,01:00:00,2,1,1,ECO_300019380
642,Herenthoutsesteenweg 2,2021-10-20,02:00:00,2,2,0,ECO_300019380
642,Herenthoutsesteenweg 2,2021-10-20,03:00:00,2,1,1,ECO_300019380
642,Herenthoutsesteenweg 2,2021-10-20,04:00:00,0,0,0,ECO_300019380
642,Herenthoutsesteenweg 2,2021-10-20,05:00:00,0,0,0,ECO_300019380
642,Herenthoutsesteenweg 2,2021-10-20,06:00:00,2,2,0,ECO_300019380
642,Herenthoutsesteenweg 2,2021-10-20,07:00:00,16,15,1,ECO_300019380
642,Herenthoutsesteenweg 2,2021-10-20,08:00:00,37,33,4,ECO_300019380
642,Herenthoutsesteenweg 2,2021-10-20,09:00:00,142,136,6,ECO_300019380
642,Herenthoutsesteenweg 2,2021-10-20,10:00:00,479,470,9,ECO_300019380
642,Herenthoutsesteenweg 2,2021-10-20,11:00:00,71,68,3,ECO_300019380
642,Herenthoutsesteenweg 2,2021-10-20,12:00:00,31,29,2,ECO_300019380
642,Herenthoutsesteenweg 2,2021-10-20,13:00:00,37,33,4,ECO_300019380
642,Herenthoutsesteenweg 2,2021-10-20,14:00:00,83,78,5,ECO_300019380
642,Herenthoutsesteenweg 2,2021-10-20,15:00:00,77,74,3,ECO_300019380
642,Herenthoutsesteenweg 2,2021-10-20,16:00:00,65,61,4,ECO_300019380
642,Herenthoutsesteenweg 2,2021-10-20,17:00:00,50,43,7,ECO_300019380
642,Herenthoutsesteenweg 2,2021-10-20,18:00:00,93,86,7,ECO_300019380
642,Herenthoutsesteenweg 2,2021-10-20,19:00:00,71,62,9,ECO_300019380
642,Herenthoutsesteenweg 2,2021-10-20,20:00:00,33,29,4,ECO_300019380
642,Herenthoutsesteenweg 2,2021-10-20,21:00:00,19,17,2,ECO_300019380
642,Herenthoutsesteenweg 2,2021-10-20,22:00:00,19,18,1,ECO_300019380
642,Herenthoutsesteenweg 2,2021-10-20,23:00:00,6,5,1,ECO_300019380
642,Herenthoutsesteenweg 2,2021-10-21,00:00:00,9,7,2,ECO_300019380
642,Herenthoutsesteenweg 2,2021-10-21,01:00:00,6,4,2,ECO_300019380
642,Herenthoutsesteenweg 2,2021-10-21,02:00:00,3,2,1,ECO_300019380
642,Herenthoutsesteenweg 2,2021-10-21,03:00:00,1,1,0,ECO_300019380
642,Herenthoutsesteenweg 2,2021-10-21,04:00:00,1,1,0,ECO_300019380
642,Herenthoutsesteenweg 2,2021-10-21,05:00:00,0,0,0,ECO_300019380
642,Herenthoutsesteenweg 2,2021-10-21,06:00:00,2,2,0,ECO_300019380
642,Herenthoutsesteenweg 2,2021-10-21,07:00:00,6,6,0,ECO_300019380
642,Herenthoutsesteenweg 2,2021-10-21,08:00:00,23,22,1,ECO_300019380
642,Herenthoutsesteenweg 2,2021-10-21,09:00:00,36,34,2,ECO_300019380
642,Herenthoutsesteenweg 2,2021-10-21,10:00:00,202,196,6,ECO_300019380
642,Herenthoutsesteenweg 2,2021-10-21,11:00:00,36,35,1,ECO_300019380
642,Herenthoutsesteenweg 2,2021-10-21,12:00:00,27,23,4,ECO_300019380
642,Herenthoutsesteenweg 2,2021-10-21,13:00:00,12,12,0,ECO_300019380
642,Herenthoutsesteenweg 2,2021-10-21,14:00:00,20,20,0,ECO_300019380
642,Herenthoutsesteenweg 2,2021-10-21,15:00:00,26,24,2,ECO_300019380
642,Herenthoutsesteenweg 2,2021-10-21,16:00:00,37,35,2,ECO_300019380
642,Herenthoutsesteenweg 2,2021-10-21,17:00:00,30,28,2,ECO_300019380
642,Herenthoutsesteenweg 2,2021-10-21,18:00:00,53,46,7,ECO_300019380
642,Herenthoutsesteenweg 2,2021-10-21,19:00:00,43,40,3,ECO_300019380
642,Herenthoutsesteenweg 2,2021-10-21,20:00:00,32,30,2,ECO_300019380
642,Herenthoutsesteenweg 2,2021-10-21,21:00:00,27,24,3,ECO_300019380
642,Herenthoutsesteenweg 2,2021-10-21,22:00:00,8,8,0,ECO_300019380
642,Herenthoutsesteenweg 2,2021-10-21,23:00:00,7,6,1,ECO_300019380
642,Herenthoutsesteenweg 2,2021-10-22,00:00:00,16,12,4,ECO_300019380
642,Herenthoutsesteenweg 2,2021-10-22,01:00:00,3,3,0,ECO_300019380
642,Herenthoutsesteenweg 2,2021-10-22,02:00:00,1,1,0,ECO_300019380
642,Herenthoutsesteenweg 2,2021-10-22,03:00:00,0,0,0,ECO_300019380
642,Herenthoutsesteenweg 2,2021-10-22,04:00:00,0,0,0,ECO_300019380
642,Herenthoutsesteenweg 2,2021-10-22,05:00:00,4,4,0,ECO_300019380
642,Herenthoutsesteenweg 2,2021-10-22,06:00:00,2,1,1,ECO_300019380
642,Herenthoutsesteenweg 2,2021-10-22,07:00:00,10,9,1,ECO_300019380
642,Herenthoutsesteenweg 2,2021-10-22,08:00:00,24,23,1,ECO_300019380
642,Herenthoutsesteenweg 2,2021-10-22,09:00:00,149,147,2,ECO_300019380
642,Herenthoutsesteenweg 2,2021-10-22,10:00:00,490,478,12,ECO_300019380
642,Herenthoutsesteenweg 2,2021-10-22,11:00:00,78,75,3,ECO_300019380
642,Herenthoutsesteenweg 2,2021-10-22,12:00:00,75,73,2,ECO_300019380
642,Herenthoutsesteenweg 2,2021-10-22,13:00:00,49,46,3,ECO_300019380
642,Herenthoutsesteenweg 2,2021-10-22,14:00:00,53,52,1,ECO_300019380
642,Herenthoutsesteenweg 2,2021-10-22,15:00:00,71,69,2,ECO_300019380
642,Herenthoutsesteenweg 2,2021-10-22,16:00:00,47,42,5,ECO_300019380
642,Herenthoutsesteenweg 2,2021-10-22,17:00:00,101,93,8,ECO_300019380
642,Herenthoutsesteenweg 2,2021-10-22,18:00:00,81,70,11,ECO_300019380
642,Herenthoutsesteenweg 2,2021-10-22,19:00:00,53,47,6,ECO_300019380
642,Herenthoutsesteenweg 2,2021-10-22,20:00:00,28,24,4,ECO_300019380
642,Herenthoutsesteenweg 2,2021-10-22,21:00:00,20,17,3,ECO_300019380
642,Herenthoutsesteenweg 2,2021-10-22,22:00:00,14,13,1,ECO_300019380
642,Herenthoutsesteenweg 2,2021-10-22,23:00:00,23,19,4,ECO_300019380
642,Herenthoutsesteenweg 2,2021-10-23,00:00:00,30,29,1,ECO_300019380
642,Herenthoutsesteenweg 2,2021-10-23,01:00:00,5,5,0,ECO_300019380
642,Herenthoutsesteenweg 2,2021-10-23,02:00:00,7,3,4,ECO_300019380
642,Herenthoutsesteenweg 2,2021-10-23,03:00:00,0,0,0,ECO_300019380
642,Herenthoutsesteenweg 2,2021-10-23,04:00:00,2,2,0,ECO_300019380
642,Herenthoutsesteenweg 2,2021-10-23,05:00:00,2,1,1,ECO_300019380
642,Herenthoutsesteenweg 2,2021-10-23,06:00:00,3,2,1,ECO_300019380
642,Herenthoutsesteenweg 2,2021-10-23,07:00:00,5,4,1,ECO_300019380
642,Herenthoutsesteenweg 2,2021-10-23,08:00:00,5,5,0,ECO_300019380
642,Herenthoutsesteenweg 2,2021-10-23,09:00:00,7,6,1,ECO_300019380
642,Herenthoutsesteenweg 2,2021-10-23,10:00:00,47,46,1,ECO_300019380
642,Herenthoutsesteenweg 2,2021-10-23,11:00:00,43,42,1,ECO_300019380
642,Herenthoutsesteenweg 2,2021-10-23,12:00:00,58,51,7,ECO_300019380
642,Herenthoutsesteenweg 2,2021-10-23,13:00:00,77,72,5,ECO_300019380
642,Herenthoutsesteenweg 2,2021-10-23,14:00:00,66,62,4,ECO_300019380
642,Herenthoutsesteenweg 2,2021-10-23,15:00:00,122,113,9,ECO_300019380
642,Herenthoutsesteenweg 2,2021-10-23,16:00:00,106,98,8,ECO_300019380
642,Herenthoutsesteenweg 2,2021-10-23,17:00:00,131,115,16,ECO_300019380
642,Herenthoutsesteenweg 2,2021-10-23,18:00:00,81,64,17,ECO_300019380
642,Herenthoutsesteenweg 2,2021-10-23,19:00:00,57,49,8,ECO_300019380
642,Herenthoutsesteenweg 2,2021-10-23,20:00:00,38,36,2,ECO_300019380
642,Herenthoutsesteenweg 2,2021-10-23,21:00:00,31,26,5,ECO_300019380
642,Herenthoutsesteenweg 2,2021-10-23,22:00:00,21,16,5,ECO_300019380
642,Herenthoutsesteenweg 2,2021-10-23,23:00:00,16,15,1,ECO_300019380
642,Herenthoutsesteenweg 2,2021-10-24,00:00:00,8,4,4,ECO_300019380
642,Herenthoutsesteenweg 2,2021-10-24,01:00:00,6,4,2,ECO_300019380
642,Herenthoutsesteenweg 2,2021-10-24,02:00:00,2,2,0,ECO_300019380
642,Herenthoutsesteenweg 2,2021-10-24,03:00:00,9,6,3,ECO_300019380
642,Herenthoutsesteenweg 2,2021-10-24,04:00:00,4,2,2,ECO_300019380
642,Herenthoutsesteenweg 2,2021-10-24,05:00:00,12,12,0,ECO_300019380
642,Herenthoutsesteenweg 2,2021-10-24,06:00:00,4,4,0,ECO_300019380
642,Herenthoutsesteenweg 2,2021-10-24,07:00:00,4,2,2,ECO_300019380
642,Herenthoutsesteenweg 2,2021-10-24,08:00:00,4,4,0,ECO_300019380
642,Herenthoutsesteenweg 2,2021-10-24,09:00:00,33,31,2,ECO_300019380
642,Herenthoutsesteenweg 2,2021-10-24,10:00:00,49,47,2,ECO_300019380
642,Herenthoutsesteenweg 2,2021-10-24,11:00:00,73,65,8,ECO_300019380
642,Herenthoutsesteenweg 2,2021-10-24,12:00:00,86,71,15,ECO_300019380
642,Herenthoutsesteenweg 2,2021-10-24,13:00:00,77,55,22,ECO_300019380
642,Herenthoutsesteenweg 2,2021-10-24,14:00:00,71,65,6,ECO_300019380
642,Herenthoutsesteenweg 2,2021-10-24,15:00:00,108,100,8,ECO_300019380
642,Herenthoutsesteenweg 2,2021-10-24,16:00:00,126,119,7,ECO_300019380
642,Herenthoutsesteenweg 2,2021-10-24,17:00:00,110,95,15,ECO_300019380
642,Herenthoutsesteenweg 2,2021-10-24,18:00:00,65,57,8,ECO_300019380
642,Herenthoutsesteenweg 2,2021-10-24,19:00:00,63,46,17,ECO_300019380
642,Herenthoutsesteenweg 2,2021-10-24,20:00:00,28,25,3,ECO_300019380
642,Herenthoutsesteenweg 2,2021-10-24,21:00:00,15,12,3,ECO_300019380
642,Herenthoutsesteenweg 2,2021-10-24,22:00:00,11,10,1,ECO_300019380
642,Herenthoutsesteenweg 2,2021-10-24,23:00:00,4,3,1,ECO_300019380
642,Herenthoutsesteenweg 2,2021-10-25,00:00:00,4,3,1,ECO_300019380
642,Herenthoutsesteenweg 2,2021-10-25,01:00:00,0,0,0,ECO_300019380
642,Herenthoutsesteenweg 2,2021-10-25,02:00:00,0,0,0,ECO_300019380
642,Herenthoutsesteenweg 2,2021-10-25,03:00:00,7,3,4,ECO_300019380
642,Herenthoutsesteenweg 2,2021-10-25,04:00:00,0,0,0,ECO_300019380
642,Herenthoutsesteenweg 2,2021-10-25,05:00:00,0,0,0,ECO_300019380
642,Herenthoutsesteenweg 2,2021-10-25,06:00:00,2,2,0,ECO_300019380
642,Herenthoutsesteenweg 2,2021-10-25,07:00:00,12,10,2,ECO_300019380
642,Herenthoutsesteenweg 2,2021-10-25,08:00:00,38,36,2,ECO_300019380
642,Herenthoutsesteenweg 2,2021-10-25,09:00:00,142,134,8,ECO_300019380
642,Herenthoutsesteenweg 2,2021-10-25,10:00:00,520,507,13,ECO_300019380
642,Herenthoutsesteenweg 2,2021-10-25,11:00:00,61,56,5,ECO_300019380
642,Herenthoutsesteenweg 2,2021-10-25,12:00:00,44,43,1,ECO_300019380
642,Herenthoutsesteenweg 2,2021-10-25,13:00:00,43,41,2,ECO_300019380
642,Herenthoutsesteenweg 2,2021-10-25,14:00:00,37,35,2,ECO_300019380
642,Herenthoutsesteenweg 2,2021-10-25,15:00:00,82,78,4,ECO_300019380
642,Herenthoutsesteenweg 2,2021-10-25,16:00:00,88,78,10,ECO_300019380
642,Herenthoutsesteenweg 2,2021-10-25,17:00:00,97,89,8,ECO_300019380
642,Herenthoutsesteenweg 2,2021-10-25,18:00:00,108,96,12,ECO_300019380
642,Herenthoutsesteenweg 2,2021-10-25,19:00:00,65,59,6,ECO_300019380
642,Herenthoutsesteenweg 2,2021-10-25,20:00:00,29,24,5,ECO_300019380
642,Herenthoutsesteenweg 2,2021-10-25,21:00:00,18,12,6,ECO_300019380
642,Herenthoutsesteenweg 2,2021-10-25,22:00:00,13,13,0,ECO_300019380
642,Herenthoutsesteenweg 2,2021-10-25,23:00:00,10,8,2,ECO_300019380
642,Herenthoutsesteenweg 2,2021-10-26,00:00:00,12,10,2,ECO_300019380
642,Herenthoutsesteenweg 2,2021-10-26,01:00:00,1,1,0,ECO_300019380
642,Herenthoutsesteenweg 2,2021-10-26,02:00:00,1,1,0,ECO_300019380
642,Herenthoutsesteenweg 2,2021-10-26,03:00:00,0,0,0,ECO_300019380
642,Herenthoutsesteenweg 2,2021-10-26,04:00:00,0,0,0,ECO_300019380
642,Herenthoutsesteenweg 2,2021-10-26,05:00:00,0,0,0,ECO_300019380
642,Herenthoutsesteenweg 2,2021-10-26,06:00:00,2,2,0,ECO_300019380
642,Herenthoutsesteenweg 2,2021-10-26,07:00:00,14,10,4,ECO_300019380
642,Herenthoutsesteenweg 2,2021-10-26,08:00:00,35,33,2,ECO_300019380
642,Herenthoutsesteenweg 2,2021-10-26,09:00:00,152,148,4,ECO_300019380
642,Herenthoutsesteenweg 2,2021-10-26,10:00:00,472,464,8,ECO_300019380
642,Herenthoutsesteenweg 2,2021-10-26,11:00:00,68,67,1,ECO_300019380
642,Herenthoutsesteenweg 2,2021-10-26,12:00:00,63,61,2,ECO_300019380
642,Herenthoutsesteenweg 2,2021-10-26,13:00:00,50,49,1,ECO_300019380
642,Herenthoutsesteenweg 2,2021-10-26,14:00:00,65,60,5,ECO_300019380
642,Herenthoutsesteenweg 2,2021-10-26,15:00:00,90,89,1,ECO_300019380
642,Herenthoutsesteenweg 2,2021-10-26,16:00:00,95,90,5,ECO_300019380
642,Herenthoutsesteenweg 2,2021-10-26,17:00:00,119,107,12,ECO_300019380
642,Herenthoutsesteenweg 2,2021-10-26,18:00:00,123,117,6,ECO_300019380
642,Herenthoutsesteenweg 2,2021-10-26,19:00:00,110,97,13,ECO_300019380
642,Herenthoutsesteenweg 2,2021-10-26,20:00:00,42,39,3,ECO_300019380
642,Herenthoutsesteenweg 2,2021-10-26,21:00:00,24,20,4,ECO_300019380
642,Herenthoutsesteenweg 2,2021-10-26,22:00:00,22,18,4,ECO_300019380
642,Herenthoutsesteenweg 2,2021-10-26,23:00:00,7,6,1,ECO_300019380
642,Herenthoutsesteenweg 2,2021-10-27,00:00:00,12,10,2,ECO_300019380
642,Herenthoutsesteenweg 2,2021-10-27,01:00:00,7,6,1,ECO_300019380
642,Herenthoutsesteenweg 2,2021-10-27,02:00:00,1,1,0,ECO_300019380
642,Herenthoutsesteenweg 2,2021-10-27,03:00:00,3,2,1,ECO_300019380
642,Herenthoutsesteenweg 2,2021-10-27,04:00:00,0,0,0,ECO_300019380
642,Herenthoutsesteenweg 2,2021-10-27,05:00:00,1,1,0,ECO_300019380
642,Herenthoutsesteenweg 2,2021-10-27,06:00:00,3,3,0,ECO_300019380
642,Herenthoutsesteenweg 2,2021-10-27,07:00:00,20,16,4,ECO_300019380
642,Herenthoutsesteenweg 2,2021-10-27,08:00:00,49,47,2,ECO_300019380
642,Herenthoutsesteenweg 2,2021-10-27,09:00:00,138,133,5,ECO_300019380
642,Herenthoutsesteenweg 2,2021-10-27,10:00:00,433,424,9,ECO_300019380
642,Herenthoutsesteenweg 2,2021-10-27,11:00:00,80,75,5,ECO_300019380
642,Herenthoutsesteenweg 2,2021-10-27,12:00:00,72,69,3,ECO_300019380
642,Herenthoutsesteenweg 2,2021-10-27,13:00:00,54,46,8,ECO_300019380
642,Herenthoutsesteenweg 2,2021-10-27,14:00:00,121,113,8,ECO_300019380
642,Herenthoutsesteenweg 2,2021-10-27,15:00:00,119,111,8,ECO_300019380
642,Herenthoutsesteenweg 2,2021-10-27,16:00:00,137,130,7,ECO_300019380
642,Herenthoutsesteenweg 2,2021-10-27,17:00:00,103,88,15,ECO_300019380
642,Herenthoutsesteenweg 2,2021-10-27,18:00:00,135,119,16,ECO_300019380
642,Herenthoutsesteenweg 2,2021-10-27,19:00:00,88,78,10,ECO_300019380
642,Herenthoutsesteenweg 2,2021-10-27,20:00:00,49,45,4,ECO_300019380
642,Herenthoutsesteenweg 2,2021-10-27,21:00:00,38,37,1,ECO_300019380
642,Herenthoutsesteenweg 2,2021-10-27,22:00:00,21,19,2,ECO_300019380
642,Herenthoutsesteenweg 2,2021-10-27,23:00:00,21,16,5,ECO_300019380
642,Herenthoutsesteenweg 2,2021-10-28,00:00:00,16,14,2,ECO_300019380
642,Herenthoutsesteenweg 2,2021-10-28,01:00:00,4,2,2,ECO_300019380
642,Herenthoutsesteenweg 2,2021-10-28,02:00:00,2,0,2,ECO_300019380
642,Herenthoutsesteenweg 2,2021-10-28,03:00:00,3,2,1,ECO_300019380
642,Herenthoutsesteenweg 2,2021-10-28,04:00:00,0,0,0,ECO_300019380
642,Herenthoutsesteenweg 2,2021-10-28,05:00:00,0,0,0,ECO_300019380
642,Herenthoutsesteenweg 2,2021-10-28,06:00:00,7,5,2,ECO_300019380
642,Herenthoutsesteenweg 2,2021-10-28,07:00:00,18,15,3,ECO_300019380
642,Herenthoutsesteenweg 2,2021-10-28,08:00:00,45,41,4,ECO_300019380
642,Herenthoutsesteenweg 2,2021-10-28,09:00:00,147,140,7,ECO_300019380
642,Herenthoutsesteenweg 2,2021-10-28,10:00:00,472,466,6,ECO_300019380
642,Herenthoutsesteenweg 2,2021-10-28,11:00:00,88,85,3,ECO_300019380
642,Herenthoutsesteenweg 2,2021-10-28,12:00:00,68,64,4,ECO_300019380
642,Herenthoutsesteenweg 2,2021-10-28,13:00:00,69,63,6,ECO_300019380
642,Herenthoutsesteenweg 2,2021-10-28,14:00:00,67,64,3,ECO_300019380
642,Herenthoutsesteenweg 2,2021-10-28,15:00:00,122,119,3,ECO_300019380
642,Herenthoutsesteenweg 2,2021-10-28,16:00:00,151,139,12,ECO_300019380
642,Herenthoutsesteenweg 2,2021-10-28,17:00:00,141,133,8,ECO_300019380
642,Herenthoutsesteenweg 2,2021-10-28,18:00:00,147,130,17,ECO_300019380
642,Herenthoutsesteenweg 2,2021-10-28,19:00:00,108,90,18,ECO_300019380
642,Herenthoutsesteenweg 2,2021-10-28,20:00:00,46,42,4,ECO_300019380
642,Herenthoutsesteenweg 2,2021-10-28,21:00:00,35,28,7,ECO_300019380
642,Herenthoutsesteenweg 2,2021-10-28,22:00:00,26,21,5,ECO_300019380
642,Herenthoutsesteenweg 2,2021-10-28,23:00:00,17,15,2,ECO_300019380
642,Herenthoutsesteenweg 2,2021-10-29,00:00:00,10,7,3,ECO_300019380
642,Herenthoutsesteenweg 2,2021-10-29,01:00:00,9,6,3,ECO_300019380
642,Herenthoutsesteenweg 2,2021-10-29,02:00:00,4,3,1,ECO_300019380
642,Herenthoutsesteenweg 2,2021-10-29,03:00:00,6,2,4,ECO_300019380
642,Herenthoutsesteenweg 2,2021-10-29,04:00:00,0,0,0,ECO_300019380
642,Herenthoutsesteenweg 2,2021-10-29,05:00:00,0,0,0,ECO_300019380
642,Herenthoutsesteenweg 2,2021-10-29,06:00:00,4,3,1,ECO_300019380
642,Herenthoutsesteenweg 2,2021-10-29,07:00:00,13,12,1,ECO_300019380
642,Herenthoutsesteenweg 2,2021-10-29,08:00:00,32,31,1,ECO_300019380
642,Herenthoutsesteenweg 2,2021-10-29,09:00:00,123,123,0,ECO_300019380
642,Herenthoutsesteenweg 2,2021-10-29,10:00:00,425,420,5,ECO_300019380
642,Herenthoutsesteenweg 2,2021-10-29,11:00:00,107,104,3,ECO_300019380
642,Herenthoutsesteenweg 2,2021-10-29,12:00:00,86,84,2,ECO_300019380
642,Herenthoutsesteenweg 2,2021-10-29,13:00:00,84,79,5,ECO_300019380
642,Herenthoutsesteenweg 2,2021-10-29,14:00:00,78,73,5,ECO_300019380
642,Herenthoutsesteenweg 2,2021-10-29,15:00:00,96,87,9,ECO_300019380
642,Herenthoutsesteenweg 2,2021-10-29,16:00:00,145,133,12,ECO_300019380
642,Herenthoutsesteenweg 2,2021-10-29,17:00:00,99,95,4,ECO_300019380
642,Herenthoutsesteenweg 2,2021-10-29,18:00:00,121,105,16,ECO_300019380
642,Herenthoutsesteenweg 2,2021-10-29,19:00:00,45,40,5,ECO_300019380
642,Herenthoutsesteenweg 2,2021-10-29,20:00:00,39,34,5,ECO_300019380
642,Herenthoutsesteenweg 2,2021-10-29,21:00:00,26,25,1,ECO_300019380
642,Herenthoutsesteenweg 2,2021-10-29,22:00:00,22,20,2,ECO_300019380
642,Herenthoutsesteenweg 2,2021-10-29,23:00:00,13,12,1,ECO_300019380
642,Herenthoutsesteenweg 2,2021-10-30,00:00:00,12,9,3,ECO_300019380
642,Herenthoutsesteenweg 2,2021-10-30,01:00:00,6,4,2,ECO_300019380
642,Herenthoutsesteenweg 2,2021-10-30,02:00:00,13,11,2,ECO_300019380
642,Herenthoutsesteenweg 2,2021-10-30,03:00:00,4,4,0,ECO_300019380
642,Herenthoutsesteenweg 2,2021-10-30,04:00:00,5,2,3,ECO_300019380
642,Herenthoutsesteenweg 2,2021-10-30,05:00:00,2,1,1,ECO_300019380
642,Herenthoutsesteenweg 2,2021-10-30,06:00:00,1,0,1,ECO_300019380
642,Herenthoutsesteenweg 2,2021-10-30,07:00:00,3,3,0,ECO_300019380
642,Herenthoutsesteenweg 2,2021-10-30,08:00:00,5,3,2,ECO_300019380
642,Herenthoutsesteenweg 2,2021-10-30,09:00:00,8,7,1,ECO_300019380
642,Herenthoutsesteenweg 2,2021-10-30,10:00:00,20,18,2,ECO_300019380
642,Herenthoutsesteenweg 2,2021-10-30,11:00:00,31,26,5,ECO_300019380
642,Herenthoutsesteenweg 2,2021-10-30,12:00:00,15,14,1,ECO_300019380
642,Herenthoutsesteenweg 2,2021-10-30,13:00:00,17,14,3,ECO_300019380
642,Herenthoutsesteenweg 2,2021-10-30,14:00:00,25,25,0,ECO_300019380
642,Herenthoutsesteenweg 2,2021-10-30,15:00:00,40,40,0,ECO_300019380
642,Herenthoutsesteenweg 2,2021-10-30,16:00:00,36,33,3,ECO_300019380
642,Herenthoutsesteenweg 2,2021-10-30,17:00:00,34,31,3,ECO_300019380
642,Herenthoutsesteenweg 2,2021-10-30,18:00:00,25,22,3,ECO_300019380
642,Herenthoutsesteenweg 2,2021-10-30,19:00:00,20,18,2,ECO_300019380
642,Herenthoutsesteenweg 2,2021-10-30,20:00:00,17,14,3,ECO_300019380
642,Herenthoutsesteenweg 2,2021-10-30,21:00:00,26,25,1,ECO_300019380
642,Herenthoutsesteenweg 2,2021-10-30,22:00:00,21,17,4,ECO_300019380
642,Herenthoutsesteenweg 2,2021-10-30,23:00:00,9,8,1,ECO_300019380
642,Herenthoutsesteenweg 2,2021-10-31,00:00:00,8,7,1,ECO_300019380
642,Herenthoutsesteenweg 2,2021-10-31,01:00:00,8,4,4,ECO_300019380
642,Herenthoutsesteenweg 2,2021-10-31,02:00:00,7,6,1,ECO_300019380
642,Herenthoutsesteenweg 2,2021-10-31,03:00:00,2,0,2,ECO_300019380
642,Herenthoutsesteenweg 2,2021-10-31,04:00:00,2,1,1,ECO_300019380
642,Herenthoutsesteenweg 2,2021-10-31,05:00:00,0,0,0,ECO_300019380
642,Herenthoutsesteenweg 2,2021-10-31,06:00:00,3,3,0,ECO_300019380
642,Herenthoutsesteenweg 2,2021-10-31,07:00:00,4,4,0,ECO_300019380
642,Herenthoutsesteenweg 2,2021-10-31,08:00:00,15,14,1,ECO_300019380
642,Herenthoutsesteenweg 2,2021-10-31,09:00:00,51,48,3,ECO_300019380
642,Herenthoutsesteenweg 2,2021-10-31,10:00:00,114,99,15,ECO_300019380
642,Herenthoutsesteenweg 2,2021-10-31,11:00:00,72,59,13,ECO_300019380
642,Herenthoutsesteenweg 2,2021-10-31,12:00:00,66,58,8,ECO_300019380
642,Herenthoutsesteenweg 2,2021-10-31,13:00:00,75,69,6,ECO_300019380
642,Herenthoutsesteenweg 2,2021-10-31,14:00:00,56,55,1,ECO_300019380
642,Herenthoutsesteenweg 2,2021-10-31,15:00:00,54,52,2,ECO_300019380
642,Herenthoutsesteenweg 2,2021-10-31,16:00:00,29,27,2,ECO_300019380
642,Herenthoutsesteenweg 2,2021-10-31,17:00:00,24,19,5,ECO_300019380
642,Herenthoutsesteenweg 2,2021-10-31,18:00:00,20,19,1,ECO_300019380
642,Herenthoutsesteenweg 2,2021-10-31,19:00:00,13,10,3,ECO_300019380
642,Herenthoutsesteenweg 2,2021-10-31,20:00:00,29,26,3,ECO_300019380
642,Herenthoutsesteenweg 2,2021-10-31,21:00:00,29,28,1,ECO_300019380
642,Herenthoutsesteenweg 2,2021-10-31,22:00:00,16,16,0,ECO_300019380
642,Herenthoutsesteenweg 2,2021-10-31,23:00:00,17,13,4,ECO_300019380
642,Herenthoutsesteenweg 2,2021-11-01,00:00:00,7,6,1,ECO_300019380
642,Herenthoutsesteenweg 2,2021-11-01,01:00:00,3,2,1,ECO_300019380
642,Herenthoutsesteenweg 2,2021-11-01,02:00:00,6,5,1,ECO_300019380
642,Herenthoutsesteenweg 2,2021-11-01,03:00:00,11,6,5,ECO_300019380
642,Herenthoutsesteenweg 2,2021-11-01,04:00:00,1,0,1,ECO_300019380
642,Herenthoutsesteenweg 2,2021-11-01,05:00:00,0,0,0,ECO_300019380
642,Herenthoutsesteenweg 2,2021-11-01,06:00:00,2,2,0,ECO_300019380
642,Herenthoutsesteenweg 2,2021-11-01,07:00:00,8,8,0,ECO_300019380
642,Herenthoutsesteenweg 2,2021-11-01,08:00:00,7,7,0,ECO_300019380
642,Herenthoutsesteenweg 2,2021-11-01,09:00:00,12,12,0,ECO_300019380
642,Herenthoutsesteenweg 2,2021-11-01,10:00:00,47,41,6,ECO_300019380
642,Herenthoutsesteenweg 2,2021-11-01,11:00:00,41,34,7,ECO_300019380
642,Herenthoutsesteenweg 2,2021-11-01,12:00:00,47,42,5,ECO_300019380
642,Herenthoutsesteenweg 2,2021-11-01,13:00:00,33,28,5,ECO_300019380
642,Herenthoutsesteenweg 2,2021-11-01,14:00:00,45,35,10,ECO_300019380
642,Herenthoutsesteenweg 2,2021-11-01,15:00:00,47,41,6,ECO_300019380
642,Herenthoutsesteenweg 2,2021-11-01,16:00:00,36,30,6,ECO_300019380
642,Herenthoutsesteenweg 2,2021-11-01,17:00:00,32,25,7,ECO_300019380
642,Herenthoutsesteenweg 2,2021-11-01,18:00:00,16,14,2,ECO_300019380
642,Herenthoutsesteenweg 2,2021-11-01,19:00:00,12,11,1,ECO_300019380
642,Herenthoutsesteenweg 2,2021-11-01,20:00:00,15,13,2,ECO_300019380
642,Herenthoutsesteenweg 2,2021-11-01,21:00:00,12,11,1,ECO_300019380
642,Herenthoutsesteenweg 2,2021-11-01,22:00:00,10,7,3,ECO_300019380
642,Herenthoutsesteenweg 2,2021-11-01,23:00:00,0,0,0,ECO_300019380
642,Herenthoutsesteenweg 2,2021-11-02,00:00:00,1,1,0,ECO_300019380
642,Herenthoutsesteenweg 2,2021-11-02,01:00:00,1,1,0,ECO_300019380
642,Herenthoutsesteenweg 2,2021-11-02,02:00:00,0,0,0,ECO_300019380
642,Herenthoutsesteenweg 2,2021-11-02,03:00:00,0,0,0,ECO_300019380
642,Herenthoutsesteenweg 2,2021-11-02,04:00:00,0,0,0,ECO_300019380
642,Herenthoutsesteenweg 2,2021-11-02,05:00:00,2,2,0,ECO_300019380
642,Herenthoutsesteenweg 2,2021-11-02,06:00:00,13,12,1,ECO_300019380
642,Herenthoutsesteenweg 2,2021-11-02,07:00:00,21,21,0,ECO_300019380
642,Herenthoutsesteenweg 2,2021-11-02,08:00:00,38,38,0,ECO_300019380
642,Herenthoutsesteenweg 2,2021-11-02,09:00:00,37,35,2,ECO_300019380
642,Herenthoutsesteenweg 2,2021-11-02,10:00:00,34,33,1,ECO_300019380
642,Herenthoutsesteenweg 2,2021-11-02,11:00:00,36,34,2,ECO_300019380
642,Herenthoutsesteenweg 2,2021-11-02,12:00:00,36,33,3,ECO_300019380
642,Herenthoutsesteenweg 2,2021-11-02,13:00:00,30,27,3,ECO_300019380
642,Herenthoutsesteenweg 2,2021-11-02,14:00:00,42,37,5,ECO_300019380
642,Herenthoutsesteenweg 2,2021-11-02,15:00:00,55,52,3,ECO_300019380
642,Herenthoutsesteenweg 2,2021-11-02,16:00:00,47,43,4,ECO_300019380
642,Herenthoutsesteenweg 2,2021-11-02,17:00:00,64,58,6,ECO_300019380
642,Herenthoutsesteenweg 2,2021-11-02,18:00:00,61,56,5,ECO_300019380
642,Herenthoutsesteenweg 2,2021-11-02,19:00:00,15,14,1,ECO_300019380
642,Herenthoutsesteenweg 2,2021-11-02,20:00:00,20,13,7,ECO_300019380
642,Herenthoutsesteenweg 2,2021-11-02,21:00:00,16,14,2,ECO_300019380
642,Herenthoutsesteenweg 2,2021-11-02,22:00:00,7,6,1,ECO_300019380
642,Herenthoutsesteenweg 2,2021-11-02,23:00:00,15,12,3,ECO_300019380
642,Herenthoutsesteenweg 2,2021-11-03,00:00:00,2,2,0,ECO_300019380
642,Herenthoutsesteenweg 2,2021-11-03,01:00:00,0,0,0,ECO_300019380
642,Herenthoutsesteenweg 2,2021-11-03,02:00:00,3,3,0,ECO_300019380
642,Herenthoutsesteenweg 2,2021-11-03,03:00:00,1,1,0,ECO_300019380
642,Herenthoutsesteenweg 2,2021-11-03,04:00:00,0,0,0,ECO_300019380
642,Herenthoutsesteenweg 2,2021-11-03,05:00:00,2,2,0,ECO_300019380
642,Herenthoutsesteenweg 2,2021-11-03,06:00:00,11,10,1,ECO_300019380
642,Herenthoutsesteenweg 2,2021-11-03,07:00:00,39,36,3,ECO_300019380
642,Herenthoutsesteenweg 2,2021-11-03,08:00:00,63,61,2,ECO_300019380
642,Herenthoutsesteenweg 2,2021-11-03,09:00:00,47,45,2,ECO_300019380
642,Herenthoutsesteenweg 2,2021-11-03,10:00:00,59,58,1,ECO_300019380
642,Herenthoutsesteenweg 2,2021-11-03,11:00:00,73,71,2,ECO_300019380
642,Herenthoutsesteenweg 2,2021-11-03,12:00:00,46,40,6,ECO_300019380
642,Herenthoutsesteenweg 2,2021-11-03,13:00:00,63,59,4,ECO_300019380
642,Herenthoutsesteenweg 2,2021-11-03,14:00:00,77,70,7,ECO_300019380
642,Herenthoutsesteenweg 2,2021-11-03,15:00:00,86,83,3,ECO_300019380
642,Herenthoutsesteenweg 2,2021-11-03,16:00:00,64,58,6,ECO_300019380
642,Herenthoutsesteenweg 2,2021-11-03,17:00:00,66,59,7,ECO_300019380
642,Herenthoutsesteenweg 2,2021-11-03,18:00:00,44,37,7,ECO_300019380
642,Herenthoutsesteenweg 2,2021-11-03,19:00:00,24,21,3,ECO_300019380
642,Herenthoutsesteenweg 2,2021-11-03,20:00:00,38,30,8,ECO_300019380
642,Herenthoutsesteenweg 2,2021-11-03,21:00:00,23,19,4,ECO_300019380
642,Herenthoutsesteenweg 2,2021-11-03,22:00:00,7,6,1,ECO_300019380
642,Herenthoutsesteenweg 2,2021-11-03,23:00:00,18,16,2,ECO_300019380
642,Herenthoutsesteenweg 2,2021-11-04,00:00:00,4,3,1,ECO_300019380
642,Herenthoutsesteenweg 2,2021-11-04,01:00:00,2,1,1,ECO_300019380
642,Herenthoutsesteenweg 2,2021-11-04,02:00:00,3,2,1,ECO_300019380
642,Herenthoutsesteenweg 2,2021-11-04,03:00:00,1,1,0,ECO_300019380
642,Herenthoutsesteenweg 2,2021-11-04,04:00:00,0,0,0,ECO_300019380
642,Herenthoutsesteenweg 2,2021-11-04,05:00:00,3,3,0,ECO_300019380
642,Herenthoutsesteenweg 2,2021-11-04,06:00:00,10,8,2,ECO_300019380
642,Herenthoutsesteenweg 2,2021-11-04,07:00:00,32,31,1,ECO_300019380
642,Herenthoutsesteenweg 2,2021-11-04,08:00:00,65,62,3,ECO_300019380
642,Herenthoutsesteenweg 2,2021-11-04,09:00:00,45,43,2,ECO_300019380
642,Herenthoutsesteenweg 2,2021-11-04,10:00:00,52,52,0,ECO_300019380
642,Herenthoutsesteenweg 2,2021-11-04,11:00:00,45,44,1,ECO_300019380
642,Herenthoutsesteenweg 2,2021-11-04,12:00:00,44,39,5,ECO_300019380
642,Herenthoutsesteenweg 2,2021-11-04,13:00:00,44,42,2,ECO_300019380
642,Herenthoutsesteenweg 2,2021-11-04,14:00:00,49,47,2,ECO_300019380
642,Herenthoutsesteenweg 2,2021-11-04,15:00:00,45,41,4,ECO_300019380
642,Herenthoutsesteenweg 2,2021-11-04,16:00:00,38,34,4,ECO_300019380
642,Herenthoutsesteenweg 2,2021-11-04,17:00:00,79,70,9,ECO_300019380
642,Herenthoutsesteenweg 2,2021-11-04,18:00:00,46,35,11,ECO_300019380
642,Herenthoutsesteenweg 2,2021-11-04,19:00:00,34,28,6,ECO_300019380
642,Herenthoutsesteenweg 2,2021-11-04,20:00:00,14,12,2,ECO_300019380
642,Herenthoutsesteenweg 2,2021-11-04,21:00:00,13,10,3,ECO_300019380
642,Herenthoutsesteenweg 2,2021-11-04,22:00:00,15,15,0,ECO_300019380
642,Herenthoutsesteenweg 2,2021-11-04,23:00:00,16,14,2,ECO_300019380
642,Herenthoutsesteenweg 2,2021-11-05,00:00:00,5,3,2,ECO_300019380
642,Herenthoutsesteenweg 2,2021-11-05,01:00:00,0,0,0,ECO_300019380
642,Herenthoutsesteenweg 2,2021-11-05,02:00:00,1,0,1,ECO_300019380
642,Herenthoutsesteenweg 2,2021-11-05,03:00:00,0,0,0,ECO_300019380
642,Herenthoutsesteenweg 2,2021-11-05,04:00:00,0,0,0,ECO_300019380
642,Herenthoutsesteenweg 2,2021-11-05,05:00:00,2,2,0,ECO_300019380
642,Herenthoutsesteenweg 2,2021-11-05,06:00:00,7,6,1,ECO_300019380
642,Herenthoutsesteenweg 2,2021-11-05,07:00:00,28,26,2,ECO_300019380
642,Herenthoutsesteenweg 2,2021-11-05,08:00:00,50,47,3,ECO_300019380
642,Herenthoutsesteenweg 2,2021-11-05,09:00:00,50,48,2,ECO_300019380
642,Herenthoutsesteenweg 2,2021-11-05,10:00:00,65,65,0,ECO_300019380
642,Herenthoutsesteenweg 2,2021-11-05,11:00:00,85,82,3,ECO_300019380
642,Herenthoutsesteenweg 2,2021-11-05,12:00:00,69,59,10,ECO_300019380
642,Herenthoutsesteenweg 2,2021-11-05,13:00:00,60,49,11,ECO_300019380
642,Herenthoutsesteenweg 2,2021-11-05,14:00:00,78,72,6,ECO_300019380
642,Herenthoutsesteenweg 2,2021-11-05,15:00:00,77,72,5,ECO_300019380
642,Herenthoutsesteenweg 2,2021-11-05,16:00:00,74,70,4,ECO_300019380
642,Herenthoutsesteenweg 2,2021-11-05,17:00:00,70,65,5,ECO_300019380
642,Herenthoutsesteenweg 2,2021-11-05,18:00:00,57,50,7,ECO_300019380
642,Herenthoutsesteenweg 2,2021-11-05,19:00:00,37,34,3,ECO_300019380
642,Herenthoutsesteenweg 2,2021-11-05,20:00:00,39,32,7,ECO_300019380
642,Herenthoutsesteenweg 2,2021-11-05,21:00:00,19,17,2,ECO_300019380
642,Herenthoutsesteenweg 2,2021-11-05,22:00:00,26,22,4,ECO_300019380
642,Herenthoutsesteenweg 2,2021-11-05,23:00:00,34,32,2,ECO_300019380
642,Herenthoutsesteenweg 2,2021-11-06,00:00:00,25,23,2,ECO_300019380
642,Herenthoutsesteenweg 2,2021-11-06,01:00:00,2,1,1,ECO_300019380
642,Herenthoutsesteenweg 2,2021-11-06,02:00:00,7,5,2,ECO_300019380
642,Herenthoutsesteenweg 2,2021-11-06,03:00:00,2,1,1,ECO_300019380
642,Herenthoutsesteenweg 2,2021-11-06,04:00:00,0,0,0,ECO_300019380
642,Herenthoutsesteenweg 2,2021-11-06,05:00:00,1,1,0,ECO_300019380
642,Herenthoutsesteenweg 2,2021-11-06,06:00:00,4,4,0,ECO_300019380
642,Herenthoutsesteenweg 2,2021-11-06,07:00:00,12,10,2,ECO_300019380
642,Herenthoutsesteenweg 2,2021-11-06,08:00:00,8,7,1,ECO_300019380
642,Herenthoutsesteenweg 2,2021-11-06,09:00:00,29,28,1,ECO_300019380
642,Herenthoutsesteenweg 2,2021-11-06,10:00:00,53,52,1,ECO_300019380
642,Herenthoutsesteenweg 2,2021-11-06,11:00:00,71,63,8,ECO_300019380
642,Herenthoutsesteenweg 2,2021-11-06,12:00:00,59,51,8,ECO_300019380
642,Herenthoutsesteenweg 2,2021-11-06,13:00:00,72,68,4,ECO_300019380
642,Herenthoutsesteenweg 2,2021-11-06,14:00:00,99,87,12,ECO_300019380
642,Herenthoutsesteenweg 2,2021-11-06,15:00:00,81,68,13,ECO_300019380
642,Herenthoutsesteenweg 2,2021-11-06,16:00:00,76,70,6,ECO_300019380
642,Herenthoutsesteenweg 2,2021-11-06,17:00:00,49,45,4,ECO_300019380
642,Herenthoutsesteenweg 2,2021-11-06,18:00:00,36,31,5,ECO_300019380
642,Herenthoutsesteenweg 2,2021-11-06,19:00:00,17,16,1,ECO_300019380
642,Herenthoutsesteenweg 2,2021-11-06,20:00:00,27,21,6,ECO_300019380
642,Herenthoutsesteenweg 2,2021-11-06,21:00:00,25,22,3,ECO_300019380
642,Herenthoutsesteenweg 2,2021-11-06,22:00:00,4,3,1,ECO_300019380
642,Herenthoutsesteenweg 2,2021-11-06,23:00:00,4,3,1,ECO_300019380
642,Herenthoutsesteenweg 2,2021-11-07,00:00:00,9,5,4,ECO_300019380
642,Herenthoutsesteenweg 2,2021-11-07,01:00:00,11,9,2,ECO_300019380
642,Herenthoutsesteenweg 2,2021-11-07,02:00:00,1,1,0,ECO_300019380
642,Herenthoutsesteenweg 2,2021-11-07,03:00:00,3,3,0,ECO_300019380
642,Herenthoutsesteenweg 2,2021-11-07,04:00:00,7,6,1,ECO_300019380
642,Herenthoutsesteenweg 2,2021-11-07,05:00:00,1,1,0,ECO_300019380
642,Herenthoutsesteenweg 2,2021-11-07,06:00:00,1,1,0,ECO_300019380
642,Herenthoutsesteenweg 2,2021-11-07,07:00:00,9,8,1,ECO_300019380
642,Herenthoutsesteenweg 2,2021-11-07,08:00:00,9,9,0,ECO_300019380
642,Herenthoutsesteenweg 2,2021-11-07,09:00:00,48,47,1,ECO_300019380
642,Herenthoutsesteenweg 2,2021-11-07,10:00:00,56,53,3,ECO_300019380
642,Herenthoutsesteenweg 2,2021-11-07,11:00:00,87,85,2,ECO_300019380
642,Herenthoutsesteenweg 2,2021-11-07,12:00:00,56,46,10,ECO_300019380
642,Herenthoutsesteenweg 2,2021-11-07,13:00:00,82,75,7,ECO_300019380
642,Herenthoutsesteenweg 2,2021-11-07,14:00:00,56,53,3,ECO_300019380
642,Herenthoutsesteenweg 2,2021-11-07,15:00:00,54,48,6,ECO_300019380
642,Herenthoutsesteenweg 2,2021-11-07,16:00:00,52,46,6,ECO_300019380
642,Herenthoutsesteenweg 2,2021-11-07,17:00:00,16,13,3,ECO_300019380
642,Herenthoutsesteenweg 2,2021-11-07,18:00:00,34,27,7,ECO_300019380
642,Herenthoutsesteenweg 2,2021-11-07,19:00:00,9,5,4,ECO_300019380
642,Herenthoutsesteenweg 2,2021-11-07,20:00:00,10,9,1,ECO_300019380
642,Herenthoutsesteenweg 2,2021-11-07,21:00:00,10,9,1,ECO_300019380
642,Herenthoutsesteenweg 2,2021-11-07,22:00:00,10,9,1,ECO_300019380
642,Herenthoutsesteenweg 2,2021-11-07,23:00:00,5,3,2,ECO_300019380
642,Herenthoutsesteenweg 2,2021-11-08,00:00:00,2,2,0,ECO_300019380
642,Herenthoutsesteenweg 2,2021-11-08,01:00:00,3,1,2,ECO_300019380
642,Herenthoutsesteenweg 2,2021-11-08,02:00:00,2,2,0,ECO_300019380
642,Herenthoutsesteenweg 2,2021-11-08,03:00:00,0,0,0,ECO_300019380
642,Herenthoutsesteenweg 2,2021-11-08,04:00:00,1,0,1,ECO_300019380
642,Herenthoutsesteenweg 2,2021-11-08,05:00:00,2,2,0,ECO_300019380
642,Herenthoutsesteenweg 2,2021-11-08,06:00:00,12,10,2,ECO_300019380
642,Herenthoutsesteenweg 2,2021-11-08,07:00:00,46,42,4,ECO_300019380
642,Herenthoutsesteenweg 2,2021-11-08,08:00:00,167,163,4,ECO_300019380
642,Herenthoutsesteenweg 2,2021-11-08,09:00:00,515,511,4,ECO_300019380
642,Herenthoutsesteenweg 2,2021-11-08,10:00:00,63,62,1,ECO_300019380
642,Herenthoutsesteenweg 2,2021-11-08,11:00:00,48,46,2,ECO_300019380
642,Herenthoutsesteenweg 2,2021-11-08,12:00:00,52,50,2,ECO_300019380
642,Herenthoutsesteenweg 2,2021-11-08,13:00:00,57,52,5,ECO_300019380
642,Herenthoutsesteenweg 2,2021-11-08,14:00:00,102,95,7,ECO_300019380
642,Herenthoutsesteenweg 2,2021-11-08,15:00:00,100,91,9,ECO_300019380
642,Herenthoutsesteenweg 2,2021-11-08,16:00:00,88,78,10,ECO_300019380
642,Herenthoutsesteenweg 2,2021-11-08,17:00:00,105,95,10,ECO_300019380
642,Herenthoutsesteenweg 2,2021-11-08,18:00:00,62,55,7,ECO_300019380
642,Herenthoutsesteenweg 2,2021-11-08,19:00:00,25,23,2,ECO_300019380
642,Herenthoutsesteenweg 2,2021-11-08,20:00:00,29,28,1,ECO_300019380
642,Herenthoutsesteenweg 2,2021-11-08,21:00:00,11,8,3,ECO_300019380
642,Herenthoutsesteenweg 2,2021-11-08,22:00:00,3,2,1,ECO_300019380
642,Herenthoutsesteenweg 2,2021-11-08,23:00:00,10,8,2,ECO_300019380
642,Herenthoutsesteenweg 2,2021-11-09,00:00:00,4,3,1,ECO_300019380
642,Herenthoutsesteenweg 2,2021-11-09,01:00:00,1,1,0,ECO_300019380
642,Herenthoutsesteenweg 2,2021-11-09,02:00:00,0,0,0,ECO_300019380
642,Herenthoutsesteenweg 2,2021-11-09,03:00:00,0,0,0,ECO_300019380
642,Herenthoutsesteenweg 2,2021-11-09,04:00:00,1,1,0,ECO_300019380
642,Herenthoutsesteenweg 2,2021-11-09,05:00:00,4,4,0,ECO_300019380
642,Herenthoutsesteenweg 2,2021-11-09,06:00:00,19,17,2,ECO_300019380
642,Herenthoutsesteenweg 2,2021-11-09,07:00:00,36,34,2,ECO_300019380
642,Herenthoutsesteenweg 2,2021-11-09,08:00:00,162,160,2,ECO_300019380
642,Herenthoutsesteenweg 2,2021-11-09,09:00:00,522,516,6,ECO_300019380
642,Herenthoutsesteenweg 2,2021-11-09,10:00:00,84,81,3,ECO_300019380
642,Herenthoutsesteenweg 2,2021-11-09,11:00:00,59,57,2,ECO_300019380
642,Herenthoutsesteenweg 2,2021-11-09,12:00:00,59,52,7,ECO_300019380
642,Herenthoutsesteenweg 2,2021-11-09,13:00:00,94,86,8,ECO_300019380
642,Herenthoutsesteenweg 2,2021-11-09,14:00:00,132,125,7,ECO_300019380
642,Herenthoutsesteenweg 2,2021-11-09,15:00:00,126,120,6,ECO_300019380
642,Herenthoutsesteenweg 2,2021-11-09,16:00:00,114,105,9,ECO_300019380
642,Herenthoutsesteenweg 2,2021-11-09,17:00:00,105,95,10,ECO_300019380
642,Herenthoutsesteenweg 2,2021-11-09,18:00:00,69,64,5,ECO_300019380
642,Herenthoutsesteenweg 2,2021-11-09,19:00:00,28,26,2,ECO_300019380
642,Herenthoutsesteenweg 2,2021-11-09,20:00:00,18,14,4,ECO_300019380
642,Herenthoutsesteenweg 2,2021-11-09,21:00:00,18,15,3,ECO_300019380
642,Herenthoutsesteenweg 2,2021-11-09,22:00:00,11,7,4,ECO_300019380
642,Herenthoutsesteenweg 2,2021-11-09,23:00:00,14,13,1,ECO_300019380
642,Herenthoutsesteenweg 2,2021-11-10,00:00:00,2,1,1,ECO_300019380
642,Herenthoutsesteenweg 2,2021-11-10,01:00:00,0,0,0,ECO_300019380
642,Herenthoutsesteenweg 2,2021-11-10,02:00:00,0,0,0,ECO_300019380
642,Herenthoutsesteenweg 2,2021-11-10,03:00:00,0,0,0,ECO_300019380
642,Herenthoutsesteenweg 2,2021-11-10,04:00:00,0,0,0,ECO_300019380
642,Herenthoutsesteenweg 2,2021-11-10,05:00:00,3,3,0,ECO_300019380
642,Herenthoutsesteenweg 2,2021-11-10,06:00:00,17,16,1,ECO_300019380
642,Herenthoutsesteenweg 2,2021-11-10,07:00:00,38,35,3,ECO_300019380
642,Herenthoutsesteenweg 2,2021-11-10,08:00:00,139,135,4,ECO_300019380
642,Herenthoutsesteenweg 2,2021-11-10,09:00:00,519,511,8,ECO_300019380
642,Herenthoutsesteenweg 2,2021-11-10,10:00:00,88,87,1,ECO_300019380
642,Herenthoutsesteenweg 2,2021-11-10,11:00:00,53,48,5,ECO_300019380
642,Herenthoutsesteenweg 2,2021-11-10,12:00:00,63,56,7,ECO_300019380
642,Herenthoutsesteenweg 2,2021-11-10,13:00:00,120,105,15,ECO_300019380
642,Herenthoutsesteenweg 2,2021-11-10,14:00:00,121,113,8,ECO_300019380
642,Herenthoutsesteenweg 2,2021-11-10,15:00:00,125,118,7,ECO_300019380
642,Herenthoutsesteenweg 2,2021-11-10,16:00:00,84,77,7,ECO_300019380
642,Herenthoutsesteenweg 2,2021-11-10,17:00:00,80,68,12,ECO_300019380
642,Herenthoutsesteenweg 2,2021-11-10,18:00:00,54,47,7,ECO_300019380
642,Herenthoutsesteenweg 2,2021-11-10,19:00:00,27,24,3,ECO_300019380
642,Herenthoutsesteenweg 2,2021-11-10,20:00:00,30,26,4,ECO_300019380
642,Herenthoutsesteenweg 2,2021-11-10,21:00:00,30,29,1,ECO_300019380
642,Herenthoutsesteenweg 2,2021-11-10,22:00:00,9,5,4,ECO_300019380
642,Herenthoutsesteenweg 2,2021-11-10,23:00:00,14,12,2,ECO_300019380
642,Herenthoutsesteenweg 2,2021-11-11,00:00:00,6,5,1,ECO_300019380
642,Herenthoutsesteenweg 2,2021-11-11,01:00:00,6,5,1,ECO_300019380
642,Herenthoutsesteenweg 2,2021-11-11,02:00:00,10,10,0,ECO_300019380
642,Herenthoutsesteenweg 2,2021-11-11,03:00:00,3,3,0,ECO_300019380
642,Herenthoutsesteenweg 2,2021-11-11,04:00:00,7,7,0,ECO_300019380
642,Herenthoutsesteenweg 2,2021-11-11,05:00:00,1,0,1,ECO_300019380
642,Herenthoutsesteenweg 2,2021-11-11,06:00:00,4,3,1,ECO_300019380
642,Herenthoutsesteenweg 2,2021-11-11,07:00:00,11,9,2,ECO_300019380
642,Herenthoutsesteenweg 2,2021-11-11,08:00:00,4,3,1,ECO_300019380
642,Herenthoutsesteenweg 2,2021-11-11,09:00:00,31,30,1,ECO_300019380
642,Herenthoutsesteenweg 2,2021-11-11,10:00:00,44,43,1,ECO_300019380
642,Herenthoutsesteenweg 2,2021-11-11,11:00:00,41,38,3,ECO_300019380
642,Herenthoutsesteenweg 2,2021-11-11,12:00:00,59,48,11,ECO_300019380
642,Herenthoutsesteenweg 2,2021-11-11,13:00:00,71,62,9,ECO_300019380
642,Herenthoutsesteenweg 2,2021-11-11,14:00:00,57,56,1,ECO_300019380
642,Herenthoutsesteenweg 2,2021-11-11,15:00:00,45,40,5,ECO_300019380
642,Herenthoutsesteenweg 2,2021-11-11,16:00:00,44,40,4,ECO_300019380
642,Herenthoutsesteenweg 2,2021-11-11,17:00:00,45,44,1,ECO_300019380
642,Herenthoutsesteenweg 2,2021-11-11,18:00:00,29,28,1,ECO_300019380
642,Herenthoutsesteenweg 2,2021-11-11,19:00:00,19,16,3,ECO_300019380
642,Herenthoutsesteenweg 2,2021-11-11,20:00:00,9,8,1,ECO_300019380
642,Herenthoutsesteenweg 2,2021-11-11,21:00:00,9,5,4,ECO_300019380
642,Herenthoutsesteenweg 2,2021-11-11,22:00:00,3,2,1,ECO_300019380
642,Herenthoutsesteenweg 2,2021-11-11,23:00:00,6,2,4,ECO_300019380
642,Herenthoutsesteenweg 2,2021-11-12,00:00:00,2,1,1,ECO_300019380
642,Herenthoutsesteenweg 2,2021-11-12,01:00:00,1,1,0,ECO_300019380
642,Herenthoutsesteenweg 2,2021-11-12,02:00:00,4,4,0,ECO_300019380
642,Herenthoutsesteenweg 2,2021-11-12,03:00:00,0,0,0,ECO_300019380
642,Herenthoutsesteenweg 2,2021-11-12,04:00:00,0,0,0,ECO_300019380
642,Herenthoutsesteenweg 2,2021-11-12,05:00:00,0,0,0,ECO_300019380
642,Herenthoutsesteenweg 2,2021-11-12,06:00:00,13,10,3,ECO_300019380
642,Herenthoutsesteenweg 2,2021-11-12,07:00:00,13,12,1,ECO_300019380
642,Herenthoutsesteenweg 2,2021-11-12,08:00:00,66,63,3,ECO_300019380
642,Herenthoutsesteenweg 2,2021-11-12,09:00:00,421,416,5,ECO_300019380
642,Herenthoutsesteenweg 2,2021-11-12,10:00:00,78,76,2,ECO_300019380
642,Herenthoutsesteenweg 2,2021-11-12,11:00:00,66,63,3,ECO_300019380
642,Herenthoutsesteenweg 2,2021-11-12,12:00:00,66,66,0,ECO_300019380
642,Herenthoutsesteenweg 2,2021-11-12,13:00:00,69,61,8,ECO_300019380
642,Herenthoutsesteenweg 2,2021-11-12,14:00:00,89,85,4,ECO_300019380
642,Herenthoutsesteenweg 2,2021-11-12,15:00:00,89,79,10,ECO_300019380
642,Herenthoutsesteenweg 2,2021-11-12,16:00:00,117,110,7,ECO_300019380
642,Herenthoutsesteenweg 2,2021-11-12,17:00:00,71,66,5,ECO_300019380
642,Herenthoutsesteenweg 2,2021-11-12,18:00:00,39,35,4,ECO_300019380
642,Herenthoutsesteenweg 2,2021-11-12,19:00:00,27,26,1,ECO_300019380
642,Herenthoutsesteenweg 2,2021-11-12,20:00:00,28,22,6,ECO_300019380
642,Herenthoutsesteenweg 2,2021-11-12,21:00:00,31,30,1,ECO_300019380
642,Herenthoutsesteenweg 2,2021-11-12,22:00:00,12,10,2,ECO_300019380
642,Herenthoutsesteenweg 2,2021-11-12,23:00:00,19,16,3,ECO_300019380
642,Herenthoutsesteenweg 2,2021-11-13,00:00:00,9,8,1,ECO_300019380
642,Herenthoutsesteenweg 2,2021-11-13,01:00:00,6,3,3,ECO_300019380
642,Herenthoutsesteenweg 2,2021-11-13,02:00:00,10,6,4,ECO_300019380
642,Herenthoutsesteenweg 2,2021-11-13,03:00:00,1,0,1,ECO_300019380
642,Herenthoutsesteenweg 2,2021-11-13,04:00:00,0,0,0,ECO_300019380
642,Herenthoutsesteenweg 2,2021-11-13,05:00:00,0,0,0,ECO_300019380
642,Herenthoutsesteenweg 2,2021-11-13,06:00:00,2,2,0,ECO_300019380
642,Herenthoutsesteenweg 2,2021-11-13,07:00:00,2,2,0,ECO_300019380
642,Herenthoutsesteenweg 2,2021-11-13,08:00:00,5,4,1,ECO_300019380
642,Herenthoutsesteenweg 2,2021-11-13,09:00:00,10,9,1,ECO_300019380
642,Herenthoutsesteenweg 2,2021-11-13,10:00:00,27,26,1,ECO_300019380
642,Herenthoutsesteenweg 2,2021-11-13,11:00:00,24,22,2,ECO_300019380
642,Herenthoutsesteenweg 2,2021-11-13,12:00:00,30,25,5,ECO_300019380
642,Herenthoutsesteenweg 2,2021-11-13,13:00:00,36,30,6,ECO_300019380
642,Herenthoutsesteenweg 2,2021-11-13,14:00:00,77,73,4,ECO_300019380
642,Herenthoutsesteenweg 2,2021-11-13,15:00:00,51,47,4,ECO_300019380
642,Herenthoutsesteenweg 2,2021-11-13,16:00:00,32,29,3,ECO_300019380
642,Herenthoutsesteenweg 2,2021-11-13,17:00:00,25,23,2,ECO_300019380
642,Herenthoutsesteenweg 2,2021-11-13,18:00:00,16,10,6,ECO_300019380
642,Herenthoutsesteenweg 2,2021-11-13,19:00:00,34,33,1,ECO_300019380
642,Herenthoutsesteenweg 2,2021-11-13,20:00:00,26,24,2,ECO_300019380
642,Herenthoutsesteenweg 2,2021-11-13,21:00:00,24,20,4,ECO_300019380
642,Herenthoutsesteenweg 2,2021-11-13,22:00:00,12,11,1,ECO_300019380
642,Herenthoutsesteenweg 2,2021-11-13,23:00:00,12,10,2,ECO_300019380
642,Herenthoutsesteenweg 2,2021-11-14,00:00:00,3,1,2,ECO_300019380
642,Herenthoutsesteenweg 2,2021-11-14,01:00:00,3,1,2,ECO_300019380
642,Herenthoutsesteenweg 2,2021-11-14,02:00:00,6,5,1,ECO_300019380
642,Herenthoutsesteenweg 2,2021-11-14,03:00:00,3,2,1,ECO_300019380
642,Herenthoutsesteenweg 2,2021-11-14,04:00:00,3,3,0,ECO_300019380
642,Herenthoutsesteenweg 2,2021-11-14,05:00:00,2,1,1,ECO_300019380
642,Herenthoutsesteenweg 2,2021-11-14,06:00:00,1,1,0,ECO_300019380
642,Herenthoutsesteenweg 2,2021-11-14,07:00:00,9,9,0,ECO_300019380
642,Herenthoutsesteenweg 2,2021-11-14,08:00:00,17,16,1,ECO_300019380
642,Herenthoutsesteenweg 2,2021-11-14,09:00:00,36,35,1,ECO_300019380
642,Herenthoutsesteenweg 2,2021-11-14,10:00:00,81,76,5,ECO_300019380
642,Herenthoutsesteenweg 2,2021-11-14,11:00:00,72,67,5,ECO_300019380
642,Herenthoutsesteenweg 2,2021-11-14,12:00:00,50,38,12,ECO_300019380
642,Herenthoutsesteenweg 2,2021-11-14,13:00:00,49,41,8,ECO_300019380
642,Herenthoutsesteenweg 2,2021-11-14,14:00:00,45,40,5,ECO_300019380
642,Herenthoutsesteenweg 2,2021-11-14,15:00:00,53,51,2,ECO_300019380
642,Herenthoutsesteenweg 2,2021-11-14,16:00:00,37,33,4,ECO_300019380
642,Herenthoutsesteenweg 2,2021-11-14,17:00:00,27,24,3,ECO_300019380
642,Herenthoutsesteenweg 2,2021-11-14,18:00:00,16,15,1,ECO_300019380
642,Herenthoutsesteenweg 2,2021-11-14,19:00:00,20,19,1,ECO_300019380
642,Herenthoutsesteenweg 2,2021-11-14,20:00:00,14,13,1,ECO_300019380
642,Herenthoutsesteenweg 2,2021-11-14,21:00:00,10,10,0,ECO_300019380
642,Herenthoutsesteenweg 2,2021-11-14,22:00:00,5,5,0,ECO_300019380
642,Herenthoutsesteenweg 2,2021-11-14,23:00:00,2,2,0,ECO_300019380
642,Herenthoutsesteenweg 2,2021-11-15,00:00:00,2,1,1,ECO_300019380
642,Herenthoutsesteenweg 2,2021-11-15,01:00:00,0,0,0,ECO_300019380
642,Herenthoutsesteenweg 2,2021-11-15,02:00:00,0,0,0,ECO_300019380
642,Herenthoutsesteenweg 2,2021-11-15,03:00:00,1,1,0,ECO_300019380
642,Herenthoutsesteenweg 2,2021-11-15,04:00:00,0,0,0,ECO_300019380
642,Herenthoutsesteenweg 2,2021-11-15,05:00:00,1,1,0,ECO_300019380
642,Herenthoutsesteenweg 2,2021-11-15,06:00:00,13,13,0,ECO_300019380
642,Herenthoutsesteenweg 2,2021-11-15,07:00:00,30,28,2,ECO_300019380
642,Herenthoutsesteenweg 2,2021-11-15,08:00:00,114,112,2,ECO_300019380
642,Herenthoutsesteenweg 2,2021-11-15,09:00:00,548,540,8,ECO_300019380
642,Herenthoutsesteenweg 2,2021-11-15,10:00:00,64,64,0,ECO_300019380
642,Herenthoutsesteenweg 2,2021-11-15,11:00:00,52,51,1,ECO_300019380
642,Herenthoutsesteenweg 2,2021-11-15,12:00:00,46,42,4,ECO_300019380
642,Herenthoutsesteenweg 2,2021-11-15,13:00:00,49,45,4,ECO_300019380
642,Herenthoutsesteenweg 2,2021-11-15,14:00:00,79,74,5,ECO_300019380
642,Herenthoutsesteenweg 2,2021-11-15,15:00:00,52,48,4,ECO_300019380
642,Herenthoutsesteenweg 2,2021-11-15,16:00:00,77,70,7,ECO_300019380
642,Herenthoutsesteenweg 2,2021-11-15,17:00:00,86,74,12,ECO_300019380
642,Herenthoutsesteenweg 2,2021-11-15,18:00:00,55,52,3,ECO_300019380
642,Herenthoutsesteenweg 2,2021-11-15,19:00:00,26,24,2,ECO_300019380
642,Herenthoutsesteenweg 2,2021-11-15,20:00:00,17,16,1,ECO_300019380
642,Herenthoutsesteenweg 2,2021-11-15,21:00:00,5,5,0,ECO_300019380
642,Herenthoutsesteenweg 2,2021-11-15,22:00:00,6,5,1,ECO_300019380
642,Herenthoutsesteenweg 2,2021-11-15,23:00:00,11,9,2,ECO_300019380
642,Herenthoutsesteenweg 2,2021-11-16,00:00:00,4,3,1,ECO_300019380
642,Herenthoutsesteenweg 2,2021-11-16,01:00:00,1,0,1,ECO_300019380
642,Herenthoutsesteenweg 2,2021-11-16,02:00:00,1,1,0,ECO_300019380
642,Herenthoutsesteenweg 2,2021-11-16,03:00:00,0,0,0,ECO_300019380
642,Herenthoutsesteenweg 2,2021-11-16,04:00:00,0,0,0,ECO_300019380
642,Herenthoutsesteenweg 2,2021-11-16,05:00:00,2,2,0,ECO_300019380
642,Herenthoutsesteenweg 2,2021-11-16,06:00:00,14,14,0,ECO_300019380
642,Herenthoutsesteenweg 2,2021-11-16,07:00:00,42,40,2,ECO_300019380
642,Herenthoutsesteenweg 2,2021-11-16,08:00:00,149,148,1,ECO_300019380
642,Herenthoutsesteenweg 2,2021-11-16,09:00:00,482,479,3,ECO_300019380
642,Herenthoutsesteenweg 2,2021-11-16,10:00:00,86,83,3,ECO_300019380
642,Herenthoutsesteenweg 2,2021-11-16,11:00:00,56,54,2,ECO_300019380
642,Herenthoutsesteenweg 2,2021-11-16,12:00:00,40,38,2,ECO_300019380
642,Herenthoutsesteenweg 2,2021-11-16,13:00:00,49,43,6,ECO_300019380
642,Herenthoutsesteenweg 2,2021-11-16,14:00:00,75,71,4,ECO_300019380
642,Herenthoutsesteenweg 2,2021-11-16,15:00:00,46,43,3,ECO_300019380
642,Herenthoutsesteenweg 2,2021-11-16,16:00:00,85,83,2,ECO_300019380
642,Herenthoutsesteenweg 2,2021-11-16,17:00:00,77,62,15,ECO_300019380
642,Herenthoutsesteenweg 2,2021-11-16,18:00:00,55,52,3,ECO_300019380
642,Herenthoutsesteenweg 2,2021-11-16,19:00:00,23,21,2,ECO_300019380
642,Herenthoutsesteenweg 2,2021-11-16,20:00:00,11,9,2,ECO_300019380
642,Herenthoutsesteenweg 2,2021-11-16,21:00:00,11,10,1,ECO_300019380
642,Herenthoutsesteenweg 2,2021-11-16,22:00:00,6,6,0,ECO_300019380
642,Herenthoutsesteenweg 2,2021-11-16,23:00:00,13,12,1,ECO_300019380
642,Herenthoutsesteenweg 2,2021-11-17,00:00:00,1,1,0,ECO_300019380
642,Herenthoutsesteenweg 2,2021-11-17,01:00:00,0,0,0,ECO_300019380
642,Herenthoutsesteenweg 2,2021-11-17,02:00:00,3,3,0,ECO_300019380
642,Herenthoutsesteenweg 2,2021-11-17,03:00:00,0,0,0,ECO_300019380
642,Herenthoutsesteenweg 2,2021-11-17,04:00:00,0,0,0,ECO_300019380
642,Herenthoutsesteenweg 2,2021-11-17,05:00:00,3,3,0,ECO_300019380
642,Herenthoutsesteenweg 2,2021-11-17,06:00:00,17,15,2,ECO_300019380
642,Herenthoutsesteenweg 2,2021-11-17,07:00:00,46,42,4,ECO_300019380
642,Herenthoutsesteenweg 2,2021-11-17,08:00:00,131,131,0,ECO_300019380
642,Herenthoutsesteenweg 2,2021-11-17,09:00:00,478,466,12,ECO_300019380
642,Herenthoutsesteenweg 2,2021-11-17,10:00:00,62,59,3,ECO_300019380
642,Herenthoutsesteenweg 2,2021-11-17,11:00:00,34,29,5,ECO_300019380
642,Herenthoutsesteenweg 2,2021-11-17,12:00:00,30,28,2,ECO_300019380
642,Herenthoutsesteenweg 2,2021-11-17,13:00:00,83,75,8,ECO_300019380
642,Herenthoutsesteenweg 2,2021-11-17,14:00:00,90,81,9,ECO_300019380
642,Herenthoutsesteenweg 2,2021-11-17,15:00:00,80,75,5,ECO_300019380
642,Herenthoutsesteenweg 2,2021-11-17,16:00:00,43,35,8,ECO_300019380
642,Herenthoutsesteenweg 2,2021-11-17,17:00:00,92,79,13,ECO_300019380
642,Herenthoutsesteenweg 2,2021-11-17,18:00:00,35,33,2,ECO_300019380
642,Herenthoutsesteenweg 2,2021-11-17,19:00:00,23,21,2,ECO_300019380
642,Herenthoutsesteenweg 2,2021-11-17,20:00:00,29,27,2,ECO_300019380
642,Herenthoutsesteenweg 2,2021-11-17,21:00:00,17,12,5,ECO_300019380
642,Herenthoutsesteenweg 2,2021-11-17,22:00:00,5,3,2,ECO_300019380
642,Herenthoutsesteenweg 2,2021-11-17,23:00:00,19,16,3,ECO_300019380
642,Herenthoutsesteenweg 2,2021-11-18,00:00:00,1,0,1,ECO_300019380
642,Herenthoutsesteenweg 2,2021-11-18,01:00:00,4,2,2,ECO_300019380
642,Herenthoutsesteenweg 2,2021-11-18,02:00:00,0,0,0,ECO_300019380
642,Herenthoutsesteenweg 2,2021-11-18,03:00:00,0,0,0,ECO_300019380
642,Herenthoutsesteenweg 2,2021-11-18,04:00:00,0,0,0,ECO_300019380
642,Herenthoutsesteenweg 2,2021-11-18,05:00:00,4,4,0,ECO_300019380
642,Herenthoutsesteenweg 2,2021-11-18,06:00:00,13,11,2,ECO_300019380
642,Herenthoutsesteenweg 2,2021-11-18,07:00:00,43,42,1,ECO_300019380
642,Herenthoutsesteenweg 2,2021-11-18,08:00:00,129,126,3,ECO_300019380
642,Herenthoutsesteenweg 2,2021-11-18,09:00:00,512,502,10,ECO_300019380
642,Herenthoutsesteenweg 2,2021-11-18,10:00:00,86,85,1,ECO_300019380
642,Herenthoutsesteenweg 2,2021-11-18,11:00:00,50,47,3,ECO_300019380
642,Herenthoutsesteenweg 2,2021-11-18,12:00:00,42,39,3,ECO_300019380
642,Herenthoutsesteenweg 2,2021-11-18,13:00:00,56,52,4,ECO_300019380
642,Herenthoutsesteenweg 2,2021-11-18,14:00:00,86,81,5,ECO_300019380
642,Herenthoutsesteenweg 2,2021-11-18,15:00:00,101,92,9,ECO_300019380
642,Herenthoutsesteenweg 2,2021-11-18,16:00:00,107,97,10,ECO_300019380
642,Herenthoutsesteenweg 2,2021-11-18,17:00:00,87,73,14,ECO_300019380
642,Herenthoutsesteenweg 2,2021-11-18,18:00:00,37,33,4,ECO_300019380
642,Herenthoutsesteenweg 2,2021-11-18,19:00:00,32,32,0,ECO_300019380
642,Herenthoutsesteenweg 2,2021-11-18,20:00:00,22,21,1,ECO_300019380
642,Herenthoutsesteenweg 2,2021-11-18,21:00:00,9,8,1,ECO_300019380
642,Herenthoutsesteenweg 2,2021-11-18,22:00:00,6,4,2,ECO_300019380
642,Herenthoutsesteenweg 2,2021-11-18,23:00:00,21,19,2,ECO_300019380
642,Herenthoutsesteenweg 2,2021-11-19,00:00:00,3,2,1,ECO_300019380
642,Herenthoutsesteenweg 2,2021-11-19,01:00:00,1,1,0,ECO_300019380
642,Herenthoutsesteenweg 2,2021-11-19,02:00:00,0,0,0,ECO_300019380
642,Herenthoutsesteenweg 2,2021-11-19,03:00:00,0,0,0,ECO_300019380
642,Herenthoutsesteenweg 2,2021-11-19,04:00:00,1,1,0,ECO_300019380
642,Herenthoutsesteenweg 2,2021-11-19,05:00:00,6,6,0,ECO_300019380
642,Herenthoutsesteenweg 2,2021-11-19,06:00:00,12,12,0,ECO_300019380
642,Herenthoutsesteenweg 2,2021-11-19,07:00:00,36,34,2,ECO_300019380
642,Herenthoutsesteenweg 2,2021-11-19,08:00:00,135,134,1,ECO_300019380
642,Herenthoutsesteenweg 2,2021-11-19,09:00:00,472,469,3,ECO_300019380
642,Herenthoutsesteenweg 2,2021-11-19,10:00:00,86,84,2,ECO_300019380
642,Herenthoutsesteenweg 2,2021-11-19,11:00:00,95,90,5,ECO_300019380
642,Herenthoutsesteenweg 2,2021-11-19,12:00:00,59,55,4,ECO_300019380
642,Herenthoutsesteenweg 2,2021-11-19,13:00:00,60,58,2,ECO_300019380
642,Herenthoutsesteenweg 2,2021-11-19,14:00:00,63,58,5,ECO_300019380
642,Herenthoutsesteenweg 2,2021-11-19,15:00:00,84,78,6,ECO_300019380
642,Herenthoutsesteenweg 2,2021-11-19,16:00:00,100,93,7,ECO_300019380
642,Herenthoutsesteenweg 2,2021-11-19,17:00:00,85,68,17,ECO_300019380
642,Herenthoutsesteenweg 2,2021-11-19,18:00:00,59,57,2,ECO_300019380
642,Herenthoutsesteenweg 2,2021-11-19,19:00:00,30,27,3,ECO_300019380
642,Herenthoutsesteenweg 2,2021-11-19,20:00:00,23,21,2,ECO_300019380
642,Herenthoutsesteenweg 2,2021-11-19,21:00:00,19,18,1,ECO_300019380
642,Herenthoutsesteenweg 2,2021-11-19,22:00:00,15,15,0,ECO_300019380
642,Herenthoutsesteenweg 2,2021-11-19,23:00:00,25,24,1,ECO_300019380
642,Herenthoutsesteenweg 2,2021-11-20,00:00:00,7,6,1,ECO_300019380
642,Herenthoutsesteenweg 2,2021-11-20,01:00:00,7,6,1,ECO_300019380
642,Herenthoutsesteenweg 2,2021-11-20,02:00:00,9,8,1,ECO_300019380
642,Herenthoutsesteenweg 2,2021-11-20,03:00:00,5,3,2,ECO_300019380
642,Herenthoutsesteenweg 2,2021-11-20,04:00:00,4,2,2,ECO_300019380
642,Herenthoutsesteenweg 2,2021-11-20,05:00:00,2,2,0,ECO_300019380
642,Herenthoutsesteenweg 2,2021-11-20,06:00:00,2,2,0,ECO_300019380
642,Herenthoutsesteenweg 2,2021-11-20,07:00:00,6,6,0,ECO_300019380
642,Herenthoutsesteenweg 2,2021-11-20,08:00:00,7,6,1,ECO_300019380
642,Herenthoutsesteenweg 2,2021-11-20,09:00:00,37,33,4,ECO_300019380
642,Herenthoutsesteenweg 2,2021-11-20,10:00:00,51,51,0,ECO_300019380
642,Herenthoutsesteenweg 2,2021-11-20,11:00:00,76,70,6,ECO_300019380
642,Herenthoutsesteenweg 2,2021-11-20,12:00:00,65,55,10,ECO_300019380
642,Herenthoutsesteenweg 2,2021-11-20,13:00:00,59,49,10,ECO_300019380
642,Herenthoutsesteenweg 2,2021-11-20,14:00:00,100,96,4,ECO_300019380
642,Herenthoutsesteenweg 2,2021-11-20,15:00:00,71,70,1,ECO_300019380
642,Herenthoutsesteenweg 2,2021-11-20,16:00:00,57,52,5,ECO_300019380
642,Herenthoutsesteenweg 2,2021-11-20,17:00:00,47,40,7,ECO_300019380
642,Herenthoutsesteenweg 2,2021-11-20,18:00:00,27,26,1,ECO_300019380
642,Herenthoutsesteenweg 2,2021-11-20,19:00:00,32,32,0,ECO_300019380
642,Herenthoutsesteenweg 2,2021-11-20,20:00:00,26,25,1,ECO_300019380
642,Herenthoutsesteenweg 2,2021-11-20,21:00:00,15,14,1,ECO_300019380
642,Herenthoutsesteenweg 2,2021-11-20,22:00:00,11,11,0,ECO_300019380
642,Herenthoutsesteenweg 2,2021-11-20,23:00:00,14,9,5,ECO_300019380
642,Herenthoutsesteenweg 2,2021-11-21,00:00:00,9,7,2,ECO_300019380
642,Herenthoutsesteenweg 2,2021-11-21,01:00:00,5,3,2,ECO_300019380
642,Herenthoutsesteenweg 2,2021-11-21,02:00:00,13,11,2,ECO_300019380
642,Herenthoutsesteenweg 2,2021-11-21,03:00:00,1,1,0,ECO_300019380
642,Herenthoutsesteenweg 2,2021-11-21,04:00:00,4,3,1,ECO_300019380
642,Herenthoutsesteenweg 2,2021-11-21,05:00:00,3,2,1,ECO_300019380
642,Herenthoutsesteenweg 2,2021-11-21,06:00:00,5,3,2,ECO_300019380
642,Herenthoutsesteenweg 2,2021-11-21,07:00:00,1,1,0,ECO_300019380
642,Herenthoutsesteenweg 2,2021-11-21,08:00:00,6,6,0,ECO_300019380
642,Herenthoutsesteenweg 2,2021-11-21,09:00:00,17,17,0,ECO_300019380
642,Herenthoutsesteenweg 2,2021-11-21,10:00:00,38,33,5,ECO_300019380
642,Herenthoutsesteenweg 2,2021-11-21,11:00:00,43,39,4,ECO_300019380
642,Herenthoutsesteenweg 2,2021-11-21,12:00:00,25,22,3,ECO_300019380
642,Herenthoutsesteenweg 2,2021-11-21,13:00:00,26,19,7,ECO_300019380
642,Herenthoutsesteenweg 2,2021-11-21,14:00:00,41,36,5,ECO_300019380
642,Herenthoutsesteenweg 2,2021-11-21,15:00:00,59,54,5,ECO_300019380
642,Herenthoutsesteenweg 2,2021-11-21,16:00:00,26,22,4,ECO_300019380
642,Herenthoutsesteenweg 2,2021-11-21,17:00:00,30,27,3,ECO_300019380
642,Herenthoutsesteenweg 2,2021-11-21,18:00:00,10,10,0,ECO_300019380
642,Herenthoutsesteenweg 2,2021-11-21,19:00:00,13,11,2,ECO_300019380
642,Herenthoutsesteenweg 2,2021-11-21,20:00:00,12,11,1,ECO_300019380
642,Herenthoutsesteenweg 2,2021-11-21,21:00:00,8,7,1,ECO_300019380
642,Herenthoutsesteenweg 2,2021-11-21,22:00:00,3,3,0,ECO_300019380
642,Herenthoutsesteenweg 2,2021-11-21,23:00:00,2,2,0,ECO_300019380
642,Herenthoutsesteenweg 2,2021-11-22,00:00:00,2,2,0,ECO_300019380
642,Herenthoutsesteenweg 2,2021-11-22,01:00:00,0,0,0,ECO_300019380
642,Herenthoutsesteenweg 2,2021-11-22,02:00:00,1,1,0,ECO_300019380
642,Herenthoutsesteenweg 2,2021-11-22,03:00:00,0,0,0,ECO_300019380
642,Herenthoutsesteenweg 2,2021-11-22,04:00:00,0,0,0,ECO_300019380
642,Herenthoutsesteenweg 2,2021-11-22,05:00:00,6,5,1,ECO_300019380
642,Herenthoutsesteenweg 2,2021-11-22,06:00:00,17,14,3,ECO_300019380
642,Herenthoutsesteenweg 2,2021-11-22,07:00:00,37,31,6,ECO_300019380
642,Herenthoutsesteenweg 2,2021-11-22,08:00:00,112,110,2,ECO_300019380
642,Herenthoutsesteenweg 2,2021-11-22,09:00:00,534,528,6,ECO_300019380
642,Herenthoutsesteenweg 2,2021-11-22,10:00:00,69,65,4,ECO_300019380
642,Herenthoutsesteenweg 2,2021-11-22,11:00:00,58,57,1,ECO_300019380
642,Herenthoutsesteenweg 2,2021-11-22,12:00:00,41,36,5,ECO_300019380
642,Herenthoutsesteenweg 2,2021-11-22,13:00:00,62,58,4,ECO_300019380
642,Herenthoutsesteenweg 2,2021-11-22,14:00:00,103,97,6,ECO_300019380
642,Herenthoutsesteenweg 2,2021-11-22,15:00:00,77,69,8,ECO_300019380
642,Herenthoutsesteenweg 2,2021-11-22,16:00:00,79,73,6,ECO_300019380
642,Herenthoutsesteenweg 2,2021-11-22,17:00:00,94,83,11,ECO_300019380
642,Herenthoutsesteenweg 2,2021-11-22,18:00:00,57,53,4,ECO_300019380
642,Herenthoutsesteenweg 2,2021-11-22,19:00:00,16,14,2,ECO_300019380
642,Herenthoutsesteenweg 2,2021-11-22,20:00:00,20,19,1,ECO_300019380
642,Herenthoutsesteenweg 2,2021-11-22,21:00:00,13,11,2,ECO_300019380
642,Herenthoutsesteenweg 2,2021-11-22,22:00:00,3,3,0,ECO_300019380
642,Herenthoutsesteenweg 2,2021-11-22,23:00:00,10,7,3,ECO_300019380
642,Herenthoutsesteenweg 2,2021-11-23,00:00:00,4,0,4,ECO_300019380
642,Herenthoutsesteenweg 2,2021-11-23,01:00:00,1,1,0,ECO_300019380
642,Herenthoutsesteenweg 2,2021-11-23,02:00:00,0,0,0,ECO_300019380
642,Herenthoutsesteenweg 2,2021-11-23,03:00:00,1,1,0,ECO_300019380
642,Herenthoutsesteenweg 2,2021-11-23,04:00:00,0,0,0,ECO_300019380
642,Herenthoutsesteenweg 2,2021-11-23,05:00:00,6,6,0,ECO_300019380
642,Herenthoutsesteenweg 2,2021-11-23,06:00:00,20,16,4,ECO_300019380
642,Herenthoutsesteenweg 2,2021-11-23,07:00:00,39,38,1,ECO_300019380
642,Herenthoutsesteenweg 2,2021-11-23,08:00:00,113,112,1,ECO_300019380
642,Herenthoutsesteenweg 2,2021-11-23,09:00:00,516,509,7,ECO_300019380
642,Herenthoutsesteenweg 2,2021-11-23,10:00:00,66,63,3,ECO_300019380
642,Herenthoutsesteenweg 2,2021-11-23,11:00:00,52,50,2,ECO_300019380
642,Herenthoutsesteenweg 2,2021-11-23,12:00:00,38,37,1,ECO_300019380
642,Herenthoutsesteenweg 2,2021-11-23,13:00:00,61,58,3,ECO_300019380
642,Herenthoutsesteenweg 2,2021-11-23,14:00:00,82,69,13,ECO_300019380
642,Herenthoutsesteenweg 2,2021-11-23,15:00:00,66,64,2,ECO_300019380
642,Herenthoutsesteenweg 2,2021-11-23,16:00:00,82,77,5,ECO_300019380
642,Herenthoutsesteenweg 2,2021-11-23,17:00:00,75,66,9,ECO_300019380
642,Herenthoutsesteenweg 2,2021-11-23,18:00:00,55,48,7,ECO_300019380
642,Herenthoutsesteenweg 2,2021-11-23,19:00:00,14,11,3,ECO_300019380
642,Herenthoutsesteenweg 2,2021-11-23,20:00:00,24,23,1,ECO_300019380
642,Herenthoutsesteenweg 2,2021-11-23,21:00:00,19,14,5,ECO_300019380
642,Herenthoutsesteenweg 2,2021-11-23,22:00:00,14,11,3,ECO_300019380
642,Herenthoutsesteenweg 2,2021-11-23,23:00:00,11,8,3,ECO_300019380
642,Herenthoutsesteenweg 2,2021-11-24,00:00:00,5,2,3,ECO_300019380
642,Herenthoutsesteenweg 2,2021-11-24,01:00:00,2,1,1,ECO_300019380
642,Herenthoutsesteenweg 2,2021-11-24,02:00:00,0,0,0,ECO_300019380
642,Herenthoutsesteenweg 2,2021-11-24,03:00:00,0,0,0,ECO_300019380
642,Herenthoutsesteenweg 2,2021-11-24,04:00:00,0,0,0,ECO_300019380
642,Herenthoutsesteenweg 2,2021-11-24,05:00:00,3,3,0,ECO_300019380
642,Herenthoutsesteenweg 2,2021-11-24,06:00:00,17,14,3,ECO_300019380
642,Herenthoutsesteenweg 2,2021-11-24,07:00:00,42,39,3,ECO_300019380
642,Herenthoutsesteenweg 2,2021-11-24,08:00:00,113,112,1,ECO_300019380
642,Herenthoutsesteenweg 2,2021-11-24,09:00:00,466,459,7,ECO_300019380
642,Herenthoutsesteenweg 2,2021-11-24,10:00:00,62,61,1,ECO_300019380
642,Herenthoutsesteenweg 2,2021-11-24,11:00:00,50,48,2,ECO_300019380
642,Herenthoutsesteenweg 2,2021-11-24,12:00:00,35,31,4,ECO_300019380
642,Herenthoutsesteenweg 2,2021-11-24,13:00:00,67,61,6,ECO_300019380
642,Herenthoutsesteenweg 2,2021-11-24,14:00:00,78,75,3,ECO_300019380
642,Herenthoutsesteenweg 2,2021-11-24,15:00:00,69,66,3,ECO_300019380
642,Herenthoutsesteenweg 2,2021-11-24,16:00:00,44,40,4,ECO_300019380
642,Herenthoutsesteenweg 2,2021-11-24,17:00:00,78,73,5,ECO_300019380
642,Herenthoutsesteenweg 2,2021-11-24,18:00:00,36,33,3,ECO_300019380
642,Herenthoutsesteenweg 2,2021-11-24,19:00:00,38,35,3,ECO_300019380
642,Herenthoutsesteenweg 2,2021-11-24,20:00:00,20,17,3,ECO_300019380
642,Herenthoutsesteenweg 2,2021-11-24,21:00:00,16,12,4,ECO_300019380
642,Herenthoutsesteenweg 2,2021-11-24,22:00:00,12,11,1,ECO_300019380
642,Herenthoutsesteenweg 2,2021-11-24,23:00:00,14,11,3,ECO_300019380
642,Herenthoutsesteenweg 2,2021-11-25,00:00:00,3,1,2,ECO_300019380
642,Herenthoutsesteenweg 2,2021-11-25,01:00:00,0,0,0,ECO_300019380
642,Herenthoutsesteenweg 2,2021-11-25,02:00:00,1,0,1,ECO_300019380
642,Herenthoutsesteenweg 2,2021-11-25,03:00:00,0,0,0,ECO_300019380
642,Herenthoutsesteenweg 2,2021-11-25,04:00:00,0,0,0,ECO_300019380
642,Herenthoutsesteenweg 2,2021-11-25,05:00:00,5,4,1,ECO_300019380
642,Herenthoutsesteenweg 2,2021-11-25,06:00:00,16,14,2,ECO_300019380
642,Herenthoutsesteenweg 2,2021-11-25,07:00:00,37,36,1,ECO_300019380
642,Herenthoutsesteenweg 2,2021-11-25,08:00:00,107,103,4,ECO_300019380
642,Herenthoutsesteenweg 2,2021-11-25,09:00:00,442,437,5,ECO_300019380
642,Herenthoutsesteenweg 2,2021-11-25,10:00:00,59,57,2,ECO_300019380
642,Herenthoutsesteenweg 2,2021-11-25,11:00:00,35,34,1,ECO_300019380
642,Herenthoutsesteenweg 2,2021-11-25,12:00:00,37,33,4,ECO_300019380
642,Herenthoutsesteenweg 2,2021-11-25,13:00:00,48,44,4,ECO_300019380
642,Herenthoutsesteenweg 2,2021-11-25,14:00:00,41,41,0,ECO_300019380
642,Herenthoutsesteenweg 2,2021-11-25,15:00:00,52,48,4,ECO_300019380
642,Herenthoutsesteenweg 2,2021-11-25,16:00:00,50,48,2,ECO_300019380
642,Herenthoutsesteenweg 2,2021-11-25,17:00:00,64,58,6,ECO_300019380
642,Herenthoutsesteenweg 2,2021-11-25,18:00:00,45,44,1,ECO_300019380
642,Herenthoutsesteenweg 2,2021-11-25,19:00:00,22,17,5,ECO_300019380
642,Herenthoutsesteenweg 2,2021-11-25,20:00:00,30,28,2,ECO_300019380
642,Herenthoutsesteenweg 2,2021-11-25,21:00:00,14,13,1,ECO_300019380
642,Herenthoutsesteenweg 2,2021-11-25,22:00:00,10,7,3,ECO_300019380
642,Herenthoutsesteenweg 2,2021-11-25,23:00:00,10,8,2,ECO_300019380
642,Herenthoutsesteenweg 2,2021-11-26,00:00:00,6,3,3,ECO_300019380
642,Herenthoutsesteenweg 2,2021-11-26,01:00:00,0,0,0,ECO_300019380
642,Herenthoutsesteenweg 2,2021-11-26,02:00:00,2,1,1,ECO_300019380
642,Herenthoutsesteenweg 2,2021-11-26,03:00:00,0,0,0,ECO_300019380
642,Herenthoutsesteenweg 2,2021-11-26,04:00:00,0,0,0,ECO_300019380
642,Herenthoutsesteenweg 2,2021-11-26,05:00:00,2,2,0,ECO_300019380
642,Herenthoutsesteenweg 2,2021-11-26,06:00:00,11,10,1,ECO_300019380
642,Herenthoutsesteenweg 2,2021-11-26,07:00:00,31,28,3,ECO_300019380
642,Herenthoutsesteenweg 2,2021-11-26,08:00:00,110,104,6,ECO_300019380
642,Herenthoutsesteenweg 2,2021-11-26,09:00:00,454,447,7,ECO_300019380
642,Herenthoutsesteenweg 2,2021-11-26,10:00:00,83,78,5,ECO_300019380
642,Herenthoutsesteenweg 2,2021-11-26,11:00:00,59,57,2,ECO_300019380
642,Herenthoutsesteenweg 2,2021-11-26,12:00:00,41,39,2,ECO_300019380
642,Herenthoutsesteenweg 2,2021-11-26,13:00:00,35,35,0,ECO_300019380
642,Herenthoutsesteenweg 2,2021-11-26,14:00:00,22,21,1,ECO_300019380
642,Herenthoutsesteenweg 2,2021-11-26,15:00:00,35,34,1,ECO_300019380
642,Herenthoutsesteenweg 2,2021-11-26,16:00:00,43,39,4,ECO_300019380
642,Herenthoutsesteenweg 2,2021-11-26,17:00:00,62,57,5,ECO_300019380
642,Herenthoutsesteenweg 2,2021-11-26,18:00:00,17,13,4,ECO_300019380
642,Herenthoutsesteenweg 2,2021-11-26,19:00:00,14,12,2,ECO_300019380
642,Herenthoutsesteenweg 2,2021-11-26,20:00:00,18,16,2,ECO_300019380
642,Herenthoutsesteenweg 2,2021-11-26,21:00:00,9,9,0,ECO_300019380
642,Herenthoutsesteenweg 2,2021-11-26,22:00:00,5,1,4,ECO_300019380
642,Herenthoutsesteenweg 2,2021-11-26,23:00:00,11,8,3,ECO_300019380
642,Herenthoutsesteenweg 2,2021-11-27,00:00:00,6,4,2,ECO_300019380
642,Herenthoutsesteenweg 2,2021-11-27,01:00:00,3,2,1,ECO_300019380
642,Herenthoutsesteenweg 2,2021-11-27,02:00:00,2,1,1,ECO_300019380
642,Herenthoutsesteenweg 2,2021-11-27,03:00:00,1,0,1,ECO_300019380
642,Herenthoutsesteenweg 2,2021-11-27,04:00:00,5,3,2,ECO_300019380
642,Herenthoutsesteenweg 2,2021-11-27,05:00:00,1,1,0,ECO_300019380
642,Herenthoutsesteenweg 2,2021-11-27,06:00:00,2,1,1,ECO_300019380
642,Herenthoutsesteenweg 2,2021-11-27,07:00:00,5,5,0,ECO_300019380
642,Herenthoutsesteenweg 2,2021-11-27,08:00:00,8,8,0,ECO_300019380
642,Herenthoutsesteenweg 2,2021-11-27,09:00:00,28,26,2,ECO_300019380
642,Herenthoutsesteenweg 2,2021-11-27,10:00:00,49,44,5,ECO_300019380
642,Herenthoutsesteenweg 2,2021-11-27,11:00:00,49,43,6,ECO_300019380
642,Herenthoutsesteenweg 2,2021-11-27,12:00:00,55,53,2,ECO_300019380
642,Herenthoutsesteenweg 2,2021-11-27,13:00:00,53,47,6,ECO_300019380
642,Herenthoutsesteenweg 2,2021-11-27,14:00:00,82,76,6,ECO_300019380
642,Herenthoutsesteenweg 2,2021-11-27,15:00:00,71,64,7,ECO_300019380
642,Herenthoutsesteenweg 2,2021-11-27,16:00:00,56,52,4,ECO_300019380
642,Herenthoutsesteenweg 2,2021-11-27,17:00:00,24,20,4,ECO_300019380
642,Herenthoutsesteenweg 2,2021-11-27,18:00:00,22,17,5,ECO_300019380
642,Herenthoutsesteenweg 2,2021-11-27,19:00:00,10,8,2,ECO_300019380
642,Herenthoutsesteenweg 2,2021-11-27,20:00:00,14,13,1,ECO_300019380
642,Herenthoutsesteenweg 2,2021-11-27,21:00:00,11,10,1,ECO_300019380
642,Herenthoutsesteenweg 2,2021-11-27,22:00:00,9,3,6,ECO_300019380
642,Herenthoutsesteenweg 2,2021-11-27,23:00:00,3,3,0,ECO_300019380
642,Herenthoutsesteenweg 2,2021-11-28,00:00:00,5,3,2,ECO_300019380
642,Herenthoutsesteenweg 2,2021-11-28,01:00:00,2,0,2,ECO_300019380
642,Herenthoutsesteenweg 2,2021-11-28,02:00:00,3,2,1,ECO_300019380
642,Herenthoutsesteenweg 2,2021-11-28,03:00:00,0,0,0,ECO_300019380
642,Herenthoutsesteenweg 2,2021-11-28,04:00:00,0,0,0,ECO_300019380
642,Herenthoutsesteenweg 2,2021-11-28,05:00:00,2,2,0,ECO_300019380
642,Herenthoutsesteenweg 2,2021-11-28,06:00:00,1,1,0,ECO_300019380
642,Herenthoutsesteenweg 2,2021-11-28,07:00:00,3,3,0,ECO_300019380
642,Herenthoutsesteenweg 2,2021-11-28,08:00:00,9,8,1,ECO_300019380
642,Herenthoutsesteenweg 2,2021-11-28,09:00:00,43,41,2,ECO_300019380
642,Herenthoutsesteenweg 2,2021-11-28,10:00:00,61,57,4,ECO_300019380
642,Herenthoutsesteenweg 2,2021-11-28,11:00:00,87,77,10,ECO_300019380
642,Herenthoutsesteenweg 2,2021-11-28,12:00:00,44,36,8,ECO_300019380
642,Herenthoutsesteenweg 2,2021-11-28,13:00:00,20,16,4,ECO_300019380
642,Herenthoutsesteenweg 2,2021-11-28,14:00:00,18,16,2,ECO_300019380
642,Herenthoutsesteenweg 2,2021-11-28,15:00:00,15,12,3,ECO_300019380
642,Herenthoutsesteenweg 2,2021-11-28,16:00:00,10,9,1,ECO_300019380
642,Herenthoutsesteenweg 2,2021-11-28,17:00:00,24,23,1,ECO_300019380
642,Herenthoutsesteenweg 2,2021-11-28,18:00:00,13,9,4,ECO_300019380
642,Herenthoutsesteenweg 2,2021-11-28,19:00:00,15,14,1,ECO_300019380
642,Herenthoutsesteenweg 2,2021-11-28,20:00:00,16,14,2,ECO_300019380
642,Herenthoutsesteenweg 2,2021-11-28,21:00:00,2,2,0,ECO_300019380
642,Herenthoutsesteenweg 2,2021-11-28,22:00:00,3,3,0,ECO_300019380
642,Herenthoutsesteenweg 2,2021-11-28,23:00:00,2,1,1,ECO_300019380
642,Herenthoutsesteenweg 2,2021-11-29,00:00:00,2,2,0,ECO_300019380
642,Herenthoutsesteenweg 2,2021-11-29,01:00:00,2,2,0,ECO_300019380
642,Herenthoutsesteenweg 2,2021-11-29,02:00:00,0,0,0,ECO_300019380
642,Herenthoutsesteenweg 2,2021-11-29,03:00:00,0,0,0,ECO_300019380
642,Herenthoutsesteenweg 2,2021-11-29,04:00:00,0,0,0,ECO_300019380
642,Herenthoutsesteenweg 2,2021-11-29,05:00:00,2,2,0,ECO_300019380
642,Herenthoutsesteenweg 2,2021-11-29,06:00:00,10,10,0,ECO_300019380
642,Herenthoutsesteenweg 2,2021-11-29,07:00:00,38,35,3,ECO_300019380
642,Herenthoutsesteenweg 2,2021-11-29,08:00:00,96,95,1,ECO_300019380
642,Herenthoutsesteenweg 2,2021-11-29,09:00:00,437,433,4,ECO_300019380
642,Herenthoutsesteenweg 2,2021-11-29,10:00:00,59,58,1,ECO_300019380
642,Herenthoutsesteenweg 2,2021-11-29,11:00:00,55,55,0,ECO_300019380
642,Herenthoutsesteenweg 2,2021-11-29,12:00:00,33,29,4,ECO_300019380
642,Herenthoutsesteenweg 2,2021-11-29,13:00:00,51,50,1,ECO_300019380
642,Herenthoutsesteenweg 2,2021-11-29,14:00:00,41,39,2,ECO_300019380
642,Herenthoutsesteenweg 2,2021-11-29,15:00:00,55,49,6,ECO_300019380
642,Herenthoutsesteenweg 2,2021-11-29,16:00:00,57,54,3,ECO_300019380
642,Herenthoutsesteenweg 2,2021-11-29,17:00:00,66,58,8,ECO_300019380
642,Herenthoutsesteenweg 2,2021-11-29,18:00:00,33,31,2,ECO_300019380
642,Herenthoutsesteenweg 2,2021-11-29,19:00:00,14,12,2,ECO_300019380
642,Herenthoutsesteenweg 2,2021-11-29,20:00:00,17,16,1,ECO_300019380
642,Herenthoutsesteenweg 2,2021-11-29,21:00:00,7,7,0,ECO_300019380
642,Herenthoutsesteenweg 2,2021-11-29,22:00:00,3,3,0,ECO_300019380
642,Herenthoutsesteenweg 2,2021-11-29,23:00:00,13,11,2,ECO_300019380
642,Herenthoutsesteenweg 2,2021-11-30,00:00:00,5,3,2,ECO_300019380
642,Herenthoutsesteenweg 2,2021-11-30,01:00:00,1,1,0,ECO_300019380
642,Herenthoutsesteenweg 2,2021-11-30,02:00:00,0,0,0,ECO_300019380
642,Herenthoutsesteenweg 2,2021-11-30,03:00:00,0,0,0,ECO_300019380
642,Herenthoutsesteenweg 2,2021-11-30,04:00:00,0,0,0,ECO_300019380
642,Herenthoutsesteenweg 2,2021-11-30,05:00:00,1,1,0,ECO_300019380
642,Herenthoutsesteenweg 2,2021-11-30,06:00:00,10,10,0,ECO_300019380
642,Herenthoutsesteenweg 2,2021-11-30,07:00:00,31,30,1,ECO_300019380
642,Herenthoutsesteenweg 2,2021-11-30,08:00:00,63,60,3,ECO_300019380
642,Herenthoutsesteenweg 2,2021-11-30,09:00:00,365,351,14,ECO_300019380
642,Herenthoutsesteenweg 2,2021-11-30,10:00:00,57,56,1,ECO_300019380
642,Herenthoutsesteenweg 2,2021-11-30,11:00:00,17,15,2,ECO_300019380
642,Herenthoutsesteenweg 2,2021-11-30,12:00:00,13,13,0,ECO_300019380
642,Herenthoutsesteenweg 2,2021-11-30,13:00:00,20,17,3,ECO_300019380
642,Herenthoutsesteenweg 2,2021-11-30,14:00:00,31,29,2,ECO_300019380
642,Herenthoutsesteenweg 2,2021-11-30,15:00:00,32,30,2,ECO_300019380
642,Herenthoutsesteenweg 2,2021-11-30,16:00:00,34,31,3,ECO_300019380
642,Herenthoutsesteenweg 2,2021-11-30,17:00:00,50,45,5,ECO_300019380
642,Herenthoutsesteenweg 2,2021-11-30,18:00:00,28,28,0,ECO_300019380
642,Herenthoutsesteenweg 2,2021-11-30,19:00:00,14,12,2,ECO_300019380
642,Herenthoutsesteenweg 2,2021-11-30,20:00:00,12,11,1,ECO_300019380
642,Herenthoutsesteenweg 2,2021-11-30,21:00:00,8,6,2,ECO_300019380
642,Herenthoutsesteenweg 2,2021-11-30,22:00:00,3,3,0,ECO_300019380
642,Herenthoutsesteenweg 2,2021-11-30,23:00:00,11,8,3,ECO_300019380
642,Herenthoutsesteenweg 2,2021-12-01,00:00:00,3,2,1,ECO_300019380
642,Herenthoutsesteenweg 2,2021-12-01,01:00:00,0,0,0,ECO_300019380
642,Herenthoutsesteenweg 2,2021-12-01,02:00:00,1,0,1,ECO_300019380
642,Herenthoutsesteenweg 2,2021-12-01,03:00:00,1,1,0,ECO_300019380
642,Herenthoutsesteenweg 2,2021-12-01,04:00:00,1,1,0,ECO_300019380
642,Herenthoutsesteenweg 2,2021-12-01,05:00:00,2,2,0,ECO_300019380
642,Herenthoutsesteenweg 2,2021-12-01,06:00:00,11,11,0,ECO_300019380
642,Herenthoutsesteenweg 2,2021-12-01,07:00:00,26,25,1,ECO_300019380
642,Herenthoutsesteenweg 2,2021-12-01,08:00:00,60,55,5,ECO_300019380
642,Herenthoutsesteenweg 2,2021-12-01,09:00:00,305,300,5,ECO_300019380
642,Herenthoutsesteenweg 2,2021-12-01,10:00:00,45,42,3,ECO_300019380
642,Herenthoutsesteenweg 2,2021-12-01,11:00:00,11,10,1,ECO_300019380
642,Herenthoutsesteenweg 2,2021-12-01,12:00:00,17,15,2,ECO_300019380
642,Herenthoutsesteenweg 2,2021-12-01,13:00:00,51,47,4,ECO_300019380
642,Herenthoutsesteenweg 2,2021-12-01,14:00:00,57,52,5,ECO_300019380
642,Herenthoutsesteenweg 2,2021-12-01,15:00:00,45,44,1,ECO_300019380
642,Herenthoutsesteenweg 2,2021-12-01,16:00:00,29,27,2,ECO_300019380
642,Herenthoutsesteenweg 2,2021-12-01,17:00:00,44,39,5,ECO_300019380
642,Herenthoutsesteenweg 2,2021-12-01,18:00:00,22,21,1,ECO_300019380
642,Herenthoutsesteenweg 2,2021-12-01,19:00:00,14,10,4,ECO_300019380
642,Herenthoutsesteenweg 2,2021-12-01,20:00:00,7,7,0,ECO_300019380
642,Herenthoutsesteenweg 2,2021-12-01,21:00:00,13,11,2,ECO_300019380
642,Herenthoutsesteenweg 2,2021-12-01,22:00:00,7,6,1,ECO_300019380
642,Herenthoutsesteenweg 2,2021-12-01,23:00:00,16,14,2,ECO_300019380
642,Herenthoutsesteenweg 2,2021-12-02,00:00:00,7,6,1,ECO_300019380
642,Herenthoutsesteenweg 2,2021-12-02,01:00:00,1,1,0,ECO_300019380
642,Herenthoutsesteenweg 2,2021-12-02,02:00:00,1,1,0,ECO_300019380
642,Herenthoutsesteenweg 2,2021-12-02,03:00:00,4,2,2,ECO_300019380
642,Herenthoutsesteenweg 2,2021-12-02,04:00:00,1,1,0,ECO_300019380
642,Herenthoutsesteenweg 2,2021-12-02,05:00:00,1,1,0,ECO_300019380
642,Herenthoutsesteenweg 2,2021-12-02,06:00:00,12,11,1,ECO_300019380
642,Herenthoutsesteenweg 2,2021-12-02,07:00:00,25,24,1,ECO_300019380
642,Herenthoutsesteenweg 2,2021-12-02,08:00:00,93,90,3,ECO_300019380
642,Herenthoutsesteenweg 2,2021-12-02,09:00:00,315,313,2,ECO_300019380
642,Herenthoutsesteenweg 2,2021-12-02,10:00:00,27,27,0,ECO_300019380
642,Herenthoutsesteenweg 2,2021-12-02,11:00:00,16,16,0,ECO_300019380
642,Herenthoutsesteenweg 2,2021-12-02,12:00:00,15,13,2,ECO_300019380
642,Herenthoutsesteenweg 2,2021-12-02,13:00:00,23,22,1,ECO_300019380
642,Herenthoutsesteenweg 2,2021-12-02,14:00:00,36,35,1,ECO_300019380
642,Herenthoutsesteenweg 2,2021-12-02,15:00:00,27,23,4,ECO_300019380
642,Herenthoutsesteenweg 2,2021-12-02,16:00:00,59,54,5,ECO_300019380
642,Herenthoutsesteenweg 2,2021-12-02,17:00:00,67,60,7,ECO_300019380
642,Herenthoutsesteenweg 2,2021-12-02,18:00:00,37,36,1,ECO_300019380
642,Herenthoutsesteenweg 2,2021-12-02,19:00:00,13,12,1,ECO_300019380
642,Herenthoutsesteenweg 2,2021-12-02,20:00:00,16,15,1,ECO_300019380
642,Herenthoutsesteenweg 2,2021-12-02,21:00:00,7,7,0,ECO_300019380
642,Herenthoutsesteenweg 2,2021-12-02,22:00:00,7,5,2,ECO_300019380
642,Herenthoutsesteenweg 2,2021-12-02,23:00:00,12,9,3,ECO_300019380
642,Herenthoutsesteenweg 2,2021-12-03,00:00:00,2,0,2,ECO_300019380
642,Herenthoutsesteenweg 2,2021-12-03,01:00:00,0,0,0,ECO_300019380
642,Herenthoutsesteenweg 2,2021-12-03,02:00:00,0,0,0,ECO_300019380
642,Herenthoutsesteenweg 2,2021-12-03,03:00:00,0,0,0,ECO_300019380
642,Herenthoutsesteenweg 2,2021-12-03,04:00:00,2,2,0,ECO_300019380
642,Herenthoutsesteenweg 2,2021-12-03,05:00:00,3,2,1,ECO_300019380
642,Herenthoutsesteenweg 2,2021-12-03,06:00:00,12,12,0,ECO_300019380
642,Herenthoutsesteenweg 2,2021-12-03,07:00:00,26,23,3,ECO_300019380
642,Herenthoutsesteenweg 2,2021-12-03,08:00:00,78,76,2,ECO_300019380
642,Herenthoutsesteenweg 2,2021-12-03,09:00:00,264,254,10,ECO_300019380
642,Herenthoutsesteenweg 2,2021-12-03,10:00:00,53,52,1,ECO_300019380
642,Herenthoutsesteenweg 2,2021-12-03,11:00:00,47,44,3,ECO_300019380
642,Herenthoutsesteenweg 2,2021-12-03,12:00:00,32,31,1,ECO_300019380
642,Herenthoutsesteenweg 2,2021-12-03,13:00:00,47,42,5,ECO_300019380
642,Herenthoutsesteenweg 2,2021-12-03,14:00:00,32,30,2,ECO_300019380
642,Herenthoutsesteenweg 2,2021-12-03,15:00:00,51,48,3,ECO_300019380
642,Herenthoutsesteenweg 2,2021-12-03,16:00:00,66,60,6,ECO_300019380
642,Herenthoutsesteenweg 2,2021-12-03,17:00:00,68,60,8,ECO_300019380
642,Herenthoutsesteenweg 2,2021-12-03,18:00:00,31,29,2,ECO_300019380
642,Herenthoutsesteenweg 2,2021-12-03,19:00:00,20,17,3,ECO_300019380
642,Herenthoutsesteenweg 2,2021-12-03,20:00:00,19,18,1,ECO_300019380
642,Herenthoutsesteenweg 2,2021-12-03,21:00:00,21,19,2,ECO_300019380
642,Herenthoutsesteenweg 2,2021-12-03,22:00:00,6,6,0,ECO_300019380
642,Herenthoutsesteenweg 2,2021-12-03,23:00:00,10,8,2,ECO_300019380
642,Herenthoutsesteenweg 2,2021-12-04,00:00:00,6,6,0,ECO_300019380
642,Herenthoutsesteenweg 2,2021-12-04,01:00:00,2,1,1,ECO_300019380
642,Herenthoutsesteenweg 2,2021-12-04,02:00:00,2,1,1,ECO_300019380
642,Herenthoutsesteenweg 2,2021-12-04,03:00:00,0,0,0,ECO_300019380
642,Herenthoutsesteenweg 2,2021-12-04,04:00:00,0,0,0,ECO_300019380
642,Herenthoutsesteenweg 2,2021-12-04,05:00:00,0,0,0,ECO_300019380
642,Herenthoutsesteenweg 2,2021-12-04,06:00:00,1,1,0,ECO_300019380
642,Herenthoutsesteenweg 2,2021-12-04,07:00:00,3,3,0,ECO_300019380
642,Herenthoutsesteenweg 2,2021-12-04,08:00:00,7,7,0,ECO_300019380
642,Herenthoutsesteenweg 2,2021-12-04,09:00:00,25,23,2,ECO_300019380
642,Herenthoutsesteenweg 2,2021-12-04,10:00:00,45,44,1,ECO_300019380
642,Herenthoutsesteenweg 2,2021-12-04,11:00:00,58,52,6,ECO_300019380
642,Herenthoutsesteenweg 2,2021-12-04,12:00:00,31,27,4,ECO_300019380
642,Herenthoutsesteenweg 2,2021-12-04,13:00:00,28,27,1,ECO_300019380
642,Herenthoutsesteenweg 2,2021-12-04,14:00:00,13,13,0,ECO_300019380
642,Herenthoutsesteenweg 2,2021-12-04,15:00:00,17,15,2,ECO_300019380
642,Herenthoutsesteenweg 2,2021-12-04,16:00:00,24,22,2,ECO_300019380
642,Herenthoutsesteenweg 2,2021-12-04,17:00:00,27,26,1,ECO_300019380
642,Herenthoutsesteenweg 2,2021-12-04,18:00:00,8,5,3,ECO_300019380
642,Herenthoutsesteenweg 2,2021-12-04,19:00:00,11,10,1,ECO_300019380
642,Herenthoutsesteenweg 2,2021-12-04,20:00:00,19,19,0,ECO_300019380
642,Herenthoutsesteenweg 2,2021-12-04,21:00:00,4,3,1,ECO_300019380
642,Herenthoutsesteenweg 2,2021-12-04,22:00:00,6,6,0,ECO_300019380
642,Herenthoutsesteenweg 2,2021-12-04,23:00:00,3,2,1,ECO_300019380
642,Herenthoutsesteenweg 2,2021-12-05,00:00:00,6,4,2,ECO_300019380
642,Herenthoutsesteenweg 2,2021-12-05,01:00:00,5,4,1,ECO_300019380
642,Herenthoutsesteenweg 2,2021-12-05,02:00:00,2,0,2,ECO_300019380
642,Herenthoutsesteenweg 2,2021-12-05,03:00:00,5,5,0,ECO_300019380
642,Herenthoutsesteenweg 2,2021-12-05,04:00:00,4,4,0,ECO_300019380
642,Herenthoutsesteenweg 2,2021-12-05,05:00:00,0,0,0,ECO_300019380
642,Herenthoutsesteenweg 2,2021-12-05,06:00:00,0,0,0,ECO_300019380
642,Herenthoutsesteenweg 2,2021-12-05,07:00:00,7,6,1,ECO_300019380
642,Herenthoutsesteenweg 2,2021-12-05,08:00:00,13,12,1,ECO_300019380
642,Herenthoutsesteenweg 2,2021-12-05,09:00:00,21,19,2,ECO_300019380
642,Herenthoutsesteenweg 2,2021-12-05,10:00:00,32,29,3,ECO_300019380
642,Herenthoutsesteenweg 2,2021-12-05,11:00:00,43,41,2,ECO_300019380
642,Herenthoutsesteenweg 2,2021-12-05,12:00:00,26,24,2,ECO_300019380
642,Herenthoutsesteenweg 2,2021-12-05,13:00:00,25,21,4,ECO_300019380
642,Herenthoutsesteenweg 2,2021-12-05,14:00:00,40,39,1,ECO_300019380
642,Herenthoutsesteenweg 2,2021-12-05,15:00:00,26,25,1,ECO_300019380
642,Herenthoutsesteenweg 2,2021-12-05,16:00:00,34,28,6,ECO_300019380
642,Herenthoutsesteenweg 2,2021-12-05,17:00:00,29,25,4,ECO_300019380
642,Herenthoutsesteenweg 2,2021-12-05,18:00:00,14,10,4,ECO_300019380
642,Herenthoutsesteenweg 2,2021-12-05,19:00:00,6,5,1,ECO_300019380
642,Herenthoutsesteenweg 2,2021-12-05,20:00:00,5,5,0,ECO_300019380
642,Herenthoutsesteenweg 2,2021-12-05,21:00:00,6,5,1,ECO_300019380
642,Herenthoutsesteenweg 2,2021-12-05,22:00:00,3,3,0,ECO_300019380
642,Herenthoutsesteenweg 2,2021-12-05,23:00:00,0,0,0,ECO_300019380
642,Herenthoutsesteenweg 2,2021-12-06,00:00:00,2,1,1,ECO_300019380
642,Herenthoutsesteenweg 2,2021-12-06,01:00:00,2,2,0,ECO_300019380
642,Herenthoutsesteenweg 2,2021-12-06,02:00:00,0,0,0,ECO_300019380
642,Herenthoutsesteenweg 2,2021-12-06,03:00:00,2,2,0,ECO_300019380
642,Herenthoutsesteenweg 2,2021-12-06,04:00:00,0,0,0,ECO_300019380
642,Herenthoutsesteenweg 2,2021-12-06,05:00:00,2,2,0,ECO_300019380
642,Herenthoutsesteenweg 2,2021-12-06,06:00:00,19,16,3,ECO_300019380
642,Herenthoutsesteenweg 2,2021-12-06,07:00:00,30,28,2,ECO_300019380
642,Herenthoutsesteenweg 2,2021-12-06,08:00:00,76,75,1,ECO_300019380
642,Herenthoutsesteenweg 2,2021-12-06,09:00:00,99,96,3,ECO_300019380
642,Herenthoutsesteenweg 2,2021-12-06,10:00:00,42,37,5,ECO_300019380
642,Herenthoutsesteenweg 2,2021-12-06,11:00:00,34,30,4,ECO_300019380
642,Herenthoutsesteenweg 2,2021-12-06,12:00:00,35,31,4,ECO_300019380
642,Herenthoutsesteenweg 2,2021-12-06,13:00:00,38,35,3,ECO_300019380
642,Herenthoutsesteenweg 2,2021-12-06,14:00:00,65,62,3,ECO_300019380
642,Herenthoutsesteenweg 2,2021-12-06,15:00:00,69,65,4,ECO_300019380
642,Herenthoutsesteenweg 2,2021-12-06,16:00:00,47,42,5,ECO_300019380
642,Herenthoutsesteenweg 2,2021-12-06,17:00:00,69,67,2,ECO_300019380
642,Herenthoutsesteenweg 2,2021-12-06,18:00:00,36,32,4,ECO_300019380
642,Herenthoutsesteenweg 2,2021-12-06,19:00:00,16,11,5,ECO_300019380
642,Herenthoutsesteenweg 2,2021-12-06,20:00:00,9,9,0,ECO_300019380
642,Herenthoutsesteenweg 2,2021-12-06,21:00:00,5,5,0,ECO_300019380
642,Herenthoutsesteenweg 2,2021-12-06,22:00:00,1,1,0,ECO_300019380
642,Herenthoutsesteenweg 2,2021-12-06,23:00:00,8,7,1,ECO_300019380
642,Herenthoutsesteenweg 2,2021-12-07,00:00:00,3,2,1,ECO_300019380
642,Herenthoutsesteenweg 2,2021-12-07,01:00:00,1,0,1,ECO_300019380
642,Herenthoutsesteenweg 2,2021-12-07,02:00:00,0,0,0,ECO_300019380
642,Herenthoutsesteenweg 2,2021-12-07,03:00:00,0,0,0,ECO_300019380
642,Herenthoutsesteenweg 2,2021-12-07,04:00:00,0,0,0,ECO_300019380
642,Herenthoutsesteenweg 2,2021-12-07,05:00:00,1,1,0,ECO_300019380
642,Herenthoutsesteenweg 2,2021-12-07,06:00:00,15,14,1,ECO_300019380
642,Herenthoutsesteenweg 2,2021-12-07,07:00:00,39,37,2,ECO_300019380
642,Herenthoutsesteenweg 2,2021-12-07,08:00:00,78,76,2,ECO_300019380
642,Herenthoutsesteenweg 2,2021-12-07,09:00:00,141,137,4,ECO_300019380
642,Herenthoutsesteenweg 2,2021-12-07,10:00:00,60,57,3,ECO_300019380
642,Herenthoutsesteenweg 2,2021-12-07,11:00:00,44,41,3,ECO_300019380
642,Herenthoutsesteenweg 2,2021-12-07,12:00:00,41,39,2,ECO_300019380
642,Herenthoutsesteenweg 2,2021-12-07,13:00:00,47,41,6,ECO_300019380
642,Herenthoutsesteenweg 2,2021-12-07,14:00:00,97,93,4,ECO_300019380
642,Herenthoutsesteenweg 2,2021-12-07,15:00:00,77,69,8,ECO_300019380
642,Herenthoutsesteenweg 2,2021-12-07,16:00:00,89,79,10,ECO_300019380
642,Herenthoutsesteenweg 2,2021-12-07,17:00:00,73,72,1,ECO_300019380
642,Herenthoutsesteenweg 2,2021-12-07,18:00:00,32,32,0,ECO_300019380
642,Herenthoutsesteenweg 2,2021-12-07,19:00:00,25,21,4,ECO_300019380
642,Herenthoutsesteenweg 2,2021-12-07,20:00:00,13,12,1,ECO_300019380
642,Herenthoutsesteenweg 2,2021-12-07,21:00:00,7,7,0,ECO_300019380
642,Herenthoutsesteenweg 2,2021-12-07,22:00:00,5,4,1,ECO_300019380
642,Herenthoutsesteenweg 2,2021-12-07,23:00:00,7,5,2,ECO_300019380
642,Herenthoutsesteenweg 2,2021-12-08,00:00:00,5,2,3,ECO_300019380
642,Herenthoutsesteenweg 2,2021-12-08,01:00:00,0,0,0,ECO_300019380
642,Herenthoutsesteenweg 2,2021-12-08,02:00:00,1,1,0,ECO_300019380
642,Herenthoutsesteenweg 2,2021-12-08,03:00:00,0,0,0,ECO_300019380
642,Herenthoutsesteenweg 2,2021-12-08,04:00:00,3,3,0,ECO_300019380
642,Herenthoutsesteenweg 2,2021-12-08,05:00:00,3,2,1,ECO_300019380
642,Herenthoutsesteenweg 2,2021-12-08,06:00:00,10,9,1,ECO_300019380
642,Herenthoutsesteenweg 2,2021-12-08,07:00:00,38,37,1,ECO_300019380
642,Herenthoutsesteenweg 2,2021-12-08,08:00:00,97,94,3,ECO_300019380
642,Herenthoutsesteenweg 2,2021-12-08,09:00:00,203,203,0,ECO_300019380
642,Herenthoutsesteenweg 2,2021-12-08,10:00:00,43,43,0,ECO_300019380
642,Herenthoutsesteenweg 2,2021-12-08,11:00:00,46,45,1,ECO_300019380
642,Herenthoutsesteenweg 2,2021-12-08,12:00:00,43,40,3,ECO_300019380
642,Herenthoutsesteenweg 2,2021-12-08,13:00:00,78,76,2,ECO_300019380
642,Herenthoutsesteenweg 2,2021-12-08,14:00:00,77,74,3,ECO_300019380
642,Herenthoutsesteenweg 2,2021-12-08,15:00:00,62,61,1,ECO_300019380
642,Herenthoutsesteenweg 2,2021-12-08,16:00:00,62,56,6,ECO_300019380
642,Herenthoutsesteenweg 2,2021-12-08,17:00:00,61,55,6,ECO_300019380
642,Herenthoutsesteenweg 2,2021-12-08,18:00:00,41,37,4,ECO_300019380
642,Herenthoutsesteenweg 2,2021-12-08,19:00:00,33,30,3,ECO_300019380
642,Herenthoutsesteenweg 2,2021-12-08,20:00:00,18,16,2,ECO_300019380
642,Herenthoutsesteenweg 2,2021-12-08,21:00:00,7,6,1,ECO_300019380
642,Herenthoutsesteenweg 2,2021-12-08,22:00:00,7,5,2,ECO_300019380
642,Herenthoutsesteenweg 2,2021-12-08,23:00:00,9,8,1,ECO_300019380
642,Herenthoutsesteenweg 2,2021-12-09,00:00:00,5,5,0,ECO_300019380
642,Herenthoutsesteenweg 2,2021-12-09,01:00:00,2,2,0,ECO_300019380
642,Herenthoutsesteenweg 2,2021-12-09,02:00:00,1,1,0,ECO_300019380
642,Herenthoutsesteenweg 2,2021-12-09,03:00:00,0,0,0,ECO_300019380
642,Herenthoutsesteenweg 2,2021-12-09,04:00:00,2,1,1,ECO_300019380
642,Herenthoutsesteenweg 2,2021-12-09,05:00:00,1,1,0,ECO_300019380
642,Herenthoutsesteenweg 2,2021-12-09,06:00:00,18,17,1,ECO_300019380
642,Herenthoutsesteenweg 2,2021-12-09,07:00:00,38,35,3,ECO_300019380
642,Herenthoutsesteenweg 2,2021-12-09,08:00:00,96,94,2,ECO_300019380
642,Herenthoutsesteenweg 2,2021-12-09,09:00:00,212,204,8,ECO_300019380
642,Herenthoutsesteenweg 2,2021-12-09,10:00:00,53,50,3,ECO_300019380
642,Herenthoutsesteenweg 2,2021-12-09,11:00:00,32,32,0,ECO_300019380
642,Herenthoutsesteenweg 2,2021-12-09,12:00:00,44,43,1,ECO_300019380
642,Herenthoutsesteenweg 2,2021-12-09,13:00:00,108,102,6,ECO_300019380
642,Herenthoutsesteenweg 2,2021-12-09,14:00:00,64,60,4,ECO_300019380
642,Herenthoutsesteenweg 2,2021-12-09,15:00:00,55,53,2,ECO_300019380
642,Herenthoutsesteenweg 2,2021-12-09,16:00:00,64,58,6,ECO_300019380
642,Herenthoutsesteenweg 2,2021-12-09,17:00:00,78,71,7,ECO_300019380
642,Herenthoutsesteenweg 2,2021-12-09,18:00:00,37,35,2,ECO_300019380
642,Herenthoutsesteenweg 2,2021-12-09,19:00:00,20,18,2,ECO_300019380
642,Herenthoutsesteenweg 2,2021-12-09,20:00:00,17,12,5,ECO_300019380
642,Herenthoutsesteenweg 2,2021-12-09,21:00:00,9,9,0,ECO_300019380
642,Herenthoutsesteenweg 2,2021-12-09,22:00:00,11,10,1,ECO_300019380
642,Herenthoutsesteenweg 2,2021-12-09,23:00:00,8,4,4,ECO_300019380
642,Herenthoutsesteenweg 2,2021-12-10,00:00:00,5,4,1,ECO_300019380
642,Herenthoutsesteenweg 2,2021-12-10,01:00:00,2,2,0,ECO_300019380
642,Herenthoutsesteenweg 2,2021-12-10,02:00:00,1,1,0,ECO_300019380
642,Herenthoutsesteenweg 2,2021-12-10,03:00:00,1,0,1,ECO_300019380
642,Herenthoutsesteenweg 2,2021-12-10,04:00:00,0,0,0,ECO_300019380
642,Herenthoutsesteenweg 2,2021-12-10,05:00:00,0,0,0,ECO_300019380
642,Herenthoutsesteenweg 2,2021-12-10,06:00:00,12,11,1,ECO_300019380
642,Herenthoutsesteenweg 2,2021-12-10,07:00:00,25,25,0,ECO_300019380
642,Herenthoutsesteenweg 2,2021-12-10,08:00:00,61,60,1,ECO_300019380
642,Herenthoutsesteenweg 2,2021-12-10,09:00:00,183,183,0,ECO_300019380
642,Herenthoutsesteenweg 2,2021-12-10,10:00:00,48,48,0,ECO_300019380
642,Herenthoutsesteenweg 2,2021-12-10,11:00:00,31,31,0,ECO_300019380
642,Herenthoutsesteenweg 2,2021-12-10,12:00:00,27,26,1,ECO_300019380
642,Herenthoutsesteenweg 2,2021-12-10,13:00:00,62,60,2,ECO_300019380
642,Herenthoutsesteenweg 2,2021-12-10,14:00:00,25,23,2,ECO_300019380
642,Herenthoutsesteenweg 2,2021-12-10,15:00:00,22,21,1,ECO_300019380
642,Herenthoutsesteenweg 2,2021-12-10,16:00:00,44,40,4,ECO_300019380
642,Herenthoutsesteenweg 2,2021-12-10,17:00:00,42,39,3,ECO_300019380
642,Herenthoutsesteenweg 2,2021-12-10,18:00:00,27,25,2,ECO_300019380
642,Herenthoutsesteenweg 2,2021-12-10,19:00:00,16,14,2,ECO_300019380
642,Herenthoutsesteenweg 2,2021-12-10,20:00:00,15,13,2,ECO_300019380
642,Herenthoutsesteenweg 2,2021-12-10,21:00:00,17,16,1,ECO_300019380
642,Herenthoutsesteenweg 2,2021-12-10,22:00:00,3,2,1,ECO_300019380
642,Herenthoutsesteenweg 2,2021-12-10,23:00:00,6,5,1,ECO_300019380
642,Herenthoutsesteenweg 2,2021-12-11,00:00:00,6,5,1,ECO_300019380
642,Herenthoutsesteenweg 2,2021-12-11,01:00:00,2,1,1,ECO_300019380
642,Herenthoutsesteenweg 2,2021-12-11,02:00:00,1,0,1,ECO_300019380
642,Herenthoutsesteenweg 2,2021-12-11,03:00:00,2,2,0,ECO_300019380
642,Herenthoutsesteenweg 2,2021-12-11,04:00:00,1,1,0,ECO_300019380
642,Herenthoutsesteenweg 2,2021-12-11,05:00:00,4,3,1,ECO_300019380
642,Herenthoutsesteenweg 2,2021-12-11,06:00:00,1,1,0,ECO_300019380
642,Herenthoutsesteenweg 2,2021-12-11,07:00:00,5,5,0,ECO_300019380
642,Herenthoutsesteenweg 2,2021-12-11,08:00:00,7,7,0,ECO_300019380
642,Herenthoutsesteenweg 2,2021-12-11,09:00:00,25,25,0,ECO_300019380
642,Herenthoutsesteenweg 2,2021-12-11,10:00:00,49,47,2,ECO_300019380
642,Herenthoutsesteenweg 2,2021-12-11,11:00:00,52,47,5,ECO_300019380
642,Herenthoutsesteenweg 2,2021-12-11,12:00:00,58,52,6,ECO_300019380
642,Herenthoutsesteenweg 2,2021-12-11,13:00:00,64,56,8,ECO_300019380
642,Herenthoutsesteenweg 2,2021-12-11,14:00:00,96,90,6,ECO_300019380
642,Herenthoutsesteenweg 2,2021-12-11,15:00:00,90,80,10,ECO_300019380
642,Herenthoutsesteenweg 2,2021-12-11,16:00:00,75,66,9,ECO_300019380
642,Herenthoutsesteenweg 2,2021-12-11,17:00:00,41,40,1,ECO_300019380
642,Herenthoutsesteenweg 2,2021-12-11,18:00:00,22,19,3,ECO_300019380
642,Herenthoutsesteenweg 2,2021-12-11,19:00:00,26,25,1,ECO_300019380
642,Herenthoutsesteenweg 2,2021-12-11,20:00:00,16,15,1,ECO_300019380
642,Herenthoutsesteenweg 2,2021-12-11,21:00:00,11,10,1,ECO_300019380
642,Herenthoutsesteenweg 2,2021-12-11,22:00:00,8,6,2,ECO_300019380
642,Herenthoutsesteenweg 2,2021-12-11,23:00:00,6,6,0,ECO_300019380
642,Herenthoutsesteenweg 2,2021-12-12,00:00:00,2,1,1,ECO_300019380
642,Herenthoutsesteenweg 2,2021-12-12,01:00:00,4,3,1,ECO_300019380
642,Herenthoutsesteenweg 2,2021-12-12,02:00:00,3,3,0,ECO_300019380
642,Herenthoutsesteenweg 2,2021-12-12,03:00:00,3,2,1,ECO_300019380
642,Herenthoutsesteenweg 2,2021-12-12,04:00:00,2,1,1,ECO_300019380
642,Herenthoutsesteenweg 2,2021-12-12,05:00:00,0,0,0,ECO_300019380
642,Herenthoutsesteenweg 2,2021-12-12,06:00:00,3,3,0,ECO_300019380
642,Herenthoutsesteenweg 2,2021-12-12,07:00:00,5,4,1,ECO_300019380
642,Herenthoutsesteenweg 2,2021-12-12,08:00:00,8,8,0,ECO_300019380
642,Herenthoutsesteenweg 2,2021-12-12,09:00:00,25,24,1,ECO_300019380
642,Herenthoutsesteenweg 2,2021-12-12,10:00:00,51,44,7,ECO_300019380
642,Herenthoutsesteenweg 2,2021-12-12,11:00:00,42,40,2,ECO_300019380
642,Herenthoutsesteenweg 2,2021-12-12,12:00:00,33,24,9,ECO_300019380
642,Herenthoutsesteenweg 2,2021-12-12,13:00:00,15,14,1,ECO_300019380
642,Herenthoutsesteenweg 2,2021-12-12,14:00:00,19,17,2,ECO_300019380
642,Herenthoutsesteenweg 2,2021-12-12,15:00:00,16,13,3,ECO_300019380
642,Herenthoutsesteenweg 2,2021-12-12,16:00:00,12,9,3,ECO_300019380
642,Herenthoutsesteenweg 2,2021-12-12,17:00:00,13,13,0,ECO_300019380
642,Herenthoutsesteenweg 2,2021-12-12,18:00:00,8,8,0,ECO_300019380
642,Herenthoutsesteenweg 2,2021-12-12,19:00:00,14,14,0,ECO_300019380
642,Herenthoutsesteenweg 2,2021-12-12,20:00:00,4,3,1,ECO_300019380
642,Herenthoutsesteenweg 2,2021-12-12,21:00:00,6,6,0,ECO_300019380
642,Herenthoutsesteenweg 2,2021-12-12,22:00:00,3,3,0,ECO_300019380
642,Herenthoutsesteenweg 2,2021-12-12,23:00:00,2,2,0,ECO_300019380
642,Herenthoutsesteenweg 2,2021-12-13,00:00:00,3,1,2,ECO_300019380
642,Herenthoutsesteenweg 2,2021-12-13,01:00:00,4,3,1,ECO_300019380
642,Herenthoutsesteenweg 2,2021-12-13,02:00:00,1,1,0,ECO_300019380
642,Herenthoutsesteenweg 2,2021-12-13,03:00:00,1,1,0,ECO_300019380
642,Herenthoutsesteenweg 2,2021-12-13,04:00:00,0,0,0,ECO_300019380
642,Herenthoutsesteenweg 2,2021-12-13,05:00:00,1,1,0,ECO_300019380
642,Herenthoutsesteenweg 2,2021-12-13,06:00:00,15,14,1,ECO_300019380
642,Herenthoutsesteenweg 2,2021-12-13,07:00:00,36,34,2,ECO_300019380
642,Herenthoutsesteenweg 2,2021-12-13,08:00:00,113,109,4,ECO_300019380
642,Herenthoutsesteenweg 2,2021-12-13,09:00:00,266,260,6,ECO_300019380
642,Herenthoutsesteenweg 2,2021-12-13,10:00:00,33,33,0,ECO_300019380
642,Herenthoutsesteenweg 2,2021-12-13,11:00:00,59,54,5,ECO_300019380
642,Herenthoutsesteenweg 2,2021-12-13,12:00:00,56,52,4,ECO_300019380
642,Herenthoutsesteenweg 2,2021-12-13,13:00:00,141,135,6,ECO_300019380
642,Herenthoutsesteenweg 2,2021-12-13,14:00:00,75,70,5,ECO_300019380
642,Herenthoutsesteenweg 2,2021-12-13,15:00:00,73,66,7,ECO_300019380
642,Herenthoutsesteenweg 2,2021-12-13,16:00:00,100,93,7,ECO_300019380
642,Herenthoutsesteenweg 2,2021-12-13,17:00:00,77,71,6,ECO_300019380
642,Herenthoutsesteenweg 2,2021-12-13,18:00:00,45,41,4,ECO_300019380
642,Herenthoutsesteenweg 2,2021-12-13,19:00:00,30,25,5,ECO_300019380
642,Herenthoutsesteenweg 2,2021-12-13,20:00:00,22,19,3,ECO_300019380
642,Herenthoutsesteenweg 2,2021-12-13,21:00:00,10,9,1,ECO_300019380
642,Herenthoutsesteenweg 2,2021-12-13,22:00:00,5,5,0,ECO_300019380
642,Herenthoutsesteenweg 2,2021-12-13,23:00:00,12,10,2,ECO_300019380
642,Herenthoutsesteenweg 2,2021-12-14,00:00:00,1,0,1,ECO_300019380
642,Herenthoutsesteenweg 2,2021-12-14,01:00:00,0,0,0,ECO_300019380
642,Herenthoutsesteenweg 2,2021-12-14,02:00:00,0,0,0,ECO_300019380
642,Herenthoutsesteenweg 2,2021-12-14,03:00:00,0,0,0,ECO_300019380
642,Herenthoutsesteenweg 2,2021-12-14,04:00:00,1,0,1,ECO_300019380
642,Herenthoutsesteenweg 2,2021-12-14,05:00:00,1,1,0,ECO_300019380
642,Herenthoutsesteenweg 2,2021-12-14,06:00:00,11,10,1,ECO_300019380
642,Herenthoutsesteenweg 2,2021-12-14,07:00:00,32,31,1,ECO_300019380
642,Herenthoutsesteenweg 2,2021-12-14,08:00:00,111,104,7,ECO_300019380
642,Herenthoutsesteenweg 2,2021-12-14,09:00:00,265,257,8,ECO_300019380
642,Herenthoutsesteenweg 2,2021-12-14,10:00:00,55,55,0,ECO_300019380
642,Herenthoutsesteenweg 2,2021-12-14,11:00:00,62,53,9,ECO_300019380
642,Herenthoutsesteenweg 2,2021-12-14,12:00:00,70,63,7,ECO_300019380
642,Herenthoutsesteenweg 2,2021-12-14,13:00:00,143,135,8,ECO_300019380
642,Herenthoutsesteenweg 2,2021-12-14,14:00:00,67,57,10,ECO_300019380
642,Herenthoutsesteenweg 2,2021-12-14,15:00:00,86,80,6,ECO_300019380
642,Herenthoutsesteenweg 2,2021-12-14,16:00:00,91,84,7,ECO_300019380
642,Herenthoutsesteenweg 2,2021-12-14,17:00:00,86,76,10,ECO_300019380
642,Herenthoutsesteenweg 2,2021-12-14,18:00:00,48,43,5,ECO_300019380
642,Herenthoutsesteenweg 2,2021-12-14,19:00:00,19,16,3,ECO_300019380
642,Herenthoutsesteenweg 2,2021-12-14,20:00:00,18,16,2,ECO_300019380
642,Herenthoutsesteenweg 2,2021-12-14,21:00:00,7,4,3,ECO_300019380
642,Herenthoutsesteenweg 2,2021-12-14,22:00:00,4,4,0,ECO_300019380
642,Herenthoutsesteenweg 2,2021-12-14,23:00:00,8,8,0,ECO_300019380
642,Herenthoutsesteenweg 2,2021-12-15,00:00:00,2,1,1,ECO_300019380
642,Herenthoutsesteenweg 2,2021-12-15,01:00:00,0,0,0,ECO_300019380
642,Herenthoutsesteenweg 2,2021-12-15,02:00:00,0,0,0,ECO_300019380
642,Herenthoutsesteenweg 2,2021-12-15,03:00:00,1,1,0,ECO_300019380
642,Herenthoutsesteenweg 2,2021-12-15,04:00:00,1,0,1,ECO_300019380
642,Herenthoutsesteenweg 2,2021-12-15,05:00:00,0,0,0,ECO_300019380
642,Herenthoutsesteenweg 2,2021-12-15,06:00:00,17,16,1,ECO_300019380
642,Herenthoutsesteenweg 2,2021-12-15,07:00:00,38,35,3,ECO_300019380
642,Herenthoutsesteenweg 2,2021-12-15,08:00:00,111,107,4,ECO_300019380
642,Herenthoutsesteenweg 2,2021-12-15,09:00:00,238,236,2,ECO_300019380
642,Herenthoutsesteenweg 2,2021-12-15,10:00:00,62,58,4,ECO_300019380
642,Herenthoutsesteenweg 2,2021-12-15,11:00:00,58,56,2,ECO_300019380
642,Herenthoutsesteenweg 2,2021-12-15,12:00:00,45,42,3,ECO_300019380
642,Herenthoutsesteenweg 2,2021-12-15,13:00:00,165,162,3,ECO_300019380
642,Herenthoutsesteenweg 2,2021-12-15,14:00:00,83,76,7,ECO_300019380
642,Herenthoutsesteenweg 2,2021-12-15,15:00:00,87,78,9,ECO_300019380
642,Herenthoutsesteenweg 2,2021-12-15,16:00:00,63,53,10,ECO_300019380
642,Herenthoutsesteenweg 2,2021-12-15,17:00:00,69,61,8,ECO_300019380
642,Herenthoutsesteenweg 2,2021-12-15,18:00:00,40,32,8,ECO_300019380
642,Herenthoutsesteenweg 2,2021-12-15,19:00:00,20,19,1,ECO_300019380
642,Herenthoutsesteenweg 2,2021-12-15,20:00:00,10,10,0,ECO_300019380
642,Herenthoutsesteenweg 2,2021-12-15,21:00:00,15,14,1,ECO_300019380
642,Herenthoutsesteenweg 2,2021-12-15,22:00:00,6,4,2,ECO_300019380
642,Herenthoutsesteenweg 2,2021-12-15,23:00:00,12,11,1,ECO_300019380
642,Herenthoutsesteenweg 2,2021-12-16,00:00:00,2,2,0,ECO_300019380
642,Herenthoutsesteenweg 2,2021-12-16,01:00:00,3,1,2,ECO_300019380
642,Herenthoutsesteenweg 2,2021-12-16,02:00:00,0,0,0,ECO_300019380
642,Herenthoutsesteenweg 2,2021-12-16,03:00:00,0,0,0,ECO_300019380
642,Herenthoutsesteenweg 2,2021-12-16,04:00:00,0,0,0,ECO_300019380
642,Herenthoutsesteenweg 2,2021-12-16,05:00:00,1,1,0,ECO_300019380
642,Herenthoutsesteenweg 2,2021-12-16,06:00:00,8,6,2,ECO_300019380
642,Herenthoutsesteenweg 2,2021-12-16,07:00:00,27,26,1,ECO_300019380
642,Herenthoutsesteenweg 2,2021-12-16,08:00:00,122,117,5,ECO_300019380
642,Herenthoutsesteenweg 2,2021-12-16,09:00:00,293,285,8,ECO_300019380
642,Herenthoutsesteenweg 2,2021-12-16,10:00:00,86,79,7,ECO_300019380
642,Herenthoutsesteenweg 2,2021-12-16,11:00:00,105,101,4,ECO_300019380
642,Herenthoutsesteenweg 2,2021-12-16,12:00:00,76,69,7,ECO_300019380
642,Herenthoutsesteenweg 2,2021-12-16,13:00:00,153,148,5,ECO_300019380
642,Herenthoutsesteenweg 2,2021-12-16,14:00:00,138,131,7,ECO_300019380
642,Herenthoutsesteenweg 2,2021-12-16,15:00:00,116,109,7,ECO_300019380
642,Herenthoutsesteenweg 2,2021-12-16,16:00:00,126,113,13,ECO_300019380
642,Herenthoutsesteenweg 2,2021-12-16,17:00:00,92,86,6,ECO_300019380
642,Herenthoutsesteenweg 2,2021-12-16,18:00:00,49,40,9,ECO_300019380
642,Herenthoutsesteenweg 2,2021-12-16,19:00:00,31,28,3,ECO_300019380
642,Herenthoutsesteenweg 2,2021-12-16,20:00:00,15,13,2,ECO_300019380
642,Herenthoutsesteenweg 2,2021-12-16,21:00:00,8,6,2,ECO_300019380
642,Herenthoutsesteenweg 2,2021-12-16,22:00:00,7,7,0,ECO_300019380
642,Herenthoutsesteenweg 2,2021-12-16,23:00:00,16,16,0,ECO_300019380
642,Herenthoutsesteenweg 2,2021-12-17,00:00:00,2,1,1,ECO_300019380
642,Herenthoutsesteenweg 2,2021-12-17,01:00:00,0,0,0,ECO_300019380
642,Herenthoutsesteenweg 2,2021-12-17,02:00:00,0,0,0,ECO_300019380
642,Herenthoutsesteenweg 2,2021-12-17,03:00:00,0,0,0,ECO_300019380
642,Herenthoutsesteenweg 2,2021-12-17,04:00:00,1,1,0,ECO_300019380
642,Herenthoutsesteenweg 2,2021-12-17,05:00:00,1,1,0,ECO_300019380
642,Herenthoutsesteenweg 2,2021-12-17,06:00:00,15,14,1,ECO_300019380
642,Herenthoutsesteenweg 2,2021-12-17,07:00:00,20,20,0,ECO_300019380
642,Herenthoutsesteenweg 2,2021-12-17,08:00:00,111,108,3,ECO_300019380
642,Herenthoutsesteenweg 2,2021-12-17,09:00:00,320,317,3,ECO_300019380
642,Herenthoutsesteenweg 2,2021-12-17,10:00:00,110,105,5,ECO_300019380
642,Herenthoutsesteenweg 2,2021-12-17,11:00:00,123,117,6,ECO_300019380
642,Herenthoutsesteenweg 2,2021-12-17,12:00:00,65,62,3,ECO_300019380
642,Herenthoutsesteenweg 2,2021-12-17,13:00:00,136,133,3,ECO_300019380
642,Herenthoutsesteenweg 2,2021-12-17,14:00:00,81,75,6,ECO_300019380
642,Herenthoutsesteenweg 2,2021-12-17,15:00:00,61,58,3,ECO_300019380
642,Herenthoutsesteenweg 2,2021-12-17,16:00:00,83,76,7,ECO_300019380
642,Herenthoutsesteenweg 2,2021-12-17,17:00:00,94,84,10,ECO_300019380
642,Herenthoutsesteenweg 2,2021-12-17,18:00:00,32,29,3,ECO_300019380
642,Herenthoutsesteenweg 2,2021-12-17,19:00:00,23,20,3,ECO_300019380
642,Herenthoutsesteenweg 2,2021-12-17,20:00:00,21,18,3,ECO_300019380
642,Herenthoutsesteenweg 2,2021-12-17,21:00:00,21,21,0,ECO_300019380
642,Herenthoutsesteenweg 2,2021-12-17,22:00:00,7,6,1,ECO_300019380
642,Herenthoutsesteenweg 2,2021-12-17,23:00:00,13,10,3,ECO_300019380
642,Herenthoutsesteenweg 2,2021-12-18,00:00:00,7,3,4,ECO_300019380
642,Herenthoutsesteenweg 2,2021-12-18,01:00:00,2,2,0,ECO_300019380
642,Herenthoutsesteenweg 2,2021-12-18,02:00:00,0,0,0,ECO_300019380
642,Herenthoutsesteenweg 2,2021-12-18,03:00:00,2,0,2,ECO_300019380
642,Herenthoutsesteenweg 2,2021-12-18,04:00:00,2,2,0,ECO_300019380
642,Herenthoutsesteenweg 2,2021-12-18,05:00:00,2,1,1,ECO_300019380
642,Herenthoutsesteenweg 2,2021-12-18,06:00:00,1,1,0,ECO_300019380
642,Herenthoutsesteenweg 2,2021-12-18,07:00:00,3,3,0,ECO_300019380
642,Herenthoutsesteenweg 2,2021-12-18,08:00:00,4,4,0,ECO_300019380
642,Herenthoutsesteenweg 2,2021-12-18,09:00:00,23,23,0,ECO_300019380
642,Herenthoutsesteenweg 2,2021-12-18,10:00:00,50,46,4,ECO_300019380
642,Herenthoutsesteenweg 2,2021-12-18,11:00:00,53,50,3,ECO_300019380
642,Herenthoutsesteenweg 2,2021-12-18,12:00:00,58,56,2,ECO_300019380
642,Herenthoutsesteenweg 2,2021-12-18,13:00:00,81,72,9,ECO_300019380
642,Herenthoutsesteenweg 2,2021-12-18,14:00:00,69,63,6,ECO_300019380
642,Herenthoutsesteenweg 2,2021-12-18,15:00:00,67,63,4,ECO_300019380
642,Herenthoutsesteenweg 2,2021-12-18,16:00:00,58,49,9,ECO_300019380
642,Herenthoutsesteenweg 2,2021-12-18,17:00:00,41,38,3,ECO_300019380
642,Herenthoutsesteenweg 2,2021-12-18,18:00:00,10,10,0,ECO_300019380
642,Herenthoutsesteenweg 2,2021-12-18,19:00:00,14,13,1,ECO_300019380
642,Herenthoutsesteenweg 2,2021-12-18,20:00:00,24,22,2,ECO_300019380
642,Herenthoutsesteenweg 2,2021-12-18,21:00:00,12,11,1,ECO_300019380
642,Herenthoutsesteenweg 2,2021-12-18,22:00:00,8,5,3,ECO_300019380
642,Herenthoutsesteenweg 2,2021-12-18,23:00:00,2,1,1,ECO_300019380
642,Herenthoutsesteenweg 2,2021-12-19,00:00:00,11,10,1,ECO_300019380
642,Herenthoutsesteenweg 2,2021-12-19,01:00:00,5,4,1,ECO_300019380
642,Herenthoutsesteenweg 2,2021-12-19,02:00:00,6,5,1,ECO_300019380
642,Herenthoutsesteenweg 2,2021-12-19,03:00:00,1,1,0,ECO_300019380
642,Herenthoutsesteenweg 2,2021-12-19,04:00:00,1,1,0,ECO_300019380
642,Herenthoutsesteenweg 2,2021-12-19,05:00:00,1,1,0,ECO_300019380
642,Herenthoutsesteenweg 2,2021-12-19,06:00:00,3,3,0,ECO_300019380
642,Herenthoutsesteenweg 2,2021-12-19,07:00:00,4,3,1,ECO_300019380
642,Herenthoutsesteenweg 2,2021-12-19,08:00:00,12,11,1,ECO_300019380
642,Herenthoutsesteenweg 2,2021-12-19,09:00:00,28,25,3,ECO_300019380
642,Herenthoutsesteenweg 2,2021-12-19,10:00:00,65,57,8,ECO_300019380
642,Herenthoutsesteenweg 2,2021-12-19,11:00:00,85,74,11,ECO_300019380
642,Herenthoutsesteenweg 2,2021-12-19,12:00:00,82,65,17,ECO_300019380
642,Herenthoutsesteenweg 2,2021-12-19,13:00:00,20,14,6,ECO_300019380
642,Herenthoutsesteenweg 2,2021-12-19,14:00:00,38,36,2,ECO_300019380
642,Herenthoutsesteenweg 2,2021-12-19,15:00:00,32,30,2,ECO_300019380
642,Herenthoutsesteenweg 2,2021-12-19,16:00:00,30,26,4,ECO_300019380
642,Herenthoutsesteenweg 2,2021-12-19,17:00:00,18,15,3,ECO_300019380
642,Herenthoutsesteenweg 2,2021-12-19,18:00:00,7,7,0,ECO_300019380
642,Herenthoutsesteenweg 2,2021-12-19,19:00:00,9,9,0,ECO_300019380
642,Herenthoutsesteenweg 2,2021-12-19,20:00:00,8,8,0,ECO_300019380
642,Herenthoutsesteenweg 2,2021-12-19,21:00:00,7,6,1,ECO_300019380
642,Herenthoutsesteenweg 2,2021-12-19,22:00:00,4,2,2,ECO_300019380
642,Herenthoutsesteenweg 2,2021-12-19,23:00:00,4,3,1,ECO_300019380
642,Herenthoutsesteenweg 2,2021-12-20,00:00:00,1,1,0,ECO_300019380
642,Herenthoutsesteenweg 2,2021-12-20,01:00:00,1,0,1,ECO_300019380
642,Herenthoutsesteenweg 2,2021-12-20,02:00:00,0,0,0,ECO_300019380
642,Herenthoutsesteenweg 2,2021-12-20,03:00:00,0,0,0,ECO_300019380
642,Herenthoutsesteenweg 2,2021-12-20,04:00:00,2,1,1,ECO_300019380
642,Herenthoutsesteenweg 2,2021-12-20,05:00:00,2,2,0,ECO_300019380
642,Herenthoutsesteenweg 2,2021-12-20,06:00:00,12,11,1,ECO_300019380
642,Herenthoutsesteenweg 2,2021-12-20,07:00:00,32,29,3,ECO_300019380
642,Herenthoutsesteenweg 2,2021-12-20,08:00:00,83,81,2,ECO_300019380
642,Herenthoutsesteenweg 2,2021-12-20,09:00:00,251,250,1,ECO_300019380
642,Herenthoutsesteenweg 2,2021-12-20,10:00:00,50,45,5,ECO_300019380
642,Herenthoutsesteenweg 2,2021-12-20,11:00:00,46,40,6,ECO_300019380
642,Herenthoutsesteenweg 2,2021-12-20,12:00:00,53,52,1,ECO_300019380
642,Herenthoutsesteenweg 2,2021-12-20,13:00:00,132,123,9,ECO_300019380
642,Herenthoutsesteenweg 2,2021-12-20,14:00:00,96,85,11,ECO_300019380
642,Herenthoutsesteenweg 2,2021-12-20,15:00:00,87,78,9,ECO_300019380
642,Herenthoutsesteenweg 2,2021-12-20,16:00:00,56,50,6,ECO_300019380
642,Herenthoutsesteenweg 2,2021-12-20,17:00:00,74,69,5,ECO_300019380
642,Herenthoutsesteenweg 2,2021-12-20,18:00:00,37,30,7,ECO_300019380
642,Herenthoutsesteenweg 2,2021-12-20,19:00:00,20,16,4,ECO_300019380
642,Herenthoutsesteenweg 2,2021-12-20,20:00:00,17,16,1,ECO_300019380
642,Herenthoutsesteenweg 2,2021-12-20,21:00:00,13,10,3,ECO_300019380
642,Herenthoutsesteenweg 2,2021-12-20,22:00:00,10,9,1,ECO_300019380
642,Herenthoutsesteenweg 2,2021-12-20,23:00:00,15,14,1,ECO_300019380
642,Herenthoutsesteenweg 2,2021-12-21,00:00:00,5,3,2,ECO_300019380
642,Herenthoutsesteenweg 2,2021-12-21,01:00:00,2,1,1,ECO_300019380
642,Herenthoutsesteenweg 2,2021-12-21,02:00:00,2,1,1,ECO_300019380
642,Herenthoutsesteenweg 2,2021-12-21,03:00:00,1,1,0,ECO_300019380
642,Herenthoutsesteenweg 2,2021-12-21,04:00:00,1,1,0,ECO_300019380
642,Herenthoutsesteenweg 2,2021-12-21,05:00:00,3,3,0,ECO_300019380
642,Herenthoutsesteenweg 2,2021-12-21,06:00:00,15,14,1,ECO_300019380
642,Herenthoutsesteenweg 2,2021-12-21,07:00:00,33,31,2,ECO_300019380
642,Herenthoutsesteenweg 2,2021-12-21,08:00:00,86,81,5,ECO_300019380
642,Herenthoutsesteenweg 2,2021-12-21,09:00:00,201,196,5,ECO_300019380
642,Herenthoutsesteenweg 2,2021-12-21,10:00:00,60,58,2,ECO_300019380
642,Herenthoutsesteenweg 2,2021-12-21,11:00:00,47,43,4,ECO_300019380
642,Herenthoutsesteenweg 2,2021-12-21,12:00:00,55,44,11,ECO_300019380
642,Herenthoutsesteenweg 2,2021-12-21,13:00:00,91,82,9,ECO_300019380
642,Herenthoutsesteenweg 2,2021-12-21,14:00:00,87,80,7,ECO_300019380
642,Herenthoutsesteenweg 2,2021-12-21,15:00:00,95,91,4,ECO_300019380
642,Herenthoutsesteenweg 2,2021-12-21,16:00:00,49,39,10,ECO_300019380
642,Herenthoutsesteenweg 2,2021-12-21,17:00:00,94,88,6,ECO_300019380
642,Herenthoutsesteenweg 2,2021-12-21,18:00:00,48,46,2,ECO_300019380
642,Herenthoutsesteenweg 2,2021-12-21,19:00:00,21,16,5,ECO_300019380
642,Herenthoutsesteenweg 2,2021-12-21,20:00:00,11,10,1,ECO_300019380
642,Herenthoutsesteenweg 2,2021-12-21,21:00:00,21,19,2,ECO_300019380
642,Herenthoutsesteenweg 2,2021-12-21,22:00:00,5,5,0,ECO_300019380
642,Herenthoutsesteenweg 2,2021-12-21,23:00:00,14,9,5,ECO_300019380
642,Herenthoutsesteenweg 2,2021-12-22,00:00:00,1,1,0,ECO_300019380
642,Herenthoutsesteenweg 2,2021-12-22,01:00:00,3,2,1,ECO_300019380
642,Herenthoutsesteenweg 2,2021-12-22,02:00:00,1,1,0,ECO_300019380
642,Herenthoutsesteenweg 2,2021-12-22,03:00:00,0,0,0,ECO_300019380
642,Herenthoutsesteenweg 2,2021-12-22,04:00:00,0,0,0,ECO_300019380
642,Herenthoutsesteenweg 2,2021-12-22,05:00:00,4,4,0,ECO_300019380
642,Herenthoutsesteenweg 2,2021-12-22,06:00:00,14,13,1,ECO_300019380
642,Herenthoutsesteenweg 2,2021-12-22,07:00:00,30,26,4,ECO_300019380
642,Herenthoutsesteenweg 2,2021-12-22,08:00:00,57,54,3,ECO_300019380
642,Herenthoutsesteenweg 2,2021-12-22,09:00:00,42,42,0,ECO_300019380
642,Herenthoutsesteenweg 2,2021-12-22,10:00:00,38,37,1,ECO_300019380
642,Herenthoutsesteenweg 2,2021-12-22,11:00:00,37,35,2,ECO_300019380
642,Herenthoutsesteenweg 2,2021-12-22,12:00:00,36,33,3,ECO_300019380
642,Herenthoutsesteenweg 2,2021-12-22,13:00:00,48,44,4,ECO_300019380
642,Herenthoutsesteenweg 2,2021-12-22,14:00:00,89,84,5,ECO_300019380
642,Herenthoutsesteenweg 2,2021-12-22,15:00:00,82,76,6,ECO_300019380
642,Herenthoutsesteenweg 2,2021-12-22,16:00:00,53,49,4,ECO_300019380
642,Herenthoutsesteenweg 2,2021-12-22,17:00:00,55,55,0,ECO_300019380
642,Herenthoutsesteenweg 2,2021-12-22,18:00:00,31,26,5,ECO_300019380
642,Herenthoutsesteenweg 2,2021-12-22,19:00:00,18,14,4,ECO_300019380
642,Herenthoutsesteenweg 2,2021-12-22,20:00:00,17,16,1,ECO_300019380
642,Herenthoutsesteenweg 2,2021-12-22,21:00:00,11,10,1,ECO_300019380
642,Herenthoutsesteenweg 2,2021-12-22,22:00:00,11,9,2,ECO_300019380
642,Herenthoutsesteenweg 2,2021-12-22,23:00:00,13,8,5,ECO_300019380
642,Herenthoutsesteenweg 2,2021-12-23,00:00:00,5,3,2,ECO_300019380
642,Herenthoutsesteenweg 2,2021-12-23,01:00:00,1,1,0,ECO_300019380
642,Herenthoutsesteenweg 2,2021-12-23,02:00:00,2,1,1,ECO_300019380
642,Herenthoutsesteenweg 2,2021-12-23,03:00:00,0,0,0,ECO_300019380
642,Herenthoutsesteenweg 2,2021-12-23,04:00:00,0,0,0,ECO_300019380
642,Herenthoutsesteenweg 2,2021-12-23,05:00:00,5,3,2,ECO_300019380
642,Herenthoutsesteenweg 2,2021-12-23,06:00:00,12,12,0,ECO_300019380
642,Herenthoutsesteenweg 2,2021-12-23,07:00:00,31,27,4,ECO_300019380
642,Herenthoutsesteenweg 2,2021-12-23,08:00:00,49,49,0,ECO_300019380
642,Herenthoutsesteenweg 2,2021-12-23,09:00:00,38,37,1,ECO_300019380
642,Herenthoutsesteenweg 2,2021-12-23,10:00:00,37,31,6,ECO_300019380
642,Herenthoutsesteenweg 2,2021-12-23,11:00:00,52,47,5,ECO_300019380
642,Herenthoutsesteenweg 2,2021-12-23,12:00:00,44,40,4,ECO_300019380
642,Herenthoutsesteenweg 2,2021-12-23,13:00:00,59,57,2,ECO_300019380
642,Herenthoutsesteenweg 2,2021-12-23,14:00:00,60,56,4,ECO_300019380
642,Herenthoutsesteenweg 2,2021-12-23,15:00:00,74,68,6,ECO_300019380
642,Herenthoutsesteenweg 2,2021-12-23,16:00:00,60,52,8,ECO_300019380
642,Herenthoutsesteenweg 2,2021-12-23,17:00:00,56,45,11,ECO_300019380
642,Herenthoutsesteenweg 2,2021-12-23,18:00:00,45,38,7,ECO_300019380
642,Herenthoutsesteenweg 2,2021-12-23,19:00:00,25,23,2,ECO_300019380
642,Herenthoutsesteenweg 2,2021-12-23,20:00:00,20,18,2,ECO_300019380
642,Herenthoutsesteenweg 2,2021-12-23,21:00:00,15,12,3,ECO_300019380
642,Herenthoutsesteenweg 2,2021-12-23,22:00:00,10,9,1,ECO_300019380
642,Herenthoutsesteenweg 2,2021-12-23,23:00:00,3,3,0,ECO_300019380
642,Herenthoutsesteenweg 2,2021-12-24,00:00:00,1,1,0,ECO_300019380
642,Herenthoutsesteenweg 2,2021-12-24,01:00:00,2,1,1,ECO_300019380
642,Herenthoutsesteenweg 2,2021-12-24,02:00:00,3,0,3,ECO_300019380
642,Herenthoutsesteenweg 2,2021-12-24,03:00:00,1,0,1,ECO_300019380
642,Herenthoutsesteenweg 2,2021-12-24,04:00:00,0,0,0,ECO_300019380
642,Herenthoutsesteenweg 2,2021-12-24,05:00:00,7,7,0,ECO_300019380
642,Herenthoutsesteenweg 2,2021-12-24,06:00:00,8,7,1,ECO_300019380
642,Herenthoutsesteenweg 2,2021-12-24,07:00:00,6,6,0,ECO_300019380
642,Herenthoutsesteenweg 2,2021-12-24,08:00:00,27,25,2,ECO_300019380
642,Herenthoutsesteenweg 2,2021-12-24,09:00:00,40,40,0,ECO_300019380
642,Herenthoutsesteenweg 2,2021-12-24,10:00:00,63,60,3,ECO_300019380
642,Herenthoutsesteenweg 2,2021-12-24,11:00:00,76,68,8,ECO_300019380
642,Herenthoutsesteenweg 2,2021-12-24,12:00:00,48,42,6,ECO_300019380
642,Herenthoutsesteenweg 2,2021-12-24,13:00:00,36,34,2,ECO_300019380
642,Herenthoutsesteenweg 2,2021-12-24,14:00:00,55,50,5,ECO_300019380
642,Herenthoutsesteenweg 2,2021-12-24,15:00:00,69,63,6,ECO_300019380
642,Herenthoutsesteenweg 2,2021-12-24,16:00:00,41,35,6,ECO_300019380
642,Herenthoutsesteenweg 2,2021-12-24,17:00:00,20,14,6,ECO_300019380
642,Herenthoutsesteenweg 2,2021-12-24,18:00:00,11,9,2,ECO_300019380
642,Herenthoutsesteenweg 2,2021-12-24,19:00:00,9,9,0,ECO_300019380
642,Herenthoutsesteenweg 2,2021-12-24,20:00:00,4,4,0,ECO_300019380
642,Herenthoutsesteenweg 2,2021-12-24,21:00:00,6,5,1,ECO_300019380
642,Herenthoutsesteenweg 2,2021-12-24,22:00:00,2,2,0,ECO_300019380
642,Herenthoutsesteenweg 2,2021-12-24,23:00:00,3,3,0,ECO_300019380
642,Herenthoutsesteenweg 2,2021-12-25,00:00:00,2,2,0,ECO_300019380
642,Herenthoutsesteenweg 2,2021-12-25,01:00:00,2,1,1,ECO_300019380
642,Herenthoutsesteenweg 2,2021-12-25,02:00:00,4,2,2,ECO_300019380
642,Herenthoutsesteenweg 2,2021-12-25,03:00:00,2,2,0,ECO_300019380
642,Herenthoutsesteenweg 2,2021-12-25,04:00:00,0,0,0,ECO_300019380
642,Herenthoutsesteenweg 2,2021-12-25,05:00:00,1,1,0,ECO_300019380
642,Herenthoutsesteenweg 2,2021-12-25,06:00:00,1,1,0,ECO_300019380
642,Herenthoutsesteenweg 2,2021-12-25,07:00:00,1,1,0,ECO_300019380
642,Herenthoutsesteenweg 2,2021-12-25,08:00:00,0,0,0,ECO_300019380
642,Herenthoutsesteenweg 2,2021-12-25,09:00:00,1,1,0,ECO_300019380
642,Herenthoutsesteenweg 2,2021-12-25,10:00:00,2,2,0,ECO_300019380
642,Herenthoutsesteenweg 2,2021-12-25,11:00:00,7,6,1,ECO_300019380
642,Herenthoutsesteenweg 2,2021-12-25,12:00:00,5,5,0,ECO_300019380
642,Herenthoutsesteenweg 2,2021-12-25,13:00:00,22,15,7,ECO_300019380
642,Herenthoutsesteenweg 2,2021-12-25,14:00:00,20,18,2,ECO_300019380
642,Herenthoutsesteenweg 2,2021-12-25,15:00:00,15,13,2,ECO_300019380
642,Herenthoutsesteenweg 2,2021-12-25,16:00:00,24,20,4,ECO_300019380
642,Herenthoutsesteenweg 2,2021-12-25,17:00:00,5,5,0,ECO_300019380
642,Herenthoutsesteenweg 2,2021-12-25,18:00:00,9,8,1,ECO_300019380
642,Herenthoutsesteenweg 2,2021-12-25,19:00:00,10,9,1,ECO_300019380
642,Herenthoutsesteenweg 2,2021-12-25,20:00:00,2,1,1,ECO_300019380
642,Herenthoutsesteenweg 2,2021-12-25,21:00:00,13,12,1,ECO_300019380
642,Herenthoutsesteenweg 2,2021-12-25,22:00:00,6,6,0,ECO_300019380
642,Herenthoutsesteenweg 2,2021-12-25,23:00:00,4,4,0,ECO_300019380
642,Herenthoutsesteenweg 2,2021-12-26,00:00:00,2,2,0,ECO_300019380
642,Herenthoutsesteenweg 2,2021-12-26,01:00:00,4,3,1,ECO_300019380
642,Herenthoutsesteenweg 2,2021-12-26,02:00:00,1,1,0,ECO_300019380
642,Herenthoutsesteenweg 2,2021-12-26,03:00:00,3,1,2,ECO_300019380
642,Herenthoutsesteenweg 2,2021-12-26,04:00:00,0,0,0,ECO_300019380
642,Herenthoutsesteenweg 2,2021-12-26,05:00:00,0,0,0,ECO_300019380
642,Herenthoutsesteenweg 2,2021-12-26,06:00:00,4,4,0,ECO_300019380
642,Herenthoutsesteenweg 2,2021-12-26,07:00:00,2,2,0,ECO_300019380
642,Herenthoutsesteenweg 2,2021-12-26,08:00:00,6,6,0,ECO_300019380
642,Herenthoutsesteenweg 2,2021-12-26,09:00:00,19,19,0,ECO_300019380
642,Herenthoutsesteenweg 2,2021-12-26,10:00:00,48,46,2,ECO_300019380
642,Herenthoutsesteenweg 2,2021-12-26,11:00:00,61,52,9,ECO_300019380
642,Herenthoutsesteenweg 2,2021-12-26,12:00:00,56,49,7,ECO_300019380
642,Herenthoutsesteenweg 2,2021-12-26,13:00:00,47,39,8,ECO_300019380
642,Herenthoutsesteenweg 2,2021-12-26,14:00:00,35,31,4,ECO_300019380
642,Herenthoutsesteenweg 2,2021-12-26,15:00:00,27,25,2,ECO_300019380
642,Herenthoutsesteenweg 2,2021-12-26,16:00:00,20,18,2,ECO_300019380
642,Herenthoutsesteenweg 2,2021-12-26,17:00:00,22,21,1,ECO_300019380
642,Herenthoutsesteenweg 2,2021-12-26,18:00:00,9,6,3,ECO_300019380
642,Herenthoutsesteenweg 2,2021-12-26,19:00:00,13,13,0,ECO_300019380
642,Herenthoutsesteenweg 2,2021-12-26,20:00:00,8,8,0,ECO_300019380
642,Herenthoutsesteenweg 2,2021-12-26,21:00:00,2,2,0,ECO_300019380
642,Herenthoutsesteenweg 2,2021-12-26,22:00:00,10,9,1,ECO_300019380
642,Herenthoutsesteenweg 2,2021-12-26,23:00:00,3,3,0,ECO_300019380
642,Herenthoutsesteenweg 2,2021-12-27,00:00:00,8,3,5,ECO_300019380
642,Herenthoutsesteenweg 2,2021-12-27,01:00:00,1,1,0,ECO_300019380
642,Herenthoutsesteenweg 2,2021-12-27,02:00:00,3,3,0,ECO_300019380
642,Herenthoutsesteenweg 2,2021-12-27,03:00:00,0,0,0,ECO_300019380
642,Herenthoutsesteenweg 2,2021-12-27,04:00:00,0,0,0,ECO_300019380
642,Herenthoutsesteenweg 2,2021-12-27,05:00:00,2,2,0,ECO_300019380
642,Herenthoutsesteenweg 2,2021-12-27,06:00:00,5,5,0,ECO_300019380
642,Herenthoutsesteenweg 2,2021-12-27,07:00:00,14,14,0,ECO_300019380
642,Herenthoutsesteenweg 2,2021-12-27,08:00:00,18,17,1,ECO_300019380
642,Herenthoutsesteenweg 2,2021-12-27,09:00:00,30,29,1,ECO_300019380
642,Herenthoutsesteenweg 2,2021-12-27,10:00:00,43,40,3,ECO_300019380
642,Herenthoutsesteenweg 2,2021-12-27,11:00:00,49,43,6,ECO_300019380
642,Herenthoutsesteenweg 2,2021-12-27,12:00:00,40,33,7,ECO_300019380
642,Herenthoutsesteenweg 2,2021-12-27,13:00:00,40,35,5,ECO_300019380
642,Herenthoutsesteenweg 2,2021-12-27,14:00:00,89,81,8,ECO_300019380
642,Herenthoutsesteenweg 2,2021-12-27,15:00:00,73,65,8,ECO_300019380
642,Herenthoutsesteenweg 2,2021-12-27,16:00:00,31,31,0,ECO_300019380
642,Herenthoutsesteenweg 2,2021-12-27,17:00:00,34,30,4,ECO_300019380
642,Herenthoutsesteenweg 2,2021-12-27,18:00:00,19,15,4,ECO_300019380
642,Herenthoutsesteenweg 2,2021-12-27,19:00:00,10,5,5,ECO_300019380
642,Herenthoutsesteenweg 2,2021-12-27,20:00:00,15,15,0,ECO_300019380
642,Herenthoutsesteenweg 2,2021-12-27,21:00:00,4,4,0,ECO_300019380
642,Herenthoutsesteenweg 2,2021-12-27,22:00:00,11,11,0,ECO_300019380
642,Herenthoutsesteenweg 2,2021-12-27,23:00:00,6,5,1,ECO_300019380
642,Herenthoutsesteenweg 2,2021-12-28,00:00:00,9,7,2,ECO_300019380
642,Herenthoutsesteenweg 2,2021-12-28,01:00:00,0,0,0,ECO_300019380
642,Herenthoutsesteenweg 2,2021-12-28,02:00:00,0,0,0,ECO_300019380
642,Herenthoutsesteenweg 2,2021-12-28,03:00:00,1,1,0,ECO_300019380
642,Herenthoutsesteenweg 2,2021-12-28,04:00:00,0,0,0,ECO_300019380
642,Herenthoutsesteenweg 2,2021-12-28,05:00:00,3,3,0,ECO_300019380
642,Herenthoutsesteenweg 2,2021-12-28,06:00:00,8,7,1,ECO_300019380
642,Herenthoutsesteenweg 2,2021-12-28,07:00:00,13,12,1,ECO_300019380
642,Herenthoutsesteenweg 2,2021-12-28,08:00:00,23,21,2,ECO_300019380
642,Herenthoutsesteenweg 2,2021-12-28,09:00:00,25,24,1,ECO_300019380
642,Herenthoutsesteenweg 2,2021-12-28,10:00:00,35,35,0,ECO_300019380
642,Herenthoutsesteenweg 2,2021-12-28,11:00:00,31,25,6,ECO_300019380
642,Herenthoutsesteenweg 2,2021-12-28,12:00:00,29,26,3,ECO_300019380
642,Herenthoutsesteenweg 2,2021-12-28,13:00:00,19,16,3,ECO_300019380
642,Herenthoutsesteenweg 2,2021-12-28,14:00:00,38,34,4,ECO_300019380
642,Herenthoutsesteenweg 2,2021-12-28,15:00:00,32,29,3,ECO_300019380
642,Herenthoutsesteenweg 2,2021-12-28,16:00:00,13,10,3,ECO_300019380
642,Herenthoutsesteenweg 2,2021-12-28,17:00:00,11,8,3,ECO_300019380
642,Herenthoutsesteenweg 2,2021-12-28,18:00:00,13,13,0,ECO_300019380
642,Herenthoutsesteenweg 2,2021-12-28,19:00:00,7,6,1,ECO_300019380
642,Herenthoutsesteenweg 2,2021-12-28,20:00:00,17,17,0,ECO_300019380
642,Herenthoutsesteenweg 2,2021-12-28,21:00:00,9,9,0,ECO_300019380
642,Herenthoutsesteenweg 2,2021-12-28,22:00:00,2,1,1,ECO_300019380
642,Herenthoutsesteenweg 2,2021-12-28,23:00:00,4,3,1,ECO_300019380
642,Herenthoutsesteenweg 2,2021-12-29,00:00:00,1,1,0,ECO_300019380
642,Herenthoutsesteenweg 2,2021-12-29,01:00:00,1,1,0,ECO_300019380
642,Herenthoutsesteenweg 2,2021-12-29,02:00:00,1,1,0,ECO_300019380
642,Herenthoutsesteenweg 2,2021-12-29,03:00:00,0,0,0,ECO_300019380
642,Herenthoutsesteenweg 2,2021-12-29,04:00:00,0,0,0,ECO_300019380
642,Herenthoutsesteenweg 2,2021-12-29,05:00:00,1,1,0,ECO_300019380
642,Herenthoutsesteenweg 2,2021-12-29,06:00:00,6,4,2,ECO_300019380
642,Herenthoutsesteenweg 2,2021-12-29,07:00:00,9,8,1,ECO_300019380
642,Herenthoutsesteenweg 2,2021-12-29,08:00:00,19,19,0,ECO_300019380
642,Herenthoutsesteenweg 2,2021-12-29,09:00:00,26,25,1,ECO_300019380
642,Herenthoutsesteenweg 2,2021-12-29,10:00:00,53,50,3,ECO_300019380
642,Herenthoutsesteenweg 2,2021-12-29,11:00:00,47,42,5,ECO_300019380
642,Herenthoutsesteenweg 2,2021-12-29,12:00:00,45,40,5,ECO_300019380
642,Herenthoutsesteenweg 2,2021-12-29,13:00:00,40,37,3,ECO_300019380
642,Herenthoutsesteenweg 2,2021-12-29,14:00:00,65,61,4,ECO_300019380
642,Herenthoutsesteenweg 2,2021-12-29,15:00:00,26,22,4,ECO_300019380
642,Herenthoutsesteenweg 2,2021-12-29,16:00:00,19,13,6,ECO_300019380
642,Herenthoutsesteenweg 2,2021-12-29,17:00:00,25,23,2,ECO_300019380
642,Herenthoutsesteenweg 2,2021-12-29,18:00:00,28,19,9,ECO_300019380
642,Herenthoutsesteenweg 2,2021-12-29,19:00:00,11,8,3,ECO_300019380
642,Herenthoutsesteenweg 2,2021-12-29,20:00:00,13,10,3,ECO_300019380
642,Herenthoutsesteenweg 2,2021-12-29,21:00:00,19,16,3,ECO_300019380
642,Herenthoutsesteenweg 2,2021-12-29,22:00:00,6,6,0,ECO_300019380
642,Herenthoutsesteenweg 2,2021-12-29,23:00:00,2,2,0,ECO_300019380
642,Herenthoutsesteenweg 2,2021-12-30,00:00:00,4,3,1,ECO_300019380
642,Herenthoutsesteenweg 2,2021-12-30,01:00:00,4,3,1,ECO_300019380
642,Herenthoutsesteenweg 2,2021-12-30,02:00:00,1,1,0,ECO_300019380
642,Herenthoutsesteenweg 2,2021-12-30,03:00:00,1,1,0,ECO_300019380
642,Herenthoutsesteenweg 2,2021-12-30,04:00:00,0,0,0,ECO_300019380
642,Herenthoutsesteenweg 2,2021-12-30,05:00:00,2,2,0,ECO_300019380
642,Herenthoutsesteenweg 2,2021-12-30,06:00:00,8,7,1,ECO_300019380
642,Herenthoutsesteenweg 2,2021-12-30,07:00:00,10,10,0,ECO_300019380
642,Herenthoutsesteenweg 2,2021-12-30,08:00:00,25,24,1,ECO_300019380
642,Herenthoutsesteenweg 2,2021-12-30,09:00:00,32,30,2,ECO_300019380
642,Herenthoutsesteenweg 2,2021-12-30,10:00:00,42,40,2,ECO_300019380
642,Herenthoutsesteenweg 2,2021-12-30,11:00:00,60,56,4,ECO_300019380
642,Herenthoutsesteenweg 2,2021-12-30,12:00:00,52,48,4,ECO_300019380
642,Herenthoutsesteenweg 2,2021-12-30,13:00:00,55,44,11,ECO_300019380
642,Herenthoutsesteenweg 2,2021-12-30,14:00:00,77,71,6,ECO_300019380
642,Herenthoutsesteenweg 2,2021-12-30,15:00:00,75,68,7,ECO_300019380
642,Herenthoutsesteenweg 2,2021-12-30,16:00:00,75,66,9,ECO_300019380
642,Herenthoutsesteenweg 2,2021-12-30,17:00:00,63,57,6,ECO_300019380
642,Herenthoutsesteenweg 2,2021-12-30,18:00:00,21,20,1,ECO_300019380
642,Herenthoutsesteenweg 2,2021-12-30,19:00:00,12,11,1,ECO_300019380
642,Herenthoutsesteenweg 2,2021-12-30,20:00:00,18,16,2,ECO_300019380
642,Herenthoutsesteenweg 2,2021-12-30,21:00:00,7,7,0,ECO_300019380
642,Herenthoutsesteenweg 2,2021-12-30,22:00:00,5,4,1,ECO_300019380
642,Herenthoutsesteenweg 2,2021-12-30,23:00:00,7,6,1,ECO_300019380
642,Herenthoutsesteenweg 2,2021-12-31,00:00:00,7,6,1,ECO_300019380
642,Herenthoutsesteenweg 2,2021-12-31,01:00:00,3,3,0,ECO_300019380
642,Herenthoutsesteenweg 2,2021-12-31,02:00:00,1,1,0,ECO_300019380
642,Herenthoutsesteenweg 2,2021-12-31,03:00:00,0,0,0,ECO_300019380
642,Herenthoutsesteenweg 2,2021-12-31,04:00:00,1,1,0,ECO_300019380
642,Herenthoutsesteenweg 2,2021-12-31,05:00:00,1,1,0,ECO_300019380
642,Herenthoutsesteenweg 2,2021-12-31,06:00:00,1,1,0,ECO_300019380
642,Herenthoutsesteenweg 2,2021-12-31,07:00:00,11,10,1,ECO_300019380
642,Herenthoutsesteenweg 2,2021-12-31,08:00:00,30,27,3,ECO_300019380
642,Herenthoutsesteenweg 2,2021-12-31,09:00:00,45,42,3,ECO_300019380
642,Herenthoutsesteenweg 2,2021-12-31,10:00:00,73,67,6,ECO_300019380
642,Herenthoutsesteenweg 2,2021-12-31,11:00:00,83,69,14,ECO_300019380
642,Herenthoutsesteenweg 2,2021-12-31,12:00:00,84,72,12,ECO_300019380
642,Herenthoutsesteenweg 2,2021-12-31,13:00:00,65,57,8,ECO_300019380
642,Herenthoutsesteenweg 2,2021-12-31,14:00:00,86,80,6,ECO_300019380
642,Herenthoutsesteenweg 2,2021-12-31,15:00:00,88,80,8,ECO_300019380
642,Herenthoutsesteenweg 2,2021-12-31,16:00:00,56,51,5,ECO_300019380
642,Herenthoutsesteenweg 2,2021-12-31,17:00:00,22,21,1,ECO_300019380
642,Herenthoutsesteenweg 2,2021-12-31,18:00:00,28,27,1,ECO_300019380
642,Herenthoutsesteenweg 2,2021-12-31,19:00:00,20,16,4,ECO_300019380
642,Herenthoutsesteenweg 2,2021-12-31,20:00:00,12,11,1,ECO_300019380
642,Herenthoutsesteenweg 2,2021-12-31,21:00:00,8,6,2,ECO_300019380
642,Herenthoutsesteenweg 2,2021-12-31,22:00:00,7,7,0,ECO_300019380
642,Herenthoutsesteenweg 2,2021-12-31,23:00:00,9,8,1,ECO_300019380
642,Herenthoutsesteenweg 2,2022-01-01,00:00:00,4,4,0,ECO_300019380
642,Herenthoutsesteenweg 2,2022-01-01,01:00:00,8,7,1,ECO_300019380
642,Herenthoutsesteenweg 2,2022-01-01,02:00:00,21,18,3,ECO_300019380
642,Herenthoutsesteenweg 2,2022-01-01,03:00:00,12,11,1,ECO_300019380
642,Herenthoutsesteenweg 2,2022-01-01,04:00:00,13,9,4,ECO_300019380
642,Herenthoutsesteenweg 2,2022-01-01,05:00:00,10,7,3,ECO_300019380
642,Herenthoutsesteenweg 2,2022-01-01,06:00:00,1,0,1,ECO_300019380
642,Herenthoutsesteenweg 2,2022-01-01,07:00:00,3,3,0,ECO_300019380
642,Herenthoutsesteenweg 2,2022-01-01,08:00:00,3,3,0,ECO_300019380
642,Herenthoutsesteenweg 2,2022-01-01,09:00:00,5,5,0,ECO_300019380
642,Herenthoutsesteenweg 2,2022-01-01,10:00:00,24,20,4,ECO_300019380
642,Herenthoutsesteenweg 2,2022-01-01,11:00:00,40,35,5,ECO_300019380
642,Herenthoutsesteenweg 2,2022-01-01,12:00:00,54,48,6,ECO_300019380
642,Herenthoutsesteenweg 2,2022-01-01,13:00:00,59,48,11,ECO_300019380
642,Herenthoutsesteenweg 2,2022-01-01,14:00:00,71,66,5,ECO_300019380
642,Herenthoutsesteenweg 2,2022-01-01,15:00:00,72,62,10,ECO_300019380
642,Herenthoutsesteenweg 2,2022-01-01,16:00:00,47,40,7,ECO_300019380
642,Herenthoutsesteenweg 2,2022-01-01,17:00:00,29,26,3,ECO_300019380
642,Herenthoutsesteenweg 2,2022-01-01,18:00:00,13,12,1,ECO_300019380
642,Herenthoutsesteenweg 2,2022-01-01,19:00:00,17,15,2,ECO_300019380
642,Herenthoutsesteenweg 2,2022-01-01,20:00:00,14,13,1,ECO_300019380
642,Herenthoutsesteenweg 2,2022-01-01,21:00:00,12,12,0,ECO_300019380
642,Herenthoutsesteenweg 2,2022-01-01,22:00:00,5,5,0,ECO_300019380
642,Herenthoutsesteenweg 2,2022-01-01,23:00:00,2,1,1,ECO_300019380
642,Herenthoutsesteenweg 2,2022-01-02,00:00:00,3,1,2,ECO_300019380
642,Herenthoutsesteenweg 2,2022-01-02,01:00:00,0,0,0,ECO_300019380
642,Herenthoutsesteenweg 2,2022-01-02,02:00:00,3,2,1,ECO_300019380
642,Herenthoutsesteenweg 2,2022-01-02,03:00:00,1,0,1,ECO_300019380
642,Herenthoutsesteenweg 2,2022-01-02,04:00:00,2,2,0,ECO_300019380
642,Herenthoutsesteenweg 2,2022-01-02,05:00:00,2,1,1,ECO_300019380
642,Herenthoutsesteenweg 2,2022-01-02,06:00:00,0,0,0,ECO_300019380
642,Herenthoutsesteenweg 2,2022-01-02,07:00:00,2,2,0,ECO_300019380
642,Herenthoutsesteenweg 2,2022-01-02,08:00:00,3,3,0,ECO_300019380
642,Herenthoutsesteenweg 2,2022-01-02,09:00:00,25,23,2,ECO_300019380
642,Herenthoutsesteenweg 2,2022-01-02,10:00:00,57,49,8,ECO_300019380
642,Herenthoutsesteenweg 2,2022-01-02,11:00:00,72,68,4,ECO_300019380
642,Herenthoutsesteenweg 2,2022-01-02,12:00:00,72,64,8,ECO_300019380
642,Herenthoutsesteenweg 2,2022-01-02,13:00:00,45,33,12,ECO_300019380
642,Herenthoutsesteenweg 2,2022-01-02,14:00:00,43,37,6,ECO_300019380
642,Herenthoutsesteenweg 2,2022-01-02,15:00:00,46,41,5,ECO_300019380
642,Herenthoutsesteenweg 2,2022-01-02,16:00:00,30,29,1,ECO_300019380
642,Herenthoutsesteenweg 2,2022-01-02,17:00:00,23,18,5,ECO_300019380
642,Herenthoutsesteenweg 2,2022-01-02,18:00:00,19,18,1,ECO_300019380
642,Herenthoutsesteenweg 2,2022-01-02,19:00:00,10,10,0,ECO_300019380
642,Herenthoutsesteenweg 2,2022-01-02,20:00:00,13,8,5,ECO_300019380
642,Herenthoutsesteenweg 2,2022-01-02,21:00:00,11,11,0,ECO_300019380
642,Herenthoutsesteenweg 2,2022-01-02,22:00:00,3,3,0,ECO_300019380
642,Herenthoutsesteenweg 2,2022-01-02,23:00:00,4,3,1,ECO_300019380
642,Herenthoutsesteenweg 2,2022-01-03,00:00:00,0,0,0,ECO_300019380
642,Herenthoutsesteenweg 2,2022-01-03,01:00:00,1,1,0,ECO_300019380
642,Herenthoutsesteenweg 2,2022-01-03,02:00:00,0,0,0,ECO_300019380
642,Herenthoutsesteenweg 2,2022-01-03,03:00:00,0,0,0,ECO_300019380
642,Herenthoutsesteenweg 2,2022-01-03,04:00:00,0,0,0,ECO_300019380
642,Herenthoutsesteenweg 2,2022-01-03,05:00:00,1,1,0,ECO_300019380
642,Herenthoutsesteenweg 2,2022-01-03,06:00:00,15,12,3,ECO_300019380
642,Herenthoutsesteenweg 2,2022-01-03,07:00:00,25,24,1,ECO_300019380
642,Herenthoutsesteenweg 2,2022-01-03,08:00:00,34,32,2,ECO_300019380
642,Herenthoutsesteenweg 2,2022-01-03,09:00:00,37,35,2,ECO_300019380
642,Herenthoutsesteenweg 2,2022-01-03,10:00:00,42,42,0,ECO_300019380
642,Herenthoutsesteenweg 2,2022-01-03,11:00:00,44,39,5,ECO_300019380
642,Herenthoutsesteenweg 2,2022-01-03,12:00:00,43,38,5,ECO_300019380
642,Herenthoutsesteenweg 2,2022-01-03,13:00:00,38,33,5,ECO_300019380
642,Herenthoutsesteenweg 2,2022-01-03,14:00:00,29,27,2,ECO_300019380
642,Herenthoutsesteenweg 2,2022-01-03,15:00:00,38,36,2,ECO_300019380
642,Herenthoutsesteenweg 2,2022-01-03,16:00:00,29,26,3,ECO_300019380
642,Herenthoutsesteenweg 2,2022-01-03,17:00:00,35,33,2,ECO_300019380
642,Herenthoutsesteenweg 2,2022-01-03,18:00:00,18,17,1,ECO_300019380
642,Herenthoutsesteenweg 2,2022-01-03,19:00:00,11,11,0,ECO_300019380
642,Herenthoutsesteenweg 2,2022-01-03,20:00:00,18,16,2,ECO_300019380
642,Herenthoutsesteenweg 2,2022-01-03,21:00:00,6,4,2,ECO_300019380
642,Herenthoutsesteenweg 2,2022-01-03,22:00:00,3,3,0,ECO_300019380
642,Herenthoutsesteenweg 2,2022-01-03,23:00:00,4,4,0,ECO_300019380
642,Herenthoutsesteenweg 2,2022-01-04,00:00:00,4,3,1,ECO_300019380
642,Herenthoutsesteenweg 2,2022-01-04,01:00:00,0,0,0,ECO_300019380
642,Herenthoutsesteenweg 2,2022-01-04,02:00:00,0,0,0,ECO_300019380
642,Herenthoutsesteenweg 2,2022-01-04,03:00:00,0,0,0,ECO_300019380
642,Herenthoutsesteenweg 2,2022-01-04,04:00:00,1,1,0,ECO_300019380
642,Herenthoutsesteenweg 2,2022-01-04,05:00:00,2,2,0,ECO_300019380
642,Herenthoutsesteenweg 2,2022-01-04,06:00:00,9,7,2,ECO_300019380
642,Herenthoutsesteenweg 2,2022-01-04,07:00:00,24,24,0,ECO_300019380
642,Herenthoutsesteenweg 2,2022-01-04,08:00:00,36,32,4,ECO_300019380
642,Herenthoutsesteenweg 2,2022-01-04,09:00:00,22,22,0,ECO_300019380
642,Herenthoutsesteenweg 2,2022-01-04,10:00:00,41,37,4,ECO_300019380
642,Herenthoutsesteenweg 2,2022-01-04,11:00:00,44,41,3,ECO_300019380
642,Herenthoutsesteenweg 2,2022-01-04,12:00:00,51,48,3,ECO_300019380
642,Herenthoutsesteenweg 2,2022-01-04,13:00:00,45,41,4,ECO_300019380
642,Herenthoutsesteenweg 2,2022-01-04,14:00:00,59,56,3,ECO_300019380
642,Herenthoutsesteenweg 2,2022-01-04,15:00:00,31,31,0,ECO_300019380
642,Herenthoutsesteenweg 2,2022-01-04,16:00:00,15,12,3,ECO_300019380
642,Herenthoutsesteenweg 2,2022-01-04,17:00:00,32,27,5,ECO_300019380
642,Herenthoutsesteenweg 2,2022-01-04,18:00:00,24,22,2,ECO_300019380
642,Herenthoutsesteenweg 2,2022-01-04,19:00:00,18,16,2,ECO_300019380
642,Herenthoutsesteenweg 2,2022-01-04,20:00:00,12,7,5,ECO_300019380
642,Herenthoutsesteenweg 2,2022-01-04,21:00:00,12,10,2,ECO_300019380
642,Herenthoutsesteenweg 2,2022-01-04,22:00:00,4,4,0,ECO_300019380
642,Herenthoutsesteenweg 2,2022-01-04,23:00:00,8,7,1,ECO_300019380
642,Herenthoutsesteenweg 2,2022-01-05,00:00:00,0,0,0,ECO_300019380
642,Herenthoutsesteenweg 2,2022-01-05,01:00:00,1,1,0,ECO_300019380
642,Herenthoutsesteenweg 2,2022-01-05,02:00:00,1,1,0,ECO_300019380
642,Herenthoutsesteenweg 2,2022-01-05,03:00:00,1,1,0,ECO_300019380
642,Herenthoutsesteenweg 2,2022-01-05,04:00:00,0,0,0,ECO_300019380
642,Herenthoutsesteenweg 2,2022-01-05,05:00:00,2,1,1,ECO_300019380
642,Herenthoutsesteenweg 2,2022-01-05,06:00:00,17,15,2,ECO_300019380
642,Herenthoutsesteenweg 2,2022-01-05,07:00:00,34,33,1,ECO_300019380
642,Herenthoutsesteenweg 2,2022-01-05,08:00:00,40,39,1,ECO_300019380
642,Herenthoutsesteenweg 2,2022-01-05,09:00:00,29,28,1,ECO_300019380
642,Herenthoutsesteenweg 2,2022-01-05,10:00:00,36,36,0,ECO_300019380
642,Herenthoutsesteenweg 2,2022-01-05,11:00:00,44,42,2,ECO_300019380
642,Herenthoutsesteenweg 2,2022-01-05,12:00:00,56,55,1,ECO_300019380
642,Herenthoutsesteenweg 2,2022-01-05,13:00:00,64,56,8,ECO_300019380
642,Herenthoutsesteenweg 2,2022-01-05,14:00:00,83,75,8,ECO_300019380
642,Herenthoutsesteenweg 2,2022-01-05,15:00:00,47,43,4,ECO_300019380
642,Herenthoutsesteenweg 2,2022-01-05,16:00:00,54,46,8,ECO_300019380
642,Herenthoutsesteenweg 2,2022-01-05,17:00:00,62,57,5,ECO_300019380
642,Herenthoutsesteenweg 2,2022-01-05,18:00:00,30,28,2,ECO_300019380
642,Herenthoutsesteenweg 2,2022-01-05,19:00:00,15,14,1,ECO_300019380
642,Herenthoutsesteenweg 2,2022-01-05,20:00:00,5,5,0,ECO_300019380
642,Herenthoutsesteenweg 2,2022-01-05,21:00:00,15,13,2,ECO_300019380
642,Herenthoutsesteenweg 2,2022-01-05,22:00:00,8,6,2,ECO_300019380
642,Herenthoutsesteenweg 2,2022-01-05,23:00:00,5,4,1,ECO_300019380
642,Herenthoutsesteenweg 2,2022-01-06,00:00:00,2,2,0,ECO_300019380
642,Herenthoutsesteenweg 2,2022-01-06,01:00:00,0,0,0,ECO_300019380
642,Herenthoutsesteenweg 2,2022-01-06,02:00:00,3,2,1,ECO_300019380
642,Herenthoutsesteenweg 2,2022-01-06,03:00:00,0,0,0,ECO_300019380
642,Herenthoutsesteenweg 2,2022-01-06,04:00:00,3,3,0,ECO_300019380
642,Herenthoutsesteenweg 2,2022-01-06,05:00:00,3,3,0,ECO_300019380
642,Herenthoutsesteenweg 2,2022-01-06,06:00:00,17,16,1,ECO_300019380
642,Herenthoutsesteenweg 2,2022-01-06,07:00:00,22,22,0,ECO_300019380
642,Herenthoutsesteenweg 2,2022-01-06,08:00:00,46,45,1,ECO_300019380
642,Herenthoutsesteenweg 2,2022-01-06,09:00:00,40,38,2,ECO_300019380
642,Herenthoutsesteenweg 2,2022-01-06,10:00:00,29,28,1,ECO_300019380
642,Herenthoutsesteenweg 2,2022-01-06,11:00:00,55,53,2,ECO_300019380
642,Herenthoutsesteenweg 2,2022-01-06,12:00:00,56,55,1,ECO_300019380
642,Herenthoutsesteenweg 2,2022-01-06,13:00:00,88,81,7,ECO_300019380
642,Herenthoutsesteenweg 2,2022-01-06,14:00:00,99,94,5,ECO_300019380
642,Herenthoutsesteenweg 2,2022-01-06,15:00:00,106,98,8,ECO_300019380
642,Herenthoutsesteenweg 2,2022-01-06,16:00:00,64,59,5,ECO_300019380
642,Herenthoutsesteenweg 2,2022-01-06,17:00:00,85,73,12,ECO_300019380
642,Herenthoutsesteenweg 2,2022-01-06,18:00:00,36,33,3,ECO_300019380
642,Herenthoutsesteenweg 2,2022-01-06,19:00:00,17,15,2,ECO_300019380
642,Herenthoutsesteenweg 2,2022-01-06,20:00:00,19,16,3,ECO_300019380
642,Herenthoutsesteenweg 2,2022-01-06,21:00:00,12,9,3,ECO_300019380
642,Herenthoutsesteenweg 2,2022-01-06,22:00:00,4,3,1,ECO_300019380
642,Herenthoutsesteenweg 2,2022-01-06,23:00:00,10,8,2,ECO_300019380
642,Herenthoutsesteenweg 2,2022-01-07,00:00:00,7,4,3,ECO_300019380
642,Herenthoutsesteenweg 2,2022-01-07,01:00:00,1,1,0,ECO_300019380
642,Herenthoutsesteenweg 2,2022-01-07,02:00:00,3,3,0,ECO_300019380
642,Herenthoutsesteenweg 2,2022-01-07,03:00:00,0,0,0,ECO_300019380
642,Herenthoutsesteenweg 2,2022-01-07,04:00:00,1,1,0,ECO_300019380
642,Herenthoutsesteenweg 2,2022-01-07,05:00:00,1,1,0,ECO_300019380
642,Herenthoutsesteenweg 2,2022-01-07,06:00:00,8,7,1,ECO_300019380
642,Herenthoutsesteenweg 2,2022-01-07,07:00:00,14,14,0,ECO_300019380
642,Herenthoutsesteenweg 2,2022-01-07,08:00:00,36,34,2,ECO_300019380
642,Herenthoutsesteenweg 2,2022-01-07,09:00:00,29,28,1,ECO_300019380
642,Herenthoutsesteenweg 2,2022-01-07,10:00:00,49,48,1,ECO_300019380
642,Herenthoutsesteenweg 2,2022-01-07,11:00:00,70,69,1,ECO_300019380
642,Herenthoutsesteenweg 2,2022-01-07,12:00:00,58,51,7,ECO_300019380
642,Herenthoutsesteenweg 2,2022-01-07,13:00:00,29,24,5,ECO_300019380
642,Herenthoutsesteenweg 2,2022-01-07,14:00:00,66,63,3,ECO_300019380
642,Herenthoutsesteenweg 2,2022-01-07,15:00:00,49,41,8,ECO_300019380
642,Herenthoutsesteenweg 2,2022-01-07,16:00:00,33,32,1,ECO_300019380
642,Herenthoutsesteenweg 2,2022-01-07,17:00:00,52,49,3,ECO_300019380
642,Herenthoutsesteenweg 2,2022-01-07,18:00:00,15,14,1,ECO_300019380
642,Herenthoutsesteenweg 2,2022-01-07,19:00:00,21,17,4,ECO_300019380
642,Herenthoutsesteenweg 2,2022-01-07,20:00:00,17,17,0,ECO_300019380
642,Herenthoutsesteenweg 2,2022-01-07,21:00:00,22,19,3,ECO_300019380
642,Herenthoutsesteenweg 2,2022-01-07,22:00:00,6,6,0,ECO_300019380
642,Herenthoutsesteenweg 2,2022-01-07,23:00:00,10,8,2,ECO_300019380
642,Herenthoutsesteenweg 2,2022-01-08,00:00:00,11,10,1,ECO_300019380
642,Herenthoutsesteenweg 2,2022-01-08,01:00:00,6,3,3,ECO_300019380
642,Herenthoutsesteenweg 2,2022-01-08,02:00:00,2,1,1,ECO_300019380
642,Herenthoutsesteenweg 2,2022-01-08,03:00:00,3,3,0,ECO_300019380
642,Herenthoutsesteenweg 2,2022-01-08,04:00:00,0,0,0,ECO_300019380
642,Herenthoutsesteenweg 2,2022-01-08,05:00:00,2,2,0,ECO_300019380
642,Herenthoutsesteenweg 2,2022-01-08,06:00:00,2,2,0,ECO_300019380
642,Herenthoutsesteenweg 2,2022-01-08,07:00:00,2,2,0,ECO_300019380
642,Herenthoutsesteenweg 2,2022-01-08,08:00:00,6,5,1,ECO_300019380
642,Herenthoutsesteenweg 2,2022-01-08,09:00:00,24,24,0,ECO_300019380
642,Herenthoutsesteenweg 2,2022-01-08,10:00:00,51,49,2,ECO_300019380
642,Herenthoutsesteenweg 2,2022-01-08,11:00:00,42,42,0,ECO_300019380
642,Herenthoutsesteenweg 2,2022-01-08,12:00:00,54,46,8,ECO_300019380
642,Herenthoutsesteenweg 2,2022-01-08,13:00:00,43,32,11,ECO_300019380
642,Herenthoutsesteenweg 2,2022-01-08,14:00:00,20,20,0,ECO_300019380
642,Herenthoutsesteenweg 2,2022-01-08,15:00:00,13,11,2,ECO_300019380
642,Herenthoutsesteenweg 2,2022-01-08,16:00:00,10,10,0,ECO_300019380
642,Herenthoutsesteenweg 2,2022-01-08,17:00:00,10,10,0,ECO_300019380
642,Herenthoutsesteenweg 2,2022-01-08,18:00:00,8,8,0,ECO_300019380
642,Herenthoutsesteenweg 2,2022-01-08,19:00:00,8,8,0,ECO_300019380
642,Herenthoutsesteenweg 2,2022-01-08,20:00:00,11,11,0,ECO_300019380
642,Herenthoutsesteenweg 2,2022-01-08,21:00:00,5,4,1,ECO_300019380
642,Herenthoutsesteenweg 2,2022-01-08,22:00:00,6,4,2,ECO_300019380
642,Herenthoutsesteenweg 2,2022-01-08,23:00:00,1,1,0,ECO_300019380
642,Herenthoutsesteenweg 2,2022-01-09,00:00:00,3,1,2,ECO_300019380
642,Herenthoutsesteenweg 2,2022-01-09,01:00:00,3,3,0,ECO_300019380
642,Herenthoutsesteenweg 2,2022-01-09,02:00:00,4,1,3,ECO_300019380
642,Herenthoutsesteenweg 2,2022-01-09,03:00:00,0,0,0,ECO_300019380
642,Herenthoutsesteenweg 2,2022-01-09,04:00:00,0,0,0,ECO_300019380
642,Herenthoutsesteenweg 2,2022-01-09,05:00:00,3,2,1,ECO_300019380
642,Herenthoutsesteenweg 2,2022-01-09,06:00:00,1,0,1,ECO_300019380
642,Herenthoutsesteenweg 2,2022-01-09,07:00:00,8,5,3,ECO_300019380
642,Herenthoutsesteenweg 2,2022-01-09,08:00:00,4,4,0,ECO_300019380
642,Herenthoutsesteenweg 2,2022-01-09,09:00:00,21,18,3,ECO_300019380
642,Herenthoutsesteenweg 2,2022-01-09,10:00:00,83,69,14,ECO_300019380
642,Herenthoutsesteenweg 2,2022-01-09,11:00:00,78,74,4,ECO_300019380
642,Herenthoutsesteenweg 2,2022-01-09,12:00:00,58,43,15,ECO_300019380
642,Herenthoutsesteenweg 2,2022-01-09,13:00:00,48,36,12,ECO_300019380
642,Herenthoutsesteenweg 2,2022-01-09,14:00:00,40,32,8,ECO_300019380
642,Herenthoutsesteenweg 2,2022-01-09,15:00:00,38,30,8,ECO_300019380
642,Herenthoutsesteenweg 2,2022-01-09,16:00:00,19,18,1,ECO_300019380
642,Herenthoutsesteenweg 2,2022-01-09,17:00:00,19,17,2,ECO_300019380
642,Herenthoutsesteenweg 2,2022-01-09,18:00:00,14,12,2,ECO_300019380
642,Herenthoutsesteenweg 2,2022-01-09,19:00:00,9,7,2,ECO_300019380
642,Herenthoutsesteenweg 2,2022-01-09,20:00:00,14,11,3,ECO_300019380
642,Herenthoutsesteenweg 2,2022-01-09,21:00:00,2,1,1,ECO_300019380
642,Herenthoutsesteenweg 2,2022-01-09,22:00:00,1,0,1,ECO_300019380
642,Herenthoutsesteenweg 2,2022-01-09,23:00:00,3,2,1,ECO_300019380
642,Herenthoutsesteenweg 2,2022-01-10,00:00:00,1,1,0,ECO_300019380
642,Herenthoutsesteenweg 2,2022-01-10,01:00:00,0,0,0,ECO_300019380
642,Herenthoutsesteenweg 2,2022-01-10,02:00:00,0,0,0,ECO_300019380
642,Herenthoutsesteenweg 2,2022-01-10,03:00:00,0,0,0,ECO_300019380
642,Herenthoutsesteenweg 2,2022-01-10,04:00:00,1,1,0,ECO_300019380
642,Herenthoutsesteenweg 2,2022-01-10,05:00:00,3,3,0,ECO_300019380
642,Herenthoutsesteenweg 2,2022-01-10,06:00:00,13,13,0,ECO_300019380
642,Herenthoutsesteenweg 2,2022-01-10,07:00:00,40,38,2,ECO_300019380
642,Herenthoutsesteenweg 2,2022-01-10,08:00:00,122,121,1,ECO_300019380
642,Herenthoutsesteenweg 2,2022-01-10,09:00:00,529,524,5,ECO_300019380
642,Herenthoutsesteenweg 2,2022-01-10,10:00:00,59,59,0,ECO_300019380
642,Herenthoutsesteenweg 2,2022-01-10,11:00:00,37,37,0,ECO_300019380
642,Herenthoutsesteenweg 2,2022-01-10,12:00:00,28,26,2,ECO_300019380
642,Herenthoutsesteenweg 2,2022-01-10,13:00:00,48,45,3,ECO_300019380
642,Herenthoutsesteenweg 2,2022-01-10,14:00:00,46,41,5,ECO_300019380
642,Herenthoutsesteenweg 2,2022-01-10,15:00:00,60,54,6,ECO_300019380
642,Herenthoutsesteenweg 2,2022-01-10,16:00:00,77,73,4,ECO_300019380
642,Herenthoutsesteenweg 2,2022-01-10,17:00:00,68,65,3,ECO_300019380
642,Herenthoutsesteenweg 2,2022-01-10,18:00:00,42,39,3,ECO_300019380
642,Herenthoutsesteenweg 2,2022-01-10,19:00:00,21,19,2,ECO_300019380
642,Herenthoutsesteenweg 2,2022-01-10,20:00:00,8,8,0,ECO_300019380
642,Herenthoutsesteenweg 2,2022-01-10,21:00:00,8,6,2,ECO_300019380
642,Herenthoutsesteenweg 2,2022-01-10,22:00:00,3,3,0,ECO_300019380
642,Herenthoutsesteenweg 2,2022-01-10,23:00:00,12,12,0,ECO_300019380
642,Herenthoutsesteenweg 2,2022-01-11,00:00:00,2,0,2,ECO_300019380
642,Herenthoutsesteenweg 2,2022-01-11,01:00:00,0,0,0,ECO_300019380
642,Herenthoutsesteenweg 2,2022-01-11,02:00:00,0,0,0,ECO_300019380
642,Herenthoutsesteenweg 2,2022-01-11,03:00:00,1,1,0,ECO_300019380
642,Herenthoutsesteenweg 2,2022-01-11,04:00:00,1,0,1,ECO_300019380
642,Herenthoutsesteenweg 2,2022-01-11,05:00:00,5,5,0,ECO_300019380
642,Herenthoutsesteenweg 2,2022-01-11,06:00:00,14,14,0,ECO_300019380
642,Herenthoutsesteenweg 2,2022-01-11,07:00:00,30,28,2,ECO_300019380
642,Herenthoutsesteenweg 2,2022-01-11,08:00:00,121,120,1,ECO_300019380
642,Herenthoutsesteenweg 2,2022-01-11,09:00:00,488,484,4,ECO_300019380
642,Herenthoutsesteenweg 2,2022-01-11,10:00:00,73,72,1,ECO_300019380
642,Herenthoutsesteenweg 2,2022-01-11,11:00:00,46,42,4,ECO_300019380
642,Herenthoutsesteenweg 2,2022-01-11,12:00:00,39,28,11,ECO_300019380
642,Herenthoutsesteenweg 2,2022-01-11,13:00:00,57,55,2,ECO_300019380
642,Herenthoutsesteenweg 2,2022-01-11,14:00:00,98,88,10,ECO_300019380
642,Herenthoutsesteenweg 2,2022-01-11,15:00:00,85,62,23,ECO_300019380
642,Herenthoutsesteenweg 2,2022-01-11,16:00:00,80,72,8,ECO_300019380
642,Herenthoutsesteenweg 2,2022-01-11,17:00:00,78,72,6,ECO_300019380
642,Herenthoutsesteenweg 2,2022-01-11,18:00:00,52,48,4,ECO_300019380
642,Herenthoutsesteenweg 2,2022-01-11,19:00:00,27,25,2,ECO_300019380
642,Herenthoutsesteenweg 2,2022-01-11,20:00:00,17,15,2,ECO_300019380
642,Herenthoutsesteenweg 2,2022-01-11,21:00:00,12,10,2,ECO_300019380
642,Herenthoutsesteenweg 2,2022-01-11,22:00:00,7,6,1,ECO_300019380
642,Herenthoutsesteenweg 2,2022-01-11,23:00:00,10,10,0,ECO_300019380
642,Herenthoutsesteenweg 2,2022-01-12,00:00:00,3,3,0,ECO_300019380
642,Herenthoutsesteenweg 2,2022-01-12,01:00:00,1,1,0,ECO_300019380
642,Herenthoutsesteenweg 2,2022-01-12,02:00:00,0,0,0,ECO_300019380
642,Herenthoutsesteenweg 2,2022-01-12,03:00:00,2,1,1,ECO_300019380
642,Herenthoutsesteenweg 2,2022-01-12,04:00:00,0,0,0,ECO_300019380
642,Herenthoutsesteenweg 2,2022-01-12,05:00:00,1,1,0,ECO_300019380
642,Herenthoutsesteenweg 2,2022-01-12,06:00:00,13,13,0,ECO_300019380
642,Herenthoutsesteenweg 2,2022-01-12,07:00:00,26,25,1,ECO_300019380
642,Herenthoutsesteenweg 2,2022-01-12,08:00:00,108,107,1,ECO_300019380
642,Herenthoutsesteenweg 2,2022-01-12,09:00:00,486,483,3,ECO_300019380
642,Herenthoutsesteenweg 2,2022-01-12,10:00:00,50,50,0,ECO_300019380
642,Herenthoutsesteenweg 2,2022-01-12,11:00:00,46,45,1,ECO_300019380
642,Herenthoutsesteenweg 2,2022-01-12,12:00:00,32,29,3,ECO_300019380
642,Herenthoutsesteenweg 2,2022-01-12,13:00:00,93,80,13,ECO_300019380
642,Herenthoutsesteenweg 2,2022-01-12,14:00:00,78,71,7,ECO_300019380
642,Herenthoutsesteenweg 2,2022-01-12,15:00:00,61,56,5,ECO_300019380
642,Herenthoutsesteenweg 2,2022-01-12,16:00:00,45,38,7,ECO_300019380
642,Herenthoutsesteenweg 2,2022-01-12,17:00:00,66,61,5,ECO_300019380
642,Herenthoutsesteenweg 2,2022-01-12,18:00:00,39,35,4,ECO_300019380
642,Herenthoutsesteenweg 2,2022-01-12,19:00:00,25,25,0,ECO_300019380
642,Herenthoutsesteenweg 2,2022-01-12,20:00:00,28,25,3,ECO_300019380
642,Herenthoutsesteenweg 2,2022-01-12,21:00:00,17,16,1,ECO_300019380
642,Herenthoutsesteenweg 2,2022-01-12,22:00:00,4,4,0,ECO_300019380
642,Herenthoutsesteenweg 2,2022-01-12,23:00:00,8,8,0,ECO_300019380
642,Herenthoutsesteenweg 2,2022-01-13,00:00:00,3,1,2,ECO_300019380
642,Herenthoutsesteenweg 2,2022-01-13,01:00:00,2,1,1,ECO_300019380
642,Herenthoutsesteenweg 2,2022-01-13,02:00:00,0,0,0,ECO_300019380
642,Herenthoutsesteenweg 2,2022-01-13,03:00:00,0,0,0,ECO_300019380
642,Herenthoutsesteenweg 2,2022-01-13,04:00:00,0,0,0,ECO_300019380
642,Herenthoutsesteenweg 2,2022-01-13,05:00:00,3,3,0,ECO_300019380
642,Herenthoutsesteenweg 2,2022-01-13,06:00:00,11,11,0,ECO_300019380
642,Herenthoutsesteenweg 2,2022-01-13,07:00:00,29,28,1,ECO_300019380
642,Herenthoutsesteenweg 2,2022-01-13,08:00:00,119,117,2,ECO_300019380
642,Herenthoutsesteenweg 2,2022-01-13,09:00:00,458,455,3,ECO_300019380
642,Herenthoutsesteenweg 2,2022-01-13,10:00:00,66,65,1,ECO_300019380
642,Herenthoutsesteenweg 2,2022-01-13,11:00:00,30,25,5,ECO_300019380
642,Herenthoutsesteenweg 2,2022-01-13,12:00:00,43,40,3,ECO_300019380
642,Herenthoutsesteenweg 2,2022-01-13,13:00:00,43,39,4,ECO_300019380
642,Herenthoutsesteenweg 2,2022-01-13,14:00:00,56,54,2,ECO_300019380
642,Herenthoutsesteenweg 2,2022-01-13,15:00:00,51,45,6,ECO_300019380
642,Herenthoutsesteenweg 2,2022-01-13,16:00:00,86,72,14,ECO_300019380
642,Herenthoutsesteenweg 2,2022-01-13,17:00:00,65,51,14,ECO_300019380
642,Herenthoutsesteenweg 2,2022-01-13,18:00:00,38,36,2,ECO_300019380
642,Herenthoutsesteenweg 2,2022-01-13,19:00:00,22,19,3,ECO_300019380
642,Herenthoutsesteenweg 2,2022-01-13,20:00:00,19,18,1,ECO_300019380
642,Herenthoutsesteenweg 2,2022-01-13,21:00:00,9,6,3,ECO_300019380
642,Herenthoutsesteenweg 2,2022-01-13,22:00:00,5,5,0,ECO_300019380
642,Herenthoutsesteenweg 2,2022-01-13,23:00:00,7,7,0,ECO_300019380
642,Herenthoutsesteenweg 2,2022-01-14,00:00:00,1,1,0,ECO_300019380
642,Herenthoutsesteenweg 2,2022-01-14,01:00:00,2,2,0,ECO_300019380
642,Herenthoutsesteenweg 2,2022-01-14,02:00:00,0,0,0,ECO_300019380
642,Herenthoutsesteenweg 2,2022-01-14,03:00:00,0,0,0,ECO_300019380
642,Herenthoutsesteenweg 2,2022-01-14,04:00:00,1,1,0,ECO_300019380
642,Herenthoutsesteenweg 2,2022-01-14,05:00:00,2,2,0,ECO_300019380
642,Herenthoutsesteenweg 2,2022-01-14,06:00:00,10,10,0,ECO_300019380
642,Herenthoutsesteenweg 2,2022-01-14,07:00:00,25,22,3,ECO_300019380
642,Herenthoutsesteenweg 2,2022-01-14,08:00:00,96,92,4,ECO_300019380
642,Herenthoutsesteenweg 2,2022-01-14,09:00:00,476,469,7,ECO_300019380
642,Herenthoutsesteenweg 2,2022-01-14,10:00:00,75,74,1,ECO_300019380
642,Herenthoutsesteenweg 2,2022-01-14,11:00:00,52,49,3,ECO_300019380
642,Herenthoutsesteenweg 2,2022-01-14,12:00:00,35,31,4,ECO_300019380
642,Herenthoutsesteenweg 2,2022-01-14,13:00:00,46,38,8,ECO_300019380
642,Herenthoutsesteenweg 2,2022-01-14,14:00:00,44,41,3,ECO_300019380
642,Herenthoutsesteenweg 2,2022-01-14,15:00:00,73,62,11,ECO_300019380
642,Herenthoutsesteenweg 2,2022-01-14,16:00:00,84,79,5,ECO_300019380
642,Herenthoutsesteenweg 2,2022-01-14,17:00:00,82,68,14,ECO_300019380
642,Herenthoutsesteenweg 2,2022-01-14,18:00:00,40,37,3,ECO_300019380
642,Herenthoutsesteenweg 2,2022-01-14,19:00:00,34,30,4,ECO_300019380
642,Herenthoutsesteenweg 2,2022-01-14,20:00:00,35,29,6,ECO_300019380
642,Herenthoutsesteenweg 2,2022-01-14,21:00:00,16,14,2,ECO_300019380
642,Herenthoutsesteenweg 2,2022-01-14,22:00:00,13,11,2,ECO_300019380
642,Herenthoutsesteenweg 2,2022-01-14,23:00:00,10,9,1,ECO_300019380
642,Herenthoutsesteenweg 2,2022-01-15,00:00:00,8,5,3,ECO_300019380
642,Herenthoutsesteenweg 2,2022-01-15,01:00:00,4,4,0,ECO_300019380
642,Herenthoutsesteenweg 2,2022-01-15,02:00:00,2,2,0,ECO_300019380
642,Herenthoutsesteenweg 2,2022-01-15,03:00:00,1,0,1,ECO_300019380
642,Herenthoutsesteenweg 2,2022-01-15,04:00:00,2,2,0,ECO_300019380
642,Herenthoutsesteenweg 2,2022-01-15,05:00:00,0,0,0,ECO_300019380
642,Herenthoutsesteenweg 2,2022-01-15,06:00:00,6,5,1,ECO_300019380
642,Herenthoutsesteenweg 2,2022-01-15,07:00:00,2,2,0,ECO_300019380
642,Herenthoutsesteenweg 2,2022-01-15,08:00:00,6,5,1,ECO_300019380
642,Herenthoutsesteenweg 2,2022-01-15,09:00:00,33,30,3,ECO_300019380
642,Herenthoutsesteenweg 2,2022-01-15,10:00:00,51,46,5,ECO_300019380
642,Herenthoutsesteenweg 2,2022-01-15,11:00:00,63,53,10,ECO_300019380
642,Herenthoutsesteenweg 2,2022-01-15,12:00:00,63,52,11,ECO_300019380
642,Herenthoutsesteenweg 2,2022-01-15,13:00:00,58,46,12,ECO_300019380
642,Herenthoutsesteenweg 2,2022-01-15,14:00:00,100,85,15,ECO_300019380
642,Herenthoutsesteenweg 2,2022-01-15,15:00:00,116,102,14,ECO_300019380
642,Herenthoutsesteenweg 2,2022-01-15,16:00:00,75,65,10,ECO_300019380
642,Herenthoutsesteenweg 2,2022-01-15,17:00:00,59,46,13,ECO_300019380
642,Herenthoutsesteenweg 2,2022-01-15,18:00:00,27,24,3,ECO_300019380
642,Herenthoutsesteenweg 2,2022-01-15,19:00:00,13,13,0,ECO_300019380
642,Herenthoutsesteenweg 2,2022-01-15,20:00:00,15,14,1,ECO_300019380
642,Herenthoutsesteenweg 2,2022-01-15,21:00:00,15,11,4,ECO_300019380
642,Herenthoutsesteenweg 2,2022-01-15,22:00:00,8,7,1,ECO_300019380
642,Herenthoutsesteenweg 2,2022-01-15,23:00:00,4,2,2,ECO_300019380
642,Herenthoutsesteenweg 2,2022-01-16,00:00:00,9,8,1,ECO_300019380
642,Herenthoutsesteenweg 2,2022-01-16,01:00:00,2,2,0,ECO_300019380
642,Herenthoutsesteenweg 2,2022-01-16,02:00:00,2,1,1,ECO_300019380
642,Herenthoutsesteenweg 2,2022-01-16,03:00:00,0,0,0,ECO_300019380
642,Herenthoutsesteenweg 2,2022-01-16,04:00:00,0,0,0,ECO_300019380
642,Herenthoutsesteenweg 2,2022-01-16,05:00:00,0,0,0,ECO_300019380
642,Herenthoutsesteenweg 2,2022-01-16,06:00:00,0,0,0,ECO_300019380
642,Herenthoutsesteenweg 2,2022-01-16,07:00:00,3,3,0,ECO_300019380
642,Herenthoutsesteenweg 2,2022-01-16,08:00:00,10,10,0,ECO_300019380
642,Herenthoutsesteenweg 2,2022-01-16,09:00:00,29,27,2,ECO_300019380
642,Herenthoutsesteenweg 2,2022-01-16,10:00:00,48,47,1,ECO_300019380
642,Herenthoutsesteenweg 2,2022-01-16,11:00:00,71,62,9,ECO_300019380
642,Herenthoutsesteenweg 2,2022-01-16,12:00:00,59,49,10,ECO_300019380
642,Herenthoutsesteenweg 2,2022-01-16,13:00:00,48,41,7,ECO_300019380
642,Herenthoutsesteenweg 2,2022-01-16,14:00:00,17,14,3,ECO_300019380
642,Herenthoutsesteenweg 2,2022-01-16,15:00:00,35,31,4,ECO_300019380
642,Herenthoutsesteenweg 2,2022-01-16,16:00:00,25,24,1,ECO_300019380
642,Herenthoutsesteenweg 2,2022-01-16,17:00:00,16,12,4,ECO_300019380
642,Herenthoutsesteenweg 2,2022-01-16,18:00:00,22,22,0,ECO_300019380
642,Herenthoutsesteenweg 2,2022-01-16,19:00:00,7,7,0,ECO_300019380
642,Herenthoutsesteenweg 2,2022-01-16,20:00:00,8,7,1,ECO_300019380
642,Herenthoutsesteenweg 2,2022-01-16,21:00:00,5,3,2,ECO_300019380
642,Herenthoutsesteenweg 2,2022-01-16,22:00:00,6,6,0,ECO_300019380
642,Herenthoutsesteenweg 2,2022-01-16,23:00:00,3,2,1,ECO_300019380
642,Herenthoutsesteenweg 2,2022-01-17,00:00:00,4,2,2,ECO_300019380
642,Herenthoutsesteenweg 2,2022-01-17,01:00:00,2,2,0,ECO_300019380
642,Herenthoutsesteenweg 2,2022-01-17,02:00:00,0,0,0,ECO_300019380
642,Herenthoutsesteenweg 2,2022-01-17,03:00:00,0,0,0,ECO_300019380
642,Herenthoutsesteenweg 2,2022-01-17,04:00:00,0,0,0,ECO_300019380
642,Herenthoutsesteenweg 2,2022-01-17,05:00:00,3,3,0,ECO_300019380
642,Herenthoutsesteenweg 2,2022-01-17,06:00:00,17,14,3,ECO_300019380
642,Herenthoutsesteenweg 2,2022-01-17,07:00:00,35,31,4,ECO_300019380
642,Herenthoutsesteenweg 2,2022-01-17,08:00:00,118,113,5,ECO_300019380
642,Herenthoutsesteenweg 2,2022-01-17,09:00:00,446,437,9,ECO_300019380
642,Herenthoutsesteenweg 2,2022-01-17,10:00:00,85,84,1,ECO_300019380
642,Herenthoutsesteenweg 2,2022-01-17,11:00:00,41,37,4,ECO_300019380
642,Herenthoutsesteenweg 2,2022-01-17,12:00:00,42,38,4,ECO_300019380
642,Herenthoutsesteenweg 2,2022-01-17,13:00:00,37,35,2,ECO_300019380
642,Herenthoutsesteenweg 2,2022-01-17,14:00:00,72,66,6,ECO_300019380
642,Herenthoutsesteenweg 2,2022-01-17,15:00:00,72,66,6,ECO_300019380
642,Herenthoutsesteenweg 2,2022-01-17,16:00:00,86,72,14,ECO_300019380
642,Herenthoutsesteenweg 2,2022-01-17,17:00:00,80,66,14,ECO_300019380
642,Herenthoutsesteenweg 2,2022-01-17,18:00:00,55,47,8,ECO_300019380
642,Herenthoutsesteenweg 2,2022-01-17,19:00:00,20,19,1,ECO_300019380
642,Herenthoutsesteenweg 2,2022-01-17,20:00:00,14,13,1,ECO_300019380
642,Herenthoutsesteenweg 2,2022-01-17,21:00:00,10,9,1,ECO_300019380
642,Herenthoutsesteenweg 2,2022-01-17,22:00:00,7,5,2,ECO_300019380
642,Herenthoutsesteenweg 2,2022-01-17,23:00:00,11,10,1,ECO_300019380
642,Herenthoutsesteenweg 2,2022-01-18,00:00:00,2,1,1,ECO_300019380
642,Herenthoutsesteenweg 2,2022-01-18,01:00:00,1,1,0,ECO_300019380
642,Herenthoutsesteenweg 2,2022-01-18,02:00:00,0,0,0,ECO_300019380
642,Herenthoutsesteenweg 2,2022-01-18,03:00:00,1,1,0,ECO_300019380
642,Herenthoutsesteenweg 2,2022-01-18,04:00:00,0,0,0,ECO_300019380
642,Herenthoutsesteenweg 2,2022-01-18,05:00:00,8,8,0,ECO_300019380
642,Herenthoutsesteenweg 2,2022-01-18,06:00:00,15,14,1,ECO_300019380
642,Herenthoutsesteenweg 2,2022-01-18,07:00:00,44,43,1,ECO_300019380
642,Herenthoutsesteenweg 2,2022-01-18,08:00:00,126,121,5,ECO_300019380
642,Herenthoutsesteenweg 2,2022-01-18,09:00:00,445,435,10,ECO_300019380
642,Herenthoutsesteenweg 2,2022-01-18,10:00:00,89,82,7,ECO_300019380
642,Herenthoutsesteenweg 2,2022-01-18,11:00:00,43,39,4,ECO_300019380
642,Herenthoutsesteenweg 2,2022-01-18,12:00:00,50,44,6,ECO_300019380
642,Herenthoutsesteenweg 2,2022-01-18,13:00:00,61,55,6,ECO_300019380
642,Herenthoutsesteenweg 2,2022-01-18,14:00:00,108,99,9,ECO_300019380
642,Herenthoutsesteenweg 2,2022-01-18,15:00:00,98,92,6,ECO_300019380
642,Herenthoutsesteenweg 2,2022-01-18,16:00:00,101,83,18,ECO_300019380
642,Herenthoutsesteenweg 2,2022-01-18,17:00:00,103,96,7,ECO_300019380
642,Herenthoutsesteenweg 2,2022-01-18,18:00:00,65,59,6,ECO_300019380
642,Herenthoutsesteenweg 2,2022-01-18,19:00:00,33,30,3,ECO_300019380
642,Herenthoutsesteenweg 2,2022-01-18,20:00:00,19,16,3,ECO_300019380
642,Herenthoutsesteenweg 2,2022-01-18,21:00:00,15,13,2,ECO_300019380
642,Herenthoutsesteenweg 2,2022-01-18,22:00:00,4,2,2,ECO_300019380
642,Herenthoutsesteenweg 2,2022-01-18,23:00:00,11,10,1,ECO_300019380
642,Herenthoutsesteenweg 2,2022-01-19,00:00:00,1,1,0,ECO_300019380
642,Herenthoutsesteenweg 2,2022-01-19,01:00:00,0,0,0,ECO_300019380
642,Herenthoutsesteenweg 2,2022-01-19,02:00:00,3,3,0,ECO_300019380
642,Herenthoutsesteenweg 2,2022-01-19,03:00:00,0,0,0,ECO_300019380
642,Herenthoutsesteenweg 2,2022-01-19,04:00:00,0,0,0,ECO_300019380
642,Herenthoutsesteenweg 2,2022-01-19,05:00:00,3,3,0,ECO_300019380
642,Herenthoutsesteenweg 2,2022-01-19,06:00:00,17,16,1,ECO_300019380
642,Herenthoutsesteenweg 2,2022-01-19,07:00:00,30,28,2,ECO_300019380
642,Herenthoutsesteenweg 2,2022-01-19,08:00:00,121,119,2,ECO_300019380
642,Herenthoutsesteenweg 2,2022-01-19,09:00:00,386,382,4,ECO_300019380
642,Herenthoutsesteenweg 2,2022-01-19,10:00:00,73,68,5,ECO_300019380
642,Herenthoutsesteenweg 2,2022-01-19,11:00:00,36,34,2,ECO_300019380
642,Herenthoutsesteenweg 2,2022-01-19,12:00:00,35,29,6,ECO_300019380
642,Herenthoutsesteenweg 2,2022-01-19,13:00:00,67,63,4,ECO_300019380
642,Herenthoutsesteenweg 2,2022-01-19,14:00:00,50,45,5,ECO_300019380
642,Herenthoutsesteenweg 2,2022-01-19,15:00:00,72,65,7,ECO_300019380
642,Herenthoutsesteenweg 2,2022-01-19,16:00:00,58,54,4,ECO_300019380
642,Herenthoutsesteenweg 2,2022-01-19,17:00:00,64,55,9,ECO_300019380
642,Herenthoutsesteenweg 2,2022-01-19,18:00:00,31,27,4,ECO_300019380
642,Herenthoutsesteenweg 2,2022-01-19,19:00:00,21,19,2,ECO_300019380
642,Herenthoutsesteenweg 2,2022-01-19,20:00:00,14,13,1,ECO_300019380
642,Herenthoutsesteenweg 2,2022-01-19,21:00:00,12,10,2,ECO_300019380
642,Herenthoutsesteenweg 2,2022-01-19,22:00:00,11,9,2,ECO_300019380
642,Herenthoutsesteenweg 2,2022-01-19,23:00:00,12,11,1,ECO_300019380
642,Herenthoutsesteenweg 2,2022-01-20,00:00:00,0,0,0,ECO_300019380
642,Herenthoutsesteenweg 2,2022-01-20,01:00:00,0,0,0,ECO_300019380
642,Herenthoutsesteenweg 2,2022-01-20,02:00:00,0,0,0,ECO_300019380
642,Herenthoutsesteenweg 2,2022-01-20,03:00:00,0,0,0,ECO_300019380
642,Herenthoutsesteenweg 2,2022-01-20,04:00:00,0,0,0,ECO_300019380
642,Herenthoutsesteenweg 2,2022-01-20,05:00:00,3,3,0,ECO_300019380
642,Herenthoutsesteenweg 2,2022-01-20,06:00:00,16,14,2,ECO_300019380
642,Herenthoutsesteenweg 2,2022-01-20,07:00:00,40,37,3,ECO_300019380
642,Herenthoutsesteenweg 2,2022-01-20,08:00:00,88,86,2,ECO_300019380
642,Herenthoutsesteenweg 2,2022-01-20,09:00:00,356,350,6,ECO_300019380
642,Herenthoutsesteenweg 2,2022-01-20,10:00:00,63,60,3,ECO_300019380
642,Herenthoutsesteenweg 2,2022-01-20,11:00:00,47,43,4,ECO_300019380
642,Herenthoutsesteenweg 2,2022-01-20,12:00:00,40,34,6,ECO_300019380
642,Herenthoutsesteenweg 2,2022-01-20,13:00:00,37,32,5,ECO_300019380
642,Herenthoutsesteenweg 2,2022-01-20,14:00:00,48,47,1,ECO_300019380
642,Herenthoutsesteenweg 2,2022-01-20,15:00:00,83,79,4,ECO_300019380
642,Herenthoutsesteenweg 2,2022-01-20,16:00:00,74,65,9,ECO_300019380
642,Herenthoutsesteenweg 2,2022-01-20,17:00:00,62,58,4,ECO_300019380
642,Herenthoutsesteenweg 2,2022-01-20,18:00:00,51,44,7,ECO_300019380
642,Herenthoutsesteenweg 2,2022-01-20,19:00:00,21,19,2,ECO_300019380
642,Herenthoutsesteenweg 2,2022-01-20,20:00:00,18,15,3,ECO_300019380
642,Herenthoutsesteenweg 2,2022-01-20,21:00:00,12,11,1,ECO_300019380
642,Herenthoutsesteenweg 2,2022-01-20,22:00:00,8,8,0,ECO_300019380
642,Herenthoutsesteenweg 2,2022-01-20,23:00:00,8,8,0,ECO_300019380
642,Herenthoutsesteenweg 2,2022-01-21,00:00:00,4,2,2,ECO_300019380
642,Herenthoutsesteenweg 2,2022-01-21,01:00:00,0,0,0,ECO_300019380
642,Herenthoutsesteenweg 2,2022-01-21,02:00:00,2,1,1,ECO_300019380
642,Herenthoutsesteenweg 2,2022-01-21,03:00:00,3,2,1,ECO_300019380
642,Herenthoutsesteenweg 2,2022-01-21,04:00:00,1,1,0,ECO_300019380
642,Herenthoutsesteenweg 2,2022-01-21,05:00:00,3,3,0,ECO_300019380
642,Herenthoutsesteenweg 2,2022-01-21,06:00:00,20,20,0,ECO_300019380
642,Herenthoutsesteenweg 2,2022-01-21,07:00:00,28,25,3,ECO_300019380
642,Herenthoutsesteenweg 2,2022-01-21,08:00:00,99,97,2,ECO_300019380
642,Herenthoutsesteenweg 2,2022-01-21,09:00:00,359,357,2,ECO_300019380
642,Herenthoutsesteenweg 2,2022-01-21,10:00:00,63,62,1,ECO_300019380
642,Herenthoutsesteenweg 2,2022-01-21,11:00:00,48,45,3,ECO_300019380
642,Herenthoutsesteenweg 2,2022-01-21,12:00:00,51,47,4,ECO_300019380
642,Herenthoutsesteenweg 2,2022-01-21,13:00:00,45,41,4,ECO_300019380
642,Herenthoutsesteenweg 2,2022-01-21,14:00:00,57,52,5,ECO_300019380
642,Herenthoutsesteenweg 2,2022-01-21,15:00:00,58,57,1,ECO_300019380
642,Herenthoutsesteenweg 2,2022-01-21,16:00:00,95,88,7,ECO_300019380
642,Herenthoutsesteenweg 2,2022-01-21,17:00:00,64,57,7,ECO_300019380
642,Herenthoutsesteenweg 2,2022-01-21,18:00:00,39,35,4,ECO_300019380
642,Herenthoutsesteenweg 2,2022-01-21,19:00:00,25,25,0,ECO_300019380
642,Herenthoutsesteenweg 2,2022-01-21,20:00:00,25,23,2,ECO_300019380
642,Herenthoutsesteenweg 2,2022-01-21,21:00:00,23,23,0,ECO_300019380
642,Herenthoutsesteenweg 2,2022-01-21,22:00:00,9,9,0,ECO_300019380
642,Herenthoutsesteenweg 2,2022-01-21,23:00:00,11,8,3,ECO_300019380
642,Herenthoutsesteenweg 2,2022-01-22,00:00:00,5,4,1,ECO_300019380
642,Herenthoutsesteenweg 2,2022-01-22,01:00:00,1,0,1,ECO_300019380
642,Herenthoutsesteenweg 2,2022-01-22,02:00:00,2,2,0,ECO_300019380
642,Herenthoutsesteenweg 2,2022-01-22,03:00:00,4,3,1,ECO_300019380
642,Herenthoutsesteenweg 2,2022-01-22,04:00:00,0,0,0,ECO_300019380
642,Herenthoutsesteenweg 2,2022-01-22,05:00:00,0,0,0,ECO_300019380
642,Herenthoutsesteenweg 2,2022-01-22,06:00:00,4,4,0,ECO_300019380
642,Herenthoutsesteenweg 2,2022-01-22,07:00:00,5,5,0,ECO_300019380
642,Herenthoutsesteenweg 2,2022-01-22,08:00:00,9,9,0,ECO_300019380
642,Herenthoutsesteenweg 2,2022-01-22,09:00:00,29,26,3,ECO_300019380
642,Herenthoutsesteenweg 2,2022-01-22,10:00:00,48,46,2,ECO_300019380
642,Herenthoutsesteenweg 2,2022-01-22,11:00:00,49,41,8,ECO_300019380
642,Herenthoutsesteenweg 2,2022-01-22,12:00:00,70,62,8,ECO_300019380
642,Herenthoutsesteenweg 2,2022-01-22,13:00:00,74,60,14,ECO_300019380
642,Herenthoutsesteenweg 2,2022-01-22,14:00:00,68,58,10,ECO_300019380
642,Herenthoutsesteenweg 2,2022-01-22,15:00:00,71,62,9,ECO_300019380
642,Herenthoutsesteenweg 2,2022-01-22,16:00:00,47,44,3,ECO_300019380
642,Herenthoutsesteenweg 2,2022-01-22,17:00:00,40,35,5,ECO_300019380
642,Herenthoutsesteenweg 2,2022-01-22,18:00:00,15,13,2,ECO_300019380
642,Herenthoutsesteenweg 2,2022-01-22,19:00:00,17,17,0,ECO_300019380
642,Herenthoutsesteenweg 2,2022-01-22,20:00:00,24,20,4,ECO_300019380
642,Herenthoutsesteenweg 2,2022-01-22,21:00:00,11,9,2,ECO_300019380
642,Herenthoutsesteenweg 2,2022-01-22,22:00:00,13,10,3,ECO_300019380
642,Herenthoutsesteenweg 2,2022-01-22,23:00:00,4,3,1,ECO_300019380
642,Herenthoutsesteenweg 2,2022-01-23,00:00:00,10,4,6,ECO_300019380
642,Herenthoutsesteenweg 2,2022-01-23,01:00:00,2,1,1,ECO_300019380
642,Herenthoutsesteenweg 2,2022-01-23,02:00:00,8,8,0,ECO_300019380
642,Herenthoutsesteenweg 2,2022-01-23,03:00:00,9,8,1,ECO_300019380
642,Herenthoutsesteenweg 2,2022-01-23,04:00:00,0,0,0,ECO_300019380
642,Herenthoutsesteenweg 2,2022-01-23,05:00:00,0,0,0,ECO_300019380
642,Herenthoutsesteenweg 2,2022-01-23,06:00:00,2,2,0,ECO_300019380
642,Herenthoutsesteenweg 2,2022-01-23,07:00:00,4,4,0,ECO_300019380
642,Herenthoutsesteenweg 2,2022-01-23,08:00:00,7,7,0,ECO_300019380
642,Herenthoutsesteenweg 2,2022-01-23,09:00:00,38,35,3,ECO_300019380
642,Herenthoutsesteenweg 2,2022-01-23,10:00:00,63,56,7,ECO_300019380
642,Herenthoutsesteenweg 2,2022-01-23,11:00:00,74,67,7,ECO_300019380
642,Herenthoutsesteenweg 2,2022-01-23,12:00:00,70,55,15,ECO_300019380
642,Herenthoutsesteenweg 2,2022-01-23,13:00:00,36,28,8,ECO_300019380
642,Herenthoutsesteenweg 2,2022-01-23,14:00:00,44,37,7,ECO_300019380
642,Herenthoutsesteenweg 2,2022-01-23,15:00:00,44,39,5,ECO_300019380
642,Herenthoutsesteenweg 2,2022-01-23,16:00:00,35,32,3,ECO_300019380
642,Herenthoutsesteenweg 2,2022-01-23,17:00:00,30,28,2,ECO_300019380
642,Herenthoutsesteenweg 2,2022-01-23,18:00:00,20,18,2,ECO_300019380
642,Herenthoutsesteenweg 2,2022-01-23,19:00:00,12,10,2,ECO_300019380
642,Herenthoutsesteenweg 2,2022-01-23,20:00:00,10,10,0,ECO_300019380
642,Herenthoutsesteenweg 2,2022-01-23,21:00:00,9,8,1,ECO_300019380
642,Herenthoutsesteenweg 2,2022-01-23,22:00:00,7,4,3,ECO_300019380
642,Herenthoutsesteenweg 2,2022-01-23,23:00:00,1,1,0,ECO_300019380
642,Herenthoutsesteenweg 2,2022-01-24,00:00:00,2,2,0,ECO_300019380
642,Herenthoutsesteenweg 2,2022-01-24,01:00:00,2,1,1,ECO_300019380
642,Herenthoutsesteenweg 2,2022-01-24,02:00:00,0,0,0,ECO_300019380
642,Herenthoutsesteenweg 2,2022-01-24,03:00:00,1,1,0,ECO_300019380
642,Herenthoutsesteenweg 2,2022-01-24,04:00:00,1,1,0,ECO_300019380
642,Herenthoutsesteenweg 2,2022-01-24,05:00:00,5,5,0,ECO_300019380
642,Herenthoutsesteenweg 2,2022-01-24,06:00:00,15,14,1,ECO_300019380
642,Herenthoutsesteenweg 2,2022-01-24,07:00:00,34,32,2,ECO_300019380
642,Herenthoutsesteenweg 2,2022-01-24,08:00:00,113,110,3,ECO_300019380
642,Herenthoutsesteenweg 2,2022-01-24,09:00:00,341,335,6,ECO_300019380
642,Herenthoutsesteenweg 2,2022-01-24,10:00:00,81,80,1,ECO_300019380
642,Herenthoutsesteenweg 2,2022-01-24,11:00:00,51,47,4,ECO_300019380
642,Herenthoutsesteenweg 2,2022-01-24,12:00:00,47,39,8,ECO_300019380
642,Herenthoutsesteenweg 2,2022-01-24,13:00:00,70,65,5,ECO_300019380
642,Herenthoutsesteenweg 2,2022-01-24,14:00:00,117,106,11,ECO_300019380
642,Herenthoutsesteenweg 2,2022-01-24,15:00:00,97,81,16,ECO_300019380
642,Herenthoutsesteenweg 2,2022-01-24,16:00:00,106,97,9,ECO_300019380
642,Herenthoutsesteenweg 2,2022-01-24,17:00:00,88,79,9,ECO_300019380
642,Herenthoutsesteenweg 2,2022-01-24,18:00:00,43,40,3,ECO_300019380
642,Herenthoutsesteenweg 2,2022-01-24,19:00:00,28,25,3,ECO_300019380
642,Herenthoutsesteenweg 2,2022-01-24,20:00:00,17,14,3,ECO_300019380
642,Herenthoutsesteenweg 2,2022-01-24,21:00:00,7,7,0,ECO_300019380
642,Herenthoutsesteenweg 2,2022-01-24,22:00:00,6,6,0,ECO_300019380
642,Herenthoutsesteenweg 2,2022-01-24,23:00:00,14,12,2,ECO_300019380
642,Herenthoutsesteenweg 2,2022-01-25,00:00:00,1,0,1,ECO_300019380
642,Herenthoutsesteenweg 2,2022-01-25,01:00:00,2,2,0,ECO_300019380
642,Herenthoutsesteenweg 2,2022-01-25,02:00:00,3,3,0,ECO_300019380
642,Herenthoutsesteenweg 2,2022-01-25,03:00:00,0,0,0,ECO_300019380
642,Herenthoutsesteenweg 2,2022-01-25,04:00:00,0,0,0,ECO_300019380
642,Herenthoutsesteenweg 2,2022-01-25,05:00:00,2,1,1,ECO_300019380
642,Herenthoutsesteenweg 2,2022-01-25,06:00:00,15,13,2,ECO_300019380
642,Herenthoutsesteenweg 2,2022-01-25,07:00:00,42,40,2,ECO_300019380
642,Herenthoutsesteenweg 2,2022-01-25,08:00:00,97,97,0,ECO_300019380
642,Herenthoutsesteenweg 2,2022-01-25,09:00:00,320,320,0,ECO_300019380
642,Herenthoutsesteenweg 2,2022-01-25,10:00:00,74,74,0,ECO_300019380
642,Herenthoutsesteenweg 2,2022-01-25,11:00:00,64,55,9,ECO_300019380
642,Herenthoutsesteenweg 2,2022-01-25,12:00:00,38,31,7,ECO_300019380
642,Herenthoutsesteenweg 2,2022-01-25,13:00:00,61,56,5,ECO_300019380
642,Herenthoutsesteenweg 2,2022-01-25,14:00:00,59,55,4,ECO_300019380
642,Herenthoutsesteenweg 2,2022-01-25,15:00:00,51,48,3,ECO_300019380
642,Herenthoutsesteenweg 2,2022-01-25,16:00:00,108,93,15,ECO_300019380
642,Herenthoutsesteenweg 2,2022-01-25,17:00:00,94,90,4,ECO_300019380
642,Herenthoutsesteenweg 2,2022-01-25,18:00:00,55,53,2,ECO_300019380
642,Herenthoutsesteenweg 2,2022-01-25,19:00:00,17,17,0,ECO_300019380
642,Herenthoutsesteenweg 2,2022-01-25,20:00:00,15,15,0,ECO_300019380
642,Herenthoutsesteenweg 2,2022-01-25,21:00:00,11,11,0,ECO_300019380
642,Herenthoutsesteenweg 2,2022-01-25,22:00:00,9,8,1,ECO_300019380
642,Herenthoutsesteenweg 2,2022-01-25,23:00:00,14,13,1,ECO_300019380
642,Herenthoutsesteenweg 2,2022-01-26,00:00:00,2,2,0,ECO_300019380
642,Herenthoutsesteenweg 2,2022-01-26,01:00:00,2,1,1,ECO_300019380
642,Herenthoutsesteenweg 2,2022-01-26,02:00:00,0,0,0,ECO_300019380
642,Herenthoutsesteenweg 2,2022-01-26,03:00:00,0,0,0,ECO_300019380
642,Herenthoutsesteenweg 2,2022-01-26,04:00:00,0,0,0,ECO_300019380
642,Herenthoutsesteenweg 2,2022-01-26,05:00:00,2,2,0,ECO_300019380
642,Herenthoutsesteenweg 2,2022-01-26,06:00:00,17,16,1,ECO_300019380
642,Herenthoutsesteenweg 2,2022-01-26,07:00:00,36,35,1,ECO_300019380
642,Herenthoutsesteenweg 2,2022-01-26,08:00:00,98,95,3,ECO_300019380
642,Herenthoutsesteenweg 2,2022-01-26,09:00:00,285,282,3,ECO_300019380
642,Herenthoutsesteenweg 2,2022-01-26,10:00:00,72,70,2,ECO_300019380
642,Herenthoutsesteenweg 2,2022-01-26,11:00:00,44,44,0,ECO_300019380
642,Herenthoutsesteenweg 2,2022-01-26,12:00:00,37,32,5,ECO_300019380
642,Herenthoutsesteenweg 2,2022-01-26,13:00:00,102,98,4,ECO_300019380
642,Herenthoutsesteenweg 2,2022-01-26,14:00:00,87,83,4,ECO_300019380
642,Herenthoutsesteenweg 2,2022-01-26,15:00:00,57,54,3,ECO_300019380
642,Herenthoutsesteenweg 2,2022-01-26,16:00:00,67,59,8,ECO_300019380
642,Herenthoutsesteenweg 2,2022-01-26,17:00:00,72,67,5,ECO_300019380
642,Herenthoutsesteenweg 2,2022-01-26,18:00:00,50,42,8,ECO_300019380
642,Herenthoutsesteenweg 2,2022-01-26,19:00:00,28,24,4,ECO_300019380
642,Herenthoutsesteenweg 2,2022-01-26,20:00:00,13,11,2,ECO_300019380
642,Herenthoutsesteenweg 2,2022-01-26,21:00:00,16,15,1,ECO_300019380
642,Herenthoutsesteenweg 2,2022-01-26,22:00:00,7,7,0,ECO_300019380
642,Herenthoutsesteenweg 2,2022-01-26,23:00:00,13,10,3,ECO_300019380
642,Herenthoutsesteenweg 2,2022-01-27,00:00:00,7,7,0,ECO_300019380
642,Herenthoutsesteenweg 2,2022-01-27,01:00:00,0,0,0,ECO_300019380
642,Herenthoutsesteenweg 2,2022-01-27,02:00:00,0,0,0,ECO_300019380
642,Herenthoutsesteenweg 2,2022-01-27,03:00:00,1,0,1,ECO_300019380
642,Herenthoutsesteenweg 2,2022-01-27,04:00:00,0,0,0,ECO_300019380
642,Herenthoutsesteenweg 2,2022-01-27,05:00:00,1,1,0,ECO_300019380
642,Herenthoutsesteenweg 2,2022-01-27,06:00:00,15,14,1,ECO_300019380
642,Herenthoutsesteenweg 2,2022-01-27,07:00:00,22,22,0,ECO_300019380
642,Herenthoutsesteenweg 2,2022-01-27,08:00:00,103,100,3,ECO_300019380
642,Herenthoutsesteenweg 2,2022-01-27,09:00:00,311,305,6,ECO_300019380
642,Herenthoutsesteenweg 2,2022-01-27,10:00:00,63,63,0,ECO_300019380
642,Herenthoutsesteenweg 2,2022-01-27,11:00:00,29,27,2,ECO_300019380
642,Herenthoutsesteenweg 2,2022-01-27,12:00:00,21,19,2,ECO_300019380
642,Herenthoutsesteenweg 2,2022-01-27,13:00:00,22,20,2,ECO_300019380
642,Herenthoutsesteenweg 2,2022-01-27,14:00:00,39,37,2,ECO_300019380
642,Herenthoutsesteenweg 2,2022-01-27,15:00:00,28,27,1,ECO_300019380
642,Herenthoutsesteenweg 2,2022-01-27,16:00:00,66,62,4,ECO_300019380
642,Herenthoutsesteenweg 2,2022-01-27,17:00:00,57,49,8,ECO_300019380
642,Herenthoutsesteenweg 2,2022-01-27,18:00:00,31,27,4,ECO_300019380
642,Herenthoutsesteenweg 2,2022-01-27,19:00:00,24,21,3,ECO_300019380
642,Herenthoutsesteenweg 2,2022-01-27,20:00:00,13,10,3,ECO_300019380
642,Herenthoutsesteenweg 2,2022-01-27,21:00:00,13,9,4,ECO_300019380
642,Herenthoutsesteenweg 2,2022-01-27,22:00:00,7,5,2,ECO_300019380
642,Herenthoutsesteenweg 2,2022-01-27,23:00:00,9,9,0,ECO_300019380
642,Herenthoutsesteenweg 2,2022-01-28,00:00:00,0,0,0,ECO_300019380
642,Herenthoutsesteenweg 2,2022-01-28,01:00:00,2,1,1,ECO_300019380
642,Herenthoutsesteenweg 2,2022-01-28,02:00:00,2,2,0,ECO_300019380
642,Herenthoutsesteenweg 2,2022-01-28,03:00:00,0,0,0,ECO_300019380
642,Herenthoutsesteenweg 2,2022-01-28,04:00:00,0,0,0,ECO_300019380
642,Herenthoutsesteenweg 2,2022-01-28,05:00:00,1,1,0,ECO_300019380
642,Herenthoutsesteenweg 2,2022-01-28,06:00:00,14,11,3,ECO_300019380
642,Herenthoutsesteenweg 2,2022-01-28,07:00:00,23,21,2,ECO_300019380
642,Herenthoutsesteenweg 2,2022-01-28,08:00:00,77,76,1,ECO_300019380
642,Herenthoutsesteenweg 2,2022-01-28,09:00:00,350,348,2,ECO_300019380
642,Herenthoutsesteenweg 2,2022-01-28,10:00:00,71,70,1,ECO_300019380
642,Herenthoutsesteenweg 2,2022-01-28,11:00:00,64,62,2,ECO_300019380
642,Herenthoutsesteenweg 2,2022-01-28,12:00:00,67,64,3,ECO_300019380
642,Herenthoutsesteenweg 2,2022-01-28,13:00:00,60,48,12,ECO_300019380
642,Herenthoutsesteenweg 2,2022-01-28,14:00:00,96,88,8,ECO_300019380
642,Herenthoutsesteenweg 2,2022-01-28,15:00:00,126,113,13,ECO_300019380
642,Herenthoutsesteenweg 2,2022-01-28,16:00:00,128,118,10,ECO_300019380
642,Herenthoutsesteenweg 2,2022-01-28,17:00:00,80,72,8,ECO_300019380
642,Herenthoutsesteenweg 2,2022-01-28,18:00:00,48,38,10,ECO_300019380
642,Herenthoutsesteenweg 2,2022-01-28,19:00:00,29,25,4,ECO_300019380
642,Herenthoutsesteenweg 2,2022-01-28,20:00:00,24,23,1,ECO_300019380
642,Herenthoutsesteenweg 2,2022-01-28,21:00:00,22,19,3,ECO_300019380
642,Herenthoutsesteenweg 2,2022-01-28,22:00:00,10,10,0,ECO_300019380
642,Herenthoutsesteenweg 2,2022-01-28,23:00:00,19,19,0,ECO_300019380
642,Herenthoutsesteenweg 2,2022-01-29,00:00:00,3,2,1,ECO_300019380
642,Herenthoutsesteenweg 2,2022-01-29,01:00:00,9,5,4,ECO_300019380
642,Herenthoutsesteenweg 2,2022-01-29,02:00:00,3,2,1,ECO_300019380
642,Herenthoutsesteenweg 2,2022-01-29,03:00:00,3,3,0,ECO_300019380
642,Herenthoutsesteenweg 2,2022-01-29,04:00:00,0,0,0,ECO_300019380
642,Herenthoutsesteenweg 2,2022-01-29,05:00:00,1,1,0,ECO_300019380
642,Herenthoutsesteenweg 2,2022-01-29,06:00:00,3,3,0,ECO_300019380
642,Herenthoutsesteenweg 2,2022-01-29,07:00:00,9,8,1,ECO_300019380
642,Herenthoutsesteenweg 2,2022-01-29,08:00:00,8,8,0,ECO_300019380
642,Herenthoutsesteenweg 2,2022-01-29,09:00:00,30,30,0,ECO_300019380
642,Herenthoutsesteenweg 2,2022-01-29,10:00:00,40,33,7,ECO_300019380
642,Herenthoutsesteenweg 2,2022-01-29,11:00:00,43,38,5,ECO_300019380
642,Herenthoutsesteenweg 2,2022-01-29,12:00:00,42,38,4,ECO_300019380
642,Herenthoutsesteenweg 2,2022-01-29,13:00:00,38,35,3,ECO_300019380
642,Herenthoutsesteenweg 2,2022-01-29,14:00:00,48,47,1,ECO_300019380
642,Herenthoutsesteenweg 2,2022-01-29,15:00:00,50,47,3,ECO_300019380
642,Herenthoutsesteenweg 2,2022-01-29,16:00:00,65,57,8,ECO_300019380
642,Herenthoutsesteenweg 2,2022-01-29,17:00:00,30,28,2,ECO_300019380
642,Herenthoutsesteenweg 2,2022-01-29,18:00:00,33,29,4,ECO_300019380
642,Herenthoutsesteenweg 2,2022-01-29,19:00:00,22,22,0,ECO_300019380
642,Herenthoutsesteenweg 2,2022-01-29,20:00:00,21,20,1,ECO_300019380
642,Herenthoutsesteenweg 2,2022-01-29,21:00:00,10,7,3,ECO_300019380
642,Herenthoutsesteenweg 2,2022-01-29,22:00:00,6,6,0,ECO_300019380
642,Herenthoutsesteenweg 2,2022-01-29,23:00:00,3,2,1,ECO_300019380
642,Herenthoutsesteenweg 2,2022-01-30,00:00:00,7,7,0,ECO_300019380
642,Herenthoutsesteenweg 2,2022-01-30,01:00:00,8,6,2,ECO_300019380
642,Herenthoutsesteenweg 2,2022-01-30,02:00:00,7,5,2,ECO_300019380
642,Herenthoutsesteenweg 2,2022-01-30,03:00:00,4,3,1,ECO_300019380
642,Herenthoutsesteenweg 2,2022-01-30,04:00:00,2,2,0,ECO_300019380
642,Herenthoutsesteenweg 2,2022-01-30,05:00:00,0,0,0,ECO_300019380
642,Herenthoutsesteenweg 2,2022-01-30,06:00:00,3,3,0,ECO_300019380
642,Herenthoutsesteenweg 2,2022-01-30,07:00:00,8,8,0,ECO_300019380
642,Herenthoutsesteenweg 2,2022-01-30,08:00:00,8,8,0,ECO_300019380
642,Herenthoutsesteenweg 2,2022-01-30,09:00:00,41,34,7,ECO_300019380
642,Herenthoutsesteenweg 2,2022-01-30,10:00:00,59,58,1,ECO_300019380
642,Herenthoutsesteenweg 2,2022-01-30,11:00:00,133,123,10,ECO_300019380
642,Herenthoutsesteenweg 2,2022-01-30,12:00:00,121,89,32,ECO_300019380
642,Herenthoutsesteenweg 2,2022-01-30,13:00:00,90,81,9,ECO_300019380
642,Herenthoutsesteenweg 2,2022-01-30,14:00:00,66,59,7,ECO_300019380
642,Herenthoutsesteenweg 2,2022-01-30,15:00:00,63,54,9,ECO_300019380
642,Herenthoutsesteenweg 2,2022-01-30,16:00:00,76,67,9,ECO_300019380
642,Herenthoutsesteenweg 2,2022-01-30,17:00:00,45,38,7,ECO_300019380
642,Herenthoutsesteenweg 2,2022-01-30,18:00:00,26,23,3,ECO_300019380
642,Herenthoutsesteenweg 2,2022-01-30,19:00:00,10,9,1,ECO_300019380
642,Herenthoutsesteenweg 2,2022-01-30,20:00:00,18,14,4,ECO_300019380
642,Herenthoutsesteenweg 2,2022-01-30,21:00:00,6,3,3,ECO_300019380
642,Herenthoutsesteenweg 2,2022-01-30,22:00:00,3,3,0,ECO_300019380
642,Herenthoutsesteenweg 2,2022-01-30,23:00:00,2,2,0,ECO_300019380
642,Herenthoutsesteenweg 2,2022-01-31,00:00:00,2,2,0,ECO_300019380
642,Herenthoutsesteenweg 2,2022-01-31,01:00:00,1,0,1,ECO_300019380
642,Herenthoutsesteenweg 2,2022-01-31,02:00:00,1,1,0,ECO_300019380
642,Herenthoutsesteenweg 2,2022-01-31,03:00:00,0,0,0,ECO_300019380
642,Herenthoutsesteenweg 2,2022-01-31,04:00:00,0,0,0,ECO_300019380
642,Herenthoutsesteenweg 2,2022-01-31,05:00:00,1,1,0,ECO_300019380
642,Herenthoutsesteenweg 2,2022-01-31,06:00:00,13,13,0,ECO_300019380
642,Herenthoutsesteenweg 2,2022-01-31,07:00:00,24,22,2,ECO_300019380
642,Herenthoutsesteenweg 2,2022-01-31,08:00:00,83,82,1,ECO_300019380
642,Herenthoutsesteenweg 2,2022-01-31,09:00:00,299,294,5,ECO_300019380
642,Herenthoutsesteenweg 2,2022-01-31,10:00:00,39,37,2,ECO_300019380
642,Herenthoutsesteenweg 2,2022-01-31,11:00:00,17,17,0,ECO_300019380
642,Herenthoutsesteenweg 2,2022-01-31,12:00:00,18,13,5,ECO_300019380
642,Herenthoutsesteenweg 2,2022-01-31,13:00:00,26,24,2,ECO_300019380
642,Herenthoutsesteenweg 2,2022-01-31,14:00:00,20,17,3,ECO_300019380
642,Herenthoutsesteenweg 2,2022-01-31,15:00:00,29,25,4,ECO_300019380
642,Herenthoutsesteenweg 2,2022-01-31,16:00:00,29,25,4,ECO_300019380
642,Herenthoutsesteenweg 2,2022-01-31,17:00:00,43,39,4,ECO_300019380
642,Herenthoutsesteenweg 2,2022-01-31,18:00:00,20,18,2,ECO_300019380
642,Herenthoutsesteenweg 2,2022-01-31,19:00:00,21,18,3,ECO_300019380
642,Herenthoutsesteenweg 2,2022-01-31,20:00:00,9,8,1,ECO_300019380
642,Herenthoutsesteenweg 2,2022-01-31,21:00:00,6,5,1,ECO_300019380
642,Herenthoutsesteenweg 2,2022-01-31,22:00:00,6,4,2,ECO_300019380
642,Herenthoutsesteenweg 2,2022-01-31,23:00:00,7,7,0,ECO_300019380
642,Herenthoutsesteenweg 2,2022-02-01,00:00:00,2,1,1,ECO_300019380
642,Herenthoutsesteenweg 2,2022-02-01,01:00:00,0,0,0,ECO_300019380
642,Herenthoutsesteenweg 2,2022-02-01,02:00:00,0,0,0,ECO_300019380
642,Herenthoutsesteenweg 2,2022-02-01,03:00:00,0,0,0,ECO_300019380
642,Herenthoutsesteenweg 2,2022-02-01,04:00:00,0,0,0,ECO_300019380
642,Herenthoutsesteenweg 2,2022-02-01,05:00:00,3,3,0,ECO_300019380
642,Herenthoutsesteenweg 2,2022-02-01,06:00:00,11,10,1,ECO_300019380
642,Herenthoutsesteenweg 2,2022-02-01,07:00:00,30,29,1,ECO_300019380
642,Herenthoutsesteenweg 2,2022-02-01,08:00:00,107,106,1,ECO_300019380
642,Herenthoutsesteenweg 2,2022-02-01,09:00:00,426,419,7,ECO_300019380
642,Herenthoutsesteenweg 2,2022-02-01,10:00:00,30,30,0,ECO_300019380
642,Herenthoutsesteenweg 2,2022-02-01,11:00:00,35,33,2,ECO_300019380
642,Herenthoutsesteenweg 2,2022-02-01,12:00:00,17,16,1,ECO_300019380
642,Herenthoutsesteenweg 2,2022-02-01,13:00:00,22,20,2,ECO_300019380
642,Herenthoutsesteenweg 2,2022-02-01,14:00:00,32,31,1,ECO_300019380
642,Herenthoutsesteenweg 2,2022-02-01,15:00:00,37,35,2,ECO_300019380
642,Herenthoutsesteenweg 2,2022-02-01,16:00:00,68,57,11,ECO_300019380
642,Herenthoutsesteenweg 2,2022-02-01,17:00:00,79,67,12,ECO_300019380
642,Herenthoutsesteenweg 2,2022-02-01,18:00:00,43,38,5,ECO_300019380
642,Herenthoutsesteenweg 2,2022-02-01,19:00:00,19,17,2,ECO_300019380
642,Herenthoutsesteenweg 2,2022-02-01,20:00:00,14,14,0,ECO_300019380
642,Herenthoutsesteenweg 2,2022-02-01,21:00:00,10,8,2,ECO_300019380
642,Herenthoutsesteenweg 2,2022-02-01,22:00:00,13,11,2,ECO_300019380
642,Herenthoutsesteenweg 2,2022-02-01,23:00:00,3,2,1,ECO_300019380
642,Herenthoutsesteenweg 2,2022-02-02,00:00:00,1,0,1,ECO_300019380
642,Herenthoutsesteenweg 2,2022-02-02,01:00:00,2,2,0,ECO_300019380
642,Herenthoutsesteenweg 2,2022-02-02,02:00:00,0,0,0,ECO_300019380
642,Herenthoutsesteenweg 2,2022-02-02,03:00:00,0,0,0,ECO_300019380
642,Herenthoutsesteenweg 2,2022-02-02,04:00:00,0,0,0,ECO_300019380
642,Herenthoutsesteenweg 2,2022-02-02,05:00:00,3,3,0,ECO_300019380
642,Herenthoutsesteenweg 2,2022-02-02,06:00:00,11,10,1,ECO_300019380
642,Herenthoutsesteenweg 2,2022-02-02,07:00:00,35,33,2,ECO_300019380
642,Herenthoutsesteenweg 2,2022-02-02,08:00:00,107,103,4,ECO_300019380
642,Herenthoutsesteenweg 2,2022-02-02,09:00:00,418,408,10,ECO_300019380
642,Herenthoutsesteenweg 2,2022-02-02,10:00:00,60,58,2,ECO_300019380
642,Herenthoutsesteenweg 2,2022-02-02,11:00:00,73,64,9,ECO_300019380
642,Herenthoutsesteenweg 2,2022-02-02,12:00:00,50,46,4,ECO_300019380
642,Herenthoutsesteenweg 2,2022-02-02,13:00:00,69,59,10,ECO_300019380
642,Herenthoutsesteenweg 2,2022-02-02,14:00:00,49,47,2,ECO_300019380
642,Herenthoutsesteenweg 2,2022-02-02,15:00:00,59,54,5,ECO_300019380
642,Herenthoutsesteenweg 2,2022-02-02,16:00:00,27,23,4,ECO_300019380
642,Herenthoutsesteenweg 2,2022-02-02,17:00:00,69,62,7,ECO_300019380
642,Herenthoutsesteenweg 2,2022-02-02,18:00:00,39,36,3,ECO_300019380
642,Herenthoutsesteenweg 2,2022-02-02,19:00:00,36,32,4,ECO_300019380
642,Herenthoutsesteenweg 2,2022-02-02,20:00:00,32,29,3,ECO_300019380
642,Herenthoutsesteenweg 2,2022-02-02,21:00:00,21,20,1,ECO_300019380
642,Herenthoutsesteenweg 2,2022-02-02,22:00:00,8,6,2,ECO_300019380
642,Herenthoutsesteenweg 2,2022-02-02,23:00:00,9,8,1,ECO_300019380
642,Herenthoutsesteenweg 2,2022-02-03,00:00:00,6,5,1,ECO_300019380
642,Herenthoutsesteenweg 2,2022-02-03,01:00:00,4,4,0,ECO_300019380
642,Herenthoutsesteenweg 2,2022-02-03,02:00:00,0,0,0,ECO_300019380
642,Herenthoutsesteenweg 2,2022-02-03,03:00:00,0,0,0,ECO_300019380
642,Herenthoutsesteenweg 2,2022-02-03,04:00:00,0,0,0,ECO_300019380
642,Herenthoutsesteenweg 2,2022-02-03,05:00:00,1,1,0,ECO_300019380
642,Herenthoutsesteenweg 2,2022-02-03,06:00:00,19,14,5,ECO_300019380
642,Herenthoutsesteenweg 2,2022-02-03,07:00:00,35,29,6,ECO_300019380
642,Herenthoutsesteenweg 2,2022-02-03,08:00:00,122,121,1,ECO_300019380
642,Herenthoutsesteenweg 2,2022-02-03,09:00:00,457,451,6,ECO_300019380
642,Herenthoutsesteenweg 2,2022-02-03,10:00:00,77,72,5,ECO_300019380
642,Herenthoutsesteenweg 2,2022-02-03,11:00:00,43,43,0,ECO_300019380
642,Herenthoutsesteenweg 2,2022-02-03,12:00:00,46,42,4,ECO_300019380
642,Herenthoutsesteenweg 2,2022-02-03,13:00:00,38,34,4,ECO_300019380
642,Herenthoutsesteenweg 2,2022-02-03,14:00:00,68,61,7,ECO_300019380
642,Herenthoutsesteenweg 2,2022-02-03,15:00:00,60,58,2,ECO_300019380
642,Herenthoutsesteenweg 2,2022-02-03,16:00:00,87,80,7,ECO_300019380
642,Herenthoutsesteenweg 2,2022-02-03,17:00:00,75,63,12,ECO_300019380
642,Herenthoutsesteenweg 2,2022-02-03,18:00:00,45,40,5,ECO_300019380
642,Herenthoutsesteenweg 2,2022-02-03,19:00:00,23,20,3,ECO_300019380
642,Herenthoutsesteenweg 2,2022-02-03,20:00:00,34,33,1,ECO_300019380
642,Herenthoutsesteenweg 2,2022-02-03,21:00:00,17,15,2,ECO_300019380
642,Herenthoutsesteenweg 2,2022-02-03,22:00:00,10,8,2,ECO_300019380
642,Herenthoutsesteenweg 2,2022-02-03,23:00:00,13,12,1,ECO_300019380
642,Herenthoutsesteenweg 2,2022-02-04,00:00:00,5,2,3,ECO_300019380
642,Herenthoutsesteenweg 2,2022-02-04,01:00:00,5,1,4,ECO_300019380
642,Herenthoutsesteenweg 2,2022-02-04,02:00:00,3,3,0,ECO_300019380
642,Herenthoutsesteenweg 2,2022-02-04,03:00:00,1,1,0,ECO_300019380
642,Herenthoutsesteenweg 2,2022-02-04,04:00:00,0,0,0,ECO_300019380
642,Herenthoutsesteenweg 2,2022-02-04,05:00:00,0,0,0,ECO_300019380
642,Herenthoutsesteenweg 2,2022-02-04,06:00:00,14,12,2,ECO_300019380
642,Herenthoutsesteenweg 2,2022-02-04,07:00:00,23,23,0,ECO_300019380
642,Herenthoutsesteenweg 2,2022-02-04,08:00:00,96,90,6,ECO_300019380
642,Herenthoutsesteenweg 2,2022-02-04,09:00:00,117,111,6,ECO_300019380
642,Herenthoutsesteenweg 2,2022-02-04,10:00:00,59,57,2,ECO_300019380
642,Herenthoutsesteenweg 2,2022-02-04,11:00:00,58,56,2,ECO_300019380
642,Herenthoutsesteenweg 2,2022-02-04,12:00:00,54,49,5,ECO_300019380
642,Herenthoutsesteenweg 2,2022-02-04,13:00:00,32,27,5,ECO_300019380
642,Herenthoutsesteenweg 2,2022-02-04,14:00:00,50,46,4,ECO_300019380
642,Herenthoutsesteenweg 2,2022-02-04,15:00:00,46,40,6,ECO_300019380
642,Herenthoutsesteenweg 2,2022-02-04,16:00:00,54,46,8,ECO_300019380
642,Herenthoutsesteenweg 2,2022-02-04,17:00:00,51,47,4,ECO_300019380
642,Herenthoutsesteenweg 2,2022-02-04,18:00:00,28,23,5,ECO_300019380
642,Herenthoutsesteenweg 2,2022-02-04,19:00:00,33,29,4,ECO_300019380
642,Herenthoutsesteenweg 2,2022-02-04,20:00:00,19,19,0,ECO_300019380
642,Herenthoutsesteenweg 2,2022-02-04,21:00:00,31,30,1,ECO_300019380
642,Herenthoutsesteenweg 2,2022-02-04,22:00:00,12,11,1,ECO_300019380
642,Herenthoutsesteenweg 2,2022-02-04,23:00:00,13,12,1,ECO_300019380
642,Herenthoutsesteenweg 2,2022-02-05,00:00:00,1,1,0,ECO_300019380
642,Herenthoutsesteenweg 2,2022-02-05,01:00:00,6,3,3,ECO_300019380
642,Herenthoutsesteenweg 2,2022-02-05,02:00:00,4,4,0,ECO_300019380
642,Herenthoutsesteenweg 2,2022-02-05,03:00:00,2,1,1,ECO_300019380
642,Herenthoutsesteenweg 2,2022-02-05,04:00:00,5,2,3,ECO_300019380
642,Herenthoutsesteenweg 2,2022-02-05,05:00:00,2,2,0,ECO_300019380
642,Herenthoutsesteenweg 2,2022-02-05,06:00:00,4,4,0,ECO_300019380
642,Herenthoutsesteenweg 2,2022-02-05,07:00:00,7,7,0,ECO_300019380
642,Herenthoutsesteenweg 2,2022-02-05,08:00:00,10,10,0,ECO_300019380
642,Herenthoutsesteenweg 2,2022-02-05,09:00:00,25,23,2,ECO_300019380
642,Herenthoutsesteenweg 2,2022-02-05,10:00:00,69,69,0,ECO_300019380
642,Herenthoutsesteenweg 2,2022-02-05,11:00:00,89,78,11,ECO_300019380
642,Herenthoutsesteenweg 2,2022-02-05,12:00:00,67,65,2,ECO_300019380
642,Herenthoutsesteenweg 2,2022-02-05,13:00:00,76,71,5,ECO_300019380
642,Herenthoutsesteenweg 2,2022-02-05,14:00:00,137,125,12,ECO_300019380
642,Herenthoutsesteenweg 2,2022-02-05,15:00:00,116,109,7,ECO_300019380
642,Herenthoutsesteenweg 2,2022-02-05,16:00:00,122,113,9,ECO_300019380
642,Herenthoutsesteenweg 2,2022-02-05,17:00:00,71,62,9,ECO_300019380
642,Herenthoutsesteenweg 2,2022-02-05,18:00:00,49,43,6,ECO_300019380
642,Herenthoutsesteenweg 2,2022-02-05,19:00:00,24,24,0,ECO_300019380
642,Herenthoutsesteenweg 2,2022-02-05,20:00:00,15,14,1,ECO_300019380
642,Herenthoutsesteenweg 2,2022-02-05,21:00:00,17,15,2,ECO_300019380
642,Herenthoutsesteenweg 2,2022-02-05,22:00:00,6,5,1,ECO_300019380
642,Herenthoutsesteenweg 2,2022-02-05,23:00:00,6,4,2,ECO_300019380
642,Herenthoutsesteenweg 2,2022-02-06,00:00:00,6,3,3,ECO_300019380
642,Herenthoutsesteenweg 2,2022-02-06,01:00:00,12,6,6,ECO_300019380
642,Herenthoutsesteenweg 2,2022-02-06,02:00:00,6,6,0,ECO_300019380
642,Herenthoutsesteenweg 2,2022-02-06,03:00:00,2,2,0,ECO_300019380
642,Herenthoutsesteenweg 2,2022-02-06,04:00:00,0,0,0,ECO_300019380
642,Herenthoutsesteenweg 2,2022-02-06,05:00:00,0,0,0,ECO_300019380
642,Herenthoutsesteenweg 2,2022-02-06,06:00:00,2,1,1,ECO_300019380
642,Herenthoutsesteenweg 2,2022-02-06,07:00:00,4,4,0,ECO_300019380
642,Herenthoutsesteenweg 2,2022-02-06,08:00:00,3,3,0,ECO_300019380
642,Herenthoutsesteenweg 2,2022-02-06,09:00:00,5,4,1,ECO_300019380
642,Herenthoutsesteenweg 2,2022-02-06,10:00:00,10,9,1,ECO_300019380
642,Herenthoutsesteenweg 2,2022-02-06,11:00:00,6,5,1,ECO_300019380
642,Herenthoutsesteenweg 2,2022-02-06,12:00:00,5,4,1,ECO_300019380
642,Herenthoutsesteenweg 2,2022-02-06,13:00:00,4,4,0,ECO_300019380
642,Herenthoutsesteenweg 2,2022-02-06,14:00:00,5,5,0,ECO_300019380
642,Herenthoutsesteenweg 2,2022-02-06,15:00:00,1,0,1,ECO_300019380
642,Herenthoutsesteenweg 2,2022-02-06,16:00:00,4,4,0,ECO_300019380
642,Herenthoutsesteenweg 2,2022-02-06,17:00:00,8,8,0,ECO_300019380
642,Herenthoutsesteenweg 2,2022-02-06,18:00:00,7,7,0,ECO_300019380
642,Herenthoutsesteenweg 2,2022-02-06,19:00:00,6,6,0,ECO_300019380
642,Herenthoutsesteenweg 2,2022-02-06,20:00:00,6,6,0,ECO_300019380
642,Herenthoutsesteenweg 2,2022-02-06,21:00:00,1,1,0,ECO_300019380
642,Herenthoutsesteenweg 2,2022-02-06,22:00:00,2,2,0,ECO_300019380
642,Herenthoutsesteenweg 2,2022-02-06,23:00:00,1,1,0,ECO_300019380
642,Herenthoutsesteenweg 2,2022-02-07,00:00:00,0,0,0,ECO_300019380
642,Herenthoutsesteenweg 2,2022-02-07,01:00:00,0,0,0,ECO_300019380
642,Herenthoutsesteenweg 2,2022-02-07,02:00:00,0,0,0,ECO_300019380
642,Herenthoutsesteenweg 2,2022-02-07,03:00:00,0,0,0,ECO_300019380
642,Herenthoutsesteenweg 2,2022-02-07,04:00:00,0,0,0,ECO_300019380
642,Herenthoutsesteenweg 2,2022-02-07,05:00:00,1,1,0,ECO_300019380
642,Herenthoutsesteenweg 2,2022-02-07,06:00:00,12,12,0,ECO_300019380
642,Herenthoutsesteenweg 2,2022-02-07,07:00:00,32,29,3,ECO_300019380
642,Herenthoutsesteenweg 2,2022-02-07,08:00:00,114,113,1,ECO_300019380
642,Herenthoutsesteenweg 2,2022-02-07,09:00:00,459,450,9,ECO_300019380
642,Herenthoutsesteenweg 2,2022-02-07,10:00:00,47,44,3,ECO_300019380
642,Herenthoutsesteenweg 2,2022-02-07,11:00:00,39,39,0,ECO_300019380
642,Herenthoutsesteenweg 2,2022-02-07,12:00:00,38,33,5,ECO_300019380
642,Herenthoutsesteenweg 2,2022-02-07,13:00:00,51,48,3,ECO_300019380
642,Herenthoutsesteenweg 2,2022-02-07,14:00:00,104,91,13,ECO_300019380
642,Herenthoutsesteenweg 2,2022-02-07,15:00:00,87,82,5,ECO_300019380
642,Herenthoutsesteenweg 2,2022-02-07,16:00:00,107,98,9,ECO_300019380
642,Herenthoutsesteenweg 2,2022-02-07,17:00:00,97,87,10,ECO_300019380
642,Herenthoutsesteenweg 2,2022-02-07,18:00:00,59,55,4,ECO_300019380
642,Herenthoutsesteenweg 2,2022-02-07,19:00:00,41,38,3,ECO_300019380
642,Herenthoutsesteenweg 2,2022-02-07,20:00:00,30,27,3,ECO_300019380
642,Herenthoutsesteenweg 2,2022-02-07,21:00:00,8,7,1,ECO_300019380
642,Herenthoutsesteenweg 2,2022-02-07,22:00:00,3,3,0,ECO_300019380
642,Herenthoutsesteenweg 2,2022-02-07,23:00:00,12,10,2,ECO_300019380
642,Herenthoutsesteenweg 2,2022-02-08,00:00:00,1,0,1,ECO_300019380
642,Herenthoutsesteenweg 2,2022-02-08,01:00:00,1,0,1,ECO_300019380
642,Herenthoutsesteenweg 2,2022-02-08,02:00:00,0,0,0,ECO_300019380
642,Herenthoutsesteenweg 2,2022-02-08,03:00:00,0,0,0,ECO_300019380
642,Herenthoutsesteenweg 2,2022-02-08,04:00:00,0,0,0,ECO_300019380
642,Herenthoutsesteenweg 2,2022-02-08,05:00:00,1,1,0,ECO_300019380
642,Herenthoutsesteenweg 2,2022-02-08,06:00:00,11,9,2,ECO_300019380
642,Herenthoutsesteenweg 2,2022-02-08,07:00:00,39,38,1,ECO_300019380
642,Herenthoutsesteenweg 2,2022-02-08,08:00:00,131,128,3,ECO_300019380
642,Herenthoutsesteenweg 2,2022-02-08,09:00:00,449,443,6,ECO_300019380
642,Herenthoutsesteenweg 2,2022-02-08,10:00:00,75,68,7,ECO_300019380
642,Herenthoutsesteenweg 2,2022-02-08,11:00:00,42,36,6,ECO_300019380
642,Herenthoutsesteenweg 2,2022-02-08,12:00:00,40,34,6,ECO_300019380
642,Herenthoutsesteenweg 2,2022-02-08,13:00:00,50,47,3,ECO_300019380
642,Herenthoutsesteenweg 2,2022-02-08,14:00:00,87,77,10,ECO_300019380
642,Herenthoutsesteenweg 2,2022-02-08,15:00:00,95,90,5,ECO_300019380
642,Herenthoutsesteenweg 2,2022-02-08,16:00:00,108,92,16,ECO_300019380
642,Herenthoutsesteenweg 2,2022-02-08,17:00:00,82,71,11,ECO_300019380
642,Herenthoutsesteenweg 2,2022-02-08,18:00:00,66,59,7,ECO_300019380
642,Herenthoutsesteenweg 2,2022-02-08,19:00:00,25,22,3,ECO_300019380
642,Herenthoutsesteenweg 2,2022-02-08,20:00:00,12,10,2,ECO_300019380
642,Herenthoutsesteenweg 2,2022-02-08,21:00:00,16,16,0,ECO_300019380
642,Herenthoutsesteenweg 2,2022-02-08,22:00:00,14,12,2,ECO_300019380
642,Herenthoutsesteenweg 2,2022-02-08,23:00:00,14,11,3,ECO_300019380
642,Herenthoutsesteenweg 2,2022-02-09,00:00:00,0,0,0,ECO_300019380
642,Herenthoutsesteenweg 2,2022-02-09,01:00:00,0,0,0,ECO_300019380
642,Herenthoutsesteenweg 2,2022-02-09,02:00:00,0,0,0,ECO_300019380
642,Herenthoutsesteenweg 2,2022-02-09,03:00:00,0,0,0,ECO_300019380
642,Herenthoutsesteenweg 2,2022-02-09,04:00:00,1,1,0,ECO_300019380
642,Herenthoutsesteenweg 2,2022-02-09,05:00:00,2,2,0,ECO_300019380
642,Herenthoutsesteenweg 2,2022-02-09,06:00:00,13,13,0,ECO_300019380
642,Herenthoutsesteenweg 2,2022-02-09,07:00:00,39,38,1,ECO_300019380
642,Herenthoutsesteenweg 2,2022-02-09,08:00:00,123,118,5,ECO_300019380
642,Herenthoutsesteenweg 2,2022-02-09,09:00:00,437,432,5,ECO_300019380
642,Herenthoutsesteenweg 2,2022-02-09,10:00:00,68,56,12,ECO_300019380
642,Herenthoutsesteenweg 2,2022-02-09,11:00:00,50,42,8,ECO_300019380
642,Herenthoutsesteenweg 2,2022-02-09,12:00:00,49,41,8,ECO_300019380
642,Herenthoutsesteenweg 2,2022-02-09,13:00:00,96,87,9,ECO_300019380
642,Herenthoutsesteenweg 2,2022-02-09,14:00:00,98,90,8,ECO_300019380
642,Herenthoutsesteenweg 2,2022-02-09,15:00:00,98,94,4,ECO_300019380
642,Herenthoutsesteenweg 2,2022-02-09,16:00:00,87,75,12,ECO_300019380
642,Herenthoutsesteenweg 2,2022-02-09,17:00:00,95,78,17,ECO_300019380
642,Herenthoutsesteenweg 2,2022-02-09,18:00:00,69,63,6,ECO_300019380
642,Herenthoutsesteenweg 2,2022-02-09,19:00:00,42,38,4,ECO_300019380
642,Herenthoutsesteenweg 2,2022-02-09,20:00:00,31,29,2,ECO_300019380
642,Herenthoutsesteenweg 2,2022-02-09,21:00:00,20,17,3,ECO_300019380
642,Herenthoutsesteenweg 2,2022-02-09,22:00:00,16,14,2,ECO_300019380
642,Herenthoutsesteenweg 2,2022-02-09,23:00:00,9,8,1,ECO_300019380
642,Herenthoutsesteenweg 2,2022-02-10,00:00:00,3,3,0,ECO_300019380
642,Herenthoutsesteenweg 2,2022-02-10,01:00:00,5,4,1,ECO_300019380
642,Herenthoutsesteenweg 2,2022-02-10,02:00:00,0,0,0,ECO_300019380
642,Herenthoutsesteenweg 2,2022-02-10,03:00:00,0,0,0,ECO_300019380
642,Herenthoutsesteenweg 2,2022-02-10,04:00:00,0,0,0,ECO_300019380
642,Herenthoutsesteenweg 2,2022-02-10,05:00:00,1,1,0,ECO_300019380
642,Herenthoutsesteenweg 2,2022-02-10,06:00:00,16,15,1,ECO_300019380
642,Herenthoutsesteenweg 2,2022-02-10,07:00:00,28,27,1,ECO_300019380
642,Herenthoutsesteenweg 2,2022-02-10,08:00:00,137,135,2,ECO_300019380
642,Herenthoutsesteenweg 2,2022-02-10,09:00:00,443,440,3,ECO_300019380
642,Herenthoutsesteenweg 2,2022-02-10,10:00:00,35,34,1,ECO_300019380
642,Herenthoutsesteenweg 2,2022-02-10,11:00:00,19,18,1,ECO_300019380
642,Herenthoutsesteenweg 2,2022-02-10,12:00:00,26,20,6,ECO_300019380
642,Herenthoutsesteenweg 2,2022-02-10,13:00:00,15,14,1,ECO_300019380
642,Herenthoutsesteenweg 2,2022-02-10,14:00:00,36,33,3,ECO_300019380
642,Herenthoutsesteenweg 2,2022-02-10,15:00:00,52,52,0,ECO_300019380
642,Herenthoutsesteenweg 2,2022-02-10,16:00:00,73,62,11,ECO_300019380
642,Herenthoutsesteenweg 2,2022-02-10,17:00:00,65,58,7,ECO_300019380
642,Herenthoutsesteenweg 2,2022-02-10,18:00:00,34,30,4,ECO_300019380
642,Herenthoutsesteenweg 2,2022-02-10,19:00:00,26,22,4,ECO_300019380
642,Herenthoutsesteenweg 2,2022-02-10,20:00:00,11,11,0,ECO_300019380
642,Herenthoutsesteenweg 2,2022-02-10,21:00:00,19,17,2,ECO_300019380
642,Herenthoutsesteenweg 2,2022-02-10,22:00:00,9,8,1,ECO_300019380
642,Herenthoutsesteenweg 2,2022-02-10,23:00:00,10,10,0,ECO_300019380
642,Herenthoutsesteenweg 2,2022-02-11,00:00:00,1,1,0,ECO_300019380
642,Herenthoutsesteenweg 2,2022-02-11,01:00:00,2,2,0,ECO_300019380
642,Herenthoutsesteenweg 2,2022-02-11,02:00:00,0,0,0,ECO_300019380
642,Herenthoutsesteenweg 2,2022-02-11,03:00:00,2,0,2,ECO_300019380
642,Herenthoutsesteenweg 2,2022-02-11,04:00:00,0,0,0,ECO_300019380
642,Herenthoutsesteenweg 2,2022-02-11,05:00:00,3,3,0,ECO_300019380
642,Herenthoutsesteenweg 2,2022-02-11,06:00:00,20,20,0,ECO_300019380
642,Herenthoutsesteenweg 2,2022-02-11,07:00:00,26,26,0,ECO_300019380
642,Herenthoutsesteenweg 2,2022-02-11,08:00:00,103,95,8,ECO_300019380
642,Herenthoutsesteenweg 2,2022-02-11,09:00:00,440,430,10,ECO_300019380
642,Herenthoutsesteenweg 2,2022-02-11,10:00:00,97,94,3,ECO_300019380
642,Herenthoutsesteenweg 2,2022-02-11,11:00:00,71,66,5,ECO_300019380
642,Herenthoutsesteenweg 2,2022-02-11,12:00:00,58,54,4,ECO_300019380
642,Herenthoutsesteenweg 2,2022-02-11,13:00:00,52,46,6,ECO_300019380
642,Herenthoutsesteenweg 2,2022-02-11,14:00:00,88,83,5,ECO_300019380
642,Herenthoutsesteenweg 2,2022-02-11,15:00:00,80,76,4,ECO_300019380
642,Herenthoutsesteenweg 2,2022-02-11,16:00:00,110,98,12,ECO_300019380
642,Herenthoutsesteenweg 2,2022-02-11,17:00:00,100,90,10,ECO_300019380
642,Herenthoutsesteenweg 2,2022-02-11,18:00:00,64,55,9,ECO_300019380
642,Herenthoutsesteenweg 2,2022-02-11,19:00:00,39,36,3,ECO_300019380
642,Herenthoutsesteenweg 2,2022-02-11,20:00:00,41,40,1,ECO_300019380
642,Herenthoutsesteenweg 2,2022-02-11,21:00:00,32,28,4,ECO_300019380
642,Herenthoutsesteenweg 2,2022-02-11,22:00:00,9,9,0,ECO_300019380
642,Herenthoutsesteenweg 2,2022-02-11,23:00:00,19,18,1,ECO_300019380
642,Herenthoutsesteenweg 2,2022-02-12,00:00:00,5,4,1,ECO_300019380
642,Herenthoutsesteenweg 2,2022-02-12,01:00:00,4,2,2,ECO_300019380
642,Herenthoutsesteenweg 2,2022-02-12,02:00:00,3,2,1,ECO_300019380
642,Herenthoutsesteenweg 2,2022-02-12,03:00:00,4,1,3,ECO_300019380
642,Herenthoutsesteenweg 2,2022-02-12,04:00:00,3,2,1,ECO_300019380
642,Herenthoutsesteenweg 2,2022-02-12,05:00:00,7,5,2,ECO_300019380
642,Herenthoutsesteenweg 2,2022-02-12,06:00:00,6,6,0,ECO_300019380
642,Herenthoutsesteenweg 2,2022-02-12,07:00:00,4,4,0,ECO_300019380
642,Herenthoutsesteenweg 2,2022-02-12,08:00:00,7,7,0,ECO_300019380
642,Herenthoutsesteenweg 2,2022-02-12,09:00:00,23,22,1,ECO_300019380
642,Herenthoutsesteenweg 2,2022-02-12,10:00:00,46,45,1,ECO_300019380
642,Herenthoutsesteenweg 2,2022-02-12,11:00:00,46,46,0,ECO_300019380
642,Herenthoutsesteenweg 2,2022-02-12,12:00:00,63,58,5,ECO_300019380
642,Herenthoutsesteenweg 2,2022-02-12,13:00:00,92,82,10,ECO_300019380
642,Herenthoutsesteenweg 2,2022-02-12,14:00:00,125,115,10,ECO_300019380
642,Herenthoutsesteenweg 2,2022-02-12,15:00:00,103,92,11,ECO_300019380
642,Herenthoutsesteenweg 2,2022-02-12,16:00:00,103,96,7,ECO_300019380
642,Herenthoutsesteenweg 2,2022-02-12,17:00:00,68,61,7,ECO_300019380
642,Herenthoutsesteenweg 2,2022-02-12,18:00:00,36,33,3,ECO_300019380
642,Herenthoutsesteenweg 2,2022-02-12,19:00:00,22,20,2,ECO_300019380
642,Herenthoutsesteenweg 2,2022-02-12,20:00:00,31,30,1,ECO_300019380
642,Herenthoutsesteenweg 2,2022-02-12,21:00:00,15,13,2,ECO_300019380
642,Herenthoutsesteenweg 2,2022-02-12,22:00:00,11,11,0,ECO_300019380
642,Herenthoutsesteenweg 2,2022-02-12,23:00:00,6,5,1,ECO_300019380
642,Herenthoutsesteenweg 2,2022-02-13,00:00:00,6,3,3,ECO_300019380
642,Herenthoutsesteenweg 2,2022-02-13,01:00:00,11,5,6,ECO_300019380
642,Herenthoutsesteenweg 2,2022-02-13,02:00:00,6,1,5,ECO_300019380
642,Herenthoutsesteenweg 2,2022-02-13,03:00:00,1,1,0,ECO_300019380
642,Herenthoutsesteenweg 2,2022-02-13,04:00:00,1,0,1,ECO_300019380
642,Herenthoutsesteenweg 2,2022-02-13,05:00:00,3,3,0,ECO_300019380
642,Herenthoutsesteenweg 2,2022-02-13,06:00:00,2,2,0,ECO_300019380
642,Herenthoutsesteenweg 2,2022-02-13,07:00:00,9,7,2,ECO_300019380
642,Herenthoutsesteenweg 2,2022-02-13,08:00:00,3,3,0,ECO_300019380
642,Herenthoutsesteenweg 2,2022-02-13,09:00:00,41,38,3,ECO_300019380
642,Herenthoutsesteenweg 2,2022-02-13,10:00:00,70,62,8,ECO_300019380
642,Herenthoutsesteenweg 2,2022-02-13,11:00:00,93,75,18,ECO_300019380
642,Herenthoutsesteenweg 2,2022-02-13,12:00:00,79,72,7,ECO_300019380
642,Herenthoutsesteenweg 2,2022-02-13,13:00:00,88,78,10,ECO_300019380
642,Herenthoutsesteenweg 2,2022-02-13,14:00:00,44,39,5,ECO_300019380
642,Herenthoutsesteenweg 2,2022-02-13,15:00:00,70,64,6,ECO_300019380
642,Herenthoutsesteenweg 2,2022-02-13,16:00:00,49,48,1,ECO_300019380
642,Herenthoutsesteenweg 2,2022-02-13,17:00:00,44,38,6,ECO_300019380
642,Herenthoutsesteenweg 2,2022-02-13,18:00:00,31,30,1,ECO_300019380
642,Herenthoutsesteenweg 2,2022-02-13,19:00:00,29,26,3,ECO_300019380
642,Herenthoutsesteenweg 2,2022-02-13,20:00:00,14,8,6,ECO_300019380
642,Herenthoutsesteenweg 2,2022-02-13,21:00:00,7,5,2,ECO_300019380
642,Herenthoutsesteenweg 2,2022-02-13,22:00:00,5,4,1,ECO_300019380
642,Herenthoutsesteenweg 2,2022-02-13,23:00:00,9,8,1,ECO_300019380
642,Herenthoutsesteenweg 2,2022-02-14,00:00:00,0,0,0,ECO_300019380
642,Herenthoutsesteenweg 2,2022-02-14,01:00:00,1,0,1,ECO_300019380
642,Herenthoutsesteenweg 2,2022-02-14,02:00:00,0,0,0,ECO_300019380
642,Herenthoutsesteenweg 2,2022-02-14,03:00:00,1,1,0,ECO_300019380
642,Herenthoutsesteenweg 2,2022-02-14,04:00:00,0,0,0,ECO_300019380
642,Herenthoutsesteenweg 2,2022-02-14,05:00:00,1,1,0,ECO_300019380
642,Herenthoutsesteenweg 2,2022-02-14,06:00:00,19,16,3,ECO_300019380
642,Herenthoutsesteenweg 2,2022-02-14,07:00:00,31,29,2,ECO_300019380
642,Herenthoutsesteenweg 2,2022-02-14,08:00:00,110,108,2,ECO_300019380
642,Herenthoutsesteenweg 2,2022-02-14,09:00:00,402,402,0,ECO_300019380
642,Herenthoutsesteenweg 2,2022-02-14,10:00:00,54,54,0,ECO_300019380
642,Herenthoutsesteenweg 2,2022-02-14,11:00:00,34,31,3,ECO_300019380
642,Herenthoutsesteenweg 2,2022-02-14,12:00:00,30,30,0,ECO_300019380
642,Herenthoutsesteenweg 2,2022-02-14,13:00:00,32,31,1,ECO_300019380
642,Herenthoutsesteenweg 2,2022-02-14,14:00:00,58,57,1,ECO_300019380
642,Herenthoutsesteenweg 2,2022-02-14,15:00:00,46,44,2,ECO_300019380
642,Herenthoutsesteenweg 2,2022-02-14,16:00:00,59,56,3,ECO_300019380
642,Herenthoutsesteenweg 2,2022-02-14,17:00:00,58,53,5,ECO_300019380
642,Herenthoutsesteenweg 2,2022-02-14,18:00:00,59,52,7,ECO_300019380
642,Herenthoutsesteenweg 2,2022-02-14,19:00:00,32,30,2,ECO_300019380
642,Herenthoutsesteenweg 2,2022-02-14,20:00:00,22,20,2,ECO_300019380
642,Herenthoutsesteenweg 2,2022-02-14,21:00:00,12,10,2,ECO_300019380
642,Herenthoutsesteenweg 2,2022-02-14,22:00:00,9,8,1,ECO_300019380
642,Herenthoutsesteenweg 2,2022-02-14,23:00:00,10,9,1,ECO_300019380
642,Herenthoutsesteenweg 2,2022-02-15,00:00:00,2,0,2,ECO_300019380
642,Herenthoutsesteenweg 2,2022-02-15,01:00:00,0,0,0,ECO_300019380
642,Herenthoutsesteenweg 2,2022-02-15,02:00:00,2,2,0,ECO_300019380
642,Herenthoutsesteenweg 2,2022-02-15,03:00:00,0,0,0,ECO_300019380
642,Herenthoutsesteenweg 2,2022-02-15,04:00:00,0,0,0,ECO_300019380
642,Herenthoutsesteenweg 2,2022-02-15,05:00:00,1,1,0,ECO_300019380
642,Herenthoutsesteenweg 2,2022-02-15,06:00:00,15,13,2,ECO_300019380
642,Herenthoutsesteenweg 2,2022-02-15,07:00:00,39,37,2,ECO_300019380
642,Herenthoutsesteenweg 2,2022-02-15,08:00:00,98,97,1,ECO_300019380
642,Herenthoutsesteenweg 2,2022-02-15,09:00:00,421,420,1,ECO_300019380
642,Herenthoutsesteenweg 2,2022-02-15,10:00:00,71,70,1,ECO_300019380
642,Herenthoutsesteenweg 2,2022-02-15,11:00:00,50,47,3,ECO_300019380
642,Herenthoutsesteenweg 2,2022-02-15,12:00:00,49,47,2,ECO_300019380
642,Herenthoutsesteenweg 2,2022-02-15,13:00:00,57,52,5,ECO_300019380
642,Herenthoutsesteenweg 2,2022-02-15,14:00:00,81,78,3,ECO_300019380
642,Herenthoutsesteenweg 2,2022-02-15,15:00:00,52,52,0,ECO_300019380
642,Herenthoutsesteenweg 2,2022-02-15,16:00:00,72,59,13,ECO_300019380
642,Herenthoutsesteenweg 2,2022-02-15,17:00:00,65,58,7,ECO_300019380
642,Herenthoutsesteenweg 2,2022-02-15,18:00:00,46,38,8,ECO_300019380
642,Herenthoutsesteenweg 2,2022-02-15,19:00:00,13,12,1,ECO_300019380
642,Herenthoutsesteenweg 2,2022-02-15,20:00:00,12,11,1,ECO_300019380
642,Herenthoutsesteenweg 2,2022-02-15,21:00:00,7,5,2,ECO_300019380
642,Herenthoutsesteenweg 2,2022-02-15,22:00:00,5,4,1,ECO_300019380
642,Herenthoutsesteenweg 2,2022-02-15,23:00:00,9,9,0,ECO_300019380
642,Herenthoutsesteenweg 2,2022-02-16,00:00:00,1,1,0,ECO_300019380
642,Herenthoutsesteenweg 2,2022-02-16,01:00:00,2,0,2,ECO_300019380
642,Herenthoutsesteenweg 2,2022-02-16,02:00:00,1,1,0,ECO_300019380
642,Herenthoutsesteenweg 2,2022-02-16,03:00:00,1,1,0,ECO_300019380
642,Herenthoutsesteenweg 2,2022-02-16,04:00:00,0,0,0,ECO_300019380
642,Herenthoutsesteenweg 2,2022-02-16,05:00:00,1,1,0,ECO_300019380
642,Herenthoutsesteenweg 2,2022-02-16,06:00:00,14,10,4,ECO_300019380
642,Herenthoutsesteenweg 2,2022-02-16,07:00:00,22,20,2,ECO_300019380
642,Herenthoutsesteenweg 2,2022-02-16,08:00:00,90,88,2,ECO_300019380
642,Herenthoutsesteenweg 2,2022-02-16,09:00:00,361,356,5,ECO_300019380
642,Herenthoutsesteenweg 2,2022-02-16,10:00:00,28,27,1,ECO_300019380
642,Herenthoutsesteenweg 2,2022-02-16,11:00:00,20,17,3,ECO_300019380
642,Herenthoutsesteenweg 2,2022-02-16,12:00:00,29,27,2,ECO_300019380
642,Herenthoutsesteenweg 2,2022-02-16,13:00:00,46,40,6,ECO_300019380
642,Herenthoutsesteenweg 2,2022-02-16,14:00:00,51,48,3,ECO_300019380
642,Herenthoutsesteenweg 2,2022-02-16,15:00:00,41,39,2,ECO_300019380
642,Herenthoutsesteenweg 2,2022-02-16,16:00:00,41,39,2,ECO_300019380
642,Herenthoutsesteenweg 2,2022-02-16,17:00:00,61,52,9,ECO_300019380
642,Herenthoutsesteenweg 2,2022-02-16,18:00:00,32,31,1,ECO_300019380
642,Herenthoutsesteenweg 2,2022-02-16,19:00:00,26,23,3,ECO_300019380
642,Herenthoutsesteenweg 2,2022-02-16,20:00:00,9,8,1,ECO_300019380
642,Herenthoutsesteenweg 2,2022-02-16,21:00:00,8,8,0,ECO_300019380
642,Herenthoutsesteenweg 2,2022-02-16,22:00:00,2,2,0,ECO_300019380
642,Herenthoutsesteenweg 2,2022-02-16,23:00:00,7,7,0,ECO_300019380
642,Herenthoutsesteenweg 2,2022-02-17,00:00:00,0,0,0,ECO_300019380
642,Herenthoutsesteenweg 2,2022-02-17,01:00:00,1,1,0,ECO_300019380
642,Herenthoutsesteenweg 2,2022-02-17,02:00:00,1,1,0,ECO_300019380
642,Herenthoutsesteenweg 2,2022-02-17,03:00:00,0,0,0,ECO_300019380
642,Herenthoutsesteenweg 2,2022-02-17,04:00:00,0,0,0,ECO_300019380
642,Herenthoutsesteenweg 2,2022-02-17,05:00:00,1,1,0,ECO_300019380
642,Herenthoutsesteenweg 2,2022-02-17,06:00:00,11,9,2,ECO_300019380
642,Herenthoutsesteenweg 2,2022-02-17,07:00:00,32,28,4,ECO_300019380
642,Herenthoutsesteenweg 2,2022-02-17,08:00:00,88,85,3,ECO_300019380
642,Herenthoutsesteenweg 2,2022-02-17,09:00:00,366,362,4,ECO_300019380
642,Herenthoutsesteenweg 2,2022-02-17,10:00:00,43,42,1,ECO_300019380
642,Herenthoutsesteenweg 2,2022-02-17,11:00:00,35,35,0,ECO_300019380
642,Herenthoutsesteenweg 2,2022-02-17,12:00:00,35,32,3,ECO_300019380
642,Herenthoutsesteenweg 2,2022-02-17,13:00:00,48,45,3,ECO_300019380
642,Herenthoutsesteenweg 2,2022-02-17,14:00:00,45,36,9,ECO_300019380
642,Herenthoutsesteenweg 2,2022-02-17,15:00:00,48,45,3,ECO_300019380
642,Herenthoutsesteenweg 2,2022-02-17,16:00:00,98,84,14,ECO_300019380
642,Herenthoutsesteenweg 2,2022-02-17,17:00:00,62,57,5,ECO_300019380
642,Herenthoutsesteenweg 2,2022-02-17,18:00:00,38,35,3,ECO_300019380
642,Herenthoutsesteenweg 2,2022-02-17,19:00:00,37,28,9,ECO_300019380
642,Herenthoutsesteenweg 2,2022-02-17,20:00:00,27,25,2,ECO_300019380
642,Herenthoutsesteenweg 2,2022-02-17,21:00:00,16,14,2,ECO_300019380
642,Herenthoutsesteenweg 2,2022-02-17,22:00:00,11,10,1,ECO_300019380
642,Herenthoutsesteenweg 2,2022-02-17,23:00:00,4,4,0,ECO_300019380
642,Herenthoutsesteenweg 2,2022-02-18,00:00:00,1,0,1,ECO_300019380
642,Herenthoutsesteenweg 2,2022-02-18,01:00:00,1,0,1,ECO_300019380
642,Herenthoutsesteenweg 2,2022-02-18,02:00:00,1,1,0,ECO_300019380
642,Herenthoutsesteenweg 2,2022-02-18,03:00:00,2,0,2,ECO_300019380
642,Herenthoutsesteenweg 2,2022-02-18,04:00:00,1,1,0,ECO_300019380
642,Herenthoutsesteenweg 2,2022-02-18,05:00:00,3,3,0,ECO_300019380
642,Herenthoutsesteenweg 2,2022-02-18,06:00:00,9,7,2,ECO_300019380
642,Herenthoutsesteenweg 2,2022-02-18,07:00:00,15,14,1,ECO_300019380
642,Herenthoutsesteenweg 2,2022-02-18,08:00:00,58,56,2,ECO_300019380
642,Herenthoutsesteenweg 2,2022-02-18,09:00:00,222,221,1,ECO_300019380
642,Herenthoutsesteenweg 2,2022-02-18,10:00:00,52,51,1,ECO_300019380
642,Herenthoutsesteenweg 2,2022-02-18,11:00:00,37,35,2,ECO_300019380
642,Herenthoutsesteenweg 2,2022-02-18,12:00:00,23,21,2,ECO_300019380
642,Herenthoutsesteenweg 2,2022-02-18,13:00:00,36,33,3,ECO_300019380
642,Herenthoutsesteenweg 2,2022-02-18,14:00:00,32,28,4,ECO_300019380
642,Herenthoutsesteenweg 2,2022-02-18,15:00:00,14,13,1,ECO_300019380
642,Herenthoutsesteenweg 2,2022-02-18,16:00:00,11,10,1,ECO_300019380
642,Herenthoutsesteenweg 2,2022-02-18,17:00:00,11,9,2,ECO_300019380
642,Herenthoutsesteenweg 2,2022-02-18,18:00:00,7,7,0,ECO_300019380
642,Herenthoutsesteenweg 2,2022-02-18,19:00:00,11,10,1,ECO_300019380
642,Herenthoutsesteenweg 2,2022-02-18,20:00:00,12,11,1,ECO_300019380
642,Herenthoutsesteenweg 2,2022-02-18,21:00:00,6,6,0,ECO_300019380
642,Herenthoutsesteenweg 2,2022-02-18,22:00:00,4,3,1,ECO_300019380
642,Herenthoutsesteenweg 2,2022-02-18,23:00:00,3,3,0,ECO_300019380
642,Herenthoutsesteenweg 2,2022-02-19,00:00:00,2,1,1,ECO_300019380
642,Herenthoutsesteenweg 2,2022-02-19,01:00:00,1,1,0,ECO_300019380
642,Herenthoutsesteenweg 2,2022-02-19,02:00:00,2,2,0,ECO_300019380
642,Herenthoutsesteenweg 2,2022-02-19,03:00:00,1,1,0,ECO_300019380
642,Herenthoutsesteenweg 2,2022-02-19,04:00:00,2,2,0,ECO_300019380
642,Herenthoutsesteenweg 2,2022-02-19,05:00:00,0,0,0,ECO_300019380
642,Herenthoutsesteenweg 2,2022-02-19,06:00:00,3,2,1,ECO_300019380
642,Herenthoutsesteenweg 2,2022-02-19,07:00:00,2,2,0,ECO_300019380
642,Herenthoutsesteenweg 2,2022-02-19,08:00:00,4,4,0,ECO_300019380
642,Herenthoutsesteenweg 2,2022-02-19,09:00:00,21,18,3,ECO_300019380
642,Herenthoutsesteenweg 2,2022-02-19,10:00:00,54,50,4,ECO_300019380
642,Herenthoutsesteenweg 2,2022-02-19,11:00:00,63,60,3,ECO_300019380
642,Herenthoutsesteenweg 2,2022-02-19,12:00:00,85,80,5,ECO_300019380
642,Herenthoutsesteenweg 2,2022-02-19,13:00:00,58,53,5,ECO_300019380
642,Herenthoutsesteenweg 2,2022-02-19,14:00:00,65,61,4,ECO_300019380
642,Herenthoutsesteenweg 2,2022-02-19,15:00:00,70,64,6,ECO_300019380
642,Herenthoutsesteenweg 2,2022-02-19,16:00:00,55,48,7,ECO_300019380
642,Herenthoutsesteenweg 2,2022-02-19,17:00:00,49,43,6,ECO_300019380
642,Herenthoutsesteenweg 2,2022-02-19,18:00:00,17,16,1,ECO_300019380
642,Herenthoutsesteenweg 2,2022-02-19,19:00:00,16,16,0,ECO_300019380
642,Herenthoutsesteenweg 2,2022-02-19,20:00:00,12,12,0,ECO_300019380
642,Herenthoutsesteenweg 2,2022-02-19,21:00:00,13,11,2,ECO_300019380
642,Herenthoutsesteenweg 2,2022-02-19,22:00:00,8,6,2,ECO_300019380
642,Herenthoutsesteenweg 2,2022-02-19,23:00:00,6,0,6,ECO_300019380
642,Herenthoutsesteenweg 2,2022-02-20,00:00:00,2,0,2,ECO_300019380
642,Herenthoutsesteenweg 2,2022-02-20,01:00:00,0,0,0,ECO_300019380
642,Herenthoutsesteenweg 2,2022-02-20,02:00:00,5,5,0,ECO_300019380
642,Herenthoutsesteenweg 2,2022-02-20,03:00:00,2,2,0,ECO_300019380
642,Herenthoutsesteenweg 2,2022-02-20,04:00:00,6,5,1,ECO_300019380
642,Herenthoutsesteenweg 2,2022-02-20,05:00:00,0,0,0,ECO_300019380
642,Herenthoutsesteenweg 2,2022-02-20,06:00:00,1,1,0,ECO_300019380
642,Herenthoutsesteenweg 2,2022-02-20,07:00:00,2,1,1,ECO_300019380
642,Herenthoutsesteenweg 2,2022-02-20,08:00:00,5,5,0,ECO_300019380
642,Herenthoutsesteenweg 2,2022-02-20,09:00:00,7,7,0,ECO_300019380
642,Herenthoutsesteenweg 2,2022-02-20,10:00:00,25,25,0,ECO_300019380
642,Herenthoutsesteenweg 2,2022-02-20,11:00:00,22,20,2,ECO_300019380
642,Herenthoutsesteenweg 2,2022-02-20,12:00:00,14,14,0,ECO_300019380
642,Herenthoutsesteenweg 2,2022-02-20,13:00:00,7,2,5,ECO_300019380
642,Herenthoutsesteenweg 2,2022-02-20,14:00:00,15,14,1,ECO_300019380
642,Herenthoutsesteenweg 2,2022-02-20,15:00:00,5,5,0,ECO_300019380
642,Herenthoutsesteenweg 2,2022-02-20,16:00:00,4,3,1,ECO_300019380
642,Herenthoutsesteenweg 2,2022-02-20,17:00:00,2,1,1,ECO_300019380
642,Herenthoutsesteenweg 2,2022-02-20,18:00:00,2,2,0,ECO_300019380
642,Herenthoutsesteenweg 2,2022-02-20,19:00:00,5,4,1,ECO_300019380
642,Herenthoutsesteenweg 2,2022-02-20,20:00:00,2,2,0,ECO_300019380
642,Herenthoutsesteenweg 2,2022-02-20,21:00:00,2,2,0,ECO_300019380
642,Herenthoutsesteenweg 2,2022-02-20,22:00:00,3,3,0,ECO_300019380
642,Herenthoutsesteenweg 2,2022-02-20,23:00:00,2,1,1,ECO_300019380
642,Herenthoutsesteenweg 2,2022-02-21,00:00:00,0,0,0,ECO_300019380
642,Herenthoutsesteenweg 2,2022-02-21,01:00:00,0,0,0,ECO_300019380
642,Herenthoutsesteenweg 2,2022-02-21,02:00:00,0,0,0,ECO_300019380
642,Herenthoutsesteenweg 2,2022-02-21,03:00:00,0,0,0,ECO_300019380
642,Herenthoutsesteenweg 2,2022-02-21,04:00:00,0,0,0,ECO_300019380
642,Herenthoutsesteenweg 2,2022-02-21,05:00:00,4,4,0,ECO_300019380
642,Herenthoutsesteenweg 2,2022-02-21,06:00:00,13,10,3,ECO_300019380
642,Herenthoutsesteenweg 2,2022-02-21,07:00:00,20,18,2,ECO_300019380
642,Herenthoutsesteenweg 2,2022-02-21,08:00:00,77,77,0,ECO_300019380
642,Herenthoutsesteenweg 2,2022-02-21,09:00:00,344,335,9,ECO_300019380
642,Herenthoutsesteenweg 2,2022-02-21,10:00:00,33,33,0,ECO_300019380
642,Herenthoutsesteenweg 2,2022-02-21,11:00:00,22,20,2,ECO_300019380
642,Herenthoutsesteenweg 2,2022-02-21,12:00:00,12,9,3,ECO_300019380
642,Herenthoutsesteenweg 2,2022-02-21,13:00:00,22,20,2,ECO_300019380
642,Herenthoutsesteenweg 2,2022-02-21,14:00:00,14,13,1,ECO_300019380
642,Herenthoutsesteenweg 2,2022-02-21,15:00:00,14,13,1,ECO_300019380
642,Herenthoutsesteenweg 2,2022-02-21,16:00:00,43,35,8,ECO_300019380
642,Herenthoutsesteenweg 2,2022-02-21,17:00:00,51,47,4,ECO_300019380
642,Herenthoutsesteenweg 2,2022-02-21,18:00:00,32,26,6,ECO_300019380
642,Herenthoutsesteenweg 2,2022-02-21,19:00:00,15,13,2,ECO_300019380
642,Herenthoutsesteenweg 2,2022-02-21,20:00:00,15,12,3,ECO_300019380
642,Herenthoutsesteenweg 2,2022-02-21,21:00:00,12,9,3,ECO_300019380
642,Herenthoutsesteenweg 2,2022-02-21,22:00:00,4,3,1,ECO_300019380
642,Herenthoutsesteenweg 2,2022-02-21,23:00:00,9,9,0,ECO_300019380
642,Herenthoutsesteenweg 2,2022-02-22,00:00:00,3,2,1,ECO_300019380
642,Herenthoutsesteenweg 2,2022-02-22,01:00:00,1,0,1,ECO_300019380
642,Herenthoutsesteenweg 2,2022-02-22,02:00:00,1,0,1,ECO_300019380
642,Herenthoutsesteenweg 2,2022-02-22,03:00:00,1,1,0,ECO_300019380
642,Herenthoutsesteenweg 2,2022-02-22,04:00:00,0,0,0,ECO_300019380
642,Herenthoutsesteenweg 2,2022-02-22,05:00:00,5,5,0,ECO_300019380
642,Herenthoutsesteenweg 2,2022-02-22,06:00:00,12,11,1,ECO_300019380
642,Herenthoutsesteenweg 2,2022-02-22,07:00:00,26,24,2,ECO_300019380
642,Herenthoutsesteenweg 2,2022-02-22,08:00:00,122,120,2,ECO_300019380
642,Herenthoutsesteenweg 2,2022-02-22,09:00:00,417,415,2,ECO_300019380
642,Herenthoutsesteenweg 2,2022-02-22,10:00:00,70,69,1,ECO_300019380
642,Herenthoutsesteenweg 2,2022-02-22,11:00:00,39,35,4,ECO_300019380
642,Herenthoutsesteenweg 2,2022-02-22,12:00:00,28,26,2,ECO_300019380
642,Herenthoutsesteenweg 2,2022-02-22,13:00:00,25,23,2,ECO_300019380
642,Herenthoutsesteenweg 2,2022-02-22,14:00:00,37,33,4,ECO_300019380
642,Herenthoutsesteenweg 2,2022-02-22,15:00:00,28,27,1,ECO_300019380
642,Herenthoutsesteenweg 2,2022-02-22,16:00:00,69,60,9,ECO_300019380
642,Herenthoutsesteenweg 2,2022-02-22,17:00:00,65,57,8,ECO_300019380
642,Herenthoutsesteenweg 2,2022-02-22,18:00:00,45,40,5,ECO_300019380
642,Herenthoutsesteenweg 2,2022-02-22,19:00:00,27,21,6,ECO_300019380
642,Herenthoutsesteenweg 2,2022-02-22,20:00:00,10,8,2,ECO_300019380
642,Herenthoutsesteenweg 2,2022-02-22,21:00:00,8,8,0,ECO_300019380
642,Herenthoutsesteenweg 2,2022-02-22,22:00:00,9,7,2,ECO_300019380
642,Herenthoutsesteenweg 2,2022-02-22,23:00:00,15,14,1,ECO_300019380
642,Herenthoutsesteenweg 2,2022-02-23,00:00:00,2,1,1,ECO_300019380
642,Herenthoutsesteenweg 2,2022-02-23,01:00:00,0,0,0,ECO_300019380
642,Herenthoutsesteenweg 2,2022-02-23,02:00:00,0,0,0,ECO_300019380
642,Herenthoutsesteenweg 2,2022-02-23,03:00:00,0,0,0,ECO_300019380
642,Herenthoutsesteenweg 2,2022-02-23,04:00:00,1,1,0,ECO_300019380
642,Herenthoutsesteenweg 2,2022-02-23,05:00:00,2,2,0,ECO_300019380
642,Herenthoutsesteenweg 2,2022-02-23,06:00:00,12,12,0,ECO_300019380
642,Herenthoutsesteenweg 2,2022-02-23,07:00:00,33,29,4,ECO_300019380
642,Herenthoutsesteenweg 2,2022-02-23,08:00:00,121,120,1,ECO_300019380
642,Herenthoutsesteenweg 2,2022-02-23,09:00:00,377,373,4,ECO_300019380
642,Herenthoutsesteenweg 2,2022-02-23,10:00:00,65,61,4,ECO_300019380
642,Herenthoutsesteenweg 2,2022-02-23,11:00:00,56,56,0,ECO_300019380
642,Herenthoutsesteenweg 2,2022-02-23,12:00:00,71,67,4,ECO_300019380
642,Herenthoutsesteenweg 2,2022-02-23,13:00:00,142,132,10,ECO_300019380
642,Herenthoutsesteenweg 2,2022-02-23,14:00:00,129,121,8,ECO_300019380
642,Herenthoutsesteenweg 2,2022-02-23,15:00:00,126,120,6,ECO_300019380
642,Herenthoutsesteenweg 2,2022-02-23,16:00:00,89,72,17,ECO_300019380
642,Herenthoutsesteenweg 2,2022-02-23,17:00:00,122,109,13,ECO_300019380
642,Herenthoutsesteenweg 2,2022-02-23,18:00:00,64,48,16,ECO_300019380
642,Herenthoutsesteenweg 2,2022-02-23,19:00:00,53,41,12,ECO_300019380
642,Herenthoutsesteenweg 2,2022-02-23,20:00:00,24,19,5,ECO_300019380
642,Herenthoutsesteenweg 2,2022-02-23,21:00:00,17,16,1,ECO_300019380
642,Herenthoutsesteenweg 2,2022-02-23,22:00:00,8,7,1,ECO_300019380
642,Herenthoutsesteenweg 2,2022-02-23,23:00:00,15,12,3,ECO_300019380
642,Herenthoutsesteenweg 2,2022-02-24,00:00:00,5,5,0,ECO_300019380
642,Herenthoutsesteenweg 2,2022-02-24,01:00:00,2,2,0,ECO_300019380
642,Herenthoutsesteenweg 2,2022-02-24,02:00:00,1,1,0,ECO_300019380
642,Herenthoutsesteenweg 2,2022-02-24,03:00:00,0,0,0,ECO_300019380
642,Herenthoutsesteenweg 2,2022-02-24,04:00:00,0,0,0,ECO_300019380
642,Herenthoutsesteenweg 2,2022-02-24,05:00:00,1,1,0,ECO_300019380
642,Herenthoutsesteenweg 2,2022-02-24,06:00:00,10,10,0,ECO_300019380
642,Herenthoutsesteenweg 2,2022-02-24,07:00:00,32,29,3,ECO_300019380
642,Herenthoutsesteenweg 2,2022-02-24,08:00:00,138,137,1,ECO_300019380
642,Herenthoutsesteenweg 2,2022-02-24,09:00:00,434,432,2,ECO_300019380
642,Herenthoutsesteenweg 2,2022-02-24,10:00:00,75,71,4,ECO_300019380
642,Herenthoutsesteenweg 2,2022-02-24,11:00:00,41,35,6,ECO_300019380
642,Herenthoutsesteenweg 2,2022-02-24,12:00:00,38,36,2,ECO_300019380
642,Herenthoutsesteenweg 2,2022-02-24,13:00:00,35,30,5,ECO_300019380
642,Herenthoutsesteenweg 2,2022-02-24,14:00:00,45,40,5,ECO_300019380
642,Herenthoutsesteenweg 2,2022-02-24,15:00:00,21,20,1,ECO_300019380
642,Herenthoutsesteenweg 2,2022-02-24,16:00:00,44,39,5,ECO_300019380
642,Herenthoutsesteenweg 2,2022-02-24,17:00:00,59,50,9,ECO_300019380
642,Herenthoutsesteenweg 2,2022-02-24,18:00:00,36,33,3,ECO_300019380
642,Herenthoutsesteenweg 2,2022-02-24,19:00:00,18,15,3,ECO_300019380
642,Herenthoutsesteenweg 2,2022-02-24,20:00:00,14,13,1,ECO_300019380
642,Herenthoutsesteenweg 2,2022-02-24,21:00:00,6,6,0,ECO_300019380
642,Herenthoutsesteenweg 2,2022-02-24,22:00:00,6,5,1,ECO_300019380
642,Herenthoutsesteenweg 2,2022-02-24,23:00:00,12,12,0,ECO_300019380
642,Herenthoutsesteenweg 2,2022-02-25,00:00:00,2,1,1,ECO_300019380
642,Herenthoutsesteenweg 2,2022-02-25,01:00:00,0,0,0,ECO_300019380
642,Herenthoutsesteenweg 2,2022-02-25,02:00:00,1,0,1,ECO_300019380
642,Herenthoutsesteenweg 2,2022-02-25,03:00:00,0,0,0,ECO_300019380
642,Herenthoutsesteenweg 2,2022-02-25,04:00:00,2,1,1,ECO_300019380
642,Herenthoutsesteenweg 2,2022-02-25,05:00:00,2,2,0,ECO_300019380
642,Herenthoutsesteenweg 2,2022-02-25,06:00:00,11,10,1,ECO_300019380
642,Herenthoutsesteenweg 2,2022-02-25,07:00:00,25,23,2,ECO_300019380
642,Herenthoutsesteenweg 2,2022-02-25,08:00:00,104,101,3,ECO_300019380
642,Herenthoutsesteenweg 2,2022-02-25,09:00:00,390,384,6,ECO_300019380
642,Herenthoutsesteenweg 2,2022-02-25,10:00:00,56,53,3,ECO_300019380
642,Herenthoutsesteenweg 2,2022-02-25,11:00:00,37,33,4,ECO_300019380
642,Herenthoutsesteenweg 2,2022-02-25,12:00:00,41,39,2,ECO_300019380
642,Herenthoutsesteenweg 2,2022-02-25,13:00:00,40,39,1,ECO_300019380
642,Herenthoutsesteenweg 2,2022-02-25,14:00:00,33,30,3,ECO_300019380
642,Herenthoutsesteenweg 2,2022-02-25,15:00:00,44,42,2,ECO_300019380
642,Herenthoutsesteenweg 2,2022-02-25,16:00:00,56,47,9,ECO_300019380
642,Herenthoutsesteenweg 2,2022-02-25,17:00:00,68,62,6,ECO_300019380
642,Herenthoutsesteenweg 2,2022-02-25,18:00:00,46,41,5,ECO_300019380
642,Herenthoutsesteenweg 2,2022-02-25,19:00:00,24,20,4,ECO_300019380
642,Herenthoutsesteenweg 2,2022-02-25,20:00:00,39,38,1,ECO_300019380
642,Herenthoutsesteenweg 2,2022-02-25,21:00:00,14,11,3,ECO_300019380
642,Herenthoutsesteenweg 2,2022-02-25,22:00:00,14,12,2,ECO_300019380
642,Herenthoutsesteenweg 2,2022-02-25,23:00:00,11,9,2,ECO_300019380
642,Herenthoutsesteenweg 2,2022-02-26,00:00:00,5,2,3,ECO_300019380
642,Herenthoutsesteenweg 2,2022-02-26,01:00:00,3,2,1,ECO_300019380
642,Herenthoutsesteenweg 2,2022-02-26,02:00:00,4,4,0,ECO_300019380
642,Herenthoutsesteenweg 2,2022-02-26,03:00:00,4,3,1,ECO_300019380
642,Herenthoutsesteenweg 2,2022-02-26,04:00:00,5,5,0,ECO_300019380
642,Herenthoutsesteenweg 2,2022-02-26,05:00:00,0,0,0,ECO_300019380
642,Herenthoutsesteenweg 2,2022-02-26,06:00:00,4,4,0,ECO_300019380
642,Herenthoutsesteenweg 2,2022-02-26,07:00:00,3,3,0,ECO_300019380
642,Herenthoutsesteenweg 2,2022-02-26,08:00:00,11,11,0,ECO_300019380
642,Herenthoutsesteenweg 2,2022-02-26,09:00:00,34,30,4,ECO_300019380
642,Herenthoutsesteenweg 2,2022-02-26,10:00:00,50,46,4,ECO_300019380
642,Herenthoutsesteenweg 2,2022-02-26,11:00:00,61,55,6,ECO_300019380
642,Herenthoutsesteenweg 2,2022-02-26,12:00:00,56,51,5,ECO_300019380
642,Herenthoutsesteenweg 2,2022-02-26,13:00:00,82,76,6,ECO_300019380
642,Herenthoutsesteenweg 2,2022-02-26,14:00:00,98,85,13,ECO_300019380
642,Herenthoutsesteenweg 2,2022-02-26,15:00:00,135,129,6,ECO_300019380
642,Herenthoutsesteenweg 2,2022-02-26,16:00:00,82,73,9,ECO_300019380
642,Herenthoutsesteenweg 2,2022-02-26,17:00:00,60,50,10,ECO_300019380
642,Herenthoutsesteenweg 2,2022-02-26,18:00:00,62,57,5,ECO_300019380
642,Herenthoutsesteenweg 2,2022-02-26,19:00:00,39,39,0,ECO_300019380
642,Herenthoutsesteenweg 2,2022-02-26,20:00:00,28,25,3,ECO_300019380
642,Herenthoutsesteenweg 2,2022-02-26,21:00:00,19,17,2,ECO_300019380
642,Herenthoutsesteenweg 2,2022-02-26,22:00:00,9,8,1,ECO_300019380
642,Herenthoutsesteenweg 2,2022-02-26,23:00:00,3,2,1,ECO_300019380
642,Herenthoutsesteenweg 2,2022-02-27,00:00:00,14,11,3,ECO_300019380
642,Herenthoutsesteenweg 2,2022-02-27,01:00:00,6,4,2,ECO_300019380
642,Herenthoutsesteenweg 2,2022-02-27,02:00:00,11,9,2,ECO_300019380
642,Herenthoutsesteenweg 2,2022-02-27,03:00:00,1,1,0,ECO_300019380
642,Herenthoutsesteenweg 2,2022-02-27,04:00:00,3,1,2,ECO_300019380
642,Herenthoutsesteenweg 2,2022-02-27,05:00:00,1,1,0,ECO_300019380
642,Herenthoutsesteenweg 2,2022-02-27,06:00:00,0,0,0,ECO_300019380
642,Herenthoutsesteenweg 2,2022-02-27,07:00:00,4,4,0,ECO_300019380
642,Herenthoutsesteenweg 2,2022-02-27,08:00:00,13,12,1,ECO_300019380
642,Herenthoutsesteenweg 2,2022-02-27,09:00:00,44,38,6,ECO_300019380
642,Herenthoutsesteenweg 2,2022-02-27,10:00:00,81,66,15,ECO_300019380
642,Herenthoutsesteenweg 2,2022-02-27,11:00:00,96,89,7,ECO_300019380
642,Herenthoutsesteenweg 2,2022-02-27,12:00:00,73,62,11,ECO_300019380
642,Herenthoutsesteenweg 2,2022-02-27,13:00:00,67,55,12,ECO_300019380
642,Herenthoutsesteenweg 2,2022-02-27,14:00:00,102,95,7,ECO_300019380
642,Herenthoutsesteenweg 2,2022-02-27,15:00:00,77,68,9,ECO_300019380
642,Herenthoutsesteenweg 2,2022-02-27,16:00:00,82,68,14,ECO_300019380
642,Herenthoutsesteenweg 2,2022-02-27,17:00:00,68,51,17,ECO_300019380
642,Herenthoutsesteenweg 2,2022-02-27,18:00:00,44,38,6,ECO_300019380
642,Herenthoutsesteenweg 2,2022-02-27,19:00:00,30,28,2,ECO_300019380
642,Herenthoutsesteenweg 2,2022-02-27,20:00:00,10,9,1,ECO_300019380
642,Herenthoutsesteenweg 2,2022-02-27,21:00:00,17,16,1,ECO_300019380
642,Herenthoutsesteenweg 2,2022-02-27,22:00:00,3,3,0,ECO_300019380
642,Herenthoutsesteenweg 2,2022-02-27,23:00:00,1,1,0,ECO_300019380
642,Herenthoutsesteenweg 2,2022-02-28,00:00:00,2,1,1,ECO_300019380
642,Herenthoutsesteenweg 2,2022-02-28,01:00:00,1,1,0,ECO_300019380
642,Herenthoutsesteenweg 2,2022-02-28,02:00:00,0,0,0,ECO_300019380
642,Herenthoutsesteenweg 2,2022-02-28,03:00:00,0,0,0,ECO_300019380
642,Herenthoutsesteenweg 2,2022-02-28,04:00:00,0,0,0,ECO_300019380
642,Herenthoutsesteenweg 2,2022-02-28,05:00:00,2,2,0,ECO_300019380
642,Herenthoutsesteenweg 2,2022-02-28,06:00:00,10,8,2,ECO_300019380
642,Herenthoutsesteenweg 2,2022-02-28,07:00:00,36,34,2,ECO_300019380
642,Herenthoutsesteenweg 2,2022-02-28,08:00:00,62,59,3,ECO_300019380
642,Herenthoutsesteenweg 2,2022-02-28,09:00:00,58,58,0,ECO_300019380
642,Herenthoutsesteenweg 2,2022-02-28,10:00:00,30,28,2,ECO_300019380
642,Herenthoutsesteenweg 2,2022-02-28,11:00:00,49,43,6,ECO_300019380
642,Herenthoutsesteenweg 2,2022-02-28,12:00:00,54,49,5,ECO_300019380
642,Herenthoutsesteenweg 2,2022-02-28,13:00:00,79,75,4,ECO_300019380
642,Herenthoutsesteenweg 2,2022-02-28,14:00:00,117,113,4,ECO_300019380
642,Herenthoutsesteenweg 2,2022-02-28,15:00:00,147,135,12,ECO_300019380
642,Herenthoutsesteenweg 2,2022-02-28,16:00:00,89,75,14,ECO_300019380
642,Herenthoutsesteenweg 2,2022-02-28,17:00:00,103,97,6,ECO_300019380
642,Herenthoutsesteenweg 2,2022-02-28,18:00:00,67,52,15,ECO_300019380
642,Herenthoutsesteenweg 2,2022-02-28,19:00:00,42,35,7,ECO_300019380
642,Herenthoutsesteenweg 2,2022-02-28,20:00:00,27,26,1,ECO_300019380
642,Herenthoutsesteenweg 2,2022-02-28,21:00:00,23,16,7,ECO_300019380
642,Herenthoutsesteenweg 2,2022-02-28,22:00:00,7,5,2,ECO_300019380
642,Herenthoutsesteenweg 2,2022-02-28,23:00:00,13,11,2,ECO_300019380
642,Herenthoutsesteenweg 2,2022-03-01,00:00:00,4,3,1,ECO_300019380
642,Herenthoutsesteenweg 2,2022-03-01,01:00:00,1,1,0,ECO_300019380
642,Herenthoutsesteenweg 2,2022-03-01,02:00:00,0,0,0,ECO_300019380
642,Herenthoutsesteenweg 2,2022-03-01,03:00:00,0,0,0,ECO_300019380
642,Herenthoutsesteenweg 2,2022-03-01,04:00:00,0,0,0,ECO_300019380
642,Herenthoutsesteenweg 2,2022-03-01,05:00:00,4,4,0,ECO_300019380
642,Herenthoutsesteenweg 2,2022-03-01,06:00:00,11,10,1,ECO_300019380
642,Herenthoutsesteenweg 2,2022-03-01,07:00:00,36,34,2,ECO_300019380
642,Herenthoutsesteenweg 2,2022-03-01,08:00:00,78,77,1,ECO_300019380
642,Herenthoutsesteenweg 2,2022-03-01,09:00:00,43,41,2,ECO_300019380
642,Herenthoutsesteenweg 2,2022-03-01,10:00:00,34,33,1,ECO_300019380
642,Herenthoutsesteenweg 2,2022-03-01,11:00:00,48,45,3,ECO_300019380
642,Herenthoutsesteenweg 2,2022-03-01,12:00:00,55,53,2,ECO_300019380
642,Herenthoutsesteenweg 2,2022-03-01,13:00:00,58,51,7,ECO_300019380
642,Herenthoutsesteenweg 2,2022-03-01,14:00:00,85,80,5,ECO_300019380
642,Herenthoutsesteenweg 2,2022-03-01,15:00:00,62,56,6,ECO_300019380
642,Herenthoutsesteenweg 2,2022-03-01,16:00:00,67,62,5,ECO_300019380
642,Herenthoutsesteenweg 2,2022-03-01,17:00:00,85,79,6,ECO_300019380
642,Herenthoutsesteenweg 2,2022-03-01,18:00:00,60,51,9,ECO_300019380
642,Herenthoutsesteenweg 2,2022-03-01,19:00:00,30,26,4,ECO_300019380
642,Herenthoutsesteenweg 2,2022-03-01,20:00:00,13,11,2,ECO_300019380
642,Herenthoutsesteenweg 2,2022-03-01,21:00:00,16,9,7,ECO_300019380
642,Herenthoutsesteenweg 2,2022-03-01,22:00:00,9,8,1,ECO_300019380
642,Herenthoutsesteenweg 2,2022-03-01,23:00:00,10,10,0,ECO_300019380
642,Herenthoutsesteenweg 2,2022-03-02,00:00:00,2,1,1,ECO_300019380
642,Herenthoutsesteenweg 2,2022-03-02,01:00:00,1,0,1,ECO_300019380
642,Herenthoutsesteenweg 2,2022-03-02,02:00:00,1,1,0,ECO_300019380
642,Herenthoutsesteenweg 2,2022-03-02,03:00:00,0,0,0,ECO_300019380
642,Herenthoutsesteenweg 2,2022-03-02,04:00:00,0,0,0,ECO_300019380
642,Herenthoutsesteenweg 2,2022-03-02,05:00:00,2,2,0,ECO_300019380
642,Herenthoutsesteenweg 2,2022-03-02,06:00:00,16,14,2,ECO_300019380
642,Herenthoutsesteenweg 2,2022-03-02,07:00:00,27,23,4,ECO_300019380
642,Herenthoutsesteenweg 2,2022-03-02,08:00:00,73,70,3,ECO_300019380
642,Herenthoutsesteenweg 2,2022-03-02,09:00:00,57,54,3,ECO_300019380
642,Herenthoutsesteenweg 2,2022-03-02,10:00:00,51,50,1,ECO_300019380
642,Herenthoutsesteenweg 2,2022-03-02,11:00:00,63,60,3,ECO_300019380
642,Herenthoutsesteenweg 2,2022-03-02,12:00:00,59,52,7,ECO_300019380
642,Herenthoutsesteenweg 2,2022-03-02,13:00:00,66,62,4,ECO_300019380
642,Herenthoutsesteenweg 2,2022-03-02,14:00:00,128,125,3,ECO_300019380
642,Herenthoutsesteenweg 2,2022-03-02,15:00:00,132,122,10,ECO_300019380
642,Herenthoutsesteenweg 2,2022-03-02,16:00:00,79,71,8,ECO_300019380
642,Herenthoutsesteenweg 2,2022-03-02,17:00:00,73,68,5,ECO_300019380
642,Herenthoutsesteenweg 2,2022-03-02,18:00:00,57,45,12,ECO_300019380
642,Herenthoutsesteenweg 2,2022-03-02,19:00:00,36,27,9,ECO_300019380
642,Herenthoutsesteenweg 2,2022-03-02,20:00:00,18,14,4,ECO_300019380
642,Herenthoutsesteenweg 2,2022-03-02,21:00:00,19,16,3,ECO_300019380
642,Herenthoutsesteenweg 2,2022-03-02,22:00:00,18,15,3,ECO_300019380
642,Herenthoutsesteenweg 2,2022-03-02,23:00:00,11,8,3,ECO_300019380
642,Herenthoutsesteenweg 2,2022-03-03,00:00:00,8,7,1,ECO_300019380
642,Herenthoutsesteenweg 2,2022-03-03,01:00:00,1,1,0,ECO_300019380
642,Herenthoutsesteenweg 2,2022-03-03,02:00:00,5,4,1,ECO_300019380
642,Herenthoutsesteenweg 2,2022-03-03,03:00:00,1,0,1,ECO_300019380
642,Herenthoutsesteenweg 2,2022-03-03,04:00:00,0,0,0,ECO_300019380
642,Herenthoutsesteenweg 2,2022-03-03,05:00:00,6,6,0,ECO_300019380
642,Herenthoutsesteenweg 2,2022-03-03,06:00:00,13,10,3,ECO_300019380
642,Herenthoutsesteenweg 2,2022-03-03,07:00:00,34,33,1,ECO_300019380
642,Herenthoutsesteenweg 2,2022-03-03,08:00:00,83,79,4,ECO_300019380
642,Herenthoutsesteenweg 2,2022-03-03,09:00:00,51,50,1,ECO_300019380
642,Herenthoutsesteenweg 2,2022-03-03,10:00:00,57,57,0,ECO_300019380
642,Herenthoutsesteenweg 2,2022-03-03,11:00:00,56,54,2,ECO_300019380
642,Herenthoutsesteenweg 2,2022-03-03,12:00:00,54,46,8,ECO_300019380
642,Herenthoutsesteenweg 2,2022-03-03,13:00:00,72,69,3,ECO_300019380
642,Herenthoutsesteenweg 2,2022-03-03,14:00:00,146,136,10,ECO_300019380
642,Herenthoutsesteenweg 2,2022-03-03,15:00:00,129,119,10,ECO_300019380
642,Herenthoutsesteenweg 2,2022-03-03,16:00:00,80,65,15,ECO_300019380
642,Herenthoutsesteenweg 2,2022-03-03,17:00:00,99,82,17,ECO_300019380
642,Herenthoutsesteenweg 2,2022-03-03,18:00:00,71,61,10,ECO_300019380
642,Herenthoutsesteenweg 2,2022-03-03,19:00:00,26,22,4,ECO_300019380
642,Herenthoutsesteenweg 2,2022-03-03,20:00:00,19,16,3,ECO_300019380
642,Herenthoutsesteenweg 2,2022-03-03,21:00:00,18,16,2,ECO_300019380
642,Herenthoutsesteenweg 2,2022-03-03,22:00:00,14,14,0,ECO_300019380
642,Herenthoutsesteenweg 2,2022-03-03,23:00:00,13,11,2,ECO_300019380
642,Herenthoutsesteenweg 2,2022-03-04,00:00:00,2,2,0,ECO_300019380
642,Herenthoutsesteenweg 2,2022-03-04,01:00:00,0,0,0,ECO_300019380
642,Herenthoutsesteenweg 2,2022-03-04,02:00:00,0,0,0,ECO_300019380
642,Herenthoutsesteenweg 2,2022-03-04,03:00:00,0,0,0,ECO_300019380
642,Herenthoutsesteenweg 2,2022-03-04,04:00:00,0,0,0,ECO_300019380
642,Herenthoutsesteenweg 2,2022-03-04,05:00:00,4,4,0,ECO_300019380
642,Herenthoutsesteenweg 2,2022-03-04,06:00:00,11,11,0,ECO_300019380
642,Herenthoutsesteenweg 2,2022-03-04,07:00:00,24,22,2,ECO_300019380
642,Herenthoutsesteenweg 2,2022-03-04,08:00:00,65,60,5,ECO_300019380
642,Herenthoutsesteenweg 2,2022-03-04,09:00:00,69,69,0,ECO_300019380
642,Herenthoutsesteenweg 2,2022-03-04,10:00:00,77,76,1,ECO_300019380
642,Herenthoutsesteenweg 2,2022-03-04,11:00:00,102,100,2,ECO_300019380
642,Herenthoutsesteenweg 2,2022-03-04,12:00:00,69,64,5,ECO_300019380
642,Herenthoutsesteenweg 2,2022-03-04,13:00:00,71,64,7,ECO_300019380
642,Herenthoutsesteenweg 2,2022-03-04,14:00:00,102,99,3,ECO_300019380
642,Herenthoutsesteenweg 2,2022-03-04,15:00:00,149,142,7,ECO_300019380
642,Herenthoutsesteenweg 2,2022-03-04,16:00:00,102,85,17,ECO_300019380
642,Herenthoutsesteenweg 2,2022-03-04,17:00:00,118,106,12,ECO_300019380
642,Herenthoutsesteenweg 2,2022-03-04,18:00:00,67,59,8,ECO_300019380
642,Herenthoutsesteenweg 2,2022-03-04,19:00:00,42,34,8,ECO_300019380
642,Herenthoutsesteenweg 2,2022-03-04,20:00:00,31,26,5,ECO_300019380
642,Herenthoutsesteenweg 2,2022-03-04,21:00:00,21,16,5,ECO_300019380
642,Herenthoutsesteenweg 2,2022-03-04,22:00:00,14,14,0,ECO_300019380
642,Herenthoutsesteenweg 2,2022-03-04,23:00:00,15,14,1,ECO_300019380
642,Herenthoutsesteenweg 2,2022-03-05,00:00:00,8,7,1,ECO_300019380
642,Herenthoutsesteenweg 2,2022-03-05,01:00:00,3,1,2,ECO_300019380
642,Herenthoutsesteenweg 2,2022-03-05,02:00:00,4,3,1,ECO_300019380
642,Herenthoutsesteenweg 2,2022-03-05,03:00:00,0,0,0,ECO_300019380
642,Herenthoutsesteenweg 2,2022-03-05,04:00:00,3,3,0,ECO_300019380
642,Herenthoutsesteenweg 2,2022-03-05,05:00:00,4,3,1,ECO_300019380
642,Herenthoutsesteenweg 2,2022-03-05,06:00:00,1,1,0,ECO_300019380
642,Herenthoutsesteenweg 2,2022-03-05,07:00:00,12,10,2,ECO_300019380
642,Herenthoutsesteenweg 2,2022-03-05,08:00:00,9,9,0,ECO_300019380
642,Herenthoutsesteenweg 2,2022-03-05,09:00:00,28,26,2,ECO_300019380
642,Herenthoutsesteenweg 2,2022-03-05,10:00:00,58,52,6,ECO_300019380
642,Herenthoutsesteenweg 2,2022-03-05,11:00:00,75,73,2,ECO_300019380
642,Herenthoutsesteenweg 2,2022-03-05,12:00:00,89,76,13,ECO_300019380
642,Herenthoutsesteenweg 2,2022-03-05,13:00:00,117,99,18,ECO_300019380
642,Herenthoutsesteenweg 2,2022-03-05,14:00:00,203,184,19,ECO_300019380
642,Herenthoutsesteenweg 2,2022-03-05,15:00:00,130,108,22,ECO_300019380
642,Herenthoutsesteenweg 2,2022-03-05,16:00:00,103,73,30,ECO_300019380
642,Herenthoutsesteenweg 2,2022-03-05,17:00:00,74,61,13,ECO_300019380
642,Herenthoutsesteenweg 2,2022-03-05,18:00:00,65,57,8,ECO_300019380
642,Herenthoutsesteenweg 2,2022-03-05,19:00:00,21,19,2,ECO_300019380
642,Herenthoutsesteenweg 2,2022-03-05,20:00:00,25,23,2,ECO_300019380
642,Herenthoutsesteenweg 2,2022-03-05,21:00:00,31,26,5,ECO_300019380
642,Herenthoutsesteenweg 2,2022-03-05,22:00:00,18,17,1,ECO_300019380
642,Herenthoutsesteenweg 2,2022-03-05,23:00:00,18,18,0,ECO_300019380
642,Herenthoutsesteenweg 2,2022-03-06,00:00:00,9,5,4,ECO_300019380
642,Herenthoutsesteenweg 2,2022-03-06,01:00:00,4,3,1,ECO_300019380
642,Herenthoutsesteenweg 2,2022-03-06,02:00:00,10,6,4,ECO_300019380
642,Herenthoutsesteenweg 2,2022-03-06,03:00:00,5,2,3,ECO_300019380
642,Herenthoutsesteenweg 2,2022-03-06,04:00:00,5,2,3,ECO_300019380
642,Herenthoutsesteenweg 2,2022-03-06,05:00:00,3,0,3,ECO_300019380
642,Herenthoutsesteenweg 2,2022-03-06,06:00:00,1,1,0,ECO_300019380
642,Herenthoutsesteenweg 2,2022-03-06,07:00:00,8,8,0,ECO_300019380
642,Herenthoutsesteenweg 2,2022-03-06,08:00:00,12,12,0,ECO_300019380
642,Herenthoutsesteenweg 2,2022-03-06,09:00:00,53,52,1,ECO_300019380
642,Herenthoutsesteenweg 2,2022-03-06,10:00:00,69,67,2,ECO_300019380
642,Herenthoutsesteenweg 2,2022-03-06,11:00:00,87,78,9,ECO_300019380
642,Herenthoutsesteenweg 2,2022-03-06,12:00:00,78,66,12,ECO_300019380
642,Herenthoutsesteenweg 2,2022-03-06,13:00:00,50,36,14,ECO_300019380
642,Herenthoutsesteenweg 2,2022-03-06,14:00:00,64,57,7,ECO_300019380
642,Herenthoutsesteenweg 2,2022-03-06,15:00:00,54,49,5,ECO_300019380
642,Herenthoutsesteenweg 2,2022-03-06,16:00:00,48,33,15,ECO_300019380
642,Herenthoutsesteenweg 2,2022-03-06,17:00:00,51,42,9,ECO_300019380
642,Herenthoutsesteenweg 2,2022-03-06,18:00:00,27,23,4,ECO_300019380
642,Herenthoutsesteenweg 2,2022-03-06,19:00:00,24,22,2,ECO_300019380
642,Herenthoutsesteenweg 2,2022-03-06,20:00:00,16,14,2,ECO_300019380
642,Herenthoutsesteenweg 2,2022-03-06,21:00:00,10,7,3,ECO_300019380
642,Herenthoutsesteenweg 2,2022-03-06,22:00:00,5,4,1,ECO_300019380
642,Herenthoutsesteenweg 2,2022-03-06,23:00:00,2,2,0,ECO_300019380
642,Herenthoutsesteenweg 2,2022-03-07,00:00:00,2,1,1,ECO_300019380
642,Herenthoutsesteenweg 2,2022-03-07,01:00:00,0,0,0,ECO_300019380
642,Herenthoutsesteenweg 2,2022-03-07,02:00:00,0,0,0,ECO_300019380
642,Herenthoutsesteenweg 2,2022-03-07,03:00:00,0,0,0,ECO_300019380
642,Herenthoutsesteenweg 2,2022-03-07,04:00:00,0,0,0,ECO_300019380
642,Herenthoutsesteenweg 2,2022-03-07,05:00:00,2,2,0,ECO_300019380
642,Herenthoutsesteenweg 2,2022-03-07,06:00:00,19,17,2,ECO_300019380
642,Herenthoutsesteenweg 2,2022-03-07,07:00:00,36,34,2,ECO_300019380
642,Herenthoutsesteenweg 2,2022-03-07,08:00:00,149,148,1,ECO_300019380
642,Herenthoutsesteenweg 2,2022-03-07,09:00:00,488,471,17,ECO_300019380
642,Herenthoutsesteenweg 2,2022-03-07,10:00:00,81,80,1,ECO_300019380
642,Herenthoutsesteenweg 2,2022-03-07,11:00:00,55,53,2,ECO_300019380
642,Herenthoutsesteenweg 2,2022-03-07,12:00:00,48,44,4,ECO_300019380
642,Herenthoutsesteenweg 2,2022-03-07,13:00:00,51,48,3,ECO_300019380
642,Herenthoutsesteenweg 2,2022-03-07,14:00:00,62,59,3,ECO_300019380
642,Herenthoutsesteenweg 2,2022-03-07,15:00:00,50,46,4,ECO_300019380
642,Herenthoutsesteenweg 2,2022-03-07,16:00:00,89,84,5,ECO_300019380
642,Herenthoutsesteenweg 2,2022-03-07,17:00:00,96,78,18,ECO_300019380
642,Herenthoutsesteenweg 2,2022-03-07,18:00:00,74,72,2,ECO_300019380
642,Herenthoutsesteenweg 2,2022-03-07,19:00:00,27,21,6,ECO_300019380
642,Herenthoutsesteenweg 2,2022-03-07,20:00:00,32,26,6,ECO_300019380
642,Herenthoutsesteenweg 2,2022-03-07,21:00:00,12,10,2,ECO_300019380
642,Herenthoutsesteenweg 2,2022-03-07,22:00:00,9,6,3,ECO_300019380
642,Herenthoutsesteenweg 2,2022-03-07,23:00:00,14,12,2,ECO_300019380
642,Herenthoutsesteenweg 2,2022-03-08,00:00:00,2,1,1,ECO_300019380
642,Herenthoutsesteenweg 2,2022-03-08,01:00:00,0,0,0,ECO_300019380
642,Herenthoutsesteenweg 2,2022-03-08,02:00:00,1,0,1,ECO_300019380
642,Herenthoutsesteenweg 2,2022-03-08,03:00:00,0,0,0,ECO_300019380
642,Herenthoutsesteenweg 2,2022-03-08,04:00:00,1,1,0,ECO_300019380
642,Herenthoutsesteenweg 2,2022-03-08,05:00:00,3,3,0,ECO_300019380
642,Herenthoutsesteenweg 2,2022-03-08,06:00:00,20,18,2,ECO_300019380
642,Herenthoutsesteenweg 2,2022-03-08,07:00:00,43,39,4,ECO_300019380
642,Herenthoutsesteenweg 2,2022-03-08,08:00:00,172,166,6,ECO_300019380
642,Herenthoutsesteenweg 2,2022-03-08,09:00:00,498,496,2,ECO_300019380
642,Herenthoutsesteenweg 2,2022-03-08,10:00:00,104,103,1,ECO_300019380
642,Herenthoutsesteenweg 2,2022-03-08,11:00:00,54,51,3,ECO_300019380
642,Herenthoutsesteenweg 2,2022-03-08,12:00:00,48,42,6,ECO_300019380
642,Herenthoutsesteenweg 2,2022-03-08,13:00:00,71,67,4,ECO_300019380
642,Herenthoutsesteenweg 2,2022-03-08,14:00:00,93,83,10,ECO_300019380
642,Herenthoutsesteenweg 2,2022-03-08,15:00:00,88,82,6,ECO_300019380
642,Herenthoutsesteenweg 2,2022-03-08,16:00:00,106,95,11,ECO_300019380
642,Herenthoutsesteenweg 2,2022-03-08,17:00:00,113,105,8,ECO_300019380
642,Herenthoutsesteenweg 2,2022-03-08,18:00:00,69,61,8,ECO_300019380
642,Herenthoutsesteenweg 2,2022-03-08,19:00:00,36,33,3,ECO_300019380
642,Herenthoutsesteenweg 2,2022-03-08,20:00:00,22,13,9,ECO_300019380
642,Herenthoutsesteenweg 2,2022-03-08,21:00:00,19,16,3,ECO_300019380
642,Herenthoutsesteenweg 2,2022-03-08,22:00:00,9,8,1,ECO_300019380
642,Herenthoutsesteenweg 2,2022-03-08,23:00:00,18,15,3,ECO_300019380
642,Herenthoutsesteenweg 2,2022-03-09,00:00:00,0,0,0,ECO_300019380
642,Herenthoutsesteenweg 2,2022-03-09,01:00:00,1,1,0,ECO_300019380
642,Herenthoutsesteenweg 2,2022-03-09,02:00:00,0,0,0,ECO_300019380
642,Herenthoutsesteenweg 2,2022-03-09,03:00:00,2,1,1,ECO_300019380
642,Herenthoutsesteenweg 2,2022-03-09,04:00:00,0,0,0,ECO_300019380
642,Herenthoutsesteenweg 2,2022-03-09,05:00:00,2,2,0,ECO_300019380
642,Herenthoutsesteenweg 2,2022-03-09,06:00:00,21,20,1,ECO_300019380
642,Herenthoutsesteenweg 2,2022-03-09,07:00:00,39,38,1,ECO_300019380
642,Herenthoutsesteenweg 2,2022-03-09,08:00:00,164,158,6,ECO_300019380
642,Herenthoutsesteenweg 2,2022-03-09,09:00:00,489,484,5,ECO_300019380
642,Herenthoutsesteenweg 2,2022-03-09,10:00:00,74,71,3,ECO_300019380
642,Herenthoutsesteenweg 2,2022-03-09,11:00:00,50,47,3,ECO_300019380
642,Herenthoutsesteenweg 2,2022-03-09,12:00:00,50,47,3,ECO_300019380
642,Herenthoutsesteenweg 2,2022-03-09,13:00:00,133,117,16,ECO_300019380
642,Herenthoutsesteenweg 2,2022-03-09,14:00:00,158,148,10,ECO_300019380
642,Herenthoutsesteenweg 2,2022-03-09,15:00:00,145,133,12,ECO_300019380
642,Herenthoutsesteenweg 2,2022-03-09,16:00:00,135,113,22,ECO_300019380
642,Herenthoutsesteenweg 2,2022-03-09,17:00:00,137,116,21,ECO_300019380
642,Herenthoutsesteenweg 2,2022-03-09,18:00:00,120,102,18,ECO_300019380
642,Herenthoutsesteenweg 2,2022-03-09,19:00:00,52,45,7,ECO_300019380
642,Herenthoutsesteenweg 2,2022-03-09,20:00:00,21,18,3,ECO_300019380
642,Herenthoutsesteenweg 2,2022-03-09,21:00:00,15,12,3,ECO_300019380
642,Herenthoutsesteenweg 2,2022-03-09,22:00:00,11,9,2,ECO_300019380
642,Herenthoutsesteenweg 2,2022-03-09,23:00:00,15,13,2,ECO_300019380
642,Herenthoutsesteenweg 2,2022-03-10,00:00:00,7,5,2,ECO_300019380
642,Herenthoutsesteenweg 2,2022-03-10,01:00:00,1,0,1,ECO_300019380
642,Herenthoutsesteenweg 2,2022-03-10,02:00:00,4,3,1,ECO_300019380
642,Herenthoutsesteenweg 2,2022-03-10,03:00:00,2,2,0,ECO_300019380
642,Herenthoutsesteenweg 2,2022-03-10,04:00:00,0,0,0,ECO_300019380
642,Herenthoutsesteenweg 2,2022-03-10,05:00:00,1,1,0,ECO_300019380
642,Herenthoutsesteenweg 2,2022-03-10,06:00:00,18,16,2,ECO_300019380
642,Herenthoutsesteenweg 2,2022-03-10,07:00:00,46,42,4,ECO_300019380
642,Herenthoutsesteenweg 2,2022-03-10,08:00:00,156,153,3,ECO_300019380
642,Herenthoutsesteenweg 2,2022-03-10,09:00:00,499,493,6,ECO_300019380
642,Herenthoutsesteenweg 2,2022-03-10,10:00:00,110,107,3,ECO_300019380
642,Herenthoutsesteenweg 2,2022-03-10,11:00:00,70,63,7,ECO_300019380
642,Herenthoutsesteenweg 2,2022-03-10,12:00:00,68,67,1,ECO_300019380
642,Herenthoutsesteenweg 2,2022-03-10,13:00:00,70,62,8,ECO_300019380
642,Herenthoutsesteenweg 2,2022-03-10,14:00:00,123,116,7,ECO_300019380
642,Herenthoutsesteenweg 2,2022-03-10,15:00:00,107,97,10,ECO_300019380
642,Herenthoutsesteenweg 2,2022-03-10,16:00:00,148,130,18,ECO_300019380
642,Herenthoutsesteenweg 2,2022-03-10,17:00:00,123,109,14,ECO_300019380
642,Herenthoutsesteenweg 2,2022-03-10,18:00:00,85,69,16,ECO_300019380
642,Herenthoutsesteenweg 2,2022-03-10,19:00:00,65,58,7,ECO_300019380
642,Herenthoutsesteenweg 2,2022-03-10,20:00:00,26,21,5,ECO_300019380
642,Herenthoutsesteenweg 2,2022-03-10,21:00:00,16,14,2,ECO_300019380
642,Herenthoutsesteenweg 2,2022-03-10,22:00:00,11,9,2,ECO_300019380
642,Herenthoutsesteenweg 2,2022-03-10,23:00:00,15,12,3,ECO_300019380
642,Herenthoutsesteenweg 2,2022-03-11,00:00:00,3,3,0,ECO_300019380
642,Herenthoutsesteenweg 2,2022-03-11,01:00:00,2,2,0,ECO_300019380
642,Herenthoutsesteenweg 2,2022-03-11,02:00:00,1,0,1,ECO_300019380
642,Herenthoutsesteenweg 2,2022-03-11,03:00:00,0,0,0,ECO_300019380
642,Herenthoutsesteenweg 2,2022-03-11,04:00:00,1,1,0,ECO_300019380
642,Herenthoutsesteenweg 2,2022-03-11,05:00:00,0,0,0,ECO_300019380
642,Herenthoutsesteenweg 2,2022-03-11,06:00:00,18,18,0,ECO_300019380
642,Herenthoutsesteenweg 2,2022-03-11,07:00:00,39,34,5,ECO_300019380
642,Herenthoutsesteenweg 2,2022-03-11,08:00:00,124,117,7,ECO_300019380
642,Herenthoutsesteenweg 2,2022-03-11,09:00:00,527,511,16,ECO_300019380
642,Herenthoutsesteenweg 2,2022-03-11,10:00:00,121,116,5,ECO_300019380
642,Herenthoutsesteenweg 2,2022-03-11,11:00:00,104,100,4,ECO_300019380
642,Herenthoutsesteenweg 2,2022-03-11,12:00:00,70,67,3,ECO_300019380
642,Herenthoutsesteenweg 2,2022-03-11,13:00:00,87,79,8,ECO_300019380
642,Herenthoutsesteenweg 2,2022-03-11,14:00:00,107,99,8,ECO_300019380
642,Herenthoutsesteenweg 2,2022-03-11,15:00:00,114,108,6,ECO_300019380
642,Herenthoutsesteenweg 2,2022-03-11,16:00:00,154,140,14,ECO_300019380
642,Herenthoutsesteenweg 2,2022-03-11,17:00:00,134,114,20,ECO_300019380
642,Herenthoutsesteenweg 2,2022-03-11,18:00:00,79,69,10,ECO_300019380
642,Herenthoutsesteenweg 2,2022-03-11,19:00:00,50,44,6,ECO_300019380
642,Herenthoutsesteenweg 2,2022-03-11,20:00:00,35,31,4,ECO_300019380
642,Herenthoutsesteenweg 2,2022-03-11,21:00:00,28,25,3,ECO_300019380
642,Herenthoutsesteenweg 2,2022-03-11,22:00:00,20,19,1,ECO_300019380
642,Herenthoutsesteenweg 2,2022-03-11,23:00:00,14,13,1,ECO_300019380
642,Herenthoutsesteenweg 2,2022-03-12,00:00:00,7,6,1,ECO_300019380
642,Herenthoutsesteenweg 2,2022-03-12,01:00:00,2,1,1,ECO_300019380
642,Herenthoutsesteenweg 2,2022-03-12,02:00:00,3,2,1,ECO_300019380
642,Herenthoutsesteenweg 2,2022-03-12,03:00:00,4,2,2,ECO_300019380
642,Herenthoutsesteenweg 2,2022-03-12,04:00:00,1,1,0,ECO_300019380
642,Herenthoutsesteenweg 2,2022-03-12,05:00:00,4,4,0,ECO_300019380
642,Herenthoutsesteenweg 2,2022-03-12,06:00:00,3,3,0,ECO_300019380
642,Herenthoutsesteenweg 2,2022-03-12,07:00:00,10,8,2,ECO_300019380
642,Herenthoutsesteenweg 2,2022-03-12,08:00:00,15,13,2,ECO_300019380
642,Herenthoutsesteenweg 2,2022-03-12,09:00:00,47,43,4,ECO_300019380
642,Herenthoutsesteenweg 2,2022-03-12,10:00:00,57,54,3,ECO_300019380
642,Herenthoutsesteenweg 2,2022-03-12,11:00:00,78,69,9,ECO_300019380
642,Herenthoutsesteenweg 2,2022-03-12,12:00:00,99,93,6,ECO_300019380
642,Herenthoutsesteenweg 2,2022-03-12,13:00:00,80,69,11,ECO_300019380
642,Herenthoutsesteenweg 2,2022-03-12,14:00:00,102,96,6,ECO_300019380
642,Herenthoutsesteenweg 2,2022-03-12,15:00:00,119,111,8,ECO_300019380
642,Herenthoutsesteenweg 2,2022-03-12,16:00:00,105,90,15,ECO_300019380
642,Herenthoutsesteenweg 2,2022-03-12,17:00:00,62,57,5,ECO_300019380
642,Herenthoutsesteenweg 2,2022-03-12,18:00:00,58,53,5,ECO_300019380
642,Herenthoutsesteenweg 2,2022-03-12,19:00:00,29,25,4,ECO_300019380
642,Herenthoutsesteenweg 2,2022-03-12,20:00:00,28,27,1,ECO_300019380
642,Herenthoutsesteenweg 2,2022-03-12,21:00:00,20,18,2,ECO_300019380
642,Herenthoutsesteenweg 2,2022-03-12,22:00:00,13,12,1,ECO_300019380
642,Herenthoutsesteenweg 2,2022-03-12,23:00:00,5,3,2,ECO_300019380
642,Herenthoutsesteenweg 2,2022-03-13,00:00:00,3,3,0,ECO_300019380
642,Herenthoutsesteenweg 2,2022-03-13,01:00:00,16,13,3,ECO_300019380
642,Herenthoutsesteenweg 2,2022-03-13,02:00:00,3,2,1,ECO_300019380
642,Herenthoutsesteenweg 2,2022-03-13,03:00:00,3,3,0,ECO_300019380
642,Herenthoutsesteenweg 2,2022-03-13,04:00:00,5,0,5,ECO_300019380
642,Herenthoutsesteenweg 2,2022-03-13,05:00:00,0,0,0,ECO_300019380
642,Herenthoutsesteenweg 2,2022-03-13,06:00:00,2,2,0,ECO_300019380
642,Herenthoutsesteenweg 2,2022-03-13,07:00:00,4,4,0,ECO_300019380
642,Herenthoutsesteenweg 2,2022-03-13,08:00:00,16,16,0,ECO_300019380
642,Herenthoutsesteenweg 2,2022-03-13,09:00:00,66,57,9,ECO_300019380
642,Herenthoutsesteenweg 2,2022-03-13,10:00:00,104,93,11,ECO_300019380
642,Herenthoutsesteenweg 2,2022-03-13,11:00:00,148,130,18,ECO_300019380
642,Herenthoutsesteenweg 2,2022-03-13,12:00:00,108,82,26,ECO_300019380
642,Herenthoutsesteenweg 2,2022-03-13,13:00:00,72,65,7,ECO_300019380
642,Herenthoutsesteenweg 2,2022-03-13,14:00:00,125,115,10,ECO_300019380
642,Herenthoutsesteenweg 2,2022-03-13,15:00:00,151,129,22,ECO_300019380
642,Herenthoutsesteenweg 2,2022-03-13,16:00:00,93,87,6,ECO_300019380
642,Herenthoutsesteenweg 2,2022-03-13,17:00:00,66,61,5,ECO_300019380
642,Herenthoutsesteenweg 2,2022-03-13,18:00:00,43,27,16,ECO_300019380
642,Herenthoutsesteenweg 2,2022-03-13,19:00:00,30,30,0,ECO_300019380
642,Herenthoutsesteenweg 2,2022-03-13,20:00:00,20,15,5,ECO_300019380
642,Herenthoutsesteenweg 2,2022-03-13,21:00:00,7,6,1,ECO_300019380
642,Herenthoutsesteenweg 2,2022-03-13,22:00:00,13,9,4,ECO_300019380
642,Herenthoutsesteenweg 2,2022-03-13,23:00:00,6,4,2,ECO_300019380
642,Herenthoutsesteenweg 2,2022-03-14,00:00:00,3,3,0,ECO_300019380
642,Herenthoutsesteenweg 2,2022-03-14,01:00:00,4,1,3,ECO_300019380
642,Herenthoutsesteenweg 2,2022-03-14,02:00:00,4,4,0,ECO_300019380
642,Herenthoutsesteenweg 2,2022-03-14,03:00:00,0,0,0,ECO_300019380
642,Herenthoutsesteenweg 2,2022-03-14,04:00:00,0,0,0,ECO_300019380
642,Herenthoutsesteenweg 2,2022-03-14,05:00:00,2,2,0,ECO_300019380
642,Herenthoutsesteenweg 2,2022-03-14,06:00:00,18,17,1,ECO_300019380
642,Herenthoutsesteenweg 2,2022-03-14,07:00:00,44,41,3,ECO_300019380
642,Herenthoutsesteenweg 2,2022-03-14,08:00:00,157,154,3,ECO_300019380
642,Herenthoutsesteenweg 2,2022-03-14,09:00:00,475,468,7,ECO_300019380
642,Herenthoutsesteenweg 2,2022-03-14,10:00:00,95,91,4,ECO_300019380
642,Herenthoutsesteenweg 2,2022-03-14,11:00:00,63,60,3,ECO_300019380
642,Herenthoutsesteenweg 2,2022-03-14,12:00:00,41,39,2,ECO_300019380
642,Herenthoutsesteenweg 2,2022-03-14,13:00:00,57,54,3,ECO_300019380
642,Herenthoutsesteenweg 2,2022-03-14,14:00:00,57,51,6,ECO_300019380
642,Herenthoutsesteenweg 2,2022-03-14,15:00:00,80,74,6,ECO_300019380
642,Herenthoutsesteenweg 2,2022-03-14,16:00:00,111,106,5,ECO_300019380
642,Herenthoutsesteenweg 2,2022-03-14,17:00:00,120,105,15,ECO_300019380
642,Herenthoutsesteenweg 2,2022-03-14,18:00:00,88,80,8,ECO_300019380
642,Herenthoutsesteenweg 2,2022-03-14,19:00:00,38,35,3,ECO_300019380
642,Herenthoutsesteenweg 2,2022-03-14,20:00:00,35,28,7,ECO_300019380
642,Herenthoutsesteenweg 2,2022-03-14,21:00:00,9,8,1,ECO_300019380
642,Herenthoutsesteenweg 2,2022-03-14,22:00:00,6,3,3,ECO_300019380
642,Herenthoutsesteenweg 2,2022-03-14,23:00:00,16,13,3,ECO_300019380
642,Herenthoutsesteenweg 2,2022-03-15,00:00:00,2,0,2,ECO_300019380
642,Herenthoutsesteenweg 2,2022-03-15,01:00:00,1,1,0,ECO_300019380
642,Herenthoutsesteenweg 2,2022-03-15,02:00:00,1,0,1,ECO_300019380
642,Herenthoutsesteenweg 2,2022-03-15,03:00:00,1,0,1,ECO_300019380
642,Herenthoutsesteenweg 2,2022-03-15,04:00:00,0,0,0,ECO_300019380
642,Herenthoutsesteenweg 2,2022-03-15,05:00:00,3,3,0,ECO_300019380
642,Herenthoutsesteenweg 2,2022-03-15,06:00:00,14,13,1,ECO_300019380
642,Herenthoutsesteenweg 2,2022-03-15,07:00:00,37,33,4,ECO_300019380
642,Herenthoutsesteenweg 2,2022-03-15,08:00:00,136,134,2,ECO_300019380
642,Herenthoutsesteenweg 2,2022-03-15,09:00:00,451,448,3,ECO_300019380
642,Herenthoutsesteenweg 2,2022-03-15,10:00:00,92,87,5,ECO_300019380
642,Herenthoutsesteenweg 2,2022-03-15,11:00:00,47,46,1,ECO_300019380
642,Herenthoutsesteenweg 2,2022-03-15,12:00:00,40,37,3,ECO_300019380
642,Herenthoutsesteenweg 2,2022-03-15,13:00:00,74,71,3,ECO_300019380
642,Herenthoutsesteenweg 2,2022-03-15,14:00:00,87,81,6,ECO_300019380
642,Herenthoutsesteenweg 2,2022-03-15,15:00:00,69,64,5,ECO_300019380
642,Herenthoutsesteenweg 2,2022-03-15,16:00:00,109,101,8,ECO_300019380
642,Herenthoutsesteenweg 2,2022-03-15,17:00:00,123,114,9,ECO_300019380
642,Herenthoutsesteenweg 2,2022-03-15,18:00:00,86,76,10,ECO_300019380
642,Herenthoutsesteenweg 2,2022-03-15,19:00:00,41,37,4,ECO_300019380
642,Herenthoutsesteenweg 2,2022-03-15,20:00:00,24,22,2,ECO_300019380
642,Herenthoutsesteenweg 2,2022-03-15,21:00:00,12,8,4,ECO_300019380
642,Herenthoutsesteenweg 2,2022-03-15,22:00:00,16,12,4,ECO_300019380
642,Herenthoutsesteenweg 2,2022-03-15,23:00:00,12,10,2,ECO_300019380
642,Herenthoutsesteenweg 2,2022-03-16,00:00:00,5,2,3,ECO_300019380
642,Herenthoutsesteenweg 2,2022-03-16,01:00:00,1,0,1,ECO_300019380
642,Herenthoutsesteenweg 2,2022-03-16,02:00:00,1,1,0,ECO_300019380
642,Herenthoutsesteenweg 2,2022-03-16,03:00:00,0,0,0,ECO_300019380
642,Herenthoutsesteenweg 2,2022-03-16,04:00:00,0,0,0,ECO_300019380
642,Herenthoutsesteenweg 2,2022-03-16,05:00:00,4,4,0,ECO_300019380
642,Herenthoutsesteenweg 2,2022-03-16,06:00:00,16,15,1,ECO_300019380
642,Herenthoutsesteenweg 2,2022-03-16,07:00:00,52,49,3,ECO_300019380
642,Herenthoutsesteenweg 2,2022-03-16,08:00:00,150,142,8,ECO_300019380
642,Herenthoutsesteenweg 2,2022-03-16,09:00:00,460,453,7,ECO_300019380
642,Herenthoutsesteenweg 2,2022-03-16,10:00:00,105,102,3,ECO_300019380
642,Herenthoutsesteenweg 2,2022-03-16,11:00:00,68,66,2,ECO_300019380
642,Herenthoutsesteenweg 2,2022-03-16,12:00:00,69,66,3,ECO_300019380
642,Herenthoutsesteenweg 2,2022-03-16,13:00:00,144,137,7,ECO_300019380
642,Herenthoutsesteenweg 2,2022-03-16,14:00:00,174,163,11,ECO_300019380
642,Herenthoutsesteenweg 2,2022-03-16,15:00:00,154,139,15,ECO_300019380
642,Herenthoutsesteenweg 2,2022-03-16,16:00:00,95,81,14,ECO_300019380
642,Herenthoutsesteenweg 2,2022-03-16,17:00:00,146,123,23,ECO_300019380
642,Herenthoutsesteenweg 2,2022-03-16,18:00:00,117,104,13,ECO_300019380
642,Herenthoutsesteenweg 2,2022-03-16,19:00:00,47,37,10,ECO_300019380
642,Herenthoutsesteenweg 2,2022-03-16,20:00:00,28,22,6,ECO_300019380
642,Herenthoutsesteenweg 2,2022-03-16,21:00:00,16,16,0,ECO_300019380
642,Herenthoutsesteenweg 2,2022-03-16,22:00:00,10,7,3,ECO_300019380
642,Herenthoutsesteenweg 2,2022-03-16,23:00:00,19,17,2,ECO_300019380
642,Herenthoutsesteenweg 2,2022-03-17,00:00:00,3,0,3,ECO_300019380
642,Herenthoutsesteenweg 2,2022-03-17,01:00:00,2,2,0,ECO_300019380
642,Herenthoutsesteenweg 2,2022-03-17,02:00:00,0,0,0,ECO_300019380
642,Herenthoutsesteenweg 2,2022-03-17,03:00:00,1,0,1,ECO_300019380
642,Herenthoutsesteenweg 2,2022-03-17,04:00:00,0,0,0,ECO_300019380
642,Herenthoutsesteenweg 2,2022-03-17,05:00:00,2,2,0,ECO_300019380
642,Herenthoutsesteenweg 2,2022-03-17,06:00:00,24,21,3,ECO_300019380
642,Herenthoutsesteenweg 2,2022-03-17,07:00:00,39,35,4,ECO_300019380
642,Herenthoutsesteenweg 2,2022-03-17,08:00:00,135,132,3,ECO_300019380
642,Herenthoutsesteenweg 2,2022-03-17,09:00:00,499,492,7,ECO_300019380
642,Herenthoutsesteenweg 2,2022-03-17,10:00:00,72,69,3,ECO_300019380
642,Herenthoutsesteenweg 2,2022-03-17,11:00:00,43,41,2,ECO_300019380
642,Herenthoutsesteenweg 2,2022-03-17,12:00:00,39,38,1,ECO_300019380
642,Herenthoutsesteenweg 2,2022-03-17,13:00:00,66,61,5,ECO_300019380
642,Herenthoutsesteenweg 2,2022-03-17,14:00:00,93,88,5,ECO_300019380
642,Herenthoutsesteenweg 2,2022-03-17,15:00:00,88,81,7,ECO_300019380
642,Herenthoutsesteenweg 2,2022-03-17,16:00:00,116,101,15,ECO_300019380
642,Herenthoutsesteenweg 2,2022-03-17,17:00:00,106,98,8,ECO_300019380
642,Herenthoutsesteenweg 2,2022-03-17,18:00:00,74,65,9,ECO_300019380
642,Herenthoutsesteenweg 2,2022-03-17,19:00:00,55,47,8,ECO_300019380
642,Herenthoutsesteenweg 2,2022-03-17,20:00:00,29,28,1,ECO_300019380
642,Herenthoutsesteenweg 2,2022-03-17,21:00:00,16,13,3,ECO_300019380
642,Herenthoutsesteenweg 2,2022-03-17,22:00:00,9,6,3,ECO_300019380
642,Herenthoutsesteenweg 2,2022-03-17,23:00:00,17,14,3,ECO_300019380
642,Herenthoutsesteenweg 2,2022-03-18,00:00:00,5,2,3,ECO_300019380
642,Herenthoutsesteenweg 2,2022-03-18,01:00:00,2,2,0,ECO_300019380
642,Herenthoutsesteenweg 2,2022-03-18,02:00:00,1,0,1,ECO_300019380
642,Herenthoutsesteenweg 2,2022-03-18,03:00:00,0,0,0,ECO_300019380
642,Herenthoutsesteenweg 2,2022-03-18,04:00:00,0,0,0,ECO_300019380
642,Herenthoutsesteenweg 2,2022-03-18,05:00:00,3,2,1,ECO_300019380
642,Herenthoutsesteenweg 2,2022-03-18,06:00:00,11,11,0,ECO_300019380
642,Herenthoutsesteenweg 2,2022-03-18,07:00:00,45,42,3,ECO_300019380
642,Herenthoutsesteenweg 2,2022-03-18,08:00:00,149,143,6,ECO_300019380
642,Herenthoutsesteenweg 2,2022-03-18,09:00:00,422,413,9,ECO_300019380
642,Herenthoutsesteenweg 2,2022-03-18,10:00:00,134,127,7,ECO_300019380
642,Herenthoutsesteenweg 2,2022-03-18,11:00:00,130,125,5,ECO_300019380
642,Herenthoutsesteenweg 2,2022-03-18,12:00:00,90,86,4,ECO_300019380
642,Herenthoutsesteenweg 2,2022-03-18,13:00:00,64,58,6,ECO_300019380
642,Herenthoutsesteenweg 2,2022-03-18,14:00:00,137,131,6,ECO_300019380
642,Herenthoutsesteenweg 2,2022-03-18,15:00:00,143,124,19,ECO_300019380
642,Herenthoutsesteenweg 2,2022-03-18,16:00:00,161,148,13,ECO_300019380
642,Herenthoutsesteenweg 2,2022-03-18,17:00:00,147,124,23,ECO_300019380
642,Herenthoutsesteenweg 2,2022-03-18,18:00:00,86,80,6,ECO_300019380
642,Herenthoutsesteenweg 2,2022-03-18,19:00:00,55,47,8,ECO_300019380
642,Herenthoutsesteenweg 2,2022-03-18,20:00:00,37,34,3,ECO_300019380
642,Herenthoutsesteenweg 2,2022-03-18,21:00:00,24,23,1,ECO_300019380
642,Herenthoutsesteenweg 2,2022-03-18,22:00:00,24,22,2,ECO_300019380
642,Herenthoutsesteenweg 2,2022-03-18,23:00:00,17,15,2,ECO_300019380
642,Herenthoutsesteenweg 2,2022-03-19,00:00:00,4,1,3,ECO_300019380
642,Herenthoutsesteenweg 2,2022-03-19,01:00:00,1,0,1,ECO_300019380
642,Herenthoutsesteenweg 2,2022-03-19,02:00:00,10,8,2,ECO_300019380
642,Herenthoutsesteenweg 2,2022-03-19,03:00:00,3,1,2,ECO_300019380
642,Herenthoutsesteenweg 2,2022-03-19,04:00:00,2,0,2,ECO_300019380
642,Herenthoutsesteenweg 2,2022-03-19,05:00:00,0,0,0,ECO_300019380
642,Herenthoutsesteenweg 2,2022-03-19,06:00:00,3,3,0,ECO_300019380
642,Herenthoutsesteenweg 2,2022-03-19,07:00:00,13,13,0,ECO_300019380
642,Herenthoutsesteenweg 2,2022-03-19,08:00:00,14,13,1,ECO_300019380
642,Herenthoutsesteenweg 2,2022-03-19,09:00:00,49,46,3,ECO_300019380
642,Herenthoutsesteenweg 2,2022-03-19,10:00:00,84,79,5,ECO_300019380
642,Herenthoutsesteenweg 2,2022-03-19,11:00:00,82,77,5,ECO_300019380
642,Herenthoutsesteenweg 2,2022-03-19,12:00:00,81,68,13,ECO_300019380
642,Herenthoutsesteenweg 2,2022-03-19,13:00:00,104,93,11,ECO_300019380
642,Herenthoutsesteenweg 2,2022-03-19,14:00:00,116,101,15,ECO_300019380
642,Herenthoutsesteenweg 2,2022-03-19,15:00:00,110,100,10,ECO_300019380
642,Herenthoutsesteenweg 2,2022-03-19,16:00:00,104,63,41,ECO_300019380
642,Herenthoutsesteenweg 2,2022-03-19,17:00:00,55,48,7,ECO_300019380
642,Herenthoutsesteenweg 2,2022-03-19,18:00:00,44,40,4,ECO_300019380
642,Herenthoutsesteenweg 2,2022-03-19,19:00:00,43,38,5,ECO_300019380
642,Herenthoutsesteenweg 2,2022-03-19,20:00:00,33,29,4,ECO_300019380
642,Herenthoutsesteenweg 2,2022-03-19,21:00:00,21,19,2,ECO_300019380
642,Herenthoutsesteenweg 2,2022-03-19,22:00:00,12,11,1,ECO_300019380
642,Herenthoutsesteenweg 2,2022-03-19,23:00:00,5,4,1,ECO_300019380
642,Herenthoutsesteenweg 2,2022-03-20,00:00:00,8,8,0,ECO_300019380
642,Herenthoutsesteenweg 2,2022-03-20,01:00:00,3,2,1,ECO_300019380
642,Herenthoutsesteenweg 2,2022-03-20,02:00:00,12,10,2,ECO_300019380
642,Herenthoutsesteenweg 2,2022-03-20,03:00:00,2,2,0,ECO_300019380
642,Herenthoutsesteenweg 2,2022-03-20,04:00:00,3,2,1,ECO_300019380
642,Herenthoutsesteenweg 2,2022-03-20,05:00:00,2,0,2,ECO_300019380
642,Herenthoutsesteenweg 2,2022-03-20,06:00:00,2,0,2,ECO_300019380
642,Herenthoutsesteenweg 2,2022-03-20,07:00:00,6,6,0,ECO_300019380
642,Herenthoutsesteenweg 2,2022-03-20,08:00:00,12,10,2,ECO_300019380
642,Herenthoutsesteenweg 2,2022-03-20,09:00:00,30,30,0,ECO_300019380
642,Herenthoutsesteenweg 2,2022-03-20,10:00:00,50,47,3,ECO_300019380
642,Herenthoutsesteenweg 2,2022-03-20,11:00:00,71,63,8,ECO_300019380
642,Herenthoutsesteenweg 2,2022-03-20,12:00:00,49,42,7,ECO_300019380
642,Herenthoutsesteenweg 2,2022-03-20,13:00:00,47,35,12,ECO_300019380
642,Herenthoutsesteenweg 2,2022-03-20,14:00:00,91,82,9,ECO_300019380
642,Herenthoutsesteenweg 2,2022-03-20,15:00:00,92,72,20,ECO_300019380
642,Herenthoutsesteenweg 2,2022-03-20,16:00:00,56,48,8,ECO_300019380
642,Herenthoutsesteenweg 2,2022-03-20,17:00:00,39,36,3,ECO_300019380
642,Herenthoutsesteenweg 2,2022-03-20,18:00:00,31,28,3,ECO_300019380
642,Herenthoutsesteenweg 2,2022-03-20,19:00:00,18,18,0,ECO_300019380
642,Herenthoutsesteenweg 2,2022-03-20,20:00:00,14,10,4,ECO_300019380
642,Herenthoutsesteenweg 2,2022-03-20,21:00:00,12,10,2,ECO_300019380
642,Herenthoutsesteenweg 2,2022-03-20,22:00:00,6,6,0,ECO_300019380
642,Herenthoutsesteenweg 2,2022-03-20,23:00:00,4,4,0,ECO_300019380
642,Herenthoutsesteenweg 2,2022-03-21,00:00:00,6,6,0,ECO_300019380
642,Herenthoutsesteenweg 2,2022-03-21,01:00:00,2,2,0,ECO_300019380
642,Herenthoutsesteenweg 2,2022-03-21,02:00:00,0,0,0,ECO_300019380
642,Herenthoutsesteenweg 2,2022-03-21,03:00:00,2,1,1,ECO_300019380
642,Herenthoutsesteenweg 2,2022-03-21,04:00:00,0,0,0,ECO_300019380
642,Herenthoutsesteenweg 2,2022-03-21,05:00:00,1,0,1,ECO_300019380
642,Herenthoutsesteenweg 2,2022-03-21,06:00:00,17,17,0,ECO_300019380
642,Herenthoutsesteenweg 2,2022-03-21,07:00:00,48,44,4,ECO_300019380
642,Herenthoutsesteenweg 2,2022-03-21,08:00:00,146,140,6,ECO_300019380
642,Herenthoutsesteenweg 2,2022-03-21,09:00:00,500,486,14,ECO_300019380
642,Herenthoutsesteenweg 2,2022-03-21,10:00:00,89,87,2,ECO_300019380
642,Herenthoutsesteenweg 2,2022-03-21,11:00:00,56,56,0,ECO_300019380
642,Herenthoutsesteenweg 2,2022-03-21,12:00:00,55,46,9,ECO_300019380
642,Herenthoutsesteenweg 2,2022-03-21,13:00:00,74,67,7,ECO_300019380
642,Herenthoutsesteenweg 2,2022-03-21,14:00:00,122,110,12,ECO_300019380
642,Herenthoutsesteenweg 2,2022-03-21,15:00:00,119,107,12,ECO_300019380
642,Herenthoutsesteenweg 2,2022-03-21,16:00:00,158,148,10,ECO_300019380
642,Herenthoutsesteenweg 2,2022-03-21,17:00:00,135,117,18,ECO_300019380
642,Herenthoutsesteenweg 2,2022-03-21,18:00:00,88,72,16,ECO_300019380
642,Herenthoutsesteenweg 2,2022-03-21,19:00:00,49,46,3,ECO_300019380
642,Herenthoutsesteenweg 2,2022-03-21,20:00:00,28,24,4,ECO_300019380
642,Herenthoutsesteenweg 2,2022-03-21,21:00:00,20,16,4,ECO_300019380
642,Herenthoutsesteenweg 2,2022-03-21,22:00:00,23,21,2,ECO_300019380
642,Herenthoutsesteenweg 2,2022-03-21,23:00:00,15,11,4,ECO_300019380
642,Herenthoutsesteenweg 2,2022-03-22,00:00:00,3,2,1,ECO_300019380
642,Herenthoutsesteenweg 2,2022-03-22,01:00:00,6,6,0,ECO_300019380
642,Herenthoutsesteenweg 2,2022-03-22,02:00:00,1,0,1,ECO_300019380
642,Herenthoutsesteenweg 2,2022-03-22,03:00:00,0,0,0,ECO_300019380
642,Herenthoutsesteenweg 2,2022-03-22,04:00:00,0,0,0,ECO_300019380
642,Herenthoutsesteenweg 2,2022-03-22,05:00:00,1,1,0,ECO_300019380
642,Herenthoutsesteenweg 2,2022-03-22,06:00:00,17,16,1,ECO_300019380
642,Herenthoutsesteenweg 2,2022-03-22,07:00:00,47,44,3,ECO_300019380
642,Herenthoutsesteenweg 2,2022-03-22,08:00:00,158,151,7,ECO_300019380
642,Herenthoutsesteenweg 2,2022-03-22,09:00:00,481,477,4,ECO_300019380
642,Herenthoutsesteenweg 2,2022-03-22,10:00:00,91,85,6,ECO_300019380
642,Herenthoutsesteenweg 2,2022-03-22,11:00:00,96,86,10,ECO_300019380
642,Herenthoutsesteenweg 2,2022-03-22,12:00:00,77,74,3,ECO_300019380
642,Herenthoutsesteenweg 2,2022-03-22,13:00:00,102,93,9,ECO_300019380
642,Herenthoutsesteenweg 2,2022-03-22,14:00:00,173,157,16,ECO_300019380
642,Herenthoutsesteenweg 2,2022-03-22,15:00:00,171,152,19,ECO_300019380
642,Herenthoutsesteenweg 2,2022-03-22,16:00:00,192,178,14,ECO_300019380
642,Herenthoutsesteenweg 2,2022-03-22,17:00:00,182,159,23,ECO_300019380
642,Herenthoutsesteenweg 2,2022-03-22,18:00:00,139,120,19,ECO_300019380
642,Herenthoutsesteenweg 2,2022-03-22,19:00:00,57,45,12,ECO_300019380
642,Herenthoutsesteenweg 2,2022-03-22,20:00:00,25,19,6,ECO_300019380
642,Herenthoutsesteenweg 2,2022-03-22,21:00:00,22,17,5,ECO_300019380
642,Herenthoutsesteenweg 2,2022-03-22,22:00:00,18,16,2,ECO_300019380
642,Herenthoutsesteenweg 2,2022-03-22,23:00:00,18,15,3,ECO_300019380
642,Herenthoutsesteenweg 2,2022-03-23,00:00:00,5,5,0,ECO_300019380
642,Herenthoutsesteenweg 2,2022-03-23,01:00:00,0,0,0,ECO_300019380
642,Herenthoutsesteenweg 2,2022-03-23,02:00:00,0,0,0,ECO_300019380
642,Herenthoutsesteenweg 2,2022-03-23,03:00:00,0,0,0,ECO_300019380
642,Herenthoutsesteenweg 2,2022-03-23,04:00:00,0,0,0,ECO_300019380
642,Herenthoutsesteenweg 2,2022-03-23,05:00:00,1,1,0,ECO_300019380
642,Herenthoutsesteenweg 2,2022-03-23,06:00:00,21,19,2,ECO_300019380
642,Herenthoutsesteenweg 2,2022-03-23,07:00:00,50,47,3,ECO_300019380
642,Herenthoutsesteenweg 2,2022-03-23,08:00:00,146,142,4,ECO_300019380
642,Herenthoutsesteenweg 2,2022-03-23,09:00:00,471,466,5,ECO_300019380
642,Herenthoutsesteenweg 2,2022-03-23,10:00:00,92,90,2,ECO_300019380
642,Herenthoutsesteenweg 2,2022-03-23,11:00:00,82,75,7,ECO_300019380
642,Herenthoutsesteenweg 2,2022-03-23,12:00:00,80,76,4,ECO_300019380
642,Herenthoutsesteenweg 2,2022-03-23,13:00:00,198,178,20,ECO_300019380
642,Herenthoutsesteenweg 2,2022-03-23,14:00:00,189,179,10,ECO_300019380
642,Herenthoutsesteenweg 2,2022-03-23,15:00:00,182,172,10,ECO_300019380
642,Herenthoutsesteenweg 2,2022-03-23,16:00:00,147,120,27,ECO_300019380
642,Herenthoutsesteenweg 2,2022-03-23,17:00:00,169,158,11,ECO_300019380
642,Herenthoutsesteenweg 2,2022-03-23,18:00:00,153,133,20,ECO_300019380
642,Herenthoutsesteenweg 2,2022-03-23,19:00:00,63,55,8,ECO_300019380
642,Herenthoutsesteenweg 2,2022-03-23,20:00:00,42,35,7,ECO_300019380
642,Herenthoutsesteenweg 2,2022-03-23,21:00:00,23,20,3,ECO_300019380
642,Herenthoutsesteenweg 2,2022-03-23,22:00:00,10,8,2,ECO_300019380
642,Herenthoutsesteenweg 2,2022-03-23,23:00:00,14,13,1,ECO_300019380
642,Herenthoutsesteenweg 2,2022-03-24,00:00:00,4,2,2,ECO_300019380
642,Herenthoutsesteenweg 2,2022-03-24,01:00:00,5,3,2,ECO_300019380
642,Herenthoutsesteenweg 2,2022-03-24,02:00:00,0,0,0,ECO_300019380
642,Herenthoutsesteenweg 2,2022-03-24,03:00:00,0,0,0,ECO_300019380
642,Herenthoutsesteenweg 2,2022-03-24,04:00:00,0,0,0,ECO_300019380
642,Herenthoutsesteenweg 2,2022-03-24,05:00:00,1,1,0,ECO_300019380
642,Herenthoutsesteenweg 2,2022-03-24,06:00:00,15,13,2,ECO_300019380
642,Herenthoutsesteenweg 2,2022-03-24,07:00:00,39,33,6,ECO_300019380
642,Herenthoutsesteenweg 2,2022-03-24,08:00:00,167,158,9,ECO_300019380
642,Herenthoutsesteenweg 2,2022-03-24,09:00:00,558,545,13,ECO_300019380
642,Herenthoutsesteenweg 2,2022-03-24,10:00:00,121,119,2,ECO_300019380
642,Herenthoutsesteenweg 2,2022-03-24,11:00:00,84,81,3,ECO_300019380
642,Herenthoutsesteenweg 2,2022-03-24,12:00:00,76,71,5,ECO_300019380
642,Herenthoutsesteenweg 2,2022-03-24,13:00:00,105,98,7,ECO_300019380
642,Herenthoutsesteenweg 2,2022-03-24,14:00:00,166,151,15,ECO_300019380
642,Herenthoutsesteenweg 2,2022-03-24,15:00:00,160,145,15,ECO_300019380
642,Herenthoutsesteenweg 2,2022-03-24,16:00:00,187,167,20,ECO_300019380
642,Herenthoutsesteenweg 2,2022-03-24,17:00:00,166,142,24,ECO_300019380
642,Herenthoutsesteenweg 2,2022-03-24,18:00:00,109,101,8,ECO_300019380
642,Herenthoutsesteenweg 2,2022-03-24,19:00:00,53,41,12,ECO_300019380
642,Herenthoutsesteenweg 2,2022-03-24,20:00:00,39,35,4,ECO_300019380
642,Herenthoutsesteenweg 2,2022-03-24,21:00:00,21,19,2,ECO_300019380
642,Herenthoutsesteenweg 2,2022-03-24,22:00:00,15,14,1,ECO_300019380
642,Herenthoutsesteenweg 2,2022-03-24,23:00:00,12,11,1,ECO_300019380
642,Herenthoutsesteenweg 2,2022-03-25,00:00:00,9,4,5,ECO_300019380
642,Herenthoutsesteenweg 2,2022-03-25,01:00:00,1,1,0,ECO_300019380
642,Herenthoutsesteenweg 2,2022-03-25,02:00:00,0,0,0,ECO_300019380
642,Herenthoutsesteenweg 2,2022-03-25,03:00:00,0,0,0,ECO_300019380
642,Herenthoutsesteenweg 2,2022-03-25,04:00:00,0,0,0,ECO_300019380
642,Herenthoutsesteenweg 2,2022-03-25,05:00:00,1,1,0,ECO_300019380
642,Herenthoutsesteenweg 2,2022-03-25,06:00:00,20,18,2,ECO_300019380
642,Herenthoutsesteenweg 2,2022-03-25,07:00:00,40,38,2,ECO_300019380
642,Herenthoutsesteenweg 2,2022-03-25,08:00:00,159,149,10,ECO_300019380
642,Herenthoutsesteenweg 2,2022-03-25,09:00:00,480,473,7,ECO_300019380
642,Herenthoutsesteenweg 2,2022-03-25,10:00:00,135,127,8,ECO_300019380
642,Herenthoutsesteenweg 2,2022-03-25,11:00:00,135,129,6,ECO_300019380
642,Herenthoutsesteenweg 2,2022-03-25,12:00:00,87,74,13,ECO_300019380
642,Herenthoutsesteenweg 2,2022-03-25,13:00:00,88,77,11,ECO_300019380
642,Herenthoutsesteenweg 2,2022-03-25,14:00:00,156,144,12,ECO_300019380
642,Herenthoutsesteenweg 2,2022-03-25,15:00:00,140,132,8,ECO_300019380
642,Herenthoutsesteenweg 2,2022-03-25,16:00:00,233,217,16,ECO_300019380
642,Herenthoutsesteenweg 2,2022-03-25,17:00:00,131,114,17,ECO_300019380
642,Herenthoutsesteenweg 2,2022-03-25,18:00:00,100,85,15,ECO_300019380
642,Herenthoutsesteenweg 2,2022-03-25,19:00:00,61,55,6,ECO_300019380
642,Herenthoutsesteenweg 2,2022-03-25,20:00:00,38,33,5,ECO_300019380
642,Herenthoutsesteenweg 2,2022-03-25,21:00:00,28,26,2,ECO_300019380
642,Herenthoutsesteenweg 2,2022-03-25,22:00:00,16,16,0,ECO_300019380
642,Herenthoutsesteenweg 2,2022-03-25,23:00:00,10,10,0,ECO_300019380
642,Herenthoutsesteenweg 2,2022-03-26,00:00:00,9,5,4,ECO_300019380
642,Herenthoutsesteenweg 2,2022-03-26,01:00:00,8,6,2,ECO_300019380
642,Herenthoutsesteenweg 2,2022-03-26,02:00:00,9,5,4,ECO_300019380
642,Herenthoutsesteenweg 2,2022-03-26,03:00:00,6,3,3,ECO_300019380
642,Herenthoutsesteenweg 2,2022-03-26,04:00:00,2,2,0,ECO_300019380
642,Herenthoutsesteenweg 2,2022-03-26,05:00:00,3,3,0,ECO_300019380
642,Herenthoutsesteenweg 2,2022-03-26,06:00:00,4,3,1,ECO_300019380
642,Herenthoutsesteenweg 2,2022-03-26,07:00:00,7,7,0,ECO_300019380
642,Herenthoutsesteenweg 2,2022-03-26,08:00:00,13,13,0,ECO_300019380
642,Herenthoutsesteenweg 2,2022-03-26,09:00:00,62,59,3,ECO_300019380
642,Herenthoutsesteenweg 2,2022-03-26,10:00:00,67,63,4,ECO_300019380
642,Herenthoutsesteenweg 2,2022-03-26,11:00:00,89,83,6,ECO_300019380
642,Herenthoutsesteenweg 2,2022-03-26,12:00:00,136,129,7,ECO_300019380
642,Herenthoutsesteenweg 2,2022-03-26,13:00:00,109,100,9,ECO_300019380
642,Herenthoutsesteenweg 2,2022-03-26,14:00:00,223,198,25,ECO_300019380
642,Herenthoutsesteenweg 2,2022-03-26,15:00:00,183,171,12,ECO_300019380
642,Herenthoutsesteenweg 2,2022-03-26,16:00:00,140,117,23,ECO_300019380
642,Herenthoutsesteenweg 2,2022-03-26,17:00:00,102,86,16,ECO_300019380
642,Herenthoutsesteenweg 2,2022-03-26,18:00:00,68,60,8,ECO_300019380
642,Herenthoutsesteenweg 2,2022-03-26,19:00:00,54,50,4,ECO_300019380
642,Herenthoutsesteenweg 2,2022-03-26,20:00:00,52,47,5,ECO_300019380
642,Herenthoutsesteenweg 2,2022-03-26,21:00:00,18,14,4,ECO_300019380
642,Herenthoutsesteenweg 2,2022-03-26,22:00:00,18,15,3,ECO_300019380
642,Herenthoutsesteenweg 2,2022-03-26,23:00:00,17,14,3,ECO_300019380
642,Herenthoutsesteenweg 2,2022-03-27,00:00:00,3,2,1,ECO_300019380
642,Herenthoutsesteenweg 2,2022-03-27,01:00:00,10,7,3,ECO_300019380
642,Herenthoutsesteenweg 2,2022-03-27,03:00:00,3,3,0,ECO_300019380
642,Herenthoutsesteenweg 2,2022-03-27,05:00:00,5,5,0,ECO_300019380
642,Herenthoutsesteenweg 2,2022-03-27,06:00:00,14,11,3,ECO_300019380
642,Herenthoutsesteenweg 2,2022-03-27,07:00:00,6,4,2,ECO_300019380
642,Herenthoutsesteenweg 2,2022-03-27,08:00:00,6,6,0,ECO_300019380
642,Herenthoutsesteenweg 2,2022-03-27,09:00:00,7,6,1,ECO_300019380
642,Herenthoutsesteenweg 2,2022-03-27,10:00:00,46,41,5,ECO_300019380
642,Herenthoutsesteenweg 2,2022-03-27,11:00:00,66,64,2,ECO_300019380
642,Herenthoutsesteenweg 2,2022-03-27,12:00:00,99,90,9,ECO_300019380
642,Herenthoutsesteenweg 2,2022-03-27,13:00:00,68,55,13,ECO_300019380
642,Herenthoutsesteenweg 2,2022-03-27,14:00:00,59,48,11,ECO_300019380
642,Herenthoutsesteenweg 2,2022-03-27,15:00:00,63,52,11,ECO_300019380
642,Herenthoutsesteenweg 2,2022-03-27,16:00:00,73,71,2,ECO_300019380
642,Herenthoutsesteenweg 2,2022-03-27,17:00:00,52,45,7,ECO_300019380
642,Herenthoutsesteenweg 2,2022-03-27,18:00:00,48,43,5,ECO_300019380
642,Herenthoutsesteenweg 2,2022-03-27,19:00:00,64,54,10,ECO_300019380
642,Herenthoutsesteenweg 2,2022-03-27,20:00:00,36,32,4,ECO_300019380
642,Herenthoutsesteenweg 2,2022-03-27,21:00:00,13,9,4,ECO_300019380
642,Herenthoutsesteenweg 2,2022-03-27,22:00:00,16,15,1,ECO_300019380
642,Herenthoutsesteenweg 2,2022-03-27,23:00:00,8,8,0,ECO_300019380
642,Herenthoutsesteenweg 2,2022-03-28,00:00:00,7,4,3,ECO_300019380
642,Herenthoutsesteenweg 2,2022-03-28,01:00:00,3,3,0,ECO_300019380
642,Herenthoutsesteenweg 2,2022-03-28,02:00:00,1,1,0,ECO_300019380
642,Herenthoutsesteenweg 2,2022-03-28,03:00:00,1,1,0,ECO_300019380
642,Herenthoutsesteenweg 2,2022-03-28,04:00:00,0,0,0,ECO_300019380
642,Herenthoutsesteenweg 2,2022-03-28,05:00:00,0,0,0,ECO_300019380
642,Herenthoutsesteenweg 2,2022-03-28,06:00:00,0,0,0,ECO_300019380
642,Herenthoutsesteenweg 2,2022-03-28,07:00:00,17,15,2,ECO_300019380
642,Herenthoutsesteenweg 2,2022-03-28,08:00:00,39,37,2,ECO_300019380
642,Herenthoutsesteenweg 2,2022-03-28,09:00:00,157,148,9,ECO_300019380
642,Herenthoutsesteenweg 2,2022-03-28,10:00:00,520,516,4,ECO_300019380
642,Herenthoutsesteenweg 2,2022-03-28,11:00:00,84,82,2,ECO_300019380
642,Herenthoutsesteenweg 2,2022-03-28,12:00:00,86,82,4,ECO_300019380
642,Herenthoutsesteenweg 2,2022-03-28,13:00:00,46,41,5,ECO_300019380
642,Herenthoutsesteenweg 2,2022-03-28,14:00:00,76,69,7,ECO_300019380
642,Herenthoutsesteenweg 2,2022-03-28,15:00:00,199,193,6,ECO_300019380
642,Herenthoutsesteenweg 2,2022-03-28,16:00:00,177,162,15,ECO_300019380
642,Herenthoutsesteenweg 2,2022-03-28,17:00:00,194,182,12,ECO_300019380
642,Herenthoutsesteenweg 2,2022-03-28,18:00:00,159,144,15,ECO_300019380
642,Herenthoutsesteenweg 2,2022-03-28,19:00:00,96,89,7,ECO_300019380
642,Herenthoutsesteenweg 2,2022-03-28,20:00:00,75,65,10,ECO_300019380
642,Herenthoutsesteenweg 2,2022-03-28,21:00:00,30,28,2,ECO_300019380
642,Herenthoutsesteenweg 2,2022-03-28,22:00:00,15,10,5,ECO_300019380
642,Herenthoutsesteenweg 2,2022-03-28,23:00:00,8,8,0,ECO_300019380
642,Herenthoutsesteenweg 2,2022-03-29,00:00:00,16,12,4,ECO_300019380
642,Herenthoutsesteenweg 2,2022-03-29,01:00:00,6,3,3,ECO_300019380
642,Herenthoutsesteenweg 2,2022-03-29,02:00:00,0,0,0,ECO_300019380
642,Herenthoutsesteenweg 2,2022-03-29,03:00:00,2,1,1,ECO_300019380
642,Herenthoutsesteenweg 2,2022-03-29,04:00:00,0,0,0,ECO_300019380
642,Herenthoutsesteenweg 2,2022-03-29,05:00:00,0,0,0,ECO_300019380
642,Herenthoutsesteenweg 2,2022-03-29,06:00:00,1,1,0,ECO_300019380
642,Herenthoutsesteenweg 2,2022-03-29,07:00:00,12,11,1,ECO_300019380
642,Herenthoutsesteenweg 2,2022-03-29,08:00:00,43,40,3,ECO_300019380
642,Herenthoutsesteenweg 2,2022-03-29,09:00:00,158,153,5,ECO_300019380
642,Herenthoutsesteenweg 2,2022-03-29,10:00:00,465,452,13,ECO_300019380
642,Herenthoutsesteenweg 2,2022-03-29,11:00:00,85,85,0,ECO_300019380
642,Herenthoutsesteenweg 2,2022-03-29,12:00:00,86,80,6,ECO_300019380
642,Herenthoutsesteenweg 2,2022-03-29,13:00:00,52,49,3,ECO_300019380
642,Herenthoutsesteenweg 2,2022-03-29,14:00:00,77,66,11,ECO_300019380
642,Herenthoutsesteenweg 2,2022-03-29,15:00:00,109,100,9,ECO_300019380
642,Herenthoutsesteenweg 2,2022-03-29,16:00:00,112,97,15,ECO_300019380
642,Herenthoutsesteenweg 2,2022-03-29,17:00:00,118,106,12,ECO_300019380
642,Herenthoutsesteenweg 2,2022-03-29,18:00:00,147,131,16,ECO_300019380
642,Herenthoutsesteenweg 2,2022-03-29,19:00:00,80,73,7,ECO_300019380
642,Herenthoutsesteenweg 2,2022-03-29,20:00:00,43,40,3,ECO_300019380
642,Herenthoutsesteenweg 2,2022-03-29,21:00:00,46,44,2,ECO_300019380
642,Herenthoutsesteenweg 2,2022-03-29,22:00:00,13,10,3,ECO_300019380
642,Herenthoutsesteenweg 2,2022-03-29,23:00:00,17,14,3,ECO_300019380
642,Herenthoutsesteenweg 2,2022-03-30,00:00:00,18,15,3,ECO_300019380
642,Herenthoutsesteenweg 2,2022-03-30,01:00:00,4,2,2,ECO_300019380
642,Herenthoutsesteenweg 2,2022-03-30,02:00:00,2,0,2,ECO_300019380
642,Herenthoutsesteenweg 2,2022-03-30,03:00:00,2,2,0,ECO_300019380
642,Herenthoutsesteenweg 2,2022-03-30,04:00:00,0,0,0,ECO_300019380
642,Herenthoutsesteenweg 2,2022-03-30,05:00:00,0,0,0,ECO_300019380
642,Herenthoutsesteenweg 2,2022-03-30,06:00:00,2,2,0,ECO_300019380
642,Herenthoutsesteenweg 2,2022-03-30,07:00:00,19,16,3,ECO_300019380
642,Herenthoutsesteenweg 2,2022-03-30,08:00:00,34,32,2,ECO_300019380
642,Herenthoutsesteenweg 2,2022-03-30,09:00:00,120,117,3,ECO_300019380
642,Herenthoutsesteenweg 2,2022-03-30,10:00:00,371,365,6,ECO_300019380
642,Herenthoutsesteenweg 2,2022-03-30,11:00:00,91,88,3,ECO_300019380
642,Herenthoutsesteenweg 2,2022-03-30,12:00:00,69,68,1,ECO_300019380
642,Herenthoutsesteenweg 2,2022-03-30,13:00:00,53,48,5,ECO_300019380
642,Herenthoutsesteenweg 2,2022-03-30,14:00:00,116,110,6,ECO_300019380
642,Herenthoutsesteenweg 2,2022-03-30,15:00:00,134,122,12,ECO_300019380
642,Herenthoutsesteenweg 2,2022-03-30,16:00:00,110,105,5,ECO_300019380
642,Herenthoutsesteenweg 2,2022-03-30,17:00:00,83,74,9,ECO_300019380
642,Herenthoutsesteenweg 2,2022-03-30,18:00:00,105,95,10,ECO_300019380
642,Herenthoutsesteenweg 2,2022-03-30,19:00:00,77,72,5,ECO_300019380
642,Herenthoutsesteenweg 2,2022-03-30,20:00:00,52,46,6,ECO_300019380
642,Herenthoutsesteenweg 2,2022-03-30,21:00:00,39,32,7,ECO_300019380
642,Herenthoutsesteenweg 2,2022-03-30,22:00:00,15,13,2,ECO_300019380
642,Herenthoutsesteenweg 2,2022-03-30,23:00:00,16,10,6,ECO_300019380
642,Herenthoutsesteenweg 2,2022-03-31,00:00:00,23,19,4,ECO_300019380
642,Herenthoutsesteenweg 2,2022-03-31,01:00:00,8,5,3,ECO_300019380
642,Herenthoutsesteenweg 2,2022-03-31,02:00:00,5,2,3,ECO_300019380
642,Herenthoutsesteenweg 2,2022-03-31,03:00:00,0,0,0,ECO_300019380
642,Herenthoutsesteenweg 2,2022-03-31,04:00:00,1,1,0,ECO_300019380
642,Herenthoutsesteenweg 2,2022-03-31,05:00:00,0,0,0,ECO_300019380
642,Herenthoutsesteenweg 2,2022-03-31,06:00:00,0,0,0,ECO_300019380
642,Herenthoutsesteenweg 2,2022-03-31,07:00:00,14,14,0,ECO_300019380
642,Herenthoutsesteenweg 2,2022-03-31,08:00:00,23,22,1,ECO_300019380
642,Herenthoutsesteenweg 2,2022-03-31,09:00:00,63,60,3,ECO_300019380
642,Herenthoutsesteenweg 2,2022-03-31,10:00:00,172,165,7,ECO_300019380
642,Herenthoutsesteenweg 2,2022-03-31,11:00:00,68,67,1,ECO_300019380
642,Herenthoutsesteenweg 2,2022-03-31,12:00:00,37,36,1,ECO_300019380
642,Herenthoutsesteenweg 2,2022-03-31,13:00:00,32,30,2,ECO_300019380
642,Herenthoutsesteenweg 2,2022-03-31,14:00:00,40,40,0,ECO_300019380
642,Herenthoutsesteenweg 2,2022-03-31,15:00:00,45,43,2,ECO_300019380
642,Herenthoutsesteenweg 2,2022-03-31,16:00:00,47,45,2,ECO_300019380
642,Herenthoutsesteenweg 2,2022-03-31,17:00:00,62,60,2,ECO_300019380
642,Herenthoutsesteenweg 2,2022-03-31,18:00:00,75,72,3,ECO_300019380
642,Herenthoutsesteenweg 2,2022-03-31,19:00:00,48,41,7,ECO_300019380
642,Herenthoutsesteenweg 2,2022-03-31,20:00:00,39,32,7,ECO_300019380
642,Herenthoutsesteenweg 2,2022-03-31,21:00:00,26,18,8,ECO_300019380
642,Herenthoutsesteenweg 2,2022-03-31,22:00:00,17,16,1,ECO_300019380
642,Herenthoutsesteenweg 2,2022-03-31,23:00:00,10,8,2,ECO_300019380
642,Herenthoutsesteenweg 2,2022-04-01,00:00:00,14,11,3,ECO_300019380
642,Herenthoutsesteenweg 2,2022-04-01,01:00:00,6,3,3,ECO_300019380
642,Herenthoutsesteenweg 2,2022-04-01,02:00:00,3,2,1,ECO_300019380
642,Herenthoutsesteenweg 2,2022-04-01,03:00:00,0,0,0,ECO_300019380
642,Herenthoutsesteenweg 2,2022-04-01,04:00:00,0,0,0,ECO_300019380
642,Herenthoutsesteenweg 2,2022-04-01,05:00:00,0,0,0,ECO_300019380
642,Herenthoutsesteenweg 2,2022-04-01,06:00:00,1,1,0,ECO_300019380
642,Herenthoutsesteenweg 2,2022-04-01,07:00:00,14,13,1,ECO_300019380
642,Herenthoutsesteenweg 2,2022-04-01,08:00:00,19,16,3,ECO_300019380
642,Herenthoutsesteenweg 2,2022-04-01,09:00:00,56,50,6,ECO_300019380
642,Herenthoutsesteenweg 2,2022-04-01,10:00:00,155,153,2,ECO_300019380
642,Herenthoutsesteenweg 2,2022-04-01,11:00:00,47,45,2,ECO_300019380
642,Herenthoutsesteenweg 2,2022-04-01,12:00:00,34,33,1,ECO_300019380
642,Herenthoutsesteenweg 2,2022-04-01,13:00:00,23,23,0,ECO_300019380
642,Herenthoutsesteenweg 2,2022-04-01,14:00:00,127,125,2,ECO_300019380
642,Herenthoutsesteenweg 2,2022-04-01,15:00:00,28,27,1,ECO_300019380
642,Herenthoutsesteenweg 2,2022-04-01,16:00:00,59,53,6,ECO_300019380
642,Herenthoutsesteenweg 2,2022-04-01,17:00:00,44,38,6,ECO_300019380
642,Herenthoutsesteenweg 2,2022-04-01,18:00:00,55,49,6,ECO_300019380
642,Herenthoutsesteenweg 2,2022-04-01,19:00:00,36,31,5,ECO_300019380
642,Herenthoutsesteenweg 2,2022-04-01,20:00:00,34,28,6,ECO_300019380
642,Herenthoutsesteenweg 2,2022-04-01,21:00:00,12,10,2,ECO_300019380
642,Herenthoutsesteenweg 2,2022-04-01,22:00:00,9,7,2,ECO_300019380
642,Herenthoutsesteenweg 2,2022-04-01,23:00:00,14,11,3,ECO_300019380
642,Herenthoutsesteenweg 2,2022-04-02,00:00:00,19,16,3,ECO_300019380
642,Herenthoutsesteenweg 2,2022-04-02,01:00:00,12,11,1,ECO_300019380
642,Herenthoutsesteenweg 2,2022-04-02,02:00:00,1,0,1,ECO_300019380
642,Herenthoutsesteenweg 2,2022-04-02,03:00:00,3,3,0,ECO_300019380
642,Herenthoutsesteenweg 2,2022-04-02,04:00:00,2,2,0,ECO_300019380
642,Herenthoutsesteenweg 2,2022-04-02,05:00:00,0,0,0,ECO_300019380
642,Herenthoutsesteenweg 2,2022-04-02,06:00:00,1,0,1,ECO_300019380
642,Herenthoutsesteenweg 2,2022-04-02,07:00:00,3,3,0,ECO_300019380
642,Herenthoutsesteenweg 2,2022-04-02,08:00:00,6,6,0,ECO_300019380
642,Herenthoutsesteenweg 2,2022-04-02,09:00:00,6,6,0,ECO_300019380
642,Herenthoutsesteenweg 2,2022-04-02,10:00:00,36,34,2,ECO_300019380
642,Herenthoutsesteenweg 2,2022-04-02,11:00:00,42,33,9,ECO_300019380
642,Herenthoutsesteenweg 2,2022-04-02,12:00:00,52,46,6,ECO_300019380
642,Herenthoutsesteenweg 2,2022-04-02,13:00:00,64,55,9,ECO_300019380
642,Herenthoutsesteenweg 2,2022-04-02,14:00:00,50,43,7,ECO_300019380
642,Herenthoutsesteenweg 2,2022-04-02,15:00:00,79,67,12,ECO_300019380
642,Herenthoutsesteenweg 2,2022-04-02,16:00:00,78,67,11,ECO_300019380
642,Herenthoutsesteenweg 2,2022-04-02,17:00:00,48,38,10,ECO_300019380
642,Herenthoutsesteenweg 2,2022-04-02,18:00:00,35,26,9,ECO_300019380
642,Herenthoutsesteenweg 2,2022-04-02,19:00:00,37,35,2,ECO_300019380
642,Herenthoutsesteenweg 2,2022-04-02,20:00:00,23,21,2,ECO_300019380
642,Herenthoutsesteenweg 2,2022-04-02,21:00:00,29,23,6,ECO_300019380
642,Herenthoutsesteenweg 2,2022-04-02,22:00:00,21,19,2,ECO_300019380
642,Herenthoutsesteenweg 2,2022-04-02,23:00:00,13,13,0,ECO_300019380
642,Herenthoutsesteenweg 2,2022-04-03,00:00:00,6,6,0,ECO_300019380
642,Herenthoutsesteenweg 2,2022-04-03,01:00:00,4,3,1,ECO_300019380
642,Herenthoutsesteenweg 2,2022-04-03,02:00:00,15,14,1,ECO_300019380
642,Herenthoutsesteenweg 2,2022-04-03,03:00:00,5,4,1,ECO_300019380
642,Herenthoutsesteenweg 2,2022-04-03,04:00:00,3,2,1,ECO_300019380
642,Herenthoutsesteenweg 2,2022-04-03,05:00:00,7,5,2,ECO_300019380
642,Herenthoutsesteenweg 2,2022-04-03,06:00:00,0,0,0,ECO_300019380
642,Herenthoutsesteenweg 2,2022-04-03,07:00:00,3,3,0,ECO_300019380
642,Herenthoutsesteenweg 2,2022-04-03,08:00:00,4,4,0,ECO_300019380
642,Herenthoutsesteenweg 2,2022-04-03,09:00:00,12,12,0,ECO_300019380
642,Herenthoutsesteenweg 2,2022-04-03,10:00:00,24,23,1,ECO_300019380
642,Herenthoutsesteenweg 2,2022-04-03,11:00:00,68,64,4,ECO_300019380
642,Herenthoutsesteenweg 2,2022-04-03,12:00:00,88,81,7,ECO_300019380
642,Herenthoutsesteenweg 2,2022-04-03,13:00:00,59,49,10,ECO_300019380
642,Herenthoutsesteenweg 2,2022-04-03,14:00:00,59,44,15,ECO_300019380
642,Herenthoutsesteenweg 2,2022-04-03,15:00:00,75,70,5,ECO_300019380
642,Herenthoutsesteenweg 2,2022-04-03,16:00:00,100,88,12,ECO_300019380
642,Herenthoutsesteenweg 2,2022-04-03,17:00:00,37,33,4,ECO_300019380
642,Herenthoutsesteenweg 2,2022-04-03,18:00:00,25,22,3,ECO_300019380
642,Herenthoutsesteenweg 2,2022-04-03,19:00:00,24,22,2,ECO_300019380
642,Herenthoutsesteenweg 2,2022-04-03,20:00:00,28,27,1,ECO_300019380
642,Herenthoutsesteenweg 2,2022-04-03,21:00:00,19,10,9,ECO_300019380
642,Herenthoutsesteenweg 2,2022-04-03,22:00:00,15,14,1,ECO_300019380
642,Herenthoutsesteenweg 2,2022-04-03,23:00:00,8,6,2,ECO_300019380
642,Herenthoutsesteenweg 2,2022-04-04,00:00:00,6,3,3,ECO_300019380
642,Herenthoutsesteenweg 2,2022-04-04,01:00:00,6,6,0,ECO_300019380
642,Herenthoutsesteenweg 2,2022-04-04,02:00:00,0,0,0,ECO_300019380
642,Herenthoutsesteenweg 2,2022-04-04,03:00:00,1,0,1,ECO_300019380
642,Herenthoutsesteenweg 2,2022-04-04,04:00:00,0,0,0,ECO_300019380
642,Herenthoutsesteenweg 2,2022-04-04,05:00:00,0,0,0,ECO_300019380
642,Herenthoutsesteenweg 2,2022-04-04,06:00:00,0,0,0,ECO_300019380
642,Herenthoutsesteenweg 2,2022-04-04,07:00:00,11,10,1,ECO_300019380
642,Herenthoutsesteenweg 2,2022-04-04,08:00:00,24,23,1,ECO_300019380
642,Herenthoutsesteenweg 2,2022-04-04,09:00:00,60,57,3,ECO_300019380
642,Herenthoutsesteenweg 2,2022-04-04,10:00:00,53,52,1,ECO_300019380
642,Herenthoutsesteenweg 2,2022-04-04,11:00:00,30,30,0,ECO_300019380
642,Herenthoutsesteenweg 2,2022-04-04,12:00:00,22,19,3,ECO_300019380
642,Herenthoutsesteenweg 2,2022-04-04,13:00:00,19,19,0,ECO_300019380
642,Herenthoutsesteenweg 2,2022-04-04,14:00:00,15,13,2,ECO_300019380
642,Herenthoutsesteenweg 2,2022-04-04,15:00:00,14,13,1,ECO_300019380
642,Herenthoutsesteenweg 2,2022-04-04,16:00:00,28,23,5,ECO_300019380
642,Herenthoutsesteenweg 2,2022-04-04,17:00:00,20,17,3,ECO_300019380
642,Herenthoutsesteenweg 2,2022-04-04,18:00:00,45,43,2,ECO_300019380
642,Herenthoutsesteenweg 2,2022-04-04,19:00:00,26,23,3,ECO_300019380
642,Herenthoutsesteenweg 2,2022-04-04,20:00:00,16,16,0,ECO_300019380
642,Herenthoutsesteenweg 2,2022-04-04,21:00:00,8,5,3,ECO_300019380
642,Herenthoutsesteenweg 2,2022-04-04,22:00:00,7,6,1,ECO_300019380
642,Herenthoutsesteenweg 2,2022-04-04,23:00:00,3,2,1,ECO_300019380
642,Herenthoutsesteenweg 2,2022-04-05,00:00:00,8,8,0,ECO_300019380
642,Herenthoutsesteenweg 2,2022-04-05,01:00:00,2,0,2,ECO_300019380
642,Herenthoutsesteenweg 2,2022-04-05,02:00:00,2,2,0,ECO_300019380
642,Herenthoutsesteenweg 2,2022-04-05,03:00:00,1,0,1,ECO_300019380
642,Herenthoutsesteenweg 2,2022-04-05,04:00:00,0,0,0,ECO_300019380
642,Herenthoutsesteenweg 2,2022-04-05,05:00:00,0,0,0,ECO_300019380
642,Herenthoutsesteenweg 2,2022-04-05,06:00:00,0,0,0,ECO_300019380
642,Herenthoutsesteenweg 2,2022-04-05,07:00:00,8,7,1,ECO_300019380
642,Herenthoutsesteenweg 2,2022-04-05,08:00:00,10,9,1,ECO_300019380
642,Herenthoutsesteenweg 2,2022-04-05,09:00:00,51,49,2,ECO_300019380
642,Herenthoutsesteenweg 2,2022-04-05,10:00:00,47,47,0,ECO_300019380
642,Herenthoutsesteenweg 2,2022-04-05,11:00:00,31,31,0,ECO_300019380
642,Herenthoutsesteenweg 2,2022-04-05,12:00:00,23,23,0,ECO_300019380
642,Herenthoutsesteenweg 2,2022-04-05,13:00:00,21,17,4,ECO_300019380
642,Herenthoutsesteenweg 2,2022-04-05,14:00:00,21,19,2,ECO_300019380
642,Herenthoutsesteenweg 2,2022-04-05,15:00:00,37,34,3,ECO_300019380
642,Herenthoutsesteenweg 2,2022-04-05,16:00:00,36,33,3,ECO_300019380
642,Herenthoutsesteenweg 2,2022-04-05,17:00:00,39,33,6,ECO_300019380
642,Herenthoutsesteenweg 2,2022-04-05,18:00:00,44,41,3,ECO_300019380
642,Herenthoutsesteenweg 2,2022-04-05,19:00:00,40,35,5,ECO_300019380
642,Herenthoutsesteenweg 2,2022-04-05,20:00:00,26,22,4,ECO_300019380
642,Herenthoutsesteenweg 2,2022-04-05,21:00:00,15,12,3,ECO_300019380
642,Herenthoutsesteenweg 2,2022-04-05,22:00:00,9,8,1,ECO_300019380
642,Herenthoutsesteenweg 2,2022-04-05,23:00:00,5,4,1,ECO_300019380
642,Herenthoutsesteenweg 2,2022-04-06,00:00:00,11,11,0,ECO_300019380
642,Herenthoutsesteenweg 2,2022-04-06,01:00:00,2,1,1,ECO_300019380
642,Herenthoutsesteenweg 2,2022-04-06,02:00:00,5,5,0,ECO_300019380
642,Herenthoutsesteenweg 2,2022-04-06,03:00:00,0,0,0,ECO_300019380
642,Herenthoutsesteenweg 2,2022-04-06,04:00:00,1,1,0,ECO_300019380
642,Herenthoutsesteenweg 2,2022-04-06,05:00:00,0,0,0,ECO_300019380
642,Herenthoutsesteenweg 2,2022-04-06,06:00:00,1,0,1,ECO_300019380
642,Herenthoutsesteenweg 2,2022-04-06,07:00:00,14,14,0,ECO_300019380
642,Herenthoutsesteenweg 2,2022-04-06,08:00:00,26,25,1,ECO_300019380
642,Herenthoutsesteenweg 2,2022-04-06,09:00:00,50,49,1,ECO_300019380
642,Herenthoutsesteenweg 2,2022-04-06,10:00:00,43,42,1,ECO_300019380
642,Herenthoutsesteenweg 2,2022-04-06,11:00:00,36,35,1,ECO_300019380
642,Herenthoutsesteenweg 2,2022-04-06,12:00:00,41,37,4,ECO_300019380
642,Herenthoutsesteenweg 2,2022-04-06,13:00:00,34,32,2,ECO_300019380
642,Herenthoutsesteenweg 2,2022-04-06,14:00:00,35,30,5,ECO_300019380
642,Herenthoutsesteenweg 2,2022-04-06,15:00:00,47,45,2,ECO_300019380
642,Herenthoutsesteenweg 2,2022-04-06,16:00:00,39,35,4,ECO_300019380
642,Herenthoutsesteenweg 2,2022-04-06,17:00:00,29,24,5,ECO_300019380
642,Herenthoutsesteenweg 2,2022-04-06,18:00:00,65,57,8,ECO_300019380
642,Herenthoutsesteenweg 2,2022-04-06,19:00:00,30,25,5,ECO_300019380
642,Herenthoutsesteenweg 2,2022-04-06,20:00:00,18,17,1,ECO_300019380
642,Herenthoutsesteenweg 2,2022-04-06,21:00:00,7,7,0,ECO_300019380
642,Herenthoutsesteenweg 2,2022-04-06,22:00:00,18,17,1,ECO_300019380
642,Herenthoutsesteenweg 2,2022-04-06,23:00:00,6,4,2,ECO_300019380
642,Herenthoutsesteenweg 2,2022-04-07,00:00:00,10,8,2,ECO_300019380
642,Herenthoutsesteenweg 2,2022-04-07,01:00:00,0,0,0,ECO_300019380
642,Herenthoutsesteenweg 2,2022-04-07,02:00:00,2,1,1,ECO_300019380
642,Herenthoutsesteenweg 2,2022-04-07,03:00:00,5,5,0,ECO_300019380
642,Herenthoutsesteenweg 2,2022-04-07,04:00:00,0,0,0,ECO_300019380
642,Herenthoutsesteenweg 2,2022-04-07,05:00:00,0,0,0,ECO_300019380
642,Herenthoutsesteenweg 2,2022-04-07,06:00:00,0,0,0,ECO_300019380
642,Herenthoutsesteenweg 2,2022-04-07,07:00:00,7,7,0,ECO_300019380
642,Herenthoutsesteenweg 2,2022-04-07,08:00:00,13,12,1,ECO_300019380
642,Herenthoutsesteenweg 2,2022-04-07,09:00:00,32,32,0,ECO_300019380
642,Herenthoutsesteenweg 2,2022-04-07,10:00:00,18,18,0,ECO_300019380
642,Herenthoutsesteenweg 2,2022-04-07,11:00:00,13,12,1,ECO_300019380
642,Herenthoutsesteenweg 2,2022-04-07,12:00:00,10,10,0,ECO_300019380
642,Herenthoutsesteenweg 2,2022-04-07,13:00:00,14,13,1,ECO_300019380
642,Herenthoutsesteenweg 2,2022-04-07,14:00:00,22,20,2,ECO_300019380
642,Herenthoutsesteenweg 2,2022-04-07,15:00:00,30,27,3,ECO_300019380
642,Herenthoutsesteenweg 2,2022-04-07,16:00:00,45,40,5,ECO_300019380
642,Herenthoutsesteenweg 2,2022-04-07,17:00:00,37,35,2,ECO_300019380
642,Herenthoutsesteenweg 2,2022-04-07,18:00:00,46,42,4,ECO_300019380
642,Herenthoutsesteenweg 2,2022-04-07,19:00:00,27,24,3,ECO_300019380
642,Herenthoutsesteenweg 2,2022-04-07,20:00:00,23,23,0,ECO_300019380
642,Herenthoutsesteenweg 2,2022-04-07,21:00:00,18,14,4,ECO_300019380
642,Herenthoutsesteenweg 2,2022-04-07,22:00:00,11,9,2,ECO_300019380
642,Herenthoutsesteenweg 2,2022-04-07,23:00:00,7,4,3,ECO_300019380
642,Herenthoutsesteenweg 2,2022-04-08,00:00:00,12,12,0,ECO_300019380
642,Herenthoutsesteenweg 2,2022-04-08,01:00:00,1,1,0,ECO_300019380
642,Herenthoutsesteenweg 2,2022-04-08,02:00:00,2,0,2,ECO_300019380
642,Herenthoutsesteenweg 2,2022-04-08,03:00:00,0,0,0,ECO_300019380
642,Herenthoutsesteenweg 2,2022-04-08,04:00:00,1,0,1,ECO_300019380
642,Herenthoutsesteenweg 2,2022-04-08,05:00:00,0,0,0,ECO_300019380
642,Herenthoutsesteenweg 2,2022-04-08,06:00:00,0,0,0,ECO_300019380
642,Herenthoutsesteenweg 2,2022-04-08,07:00:00,9,9,0,ECO_300019380
642,Herenthoutsesteenweg 2,2022-04-08,08:00:00,20,17,3,ECO_300019380
642,Herenthoutsesteenweg 2,2022-04-08,09:00:00,43,40,3,ECO_300019380
642,Herenthoutsesteenweg 2,2022-04-08,10:00:00,54,52,2,ECO_300019380
642,Herenthoutsesteenweg 2,2022-04-08,11:00:00,55,54,1,ECO_300019380
642,Herenthoutsesteenweg 2,2022-04-08,12:00:00,64,60,4,ECO_300019380
642,Herenthoutsesteenweg 2,2022-04-08,13:00:00,45,41,4,ECO_300019380
642,Herenthoutsesteenweg 2,2022-04-08,14:00:00,39,37,2,ECO_300019380
642,Herenthoutsesteenweg 2,2022-04-08,15:00:00,46,45,1,ECO_300019380
642,Herenthoutsesteenweg 2,2022-04-08,16:00:00,69,65,4,ECO_300019380
642,Herenthoutsesteenweg 2,2022-04-08,17:00:00,62,56,6,ECO_300019380
642,Herenthoutsesteenweg 2,2022-04-08,18:00:00,77,70,7,ECO_300019380
642,Herenthoutsesteenweg 2,2022-04-08,19:00:00,40,35,5,ECO_300019380
642,Herenthoutsesteenweg 2,2022-04-08,20:00:00,39,34,5,ECO_300019380
642,Herenthoutsesteenweg 2,2022-04-08,21:00:00,24,22,2,ECO_300019380
642,Herenthoutsesteenweg 2,2022-04-08,22:00:00,17,11,6,ECO_300019380
642,Herenthoutsesteenweg 2,2022-04-08,23:00:00,14,12,2,ECO_300019380
642,Herenthoutsesteenweg 2,2022-04-09,00:00:00,9,8,1,ECO_300019380
642,Herenthoutsesteenweg 2,2022-04-09,01:00:00,7,6,1,ECO_300019380
642,Herenthoutsesteenweg 2,2022-04-09,02:00:00,8,4,4,ECO_300019380
642,Herenthoutsesteenweg 2,2022-04-09,03:00:00,10,8,2,ECO_300019380
642,Herenthoutsesteenweg 2,2022-04-09,04:00:00,2,2,0,ECO_300019380
642,Herenthoutsesteenweg 2,2022-04-09,05:00:00,1,1,0,ECO_300019380
642,Herenthoutsesteenweg 2,2022-04-09,06:00:00,1,1,0,ECO_300019380
642,Herenthoutsesteenweg 2,2022-04-09,07:00:00,1,1,0,ECO_300019380
642,Herenthoutsesteenweg 2,2022-04-09,08:00:00,4,4,0,ECO_300019380
642,Herenthoutsesteenweg 2,2022-04-09,09:00:00,11,11,0,ECO_300019380
642,Herenthoutsesteenweg 2,2022-04-09,10:00:00,22,22,0,ECO_300019380
642,Herenthoutsesteenweg 2,2022-04-09,11:00:00,42,38,4,ECO_300019380
642,Herenthoutsesteenweg 2,2022-04-09,12:00:00,62,57,5,ECO_300019380
642,Herenthoutsesteenweg 2,2022-04-09,13:00:00,61,57,4,ECO_300019380
642,Herenthoutsesteenweg 2,2022-04-09,14:00:00,73,69,4,ECO_300019380
642,Herenthoutsesteenweg 2,2022-04-09,15:00:00,74,66,8,ECO_300019380
642,Herenthoutsesteenweg 2,2022-04-09,16:00:00,82,75,7,ECO_300019380
642,Herenthoutsesteenweg 2,2022-04-09,17:00:00,42,38,4,ECO_300019380
642,Herenthoutsesteenweg 2,2022-04-09,18:00:00,51,49,2,ECO_300019380
642,Herenthoutsesteenweg 2,2022-04-09,19:00:00,26,23,3,ECO_300019380
642,Herenthoutsesteenweg 2,2022-04-09,20:00:00,39,34,5,ECO_300019380
642,Herenthoutsesteenweg 2,2022-04-09,21:00:00,25,23,2,ECO_300019380
642,Herenthoutsesteenweg 2,2022-04-09,22:00:00,19,17,2,ECO_300019380
642,Herenthoutsesteenweg 2,2022-04-09,23:00:00,10,10,0,ECO_300019380
642,Herenthoutsesteenweg 2,2022-04-10,00:00:00,5,4,1,ECO_300019380
642,Herenthoutsesteenweg 2,2022-04-10,01:00:00,5,2,3,ECO_300019380
642,Herenthoutsesteenweg 2,2022-04-10,02:00:00,4,1,3,ECO_300019380
642,Herenthoutsesteenweg 2,2022-04-10,03:00:00,2,2,0,ECO_300019380
642,Herenthoutsesteenweg 2,2022-04-10,04:00:00,5,5,0,ECO_300019380
642,Herenthoutsesteenweg 2,2022-04-10,05:00:00,0,0,0,ECO_300019380
642,Herenthoutsesteenweg 2,2022-04-10,06:00:00,0,0,0,ECO_300019380
642,Herenthoutsesteenweg 2,2022-04-10,07:00:00,2,1,1,ECO_300019380
642,Herenthoutsesteenweg 2,2022-04-10,08:00:00,4,4,0,ECO_300019380
642,Herenthoutsesteenweg 2,2022-04-10,09:00:00,13,13,0,ECO_300019380
642,Herenthoutsesteenweg 2,2022-04-10,10:00:00,44,36,8,ECO_300019380
642,Herenthoutsesteenweg 2,2022-04-10,11:00:00,75,74,1,ECO_300019380
642,Herenthoutsesteenweg 2,2022-04-10,12:00:00,101,90,11,ECO_300019380
642,Herenthoutsesteenweg 2,2022-04-10,13:00:00,101,88,13,ECO_300019380
642,Herenthoutsesteenweg 2,2022-04-10,14:00:00,90,82,8,ECO_300019380
642,Herenthoutsesteenweg 2,2022-04-10,15:00:00,66,61,5,ECO_300019380
642,Herenthoutsesteenweg 2,2022-04-10,16:00:00,90,77,13,ECO_300019380
642,Herenthoutsesteenweg 2,2022-04-10,17:00:00,64,52,12,ECO_300019380
642,Herenthoutsesteenweg 2,2022-04-10,18:00:00,53,50,3,ECO_300019380
642,Herenthoutsesteenweg 2,2022-04-10,19:00:00,49,46,3,ECO_300019380
642,Herenthoutsesteenweg 2,2022-04-10,20:00:00,26,21,5,ECO_300019380
642,Herenthoutsesteenweg 2,2022-04-10,21:00:00,22,19,3,ECO_300019380
642,Herenthoutsesteenweg 2,2022-04-10,22:00:00,10,10,0,ECO_300019380
642,Herenthoutsesteenweg 2,2022-04-10,23:00:00,10,9,1,ECO_300019380
642,Herenthoutsesteenweg 2,2022-04-11,00:00:00,8,8,0,ECO_300019380
642,Herenthoutsesteenweg 2,2022-04-11,01:00:00,4,2,2,ECO_300019380
642,Herenthoutsesteenweg 2,2022-04-11,02:00:00,1,1,0,ECO_300019380
642,Herenthoutsesteenweg 2,2022-04-11,03:00:00,0,0,0,ECO_300019380
642,Herenthoutsesteenweg 2,2022-04-11,04:00:00,1,1,0,ECO_300019380
642,Herenthoutsesteenweg 2,2022-04-11,05:00:00,0,0,0,ECO_300019380
642,Herenthoutsesteenweg 2,2022-04-11,06:00:00,1,1,0,ECO_300019380
642,Herenthoutsesteenweg 2,2022-04-11,07:00:00,18,17,1,ECO_300019380
642,Herenthoutsesteenweg 2,2022-04-11,08:00:00,33,31,2,ECO_300019380
642,Herenthoutsesteenweg 2,2022-04-11,09:00:00,69,63,6,ECO_300019380
642,Herenthoutsesteenweg 2,2022-04-11,10:00:00,80,75,5,ECO_300019380
642,Herenthoutsesteenweg 2,2022-04-11,11:00:00,52,50,2,ECO_300019380
642,Herenthoutsesteenweg 2,2022-04-11,12:00:00,70,63,7,ECO_300019380
642,Herenthoutsesteenweg 2,2022-04-11,13:00:00,36,32,4,ECO_300019380
642,Herenthoutsesteenweg 2,2022-04-11,14:00:00,62,58,4,ECO_300019380
642,Herenthoutsesteenweg 2,2022-04-11,15:00:00,133,124,9,ECO_300019380
642,Herenthoutsesteenweg 2,2022-04-11,16:00:00,113,107,6,ECO_300019380
642,Herenthoutsesteenweg 2,2022-04-11,17:00:00,111,103,8,ECO_300019380
642,Herenthoutsesteenweg 2,2022-04-11,18:00:00,136,114,22,ECO_300019380
642,Herenthoutsesteenweg 2,2022-04-11,19:00:00,79,70,9,ECO_300019380
642,Herenthoutsesteenweg 2,2022-04-11,20:00:00,65,57,8,ECO_300019380
642,Herenthoutsesteenweg 2,2022-04-11,21:00:00,38,29,9,ECO_300019380
642,Herenthoutsesteenweg 2,2022-04-11,22:00:00,17,15,2,ECO_300019380
642,Herenthoutsesteenweg 2,2022-04-11,23:00:00,6,5,1,ECO_300019380
642,Herenthoutsesteenweg 2,2022-04-12,00:00:00,12,12,0,ECO_300019380
642,Herenthoutsesteenweg 2,2022-04-12,01:00:00,8,0,8,ECO_300019380
642,Herenthoutsesteenweg 2,2022-04-12,02:00:00,4,3,1,ECO_300019380
642,Herenthoutsesteenweg 2,2022-04-12,03:00:00,1,1,0,ECO_300019380
642,Herenthoutsesteenweg 2,2022-04-12,04:00:00,0,0,0,ECO_300019380
642,Herenthoutsesteenweg 2,2022-04-12,05:00:00,0,0,0,ECO_300019380
642,Herenthoutsesteenweg 2,2022-04-12,06:00:00,2,2,0,ECO_300019380
642,Herenthoutsesteenweg 2,2022-04-12,07:00:00,19,17,2,ECO_300019380
642,Herenthoutsesteenweg 2,2022-04-12,08:00:00,46,42,4,ECO_300019380
642,Herenthoutsesteenweg 2,2022-04-12,09:00:00,96,90,6,ECO_300019380
642,Herenthoutsesteenweg 2,2022-04-12,10:00:00,80,78,2,ECO_300019380
642,Herenthoutsesteenweg 2,2022-04-12,11:00:00,78,71,7,ECO_300019380
642,Herenthoutsesteenweg 2,2022-04-12,12:00:00,110,107,3,ECO_300019380
642,Herenthoutsesteenweg 2,2022-04-12,13:00:00,84,83,1,ECO_300019380
642,Herenthoutsesteenweg 2,2022-04-12,14:00:00,116,112,4,ECO_300019380
642,Herenthoutsesteenweg 2,2022-04-12,15:00:00,173,161,12,ECO_300019380
642,Herenthoutsesteenweg 2,2022-04-12,16:00:00,164,151,13,ECO_300019380
642,Herenthoutsesteenweg 2,2022-04-12,17:00:00,147,133,14,ECO_300019380
642,Herenthoutsesteenweg 2,2022-04-12,18:00:00,171,156,15,ECO_300019380
642,Herenthoutsesteenweg 2,2022-04-12,19:00:00,111,97,14,ECO_300019380
642,Herenthoutsesteenweg 2,2022-04-12,20:00:00,71,59,12,ECO_300019380
642,Herenthoutsesteenweg 2,2022-04-12,21:00:00,48,44,4,ECO_300019380
642,Herenthoutsesteenweg 2,2022-04-12,22:00:00,36,25,11,ECO_300019380
642,Herenthoutsesteenweg 2,2022-04-12,23:00:00,20,20,0,ECO_300019380
642,Herenthoutsesteenweg 2,2022-04-13,00:00:00,21,16,5,ECO_300019380
642,Herenthoutsesteenweg 2,2022-04-13,01:00:00,5,3,2,ECO_300019380
642,Herenthoutsesteenweg 2,2022-04-13,02:00:00,1,1,0,ECO_300019380
642,Herenthoutsesteenweg 2,2022-04-13,03:00:00,0,0,0,ECO_300019380
642,Herenthoutsesteenweg 2,2022-04-13,04:00:00,0,0,0,ECO_300019380
642,Herenthoutsesteenweg 2,2022-04-13,05:00:00,0,0,0,ECO_300019380
642,Herenthoutsesteenweg 2,2022-04-13,06:00:00,1,1,0,ECO_300019380
642,Herenthoutsesteenweg 2,2022-04-13,07:00:00,18,16,2,ECO_300019380
642,Herenthoutsesteenweg 2,2022-04-13,08:00:00,35,32,3,ECO_300019380
642,Herenthoutsesteenweg 2,2022-04-13,09:00:00,76,71,5,ECO_300019380
642,Herenthoutsesteenweg 2,2022-04-13,10:00:00,55,51,4,ECO_300019380
642,Herenthoutsesteenweg 2,2022-04-13,11:00:00,48,45,3,ECO_300019380
642,Herenthoutsesteenweg 2,2022-04-13,12:00:00,56,50,6,ECO_300019380
642,Herenthoutsesteenweg 2,2022-04-13,13:00:00,49,46,3,ECO_300019380
642,Herenthoutsesteenweg 2,2022-04-13,14:00:00,53,45,8,ECO_300019380
642,Herenthoutsesteenweg 2,2022-04-13,15:00:00,75,55,20,ECO_300019380
642,Herenthoutsesteenweg 2,2022-04-13,16:00:00,75,61,14,ECO_300019380
642,Herenthoutsesteenweg 2,2022-04-13,17:00:00,28,24,4,ECO_300019380
642,Herenthoutsesteenweg 2,2022-04-13,18:00:00,80,72,8,ECO_300019380
642,Herenthoutsesteenweg 2,2022-04-13,19:00:00,67,62,5,ECO_300019380
642,Herenthoutsesteenweg 2,2022-04-13,20:00:00,39,34,5,ECO_300019380
642,Herenthoutsesteenweg 2,2022-04-13,21:00:00,38,32,6,ECO_300019380
642,Herenthoutsesteenweg 2,2022-04-13,22:00:00,39,30,9,ECO_300019380
642,Herenthoutsesteenweg 2,2022-04-13,23:00:00,21,21,0,ECO_300019380
642,Herenthoutsesteenweg 2,2022-04-14,00:00:00,18,17,1,ECO_300019380
642,Herenthoutsesteenweg 2,2022-04-14,01:00:00,5,3,2,ECO_300019380
642,Herenthoutsesteenweg 2,2022-04-14,02:00:00,7,6,1,ECO_300019380
642,Herenthoutsesteenweg 2,2022-04-14,03:00:00,4,2,2,ECO_300019380
642,Herenthoutsesteenweg 2,2022-04-14,04:00:00,1,0,1,ECO_300019380
642,Herenthoutsesteenweg 2,2022-04-14,05:00:00,0,0,0,ECO_300019380
642,Herenthoutsesteenweg 2,2022-04-14,06:00:00,2,2,0,ECO_300019380
642,Herenthoutsesteenweg 2,2022-04-14,07:00:00,17,17,0,ECO_300019380
642,Herenthoutsesteenweg 2,2022-04-14,08:00:00,30,29,1,ECO_300019380
642,Herenthoutsesteenweg 2,2022-04-14,09:00:00,72,66,6,ECO_300019380
642,Herenthoutsesteenweg 2,2022-04-14,10:00:00,73,71,2,ECO_300019380
642,Herenthoutsesteenweg 2,2022-04-14,11:00:00,67,64,3,ECO_300019380
642,Herenthoutsesteenweg 2,2022-04-14,12:00:00,106,103,3,ECO_300019380
642,Herenthoutsesteenweg 2,2022-04-14,13:00:00,99,93,6,ECO_300019380
642,Herenthoutsesteenweg 2,2022-04-14,14:00:00,101,96,5,ECO_300019380
642,Herenthoutsesteenweg 2,2022-04-14,15:00:00,141,136,5,ECO_300019380
642,Herenthoutsesteenweg 2,2022-04-14,16:00:00,151,141,10,ECO_300019380
642,Herenthoutsesteenweg 2,2022-04-14,17:00:00,111,99,12,ECO_300019380
642,Herenthoutsesteenweg 2,2022-04-14,18:00:00,131,113,18,ECO_300019380
642,Herenthoutsesteenweg 2,2022-04-14,19:00:00,85,75,10,ECO_300019380
642,Herenthoutsesteenweg 2,2022-04-14,20:00:00,77,70,7,ECO_300019380
642,Herenthoutsesteenweg 2,2022-04-14,21:00:00,57,49,8,ECO_300019380
642,Herenthoutsesteenweg 2,2022-04-14,22:00:00,23,21,2,ECO_300019380
642,Herenthoutsesteenweg 2,2022-04-14,23:00:00,24,23,1,ECO_300019380
642,Herenthoutsesteenweg 2,2022-04-15,00:00:00,17,15,2,ECO_300019380
642,Herenthoutsesteenweg 2,2022-04-15,01:00:00,5,3,2,ECO_300019380
642,Herenthoutsesteenweg 2,2022-04-15,02:00:00,4,3,1,ECO_300019380
642,Herenthoutsesteenweg 2,2022-04-15,03:00:00,0,0,0,ECO_300019380
642,Herenthoutsesteenweg 2,2022-04-15,04:00:00,3,2,1,ECO_300019380
642,Herenthoutsesteenweg 2,2022-04-15,05:00:00,0,0,0,ECO_300019380
642,Herenthoutsesteenweg 2,2022-04-15,06:00:00,3,3,0,ECO_300019380
642,Herenthoutsesteenweg 2,2022-04-15,07:00:00,13,11,2,ECO_300019380
642,Herenthoutsesteenweg 2,2022-04-15,08:00:00,36,33,3,ECO_300019380
642,Herenthoutsesteenweg 2,2022-04-15,09:00:00,66,62,4,ECO_300019380
642,Herenthoutsesteenweg 2,2022-04-15,10:00:00,88,85,3,ECO_300019380
642,Herenthoutsesteenweg 2,2022-04-15,11:00:00,91,89,2,ECO_300019380
642,Herenthoutsesteenweg 2,2022-04-15,12:00:00,115,109,6,ECO_300019380
642,Herenthoutsesteenweg 2,2022-04-15,13:00:00,94,87,7,ECO_300019380
642,Herenthoutsesteenweg 2,2022-04-15,14:00:00,54,46,8,ECO_300019380
642,Herenthoutsesteenweg 2,2022-04-15,15:00:00,92,90,2,ECO_300019380
642,Herenthoutsesteenweg 2,2022-04-15,16:00:00,127,122,5,ECO_300019380
642,Herenthoutsesteenweg 2,2022-04-15,17:00:00,137,125,12,ECO_300019380
642,Herenthoutsesteenweg 2,2022-04-15,18:00:00,118,103,15,ECO_300019380
642,Herenthoutsesteenweg 2,2022-04-15,19:00:00,94,84,10,ECO_300019380
642,Herenthoutsesteenweg 2,2022-04-15,20:00:00,78,72,6,ECO_300019380
642,Herenthoutsesteenweg 2,2022-04-15,21:00:00,45,40,5,ECO_300019380
642,Herenthoutsesteenweg 2,2022-04-15,22:00:00,49,44,5,ECO_300019380
642,Herenthoutsesteenweg 2,2022-04-15,23:00:00,27,22,5,ECO_300019380
642,Herenthoutsesteenweg 2,2022-04-16,00:00:00,12,10,2,ECO_300019380
642,Herenthoutsesteenweg 2,2022-04-16,01:00:00,9,4,5,ECO_300019380
642,Herenthoutsesteenweg 2,2022-04-16,02:00:00,5,4,1,ECO_300019380
642,Herenthoutsesteenweg 2,2022-04-16,03:00:00,5,4,1,ECO_300019380
642,Herenthoutsesteenweg 2,2022-04-16,04:00:00,3,2,1,ECO_300019380
642,Herenthoutsesteenweg 2,2022-04-16,05:00:00,0,0,0,ECO_300019380
642,Herenthoutsesteenweg 2,2022-04-16,06:00:00,1,1,0,ECO_300019380
642,Herenthoutsesteenweg 2,2022-04-16,07:00:00,8,6,2,ECO_300019380
642,Herenthoutsesteenweg 2,2022-04-16,08:00:00,10,9,1,ECO_300019380
642,Herenthoutsesteenweg 2,2022-04-16,09:00:00,12,11,1,ECO_300019380
642,Herenthoutsesteenweg 2,2022-04-16,10:00:00,37,35,2,ECO_300019380
642,Herenthoutsesteenweg 2,2022-04-16,11:00:00,73,72,1,ECO_300019380
642,Herenthoutsesteenweg 2,2022-04-16,12:00:00,88,80,8,ECO_300019380
642,Herenthoutsesteenweg 2,2022-04-16,13:00:00,104,101,3,ECO_300019380
642,Herenthoutsesteenweg 2,2022-04-16,14:00:00,91,83,8,ECO_300019380
642,Herenthoutsesteenweg 2,2022-04-16,15:00:00,187,170,17,ECO_300019380
642,Herenthoutsesteenweg 2,2022-04-16,16:00:00,179,163,16,ECO_300019380
642,Herenthoutsesteenweg 2,2022-04-16,17:00:00,173,152,21,ECO_300019380
642,Herenthoutsesteenweg 2,2022-04-16,18:00:00,108,89,19,ECO_300019380
642,Herenthoutsesteenweg 2,2022-04-16,19:00:00,89,77,12,ECO_300019380
642,Herenthoutsesteenweg 2,2022-04-16,20:00:00,57,48,9,ECO_300019380
642,Herenthoutsesteenweg 2,2022-04-16,21:00:00,55,51,4,ECO_300019380
642,Herenthoutsesteenweg 2,2022-04-16,22:00:00,40,32,8,ECO_300019380
642,Herenthoutsesteenweg 2,2022-04-16,23:00:00,23,18,5,ECO_300019380
642,Herenthoutsesteenweg 2,2022-04-17,00:00:00,28,26,2,ECO_300019380
642,Herenthoutsesteenweg 2,2022-04-17,01:00:00,11,9,2,ECO_300019380
642,Herenthoutsesteenweg 2,2022-04-17,02:00:00,36,33,3,ECO_300019380
642,Herenthoutsesteenweg 2,2022-04-17,03:00:00,4,4,0,ECO_300019380
642,Herenthoutsesteenweg 2,2022-04-17,04:00:00,1,1,0,ECO_300019380
642,Herenthoutsesteenweg 2,2022-04-17,05:00:00,3,3,0,ECO_300019380
642,Herenthoutsesteenweg 2,2022-04-17,06:00:00,6,0,6,ECO_300019380
642,Herenthoutsesteenweg 2,2022-04-17,07:00:00,4,3,1,ECO_300019380
642,Herenthoutsesteenweg 2,2022-04-17,08:00:00,8,7,1,ECO_300019380
642,Herenthoutsesteenweg 2,2022-04-17,09:00:00,11,10,1,ECO_300019380
642,Herenthoutsesteenweg 2,2022-04-17,10:00:00,47,46,1,ECO_300019380
642,Herenthoutsesteenweg 2,2022-04-17,11:00:00,109,100,9,ECO_300019380
642,Herenthoutsesteenweg 2,2022-04-17,12:00:00,110,90,20,ECO_300019380
642,Herenthoutsesteenweg 2,2022-04-17,13:00:00,97,80,17,ECO_300019380
642,Herenthoutsesteenweg 2,2022-04-17,14:00:00,62,58,4,ECO_300019380
642,Herenthoutsesteenweg 2,2022-04-17,15:00:00,135,124,11,ECO_300019380
642,Herenthoutsesteenweg 2,2022-04-17,16:00:00,145,140,5,ECO_300019380
642,Herenthoutsesteenweg 2,2022-04-17,17:00:00,114,93,21,ECO_300019380
642,Herenthoutsesteenweg 2,2022-04-17,18:00:00,97,87,10,ECO_300019380
642,Herenthoutsesteenweg 2,2022-04-17,19:00:00,96,86,10,ECO_300019380
642,Herenthoutsesteenweg 2,2022-04-17,20:00:00,76,61,15,ECO_300019380
642,Herenthoutsesteenweg 2,2022-04-17,21:00:00,62,55,7,ECO_300019380
642,Herenthoutsesteenweg 2,2022-04-17,22:00:00,38,31,7,ECO_300019380
642,Herenthoutsesteenweg 2,2022-04-17,23:00:00,13,13,0,ECO_300019380
642,Herenthoutsesteenweg 2,2022-04-18,00:00:00,10,9,1,ECO_300019380
642,Herenthoutsesteenweg 2,2022-04-18,01:00:00,11,11,0,ECO_300019380
642,Herenthoutsesteenweg 2,2022-04-18,02:00:00,5,3,2,ECO_300019380
642,Herenthoutsesteenweg 2,2022-04-18,03:00:00,0,0,0,ECO_300019380
642,Herenthoutsesteenweg 2,2022-04-18,04:00:00,8,8,0,ECO_300019380
642,Herenthoutsesteenweg 2,2022-04-18,05:00:00,7,6,1,ECO_300019380
642,Herenthoutsesteenweg 2,2022-04-18,06:00:00,5,5,0,ECO_300019380
642,Herenthoutsesteenweg 2,2022-04-18,07:00:00,5,5,0,ECO_300019380
642,Herenthoutsesteenweg 2,2022-04-18,08:00:00,5,5,0,ECO_300019380
642,Herenthoutsesteenweg 2,2022-04-18,09:00:00,9,7,2,ECO_300019380
642,Herenthoutsesteenweg 2,2022-04-18,10:00:00,47,36,11,ECO_300019380
642,Herenthoutsesteenweg 2,2022-04-18,11:00:00,60,56,4,ECO_300019380
642,Herenthoutsesteenweg 2,2022-04-18,12:00:00,101,86,15,ECO_300019380
642,Herenthoutsesteenweg 2,2022-04-18,13:00:00,121,115,6,ECO_300019380
642,Herenthoutsesteenweg 2,2022-04-18,14:00:00,113,105,8,ECO_300019380
642,Herenthoutsesteenweg 2,2022-04-18,15:00:00,163,148,15,ECO_300019380
642,Herenthoutsesteenweg 2,2022-04-18,16:00:00,246,232,14,ECO_300019380
642,Herenthoutsesteenweg 2,2022-04-18,17:00:00,150,132,18,ECO_300019380
642,Herenthoutsesteenweg 2,2022-04-18,18:00:00,151,128,23,ECO_300019380
642,Herenthoutsesteenweg 2,2022-04-18,19:00:00,93,84,9,ECO_300019380
642,Herenthoutsesteenweg 2,2022-04-18,20:00:00,67,61,6,ECO_300019380
642,Herenthoutsesteenweg 2,2022-04-18,21:00:00,62,57,5,ECO_300019380
642,Herenthoutsesteenweg 2,2022-04-18,22:00:00,23,20,3,ECO_300019380
642,Herenthoutsesteenweg 2,2022-04-18,23:00:00,6,5,1,ECO_300019380
642,Herenthoutsesteenweg 2,2022-04-19,00:00:00,4,4,0,ECO_300019380
642,Herenthoutsesteenweg 2,2022-04-19,01:00:00,2,1,1,ECO_300019380
642,Herenthoutsesteenweg 2,2022-04-19,02:00:00,1,0,1,ECO_300019380
642,Herenthoutsesteenweg 2,2022-04-19,03:00:00,0,0,0,ECO_300019380
642,Herenthoutsesteenweg 2,2022-04-19,04:00:00,0,0,0,ECO_300019380
642,Herenthoutsesteenweg 2,2022-04-19,05:00:00,0,0,0,ECO_300019380
642,Herenthoutsesteenweg 2,2022-04-19,06:00:00,4,4,0,ECO_300019380
642,Herenthoutsesteenweg 2,2022-04-19,07:00:00,19,18,1,ECO_300019380
642,Herenthoutsesteenweg 2,2022-04-19,08:00:00,41,38,3,ECO_300019380
642,Herenthoutsesteenweg 2,2022-04-19,09:00:00,187,184,3,ECO_300019380
642,Herenthoutsesteenweg 2,2022-04-19,10:00:00,565,556,9,ECO_300019380
642,Herenthoutsesteenweg 2,2022-04-19,11:00:00,86,83,3,ECO_300019380
642,Herenthoutsesteenweg 2,2022-04-19,12:00:00,81,77,4,ECO_300019380
642,Herenthoutsesteenweg 2,2022-04-19,13:00:00,58,54,4,ECO_300019380
642,Herenthoutsesteenweg 2,2022-04-19,14:00:00,106,101,5,ECO_300019380
642,Herenthoutsesteenweg 2,2022-04-19,15:00:00,141,132,9,ECO_300019380
642,Herenthoutsesteenweg 2,2022-04-19,16:00:00,141,131,10,ECO_300019380
642,Herenthoutsesteenweg 2,2022-04-19,17:00:00,165,146,19,ECO_300019380
642,Herenthoutsesteenweg 2,2022-04-19,18:00:00,179,172,7,ECO_300019380
642,Herenthoutsesteenweg 2,2022-04-19,19:00:00,119,109,10,ECO_300019380
642,Herenthoutsesteenweg 2,2022-04-19,20:00:00,80,69,11,ECO_300019380
642,Herenthoutsesteenweg 2,2022-04-19,21:00:00,43,36,7,ECO_300019380
642,Herenthoutsesteenweg 2,2022-04-19,22:00:00,34,32,2,ECO_300019380
642,Herenthoutsesteenweg 2,2022-04-19,23:00:00,23,20,3,ECO_300019380
642,Herenthoutsesteenweg 2,2022-04-20,00:00:00,21,20,1,ECO_300019380
642,Herenthoutsesteenweg 2,2022-04-20,01:00:00,5,3,2,ECO_300019380
642,Herenthoutsesteenweg 2,2022-04-20,02:00:00,0,0,0,ECO_300019380
642,Herenthoutsesteenweg 2,2022-04-20,03:00:00,0,0,0,ECO_300019380
642,Herenthoutsesteenweg 2,2022-04-20,04:00:00,0,0,0,ECO_300019380
642,Herenthoutsesteenweg 2,2022-04-20,05:00:00,0,0,0,ECO_300019380
642,Herenthoutsesteenweg 2,2022-04-20,06:00:00,2,2,0,ECO_300019380
642,Herenthoutsesteenweg 2,2022-04-20,07:00:00,24,22,2,ECO_300019380
642,Herenthoutsesteenweg 2,2022-04-20,08:00:00,44,43,1,ECO_300019380
642,Herenthoutsesteenweg 2,2022-04-20,09:00:00,152,144,8,ECO_300019380
642,Herenthoutsesteenweg 2,2022-04-20,10:00:00,501,494,7,ECO_300019380
642,Herenthoutsesteenweg 2,2022-04-20,11:00:00,94,88,6,ECO_300019380
642,Herenthoutsesteenweg 2,2022-04-20,12:00:00,84,80,4,ECO_300019380
642,Herenthoutsesteenweg 2,2022-04-20,13:00:00,69,64,5,ECO_300019380
642,Herenthoutsesteenweg 2,2022-04-20,14:00:00,135,127,8,ECO_300019380
642,Herenthoutsesteenweg 2,2022-04-20,15:00:00,139,127,12,ECO_300019380
642,Herenthoutsesteenweg 2,2022-04-20,16:00:00,171,167,4,ECO_300019380
642,Herenthoutsesteenweg 2,2022-04-20,17:00:00,124,106,18,ECO_300019380
642,Herenthoutsesteenweg 2,2022-04-20,18:00:00,127,114,13,ECO_300019380
642,Herenthoutsesteenweg 2,2022-04-20,19:00:00,135,124,11,ECO_300019380
642,Herenthoutsesteenweg 2,2022-04-20,20:00:00,76,67,9,ECO_300019380
642,Herenthoutsesteenweg 2,2022-04-20,21:00:00,49,45,4,ECO_300019380
642,Herenthoutsesteenweg 2,2022-04-20,22:00:00,37,30,7,ECO_300019380
642,Herenthoutsesteenweg 2,2022-04-20,23:00:00,20,17,3,ECO_300019380
642,Herenthoutsesteenweg 2,2022-04-21,00:00:00,20,14,6,ECO_300019380
642,Herenthoutsesteenweg 2,2022-04-21,01:00:00,1,1,0,ECO_300019380
642,Herenthoutsesteenweg 2,2022-04-21,02:00:00,1,1,0,ECO_300019380
642,Herenthoutsesteenweg 2,2022-04-21,03:00:00,3,1,2,ECO_300019380
642,Herenthoutsesteenweg 2,2022-04-21,04:00:00,3,3,0,ECO_300019380
642,Herenthoutsesteenweg 2,2022-04-21,05:00:00,0,0,0,ECO_300019380
642,Herenthoutsesteenweg 2,2022-04-21,06:00:00,5,3,2,ECO_300019380
642,Herenthoutsesteenweg 2,2022-04-21,07:00:00,25,25,0,ECO_300019380
642,Herenthoutsesteenweg 2,2022-04-21,08:00:00,52,49,3,ECO_300019380
642,Herenthoutsesteenweg 2,2022-04-21,09:00:00,187,180,7,ECO_300019380
642,Herenthoutsesteenweg 2,2022-04-21,10:00:00,486,481,5,ECO_300019380
642,Herenthoutsesteenweg 2,2022-04-21,11:00:00,103,97,6,ECO_300019380
642,Herenthoutsesteenweg 2,2022-04-21,12:00:00,80,74,6,ECO_300019380
642,Herenthoutsesteenweg 2,2022-04-21,13:00:00,70,67,3,ECO_300019380
642,Herenthoutsesteenweg 2,2022-04-21,14:00:00,92,86,6,ECO_300019380
642,Herenthoutsesteenweg 2,2022-04-21,15:00:00,115,108,7,ECO_300019380
642,Herenthoutsesteenweg 2,2022-04-21,16:00:00,134,124,10,ECO_300019380
642,Herenthoutsesteenweg 2,2022-04-21,17:00:00,148,127,21,ECO_300019380
642,Herenthoutsesteenweg 2,2022-04-21,18:00:00,148,131,17,ECO_300019380
642,Herenthoutsesteenweg 2,2022-04-21,19:00:00,124,108,16,ECO_300019380
642,Herenthoutsesteenweg 2,2022-04-21,20:00:00,66,61,5,ECO_300019380
642,Herenthoutsesteenweg 2,2022-04-21,21:00:00,45,37,8,ECO_300019380
642,Herenthoutsesteenweg 2,2022-04-21,22:00:00,28,23,5,ECO_300019380
642,Herenthoutsesteenweg 2,2022-04-21,23:00:00,17,15,2,ECO_300019380
642,Herenthoutsesteenweg 2,2022-04-22,00:00:00,15,12,3,ECO_300019380
642,Herenthoutsesteenweg 2,2022-04-22,01:00:00,3,2,1,ECO_300019380
642,Herenthoutsesteenweg 2,2022-04-22,02:00:00,0,0,0,ECO_300019380
642,Herenthoutsesteenweg 2,2022-04-22,03:00:00,0,0,0,ECO_300019380
642,Herenthoutsesteenweg 2,2022-04-22,04:00:00,0,0,0,ECO_300019380
642,Herenthoutsesteenweg 2,2022-04-22,05:00:00,0,0,0,ECO_300019380
642,Herenthoutsesteenweg 2,2022-04-22,06:00:00,1,1,0,ECO_300019380
642,Herenthoutsesteenweg 2,2022-04-22,07:00:00,20,19,1,ECO_300019380
642,Herenthoutsesteenweg 2,2022-04-22,08:00:00,45,44,1,ECO_300019380
642,Herenthoutsesteenweg 2,2022-04-22,09:00:00,149,147,2,ECO_300019380
642,Herenthoutsesteenweg 2,2022-04-22,10:00:00,519,511,8,ECO_300019380
642,Herenthoutsesteenweg 2,2022-04-22,11:00:00,146,143,3,ECO_300019380
642,Herenthoutsesteenweg 2,2022-04-22,12:00:00,125,114,11,ECO_300019380
642,Herenthoutsesteenweg 2,2022-04-22,13:00:00,92,87,5,ECO_300019380
642,Herenthoutsesteenweg 2,2022-04-22,14:00:00,61,55,6,ECO_300019380
642,Herenthoutsesteenweg 2,2022-04-22,15:00:00,83,80,3,ECO_300019380
642,Herenthoutsesteenweg 2,2022-04-22,16:00:00,93,85,8,ECO_300019380
642,Herenthoutsesteenweg 2,2022-04-22,17:00:00,147,135,12,ECO_300019380
642,Herenthoutsesteenweg 2,2022-04-22,18:00:00,90,83,7,ECO_300019380
642,Herenthoutsesteenweg 2,2022-04-22,19:00:00,114,100,14,ECO_300019380
642,Herenthoutsesteenweg 2,2022-04-22,20:00:00,66,56,10,ECO_300019380
642,Herenthoutsesteenweg 2,2022-04-22,21:00:00,48,42,6,ECO_300019380
642,Herenthoutsesteenweg 2,2022-04-22,22:00:00,27,23,4,ECO_300019380
642,Herenthoutsesteenweg 2,2022-04-22,23:00:00,41,35,6,ECO_300019380
642,Herenthoutsesteenweg 2,2022-04-23,00:00:00,23,23,0,ECO_300019380
642,Herenthoutsesteenweg 2,2022-04-23,01:00:00,1,1,0,ECO_300019380
642,Herenthoutsesteenweg 2,2022-04-23,02:00:00,9,9,0,ECO_300019380
642,Herenthoutsesteenweg 2,2022-04-23,03:00:00,5,5,0,ECO_300019380
642,Herenthoutsesteenweg 2,2022-04-23,04:00:00,4,2,2,ECO_300019380
642,Herenthoutsesteenweg 2,2022-04-23,05:00:00,4,0,4,ECO_300019380
642,Herenthoutsesteenweg 2,2022-04-23,06:00:00,1,0,1,ECO_300019380
642,Herenthoutsesteenweg 2,2022-04-23,07:00:00,4,4,0,ECO_300019380
642,Herenthoutsesteenweg 2,2022-04-23,08:00:00,8,7,1,ECO_300019380
642,Herenthoutsesteenweg 2,2022-04-23,09:00:00,22,19,3,ECO_300019380
642,Herenthoutsesteenweg 2,2022-04-23,10:00:00,50,48,2,ECO_300019380
642,Herenthoutsesteenweg 2,2022-04-23,11:00:00,82,77,5,ECO_300019380
642,Herenthoutsesteenweg 2,2022-04-23,12:00:00,123,117,6,ECO_300019380
642,Herenthoutsesteenweg 2,2022-04-23,13:00:00,120,109,11,ECO_300019380
642,Herenthoutsesteenweg 2,2022-04-23,14:00:00,113,104,9,ECO_300019380
642,Herenthoutsesteenweg 2,2022-04-23,15:00:00,155,135,20,ECO_300019380
642,Herenthoutsesteenweg 2,2022-04-23,16:00:00,155,140,15,ECO_300019380
642,Herenthoutsesteenweg 2,2022-04-23,17:00:00,130,114,16,ECO_300019380
642,Herenthoutsesteenweg 2,2022-04-23,18:00:00,85,73,12,ECO_300019380
642,Herenthoutsesteenweg 2,2022-04-23,19:00:00,49,42,7,ECO_300019380
642,Herenthoutsesteenweg 2,2022-04-23,20:00:00,44,40,4,ECO_300019380
642,Herenthoutsesteenweg 2,2022-04-23,21:00:00,46,41,5,ECO_300019380
642,Herenthoutsesteenweg 2,2022-04-23,22:00:00,41,35,6,ECO_300019380
642,Herenthoutsesteenweg 2,2022-04-23,23:00:00,52,48,4,ECO_300019380
642,Herenthoutsesteenweg 2,2022-04-24,00:00:00,36,34,2,ECO_300019380
642,Herenthoutsesteenweg 2,2022-04-24,01:00:00,17,14,3,ECO_300019380
642,Herenthoutsesteenweg 2,2022-04-24,02:00:00,6,6,0,ECO_300019380
642,Herenthoutsesteenweg 2,2022-04-24,03:00:00,8,8,0,ECO_300019380
642,Herenthoutsesteenweg 2,2022-04-24,04:00:00,4,3,1,ECO_300019380
642,Herenthoutsesteenweg 2,2022-04-24,05:00:00,3,1,2,ECO_300019380
642,Herenthoutsesteenweg 2,2022-04-24,06:00:00,2,1,1,ECO_300019380
642,Herenthoutsesteenweg 2,2022-04-24,07:00:00,3,2,1,ECO_300019380
642,Herenthoutsesteenweg 2,2022-04-24,08:00:00,10,10,0,ECO_300019380
642,Herenthoutsesteenweg 2,2022-04-24,09:00:00,21,18,3,ECO_300019380
642,Herenthoutsesteenweg 2,2022-04-24,10:00:00,53,53,0,ECO_300019380
642,Herenthoutsesteenweg 2,2022-04-24,11:00:00,98,91,7,ECO_300019380
642,Herenthoutsesteenweg 2,2022-04-24,12:00:00,120,103,17,ECO_300019380
642,Herenthoutsesteenweg 2,2022-04-24,13:00:00,116,92,24,ECO_300019380
642,Herenthoutsesteenweg 2,2022-04-24,14:00:00,94,83,11,ECO_300019380
642,Herenthoutsesteenweg 2,2022-04-24,15:00:00,142,124,18,ECO_300019380
642,Herenthoutsesteenweg 2,2022-04-24,16:00:00,176,170,6,ECO_300019380
642,Herenthoutsesteenweg 2,2022-04-24,17:00:00,84,75,9,ECO_300019380
642,Herenthoutsesteenweg 2,2022-04-24,18:00:00,74,66,8,ECO_300019380
642,Herenthoutsesteenweg 2,2022-04-24,19:00:00,81,72,9,ECO_300019380
642,Herenthoutsesteenweg 2,2022-04-24,20:00:00,64,56,8,ECO_300019380
642,Herenthoutsesteenweg 2,2022-04-24,21:00:00,36,33,3,ECO_300019380
642,Herenthoutsesteenweg 2,2022-04-24,22:00:00,22,21,1,ECO_300019380
642,Herenthoutsesteenweg 2,2022-04-24,23:00:00,16,15,1,ECO_300019380
642,Herenthoutsesteenweg 2,2022-04-25,00:00:00,7,6,1,ECO_300019380
642,Herenthoutsesteenweg 2,2022-04-25,01:00:00,4,3,1,ECO_300019380
642,Herenthoutsesteenweg 2,2022-04-25,02:00:00,0,0,0,ECO_300019380
642,Herenthoutsesteenweg 2,2022-04-25,03:00:00,0,0,0,ECO_300019380
642,Herenthoutsesteenweg 2,2022-04-25,04:00:00,0,0,0,ECO_300019380
642,Herenthoutsesteenweg 2,2022-04-25,05:00:00,0,0,0,ECO_300019380
642,Herenthoutsesteenweg 2,2022-04-25,06:00:00,3,3,0,ECO_300019380
642,Herenthoutsesteenweg 2,2022-04-25,07:00:00,17,16,1,ECO_300019380
642,Herenthoutsesteenweg 2,2022-04-25,08:00:00,36,34,2,ECO_300019380
642,Herenthoutsesteenweg 2,2022-04-25,09:00:00,172,170,2,ECO_300019380
642,Herenthoutsesteenweg 2,2022-04-25,10:00:00,516,509,7,ECO_300019380
642,Herenthoutsesteenweg 2,2022-04-25,11:00:00,70,66,4,ECO_300019380
642,Herenthoutsesteenweg 2,2022-04-25,12:00:00,68,67,1,ECO_300019380
642,Herenthoutsesteenweg 2,2022-04-25,13:00:00,44,41,3,ECO_300019380
642,Herenthoutsesteenweg 2,2022-04-25,14:00:00,48,43,5,ECO_300019380
642,Herenthoutsesteenweg 2,2022-04-25,15:00:00,74,70,4,ECO_300019380
642,Herenthoutsesteenweg 2,2022-04-25,16:00:00,74,68,6,ECO_300019380
642,Herenthoutsesteenweg 2,2022-04-25,17:00:00,117,112,5,ECO_300019380
642,Herenthoutsesteenweg 2,2022-04-25,18:00:00,109,94,15,ECO_300019380
642,Herenthoutsesteenweg 2,2022-04-25,19:00:00,69,61,8,ECO_300019380
642,Herenthoutsesteenweg 2,2022-04-25,20:00:00,48,43,5,ECO_300019380
642,Herenthoutsesteenweg 2,2022-04-25,21:00:00,30,29,1,ECO_300019380
642,Herenthoutsesteenweg 2,2022-04-25,22:00:00,29,27,2,ECO_300019380
642,Herenthoutsesteenweg 2,2022-04-25,23:00:00,13,11,2,ECO_300019380
642,Herenthoutsesteenweg 2,2022-04-26,00:00:00,14,12,2,ECO_300019380
642,Herenthoutsesteenweg 2,2022-04-26,01:00:00,6,4,2,ECO_300019380
642,Herenthoutsesteenweg 2,2022-04-26,02:00:00,1,0,1,ECO_300019380
642,Herenthoutsesteenweg 2,2022-04-26,03:00:00,0,0,0,ECO_300019380
642,Herenthoutsesteenweg 2,2022-04-26,04:00:00,0,0,0,ECO_300019380
642,Herenthoutsesteenweg 2,2022-04-26,05:00:00,1,1,0,ECO_300019380
642,Herenthoutsesteenweg 2,2022-04-26,06:00:00,2,2,0,ECO_300019380
642,Herenthoutsesteenweg 2,2022-04-26,07:00:00,18,16,2,ECO_300019380
642,Herenthoutsesteenweg 2,2022-04-26,08:00:00,55,50,5,ECO_300019380
642,Herenthoutsesteenweg 2,2022-04-26,09:00:00,179,174,5,ECO_300019380
642,Herenthoutsesteenweg 2,2022-04-26,10:00:00,518,512,6,ECO_300019380
642,Herenthoutsesteenweg 2,2022-04-26,11:00:00,95,93,2,ECO_300019380
642,Herenthoutsesteenweg 2,2022-04-26,12:00:00,84,81,3,ECO_300019380
642,Herenthoutsesteenweg 2,2022-04-26,13:00:00,74,66,8,ECO_300019380
642,Herenthoutsesteenweg 2,2022-04-26,14:00:00,76,71,5,ECO_300019380
642,Herenthoutsesteenweg 2,2022-04-26,15:00:00,96,91,5,ECO_300019380
642,Herenthoutsesteenweg 2,2022-04-26,16:00:00,94,90,4,ECO_300019380
642,Herenthoutsesteenweg 2,2022-04-26,17:00:00,135,125,10,ECO_300019380
642,Herenthoutsesteenweg 2,2022-04-26,18:00:00,161,141,20,ECO_300019380
642,Herenthoutsesteenweg 2,2022-04-26,19:00:00,100,91,9,ECO_300019380
642,Herenthoutsesteenweg 2,2022-04-26,20:00:00,83,72,11,ECO_300019380
642,Herenthoutsesteenweg 2,2022-04-26,21:00:00,48,43,5,ECO_300019380
642,Herenthoutsesteenweg 2,2022-04-26,22:00:00,31,24,7,ECO_300019380
642,Herenthoutsesteenweg 2,2022-04-26,23:00:00,17,15,2,ECO_300019380
642,Herenthoutsesteenweg 2,2022-04-27,00:00:00,17,14,3,ECO_300019380
642,Herenthoutsesteenweg 2,2022-04-27,01:00:00,4,2,2,ECO_300019380
642,Herenthoutsesteenweg 2,2022-04-27,02:00:00,0,0,0,ECO_300019380
642,Herenthoutsesteenweg 2,2022-04-27,03:00:00,0,0,0,ECO_300019380
642,Herenthoutsesteenweg 2,2022-04-27,04:00:00,0,0,0,ECO_300019380
642,Herenthoutsesteenweg 2,2022-04-27,05:00:00,0,0,0,ECO_300019380
642,Herenthoutsesteenweg 2,2022-04-27,06:00:00,2,2,0,ECO_300019380
642,Herenthoutsesteenweg 2,2022-04-27,07:00:00,21,18,3,ECO_300019380
642,Herenthoutsesteenweg 2,2022-04-27,08:00:00,43,40,3,ECO_300019380
642,Herenthoutsesteenweg 2,2022-04-27,09:00:00,185,175,10,ECO_300019380
642,Herenthoutsesteenweg 2,2022-04-27,10:00:00,526,510,16,ECO_300019380
642,Herenthoutsesteenweg 2,2022-04-27,11:00:00,82,79,3,ECO_300019380
642,Herenthoutsesteenweg 2,2022-04-27,12:00:00,78,72,6,ECO_300019380
642,Herenthoutsesteenweg 2,2022-04-27,13:00:00,85,79,6,ECO_300019380
642,Herenthoutsesteenweg 2,2022-04-27,14:00:00,161,148,13,ECO_300019380
642,Herenthoutsesteenweg 2,2022-04-27,15:00:00,155,141,14,ECO_300019380
642,Herenthoutsesteenweg 2,2022-04-27,16:00:00,173,160,13,ECO_300019380
642,Herenthoutsesteenweg 2,2022-04-27,17:00:00,115,108,7,ECO_300019380
642,Herenthoutsesteenweg 2,2022-04-27,18:00:00,149,137,12,ECO_300019380
642,Herenthoutsesteenweg 2,2022-04-27,19:00:00,138,126,12,ECO_300019380
642,Herenthoutsesteenweg 2,2022-04-27,20:00:00,87,75,12,ECO_300019380
642,Herenthoutsesteenweg 2,2022-04-27,21:00:00,58,55,3,ECO_300019380
642,Herenthoutsesteenweg 2,2022-04-27,22:00:00,50,30,20,ECO_300019380
642,Herenthoutsesteenweg 2,2022-04-27,23:00:00,19,14,5,ECO_300019380
642,Herenthoutsesteenweg 2,2022-04-28,00:00:00,24,21,3,ECO_300019380
642,Herenthoutsesteenweg 2,2022-04-28,01:00:00,8,4,4,ECO_300019380
642,Herenthoutsesteenweg 2,2022-04-28,02:00:00,4,3,1,ECO_300019380
642,Herenthoutsesteenweg 2,2022-04-28,03:00:00,3,2,1,ECO_300019380
642,Herenthoutsesteenweg 2,2022-04-28,04:00:00,0,0,0,ECO_300019380
642,Herenthoutsesteenweg 2,2022-04-28,05:00:00,0,0,0,ECO_300019380
642,Herenthoutsesteenweg 2,2022-04-28,06:00:00,1,1,0,ECO_300019380
642,Herenthoutsesteenweg 2,2022-04-28,07:00:00,26,23,3,ECO_300019380
642,Herenthoutsesteenweg 2,2022-04-28,08:00:00,48,42,6,ECO_300019380
642,Herenthoutsesteenweg 2,2022-04-28,09:00:00,181,177,4,ECO_300019380
642,Herenthoutsesteenweg 2,2022-04-28,10:00:00,515,505,10,ECO_300019380
642,Herenthoutsesteenweg 2,2022-04-28,11:00:00,93,86,7,ECO_300019380
642,Herenthoutsesteenweg 2,2022-04-28,12:00:00,78,75,3,ECO_300019380
642,Herenthoutsesteenweg 2,2022-04-28,13:00:00,92,84,8,ECO_300019380
642,Herenthoutsesteenweg 2,2022-04-28,14:00:00,82,73,9,ECO_300019380
642,Herenthoutsesteenweg 2,2022-04-28,15:00:00,129,122,7,ECO_300019380
642,Herenthoutsesteenweg 2,2022-04-28,16:00:00,140,128,12,ECO_300019380
642,Herenthoutsesteenweg 2,2022-04-28,17:00:00,173,152,21,ECO_300019380
642,Herenthoutsesteenweg 2,2022-04-28,18:00:00,160,142,18,ECO_300019380
642,Herenthoutsesteenweg 2,2022-04-28,19:00:00,121,111,10,ECO_300019380
642,Herenthoutsesteenweg 2,2022-04-28,20:00:00,77,71,6,ECO_300019380
642,Herenthoutsesteenweg 2,2022-04-28,21:00:00,54,49,5,ECO_300019380
642,Herenthoutsesteenweg 2,2022-04-28,22:00:00,40,38,2,ECO_300019380
642,Herenthoutsesteenweg 2,2022-04-28,23:00:00,30,28,2,ECO_300019380
642,Herenthoutsesteenweg 2,2022-04-29,00:00:00,32,28,4,ECO_300019380
642,Herenthoutsesteenweg 2,2022-04-29,01:00:00,6,2,4,ECO_300019380
642,Herenthoutsesteenweg 2,2022-04-29,02:00:00,2,0,2,ECO_300019380
642,Herenthoutsesteenweg 2,2022-04-29,03:00:00,0,0,0,ECO_300019380
642,Herenthoutsesteenweg 2,2022-04-29,04:00:00,0,0,0,ECO_300019380
642,Herenthoutsesteenweg 2,2022-04-29,05:00:00,0,0,0,ECO_300019380
642,Herenthoutsesteenweg 2,2022-04-29,06:00:00,5,3,2,ECO_300019380
642,Herenthoutsesteenweg 2,2022-04-29,07:00:00,18,16,2,ECO_300019380
642,Herenthoutsesteenweg 2,2022-04-29,08:00:00,29,27,2,ECO_300019380
642,Herenthoutsesteenweg 2,2022-04-29,09:00:00,165,156,9,ECO_300019380
642,Herenthoutsesteenweg 2,2022-04-29,10:00:00,533,519,14,ECO_300019380
642,Herenthoutsesteenweg 2,2022-04-29,11:00:00,114,111,3,ECO_300019380
642,Herenthoutsesteenweg 2,2022-04-29,12:00:00,116,111,5,ECO_300019380
642,Herenthoutsesteenweg 2,2022-04-29,13:00:00,84,81,3,ECO_300019380
642,Herenthoutsesteenweg 2,2022-04-29,14:00:00,65,60,5,ECO_300019380
642,Herenthoutsesteenweg 2,2022-04-29,15:00:00,87,82,5,ECO_300019380
642,Herenthoutsesteenweg 2,2022-04-29,16:00:00,100,94,6,ECO_300019380
642,Herenthoutsesteenweg 2,2022-04-29,17:00:00,153,144,9,ECO_300019380
642,Herenthoutsesteenweg 2,2022-04-29,18:00:00,141,130,11,ECO_300019380
642,Herenthoutsesteenweg 2,2022-04-29,19:00:00,99,83,16,ECO_300019380
642,Herenthoutsesteenweg 2,2022-04-29,20:00:00,51,48,3,ECO_300019380
642,Herenthoutsesteenweg 2,2022-04-29,21:00:00,37,35,2,ECO_300019380
642,Herenthoutsesteenweg 2,2022-04-29,22:00:00,34,25,9,ECO_300019380
642,Herenthoutsesteenweg 2,2022-04-29,23:00:00,22,22,0,ECO_300019380
642,Herenthoutsesteenweg 2,2022-04-30,00:00:00,20,19,1,ECO_300019380
642,Herenthoutsesteenweg 2,2022-04-30,01:00:00,5,3,2,ECO_300019380
642,Herenthoutsesteenweg 2,2022-04-30,02:00:00,6,4,2,ECO_300019380
642,Herenthoutsesteenweg 2,2022-04-30,03:00:00,4,1,3,ECO_300019380
642,Herenthoutsesteenweg 2,2022-04-30,04:00:00,12,12,0,ECO_300019380
642,Herenthoutsesteenweg 2,2022-04-30,05:00:00,11,10,1,ECO_300019380
642,Herenthoutsesteenweg 2,2022-04-30,06:00:00,1,0,1,ECO_300019380
642,Herenthoutsesteenweg 2,2022-04-30,07:00:00,4,4,0,ECO_300019380
642,Herenthoutsesteenweg 2,2022-04-30,08:00:00,8,8,0,ECO_300019380
642,Herenthoutsesteenweg 2,2022-04-30,09:00:00,21,20,1,ECO_300019380
642,Herenthoutsesteenweg 2,2022-04-30,10:00:00,40,38,2,ECO_300019380
642,Herenthoutsesteenweg 2,2022-04-30,11:00:00,67,63,4,ECO_300019380
642,Herenthoutsesteenweg 2,2022-04-30,12:00:00,71,68,3,ECO_300019380
642,Herenthoutsesteenweg 2,2022-04-30,13:00:00,75,57,18,ECO_300019380
642,Herenthoutsesteenweg 2,2022-04-30,14:00:00,95,78,17,ECO_300019380
642,Herenthoutsesteenweg 2,2022-04-30,15:00:00,121,112,9,ECO_300019380
642,Herenthoutsesteenweg 2,2022-04-30,16:00:00,90,81,9,ECO_300019380
642,Herenthoutsesteenweg 2,2022-04-30,17:00:00,108,92,16,ECO_300019380
642,Herenthoutsesteenweg 2,2022-04-30,18:00:00,46,42,4,ECO_300019380
642,Herenthoutsesteenweg 2,2022-04-30,19:00:00,54,49,5,ECO_300019380
642,Herenthoutsesteenweg 2,2022-04-30,20:00:00,43,37,6,ECO_300019380
642,Herenthoutsesteenweg 2,2022-04-30,21:00:00,26,20,6,ECO_300019380
642,Herenthoutsesteenweg 2,2022-04-30,22:00:00,39,36,3,ECO_300019380
642,Herenthoutsesteenweg 2,2022-04-30,23:00:00,19,19,0,ECO_300019380
642,Herenthoutsesteenweg 2,2022-05-01,00:00:00,14,9,5,ECO_300019380
642,Herenthoutsesteenweg 2,2022-05-01,01:00:00,14,11,3,ECO_300019380
642,Herenthoutsesteenweg 2,2022-05-01,02:00:00,8,8,0,ECO_300019380
642,Herenthoutsesteenweg 2,2022-05-01,03:00:00,3,2,1,ECO_300019380
642,Herenthoutsesteenweg 2,2022-05-01,04:00:00,1,1,0,ECO_300019380
642,Herenthoutsesteenweg 2,2022-05-01,05:00:00,7,4,3,ECO_300019380
642,Herenthoutsesteenweg 2,2022-05-01,06:00:00,6,5,1,ECO_300019380
642,Herenthoutsesteenweg 2,2022-05-01,07:00:00,5,4,1,ECO_300019380
642,Herenthoutsesteenweg 2,2022-05-01,08:00:00,7,7,0,ECO_300019380
642,Herenthoutsesteenweg 2,2022-05-01,09:00:00,16,11,5,ECO_300019380
642,Herenthoutsesteenweg 2,2022-05-01,10:00:00,92,88,4,ECO_300019380
642,Herenthoutsesteenweg 2,2022-05-01,11:00:00,110,105,5,ECO_300019380
642,Herenthoutsesteenweg 2,2022-05-01,12:00:00,79,76,3,ECO_300019380
642,Herenthoutsesteenweg 2,2022-05-01,13:00:00,111,79,32,ECO_300019380
642,Herenthoutsesteenweg 2,2022-05-01,14:00:00,64,52,12,ECO_300019380
642,Herenthoutsesteenweg 2,2022-05-01,15:00:00,105,98,7,ECO_300019380
642,Herenthoutsesteenweg 2,2022-05-01,16:00:00,110,104,6,ECO_300019380
642,Herenthoutsesteenweg 2,2022-05-01,17:00:00,72,67,5,ECO_300019380
642,Herenthoutsesteenweg 2,2022-05-01,18:00:00,73,60,13,ECO_300019380
642,Herenthoutsesteenweg 2,2022-05-01,19:00:00,74,65,9,ECO_300019380
642,Herenthoutsesteenweg 2,2022-05-01,20:00:00,46,38,8,ECO_300019380
642,Herenthoutsesteenweg 2,2022-05-01,21:00:00,44,35,9,ECO_300019380
642,Herenthoutsesteenweg 2,2022-05-01,22:00:00,30,28,2,ECO_300019380
642,Herenthoutsesteenweg 2,2022-05-01,23:00:00,9,8,1,ECO_300019380
642,Herenthoutsesteenweg 2,2022-05-02,00:00:00,5,3,2,ECO_300019380
642,Herenthoutsesteenweg 2,2022-05-02,01:00:00,3,3,0,ECO_300019380
642,Herenthoutsesteenweg 2,2022-05-02,02:00:00,0,0,0,ECO_300019380
642,Herenthoutsesteenweg 2,2022-05-02,03:00:00,0,0,0,ECO_300019380
642,Herenthoutsesteenweg 2,2022-05-02,04:00:00,0,0,0,ECO_300019380
642,Herenthoutsesteenweg 2,2022-05-02,05:00:00,0,0,0,ECO_300019380
642,Herenthoutsesteenweg 2,2022-05-02,06:00:00,1,1,0,ECO_300019380
642,Herenthoutsesteenweg 2,2022-05-02,07:00:00,25,25,0,ECO_300019380
642,Herenthoutsesteenweg 2,2022-05-02,08:00:00,37,33,4,ECO_300019380
642,Herenthoutsesteenweg 2,2022-05-02,09:00:00,159,153,6,ECO_300019380
642,Herenthoutsesteenweg 2,2022-05-02,10:00:00,509,502,7,ECO_300019380
642,Herenthoutsesteenweg 2,2022-05-02,11:00:00,102,99,3,ECO_300019380
642,Herenthoutsesteenweg 2,2022-05-02,12:00:00,97,94,3,ECO_300019380
642,Herenthoutsesteenweg 2,2022-05-02,13:00:00,58,55,3,ECO_300019380
642,Herenthoutsesteenweg 2,2022-05-02,14:00:00,106,99,7,ECO_300019380
642,Herenthoutsesteenweg 2,2022-05-02,15:00:00,142,134,8,ECO_300019380
642,Herenthoutsesteenweg 2,2022-05-02,16:00:00,137,130,7,ECO_300019380
642,Herenthoutsesteenweg 2,2022-05-02,17:00:00,130,118,12,ECO_300019380
642,Herenthoutsesteenweg 2,2022-05-02,18:00:00,126,108,18,ECO_300019380
642,Herenthoutsesteenweg 2,2022-05-02,19:00:00,103,94,9,ECO_300019380
642,Herenthoutsesteenweg 2,2022-05-02,20:00:00,52,43,9,ECO_300019380
642,Herenthoutsesteenweg 2,2022-05-02,21:00:00,28,23,5,ECO_300019380
642,Herenthoutsesteenweg 2,2022-05-02,22:00:00,22,18,4,ECO_300019380
642,Herenthoutsesteenweg 2,2022-05-02,23:00:00,15,13,2,ECO_300019380
642,Herenthoutsesteenweg 2,2022-05-03,00:00:00,12,9,3,ECO_300019380
642,Herenthoutsesteenweg 2,2022-05-03,01:00:00,4,3,1,ECO_300019380
642,Herenthoutsesteenweg 2,2022-05-03,02:00:00,0,0,0,ECO_300019380
642,Herenthoutsesteenweg 2,2022-05-03,03:00:00,0,0,0,ECO_300019380
642,Herenthoutsesteenweg 2,2022-05-03,04:00:00,1,1,0,ECO_300019380
642,Herenthoutsesteenweg 2,2022-05-03,05:00:00,1,1,0,ECO_300019380
642,Herenthoutsesteenweg 2,2022-05-03,06:00:00,2,2,0,ECO_300019380
642,Herenthoutsesteenweg 2,2022-05-03,07:00:00,20,20,0,ECO_300019380
642,Herenthoutsesteenweg 2,2022-05-03,08:00:00,43,38,5,ECO_300019380
642,Herenthoutsesteenweg 2,2022-05-03,09:00:00,186,180,6,ECO_300019380
642,Herenthoutsesteenweg 2,2022-05-03,10:00:00,574,561,13,ECO_300019380
642,Herenthoutsesteenweg 2,2022-05-03,11:00:00,98,97,1,ECO_300019380
642,Herenthoutsesteenweg 2,2022-05-03,12:00:00,109,101,8,ECO_300019380
642,Herenthoutsesteenweg 2,2022-05-03,13:00:00,87,78,9,ECO_300019380
642,Herenthoutsesteenweg 2,2022-05-03,14:00:00,114,107,7,ECO_300019380
642,Herenthoutsesteenweg 2,2022-05-03,15:00:00,125,110,15,ECO_300019380
642,Herenthoutsesteenweg 2,2022-05-03,16:00:00,127,119,8,ECO_300019380
642,Herenthoutsesteenweg 2,2022-05-03,17:00:00,162,145,17,ECO_300019380
642,Herenthoutsesteenweg 2,2022-05-03,18:00:00,176,162,14,ECO_300019380
642,Herenthoutsesteenweg 2,2022-05-03,19:00:00,112,97,15,ECO_300019380
642,Herenthoutsesteenweg 2,2022-05-03,20:00:00,74,68,6,ECO_300019380
642,Herenthoutsesteenweg 2,2022-05-03,21:00:00,48,39,9,ECO_300019380
642,Herenthoutsesteenweg 2,2022-05-03,22:00:00,33,28,5,ECO_300019380
642,Herenthoutsesteenweg 2,2022-05-03,23:00:00,21,20,1,ECO_300019380
642,Herenthoutsesteenweg 2,2022-05-04,00:00:00,18,16,2,ECO_300019380
642,Herenthoutsesteenweg 2,2022-05-04,01:00:00,1,0,1,ECO_300019380
642,Herenthoutsesteenweg 2,2022-05-04,02:00:00,0,0,0,ECO_300019380
642,Herenthoutsesteenweg 2,2022-05-04,03:00:00,0,0,0,ECO_300019380
642,Herenthoutsesteenweg 2,2022-05-04,04:00:00,2,2,0,ECO_300019380
642,Herenthoutsesteenweg 2,2022-05-04,05:00:00,0,0,0,ECO_300019380
642,Herenthoutsesteenweg 2,2022-05-04,06:00:00,2,2,0,ECO_300019380
642,Herenthoutsesteenweg 2,2022-05-04,07:00:00,27,24,3,ECO_300019380
642,Herenthoutsesteenweg 2,2022-05-04,08:00:00,46,42,4,ECO_300019380
642,Herenthoutsesteenweg 2,2022-05-04,09:00:00,191,186,5,ECO_300019380
642,Herenthoutsesteenweg 2,2022-05-04,10:00:00,539,529,10,ECO_300019380
642,Herenthoutsesteenweg 2,2022-05-04,11:00:00,84,77,7,ECO_300019380
642,Herenthoutsesteenweg 2,2022-05-04,12:00:00,78,78,0,ECO_300019380
642,Herenthoutsesteenweg 2,2022-05-04,13:00:00,84,78,6,ECO_300019380
642,Herenthoutsesteenweg 2,2022-05-04,14:00:00,175,156,19,ECO_300019380
642,Herenthoutsesteenweg 2,2022-05-04,15:00:00,157,144,13,ECO_300019380
642,Herenthoutsesteenweg 2,2022-05-04,16:00:00,183,170,13,ECO_300019380
642,Herenthoutsesteenweg 2,2022-05-04,17:00:00,126,97,29,ECO_300019380
642,Herenthoutsesteenweg 2,2022-05-04,18:00:00,157,131,26,ECO_300019380
642,Herenthoutsesteenweg 2,2022-05-04,19:00:00,127,116,11,ECO_300019380
642,Herenthoutsesteenweg 2,2022-05-04,20:00:00,66,56,10,ECO_300019380
642,Herenthoutsesteenweg 2,2022-05-04,21:00:00,122,118,4,ECO_300019380
642,Herenthoutsesteenweg 2,2022-05-04,22:00:00,26,25,1,ECO_300019380
642,Herenthoutsesteenweg 2,2022-05-04,23:00:00,37,30,7,ECO_300019380
642,Herenthoutsesteenweg 2,2022-05-05,00:00:00,23,22,1,ECO_300019380
642,Herenthoutsesteenweg 2,2022-05-05,01:00:00,5,4,1,ECO_300019380
642,Herenthoutsesteenweg 2,2022-05-05,02:00:00,1,1,0,ECO_300019380
642,Herenthoutsesteenweg 2,2022-05-05,03:00:00,4,4,0,ECO_300019380
642,Herenthoutsesteenweg 2,2022-05-05,04:00:00,0,0,0,ECO_300019380
642,Herenthoutsesteenweg 2,2022-05-05,05:00:00,0,0,0,ECO_300019380
642,Herenthoutsesteenweg 2,2022-05-05,06:00:00,2,2,0,ECO_300019380
642,Herenthoutsesteenweg 2,2022-05-05,07:00:00,27,24,3,ECO_300019380
642,Herenthoutsesteenweg 2,2022-05-05,08:00:00,46,43,3,ECO_300019380
642,Herenthoutsesteenweg 2,2022-05-05,09:00:00,195,179,16,ECO_300019380
642,Herenthoutsesteenweg 2,2022-05-05,10:00:00,544,532,12,ECO_300019380
642,Herenthoutsesteenweg 2,2022-05-05,11:00:00,91,86,5,ECO_300019380
642,Herenthoutsesteenweg 2,2022-05-05,12:00:00,57,55,2,ECO_300019380
642,Herenthoutsesteenweg 2,2022-05-05,13:00:00,73,66,7,ECO_300019380
642,Herenthoutsesteenweg 2,2022-05-05,14:00:00,84,79,5,ECO_300019380
642,Herenthoutsesteenweg 2,2022-05-05,15:00:00,116,114,2,ECO_300019380
642,Herenthoutsesteenweg 2,2022-05-05,16:00:00,114,106,8,ECO_300019380
642,Herenthoutsesteenweg 2,2022-05-05,17:00:00,140,127,13,ECO_300019380
642,Herenthoutsesteenweg 2,2022-05-05,18:00:00,158,142,16,ECO_300019380
642,Herenthoutsesteenweg 2,2022-05-05,19:00:00,95,90,5,ECO_300019380
642,Herenthoutsesteenweg 2,2022-05-05,20:00:00,67,54,13,ECO_300019380
642,Herenthoutsesteenweg 2,2022-05-05,21:00:00,46,41,5,ECO_300019380
642,Herenthoutsesteenweg 2,2022-05-05,22:00:00,35,32,3,ECO_300019380
642,Herenthoutsesteenweg 2,2022-05-05,23:00:00,22,17,5,ECO_300019380
642,Herenthoutsesteenweg 2,2022-05-06,00:00:00,20,16,4,ECO_300019380
642,Herenthoutsesteenweg 2,2022-05-06,01:00:00,6,5,1,ECO_300019380
642,Herenthoutsesteenweg 2,2022-05-06,02:00:00,0,0,0,ECO_300019380
642,Herenthoutsesteenweg 2,2022-05-06,03:00:00,0,0,0,ECO_300019380
642,Herenthoutsesteenweg 2,2022-05-06,04:00:00,0,0,0,ECO_300019380
642,Herenthoutsesteenweg 2,2022-05-06,05:00:00,0,0,0,ECO_300019380
642,Herenthoutsesteenweg 2,2022-05-06,06:00:00,3,3,0,ECO_300019380
642,Herenthoutsesteenweg 2,2022-05-06,07:00:00,24,23,1,ECO_300019380
642,Herenthoutsesteenweg 2,2022-05-06,08:00:00,42,37,5,ECO_300019380
642,Herenthoutsesteenweg 2,2022-05-06,09:00:00,183,168,15,ECO_300019380
642,Herenthoutsesteenweg 2,2022-05-06,10:00:00,577,571,6,ECO_300019380
642,Herenthoutsesteenweg 2,2022-05-06,11:00:00,139,136,3,ECO_300019380
642,Herenthoutsesteenweg 2,2022-05-06,12:00:00,133,125,8,ECO_300019380
642,Herenthoutsesteenweg 2,2022-05-06,13:00:00,85,79,6,ECO_300019380
642,Herenthoutsesteenweg 2,2022-05-06,14:00:00,67,61,6,ECO_300019380
642,Herenthoutsesteenweg 2,2022-05-06,15:00:00,123,114,9,ECO_300019380
642,Herenthoutsesteenweg 2,2022-05-06,16:00:00,125,116,9,ECO_300019380
642,Herenthoutsesteenweg 2,2022-05-06,17:00:00,189,172,17,ECO_300019380
642,Herenthoutsesteenweg 2,2022-05-06,18:00:00,156,139,17,ECO_300019380
642,Herenthoutsesteenweg 2,2022-05-06,19:00:00,118,93,25,ECO_300019380
642,Herenthoutsesteenweg 2,2022-05-06,20:00:00,78,69,9,ECO_300019380
642,Herenthoutsesteenweg 2,2022-05-06,21:00:00,69,62,7,ECO_300019380
642,Herenthoutsesteenweg 2,2022-05-06,22:00:00,53,48,5,ECO_300019380
642,Herenthoutsesteenweg 2,2022-05-06,23:00:00,22,16,6,ECO_300019380
642,Herenthoutsesteenweg 2,2022-05-07,00:00:00,27,20,7,ECO_300019380
642,Herenthoutsesteenweg 2,2022-05-07,01:00:00,11,5,6,ECO_300019380
642,Herenthoutsesteenweg 2,2022-05-07,02:00:00,2,1,1,ECO_300019380
642,Herenthoutsesteenweg 2,2022-05-07,03:00:00,11,7,4,ECO_300019380
642,Herenthoutsesteenweg 2,2022-05-07,04:00:00,4,0,4,ECO_300019380
642,Herenthoutsesteenweg 2,2022-05-07,05:00:00,3,1,2,ECO_300019380
642,Herenthoutsesteenweg 2,2022-05-07,06:00:00,1,1,0,ECO_300019380
642,Herenthoutsesteenweg 2,2022-05-07,07:00:00,5,5,0,ECO_300019380
642,Herenthoutsesteenweg 2,2022-05-07,08:00:00,13,10,3,ECO_300019380
642,Herenthoutsesteenweg 2,2022-05-07,09:00:00,17,15,2,ECO_300019380
642,Herenthoutsesteenweg 2,2022-05-07,10:00:00,42,40,2,ECO_300019380
642,Herenthoutsesteenweg 2,2022-05-07,11:00:00,97,88,9,ECO_300019380
642,Herenthoutsesteenweg 2,2022-05-07,12:00:00,92,86,6,ECO_300019380
642,Herenthoutsesteenweg 2,2022-05-07,13:00:00,106,97,9,ECO_300019380
642,Herenthoutsesteenweg 2,2022-05-07,14:00:00,140,130,10,ECO_300019380
642,Herenthoutsesteenweg 2,2022-05-07,15:00:00,185,177,8,ECO_300019380
642,Herenthoutsesteenweg 2,2022-05-07,16:00:00,88,74,14,ECO_300019380
642,Herenthoutsesteenweg 2,2022-05-07,17:00:00,111,103,8,ECO_300019380
642,Herenthoutsesteenweg 2,2022-05-07,18:00:00,109,102,7,ECO_300019380
642,Herenthoutsesteenweg 2,2022-05-07,19:00:00,52,50,2,ECO_300019380
642,Herenthoutsesteenweg 2,2022-05-07,20:00:00,57,53,4,ECO_300019380
642,Herenthoutsesteenweg 2,2022-05-07,21:00:00,36,32,4,ECO_300019380
642,Herenthoutsesteenweg 2,2022-05-07,22:00:00,41,31,10,ECO_300019380
642,Herenthoutsesteenweg 2,2022-05-07,23:00:00,21,12,9,ECO_300019380
642,Herenthoutsesteenweg 2,2022-05-08,00:00:00,18,15,3,ECO_300019380
642,Herenthoutsesteenweg 2,2022-05-08,01:00:00,9,7,2,ECO_300019380
642,Herenthoutsesteenweg 2,2022-05-08,02:00:00,5,4,1,ECO_300019380
642,Herenthoutsesteenweg 2,2022-05-08,03:00:00,20,19,1,ECO_300019380
642,Herenthoutsesteenweg 2,2022-05-08,04:00:00,6,5,1,ECO_300019380
642,Herenthoutsesteenweg 2,2022-05-08,05:00:00,36,35,1,ECO_300019380
642,Herenthoutsesteenweg 2,2022-05-08,06:00:00,8,8,0,ECO_300019380
642,Herenthoutsesteenweg 2,2022-05-08,07:00:00,2,2,0,ECO_300019380
642,Herenthoutsesteenweg 2,2022-05-08,08:00:00,18,17,1,ECO_300019380
642,Herenthoutsesteenweg 2,2022-05-08,09:00:00,21,19,2,ECO_300019380
642,Herenthoutsesteenweg 2,2022-05-08,10:00:00,60,55,5,ECO_300019380
642,Herenthoutsesteenweg 2,2022-05-08,11:00:00,132,122,10,ECO_300019380
642,Herenthoutsesteenweg 2,2022-05-08,12:00:00,133,125,8,ECO_300019380
642,Herenthoutsesteenweg 2,2022-05-08,13:00:00,160,133,27,ECO_300019380
642,Herenthoutsesteenweg 2,2022-05-08,14:00:00,116,113,3,ECO_300019380
642,Herenthoutsesteenweg 2,2022-05-08,15:00:00,260,244,16,ECO_300019380
642,Herenthoutsesteenweg 2,2022-05-08,16:00:00,186,170,16,ECO_300019380
642,Herenthoutsesteenweg 2,2022-05-08,17:00:00,137,129,8,ECO_300019380
642,Herenthoutsesteenweg 2,2022-05-08,18:00:00,115,97,18,ECO_300019380
642,Herenthoutsesteenweg 2,2022-05-08,19:00:00,70,55,15,ECO_300019380
642,Herenthoutsesteenweg 2,2022-05-08,20:00:00,69,64,5,ECO_300019380
642,Herenthoutsesteenweg 2,2022-05-08,21:00:00,43,38,5,ECO_300019380
642,Herenthoutsesteenweg 2,2022-05-08,22:00:00,28,20,8,ECO_300019380
642,Herenthoutsesteenweg 2,2022-05-08,23:00:00,16,10,6,ECO_300019380
642,Herenthoutsesteenweg 2,2022-05-09,00:00:00,7,5,2,ECO_300019380
642,Herenthoutsesteenweg 2,2022-05-09,01:00:00,2,2,0,ECO_300019380
642,Herenthoutsesteenweg 2,2022-05-09,02:00:00,1,1,0,ECO_300019380
642,Herenthoutsesteenweg 2,2022-05-09,03:00:00,1,1,0,ECO_300019380
642,Herenthoutsesteenweg 2,2022-05-09,04:00:00,0,0,0,ECO_300019380
642,Herenthoutsesteenweg 2,2022-05-09,05:00:00,0,0,0,ECO_300019380
642,Herenthoutsesteenweg 2,2022-05-09,06:00:00,2,2,0,ECO_300019380
642,Herenthoutsesteenweg 2,2022-05-09,07:00:00,19,16,3,ECO_300019380
642,Herenthoutsesteenweg 2,2022-05-09,08:00:00,49,44,5,ECO_300019380
642,Herenthoutsesteenweg 2,2022-05-09,09:00:00,190,180,10,ECO_300019380
642,Herenthoutsesteenweg 2,2022-05-09,10:00:00,608,603,5,ECO_300019380
642,Herenthoutsesteenweg 2,2022-05-09,11:00:00,119,113,6,ECO_300019380
642,Herenthoutsesteenweg 2,2022-05-09,12:00:00,82,79,3,ECO_300019380
642,Herenthoutsesteenweg 2,2022-05-09,13:00:00,79,77,2,ECO_300019380
642,Herenthoutsesteenweg 2,2022-05-09,14:00:00,100,91,9,ECO_300019380
642,Herenthoutsesteenweg 2,2022-05-09,15:00:00,146,137,9,ECO_300019380
642,Herenthoutsesteenweg 2,2022-05-09,16:00:00,183,167,16,ECO_300019380
642,Herenthoutsesteenweg 2,2022-05-09,17:00:00,188,171,17,ECO_300019380
642,Herenthoutsesteenweg 2,2022-05-09,18:00:00,158,133,25,ECO_300019380
642,Herenthoutsesteenweg 2,2022-05-09,19:00:00,133,129,4,ECO_300019380
642,Herenthoutsesteenweg 2,2022-05-09,20:00:00,76,66,10,ECO_300019380
642,Herenthoutsesteenweg 2,2022-05-09,21:00:00,53,51,2,ECO_300019380
642,Herenthoutsesteenweg 2,2022-05-09,22:00:00,37,29,8,ECO_300019380
642,Herenthoutsesteenweg 2,2022-05-09,23:00:00,23,20,3,ECO_300019380
642,Herenthoutsesteenweg 2,2022-05-10,00:00:00,23,18,5,ECO_300019380
642,Herenthoutsesteenweg 2,2022-05-10,01:00:00,7,4,3,ECO_300019380
642,Herenthoutsesteenweg 2,2022-05-10,02:00:00,2,2,0,ECO_300019380
642,Herenthoutsesteenweg 2,2022-05-10,03:00:00,0,0,0,ECO_300019380
642,Herenthoutsesteenweg 2,2022-05-10,04:00:00,1,1,0,ECO_300019380
642,Herenthoutsesteenweg 2,2022-05-10,05:00:00,0,0,0,ECO_300019380
642,Herenthoutsesteenweg 2,2022-05-10,06:00:00,2,2,0,ECO_300019380
642,Herenthoutsesteenweg 2,2022-05-10,07:00:00,15,14,1,ECO_300019380
642,Herenthoutsesteenweg 2,2022-05-10,08:00:00,66,58,8,ECO_300019380
642,Herenthoutsesteenweg 2,2022-05-10,09:00:00,218,210,8,ECO_300019380
642,Herenthoutsesteenweg 2,2022-05-10,10:00:00,594,586,8,ECO_300019380
642,Herenthoutsesteenweg 2,2022-05-10,11:00:00,108,106,2,ECO_300019380
642,Herenthoutsesteenweg 2,2022-05-10,12:00:00,88,81,7,ECO_300019380
642,Herenthoutsesteenweg 2,2022-05-10,13:00:00,82,75,7,ECO_300019380
642,Herenthoutsesteenweg 2,2022-05-10,14:00:00,102,100,2,ECO_300019380
642,Herenthoutsesteenweg 2,2022-05-10,15:00:00,135,129,6,ECO_300019380
642,Herenthoutsesteenweg 2,2022-05-10,16:00:00,128,116,12,ECO_300019380
642,Herenthoutsesteenweg 2,2022-05-10,17:00:00,132,124,8,ECO_300019380
642,Herenthoutsesteenweg 2,2022-05-10,18:00:00,207,190,17,ECO_300019380
642,Herenthoutsesteenweg 2,2022-05-10,19:00:00,131,117,14,ECO_300019380
642,Herenthoutsesteenweg 2,2022-05-10,20:00:00,83,74,9,ECO_300019380
642,Herenthoutsesteenweg 2,2022-05-10,21:00:00,70,61,9,ECO_300019380
642,Herenthoutsesteenweg 2,2022-05-10,22:00:00,32,27,5,ECO_300019380
642,Herenthoutsesteenweg 2,2022-05-10,23:00:00,37,36,1,ECO_300019380
642,Herenthoutsesteenweg 2,2022-05-11,00:00:00,30,20,10,ECO_300019380
642,Herenthoutsesteenweg 2,2022-05-11,01:00:00,7,4,3,ECO_300019380
642,Herenthoutsesteenweg 2,2022-05-11,02:00:00,1,1,0,ECO_300019380
642,Herenthoutsesteenweg 2,2022-05-11,03:00:00,0,0,0,ECO_300019380
642,Herenthoutsesteenweg 2,2022-05-11,04:00:00,1,0,1,ECO_300019380
642,Herenthoutsesteenweg 2,2022-05-11,05:00:00,0,0,0,ECO_300019380
642,Herenthoutsesteenweg 2,2022-05-11,06:00:00,3,3,0,ECO_300019380
642,Herenthoutsesteenweg 2,2022-05-11,07:00:00,19,16,3,ECO_300019380
642,Herenthoutsesteenweg 2,2022-05-11,08:00:00,43,39,4,ECO_300019380
642,Herenthoutsesteenweg 2,2022-05-11,09:00:00,228,219,9,ECO_300019380
642,Herenthoutsesteenweg 2,2022-05-11,10:00:00,576,571,5,ECO_300019380
642,Herenthoutsesteenweg 2,2022-05-11,11:00:00,107,104,3,ECO_300019380
642,Herenthoutsesteenweg 2,2022-05-11,12:00:00,76,74,2,ECO_300019380
642,Herenthoutsesteenweg 2,2022-05-11,13:00:00,66,63,3,ECO_300019380
642,Herenthoutsesteenweg 2,2022-05-11,14:00:00,220,205,15,ECO_300019380
642,Herenthoutsesteenweg 2,2022-05-11,15:00:00,167,160,7,ECO_300019380
642,Herenthoutsesteenweg 2,2022-05-11,16:00:00,224,210,14,ECO_300019380
642,Herenthoutsesteenweg 2,2022-05-11,17:00:00,141,127,14,ECO_300019380
642,Herenthoutsesteenweg 2,2022-05-11,18:00:00,161,143,18,ECO_300019380
642,Herenthoutsesteenweg 2,2022-05-11,19:00:00,103,95,8,ECO_300019380
642,Herenthoutsesteenweg 2,2022-05-11,20:00:00,77,63,14,ECO_300019380
642,Herenthoutsesteenweg 2,2022-05-11,21:00:00,60,45,15,ECO_300019380
642,Herenthoutsesteenweg 2,2022-05-11,22:00:00,43,39,4,ECO_300019380
642,Herenthoutsesteenweg 2,2022-05-11,23:00:00,60,52,8,ECO_300019380
642,Herenthoutsesteenweg 2,2022-05-12,00:00:00,23,18,5,ECO_300019380
642,Herenthoutsesteenweg 2,2022-05-12,01:00:00,6,4,2,ECO_300019380
642,Herenthoutsesteenweg 2,2022-05-12,02:00:00,2,1,1,ECO_300019380
642,Herenthoutsesteenweg 2,2022-05-12,03:00:00,6,4,2,ECO_300019380
642,Herenthoutsesteenweg 2,2022-05-12,04:00:00,0,0,0,ECO_300019380
642,Herenthoutsesteenweg 2,2022-05-12,05:00:00,0,0,0,ECO_300019380
642,Herenthoutsesteenweg 2,2022-05-12,06:00:00,1,1,0,ECO_300019380
642,Herenthoutsesteenweg 2,2022-05-12,07:00:00,18,17,1,ECO_300019380
642,Herenthoutsesteenweg 2,2022-05-12,08:00:00,53,48,5,ECO_300019380
642,Herenthoutsesteenweg 2,2022-05-12,09:00:00,212,208,4,ECO_300019380
642,Herenthoutsesteenweg 2,2022-05-12,10:00:00,552,550,2,ECO_300019380
642,Herenthoutsesteenweg 2,2022-05-12,11:00:00,104,98,6,ECO_300019380
642,Herenthoutsesteenweg 2,2022-05-12,12:00:00,105,100,5,ECO_300019380
642,Herenthoutsesteenweg 2,2022-05-12,13:00:00,77,71,6,ECO_300019380
642,Herenthoutsesteenweg 2,2022-05-12,14:00:00,89,82,7,ECO_300019380
642,Herenthoutsesteenweg 2,2022-05-12,15:00:00,110,104,6,ECO_300019380
642,Herenthoutsesteenweg 2,2022-05-12,16:00:00,127,114,13,ECO_300019380
642,Herenthoutsesteenweg 2,2022-05-12,17:00:00,150,137,13,ECO_300019380
642,Herenthoutsesteenweg 2,2022-05-12,18:00:00,173,152,21,ECO_300019380
642,Herenthoutsesteenweg 2,2022-05-12,19:00:00,109,98,11,ECO_300019380
642,Herenthoutsesteenweg 2,2022-05-12,20:00:00,80,71,9,ECO_300019380
642,Herenthoutsesteenweg 2,2022-05-12,21:00:00,52,47,5,ECO_300019380
642,Herenthoutsesteenweg 2,2022-05-12,22:00:00,44,43,1,ECO_300019380
642,Herenthoutsesteenweg 2,2022-05-12,23:00:00,23,19,4,ECO_300019380
642,Herenthoutsesteenweg 2,2022-05-13,00:00:00,31,27,4,ECO_300019380
642,Herenthoutsesteenweg 2,2022-05-13,01:00:00,12,7,5,ECO_300019380
642,Herenthoutsesteenweg 2,2022-05-13,02:00:00,2,2,0,ECO_300019380
642,Herenthoutsesteenweg 2,2022-05-13,03:00:00,2,1,1,ECO_300019380
642,Herenthoutsesteenweg 2,2022-05-13,04:00:00,0,0,0,ECO_300019380
642,Herenthoutsesteenweg 2,2022-05-13,05:00:00,0,0,0,ECO_300019380
642,Herenthoutsesteenweg 2,2022-05-13,06:00:00,3,3,0,ECO_300019380
642,Herenthoutsesteenweg 2,2022-05-13,07:00:00,20,18,2,ECO_300019380
642,Herenthoutsesteenweg 2,2022-05-13,08:00:00,42,39,3,ECO_300019380
642,Herenthoutsesteenweg 2,2022-05-13,09:00:00,181,176,5,ECO_300019380
642,Herenthoutsesteenweg 2,2022-05-13,10:00:00,571,558,13,ECO_300019380
642,Herenthoutsesteenweg 2,2022-05-13,11:00:00,118,115,3,ECO_300019380
642,Herenthoutsesteenweg 2,2022-05-13,12:00:00,141,135,6,ECO_300019380
642,Herenthoutsesteenweg 2,2022-05-13,13:00:00,84,79,5,ECO_300019380
642,Herenthoutsesteenweg 2,2022-05-13,14:00:00,81,73,8,ECO_300019380
642,Herenthoutsesteenweg 2,2022-05-13,15:00:00,103,96,7,ECO_300019380
642,Herenthoutsesteenweg 2,2022-05-13,16:00:00,119,109,10,ECO_300019380
642,Herenthoutsesteenweg 2,2022-05-13,17:00:00,194,176,18,ECO_300019380
642,Herenthoutsesteenweg 2,2022-05-13,18:00:00,162,142,20,ECO_300019380
642,Herenthoutsesteenweg 2,2022-05-13,19:00:00,114,105,9,ECO_300019380
642,Herenthoutsesteenweg 2,2022-05-13,20:00:00,104,92,12,ECO_300019380
642,Herenthoutsesteenweg 2,2022-05-13,21:00:00,112,105,7,ECO_300019380
642,Herenthoutsesteenweg 2,2022-05-13,22:00:00,88,81,7,ECO_300019380
642,Herenthoutsesteenweg 2,2022-05-13,23:00:00,81,79,2,ECO_300019380
642,Herenthoutsesteenweg 2,2022-05-14,00:00:00,77,74,3,ECO_300019380
642,Herenthoutsesteenweg 2,2022-05-14,01:00:00,20,16,4,ECO_300019380
642,Herenthoutsesteenweg 2,2022-05-14,02:00:00,16,9,7,ECO_300019380
642,Herenthoutsesteenweg 2,2022-05-14,03:00:00,8,5,3,ECO_300019380
642,Herenthoutsesteenweg 2,2022-05-14,04:00:00,2,1,1,ECO_300019380
642,Herenthoutsesteenweg 2,2022-05-14,05:00:00,5,4,1,ECO_300019380
642,Herenthoutsesteenweg 2,2022-05-14,06:00:00,0,0,0,ECO_300019380
642,Herenthoutsesteenweg 2,2022-05-14,07:00:00,3,3,0,ECO_300019380
642,Herenthoutsesteenweg 2,2022-05-14,08:00:00,9,8,1,ECO_300019380
642,Herenthoutsesteenweg 2,2022-05-14,09:00:00,19,16,3,ECO_300019380
642,Herenthoutsesteenweg 2,2022-05-14,10:00:00,40,38,2,ECO_300019380
642,Herenthoutsesteenweg 2,2022-05-14,11:00:00,91,80,11,ECO_300019380
642,Herenthoutsesteenweg 2,2022-05-14,12:00:00,142,132,10,ECO_300019380
642,Herenthoutsesteenweg 2,2022-05-14,13:00:00,169,152,17,ECO_300019380
642,Herenthoutsesteenweg 2,2022-05-14,14:00:00,161,145,16,ECO_300019380
642,Herenthoutsesteenweg 2,2022-05-14,15:00:00,210,180,30,ECO_300019380
642,Herenthoutsesteenweg 2,2022-05-14,16:00:00,214,194,20,ECO_300019380
642,Herenthoutsesteenweg 2,2022-05-14,17:00:00,187,161,26,ECO_300019380
642,Herenthoutsesteenweg 2,2022-05-14,18:00:00,169,138,31,ECO_300019380
642,Herenthoutsesteenweg 2,2022-05-14,19:00:00,97,84,13,ECO_300019380
642,Herenthoutsesteenweg 2,2022-05-14,20:00:00,62,60,2,ECO_300019380
642,Herenthoutsesteenweg 2,2022-05-14,21:00:00,42,37,5,ECO_300019380
642,Herenthoutsesteenweg 2,2022-05-14,22:00:00,67,61,6,ECO_300019380
642,Herenthoutsesteenweg 2,2022-05-14,23:00:00,23,19,4,ECO_300019380
642,Herenthoutsesteenweg 2,2022-05-15,00:00:00,14,10,4,ECO_300019380
642,Herenthoutsesteenweg 2,2022-05-15,01:00:00,12,12,0,ECO_300019380
642,Herenthoutsesteenweg 2,2022-05-15,02:00:00,8,5,3,ECO_300019380
642,Herenthoutsesteenweg 2,2022-05-15,03:00:00,2,2,0,ECO_300019380
642,Herenthoutsesteenweg 2,2022-05-15,04:00:00,5,5,0,ECO_300019380
642,Herenthoutsesteenweg 2,2022-05-15,05:00:00,4,4,0,ECO_300019380
642,Herenthoutsesteenweg 2,2022-05-15,06:00:00,3,2,1,ECO_300019380
642,Herenthoutsesteenweg 2,2022-05-15,07:00:00,3,3,0,ECO_300019380
642,Herenthoutsesteenweg 2,2022-05-15,08:00:00,6,6,0,ECO_300019380
642,Herenthoutsesteenweg 2,2022-05-15,09:00:00,24,23,1,ECO_300019380
642,Herenthoutsesteenweg 2,2022-05-15,10:00:00,62,57,5,ECO_300019380
642,Herenthoutsesteenweg 2,2022-05-15,11:00:00,128,121,7,ECO_300019380
642,Herenthoutsesteenweg 2,2022-05-15,12:00:00,210,189,21,ECO_300019380
642,Herenthoutsesteenweg 2,2022-05-15,13:00:00,170,144,26,ECO_300019380
642,Herenthoutsesteenweg 2,2022-05-15,14:00:00,127,112,15,ECO_300019380
642,Herenthoutsesteenweg 2,2022-05-15,15:00:00,214,205,9,ECO_300019380
642,Herenthoutsesteenweg 2,2022-05-15,16:00:00,210,193,17,ECO_300019380
642,Herenthoutsesteenweg 2,2022-05-15,17:00:00,156,148,8,ECO_300019380
642,Herenthoutsesteenweg 2,2022-05-15,18:00:00,120,100,20,ECO_300019380
642,Herenthoutsesteenweg 2,2022-05-15,19:00:00,89,75,14,ECO_300019380
642,Herenthoutsesteenweg 2,2022-05-15,20:00:00,65,61,4,ECO_300019380
642,Herenthoutsesteenweg 2,2022-05-15,21:00:00,67,57,10,ECO_300019380
642,Herenthoutsesteenweg 2,2022-05-15,22:00:00,47,41,6,ECO_300019380
642,Herenthoutsesteenweg 2,2022-05-15,23:00:00,42,34,8,ECO_300019380
642,Herenthoutsesteenweg 2,2022-05-16,00:00:00,15,14,1,ECO_300019380
642,Herenthoutsesteenweg 2,2022-05-16,01:00:00,4,3,1,ECO_300019380
642,Herenthoutsesteenweg 2,2022-05-16,02:00:00,3,2,1,ECO_300019380
642,Herenthoutsesteenweg 2,2022-05-16,03:00:00,2,1,1,ECO_300019380
642,Herenthoutsesteenweg 2,2022-05-16,04:00:00,0,0,0,ECO_300019380
642,Herenthoutsesteenweg 2,2022-05-16,05:00:00,1,1,0,ECO_300019380
642,Herenthoutsesteenweg 2,2022-05-16,06:00:00,2,2,0,ECO_300019380
642,Herenthoutsesteenweg 2,2022-05-16,07:00:00,27,25,2,ECO_300019380
642,Herenthoutsesteenweg 2,2022-05-16,08:00:00,49,47,2,ECO_300019380
642,Herenthoutsesteenweg 2,2022-05-16,09:00:00,193,189,4,ECO_300019380
642,Herenthoutsesteenweg 2,2022-05-16,10:00:00,574,569,5,ECO_300019380
642,Herenthoutsesteenweg 2,2022-05-16,11:00:00,129,123,6,ECO_300019380
642,Herenthoutsesteenweg 2,2022-05-16,12:00:00,70,69,1,ECO_300019380
642,Herenthoutsesteenweg 2,2022-05-16,13:00:00,71,65,6,ECO_300019380
642,Herenthoutsesteenweg 2,2022-05-16,14:00:00,61,58,3,ECO_300019380
642,Herenthoutsesteenweg 2,2022-05-16,15:00:00,49,49,0,ECO_300019380
642,Herenthoutsesteenweg 2,2022-05-16,16:00:00,114,99,15,ECO_300019380
642,Herenthoutsesteenweg 2,2022-05-16,17:00:00,104,98,6,ECO_300019380
642,Herenthoutsesteenweg 2,2022-05-16,18:00:00,143,122,21,ECO_300019380
642,Herenthoutsesteenweg 2,2022-05-16,19:00:00,84,76,8,ECO_300019380
642,Herenthoutsesteenweg 2,2022-05-16,20:00:00,72,61,11,ECO_300019380
642,Herenthoutsesteenweg 2,2022-05-16,21:00:00,52,45,7,ECO_300019380
642,Herenthoutsesteenweg 2,2022-05-16,22:00:00,24,22,2,ECO_300019380
642,Herenthoutsesteenweg 2,2022-05-16,23:00:00,21,20,1,ECO_300019380
642,Herenthoutsesteenweg 2,2022-05-17,00:00:00,21,20,1,ECO_300019380
642,Herenthoutsesteenweg 2,2022-05-17,01:00:00,2,1,1,ECO_300019380
642,Herenthoutsesteenweg 2,2022-05-17,02:00:00,0,0,0,ECO_300019380
642,Herenthoutsesteenweg 2,2022-05-17,03:00:00,0,0,0,ECO_300019380
642,Herenthoutsesteenweg 2,2022-05-17,04:00:00,0,0,0,ECO_300019380
642,Herenthoutsesteenweg 2,2022-05-17,05:00:00,1,1,0,ECO_300019380
642,Herenthoutsesteenweg 2,2022-05-17,06:00:00,3,3,0,ECO_300019380
642,Herenthoutsesteenweg 2,2022-05-17,07:00:00,25,23,2,ECO_300019380
642,Herenthoutsesteenweg 2,2022-05-17,08:00:00,55,53,2,ECO_300019380
642,Herenthoutsesteenweg 2,2022-05-17,09:00:00,212,208,4,ECO_300019380
642,Herenthoutsesteenweg 2,2022-05-17,10:00:00,566,548,18,ECO_300019380
642,Herenthoutsesteenweg 2,2022-05-17,11:00:00,109,106,3,ECO_300019380
642,Herenthoutsesteenweg 2,2022-05-17,12:00:00,64,60,4,ECO_300019380
642,Herenthoutsesteenweg 2,2022-05-17,13:00:00,61,58,3,ECO_300019380
642,Herenthoutsesteenweg 2,2022-05-17,14:00:00,79,74,5,ECO_300019380
642,Herenthoutsesteenweg 2,2022-05-17,15:00:00,134,123,11,ECO_300019380
642,Herenthoutsesteenweg 2,2022-05-17,16:00:00,149,140,9,ECO_300019380
642,Herenthoutsesteenweg 2,2022-05-17,17:00:00,161,145,16,ECO_300019380
642,Herenthoutsesteenweg 2,2022-05-17,18:00:00,184,171,13,ECO_300019380
642,Herenthoutsesteenweg 2,2022-05-17,19:00:00,132,120,12,ECO_300019380
642,Herenthoutsesteenweg 2,2022-05-17,20:00:00,106,96,10,ECO_300019380
642,Herenthoutsesteenweg 2,2022-05-17,21:00:00,71,66,5,ECO_300019380
642,Herenthoutsesteenweg 2,2022-05-17,22:00:00,52,44,8,ECO_300019380
642,Herenthoutsesteenweg 2,2022-05-17,23:00:00,41,31,10,ECO_300019380
642,Herenthoutsesteenweg 2,2022-05-18,00:00:00,20,17,3,ECO_300019380
642,Herenthoutsesteenweg 2,2022-05-18,01:00:00,7,6,1,ECO_300019380
642,Herenthoutsesteenweg 2,2022-05-18,02:00:00,2,2,0,ECO_300019380
642,Herenthoutsesteenweg 2,2022-05-18,03:00:00,0,0,0,ECO_300019380
642,Herenthoutsesteenweg 2,2022-05-18,04:00:00,0,0,0,ECO_300019380
642,Herenthoutsesteenweg 2,2022-05-18,05:00:00,1,1,0,ECO_300019380
642,Herenthoutsesteenweg 2,2022-05-18,06:00:00,1,1,0,ECO_300019380
642,Herenthoutsesteenweg 2,2022-05-18,07:00:00,29,28,1,ECO_300019380
642,Herenthoutsesteenweg 2,2022-05-18,08:00:00,47,45,2,ECO_300019380
642,Herenthoutsesteenweg 2,2022-05-18,09:00:00,220,214,6,ECO_300019380
642,Herenthoutsesteenweg 2,2022-05-18,10:00:00,583,575,8,ECO_300019380
642,Herenthoutsesteenweg 2,2022-05-18,11:00:00,133,130,3,ECO_300019380
642,Herenthoutsesteenweg 2,2022-05-18,12:00:00,105,104,1,ECO_300019380
642,Herenthoutsesteenweg 2,2022-05-18,13:00:00,100,91,9,ECO_300019380
642,Herenthoutsesteenweg 2,2022-05-18,14:00:00,173,159,14,ECO_300019380
642,Herenthoutsesteenweg 2,2022-05-18,15:00:00,182,167,15,ECO_300019380
642,Herenthoutsesteenweg 2,2022-05-18,16:00:00,214,202,12,ECO_300019380
642,Herenthoutsesteenweg 2,2022-05-18,17:00:00,145,131,14,ECO_300019380
642,Herenthoutsesteenweg 2,2022-05-18,18:00:00,190,168,22,ECO_300019380
642,Herenthoutsesteenweg 2,2022-05-18,19:00:00,120,109,11,ECO_300019380
642,Herenthoutsesteenweg 2,2022-05-18,20:00:00,99,89,10,ECO_300019380
642,Herenthoutsesteenweg 2,2022-05-18,21:00:00,128,120,8,ECO_300019380
642,Herenthoutsesteenweg 2,2022-05-18,22:00:00,63,47,16,ECO_300019380
642,Herenthoutsesteenweg 2,2022-05-18,23:00:00,41,35,6,ECO_300019380
642,Herenthoutsesteenweg 2,2022-05-19,00:00:00,32,29,3,ECO_300019380
642,Herenthoutsesteenweg 2,2022-05-19,01:00:00,7,5,2,ECO_300019380
642,Herenthoutsesteenweg 2,2022-05-19,02:00:00,3,3,0,ECO_300019380
642,Herenthoutsesteenweg 2,2022-05-19,03:00:00,1,1,0,ECO_300019380
642,Herenthoutsesteenweg 2,2022-05-19,04:00:00,1,1,0,ECO_300019380
642,Herenthoutsesteenweg 2,2022-05-19,05:00:00,1,1,0,ECO_300019380
642,Herenthoutsesteenweg 2,2022-05-19,06:00:00,3,3,0,ECO_300019380
642,Herenthoutsesteenweg 2,2022-05-19,07:00:00,15,15,0,ECO_300019380
642,Herenthoutsesteenweg 2,2022-05-19,08:00:00,23,22,1,ECO_300019380
642,Herenthoutsesteenweg 2,2022-05-19,09:00:00,117,113,4,ECO_300019380
642,Herenthoutsesteenweg 2,2022-05-19,10:00:00,455,453,2,ECO_300019380
642,Herenthoutsesteenweg 2,2022-05-19,11:00:00,109,107,2,ECO_300019380
642,Herenthoutsesteenweg 2,2022-05-19,12:00:00,85,82,3,ECO_300019380
642,Herenthoutsesteenweg 2,2022-05-19,13:00:00,60,56,4,ECO_300019380
642,Herenthoutsesteenweg 2,2022-05-19,14:00:00,55,52,3,ECO_300019380
642,Herenthoutsesteenweg 2,2022-05-19,15:00:00,25,24,1,ECO_300019380
642,Herenthoutsesteenweg 2,2022-05-19,16:00:00,44,37,7,ECO_300019380
642,Herenthoutsesteenweg 2,2022-05-19,17:00:00,71,64,7,ECO_300019380
642,Herenthoutsesteenweg 2,2022-05-19,18:00:00,83,74,9,ECO_300019380
642,Herenthoutsesteenweg 2,2022-05-19,19:00:00,81,70,11,ECO_300019380
642,Herenthoutsesteenweg 2,2022-05-19,20:00:00,95,87,8,ECO_300019380
642,Herenthoutsesteenweg 2,2022-05-19,21:00:00,53,48,5,ECO_300019380
642,Herenthoutsesteenweg 2,2022-05-19,22:00:00,41,28,13,ECO_300019380
642,Herenthoutsesteenweg 2,2022-05-19,23:00:00,14,9,5,ECO_300019380
642,Herenthoutsesteenweg 2,2022-05-20,00:00:00,9,7,2,ECO_300019380
642,Herenthoutsesteenweg 2,2022-05-20,01:00:00,3,3,0,ECO_300019380
642,Herenthoutsesteenweg 2,2022-05-20,02:00:00,2,2,0,ECO_300019380
642,Herenthoutsesteenweg 2,2022-05-20,03:00:00,1,0,1,ECO_300019380
642,Herenthoutsesteenweg 2,2022-05-20,04:00:00,0,0,0,ECO_300019380
642,Herenthoutsesteenweg 2,2022-05-20,05:00:00,0,0,0,ECO_300019380
642,Herenthoutsesteenweg 2,2022-05-20,06:00:00,2,2,0,ECO_300019380
642,Herenthoutsesteenweg 2,2022-05-20,07:00:00,18,18,0,ECO_300019380
642,Herenthoutsesteenweg 2,2022-05-20,08:00:00,20,17,3,ECO_300019380
642,Herenthoutsesteenweg 2,2022-05-20,09:00:00,121,118,3,ECO_300019380
642,Herenthoutsesteenweg 2,2022-05-20,10:00:00,468,465,3,ECO_300019380
642,Herenthoutsesteenweg 2,2022-05-20,11:00:00,109,106,3,ECO_300019380
642,Herenthoutsesteenweg 2,2022-05-20,12:00:00,103,94,9,ECO_300019380
642,Herenthoutsesteenweg 2,2022-05-20,13:00:00,59,53,6,ECO_300019380
642,Herenthoutsesteenweg 2,2022-05-20,14:00:00,43,38,5,ECO_300019380
642,Herenthoutsesteenweg 2,2022-05-20,15:00:00,27,25,2,ECO_300019380
642,Herenthoutsesteenweg 2,2022-05-20,16:00:00,36,33,3,ECO_300019380
642,Herenthoutsesteenweg 2,2022-05-20,17:00:00,72,61,11,ECO_300019380
642,Herenthoutsesteenweg 2,2022-05-20,18:00:00,65,61,4,ECO_300019380
642,Herenthoutsesteenweg 2,2022-05-20,19:00:00,48,39,9,ECO_300019380
642,Herenthoutsesteenweg 2,2022-05-20,20:00:00,59,55,4,ECO_300019380
642,Herenthoutsesteenweg 2,2022-05-20,21:00:00,33,32,1,ECO_300019380
642,Herenthoutsesteenweg 2,2022-05-20,22:00:00,43,38,5,ECO_300019380
642,Herenthoutsesteenweg 2,2022-05-20,23:00:00,15,15,0,ECO_300019380
642,Herenthoutsesteenweg 2,2022-05-21,00:00:00,14,10,4,ECO_300019380
642,Herenthoutsesteenweg 2,2022-05-21,01:00:00,20,19,1,ECO_300019380
642,Herenthoutsesteenweg 2,2022-05-21,02:00:00,4,3,1,ECO_300019380
642,Herenthoutsesteenweg 2,2022-05-21,03:00:00,3,3,0,ECO_300019380
642,Herenthoutsesteenweg 2,2022-05-21,04:00:00,1,0,1,ECO_300019380
642,Herenthoutsesteenweg 2,2022-05-21,05:00:00,0,0,0,ECO_300019380
642,Herenthoutsesteenweg 2,2022-05-21,06:00:00,0,0,0,ECO_300019380
642,Herenthoutsesteenweg 2,2022-05-21,07:00:00,5,5,0,ECO_300019380
642,Herenthoutsesteenweg 2,2022-05-21,08:00:00,7,6,1,ECO_300019380
642,Herenthoutsesteenweg 2,2022-05-21,09:00:00,14,13,1,ECO_300019380
642,Herenthoutsesteenweg 2,2022-05-21,10:00:00,52,49,3,ECO_300019380
642,Herenthoutsesteenweg 2,2022-05-21,11:00:00,67,57,10,ECO_300019380
642,Herenthoutsesteenweg 2,2022-05-21,12:00:00,87,79,8,ECO_300019380
642,Herenthoutsesteenweg 2,2022-05-21,13:00:00,100,90,10,ECO_300019380
642,Herenthoutsesteenweg 2,2022-05-21,14:00:00,148,133,15,ECO_300019380
642,Herenthoutsesteenweg 2,2022-05-21,15:00:00,191,182,9,ECO_300019380
642,Herenthoutsesteenweg 2,2022-05-21,16:00:00,199,194,5,ECO_300019380
642,Herenthoutsesteenweg 2,2022-05-21,17:00:00,117,109,8,ECO_300019380
642,Herenthoutsesteenweg 2,2022-05-21,18:00:00,86,77,9,ECO_300019380
642,Herenthoutsesteenweg 2,2022-05-21,19:00:00,70,62,8,ECO_300019380
642,Herenthoutsesteenweg 2,2022-05-21,20:00:00,58,51,7,ECO_300019380
642,Herenthoutsesteenweg 2,2022-05-21,21:00:00,35,28,7,ECO_300019380
642,Herenthoutsesteenweg 2,2022-05-21,22:00:00,53,44,9,ECO_300019380
642,Herenthoutsesteenweg 2,2022-05-21,23:00:00,17,9,8,ECO_300019380
642,Herenthoutsesteenweg 2,2022-05-22,00:00:00,11,7,4,ECO_300019380
642,Herenthoutsesteenweg 2,2022-05-22,01:00:00,8,4,4,ECO_300019380
642,Herenthoutsesteenweg 2,2022-05-22,02:00:00,12,11,1,ECO_300019380
642,Herenthoutsesteenweg 2,2022-05-22,03:00:00,7,7,0,ECO_300019380
642,Herenthoutsesteenweg 2,2022-05-22,04:00:00,6,6,0,ECO_300019380
642,Herenthoutsesteenweg 2,2022-05-22,05:00:00,3,3,0,ECO_300019380
642,Herenthoutsesteenweg 2,2022-05-22,06:00:00,4,2,2,ECO_300019380
642,Herenthoutsesteenweg 2,2022-05-22,07:00:00,2,2,0,ECO_300019380
642,Herenthoutsesteenweg 2,2022-05-22,08:00:00,12,12,0,ECO_300019380
642,Herenthoutsesteenweg 2,2022-05-22,09:00:00,28,24,4,ECO_300019380
642,Herenthoutsesteenweg 2,2022-05-22,10:00:00,82,72,10,ECO_300019380
642,Herenthoutsesteenweg 2,2022-05-22,11:00:00,138,133,5,ECO_300019380
642,Herenthoutsesteenweg 2,2022-05-22,12:00:00,130,115,15,ECO_300019380
642,Herenthoutsesteenweg 2,2022-05-22,13:00:00,181,166,15,ECO_300019380
642,Herenthoutsesteenweg 2,2022-05-22,14:00:00,142,125,17,ECO_300019380
642,Herenthoutsesteenweg 2,2022-05-22,15:00:00,195,186,9,ECO_300019380
642,Herenthoutsesteenweg 2,2022-05-22,16:00:00,214,210,4,ECO_300019380
642,Herenthoutsesteenweg 2,2022-05-22,17:00:00,168,155,13,ECO_300019380
642,Herenthoutsesteenweg 2,2022-05-22,18:00:00,133,115,18,ECO_300019380
642,Herenthoutsesteenweg 2,2022-05-22,19:00:00,109,87,22,ECO_300019380
642,Herenthoutsesteenweg 2,2022-05-22,20:00:00,62,56,6,ECO_300019380
642,Herenthoutsesteenweg 2,2022-05-22,21:00:00,47,44,3,ECO_300019380
642,Herenthoutsesteenweg 2,2022-05-22,22:00:00,37,33,4,ECO_300019380
642,Herenthoutsesteenweg 2,2022-05-22,23:00:00,33,28,5,ECO_300019380
642,Herenthoutsesteenweg 2,2022-05-23,00:00:00,11,9,2,ECO_300019380
642,Herenthoutsesteenweg 2,2022-05-23,01:00:00,3,2,1,ECO_300019380
642,Herenthoutsesteenweg 2,2022-05-23,02:00:00,0,0,0,ECO_300019380
642,Herenthoutsesteenweg 2,2022-05-23,03:00:00,1,1,0,ECO_300019380
642,Herenthoutsesteenweg 2,2022-05-23,04:00:00,0,0,0,ECO_300019380
642,Herenthoutsesteenweg 2,2022-05-23,05:00:00,0,0,0,ECO_300019380
642,Herenthoutsesteenweg 2,2022-05-23,06:00:00,1,1,0,ECO_300019380
642,Herenthoutsesteenweg 2,2022-05-23,07:00:00,16,16,0,ECO_300019380
642,Herenthoutsesteenweg 2,2022-05-23,08:00:00,39,37,2,ECO_300019380
642,Herenthoutsesteenweg 2,2022-05-23,09:00:00,159,156,3,ECO_300019380
642,Herenthoutsesteenweg 2,2022-05-23,10:00:00,547,542,5,ECO_300019380
642,Herenthoutsesteenweg 2,2022-05-23,11:00:00,74,68,6,ECO_300019380
642,Herenthoutsesteenweg 2,2022-05-23,12:00:00,71,66,5,ECO_300019380
642,Herenthoutsesteenweg 2,2022-05-23,13:00:00,56,52,4,ECO_300019380
642,Herenthoutsesteenweg 2,2022-05-23,14:00:00,51,49,2,ECO_300019380
642,Herenthoutsesteenweg 2,2022-05-23,15:00:00,88,82,6,ECO_300019380
642,Herenthoutsesteenweg 2,2022-05-23,16:00:00,39,34,5,ECO_300019380
642,Herenthoutsesteenweg 2,2022-05-23,17:00:00,70,66,4,ECO_300019380
642,Herenthoutsesteenweg 2,2022-05-23,18:00:00,74,65,9,ECO_300019380
642,Herenthoutsesteenweg 2,2022-05-23,19:00:00,52,48,4,ECO_300019380
642,Herenthoutsesteenweg 2,2022-05-23,20:00:00,32,29,3,ECO_300019380
642,Herenthoutsesteenweg 2,2022-05-23,21:00:00,16,15,1,ECO_300019380
642,Herenthoutsesteenweg 2,2022-05-23,22:00:00,22,19,3,ECO_300019380
642,Herenthoutsesteenweg 2,2022-05-23,23:00:00,13,12,1,ECO_300019380
642,Herenthoutsesteenweg 2,2022-05-24,00:00:00,17,14,3,ECO_300019380
642,Herenthoutsesteenweg 2,2022-05-24,01:00:00,3,2,1,ECO_300019380
642,Herenthoutsesteenweg 2,2022-05-24,02:00:00,2,1,1,ECO_300019380
642,Herenthoutsesteenweg 2,2022-05-24,03:00:00,0,0,0,ECO_300019380
642,Herenthoutsesteenweg 2,2022-05-24,04:00:00,0,0,0,ECO_300019380
642,Herenthoutsesteenweg 2,2022-05-24,05:00:00,0,0,0,ECO_300019380
642,Herenthoutsesteenweg 2,2022-05-24,06:00:00,1,1,0,ECO_300019380
642,Herenthoutsesteenweg 2,2022-05-24,07:00:00,13,13,0,ECO_300019380
642,Herenthoutsesteenweg 2,2022-05-24,08:00:00,38,36,2,ECO_300019380
642,Herenthoutsesteenweg 2,2022-05-24,09:00:00,153,147,6,ECO_300019380
642,Herenthoutsesteenweg 2,2022-05-24,10:00:00,529,519,10,ECO_300019380
642,Herenthoutsesteenweg 2,2022-05-24,11:00:00,85,76,9,ECO_300019380
642,Herenthoutsesteenweg 2,2022-05-24,12:00:00,72,67,5,ECO_300019380
642,Herenthoutsesteenweg 2,2022-05-24,13:00:00,48,46,2,ECO_300019380
642,Herenthoutsesteenweg 2,2022-05-24,14:00:00,53,49,4,ECO_300019380
642,Herenthoutsesteenweg 2,2022-05-24,15:00:00,68,66,2,ECO_300019380
642,Herenthoutsesteenweg 2,2022-05-24,16:00:00,57,51,6,ECO_300019380
642,Herenthoutsesteenweg 2,2022-05-24,17:00:00,96,91,5,ECO_300019380
642,Herenthoutsesteenweg 2,2022-05-24,18:00:00,101,96,5,ECO_300019380
642,Herenthoutsesteenweg 2,2022-05-24,19:00:00,68,59,9,ECO_300019380
642,Herenthoutsesteenweg 2,2022-05-24,20:00:00,46,40,6,ECO_300019380
642,Herenthoutsesteenweg 2,2022-05-24,21:00:00,29,25,4,ECO_300019380
642,Herenthoutsesteenweg 2,2022-05-24,22:00:00,29,25,4,ECO_300019380
642,Herenthoutsesteenweg 2,2022-05-24,23:00:00,11,8,3,ECO_300019380
642,Herenthoutsesteenweg 2,2022-05-25,00:00:00,20,19,1,ECO_300019380
642,Herenthoutsesteenweg 2,2022-05-25,01:00:00,3,3,0,ECO_300019380
642,Herenthoutsesteenweg 2,2022-05-25,02:00:00,0,0,0,ECO_300019380
642,Herenthoutsesteenweg 2,2022-05-25,03:00:00,0,0,0,ECO_300019380
642,Herenthoutsesteenweg 2,2022-05-25,04:00:00,0,0,0,ECO_300019380
642,Herenthoutsesteenweg 2,2022-05-25,05:00:00,0,0,0,ECO_300019380
642,Herenthoutsesteenweg 2,2022-05-25,06:00:00,4,4,0,ECO_300019380
642,Herenthoutsesteenweg 2,2022-05-25,07:00:00,19,15,4,ECO_300019380
642,Herenthoutsesteenweg 2,2022-05-25,08:00:00,40,35,5,ECO_300019380
642,Herenthoutsesteenweg 2,2022-05-25,09:00:00,159,156,3,ECO_300019380
642,Herenthoutsesteenweg 2,2022-05-25,10:00:00,514,506,8,ECO_300019380
642,Herenthoutsesteenweg 2,2022-05-25,11:00:00,118,111,7,ECO_300019380
642,Herenthoutsesteenweg 2,2022-05-25,12:00:00,87,84,3,ECO_300019380
642,Herenthoutsesteenweg 2,2022-05-25,13:00:00,85,79,6,ECO_300019380
642,Herenthoutsesteenweg 2,2022-05-25,14:00:00,134,119,15,ECO_300019380
642,Herenthoutsesteenweg 2,2022-05-25,15:00:00,120,106,14,ECO_300019380
642,Herenthoutsesteenweg 2,2022-05-25,16:00:00,123,115,8,ECO_300019380
642,Herenthoutsesteenweg 2,2022-05-25,17:00:00,95,90,5,ECO_300019380
642,Herenthoutsesteenweg 2,2022-05-25,18:00:00,177,161,16,ECO_300019380
642,Herenthoutsesteenweg 2,2022-05-25,19:00:00,83,79,4,ECO_300019380
642,Herenthoutsesteenweg 2,2022-05-25,20:00:00,63,55,8,ECO_300019380
642,Herenthoutsesteenweg 2,2022-05-25,21:00:00,50,40,10,ECO_300019380
642,Herenthoutsesteenweg 2,2022-05-25,22:00:00,33,26,7,ECO_300019380
642,Herenthoutsesteenweg 2,2022-05-25,23:00:00,29,27,2,ECO_300019380
642,Herenthoutsesteenweg 2,2022-05-26,00:00:00,21,19,2,ECO_300019380
642,Herenthoutsesteenweg 2,2022-05-26,01:00:00,20,8,12,ECO_300019380
642,Herenthoutsesteenweg 2,2022-05-26,02:00:00,5,5,0,ECO_300019380
642,Herenthoutsesteenweg 2,2022-05-26,03:00:00,8,8,0,ECO_300019380
642,Herenthoutsesteenweg 2,2022-05-26,04:00:00,11,10,1,ECO_300019380
642,Herenthoutsesteenweg 2,2022-05-26,05:00:00,11,10,1,ECO_300019380
642,Herenthoutsesteenweg 2,2022-05-26,06:00:00,22,22,0,ECO_300019380
642,Herenthoutsesteenweg 2,2022-05-26,07:00:00,11,11,0,ECO_300019380
642,Herenthoutsesteenweg 2,2022-05-26,08:00:00,9,8,1,ECO_300019380
642,Herenthoutsesteenweg 2,2022-05-26,09:00:00,9,9,0,ECO_300019380
642,Herenthoutsesteenweg 2,2022-05-26,10:00:00,29,23,6,ECO_300019380
642,Herenthoutsesteenweg 2,2022-05-26,11:00:00,48,38,10,ECO_300019380
642,Herenthoutsesteenweg 2,2022-05-26,12:00:00,104,88,16,ECO_300019380
642,Herenthoutsesteenweg 2,2022-05-26,13:00:00,77,68,9,ECO_300019380
642,Herenthoutsesteenweg 2,2022-05-26,14:00:00,74,70,4,ECO_300019380
642,Herenthoutsesteenweg 2,2022-05-26,15:00:00,116,111,5,ECO_300019380
642,Herenthoutsesteenweg 2,2022-05-26,16:00:00,135,128,7,ECO_300019380
642,Herenthoutsesteenweg 2,2022-05-26,17:00:00,102,98,4,ECO_300019380
642,Herenthoutsesteenweg 2,2022-05-26,18:00:00,84,80,4,ECO_300019380
642,Herenthoutsesteenweg 2,2022-05-26,19:00:00,71,63,8,ECO_300019380
642,Herenthoutsesteenweg 2,2022-05-26,20:00:00,58,42,16,ECO_300019380
642,Herenthoutsesteenweg 2,2022-05-26,21:00:00,29,22,7,ECO_300019380
642,Herenthoutsesteenweg 2,2022-05-26,22:00:00,26,24,2,ECO_300019380
642,Herenthoutsesteenweg 2,2022-05-26,23:00:00,25,22,3,ECO_300019380
642,Herenthoutsesteenweg 2,2022-05-27,00:00:00,12,10,2,ECO_300019380
642,Herenthoutsesteenweg 2,2022-05-27,01:00:00,12,11,1,ECO_300019380
642,Herenthoutsesteenweg 2,2022-05-27,02:00:00,33,33,0,ECO_300019380
642,Herenthoutsesteenweg 2,2022-05-27,03:00:00,9,8,1,ECO_300019380
642,Herenthoutsesteenweg 2,2022-05-27,04:00:00,2,1,1,ECO_300019380
642,Herenthoutsesteenweg 2,2022-05-27,05:00:00,1,1,0,ECO_300019380
642,Herenthoutsesteenweg 2,2022-05-27,06:00:00,0,0,0,ECO_300019380
642,Herenthoutsesteenweg 2,2022-05-27,07:00:00,3,3,0,ECO_300019380
642,Herenthoutsesteenweg 2,2022-05-27,08:00:00,11,10,1,ECO_300019380
642,Herenthoutsesteenweg 2,2022-05-27,09:00:00,20,18,2,ECO_300019380
642,Herenthoutsesteenweg 2,2022-05-27,10:00:00,41,41,0,ECO_300019380
642,Herenthoutsesteenweg 2,2022-05-27,11:00:00,91,91,0,ECO_300019380
642,Herenthoutsesteenweg 2,2022-05-27,12:00:00,120,110,10,ECO_300019380
642,Herenthoutsesteenweg 2,2022-05-27,13:00:00,77,74,3,ECO_300019380
642,Herenthoutsesteenweg 2,2022-05-27,14:00:00,61,57,4,ECO_300019380
642,Herenthoutsesteenweg 2,2022-05-27,15:00:00,120,107,13,ECO_300019380
642,Herenthoutsesteenweg 2,2022-05-27,16:00:00,112,105,7,ECO_300019380
642,Herenthoutsesteenweg 2,2022-05-27,17:00:00,100,90,10,ECO_300019380
642,Herenthoutsesteenweg 2,2022-05-27,18:00:00,75,65,10,ECO_300019380
642,Herenthoutsesteenweg 2,2022-05-27,19:00:00,77,66,11,ECO_300019380
642,Herenthoutsesteenweg 2,2022-05-27,20:00:00,44,34,10,ECO_300019380
642,Herenthoutsesteenweg 2,2022-05-27,21:00:00,46,34,12,ECO_300019380
642,Herenthoutsesteenweg 2,2022-05-27,22:00:00,40,33,7,ECO_300019380
642,Herenthoutsesteenweg 2,2022-05-27,23:00:00,28,23,5,ECO_300019380
642,Herenthoutsesteenweg 2,2022-05-28,00:00:00,14,11,3,ECO_300019380
642,Herenthoutsesteenweg 2,2022-05-28,01:00:00,21,19,2,ECO_300019380
642,Herenthoutsesteenweg 2,2022-05-28,02:00:00,20,18,2,ECO_300019380
642,Herenthoutsesteenweg 2,2022-05-28,03:00:00,35,34,1,ECO_300019380
642,Herenthoutsesteenweg 2,2022-05-28,04:00:00,12,12,0,ECO_300019380
642,Herenthoutsesteenweg 2,2022-05-28,05:00:00,2,1,1,ECO_300019380
642,Herenthoutsesteenweg 2,2022-05-28,06:00:00,4,3,1,ECO_300019380
642,Herenthoutsesteenweg 2,2022-05-28,07:00:00,4,4,0,ECO_300019380
642,Herenthoutsesteenweg 2,2022-05-28,08:00:00,13,13,0,ECO_300019380
642,Herenthoutsesteenweg 2,2022-05-28,09:00:00,20,17,3,ECO_300019380
642,Herenthoutsesteenweg 2,2022-05-28,10:00:00,50,48,2,ECO_300019380
642,Herenthoutsesteenweg 2,2022-05-28,11:00:00,62,58,4,ECO_300019380
642,Herenthoutsesteenweg 2,2022-05-28,12:00:00,97,94,3,ECO_300019380
642,Herenthoutsesteenweg 2,2022-05-28,13:00:00,117,110,7,ECO_300019380
642,Herenthoutsesteenweg 2,2022-05-28,14:00:00,115,98,17,ECO_300019380
642,Herenthoutsesteenweg 2,2022-05-28,15:00:00,173,164,9,ECO_300019380
642,Herenthoutsesteenweg 2,2022-05-28,16:00:00,100,92,8,ECO_300019380
642,Herenthoutsesteenweg 2,2022-05-28,17:00:00,98,83,15,ECO_300019380
642,Herenthoutsesteenweg 2,2022-05-28,18:00:00,99,70,29,ECO_300019380
642,Herenthoutsesteenweg 2,2022-05-28,19:00:00,85,79,6,ECO_300019380
642,Herenthoutsesteenweg 2,2022-05-28,20:00:00,52,41,11,ECO_300019380
642,Herenthoutsesteenweg 2,2022-05-28,21:00:00,52,42,10,ECO_300019380
642,Herenthoutsesteenweg 2,2022-05-28,22:00:00,40,35,5,ECO_300019380
642,Herenthoutsesteenweg 2,2022-05-28,23:00:00,18,16,2,ECO_300019380
642,Herenthoutsesteenweg 2,2022-05-29,00:00:00,16,15,1,ECO_300019380
642,Herenthoutsesteenweg 2,2022-05-29,01:00:00,20,20,0,ECO_300019380
642,Herenthoutsesteenweg 2,2022-05-29,02:00:00,41,40,1,ECO_300019380
642,Herenthoutsesteenweg 2,2022-05-29,03:00:00,40,40,0,ECO_300019380
642,Herenthoutsesteenweg 2,2022-05-29,04:00:00,46,46,0,ECO_300019380
642,Herenthoutsesteenweg 2,2022-05-29,05:00:00,9,8,1,ECO_300019380
642,Herenthoutsesteenweg 2,2022-05-29,06:00:00,3,3,0,ECO_300019380
642,Herenthoutsesteenweg 2,2022-05-29,07:00:00,1,0,1,ECO_300019380
642,Herenthoutsesteenweg 2,2022-05-29,08:00:00,13,13,0,ECO_300019380
642,Herenthoutsesteenweg 2,2022-05-29,09:00:00,21,19,2,ECO_300019380
642,Herenthoutsesteenweg 2,2022-05-29,10:00:00,42,40,2,ECO_300019380
642,Herenthoutsesteenweg 2,2022-05-29,11:00:00,72,67,5,ECO_300019380
642,Herenthoutsesteenweg 2,2022-05-29,12:00:00,73,63,10,ECO_300019380
642,Herenthoutsesteenweg 2,2022-05-29,13:00:00,66,58,8,ECO_300019380
642,Herenthoutsesteenweg 2,2022-05-29,14:00:00,36,32,4,ECO_300019380
642,Herenthoutsesteenweg 2,2022-05-29,15:00:00,30,25,5,ECO_300019380
642,Herenthoutsesteenweg 2,2022-05-29,16:00:00,36,31,5,ECO_300019380
642,Herenthoutsesteenweg 2,2022-05-29,17:00:00,23,22,1,ECO_300019380
642,Herenthoutsesteenweg 2,2022-05-29,18:00:00,26,24,2,ECO_300019380
642,Herenthoutsesteenweg 2,2022-05-29,19:00:00,27,26,1,ECO_300019380
642,Herenthoutsesteenweg 2,2022-05-29,20:00:00,25,24,1,ECO_300019380
642,Herenthoutsesteenweg 2,2022-05-29,21:00:00,16,15,1,ECO_300019380
642,Herenthoutsesteenweg 2,2022-05-29,22:00:00,16,13,3,ECO_300019380
642,Herenthoutsesteenweg 2,2022-05-29,23:00:00,8,7,1,ECO_300019380
642,Herenthoutsesteenweg 2,2022-05-30,00:00:00,7,6,1,ECO_300019380
642,Herenthoutsesteenweg 2,2022-05-30,01:00:00,1,1,0,ECO_300019380
642,Herenthoutsesteenweg 2,2022-05-30,02:00:00,0,0,0,ECO_300019380
642,Herenthoutsesteenweg 2,2022-05-30,03:00:00,0,0,0,ECO_300019380
642,Herenthoutsesteenweg 2,2022-05-30,04:00:00,0,0,0,ECO_300019380
642,Herenthoutsesteenweg 2,2022-05-30,05:00:00,1,1,0,ECO_300019380
642,Herenthoutsesteenweg 2,2022-05-30,06:00:00,1,1,0,ECO_300019380
642,Herenthoutsesteenweg 2,2022-05-30,07:00:00,21,21,0,ECO_300019380
642,Herenthoutsesteenweg 2,2022-05-30,08:00:00,43,41,2,ECO_300019380
642,Herenthoutsesteenweg 2,2022-05-30,09:00:00,190,185,5,ECO_300019380
642,Herenthoutsesteenweg 2,2022-05-30,10:00:00,553,541,12,ECO_300019380
642,Herenthoutsesteenweg 2,2022-05-30,11:00:00,102,97,5,ECO_300019380
642,Herenthoutsesteenweg 2,2022-05-30,12:00:00,82,76,6,ECO_300019380
642,Herenthoutsesteenweg 2,2022-05-30,13:00:00,73,68,5,ECO_300019380
642,Herenthoutsesteenweg 2,2022-05-30,14:00:00,72,68,4,ECO_300019380
642,Herenthoutsesteenweg 2,2022-05-30,15:00:00,90,86,4,ECO_300019380
642,Herenthoutsesteenweg 2,2022-05-30,16:00:00,112,104,8,ECO_300019380
642,Herenthoutsesteenweg 2,2022-05-30,17:00:00,166,157,9,ECO_300019380
642,Herenthoutsesteenweg 2,2022-05-30,18:00:00,143,133,10,ECO_300019380
642,Herenthoutsesteenweg 2,2022-05-30,19:00:00,104,92,12,ECO_300019380
642,Herenthoutsesteenweg 2,2022-05-30,20:00:00,72,65,7,ECO_300019380
642,Herenthoutsesteenweg 2,2022-05-30,21:00:00,42,39,3,ECO_300019380
642,Herenthoutsesteenweg 2,2022-05-30,22:00:00,16,14,2,ECO_300019380
642,Herenthoutsesteenweg 2,2022-05-30,23:00:00,16,14,2,ECO_300019380
642,Herenthoutsesteenweg 2,2022-05-31,00:00:00,14,13,1,ECO_300019380
642,Herenthoutsesteenweg 2,2022-05-31,01:00:00,0,0,0,ECO_300019380
642,Herenthoutsesteenweg 2,2022-05-31,02:00:00,4,2,2,ECO_300019380
642,Herenthoutsesteenweg 2,2022-05-31,03:00:00,0,0,0,ECO_300019380
642,Herenthoutsesteenweg 2,2022-05-31,04:00:00,0,0,0,ECO_300019380
642,Herenthoutsesteenweg 2,2022-05-31,05:00:00,1,0,1,ECO_300019380
642,Herenthoutsesteenweg 2,2022-05-31,06:00:00,3,3,0,ECO_300019380
642,Herenthoutsesteenweg 2,2022-05-31,07:00:00,16,15,1,ECO_300019380
642,Herenthoutsesteenweg 2,2022-05-31,08:00:00,40,36,4,ECO_300019380
642,Herenthoutsesteenweg 2,2022-05-31,09:00:00,161,157,4,ECO_300019380
642,Herenthoutsesteenweg 2,2022-05-31,10:00:00,574,566,8,ECO_300019380
642,Herenthoutsesteenweg 2,2022-05-31,11:00:00,125,119,6,ECO_300019380
642,Herenthoutsesteenweg 2,2022-05-31,12:00:00,98,93,5,ECO_300019380
642,Herenthoutsesteenweg 2,2022-05-31,13:00:00,75,67,8,ECO_300019380
642,Herenthoutsesteenweg 2,2022-05-31,14:00:00,112,106,6,ECO_300019380
642,Herenthoutsesteenweg 2,2022-05-31,15:00:00,111,103,8,ECO_300019380
642,Herenthoutsesteenweg 2,2022-05-31,16:00:00,135,127,8,ECO_300019380
642,Herenthoutsesteenweg 2,2022-05-31,17:00:00,141,121,20,ECO_300019380
642,Herenthoutsesteenweg 2,2022-05-31,18:00:00,185,176,9,ECO_300019380
642,Herenthoutsesteenweg 2,2022-05-31,19:00:00,120,112,8,ECO_300019380
642,Herenthoutsesteenweg 2,2022-05-31,20:00:00,42,33,9,ECO_300019380
642,Herenthoutsesteenweg 2,2022-05-31,21:00:00,36,33,3,ECO_300019380
642,Herenthoutsesteenweg 2,2022-05-31,22:00:00,22,18,4,ECO_300019380
642,Herenthoutsesteenweg 2,2022-05-31,23:00:00,24,20,4,ECO_300019380
642,Herenthoutsesteenweg 2,2022-06-01,00:00:00,20,17,3,ECO_300019380
642,Herenthoutsesteenweg 2,2022-06-01,01:00:00,4,3,1,ECO_300019380
642,Herenthoutsesteenweg 2,2022-06-01,02:00:00,0,0,0,ECO_300019380
642,Herenthoutsesteenweg 2,2022-06-01,03:00:00,2,1,1,ECO_300019380
642,Herenthoutsesteenweg 2,2022-06-01,04:00:00,0,0,0,ECO_300019380
642,Herenthoutsesteenweg 2,2022-06-01,05:00:00,0,0,0,ECO_300019380
642,Herenthoutsesteenweg 2,2022-06-01,06:00:00,1,1,0,ECO_300019380
642,Herenthoutsesteenweg 2,2022-06-01,07:00:00,25,24,1,ECO_300019380
642,Herenthoutsesteenweg 2,2022-06-01,08:00:00,49,44,5,ECO_300019380
642,Herenthoutsesteenweg 2,2022-06-01,09:00:00,179,171,8,ECO_300019380
642,Herenthoutsesteenweg 2,2022-06-01,10:00:00,572,565,7,ECO_300019380
642,Herenthoutsesteenweg 2,2022-06-01,11:00:00,126,110,16,ECO_300019380
642,Herenthoutsesteenweg 2,2022-06-01,12:00:00,85,77,8,ECO_300019380
642,Herenthoutsesteenweg 2,2022-06-01,13:00:00,74,71,3,ECO_300019380
642,Herenthoutsesteenweg 2,2022-06-01,14:00:00,169,155,14,ECO_300019380
642,Herenthoutsesteenweg 2,2022-06-01,15:00:00,120,111,9,ECO_300019380
642,Herenthoutsesteenweg 2,2022-06-01,16:00:00,101,94,7,ECO_300019380
642,Herenthoutsesteenweg 2,2022-06-01,17:00:00,71,61,10,ECO_300019380
642,Herenthoutsesteenweg 2,2022-06-01,18:00:00,130,122,8,ECO_300019380
642,Herenthoutsesteenweg 2,2022-06-01,19:00:00,93,82,11,ECO_300019380
642,Herenthoutsesteenweg 2,2022-06-01,20:00:00,64,57,7,ECO_300019380
642,Herenthoutsesteenweg 2,2022-06-01,21:00:00,47,39,8,ECO_300019380
642,Herenthoutsesteenweg 2,2022-06-01,22:00:00,40,33,7,ECO_300019380
642,Herenthoutsesteenweg 2,2022-06-01,23:00:00,33,28,5,ECO_300019380
642,Herenthoutsesteenweg 2,2022-06-02,00:00:00,33,28,5,ECO_300019380
642,Herenthoutsesteenweg 2,2022-06-02,01:00:00,6,5,1,ECO_300019380
642,Herenthoutsesteenweg 2,2022-06-02,02:00:00,2,2,0,ECO_300019380
642,Herenthoutsesteenweg 2,2022-06-02,03:00:00,1,1,0,ECO_300019380
642,Herenthoutsesteenweg 2,2022-06-02,04:00:00,0,0,0,ECO_300019380
642,Herenthoutsesteenweg 2,2022-06-02,05:00:00,0,0,0,ECO_300019380
642,Herenthoutsesteenweg 2,2022-06-02,06:00:00,3,3,0,ECO_300019380
642,Herenthoutsesteenweg 2,2022-06-02,07:00:00,25,24,1,ECO_300019380
642,Herenthoutsesteenweg 2,2022-06-02,08:00:00,52,49,3,ECO_300019380
642,Herenthoutsesteenweg 2,2022-06-02,09:00:00,180,175,5,ECO_300019380
642,Herenthoutsesteenweg 2,2022-06-02,10:00:00,630,616,14,ECO_300019380
642,Herenthoutsesteenweg 2,2022-06-02,11:00:00,145,140,5,ECO_300019380
642,Herenthoutsesteenweg 2,2022-06-02,12:00:00,92,79,13,ECO_300019380
642,Herenthoutsesteenweg 2,2022-06-02,13:00:00,85,75,10,ECO_300019380
642,Herenthoutsesteenweg 2,2022-06-02,14:00:00,106,93,13,ECO_300019380
642,Herenthoutsesteenweg 2,2022-06-02,15:00:00,146,140,6,ECO_300019380
642,Herenthoutsesteenweg 2,2022-06-02,16:00:00,153,133,20,ECO_300019380
642,Herenthoutsesteenweg 2,2022-06-02,17:00:00,146,131,15,ECO_300019380
642,Herenthoutsesteenweg 2,2022-06-02,18:00:00,190,172,18,ECO_300019380
642,Herenthoutsesteenweg 2,2022-06-02,19:00:00,117,112,5,ECO_300019380
642,Herenthoutsesteenweg 2,2022-06-02,20:00:00,101,86,15,ECO_300019380
642,Herenthoutsesteenweg 2,2022-06-02,21:00:00,95,83,12,ECO_300019380
642,Herenthoutsesteenweg 2,2022-06-02,22:00:00,50,43,7,ECO_300019380
642,Herenthoutsesteenweg 2,2022-06-02,23:00:00,28,26,2,ECO_300019380
642,Herenthoutsesteenweg 2,2022-06-03,00:00:00,21,15,6,ECO_300019380
642,Herenthoutsesteenweg 2,2022-06-03,01:00:00,5,3,2,ECO_300019380
642,Herenthoutsesteenweg 2,2022-06-03,02:00:00,2,0,2,ECO_300019380
642,Herenthoutsesteenweg 2,2022-06-03,03:00:00,1,0,1,ECO_300019380
642,Herenthoutsesteenweg 2,2022-06-03,04:00:00,0,0,0,ECO_300019380
642,Herenthoutsesteenweg 2,2022-06-03,05:00:00,1,1,0,ECO_300019380
642,Herenthoutsesteenweg 2,2022-06-03,06:00:00,2,2,0,ECO_300019380
642,Herenthoutsesteenweg 2,2022-06-03,07:00:00,24,22,2,ECO_300019380
642,Herenthoutsesteenweg 2,2022-06-03,08:00:00,45,43,2,ECO_300019380
642,Herenthoutsesteenweg 2,2022-06-03,09:00:00,182,176,6,ECO_300019380
642,Herenthoutsesteenweg 2,2022-06-03,10:00:00,653,646,7,ECO_300019380
642,Herenthoutsesteenweg 2,2022-06-03,11:00:00,188,180,8,ECO_300019380
642,Herenthoutsesteenweg 2,2022-06-03,12:00:00,181,179,2,ECO_300019380
642,Herenthoutsesteenweg 2,2022-06-03,13:00:00,118,108,10,ECO_300019380
642,Herenthoutsesteenweg 2,2022-06-03,14:00:00,105,98,7,ECO_300019380
642,Herenthoutsesteenweg 2,2022-06-03,15:00:00,133,125,8,ECO_300019380
642,Herenthoutsesteenweg 2,2022-06-03,16:00:00,165,151,14,ECO_300019380
642,Herenthoutsesteenweg 2,2022-06-03,17:00:00,207,186,21,ECO_300019380
642,Herenthoutsesteenweg 2,2022-06-03,18:00:00,194,174,20,ECO_300019380
642,Herenthoutsesteenweg 2,2022-06-03,19:00:00,128,114,14,ECO_300019380
642,Herenthoutsesteenweg 2,2022-06-03,20:00:00,96,87,9,ECO_300019380
642,Herenthoutsesteenweg 2,2022-06-03,21:00:00,65,53,12,ECO_300019380
642,Herenthoutsesteenweg 2,2022-06-03,22:00:00,41,38,3,ECO_300019380
642,Herenthoutsesteenweg 2,2022-06-03,23:00:00,26,19,7,ECO_300019380
642,Herenthoutsesteenweg 2,2022-06-04,00:00:00,19,15,4,ECO_300019380
642,Herenthoutsesteenweg 2,2022-06-04,01:00:00,13,8,5,ECO_300019380
642,Herenthoutsesteenweg 2,2022-06-04,02:00:00,9,7,2,ECO_300019380
642,Herenthoutsesteenweg 2,2022-06-04,03:00:00,6,3,3,ECO_300019380
642,Herenthoutsesteenweg 2,2022-06-04,04:00:00,6,2,4,ECO_300019380
642,Herenthoutsesteenweg 2,2022-06-04,05:00:00,3,1,2,ECO_300019380
642,Herenthoutsesteenweg 2,2022-06-04,06:00:00,1,1,0,ECO_300019380
642,Herenthoutsesteenweg 2,2022-06-04,07:00:00,4,4,0,ECO_300019380
642,Herenthoutsesteenweg 2,2022-06-04,08:00:00,15,14,1,ECO_300019380
642,Herenthoutsesteenweg 2,2022-06-04,09:00:00,20,20,0,ECO_300019380
642,Herenthoutsesteenweg 2,2022-06-04,10:00:00,35,33,2,ECO_300019380
642,Herenthoutsesteenweg 2,2022-06-04,11:00:00,88,78,10,ECO_300019380
642,Herenthoutsesteenweg 2,2022-06-04,12:00:00,137,125,12,ECO_300019380
642,Herenthoutsesteenweg 2,2022-06-04,13:00:00,140,129,11,ECO_300019380
642,Herenthoutsesteenweg 2,2022-06-04,14:00:00,116,100,16,ECO_300019380
642,Herenthoutsesteenweg 2,2022-06-04,15:00:00,222,211,11,ECO_300019380
642,Herenthoutsesteenweg 2,2022-06-04,16:00:00,189,162,27,ECO_300019380
642,Herenthoutsesteenweg 2,2022-06-04,17:00:00,155,131,24,ECO_300019380
642,Herenthoutsesteenweg 2,2022-06-04,18:00:00,132,122,10,ECO_300019380
642,Herenthoutsesteenweg 2,2022-06-04,19:00:00,105,90,15,ECO_300019380
642,Herenthoutsesteenweg 2,2022-06-04,20:00:00,60,51,9,ECO_300019380
642,Herenthoutsesteenweg 2,2022-06-04,21:00:00,54,47,7,ECO_300019380
642,Herenthoutsesteenweg 2,2022-06-04,22:00:00,56,50,6,ECO_300019380
642,Herenthoutsesteenweg 2,2022-06-04,23:00:00,30,16,14,ECO_300019380
642,Herenthoutsesteenweg 2,2022-06-05,00:00:00,19,15,4,ECO_300019380
642,Herenthoutsesteenweg 2,2022-06-05,01:00:00,9,9,0,ECO_300019380
642,Herenthoutsesteenweg 2,2022-06-05,02:00:00,4,2,2,ECO_300019380
642,Herenthoutsesteenweg 2,2022-06-05,03:00:00,3,1,2,ECO_300019380
642,Herenthoutsesteenweg 2,2022-06-05,04:00:00,0,0,0,ECO_300019380
642,Herenthoutsesteenweg 2,2022-06-05,05:00:00,4,1,3,ECO_300019380
642,Herenthoutsesteenweg 2,2022-06-05,06:00:00,1,0,1,ECO_300019380
642,Herenthoutsesteenweg 2,2022-06-05,07:00:00,1,0,1,ECO_300019380
642,Herenthoutsesteenweg 2,2022-06-05,08:00:00,6,6,0,ECO_300019380
642,Herenthoutsesteenweg 2,2022-06-05,09:00:00,22,21,1,ECO_300019380
642,Herenthoutsesteenweg 2,2022-06-05,10:00:00,61,60,1,ECO_300019380
642,Herenthoutsesteenweg 2,2022-06-05,11:00:00,71,68,3,ECO_300019380
642,Herenthoutsesteenweg 2,2022-06-05,12:00:00,64,60,4,ECO_300019380
642,Herenthoutsesteenweg 2,2022-06-05,13:00:00,51,42,9,ECO_300019380
642,Herenthoutsesteenweg 2,2022-06-05,14:00:00,13,12,1,ECO_300019380
642,Herenthoutsesteenweg 2,2022-06-05,15:00:00,13,10,3,ECO_300019380
642,Herenthoutsesteenweg 2,2022-06-05,16:00:00,3,3,0,ECO_300019380
642,Herenthoutsesteenweg 2,2022-06-05,17:00:00,2,2,0,ECO_300019380
642,Herenthoutsesteenweg 2,2022-06-05,18:00:00,6,5,1,ECO_300019380
642,Herenthoutsesteenweg 2,2022-06-05,19:00:00,6,6,0,ECO_300019380
642,Herenthoutsesteenweg 2,2022-06-05,20:00:00,7,7,0,ECO_300019380
642,Herenthoutsesteenweg 2,2022-06-05,21:00:00,22,18,4,ECO_300019380
642,Herenthoutsesteenweg 2,2022-06-05,22:00:00,28,28,0,ECO_300019380
642,Herenthoutsesteenweg 2,2022-06-05,23:00:00,15,11,4,ECO_300019380
642,Herenthoutsesteenweg 2,2022-06-06,00:00:00,5,5,0,ECO_300019380
642,Herenthoutsesteenweg 2,2022-06-06,01:00:00,5,5,0,ECO_300019380
642,Herenthoutsesteenweg 2,2022-06-06,02:00:00,2,0,2,ECO_300019380
642,Herenthoutsesteenweg 2,2022-06-06,03:00:00,2,2,0,ECO_300019380
642,Herenthoutsesteenweg 2,2022-06-06,04:00:00,1,0,1,ECO_300019380
642,Herenthoutsesteenweg 2,2022-06-06,05:00:00,1,1,0,ECO_300019380
642,Herenthoutsesteenweg 2,2022-06-06,06:00:00,0,0,0,ECO_300019380
642,Herenthoutsesteenweg 2,2022-06-06,07:00:00,0,0,0,ECO_300019380
642,Herenthoutsesteenweg 2,2022-06-06,08:00:00,6,6,0,ECO_300019380
642,Herenthoutsesteenweg 2,2022-06-06,09:00:00,16,16,0,ECO_300019380
642,Herenthoutsesteenweg 2,2022-06-06,10:00:00,36,35,1,ECO_300019380
642,Herenthoutsesteenweg 2,2022-06-06,11:00:00,45,38,7,ECO_300019380
642,Herenthoutsesteenweg 2,2022-06-06,12:00:00,59,49,10,ECO_300019380
642,Herenthoutsesteenweg 2,2022-06-06,13:00:00,82,70,12,ECO_300019380
642,Herenthoutsesteenweg 2,2022-06-06,14:00:00,48,43,5,ECO_300019380
642,Herenthoutsesteenweg 2,2022-06-06,15:00:00,58,55,3,ECO_300019380
642,Herenthoutsesteenweg 2,2022-06-06,16:00:00,51,49,2,ECO_300019380
642,Herenthoutsesteenweg 2,2022-06-06,17:00:00,28,24,4,ECO_300019380
642,Herenthoutsesteenweg 2,2022-06-06,18:00:00,53,46,7,ECO_300019380
642,Herenthoutsesteenweg 2,2022-06-06,19:00:00,30,28,2,ECO_300019380
642,Herenthoutsesteenweg 2,2022-06-06,20:00:00,12,12,0,ECO_300019380
642,Herenthoutsesteenweg 2,2022-06-06,21:00:00,26,23,3,ECO_300019380
642,Herenthoutsesteenweg 2,2022-06-06,22:00:00,22,18,4,ECO_300019380
642,Herenthoutsesteenweg 2,2022-06-06,23:00:00,12,10,2,ECO_300019380
642,Herenthoutsesteenweg 2,2022-06-07,00:00:00,7,5,2,ECO_300019380
642,Herenthoutsesteenweg 2,2022-06-07,01:00:00,4,2,2,ECO_300019380
642,Herenthoutsesteenweg 2,2022-06-07,02:00:00,2,1,1,ECO_300019380
642,Herenthoutsesteenweg 2,2022-06-07,03:00:00,0,0,0,ECO_300019380
642,Herenthoutsesteenweg 2,2022-06-07,04:00:00,0,0,0,ECO_300019380
642,Herenthoutsesteenweg 2,2022-06-07,05:00:00,0,0,0,ECO_300019380
642,Herenthoutsesteenweg 2,2022-06-07,06:00:00,6,6,0,ECO_300019380
642,Herenthoutsesteenweg 2,2022-06-07,07:00:00,19,18,1,ECO_300019380
642,Herenthoutsesteenweg 2,2022-06-07,08:00:00,40,37,3,ECO_300019380
642,Herenthoutsesteenweg 2,2022-06-07,09:00:00,191,188,3,ECO_300019380
642,Herenthoutsesteenweg 2,2022-06-07,10:00:00,568,567,1,ECO_300019380
642,Herenthoutsesteenweg 2,2022-06-07,11:00:00,100,96,4,ECO_300019380
642,Herenthoutsesteenweg 2,2022-06-07,12:00:00,98,93,5,ECO_300019380
642,Herenthoutsesteenweg 2,2022-06-07,13:00:00,87,83,4,ECO_300019380
642,Herenthoutsesteenweg 2,2022-06-07,14:00:00,64,60,4,ECO_300019380
642,Herenthoutsesteenweg 2,2022-06-07,15:00:00,92,85,7,ECO_300019380
642,Herenthoutsesteenweg 2,2022-06-07,16:00:00,96,83,13,ECO_300019380
642,Herenthoutsesteenweg 2,2022-06-07,17:00:00,132,127,5,ECO_300019380
642,Herenthoutsesteenweg 2,2022-06-07,18:00:00,128,116,12,ECO_300019380
642,Herenthoutsesteenweg 2,2022-06-07,19:00:00,125,110,15,ECO_300019380
642,Herenthoutsesteenweg 2,2022-06-07,20:00:00,53,46,7,ECO_300019380
642,Herenthoutsesteenweg 2,2022-06-07,21:00:00,43,38,5,ECO_300019380
642,Herenthoutsesteenweg 2,2022-06-07,22:00:00,33,30,3,ECO_300019380
642,Herenthoutsesteenweg 2,2022-06-07,23:00:00,18,16,2,ECO_300019380
642,Herenthoutsesteenweg 2,2022-06-08,00:00:00,23,18,5,ECO_300019380
642,Herenthoutsesteenweg 2,2022-06-08,01:00:00,3,2,1,ECO_300019380
642,Herenthoutsesteenweg 2,2022-06-08,02:00:00,0,0,0,ECO_300019380
642,Herenthoutsesteenweg 2,2022-06-08,03:00:00,3,0,3,ECO_300019380
642,Herenthoutsesteenweg 2,2022-06-08,04:00:00,0,0,0,ECO_300019380
642,Herenthoutsesteenweg 2,2022-06-08,05:00:00,0,0,0,ECO_300019380
642,Herenthoutsesteenweg 2,2022-06-08,06:00:00,2,2,0,ECO_300019380
642,Herenthoutsesteenweg 2,2022-06-08,07:00:00,20,19,1,ECO_300019380
642,Herenthoutsesteenweg 2,2022-06-08,08:00:00,35,33,2,ECO_300019380
642,Herenthoutsesteenweg 2,2022-06-08,09:00:00,164,161,3,ECO_300019380
642,Herenthoutsesteenweg 2,2022-06-08,10:00:00,494,489,5,ECO_300019380
642,Herenthoutsesteenweg 2,2022-06-08,11:00:00,78,77,1,ECO_300019380
642,Herenthoutsesteenweg 2,2022-06-08,12:00:00,34,27,7,ECO_300019380
642,Herenthoutsesteenweg 2,2022-06-08,13:00:00,23,23,0,ECO_300019380
642,Herenthoutsesteenweg 2,2022-06-08,14:00:00,60,54,6,ECO_300019380
642,Herenthoutsesteenweg 2,2022-06-08,15:00:00,32,30,2,ECO_300019380
642,Herenthoutsesteenweg 2,2022-06-08,16:00:00,22,17,5,ECO_300019380
642,Herenthoutsesteenweg 2,2022-06-08,17:00:00,24,22,2,ECO_300019380
642,Herenthoutsesteenweg 2,2022-06-08,18:00:00,58,57,1,ECO_300019380
642,Herenthoutsesteenweg 2,2022-06-08,19:00:00,54,48,6,ECO_300019380
642,Herenthoutsesteenweg 2,2022-06-08,20:00:00,35,28,7,ECO_300019380
642,Herenthoutsesteenweg 2,2022-06-08,21:00:00,36,27,9,ECO_300019380
642,Herenthoutsesteenweg 2,2022-06-08,22:00:00,30,26,4,ECO_300019380
642,Herenthoutsesteenweg 2,2022-06-08,23:00:00,9,6,3,ECO_300019380
642,Herenthoutsesteenweg 2,2022-06-09,00:00:00,7,6,1,ECO_300019380
642,Herenthoutsesteenweg 2,2022-06-09,01:00:00,3,3,0,ECO_300019380
642,Herenthoutsesteenweg 2,2022-06-09,02:00:00,1,1,0,ECO_300019380
642,Herenthoutsesteenweg 2,2022-06-09,03:00:00,2,2,0,ECO_300019380
642,Herenthoutsesteenweg 2,2022-06-09,04:00:00,0,0,0,ECO_300019380
642,Herenthoutsesteenweg 2,2022-06-09,05:00:00,1,1,0,ECO_300019380
642,Herenthoutsesteenweg 2,2022-06-09,06:00:00,2,1,1,ECO_300019380
642,Herenthoutsesteenweg 2,2022-06-09,07:00:00,23,19,4,ECO_300019380
642,Herenthoutsesteenweg 2,2022-06-09,08:00:00,44,41,3,ECO_300019380
642,Herenthoutsesteenweg 2,2022-06-09,09:00:00,176,169,7,ECO_300019380
642,Herenthoutsesteenweg 2,2022-06-09,10:00:00,559,547,12,ECO_300019380
642,Herenthoutsesteenweg 2,2022-06-09,11:00:00,94,92,2,ECO_300019380
642,Herenthoutsesteenweg 2,2022-06-09,12:00:00,72,67,5,ECO_300019380
642,Herenthoutsesteenweg 2,2022-06-09,13:00:00,47,42,5,ECO_300019380
642,Herenthoutsesteenweg 2,2022-06-09,14:00:00,58,52,6,ECO_300019380
642,Herenthoutsesteenweg 2,2022-06-09,15:00:00,76,73,3,ECO_300019380
642,Herenthoutsesteenweg 2,2022-06-09,16:00:00,75,68,7,ECO_300019380
642,Herenthoutsesteenweg 2,2022-06-09,17:00:00,147,133,14,ECO_300019380
642,Herenthoutsesteenweg 2,2022-06-09,18:00:00,133,118,15,ECO_300019380
642,Herenthoutsesteenweg 2,2022-06-09,19:00:00,117,102,15,ECO_300019380
642,Herenthoutsesteenweg 2,2022-06-09,20:00:00,85,80,5,ECO_300019380
642,Herenthoutsesteenweg 2,2022-06-09,21:00:00,64,59,5,ECO_300019380
642,Herenthoutsesteenweg 2,2022-06-09,22:00:00,30,24,6,ECO_300019380
642,Herenthoutsesteenweg 2,2022-06-09,23:00:00,20,18,2,ECO_300019380
642,Herenthoutsesteenweg 2,2022-06-10,00:00:00,19,13,6,ECO_300019380
642,Herenthoutsesteenweg 2,2022-06-10,01:00:00,9,7,2,ECO_300019380
642,Herenthoutsesteenweg 2,2022-06-10,02:00:00,4,2,2,ECO_300019380
642,Herenthoutsesteenweg 2,2022-06-10,03:00:00,2,0,2,ECO_300019380
642,Herenthoutsesteenweg 2,2022-06-10,04:00:00,1,0,1,ECO_300019380
642,Herenthoutsesteenweg 2,2022-06-10,05:00:00,0,0,0,ECO_300019380
642,Herenthoutsesteenweg 2,2022-06-10,06:00:00,6,5,1,ECO_300019380
642,Herenthoutsesteenweg 2,2022-06-10,07:00:00,20,18,2,ECO_300019380
642,Herenthoutsesteenweg 2,2022-06-10,08:00:00,40,35,5,ECO_300019380
642,Herenthoutsesteenweg 2,2022-06-10,09:00:00,173,168,5,ECO_300019380
642,Herenthoutsesteenweg 2,2022-06-10,10:00:00,524,520,4,ECO_300019380
642,Herenthoutsesteenweg 2,2022-06-10,11:00:00,157,154,3,ECO_300019380
642,Herenthoutsesteenweg 2,2022-06-10,12:00:00,114,112,2,ECO_300019380
642,Herenthoutsesteenweg 2,2022-06-10,13:00:00,98,94,4,ECO_300019380
642,Herenthoutsesteenweg 2,2022-06-10,14:00:00,71,65,6,ECO_300019380
642,Herenthoutsesteenweg 2,2022-06-10,15:00:00,126,112,14,ECO_300019380
642,Herenthoutsesteenweg 2,2022-06-10,16:00:00,149,138,11,ECO_300019380
642,Herenthoutsesteenweg 2,2022-06-10,17:00:00,171,157,14,ECO_300019380
642,Herenthoutsesteenweg 2,2022-06-10,18:00:00,144,131,13,ECO_300019380
642,Herenthoutsesteenweg 2,2022-06-10,19:00:00,125,110,15,ECO_300019380
642,Herenthoutsesteenweg 2,2022-06-10,20:00:00,63,52,11,ECO_300019380
642,Herenthoutsesteenweg 2,2022-06-10,21:00:00,59,54,5,ECO_300019380
642,Herenthoutsesteenweg 2,2022-06-10,22:00:00,53,50,3,ECO_300019380
642,Herenthoutsesteenweg 2,2022-06-10,23:00:00,40,35,5,ECO_300019380
642,Herenthoutsesteenweg 2,2022-06-11,00:00:00,29,23,6,ECO_300019380
642,Herenthoutsesteenweg 2,2022-06-11,01:00:00,20,17,3,ECO_300019380
642,Herenthoutsesteenweg 2,2022-06-11,02:00:00,13,9,4,ECO_300019380
642,Herenthoutsesteenweg 2,2022-06-11,03:00:00,8,2,6,ECO_300019380
642,Herenthoutsesteenweg 2,2022-06-11,04:00:00,3,3,0,ECO_300019380
642,Herenthoutsesteenweg 2,2022-06-11,05:00:00,7,1,6,ECO_300019380
642,Herenthoutsesteenweg 2,2022-06-11,06:00:00,0,0,0,ECO_300019380
642,Herenthoutsesteenweg 2,2022-06-11,07:00:00,5,5,0,ECO_300019380
642,Herenthoutsesteenweg 2,2022-06-11,08:00:00,14,14,0,ECO_300019380
642,Herenthoutsesteenweg 2,2022-06-11,09:00:00,77,72,5,ECO_300019380
642,Herenthoutsesteenweg 2,2022-06-11,10:00:00,45,41,4,ECO_300019380
642,Herenthoutsesteenweg 2,2022-06-11,11:00:00,80,72,8,ECO_300019380
642,Herenthoutsesteenweg 2,2022-06-11,12:00:00,106,102,4,ECO_300019380
642,Herenthoutsesteenweg 2,2022-06-11,13:00:00,116,100,16,ECO_300019380
642,Herenthoutsesteenweg 2,2022-06-11,14:00:00,128,114,14,ECO_300019380
642,Herenthoutsesteenweg 2,2022-06-11,15:00:00,188,171,17,ECO_300019380
642,Herenthoutsesteenweg 2,2022-06-11,16:00:00,181,170,11,ECO_300019380
642,Herenthoutsesteenweg 2,2022-06-11,17:00:00,213,199,14,ECO_300019380
642,Herenthoutsesteenweg 2,2022-06-11,18:00:00,158,146,12,ECO_300019380
642,Herenthoutsesteenweg 2,2022-06-11,19:00:00,128,118,10,ECO_300019380
642,Herenthoutsesteenweg 2,2022-06-11,20:00:00,81,70,11,ECO_300019380
642,Herenthoutsesteenweg 2,2022-06-11,21:00:00,59,57,2,ECO_300019380
642,Herenthoutsesteenweg 2,2022-06-11,22:00:00,59,53,6,ECO_300019380
642,Herenthoutsesteenweg 2,2022-06-11,23:00:00,49,38,11,ECO_300019380
642,Herenthoutsesteenweg 2,2022-06-12,00:00:00,34,22,12,ECO_300019380
642,Herenthoutsesteenweg 2,2022-06-12,01:00:00,21,18,3,ECO_300019380
642,Herenthoutsesteenweg 2,2022-06-12,02:00:00,10,6,4,ECO_300019380
642,Herenthoutsesteenweg 2,2022-06-12,03:00:00,8,5,3,ECO_300019380
642,Herenthoutsesteenweg 2,2022-06-12,04:00:00,3,1,2,ECO_300019380
642,Herenthoutsesteenweg 2,2022-06-12,05:00:00,4,1,3,ECO_300019380
642,Herenthoutsesteenweg 2,2022-06-12,06:00:00,1,1,0,ECO_300019380
642,Herenthoutsesteenweg 2,2022-06-12,07:00:00,5,5,0,ECO_300019380
642,Herenthoutsesteenweg 2,2022-06-12,08:00:00,14,13,1,ECO_300019380
642,Herenthoutsesteenweg 2,2022-06-12,09:00:00,22,20,2,ECO_300019380
642,Herenthoutsesteenweg 2,2022-06-12,10:00:00,78,74,4,ECO_300019380
642,Herenthoutsesteenweg 2,2022-06-12,11:00:00,135,125,10,ECO_300019380
642,Herenthoutsesteenweg 2,2022-06-12,12:00:00,190,175,15,ECO_300019380
642,Herenthoutsesteenweg 2,2022-06-12,13:00:00,196,172,24,ECO_300019380
642,Herenthoutsesteenweg 2,2022-06-12,14:00:00,98,87,11,ECO_300019380
642,Herenthoutsesteenweg 2,2022-06-12,15:00:00,175,165,10,ECO_300019380
642,Herenthoutsesteenweg 2,2022-06-12,16:00:00,180,164,16,ECO_300019380
642,Herenthoutsesteenweg 2,2022-06-12,17:00:00,122,110,12,ECO_300019380
642,Herenthoutsesteenweg 2,2022-06-12,18:00:00,131,112,19,ECO_300019380
642,Herenthoutsesteenweg 2,2022-06-12,19:00:00,128,105,23,ECO_300019380
642,Herenthoutsesteenweg 2,2022-06-12,20:00:00,55,52,3,ECO_300019380
642,Herenthoutsesteenweg 2,2022-06-12,21:00:00,30,28,2,ECO_300019380
642,Herenthoutsesteenweg 2,2022-06-12,22:00:00,46,41,5,ECO_300019380
642,Herenthoutsesteenweg 2,2022-06-12,23:00:00,26,21,5,ECO_300019380
642,Herenthoutsesteenweg 2,2022-06-13,00:00:00,18,12,6,ECO_300019380
642,Herenthoutsesteenweg 2,2022-06-13,01:00:00,3,3,0,ECO_300019380
642,Herenthoutsesteenweg 2,2022-06-13,02:00:00,2,2,0,ECO_300019380
642,Herenthoutsesteenweg 2,2022-06-13,03:00:00,2,2,0,ECO_300019380
642,Herenthoutsesteenweg 2,2022-06-13,04:00:00,1,0,1,ECO_300019380
642,Herenthoutsesteenweg 2,2022-06-13,05:00:00,0,0,0,ECO_300019380
642,Herenthoutsesteenweg 2,2022-06-13,06:00:00,2,2,0,ECO_300019380
642,Herenthoutsesteenweg 2,2022-06-13,07:00:00,28,26,2,ECO_300019380
642,Herenthoutsesteenweg 2,2022-06-13,08:00:00,38,35,3,ECO_300019380
642,Herenthoutsesteenweg 2,2022-06-13,09:00:00,217,213,4,ECO_300019380
642,Herenthoutsesteenweg 2,2022-06-13,10:00:00,510,504,6,ECO_300019380
642,Herenthoutsesteenweg 2,2022-06-13,11:00:00,106,104,2,ECO_300019380
642,Herenthoutsesteenweg 2,2022-06-13,12:00:00,92,88,4,ECO_300019380
642,Herenthoutsesteenweg 2,2022-06-13,13:00:00,81,75,6,ECO_300019380
642,Herenthoutsesteenweg 2,2022-06-13,14:00:00,75,68,7,ECO_300019380
642,Herenthoutsesteenweg 2,2022-06-13,15:00:00,86,79,7,ECO_300019380
642,Herenthoutsesteenweg 2,2022-06-13,16:00:00,135,122,13,ECO_300019380
642,Herenthoutsesteenweg 2,2022-06-13,17:00:00,189,182,7,ECO_300019380
642,Herenthoutsesteenweg 2,2022-06-13,18:00:00,144,124,20,ECO_300019380
642,Herenthoutsesteenweg 2,2022-06-13,19:00:00,133,122,11,ECO_300019380
642,Herenthoutsesteenweg 2,2022-06-13,20:00:00,80,75,5,ECO_300019380
642,Herenthoutsesteenweg 2,2022-06-13,21:00:00,58,49,9,ECO_300019380
642,Herenthoutsesteenweg 2,2022-06-13,22:00:00,37,27,10,ECO_300019380
642,Herenthoutsesteenweg 2,2022-06-13,23:00:00,15,13,2,ECO_300019380
642,Herenthoutsesteenweg 2,2022-06-14,00:00:00,23,20,3,ECO_300019380
642,Herenthoutsesteenweg 2,2022-06-14,01:00:00,3,2,1,ECO_300019380
642,Herenthoutsesteenweg 2,2022-06-14,02:00:00,2,2,0,ECO_300019380
642,Herenthoutsesteenweg 2,2022-06-14,03:00:00,1,1,0,ECO_300019380
642,Herenthoutsesteenweg 2,2022-06-14,04:00:00,0,0,0,ECO_300019380
642,Herenthoutsesteenweg 2,2022-06-14,05:00:00,0,0,0,ECO_300019380
642,Herenthoutsesteenweg 2,2022-06-14,06:00:00,3,3,0,ECO_300019380
642,Herenthoutsesteenweg 2,2022-06-14,07:00:00,32,28,4,ECO_300019380
642,Herenthoutsesteenweg 2,2022-06-14,08:00:00,61,58,3,ECO_300019380
642,Herenthoutsesteenweg 2,2022-06-14,09:00:00,238,230,8,ECO_300019380
642,Herenthoutsesteenweg 2,2022-06-14,10:00:00,527,516,11,ECO_300019380
642,Herenthoutsesteenweg 2,2022-06-14,11:00:00,126,116,10,ECO_300019380
642,Herenthoutsesteenweg 2,2022-06-14,12:00:00,92,88,4,ECO_300019380
642,Herenthoutsesteenweg 2,2022-06-14,13:00:00,94,88,6,ECO_300019380
642,Herenthoutsesteenweg 2,2022-06-14,14:00:00,109,103,6,ECO_300019380
642,Herenthoutsesteenweg 2,2022-06-14,15:00:00,162,152,10,ECO_300019380
642,Herenthoutsesteenweg 2,2022-06-14,16:00:00,154,144,10,ECO_300019380
642,Herenthoutsesteenweg 2,2022-06-14,17:00:00,181,168,13,ECO_300019380
642,Herenthoutsesteenweg 2,2022-06-14,18:00:00,209,182,27,ECO_300019380
642,Herenthoutsesteenweg 2,2022-06-14,19:00:00,144,128,16,ECO_300019380
642,Herenthoutsesteenweg 2,2022-06-14,20:00:00,72,62,10,ECO_300019380
642,Herenthoutsesteenweg 2,2022-06-14,21:00:00,72,54,18,ECO_300019380
642,Herenthoutsesteenweg 2,2022-06-14,22:00:00,60,49,11,ECO_300019380
642,Herenthoutsesteenweg 2,2022-06-14,23:00:00,46,42,4,ECO_300019380
642,Herenthoutsesteenweg 2,2022-06-15,00:00:00,31,28,3,ECO_300019380
642,Herenthoutsesteenweg 2,2022-06-15,01:00:00,3,3,0,ECO_300019380
642,Herenthoutsesteenweg 2,2022-06-15,02:00:00,3,2,1,ECO_300019380
642,Herenthoutsesteenweg 2,2022-06-15,03:00:00,1,0,1,ECO_300019380
642,Herenthoutsesteenweg 2,2022-06-15,04:00:00,0,0,0,ECO_300019380
642,Herenthoutsesteenweg 2,2022-06-15,05:00:00,0,0,0,ECO_300019380
642,Herenthoutsesteenweg 2,2022-06-15,06:00:00,1,1,0,ECO_300019380
642,Herenthoutsesteenweg 2,2022-06-15,07:00:00,33,26,7,ECO_300019380
642,Herenthoutsesteenweg 2,2022-06-15,08:00:00,66,64,2,ECO_300019380
642,Herenthoutsesteenweg 2,2022-06-15,09:00:00,216,213,3,ECO_300019380
642,Herenthoutsesteenweg 2,2022-06-15,10:00:00,509,505,4,ECO_300019380
642,Herenthoutsesteenweg 2,2022-06-15,11:00:00,140,134,6,ECO_300019380
642,Herenthoutsesteenweg 2,2022-06-15,12:00:00,122,119,3,ECO_300019380
642,Herenthoutsesteenweg 2,2022-06-15,13:00:00,121,104,17,ECO_300019380
642,Herenthoutsesteenweg 2,2022-06-15,14:00:00,206,197,9,ECO_300019380
642,Herenthoutsesteenweg 2,2022-06-15,15:00:00,195,176,19,ECO_300019380
642,Herenthoutsesteenweg 2,2022-06-15,16:00:00,175,162,13,ECO_300019380
642,Herenthoutsesteenweg 2,2022-06-15,17:00:00,121,106,15,ECO_300019380
642,Herenthoutsesteenweg 2,2022-06-15,18:00:00,203,186,17,ECO_300019380
642,Herenthoutsesteenweg 2,2022-06-15,19:00:00,134,121,13,ECO_300019380
642,Herenthoutsesteenweg 2,2022-06-15,20:00:00,135,121,14,ECO_300019380
642,Herenthoutsesteenweg 2,2022-06-15,21:00:00,119,100,19,ECO_300019380
642,Herenthoutsesteenweg 2,2022-06-15,22:00:00,62,48,14,ECO_300019380
642,Herenthoutsesteenweg 2,2022-06-15,23:00:00,37,29,8,ECO_300019380
642,Herenthoutsesteenweg 2,2022-06-16,00:00:00,36,31,5,ECO_300019380
642,Herenthoutsesteenweg 2,2022-06-16,01:00:00,8,3,5,ECO_300019380
642,Herenthoutsesteenweg 2,2022-06-16,02:00:00,2,2,0,ECO_300019380
642,Herenthoutsesteenweg 2,2022-06-16,03:00:00,1,1,0,ECO_300019380
642,Herenthoutsesteenweg 2,2022-06-16,04:00:00,0,0,0,ECO_300019380
642,Herenthoutsesteenweg 2,2022-06-16,05:00:00,0,0,0,ECO_300019380
642,Herenthoutsesteenweg 2,2022-06-16,06:00:00,4,4,0,ECO_300019380
642,Herenthoutsesteenweg 2,2022-06-16,07:00:00,27,22,5,ECO_300019380
642,Herenthoutsesteenweg 2,2022-06-16,08:00:00,62,58,4,ECO_300019380
642,Herenthoutsesteenweg 2,2022-06-16,09:00:00,194,190,4,ECO_300019380
642,Herenthoutsesteenweg 2,2022-06-16,10:00:00,529,525,4,ECO_300019380
642,Herenthoutsesteenweg 2,2022-06-16,11:00:00,158,144,14,ECO_300019380
642,Herenthoutsesteenweg 2,2022-06-16,12:00:00,146,142,4,ECO_300019380
642,Herenthoutsesteenweg 2,2022-06-16,13:00:00,117,112,5,ECO_300019380
642,Herenthoutsesteenweg 2,2022-06-16,14:00:00,92,81,11,ECO_300019380
642,Herenthoutsesteenweg 2,2022-06-16,15:00:00,143,138,5,ECO_300019380
642,Herenthoutsesteenweg 2,2022-06-16,16:00:00,160,151,9,ECO_300019380
642,Herenthoutsesteenweg 2,2022-06-16,17:00:00,207,192,15,ECO_300019380
642,Herenthoutsesteenweg 2,2022-06-16,18:00:00,185,167,18,ECO_300019380
642,Herenthoutsesteenweg 2,2022-06-16,19:00:00,151,133,18,ECO_300019380
642,Herenthoutsesteenweg 2,2022-06-16,20:00:00,100,95,5,ECO_300019380
642,Herenthoutsesteenweg 2,2022-06-16,21:00:00,91,82,9,ECO_300019380
642,Herenthoutsesteenweg 2,2022-06-16,22:00:00,61,50,11,ECO_300019380
642,Herenthoutsesteenweg 2,2022-06-16,23:00:00,29,22,7,ECO_300019380
642,Herenthoutsesteenweg 2,2022-06-17,00:00:00,32,28,4,ECO_300019380
642,Herenthoutsesteenweg 2,2022-06-17,01:00:00,8,4,4,ECO_300019380
642,Herenthoutsesteenweg 2,2022-06-17,02:00:00,2,2,0,ECO_300019380
642,Herenthoutsesteenweg 2,2022-06-17,03:00:00,3,2,1,ECO_300019380
642,Herenthoutsesteenweg 2,2022-06-17,04:00:00,0,0,0,ECO_300019380
642,Herenthoutsesteenweg 2,2022-06-17,05:00:00,0,0,0,ECO_300019380
642,Herenthoutsesteenweg 2,2022-06-17,06:00:00,2,2,0,ECO_300019380
642,Herenthoutsesteenweg 2,2022-06-17,07:00:00,26,25,1,ECO_300019380
642,Herenthoutsesteenweg 2,2022-06-17,08:00:00,51,43,8,ECO_300019380
642,Herenthoutsesteenweg 2,2022-06-17,09:00:00,187,184,3,ECO_300019380
642,Herenthoutsesteenweg 2,2022-06-17,10:00:00,504,497,7,ECO_300019380
642,Herenthoutsesteenweg 2,2022-06-17,11:00:00,232,227,5,ECO_300019380
642,Herenthoutsesteenweg 2,2022-06-17,12:00:00,236,230,6,ECO_300019380
642,Herenthoutsesteenweg 2,2022-06-17,13:00:00,131,126,5,ECO_300019380
642,Herenthoutsesteenweg 2,2022-06-17,14:00:00,85,79,6,ECO_300019380
642,Herenthoutsesteenweg 2,2022-06-17,15:00:00,140,127,13,ECO_300019380
642,Herenthoutsesteenweg 2,2022-06-17,16:00:00,216,206,10,ECO_300019380
642,Herenthoutsesteenweg 2,2022-06-17,17:00:00,201,182,19,ECO_300019380
642,Herenthoutsesteenweg 2,2022-06-17,18:00:00,198,185,13,ECO_300019380
642,Herenthoutsesteenweg 2,2022-06-17,19:00:00,132,121,11,ECO_300019380
642,Herenthoutsesteenweg 2,2022-06-17,20:00:00,95,91,4,ECO_300019380
642,Herenthoutsesteenweg 2,2022-06-17,21:00:00,112,101,11,ECO_300019380
642,Herenthoutsesteenweg 2,2022-06-17,22:00:00,73,65,8,ECO_300019380
642,Herenthoutsesteenweg 2,2022-06-17,23:00:00,55,41,14,ECO_300019380
642,Herenthoutsesteenweg 2,2022-06-18,00:00:00,54,44,10,ECO_300019380
642,Herenthoutsesteenweg 2,2022-06-18,01:00:00,20,14,6,ECO_300019380
642,Herenthoutsesteenweg 2,2022-06-18,02:00:00,11,10,1,ECO_300019380
642,Herenthoutsesteenweg 2,2022-06-18,03:00:00,17,11,6,ECO_300019380
642,Herenthoutsesteenweg 2,2022-06-18,04:00:00,8,7,1,ECO_300019380
642,Herenthoutsesteenweg 2,2022-06-18,05:00:00,1,0,1,ECO_300019380
642,Herenthoutsesteenweg 2,2022-06-18,06:00:00,0,0,0,ECO_300019380
642,Herenthoutsesteenweg 2,2022-06-18,07:00:00,5,5,0,ECO_300019380
642,Herenthoutsesteenweg 2,2022-06-18,08:00:00,24,23,1,ECO_300019380
642,Herenthoutsesteenweg 2,2022-06-18,09:00:00,29,26,3,ECO_300019380
642,Herenthoutsesteenweg 2,2022-06-18,10:00:00,84,75,9,ECO_300019380
642,Herenthoutsesteenweg 2,2022-06-18,11:00:00,132,117,15,ECO_300019380
642,Herenthoutsesteenweg 2,2022-06-18,12:00:00,165,152,13,ECO_300019380
642,Herenthoutsesteenweg 2,2022-06-18,13:00:00,141,117,24,ECO_300019380
642,Herenthoutsesteenweg 2,2022-06-18,14:00:00,105,91,14,ECO_300019380
642,Herenthoutsesteenweg 2,2022-06-18,15:00:00,112,98,14,ECO_300019380
642,Herenthoutsesteenweg 2,2022-06-18,16:00:00,109,95,14,ECO_300019380
642,Herenthoutsesteenweg 2,2022-06-18,17:00:00,78,63,15,ECO_300019380
642,Herenthoutsesteenweg 2,2022-06-18,18:00:00,90,81,9,ECO_300019380
642,Herenthoutsesteenweg 2,2022-06-18,19:00:00,66,55,11,ECO_300019380
642,Herenthoutsesteenweg 2,2022-06-18,20:00:00,69,59,10,ECO_300019380
642,Herenthoutsesteenweg 2,2022-06-18,21:00:00,57,51,6,ECO_300019380
642,Herenthoutsesteenweg 2,2022-06-18,22:00:00,48,43,5,ECO_300019380
642,Herenthoutsesteenweg 2,2022-06-18,23:00:00,63,50,13,ECO_300019380
642,Herenthoutsesteenweg 2,2022-06-19,00:00:00,38,33,5,ECO_300019380
642,Herenthoutsesteenweg 2,2022-06-19,01:00:00,19,12,7,ECO_300019380
642,Herenthoutsesteenweg 2,2022-06-19,02:00:00,27,12,15,ECO_300019380
642,Herenthoutsesteenweg 2,2022-06-19,03:00:00,22,14,8,ECO_300019380
642,Herenthoutsesteenweg 2,2022-06-19,04:00:00,10,9,1,ECO_300019380
642,Herenthoutsesteenweg 2,2022-06-19,05:00:00,1,0,1,ECO_300019380
642,Herenthoutsesteenweg 2,2022-06-19,06:00:00,3,2,1,ECO_300019380
642,Herenthoutsesteenweg 2,2022-06-19,07:00:00,4,4,0,ECO_300019380
642,Herenthoutsesteenweg 2,2022-06-19,08:00:00,9,9,0,ECO_300019380
642,Herenthoutsesteenweg 2,2022-06-19,09:00:00,49,45,4,ECO_300019380
642,Herenthoutsesteenweg 2,2022-06-19,10:00:00,60,58,2,ECO_300019380
642,Herenthoutsesteenweg 2,2022-06-19,11:00:00,34,34,0,ECO_300019380
642,Herenthoutsesteenweg 2,2022-06-19,12:00:00,57,54,3,ECO_300019380
642,Herenthoutsesteenweg 2,2022-06-19,13:00:00,76,71,5,ECO_300019380
642,Herenthoutsesteenweg 2,2022-06-19,14:00:00,60,52,8,ECO_300019380
642,Herenthoutsesteenweg 2,2022-06-19,15:00:00,72,66,6,ECO_300019380
642,Herenthoutsesteenweg 2,2022-06-19,16:00:00,77,68,9,ECO_300019380
642,Herenthoutsesteenweg 2,2022-06-19,17:00:00,73,67,6,ECO_300019380
642,Herenthoutsesteenweg 2,2022-06-19,18:00:00,49,44,5,ECO_300019380
642,Herenthoutsesteenweg 2,2022-06-19,19:00:00,64,61,3,ECO_300019380
642,Herenthoutsesteenweg 2,2022-06-19,20:00:00,46,39,7,ECO_300019380
642,Herenthoutsesteenweg 2,2022-06-19,21:00:00,31,23,8,ECO_300019380
642,Herenthoutsesteenweg 2,2022-06-19,22:00:00,31,22,9,ECO_300019380
642,Herenthoutsesteenweg 2,2022-06-19,23:00:00,13,10,3,ECO_300019380
642,Herenthoutsesteenweg 2,2022-06-20,00:00:00,7,6,1,ECO_300019380
642,Herenthoutsesteenweg 2,2022-06-20,01:00:00,6,5,1,ECO_300019380
642,Herenthoutsesteenweg 2,2022-06-20,02:00:00,3,2,1,ECO_300019380
642,Herenthoutsesteenweg 2,2022-06-20,03:00:00,1,1,0,ECO_300019380
642,Herenthoutsesteenweg 2,2022-06-20,04:00:00,3,1,2,ECO_300019380
642,Herenthoutsesteenweg 2,2022-06-20,05:00:00,0,0,0,ECO_300019380
642,Herenthoutsesteenweg 2,2022-06-20,06:00:00,7,5,2,ECO_300019380
642,Herenthoutsesteenweg 2,2022-06-20,07:00:00,23,20,3,ECO_300019380
642,Herenthoutsesteenweg 2,2022-06-20,08:00:00,49,47,2,ECO_300019380
642,Herenthoutsesteenweg 2,2022-06-20,09:00:00,196,192,4,ECO_300019380
642,Herenthoutsesteenweg 2,2022-06-20,10:00:00,571,566,5,ECO_300019380
642,Herenthoutsesteenweg 2,2022-06-20,11:00:00,86,85,1,ECO_300019380
642,Herenthoutsesteenweg 2,2022-06-20,12:00:00,80,76,4,ECO_300019380
642,Herenthoutsesteenweg 2,2022-06-20,13:00:00,54,49,5,ECO_300019380
642,Herenthoutsesteenweg 2,2022-06-20,14:00:00,78,71,7,ECO_300019380
642,Herenthoutsesteenweg 2,2022-06-20,15:00:00,115,115,0,ECO_300019380
642,Herenthoutsesteenweg 2,2022-06-20,16:00:00,140,129,11,ECO_300019380
642,Herenthoutsesteenweg 2,2022-06-20,17:00:00,158,143,15,ECO_300019380
642,Herenthoutsesteenweg 2,2022-06-20,18:00:00,167,153,14,ECO_300019380
642,Herenthoutsesteenweg 2,2022-06-20,19:00:00,112,100,12,ECO_300019380
642,Herenthoutsesteenweg 2,2022-06-20,20:00:00,67,60,7,ECO_300019380
642,Herenthoutsesteenweg 2,2022-06-20,21:00:00,62,57,5,ECO_300019380
642,Herenthoutsesteenweg 2,2022-06-20,22:00:00,53,48,5,ECO_300019380
642,Herenthoutsesteenweg 2,2022-06-20,23:00:00,24,20,4,ECO_300019380
642,Herenthoutsesteenweg 2,2022-06-21,00:00:00,25,21,4,ECO_300019380
642,Herenthoutsesteenweg 2,2022-06-21,01:00:00,5,2,3,ECO_300019380
642,Herenthoutsesteenweg 2,2022-06-21,02:00:00,1,1,0,ECO_300019380
642,Herenthoutsesteenweg 2,2022-06-21,03:00:00,0,0,0,ECO_300019380
642,Herenthoutsesteenweg 2,2022-06-21,04:00:00,0,0,0,ECO_300019380
642,Herenthoutsesteenweg 2,2022-06-21,05:00:00,3,2,1,ECO_300019380
642,Herenthoutsesteenweg 2,2022-06-21,06:00:00,5,3,2,ECO_300019380
642,Herenthoutsesteenweg 2,2022-06-21,07:00:00,26,24,2,ECO_300019380
642,Herenthoutsesteenweg 2,2022-06-21,08:00:00,60,53,7,ECO_300019380
642,Herenthoutsesteenweg 2,2022-06-21,09:00:00,229,221,8,ECO_300019380
642,Herenthoutsesteenweg 2,2022-06-21,10:00:00,471,467,4,ECO_300019380
642,Herenthoutsesteenweg 2,2022-06-21,11:00:00,155,148,7,ECO_300019380
642,Herenthoutsesteenweg 2,2022-06-21,12:00:00,153,150,3,ECO_300019380
642,Herenthoutsesteenweg 2,2022-06-21,13:00:00,114,99,15,ECO_300019380
642,Herenthoutsesteenweg 2,2022-06-21,14:00:00,96,88,8,ECO_300019380
642,Herenthoutsesteenweg 2,2022-06-21,15:00:00,145,139,6,ECO_300019380
642,Herenthoutsesteenweg 2,2022-06-21,16:00:00,116,106,10,ECO_300019380
642,Herenthoutsesteenweg 2,2022-06-21,17:00:00,176,154,22,ECO_300019380
642,Herenthoutsesteenweg 2,2022-06-21,18:00:00,126,112,14,ECO_300019380
642,Herenthoutsesteenweg 2,2022-06-21,19:00:00,126,107,19,ECO_300019380
642,Herenthoutsesteenweg 2,2022-06-21,20:00:00,90,74,16,ECO_300019380
642,Herenthoutsesteenweg 2,2022-06-21,21:00:00,44,37,7,ECO_300019380
642,Herenthoutsesteenweg 2,2022-06-21,22:00:00,44,37,7,ECO_300019380
642,Herenthoutsesteenweg 2,2022-06-21,23:00:00,23,22,1,ECO_300019380
642,Herenthoutsesteenweg 2,2022-06-22,00:00:00,33,27,6,ECO_300019380
642,Herenthoutsesteenweg 2,2022-06-22,01:00:00,9,7,2,ECO_300019380
642,Herenthoutsesteenweg 2,2022-06-22,02:00:00,2,2,0,ECO_300019380
642,Herenthoutsesteenweg 2,2022-06-22,03:00:00,1,1,0,ECO_300019380
642,Herenthoutsesteenweg 2,2022-06-22,04:00:00,0,0,0,ECO_300019380
642,Herenthoutsesteenweg 2,2022-06-22,05:00:00,0,0,0,ECO_300019380
642,Herenthoutsesteenweg 2,2022-06-22,06:00:00,6,4,2,ECO_300019380
642,Herenthoutsesteenweg 2,2022-06-22,07:00:00,32,28,4,ECO_300019380
642,Herenthoutsesteenweg 2,2022-06-22,08:00:00,54,49,5,ECO_300019380
642,Herenthoutsesteenweg 2,2022-06-22,09:00:00,194,192,2,ECO_300019380
642,Herenthoutsesteenweg 2,2022-06-22,10:00:00,460,452,8,ECO_300019380
642,Herenthoutsesteenweg 2,2022-06-22,11:00:00,141,137,4,ECO_300019380
642,Herenthoutsesteenweg 2,2022-06-22,12:00:00,137,132,5,ECO_300019380
642,Herenthoutsesteenweg 2,2022-06-22,13:00:00,99,89,10,ECO_300019380
642,Herenthoutsesteenweg 2,2022-06-22,14:00:00,229,214,15,ECO_300019380
642,Herenthoutsesteenweg 2,2022-06-22,15:00:00,210,199,11,ECO_300019380
642,Herenthoutsesteenweg 2,2022-06-22,16:00:00,166,147,19,ECO_300019380
642,Herenthoutsesteenweg 2,2022-06-22,17:00:00,148,132,16,ECO_300019380
642,Herenthoutsesteenweg 2,2022-06-22,18:00:00,200,180,20,ECO_300019380
642,Herenthoutsesteenweg 2,2022-06-22,19:00:00,149,128,21,ECO_300019380
642,Herenthoutsesteenweg 2,2022-06-22,20:00:00,111,95,16,ECO_300019380
642,Herenthoutsesteenweg 2,2022-06-22,21:00:00,103,90,13,ECO_300019380
642,Herenthoutsesteenweg 2,2022-06-22,22:00:00,88,51,37,ECO_300019380
642,Herenthoutsesteenweg 2,2022-06-22,23:00:00,47,36,11,ECO_300019380
642,Herenthoutsesteenweg 2,2022-06-23,00:00:00,40,34,6,ECO_300019380
642,Herenthoutsesteenweg 2,2022-06-23,01:00:00,9,3,6,ECO_300019380
642,Herenthoutsesteenweg 2,2022-06-23,02:00:00,3,2,1,ECO_300019380
642,Herenthoutsesteenweg 2,2022-06-23,03:00:00,2,1,1,ECO_300019380
642,Herenthoutsesteenweg 2,2022-06-23,04:00:00,0,0,0,ECO_300019380
642,Herenthoutsesteenweg 2,2022-06-23,05:00:00,1,1,0,ECO_300019380
642,Herenthoutsesteenweg 2,2022-06-23,06:00:00,3,1,2,ECO_300019380
642,Herenthoutsesteenweg 2,2022-06-23,07:00:00,25,20,5,ECO_300019380
642,Herenthoutsesteenweg 2,2022-06-23,08:00:00,50,43,7,ECO_300019380
642,Herenthoutsesteenweg 2,2022-06-23,09:00:00,202,199,3,ECO_300019380
642,Herenthoutsesteenweg 2,2022-06-23,10:00:00,391,385,6,ECO_300019380
642,Herenthoutsesteenweg 2,2022-06-23,11:00:00,154,141,13,ECO_300019380
642,Herenthoutsesteenweg 2,2022-06-23,12:00:00,139,137,2,ECO_300019380
642,Herenthoutsesteenweg 2,2022-06-23,13:00:00,247,234,13,ECO_300019380
642,Herenthoutsesteenweg 2,2022-06-23,14:00:00,121,105,16,ECO_300019380
642,Herenthoutsesteenweg 2,2022-06-23,15:00:00,142,128,14,ECO_300019380
642,Herenthoutsesteenweg 2,2022-06-23,16:00:00,167,153,14,ECO_300019380
642,Herenthoutsesteenweg 2,2022-06-23,17:00:00,177,152,25,ECO_300019380
642,Herenthoutsesteenweg 2,2022-06-23,18:00:00,178,161,17,ECO_300019380
642,Herenthoutsesteenweg 2,2022-06-23,19:00:00,148,134,14,ECO_300019380
642,Herenthoutsesteenweg 2,2022-06-23,20:00:00,108,93,15,ECO_300019380
642,Herenthoutsesteenweg 2,2022-06-23,21:00:00,118,109,9,ECO_300019380
642,Herenthoutsesteenweg 2,2022-06-23,22:00:00,57,44,13,ECO_300019380
642,Herenthoutsesteenweg 2,2022-06-23,23:00:00,53,44,9,ECO_300019380
642,Herenthoutsesteenweg 2,2022-06-24,00:00:00,39,32,7,ECO_300019380
642,Herenthoutsesteenweg 2,2022-06-24,01:00:00,12,10,2,ECO_300019380
642,Herenthoutsesteenweg 2,2022-06-24,02:00:00,9,6,3,ECO_300019380
642,Herenthoutsesteenweg 2,2022-06-24,03:00:00,1,1,0,ECO_300019380
642,Herenthoutsesteenweg 2,2022-06-24,04:00:00,1,1,0,ECO_300019380
642,Herenthoutsesteenweg 2,2022-06-24,05:00:00,2,2,0,ECO_300019380
642,Herenthoutsesteenweg 2,2022-06-24,06:00:00,2,2,0,ECO_300019380
642,Herenthoutsesteenweg 2,2022-06-24,07:00:00,22,17,5,ECO_300019380
642,Herenthoutsesteenweg 2,2022-06-24,08:00:00,15,12,3,ECO_300019380
642,Herenthoutsesteenweg 2,2022-06-24,09:00:00,32,31,1,ECO_300019380
642,Herenthoutsesteenweg 2,2022-06-24,10:00:00,53,50,3,ECO_300019380
642,Herenthoutsesteenweg 2,2022-06-24,11:00:00,82,74,8,ECO_300019380
642,Herenthoutsesteenweg 2,2022-06-24,12:00:00,86,78,8,ECO_300019380
642,Herenthoutsesteenweg 2,2022-06-24,13:00:00,43,43,0,ECO_300019380
642,Herenthoutsesteenweg 2,2022-06-24,14:00:00,40,38,2,ECO_300019380
642,Herenthoutsesteenweg 2,2022-06-24,15:00:00,66,63,3,ECO_300019380
642,Herenthoutsesteenweg 2,2022-06-24,16:00:00,78,66,12,ECO_300019380
642,Herenthoutsesteenweg 2,2022-06-24,17:00:00,101,96,5,ECO_300019380
642,Herenthoutsesteenweg 2,2022-06-24,18:00:00,121,113,8,ECO_300019380
642,Herenthoutsesteenweg 2,2022-06-24,19:00:00,55,48,7,ECO_300019380
642,Herenthoutsesteenweg 2,2022-06-24,20:00:00,25,24,1,ECO_300019380
642,Herenthoutsesteenweg 2,2022-06-24,21:00:00,36,31,5,ECO_300019380
642,Herenthoutsesteenweg 2,2022-06-24,22:00:00,22,21,1,ECO_300019380
642,Herenthoutsesteenweg 2,2022-06-24,23:00:00,64,60,4,ECO_300019380
642,Herenthoutsesteenweg 2,2022-06-25,00:00:00,29,25,4,ECO_300019380
642,Herenthoutsesteenweg 2,2022-06-25,01:00:00,8,5,3,ECO_300019380
642,Herenthoutsesteenweg 2,2022-06-25,02:00:00,9,5,4,ECO_300019380
642,Herenthoutsesteenweg 2,2022-06-25,03:00:00,3,2,1,ECO_300019380
642,Herenthoutsesteenweg 2,2022-06-25,04:00:00,7,5,2,ECO_300019380
642,Herenthoutsesteenweg 2,2022-06-25,05:00:00,1,1,0,ECO_300019380
642,Herenthoutsesteenweg 2,2022-06-25,06:00:00,1,0,1,ECO_300019380
642,Herenthoutsesteenweg 2,2022-06-25,07:00:00,5,5,0,ECO_300019380
642,Herenthoutsesteenweg 2,2022-06-25,08:00:00,8,8,0,ECO_300019380
642,Herenthoutsesteenweg 2,2022-06-25,09:00:00,19,19,0,ECO_300019380
642,Herenthoutsesteenweg 2,2022-06-25,10:00:00,58,55,3,ECO_300019380
642,Herenthoutsesteenweg 2,2022-06-25,11:00:00,89,83,6,ECO_300019380
642,Herenthoutsesteenweg 2,2022-06-25,12:00:00,80,77,3,ECO_300019380
642,Herenthoutsesteenweg 2,2022-06-25,13:00:00,95,83,12,ECO_300019380
642,Herenthoutsesteenweg 2,2022-06-25,14:00:00,99,95,4,ECO_300019380
642,Herenthoutsesteenweg 2,2022-06-25,15:00:00,142,132,10,ECO_300019380
642,Herenthoutsesteenweg 2,2022-06-25,16:00:00,83,72,11,ECO_300019380
642,Herenthoutsesteenweg 2,2022-06-25,17:00:00,90,83,7,ECO_300019380
642,Herenthoutsesteenweg 2,2022-06-25,18:00:00,83,70,13,ECO_300019380
642,Herenthoutsesteenweg 2,2022-06-25,19:00:00,43,37,6,ECO_300019380
642,Herenthoutsesteenweg 2,2022-06-25,20:00:00,26,22,4,ECO_300019380
642,Herenthoutsesteenweg 2,2022-06-25,21:00:00,28,24,4,ECO_300019380
642,Herenthoutsesteenweg 2,2022-06-25,22:00:00,28,24,4,ECO_300019380
642,Herenthoutsesteenweg 2,2022-06-25,23:00:00,21,19,2,ECO_300019380
642,Herenthoutsesteenweg 2,2022-06-26,00:00:00,11,9,2,ECO_300019380
642,Herenthoutsesteenweg 2,2022-06-26,01:00:00,2,2,0,ECO_300019380
642,Herenthoutsesteenweg 2,2022-06-26,02:00:00,5,4,1,ECO_300019380
642,Herenthoutsesteenweg 2,2022-06-26,03:00:00,13,8,5,ECO_300019380
642,Herenthoutsesteenweg 2,2022-06-26,04:00:00,2,2,0,ECO_300019380
642,Herenthoutsesteenweg 2,2022-06-26,05:00:00,6,4,2,ECO_300019380
642,Herenthoutsesteenweg 2,2022-06-26,06:00:00,3,2,1,ECO_300019380
642,Herenthoutsesteenweg 2,2022-06-26,07:00:00,1,1,0,ECO_300019380
642,Herenthoutsesteenweg 2,2022-06-26,08:00:00,17,17,0,ECO_300019380
642,Herenthoutsesteenweg 2,2022-06-26,09:00:00,34,30,4,ECO_300019380
642,Herenthoutsesteenweg 2,2022-06-26,10:00:00,58,54,4,ECO_300019380
642,Herenthoutsesteenweg 2,2022-06-26,11:00:00,114,95,19,ECO_300019380
642,Herenthoutsesteenweg 2,2022-06-26,12:00:00,152,144,8,ECO_300019380
642,Herenthoutsesteenweg 2,2022-06-26,13:00:00,88,76,12,ECO_300019380
642,Herenthoutsesteenweg 2,2022-06-26,14:00:00,118,103,15,ECO_300019380
642,Herenthoutsesteenweg 2,2022-06-26,15:00:00,90,81,9,ECO_300019380
642,Herenthoutsesteenweg 2,2022-06-26,16:00:00,123,116,7,ECO_300019380
642,Herenthoutsesteenweg 2,2022-06-26,17:00:00,90,77,13,ECO_300019380
642,Herenthoutsesteenweg 2,2022-06-26,18:00:00,84,70,14,ECO_300019380
642,Herenthoutsesteenweg 2,2022-06-26,19:00:00,63,63,0,ECO_300019380
642,Herenthoutsesteenweg 2,2022-06-26,20:00:00,57,54,3,ECO_300019380
642,Herenthoutsesteenweg 2,2022-06-26,21:00:00,45,40,5,ECO_300019380
642,Herenthoutsesteenweg 2,2022-06-26,22:00:00,48,43,5,ECO_300019380
642,Herenthoutsesteenweg 2,2022-06-26,23:00:00,26,18,8,ECO_300019380
642,Herenthoutsesteenweg 2,2022-06-27,00:00:00,21,20,1,ECO_300019380
642,Herenthoutsesteenweg 2,2022-06-27,01:00:00,1,1,0,ECO_300019380
642,Herenthoutsesteenweg 2,2022-06-27,02:00:00,3,3,0,ECO_300019380
642,Herenthoutsesteenweg 2,2022-06-27,03:00:00,2,2,0,ECO_300019380
642,Herenthoutsesteenweg 2,2022-06-27,04:00:00,0,0,0,ECO_300019380
642,Herenthoutsesteenweg 2,2022-06-27,05:00:00,0,0,0,ECO_300019380
642,Herenthoutsesteenweg 2,2022-06-27,06:00:00,4,2,2,ECO_300019380
642,Herenthoutsesteenweg 2,2022-06-27,07:00:00,24,23,1,ECO_300019380
642,Herenthoutsesteenweg 2,2022-06-27,08:00:00,41,34,7,ECO_300019380
642,Herenthoutsesteenweg 2,2022-06-27,09:00:00,127,122,5,ECO_300019380
642,Herenthoutsesteenweg 2,2022-06-27,10:00:00,130,126,4,ECO_300019380
642,Herenthoutsesteenweg 2,2022-06-27,11:00:00,77,73,4,ECO_300019380
642,Herenthoutsesteenweg 2,2022-06-27,12:00:00,81,78,3,ECO_300019380
642,Herenthoutsesteenweg 2,2022-06-27,13:00:00,67,66,1,ECO_300019380
642,Herenthoutsesteenweg 2,2022-06-27,14:00:00,75,70,5,ECO_300019380
642,Herenthoutsesteenweg 2,2022-06-27,15:00:00,38,34,4,ECO_300019380
642,Herenthoutsesteenweg 2,2022-06-27,16:00:00,41,34,7,ECO_300019380
642,Herenthoutsesteenweg 2,2022-06-27,17:00:00,66,59,7,ECO_300019380
642,Herenthoutsesteenweg 2,2022-06-27,18:00:00,114,101,13,ECO_300019380
642,Herenthoutsesteenweg 2,2022-06-27,19:00:00,124,115,9,ECO_300019380
642,Herenthoutsesteenweg 2,2022-06-27,20:00:00,80,66,14,ECO_300019380
642,Herenthoutsesteenweg 2,2022-06-27,21:00:00,54,48,6,ECO_300019380
642,Herenthoutsesteenweg 2,2022-06-27,22:00:00,43,39,4,ECO_300019380
642,Herenthoutsesteenweg 2,2022-06-27,23:00:00,42,39,3,ECO_300019380
642,Herenthoutsesteenweg 2,2022-06-28,00:00:00,27,26,1,ECO_300019380
642,Herenthoutsesteenweg 2,2022-06-28,01:00:00,3,2,1,ECO_300019380
642,Herenthoutsesteenweg 2,2022-06-28,02:00:00,4,4,0,ECO_300019380
642,Herenthoutsesteenweg 2,2022-06-28,03:00:00,2,2,0,ECO_300019380
642,Herenthoutsesteenweg 2,2022-06-28,04:00:00,0,0,0,ECO_300019380
642,Herenthoutsesteenweg 2,2022-06-28,05:00:00,0,0,0,ECO_300019380
642,Herenthoutsesteenweg 2,2022-06-28,06:00:00,3,1,2,ECO_300019380
642,Herenthoutsesteenweg 2,2022-06-28,07:00:00,30,26,4,ECO_300019380
642,Herenthoutsesteenweg 2,2022-06-28,08:00:00,61,57,4,ECO_300019380
642,Herenthoutsesteenweg 2,2022-06-28,09:00:00,136,131,5,ECO_300019380
642,Herenthoutsesteenweg 2,2022-06-28,10:00:00,179,176,3,ECO_300019380
642,Herenthoutsesteenweg 2,2022-06-28,11:00:00,141,133,8,ECO_300019380
642,Herenthoutsesteenweg 2,2022-06-28,12:00:00,105,98,7,ECO_300019380
642,Herenthoutsesteenweg 2,2022-06-28,13:00:00,112,99,13,ECO_300019380
642,Herenthoutsesteenweg 2,2022-06-28,14:00:00,137,127,10,ECO_300019380
642,Herenthoutsesteenweg 2,2022-06-28,15:00:00,196,184,12,ECO_300019380
642,Herenthoutsesteenweg 2,2022-06-28,16:00:00,169,159,10,ECO_300019380
642,Herenthoutsesteenweg 2,2022-06-28,17:00:00,241,221,20,ECO_300019380
642,Herenthoutsesteenweg 2,2022-06-28,18:00:00,236,215,21,ECO_300019380
642,Herenthoutsesteenweg 2,2022-06-28,19:00:00,167,155,12,ECO_300019380
642,Herenthoutsesteenweg 2,2022-06-28,20:00:00,104,91,13,ECO_300019380
642,Herenthoutsesteenweg 2,2022-06-28,21:00:00,79,66,13,ECO_300019380
642,Herenthoutsesteenweg 2,2022-06-28,22:00:00,80,69,11,ECO_300019380
642,Herenthoutsesteenweg 2,2022-06-28,23:00:00,42,35,7,ECO_300019380
642,Herenthoutsesteenweg 2,2022-06-29,00:00:00,45,42,3,ECO_300019380
642,Herenthoutsesteenweg 2,2022-06-29,01:00:00,9,5,4,ECO_300019380
642,Herenthoutsesteenweg 2,2022-06-29,02:00:00,10,7,3,ECO_300019380
642,Herenthoutsesteenweg 2,2022-06-29,03:00:00,3,3,0,ECO_300019380
642,Herenthoutsesteenweg 2,2022-06-29,04:00:00,2,0,2,ECO_300019380
642,Herenthoutsesteenweg 2,2022-06-29,05:00:00,1,1,0,ECO_300019380
642,Herenthoutsesteenweg 2,2022-06-29,06:00:00,6,4,2,ECO_300019380
642,Herenthoutsesteenweg 2,2022-06-29,07:00:00,28,24,4,ECO_300019380
642,Herenthoutsesteenweg 2,2022-06-29,08:00:00,51,46,5,ECO_300019380
642,Herenthoutsesteenweg 2,2022-06-29,09:00:00,121,118,3,ECO_300019380
642,Herenthoutsesteenweg 2,2022-06-29,10:00:00,169,167,2,ECO_300019380
642,Herenthoutsesteenweg 2,2022-06-29,11:00:00,137,131,6,ECO_300019380
642,Herenthoutsesteenweg 2,2022-06-29,12:00:00,137,135,2,ECO_300019380
642,Herenthoutsesteenweg 2,2022-06-29,13:00:00,122,112,10,ECO_300019380
642,Herenthoutsesteenweg 2,2022-06-29,14:00:00,212,208,4,ECO_300019380
642,Herenthoutsesteenweg 2,2022-06-29,15:00:00,212,196,16,ECO_300019380
642,Herenthoutsesteenweg 2,2022-06-29,16:00:00,241,232,9,ECO_300019380
642,Herenthoutsesteenweg 2,2022-06-29,17:00:00,231,217,14,ECO_300019380
642,Herenthoutsesteenweg 2,2022-06-29,18:00:00,207,193,14,ECO_300019380
642,Herenthoutsesteenweg 2,2022-06-29,19:00:00,208,193,15,ECO_300019380
642,Herenthoutsesteenweg 2,2022-06-29,20:00:00,181,169,12,ECO_300019380
642,Herenthoutsesteenweg 2,2022-06-29,21:00:00,140,133,7,ECO_300019380
642,Herenthoutsesteenweg 2,2022-06-29,22:00:00,93,77,16,ECO_300019380
642,Herenthoutsesteenweg 2,2022-06-29,23:00:00,69,64,5,ECO_300019380
642,Herenthoutsesteenweg 2,2022-06-30,00:00:00,56,41,15,ECO_300019380
642,Herenthoutsesteenweg 2,2022-06-30,01:00:00,14,11,3,ECO_300019380
642,Herenthoutsesteenweg 2,2022-06-30,02:00:00,3,2,1,ECO_300019380
642,Herenthoutsesteenweg 2,2022-06-30,03:00:00,7,2,5,ECO_300019380
642,Herenthoutsesteenweg 2,2022-06-30,04:00:00,3,0,3,ECO_300019380
642,Herenthoutsesteenweg 2,2022-06-30,05:00:00,1,1,0,ECO_300019380
642,Herenthoutsesteenweg 2,2022-06-30,06:00:00,8,4,4,ECO_300019380
642,Herenthoutsesteenweg 2,2022-06-30,07:00:00,19,17,2,ECO_300019380
642,Herenthoutsesteenweg 2,2022-06-30,08:00:00,36,35,1,ECO_300019380
642,Herenthoutsesteenweg 2,2022-06-30,09:00:00,104,98,6,ECO_300019380
642,Herenthoutsesteenweg 2,2022-06-30,10:00:00,146,140,6,ECO_300019380
642,Herenthoutsesteenweg 2,2022-06-30,11:00:00,111,107,4,ECO_300019380
642,Herenthoutsesteenweg 2,2022-06-30,12:00:00,124,117,7,ECO_300019380
642,Herenthoutsesteenweg 2,2022-06-30,13:00:00,90,82,8,ECO_300019380
642,Herenthoutsesteenweg 2,2022-06-30,14:00:00,179,169,10,ECO_300019380
642,Herenthoutsesteenweg 2,2022-06-30,15:00:00,83,69,14,ECO_300019380
642,Herenthoutsesteenweg 2,2022-06-30,16:00:00,104,97,7,ECO_300019380
642,Herenthoutsesteenweg 2,2022-06-30,17:00:00,66,56,10,ECO_300019380
642,Herenthoutsesteenweg 2,2022-06-30,18:00:00,98,91,7,ECO_300019380
642,Herenthoutsesteenweg 2,2022-06-30,19:00:00,51,44,7,ECO_300019380
642,Herenthoutsesteenweg 2,2022-06-30,20:00:00,14,12,2,ECO_300019380
642,Herenthoutsesteenweg 2,2022-06-30,21:00:00,13,13,0,ECO_300019380
642,Herenthoutsesteenweg 2,2022-06-30,22:00:00,14,10,4,ECO_300019380
642,Herenthoutsesteenweg 2,2022-06-30,23:00:00,7,5,2,ECO_300019380
642,Herenthoutsesteenweg 2,2022-07-01,00:00:00,18,17,1,ECO_300019380
642,Herenthoutsesteenweg 2,2022-07-01,01:00:00,2,2,0,ECO_300019380
642,Herenthoutsesteenweg 2,2022-07-01,02:00:00,1,1,0,ECO_300019380
642,Herenthoutsesteenweg 2,2022-07-01,03:00:00,2,2,0,ECO_300019380
642,Herenthoutsesteenweg 2,2022-07-01,04:00:00,0,0,0,ECO_300019380
642,Herenthoutsesteenweg 2,2022-07-01,05:00:00,0,0,0,ECO_300019380
642,Herenthoutsesteenweg 2,2022-07-01,06:00:00,3,2,1,ECO_300019380
642,Herenthoutsesteenweg 2,2022-07-01,07:00:00,25,21,4,ECO_300019380
642,Herenthoutsesteenweg 2,2022-07-01,08:00:00,23,19,4,ECO_300019380
642,Herenthoutsesteenweg 2,2022-07-01,09:00:00,93,90,3,ECO_300019380
642,Herenthoutsesteenweg 2,2022-07-01,10:00:00,123,119,4,ECO_300019380
642,Herenthoutsesteenweg 2,2022-07-01,11:00:00,134,129,5,ECO_300019380
642,Herenthoutsesteenweg 2,2022-07-01,12:00:00,196,185,11,ECO_300019380
642,Herenthoutsesteenweg 2,2022-07-01,13:00:00,87,81,6,ECO_300019380
642,Herenthoutsesteenweg 2,2022-07-01,14:00:00,94,87,7,ECO_300019380
642,Herenthoutsesteenweg 2,2022-07-01,15:00:00,149,139,10,ECO_300019380
642,Herenthoutsesteenweg 2,2022-07-01,16:00:00,211,202,9,ECO_300019380
642,Herenthoutsesteenweg 2,2022-07-01,17:00:00,124,114,10,ECO_300019380
642,Herenthoutsesteenweg 2,2022-07-01,18:00:00,164,147,17,ECO_300019380
642,Herenthoutsesteenweg 2,2022-07-01,19:00:00,102,92,10,ECO_300019380
642,Herenthoutsesteenweg 2,2022-07-01,20:00:00,96,87,9,ECO_300019380
642,Herenthoutsesteenweg 2,2022-07-01,21:00:00,68,62,6,ECO_300019380
642,Herenthoutsesteenweg 2,2022-07-01,22:00:00,44,40,4,ECO_300019380
642,Herenthoutsesteenweg 2,2022-07-01,23:00:00,33,26,7,ECO_300019380
642,Herenthoutsesteenweg 2,2022-07-02,00:00:00,23,21,2,ECO_300019380
642,Herenthoutsesteenweg 2,2022-07-02,01:00:00,16,14,2,ECO_300019380
642,Herenthoutsesteenweg 2,2022-07-02,02:00:00,14,13,1,ECO_300019380
642,Herenthoutsesteenweg 2,2022-07-02,03:00:00,6,1,5,ECO_300019380
642,Herenthoutsesteenweg 2,2022-07-02,04:00:00,8,7,1,ECO_300019380
642,Herenthoutsesteenweg 2,2022-07-02,05:00:00,14,11,3,ECO_300019380
642,Herenthoutsesteenweg 2,2022-07-02,06:00:00,0,0,0,ECO_300019380
642,Herenthoutsesteenweg 2,2022-07-02,07:00:00,11,10,1,ECO_300019380
642,Herenthoutsesteenweg 2,2022-07-02,08:00:00,15,14,1,ECO_300019380
642,Herenthoutsesteenweg 2,2022-07-02,09:00:00,21,20,1,ECO_300019380
642,Herenthoutsesteenweg 2,2022-07-02,10:00:00,43,40,3,ECO_300019380
642,Herenthoutsesteenweg 2,2022-07-02,11:00:00,85,76,9,ECO_300019380
642,Herenthoutsesteenweg 2,2022-07-02,12:00:00,125,120,5,ECO_300019380
642,Herenthoutsesteenweg 2,2022-07-02,13:00:00,132,121,11,ECO_300019380
642,Herenthoutsesteenweg 2,2022-07-02,14:00:00,84,81,3,ECO_300019380
642,Herenthoutsesteenweg 2,2022-07-02,15:00:00,217,209,8,ECO_300019380
642,Herenthoutsesteenweg 2,2022-07-02,16:00:00,232,209,23,ECO_300019380
642,Herenthoutsesteenweg 2,2022-07-02,17:00:00,167,137,30,ECO_300019380
642,Herenthoutsesteenweg 2,2022-07-02,18:00:00,134,110,24,ECO_300019380
642,Herenthoutsesteenweg 2,2022-07-02,19:00:00,82,79,3,ECO_300019380
642,Herenthoutsesteenweg 2,2022-07-02,20:00:00,76,70,6,ECO_300019380
642,Herenthoutsesteenweg 2,2022-07-02,21:00:00,63,58,5,ECO_300019380
642,Herenthoutsesteenweg 2,2022-07-02,22:00:00,32,31,1,ECO_300019380
642,Herenthoutsesteenweg 2,2022-07-02,23:00:00,28,26,2,ECO_300019380
642,Herenthoutsesteenweg 2,2022-07-03,00:00:00,20,16,4,ECO_300019380
642,Herenthoutsesteenweg 2,2022-07-03,01:00:00,13,10,3,ECO_300019380
642,Herenthoutsesteenweg 2,2022-07-03,02:00:00,14,9,5,ECO_300019380
642,Herenthoutsesteenweg 2,2022-07-03,03:00:00,11,8,3,ECO_300019380
642,Herenthoutsesteenweg 2,2022-07-03,04:00:00,9,7,2,ECO_300019380
642,Herenthoutsesteenweg 2,2022-07-03,05:00:00,5,3,2,ECO_300019380
642,Herenthoutsesteenweg 2,2022-07-03,06:00:00,0,0,0,ECO_300019380
642,Herenthoutsesteenweg 2,2022-07-03,07:00:00,2,2,0,ECO_300019380
642,Herenthoutsesteenweg 2,2022-07-03,08:00:00,11,11,0,ECO_300019380
642,Herenthoutsesteenweg 2,2022-07-03,09:00:00,25,24,1,ECO_300019380
642,Herenthoutsesteenweg 2,2022-07-03,10:00:00,72,60,12,ECO_300019380
642,Herenthoutsesteenweg 2,2022-07-03,11:00:00,133,128,5,ECO_300019380
642,Herenthoutsesteenweg 2,2022-07-03,12:00:00,132,119,13,ECO_300019380
642,Herenthoutsesteenweg 2,2022-07-03,13:00:00,141,129,12,ECO_300019380
642,Herenthoutsesteenweg 2,2022-07-03,14:00:00,120,103,17,ECO_300019380
642,Herenthoutsesteenweg 2,2022-07-03,15:00:00,155,150,5,ECO_300019380
642,Herenthoutsesteenweg 2,2022-07-03,16:00:00,151,135,16,ECO_300019380
642,Herenthoutsesteenweg 2,2022-07-03,17:00:00,143,135,8,ECO_300019380
642,Herenthoutsesteenweg 2,2022-07-03,18:00:00,116,98,18,ECO_300019380
642,Herenthoutsesteenweg 2,2022-07-03,19:00:00,100,87,13,ECO_300019380
642,Herenthoutsesteenweg 2,2022-07-03,20:00:00,69,60,9,ECO_300019380
642,Herenthoutsesteenweg 2,2022-07-03,21:00:00,56,51,5,ECO_300019380
642,Herenthoutsesteenweg 2,2022-07-03,22:00:00,43,37,6,ECO_300019380
642,Herenthoutsesteenweg 2,2022-07-03,23:00:00,21,17,4,ECO_300019380
642,Herenthoutsesteenweg 2,2022-07-04,00:00:00,11,8,3,ECO_300019380
642,Herenthoutsesteenweg 2,2022-07-04,01:00:00,4,4,0,ECO_300019380
642,Herenthoutsesteenweg 2,2022-07-04,02:00:00,4,2,2,ECO_300019380
642,Herenthoutsesteenweg 2,2022-07-04,03:00:00,2,1,1,ECO_300019380
642,Herenthoutsesteenweg 2,2022-07-04,04:00:00,0,0,0,ECO_300019380
642,Herenthoutsesteenweg 2,2022-07-04,05:00:00,0,0,0,ECO_300019380
642,Herenthoutsesteenweg 2,2022-07-04,06:00:00,2,2,0,ECO_300019380
642,Herenthoutsesteenweg 2,2022-07-04,07:00:00,22,19,3,ECO_300019380
642,Herenthoutsesteenweg 2,2022-07-04,08:00:00,43,40,3,ECO_300019380
642,Herenthoutsesteenweg 2,2022-07-04,09:00:00,114,107,7,ECO_300019380
642,Herenthoutsesteenweg 2,2022-07-04,10:00:00,100,100,0,ECO_300019380
642,Herenthoutsesteenweg 2,2022-07-04,11:00:00,92,88,4,ECO_300019380
642,Herenthoutsesteenweg 2,2022-07-04,12:00:00,87,82,5,ECO_300019380
642,Herenthoutsesteenweg 2,2022-07-04,13:00:00,96,88,8,ECO_300019380
642,Herenthoutsesteenweg 2,2022-07-04,14:00:00,99,90,9,ECO_300019380
642,Herenthoutsesteenweg 2,2022-07-04,15:00:00,142,136,6,ECO_300019380
642,Herenthoutsesteenweg 2,2022-07-04,16:00:00,119,113,6,ECO_300019380
642,Herenthoutsesteenweg 2,2022-07-04,17:00:00,149,129,20,ECO_300019380
642,Herenthoutsesteenweg 2,2022-07-04,18:00:00,172,163,9,ECO_300019380
642,Herenthoutsesteenweg 2,2022-07-04,19:00:00,120,110,10,ECO_300019380
642,Herenthoutsesteenweg 2,2022-07-04,20:00:00,69,61,8,ECO_300019380
642,Herenthoutsesteenweg 2,2022-07-04,21:00:00,87,80,7,ECO_300019380
642,Herenthoutsesteenweg 2,2022-07-04,22:00:00,41,38,3,ECO_300019380
642,Herenthoutsesteenweg 2,2022-07-04,23:00:00,26,21,5,ECO_300019380
642,Herenthoutsesteenweg 2,2022-07-05,00:00:00,31,29,2,ECO_300019380
642,Herenthoutsesteenweg 2,2022-07-05,01:00:00,3,1,2,ECO_300019380
642,Herenthoutsesteenweg 2,2022-07-05,02:00:00,5,5,0,ECO_300019380
642,Herenthoutsesteenweg 2,2022-07-05,03:00:00,3,2,1,ECO_300019380
642,Herenthoutsesteenweg 2,2022-07-05,04:00:00,2,2,0,ECO_300019380
642,Herenthoutsesteenweg 2,2022-07-05,05:00:00,0,0,0,ECO_300019380
642,Herenthoutsesteenweg 2,2022-07-05,06:00:00,4,2,2,ECO_300019380
642,Herenthoutsesteenweg 2,2022-07-05,07:00:00,25,20,5,ECO_300019380
642,Herenthoutsesteenweg 2,2022-07-05,08:00:00,54,51,3,ECO_300019380
642,Herenthoutsesteenweg 2,2022-07-05,09:00:00,114,109,5,ECO_300019380
642,Herenthoutsesteenweg 2,2022-07-05,10:00:00,94,90,4,ECO_300019380
642,Herenthoutsesteenweg 2,2022-07-05,11:00:00,87,82,5,ECO_300019380
642,Herenthoutsesteenweg 2,2022-07-05,12:00:00,127,122,5,ECO_300019380
642,Herenthoutsesteenweg 2,2022-07-05,13:00:00,100,91,9,ECO_300019380
642,Herenthoutsesteenweg 2,2022-07-05,14:00:00,121,115,6,ECO_300019380
642,Herenthoutsesteenweg 2,2022-07-05,15:00:00,157,152,5,ECO_300019380
642,Herenthoutsesteenweg 2,2022-07-05,16:00:00,149,138,11,ECO_300019380
642,Herenthoutsesteenweg 2,2022-07-05,17:00:00,110,97,13,ECO_300019380
642,Herenthoutsesteenweg 2,2022-07-05,18:00:00,178,149,29,ECO_300019380
642,Herenthoutsesteenweg 2,2022-07-05,19:00:00,120,107,13,ECO_300019380
642,Herenthoutsesteenweg 2,2022-07-05,20:00:00,61,53,8,ECO_300019380
642,Herenthoutsesteenweg 2,2022-07-05,21:00:00,111,101,10,ECO_300019380
642,Herenthoutsesteenweg 2,2022-07-05,22:00:00,38,31,7,ECO_300019380
642,Herenthoutsesteenweg 2,2022-07-05,23:00:00,46,41,5,ECO_300019380
642,Herenthoutsesteenweg 2,2022-07-06,00:00:00,33,29,4,ECO_300019380
642,Herenthoutsesteenweg 2,2022-07-06,01:00:00,4,2,2,ECO_300019380
642,Herenthoutsesteenweg 2,2022-07-06,02:00:00,1,1,0,ECO_300019380
642,Herenthoutsesteenweg 2,2022-07-06,03:00:00,2,1,1,ECO_300019380
642,Herenthoutsesteenweg 2,2022-07-06,04:00:00,0,0,0,ECO_300019380
642,Herenthoutsesteenweg 2,2022-07-06,05:00:00,0,0,0,ECO_300019380
642,Herenthoutsesteenweg 2,2022-07-06,06:00:00,5,3,2,ECO_300019380
642,Herenthoutsesteenweg 2,2022-07-06,07:00:00,20,15,5,ECO_300019380
642,Herenthoutsesteenweg 2,2022-07-06,08:00:00,57,51,6,ECO_300019380
642,Herenthoutsesteenweg 2,2022-07-06,09:00:00,95,87,8,ECO_300019380
642,Herenthoutsesteenweg 2,2022-07-06,10:00:00,91,88,3,ECO_300019380
642,Herenthoutsesteenweg 2,2022-07-06,11:00:00,88,86,2,ECO_300019380
642,Herenthoutsesteenweg 2,2022-07-06,12:00:00,126,116,10,ECO_300019380
642,Herenthoutsesteenweg 2,2022-07-06,13:00:00,99,94,5,ECO_300019380
642,Herenthoutsesteenweg 2,2022-07-06,14:00:00,92,89,3,ECO_300019380
642,Herenthoutsesteenweg 2,2022-07-06,15:00:00,129,117,12,ECO_300019380
642,Herenthoutsesteenweg 2,2022-07-06,16:00:00,144,130,14,ECO_300019380
642,Herenthoutsesteenweg 2,2022-07-06,17:00:00,113,101,12,ECO_300019380
642,Herenthoutsesteenweg 2,2022-07-06,18:00:00,170,155,15,ECO_300019380
642,Herenthoutsesteenweg 2,2022-07-06,19:00:00,108,90,18,ECO_300019380
642,Herenthoutsesteenweg 2,2022-07-06,20:00:00,96,86,10,ECO_300019380
642,Herenthoutsesteenweg 2,2022-07-06,21:00:00,62,53,9,ECO_300019380
642,Herenthoutsesteenweg 2,2022-07-06,22:00:00,45,38,7,ECO_300019380
642,Herenthoutsesteenweg 2,2022-07-06,23:00:00,38,29,9,ECO_300019380
642,Herenthoutsesteenweg 2,2022-07-07,00:00:00,40,34,6,ECO_300019380
642,Herenthoutsesteenweg 2,2022-07-07,01:00:00,9,2,7,ECO_300019380
642,Herenthoutsesteenweg 2,2022-07-07,02:00:00,3,0,3,ECO_300019380
642,Herenthoutsesteenweg 2,2022-07-07,03:00:00,0,0,0,ECO_300019380
642,Herenthoutsesteenweg 2,2022-07-07,04:00:00,0,0,0,ECO_300019380
642,Herenthoutsesteenweg 2,2022-07-07,05:00:00,0,0,0,ECO_300019380
642,Herenthoutsesteenweg 2,2022-07-07,06:00:00,3,1,2,ECO_300019380
642,Herenthoutsesteenweg 2,2022-07-07,07:00:00,19,16,3,ECO_300019380
642,Herenthoutsesteenweg 2,2022-07-07,08:00:00,49,44,5,ECO_300019380
642,Herenthoutsesteenweg 2,2022-07-07,09:00:00,62,57,5,ECO_300019380
642,Herenthoutsesteenweg 2,2022-07-07,10:00:00,71,69,2,ECO_300019380
642,Herenthoutsesteenweg 2,2022-07-07,11:00:00,54,51,3,ECO_300019380
642,Herenthoutsesteenweg 2,2022-07-07,12:00:00,41,38,3,ECO_300019380
642,Herenthoutsesteenweg 2,2022-07-07,13:00:00,53,50,3,ECO_300019380
642,Herenthoutsesteenweg 2,2022-07-07,14:00:00,39,34,5,ECO_300019380
642,Herenthoutsesteenweg 2,2022-07-07,15:00:00,98,97,1,ECO_300019380
642,Herenthoutsesteenweg 2,2022-07-07,16:00:00,78,72,6,ECO_300019380
642,Herenthoutsesteenweg 2,2022-07-07,17:00:00,69,64,5,ECO_300019380
642,Herenthoutsesteenweg 2,2022-07-07,18:00:00,108,94,14,ECO_300019380
642,Herenthoutsesteenweg 2,2022-07-07,19:00:00,82,72,10,ECO_300019380
642,Herenthoutsesteenweg 2,2022-07-07,20:00:00,56,46,10,ECO_300019380
642,Herenthoutsesteenweg 2,2022-07-07,21:00:00,68,63,5,ECO_300019380
642,Herenthoutsesteenweg 2,2022-07-07,22:00:00,35,31,4,ECO_300019380
642,Herenthoutsesteenweg 2,2022-07-07,23:00:00,22,19,3,ECO_300019380
642,Herenthoutsesteenweg 2,2022-07-08,00:00:00,34,27,7,ECO_300019380
642,Herenthoutsesteenweg 2,2022-07-08,01:00:00,4,3,1,ECO_300019380
642,Herenthoutsesteenweg 2,2022-07-08,02:00:00,4,4,0,ECO_300019380
642,Herenthoutsesteenweg 2,2022-07-08,03:00:00,3,2,1,ECO_300019380
642,Herenthoutsesteenweg 2,2022-07-08,04:00:00,0,0,0,ECO_300019380
642,Herenthoutsesteenweg 2,2022-07-08,05:00:00,0,0,0,ECO_300019380
642,Herenthoutsesteenweg 2,2022-07-08,06:00:00,3,2,1,ECO_300019380
642,Herenthoutsesteenweg 2,2022-07-08,07:00:00,21,15,6,ECO_300019380
642,Herenthoutsesteenweg 2,2022-07-08,08:00:00,37,34,3,ECO_300019380
642,Herenthoutsesteenweg 2,2022-07-08,09:00:00,96,88,8,ECO_300019380
642,Herenthoutsesteenweg 2,2022-07-08,10:00:00,124,122,2,ECO_300019380
642,Herenthoutsesteenweg 2,2022-07-08,11:00:00,148,147,1,ECO_300019380
642,Herenthoutsesteenweg 2,2022-07-08,12:00:00,168,161,7,ECO_300019380
642,Herenthoutsesteenweg 2,2022-07-08,13:00:00,122,119,3,ECO_300019380
642,Herenthoutsesteenweg 2,2022-07-08,14:00:00,116,107,9,ECO_300019380
642,Herenthoutsesteenweg 2,2022-07-08,15:00:00,147,136,11,ECO_300019380
642,Herenthoutsesteenweg 2,2022-07-08,16:00:00,183,165,18,ECO_300019380
642,Herenthoutsesteenweg 2,2022-07-08,17:00:00,154,143,11,ECO_300019380
642,Herenthoutsesteenweg 2,2022-07-08,18:00:00,132,122,10,ECO_300019380
642,Herenthoutsesteenweg 2,2022-07-08,19:00:00,90,79,11,ECO_300019380
642,Herenthoutsesteenweg 2,2022-07-08,20:00:00,69,61,8,ECO_300019380
642,Herenthoutsesteenweg 2,2022-07-08,21:00:00,75,64,11,ECO_300019380
642,Herenthoutsesteenweg 2,2022-07-08,22:00:00,47,43,4,ECO_300019380
642,Herenthoutsesteenweg 2,2022-07-08,23:00:00,38,33,5,ECO_300019380
642,Herenthoutsesteenweg 2,2022-07-09,00:00:00,28,19,9,ECO_300019380
642,Herenthoutsesteenweg 2,2022-07-09,01:00:00,9,7,2,ECO_300019380
642,Herenthoutsesteenweg 2,2022-07-09,02:00:00,14,13,1,ECO_300019380
642,Herenthoutsesteenweg 2,2022-07-09,03:00:00,4,2,2,ECO_300019380
642,Herenthoutsesteenweg 2,2022-07-09,04:00:00,4,2,2,ECO_300019380
642,Herenthoutsesteenweg 2,2022-07-09,05:00:00,3,1,2,ECO_300019380
642,Herenthoutsesteenweg 2,2022-07-09,06:00:00,2,2,0,ECO_300019380
642,Herenthoutsesteenweg 2,2022-07-09,07:00:00,6,6,0,ECO_300019380
642,Herenthoutsesteenweg 2,2022-07-09,08:00:00,20,18,2,ECO_300019380
642,Herenthoutsesteenweg 2,2022-07-09,09:00:00,19,19,0,ECO_300019380
642,Herenthoutsesteenweg 2,2022-07-09,10:00:00,51,49,2,ECO_300019380
642,Herenthoutsesteenweg 2,2022-07-09,11:00:00,69,62,7,ECO_300019380
642,Herenthoutsesteenweg 2,2022-07-09,12:00:00,115,106,9,ECO_300019380
642,Herenthoutsesteenweg 2,2022-07-09,13:00:00,113,97,16,ECO_300019380
642,Herenthoutsesteenweg 2,2022-07-09,14:00:00,116,111,5,ECO_300019380
642,Herenthoutsesteenweg 2,2022-07-09,15:00:00,166,153,13,ECO_300019380
642,Herenthoutsesteenweg 2,2022-07-09,16:00:00,170,155,15,ECO_300019380
642,Herenthoutsesteenweg 2,2022-07-09,17:00:00,149,133,16,ECO_300019380
642,Herenthoutsesteenweg 2,2022-07-09,18:00:00,122,119,3,ECO_300019380
642,Herenthoutsesteenweg 2,2022-07-09,19:00:00,105,89,16,ECO_300019380
642,Herenthoutsesteenweg 2,2022-07-09,20:00:00,87,82,5,ECO_300019380
642,Herenthoutsesteenweg 2,2022-07-09,21:00:00,61,54,7,ECO_300019380
642,Herenthoutsesteenweg 2,2022-07-09,22:00:00,36,32,4,ECO_300019380
642,Herenthoutsesteenweg 2,2022-07-09,23:00:00,31,23,8,ECO_300019380
642,Herenthoutsesteenweg 2,2022-07-10,00:00:00,10,8,2,ECO_300019380
642,Herenthoutsesteenweg 2,2022-07-10,01:00:00,20,15,5,ECO_300019380
642,Herenthoutsesteenweg 2,2022-07-10,02:00:00,6,5,1,ECO_300019380
642,Herenthoutsesteenweg 2,2022-07-10,03:00:00,4,4,0,ECO_300019380
642,Herenthoutsesteenweg 2,2022-07-10,04:00:00,5,5,0,ECO_300019380
642,Herenthoutsesteenweg 2,2022-07-10,05:00:00,6,4,2,ECO_300019380
642,Herenthoutsesteenweg 2,2022-07-10,06:00:00,4,3,1,ECO_300019380
642,Herenthoutsesteenweg 2,2022-07-10,07:00:00,4,3,1,ECO_300019380
642,Herenthoutsesteenweg 2,2022-07-10,08:00:00,7,7,0,ECO_300019380
642,Herenthoutsesteenweg 2,2022-07-10,09:00:00,24,22,2,ECO_300019380
642,Herenthoutsesteenweg 2,2022-07-10,10:00:00,60,58,2,ECO_300019380
642,Herenthoutsesteenweg 2,2022-07-10,11:00:00,123,118,5,ECO_300019380
642,Herenthoutsesteenweg 2,2022-07-10,12:00:00,182,165,17,ECO_300019380
642,Herenthoutsesteenweg 2,2022-07-10,13:00:00,122,107,15,ECO_300019380
642,Herenthoutsesteenweg 2,2022-07-10,14:00:00,79,67,12,ECO_300019380
642,Herenthoutsesteenweg 2,2022-07-10,15:00:00,140,135,5,ECO_300019380
642,Herenthoutsesteenweg 2,2022-07-10,16:00:00,186,176,10,ECO_300019380
642,Herenthoutsesteenweg 2,2022-07-10,17:00:00,175,159,16,ECO_300019380
642,Herenthoutsesteenweg 2,2022-07-10,18:00:00,79,66,13,ECO_300019380
642,Herenthoutsesteenweg 2,2022-07-10,19:00:00,63,58,5,ECO_300019380
642,Herenthoutsesteenweg 2,2022-07-10,20:00:00,84,64,20,ECO_300019380
642,Herenthoutsesteenweg 2,2022-07-10,21:00:00,55,47,8,ECO_300019380
642,Herenthoutsesteenweg 2,2022-07-10,22:00:00,54,45,9,ECO_300019380
642,Herenthoutsesteenweg 2,2022-07-10,23:00:00,34,31,3,ECO_300019380
642,Herenthoutsesteenweg 2,2022-07-11,00:00:00,23,16,7,ECO_300019380
642,Herenthoutsesteenweg 2,2022-07-11,01:00:00,8,4,4,ECO_300019380
642,Herenthoutsesteenweg 2,2022-07-11,02:00:00,0,0,0,ECO_300019380
642,Herenthoutsesteenweg 2,2022-07-11,03:00:00,1,0,1,ECO_300019380
642,Herenthoutsesteenweg 2,2022-07-11,04:00:00,2,2,0,ECO_300019380
642,Herenthoutsesteenweg 2,2022-07-11,05:00:00,1,1,0,ECO_300019380
642,Herenthoutsesteenweg 2,2022-07-11,06:00:00,6,4,2,ECO_300019380
642,Herenthoutsesteenweg 2,2022-07-11,07:00:00,14,12,2,ECO_300019380
642,Herenthoutsesteenweg 2,2022-07-11,08:00:00,25,24,1,ECO_300019380
642,Herenthoutsesteenweg 2,2022-07-11,09:00:00,61,57,4,ECO_300019380
642,Herenthoutsesteenweg 2,2022-07-11,10:00:00,77,74,3,ECO_300019380
642,Herenthoutsesteenweg 2,2022-07-11,11:00:00,82,79,3,ECO_300019380
642,Herenthoutsesteenweg 2,2022-07-11,12:00:00,83,79,4,ECO_300019380
642,Herenthoutsesteenweg 2,2022-07-11,13:00:00,128,122,6,ECO_300019380
642,Herenthoutsesteenweg 2,2022-07-11,14:00:00,88,76,12,ECO_300019380
642,Herenthoutsesteenweg 2,2022-07-11,15:00:00,179,171,8,ECO_300019380
642,Herenthoutsesteenweg 2,2022-07-11,16:00:00,168,160,8,ECO_300019380
642,Herenthoutsesteenweg 2,2022-07-11,17:00:00,114,104,10,ECO_300019380
642,Herenthoutsesteenweg 2,2022-07-11,18:00:00,151,136,15,ECO_300019380
642,Herenthoutsesteenweg 2,2022-07-11,19:00:00,126,110,16,ECO_300019380
642,Herenthoutsesteenweg 2,2022-07-11,20:00:00,76,66,10,ECO_300019380
642,Herenthoutsesteenweg 2,2022-07-11,21:00:00,47,41,6,ECO_300019380
642,Herenthoutsesteenweg 2,2022-07-11,22:00:00,55,47,8,ECO_300019380
642,Herenthoutsesteenweg 2,2022-07-11,23:00:00,45,36,9,ECO_300019380
642,Herenthoutsesteenweg 2,2022-07-12,00:00:00,30,26,4,ECO_300019380
642,Herenthoutsesteenweg 2,2022-07-12,01:00:00,3,2,1,ECO_300019380
642,Herenthoutsesteenweg 2,2022-07-12,02:00:00,3,3,0,ECO_300019380
642,Herenthoutsesteenweg 2,2022-07-12,03:00:00,1,1,0,ECO_300019380
642,Herenthoutsesteenweg 2,2022-07-12,04:00:00,3,3,0,ECO_300019380
642,Herenthoutsesteenweg 2,2022-07-12,05:00:00,1,1,0,ECO_300019380
642,Herenthoutsesteenweg 2,2022-07-12,06:00:00,5,3,2,ECO_300019380
642,Herenthoutsesteenweg 2,2022-07-12,07:00:00,17,15,2,ECO_300019380
642,Herenthoutsesteenweg 2,2022-07-12,08:00:00,46,43,3,ECO_300019380
642,Herenthoutsesteenweg 2,2022-07-12,09:00:00,82,79,3,ECO_300019380
642,Herenthoutsesteenweg 2,2022-07-12,10:00:00,90,88,2,ECO_300019380
642,Herenthoutsesteenweg 2,2022-07-12,11:00:00,112,109,3,ECO_300019380
642,Herenthoutsesteenweg 2,2022-07-12,12:00:00,124,118,6,ECO_300019380
642,Herenthoutsesteenweg 2,2022-07-12,13:00:00,116,105,11,ECO_300019380
642,Herenthoutsesteenweg 2,2022-07-12,14:00:00,134,119,15,ECO_300019380
642,Herenthoutsesteenweg 2,2022-07-12,15:00:00,131,126,5,ECO_300019380
642,Herenthoutsesteenweg 2,2022-07-12,16:00:00,169,157,12,ECO_300019380
642,Herenthoutsesteenweg 2,2022-07-12,17:00:00,112,94,18,ECO_300019380
642,Herenthoutsesteenweg 2,2022-07-12,18:00:00,173,150,23,ECO_300019380
642,Herenthoutsesteenweg 2,2022-07-12,19:00:00,126,112,14,ECO_300019380
642,Herenthoutsesteenweg 2,2022-07-12,20:00:00,99,86,13,ECO_300019380
642,Herenthoutsesteenweg 2,2022-07-12,21:00:00,86,81,5,ECO_300019380
642,Herenthoutsesteenweg 2,2022-07-12,22:00:00,60,54,6,ECO_300019380
642,Herenthoutsesteenweg 2,2022-07-12,23:00:00,40,32,8,ECO_300019380
642,Herenthoutsesteenweg 2,2022-07-13,00:00:00,33,26,7,ECO_300019380
642,Herenthoutsesteenweg 2,2022-07-13,01:00:00,8,7,1,ECO_300019380
642,Herenthoutsesteenweg 2,2022-07-13,02:00:00,6,4,2,ECO_300019380
642,Herenthoutsesteenweg 2,2022-07-13,03:00:00,1,0,1,ECO_300019380
642,Herenthoutsesteenweg 2,2022-07-13,04:00:00,0,0,0,ECO_300019380
642,Herenthoutsesteenweg 2,2022-07-13,05:00:00,1,1,0,ECO_300019380
642,Herenthoutsesteenweg 2,2022-07-13,06:00:00,4,2,2,ECO_300019380
642,Herenthoutsesteenweg 2,2022-07-13,07:00:00,20,16,4,ECO_300019380
642,Herenthoutsesteenweg 2,2022-07-13,08:00:00,52,47,5,ECO_300019380
642,Herenthoutsesteenweg 2,2022-07-13,09:00:00,86,79,7,ECO_300019380
642,Herenthoutsesteenweg 2,2022-07-13,10:00:00,92,89,3,ECO_300019380
642,Herenthoutsesteenweg 2,2022-07-13,11:00:00,103,100,3,ECO_300019380
642,Herenthoutsesteenweg 2,2022-07-13,12:00:00,124,118,6,ECO_300019380
642,Herenthoutsesteenweg 2,2022-07-13,13:00:00,90,88,2,ECO_300019380
642,Herenthoutsesteenweg 2,2022-07-13,14:00:00,128,115,13,ECO_300019380
642,Herenthoutsesteenweg 2,2022-07-13,15:00:00,124,110,14,ECO_300019380
642,Herenthoutsesteenweg 2,2022-07-13,16:00:00,166,156,10,ECO_300019380
642,Herenthoutsesteenweg 2,2022-07-13,17:00:00,113,110,3,ECO_300019380
642,Herenthoutsesteenweg 2,2022-07-13,18:00:00,126,111,15,ECO_300019380
642,Herenthoutsesteenweg 2,2022-07-13,19:00:00,104,87,17,ECO_300019380
642,Herenthoutsesteenweg 2,2022-07-13,20:00:00,122,115,7,ECO_300019380
642,Herenthoutsesteenweg 2,2022-07-13,21:00:00,85,78,7,ECO_300019380
642,Herenthoutsesteenweg 2,2022-07-13,22:00:00,58,51,7,ECO_300019380
642,Herenthoutsesteenweg 2,2022-07-13,23:00:00,39,34,5,ECO_300019380
642,Herenthoutsesteenweg 2,2022-07-14,00:00:00,34,30,4,ECO_300019380
642,Herenthoutsesteenweg 2,2022-07-14,01:00:00,13,9,4,ECO_300019380
642,Herenthoutsesteenweg 2,2022-07-14,02:00:00,0,0,0,ECO_300019380
642,Herenthoutsesteenweg 2,2022-07-14,03:00:00,0,0,0,ECO_300019380
642,Herenthoutsesteenweg 2,2022-07-14,04:00:00,2,2,0,ECO_300019380
642,Herenthoutsesteenweg 2,2022-07-14,05:00:00,2,2,0,ECO_300019380
642,Herenthoutsesteenweg 2,2022-07-14,06:00:00,8,6,2,ECO_300019380
642,Herenthoutsesteenweg 2,2022-07-14,07:00:00,16,14,2,ECO_300019380
642,Herenthoutsesteenweg 2,2022-07-14,08:00:00,41,38,3,ECO_300019380
642,Herenthoutsesteenweg 2,2022-07-14,09:00:00,98,91,7,ECO_300019380
642,Herenthoutsesteenweg 2,2022-07-14,10:00:00,93,90,3,ECO_300019380
642,Herenthoutsesteenweg 2,2022-07-14,11:00:00,98,97,1,ECO_300019380
642,Herenthoutsesteenweg 2,2022-07-14,12:00:00,126,112,14,ECO_300019380
642,Herenthoutsesteenweg 2,2022-07-14,13:00:00,107,91,16,ECO_300019380
642,Herenthoutsesteenweg 2,2022-07-14,14:00:00,120,110,10,ECO_300019380
642,Herenthoutsesteenweg 2,2022-07-14,15:00:00,181,173,8,ECO_300019380
642,Herenthoutsesteenweg 2,2022-07-14,16:00:00,155,147,8,ECO_300019380
642,Herenthoutsesteenweg 2,2022-07-14,17:00:00,107,95,12,ECO_300019380
642,Herenthoutsesteenweg 2,2022-07-14,18:00:00,147,128,19,ECO_300019380
642,Herenthoutsesteenweg 2,2022-07-14,19:00:00,111,103,8,ECO_300019380
642,Herenthoutsesteenweg 2,2022-07-14,20:00:00,107,98,9,ECO_300019380
642,Herenthoutsesteenweg 2,2022-07-14,21:00:00,83,78,5,ECO_300019380
642,Herenthoutsesteenweg 2,2022-07-14,22:00:00,80,72,8,ECO_300019380
642,Herenthoutsesteenweg 2,2022-07-14,23:00:00,31,26,5,ECO_300019380
642,Herenthoutsesteenweg 2,2022-07-15,00:00:00,23,20,3,ECO_300019380
642,Herenthoutsesteenweg 2,2022-07-15,01:00:00,6,4,2,ECO_300019380
642,Herenthoutsesteenweg 2,2022-07-15,02:00:00,5,3,2,ECO_300019380
642,Herenthoutsesteenweg 2,2022-07-15,03:00:00,0,0,0,ECO_300019380
642,Herenthoutsesteenweg 2,2022-07-15,04:00:00,4,3,1,ECO_300019380
642,Herenthoutsesteenweg 2,2022-07-15,05:00:00,1,1,0,ECO_300019380
642,Herenthoutsesteenweg 2,2022-07-15,06:00:00,3,3,0,ECO_300019380
642,Herenthoutsesteenweg 2,2022-07-15,07:00:00,10,8,2,ECO_300019380
642,Herenthoutsesteenweg 2,2022-07-15,08:00:00,39,35,4,ECO_300019380
642,Herenthoutsesteenweg 2,2022-07-15,09:00:00,78,76,2,ECO_300019380
642,Herenthoutsesteenweg 2,2022-07-15,10:00:00,105,101,4,ECO_300019380
642,Herenthoutsesteenweg 2,2022-07-15,11:00:00,194,188,6,ECO_300019380
642,Herenthoutsesteenweg 2,2022-07-15,12:00:00,173,163,10,ECO_300019380
642,Herenthoutsesteenweg 2,2022-07-15,13:00:00,140,130,10,ECO_300019380
642,Herenthoutsesteenweg 2,2022-07-15,14:00:00,81,76,5,ECO_300019380
642,Herenthoutsesteenweg 2,2022-07-15,15:00:00,163,151,12,ECO_300019380
642,Herenthoutsesteenweg 2,2022-07-15,16:00:00,184,169,15,ECO_300019380
642,Herenthoutsesteenweg 2,2022-07-15,17:00:00,128,112,16,ECO_300019380
642,Herenthoutsesteenweg 2,2022-07-15,18:00:00,142,130,12,ECO_300019380
642,Herenthoutsesteenweg 2,2022-07-15,19:00:00,92,80,12,ECO_300019380
642,Herenthoutsesteenweg 2,2022-07-15,20:00:00,94,79,15,ECO_300019380
642,Herenthoutsesteenweg 2,2022-07-15,21:00:00,70,59,11,ECO_300019380
642,Herenthoutsesteenweg 2,2022-07-15,22:00:00,58,51,7,ECO_300019380
642,Herenthoutsesteenweg 2,2022-07-15,23:00:00,37,31,6,ECO_300019380
642,Herenthoutsesteenweg 2,2022-07-16,00:00:00,46,40,6,ECO_300019380
642,Herenthoutsesteenweg 2,2022-07-16,01:00:00,4,1,3,ECO_300019380
642,Herenthoutsesteenweg 2,2022-07-16,02:00:00,27,22,5,ECO_300019380
642,Herenthoutsesteenweg 2,2022-07-16,03:00:00,9,8,1,ECO_300019380
642,Herenthoutsesteenweg 2,2022-07-16,04:00:00,4,3,1,ECO_300019380
642,Herenthoutsesteenweg 2,2022-07-16,05:00:00,4,3,1,ECO_300019380
642,Herenthoutsesteenweg 2,2022-07-16,06:00:00,2,2,0,ECO_300019380
642,Herenthoutsesteenweg 2,2022-07-16,07:00:00,5,5,0,ECO_300019380
642,Herenthoutsesteenweg 2,2022-07-16,08:00:00,19,15,4,ECO_300019380
642,Herenthoutsesteenweg 2,2022-07-16,09:00:00,19,19,0,ECO_300019380
642,Herenthoutsesteenweg 2,2022-07-16,10:00:00,53,52,1,ECO_300019380
642,Herenthoutsesteenweg 2,2022-07-16,11:00:00,100,97,3,ECO_300019380
642,Herenthoutsesteenweg 2,2022-07-16,12:00:00,114,102,12,ECO_300019380
642,Herenthoutsesteenweg 2,2022-07-16,13:00:00,114,105,9,ECO_300019380
642,Herenthoutsesteenweg 2,2022-07-16,14:00:00,120,111,9,ECO_300019380
642,Herenthoutsesteenweg 2,2022-07-16,15:00:00,230,220,10,ECO_300019380
642,Herenthoutsesteenweg 2,2022-07-16,16:00:00,184,161,23,ECO_300019380
642,Herenthoutsesteenweg 2,2022-07-16,17:00:00,154,135,19,ECO_300019380
642,Herenthoutsesteenweg 2,2022-07-16,18:00:00,101,78,23,ECO_300019380
642,Herenthoutsesteenweg 2,2022-07-16,19:00:00,76,61,15,ECO_300019380
642,Herenthoutsesteenweg 2,2022-07-16,20:00:00,61,55,6,ECO_300019380
642,Herenthoutsesteenweg 2,2022-07-16,21:00:00,57,53,4,ECO_300019380
642,Herenthoutsesteenweg 2,2022-07-16,22:00:00,68,60,8,ECO_300019380
642,Herenthoutsesteenweg 2,2022-07-16,23:00:00,42,33,9,ECO_300019380
642,Herenthoutsesteenweg 2,2022-07-17,00:00:00,38,37,1,ECO_300019380
642,Herenthoutsesteenweg 2,2022-07-17,01:00:00,20,17,3,ECO_300019380
642,Herenthoutsesteenweg 2,2022-07-17,02:00:00,6,5,1,ECO_300019380
642,Herenthoutsesteenweg 2,2022-07-17,03:00:00,21,20,1,ECO_300019380
642,Herenthoutsesteenweg 2,2022-07-17,04:00:00,16,14,2,ECO_300019380
642,Herenthoutsesteenweg 2,2022-07-17,05:00:00,10,10,0,ECO_300019380
642,Herenthoutsesteenweg 2,2022-07-17,06:00:00,2,1,1,ECO_300019380
642,Herenthoutsesteenweg 2,2022-07-17,07:00:00,6,5,1,ECO_300019380
642,Herenthoutsesteenweg 2,2022-07-17,08:00:00,8,8,0,ECO_300019380
642,Herenthoutsesteenweg 2,2022-07-17,09:00:00,33,29,4,ECO_300019380
642,Herenthoutsesteenweg 2,2022-07-17,10:00:00,75,63,12,ECO_300019380
642,Herenthoutsesteenweg 2,2022-07-17,11:00:00,150,143,7,ECO_300019380
642,Herenthoutsesteenweg 2,2022-07-17,12:00:00,199,181,18,ECO_300019380
642,Herenthoutsesteenweg 2,2022-07-17,13:00:00,155,136,19,ECO_300019380
642,Herenthoutsesteenweg 2,2022-07-17,14:00:00,152,136,16,ECO_300019380
642,Herenthoutsesteenweg 2,2022-07-17,15:00:00,183,167,16,ECO_300019380
642,Herenthoutsesteenweg 2,2022-07-17,16:00:00,183,172,11,ECO_300019380
642,Herenthoutsesteenweg 2,2022-07-17,17:00:00,130,114,16,ECO_300019380
642,Herenthoutsesteenweg 2,2022-07-17,18:00:00,109,92,17,ECO_300019380
642,Herenthoutsesteenweg 2,2022-07-17,19:00:00,107,94,13,ECO_300019380
642,Herenthoutsesteenweg 2,2022-07-17,20:00:00,77,71,6,ECO_300019380
642,Herenthoutsesteenweg 2,2022-07-17,21:00:00,87,71,16,ECO_300019380
642,Herenthoutsesteenweg 2,2022-07-17,22:00:00,79,66,13,ECO_300019380
642,Herenthoutsesteenweg 2,2022-07-17,23:00:00,43,28,15,ECO_300019380
642,Herenthoutsesteenweg 2,2022-07-18,00:00:00,38,28,10,ECO_300019380
642,Herenthoutsesteenweg 2,2022-07-18,01:00:00,17,11,6,ECO_300019380
642,Herenthoutsesteenweg 2,2022-07-18,02:00:00,2,2,0,ECO_300019380
642,Herenthoutsesteenweg 2,2022-07-18,03:00:00,4,4,0,ECO_300019380
642,Herenthoutsesteenweg 2,2022-07-18,04:00:00,6,6,0,ECO_300019380
642,Herenthoutsesteenweg 2,2022-07-18,05:00:00,2,1,1,ECO_300019380
642,Herenthoutsesteenweg 2,2022-07-18,06:00:00,5,3,2,ECO_300019380
642,Herenthoutsesteenweg 2,2022-07-18,07:00:00,18,16,2,ECO_300019380
642,Herenthoutsesteenweg 2,2022-07-18,08:00:00,40,40,0,ECO_300019380
642,Herenthoutsesteenweg 2,2022-07-18,09:00:00,84,78,6,ECO_300019380
642,Herenthoutsesteenweg 2,2022-07-18,10:00:00,84,82,2,ECO_300019380
642,Herenthoutsesteenweg 2,2022-07-18,11:00:00,112,106,6,ECO_300019380
642,Herenthoutsesteenweg 2,2022-07-18,12:00:00,110,103,7,ECO_300019380
642,Herenthoutsesteenweg 2,2022-07-18,13:00:00,88,86,2,ECO_300019380
642,Herenthoutsesteenweg 2,2022-07-18,14:00:00,91,86,5,ECO_300019380
642,Herenthoutsesteenweg 2,2022-07-18,15:00:00,100,95,5,ECO_300019380
642,Herenthoutsesteenweg 2,2022-07-18,16:00:00,88,83,5,ECO_300019380
642,Herenthoutsesteenweg 2,2022-07-18,17:00:00,77,65,12,ECO_300019380
642,Herenthoutsesteenweg 2,2022-07-18,18:00:00,84,73,11,ECO_300019380
642,Herenthoutsesteenweg 2,2022-07-18,19:00:00,79,69,10,ECO_300019380
642,Herenthoutsesteenweg 2,2022-07-18,20:00:00,60,54,6,ECO_300019380
642,Herenthoutsesteenweg 2,2022-07-18,21:00:00,70,66,4,ECO_300019380
642,Herenthoutsesteenweg 2,2022-07-18,22:00:00,37,33,4,ECO_300019380
642,Herenthoutsesteenweg 2,2022-07-18,23:00:00,45,38,7,ECO_300019380
642,Herenthoutsesteenweg 2,2022-07-19,00:00:00,32,28,4,ECO_300019380
642,Herenthoutsesteenweg 2,2022-07-19,01:00:00,4,3,1,ECO_300019380
642,Herenthoutsesteenweg 2,2022-07-19,02:00:00,2,2,0,ECO_300019380
642,Herenthoutsesteenweg 2,2022-07-19,03:00:00,3,1,2,ECO_300019380
642,Herenthoutsesteenweg 2,2022-07-19,04:00:00,0,0,0,ECO_300019380
642,Herenthoutsesteenweg 2,2022-07-19,05:00:00,0,0,0,ECO_300019380
642,Herenthoutsesteenweg 2,2022-07-19,06:00:00,4,1,3,ECO_300019380
642,Herenthoutsesteenweg 2,2022-07-19,07:00:00,20,17,3,ECO_300019380
642,Herenthoutsesteenweg 2,2022-07-19,08:00:00,50,48,2,ECO_300019380
642,Herenthoutsesteenweg 2,2022-07-19,09:00:00,86,80,6,ECO_300019380
642,Herenthoutsesteenweg 2,2022-07-19,10:00:00,114,109,5,ECO_300019380
642,Herenthoutsesteenweg 2,2022-07-19,11:00:00,103,97,6,ECO_300019380
642,Herenthoutsesteenweg 2,2022-07-19,12:00:00,115,110,5,ECO_300019380
642,Herenthoutsesteenweg 2,2022-07-19,13:00:00,65,61,4,ECO_300019380
642,Herenthoutsesteenweg 2,2022-07-19,14:00:00,49,47,2,ECO_300019380
642,Herenthoutsesteenweg 2,2022-07-19,15:00:00,70,67,3,ECO_300019380
642,Herenthoutsesteenweg 2,2022-07-19,16:00:00,58,52,6,ECO_300019380
642,Herenthoutsesteenweg 2,2022-07-19,17:00:00,55,53,2,ECO_300019380
642,Herenthoutsesteenweg 2,2022-07-19,18:00:00,53,46,7,ECO_300019380
642,Herenthoutsesteenweg 2,2022-07-19,19:00:00,52,45,7,ECO_300019380
642,Herenthoutsesteenweg 2,2022-07-19,20:00:00,33,27,6,ECO_300019380
642,Herenthoutsesteenweg 2,2022-07-19,21:00:00,61,54,7,ECO_300019380
642,Herenthoutsesteenweg 2,2022-07-19,22:00:00,39,34,5,ECO_300019380
642,Herenthoutsesteenweg 2,2022-07-19,23:00:00,30,26,4,ECO_300019380
642,Herenthoutsesteenweg 2,2022-07-20,00:00:00,36,25,11,ECO_300019380
642,Herenthoutsesteenweg 2,2022-07-20,01:00:00,10,7,3,ECO_300019380
642,Herenthoutsesteenweg 2,2022-07-20,02:00:00,4,3,1,ECO_300019380
642,Herenthoutsesteenweg 2,2022-07-20,03:00:00,2,2,0,ECO_300019380
642,Herenthoutsesteenweg 2,2022-07-20,04:00:00,0,0,0,ECO_300019380
642,Herenthoutsesteenweg 2,2022-07-20,05:00:00,0,0,0,ECO_300019380
642,Herenthoutsesteenweg 2,2022-07-20,06:00:00,2,2,0,ECO_300019380
642,Herenthoutsesteenweg 2,2022-07-20,07:00:00,18,13,5,ECO_300019380
642,Herenthoutsesteenweg 2,2022-07-20,08:00:00,30,28,2,ECO_300019380
642,Herenthoutsesteenweg 2,2022-07-20,09:00:00,49,44,5,ECO_300019380
642,Herenthoutsesteenweg 2,2022-07-20,10:00:00,85,84,1,ECO_300019380
642,Herenthoutsesteenweg 2,2022-07-20,11:00:00,92,91,1,ECO_300019380
642,Herenthoutsesteenweg 2,2022-07-20,12:00:00,94,87,7,ECO_300019380
642,Herenthoutsesteenweg 2,2022-07-20,13:00:00,114,112,2,ECO_300019380
642,Herenthoutsesteenweg 2,2022-07-20,14:00:00,77,73,4,ECO_300019380
642,Herenthoutsesteenweg 2,2022-07-20,15:00:00,90,84,6,ECO_300019380
642,Herenthoutsesteenweg 2,2022-07-20,16:00:00,90,85,5,ECO_300019380
642,Herenthoutsesteenweg 2,2022-07-20,17:00:00,79,59,20,ECO_300019380
642,Herenthoutsesteenweg 2,2022-07-20,18:00:00,85,79,6,ECO_300019380
642,Herenthoutsesteenweg 2,2022-07-20,19:00:00,78,72,6,ECO_300019380
642,Herenthoutsesteenweg 2,2022-07-20,20:00:00,60,55,5,ECO_300019380
642,Herenthoutsesteenweg 2,2022-07-20,21:00:00,54,45,9,ECO_300019380
642,Herenthoutsesteenweg 2,2022-07-20,22:00:00,32,27,5,ECO_300019380
642,Herenthoutsesteenweg 2,2022-07-20,23:00:00,39,30,9,ECO_300019380
642,Herenthoutsesteenweg 2,2022-07-21,00:00:00,16,16,0,ECO_300019380
642,Herenthoutsesteenweg 2,2022-07-21,01:00:00,11,9,2,ECO_300019380
642,Herenthoutsesteenweg 2,2022-07-21,02:00:00,13,11,2,ECO_300019380
642,Herenthoutsesteenweg 2,2022-07-21,03:00:00,10,9,1,ECO_300019380
642,Herenthoutsesteenweg 2,2022-07-21,04:00:00,2,2,0,ECO_300019380
642,Herenthoutsesteenweg 2,2022-07-21,05:00:00,5,3,2,ECO_300019380
642,Herenthoutsesteenweg 2,2022-07-21,06:00:00,5,4,1,ECO_300019380
642,Herenthoutsesteenweg 2,2022-07-21,07:00:00,2,1,1,ECO_300019380
642,Herenthoutsesteenweg 2,2022-07-21,08:00:00,12,12,0,ECO_300019380
642,Herenthoutsesteenweg 2,2022-07-21,09:00:00,21,19,2,ECO_300019380
642,Herenthoutsesteenweg 2,2022-07-21,10:00:00,10,7,3,ECO_300019380
642,Herenthoutsesteenweg 2,2022-07-21,11:00:00,3,2,1,ECO_300019380
642,Herenthoutsesteenweg 2,2022-07-21,12:00:00,9,9,0,ECO_300019380
642,Herenthoutsesteenweg 2,2022-07-21,13:00:00,37,36,1,ECO_300019380
642,Herenthoutsesteenweg 2,2022-07-21,14:00:00,75,69,6,ECO_300019380
642,Herenthoutsesteenweg 2,2022-07-21,15:00:00,49,37,12,ECO_300019380
642,Herenthoutsesteenweg 2,2022-07-21,16:00:00,138,131,7,ECO_300019380
642,Herenthoutsesteenweg 2,2022-07-21,17:00:00,43,32,11,ECO_300019380
642,Herenthoutsesteenweg 2,2022-07-21,18:00:00,85,83,2,ECO_300019380
642,Herenthoutsesteenweg 2,2022-07-21,19:00:00,44,35,9,ECO_300019380
642,Herenthoutsesteenweg 2,2022-07-21,20:00:00,50,42,8,ECO_300019380
642,Herenthoutsesteenweg 2,2022-07-21,21:00:00,34,32,2,ECO_300019380
642,Herenthoutsesteenweg 2,2022-07-21,22:00:00,28,21,7,ECO_300019380
642,Herenthoutsesteenweg 2,2022-07-21,23:00:00,19,16,3,ECO_300019380
642,Herenthoutsesteenweg 2,2022-07-22,00:00:00,16,15,1,ECO_300019380
642,Herenthoutsesteenweg 2,2022-07-22,01:00:00,8,6,2,ECO_300019380
642,Herenthoutsesteenweg 2,2022-07-22,02:00:00,6,3,3,ECO_300019380
642,Herenthoutsesteenweg 2,2022-07-22,03:00:00,5,4,1,ECO_300019380
642,Herenthoutsesteenweg 2,2022-07-22,04:00:00,0,0,0,ECO_300019380
642,Herenthoutsesteenweg 2,2022-07-22,05:00:00,0,0,0,ECO_300019380
642,Herenthoutsesteenweg 2,2022-07-22,06:00:00,2,0,2,ECO_300019380
642,Herenthoutsesteenweg 2,2022-07-22,07:00:00,7,5,2,ECO_300019380
642,Herenthoutsesteenweg 2,2022-07-22,08:00:00,18,16,2,ECO_300019380
642,Herenthoutsesteenweg 2,2022-07-22,09:00:00,32,31,1,ECO_300019380
642,Herenthoutsesteenweg 2,2022-07-22,10:00:00,76,76,0,ECO_300019380
642,Herenthoutsesteenweg 2,2022-07-22,11:00:00,160,157,3,ECO_300019380
642,Herenthoutsesteenweg 2,2022-07-22,12:00:00,184,179,5,ECO_300019380
642,Herenthoutsesteenweg 2,2022-07-22,13:00:00,113,100,13,ECO_300019380
642,Herenthoutsesteenweg 2,2022-07-22,14:00:00,90,87,3,ECO_300019380
642,Herenthoutsesteenweg 2,2022-07-22,15:00:00,161,137,24,ECO_300019380
642,Herenthoutsesteenweg 2,2022-07-22,16:00:00,216,204,12,ECO_300019380
642,Herenthoutsesteenweg 2,2022-07-22,17:00:00,174,159,15,ECO_300019380
642,Herenthoutsesteenweg 2,2022-07-22,18:00:00,109,101,8,ECO_300019380
642,Herenthoutsesteenweg 2,2022-07-22,19:00:00,108,94,14,ECO_300019380
642,Herenthoutsesteenweg 2,2022-07-22,20:00:00,72,68,4,ECO_300019380
642,Herenthoutsesteenweg 2,2022-07-22,21:00:00,50,40,10,ECO_300019380
642,Herenthoutsesteenweg 2,2022-07-22,22:00:00,40,35,5,ECO_300019380
642,Herenthoutsesteenweg 2,2022-07-22,23:00:00,24,17,7,ECO_300019380
642,Herenthoutsesteenweg 2,2022-07-23,00:00:00,18,16,2,ECO_300019380
642,Herenthoutsesteenweg 2,2022-07-23,01:00:00,8,3,5,ECO_300019380
642,Herenthoutsesteenweg 2,2022-07-23,02:00:00,5,3,2,ECO_300019380
642,Herenthoutsesteenweg 2,2022-07-23,03:00:00,6,6,0,ECO_300019380
642,Herenthoutsesteenweg 2,2022-07-23,04:00:00,11,9,2,ECO_300019380
642,Herenthoutsesteenweg 2,2022-07-23,05:00:00,0,0,0,ECO_300019380
642,Herenthoutsesteenweg 2,2022-07-23,06:00:00,1,1,0,ECO_300019380
642,Herenthoutsesteenweg 2,2022-07-23,07:00:00,9,6,3,ECO_300019380
642,Herenthoutsesteenweg 2,2022-07-23,08:00:00,7,7,0,ECO_300019380
642,Herenthoutsesteenweg 2,2022-07-23,09:00:00,24,22,2,ECO_300019380
642,Herenthoutsesteenweg 2,2022-07-23,10:00:00,46,41,5,ECO_300019380
642,Herenthoutsesteenweg 2,2022-07-23,11:00:00,100,92,8,ECO_300019380
642,Herenthoutsesteenweg 2,2022-07-23,12:00:00,109,102,7,ECO_300019380
642,Herenthoutsesteenweg 2,2022-07-23,13:00:00,121,111,10,ECO_300019380
642,Herenthoutsesteenweg 2,2022-07-23,14:00:00,181,167,14,ECO_300019380
642,Herenthoutsesteenweg 2,2022-07-23,15:00:00,189,179,10,ECO_300019380
642,Herenthoutsesteenweg 2,2022-07-23,16:00:00,205,185,20,ECO_300019380
642,Herenthoutsesteenweg 2,2022-07-23,17:00:00,163,147,16,ECO_300019380
642,Herenthoutsesteenweg 2,2022-07-23,18:00:00,127,116,11,ECO_300019380
642,Herenthoutsesteenweg 2,2022-07-23,19:00:00,96,80,16,ECO_300019380
642,Herenthoutsesteenweg 2,2022-07-23,20:00:00,92,74,18,ECO_300019380
642,Herenthoutsesteenweg 2,2022-07-23,21:00:00,65,52,13,ECO_300019380
642,Herenthoutsesteenweg 2,2022-07-23,22:00:00,71,66,5,ECO_300019380
642,Herenthoutsesteenweg 2,2022-07-23,23:00:00,28,27,1,ECO_300019380
642,Herenthoutsesteenweg 2,2022-07-24,00:00:00,40,27,13,ECO_300019380
642,Herenthoutsesteenweg 2,2022-07-24,01:00:00,36,33,3,ECO_300019380
642,Herenthoutsesteenweg 2,2022-07-24,02:00:00,8,7,1,ECO_300019380
642,Herenthoutsesteenweg 2,2022-07-24,03:00:00,9,8,1,ECO_300019380
642,Herenthoutsesteenweg 2,2022-07-24,04:00:00,13,11,2,ECO_300019380
642,Herenthoutsesteenweg 2,2022-07-24,05:00:00,5,2,3,ECO_300019380
642,Herenthoutsesteenweg 2,2022-07-24,06:00:00,2,2,0,ECO_300019380
642,Herenthoutsesteenweg 2,2022-07-24,07:00:00,3,3,0,ECO_300019380
642,Herenthoutsesteenweg 2,2022-07-24,08:00:00,17,13,4,ECO_300019380
642,Herenthoutsesteenweg 2,2022-07-24,09:00:00,31,27,4,ECO_300019380
642,Herenthoutsesteenweg 2,2022-07-24,10:00:00,69,65,4,ECO_300019380
642,Herenthoutsesteenweg 2,2022-07-24,11:00:00,158,152,6,ECO_300019380
642,Herenthoutsesteenweg 2,2022-07-24,12:00:00,182,171,11,ECO_300019380
642,Herenthoutsesteenweg 2,2022-07-24,13:00:00,185,168,17,ECO_300019380
642,Herenthoutsesteenweg 2,2022-07-24,14:00:00,131,116,15,ECO_300019380
642,Herenthoutsesteenweg 2,2022-07-24,15:00:00,145,134,11,ECO_300019380
642,Herenthoutsesteenweg 2,2022-07-24,16:00:00,174,160,14,ECO_300019380
642,Herenthoutsesteenweg 2,2022-07-24,17:00:00,102,81,21,ECO_300019380
642,Herenthoutsesteenweg 2,2022-07-24,18:00:00,111,100,11,ECO_300019380
642,Herenthoutsesteenweg 2,2022-07-24,19:00:00,96,82,14,ECO_300019380
642,Herenthoutsesteenweg 2,2022-07-24,20:00:00,69,56,13,ECO_300019380
642,Herenthoutsesteenweg 2,2022-07-24,21:00:00,50,47,3,ECO_300019380
642,Herenthoutsesteenweg 2,2022-07-24,22:00:00,46,40,6,ECO_300019380
642,Herenthoutsesteenweg 2,2022-07-24,23:00:00,82,62,20,ECO_300019380
642,Herenthoutsesteenweg 2,2022-07-25,00:00:00,32,25,7,ECO_300019380
642,Herenthoutsesteenweg 2,2022-07-25,01:00:00,4,3,1,ECO_300019380
642,Herenthoutsesteenweg 2,2022-07-25,02:00:00,6,3,3,ECO_300019380
642,Herenthoutsesteenweg 2,2022-07-25,03:00:00,9,8,1,ECO_300019380
642,Herenthoutsesteenweg 2,2022-07-25,04:00:00,5,5,0,ECO_300019380
642,Herenthoutsesteenweg 2,2022-07-25,05:00:00,2,2,0,ECO_300019380
642,Herenthoutsesteenweg 2,2022-07-25,06:00:00,3,3,0,ECO_300019380
642,Herenthoutsesteenweg 2,2022-07-25,07:00:00,23,20,3,ECO_300019380
642,Herenthoutsesteenweg 2,2022-07-25,08:00:00,45,39,6,ECO_300019380
642,Herenthoutsesteenweg 2,2022-07-25,09:00:00,80,76,4,ECO_300019380
642,Herenthoutsesteenweg 2,2022-07-25,10:00:00,82,80,2,ECO_300019380
642,Herenthoutsesteenweg 2,2022-07-25,11:00:00,80,74,6,ECO_300019380
642,Herenthoutsesteenweg 2,2022-07-25,12:00:00,105,103,2,ECO_300019380
642,Herenthoutsesteenweg 2,2022-07-25,13:00:00,82,78,4,ECO_300019380
642,Herenthoutsesteenweg 2,2022-07-25,14:00:00,100,93,7,ECO_300019380
642,Herenthoutsesteenweg 2,2022-07-25,15:00:00,124,121,3,ECO_300019380
642,Herenthoutsesteenweg 2,2022-07-25,16:00:00,135,121,14,ECO_300019380
642,Herenthoutsesteenweg 2,2022-07-25,17:00:00,116,111,5,ECO_300019380
642,Herenthoutsesteenweg 2,2022-07-25,18:00:00,110,98,12,ECO_300019380
642,Herenthoutsesteenweg 2,2022-07-25,19:00:00,94,77,17,ECO_300019380
642,Herenthoutsesteenweg 2,2022-07-25,20:00:00,63,57,6,ECO_300019380
642,Herenthoutsesteenweg 2,2022-07-25,21:00:00,60,46,14,ECO_300019380
642,Herenthoutsesteenweg 2,2022-07-25,22:00:00,34,31,3,ECO_300019380
642,Herenthoutsesteenweg 2,2022-07-25,23:00:00,36,31,5,ECO_300019380
642,Herenthoutsesteenweg 2,2022-07-26,00:00:00,22,21,1,ECO_300019380
642,Herenthoutsesteenweg 2,2022-07-26,01:00:00,2,1,1,ECO_300019380
642,Herenthoutsesteenweg 2,2022-07-26,02:00:00,3,2,1,ECO_300019380
642,Herenthoutsesteenweg 2,2022-07-26,03:00:00,3,1,2,ECO_300019380
642,Herenthoutsesteenweg 2,2022-07-26,04:00:00,1,1,0,ECO_300019380
642,Herenthoutsesteenweg 2,2022-07-26,05:00:00,0,0,0,ECO_300019380
642,Herenthoutsesteenweg 2,2022-07-26,06:00:00,1,1,0,ECO_300019380
642,Herenthoutsesteenweg 2,2022-07-26,07:00:00,12,9,3,ECO_300019380
642,Herenthoutsesteenweg 2,2022-07-26,08:00:00,38,32,6,ECO_300019380
642,Herenthoutsesteenweg 2,2022-07-26,09:00:00,76,70,6,ECO_300019380
642,Herenthoutsesteenweg 2,2022-07-26,10:00:00,72,70,2,ECO_300019380
642,Herenthoutsesteenweg 2,2022-07-26,11:00:00,106,99,7,ECO_300019380
642,Herenthoutsesteenweg 2,2022-07-26,12:00:00,90,85,5,ECO_300019380
642,Herenthoutsesteenweg 2,2022-07-26,13:00:00,64,62,2,ECO_300019380
642,Herenthoutsesteenweg 2,2022-07-26,14:00:00,72,65,7,ECO_300019380
642,Herenthoutsesteenweg 2,2022-07-26,15:00:00,102,100,2,ECO_300019380
642,Herenthoutsesteenweg 2,2022-07-26,16:00:00,110,101,9,ECO_300019380
642,Herenthoutsesteenweg 2,2022-07-26,17:00:00,72,55,17,ECO_300019380
642,Herenthoutsesteenweg 2,2022-07-26,18:00:00,95,86,9,ECO_300019380
642,Herenthoutsesteenweg 2,2022-07-26,19:00:00,90,87,3,ECO_300019380
642,Herenthoutsesteenweg 2,2022-07-26,20:00:00,59,52,7,ECO_300019380
642,Herenthoutsesteenweg 2,2022-07-26,21:00:00,50,39,11,ECO_300019380
642,Herenthoutsesteenweg 2,2022-07-26,22:00:00,31,30,1,ECO_300019380
642,Herenthoutsesteenweg 2,2022-07-26,23:00:00,27,24,3,ECO_300019380
642,Herenthoutsesteenweg 2,2022-07-27,00:00:00,20,18,2,ECO_300019380
642,Herenthoutsesteenweg 2,2022-07-27,01:00:00,9,8,1,ECO_300019380
642,Herenthoutsesteenweg 2,2022-07-27,02:00:00,4,2,2,ECO_300019380
642,Herenthoutsesteenweg 2,2022-07-27,03:00:00,2,2,0,ECO_300019380
642,Herenthoutsesteenweg 2,2022-07-27,04:00:00,1,1,0,ECO_300019380
642,Herenthoutsesteenweg 2,2022-07-27,05:00:00,6,4,2,ECO_300019380
642,Herenthoutsesteenweg 2,2022-07-27,06:00:00,8,8,0,ECO_300019380
642,Herenthoutsesteenweg 2,2022-07-27,07:00:00,16,14,2,ECO_300019380
642,Herenthoutsesteenweg 2,2022-07-27,08:00:00,27,22,5,ECO_300019380
642,Herenthoutsesteenweg 2,2022-07-27,09:00:00,61,55,6,ECO_300019380
642,Herenthoutsesteenweg 2,2022-07-27,10:00:00,103,100,3,ECO_300019380
642,Herenthoutsesteenweg 2,2022-07-27,11:00:00,115,107,8,ECO_300019380
642,Herenthoutsesteenweg 2,2022-07-27,12:00:00,125,122,3,ECO_300019380
642,Herenthoutsesteenweg 2,2022-07-27,13:00:00,106,104,2,ECO_300019380
642,Herenthoutsesteenweg 2,2022-07-27,14:00:00,114,107,7,ECO_300019380
642,Herenthoutsesteenweg 2,2022-07-27,15:00:00,139,133,6,ECO_300019380
642,Herenthoutsesteenweg 2,2022-07-27,16:00:00,229,220,9,ECO_300019380
642,Herenthoutsesteenweg 2,2022-07-27,17:00:00,138,127,11,ECO_300019380
642,Herenthoutsesteenweg 2,2022-07-27,18:00:00,147,139,8,ECO_300019380
642,Herenthoutsesteenweg 2,2022-07-27,19:00:00,154,134,20,ECO_300019380
642,Herenthoutsesteenweg 2,2022-07-27,20:00:00,112,98,14,ECO_300019380
642,Herenthoutsesteenweg 2,2022-07-27,21:00:00,82,77,5,ECO_300019380
642,Herenthoutsesteenweg 2,2022-07-27,22:00:00,74,65,9,ECO_300019380
642,Herenthoutsesteenweg 2,2022-07-27,23:00:00,30,25,5,ECO_300019380
642,Herenthoutsesteenweg 2,2022-07-28,00:00:00,26,20,6,ECO_300019380
642,Herenthoutsesteenweg 2,2022-07-28,01:00:00,13,11,2,ECO_300019380
642,Herenthoutsesteenweg 2,2022-07-28,02:00:00,5,4,1,ECO_300019380
642,Herenthoutsesteenweg 2,2022-07-28,03:00:00,0,0,0,ECO_300019380
642,Herenthoutsesteenweg 2,2022-07-28,04:00:00,3,0,3,ECO_300019380
642,Herenthoutsesteenweg 2,2022-07-28,05:00:00,0,0,0,ECO_300019380
642,Herenthoutsesteenweg 2,2022-07-28,06:00:00,1,1,0,ECO_300019380
642,Herenthoutsesteenweg 2,2022-07-28,07:00:00,22,19,3,ECO_300019380
642,Herenthoutsesteenweg 2,2022-07-28,08:00:00,42,35,7,ECO_300019380
642,Herenthoutsesteenweg 2,2022-07-28,09:00:00,72,70,2,ECO_300019380
642,Herenthoutsesteenweg 2,2022-07-28,10:00:00,95,93,2,ECO_300019380
642,Herenthoutsesteenweg 2,2022-07-28,11:00:00,99,95,4,ECO_300019380
642,Herenthoutsesteenweg 2,2022-07-28,12:00:00,100,96,4,ECO_300019380
642,Herenthoutsesteenweg 2,2022-07-28,13:00:00,132,126,6,ECO_300019380
642,Herenthoutsesteenweg 2,2022-07-28,14:00:00,115,100,15,ECO_300019380
642,Herenthoutsesteenweg 2,2022-07-28,15:00:00,201,190,11,ECO_300019380
642,Herenthoutsesteenweg 2,2022-07-28,16:00:00,212,194,18,ECO_300019380
642,Herenthoutsesteenweg 2,2022-07-28,17:00:00,210,186,24,ECO_300019380
642,Herenthoutsesteenweg 2,2022-07-28,18:00:00,258,240,18,ECO_300019380
642,Herenthoutsesteenweg 2,2022-07-28,19:00:00,336,304,32,ECO_300019380
642,Herenthoutsesteenweg 2,2022-07-28,20:00:00,705,692,13,ECO_300019380
642,Herenthoutsesteenweg 2,2022-07-28,21:00:00,478,464,14,ECO_300019380
642,Herenthoutsesteenweg 2,2022-07-28,22:00:00,180,168,12,ECO_300019380
642,Herenthoutsesteenweg 2,2022-07-28,23:00:00,108,88,20,ECO_300019380
642,Herenthoutsesteenweg 2,2022-07-29,00:00:00,72,40,32,ECO_300019380
642,Herenthoutsesteenweg 2,2022-07-29,01:00:00,37,21,16,ECO_300019380
642,Herenthoutsesteenweg 2,2022-07-29,02:00:00,12,9,3,ECO_300019380
642,Herenthoutsesteenweg 2,2022-07-29,03:00:00,5,1,4,ECO_300019380
642,Herenthoutsesteenweg 2,2022-07-29,04:00:00,7,2,5,ECO_300019380
642,Herenthoutsesteenweg 2,2022-07-29,05:00:00,10,1,9,ECO_300019380
642,Herenthoutsesteenweg 2,2022-07-29,06:00:00,5,3,2,ECO_300019380
642,Herenthoutsesteenweg 2,2022-07-29,07:00:00,17,15,2,ECO_300019380
642,Herenthoutsesteenweg 2,2022-07-29,08:00:00,31,25,6,ECO_300019380
642,Herenthoutsesteenweg 2,2022-07-29,09:00:00,68,63,5,ECO_300019380
642,Herenthoutsesteenweg 2,2022-07-29,10:00:00,91,87,4,ECO_300019380
642,Herenthoutsesteenweg 2,2022-07-29,11:00:00,148,145,3,ECO_300019380
642,Herenthoutsesteenweg 2,2022-07-29,12:00:00,160,158,2,ECO_300019380
642,Herenthoutsesteenweg 2,2022-07-29,13:00:00,151,142,9,ECO_300019380
642,Herenthoutsesteenweg 2,2022-07-29,14:00:00,135,124,11,ECO_300019380
642,Herenthoutsesteenweg 2,2022-07-29,15:00:00,208,196,12,ECO_300019380
642,Herenthoutsesteenweg 2,2022-07-29,16:00:00,254,238,16,ECO_300019380
642,Herenthoutsesteenweg 2,2022-07-29,17:00:00,210,196,14,ECO_300019380
642,Herenthoutsesteenweg 2,2022-07-29,18:00:00,260,243,17,ECO_300019380
642,Herenthoutsesteenweg 2,2022-07-29,19:00:00,167,159,8,ECO_300019380
642,Herenthoutsesteenweg 2,2022-07-29,20:00:00,153,137,16,ECO_300019380
642,Herenthoutsesteenweg 2,2022-07-29,21:00:00,197,185,12,ECO_300019380
642,Herenthoutsesteenweg 2,2022-07-29,22:00:00,182,169,13,ECO_300019380
642,Herenthoutsesteenweg 2,2022-07-29,23:00:00,199,191,8,ECO_300019380
642,Herenthoutsesteenweg 2,2022-07-30,00:00:00,109,107,2,ECO_300019380
642,Herenthoutsesteenweg 2,2022-07-30,01:00:00,47,38,9,ECO_300019380
642,Herenthoutsesteenweg 2,2022-07-30,02:00:00,9,6,3,ECO_300019380
642,Herenthoutsesteenweg 2,2022-07-30,03:00:00,8,4,4,ECO_300019380
642,Herenthoutsesteenweg 2,2022-07-30,04:00:00,6,0,6,ECO_300019380
642,Herenthoutsesteenweg 2,2022-07-30,05:00:00,12,0,12,ECO_300019380
642,Herenthoutsesteenweg 2,2022-07-30,06:00:00,10,1,9,ECO_300019380
642,Herenthoutsesteenweg 2,2022-07-30,07:00:00,10,7,3,ECO_300019380
642,Herenthoutsesteenweg 2,2022-07-30,08:00:00,14,14,0,ECO_300019380
642,Herenthoutsesteenweg 2,2022-07-30,09:00:00,15,11,4,ECO_300019380
642,Herenthoutsesteenweg 2,2022-07-30,10:00:00,45,41,4,ECO_300019380
642,Herenthoutsesteenweg 2,2022-07-30,11:00:00,95,89,6,ECO_300019380
642,Herenthoutsesteenweg 2,2022-07-30,12:00:00,141,135,6,ECO_300019380
642,Herenthoutsesteenweg 2,2022-07-30,13:00:00,153,145,8,ECO_300019380
642,Herenthoutsesteenweg 2,2022-07-30,14:00:00,152,142,10,ECO_300019380
642,Herenthoutsesteenweg 2,2022-07-30,15:00:00,183,170,13,ECO_300019380
642,Herenthoutsesteenweg 2,2022-07-30,16:00:00,166,159,7,ECO_300019380
642,Herenthoutsesteenweg 2,2022-07-30,17:00:00,184,162,22,ECO_300019380
642,Herenthoutsesteenweg 2,2022-07-30,18:00:00,140,118,22,ECO_300019380
642,Herenthoutsesteenweg 2,2022-07-30,19:00:00,110,105,5,ECO_300019380
642,Herenthoutsesteenweg 2,2022-07-30,20:00:00,77,65,12,ECO_300019380
642,Herenthoutsesteenweg 2,2022-07-30,21:00:00,62,53,9,ECO_300019380
642,Herenthoutsesteenweg 2,2022-07-30,22:00:00,44,35,9,ECO_300019380
642,Herenthoutsesteenweg 2,2022-07-30,23:00:00,48,39,9,ECO_300019380
642,Herenthoutsesteenweg 2,2022-07-31,00:00:00,25,16,9,ECO_300019380
642,Herenthoutsesteenweg 2,2022-07-31,01:00:00,8,6,2,ECO_300019380
642,Herenthoutsesteenweg 2,2022-07-31,02:00:00,10,10,0,ECO_300019380
642,Herenthoutsesteenweg 2,2022-07-31,03:00:00,2,2,0,ECO_300019380
642,Herenthoutsesteenweg 2,2022-07-31,04:00:00,0,0,0,ECO_300019380
642,Herenthoutsesteenweg 2,2022-07-31,05:00:00,9,7,2,ECO_300019380
642,Herenthoutsesteenweg 2,2022-07-31,06:00:00,7,5,2,ECO_300019380
642,Herenthoutsesteenweg 2,2022-07-31,07:00:00,4,4,0,ECO_300019380
642,Herenthoutsesteenweg 2,2022-07-31,08:00:00,11,11,0,ECO_300019380
642,Herenthoutsesteenweg 2,2022-07-31,09:00:00,16,15,1,ECO_300019380
642,Herenthoutsesteenweg 2,2022-07-31,10:00:00,101,95,6,ECO_300019380
642,Herenthoutsesteenweg 2,2022-07-31,11:00:00,144,129,15,ECO_300019380
642,Herenthoutsesteenweg 2,2022-07-31,12:00:00,210,196,14,ECO_300019380
642,Herenthoutsesteenweg 2,2022-07-31,13:00:00,145,135,10,ECO_300019380
642,Herenthoutsesteenweg 2,2022-07-31,14:00:00,172,152,20,ECO_300019380
642,Herenthoutsesteenweg 2,2022-07-31,15:00:00,185,172,13,ECO_300019380
642,Herenthoutsesteenweg 2,2022-07-31,16:00:00,148,139,9,ECO_300019380
642,Herenthoutsesteenweg 2,2022-07-31,17:00:00,123,116,7,ECO_300019380
642,Herenthoutsesteenweg 2,2022-07-31,18:00:00,99,81,18,ECO_300019380
642,Herenthoutsesteenweg 2,2022-07-31,19:00:00,102,75,27,ECO_300019380
642,Herenthoutsesteenweg 2,2022-07-31,20:00:00,56,50,6,ECO_300019380
642,Herenthoutsesteenweg 2,2022-07-31,21:00:00,59,55,4,ECO_300019380
642,Herenthoutsesteenweg 2,2022-07-31,22:00:00,22,18,4,ECO_300019380
642,Herenthoutsesteenweg 2,2022-07-31,23:00:00,19,14,5,ECO_300019380
642,Herenthoutsesteenweg 2,2022-08-01,00:00:00,16,16,0,ECO_300019380
642,Herenthoutsesteenweg 2,2022-08-01,01:00:00,7,5,2,ECO_300019380
642,Herenthoutsesteenweg 2,2022-08-01,02:00:00,6,6,0,ECO_300019380
642,Herenthoutsesteenweg 2,2022-08-01,03:00:00,3,3,0,ECO_300019380
642,Herenthoutsesteenweg 2,2022-08-01,04:00:00,0,0,0,ECO_300019380
642,Herenthoutsesteenweg 2,2022-08-01,05:00:00,0,0,0,ECO_300019380
642,Herenthoutsesteenweg 2,2022-08-01,06:00:00,2,2,0,ECO_300019380
642,Herenthoutsesteenweg 2,2022-08-01,07:00:00,15,12,3,ECO_300019380
642,Herenthoutsesteenweg 2,2022-08-01,08:00:00,40,35,5,ECO_300019380
642,Herenthoutsesteenweg 2,2022-08-01,09:00:00,103,97,6,ECO_300019380
642,Herenthoutsesteenweg 2,2022-08-01,10:00:00,78,74,4,ECO_300019380
642,Herenthoutsesteenweg 2,2022-08-01,11:00:00,70,65,5,ECO_300019380
642,Herenthoutsesteenweg 2,2022-08-01,12:00:00,81,80,1,ECO_300019380
642,Herenthoutsesteenweg 2,2022-08-01,13:00:00,97,96,1,ECO_300019380
642,Herenthoutsesteenweg 2,2022-08-01,14:00:00,83,74,9,ECO_300019380
642,Herenthoutsesteenweg 2,2022-08-01,15:00:00,165,156,9,ECO_300019380
642,Herenthoutsesteenweg 2,2022-08-01,16:00:00,186,178,8,ECO_300019380
642,Herenthoutsesteenweg 2,2022-08-01,17:00:00,117,110,7,ECO_300019380
642,Herenthoutsesteenweg 2,2022-08-01,18:00:00,209,182,27,ECO_300019380
642,Herenthoutsesteenweg 2,2022-08-01,19:00:00,119,106,13,ECO_300019380
642,Herenthoutsesteenweg 2,2022-08-01,20:00:00,86,77,9,ECO_300019380
642,Herenthoutsesteenweg 2,2022-08-01,21:00:00,68,57,11,ECO_300019380
642,Herenthoutsesteenweg 2,2022-08-01,22:00:00,44,40,4,ECO_300019380
642,Herenthoutsesteenweg 2,2022-08-01,23:00:00,50,46,4,ECO_300019380
642,Herenthoutsesteenweg 2,2022-08-02,00:00:00,25,19,6,ECO_300019380
642,Herenthoutsesteenweg 2,2022-08-02,01:00:00,10,7,3,ECO_300019380
642,Herenthoutsesteenweg 2,2022-08-02,02:00:00,1,1,0,ECO_300019380
642,Herenthoutsesteenweg 2,2022-08-02,03:00:00,2,1,1,ECO_300019380
642,Herenthoutsesteenweg 2,2022-08-02,04:00:00,0,0,0,ECO_300019380
642,Herenthoutsesteenweg 2,2022-08-02,05:00:00,0,0,0,ECO_300019380
642,Herenthoutsesteenweg 2,2022-08-02,06:00:00,8,6,2,ECO_300019380
642,Herenthoutsesteenweg 2,2022-08-02,07:00:00,25,19,6,ECO_300019380
642,Herenthoutsesteenweg 2,2022-08-02,08:00:00,54,49,5,ECO_300019380
642,Herenthoutsesteenweg 2,2022-08-02,09:00:00,110,103,7,ECO_300019380
642,Herenthoutsesteenweg 2,2022-08-02,10:00:00,111,108,3,ECO_300019380
642,Herenthoutsesteenweg 2,2022-08-02,11:00:00,116,104,12,ECO_300019380
642,Herenthoutsesteenweg 2,2022-08-02,12:00:00,112,107,5,ECO_300019380
642,Herenthoutsesteenweg 2,2022-08-02,13:00:00,115,107,8,ECO_300019380
642,Herenthoutsesteenweg 2,2022-08-02,14:00:00,111,100,11,ECO_300019380
642,Herenthoutsesteenweg 2,2022-08-02,15:00:00,170,164,6,ECO_300019380
642,Herenthoutsesteenweg 2,2022-08-02,16:00:00,197,187,10,ECO_300019380
642,Herenthoutsesteenweg 2,2022-08-02,17:00:00,155,147,8,ECO_300019380
642,Herenthoutsesteenweg 2,2022-08-02,18:00:00,194,180,14,ECO_300019380
642,Herenthoutsesteenweg 2,2022-08-02,19:00:00,175,157,18,ECO_300019380
642,Herenthoutsesteenweg 2,2022-08-02,20:00:00,119,103,16,ECO_300019380
642,Herenthoutsesteenweg 2,2022-08-02,21:00:00,109,95,14,ECO_300019380
642,Herenthoutsesteenweg 2,2022-08-02,22:00:00,43,37,6,ECO_300019380
642,Herenthoutsesteenweg 2,2022-08-02,23:00:00,35,30,5,ECO_300019380
642,Herenthoutsesteenweg 2,2022-08-03,00:00:00,28,23,5,ECO_300019380
642,Herenthoutsesteenweg 2,2022-08-03,01:00:00,9,7,2,ECO_300019380
642,Herenthoutsesteenweg 2,2022-08-03,02:00:00,7,6,1,ECO_300019380
642,Herenthoutsesteenweg 2,2022-08-03,03:00:00,2,2,0,ECO_300019380
642,Herenthoutsesteenweg 2,2022-08-03,04:00:00,0,0,0,ECO_300019380
642,Herenthoutsesteenweg 2,2022-08-03,05:00:00,1,1,0,ECO_300019380
642,Herenthoutsesteenweg 2,2022-08-03,06:00:00,6,4,2,ECO_300019380
642,Herenthoutsesteenweg 2,2022-08-03,07:00:00,24,19,5,ECO_300019380
642,Herenthoutsesteenweg 2,2022-08-03,08:00:00,52,45,7,ECO_300019380
642,Herenthoutsesteenweg 2,2022-08-03,09:00:00,85,81,4,ECO_300019380
642,Herenthoutsesteenweg 2,2022-08-03,10:00:00,120,112,8,ECO_300019380
642,Herenthoutsesteenweg 2,2022-08-03,11:00:00,125,120,5,ECO_300019380
642,Herenthoutsesteenweg 2,2022-08-03,12:00:00,143,136,7,ECO_300019380
642,Herenthoutsesteenweg 2,2022-08-03,13:00:00,120,116,4,ECO_300019380
642,Herenthoutsesteenweg 2,2022-08-03,14:00:00,104,101,3,ECO_300019380
642,Herenthoutsesteenweg 2,2022-08-03,15:00:00,104,92,12,ECO_300019380
642,Herenthoutsesteenweg 2,2022-08-03,16:00:00,129,119,10,ECO_300019380
642,Herenthoutsesteenweg 2,2022-08-03,17:00:00,95,85,10,ECO_300019380
642,Herenthoutsesteenweg 2,2022-08-03,18:00:00,153,140,13,ECO_300019380
642,Herenthoutsesteenweg 2,2022-08-03,19:00:00,112,102,10,ECO_300019380
642,Herenthoutsesteenweg 2,2022-08-03,20:00:00,114,102,12,ECO_300019380
642,Herenthoutsesteenweg 2,2022-08-03,21:00:00,132,117,15,ECO_300019380
642,Herenthoutsesteenweg 2,2022-08-03,22:00:00,66,53,13,ECO_300019380
642,Herenthoutsesteenweg 2,2022-08-03,23:00:00,64,61,3,ECO_300019380
642,Herenthoutsesteenweg 2,2022-08-04,00:00:00,43,32,11,ECO_300019380
642,Herenthoutsesteenweg 2,2022-08-04,01:00:00,11,7,4,ECO_300019380
642,Herenthoutsesteenweg 2,2022-08-04,02:00:00,8,3,5,ECO_300019380
642,Herenthoutsesteenweg 2,2022-08-04,03:00:00,5,4,1,ECO_300019380
642,Herenthoutsesteenweg 2,2022-08-04,04:00:00,0,0,0,ECO_300019380
642,Herenthoutsesteenweg 2,2022-08-04,05:00:00,0,0,0,ECO_300019380
642,Herenthoutsesteenweg 2,2022-08-04,06:00:00,5,3,2,ECO_300019380
642,Herenthoutsesteenweg 2,2022-08-04,07:00:00,23,19,4,ECO_300019380
642,Herenthoutsesteenweg 2,2022-08-04,08:00:00,58,50,8,ECO_300019380
642,Herenthoutsesteenweg 2,2022-08-04,09:00:00,106,100,6,ECO_300019380
642,Herenthoutsesteenweg 2,2022-08-04,10:00:00,114,109,5,ECO_300019380
642,Herenthoutsesteenweg 2,2022-08-04,11:00:00,111,107,4,ECO_300019380
642,Herenthoutsesteenweg 2,2022-08-04,12:00:00,116,109,7,ECO_300019380
642,Herenthoutsesteenweg 2,2022-08-04,13:00:00,67,65,2,ECO_300019380
642,Herenthoutsesteenweg 2,2022-08-04,14:00:00,72,66,6,ECO_300019380
642,Herenthoutsesteenweg 2,2022-08-04,15:00:00,102,94,8,ECO_300019380
642,Herenthoutsesteenweg 2,2022-08-04,16:00:00,174,158,16,ECO_300019380
642,Herenthoutsesteenweg 2,2022-08-04,17:00:00,135,122,13,ECO_300019380
642,Herenthoutsesteenweg 2,2022-08-04,18:00:00,150,132,18,ECO_300019380
642,Herenthoutsesteenweg 2,2022-08-04,19:00:00,123,103,20,ECO_300019380
642,Herenthoutsesteenweg 2,2022-08-04,20:00:00,107,98,9,ECO_300019380
642,Herenthoutsesteenweg 2,2022-08-04,21:00:00,98,86,12,ECO_300019380
642,Herenthoutsesteenweg 2,2022-08-04,22:00:00,61,55,6,ECO_300019380
642,Herenthoutsesteenweg 2,2022-08-04,23:00:00,42,32,10,ECO_300019380
642,Herenthoutsesteenweg 2,2022-08-05,00:00:00,25,18,7,ECO_300019380
642,Herenthoutsesteenweg 2,2022-08-05,01:00:00,22,15,7,ECO_300019380
642,Herenthoutsesteenweg 2,2022-08-05,02:00:00,5,3,2,ECO_300019380
642,Herenthoutsesteenweg 2,2022-08-05,03:00:00,0,0,0,ECO_300019380
642,Herenthoutsesteenweg 2,2022-08-05,04:00:00,0,0,0,ECO_300019380
642,Herenthoutsesteenweg 2,2022-08-05,05:00:00,0,0,0,ECO_300019380
642,Herenthoutsesteenweg 2,2022-08-05,06:00:00,4,3,1,ECO_300019380
642,Herenthoutsesteenweg 2,2022-08-05,07:00:00,28,25,3,ECO_300019380
642,Herenthoutsesteenweg 2,2022-08-05,08:00:00,38,33,5,ECO_300019380
642,Herenthoutsesteenweg 2,2022-08-05,09:00:00,77,72,5,ECO_300019380
642,Herenthoutsesteenweg 2,2022-08-05,10:00:00,97,95,2,ECO_300019380
642,Herenthoutsesteenweg 2,2022-08-05,11:00:00,152,151,1,ECO_300019380
642,Herenthoutsesteenweg 2,2022-08-05,12:00:00,171,166,5,ECO_300019380
642,Herenthoutsesteenweg 2,2022-08-05,13:00:00,115,105,10,ECO_300019380
642,Herenthoutsesteenweg 2,2022-08-05,14:00:00,101,83,18,ECO_300019380
642,Herenthoutsesteenweg 2,2022-08-05,15:00:00,175,168,7,ECO_300019380
642,Herenthoutsesteenweg 2,2022-08-05,16:00:00,165,150,15,ECO_300019380
642,Herenthoutsesteenweg 2,2022-08-05,17:00:00,143,132,11,ECO_300019380
642,Herenthoutsesteenweg 2,2022-08-05,18:00:00,156,142,14,ECO_300019380
642,Herenthoutsesteenweg 2,2022-08-05,19:00:00,112,94,18,ECO_300019380
642,Herenthoutsesteenweg 2,2022-08-05,20:00:00,83,69,14,ECO_300019380
642,Herenthoutsesteenweg 2,2022-08-05,21:00:00,42,38,4,ECO_300019380
642,Herenthoutsesteenweg 2,2022-08-05,22:00:00,77,64,13,ECO_300019380
642,Herenthoutsesteenweg 2,2022-08-05,23:00:00,35,34,1,ECO_300019380
642,Herenthoutsesteenweg 2,2022-08-06,00:00:00,28,20,8,ECO_300019380
642,Herenthoutsesteenweg 2,2022-08-06,01:00:00,21,18,3,ECO_300019380
642,Herenthoutsesteenweg 2,2022-08-06,02:00:00,9,8,1,ECO_300019380
642,Herenthoutsesteenweg 2,2022-08-06,03:00:00,18,6,12,ECO_300019380
642,Herenthoutsesteenweg 2,2022-08-06,04:00:00,7,5,2,ECO_300019380
642,Herenthoutsesteenweg 2,2022-08-06,05:00:00,4,4,0,ECO_300019380
642,Herenthoutsesteenweg 2,2022-08-06,06:00:00,0,0,0,ECO_300019380
642,Herenthoutsesteenweg 2,2022-08-06,07:00:00,8,8,0,ECO_300019380
642,Herenthoutsesteenweg 2,2022-08-06,08:00:00,12,11,1,ECO_300019380
642,Herenthoutsesteenweg 2,2022-08-06,09:00:00,21,19,2,ECO_300019380
642,Herenthoutsesteenweg 2,2022-08-06,10:00:00,51,49,2,ECO_300019380
642,Herenthoutsesteenweg 2,2022-08-06,11:00:00,107,105,2,ECO_300019380
642,Herenthoutsesteenweg 2,2022-08-06,12:00:00,158,151,7,ECO_300019380
642,Herenthoutsesteenweg 2,2022-08-06,13:00:00,143,142,1,ECO_300019380
642,Herenthoutsesteenweg 2,2022-08-06,14:00:00,143,132,11,ECO_300019380
642,Herenthoutsesteenweg 2,2022-08-06,15:00:00,231,217,14,ECO_300019380
642,Herenthoutsesteenweg 2,2022-08-06,16:00:00,209,184,25,ECO_300019380
642,Herenthoutsesteenweg 2,2022-08-06,17:00:00,171,145,26,ECO_300019380
642,Herenthoutsesteenweg 2,2022-08-06,18:00:00,129,111,18,ECO_300019380
642,Herenthoutsesteenweg 2,2022-08-06,19:00:00,92,83,9,ECO_300019380
642,Herenthoutsesteenweg 2,2022-08-06,20:00:00,65,50,15,ECO_300019380
642,Herenthoutsesteenweg 2,2022-08-06,21:00:00,50,41,9,ECO_300019380
642,Herenthoutsesteenweg 2,2022-08-06,22:00:00,52,38,14,ECO_300019380
642,Herenthoutsesteenweg 2,2022-08-06,23:00:00,61,47,14,ECO_300019380
642,Herenthoutsesteenweg 2,2022-08-07,00:00:00,25,23,2,ECO_300019380
642,Herenthoutsesteenweg 2,2022-08-07,01:00:00,30,23,7,ECO_300019380
642,Herenthoutsesteenweg 2,2022-08-07,02:00:00,16,15,1,ECO_300019380
642,Herenthoutsesteenweg 2,2022-08-07,03:00:00,10,10,0,ECO_300019380
642,Herenthoutsesteenweg 2,2022-08-07,04:00:00,7,6,1,ECO_300019380
642,Herenthoutsesteenweg 2,2022-08-07,05:00:00,20,18,2,ECO_300019380
642,Herenthoutsesteenweg 2,2022-08-07,06:00:00,8,8,0,ECO_300019380
642,Herenthoutsesteenweg 2,2022-08-07,07:00:00,3,1,2,ECO_300019380
642,Herenthoutsesteenweg 2,2022-08-07,08:00:00,11,11,0,ECO_300019380
642,Herenthoutsesteenweg 2,2022-08-07,09:00:00,28,26,2,ECO_300019380
642,Herenthoutsesteenweg 2,2022-08-07,10:00:00,79,73,6,ECO_300019380
642,Herenthoutsesteenweg 2,2022-08-07,11:00:00,162,159,3,ECO_300019380
642,Herenthoutsesteenweg 2,2022-08-07,12:00:00,177,152,25,ECO_300019380
642,Herenthoutsesteenweg 2,2022-08-07,13:00:00,120,108,12,ECO_300019380
642,Herenthoutsesteenweg 2,2022-08-07,14:00:00,128,121,7,ECO_300019380
642,Herenthoutsesteenweg 2,2022-08-07,15:00:00,190,171,19,ECO_300019380
642,Herenthoutsesteenweg 2,2022-08-07,16:00:00,193,180,13,ECO_300019380
642,Herenthoutsesteenweg 2,2022-08-07,17:00:00,148,136,12,ECO_300019380
642,Herenthoutsesteenweg 2,2022-08-07,18:00:00,133,115,18,ECO_300019380
642,Herenthoutsesteenweg 2,2022-08-07,19:00:00,104,82,22,ECO_300019380
642,Herenthoutsesteenweg 2,2022-08-07,20:00:00,96,71,25,ECO_300019380
642,Herenthoutsesteenweg 2,2022-08-07,21:00:00,64,51,13,ECO_300019380
642,Herenthoutsesteenweg 2,2022-08-07,22:00:00,47,43,4,ECO_300019380
642,Herenthoutsesteenweg 2,2022-08-07,23:00:00,34,25,9,ECO_300019380
642,Herenthoutsesteenweg 2,2022-08-08,00:00:00,17,16,1,ECO_300019380
642,Herenthoutsesteenweg 2,2022-08-08,01:00:00,10,8,2,ECO_300019380
642,Herenthoutsesteenweg 2,2022-08-08,02:00:00,3,2,1,ECO_300019380
642,Herenthoutsesteenweg 2,2022-08-08,03:00:00,2,2,0,ECO_300019380
642,Herenthoutsesteenweg 2,2022-08-08,04:00:00,0,0,0,ECO_300019380
642,Herenthoutsesteenweg 2,2022-08-08,05:00:00,1,1,0,ECO_300019380
642,Herenthoutsesteenweg 2,2022-08-08,06:00:00,4,2,2,ECO_300019380
642,Herenthoutsesteenweg 2,2022-08-08,07:00:00,27,25,2,ECO_300019380
642,Herenthoutsesteenweg 2,2022-08-08,08:00:00,48,42,6,ECO_300019380
642,Herenthoutsesteenweg 2,2022-08-08,09:00:00,99,93,6,ECO_300019380
642,Herenthoutsesteenweg 2,2022-08-08,10:00:00,129,126,3,ECO_300019380
642,Herenthoutsesteenweg 2,2022-08-08,11:00:00,102,97,5,ECO_300019380
642,Herenthoutsesteenweg 2,2022-08-08,12:00:00,100,95,5,ECO_300019380
642,Herenthoutsesteenweg 2,2022-08-08,13:00:00,94,91,3,ECO_300019380
642,Herenthoutsesteenweg 2,2022-08-08,14:00:00,87,78,9,ECO_300019380
642,Herenthoutsesteenweg 2,2022-08-08,15:00:00,149,144,5,ECO_300019380
642,Herenthoutsesteenweg 2,2022-08-08,16:00:00,173,163,10,ECO_300019380
642,Herenthoutsesteenweg 2,2022-08-08,17:00:00,155,140,15,ECO_300019380
642,Herenthoutsesteenweg 2,2022-08-08,18:00:00,182,163,19,ECO_300019380
642,Herenthoutsesteenweg 2,2022-08-08,19:00:00,155,136,19,ECO_300019380
642,Herenthoutsesteenweg 2,2022-08-08,20:00:00,94,81,13,ECO_300019380
642,Herenthoutsesteenweg 2,2022-08-08,21:00:00,80,77,3,ECO_300019380
642,Herenthoutsesteenweg 2,2022-08-08,22:00:00,73,61,12,ECO_300019380
642,Herenthoutsesteenweg 2,2022-08-08,23:00:00,41,36,5,ECO_300019380
642,Herenthoutsesteenweg 2,2022-08-09,00:00:00,19,18,1,ECO_300019380
642,Herenthoutsesteenweg 2,2022-08-09,01:00:00,8,6,2,ECO_300019380
642,Herenthoutsesteenweg 2,2022-08-09,02:00:00,10,10,0,ECO_300019380
642,Herenthoutsesteenweg 2,2022-08-09,03:00:00,1,1,0,ECO_300019380
642,Herenthoutsesteenweg 2,2022-08-09,04:00:00,4,4,0,ECO_300019380
642,Herenthoutsesteenweg 2,2022-08-09,05:00:00,1,1,0,ECO_300019380
642,Herenthoutsesteenweg 2,2022-08-09,06:00:00,6,5,1,ECO_300019380
642,Herenthoutsesteenweg 2,2022-08-09,07:00:00,31,27,4,ECO_300019380
642,Herenthoutsesteenweg 2,2022-08-09,08:00:00,49,43,6,ECO_300019380
642,Herenthoutsesteenweg 2,2022-08-09,09:00:00,126,117,9,ECO_300019380
642,Herenthoutsesteenweg 2,2022-08-09,10:00:00,112,107,5,ECO_300019380
642,Herenthoutsesteenweg 2,2022-08-09,11:00:00,134,128,6,ECO_300019380
642,Herenthoutsesteenweg 2,2022-08-09,12:00:00,149,136,13,ECO_300019380
642,Herenthoutsesteenweg 2,2022-08-09,13:00:00,111,99,12,ECO_300019380
642,Herenthoutsesteenweg 2,2022-08-09,14:00:00,124,113,11,ECO_300019380
642,Herenthoutsesteenweg 2,2022-08-09,15:00:00,166,155,11,ECO_300019380
642,Herenthoutsesteenweg 2,2022-08-09,16:00:00,188,172,16,ECO_300019380
642,Herenthoutsesteenweg 2,2022-08-09,17:00:00,146,130,16,ECO_300019380
642,Herenthoutsesteenweg 2,2022-08-09,18:00:00,182,156,26,ECO_300019380
642,Herenthoutsesteenweg 2,2022-08-09,19:00:00,123,116,7,ECO_300019380
642,Herenthoutsesteenweg 2,2022-08-09,20:00:00,107,89,18,ECO_300019380
642,Herenthoutsesteenweg 2,2022-08-09,21:00:00,98,88,10,ECO_300019380
642,Herenthoutsesteenweg 2,2022-08-09,22:00:00,64,51,13,ECO_300019380
642,Herenthoutsesteenweg 2,2022-08-09,23:00:00,42,39,3,ECO_300019380
642,Herenthoutsesteenweg 2,2022-08-10,00:00:00,25,23,2,ECO_300019380
642,Herenthoutsesteenweg 2,2022-08-10,01:00:00,3,3,0,ECO_300019380
642,Herenthoutsesteenweg 2,2022-08-10,02:00:00,2,0,2,ECO_300019380
642,Herenthoutsesteenweg 2,2022-08-10,03:00:00,3,1,2,ECO_300019380
642,Herenthoutsesteenweg 2,2022-08-10,04:00:00,1,1,0,ECO_300019380
642,Herenthoutsesteenweg 2,2022-08-10,05:00:00,0,0,0,ECO_300019380
642,Herenthoutsesteenweg 2,2022-08-10,06:00:00,5,3,2,ECO_300019380
642,Herenthoutsesteenweg 2,2022-08-10,07:00:00,30,27,3,ECO_300019380
642,Herenthoutsesteenweg 2,2022-08-10,08:00:00,55,48,7,ECO_300019380
642,Herenthoutsesteenweg 2,2022-08-10,09:00:00,101,97,4,ECO_300019380
642,Herenthoutsesteenweg 2,2022-08-10,10:00:00,108,107,1,ECO_300019380
642,Herenthoutsesteenweg 2,2022-08-10,11:00:00,146,141,5,ECO_300019380
642,Herenthoutsesteenweg 2,2022-08-10,12:00:00,150,144,6,ECO_300019380
642,Herenthoutsesteenweg 2,2022-08-10,13:00:00,113,100,13,ECO_300019380
642,Herenthoutsesteenweg 2,2022-08-10,14:00:00,67,59,8,ECO_300019380
642,Herenthoutsesteenweg 2,2022-08-10,15:00:00,180,168,12,ECO_300019380
642,Herenthoutsesteenweg 2,2022-08-10,16:00:00,153,137,16,ECO_300019380
642,Herenthoutsesteenweg 2,2022-08-10,17:00:00,122,108,14,ECO_300019380
642,Herenthoutsesteenweg 2,2022-08-10,18:00:00,154,125,29,ECO_300019380
642,Herenthoutsesteenweg 2,2022-08-10,19:00:00,111,101,10,ECO_300019380
642,Herenthoutsesteenweg 2,2022-08-10,20:00:00,102,81,21,ECO_300019380
642,Herenthoutsesteenweg 2,2022-08-10,21:00:00,105,95,10,ECO_300019380
642,Herenthoutsesteenweg 2,2022-08-10,22:00:00,101,84,17,ECO_300019380
642,Herenthoutsesteenweg 2,2022-08-10,23:00:00,65,57,8,ECO_300019380
642,Herenthoutsesteenweg 2,2022-08-11,00:00:00,34,25,9,ECO_300019380
642,Herenthoutsesteenweg 2,2022-08-11,01:00:00,16,13,3,ECO_300019380
642,Herenthoutsesteenweg 2,2022-08-11,02:00:00,10,7,3,ECO_300019380
642,Herenthoutsesteenweg 2,2022-08-11,03:00:00,4,2,2,ECO_300019380
642,Herenthoutsesteenweg 2,2022-08-11,04:00:00,1,1,0,ECO_300019380
642,Herenthoutsesteenweg 2,2022-08-11,05:00:00,1,1,0,ECO_300019380
642,Herenthoutsesteenweg 2,2022-08-11,06:00:00,7,5,2,ECO_300019380
642,Herenthoutsesteenweg 2,2022-08-11,07:00:00,32,29,3,ECO_300019380
642,Herenthoutsesteenweg 2,2022-08-11,08:00:00,55,50,5,ECO_300019380
642,Herenthoutsesteenweg 2,2022-08-11,09:00:00,94,91,3,ECO_300019380
642,Herenthoutsesteenweg 2,2022-08-11,10:00:00,132,127,5,ECO_300019380
642,Herenthoutsesteenweg 2,2022-08-11,11:00:00,132,125,7,ECO_300019380
642,Herenthoutsesteenweg 2,2022-08-11,12:00:00,135,125,10,ECO_300019380
642,Herenthoutsesteenweg 2,2022-08-11,13:00:00,146,134,12,ECO_300019380
642,Herenthoutsesteenweg 2,2022-08-11,14:00:00,91,83,8,ECO_300019380
642,Herenthoutsesteenweg 2,2022-08-11,15:00:00,109,102,7,ECO_300019380
642,Herenthoutsesteenweg 2,2022-08-11,16:00:00,130,114,16,ECO_300019380
642,Herenthoutsesteenweg 2,2022-08-11,17:00:00,108,96,12,ECO_300019380
642,Herenthoutsesteenweg 2,2022-08-11,18:00:00,157,135,22,ECO_300019380
642,Herenthoutsesteenweg 2,2022-08-11,19:00:00,99,89,10,ECO_300019380
642,Herenthoutsesteenweg 2,2022-08-11,20:00:00,95,87,8,ECO_300019380
642,Herenthoutsesteenweg 2,2022-08-11,21:00:00,159,149,10,ECO_300019380
642,Herenthoutsesteenweg 2,2022-08-11,22:00:00,81,70,11,ECO_300019380
642,Herenthoutsesteenweg 2,2022-08-11,23:00:00,53,45,8,ECO_300019380
642,Herenthoutsesteenweg 2,2022-08-12,00:00:00,32,27,5,ECO_300019380
642,Herenthoutsesteenweg 2,2022-08-12,01:00:00,10,6,4,ECO_300019380
642,Herenthoutsesteenweg 2,2022-08-12,02:00:00,9,7,2,ECO_300019380
642,Herenthoutsesteenweg 2,2022-08-12,03:00:00,4,2,2,ECO_300019380
642,Herenthoutsesteenweg 2,2022-08-12,04:00:00,0,0,0,ECO_300019380
642,Herenthoutsesteenweg 2,2022-08-12,05:00:00,3,3,0,ECO_300019380
642,Herenthoutsesteenweg 2,2022-08-12,06:00:00,6,4,2,ECO_300019380
642,Herenthoutsesteenweg 2,2022-08-12,07:00:00,28,25,3,ECO_300019380
642,Herenthoutsesteenweg 2,2022-08-12,08:00:00,46,39,7,ECO_300019380
642,Herenthoutsesteenweg 2,2022-08-12,09:00:00,108,102,6,ECO_300019380
642,Herenthoutsesteenweg 2,2022-08-12,10:00:00,137,132,5,ECO_300019380
642,Herenthoutsesteenweg 2,2022-08-12,11:00:00,212,205,7,ECO_300019380
642,Herenthoutsesteenweg 2,2022-08-12,12:00:00,191,181,10,ECO_300019380
642,Herenthoutsesteenweg 2,2022-08-12,13:00:00,141,124,17,ECO_300019380
642,Herenthoutsesteenweg 2,2022-08-12,14:00:00,99,91,8,ECO_300019380
642,Herenthoutsesteenweg 2,2022-08-12,15:00:00,81,73,8,ECO_300019380
642,Herenthoutsesteenweg 2,2022-08-12,16:00:00,97,86,11,ECO_300019380
642,Herenthoutsesteenweg 2,2022-08-12,17:00:00,86,78,8,ECO_300019380
642,Herenthoutsesteenweg 2,2022-08-12,18:00:00,125,109,16,ECO_300019380
642,Herenthoutsesteenweg 2,2022-08-12,19:00:00,72,63,9,ECO_300019380
642,Herenthoutsesteenweg 2,2022-08-12,20:00:00,79,75,4,ECO_300019380
642,Herenthoutsesteenweg 2,2022-08-12,21:00:00,67,58,9,ECO_300019380
642,Herenthoutsesteenweg 2,2022-08-12,22:00:00,74,56,18,ECO_300019380
642,Herenthoutsesteenweg 2,2022-08-12,23:00:00,63,57,6,ECO_300019380
642,Herenthoutsesteenweg 2,2022-08-13,00:00:00,42,38,4,ECO_300019380
642,Herenthoutsesteenweg 2,2022-08-13,01:00:00,12,7,5,ECO_300019380
642,Herenthoutsesteenweg 2,2022-08-13,02:00:00,19,12,7,ECO_300019380
642,Herenthoutsesteenweg 2,2022-08-13,03:00:00,11,6,5,ECO_300019380
642,Herenthoutsesteenweg 2,2022-08-13,04:00:00,10,10,0,ECO_300019380
642,Herenthoutsesteenweg 2,2022-08-13,05:00:00,1,1,0,ECO_300019380
642,Herenthoutsesteenweg 2,2022-08-13,06:00:00,2,2,0,ECO_300019380
642,Herenthoutsesteenweg 2,2022-08-13,07:00:00,6,5,1,ECO_300019380
642,Herenthoutsesteenweg 2,2022-08-13,08:00:00,17,15,2,ECO_300019380
642,Herenthoutsesteenweg 2,2022-08-13,09:00:00,25,23,2,ECO_300019380
642,Herenthoutsesteenweg 2,2022-08-13,10:00:00,87,84,3,ECO_300019380
642,Herenthoutsesteenweg 2,2022-08-13,11:00:00,135,134,1,ECO_300019380
642,Herenthoutsesteenweg 2,2022-08-13,12:00:00,169,157,12,ECO_300019380
642,Herenthoutsesteenweg 2,2022-08-13,13:00:00,111,94,17,ECO_300019380
642,Herenthoutsesteenweg 2,2022-08-13,14:00:00,107,95,12,ECO_300019380
642,Herenthoutsesteenweg 2,2022-08-13,15:00:00,117,110,7,ECO_300019380
642,Herenthoutsesteenweg 2,2022-08-13,16:00:00,100,96,4,ECO_300019380
642,Herenthoutsesteenweg 2,2022-08-13,17:00:00,100,86,14,ECO_300019380
642,Herenthoutsesteenweg 2,2022-08-13,18:00:00,53,46,7,ECO_300019380
642,Herenthoutsesteenweg 2,2022-08-13,19:00:00,82,66,16,ECO_300019380
642,Herenthoutsesteenweg 2,2022-08-13,20:00:00,76,65,11,ECO_300019380
642,Herenthoutsesteenweg 2,2022-08-13,21:00:00,56,49,7,ECO_300019380
642,Herenthoutsesteenweg 2,2022-08-13,22:00:00,57,53,4,ECO_300019380
642,Herenthoutsesteenweg 2,2022-08-13,23:00:00,66,59,7,ECO_300019380
642,Herenthoutsesteenweg 2,2022-08-14,00:00:00,32,25,7,ECO_300019380
642,Herenthoutsesteenweg 2,2022-08-14,01:00:00,10,9,1,ECO_300019380
642,Herenthoutsesteenweg 2,2022-08-14,02:00:00,8,6,2,ECO_300019380
642,Herenthoutsesteenweg 2,2022-08-14,03:00:00,10,8,2,ECO_300019380
642,Herenthoutsesteenweg 2,2022-08-14,04:00:00,10,8,2,ECO_300019380
642,Herenthoutsesteenweg 2,2022-08-14,05:00:00,6,6,0,ECO_300019380
642,Herenthoutsesteenweg 2,2022-08-14,06:00:00,1,1,0,ECO_300019380
642,Herenthoutsesteenweg 2,2022-08-14,07:00:00,4,2,2,ECO_300019380
642,Herenthoutsesteenweg 2,2022-08-14,08:00:00,16,14,2,ECO_300019380
642,Herenthoutsesteenweg 2,2022-08-14,09:00:00,37,36,1,ECO_300019380
642,Herenthoutsesteenweg 2,2022-08-14,10:00:00,117,112,5,ECO_300019380
642,Herenthoutsesteenweg 2,2022-08-14,11:00:00,168,160,8,ECO_300019380
642,Herenthoutsesteenweg 2,2022-08-14,12:00:00,185,174,11,ECO_300019380
642,Herenthoutsesteenweg 2,2022-08-14,13:00:00,112,88,24,ECO_300019380
642,Herenthoutsesteenweg 2,2022-08-14,14:00:00,86,71,15,ECO_300019380
642,Herenthoutsesteenweg 2,2022-08-14,15:00:00,81,72,9,ECO_300019380
642,Herenthoutsesteenweg 2,2022-08-14,16:00:00,96,87,9,ECO_300019380
642,Herenthoutsesteenweg 2,2022-08-14,17:00:00,74,65,9,ECO_300019380
642,Herenthoutsesteenweg 2,2022-08-14,18:00:00,85,70,15,ECO_300019380
642,Herenthoutsesteenweg 2,2022-08-14,19:00:00,79,72,7,ECO_300019380
642,Herenthoutsesteenweg 2,2022-08-14,20:00:00,59,52,7,ECO_300019380
642,Herenthoutsesteenweg 2,2022-08-14,21:00:00,70,61,9,ECO_300019380
642,Herenthoutsesteenweg 2,2022-08-14,22:00:00,68,60,8,ECO_300019380
642,Herenthoutsesteenweg 2,2022-08-14,23:00:00,55,43,12,ECO_300019380
642,Herenthoutsesteenweg 2,2022-08-15,00:00:00,25,21,4,ECO_300019380
642,Herenthoutsesteenweg 2,2022-08-15,01:00:00,18,14,4,ECO_300019380
642,Herenthoutsesteenweg 2,2022-08-15,02:00:00,24,13,11,ECO_300019380
642,Herenthoutsesteenweg 2,2022-08-15,03:00:00,5,4,1,ECO_300019380
642,Herenthoutsesteenweg 2,2022-08-15,04:00:00,19,14,5,ECO_300019380
642,Herenthoutsesteenweg 2,2022-08-15,05:00:00,3,3,0,ECO_300019380
642,Herenthoutsesteenweg 2,2022-08-15,06:00:00,3,1,2,ECO_300019380
642,Herenthoutsesteenweg 2,2022-08-15,07:00:00,2,2,0,ECO_300019380
642,Herenthoutsesteenweg 2,2022-08-15,08:00:00,6,4,2,ECO_300019380
642,Herenthoutsesteenweg 2,2022-08-15,09:00:00,9,9,0,ECO_300019380
642,Herenthoutsesteenweg 2,2022-08-15,10:00:00,26,25,1,ECO_300019380
642,Herenthoutsesteenweg 2,2022-08-15,11:00:00,55,53,2,ECO_300019380
642,Herenthoutsesteenweg 2,2022-08-15,12:00:00,84,80,4,ECO_300019380
642,Herenthoutsesteenweg 2,2022-08-15,13:00:00,86,75,11,ECO_300019380
642,Herenthoutsesteenweg 2,2022-08-15,14:00:00,66,56,10,ECO_300019380
642,Herenthoutsesteenweg 2,2022-08-15,15:00:00,126,111,15,ECO_300019380
642,Herenthoutsesteenweg 2,2022-08-15,16:00:00,126,115,11,ECO_300019380
642,Herenthoutsesteenweg 2,2022-08-15,17:00:00,77,72,5,ECO_300019380
642,Herenthoutsesteenweg 2,2022-08-15,18:00:00,52,38,14,ECO_300019380
642,Herenthoutsesteenweg 2,2022-08-15,19:00:00,45,41,4,ECO_300019380
642,Herenthoutsesteenweg 2,2022-08-15,20:00:00,63,41,22,ECO_300019380
642,Herenthoutsesteenweg 2,2022-08-15,21:00:00,48,40,8,ECO_300019380
642,Herenthoutsesteenweg 2,2022-08-15,22:00:00,47,43,4,ECO_300019380
642,Herenthoutsesteenweg 2,2022-08-15,23:00:00,33,29,4,ECO_300019380
642,Herenthoutsesteenweg 2,2022-08-16,00:00:00,23,22,1,ECO_300019380
642,Herenthoutsesteenweg 2,2022-08-16,01:00:00,3,1,2,ECO_300019380
642,Herenthoutsesteenweg 2,2022-08-16,02:00:00,1,1,0,ECO_300019380
642,Herenthoutsesteenweg 2,2022-08-16,03:00:00,2,2,0,ECO_300019380
642,Herenthoutsesteenweg 2,2022-08-16,04:00:00,1,1,0,ECO_300019380
642,Herenthoutsesteenweg 2,2022-08-16,05:00:00,1,1,0,ECO_300019380
642,Herenthoutsesteenweg 2,2022-08-16,06:00:00,8,5,3,ECO_300019380
642,Herenthoutsesteenweg 2,2022-08-16,07:00:00,28,23,5,ECO_300019380
642,Herenthoutsesteenweg 2,2022-08-16,08:00:00,59,54,5,ECO_300019380
642,Herenthoutsesteenweg 2,2022-08-16,09:00:00,97,92,5,ECO_300019380
642,Herenthoutsesteenweg 2,2022-08-16,10:00:00,123,116,7,ECO_300019380
642,Herenthoutsesteenweg 2,2022-08-16,11:00:00,111,108,3,ECO_300019380
642,Herenthoutsesteenweg 2,2022-08-16,12:00:00,125,119,6,ECO_300019380
642,Herenthoutsesteenweg 2,2022-08-16,13:00:00,130,121,9,ECO_300019380
642,Herenthoutsesteenweg 2,2022-08-16,14:00:00,99,91,8,ECO_300019380
642,Herenthoutsesteenweg 2,2022-08-16,15:00:00,157,151,6,ECO_300019380
642,Herenthoutsesteenweg 2,2022-08-16,16:00:00,156,141,15,ECO_300019380
642,Herenthoutsesteenweg 2,2022-08-16,17:00:00,148,136,12,ECO_300019380
642,Herenthoutsesteenweg 2,2022-08-16,18:00:00,206,177,29,ECO_300019380
642,Herenthoutsesteenweg 2,2022-08-16,19:00:00,126,120,6,ECO_300019380
642,Herenthoutsesteenweg 2,2022-08-16,20:00:00,68,60,8,ECO_300019380
642,Herenthoutsesteenweg 2,2022-08-16,21:00:00,97,83,14,ECO_300019380
642,Herenthoutsesteenweg 2,2022-08-16,22:00:00,72,55,17,ECO_300019380
642,Herenthoutsesteenweg 2,2022-08-16,23:00:00,34,32,2,ECO_300019380
642,Herenthoutsesteenweg 2,2022-08-17,00:00:00,28,22,6,ECO_300019380
642,Herenthoutsesteenweg 2,2022-08-17,01:00:00,12,9,3,ECO_300019380
642,Herenthoutsesteenweg 2,2022-08-17,02:00:00,4,4,0,ECO_300019380
642,Herenthoutsesteenweg 2,2022-08-17,03:00:00,0,0,0,ECO_300019380
642,Herenthoutsesteenweg 2,2022-08-17,04:00:00,0,0,0,ECO_300019380
642,Herenthoutsesteenweg 2,2022-08-17,05:00:00,6,6,0,ECO_300019380
642,Herenthoutsesteenweg 2,2022-08-17,06:00:00,4,2,2,ECO_300019380
642,Herenthoutsesteenweg 2,2022-08-17,07:00:00,22,18,4,ECO_300019380
642,Herenthoutsesteenweg 2,2022-08-17,08:00:00,40,37,3,ECO_300019380
642,Herenthoutsesteenweg 2,2022-08-17,09:00:00,62,57,5,ECO_300019380
642,Herenthoutsesteenweg 2,2022-08-17,10:00:00,62,62,0,ECO_300019380
642,Herenthoutsesteenweg 2,2022-08-17,11:00:00,52,51,1,ECO_300019380
642,Herenthoutsesteenweg 2,2022-08-17,12:00:00,47,39,8,ECO_300019380
642,Herenthoutsesteenweg 2,2022-08-17,13:00:00,10,9,1,ECO_300019380
642,Herenthoutsesteenweg 2,2022-08-17,14:00:00,26,22,4,ECO_300019380
642,Herenthoutsesteenweg 2,2022-08-17,15:00:00,34,33,1,ECO_300019380
642,Herenthoutsesteenweg 2,2022-08-17,16:00:00,46,39,7,ECO_300019380
642,Herenthoutsesteenweg 2,2022-08-17,17:00:00,64,56,8,ECO_300019380
642,Herenthoutsesteenweg 2,2022-08-17,18:00:00,76,70,6,ECO_300019380
642,Herenthoutsesteenweg 2,2022-08-17,19:00:00,76,68,8,ECO_300019380
642,Herenthoutsesteenweg 2,2022-08-17,20:00:00,46,40,6,ECO_300019380
642,Herenthoutsesteenweg 2,2022-08-17,21:00:00,66,57,9,ECO_300019380
642,Herenthoutsesteenweg 2,2022-08-17,22:00:00,44,37,7,ECO_300019380
642,Herenthoutsesteenweg 2,2022-08-17,23:00:00,33,28,5,ECO_300019380
642,Herenthoutsesteenweg 2,2022-08-18,00:00:00,26,25,1,ECO_300019380
642,Herenthoutsesteenweg 2,2022-08-18,01:00:00,10,5,5,ECO_300019380
642,Herenthoutsesteenweg 2,2022-08-18,02:00:00,5,3,2,ECO_300019380
642,Herenthoutsesteenweg 2,2022-08-18,03:00:00,5,5,0,ECO_300019380
642,Herenthoutsesteenweg 2,2022-08-18,04:00:00,1,1,0,ECO_300019380
642,Herenthoutsesteenweg 2,2022-08-18,05:00:00,0,0,0,ECO_300019380
642,Herenthoutsesteenweg 2,2022-08-18,06:00:00,3,2,1,ECO_300019380
642,Herenthoutsesteenweg 2,2022-08-18,07:00:00,26,21,5,ECO_300019380
642,Herenthoutsesteenweg 2,2022-08-18,08:00:00,49,46,3,ECO_300019380
642,Herenthoutsesteenweg 2,2022-08-18,09:00:00,82,80,2,ECO_300019380
642,Herenthoutsesteenweg 2,2022-08-18,10:00:00,97,91,6,ECO_300019380
642,Herenthoutsesteenweg 2,2022-08-18,11:00:00,81,78,3,ECO_300019380
642,Herenthoutsesteenweg 2,2022-08-18,12:00:00,108,105,3,ECO_300019380
642,Herenthoutsesteenweg 2,2022-08-18,13:00:00,125,114,11,ECO_300019380
642,Herenthoutsesteenweg 2,2022-08-18,14:00:00,80,75,5,ECO_300019380
642,Herenthoutsesteenweg 2,2022-08-18,15:00:00,166,155,11,ECO_300019380
642,Herenthoutsesteenweg 2,2022-08-18,16:00:00,186,174,12,ECO_300019380
642,Herenthoutsesteenweg 2,2022-08-18,17:00:00,133,122,11,ECO_300019380
642,Herenthoutsesteenweg 2,2022-08-18,18:00:00,167,147,20,ECO_300019380
642,Herenthoutsesteenweg 2,2022-08-18,19:00:00,156,137,19,ECO_300019380
642,Herenthoutsesteenweg 2,2022-08-18,20:00:00,113,91,22,ECO_300019380
642,Herenthoutsesteenweg 2,2022-08-18,21:00:00,102,89,13,ECO_300019380
642,Herenthoutsesteenweg 2,2022-08-18,22:00:00,72,61,11,ECO_300019380
642,Herenthoutsesteenweg 2,2022-08-18,23:00:00,33,28,5,ECO_300019380
642,Herenthoutsesteenweg 2,2022-08-19,00:00:00,29,26,3,ECO_300019380
642,Herenthoutsesteenweg 2,2022-08-19,01:00:00,10,5,5,ECO_300019380
642,Herenthoutsesteenweg 2,2022-08-19,02:00:00,3,3,0,ECO_300019380
642,Herenthoutsesteenweg 2,2022-08-19,03:00:00,0,0,0,ECO_300019380
642,Herenthoutsesteenweg 2,2022-08-19,04:00:00,1,0,1,ECO_300019380
642,Herenthoutsesteenweg 2,2022-08-19,05:00:00,0,0,0,ECO_300019380
642,Herenthoutsesteenweg 2,2022-08-19,06:00:00,4,4,0,ECO_300019380
642,Herenthoutsesteenweg 2,2022-08-19,07:00:00,23,16,7,ECO_300019380
642,Herenthoutsesteenweg 2,2022-08-19,08:00:00,28,26,2,ECO_300019380
642,Herenthoutsesteenweg 2,2022-08-19,09:00:00,83,80,3,ECO_300019380
642,Herenthoutsesteenweg 2,2022-08-19,10:00:00,91,90,1,ECO_300019380
642,Herenthoutsesteenweg 2,2022-08-19,11:00:00,138,129,9,ECO_300019380
642,Herenthoutsesteenweg 2,2022-08-19,12:00:00,134,130,4,ECO_300019380
642,Herenthoutsesteenweg 2,2022-08-19,13:00:00,86,86,0,ECO_300019380
642,Herenthoutsesteenweg 2,2022-08-19,14:00:00,79,75,4,ECO_300019380
642,Herenthoutsesteenweg 2,2022-08-19,15:00:00,105,98,7,ECO_300019380
642,Herenthoutsesteenweg 2,2022-08-19,16:00:00,100,91,9,ECO_300019380
642,Herenthoutsesteenweg 2,2022-08-19,17:00:00,112,106,6,ECO_300019380
642,Herenthoutsesteenweg 2,2022-08-19,18:00:00,122,109,13,ECO_300019380
642,Herenthoutsesteenweg 2,2022-08-19,19:00:00,76,66,10,ECO_300019380
642,Herenthoutsesteenweg 2,2022-08-19,20:00:00,44,42,2,ECO_300019380
642,Herenthoutsesteenweg 2,2022-08-19,21:00:00,68,63,5,ECO_300019380
642,Herenthoutsesteenweg 2,2022-08-19,22:00:00,33,27,6,ECO_300019380
642,Herenthoutsesteenweg 2,2022-08-19,23:00:00,25,21,4,ECO_300019380
642,Herenthoutsesteenweg 2,2022-08-20,00:00:00,30,29,1,ECO_300019380
642,Herenthoutsesteenweg 2,2022-08-20,01:00:00,6,2,4,ECO_300019380
642,Herenthoutsesteenweg 2,2022-08-20,02:00:00,7,6,1,ECO_300019380
642,Herenthoutsesteenweg 2,2022-08-20,03:00:00,8,7,1,ECO_300019380
642,Herenthoutsesteenweg 2,2022-08-20,04:00:00,3,2,1,ECO_300019380
642,Herenthoutsesteenweg 2,2022-08-20,05:00:00,5,0,5,ECO_300019380
642,Herenthoutsesteenweg 2,2022-08-20,06:00:00,1,1,0,ECO_300019380
642,Herenthoutsesteenweg 2,2022-08-20,07:00:00,7,6,1,ECO_300019380
642,Herenthoutsesteenweg 2,2022-08-20,08:00:00,8,7,1,ECO_300019380
642,Herenthoutsesteenweg 2,2022-08-20,09:00:00,14,14,0,ECO_300019380
642,Herenthoutsesteenweg 2,2022-08-20,10:00:00,44,42,2,ECO_300019380
642,Herenthoutsesteenweg 2,2022-08-20,11:00:00,76,74,2,ECO_300019380
642,Herenthoutsesteenweg 2,2022-08-20,12:00:00,106,100,6,ECO_300019380
642,Herenthoutsesteenweg 2,2022-08-20,13:00:00,133,125,8,ECO_300019380
642,Herenthoutsesteenweg 2,2022-08-20,14:00:00,113,103,10,ECO_300019380
642,Herenthoutsesteenweg 2,2022-08-20,15:00:00,230,212,18,ECO_300019380
642,Herenthoutsesteenweg 2,2022-08-20,16:00:00,224,208,16,ECO_300019380
642,Herenthoutsesteenweg 2,2022-08-20,17:00:00,148,137,11,ECO_300019380
642,Herenthoutsesteenweg 2,2022-08-20,18:00:00,135,103,32,ECO_300019380
642,Herenthoutsesteenweg 2,2022-08-20,19:00:00,86,78,8,ECO_300019380
642,Herenthoutsesteenweg 2,2022-08-20,20:00:00,62,58,4,ECO_300019380
642,Herenthoutsesteenweg 2,2022-08-20,21:00:00,72,50,22,ECO_300019380
642,Herenthoutsesteenweg 2,2022-08-20,22:00:00,76,71,5,ECO_300019380
642,Herenthoutsesteenweg 2,2022-08-20,23:00:00,44,39,5,ECO_300019380
642,Herenthoutsesteenweg 2,2022-08-21,00:00:00,15,12,3,ECO_300019380
642,Herenthoutsesteenweg 2,2022-08-21,01:00:00,8,7,1,ECO_300019380
642,Herenthoutsesteenweg 2,2022-08-21,02:00:00,15,10,5,ECO_300019380
642,Herenthoutsesteenweg 2,2022-08-21,03:00:00,11,10,1,ECO_300019380
642,Herenthoutsesteenweg 2,2022-08-21,04:00:00,5,0,5,ECO_300019380
642,Herenthoutsesteenweg 2,2022-08-21,05:00:00,4,4,0,ECO_300019380
642,Herenthoutsesteenweg 2,2022-08-21,06:00:00,0,0,0,ECO_300019380
642,Herenthoutsesteenweg 2,2022-08-21,07:00:00,0,0,0,ECO_300019380
642,Herenthoutsesteenweg 2,2022-08-21,08:00:00,12,12,0,ECO_300019380
642,Herenthoutsesteenweg 2,2022-08-21,09:00:00,30,27,3,ECO_300019380
642,Herenthoutsesteenweg 2,2022-08-21,10:00:00,68,65,3,ECO_300019380
642,Herenthoutsesteenweg 2,2022-08-21,11:00:00,127,118,9,ECO_300019380
642,Herenthoutsesteenweg 2,2022-08-21,12:00:00,194,184,10,ECO_300019380
642,Herenthoutsesteenweg 2,2022-08-21,13:00:00,152,134,18,ECO_300019380
642,Herenthoutsesteenweg 2,2022-08-21,14:00:00,126,111,15,ECO_300019380
642,Herenthoutsesteenweg 2,2022-08-21,15:00:00,148,138,10,ECO_300019380
642,Herenthoutsesteenweg 2,2022-08-21,16:00:00,154,145,9,ECO_300019380
642,Herenthoutsesteenweg 2,2022-08-21,17:00:00,137,126,11,ECO_300019380
642,Herenthoutsesteenweg 2,2022-08-21,18:00:00,109,92,17,ECO_300019380
642,Herenthoutsesteenweg 2,2022-08-21,19:00:00,104,79,25,ECO_300019380
642,Herenthoutsesteenweg 2,2022-08-21,20:00:00,78,69,9,ECO_300019380
642,Herenthoutsesteenweg 2,2022-08-21,21:00:00,72,60,12,ECO_300019380
642,Herenthoutsesteenweg 2,2022-08-21,22:00:00,43,41,2,ECO_300019380
642,Herenthoutsesteenweg 2,2022-08-21,23:00:00,23,18,5,ECO_300019380
642,Herenthoutsesteenweg 2,2022-08-22,00:00:00,14,13,1,ECO_300019380
642,Herenthoutsesteenweg 2,2022-08-22,01:00:00,6,4,2,ECO_300019380
642,Herenthoutsesteenweg 2,2022-08-22,02:00:00,5,5,0,ECO_300019380
642,Herenthoutsesteenweg 2,2022-08-22,03:00:00,12,11,1,ECO_300019380
642,Herenthoutsesteenweg 2,2022-08-22,04:00:00,2,0,2,ECO_300019380
642,Herenthoutsesteenweg 2,2022-08-22,05:00:00,0,0,0,ECO_300019380
642,Herenthoutsesteenweg 2,2022-08-22,06:00:00,5,5,0,ECO_300019380
642,Herenthoutsesteenweg 2,2022-08-22,07:00:00,28,26,2,ECO_300019380
642,Herenthoutsesteenweg 2,2022-08-22,08:00:00,48,42,6,ECO_300019380
642,Herenthoutsesteenweg 2,2022-08-22,09:00:00,95,88,7,ECO_300019380
642,Herenthoutsesteenweg 2,2022-08-22,10:00:00,92,88,4,ECO_300019380
642,Herenthoutsesteenweg 2,2022-08-22,11:00:00,93,90,3,ECO_300019380
642,Herenthoutsesteenweg 2,2022-08-22,12:00:00,106,99,7,ECO_300019380
642,Herenthoutsesteenweg 2,2022-08-22,13:00:00,73,70,3,ECO_300019380
642,Herenthoutsesteenweg 2,2022-08-22,14:00:00,74,70,4,ECO_300019380
642,Herenthoutsesteenweg 2,2022-08-22,15:00:00,173,163,10,ECO_300019380
642,Herenthoutsesteenweg 2,2022-08-22,16:00:00,164,151,13,ECO_300019380
642,Herenthoutsesteenweg 2,2022-08-22,17:00:00,116,104,12,ECO_300019380
642,Herenthoutsesteenweg 2,2022-08-22,18:00:00,167,152,15,ECO_300019380
642,Herenthoutsesteenweg 2,2022-08-22,19:00:00,131,118,13,ECO_300019380
642,Herenthoutsesteenweg 2,2022-08-22,20:00:00,70,63,7,ECO_300019380
642,Herenthoutsesteenweg 2,2022-08-22,21:00:00,74,65,9,ECO_300019380
642,Herenthoutsesteenweg 2,2022-08-22,22:00:00,44,38,6,ECO_300019380
642,Herenthoutsesteenweg 2,2022-08-22,23:00:00,32,27,5,ECO_300019380
642,Herenthoutsesteenweg 2,2022-08-23,00:00:00,15,12,3,ECO_300019380
642,Herenthoutsesteenweg 2,2022-08-23,01:00:00,1,1,0,ECO_300019380
642,Herenthoutsesteenweg 2,2022-08-23,02:00:00,3,3,0,ECO_300019380
642,Herenthoutsesteenweg 2,2022-08-23,03:00:00,2,1,1,ECO_300019380
642,Herenthoutsesteenweg 2,2022-08-23,04:00:00,0,0,0,ECO_300019380
642,Herenthoutsesteenweg 2,2022-08-23,05:00:00,0,0,0,ECO_300019380
642,Herenthoutsesteenweg 2,2022-08-23,06:00:00,7,7,0,ECO_300019380
642,Herenthoutsesteenweg 2,2022-08-23,07:00:00,29,27,2,ECO_300019380
642,Herenthoutsesteenweg 2,2022-08-23,08:00:00,52,42,10,ECO_300019380
642,Herenthoutsesteenweg 2,2022-08-23,09:00:00,116,108,8,ECO_300019380
642,Herenthoutsesteenweg 2,2022-08-23,10:00:00,101,99,2,ECO_300019380
642,Herenthoutsesteenweg 2,2022-08-23,11:00:00,106,99,7,ECO_300019380
642,Herenthoutsesteenweg 2,2022-08-23,12:00:00,130,126,4,ECO_300019380
642,Herenthoutsesteenweg 2,2022-08-23,13:00:00,149,136,13,ECO_300019380
642,Herenthoutsesteenweg 2,2022-08-23,14:00:00,99,87,12,ECO_300019380
642,Herenthoutsesteenweg 2,2022-08-23,15:00:00,164,152,12,ECO_300019380
642,Herenthoutsesteenweg 2,2022-08-23,16:00:00,181,165,16,ECO_300019380
642,Herenthoutsesteenweg 2,2022-08-23,17:00:00,150,133,17,ECO_300019380
642,Herenthoutsesteenweg 2,2022-08-23,18:00:00,167,150,17,ECO_300019380
642,Herenthoutsesteenweg 2,2022-08-23,19:00:00,142,119,23,ECO_300019380
642,Herenthoutsesteenweg 2,2022-08-23,20:00:00,99,86,13,ECO_300019380
642,Herenthoutsesteenweg 2,2022-08-23,21:00:00,98,94,4,ECO_300019380
642,Herenthoutsesteenweg 2,2022-08-23,22:00:00,59,51,8,ECO_300019380
642,Herenthoutsesteenweg 2,2022-08-23,23:00:00,37,30,7,ECO_300019380
642,Herenthoutsesteenweg 2,2022-08-24,00:00:00,34,27,7,ECO_300019380
642,Herenthoutsesteenweg 2,2022-08-24,01:00:00,9,6,3,ECO_300019380
642,Herenthoutsesteenweg 2,2022-08-24,02:00:00,8,4,4,ECO_300019380
642,Herenthoutsesteenweg 2,2022-08-24,03:00:00,1,0,1,ECO_300019380
642,Herenthoutsesteenweg 2,2022-08-24,04:00:00,0,0,0,ECO_300019380
642,Herenthoutsesteenweg 2,2022-08-24,05:00:00,3,3,0,ECO_300019380
642,Herenthoutsesteenweg 2,2022-08-24,06:00:00,3,2,1,ECO_300019380
642,Herenthoutsesteenweg 2,2022-08-24,07:00:00,33,29,4,ECO_300019380
642,Herenthoutsesteenweg 2,2022-08-24,08:00:00,50,42,8,ECO_300019380
642,Herenthoutsesteenweg 2,2022-08-24,09:00:00,114,105,9,ECO_300019380
642,Herenthoutsesteenweg 2,2022-08-24,10:00:00,112,107,5,ECO_300019380
642,Herenthoutsesteenweg 2,2022-08-24,11:00:00,103,94,9,ECO_300019380
642,Herenthoutsesteenweg 2,2022-08-24,12:00:00,148,142,6,ECO_300019380
642,Herenthoutsesteenweg 2,2022-08-24,13:00:00,112,103,9,ECO_300019380
642,Herenthoutsesteenweg 2,2022-08-24,14:00:00,127,118,9,ECO_300019380
642,Herenthoutsesteenweg 2,2022-08-24,15:00:00,140,132,8,ECO_300019380
642,Herenthoutsesteenweg 2,2022-08-24,16:00:00,148,139,9,ECO_300019380
642,Herenthoutsesteenweg 2,2022-08-24,17:00:00,121,111,10,ECO_300019380
642,Herenthoutsesteenweg 2,2022-08-24,18:00:00,175,154,21,ECO_300019380
642,Herenthoutsesteenweg 2,2022-08-24,19:00:00,109,99,10,ECO_300019380
642,Herenthoutsesteenweg 2,2022-08-24,20:00:00,94,80,14,ECO_300019380
642,Herenthoutsesteenweg 2,2022-08-24,21:00:00,99,84,15,ECO_300019380
642,Herenthoutsesteenweg 2,2022-08-24,22:00:00,77,68,9,ECO_300019380
642,Herenthoutsesteenweg 2,2022-08-24,23:00:00,58,55,3,ECO_300019380
642,Herenthoutsesteenweg 2,2022-08-25,00:00:00,24,23,1,ECO_300019380
642,Herenthoutsesteenweg 2,2022-08-25,01:00:00,11,3,8,ECO_300019380
642,Herenthoutsesteenweg 2,2022-08-25,02:00:00,6,6,0,ECO_300019380
642,Herenthoutsesteenweg 2,2022-08-25,03:00:00,1,1,0,ECO_300019380
642,Herenthoutsesteenweg 2,2022-08-25,04:00:00,2,1,1,ECO_300019380
642,Herenthoutsesteenweg 2,2022-08-25,05:00:00,0,0,0,ECO_300019380
642,Herenthoutsesteenweg 2,2022-08-25,06:00:00,4,4,0,ECO_300019380
642,Herenthoutsesteenweg 2,2022-08-25,07:00:00,20,19,1,ECO_300019380
642,Herenthoutsesteenweg 2,2022-08-25,08:00:00,56,47,9,ECO_300019380
642,Herenthoutsesteenweg 2,2022-08-25,09:00:00,118,109,9,ECO_300019380
642,Herenthoutsesteenweg 2,2022-08-25,10:00:00,132,128,4,ECO_300019380
642,Herenthoutsesteenweg 2,2022-08-25,11:00:00,107,103,4,ECO_300019380
642,Herenthoutsesteenweg 2,2022-08-25,12:00:00,121,110,11,ECO_300019380
642,Herenthoutsesteenweg 2,2022-08-25,13:00:00,112,105,7,ECO_300019380
642,Herenthoutsesteenweg 2,2022-08-25,14:00:00,103,88,15,ECO_300019380
642,Herenthoutsesteenweg 2,2022-08-25,15:00:00,101,98,3,ECO_300019380
642,Herenthoutsesteenweg 2,2022-08-25,16:00:00,111,103,8,ECO_300019380
642,Herenthoutsesteenweg 2,2022-08-25,17:00:00,101,92,9,ECO_300019380
642,Herenthoutsesteenweg 2,2022-08-25,18:00:00,179,165,14,ECO_300019380
642,Herenthoutsesteenweg 2,2022-08-25,19:00:00,106,100,6,ECO_300019380
642,Herenthoutsesteenweg 2,2022-08-25,20:00:00,99,89,10,ECO_300019380
642,Herenthoutsesteenweg 2,2022-08-25,21:00:00,102,95,7,ECO_300019380
642,Herenthoutsesteenweg 2,2022-08-25,22:00:00,56,52,4,ECO_300019380
642,Herenthoutsesteenweg 2,2022-08-25,23:00:00,29,25,4,ECO_300019380
642,Herenthoutsesteenweg 2,2022-08-26,00:00:00,19,12,7,ECO_300019380
642,Herenthoutsesteenweg 2,2022-08-26,01:00:00,16,13,3,ECO_300019380
642,Herenthoutsesteenweg 2,2022-08-26,02:00:00,7,7,0,ECO_300019380
642,Herenthoutsesteenweg 2,2022-08-26,03:00:00,4,3,1,ECO_300019380
642,Herenthoutsesteenweg 2,2022-08-26,04:00:00,0,0,0,ECO_300019380
642,Herenthoutsesteenweg 2,2022-08-26,05:00:00,0,0,0,ECO_300019380
642,Herenthoutsesteenweg 2,2022-08-26,06:00:00,4,4,0,ECO_300019380
642,Herenthoutsesteenweg 2,2022-08-26,07:00:00,24,22,2,ECO_300019380
642,Herenthoutsesteenweg 2,2022-08-26,08:00:00,42,33,9,ECO_300019380
642,Herenthoutsesteenweg 2,2022-08-26,09:00:00,82,77,5,ECO_300019380
642,Herenthoutsesteenweg 2,2022-08-26,10:00:00,131,128,3,ECO_300019380
642,Herenthoutsesteenweg 2,2022-08-26,11:00:00,119,114,5,ECO_300019380
642,Herenthoutsesteenweg 2,2022-08-26,12:00:00,118,116,2,ECO_300019380
642,Herenthoutsesteenweg 2,2022-08-26,13:00:00,92,86,6,ECO_300019380
642,Herenthoutsesteenweg 2,2022-08-26,14:00:00,65,63,2,ECO_300019380
642,Herenthoutsesteenweg 2,2022-08-26,15:00:00,100,97,3,ECO_300019380
642,Herenthoutsesteenweg 2,2022-08-26,16:00:00,99,95,4,ECO_300019380
642,Herenthoutsesteenweg 2,2022-08-26,17:00:00,109,99,10,ECO_300019380
642,Herenthoutsesteenweg 2,2022-08-26,18:00:00,146,132,14,ECO_300019380
642,Herenthoutsesteenweg 2,2022-08-26,19:00:00,94,88,6,ECO_300019380
642,Herenthoutsesteenweg 2,2022-08-26,20:00:00,70,62,8,ECO_300019380
642,Herenthoutsesteenweg 2,2022-08-26,21:00:00,68,56,12,ECO_300019380
642,Herenthoutsesteenweg 2,2022-08-26,22:00:00,77,71,6,ECO_300019380
642,Herenthoutsesteenweg 2,2022-08-26,23:00:00,34,31,3,ECO_300019380
642,Herenthoutsesteenweg 2,2022-08-27,00:00:00,30,26,4,ECO_300019380
642,Herenthoutsesteenweg 2,2022-08-27,01:00:00,25,20,5,ECO_300019380
642,Herenthoutsesteenweg 2,2022-08-27,02:00:00,12,9,3,ECO_300019380
642,Herenthoutsesteenweg 2,2022-08-27,03:00:00,12,12,0,ECO_300019380
642,Herenthoutsesteenweg 2,2022-08-27,04:00:00,5,5,0,ECO_300019380
642,Herenthoutsesteenweg 2,2022-08-27,05:00:00,10,9,1,ECO_300019380
642,Herenthoutsesteenweg 2,2022-08-27,06:00:00,3,3,0,ECO_300019380
642,Herenthoutsesteenweg 2,2022-08-27,07:00:00,5,5,0,ECO_300019380
642,Herenthoutsesteenweg 2,2022-08-27,08:00:00,16,15,1,ECO_300019380
642,Herenthoutsesteenweg 2,2022-08-27,09:00:00,10,8,2,ECO_300019380
642,Herenthoutsesteenweg 2,2022-08-27,10:00:00,44,41,3,ECO_300019380
642,Herenthoutsesteenweg 2,2022-08-27,11:00:00,88,87,1,ECO_300019380
642,Herenthoutsesteenweg 2,2022-08-27,12:00:00,141,134,7,ECO_300019380
642,Herenthoutsesteenweg 2,2022-08-27,13:00:00,129,124,5,ECO_300019380
642,Herenthoutsesteenweg 2,2022-08-27,14:00:00,112,109,3,ECO_300019380
642,Herenthoutsesteenweg 2,2022-08-27,15:00:00,212,196,16,ECO_300019380
642,Herenthoutsesteenweg 2,2022-08-27,16:00:00,172,160,12,ECO_300019380
642,Herenthoutsesteenweg 2,2022-08-27,17:00:00,133,112,21,ECO_300019380
642,Herenthoutsesteenweg 2,2022-08-27,18:00:00,95,75,20,ECO_300019380
642,Herenthoutsesteenweg 2,2022-08-27,19:00:00,86,76,10,ECO_300019380
642,Herenthoutsesteenweg 2,2022-08-27,20:00:00,75,71,4,ECO_300019380
642,Herenthoutsesteenweg 2,2022-08-27,21:00:00,57,50,7,ECO_300019380
642,Herenthoutsesteenweg 2,2022-08-27,22:00:00,40,37,3,ECO_300019380
642,Herenthoutsesteenweg 2,2022-08-27,23:00:00,27,22,5,ECO_300019380
642,Herenthoutsesteenweg 2,2022-08-28,00:00:00,13,10,3,ECO_300019380
642,Herenthoutsesteenweg 2,2022-08-28,01:00:00,16,15,1,ECO_300019380
642,Herenthoutsesteenweg 2,2022-08-28,02:00:00,19,19,0,ECO_300019380
642,Herenthoutsesteenweg 2,2022-08-28,03:00:00,16,14,2,ECO_300019380
642,Herenthoutsesteenweg 2,2022-08-28,04:00:00,18,18,0,ECO_300019380
642,Herenthoutsesteenweg 2,2022-08-28,05:00:00,4,3,1,ECO_300019380
642,Herenthoutsesteenweg 2,2022-08-28,06:00:00,6,5,1,ECO_300019380
642,Herenthoutsesteenweg 2,2022-08-28,07:00:00,0,0,0,ECO_300019380
642,Herenthoutsesteenweg 2,2022-08-28,08:00:00,19,17,2,ECO_300019380
642,Herenthoutsesteenweg 2,2022-08-28,09:00:00,26,23,3,ECO_300019380
642,Herenthoutsesteenweg 2,2022-08-28,10:00:00,82,75,7,ECO_300019380
642,Herenthoutsesteenweg 2,2022-08-28,11:00:00,186,181,5,ECO_300019380
642,Herenthoutsesteenweg 2,2022-08-28,12:00:00,161,154,7,ECO_300019380
642,Herenthoutsesteenweg 2,2022-08-28,13:00:00,149,131,18,ECO_300019380
642,Herenthoutsesteenweg 2,2022-08-28,14:00:00,163,146,17,ECO_300019380
642,Herenthoutsesteenweg 2,2022-08-28,15:00:00,226,219,7,ECO_300019380
642,Herenthoutsesteenweg 2,2022-08-28,16:00:00,242,236,6,ECO_300019380
642,Herenthoutsesteenweg 2,2022-08-28,17:00:00,208,198,10,ECO_300019380
642,Herenthoutsesteenweg 2,2022-08-28,18:00:00,118,105,13,ECO_300019380
642,Herenthoutsesteenweg 2,2022-08-28,19:00:00,101,90,11,ECO_300019380
642,Herenthoutsesteenweg 2,2022-08-28,20:00:00,72,61,11,ECO_300019380
642,Herenthoutsesteenweg 2,2022-08-28,21:00:00,57,52,5,ECO_300019380
642,Herenthoutsesteenweg 2,2022-08-28,22:00:00,49,43,6,ECO_300019380
642,Herenthoutsesteenweg 2,2022-08-28,23:00:00,33,32,1,ECO_300019380
642,Herenthoutsesteenweg 2,2022-08-29,00:00:00,14,14,0,ECO_300019380
642,Herenthoutsesteenweg 2,2022-08-29,01:00:00,7,6,1,ECO_300019380
642,Herenthoutsesteenweg 2,2022-08-29,02:00:00,4,2,2,ECO_300019380
642,Herenthoutsesteenweg 2,2022-08-29,03:00:00,0,0,0,ECO_300019380
642,Herenthoutsesteenweg 2,2022-08-29,04:00:00,0,0,0,ECO_300019380
642,Herenthoutsesteenweg 2,2022-08-29,05:00:00,1,1,0,ECO_300019380
642,Herenthoutsesteenweg 2,2022-08-29,06:00:00,6,5,1,ECO_300019380
642,Herenthoutsesteenweg 2,2022-08-29,07:00:00,19,16,3,ECO_300019380
642,Herenthoutsesteenweg 2,2022-08-29,08:00:00,48,42,6,ECO_300019380
642,Herenthoutsesteenweg 2,2022-08-29,09:00:00,108,105,3,ECO_300019380
642,Herenthoutsesteenweg 2,2022-08-29,10:00:00,102,99,3,ECO_300019380
642,Herenthoutsesteenweg 2,2022-08-29,11:00:00,82,80,2,ECO_300019380
642,Herenthoutsesteenweg 2,2022-08-29,12:00:00,76,72,4,ECO_300019380
642,Herenthoutsesteenweg 2,2022-08-29,13:00:00,76,75,1,ECO_300019380
642,Herenthoutsesteenweg 2,2022-08-29,14:00:00,83,78,5,ECO_300019380
642,Herenthoutsesteenweg 2,2022-08-29,15:00:00,134,131,3,ECO_300019380
642,Herenthoutsesteenweg 2,2022-08-29,16:00:00,186,175,11,ECO_300019380
642,Herenthoutsesteenweg 2,2022-08-29,17:00:00,139,129,10,ECO_300019380
642,Herenthoutsesteenweg 2,2022-08-29,18:00:00,158,138,20,ECO_300019380
642,Herenthoutsesteenweg 2,2022-08-29,19:00:00,147,131,16,ECO_300019380
642,Herenthoutsesteenweg 2,2022-08-29,20:00:00,100,99,1,ECO_300019380
642,Herenthoutsesteenweg 2,2022-08-29,21:00:00,126,118,8,ECO_300019380
642,Herenthoutsesteenweg 2,2022-08-29,22:00:00,54,50,4,ECO_300019380
642,Herenthoutsesteenweg 2,2022-08-29,23:00:00,28,25,3,ECO_300019380
642,Herenthoutsesteenweg 2,2022-08-30,00:00:00,37,29,8,ECO_300019380
642,Herenthoutsesteenweg 2,2022-08-30,01:00:00,7,4,3,ECO_300019380
642,Herenthoutsesteenweg 2,2022-08-30,02:00:00,2,0,2,ECO_300019380
642,Herenthoutsesteenweg 2,2022-08-30,03:00:00,2,0,2,ECO_300019380
642,Herenthoutsesteenweg 2,2022-08-30,04:00:00,1,1,0,ECO_300019380
642,Herenthoutsesteenweg 2,2022-08-30,05:00:00,1,1,0,ECO_300019380
642,Herenthoutsesteenweg 2,2022-08-30,06:00:00,3,3,0,ECO_300019380
642,Herenthoutsesteenweg 2,2022-08-30,07:00:00,29,25,4,ECO_300019380
642,Herenthoutsesteenweg 2,2022-08-30,08:00:00,58,49,9,ECO_300019380
642,Herenthoutsesteenweg 2,2022-08-30,09:00:00,126,121,5,ECO_300019380
642,Herenthoutsesteenweg 2,2022-08-30,10:00:00,120,119,1,ECO_300019380
642,Herenthoutsesteenweg 2,2022-08-30,11:00:00,105,101,4,ECO_300019380
642,Herenthoutsesteenweg 2,2022-08-30,12:00:00,118,114,4,ECO_300019380
642,Herenthoutsesteenweg 2,2022-08-30,13:00:00,97,85,12,ECO_300019380
642,Herenthoutsesteenweg 2,2022-08-30,14:00:00,134,122,12,ECO_300019380
642,Herenthoutsesteenweg 2,2022-08-30,15:00:00,178,163,15,ECO_300019380
642,Herenthoutsesteenweg 2,2022-08-30,16:00:00,191,185,6,ECO_300019380
642,Herenthoutsesteenweg 2,2022-08-30,17:00:00,144,139,5,ECO_300019380
642,Herenthoutsesteenweg 2,2022-08-30,18:00:00,185,173,12,ECO_300019380
642,Herenthoutsesteenweg 2,2022-08-30,19:00:00,164,150,14,ECO_300019380
642,Herenthoutsesteenweg 2,2022-08-30,20:00:00,118,108,10,ECO_300019380
642,Herenthoutsesteenweg 2,2022-08-30,21:00:00,107,97,10,ECO_300019380
642,Herenthoutsesteenweg 2,2022-08-30,22:00:00,41,38,3,ECO_300019380
642,Herenthoutsesteenweg 2,2022-08-30,23:00:00,26,23,3,ECO_300019380
642,Herenthoutsesteenweg 2,2022-08-31,00:00:00,30,25,5,ECO_300019380
642,Herenthoutsesteenweg 2,2022-08-31,01:00:00,14,10,4,ECO_300019380
642,Herenthoutsesteenweg 2,2022-08-31,02:00:00,3,1,2,ECO_300019380
642,Herenthoutsesteenweg 2,2022-08-31,03:00:00,1,1,0,ECO_300019380
642,Herenthoutsesteenweg 2,2022-08-31,04:00:00,0,0,0,ECO_300019380
642,Herenthoutsesteenweg 2,2022-08-31,05:00:00,1,1,0,ECO_300019380
642,Herenthoutsesteenweg 2,2022-08-31,06:00:00,2,2,0,ECO_300019380
642,Herenthoutsesteenweg 2,2022-08-31,07:00:00,22,18,4,ECO_300019380
642,Herenthoutsesteenweg 2,2022-08-31,08:00:00,49,41,8,ECO_300019380
642,Herenthoutsesteenweg 2,2022-08-31,09:00:00,115,101,14,ECO_300019380
642,Herenthoutsesteenweg 2,2022-08-31,10:00:00,99,95,4,ECO_300019380
642,Herenthoutsesteenweg 2,2022-08-31,11:00:00,117,113,4,ECO_300019380
642,Herenthoutsesteenweg 2,2022-08-31,12:00:00,105,97,8,ECO_300019380
642,Herenthoutsesteenweg 2,2022-08-31,13:00:00,117,110,7,ECO_300019380
642,Herenthoutsesteenweg 2,2022-08-31,14:00:00,102,96,6,ECO_300019380
642,Herenthoutsesteenweg 2,2022-08-31,15:00:00,218,208,10,ECO_300019380
642,Herenthoutsesteenweg 2,2022-08-31,16:00:00,176,160,16,ECO_300019380
642,Herenthoutsesteenweg 2,2022-08-31,17:00:00,153,144,9,ECO_300019380
642,Herenthoutsesteenweg 2,2022-08-31,18:00:00,178,169,9,ECO_300019380
642,Herenthoutsesteenweg 2,2022-08-31,19:00:00,147,133,14,ECO_300019380
642,Herenthoutsesteenweg 2,2022-08-31,20:00:00,125,111,14,ECO_300019380
642,Herenthoutsesteenweg 2,2022-08-31,21:00:00,69,62,7,ECO_300019380
642,Herenthoutsesteenweg 2,2022-08-31,22:00:00,50,46,4,ECO_300019380
642,Herenthoutsesteenweg 2,2022-08-31,23:00:00,41,36,5,ECO_300019380
642,Herenthoutsesteenweg 2,2022-09-01,00:00:00,30,26,4,ECO_300019380
642,Herenthoutsesteenweg 2,2022-09-01,01:00:00,8,5,3,ECO_300019380
642,Herenthoutsesteenweg 2,2022-09-01,02:00:00,4,2,2,ECO_300019380
642,Herenthoutsesteenweg 2,2022-09-01,03:00:00,0,0,0,ECO_300019380
642,Herenthoutsesteenweg 2,2022-09-01,04:00:00,2,2,0,ECO_300019380
642,Herenthoutsesteenweg 2,2022-09-01,05:00:00,2,2,0,ECO_300019380
642,Herenthoutsesteenweg 2,2022-09-01,06:00:00,5,5,0,ECO_300019380
642,Herenthoutsesteenweg 2,2022-09-01,07:00:00,24,22,2,ECO_300019380
642,Herenthoutsesteenweg 2,2022-09-01,08:00:00,62,55,7,ECO_300019380
642,Herenthoutsesteenweg 2,2022-09-01,09:00:00,181,175,6,ECO_300019380
642,Herenthoutsesteenweg 2,2022-09-01,10:00:00,373,370,3,ECO_300019380
642,Herenthoutsesteenweg 2,2022-09-01,11:00:00,305,302,3,ECO_300019380
642,Herenthoutsesteenweg 2,2022-09-01,12:00:00,163,157,6,ECO_300019380
642,Herenthoutsesteenweg 2,2022-09-01,13:00:00,99,93,6,ECO_300019380
642,Herenthoutsesteenweg 2,2022-09-01,14:00:00,272,264,8,ECO_300019380
642,Herenthoutsesteenweg 2,2022-09-01,15:00:00,157,145,12,ECO_300019380
642,Herenthoutsesteenweg 2,2022-09-01,16:00:00,158,143,15,ECO_300019380
642,Herenthoutsesteenweg 2,2022-09-01,17:00:00,222,206,16,ECO_300019380
642,Herenthoutsesteenweg 2,2022-09-01,18:00:00,207,189,18,ECO_300019380
642,Herenthoutsesteenweg 2,2022-09-01,19:00:00,173,153,20,ECO_300019380
642,Herenthoutsesteenweg 2,2022-09-01,20:00:00,115,105,10,ECO_300019380
642,Herenthoutsesteenweg 2,2022-09-01,21:00:00,73,70,3,ECO_300019380
642,Herenthoutsesteenweg 2,2022-09-01,22:00:00,56,52,4,ECO_300019380
642,Herenthoutsesteenweg 2,2022-09-01,23:00:00,25,23,2,ECO_300019380
642,Herenthoutsesteenweg 2,2022-09-02,00:00:00,35,30,5,ECO_300019380
642,Herenthoutsesteenweg 2,2022-09-02,01:00:00,7,5,2,ECO_300019380
642,Herenthoutsesteenweg 2,2022-09-02,02:00:00,3,3,0,ECO_300019380
642,Herenthoutsesteenweg 2,2022-09-02,03:00:00,2,0,2,ECO_300019380
642,Herenthoutsesteenweg 2,2022-09-02,04:00:00,1,1,0,ECO_300019380
642,Herenthoutsesteenweg 2,2022-09-02,05:00:00,0,0,0,ECO_300019380
642,Herenthoutsesteenweg 2,2022-09-02,06:00:00,5,5,0,ECO_300019380
642,Herenthoutsesteenweg 2,2022-09-02,07:00:00,23,18,5,ECO_300019380
642,Herenthoutsesteenweg 2,2022-09-02,08:00:00,42,40,2,ECO_300019380
642,Herenthoutsesteenweg 2,2022-09-02,09:00:00,227,219,8,ECO_300019380
642,Herenthoutsesteenweg 2,2022-09-02,10:00:00,709,700,9,ECO_300019380
642,Herenthoutsesteenweg 2,2022-09-02,11:00:00,152,147,5,ECO_300019380
642,Herenthoutsesteenweg 2,2022-09-02,12:00:00,139,137,2,ECO_300019380
642,Herenthoutsesteenweg 2,2022-09-02,13:00:00,117,109,8,ECO_300019380
642,Herenthoutsesteenweg 2,2022-09-02,14:00:00,117,109,8,ECO_300019380
642,Herenthoutsesteenweg 2,2022-09-02,15:00:00,137,128,9,ECO_300019380
642,Herenthoutsesteenweg 2,2022-09-02,16:00:00,165,153,12,ECO_300019380
642,Herenthoutsesteenweg 2,2022-09-02,17:00:00,196,179,17,ECO_300019380
642,Herenthoutsesteenweg 2,2022-09-02,18:00:00,182,162,20,ECO_300019380
642,Herenthoutsesteenweg 2,2022-09-02,19:00:00,141,129,12,ECO_300019380
642,Herenthoutsesteenweg 2,2022-09-02,20:00:00,110,107,3,ECO_300019380
642,Herenthoutsesteenweg 2,2022-09-02,21:00:00,96,88,8,ECO_300019380
642,Herenthoutsesteenweg 2,2022-09-02,22:00:00,83,74,9,ECO_300019380
642,Herenthoutsesteenweg 2,2022-09-02,23:00:00,40,38,2,ECO_300019380
642,Herenthoutsesteenweg 2,2022-09-03,00:00:00,32,25,7,ECO_300019380
642,Herenthoutsesteenweg 2,2022-09-03,01:00:00,11,9,2,ECO_300019380
642,Herenthoutsesteenweg 2,2022-09-03,02:00:00,7,4,3,ECO_300019380
642,Herenthoutsesteenweg 2,2022-09-03,03:00:00,8,8,0,ECO_300019380
642,Herenthoutsesteenweg 2,2022-09-03,04:00:00,7,6,1,ECO_300019380
642,Herenthoutsesteenweg 2,2022-09-03,05:00:00,1,1,0,ECO_300019380
642,Herenthoutsesteenweg 2,2022-09-03,06:00:00,2,2,0,ECO_300019380
642,Herenthoutsesteenweg 2,2022-09-03,07:00:00,6,6,0,ECO_300019380
642,Herenthoutsesteenweg 2,2022-09-03,08:00:00,9,9,0,ECO_300019380
642,Herenthoutsesteenweg 2,2022-09-03,09:00:00,14,12,2,ECO_300019380
642,Herenthoutsesteenweg 2,2022-09-03,10:00:00,45,42,3,ECO_300019380
642,Herenthoutsesteenweg 2,2022-09-03,11:00:00,81,77,4,ECO_300019380
642,Herenthoutsesteenweg 2,2022-09-03,12:00:00,128,118,10,ECO_300019380
642,Herenthoutsesteenweg 2,2022-09-03,13:00:00,126,117,9,ECO_300019380
642,Herenthoutsesteenweg 2,2022-09-03,14:00:00,122,109,13,ECO_300019380
642,Herenthoutsesteenweg 2,2022-09-03,15:00:00,175,169,6,ECO_300019380
642,Herenthoutsesteenweg 2,2022-09-03,16:00:00,188,175,13,ECO_300019380
642,Herenthoutsesteenweg 2,2022-09-03,17:00:00,134,126,8,ECO_300019380
642,Herenthoutsesteenweg 2,2022-09-03,18:00:00,122,107,15,ECO_300019380
642,Herenthoutsesteenweg 2,2022-09-03,19:00:00,107,98,9,ECO_300019380
642,Herenthoutsesteenweg 2,2022-09-03,20:00:00,74,70,4,ECO_300019380
642,Herenthoutsesteenweg 2,2022-09-03,21:00:00,55,51,4,ECO_300019380
642,Herenthoutsesteenweg 2,2022-09-03,22:00:00,47,43,4,ECO_300019380
642,Herenthoutsesteenweg 2,2022-09-03,23:00:00,20,19,1,ECO_300019380
642,Herenthoutsesteenweg 2,2022-09-04,00:00:00,18,11,7,ECO_300019380
642,Herenthoutsesteenweg 2,2022-09-04,01:00:00,15,13,2,ECO_300019380
642,Herenthoutsesteenweg 2,2022-09-04,02:00:00,15,4,11,ECO_300019380
642,Herenthoutsesteenweg 2,2022-09-04,03:00:00,21,17,4,ECO_300019380
642,Herenthoutsesteenweg 2,2022-09-04,04:00:00,5,0,5,ECO_300019380
642,Herenthoutsesteenweg 2,2022-09-04,05:00:00,0,0,0,ECO_300019380
642,Herenthoutsesteenweg 2,2022-09-04,06:00:00,3,1,2,ECO_300019380
642,Herenthoutsesteenweg 2,2022-09-04,07:00:00,1,1,0,ECO_300019380
642,Herenthoutsesteenweg 2,2022-09-04,08:00:00,14,13,1,ECO_300019380
642,Herenthoutsesteenweg 2,2022-09-04,09:00:00,29,28,1,ECO_300019380
642,Herenthoutsesteenweg 2,2022-09-04,10:00:00,77,66,11,ECO_300019380
642,Herenthoutsesteenweg 2,2022-09-04,11:00:00,121,119,2,ECO_300019380
642,Herenthoutsesteenweg 2,2022-09-04,12:00:00,172,158,14,ECO_300019380
642,Herenthoutsesteenweg 2,2022-09-04,13:00:00,121,99,22,ECO_300019380
642,Herenthoutsesteenweg 2,2022-09-04,14:00:00,109,103,6,ECO_300019380
642,Herenthoutsesteenweg 2,2022-09-04,15:00:00,157,144,13,ECO_300019380
642,Herenthoutsesteenweg 2,2022-09-04,16:00:00,186,174,12,ECO_300019380
642,Herenthoutsesteenweg 2,2022-09-04,17:00:00,143,127,16,ECO_300019380
642,Herenthoutsesteenweg 2,2022-09-04,18:00:00,131,121,10,ECO_300019380
642,Herenthoutsesteenweg 2,2022-09-04,19:00:00,108,85,23,ECO_300019380
642,Herenthoutsesteenweg 2,2022-09-04,20:00:00,107,93,14,ECO_300019380
642,Herenthoutsesteenweg 2,2022-09-04,21:00:00,78,70,8,ECO_300019380
642,Herenthoutsesteenweg 2,2022-09-04,22:00:00,37,35,2,ECO_300019380
642,Herenthoutsesteenweg 2,2022-09-04,23:00:00,23,17,6,ECO_300019380
642,Herenthoutsesteenweg 2,2022-09-05,00:00:00,14,9,5,ECO_300019380
642,Herenthoutsesteenweg 2,2022-09-05,01:00:00,4,4,0,ECO_300019380
642,Herenthoutsesteenweg 2,2022-09-05,02:00:00,3,2,1,ECO_300019380
642,Herenthoutsesteenweg 2,2022-09-05,03:00:00,1,1,0,ECO_300019380
642,Herenthoutsesteenweg 2,2022-09-05,04:00:00,1,0,1,ECO_300019380
642,Herenthoutsesteenweg 2,2022-09-05,05:00:00,1,1,0,ECO_300019380
642,Herenthoutsesteenweg 2,2022-09-05,06:00:00,1,1,0,ECO_300019380
642,Herenthoutsesteenweg 2,2022-09-05,07:00:00,31,28,3,ECO_300019380
642,Herenthoutsesteenweg 2,2022-09-05,08:00:00,62,56,6,ECO_300019380
642,Herenthoutsesteenweg 2,2022-09-05,09:00:00,298,290,8,ECO_300019380
642,Herenthoutsesteenweg 2,2022-09-05,10:00:00,633,627,6,ECO_300019380
642,Herenthoutsesteenweg 2,2022-09-05,11:00:00,109,105,4,ECO_300019380
642,Herenthoutsesteenweg 2,2022-09-05,12:00:00,98,92,6,ECO_300019380
642,Herenthoutsesteenweg 2,2022-09-05,13:00:00,95,91,4,ECO_300019380
642,Herenthoutsesteenweg 2,2022-09-05,14:00:00,84,78,6,ECO_300019380
642,Herenthoutsesteenweg 2,2022-09-05,15:00:00,96,88,8,ECO_300019380
642,Herenthoutsesteenweg 2,2022-09-05,16:00:00,144,130,14,ECO_300019380
642,Herenthoutsesteenweg 2,2022-09-05,17:00:00,178,165,13,ECO_300019380
642,Herenthoutsesteenweg 2,2022-09-05,18:00:00,162,148,14,ECO_300019380
642,Herenthoutsesteenweg 2,2022-09-05,19:00:00,145,126,19,ECO_300019380
642,Herenthoutsesteenweg 2,2022-09-05,20:00:00,69,63,6,ECO_300019380
642,Herenthoutsesteenweg 2,2022-09-05,21:00:00,41,41,0,ECO_300019380
642,Herenthoutsesteenweg 2,2022-09-05,22:00:00,27,25,2,ECO_300019380
642,Herenthoutsesteenweg 2,2022-09-05,23:00:00,10,10,0,ECO_300019380
642,Herenthoutsesteenweg 2,2022-09-06,00:00:00,19,16,3,ECO_300019380
642,Herenthoutsesteenweg 2,2022-09-06,01:00:00,4,2,2,ECO_300019380
642,Herenthoutsesteenweg 2,2022-09-06,02:00:00,5,3,2,ECO_300019380
642,Herenthoutsesteenweg 2,2022-09-06,03:00:00,1,1,0,ECO_300019380
642,Herenthoutsesteenweg 2,2022-09-06,04:00:00,1,1,0,ECO_300019380
642,Herenthoutsesteenweg 2,2022-09-06,05:00:00,0,0,0,ECO_300019380
642,Herenthoutsesteenweg 2,2022-09-06,06:00:00,2,1,1,ECO_300019380
642,Herenthoutsesteenweg 2,2022-09-06,07:00:00,21,18,3,ECO_300019380
642,Herenthoutsesteenweg 2,2022-09-06,08:00:00,62,50,12,ECO_300019380
642,Herenthoutsesteenweg 2,2022-09-06,09:00:00,219,213,6,ECO_300019380
642,Herenthoutsesteenweg 2,2022-09-06,10:00:00,655,652,3,ECO_300019380
642,Herenthoutsesteenweg 2,2022-09-06,11:00:00,108,106,2,ECO_300019380
642,Herenthoutsesteenweg 2,2022-09-06,12:00:00,95,94,1,ECO_300019380
642,Herenthoutsesteenweg 2,2022-09-06,13:00:00,96,93,3,ECO_300019380
642,Herenthoutsesteenweg 2,2022-09-06,14:00:00,97,87,10,ECO_300019380
642,Herenthoutsesteenweg 2,2022-09-06,15:00:00,142,129,13,ECO_300019380
642,Herenthoutsesteenweg 2,2022-09-06,16:00:00,174,164,10,ECO_300019380
642,Herenthoutsesteenweg 2,2022-09-06,17:00:00,184,166,18,ECO_300019380
642,Herenthoutsesteenweg 2,2022-09-06,18:00:00,264,244,20,ECO_300019380
642,Herenthoutsesteenweg 2,2022-09-06,19:00:00,140,129,11,ECO_300019380
642,Herenthoutsesteenweg 2,2022-09-06,20:00:00,88,74,14,ECO_300019380
642,Herenthoutsesteenweg 2,2022-09-06,21:00:00,93,88,5,ECO_300019380
642,Herenthoutsesteenweg 2,2022-09-06,22:00:00,42,38,4,ECO_300019380
642,Herenthoutsesteenweg 2,2022-09-06,23:00:00,23,23,0,ECO_300019380
642,Herenthoutsesteenweg 2,2022-09-07,00:00:00,18,16,2,ECO_300019380
642,Herenthoutsesteenweg 2,2022-09-07,01:00:00,4,4,0,ECO_300019380
642,Herenthoutsesteenweg 2,2022-09-07,02:00:00,2,1,1,ECO_300019380
642,Herenthoutsesteenweg 2,2022-09-07,03:00:00,6,0,6,ECO_300019380
642,Herenthoutsesteenweg 2,2022-09-07,04:00:00,1,1,0,ECO_300019380
642,Herenthoutsesteenweg 2,2022-09-07,05:00:00,0,0,0,ECO_300019380
642,Herenthoutsesteenweg 2,2022-09-07,06:00:00,5,3,2,ECO_300019380
642,Herenthoutsesteenweg 2,2022-09-07,07:00:00,27,25,2,ECO_300019380
642,Herenthoutsesteenweg 2,2022-09-07,08:00:00,66,61,5,ECO_300019380
642,Herenthoutsesteenweg 2,2022-09-07,09:00:00,149,146,3,ECO_300019380
642,Herenthoutsesteenweg 2,2022-09-07,10:00:00,234,229,5,ECO_300019380
642,Herenthoutsesteenweg 2,2022-09-07,11:00:00,122,117,5,ECO_300019380
642,Herenthoutsesteenweg 2,2022-09-07,12:00:00,99,97,2,ECO_300019380
642,Herenthoutsesteenweg 2,2022-09-07,13:00:00,84,83,1,ECO_300019380
642,Herenthoutsesteenweg 2,2022-09-07,14:00:00,199,183,16,ECO_300019380
642,Herenthoutsesteenweg 2,2022-09-07,15:00:00,164,149,15,ECO_300019380
642,Herenthoutsesteenweg 2,2022-09-07,16:00:00,201,185,16,ECO_300019380
642,Herenthoutsesteenweg 2,2022-09-07,17:00:00,156,135,21,ECO_300019380
642,Herenthoutsesteenweg 2,2022-09-07,18:00:00,171,163,8,ECO_300019380
642,Herenthoutsesteenweg 2,2022-09-07,19:00:00,120,101,19,ECO_300019380
642,Herenthoutsesteenweg 2,2022-09-07,20:00:00,139,127,12,ECO_300019380
642,Herenthoutsesteenweg 2,2022-09-07,21:00:00,89,77,12,ECO_300019380
642,Herenthoutsesteenweg 2,2022-09-07,22:00:00,58,52,6,ECO_300019380
642,Herenthoutsesteenweg 2,2022-09-07,23:00:00,38,37,1,ECO_300019380
642,Herenthoutsesteenweg 2,2022-09-08,00:00:00,18,16,2,ECO_300019380
642,Herenthoutsesteenweg 2,2022-09-08,01:00:00,2,1,1,ECO_300019380
642,Herenthoutsesteenweg 2,2022-09-08,02:00:00,1,1,0,ECO_300019380
642,Herenthoutsesteenweg 2,2022-09-08,03:00:00,0,0,0,ECO_300019380
642,Herenthoutsesteenweg 2,2022-09-08,04:00:00,1,1,0,ECO_300019380
642,Herenthoutsesteenweg 2,2022-09-08,05:00:00,1,1,0,ECO_300019380
642,Herenthoutsesteenweg 2,2022-09-08,06:00:00,0,0,0,ECO_300019380
642,Herenthoutsesteenweg 2,2022-09-08,07:00:00,14,11,3,ECO_300019380
642,Herenthoutsesteenweg 2,2022-09-08,08:00:00,47,41,6,ECO_300019380
642,Herenthoutsesteenweg 2,2022-09-08,09:00:00,184,180,4,ECO_300019380
642,Herenthoutsesteenweg 2,2022-09-08,10:00:00,578,575,3,ECO_300019380
642,Herenthoutsesteenweg 2,2022-09-08,11:00:00,73,71,2,ECO_300019380
642,Herenthoutsesteenweg 2,2022-09-08,12:00:00,76,71,5,ECO_300019380
642,Herenthoutsesteenweg 2,2022-09-08,13:00:00,64,60,4,ECO_300019380
642,Herenthoutsesteenweg 2,2022-09-08,14:00:00,65,57,8,ECO_300019380
642,Herenthoutsesteenweg 2,2022-09-08,15:00:00,76,68,8,ECO_300019380
642,Herenthoutsesteenweg 2,2022-09-08,16:00:00,74,71,3,ECO_300019380
642,Herenthoutsesteenweg 2,2022-09-08,17:00:00,139,127,12,ECO_300019380
642,Herenthoutsesteenweg 2,2022-09-08,18:00:00,120,116,4,ECO_300019380
642,Herenthoutsesteenweg 2,2022-09-08,19:00:00,90,80,10,ECO_300019380
642,Herenthoutsesteenweg 2,2022-09-08,20:00:00,90,82,8,ECO_300019380
642,Herenthoutsesteenweg 2,2022-09-08,21:00:00,47,41,6,ECO_300019380
642,Herenthoutsesteenweg 2,2022-09-08,22:00:00,19,18,1,ECO_300019380
642,Herenthoutsesteenweg 2,2022-09-08,23:00:00,5,4,1,ECO_300019380
642,Herenthoutsesteenweg 2,2022-09-09,00:00:00,14,14,0,ECO_300019380
642,Herenthoutsesteenweg 2,2022-09-09,01:00:00,6,5,1,ECO_300019380
642,Herenthoutsesteenweg 2,2022-09-09,02:00:00,0,0,0,ECO_300019380
642,Herenthoutsesteenweg 2,2022-09-09,03:00:00,2,1,1,ECO_300019380
642,Herenthoutsesteenweg 2,2022-09-09,04:00:00,1,0,1,ECO_300019380
642,Herenthoutsesteenweg 2,2022-09-09,05:00:00,1,1,0,ECO_300019380
642,Herenthoutsesteenweg 2,2022-09-09,06:00:00,1,1,0,ECO_300019380
642,Herenthoutsesteenweg 2,2022-09-09,07:00:00,22,18,4,ECO_300019380
642,Herenthoutsesteenweg 2,2022-09-09,08:00:00,40,37,3,ECO_300019380
642,Herenthoutsesteenweg 2,2022-09-09,09:00:00,152,148,4,ECO_300019380
642,Herenthoutsesteenweg 2,2022-09-09,10:00:00,574,569,5,ECO_300019380
642,Herenthoutsesteenweg 2,2022-09-09,11:00:00,93,92,1,ECO_300019380
642,Herenthoutsesteenweg 2,2022-09-09,12:00:00,59,58,1,ECO_300019380
642,Herenthoutsesteenweg 2,2022-09-09,13:00:00,33,31,2,ECO_300019380
642,Herenthoutsesteenweg 2,2022-09-09,14:00:00,57,54,3,ECO_300019380
642,Herenthoutsesteenweg 2,2022-09-09,15:00:00,40,36,4,ECO_300019380
642,Herenthoutsesteenweg 2,2022-09-09,16:00:00,68,65,3,ECO_300019380
642,Herenthoutsesteenweg 2,2022-09-09,17:00:00,100,93,7,ECO_300019380
642,Herenthoutsesteenweg 2,2022-09-09,18:00:00,121,108,13,ECO_300019380
642,Herenthoutsesteenweg 2,2022-09-09,19:00:00,69,60,9,ECO_300019380
642,Herenthoutsesteenweg 2,2022-09-09,20:00:00,46,43,3,ECO_300019380
642,Herenthoutsesteenweg 2,2022-09-09,21:00:00,21,20,1,ECO_300019380
642,Herenthoutsesteenweg 2,2022-09-09,22:00:00,23,21,2,ECO_300019380
642,Herenthoutsesteenweg 2,2022-09-09,23:00:00,18,17,1,ECO_300019380
642,Herenthoutsesteenweg 2,2022-09-10,00:00:00,21,17,4,ECO_300019380
642,Herenthoutsesteenweg 2,2022-09-10,01:00:00,9,6,3,ECO_300019380
642,Herenthoutsesteenweg 2,2022-09-10,02:00:00,9,8,1,ECO_300019380
642,Herenthoutsesteenweg 2,2022-09-10,03:00:00,14,14,0,ECO_300019380
642,Herenthoutsesteenweg 2,2022-09-10,04:00:00,6,2,4,ECO_300019380
642,Herenthoutsesteenweg 2,2022-09-10,05:00:00,4,4,0,ECO_300019380
642,Herenthoutsesteenweg 2,2022-09-10,06:00:00,0,0,0,ECO_300019380
642,Herenthoutsesteenweg 2,2022-09-10,07:00:00,4,4,0,ECO_300019380
642,Herenthoutsesteenweg 2,2022-09-10,08:00:00,7,7,0,ECO_300019380
642,Herenthoutsesteenweg 2,2022-09-10,09:00:00,6,5,1,ECO_300019380
642,Herenthoutsesteenweg 2,2022-09-10,10:00:00,16,16,0,ECO_300019380
642,Herenthoutsesteenweg 2,2022-09-10,11:00:00,15,14,1,ECO_300019380
642,Herenthoutsesteenweg 2,2022-09-10,12:00:00,14,14,0,ECO_300019380
642,Herenthoutsesteenweg 2,2022-09-10,13:00:00,27,24,3,ECO_300019380
642,Herenthoutsesteenweg 2,2022-09-10,14:00:00,24,23,1,ECO_300019380
642,Herenthoutsesteenweg 2,2022-09-10,15:00:00,40,35,5,ECO_300019380
642,Herenthoutsesteenweg 2,2022-09-10,16:00:00,39,34,5,ECO_300019380
642,Herenthoutsesteenweg 2,2022-09-10,17:00:00,48,44,4,ECO_300019380
642,Herenthoutsesteenweg 2,2022-09-10,18:00:00,41,40,1,ECO_300019380
642,Herenthoutsesteenweg 2,2022-09-10,19:00:00,49,47,2,ECO_300019380
642,Herenthoutsesteenweg 2,2022-09-10,20:00:00,36,34,2,ECO_300019380
642,Herenthoutsesteenweg 2,2022-09-10,21:00:00,28,26,2,ECO_300019380
642,Herenthoutsesteenweg 2,2022-09-10,22:00:00,42,38,4,ECO_300019380
642,Herenthoutsesteenweg 2,2022-09-10,23:00:00,21,18,3,ECO_300019380
642,Herenthoutsesteenweg 2,2022-09-11,00:00:00,10,7,3,ECO_300019380
642,Herenthoutsesteenweg 2,2022-09-11,01:00:00,4,3,1,ECO_300019380
642,Herenthoutsesteenweg 2,2022-09-11,02:00:00,9,7,2,ECO_300019380
642,Herenthoutsesteenweg 2,2022-09-11,03:00:00,3,2,1,ECO_300019380
642,Herenthoutsesteenweg 2,2022-09-11,04:00:00,7,3,4,ECO_300019380
642,Herenthoutsesteenweg 2,2022-09-11,05:00:00,3,1,2,ECO_300019380
642,Herenthoutsesteenweg 2,2022-09-11,06:00:00,1,0,1,ECO_300019380
642,Herenthoutsesteenweg 2,2022-09-11,07:00:00,3,3,0,ECO_300019380
642,Herenthoutsesteenweg 2,2022-09-11,08:00:00,4,4,0,ECO_300019380
642,Herenthoutsesteenweg 2,2022-09-11,09:00:00,28,26,2,ECO_300019380
642,Herenthoutsesteenweg 2,2022-09-11,10:00:00,65,60,5,ECO_300019380
642,Herenthoutsesteenweg 2,2022-09-11,11:00:00,96,91,5,ECO_300019380
642,Herenthoutsesteenweg 2,2022-09-11,12:00:00,108,101,7,ECO_300019380
642,Herenthoutsesteenweg 2,2022-09-11,13:00:00,126,113,13,ECO_300019380
642,Herenthoutsesteenweg 2,2022-09-11,14:00:00,68,59,9,ECO_300019380
642,Herenthoutsesteenweg 2,2022-09-11,15:00:00,171,159,12,ECO_300019380
642,Herenthoutsesteenweg 2,2022-09-11,16:00:00,167,164,3,ECO_300019380
642,Herenthoutsesteenweg 2,2022-09-11,17:00:00,137,123,14,ECO_300019380
642,Herenthoutsesteenweg 2,2022-09-11,18:00:00,109,95,14,ECO_300019380
642,Herenthoutsesteenweg 2,2022-09-11,19:00:00,100,83,17,ECO_300019380
642,Herenthoutsesteenweg 2,2022-09-11,20:00:00,51,44,7,ECO_300019380
642,Herenthoutsesteenweg 2,2022-09-11,21:00:00,45,40,5,ECO_300019380
642,Herenthoutsesteenweg 2,2022-09-11,22:00:00,19,15,4,ECO_300019380
642,Herenthoutsesteenweg 2,2022-09-11,23:00:00,12,10,2,ECO_300019380
642,Herenthoutsesteenweg 2,2022-09-12,00:00:00,8,8,0,ECO_300019380
642,Herenthoutsesteenweg 2,2022-09-12,01:00:00,1,1,0,ECO_300019380
642,Herenthoutsesteenweg 2,2022-09-12,02:00:00,1,0,1,ECO_300019380
642,Herenthoutsesteenweg 2,2022-09-12,03:00:00,0,0,0,ECO_300019380
642,Herenthoutsesteenweg 2,2022-09-12,04:00:00,0,0,0,ECO_300019380
642,Herenthoutsesteenweg 2,2022-09-12,05:00:00,2,2,0,ECO_300019380
642,Herenthoutsesteenweg 2,2022-09-12,06:00:00,8,7,1,ECO_300019380
642,Herenthoutsesteenweg 2,2022-09-12,07:00:00,24,20,4,ECO_300019380
642,Herenthoutsesteenweg 2,2022-09-12,08:00:00,52,49,3,ECO_300019380
642,Herenthoutsesteenweg 2,2022-09-12,09:00:00,252,244,8,ECO_300019380
642,Herenthoutsesteenweg 2,2022-09-12,10:00:00,654,646,8,ECO_300019380
642,Herenthoutsesteenweg 2,2022-09-12,11:00:00,69,67,2,ECO_300019380
642,Herenthoutsesteenweg 2,2022-09-12,12:00:00,75,73,2,ECO_300019380
642,Herenthoutsesteenweg 2,2022-09-12,13:00:00,82,78,4,ECO_300019380
642,Herenthoutsesteenweg 2,2022-09-12,14:00:00,115,105,10,ECO_300019380
642,Herenthoutsesteenweg 2,2022-09-12,15:00:00,194,181,13,ECO_300019380
642,Herenthoutsesteenweg 2,2022-09-12,16:00:00,188,177,11,ECO_300019380
642,Herenthoutsesteenweg 2,2022-09-12,17:00:00,192,171,21,ECO_300019380
642,Herenthoutsesteenweg 2,2022-09-12,18:00:00,196,179,17,ECO_300019380
642,Herenthoutsesteenweg 2,2022-09-12,19:00:00,150,131,19,ECO_300019380
642,Herenthoutsesteenweg 2,2022-09-12,20:00:00,115,99,16,ECO_300019380
642,Herenthoutsesteenweg 2,2022-09-12,21:00:00,104,91,13,ECO_300019380
642,Herenthoutsesteenweg 2,2022-09-12,22:00:00,41,37,4,ECO_300019380
642,Herenthoutsesteenweg 2,2022-09-12,23:00:00,15,14,1,ECO_300019380
642,Herenthoutsesteenweg 2,2022-09-13,00:00:00,26,18,8,ECO_300019380
642,Herenthoutsesteenweg 2,2022-09-13,01:00:00,7,6,1,ECO_300019380
642,Herenthoutsesteenweg 2,2022-09-13,02:00:00,0,0,0,ECO_300019380
642,Herenthoutsesteenweg 2,2022-09-13,03:00:00,1,1,0,ECO_300019380
642,Herenthoutsesteenweg 2,2022-09-13,04:00:00,1,1,0,ECO_300019380
642,Herenthoutsesteenweg 2,2022-09-13,05:00:00,0,0,0,ECO_300019380
642,Herenthoutsesteenweg 2,2022-09-13,06:00:00,4,4,0,ECO_300019380
642,Herenthoutsesteenweg 2,2022-09-13,07:00:00,16,13,3,ECO_300019380
642,Herenthoutsesteenweg 2,2022-09-13,08:00:00,51,43,8,ECO_300019380
642,Herenthoutsesteenweg 2,2022-09-13,09:00:00,184,178,6,ECO_300019380
642,Herenthoutsesteenweg 2,2022-09-13,10:00:00,652,645,7,ECO_300019380
642,Herenthoutsesteenweg 2,2022-09-13,11:00:00,98,94,4,ECO_300019380
642,Herenthoutsesteenweg 2,2022-09-13,12:00:00,85,80,5,ECO_300019380
642,Herenthoutsesteenweg 2,2022-09-13,13:00:00,65,59,6,ECO_300019380
642,Herenthoutsesteenweg 2,2022-09-13,14:00:00,102,90,12,ECO_300019380
642,Herenthoutsesteenweg 2,2022-09-13,15:00:00,111,98,13,ECO_300019380
642,Herenthoutsesteenweg 2,2022-09-13,16:00:00,134,121,13,ECO_300019380
642,Herenthoutsesteenweg 2,2022-09-13,17:00:00,168,151,17,ECO_300019380
642,Herenthoutsesteenweg 2,2022-09-13,18:00:00,122,107,15,ECO_300019380
642,Herenthoutsesteenweg 2,2022-09-13,19:00:00,76,67,9,ECO_300019380
642,Herenthoutsesteenweg 2,2022-09-13,20:00:00,31,26,5,ECO_300019380
642,Herenthoutsesteenweg 2,2022-09-13,21:00:00,47,41,6,ECO_300019380
642,Herenthoutsesteenweg 2,2022-09-13,22:00:00,29,22,7,ECO_300019380
642,Herenthoutsesteenweg 2,2022-09-13,23:00:00,21,18,3,ECO_300019380
642,Herenthoutsesteenweg 2,2022-09-14,00:00:00,19,18,1,ECO_300019380
642,Herenthoutsesteenweg 2,2022-09-14,01:00:00,3,3,0,ECO_300019380
642,Herenthoutsesteenweg 2,2022-09-14,02:00:00,1,1,0,ECO_300019380
642,Herenthoutsesteenweg 2,2022-09-14,03:00:00,0,0,0,ECO_300019380
642,Herenthoutsesteenweg 2,2022-09-14,04:00:00,2,2,0,ECO_300019380
642,Herenthoutsesteenweg 2,2022-09-14,05:00:00,1,1,0,ECO_300019380
642,Herenthoutsesteenweg 2,2022-09-14,06:00:00,4,4,0,ECO_300019380
642,Herenthoutsesteenweg 2,2022-09-14,07:00:00,13,10,3,ECO_300019380
642,Herenthoutsesteenweg 2,2022-09-14,08:00:00,29,23,6,ECO_300019380
642,Herenthoutsesteenweg 2,2022-09-14,09:00:00,78,77,1,ECO_300019380
642,Herenthoutsesteenweg 2,2022-09-14,10:00:00,267,266,1,ECO_300019380
642,Herenthoutsesteenweg 2,2022-09-14,11:00:00,22,21,1,ECO_300019380
642,Herenthoutsesteenweg 2,2022-09-14,12:00:00,14,14,0,ECO_300019380
642,Herenthoutsesteenweg 2,2022-09-14,13:00:00,14,13,1,ECO_300019380
642,Herenthoutsesteenweg 2,2022-09-14,14:00:00,28,19,9,ECO_300019380
642,Herenthoutsesteenweg 2,2022-09-14,15:00:00,25,21,4,ECO_300019380
642,Herenthoutsesteenweg 2,2022-09-14,16:00:00,38,34,4,ECO_300019380
642,Herenthoutsesteenweg 2,2022-09-14,17:00:00,37,34,3,ECO_300019380
642,Herenthoutsesteenweg 2,2022-09-14,18:00:00,68,64,4,ECO_300019380
642,Herenthoutsesteenweg 2,2022-09-14,19:00:00,55,49,6,ECO_300019380
642,Herenthoutsesteenweg 2,2022-09-14,20:00:00,33,31,2,ECO_300019380
642,Herenthoutsesteenweg 2,2022-09-14,21:00:00,30,27,3,ECO_300019380
642,Herenthoutsesteenweg 2,2022-09-14,22:00:00,13,13,0,ECO_300019380
642,Herenthoutsesteenweg 2,2022-09-14,23:00:00,11,11,0,ECO_300019380
642,Herenthoutsesteenweg 2,2022-09-15,00:00:00,17,16,1,ECO_300019380
642,Herenthoutsesteenweg 2,2022-09-15,01:00:00,0,0,0,ECO_300019380
642,Herenthoutsesteenweg 2,2022-09-15,02:00:00,1,1,0,ECO_300019380
642,Herenthoutsesteenweg 2,2022-09-15,03:00:00,0,0,0,ECO_300019380
642,Herenthoutsesteenweg 2,2022-09-15,04:00:00,1,1,0,ECO_300019380
642,Herenthoutsesteenweg 2,2022-09-15,05:00:00,0,0,0,ECO_300019380
642,Herenthoutsesteenweg 2,2022-09-15,06:00:00,3,3,0,ECO_300019380
642,Herenthoutsesteenweg 2,2022-09-15,07:00:00,21,18,3,ECO_300019380
642,Herenthoutsesteenweg 2,2022-09-15,08:00:00,51,46,5,ECO_300019380
642,Herenthoutsesteenweg 2,2022-09-15,09:00:00,190,184,6,ECO_300019380
642,Herenthoutsesteenweg 2,2022-09-15,10:00:00,580,572,8,ECO_300019380
642,Herenthoutsesteenweg 2,2022-09-15,11:00:00,104,101,3,ECO_300019380
642,Herenthoutsesteenweg 2,2022-09-15,12:00:00,78,76,2,ECO_300019380
642,Herenthoutsesteenweg 2,2022-09-15,13:00:00,53,47,6,ECO_300019380
642,Herenthoutsesteenweg 2,2022-09-15,14:00:00,79,76,3,ECO_300019380
642,Herenthoutsesteenweg 2,2022-09-15,15:00:00,78,74,4,ECO_300019380
642,Herenthoutsesteenweg 2,2022-09-15,16:00:00,95,92,3,ECO_300019380
642,Herenthoutsesteenweg 2,2022-09-15,17:00:00,139,127,12,ECO_300019380
642,Herenthoutsesteenweg 2,2022-09-15,18:00:00,147,141,6,ECO_300019380
642,Herenthoutsesteenweg 2,2022-09-15,19:00:00,104,93,11,ECO_300019380
642,Herenthoutsesteenweg 2,2022-09-15,20:00:00,71,63,8,ECO_300019380
642,Herenthoutsesteenweg 2,2022-09-15,21:00:00,62,57,5,ECO_300019380
642,Herenthoutsesteenweg 2,2022-09-15,22:00:00,26,23,3,ECO_300019380
642,Herenthoutsesteenweg 2,2022-09-15,23:00:00,15,11,4,ECO_300019380
642,Herenthoutsesteenweg 2,2022-09-16,00:00:00,20,20,0,ECO_300019380
642,Herenthoutsesteenweg 2,2022-09-16,01:00:00,2,1,1,ECO_300019380
642,Herenthoutsesteenweg 2,2022-09-16,02:00:00,2,2,0,ECO_300019380
642,Herenthoutsesteenweg 2,2022-09-16,03:00:00,2,2,0,ECO_300019380
642,Herenthoutsesteenweg 2,2022-09-16,04:00:00,1,1,0,ECO_300019380
642,Herenthoutsesteenweg 2,2022-09-16,05:00:00,0,0,0,ECO_300019380
642,Herenthoutsesteenweg 2,2022-09-16,06:00:00,3,3,0,ECO_300019380
642,Herenthoutsesteenweg 2,2022-09-16,07:00:00,21,18,3,ECO_300019380
642,Herenthoutsesteenweg 2,2022-09-16,08:00:00,37,34,3,ECO_300019380
642,Herenthoutsesteenweg 2,2022-09-16,09:00:00,148,146,2,ECO_300019380
642,Herenthoutsesteenweg 2,2022-09-16,10:00:00,573,570,3,ECO_300019380
642,Herenthoutsesteenweg 2,2022-09-16,11:00:00,61,60,1,ECO_300019380
642,Herenthoutsesteenweg 2,2022-09-16,12:00:00,47,45,2,ECO_300019380
642,Herenthoutsesteenweg 2,2022-09-16,13:00:00,31,29,2,ECO_300019380
642,Herenthoutsesteenweg 2,2022-09-16,14:00:00,30,30,0,ECO_300019380
642,Herenthoutsesteenweg 2,2022-09-16,15:00:00,41,37,4,ECO_300019380
642,Herenthoutsesteenweg 2,2022-09-16,16:00:00,67,58,9,ECO_300019380
642,Herenthoutsesteenweg 2,2022-09-16,17:00:00,128,125,3,ECO_300019380
642,Herenthoutsesteenweg 2,2022-09-16,18:00:00,113,109,4,ECO_300019380
642,Herenthoutsesteenweg 2,2022-09-16,19:00:00,53,44,9,ECO_300019380
642,Herenthoutsesteenweg 2,2022-09-16,20:00:00,55,41,14,ECO_300019380
642,Herenthoutsesteenweg 2,2022-09-16,21:00:00,43,34,9,ECO_300019380
642,Herenthoutsesteenweg 2,2022-09-16,22:00:00,32,26,6,ECO_300019380
642,Herenthoutsesteenweg 2,2022-09-16,23:00:00,29,25,4,ECO_300019380
642,Herenthoutsesteenweg 2,2022-09-17,00:00:00,19,17,2,ECO_300019380
642,Herenthoutsesteenweg 2,2022-09-17,01:00:00,18,8,10,ECO_300019380
642,Herenthoutsesteenweg 2,2022-09-17,02:00:00,3,1,2,ECO_300019380
642,Herenthoutsesteenweg 2,2022-09-17,03:00:00,6,5,1,ECO_300019380
642,Herenthoutsesteenweg 2,2022-09-17,04:00:00,10,10,0,ECO_300019380
642,Herenthoutsesteenweg 2,2022-09-17,05:00:00,29,27,2,ECO_300019380
642,Herenthoutsesteenweg 2,2022-09-17,06:00:00,8,7,1,ECO_300019380
642,Herenthoutsesteenweg 2,2022-09-17,07:00:00,3,3,0,ECO_300019380
642,Herenthoutsesteenweg 2,2022-09-17,08:00:00,11,10,1,ECO_300019380
642,Herenthoutsesteenweg 2,2022-09-17,09:00:00,11,10,1,ECO_300019380
642,Herenthoutsesteenweg 2,2022-09-17,10:00:00,37,37,0,ECO_300019380
642,Herenthoutsesteenweg 2,2022-09-17,11:00:00,44,43,1,ECO_300019380
642,Herenthoutsesteenweg 2,2022-09-17,12:00:00,72,71,1,ECO_300019380
642,Herenthoutsesteenweg 2,2022-09-17,13:00:00,53,49,4,ECO_300019380
642,Herenthoutsesteenweg 2,2022-09-17,14:00:00,55,52,3,ECO_300019380
642,Herenthoutsesteenweg 2,2022-09-17,15:00:00,58,48,10,ECO_300019380
642,Herenthoutsesteenweg 2,2022-09-17,16:00:00,62,58,4,ECO_300019380
642,Herenthoutsesteenweg 2,2022-09-17,17:00:00,56,51,5,ECO_300019380
642,Herenthoutsesteenweg 2,2022-09-17,18:00:00,37,33,4,ECO_300019380
642,Herenthoutsesteenweg 2,2022-09-17,19:00:00,23,21,2,ECO_300019380
642,Herenthoutsesteenweg 2,2022-09-17,20:00:00,23,19,4,ECO_300019380
642,Herenthoutsesteenweg 2,2022-09-17,21:00:00,25,21,4,ECO_300019380
642,Herenthoutsesteenweg 2,2022-09-17,22:00:00,15,14,1,ECO_300019380
642,Herenthoutsesteenweg 2,2022-09-17,23:00:00,31,28,3,ECO_300019380
642,Herenthoutsesteenweg 2,2022-09-18,00:00:00,6,5,1,ECO_300019380
642,Herenthoutsesteenweg 2,2022-09-18,01:00:00,9,8,1,ECO_300019380
642,Herenthoutsesteenweg 2,2022-09-18,02:00:00,10,9,1,ECO_300019380
642,Herenthoutsesteenweg 2,2022-09-18,03:00:00,3,2,1,ECO_300019380
642,Herenthoutsesteenweg 2,2022-09-18,04:00:00,2,2,0,ECO_300019380
642,Herenthoutsesteenweg 2,2022-09-18,05:00:00,5,4,1,ECO_300019380
642,Herenthoutsesteenweg 2,2022-09-18,06:00:00,0,0,0,ECO_300019380
642,Herenthoutsesteenweg 2,2022-09-18,07:00:00,0,0,0,ECO_300019380
642,Herenthoutsesteenweg 2,2022-09-18,08:00:00,6,6,0,ECO_300019380
642,Herenthoutsesteenweg 2,2022-09-18,09:00:00,13,11,2,ECO_300019380
642,Herenthoutsesteenweg 2,2022-09-18,10:00:00,24,22,2,ECO_300019380
642,Herenthoutsesteenweg 2,2022-09-18,11:00:00,36,35,1,ECO_300019380
642,Herenthoutsesteenweg 2,2022-09-18,12:00:00,43,41,2,ECO_300019380
642,Herenthoutsesteenweg 2,2022-09-18,13:00:00,19,17,2,ECO_300019380
642,Herenthoutsesteenweg 2,2022-09-18,14:00:00,18,15,3,ECO_300019380
642,Herenthoutsesteenweg 2,2022-09-18,15:00:00,13,12,1,ECO_300019380
642,Herenthoutsesteenweg 2,2022-09-18,16:00:00,20,19,1,ECO_300019380
642,Herenthoutsesteenweg 2,2022-09-18,17:00:00,8,6,2,ECO_300019380
642,Herenthoutsesteenweg 2,2022-09-18,18:00:00,11,11,0,ECO_300019380
642,Herenthoutsesteenweg 2,2022-09-18,19:00:00,15,11,4,ECO_300019380
642,Herenthoutsesteenweg 2,2022-09-18,20:00:00,5,5,0,ECO_300019380
642,Herenthoutsesteenweg 2,2022-09-18,21:00:00,10,8,2,ECO_300019380
642,Herenthoutsesteenweg 2,2022-09-18,22:00:00,5,4,1,ECO_300019380
642,Herenthoutsesteenweg 2,2022-09-18,23:00:00,5,4,1,ECO_300019380
642,Herenthoutsesteenweg 2,2022-09-19,00:00:00,4,3,1,ECO_300019380
642,Herenthoutsesteenweg 2,2022-09-19,01:00:00,3,3,0,ECO_300019380
642,Herenthoutsesteenweg 2,2022-09-19,02:00:00,0,0,0,ECO_300019380
642,Herenthoutsesteenweg 2,2022-09-19,03:00:00,0,0,0,ECO_300019380
642,Herenthoutsesteenweg 2,2022-09-19,04:00:00,0,0,0,ECO_300019380
642,Herenthoutsesteenweg 2,2022-09-19,05:00:00,0,0,0,ECO_300019380
642,Herenthoutsesteenweg 2,2022-09-19,06:00:00,1,1,0,ECO_300019380
642,Herenthoutsesteenweg 2,2022-09-19,07:00:00,20,16,4,ECO_300019380
642,Herenthoutsesteenweg 2,2022-09-19,08:00:00,46,40,6,ECO_300019380
642,Herenthoutsesteenweg 2,2022-09-19,09:00:00,175,168,7,ECO_300019380
642,Herenthoutsesteenweg 2,2022-09-19,10:00:00,617,608,9,ECO_300019380
642,Herenthoutsesteenweg 2,2022-09-19,11:00:00,83,80,3,ECO_300019380
642,Herenthoutsesteenweg 2,2022-09-19,12:00:00,57,52,5,ECO_300019380
642,Herenthoutsesteenweg 2,2022-09-19,13:00:00,40,37,3,ECO_300019380
642,Herenthoutsesteenweg 2,2022-09-19,14:00:00,72,67,5,ECO_300019380
642,Herenthoutsesteenweg 2,2022-09-19,15:00:00,98,89,9,ECO_300019380
642,Herenthoutsesteenweg 2,2022-09-19,16:00:00,99,95,4,ECO_300019380
642,Herenthoutsesteenweg 2,2022-09-19,17:00:00,126,111,15,ECO_300019380
642,Herenthoutsesteenweg 2,2022-09-19,18:00:00,149,135,14,ECO_300019380
642,Herenthoutsesteenweg 2,2022-09-19,19:00:00,97,86,11,ECO_300019380
642,Herenthoutsesteenweg 2,2022-09-19,20:00:00,55,50,5,ECO_300019380
642,Herenthoutsesteenweg 2,2022-09-19,21:00:00,52,49,3,ECO_300019380
642,Herenthoutsesteenweg 2,2022-09-19,22:00:00,19,17,2,ECO_300019380
642,Herenthoutsesteenweg 2,2022-09-19,23:00:00,14,14,0,ECO_300019380
642,Herenthoutsesteenweg 2,2022-09-20,00:00:00,18,16,2,ECO_300019380
642,Herenthoutsesteenweg 2,2022-09-20,01:00:00,0,0,0,ECO_300019380
642,Herenthoutsesteenweg 2,2022-09-20,02:00:00,5,5,0,ECO_300019380
642,Herenthoutsesteenweg 2,2022-09-20,03:00:00,0,0,0,ECO_300019380
642,Herenthoutsesteenweg 2,2022-09-20,04:00:00,1,1,0,ECO_300019380
642,Herenthoutsesteenweg 2,2022-09-20,05:00:00,0,0,0,ECO_300019380
642,Herenthoutsesteenweg 2,2022-09-20,06:00:00,4,4,0,ECO_300019380
642,Herenthoutsesteenweg 2,2022-09-20,07:00:00,24,18,6,ECO_300019380
642,Herenthoutsesteenweg 2,2022-09-20,08:00:00,64,56,8,ECO_300019380
642,Herenthoutsesteenweg 2,2022-09-20,09:00:00,197,190,7,ECO_300019380
642,Herenthoutsesteenweg 2,2022-09-20,10:00:00,603,594,9,ECO_300019380
642,Herenthoutsesteenweg 2,2022-09-20,11:00:00,76,71,5,ECO_300019380
642,Herenthoutsesteenweg 2,2022-09-20,12:00:00,68,62,6,ECO_300019380
642,Herenthoutsesteenweg 2,2022-09-20,13:00:00,51,45,6,ECO_300019380
642,Herenthoutsesteenweg 2,2022-09-20,14:00:00,93,88,5,ECO_300019380
642,Herenthoutsesteenweg 2,2022-09-20,15:00:00,108,98,10,ECO_300019380
642,Herenthoutsesteenweg 2,2022-09-20,16:00:00,109,104,5,ECO_300019380
642,Herenthoutsesteenweg 2,2022-09-20,17:00:00,124,117,7,ECO_300019380
642,Herenthoutsesteenweg 2,2022-09-20,18:00:00,142,131,11,ECO_300019380
642,Herenthoutsesteenweg 2,2022-09-20,19:00:00,128,117,11,ECO_300019380
642,Herenthoutsesteenweg 2,2022-09-20,20:00:00,56,54,2,ECO_300019380
642,Herenthoutsesteenweg 2,2022-09-20,21:00:00,41,37,4,ECO_300019380
642,Herenthoutsesteenweg 2,2022-09-20,22:00:00,26,23,3,ECO_300019380
642,Herenthoutsesteenweg 2,2022-09-20,23:00:00,13,13,0,ECO_300019380
642,Herenthoutsesteenweg 2,2022-09-21,00:00:00,21,16,5,ECO_300019380
642,Herenthoutsesteenweg 2,2022-09-21,01:00:00,2,1,1,ECO_300019380
642,Herenthoutsesteenweg 2,2022-09-21,02:00:00,0,0,0,ECO_300019380
642,Herenthoutsesteenweg 2,2022-09-21,03:00:00,3,3,0,ECO_300019380
642,Herenthoutsesteenweg 2,2022-09-21,04:00:00,2,2,0,ECO_300019380
642,Herenthoutsesteenweg 2,2022-09-21,05:00:00,2,1,1,ECO_300019380
642,Herenthoutsesteenweg 2,2022-09-21,06:00:00,2,2,0,ECO_300019380
642,Herenthoutsesteenweg 2,2022-09-21,07:00:00,25,24,1,ECO_300019380
642,Herenthoutsesteenweg 2,2022-09-21,08:00:00,58,52,6,ECO_300019380
642,Herenthoutsesteenweg 2,2022-09-21,09:00:00,188,183,5,ECO_300019380
642,Herenthoutsesteenweg 2,2022-09-21,10:00:00,656,652,4,ECO_300019380
642,Herenthoutsesteenweg 2,2022-09-21,11:00:00,95,94,1,ECO_300019380
642,Herenthoutsesteenweg 2,2022-09-21,12:00:00,94,89,5,ECO_300019380
642,Herenthoutsesteenweg 2,2022-09-21,13:00:00,70,68,2,ECO_300019380
642,Herenthoutsesteenweg 2,2022-09-21,14:00:00,163,145,18,ECO_300019380
642,Herenthoutsesteenweg 2,2022-09-21,15:00:00,146,135,11,ECO_300019380
642,Herenthoutsesteenweg 2,2022-09-21,16:00:00,154,141,13,ECO_300019380
642,Herenthoutsesteenweg 2,2022-09-21,17:00:00,114,101,13,ECO_300019380
642,Herenthoutsesteenweg 2,2022-09-21,18:00:00,149,140,9,ECO_300019380
642,Herenthoutsesteenweg 2,2022-09-21,19:00:00,109,99,10,ECO_300019380
642,Herenthoutsesteenweg 2,2022-09-21,20:00:00,88,75,13,ECO_300019380
642,Herenthoutsesteenweg 2,2022-09-21,21:00:00,60,52,8,ECO_300019380
642,Herenthoutsesteenweg 2,2022-09-21,22:00:00,31,29,2,ECO_300019380
642,Herenthoutsesteenweg 2,2022-09-21,23:00:00,20,18,2,ECO_300019380
642,Herenthoutsesteenweg 2,2022-09-22,00:00:00,21,18,3,ECO_300019380
642,Herenthoutsesteenweg 2,2022-09-22,01:00:00,3,3,0,ECO_300019380
642,Herenthoutsesteenweg 2,2022-09-22,02:00:00,0,0,0,ECO_300019380
642,Herenthoutsesteenweg 2,2022-09-22,03:00:00,0,0,0,ECO_300019380
642,Herenthoutsesteenweg 2,2022-09-22,04:00:00,1,1,0,ECO_300019380
642,Herenthoutsesteenweg 2,2022-09-22,05:00:00,0,0,0,ECO_300019380
642,Herenthoutsesteenweg 2,2022-09-22,06:00:00,4,4,0,ECO_300019380
642,Herenthoutsesteenweg 2,2022-09-22,07:00:00,22,22,0,ECO_300019380
642,Herenthoutsesteenweg 2,2022-09-22,08:00:00,52,47,5,ECO_300019380
642,Herenthoutsesteenweg 2,2022-09-22,09:00:00,189,177,12,ECO_300019380
642,Herenthoutsesteenweg 2,2022-09-22,10:00:00,658,651,7,ECO_300019380
642,Herenthoutsesteenweg 2,2022-09-22,11:00:00,72,70,2,ECO_300019380
642,Herenthoutsesteenweg 2,2022-09-22,12:00:00,101,93,8,ECO_300019380
642,Herenthoutsesteenweg 2,2022-09-22,13:00:00,71,67,4,ECO_300019380
642,Herenthoutsesteenweg 2,2022-09-22,14:00:00,121,113,8,ECO_300019380
642,Herenthoutsesteenweg 2,2022-09-22,15:00:00,152,144,8,ECO_300019380
642,Herenthoutsesteenweg 2,2022-09-22,16:00:00,158,132,26,ECO_300019380
642,Herenthoutsesteenweg 2,2022-09-22,17:00:00,170,158,12,ECO_300019380
642,Herenthoutsesteenweg 2,2022-09-22,18:00:00,193,171,22,ECO_300019380
642,Herenthoutsesteenweg 2,2022-09-22,19:00:00,123,109,14,ECO_300019380
642,Herenthoutsesteenweg 2,2022-09-22,20:00:00,93,83,10,ECO_300019380
642,Herenthoutsesteenweg 2,2022-09-22,21:00:00,59,55,4,ECO_300019380
642,Herenthoutsesteenweg 2,2022-09-22,22:00:00,27,26,1,ECO_300019380
642,Herenthoutsesteenweg 2,2022-09-22,23:00:00,19,18,1,ECO_300019380
642,Herenthoutsesteenweg 2,2022-09-23,00:00:00,22,20,2,ECO_300019380
642,Herenthoutsesteenweg 2,2022-09-23,01:00:00,3,3,0,ECO_300019380
642,Herenthoutsesteenweg 2,2022-09-23,02:00:00,0,0,0,ECO_300019380
642,Herenthoutsesteenweg 2,2022-09-23,03:00:00,0,0,0,ECO_300019380
642,Herenthoutsesteenweg 2,2022-09-23,04:00:00,0,0,0,ECO_300019380
642,Herenthoutsesteenweg 2,2022-09-23,05:00:00,0,0,0,ECO_300019380
642,Herenthoutsesteenweg 2,2022-09-23,06:00:00,3,3,0,ECO_300019380
642,Herenthoutsesteenweg 2,2022-09-23,07:00:00,19,18,1,ECO_300019380
642,Herenthoutsesteenweg 2,2022-09-23,08:00:00,37,31,6,ECO_300019380
642,Herenthoutsesteenweg 2,2022-09-23,09:00:00,141,138,3,ECO_300019380
642,Herenthoutsesteenweg 2,2022-09-23,10:00:00,608,598,10,ECO_300019380
642,Herenthoutsesteenweg 2,2022-09-23,11:00:00,124,123,1,ECO_300019380
642,Herenthoutsesteenweg 2,2022-09-23,12:00:00,104,102,2,ECO_300019380
642,Herenthoutsesteenweg 2,2022-09-23,13:00:00,98,93,5,ECO_300019380
642,Herenthoutsesteenweg 2,2022-09-23,14:00:00,91,82,9,ECO_300019380
642,Herenthoutsesteenweg 2,2022-09-23,15:00:00,99,87,12,ECO_300019380
642,Herenthoutsesteenweg 2,2022-09-23,16:00:00,120,109,11,ECO_300019380
642,Herenthoutsesteenweg 2,2022-09-23,17:00:00,152,143,9,ECO_300019380
642,Herenthoutsesteenweg 2,2022-09-23,18:00:00,136,126,10,ECO_300019380
642,Herenthoutsesteenweg 2,2022-09-23,19:00:00,90,82,8,ECO_300019380
642,Herenthoutsesteenweg 2,2022-09-23,20:00:00,46,45,1,ECO_300019380
642,Herenthoutsesteenweg 2,2022-09-23,21:00:00,33,25,8,ECO_300019380
642,Herenthoutsesteenweg 2,2022-09-23,22:00:00,19,19,0,ECO_300019380
642,Herenthoutsesteenweg 2,2022-09-23,23:00:00,11,11,0,ECO_300019380
642,Herenthoutsesteenweg 2,2022-09-24,00:00:00,18,15,3,ECO_300019380
642,Herenthoutsesteenweg 2,2022-09-24,01:00:00,9,7,2,ECO_300019380
642,Herenthoutsesteenweg 2,2022-09-24,02:00:00,7,6,1,ECO_300019380
642,Herenthoutsesteenweg 2,2022-09-24,03:00:00,7,7,0,ECO_300019380
642,Herenthoutsesteenweg 2,2022-09-24,04:00:00,2,2,0,ECO_300019380
642,Herenthoutsesteenweg 2,2022-09-24,05:00:00,0,0,0,ECO_300019380
642,Herenthoutsesteenweg 2,2022-09-24,06:00:00,0,0,0,ECO_300019380
642,Herenthoutsesteenweg 2,2022-09-24,07:00:00,4,4,0,ECO_300019380
642,Herenthoutsesteenweg 2,2022-09-24,08:00:00,10,10,0,ECO_300019380
642,Herenthoutsesteenweg 2,2022-09-24,09:00:00,4,4,0,ECO_300019380
642,Herenthoutsesteenweg 2,2022-09-24,10:00:00,23,23,0,ECO_300019380
642,Herenthoutsesteenweg 2,2022-09-24,11:00:00,19,19,0,ECO_300019380
642,Herenthoutsesteenweg 2,2022-09-24,12:00:00,11,10,1,ECO_300019380
642,Herenthoutsesteenweg 2,2022-09-24,13:00:00,18,16,2,ECO_300019380
642,Herenthoutsesteenweg 2,2022-09-24,14:00:00,16,15,1,ECO_300019380
642,Herenthoutsesteenweg 2,2022-09-24,15:00:00,32,32,0,ECO_300019380
642,Herenthoutsesteenweg 2,2022-09-24,16:00:00,16,15,1,ECO_300019380
642,Herenthoutsesteenweg 2,2022-09-24,17:00:00,28,21,7,ECO_300019380
642,Herenthoutsesteenweg 2,2022-09-24,18:00:00,36,34,2,ECO_300019380
642,Herenthoutsesteenweg 2,2022-09-24,19:00:00,31,26,5,ECO_300019380
642,Herenthoutsesteenweg 2,2022-09-24,20:00:00,44,35,9,ECO_300019380
642,Herenthoutsesteenweg 2,2022-09-24,21:00:00,19,18,1,ECO_300019380
642,Herenthoutsesteenweg 2,2022-09-24,22:00:00,19,16,3,ECO_300019380
642,Herenthoutsesteenweg 2,2022-09-24,23:00:00,29,24,5,ECO_300019380
642,Herenthoutsesteenweg 2,2022-09-25,00:00:00,12,12,0,ECO_300019380
642,Herenthoutsesteenweg 2,2022-09-25,01:00:00,9,8,1,ECO_300019380
642,Herenthoutsesteenweg 2,2022-09-25,02:00:00,4,1,3,ECO_300019380
642,Herenthoutsesteenweg 2,2022-09-25,03:00:00,0,0,0,ECO_300019380
642,Herenthoutsesteenweg 2,2022-09-25,04:00:00,2,1,1,ECO_300019380
642,Herenthoutsesteenweg 2,2022-09-25,05:00:00,8,2,6,ECO_300019380
642,Herenthoutsesteenweg 2,2022-09-25,06:00:00,2,0,2,ECO_300019380
642,Herenthoutsesteenweg 2,2022-09-25,07:00:00,4,4,0,ECO_300019380
642,Herenthoutsesteenweg 2,2022-09-25,08:00:00,4,3,1,ECO_300019380
642,Herenthoutsesteenweg 2,2022-09-25,09:00:00,19,18,1,ECO_300019380
642,Herenthoutsesteenweg 2,2022-09-25,10:00:00,36,33,3,ECO_300019380
642,Herenthoutsesteenweg 2,2022-09-25,11:00:00,105,104,1,ECO_300019380
642,Herenthoutsesteenweg 2,2022-09-25,12:00:00,139,126,13,ECO_300019380
642,Herenthoutsesteenweg 2,2022-09-25,13:00:00,114,89,25,ECO_300019380
642,Herenthoutsesteenweg 2,2022-09-25,14:00:00,98,81,17,ECO_300019380
642,Herenthoutsesteenweg 2,2022-09-25,15:00:00,125,106,19,ECO_300019380
642,Herenthoutsesteenweg 2,2022-09-25,16:00:00,149,140,9,ECO_300019380
642,Herenthoutsesteenweg 2,2022-09-25,17:00:00,95,85,10,ECO_300019380
642,Herenthoutsesteenweg 2,2022-09-25,18:00:00,62,56,6,ECO_300019380
642,Herenthoutsesteenweg 2,2022-09-25,19:00:00,57,53,4,ECO_300019380
642,Herenthoutsesteenweg 2,2022-09-25,20:00:00,47,46,1,ECO_300019380
642,Herenthoutsesteenweg 2,2022-09-25,21:00:00,22,21,1,ECO_300019380
642,Herenthoutsesteenweg 2,2022-09-25,22:00:00,17,15,2,ECO_300019380
642,Herenthoutsesteenweg 2,2022-09-25,23:00:00,10,8,2,ECO_300019380
642,Herenthoutsesteenweg 2,2022-09-26,00:00:00,5,2,3,ECO_300019380
642,Herenthoutsesteenweg 2,2022-09-26,01:00:00,0,0,0,ECO_300019380
642,Herenthoutsesteenweg 2,2022-09-26,02:00:00,2,2,0,ECO_300019380
642,Herenthoutsesteenweg 2,2022-09-26,03:00:00,0,0,0,ECO_300019380
642,Herenthoutsesteenweg 2,2022-09-26,04:00:00,0,0,0,ECO_300019380
642,Herenthoutsesteenweg 2,2022-09-26,05:00:00,0,0,0,ECO_300019380
642,Herenthoutsesteenweg 2,2022-09-26,06:00:00,3,3,0,ECO_300019380
642,Herenthoutsesteenweg 2,2022-09-26,07:00:00,21,17,4,ECO_300019380
642,Herenthoutsesteenweg 2,2022-09-26,08:00:00,35,33,2,ECO_300019380
642,Herenthoutsesteenweg 2,2022-09-26,09:00:00,123,121,2,ECO_300019380
642,Herenthoutsesteenweg 2,2022-09-26,10:00:00,455,451,4,ECO_300019380
642,Herenthoutsesteenweg 2,2022-09-26,11:00:00,63,63,0,ECO_300019380
642,Herenthoutsesteenweg 2,2022-09-26,12:00:00,49,49,0,ECO_300019380
642,Herenthoutsesteenweg 2,2022-09-26,13:00:00,26,24,2,ECO_300019380
642,Herenthoutsesteenweg 2,2022-09-26,14:00:00,25,24,1,ECO_300019380
642,Herenthoutsesteenweg 2,2022-09-26,15:00:00,23,21,2,ECO_300019380
642,Herenthoutsesteenweg 2,2022-09-26,16:00:00,38,37,1,ECO_300019380
642,Herenthoutsesteenweg 2,2022-09-26,17:00:00,45,36,9,ECO_300019380
642,Herenthoutsesteenweg 2,2022-09-26,18:00:00,57,51,6,ECO_300019380
642,Herenthoutsesteenweg 2,2022-09-26,19:00:00,49,44,5,ECO_300019380
642,Herenthoutsesteenweg 2,2022-09-26,20:00:00,25,23,2,ECO_300019380
642,Herenthoutsesteenweg 2,2022-09-26,21:00:00,20,20,0,ECO_300019380
642,Herenthoutsesteenweg 2,2022-09-26,22:00:00,9,9,0,ECO_300019380
642,Herenthoutsesteenweg 2,2022-09-26,23:00:00,12,10,2,ECO_300019380
642,Herenthoutsesteenweg 2,2022-09-27,00:00:00,12,12,0,ECO_300019380
642,Herenthoutsesteenweg 2,2022-09-27,01:00:00,1,0,1,ECO_300019380
642,Herenthoutsesteenweg 2,2022-09-27,02:00:00,0,0,0,ECO_300019380
642,Herenthoutsesteenweg 2,2022-09-27,03:00:00,2,2,0,ECO_300019380
642,Herenthoutsesteenweg 2,2022-09-27,04:00:00,1,1,0,ECO_300019380
642,Herenthoutsesteenweg 2,2022-09-27,05:00:00,1,1,0,ECO_300019380
642,Herenthoutsesteenweg 2,2022-09-27,06:00:00,2,2,0,ECO_300019380
642,Herenthoutsesteenweg 2,2022-09-27,07:00:00,14,11,3,ECO_300019380
642,Herenthoutsesteenweg 2,2022-09-27,08:00:00,33,27,6,ECO_300019380
642,Herenthoutsesteenweg 2,2022-09-27,09:00:00,86,84,2,ECO_300019380
642,Herenthoutsesteenweg 2,2022-09-27,10:00:00,305,301,4,ECO_300019380
642,Herenthoutsesteenweg 2,2022-09-27,11:00:00,53,52,1,ECO_300019380
642,Herenthoutsesteenweg 2,2022-09-27,12:00:00,35,32,3,ECO_300019380
642,Herenthoutsesteenweg 2,2022-09-27,13:00:00,17,16,1,ECO_300019380
642,Herenthoutsesteenweg 2,2022-09-27,14:00:00,36,27,9,ECO_300019380
642,Herenthoutsesteenweg 2,2022-09-27,15:00:00,39,35,4,ECO_300019380
642,Herenthoutsesteenweg 2,2022-09-27,16:00:00,49,45,4,ECO_300019380
642,Herenthoutsesteenweg 2,2022-09-27,17:00:00,56,49,7,ECO_300019380
642,Herenthoutsesteenweg 2,2022-09-27,18:00:00,76,65,11,ECO_300019380
642,Herenthoutsesteenweg 2,2022-09-27,19:00:00,49,43,6,ECO_300019380
642,Herenthoutsesteenweg 2,2022-09-27,20:00:00,33,28,5,ECO_300019380
642,Herenthoutsesteenweg 2,2022-09-27,21:00:00,32,30,2,ECO_300019380
642,Herenthoutsesteenweg 2,2022-09-27,22:00:00,13,10,3,ECO_300019380
642,Herenthoutsesteenweg 2,2022-09-27,23:00:00,6,4,2,ECO_300019380
642,Herenthoutsesteenweg 2,2022-09-28,00:00:00,11,10,1,ECO_300019380
642,Herenthoutsesteenweg 2,2022-09-28,01:00:00,3,2,1,ECO_300019380
642,Herenthoutsesteenweg 2,2022-09-28,02:00:00,1,1,0,ECO_300019380
642,Herenthoutsesteenweg 2,2022-09-28,03:00:00,0,0,0,ECO_300019380
642,Herenthoutsesteenweg 2,2022-09-28,04:00:00,2,2,0,ECO_300019380
642,Herenthoutsesteenweg 2,2022-09-28,05:00:00,0,0,0,ECO_300019380
642,Herenthoutsesteenweg 2,2022-09-28,06:00:00,6,6,0,ECO_300019380
642,Herenthoutsesteenweg 2,2022-09-28,07:00:00,22,19,3,ECO_300019380
642,Herenthoutsesteenweg 2,2022-09-28,08:00:00,42,36,6,ECO_300019380
642,Herenthoutsesteenweg 2,2022-09-28,09:00:00,124,117,7,ECO_300019380
642,Herenthoutsesteenweg 2,2022-09-28,10:00:00,470,465,5,ECO_300019380
642,Herenthoutsesteenweg 2,2022-09-28,11:00:00,70,67,3,ECO_300019380
642,Herenthoutsesteenweg 2,2022-09-28,12:00:00,59,57,2,ECO_300019380
642,Herenthoutsesteenweg 2,2022-09-28,13:00:00,56,51,5,ECO_300019380
642,Herenthoutsesteenweg 2,2022-09-28,14:00:00,103,96,7,ECO_300019380
642,Herenthoutsesteenweg 2,2022-09-28,15:00:00,79,72,7,ECO_300019380
642,Herenthoutsesteenweg 2,2022-09-28,16:00:00,85,79,6,ECO_300019380
642,Herenthoutsesteenweg 2,2022-09-28,17:00:00,66,59,7,ECO_300019380
642,Herenthoutsesteenweg 2,2022-09-28,18:00:00,104,96,8,ECO_300019380
642,Herenthoutsesteenweg 2,2022-09-28,19:00:00,87,79,8,ECO_300019380
642,Herenthoutsesteenweg 2,2022-09-28,20:00:00,46,37,9,ECO_300019380
642,Herenthoutsesteenweg 2,2022-09-28,21:00:00,43,36,7,ECO_300019380
642,Herenthoutsesteenweg 2,2022-09-28,22:00:00,28,25,3,ECO_300019380
642,Herenthoutsesteenweg 2,2022-09-28,23:00:00,19,17,2,ECO_300019380
642,Herenthoutsesteenweg 2,2022-09-29,00:00:00,12,11,1,ECO_300019380
642,Herenthoutsesteenweg 2,2022-09-29,01:00:00,2,2,0,ECO_300019380
642,Herenthoutsesteenweg 2,2022-09-29,02:00:00,5,5,0,ECO_300019380
642,Herenthoutsesteenweg 2,2022-09-29,03:00:00,1,0,1,ECO_300019380
642,Herenthoutsesteenweg 2,2022-09-29,04:00:00,0,0,0,ECO_300019380
642,Herenthoutsesteenweg 2,2022-09-29,05:00:00,0,0,0,ECO_300019380
642,Herenthoutsesteenweg 2,2022-09-29,06:00:00,3,3,0,ECO_300019380
642,Herenthoutsesteenweg 2,2022-09-29,07:00:00,16,14,2,ECO_300019380
642,Herenthoutsesteenweg 2,2022-09-29,08:00:00,52,48,4,ECO_300019380
642,Herenthoutsesteenweg 2,2022-09-29,09:00:00,146,140,6,ECO_300019380
642,Herenthoutsesteenweg 2,2022-09-29,10:00:00,573,569,4,ECO_300019380
642,Herenthoutsesteenweg 2,2022-09-29,11:00:00,69,68,1,ECO_300019380
642,Herenthoutsesteenweg 2,2022-09-29,12:00:00,60,57,3,ECO_300019380
642,Herenthoutsesteenweg 2,2022-09-29,13:00:00,61,58,3,ECO_300019380
642,Herenthoutsesteenweg 2,2022-09-29,14:00:00,79,75,4,ECO_300019380
642,Herenthoutsesteenweg 2,2022-09-29,15:00:00,107,104,3,ECO_300019380
642,Herenthoutsesteenweg 2,2022-09-29,16:00:00,132,113,19,ECO_300019380
642,Herenthoutsesteenweg 2,2022-09-29,17:00:00,143,124,19,ECO_300019380
642,Herenthoutsesteenweg 2,2022-09-29,18:00:00,142,132,10,ECO_300019380
642,Herenthoutsesteenweg 2,2022-09-29,19:00:00,119,106,13,ECO_300019380
642,Herenthoutsesteenweg 2,2022-09-29,20:00:00,68,58,10,ECO_300019380
642,Herenthoutsesteenweg 2,2022-09-29,21:00:00,44,43,1,ECO_300019380
642,Herenthoutsesteenweg 2,2022-09-29,22:00:00,9,9,0,ECO_300019380
642,Herenthoutsesteenweg 2,2022-09-29,23:00:00,15,11,4,ECO_300019380
642,Herenthoutsesteenweg 2,2022-09-30,00:00:00,15,14,1,ECO_300019380
642,Herenthoutsesteenweg 2,2022-09-30,01:00:00,8,5,3,ECO_300019380
642,Herenthoutsesteenweg 2,2022-09-30,02:00:00,3,2,1,ECO_300019380
642,Herenthoutsesteenweg 2,2022-09-30,03:00:00,0,0,0,ECO_300019380
642,Herenthoutsesteenweg 2,2022-09-30,04:00:00,0,0,0,ECO_300019380
642,Herenthoutsesteenweg 2,2022-09-30,05:00:00,0,0,0,ECO_300019380
642,Herenthoutsesteenweg 2,2022-09-30,06:00:00,2,2,0,ECO_300019380
642,Herenthoutsesteenweg 2,2022-09-30,07:00:00,17,17,0,ECO_300019380
642,Herenthoutsesteenweg 2,2022-09-30,08:00:00,41,40,1,ECO_300019380
642,Herenthoutsesteenweg 2,2022-09-30,09:00:00,125,122,3,ECO_300019380
642,Herenthoutsesteenweg 2,2022-09-30,10:00:00,522,516,6,ECO_300019380
642,Herenthoutsesteenweg 2,2022-09-30,11:00:00,102,100,2,ECO_300019380
642,Herenthoutsesteenweg 2,2022-09-30,12:00:00,101,100,1,ECO_300019380
642,Herenthoutsesteenweg 2,2022-09-30,13:00:00,71,68,3,ECO_300019380
642,Herenthoutsesteenweg 2,2022-09-30,14:00:00,89,84,5,ECO_300019380
642,Herenthoutsesteenweg 2,2022-09-30,15:00:00,127,120,7,ECO_300019380
642,Herenthoutsesteenweg 2,2022-09-30,16:00:00,166,155,11,ECO_300019380
642,Herenthoutsesteenweg 2,2022-09-30,17:00:00,148,137,11,ECO_300019380
642,Herenthoutsesteenweg 2,2022-09-30,18:00:00,136,128,8,ECO_300019380
642,Herenthoutsesteenweg 2,2022-09-30,19:00:00,81,66,15,ECO_300019380
642,Herenthoutsesteenweg 2,2022-09-30,20:00:00,70,65,5,ECO_300019380
642,Herenthoutsesteenweg 2,2022-09-30,21:00:00,41,40,1,ECO_300019380
642,Herenthoutsesteenweg 2,2022-09-30,22:00:00,32,27,5,ECO_300019380
642,Herenthoutsesteenweg 2,2022-09-30,23:00:00,13,13,0,ECO_300019380
642,Herenthoutsesteenweg 2,2022-10-01,00:00:00,17,17,0,ECO_300019380
642,Herenthoutsesteenweg 2,2022-10-01,01:00:00,8,7,1,ECO_300019380
642,Herenthoutsesteenweg 2,2022-10-01,02:00:00,9,6,3,ECO_300019380
642,Herenthoutsesteenweg 2,2022-10-01,03:00:00,5,4,1,ECO_300019380
642,Herenthoutsesteenweg 2,2022-10-01,04:00:00,2,0,2,ECO_300019380
642,Herenthoutsesteenweg 2,2022-10-01,05:00:00,1,1,0,ECO_300019380
642,Herenthoutsesteenweg 2,2022-10-01,06:00:00,0,0,0,ECO_300019380
642,Herenthoutsesteenweg 2,2022-10-01,07:00:00,3,3,0,ECO_300019380
642,Herenthoutsesteenweg 2,2022-10-01,08:00:00,11,11,0,ECO_300019380
642,Herenthoutsesteenweg 2,2022-10-01,09:00:00,8,6,2,ECO_300019380
642,Herenthoutsesteenweg 2,2022-10-01,10:00:00,21,19,2,ECO_300019380
642,Herenthoutsesteenweg 2,2022-10-01,11:00:00,37,36,1,ECO_300019380
642,Herenthoutsesteenweg 2,2022-10-01,12:00:00,46,45,1,ECO_300019380
642,Herenthoutsesteenweg 2,2022-10-01,13:00:00,53,51,2,ECO_300019380
642,Herenthoutsesteenweg 2,2022-10-01,14:00:00,65,62,3,ECO_300019380
642,Herenthoutsesteenweg 2,2022-10-01,15:00:00,99,88,11,ECO_300019380
642,Herenthoutsesteenweg 2,2022-10-01,16:00:00,67,65,2,ECO_300019380
642,Herenthoutsesteenweg 2,2022-10-01,17:00:00,73,62,11,ECO_300019380
642,Herenthoutsesteenweg 2,2022-10-01,18:00:00,60,56,4,ECO_300019380
642,Herenthoutsesteenweg 2,2022-10-01,19:00:00,48,44,4,ECO_300019380
642,Herenthoutsesteenweg 2,2022-10-01,20:00:00,55,53,2,ECO_300019380
642,Herenthoutsesteenweg 2,2022-10-01,21:00:00,21,18,3,ECO_300019380
642,Herenthoutsesteenweg 2,2022-10-01,22:00:00,30,29,1,ECO_300019380
642,Herenthoutsesteenweg 2,2022-10-01,23:00:00,23,21,2,ECO_300019380
642,Herenthoutsesteenweg 2,2022-10-02,00:00:00,10,9,1,ECO_300019380
642,Herenthoutsesteenweg 2,2022-10-02,01:00:00,7,5,2,ECO_300019380
642,Herenthoutsesteenweg 2,2022-10-02,02:00:00,6,3,3,ECO_300019380
642,Herenthoutsesteenweg 2,2022-10-02,03:00:00,9,7,2,ECO_300019380
642,Herenthoutsesteenweg 2,2022-10-02,04:00:00,2,2,0,ECO_300019380
642,Herenthoutsesteenweg 2,2022-10-02,05:00:00,4,4,0,ECO_300019380
642,Herenthoutsesteenweg 2,2022-10-02,06:00:00,2,2,0,ECO_300019380
642,Herenthoutsesteenweg 2,2022-10-02,07:00:00,6,6,0,ECO_300019380
642,Herenthoutsesteenweg 2,2022-10-02,08:00:00,8,8,0,ECO_300019380
642,Herenthoutsesteenweg 2,2022-10-02,09:00:00,13,12,1,ECO_300019380
642,Herenthoutsesteenweg 2,2022-10-02,10:00:00,40,35,5,ECO_300019380
642,Herenthoutsesteenweg 2,2022-10-02,11:00:00,102,88,14,ECO_300019380
642,Herenthoutsesteenweg 2,2022-10-02,12:00:00,68,65,3,ECO_300019380
642,Herenthoutsesteenweg 2,2022-10-02,13:00:00,48,45,3,ECO_300019380
642,Herenthoutsesteenweg 2,2022-10-02,14:00:00,50,42,8,ECO_300019380
642,Herenthoutsesteenweg 2,2022-10-02,15:00:00,67,65,2,ECO_300019380
642,Herenthoutsesteenweg 2,2022-10-02,16:00:00,82,79,3,ECO_300019380
642,Herenthoutsesteenweg 2,2022-10-02,17:00:00,56,54,2,ECO_300019380
642,Herenthoutsesteenweg 2,2022-10-02,18:00:00,47,47,0,ECO_300019380
642,Herenthoutsesteenweg 2,2022-10-02,19:00:00,37,28,9,ECO_300019380
642,Herenthoutsesteenweg 2,2022-10-02,20:00:00,22,16,6,ECO_300019380
642,Herenthoutsesteenweg 2,2022-10-02,21:00:00,19,15,4,ECO_300019380
642,Herenthoutsesteenweg 2,2022-10-02,22:00:00,13,13,0,ECO_300019380
642,Herenthoutsesteenweg 2,2022-10-02,23:00:00,5,5,0,ECO_300019380
642,Herenthoutsesteenweg 2,2022-10-03,00:00:00,6,6,0,ECO_300019380
642,Herenthoutsesteenweg 2,2022-10-03,01:00:00,4,3,1,ECO_300019380
642,Herenthoutsesteenweg 2,2022-10-03,02:00:00,0,0,0,ECO_300019380
642,Herenthoutsesteenweg 2,2022-10-03,03:00:00,4,4,0,ECO_300019380
642,Herenthoutsesteenweg 2,2022-10-03,04:00:00,1,1,0,ECO_300019380
642,Herenthoutsesteenweg 2,2022-10-03,05:00:00,0,0,0,ECO_300019380
642,Herenthoutsesteenweg 2,2022-10-03,06:00:00,3,2,1,ECO_300019380
642,Herenthoutsesteenweg 2,2022-10-03,07:00:00,23,20,3,ECO_300019380
642,Herenthoutsesteenweg 2,2022-10-03,08:00:00,49,43,6,ECO_300019380
642,Herenthoutsesteenweg 2,2022-10-03,09:00:00,115,108,7,ECO_300019380
642,Herenthoutsesteenweg 2,2022-10-03,10:00:00,99,98,1,ECO_300019380
642,Herenthoutsesteenweg 2,2022-10-03,11:00:00,77,74,3,ECO_300019380
642,Herenthoutsesteenweg 2,2022-10-03,12:00:00,75,70,5,ECO_300019380
642,Herenthoutsesteenweg 2,2022-10-03,13:00:00,68,63,5,ECO_300019380
642,Herenthoutsesteenweg 2,2022-10-03,14:00:00,85,79,6,ECO_300019380
642,Herenthoutsesteenweg 2,2022-10-03,15:00:00,154,136,18,ECO_300019380
642,Herenthoutsesteenweg 2,2022-10-03,16:00:00,154,149,5,ECO_300019380
642,Herenthoutsesteenweg 2,2022-10-03,17:00:00,148,143,5,ECO_300019380
642,Herenthoutsesteenweg 2,2022-10-03,18:00:00,129,122,7,ECO_300019380
642,Herenthoutsesteenweg 2,2022-10-03,19:00:00,95,89,6,ECO_300019380
642,Herenthoutsesteenweg 2,2022-10-03,20:00:00,70,66,4,ECO_300019380
642,Herenthoutsesteenweg 2,2022-10-03,21:00:00,33,30,3,ECO_300019380
642,Herenthoutsesteenweg 2,2022-10-03,22:00:00,15,13,2,ECO_300019380
642,Herenthoutsesteenweg 2,2022-10-03,23:00:00,11,11,0,ECO_300019380
642,Herenthoutsesteenweg 2,2022-10-04,00:00:00,20,17,3,ECO_300019380
642,Herenthoutsesteenweg 2,2022-10-04,01:00:00,3,3,0,ECO_300019380
642,Herenthoutsesteenweg 2,2022-10-04,02:00:00,1,1,0,ECO_300019380
642,Herenthoutsesteenweg 2,2022-10-04,03:00:00,2,2,0,ECO_300019380
642,Herenthoutsesteenweg 2,2022-10-04,04:00:00,0,0,0,ECO_300019380
642,Herenthoutsesteenweg 2,2022-10-04,05:00:00,0,0,0,ECO_300019380
642,Herenthoutsesteenweg 2,2022-10-04,06:00:00,3,3,0,ECO_300019380
642,Herenthoutsesteenweg 2,2022-10-04,07:00:00,22,19,3,ECO_300019380
642,Herenthoutsesteenweg 2,2022-10-04,08:00:00,48,41,7,ECO_300019380
642,Herenthoutsesteenweg 2,2022-10-04,09:00:00,200,191,9,ECO_300019380
642,Herenthoutsesteenweg 2,2022-10-04,10:00:00,614,607,7,ECO_300019380
642,Herenthoutsesteenweg 2,2022-10-04,11:00:00,84,81,3,ECO_300019380
642,Herenthoutsesteenweg 2,2022-10-04,12:00:00,105,104,1,ECO_300019380
642,Herenthoutsesteenweg 2,2022-10-04,13:00:00,67,64,3,ECO_300019380
642,Herenthoutsesteenweg 2,2022-10-04,14:00:00,95,89,6,ECO_300019380
642,Herenthoutsesteenweg 2,2022-10-04,15:00:00,160,145,15,ECO_300019380
642,Herenthoutsesteenweg 2,2022-10-04,16:00:00,132,125,7,ECO_300019380
642,Herenthoutsesteenweg 2,2022-10-04,17:00:00,174,163,11,ECO_300019380
642,Herenthoutsesteenweg 2,2022-10-04,18:00:00,204,185,19,ECO_300019380
642,Herenthoutsesteenweg 2,2022-10-04,19:00:00,135,120,15,ECO_300019380
642,Herenthoutsesteenweg 2,2022-10-04,20:00:00,77,73,4,ECO_300019380
642,Herenthoutsesteenweg 2,2022-10-04,21:00:00,41,39,2,ECO_300019380
642,Herenthoutsesteenweg 2,2022-10-04,22:00:00,20,20,0,ECO_300019380
642,Herenthoutsesteenweg 2,2022-10-04,23:00:00,17,15,2,ECO_300019380
642,Herenthoutsesteenweg 2,2022-10-05,00:00:00,21,16,5,ECO_300019380
642,Herenthoutsesteenweg 2,2022-10-05,01:00:00,5,5,0,ECO_300019380
642,Herenthoutsesteenweg 2,2022-10-05,02:00:00,0,0,0,ECO_300019380
642,Herenthoutsesteenweg 2,2022-10-05,03:00:00,1,1,0,ECO_300019380
642,Herenthoutsesteenweg 2,2022-10-05,04:00:00,1,1,0,ECO_300019380
642,Herenthoutsesteenweg 2,2022-10-05,05:00:00,0,0,0,ECO_300019380
642,Herenthoutsesteenweg 2,2022-10-05,06:00:00,2,2,0,ECO_300019380
642,Herenthoutsesteenweg 2,2022-10-05,07:00:00,23,23,0,ECO_300019380
642,Herenthoutsesteenweg 2,2022-10-05,08:00:00,47,41,6,ECO_300019380
642,Herenthoutsesteenweg 2,2022-10-05,09:00:00,192,187,5,ECO_300019380
642,Herenthoutsesteenweg 2,2022-10-05,10:00:00,580,567,13,ECO_300019380
642,Herenthoutsesteenweg 2,2022-10-05,11:00:00,90,86,4,ECO_300019380
642,Herenthoutsesteenweg 2,2022-10-05,12:00:00,55,55,0,ECO_300019380
642,Herenthoutsesteenweg 2,2022-10-05,13:00:00,77,72,5,ECO_300019380
642,Herenthoutsesteenweg 2,2022-10-05,14:00:00,149,138,11,ECO_300019380
642,Herenthoutsesteenweg 2,2022-10-05,15:00:00,116,104,12,ECO_300019380
642,Herenthoutsesteenweg 2,2022-10-05,16:00:00,138,128,10,ECO_300019380
642,Herenthoutsesteenweg 2,2022-10-05,17:00:00,122,110,12,ECO_300019380
642,Herenthoutsesteenweg 2,2022-10-05,18:00:00,162,150,12,ECO_300019380
642,Herenthoutsesteenweg 2,2022-10-05,19:00:00,107,92,15,ECO_300019380
642,Herenthoutsesteenweg 2,2022-10-05,20:00:00,58,54,4,ECO_300019380
642,Herenthoutsesteenweg 2,2022-10-05,21:00:00,54,51,3,ECO_300019380
642,Herenthoutsesteenweg 2,2022-10-05,22:00:00,29,26,3,ECO_300019380
642,Herenthoutsesteenweg 2,2022-10-05,23:00:00,21,19,2,ECO_300019380
642,Herenthoutsesteenweg 2,2022-10-06,00:00:00,18,16,2,ECO_300019380
642,Herenthoutsesteenweg 2,2022-10-06,01:00:00,4,4,0,ECO_300019380
642,Herenthoutsesteenweg 2,2022-10-06,02:00:00,3,2,1,ECO_300019380
642,Herenthoutsesteenweg 2,2022-10-06,03:00:00,1,0,1,ECO_300019380
642,Herenthoutsesteenweg 2,2022-10-06,04:00:00,2,1,1,ECO_300019380
642,Herenthoutsesteenweg 2,2022-10-06,05:00:00,0,0,0,ECO_300019380
642,Herenthoutsesteenweg 2,2022-10-06,06:00:00,2,2,0,ECO_300019380
642,Herenthoutsesteenweg 2,2022-10-06,07:00:00,23,22,1,ECO_300019380
642,Herenthoutsesteenweg 2,2022-10-06,08:00:00,52,47,5,ECO_300019380
642,Herenthoutsesteenweg 2,2022-10-06,09:00:00,197,188,9,ECO_300019380
642,Herenthoutsesteenweg 2,2022-10-06,10:00:00,609,600,9,ECO_300019380
642,Herenthoutsesteenweg 2,2022-10-06,11:00:00,74,68,6,ECO_300019380
642,Herenthoutsesteenweg 2,2022-10-06,12:00:00,65,62,3,ECO_300019380
642,Herenthoutsesteenweg 2,2022-10-06,13:00:00,61,59,2,ECO_300019380
642,Herenthoutsesteenweg 2,2022-10-06,14:00:00,97,90,7,ECO_300019380
642,Herenthoutsesteenweg 2,2022-10-06,15:00:00,114,106,8,ECO_300019380
642,Herenthoutsesteenweg 2,2022-10-06,16:00:00,144,136,8,ECO_300019380
642,Herenthoutsesteenweg 2,2022-10-06,17:00:00,176,160,16,ECO_300019380
642,Herenthoutsesteenweg 2,2022-10-06,18:00:00,183,173,10,ECO_300019380
642,Herenthoutsesteenweg 2,2022-10-06,19:00:00,121,111,10,ECO_300019380
642,Herenthoutsesteenweg 2,2022-10-06,20:00:00,65,61,4,ECO_300019380
642,Herenthoutsesteenweg 2,2022-10-06,21:00:00,46,43,3,ECO_300019380
642,Herenthoutsesteenweg 2,2022-10-06,22:00:00,13,11,2,ECO_300019380
642,Herenthoutsesteenweg 2,2022-10-06,23:00:00,21,19,2,ECO_300019380
642,Herenthoutsesteenweg 2,2022-10-07,00:00:00,18,16,2,ECO_300019380
642,Herenthoutsesteenweg 2,2022-10-07,01:00:00,4,3,1,ECO_300019380
642,Herenthoutsesteenweg 2,2022-10-07,02:00:00,3,3,0,ECO_300019380
642,Herenthoutsesteenweg 2,2022-10-07,03:00:00,1,1,0,ECO_300019380
642,Herenthoutsesteenweg 2,2022-10-07,04:00:00,1,1,0,ECO_300019380
642,Herenthoutsesteenweg 2,2022-10-07,05:00:00,1,1,0,ECO_300019380
642,Herenthoutsesteenweg 2,2022-10-07,06:00:00,2,2,0,ECO_300019380
642,Herenthoutsesteenweg 2,2022-10-07,07:00:00,23,22,1,ECO_300019380
642,Herenthoutsesteenweg 2,2022-10-07,08:00:00,37,34,3,ECO_300019380
642,Herenthoutsesteenweg 2,2022-10-07,09:00:00,153,147,6,ECO_300019380
642,Herenthoutsesteenweg 2,2022-10-07,10:00:00,630,624,6,ECO_300019380
642,Herenthoutsesteenweg 2,2022-10-07,11:00:00,140,139,1,ECO_300019380
642,Herenthoutsesteenweg 2,2022-10-07,12:00:00,122,116,6,ECO_300019380
642,Herenthoutsesteenweg 2,2022-10-07,13:00:00,83,77,6,ECO_300019380
642,Herenthoutsesteenweg 2,2022-10-07,14:00:00,98,89,9,ECO_300019380
642,Herenthoutsesteenweg 2,2022-10-07,15:00:00,87,75,12,ECO_300019380
642,Herenthoutsesteenweg 2,2022-10-07,16:00:00,119,108,11,ECO_300019380
642,Herenthoutsesteenweg 2,2022-10-07,17:00:00,182,166,16,ECO_300019380
642,Herenthoutsesteenweg 2,2022-10-07,18:00:00,161,152,9,ECO_300019380
642,Herenthoutsesteenweg 2,2022-10-07,19:00:00,83,72,11,ECO_300019380
642,Herenthoutsesteenweg 2,2022-10-07,20:00:00,71,60,11,ECO_300019380
642,Herenthoutsesteenweg 2,2022-10-07,21:00:00,40,35,5,ECO_300019380
642,Herenthoutsesteenweg 2,2022-10-07,22:00:00,29,26,3,ECO_300019380
642,Herenthoutsesteenweg 2,2022-10-07,23:00:00,23,22,1,ECO_300019380
642,Herenthoutsesteenweg 2,2022-10-08,00:00:00,11,11,0,ECO_300019380
642,Herenthoutsesteenweg 2,2022-10-08,01:00:00,10,10,0,ECO_300019380
642,Herenthoutsesteenweg 2,2022-10-08,02:00:00,8,5,3,ECO_300019380
642,Herenthoutsesteenweg 2,2022-10-08,03:00:00,7,4,3,ECO_300019380
642,Herenthoutsesteenweg 2,2022-10-08,04:00:00,5,5,0,ECO_300019380
642,Herenthoutsesteenweg 2,2022-10-08,05:00:00,5,4,1,ECO_300019380
642,Herenthoutsesteenweg 2,2022-10-08,06:00:00,0,0,0,ECO_300019380
642,Herenthoutsesteenweg 2,2022-10-08,07:00:00,3,3,0,ECO_300019380
642,Herenthoutsesteenweg 2,2022-10-08,08:00:00,12,12,0,ECO_300019380
642,Herenthoutsesteenweg 2,2022-10-08,09:00:00,12,12,0,ECO_300019380
642,Herenthoutsesteenweg 2,2022-10-08,10:00:00,39,37,2,ECO_300019380
642,Herenthoutsesteenweg 2,2022-10-08,11:00:00,95,93,2,ECO_300019380
642,Herenthoutsesteenweg 2,2022-10-08,12:00:00,77,73,4,ECO_300019380
642,Herenthoutsesteenweg 2,2022-10-08,13:00:00,92,77,15,ECO_300019380
642,Herenthoutsesteenweg 2,2022-10-08,14:00:00,92,81,11,ECO_300019380
642,Herenthoutsesteenweg 2,2022-10-08,15:00:00,126,121,5,ECO_300019380
642,Herenthoutsesteenweg 2,2022-10-08,16:00:00,148,143,5,ECO_300019380
642,Herenthoutsesteenweg 2,2022-10-08,17:00:00,88,79,9,ECO_300019380
642,Herenthoutsesteenweg 2,2022-10-08,18:00:00,79,72,7,ECO_300019380
642,Herenthoutsesteenweg 2,2022-10-08,19:00:00,64,51,13,ECO_300019380
642,Herenthoutsesteenweg 2,2022-10-08,20:00:00,59,55,4,ECO_300019380
642,Herenthoutsesteenweg 2,2022-10-08,21:00:00,39,33,6,ECO_300019380
642,Herenthoutsesteenweg 2,2022-10-08,22:00:00,12,11,1,ECO_300019380
642,Herenthoutsesteenweg 2,2022-10-08,23:00:00,21,20,1,ECO_300019380
642,Herenthoutsesteenweg 2,2022-10-09,00:00:00,28,12,16,ECO_300019380
642,Herenthoutsesteenweg 2,2022-10-09,01:00:00,3,3,0,ECO_300019380
642,Herenthoutsesteenweg 2,2022-10-09,02:00:00,3,2,1,ECO_300019380
642,Herenthoutsesteenweg 2,2022-10-09,03:00:00,4,2,2,ECO_300019380
642,Herenthoutsesteenweg 2,2022-10-09,04:00:00,3,3,0,ECO_300019380
642,Herenthoutsesteenweg 2,2022-10-09,05:00:00,3,2,1,ECO_300019380
642,Herenthoutsesteenweg 2,2022-10-09,06:00:00,0,0,0,ECO_300019380
642,Herenthoutsesteenweg 2,2022-10-09,07:00:00,1,1,0,ECO_300019380
642,Herenthoutsesteenweg 2,2022-10-09,08:00:00,9,9,0,ECO_300019380
642,Herenthoutsesteenweg 2,2022-10-09,09:00:00,8,6,2,ECO_300019380
642,Herenthoutsesteenweg 2,2022-10-09,10:00:00,54,46,8,ECO_300019380
642,Herenthoutsesteenweg 2,2022-10-09,11:00:00,110,106,4,ECO_300019380
642,Herenthoutsesteenweg 2,2022-10-09,12:00:00,118,110,8,ECO_300019380
642,Herenthoutsesteenweg 2,2022-10-09,13:00:00,137,116,21,ECO_300019380
642,Herenthoutsesteenweg 2,2022-10-09,14:00:00,74,60,14,ECO_300019380
642,Herenthoutsesteenweg 2,2022-10-09,15:00:00,179,170,9,ECO_300019380
642,Herenthoutsesteenweg 2,2022-10-09,16:00:00,189,180,9,ECO_300019380
642,Herenthoutsesteenweg 2,2022-10-09,17:00:00,121,99,22,ECO_300019380
642,Herenthoutsesteenweg 2,2022-10-09,18:00:00,85,72,13,ECO_300019380
642,Herenthoutsesteenweg 2,2022-10-09,19:00:00,59,52,7,ECO_300019380
642,Herenthoutsesteenweg 2,2022-10-09,20:00:00,53,44,9,ECO_300019380
642,Herenthoutsesteenweg 2,2022-10-09,21:00:00,55,43,12,ECO_300019380
642,Herenthoutsesteenweg 2,2022-10-09,22:00:00,16,13,3,ECO_300019380
642,Herenthoutsesteenweg 2,2022-10-09,23:00:00,6,5,1,ECO_300019380
642,Herenthoutsesteenweg 2,2022-10-10,00:00:00,2,2,0,ECO_300019380
642,Herenthoutsesteenweg 2,2022-10-10,01:00:00,1,1,0,ECO_300019380
642,Herenthoutsesteenweg 2,2022-10-10,02:00:00,0,0,0,ECO_300019380
642,Herenthoutsesteenweg 2,2022-10-10,03:00:00,2,1,1,ECO_300019380
642,Herenthoutsesteenweg 2,2022-10-10,04:00:00,0,0,0,ECO_300019380
642,Herenthoutsesteenweg 2,2022-10-10,05:00:00,0,0,0,ECO_300019380
642,Herenthoutsesteenweg 2,2022-10-10,06:00:00,3,3,0,ECO_300019380
642,Herenthoutsesteenweg 2,2022-10-10,07:00:00,19,15,4,ECO_300019380
642,Herenthoutsesteenweg 2,2022-10-10,08:00:00,48,46,2,ECO_300019380
642,Herenthoutsesteenweg 2,2022-10-10,09:00:00,177,173,4,ECO_300019380
642,Herenthoutsesteenweg 2,2022-10-10,10:00:00,602,597,5,ECO_300019380
642,Herenthoutsesteenweg 2,2022-10-10,11:00:00,85,81,4,ECO_300019380
642,Herenthoutsesteenweg 2,2022-10-10,12:00:00,63,63,0,ECO_300019380
642,Herenthoutsesteenweg 2,2022-10-10,13:00:00,63,62,1,ECO_300019380
642,Herenthoutsesteenweg 2,2022-10-10,14:00:00,61,59,2,ECO_300019380
642,Herenthoutsesteenweg 2,2022-10-10,15:00:00,99,95,4,ECO_300019380
642,Herenthoutsesteenweg 2,2022-10-10,16:00:00,86,78,8,ECO_300019380
642,Herenthoutsesteenweg 2,2022-10-10,17:00:00,391,84,307,ECO_300019380
642,Herenthoutsesteenweg 2,2022-10-10,18:00:00,369,109,260,ECO_300019380
642,Herenthoutsesteenweg 2,2022-10-10,19:00:00,97,88,9,ECO_300019380
642,Herenthoutsesteenweg 2,2022-10-10,20:00:00,44,38,6,ECO_300019380
642,Herenthoutsesteenweg 2,2022-10-10,21:00:00,32,30,2,ECO_300019380
642,Herenthoutsesteenweg 2,2022-10-10,22:00:00,18,17,1,ECO_300019380
642,Herenthoutsesteenweg 2,2022-10-10,23:00:00,13,12,1,ECO_300019380
642,Herenthoutsesteenweg 2,2022-10-11,00:00:00,22,21,1,ECO_300019380
642,Herenthoutsesteenweg 2,2022-10-11,01:00:00,3,0,3,ECO_300019380
642,Herenthoutsesteenweg 2,2022-10-11,02:00:00,1,1,0,ECO_300019380
642,Herenthoutsesteenweg 2,2022-10-11,03:00:00,0,0,0,ECO_300019380
642,Herenthoutsesteenweg 2,2022-10-11,04:00:00,1,1,0,ECO_300019380
642,Herenthoutsesteenweg 2,2022-10-11,05:00:00,0,0,0,ECO_300019380
642,Herenthoutsesteenweg 2,2022-10-11,06:00:00,4,3,1,ECO_300019380
642,Herenthoutsesteenweg 2,2022-10-11,07:00:00,22,20,2,ECO_300019380
642,Herenthoutsesteenweg 2,2022-10-11,08:00:00,54,48,6,ECO_300019380
642,Herenthoutsesteenweg 2,2022-10-11,09:00:00,178,175,3,ECO_300019380
642,Herenthoutsesteenweg 2,2022-10-11,10:00:00,634,628,6,ECO_300019380
642,Herenthoutsesteenweg 2,2022-10-11,11:00:00,87,83,4,ECO_300019380
642,Herenthoutsesteenweg 2,2022-10-11,12:00:00,79,76,3,ECO_300019380
642,Herenthoutsesteenweg 2,2022-10-11,13:00:00,80,77,3,ECO_300019380
642,Herenthoutsesteenweg 2,2022-10-11,14:00:00,80,69,11,ECO_300019380
642,Herenthoutsesteenweg 2,2022-10-11,15:00:00,206,196,10,ECO_300019380
642,Herenthoutsesteenweg 2,2022-10-11,16:00:00,153,142,11,ECO_300019380
642,Herenthoutsesteenweg 2,2022-10-11,17:00:00,149,133,16,ECO_300019380
642,Herenthoutsesteenweg 2,2022-10-11,18:00:00,165,155,10,ECO_300019380
642,Herenthoutsesteenweg 2,2022-10-11,19:00:00,119,106,13,ECO_300019380
642,Herenthoutsesteenweg 2,2022-10-11,20:00:00,59,49,10,ECO_300019380
642,Herenthoutsesteenweg 2,2022-10-11,21:00:00,35,32,3,ECO_300019380
642,Herenthoutsesteenweg 2,2022-10-11,22:00:00,23,20,3,ECO_300019380
642,Herenthoutsesteenweg 2,2022-10-11,23:00:00,13,13,0,ECO_300019380
642,Herenthoutsesteenweg 2,2022-10-12,00:00:00,27,25,2,ECO_300019380
642,Herenthoutsesteenweg 2,2022-10-12,01:00:00,3,1,2,ECO_300019380
642,Herenthoutsesteenweg 2,2022-10-12,02:00:00,0,0,0,ECO_300019380
642,Herenthoutsesteenweg 2,2022-10-12,03:00:00,0,0,0,ECO_300019380
642,Herenthoutsesteenweg 2,2022-10-12,04:00:00,1,1,0,ECO_300019380
642,Herenthoutsesteenweg 2,2022-10-12,05:00:00,0,0,0,ECO_300019380
642,Herenthoutsesteenweg 2,2022-10-12,06:00:00,3,3,0,ECO_300019380
642,Herenthoutsesteenweg 2,2022-10-12,07:00:00,23,20,3,ECO_300019380
642,Herenthoutsesteenweg 2,2022-10-12,08:00:00,50,42,8,ECO_300019380
642,Herenthoutsesteenweg 2,2022-10-12,09:00:00,160,154,6,ECO_300019380
642,Herenthoutsesteenweg 2,2022-10-12,10:00:00,601,594,7,ECO_300019380
642,Herenthoutsesteenweg 2,2022-10-12,11:00:00,92,92,0,ECO_300019380
642,Herenthoutsesteenweg 2,2022-10-12,12:00:00,73,70,3,ECO_300019380
642,Herenthoutsesteenweg 2,2022-10-12,13:00:00,68,61,7,ECO_300019380
642,Herenthoutsesteenweg 2,2022-10-12,14:00:00,113,102,11,ECO_300019380
642,Herenthoutsesteenweg 2,2022-10-12,15:00:00,165,155,10,ECO_300019380
642,Herenthoutsesteenweg 2,2022-10-12,16:00:00,118,109,9,ECO_300019380
642,Herenthoutsesteenweg 2,2022-10-12,17:00:00,113,105,8,ECO_300019380
642,Herenthoutsesteenweg 2,2022-10-12,18:00:00,156,146,10,ECO_300019380
642,Herenthoutsesteenweg 2,2022-10-12,19:00:00,132,120,12,ECO_300019380
642,Herenthoutsesteenweg 2,2022-10-12,20:00:00,64,59,5,ECO_300019380
642,Herenthoutsesteenweg 2,2022-10-12,21:00:00,35,30,5,ECO_300019380
642,Herenthoutsesteenweg 2,2022-10-12,22:00:00,21,17,4,ECO_300019380
642,Herenthoutsesteenweg 2,2022-10-12,23:00:00,24,23,1,ECO_300019380
642,Herenthoutsesteenweg 2,2022-10-13,00:00:00,23,19,4,ECO_300019380
642,Herenthoutsesteenweg 2,2022-10-13,01:00:00,7,5,2,ECO_300019380
642,Herenthoutsesteenweg 2,2022-10-13,02:00:00,0,0,0,ECO_300019380
642,Herenthoutsesteenweg 2,2022-10-13,03:00:00,2,2,0,ECO_300019380
642,Herenthoutsesteenweg 2,2022-10-13,04:00:00,1,1,0,ECO_300019380
642,Herenthoutsesteenweg 2,2022-10-13,05:00:00,1,0,1,ECO_300019380
642,Herenthoutsesteenweg 2,2022-10-13,06:00:00,3,3,0,ECO_300019380
642,Herenthoutsesteenweg 2,2022-10-13,07:00:00,15,14,1,ECO_300019380
642,Herenthoutsesteenweg 2,2022-10-13,08:00:00,45,40,5,ECO_300019380
642,Herenthoutsesteenweg 2,2022-10-13,09:00:00,154,151,3,ECO_300019380
642,Herenthoutsesteenweg 2,2022-10-13,10:00:00,589,584,5,ECO_300019380
642,Herenthoutsesteenweg 2,2022-10-13,11:00:00,86,79,7,ECO_300019380
642,Herenthoutsesteenweg 2,2022-10-13,12:00:00,42,41,1,ECO_300019380
642,Herenthoutsesteenweg 2,2022-10-13,13:00:00,42,38,4,ECO_300019380
642,Herenthoutsesteenweg 2,2022-10-13,14:00:00,41,40,1,ECO_300019380
642,Herenthoutsesteenweg 2,2022-10-13,15:00:00,42,40,2,ECO_300019380
642,Herenthoutsesteenweg 2,2022-10-13,16:00:00,51,46,5,ECO_300019380
642,Herenthoutsesteenweg 2,2022-10-13,17:00:00,104,99,5,ECO_300019380
642,Herenthoutsesteenweg 2,2022-10-13,18:00:00,107,100,7,ECO_300019380
642,Herenthoutsesteenweg 2,2022-10-13,19:00:00,63,61,2,ECO_300019380
642,Herenthoutsesteenweg 2,2022-10-13,20:00:00,36,30,6,ECO_300019380
642,Herenthoutsesteenweg 2,2022-10-13,21:00:00,24,21,3,ECO_300019380
642,Herenthoutsesteenweg 2,2022-10-13,22:00:00,8,7,1,ECO_300019380
642,Herenthoutsesteenweg 2,2022-10-13,23:00:00,13,13,0,ECO_300019380
642,Herenthoutsesteenweg 2,2022-10-14,00:00:00,21,19,2,ECO_300019380
642,Herenthoutsesteenweg 2,2022-10-14,01:00:00,5,3,2,ECO_300019380
642,Herenthoutsesteenweg 2,2022-10-14,02:00:00,2,2,0,ECO_300019380
642,Herenthoutsesteenweg 2,2022-10-14,03:00:00,2,2,0,ECO_300019380
642,Herenthoutsesteenweg 2,2022-10-14,04:00:00,2,2,0,ECO_300019380
642,Herenthoutsesteenweg 2,2022-10-14,05:00:00,0,0,0,ECO_300019380
642,Herenthoutsesteenweg 2,2022-10-14,06:00:00,2,2,0,ECO_300019380
642,Herenthoutsesteenweg 2,2022-10-14,07:00:00,21,19,2,ECO_300019380
642,Herenthoutsesteenweg 2,2022-10-14,08:00:00,33,30,3,ECO_300019380
642,Herenthoutsesteenweg 2,2022-10-14,09:00:00,115,114,1,ECO_300019380
642,Herenthoutsesteenweg 2,2022-10-14,10:00:00,563,557,6,ECO_300019380
642,Herenthoutsesteenweg 2,2022-10-14,11:00:00,67,65,2,ECO_300019380
642,Herenthoutsesteenweg 2,2022-10-14,12:00:00,61,60,1,ECO_300019380
642,Herenthoutsesteenweg 2,2022-10-14,13:00:00,45,43,2,ECO_300019380
642,Herenthoutsesteenweg 2,2022-10-14,14:00:00,48,45,3,ECO_300019380
642,Herenthoutsesteenweg 2,2022-10-14,15:00:00,40,39,1,ECO_300019380
642,Herenthoutsesteenweg 2,2022-10-14,16:00:00,59,56,3,ECO_300019380
642,Herenthoutsesteenweg 2,2022-10-14,17:00:00,111,105,6,ECO_300019380
642,Herenthoutsesteenweg 2,2022-10-14,18:00:00,115,108,7,ECO_300019380
642,Herenthoutsesteenweg 2,2022-10-14,19:00:00,68,62,6,ECO_300019380
642,Herenthoutsesteenweg 2,2022-10-14,20:00:00,50,47,3,ECO_300019380
642,Herenthoutsesteenweg 2,2022-10-14,21:00:00,46,40,6,ECO_300019380
642,Herenthoutsesteenweg 2,2022-10-14,22:00:00,26,25,1,ECO_300019380
642,Herenthoutsesteenweg 2,2022-10-14,23:00:00,24,23,1,ECO_300019380
642,Herenthoutsesteenweg 2,2022-10-15,00:00:00,12,11,1,ECO_300019380
642,Herenthoutsesteenweg 2,2022-10-15,01:00:00,14,10,4,ECO_300019380
642,Herenthoutsesteenweg 2,2022-10-15,02:00:00,4,4,0,ECO_300019380
642,Herenthoutsesteenweg 2,2022-10-15,03:00:00,13,9,4,ECO_300019380
642,Herenthoutsesteenweg 2,2022-10-15,04:00:00,0,0,0,ECO_300019380
642,Herenthoutsesteenweg 2,2022-10-15,05:00:00,2,2,0,ECO_300019380
642,Herenthoutsesteenweg 2,2022-10-15,06:00:00,2,0,2,ECO_300019380
642,Herenthoutsesteenweg 2,2022-10-15,07:00:00,4,3,1,ECO_300019380
642,Herenthoutsesteenweg 2,2022-10-15,08:00:00,8,7,1,ECO_300019380
642,Herenthoutsesteenweg 2,2022-10-15,09:00:00,11,10,1,ECO_300019380
642,Herenthoutsesteenweg 2,2022-10-15,10:00:00,38,37,1,ECO_300019380
642,Herenthoutsesteenweg 2,2022-10-15,11:00:00,80,79,1,ECO_300019380
642,Herenthoutsesteenweg 2,2022-10-15,12:00:00,77,73,4,ECO_300019380
642,Herenthoutsesteenweg 2,2022-10-15,13:00:00,53,49,4,ECO_300019380
642,Herenthoutsesteenweg 2,2022-10-15,14:00:00,51,46,5,ECO_300019380
642,Herenthoutsesteenweg 2,2022-10-15,15:00:00,71,60,11,ECO_300019380
642,Herenthoutsesteenweg 2,2022-10-15,16:00:00,69,64,5,ECO_300019380
642,Herenthoutsesteenweg 2,2022-10-15,17:00:00,73,68,5,ECO_300019380
642,Herenthoutsesteenweg 2,2022-10-15,18:00:00,47,43,4,ECO_300019380
642,Herenthoutsesteenweg 2,2022-10-15,19:00:00,42,40,2,ECO_300019380
642,Herenthoutsesteenweg 2,2022-10-15,20:00:00,36,32,4,ECO_300019380
642,Herenthoutsesteenweg 2,2022-10-15,21:00:00,35,34,1,ECO_300019380
642,Herenthoutsesteenweg 2,2022-10-15,22:00:00,39,39,0,ECO_300019380
642,Herenthoutsesteenweg 2,2022-10-15,23:00:00,26,22,4,ECO_300019380
642,Herenthoutsesteenweg 2,2022-10-16,00:00:00,5,5,0,ECO_300019380
642,Herenthoutsesteenweg 2,2022-10-16,01:00:00,9,8,1,ECO_300019380
642,Herenthoutsesteenweg 2,2022-10-16,02:00:00,6,0,6,ECO_300019380
642,Herenthoutsesteenweg 2,2022-10-16,03:00:00,8,6,2,ECO_300019380
642,Herenthoutsesteenweg 2,2022-10-16,04:00:00,4,0,4,ECO_300019380
642,Herenthoutsesteenweg 2,2022-10-16,05:00:00,1,0,1,ECO_300019380
642,Herenthoutsesteenweg 2,2022-10-16,06:00:00,0,0,0,ECO_300019380
642,Herenthoutsesteenweg 2,2022-10-16,07:00:00,2,2,0,ECO_300019380
642,Herenthoutsesteenweg 2,2022-10-16,08:00:00,8,8,0,ECO_300019380
642,Herenthoutsesteenweg 2,2022-10-16,09:00:00,9,8,1,ECO_300019380
642,Herenthoutsesteenweg 2,2022-10-16,10:00:00,61,58,3,ECO_300019380
642,Herenthoutsesteenweg 2,2022-10-16,11:00:00,121,109,12,ECO_300019380
642,Herenthoutsesteenweg 2,2022-10-16,12:00:00,121,113,8,ECO_300019380
642,Herenthoutsesteenweg 2,2022-10-16,13:00:00,127,95,32,ECO_300019380
642,Herenthoutsesteenweg 2,2022-10-16,14:00:00,85,82,3,ECO_300019380
642,Herenthoutsesteenweg 2,2022-10-16,15:00:00,131,124,7,ECO_300019380
642,Herenthoutsesteenweg 2,2022-10-16,16:00:00,156,145,11,ECO_300019380
642,Herenthoutsesteenweg 2,2022-10-16,17:00:00,104,90,14,ECO_300019380
642,Herenthoutsesteenweg 2,2022-10-16,18:00:00,93,88,5,ECO_300019380
642,Herenthoutsesteenweg 2,2022-10-16,19:00:00,48,44,4,ECO_300019380
642,Herenthoutsesteenweg 2,2022-10-16,20:00:00,41,38,3,ECO_300019380
642,Herenthoutsesteenweg 2,2022-10-16,21:00:00,21,19,2,ECO_300019380
642,Herenthoutsesteenweg 2,2022-10-16,22:00:00,2,1,1,ECO_300019380
642,Herenthoutsesteenweg 2,2022-10-16,23:00:00,9,9,0,ECO_300019380
642,Herenthoutsesteenweg 2,2022-10-17,00:00:00,4,4,0,ECO_300019380
642,Herenthoutsesteenweg 2,2022-10-17,01:00:00,1,0,1,ECO_300019380
642,Herenthoutsesteenweg 2,2022-10-17,02:00:00,1,1,0,ECO_300019380
642,Herenthoutsesteenweg 2,2022-10-17,03:00:00,0,0,0,ECO_300019380
642,Herenthoutsesteenweg 2,2022-10-17,04:00:00,0,0,0,ECO_300019380
642,Herenthoutsesteenweg 2,2022-10-17,05:00:00,0,0,0,ECO_300019380
642,Herenthoutsesteenweg 2,2022-10-17,06:00:00,3,2,1,ECO_300019380
642,Herenthoutsesteenweg 2,2022-10-17,07:00:00,23,22,1,ECO_300019380
642,Herenthoutsesteenweg 2,2022-10-17,08:00:00,48,43,5,ECO_300019380
642,Herenthoutsesteenweg 2,2022-10-17,09:00:00,143,139,4,ECO_300019380
642,Herenthoutsesteenweg 2,2022-10-17,10:00:00,561,556,5,ECO_300019380
642,Herenthoutsesteenweg 2,2022-10-17,11:00:00,51,47,4,ECO_300019380
642,Herenthoutsesteenweg 2,2022-10-17,12:00:00,18,18,0,ECO_300019380
642,Herenthoutsesteenweg 2,2022-10-17,13:00:00,23,23,0,ECO_300019380
642,Herenthoutsesteenweg 2,2022-10-17,14:00:00,46,44,2,ECO_300019380
642,Herenthoutsesteenweg 2,2022-10-17,15:00:00,53,43,10,ECO_300019380
642,Herenthoutsesteenweg 2,2022-10-17,16:00:00,51,46,5,ECO_300019380
642,Herenthoutsesteenweg 2,2022-10-17,17:00:00,58,56,2,ECO_300019380
642,Herenthoutsesteenweg 2,2022-10-17,18:00:00,96,87,9,ECO_300019380
642,Herenthoutsesteenweg 2,2022-10-17,19:00:00,77,73,4,ECO_300019380
642,Herenthoutsesteenweg 2,2022-10-17,20:00:00,52,45,7,ECO_300019380
642,Herenthoutsesteenweg 2,2022-10-17,21:00:00,34,32,2,ECO_300019380
642,Herenthoutsesteenweg 2,2022-10-17,22:00:00,12,11,1,ECO_300019380
642,Herenthoutsesteenweg 2,2022-10-17,23:00:00,15,13,2,ECO_300019380
642,Herenthoutsesteenweg 2,2022-10-18,00:00:00,12,10,2,ECO_300019380
642,Herenthoutsesteenweg 2,2022-10-18,01:00:00,0,0,0,ECO_300019380
642,Herenthoutsesteenweg 2,2022-10-18,02:00:00,2,0,2,ECO_300019380
642,Herenthoutsesteenweg 2,2022-10-18,03:00:00,1,1,0,ECO_300019380
642,Herenthoutsesteenweg 2,2022-10-18,04:00:00,0,0,0,ECO_300019380
642,Herenthoutsesteenweg 2,2022-10-18,05:00:00,0,0,0,ECO_300019380
642,Herenthoutsesteenweg 2,2022-10-18,06:00:00,4,4,0,ECO_300019380
642,Herenthoutsesteenweg 2,2022-10-18,07:00:00,20,20,0,ECO_300019380
642,Herenthoutsesteenweg 2,2022-10-18,08:00:00,58,50,8,ECO_300019380
642,Herenthoutsesteenweg 2,2022-10-18,09:00:00,170,164,6,ECO_300019380
642,Herenthoutsesteenweg 2,2022-10-18,10:00:00,593,574,19,ECO_300019380
642,Herenthoutsesteenweg 2,2022-10-18,11:00:00,118,113,5,ECO_300019380
642,Herenthoutsesteenweg 2,2022-10-18,12:00:00,69,64,5,ECO_300019380
642,Herenthoutsesteenweg 2,2022-10-18,13:00:00,76,74,2,ECO_300019380
642,Herenthoutsesteenweg 2,2022-10-18,14:00:00,99,90,9,ECO_300019380
642,Herenthoutsesteenweg 2,2022-10-18,15:00:00,148,145,3,ECO_300019380
642,Herenthoutsesteenweg 2,2022-10-18,16:00:00,162,146,16,ECO_300019380
642,Herenthoutsesteenweg 2,2022-10-18,17:00:00,164,147,17,ECO_300019380
642,Herenthoutsesteenweg 2,2022-10-18,18:00:00,185,171,14,ECO_300019380
642,Herenthoutsesteenweg 2,2022-10-18,19:00:00,119,111,8,ECO_300019380
642,Herenthoutsesteenweg 2,2022-10-18,20:00:00,57,48,9,ECO_300019380
642,Herenthoutsesteenweg 2,2022-10-18,21:00:00,43,41,2,ECO_300019380
642,Herenthoutsesteenweg 2,2022-10-18,22:00:00,23,19,4,ECO_300019380
642,Herenthoutsesteenweg 2,2022-10-18,23:00:00,12,11,1,ECO_300019380
642,Herenthoutsesteenweg 2,2022-10-19,00:00:00,19,17,2,ECO_300019380
642,Herenthoutsesteenweg 2,2022-10-19,01:00:00,3,3,0,ECO_300019380
642,Herenthoutsesteenweg 2,2022-10-19,02:00:00,3,3,0,ECO_300019380
642,Herenthoutsesteenweg 2,2022-10-19,03:00:00,0,0,0,ECO_300019380
642,Herenthoutsesteenweg 2,2022-10-19,04:00:00,1,1,0,ECO_300019380
642,Herenthoutsesteenweg 2,2022-10-19,05:00:00,0,0,0,ECO_300019380
642,Herenthoutsesteenweg 2,2022-10-19,06:00:00,2,2,0,ECO_300019380
642,Herenthoutsesteenweg 2,2022-10-19,07:00:00,28,27,1,ECO_300019380
642,Herenthoutsesteenweg 2,2022-10-19,08:00:00,44,39,5,ECO_300019380
642,Herenthoutsesteenweg 2,2022-10-19,09:00:00,170,164,6,ECO_300019380
642,Herenthoutsesteenweg 2,2022-10-19,10:00:00,587,583,4,ECO_300019380
642,Herenthoutsesteenweg 2,2022-10-19,11:00:00,104,100,4,ECO_300019380
642,Herenthoutsesteenweg 2,2022-10-19,12:00:00,81,76,5,ECO_300019380
642,Herenthoutsesteenweg 2,2022-10-19,13:00:00,84,83,1,ECO_300019380
642,Herenthoutsesteenweg 2,2022-10-19,14:00:00,156,149,7,ECO_300019380
642,Herenthoutsesteenweg 2,2022-10-19,15:00:00,153,142,11,ECO_300019380
642,Herenthoutsesteenweg 2,2022-10-19,16:00:00,189,182,7,ECO_300019380
642,Herenthoutsesteenweg 2,2022-10-19,17:00:00,106,88,18,ECO_300019380
642,Herenthoutsesteenweg 2,2022-10-19,18:00:00,151,137,14,ECO_300019380
642,Herenthoutsesteenweg 2,2022-10-19,19:00:00,91,83,8,ECO_300019380
642,Herenthoutsesteenweg 2,2022-10-19,20:00:00,67,59,8,ECO_300019380
642,Herenthoutsesteenweg 2,2022-10-19,21:00:00,39,39,0,ECO_300019380
642,Herenthoutsesteenweg 2,2022-10-19,22:00:00,24,20,4,ECO_300019380
642,Herenthoutsesteenweg 2,2022-10-19,23:00:00,28,26,2,ECO_300019380
642,Herenthoutsesteenweg 2,2022-10-20,00:00:00,24,22,2,ECO_300019380
642,Herenthoutsesteenweg 2,2022-10-20,01:00:00,4,2,2,ECO_300019380
642,Herenthoutsesteenweg 2,2022-10-20,02:00:00,4,3,1,ECO_300019380
642,Herenthoutsesteenweg 2,2022-10-20,03:00:00,0,0,0,ECO_300019380
642,Herenthoutsesteenweg 2,2022-10-20,04:00:00,1,1,0,ECO_300019380
642,Herenthoutsesteenweg 2,2022-10-20,05:00:00,3,2,1,ECO_300019380
642,Herenthoutsesteenweg 2,2022-10-20,06:00:00,1,1,0,ECO_300019380
642,Herenthoutsesteenweg 2,2022-10-20,07:00:00,21,21,0,ECO_300019380
642,Herenthoutsesteenweg 2,2022-10-20,08:00:00,52,47,5,ECO_300019380
642,Herenthoutsesteenweg 2,2022-10-20,09:00:00,134,130,4,ECO_300019380
642,Herenthoutsesteenweg 2,2022-10-20,10:00:00,335,334,1,ECO_300019380
642,Herenthoutsesteenweg 2,2022-10-20,11:00:00,75,74,1,ECO_300019380
642,Herenthoutsesteenweg 2,2022-10-20,12:00:00,56,56,0,ECO_300019380
642,Herenthoutsesteenweg 2,2022-10-20,13:00:00,32,29,3,ECO_300019380
642,Herenthoutsesteenweg 2,2022-10-20,14:00:00,27,24,3,ECO_300019380
642,Herenthoutsesteenweg 2,2022-10-20,15:00:00,71,68,3,ECO_300019380
642,Herenthoutsesteenweg 2,2022-10-20,16:00:00,68,65,3,ECO_300019380
642,Herenthoutsesteenweg 2,2022-10-20,17:00:00,101,88,13,ECO_300019380
642,Herenthoutsesteenweg 2,2022-10-20,18:00:00,146,131,15,ECO_300019380
642,Herenthoutsesteenweg 2,2022-10-20,19:00:00,104,95,9,ECO_300019380
642,Herenthoutsesteenweg 2,2022-10-20,20:00:00,72,62,10,ECO_300019380
642,Herenthoutsesteenweg 2,2022-10-20,21:00:00,48,46,2,ECO_300019380
642,Herenthoutsesteenweg 2,2022-10-20,22:00:00,13,13,0,ECO_300019380
642,Herenthoutsesteenweg 2,2022-10-20,23:00:00,9,9,0,ECO_300019380
642,Herenthoutsesteenweg 2,2022-10-21,00:00:00,12,11,1,ECO_300019380
642,Herenthoutsesteenweg 2,2022-10-21,01:00:00,1,0,1,ECO_300019380
642,Herenthoutsesteenweg 2,2022-10-21,02:00:00,2,2,0,ECO_300019380
642,Herenthoutsesteenweg 2,2022-10-21,03:00:00,0,0,0,ECO_300019380
642,Herenthoutsesteenweg 2,2022-10-21,04:00:00,0,0,0,ECO_300019380
642,Herenthoutsesteenweg 2,2022-10-21,05:00:00,2,2,0,ECO_300019380
642,Herenthoutsesteenweg 2,2022-10-21,06:00:00,3,3,0,ECO_300019380
642,Herenthoutsesteenweg 2,2022-10-21,07:00:00,20,19,1,ECO_300019380
642,Herenthoutsesteenweg 2,2022-10-21,08:00:00,39,37,2,ECO_300019380
642,Herenthoutsesteenweg 2,2022-10-21,09:00:00,182,175,7,ECO_300019380
642,Herenthoutsesteenweg 2,2022-10-21,10:00:00,569,550,19,ECO_300019380
642,Herenthoutsesteenweg 2,2022-10-21,11:00:00,79,74,5,ECO_300019380
642,Herenthoutsesteenweg 2,2022-10-21,12:00:00,72,69,3,ECO_300019380
642,Herenthoutsesteenweg 2,2022-10-21,13:00:00,60,52,8,ECO_300019380
642,Herenthoutsesteenweg 2,2022-10-21,14:00:00,72,68,4,ECO_300019380
642,Herenthoutsesteenweg 2,2022-10-21,15:00:00,107,100,7,ECO_300019380
642,Herenthoutsesteenweg 2,2022-10-21,16:00:00,118,106,12,ECO_300019380
642,Herenthoutsesteenweg 2,2022-10-21,17:00:00,151,133,18,ECO_300019380
642,Herenthoutsesteenweg 2,2022-10-21,18:00:00,156,139,17,ECO_300019380
642,Herenthoutsesteenweg 2,2022-10-21,19:00:00,84,77,7,ECO_300019380
642,Herenthoutsesteenweg 2,2022-10-21,20:00:00,85,74,11,ECO_300019380
642,Herenthoutsesteenweg 2,2022-10-21,21:00:00,53,50,3,ECO_300019380
642,Herenthoutsesteenweg 2,2022-10-21,22:00:00,23,22,1,ECO_300019380
642,Herenthoutsesteenweg 2,2022-10-21,23:00:00,33,31,2,ECO_300019380
642,Herenthoutsesteenweg 2,2022-10-22,00:00:00,29,28,1,ECO_300019380
642,Herenthoutsesteenweg 2,2022-10-22,01:00:00,46,44,2,ECO_300019380
642,Herenthoutsesteenweg 2,2022-10-22,02:00:00,31,28,3,ECO_300019380
642,Herenthoutsesteenweg 2,2022-10-22,03:00:00,15,10,5,ECO_300019380
642,Herenthoutsesteenweg 2,2022-10-22,04:00:00,3,1,2,ECO_300019380
642,Herenthoutsesteenweg 2,2022-10-22,05:00:00,5,4,1,ECO_300019380
642,Herenthoutsesteenweg 2,2022-10-22,06:00:00,3,3,0,ECO_300019380
642,Herenthoutsesteenweg 2,2022-10-22,07:00:00,3,3,0,ECO_300019380
642,Herenthoutsesteenweg 2,2022-10-22,08:00:00,12,10,2,ECO_300019380
642,Herenthoutsesteenweg 2,2022-10-22,09:00:00,14,14,0,ECO_300019380
642,Herenthoutsesteenweg 2,2022-10-22,10:00:00,43,42,1,ECO_300019380
642,Herenthoutsesteenweg 2,2022-10-22,11:00:00,63,60,3,ECO_300019380
642,Herenthoutsesteenweg 2,2022-10-22,12:00:00,98,94,4,ECO_300019380
642,Herenthoutsesteenweg 2,2022-10-22,13:00:00,83,78,5,ECO_300019380
642,Herenthoutsesteenweg 2,2022-10-22,14:00:00,109,96,13,ECO_300019380
642,Herenthoutsesteenweg 2,2022-10-22,15:00:00,160,151,9,ECO_300019380
642,Herenthoutsesteenweg 2,2022-10-22,16:00:00,113,103,10,ECO_300019380
642,Herenthoutsesteenweg 2,2022-10-22,17:00:00,108,94,14,ECO_300019380
642,Herenthoutsesteenweg 2,2022-10-22,18:00:00,103,96,7,ECO_300019380
642,Herenthoutsesteenweg 2,2022-10-22,19:00:00,57,54,3,ECO_300019380
642,Herenthoutsesteenweg 2,2022-10-22,20:00:00,48,47,1,ECO_300019380
642,Herenthoutsesteenweg 2,2022-10-22,21:00:00,55,51,4,ECO_300019380
642,Herenthoutsesteenweg 2,2022-10-22,22:00:00,43,37,6,ECO_300019380
642,Herenthoutsesteenweg 2,2022-10-22,23:00:00,18,15,3,ECO_300019380
642,Herenthoutsesteenweg 2,2022-10-23,00:00:00,37,32,5,ECO_300019380
642,Herenthoutsesteenweg 2,2022-10-23,01:00:00,16,15,1,ECO_300019380
642,Herenthoutsesteenweg 2,2022-10-23,02:00:00,6,2,4,ECO_300019380
642,Herenthoutsesteenweg 2,2022-10-23,03:00:00,7,3,4,ECO_300019380
642,Herenthoutsesteenweg 2,2022-10-23,04:00:00,3,2,1,ECO_300019380
642,Herenthoutsesteenweg 2,2022-10-23,05:00:00,4,4,0,ECO_300019380
642,Herenthoutsesteenweg 2,2022-10-23,06:00:00,2,2,0,ECO_300019380
642,Herenthoutsesteenweg 2,2022-10-23,07:00:00,6,5,1,ECO_300019380
642,Herenthoutsesteenweg 2,2022-10-23,08:00:00,5,5,0,ECO_300019380
642,Herenthoutsesteenweg 2,2022-10-23,09:00:00,7,6,1,ECO_300019380
642,Herenthoutsesteenweg 2,2022-10-23,10:00:00,42,39,3,ECO_300019380
642,Herenthoutsesteenweg 2,2022-10-23,11:00:00,106,95,11,ECO_300019380
642,Herenthoutsesteenweg 2,2022-10-23,12:00:00,112,99,13,ECO_300019380
642,Herenthoutsesteenweg 2,2022-10-23,13:00:00,96,81,15,ECO_300019380
642,Herenthoutsesteenweg 2,2022-10-23,14:00:00,53,46,7,ECO_300019380
642,Herenthoutsesteenweg 2,2022-10-23,15:00:00,73,70,3,ECO_300019380
642,Herenthoutsesteenweg 2,2022-10-23,16:00:00,76,75,1,ECO_300019380
642,Herenthoutsesteenweg 2,2022-10-23,17:00:00,84,79,5,ECO_300019380
642,Herenthoutsesteenweg 2,2022-10-23,18:00:00,55,49,6,ECO_300019380
642,Herenthoutsesteenweg 2,2022-10-23,19:00:00,40,38,2,ECO_300019380
642,Herenthoutsesteenweg 2,2022-10-23,20:00:00,33,24,9,ECO_300019380
642,Herenthoutsesteenweg 2,2022-10-23,21:00:00,24,22,2,ECO_300019380
642,Herenthoutsesteenweg 2,2022-10-23,22:00:00,4,3,1,ECO_300019380
642,Herenthoutsesteenweg 2,2022-10-23,23:00:00,7,7,0,ECO_300019380
642,Herenthoutsesteenweg 2,2022-10-24,00:00:00,4,3,1,ECO_300019380
642,Herenthoutsesteenweg 2,2022-10-24,01:00:00,1,1,0,ECO_300019380
642,Herenthoutsesteenweg 2,2022-10-24,02:00:00,2,2,0,ECO_300019380
642,Herenthoutsesteenweg 2,2022-10-24,03:00:00,1,1,0,ECO_300019380
642,Herenthoutsesteenweg 2,2022-10-24,04:00:00,0,0,0,ECO_300019380
642,Herenthoutsesteenweg 2,2022-10-24,05:00:00,0,0,0,ECO_300019380
642,Herenthoutsesteenweg 2,2022-10-24,06:00:00,1,1,0,ECO_300019380
642,Herenthoutsesteenweg 2,2022-10-24,07:00:00,20,18,2,ECO_300019380
642,Herenthoutsesteenweg 2,2022-10-24,08:00:00,44,37,7,ECO_300019380
642,Herenthoutsesteenweg 2,2022-10-24,09:00:00,133,129,4,ECO_300019380
642,Herenthoutsesteenweg 2,2022-10-24,10:00:00,510,504,6,ECO_300019380
642,Herenthoutsesteenweg 2,2022-10-24,11:00:00,65,60,5,ECO_300019380
642,Herenthoutsesteenweg 2,2022-10-24,12:00:00,42,41,1,ECO_300019380
642,Herenthoutsesteenweg 2,2022-10-24,13:00:00,34,32,2,ECO_300019380
642,Herenthoutsesteenweg 2,2022-10-24,14:00:00,48,45,3,ECO_300019380
642,Herenthoutsesteenweg 2,2022-10-24,15:00:00,54,52,2,ECO_300019380
642,Herenthoutsesteenweg 2,2022-10-24,16:00:00,61,53,8,ECO_300019380
642,Herenthoutsesteenweg 2,2022-10-24,17:00:00,81,77,4,ECO_300019380
642,Herenthoutsesteenweg 2,2022-10-24,18:00:00,114,108,6,ECO_300019380
642,Herenthoutsesteenweg 2,2022-10-24,19:00:00,77,73,4,ECO_300019380
642,Herenthoutsesteenweg 2,2022-10-24,20:00:00,54,46,8,ECO_300019380
642,Herenthoutsesteenweg 2,2022-10-24,21:00:00,22,21,1,ECO_300019380
642,Herenthoutsesteenweg 2,2022-10-24,22:00:00,14,13,1,ECO_300019380
642,Herenthoutsesteenweg 2,2022-10-24,23:00:00,23,19,4,ECO_300019380
642,Herenthoutsesteenweg 2,2022-10-25,00:00:00,15,14,1,ECO_300019380
642,Herenthoutsesteenweg 2,2022-10-25,01:00:00,3,1,2,ECO_300019380
642,Herenthoutsesteenweg 2,2022-10-25,02:00:00,5,5,0,ECO_300019380
642,Herenthoutsesteenweg 2,2022-10-25,03:00:00,0,0,0,ECO_300019380
642,Herenthoutsesteenweg 2,2022-10-25,04:00:00,1,1,0,ECO_300019380
642,Herenthoutsesteenweg 2,2022-10-25,05:00:00,0,0,0,ECO_300019380
642,Herenthoutsesteenweg 2,2022-10-25,06:00:00,2,2,0,ECO_300019380
642,Herenthoutsesteenweg 2,2022-10-25,07:00:00,23,21,2,ECO_300019380
642,Herenthoutsesteenweg 2,2022-10-25,08:00:00,57,47,10,ECO_300019380
642,Herenthoutsesteenweg 2,2022-10-25,09:00:00,171,160,11,ECO_300019380
642,Herenthoutsesteenweg 2,2022-10-25,10:00:00,550,537,13,ECO_300019380
642,Herenthoutsesteenweg 2,2022-10-25,11:00:00,74,71,3,ECO_300019380
642,Herenthoutsesteenweg 2,2022-10-25,12:00:00,71,67,4,ECO_300019380
642,Herenthoutsesteenweg 2,2022-10-25,13:00:00,71,64,7,ECO_300019380
642,Herenthoutsesteenweg 2,2022-10-25,14:00:00,90,79,11,ECO_300019380
642,Herenthoutsesteenweg 2,2022-10-25,15:00:00,139,129,10,ECO_300019380
642,Herenthoutsesteenweg 2,2022-10-25,16:00:00,114,104,10,ECO_300019380
642,Herenthoutsesteenweg 2,2022-10-25,17:00:00,106,94,12,ECO_300019380
642,Herenthoutsesteenweg 2,2022-10-25,18:00:00,167,156,11,ECO_300019380
642,Herenthoutsesteenweg 2,2022-10-25,19:00:00,92,85,7,ECO_300019380
642,Herenthoutsesteenweg 2,2022-10-25,20:00:00,63,55,8,ECO_300019380
642,Herenthoutsesteenweg 2,2022-10-25,21:00:00,33,31,2,ECO_300019380
642,Herenthoutsesteenweg 2,2022-10-25,22:00:00,11,9,2,ECO_300019380
642,Herenthoutsesteenweg 2,2022-10-25,23:00:00,17,16,1,ECO_300019380
642,Herenthoutsesteenweg 2,2022-10-26,00:00:00,20,18,2,ECO_300019380
642,Herenthoutsesteenweg 2,2022-10-26,01:00:00,3,1,2,ECO_300019380
642,Herenthoutsesteenweg 2,2022-10-26,02:00:00,2,1,1,ECO_300019380
642,Herenthoutsesteenweg 2,2022-10-26,03:00:00,2,1,1,ECO_300019380
642,Herenthoutsesteenweg 2,2022-10-26,04:00:00,0,0,0,ECO_300019380
642,Herenthoutsesteenweg 2,2022-10-26,05:00:00,0,0,0,ECO_300019380
642,Herenthoutsesteenweg 2,2022-10-26,06:00:00,6,6,0,ECO_300019380
642,Herenthoutsesteenweg 2,2022-10-26,07:00:00,21,19,2,ECO_300019380
642,Herenthoutsesteenweg 2,2022-10-26,08:00:00,58,49,9,ECO_300019380
642,Herenthoutsesteenweg 2,2022-10-26,09:00:00,138,133,5,ECO_300019380
642,Herenthoutsesteenweg 2,2022-10-26,10:00:00,519,509,10,ECO_300019380
642,Herenthoutsesteenweg 2,2022-10-26,11:00:00,83,82,1,ECO_300019380
642,Herenthoutsesteenweg 2,2022-10-26,12:00:00,71,68,3,ECO_300019380
642,Herenthoutsesteenweg 2,2022-10-26,13:00:00,78,76,2,ECO_300019380
642,Herenthoutsesteenweg 2,2022-10-26,14:00:00,142,134,8,ECO_300019380
642,Herenthoutsesteenweg 2,2022-10-26,15:00:00,200,187,13,ECO_300019380
642,Herenthoutsesteenweg 2,2022-10-26,16:00:00,154,147,7,ECO_300019380
642,Herenthoutsesteenweg 2,2022-10-26,17:00:00,120,112,8,ECO_300019380
642,Herenthoutsesteenweg 2,2022-10-26,18:00:00,203,174,29,ECO_300019380
642,Herenthoutsesteenweg 2,2022-10-26,19:00:00,100,86,14,ECO_300019380
642,Herenthoutsesteenweg 2,2022-10-26,20:00:00,69,59,10,ECO_300019380
642,Herenthoutsesteenweg 2,2022-10-26,21:00:00,42,40,2,ECO_300019380
642,Herenthoutsesteenweg 2,2022-10-26,22:00:00,23,18,5,ECO_300019380
642,Herenthoutsesteenweg 2,2022-10-26,23:00:00,9,9,0,ECO_300019380
642,Herenthoutsesteenweg 2,2022-10-27,00:00:00,21,19,2,ECO_300019380
642,Herenthoutsesteenweg 2,2022-10-27,01:00:00,18,12,6,ECO_300019380
642,Herenthoutsesteenweg 2,2022-10-27,02:00:00,2,1,1,ECO_300019380
642,Herenthoutsesteenweg 2,2022-10-27,03:00:00,1,1,0,ECO_300019380
642,Herenthoutsesteenweg 2,2022-10-27,04:00:00,1,1,0,ECO_300019380
642,Herenthoutsesteenweg 2,2022-10-27,05:00:00,0,0,0,ECO_300019380
642,Herenthoutsesteenweg 2,2022-10-27,06:00:00,11,9,2,ECO_300019380
642,Herenthoutsesteenweg 2,2022-10-27,07:00:00,19,18,1,ECO_300019380
642,Herenthoutsesteenweg 2,2022-10-27,08:00:00,59,53,6,ECO_300019380
642,Herenthoutsesteenweg 2,2022-10-27,09:00:00,161,151,10,ECO_300019380
642,Herenthoutsesteenweg 2,2022-10-27,10:00:00,613,605,8,ECO_300019380
642,Herenthoutsesteenweg 2,2022-10-27,11:00:00,86,82,4,ECO_300019380
642,Herenthoutsesteenweg 2,2022-10-27,12:00:00,72,70,2,ECO_300019380
642,Herenthoutsesteenweg 2,2022-10-27,13:00:00,72,69,3,ECO_300019380
642,Herenthoutsesteenweg 2,2022-10-27,14:00:00,90,81,9,ECO_300019380
642,Herenthoutsesteenweg 2,2022-10-27,15:00:00,157,152,5,ECO_300019380
642,Herenthoutsesteenweg 2,2022-10-27,16:00:00,109,96,13,ECO_300019380
642,Herenthoutsesteenweg 2,2022-10-27,17:00:00,204,191,13,ECO_300019380
642,Herenthoutsesteenweg 2,2022-10-27,18:00:00,154,145,9,ECO_300019380
642,Herenthoutsesteenweg 2,2022-10-27,19:00:00,151,129,22,ECO_300019380
642,Herenthoutsesteenweg 2,2022-10-27,20:00:00,72,66,6,ECO_300019380
642,Herenthoutsesteenweg 2,2022-10-27,21:00:00,45,44,1,ECO_300019380
642,Herenthoutsesteenweg 2,2022-10-27,22:00:00,31,27,4,ECO_300019380
642,Herenthoutsesteenweg 2,2022-10-27,23:00:00,23,20,3,ECO_300019380
642,Herenthoutsesteenweg 2,2022-10-28,00:00:00,25,23,2,ECO_300019380
642,Herenthoutsesteenweg 2,2022-10-28,01:00:00,4,2,2,ECO_300019380
642,Herenthoutsesteenweg 2,2022-10-28,02:00:00,1,0,1,ECO_300019380
642,Herenthoutsesteenweg 2,2022-10-28,03:00:00,2,1,1,ECO_300019380
642,Herenthoutsesteenweg 2,2022-10-28,04:00:00,2,0,2,ECO_300019380
642,Herenthoutsesteenweg 2,2022-10-28,05:00:00,0,0,0,ECO_300019380
642,Herenthoutsesteenweg 2,2022-10-28,06:00:00,3,3,0,ECO_300019380
642,Herenthoutsesteenweg 2,2022-10-28,07:00:00,16,15,1,ECO_300019380
642,Herenthoutsesteenweg 2,2022-10-28,08:00:00,45,43,2,ECO_300019380
642,Herenthoutsesteenweg 2,2022-10-28,09:00:00,147,144,3,ECO_300019380
642,Herenthoutsesteenweg 2,2022-10-28,10:00:00,639,628,11,ECO_300019380
642,Herenthoutsesteenweg 2,2022-10-28,11:00:00,140,136,4,ECO_300019380
642,Herenthoutsesteenweg 2,2022-10-28,12:00:00,136,131,5,ECO_300019380
642,Herenthoutsesteenweg 2,2022-10-28,13:00:00,84,81,3,ECO_300019380
642,Herenthoutsesteenweg 2,2022-10-28,14:00:00,92,81,11,ECO_300019380
642,Herenthoutsesteenweg 2,2022-10-28,15:00:00,153,144,9,ECO_300019380
642,Herenthoutsesteenweg 2,2022-10-28,16:00:00,136,115,21,ECO_300019380
642,Herenthoutsesteenweg 2,2022-10-28,17:00:00,161,156,5,ECO_300019380
642,Herenthoutsesteenweg 2,2022-10-28,18:00:00,170,151,19,ECO_300019380
642,Herenthoutsesteenweg 2,2022-10-28,19:00:00,83,76,7,ECO_300019380
642,Herenthoutsesteenweg 2,2022-10-28,20:00:00,76,68,8,ECO_300019380
642,Herenthoutsesteenweg 2,2022-10-28,21:00:00,33,31,2,ECO_300019380
642,Herenthoutsesteenweg 2,2022-10-28,22:00:00,32,27,5,ECO_300019380
642,Herenthoutsesteenweg 2,2022-10-28,23:00:00,27,26,1,ECO_300019380
642,Herenthoutsesteenweg 2,2022-10-29,00:00:00,30,27,3,ECO_300019380
642,Herenthoutsesteenweg 2,2022-10-29,01:00:00,17,13,4,ECO_300019380
642,Herenthoutsesteenweg 2,2022-10-29,02:00:00,4,3,1,ECO_300019380
642,Herenthoutsesteenweg 2,2022-10-29,03:00:00,10,8,2,ECO_300019380
642,Herenthoutsesteenweg 2,2022-10-29,04:00:00,3,1,2,ECO_300019380
642,Herenthoutsesteenweg 2,2022-10-29,05:00:00,2,0,2,ECO_300019380
642,Herenthoutsesteenweg 2,2022-10-29,06:00:00,2,1,1,ECO_300019380
642,Herenthoutsesteenweg 2,2022-10-29,07:00:00,5,5,0,ECO_300019380
642,Herenthoutsesteenweg 2,2022-10-29,08:00:00,12,11,1,ECO_300019380
642,Herenthoutsesteenweg 2,2022-10-29,09:00:00,14,13,1,ECO_300019380
642,Herenthoutsesteenweg 2,2022-10-29,10:00:00,39,39,0,ECO_300019380
642,Herenthoutsesteenweg 2,2022-10-29,11:00:00,65,64,1,ECO_300019380
642,Herenthoutsesteenweg 2,2022-10-29,12:00:00,73,72,1,ECO_300019380
642,Herenthoutsesteenweg 2,2022-10-29,13:00:00,83,79,4,ECO_300019380
642,Herenthoutsesteenweg 2,2022-10-29,14:00:00,126,111,15,ECO_300019380
642,Herenthoutsesteenweg 2,2022-10-29,15:00:00,168,158,10,ECO_300019380
642,Herenthoutsesteenweg 2,2022-10-29,16:00:00,163,151,12,ECO_300019380
642,Herenthoutsesteenweg 2,2022-10-29,17:00:00,137,127,10,ECO_300019380
642,Herenthoutsesteenweg 2,2022-10-29,18:00:00,76,67,9,ECO_300019380
642,Herenthoutsesteenweg 2,2022-10-29,19:00:00,66,62,4,ECO_300019380
642,Herenthoutsesteenweg 2,2022-10-29,20:00:00,64,59,5,ECO_300019380
642,Herenthoutsesteenweg 2,2022-10-29,21:00:00,31,30,1,ECO_300019380
642,Herenthoutsesteenweg 2,2022-10-29,22:00:00,34,32,2,ECO_300019380
642,Herenthoutsesteenweg 2,2022-10-29,23:00:00,20,18,2,ECO_300019380
642,Herenthoutsesteenweg 2,2022-10-30,00:00:00,18,17,1,ECO_300019380
642,Herenthoutsesteenweg 2,2022-10-30,01:00:00,14,11,3,ECO_300019380
642,Herenthoutsesteenweg 2,2022-10-30,02:00:00,22,14,8,ECO_300019380
642,Herenthoutsesteenweg 2,2022-10-30,03:00:00,5,3,2,ECO_300019380
642,Herenthoutsesteenweg 2,2022-10-30,04:00:00,3,3,0,ECO_300019380
642,Herenthoutsesteenweg 2,2022-10-30,05:00:00,1,1,0,ECO_300019380
642,Herenthoutsesteenweg 2,2022-10-30,06:00:00,2,2,0,ECO_300019380
642,Herenthoutsesteenweg 2,2022-10-30,07:00:00,10,10,0,ECO_300019380
642,Herenthoutsesteenweg 2,2022-10-30,08:00:00,32,30,2,ECO_300019380
642,Herenthoutsesteenweg 2,2022-10-30,09:00:00,83,78,5,ECO_300019380
642,Herenthoutsesteenweg 2,2022-10-30,10:00:00,157,147,10,ECO_300019380
642,Herenthoutsesteenweg 2,2022-10-30,11:00:00,133,119,14,ECO_300019380
642,Herenthoutsesteenweg 2,2022-10-30,12:00:00,131,117,14,ECO_300019380
642,Herenthoutsesteenweg 2,2022-10-30,13:00:00,121,109,12,ECO_300019380
642,Herenthoutsesteenweg 2,2022-10-30,14:00:00,141,133,8,ECO_300019380
642,Herenthoutsesteenweg 2,2022-10-30,15:00:00,176,162,14,ECO_300019380
642,Herenthoutsesteenweg 2,2022-10-30,16:00:00,115,106,9,ECO_300019380
642,Herenthoutsesteenweg 2,2022-10-30,17:00:00,85,75,10,ECO_300019380
642,Herenthoutsesteenweg 2,2022-10-30,18:00:00,57,56,1,ECO_300019380
642,Herenthoutsesteenweg 2,2022-10-30,19:00:00,32,24,8,ECO_300019380
642,Herenthoutsesteenweg 2,2022-10-30,20:00:00,20,19,1,ECO_300019380
642,Herenthoutsesteenweg 2,2022-10-30,21:00:00,14,14,0,ECO_300019380
642,Herenthoutsesteenweg 2,2022-10-30,22:00:00,10,9,1,ECO_300019380
642,Herenthoutsesteenweg 2,2022-10-30,23:00:00,2,2,0,ECO_300019380
642,Herenthoutsesteenweg 2,2022-10-31,00:00:00,6,4,2,ECO_300019380
642,Herenthoutsesteenweg 2,2022-10-31,01:00:00,1,1,0,ECO_300019380
642,Herenthoutsesteenweg 2,2022-10-31,02:00:00,1,1,0,ECO_300019380
642,Herenthoutsesteenweg 2,2022-10-31,03:00:00,0,0,0,ECO_300019380
642,Herenthoutsesteenweg 2,2022-10-31,04:00:00,1,1,0,ECO_300019380
642,Herenthoutsesteenweg 2,2022-10-31,05:00:00,5,4,1,ECO_300019380
642,Herenthoutsesteenweg 2,2022-10-31,06:00:00,9,8,1,ECO_300019380
642,Herenthoutsesteenweg 2,2022-10-31,07:00:00,14,12,2,ECO_300019380
642,Herenthoutsesteenweg 2,2022-10-31,08:00:00,34,32,2,ECO_300019380
642,Herenthoutsesteenweg 2,2022-10-31,09:00:00,39,38,1,ECO_300019380
642,Herenthoutsesteenweg 2,2022-10-31,10:00:00,51,49,2,ECO_300019380
642,Herenthoutsesteenweg 2,2022-10-31,11:00:00,36,35,1,ECO_300019380
642,Herenthoutsesteenweg 2,2022-10-31,12:00:00,52,47,5,ECO_300019380
642,Herenthoutsesteenweg 2,2022-10-31,13:00:00,62,58,4,ECO_300019380
642,Herenthoutsesteenweg 2,2022-10-31,14:00:00,101,93,8,ECO_300019380
642,Herenthoutsesteenweg 2,2022-10-31,15:00:00,131,120,11,ECO_300019380
642,Herenthoutsesteenweg 2,2022-10-31,16:00:00,109,102,7,ECO_300019380
642,Herenthoutsesteenweg 2,2022-10-31,17:00:00,69,66,3,ECO_300019380
642,Herenthoutsesteenweg 2,2022-10-31,18:00:00,62,57,5,ECO_300019380
642,Herenthoutsesteenweg 2,2022-10-31,19:00:00,41,33,8,ECO_300019380
642,Herenthoutsesteenweg 2,2022-10-31,20:00:00,34,31,3,ECO_300019380
642,Herenthoutsesteenweg 2,2022-10-31,21:00:00,37,32,5,ECO_300019380
642,Herenthoutsesteenweg 2,2022-10-31,22:00:00,30,27,3,ECO_300019380
642,Herenthoutsesteenweg 2,2022-10-31,23:00:00,19,18,1,ECO_300019380
642,Herenthoutsesteenweg 2,2022-11-01,00:00:00,3,3,0,ECO_300019380
642,Herenthoutsesteenweg 2,2022-11-01,01:00:00,5,5,0,ECO_300019380
642,Herenthoutsesteenweg 2,2022-11-01,02:00:00,0,0,0,ECO_300019380
642,Herenthoutsesteenweg 2,2022-11-01,03:00:00,3,2,1,ECO_300019380
642,Herenthoutsesteenweg 2,2022-11-01,04:00:00,2,1,1,ECO_300019380
642,Herenthoutsesteenweg 2,2022-11-01,05:00:00,2,0,2,ECO_300019380
642,Herenthoutsesteenweg 2,2022-11-01,06:00:00,4,4,0,ECO_300019380
642,Herenthoutsesteenweg 2,2022-11-01,07:00:00,7,7,0,ECO_300019380
642,Herenthoutsesteenweg 2,2022-11-01,08:00:00,12,10,2,ECO_300019380
642,Herenthoutsesteenweg 2,2022-11-01,09:00:00,23,22,1,ECO_300019380
642,Herenthoutsesteenweg 2,2022-11-01,10:00:00,62,52,10,ECO_300019380
642,Herenthoutsesteenweg 2,2022-11-01,11:00:00,80,70,10,ECO_300019380
642,Herenthoutsesteenweg 2,2022-11-01,12:00:00,55,45,10,ECO_300019380
642,Herenthoutsesteenweg 2,2022-11-01,13:00:00,39,38,1,ECO_300019380
642,Herenthoutsesteenweg 2,2022-11-01,14:00:00,78,72,6,ECO_300019380
642,Herenthoutsesteenweg 2,2022-11-01,15:00:00,62,52,10,ECO_300019380
642,Herenthoutsesteenweg 2,2022-11-01,16:00:00,52,42,10,ECO_300019380
642,Herenthoutsesteenweg 2,2022-11-01,17:00:00,53,48,5,ECO_300019380
642,Herenthoutsesteenweg 2,2022-11-01,18:00:00,22,16,6,ECO_300019380
642,Herenthoutsesteenweg 2,2022-11-01,19:00:00,19,15,4,ECO_300019380
642,Herenthoutsesteenweg 2,2022-11-01,20:00:00,17,15,2,ECO_300019380
642,Herenthoutsesteenweg 2,2022-11-01,21:00:00,11,11,0,ECO_300019380
642,Herenthoutsesteenweg 2,2022-11-01,22:00:00,5,5,0,ECO_300019380
642,Herenthoutsesteenweg 2,2022-11-01,23:00:00,5,4,1,ECO_300019380
642,Herenthoutsesteenweg 2,2022-11-02,00:00:00,5,4,1,ECO_300019380
642,Herenthoutsesteenweg 2,2022-11-02,01:00:00,2,2,0,ECO_300019380
642,Herenthoutsesteenweg 2,2022-11-02,02:00:00,0,0,0,ECO_300019380
642,Herenthoutsesteenweg 2,2022-11-02,03:00:00,2,2,0,ECO_300019380
642,Herenthoutsesteenweg 2,2022-11-02,04:00:00,0,0,0,ECO_300019380
642,Herenthoutsesteenweg 2,2022-11-02,05:00:00,1,1,0,ECO_300019380
642,Herenthoutsesteenweg 2,2022-11-02,06:00:00,16,16,0,ECO_300019380
642,Herenthoutsesteenweg 2,2022-11-02,07:00:00,35,28,7,ECO_300019380
642,Herenthoutsesteenweg 2,2022-11-02,08:00:00,62,61,1,ECO_300019380
642,Herenthoutsesteenweg 2,2022-11-02,09:00:00,60,59,1,ECO_300019380
642,Herenthoutsesteenweg 2,2022-11-02,10:00:00,68,66,2,ECO_300019380
642,Herenthoutsesteenweg 2,2022-11-02,11:00:00,66,61,5,ECO_300019380
642,Herenthoutsesteenweg 2,2022-11-02,12:00:00,66,62,4,ECO_300019380
642,Herenthoutsesteenweg 2,2022-11-02,13:00:00,96,88,8,ECO_300019380
642,Herenthoutsesteenweg 2,2022-11-02,14:00:00,138,131,7,ECO_300019380
642,Herenthoutsesteenweg 2,2022-11-02,15:00:00,128,121,7,ECO_300019380
642,Herenthoutsesteenweg 2,2022-11-02,16:00:00,98,85,13,ECO_300019380
642,Herenthoutsesteenweg 2,2022-11-02,17:00:00,111,100,11,ECO_300019380
642,Herenthoutsesteenweg 2,2022-11-02,18:00:00,87,81,6,ECO_300019380
642,Herenthoutsesteenweg 2,2022-11-02,19:00:00,33,28,5,ECO_300019380
642,Herenthoutsesteenweg 2,2022-11-02,20:00:00,28,28,0,ECO_300019380
642,Herenthoutsesteenweg 2,2022-11-02,21:00:00,20,18,2,ECO_300019380
642,Herenthoutsesteenweg 2,2022-11-02,22:00:00,31,27,4,ECO_300019380
642,Herenthoutsesteenweg 2,2022-11-02,23:00:00,27,23,4,ECO_300019380
642,Herenthoutsesteenweg 2,2022-11-03,00:00:00,5,4,1,ECO_300019380
642,Herenthoutsesteenweg 2,2022-11-03,01:00:00,0,0,0,ECO_300019380
642,Herenthoutsesteenweg 2,2022-11-03,02:00:00,1,1,0,ECO_300019380
642,Herenthoutsesteenweg 2,2022-11-03,03:00:00,0,0,0,ECO_300019380
642,Herenthoutsesteenweg 2,2022-11-03,04:00:00,1,0,1,ECO_300019380
642,Herenthoutsesteenweg 2,2022-11-03,05:00:00,1,1,0,ECO_300019380
642,Herenthoutsesteenweg 2,2022-11-03,06:00:00,12,11,1,ECO_300019380
642,Herenthoutsesteenweg 2,2022-11-03,07:00:00,40,33,7,ECO_300019380
642,Herenthoutsesteenweg 2,2022-11-03,08:00:00,73,71,2,ECO_300019380
642,Herenthoutsesteenweg 2,2022-11-03,09:00:00,53,49,4,ECO_300019380
642,Herenthoutsesteenweg 2,2022-11-03,10:00:00,56,51,5,ECO_300019380
642,Herenthoutsesteenweg 2,2022-11-03,11:00:00,74,72,2,ECO_300019380
642,Herenthoutsesteenweg 2,2022-11-03,12:00:00,68,64,4,ECO_300019380
642,Herenthoutsesteenweg 2,2022-11-03,13:00:00,57,50,7,ECO_300019380
642,Herenthoutsesteenweg 2,2022-11-03,14:00:00,84,81,3,ECO_300019380
642,Herenthoutsesteenweg 2,2022-11-03,15:00:00,60,50,10,ECO_300019380
642,Herenthoutsesteenweg 2,2022-11-03,16:00:00,50,47,3,ECO_300019380
642,Herenthoutsesteenweg 2,2022-11-03,17:00:00,79,75,4,ECO_300019380
642,Herenthoutsesteenweg 2,2022-11-03,18:00:00,42,36,6,ECO_300019380
642,Herenthoutsesteenweg 2,2022-11-03,19:00:00,25,23,2,ECO_300019380
642,Herenthoutsesteenweg 2,2022-11-03,20:00:00,23,19,4,ECO_300019380
642,Herenthoutsesteenweg 2,2022-11-03,21:00:00,13,8,5,ECO_300019380
642,Herenthoutsesteenweg 2,2022-11-03,22:00:00,7,7,0,ECO_300019380
642,Herenthoutsesteenweg 2,2022-11-03,23:00:00,17,15,2,ECO_300019380
642,Herenthoutsesteenweg 2,2022-11-04,00:00:00,5,4,1,ECO_300019380
642,Herenthoutsesteenweg 2,2022-11-04,01:00:00,0,0,0,ECO_300019380
642,Herenthoutsesteenweg 2,2022-11-04,02:00:00,0,0,0,ECO_300019380
642,Herenthoutsesteenweg 2,2022-11-04,03:00:00,2,1,1,ECO_300019380
642,Herenthoutsesteenweg 2,2022-11-04,04:00:00,0,0,0,ECO_300019380
642,Herenthoutsesteenweg 2,2022-11-04,05:00:00,1,1,0,ECO_300019380
642,Herenthoutsesteenweg 2,2022-11-04,06:00:00,17,15,2,ECO_300019380
642,Herenthoutsesteenweg 2,2022-11-04,07:00:00,34,33,1,ECO_300019380
642,Herenthoutsesteenweg 2,2022-11-04,08:00:00,46,43,3,ECO_300019380
642,Herenthoutsesteenweg 2,2022-11-04,09:00:00,49,45,4,ECO_300019380
642,Herenthoutsesteenweg 2,2022-11-04,10:00:00,64,62,2,ECO_300019380
642,Herenthoutsesteenweg 2,2022-11-04,11:00:00,70,68,2,ECO_300019380
642,Herenthoutsesteenweg 2,2022-11-04,12:00:00,61,58,3,ECO_300019380
642,Herenthoutsesteenweg 2,2022-11-04,13:00:00,46,37,9,ECO_300019380
642,Herenthoutsesteenweg 2,2022-11-04,14:00:00,79,74,5,ECO_300019380
642,Herenthoutsesteenweg 2,2022-11-04,15:00:00,74,69,5,ECO_300019380
642,Herenthoutsesteenweg 2,2022-11-04,16:00:00,63,55,8,ECO_300019380
642,Herenthoutsesteenweg 2,2022-11-04,17:00:00,90,84,6,ECO_300019380
642,Herenthoutsesteenweg 2,2022-11-04,18:00:00,46,39,7,ECO_300019380
642,Herenthoutsesteenweg 2,2022-11-04,19:00:00,42,39,3,ECO_300019380
642,Herenthoutsesteenweg 2,2022-11-04,20:00:00,30,28,2,ECO_300019380
642,Herenthoutsesteenweg 2,2022-11-04,21:00:00,22,21,1,ECO_300019380
642,Herenthoutsesteenweg 2,2022-11-04,22:00:00,20,20,0,ECO_300019380
642,Herenthoutsesteenweg 2,2022-11-04,23:00:00,51,49,2,ECO_300019380
642,Herenthoutsesteenweg 2,2022-11-05,00:00:00,15,12,3,ECO_300019380
642,Herenthoutsesteenweg 2,2022-11-05,01:00:00,11,10,1,ECO_300019380
642,Herenthoutsesteenweg 2,2022-11-05,02:00:00,6,5,1,ECO_300019380
642,Herenthoutsesteenweg 2,2022-11-05,03:00:00,4,3,1,ECO_300019380
642,Herenthoutsesteenweg 2,2022-11-05,04:00:00,1,1,0,ECO_300019380
642,Herenthoutsesteenweg 2,2022-11-05,05:00:00,0,0,0,ECO_300019380
642,Herenthoutsesteenweg 2,2022-11-05,06:00:00,4,4,0,ECO_300019380
642,Herenthoutsesteenweg 2,2022-11-05,07:00:00,9,8,1,ECO_300019380
642,Herenthoutsesteenweg 2,2022-11-05,08:00:00,14,10,4,ECO_300019380
642,Herenthoutsesteenweg 2,2022-11-05,09:00:00,31,29,2,ECO_300019380
642,Herenthoutsesteenweg 2,2022-11-05,10:00:00,79,77,2,ECO_300019380
642,Herenthoutsesteenweg 2,2022-11-05,11:00:00,82,77,5,ECO_300019380
642,Herenthoutsesteenweg 2,2022-11-05,12:00:00,66,55,11,ECO_300019380
642,Herenthoutsesteenweg 2,2022-11-05,13:00:00,62,52,10,ECO_300019380
642,Herenthoutsesteenweg 2,2022-11-05,14:00:00,139,129,10,ECO_300019380
642,Herenthoutsesteenweg 2,2022-11-05,15:00:00,143,134,9,ECO_300019380
642,Herenthoutsesteenweg 2,2022-11-05,16:00:00,93,82,11,ECO_300019380
642,Herenthoutsesteenweg 2,2022-11-05,17:00:00,58,53,5,ECO_300019380
642,Herenthoutsesteenweg 2,2022-11-05,18:00:00,56,52,4,ECO_300019380
642,Herenthoutsesteenweg 2,2022-11-05,19:00:00,31,31,0,ECO_300019380
642,Herenthoutsesteenweg 2,2022-11-05,20:00:00,24,23,1,ECO_300019380
642,Herenthoutsesteenweg 2,2022-11-05,21:00:00,11,9,2,ECO_300019380
642,Herenthoutsesteenweg 2,2022-11-05,22:00:00,14,14,0,ECO_300019380
642,Herenthoutsesteenweg 2,2022-11-05,23:00:00,9,8,1,ECO_300019380
642,Herenthoutsesteenweg 2,2022-11-06,00:00:00,11,9,2,ECO_300019380
642,Herenthoutsesteenweg 2,2022-11-06,01:00:00,3,3,0,ECO_300019380
642,Herenthoutsesteenweg 2,2022-11-06,02:00:00,3,1,2,ECO_300019380
642,Herenthoutsesteenweg 2,2022-11-06,03:00:00,1,0,1,ECO_300019380
642,Herenthoutsesteenweg 2,2022-11-06,04:00:00,1,0,1,ECO_300019380
642,Herenthoutsesteenweg 2,2022-11-06,05:00:00,0,0,0,ECO_300019380
642,Herenthoutsesteenweg 2,2022-11-06,06:00:00,2,2,0,ECO_300019380
642,Herenthoutsesteenweg 2,2022-11-06,07:00:00,6,6,0,ECO_300019380
642,Herenthoutsesteenweg 2,2022-11-06,08:00:00,7,6,1,ECO_300019380
642,Herenthoutsesteenweg 2,2022-11-06,09:00:00,43,39,4,ECO_300019380
642,Herenthoutsesteenweg 2,2022-11-06,10:00:00,65,64,1,ECO_300019380
642,Herenthoutsesteenweg 2,2022-11-06,11:00:00,69,67,2,ECO_300019380
642,Herenthoutsesteenweg 2,2022-11-06,12:00:00,54,46,8,ECO_300019380
642,Herenthoutsesteenweg 2,2022-11-06,13:00:00,37,32,5,ECO_300019380
642,Herenthoutsesteenweg 2,2022-11-06,14:00:00,22,19,3,ECO_300019380
642,Herenthoutsesteenweg 2,2022-11-06,15:00:00,11,10,1,ECO_300019380
642,Herenthoutsesteenweg 2,2022-11-06,16:00:00,6,6,0,ECO_300019380
642,Herenthoutsesteenweg 2,2022-11-06,17:00:00,5,5,0,ECO_300019380
642,Herenthoutsesteenweg 2,2022-11-06,18:00:00,7,6,1,ECO_300019380
642,Herenthoutsesteenweg 2,2022-11-06,19:00:00,9,8,1,ECO_300019380
642,Herenthoutsesteenweg 2,2022-11-06,20:00:00,10,10,0,ECO_300019380
642,Herenthoutsesteenweg 2,2022-11-06,21:00:00,4,4,0,ECO_300019380
642,Herenthoutsesteenweg 2,2022-11-06,22:00:00,3,3,0,ECO_300019380
642,Herenthoutsesteenweg 2,2022-11-06,23:00:00,4,3,1,ECO_300019380
642,Herenthoutsesteenweg 2,2022-11-07,00:00:00,1,1,0,ECO_300019380
642,Herenthoutsesteenweg 2,2022-11-07,01:00:00,0,0,0,ECO_300019380
642,Herenthoutsesteenweg 2,2022-11-07,02:00:00,0,0,0,ECO_300019380
642,Herenthoutsesteenweg 2,2022-11-07,03:00:00,1,1,0,ECO_300019380
642,Herenthoutsesteenweg 2,2022-11-07,04:00:00,0,0,0,ECO_300019380
642,Herenthoutsesteenweg 2,2022-11-07,05:00:00,1,1,0,ECO_300019380
642,Herenthoutsesteenweg 2,2022-11-07,06:00:00,21,18,3,ECO_300019380
642,Herenthoutsesteenweg 2,2022-11-07,07:00:00,34,34,0,ECO_300019380
642,Herenthoutsesteenweg 2,2022-11-07,08:00:00,149,146,3,ECO_300019380
642,Herenthoutsesteenweg 2,2022-11-07,09:00:00,583,575,8,ECO_300019380
642,Herenthoutsesteenweg 2,2022-11-07,10:00:00,55,51,4,ECO_300019380
642,Herenthoutsesteenweg 2,2022-11-07,11:00:00,47,45,2,ECO_300019380
642,Herenthoutsesteenweg 2,2022-11-07,12:00:00,35,34,1,ECO_300019380
642,Herenthoutsesteenweg 2,2022-11-07,13:00:00,66,64,2,ECO_300019380
642,Herenthoutsesteenweg 2,2022-11-07,14:00:00,65,61,4,ECO_300019380
642,Herenthoutsesteenweg 2,2022-11-07,15:00:00,46,42,4,ECO_300019380
642,Herenthoutsesteenweg 2,2022-11-07,16:00:00,102,89,13,ECO_300019380
642,Herenthoutsesteenweg 2,2022-11-07,17:00:00,124,114,10,ECO_300019380
642,Herenthoutsesteenweg 2,2022-11-07,18:00:00,63,59,4,ECO_300019380
642,Herenthoutsesteenweg 2,2022-11-07,19:00:00,40,35,5,ECO_300019380
642,Herenthoutsesteenweg 2,2022-11-07,20:00:00,27,27,0,ECO_300019380
642,Herenthoutsesteenweg 2,2022-11-07,21:00:00,11,11,0,ECO_300019380
642,Herenthoutsesteenweg 2,2022-11-07,22:00:00,6,5,1,ECO_300019380
642,Herenthoutsesteenweg 2,2022-11-07,23:00:00,18,16,2,ECO_300019380
642,Herenthoutsesteenweg 2,2022-11-08,00:00:00,5,2,3,ECO_300019380
642,Herenthoutsesteenweg 2,2022-11-08,01:00:00,0,0,0,ECO_300019380
642,Herenthoutsesteenweg 2,2022-11-08,02:00:00,0,0,0,ECO_300019380
642,Herenthoutsesteenweg 2,2022-11-08,03:00:00,0,0,0,ECO_300019380
642,Herenthoutsesteenweg 2,2022-11-08,04:00:00,0,0,0,ECO_300019380
642,Herenthoutsesteenweg 2,2022-11-08,05:00:00,1,1,0,ECO_300019380
642,Herenthoutsesteenweg 2,2022-11-08,06:00:00,14,12,2,ECO_300019380
642,Herenthoutsesteenweg 2,2022-11-08,07:00:00,63,53,10,ECO_300019380
642,Herenthoutsesteenweg 2,2022-11-08,08:00:00,182,178,4,ECO_300019380
642,Herenthoutsesteenweg 2,2022-11-08,09:00:00,587,584,3,ECO_300019380
642,Herenthoutsesteenweg 2,2022-11-08,10:00:00,106,102,4,ECO_300019380
642,Herenthoutsesteenweg 2,2022-11-08,11:00:00,77,75,2,ECO_300019380
642,Herenthoutsesteenweg 2,2022-11-08,12:00:00,57,54,3,ECO_300019380
642,Herenthoutsesteenweg 2,2022-11-08,13:00:00,78,73,5,ECO_300019380
642,Herenthoutsesteenweg 2,2022-11-08,14:00:00,86,83,3,ECO_300019380
642,Herenthoutsesteenweg 2,2022-11-08,15:00:00,95,89,6,ECO_300019380
642,Herenthoutsesteenweg 2,2022-11-08,16:00:00,104,93,11,ECO_300019380
642,Herenthoutsesteenweg 2,2022-11-08,17:00:00,148,143,5,ECO_300019380
642,Herenthoutsesteenweg 2,2022-11-08,18:00:00,91,77,14,ECO_300019380
642,Herenthoutsesteenweg 2,2022-11-08,19:00:00,38,34,4,ECO_300019380
642,Herenthoutsesteenweg 2,2022-11-08,20:00:00,26,25,1,ECO_300019380
642,Herenthoutsesteenweg 2,2022-11-08,21:00:00,16,13,3,ECO_300019380
642,Herenthoutsesteenweg 2,2022-11-08,22:00:00,16,16,0,ECO_300019380
642,Herenthoutsesteenweg 2,2022-11-08,23:00:00,20,19,1,ECO_300019380
642,Herenthoutsesteenweg 2,2022-11-09,00:00:00,5,2,3,ECO_300019380
642,Herenthoutsesteenweg 2,2022-11-09,01:00:00,0,0,0,ECO_300019380
642,Herenthoutsesteenweg 2,2022-11-09,02:00:00,1,1,0,ECO_300019380
642,Herenthoutsesteenweg 2,2022-11-09,03:00:00,0,0,0,ECO_300019380
642,Herenthoutsesteenweg 2,2022-11-09,04:00:00,1,1,0,ECO_300019380
642,Herenthoutsesteenweg 2,2022-11-09,05:00:00,2,2,0,ECO_300019380
642,Herenthoutsesteenweg 2,2022-11-09,06:00:00,18,15,3,ECO_300019380
642,Herenthoutsesteenweg 2,2022-11-09,07:00:00,41,35,6,ECO_300019380
642,Herenthoutsesteenweg 2,2022-11-09,08:00:00,150,144,6,ECO_300019380
642,Herenthoutsesteenweg 2,2022-11-09,09:00:00,537,529,8,ECO_300019380
642,Herenthoutsesteenweg 2,2022-11-09,10:00:00,92,90,2,ECO_300019380
642,Herenthoutsesteenweg 2,2022-11-09,11:00:00,92,89,3,ECO_300019380
642,Herenthoutsesteenweg 2,2022-11-09,12:00:00,52,51,1,ECO_300019380
642,Herenthoutsesteenweg 2,2022-11-09,13:00:00,119,110,9,ECO_300019380
642,Herenthoutsesteenweg 2,2022-11-09,14:00:00,89,78,11,ECO_300019380
642,Herenthoutsesteenweg 2,2022-11-09,15:00:00,93,83,10,ECO_300019380
642,Herenthoutsesteenweg 2,2022-11-09,16:00:00,89,80,9,ECO_300019380
642,Herenthoutsesteenweg 2,2022-11-09,17:00:00,136,127,9,ECO_300019380
642,Herenthoutsesteenweg 2,2022-11-09,18:00:00,98,86,12,ECO_300019380
642,Herenthoutsesteenweg 2,2022-11-09,19:00:00,49,45,4,ECO_300019380
642,Herenthoutsesteenweg 2,2022-11-09,20:00:00,40,38,2,ECO_300019380
642,Herenthoutsesteenweg 2,2022-11-09,21:00:00,13,12,1,ECO_300019380
642,Herenthoutsesteenweg 2,2022-11-09,22:00:00,21,19,2,ECO_300019380
642,Herenthoutsesteenweg 2,2022-11-09,23:00:00,14,13,1,ECO_300019380
642,Herenthoutsesteenweg 2,2022-11-10,00:00:00,6,4,2,ECO_300019380
642,Herenthoutsesteenweg 2,2022-11-10,01:00:00,1,1,0,ECO_300019380
642,Herenthoutsesteenweg 2,2022-11-10,02:00:00,1,1,0,ECO_300019380
642,Herenthoutsesteenweg 2,2022-11-10,03:00:00,1,1,0,ECO_300019380
642,Herenthoutsesteenweg 2,2022-11-10,04:00:00,0,0,0,ECO_300019380
642,Herenthoutsesteenweg 2,2022-11-10,05:00:00,2,2,0,ECO_300019380
642,Herenthoutsesteenweg 2,2022-11-10,06:00:00,24,18,6,ECO_300019380
642,Herenthoutsesteenweg 2,2022-11-10,07:00:00,52,47,5,ECO_300019380
642,Herenthoutsesteenweg 2,2022-11-10,08:00:00,143,139,4,ECO_300019380
642,Herenthoutsesteenweg 2,2022-11-10,09:00:00,587,580,7,ECO_300019380
642,Herenthoutsesteenweg 2,2022-11-10,10:00:00,113,107,6,ECO_300019380
642,Herenthoutsesteenweg 2,2022-11-10,11:00:00,77,74,3,ECO_300019380
642,Herenthoutsesteenweg 2,2022-11-10,12:00:00,67,65,2,ECO_300019380
642,Herenthoutsesteenweg 2,2022-11-10,13:00:00,86,81,5,ECO_300019380
642,Herenthoutsesteenweg 2,2022-11-10,14:00:00,146,137,9,ECO_300019380
642,Herenthoutsesteenweg 2,2022-11-10,15:00:00,107,97,10,ECO_300019380
642,Herenthoutsesteenweg 2,2022-11-10,16:00:00,174,155,19,ECO_300019380
642,Herenthoutsesteenweg 2,2022-11-10,17:00:00,147,139,8,ECO_300019380
642,Herenthoutsesteenweg 2,2022-11-10,18:00:00,96,84,12,ECO_300019380
642,Herenthoutsesteenweg 2,2022-11-10,19:00:00,46,41,5,ECO_300019380
642,Herenthoutsesteenweg 2,2022-11-10,20:00:00,42,38,4,ECO_300019380
642,Herenthoutsesteenweg 2,2022-11-10,21:00:00,27,23,4,ECO_300019380
642,Herenthoutsesteenweg 2,2022-11-10,22:00:00,18,18,0,ECO_300019380
642,Herenthoutsesteenweg 2,2022-11-10,23:00:00,21,18,3,ECO_300019380
642,Herenthoutsesteenweg 2,2022-11-11,00:00:00,11,7,4,ECO_300019380
642,Herenthoutsesteenweg 2,2022-11-11,01:00:00,7,5,2,ECO_300019380
642,Herenthoutsesteenweg 2,2022-11-11,02:00:00,4,3,1,ECO_300019380
642,Herenthoutsesteenweg 2,2022-11-11,03:00:00,5,3,2,ECO_300019380
642,Herenthoutsesteenweg 2,2022-11-11,04:00:00,0,0,0,ECO_300019380
642,Herenthoutsesteenweg 2,2022-11-11,05:00:00,0,0,0,ECO_300019380
642,Herenthoutsesteenweg 2,2022-11-11,06:00:00,3,3,0,ECO_300019380
642,Herenthoutsesteenweg 2,2022-11-11,07:00:00,8,8,0,ECO_300019380
642,Herenthoutsesteenweg 2,2022-11-11,08:00:00,18,17,1,ECO_300019380
642,Herenthoutsesteenweg 2,2022-11-11,09:00:00,48,47,1,ECO_300019380
642,Herenthoutsesteenweg 2,2022-11-11,10:00:00,57,54,3,ECO_300019380
642,Herenthoutsesteenweg 2,2022-11-11,11:00:00,115,109,6,ECO_300019380
642,Herenthoutsesteenweg 2,2022-11-11,12:00:00,107,93,14,ECO_300019380
642,Herenthoutsesteenweg 2,2022-11-11,13:00:00,71,63,8,ECO_300019380
642,Herenthoutsesteenweg 2,2022-11-11,14:00:00,131,118,13,ECO_300019380
642,Herenthoutsesteenweg 2,2022-11-11,15:00:00,114,107,7,ECO_300019380
642,Herenthoutsesteenweg 2,2022-11-11,16:00:00,63,55,8,ECO_300019380
642,Herenthoutsesteenweg 2,2022-11-11,17:00:00,74,63,11,ECO_300019380
642,Herenthoutsesteenweg 2,2022-11-11,18:00:00,41,38,3,ECO_300019380
642,Herenthoutsesteenweg 2,2022-11-11,19:00:00,43,35,8,ECO_300019380
642,Herenthoutsesteenweg 2,2022-11-11,20:00:00,27,26,1,ECO_300019380
642,Herenthoutsesteenweg 2,2022-11-11,21:00:00,16,15,1,ECO_300019380
642,Herenthoutsesteenweg 2,2022-11-11,22:00:00,20,19,1,ECO_300019380
642,Herenthoutsesteenweg 2,2022-11-11,23:00:00,12,10,2,ECO_300019380
642,Herenthoutsesteenweg 2,2022-11-12,00:00:00,10,9,1,ECO_300019380
642,Herenthoutsesteenweg 2,2022-11-12,01:00:00,17,16,1,ECO_300019380
642,Herenthoutsesteenweg 2,2022-11-12,02:00:00,3,3,0,ECO_300019380
642,Herenthoutsesteenweg 2,2022-11-12,03:00:00,0,0,0,ECO_300019380
642,Herenthoutsesteenweg 2,2022-11-12,04:00:00,2,2,0,ECO_300019380
642,Herenthoutsesteenweg 2,2022-11-12,05:00:00,1,1,0,ECO_300019380
642,Herenthoutsesteenweg 2,2022-11-12,06:00:00,3,2,1,ECO_300019380
642,Herenthoutsesteenweg 2,2022-11-12,07:00:00,11,11,0,ECO_300019380
642,Herenthoutsesteenweg 2,2022-11-12,08:00:00,14,12,2,ECO_300019380
642,Herenthoutsesteenweg 2,2022-11-12,09:00:00,56,55,1,ECO_300019380
642,Herenthoutsesteenweg 2,2022-11-12,10:00:00,70,66,4,ECO_300019380
642,Herenthoutsesteenweg 2,2022-11-12,11:00:00,90,86,4,ECO_300019380
642,Herenthoutsesteenweg 2,2022-11-12,12:00:00,85,73,12,ECO_300019380
642,Herenthoutsesteenweg 2,2022-11-12,13:00:00,157,143,14,ECO_300019380
642,Herenthoutsesteenweg 2,2022-11-12,14:00:00,204,197,7,ECO_300019380
642,Herenthoutsesteenweg 2,2022-11-12,15:00:00,150,134,16,ECO_300019380
642,Herenthoutsesteenweg 2,2022-11-12,16:00:00,108,86,22,ECO_300019380
642,Herenthoutsesteenweg 2,2022-11-12,17:00:00,74,67,7,ECO_300019380
642,Herenthoutsesteenweg 2,2022-11-12,18:00:00,54,42,12,ECO_300019380
642,Herenthoutsesteenweg 2,2022-11-12,19:00:00,53,51,2,ECO_300019380
642,Herenthoutsesteenweg 2,2022-11-12,20:00:00,31,30,1,ECO_300019380
642,Herenthoutsesteenweg 2,2022-11-12,21:00:00,23,22,1,ECO_300019380
642,Herenthoutsesteenweg 2,2022-11-12,22:00:00,20,19,1,ECO_300019380
642,Herenthoutsesteenweg 2,2022-11-12,23:00:00,10,10,0,ECO_300019380
642,Herenthoutsesteenweg 2,2022-11-13,00:00:00,6,5,1,ECO_300019380
642,Herenthoutsesteenweg 2,2022-11-13,01:00:00,10,10,0,ECO_300019380
642,Herenthoutsesteenweg 2,2022-11-13,02:00:00,4,3,1,ECO_300019380
642,Herenthoutsesteenweg 2,2022-11-13,03:00:00,1,0,1,ECO_300019380
642,Herenthoutsesteenweg 2,2022-11-13,04:00:00,1,1,0,ECO_300019380
642,Herenthoutsesteenweg 2,2022-11-13,05:00:00,1,1,0,ECO_300019380
642,Herenthoutsesteenweg 2,2022-11-13,06:00:00,2,0,2,ECO_300019380
642,Herenthoutsesteenweg 2,2022-11-13,07:00:00,17,16,1,ECO_300019380
642,Herenthoutsesteenweg 2,2022-11-13,08:00:00,16,14,2,ECO_300019380
642,Herenthoutsesteenweg 2,2022-11-13,09:00:00,56,54,2,ECO_300019380
642,Herenthoutsesteenweg 2,2022-11-13,10:00:00,95,90,5,ECO_300019380
642,Herenthoutsesteenweg 2,2022-11-13,11:00:00,81,78,3,ECO_300019380
642,Herenthoutsesteenweg 2,2022-11-13,12:00:00,72,58,14,ECO_300019380
642,Herenthoutsesteenweg 2,2022-11-13,13:00:00,69,68,1,ECO_300019380
642,Herenthoutsesteenweg 2,2022-11-13,14:00:00,119,110,9,ECO_300019380
642,Herenthoutsesteenweg 2,2022-11-13,15:00:00,148,131,17,ECO_300019380
642,Herenthoutsesteenweg 2,2022-11-13,16:00:00,72,69,3,ECO_300019380
642,Herenthoutsesteenweg 2,2022-11-13,17:00:00,84,75,9,ECO_300019380
642,Herenthoutsesteenweg 2,2022-11-13,18:00:00,45,41,4,ECO_300019380
642,Herenthoutsesteenweg 2,2022-11-13,19:00:00,23,20,3,ECO_300019380
642,Herenthoutsesteenweg 2,2022-11-13,20:00:00,14,13,1,ECO_300019380
642,Herenthoutsesteenweg 2,2022-11-13,21:00:00,12,12,0,ECO_300019380
642,Herenthoutsesteenweg 2,2022-11-13,22:00:00,12,11,1,ECO_300019380
642,Herenthoutsesteenweg 2,2022-11-13,23:00:00,4,4,0,ECO_300019380
642,Herenthoutsesteenweg 2,2022-11-14,00:00:00,2,1,1,ECO_300019380
642,Herenthoutsesteenweg 2,2022-11-14,01:00:00,1,1,0,ECO_300019380
642,Herenthoutsesteenweg 2,2022-11-14,02:00:00,0,0,0,ECO_300019380
642,Herenthoutsesteenweg 2,2022-11-14,03:00:00,0,0,0,ECO_300019380
642,Herenthoutsesteenweg 2,2022-11-14,04:00:00,0,0,0,ECO_300019380
642,Herenthoutsesteenweg 2,2022-11-14,05:00:00,3,1,2,ECO_300019380
642,Herenthoutsesteenweg 2,2022-11-14,06:00:00,17,17,0,ECO_300019380
642,Herenthoutsesteenweg 2,2022-11-14,07:00:00,42,38,4,ECO_300019380
642,Herenthoutsesteenweg 2,2022-11-14,08:00:00,158,149,9,ECO_300019380
642,Herenthoutsesteenweg 2,2022-11-14,09:00:00,584,577,7,ECO_300019380
642,Herenthoutsesteenweg 2,2022-11-14,10:00:00,63,62,1,ECO_300019380
642,Herenthoutsesteenweg 2,2022-11-14,11:00:00,70,64,6,ECO_300019380
642,Herenthoutsesteenweg 2,2022-11-14,12:00:00,51,46,5,ECO_300019380
642,Herenthoutsesteenweg 2,2022-11-14,13:00:00,72,68,4,ECO_300019380
642,Herenthoutsesteenweg 2,2022-11-14,14:00:00,107,98,9,ECO_300019380
642,Herenthoutsesteenweg 2,2022-11-14,15:00:00,93,85,8,ECO_300019380
642,Herenthoutsesteenweg 2,2022-11-14,16:00:00,93,86,7,ECO_300019380
642,Herenthoutsesteenweg 2,2022-11-14,17:00:00,120,110,10,ECO_300019380
642,Herenthoutsesteenweg 2,2022-11-14,18:00:00,69,61,8,ECO_300019380
642,Herenthoutsesteenweg 2,2022-11-14,19:00:00,41,37,4,ECO_300019380
642,Herenthoutsesteenweg 2,2022-11-14,20:00:00,27,26,1,ECO_300019380
642,Herenthoutsesteenweg 2,2022-11-14,21:00:00,12,12,0,ECO_300019380
642,Herenthoutsesteenweg 2,2022-11-14,22:00:00,12,11,1,ECO_300019380
642,Herenthoutsesteenweg 2,2022-11-14,23:00:00,14,14,0,ECO_300019380
642,Herenthoutsesteenweg 2,2022-11-15,00:00:00,2,2,0,ECO_300019380
642,Herenthoutsesteenweg 2,2022-11-15,01:00:00,2,2,0,ECO_300019380
642,Herenthoutsesteenweg 2,2022-11-15,02:00:00,0,0,0,ECO_300019380
642,Herenthoutsesteenweg 2,2022-11-15,03:00:00,0,0,0,ECO_300019380
642,Herenthoutsesteenweg 2,2022-11-15,04:00:00,1,1,0,ECO_300019380
642,Herenthoutsesteenweg 2,2022-11-15,05:00:00,1,1,0,ECO_300019380
642,Herenthoutsesteenweg 2,2022-11-15,06:00:00,18,18,0,ECO_300019380
642,Herenthoutsesteenweg 2,2022-11-15,07:00:00,39,38,1,ECO_300019380
642,Herenthoutsesteenweg 2,2022-11-15,08:00:00,137,133,4,ECO_300019380
642,Herenthoutsesteenweg 2,2022-11-15,09:00:00,513,505,8,ECO_300019380
642,Herenthoutsesteenweg 2,2022-11-15,10:00:00,85,81,4,ECO_300019380
642,Herenthoutsesteenweg 2,2022-11-15,11:00:00,62,57,5,ECO_300019380
642,Herenthoutsesteenweg 2,2022-11-15,12:00:00,39,36,3,ECO_300019380
642,Herenthoutsesteenweg 2,2022-11-15,13:00:00,63,58,5,ECO_300019380
642,Herenthoutsesteenweg 2,2022-11-15,14:00:00,74,71,3,ECO_300019380
642,Herenthoutsesteenweg 2,2022-11-15,15:00:00,72,66,6,ECO_300019380
642,Herenthoutsesteenweg 2,2022-11-15,16:00:00,88,76,12,ECO_300019380
642,Herenthoutsesteenweg 2,2022-11-15,17:00:00,97,90,7,ECO_300019380
642,Herenthoutsesteenweg 2,2022-11-15,18:00:00,43,37,6,ECO_300019380
642,Herenthoutsesteenweg 2,2022-11-15,19:00:00,24,23,1,ECO_300019380
642,Herenthoutsesteenweg 2,2022-11-15,20:00:00,11,11,0,ECO_300019380
642,Herenthoutsesteenweg 2,2022-11-15,21:00:00,14,13,1,ECO_300019380
642,Herenthoutsesteenweg 2,2022-11-15,22:00:00,8,7,1,ECO_300019380
642,Herenthoutsesteenweg 2,2022-11-15,23:00:00,13,11,2,ECO_300019380
642,Herenthoutsesteenweg 2,2022-11-16,00:00:00,1,1,0,ECO_300019380
642,Herenthoutsesteenweg 2,2022-11-16,01:00:00,1,1,0,ECO_300019380
642,Herenthoutsesteenweg 2,2022-11-16,02:00:00,1,1,0,ECO_300019380
642,Herenthoutsesteenweg 2,2022-11-16,03:00:00,0,0,0,ECO_300019380
642,Herenthoutsesteenweg 2,2022-11-16,04:00:00,0,0,0,ECO_300019380
642,Herenthoutsesteenweg 2,2022-11-16,05:00:00,1,1,0,ECO_300019380
642,Herenthoutsesteenweg 2,2022-11-16,06:00:00,19,18,1,ECO_300019380
642,Herenthoutsesteenweg 2,2022-11-16,07:00:00,45,43,2,ECO_300019380
642,Herenthoutsesteenweg 2,2022-11-16,08:00:00,159,156,3,ECO_300019380
642,Herenthoutsesteenweg 2,2022-11-16,09:00:00,529,524,5,ECO_300019380
642,Herenthoutsesteenweg 2,2022-11-16,10:00:00,81,78,3,ECO_300019380
642,Herenthoutsesteenweg 2,2022-11-16,11:00:00,72,72,0,ECO_300019380
642,Herenthoutsesteenweg 2,2022-11-16,12:00:00,66,59,7,ECO_300019380
642,Herenthoutsesteenweg 2,2022-11-16,13:00:00,121,108,13,ECO_300019380
642,Herenthoutsesteenweg 2,2022-11-16,14:00:00,98,92,6,ECO_300019380
642,Herenthoutsesteenweg 2,2022-11-16,15:00:00,103,98,5,ECO_300019380
642,Herenthoutsesteenweg 2,2022-11-16,16:00:00,72,62,10,ECO_300019380
642,Herenthoutsesteenweg 2,2022-11-16,17:00:00,97,91,6,ECO_300019380
642,Herenthoutsesteenweg 2,2022-11-16,18:00:00,60,56,4,ECO_300019380
642,Herenthoutsesteenweg 2,2022-11-16,19:00:00,42,35,7,ECO_300019380
642,Herenthoutsesteenweg 2,2022-11-16,20:00:00,28,26,2,ECO_300019380
642,Herenthoutsesteenweg 2,2022-11-16,21:00:00,15,13,2,ECO_300019380
642,Herenthoutsesteenweg 2,2022-11-16,22:00:00,7,7,0,ECO_300019380
642,Herenthoutsesteenweg 2,2022-11-16,23:00:00,12,11,1,ECO_300019380
642,Herenthoutsesteenweg 2,2022-11-17,00:00:00,5,5,0,ECO_300019380
642,Herenthoutsesteenweg 2,2022-11-17,01:00:00,2,1,1,ECO_300019380
642,Herenthoutsesteenweg 2,2022-11-17,02:00:00,1,0,1,ECO_300019380
642,Herenthoutsesteenweg 2,2022-11-17,03:00:00,0,0,0,ECO_300019380
642,Herenthoutsesteenweg 2,2022-11-17,04:00:00,0,0,0,ECO_300019380
642,Herenthoutsesteenweg 2,2022-11-17,05:00:00,3,1,2,ECO_300019380
642,Herenthoutsesteenweg 2,2022-11-17,06:00:00,13,12,1,ECO_300019380
642,Herenthoutsesteenweg 2,2022-11-17,07:00:00,40,38,2,ECO_300019380
642,Herenthoutsesteenweg 2,2022-11-17,08:00:00,82,79,3,ECO_300019380
642,Herenthoutsesteenweg 2,2022-11-17,09:00:00,363,353,10,ECO_300019380
642,Herenthoutsesteenweg 2,2022-11-17,10:00:00,34,34,0,ECO_300019380
642,Herenthoutsesteenweg 2,2022-11-17,11:00:00,18,18,0,ECO_300019380
642,Herenthoutsesteenweg 2,2022-11-17,12:00:00,25,24,1,ECO_300019380
642,Herenthoutsesteenweg 2,2022-11-17,13:00:00,39,37,2,ECO_300019380
642,Herenthoutsesteenweg 2,2022-11-17,14:00:00,51,46,5,ECO_300019380
642,Herenthoutsesteenweg 2,2022-11-17,15:00:00,36,30,6,ECO_300019380
642,Herenthoutsesteenweg 2,2022-11-17,16:00:00,75,68,7,ECO_300019380
642,Herenthoutsesteenweg 2,2022-11-17,17:00:00,97,81,16,ECO_300019380
642,Herenthoutsesteenweg 2,2022-11-17,18:00:00,59,52,7,ECO_300019380
642,Herenthoutsesteenweg 2,2022-11-17,19:00:00,32,29,3,ECO_300019380
642,Herenthoutsesteenweg 2,2022-11-17,20:00:00,25,25,0,ECO_300019380
642,Herenthoutsesteenweg 2,2022-11-17,21:00:00,13,12,1,ECO_300019380
642,Herenthoutsesteenweg 2,2022-11-17,22:00:00,3,2,1,ECO_300019380
642,Herenthoutsesteenweg 2,2022-11-17,23:00:00,15,14,1,ECO_300019380
642,Herenthoutsesteenweg 2,2022-11-18,00:00:00,3,3,0,ECO_300019380
642,Herenthoutsesteenweg 2,2022-11-18,01:00:00,2,2,0,ECO_300019380
642,Herenthoutsesteenweg 2,2022-11-18,02:00:00,0,0,0,ECO_300019380
642,Herenthoutsesteenweg 2,2022-11-18,03:00:00,0,0,0,ECO_300019380
642,Herenthoutsesteenweg 2,2022-11-18,04:00:00,1,1,0,ECO_300019380
642,Herenthoutsesteenweg 2,2022-11-18,05:00:00,2,2,0,ECO_300019380
642,Herenthoutsesteenweg 2,2022-11-18,06:00:00,15,15,0,ECO_300019380
642,Herenthoutsesteenweg 2,2022-11-18,07:00:00,42,40,2,ECO_300019380
642,Herenthoutsesteenweg 2,2022-11-18,08:00:00,120,118,2,ECO_300019380
642,Herenthoutsesteenweg 2,2022-11-18,09:00:00,563,559,4,ECO_300019380
642,Herenthoutsesteenweg 2,2022-11-18,10:00:00,107,100,7,ECO_300019380
642,Herenthoutsesteenweg 2,2022-11-18,11:00:00,76,75,1,ECO_300019380
642,Herenthoutsesteenweg 2,2022-11-18,12:00:00,53,52,1,ECO_300019380
642,Herenthoutsesteenweg 2,2022-11-18,13:00:00,57,54,3,ECO_300019380
642,Herenthoutsesteenweg 2,2022-11-18,14:00:00,46,44,2,ECO_300019380
642,Herenthoutsesteenweg 2,2022-11-18,15:00:00,38,33,5,ECO_300019380
642,Herenthoutsesteenweg 2,2022-11-18,16:00:00,67,63,4,ECO_300019380
642,Herenthoutsesteenweg 2,2022-11-18,17:00:00,86,83,3,ECO_300019380
642,Herenthoutsesteenweg 2,2022-11-18,18:00:00,43,35,8,ECO_300019380
642,Herenthoutsesteenweg 2,2022-11-18,19:00:00,27,25,2,ECO_300019380
642,Herenthoutsesteenweg 2,2022-11-18,20:00:00,24,21,3,ECO_300019380
642,Herenthoutsesteenweg 2,2022-11-18,21:00:00,7,4,3,ECO_300019380
642,Herenthoutsesteenweg 2,2022-11-18,22:00:00,20,19,1,ECO_300019380
642,Herenthoutsesteenweg 2,2022-11-18,23:00:00,17,14,3,ECO_300019380
642,Herenthoutsesteenweg 2,2022-11-19,00:00:00,2,2,0,ECO_300019380
642,Herenthoutsesteenweg 2,2022-11-19,01:00:00,29,29,0,ECO_300019380
642,Herenthoutsesteenweg 2,2022-11-19,02:00:00,6,5,1,ECO_300019380
642,Herenthoutsesteenweg 2,2022-11-19,03:00:00,2,1,1,ECO_300019380
642,Herenthoutsesteenweg 2,2022-11-19,04:00:00,2,2,0,ECO_300019380
642,Herenthoutsesteenweg 2,2022-11-19,05:00:00,1,0,1,ECO_300019380
642,Herenthoutsesteenweg 2,2022-11-19,06:00:00,1,1,0,ECO_300019380
642,Herenthoutsesteenweg 2,2022-11-19,07:00:00,10,10,0,ECO_300019380
642,Herenthoutsesteenweg 2,2022-11-19,08:00:00,2,2,0,ECO_300019380
642,Herenthoutsesteenweg 2,2022-11-19,09:00:00,25,25,0,ECO_300019380
642,Herenthoutsesteenweg 2,2022-11-19,10:00:00,24,24,0,ECO_300019380
642,Herenthoutsesteenweg 2,2022-11-19,11:00:00,39,36,3,ECO_300019380
642,Herenthoutsesteenweg 2,2022-11-19,12:00:00,37,37,0,ECO_300019380
642,Herenthoutsesteenweg 2,2022-11-19,13:00:00,61,53,8,ECO_300019380
642,Herenthoutsesteenweg 2,2022-11-19,14:00:00,83,77,6,ECO_300019380
642,Herenthoutsesteenweg 2,2022-11-19,15:00:00,47,43,4,ECO_300019380
642,Herenthoutsesteenweg 2,2022-11-19,16:00:00,69,62,7,ECO_300019380
642,Herenthoutsesteenweg 2,2022-11-19,17:00:00,38,35,3,ECO_300019380
642,Herenthoutsesteenweg 2,2022-11-19,18:00:00,37,36,1,ECO_300019380
642,Herenthoutsesteenweg 2,2022-11-19,19:00:00,22,21,1,ECO_300019380
642,Herenthoutsesteenweg 2,2022-11-19,20:00:00,26,25,1,ECO_300019380
642,Herenthoutsesteenweg 2,2022-11-19,21:00:00,32,31,1,ECO_300019380
642,Herenthoutsesteenweg 2,2022-11-19,22:00:00,25,23,2,ECO_300019380
642,Herenthoutsesteenweg 2,2022-11-19,23:00:00,21,21,0,ECO_300019380
642,Herenthoutsesteenweg 2,2022-11-20,00:00:00,19,18,1,ECO_300019380
642,Herenthoutsesteenweg 2,2022-11-20,01:00:00,5,4,1,ECO_300019380
642,Herenthoutsesteenweg 2,2022-11-20,02:00:00,3,2,1,ECO_300019380
642,Herenthoutsesteenweg 2,2022-11-20,03:00:00,4,1,3,ECO_300019380
642,Herenthoutsesteenweg 2,2022-11-20,04:00:00,6,5,1,ECO_300019380
642,Herenthoutsesteenweg 2,2022-11-20,05:00:00,0,0,0,ECO_300019380
642,Herenthoutsesteenweg 2,2022-11-20,06:00:00,1,1,0,ECO_300019380
642,Herenthoutsesteenweg 2,2022-11-20,07:00:00,4,4,0,ECO_300019380
642,Herenthoutsesteenweg 2,2022-11-20,08:00:00,12,9,3,ECO_300019380
642,Herenthoutsesteenweg 2,2022-11-20,09:00:00,30,29,1,ECO_300019380
642,Herenthoutsesteenweg 2,2022-11-20,10:00:00,60,56,4,ECO_300019380
642,Herenthoutsesteenweg 2,2022-11-20,11:00:00,41,37,4,ECO_300019380
642,Herenthoutsesteenweg 2,2022-11-20,12:00:00,45,40,5,ECO_300019380
642,Herenthoutsesteenweg 2,2022-11-20,13:00:00,17,13,4,ECO_300019380
642,Herenthoutsesteenweg 2,2022-11-20,14:00:00,40,37,3,ECO_300019380
642,Herenthoutsesteenweg 2,2022-11-20,15:00:00,10,9,1,ECO_300019380
642,Herenthoutsesteenweg 2,2022-11-20,16:00:00,9,9,0,ECO_300019380
642,Herenthoutsesteenweg 2,2022-11-20,17:00:00,17,13,4,ECO_300019380
642,Herenthoutsesteenweg 2,2022-11-20,18:00:00,12,12,0,ECO_300019380
642,Herenthoutsesteenweg 2,2022-11-20,19:00:00,12,10,2,ECO_300019380
642,Herenthoutsesteenweg 2,2022-11-20,20:00:00,10,10,0,ECO_300019380
642,Herenthoutsesteenweg 2,2022-11-20,21:00:00,7,6,1,ECO_300019380
642,Herenthoutsesteenweg 2,2022-11-20,22:00:00,2,2,0,ECO_300019380
642,Herenthoutsesteenweg 2,2022-11-20,23:00:00,3,3,0,ECO_300019380
642,Herenthoutsesteenweg 2,2022-11-21,00:00:00,2,2,0,ECO_300019380
642,Herenthoutsesteenweg 2,2022-11-21,01:00:00,0,0,0,ECO_300019380
642,Herenthoutsesteenweg 2,2022-11-21,02:00:00,3,3,0,ECO_300019380
642,Herenthoutsesteenweg 2,2022-11-21,03:00:00,0,0,0,ECO_300019380
642,Herenthoutsesteenweg 2,2022-11-21,04:00:00,0,0,0,ECO_300019380
642,Herenthoutsesteenweg 2,2022-11-21,05:00:00,2,2,0,ECO_300019380
642,Herenthoutsesteenweg 2,2022-11-21,06:00:00,16,15,1,ECO_300019380
642,Herenthoutsesteenweg 2,2022-11-21,07:00:00,37,36,1,ECO_300019380
642,Herenthoutsesteenweg 2,2022-11-21,08:00:00,135,131,4,ECO_300019380
642,Herenthoutsesteenweg 2,2022-11-21,09:00:00,569,568,1,ECO_300019380
642,Herenthoutsesteenweg 2,2022-11-21,10:00:00,75,74,1,ECO_300019380
642,Herenthoutsesteenweg 2,2022-11-21,11:00:00,69,67,2,ECO_300019380
642,Herenthoutsesteenweg 2,2022-11-21,12:00:00,47,43,4,ECO_300019380
642,Herenthoutsesteenweg 2,2022-11-21,13:00:00,56,50,6,ECO_300019380
642,Herenthoutsesteenweg 2,2022-11-21,14:00:00,59,55,4,ECO_300019380
642,Herenthoutsesteenweg 2,2022-11-21,15:00:00,74,71,3,ECO_300019380
642,Herenthoutsesteenweg 2,2022-11-21,16:00:00,82,77,5,ECO_300019380
642,Herenthoutsesteenweg 2,2022-11-21,17:00:00,107,94,13,ECO_300019380
642,Herenthoutsesteenweg 2,2022-11-21,18:00:00,54,51,3,ECO_300019380
642,Herenthoutsesteenweg 2,2022-11-21,19:00:00,20,19,1,ECO_300019380
642,Herenthoutsesteenweg 2,2022-11-21,20:00:00,13,12,1,ECO_300019380
642,Herenthoutsesteenweg 2,2022-11-21,21:00:00,5,5,0,ECO_300019380
642,Herenthoutsesteenweg 2,2022-11-21,22:00:00,14,14,0,ECO_300019380
642,Herenthoutsesteenweg 2,2022-11-21,23:00:00,16,15,1,ECO_300019380
642,Herenthoutsesteenweg 2,2022-11-22,00:00:00,8,2,6,ECO_300019380
642,Herenthoutsesteenweg 2,2022-11-22,01:00:00,0,0,0,ECO_300019380
642,Herenthoutsesteenweg 2,2022-11-22,02:00:00,0,0,0,ECO_300019380
642,Herenthoutsesteenweg 2,2022-11-22,03:00:00,1,1,0,ECO_300019380
642,Herenthoutsesteenweg 2,2022-11-22,04:00:00,0,0,0,ECO_300019380
642,Herenthoutsesteenweg 2,2022-11-22,05:00:00,1,1,0,ECO_300019380
642,Herenthoutsesteenweg 2,2022-11-22,06:00:00,16,15,1,ECO_300019380
642,Herenthoutsesteenweg 2,2022-11-22,07:00:00,53,47,6,ECO_300019380
642,Herenthoutsesteenweg 2,2022-11-22,08:00:00,126,123,3,ECO_300019380
642,Herenthoutsesteenweg 2,2022-11-22,09:00:00,542,534,8,ECO_300019380
642,Herenthoutsesteenweg 2,2022-11-22,10:00:00,79,78,1,ECO_300019380
642,Herenthoutsesteenweg 2,2022-11-22,11:00:00,56,56,0,ECO_300019380
642,Herenthoutsesteenweg 2,2022-11-22,12:00:00,31,27,4,ECO_300019380
642,Herenthoutsesteenweg 2,2022-11-22,13:00:00,57,57,0,ECO_300019380
642,Herenthoutsesteenweg 2,2022-11-22,14:00:00,73,70,3,ECO_300019380
642,Herenthoutsesteenweg 2,2022-11-22,15:00:00,55,51,4,ECO_300019380
642,Herenthoutsesteenweg 2,2022-11-22,16:00:00,72,68,4,ECO_300019380
642,Herenthoutsesteenweg 2,2022-11-22,17:00:00,95,88,7,ECO_300019380
642,Herenthoutsesteenweg 2,2022-11-22,18:00:00,58,55,3,ECO_300019380
642,Herenthoutsesteenweg 2,2022-11-22,19:00:00,35,33,2,ECO_300019380
642,Herenthoutsesteenweg 2,2022-11-22,20:00:00,26,25,1,ECO_300019380
642,Herenthoutsesteenweg 2,2022-11-22,21:00:00,11,10,1,ECO_300019380
642,Herenthoutsesteenweg 2,2022-11-22,22:00:00,9,6,3,ECO_300019380
642,Herenthoutsesteenweg 2,2022-11-22,23:00:00,12,10,2,ECO_300019380
642,Herenthoutsesteenweg 2,2022-11-23,00:00:00,5,3,2,ECO_300019380
642,Herenthoutsesteenweg 2,2022-11-23,01:00:00,5,5,0,ECO_300019380
642,Herenthoutsesteenweg 2,2022-11-23,02:00:00,0,0,0,ECO_300019380
642,Herenthoutsesteenweg 2,2022-11-23,03:00:00,0,0,0,ECO_300019380
642,Herenthoutsesteenweg 2,2022-11-23,04:00:00,1,1,0,ECO_300019380
642,Herenthoutsesteenweg 2,2022-11-23,05:00:00,5,4,1,ECO_300019380
642,Herenthoutsesteenweg 2,2022-11-23,06:00:00,19,18,1,ECO_300019380
642,Herenthoutsesteenweg 2,2022-11-23,07:00:00,39,36,3,ECO_300019380
642,Herenthoutsesteenweg 2,2022-11-23,08:00:00,140,134,6,ECO_300019380
642,Herenthoutsesteenweg 2,2022-11-23,09:00:00,515,510,5,ECO_300019380
642,Herenthoutsesteenweg 2,2022-11-23,10:00:00,82,78,4,ECO_300019380
642,Herenthoutsesteenweg 2,2022-11-23,11:00:00,56,52,4,ECO_300019380
642,Herenthoutsesteenweg 2,2022-11-23,12:00:00,40,38,2,ECO_300019380
642,Herenthoutsesteenweg 2,2022-11-23,13:00:00,108,98,10,ECO_300019380
642,Herenthoutsesteenweg 2,2022-11-23,14:00:00,82,76,6,ECO_300019380
642,Herenthoutsesteenweg 2,2022-11-23,15:00:00,48,43,5,ECO_300019380
642,Herenthoutsesteenweg 2,2022-11-23,16:00:00,36,30,6,ECO_300019380
642,Herenthoutsesteenweg 2,2022-11-23,17:00:00,87,79,8,ECO_300019380
642,Herenthoutsesteenweg 2,2022-11-23,18:00:00,55,49,6,ECO_300019380
642,Herenthoutsesteenweg 2,2022-11-23,19:00:00,32,30,2,ECO_300019380
642,Herenthoutsesteenweg 2,2022-11-23,20:00:00,50,47,3,ECO_300019380
642,Herenthoutsesteenweg 2,2022-11-23,21:00:00,13,11,2,ECO_300019380
642,Herenthoutsesteenweg 2,2022-11-23,22:00:00,9,6,3,ECO_300019380
642,Herenthoutsesteenweg 2,2022-11-23,23:00:00,19,15,4,ECO_300019380
642,Herenthoutsesteenweg 2,2022-11-24,00:00:00,1,1,0,ECO_300019380
642,Herenthoutsesteenweg 2,2022-11-24,01:00:00,0,0,0,ECO_300019380
642,Herenthoutsesteenweg 2,2022-11-24,02:00:00,2,1,1,ECO_300019380
642,Herenthoutsesteenweg 2,2022-11-24,03:00:00,3,2,1,ECO_300019380
642,Herenthoutsesteenweg 2,2022-11-24,04:00:00,0,0,0,ECO_300019380
642,Herenthoutsesteenweg 2,2022-11-24,05:00:00,3,2,1,ECO_300019380
642,Herenthoutsesteenweg 2,2022-11-24,06:00:00,14,12,2,ECO_300019380
642,Herenthoutsesteenweg 2,2022-11-24,07:00:00,53,49,4,ECO_300019380
642,Herenthoutsesteenweg 2,2022-11-24,08:00:00,125,119,6,ECO_300019380
642,Herenthoutsesteenweg 2,2022-11-24,09:00:00,559,554,5,ECO_300019380
642,Herenthoutsesteenweg 2,2022-11-24,10:00:00,73,72,1,ECO_300019380
642,Herenthoutsesteenweg 2,2022-11-24,11:00:00,61,56,5,ECO_300019380
642,Herenthoutsesteenweg 2,2022-11-24,12:00:00,60,60,0,ECO_300019380
642,Herenthoutsesteenweg 2,2022-11-24,13:00:00,70,65,5,ECO_300019380
642,Herenthoutsesteenweg 2,2022-11-24,14:00:00,109,105,4,ECO_300019380
642,Herenthoutsesteenweg 2,2022-11-24,15:00:00,104,94,10,ECO_300019380
642,Herenthoutsesteenweg 2,2022-11-24,16:00:00,106,97,9,ECO_300019380
642,Herenthoutsesteenweg 2,2022-11-24,17:00:00,120,112,8,ECO_300019380
642,Herenthoutsesteenweg 2,2022-11-24,18:00:00,58,50,8,ECO_300019380
642,Herenthoutsesteenweg 2,2022-11-24,19:00:00,37,35,2,ECO_300019380
642,Herenthoutsesteenweg 2,2022-11-24,20:00:00,20,19,1,ECO_300019380
642,Herenthoutsesteenweg 2,2022-11-24,21:00:00,17,16,1,ECO_300019380
642,Herenthoutsesteenweg 2,2022-11-24,22:00:00,18,17,1,ECO_300019380
642,Herenthoutsesteenweg 2,2022-11-24,23:00:00,18,17,1,ECO_300019380
642,Herenthoutsesteenweg 2,2022-11-25,00:00:00,2,1,1,ECO_300019380
642,Herenthoutsesteenweg 2,2022-11-25,01:00:00,3,3,0,ECO_300019380
642,Herenthoutsesteenweg 2,2022-11-25,02:00:00,1,1,0,ECO_300019380
642,Herenthoutsesteenweg 2,2022-11-25,03:00:00,1,1,0,ECO_300019380
642,Herenthoutsesteenweg 2,2022-11-25,04:00:00,0,0,0,ECO_300019380
642,Herenthoutsesteenweg 2,2022-11-25,05:00:00,3,3,0,ECO_300019380
642,Herenthoutsesteenweg 2,2022-11-25,06:00:00,16,15,1,ECO_300019380
642,Herenthoutsesteenweg 2,2022-11-25,07:00:00,29,27,2,ECO_300019380
642,Herenthoutsesteenweg 2,2022-11-25,08:00:00,118,115,3,ECO_300019380
642,Herenthoutsesteenweg 2,2022-11-25,09:00:00,523,514,9,ECO_300019380
642,Herenthoutsesteenweg 2,2022-11-25,10:00:00,89,87,2,ECO_300019380
642,Herenthoutsesteenweg 2,2022-11-25,11:00:00,99,98,1,ECO_300019380
642,Herenthoutsesteenweg 2,2022-11-25,12:00:00,75,74,1,ECO_300019380
642,Herenthoutsesteenweg 2,2022-11-25,13:00:00,65,58,7,ECO_300019380
642,Herenthoutsesteenweg 2,2022-11-25,14:00:00,75,69,6,ECO_300019380
642,Herenthoutsesteenweg 2,2022-11-25,15:00:00,106,92,14,ECO_300019380
642,Herenthoutsesteenweg 2,2022-11-25,16:00:00,121,114,7,ECO_300019380
642,Herenthoutsesteenweg 2,2022-11-25,17:00:00,116,108,8,ECO_300019380
642,Herenthoutsesteenweg 2,2022-11-25,18:00:00,66,57,9,ECO_300019380
642,Herenthoutsesteenweg 2,2022-11-25,19:00:00,46,43,3,ECO_300019380
642,Herenthoutsesteenweg 2,2022-11-25,20:00:00,32,29,3,ECO_300019380
642,Herenthoutsesteenweg 2,2022-11-25,21:00:00,23,22,1,ECO_300019380
642,Herenthoutsesteenweg 2,2022-11-25,22:00:00,28,25,3,ECO_300019380
642,Herenthoutsesteenweg 2,2022-11-25,23:00:00,17,15,2,ECO_300019380
642,Herenthoutsesteenweg 2,2022-11-26,00:00:00,5,3,2,ECO_300019380
642,Herenthoutsesteenweg 2,2022-11-26,01:00:00,9,8,1,ECO_300019380
642,Herenthoutsesteenweg 2,2022-11-26,02:00:00,7,7,0,ECO_300019380
642,Herenthoutsesteenweg 2,2022-11-26,03:00:00,1,0,1,ECO_300019380
642,Herenthoutsesteenweg 2,2022-11-26,04:00:00,1,0,1,ECO_300019380
642,Herenthoutsesteenweg 2,2022-11-26,05:00:00,2,2,0,ECO_300019380
642,Herenthoutsesteenweg 2,2022-11-26,06:00:00,1,1,0,ECO_300019380
642,Herenthoutsesteenweg 2,2022-11-26,07:00:00,9,9,0,ECO_300019380
642,Herenthoutsesteenweg 2,2022-11-26,08:00:00,9,9,0,ECO_300019380
642,Herenthoutsesteenweg 2,2022-11-26,09:00:00,55,54,1,ECO_300019380
642,Herenthoutsesteenweg 2,2022-11-26,10:00:00,75,63,12,ECO_300019380
642,Herenthoutsesteenweg 2,2022-11-26,11:00:00,67,66,1,ECO_300019380
642,Herenthoutsesteenweg 2,2022-11-26,12:00:00,60,54,6,ECO_300019380
642,Herenthoutsesteenweg 2,2022-11-26,13:00:00,94,77,17,ECO_300019380
642,Herenthoutsesteenweg 2,2022-11-26,14:00:00,145,133,12,ECO_300019380
642,Herenthoutsesteenweg 2,2022-11-26,15:00:00,98,95,3,ECO_300019380
642,Herenthoutsesteenweg 2,2022-11-26,16:00:00,103,95,8,ECO_300019380
642,Herenthoutsesteenweg 2,2022-11-26,17:00:00,59,57,2,ECO_300019380
642,Herenthoutsesteenweg 2,2022-11-26,18:00:00,51,50,1,ECO_300019380
642,Herenthoutsesteenweg 2,2022-11-26,19:00:00,22,20,2,ECO_300019380
642,Herenthoutsesteenweg 2,2022-11-26,20:00:00,23,21,2,ECO_300019380
642,Herenthoutsesteenweg 2,2022-11-26,21:00:00,22,22,0,ECO_300019380
642,Herenthoutsesteenweg 2,2022-11-26,22:00:00,8,8,0,ECO_300019380
642,Herenthoutsesteenweg 2,2022-11-26,23:00:00,7,3,4,ECO_300019380
642,Herenthoutsesteenweg 2,2022-11-27,00:00:00,11,10,1,ECO_300019380
642,Herenthoutsesteenweg 2,2022-11-27,01:00:00,8,8,0,ECO_300019380
642,Herenthoutsesteenweg 2,2022-11-27,02:00:00,4,4,0,ECO_300019380
642,Herenthoutsesteenweg 2,2022-11-27,03:00:00,8,7,1,ECO_300019380
642,Herenthoutsesteenweg 2,2022-11-27,04:00:00,1,1,0,ECO_300019380
642,Herenthoutsesteenweg 2,2022-11-27,05:00:00,7,6,1,ECO_300019380
642,Herenthoutsesteenweg 2,2022-11-27,06:00:00,3,2,1,ECO_300019380
642,Herenthoutsesteenweg 2,2022-11-27,07:00:00,8,8,0,ECO_300019380
642,Herenthoutsesteenweg 2,2022-11-27,08:00:00,5,4,1,ECO_300019380
642,Herenthoutsesteenweg 2,2022-11-27,09:00:00,23,23,0,ECO_300019380
642,Herenthoutsesteenweg 2,2022-11-27,10:00:00,37,32,5,ECO_300019380
642,Herenthoutsesteenweg 2,2022-11-27,11:00:00,42,38,4,ECO_300019380
642,Herenthoutsesteenweg 2,2022-11-27,12:00:00,17,14,3,ECO_300019380
642,Herenthoutsesteenweg 2,2022-11-27,13:00:00,13,11,2,ECO_300019380
642,Herenthoutsesteenweg 2,2022-11-27,14:00:00,29,28,1,ECO_300019380
642,Herenthoutsesteenweg 2,2022-11-27,15:00:00,11,10,1,ECO_300019380
642,Herenthoutsesteenweg 2,2022-11-27,16:00:00,10,8,2,ECO_300019380
642,Herenthoutsesteenweg 2,2022-11-27,17:00:00,20,17,3,ECO_300019380
642,Herenthoutsesteenweg 2,2022-11-27,18:00:00,9,7,2,ECO_300019380
642,Herenthoutsesteenweg 2,2022-11-27,19:00:00,6,6,0,ECO_300019380
642,Herenthoutsesteenweg 2,2022-11-27,20:00:00,3,3,0,ECO_300019380
642,Herenthoutsesteenweg 2,2022-11-27,21:00:00,4,3,1,ECO_300019380
642,Herenthoutsesteenweg 2,2022-11-27,22:00:00,6,6,0,ECO_300019380
642,Herenthoutsesteenweg 2,2022-11-27,23:00:00,3,3,0,ECO_300019380
642,Herenthoutsesteenweg 2,2022-11-28,00:00:00,1,1,0,ECO_300019380
642,Herenthoutsesteenweg 2,2022-11-28,01:00:00,2,2,0,ECO_300019380
642,Herenthoutsesteenweg 2,2022-11-28,02:00:00,0,0,0,ECO_300019380
642,Herenthoutsesteenweg 2,2022-11-28,03:00:00,0,0,0,ECO_300019380
642,Herenthoutsesteenweg 2,2022-11-28,04:00:00,1,1,0,ECO_300019380
642,Herenthoutsesteenweg 2,2022-11-28,05:00:00,1,1,0,ECO_300019380
642,Herenthoutsesteenweg 2,2022-11-28,06:00:00,14,14,0,ECO_300019380
642,Herenthoutsesteenweg 2,2022-11-28,07:00:00,30,29,1,ECO_300019380
642,Herenthoutsesteenweg 2,2022-11-28,08:00:00,115,111,4,ECO_300019380
642,Herenthoutsesteenweg 2,2022-11-28,09:00:00,515,503,12,ECO_300019380
642,Herenthoutsesteenweg 2,2022-11-28,10:00:00,43,43,0,ECO_300019380
642,Herenthoutsesteenweg 2,2022-11-28,11:00:00,36,30,6,ECO_300019380
642,Herenthoutsesteenweg 2,2022-11-28,12:00:00,30,30,0,ECO_300019380
642,Herenthoutsesteenweg 2,2022-11-28,13:00:00,56,50,6,ECO_300019380
642,Herenthoutsesteenweg 2,2022-11-28,14:00:00,75,65,10,ECO_300019380
642,Herenthoutsesteenweg 2,2022-11-28,15:00:00,69,66,3,ECO_300019380
642,Herenthoutsesteenweg 2,2022-11-28,16:00:00,80,75,5,ECO_300019380
642,Herenthoutsesteenweg 2,2022-11-28,17:00:00,98,91,7,ECO_300019380
642,Herenthoutsesteenweg 2,2022-11-28,18:00:00,48,41,7,ECO_300019380
642,Herenthoutsesteenweg 2,2022-11-28,19:00:00,29,26,3,ECO_300019380
642,Herenthoutsesteenweg 2,2022-11-28,20:00:00,31,30,1,ECO_300019380
642,Herenthoutsesteenweg 2,2022-11-28,21:00:00,7,7,0,ECO_300019380
642,Herenthoutsesteenweg 2,2022-11-28,22:00:00,15,13,2,ECO_300019380
642,Herenthoutsesteenweg 2,2022-11-28,23:00:00,11,11,0,ECO_300019380
642,Herenthoutsesteenweg 2,2022-11-29,00:00:00,3,2,1,ECO_300019380
642,Herenthoutsesteenweg 2,2022-11-29,01:00:00,1,1,0,ECO_300019380
642,Herenthoutsesteenweg 2,2022-11-29,02:00:00,0,0,0,ECO_300019380
642,Herenthoutsesteenweg 2,2022-11-29,03:00:00,1,0,1,ECO_300019380
642,Herenthoutsesteenweg 2,2022-11-29,04:00:00,1,1,0,ECO_300019380
642,Herenthoutsesteenweg 2,2022-11-29,05:00:00,2,2,0,ECO_300019380
642,Herenthoutsesteenweg 2,2022-11-29,06:00:00,11,10,1,ECO_300019380
642,Herenthoutsesteenweg 2,2022-11-29,07:00:00,51,46,5,ECO_300019380
642,Herenthoutsesteenweg 2,2022-11-29,08:00:00,135,132,3,ECO_300019380
642,Herenthoutsesteenweg 2,2022-11-29,09:00:00,513,507,6,ECO_300019380
642,Herenthoutsesteenweg 2,2022-11-29,10:00:00,74,70,4,ECO_300019380
642,Herenthoutsesteenweg 2,2022-11-29,11:00:00,52,50,2,ECO_300019380
642,Herenthoutsesteenweg 2,2022-11-29,12:00:00,47,41,6,ECO_300019380
642,Herenthoutsesteenweg 2,2022-11-29,13:00:00,66,60,6,ECO_300019380
642,Herenthoutsesteenweg 2,2022-11-29,14:00:00,79,76,3,ECO_300019380
642,Herenthoutsesteenweg 2,2022-11-29,15:00:00,90,83,7,ECO_300019380
642,Herenthoutsesteenweg 2,2022-11-29,16:00:00,87,79,8,ECO_300019380
642,Herenthoutsesteenweg 2,2022-11-29,17:00:00,119,107,12,ECO_300019380
642,Herenthoutsesteenweg 2,2022-11-29,18:00:00,58,53,5,ECO_300019380
642,Herenthoutsesteenweg 2,2022-11-29,19:00:00,35,33,2,ECO_300019380
642,Herenthoutsesteenweg 2,2022-11-29,20:00:00,28,26,2,ECO_300019380
642,Herenthoutsesteenweg 2,2022-11-29,21:00:00,20,17,3,ECO_300019380
642,Herenthoutsesteenweg 2,2022-11-29,22:00:00,4,4,0,ECO_300019380
642,Herenthoutsesteenweg 2,2022-11-29,23:00:00,22,20,2,ECO_300019380
642,Herenthoutsesteenweg 2,2022-11-30,00:00:00,1,0,1,ECO_300019380
642,Herenthoutsesteenweg 2,2022-11-30,01:00:00,2,2,0,ECO_300019380
642,Herenthoutsesteenweg 2,2022-11-30,02:00:00,2,1,1,ECO_300019380
642,Herenthoutsesteenweg 2,2022-11-30,03:00:00,1,1,0,ECO_300019380
642,Herenthoutsesteenweg 2,2022-11-30,04:00:00,1,1,0,ECO_300019380
642,Herenthoutsesteenweg 2,2022-11-30,05:00:00,1,1,0,ECO_300019380
642,Herenthoutsesteenweg 2,2022-11-30,06:00:00,18,18,0,ECO_300019380
642,Herenthoutsesteenweg 2,2022-11-30,07:00:00,44,41,3,ECO_300019380
642,Herenthoutsesteenweg 2,2022-11-30,08:00:00,110,104,6,ECO_300019380
642,Herenthoutsesteenweg 2,2022-11-30,09:00:00,545,539,6,ECO_300019380
642,Herenthoutsesteenweg 2,2022-11-30,10:00:00,66,66,0,ECO_300019380
642,Herenthoutsesteenweg 2,2022-11-30,11:00:00,31,31,0,ECO_300019380
642,Herenthoutsesteenweg 2,2022-11-30,12:00:00,54,52,2,ECO_300019380
642,Herenthoutsesteenweg 2,2022-11-30,13:00:00,110,96,14,ECO_300019380
642,Herenthoutsesteenweg 2,2022-11-30,14:00:00,102,96,6,ECO_300019380
642,Herenthoutsesteenweg 2,2022-11-30,15:00:00,75,69,6,ECO_300019380
642,Herenthoutsesteenweg 2,2022-11-30,16:00:00,73,67,6,ECO_300019380
642,Herenthoutsesteenweg 2,2022-11-30,17:00:00,100,92,8,ECO_300019380
642,Herenthoutsesteenweg 2,2022-11-30,18:00:00,61,55,6,ECO_300019380
642,Herenthoutsesteenweg 2,2022-11-30,19:00:00,43,41,2,ECO_300019380
642,Herenthoutsesteenweg 2,2022-11-30,20:00:00,26,26,0,ECO_300019380
642,Herenthoutsesteenweg 2,2022-11-30,21:00:00,27,25,2,ECO_300019380
642,Herenthoutsesteenweg 2,2022-11-30,22:00:00,3,2,1,ECO_300019380
642,Herenthoutsesteenweg 2,2022-11-30,23:00:00,16,15,1,ECO_300019380
642,Herenthoutsesteenweg 2,2022-12-01,00:00:00,4,4,0,ECO_300019380
642,Herenthoutsesteenweg 2,2022-12-01,01:00:00,1,0,1,ECO_300019380
642,Herenthoutsesteenweg 2,2022-12-01,02:00:00,2,2,0,ECO_300019380
642,Herenthoutsesteenweg 2,2022-12-01,03:00:00,1,1,0,ECO_300019380
642,Herenthoutsesteenweg 2,2022-12-01,04:00:00,0,0,0,ECO_300019380
642,Herenthoutsesteenweg 2,2022-12-01,05:00:00,2,2,0,ECO_300019380
642,Herenthoutsesteenweg 2,2022-12-01,06:00:00,12,12,0,ECO_300019380
642,Herenthoutsesteenweg 2,2022-12-01,07:00:00,38,33,5,ECO_300019380
642,Herenthoutsesteenweg 2,2022-12-01,08:00:00,132,130,2,ECO_300019380
642,Herenthoutsesteenweg 2,2022-12-01,09:00:00,544,539,5,ECO_300019380
642,Herenthoutsesteenweg 2,2022-12-01,10:00:00,86,84,2,ECO_300019380
642,Herenthoutsesteenweg 2,2022-12-01,11:00:00,39,39,0,ECO_300019380
642,Herenthoutsesteenweg 2,2022-12-01,12:00:00,45,44,1,ECO_300019380
642,Herenthoutsesteenweg 2,2022-12-01,13:00:00,71,68,3,ECO_300019380
642,Herenthoutsesteenweg 2,2022-12-01,14:00:00,84,81,3,ECO_300019380
642,Herenthoutsesteenweg 2,2022-12-01,15:00:00,73,65,8,ECO_300019380
642,Herenthoutsesteenweg 2,2022-12-01,16:00:00,141,127,14,ECO_300019380
642,Herenthoutsesteenweg 2,2022-12-01,17:00:00,93,86,7,ECO_300019380
642,Herenthoutsesteenweg 2,2022-12-01,18:00:00,48,43,5,ECO_300019380
642,Herenthoutsesteenweg 2,2022-12-01,19:00:00,50,49,1,ECO_300019380
642,Herenthoutsesteenweg 2,2022-12-01,20:00:00,21,20,1,ECO_300019380
642,Herenthoutsesteenweg 2,2022-12-01,21:00:00,16,13,3,ECO_300019380
642,Herenthoutsesteenweg 2,2022-12-01,22:00:00,10,10,0,ECO_300019380
642,Herenthoutsesteenweg 2,2022-12-01,23:00:00,12,10,2,ECO_300019380
642,Herenthoutsesteenweg 2,2022-12-02,00:00:00,4,4,0,ECO_300019380
642,Herenthoutsesteenweg 2,2022-12-02,01:00:00,4,3,1,ECO_300019380
642,Herenthoutsesteenweg 2,2022-12-02,02:00:00,2,0,2,ECO_300019380
642,Herenthoutsesteenweg 2,2022-12-02,03:00:00,1,1,0,ECO_300019380
642,Herenthoutsesteenweg 2,2022-12-02,04:00:00,2,1,1,ECO_300019380
642,Herenthoutsesteenweg 2,2022-12-02,05:00:00,1,1,0,ECO_300019380
642,Herenthoutsesteenweg 2,2022-12-02,06:00:00,14,14,0,ECO_300019380
642,Herenthoutsesteenweg 2,2022-12-02,07:00:00,33,31,2,ECO_300019380
642,Herenthoutsesteenweg 2,2022-12-02,08:00:00,107,106,1,ECO_300019380
642,Herenthoutsesteenweg 2,2022-12-02,09:00:00,534,527,7,ECO_300019380
642,Herenthoutsesteenweg 2,2022-12-02,10:00:00,95,91,4,ECO_300019380
642,Herenthoutsesteenweg 2,2022-12-02,11:00:00,64,64,0,ECO_300019380
642,Herenthoutsesteenweg 2,2022-12-02,12:00:00,56,47,9,ECO_300019380
642,Herenthoutsesteenweg 2,2022-12-02,13:00:00,41,37,4,ECO_300019380
642,Herenthoutsesteenweg 2,2022-12-02,14:00:00,55,50,5,ECO_300019380
642,Herenthoutsesteenweg 2,2022-12-02,15:00:00,47,40,7,ECO_300019380
642,Herenthoutsesteenweg 2,2022-12-02,16:00:00,97,89,8,ECO_300019380
642,Herenthoutsesteenweg 2,2022-12-02,17:00:00,99,87,12,ECO_300019380
642,Herenthoutsesteenweg 2,2022-12-02,18:00:00,35,30,5,ECO_300019380
642,Herenthoutsesteenweg 2,2022-12-02,19:00:00,31,29,2,ECO_300019380
642,Herenthoutsesteenweg 2,2022-12-02,20:00:00,19,18,1,ECO_300019380
642,Herenthoutsesteenweg 2,2022-12-02,21:00:00,15,15,0,ECO_300019380
642,Herenthoutsesteenweg 2,2022-12-02,22:00:00,13,10,3,ECO_300019380
642,Herenthoutsesteenweg 2,2022-12-02,23:00:00,13,10,3,ECO_300019380
642,Herenthoutsesteenweg 2,2022-12-03,00:00:00,5,5,0,ECO_300019380
642,Herenthoutsesteenweg 2,2022-12-03,01:00:00,8,5,3,ECO_300019380
642,Herenthoutsesteenweg 2,2022-12-03,02:00:00,0,0,0,ECO_300019380
642,Herenthoutsesteenweg 2,2022-12-03,03:00:00,0,0,0,ECO_300019380
642,Herenthoutsesteenweg 2,2022-12-03,04:00:00,4,4,0,ECO_300019380
642,Herenthoutsesteenweg 2,2022-12-03,05:00:00,4,3,1,ECO_300019380
642,Herenthoutsesteenweg 2,2022-12-03,06:00:00,5,5,0,ECO_300019380
642,Herenthoutsesteenweg 2,2022-12-03,07:00:00,4,4,0,ECO_300019380
642,Herenthoutsesteenweg 2,2022-12-03,08:00:00,5,5,0,ECO_300019380
642,Herenthoutsesteenweg 2,2022-12-03,09:00:00,26,25,1,ECO_300019380
642,Herenthoutsesteenweg 2,2022-12-03,10:00:00,43,43,0,ECO_300019380
642,Herenthoutsesteenweg 2,2022-12-03,11:00:00,52,49,3,ECO_300019380
642,Herenthoutsesteenweg 2,2022-12-03,12:00:00,63,60,3,ECO_300019380
642,Herenthoutsesteenweg 2,2022-12-03,13:00:00,55,49,6,ECO_300019380
642,Herenthoutsesteenweg 2,2022-12-03,14:00:00,48,44,4,ECO_300019380
642,Herenthoutsesteenweg 2,2022-12-03,15:00:00,50,40,10,ECO_300019380
642,Herenthoutsesteenweg 2,2022-12-03,16:00:00,42,35,7,ECO_300019380
642,Herenthoutsesteenweg 2,2022-12-03,17:00:00,35,30,5,ECO_300019380
642,Herenthoutsesteenweg 2,2022-12-03,18:00:00,22,21,1,ECO_300019380
642,Herenthoutsesteenweg 2,2022-12-03,19:00:00,25,22,3,ECO_300019380
642,Herenthoutsesteenweg 2,2022-12-03,20:00:00,16,16,0,ECO_300019380
642,Herenthoutsesteenweg 2,2022-12-03,21:00:00,17,17,0,ECO_300019380
642,Herenthoutsesteenweg 2,2022-12-03,22:00:00,6,5,1,ECO_300019380
642,Herenthoutsesteenweg 2,2022-12-03,23:00:00,7,6,1,ECO_300019380
642,Herenthoutsesteenweg 2,2022-12-04,00:00:00,3,2,1,ECO_300019380
642,Herenthoutsesteenweg 2,2022-12-04,01:00:00,7,7,0,ECO_300019380
642,Herenthoutsesteenweg 2,2022-12-04,02:00:00,7,6,1,ECO_300019380
642,Herenthoutsesteenweg 2,2022-12-04,03:00:00,7,7,0,ECO_300019380
642,Herenthoutsesteenweg 2,2022-12-04,04:00:00,1,1,0,ECO_300019380
642,Herenthoutsesteenweg 2,2022-12-04,05:00:00,0,0,0,ECO_300019380
642,Herenthoutsesteenweg 2,2022-12-04,06:00:00,4,4,0,ECO_300019380
642,Herenthoutsesteenweg 2,2022-12-04,07:00:00,4,4,0,ECO_300019380
642,Herenthoutsesteenweg 2,2022-12-04,08:00:00,8,8,0,ECO_300019380
642,Herenthoutsesteenweg 2,2022-12-04,09:00:00,29,27,2,ECO_300019380
642,Herenthoutsesteenweg 2,2022-12-04,10:00:00,74,70,4,ECO_300019380
642,Herenthoutsesteenweg 2,2022-12-04,11:00:00,56,48,8,ECO_300019380
642,Herenthoutsesteenweg 2,2022-12-04,12:00:00,37,34,3,ECO_300019380
642,Herenthoutsesteenweg 2,2022-12-04,13:00:00,30,18,12,ECO_300019380
642,Herenthoutsesteenweg 2,2022-12-04,14:00:00,33,30,3,ECO_300019380
642,Herenthoutsesteenweg 2,2022-12-04,15:00:00,27,18,9,ECO_300019380
642,Herenthoutsesteenweg 2,2022-12-04,16:00:00,16,14,2,ECO_300019380
642,Herenthoutsesteenweg 2,2022-12-04,17:00:00,14,12,2,ECO_300019380
642,Herenthoutsesteenweg 2,2022-12-04,18:00:00,6,5,1,ECO_300019380
642,Herenthoutsesteenweg 2,2022-12-04,19:00:00,14,13,1,ECO_300019380
642,Herenthoutsesteenweg 2,2022-12-04,20:00:00,13,12,1,ECO_300019380
642,Herenthoutsesteenweg 2,2022-12-04,21:00:00,3,3,0,ECO_300019380
642,Herenthoutsesteenweg 2,2022-12-04,22:00:00,6,5,1,ECO_300019380
642,Herenthoutsesteenweg 2,2022-12-04,23:00:00,2,1,1,ECO_300019380
642,Herenthoutsesteenweg 2,2022-12-05,00:00:00,3,3,0,ECO_300019380
642,Herenthoutsesteenweg 2,2022-12-05,01:00:00,1,1,0,ECO_300019380
642,Herenthoutsesteenweg 2,2022-12-05,02:00:00,2,2,0,ECO_300019380
642,Herenthoutsesteenweg 2,2022-12-05,03:00:00,0,0,0,ECO_300019380
642,Herenthoutsesteenweg 2,2022-12-05,04:00:00,0,0,0,ECO_300019380
642,Herenthoutsesteenweg 2,2022-12-05,05:00:00,2,2,0,ECO_300019380
642,Herenthoutsesteenweg 2,2022-12-05,06:00:00,11,10,1,ECO_300019380
642,Herenthoutsesteenweg 2,2022-12-05,07:00:00,32,30,2,ECO_300019380
642,Herenthoutsesteenweg 2,2022-12-05,08:00:00,105,102,3,ECO_300019380
642,Herenthoutsesteenweg 2,2022-12-05,09:00:00,461,447,14,ECO_300019380
642,Herenthoutsesteenweg 2,2022-12-05,10:00:00,31,30,1,ECO_300019380
642,Herenthoutsesteenweg 2,2022-12-05,11:00:00,20,19,1,ECO_300019380
642,Herenthoutsesteenweg 2,2022-12-05,12:00:00,15,13,2,ECO_300019380
642,Herenthoutsesteenweg 2,2022-12-05,13:00:00,25,22,3,ECO_300019380
642,Herenthoutsesteenweg 2,2022-12-05,14:00:00,32,28,4,ECO_300019380
642,Herenthoutsesteenweg 2,2022-12-05,15:00:00,37,36,1,ECO_300019380
642,Herenthoutsesteenweg 2,2022-12-05,16:00:00,47,40,7,ECO_300019380
642,Herenthoutsesteenweg 2,2022-12-05,17:00:00,76,69,7,ECO_300019380
642,Herenthoutsesteenweg 2,2022-12-05,18:00:00,37,33,4,ECO_300019380
642,Herenthoutsesteenweg 2,2022-12-05,19:00:00,28,24,4,ECO_300019380
642,Herenthoutsesteenweg 2,2022-12-05,20:00:00,23,22,1,ECO_300019380
642,Herenthoutsesteenweg 2,2022-12-05,21:00:00,10,9,1,ECO_300019380
642,Herenthoutsesteenweg 2,2022-12-05,22:00:00,4,4,0,ECO_300019380
642,Herenthoutsesteenweg 2,2022-12-05,23:00:00,15,11,4,ECO_300019380
642,Herenthoutsesteenweg 2,2022-12-06,00:00:00,3,1,2,ECO_300019380
642,Herenthoutsesteenweg 2,2022-12-06,01:00:00,2,2,0,ECO_300019380
642,Herenthoutsesteenweg 2,2022-12-06,02:00:00,0,0,0,ECO_300019380
642,Herenthoutsesteenweg 2,2022-12-06,03:00:00,1,1,0,ECO_300019380
642,Herenthoutsesteenweg 2,2022-12-06,04:00:00,0,0,0,ECO_300019380
642,Herenthoutsesteenweg 2,2022-12-06,05:00:00,5,4,1,ECO_300019380
642,Herenthoutsesteenweg 2,2022-12-06,06:00:00,16,14,2,ECO_300019380
642,Herenthoutsesteenweg 2,2022-12-06,07:00:00,48,45,3,ECO_300019380
642,Herenthoutsesteenweg 2,2022-12-06,08:00:00,127,124,3,ECO_300019380
642,Herenthoutsesteenweg 2,2022-12-06,09:00:00,527,523,4,ECO_300019380
642,Herenthoutsesteenweg 2,2022-12-06,10:00:00,75,75,0,ECO_300019380
642,Herenthoutsesteenweg 2,2022-12-06,11:00:00,48,47,1,ECO_300019380
642,Herenthoutsesteenweg 2,2022-12-06,12:00:00,38,37,1,ECO_300019380
642,Herenthoutsesteenweg 2,2022-12-06,13:00:00,65,63,2,ECO_300019380
642,Herenthoutsesteenweg 2,2022-12-06,14:00:00,112,108,4,ECO_300019380
642,Herenthoutsesteenweg 2,2022-12-06,15:00:00,78,72,6,ECO_300019380
642,Herenthoutsesteenweg 2,2022-12-06,16:00:00,91,84,7,ECO_300019380
642,Herenthoutsesteenweg 2,2022-12-06,17:00:00,112,98,14,ECO_300019380
642,Herenthoutsesteenweg 2,2022-12-06,18:00:00,57,54,3,ECO_300019380
642,Herenthoutsesteenweg 2,2022-12-06,19:00:00,23,19,4,ECO_300019380
642,Herenthoutsesteenweg 2,2022-12-06,20:00:00,36,32,4,ECO_300019380
642,Herenthoutsesteenweg 2,2022-12-06,21:00:00,11,9,2,ECO_300019380
642,Herenthoutsesteenweg 2,2022-12-06,22:00:00,10,8,2,ECO_300019380
642,Herenthoutsesteenweg 2,2022-12-06,23:00:00,12,9,3,ECO_300019380
642,Herenthoutsesteenweg 2,2022-12-07,00:00:00,2,0,2,ECO_300019380
642,Herenthoutsesteenweg 2,2022-12-07,01:00:00,1,1,0,ECO_300019380
642,Herenthoutsesteenweg 2,2022-12-07,02:00:00,3,3,0,ECO_300019380
642,Herenthoutsesteenweg 2,2022-12-07,03:00:00,1,1,0,ECO_300019380
642,Herenthoutsesteenweg 2,2022-12-07,04:00:00,0,0,0,ECO_300019380
642,Herenthoutsesteenweg 2,2022-12-07,05:00:00,3,3,0,ECO_300019380
642,Herenthoutsesteenweg 2,2022-12-07,06:00:00,16,13,3,ECO_300019380
642,Herenthoutsesteenweg 2,2022-12-07,07:00:00,43,36,7,ECO_300019380
642,Herenthoutsesteenweg 2,2022-12-07,08:00:00,117,115,2,ECO_300019380
642,Herenthoutsesteenweg 2,2022-12-07,09:00:00,486,484,2,ECO_300019380
642,Herenthoutsesteenweg 2,2022-12-07,10:00:00,57,56,1,ECO_300019380
642,Herenthoutsesteenweg 2,2022-12-07,11:00:00,50,49,1,ECO_300019380
642,Herenthoutsesteenweg 2,2022-12-07,12:00:00,58,53,5,ECO_300019380
642,Herenthoutsesteenweg 2,2022-12-07,13:00:00,65,60,5,ECO_300019380
642,Herenthoutsesteenweg 2,2022-12-07,14:00:00,65,61,4,ECO_300019380
642,Herenthoutsesteenweg 2,2022-12-07,15:00:00,73,69,4,ECO_300019380
642,Herenthoutsesteenweg 2,2022-12-07,16:00:00,57,52,5,ECO_300019380
642,Herenthoutsesteenweg 2,2022-12-07,17:00:00,69,63,6,ECO_300019380
642,Herenthoutsesteenweg 2,2022-12-07,18:00:00,46,43,3,ECO_300019380
642,Herenthoutsesteenweg 2,2022-12-07,19:00:00,26,24,2,ECO_300019380
642,Herenthoutsesteenweg 2,2022-12-07,20:00:00,18,18,0,ECO_300019380
642,Herenthoutsesteenweg 2,2022-12-07,21:00:00,12,12,0,ECO_300019380
642,Herenthoutsesteenweg 2,2022-12-07,22:00:00,5,3,2,ECO_300019380
642,Herenthoutsesteenweg 2,2022-12-07,23:00:00,15,12,3,ECO_300019380
642,Herenthoutsesteenweg 2,2022-12-08,00:00:00,3,2,1,ECO_300019380
642,Herenthoutsesteenweg 2,2022-12-08,01:00:00,3,3,0,ECO_300019380
642,Herenthoutsesteenweg 2,2022-12-08,02:00:00,1,1,0,ECO_300019380
642,Herenthoutsesteenweg 2,2022-12-08,03:00:00,0,0,0,ECO_300019380
642,Herenthoutsesteenweg 2,2022-12-08,04:00:00,0,0,0,ECO_300019380
642,Herenthoutsesteenweg 2,2022-12-08,05:00:00,3,3,0,ECO_300019380
642,Herenthoutsesteenweg 2,2022-12-08,06:00:00,12,11,1,ECO_300019380
642,Herenthoutsesteenweg 2,2022-12-08,07:00:00,27,26,1,ECO_300019380
642,Herenthoutsesteenweg 2,2022-12-08,08:00:00,108,105,3,ECO_300019380
642,Herenthoutsesteenweg 2,2022-12-08,09:00:00,482,470,12,ECO_300019380
642,Herenthoutsesteenweg 2,2022-12-08,10:00:00,107,106,1,ECO_300019380
642,Herenthoutsesteenweg 2,2022-12-08,11:00:00,43,41,2,ECO_300019380
642,Herenthoutsesteenweg 2,2022-12-08,12:00:00,51,47,4,ECO_300019380
642,Herenthoutsesteenweg 2,2022-12-08,13:00:00,50,42,8,ECO_300019380
642,Herenthoutsesteenweg 2,2022-12-08,14:00:00,47,43,4,ECO_300019380
642,Herenthoutsesteenweg 2,2022-12-08,15:00:00,27,25,2,ECO_300019380
642,Herenthoutsesteenweg 2,2022-12-08,16:00:00,77,69,8,ECO_300019380
642,Herenthoutsesteenweg 2,2022-12-08,17:00:00,92,82,10,ECO_300019380
642,Herenthoutsesteenweg 2,2022-12-08,18:00:00,44,35,9,ECO_300019380
642,Herenthoutsesteenweg 2,2022-12-08,19:00:00,35,33,2,ECO_300019380
642,Herenthoutsesteenweg 2,2022-12-08,20:00:00,27,26,1,ECO_300019380
642,Herenthoutsesteenweg 2,2022-12-08,21:00:00,10,9,1,ECO_300019380
642,Herenthoutsesteenweg 2,2022-12-08,22:00:00,9,9,0,ECO_300019380
642,Herenthoutsesteenweg 2,2022-12-08,23:00:00,14,12,2,ECO_300019380
642,Herenthoutsesteenweg 2,2022-12-09,00:00:00,3,0,3,ECO_300019380
642,Herenthoutsesteenweg 2,2022-12-09,01:00:00,3,2,1,ECO_300019380
642,Herenthoutsesteenweg 2,2022-12-09,02:00:00,1,1,0,ECO_300019380
642,Herenthoutsesteenweg 2,2022-12-09,03:00:00,0,0,0,ECO_300019380
642,Herenthoutsesteenweg 2,2022-12-09,04:00:00,0,0,0,ECO_300019380
642,Herenthoutsesteenweg 2,2022-12-09,05:00:00,3,3,0,ECO_300019380
642,Herenthoutsesteenweg 2,2022-12-09,06:00:00,15,12,3,ECO_300019380
642,Herenthoutsesteenweg 2,2022-12-09,07:00:00,29,28,1,ECO_300019380
642,Herenthoutsesteenweg 2,2022-12-09,08:00:00,94,92,2,ECO_300019380
642,Herenthoutsesteenweg 2,2022-12-09,09:00:00,485,482,3,ECO_300019380
642,Herenthoutsesteenweg 2,2022-12-09,10:00:00,94,92,2,ECO_300019380
642,Herenthoutsesteenweg 2,2022-12-09,11:00:00,73,70,3,ECO_300019380
642,Herenthoutsesteenweg 2,2022-12-09,12:00:00,44,42,2,ECO_300019380
642,Herenthoutsesteenweg 2,2022-12-09,13:00:00,51,45,6,ECO_300019380
642,Herenthoutsesteenweg 2,2022-12-09,14:00:00,66,59,7,ECO_300019380
642,Herenthoutsesteenweg 2,2022-12-09,15:00:00,57,51,6,ECO_300019380
642,Herenthoutsesteenweg 2,2022-12-09,16:00:00,103,95,8,ECO_300019380
642,Herenthoutsesteenweg 2,2022-12-09,17:00:00,62,56,6,ECO_300019380
642,Herenthoutsesteenweg 2,2022-12-09,18:00:00,46,36,10,ECO_300019380
642,Herenthoutsesteenweg 2,2022-12-09,19:00:00,31,29,2,ECO_300019380
642,Herenthoutsesteenweg 2,2022-12-09,20:00:00,25,24,1,ECO_300019380
642,Herenthoutsesteenweg 2,2022-12-09,21:00:00,19,19,0,ECO_300019380
642,Herenthoutsesteenweg 2,2022-12-09,22:00:00,10,8,2,ECO_300019380
642,Herenthoutsesteenweg 2,2022-12-09,23:00:00,18,12,6,ECO_300019380
642,Herenthoutsesteenweg 2,2022-12-10,00:00:00,8,6,2,ECO_300019380
642,Herenthoutsesteenweg 2,2022-12-10,01:00:00,7,6,1,ECO_300019380
642,Herenthoutsesteenweg 2,2022-12-10,02:00:00,5,5,0,ECO_300019380
642,Herenthoutsesteenweg 2,2022-12-10,03:00:00,1,0,1,ECO_300019380
642,Herenthoutsesteenweg 2,2022-12-10,04:00:00,0,0,0,ECO_300019380
642,Herenthoutsesteenweg 2,2022-12-10,05:00:00,0,0,0,ECO_300019380
642,Herenthoutsesteenweg 2,2022-12-10,06:00:00,4,4,0,ECO_300019380
642,Herenthoutsesteenweg 2,2022-12-10,07:00:00,7,7,0,ECO_300019380
642,Herenthoutsesteenweg 2,2022-12-10,08:00:00,5,5,0,ECO_300019380
642,Herenthoutsesteenweg 2,2022-12-10,09:00:00,16,15,1,ECO_300019380
642,Herenthoutsesteenweg 2,2022-12-10,10:00:00,31,28,3,ECO_300019380
642,Herenthoutsesteenweg 2,2022-12-10,11:00:00,39,39,0,ECO_300019380
642,Herenthoutsesteenweg 2,2022-12-10,12:00:00,37,36,1,ECO_300019380
642,Herenthoutsesteenweg 2,2022-12-10,13:00:00,54,48,6,ECO_300019380
642,Herenthoutsesteenweg 2,2022-12-10,14:00:00,44,42,2,ECO_300019380
642,Herenthoutsesteenweg 2,2022-12-10,15:00:00,32,31,1,ECO_300019380
642,Herenthoutsesteenweg 2,2022-12-10,16:00:00,35,33,2,ECO_300019380
642,Herenthoutsesteenweg 2,2022-12-10,17:00:00,34,28,6,ECO_300019380
642,Herenthoutsesteenweg 2,2022-12-10,18:00:00,21,18,3,ECO_300019380
642,Herenthoutsesteenweg 2,2022-12-10,19:00:00,23,21,2,ECO_300019380
642,Herenthoutsesteenweg 2,2022-12-10,20:00:00,15,14,1,ECO_300019380
642,Herenthoutsesteenweg 2,2022-12-10,21:00:00,4,4,0,ECO_300019380
642,Herenthoutsesteenweg 2,2022-12-10,22:00:00,11,11,0,ECO_300019380
642,Herenthoutsesteenweg 2,2022-12-10,23:00:00,4,4,0,ECO_300019380
642,Herenthoutsesteenweg 2,2022-12-11,00:00:00,7,4,3,ECO_300019380
642,Herenthoutsesteenweg 2,2022-12-11,01:00:00,11,10,1,ECO_300019380
642,Herenthoutsesteenweg 2,2022-12-11,02:00:00,5,4,1,ECO_300019380
642,Herenthoutsesteenweg 2,2022-12-11,03:00:00,8,6,2,ECO_300019380
642,Herenthoutsesteenweg 2,2022-12-11,04:00:00,6,3,3,ECO_300019380
642,Herenthoutsesteenweg 2,2022-12-11,05:00:00,5,5,0,ECO_300019380
642,Herenthoutsesteenweg 2,2022-12-11,06:00:00,3,3,0,ECO_300019380
642,Herenthoutsesteenweg 2,2022-12-11,07:00:00,6,5,1,ECO_300019380
642,Herenthoutsesteenweg 2,2022-12-11,08:00:00,5,4,1,ECO_300019380
642,Herenthoutsesteenweg 2,2022-12-11,09:00:00,31,30,1,ECO_300019380
642,Herenthoutsesteenweg 2,2022-12-11,10:00:00,49,49,0,ECO_300019380
642,Herenthoutsesteenweg 2,2022-12-11,11:00:00,30,26,4,ECO_300019380
642,Herenthoutsesteenweg 2,2022-12-11,12:00:00,39,28,11,ECO_300019380
642,Herenthoutsesteenweg 2,2022-12-11,13:00:00,21,19,2,ECO_300019380
642,Herenthoutsesteenweg 2,2022-12-11,14:00:00,31,25,6,ECO_300019380
642,Herenthoutsesteenweg 2,2022-12-11,15:00:00,44,37,7,ECO_300019380
642,Herenthoutsesteenweg 2,2022-12-11,16:00:00,26,26,0,ECO_300019380
642,Herenthoutsesteenweg 2,2022-12-11,17:00:00,12,10,2,ECO_300019380
642,Herenthoutsesteenweg 2,2022-12-11,18:00:00,14,12,2,ECO_300019380
642,Herenthoutsesteenweg 2,2022-12-11,19:00:00,4,4,0,ECO_300019380
642,Herenthoutsesteenweg 2,2022-12-11,20:00:00,9,9,0,ECO_300019380
642,Herenthoutsesteenweg 2,2022-12-11,21:00:00,3,3,0,ECO_300019380
642,Herenthoutsesteenweg 2,2022-12-11,22:00:00,5,5,0,ECO_300019380
642,Herenthoutsesteenweg 2,2022-12-11,23:00:00,3,2,1,ECO_300019380
642,Herenthoutsesteenweg 2,2022-12-12,00:00:00,1,1,0,ECO_300019380
642,Herenthoutsesteenweg 2,2022-12-12,01:00:00,0,0,0,ECO_300019380
642,Herenthoutsesteenweg 2,2022-12-12,02:00:00,0,0,0,ECO_300019380
642,Herenthoutsesteenweg 2,2022-12-12,03:00:00,0,0,0,ECO_300019380
642,Herenthoutsesteenweg 2,2022-12-12,04:00:00,1,1,0,ECO_300019380
642,Herenthoutsesteenweg 2,2022-12-12,05:00:00,2,2,0,ECO_300019380
642,Herenthoutsesteenweg 2,2022-12-12,06:00:00,13,12,1,ECO_300019380
642,Herenthoutsesteenweg 2,2022-12-12,07:00:00,37,34,3,ECO_300019380
642,Herenthoutsesteenweg 2,2022-12-12,08:00:00,106,104,2,ECO_300019380
642,Herenthoutsesteenweg 2,2022-12-12,09:00:00,491,485,6,ECO_300019380
642,Herenthoutsesteenweg 2,2022-12-12,10:00:00,39,37,2,ECO_300019380
642,Herenthoutsesteenweg 2,2022-12-12,11:00:00,55,52,3,ECO_300019380
642,Herenthoutsesteenweg 2,2022-12-12,12:00:00,32,32,0,ECO_300019380
642,Herenthoutsesteenweg 2,2022-12-12,13:00:00,44,42,2,ECO_300019380
642,Herenthoutsesteenweg 2,2022-12-12,14:00:00,66,63,3,ECO_300019380
642,Herenthoutsesteenweg 2,2022-12-12,15:00:00,53,48,5,ECO_300019380
642,Herenthoutsesteenweg 2,2022-12-12,16:00:00,66,59,7,ECO_300019380
642,Herenthoutsesteenweg 2,2022-12-12,17:00:00,76,69,7,ECO_300019380
642,Herenthoutsesteenweg 2,2022-12-12,18:00:00,50,40,10,ECO_300019380
642,Herenthoutsesteenweg 2,2022-12-12,19:00:00,23,23,0,ECO_300019380
642,Herenthoutsesteenweg 2,2022-12-12,20:00:00,14,13,1,ECO_300019380
642,Herenthoutsesteenweg 2,2022-12-12,21:00:00,2,2,0,ECO_300019380
642,Herenthoutsesteenweg 2,2022-12-12,22:00:00,5,4,1,ECO_300019380
642,Herenthoutsesteenweg 2,2022-12-12,23:00:00,15,14,1,ECO_300019380
642,Herenthoutsesteenweg 2,2022-12-13,00:00:00,2,1,1,ECO_300019380
642,Herenthoutsesteenweg 2,2022-12-13,01:00:00,1,0,1,ECO_300019380
642,Herenthoutsesteenweg 2,2022-12-13,02:00:00,1,1,0,ECO_300019380
642,Herenthoutsesteenweg 2,2022-12-13,03:00:00,0,0,0,ECO_300019380
642,Herenthoutsesteenweg 2,2022-12-13,04:00:00,1,1,0,ECO_300019380
642,Herenthoutsesteenweg 2,2022-12-13,05:00:00,4,3,1,ECO_300019380
642,Herenthoutsesteenweg 2,2022-12-13,06:00:00,19,16,3,ECO_300019380
642,Herenthoutsesteenweg 2,2022-12-13,07:00:00,30,29,1,ECO_300019380
642,Herenthoutsesteenweg 2,2022-12-13,08:00:00,119,115,4,ECO_300019380
642,Herenthoutsesteenweg 2,2022-12-13,09:00:00,445,439,6,ECO_300019380
642,Herenthoutsesteenweg 2,2022-12-13,10:00:00,86,83,3,ECO_300019380
642,Herenthoutsesteenweg 2,2022-12-13,11:00:00,60,59,1,ECO_300019380
642,Herenthoutsesteenweg 2,2022-12-13,12:00:00,39,36,3,ECO_300019380
642,Herenthoutsesteenweg 2,2022-12-13,13:00:00,69,63,6,ECO_300019380
642,Herenthoutsesteenweg 2,2022-12-13,14:00:00,39,37,2,ECO_300019380
642,Herenthoutsesteenweg 2,2022-12-13,15:00:00,32,30,2,ECO_300019380
642,Herenthoutsesteenweg 2,2022-12-13,16:00:00,60,50,10,ECO_300019380
642,Herenthoutsesteenweg 2,2022-12-13,17:00:00,89,75,14,ECO_300019380
642,Herenthoutsesteenweg 2,2022-12-13,18:00:00,36,33,3,ECO_300019380
642,Herenthoutsesteenweg 2,2022-12-13,19:00:00,29,27,2,ECO_300019380
642,Herenthoutsesteenweg 2,2022-12-13,20:00:00,7,5,2,ECO_300019380
642,Herenthoutsesteenweg 2,2022-12-13,21:00:00,4,4,0,ECO_300019380
642,Herenthoutsesteenweg 2,2022-12-13,22:00:00,8,8,0,ECO_300019380
642,Herenthoutsesteenweg 2,2022-12-13,23:00:00,13,10,3,ECO_300019380
642,Herenthoutsesteenweg 2,2022-12-14,00:00:00,2,2,0,ECO_300019380
642,Herenthoutsesteenweg 2,2022-12-14,01:00:00,0,0,0,ECO_300019380
642,Herenthoutsesteenweg 2,2022-12-14,02:00:00,0,0,0,ECO_300019380
642,Herenthoutsesteenweg 2,2022-12-14,03:00:00,2,2,0,ECO_300019380
642,Herenthoutsesteenweg 2,2022-12-14,04:00:00,0,0,0,ECO_300019380
642,Herenthoutsesteenweg 2,2022-12-14,05:00:00,2,2,0,ECO_300019380
642,Herenthoutsesteenweg 2,2022-12-14,06:00:00,18,17,1,ECO_300019380
642,Herenthoutsesteenweg 2,2022-12-14,07:00:00,32,31,1,ECO_300019380
642,Herenthoutsesteenweg 2,2022-12-14,08:00:00,98,95,3,ECO_300019380
642,Herenthoutsesteenweg 2,2022-12-14,09:00:00,413,411,2,ECO_300019380
642,Herenthoutsesteenweg 2,2022-12-14,10:00:00,64,63,1,ECO_300019380
642,Herenthoutsesteenweg 2,2022-12-14,11:00:00,81,78,3,ECO_300019380
642,Herenthoutsesteenweg 2,2022-12-14,12:00:00,36,34,2,ECO_300019380
642,Herenthoutsesteenweg 2,2022-12-14,13:00:00,70,67,3,ECO_300019380
642,Herenthoutsesteenweg 2,2022-12-14,14:00:00,49,41,8,ECO_300019380
642,Herenthoutsesteenweg 2,2022-12-14,15:00:00,54,49,5,ECO_300019380
642,Herenthoutsesteenweg 2,2022-12-14,16:00:00,47,41,6,ECO_300019380
642,Herenthoutsesteenweg 2,2022-12-14,17:00:00,70,62,8,ECO_300019380
642,Herenthoutsesteenweg 2,2022-12-14,18:00:00,33,23,10,ECO_300019380
642,Herenthoutsesteenweg 2,2022-12-14,19:00:00,25,23,2,ECO_300019380
642,Herenthoutsesteenweg 2,2022-12-14,20:00:00,13,9,4,ECO_300019380
642,Herenthoutsesteenweg 2,2022-12-14,21:00:00,8,8,0,ECO_300019380
642,Herenthoutsesteenweg 2,2022-12-14,22:00:00,7,5,2,ECO_300019380
642,Herenthoutsesteenweg 2,2022-12-14,23:00:00,14,13,1,ECO_300019380
642,Herenthoutsesteenweg 2,2022-12-15,00:00:00,1,1,0,ECO_300019380
642,Herenthoutsesteenweg 2,2022-12-15,01:00:00,2,1,1,ECO_300019380
642,Herenthoutsesteenweg 2,2022-12-15,02:00:00,0,0,0,ECO_300019380
642,Herenthoutsesteenweg 2,2022-12-15,03:00:00,2,2,0,ECO_300019380
642,Herenthoutsesteenweg 2,2022-12-15,04:00:00,2,1,1,ECO_300019380
642,Herenthoutsesteenweg 2,2022-12-15,05:00:00,3,3,0,ECO_300019380
642,Herenthoutsesteenweg 2,2022-12-15,06:00:00,14,13,1,ECO_300019380
642,Herenthoutsesteenweg 2,2022-12-15,07:00:00,32,31,1,ECO_300019380
642,Herenthoutsesteenweg 2,2022-12-15,08:00:00,99,98,1,ECO_300019380
642,Herenthoutsesteenweg 2,2022-12-15,09:00:00,353,350,3,ECO_300019380
642,Herenthoutsesteenweg 2,2022-12-15,10:00:00,88,86,2,ECO_300019380
642,Herenthoutsesteenweg 2,2022-12-15,11:00:00,90,88,2,ECO_300019380
642,Herenthoutsesteenweg 2,2022-12-15,12:00:00,34,32,2,ECO_300019380
642,Herenthoutsesteenweg 2,2022-12-15,13:00:00,41,37,4,ECO_300019380
642,Herenthoutsesteenweg 2,2022-12-15,14:00:00,74,70,4,ECO_300019380
642,Herenthoutsesteenweg 2,2022-12-15,15:00:00,55,51,4,ECO_300019380
642,Herenthoutsesteenweg 2,2022-12-15,16:00:00,62,58,4,ECO_300019380
642,Herenthoutsesteenweg 2,2022-12-15,17:00:00,71,67,4,ECO_300019380
642,Herenthoutsesteenweg 2,2022-12-15,18:00:00,31,28,3,ECO_300019380
642,Herenthoutsesteenweg 2,2022-12-15,19:00:00,33,30,3,ECO_300019380
642,Herenthoutsesteenweg 2,2022-12-15,20:00:00,19,19,0,ECO_300019380
642,Herenthoutsesteenweg 2,2022-12-15,21:00:00,9,9,0,ECO_300019380
642,Herenthoutsesteenweg 2,2022-12-15,22:00:00,6,4,2,ECO_300019380
642,Herenthoutsesteenweg 2,2022-12-15,23:00:00,14,12,2,ECO_300019380
642,Herenthoutsesteenweg 2,2022-12-16,00:00:00,1,1,0,ECO_300019380
642,Herenthoutsesteenweg 2,2022-12-16,01:00:00,2,2,0,ECO_300019380
642,Herenthoutsesteenweg 2,2022-12-16,02:00:00,0,0,0,ECO_300019380
642,Herenthoutsesteenweg 2,2022-12-16,03:00:00,0,0,0,ECO_300019380
642,Herenthoutsesteenweg 2,2022-12-16,04:00:00,2,2,0,ECO_300019380
642,Herenthoutsesteenweg 2,2022-12-16,05:00:00,3,3,0,ECO_300019380
642,Herenthoutsesteenweg 2,2022-12-16,06:00:00,13,12,1,ECO_300019380
642,Herenthoutsesteenweg 2,2022-12-16,07:00:00,25,23,2,ECO_300019380
642,Herenthoutsesteenweg 2,2022-12-16,08:00:00,79,78,1,ECO_300019380
642,Herenthoutsesteenweg 2,2022-12-16,09:00:00,361,350,11,ECO_300019380
642,Herenthoutsesteenweg 2,2022-12-16,10:00:00,89,85,4,ECO_300019380
642,Herenthoutsesteenweg 2,2022-12-16,11:00:00,95,88,7,ECO_300019380
642,Herenthoutsesteenweg 2,2022-12-16,12:00:00,39,37,2,ECO_300019380
642,Herenthoutsesteenweg 2,2022-12-16,13:00:00,45,43,2,ECO_300019380
642,Herenthoutsesteenweg 2,2022-12-16,14:00:00,70,66,4,ECO_300019380
642,Herenthoutsesteenweg 2,2022-12-16,15:00:00,71,66,5,ECO_300019380
642,Herenthoutsesteenweg 2,2022-12-16,16:00:00,84,74,10,ECO_300019380
642,Herenthoutsesteenweg 2,2022-12-16,17:00:00,82,73,9,ECO_300019380
642,Herenthoutsesteenweg 2,2022-12-16,18:00:00,43,41,2,ECO_300019380
642,Herenthoutsesteenweg 2,2022-12-16,19:00:00,34,31,3,ECO_300019380
642,Herenthoutsesteenweg 2,2022-12-16,20:00:00,39,37,2,ECO_300019380
642,Herenthoutsesteenweg 2,2022-12-16,21:00:00,19,17,2,ECO_300019380
642,Herenthoutsesteenweg 2,2022-12-16,22:00:00,12,11,1,ECO_300019380
642,Herenthoutsesteenweg 2,2022-12-16,23:00:00,13,12,1,ECO_300019380
642,Herenthoutsesteenweg 2,2022-12-17,00:00:00,4,2,2,ECO_300019380
642,Herenthoutsesteenweg 2,2022-12-17,01:00:00,5,5,0,ECO_300019380
642,Herenthoutsesteenweg 2,2022-12-17,02:00:00,5,4,1,ECO_300019380
642,Herenthoutsesteenweg 2,2022-12-17,03:00:00,7,5,2,ECO_300019380
642,Herenthoutsesteenweg 2,2022-12-17,04:00:00,1,1,0,ECO_300019380
642,Herenthoutsesteenweg 2,2022-12-17,05:00:00,1,0,1,ECO_300019380
642,Herenthoutsesteenweg 2,2022-12-17,06:00:00,1,1,0,ECO_300019380
642,Herenthoutsesteenweg 2,2022-12-17,07:00:00,6,6,0,ECO_300019380
642,Herenthoutsesteenweg 2,2022-12-17,08:00:00,3,2,1,ECO_300019380
642,Herenthoutsesteenweg 2,2022-12-17,09:00:00,12,12,0,ECO_300019380
642,Herenthoutsesteenweg 2,2022-12-17,10:00:00,18,18,0,ECO_300019380
642,Herenthoutsesteenweg 2,2022-12-17,11:00:00,35,34,1,ECO_300019380
642,Herenthoutsesteenweg 2,2022-12-17,12:00:00,20,18,2,ECO_300019380
642,Herenthoutsesteenweg 2,2022-12-17,13:00:00,29,27,2,ECO_300019380
642,Herenthoutsesteenweg 2,2022-12-17,14:00:00,37,32,5,ECO_300019380
642,Herenthoutsesteenweg 2,2022-12-17,15:00:00,49,47,2,ECO_300019380
642,Herenthoutsesteenweg 2,2022-12-17,16:00:00,41,40,1,ECO_300019380
642,Herenthoutsesteenweg 2,2022-12-17,17:00:00,23,22,1,ECO_300019380
642,Herenthoutsesteenweg 2,2022-12-17,18:00:00,20,16,4,ECO_300019380
642,Herenthoutsesteenweg 2,2022-12-17,19:00:00,13,11,2,ECO_300019380
642,Herenthoutsesteenweg 2,2022-12-17,20:00:00,23,21,2,ECO_300019380
642,Herenthoutsesteenweg 2,2022-12-17,21:00:00,13,13,0,ECO_300019380
642,Herenthoutsesteenweg 2,2022-12-17,22:00:00,1,1,0,ECO_300019380
642,Herenthoutsesteenweg 2,2022-12-17,23:00:00,2,1,1,ECO_300019380
642,Herenthoutsesteenweg 2,2022-12-18,00:00:00,2,2,0,ECO_300019380
642,Herenthoutsesteenweg 2,2022-12-18,01:00:00,2,1,1,ECO_300019380
642,Herenthoutsesteenweg 2,2022-12-18,02:00:00,2,1,1,ECO_300019380
642,Herenthoutsesteenweg 2,2022-12-18,03:00:00,0,0,0,ECO_300019380
642,Herenthoutsesteenweg 2,2022-12-18,04:00:00,1,1,0,ECO_300019380
642,Herenthoutsesteenweg 2,2022-12-18,05:00:00,0,0,0,ECO_300019380
642,Herenthoutsesteenweg 2,2022-12-18,06:00:00,0,0,0,ECO_300019380
642,Herenthoutsesteenweg 2,2022-12-18,07:00:00,5,5,0,ECO_300019380
642,Herenthoutsesteenweg 2,2022-12-18,08:00:00,4,4,0,ECO_300019380
642,Herenthoutsesteenweg 2,2022-12-18,09:00:00,17,16,1,ECO_300019380
642,Herenthoutsesteenweg 2,2022-12-18,10:00:00,20,20,0,ECO_300019380
642,Herenthoutsesteenweg 2,2022-12-18,11:00:00,23,22,1,ECO_300019380
642,Herenthoutsesteenweg 2,2022-12-18,12:00:00,17,17,0,ECO_300019380
642,Herenthoutsesteenweg 2,2022-12-18,13:00:00,18,12,6,ECO_300019380
642,Herenthoutsesteenweg 2,2022-12-18,14:00:00,20,19,1,ECO_300019380
642,Herenthoutsesteenweg 2,2022-12-18,15:00:00,23,22,1,ECO_300019380
642,Herenthoutsesteenweg 2,2022-12-18,16:00:00,20,16,4,ECO_300019380
642,Herenthoutsesteenweg 2,2022-12-18,17:00:00,7,6,1,ECO_300019380
642,Herenthoutsesteenweg 2,2022-12-18,18:00:00,17,10,7,ECO_300019380
642,Herenthoutsesteenweg 2,2022-12-18,19:00:00,8,8,0,ECO_300019380
642,Herenthoutsesteenweg 2,2022-12-18,20:00:00,5,3,2,ECO_300019380
642,Herenthoutsesteenweg 2,2022-12-18,21:00:00,5,3,2,ECO_300019380
642,Herenthoutsesteenweg 2,2022-12-18,22:00:00,3,2,1,ECO_300019380
642,Herenthoutsesteenweg 2,2022-12-18,23:00:00,0,0,0,ECO_300019380
642,Herenthoutsesteenweg 2,2022-12-19,00:00:00,1,1,0,ECO_300019380
642,Herenthoutsesteenweg 2,2022-12-19,01:00:00,1,1,0,ECO_300019380
642,Herenthoutsesteenweg 2,2022-12-19,02:00:00,0,0,0,ECO_300019380
642,Herenthoutsesteenweg 2,2022-12-19,03:00:00,0,0,0,ECO_300019380
642,Herenthoutsesteenweg 2,2022-12-19,04:00:00,0,0,0,ECO_300019380
642,Herenthoutsesteenweg 2,2022-12-19,05:00:00,0,0,0,ECO_300019380
642,Herenthoutsesteenweg 2,2022-12-19,06:00:00,14,11,3,ECO_300019380
642,Herenthoutsesteenweg 2,2022-12-19,07:00:00,29,28,1,ECO_300019380
642,Herenthoutsesteenweg 2,2022-12-19,08:00:00,88,85,3,ECO_300019380
642,Herenthoutsesteenweg 2,2022-12-19,09:00:00,351,346,5,ECO_300019380
642,Herenthoutsesteenweg 2,2022-12-19,10:00:00,76,75,1,ECO_300019380
642,Herenthoutsesteenweg 2,2022-12-19,11:00:00,60,57,3,ECO_300019380
642,Herenthoutsesteenweg 2,2022-12-19,12:00:00,34,31,3,ECO_300019380
642,Herenthoutsesteenweg 2,2022-12-19,13:00:00,44,42,2,ECO_300019380
642,Herenthoutsesteenweg 2,2022-12-19,14:00:00,38,37,1,ECO_300019380
642,Herenthoutsesteenweg 2,2022-12-19,15:00:00,52,47,5,ECO_300019380
642,Herenthoutsesteenweg 2,2022-12-19,16:00:00,67,56,11,ECO_300019380
642,Herenthoutsesteenweg 2,2022-12-19,17:00:00,75,69,6,ECO_300019380
642,Herenthoutsesteenweg 2,2022-12-19,18:00:00,42,39,3,ECO_300019380
642,Herenthoutsesteenweg 2,2022-12-19,19:00:00,26,24,2,ECO_300019380
642,Herenthoutsesteenweg 2,2022-12-19,20:00:00,16,16,0,ECO_300019380
642,Herenthoutsesteenweg 2,2022-12-19,21:00:00,12,9,3,ECO_300019380
642,Herenthoutsesteenweg 2,2022-12-19,22:00:00,7,6,1,ECO_300019380
642,Herenthoutsesteenweg 2,2022-12-19,23:00:00,20,19,1,ECO_300019380
642,Herenthoutsesteenweg 2,2022-12-20,00:00:00,3,1,2,ECO_300019380
642,Herenthoutsesteenweg 2,2022-12-20,01:00:00,2,2,0,ECO_300019380
642,Herenthoutsesteenweg 2,2022-12-20,02:00:00,1,0,1,ECO_300019380
642,Herenthoutsesteenweg 2,2022-12-20,03:00:00,1,1,0,ECO_300019380
642,Herenthoutsesteenweg 2,2022-12-20,04:00:00,0,0,0,ECO_300019380
642,Herenthoutsesteenweg 2,2022-12-20,05:00:00,1,0,1,ECO_300019380
642,Herenthoutsesteenweg 2,2022-12-20,06:00:00,12,10,2,ECO_300019380
642,Herenthoutsesteenweg 2,2022-12-20,07:00:00,43,39,4,ECO_300019380
642,Herenthoutsesteenweg 2,2022-12-20,08:00:00,94,94,0,ECO_300019380
642,Herenthoutsesteenweg 2,2022-12-20,09:00:00,368,365,3,ECO_300019380
642,Herenthoutsesteenweg 2,2022-12-20,10:00:00,44,43,1,ECO_300019380
642,Herenthoutsesteenweg 2,2022-12-20,11:00:00,59,57,2,ECO_300019380
642,Herenthoutsesteenweg 2,2022-12-20,12:00:00,44,43,1,ECO_300019380
642,Herenthoutsesteenweg 2,2022-12-20,13:00:00,33,31,2,ECO_300019380
642,Herenthoutsesteenweg 2,2022-12-20,14:00:00,33,32,1,ECO_300019380
642,Herenthoutsesteenweg 2,2022-12-20,15:00:00,28,26,2,ECO_300019380
642,Herenthoutsesteenweg 2,2022-12-20,16:00:00,52,44,8,ECO_300019380
642,Herenthoutsesteenweg 2,2022-12-20,17:00:00,61,55,6,ECO_300019380
642,Herenthoutsesteenweg 2,2022-12-20,18:00:00,42,37,5,ECO_300019380
642,Herenthoutsesteenweg 2,2022-12-20,19:00:00,18,16,2,ECO_300019380
642,Herenthoutsesteenweg 2,2022-12-20,20:00:00,18,17,1,ECO_300019380
642,Herenthoutsesteenweg 2,2022-12-20,21:00:00,21,16,5,ECO_300019380
642,Herenthoutsesteenweg 2,2022-12-20,22:00:00,7,2,5,ECO_300019380
642,Herenthoutsesteenweg 2,2022-12-20,23:00:00,9,8,1,ECO_300019380
642,Herenthoutsesteenweg 2,2022-12-21,00:00:00,1,0,1,ECO_300019380
642,Herenthoutsesteenweg 2,2022-12-21,01:00:00,1,0,1,ECO_300019380
642,Herenthoutsesteenweg 2,2022-12-21,02:00:00,0,0,0,ECO_300019380
642,Herenthoutsesteenweg 2,2022-12-21,03:00:00,0,0,0,ECO_300019380
642,Herenthoutsesteenweg 2,2022-12-21,04:00:00,0,0,0,ECO_300019380
642,Herenthoutsesteenweg 2,2022-12-21,05:00:00,1,1,0,ECO_300019380
642,Herenthoutsesteenweg 2,2022-12-21,06:00:00,13,12,1,ECO_300019380
642,Herenthoutsesteenweg 2,2022-12-21,07:00:00,31,28,3,ECO_300019380
642,Herenthoutsesteenweg 2,2022-12-21,08:00:00,66,66,0,ECO_300019380
642,Herenthoutsesteenweg 2,2022-12-21,09:00:00,84,79,5,ECO_300019380
642,Herenthoutsesteenweg 2,2022-12-21,10:00:00,66,66,0,ECO_300019380
642,Herenthoutsesteenweg 2,2022-12-21,11:00:00,59,54,5,ECO_300019380
642,Herenthoutsesteenweg 2,2022-12-21,12:00:00,69,67,2,ECO_300019380
642,Herenthoutsesteenweg 2,2022-12-21,13:00:00,84,83,1,ECO_300019380
642,Herenthoutsesteenweg 2,2022-12-21,14:00:00,78,73,5,ECO_300019380
642,Herenthoutsesteenweg 2,2022-12-21,15:00:00,81,78,3,ECO_300019380
642,Herenthoutsesteenweg 2,2022-12-21,16:00:00,65,57,8,ECO_300019380
642,Herenthoutsesteenweg 2,2022-12-21,17:00:00,88,84,4,ECO_300019380
642,Herenthoutsesteenweg 2,2022-12-21,18:00:00,39,33,6,ECO_300019380
642,Herenthoutsesteenweg 2,2022-12-21,19:00:00,25,24,1,ECO_300019380
642,Herenthoutsesteenweg 2,2022-12-21,20:00:00,17,14,3,ECO_300019380
642,Herenthoutsesteenweg 2,2022-12-21,21:00:00,9,6,3,ECO_300019380
642,Herenthoutsesteenweg 2,2022-12-21,22:00:00,14,11,3,ECO_300019380
642,Herenthoutsesteenweg 2,2022-12-21,23:00:00,14,12,2,ECO_300019380
642,Herenthoutsesteenweg 2,2022-12-22,00:00:00,7,5,2,ECO_300019380
642,Herenthoutsesteenweg 2,2022-12-22,01:00:00,0,0,0,ECO_300019380
642,Herenthoutsesteenweg 2,2022-12-22,02:00:00,1,1,0,ECO_300019380
642,Herenthoutsesteenweg 2,2022-12-22,03:00:00,1,1,0,ECO_300019380
642,Herenthoutsesteenweg 2,2022-12-22,04:00:00,0,0,0,ECO_300019380
642,Herenthoutsesteenweg 2,2022-12-22,05:00:00,1,1,0,ECO_300019380
642,Herenthoutsesteenweg 2,2022-12-22,06:00:00,12,12,0,ECO_300019380
642,Herenthoutsesteenweg 2,2022-12-22,07:00:00,22,21,1,ECO_300019380
642,Herenthoutsesteenweg 2,2022-12-22,08:00:00,55,55,0,ECO_300019380
642,Herenthoutsesteenweg 2,2022-12-22,09:00:00,74,73,1,ECO_300019380
642,Herenthoutsesteenweg 2,2022-12-22,10:00:00,61,59,2,ECO_300019380
642,Herenthoutsesteenweg 2,2022-12-22,11:00:00,47,47,0,ECO_300019380
642,Herenthoutsesteenweg 2,2022-12-22,12:00:00,101,97,4,ECO_300019380
642,Herenthoutsesteenweg 2,2022-12-22,13:00:00,54,50,4,ECO_300019380
642,Herenthoutsesteenweg 2,2022-12-22,14:00:00,68,66,2,ECO_300019380
642,Herenthoutsesteenweg 2,2022-12-22,15:00:00,66,60,6,ECO_300019380
642,Herenthoutsesteenweg 2,2022-12-22,16:00:00,50,47,3,ECO_300019380
642,Herenthoutsesteenweg 2,2022-12-22,17:00:00,85,81,4,ECO_300019380
642,Herenthoutsesteenweg 2,2022-12-22,18:00:00,44,41,3,ECO_300019380
642,Herenthoutsesteenweg 2,2022-12-22,19:00:00,35,30,5,ECO_300019380
642,Herenthoutsesteenweg 2,2022-12-22,20:00:00,18,18,0,ECO_300019380
642,Herenthoutsesteenweg 2,2022-12-22,21:00:00,13,12,1,ECO_300019380
642,Herenthoutsesteenweg 2,2022-12-22,22:00:00,9,8,1,ECO_300019380
642,Herenthoutsesteenweg 2,2022-12-22,23:00:00,13,12,1,ECO_300019380
642,Herenthoutsesteenweg 2,2022-12-23,00:00:00,5,4,1,ECO_300019380
642,Herenthoutsesteenweg 2,2022-12-23,01:00:00,4,1,3,ECO_300019380
642,Herenthoutsesteenweg 2,2022-12-23,02:00:00,0,0,0,ECO_300019380
642,Herenthoutsesteenweg 2,2022-12-23,03:00:00,0,0,0,ECO_300019380
642,Herenthoutsesteenweg 2,2022-12-23,04:00:00,0,0,0,ECO_300019380
642,Herenthoutsesteenweg 2,2022-12-23,05:00:00,1,1,0,ECO_300019380
642,Herenthoutsesteenweg 2,2022-12-23,06:00:00,7,7,0,ECO_300019380
642,Herenthoutsesteenweg 2,2022-12-23,07:00:00,22,20,2,ECO_300019380
642,Herenthoutsesteenweg 2,2022-12-23,08:00:00,49,48,1,ECO_300019380
642,Herenthoutsesteenweg 2,2022-12-23,09:00:00,91,90,1,ECO_300019380
642,Herenthoutsesteenweg 2,2022-12-23,10:00:00,75,74,1,ECO_300019380
642,Herenthoutsesteenweg 2,2022-12-23,11:00:00,53,50,3,ECO_300019380
642,Herenthoutsesteenweg 2,2022-12-23,12:00:00,25,24,1,ECO_300019380
642,Herenthoutsesteenweg 2,2022-12-23,13:00:00,19,16,3,ECO_300019380
642,Herenthoutsesteenweg 2,2022-12-23,14:00:00,15,13,2,ECO_300019380
642,Herenthoutsesteenweg 2,2022-12-23,15:00:00,39,38,1,ECO_300019380
642,Herenthoutsesteenweg 2,2022-12-23,16:00:00,54,52,2,ECO_300019380
642,Herenthoutsesteenweg 2,2022-12-23,17:00:00,60,59,1,ECO_300019380
642,Herenthoutsesteenweg 2,2022-12-23,18:00:00,29,27,2,ECO_300019380
642,Herenthoutsesteenweg 2,2022-12-23,19:00:00,30,26,4,ECO_300019380
642,Herenthoutsesteenweg 2,2022-12-23,20:00:00,30,28,2,ECO_300019380
642,Herenthoutsesteenweg 2,2022-12-23,21:00:00,16,13,3,ECO_300019380
642,Herenthoutsesteenweg 2,2022-12-23,22:00:00,11,9,2,ECO_300019380
642,Herenthoutsesteenweg 2,2022-12-23,23:00:00,5,4,1,ECO_300019380
642,Herenthoutsesteenweg 2,2022-12-24,00:00:00,10,5,5,ECO_300019380
642,Herenthoutsesteenweg 2,2022-12-24,01:00:00,6,3,3,ECO_300019380
642,Herenthoutsesteenweg 2,2022-12-24,02:00:00,3,3,0,ECO_300019380
642,Herenthoutsesteenweg 2,2022-12-24,03:00:00,4,4,0,ECO_300019380
642,Herenthoutsesteenweg 2,2022-12-24,04:00:00,0,0,0,ECO_300019380
642,Herenthoutsesteenweg 2,2022-12-24,05:00:00,0,0,0,ECO_300019380
642,Herenthoutsesteenweg 2,2022-12-24,06:00:00,2,2,0,ECO_300019380
642,Herenthoutsesteenweg 2,2022-12-24,07:00:00,4,4,0,ECO_300019380
642,Herenthoutsesteenweg 2,2022-12-24,08:00:00,2,2,0,ECO_300019380
642,Herenthoutsesteenweg 2,2022-12-24,09:00:00,26,25,1,ECO_300019380
642,Herenthoutsesteenweg 2,2022-12-24,10:00:00,52,48,4,ECO_300019380
642,Herenthoutsesteenweg 2,2022-12-24,11:00:00,61,57,4,ECO_300019380
642,Herenthoutsesteenweg 2,2022-12-24,12:00:00,56,51,5,ECO_300019380
642,Herenthoutsesteenweg 2,2022-12-24,13:00:00,77,62,15,ECO_300019380
642,Herenthoutsesteenweg 2,2022-12-24,14:00:00,57,46,11,ECO_300019380
642,Herenthoutsesteenweg 2,2022-12-24,15:00:00,60,55,5,ECO_300019380
642,Herenthoutsesteenweg 2,2022-12-24,16:00:00,29,22,7,ECO_300019380
642,Herenthoutsesteenweg 2,2022-12-24,17:00:00,28,25,3,ECO_300019380
642,Herenthoutsesteenweg 2,2022-12-24,18:00:00,19,17,2,ECO_300019380
642,Herenthoutsesteenweg 2,2022-12-24,19:00:00,7,6,1,ECO_300019380
642,Herenthoutsesteenweg 2,2022-12-24,20:00:00,4,3,1,ECO_300019380
642,Herenthoutsesteenweg 2,2022-12-24,21:00:00,2,2,0,ECO_300019380
642,Herenthoutsesteenweg 2,2022-12-24,22:00:00,10,8,2,ECO_300019380
642,Herenthoutsesteenweg 2,2022-12-24,23:00:00,10,10,0,ECO_300019380
642,Herenthoutsesteenweg 2,2022-12-25,00:00:00,8,8,0,ECO_300019380
642,Herenthoutsesteenweg 2,2022-12-25,01:00:00,2,2,0,ECO_300019380
642,Herenthoutsesteenweg 2,2022-12-25,02:00:00,3,2,1,ECO_300019380
642,Herenthoutsesteenweg 2,2022-12-25,03:00:00,2,0,2,ECO_300019380
642,Herenthoutsesteenweg 2,2022-12-25,04:00:00,0,0,0,ECO_300019380
642,Herenthoutsesteenweg 2,2022-12-25,05:00:00,2,2,0,ECO_300019380
642,Herenthoutsesteenweg 2,2022-12-25,06:00:00,0,0,0,ECO_300019380
642,Herenthoutsesteenweg 2,2022-12-25,07:00:00,4,3,1,ECO_300019380
642,Herenthoutsesteenweg 2,2022-12-25,08:00:00,3,2,1,ECO_300019380
642,Herenthoutsesteenweg 2,2022-12-25,09:00:00,6,6,0,ECO_300019380
642,Herenthoutsesteenweg 2,2022-12-25,10:00:00,10,10,0,ECO_300019380
642,Herenthoutsesteenweg 2,2022-12-25,11:00:00,18,17,1,ECO_300019380
642,Herenthoutsesteenweg 2,2022-12-25,12:00:00,4,4,0,ECO_300019380
642,Herenthoutsesteenweg 2,2022-12-25,13:00:00,4,3,1,ECO_300019380
642,Herenthoutsesteenweg 2,2022-12-25,14:00:00,10,9,1,ECO_300019380
642,Herenthoutsesteenweg 2,2022-12-25,15:00:00,7,7,0,ECO_300019380
642,Herenthoutsesteenweg 2,2022-12-25,16:00:00,3,3,0,ECO_300019380
642,Herenthoutsesteenweg 2,2022-12-25,17:00:00,7,6,1,ECO_300019380
642,Herenthoutsesteenweg 2,2022-12-25,18:00:00,5,5,0,ECO_300019380
642,Herenthoutsesteenweg 2,2022-12-25,19:00:00,4,3,1,ECO_300019380
642,Herenthoutsesteenweg 2,2022-12-25,20:00:00,1,1,0,ECO_300019380
642,Herenthoutsesteenweg 2,2022-12-25,21:00:00,3,1,2,ECO_300019380
642,Herenthoutsesteenweg 2,2022-12-25,22:00:00,1,1,0,ECO_300019380
642,Herenthoutsesteenweg 2,2022-12-25,23:00:00,1,1,0,ECO_300019380
642,Herenthoutsesteenweg 2,2022-12-26,00:00:00,0,0,0,ECO_300019380
642,Herenthoutsesteenweg 2,2022-12-26,01:00:00,0,0,0,ECO_300019380
642,Herenthoutsesteenweg 2,2022-12-26,02:00:00,3,3,0,ECO_300019380
642,Herenthoutsesteenweg 2,2022-12-26,03:00:00,0,0,0,ECO_300019380
642,Herenthoutsesteenweg 2,2022-12-26,04:00:00,0,0,0,ECO_300019380
642,Herenthoutsesteenweg 2,2022-12-26,05:00:00,1,1,0,ECO_300019380
642,Herenthoutsesteenweg 2,2022-12-26,06:00:00,4,4,0,ECO_300019380
642,Herenthoutsesteenweg 2,2022-12-26,07:00:00,6,6,0,ECO_300019380
642,Herenthoutsesteenweg 2,2022-12-26,08:00:00,17,16,1,ECO_300019380
642,Herenthoutsesteenweg 2,2022-12-26,09:00:00,13,12,1,ECO_300019380
642,Herenthoutsesteenweg 2,2022-12-26,10:00:00,32,29,3,ECO_300019380
642,Herenthoutsesteenweg 2,2022-12-26,11:00:00,33,31,2,ECO_300019380
642,Herenthoutsesteenweg 2,2022-12-26,12:00:00,20,18,2,ECO_300019380
642,Herenthoutsesteenweg 2,2022-12-26,13:00:00,33,30,3,ECO_300019380
642,Herenthoutsesteenweg 2,2022-12-26,14:00:00,53,49,4,ECO_300019380
642,Herenthoutsesteenweg 2,2022-12-26,15:00:00,49,41,8,ECO_300019380
642,Herenthoutsesteenweg 2,2022-12-26,16:00:00,56,51,5,ECO_300019380
642,Herenthoutsesteenweg 2,2022-12-26,17:00:00,37,34,3,ECO_300019380
642,Herenthoutsesteenweg 2,2022-12-26,18:00:00,30,27,3,ECO_300019380
642,Herenthoutsesteenweg 2,2022-12-26,19:00:00,27,25,2,ECO_300019380
642,Herenthoutsesteenweg 2,2022-12-26,20:00:00,11,11,0,ECO_300019380
642,Herenthoutsesteenweg 2,2022-12-26,21:00:00,8,7,1,ECO_300019380
642,Herenthoutsesteenweg 2,2022-12-26,22:00:00,5,3,2,ECO_300019380
642,Herenthoutsesteenweg 2,2022-12-26,23:00:00,6,4,2,ECO_300019380
642,Herenthoutsesteenweg 2,2022-12-27,00:00:00,2,0,2,ECO_300019380
642,Herenthoutsesteenweg 2,2022-12-27,01:00:00,1,1,0,ECO_300019380
642,Herenthoutsesteenweg 2,2022-12-27,02:00:00,2,0,2,ECO_300019380
642,Herenthoutsesteenweg 2,2022-12-27,03:00:00,2,2,0,ECO_300019380
642,Herenthoutsesteenweg 2,2022-12-27,04:00:00,0,0,0,ECO_300019380
642,Herenthoutsesteenweg 2,2022-12-27,05:00:00,2,2,0,ECO_300019380
642,Herenthoutsesteenweg 2,2022-12-27,06:00:00,4,4,0,ECO_300019380
642,Herenthoutsesteenweg 2,2022-12-27,07:00:00,13,13,0,ECO_300019380
642,Herenthoutsesteenweg 2,2022-12-27,08:00:00,34,32,2,ECO_300019380
642,Herenthoutsesteenweg 2,2022-12-27,09:00:00,24,22,2,ECO_300019380
642,Herenthoutsesteenweg 2,2022-12-27,10:00:00,53,50,3,ECO_300019380
642,Herenthoutsesteenweg 2,2022-12-27,11:00:00,46,42,4,ECO_300019380
642,Herenthoutsesteenweg 2,2022-12-27,12:00:00,56,46,10,ECO_300019380
642,Herenthoutsesteenweg 2,2022-12-27,13:00:00,65,56,9,ECO_300019380
642,Herenthoutsesteenweg 2,2022-12-27,14:00:00,87,81,6,ECO_300019380
642,Herenthoutsesteenweg 2,2022-12-27,15:00:00,58,55,3,ECO_300019380
642,Herenthoutsesteenweg 2,2022-12-27,16:00:00,50,40,10,ECO_300019380
642,Herenthoutsesteenweg 2,2022-12-27,17:00:00,44,40,4,ECO_300019380
642,Herenthoutsesteenweg 2,2022-12-27,18:00:00,42,36,6,ECO_300019380
642,Herenthoutsesteenweg 2,2022-12-27,19:00:00,26,22,4,ECO_300019380
642,Herenthoutsesteenweg 2,2022-12-27,20:00:00,11,11,0,ECO_300019380
642,Herenthoutsesteenweg 2,2022-12-27,21:00:00,18,16,2,ECO_300019380
642,Herenthoutsesteenweg 2,2022-12-27,22:00:00,5,4,1,ECO_300019380
642,Herenthoutsesteenweg 2,2022-12-27,23:00:00,8,7,1,ECO_300019380
642,Herenthoutsesteenweg 2,2022-12-28,00:00:00,7,6,1,ECO_300019380
642,Herenthoutsesteenweg 2,2022-12-28,01:00:00,3,3,0,ECO_300019380
642,Herenthoutsesteenweg 2,2022-12-28,02:00:00,0,0,0,ECO_300019380
642,Herenthoutsesteenweg 2,2022-12-28,03:00:00,1,1,0,ECO_300019380
642,Herenthoutsesteenweg 2,2022-12-28,04:00:00,3,3,0,ECO_300019380
642,Herenthoutsesteenweg 2,2022-12-28,05:00:00,1,1,0,ECO_300019380
642,Herenthoutsesteenweg 2,2022-12-28,06:00:00,1,0,1,ECO_300019380
642,Herenthoutsesteenweg 2,2022-12-28,07:00:00,5,5,0,ECO_300019380
642,Herenthoutsesteenweg 2,2022-12-28,08:00:00,21,19,2,ECO_300019380
642,Herenthoutsesteenweg 2,2022-12-28,09:00:00,18,18,0,ECO_300019380
642,Herenthoutsesteenweg 2,2022-12-28,10:00:00,35,33,2,ECO_300019380
642,Herenthoutsesteenweg 2,2022-12-28,11:00:00,29,28,1,ECO_300019380
642,Herenthoutsesteenweg 2,2022-12-28,12:00:00,29,29,0,ECO_300019380
642,Herenthoutsesteenweg 2,2022-12-28,13:00:00,60,57,3,ECO_300019380
642,Herenthoutsesteenweg 2,2022-12-28,14:00:00,69,63,6,ECO_300019380
642,Herenthoutsesteenweg 2,2022-12-28,15:00:00,42,35,7,ECO_300019380
642,Herenthoutsesteenweg 2,2022-12-28,16:00:00,38,32,6,ECO_300019380
642,Herenthoutsesteenweg 2,2022-12-28,17:00:00,37,31,6,ECO_300019380
642,Herenthoutsesteenweg 2,2022-12-28,18:00:00,17,16,1,ECO_300019380
642,Herenthoutsesteenweg 2,2022-12-28,19:00:00,15,15,0,ECO_300019380
642,Herenthoutsesteenweg 2,2022-12-28,20:00:00,19,19,0,ECO_300019380
642,Herenthoutsesteenweg 2,2022-12-28,21:00:00,5,5,0,ECO_300019380
642,Herenthoutsesteenweg 2,2022-12-28,22:00:00,6,5,1,ECO_300019380
642,Herenthoutsesteenweg 2,2022-12-28,23:00:00,12,12,0,ECO_300019380
642,Herenthoutsesteenweg 2,2022-12-29,00:00:00,3,2,1,ECO_300019380
642,Herenthoutsesteenweg 2,2022-12-29,01:00:00,3,3,0,ECO_300019380
642,Herenthoutsesteenweg 2,2022-12-29,02:00:00,3,2,1,ECO_300019380
642,Herenthoutsesteenweg 2,2022-12-29,03:00:00,1,1,0,ECO_300019380
642,Herenthoutsesteenweg 2,2022-12-29,04:00:00,1,1,0,ECO_300019380
642,Herenthoutsesteenweg 2,2022-12-29,05:00:00,0,0,0,ECO_300019380
642,Herenthoutsesteenweg 2,2022-12-29,06:00:00,2,2,0,ECO_300019380
642,Herenthoutsesteenweg 2,2022-12-29,07:00:00,12,12,0,ECO_300019380
642,Herenthoutsesteenweg 2,2022-12-29,08:00:00,24,23,1,ECO_300019380
642,Herenthoutsesteenweg 2,2022-12-29,09:00:00,10,10,0,ECO_300019380
642,Herenthoutsesteenweg 2,2022-12-29,10:00:00,40,38,2,ECO_300019380
642,Herenthoutsesteenweg 2,2022-12-29,11:00:00,32,31,1,ECO_300019380
642,Herenthoutsesteenweg 2,2022-12-29,12:00:00,22,22,0,ECO_300019380
642,Herenthoutsesteenweg 2,2022-12-29,13:00:00,27,23,4,ECO_300019380
642,Herenthoutsesteenweg 2,2022-12-29,14:00:00,35,32,3,ECO_300019380
642,Herenthoutsesteenweg 2,2022-12-29,15:00:00,37,34,3,ECO_300019380
642,Herenthoutsesteenweg 2,2022-12-29,16:00:00,25,23,2,ECO_300019380
642,Herenthoutsesteenweg 2,2022-12-29,17:00:00,40,34,6,ECO_300019380
642,Herenthoutsesteenweg 2,2022-12-29,18:00:00,22,21,1,ECO_300019380
642,Herenthoutsesteenweg 2,2022-12-29,19:00:00,32,28,4,ECO_300019380
642,Herenthoutsesteenweg 2,2022-12-29,20:00:00,29,27,2,ECO_300019380
642,Herenthoutsesteenweg 2,2022-12-29,21:00:00,14,13,1,ECO_300019380
642,Herenthoutsesteenweg 2,2022-12-29,22:00:00,8,7,1,ECO_300019380
642,Herenthoutsesteenweg 2,2022-12-29,23:00:00,9,6,3,ECO_300019380
642,Herenthoutsesteenweg 2,2022-12-30,00:00:00,4,3,1,ECO_300019380
642,Herenthoutsesteenweg 2,2022-12-30,01:00:00,2,0,2,ECO_300019380
642,Herenthoutsesteenweg 2,2022-12-30,02:00:00,1,0,1,ECO_300019380
642,Herenthoutsesteenweg 2,2022-12-30,03:00:00,1,0,1,ECO_300019380
642,Herenthoutsesteenweg 2,2022-12-30,04:00:00,1,0,1,ECO_300019380
642,Herenthoutsesteenweg 2,2022-12-30,05:00:00,0,0,0,ECO_300019380
642,Herenthoutsesteenweg 2,2022-12-30,06:00:00,7,7,0,ECO_300019380
642,Herenthoutsesteenweg 2,2022-12-30,07:00:00,8,7,1,ECO_300019380
642,Herenthoutsesteenweg 2,2022-12-30,08:00:00,27,24,3,ECO_300019380
642,Herenthoutsesteenweg 2,2022-12-30,09:00:00,29,27,2,ECO_300019380
642,Herenthoutsesteenweg 2,2022-12-30,10:00:00,75,68,7,ECO_300019380
642,Herenthoutsesteenweg 2,2022-12-30,11:00:00,70,67,3,ECO_300019380
642,Herenthoutsesteenweg 2,2022-12-30,12:00:00,59,53,6,ECO_300019380
642,Herenthoutsesteenweg 2,2022-12-30,13:00:00,30,27,3,ECO_300019380
642,Herenthoutsesteenweg 2,2022-12-30,14:00:00,19,17,2,ECO_300019380
642,Herenthoutsesteenweg 2,2022-12-30,15:00:00,18,17,1,ECO_300019380
642,Herenthoutsesteenweg 2,2022-12-30,16:00:00,23,19,4,ECO_300019380
642,Herenthoutsesteenweg 2,2022-12-30,17:00:00,30,27,3,ECO_300019380
642,Herenthoutsesteenweg 2,2022-12-30,18:00:00,29,26,3,ECO_300019380
642,Herenthoutsesteenweg 2,2022-12-30,19:00:00,9,9,0,ECO_300019380
642,Herenthoutsesteenweg 2,2022-12-30,20:00:00,19,18,1,ECO_300019380
642,Herenthoutsesteenweg 2,2022-12-30,21:00:00,17,16,1,ECO_300019380
642,Herenthoutsesteenweg 2,2022-12-30,22:00:00,8,8,0,ECO_300019380
642,Herenthoutsesteenweg 2,2022-12-30,23:00:00,4,2,2,ECO_300019380
642,Herenthoutsesteenweg 2,2022-12-31,00:00:00,6,4,2,ECO_300019380
642,Herenthoutsesteenweg 2,2022-12-31,01:00:00,7,7,0,ECO_300019380
642,Herenthoutsesteenweg 2,2022-12-31,02:00:00,2,0,2,ECO_300019380
642,Herenthoutsesteenweg 2,2022-12-31,03:00:00,0,0,0,ECO_300019380
642,Herenthoutsesteenweg 2,2022-12-31,04:00:00,1,0,1,ECO_300019380
642,Herenthoutsesteenweg 2,2022-12-31,05:00:00,2,1,1,ECO_300019380
642,Herenthoutsesteenweg 2,2022-12-31,06:00:00,2,2,0,ECO_300019380
642,Herenthoutsesteenweg 2,2022-12-31,07:00:00,5,5,0,ECO_300019380
642,Herenthoutsesteenweg 2,2022-12-31,08:00:00,1,1,0,ECO_300019380
642,Herenthoutsesteenweg 2,2022-12-31,09:00:00,15,15,0,ECO_300019380
642,Herenthoutsesteenweg 2,2022-12-31,10:00:00,27,27,0,ECO_300019380
642,Herenthoutsesteenweg 2,2022-12-31,11:00:00,44,38,6,ECO_300019380
642,Herenthoutsesteenweg 2,2022-12-31,12:00:00,35,29,6,ECO_300019380
642,Herenthoutsesteenweg 2,2022-12-31,13:00:00,33,28,5,ECO_300019380
642,Herenthoutsesteenweg 2,2022-12-31,14:00:00,48,47,1,ECO_300019380
642,Herenthoutsesteenweg 2,2022-12-31,15:00:00,38,31,7,ECO_300019380
642,Herenthoutsesteenweg 2,2022-12-31,16:00:00,32,30,2,ECO_300019380
642,Herenthoutsesteenweg 2,2022-12-31,17:00:00,33,31,2,ECO_300019380
642,Herenthoutsesteenweg 2,2022-12-31,18:00:00,26,26,0,ECO_300019380
642,Herenthoutsesteenweg 2,2022-12-31,19:00:00,28,27,1,ECO_300019380
642,Herenthoutsesteenweg 2,2022-12-31,20:00:00,21,20,1,ECO_300019380
642,Herenthoutsesteenweg 2,2022-12-31,21:00:00,5,5,0,ECO_300019380
642,Herenthoutsesteenweg 2,2022-12-31,22:00:00,28,26,2,ECO_300019380
642,Herenthoutsesteenweg 2,2022-12-31,23:00:00,31,24,7,ECO_300019380
642,Herenthoutsesteenweg 2,2023-01-01,00:00:00,12,11,1,ECO_300019380
642,Herenthoutsesteenweg 2,2023-01-01,01:00:00,15,15,0,ECO_300019380
642,Herenthoutsesteenweg 2,2023-01-01,02:00:00,31,28,3,ECO_300019380
642,Herenthoutsesteenweg 2,2023-01-01,03:00:00,16,14,2,ECO_300019380
642,Herenthoutsesteenweg 2,2023-01-01,04:00:00,24,18,6,ECO_300019380
642,Herenthoutsesteenweg 2,2023-01-01,05:00:00,16,15,1,ECO_300019380
642,Herenthoutsesteenweg 2,2023-01-01,06:00:00,5,3,2,ECO_300019380
642,Herenthoutsesteenweg 2,2023-01-01,07:00:00,5,5,0,ECO_300019380
642,Herenthoutsesteenweg 2,2023-01-01,08:00:00,5,5,0,ECO_300019380
642,Herenthoutsesteenweg 2,2023-01-01,09:00:00,5,4,1,ECO_300019380
642,Herenthoutsesteenweg 2,2023-01-01,10:00:00,17,16,1,ECO_300019380
642,Herenthoutsesteenweg 2,2023-01-01,11:00:00,31,30,1,ECO_300019380
642,Herenthoutsesteenweg 2,2023-01-01,12:00:00,34,28,6,ECO_300019380
642,Herenthoutsesteenweg 2,2023-01-01,13:00:00,24,21,3,ECO_300019380
642,Herenthoutsesteenweg 2,2023-01-01,14:00:00,24,24,0,ECO_300019380
642,Herenthoutsesteenweg 2,2023-01-01,15:00:00,38,33,5,ECO_300019380
642,Herenthoutsesteenweg 2,2023-01-01,16:00:00,21,17,4,ECO_300019380
642,Herenthoutsesteenweg 2,2023-01-01,17:00:00,31,27,4,ECO_300019380
642,Herenthoutsesteenweg 2,2023-01-01,18:00:00,22,21,1,ECO_300019380
642,Herenthoutsesteenweg 2,2023-01-01,19:00:00,9,8,1,ECO_300019380
642,Herenthoutsesteenweg 2,2023-01-01,20:00:00,11,10,1,ECO_300019380
642,Herenthoutsesteenweg 2,2023-01-01,21:00:00,7,5,2,ECO_300019380
642,Herenthoutsesteenweg 2,2023-01-01,22:00:00,2,2,0,ECO_300019380
642,Herenthoutsesteenweg 2,2023-01-01,23:00:00,1,0,1,ECO_300019380
642,Herenthoutsesteenweg 2,2023-01-02,00:00:00,0,0,0,ECO_300019380
642,Herenthoutsesteenweg 2,2023-01-02,01:00:00,0,0,0,ECO_300019380
642,Herenthoutsesteenweg 2,2023-01-02,02:00:00,1,0,1,ECO_300019380
642,Herenthoutsesteenweg 2,2023-01-02,03:00:00,0,0,0,ECO_300019380
642,Herenthoutsesteenweg 2,2023-01-02,04:00:00,0,0,0,ECO_300019380
642,Herenthoutsesteenweg 2,2023-01-02,05:00:00,1,1,0,ECO_300019380
642,Herenthoutsesteenweg 2,2023-01-02,06:00:00,6,6,0,ECO_300019380
642,Herenthoutsesteenweg 2,2023-01-02,07:00:00,14,14,0,ECO_300019380
642,Herenthoutsesteenweg 2,2023-01-02,08:00:00,21,19,2,ECO_300019380
642,Herenthoutsesteenweg 2,2023-01-02,09:00:00,25,24,1,ECO_300019380
642,Herenthoutsesteenweg 2,2023-01-02,10:00:00,24,23,1,ECO_300019380
642,Herenthoutsesteenweg 2,2023-01-02,11:00:00,36,34,2,ECO_300019380
642,Herenthoutsesteenweg 2,2023-01-02,12:00:00,40,31,9,ECO_300019380
642,Herenthoutsesteenweg 2,2023-01-02,13:00:00,26,20,6,ECO_300019380
642,Herenthoutsesteenweg 2,2023-01-02,14:00:00,62,58,4,ECO_300019380
642,Herenthoutsesteenweg 2,2023-01-02,15:00:00,67,61,6,ECO_300019380
642,Herenthoutsesteenweg 2,2023-01-02,16:00:00,25,24,1,ECO_300019380
642,Herenthoutsesteenweg 2,2023-01-02,17:00:00,49,45,4,ECO_300019380
642,Herenthoutsesteenweg 2,2023-01-02,18:00:00,37,32,5,ECO_300019380
642,Herenthoutsesteenweg 2,2023-01-02,19:00:00,24,21,3,ECO_300019380
642,Herenthoutsesteenweg 2,2023-01-02,20:00:00,19,16,3,ECO_300019380
642,Herenthoutsesteenweg 2,2023-01-02,21:00:00,10,10,0,ECO_300019380
642,Herenthoutsesteenweg 2,2023-01-02,22:00:00,12,11,1,ECO_300019380
642,Herenthoutsesteenweg 2,2023-01-02,23:00:00,7,5,2,ECO_300019380
642,Herenthoutsesteenweg 2,2023-01-03,00:00:00,2,1,1,ECO_300019380
642,Herenthoutsesteenweg 2,2023-01-03,01:00:00,2,1,1,ECO_300019380
642,Herenthoutsesteenweg 2,2023-01-03,02:00:00,1,0,1,ECO_300019380
642,Herenthoutsesteenweg 2,2023-01-03,03:00:00,0,0,0,ECO_300019380
642,Herenthoutsesteenweg 2,2023-01-03,04:00:00,0,0,0,ECO_300019380
642,Herenthoutsesteenweg 2,2023-01-03,05:00:00,2,2,0,ECO_300019380
642,Herenthoutsesteenweg 2,2023-01-03,06:00:00,12,12,0,ECO_300019380
642,Herenthoutsesteenweg 2,2023-01-03,07:00:00,33,32,1,ECO_300019380
642,Herenthoutsesteenweg 2,2023-01-03,08:00:00,54,50,4,ECO_300019380
642,Herenthoutsesteenweg 2,2023-01-03,09:00:00,62,61,1,ECO_300019380
642,Herenthoutsesteenweg 2,2023-01-03,10:00:00,65,60,5,ECO_300019380
642,Herenthoutsesteenweg 2,2023-01-03,11:00:00,94,90,4,ECO_300019380
642,Herenthoutsesteenweg 2,2023-01-03,12:00:00,118,109,9,ECO_300019380
642,Herenthoutsesteenweg 2,2023-01-03,13:00:00,122,115,7,ECO_300019380
642,Herenthoutsesteenweg 2,2023-01-03,14:00:00,181,177,4,ECO_300019380
642,Herenthoutsesteenweg 2,2023-01-03,15:00:00,115,106,9,ECO_300019380
642,Herenthoutsesteenweg 2,2023-01-03,16:00:00,42,39,3,ECO_300019380
642,Herenthoutsesteenweg 2,2023-01-03,17:00:00,78,71,7,ECO_300019380
642,Herenthoutsesteenweg 2,2023-01-03,18:00:00,58,46,12,ECO_300019380
642,Herenthoutsesteenweg 2,2023-01-03,19:00:00,20,16,4,ECO_300019380
642,Herenthoutsesteenweg 2,2023-01-03,20:00:00,27,24,3,ECO_300019380
642,Herenthoutsesteenweg 2,2023-01-03,21:00:00,9,8,1,ECO_300019380
642,Herenthoutsesteenweg 2,2023-01-03,22:00:00,12,12,0,ECO_300019380
642,Herenthoutsesteenweg 2,2023-01-03,23:00:00,10,9,1,ECO_300019380
642,Herenthoutsesteenweg 2,2023-01-04,00:00:00,4,3,1,ECO_300019380
642,Herenthoutsesteenweg 2,2023-01-04,01:00:00,2,1,1,ECO_300019380
642,Herenthoutsesteenweg 2,2023-01-04,02:00:00,0,0,0,ECO_300019380
642,Herenthoutsesteenweg 2,2023-01-04,03:00:00,0,0,0,ECO_300019380
642,Herenthoutsesteenweg 2,2023-01-04,04:00:00,1,0,1,ECO_300019380
642,Herenthoutsesteenweg 2,2023-01-04,05:00:00,3,3,0,ECO_300019380
642,Herenthoutsesteenweg 2,2023-01-04,06:00:00,13,13,0,ECO_300019380
642,Herenthoutsesteenweg 2,2023-01-04,07:00:00,27,25,2,ECO_300019380
642,Herenthoutsesteenweg 2,2023-01-04,08:00:00,45,43,2,ECO_300019380
642,Herenthoutsesteenweg 2,2023-01-04,09:00:00,41,38,3,ECO_300019380
642,Herenthoutsesteenweg 2,2023-01-04,10:00:00,29,29,0,ECO_300019380
642,Herenthoutsesteenweg 2,2023-01-04,11:00:00,23,21,2,ECO_300019380
642,Herenthoutsesteenweg 2,2023-01-04,12:00:00,28,26,2,ECO_300019380
642,Herenthoutsesteenweg 2,2023-01-04,13:00:00,31,30,1,ECO_300019380
642,Herenthoutsesteenweg 2,2023-01-04,14:00:00,35,34,1,ECO_300019380
642,Herenthoutsesteenweg 2,2023-01-04,15:00:00,24,21,3,ECO_300019380
642,Herenthoutsesteenweg 2,2023-01-04,16:00:00,31,29,2,ECO_300019380
642,Herenthoutsesteenweg 2,2023-01-04,17:00:00,60,54,6,ECO_300019380
642,Herenthoutsesteenweg 2,2023-01-04,18:00:00,37,34,3,ECO_300019380
642,Herenthoutsesteenweg 2,2023-01-04,19:00:00,25,21,4,ECO_300019380
642,Herenthoutsesteenweg 2,2023-01-04,20:00:00,16,15,1,ECO_300019380
642,Herenthoutsesteenweg 2,2023-01-04,21:00:00,13,11,2,ECO_300019380
642,Herenthoutsesteenweg 2,2023-01-04,22:00:00,23,18,5,ECO_300019380
642,Herenthoutsesteenweg 2,2023-01-04,23:00:00,9,8,1,ECO_300019380
642,Herenthoutsesteenweg 2,2023-01-05,00:00:00,3,1,2,ECO_300019380
642,Herenthoutsesteenweg 2,2023-01-05,01:00:00,4,2,2,ECO_300019380
642,Herenthoutsesteenweg 2,2023-01-05,02:00:00,5,4,1,ECO_300019380
642,Herenthoutsesteenweg 2,2023-01-05,03:00:00,0,0,0,ECO_300019380
642,Herenthoutsesteenweg 2,2023-01-05,04:00:00,2,0,2,ECO_300019380
642,Herenthoutsesteenweg 2,2023-01-05,05:00:00,3,3,0,ECO_300019380
642,Herenthoutsesteenweg 2,2023-01-05,06:00:00,13,12,1,ECO_300019380
642,Herenthoutsesteenweg 2,2023-01-05,07:00:00,27,26,1,ECO_300019380
642,Herenthoutsesteenweg 2,2023-01-05,08:00:00,52,51,1,ECO_300019380
642,Herenthoutsesteenweg 2,2023-01-05,09:00:00,51,50,1,ECO_300019380
642,Herenthoutsesteenweg 2,2023-01-05,10:00:00,43,40,3,ECO_300019380
642,Herenthoutsesteenweg 2,2023-01-05,11:00:00,78,73,5,ECO_300019380
642,Herenthoutsesteenweg 2,2023-01-05,12:00:00,50,48,2,ECO_300019380
642,Herenthoutsesteenweg 2,2023-01-05,13:00:00,70,59,11,ECO_300019380
642,Herenthoutsesteenweg 2,2023-01-05,14:00:00,87,84,3,ECO_300019380
642,Herenthoutsesteenweg 2,2023-01-05,15:00:00,81,78,3,ECO_300019380
642,Herenthoutsesteenweg 2,2023-01-05,16:00:00,37,30,7,ECO_300019380
642,Herenthoutsesteenweg 2,2023-01-05,17:00:00,71,67,4,ECO_300019380
642,Herenthoutsesteenweg 2,2023-01-05,18:00:00,39,34,5,ECO_300019380
642,Herenthoutsesteenweg 2,2023-01-05,19:00:00,33,29,4,ECO_300019380
642,Herenthoutsesteenweg 2,2023-01-05,20:00:00,15,13,2,ECO_300019380
642,Herenthoutsesteenweg 2,2023-01-05,21:00:00,10,9,1,ECO_300019380
642,Herenthoutsesteenweg 2,2023-01-05,22:00:00,14,13,1,ECO_300019380
642,Herenthoutsesteenweg 2,2023-01-05,23:00:00,14,13,1,ECO_300019380
642,Herenthoutsesteenweg 2,2023-01-06,00:00:00,4,2,2,ECO_300019380
642,Herenthoutsesteenweg 2,2023-01-06,01:00:00,4,2,2,ECO_300019380
642,Herenthoutsesteenweg 2,2023-01-06,02:00:00,1,1,0,ECO_300019380
642,Herenthoutsesteenweg 2,2023-01-06,03:00:00,0,0,0,ECO_300019380
642,Herenthoutsesteenweg 2,2023-01-06,04:00:00,0,0,0,ECO_300019380
642,Herenthoutsesteenweg 2,2023-01-06,05:00:00,1,1,0,ECO_300019380
642,Herenthoutsesteenweg 2,2023-01-06,06:00:00,12,12,0,ECO_300019380
642,Herenthoutsesteenweg 2,2023-01-06,07:00:00,33,29,4,ECO_300019380
642,Herenthoutsesteenweg 2,2023-01-06,08:00:00,46,43,3,ECO_300019380
642,Herenthoutsesteenweg 2,2023-01-06,09:00:00,59,58,1,ECO_300019380
642,Herenthoutsesteenweg 2,2023-01-06,10:00:00,42,38,4,ECO_300019380
642,Herenthoutsesteenweg 2,2023-01-06,11:00:00,73,69,4,ECO_300019380
642,Herenthoutsesteenweg 2,2023-01-06,12:00:00,65,58,7,ECO_300019380
642,Herenthoutsesteenweg 2,2023-01-06,13:00:00,48,41,7,ECO_300019380
642,Herenthoutsesteenweg 2,2023-01-06,14:00:00,69,68,1,ECO_300019380
642,Herenthoutsesteenweg 2,2023-01-06,15:00:00,52,48,4,ECO_300019380
642,Herenthoutsesteenweg 2,2023-01-06,16:00:00,43,41,2,ECO_300019380
642,Herenthoutsesteenweg 2,2023-01-06,17:00:00,86,79,7,ECO_300019380
642,Herenthoutsesteenweg 2,2023-01-06,18:00:00,35,30,5,ECO_300019380
642,Herenthoutsesteenweg 2,2023-01-06,19:00:00,21,19,2,ECO_300019380
642,Herenthoutsesteenweg 2,2023-01-06,20:00:00,30,29,1,ECO_300019380
642,Herenthoutsesteenweg 2,2023-01-06,21:00:00,14,13,1,ECO_300019380
642,Herenthoutsesteenweg 2,2023-01-06,22:00:00,11,11,0,ECO_300019380
642,Herenthoutsesteenweg 2,2023-01-06,23:00:00,13,9,4,ECO_300019380
642,Herenthoutsesteenweg 2,2023-01-07,00:00:00,7,6,1,ECO_300019380
642,Herenthoutsesteenweg 2,2023-01-07,01:00:00,5,2,3,ECO_300019380
642,Herenthoutsesteenweg 2,2023-01-07,02:00:00,9,7,2,ECO_300019380
642,Herenthoutsesteenweg 2,2023-01-07,03:00:00,4,3,1,ECO_300019380
642,Herenthoutsesteenweg 2,2023-01-07,04:00:00,1,1,0,ECO_300019380
642,Herenthoutsesteenweg 2,2023-01-07,05:00:00,1,1,0,ECO_300019380
642,Herenthoutsesteenweg 2,2023-01-07,06:00:00,3,3,0,ECO_300019380
642,Herenthoutsesteenweg 2,2023-01-07,07:00:00,11,11,0,ECO_300019380
642,Herenthoutsesteenweg 2,2023-01-07,08:00:00,2,1,1,ECO_300019380
642,Herenthoutsesteenweg 2,2023-01-07,09:00:00,26,23,3,ECO_300019380
642,Herenthoutsesteenweg 2,2023-01-07,10:00:00,55,51,4,ECO_300019380
642,Herenthoutsesteenweg 2,2023-01-07,11:00:00,81,76,5,ECO_300019380
642,Herenthoutsesteenweg 2,2023-01-07,12:00:00,77,62,15,ECO_300019380
642,Herenthoutsesteenweg 2,2023-01-07,13:00:00,76,62,14,ECO_300019380
642,Herenthoutsesteenweg 2,2023-01-07,14:00:00,98,94,4,ECO_300019380
642,Herenthoutsesteenweg 2,2023-01-07,15:00:00,90,87,3,ECO_300019380
642,Herenthoutsesteenweg 2,2023-01-07,16:00:00,47,39,8,ECO_300019380
642,Herenthoutsesteenweg 2,2023-01-07,17:00:00,25,20,5,ECO_300019380
642,Herenthoutsesteenweg 2,2023-01-07,18:00:00,16,15,1,ECO_300019380
642,Herenthoutsesteenweg 2,2023-01-07,19:00:00,12,11,1,ECO_300019380
642,Herenthoutsesteenweg 2,2023-01-07,20:00:00,18,18,0,ECO_300019380
642,Herenthoutsesteenweg 2,2023-01-07,21:00:00,11,10,1,ECO_300019380
642,Herenthoutsesteenweg 2,2023-01-07,22:00:00,4,4,0,ECO_300019380
642,Herenthoutsesteenweg 2,2023-01-07,23:00:00,8,5,3,ECO_300019380
642,Herenthoutsesteenweg 2,2023-01-08,00:00:00,6,5,1,ECO_300019380
642,Herenthoutsesteenweg 2,2023-01-08,01:00:00,1,1,0,ECO_300019380
642,Herenthoutsesteenweg 2,2023-01-08,02:00:00,12,9,3,ECO_300019380
642,Herenthoutsesteenweg 2,2023-01-08,03:00:00,2,1,1,ECO_300019380
642,Herenthoutsesteenweg 2,2023-01-08,04:00:00,1,1,0,ECO_300019380
642,Herenthoutsesteenweg 2,2023-01-08,05:00:00,4,3,1,ECO_300019380
642,Herenthoutsesteenweg 2,2023-01-08,06:00:00,0,0,0,ECO_300019380
642,Herenthoutsesteenweg 2,2023-01-08,07:00:00,7,5,2,ECO_300019380
642,Herenthoutsesteenweg 2,2023-01-08,08:00:00,9,9,0,ECO_300019380
642,Herenthoutsesteenweg 2,2023-01-08,09:00:00,37,32,5,ECO_300019380
642,Herenthoutsesteenweg 2,2023-01-08,10:00:00,67,65,2,ECO_300019380
642,Herenthoutsesteenweg 2,2023-01-08,11:00:00,88,81,7,ECO_300019380
642,Herenthoutsesteenweg 2,2023-01-08,12:00:00,61,54,7,ECO_300019380
642,Herenthoutsesteenweg 2,2023-01-08,13:00:00,40,39,1,ECO_300019380
642,Herenthoutsesteenweg 2,2023-01-08,14:00:00,50,45,5,ECO_300019380
642,Herenthoutsesteenweg 2,2023-01-08,15:00:00,37,31,6,ECO_300019380
642,Herenthoutsesteenweg 2,2023-01-08,16:00:00,43,40,3,ECO_300019380
642,Herenthoutsesteenweg 2,2023-01-08,17:00:00,26,24,2,ECO_300019380
642,Herenthoutsesteenweg 2,2023-01-08,18:00:00,15,10,5,ECO_300019380
642,Herenthoutsesteenweg 2,2023-01-08,19:00:00,9,8,1,ECO_300019380
642,Herenthoutsesteenweg 2,2023-01-08,20:00:00,14,14,0,ECO_300019380
642,Herenthoutsesteenweg 2,2023-01-08,21:00:00,10,9,1,ECO_300019380
642,Herenthoutsesteenweg 2,2023-01-08,22:00:00,5,3,2,ECO_300019380
642,Herenthoutsesteenweg 2,2023-01-08,23:00:00,7,6,1,ECO_300019380
642,Herenthoutsesteenweg 2,2023-01-09,00:00:00,1,1,0,ECO_300019380
642,Herenthoutsesteenweg 2,2023-01-09,01:00:00,1,1,0,ECO_300019380
642,Herenthoutsesteenweg 2,2023-01-09,02:00:00,1,1,0,ECO_300019380
642,Herenthoutsesteenweg 2,2023-01-09,03:00:00,1,0,1,ECO_300019380
642,Herenthoutsesteenweg 2,2023-01-09,04:00:00,0,0,0,ECO_300019380
642,Herenthoutsesteenweg 2,2023-01-09,05:00:00,1,1,0,ECO_300019380
642,Herenthoutsesteenweg 2,2023-01-09,06:00:00,12,11,1,ECO_300019380
642,Herenthoutsesteenweg 2,2023-01-09,07:00:00,34,33,1,ECO_300019380
642,Herenthoutsesteenweg 2,2023-01-09,08:00:00,126,124,2,ECO_300019380
642,Herenthoutsesteenweg 2,2023-01-09,09:00:00,527,515,12,ECO_300019380
642,Herenthoutsesteenweg 2,2023-01-09,10:00:00,56,56,0,ECO_300019380
642,Herenthoutsesteenweg 2,2023-01-09,11:00:00,58,58,0,ECO_300019380
642,Herenthoutsesteenweg 2,2023-01-09,12:00:00,31,29,2,ECO_300019380
642,Herenthoutsesteenweg 2,2023-01-09,13:00:00,47,45,2,ECO_300019380
642,Herenthoutsesteenweg 2,2023-01-09,14:00:00,56,50,6,ECO_300019380
642,Herenthoutsesteenweg 2,2023-01-09,15:00:00,53,48,5,ECO_300019380
642,Herenthoutsesteenweg 2,2023-01-09,16:00:00,75,70,5,ECO_300019380
642,Herenthoutsesteenweg 2,2023-01-09,17:00:00,90,77,13,ECO_300019380
642,Herenthoutsesteenweg 2,2023-01-09,18:00:00,50,45,5,ECO_300019380
642,Herenthoutsesteenweg 2,2023-01-09,19:00:00,32,27,5,ECO_300019380
642,Herenthoutsesteenweg 2,2023-01-09,20:00:00,23,20,3,ECO_300019380
642,Herenthoutsesteenweg 2,2023-01-09,21:00:00,16,15,1,ECO_300019380
642,Herenthoutsesteenweg 2,2023-01-09,22:00:00,14,14,0,ECO_300019380
642,Herenthoutsesteenweg 2,2023-01-09,23:00:00,19,16,3,ECO_300019380
642,Herenthoutsesteenweg 2,2023-01-10,00:00:00,4,2,2,ECO_300019380
642,Herenthoutsesteenweg 2,2023-01-10,01:00:00,0,0,0,ECO_300019380
642,Herenthoutsesteenweg 2,2023-01-10,02:00:00,0,0,0,ECO_300019380
642,Herenthoutsesteenweg 2,2023-01-10,03:00:00,0,0,0,ECO_300019380
642,Herenthoutsesteenweg 2,2023-01-10,04:00:00,1,1,0,ECO_300019380
642,Herenthoutsesteenweg 2,2023-01-10,05:00:00,3,3,0,ECO_300019380
642,Herenthoutsesteenweg 2,2023-01-10,06:00:00,13,11,2,ECO_300019380
642,Herenthoutsesteenweg 2,2023-01-10,07:00:00,47,42,5,ECO_300019380
642,Herenthoutsesteenweg 2,2023-01-10,08:00:00,140,136,4,ECO_300019380
642,Herenthoutsesteenweg 2,2023-01-10,09:00:00,531,523,8,ECO_300019380
642,Herenthoutsesteenweg 2,2023-01-10,10:00:00,70,65,5,ECO_300019380
642,Herenthoutsesteenweg 2,2023-01-10,11:00:00,47,47,0,ECO_300019380
642,Herenthoutsesteenweg 2,2023-01-10,12:00:00,37,35,2,ECO_300019380
642,Herenthoutsesteenweg 2,2023-01-10,13:00:00,95,89,6,ECO_300019380
642,Herenthoutsesteenweg 2,2023-01-10,14:00:00,55,50,5,ECO_300019380
642,Herenthoutsesteenweg 2,2023-01-10,15:00:00,38,37,1,ECO_300019380
642,Herenthoutsesteenweg 2,2023-01-10,16:00:00,37,32,5,ECO_300019380
642,Herenthoutsesteenweg 2,2023-01-10,17:00:00,92,80,12,ECO_300019380
642,Herenthoutsesteenweg 2,2023-01-10,18:00:00,49,44,5,ECO_300019380
642,Herenthoutsesteenweg 2,2023-01-10,19:00:00,26,20,6,ECO_300019380
642,Herenthoutsesteenweg 2,2023-01-10,20:00:00,25,24,1,ECO_300019380
642,Herenthoutsesteenweg 2,2023-01-10,21:00:00,11,9,2,ECO_300019380
642,Herenthoutsesteenweg 2,2023-01-10,22:00:00,7,6,1,ECO_300019380
642,Herenthoutsesteenweg 2,2023-01-10,23:00:00,15,14,1,ECO_300019380
642,Herenthoutsesteenweg 2,2023-01-11,00:00:00,1,1,0,ECO_300019380
642,Herenthoutsesteenweg 2,2023-01-11,01:00:00,0,0,0,ECO_300019380
642,Herenthoutsesteenweg 2,2023-01-11,02:00:00,2,2,0,ECO_300019380
642,Herenthoutsesteenweg 2,2023-01-11,03:00:00,0,0,0,ECO_300019380
642,Herenthoutsesteenweg 2,2023-01-11,04:00:00,1,0,1,ECO_300019380
642,Herenthoutsesteenweg 2,2023-01-11,05:00:00,1,1,0,ECO_300019380
642,Herenthoutsesteenweg 2,2023-01-11,06:00:00,14,12,2,ECO_300019380
642,Herenthoutsesteenweg 2,2023-01-11,07:00:00,41,35,6,ECO_300019380
642,Herenthoutsesteenweg 2,2023-01-11,08:00:00,105,101,4,ECO_300019380
642,Herenthoutsesteenweg 2,2023-01-11,09:00:00,520,513,7,ECO_300019380
642,Herenthoutsesteenweg 2,2023-01-11,10:00:00,61,60,1,ECO_300019380
642,Herenthoutsesteenweg 2,2023-01-11,11:00:00,49,46,3,ECO_300019380
642,Herenthoutsesteenweg 2,2023-01-11,12:00:00,50,49,1,ECO_300019380
642,Herenthoutsesteenweg 2,2023-01-11,13:00:00,102,95,7,ECO_300019380
642,Herenthoutsesteenweg 2,2023-01-11,14:00:00,113,106,7,ECO_300019380
642,Herenthoutsesteenweg 2,2023-01-11,15:00:00,86,80,6,ECO_300019380
642,Herenthoutsesteenweg 2,2023-01-11,16:00:00,68,56,12,ECO_300019380
642,Herenthoutsesteenweg 2,2023-01-11,17:00:00,101,96,5,ECO_300019380
642,Herenthoutsesteenweg 2,2023-01-11,18:00:00,65,56,9,ECO_300019380
642,Herenthoutsesteenweg 2,2023-01-11,19:00:00,27,21,6,ECO_300019380
642,Herenthoutsesteenweg 2,2023-01-11,20:00:00,17,16,1,ECO_300019380
642,Herenthoutsesteenweg 2,2023-01-11,21:00:00,13,13,0,ECO_300019380
642,Herenthoutsesteenweg 2,2023-01-11,22:00:00,7,6,1,ECO_300019380
642,Herenthoutsesteenweg 2,2023-01-11,23:00:00,22,20,2,ECO_300019380
642,Herenthoutsesteenweg 2,2023-01-12,00:00:00,1,1,0,ECO_300019380
642,Herenthoutsesteenweg 2,2023-01-12,01:00:00,0,0,0,ECO_300019380
642,Herenthoutsesteenweg 2,2023-01-12,02:00:00,1,0,1,ECO_300019380
642,Herenthoutsesteenweg 2,2023-01-12,03:00:00,0,0,0,ECO_300019380
642,Herenthoutsesteenweg 2,2023-01-12,04:00:00,1,1,0,ECO_300019380
642,Herenthoutsesteenweg 2,2023-01-12,05:00:00,0,0,0,ECO_300019380
642,Herenthoutsesteenweg 2,2023-01-12,06:00:00,10,9,1,ECO_300019380
642,Herenthoutsesteenweg 2,2023-01-12,07:00:00,25,24,1,ECO_300019380
642,Herenthoutsesteenweg 2,2023-01-12,08:00:00,42,42,0,ECO_300019380
642,Herenthoutsesteenweg 2,2023-01-12,09:00:00,222,217,5,ECO_300019380
642,Herenthoutsesteenweg 2,2023-01-12,10:00:00,24,23,1,ECO_300019380
642,Herenthoutsesteenweg 2,2023-01-12,11:00:00,11,10,1,ECO_300019380
642,Herenthoutsesteenweg 2,2023-01-12,12:00:00,11,11,0,ECO_300019380
642,Herenthoutsesteenweg 2,2023-01-12,13:00:00,22,22,0,ECO_300019380
642,Herenthoutsesteenweg 2,2023-01-12,14:00:00,13,12,1,ECO_300019380
642,Herenthoutsesteenweg 2,2023-01-12,15:00:00,11,11,0,ECO_300019380
642,Herenthoutsesteenweg 2,2023-01-12,16:00:00,26,24,2,ECO_300019380
642,Herenthoutsesteenweg 2,2023-01-12,17:00:00,55,50,5,ECO_300019380
642,Herenthoutsesteenweg 2,2023-01-12,18:00:00,23,21,2,ECO_300019380
642,Herenthoutsesteenweg 2,2023-01-12,19:00:00,15,14,1,ECO_300019380
642,Herenthoutsesteenweg 2,2023-01-12,20:00:00,12,11,1,ECO_300019380
642,Herenthoutsesteenweg 2,2023-01-12,21:00:00,8,8,0,ECO_300019380
642,Herenthoutsesteenweg 2,2023-01-12,22:00:00,4,4,0,ECO_300019380
642,Herenthoutsesteenweg 2,2023-01-12,23:00:00,10,9,1,ECO_300019380
642,Herenthoutsesteenweg 2,2023-01-13,00:00:00,1,1,0,ECO_300019380
642,Herenthoutsesteenweg 2,2023-01-13,01:00:00,1,0,1,ECO_300019380
642,Herenthoutsesteenweg 2,2023-01-13,02:00:00,1,1,0,ECO_300019380
642,Herenthoutsesteenweg 2,2023-01-13,03:00:00,1,0,1,ECO_300019380
642,Herenthoutsesteenweg 2,2023-01-13,04:00:00,2,2,0,ECO_300019380
642,Herenthoutsesteenweg 2,2023-01-13,05:00:00,0,0,0,ECO_300019380
642,Herenthoutsesteenweg 2,2023-01-13,06:00:00,16,15,1,ECO_300019380
642,Herenthoutsesteenweg 2,2023-01-13,07:00:00,29,28,1,ECO_300019380
642,Herenthoutsesteenweg 2,2023-01-13,08:00:00,106,101,5,ECO_300019380
642,Herenthoutsesteenweg 2,2023-01-13,09:00:00,471,464,7,ECO_300019380
642,Herenthoutsesteenweg 2,2023-01-13,10:00:00,93,88,5,ECO_300019380
642,Herenthoutsesteenweg 2,2023-01-13,11:00:00,94,90,4,ECO_300019380
642,Herenthoutsesteenweg 2,2023-01-13,12:00:00,47,43,4,ECO_300019380
642,Herenthoutsesteenweg 2,2023-01-13,13:00:00,52,46,6,ECO_300019380
642,Herenthoutsesteenweg 2,2023-01-13,14:00:00,42,41,1,ECO_300019380
642,Herenthoutsesteenweg 2,2023-01-13,15:00:00,46,41,5,ECO_300019380
642,Herenthoutsesteenweg 2,2023-01-13,16:00:00,79,73,6,ECO_300019380
642,Herenthoutsesteenweg 2,2023-01-13,17:00:00,88,78,10,ECO_300019380
642,Herenthoutsesteenweg 2,2023-01-13,18:00:00,59,55,4,ECO_300019380
642,Herenthoutsesteenweg 2,2023-01-13,19:00:00,34,32,2,ECO_300019380
642,Herenthoutsesteenweg 2,2023-01-13,20:00:00,43,38,5,ECO_300019380
642,Herenthoutsesteenweg 2,2023-01-13,21:00:00,19,19,0,ECO_300019380
642,Herenthoutsesteenweg 2,2023-01-13,22:00:00,14,14,0,ECO_300019380
642,Herenthoutsesteenweg 2,2023-01-13,23:00:00,18,17,1,ECO_300019380
642,Herenthoutsesteenweg 2,2023-01-14,00:00:00,9,8,1,ECO_300019380
642,Herenthoutsesteenweg 2,2023-01-14,01:00:00,1,1,0,ECO_300019380
642,Herenthoutsesteenweg 2,2023-01-14,02:00:00,4,3,1,ECO_300019380
642,Herenthoutsesteenweg 2,2023-01-14,03:00:00,0,0,0,ECO_300019380
642,Herenthoutsesteenweg 2,2023-01-14,04:00:00,1,1,0,ECO_300019380
642,Herenthoutsesteenweg 2,2023-01-14,05:00:00,0,0,0,ECO_300019380
642,Herenthoutsesteenweg 2,2023-01-14,06:00:00,1,1,0,ECO_300019380
642,Herenthoutsesteenweg 2,2023-01-14,07:00:00,11,7,4,ECO_300019380
642,Herenthoutsesteenweg 2,2023-01-14,08:00:00,2,2,0,ECO_300019380
642,Herenthoutsesteenweg 2,2023-01-14,09:00:00,10,9,1,ECO_300019380
642,Herenthoutsesteenweg 2,2023-01-14,10:00:00,19,18,1,ECO_300019380
642,Herenthoutsesteenweg 2,2023-01-14,11:00:00,19,17,2,ECO_300019380
642,Herenthoutsesteenweg 2,2023-01-14,12:00:00,10,8,2,ECO_300019380
642,Herenthoutsesteenweg 2,2023-01-14,13:00:00,18,17,1,ECO_300019380
642,Herenthoutsesteenweg 2,2023-01-14,14:00:00,13,13,0,ECO_300019380
642,Herenthoutsesteenweg 2,2023-01-14,15:00:00,15,14,1,ECO_300019380
642,Herenthoutsesteenweg 2,2023-01-14,16:00:00,20,19,1,ECO_300019380
642,Herenthoutsesteenweg 2,2023-01-14,17:00:00,23,21,2,ECO_300019380
642,Herenthoutsesteenweg 2,2023-01-14,18:00:00,9,9,0,ECO_300019380
642,Herenthoutsesteenweg 2,2023-01-14,19:00:00,17,17,0,ECO_300019380
642,Herenthoutsesteenweg 2,2023-01-14,20:00:00,15,14,1,ECO_300019380
642,Herenthoutsesteenweg 2,2023-01-14,21:00:00,12,12,0,ECO_300019380
642,Herenthoutsesteenweg 2,2023-01-14,22:00:00,6,5,1,ECO_300019380
642,Herenthoutsesteenweg 2,2023-01-14,23:00:00,4,3,1,ECO_300019380
642,Herenthoutsesteenweg 2,2023-01-15,00:00:00,6,6,0,ECO_300019380
642,Herenthoutsesteenweg 2,2023-01-15,01:00:00,9,8,1,ECO_300019380
642,Herenthoutsesteenweg 2,2023-01-15,02:00:00,4,1,3,ECO_300019380
642,Herenthoutsesteenweg 2,2023-01-15,03:00:00,1,0,1,ECO_300019380
642,Herenthoutsesteenweg 2,2023-01-15,04:00:00,0,0,0,ECO_300019380
642,Herenthoutsesteenweg 2,2023-01-15,05:00:00,1,1,0,ECO_300019380
642,Herenthoutsesteenweg 2,2023-01-15,06:00:00,1,1,0,ECO_300019380
642,Herenthoutsesteenweg 2,2023-01-15,07:00:00,7,7,0,ECO_300019380
642,Herenthoutsesteenweg 2,2023-01-15,08:00:00,8,7,1,ECO_300019380
642,Herenthoutsesteenweg 2,2023-01-15,09:00:00,34,31,3,ECO_300019380
642,Herenthoutsesteenweg 2,2023-01-15,10:00:00,83,79,4,ECO_300019380
642,Herenthoutsesteenweg 2,2023-01-15,11:00:00,80,77,3,ECO_300019380
642,Herenthoutsesteenweg 2,2023-01-15,12:00:00,69,64,5,ECO_300019380
642,Herenthoutsesteenweg 2,2023-01-15,13:00:00,40,38,2,ECO_300019380
642,Herenthoutsesteenweg 2,2023-01-15,14:00:00,36,31,5,ECO_300019380
642,Herenthoutsesteenweg 2,2023-01-15,15:00:00,43,41,2,ECO_300019380
642,Herenthoutsesteenweg 2,2023-01-15,16:00:00,20,20,0,ECO_300019380
642,Herenthoutsesteenweg 2,2023-01-15,17:00:00,25,23,2,ECO_300019380
642,Herenthoutsesteenweg 2,2023-01-15,18:00:00,19,18,1,ECO_300019380
642,Herenthoutsesteenweg 2,2023-01-15,19:00:00,12,10,2,ECO_300019380
642,Herenthoutsesteenweg 2,2023-01-15,20:00:00,14,12,2,ECO_300019380
642,Herenthoutsesteenweg 2,2023-01-15,21:00:00,8,8,0,ECO_300019380
642,Herenthoutsesteenweg 2,2023-01-15,22:00:00,5,4,1,ECO_300019380
642,Herenthoutsesteenweg 2,2023-01-15,23:00:00,2,2,0,ECO_300019380
642,Herenthoutsesteenweg 2,2023-01-16,00:00:00,1,1,0,ECO_300019380
642,Herenthoutsesteenweg 2,2023-01-16,01:00:00,1,0,1,ECO_300019380
642,Herenthoutsesteenweg 2,2023-01-16,02:00:00,1,0,1,ECO_300019380
642,Herenthoutsesteenweg 2,2023-01-16,03:00:00,0,0,0,ECO_300019380
642,Herenthoutsesteenweg 2,2023-01-16,04:00:00,0,0,0,ECO_300019380
642,Herenthoutsesteenweg 2,2023-01-16,05:00:00,2,2,0,ECO_300019380
642,Herenthoutsesteenweg 2,2023-01-16,06:00:00,15,12,3,ECO_300019380
642,Herenthoutsesteenweg 2,2023-01-16,07:00:00,32,30,2,ECO_300019380
642,Herenthoutsesteenweg 2,2023-01-16,08:00:00,64,63,1,ECO_300019380
642,Herenthoutsesteenweg 2,2023-01-16,09:00:00,297,296,1,ECO_300019380
642,Herenthoutsesteenweg 2,2023-01-16,10:00:00,40,40,0,ECO_300019380
642,Herenthoutsesteenweg 2,2023-01-16,11:00:00,28,28,0,ECO_300019380
642,Herenthoutsesteenweg 2,2023-01-16,12:00:00,28,27,1,ECO_300019380
642,Herenthoutsesteenweg 2,2023-01-16,13:00:00,29,28,1,ECO_300019380
642,Herenthoutsesteenweg 2,2023-01-16,14:00:00,24,19,5,ECO_300019380
642,Herenthoutsesteenweg 2,2023-01-16,15:00:00,22,20,2,ECO_300019380
642,Herenthoutsesteenweg 2,2023-01-16,16:00:00,43,35,8,ECO_300019380
642,Herenthoutsesteenweg 2,2023-01-16,17:00:00,62,57,5,ECO_300019380
642,Herenthoutsesteenweg 2,2023-01-16,18:00:00,31,24,7,ECO_300019380
642,Herenthoutsesteenweg 2,2023-01-16,19:00:00,17,15,2,ECO_300019380
642,Herenthoutsesteenweg 2,2023-01-16,20:00:00,15,12,3,ECO_300019380
642,Herenthoutsesteenweg 2,2023-01-16,21:00:00,8,7,1,ECO_300019380
642,Herenthoutsesteenweg 2,2023-01-16,22:00:00,11,10,1,ECO_300019380
642,Herenthoutsesteenweg 2,2023-01-16,23:00:00,8,6,2,ECO_300019380
642,Herenthoutsesteenweg 2,2023-01-17,00:00:00,1,1,0,ECO_300019380
642,Herenthoutsesteenweg 2,2023-01-17,01:00:00,0,0,0,ECO_300019380
642,Herenthoutsesteenweg 2,2023-01-17,02:00:00,1,1,0,ECO_300019380
642,Herenthoutsesteenweg 2,2023-01-17,03:00:00,0,0,0,ECO_300019380
642,Herenthoutsesteenweg 2,2023-01-17,04:00:00,0,0,0,ECO_300019380
642,Herenthoutsesteenweg 2,2023-01-17,05:00:00,4,4,0,ECO_300019380
642,Herenthoutsesteenweg 2,2023-01-17,06:00:00,16,13,3,ECO_300019380
642,Herenthoutsesteenweg 2,2023-01-17,07:00:00,40,38,2,ECO_300019380
642,Herenthoutsesteenweg 2,2023-01-17,08:00:00,125,116,9,ECO_300019380
642,Herenthoutsesteenweg 2,2023-01-17,09:00:00,480,471,9,ECO_300019380
642,Herenthoutsesteenweg 2,2023-01-17,10:00:00,59,59,0,ECO_300019380
642,Herenthoutsesteenweg 2,2023-01-17,11:00:00,48,46,2,ECO_300019380
642,Herenthoutsesteenweg 2,2023-01-17,12:00:00,43,42,1,ECO_300019380
642,Herenthoutsesteenweg 2,2023-01-17,13:00:00,50,41,9,ECO_300019380
642,Herenthoutsesteenweg 2,2023-01-17,14:00:00,78,74,4,ECO_300019380
642,Herenthoutsesteenweg 2,2023-01-17,15:00:00,72,66,6,ECO_300019380
642,Herenthoutsesteenweg 2,2023-01-17,16:00:00,99,88,11,ECO_300019380
642,Herenthoutsesteenweg 2,2023-01-17,17:00:00,99,86,13,ECO_300019380
642,Herenthoutsesteenweg 2,2023-01-17,18:00:00,49,46,3,ECO_300019380
642,Herenthoutsesteenweg 2,2023-01-17,19:00:00,42,38,4,ECO_300019380
642,Herenthoutsesteenweg 2,2023-01-17,20:00:00,16,14,2,ECO_300019380
642,Herenthoutsesteenweg 2,2023-01-17,21:00:00,8,7,1,ECO_300019380
642,Herenthoutsesteenweg 2,2023-01-17,22:00:00,10,8,2,ECO_300019380
642,Herenthoutsesteenweg 2,2023-01-17,23:00:00,13,11,2,ECO_300019380
642,Herenthoutsesteenweg 2,2023-01-18,00:00:00,4,2,2,ECO_300019380
642,Herenthoutsesteenweg 2,2023-01-18,01:00:00,2,1,1,ECO_300019380
642,Herenthoutsesteenweg 2,2023-01-18,02:00:00,0,0,0,ECO_300019380
642,Herenthoutsesteenweg 2,2023-01-18,03:00:00,0,0,0,ECO_300019380
642,Herenthoutsesteenweg 2,2023-01-18,04:00:00,0,0,0,ECO_300019380
642,Herenthoutsesteenweg 2,2023-01-18,05:00:00,12,9,3,ECO_300019380
642,Herenthoutsesteenweg 2,2023-01-18,06:00:00,12,12,0,ECO_300019380
642,Herenthoutsesteenweg 2,2023-01-18,07:00:00,32,31,1,ECO_300019380
642,Herenthoutsesteenweg 2,2023-01-18,08:00:00,106,100,6,ECO_300019380
642,Herenthoutsesteenweg 2,2023-01-18,09:00:00,511,509,2,ECO_300019380
642,Herenthoutsesteenweg 2,2023-01-18,10:00:00,48,48,0,ECO_300019380
642,Herenthoutsesteenweg 2,2023-01-18,11:00:00,41,39,2,ECO_300019380
642,Herenthoutsesteenweg 2,2023-01-18,12:00:00,35,31,4,ECO_300019380
642,Herenthoutsesteenweg 2,2023-01-18,13:00:00,79,71,8,ECO_300019380
642,Herenthoutsesteenweg 2,2023-01-18,14:00:00,76,74,2,ECO_300019380
642,Herenthoutsesteenweg 2,2023-01-18,15:00:00,93,87,6,ECO_300019380
642,Herenthoutsesteenweg 2,2023-01-18,16:00:00,64,62,2,ECO_300019380
642,Herenthoutsesteenweg 2,2023-01-18,17:00:00,91,90,1,ECO_300019380
642,Herenthoutsesteenweg 2,2023-01-18,18:00:00,48,48,0,ECO_300019380
642,Herenthoutsesteenweg 2,2023-01-18,19:00:00,29,25,4,ECO_300019380
642,Herenthoutsesteenweg 2,2023-01-18,20:00:00,32,30,2,ECO_300019380
642,Herenthoutsesteenweg 2,2023-01-18,21:00:00,8,7,1,ECO_300019380
642,Herenthoutsesteenweg 2,2023-01-18,22:00:00,16,14,2,ECO_300019380
642,Herenthoutsesteenweg 2,2023-01-18,23:00:00,14,13,1,ECO_300019380
642,Herenthoutsesteenweg 2,2023-01-19,00:00:00,2,2,0,ECO_300019380
642,Herenthoutsesteenweg 2,2023-01-19,01:00:00,2,1,1,ECO_300019380
642,Herenthoutsesteenweg 2,2023-01-19,02:00:00,1,1,0,ECO_300019380
642,Herenthoutsesteenweg 2,2023-01-19,03:00:00,1,1,0,ECO_300019380
642,Herenthoutsesteenweg 2,2023-01-19,04:00:00,0,0,0,ECO_300019380
642,Herenthoutsesteenweg 2,2023-01-19,05:00:00,3,3,0,ECO_300019380
642,Herenthoutsesteenweg 2,2023-01-19,06:00:00,16,14,2,ECO_300019380
642,Herenthoutsesteenweg 2,2023-01-19,07:00:00,31,29,2,ECO_300019380
642,Herenthoutsesteenweg 2,2023-01-19,08:00:00,103,96,7,ECO_300019380
642,Herenthoutsesteenweg 2,2023-01-19,09:00:00,481,472,9,ECO_300019380
642,Herenthoutsesteenweg 2,2023-01-19,10:00:00,62,61,1,ECO_300019380
642,Herenthoutsesteenweg 2,2023-01-19,11:00:00,43,38,5,ECO_300019380
642,Herenthoutsesteenweg 2,2023-01-19,12:00:00,25,24,1,ECO_300019380
642,Herenthoutsesteenweg 2,2023-01-19,13:00:00,43,38,5,ECO_300019380
642,Herenthoutsesteenweg 2,2023-01-19,14:00:00,46,45,1,ECO_300019380
642,Herenthoutsesteenweg 2,2023-01-19,15:00:00,60,55,5,ECO_300019380
642,Herenthoutsesteenweg 2,2023-01-19,16:00:00,69,60,9,ECO_300019380
642,Herenthoutsesteenweg 2,2023-01-19,17:00:00,81,69,12,ECO_300019380
642,Herenthoutsesteenweg 2,2023-01-19,18:00:00,41,37,4,ECO_300019380
642,Herenthoutsesteenweg 2,2023-01-19,19:00:00,50,47,3,ECO_300019380
642,Herenthoutsesteenweg 2,2023-01-19,20:00:00,26,25,1,ECO_300019380
642,Herenthoutsesteenweg 2,2023-01-19,21:00:00,17,16,1,ECO_300019380
642,Herenthoutsesteenweg 2,2023-01-19,22:00:00,10,8,2,ECO_300019380
642,Herenthoutsesteenweg 2,2023-01-19,23:00:00,14,11,3,ECO_300019380
642,Herenthoutsesteenweg 2,2023-01-20,00:00:00,5,5,0,ECO_300019380
642,Herenthoutsesteenweg 2,2023-01-20,01:00:00,2,1,1,ECO_300019380
642,Herenthoutsesteenweg 2,2023-01-20,02:00:00,2,1,1,ECO_300019380
642,Herenthoutsesteenweg 2,2023-01-20,03:00:00,0,0,0,ECO_300019380
642,Herenthoutsesteenweg 2,2023-01-20,04:00:00,0,0,0,ECO_300019380
642,Herenthoutsesteenweg 2,2023-01-20,05:00:00,5,4,1,ECO_300019380
642,Herenthoutsesteenweg 2,2023-01-20,06:00:00,8,8,0,ECO_300019380
642,Herenthoutsesteenweg 2,2023-01-20,07:00:00,27,26,1,ECO_300019380
642,Herenthoutsesteenweg 2,2023-01-20,08:00:00,94,87,7,ECO_300019380
642,Herenthoutsesteenweg 2,2023-01-20,09:00:00,418,404,14,ECO_300019380
642,Herenthoutsesteenweg 2,2023-01-20,10:00:00,43,38,5,ECO_300019380
642,Herenthoutsesteenweg 2,2023-01-20,11:00:00,32,29,3,ECO_300019380
642,Herenthoutsesteenweg 2,2023-01-20,12:00:00,20,20,0,ECO_300019380
642,Herenthoutsesteenweg 2,2023-01-20,13:00:00,26,23,3,ECO_300019380
642,Herenthoutsesteenweg 2,2023-01-20,14:00:00,22,20,2,ECO_300019380
642,Herenthoutsesteenweg 2,2023-01-20,15:00:00,16,15,1,ECO_300019380
642,Herenthoutsesteenweg 2,2023-01-20,16:00:00,34,32,2,ECO_300019380
642,Herenthoutsesteenweg 2,2023-01-20,17:00:00,37,33,4,ECO_300019380
642,Herenthoutsesteenweg 2,2023-01-20,18:00:00,33,30,3,ECO_300019380
642,Herenthoutsesteenweg 2,2023-01-20,19:00:00,12,11,1,ECO_300019380
642,Herenthoutsesteenweg 2,2023-01-20,20:00:00,16,15,1,ECO_300019380
642,Herenthoutsesteenweg 2,2023-01-20,21:00:00,15,14,1,ECO_300019380
642,Herenthoutsesteenweg 2,2023-01-20,22:00:00,6,5,1,ECO_300019380
642,Herenthoutsesteenweg 2,2023-01-20,23:00:00,9,8,1,ECO_300019380
642,Herenthoutsesteenweg 2,2023-01-21,00:00:00,1,1,0,ECO_300019380
642,Herenthoutsesteenweg 2,2023-01-21,01:00:00,2,0,2,ECO_300019380
642,Herenthoutsesteenweg 2,2023-01-21,02:00:00,3,1,2,ECO_300019380
642,Herenthoutsesteenweg 2,2023-01-21,03:00:00,2,1,1,ECO_300019380
642,Herenthoutsesteenweg 2,2023-01-21,04:00:00,1,0,1,ECO_300019380
642,Herenthoutsesteenweg 2,2023-01-21,05:00:00,5,3,2,ECO_300019380
642,Herenthoutsesteenweg 2,2023-01-21,06:00:00,2,2,0,ECO_300019380
642,Herenthoutsesteenweg 2,2023-01-21,07:00:00,5,4,1,ECO_300019380
642,Herenthoutsesteenweg 2,2023-01-21,08:00:00,4,4,0,ECO_300019380
642,Herenthoutsesteenweg 2,2023-01-21,09:00:00,9,8,1,ECO_300019380
642,Herenthoutsesteenweg 2,2023-01-21,10:00:00,19,18,1,ECO_300019380
642,Herenthoutsesteenweg 2,2023-01-21,11:00:00,39,36,3,ECO_300019380
642,Herenthoutsesteenweg 2,2023-01-21,12:00:00,41,39,2,ECO_300019380
642,Herenthoutsesteenweg 2,2023-01-21,13:00:00,33,30,3,ECO_300019380
642,Herenthoutsesteenweg 2,2023-01-21,14:00:00,46,45,1,ECO_300019380
642,Herenthoutsesteenweg 2,2023-01-21,15:00:00,36,34,2,ECO_300019380
642,Herenthoutsesteenweg 2,2023-01-21,16:00:00,28,27,1,ECO_300019380
642,Herenthoutsesteenweg 2,2023-01-21,17:00:00,25,23,2,ECO_300019380
642,Herenthoutsesteenweg 2,2023-01-21,18:00:00,20,16,4,ECO_300019380
642,Herenthoutsesteenweg 2,2023-01-21,19:00:00,27,25,2,ECO_300019380
642,Herenthoutsesteenweg 2,2023-01-21,20:00:00,23,23,0,ECO_300019380
642,Herenthoutsesteenweg 2,2023-01-21,21:00:00,11,11,0,ECO_300019380
642,Herenthoutsesteenweg 2,2023-01-21,22:00:00,9,8,1,ECO_300019380
642,Herenthoutsesteenweg 2,2023-01-21,23:00:00,4,4,0,ECO_300019380
642,Herenthoutsesteenweg 2,2023-01-22,00:00:00,9,7,2,ECO_300019380
642,Herenthoutsesteenweg 2,2023-01-22,01:00:00,2,1,1,ECO_300019380
642,Herenthoutsesteenweg 2,2023-01-22,02:00:00,9,7,2,ECO_300019380
642,Herenthoutsesteenweg 2,2023-01-22,03:00:00,0,0,0,ECO_300019380
642,Herenthoutsesteenweg 2,2023-01-22,04:00:00,1,0,1,ECO_300019380
642,Herenthoutsesteenweg 2,2023-01-22,05:00:00,2,2,0,ECO_300019380
642,Herenthoutsesteenweg 2,2023-01-22,06:00:00,3,2,1,ECO_300019380
642,Herenthoutsesteenweg 2,2023-01-22,07:00:00,4,4,0,ECO_300019380
642,Herenthoutsesteenweg 2,2023-01-22,08:00:00,6,6,0,ECO_300019380
642,Herenthoutsesteenweg 2,2023-01-22,09:00:00,22,19,3,ECO_300019380
642,Herenthoutsesteenweg 2,2023-01-22,10:00:00,29,29,0,ECO_300019380
642,Herenthoutsesteenweg 2,2023-01-22,11:00:00,50,46,4,ECO_300019380
642,Herenthoutsesteenweg 2,2023-01-22,12:00:00,23,20,3,ECO_300019380
642,Herenthoutsesteenweg 2,2023-01-22,13:00:00,30,24,6,ECO_300019380
642,Herenthoutsesteenweg 2,2023-01-22,14:00:00,33,30,3,ECO_300019380
642,Herenthoutsesteenweg 2,2023-01-22,15:00:00,30,28,2,ECO_300019380
642,Herenthoutsesteenweg 2,2023-01-22,16:00:00,11,9,2,ECO_300019380
642,Herenthoutsesteenweg 2,2023-01-22,17:00:00,15,14,1,ECO_300019380
642,Herenthoutsesteenweg 2,2023-01-22,18:00:00,10,10,0,ECO_300019380
642,Herenthoutsesteenweg 2,2023-01-22,19:00:00,5,5,0,ECO_300019380
642,Herenthoutsesteenweg 2,2023-01-22,20:00:00,4,4,0,ECO_300019380
642,Herenthoutsesteenweg 2,2023-01-22,21:00:00,5,4,1,ECO_300019380
642,Herenthoutsesteenweg 2,2023-01-22,22:00:00,3,3,0,ECO_300019380
642,Herenthoutsesteenweg 2,2023-01-22,23:00:00,4,4,0,ECO_300019380
642,Herenthoutsesteenweg 2,2023-01-23,00:00:00,3,3,0,ECO_300019380
642,Herenthoutsesteenweg 2,2023-01-23,01:00:00,0,0,0,ECO_300019380
642,Herenthoutsesteenweg 2,2023-01-23,02:00:00,1,1,0,ECO_300019380
642,Herenthoutsesteenweg 2,2023-01-23,03:00:00,0,0,0,ECO_300019380
642,Herenthoutsesteenweg 2,2023-01-23,04:00:00,1,1,0,ECO_300019380
642,Herenthoutsesteenweg 2,2023-01-23,05:00:00,6,6,0,ECO_300019380
642,Herenthoutsesteenweg 2,2023-01-23,06:00:00,17,16,1,ECO_300019380
642,Herenthoutsesteenweg 2,2023-01-23,07:00:00,41,40,1,ECO_300019380
642,Herenthoutsesteenweg 2,2023-01-23,08:00:00,116,114,2,ECO_300019380
642,Herenthoutsesteenweg 2,2023-01-23,09:00:00,472,462,10,ECO_300019380
642,Herenthoutsesteenweg 2,2023-01-23,10:00:00,50,50,0,ECO_300019380
642,Herenthoutsesteenweg 2,2023-01-23,11:00:00,25,23,2,ECO_300019380
642,Herenthoutsesteenweg 2,2023-01-23,12:00:00,41,41,0,ECO_300019380
642,Herenthoutsesteenweg 2,2023-01-23,13:00:00,48,45,3,ECO_300019380
642,Herenthoutsesteenweg 2,2023-01-23,14:00:00,48,47,1,ECO_300019380
642,Herenthoutsesteenweg 2,2023-01-23,15:00:00,51,44,7,ECO_300019380
642,Herenthoutsesteenweg 2,2023-01-23,16:00:00,57,52,5,ECO_300019380
642,Herenthoutsesteenweg 2,2023-01-23,17:00:00,72,65,7,ECO_300019380
642,Herenthoutsesteenweg 2,2023-01-23,18:00:00,47,45,2,ECO_300019380
642,Herenthoutsesteenweg 2,2023-01-23,19:00:00,35,31,4,ECO_300019380
642,Herenthoutsesteenweg 2,2023-01-23,20:00:00,17,16,1,ECO_300019380
642,Herenthoutsesteenweg 2,2023-01-23,21:00:00,13,13,0,ECO_300019380
642,Herenthoutsesteenweg 2,2023-01-23,22:00:00,9,6,3,ECO_300019380
642,Herenthoutsesteenweg 2,2023-01-23,23:00:00,18,16,2,ECO_300019380
642,Herenthoutsesteenweg 2,2023-01-24,00:00:00,1,0,1,ECO_300019380
642,Herenthoutsesteenweg 2,2023-01-24,01:00:00,2,2,0,ECO_300019380
642,Herenthoutsesteenweg 2,2023-01-24,02:00:00,1,0,1,ECO_300019380
642,Herenthoutsesteenweg 2,2023-01-24,03:00:00,0,0,0,ECO_300019380
642,Herenthoutsesteenweg 2,2023-01-24,04:00:00,1,1,0,ECO_300019380
642,Herenthoutsesteenweg 2,2023-01-24,05:00:00,3,3,0,ECO_300019380
642,Herenthoutsesteenweg 2,2023-01-24,06:00:00,15,15,0,ECO_300019380
642,Herenthoutsesteenweg 2,2023-01-24,07:00:00,39,36,3,ECO_300019380
642,Herenthoutsesteenweg 2,2023-01-24,08:00:00,118,112,6,ECO_300019380
642,Herenthoutsesteenweg 2,2023-01-24,09:00:00,499,485,14,ECO_300019380
642,Herenthoutsesteenweg 2,2023-01-24,10:00:00,79,77,2,ECO_300019380
642,Herenthoutsesteenweg 2,2023-01-24,11:00:00,38,37,1,ECO_300019380
642,Herenthoutsesteenweg 2,2023-01-24,12:00:00,26,20,6,ECO_300019380
642,Herenthoutsesteenweg 2,2023-01-24,13:00:00,47,43,4,ECO_300019380
642,Herenthoutsesteenweg 2,2023-01-24,14:00:00,54,50,4,ECO_300019380
642,Herenthoutsesteenweg 2,2023-01-24,15:00:00,73,63,10,ECO_300019380
642,Herenthoutsesteenweg 2,2023-01-24,16:00:00,72,61,11,ECO_300019380
642,Herenthoutsesteenweg 2,2023-01-24,17:00:00,97,87,10,ECO_300019380
642,Herenthoutsesteenweg 2,2023-01-24,18:00:00,51,46,5,ECO_300019380
642,Herenthoutsesteenweg 2,2023-01-24,19:00:00,30,28,2,ECO_300019380
642,Herenthoutsesteenweg 2,2023-01-24,20:00:00,17,16,1,ECO_300019380
642,Herenthoutsesteenweg 2,2023-01-24,21:00:00,15,13,2,ECO_300019380
642,Herenthoutsesteenweg 2,2023-01-24,22:00:00,6,5,1,ECO_300019380
642,Herenthoutsesteenweg 2,2023-01-24,23:00:00,18,17,1,ECO_300019380
642,Herenthoutsesteenweg 2,2023-01-25,00:00:00,3,2,1,ECO_300019380
642,Herenthoutsesteenweg 2,2023-01-25,01:00:00,2,1,1,ECO_300019380
642,Herenthoutsesteenweg 2,2023-01-25,02:00:00,1,1,0,ECO_300019380
642,Herenthoutsesteenweg 2,2023-01-25,03:00:00,0,0,0,ECO_300019380
642,Herenthoutsesteenweg 2,2023-01-25,04:00:00,1,1,0,ECO_300019380
642,Herenthoutsesteenweg 2,2023-01-25,05:00:00,2,2,0,ECO_300019380
642,Herenthoutsesteenweg 2,2023-01-25,06:00:00,16,14,2,ECO_300019380
642,Herenthoutsesteenweg 2,2023-01-25,07:00:00,35,34,1,ECO_300019380
642,Herenthoutsesteenweg 2,2023-01-25,08:00:00,131,127,4,ECO_300019380
642,Herenthoutsesteenweg 2,2023-01-25,09:00:00,461,451,10,ECO_300019380
642,Herenthoutsesteenweg 2,2023-01-25,10:00:00,62,62,0,ECO_300019380
642,Herenthoutsesteenweg 2,2023-01-25,11:00:00,48,46,2,ECO_300019380
642,Herenthoutsesteenweg 2,2023-01-25,12:00:00,42,38,4,ECO_300019380
642,Herenthoutsesteenweg 2,2023-01-25,13:00:00,95,89,6,ECO_300019380
642,Herenthoutsesteenweg 2,2023-01-25,14:00:00,67,58,9,ECO_300019380
642,Herenthoutsesteenweg 2,2023-01-25,15:00:00,57,53,4,ECO_300019380
642,Herenthoutsesteenweg 2,2023-01-25,16:00:00,49,40,9,ECO_300019380
642,Herenthoutsesteenweg 2,2023-01-25,17:00:00,82,74,8,ECO_300019380
642,Herenthoutsesteenweg 2,2023-01-25,18:00:00,45,41,4,ECO_300019380
642,Herenthoutsesteenweg 2,2023-01-25,19:00:00,43,40,3,ECO_300019380
642,Herenthoutsesteenweg 2,2023-01-25,20:00:00,27,25,2,ECO_300019380
642,Herenthoutsesteenweg 2,2023-01-25,21:00:00,13,11,2,ECO_300019380
642,Herenthoutsesteenweg 2,2023-01-25,22:00:00,7,2,5,ECO_300019380
642,Herenthoutsesteenweg 2,2023-01-25,23:00:00,17,17,0,ECO_300019380
642,Herenthoutsesteenweg 2,2023-01-26,00:00:00,5,5,0,ECO_300019380
642,Herenthoutsesteenweg 2,2023-01-26,01:00:00,1,1,0,ECO_300019380
642,Herenthoutsesteenweg 2,2023-01-26,02:00:00,4,2,2,ECO_300019380
642,Herenthoutsesteenweg 2,2023-01-26,03:00:00,2,2,0,ECO_300019380
642,Herenthoutsesteenweg 2,2023-01-26,04:00:00,0,0,0,ECO_300019380
642,Herenthoutsesteenweg 2,2023-01-26,05:00:00,2,2,0,ECO_300019380
642,Herenthoutsesteenweg 2,2023-01-26,06:00:00,13,10,3,ECO_300019380
642,Herenthoutsesteenweg 2,2023-01-26,07:00:00,37,36,1,ECO_300019380
642,Herenthoutsesteenweg 2,2023-01-26,08:00:00,88,84,4,ECO_300019380
642,Herenthoutsesteenweg 2,2023-01-26,09:00:00,425,420,5,ECO_300019380
642,Herenthoutsesteenweg 2,2023-01-26,10:00:00,42,42,0,ECO_300019380
642,Herenthoutsesteenweg 2,2023-01-26,11:00:00,21,20,1,ECO_300019380
642,Herenthoutsesteenweg 2,2023-01-26,12:00:00,21,20,1,ECO_300019380
642,Herenthoutsesteenweg 2,2023-01-26,13:00:00,40,36,4,ECO_300019380
642,Herenthoutsesteenweg 2,2023-01-26,14:00:00,58,51,7,ECO_300019380
642,Herenthoutsesteenweg 2,2023-01-26,15:00:00,43,42,1,ECO_300019380
642,Herenthoutsesteenweg 2,2023-01-26,16:00:00,60,55,5,ECO_300019380
642,Herenthoutsesteenweg 2,2023-01-26,17:00:00,63,58,5,ECO_300019380
642,Herenthoutsesteenweg 2,2023-01-26,18:00:00,51,48,3,ECO_300019380
642,Herenthoutsesteenweg 2,2023-01-26,19:00:00,29,29,0,ECO_300019380
642,Herenthoutsesteenweg 2,2023-01-26,20:00:00,32,30,2,ECO_300019380
642,Herenthoutsesteenweg 2,2023-01-26,21:00:00,11,11,0,ECO_300019380
642,Herenthoutsesteenweg 2,2023-01-26,22:00:00,2,1,1,ECO_300019380
642,Herenthoutsesteenweg 2,2023-01-26,23:00:00,16,14,2,ECO_300019380
642,Herenthoutsesteenweg 2,2023-01-27,00:00:00,2,1,1,ECO_300019380
642,Herenthoutsesteenweg 2,2023-01-27,01:00:00,2,2,0,ECO_300019380
642,Herenthoutsesteenweg 2,2023-01-27,02:00:00,1,1,0,ECO_300019380
642,Herenthoutsesteenweg 2,2023-01-27,03:00:00,1,0,1,ECO_300019380
642,Herenthoutsesteenweg 2,2023-01-27,04:00:00,0,0,0,ECO_300019380
642,Herenthoutsesteenweg 2,2023-01-27,05:00:00,2,2,0,ECO_300019380
642,Herenthoutsesteenweg 2,2023-01-27,06:00:00,15,14,1,ECO_300019380
642,Herenthoutsesteenweg 2,2023-01-27,07:00:00,33,31,2,ECO_300019380
642,Herenthoutsesteenweg 2,2023-01-27,08:00:00,97,89,8,ECO_300019380
642,Herenthoutsesteenweg 2,2023-01-27,09:00:00,454,451,3,ECO_300019380
642,Herenthoutsesteenweg 2,2023-01-27,10:00:00,74,72,2,ECO_300019380
642,Herenthoutsesteenweg 2,2023-01-27,11:00:00,83,81,2,ECO_300019380
642,Herenthoutsesteenweg 2,2023-01-27,12:00:00,61,56,5,ECO_300019380
642,Herenthoutsesteenweg 2,2023-01-27,13:00:00,49,48,1,ECO_300019380
642,Herenthoutsesteenweg 2,2023-01-27,14:00:00,65,62,3,ECO_300019380
642,Herenthoutsesteenweg 2,2023-01-27,15:00:00,62,55,7,ECO_300019380
642,Herenthoutsesteenweg 2,2023-01-27,16:00:00,101,91,10,ECO_300019380
642,Herenthoutsesteenweg 2,2023-01-27,17:00:00,99,93,6,ECO_300019380
642,Herenthoutsesteenweg 2,2023-01-27,18:00:00,55,47,8,ECO_300019380
642,Herenthoutsesteenweg 2,2023-01-27,19:00:00,40,36,4,ECO_300019380
642,Herenthoutsesteenweg 2,2023-01-27,20:00:00,38,34,4,ECO_300019380
642,Herenthoutsesteenweg 2,2023-01-27,21:00:00,13,11,2,ECO_300019380
642,Herenthoutsesteenweg 2,2023-01-27,22:00:00,17,16,1,ECO_300019380
642,Herenthoutsesteenweg 2,2023-01-27,23:00:00,16,15,1,ECO_300019380
642,Herenthoutsesteenweg 2,2023-01-28,00:00:00,9,8,1,ECO_300019380
642,Herenthoutsesteenweg 2,2023-01-28,01:00:00,10,8,2,ECO_300019380
642,Herenthoutsesteenweg 2,2023-01-28,02:00:00,4,4,0,ECO_300019380
642,Herenthoutsesteenweg 2,2023-01-28,03:00:00,5,2,3,ECO_300019380
642,Herenthoutsesteenweg 2,2023-01-28,04:00:00,3,3,0,ECO_300019380
642,Herenthoutsesteenweg 2,2023-01-28,05:00:00,1,1,0,ECO_300019380
642,Herenthoutsesteenweg 2,2023-01-28,06:00:00,5,3,2,ECO_300019380
642,Herenthoutsesteenweg 2,2023-01-28,07:00:00,6,5,1,ECO_300019380
642,Herenthoutsesteenweg 2,2023-01-28,08:00:00,8,8,0,ECO_300019380
642,Herenthoutsesteenweg 2,2023-01-28,09:00:00,25,24,1,ECO_300019380
642,Herenthoutsesteenweg 2,2023-01-28,10:00:00,46,43,3,ECO_300019380
642,Herenthoutsesteenweg 2,2023-01-28,11:00:00,55,51,4,ECO_300019380
642,Herenthoutsesteenweg 2,2023-01-28,12:00:00,41,40,1,ECO_300019380
642,Herenthoutsesteenweg 2,2023-01-28,13:00:00,71,69,2,ECO_300019380
642,Herenthoutsesteenweg 2,2023-01-28,14:00:00,90,88,2,ECO_300019380
642,Herenthoutsesteenweg 2,2023-01-28,15:00:00,83,71,12,ECO_300019380
642,Herenthoutsesteenweg 2,2023-01-28,16:00:00,59,49,10,ECO_300019380
642,Herenthoutsesteenweg 2,2023-01-28,17:00:00,40,38,2,ECO_300019380
642,Herenthoutsesteenweg 2,2023-01-28,18:00:00,31,29,2,ECO_300019380
642,Herenthoutsesteenweg 2,2023-01-28,19:00:00,29,28,1,ECO_300019380
642,Herenthoutsesteenweg 2,2023-01-28,20:00:00,34,34,0,ECO_300019380
642,Herenthoutsesteenweg 2,2023-01-28,21:00:00,14,14,0,ECO_300019380
642,Herenthoutsesteenweg 2,2023-01-28,22:00:00,10,6,4,ECO_300019380
642,Herenthoutsesteenweg 2,2023-01-28,23:00:00,7,7,0,ECO_300019380
642,Herenthoutsesteenweg 2,2023-01-29,00:00:00,5,5,0,ECO_300019380
642,Herenthoutsesteenweg 2,2023-01-29,01:00:00,4,4,0,ECO_300019380
642,Herenthoutsesteenweg 2,2023-01-29,02:00:00,1,0,1,ECO_300019380
642,Herenthoutsesteenweg 2,2023-01-29,03:00:00,2,2,0,ECO_300019380
642,Herenthoutsesteenweg 2,2023-01-29,04:00:00,4,1,3,ECO_300019380
642,Herenthoutsesteenweg 2,2023-01-29,05:00:00,0,0,0,ECO_300019380
642,Herenthoutsesteenweg 2,2023-01-29,06:00:00,1,1,0,ECO_300019380
642,Herenthoutsesteenweg 2,2023-01-29,07:00:00,5,5,0,ECO_300019380
642,Herenthoutsesteenweg 2,2023-01-29,08:00:00,6,6,0,ECO_300019380
642,Herenthoutsesteenweg 2,2023-01-29,09:00:00,24,24,0,ECO_300019380
642,Herenthoutsesteenweg 2,2023-01-29,10:00:00,47,44,3,ECO_300019380
642,Herenthoutsesteenweg 2,2023-01-29,11:00:00,56,54,2,ECO_300019380
642,Herenthoutsesteenweg 2,2023-01-29,12:00:00,34,31,3,ECO_300019380
642,Herenthoutsesteenweg 2,2023-01-29,13:00:00,26,19,7,ECO_300019380
642,Herenthoutsesteenweg 2,2023-01-29,14:00:00,43,34,9,ECO_300019380
642,Herenthoutsesteenweg 2,2023-01-29,15:00:00,36,33,3,ECO_300019380
642,Herenthoutsesteenweg 2,2023-01-29,16:00:00,22,19,3,ECO_300019380
642,Herenthoutsesteenweg 2,2023-01-29,17:00:00,30,29,1,ECO_300019380
642,Herenthoutsesteenweg 2,2023-01-29,18:00:00,23,22,1,ECO_300019380
642,Herenthoutsesteenweg 2,2023-01-29,19:00:00,17,14,3,ECO_300019380
642,Herenthoutsesteenweg 2,2023-01-29,20:00:00,10,10,0,ECO_300019380
642,Herenthoutsesteenweg 2,2023-01-29,21:00:00,3,1,2,ECO_300019380
642,Herenthoutsesteenweg 2,2023-01-29,22:00:00,7,7,0,ECO_300019380
642,Herenthoutsesteenweg 2,2023-01-29,23:00:00,7,7,0,ECO_300019380
642,Herenthoutsesteenweg 2,2023-01-30,00:00:00,2,0,2,ECO_300019380
642,Herenthoutsesteenweg 2,2023-01-30,01:00:00,0,0,0,ECO_300019380
642,Herenthoutsesteenweg 2,2023-01-30,02:00:00,0,0,0,ECO_300019380
642,Herenthoutsesteenweg 2,2023-01-30,03:00:00,0,0,0,ECO_300019380
642,Herenthoutsesteenweg 2,2023-01-30,04:00:00,0,0,0,ECO_300019380
642,Herenthoutsesteenweg 2,2023-01-30,05:00:00,2,2,0,ECO_300019380
642,Herenthoutsesteenweg 2,2023-01-30,06:00:00,17,16,1,ECO_300019380
642,Herenthoutsesteenweg 2,2023-01-30,07:00:00,36,35,1,ECO_300019380
642,Herenthoutsesteenweg 2,2023-01-30,08:00:00,106,101,5,ECO_300019380
642,Herenthoutsesteenweg 2,2023-01-30,09:00:00,500,485,15,ECO_300019380
642,Herenthoutsesteenweg 2,2023-01-30,10:00:00,63,63,0,ECO_300019380
642,Herenthoutsesteenweg 2,2023-01-30,11:00:00,46,45,1,ECO_300019380
642,Herenthoutsesteenweg 2,2023-01-30,12:00:00,34,33,1,ECO_300019380
642,Herenthoutsesteenweg 2,2023-01-30,13:00:00,65,58,7,ECO_300019380
642,Herenthoutsesteenweg 2,2023-01-30,14:00:00,58,54,4,ECO_300019380
642,Herenthoutsesteenweg 2,2023-01-30,15:00:00,55,55,0,ECO_300019380
642,Herenthoutsesteenweg 2,2023-01-30,16:00:00,66,56,10,ECO_300019380
642,Herenthoutsesteenweg 2,2023-01-30,17:00:00,106,99,7,ECO_300019380
642,Herenthoutsesteenweg 2,2023-01-30,18:00:00,57,52,5,ECO_300019380
642,Herenthoutsesteenweg 2,2023-01-30,19:00:00,39,34,5,ECO_300019380
642,Herenthoutsesteenweg 2,2023-01-30,20:00:00,21,19,2,ECO_300019380
642,Herenthoutsesteenweg 2,2023-01-30,21:00:00,13,13,0,ECO_300019380
642,Herenthoutsesteenweg 2,2023-01-30,22:00:00,19,15,4,ECO_300019380
642,Herenthoutsesteenweg 2,2023-01-30,23:00:00,14,13,1,ECO_300019380
642,Herenthoutsesteenweg 2,2023-01-31,00:00:00,1,0,1,ECO_300019380
642,Herenthoutsesteenweg 2,2023-01-31,01:00:00,0,0,0,ECO_300019380
642,Herenthoutsesteenweg 2,2023-01-31,02:00:00,0,0,0,ECO_300019380
642,Herenthoutsesteenweg 2,2023-01-31,03:00:00,0,0,0,ECO_300019380
642,Herenthoutsesteenweg 2,2023-01-31,04:00:00,0,0,0,ECO_300019380
642,Herenthoutsesteenweg 2,2023-01-31,05:00:00,1,1,0,ECO_300019380
642,Herenthoutsesteenweg 2,2023-01-31,06:00:00,16,14,2,ECO_300019380
642,Herenthoutsesteenweg 2,2023-01-31,07:00:00,42,37,5,ECO_300019380
642,Herenthoutsesteenweg 2,2023-01-31,08:00:00,127,125,2,ECO_300019380
642,Herenthoutsesteenweg 2,2023-01-31,09:00:00,488,483,5,ECO_300019380
642,Herenthoutsesteenweg 2,2023-01-31,10:00:00,65,63,2,ECO_300019380
642,Herenthoutsesteenweg 2,2023-01-31,11:00:00,47,44,3,ECO_300019380
642,Herenthoutsesteenweg 2,2023-01-31,12:00:00,38,33,5,ECO_300019380
642,Herenthoutsesteenweg 2,2023-01-31,13:00:00,46,42,4,ECO_300019380
642,Herenthoutsesteenweg 2,2023-01-31,14:00:00,68,65,3,ECO_300019380
642,Herenthoutsesteenweg 2,2023-01-31,15:00:00,70,65,5,ECO_300019380
642,Herenthoutsesteenweg 2,2023-01-31,16:00:00,60,55,5,ECO_300019380
642,Herenthoutsesteenweg 2,2023-01-31,17:00:00,92,85,7,ECO_300019380
642,Herenthoutsesteenweg 2,2023-01-31,18:00:00,58,51,7,ECO_300019380
642,Herenthoutsesteenweg 2,2023-01-31,19:00:00,36,33,3,ECO_300019380
642,Herenthoutsesteenweg 2,2023-01-31,20:00:00,21,20,1,ECO_300019380
642,Herenthoutsesteenweg 2,2023-01-31,21:00:00,18,17,1,ECO_300019380
642,Herenthoutsesteenweg 2,2023-01-31,22:00:00,7,5,2,ECO_300019380
642,Herenthoutsesteenweg 2,2023-01-31,23:00:00,9,8,1,ECO_300019380
642,Herenthoutsesteenweg 2,2023-02-01,00:00:00,5,5,0,ECO_300019380
642,Herenthoutsesteenweg 2,2023-02-01,01:00:00,2,2,0,ECO_300019380
642,Herenthoutsesteenweg 2,2023-02-01,02:00:00,0,0,0,ECO_300019380
642,Herenthoutsesteenweg 2,2023-02-01,03:00:00,0,0,0,ECO_300019380
642,Herenthoutsesteenweg 2,2023-02-01,04:00:00,1,1,0,ECO_300019380
642,Herenthoutsesteenweg 2,2023-02-01,05:00:00,1,1,0,ECO_300019380
642,Herenthoutsesteenweg 2,2023-02-01,06:00:00,17,17,0,ECO_300019380
642,Herenthoutsesteenweg 2,2023-02-01,07:00:00,42,38,4,ECO_300019380
642,Herenthoutsesteenweg 2,2023-02-01,08:00:00,123,121,2,ECO_300019380
642,Herenthoutsesteenweg 2,2023-02-01,09:00:00,463,461,2,ECO_300019380
642,Herenthoutsesteenweg 2,2023-02-01,10:00:00,67,65,2,ECO_300019380
642,Herenthoutsesteenweg 2,2023-02-01,11:00:00,51,51,0,ECO_300019380
642,Herenthoutsesteenweg 2,2023-02-01,12:00:00,43,40,3,ECO_300019380
642,Herenthoutsesteenweg 2,2023-02-01,13:00:00,93,87,6,ECO_300019380
642,Herenthoutsesteenweg 2,2023-02-01,14:00:00,98,97,1,ECO_300019380
642,Herenthoutsesteenweg 2,2023-02-01,15:00:00,84,80,4,ECO_300019380
642,Herenthoutsesteenweg 2,2023-02-01,16:00:00,50,46,4,ECO_300019380
642,Herenthoutsesteenweg 2,2023-02-01,17:00:00,98,90,8,ECO_300019380
642,Herenthoutsesteenweg 2,2023-02-01,18:00:00,47,41,6,ECO_300019380
642,Herenthoutsesteenweg 2,2023-02-01,19:00:00,39,34,5,ECO_300019380
642,Herenthoutsesteenweg 2,2023-02-01,20:00:00,25,24,1,ECO_300019380
642,Herenthoutsesteenweg 2,2023-02-01,21:00:00,28,27,1,ECO_300019380
642,Herenthoutsesteenweg 2,2023-02-01,22:00:00,31,30,1,ECO_300019380
642,Herenthoutsesteenweg 2,2023-02-01,23:00:00,20,17,3,ECO_300019380
642,Herenthoutsesteenweg 2,2023-02-02,00:00:00,1,1,0,ECO_300019380
642,Herenthoutsesteenweg 2,2023-02-02,01:00:00,1,1,0,ECO_300019380
642,Herenthoutsesteenweg 2,2023-02-02,02:00:00,4,3,1,ECO_300019380
642,Herenthoutsesteenweg 2,2023-02-02,03:00:00,3,1,2,ECO_300019380
642,Herenthoutsesteenweg 2,2023-02-02,04:00:00,2,0,2,ECO_300019380
642,Herenthoutsesteenweg 2,2023-02-02,05:00:00,2,2,0,ECO_300019380
642,Herenthoutsesteenweg 2,2023-02-02,06:00:00,22,22,0,ECO_300019380
642,Herenthoutsesteenweg 2,2023-02-02,07:00:00,40,38,2,ECO_300019380
642,Herenthoutsesteenweg 2,2023-02-02,08:00:00,129,126,3,ECO_300019380
642,Herenthoutsesteenweg 2,2023-02-02,09:00:00,455,448,7,ECO_300019380
642,Herenthoutsesteenweg 2,2023-02-02,10:00:00,73,71,2,ECO_300019380
642,Herenthoutsesteenweg 2,2023-02-02,11:00:00,40,38,2,ECO_300019380
642,Herenthoutsesteenweg 2,2023-02-02,12:00:00,55,52,3,ECO_300019380
642,Herenthoutsesteenweg 2,2023-02-02,13:00:00,46,42,4,ECO_300019380
642,Herenthoutsesteenweg 2,2023-02-02,14:00:00,52,49,3,ECO_300019380
642,Herenthoutsesteenweg 2,2023-02-02,15:00:00,49,45,4,ECO_300019380
642,Herenthoutsesteenweg 2,2023-02-02,16:00:00,71,61,10,ECO_300019380
642,Herenthoutsesteenweg 2,2023-02-02,17:00:00,104,94,10,ECO_300019380
642,Herenthoutsesteenweg 2,2023-02-02,18:00:00,46,43,3,ECO_300019380
642,Herenthoutsesteenweg 2,2023-02-02,19:00:00,58,53,5,ECO_300019380
642,Herenthoutsesteenweg 2,2023-02-02,20:00:00,32,32,0,ECO_300019380
642,Herenthoutsesteenweg 2,2023-02-02,21:00:00,15,12,3,ECO_300019380
642,Herenthoutsesteenweg 2,2023-02-02,22:00:00,6,5,1,ECO_300019380
642,Herenthoutsesteenweg 2,2023-02-02,23:00:00,14,11,3,ECO_300019380
642,Herenthoutsesteenweg 2,2023-02-03,00:00:00,3,2,1,ECO_300019380
642,Herenthoutsesteenweg 2,2023-02-03,01:00:00,4,3,1,ECO_300019380
642,Herenthoutsesteenweg 2,2023-02-03,02:00:00,0,0,0,ECO_300019380
642,Herenthoutsesteenweg 2,2023-02-03,03:00:00,0,0,0,ECO_300019380
642,Herenthoutsesteenweg 2,2023-02-03,04:00:00,0,0,0,ECO_300019380
642,Herenthoutsesteenweg 2,2023-02-03,05:00:00,2,2,0,ECO_300019380
642,Herenthoutsesteenweg 2,2023-02-03,06:00:00,16,16,0,ECO_300019380
642,Herenthoutsesteenweg 2,2023-02-03,07:00:00,32,27,5,ECO_300019380
642,Herenthoutsesteenweg 2,2023-02-03,08:00:00,96,91,5,ECO_300019380
642,Herenthoutsesteenweg 2,2023-02-03,09:00:00,182,179,3,ECO_300019380
642,Herenthoutsesteenweg 2,2023-02-03,10:00:00,70,68,2,ECO_300019380
642,Herenthoutsesteenweg 2,2023-02-03,11:00:00,85,84,1,ECO_300019380
642,Herenthoutsesteenweg 2,2023-02-03,12:00:00,55,52,3,ECO_300019380
642,Herenthoutsesteenweg 2,2023-02-03,13:00:00,68,62,6,ECO_300019380
642,Herenthoutsesteenweg 2,2023-02-03,14:00:00,70,64,6,ECO_300019380
642,Herenthoutsesteenweg 2,2023-02-03,15:00:00,66,63,3,ECO_300019380
642,Herenthoutsesteenweg 2,2023-02-03,16:00:00,92,84,8,ECO_300019380
642,Herenthoutsesteenweg 2,2023-02-03,17:00:00,130,118,12,ECO_300019380
642,Herenthoutsesteenweg 2,2023-02-03,18:00:00,43,37,6,ECO_300019380
642,Herenthoutsesteenweg 2,2023-02-03,19:00:00,37,31,6,ECO_300019380
642,Herenthoutsesteenweg 2,2023-02-03,20:00:00,20,17,3,ECO_300019380
642,Herenthoutsesteenweg 2,2023-02-03,21:00:00,19,18,1,ECO_300019380
642,Herenthoutsesteenweg 2,2023-02-03,22:00:00,10,10,0,ECO_300019380
642,Herenthoutsesteenweg 2,2023-02-03,23:00:00,12,8,4,ECO_300019380
642,Herenthoutsesteenweg 2,2023-02-04,00:00:00,8,5,3,ECO_300019380
642,Herenthoutsesteenweg 2,2023-02-04,01:00:00,6,5,1,ECO_300019380
642,Herenthoutsesteenweg 2,2023-02-04,02:00:00,4,4,0,ECO_300019380
642,Herenthoutsesteenweg 2,2023-02-04,03:00:00,2,1,1,ECO_300019380
642,Herenthoutsesteenweg 2,2023-02-04,04:00:00,4,2,2,ECO_300019380
642,Herenthoutsesteenweg 2,2023-02-04,05:00:00,2,2,0,ECO_300019380
642,Herenthoutsesteenweg 2,2023-02-04,06:00:00,3,1,2,ECO_300019380
642,Herenthoutsesteenweg 2,2023-02-04,07:00:00,12,12,0,ECO_300019380
642,Herenthoutsesteenweg 2,2023-02-04,08:00:00,11,9,2,ECO_300019380
642,Herenthoutsesteenweg 2,2023-02-04,09:00:00,28,27,1,ECO_300019380
642,Herenthoutsesteenweg 2,2023-02-04,10:00:00,60,55,5,ECO_300019380
642,Herenthoutsesteenweg 2,2023-02-04,11:00:00,61,60,1,ECO_300019380
642,Herenthoutsesteenweg 2,2023-02-04,12:00:00,56,43,13,ECO_300019380
642,Herenthoutsesteenweg 2,2023-02-04,13:00:00,71,58,13,ECO_300019380
642,Herenthoutsesteenweg 2,2023-02-04,14:00:00,47,42,5,ECO_300019380
642,Herenthoutsesteenweg 2,2023-02-04,15:00:00,45,39,6,ECO_300019380
642,Herenthoutsesteenweg 2,2023-02-04,16:00:00,26,22,4,ECO_300019380
642,Herenthoutsesteenweg 2,2023-02-04,17:00:00,18,17,1,ECO_300019380
642,Herenthoutsesteenweg 2,2023-02-04,18:00:00,21,19,2,ECO_300019380
642,Herenthoutsesteenweg 2,2023-02-04,19:00:00,29,26,3,ECO_300019380
642,Herenthoutsesteenweg 2,2023-02-04,20:00:00,24,23,1,ECO_300019380
642,Herenthoutsesteenweg 2,2023-02-04,21:00:00,28,23,5,ECO_300019380
642,Herenthoutsesteenweg 2,2023-02-04,22:00:00,6,6,0,ECO_300019380
642,Herenthoutsesteenweg 2,2023-02-04,23:00:00,2,2,0,ECO_300019380
642,Herenthoutsesteenweg 2,2023-02-05,00:00:00,10,7,3,ECO_300019380
642,Herenthoutsesteenweg 2,2023-02-05,01:00:00,5,4,1,ECO_300019380
642,Herenthoutsesteenweg 2,2023-02-05,02:00:00,6,5,1,ECO_300019380
642,Herenthoutsesteenweg 2,2023-02-05,03:00:00,3,2,1,ECO_300019380
642,Herenthoutsesteenweg 2,2023-02-05,04:00:00,2,2,0,ECO_300019380
642,Herenthoutsesteenweg 2,2023-02-05,05:00:00,1,1,0,ECO_300019380
642,Herenthoutsesteenweg 2,2023-02-05,06:00:00,0,0,0,ECO_300019380
642,Herenthoutsesteenweg 2,2023-02-05,07:00:00,6,6,0,ECO_300019380
642,Herenthoutsesteenweg 2,2023-02-05,08:00:00,8,7,1,ECO_300019380
642,Herenthoutsesteenweg 2,2023-02-05,09:00:00,38,35,3,ECO_300019380
642,Herenthoutsesteenweg 2,2023-02-05,10:00:00,77,75,2,ECO_300019380
642,Herenthoutsesteenweg 2,2023-02-05,11:00:00,52,40,12,ECO_300019380
642,Herenthoutsesteenweg 2,2023-02-05,12:00:00,41,36,5,ECO_300019380
642,Herenthoutsesteenweg 2,2023-02-05,13:00:00,29,24,5,ECO_300019380
642,Herenthoutsesteenweg 2,2023-02-05,14:00:00,47,41,6,ECO_300019380
642,Herenthoutsesteenweg 2,2023-02-05,15:00:00,39,37,2,ECO_300019380
642,Herenthoutsesteenweg 2,2023-02-05,16:00:00,20,17,3,ECO_300019380
642,Herenthoutsesteenweg 2,2023-02-05,17:00:00,33,28,5,ECO_300019380
642,Herenthoutsesteenweg 2,2023-02-05,18:00:00,32,27,5,ECO_300019380
642,Herenthoutsesteenweg 2,2023-02-05,19:00:00,17,12,5,ECO_300019380
642,Herenthoutsesteenweg 2,2023-02-05,20:00:00,17,14,3,ECO_300019380
642,Herenthoutsesteenweg 2,2023-02-05,21:00:00,11,9,2,ECO_300019380
642,Herenthoutsesteenweg 2,2023-02-05,22:00:00,4,2,2,ECO_300019380
642,Herenthoutsesteenweg 2,2023-02-05,23:00:00,4,4,0,ECO_300019380
642,Herenthoutsesteenweg 2,2023-02-06,00:00:00,0,0,0,ECO_300019380
642,Herenthoutsesteenweg 2,2023-02-06,01:00:00,0,0,0,ECO_300019380
642,Herenthoutsesteenweg 2,2023-02-06,02:00:00,0,0,0,ECO_300019380
642,Herenthoutsesteenweg 2,2023-02-06,03:00:00,1,1,0,ECO_300019380
642,Herenthoutsesteenweg 2,2023-02-06,04:00:00,3,3,0,ECO_300019380
642,Herenthoutsesteenweg 2,2023-02-06,05:00:00,2,2,0,ECO_300019380
642,Herenthoutsesteenweg 2,2023-02-06,06:00:00,24,22,2,ECO_300019380
642,Herenthoutsesteenweg 2,2023-02-06,07:00:00,38,36,2,ECO_300019380
642,Herenthoutsesteenweg 2,2023-02-06,08:00:00,107,104,3,ECO_300019380
642,Herenthoutsesteenweg 2,2023-02-06,09:00:00,481,476,5,ECO_300019380
642,Herenthoutsesteenweg 2,2023-02-06,10:00:00,58,58,0,ECO_300019380
642,Herenthoutsesteenweg 2,2023-02-06,11:00:00,50,48,2,ECO_300019380
642,Herenthoutsesteenweg 2,2023-02-06,12:00:00,51,44,7,ECO_300019380
642,Herenthoutsesteenweg 2,2023-02-06,13:00:00,68,61,7,ECO_300019380
642,Herenthoutsesteenweg 2,2023-02-06,14:00:00,118,111,7,ECO_300019380
642,Herenthoutsesteenweg 2,2023-02-06,15:00:00,80,74,6,ECO_300019380
642,Herenthoutsesteenweg 2,2023-02-06,16:00:00,65,55,10,ECO_300019380
642,Herenthoutsesteenweg 2,2023-02-06,17:00:00,98,92,6,ECO_300019380
642,Herenthoutsesteenweg 2,2023-02-06,18:00:00,57,50,7,ECO_300019380
642,Herenthoutsesteenweg 2,2023-02-06,19:00:00,42,38,4,ECO_300019380
642,Herenthoutsesteenweg 2,2023-02-06,20:00:00,29,28,1,ECO_300019380
642,Herenthoutsesteenweg 2,2023-02-06,21:00:00,14,12,2,ECO_300019380
642,Herenthoutsesteenweg 2,2023-02-06,22:00:00,7,7,0,ECO_300019380
642,Herenthoutsesteenweg 2,2023-02-06,23:00:00,18,15,3,ECO_300019380
642,Herenthoutsesteenweg 2,2023-02-07,00:00:00,5,1,4,ECO_300019380
642,Herenthoutsesteenweg 2,2023-02-07,01:00:00,2,1,1,ECO_300019380
642,Herenthoutsesteenweg 2,2023-02-07,02:00:00,0,0,0,ECO_300019380
642,Herenthoutsesteenweg 2,2023-02-07,03:00:00,0,0,0,ECO_300019380
642,Herenthoutsesteenweg 2,2023-02-07,04:00:00,2,2,0,ECO_300019380
642,Herenthoutsesteenweg 2,2023-02-07,05:00:00,3,3,0,ECO_300019380
642,Herenthoutsesteenweg 2,2023-02-07,06:00:00,15,15,0,ECO_300019380
642,Herenthoutsesteenweg 2,2023-02-07,07:00:00,45,43,2,ECO_300019380
642,Herenthoutsesteenweg 2,2023-02-07,08:00:00,154,148,6,ECO_300019380
642,Herenthoutsesteenweg 2,2023-02-07,09:00:00,506,499,7,ECO_300019380
642,Herenthoutsesteenweg 2,2023-02-07,10:00:00,60,57,3,ECO_300019380
642,Herenthoutsesteenweg 2,2023-02-07,11:00:00,47,46,1,ECO_300019380
642,Herenthoutsesteenweg 2,2023-02-07,12:00:00,51,44,7,ECO_300019380
642,Herenthoutsesteenweg 2,2023-02-07,13:00:00,65,61,4,ECO_300019380
642,Herenthoutsesteenweg 2,2023-02-07,14:00:00,99,93,6,ECO_300019380
642,Herenthoutsesteenweg 2,2023-02-07,15:00:00,92,84,8,ECO_300019380
642,Herenthoutsesteenweg 2,2023-02-07,16:00:00,102,85,17,ECO_300019380
642,Herenthoutsesteenweg 2,2023-02-07,17:00:00,120,106,14,ECO_300019380
642,Herenthoutsesteenweg 2,2023-02-07,18:00:00,59,52,7,ECO_300019380
642,Herenthoutsesteenweg 2,2023-02-07,19:00:00,45,40,5,ECO_300019380
642,Herenthoutsesteenweg 2,2023-02-07,20:00:00,17,17,0,ECO_300019380
642,Herenthoutsesteenweg 2,2023-02-07,21:00:00,12,8,4,ECO_300019380
642,Herenthoutsesteenweg 2,2023-02-07,22:00:00,9,8,1,ECO_300019380
642,Herenthoutsesteenweg 2,2023-02-07,23:00:00,17,17,0,ECO_300019380
642,Herenthoutsesteenweg 2,2023-02-08,00:00:00,1,1,0,ECO_300019380
642,Herenthoutsesteenweg 2,2023-02-08,01:00:00,0,0,0,ECO_300019380
642,Herenthoutsesteenweg 2,2023-02-08,02:00:00,0,0,0,ECO_300019380
642,Herenthoutsesteenweg 2,2023-02-08,03:00:00,0,0,0,ECO_300019380
642,Herenthoutsesteenweg 2,2023-02-08,04:00:00,2,2,0,ECO_300019380
642,Herenthoutsesteenweg 2,2023-02-08,05:00:00,0,0,0,ECO_300019380
642,Herenthoutsesteenweg 2,2023-02-08,06:00:00,17,16,1,ECO_300019380
642,Herenthoutsesteenweg 2,2023-02-08,07:00:00,51,44,7,ECO_300019380
642,Herenthoutsesteenweg 2,2023-02-08,08:00:00,112,111,1,ECO_300019380
642,Herenthoutsesteenweg 2,2023-02-08,09:00:00,486,476,10,ECO_300019380
642,Herenthoutsesteenweg 2,2023-02-08,10:00:00,57,54,3,ECO_300019380
642,Herenthoutsesteenweg 2,2023-02-08,11:00:00,46,45,1,ECO_300019380
642,Herenthoutsesteenweg 2,2023-02-08,12:00:00,42,38,4,ECO_300019380
642,Herenthoutsesteenweg 2,2023-02-08,13:00:00,114,108,6,ECO_300019380
642,Herenthoutsesteenweg 2,2023-02-08,14:00:00,103,92,11,ECO_300019380
642,Herenthoutsesteenweg 2,2023-02-08,15:00:00,104,92,12,ECO_300019380
642,Herenthoutsesteenweg 2,2023-02-08,16:00:00,80,62,18,ECO_300019380
642,Herenthoutsesteenweg 2,2023-02-08,17:00:00,94,85,9,ECO_300019380
642,Herenthoutsesteenweg 2,2023-02-08,18:00:00,62,54,8,ECO_300019380
642,Herenthoutsesteenweg 2,2023-02-08,19:00:00,47,44,3,ECO_300019380
642,Herenthoutsesteenweg 2,2023-02-08,20:00:00,17,16,1,ECO_300019380
642,Herenthoutsesteenweg 2,2023-02-08,21:00:00,11,8,3,ECO_300019380
642,Herenthoutsesteenweg 2,2023-02-08,22:00:00,13,11,2,ECO_300019380
642,Herenthoutsesteenweg 2,2023-02-08,23:00:00,16,15,1,ECO_300019380
642,Herenthoutsesteenweg 2,2023-02-09,00:00:00,4,4,0,ECO_300019380
642,Herenthoutsesteenweg 2,2023-02-09,01:00:00,1,1,0,ECO_300019380
642,Herenthoutsesteenweg 2,2023-02-09,02:00:00,1,1,0,ECO_300019380
642,Herenthoutsesteenweg 2,2023-02-09,03:00:00,1,0,1,ECO_300019380
642,Herenthoutsesteenweg 2,2023-02-09,04:00:00,0,0,0,ECO_300019380
642,Herenthoutsesteenweg 2,2023-02-09,05:00:00,1,1,0,ECO_300019380
642,Herenthoutsesteenweg 2,2023-02-09,06:00:00,14,13,1,ECO_300019380
642,Herenthoutsesteenweg 2,2023-02-09,07:00:00,32,30,2,ECO_300019380
642,Herenthoutsesteenweg 2,2023-02-09,08:00:00,135,127,8,ECO_300019380
642,Herenthoutsesteenweg 2,2023-02-09,09:00:00,473,461,12,ECO_300019380
642,Herenthoutsesteenweg 2,2023-02-09,10:00:00,81,76,5,ECO_300019380
642,Herenthoutsesteenweg 2,2023-02-09,11:00:00,52,48,4,ECO_300019380
642,Herenthoutsesteenweg 2,2023-02-09,12:00:00,48,43,5,ECO_300019380
642,Herenthoutsesteenweg 2,2023-02-09,13:00:00,58,55,3,ECO_300019380
642,Herenthoutsesteenweg 2,2023-02-09,14:00:00,78,74,4,ECO_300019380
642,Herenthoutsesteenweg 2,2023-02-09,15:00:00,62,60,2,ECO_300019380
642,Herenthoutsesteenweg 2,2023-02-09,16:00:00,87,75,12,ECO_300019380
642,Herenthoutsesteenweg 2,2023-02-09,17:00:00,95,90,5,ECO_300019380
642,Herenthoutsesteenweg 2,2023-02-09,18:00:00,44,37,7,ECO_300019380
642,Herenthoutsesteenweg 2,2023-02-09,19:00:00,41,39,2,ECO_300019380
642,Herenthoutsesteenweg 2,2023-02-09,20:00:00,41,40,1,ECO_300019380
642,Herenthoutsesteenweg 2,2023-02-09,21:00:00,11,8,3,ECO_300019380
642,Herenthoutsesteenweg 2,2023-02-09,22:00:00,7,5,2,ECO_300019380
642,Herenthoutsesteenweg 2,2023-02-09,23:00:00,14,14,0,ECO_300019380
642,Herenthoutsesteenweg 2,2023-02-10,00:00:00,4,2,2,ECO_300019380
642,Herenthoutsesteenweg 2,2023-02-10,01:00:00,2,0,2,ECO_300019380
642,Herenthoutsesteenweg 2,2023-02-10,02:00:00,1,1,0,ECO_300019380
642,Herenthoutsesteenweg 2,2023-02-10,03:00:00,0,0,0,ECO_300019380
642,Herenthoutsesteenweg 2,2023-02-10,04:00:00,1,1,0,ECO_300019380
642,Herenthoutsesteenweg 2,2023-02-10,05:00:00,2,2,0,ECO_300019380
642,Herenthoutsesteenweg 2,2023-02-10,06:00:00,15,15,0,ECO_300019380
642,Herenthoutsesteenweg 2,2023-02-10,07:00:00,25,23,2,ECO_300019380
642,Herenthoutsesteenweg 2,2023-02-10,08:00:00,116,111,5,ECO_300019380
642,Herenthoutsesteenweg 2,2023-02-10,09:00:00,500,493,7,ECO_300019380
642,Herenthoutsesteenweg 2,2023-02-10,10:00:00,110,106,4,ECO_300019380
642,Herenthoutsesteenweg 2,2023-02-10,11:00:00,70,68,2,ECO_300019380
642,Herenthoutsesteenweg 2,2023-02-10,12:00:00,57,56,1,ECO_300019380
642,Herenthoutsesteenweg 2,2023-02-10,13:00:00,75,71,4,ECO_300019380
642,Herenthoutsesteenweg 2,2023-02-10,14:00:00,80,75,5,ECO_300019380
642,Herenthoutsesteenweg 2,2023-02-10,15:00:00,77,66,11,ECO_300019380
642,Herenthoutsesteenweg 2,2023-02-10,16:00:00,92,84,8,ECO_300019380
642,Herenthoutsesteenweg 2,2023-02-10,17:00:00,94,89,5,ECO_300019380
642,Herenthoutsesteenweg 2,2023-02-10,18:00:00,47,41,6,ECO_300019380
642,Herenthoutsesteenweg 2,2023-02-10,19:00:00,50,49,1,ECO_300019380
642,Herenthoutsesteenweg 2,2023-02-10,20:00:00,20,19,1,ECO_300019380
642,Herenthoutsesteenweg 2,2023-02-10,21:00:00,21,21,0,ECO_300019380
642,Herenthoutsesteenweg 2,2023-02-10,22:00:00,18,17,1,ECO_300019380
642,Herenthoutsesteenweg 2,2023-02-10,23:00:00,23,22,1,ECO_300019380
642,Herenthoutsesteenweg 2,2023-02-11,00:00:00,11,9,2,ECO_300019380
642,Herenthoutsesteenweg 2,2023-02-11,01:00:00,9,8,1,ECO_300019380
642,Herenthoutsesteenweg 2,2023-02-11,02:00:00,7,4,3,ECO_300019380
642,Herenthoutsesteenweg 2,2023-02-11,03:00:00,7,3,4,ECO_300019380
642,Herenthoutsesteenweg 2,2023-02-11,04:00:00,2,1,1,ECO_300019380
642,Herenthoutsesteenweg 2,2023-02-11,05:00:00,0,0,0,ECO_300019380
642,Herenthoutsesteenweg 2,2023-02-11,06:00:00,2,2,0,ECO_300019380
642,Herenthoutsesteenweg 2,2023-02-11,07:00:00,12,11,1,ECO_300019380
642,Herenthoutsesteenweg 2,2023-02-11,08:00:00,9,9,0,ECO_300019380
642,Herenthoutsesteenweg 2,2023-02-11,09:00:00,32,29,3,ECO_300019380
642,Herenthoutsesteenweg 2,2023-02-11,10:00:00,58,54,4,ECO_300019380
642,Herenthoutsesteenweg 2,2023-02-11,11:00:00,70,67,3,ECO_300019380
642,Herenthoutsesteenweg 2,2023-02-11,12:00:00,87,79,8,ECO_300019380
642,Herenthoutsesteenweg 2,2023-02-11,13:00:00,89,86,3,ECO_300019380
642,Herenthoutsesteenweg 2,2023-02-11,14:00:00,95,88,7,ECO_300019380
642,Herenthoutsesteenweg 2,2023-02-11,15:00:00,75,63,12,ECO_300019380
642,Herenthoutsesteenweg 2,2023-02-11,16:00:00,77,69,8,ECO_300019380
642,Herenthoutsesteenweg 2,2023-02-11,17:00:00,59,55,4,ECO_300019380
642,Herenthoutsesteenweg 2,2023-02-11,18:00:00,51,45,6,ECO_300019380
642,Herenthoutsesteenweg 2,2023-02-11,19:00:00,33,30,3,ECO_300019380
642,Herenthoutsesteenweg 2,2023-02-11,20:00:00,17,16,1,ECO_300019380
642,Herenthoutsesteenweg 2,2023-02-11,21:00:00,16,14,2,ECO_300019380
642,Herenthoutsesteenweg 2,2023-02-11,22:00:00,34,33,1,ECO_300019380
642,Herenthoutsesteenweg 2,2023-02-11,23:00:00,50,49,1,ECO_300019380
642,Herenthoutsesteenweg 2,2023-02-12,00:00:00,28,27,1,ECO_300019380
642,Herenthoutsesteenweg 2,2023-02-12,01:00:00,12,9,3,ECO_300019380
642,Herenthoutsesteenweg 2,2023-02-12,02:00:00,6,3,3,ECO_300019380
642,Herenthoutsesteenweg 2,2023-02-12,03:00:00,1,1,0,ECO_300019380
642,Herenthoutsesteenweg 2,2023-02-12,04:00:00,9,2,7,ECO_300019380
642,Herenthoutsesteenweg 2,2023-02-12,05:00:00,0,0,0,ECO_300019380
642,Herenthoutsesteenweg 2,2023-02-12,06:00:00,4,3,1,ECO_300019380
642,Herenthoutsesteenweg 2,2023-02-12,07:00:00,4,4,0,ECO_300019380
642,Herenthoutsesteenweg 2,2023-02-12,08:00:00,12,12,0,ECO_300019380
642,Herenthoutsesteenweg 2,2023-02-12,09:00:00,30,29,1,ECO_300019380
642,Herenthoutsesteenweg 2,2023-02-12,10:00:00,66,58,8,ECO_300019380
642,Herenthoutsesteenweg 2,2023-02-12,11:00:00,77,73,4,ECO_300019380
642,Herenthoutsesteenweg 2,2023-02-12,12:00:00,62,54,8,ECO_300019380
642,Herenthoutsesteenweg 2,2023-02-12,13:00:00,49,39,10,ECO_300019380
642,Herenthoutsesteenweg 2,2023-02-12,14:00:00,45,39,6,ECO_300019380
642,Herenthoutsesteenweg 2,2023-02-12,15:00:00,63,53,10,ECO_300019380
642,Herenthoutsesteenweg 2,2023-02-12,16:00:00,36,32,4,ECO_300019380
642,Herenthoutsesteenweg 2,2023-02-12,17:00:00,38,32,6,ECO_300019380
642,Herenthoutsesteenweg 2,2023-02-12,18:00:00,26,26,0,ECO_300019380
642,Herenthoutsesteenweg 2,2023-02-12,19:00:00,36,36,0,ECO_300019380
642,Herenthoutsesteenweg 2,2023-02-12,20:00:00,6,5,1,ECO_300019380
642,Herenthoutsesteenweg 2,2023-02-12,21:00:00,7,5,2,ECO_300019380
642,Herenthoutsesteenweg 2,2023-02-12,22:00:00,2,1,1,ECO_300019380
642,Herenthoutsesteenweg 2,2023-02-12,23:00:00,9,8,1,ECO_300019380
642,Herenthoutsesteenweg 2,2023-02-13,00:00:00,2,2,0,ECO_300019380
642,Herenthoutsesteenweg 2,2023-02-13,01:00:00,0,0,0,ECO_300019380
642,Herenthoutsesteenweg 2,2023-02-13,02:00:00,0,0,0,ECO_300019380
642,Herenthoutsesteenweg 2,2023-02-13,03:00:00,0,0,0,ECO_300019380
642,Herenthoutsesteenweg 2,2023-02-13,04:00:00,0,0,0,ECO_300019380
642,Herenthoutsesteenweg 2,2023-02-13,05:00:00,4,3,1,ECO_300019380
642,Herenthoutsesteenweg 2,2023-02-13,06:00:00,19,19,0,ECO_300019380
642,Herenthoutsesteenweg 2,2023-02-13,07:00:00,47,44,3,ECO_300019380
642,Herenthoutsesteenweg 2,2023-02-13,08:00:00,144,138,6,ECO_300019380
642,Herenthoutsesteenweg 2,2023-02-13,09:00:00,509,506,3,ECO_300019380
642,Herenthoutsesteenweg 2,2023-02-13,10:00:00,50,48,2,ECO_300019380
642,Herenthoutsesteenweg 2,2023-02-13,11:00:00,53,49,4,ECO_300019380
642,Herenthoutsesteenweg 2,2023-02-13,12:00:00,55,51,4,ECO_300019380
642,Herenthoutsesteenweg 2,2023-02-13,13:00:00,79,74,5,ECO_300019380
642,Herenthoutsesteenweg 2,2023-02-13,14:00:00,88,86,2,ECO_300019380
642,Herenthoutsesteenweg 2,2023-02-13,15:00:00,123,118,5,ECO_300019380
642,Herenthoutsesteenweg 2,2023-02-13,16:00:00,99,89,10,ECO_300019380
642,Herenthoutsesteenweg 2,2023-02-13,17:00:00,110,104,6,ECO_300019380
642,Herenthoutsesteenweg 2,2023-02-13,18:00:00,79,69,10,ECO_300019380
642,Herenthoutsesteenweg 2,2023-02-13,19:00:00,42,39,3,ECO_300019380
642,Herenthoutsesteenweg 2,2023-02-13,20:00:00,33,32,1,ECO_300019380
642,Herenthoutsesteenweg 2,2023-02-13,21:00:00,18,17,1,ECO_300019380
642,Herenthoutsesteenweg 2,2023-02-13,22:00:00,8,6,2,ECO_300019380
642,Herenthoutsesteenweg 2,2023-02-13,23:00:00,15,13,2,ECO_300019380
642,Herenthoutsesteenweg 2,2023-02-14,00:00:00,4,0,4,ECO_300019380
642,Herenthoutsesteenweg 2,2023-02-14,01:00:00,1,0,1,ECO_300019380
642,Herenthoutsesteenweg 2,2023-02-14,02:00:00,0,0,0,ECO_300019380
642,Herenthoutsesteenweg 2,2023-02-14,03:00:00,0,0,0,ECO_300019380
642,Herenthoutsesteenweg 2,2023-02-14,04:00:00,0,0,0,ECO_300019380
642,Herenthoutsesteenweg 2,2023-02-14,05:00:00,3,3,0,ECO_300019380
642,Herenthoutsesteenweg 2,2023-02-14,06:00:00,13,13,0,ECO_300019380
642,Herenthoutsesteenweg 2,2023-02-14,07:00:00,48,44,4,ECO_300019380
642,Herenthoutsesteenweg 2,2023-02-14,08:00:00,156,146,10,ECO_300019380
642,Herenthoutsesteenweg 2,2023-02-14,09:00:00,514,506,8,ECO_300019380
642,Herenthoutsesteenweg 2,2023-02-14,10:00:00,98,96,2,ECO_300019380
642,Herenthoutsesteenweg 2,2023-02-14,11:00:00,62,61,1,ECO_300019380
642,Herenthoutsesteenweg 2,2023-02-14,12:00:00,59,54,5,ECO_300019380
642,Herenthoutsesteenweg 2,2023-02-14,13:00:00,69,65,4,ECO_300019380
642,Herenthoutsesteenweg 2,2023-02-14,14:00:00,153,146,7,ECO_300019380
642,Herenthoutsesteenweg 2,2023-02-14,15:00:00,129,115,14,ECO_300019380
642,Herenthoutsesteenweg 2,2023-02-14,16:00:00,144,125,19,ECO_300019380
642,Herenthoutsesteenweg 2,2023-02-14,17:00:00,146,137,9,ECO_300019380
642,Herenthoutsesteenweg 2,2023-02-14,18:00:00,86,77,9,ECO_300019380
642,Herenthoutsesteenweg 2,2023-02-14,19:00:00,47,42,5,ECO_300019380
642,Herenthoutsesteenweg 2,2023-02-14,20:00:00,32,29,3,ECO_300019380
642,Herenthoutsesteenweg 2,2023-02-14,21:00:00,14,11,3,ECO_300019380
642,Herenthoutsesteenweg 2,2023-02-14,22:00:00,12,9,3,ECO_300019380
642,Herenthoutsesteenweg 2,2023-02-14,23:00:00,17,16,1,ECO_300019380
642,Herenthoutsesteenweg 2,2023-02-15,00:00:00,4,3,1,ECO_300019380
642,Herenthoutsesteenweg 2,2023-02-15,01:00:00,4,3,1,ECO_300019380
642,Herenthoutsesteenweg 2,2023-02-15,02:00:00,0,0,0,ECO_300019380
642,Herenthoutsesteenweg 2,2023-02-15,03:00:00,1,0,1,ECO_300019380
642,Herenthoutsesteenweg 2,2023-02-15,04:00:00,0,0,0,ECO_300019380
642,Herenthoutsesteenweg 2,2023-02-15,05:00:00,5,4,1,ECO_300019380
642,Herenthoutsesteenweg 2,2023-02-15,06:00:00,23,19,4,ECO_300019380
642,Herenthoutsesteenweg 2,2023-02-15,07:00:00,45,39,6,ECO_300019380
642,Herenthoutsesteenweg 2,2023-02-15,08:00:00,136,131,5,ECO_300019380
642,Herenthoutsesteenweg 2,2023-02-15,09:00:00,500,487,13,ECO_300019380
642,Herenthoutsesteenweg 2,2023-02-15,10:00:00,63,59,4,ECO_300019380
642,Herenthoutsesteenweg 2,2023-02-15,11:00:00,71,67,4,ECO_300019380
642,Herenthoutsesteenweg 2,2023-02-15,12:00:00,68,64,4,ECO_300019380
642,Herenthoutsesteenweg 2,2023-02-15,13:00:00,114,103,11,ECO_300019380
642,Herenthoutsesteenweg 2,2023-02-15,14:00:00,156,153,3,ECO_300019380
642,Herenthoutsesteenweg 2,2023-02-15,15:00:00,138,114,24,ECO_300019380
642,Herenthoutsesteenweg 2,2023-02-15,16:00:00,99,86,13,ECO_300019380
642,Herenthoutsesteenweg 2,2023-02-15,17:00:00,157,142,15,ECO_300019380
642,Herenthoutsesteenweg 2,2023-02-15,18:00:00,92,84,8,ECO_300019380
642,Herenthoutsesteenweg 2,2023-02-15,19:00:00,37,32,5,ECO_300019380
642,Herenthoutsesteenweg 2,2023-02-15,20:00:00,26,25,1,ECO_300019380
642,Herenthoutsesteenweg 2,2023-02-15,21:00:00,20,17,3,ECO_300019380
642,Herenthoutsesteenweg 2,2023-02-15,22:00:00,18,14,4,ECO_300019380
642,Herenthoutsesteenweg 2,2023-02-15,23:00:00,15,12,3,ECO_300019380
642,Herenthoutsesteenweg 2,2023-02-16,00:00:00,6,5,1,ECO_300019380
642,Herenthoutsesteenweg 2,2023-02-16,01:00:00,5,5,0,ECO_300019380
642,Herenthoutsesteenweg 2,2023-02-16,02:00:00,2,2,0,ECO_300019380
642,Herenthoutsesteenweg 2,2023-02-16,03:00:00,0,0,0,ECO_300019380
642,Herenthoutsesteenweg 2,2023-02-16,04:00:00,0,0,0,ECO_300019380
642,Herenthoutsesteenweg 2,2023-02-16,05:00:00,4,4,0,ECO_300019380
642,Herenthoutsesteenweg 2,2023-02-16,06:00:00,20,18,2,ECO_300019380
642,Herenthoutsesteenweg 2,2023-02-16,07:00:00,48,40,8,ECO_300019380
642,Herenthoutsesteenweg 2,2023-02-16,08:00:00,144,140,4,ECO_300019380
642,Herenthoutsesteenweg 2,2023-02-16,09:00:00,516,502,14,ECO_300019380
642,Herenthoutsesteenweg 2,2023-02-16,10:00:00,71,69,2,ECO_300019380
642,Herenthoutsesteenweg 2,2023-02-16,11:00:00,40,38,2,ECO_300019380
642,Herenthoutsesteenweg 2,2023-02-16,12:00:00,33,29,4,ECO_300019380
642,Herenthoutsesteenweg 2,2023-02-16,13:00:00,44,41,3,ECO_300019380
642,Herenthoutsesteenweg 2,2023-02-16,14:00:00,70,67,3,ECO_300019380
642,Herenthoutsesteenweg 2,2023-02-16,15:00:00,57,53,4,ECO_300019380
642,Herenthoutsesteenweg 2,2023-02-16,16:00:00,97,89,8,ECO_300019380
642,Herenthoutsesteenweg 2,2023-02-16,17:00:00,85,80,5,ECO_300019380
642,Herenthoutsesteenweg 2,2023-02-16,18:00:00,62,58,4,ECO_300019380
642,Herenthoutsesteenweg 2,2023-02-16,19:00:00,28,24,4,ECO_300019380
642,Herenthoutsesteenweg 2,2023-02-16,20:00:00,23,19,4,ECO_300019380
642,Herenthoutsesteenweg 2,2023-02-16,21:00:00,10,9,1,ECO_300019380
642,Herenthoutsesteenweg 2,2023-02-16,22:00:00,11,9,2,ECO_300019380
642,Herenthoutsesteenweg 2,2023-02-16,23:00:00,14,12,2,ECO_300019380
642,Herenthoutsesteenweg 2,2023-02-17,00:00:00,5,5,0,ECO_300019380
642,Herenthoutsesteenweg 2,2023-02-17,01:00:00,2,2,0,ECO_300019380
642,Herenthoutsesteenweg 2,2023-02-17,02:00:00,1,0,1,ECO_300019380
642,Herenthoutsesteenweg 2,2023-02-17,03:00:00,0,0,0,ECO_300019380
642,Herenthoutsesteenweg 2,2023-02-17,04:00:00,0,0,0,ECO_300019380
642,Herenthoutsesteenweg 2,2023-02-17,05:00:00,1,1,0,ECO_300019380
642,Herenthoutsesteenweg 2,2023-02-17,06:00:00,18,16,2,ECO_300019380
642,Herenthoutsesteenweg 2,2023-02-17,07:00:00,33,28,5,ECO_300019380
642,Herenthoutsesteenweg 2,2023-02-17,08:00:00,121,116,5,ECO_300019380
642,Herenthoutsesteenweg 2,2023-02-17,09:00:00,499,487,12,ECO_300019380
642,Herenthoutsesteenweg 2,2023-02-17,10:00:00,83,81,2,ECO_300019380
642,Herenthoutsesteenweg 2,2023-02-17,11:00:00,60,57,3,ECO_300019380
642,Herenthoutsesteenweg 2,2023-02-17,12:00:00,45,45,0,ECO_300019380
642,Herenthoutsesteenweg 2,2023-02-17,13:00:00,65,58,7,ECO_300019380
642,Herenthoutsesteenweg 2,2023-02-17,14:00:00,56,52,4,ECO_300019380
642,Herenthoutsesteenweg 2,2023-02-17,15:00:00,74,70,4,ECO_300019380
642,Herenthoutsesteenweg 2,2023-02-17,16:00:00,80,72,8,ECO_300019380
642,Herenthoutsesteenweg 2,2023-02-17,17:00:00,73,68,5,ECO_300019380
642,Herenthoutsesteenweg 2,2023-02-17,18:00:00,55,46,9,ECO_300019380
642,Herenthoutsesteenweg 2,2023-02-17,19:00:00,45,43,2,ECO_300019380
642,Herenthoutsesteenweg 2,2023-02-17,20:00:00,30,27,3,ECO_300019380
642,Herenthoutsesteenweg 2,2023-02-17,21:00:00,20,20,0,ECO_300019380
642,Herenthoutsesteenweg 2,2023-02-17,22:00:00,19,17,2,ECO_300019380
642,Herenthoutsesteenweg 2,2023-02-17,23:00:00,13,10,3,ECO_300019380
642,Herenthoutsesteenweg 2,2023-02-18,00:00:00,9,5,4,ECO_300019380
642,Herenthoutsesteenweg 2,2023-02-18,01:00:00,4,0,4,ECO_300019380
642,Herenthoutsesteenweg 2,2023-02-18,02:00:00,14,11,3,ECO_300019380
642,Herenthoutsesteenweg 2,2023-02-18,03:00:00,4,3,1,ECO_300019380
642,Herenthoutsesteenweg 2,2023-02-18,04:00:00,1,0,1,ECO_300019380
642,Herenthoutsesteenweg 2,2023-02-18,05:00:00,1,1,0,ECO_300019380
642,Herenthoutsesteenweg 2,2023-02-18,06:00:00,2,1,1,ECO_300019380
642,Herenthoutsesteenweg 2,2023-02-18,07:00:00,4,4,0,ECO_300019380
642,Herenthoutsesteenweg 2,2023-02-18,08:00:00,4,4,0,ECO_300019380
642,Herenthoutsesteenweg 2,2023-02-18,09:00:00,41,39,2,ECO_300019380
642,Herenthoutsesteenweg 2,2023-02-18,10:00:00,48,37,11,ECO_300019380
642,Herenthoutsesteenweg 2,2023-02-18,11:00:00,52,47,5,ECO_300019380
642,Herenthoutsesteenweg 2,2023-02-18,12:00:00,48,45,3,ECO_300019380
642,Herenthoutsesteenweg 2,2023-02-18,13:00:00,48,43,5,ECO_300019380
642,Herenthoutsesteenweg 2,2023-02-18,14:00:00,64,58,6,ECO_300019380
642,Herenthoutsesteenweg 2,2023-02-18,15:00:00,63,61,2,ECO_300019380
642,Herenthoutsesteenweg 2,2023-02-18,16:00:00,42,39,3,ECO_300019380
642,Herenthoutsesteenweg 2,2023-02-18,17:00:00,38,29,9,ECO_300019380
642,Herenthoutsesteenweg 2,2023-02-18,18:00:00,25,22,3,ECO_300019380
642,Herenthoutsesteenweg 2,2023-02-18,19:00:00,27,25,2,ECO_300019380
642,Herenthoutsesteenweg 2,2023-02-18,20:00:00,39,37,2,ECO_300019380
642,Herenthoutsesteenweg 2,2023-02-18,21:00:00,15,12,3,ECO_300019380
642,Herenthoutsesteenweg 2,2023-02-18,22:00:00,14,12,2,ECO_300019380
642,Herenthoutsesteenweg 2,2023-02-18,23:00:00,9,9,0,ECO_300019380
642,Herenthoutsesteenweg 2,2023-02-19,00:00:00,6,5,1,ECO_300019380
642,Herenthoutsesteenweg 2,2023-02-19,01:00:00,4,4,0,ECO_300019380
642,Herenthoutsesteenweg 2,2023-02-19,02:00:00,2,1,1,ECO_300019380
642,Herenthoutsesteenweg 2,2023-02-19,03:00:00,4,3,1,ECO_300019380
642,Herenthoutsesteenweg 2,2023-02-19,04:00:00,9,9,0,ECO_300019380
642,Herenthoutsesteenweg 2,2023-02-19,05:00:00,5,4,1,ECO_300019380
642,Herenthoutsesteenweg 2,2023-02-19,06:00:00,2,2,0,ECO_300019380
642,Herenthoutsesteenweg 2,2023-02-19,07:00:00,3,3,0,ECO_300019380
642,Herenthoutsesteenweg 2,2023-02-19,08:00:00,28,26,2,ECO_300019380
642,Herenthoutsesteenweg 2,2023-02-19,09:00:00,56,54,2,ECO_300019380
642,Herenthoutsesteenweg 2,2023-02-19,10:00:00,77,72,5,ECO_300019380
642,Herenthoutsesteenweg 2,2023-02-19,11:00:00,75,69,6,ECO_300019380
642,Herenthoutsesteenweg 2,2023-02-19,12:00:00,58,48,10,ECO_300019380
642,Herenthoutsesteenweg 2,2023-02-19,13:00:00,40,34,6,ECO_300019380
642,Herenthoutsesteenweg 2,2023-02-19,14:00:00,30,22,8,ECO_300019380
642,Herenthoutsesteenweg 2,2023-02-19,15:00:00,45,41,4,ECO_300019380
642,Herenthoutsesteenweg 2,2023-02-19,16:00:00,24,21,3,ECO_300019380
642,Herenthoutsesteenweg 2,2023-02-19,17:00:00,29,27,2,ECO_300019380
642,Herenthoutsesteenweg 2,2023-02-19,18:00:00,41,38,3,ECO_300019380
642,Herenthoutsesteenweg 2,2023-02-19,19:00:00,14,12,2,ECO_300019380
642,Herenthoutsesteenweg 2,2023-02-19,20:00:00,17,16,1,ECO_300019380
642,Herenthoutsesteenweg 2,2023-02-19,21:00:00,8,8,0,ECO_300019380
642,Herenthoutsesteenweg 2,2023-02-19,22:00:00,12,10,2,ECO_300019380
642,Herenthoutsesteenweg 2,2023-02-19,23:00:00,3,3,0,ECO_300019380
642,Herenthoutsesteenweg 2,2023-02-20,00:00:00,3,2,1,ECO_300019380
642,Herenthoutsesteenweg 2,2023-02-20,01:00:00,1,1,0,ECO_300019380
642,Herenthoutsesteenweg 2,2023-02-20,02:00:00,1,0,1,ECO_300019380
642,Herenthoutsesteenweg 2,2023-02-20,03:00:00,0,0,0,ECO_300019380
642,Herenthoutsesteenweg 2,2023-02-20,04:00:00,1,1,0,ECO_300019380
642,Herenthoutsesteenweg 2,2023-02-20,05:00:00,3,3,0,ECO_300019380
642,Herenthoutsesteenweg 2,2023-02-20,06:00:00,15,15,0,ECO_300019380
642,Herenthoutsesteenweg 2,2023-02-20,07:00:00,43,37,6,ECO_300019380
642,Herenthoutsesteenweg 2,2023-02-20,08:00:00,82,74,8,ECO_300019380
642,Herenthoutsesteenweg 2,2023-02-20,09:00:00,65,61,4,ECO_300019380
642,Herenthoutsesteenweg 2,2023-02-20,10:00:00,57,54,3,ECO_300019380
642,Herenthoutsesteenweg 2,2023-02-20,11:00:00,57,52,5,ECO_300019380
642,Herenthoutsesteenweg 2,2023-02-20,12:00:00,61,57,4,ECO_300019380
642,Herenthoutsesteenweg 2,2023-02-20,13:00:00,58,51,7,ECO_300019380
642,Herenthoutsesteenweg 2,2023-02-20,14:00:00,61,56,5,ECO_300019380
642,Herenthoutsesteenweg 2,2023-02-20,15:00:00,82,75,7,ECO_300019380
642,Herenthoutsesteenweg 2,2023-02-20,16:00:00,50,44,6,ECO_300019380
642,Herenthoutsesteenweg 2,2023-02-20,17:00:00,97,89,8,ECO_300019380
642,Herenthoutsesteenweg 2,2023-02-20,18:00:00,62,54,8,ECO_300019380
642,Herenthoutsesteenweg 2,2023-02-20,19:00:00,35,32,3,ECO_300019380
642,Herenthoutsesteenweg 2,2023-02-20,20:00:00,26,24,2,ECO_300019380
642,Herenthoutsesteenweg 2,2023-02-20,21:00:00,11,10,1,ECO_300019380
642,Herenthoutsesteenweg 2,2023-02-20,22:00:00,14,12,2,ECO_300019380
642,Herenthoutsesteenweg 2,2023-02-20,23:00:00,17,15,2,ECO_300019380
642,Herenthoutsesteenweg 2,2023-02-21,00:00:00,3,1,2,ECO_300019380
642,Herenthoutsesteenweg 2,2023-02-21,01:00:00,0,0,0,ECO_300019380
642,Herenthoutsesteenweg 2,2023-02-21,02:00:00,2,1,1,ECO_300019380
642,Herenthoutsesteenweg 2,2023-02-21,03:00:00,2,2,0,ECO_300019380
642,Herenthoutsesteenweg 2,2023-02-21,04:00:00,3,3,0,ECO_300019380
642,Herenthoutsesteenweg 2,2023-02-21,05:00:00,4,4,0,ECO_300019380
642,Herenthoutsesteenweg 2,2023-02-21,06:00:00,17,15,2,ECO_300019380
642,Herenthoutsesteenweg 2,2023-02-21,07:00:00,49,43,6,ECO_300019380
642,Herenthoutsesteenweg 2,2023-02-21,08:00:00,80,76,4,ECO_300019380
642,Herenthoutsesteenweg 2,2023-02-21,09:00:00,49,45,4,ECO_300019380
642,Herenthoutsesteenweg 2,2023-02-21,10:00:00,43,43,0,ECO_300019380
642,Herenthoutsesteenweg 2,2023-02-21,11:00:00,55,50,5,ECO_300019380
642,Herenthoutsesteenweg 2,2023-02-21,12:00:00,39,35,4,ECO_300019380
642,Herenthoutsesteenweg 2,2023-02-21,13:00:00,58,49,9,ECO_300019380
642,Herenthoutsesteenweg 2,2023-02-21,14:00:00,83,77,6,ECO_300019380
642,Herenthoutsesteenweg 2,2023-02-21,15:00:00,60,54,6,ECO_300019380
642,Herenthoutsesteenweg 2,2023-02-21,16:00:00,77,68,9,ECO_300019380
642,Herenthoutsesteenweg 2,2023-02-21,17:00:00,85,79,6,ECO_300019380
642,Herenthoutsesteenweg 2,2023-02-21,18:00:00,58,54,4,ECO_300019380
642,Herenthoutsesteenweg 2,2023-02-21,19:00:00,30,26,4,ECO_300019380
642,Herenthoutsesteenweg 2,2023-02-21,20:00:00,22,20,2,ECO_300019380
642,Herenthoutsesteenweg 2,2023-02-21,21:00:00,18,17,1,ECO_300019380
642,Herenthoutsesteenweg 2,2023-02-21,22:00:00,7,6,1,ECO_300019380
642,Herenthoutsesteenweg 2,2023-02-21,23:00:00,19,17,2,ECO_300019380
642,Herenthoutsesteenweg 2,2023-02-22,00:00:00,1,1,0,ECO_300019380
642,Herenthoutsesteenweg 2,2023-02-22,01:00:00,1,1,0,ECO_300019380
642,Herenthoutsesteenweg 2,2023-02-22,02:00:00,0,0,0,ECO_300019380
642,Herenthoutsesteenweg 2,2023-02-22,03:00:00,0,0,0,ECO_300019380
642,Herenthoutsesteenweg 2,2023-02-22,04:00:00,1,1,0,ECO_300019380
642,Herenthoutsesteenweg 2,2023-02-22,05:00:00,1,1,0,ECO_300019380
642,Herenthoutsesteenweg 2,2023-02-22,06:00:00,12,10,2,ECO_300019380
642,Herenthoutsesteenweg 2,2023-02-22,07:00:00,32,26,6,ECO_300019380
642,Herenthoutsesteenweg 2,2023-02-22,08:00:00,76,72,4,ECO_300019380
642,Herenthoutsesteenweg 2,2023-02-22,09:00:00,57,53,4,ECO_300019380
642,Herenthoutsesteenweg 2,2023-02-22,10:00:00,53,46,7,ECO_300019380
642,Herenthoutsesteenweg 2,2023-02-22,11:00:00,61,55,6,ECO_300019380
642,Herenthoutsesteenweg 2,2023-02-22,12:00:00,39,35,4,ECO_300019380
642,Herenthoutsesteenweg 2,2023-02-22,13:00:00,45,41,4,ECO_300019380
642,Herenthoutsesteenweg 2,2023-02-22,14:00:00,76,75,1,ECO_300019380
642,Herenthoutsesteenweg 2,2023-02-22,15:00:00,55,52,3,ECO_300019380
642,Herenthoutsesteenweg 2,2023-02-22,16:00:00,48,47,1,ECO_300019380
642,Herenthoutsesteenweg 2,2023-02-22,17:00:00,68,61,7,ECO_300019380
642,Herenthoutsesteenweg 2,2023-02-22,18:00:00,65,61,4,ECO_300019380
642,Herenthoutsesteenweg 2,2023-02-22,19:00:00,42,40,2,ECO_300019380
642,Herenthoutsesteenweg 2,2023-02-22,20:00:00,14,11,3,ECO_300019380
642,Herenthoutsesteenweg 2,2023-02-22,21:00:00,15,13,2,ECO_300019380
642,Herenthoutsesteenweg 2,2023-02-22,22:00:00,8,5,3,ECO_300019380
642,Herenthoutsesteenweg 2,2023-02-22,23:00:00,31,26,5,ECO_300019380
642,Herenthoutsesteenweg 2,2023-02-23,00:00:00,4,3,1,ECO_300019380
642,Herenthoutsesteenweg 2,2023-02-23,01:00:00,2,2,0,ECO_300019380
642,Herenthoutsesteenweg 2,2023-02-23,02:00:00,0,0,0,ECO_300019380
642,Herenthoutsesteenweg 2,2023-02-23,03:00:00,2,2,0,ECO_300019380
642,Herenthoutsesteenweg 2,2023-02-23,04:00:00,0,0,0,ECO_300019380
642,Herenthoutsesteenweg 2,2023-02-23,05:00:00,1,1,0,ECO_300019380
642,Herenthoutsesteenweg 2,2023-02-23,06:00:00,12,9,3,ECO_300019380
642,Herenthoutsesteenweg 2,2023-02-23,07:00:00,32,29,3,ECO_300019380
642,Herenthoutsesteenweg 2,2023-02-23,08:00:00,71,68,3,ECO_300019380
642,Herenthoutsesteenweg 2,2023-02-23,09:00:00,67,64,3,ECO_300019380
642,Herenthoutsesteenweg 2,2023-02-23,10:00:00,39,39,0,ECO_300019380
642,Herenthoutsesteenweg 2,2023-02-23,11:00:00,41,40,1,ECO_300019380
642,Herenthoutsesteenweg 2,2023-02-23,12:00:00,55,52,3,ECO_300019380
642,Herenthoutsesteenweg 2,2023-02-23,13:00:00,58,51,7,ECO_300019380
642,Herenthoutsesteenweg 2,2023-02-23,14:00:00,85,82,3,ECO_300019380
642,Herenthoutsesteenweg 2,2023-02-23,15:00:00,73,70,3,ECO_300019380
642,Herenthoutsesteenweg 2,2023-02-23,16:00:00,53,46,7,ECO_300019380
642,Herenthoutsesteenweg 2,2023-02-23,17:00:00,91,86,5,ECO_300019380
642,Herenthoutsesteenweg 2,2023-02-23,18:00:00,44,39,5,ECO_300019380
642,Herenthoutsesteenweg 2,2023-02-23,19:00:00,39,34,5,ECO_300019380
642,Herenthoutsesteenweg 2,2023-02-23,20:00:00,36,33,3,ECO_300019380
642,Herenthoutsesteenweg 2,2023-02-23,21:00:00,18,12,6,ECO_300019380
642,Herenthoutsesteenweg 2,2023-02-23,22:00:00,10,9,1,ECO_300019380
642,Herenthoutsesteenweg 2,2023-02-23,23:00:00,14,12,2,ECO_300019380
642,Herenthoutsesteenweg 2,2023-02-24,00:00:00,3,1,2,ECO_300019380
642,Herenthoutsesteenweg 2,2023-02-24,01:00:00,4,2,2,ECO_300019380
642,Herenthoutsesteenweg 2,2023-02-24,02:00:00,1,1,0,ECO_300019380
642,Herenthoutsesteenweg 2,2023-02-24,03:00:00,3,2,1,ECO_300019380
642,Herenthoutsesteenweg 2,2023-02-24,04:00:00,3,3,0,ECO_300019380
642,Herenthoutsesteenweg 2,2023-02-24,05:00:00,3,2,1,ECO_300019380
642,Herenthoutsesteenweg 2,2023-02-24,06:00:00,11,9,2,ECO_300019380
642,Herenthoutsesteenweg 2,2023-02-24,07:00:00,35,30,5,ECO_300019380
642,Herenthoutsesteenweg 2,2023-02-24,08:00:00,60,55,5,ECO_300019380
642,Herenthoutsesteenweg 2,2023-02-24,09:00:00,74,68,6,ECO_300019380
642,Herenthoutsesteenweg 2,2023-02-24,10:00:00,73,71,2,ECO_300019380
642,Herenthoutsesteenweg 2,2023-02-24,11:00:00,73,68,5,ECO_300019380
642,Herenthoutsesteenweg 2,2023-02-24,12:00:00,55,52,3,ECO_300019380
642,Herenthoutsesteenweg 2,2023-02-24,13:00:00,59,55,4,ECO_300019380
642,Herenthoutsesteenweg 2,2023-02-24,14:00:00,60,57,3,ECO_300019380
642,Herenthoutsesteenweg 2,2023-02-24,15:00:00,54,47,7,ECO_300019380
642,Herenthoutsesteenweg 2,2023-02-24,16:00:00,52,46,6,ECO_300019380
642,Herenthoutsesteenweg 2,2023-02-24,17:00:00,81,74,7,ECO_300019380
642,Herenthoutsesteenweg 2,2023-02-24,18:00:00,60,53,7,ECO_300019380
642,Herenthoutsesteenweg 2,2023-02-24,19:00:00,31,31,0,ECO_300019380
642,Herenthoutsesteenweg 2,2023-02-24,20:00:00,28,24,4,ECO_300019380
642,Herenthoutsesteenweg 2,2023-02-24,21:00:00,41,38,3,ECO_300019380
642,Herenthoutsesteenweg 2,2023-02-24,22:00:00,29,26,3,ECO_300019380
642,Herenthoutsesteenweg 2,2023-02-24,23:00:00,15,13,2,ECO_300019380
642,Herenthoutsesteenweg 2,2023-02-25,00:00:00,12,12,0,ECO_300019380
642,Herenthoutsesteenweg 2,2023-02-25,01:00:00,2,1,1,ECO_300019380
642,Herenthoutsesteenweg 2,2023-02-25,02:00:00,7,5,2,ECO_300019380
642,Herenthoutsesteenweg 2,2023-02-25,03:00:00,2,1,1,ECO_300019380
642,Herenthoutsesteenweg 2,2023-02-25,04:00:00,4,0,4,ECO_300019380
642,Herenthoutsesteenweg 2,2023-02-25,05:00:00,11,8,3,ECO_300019380
642,Herenthoutsesteenweg 2,2023-02-25,06:00:00,4,3,1,ECO_300019380
642,Herenthoutsesteenweg 2,2023-02-25,07:00:00,12,12,0,ECO_300019380
642,Herenthoutsesteenweg 2,2023-02-25,08:00:00,10,9,1,ECO_300019380
642,Herenthoutsesteenweg 2,2023-02-25,09:00:00,25,23,2,ECO_300019380
642,Herenthoutsesteenweg 2,2023-02-25,10:00:00,48,38,10,ECO_300019380
642,Herenthoutsesteenweg 2,2023-02-25,11:00:00,63,58,5,ECO_300019380
642,Herenthoutsesteenweg 2,2023-02-25,12:00:00,65,59,6,ECO_300019380
642,Herenthoutsesteenweg 2,2023-02-25,13:00:00,66,59,7,ECO_300019380
642,Herenthoutsesteenweg 2,2023-02-25,14:00:00,90,87,3,ECO_300019380
642,Herenthoutsesteenweg 2,2023-02-25,15:00:00,84,74,10,ECO_300019380
642,Herenthoutsesteenweg 2,2023-02-25,16:00:00,62,43,19,ECO_300019380
642,Herenthoutsesteenweg 2,2023-02-25,17:00:00,35,24,11,ECO_300019380
642,Herenthoutsesteenweg 2,2023-02-25,18:00:00,25,22,3,ECO_300019380
642,Herenthoutsesteenweg 2,2023-02-25,19:00:00,33,23,10,ECO_300019380
642,Herenthoutsesteenweg 2,2023-02-25,20:00:00,23,18,5,ECO_300019380
642,Herenthoutsesteenweg 2,2023-02-25,21:00:00,20,14,6,ECO_300019380
642,Herenthoutsesteenweg 2,2023-02-25,22:00:00,23,15,8,ECO_300019380
642,Herenthoutsesteenweg 2,2023-02-25,23:00:00,10,5,5,ECO_300019380
642,Herenthoutsesteenweg 2,2023-02-26,00:00:00,12,9,3,ECO_300019380
642,Herenthoutsesteenweg 2,2023-02-26,01:00:00,9,3,6,ECO_300019380
642,Herenthoutsesteenweg 2,2023-02-26,02:00:00,9,5,4,ECO_300019380
642,Herenthoutsesteenweg 2,2023-02-26,03:00:00,11,8,3,ECO_300019380
642,Herenthoutsesteenweg 2,2023-02-26,04:00:00,4,3,1,ECO_300019380
642,Herenthoutsesteenweg 2,2023-02-26,05:00:00,0,0,0,ECO_300019380
642,Herenthoutsesteenweg 2,2023-02-26,06:00:00,0,0,0,ECO_300019380
642,Herenthoutsesteenweg 2,2023-02-26,07:00:00,7,7,0,ECO_300019380
642,Herenthoutsesteenweg 2,2023-02-26,08:00:00,14,14,0,ECO_300019380
642,Herenthoutsesteenweg 2,2023-02-26,09:00:00,34,32,2,ECO_300019380
642,Herenthoutsesteenweg 2,2023-02-26,10:00:00,67,65,2,ECO_300019380
642,Herenthoutsesteenweg 2,2023-02-26,11:00:00,89,83,6,ECO_300019380
642,Herenthoutsesteenweg 2,2023-02-26,12:00:00,69,51,18,ECO_300019380
642,Herenthoutsesteenweg 2,2023-02-26,13:00:00,68,54,14,ECO_300019380
642,Herenthoutsesteenweg 2,2023-02-26,14:00:00,40,38,2,ECO_300019380
642,Herenthoutsesteenweg 2,2023-02-26,15:00:00,42,37,5,ECO_300019380
642,Herenthoutsesteenweg 2,2023-02-26,16:00:00,34,31,3,ECO_300019380
642,Herenthoutsesteenweg 2,2023-02-26,17:00:00,29,25,4,ECO_300019380
642,Herenthoutsesteenweg 2,2023-02-26,18:00:00,35,32,3,ECO_300019380
642,Herenthoutsesteenweg 2,2023-02-26,19:00:00,12,11,1,ECO_300019380
642,Herenthoutsesteenweg 2,2023-02-26,20:00:00,7,7,0,ECO_300019380
642,Herenthoutsesteenweg 2,2023-02-26,21:00:00,10,9,1,ECO_300019380
642,Herenthoutsesteenweg 2,2023-02-26,22:00:00,4,3,1,ECO_300019380
642,Herenthoutsesteenweg 2,2023-02-26,23:00:00,5,5,0,ECO_300019380
642,Herenthoutsesteenweg 2,2023-02-27,00:00:00,1,0,1,ECO_300019380
642,Herenthoutsesteenweg 2,2023-02-27,01:00:00,0,0,0,ECO_300019380
642,Herenthoutsesteenweg 2,2023-02-27,02:00:00,3,2,1,ECO_300019380
642,Herenthoutsesteenweg 2,2023-02-27,03:00:00,0,0,0,ECO_300019380
642,Herenthoutsesteenweg 2,2023-02-27,04:00:00,1,1,0,ECO_300019380
642,Herenthoutsesteenweg 2,2023-02-27,05:00:00,2,2,0,ECO_300019380
642,Herenthoutsesteenweg 2,2023-02-27,06:00:00,18,17,1,ECO_300019380
642,Herenthoutsesteenweg 2,2023-02-27,07:00:00,44,37,7,ECO_300019380
642,Herenthoutsesteenweg 2,2023-02-27,08:00:00,136,131,5,ECO_300019380
642,Herenthoutsesteenweg 2,2023-02-27,09:00:00,504,499,5,ECO_300019380
642,Herenthoutsesteenweg 2,2023-02-27,10:00:00,64,62,2,ECO_300019380
642,Herenthoutsesteenweg 2,2023-02-27,11:00:00,52,51,1,ECO_300019380
642,Herenthoutsesteenweg 2,2023-02-27,12:00:00,52,43,9,ECO_300019380
642,Herenthoutsesteenweg 2,2023-02-27,13:00:00,53,48,5,ECO_300019380
642,Herenthoutsesteenweg 2,2023-02-27,14:00:00,82,79,3,ECO_300019380
642,Herenthoutsesteenweg 2,2023-02-27,15:00:00,72,64,8,ECO_300019380
642,Herenthoutsesteenweg 2,2023-02-27,16:00:00,67,63,4,ECO_300019380
642,Herenthoutsesteenweg 2,2023-02-27,17:00:00,114,99,15,ECO_300019380
642,Herenthoutsesteenweg 2,2023-02-27,18:00:00,69,59,10,ECO_300019380
642,Herenthoutsesteenweg 2,2023-02-27,19:00:00,46,41,5,ECO_300019380
642,Herenthoutsesteenweg 2,2023-02-27,20:00:00,27,27,0,ECO_300019380
642,Herenthoutsesteenweg 2,2023-02-27,21:00:00,7,6,1,ECO_300019380
642,Herenthoutsesteenweg 2,2023-02-27,22:00:00,16,13,3,ECO_300019380
642,Herenthoutsesteenweg 2,2023-02-27,23:00:00,12,10,2,ECO_300019380
642,Herenthoutsesteenweg 2,2023-02-28,00:00:00,4,3,1,ECO_300019380
642,Herenthoutsesteenweg 2,2023-02-28,01:00:00,0,0,0,ECO_300019380
642,Herenthoutsesteenweg 2,2023-02-28,02:00:00,1,1,0,ECO_300019380
642,Herenthoutsesteenweg 2,2023-02-28,03:00:00,0,0,0,ECO_300019380
642,Herenthoutsesteenweg 2,2023-02-28,04:00:00,0,0,0,ECO_300019380
642,Herenthoutsesteenweg 2,2023-02-28,05:00:00,3,2,1,ECO_300019380
642,Herenthoutsesteenweg 2,2023-02-28,06:00:00,17,17,0,ECO_300019380
642,Herenthoutsesteenweg 2,2023-02-28,07:00:00,46,40,6,ECO_300019380
642,Herenthoutsesteenweg 2,2023-02-28,08:00:00,149,144,5,ECO_300019380
642,Herenthoutsesteenweg 2,2023-02-28,09:00:00,520,516,4,ECO_300019380
642,Herenthoutsesteenweg 2,2023-02-28,10:00:00,77,74,3,ECO_300019380
642,Herenthoutsesteenweg 2,2023-02-28,11:00:00,50,47,3,ECO_300019380
642,Herenthoutsesteenweg 2,2023-02-28,12:00:00,38,32,6,ECO_300019380
642,Herenthoutsesteenweg 2,2023-02-28,13:00:00,54,52,2,ECO_300019380
642,Herenthoutsesteenweg 2,2023-02-28,14:00:00,71,65,6,ECO_300019380
642,Herenthoutsesteenweg 2,2023-02-28,15:00:00,69,61,8,ECO_300019380
642,Herenthoutsesteenweg 2,2023-02-28,16:00:00,88,78,10,ECO_300019380
642,Herenthoutsesteenweg 2,2023-02-28,17:00:00,120,107,13,ECO_300019380
642,Herenthoutsesteenweg 2,2023-02-28,18:00:00,69,58,11,ECO_300019380
642,Herenthoutsesteenweg 2,2023-02-28,19:00:00,37,34,3,ECO_300019380
642,Herenthoutsesteenweg 2,2023-02-28,20:00:00,34,31,3,ECO_300019380
642,Herenthoutsesteenweg 2,2023-02-28,21:00:00,19,17,2,ECO_300019380
642,Herenthoutsesteenweg 2,2023-02-28,22:00:00,15,10,5,ECO_300019380
642,Herenthoutsesteenweg 2,2023-02-28,23:00:00,12,9,3,ECO_300019380
642,Herenthoutsesteenweg 2,2023-03-01,00:00:00,4,4,0,ECO_300019380
642,Herenthoutsesteenweg 2,2023-03-01,01:00:00,0,0,0,ECO_300019380
642,Herenthoutsesteenweg 2,2023-03-01,02:00:00,0,0,0,ECO_300019380
642,Herenthoutsesteenweg 2,2023-03-01,03:00:00,2,0,2,ECO_300019380
642,Herenthoutsesteenweg 2,2023-03-01,04:00:00,0,0,0,ECO_300019380
642,Herenthoutsesteenweg 2,2023-03-01,05:00:00,4,4,0,ECO_300019380
642,Herenthoutsesteenweg 2,2023-03-01,06:00:00,17,15,2,ECO_300019380
642,Herenthoutsesteenweg 2,2023-03-01,07:00:00,44,38,6,ECO_300019380
642,Herenthoutsesteenweg 2,2023-03-01,08:00:00,116,112,4,ECO_300019380
642,Herenthoutsesteenweg 2,2023-03-01,09:00:00,439,433,6,ECO_300019380
642,Herenthoutsesteenweg 2,2023-03-01,10:00:00,73,73,0,ECO_300019380
642,Herenthoutsesteenweg 2,2023-03-01,11:00:00,66,65,1,ECO_300019380
642,Herenthoutsesteenweg 2,2023-03-01,12:00:00,35,32,3,ECO_300019380
642,Herenthoutsesteenweg 2,2023-03-01,13:00:00,118,105,13,ECO_300019380
642,Herenthoutsesteenweg 2,2023-03-01,14:00:00,100,96,4,ECO_300019380
642,Herenthoutsesteenweg 2,2023-03-01,15:00:00,94,87,7,ECO_300019380
642,Herenthoutsesteenweg 2,2023-03-01,16:00:00,68,57,11,ECO_300019380
642,Herenthoutsesteenweg 2,2023-03-01,17:00:00,114,107,7,ECO_300019380
642,Herenthoutsesteenweg 2,2023-03-01,18:00:00,59,54,5,ECO_300019380
642,Herenthoutsesteenweg 2,2023-03-01,19:00:00,39,38,1,ECO_300019380
642,Herenthoutsesteenweg 2,2023-03-01,20:00:00,34,31,3,ECO_300019380
642,Herenthoutsesteenweg 2,2023-03-01,21:00:00,14,12,2,ECO_300019380
642,Herenthoutsesteenweg 2,2023-03-01,22:00:00,13,11,2,ECO_300019380
642,Herenthoutsesteenweg 2,2023-03-01,23:00:00,21,15,6,ECO_300019380
642,Herenthoutsesteenweg 2,2023-03-02,00:00:00,0,0,0,ECO_300019380
642,Herenthoutsesteenweg 2,2023-03-02,01:00:00,1,1,0,ECO_300019380
642,Herenthoutsesteenweg 2,2023-03-02,02:00:00,1,1,0,ECO_300019380
642,Herenthoutsesteenweg 2,2023-03-02,03:00:00,0,0,0,ECO_300019380
642,Herenthoutsesteenweg 2,2023-03-02,04:00:00,0,0,0,ECO_300019380
642,Herenthoutsesteenweg 2,2023-03-02,05:00:00,3,2,1,ECO_300019380
642,Herenthoutsesteenweg 2,2023-03-02,06:00:00,16,15,1,ECO_300019380
642,Herenthoutsesteenweg 2,2023-03-02,07:00:00,43,37,6,ECO_300019380
642,Herenthoutsesteenweg 2,2023-03-02,08:00:00,162,152,10,ECO_300019380
642,Herenthoutsesteenweg 2,2023-03-02,09:00:00,503,485,18,ECO_300019380
642,Herenthoutsesteenweg 2,2023-03-02,10:00:00,71,68,3,ECO_300019380
642,Herenthoutsesteenweg 2,2023-03-02,11:00:00,56,53,3,ECO_300019380
642,Herenthoutsesteenweg 2,2023-03-02,12:00:00,69,63,6,ECO_300019380
642,Herenthoutsesteenweg 2,2023-03-02,13:00:00,72,67,5,ECO_300019380
642,Herenthoutsesteenweg 2,2023-03-02,14:00:00,111,103,8,ECO_300019380
642,Herenthoutsesteenweg 2,2023-03-02,15:00:00,96,83,13,ECO_300019380
642,Herenthoutsesteenweg 2,2023-03-02,16:00:00,105,86,19,ECO_300019380
642,Herenthoutsesteenweg 2,2023-03-02,17:00:00,118,106,12,ECO_300019380
642,Herenthoutsesteenweg 2,2023-03-02,18:00:00,82,70,12,ECO_300019380
642,Herenthoutsesteenweg 2,2023-03-02,19:00:00,42,38,4,ECO_300019380
642,Herenthoutsesteenweg 2,2023-03-02,20:00:00,25,24,1,ECO_300019380
642,Herenthoutsesteenweg 2,2023-03-02,21:00:00,8,8,0,ECO_300019380
642,Herenthoutsesteenweg 2,2023-03-02,22:00:00,11,6,5,ECO_300019380
642,Herenthoutsesteenweg 2,2023-03-02,23:00:00,19,16,3,ECO_300019380
642,Herenthoutsesteenweg 2,2023-03-03,00:00:00,0,0,0,ECO_300019380
642,Herenthoutsesteenweg 2,2023-03-03,01:00:00,0,0,0,ECO_300019380
642,Herenthoutsesteenweg 2,2023-03-03,02:00:00,2,2,0,ECO_300019380
642,Herenthoutsesteenweg 2,2023-03-03,03:00:00,0,0,0,ECO_300019380
642,Herenthoutsesteenweg 2,2023-03-03,04:00:00,0,0,0,ECO_300019380
642,Herenthoutsesteenweg 2,2023-03-03,05:00:00,5,5,0,ECO_300019380
642,Herenthoutsesteenweg 2,2023-03-03,06:00:00,17,17,0,ECO_300019380
642,Herenthoutsesteenweg 2,2023-03-03,07:00:00,35,29,6,ECO_300019380
642,Herenthoutsesteenweg 2,2023-03-03,08:00:00,119,114,5,ECO_300019380
642,Herenthoutsesteenweg 2,2023-03-03,09:00:00,515,500,15,ECO_300019380
642,Herenthoutsesteenweg 2,2023-03-03,10:00:00,87,83,4,ECO_300019380
642,Herenthoutsesteenweg 2,2023-03-03,11:00:00,75,74,1,ECO_300019380
642,Herenthoutsesteenweg 2,2023-03-03,12:00:00,52,49,3,ECO_300019380
642,Herenthoutsesteenweg 2,2023-03-03,13:00:00,46,43,3,ECO_300019380
642,Herenthoutsesteenweg 2,2023-03-03,14:00:00,61,54,7,ECO_300019380
642,Herenthoutsesteenweg 2,2023-03-03,15:00:00,85,78,7,ECO_300019380
642,Herenthoutsesteenweg 2,2023-03-03,16:00:00,126,111,15,ECO_300019380
642,Herenthoutsesteenweg 2,2023-03-03,17:00:00,115,104,11,ECO_300019380
642,Herenthoutsesteenweg 2,2023-03-03,18:00:00,82,71,11,ECO_300019380
642,Herenthoutsesteenweg 2,2023-03-03,19:00:00,56,52,4,ECO_300019380
642,Herenthoutsesteenweg 2,2023-03-03,20:00:00,38,37,1,ECO_300019380
642,Herenthoutsesteenweg 2,2023-03-03,21:00:00,23,21,2,ECO_300019380
642,Herenthoutsesteenweg 2,2023-03-03,22:00:00,12,11,1,ECO_300019380
642,Herenthoutsesteenweg 2,2023-03-03,23:00:00,29,21,8,ECO_300019380
642,Herenthoutsesteenweg 2,2023-03-04,00:00:00,8,8,0,ECO_300019380
642,Herenthoutsesteenweg 2,2023-03-04,01:00:00,8,3,5,ECO_300019380
642,Herenthoutsesteenweg 2,2023-03-04,02:00:00,4,1,3,ECO_300019380
642,Herenthoutsesteenweg 2,2023-03-04,03:00:00,1,0,1,ECO_300019380
642,Herenthoutsesteenweg 2,2023-03-04,04:00:00,2,1,1,ECO_300019380
642,Herenthoutsesteenweg 2,2023-03-04,05:00:00,3,1,2,ECO_300019380
642,Herenthoutsesteenweg 2,2023-03-04,06:00:00,0,0,0,ECO_300019380
642,Herenthoutsesteenweg 2,2023-03-04,07:00:00,10,10,0,ECO_300019380
642,Herenthoutsesteenweg 2,2023-03-04,08:00:00,10,10,0,ECO_300019380
642,Herenthoutsesteenweg 2,2023-03-04,09:00:00,28,26,2,ECO_300019380
642,Herenthoutsesteenweg 2,2023-03-04,10:00:00,65,64,1,ECO_300019380
642,Herenthoutsesteenweg 2,2023-03-04,11:00:00,66,65,1,ECO_300019380
642,Herenthoutsesteenweg 2,2023-03-04,12:00:00,79,77,2,ECO_300019380
642,Herenthoutsesteenweg 2,2023-03-04,13:00:00,51,44,7,ECO_300019380
642,Herenthoutsesteenweg 2,2023-03-04,14:00:00,74,72,2,ECO_300019380
642,Herenthoutsesteenweg 2,2023-03-04,15:00:00,60,53,7,ECO_300019380
642,Herenthoutsesteenweg 2,2023-03-04,16:00:00,52,49,3,ECO_300019380
642,Herenthoutsesteenweg 2,2023-03-04,17:00:00,31,26,5,ECO_300019380
642,Herenthoutsesteenweg 2,2023-03-04,18:00:00,27,25,2,ECO_300019380
642,Herenthoutsesteenweg 2,2023-03-04,19:00:00,22,22,0,ECO_300019380
642,Herenthoutsesteenweg 2,2023-03-04,20:00:00,42,40,2,ECO_300019380
642,Herenthoutsesteenweg 2,2023-03-04,21:00:00,20,20,0,ECO_300019380
642,Herenthoutsesteenweg 2,2023-03-04,22:00:00,11,10,1,ECO_300019380
642,Herenthoutsesteenweg 2,2023-03-04,23:00:00,4,2,2,ECO_300019380
642,Herenthoutsesteenweg 2,2023-03-05,00:00:00,8,6,2,ECO_300019380
642,Herenthoutsesteenweg 2,2023-03-05,01:00:00,16,16,0,ECO_300019380
642,Herenthoutsesteenweg 2,2023-03-05,02:00:00,5,4,1,ECO_300019380
642,Herenthoutsesteenweg 2,2023-03-05,03:00:00,2,0,2,ECO_300019380
642,Herenthoutsesteenweg 2,2023-03-05,04:00:00,1,1,0,ECO_300019380
642,Herenthoutsesteenweg 2,2023-03-05,05:00:00,1,0,1,ECO_300019380
642,Herenthoutsesteenweg 2,2023-03-05,06:00:00,1,1,0,ECO_300019380
642,Herenthoutsesteenweg 2,2023-03-05,07:00:00,9,9,0,ECO_300019380
642,Herenthoutsesteenweg 2,2023-03-05,08:00:00,10,10,0,ECO_300019380
642,Herenthoutsesteenweg 2,2023-03-05,09:00:00,48,42,6,ECO_300019380
642,Herenthoutsesteenweg 2,2023-03-05,10:00:00,77,66,11,ECO_300019380
642,Herenthoutsesteenweg 2,2023-03-05,11:00:00,58,55,3,ECO_300019380
642,Herenthoutsesteenweg 2,2023-03-05,12:00:00,67,48,19,ECO_300019380
642,Herenthoutsesteenweg 2,2023-03-05,13:00:00,25,18,7,ECO_300019380
642,Herenthoutsesteenweg 2,2023-03-05,14:00:00,25,23,2,ECO_300019380
642,Herenthoutsesteenweg 2,2023-03-05,15:00:00,49,43,6,ECO_300019380
642,Herenthoutsesteenweg 2,2023-03-05,16:00:00,15,14,1,ECO_300019380
642,Herenthoutsesteenweg 2,2023-03-05,17:00:00,23,21,2,ECO_300019380
642,Herenthoutsesteenweg 2,2023-03-05,18:00:00,18,17,1,ECO_300019380
642,Herenthoutsesteenweg 2,2023-03-05,19:00:00,14,13,1,ECO_300019380
642,Herenthoutsesteenweg 2,2023-03-05,20:00:00,12,11,1,ECO_300019380
642,Herenthoutsesteenweg 2,2023-03-05,21:00:00,8,6,2,ECO_300019380
642,Herenthoutsesteenweg 2,2023-03-05,22:00:00,5,3,2,ECO_300019380
642,Herenthoutsesteenweg 2,2023-03-05,23:00:00,2,2,0,ECO_300019380
642,Herenthoutsesteenweg 2,2023-03-06,00:00:00,1,1,0,ECO_300019380
642,Herenthoutsesteenweg 2,2023-03-06,01:00:00,2,2,0,ECO_300019380
642,Herenthoutsesteenweg 2,2023-03-06,02:00:00,1,0,1,ECO_300019380
642,Herenthoutsesteenweg 2,2023-03-06,03:00:00,1,1,0,ECO_300019380
642,Herenthoutsesteenweg 2,2023-03-06,04:00:00,2,2,0,ECO_300019380
642,Herenthoutsesteenweg 2,2023-03-06,05:00:00,1,1,0,ECO_300019380
642,Herenthoutsesteenweg 2,2023-03-06,06:00:00,14,14,0,ECO_300019380
642,Herenthoutsesteenweg 2,2023-03-06,07:00:00,39,32,7,ECO_300019380
642,Herenthoutsesteenweg 2,2023-03-06,08:00:00,135,131,4,ECO_300019380
642,Herenthoutsesteenweg 2,2023-03-06,09:00:00,493,486,7,ECO_300019380
642,Herenthoutsesteenweg 2,2023-03-06,10:00:00,85,81,4,ECO_300019380
642,Herenthoutsesteenweg 2,2023-03-06,11:00:00,42,42,0,ECO_300019380
642,Herenthoutsesteenweg 2,2023-03-06,12:00:00,25,23,2,ECO_300019380
642,Herenthoutsesteenweg 2,2023-03-06,13:00:00,27,25,2,ECO_300019380
642,Herenthoutsesteenweg 2,2023-03-06,14:00:00,47,46,1,ECO_300019380
642,Herenthoutsesteenweg 2,2023-03-06,15:00:00,45,43,2,ECO_300019380
642,Herenthoutsesteenweg 2,2023-03-06,16:00:00,70,63,7,ECO_300019380
642,Herenthoutsesteenweg 2,2023-03-06,17:00:00,91,82,9,ECO_300019380
642,Herenthoutsesteenweg 2,2023-03-06,18:00:00,66,59,7,ECO_300019380
642,Herenthoutsesteenweg 2,2023-03-06,19:00:00,34,31,3,ECO_300019380
642,Herenthoutsesteenweg 2,2023-03-06,20:00:00,18,18,0,ECO_300019380
642,Herenthoutsesteenweg 2,2023-03-06,21:00:00,11,11,0,ECO_300019380
642,Herenthoutsesteenweg 2,2023-03-06,22:00:00,23,20,3,ECO_300019380
642,Herenthoutsesteenweg 2,2023-03-06,23:00:00,14,13,1,ECO_300019380
642,Herenthoutsesteenweg 2,2023-03-07,00:00:00,0,0,0,ECO_300019380
642,Herenthoutsesteenweg 2,2023-03-07,01:00:00,0,0,0,ECO_300019380
642,Herenthoutsesteenweg 2,2023-03-07,02:00:00,1,1,0,ECO_300019380
642,Herenthoutsesteenweg 2,2023-03-07,03:00:00,2,1,1,ECO_300019380
642,Herenthoutsesteenweg 2,2023-03-07,04:00:00,2,1,1,ECO_300019380
642,Herenthoutsesteenweg 2,2023-03-07,05:00:00,4,3,1,ECO_300019380
642,Herenthoutsesteenweg 2,2023-03-07,06:00:00,11,11,0,ECO_300019380
642,Herenthoutsesteenweg 2,2023-03-07,07:00:00,33,31,2,ECO_300019380
642,Herenthoutsesteenweg 2,2023-03-07,08:00:00,106,106,0,ECO_300019380
642,Herenthoutsesteenweg 2,2023-03-07,09:00:00,401,396,5,ECO_300019380
642,Herenthoutsesteenweg 2,2023-03-07,10:00:00,70,65,5,ECO_300019380
642,Herenthoutsesteenweg 2,2023-03-07,11:00:00,12,8,4,ECO_300019380
642,Herenthoutsesteenweg 2,2023-03-07,12:00:00,11,11,0,ECO_300019380
642,Herenthoutsesteenweg 2,2023-03-07,13:00:00,23,20,3,ECO_300019380
642,Herenthoutsesteenweg 2,2023-03-07,14:00:00,21,21,0,ECO_300019380
642,Herenthoutsesteenweg 2,2023-03-07,15:00:00,21,20,1,ECO_300019380
642,Herenthoutsesteenweg 2,2023-03-07,16:00:00,42,41,1,ECO_300019380
642,Herenthoutsesteenweg 2,2023-03-07,17:00:00,68,56,12,ECO_300019380
642,Herenthoutsesteenweg 2,2023-03-07,18:00:00,42,38,4,ECO_300019380
642,Herenthoutsesteenweg 2,2023-03-07,19:00:00,39,39,0,ECO_300019380
642,Herenthoutsesteenweg 2,2023-03-07,20:00:00,12,11,1,ECO_300019380
642,Herenthoutsesteenweg 2,2023-03-07,21:00:00,9,9,0,ECO_300019380
642,Herenthoutsesteenweg 2,2023-03-07,22:00:00,9,8,1,ECO_300019380
642,Herenthoutsesteenweg 2,2023-03-07,23:00:00,12,12,0,ECO_300019380
642,Herenthoutsesteenweg 2,2023-03-08,00:00:00,0,0,0,ECO_300019380
642,Herenthoutsesteenweg 2,2023-03-08,01:00:00,0,0,0,ECO_300019380
642,Herenthoutsesteenweg 2,2023-03-08,02:00:00,3,2,1,ECO_300019380
642,Herenthoutsesteenweg 2,2023-03-08,03:00:00,0,0,0,ECO_300019380
642,Herenthoutsesteenweg 2,2023-03-08,04:00:00,2,2,0,ECO_300019380
642,Herenthoutsesteenweg 2,2023-03-08,05:00:00,3,3,0,ECO_300019380
642,Herenthoutsesteenweg 2,2023-03-08,06:00:00,16,15,1,ECO_300019380
642,Herenthoutsesteenweg 2,2023-03-08,07:00:00,24,22,2,ECO_300019380
642,Herenthoutsesteenweg 2,2023-03-08,08:00:00,58,57,1,ECO_300019380
642,Herenthoutsesteenweg 2,2023-03-08,09:00:00,274,263,11,ECO_300019380
642,Herenthoutsesteenweg 2,2023-03-08,10:00:00,30,30,0,ECO_300019380
642,Herenthoutsesteenweg 2,2023-03-08,11:00:00,11,10,1,ECO_300019380
642,Herenthoutsesteenweg 2,2023-03-08,12:00:00,13,13,0,ECO_300019380
642,Herenthoutsesteenweg 2,2023-03-08,13:00:00,57,50,7,ECO_300019380
642,Herenthoutsesteenweg 2,2023-03-08,14:00:00,34,32,2,ECO_300019380
642,Herenthoutsesteenweg 2,2023-03-08,15:00:00,46,43,3,ECO_300019380
642,Herenthoutsesteenweg 2,2023-03-08,16:00:00,26,22,4,ECO_300019380
642,Herenthoutsesteenweg 2,2023-03-08,17:00:00,57,54,3,ECO_300019380
642,Herenthoutsesteenweg 2,2023-03-08,18:00:00,30,28,2,ECO_300019380
642,Herenthoutsesteenweg 2,2023-03-08,19:00:00,24,21,3,ECO_300019380
642,Herenthoutsesteenweg 2,2023-03-08,20:00:00,8,6,2,ECO_300019380
642,Herenthoutsesteenweg 2,2023-03-08,21:00:00,8,7,1,ECO_300019380
642,Herenthoutsesteenweg 2,2023-03-08,22:00:00,6,5,1,ECO_300019380
642,Herenthoutsesteenweg 2,2023-03-08,23:00:00,17,15,2,ECO_300019380
642,Herenthoutsesteenweg 2,2023-03-09,00:00:00,1,1,0,ECO_300019380
642,Herenthoutsesteenweg 2,2023-03-09,01:00:00,1,1,0,ECO_300019380
642,Herenthoutsesteenweg 2,2023-03-09,02:00:00,1,1,0,ECO_300019380
642,Herenthoutsesteenweg 2,2023-03-09,03:00:00,0,0,0,ECO_300019380
642,Herenthoutsesteenweg 2,2023-03-09,04:00:00,1,0,1,ECO_300019380
642,Herenthoutsesteenweg 2,2023-03-09,05:00:00,2,2,0,ECO_300019380
642,Herenthoutsesteenweg 2,2023-03-09,06:00:00,16,14,2,ECO_300019380
642,Herenthoutsesteenweg 2,2023-03-09,07:00:00,28,24,4,ECO_300019380
642,Herenthoutsesteenweg 2,2023-03-09,08:00:00,108,106,2,ECO_300019380
642,Herenthoutsesteenweg 2,2023-03-09,09:00:00,410,406,4,ECO_300019380
642,Herenthoutsesteenweg 2,2023-03-09,10:00:00,60,57,3,ECO_300019380
642,Herenthoutsesteenweg 2,2023-03-09,11:00:00,28,27,1,ECO_300019380
642,Herenthoutsesteenweg 2,2023-03-09,12:00:00,33,30,3,ECO_300019380
642,Herenthoutsesteenweg 2,2023-03-09,13:00:00,34,32,2,ECO_300019380
642,Herenthoutsesteenweg 2,2023-03-09,14:00:00,25,23,2,ECO_300019380
642,Herenthoutsesteenweg 2,2023-03-09,15:00:00,27,24,3,ECO_300019380
642,Herenthoutsesteenweg 2,2023-03-09,16:00:00,43,38,5,ECO_300019380
642,Herenthoutsesteenweg 2,2023-03-09,17:00:00,80,71,9,ECO_300019380
642,Herenthoutsesteenweg 2,2023-03-09,18:00:00,37,32,5,ECO_300019380
642,Herenthoutsesteenweg 2,2023-03-09,19:00:00,26,24,2,ECO_300019380
642,Herenthoutsesteenweg 2,2023-03-09,20:00:00,20,18,2,ECO_300019380
642,Herenthoutsesteenweg 2,2023-03-09,21:00:00,7,6,1,ECO_300019380
642,Herenthoutsesteenweg 2,2023-03-09,22:00:00,5,4,1,ECO_300019380
642,Herenthoutsesteenweg 2,2023-03-09,23:00:00,9,7,2,ECO_300019380
642,Herenthoutsesteenweg 2,2023-03-10,00:00:00,3,2,1,ECO_300019380
642,Herenthoutsesteenweg 2,2023-03-10,01:00:00,1,1,0,ECO_300019380
642,Herenthoutsesteenweg 2,2023-03-10,02:00:00,2,2,0,ECO_300019380
642,Herenthoutsesteenweg 2,2023-03-10,03:00:00,0,0,0,ECO_300019380
642,Herenthoutsesteenweg 2,2023-03-10,04:00:00,0,0,0,ECO_300019380
642,Herenthoutsesteenweg 2,2023-03-10,05:00:00,2,2,0,ECO_300019380
642,Herenthoutsesteenweg 2,2023-03-10,06:00:00,12,11,1,ECO_300019380
642,Herenthoutsesteenweg 2,2023-03-10,07:00:00,22,18,4,ECO_300019380
642,Herenthoutsesteenweg 2,2023-03-10,08:00:00,94,91,3,ECO_300019380
642,Herenthoutsesteenweg 2,2023-03-10,09:00:00,435,432,3,ECO_300019380
642,Herenthoutsesteenweg 2,2023-03-10,10:00:00,58,55,3,ECO_300019380
642,Herenthoutsesteenweg 2,2023-03-10,11:00:00,15,14,1,ECO_300019380
642,Herenthoutsesteenweg 2,2023-03-10,12:00:00,27,27,0,ECO_300019380
642,Herenthoutsesteenweg 2,2023-03-10,13:00:00,38,37,1,ECO_300019380
642,Herenthoutsesteenweg 2,2023-03-10,14:00:00,31,30,1,ECO_300019380
642,Herenthoutsesteenweg 2,2023-03-10,15:00:00,25,22,3,ECO_300019380
642,Herenthoutsesteenweg 2,2023-03-10,16:00:00,57,52,5,ECO_300019380
642,Herenthoutsesteenweg 2,2023-03-10,17:00:00,54,48,6,ECO_300019380
642,Herenthoutsesteenweg 2,2023-03-10,18:00:00,27,23,4,ECO_300019380
642,Herenthoutsesteenweg 2,2023-03-10,19:00:00,26,25,1,ECO_300019380
642,Herenthoutsesteenweg 2,2023-03-10,20:00:00,21,17,4,ECO_300019380
642,Herenthoutsesteenweg 2,2023-03-10,21:00:00,12,11,1,ECO_300019380
642,Herenthoutsesteenweg 2,2023-03-10,22:00:00,12,11,1,ECO_300019380
642,Herenthoutsesteenweg 2,2023-03-10,23:00:00,11,10,1,ECO_300019380
642,Herenthoutsesteenweg 2,2023-03-11,00:00:00,6,5,1,ECO_300019380
642,Herenthoutsesteenweg 2,2023-03-11,01:00:00,5,4,1,ECO_300019380
642,Herenthoutsesteenweg 2,2023-03-11,02:00:00,6,4,2,ECO_300019380
642,Herenthoutsesteenweg 2,2023-03-11,03:00:00,4,1,3,ECO_300019380
642,Herenthoutsesteenweg 2,2023-03-11,04:00:00,1,1,0,ECO_300019380
642,Herenthoutsesteenweg 2,2023-03-11,05:00:00,4,2,2,ECO_300019380
642,Herenthoutsesteenweg 2,2023-03-11,06:00:00,0,0,0,ECO_300019380
642,Herenthoutsesteenweg 2,2023-03-11,07:00:00,9,9,0,ECO_300019380
642,Herenthoutsesteenweg 2,2023-03-11,08:00:00,8,7,1,ECO_300019380
642,Herenthoutsesteenweg 2,2023-03-11,09:00:00,32,29,3,ECO_300019380
642,Herenthoutsesteenweg 2,2023-03-11,10:00:00,53,45,8,ECO_300019380
642,Herenthoutsesteenweg 2,2023-03-11,11:00:00,75,69,6,ECO_300019380
642,Herenthoutsesteenweg 2,2023-03-11,12:00:00,81,76,5,ECO_300019380
642,Herenthoutsesteenweg 2,2023-03-11,13:00:00,89,86,3,ECO_300019380
642,Herenthoutsesteenweg 2,2023-03-11,14:00:00,144,135,9,ECO_300019380
642,Herenthoutsesteenweg 2,2023-03-11,15:00:00,110,99,11,ECO_300019380
642,Herenthoutsesteenweg 2,2023-03-11,16:00:00,76,63,13,ECO_300019380
642,Herenthoutsesteenweg 2,2023-03-11,17:00:00,79,69,10,ECO_300019380
642,Herenthoutsesteenweg 2,2023-03-11,18:00:00,42,35,7,ECO_300019380
642,Herenthoutsesteenweg 2,2023-03-11,19:00:00,31,29,2,ECO_300019380
642,Herenthoutsesteenweg 2,2023-03-11,20:00:00,26,25,1,ECO_300019380
642,Herenthoutsesteenweg 2,2023-03-11,21:00:00,20,12,8,ECO_300019380
642,Herenthoutsesteenweg 2,2023-03-11,22:00:00,13,12,1,ECO_300019380
642,Herenthoutsesteenweg 2,2023-03-11,23:00:00,7,7,0,ECO_300019380
642,Herenthoutsesteenweg 2,2023-03-12,00:00:00,6,6,0,ECO_300019380
642,Herenthoutsesteenweg 2,2023-03-12,01:00:00,8,8,0,ECO_300019380
642,Herenthoutsesteenweg 2,2023-03-12,02:00:00,13,11,2,ECO_300019380
642,Herenthoutsesteenweg 2,2023-03-12,03:00:00,3,3,0,ECO_300019380
642,Herenthoutsesteenweg 2,2023-03-12,04:00:00,3,2,1,ECO_300019380
642,Herenthoutsesteenweg 2,2023-03-12,05:00:00,3,3,0,ECO_300019380
642,Herenthoutsesteenweg 2,2023-03-12,06:00:00,1,1,0,ECO_300019380
642,Herenthoutsesteenweg 2,2023-03-12,07:00:00,5,5,0,ECO_300019380
642,Herenthoutsesteenweg 2,2023-03-12,08:00:00,7,7,0,ECO_300019380
642,Herenthoutsesteenweg 2,2023-03-12,09:00:00,27,26,1,ECO_300019380
642,Herenthoutsesteenweg 2,2023-03-12,10:00:00,49,45,4,ECO_300019380
642,Herenthoutsesteenweg 2,2023-03-12,11:00:00,49,44,5,ECO_300019380
642,Herenthoutsesteenweg 2,2023-03-12,12:00:00,51,47,4,ECO_300019380
642,Herenthoutsesteenweg 2,2023-03-12,13:00:00,53,48,5,ECO_300019380
642,Herenthoutsesteenweg 2,2023-03-12,14:00:00,51,44,7,ECO_300019380
642,Herenthoutsesteenweg 2,2023-03-12,15:00:00,27,26,1,ECO_300019380
642,Herenthoutsesteenweg 2,2023-03-12,16:00:00,40,37,3,ECO_300019380
642,Herenthoutsesteenweg 2,2023-03-12,17:00:00,23,20,3,ECO_300019380
642,Herenthoutsesteenweg 2,2023-03-12,18:00:00,11,8,3,ECO_300019380
642,Herenthoutsesteenweg 2,2023-03-12,19:00:00,14,14,0,ECO_300019380
642,Herenthoutsesteenweg 2,2023-03-12,20:00:00,14,13,1,ECO_300019380
642,Herenthoutsesteenweg 2,2023-03-12,21:00:00,11,8,3,ECO_300019380
642,Herenthoutsesteenweg 2,2023-03-12,22:00:00,4,2,2,ECO_300019380
642,Herenthoutsesteenweg 2,2023-03-12,23:00:00,5,5,0,ECO_300019380
642,Herenthoutsesteenweg 2,2023-03-13,00:00:00,0,0,0,ECO_300019380
642,Herenthoutsesteenweg 2,2023-03-13,01:00:00,2,2,0,ECO_300019380
642,Herenthoutsesteenweg 2,2023-03-13,02:00:00,3,3,0,ECO_300019380
642,Herenthoutsesteenweg 2,2023-03-13,03:00:00,0,0,0,ECO_300019380
642,Herenthoutsesteenweg 2,2023-03-13,04:00:00,0,0,0,ECO_300019380
642,Herenthoutsesteenweg 2,2023-03-13,05:00:00,2,2,0,ECO_300019380
642,Herenthoutsesteenweg 2,2023-03-13,06:00:00,11,11,0,ECO_300019380
642,Herenthoutsesteenweg 2,2023-03-13,07:00:00,37,33,4,ECO_300019380
642,Herenthoutsesteenweg 2,2023-03-13,08:00:00,123,120,3,ECO_300019380
642,Herenthoutsesteenweg 2,2023-03-13,09:00:00,397,392,5,ECO_300019380
642,Herenthoutsesteenweg 2,2023-03-13,10:00:00,56,54,2,ECO_300019380
642,Herenthoutsesteenweg 2,2023-03-13,11:00:00,28,26,2,ECO_300019380
642,Herenthoutsesteenweg 2,2023-03-13,12:00:00,31,30,1,ECO_300019380
642,Herenthoutsesteenweg 2,2023-03-13,13:00:00,34,31,3,ECO_300019380
642,Herenthoutsesteenweg 2,2023-03-13,14:00:00,54,51,3,ECO_300019380
642,Herenthoutsesteenweg 2,2023-03-13,15:00:00,40,38,2,ECO_300019380
642,Herenthoutsesteenweg 2,2023-03-13,16:00:00,61,57,4,ECO_300019380
642,Herenthoutsesteenweg 2,2023-03-13,17:00:00,102,91,11,ECO_300019380
642,Herenthoutsesteenweg 2,2023-03-13,18:00:00,63,58,5,ECO_300019380
642,Herenthoutsesteenweg 2,2023-03-13,19:00:00,39,37,2,ECO_300019380
642,Herenthoutsesteenweg 2,2023-03-13,20:00:00,22,22,0,ECO_300019380
642,Herenthoutsesteenweg 2,2023-03-13,21:00:00,14,14,0,ECO_300019380
642,Herenthoutsesteenweg 2,2023-03-13,22:00:00,21,19,2,ECO_300019380
642,Herenthoutsesteenweg 2,2023-03-13,23:00:00,9,9,0,ECO_300019380
642,Herenthoutsesteenweg 2,2023-03-14,00:00:00,4,3,1,ECO_300019380
642,Herenthoutsesteenweg 2,2023-03-14,01:00:00,2,0,2,ECO_300019380
642,Herenthoutsesteenweg 2,2023-03-14,02:00:00,0,0,0,ECO_300019380
642,Herenthoutsesteenweg 2,2023-03-14,03:00:00,3,3,0,ECO_300019380
642,Herenthoutsesteenweg 2,2023-03-14,04:00:00,0,0,0,ECO_300019380
642,Herenthoutsesteenweg 2,2023-03-14,05:00:00,1,1,0,ECO_300019380
642,Herenthoutsesteenweg 2,2023-03-14,06:00:00,15,14,1,ECO_300019380
642,Herenthoutsesteenweg 2,2023-03-14,07:00:00,39,36,3,ECO_300019380
642,Herenthoutsesteenweg 2,2023-03-14,08:00:00,113,109,4,ECO_300019380
642,Herenthoutsesteenweg 2,2023-03-14,09:00:00,277,274,3,ECO_300019380
642,Herenthoutsesteenweg 2,2023-03-14,10:00:00,36,35,1,ECO_300019380
642,Herenthoutsesteenweg 2,2023-03-14,11:00:00,25,25,0,ECO_300019380
642,Herenthoutsesteenweg 2,2023-03-14,12:00:00,20,20,0,ECO_300019380
642,Herenthoutsesteenweg 2,2023-03-14,13:00:00,39,37,2,ECO_300019380
642,Herenthoutsesteenweg 2,2023-03-14,14:00:00,28,28,0,ECO_300019380
642,Herenthoutsesteenweg 2,2023-03-14,15:00:00,40,36,4,ECO_300019380
642,Herenthoutsesteenweg 2,2023-03-14,16:00:00,50,42,8,ECO_300019380
642,Herenthoutsesteenweg 2,2023-03-14,17:00:00,80,77,3,ECO_300019380
642,Herenthoutsesteenweg 2,2023-03-14,18:00:00,56,53,3,ECO_300019380
642,Herenthoutsesteenweg 2,2023-03-14,19:00:00,31,28,3,ECO_300019380
642,Herenthoutsesteenweg 2,2023-03-14,20:00:00,34,31,3,ECO_300019380
642,Herenthoutsesteenweg 2,2023-03-14,21:00:00,12,10,2,ECO_300019380
642,Herenthoutsesteenweg 2,2023-03-14,22:00:00,4,4,0,ECO_300019380
642,Herenthoutsesteenweg 2,2023-03-14,23:00:00,8,8,0,ECO_300019380
642,Herenthoutsesteenweg 2,2023-03-15,00:00:00,0,0,0,ECO_300019380
642,Herenthoutsesteenweg 2,2023-03-15,01:00:00,2,2,0,ECO_300019380
642,Herenthoutsesteenweg 2,2023-03-15,02:00:00,2,1,1,ECO_300019380
642,Herenthoutsesteenweg 2,2023-03-15,03:00:00,0,0,0,ECO_300019380
642,Herenthoutsesteenweg 2,2023-03-15,04:00:00,0,0,0,ECO_300019380
642,Herenthoutsesteenweg 2,2023-03-15,05:00:00,2,2,0,ECO_300019380
642,Herenthoutsesteenweg 2,2023-03-15,06:00:00,21,20,1,ECO_300019380
642,Herenthoutsesteenweg 2,2023-03-15,07:00:00,33,30,3,ECO_300019380
642,Herenthoutsesteenweg 2,2023-03-15,08:00:00,120,117,3,ECO_300019380
642,Herenthoutsesteenweg 2,2023-03-15,09:00:00,424,419,5,ECO_300019380
642,Herenthoutsesteenweg 2,2023-03-15,10:00:00,75,71,4,ECO_300019380
642,Herenthoutsesteenweg 2,2023-03-15,11:00:00,42,39,3,ECO_300019380
642,Herenthoutsesteenweg 2,2023-03-15,12:00:00,56,55,1,ECO_300019380
642,Herenthoutsesteenweg 2,2023-03-15,13:00:00,105,94,11,ECO_300019380
642,Herenthoutsesteenweg 2,2023-03-15,14:00:00,106,95,11,ECO_300019380
642,Herenthoutsesteenweg 2,2023-03-15,15:00:00,124,107,17,ECO_300019380
642,Herenthoutsesteenweg 2,2023-03-15,16:00:00,86,78,8,ECO_300019380
642,Herenthoutsesteenweg 2,2023-03-15,17:00:00,108,95,13,ECO_300019380
642,Herenthoutsesteenweg 2,2023-03-15,18:00:00,71,60,11,ECO_300019380
642,Herenthoutsesteenweg 2,2023-03-15,19:00:00,49,41,8,ECO_300019380
642,Herenthoutsesteenweg 2,2023-03-15,20:00:00,38,29,9,ECO_300019380
642,Herenthoutsesteenweg 2,2023-03-15,21:00:00,9,8,1,ECO_300019380
642,Herenthoutsesteenweg 2,2023-03-15,22:00:00,18,17,1,ECO_300019380
642,Herenthoutsesteenweg 2,2023-03-15,23:00:00,22,19,3,ECO_300019380
642,Herenthoutsesteenweg 2,2023-03-16,00:00:00,1,1,0,ECO_300019380
642,Herenthoutsesteenweg 2,2023-03-16,01:00:00,1,0,1,ECO_300019380
642,Herenthoutsesteenweg 2,2023-03-16,02:00:00,1,1,0,ECO_300019380
642,Herenthoutsesteenweg 2,2023-03-16,03:00:00,4,4,0,ECO_300019380
642,Herenthoutsesteenweg 2,2023-03-16,04:00:00,0,0,0,ECO_300019380
642,Herenthoutsesteenweg 2,2023-03-16,05:00:00,3,2,1,ECO_300019380
642,Herenthoutsesteenweg 2,2023-03-16,06:00:00,20,18,2,ECO_300019380
642,Herenthoutsesteenweg 2,2023-03-16,07:00:00,40,38,2,ECO_300019380
642,Herenthoutsesteenweg 2,2023-03-16,08:00:00,133,126,7,ECO_300019380
642,Herenthoutsesteenweg 2,2023-03-16,09:00:00,409,404,5,ECO_300019380
642,Herenthoutsesteenweg 2,2023-03-16,10:00:00,80,78,2,ECO_300019380
642,Herenthoutsesteenweg 2,2023-03-16,11:00:00,63,59,4,ECO_300019380
642,Herenthoutsesteenweg 2,2023-03-16,12:00:00,59,57,2,ECO_300019380
642,Herenthoutsesteenweg 2,2023-03-16,13:00:00,55,52,3,ECO_300019380
642,Herenthoutsesteenweg 2,2023-03-16,14:00:00,84,78,6,ECO_300019380
642,Herenthoutsesteenweg 2,2023-03-16,15:00:00,88,84,4,ECO_300019380
642,Herenthoutsesteenweg 2,2023-03-16,16:00:00,128,113,15,ECO_300019380
642,Herenthoutsesteenweg 2,2023-03-16,17:00:00,108,97,11,ECO_300019380
642,Herenthoutsesteenweg 2,2023-03-16,18:00:00,87,77,10,ECO_300019380
642,Herenthoutsesteenweg 2,2023-03-16,19:00:00,56,52,4,ECO_300019380
642,Herenthoutsesteenweg 2,2023-03-16,20:00:00,34,32,2,ECO_300019380
642,Herenthoutsesteenweg 2,2023-03-16,21:00:00,11,10,1,ECO_300019380
642,Herenthoutsesteenweg 2,2023-03-16,22:00:00,3,2,1,ECO_300019380
642,Herenthoutsesteenweg 2,2023-03-16,23:00:00,15,12,3,ECO_300019380
642,Herenthoutsesteenweg 2,2023-03-17,00:00:00,2,1,1,ECO_300019380
642,Herenthoutsesteenweg 2,2023-03-17,01:00:00,0,0,0,ECO_300019380
642,Herenthoutsesteenweg 2,2023-03-17,02:00:00,3,2,1,ECO_300019380
642,Herenthoutsesteenweg 2,2023-03-17,03:00:00,1,1,0,ECO_300019380
642,Herenthoutsesteenweg 2,2023-03-17,04:00:00,0,0,0,ECO_300019380
642,Herenthoutsesteenweg 2,2023-03-17,05:00:00,2,2,0,ECO_300019380
642,Herenthoutsesteenweg 2,2023-03-17,06:00:00,16,16,0,ECO_300019380
642,Herenthoutsesteenweg 2,2023-03-17,07:00:00,49,42,7,ECO_300019380
642,Herenthoutsesteenweg 2,2023-03-17,08:00:00,131,125,6,ECO_300019380
642,Herenthoutsesteenweg 2,2023-03-17,09:00:00,415,410,5,ECO_300019380
642,Herenthoutsesteenweg 2,2023-03-17,10:00:00,125,123,2,ECO_300019380
642,Herenthoutsesteenweg 2,2023-03-17,11:00:00,89,87,2,ECO_300019380
642,Herenthoutsesteenweg 2,2023-03-17,12:00:00,64,61,3,ECO_300019380
642,Herenthoutsesteenweg 2,2023-03-17,13:00:00,69,61,8,ECO_300019380
642,Herenthoutsesteenweg 2,2023-03-17,14:00:00,122,107,15,ECO_300019380
642,Herenthoutsesteenweg 2,2023-03-17,15:00:00,107,101,6,ECO_300019380
642,Herenthoutsesteenweg 2,2023-03-17,16:00:00,137,127,10,ECO_300019380
642,Herenthoutsesteenweg 2,2023-03-17,17:00:00,129,114,15,ECO_300019380
642,Herenthoutsesteenweg 2,2023-03-17,18:00:00,74,64,10,ECO_300019380
642,Herenthoutsesteenweg 2,2023-03-17,19:00:00,48,37,11,ECO_300019380
642,Herenthoutsesteenweg 2,2023-03-17,20:00:00,46,40,6,ECO_300019380
642,Herenthoutsesteenweg 2,2023-03-17,21:00:00,21,18,3,ECO_300019380
642,Herenthoutsesteenweg 2,2023-03-17,22:00:00,19,17,2,ECO_300019380
642,Herenthoutsesteenweg 2,2023-03-17,23:00:00,16,14,2,ECO_300019380
642,Herenthoutsesteenweg 2,2023-03-18,00:00:00,15,12,3,ECO_300019380
642,Herenthoutsesteenweg 2,2023-03-18,01:00:00,6,4,2,ECO_300019380
642,Herenthoutsesteenweg 2,2023-03-18,02:00:00,7,5,2,ECO_300019380
642,Herenthoutsesteenweg 2,2023-03-18,03:00:00,1,0,1,ECO_300019380
642,Herenthoutsesteenweg 2,2023-03-18,04:00:00,0,0,0,ECO_300019380
642,Herenthoutsesteenweg 2,2023-03-18,05:00:00,3,3,0,ECO_300019380
642,Herenthoutsesteenweg 2,2023-03-18,06:00:00,3,2,1,ECO_300019380
642,Herenthoutsesteenweg 2,2023-03-18,07:00:00,14,13,1,ECO_300019380
642,Herenthoutsesteenweg 2,2023-03-18,08:00:00,7,5,2,ECO_300019380
642,Herenthoutsesteenweg 2,2023-03-18,09:00:00,49,46,3,ECO_300019380
642,Herenthoutsesteenweg 2,2023-03-18,10:00:00,86,85,1,ECO_300019380
642,Herenthoutsesteenweg 2,2023-03-18,11:00:00,107,97,10,ECO_300019380
642,Herenthoutsesteenweg 2,2023-03-18,12:00:00,76,58,18,ECO_300019380
642,Herenthoutsesteenweg 2,2023-03-18,13:00:00,60,56,4,ECO_300019380
642,Herenthoutsesteenweg 2,2023-03-18,14:00:00,94,93,1,ECO_300019380
642,Herenthoutsesteenweg 2,2023-03-18,15:00:00,79,70,9,ECO_300019380
642,Herenthoutsesteenweg 2,2023-03-18,16:00:00,65,59,6,ECO_300019380
642,Herenthoutsesteenweg 2,2023-03-18,17:00:00,44,40,4,ECO_300019380
642,Herenthoutsesteenweg 2,2023-03-18,18:00:00,61,55,6,ECO_300019380
642,Herenthoutsesteenweg 2,2023-03-18,19:00:00,34,31,3,ECO_300019380
642,Herenthoutsesteenweg 2,2023-03-18,20:00:00,31,29,2,ECO_300019380
642,Herenthoutsesteenweg 2,2023-03-18,21:00:00,14,12,2,ECO_300019380
642,Herenthoutsesteenweg 2,2023-03-18,22:00:00,14,14,0,ECO_300019380
642,Herenthoutsesteenweg 2,2023-03-18,23:00:00,7,6,1,ECO_300019380
642,Herenthoutsesteenweg 2,2023-03-19,00:00:00,11,10,1,ECO_300019380
642,Herenthoutsesteenweg 2,2023-03-19,01:00:00,13,12,1,ECO_300019380
642,Herenthoutsesteenweg 2,2023-03-19,02:00:00,8,7,1,ECO_300019380
642,Herenthoutsesteenweg 2,2023-03-19,03:00:00,2,0,2,ECO_300019380
642,Herenthoutsesteenweg 2,2023-03-19,04:00:00,2,1,1,ECO_300019380
642,Herenthoutsesteenweg 2,2023-03-19,05:00:00,2,1,1,ECO_300019380
642,Herenthoutsesteenweg 2,2023-03-19,06:00:00,3,3,0,ECO_300019380
642,Herenthoutsesteenweg 2,2023-03-19,07:00:00,8,8,0,ECO_300019380
642,Herenthoutsesteenweg 2,2023-03-19,08:00:00,12,12,0,ECO_300019380
642,Herenthoutsesteenweg 2,2023-03-19,09:00:00,85,77,8,ECO_300019380
642,Herenthoutsesteenweg 2,2023-03-19,10:00:00,89,75,14,ECO_300019380
642,Herenthoutsesteenweg 2,2023-03-19,11:00:00,131,121,10,ECO_300019380
642,Herenthoutsesteenweg 2,2023-03-19,12:00:00,73,62,11,ECO_300019380
642,Herenthoutsesteenweg 2,2023-03-19,13:00:00,57,52,5,ECO_300019380
642,Herenthoutsesteenweg 2,2023-03-19,14:00:00,80,77,3,ECO_300019380
642,Herenthoutsesteenweg 2,2023-03-19,15:00:00,98,88,10,ECO_300019380
642,Herenthoutsesteenweg 2,2023-03-19,16:00:00,47,41,6,ECO_300019380
642,Herenthoutsesteenweg 2,2023-03-19,17:00:00,49,44,5,ECO_300019380
642,Herenthoutsesteenweg 2,2023-03-19,18:00:00,45,40,5,ECO_300019380
642,Herenthoutsesteenweg 2,2023-03-19,19:00:00,28,23,5,ECO_300019380
642,Herenthoutsesteenweg 2,2023-03-19,20:00:00,6,6,0,ECO_300019380
642,Herenthoutsesteenweg 2,2023-03-19,21:00:00,7,5,2,ECO_300019380
642,Herenthoutsesteenweg 2,2023-03-19,22:00:00,6,5,1,ECO_300019380
642,Herenthoutsesteenweg 2,2023-03-19,23:00:00,7,7,0,ECO_300019380
642,Herenthoutsesteenweg 2,2023-03-20,00:00:00,2,1,1,ECO_300019380
642,Herenthoutsesteenweg 2,2023-03-20,01:00:00,0,0,0,ECO_300019380
642,Herenthoutsesteenweg 2,2023-03-20,02:00:00,2,1,1,ECO_300019380
642,Herenthoutsesteenweg 2,2023-03-20,03:00:00,0,0,0,ECO_300019380
642,Herenthoutsesteenweg 2,2023-03-20,04:00:00,1,1,0,ECO_300019380
642,Herenthoutsesteenweg 2,2023-03-20,05:00:00,1,1,0,ECO_300019380
642,Herenthoutsesteenweg 2,2023-03-20,06:00:00,17,16,1,ECO_300019380
642,Herenthoutsesteenweg 2,2023-03-20,07:00:00,38,33,5,ECO_300019380
642,Herenthoutsesteenweg 2,2023-03-20,08:00:00,156,147,9,ECO_300019380
642,Herenthoutsesteenweg 2,2023-03-20,09:00:00,554,540,14,ECO_300019380
642,Herenthoutsesteenweg 2,2023-03-20,10:00:00,66,62,4,ECO_300019380
642,Herenthoutsesteenweg 2,2023-03-20,11:00:00,24,23,1,ECO_300019380
642,Herenthoutsesteenweg 2,2023-03-20,12:00:00,35,34,1,ECO_300019380
642,Herenthoutsesteenweg 2,2023-03-20,13:00:00,55,49,6,ECO_300019380
642,Herenthoutsesteenweg 2,2023-03-20,14:00:00,55,54,1,ECO_300019380
642,Herenthoutsesteenweg 2,2023-03-20,15:00:00,50,43,7,ECO_300019380
642,Herenthoutsesteenweg 2,2023-03-20,16:00:00,75,64,11,ECO_300019380
642,Herenthoutsesteenweg 2,2023-03-20,17:00:00,94,89,5,ECO_300019380
642,Herenthoutsesteenweg 2,2023-03-20,18:00:00,64,58,6,ECO_300019380
642,Herenthoutsesteenweg 2,2023-03-20,19:00:00,37,33,4,ECO_300019380
642,Herenthoutsesteenweg 2,2023-03-20,20:00:00,32,29,3,ECO_300019380
642,Herenthoutsesteenweg 2,2023-03-20,21:00:00,8,5,3,ECO_300019380
642,Herenthoutsesteenweg 2,2023-03-20,22:00:00,10,8,2,ECO_300019380
642,Herenthoutsesteenweg 2,2023-03-20,23:00:00,14,14,0,ECO_300019380
642,Herenthoutsesteenweg 2,2023-03-21,00:00:00,2,1,1,ECO_300019380
642,Herenthoutsesteenweg 2,2023-03-21,01:00:00,1,0,1,ECO_300019380
642,Herenthoutsesteenweg 2,2023-03-21,02:00:00,2,0,2,ECO_300019380
642,Herenthoutsesteenweg 2,2023-03-21,03:00:00,1,0,1,ECO_300019380
642,Herenthoutsesteenweg 2,2023-03-21,04:00:00,1,1,0,ECO_300019380
642,Herenthoutsesteenweg 2,2023-03-21,05:00:00,5,5,0,ECO_300019380
642,Herenthoutsesteenweg 2,2023-03-21,06:00:00,14,14,0,ECO_300019380
642,Herenthoutsesteenweg 2,2023-03-21,07:00:00,45,40,5,ECO_300019380
642,Herenthoutsesteenweg 2,2023-03-21,08:00:00,119,116,3,ECO_300019380
642,Herenthoutsesteenweg 2,2023-03-21,09:00:00,343,340,3,ECO_300019380
642,Herenthoutsesteenweg 2,2023-03-21,10:00:00,57,54,3,ECO_300019380
642,Herenthoutsesteenweg 2,2023-03-21,11:00:00,40,40,0,ECO_300019380
642,Herenthoutsesteenweg 2,2023-03-21,12:00:00,42,39,3,ECO_300019380
642,Herenthoutsesteenweg 2,2023-03-21,13:00:00,50,45,5,ECO_300019380
642,Herenthoutsesteenweg 2,2023-03-21,14:00:00,89,83,6,ECO_300019380
642,Herenthoutsesteenweg 2,2023-03-21,15:00:00,75,64,11,ECO_300019380
642,Herenthoutsesteenweg 2,2023-03-21,16:00:00,82,77,5,ECO_300019380
642,Herenthoutsesteenweg 2,2023-03-21,17:00:00,99,90,9,ECO_300019380
642,Herenthoutsesteenweg 2,2023-03-21,18:00:00,61,54,7,ECO_300019380
642,Herenthoutsesteenweg 2,2023-03-21,19:00:00,38,35,3,ECO_300019380
642,Herenthoutsesteenweg 2,2023-03-21,20:00:00,30,27,3,ECO_300019380
642,Herenthoutsesteenweg 2,2023-03-21,21:00:00,14,13,1,ECO_300019380
642,Herenthoutsesteenweg 2,2023-03-21,22:00:00,15,7,8,ECO_300019380
642,Herenthoutsesteenweg 2,2023-03-21,23:00:00,19,18,1,ECO_300019380
642,Herenthoutsesteenweg 2,2023-03-22,00:00:00,3,3,0,ECO_300019380
642,Herenthoutsesteenweg 2,2023-03-22,01:00:00,5,2,3,ECO_300019380
642,Herenthoutsesteenweg 2,2023-03-22,02:00:00,1,0,1,ECO_300019380
642,Herenthoutsesteenweg 2,2023-03-22,03:00:00,1,1,0,ECO_300019380
642,Herenthoutsesteenweg 2,2023-03-22,04:00:00,1,1,0,ECO_300019380
642,Herenthoutsesteenweg 2,2023-03-22,05:00:00,1,1,0,ECO_300019380
642,Herenthoutsesteenweg 2,2023-03-22,06:00:00,19,19,0,ECO_300019380
642,Herenthoutsesteenweg 2,2023-03-22,07:00:00,36,31,5,ECO_300019380
642,Herenthoutsesteenweg 2,2023-03-22,08:00:00,130,123,7,ECO_300019380
642,Herenthoutsesteenweg 2,2023-03-22,09:00:00,416,408,8,ECO_300019380
642,Herenthoutsesteenweg 2,2023-03-22,10:00:00,69,65,4,ECO_300019380
642,Herenthoutsesteenweg 2,2023-03-22,11:00:00,41,40,1,ECO_300019380
642,Herenthoutsesteenweg 2,2023-03-22,12:00:00,27,27,0,ECO_300019380
642,Herenthoutsesteenweg 2,2023-03-22,13:00:00,70,63,7,ECO_300019380
642,Herenthoutsesteenweg 2,2023-03-22,14:00:00,61,52,9,ECO_300019380
642,Herenthoutsesteenweg 2,2023-03-22,15:00:00,58,53,5,ECO_300019380
642,Herenthoutsesteenweg 2,2023-03-22,16:00:00,48,43,5,ECO_300019380
642,Herenthoutsesteenweg 2,2023-03-22,17:00:00,83,76,7,ECO_300019380
642,Herenthoutsesteenweg 2,2023-03-22,18:00:00,52,50,2,ECO_300019380
642,Herenthoutsesteenweg 2,2023-03-22,19:00:00,34,30,4,ECO_300019380
642,Herenthoutsesteenweg 2,2023-03-22,20:00:00,21,16,5,ECO_300019380
642,Herenthoutsesteenweg 2,2023-03-22,21:00:00,16,15,1,ECO_300019380
642,Herenthoutsesteenweg 2,2023-03-22,22:00:00,11,9,2,ECO_300019380
642,Herenthoutsesteenweg 2,2023-03-22,23:00:00,13,13,0,ECO_300019380
642,Herenthoutsesteenweg 2,2023-03-23,00:00:00,2,0,2,ECO_300019380
642,Herenthoutsesteenweg 2,2023-03-23,01:00:00,1,1,0,ECO_300019380
642,Herenthoutsesteenweg 2,2023-03-23,02:00:00,2,2,0,ECO_300019380
642,Herenthoutsesteenweg 2,2023-03-23,03:00:00,0,0,0,ECO_300019380
642,Herenthoutsesteenweg 2,2023-03-23,04:00:00,0,0,0,ECO_300019380
642,Herenthoutsesteenweg 2,2023-03-23,05:00:00,2,2,0,ECO_300019380
642,Herenthoutsesteenweg 2,2023-03-23,06:00:00,14,13,1,ECO_300019380
642,Herenthoutsesteenweg 2,2023-03-23,07:00:00,37,34,3,ECO_300019380
642,Herenthoutsesteenweg 2,2023-03-23,08:00:00,109,107,2,ECO_300019380
642,Herenthoutsesteenweg 2,2023-03-23,09:00:00,377,376,1,ECO_300019380
642,Herenthoutsesteenweg 2,2023-03-23,10:00:00,72,71,1,ECO_300019380
642,Herenthoutsesteenweg 2,2023-03-23,11:00:00,32,26,6,ECO_300019380
642,Herenthoutsesteenweg 2,2023-03-23,12:00:00,29,29,0,ECO_300019380
642,Herenthoutsesteenweg 2,2023-03-23,13:00:00,43,39,4,ECO_300019380
642,Herenthoutsesteenweg 2,2023-03-23,14:00:00,51,48,3,ECO_300019380
642,Herenthoutsesteenweg 2,2023-03-23,15:00:00,69,64,5,ECO_300019380
642,Herenthoutsesteenweg 2,2023-03-23,16:00:00,59,52,7,ECO_300019380
642,Herenthoutsesteenweg 2,2023-03-23,17:00:00,79,72,7,ECO_300019380
642,Herenthoutsesteenweg 2,2023-03-23,18:00:00,57,51,6,ECO_300019380
642,Herenthoutsesteenweg 2,2023-03-23,19:00:00,37,34,3,ECO_300019380
642,Herenthoutsesteenweg 2,2023-03-23,20:00:00,33,33,0,ECO_300019380
642,Herenthoutsesteenweg 2,2023-03-23,21:00:00,10,10,0,ECO_300019380
642,Herenthoutsesteenweg 2,2023-03-23,22:00:00,8,5,3,ECO_300019380
642,Herenthoutsesteenweg 2,2023-03-23,23:00:00,13,13,0,ECO_300019380
642,Herenthoutsesteenweg 2,2023-03-24,00:00:00,1,0,1,ECO_300019380
642,Herenthoutsesteenweg 2,2023-03-24,01:00:00,1,1,0,ECO_300019380
642,Herenthoutsesteenweg 2,2023-03-24,02:00:00,0,0,0,ECO_300019380
642,Herenthoutsesteenweg 2,2023-03-24,03:00:00,0,0,0,ECO_300019380
642,Herenthoutsesteenweg 2,2023-03-24,04:00:00,0,0,0,ECO_300019380
642,Herenthoutsesteenweg 2,2023-03-24,05:00:00,4,4,0,ECO_300019380
642,Herenthoutsesteenweg 2,2023-03-24,06:00:00,8,8,0,ECO_300019380
642,Herenthoutsesteenweg 2,2023-03-24,07:00:00,35,32,3,ECO_300019380
642,Herenthoutsesteenweg 2,2023-03-24,08:00:00,131,126,5,ECO_300019380
642,Herenthoutsesteenweg 2,2023-03-24,09:00:00,428,416,12,ECO_300019380
642,Herenthoutsesteenweg 2,2023-03-24,10:00:00,128,125,3,ECO_300019380
642,Herenthoutsesteenweg 2,2023-03-24,11:00:00,99,95,4,ECO_300019380
642,Herenthoutsesteenweg 2,2023-03-24,12:00:00,77,67,10,ECO_300019380
642,Herenthoutsesteenweg 2,2023-03-24,13:00:00,65,57,8,ECO_300019380
642,Herenthoutsesteenweg 2,2023-03-24,14:00:00,23,23,0,ECO_300019380
642,Herenthoutsesteenweg 2,2023-03-24,15:00:00,85,81,4,ECO_300019380
642,Herenthoutsesteenweg 2,2023-03-24,16:00:00,85,80,5,ECO_300019380
642,Herenthoutsesteenweg 2,2023-03-24,17:00:00,86,78,8,ECO_300019380
642,Herenthoutsesteenweg 2,2023-03-24,18:00:00,45,43,2,ECO_300019380
642,Herenthoutsesteenweg 2,2023-03-24,19:00:00,31,29,2,ECO_300019380
642,Herenthoutsesteenweg 2,2023-03-24,20:00:00,36,34,2,ECO_300019380
642,Herenthoutsesteenweg 2,2023-03-24,21:00:00,22,22,0,ECO_300019380
642,Herenthoutsesteenweg 2,2023-03-24,22:00:00,13,12,1,ECO_300019380
642,Herenthoutsesteenweg 2,2023-03-24,23:00:00,12,11,1,ECO_300019380
642,Herenthoutsesteenweg 2,2023-03-25,00:00:00,3,2,1,ECO_300019380
642,Herenthoutsesteenweg 2,2023-03-25,01:00:00,5,3,2,ECO_300019380
642,Herenthoutsesteenweg 2,2023-03-25,02:00:00,3,0,3,ECO_300019380
642,Herenthoutsesteenweg 2,2023-03-25,03:00:00,5,4,1,ECO_300019380
642,Herenthoutsesteenweg 2,2023-03-25,04:00:00,2,1,1,ECO_300019380
642,Herenthoutsesteenweg 2,2023-03-25,05:00:00,0,0,0,ECO_300019380
642,Herenthoutsesteenweg 2,2023-03-25,06:00:00,2,2,0,ECO_300019380
642,Herenthoutsesteenweg 2,2023-03-25,07:00:00,14,14,0,ECO_300019380
642,Herenthoutsesteenweg 2,2023-03-25,08:00:00,7,7,0,ECO_300019380
642,Herenthoutsesteenweg 2,2023-03-25,09:00:00,38,34,4,ECO_300019380
642,Herenthoutsesteenweg 2,2023-03-25,10:00:00,27,27,0,ECO_300019380
642,Herenthoutsesteenweg 2,2023-03-25,11:00:00,34,30,4,ECO_300019380
642,Herenthoutsesteenweg 2,2023-03-25,12:00:00,36,32,4,ECO_300019380
642,Herenthoutsesteenweg 2,2023-03-25,13:00:00,20,16,4,ECO_300019380
642,Herenthoutsesteenweg 2,2023-03-25,14:00:00,20,20,0,ECO_300019380
642,Herenthoutsesteenweg 2,2023-03-25,15:00:00,23,20,3,ECO_300019380
642,Herenthoutsesteenweg 2,2023-03-25,16:00:00,35,33,2,ECO_300019380
642,Herenthoutsesteenweg 2,2023-03-25,17:00:00,22,18,4,ECO_300019380
642,Herenthoutsesteenweg 2,2023-03-25,18:00:00,21,18,3,ECO_300019380
642,Herenthoutsesteenweg 2,2023-03-25,19:00:00,27,24,3,ECO_300019380
642,Herenthoutsesteenweg 2,2023-03-25,20:00:00,23,20,3,ECO_300019380
642,Herenthoutsesteenweg 2,2023-03-25,21:00:00,17,15,2,ECO_300019380
642,Herenthoutsesteenweg 2,2023-03-25,22:00:00,7,7,0,ECO_300019380
642,Herenthoutsesteenweg 2,2023-03-25,23:00:00,3,3,0,ECO_300019380
642,Herenthoutsesteenweg 2,2023-03-26,00:00:00,6,6,0,ECO_300019380
642,Herenthoutsesteenweg 2,2023-03-26,01:00:00,5,5,0,ECO_300019380
642,Herenthoutsesteenweg 2,2023-03-26,03:00:00,5,3,2,ECO_300019380
642,Herenthoutsesteenweg 2,2023-03-26,05:00:00,0,0,0,ECO_300019380
642,Herenthoutsesteenweg 2,2023-03-26,06:00:00,2,0,2,ECO_300019380
642,Herenthoutsesteenweg 2,2023-03-26,07:00:00,0,0,0,ECO_300019380
642,Herenthoutsesteenweg 2,2023-03-26,08:00:00,4,3,1,ECO_300019380
642,Herenthoutsesteenweg 2,2023-03-26,09:00:00,5,5,0,ECO_300019380
642,Herenthoutsesteenweg 2,2023-03-26,10:00:00,8,7,1,ECO_300019380
642,Herenthoutsesteenweg 2,2023-03-26,11:00:00,10,8,2,ECO_300019380
642,Herenthoutsesteenweg 2,2023-03-26,12:00:00,14,10,4,ECO_300019380
642,Herenthoutsesteenweg 2,2023-03-26,13:00:00,9,9,0,ECO_300019380
642,Herenthoutsesteenweg 2,2023-03-26,14:00:00,18,13,5,ECO_300019380
642,Herenthoutsesteenweg 2,2023-03-26,15:00:00,7,6,1,ECO_300019380
642,Herenthoutsesteenweg 2,2023-03-26,16:00:00,11,10,1,ECO_300019380
642,Herenthoutsesteenweg 2,2023-03-26,17:00:00,10,8,2,ECO_300019380
642,Herenthoutsesteenweg 2,2023-03-26,18:00:00,8,5,3,ECO_300019380
642,Herenthoutsesteenweg 2,2023-03-26,19:00:00,11,11,0,ECO_300019380
642,Herenthoutsesteenweg 2,2023-03-26,20:00:00,9,9,0,ECO_300019380
642,Herenthoutsesteenweg 2,2023-03-26,21:00:00,3,3,0,ECO_300019380
642,Herenthoutsesteenweg 2,2023-03-26,22:00:00,5,5,0,ECO_300019380
642,Herenthoutsesteenweg 2,2023-03-26,23:00:00,4,2,2,ECO_300019380
642,Herenthoutsesteenweg 2,2023-03-27,00:00:00,1,1,0,ECO_300019380
642,Herenthoutsesteenweg 2,2023-03-27,01:00:00,1,0,1,ECO_300019380
642,Herenthoutsesteenweg 2,2023-03-27,02:00:00,2,2,0,ECO_300019380
642,Herenthoutsesteenweg 2,2023-03-27,03:00:00,0,0,0,ECO_300019380
642,Herenthoutsesteenweg 2,2023-03-27,04:00:00,1,0,1,ECO_300019380
642,Herenthoutsesteenweg 2,2023-03-27,05:00:00,0,0,0,ECO_300019380
642,Herenthoutsesteenweg 2,2023-03-27,06:00:00,2,2,0,ECO_300019380
642,Herenthoutsesteenweg 2,2023-03-27,07:00:00,17,15,2,ECO_300019380
642,Herenthoutsesteenweg 2,2023-03-27,08:00:00,31,21,10,ECO_300019380
642,Herenthoutsesteenweg 2,2023-03-27,09:00:00,121,115,6,ECO_300019380
642,Herenthoutsesteenweg 2,2023-03-27,10:00:00,413,404,9,ECO_300019380
642,Herenthoutsesteenweg 2,2023-03-27,11:00:00,97,93,4,ECO_300019380
642,Herenthoutsesteenweg 2,2023-03-27,12:00:00,87,84,3,ECO_300019380
642,Herenthoutsesteenweg 2,2023-03-27,13:00:00,26,25,1,ECO_300019380
642,Herenthoutsesteenweg 2,2023-03-27,14:00:00,62,56,6,ECO_300019380
642,Herenthoutsesteenweg 2,2023-03-27,15:00:00,45,41,4,ECO_300019380
642,Herenthoutsesteenweg 2,2023-03-27,16:00:00,66,59,7,ECO_300019380
642,Herenthoutsesteenweg 2,2023-03-27,17:00:00,97,90,7,ECO_300019380
642,Herenthoutsesteenweg 2,2023-03-27,18:00:00,87,84,3,ECO_300019380
642,Herenthoutsesteenweg 2,2023-03-27,19:00:00,73,54,19,ECO_300019380
642,Herenthoutsesteenweg 2,2023-03-27,20:00:00,38,30,8,ECO_300019380
642,Herenthoutsesteenweg 2,2023-03-27,21:00:00,30,28,2,ECO_300019380
642,Herenthoutsesteenweg 2,2023-03-27,22:00:00,14,12,2,ECO_300019380
642,Herenthoutsesteenweg 2,2023-03-27,23:00:00,7,4,3,ECO_300019380
642,Herenthoutsesteenweg 2,2023-03-28,00:00:00,19,18,1,ECO_300019380
642,Herenthoutsesteenweg 2,2023-03-28,01:00:00,6,1,5,ECO_300019380
642,Herenthoutsesteenweg 2,2023-03-28,02:00:00,2,2,0,ECO_300019380
642,Herenthoutsesteenweg 2,2023-03-28,03:00:00,2,1,1,ECO_300019380
642,Herenthoutsesteenweg 2,2023-03-28,04:00:00,0,0,0,ECO_300019380
642,Herenthoutsesteenweg 2,2023-03-28,05:00:00,0,0,0,ECO_300019380
642,Herenthoutsesteenweg 2,2023-03-28,06:00:00,4,4,0,ECO_300019380
642,Herenthoutsesteenweg 2,2023-03-28,07:00:00,17,16,1,ECO_300019380
642,Herenthoutsesteenweg 2,2023-03-28,08:00:00,38,35,3,ECO_300019380
642,Herenthoutsesteenweg 2,2023-03-28,09:00:00,132,125,7,ECO_300019380
642,Herenthoutsesteenweg 2,2023-03-28,10:00:00,437,434,3,ECO_300019380
642,Herenthoutsesteenweg 2,2023-03-28,11:00:00,99,97,2,ECO_300019380
642,Herenthoutsesteenweg 2,2023-03-28,12:00:00,67,62,5,ECO_300019380
642,Herenthoutsesteenweg 2,2023-03-28,13:00:00,63,59,4,ECO_300019380
642,Herenthoutsesteenweg 2,2023-03-28,14:00:00,83,79,4,ECO_300019380
642,Herenthoutsesteenweg 2,2023-03-28,15:00:00,108,98,10,ECO_300019380
642,Herenthoutsesteenweg 2,2023-03-28,16:00:00,86,79,7,ECO_300019380
642,Herenthoutsesteenweg 2,2023-03-28,17:00:00,106,95,11,ECO_300019380
642,Herenthoutsesteenweg 2,2023-03-28,18:00:00,120,105,15,ECO_300019380
642,Herenthoutsesteenweg 2,2023-03-28,19:00:00,68,59,9,ECO_300019380
642,Herenthoutsesteenweg 2,2023-03-28,20:00:00,59,51,8,ECO_300019380
642,Herenthoutsesteenweg 2,2023-03-28,21:00:00,20,20,0,ECO_300019380
642,Herenthoutsesteenweg 2,2023-03-28,22:00:00,9,8,1,ECO_300019380
642,Herenthoutsesteenweg 2,2023-03-28,23:00:00,17,13,4,ECO_300019380
642,Herenthoutsesteenweg 2,2023-03-29,00:00:00,14,13,1,ECO_300019380
642,Herenthoutsesteenweg 2,2023-03-29,01:00:00,3,2,1,ECO_300019380
642,Herenthoutsesteenweg 2,2023-03-29,02:00:00,2,1,1,ECO_300019380
642,Herenthoutsesteenweg 2,2023-03-29,03:00:00,5,3,2,ECO_300019380
642,Herenthoutsesteenweg 2,2023-03-29,04:00:00,0,0,0,ECO_300019380
642,Herenthoutsesteenweg 2,2023-03-29,05:00:00,1,1,0,ECO_300019380
642,Herenthoutsesteenweg 2,2023-03-29,06:00:00,2,2,0,ECO_300019380
642,Herenthoutsesteenweg 2,2023-03-29,07:00:00,16,14,2,ECO_300019380
642,Herenthoutsesteenweg 2,2023-03-29,08:00:00,32,27,5,ECO_300019380
642,Herenthoutsesteenweg 2,2023-03-29,09:00:00,128,124,4,ECO_300019380
642,Herenthoutsesteenweg 2,2023-03-29,10:00:00,342,336,6,ECO_300019380
642,Herenthoutsesteenweg 2,2023-03-29,11:00:00,95,91,4,ECO_300019380
642,Herenthoutsesteenweg 2,2023-03-29,12:00:00,45,41,4,ECO_300019380
642,Herenthoutsesteenweg 2,2023-03-29,13:00:00,55,52,3,ECO_300019380
642,Herenthoutsesteenweg 2,2023-03-29,14:00:00,100,94,6,ECO_300019380
642,Herenthoutsesteenweg 2,2023-03-29,15:00:00,109,101,8,ECO_300019380
642,Herenthoutsesteenweg 2,2023-03-29,16:00:00,131,121,10,ECO_300019380
642,Herenthoutsesteenweg 2,2023-03-29,17:00:00,85,73,12,ECO_300019380
642,Herenthoutsesteenweg 2,2023-03-29,18:00:00,114,98,16,ECO_300019380
642,Herenthoutsesteenweg 2,2023-03-29,19:00:00,103,92,11,ECO_300019380
642,Herenthoutsesteenweg 2,2023-03-29,20:00:00,48,44,4,ECO_300019380
642,Herenthoutsesteenweg 2,2023-03-29,21:00:00,31,27,4,ECO_300019380
642,Herenthoutsesteenweg 2,2023-03-29,22:00:00,36,34,2,ECO_300019380
642,Herenthoutsesteenweg 2,2023-03-29,23:00:00,22,17,5,ECO_300019380
642,Herenthoutsesteenweg 2,2023-03-30,00:00:00,20,17,3,ECO_300019380
642,Herenthoutsesteenweg 2,2023-03-30,01:00:00,10,7,3,ECO_300019380
642,Herenthoutsesteenweg 2,2023-03-30,02:00:00,1,1,0,ECO_300019380
642,Herenthoutsesteenweg 2,2023-03-30,03:00:00,2,1,1,ECO_300019380
642,Herenthoutsesteenweg 2,2023-03-30,04:00:00,0,0,0,ECO_300019380
642,Herenthoutsesteenweg 2,2023-03-30,05:00:00,1,1,0,ECO_300019380
642,Herenthoutsesteenweg 2,2023-03-30,06:00:00,6,6,0,ECO_300019380
642,Herenthoutsesteenweg 2,2023-03-30,07:00:00,13,13,0,ECO_300019380
642,Herenthoutsesteenweg 2,2023-03-30,08:00:00,43,40,3,ECO_300019380
642,Herenthoutsesteenweg 2,2023-03-30,09:00:00,107,103,4,ECO_300019380
642,Herenthoutsesteenweg 2,2023-03-30,10:00:00,233,230,3,ECO_300019380
642,Herenthoutsesteenweg 2,2023-03-30,11:00:00,63,62,1,ECO_300019380
642,Herenthoutsesteenweg 2,2023-03-30,12:00:00,53,51,2,ECO_300019380
642,Herenthoutsesteenweg 2,2023-03-30,13:00:00,58,56,2,ECO_300019380
642,Herenthoutsesteenweg 2,2023-03-30,14:00:00,56,49,7,ECO_300019380
642,Herenthoutsesteenweg 2,2023-03-30,15:00:00,49,46,3,ECO_300019380
642,Herenthoutsesteenweg 2,2023-03-30,16:00:00,56,50,6,ECO_300019380
642,Herenthoutsesteenweg 2,2023-03-30,17:00:00,94,83,11,ECO_300019380
642,Herenthoutsesteenweg 2,2023-03-30,18:00:00,107,98,9,ECO_300019380
642,Herenthoutsesteenweg 2,2023-03-30,19:00:00,51,46,5,ECO_300019380
642,Herenthoutsesteenweg 2,2023-03-30,20:00:00,49,41,8,ECO_300019380
642,Herenthoutsesteenweg 2,2023-03-30,21:00:00,65,59,6,ECO_300019380
642,Herenthoutsesteenweg 2,2023-03-30,22:00:00,23,20,3,ECO_300019380
642,Herenthoutsesteenweg 2,2023-03-30,23:00:00,19,14,5,ECO_300019380
642,Herenthoutsesteenweg 2,2023-03-31,00:00:00,14,14,0,ECO_300019380
642,Herenthoutsesteenweg 2,2023-03-31,01:00:00,6,6,0,ECO_300019380
642,Herenthoutsesteenweg 2,2023-03-31,02:00:00,3,2,1,ECO_300019380
642,Herenthoutsesteenweg 2,2023-03-31,03:00:00,2,0,2,ECO_300019380
642,Herenthoutsesteenweg 2,2023-03-31,04:00:00,2,2,0,ECO_300019380
642,Herenthoutsesteenweg 2,2023-03-31,05:00:00,1,1,0,ECO_300019380
642,Herenthoutsesteenweg 2,2023-03-31,06:00:00,1,1,0,ECO_300019380
642,Herenthoutsesteenweg 2,2023-03-31,07:00:00,9,9,0,ECO_300019380
642,Herenthoutsesteenweg 2,2023-03-31,08:00:00,11,9,2,ECO_300019380
642,Herenthoutsesteenweg 2,2023-03-31,09:00:00,59,58,1,ECO_300019380
642,Herenthoutsesteenweg 2,2023-03-31,10:00:00,150,149,1,ECO_300019380
642,Herenthoutsesteenweg 2,2023-03-31,11:00:00,110,107,3,ECO_300019380
642,Herenthoutsesteenweg 2,2023-03-31,12:00:00,52,48,4,ECO_300019380
642,Herenthoutsesteenweg 2,2023-03-31,13:00:00,49,46,3,ECO_300019380
642,Herenthoutsesteenweg 2,2023-03-31,14:00:00,35,31,4,ECO_300019380
642,Herenthoutsesteenweg 2,2023-03-31,15:00:00,41,31,10,ECO_300019380
642,Herenthoutsesteenweg 2,2023-03-31,16:00:00,29,26,3,ECO_300019380
642,Herenthoutsesteenweg 2,2023-03-31,17:00:00,60,53,7,ECO_300019380
642,Herenthoutsesteenweg 2,2023-03-31,18:00:00,63,60,3,ECO_300019380
642,Herenthoutsesteenweg 2,2023-03-31,19:00:00,39,36,3,ECO_300019380
642,Herenthoutsesteenweg 2,2023-03-31,20:00:00,37,33,4,ECO_300019380
642,Herenthoutsesteenweg 2,2023-03-31,21:00:00,22,19,3,ECO_300019380
642,Herenthoutsesteenweg 2,2023-03-31,22:00:00,45,42,3,ECO_300019380
642,Herenthoutsesteenweg 2,2023-03-31,23:00:00,24,21,3,ECO_300019380
642,Herenthoutsesteenweg 2,2023-04-01,00:00:00,19,15,4,ECO_300019380
642,Herenthoutsesteenweg 2,2023-04-01,01:00:00,4,3,1,ECO_300019380
642,Herenthoutsesteenweg 2,2023-04-01,02:00:00,5,4,1,ECO_300019380
642,Herenthoutsesteenweg 2,2023-04-01,03:00:00,5,3,2,ECO_300019380
642,Herenthoutsesteenweg 2,2023-04-01,04:00:00,3,2,1,ECO_300019380
642,Herenthoutsesteenweg 2,2023-04-01,05:00:00,1,0,1,ECO_300019380
642,Herenthoutsesteenweg 2,2023-04-01,06:00:00,0,0,0,ECO_300019380
642,Herenthoutsesteenweg 2,2023-04-01,07:00:00,0,0,0,ECO_300019380
642,Herenthoutsesteenweg 2,2023-04-01,08:00:00,8,8,0,ECO_300019380
642,Herenthoutsesteenweg 2,2023-04-01,09:00:00,2,2,0,ECO_300019380
642,Herenthoutsesteenweg 2,2023-04-01,10:00:00,27,27,0,ECO_300019380
642,Herenthoutsesteenweg 2,2023-04-01,11:00:00,14,14,0,ECO_300019380
642,Herenthoutsesteenweg 2,2023-04-01,12:00:00,25,24,1,ECO_300019380
642,Herenthoutsesteenweg 2,2023-04-01,13:00:00,23,19,4,ECO_300019380
642,Herenthoutsesteenweg 2,2023-04-01,14:00:00,19,18,1,ECO_300019380
642,Herenthoutsesteenweg 2,2023-04-01,15:00:00,20,20,0,ECO_300019380
642,Herenthoutsesteenweg 2,2023-04-01,16:00:00,12,12,0,ECO_300019380
642,Herenthoutsesteenweg 2,2023-04-01,17:00:00,24,21,3,ECO_300019380
642,Herenthoutsesteenweg 2,2023-04-01,18:00:00,27,24,3,ECO_300019380
642,Herenthoutsesteenweg 2,2023-04-01,19:00:00,15,14,1,ECO_300019380
642,Herenthoutsesteenweg 2,2023-04-01,20:00:00,13,9,4,ECO_300019380
642,Herenthoutsesteenweg 2,2023-04-01,21:00:00,17,16,1,ECO_300019380
642,Herenthoutsesteenweg 2,2023-04-01,22:00:00,6,6,0,ECO_300019380
642,Herenthoutsesteenweg 2,2023-04-01,23:00:00,7,5,2,ECO_300019380
642,Herenthoutsesteenweg 2,2023-04-02,00:00:00,7,4,3,ECO_300019380
642,Herenthoutsesteenweg 2,2023-04-02,01:00:00,3,3,0,ECO_300019380
642,Herenthoutsesteenweg 2,2023-04-02,02:00:00,13,9,4,ECO_300019380
642,Herenthoutsesteenweg 2,2023-04-02,03:00:00,15,14,1,ECO_300019380
642,Herenthoutsesteenweg 2,2023-04-02,04:00:00,3,3,0,ECO_300019380
642,Herenthoutsesteenweg 2,2023-04-02,05:00:00,1,1,0,ECO_300019380
642,Herenthoutsesteenweg 2,2023-04-02,06:00:00,0,0,0,ECO_300019380
642,Herenthoutsesteenweg 2,2023-04-02,07:00:00,1,1,0,ECO_300019380
642,Herenthoutsesteenweg 2,2023-04-02,08:00:00,5,4,1,ECO_300019380
642,Herenthoutsesteenweg 2,2023-04-02,09:00:00,18,17,1,ECO_300019380
642,Herenthoutsesteenweg 2,2023-04-02,10:00:00,50,46,4,ECO_300019380
642,Herenthoutsesteenweg 2,2023-04-02,11:00:00,104,97,7,ECO_300019380
642,Herenthoutsesteenweg 2,2023-04-02,12:00:00,68,57,11,ECO_300019380
642,Herenthoutsesteenweg 2,2023-04-02,13:00:00,82,59,23,ECO_300019380
642,Herenthoutsesteenweg 2,2023-04-02,14:00:00,48,36,12,ECO_300019380
642,Herenthoutsesteenweg 2,2023-04-02,15:00:00,52,44,8,ECO_300019380
642,Herenthoutsesteenweg 2,2023-04-02,16:00:00,57,56,1,ECO_300019380
642,Herenthoutsesteenweg 2,2023-04-02,17:00:00,30,26,4,ECO_300019380
642,Herenthoutsesteenweg 2,2023-04-02,18:00:00,32,29,3,ECO_300019380
642,Herenthoutsesteenweg 2,2023-04-02,19:00:00,21,17,4,ECO_300019380
642,Herenthoutsesteenweg 2,2023-04-02,20:00:00,39,36,3,ECO_300019380
642,Herenthoutsesteenweg 2,2023-04-02,21:00:00,30,29,1,ECO_300019380
642,Herenthoutsesteenweg 2,2023-04-02,22:00:00,13,11,2,ECO_300019380
642,Herenthoutsesteenweg 2,2023-04-02,23:00:00,5,3,2,ECO_300019380
642,Herenthoutsesteenweg 2,2023-04-03,00:00:00,5,4,1,ECO_300019380
642,Herenthoutsesteenweg 2,2023-04-03,01:00:00,9,5,4,ECO_300019380
642,Herenthoutsesteenweg 2,2023-04-03,02:00:00,5,3,2,ECO_300019380
642,Herenthoutsesteenweg 2,2023-04-03,03:00:00,1,0,1,ECO_300019380
642,Herenthoutsesteenweg 2,2023-04-03,04:00:00,1,0,1,ECO_300019380
642,Herenthoutsesteenweg 2,2023-04-03,05:00:00,0,0,0,ECO_300019380
642,Herenthoutsesteenweg 2,2023-04-03,06:00:00,2,2,0,ECO_300019380
642,Herenthoutsesteenweg 2,2023-04-03,07:00:00,23,20,3,ECO_300019380
642,Herenthoutsesteenweg 2,2023-04-03,08:00:00,36,28,8,ECO_300019380
642,Herenthoutsesteenweg 2,2023-04-03,09:00:00,86,80,6,ECO_300019380
642,Herenthoutsesteenweg 2,2023-04-03,10:00:00,57,56,1,ECO_300019380
642,Herenthoutsesteenweg 2,2023-04-03,11:00:00,65,61,4,ECO_300019380
642,Herenthoutsesteenweg 2,2023-04-03,12:00:00,55,51,4,ECO_300019380
642,Herenthoutsesteenweg 2,2023-04-03,13:00:00,74,65,9,ECO_300019380
642,Herenthoutsesteenweg 2,2023-04-03,14:00:00,56,51,5,ECO_300019380
642,Herenthoutsesteenweg 2,2023-04-03,15:00:00,104,96,8,ECO_300019380
642,Herenthoutsesteenweg 2,2023-04-03,16:00:00,100,94,6,ECO_300019380
642,Herenthoutsesteenweg 2,2023-04-03,17:00:00,75,65,10,ECO_300019380
642,Herenthoutsesteenweg 2,2023-04-03,18:00:00,100,83,17,ECO_300019380
642,Herenthoutsesteenweg 2,2023-04-03,19:00:00,86,70,16,ECO_300019380
642,Herenthoutsesteenweg 2,2023-04-03,20:00:00,62,51,11,ECO_300019380
642,Herenthoutsesteenweg 2,2023-04-03,21:00:00,37,31,6,ECO_300019380
642,Herenthoutsesteenweg 2,2023-04-03,22:00:00,30,22,8,ECO_300019380
642,Herenthoutsesteenweg 2,2023-04-03,23:00:00,10,8,2,ECO_300019380
642,Herenthoutsesteenweg 2,2023-04-04,00:00:00,16,14,2,ECO_300019380
642,Herenthoutsesteenweg 2,2023-04-04,01:00:00,3,3,0,ECO_300019380
642,Herenthoutsesteenweg 2,2023-04-04,02:00:00,0,0,0,ECO_300019380
642,Herenthoutsesteenweg 2,2023-04-04,03:00:00,0,0,0,ECO_300019380
642,Herenthoutsesteenweg 2,2023-04-04,04:00:00,1,1,0,ECO_300019380
642,Herenthoutsesteenweg 2,2023-04-04,05:00:00,1,1,0,ECO_300019380
642,Herenthoutsesteenweg 2,2023-04-04,06:00:00,1,1,0,ECO_300019380
642,Herenthoutsesteenweg 2,2023-04-04,07:00:00,19,16,3,ECO_300019380
642,Herenthoutsesteenweg 2,2023-04-04,08:00:00,47,40,7,ECO_300019380
642,Herenthoutsesteenweg 2,2023-04-04,09:00:00,94,91,3,ECO_300019380
642,Herenthoutsesteenweg 2,2023-04-04,10:00:00,74,71,3,ECO_300019380
642,Herenthoutsesteenweg 2,2023-04-04,11:00:00,53,53,0,ECO_300019380
642,Herenthoutsesteenweg 2,2023-04-04,12:00:00,72,67,5,ECO_300019380
642,Herenthoutsesteenweg 2,2023-04-04,13:00:00,78,64,14,ECO_300019380
642,Herenthoutsesteenweg 2,2023-04-04,14:00:00,65,60,5,ECO_300019380
642,Herenthoutsesteenweg 2,2023-04-04,15:00:00,123,117,6,ECO_300019380
642,Herenthoutsesteenweg 2,2023-04-04,16:00:00,128,109,19,ECO_300019380
642,Herenthoutsesteenweg 2,2023-04-04,17:00:00,115,99,16,ECO_300019380
642,Herenthoutsesteenweg 2,2023-04-04,18:00:00,128,115,13,ECO_300019380
642,Herenthoutsesteenweg 2,2023-04-04,19:00:00,92,72,20,ECO_300019380
642,Herenthoutsesteenweg 2,2023-04-04,20:00:00,51,38,13,ECO_300019380
642,Herenthoutsesteenweg 2,2023-04-04,21:00:00,52,42,10,ECO_300019380
642,Herenthoutsesteenweg 2,2023-04-04,22:00:00,25,15,10,ECO_300019380
642,Herenthoutsesteenweg 2,2023-04-04,23:00:00,22,17,5,ECO_300019380
642,Herenthoutsesteenweg 2,2023-04-05,00:00:00,15,14,1,ECO_300019380
642,Herenthoutsesteenweg 2,2023-04-05,01:00:00,2,1,1,ECO_300019380
642,Herenthoutsesteenweg 2,2023-04-05,02:00:00,2,2,0,ECO_300019380
642,Herenthoutsesteenweg 2,2023-04-05,03:00:00,0,0,0,ECO_300019380
642,Herenthoutsesteenweg 2,2023-04-05,04:00:00,2,2,0,ECO_300019380
642,Herenthoutsesteenweg 2,2023-04-05,05:00:00,1,0,1,ECO_300019380
642,Herenthoutsesteenweg 2,2023-04-05,06:00:00,1,1,0,ECO_300019380
642,Herenthoutsesteenweg 2,2023-04-05,07:00:00,21,20,1,ECO_300019380
642,Herenthoutsesteenweg 2,2023-04-05,08:00:00,34,28,6,ECO_300019380
642,Herenthoutsesteenweg 2,2023-04-05,09:00:00,73,71,2,ECO_300019380
642,Herenthoutsesteenweg 2,2023-04-05,10:00:00,54,51,3,ECO_300019380
642,Herenthoutsesteenweg 2,2023-04-05,11:00:00,66,60,6,ECO_300019380
642,Herenthoutsesteenweg 2,2023-04-05,12:00:00,82,81,1,ECO_300019380
642,Herenthoutsesteenweg 2,2023-04-05,13:00:00,81,75,6,ECO_300019380
642,Herenthoutsesteenweg 2,2023-04-05,14:00:00,86,81,5,ECO_300019380
642,Herenthoutsesteenweg 2,2023-04-05,15:00:00,137,132,5,ECO_300019380
642,Herenthoutsesteenweg 2,2023-04-05,16:00:00,172,153,19,ECO_300019380
642,Herenthoutsesteenweg 2,2023-04-05,17:00:00,130,112,18,ECO_300019380
642,Herenthoutsesteenweg 2,2023-04-05,18:00:00,132,123,9,ECO_300019380
642,Herenthoutsesteenweg 2,2023-04-05,19:00:00,91,75,16,ECO_300019380
642,Herenthoutsesteenweg 2,2023-04-05,20:00:00,64,57,7,ECO_300019380
642,Herenthoutsesteenweg 2,2023-04-05,21:00:00,63,43,20,ECO_300019380
642,Herenthoutsesteenweg 2,2023-04-05,22:00:00,35,28,7,ECO_300019380
642,Herenthoutsesteenweg 2,2023-04-05,23:00:00,21,18,3,ECO_300019380
642,Herenthoutsesteenweg 2,2023-04-06,00:00:00,15,14,1,ECO_300019380
642,Herenthoutsesteenweg 2,2023-04-06,01:00:00,2,2,0,ECO_300019380
642,Herenthoutsesteenweg 2,2023-04-06,02:00:00,2,2,0,ECO_300019380
642,Herenthoutsesteenweg 2,2023-04-06,03:00:00,0,0,0,ECO_300019380
642,Herenthoutsesteenweg 2,2023-04-06,04:00:00,2,2,0,ECO_300019380
642,Herenthoutsesteenweg 2,2023-04-06,05:00:00,0,0,0,ECO_300019380
642,Herenthoutsesteenweg 2,2023-04-06,06:00:00,2,1,1,ECO_300019380
642,Herenthoutsesteenweg 2,2023-04-06,07:00:00,13,12,1,ECO_300019380
642,Herenthoutsesteenweg 2,2023-04-06,08:00:00,29,26,3,ECO_300019380
642,Herenthoutsesteenweg 2,2023-04-06,09:00:00,76,74,2,ECO_300019380
642,Herenthoutsesteenweg 2,2023-04-06,10:00:00,55,53,2,ECO_300019380
642,Herenthoutsesteenweg 2,2023-04-06,11:00:00,51,49,2,ECO_300019380
642,Herenthoutsesteenweg 2,2023-04-06,12:00:00,22,22,0,ECO_300019380
642,Herenthoutsesteenweg 2,2023-04-06,13:00:00,19,18,1,ECO_300019380
642,Herenthoutsesteenweg 2,2023-04-06,14:00:00,26,22,4,ECO_300019380
642,Herenthoutsesteenweg 2,2023-04-06,15:00:00,29,27,2,ECO_300019380
642,Herenthoutsesteenweg 2,2023-04-06,16:00:00,52,47,5,ECO_300019380
642,Herenthoutsesteenweg 2,2023-04-06,17:00:00,43,32,11,ECO_300019380
642,Herenthoutsesteenweg 2,2023-04-06,18:00:00,81,70,11,ECO_300019380
642,Herenthoutsesteenweg 2,2023-04-06,19:00:00,49,40,9,ECO_300019380
642,Herenthoutsesteenweg 2,2023-04-06,20:00:00,20,20,0,ECO_300019380
642,Herenthoutsesteenweg 2,2023-04-06,21:00:00,23,21,2,ECO_300019380
642,Herenthoutsesteenweg 2,2023-04-06,22:00:00,11,9,2,ECO_300019380
642,Herenthoutsesteenweg 2,2023-04-06,23:00:00,7,5,2,ECO_300019380
642,Herenthoutsesteenweg 2,2023-04-07,00:00:00,8,7,1,ECO_300019380
642,Herenthoutsesteenweg 2,2023-04-07,01:00:00,1,0,1,ECO_300019380
642,Herenthoutsesteenweg 2,2023-04-07,02:00:00,2,2,0,ECO_300019380
642,Herenthoutsesteenweg 2,2023-04-07,03:00:00,2,2,0,ECO_300019380
642,Herenthoutsesteenweg 2,2023-04-07,04:00:00,3,3,0,ECO_300019380
642,Herenthoutsesteenweg 2,2023-04-07,05:00:00,1,1,0,ECO_300019380
642,Herenthoutsesteenweg 2,2023-04-07,06:00:00,1,1,0,ECO_300019380
642,Herenthoutsesteenweg 2,2023-04-07,07:00:00,19,17,2,ECO_300019380
642,Herenthoutsesteenweg 2,2023-04-07,08:00:00,22,18,4,ECO_300019380
642,Herenthoutsesteenweg 2,2023-04-07,09:00:00,70,69,1,ECO_300019380
642,Herenthoutsesteenweg 2,2023-04-07,10:00:00,47,44,3,ECO_300019380
642,Herenthoutsesteenweg 2,2023-04-07,11:00:00,85,82,3,ECO_300019380
642,Herenthoutsesteenweg 2,2023-04-07,12:00:00,87,83,4,ECO_300019380
642,Herenthoutsesteenweg 2,2023-04-07,13:00:00,59,55,4,ECO_300019380
642,Herenthoutsesteenweg 2,2023-04-07,14:00:00,53,48,5,ECO_300019380
642,Herenthoutsesteenweg 2,2023-04-07,15:00:00,68,61,7,ECO_300019380
642,Herenthoutsesteenweg 2,2023-04-07,16:00:00,82,70,12,ECO_300019380
642,Herenthoutsesteenweg 2,2023-04-07,17:00:00,69,59,10,ECO_300019380
642,Herenthoutsesteenweg 2,2023-04-07,18:00:00,94,88,6,ECO_300019380
642,Herenthoutsesteenweg 2,2023-04-07,19:00:00,63,55,8,ECO_300019380
642,Herenthoutsesteenweg 2,2023-04-07,20:00:00,53,42,11,ECO_300019380
642,Herenthoutsesteenweg 2,2023-04-07,21:00:00,51,43,8,ECO_300019380
642,Herenthoutsesteenweg 2,2023-04-07,22:00:00,38,36,2,ECO_300019380
642,Herenthoutsesteenweg 2,2023-04-07,23:00:00,20,19,1,ECO_300019380
642,Herenthoutsesteenweg 2,2023-04-08,00:00:00,18,16,2,ECO_300019380
642,Herenthoutsesteenweg 2,2023-04-08,01:00:00,11,9,2,ECO_300019380
642,Herenthoutsesteenweg 2,2023-04-08,02:00:00,9,8,1,ECO_300019380
642,Herenthoutsesteenweg 2,2023-04-08,03:00:00,15,12,3,ECO_300019380
642,Herenthoutsesteenweg 2,2023-04-08,04:00:00,4,1,3,ECO_300019380
642,Herenthoutsesteenweg 2,2023-04-08,05:00:00,3,1,2,ECO_300019380
642,Herenthoutsesteenweg 2,2023-04-08,06:00:00,4,2,2,ECO_300019380
642,Herenthoutsesteenweg 2,2023-04-08,07:00:00,5,4,1,ECO_300019380
642,Herenthoutsesteenweg 2,2023-04-08,08:00:00,11,10,1,ECO_300019380
642,Herenthoutsesteenweg 2,2023-04-08,09:00:00,9,9,0,ECO_300019380
642,Herenthoutsesteenweg 2,2023-04-08,10:00:00,32,32,0,ECO_300019380
642,Herenthoutsesteenweg 2,2023-04-08,11:00:00,61,59,2,ECO_300019380
642,Herenthoutsesteenweg 2,2023-04-08,12:00:00,75,73,2,ECO_300019380
642,Herenthoutsesteenweg 2,2023-04-08,13:00:00,93,86,7,ECO_300019380
642,Herenthoutsesteenweg 2,2023-04-08,14:00:00,94,79,15,ECO_300019380
642,Herenthoutsesteenweg 2,2023-04-08,15:00:00,145,133,12,ECO_300019380
642,Herenthoutsesteenweg 2,2023-04-08,16:00:00,156,131,25,ECO_300019380
642,Herenthoutsesteenweg 2,2023-04-08,17:00:00,107,89,18,ECO_300019380
642,Herenthoutsesteenweg 2,2023-04-08,18:00:00,87,65,22,ECO_300019380
642,Herenthoutsesteenweg 2,2023-04-08,19:00:00,63,51,12,ECO_300019380
642,Herenthoutsesteenweg 2,2023-04-08,20:00:00,71,60,11,ECO_300019380
642,Herenthoutsesteenweg 2,2023-04-08,21:00:00,56,51,5,ECO_300019380
642,Herenthoutsesteenweg 2,2023-04-08,22:00:00,28,27,1,ECO_300019380
642,Herenthoutsesteenweg 2,2023-04-08,23:00:00,18,17,1,ECO_300019380
642,Herenthoutsesteenweg 2,2023-04-09,00:00:00,24,22,2,ECO_300019380
642,Herenthoutsesteenweg 2,2023-04-09,01:00:00,17,14,3,ECO_300019380
642,Herenthoutsesteenweg 2,2023-04-09,02:00:00,16,10,6,ECO_300019380
642,Herenthoutsesteenweg 2,2023-04-09,03:00:00,4,4,0,ECO_300019380
642,Herenthoutsesteenweg 2,2023-04-09,04:00:00,8,6,2,ECO_300019380
642,Herenthoutsesteenweg 2,2023-04-09,05:00:00,2,0,2,ECO_300019380
642,Herenthoutsesteenweg 2,2023-04-09,06:00:00,3,0,3,ECO_300019380
642,Herenthoutsesteenweg 2,2023-04-09,07:00:00,4,4,0,ECO_300019380
642,Herenthoutsesteenweg 2,2023-04-09,08:00:00,6,6,0,ECO_300019380
642,Herenthoutsesteenweg 2,2023-04-09,09:00:00,17,16,1,ECO_300019380
642,Herenthoutsesteenweg 2,2023-04-09,10:00:00,64,55,9,ECO_300019380
642,Herenthoutsesteenweg 2,2023-04-09,11:00:00,79,75,4,ECO_300019380
642,Herenthoutsesteenweg 2,2023-04-09,12:00:00,128,118,10,ECO_300019380
642,Herenthoutsesteenweg 2,2023-04-09,13:00:00,91,80,11,ECO_300019380
642,Herenthoutsesteenweg 2,2023-04-09,14:00:00,72,60,12,ECO_300019380
642,Herenthoutsesteenweg 2,2023-04-09,15:00:00,90,74,16,ECO_300019380
642,Herenthoutsesteenweg 2,2023-04-09,16:00:00,87,76,11,ECO_300019380
642,Herenthoutsesteenweg 2,2023-04-09,17:00:00,96,79,17,ECO_300019380
642,Herenthoutsesteenweg 2,2023-04-09,18:00:00,54,47,7,ECO_300019380
642,Herenthoutsesteenweg 2,2023-04-09,19:00:00,52,45,7,ECO_300019380
642,Herenthoutsesteenweg 2,2023-04-09,20:00:00,62,54,8,ECO_300019380
642,Herenthoutsesteenweg 2,2023-04-09,21:00:00,64,62,2,ECO_300019380
642,Herenthoutsesteenweg 2,2023-04-09,22:00:00,35,29,6,ECO_300019380
642,Herenthoutsesteenweg 2,2023-04-09,23:00:00,10,7,3,ECO_300019380
642,Herenthoutsesteenweg 2,2023-04-10,00:00:00,15,10,5,ECO_300019380
642,Herenthoutsesteenweg 2,2023-04-10,01:00:00,12,12,0,ECO_300019380
642,Herenthoutsesteenweg 2,2023-04-10,02:00:00,5,3,2,ECO_300019380
642,Herenthoutsesteenweg 2,2023-04-10,03:00:00,2,2,0,ECO_300019380
642,Herenthoutsesteenweg 2,2023-04-10,04:00:00,0,0,0,ECO_300019380
642,Herenthoutsesteenweg 2,2023-04-10,05:00:00,1,1,0,ECO_300019380
642,Herenthoutsesteenweg 2,2023-04-10,06:00:00,4,4,0,ECO_300019380
642,Herenthoutsesteenweg 2,2023-04-10,07:00:00,5,4,1,ECO_300019380
642,Herenthoutsesteenweg 2,2023-04-10,08:00:00,8,8,0,ECO_300019380
642,Herenthoutsesteenweg 2,2023-04-10,09:00:00,17,17,0,ECO_300019380
642,Herenthoutsesteenweg 2,2023-04-10,10:00:00,16,16,0,ECO_300019380
642,Herenthoutsesteenweg 2,2023-04-10,11:00:00,43,36,7,ECO_300019380
642,Herenthoutsesteenweg 2,2023-04-10,12:00:00,50,45,5,ECO_300019380
642,Herenthoutsesteenweg 2,2023-04-10,13:00:00,61,52,9,ECO_300019380
642,Herenthoutsesteenweg 2,2023-04-10,14:00:00,69,64,5,ECO_300019380
642,Herenthoutsesteenweg 2,2023-04-10,15:00:00,65,57,8,ECO_300019380
642,Herenthoutsesteenweg 2,2023-04-10,16:00:00,76,73,3,ECO_300019380
642,Herenthoutsesteenweg 2,2023-04-10,17:00:00,38,35,3,ECO_300019380
642,Herenthoutsesteenweg 2,2023-04-10,18:00:00,19,14,5,ECO_300019380
642,Herenthoutsesteenweg 2,2023-04-10,19:00:00,13,11,2,ECO_300019380
642,Herenthoutsesteenweg 2,2023-04-10,20:00:00,22,20,2,ECO_300019380
642,Herenthoutsesteenweg 2,2023-04-10,21:00:00,7,7,0,ECO_300019380
642,Herenthoutsesteenweg 2,2023-04-10,22:00:00,6,5,1,ECO_300019380
642,Herenthoutsesteenweg 2,2023-04-10,23:00:00,4,4,0,ECO_300019380
642,Herenthoutsesteenweg 2,2023-04-11,00:00:00,1,1,0,ECO_300019380
642,Herenthoutsesteenweg 2,2023-04-11,01:00:00,1,0,1,ECO_300019380
642,Herenthoutsesteenweg 2,2023-04-11,02:00:00,3,2,1,ECO_300019380
642,Herenthoutsesteenweg 2,2023-04-11,03:00:00,0,0,0,ECO_300019380
642,Herenthoutsesteenweg 2,2023-04-11,04:00:00,0,0,0,ECO_300019380
642,Herenthoutsesteenweg 2,2023-04-11,05:00:00,0,0,0,ECO_300019380
642,Herenthoutsesteenweg 2,2023-04-11,06:00:00,2,1,1,ECO_300019380
642,Herenthoutsesteenweg 2,2023-04-11,07:00:00,16,13,3,ECO_300019380
642,Herenthoutsesteenweg 2,2023-04-11,08:00:00,27,25,2,ECO_300019380
642,Herenthoutsesteenweg 2,2023-04-11,09:00:00,94,83,11,ECO_300019380
642,Herenthoutsesteenweg 2,2023-04-11,10:00:00,75,72,3,ECO_300019380
642,Herenthoutsesteenweg 2,2023-04-11,11:00:00,84,79,5,ECO_300019380
642,Herenthoutsesteenweg 2,2023-04-11,12:00:00,80,73,7,ECO_300019380
642,Herenthoutsesteenweg 2,2023-04-11,13:00:00,66,62,4,ECO_300019380
642,Herenthoutsesteenweg 2,2023-04-11,14:00:00,48,44,4,ECO_300019380
642,Herenthoutsesteenweg 2,2023-04-11,15:00:00,91,87,4,ECO_300019380
642,Herenthoutsesteenweg 2,2023-04-11,16:00:00,111,95,16,ECO_300019380
642,Herenthoutsesteenweg 2,2023-04-11,17:00:00,91,79,12,ECO_300019380
642,Herenthoutsesteenweg 2,2023-04-11,18:00:00,116,108,8,ECO_300019380
642,Herenthoutsesteenweg 2,2023-04-11,19:00:00,81,73,8,ECO_300019380
642,Herenthoutsesteenweg 2,2023-04-11,20:00:00,62,51,11,ECO_300019380
642,Herenthoutsesteenweg 2,2023-04-11,21:00:00,40,37,3,ECO_300019380
642,Herenthoutsesteenweg 2,2023-04-11,22:00:00,30,29,1,ECO_300019380
642,Herenthoutsesteenweg 2,2023-04-11,23:00:00,19,18,1,ECO_300019380
642,Herenthoutsesteenweg 2,2023-04-12,00:00:00,15,12,3,ECO_300019380
642,Herenthoutsesteenweg 2,2023-04-12,01:00:00,7,4,3,ECO_300019380
642,Herenthoutsesteenweg 2,2023-04-12,02:00:00,2,1,1,ECO_300019380
642,Herenthoutsesteenweg 2,2023-04-12,03:00:00,1,0,1,ECO_300019380
642,Herenthoutsesteenweg 2,2023-04-12,04:00:00,2,1,1,ECO_300019380
642,Herenthoutsesteenweg 2,2023-04-12,05:00:00,1,1,0,ECO_300019380
642,Herenthoutsesteenweg 2,2023-04-12,06:00:00,2,2,0,ECO_300019380
642,Herenthoutsesteenweg 2,2023-04-12,07:00:00,11,10,1,ECO_300019380
642,Herenthoutsesteenweg 2,2023-04-12,08:00:00,25,21,4,ECO_300019380
642,Herenthoutsesteenweg 2,2023-04-12,09:00:00,41,39,2,ECO_300019380
642,Herenthoutsesteenweg 2,2023-04-12,10:00:00,27,26,1,ECO_300019380
642,Herenthoutsesteenweg 2,2023-04-12,11:00:00,28,26,2,ECO_300019380
642,Herenthoutsesteenweg 2,2023-04-12,12:00:00,37,36,1,ECO_300019380
642,Herenthoutsesteenweg 2,2023-04-12,13:00:00,40,38,2,ECO_300019380
642,Herenthoutsesteenweg 2,2023-04-12,14:00:00,32,29,3,ECO_300019380
642,Herenthoutsesteenweg 2,2023-04-12,15:00:00,51,45,6,ECO_300019380
642,Herenthoutsesteenweg 2,2023-04-12,16:00:00,41,39,2,ECO_300019380
642,Herenthoutsesteenweg 2,2023-04-12,17:00:00,45,40,5,ECO_300019380
642,Herenthoutsesteenweg 2,2023-04-12,18:00:00,50,48,2,ECO_300019380
642,Herenthoutsesteenweg 2,2023-04-12,19:00:00,61,54,7,ECO_300019380
642,Herenthoutsesteenweg 2,2023-04-12,20:00:00,34,29,5,ECO_300019380
642,Herenthoutsesteenweg 2,2023-04-12,21:00:00,31,27,4,ECO_300019380
642,Herenthoutsesteenweg 2,2023-04-12,22:00:00,25,22,3,ECO_300019380
642,Herenthoutsesteenweg 2,2023-04-12,23:00:00,19,16,3,ECO_300019380
642,Herenthoutsesteenweg 2,2023-04-13,00:00:00,20,17,3,ECO_300019380
642,Herenthoutsesteenweg 2,2023-04-13,01:00:00,2,2,0,ECO_300019380
642,Herenthoutsesteenweg 2,2023-04-13,02:00:00,3,3,0,ECO_300019380
642,Herenthoutsesteenweg 2,2023-04-13,03:00:00,4,1,3,ECO_300019380
642,Herenthoutsesteenweg 2,2023-04-13,04:00:00,1,0,1,ECO_300019380
642,Herenthoutsesteenweg 2,2023-04-13,05:00:00,0,0,0,ECO_300019380
642,Herenthoutsesteenweg 2,2023-04-13,06:00:00,2,2,0,ECO_300019380
642,Herenthoutsesteenweg 2,2023-04-13,07:00:00,12,11,1,ECO_300019380
642,Herenthoutsesteenweg 2,2023-04-13,08:00:00,39,35,4,ECO_300019380
642,Herenthoutsesteenweg 2,2023-04-13,09:00:00,85,83,2,ECO_300019380
642,Herenthoutsesteenweg 2,2023-04-13,10:00:00,61,57,4,ECO_300019380
642,Herenthoutsesteenweg 2,2023-04-13,11:00:00,48,45,3,ECO_300019380
642,Herenthoutsesteenweg 2,2023-04-13,12:00:00,58,57,1,ECO_300019380
642,Herenthoutsesteenweg 2,2023-04-13,13:00:00,35,33,2,ECO_300019380
642,Herenthoutsesteenweg 2,2023-04-13,14:00:00,60,53,7,ECO_300019380
642,Herenthoutsesteenweg 2,2023-04-13,15:00:00,76,72,4,ECO_300019380
642,Herenthoutsesteenweg 2,2023-04-13,16:00:00,100,91,9,ECO_300019380
642,Herenthoutsesteenweg 2,2023-04-13,17:00:00,83,72,11,ECO_300019380
642,Herenthoutsesteenweg 2,2023-04-13,18:00:00,133,124,9,ECO_300019380
642,Herenthoutsesteenweg 2,2023-04-13,19:00:00,72,63,9,ECO_300019380
642,Herenthoutsesteenweg 2,2023-04-13,20:00:00,51,47,4,ECO_300019380
642,Herenthoutsesteenweg 2,2023-04-13,21:00:00,33,31,2,ECO_300019380
642,Herenthoutsesteenweg 2,2023-04-13,22:00:00,26,17,9,ECO_300019380
642,Herenthoutsesteenweg 2,2023-04-13,23:00:00,12,11,1,ECO_300019380
642,Herenthoutsesteenweg 2,2023-04-14,00:00:00,14,11,3,ECO_300019380
642,Herenthoutsesteenweg 2,2023-04-14,01:00:00,8,3,5,ECO_300019380
642,Herenthoutsesteenweg 2,2023-04-14,02:00:00,4,3,1,ECO_300019380
642,Herenthoutsesteenweg 2,2023-04-14,03:00:00,6,5,1,ECO_300019380
642,Herenthoutsesteenweg 2,2023-04-14,04:00:00,1,1,0,ECO_300019380
642,Herenthoutsesteenweg 2,2023-04-14,05:00:00,1,1,0,ECO_300019380
642,Herenthoutsesteenweg 2,2023-04-14,06:00:00,2,2,0,ECO_300019380
642,Herenthoutsesteenweg 2,2023-04-14,07:00:00,15,13,2,ECO_300019380
642,Herenthoutsesteenweg 2,2023-04-14,08:00:00,23,19,4,ECO_300019380
642,Herenthoutsesteenweg 2,2023-04-14,09:00:00,71,66,5,ECO_300019380
642,Herenthoutsesteenweg 2,2023-04-14,10:00:00,85,79,6,ECO_300019380
642,Herenthoutsesteenweg 2,2023-04-14,11:00:00,120,117,3,ECO_300019380
642,Herenthoutsesteenweg 2,2023-04-14,12:00:00,127,121,6,ECO_300019380
642,Herenthoutsesteenweg 2,2023-04-14,13:00:00,85,83,2,ECO_300019380
642,Herenthoutsesteenweg 2,2023-04-14,14:00:00,68,61,7,ECO_300019380
642,Herenthoutsesteenweg 2,2023-04-14,15:00:00,94,88,6,ECO_300019380
642,Herenthoutsesteenweg 2,2023-04-14,16:00:00,106,100,6,ECO_300019380
642,Herenthoutsesteenweg 2,2023-04-14,17:00:00,79,66,13,ECO_300019380
642,Herenthoutsesteenweg 2,2023-04-14,18:00:00,142,130,12,ECO_300019380
642,Herenthoutsesteenweg 2,2023-04-14,19:00:00,74,63,11,ECO_300019380
642,Herenthoutsesteenweg 2,2023-04-14,20:00:00,58,49,9,ECO_300019380
642,Herenthoutsesteenweg 2,2023-04-14,21:00:00,50,48,2,ECO_300019380
642,Herenthoutsesteenweg 2,2023-04-14,22:00:00,37,37,0,ECO_300019380
642,Herenthoutsesteenweg 2,2023-04-14,23:00:00,26,26,0,ECO_300019380
642,Herenthoutsesteenweg 2,2023-04-15,00:00:00,19,18,1,ECO_300019380
642,Herenthoutsesteenweg 2,2023-04-15,01:00:00,12,9,3,ECO_300019380
642,Herenthoutsesteenweg 2,2023-04-15,02:00:00,11,10,1,ECO_300019380
642,Herenthoutsesteenweg 2,2023-04-15,03:00:00,3,1,2,ECO_300019380
642,Herenthoutsesteenweg 2,2023-04-15,04:00:00,4,4,0,ECO_300019380
642,Herenthoutsesteenweg 2,2023-04-15,05:00:00,4,0,4,ECO_300019380
642,Herenthoutsesteenweg 2,2023-04-15,06:00:00,0,0,0,ECO_300019380
642,Herenthoutsesteenweg 2,2023-04-15,07:00:00,8,7,1,ECO_300019380
642,Herenthoutsesteenweg 2,2023-04-15,08:00:00,11,11,0,ECO_300019380
642,Herenthoutsesteenweg 2,2023-04-15,09:00:00,12,11,1,ECO_300019380
642,Herenthoutsesteenweg 2,2023-04-15,10:00:00,31,29,2,ECO_300019380
642,Herenthoutsesteenweg 2,2023-04-15,11:00:00,68,64,4,ECO_300019380
642,Herenthoutsesteenweg 2,2023-04-15,12:00:00,107,94,13,ECO_300019380
642,Herenthoutsesteenweg 2,2023-04-15,13:00:00,114,107,7,ECO_300019380
642,Herenthoutsesteenweg 2,2023-04-15,14:00:00,99,95,4,ECO_300019380
642,Herenthoutsesteenweg 2,2023-04-15,15:00:00,185,164,21,ECO_300019380
642,Herenthoutsesteenweg 2,2023-04-15,16:00:00,137,128,9,ECO_300019380
642,Herenthoutsesteenweg 2,2023-04-15,17:00:00,114,93,21,ECO_300019380
642,Herenthoutsesteenweg 2,2023-04-15,18:00:00,94,67,27,ECO_300019380
642,Herenthoutsesteenweg 2,2023-04-15,19:00:00,90,77,13,ECO_300019380
642,Herenthoutsesteenweg 2,2023-04-15,20:00:00,62,44,18,ECO_300019380
642,Herenthoutsesteenweg 2,2023-04-15,21:00:00,53,49,4,ECO_300019380
642,Herenthoutsesteenweg 2,2023-04-15,22:00:00,57,36,21,ECO_300019380
642,Herenthoutsesteenweg 2,2023-04-15,23:00:00,19,17,2,ECO_300019380
642,Herenthoutsesteenweg 2,2023-04-16,00:00:00,20,12,8,ECO_300019380
642,Herenthoutsesteenweg 2,2023-04-16,01:00:00,15,6,9,ECO_300019380
642,Herenthoutsesteenweg 2,2023-04-16,02:00:00,3,3,0,ECO_300019380
642,Herenthoutsesteenweg 2,2023-04-16,03:00:00,7,6,1,ECO_300019380
642,Herenthoutsesteenweg 2,2023-04-16,04:00:00,7,6,1,ECO_300019380
642,Herenthoutsesteenweg 2,2023-04-16,05:00:00,17,16,1,ECO_300019380
642,Herenthoutsesteenweg 2,2023-04-16,06:00:00,2,2,0,ECO_300019380
642,Herenthoutsesteenweg 2,2023-04-16,07:00:00,2,1,1,ECO_300019380
642,Herenthoutsesteenweg 2,2023-04-16,08:00:00,8,7,1,ECO_300019380
642,Herenthoutsesteenweg 2,2023-04-16,09:00:00,17,15,2,ECO_300019380
642,Herenthoutsesteenweg 2,2023-04-16,10:00:00,25,24,1,ECO_300019380
642,Herenthoutsesteenweg 2,2023-04-16,11:00:00,60,58,2,ECO_300019380
642,Herenthoutsesteenweg 2,2023-04-16,12:00:00,57,45,12,ECO_300019380
642,Herenthoutsesteenweg 2,2023-04-16,13:00:00,55,42,13,ECO_300019380
642,Herenthoutsesteenweg 2,2023-04-16,14:00:00,40,29,11,ECO_300019380
642,Herenthoutsesteenweg 2,2023-04-16,15:00:00,38,34,4,ECO_300019380
642,Herenthoutsesteenweg 2,2023-04-16,16:00:00,40,35,5,ECO_300019380
642,Herenthoutsesteenweg 2,2023-04-16,17:00:00,46,42,4,ECO_300019380
642,Herenthoutsesteenweg 2,2023-04-16,18:00:00,35,30,5,ECO_300019380
642,Herenthoutsesteenweg 2,2023-04-16,19:00:00,31,26,5,ECO_300019380
642,Herenthoutsesteenweg 2,2023-04-16,20:00:00,11,7,4,ECO_300019380
642,Herenthoutsesteenweg 2,2023-04-16,21:00:00,14,12,2,ECO_300019380
642,Herenthoutsesteenweg 2,2023-04-16,22:00:00,10,8,2,ECO_300019380
642,Herenthoutsesteenweg 2,2023-04-16,23:00:00,11,7,4,ECO_300019380
642,Herenthoutsesteenweg 2,2023-04-17,00:00:00,3,3,0,ECO_300019380
642,Herenthoutsesteenweg 2,2023-04-17,01:00:00,2,2,0,ECO_300019380
642,Herenthoutsesteenweg 2,2023-04-17,02:00:00,2,0,2,ECO_300019380
642,Herenthoutsesteenweg 2,2023-04-17,03:00:00,2,1,1,ECO_300019380
642,Herenthoutsesteenweg 2,2023-04-17,04:00:00,0,0,0,ECO_300019380
642,Herenthoutsesteenweg 2,2023-04-17,05:00:00,0,0,0,ECO_300019380
642,Herenthoutsesteenweg 2,2023-04-17,06:00:00,7,5,2,ECO_300019380
642,Herenthoutsesteenweg 2,2023-04-17,07:00:00,16,15,1,ECO_300019380
642,Herenthoutsesteenweg 2,2023-04-17,08:00:00,38,33,5,ECO_300019380
642,Herenthoutsesteenweg 2,2023-04-17,09:00:00,174,169,5,ECO_300019380
642,Herenthoutsesteenweg 2,2023-04-17,10:00:00,560,557,3,ECO_300019380
642,Herenthoutsesteenweg 2,2023-04-17,11:00:00,78,76,2,ECO_300019380
642,Herenthoutsesteenweg 2,2023-04-17,12:00:00,60,55,5,ECO_300019380
642,Herenthoutsesteenweg 2,2023-04-17,13:00:00,51,46,5,ECO_300019380
642,Herenthoutsesteenweg 2,2023-04-17,14:00:00,75,68,7,ECO_300019380
642,Herenthoutsesteenweg 2,2023-04-17,15:00:00,95,88,7,ECO_300019380
642,Herenthoutsesteenweg 2,2023-04-17,16:00:00,111,100,11,ECO_300019380
642,Herenthoutsesteenweg 2,2023-04-17,17:00:00,117,103,14,ECO_300019380
642,Herenthoutsesteenweg 2,2023-04-17,18:00:00,136,124,12,ECO_300019380
642,Herenthoutsesteenweg 2,2023-04-17,19:00:00,85,77,8,ECO_300019380
642,Herenthoutsesteenweg 2,2023-04-17,20:00:00,71,60,11,ECO_300019380
642,Herenthoutsesteenweg 2,2023-04-17,21:00:00,42,39,3,ECO_300019380
642,Herenthoutsesteenweg 2,2023-04-17,22:00:00,26,22,4,ECO_300019380
642,Herenthoutsesteenweg 2,2023-04-17,23:00:00,14,13,1,ECO_300019380
642,Herenthoutsesteenweg 2,2023-04-18,00:00:00,24,23,1,ECO_300019380
642,Herenthoutsesteenweg 2,2023-04-18,01:00:00,4,3,1,ECO_300019380
642,Herenthoutsesteenweg 2,2023-04-18,02:00:00,0,0,0,ECO_300019380
642,Herenthoutsesteenweg 2,2023-04-18,03:00:00,0,0,0,ECO_300019380
642,Herenthoutsesteenweg 2,2023-04-18,04:00:00,1,0,1,ECO_300019380
642,Herenthoutsesteenweg 2,2023-04-18,05:00:00,0,0,0,ECO_300019380
642,Herenthoutsesteenweg 2,2023-04-18,06:00:00,3,3,0,ECO_300019380
642,Herenthoutsesteenweg 2,2023-04-18,07:00:00,18,14,4,ECO_300019380
642,Herenthoutsesteenweg 2,2023-04-18,08:00:00,56,50,6,ECO_300019380
642,Herenthoutsesteenweg 2,2023-04-18,09:00:00,187,181,6,ECO_300019380
642,Herenthoutsesteenweg 2,2023-04-18,10:00:00,607,604,3,ECO_300019380
642,Herenthoutsesteenweg 2,2023-04-18,11:00:00,98,96,2,ECO_300019380
642,Herenthoutsesteenweg 2,2023-04-18,12:00:00,72,69,3,ECO_300019380
642,Herenthoutsesteenweg 2,2023-04-18,13:00:00,62,59,3,ECO_300019380
642,Herenthoutsesteenweg 2,2023-04-18,14:00:00,67,63,4,ECO_300019380
642,Herenthoutsesteenweg 2,2023-04-18,15:00:00,122,119,3,ECO_300019380
642,Herenthoutsesteenweg 2,2023-04-18,16:00:00,104,96,8,ECO_300019380
642,Herenthoutsesteenweg 2,2023-04-18,17:00:00,111,92,19,ECO_300019380
642,Herenthoutsesteenweg 2,2023-04-18,18:00:00,166,136,30,ECO_300019380
642,Herenthoutsesteenweg 2,2023-04-18,19:00:00,84,72,12,ECO_300019380
642,Herenthoutsesteenweg 2,2023-04-18,20:00:00,80,71,9,ECO_300019380
642,Herenthoutsesteenweg 2,2023-04-18,21:00:00,43,33,10,ECO_300019380
642,Herenthoutsesteenweg 2,2023-04-18,22:00:00,31,23,8,ECO_300019380
642,Herenthoutsesteenweg 2,2023-04-18,23:00:00,13,10,3,ECO_300019380
642,Herenthoutsesteenweg 2,2023-04-19,00:00:00,28,27,1,ECO_300019380
642,Herenthoutsesteenweg 2,2023-04-19,01:00:00,3,3,0,ECO_300019380
642,Herenthoutsesteenweg 2,2023-04-19,02:00:00,4,3,1,ECO_300019380
642,Herenthoutsesteenweg 2,2023-04-19,03:00:00,1,1,0,ECO_300019380
642,Herenthoutsesteenweg 2,2023-04-19,04:00:00,1,1,0,ECO_300019380
642,Herenthoutsesteenweg 2,2023-04-19,05:00:00,0,0,0,ECO_300019380
642,Herenthoutsesteenweg 2,2023-04-19,06:00:00,5,3,2,ECO_300019380
642,Herenthoutsesteenweg 2,2023-04-19,07:00:00,25,23,2,ECO_300019380
642,Herenthoutsesteenweg 2,2023-04-19,08:00:00,55,47,8,ECO_300019380
642,Herenthoutsesteenweg 2,2023-04-19,09:00:00,166,165,1,ECO_300019380
642,Herenthoutsesteenweg 2,2023-04-19,10:00:00,515,511,4,ECO_300019380
642,Herenthoutsesteenweg 2,2023-04-19,11:00:00,91,87,4,ECO_300019380
642,Herenthoutsesteenweg 2,2023-04-19,12:00:00,75,69,6,ECO_300019380
642,Herenthoutsesteenweg 2,2023-04-19,13:00:00,85,79,6,ECO_300019380
642,Herenthoutsesteenweg 2,2023-04-19,14:00:00,129,120,9,ECO_300019380
642,Herenthoutsesteenweg 2,2023-04-19,15:00:00,137,133,4,ECO_300019380
642,Herenthoutsesteenweg 2,2023-04-19,16:00:00,136,126,10,ECO_300019380
642,Herenthoutsesteenweg 2,2023-04-19,17:00:00,101,95,6,ECO_300019380
642,Herenthoutsesteenweg 2,2023-04-19,18:00:00,134,120,14,ECO_300019380
642,Herenthoutsesteenweg 2,2023-04-19,19:00:00,105,93,12,ECO_300019380
642,Herenthoutsesteenweg 2,2023-04-19,20:00:00,85,77,8,ECO_300019380
642,Herenthoutsesteenweg 2,2023-04-19,21:00:00,36,31,5,ECO_300019380
642,Herenthoutsesteenweg 2,2023-04-19,22:00:00,44,33,11,ECO_300019380
642,Herenthoutsesteenweg 2,2023-04-19,23:00:00,21,14,7,ECO_300019380
642,Herenthoutsesteenweg 2,2023-04-20,00:00:00,19,19,0,ECO_300019380
642,Herenthoutsesteenweg 2,2023-04-20,01:00:00,9,6,3,ECO_300019380
642,Herenthoutsesteenweg 2,2023-04-20,02:00:00,1,1,0,ECO_300019380
642,Herenthoutsesteenweg 2,2023-04-20,03:00:00,1,1,0,ECO_300019380
642,Herenthoutsesteenweg 2,2023-04-20,04:00:00,0,0,0,ECO_300019380
642,Herenthoutsesteenweg 2,2023-04-20,05:00:00,0,0,0,ECO_300019380
642,Herenthoutsesteenweg 2,2023-04-20,06:00:00,6,3,3,ECO_300019380
642,Herenthoutsesteenweg 2,2023-04-20,07:00:00,17,16,1,ECO_300019380
642,Herenthoutsesteenweg 2,2023-04-20,08:00:00,41,38,3,ECO_300019380
642,Herenthoutsesteenweg 2,2023-04-20,09:00:00,139,134,5,ECO_300019380
642,Herenthoutsesteenweg 2,2023-04-20,10:00:00,463,460,3,ECO_300019380
642,Herenthoutsesteenweg 2,2023-04-20,11:00:00,63,63,0,ECO_300019380
642,Herenthoutsesteenweg 2,2023-04-20,12:00:00,37,37,0,ECO_300019380
642,Herenthoutsesteenweg 2,2023-04-20,13:00:00,39,38,1,ECO_300019380
642,Herenthoutsesteenweg 2,2023-04-20,14:00:00,54,47,7,ECO_300019380
642,Herenthoutsesteenweg 2,2023-04-20,15:00:00,48,46,2,ECO_300019380
642,Herenthoutsesteenweg 2,2023-04-20,16:00:00,53,44,9,ECO_300019380
642,Herenthoutsesteenweg 2,2023-04-20,17:00:00,69,63,6,ECO_300019380
642,Herenthoutsesteenweg 2,2023-04-20,18:00:00,87,82,5,ECO_300019380
642,Herenthoutsesteenweg 2,2023-04-20,19:00:00,65,56,9,ECO_300019380
642,Herenthoutsesteenweg 2,2023-04-20,20:00:00,50,45,5,ECO_300019380
642,Herenthoutsesteenweg 2,2023-04-20,21:00:00,49,44,5,ECO_300019380
642,Herenthoutsesteenweg 2,2023-04-20,22:00:00,11,10,1,ECO_300019380
642,Herenthoutsesteenweg 2,2023-04-20,23:00:00,16,13,3,ECO_300019380
642,Herenthoutsesteenweg 2,2023-04-21,00:00:00,16,15,1,ECO_300019380
642,Herenthoutsesteenweg 2,2023-04-21,01:00:00,4,2,2,ECO_300019380
642,Herenthoutsesteenweg 2,2023-04-21,02:00:00,3,2,1,ECO_300019380
642,Herenthoutsesteenweg 2,2023-04-21,03:00:00,1,1,0,ECO_300019380
642,Herenthoutsesteenweg 2,2023-04-21,04:00:00,0,0,0,ECO_300019380
642,Herenthoutsesteenweg 2,2023-04-21,05:00:00,1,1,0,ECO_300019380
642,Herenthoutsesteenweg 2,2023-04-21,06:00:00,2,2,0,ECO_300019380
642,Herenthoutsesteenweg 2,2023-04-21,07:00:00,15,13,2,ECO_300019380
642,Herenthoutsesteenweg 2,2023-04-21,08:00:00,33,29,4,ECO_300019380
642,Herenthoutsesteenweg 2,2023-04-21,09:00:00,130,129,1,ECO_300019380
642,Herenthoutsesteenweg 2,2023-04-21,10:00:00,502,496,6,ECO_300019380
642,Herenthoutsesteenweg 2,2023-04-21,11:00:00,125,123,2,ECO_300019380
642,Herenthoutsesteenweg 2,2023-04-21,12:00:00,141,134,7,ECO_300019380
642,Herenthoutsesteenweg 2,2023-04-21,13:00:00,89,84,5,ECO_300019380
642,Herenthoutsesteenweg 2,2023-04-21,14:00:00,79,75,4,ECO_300019380
642,Herenthoutsesteenweg 2,2023-04-21,15:00:00,107,94,13,ECO_300019380
642,Herenthoutsesteenweg 2,2023-04-21,16:00:00,149,129,20,ECO_300019380
642,Herenthoutsesteenweg 2,2023-04-21,17:00:00,140,122,18,ECO_300019380
642,Herenthoutsesteenweg 2,2023-04-21,18:00:00,133,120,13,ECO_300019380
642,Herenthoutsesteenweg 2,2023-04-21,19:00:00,93,82,11,ECO_300019380
642,Herenthoutsesteenweg 2,2023-04-21,20:00:00,70,58,12,ECO_300019380
642,Herenthoutsesteenweg 2,2023-04-21,21:00:00,33,31,2,ECO_300019380
642,Herenthoutsesteenweg 2,2023-04-21,22:00:00,33,32,1,ECO_300019380
642,Herenthoutsesteenweg 2,2023-04-21,23:00:00,16,15,1,ECO_300019380
642,Herenthoutsesteenweg 2,2023-04-22,00:00:00,17,17,0,ECO_300019380
642,Herenthoutsesteenweg 2,2023-04-22,01:00:00,14,11,3,ECO_300019380
642,Herenthoutsesteenweg 2,2023-04-22,02:00:00,6,5,1,ECO_300019380
642,Herenthoutsesteenweg 2,2023-04-22,03:00:00,3,2,1,ECO_300019380
642,Herenthoutsesteenweg 2,2023-04-22,04:00:00,2,1,1,ECO_300019380
642,Herenthoutsesteenweg 2,2023-04-22,05:00:00,1,0,1,ECO_300019380
642,Herenthoutsesteenweg 2,2023-04-22,06:00:00,3,3,0,ECO_300019380
642,Herenthoutsesteenweg 2,2023-04-22,07:00:00,4,2,2,ECO_300019380
642,Herenthoutsesteenweg 2,2023-04-22,08:00:00,11,11,0,ECO_300019380
642,Herenthoutsesteenweg 2,2023-04-22,09:00:00,8,5,3,ECO_300019380
642,Herenthoutsesteenweg 2,2023-04-22,10:00:00,37,33,4,ECO_300019380
642,Herenthoutsesteenweg 2,2023-04-22,11:00:00,89,74,15,ECO_300019380
642,Herenthoutsesteenweg 2,2023-04-22,12:00:00,75,70,5,ECO_300019380
642,Herenthoutsesteenweg 2,2023-04-22,13:00:00,72,64,8,ECO_300019380
642,Herenthoutsesteenweg 2,2023-04-22,14:00:00,58,50,8,ECO_300019380
642,Herenthoutsesteenweg 2,2023-04-22,15:00:00,33,30,3,ECO_300019380
642,Herenthoutsesteenweg 2,2023-04-22,16:00:00,28,25,3,ECO_300019380
642,Herenthoutsesteenweg 2,2023-04-22,17:00:00,41,40,1,ECO_300019380
642,Herenthoutsesteenweg 2,2023-04-22,18:00:00,24,23,1,ECO_300019380
642,Herenthoutsesteenweg 2,2023-04-22,19:00:00,23,23,0,ECO_300019380
642,Herenthoutsesteenweg 2,2023-04-22,20:00:00,27,25,2,ECO_300019380
642,Herenthoutsesteenweg 2,2023-04-22,21:00:00,19,17,2,ECO_300019380
642,Herenthoutsesteenweg 2,2023-04-22,22:00:00,25,21,4,ECO_300019380
642,Herenthoutsesteenweg 2,2023-04-22,23:00:00,16,15,1,ECO_300019380
642,Herenthoutsesteenweg 2,2023-04-23,00:00:00,12,11,1,ECO_300019380
642,Herenthoutsesteenweg 2,2023-04-23,01:00:00,13,9,4,ECO_300019380
642,Herenthoutsesteenweg 2,2023-04-23,02:00:00,15,13,2,ECO_300019380
642,Herenthoutsesteenweg 2,2023-04-23,03:00:00,8,7,1,ECO_300019380
642,Herenthoutsesteenweg 2,2023-04-23,04:00:00,1,0,1,ECO_300019380
642,Herenthoutsesteenweg 2,2023-04-23,05:00:00,4,4,0,ECO_300019380
642,Herenthoutsesteenweg 2,2023-04-23,06:00:00,5,3,2,ECO_300019380
642,Herenthoutsesteenweg 2,2023-04-23,07:00:00,0,0,0,ECO_300019380
642,Herenthoutsesteenweg 2,2023-04-23,08:00:00,10,10,0,ECO_300019380
642,Herenthoutsesteenweg 2,2023-04-23,09:00:00,15,13,2,ECO_300019380
642,Herenthoutsesteenweg 2,2023-04-23,10:00:00,53,43,10,ECO_300019380
642,Herenthoutsesteenweg 2,2023-04-23,11:00:00,104,89,15,ECO_300019380
642,Herenthoutsesteenweg 2,2023-04-23,12:00:00,133,119,14,ECO_300019380
642,Herenthoutsesteenweg 2,2023-04-23,13:00:00,111,82,29,ECO_300019380
642,Herenthoutsesteenweg 2,2023-04-23,14:00:00,61,51,10,ECO_300019380
642,Herenthoutsesteenweg 2,2023-04-23,15:00:00,54,50,4,ECO_300019380
642,Herenthoutsesteenweg 2,2023-04-23,16:00:00,31,29,2,ECO_300019380
642,Herenthoutsesteenweg 2,2023-04-23,17:00:00,17,17,0,ECO_300019380
642,Herenthoutsesteenweg 2,2023-04-23,18:00:00,9,9,0,ECO_300019380
642,Herenthoutsesteenweg 2,2023-04-23,19:00:00,14,12,2,ECO_300019380
642,Herenthoutsesteenweg 2,2023-04-23,20:00:00,19,18,1,ECO_300019380
642,Herenthoutsesteenweg 2,2023-04-23,21:00:00,10,9,1,ECO_300019380
642,Herenthoutsesteenweg 2,2023-04-23,22:00:00,14,10,4,ECO_300019380
642,Herenthoutsesteenweg 2,2023-04-23,23:00:00,6,5,1,ECO_300019380
642,Herenthoutsesteenweg 2,2023-04-24,00:00:00,5,3,2,ECO_300019380
642,Herenthoutsesteenweg 2,2023-04-24,01:00:00,0,0,0,ECO_300019380
642,Herenthoutsesteenweg 2,2023-04-24,02:00:00,1,1,0,ECO_300019380
642,Herenthoutsesteenweg 2,2023-04-24,03:00:00,3,1,2,ECO_300019380
642,Herenthoutsesteenweg 2,2023-04-24,04:00:00,0,0,0,ECO_300019380
642,Herenthoutsesteenweg 2,2023-04-24,05:00:00,0,0,0,ECO_300019380
642,Herenthoutsesteenweg 2,2023-04-24,06:00:00,3,3,0,ECO_300019380
642,Herenthoutsesteenweg 2,2023-04-24,07:00:00,22,18,4,ECO_300019380
642,Herenthoutsesteenweg 2,2023-04-24,08:00:00,26,24,2,ECO_300019380
642,Herenthoutsesteenweg 2,2023-04-24,09:00:00,51,50,1,ECO_300019380
642,Herenthoutsesteenweg 2,2023-04-24,10:00:00,300,297,3,ECO_300019380
642,Herenthoutsesteenweg 2,2023-04-24,11:00:00,31,29,2,ECO_300019380
642,Herenthoutsesteenweg 2,2023-04-24,12:00:00,31,31,0,ECO_300019380
642,Herenthoutsesteenweg 2,2023-04-24,13:00:00,23,21,2,ECO_300019380
642,Herenthoutsesteenweg 2,2023-04-24,14:00:00,38,37,1,ECO_300019380
642,Herenthoutsesteenweg 2,2023-04-24,15:00:00,53,49,4,ECO_300019380
642,Herenthoutsesteenweg 2,2023-04-24,16:00:00,49,44,5,ECO_300019380
642,Herenthoutsesteenweg 2,2023-04-24,17:00:00,53,47,6,ECO_300019380
642,Herenthoutsesteenweg 2,2023-04-24,18:00:00,87,76,11,ECO_300019380
642,Herenthoutsesteenweg 2,2023-04-24,19:00:00,60,58,2,ECO_300019380
642,Herenthoutsesteenweg 2,2023-04-24,20:00:00,35,31,4,ECO_300019380
642,Herenthoutsesteenweg 2,2023-04-24,21:00:00,36,24,12,ECO_300019380
642,Herenthoutsesteenweg 2,2023-04-24,22:00:00,20,18,2,ECO_300019380
642,Herenthoutsesteenweg 2,2023-04-24,23:00:00,20,17,3,ECO_300019380
642,Herenthoutsesteenweg 2,2023-04-25,00:00:00,16,14,2,ECO_300019380
642,Herenthoutsesteenweg 2,2023-04-25,01:00:00,5,4,1,ECO_300019380
642,Herenthoutsesteenweg 2,2023-04-25,02:00:00,0,0,0,ECO_300019380
642,Herenthoutsesteenweg 2,2023-04-25,03:00:00,0,0,0,ECO_300019380
642,Herenthoutsesteenweg 2,2023-04-25,04:00:00,0,0,0,ECO_300019380
642,Herenthoutsesteenweg 2,2023-04-25,05:00:00,0,0,0,ECO_300019380
642,Herenthoutsesteenweg 2,2023-04-25,06:00:00,1,1,0,ECO_300019380
642,Herenthoutsesteenweg 2,2023-04-25,07:00:00,16,14,2,ECO_300019380
642,Herenthoutsesteenweg 2,2023-04-25,08:00:00,50,45,5,ECO_300019380
642,Herenthoutsesteenweg 2,2023-04-25,09:00:00,176,171,5,ECO_300019380
642,Herenthoutsesteenweg 2,2023-04-25,10:00:00,456,454,2,ECO_300019380
642,Herenthoutsesteenweg 2,2023-04-25,11:00:00,78,72,6,ECO_300019380
642,Herenthoutsesteenweg 2,2023-04-25,12:00:00,59,54,5,ECO_300019380
642,Herenthoutsesteenweg 2,2023-04-25,13:00:00,38,37,1,ECO_300019380
642,Herenthoutsesteenweg 2,2023-04-25,14:00:00,61,55,6,ECO_300019380
642,Herenthoutsesteenweg 2,2023-04-25,15:00:00,112,101,11,ECO_300019380
642,Herenthoutsesteenweg 2,2023-04-25,16:00:00,82,78,4,ECO_300019380
642,Herenthoutsesteenweg 2,2023-04-25,17:00:00,105,90,15,ECO_300019380
642,Herenthoutsesteenweg 2,2023-04-25,18:00:00,121,112,9,ECO_300019380
642,Herenthoutsesteenweg 2,2023-04-25,19:00:00,90,82,8,ECO_300019380
642,Herenthoutsesteenweg 2,2023-04-25,20:00:00,73,62,11,ECO_300019380
642,Herenthoutsesteenweg 2,2023-04-25,21:00:00,43,35,8,ECO_300019380
642,Herenthoutsesteenweg 2,2023-04-25,22:00:00,23,19,4,ECO_300019380
642,Herenthoutsesteenweg 2,2023-04-25,23:00:00,9,9,0,ECO_300019380
642,Herenthoutsesteenweg 2,2023-04-26,00:00:00,17,17,0,ECO_300019380
642,Herenthoutsesteenweg 2,2023-04-26,01:00:00,1,1,0,ECO_300019380
642,Herenthoutsesteenweg 2,2023-04-26,02:00:00,2,2,0,ECO_300019380
642,Herenthoutsesteenweg 2,2023-04-26,03:00:00,0,0,0,ECO_300019380
642,Herenthoutsesteenweg 2,2023-04-26,04:00:00,0,0,0,ECO_300019380
642,Herenthoutsesteenweg 2,2023-04-26,05:00:00,0,0,0,ECO_300019380
642,Herenthoutsesteenweg 2,2023-04-26,06:00:00,2,2,0,ECO_300019380
642,Herenthoutsesteenweg 2,2023-04-26,07:00:00,21,17,4,ECO_300019380
642,Herenthoutsesteenweg 2,2023-04-26,08:00:00,47,43,4,ECO_300019380
642,Herenthoutsesteenweg 2,2023-04-26,09:00:00,126,123,3,ECO_300019380
642,Herenthoutsesteenweg 2,2023-04-26,10:00:00,518,515,3,ECO_300019380
642,Herenthoutsesteenweg 2,2023-04-26,11:00:00,72,71,1,ECO_300019380
642,Herenthoutsesteenweg 2,2023-04-26,12:00:00,67,61,6,ECO_300019380
642,Herenthoutsesteenweg 2,2023-04-26,13:00:00,69,68,1,ECO_300019380
642,Herenthoutsesteenweg 2,2023-04-26,14:00:00,115,108,7,ECO_300019380
642,Herenthoutsesteenweg 2,2023-04-26,15:00:00,98,93,5,ECO_300019380
642,Herenthoutsesteenweg 2,2023-04-26,16:00:00,119,106,13,ECO_300019380
642,Herenthoutsesteenweg 2,2023-04-26,17:00:00,106,81,25,ECO_300019380
642,Herenthoutsesteenweg 2,2023-04-26,18:00:00,122,108,14,ECO_300019380
642,Herenthoutsesteenweg 2,2023-04-26,19:00:00,110,97,13,ECO_300019380
642,Herenthoutsesteenweg 2,2023-04-26,20:00:00,60,49,11,ECO_300019380
642,Herenthoutsesteenweg 2,2023-04-26,21:00:00,60,53,7,ECO_300019380
642,Herenthoutsesteenweg 2,2023-04-26,22:00:00,30,25,5,ECO_300019380
642,Herenthoutsesteenweg 2,2023-04-26,23:00:00,33,26,7,ECO_300019380
642,Herenthoutsesteenweg 2,2023-04-27,00:00:00,19,17,2,ECO_300019380
642,Herenthoutsesteenweg 2,2023-04-27,01:00:00,2,1,1,ECO_300019380
642,Herenthoutsesteenweg 2,2023-04-27,02:00:00,1,1,0,ECO_300019380
642,Herenthoutsesteenweg 2,2023-04-27,03:00:00,0,0,0,ECO_300019380
642,Herenthoutsesteenweg 2,2023-04-27,04:00:00,0,0,0,ECO_300019380
642,Herenthoutsesteenweg 2,2023-04-27,05:00:00,0,0,0,ECO_300019380
642,Herenthoutsesteenweg 2,2023-04-27,06:00:00,1,1,0,ECO_300019380
642,Herenthoutsesteenweg 2,2023-04-27,07:00:00,26,22,4,ECO_300019380
642,Herenthoutsesteenweg 2,2023-04-27,08:00:00,63,56,7,ECO_300019380
642,Herenthoutsesteenweg 2,2023-04-27,09:00:00,153,141,12,ECO_300019380
642,Herenthoutsesteenweg 2,2023-04-27,10:00:00,593,586,7,ECO_300019380
642,Herenthoutsesteenweg 2,2023-04-27,11:00:00,125,121,4,ECO_300019380
642,Herenthoutsesteenweg 2,2023-04-27,12:00:00,70,65,5,ECO_300019380
642,Herenthoutsesteenweg 2,2023-04-27,13:00:00,67,63,4,ECO_300019380
642,Herenthoutsesteenweg 2,2023-04-27,14:00:00,77,74,3,ECO_300019380
642,Herenthoutsesteenweg 2,2023-04-27,15:00:00,111,108,3,ECO_300019380
642,Herenthoutsesteenweg 2,2023-04-27,16:00:00,116,107,9,ECO_300019380
642,Herenthoutsesteenweg 2,2023-04-27,17:00:00,141,126,15,ECO_300019380
642,Herenthoutsesteenweg 2,2023-04-27,18:00:00,148,123,25,ECO_300019380
642,Herenthoutsesteenweg 2,2023-04-27,19:00:00,94,84,10,ECO_300019380
642,Herenthoutsesteenweg 2,2023-04-27,20:00:00,74,64,10,ECO_300019380
642,Herenthoutsesteenweg 2,2023-04-27,21:00:00,46,38,8,ECO_300019380
642,Herenthoutsesteenweg 2,2023-04-27,22:00:00,26,18,8,ECO_300019380
642,Herenthoutsesteenweg 2,2023-04-27,23:00:00,19,14,5,ECO_300019380
642,Herenthoutsesteenweg 2,2023-04-28,00:00:00,14,13,1,ECO_300019380
642,Herenthoutsesteenweg 2,2023-04-28,01:00:00,5,5,0,ECO_300019380
642,Herenthoutsesteenweg 2,2023-04-28,02:00:00,1,1,0,ECO_300019380
642,Herenthoutsesteenweg 2,2023-04-28,03:00:00,2,2,0,ECO_300019380
642,Herenthoutsesteenweg 2,2023-04-28,04:00:00,0,0,0,ECO_300019380
642,Herenthoutsesteenweg 2,2023-04-28,05:00:00,0,0,0,ECO_300019380
642,Herenthoutsesteenweg 2,2023-04-28,06:00:00,1,1,0,ECO_300019380
642,Herenthoutsesteenweg 2,2023-04-28,07:00:00,21,18,3,ECO_300019380
642,Herenthoutsesteenweg 2,2023-04-28,08:00:00,34,30,4,ECO_300019380
642,Herenthoutsesteenweg 2,2023-04-28,09:00:00,160,158,2,ECO_300019380
642,Herenthoutsesteenweg 2,2023-04-28,10:00:00,422,414,8,ECO_300019380
642,Herenthoutsesteenweg 2,2023-04-28,11:00:00,72,67,5,ECO_300019380
642,Herenthoutsesteenweg 2,2023-04-28,12:00:00,72,71,1,ECO_300019380
642,Herenthoutsesteenweg 2,2023-04-28,13:00:00,73,70,3,ECO_300019380
642,Herenthoutsesteenweg 2,2023-04-28,14:00:00,58,54,4,ECO_300019380
642,Herenthoutsesteenweg 2,2023-04-28,15:00:00,69,65,4,ECO_300019380
642,Herenthoutsesteenweg 2,2023-04-28,16:00:00,94,87,7,ECO_300019380
642,Herenthoutsesteenweg 2,2023-04-28,17:00:00,93,84,9,ECO_300019380
642,Herenthoutsesteenweg 2,2023-04-28,18:00:00,94,88,6,ECO_300019380
642,Herenthoutsesteenweg 2,2023-04-28,19:00:00,67,63,4,ECO_300019380
642,Herenthoutsesteenweg 2,2023-04-28,20:00:00,56,49,7,ECO_300019380
642,Herenthoutsesteenweg 2,2023-04-28,21:00:00,68,68,0,ECO_300019380
642,Herenthoutsesteenweg 2,2023-04-28,22:00:00,34,28,6,ECO_300019380
642,Herenthoutsesteenweg 2,2023-04-28,23:00:00,35,29,6,ECO_300019380
642,Herenthoutsesteenweg 2,2023-04-29,00:00:00,27,25,2,ECO_300019380
642,Herenthoutsesteenweg 2,2023-04-29,01:00:00,16,15,1,ECO_300019380
642,Herenthoutsesteenweg 2,2023-04-29,02:00:00,8,5,3,ECO_300019380
642,Herenthoutsesteenweg 2,2023-04-29,03:00:00,8,6,2,ECO_300019380
642,Herenthoutsesteenweg 2,2023-04-29,04:00:00,7,2,5,ECO_300019380
642,Herenthoutsesteenweg 2,2023-04-29,05:00:00,3,2,1,ECO_300019380
642,Herenthoutsesteenweg 2,2023-04-29,06:00:00,4,3,1,ECO_300019380
642,Herenthoutsesteenweg 2,2023-04-29,07:00:00,4,2,2,ECO_300019380
642,Herenthoutsesteenweg 2,2023-04-29,08:00:00,8,7,1,ECO_300019380
642,Herenthoutsesteenweg 2,2023-04-29,09:00:00,15,15,0,ECO_300019380
642,Herenthoutsesteenweg 2,2023-04-29,10:00:00,34,33,1,ECO_300019380
642,Herenthoutsesteenweg 2,2023-04-29,11:00:00,56,54,2,ECO_300019380
642,Herenthoutsesteenweg 2,2023-04-29,12:00:00,78,69,9,ECO_300019380
642,Herenthoutsesteenweg 2,2023-04-29,13:00:00,98,85,13,ECO_300019380
642,Herenthoutsesteenweg 2,2023-04-29,14:00:00,116,105,11,ECO_300019380
642,Herenthoutsesteenweg 2,2023-04-29,15:00:00,141,131,10,ECO_300019380
642,Herenthoutsesteenweg 2,2023-04-29,16:00:00,90,83,7,ECO_300019380
642,Herenthoutsesteenweg 2,2023-04-29,17:00:00,89,72,17,ECO_300019380
642,Herenthoutsesteenweg 2,2023-04-29,18:00:00,98,75,23,ECO_300019380
642,Herenthoutsesteenweg 2,2023-04-29,19:00:00,70,67,3,ECO_300019380
642,Herenthoutsesteenweg 2,2023-04-29,20:00:00,56,54,2,ECO_300019380
642,Herenthoutsesteenweg 2,2023-04-29,21:00:00,48,47,1,ECO_300019380
642,Herenthoutsesteenweg 2,2023-04-29,22:00:00,26,22,4,ECO_300019380
642,Herenthoutsesteenweg 2,2023-04-29,23:00:00,23,20,3,ECO_300019380
642,Herenthoutsesteenweg 2,2023-04-30,00:00:00,21,16,5,ECO_300019380
642,Herenthoutsesteenweg 2,2023-04-30,01:00:00,14,14,0,ECO_300019380
642,Herenthoutsesteenweg 2,2023-04-30,02:00:00,1,0,1,ECO_300019380
642,Herenthoutsesteenweg 2,2023-04-30,03:00:00,1,0,1,ECO_300019380
642,Herenthoutsesteenweg 2,2023-04-30,04:00:00,2,2,0,ECO_300019380
642,Herenthoutsesteenweg 2,2023-04-30,05:00:00,1,1,0,ECO_300019380
642,Herenthoutsesteenweg 2,2023-04-30,06:00:00,1,1,0,ECO_300019380
642,Herenthoutsesteenweg 2,2023-04-30,07:00:00,5,3,2,ECO_300019380
642,Herenthoutsesteenweg 2,2023-04-30,08:00:00,10,9,1,ECO_300019380
642,Herenthoutsesteenweg 2,2023-04-30,09:00:00,16,15,1,ECO_300019380
642,Herenthoutsesteenweg 2,2023-04-30,10:00:00,61,55,6,ECO_300019380
642,Herenthoutsesteenweg 2,2023-04-30,11:00:00,114,108,6,ECO_300019380
642,Herenthoutsesteenweg 2,2023-04-30,12:00:00,170,154,16,ECO_300019380
642,Herenthoutsesteenweg 2,2023-04-30,13:00:00,120,96,24,ECO_300019380
642,Herenthoutsesteenweg 2,2023-04-30,14:00:00,98,86,12,ECO_300019380
642,Herenthoutsesteenweg 2,2023-04-30,15:00:00,177,158,19,ECO_300019380
642,Herenthoutsesteenweg 2,2023-04-30,16:00:00,223,203,20,ECO_300019380
642,Herenthoutsesteenweg 2,2023-04-30,17:00:00,127,113,14,ECO_300019380
642,Herenthoutsesteenweg 2,2023-04-30,18:00:00,111,102,9,ECO_300019380
642,Herenthoutsesteenweg 2,2023-04-30,19:00:00,88,70,18,ECO_300019380
642,Herenthoutsesteenweg 2,2023-04-30,20:00:00,62,50,12,ECO_300019380
642,Herenthoutsesteenweg 2,2023-04-30,21:00:00,31,27,4,ECO_300019380
642,Herenthoutsesteenweg 2,2023-04-30,22:00:00,24,16,8,ECO_300019380
642,Herenthoutsesteenweg 2,2023-04-30,23:00:00,19,18,1,ECO_300019380
642,Herenthoutsesteenweg 2,2023-05-01,00:00:00,9,7,2,ECO_300019380
642,Herenthoutsesteenweg 2,2023-05-01,01:00:00,9,9,0,ECO_300019380
642,Herenthoutsesteenweg 2,2023-05-01,02:00:00,11,5,6,ECO_300019380
642,Herenthoutsesteenweg 2,2023-05-01,03:00:00,2,1,1,ECO_300019380
642,Herenthoutsesteenweg 2,2023-05-01,04:00:00,2,2,0,ECO_300019380
642,Herenthoutsesteenweg 2,2023-05-01,05:00:00,7,7,0,ECO_300019380
642,Herenthoutsesteenweg 2,2023-05-01,06:00:00,8,8,0,ECO_300019380
642,Herenthoutsesteenweg 2,2023-05-01,07:00:00,5,4,1,ECO_300019380
642,Herenthoutsesteenweg 2,2023-05-01,08:00:00,5,5,0,ECO_300019380
642,Herenthoutsesteenweg 2,2023-05-01,09:00:00,14,13,1,ECO_300019380
642,Herenthoutsesteenweg 2,2023-05-01,10:00:00,35,34,1,ECO_300019380
642,Herenthoutsesteenweg 2,2023-05-01,11:00:00,77,63,14,ECO_300019380
642,Herenthoutsesteenweg 2,2023-05-01,12:00:00,127,124,3,ECO_300019380
642,Herenthoutsesteenweg 2,2023-05-01,13:00:00,116,107,9,ECO_300019380
642,Herenthoutsesteenweg 2,2023-05-01,14:00:00,97,84,13,ECO_300019380
642,Herenthoutsesteenweg 2,2023-05-01,15:00:00,108,100,8,ECO_300019380
642,Herenthoutsesteenweg 2,2023-05-01,16:00:00,119,113,6,ECO_300019380
642,Herenthoutsesteenweg 2,2023-05-01,17:00:00,101,91,10,ECO_300019380
642,Herenthoutsesteenweg 2,2023-05-01,18:00:00,61,53,8,ECO_300019380
642,Herenthoutsesteenweg 2,2023-05-01,19:00:00,59,53,6,ECO_300019380
642,Herenthoutsesteenweg 2,2023-05-01,20:00:00,28,25,3,ECO_300019380
642,Herenthoutsesteenweg 2,2023-05-01,21:00:00,31,25,6,ECO_300019380
642,Herenthoutsesteenweg 2,2023-05-01,22:00:00,22,13,9,ECO_300019380
642,Herenthoutsesteenweg 2,2023-05-01,23:00:00,17,15,2,ECO_300019380
642,Herenthoutsesteenweg 2,2023-05-02,00:00:00,2,2,0,ECO_300019380
642,Herenthoutsesteenweg 2,2023-05-02,01:00:00,2,0,2,ECO_300019380
642,Herenthoutsesteenweg 2,2023-05-02,02:00:00,1,1,0,ECO_300019380
642,Herenthoutsesteenweg 2,2023-05-02,03:00:00,1,1,0,ECO_300019380
642,Herenthoutsesteenweg 2,2023-05-02,04:00:00,0,0,0,ECO_300019380
642,Herenthoutsesteenweg 2,2023-05-02,05:00:00,0,0,0,ECO_300019380
642,Herenthoutsesteenweg 2,2023-05-02,06:00:00,1,1,0,ECO_300019380
642,Herenthoutsesteenweg 2,2023-05-02,07:00:00,24,20,4,ECO_300019380
642,Herenthoutsesteenweg 2,2023-05-02,08:00:00,64,58,6,ECO_300019380
642,Herenthoutsesteenweg 2,2023-05-02,09:00:00,194,188,6,ECO_300019380
642,Herenthoutsesteenweg 2,2023-05-02,10:00:00,511,506,5,ECO_300019380
642,Herenthoutsesteenweg 2,2023-05-02,11:00:00,102,99,3,ECO_300019380
642,Herenthoutsesteenweg 2,2023-05-02,12:00:00,67,65,2,ECO_300019380
642,Herenthoutsesteenweg 2,2023-05-02,13:00:00,55,50,5,ECO_300019380
642,Herenthoutsesteenweg 2,2023-05-02,14:00:00,70,64,6,ECO_300019380
642,Herenthoutsesteenweg 2,2023-05-02,15:00:00,138,127,11,ECO_300019380
642,Herenthoutsesteenweg 2,2023-05-02,16:00:00,90,82,8,ECO_300019380
642,Herenthoutsesteenweg 2,2023-05-02,17:00:00,108,89,19,ECO_300019380
642,Herenthoutsesteenweg 2,2023-05-02,18:00:00,157,139,18,ECO_300019380
642,Herenthoutsesteenweg 2,2023-05-02,19:00:00,102,90,12,ECO_300019380
642,Herenthoutsesteenweg 2,2023-05-02,20:00:00,92,85,7,ECO_300019380
642,Herenthoutsesteenweg 2,2023-05-02,21:00:00,65,54,11,ECO_300019380
642,Herenthoutsesteenweg 2,2023-05-02,22:00:00,27,22,5,ECO_300019380
642,Herenthoutsesteenweg 2,2023-05-02,23:00:00,26,24,2,ECO_300019380
642,Herenthoutsesteenweg 2,2023-05-03,00:00:00,24,21,3,ECO_300019380
642,Herenthoutsesteenweg 2,2023-05-03,01:00:00,5,4,1,ECO_300019380
642,Herenthoutsesteenweg 2,2023-05-03,02:00:00,1,1,0,ECO_300019380
642,Herenthoutsesteenweg 2,2023-05-03,03:00:00,0,0,0,ECO_300019380
642,Herenthoutsesteenweg 2,2023-05-03,04:00:00,0,0,0,ECO_300019380
642,Herenthoutsesteenweg 2,2023-05-03,05:00:00,0,0,0,ECO_300019380
642,Herenthoutsesteenweg 2,2023-05-03,06:00:00,2,2,0,ECO_300019380
642,Herenthoutsesteenweg 2,2023-05-03,07:00:00,30,25,5,ECO_300019380
642,Herenthoutsesteenweg 2,2023-05-03,08:00:00,57,52,5,ECO_300019380
642,Herenthoutsesteenweg 2,2023-05-03,09:00:00,155,152,3,ECO_300019380
642,Herenthoutsesteenweg 2,2023-05-03,10:00:00,585,583,2,ECO_300019380
642,Herenthoutsesteenweg 2,2023-05-03,11:00:00,94,92,2,ECO_300019380
642,Herenthoutsesteenweg 2,2023-05-03,12:00:00,76,75,1,ECO_300019380
642,Herenthoutsesteenweg 2,2023-05-03,13:00:00,77,73,4,ECO_300019380
642,Herenthoutsesteenweg 2,2023-05-03,14:00:00,129,115,14,ECO_300019380
642,Herenthoutsesteenweg 2,2023-05-03,15:00:00,147,140,7,ECO_300019380
642,Herenthoutsesteenweg 2,2023-05-03,16:00:00,191,157,34,ECO_300019380
642,Herenthoutsesteenweg 2,2023-05-03,17:00:00,154,143,11,ECO_300019380
642,Herenthoutsesteenweg 2,2023-05-03,18:00:00,155,136,19,ECO_300019380
642,Herenthoutsesteenweg 2,2023-05-03,19:00:00,148,126,22,ECO_300019380
642,Herenthoutsesteenweg 2,2023-05-03,20:00:00,98,85,13,ECO_300019380
642,Herenthoutsesteenweg 2,2023-05-03,21:00:00,99,86,13,ECO_300019380
642,Herenthoutsesteenweg 2,2023-05-03,22:00:00,38,23,15,ECO_300019380
642,Herenthoutsesteenweg 2,2023-05-03,23:00:00,19,15,4,ECO_300019380
642,Herenthoutsesteenweg 2,2023-05-04,00:00:00,23,22,1,ECO_300019380
642,Herenthoutsesteenweg 2,2023-05-04,01:00:00,3,2,1,ECO_300019380
642,Herenthoutsesteenweg 2,2023-05-04,02:00:00,1,1,0,ECO_300019380
642,Herenthoutsesteenweg 2,2023-05-04,03:00:00,4,4,0,ECO_300019380
642,Herenthoutsesteenweg 2,2023-05-04,04:00:00,0,0,0,ECO_300019380
642,Herenthoutsesteenweg 2,2023-05-04,05:00:00,1,1,0,ECO_300019380
642,Herenthoutsesteenweg 2,2023-05-04,06:00:00,0,0,0,ECO_300019380
642,Herenthoutsesteenweg 2,2023-05-04,07:00:00,27,24,3,ECO_300019380
642,Herenthoutsesteenweg 2,2023-05-04,08:00:00,62,56,6,ECO_300019380
642,Herenthoutsesteenweg 2,2023-05-04,09:00:00,160,153,7,ECO_300019380
642,Herenthoutsesteenweg 2,2023-05-04,10:00:00,596,589,7,ECO_300019380
642,Herenthoutsesteenweg 2,2023-05-04,11:00:00,125,123,2,ECO_300019380
642,Herenthoutsesteenweg 2,2023-05-04,12:00:00,79,76,3,ECO_300019380
642,Herenthoutsesteenweg 2,2023-05-04,13:00:00,102,92,10,ECO_300019380
642,Herenthoutsesteenweg 2,2023-05-04,14:00:00,98,93,5,ECO_300019380
642,Herenthoutsesteenweg 2,2023-05-04,15:00:00,204,188,16,ECO_300019380
642,Herenthoutsesteenweg 2,2023-05-04,16:00:00,137,118,19,ECO_300019380
642,Herenthoutsesteenweg 2,2023-05-04,17:00:00,174,144,30,ECO_300019380
642,Herenthoutsesteenweg 2,2023-05-04,18:00:00,230,211,19,ECO_300019380
642,Herenthoutsesteenweg 2,2023-05-04,19:00:00,138,121,17,ECO_300019380
642,Herenthoutsesteenweg 2,2023-05-04,20:00:00,84,76,8,ECO_300019380
642,Herenthoutsesteenweg 2,2023-05-04,21:00:00,82,64,18,ECO_300019380
642,Herenthoutsesteenweg 2,2023-05-04,22:00:00,37,28,9,ECO_300019380
642,Herenthoutsesteenweg 2,2023-05-04,23:00:00,24,20,4,ECO_300019380
642,Herenthoutsesteenweg 2,2023-05-05,00:00:00,23,23,0,ECO_300019380
642,Herenthoutsesteenweg 2,2023-05-05,01:00:00,7,6,1,ECO_300019380
642,Herenthoutsesteenweg 2,2023-05-05,02:00:00,3,1,2,ECO_300019380
642,Herenthoutsesteenweg 2,2023-05-05,03:00:00,2,1,1,ECO_300019380
642,Herenthoutsesteenweg 2,2023-05-05,04:00:00,1,1,0,ECO_300019380
642,Herenthoutsesteenweg 2,2023-05-05,05:00:00,0,0,0,ECO_300019380
642,Herenthoutsesteenweg 2,2023-05-05,06:00:00,1,1,0,ECO_300019380
642,Herenthoutsesteenweg 2,2023-05-05,07:00:00,30,29,1,ECO_300019380
642,Herenthoutsesteenweg 2,2023-05-05,08:00:00,35,32,3,ECO_300019380
642,Herenthoutsesteenweg 2,2023-05-05,09:00:00,158,146,12,ECO_300019380
642,Herenthoutsesteenweg 2,2023-05-05,10:00:00,521,503,18,ECO_300019380
642,Herenthoutsesteenweg 2,2023-05-05,11:00:00,108,105,3,ECO_300019380
642,Herenthoutsesteenweg 2,2023-05-05,12:00:00,105,100,5,ECO_300019380
642,Herenthoutsesteenweg 2,2023-05-05,13:00:00,43,39,4,ECO_300019380
642,Herenthoutsesteenweg 2,2023-05-05,14:00:00,45,41,4,ECO_300019380
642,Herenthoutsesteenweg 2,2023-05-05,15:00:00,44,39,5,ECO_300019380
642,Herenthoutsesteenweg 2,2023-05-05,16:00:00,65,54,11,ECO_300019380
642,Herenthoutsesteenweg 2,2023-05-05,17:00:00,110,101,9,ECO_300019380
642,Herenthoutsesteenweg 2,2023-05-05,18:00:00,115,107,8,ECO_300019380
642,Herenthoutsesteenweg 2,2023-05-05,19:00:00,53,46,7,ECO_300019380
642,Herenthoutsesteenweg 2,2023-05-05,20:00:00,37,36,1,ECO_300019380
642,Herenthoutsesteenweg 2,2023-05-05,21:00:00,49,46,3,ECO_300019380
642,Herenthoutsesteenweg 2,2023-05-05,22:00:00,19,19,0,ECO_300019380
642,Herenthoutsesteenweg 2,2023-05-05,23:00:00,28,27,1,ECO_300019380
642,Herenthoutsesteenweg 2,2023-05-06,00:00:00,27,23,4,ECO_300019380
642,Herenthoutsesteenweg 2,2023-05-06,01:00:00,6,5,1,ECO_300019380
642,Herenthoutsesteenweg 2,2023-05-06,02:00:00,12,8,4,ECO_300019380
642,Herenthoutsesteenweg 2,2023-05-06,03:00:00,11,10,1,ECO_300019380
642,Herenthoutsesteenweg 2,2023-05-06,04:00:00,1,1,0,ECO_300019380
642,Herenthoutsesteenweg 2,2023-05-06,05:00:00,1,0,1,ECO_300019380
642,Herenthoutsesteenweg 2,2023-05-06,06:00:00,5,3,2,ECO_300019380
642,Herenthoutsesteenweg 2,2023-05-06,07:00:00,7,6,1,ECO_300019380
642,Herenthoutsesteenweg 2,2023-05-06,08:00:00,18,18,0,ECO_300019380
642,Herenthoutsesteenweg 2,2023-05-06,09:00:00,11,11,0,ECO_300019380
642,Herenthoutsesteenweg 2,2023-05-06,10:00:00,56,48,8,ECO_300019380
642,Herenthoutsesteenweg 2,2023-05-06,11:00:00,98,94,4,ECO_300019380
642,Herenthoutsesteenweg 2,2023-05-06,12:00:00,127,116,11,ECO_300019380
642,Herenthoutsesteenweg 2,2023-05-06,13:00:00,112,104,8,ECO_300019380
642,Herenthoutsesteenweg 2,2023-05-06,14:00:00,115,98,17,ECO_300019380
642,Herenthoutsesteenweg 2,2023-05-06,15:00:00,127,121,6,ECO_300019380
642,Herenthoutsesteenweg 2,2023-05-06,16:00:00,149,141,8,ECO_300019380
642,Herenthoutsesteenweg 2,2023-05-06,17:00:00,88,82,6,ECO_300019380
642,Herenthoutsesteenweg 2,2023-05-06,18:00:00,74,67,7,ECO_300019380
642,Herenthoutsesteenweg 2,2023-05-06,19:00:00,84,78,6,ECO_300019380
642,Herenthoutsesteenweg 2,2023-05-06,20:00:00,43,35,8,ECO_300019380
642,Herenthoutsesteenweg 2,2023-05-06,21:00:00,27,23,4,ECO_300019380
642,Herenthoutsesteenweg 2,2023-05-06,22:00:00,20,19,1,ECO_300019380
642,Herenthoutsesteenweg 2,2023-05-06,23:00:00,20,18,2,ECO_300019380
642,Herenthoutsesteenweg 2,2023-05-07,00:00:00,17,13,4,ECO_300019380
642,Herenthoutsesteenweg 2,2023-05-07,01:00:00,3,2,1,ECO_300019380
642,Herenthoutsesteenweg 2,2023-05-07,02:00:00,16,14,2,ECO_300019380
642,Herenthoutsesteenweg 2,2023-05-07,03:00:00,22,20,2,ECO_300019380
642,Herenthoutsesteenweg 2,2023-05-07,04:00:00,3,0,3,ECO_300019380
642,Herenthoutsesteenweg 2,2023-05-07,05:00:00,3,1,2,ECO_300019380
642,Herenthoutsesteenweg 2,2023-05-07,06:00:00,3,2,1,ECO_300019380
642,Herenthoutsesteenweg 2,2023-05-07,07:00:00,3,1,2,ECO_300019380
642,Herenthoutsesteenweg 2,2023-05-07,08:00:00,8,7,1,ECO_300019380
642,Herenthoutsesteenweg 2,2023-05-07,09:00:00,15,14,1,ECO_300019380
642,Herenthoutsesteenweg 2,2023-05-07,10:00:00,36,35,1,ECO_300019380
642,Herenthoutsesteenweg 2,2023-05-07,11:00:00,65,59,6,ECO_300019380
642,Herenthoutsesteenweg 2,2023-05-07,12:00:00,74,65,9,ECO_300019380
642,Herenthoutsesteenweg 2,2023-05-07,13:00:00,36,28,8,ECO_300019380
642,Herenthoutsesteenweg 2,2023-05-07,14:00:00,28,28,0,ECO_300019380
642,Herenthoutsesteenweg 2,2023-05-07,15:00:00,42,41,1,ECO_300019380
642,Herenthoutsesteenweg 2,2023-05-07,16:00:00,18,17,1,ECO_300019380
642,Herenthoutsesteenweg 2,2023-05-07,17:00:00,30,29,1,ECO_300019380
642,Herenthoutsesteenweg 2,2023-05-07,18:00:00,10,10,0,ECO_300019380
642,Herenthoutsesteenweg 2,2023-05-07,19:00:00,15,12,3,ECO_300019380
642,Herenthoutsesteenweg 2,2023-05-07,20:00:00,31,29,2,ECO_300019380
642,Herenthoutsesteenweg 2,2023-05-07,21:00:00,16,13,3,ECO_300019380
642,Herenthoutsesteenweg 2,2023-05-07,22:00:00,17,16,1,ECO_300019380
642,Herenthoutsesteenweg 2,2023-05-07,23:00:00,8,8,0,ECO_300019380
642,Herenthoutsesteenweg 2,2023-05-08,00:00:00,2,1,1,ECO_300019380
642,Herenthoutsesteenweg 2,2023-05-08,01:00:00,4,4,0,ECO_300019380
642,Herenthoutsesteenweg 2,2023-05-08,02:00:00,1,0,1,ECO_300019380
642,Herenthoutsesteenweg 2,2023-05-08,03:00:00,0,0,0,ECO_300019380
642,Herenthoutsesteenweg 2,2023-05-08,04:00:00,0,0,0,ECO_300019380
642,Herenthoutsesteenweg 2,2023-05-08,05:00:00,0,0,0,ECO_300019380
642,Herenthoutsesteenweg 2,2023-05-08,06:00:00,4,4,0,ECO_300019380
642,Herenthoutsesteenweg 2,2023-05-08,07:00:00,24,21,3,ECO_300019380
642,Herenthoutsesteenweg 2,2023-05-08,08:00:00,46,41,5,ECO_300019380
642,Herenthoutsesteenweg 2,2023-05-08,09:00:00,162,154,8,ECO_300019380
642,Herenthoutsesteenweg 2,2023-05-08,10:00:00,553,548,5,ECO_300019380
642,Herenthoutsesteenweg 2,2023-05-08,11:00:00,85,77,8,ECO_300019380
642,Herenthoutsesteenweg 2,2023-05-08,12:00:00,85,80,5,ECO_300019380
642,Herenthoutsesteenweg 2,2023-05-08,13:00:00,66,59,7,ECO_300019380
642,Herenthoutsesteenweg 2,2023-05-08,14:00:00,95,87,8,ECO_300019380
642,Herenthoutsesteenweg 2,2023-05-08,15:00:00,90,81,9,ECO_300019380
642,Herenthoutsesteenweg 2,2023-05-08,16:00:00,89,83,6,ECO_300019380
642,Herenthoutsesteenweg 2,2023-05-08,17:00:00,138,122,16,ECO_300019380
642,Herenthoutsesteenweg 2,2023-05-08,18:00:00,172,155,17,ECO_300019380
642,Herenthoutsesteenweg 2,2023-05-08,19:00:00,99,87,12,ECO_300019380
642,Herenthoutsesteenweg 2,2023-05-08,20:00:00,79,71,8,ECO_300019380
642,Herenthoutsesteenweg 2,2023-05-08,21:00:00,67,58,9,ECO_300019380
642,Herenthoutsesteenweg 2,2023-05-08,22:00:00,37,29,8,ECO_300019380
642,Herenthoutsesteenweg 2,2023-05-08,23:00:00,11,10,1,ECO_300019380
642,Herenthoutsesteenweg 2,2023-05-09,00:00:00,22,22,0,ECO_300019380
642,Herenthoutsesteenweg 2,2023-05-09,01:00:00,4,0,4,ECO_300019380
642,Herenthoutsesteenweg 2,2023-05-09,02:00:00,1,1,0,ECO_300019380
642,Herenthoutsesteenweg 2,2023-05-09,03:00:00,0,0,0,ECO_300019380
642,Herenthoutsesteenweg 2,2023-05-09,04:00:00,0,0,0,ECO_300019380
642,Herenthoutsesteenweg 2,2023-05-09,05:00:00,0,0,0,ECO_300019380
642,Herenthoutsesteenweg 2,2023-05-09,06:00:00,4,4,0,ECO_300019380
642,Herenthoutsesteenweg 2,2023-05-09,07:00:00,22,18,4,ECO_300019380
642,Herenthoutsesteenweg 2,2023-05-09,08:00:00,40,33,7,ECO_300019380
642,Herenthoutsesteenweg 2,2023-05-09,09:00:00,111,110,1,ECO_300019380
642,Herenthoutsesteenweg 2,2023-05-09,10:00:00,379,372,7,ECO_300019380
642,Herenthoutsesteenweg 2,2023-05-09,11:00:00,64,63,1,ECO_300019380
642,Herenthoutsesteenweg 2,2023-05-09,12:00:00,28,26,2,ECO_300019380
642,Herenthoutsesteenweg 2,2023-05-09,13:00:00,16,15,1,ECO_300019380
642,Herenthoutsesteenweg 2,2023-05-09,14:00:00,21,17,4,ECO_300019380
642,Herenthoutsesteenweg 2,2023-05-09,15:00:00,19,17,2,ECO_300019380
642,Herenthoutsesteenweg 2,2023-05-09,16:00:00,24,23,1,ECO_300019380
642,Herenthoutsesteenweg 2,2023-05-09,17:00:00,42,35,7,ECO_300019380
642,Herenthoutsesteenweg 2,2023-05-09,18:00:00,73,69,4,ECO_300019380
642,Herenthoutsesteenweg 2,2023-05-09,19:00:00,44,37,7,ECO_300019380
642,Herenthoutsesteenweg 2,2023-05-09,20:00:00,22,20,2,ECO_300019380
642,Herenthoutsesteenweg 2,2023-05-09,21:00:00,10,9,1,ECO_300019380
642,Herenthoutsesteenweg 2,2023-05-09,22:00:00,8,7,1,ECO_300019380
642,Herenthoutsesteenweg 2,2023-05-09,23:00:00,11,8,3,ECO_300019380
642,Herenthoutsesteenweg 2,2023-05-10,00:00:00,10,9,1,ECO_300019380
642,Herenthoutsesteenweg 2,2023-05-10,01:00:00,2,1,1,ECO_300019380
642,Herenthoutsesteenweg 2,2023-05-10,02:00:00,1,0,1,ECO_300019380
642,Herenthoutsesteenweg 2,2023-05-10,03:00:00,0,0,0,ECO_300019380
642,Herenthoutsesteenweg 2,2023-05-10,04:00:00,0,0,0,ECO_300019380
642,Herenthoutsesteenweg 2,2023-05-10,05:00:00,0,0,0,ECO_300019380
642,Herenthoutsesteenweg 2,2023-05-10,06:00:00,5,5,0,ECO_300019380
642,Herenthoutsesteenweg 2,2023-05-10,07:00:00,22,17,5,ECO_300019380
642,Herenthoutsesteenweg 2,2023-05-10,08:00:00,42,38,4,ECO_300019380
642,Herenthoutsesteenweg 2,2023-05-10,09:00:00,111,111,0,ECO_300019380
642,Herenthoutsesteenweg 2,2023-05-10,10:00:00,488,481,7,ECO_300019380
642,Herenthoutsesteenweg 2,2023-05-10,11:00:00,71,68,3,ECO_300019380
642,Herenthoutsesteenweg 2,2023-05-10,12:00:00,65,63,2,ECO_300019380
642,Herenthoutsesteenweg 2,2023-05-10,13:00:00,41,38,3,ECO_300019380
642,Herenthoutsesteenweg 2,2023-05-10,14:00:00,63,58,5,ECO_300019380
642,Herenthoutsesteenweg 2,2023-05-10,15:00:00,80,78,2,ECO_300019380
642,Herenthoutsesteenweg 2,2023-05-10,16:00:00,76,73,3,ECO_300019380
642,Herenthoutsesteenweg 2,2023-05-10,17:00:00,89,83,6,ECO_300019380
642,Herenthoutsesteenweg 2,2023-05-10,18:00:00,102,91,11,ECO_300019380
642,Herenthoutsesteenweg 2,2023-05-10,19:00:00,53,47,6,ECO_300019380
642,Herenthoutsesteenweg 2,2023-05-10,20:00:00,42,38,4,ECO_300019380
642,Herenthoutsesteenweg 2,2023-05-10,21:00:00,40,35,5,ECO_300019380
642,Herenthoutsesteenweg 2,2023-05-10,22:00:00,39,30,9,ECO_300019380
642,Herenthoutsesteenweg 2,2023-05-10,23:00:00,10,8,2,ECO_300019380
642,Herenthoutsesteenweg 2,2023-05-11,00:00:00,14,12,2,ECO_300019380
642,Herenthoutsesteenweg 2,2023-05-11,01:00:00,5,4,1,ECO_300019380
642,Herenthoutsesteenweg 2,2023-05-11,02:00:00,2,1,1,ECO_300019380
642,Herenthoutsesteenweg 2,2023-05-11,03:00:00,4,4,0,ECO_300019380
642,Herenthoutsesteenweg 2,2023-05-11,04:00:00,0,0,0,ECO_300019380
642,Herenthoutsesteenweg 2,2023-05-11,05:00:00,1,1,0,ECO_300019380
642,Herenthoutsesteenweg 2,2023-05-11,06:00:00,3,3,0,ECO_300019380
642,Herenthoutsesteenweg 2,2023-05-11,07:00:00,25,19,6,ECO_300019380
642,Herenthoutsesteenweg 2,2023-05-11,08:00:00,43,40,3,ECO_300019380
642,Herenthoutsesteenweg 2,2023-05-11,09:00:00,151,144,7,ECO_300019380
642,Herenthoutsesteenweg 2,2023-05-11,10:00:00,515,511,4,ECO_300019380
642,Herenthoutsesteenweg 2,2023-05-11,11:00:00,90,90,0,ECO_300019380
642,Herenthoutsesteenweg 2,2023-05-11,12:00:00,58,56,2,ECO_300019380
642,Herenthoutsesteenweg 2,2023-05-11,13:00:00,53,51,2,ECO_300019380
642,Herenthoutsesteenweg 2,2023-05-11,14:00:00,57,55,2,ECO_300019380
642,Herenthoutsesteenweg 2,2023-05-11,15:00:00,91,87,4,ECO_300019380
642,Herenthoutsesteenweg 2,2023-05-11,16:00:00,91,75,16,ECO_300019380
642,Herenthoutsesteenweg 2,2023-05-11,17:00:00,105,95,10,ECO_300019380
642,Herenthoutsesteenweg 2,2023-05-11,18:00:00,129,120,9,ECO_300019380
642,Herenthoutsesteenweg 2,2023-05-11,19:00:00,87,76,11,ECO_300019380
642,Herenthoutsesteenweg 2,2023-05-11,20:00:00,53,48,5,ECO_300019380
642,Herenthoutsesteenweg 2,2023-05-11,21:00:00,39,33,6,ECO_300019380
642,Herenthoutsesteenweg 2,2023-05-11,22:00:00,13,13,0,ECO_300019380
642,Herenthoutsesteenweg 2,2023-05-11,23:00:00,11,8,3,ECO_300019380
642,Herenthoutsesteenweg 2,2023-05-12,00:00:00,20,20,0,ECO_300019380
642,Herenthoutsesteenweg 2,2023-05-12,01:00:00,3,3,0,ECO_300019380
642,Herenthoutsesteenweg 2,2023-05-12,02:00:00,3,2,1,ECO_300019380
642,Herenthoutsesteenweg 2,2023-05-12,03:00:00,5,5,0,ECO_300019380
642,Herenthoutsesteenweg 2,2023-05-12,04:00:00,0,0,0,ECO_300019380
642,Herenthoutsesteenweg 2,2023-05-12,05:00:00,0,0,0,ECO_300019380
642,Herenthoutsesteenweg 2,2023-05-12,06:00:00,2,1,1,ECO_300019380
642,Herenthoutsesteenweg 2,2023-05-12,07:00:00,9,8,1,ECO_300019380
642,Herenthoutsesteenweg 2,2023-05-12,08:00:00,21,19,2,ECO_300019380
642,Herenthoutsesteenweg 2,2023-05-12,09:00:00,67,61,6,ECO_300019380
642,Herenthoutsesteenweg 2,2023-05-12,10:00:00,376,366,10,ECO_300019380
642,Herenthoutsesteenweg 2,2023-05-12,11:00:00,57,56,1,ECO_300019380
642,Herenthoutsesteenweg 2,2023-05-12,12:00:00,65,63,2,ECO_300019380
642,Herenthoutsesteenweg 2,2023-05-12,13:00:00,37,36,1,ECO_300019380
642,Herenthoutsesteenweg 2,2023-05-12,14:00:00,48,44,4,ECO_300019380
642,Herenthoutsesteenweg 2,2023-05-12,15:00:00,61,59,2,ECO_300019380
642,Herenthoutsesteenweg 2,2023-05-12,16:00:00,89,83,6,ECO_300019380
642,Herenthoutsesteenweg 2,2023-05-12,17:00:00,105,95,10,ECO_300019380
642,Herenthoutsesteenweg 2,2023-05-12,18:00:00,89,81,8,ECO_300019380
642,Herenthoutsesteenweg 2,2023-05-12,19:00:00,58,50,8,ECO_300019380
642,Herenthoutsesteenweg 2,2023-05-12,20:00:00,57,51,6,ECO_300019380
642,Herenthoutsesteenweg 2,2023-05-12,21:00:00,63,59,4,ECO_300019380
642,Herenthoutsesteenweg 2,2023-05-12,22:00:00,62,57,5,ECO_300019380
642,Herenthoutsesteenweg 2,2023-05-12,23:00:00,37,33,4,ECO_300019380
642,Herenthoutsesteenweg 2,2023-05-13,00:00:00,53,52,1,ECO_300019380
642,Herenthoutsesteenweg 2,2023-05-13,01:00:00,28,28,0,ECO_300019380
642,Herenthoutsesteenweg 2,2023-05-13,02:00:00,14,11,3,ECO_300019380
642,Herenthoutsesteenweg 2,2023-05-13,03:00:00,19,16,3,ECO_300019380
642,Herenthoutsesteenweg 2,2023-05-13,04:00:00,4,1,3,ECO_300019380
642,Herenthoutsesteenweg 2,2023-05-13,05:00:00,2,0,2,ECO_300019380
642,Herenthoutsesteenweg 2,2023-05-13,06:00:00,3,3,0,ECO_300019380
642,Herenthoutsesteenweg 2,2023-05-13,07:00:00,6,6,0,ECO_300019380
642,Herenthoutsesteenweg 2,2023-05-13,08:00:00,6,6,0,ECO_300019380
642,Herenthoutsesteenweg 2,2023-05-13,09:00:00,17,14,3,ECO_300019380
642,Herenthoutsesteenweg 2,2023-05-13,10:00:00,74,66,8,ECO_300019380
642,Herenthoutsesteenweg 2,2023-05-13,11:00:00,90,86,4,ECO_300019380
642,Herenthoutsesteenweg 2,2023-05-13,12:00:00,144,138,6,ECO_300019380
642,Herenthoutsesteenweg 2,2023-05-13,13:00:00,111,104,7,ECO_300019380
642,Herenthoutsesteenweg 2,2023-05-13,14:00:00,147,122,25,ECO_300019380
642,Herenthoutsesteenweg 2,2023-05-13,15:00:00,189,171,18,ECO_300019380
642,Herenthoutsesteenweg 2,2023-05-13,16:00:00,228,204,24,ECO_300019380
642,Herenthoutsesteenweg 2,2023-05-13,17:00:00,189,168,21,ECO_300019380
642,Herenthoutsesteenweg 2,2023-05-13,18:00:00,134,113,21,ECO_300019380
642,Herenthoutsesteenweg 2,2023-05-13,19:00:00,85,80,5,ECO_300019380
642,Herenthoutsesteenweg 2,2023-05-13,20:00:00,64,60,4,ECO_300019380
642,Herenthoutsesteenweg 2,2023-05-13,21:00:00,74,64,10,ECO_300019380
642,Herenthoutsesteenweg 2,2023-05-13,22:00:00,54,45,9,ECO_300019380
642,Herenthoutsesteenweg 2,2023-05-13,23:00:00,33,30,3,ECO_300019380
642,Herenthoutsesteenweg 2,2023-05-14,00:00:00,23,19,4,ECO_300019380
642,Herenthoutsesteenweg 2,2023-05-14,01:00:00,14,10,4,ECO_300019380
642,Herenthoutsesteenweg 2,2023-05-14,02:00:00,17,11,6,ECO_300019380
642,Herenthoutsesteenweg 2,2023-05-14,03:00:00,8,6,2,ECO_300019380
642,Herenthoutsesteenweg 2,2023-05-14,04:00:00,6,6,0,ECO_300019380
642,Herenthoutsesteenweg 2,2023-05-14,05:00:00,6,4,2,ECO_300019380
642,Herenthoutsesteenweg 2,2023-05-14,06:00:00,3,1,2,ECO_300019380
642,Herenthoutsesteenweg 2,2023-05-14,07:00:00,2,2,0,ECO_300019380
642,Herenthoutsesteenweg 2,2023-05-14,08:00:00,10,8,2,ECO_300019380
642,Herenthoutsesteenweg 2,2023-05-14,09:00:00,20,19,1,ECO_300019380
642,Herenthoutsesteenweg 2,2023-05-14,10:00:00,60,52,8,ECO_300019380
642,Herenthoutsesteenweg 2,2023-05-14,11:00:00,172,139,33,ECO_300019380
642,Herenthoutsesteenweg 2,2023-05-14,12:00:00,156,135,21,ECO_300019380
642,Herenthoutsesteenweg 2,2023-05-14,13:00:00,117,104,13,ECO_300019380
642,Herenthoutsesteenweg 2,2023-05-14,14:00:00,109,94,15,ECO_300019380
642,Herenthoutsesteenweg 2,2023-05-14,15:00:00,144,131,13,ECO_300019380
642,Herenthoutsesteenweg 2,2023-05-14,16:00:00,168,154,14,ECO_300019380
642,Herenthoutsesteenweg 2,2023-05-14,17:00:00,145,128,17,ECO_300019380
642,Herenthoutsesteenweg 2,2023-05-14,18:00:00,130,125,5,ECO_300019380
642,Herenthoutsesteenweg 2,2023-05-14,19:00:00,96,87,9,ECO_300019380
642,Herenthoutsesteenweg 2,2023-05-14,20:00:00,55,47,8,ECO_300019380
642,Herenthoutsesteenweg 2,2023-05-14,21:00:00,47,39,8,ECO_300019380
642,Herenthoutsesteenweg 2,2023-05-14,22:00:00,20,17,3,ECO_300019380
642,Herenthoutsesteenweg 2,2023-05-14,23:00:00,14,12,2,ECO_300019380
642,Herenthoutsesteenweg 2,2023-05-15,00:00:00,2,2,0,ECO_300019380
642,Herenthoutsesteenweg 2,2023-05-15,01:00:00,2,1,1,ECO_300019380
642,Herenthoutsesteenweg 2,2023-05-15,02:00:00,2,1,1,ECO_300019380
642,Herenthoutsesteenweg 2,2023-05-15,03:00:00,0,0,0,ECO_300019380
642,Herenthoutsesteenweg 2,2023-05-15,04:00:00,0,0,0,ECO_300019380
642,Herenthoutsesteenweg 2,2023-05-15,05:00:00,0,0,0,ECO_300019380
642,Herenthoutsesteenweg 2,2023-05-15,06:00:00,2,2,0,ECO_300019380
642,Herenthoutsesteenweg 2,2023-05-15,07:00:00,21,19,2,ECO_300019380
642,Herenthoutsesteenweg 2,2023-05-15,08:00:00,40,37,3,ECO_300019380
642,Herenthoutsesteenweg 2,2023-05-15,09:00:00,139,138,1,ECO_300019380
642,Herenthoutsesteenweg 2,2023-05-15,10:00:00,536,529,7,ECO_300019380
642,Herenthoutsesteenweg 2,2023-05-15,11:00:00,66,63,3,ECO_300019380
642,Herenthoutsesteenweg 2,2023-05-15,12:00:00,59,55,4,ECO_300019380
642,Herenthoutsesteenweg 2,2023-05-15,13:00:00,60,58,2,ECO_300019380
642,Herenthoutsesteenweg 2,2023-05-15,14:00:00,62,53,9,ECO_300019380
642,Herenthoutsesteenweg 2,2023-05-15,15:00:00,98,39,59,ECO_300019380
642,Herenthoutsesteenweg 2,2023-05-15,16:00:00,50,42,8,ECO_300019380
642,Herenthoutsesteenweg 2,2023-05-15,17:00:00,57,51,6,ECO_300019380
642,Herenthoutsesteenweg 2,2023-05-15,18:00:00,92,81,11,ECO_300019380
642,Herenthoutsesteenweg 2,2023-05-15,19:00:00,49,43,6,ECO_300019380
642,Herenthoutsesteenweg 2,2023-05-15,20:00:00,28,25,3,ECO_300019380
642,Herenthoutsesteenweg 2,2023-05-15,21:00:00,16,15,1,ECO_300019380
642,Herenthoutsesteenweg 2,2023-05-15,22:00:00,5,5,0,ECO_300019380
642,Herenthoutsesteenweg 2,2023-05-15,23:00:00,7,7,0,ECO_300019380
642,Herenthoutsesteenweg 2,2023-05-16,00:00:00,14,14,0,ECO_300019380
642,Herenthoutsesteenweg 2,2023-05-16,01:00:00,0,0,0,ECO_300019380
642,Herenthoutsesteenweg 2,2023-05-16,02:00:00,1,0,1,ECO_300019380
642,Herenthoutsesteenweg 2,2023-05-16,03:00:00,1,1,0,ECO_300019380
642,Herenthoutsesteenweg 2,2023-05-16,04:00:00,2,0,2,ECO_300019380
642,Herenthoutsesteenweg 2,2023-05-16,05:00:00,0,0,0,ECO_300019380
642,Herenthoutsesteenweg 2,2023-05-16,06:00:00,2,2,0,ECO_300019380
642,Herenthoutsesteenweg 2,2023-05-16,07:00:00,21,20,1,ECO_300019380
642,Herenthoutsesteenweg 2,2023-05-16,08:00:00,45,42,3,ECO_300019380
642,Herenthoutsesteenweg 2,2023-05-16,09:00:00,191,182,9,ECO_300019380
642,Herenthoutsesteenweg 2,2023-05-16,10:00:00,554,539,15,ECO_300019380
642,Herenthoutsesteenweg 2,2023-05-16,11:00:00,91,90,1,ECO_300019380
642,Herenthoutsesteenweg 2,2023-05-16,12:00:00,68,64,4,ECO_300019380
642,Herenthoutsesteenweg 2,2023-05-16,13:00:00,55,47,8,ECO_300019380
642,Herenthoutsesteenweg 2,2023-05-16,14:00:00,68,63,5,ECO_300019380
642,Herenthoutsesteenweg 2,2023-05-16,15:00:00,114,107,7,ECO_300019380
642,Herenthoutsesteenweg 2,2023-05-16,16:00:00,87,78,9,ECO_300019380
642,Herenthoutsesteenweg 2,2023-05-16,17:00:00,108,91,17,ECO_300019380
642,Herenthoutsesteenweg 2,2023-05-16,18:00:00,136,128,8,ECO_300019380
642,Herenthoutsesteenweg 2,2023-05-16,19:00:00,103,95,8,ECO_300019380
642,Herenthoutsesteenweg 2,2023-05-16,20:00:00,67,61,6,ECO_300019380
642,Herenthoutsesteenweg 2,2023-05-16,21:00:00,49,47,2,ECO_300019380
642,Herenthoutsesteenweg 2,2023-05-16,22:00:00,25,17,8,ECO_300019380
642,Herenthoutsesteenweg 2,2023-05-16,23:00:00,33,18,15,ECO_300019380
642,Herenthoutsesteenweg 2,2023-05-17,00:00:00,19,16,3,ECO_300019380
642,Herenthoutsesteenweg 2,2023-05-17,01:00:00,2,2,0,ECO_300019380
642,Herenthoutsesteenweg 2,2023-05-17,02:00:00,4,2,2,ECO_300019380
642,Herenthoutsesteenweg 2,2023-05-17,03:00:00,0,0,0,ECO_300019380
642,Herenthoutsesteenweg 2,2023-05-17,04:00:00,0,0,0,ECO_300019380
642,Herenthoutsesteenweg 2,2023-05-17,05:00:00,2,2,0,ECO_300019380
642,Herenthoutsesteenweg 2,2023-05-17,06:00:00,3,3,0,ECO_300019380
642,Herenthoutsesteenweg 2,2023-05-17,07:00:00,25,23,2,ECO_300019380
642,Herenthoutsesteenweg 2,2023-05-17,08:00:00,48,41,7,ECO_300019380
642,Herenthoutsesteenweg 2,2023-05-17,09:00:00,136,133,3,ECO_300019380
642,Herenthoutsesteenweg 2,2023-05-17,10:00:00,532,522,10,ECO_300019380
642,Herenthoutsesteenweg 2,2023-05-17,11:00:00,92,86,6,ECO_300019380
642,Herenthoutsesteenweg 2,2023-05-17,12:00:00,88,79,9,ECO_300019380
642,Herenthoutsesteenweg 2,2023-05-17,13:00:00,73,68,5,ECO_300019380
642,Herenthoutsesteenweg 2,2023-05-17,14:00:00,119,110,9,ECO_300019380
642,Herenthoutsesteenweg 2,2023-05-17,15:00:00,145,131,14,ECO_300019380
642,Herenthoutsesteenweg 2,2023-05-17,16:00:00,160,154,6,ECO_300019380
642,Herenthoutsesteenweg 2,2023-05-17,17:00:00,103,94,9,ECO_300019380
642,Herenthoutsesteenweg 2,2023-05-17,18:00:00,128,116,12,ECO_300019380
642,Herenthoutsesteenweg 2,2023-05-17,19:00:00,123,110,13,ECO_300019380
642,Herenthoutsesteenweg 2,2023-05-17,20:00:00,68,54,14,ECO_300019380
642,Herenthoutsesteenweg 2,2023-05-17,21:00:00,65,56,9,ECO_300019380
642,Herenthoutsesteenweg 2,2023-05-17,22:00:00,53,41,12,ECO_300019380
642,Herenthoutsesteenweg 2,2023-05-17,23:00:00,25,20,5,ECO_300019380
642,Herenthoutsesteenweg 2,2023-05-18,00:00:00,21,20,1,ECO_300019380
642,Herenthoutsesteenweg 2,2023-05-18,01:00:00,12,8,4,ECO_300019380
642,Herenthoutsesteenweg 2,2023-05-18,02:00:00,12,9,3,ECO_300019380
642,Herenthoutsesteenweg 2,2023-05-18,03:00:00,9,9,0,ECO_300019380
642,Herenthoutsesteenweg 2,2023-05-18,04:00:00,16,13,3,ECO_300019380
642,Herenthoutsesteenweg 2,2023-05-18,05:00:00,20,20,0,ECO_300019380
642,Herenthoutsesteenweg 2,2023-05-18,06:00:00,8,7,1,ECO_300019380
642,Herenthoutsesteenweg 2,2023-05-18,07:00:00,2,2,0,ECO_300019380
642,Herenthoutsesteenweg 2,2023-05-18,08:00:00,9,8,1,ECO_300019380
642,Herenthoutsesteenweg 2,2023-05-18,09:00:00,10,10,0,ECO_300019380
642,Herenthoutsesteenweg 2,2023-05-18,10:00:00,47,44,3,ECO_300019380
642,Herenthoutsesteenweg 2,2023-05-18,11:00:00,80,78,2,ECO_300019380
642,Herenthoutsesteenweg 2,2023-05-18,12:00:00,80,67,13,ECO_300019380
642,Herenthoutsesteenweg 2,2023-05-18,13:00:00,83,55,28,ECO_300019380
642,Herenthoutsesteenweg 2,2023-05-18,14:00:00,92,83,9,ECO_300019380
642,Herenthoutsesteenweg 2,2023-05-18,15:00:00,127,115,12,ECO_300019380
642,Herenthoutsesteenweg 2,2023-05-18,16:00:00,163,142,21,ECO_300019380
642,Herenthoutsesteenweg 2,2023-05-18,17:00:00,122,96,26,ECO_300019380
642,Herenthoutsesteenweg 2,2023-05-18,18:00:00,108,93,15,ECO_300019380
642,Herenthoutsesteenweg 2,2023-05-18,19:00:00,91,78,13,ECO_300019380
642,Herenthoutsesteenweg 2,2023-05-18,20:00:00,44,37,7,ECO_300019380
642,Herenthoutsesteenweg 2,2023-05-18,21:00:00,42,36,6,ECO_300019380
642,Herenthoutsesteenweg 2,2023-05-18,22:00:00,27,21,6,ECO_300019380
642,Herenthoutsesteenweg 2,2023-05-18,23:00:00,30,16,14,ECO_300019380
642,Herenthoutsesteenweg 2,2023-05-19,00:00:00,27,24,3,ECO_300019380
642,Herenthoutsesteenweg 2,2023-05-19,01:00:00,12,11,1,ECO_300019380
642,Herenthoutsesteenweg 2,2023-05-19,02:00:00,3,3,0,ECO_300019380
642,Herenthoutsesteenweg 2,2023-05-19,03:00:00,1,1,0,ECO_300019380
642,Herenthoutsesteenweg 2,2023-05-19,04:00:00,0,0,0,ECO_300019380
642,Herenthoutsesteenweg 2,2023-05-19,05:00:00,1,0,1,ECO_300019380
642,Herenthoutsesteenweg 2,2023-05-19,06:00:00,0,0,0,ECO_300019380
642,Herenthoutsesteenweg 2,2023-05-19,07:00:00,10,9,1,ECO_300019380
642,Herenthoutsesteenweg 2,2023-05-19,08:00:00,10,8,2,ECO_300019380
642,Herenthoutsesteenweg 2,2023-05-19,09:00:00,25,24,1,ECO_300019380
642,Herenthoutsesteenweg 2,2023-05-19,10:00:00,64,63,1,ECO_300019380
642,Herenthoutsesteenweg 2,2023-05-19,11:00:00,149,148,1,ECO_300019380
642,Herenthoutsesteenweg 2,2023-05-19,12:00:00,180,174,6,ECO_300019380
642,Herenthoutsesteenweg 2,2023-05-19,13:00:00,117,103,14,ECO_300019380
642,Herenthoutsesteenweg 2,2023-05-19,14:00:00,91,85,6,ECO_300019380
642,Herenthoutsesteenweg 2,2023-05-19,15:00:00,125,107,18,ECO_300019380
642,Herenthoutsesteenweg 2,2023-05-19,16:00:00,191,170,21,ECO_300019380
642,Herenthoutsesteenweg 2,2023-05-19,17:00:00,149,129,20,ECO_300019380
642,Herenthoutsesteenweg 2,2023-05-19,18:00:00,113,102,11,ECO_300019380
642,Herenthoutsesteenweg 2,2023-05-19,19:00:00,112,95,17,ECO_300019380
642,Herenthoutsesteenweg 2,2023-05-19,20:00:00,65,58,7,ECO_300019380
642,Herenthoutsesteenweg 2,2023-05-19,21:00:00,59,47,12,ECO_300019380
642,Herenthoutsesteenweg 2,2023-05-19,22:00:00,40,30,10,ECO_300019380
642,Herenthoutsesteenweg 2,2023-05-19,23:00:00,32,29,3,ECO_300019380
642,Herenthoutsesteenweg 2,2023-05-20,00:00:00,24,21,3,ECO_300019380
642,Herenthoutsesteenweg 2,2023-05-20,01:00:00,8,8,0,ECO_300019380
642,Herenthoutsesteenweg 2,2023-05-20,02:00:00,38,35,3,ECO_300019380
642,Herenthoutsesteenweg 2,2023-05-20,03:00:00,39,37,2,ECO_300019380
642,Herenthoutsesteenweg 2,2023-05-20,04:00:00,26,26,0,ECO_300019380
642,Herenthoutsesteenweg 2,2023-05-20,05:00:00,3,3,0,ECO_300019380
642,Herenthoutsesteenweg 2,2023-05-20,06:00:00,0,0,0,ECO_300019380
642,Herenthoutsesteenweg 2,2023-05-20,07:00:00,3,3,0,ECO_300019380
642,Herenthoutsesteenweg 2,2023-05-20,08:00:00,11,9,2,ECO_300019380
642,Herenthoutsesteenweg 2,2023-05-20,09:00:00,9,9,0,ECO_300019380
642,Herenthoutsesteenweg 2,2023-05-20,10:00:00,40,37,3,ECO_300019380
642,Herenthoutsesteenweg 2,2023-05-20,11:00:00,78,77,1,ECO_300019380
642,Herenthoutsesteenweg 2,2023-05-20,12:00:00,121,116,5,ECO_300019380
642,Herenthoutsesteenweg 2,2023-05-20,13:00:00,103,94,9,ECO_300019380
642,Herenthoutsesteenweg 2,2023-05-20,14:00:00,136,120,16,ECO_300019380
642,Herenthoutsesteenweg 2,2023-05-20,15:00:00,178,164,14,ECO_300019380
642,Herenthoutsesteenweg 2,2023-05-20,16:00:00,143,133,10,ECO_300019380
642,Herenthoutsesteenweg 2,2023-05-20,17:00:00,142,119,23,ECO_300019380
642,Herenthoutsesteenweg 2,2023-05-20,18:00:00,143,127,16,ECO_300019380
642,Herenthoutsesteenweg 2,2023-05-20,19:00:00,71,58,13,ECO_300019380
642,Herenthoutsesteenweg 2,2023-05-20,20:00:00,74,66,8,ECO_300019380
642,Herenthoutsesteenweg 2,2023-05-20,21:00:00,64,57,7,ECO_300019380
642,Herenthoutsesteenweg 2,2023-05-20,22:00:00,42,40,2,ECO_300019380
642,Herenthoutsesteenweg 2,2023-05-20,23:00:00,30,25,5,ECO_300019380
642,Herenthoutsesteenweg 2,2023-05-21,00:00:00,24,23,1,ECO_300019380
642,Herenthoutsesteenweg 2,2023-05-21,01:00:00,25,24,1,ECO_300019380
642,Herenthoutsesteenweg 2,2023-05-21,02:00:00,38,35,3,ECO_300019380
642,Herenthoutsesteenweg 2,2023-05-21,03:00:00,55,54,1,ECO_300019380
642,Herenthoutsesteenweg 2,2023-05-21,04:00:00,27,26,1,ECO_300019380
642,Herenthoutsesteenweg 2,2023-05-21,05:00:00,10,8,2,ECO_300019380
642,Herenthoutsesteenweg 2,2023-05-21,06:00:00,3,3,0,ECO_300019380
642,Herenthoutsesteenweg 2,2023-05-21,07:00:00,5,5,0,ECO_300019380
642,Herenthoutsesteenweg 2,2023-05-21,08:00:00,14,14,0,ECO_300019380
642,Herenthoutsesteenweg 2,2023-05-21,09:00:00,17,17,0,ECO_300019380
642,Herenthoutsesteenweg 2,2023-05-21,10:00:00,61,53,8,ECO_300019380
642,Herenthoutsesteenweg 2,2023-05-21,11:00:00,124,118,6,ECO_300019380
642,Herenthoutsesteenweg 2,2023-05-21,12:00:00,172,151,21,ECO_300019380
642,Herenthoutsesteenweg 2,2023-05-21,13:00:00,138,125,13,ECO_300019380
642,Herenthoutsesteenweg 2,2023-05-21,14:00:00,100,79,21,ECO_300019380
642,Herenthoutsesteenweg 2,2023-05-21,15:00:00,173,150,23,ECO_300019380
642,Herenthoutsesteenweg 2,2023-05-21,16:00:00,170,153,17,ECO_300019380
642,Herenthoutsesteenweg 2,2023-05-21,17:00:00,155,134,21,ECO_300019380
642,Herenthoutsesteenweg 2,2023-05-21,18:00:00,136,113,23,ECO_300019380
642,Herenthoutsesteenweg 2,2023-05-21,19:00:00,104,86,18,ECO_300019380
642,Herenthoutsesteenweg 2,2023-05-21,20:00:00,80,71,9,ECO_300019380
642,Herenthoutsesteenweg 2,2023-05-21,21:00:00,46,40,6,ECO_300019380
642,Herenthoutsesteenweg 2,2023-05-21,22:00:00,41,37,4,ECO_300019380
642,Herenthoutsesteenweg 2,2023-05-21,23:00:00,17,13,4,ECO_300019380
642,Herenthoutsesteenweg 2,2023-05-22,00:00:00,9,8,1,ECO_300019380
642,Herenthoutsesteenweg 2,2023-05-22,01:00:00,8,7,1,ECO_300019380
642,Herenthoutsesteenweg 2,2023-05-22,02:00:00,3,2,1,ECO_300019380
642,Herenthoutsesteenweg 2,2023-05-22,03:00:00,0,0,0,ECO_300019380
642,Herenthoutsesteenweg 2,2023-05-22,04:00:00,0,0,0,ECO_300019380
642,Herenthoutsesteenweg 2,2023-05-22,05:00:00,0,0,0,ECO_300019380
642,Herenthoutsesteenweg 2,2023-05-22,06:00:00,3,3,0,ECO_300019380
642,Herenthoutsesteenweg 2,2023-05-22,07:00:00,22,18,4,ECO_300019380
642,Herenthoutsesteenweg 2,2023-05-22,08:00:00,54,49,5,ECO_300019380
642,Herenthoutsesteenweg 2,2023-05-22,09:00:00,177,175,2,ECO_300019380
642,Herenthoutsesteenweg 2,2023-05-22,10:00:00,603,596,7,ECO_300019380
642,Herenthoutsesteenweg 2,2023-05-22,11:00:00,70,69,1,ECO_300019380
642,Herenthoutsesteenweg 2,2023-05-22,12:00:00,56,52,4,ECO_300019380
642,Herenthoutsesteenweg 2,2023-05-22,13:00:00,41,39,2,ECO_300019380
642,Herenthoutsesteenweg 2,2023-05-22,14:00:00,68,61,7,ECO_300019380
642,Herenthoutsesteenweg 2,2023-05-22,15:00:00,114,106,8,ECO_300019380
642,Herenthoutsesteenweg 2,2023-05-22,16:00:00,118,112,6,ECO_300019380
642,Herenthoutsesteenweg 2,2023-05-22,17:00:00,150,132,18,ECO_300019380
642,Herenthoutsesteenweg 2,2023-05-22,18:00:00,159,141,18,ECO_300019380
642,Herenthoutsesteenweg 2,2023-05-22,19:00:00,121,107,14,ECO_300019380
642,Herenthoutsesteenweg 2,2023-05-22,20:00:00,80,73,7,ECO_300019380
642,Herenthoutsesteenweg 2,2023-05-22,21:00:00,42,38,4,ECO_300019380
642,Herenthoutsesteenweg 2,2023-05-22,22:00:00,28,25,3,ECO_300019380
642,Herenthoutsesteenweg 2,2023-05-22,23:00:00,11,9,2,ECO_300019380
642,Herenthoutsesteenweg 2,2023-05-23,00:00:00,17,17,0,ECO_300019380
642,Herenthoutsesteenweg 2,2023-05-23,01:00:00,6,4,2,ECO_300019380
642,Herenthoutsesteenweg 2,2023-05-23,02:00:00,2,1,1,ECO_300019380
642,Herenthoutsesteenweg 2,2023-05-23,03:00:00,2,2,0,ECO_300019380
642,Herenthoutsesteenweg 2,2023-05-23,04:00:00,0,0,0,ECO_300019380
642,Herenthoutsesteenweg 2,2023-05-23,05:00:00,1,1,0,ECO_300019380
642,Herenthoutsesteenweg 2,2023-05-23,06:00:00,2,2,0,ECO_300019380
642,Herenthoutsesteenweg 2,2023-05-23,07:00:00,25,22,3,ECO_300019380
642,Herenthoutsesteenweg 2,2023-05-23,08:00:00,50,49,1,ECO_300019380
642,Herenthoutsesteenweg 2,2023-05-23,09:00:00,174,173,1,ECO_300019380
642,Herenthoutsesteenweg 2,2023-05-23,10:00:00,584,580,4,ECO_300019380
642,Herenthoutsesteenweg 2,2023-05-23,11:00:00,117,115,2,ECO_300019380
642,Herenthoutsesteenweg 2,2023-05-23,12:00:00,65,64,1,ECO_300019380
642,Herenthoutsesteenweg 2,2023-05-23,13:00:00,55,48,7,ECO_300019380
642,Herenthoutsesteenweg 2,2023-05-23,14:00:00,72,65,7,ECO_300019380
642,Herenthoutsesteenweg 2,2023-05-23,15:00:00,120,115,5,ECO_300019380
642,Herenthoutsesteenweg 2,2023-05-23,16:00:00,130,120,10,ECO_300019380
642,Herenthoutsesteenweg 2,2023-05-23,17:00:00,131,117,14,ECO_300019380
642,Herenthoutsesteenweg 2,2023-05-23,18:00:00,181,159,22,ECO_300019380
642,Herenthoutsesteenweg 2,2023-05-23,19:00:00,98,83,15,ECO_300019380
642,Herenthoutsesteenweg 2,2023-05-23,20:00:00,78,71,7,ECO_300019380
642,Herenthoutsesteenweg 2,2023-05-23,21:00:00,66,59,7,ECO_300019380
642,Herenthoutsesteenweg 2,2023-05-23,22:00:00,44,28,16,ECO_300019380
642,Herenthoutsesteenweg 2,2023-05-23,23:00:00,22,22,0,ECO_300019380
642,Herenthoutsesteenweg 2,2023-05-24,00:00:00,25,24,1,ECO_300019380
642,Herenthoutsesteenweg 2,2023-05-24,01:00:00,8,2,6,ECO_300019380
642,Herenthoutsesteenweg 2,2023-05-24,02:00:00,2,2,0,ECO_300019380
642,Herenthoutsesteenweg 2,2023-05-24,03:00:00,1,1,0,ECO_300019380
642,Herenthoutsesteenweg 2,2023-05-24,04:00:00,0,0,0,ECO_300019380
642,Herenthoutsesteenweg 2,2023-05-24,05:00:00,0,0,0,ECO_300019380
642,Herenthoutsesteenweg 2,2023-05-24,06:00:00,5,5,0,ECO_300019380
642,Herenthoutsesteenweg 2,2023-05-24,07:00:00,25,20,5,ECO_300019380
642,Herenthoutsesteenweg 2,2023-05-24,08:00:00,51,44,7,ECO_300019380
642,Herenthoutsesteenweg 2,2023-05-24,09:00:00,158,154,4,ECO_300019380
642,Herenthoutsesteenweg 2,2023-05-24,10:00:00,390,386,4,ECO_300019380
642,Herenthoutsesteenweg 2,2023-05-24,11:00:00,87,84,3,ECO_300019380
642,Herenthoutsesteenweg 2,2023-05-24,12:00:00,71,69,2,ECO_300019380
642,Herenthoutsesteenweg 2,2023-05-24,13:00:00,63,59,4,ECO_300019380
642,Herenthoutsesteenweg 2,2023-05-24,14:00:00,134,126,8,ECO_300019380
642,Herenthoutsesteenweg 2,2023-05-24,15:00:00,136,133,3,ECO_300019380
642,Herenthoutsesteenweg 2,2023-05-24,16:00:00,156,143,13,ECO_300019380
642,Herenthoutsesteenweg 2,2023-05-24,17:00:00,112,103,9,ECO_300019380
642,Herenthoutsesteenweg 2,2023-05-24,18:00:00,150,136,14,ECO_300019380
642,Herenthoutsesteenweg 2,2023-05-24,19:00:00,98,86,12,ECO_300019380
642,Herenthoutsesteenweg 2,2023-05-24,20:00:00,85,79,6,ECO_300019380
642,Herenthoutsesteenweg 2,2023-05-24,21:00:00,48,36,12,ECO_300019380
642,Herenthoutsesteenweg 2,2023-05-24,22:00:00,44,35,9,ECO_300019380
642,Herenthoutsesteenweg 2,2023-05-24,23:00:00,25,21,4,ECO_300019380
642,Herenthoutsesteenweg 2,2023-05-25,00:00:00,22,20,2,ECO_300019380
642,Herenthoutsesteenweg 2,2023-05-25,01:00:00,1,1,0,ECO_300019380
642,Herenthoutsesteenweg 2,2023-05-25,02:00:00,0,0,0,ECO_300019380
642,Herenthoutsesteenweg 2,2023-05-25,03:00:00,3,3,0,ECO_300019380
642,Herenthoutsesteenweg 2,2023-05-25,04:00:00,0,0,0,ECO_300019380
642,Herenthoutsesteenweg 2,2023-05-25,05:00:00,0,0,0,ECO_300019380
642,Herenthoutsesteenweg 2,2023-05-25,06:00:00,4,3,1,ECO_300019380
642,Herenthoutsesteenweg 2,2023-05-25,07:00:00,16,13,3,ECO_300019380
642,Herenthoutsesteenweg 2,2023-05-25,08:00:00,51,46,5,ECO_300019380
642,Herenthoutsesteenweg 2,2023-05-25,09:00:00,170,164,6,ECO_300019380
642,Herenthoutsesteenweg 2,2023-05-25,10:00:00,612,602,10,ECO_300019380
642,Herenthoutsesteenweg 2,2023-05-25,11:00:00,99,95,4,ECO_300019380
642,Herenthoutsesteenweg 2,2023-05-25,12:00:00,112,108,4,ECO_300019380
642,Herenthoutsesteenweg 2,2023-05-25,13:00:00,77,72,5,ECO_300019380
642,Herenthoutsesteenweg 2,2023-05-25,14:00:00,80,73,7,ECO_300019380
642,Herenthoutsesteenweg 2,2023-05-25,15:00:00,135,120,15,ECO_300019380
642,Herenthoutsesteenweg 2,2023-05-25,16:00:00,139,131,8,ECO_300019380
642,Herenthoutsesteenweg 2,2023-05-25,17:00:00,148,129,19,ECO_300019380
642,Herenthoutsesteenweg 2,2023-05-25,18:00:00,181,161,20,ECO_300019380
642,Herenthoutsesteenweg 2,2023-05-25,19:00:00,89,76,13,ECO_300019380
642,Herenthoutsesteenweg 2,2023-05-25,20:00:00,98,89,9,ECO_300019380
642,Herenthoutsesteenweg 2,2023-05-25,21:00:00,68,62,6,ECO_300019380
642,Herenthoutsesteenweg 2,2023-05-25,22:00:00,40,33,7,ECO_300019380
642,Herenthoutsesteenweg 2,2023-05-25,23:00:00,22,20,2,ECO_300019380
642,Herenthoutsesteenweg 2,2023-05-26,00:00:00,19,18,1,ECO_300019380
642,Herenthoutsesteenweg 2,2023-05-26,01:00:00,1,1,0,ECO_300019380
642,Herenthoutsesteenweg 2,2023-05-26,02:00:00,0,0,0,ECO_300019380
642,Herenthoutsesteenweg 2,2023-05-26,03:00:00,2,2,0,ECO_300019380
642,Herenthoutsesteenweg 2,2023-05-26,04:00:00,1,1,0,ECO_300019380
642,Herenthoutsesteenweg 2,2023-05-26,05:00:00,0,0,0,ECO_300019380
642,Herenthoutsesteenweg 2,2023-05-26,06:00:00,4,4,0,ECO_300019380
642,Herenthoutsesteenweg 2,2023-05-26,07:00:00,17,14,3,ECO_300019380
642,Herenthoutsesteenweg 2,2023-05-26,08:00:00,51,45,6,ECO_300019380
642,Herenthoutsesteenweg 2,2023-05-26,09:00:00,158,155,3,ECO_300019380
642,Herenthoutsesteenweg 2,2023-05-26,10:00:00,733,721,12,ECO_300019380
642,Herenthoutsesteenweg 2,2023-05-26,11:00:00,129,127,2,ECO_300019380
642,Herenthoutsesteenweg 2,2023-05-26,12:00:00,98,96,2,ECO_300019380
642,Herenthoutsesteenweg 2,2023-05-26,13:00:00,79,77,2,ECO_300019380
642,Herenthoutsesteenweg 2,2023-05-26,14:00:00,93,82,11,ECO_300019380
642,Herenthoutsesteenweg 2,2023-05-26,15:00:00,128,122,6,ECO_300019380
642,Herenthoutsesteenweg 2,2023-05-26,16:00:00,146,135,11,ECO_300019380
642,Herenthoutsesteenweg 2,2023-05-26,17:00:00,182,167,15,ECO_300019380
642,Herenthoutsesteenweg 2,2023-05-26,18:00:00,161,145,16,ECO_300019380
642,Herenthoutsesteenweg 2,2023-05-26,19:00:00,147,133,14,ECO_300019380
642,Herenthoutsesteenweg 2,2023-05-26,20:00:00,91,77,14,ECO_300019380
642,Herenthoutsesteenweg 2,2023-05-26,21:00:00,73,66,7,ECO_300019380
642,Herenthoutsesteenweg 2,2023-05-26,22:00:00,39,36,3,ECO_300019380
642,Herenthoutsesteenweg 2,2023-05-26,23:00:00,30,27,3,ECO_300019380
642,Herenthoutsesteenweg 2,2023-05-27,00:00:00,28,24,4,ECO_300019380
642,Herenthoutsesteenweg 2,2023-05-27,01:00:00,6,5,1,ECO_300019380
642,Herenthoutsesteenweg 2,2023-05-27,02:00:00,10,8,2,ECO_300019380
642,Herenthoutsesteenweg 2,2023-05-27,03:00:00,9,8,1,ECO_300019380
642,Herenthoutsesteenweg 2,2023-05-27,04:00:00,0,0,0,ECO_300019380
642,Herenthoutsesteenweg 2,2023-05-27,05:00:00,5,0,5,ECO_300019380
642,Herenthoutsesteenweg 2,2023-05-27,06:00:00,2,1,1,ECO_300019380
642,Herenthoutsesteenweg 2,2023-05-27,07:00:00,7,7,0,ECO_300019380
642,Herenthoutsesteenweg 2,2023-05-27,08:00:00,15,15,0,ECO_300019380
642,Herenthoutsesteenweg 2,2023-05-27,09:00:00,14,13,1,ECO_300019380
642,Herenthoutsesteenweg 2,2023-05-27,10:00:00,54,53,1,ECO_300019380
642,Herenthoutsesteenweg 2,2023-05-27,11:00:00,80,77,3,ECO_300019380
642,Herenthoutsesteenweg 2,2023-05-27,12:00:00,117,109,8,ECO_300019380
642,Herenthoutsesteenweg 2,2023-05-27,13:00:00,111,98,13,ECO_300019380
642,Herenthoutsesteenweg 2,2023-05-27,14:00:00,135,124,11,ECO_300019380
642,Herenthoutsesteenweg 2,2023-05-27,15:00:00,171,160,11,ECO_300019380
642,Herenthoutsesteenweg 2,2023-05-27,16:00:00,188,174,14,ECO_300019380
642,Herenthoutsesteenweg 2,2023-05-27,17:00:00,166,147,19,ECO_300019380
642,Herenthoutsesteenweg 2,2023-05-27,18:00:00,136,116,20,ECO_300019380
642,Herenthoutsesteenweg 2,2023-05-27,19:00:00,93,85,8,ECO_300019380
642,Herenthoutsesteenweg 2,2023-05-27,20:00:00,67,54,13,ECO_300019380
642,Herenthoutsesteenweg 2,2023-05-27,21:00:00,72,67,5,ECO_300019380
642,Herenthoutsesteenweg 2,2023-05-27,22:00:00,17,15,2,ECO_300019380
642,Herenthoutsesteenweg 2,2023-05-27,23:00:00,38,29,9,ECO_300019380
642,Herenthoutsesteenweg 2,2023-05-28,00:00:00,12,9,3,ECO_300019380
642,Herenthoutsesteenweg 2,2023-05-28,01:00:00,9,8,1,ECO_300019380
642,Herenthoutsesteenweg 2,2023-05-28,02:00:00,12,5,7,ECO_300019380
642,Herenthoutsesteenweg 2,2023-05-28,03:00:00,11,3,8,ECO_300019380
642,Herenthoutsesteenweg 2,2023-05-28,04:00:00,11,3,8,ECO_300019380
642,Herenthoutsesteenweg 2,2023-05-28,05:00:00,4,1,3,ECO_300019380
642,Herenthoutsesteenweg 2,2023-05-28,06:00:00,6,2,4,ECO_300019380
642,Herenthoutsesteenweg 2,2023-05-28,07:00:00,1,1,0,ECO_300019380
642,Herenthoutsesteenweg 2,2023-05-28,08:00:00,14,14,0,ECO_300019380
642,Herenthoutsesteenweg 2,2023-05-28,09:00:00,27,25,2,ECO_300019380
642,Herenthoutsesteenweg 2,2023-05-28,10:00:00,57,51,6,ECO_300019380
642,Herenthoutsesteenweg 2,2023-05-28,11:00:00,122,114,8,ECO_300019380
642,Herenthoutsesteenweg 2,2023-05-28,12:00:00,184,168,16,ECO_300019380
642,Herenthoutsesteenweg 2,2023-05-28,13:00:00,137,122,15,ECO_300019380
642,Herenthoutsesteenweg 2,2023-05-28,14:00:00,118,104,14,ECO_300019380
642,Herenthoutsesteenweg 2,2023-05-28,15:00:00,162,155,7,ECO_300019380
642,Herenthoutsesteenweg 2,2023-05-28,16:00:00,167,151,16,ECO_300019380
642,Herenthoutsesteenweg 2,2023-05-28,17:00:00,179,169,10,ECO_300019380
642,Herenthoutsesteenweg 2,2023-05-28,18:00:00,130,109,21,ECO_300019380
642,Herenthoutsesteenweg 2,2023-05-28,19:00:00,129,113,16,ECO_300019380
642,Herenthoutsesteenweg 2,2023-05-28,20:00:00,77,69,8,ECO_300019380
642,Herenthoutsesteenweg 2,2023-05-28,21:00:00,53,45,8,ECO_300019380
642,Herenthoutsesteenweg 2,2023-05-28,22:00:00,47,36,11,ECO_300019380
642,Herenthoutsesteenweg 2,2023-05-28,23:00:00,43,24,19,ECO_300019380
642,Herenthoutsesteenweg 2,2023-05-29,00:00:00,25,21,4,ECO_300019380
642,Herenthoutsesteenweg 2,2023-05-29,01:00:00,22,11,11,ECO_300019380
642,Herenthoutsesteenweg 2,2023-05-29,02:00:00,3,2,1,ECO_300019380
642,Herenthoutsesteenweg 2,2023-05-29,03:00:00,1,1,0,ECO_300019380
642,Herenthoutsesteenweg 2,2023-05-29,04:00:00,4,1,3,ECO_300019380
642,Herenthoutsesteenweg 2,2023-05-29,05:00:00,0,0,0,ECO_300019380
642,Herenthoutsesteenweg 2,2023-05-29,06:00:00,2,2,0,ECO_300019380
642,Herenthoutsesteenweg 2,2023-05-29,07:00:00,6,3,3,ECO_300019380
642,Herenthoutsesteenweg 2,2023-05-29,08:00:00,10,10,0,ECO_300019380
642,Herenthoutsesteenweg 2,2023-05-29,09:00:00,11,9,2,ECO_300019380
642,Herenthoutsesteenweg 2,2023-05-29,10:00:00,30,27,3,ECO_300019380
642,Herenthoutsesteenweg 2,2023-05-29,11:00:00,79,70,9,ECO_300019380
642,Herenthoutsesteenweg 2,2023-05-29,12:00:00,92,86,6,ECO_300019380
642,Herenthoutsesteenweg 2,2023-05-29,13:00:00,106,94,12,ECO_300019380
642,Herenthoutsesteenweg 2,2023-05-29,14:00:00,84,71,13,ECO_300019380
642,Herenthoutsesteenweg 2,2023-05-29,15:00:00,166,154,12,ECO_300019380
642,Herenthoutsesteenweg 2,2023-05-29,16:00:00,191,173,18,ECO_300019380
642,Herenthoutsesteenweg 2,2023-05-29,17:00:00,212,201,11,ECO_300019380
642,Herenthoutsesteenweg 2,2023-05-29,18:00:00,184,166,18,ECO_300019380
642,Herenthoutsesteenweg 2,2023-05-29,19:00:00,132,116,16,ECO_300019380
642,Herenthoutsesteenweg 2,2023-05-29,20:00:00,75,64,11,ECO_300019380
642,Herenthoutsesteenweg 2,2023-05-29,21:00:00,48,48,0,ECO_300019380
642,Herenthoutsesteenweg 2,2023-05-29,22:00:00,31,23,8,ECO_300019380
642,Herenthoutsesteenweg 2,2023-05-29,23:00:00,18,17,1,ECO_300019380
642,Herenthoutsesteenweg 2,2023-05-30,00:00:00,5,2,3,ECO_300019380
642,Herenthoutsesteenweg 2,2023-05-30,01:00:00,2,2,0,ECO_300019380
642,Herenthoutsesteenweg 2,2023-05-30,02:00:00,0,0,0,ECO_300019380
642,Herenthoutsesteenweg 2,2023-05-30,03:00:00,4,3,1,ECO_300019380
642,Herenthoutsesteenweg 2,2023-05-30,04:00:00,0,0,0,ECO_300019380
642,Herenthoutsesteenweg 2,2023-05-30,05:00:00,1,1,0,ECO_300019380
642,Herenthoutsesteenweg 2,2023-05-30,06:00:00,4,4,0,ECO_300019380
642,Herenthoutsesteenweg 2,2023-05-30,07:00:00,15,14,1,ECO_300019380
642,Herenthoutsesteenweg 2,2023-05-30,08:00:00,64,53,11,ECO_300019380
642,Herenthoutsesteenweg 2,2023-05-30,09:00:00,178,167,11,ECO_300019380
642,Herenthoutsesteenweg 2,2023-05-30,10:00:00,593,590,3,ECO_300019380
642,Herenthoutsesteenweg 2,2023-05-30,11:00:00,101,96,5,ECO_300019380
642,Herenthoutsesteenweg 2,2023-05-30,12:00:00,50,47,3,ECO_300019380
642,Herenthoutsesteenweg 2,2023-05-30,13:00:00,62,57,5,ECO_300019380
642,Herenthoutsesteenweg 2,2023-05-30,14:00:00,89,84,5,ECO_300019380
642,Herenthoutsesteenweg 2,2023-05-30,15:00:00,147,140,7,ECO_300019380
642,Herenthoutsesteenweg 2,2023-05-30,16:00:00,115,104,11,ECO_300019380
642,Herenthoutsesteenweg 2,2023-05-30,17:00:00,167,152,15,ECO_300019380
642,Herenthoutsesteenweg 2,2023-05-30,18:00:00,210,184,26,ECO_300019380
642,Herenthoutsesteenweg 2,2023-05-30,19:00:00,148,139,9,ECO_300019380
642,Herenthoutsesteenweg 2,2023-05-30,20:00:00,67,62,5,ECO_300019380
642,Herenthoutsesteenweg 2,2023-05-30,21:00:00,59,56,3,ECO_300019380
642,Herenthoutsesteenweg 2,2023-05-30,22:00:00,39,23,16,ECO_300019380
642,Herenthoutsesteenweg 2,2023-05-30,23:00:00,25,20,5,ECO_300019380
642,Herenthoutsesteenweg 2,2023-05-31,00:00:00,22,21,1,ECO_300019380
642,Herenthoutsesteenweg 2,2023-05-31,01:00:00,1,1,0,ECO_300019380
642,Herenthoutsesteenweg 2,2023-05-31,02:00:00,1,1,0,ECO_300019380
642,Herenthoutsesteenweg 2,2023-05-31,03:00:00,0,0,0,ECO_300019380
642,Herenthoutsesteenweg 2,2023-05-31,04:00:00,1,1,0,ECO_300019380
642,Herenthoutsesteenweg 2,2023-05-31,05:00:00,1,1,0,ECO_300019380
642,Herenthoutsesteenweg 2,2023-05-31,06:00:00,1,1,0,ECO_300019380
642,Herenthoutsesteenweg 2,2023-05-31,07:00:00,22,20,2,ECO_300019380
642,Herenthoutsesteenweg 2,2023-05-31,08:00:00,59,54,5,ECO_300019380
642,Herenthoutsesteenweg 2,2023-05-31,09:00:00,154,149,5,ECO_300019380
642,Herenthoutsesteenweg 2,2023-05-31,10:00:00,627,621,6,ECO_300019380
642,Herenthoutsesteenweg 2,2023-05-31,11:00:00,138,136,2,ECO_300019380
642,Herenthoutsesteenweg 2,2023-05-31,12:00:00,90,87,3,ECO_300019380
642,Herenthoutsesteenweg 2,2023-05-31,13:00:00,92,88,4,ECO_300019380
642,Herenthoutsesteenweg 2,2023-05-31,14:00:00,154,135,19,ECO_300019380
642,Herenthoutsesteenweg 2,2023-05-31,15:00:00,192,187,5,ECO_300019380
642,Herenthoutsesteenweg 2,2023-05-31,16:00:00,207,183,24,ECO_300019380
642,Herenthoutsesteenweg 2,2023-05-31,17:00:00,153,138,15,ECO_300019380
642,Herenthoutsesteenweg 2,2023-05-31,18:00:00,193,176,17,ECO_300019380
642,Herenthoutsesteenweg 2,2023-05-31,19:00:00,138,117,21,ECO_300019380
642,Herenthoutsesteenweg 2,2023-05-31,20:00:00,116,99,17,ECO_300019380
642,Herenthoutsesteenweg 2,2023-05-31,21:00:00,75,67,8,ECO_300019380
642,Herenthoutsesteenweg 2,2023-05-31,22:00:00,53,33,20,ECO_300019380
642,Herenthoutsesteenweg 2,2023-05-31,23:00:00,35,25,10,ECO_300019380
642,Herenthoutsesteenweg 2,2023-06-01,00:00:00,34,33,1,ECO_300019380
642,Herenthoutsesteenweg 2,2023-06-01,01:00:00,5,4,1,ECO_300019380
642,Herenthoutsesteenweg 2,2023-06-01,02:00:00,2,2,0,ECO_300019380
642,Herenthoutsesteenweg 2,2023-06-01,03:00:00,4,4,0,ECO_300019380
642,Herenthoutsesteenweg 2,2023-06-01,04:00:00,1,1,0,ECO_300019380
642,Herenthoutsesteenweg 2,2023-06-01,05:00:00,0,0,0,ECO_300019380
642,Herenthoutsesteenweg 2,2023-06-01,06:00:00,4,3,1,ECO_300019380
642,Herenthoutsesteenweg 2,2023-06-01,07:00:00,18,17,1,ECO_300019380
642,Herenthoutsesteenweg 2,2023-06-01,08:00:00,64,59,5,ECO_300019380
642,Herenthoutsesteenweg 2,2023-06-01,09:00:00,171,164,7,ECO_300019380
642,Herenthoutsesteenweg 2,2023-06-01,10:00:00,632,625,7,ECO_300019380
642,Herenthoutsesteenweg 2,2023-06-01,11:00:00,95,93,2,ECO_300019380
642,Herenthoutsesteenweg 2,2023-06-01,12:00:00,86,82,4,ECO_300019380
642,Herenthoutsesteenweg 2,2023-06-01,13:00:00,81,73,8,ECO_300019380
642,Herenthoutsesteenweg 2,2023-06-01,14:00:00,76,68,8,ECO_300019380
642,Herenthoutsesteenweg 2,2023-06-01,15:00:00,128,121,7,ECO_300019380
642,Herenthoutsesteenweg 2,2023-06-01,16:00:00,137,117,20,ECO_300019380
642,Herenthoutsesteenweg 2,2023-06-01,17:00:00,161,145,16,ECO_300019380
642,Herenthoutsesteenweg 2,2023-06-01,18:00:00,226,197,29,ECO_300019380
642,Herenthoutsesteenweg 2,2023-06-01,19:00:00,138,123,15,ECO_300019380
642,Herenthoutsesteenweg 2,2023-06-01,20:00:00,124,114,10,ECO_300019380
642,Herenthoutsesteenweg 2,2023-06-01,21:00:00,63,59,4,ECO_300019380
642,Herenthoutsesteenweg 2,2023-06-01,22:00:00,36,29,7,ECO_300019380
642,Herenthoutsesteenweg 2,2023-06-01,23:00:00,30,18,12,ECO_300019380
642,Herenthoutsesteenweg 2,2023-06-02,00:00:00,32,28,4,ECO_300019380
642,Herenthoutsesteenweg 2,2023-06-02,01:00:00,8,8,0,ECO_300019380
642,Herenthoutsesteenweg 2,2023-06-02,02:00:00,3,3,0,ECO_300019380
642,Herenthoutsesteenweg 2,2023-06-02,03:00:00,3,3,0,ECO_300019380
642,Herenthoutsesteenweg 2,2023-06-02,04:00:00,1,1,0,ECO_300019380
642,Herenthoutsesteenweg 2,2023-06-02,05:00:00,2,2,0,ECO_300019380
642,Herenthoutsesteenweg 2,2023-06-02,06:00:00,1,1,0,ECO_300019380
642,Herenthoutsesteenweg 2,2023-06-02,07:00:00,24,20,4,ECO_300019380
642,Herenthoutsesteenweg 2,2023-06-02,08:00:00,40,34,6,ECO_300019380
642,Herenthoutsesteenweg 2,2023-06-02,09:00:00,140,136,4,ECO_300019380
642,Herenthoutsesteenweg 2,2023-06-02,10:00:00,628,623,5,ECO_300019380
642,Herenthoutsesteenweg 2,2023-06-02,11:00:00,132,127,5,ECO_300019380
642,Herenthoutsesteenweg 2,2023-06-02,12:00:00,113,107,6,ECO_300019380
642,Herenthoutsesteenweg 2,2023-06-02,13:00:00,67,63,4,ECO_300019380
642,Herenthoutsesteenweg 2,2023-06-02,14:00:00,73,69,4,ECO_300019380
642,Herenthoutsesteenweg 2,2023-06-02,15:00:00,103,95,8,ECO_300019380
642,Herenthoutsesteenweg 2,2023-06-02,16:00:00,128,120,8,ECO_300019380
642,Herenthoutsesteenweg 2,2023-06-02,17:00:00,209,184,25,ECO_300019380
642,Herenthoutsesteenweg 2,2023-06-02,18:00:00,184,170,14,ECO_300019380
642,Herenthoutsesteenweg 2,2023-06-02,19:00:00,149,137,12,ECO_300019380
642,Herenthoutsesteenweg 2,2023-06-02,20:00:00,83,73,10,ECO_300019380
642,Herenthoutsesteenweg 2,2023-06-02,21:00:00,80,72,8,ECO_300019380
642,Herenthoutsesteenweg 2,2023-06-02,22:00:00,47,45,2,ECO_300019380
642,Herenthoutsesteenweg 2,2023-06-02,23:00:00,33,28,5,ECO_300019380
642,Herenthoutsesteenweg 2,2023-06-03,00:00:00,32,30,2,ECO_300019380
642,Herenthoutsesteenweg 2,2023-06-03,01:00:00,6,6,0,ECO_300019380
642,Herenthoutsesteenweg 2,2023-06-03,02:00:00,7,6,1,ECO_300019380
642,Herenthoutsesteenweg 2,2023-06-03,03:00:00,3,3,0,ECO_300019380
642,Herenthoutsesteenweg 2,2023-06-03,04:00:00,5,3,2,ECO_300019380
642,Herenthoutsesteenweg 2,2023-06-03,05:00:00,1,0,1,ECO_300019380
642,Herenthoutsesteenweg 2,2023-06-03,06:00:00,2,2,0,ECO_300019380
642,Herenthoutsesteenweg 2,2023-06-03,07:00:00,6,6,0,ECO_300019380
642,Herenthoutsesteenweg 2,2023-06-03,08:00:00,14,12,2,ECO_300019380
642,Herenthoutsesteenweg 2,2023-06-03,09:00:00,19,17,2,ECO_300019380
642,Herenthoutsesteenweg 2,2023-06-03,10:00:00,51,47,4,ECO_300019380
642,Herenthoutsesteenweg 2,2023-06-03,11:00:00,99,94,5,ECO_300019380
642,Herenthoutsesteenweg 2,2023-06-03,12:00:00,127,120,7,ECO_300019380
642,Herenthoutsesteenweg 2,2023-06-03,13:00:00,120,111,9,ECO_300019380
642,Herenthoutsesteenweg 2,2023-06-03,14:00:00,137,117,20,ECO_300019380
642,Herenthoutsesteenweg 2,2023-06-03,15:00:00,200,179,21,ECO_300019380
642,Herenthoutsesteenweg 2,2023-06-03,16:00:00,249,227,22,ECO_300019380
642,Herenthoutsesteenweg 2,2023-06-03,17:00:00,162,148,14,ECO_300019380
642,Herenthoutsesteenweg 2,2023-06-03,18:00:00,108,89,19,ECO_300019380
642,Herenthoutsesteenweg 2,2023-06-03,19:00:00,114,92,22,ECO_300019380
642,Herenthoutsesteenweg 2,2023-06-03,20:00:00,99,77,22,ECO_300019380
642,Herenthoutsesteenweg 2,2023-06-03,21:00:00,85,78,7,ECO_300019380
642,Herenthoutsesteenweg 2,2023-06-03,22:00:00,37,32,5,ECO_300019380
642,Herenthoutsesteenweg 2,2023-06-03,23:00:00,42,30,12,ECO_300019380
642,Herenthoutsesteenweg 2,2023-06-04,00:00:00,29,26,3,ECO_300019380
642,Herenthoutsesteenweg 2,2023-06-04,01:00:00,24,19,5,ECO_300019380
642,Herenthoutsesteenweg 2,2023-06-04,02:00:00,12,10,2,ECO_300019380
642,Herenthoutsesteenweg 2,2023-06-04,03:00:00,21,8,13,ECO_300019380
642,Herenthoutsesteenweg 2,2023-06-04,04:00:00,5,3,2,ECO_300019380
642,Herenthoutsesteenweg 2,2023-06-04,05:00:00,1,0,1,ECO_300019380
642,Herenthoutsesteenweg 2,2023-06-04,06:00:00,5,5,0,ECO_300019380
642,Herenthoutsesteenweg 2,2023-06-04,07:00:00,5,4,1,ECO_300019380
642,Herenthoutsesteenweg 2,2023-06-04,08:00:00,12,12,0,ECO_300019380
642,Herenthoutsesteenweg 2,2023-06-04,09:00:00,21,21,0,ECO_300019380
642,Herenthoutsesteenweg 2,2023-06-04,10:00:00,81,71,10,ECO_300019380
642,Herenthoutsesteenweg 2,2023-06-04,11:00:00,182,175,7,ECO_300019380
642,Herenthoutsesteenweg 2,2023-06-04,12:00:00,173,149,24,ECO_300019380
642,Herenthoutsesteenweg 2,2023-06-04,13:00:00,182,142,40,ECO_300019380
642,Herenthoutsesteenweg 2,2023-06-04,14:00:00,138,131,7,ECO_300019380
642,Herenthoutsesteenweg 2,2023-06-04,15:00:00,198,175,23,ECO_300019380
642,Herenthoutsesteenweg 2,2023-06-04,16:00:00,226,212,14,ECO_300019380
642,Herenthoutsesteenweg 2,2023-06-04,17:00:00,166,147,19,ECO_300019380
642,Herenthoutsesteenweg 2,2023-06-04,18:00:00,113,92,21,ECO_300019380
642,Herenthoutsesteenweg 2,2023-06-04,19:00:00,121,100,21,ECO_300019380
642,Herenthoutsesteenweg 2,2023-06-04,20:00:00,69,59,10,ECO_300019380
642,Herenthoutsesteenweg 2,2023-06-04,21:00:00,55,50,5,ECO_300019380
642,Herenthoutsesteenweg 2,2023-06-04,22:00:00,37,34,3,ECO_300019380
642,Herenthoutsesteenweg 2,2023-06-04,23:00:00,28,25,3,ECO_300019380
642,Herenthoutsesteenweg 2,2023-06-05,00:00:00,12,10,2,ECO_300019380
642,Herenthoutsesteenweg 2,2023-06-05,01:00:00,6,4,2,ECO_300019380
642,Herenthoutsesteenweg 2,2023-06-05,02:00:00,2,2,0,ECO_300019380
642,Herenthoutsesteenweg 2,2023-06-05,03:00:00,0,0,0,ECO_300019380
642,Herenthoutsesteenweg 2,2023-06-05,04:00:00,1,0,1,ECO_300019380
642,Herenthoutsesteenweg 2,2023-06-05,05:00:00,1,0,1,ECO_300019380
642,Herenthoutsesteenweg 2,2023-06-05,06:00:00,7,7,0,ECO_300019380
642,Herenthoutsesteenweg 2,2023-06-05,07:00:00,27,25,2,ECO_300019380
642,Herenthoutsesteenweg 2,2023-06-05,08:00:00,49,43,6,ECO_300019380
642,Herenthoutsesteenweg 2,2023-06-05,09:00:00,169,163,6,ECO_300019380
642,Herenthoutsesteenweg 2,2023-06-05,10:00:00,634,629,5,ECO_300019380
642,Herenthoutsesteenweg 2,2023-06-05,11:00:00,83,80,3,ECO_300019380
642,Herenthoutsesteenweg 2,2023-06-05,12:00:00,89,85,4,ECO_300019380
642,Herenthoutsesteenweg 2,2023-06-05,13:00:00,97,97,0,ECO_300019380
642,Herenthoutsesteenweg 2,2023-06-05,14:00:00,105,100,5,ECO_300019380
642,Herenthoutsesteenweg 2,2023-06-05,15:00:00,103,100,3,ECO_300019380
642,Herenthoutsesteenweg 2,2023-06-05,16:00:00,158,148,10,ECO_300019380
642,Herenthoutsesteenweg 2,2023-06-05,17:00:00,131,113,18,ECO_300019380
642,Herenthoutsesteenweg 2,2023-06-05,18:00:00,175,163,12,ECO_300019380
642,Herenthoutsesteenweg 2,2023-06-05,19:00:00,123,113,10,ECO_300019380
642,Herenthoutsesteenweg 2,2023-06-05,20:00:00,80,72,8,ECO_300019380
642,Herenthoutsesteenweg 2,2023-06-05,21:00:00,76,69,7,ECO_300019380
642,Herenthoutsesteenweg 2,2023-06-05,22:00:00,30,28,2,ECO_300019380
642,Herenthoutsesteenweg 2,2023-06-05,23:00:00,21,19,2,ECO_300019380
642,Herenthoutsesteenweg 2,2023-06-06,00:00:00,27,26,1,ECO_300019380
642,Herenthoutsesteenweg 2,2023-06-06,01:00:00,7,5,2,ECO_300019380
642,Herenthoutsesteenweg 2,2023-06-06,02:00:00,0,0,0,ECO_300019380
642,Herenthoutsesteenweg 2,2023-06-06,03:00:00,0,0,0,ECO_300019380
642,Herenthoutsesteenweg 2,2023-06-06,04:00:00,0,0,0,ECO_300019380
642,Herenthoutsesteenweg 2,2023-06-06,05:00:00,0,0,0,ECO_300019380
642,Herenthoutsesteenweg 2,2023-06-06,06:00:00,6,6,0,ECO_300019380
642,Herenthoutsesteenweg 2,2023-06-06,07:00:00,34,32,2,ECO_300019380
642,Herenthoutsesteenweg 2,2023-06-06,08:00:00,64,56,8,ECO_300019380
642,Herenthoutsesteenweg 2,2023-06-06,09:00:00,180,177,3,ECO_300019380
642,Herenthoutsesteenweg 2,2023-06-06,10:00:00,670,664,6,ECO_300019380
642,Herenthoutsesteenweg 2,2023-06-06,11:00:00,93,91,2,ECO_300019380
642,Herenthoutsesteenweg 2,2023-06-06,12:00:00,103,101,2,ECO_300019380
642,Herenthoutsesteenweg 2,2023-06-06,13:00:00,94,88,6,ECO_300019380
642,Herenthoutsesteenweg 2,2023-06-06,14:00:00,109,102,7,ECO_300019380
642,Herenthoutsesteenweg 2,2023-06-06,15:00:00,145,135,10,ECO_300019380
642,Herenthoutsesteenweg 2,2023-06-06,16:00:00,166,151,15,ECO_300019380
642,Herenthoutsesteenweg 2,2023-06-06,17:00:00,162,146,16,ECO_300019380
642,Herenthoutsesteenweg 2,2023-06-06,18:00:00,236,205,31,ECO_300019380
642,Herenthoutsesteenweg 2,2023-06-06,19:00:00,138,117,21,ECO_300019380
642,Herenthoutsesteenweg 2,2023-06-06,20:00:00,84,74,10,ECO_300019380
642,Herenthoutsesteenweg 2,2023-06-06,21:00:00,83,72,11,ECO_300019380
642,Herenthoutsesteenweg 2,2023-06-06,22:00:00,38,34,4,ECO_300019380
642,Herenthoutsesteenweg 2,2023-06-06,23:00:00,40,34,6,ECO_300019380
642,Herenthoutsesteenweg 2,2023-06-07,00:00:00,32,26,6,ECO_300019380
642,Herenthoutsesteenweg 2,2023-06-07,01:00:00,8,6,2,ECO_300019380
642,Herenthoutsesteenweg 2,2023-06-07,02:00:00,3,2,1,ECO_300019380
642,Herenthoutsesteenweg 2,2023-06-07,03:00:00,3,1,2,ECO_300019380
642,Herenthoutsesteenweg 2,2023-06-07,04:00:00,0,0,0,ECO_300019380
642,Herenthoutsesteenweg 2,2023-06-07,05:00:00,0,0,0,ECO_300019380
642,Herenthoutsesteenweg 2,2023-06-07,06:00:00,5,5,0,ECO_300019380
642,Herenthoutsesteenweg 2,2023-06-07,07:00:00,37,33,4,ECO_300019380
642,Herenthoutsesteenweg 2,2023-06-07,08:00:00,62,55,7,ECO_300019380
642,Herenthoutsesteenweg 2,2023-06-07,09:00:00,182,178,4,ECO_300019380
642,Herenthoutsesteenweg 2,2023-06-07,10:00:00,604,596,8,ECO_300019380
642,Herenthoutsesteenweg 2,2023-06-07,11:00:00,115,113,2,ECO_300019380
642,Herenthoutsesteenweg 2,2023-06-07,12:00:00,102,94,8,ECO_300019380
642,Herenthoutsesteenweg 2,2023-06-07,13:00:00,94,89,5,ECO_300019380
642,Herenthoutsesteenweg 2,2023-06-07,14:00:00,144,129,15,ECO_300019380
642,Herenthoutsesteenweg 2,2023-06-07,15:00:00,142,133,9,ECO_300019380
642,Herenthoutsesteenweg 2,2023-06-07,16:00:00,96,84,12,ECO_300019380
642,Herenthoutsesteenweg 2,2023-06-07,17:00:00,92,87,5,ECO_300019380
642,Herenthoutsesteenweg 2,2023-06-07,18:00:00,198,172,26,ECO_300019380
642,Herenthoutsesteenweg 2,2023-06-07,19:00:00,108,100,8,ECO_300019380
642,Herenthoutsesteenweg 2,2023-06-07,20:00:00,90,83,7,ECO_300019380
642,Herenthoutsesteenweg 2,2023-06-07,21:00:00,77,64,13,ECO_300019380
642,Herenthoutsesteenweg 2,2023-06-07,22:00:00,63,51,12,ECO_300019380
642,Herenthoutsesteenweg 2,2023-06-07,23:00:00,39,31,8,ECO_300019380
642,Herenthoutsesteenweg 2,2023-06-08,00:00:00,33,25,8,ECO_300019380
642,Herenthoutsesteenweg 2,2023-06-08,01:00:00,6,5,1,ECO_300019380
642,Herenthoutsesteenweg 2,2023-06-08,02:00:00,2,2,0,ECO_300019380
642,Herenthoutsesteenweg 2,2023-06-08,03:00:00,0,0,0,ECO_300019380
642,Herenthoutsesteenweg 2,2023-06-08,04:00:00,3,2,1,ECO_300019380
642,Herenthoutsesteenweg 2,2023-06-08,05:00:00,0,0,0,ECO_300019380
642,Herenthoutsesteenweg 2,2023-06-08,06:00:00,5,4,1,ECO_300019380
642,Herenthoutsesteenweg 2,2023-06-08,07:00:00,29,27,2,ECO_300019380
642,Herenthoutsesteenweg 2,2023-06-08,08:00:00,81,72,9,ECO_300019380
642,Herenthoutsesteenweg 2,2023-06-08,09:00:00,210,204,6,ECO_300019380
642,Herenthoutsesteenweg 2,2023-06-08,10:00:00,659,652,7,ECO_300019380
642,Herenthoutsesteenweg 2,2023-06-08,11:00:00,108,104,4,ECO_300019380
642,Herenthoutsesteenweg 2,2023-06-08,12:00:00,92,88,4,ECO_300019380
642,Herenthoutsesteenweg 2,2023-06-08,13:00:00,87,80,7,ECO_300019380
642,Herenthoutsesteenweg 2,2023-06-08,14:00:00,97,84,13,ECO_300019380
642,Herenthoutsesteenweg 2,2023-06-08,15:00:00,134,126,8,ECO_300019380
642,Herenthoutsesteenweg 2,2023-06-08,16:00:00,154,140,14,ECO_300019380
642,Herenthoutsesteenweg 2,2023-06-08,17:00:00,180,160,20,ECO_300019380
642,Herenthoutsesteenweg 2,2023-06-08,18:00:00,206,191,15,ECO_300019380
642,Herenthoutsesteenweg 2,2023-06-08,19:00:00,166,141,25,ECO_300019380
642,Herenthoutsesteenweg 2,2023-06-08,20:00:00,98,90,8,ECO_300019380
642,Herenthoutsesteenweg 2,2023-06-08,21:00:00,76,65,11,ECO_300019380
642,Herenthoutsesteenweg 2,2023-06-08,22:00:00,81,64,17,ECO_300019380
642,Herenthoutsesteenweg 2,2023-06-08,23:00:00,35,24,11,ECO_300019380
642,Herenthoutsesteenweg 2,2023-06-09,00:00:00,32,25,7,ECO_300019380
642,Herenthoutsesteenweg 2,2023-06-09,01:00:00,18,14,4,ECO_300019380
642,Herenthoutsesteenweg 2,2023-06-09,02:00:00,2,0,2,ECO_300019380
642,Herenthoutsesteenweg 2,2023-06-09,03:00:00,1,0,1,ECO_300019380
642,Herenthoutsesteenweg 2,2023-06-09,04:00:00,0,0,0,ECO_300019380
642,Herenthoutsesteenweg 2,2023-06-09,05:00:00,1,1,0,ECO_300019380
642,Herenthoutsesteenweg 2,2023-06-09,06:00:00,5,5,0,ECO_300019380
642,Herenthoutsesteenweg 2,2023-06-09,07:00:00,24,20,4,ECO_300019380
642,Herenthoutsesteenweg 2,2023-06-09,08:00:00,55,48,7,ECO_300019380
642,Herenthoutsesteenweg 2,2023-06-09,09:00:00,188,182,6,ECO_300019380
642,Herenthoutsesteenweg 2,2023-06-09,10:00:00,662,657,5,ECO_300019380
642,Herenthoutsesteenweg 2,2023-06-09,11:00:00,201,195,6,ECO_300019380
642,Herenthoutsesteenweg 2,2023-06-09,12:00:00,158,151,7,ECO_300019380
642,Herenthoutsesteenweg 2,2023-06-09,13:00:00,115,111,4,ECO_300019380
642,Herenthoutsesteenweg 2,2023-06-09,14:00:00,114,103,11,ECO_300019380
642,Herenthoutsesteenweg 2,2023-06-09,15:00:00,124,110,14,ECO_300019380
642,Herenthoutsesteenweg 2,2023-06-09,16:00:00,142,130,12,ECO_300019380
642,Herenthoutsesteenweg 2,2023-06-09,17:00:00,187,169,18,ECO_300019380
642,Herenthoutsesteenweg 2,2023-06-09,18:00:00,167,149,18,ECO_300019380
642,Herenthoutsesteenweg 2,2023-06-09,19:00:00,125,111,14,ECO_300019380
642,Herenthoutsesteenweg 2,2023-06-09,20:00:00,99,91,8,ECO_300019380
642,Herenthoutsesteenweg 2,2023-06-09,21:00:00,73,61,12,ECO_300019380
642,Herenthoutsesteenweg 2,2023-06-09,22:00:00,61,58,3,ECO_300019380
642,Herenthoutsesteenweg 2,2023-06-09,23:00:00,57,49,8,ECO_300019380
642,Herenthoutsesteenweg 2,2023-06-10,00:00:00,47,36,11,ECO_300019380
642,Herenthoutsesteenweg 2,2023-06-10,01:00:00,23,16,7,ECO_300019380
642,Herenthoutsesteenweg 2,2023-06-10,02:00:00,7,5,2,ECO_300019380
642,Herenthoutsesteenweg 2,2023-06-10,03:00:00,19,12,7,ECO_300019380
642,Herenthoutsesteenweg 2,2023-06-10,04:00:00,2,2,0,ECO_300019380
642,Herenthoutsesteenweg 2,2023-06-10,05:00:00,6,6,0,ECO_300019380
642,Herenthoutsesteenweg 2,2023-06-10,06:00:00,0,0,0,ECO_300019380
642,Herenthoutsesteenweg 2,2023-06-10,07:00:00,6,5,1,ECO_300019380
642,Herenthoutsesteenweg 2,2023-06-10,08:00:00,17,13,4,ECO_300019380
642,Herenthoutsesteenweg 2,2023-06-10,09:00:00,25,24,1,ECO_300019380
642,Herenthoutsesteenweg 2,2023-06-10,10:00:00,67,60,7,ECO_300019380
642,Herenthoutsesteenweg 2,2023-06-10,11:00:00,114,103,11,ECO_300019380
642,Herenthoutsesteenweg 2,2023-06-10,12:00:00,155,146,9,ECO_300019380
642,Herenthoutsesteenweg 2,2023-06-10,13:00:00,131,119,12,ECO_300019380
642,Herenthoutsesteenweg 2,2023-06-10,14:00:00,100,91,9,ECO_300019380
642,Herenthoutsesteenweg 2,2023-06-10,15:00:00,151,135,16,ECO_300019380
642,Herenthoutsesteenweg 2,2023-06-10,16:00:00,136,130,6,ECO_300019380
642,Herenthoutsesteenweg 2,2023-06-10,17:00:00,196,182,14,ECO_300019380
642,Herenthoutsesteenweg 2,2023-06-10,18:00:00,176,150,26,ECO_300019380
642,Herenthoutsesteenweg 2,2023-06-10,19:00:00,127,118,9,ECO_300019380
642,Herenthoutsesteenweg 2,2023-06-10,20:00:00,131,113,18,ECO_300019380
642,Herenthoutsesteenweg 2,2023-06-10,21:00:00,104,96,8,ECO_300019380
642,Herenthoutsesteenweg 2,2023-06-10,22:00:00,88,80,8,ECO_300019380
642,Herenthoutsesteenweg 2,2023-06-10,23:00:00,58,46,12,ECO_300019380
642,Herenthoutsesteenweg 2,2023-06-11,00:00:00,24,20,4,ECO_300019380
642,Herenthoutsesteenweg 2,2023-06-11,01:00:00,25,22,3,ECO_300019380
642,Herenthoutsesteenweg 2,2023-06-11,02:00:00,19,17,2,ECO_300019380
642,Herenthoutsesteenweg 2,2023-06-11,03:00:00,18,10,8,ECO_300019380
642,Herenthoutsesteenweg 2,2023-06-11,04:00:00,11,9,2,ECO_300019380
642,Herenthoutsesteenweg 2,2023-06-11,05:00:00,10,8,2,ECO_300019380
642,Herenthoutsesteenweg 2,2023-06-11,06:00:00,5,4,1,ECO_300019380
642,Herenthoutsesteenweg 2,2023-06-11,07:00:00,6,6,0,ECO_300019380
642,Herenthoutsesteenweg 2,2023-06-11,08:00:00,19,17,2,ECO_300019380
642,Herenthoutsesteenweg 2,2023-06-11,09:00:00,39,37,2,ECO_300019380
642,Herenthoutsesteenweg 2,2023-06-11,10:00:00,108,95,13,ECO_300019380
642,Herenthoutsesteenweg 2,2023-06-11,11:00:00,183,163,20,ECO_300019380
642,Herenthoutsesteenweg 2,2023-06-11,12:00:00,199,183,16,ECO_300019380
642,Herenthoutsesteenweg 2,2023-06-11,13:00:00,113,98,15,ECO_300019380
642,Herenthoutsesteenweg 2,2023-06-11,14:00:00,97,79,18,ECO_300019380
642,Herenthoutsesteenweg 2,2023-06-11,15:00:00,100,90,10,ECO_300019380
642,Herenthoutsesteenweg 2,2023-06-11,16:00:00,97,83,14,ECO_300019380
642,Herenthoutsesteenweg 2,2023-06-11,17:00:00,108,95,13,ECO_300019380
642,Herenthoutsesteenweg 2,2023-06-11,18:00:00,72,55,17,ECO_300019380
642,Herenthoutsesteenweg 2,2023-06-11,19:00:00,66,64,2,ECO_300019380
642,Herenthoutsesteenweg 2,2023-06-11,20:00:00,47,43,4,ECO_300019380
642,Herenthoutsesteenweg 2,2023-06-11,21:00:00,34,29,5,ECO_300019380
642,Herenthoutsesteenweg 2,2023-06-11,22:00:00,43,40,3,ECO_300019380
642,Herenthoutsesteenweg 2,2023-06-11,23:00:00,34,28,6,ECO_300019380
642,Herenthoutsesteenweg 2,2023-06-12,00:00:00,17,13,4,ECO_300019380
642,Herenthoutsesteenweg 2,2023-06-12,01:00:00,8,4,4,ECO_300019380
642,Herenthoutsesteenweg 2,2023-06-12,02:00:00,2,2,0,ECO_300019380
642,Herenthoutsesteenweg 2,2023-06-12,03:00:00,3,1,2,ECO_300019380
642,Herenthoutsesteenweg 2,2023-06-12,04:00:00,0,0,0,ECO_300019380
642,Herenthoutsesteenweg 2,2023-06-12,05:00:00,1,1,0,ECO_300019380
642,Herenthoutsesteenweg 2,2023-06-12,06:00:00,2,2,0,ECO_300019380
642,Herenthoutsesteenweg 2,2023-06-12,07:00:00,25,25,0,ECO_300019380
642,Herenthoutsesteenweg 2,2023-06-12,08:00:00,65,61,4,ECO_300019380
642,Herenthoutsesteenweg 2,2023-06-12,09:00:00,191,183,8,ECO_300019380
642,Herenthoutsesteenweg 2,2023-06-12,10:00:00,601,592,9,ECO_300019380
642,Herenthoutsesteenweg 2,2023-06-12,11:00:00,122,117,5,ECO_300019380
642,Herenthoutsesteenweg 2,2023-06-12,12:00:00,89,87,2,ECO_300019380
642,Herenthoutsesteenweg 2,2023-06-12,13:00:00,81,73,8,ECO_300019380
642,Herenthoutsesteenweg 2,2023-06-12,14:00:00,90,79,11,ECO_300019380
642,Herenthoutsesteenweg 2,2023-06-12,15:00:00,103,93,10,ECO_300019380
642,Herenthoutsesteenweg 2,2023-06-12,16:00:00,108,97,11,ECO_300019380
642,Herenthoutsesteenweg 2,2023-06-12,17:00:00,147,134,13,ECO_300019380
642,Herenthoutsesteenweg 2,2023-06-12,18:00:00,175,162,13,ECO_300019380
642,Herenthoutsesteenweg 2,2023-06-12,19:00:00,123,110,13,ECO_300019380
642,Herenthoutsesteenweg 2,2023-06-12,20:00:00,95,84,11,ECO_300019380
642,Herenthoutsesteenweg 2,2023-06-12,21:00:00,69,62,7,ECO_300019380
642,Herenthoutsesteenweg 2,2023-06-12,22:00:00,44,38,6,ECO_300019380
642,Herenthoutsesteenweg 2,2023-06-12,23:00:00,18,17,1,ECO_300019380
642,Herenthoutsesteenweg 2,2023-06-13,00:00:00,25,24,1,ECO_300019380
642,Herenthoutsesteenweg 2,2023-06-13,01:00:00,10,7,3,ECO_300019380
642,Herenthoutsesteenweg 2,2023-06-13,02:00:00,0,0,0,ECO_300019380
642,Herenthoutsesteenweg 2,2023-06-13,03:00:00,3,3,0,ECO_300019380
642,Herenthoutsesteenweg 2,2023-06-13,04:00:00,1,0,1,ECO_300019380
642,Herenthoutsesteenweg 2,2023-06-13,05:00:00,0,0,0,ECO_300019380
642,Herenthoutsesteenweg 2,2023-06-13,06:00:00,3,3,0,ECO_300019380
642,Herenthoutsesteenweg 2,2023-06-13,07:00:00,32,29,3,ECO_300019380
642,Herenthoutsesteenweg 2,2023-06-13,08:00:00,80,74,6,ECO_300019380
642,Herenthoutsesteenweg 2,2023-06-13,09:00:00,237,231,6,ECO_300019380
642,Herenthoutsesteenweg 2,2023-06-13,10:00:00,616,608,8,ECO_300019380
642,Herenthoutsesteenweg 2,2023-06-13,11:00:00,160,154,6,ECO_300019380
642,Herenthoutsesteenweg 2,2023-06-13,12:00:00,131,123,8,ECO_300019380
642,Herenthoutsesteenweg 2,2023-06-13,13:00:00,93,83,10,ECO_300019380
642,Herenthoutsesteenweg 2,2023-06-13,14:00:00,89,84,5,ECO_300019380
642,Herenthoutsesteenweg 2,2023-06-13,15:00:00,111,106,5,ECO_300019380
642,Herenthoutsesteenweg 2,2023-06-13,16:00:00,142,133,9,ECO_300019380
642,Herenthoutsesteenweg 2,2023-06-13,17:00:00,175,161,14,ECO_300019380
642,Herenthoutsesteenweg 2,2023-06-13,18:00:00,174,164,10,ECO_300019380
642,Herenthoutsesteenweg 2,2023-06-13,19:00:00,122,112,10,ECO_300019380
642,Herenthoutsesteenweg 2,2023-06-13,20:00:00,124,111,13,ECO_300019380
642,Herenthoutsesteenweg 2,2023-06-13,21:00:00,82,75,7,ECO_300019380
642,Herenthoutsesteenweg 2,2023-06-13,22:00:00,62,51,11,ECO_300019380
642,Herenthoutsesteenweg 2,2023-06-13,23:00:00,42,34,8,ECO_300019380
642,Herenthoutsesteenweg 2,2023-06-14,00:00:00,30,27,3,ECO_300019380
642,Herenthoutsesteenweg 2,2023-06-14,01:00:00,10,6,4,ECO_300019380
642,Herenthoutsesteenweg 2,2023-06-14,02:00:00,1,0,1,ECO_300019380
642,Herenthoutsesteenweg 2,2023-06-14,03:00:00,3,1,2,ECO_300019380
642,Herenthoutsesteenweg 2,2023-06-14,04:00:00,1,1,0,ECO_300019380
642,Herenthoutsesteenweg 2,2023-06-14,05:00:00,1,0,1,ECO_300019380
642,Herenthoutsesteenweg 2,2023-06-14,06:00:00,2,1,1,ECO_300019380
642,Herenthoutsesteenweg 2,2023-06-14,07:00:00,39,35,4,ECO_300019380
642,Herenthoutsesteenweg 2,2023-06-14,08:00:00,68,60,8,ECO_300019380
642,Herenthoutsesteenweg 2,2023-06-14,09:00:00,215,211,4,ECO_300019380
642,Herenthoutsesteenweg 2,2023-06-14,10:00:00,569,567,2,ECO_300019380
642,Herenthoutsesteenweg 2,2023-06-14,11:00:00,151,140,11,ECO_300019380
642,Herenthoutsesteenweg 2,2023-06-14,12:00:00,124,118,6,ECO_300019380
642,Herenthoutsesteenweg 2,2023-06-14,13:00:00,104,93,11,ECO_300019380
642,Herenthoutsesteenweg 2,2023-06-14,14:00:00,182,169,13,ECO_300019380
642,Herenthoutsesteenweg 2,2023-06-14,15:00:00,126,119,7,ECO_300019380
642,Herenthoutsesteenweg 2,2023-06-14,16:00:00,121,111,10,ECO_300019380
642,Herenthoutsesteenweg 2,2023-06-14,17:00:00,112,99,13,ECO_300019380
642,Herenthoutsesteenweg 2,2023-06-14,18:00:00,191,168,23,ECO_300019380
642,Herenthoutsesteenweg 2,2023-06-14,19:00:00,135,113,22,ECO_300019380
642,Herenthoutsesteenweg 2,2023-06-14,20:00:00,130,109,21,ECO_300019380
642,Herenthoutsesteenweg 2,2023-06-14,21:00:00,88,76,12,ECO_300019380
642,Herenthoutsesteenweg 2,2023-06-14,22:00:00,72,43,29,ECO_300019380
642,Herenthoutsesteenweg 2,2023-06-14,23:00:00,46,40,6,ECO_300019380
642,Herenthoutsesteenweg 2,2023-06-15,00:00:00,34,30,4,ECO_300019380
642,Herenthoutsesteenweg 2,2023-06-15,01:00:00,8,8,0,ECO_300019380
642,Herenthoutsesteenweg 2,2023-06-15,02:00:00,5,3,2,ECO_300019380
642,Herenthoutsesteenweg 2,2023-06-15,03:00:00,2,1,1,ECO_300019380
642,Herenthoutsesteenweg 2,2023-06-15,04:00:00,1,0,1,ECO_300019380
642,Herenthoutsesteenweg 2,2023-06-15,05:00:00,0,0,0,ECO_300019380
642,Herenthoutsesteenweg 2,2023-06-15,06:00:00,1,1,0,ECO_300019380
642,Herenthoutsesteenweg 2,2023-06-15,07:00:00,29,25,4,ECO_300019380
642,Herenthoutsesteenweg 2,2023-06-15,08:00:00,78,75,3,ECO_300019380
642,Herenthoutsesteenweg 2,2023-06-15,09:00:00,240,229,11,ECO_300019380
642,Herenthoutsesteenweg 2,2023-06-15,10:00:00,618,616,2,ECO_300019380
642,Herenthoutsesteenweg 2,2023-06-15,11:00:00,131,126,5,ECO_300019380
642,Herenthoutsesteenweg 2,2023-06-15,12:00:00,122,117,5,ECO_300019380
642,Herenthoutsesteenweg 2,2023-06-15,13:00:00,112,100,12,ECO_300019380
642,Herenthoutsesteenweg 2,2023-06-15,14:00:00,92,87,5,ECO_300019380
642,Herenthoutsesteenweg 2,2023-06-15,15:00:00,122,116,6,ECO_300019380
642,Herenthoutsesteenweg 2,2023-06-15,16:00:00,141,126,15,ECO_300019380
642,Herenthoutsesteenweg 2,2023-06-15,17:00:00,183,167,16,ECO_300019380
642,Herenthoutsesteenweg 2,2023-06-15,18:00:00,176,153,23,ECO_300019380
642,Herenthoutsesteenweg 2,2023-06-15,19:00:00,130,119,11,ECO_300019380
642,Herenthoutsesteenweg 2,2023-06-15,20:00:00,103,90,13,ECO_300019380
642,Herenthoutsesteenweg 2,2023-06-15,21:00:00,80,71,9,ECO_300019380
642,Herenthoutsesteenweg 2,2023-06-15,22:00:00,57,44,13,ECO_300019380
642,Herenthoutsesteenweg 2,2023-06-15,23:00:00,35,27,8,ECO_300019380
642,Herenthoutsesteenweg 2,2023-06-16,00:00:00,35,33,2,ECO_300019380
642,Herenthoutsesteenweg 2,2023-06-16,01:00:00,8,6,2,ECO_300019380
642,Herenthoutsesteenweg 2,2023-06-16,02:00:00,2,2,0,ECO_300019380
642,Herenthoutsesteenweg 2,2023-06-16,03:00:00,5,2,3,ECO_300019380
642,Herenthoutsesteenweg 2,2023-06-16,04:00:00,3,3,0,ECO_300019380
642,Herenthoutsesteenweg 2,2023-06-16,05:00:00,1,1,0,ECO_300019380
642,Herenthoutsesteenweg 2,2023-06-16,06:00:00,0,0,0,ECO_300019380
642,Herenthoutsesteenweg 2,2023-06-16,07:00:00,28,25,3,ECO_300019380
642,Herenthoutsesteenweg 2,2023-06-16,08:00:00,43,41,2,ECO_300019380
642,Herenthoutsesteenweg 2,2023-06-16,09:00:00,197,191,6,ECO_300019380
642,Herenthoutsesteenweg 2,2023-06-16,10:00:00,519,514,5,ECO_300019380
642,Herenthoutsesteenweg 2,2023-06-16,11:00:00,240,236,4,ECO_300019380
642,Herenthoutsesteenweg 2,2023-06-16,12:00:00,173,168,5,ECO_300019380
642,Herenthoutsesteenweg 2,2023-06-16,13:00:00,110,101,9,ECO_300019380
642,Herenthoutsesteenweg 2,2023-06-16,14:00:00,125,115,10,ECO_300019380
642,Herenthoutsesteenweg 2,2023-06-16,15:00:00,135,126,9,ECO_300019380
642,Herenthoutsesteenweg 2,2023-06-16,16:00:00,148,137,11,ECO_300019380
642,Herenthoutsesteenweg 2,2023-06-16,17:00:00,195,179,16,ECO_300019380
642,Herenthoutsesteenweg 2,2023-06-16,18:00:00,199,170,29,ECO_300019380
642,Herenthoutsesteenweg 2,2023-06-16,19:00:00,133,116,17,ECO_300019380
642,Herenthoutsesteenweg 2,2023-06-16,20:00:00,111,95,16,ECO_300019380
642,Herenthoutsesteenweg 2,2023-06-16,21:00:00,112,93,19,ECO_300019380
642,Herenthoutsesteenweg 2,2023-06-16,22:00:00,60,52,8,ECO_300019380
642,Herenthoutsesteenweg 2,2023-06-16,23:00:00,56,49,7,ECO_300019380
642,Herenthoutsesteenweg 2,2023-06-17,00:00:00,34,28,6,ECO_300019380
642,Herenthoutsesteenweg 2,2023-06-17,01:00:00,17,14,3,ECO_300019380
642,Herenthoutsesteenweg 2,2023-06-17,02:00:00,17,10,7,ECO_300019380
642,Herenthoutsesteenweg 2,2023-06-17,03:00:00,8,6,2,ECO_300019380
642,Herenthoutsesteenweg 2,2023-06-17,04:00:00,2,2,0,ECO_300019380
642,Herenthoutsesteenweg 2,2023-06-17,05:00:00,1,0,1,ECO_300019380
642,Herenthoutsesteenweg 2,2023-06-17,06:00:00,3,3,0,ECO_300019380
642,Herenthoutsesteenweg 2,2023-06-17,07:00:00,6,5,1,ECO_300019380
642,Herenthoutsesteenweg 2,2023-06-17,08:00:00,29,28,1,ECO_300019380
642,Herenthoutsesteenweg 2,2023-06-17,09:00:00,30,28,2,ECO_300019380
642,Herenthoutsesteenweg 2,2023-06-17,10:00:00,70,69,1,ECO_300019380
642,Herenthoutsesteenweg 2,2023-06-17,11:00:00,124,115,9,ECO_300019380
642,Herenthoutsesteenweg 2,2023-06-17,12:00:00,144,139,5,ECO_300019380
642,Herenthoutsesteenweg 2,2023-06-17,13:00:00,143,125,18,ECO_300019380
642,Herenthoutsesteenweg 2,2023-06-17,14:00:00,110,98,12,ECO_300019380
642,Herenthoutsesteenweg 2,2023-06-17,15:00:00,146,133,13,ECO_300019380
642,Herenthoutsesteenweg 2,2023-06-17,16:00:00,129,109,20,ECO_300019380
642,Herenthoutsesteenweg 2,2023-06-17,17:00:00,133,114,19,ECO_300019380
642,Herenthoutsesteenweg 2,2023-06-17,18:00:00,89,79,10,ECO_300019380
642,Herenthoutsesteenweg 2,2023-06-17,19:00:00,93,69,24,ECO_300019380
642,Herenthoutsesteenweg 2,2023-06-17,20:00:00,64,57,7,ECO_300019380
642,Herenthoutsesteenweg 2,2023-06-17,21:00:00,61,55,6,ECO_300019380
642,Herenthoutsesteenweg 2,2023-06-17,22:00:00,68,56,12,ECO_300019380
642,Herenthoutsesteenweg 2,2023-06-17,23:00:00,30,29,1,ECO_300019380
642,Herenthoutsesteenweg 2,2023-06-18,00:00:00,22,18,4,ECO_300019380
642,Herenthoutsesteenweg 2,2023-06-18,01:00:00,16,12,4,ECO_300019380
642,Herenthoutsesteenweg 2,2023-06-18,02:00:00,17,15,2,ECO_300019380
642,Herenthoutsesteenweg 2,2023-06-18,03:00:00,11,7,4,ECO_300019380
642,Herenthoutsesteenweg 2,2023-06-18,04:00:00,6,6,0,ECO_300019380
642,Herenthoutsesteenweg 2,2023-06-18,05:00:00,5,5,0,ECO_300019380
642,Herenthoutsesteenweg 2,2023-06-18,06:00:00,2,1,1,ECO_300019380
642,Herenthoutsesteenweg 2,2023-06-18,07:00:00,4,4,0,ECO_300019380
642,Herenthoutsesteenweg 2,2023-06-18,08:00:00,12,11,1,ECO_300019380
642,Herenthoutsesteenweg 2,2023-06-18,09:00:00,21,19,2,ECO_300019380
642,Herenthoutsesteenweg 2,2023-06-18,10:00:00,59,50,9,ECO_300019380
642,Herenthoutsesteenweg 2,2023-06-18,11:00:00,130,125,5,ECO_300019380
642,Herenthoutsesteenweg 2,2023-06-18,12:00:00,80,74,6,ECO_300019380
642,Herenthoutsesteenweg 2,2023-06-18,13:00:00,54,41,13,ECO_300019380
642,Herenthoutsesteenweg 2,2023-06-18,14:00:00,39,31,8,ECO_300019380
642,Herenthoutsesteenweg 2,2023-06-18,15:00:00,45,35,10,ECO_300019380
642,Herenthoutsesteenweg 2,2023-06-18,16:00:00,62,58,4,ECO_300019380
642,Herenthoutsesteenweg 2,2023-06-18,17:00:00,53,50,3,ECO_300019380
642,Herenthoutsesteenweg 2,2023-06-18,18:00:00,62,53,9,ECO_300019380
642,Herenthoutsesteenweg 2,2023-06-18,19:00:00,64,59,5,ECO_300019380
642,Herenthoutsesteenweg 2,2023-06-18,20:00:00,21,18,3,ECO_300019380
642,Herenthoutsesteenweg 2,2023-06-18,21:00:00,28,21,7,ECO_300019380
642,Herenthoutsesteenweg 2,2023-06-18,22:00:00,29,25,4,ECO_300019380
642,Herenthoutsesteenweg 2,2023-06-18,23:00:00,23,20,3,ECO_300019380
642,Herenthoutsesteenweg 2,2023-06-19,00:00:00,6,6,0,ECO_300019380
642,Herenthoutsesteenweg 2,2023-06-19,01:00:00,6,3,3,ECO_300019380
642,Herenthoutsesteenweg 2,2023-06-19,02:00:00,4,0,4,ECO_300019380
642,Herenthoutsesteenweg 2,2023-06-19,03:00:00,2,2,0,ECO_300019380
642,Herenthoutsesteenweg 2,2023-06-19,04:00:00,1,1,0,ECO_300019380
642,Herenthoutsesteenweg 2,2023-06-19,05:00:00,3,3,0,ECO_300019380
642,Herenthoutsesteenweg 2,2023-06-19,06:00:00,2,2,0,ECO_300019380
642,Herenthoutsesteenweg 2,2023-06-19,07:00:00,22,20,2,ECO_300019380
642,Herenthoutsesteenweg 2,2023-06-19,08:00:00,52,45,7,ECO_300019380
642,Herenthoutsesteenweg 2,2023-06-19,09:00:00,214,208,6,ECO_300019380
642,Herenthoutsesteenweg 2,2023-06-19,10:00:00,511,505,6,ECO_300019380
642,Herenthoutsesteenweg 2,2023-06-19,11:00:00,102,100,2,ECO_300019380
642,Herenthoutsesteenweg 2,2023-06-19,12:00:00,116,111,5,ECO_300019380
642,Herenthoutsesteenweg 2,2023-06-19,13:00:00,94,90,4,ECO_300019380
642,Herenthoutsesteenweg 2,2023-06-19,14:00:00,118,113,5,ECO_300019380
642,Herenthoutsesteenweg 2,2023-06-19,15:00:00,123,115,8,ECO_300019380
642,Herenthoutsesteenweg 2,2023-06-19,16:00:00,130,121,9,ECO_300019380
642,Herenthoutsesteenweg 2,2023-06-19,17:00:00,154,144,10,ECO_300019380
642,Herenthoutsesteenweg 2,2023-06-19,18:00:00,191,178,13,ECO_300019380
642,Herenthoutsesteenweg 2,2023-06-19,19:00:00,110,97,13,ECO_300019380
642,Herenthoutsesteenweg 2,2023-06-19,20:00:00,91,82,9,ECO_300019380
642,Herenthoutsesteenweg 2,2023-06-19,21:00:00,68,60,8,ECO_300019380
642,Herenthoutsesteenweg 2,2023-06-19,22:00:00,42,36,6,ECO_300019380
642,Herenthoutsesteenweg 2,2023-06-19,23:00:00,37,36,1,ECO_300019380
642,Herenthoutsesteenweg 2,2023-06-20,00:00:00,17,13,4,ECO_300019380
642,Herenthoutsesteenweg 2,2023-06-20,01:00:00,11,7,4,ECO_300019380
642,Herenthoutsesteenweg 2,2023-06-20,02:00:00,5,2,3,ECO_300019380
642,Herenthoutsesteenweg 2,2023-06-20,03:00:00,3,2,1,ECO_300019380
642,Herenthoutsesteenweg 2,2023-06-20,04:00:00,1,1,0,ECO_300019380
642,Herenthoutsesteenweg 2,2023-06-20,05:00:00,0,0,0,ECO_300019380
642,Herenthoutsesteenweg 2,2023-06-20,06:00:00,3,3,0,ECO_300019380
642,Herenthoutsesteenweg 2,2023-06-20,07:00:00,35,31,4,ECO_300019380
642,Herenthoutsesteenweg 2,2023-06-20,08:00:00,55,48,7,ECO_300019380
642,Herenthoutsesteenweg 2,2023-06-20,09:00:00,213,208,5,ECO_300019380
642,Herenthoutsesteenweg 2,2023-06-20,10:00:00,538,533,5,ECO_300019380
642,Herenthoutsesteenweg 2,2023-06-20,11:00:00,128,122,6,ECO_300019380
642,Herenthoutsesteenweg 2,2023-06-20,12:00:00,137,131,6,ECO_300019380
642,Herenthoutsesteenweg 2,2023-06-20,13:00:00,107,98,9,ECO_300019380
642,Herenthoutsesteenweg 2,2023-06-20,14:00:00,96,89,7,ECO_300019380
642,Herenthoutsesteenweg 2,2023-06-20,15:00:00,116,104,12,ECO_300019380
642,Herenthoutsesteenweg 2,2023-06-20,16:00:00,103,96,7,ECO_300019380
642,Herenthoutsesteenweg 2,2023-06-20,17:00:00,133,111,22,ECO_300019380
642,Herenthoutsesteenweg 2,2023-06-20,18:00:00,149,137,12,ECO_300019380
642,Herenthoutsesteenweg 2,2023-06-20,19:00:00,69,62,7,ECO_300019380
642,Herenthoutsesteenweg 2,2023-06-20,20:00:00,39,38,1,ECO_300019380
642,Herenthoutsesteenweg 2,2023-06-20,21:00:00,38,30,8,ECO_300019380
642,Herenthoutsesteenweg 2,2023-06-20,22:00:00,18,15,3,ECO_300019380
642,Herenthoutsesteenweg 2,2023-06-20,23:00:00,11,8,3,ECO_300019380
642,Herenthoutsesteenweg 2,2023-06-21,00:00:00,9,5,4,ECO_300019380
642,Herenthoutsesteenweg 2,2023-06-21,01:00:00,6,4,2,ECO_300019380
642,Herenthoutsesteenweg 2,2023-06-21,02:00:00,0,0,0,ECO_300019380
642,Herenthoutsesteenweg 2,2023-06-21,03:00:00,0,0,0,ECO_300019380
642,Herenthoutsesteenweg 2,2023-06-21,04:00:00,1,0,1,ECO_300019380
642,Herenthoutsesteenweg 2,2023-06-21,05:00:00,0,0,0,ECO_300019380
642,Herenthoutsesteenweg 2,2023-06-21,06:00:00,4,4,0,ECO_300019380
642,Herenthoutsesteenweg 2,2023-06-21,07:00:00,34,27,7,ECO_300019380
642,Herenthoutsesteenweg 2,2023-06-21,08:00:00,53,46,7,ECO_300019380
642,Herenthoutsesteenweg 2,2023-06-21,09:00:00,229,222,7,ECO_300019380
642,Herenthoutsesteenweg 2,2023-06-21,10:00:00,434,427,7,ECO_300019380
642,Herenthoutsesteenweg 2,2023-06-21,11:00:00,188,186,2,ECO_300019380
642,Herenthoutsesteenweg 2,2023-06-21,12:00:00,194,188,6,ECO_300019380
642,Herenthoutsesteenweg 2,2023-06-21,13:00:00,92,85,7,ECO_300019380
642,Herenthoutsesteenweg 2,2023-06-21,14:00:00,131,126,5,ECO_300019380
642,Herenthoutsesteenweg 2,2023-06-21,15:00:00,146,138,8,ECO_300019380
642,Herenthoutsesteenweg 2,2023-06-21,16:00:00,157,147,10,ECO_300019380
642,Herenthoutsesteenweg 2,2023-06-21,17:00:00,112,102,10,ECO_300019380
642,Herenthoutsesteenweg 2,2023-06-21,18:00:00,159,146,13,ECO_300019380
642,Herenthoutsesteenweg 2,2023-06-21,19:00:00,137,126,11,ECO_300019380
642,Herenthoutsesteenweg 2,2023-06-21,20:00:00,114,101,13,ECO_300019380
642,Herenthoutsesteenweg 2,2023-06-21,21:00:00,93,80,13,ECO_300019380
642,Herenthoutsesteenweg 2,2023-06-21,22:00:00,75,62,13,ECO_300019380
642,Herenthoutsesteenweg 2,2023-06-21,23:00:00,67,51,16,ECO_300019380
642,Herenthoutsesteenweg 2,2023-06-22,00:00:00,31,30,1,ECO_300019380
642,Herenthoutsesteenweg 2,2023-06-22,01:00:00,11,7,4,ECO_300019380
642,Herenthoutsesteenweg 2,2023-06-22,02:00:00,3,3,0,ECO_300019380
642,Herenthoutsesteenweg 2,2023-06-22,03:00:00,1,1,0,ECO_300019380
642,Herenthoutsesteenweg 2,2023-06-22,04:00:00,0,0,0,ECO_300019380
642,Herenthoutsesteenweg 2,2023-06-22,05:00:00,1,1,0,ECO_300019380
642,Herenthoutsesteenweg 2,2023-06-22,06:00:00,1,1,0,ECO_300019380
642,Herenthoutsesteenweg 2,2023-06-22,07:00:00,22,19,3,ECO_300019380
642,Herenthoutsesteenweg 2,2023-06-22,08:00:00,49,41,8,ECO_300019380
642,Herenthoutsesteenweg 2,2023-06-22,09:00:00,177,171,6,ECO_300019380
642,Herenthoutsesteenweg 2,2023-06-22,10:00:00,441,429,12,ECO_300019380
642,Herenthoutsesteenweg 2,2023-06-22,11:00:00,73,69,4,ECO_300019380
642,Herenthoutsesteenweg 2,2023-06-22,12:00:00,67,61,6,ECO_300019380
642,Herenthoutsesteenweg 2,2023-06-22,13:00:00,50,44,6,ECO_300019380
642,Herenthoutsesteenweg 2,2023-06-22,14:00:00,36,32,4,ECO_300019380
642,Herenthoutsesteenweg 2,2023-06-22,15:00:00,16,16,0,ECO_300019380
642,Herenthoutsesteenweg 2,2023-06-22,16:00:00,34,32,2,ECO_300019380
642,Herenthoutsesteenweg 2,2023-06-22,17:00:00,37,31,6,ECO_300019380
642,Herenthoutsesteenweg 2,2023-06-22,18:00:00,63,56,7,ECO_300019380
642,Herenthoutsesteenweg 2,2023-06-22,19:00:00,26,24,2,ECO_300019380
642,Herenthoutsesteenweg 2,2023-06-22,20:00:00,10,8,2,ECO_300019380
642,Herenthoutsesteenweg 2,2023-06-22,21:00:00,21,19,2,ECO_300019380
642,Herenthoutsesteenweg 2,2023-06-22,22:00:00,4,1,3,ECO_300019380
642,Herenthoutsesteenweg 2,2023-06-22,23:00:00,10,9,1,ECO_300019380
642,Herenthoutsesteenweg 2,2023-06-23,00:00:00,15,13,2,ECO_300019380
642,Herenthoutsesteenweg 2,2023-06-23,01:00:00,4,3,1,ECO_300019380
642,Herenthoutsesteenweg 2,2023-06-23,02:00:00,3,1,2,ECO_300019380
642,Herenthoutsesteenweg 2,2023-06-23,03:00:00,0,0,0,ECO_300019380
642,Herenthoutsesteenweg 2,2023-06-23,04:00:00,0,0,0,ECO_300019380
642,Herenthoutsesteenweg 2,2023-06-23,05:00:00,0,0,0,ECO_300019380
642,Herenthoutsesteenweg 2,2023-06-23,06:00:00,4,4,0,ECO_300019380
642,Herenthoutsesteenweg 2,2023-06-23,07:00:00,28,24,4,ECO_300019380
642,Herenthoutsesteenweg 2,2023-06-23,08:00:00,38,35,3,ECO_300019380
642,Herenthoutsesteenweg 2,2023-06-23,09:00:00,176,169,7,ECO_300019380
642,Herenthoutsesteenweg 2,2023-06-23,10:00:00,422,409,13,ECO_300019380
642,Herenthoutsesteenweg 2,2023-06-23,11:00:00,218,211,7,ECO_300019380
642,Herenthoutsesteenweg 2,2023-06-23,12:00:00,182,174,8,ECO_300019380
642,Herenthoutsesteenweg 2,2023-06-23,13:00:00,147,141,6,ECO_300019380
642,Herenthoutsesteenweg 2,2023-06-23,14:00:00,114,103,11,ECO_300019380
642,Herenthoutsesteenweg 2,2023-06-23,15:00:00,134,126,8,ECO_300019380
642,Herenthoutsesteenweg 2,2023-06-23,16:00:00,162,146,16,ECO_300019380
642,Herenthoutsesteenweg 2,2023-06-23,17:00:00,182,169,13,ECO_300019380
642,Herenthoutsesteenweg 2,2023-06-23,18:00:00,204,192,12,ECO_300019380
642,Herenthoutsesteenweg 2,2023-06-23,19:00:00,130,112,18,ECO_300019380
642,Herenthoutsesteenweg 2,2023-06-23,20:00:00,93,83,10,ECO_300019380
642,Herenthoutsesteenweg 2,2023-06-23,21:00:00,84,70,14,ECO_300019380
642,Herenthoutsesteenweg 2,2023-06-23,22:00:00,60,52,8,ECO_300019380
642,Herenthoutsesteenweg 2,2023-06-23,23:00:00,41,35,6,ECO_300019380
642,Herenthoutsesteenweg 2,2023-06-24,00:00:00,53,42,11,ECO_300019380
642,Herenthoutsesteenweg 2,2023-06-24,01:00:00,20,13,7,ECO_300019380
642,Herenthoutsesteenweg 2,2023-06-24,02:00:00,11,6,5,ECO_300019380
642,Herenthoutsesteenweg 2,2023-06-24,03:00:00,15,10,5,ECO_300019380
642,Herenthoutsesteenweg 2,2023-06-24,04:00:00,5,2,3,ECO_300019380
642,Herenthoutsesteenweg 2,2023-06-24,05:00:00,1,0,1,ECO_300019380
642,Herenthoutsesteenweg 2,2023-06-24,06:00:00,1,1,0,ECO_300019380
642,Herenthoutsesteenweg 2,2023-06-24,07:00:00,5,4,1,ECO_300019380
642,Herenthoutsesteenweg 2,2023-06-24,08:00:00,20,16,4,ECO_300019380
642,Herenthoutsesteenweg 2,2023-06-24,09:00:00,15,13,2,ECO_300019380
642,Herenthoutsesteenweg 2,2023-06-24,10:00:00,70,66,4,ECO_300019380
642,Herenthoutsesteenweg 2,2023-06-24,11:00:00,98,93,5,ECO_300019380
642,Herenthoutsesteenweg 2,2023-06-24,12:00:00,142,131,11,ECO_300019380
642,Herenthoutsesteenweg 2,2023-06-24,13:00:00,151,129,22,ECO_300019380
642,Herenthoutsesteenweg 2,2023-06-24,14:00:00,125,113,12,ECO_300019380
642,Herenthoutsesteenweg 2,2023-06-24,15:00:00,205,198,7,ECO_300019380
642,Herenthoutsesteenweg 2,2023-06-24,16:00:00,167,144,23,ECO_300019380
642,Herenthoutsesteenweg 2,2023-06-24,17:00:00,141,124,17,ECO_300019380
642,Herenthoutsesteenweg 2,2023-06-24,18:00:00,145,124,21,ECO_300019380
642,Herenthoutsesteenweg 2,2023-06-24,19:00:00,94,85,9,ECO_300019380
642,Herenthoutsesteenweg 2,2023-06-24,20:00:00,88,83,5,ECO_300019380
642,Herenthoutsesteenweg 2,2023-06-24,21:00:00,70,64,6,ECO_300019380
642,Herenthoutsesteenweg 2,2023-06-24,22:00:00,53,46,7,ECO_300019380
642,Herenthoutsesteenweg 2,2023-06-24,23:00:00,60,55,5,ECO_300019380
642,Herenthoutsesteenweg 2,2023-06-25,00:00:00,40,40,0,ECO_300019380
642,Herenthoutsesteenweg 2,2023-06-25,01:00:00,30,20,10,ECO_300019380
642,Herenthoutsesteenweg 2,2023-06-25,02:00:00,17,13,4,ECO_300019380
642,Herenthoutsesteenweg 2,2023-06-25,03:00:00,16,11,5,ECO_300019380
642,Herenthoutsesteenweg 2,2023-06-25,04:00:00,6,4,2,ECO_300019380
642,Herenthoutsesteenweg 2,2023-06-25,05:00:00,3,0,3,ECO_300019380
642,Herenthoutsesteenweg 2,2023-06-25,06:00:00,1,1,0,ECO_300019380
642,Herenthoutsesteenweg 2,2023-06-25,07:00:00,1,1,0,ECO_300019380
642,Herenthoutsesteenweg 2,2023-06-25,08:00:00,13,13,0,ECO_300019380
642,Herenthoutsesteenweg 2,2023-06-25,09:00:00,50,45,5,ECO_300019380
642,Herenthoutsesteenweg 2,2023-06-25,10:00:00,130,124,6,ECO_300019380
642,Herenthoutsesteenweg 2,2023-06-25,11:00:00,198,177,21,ECO_300019380
642,Herenthoutsesteenweg 2,2023-06-25,12:00:00,153,142,11,ECO_300019380
642,Herenthoutsesteenweg 2,2023-06-25,13:00:00,136,114,22,ECO_300019380
642,Herenthoutsesteenweg 2,2023-06-25,14:00:00,92,83,9,ECO_300019380
642,Herenthoutsesteenweg 2,2023-06-25,15:00:00,140,134,6,ECO_300019380
642,Herenthoutsesteenweg 2,2023-06-25,16:00:00,99,78,21,ECO_300019380
642,Herenthoutsesteenweg 2,2023-06-25,17:00:00,74,72,2,ECO_300019380
642,Herenthoutsesteenweg 2,2023-06-25,18:00:00,90,81,9,ECO_300019380
642,Herenthoutsesteenweg 2,2023-06-25,19:00:00,71,63,8,ECO_300019380
642,Herenthoutsesteenweg 2,2023-06-25,20:00:00,74,65,9,ECO_300019380
642,Herenthoutsesteenweg 2,2023-06-25,21:00:00,57,52,5,ECO_300019380
642,Herenthoutsesteenweg 2,2023-06-25,22:00:00,78,71,7,ECO_300019380
642,Herenthoutsesteenweg 2,2023-06-25,23:00:00,34,29,5,ECO_300019380
642,Herenthoutsesteenweg 2,2023-06-26,00:00:00,38,36,2,ECO_300019380
642,Herenthoutsesteenweg 2,2023-06-26,01:00:00,10,10,0,ECO_300019380
642,Herenthoutsesteenweg 2,2023-06-26,02:00:00,5,4,1,ECO_300019380
642,Herenthoutsesteenweg 2,2023-06-26,03:00:00,6,4,2,ECO_300019380
642,Herenthoutsesteenweg 2,2023-06-26,04:00:00,0,0,0,ECO_300019380
642,Herenthoutsesteenweg 2,2023-06-26,05:00:00,2,1,1,ECO_300019380
642,Herenthoutsesteenweg 2,2023-06-26,06:00:00,3,3,0,ECO_300019380
642,Herenthoutsesteenweg 2,2023-06-26,07:00:00,26,22,4,ECO_300019380
642,Herenthoutsesteenweg 2,2023-06-26,08:00:00,52,50,2,ECO_300019380
642,Herenthoutsesteenweg 2,2023-06-26,09:00:00,157,149,8,ECO_300019380
642,Herenthoutsesteenweg 2,2023-06-26,10:00:00,163,156,7,ECO_300019380
642,Herenthoutsesteenweg 2,2023-06-26,11:00:00,124,119,5,ECO_300019380
642,Herenthoutsesteenweg 2,2023-06-26,12:00:00,69,67,2,ECO_300019380
642,Herenthoutsesteenweg 2,2023-06-26,13:00:00,140,129,11,ECO_300019380
642,Herenthoutsesteenweg 2,2023-06-26,14:00:00,96,83,13,ECO_300019380
642,Herenthoutsesteenweg 2,2023-06-26,15:00:00,159,155,4,ECO_300019380
642,Herenthoutsesteenweg 2,2023-06-26,16:00:00,189,180,9,ECO_300019380
642,Herenthoutsesteenweg 2,2023-06-26,17:00:00,188,179,9,ECO_300019380
642,Herenthoutsesteenweg 2,2023-06-26,18:00:00,194,176,18,ECO_300019380
642,Herenthoutsesteenweg 2,2023-06-26,19:00:00,135,123,12,ECO_300019380
642,Herenthoutsesteenweg 2,2023-06-26,20:00:00,87,81,6,ECO_300019380
642,Herenthoutsesteenweg 2,2023-06-26,21:00:00,97,93,4,ECO_300019380
642,Herenthoutsesteenweg 2,2023-06-26,22:00:00,50,46,4,ECO_300019380
642,Herenthoutsesteenweg 2,2023-06-26,23:00:00,47,38,9,ECO_300019380
642,Herenthoutsesteenweg 2,2023-06-27,00:00:00,36,32,4,ECO_300019380
642,Herenthoutsesteenweg 2,2023-06-27,01:00:00,14,10,4,ECO_300019380
642,Herenthoutsesteenweg 2,2023-06-27,02:00:00,5,2,3,ECO_300019380
642,Herenthoutsesteenweg 2,2023-06-27,03:00:00,6,1,5,ECO_300019380
642,Herenthoutsesteenweg 2,2023-06-27,04:00:00,5,2,3,ECO_300019380
642,Herenthoutsesteenweg 2,2023-06-27,05:00:00,1,1,0,ECO_300019380
642,Herenthoutsesteenweg 2,2023-06-27,06:00:00,3,3,0,ECO_300019380
642,Herenthoutsesteenweg 2,2023-06-27,07:00:00,31,28,3,ECO_300019380
642,Herenthoutsesteenweg 2,2023-06-27,08:00:00,78,71,7,ECO_300019380
642,Herenthoutsesteenweg 2,2023-06-27,09:00:00,141,130,11,ECO_300019380
642,Herenthoutsesteenweg 2,2023-06-27,10:00:00,172,169,3,ECO_300019380
642,Herenthoutsesteenweg 2,2023-06-27,11:00:00,115,110,5,ECO_300019380
642,Herenthoutsesteenweg 2,2023-06-27,12:00:00,104,99,5,ECO_300019380
642,Herenthoutsesteenweg 2,2023-06-27,13:00:00,99,89,10,ECO_300019380
642,Herenthoutsesteenweg 2,2023-06-27,14:00:00,112,105,7,ECO_300019380
642,Herenthoutsesteenweg 2,2023-06-27,15:00:00,136,126,10,ECO_300019380
642,Herenthoutsesteenweg 2,2023-06-27,16:00:00,171,164,7,ECO_300019380
642,Herenthoutsesteenweg 2,2023-06-27,17:00:00,217,192,25,ECO_300019380
642,Herenthoutsesteenweg 2,2023-06-27,18:00:00,185,166,19,ECO_300019380
642,Herenthoutsesteenweg 2,2023-06-27,19:00:00,143,135,8,ECO_300019380
642,Herenthoutsesteenweg 2,2023-06-27,20:00:00,105,84,21,ECO_300019380
642,Herenthoutsesteenweg 2,2023-06-27,21:00:00,76,71,5,ECO_300019380
642,Herenthoutsesteenweg 2,2023-06-27,22:00:00,59,46,13,ECO_300019380
642,Herenthoutsesteenweg 2,2023-06-27,23:00:00,41,37,4,ECO_300019380
642,Herenthoutsesteenweg 2,2023-06-28,00:00:00,42,38,4,ECO_300019380
642,Herenthoutsesteenweg 2,2023-06-28,01:00:00,13,13,0,ECO_300019380
642,Herenthoutsesteenweg 2,2023-06-28,02:00:00,8,6,2,ECO_300019380
642,Herenthoutsesteenweg 2,2023-06-28,03:00:00,5,4,1,ECO_300019380
642,Herenthoutsesteenweg 2,2023-06-28,04:00:00,0,0,0,ECO_300019380
642,Herenthoutsesteenweg 2,2023-06-28,05:00:00,0,0,0,ECO_300019380
642,Herenthoutsesteenweg 2,2023-06-28,06:00:00,4,3,1,ECO_300019380
642,Herenthoutsesteenweg 2,2023-06-28,07:00:00,27,21,6,ECO_300019380
642,Herenthoutsesteenweg 2,2023-06-28,08:00:00,60,55,5,ECO_300019380
642,Herenthoutsesteenweg 2,2023-06-28,09:00:00,112,106,6,ECO_300019380
642,Herenthoutsesteenweg 2,2023-06-28,10:00:00,117,115,2,ECO_300019380
642,Herenthoutsesteenweg 2,2023-06-28,11:00:00,92,90,2,ECO_300019380
642,Herenthoutsesteenweg 2,2023-06-28,12:00:00,81,76,5,ECO_300019380
642,Herenthoutsesteenweg 2,2023-06-28,13:00:00,76,71,5,ECO_300019380
642,Herenthoutsesteenweg 2,2023-06-28,14:00:00,157,148,9,ECO_300019380
642,Herenthoutsesteenweg 2,2023-06-28,15:00:00,182,167,15,ECO_300019380
642,Herenthoutsesteenweg 2,2023-06-28,16:00:00,179,164,15,ECO_300019380
642,Herenthoutsesteenweg 2,2023-06-28,17:00:00,161,148,13,ECO_300019380
642,Herenthoutsesteenweg 2,2023-06-28,18:00:00,154,145,9,ECO_300019380
642,Herenthoutsesteenweg 2,2023-06-28,19:00:00,154,134,20,ECO_300019380
642,Herenthoutsesteenweg 2,2023-06-28,20:00:00,103,95,8,ECO_300019380
642,Herenthoutsesteenweg 2,2023-06-28,21:00:00,96,84,12,ECO_300019380
642,Herenthoutsesteenweg 2,2023-06-28,22:00:00,65,53,12,ECO_300019380
642,Herenthoutsesteenweg 2,2023-06-28,23:00:00,48,37,11,ECO_300019380
642,Herenthoutsesteenweg 2,2023-06-29,00:00:00,46,35,11,ECO_300019380
642,Herenthoutsesteenweg 2,2023-06-29,01:00:00,12,10,2,ECO_300019380
642,Herenthoutsesteenweg 2,2023-06-29,02:00:00,11,6,5,ECO_300019380
642,Herenthoutsesteenweg 2,2023-06-29,03:00:00,9,6,3,ECO_300019380
642,Herenthoutsesteenweg 2,2023-06-29,04:00:00,1,0,1,ECO_300019380
642,Herenthoutsesteenweg 2,2023-06-29,05:00:00,1,1,0,ECO_300019380
642,Herenthoutsesteenweg 2,2023-06-29,06:00:00,2,2,0,ECO_300019380
642,Herenthoutsesteenweg 2,2023-06-29,07:00:00,25,22,3,ECO_300019380
642,Herenthoutsesteenweg 2,2023-06-29,08:00:00,48,43,5,ECO_300019380
642,Herenthoutsesteenweg 2,2023-06-29,09:00:00,116,109,7,ECO_300019380
642,Herenthoutsesteenweg 2,2023-06-29,10:00:00,194,185,9,ECO_300019380
642,Herenthoutsesteenweg 2,2023-06-29,11:00:00,149,146,3,ECO_300019380
642,Herenthoutsesteenweg 2,2023-06-29,12:00:00,96,87,9,ECO_300019380
642,Herenthoutsesteenweg 2,2023-06-29,13:00:00,64,59,5,ECO_300019380
642,Herenthoutsesteenweg 2,2023-06-29,14:00:00,83,77,6,ECO_300019380
642,Herenthoutsesteenweg 2,2023-06-29,15:00:00,149,144,5,ECO_300019380
642,Herenthoutsesteenweg 2,2023-06-29,16:00:00,156,143,13,ECO_300019380
642,Herenthoutsesteenweg 2,2023-06-29,17:00:00,206,191,15,ECO_300019380
642,Herenthoutsesteenweg 2,2023-06-29,18:00:00,158,142,16,ECO_300019380
642,Herenthoutsesteenweg 2,2023-06-29,19:00:00,118,110,8,ECO_300019380
642,Herenthoutsesteenweg 2,2023-06-29,20:00:00,103,88,15,ECO_300019380
642,Herenthoutsesteenweg 2,2023-06-29,21:00:00,99,88,11,ECO_300019380
642,Herenthoutsesteenweg 2,2023-06-29,22:00:00,43,35,8,ECO_300019380
642,Herenthoutsesteenweg 2,2023-06-29,23:00:00,26,19,7,ECO_300019380
642,Herenthoutsesteenweg 2,2023-06-30,00:00:00,28,23,5,ECO_300019380
642,Herenthoutsesteenweg 2,2023-06-30,01:00:00,7,6,1,ECO_300019380
642,Herenthoutsesteenweg 2,2023-06-30,02:00:00,8,5,3,ECO_300019380
642,Herenthoutsesteenweg 2,2023-06-30,03:00:00,0,0,0,ECO_300019380
642,Herenthoutsesteenweg 2,2023-06-30,04:00:00,2,1,1,ECO_300019380
642,Herenthoutsesteenweg 2,2023-06-30,05:00:00,0,0,0,ECO_300019380
642,Herenthoutsesteenweg 2,2023-06-30,06:00:00,2,2,0,ECO_300019380
642,Herenthoutsesteenweg 2,2023-06-30,07:00:00,24,22,2,ECO_300019380
642,Herenthoutsesteenweg 2,2023-06-30,08:00:00,37,35,2,ECO_300019380
642,Herenthoutsesteenweg 2,2023-06-30,09:00:00,107,97,10,ECO_300019380
642,Herenthoutsesteenweg 2,2023-06-30,10:00:00,214,209,5,ECO_300019380
642,Herenthoutsesteenweg 2,2023-06-30,11:00:00,182,177,5,ECO_300019380
642,Herenthoutsesteenweg 2,2023-06-30,12:00:00,173,161,12,ECO_300019380
642,Herenthoutsesteenweg 2,2023-06-30,13:00:00,114,106,8,ECO_300019380
642,Herenthoutsesteenweg 2,2023-06-30,14:00:00,183,176,7,ECO_300019380
642,Herenthoutsesteenweg 2,2023-06-30,15:00:00,163,151,12,ECO_300019380
642,Herenthoutsesteenweg 2,2023-06-30,16:00:00,187,170,17,ECO_300019380
642,Herenthoutsesteenweg 2,2023-06-30,17:00:00,154,139,15,ECO_300019380
642,Herenthoutsesteenweg 2,2023-06-30,18:00:00,196,166,30,ECO_300019380
642,Herenthoutsesteenweg 2,2023-06-30,19:00:00,139,129,10,ECO_300019380
642,Herenthoutsesteenweg 2,2023-06-30,20:00:00,117,100,17,ECO_300019380
642,Herenthoutsesteenweg 2,2023-06-30,21:00:00,86,76,10,ECO_300019380
642,Herenthoutsesteenweg 2,2023-06-30,22:00:00,51,45,6,ECO_300019380
642,Herenthoutsesteenweg 2,2023-06-30,23:00:00,43,31,12,ECO_300019380
642,Herenthoutsesteenweg 2,2023-07-01,00:00:00,26,16,10,ECO_300019380
642,Herenthoutsesteenweg 2,2023-07-01,01:00:00,22,16,6,ECO_300019380
642,Herenthoutsesteenweg 2,2023-07-01,02:00:00,16,14,2,ECO_300019380
642,Herenthoutsesteenweg 2,2023-07-01,03:00:00,11,9,2,ECO_300019380
642,Herenthoutsesteenweg 2,2023-07-01,04:00:00,9,2,7,ECO_300019380
642,Herenthoutsesteenweg 2,2023-07-01,05:00:00,3,2,1,ECO_300019380
642,Herenthoutsesteenweg 2,2023-07-01,06:00:00,1,0,1,ECO_300019380
642,Herenthoutsesteenweg 2,2023-07-01,07:00:00,3,2,1,ECO_300019380
642,Herenthoutsesteenweg 2,2023-07-01,08:00:00,9,8,1,ECO_300019380
642,Herenthoutsesteenweg 2,2023-07-01,09:00:00,11,10,1,ECO_300019380
642,Herenthoutsesteenweg 2,2023-07-01,10:00:00,29,28,1,ECO_300019380
642,Herenthoutsesteenweg 2,2023-07-01,11:00:00,18,16,2,ECO_300019380
642,Herenthoutsesteenweg 2,2023-07-01,12:00:00,36,35,1,ECO_300019380
642,Herenthoutsesteenweg 2,2023-07-01,13:00:00,34,30,4,ECO_300019380
642,Herenthoutsesteenweg 2,2023-07-01,14:00:00,44,39,5,ECO_300019380
642,Herenthoutsesteenweg 2,2023-07-01,15:00:00,75,74,1,ECO_300019380
642,Herenthoutsesteenweg 2,2023-07-01,16:00:00,120,114,6,ECO_300019380
642,Herenthoutsesteenweg 2,2023-07-01,17:00:00,50,44,6,ECO_300019380
642,Herenthoutsesteenweg 2,2023-07-01,18:00:00,68,54,14,ECO_300019380
642,Herenthoutsesteenweg 2,2023-07-01,19:00:00,46,45,1,ECO_300019380
642,Herenthoutsesteenweg 2,2023-07-01,20:00:00,35,32,3,ECO_300019380
642,Herenthoutsesteenweg 2,2023-07-01,21:00:00,42,32,10,ECO_300019380
642,Herenthoutsesteenweg 2,2023-07-01,22:00:00,38,35,3,ECO_300019380
642,Herenthoutsesteenweg 2,2023-07-01,23:00:00,27,25,2,ECO_300019380
642,Herenthoutsesteenweg 2,2023-07-02,00:00:00,18,14,4,ECO_300019380
642,Herenthoutsesteenweg 2,2023-07-02,01:00:00,22,14,8,ECO_300019380
642,Herenthoutsesteenweg 2,2023-07-02,02:00:00,7,6,1,ECO_300019380
642,Herenthoutsesteenweg 2,2023-07-02,03:00:00,2,1,1,ECO_300019380
642,Herenthoutsesteenweg 2,2023-07-02,04:00:00,9,8,1,ECO_300019380
642,Herenthoutsesteenweg 2,2023-07-02,05:00:00,2,0,2,ECO_300019380
642,Herenthoutsesteenweg 2,2023-07-02,06:00:00,0,0,0,ECO_300019380
642,Herenthoutsesteenweg 2,2023-07-02,07:00:00,3,3,0,ECO_300019380
642,Herenthoutsesteenweg 2,2023-07-02,08:00:00,13,13,0,ECO_300019380
642,Herenthoutsesteenweg 2,2023-07-02,09:00:00,21,21,0,ECO_300019380
642,Herenthoutsesteenweg 2,2023-07-02,10:00:00,58,48,10,ECO_300019380
642,Herenthoutsesteenweg 2,2023-07-02,11:00:00,103,94,9,ECO_300019380
642,Herenthoutsesteenweg 2,2023-07-02,12:00:00,144,127,17,ECO_300019380
642,Herenthoutsesteenweg 2,2023-07-02,13:00:00,106,94,12,ECO_300019380
642,Herenthoutsesteenweg 2,2023-07-02,14:00:00,74,62,12,ECO_300019380
642,Herenthoutsesteenweg 2,2023-07-02,15:00:00,113,102,11,ECO_300019380
642,Herenthoutsesteenweg 2,2023-07-02,16:00:00,136,124,12,ECO_300019380
642,Herenthoutsesteenweg 2,2023-07-02,17:00:00,132,118,14,ECO_300019380
642,Herenthoutsesteenweg 2,2023-07-02,18:00:00,83,80,3,ECO_300019380
642,Herenthoutsesteenweg 2,2023-07-02,19:00:00,64,53,11,ECO_300019380
642,Herenthoutsesteenweg 2,2023-07-02,20:00:00,65,57,8,ECO_300019380
642,Herenthoutsesteenweg 2,2023-07-02,21:00:00,48,41,7,ECO_300019380
642,Herenthoutsesteenweg 2,2023-07-02,22:00:00,33,29,4,ECO_300019380
642,Herenthoutsesteenweg 2,2023-07-02,23:00:00,23,19,4,ECO_300019380
642,Herenthoutsesteenweg 2,2023-07-03,00:00:00,11,7,4,ECO_300019380
642,Herenthoutsesteenweg 2,2023-07-03,01:00:00,9,8,1,ECO_300019380
642,Herenthoutsesteenweg 2,2023-07-03,02:00:00,3,3,0,ECO_300019380
642,Herenthoutsesteenweg 2,2023-07-03,03:00:00,3,2,1,ECO_300019380
642,Herenthoutsesteenweg 2,2023-07-03,04:00:00,0,0,0,ECO_300019380
642,Herenthoutsesteenweg 2,2023-07-03,05:00:00,0,0,0,ECO_300019380
642,Herenthoutsesteenweg 2,2023-07-03,06:00:00,4,4,0,ECO_300019380
642,Herenthoutsesteenweg 2,2023-07-03,07:00:00,27,24,3,ECO_300019380
642,Herenthoutsesteenweg 2,2023-07-03,08:00:00,45,43,2,ECO_300019380
642,Herenthoutsesteenweg 2,2023-07-03,09:00:00,100,93,7,ECO_300019380
642,Herenthoutsesteenweg 2,2023-07-03,10:00:00,102,98,4,ECO_300019380
642,Herenthoutsesteenweg 2,2023-07-03,11:00:00,100,94,6,ECO_300019380
642,Herenthoutsesteenweg 2,2023-07-03,12:00:00,75,74,1,ECO_300019380
642,Herenthoutsesteenweg 2,2023-07-03,13:00:00,73,63,10,ECO_300019380
642,Herenthoutsesteenweg 2,2023-07-03,14:00:00,70,63,7,ECO_300019380
642,Herenthoutsesteenweg 2,2023-07-03,15:00:00,99,92,7,ECO_300019380
642,Herenthoutsesteenweg 2,2023-07-03,16:00:00,114,105,9,ECO_300019380
642,Herenthoutsesteenweg 2,2023-07-03,17:00:00,102,93,9,ECO_300019380
642,Herenthoutsesteenweg 2,2023-07-03,18:00:00,123,113,10,ECO_300019380
642,Herenthoutsesteenweg 2,2023-07-03,19:00:00,105,98,7,ECO_300019380
642,Herenthoutsesteenweg 2,2023-07-03,20:00:00,58,50,8,ECO_300019380
642,Herenthoutsesteenweg 2,2023-07-03,21:00:00,53,44,9,ECO_300019380
642,Herenthoutsesteenweg 2,2023-07-03,22:00:00,29,28,1,ECO_300019380
642,Herenthoutsesteenweg 2,2023-07-03,23:00:00,29,20,9,ECO_300019380
642,Herenthoutsesteenweg 2,2023-07-04,00:00:00,18,14,4,ECO_300019380
642,Herenthoutsesteenweg 2,2023-07-04,01:00:00,9,3,6,ECO_300019380
642,Herenthoutsesteenweg 2,2023-07-04,02:00:00,4,4,0,ECO_300019380
642,Herenthoutsesteenweg 2,2023-07-04,03:00:00,2,2,0,ECO_300019380
642,Herenthoutsesteenweg 2,2023-07-04,04:00:00,0,0,0,ECO_300019380
642,Herenthoutsesteenweg 2,2023-07-04,05:00:00,0,0,0,ECO_300019380
642,Herenthoutsesteenweg 2,2023-07-04,06:00:00,5,5,0,ECO_300019380
642,Herenthoutsesteenweg 2,2023-07-04,07:00:00,29,25,4,ECO_300019380
642,Herenthoutsesteenweg 2,2023-07-04,08:00:00,60,56,4,ECO_300019380
642,Herenthoutsesteenweg 2,2023-07-04,09:00:00,98,95,3,ECO_300019380
642,Herenthoutsesteenweg 2,2023-07-04,10:00:00,101,95,6,ECO_300019380
642,Herenthoutsesteenweg 2,2023-07-04,11:00:00,80,79,1,ECO_300019380
642,Herenthoutsesteenweg 2,2023-07-04,12:00:00,94,88,6,ECO_300019380
642,Herenthoutsesteenweg 2,2023-07-04,13:00:00,80,67,13,ECO_300019380
642,Herenthoutsesteenweg 2,2023-07-04,14:00:00,99,95,4,ECO_300019380
642,Herenthoutsesteenweg 2,2023-07-04,15:00:00,116,110,6,ECO_300019380
642,Herenthoutsesteenweg 2,2023-07-04,16:00:00,136,133,3,ECO_300019380
642,Herenthoutsesteenweg 2,2023-07-04,17:00:00,113,105,8,ECO_300019380
642,Herenthoutsesteenweg 2,2023-07-04,18:00:00,134,118,16,ECO_300019380
642,Herenthoutsesteenweg 2,2023-07-04,19:00:00,97,87,10,ECO_300019380
642,Herenthoutsesteenweg 2,2023-07-04,20:00:00,55,43,12,ECO_300019380
642,Herenthoutsesteenweg 2,2023-07-04,21:00:00,46,44,2,ECO_300019380
642,Herenthoutsesteenweg 2,2023-07-04,22:00:00,27,17,10,ECO_300019380
642,Herenthoutsesteenweg 2,2023-07-04,23:00:00,25,23,2,ECO_300019380
642,Herenthoutsesteenweg 2,2023-07-05,00:00:00,20,14,6,ECO_300019380
642,Herenthoutsesteenweg 2,2023-07-05,01:00:00,6,2,4,ECO_300019380
642,Herenthoutsesteenweg 2,2023-07-05,02:00:00,1,0,1,ECO_300019380
642,Herenthoutsesteenweg 2,2023-07-05,03:00:00,3,2,1,ECO_300019380
642,Herenthoutsesteenweg 2,2023-07-05,04:00:00,0,0,0,ECO_300019380
642,Herenthoutsesteenweg 2,2023-07-05,05:00:00,0,0,0,ECO_300019380
642,Herenthoutsesteenweg 2,2023-07-05,06:00:00,1,1,0,ECO_300019380
642,Herenthoutsesteenweg 2,2023-07-05,07:00:00,15,13,2,ECO_300019380
642,Herenthoutsesteenweg 2,2023-07-05,08:00:00,43,37,6,ECO_300019380
642,Herenthoutsesteenweg 2,2023-07-05,09:00:00,56,53,3,ECO_300019380
642,Herenthoutsesteenweg 2,2023-07-05,10:00:00,64,62,2,ECO_300019380
642,Herenthoutsesteenweg 2,2023-07-05,11:00:00,46,44,2,ECO_300019380
642,Herenthoutsesteenweg 2,2023-07-05,12:00:00,43,43,0,ECO_300019380
642,Herenthoutsesteenweg 2,2023-07-05,13:00:00,36,33,3,ECO_300019380
642,Herenthoutsesteenweg 2,2023-07-05,14:00:00,58,56,2,ECO_300019380
642,Herenthoutsesteenweg 2,2023-07-05,15:00:00,54,53,1,ECO_300019380
642,Herenthoutsesteenweg 2,2023-07-05,16:00:00,70,65,5,ECO_300019380
642,Herenthoutsesteenweg 2,2023-07-05,17:00:00,66,63,3,ECO_300019380
642,Herenthoutsesteenweg 2,2023-07-05,18:00:00,86,75,11,ECO_300019380
642,Herenthoutsesteenweg 2,2023-07-05,19:00:00,49,43,6,ECO_300019380
642,Herenthoutsesteenweg 2,2023-07-05,20:00:00,37,32,5,ECO_300019380
642,Herenthoutsesteenweg 2,2023-07-05,21:00:00,19,11,8,ECO_300019380
642,Herenthoutsesteenweg 2,2023-07-05,22:00:00,14,14,0,ECO_300019380
642,Herenthoutsesteenweg 2,2023-07-05,23:00:00,12,8,4,ECO_300019380
642,Herenthoutsesteenweg 2,2023-07-06,00:00:00,15,14,1,ECO_300019380
642,Herenthoutsesteenweg 2,2023-07-06,01:00:00,1,1,0,ECO_300019380
642,Herenthoutsesteenweg 2,2023-07-06,02:00:00,5,3,2,ECO_300019380
642,Herenthoutsesteenweg 2,2023-07-06,03:00:00,2,1,1,ECO_300019380
642,Herenthoutsesteenweg 2,2023-07-06,04:00:00,0,0,0,ECO_300019380
642,Herenthoutsesteenweg 2,2023-07-06,05:00:00,0,0,0,ECO_300019380
642,Herenthoutsesteenweg 2,2023-07-06,06:00:00,5,5,0,ECO_300019380
642,Herenthoutsesteenweg 2,2023-07-06,07:00:00,20,17,3,ECO_300019380
642,Herenthoutsesteenweg 2,2023-07-06,08:00:00,50,49,1,ECO_300019380
642,Herenthoutsesteenweg 2,2023-07-06,09:00:00,95,91,4,ECO_300019380
642,Herenthoutsesteenweg 2,2023-07-06,10:00:00,109,103,6,ECO_300019380
642,Herenthoutsesteenweg 2,2023-07-06,11:00:00,101,99,2,ECO_300019380
642,Herenthoutsesteenweg 2,2023-07-06,12:00:00,85,78,7,ECO_300019380
642,Herenthoutsesteenweg 2,2023-07-06,13:00:00,91,87,4,ECO_300019380
642,Herenthoutsesteenweg 2,2023-07-06,14:00:00,92,87,5,ECO_300019380
642,Herenthoutsesteenweg 2,2023-07-06,15:00:00,129,122,7,ECO_300019380
642,Herenthoutsesteenweg 2,2023-07-06,16:00:00,160,147,13,ECO_300019380
642,Herenthoutsesteenweg 2,2023-07-06,17:00:00,120,109,11,ECO_300019380
642,Herenthoutsesteenweg 2,2023-07-06,18:00:00,153,136,17,ECO_300019380
642,Herenthoutsesteenweg 2,2023-07-06,19:00:00,129,115,14,ECO_300019380
642,Herenthoutsesteenweg 2,2023-07-06,20:00:00,81,66,15,ECO_300019380
642,Herenthoutsesteenweg 2,2023-07-06,21:00:00,64,57,7,ECO_300019380
642,Herenthoutsesteenweg 2,2023-07-06,22:00:00,53,49,4,ECO_300019380
642,Herenthoutsesteenweg 2,2023-07-06,23:00:00,36,31,5,ECO_300019380
642,Herenthoutsesteenweg 2,2023-07-07,00:00:00,19,18,1,ECO_300019380
642,Herenthoutsesteenweg 2,2023-07-07,01:00:00,8,5,3,ECO_300019380
642,Herenthoutsesteenweg 2,2023-07-07,02:00:00,11,7,4,ECO_300019380
642,Herenthoutsesteenweg 2,2023-07-07,03:00:00,13,1,12,ECO_300019380
642,Herenthoutsesteenweg 2,2023-07-07,04:00:00,6,5,1,ECO_300019380
642,Herenthoutsesteenweg 2,2023-07-07,05:00:00,2,0,2,ECO_300019380
642,Herenthoutsesteenweg 2,2023-07-07,06:00:00,5,5,0,ECO_300019380
642,Herenthoutsesteenweg 2,2023-07-07,07:00:00,21,19,2,ECO_300019380
642,Herenthoutsesteenweg 2,2023-07-07,08:00:00,48,46,2,ECO_300019380
642,Herenthoutsesteenweg 2,2023-07-07,09:00:00,98,93,5,ECO_300019380
642,Herenthoutsesteenweg 2,2023-07-07,10:00:00,146,142,4,ECO_300019380
642,Herenthoutsesteenweg 2,2023-07-07,11:00:00,193,187,6,ECO_300019380
642,Herenthoutsesteenweg 2,2023-07-07,12:00:00,181,172,9,ECO_300019380
642,Herenthoutsesteenweg 2,2023-07-07,13:00:00,145,130,15,ECO_300019380
642,Herenthoutsesteenweg 2,2023-07-07,14:00:00,120,115,5,ECO_300019380
642,Herenthoutsesteenweg 2,2023-07-07,15:00:00,138,129,9,ECO_300019380
642,Herenthoutsesteenweg 2,2023-07-07,16:00:00,151,139,12,ECO_300019380
642,Herenthoutsesteenweg 2,2023-07-07,17:00:00,146,133,13,ECO_300019380
642,Herenthoutsesteenweg 2,2023-07-07,18:00:00,135,121,14,ECO_300019380
642,Herenthoutsesteenweg 2,2023-07-07,19:00:00,122,113,9,ECO_300019380
642,Herenthoutsesteenweg 2,2023-07-07,20:00:00,109,90,19,ECO_300019380
642,Herenthoutsesteenweg 2,2023-07-07,21:00:00,81,75,6,ECO_300019380
642,Herenthoutsesteenweg 2,2023-07-07,22:00:00,68,60,8,ECO_300019380
642,Herenthoutsesteenweg 2,2023-07-07,23:00:00,49,41,8,ECO_300019380
642,Herenthoutsesteenweg 2,2023-07-08,00:00:00,30,25,5,ECO_300019380
642,Herenthoutsesteenweg 2,2023-07-08,01:00:00,7,7,0,ECO_300019380
642,Herenthoutsesteenweg 2,2023-07-08,02:00:00,13,11,2,ECO_300019380
642,Herenthoutsesteenweg 2,2023-07-08,03:00:00,10,6,4,ECO_300019380
642,Herenthoutsesteenweg 2,2023-07-08,04:00:00,12,9,3,ECO_300019380
642,Herenthoutsesteenweg 2,2023-07-08,05:00:00,5,3,2,ECO_300019380
642,Herenthoutsesteenweg 2,2023-07-08,06:00:00,1,1,0,ECO_300019380
642,Herenthoutsesteenweg 2,2023-07-08,07:00:00,9,8,1,ECO_300019380
642,Herenthoutsesteenweg 2,2023-07-08,08:00:00,25,24,1,ECO_300019380
642,Herenthoutsesteenweg 2,2023-07-08,09:00:00,29,25,4,ECO_300019380
642,Herenthoutsesteenweg 2,2023-07-08,10:00:00,66,62,4,ECO_300019380
642,Herenthoutsesteenweg 2,2023-07-08,11:00:00,115,108,7,ECO_300019380
642,Herenthoutsesteenweg 2,2023-07-08,12:00:00,132,122,10,ECO_300019380
642,Herenthoutsesteenweg 2,2023-07-08,13:00:00,143,135,8,ECO_300019380
642,Herenthoutsesteenweg 2,2023-07-08,14:00:00,117,97,20,ECO_300019380
642,Herenthoutsesteenweg 2,2023-07-08,15:00:00,135,121,14,ECO_300019380
642,Herenthoutsesteenweg 2,2023-07-08,16:00:00,95,91,4,ECO_300019380
642,Herenthoutsesteenweg 2,2023-07-08,17:00:00,112,100,12,ECO_300019380
642,Herenthoutsesteenweg 2,2023-07-08,18:00:00,70,67,3,ECO_300019380
642,Herenthoutsesteenweg 2,2023-07-08,19:00:00,55,46,9,ECO_300019380
642,Herenthoutsesteenweg 2,2023-07-08,20:00:00,92,74,18,ECO_300019380
642,Herenthoutsesteenweg 2,2023-07-08,21:00:00,67,58,9,ECO_300019380
642,Herenthoutsesteenweg 2,2023-07-08,22:00:00,50,41,9,ECO_300019380
642,Herenthoutsesteenweg 2,2023-07-08,23:00:00,36,30,6,ECO_300019380
642,Herenthoutsesteenweg 2,2023-07-09,00:00:00,25,19,6,ECO_300019380
642,Herenthoutsesteenweg 2,2023-07-09,01:00:00,15,9,6,ECO_300019380
642,Herenthoutsesteenweg 2,2023-07-09,02:00:00,21,18,3,ECO_300019380
642,Herenthoutsesteenweg 2,2023-07-09,03:00:00,12,9,3,ECO_300019380
642,Herenthoutsesteenweg 2,2023-07-09,04:00:00,3,1,2,ECO_300019380
642,Herenthoutsesteenweg 2,2023-07-09,05:00:00,12,3,9,ECO_300019380
642,Herenthoutsesteenweg 2,2023-07-09,06:00:00,3,2,1,ECO_300019380
642,Herenthoutsesteenweg 2,2023-07-09,07:00:00,4,4,0,ECO_300019380
642,Herenthoutsesteenweg 2,2023-07-09,08:00:00,16,13,3,ECO_300019380
642,Herenthoutsesteenweg 2,2023-07-09,09:00:00,29,28,1,ECO_300019380
642,Herenthoutsesteenweg 2,2023-07-09,10:00:00,107,96,11,ECO_300019380
642,Herenthoutsesteenweg 2,2023-07-09,11:00:00,193,166,27,ECO_300019380
642,Herenthoutsesteenweg 2,2023-07-09,12:00:00,178,158,20,ECO_300019380
642,Herenthoutsesteenweg 2,2023-07-09,13:00:00,127,106,21,ECO_300019380
642,Herenthoutsesteenweg 2,2023-07-09,14:00:00,95,78,17,ECO_300019380
642,Herenthoutsesteenweg 2,2023-07-09,15:00:00,63,62,1,ECO_300019380
642,Herenthoutsesteenweg 2,2023-07-09,16:00:00,56,44,12,ECO_300019380
642,Herenthoutsesteenweg 2,2023-07-09,17:00:00,7,7,0,ECO_300019380
642,Herenthoutsesteenweg 2,2023-07-09,18:00:00,44,38,6,ECO_300019380
642,Herenthoutsesteenweg 2,2023-07-09,19:00:00,40,38,2,ECO_300019380
642,Herenthoutsesteenweg 2,2023-07-09,20:00:00,45,39,6,ECO_300019380
642,Herenthoutsesteenweg 2,2023-07-09,21:00:00,34,28,6,ECO_300019380
642,Herenthoutsesteenweg 2,2023-07-09,22:00:00,30,25,5,ECO_300019380
642,Herenthoutsesteenweg 2,2023-07-09,23:00:00,15,13,2,ECO_300019380
642,Herenthoutsesteenweg 2,2023-07-10,00:00:00,13,12,1,ECO_300019380
642,Herenthoutsesteenweg 2,2023-07-10,01:00:00,5,2,3,ECO_300019380
642,Herenthoutsesteenweg 2,2023-07-10,02:00:00,3,3,0,ECO_300019380
642,Herenthoutsesteenweg 2,2023-07-10,03:00:00,1,0,1,ECO_300019380
642,Herenthoutsesteenweg 2,2023-07-10,04:00:00,0,0,0,ECO_300019380
642,Herenthoutsesteenweg 2,2023-07-10,05:00:00,0,0,0,ECO_300019380
642,Herenthoutsesteenweg 2,2023-07-10,06:00:00,5,5,0,ECO_300019380
642,Herenthoutsesteenweg 2,2023-07-10,07:00:00,18,15,3,ECO_300019380
642,Herenthoutsesteenweg 2,2023-07-10,08:00:00,36,33,3,ECO_300019380
642,Herenthoutsesteenweg 2,2023-07-10,09:00:00,100,93,7,ECO_300019380
642,Herenthoutsesteenweg 2,2023-07-10,10:00:00,79,74,5,ECO_300019380
642,Herenthoutsesteenweg 2,2023-07-10,11:00:00,143,132,11,ECO_300019380
642,Herenthoutsesteenweg 2,2023-07-10,12:00:00,100,93,7,ECO_300019380
642,Herenthoutsesteenweg 2,2023-07-10,13:00:00,84,79,5,ECO_300019380
642,Herenthoutsesteenweg 2,2023-07-10,14:00:00,123,117,6,ECO_300019380
642,Herenthoutsesteenweg 2,2023-07-10,15:00:00,150,137,13,ECO_300019380
642,Herenthoutsesteenweg 2,2023-07-10,16:00:00,242,227,15,ECO_300019380
642,Herenthoutsesteenweg 2,2023-07-10,17:00:00,112,102,10,ECO_300019380
642,Herenthoutsesteenweg 2,2023-07-10,18:00:00,202,183,19,ECO_300019380
642,Herenthoutsesteenweg 2,2023-07-10,19:00:00,113,109,4,ECO_300019380
642,Herenthoutsesteenweg 2,2023-07-10,20:00:00,102,87,15,ECO_300019380
642,Herenthoutsesteenweg 2,2023-07-10,21:00:00,77,64,13,ECO_300019380
642,Herenthoutsesteenweg 2,2023-07-10,22:00:00,60,58,2,ECO_300019380
642,Herenthoutsesteenweg 2,2023-07-10,23:00:00,31,29,2,ECO_300019380
642,Herenthoutsesteenweg 2,2023-07-11,00:00:00,24,22,2,ECO_300019380
642,Herenthoutsesteenweg 2,2023-07-11,01:00:00,8,6,2,ECO_300019380
642,Herenthoutsesteenweg 2,2023-07-11,02:00:00,2,0,2,ECO_300019380
642,Herenthoutsesteenweg 2,2023-07-11,03:00:00,4,2,2,ECO_300019380
642,Herenthoutsesteenweg 2,2023-07-11,04:00:00,0,0,0,ECO_300019380
642,Herenthoutsesteenweg 2,2023-07-11,05:00:00,0,0,0,ECO_300019380
642,Herenthoutsesteenweg 2,2023-07-11,06:00:00,10,9,1,ECO_300019380
642,Herenthoutsesteenweg 2,2023-07-11,07:00:00,17,14,3,ECO_300019380
642,Herenthoutsesteenweg 2,2023-07-11,08:00:00,52,46,6,ECO_300019380
642,Herenthoutsesteenweg 2,2023-07-11,09:00:00,103,97,6,ECO_300019380
642,Herenthoutsesteenweg 2,2023-07-11,10:00:00,83,78,5,ECO_300019380
642,Herenthoutsesteenweg 2,2023-07-11,11:00:00,152,149,3,ECO_300019380
642,Herenthoutsesteenweg 2,2023-07-11,12:00:00,114,108,6,ECO_300019380
642,Herenthoutsesteenweg 2,2023-07-11,13:00:00,155,148,7,ECO_300019380
642,Herenthoutsesteenweg 2,2023-07-11,14:00:00,118,105,13,ECO_300019380
642,Herenthoutsesteenweg 2,2023-07-11,15:00:00,158,147,11,ECO_300019380
642,Herenthoutsesteenweg 2,2023-07-11,16:00:00,121,117,4,ECO_300019380
642,Herenthoutsesteenweg 2,2023-07-11,17:00:00,135,126,9,ECO_300019380
642,Herenthoutsesteenweg 2,2023-07-11,18:00:00,139,121,18,ECO_300019380
642,Herenthoutsesteenweg 2,2023-07-11,19:00:00,130,120,10,ECO_300019380
642,Herenthoutsesteenweg 2,2023-07-11,20:00:00,90,82,8,ECO_300019380
642,Herenthoutsesteenweg 2,2023-07-11,21:00:00,85,73,12,ECO_300019380
642,Herenthoutsesteenweg 2,2023-07-11,22:00:00,53,50,3,ECO_300019380
642,Herenthoutsesteenweg 2,2023-07-11,23:00:00,36,34,2,ECO_300019380
642,Herenthoutsesteenweg 2,2023-07-12,00:00:00,32,30,2,ECO_300019380
642,Herenthoutsesteenweg 2,2023-07-12,01:00:00,5,1,4,ECO_300019380
642,Herenthoutsesteenweg 2,2023-07-12,02:00:00,4,2,2,ECO_300019380
642,Herenthoutsesteenweg 2,2023-07-12,03:00:00,1,0,1,ECO_300019380
642,Herenthoutsesteenweg 2,2023-07-12,04:00:00,1,0,1,ECO_300019380
642,Herenthoutsesteenweg 2,2023-07-12,05:00:00,1,0,1,ECO_300019380
642,Herenthoutsesteenweg 2,2023-07-12,06:00:00,4,4,0,ECO_300019380
642,Herenthoutsesteenweg 2,2023-07-12,07:00:00,18,17,1,ECO_300019380
642,Herenthoutsesteenweg 2,2023-07-12,08:00:00,39,39,0,ECO_300019380
642,Herenthoutsesteenweg 2,2023-07-12,09:00:00,91,84,7,ECO_300019380
642,Herenthoutsesteenweg 2,2023-07-12,10:00:00,91,87,4,ECO_300019380
642,Herenthoutsesteenweg 2,2023-07-12,11:00:00,69,65,4,ECO_300019380
642,Herenthoutsesteenweg 2,2023-07-12,12:00:00,60,55,5,ECO_300019380
642,Herenthoutsesteenweg 2,2023-07-12,13:00:00,104,95,9,ECO_300019380
642,Herenthoutsesteenweg 2,2023-07-12,14:00:00,107,99,8,ECO_300019380
642,Herenthoutsesteenweg 2,2023-07-12,15:00:00,99,91,8,ECO_300019380
642,Herenthoutsesteenweg 2,2023-07-12,16:00:00,131,123,8,ECO_300019380
642,Herenthoutsesteenweg 2,2023-07-12,17:00:00,93,87,6,ECO_300019380
642,Herenthoutsesteenweg 2,2023-07-12,18:00:00,151,134,17,ECO_300019380
642,Herenthoutsesteenweg 2,2023-07-12,19:00:00,86,80,6,ECO_300019380
642,Herenthoutsesteenweg 2,2023-07-12,20:00:00,82,75,7,ECO_300019380
642,Herenthoutsesteenweg 2,2023-07-12,21:00:00,66,56,10,ECO_300019380
642,Herenthoutsesteenweg 2,2023-07-12,22:00:00,62,56,6,ECO_300019380
642,Herenthoutsesteenweg 2,2023-07-12,23:00:00,34,28,6,ECO_300019380
642,Herenthoutsesteenweg 2,2023-07-13,00:00:00,34,30,4,ECO_300019380
642,Herenthoutsesteenweg 2,2023-07-13,01:00:00,11,9,2,ECO_300019380
642,Herenthoutsesteenweg 2,2023-07-13,02:00:00,8,4,4,ECO_300019380
642,Herenthoutsesteenweg 2,2023-07-13,03:00:00,4,1,3,ECO_300019380
642,Herenthoutsesteenweg 2,2023-07-13,04:00:00,4,3,1,ECO_300019380
642,Herenthoutsesteenweg 2,2023-07-13,05:00:00,3,1,2,ECO_300019380
642,Herenthoutsesteenweg 2,2023-07-13,06:00:00,5,5,0,ECO_300019380
642,Herenthoutsesteenweg 2,2023-07-13,07:00:00,21,18,3,ECO_300019380
642,Herenthoutsesteenweg 2,2023-07-13,08:00:00,47,44,3,ECO_300019380
642,Herenthoutsesteenweg 2,2023-07-13,09:00:00,81,75,6,ECO_300019380
642,Herenthoutsesteenweg 2,2023-07-13,10:00:00,88,80,8,ECO_300019380
642,Herenthoutsesteenweg 2,2023-07-13,11:00:00,88,82,6,ECO_300019380
642,Herenthoutsesteenweg 2,2023-07-13,12:00:00,72,64,8,ECO_300019380
642,Herenthoutsesteenweg 2,2023-07-13,13:00:00,120,112,8,ECO_300019380
642,Herenthoutsesteenweg 2,2023-07-13,14:00:00,78,67,11,ECO_300019380
642,Herenthoutsesteenweg 2,2023-07-13,15:00:00,105,99,6,ECO_300019380
642,Herenthoutsesteenweg 2,2023-07-13,16:00:00,73,66,7,ECO_300019380
642,Herenthoutsesteenweg 2,2023-07-13,17:00:00,67,55,12,ECO_300019380
642,Herenthoutsesteenweg 2,2023-07-13,18:00:00,110,99,11,ECO_300019380
642,Herenthoutsesteenweg 2,2023-07-13,19:00:00,83,74,9,ECO_300019380
642,Herenthoutsesteenweg 2,2023-07-13,20:00:00,78,70,8,ECO_300019380
642,Herenthoutsesteenweg 2,2023-07-13,21:00:00,51,43,8,ECO_300019380
642,Herenthoutsesteenweg 2,2023-07-13,22:00:00,58,39,19,ECO_300019380
642,Herenthoutsesteenweg 2,2023-07-13,23:00:00,20,17,3,ECO_300019380
642,Herenthoutsesteenweg 2,2023-07-14,00:00:00,29,28,1,ECO_300019380
642,Herenthoutsesteenweg 2,2023-07-14,01:00:00,6,4,2,ECO_300019380
642,Herenthoutsesteenweg 2,2023-07-14,02:00:00,0,0,0,ECO_300019380
642,Herenthoutsesteenweg 2,2023-07-14,03:00:00,3,1,2,ECO_300019380
642,Herenthoutsesteenweg 2,2023-07-14,04:00:00,0,0,0,ECO_300019380
642,Herenthoutsesteenweg 2,2023-07-14,05:00:00,1,1,0,ECO_300019380
642,Herenthoutsesteenweg 2,2023-07-14,06:00:00,5,5,0,ECO_300019380
642,Herenthoutsesteenweg 2,2023-07-14,07:00:00,17,14,3,ECO_300019380
642,Herenthoutsesteenweg 2,2023-07-14,08:00:00,34,31,3,ECO_300019380
642,Herenthoutsesteenweg 2,2023-07-14,09:00:00,81,79,2,ECO_300019380
642,Herenthoutsesteenweg 2,2023-07-14,10:00:00,95,94,1,ECO_300019380
642,Herenthoutsesteenweg 2,2023-07-14,11:00:00,129,127,2,ECO_300019380
642,Herenthoutsesteenweg 2,2023-07-14,12:00:00,155,143,12,ECO_300019380
642,Herenthoutsesteenweg 2,2023-07-14,13:00:00,98,90,8,ECO_300019380
642,Herenthoutsesteenweg 2,2023-07-14,14:00:00,90,78,12,ECO_300019380
642,Herenthoutsesteenweg 2,2023-07-14,15:00:00,128,116,12,ECO_300019380
642,Herenthoutsesteenweg 2,2023-07-14,16:00:00,155,146,9,ECO_300019380
642,Herenthoutsesteenweg 2,2023-07-14,17:00:00,110,98,12,ECO_300019380
642,Herenthoutsesteenweg 2,2023-07-14,18:00:00,125,116,9,ECO_300019380
642,Herenthoutsesteenweg 2,2023-07-14,19:00:00,87,75,12,ECO_300019380
642,Herenthoutsesteenweg 2,2023-07-14,20:00:00,89,78,11,ECO_300019380
642,Herenthoutsesteenweg 2,2023-07-14,21:00:00,69,63,6,ECO_300019380
642,Herenthoutsesteenweg 2,2023-07-14,22:00:00,60,58,2,ECO_300019380
642,Herenthoutsesteenweg 2,2023-07-14,23:00:00,44,37,7,ECO_300019380
642,Herenthoutsesteenweg 2,2023-07-15,00:00:00,23,21,2,ECO_300019380
642,Herenthoutsesteenweg 2,2023-07-15,01:00:00,25,15,10,ECO_300019380
642,Herenthoutsesteenweg 2,2023-07-15,02:00:00,22,21,1,ECO_300019380
642,Herenthoutsesteenweg 2,2023-07-15,03:00:00,4,4,0,ECO_300019380
642,Herenthoutsesteenweg 2,2023-07-15,04:00:00,1,1,0,ECO_300019380
642,Herenthoutsesteenweg 2,2023-07-15,05:00:00,4,3,1,ECO_300019380
642,Herenthoutsesteenweg 2,2023-07-15,06:00:00,2,1,1,ECO_300019380
642,Herenthoutsesteenweg 2,2023-07-15,07:00:00,4,4,0,ECO_300019380
642,Herenthoutsesteenweg 2,2023-07-15,08:00:00,18,15,3,ECO_300019380
642,Herenthoutsesteenweg 2,2023-07-15,09:00:00,22,20,2,ECO_300019380
642,Herenthoutsesteenweg 2,2023-07-15,10:00:00,47,45,2,ECO_300019380
642,Herenthoutsesteenweg 2,2023-07-15,11:00:00,100,90,10,ECO_300019380
642,Herenthoutsesteenweg 2,2023-07-15,12:00:00,131,126,5,ECO_300019380
642,Herenthoutsesteenweg 2,2023-07-15,13:00:00,93,78,15,ECO_300019380
642,Herenthoutsesteenweg 2,2023-07-15,14:00:00,91,84,7,ECO_300019380
642,Herenthoutsesteenweg 2,2023-07-15,15:00:00,95,88,7,ECO_300019380
642,Herenthoutsesteenweg 2,2023-07-15,16:00:00,88,78,10,ECO_300019380
642,Herenthoutsesteenweg 2,2023-07-15,17:00:00,81,67,14,ECO_300019380
642,Herenthoutsesteenweg 2,2023-07-15,18:00:00,73,65,8,ECO_300019380
642,Herenthoutsesteenweg 2,2023-07-15,19:00:00,34,25,9,ECO_300019380
642,Herenthoutsesteenweg 2,2023-07-15,20:00:00,28,19,9,ECO_300019380
642,Herenthoutsesteenweg 2,2023-07-15,21:00:00,18,12,6,ECO_300019380
642,Herenthoutsesteenweg 2,2023-07-15,22:00:00,24,21,3,ECO_300019380
642,Herenthoutsesteenweg 2,2023-07-15,23:00:00,15,15,0,ECO_300019380
642,Herenthoutsesteenweg 2,2023-07-16,00:00:00,12,8,4,ECO_300019380
642,Herenthoutsesteenweg 2,2023-07-16,01:00:00,13,10,3,ECO_300019380
642,Herenthoutsesteenweg 2,2023-07-16,02:00:00,2,0,2,ECO_300019380
642,Herenthoutsesteenweg 2,2023-07-16,03:00:00,5,4,1,ECO_300019380
642,Herenthoutsesteenweg 2,2023-07-16,04:00:00,4,2,2,ECO_300019380
642,Herenthoutsesteenweg 2,2023-07-16,05:00:00,1,1,0,ECO_300019380
642,Herenthoutsesteenweg 2,2023-07-16,06:00:00,5,2,3,ECO_300019380
642,Herenthoutsesteenweg 2,2023-07-16,07:00:00,6,4,2,ECO_300019380
642,Herenthoutsesteenweg 2,2023-07-16,08:00:00,10,10,0,ECO_300019380
642,Herenthoutsesteenweg 2,2023-07-16,09:00:00,31,31,0,ECO_300019380
642,Herenthoutsesteenweg 2,2023-07-16,10:00:00,72,59,13,ECO_300019380
642,Herenthoutsesteenweg 2,2023-07-16,11:00:00,88,85,3,ECO_300019380
642,Herenthoutsesteenweg 2,2023-07-16,12:00:00,179,175,4,ECO_300019380
642,Herenthoutsesteenweg 2,2023-07-16,13:00:00,126,112,14,ECO_300019380
642,Herenthoutsesteenweg 2,2023-07-16,14:00:00,87,73,14,ECO_300019380
642,Herenthoutsesteenweg 2,2023-07-16,15:00:00,59,56,3,ECO_300019380
642,Herenthoutsesteenweg 2,2023-07-16,16:00:00,69,63,6,ECO_300019380
642,Herenthoutsesteenweg 2,2023-07-16,17:00:00,71,64,7,ECO_300019380
642,Herenthoutsesteenweg 2,2023-07-16,18:00:00,55,39,16,ECO_300019380
642,Herenthoutsesteenweg 2,2023-07-16,19:00:00,51,39,12,ECO_300019380
642,Herenthoutsesteenweg 2,2023-07-16,20:00:00,64,54,10,ECO_300019380
642,Herenthoutsesteenweg 2,2023-07-16,21:00:00,33,24,9,ECO_300019380
642,Herenthoutsesteenweg 2,2023-07-16,22:00:00,25,21,4,ECO_300019380
642,Herenthoutsesteenweg 2,2023-07-16,23:00:00,28,27,1,ECO_300019380
642,Herenthoutsesteenweg 2,2023-07-17,00:00:00,22,10,12,ECO_300019380
642,Herenthoutsesteenweg 2,2023-07-17,01:00:00,10,7,3,ECO_300019380
642,Herenthoutsesteenweg 2,2023-07-17,02:00:00,5,4,1,ECO_300019380
642,Herenthoutsesteenweg 2,2023-07-17,03:00:00,5,3,2,ECO_300019380
642,Herenthoutsesteenweg 2,2023-07-17,04:00:00,0,0,0,ECO_300019380
642,Herenthoutsesteenweg 2,2023-07-17,05:00:00,0,0,0,ECO_300019380
642,Herenthoutsesteenweg 2,2023-07-17,06:00:00,6,5,1,ECO_300019380
642,Herenthoutsesteenweg 2,2023-07-17,07:00:00,12,10,2,ECO_300019380
642,Herenthoutsesteenweg 2,2023-07-17,08:00:00,36,32,4,ECO_300019380
642,Herenthoutsesteenweg 2,2023-07-17,09:00:00,81,75,6,ECO_300019380
642,Herenthoutsesteenweg 2,2023-07-17,10:00:00,89,87,2,ECO_300019380
642,Herenthoutsesteenweg 2,2023-07-17,11:00:00,63,61,2,ECO_300019380
642,Herenthoutsesteenweg 2,2023-07-17,12:00:00,72,65,7,ECO_300019380
642,Herenthoutsesteenweg 2,2023-07-17,13:00:00,89,81,8,ECO_300019380
642,Herenthoutsesteenweg 2,2023-07-17,14:00:00,82,79,3,ECO_300019380
642,Herenthoutsesteenweg 2,2023-07-17,15:00:00,80,77,3,ECO_300019380
642,Herenthoutsesteenweg 2,2023-07-17,16:00:00,104,95,9,ECO_300019380
642,Herenthoutsesteenweg 2,2023-07-17,17:00:00,65,59,6,ECO_300019380
642,Herenthoutsesteenweg 2,2023-07-17,18:00:00,66,54,12,ECO_300019380
642,Herenthoutsesteenweg 2,2023-07-17,19:00:00,59,53,6,ECO_300019380
642,Herenthoutsesteenweg 2,2023-07-17,20:00:00,49,41,8,ECO_300019380
642,Herenthoutsesteenweg 2,2023-07-17,21:00:00,53,46,7,ECO_300019380
642,Herenthoutsesteenweg 2,2023-07-17,22:00:00,40,32,8,ECO_300019380
642,Herenthoutsesteenweg 2,2023-07-17,23:00:00,29,24,5,ECO_300019380
642,Herenthoutsesteenweg 2,2023-07-18,00:00:00,14,10,4,ECO_300019380
642,Herenthoutsesteenweg 2,2023-07-18,01:00:00,6,5,1,ECO_300019380
642,Herenthoutsesteenweg 2,2023-07-18,02:00:00,2,2,0,ECO_300019380
642,Herenthoutsesteenweg 2,2023-07-18,03:00:00,0,0,0,ECO_300019380
642,Herenthoutsesteenweg 2,2023-07-18,04:00:00,3,3,0,ECO_300019380
642,Herenthoutsesteenweg 2,2023-07-18,05:00:00,2,2,0,ECO_300019380
642,Herenthoutsesteenweg 2,2023-07-18,06:00:00,3,3,0,ECO_300019380
642,Herenthoutsesteenweg 2,2023-07-18,07:00:00,15,13,2,ECO_300019380
642,Herenthoutsesteenweg 2,2023-07-18,08:00:00,43,42,1,ECO_300019380
642,Herenthoutsesteenweg 2,2023-07-18,09:00:00,91,82,9,ECO_300019380
642,Herenthoutsesteenweg 2,2023-07-18,10:00:00,93,84,9,ECO_300019380
642,Herenthoutsesteenweg 2,2023-07-18,11:00:00,99,93,6,ECO_300019380
642,Herenthoutsesteenweg 2,2023-07-18,12:00:00,136,132,4,ECO_300019380
642,Herenthoutsesteenweg 2,2023-07-18,13:00:00,96,92,4,ECO_300019380
642,Herenthoutsesteenweg 2,2023-07-18,14:00:00,69,64,5,ECO_300019380
642,Herenthoutsesteenweg 2,2023-07-18,15:00:00,197,187,10,ECO_300019380
642,Herenthoutsesteenweg 2,2023-07-18,16:00:00,156,144,12,ECO_300019380
642,Herenthoutsesteenweg 2,2023-07-18,17:00:00,159,138,21,ECO_300019380
642,Herenthoutsesteenweg 2,2023-07-18,18:00:00,194,172,22,ECO_300019380
642,Herenthoutsesteenweg 2,2023-07-18,19:00:00,119,109,10,ECO_300019380
642,Herenthoutsesteenweg 2,2023-07-18,20:00:00,100,88,12,ECO_300019380
642,Herenthoutsesteenweg 2,2023-07-18,21:00:00,89,70,19,ECO_300019380
642,Herenthoutsesteenweg 2,2023-07-18,22:00:00,64,56,8,ECO_300019380
642,Herenthoutsesteenweg 2,2023-07-18,23:00:00,41,36,5,ECO_300019380
642,Herenthoutsesteenweg 2,2023-07-19,00:00:00,37,26,11,ECO_300019380
642,Herenthoutsesteenweg 2,2023-07-19,01:00:00,13,10,3,ECO_300019380
642,Herenthoutsesteenweg 2,2023-07-19,02:00:00,10,8,2,ECO_300019380
642,Herenthoutsesteenweg 2,2023-07-19,03:00:00,2,1,1,ECO_300019380
642,Herenthoutsesteenweg 2,2023-07-19,04:00:00,2,2,0,ECO_300019380
642,Herenthoutsesteenweg 2,2023-07-19,05:00:00,2,2,0,ECO_300019380
642,Herenthoutsesteenweg 2,2023-07-19,06:00:00,4,3,1,ECO_300019380
642,Herenthoutsesteenweg 2,2023-07-19,07:00:00,11,9,2,ECO_300019380
642,Herenthoutsesteenweg 2,2023-07-19,08:00:00,33,33,0,ECO_300019380
642,Herenthoutsesteenweg 2,2023-07-19,09:00:00,79,78,1,ECO_300019380
642,Herenthoutsesteenweg 2,2023-07-19,10:00:00,82,77,5,ECO_300019380
642,Herenthoutsesteenweg 2,2023-07-19,11:00:00,62,60,2,ECO_300019380
642,Herenthoutsesteenweg 2,2023-07-19,12:00:00,89,85,4,ECO_300019380
642,Herenthoutsesteenweg 2,2023-07-19,13:00:00,72,65,7,ECO_300019380
642,Herenthoutsesteenweg 2,2023-07-19,14:00:00,94,85,9,ECO_300019380
642,Herenthoutsesteenweg 2,2023-07-19,15:00:00,74,58,16,ECO_300019380
642,Herenthoutsesteenweg 2,2023-07-19,16:00:00,95,90,5,ECO_300019380
642,Herenthoutsesteenweg 2,2023-07-19,17:00:00,85,69,16,ECO_300019380
642,Herenthoutsesteenweg 2,2023-07-19,18:00:00,86,73,13,ECO_300019380
642,Herenthoutsesteenweg 2,2023-07-19,19:00:00,75,60,15,ECO_300019380
642,Herenthoutsesteenweg 2,2023-07-19,20:00:00,51,40,11,ECO_300019380
642,Herenthoutsesteenweg 2,2023-07-19,21:00:00,48,44,4,ECO_300019380
642,Herenthoutsesteenweg 2,2023-07-19,22:00:00,36,29,7,ECO_300019380
642,Herenthoutsesteenweg 2,2023-07-19,23:00:00,32,25,7,ECO_300019380
642,Herenthoutsesteenweg 2,2023-07-20,00:00:00,25,22,3,ECO_300019380
642,Herenthoutsesteenweg 2,2023-07-20,01:00:00,9,8,1,ECO_300019380
642,Herenthoutsesteenweg 2,2023-07-20,02:00:00,10,5,5,ECO_300019380
642,Herenthoutsesteenweg 2,2023-07-20,03:00:00,10,6,4,ECO_300019380
642,Herenthoutsesteenweg 2,2023-07-20,04:00:00,1,1,0,ECO_300019380
642,Herenthoutsesteenweg 2,2023-07-20,05:00:00,1,1,0,ECO_300019380
642,Herenthoutsesteenweg 2,2023-07-20,06:00:00,2,2,0,ECO_300019380
642,Herenthoutsesteenweg 2,2023-07-20,07:00:00,12,10,2,ECO_300019380
642,Herenthoutsesteenweg 2,2023-07-20,08:00:00,37,34,3,ECO_300019380
642,Herenthoutsesteenweg 2,2023-07-20,09:00:00,73,70,3,ECO_300019380
642,Herenthoutsesteenweg 2,2023-07-20,10:00:00,78,72,6,ECO_300019380
642,Herenthoutsesteenweg 2,2023-07-20,11:00:00,82,80,2,ECO_300019380
642,Herenthoutsesteenweg 2,2023-07-20,12:00:00,132,124,8,ECO_300019380
642,Herenthoutsesteenweg 2,2023-07-20,13:00:00,171,166,5,ECO_300019380
642,Herenthoutsesteenweg 2,2023-07-20,14:00:00,111,99,12,ECO_300019380
642,Herenthoutsesteenweg 2,2023-07-20,15:00:00,111,106,5,ECO_300019380
642,Herenthoutsesteenweg 2,2023-07-20,16:00:00,168,152,16,ECO_300019380
642,Herenthoutsesteenweg 2,2023-07-20,17:00:00,149,138,11,ECO_300019380
642,Herenthoutsesteenweg 2,2023-07-20,18:00:00,128,111,17,ECO_300019380
642,Herenthoutsesteenweg 2,2023-07-20,19:00:00,97,91,6,ECO_300019380
642,Herenthoutsesteenweg 2,2023-07-20,20:00:00,58,44,14,ECO_300019380
642,Herenthoutsesteenweg 2,2023-07-20,21:00:00,29,23,6,ECO_300019380
642,Herenthoutsesteenweg 2,2023-07-20,22:00:00,42,34,8,ECO_300019380
642,Herenthoutsesteenweg 2,2023-07-20,23:00:00,28,25,3,ECO_300019380
642,Herenthoutsesteenweg 2,2023-07-21,00:00:00,30,24,6,ECO_300019380
642,Herenthoutsesteenweg 2,2023-07-21,01:00:00,18,14,4,ECO_300019380
642,Herenthoutsesteenweg 2,2023-07-21,02:00:00,12,8,4,ECO_300019380
642,Herenthoutsesteenweg 2,2023-07-21,03:00:00,14,3,11,ECO_300019380
642,Herenthoutsesteenweg 2,2023-07-21,04:00:00,5,2,3,ECO_300019380
642,Herenthoutsesteenweg 2,2023-07-21,05:00:00,4,1,3,ECO_300019380
642,Herenthoutsesteenweg 2,2023-07-21,06:00:00,0,0,0,ECO_300019380
642,Herenthoutsesteenweg 2,2023-07-21,07:00:00,3,3,0,ECO_300019380
642,Herenthoutsesteenweg 2,2023-07-21,08:00:00,11,8,3,ECO_300019380
642,Herenthoutsesteenweg 2,2023-07-21,09:00:00,14,13,1,ECO_300019380
642,Herenthoutsesteenweg 2,2023-07-21,10:00:00,71,69,2,ECO_300019380
642,Herenthoutsesteenweg 2,2023-07-21,11:00:00,176,160,16,ECO_300019380
642,Herenthoutsesteenweg 2,2023-07-21,12:00:00,239,225,14,ECO_300019380
642,Herenthoutsesteenweg 2,2023-07-21,13:00:00,171,161,10,ECO_300019380
642,Herenthoutsesteenweg 2,2023-07-21,14:00:00,108,99,9,ECO_300019380
642,Herenthoutsesteenweg 2,2023-07-21,15:00:00,45,40,5,ECO_300019380
642,Herenthoutsesteenweg 2,2023-07-21,16:00:00,46,40,6,ECO_300019380
642,Herenthoutsesteenweg 2,2023-07-21,17:00:00,43,39,4,ECO_300019380
642,Herenthoutsesteenweg 2,2023-07-21,18:00:00,77,71,6,ECO_300019380
642,Herenthoutsesteenweg 2,2023-07-21,19:00:00,38,33,5,ECO_300019380
642,Herenthoutsesteenweg 2,2023-07-21,20:00:00,61,57,4,ECO_300019380
642,Herenthoutsesteenweg 2,2023-07-21,21:00:00,69,64,5,ECO_300019380
642,Herenthoutsesteenweg 2,2023-07-21,22:00:00,46,39,7,ECO_300019380
642,Herenthoutsesteenweg 2,2023-07-21,23:00:00,35,28,7,ECO_300019380
642,Herenthoutsesteenweg 2,2023-07-22,00:00:00,21,13,8,ECO_300019380
642,Herenthoutsesteenweg 2,2023-07-22,01:00:00,10,7,3,ECO_300019380
642,Herenthoutsesteenweg 2,2023-07-22,02:00:00,8,7,1,ECO_300019380
642,Herenthoutsesteenweg 2,2023-07-22,03:00:00,9,9,0,ECO_300019380
642,Herenthoutsesteenweg 2,2023-07-22,04:00:00,2,1,1,ECO_300019380
642,Herenthoutsesteenweg 2,2023-07-22,05:00:00,2,0,2,ECO_300019380
642,Herenthoutsesteenweg 2,2023-07-22,06:00:00,0,0,0,ECO_300019380
642,Herenthoutsesteenweg 2,2023-07-22,07:00:00,3,3,0,ECO_300019380
642,Herenthoutsesteenweg 2,2023-07-22,08:00:00,10,10,0,ECO_300019380
642,Herenthoutsesteenweg 2,2023-07-22,09:00:00,14,12,2,ECO_300019380
642,Herenthoutsesteenweg 2,2023-07-22,10:00:00,45,39,6,ECO_300019380
642,Herenthoutsesteenweg 2,2023-07-22,11:00:00,74,69,5,ECO_300019380
642,Herenthoutsesteenweg 2,2023-07-22,12:00:00,125,117,8,ECO_300019380
642,Herenthoutsesteenweg 2,2023-07-22,13:00:00,141,131,10,ECO_300019380
642,Herenthoutsesteenweg 2,2023-07-22,14:00:00,131,119,12,ECO_300019380
642,Herenthoutsesteenweg 2,2023-07-22,15:00:00,147,131,16,ECO_300019380
642,Herenthoutsesteenweg 2,2023-07-22,16:00:00,127,118,9,ECO_300019380
642,Herenthoutsesteenweg 2,2023-07-22,17:00:00,120,107,13,ECO_300019380
642,Herenthoutsesteenweg 2,2023-07-22,18:00:00,87,75,12,ECO_300019380
642,Herenthoutsesteenweg 2,2023-07-22,19:00:00,84,74,10,ECO_300019380
642,Herenthoutsesteenweg 2,2023-07-22,20:00:00,42,34,8,ECO_300019380
642,Herenthoutsesteenweg 2,2023-07-22,21:00:00,30,24,6,ECO_300019380
642,Herenthoutsesteenweg 2,2023-07-22,22:00:00,31,27,4,ECO_300019380
642,Herenthoutsesteenweg 2,2023-07-22,23:00:00,15,13,2,ECO_300019380
642,Herenthoutsesteenweg 2,2023-07-23,00:00:00,12,11,1,ECO_300019380
642,Herenthoutsesteenweg 2,2023-07-23,01:00:00,6,6,0,ECO_300019380
642,Herenthoutsesteenweg 2,2023-07-23,02:00:00,7,3,4,ECO_300019380
642,Herenthoutsesteenweg 2,2023-07-23,03:00:00,11,7,4,ECO_300019380
642,Herenthoutsesteenweg 2,2023-07-23,04:00:00,3,1,2,ECO_300019380
642,Herenthoutsesteenweg 2,2023-07-23,05:00:00,8,6,2,ECO_300019380
642,Herenthoutsesteenweg 2,2023-07-23,06:00:00,0,0,0,ECO_300019380
642,Herenthoutsesteenweg 2,2023-07-23,07:00:00,0,0,0,ECO_300019380
642,Herenthoutsesteenweg 2,2023-07-23,08:00:00,7,7,0,ECO_300019380
642,Herenthoutsesteenweg 2,2023-07-23,09:00:00,11,11,0,ECO_300019380
642,Herenthoutsesteenweg 2,2023-07-23,10:00:00,24,22,2,ECO_300019380
642,Herenthoutsesteenweg 2,2023-07-23,11:00:00,29,27,2,ECO_300019380
642,Herenthoutsesteenweg 2,2023-07-23,12:00:00,28,26,2,ECO_300019380
642,Herenthoutsesteenweg 2,2023-07-23,13:00:00,26,25,1,ECO_300019380
642,Herenthoutsesteenweg 2,2023-07-23,14:00:00,15,14,1,ECO_300019380
642,Herenthoutsesteenweg 2,2023-07-23,15:00:00,41,36,5,ECO_300019380
642,Herenthoutsesteenweg 2,2023-07-23,16:00:00,47,36,11,ECO_300019380
642,Herenthoutsesteenweg 2,2023-07-23,17:00:00,24,19,5,ECO_300019380
642,Herenthoutsesteenweg 2,2023-07-23,18:00:00,26,21,5,ECO_300019380
642,Herenthoutsesteenweg 2,2023-07-23,19:00:00,16,13,3,ECO_300019380
642,Herenthoutsesteenweg 2,2023-07-23,20:00:00,14,11,3,ECO_300019380
642,Herenthoutsesteenweg 2,2023-07-23,21:00:00,8,7,1,ECO_300019380
642,Herenthoutsesteenweg 2,2023-07-23,22:00:00,2,0,2,ECO_300019380
642,Herenthoutsesteenweg 2,2023-07-23,23:00:00,8,7,1,ECO_300019380
642,Herenthoutsesteenweg 2,2023-07-24,00:00:00,0,0,0,ECO_300019380
642,Herenthoutsesteenweg 2,2023-07-24,01:00:00,3,1,2,ECO_300019380
642,Herenthoutsesteenweg 2,2023-07-24,02:00:00,3,3,0,ECO_300019380
642,Herenthoutsesteenweg 2,2023-07-24,03:00:00,0,0,0,ECO_300019380
642,Herenthoutsesteenweg 2,2023-07-24,04:00:00,0,0,0,ECO_300019380
642,Herenthoutsesteenweg 2,2023-07-24,05:00:00,1,1,0,ECO_300019380
642,Herenthoutsesteenweg 2,2023-07-24,06:00:00,1,1,0,ECO_300019380
642,Herenthoutsesteenweg 2,2023-07-24,07:00:00,8,7,1,ECO_300019380
642,Herenthoutsesteenweg 2,2023-07-24,08:00:00,28,24,4,ECO_300019380
642,Herenthoutsesteenweg 2,2023-07-24,09:00:00,46,43,3,ECO_300019380
642,Herenthoutsesteenweg 2,2023-07-24,10:00:00,50,49,1,ECO_300019380
642,Herenthoutsesteenweg 2,2023-07-24,11:00:00,57,51,6,ECO_300019380
642,Herenthoutsesteenweg 2,2023-07-24,12:00:00,50,48,2,ECO_300019380
642,Herenthoutsesteenweg 2,2023-07-24,13:00:00,53,52,1,ECO_300019380
642,Herenthoutsesteenweg 2,2023-07-24,14:00:00,35,31,4,ECO_300019380
642,Herenthoutsesteenweg 2,2023-07-24,15:00:00,57,49,8,ECO_300019380
642,Herenthoutsesteenweg 2,2023-07-24,16:00:00,71,62,9,ECO_300019380
642,Herenthoutsesteenweg 2,2023-07-24,17:00:00,48,42,6,ECO_300019380
642,Herenthoutsesteenweg 2,2023-07-24,18:00:00,38,32,6,ECO_300019380
642,Herenthoutsesteenweg 2,2023-07-24,19:00:00,46,39,7,ECO_300019380
642,Herenthoutsesteenweg 2,2023-07-24,20:00:00,45,33,12,ECO_300019380
642,Herenthoutsesteenweg 2,2023-07-24,21:00:00,45,38,7,ECO_300019380
642,Herenthoutsesteenweg 2,2023-07-24,22:00:00,26,25,1,ECO_300019380
642,Herenthoutsesteenweg 2,2023-07-24,23:00:00,12,11,1,ECO_300019380
642,Herenthoutsesteenweg 2,2023-07-25,00:00:00,14,13,1,ECO_300019380
642,Herenthoutsesteenweg 2,2023-07-25,01:00:00,5,4,1,ECO_300019380
642,Herenthoutsesteenweg 2,2023-07-25,02:00:00,4,3,1,ECO_300019380
642,Herenthoutsesteenweg 2,2023-07-25,03:00:00,0,0,0,ECO_300019380
642,Herenthoutsesteenweg 2,2023-07-25,04:00:00,3,1,2,ECO_300019380
642,Herenthoutsesteenweg 2,2023-07-25,05:00:00,1,1,0,ECO_300019380
642,Herenthoutsesteenweg 2,2023-07-25,06:00:00,3,3,0,ECO_300019380
642,Herenthoutsesteenweg 2,2023-07-25,07:00:00,12,11,1,ECO_300019380
642,Herenthoutsesteenweg 2,2023-07-25,08:00:00,43,40,3,ECO_300019380
642,Herenthoutsesteenweg 2,2023-07-25,09:00:00,70,65,5,ECO_300019380
642,Herenthoutsesteenweg 2,2023-07-25,10:00:00,75,71,4,ECO_300019380
642,Herenthoutsesteenweg 2,2023-07-25,11:00:00,58,52,6,ECO_300019380
642,Herenthoutsesteenweg 2,2023-07-25,12:00:00,53,48,5,ECO_300019380
642,Herenthoutsesteenweg 2,2023-07-25,13:00:00,74,67,7,ECO_300019380
642,Herenthoutsesteenweg 2,2023-07-25,14:00:00,101,92,9,ECO_300019380
642,Herenthoutsesteenweg 2,2023-07-25,15:00:00,126,115,11,ECO_300019380
642,Herenthoutsesteenweg 2,2023-07-25,16:00:00,160,142,18,ECO_300019380
642,Herenthoutsesteenweg 2,2023-07-25,17:00:00,180,160,20,ECO_300019380
642,Herenthoutsesteenweg 2,2023-07-25,18:00:00,144,121,23,ECO_300019380
642,Herenthoutsesteenweg 2,2023-07-25,19:00:00,104,93,11,ECO_300019380
642,Herenthoutsesteenweg 2,2023-07-25,20:00:00,69,50,19,ECO_300019380
642,Herenthoutsesteenweg 2,2023-07-25,21:00:00,84,82,2,ECO_300019380
642,Herenthoutsesteenweg 2,2023-07-25,22:00:00,45,43,2,ECO_300019380
642,Herenthoutsesteenweg 2,2023-07-25,23:00:00,59,47,12,ECO_300019380
642,Herenthoutsesteenweg 2,2023-07-26,00:00:00,34,29,5,ECO_300019380
642,Herenthoutsesteenweg 2,2023-07-26,01:00:00,5,1,4,ECO_300019380
642,Herenthoutsesteenweg 2,2023-07-26,02:00:00,9,8,1,ECO_300019380
642,Herenthoutsesteenweg 2,2023-07-26,03:00:00,0,0,0,ECO_300019380
642,Herenthoutsesteenweg 2,2023-07-26,04:00:00,1,0,1,ECO_300019380
642,Herenthoutsesteenweg 2,2023-07-26,05:00:00,1,1,0,ECO_300019380
642,Herenthoutsesteenweg 2,2023-07-26,06:00:00,1,1,0,ECO_300019380
642,Herenthoutsesteenweg 2,2023-07-26,07:00:00,22,20,2,ECO_300019380
642,Herenthoutsesteenweg 2,2023-07-26,08:00:00,37,33,4,ECO_300019380
642,Herenthoutsesteenweg 2,2023-07-26,09:00:00,87,78,9,ECO_300019380
642,Herenthoutsesteenweg 2,2023-07-26,10:00:00,88,85,3,ECO_300019380
642,Herenthoutsesteenweg 2,2023-07-26,11:00:00,139,127,12,ECO_300019380
642,Herenthoutsesteenweg 2,2023-07-26,12:00:00,114,107,7,ECO_300019380
642,Herenthoutsesteenweg 2,2023-07-26,13:00:00,115,108,7,ECO_300019380
642,Herenthoutsesteenweg 2,2023-07-26,14:00:00,138,121,17,ECO_300019380
642,Herenthoutsesteenweg 2,2023-07-26,15:00:00,141,131,10,ECO_300019380
642,Herenthoutsesteenweg 2,2023-07-26,16:00:00,176,163,13,ECO_300019380
642,Herenthoutsesteenweg 2,2023-07-26,17:00:00,144,118,26,ECO_300019380
642,Herenthoutsesteenweg 2,2023-07-26,18:00:00,144,117,27,ECO_300019380
642,Herenthoutsesteenweg 2,2023-07-26,19:00:00,103,95,8,ECO_300019380
642,Herenthoutsesteenweg 2,2023-07-26,20:00:00,91,79,12,ECO_300019380
642,Herenthoutsesteenweg 2,2023-07-26,21:00:00,61,53,8,ECO_300019380
642,Herenthoutsesteenweg 2,2023-07-26,22:00:00,48,41,7,ECO_300019380
642,Herenthoutsesteenweg 2,2023-07-26,23:00:00,49,40,9,ECO_300019380
642,Herenthoutsesteenweg 2,2023-07-27,00:00:00,36,28,8,ECO_300019380
642,Herenthoutsesteenweg 2,2023-07-27,01:00:00,11,8,3,ECO_300019380
642,Herenthoutsesteenweg 2,2023-07-27,02:00:00,8,7,1,ECO_300019380
642,Herenthoutsesteenweg 2,2023-07-27,03:00:00,3,1,2,ECO_300019380
642,Herenthoutsesteenweg 2,2023-07-27,04:00:00,1,1,0,ECO_300019380
642,Herenthoutsesteenweg 2,2023-07-27,05:00:00,0,0,0,ECO_300019380
642,Herenthoutsesteenweg 2,2023-07-27,06:00:00,0,0,0,ECO_300019380
642,Herenthoutsesteenweg 2,2023-07-27,07:00:00,8,7,1,ECO_300019380
642,Herenthoutsesteenweg 2,2023-07-27,08:00:00,15,14,1,ECO_300019380
642,Herenthoutsesteenweg 2,2023-07-27,09:00:00,40,37,3,ECO_300019380
642,Herenthoutsesteenweg 2,2023-07-27,10:00:00,40,39,1,ECO_300019380
642,Herenthoutsesteenweg 2,2023-07-27,11:00:00,48,47,1,ECO_300019380
642,Herenthoutsesteenweg 2,2023-07-27,12:00:00,48,39,9,ECO_300019380
642,Herenthoutsesteenweg 2,2023-07-27,13:00:00,36,32,4,ECO_300019380
642,Herenthoutsesteenweg 2,2023-07-27,14:00:00,31,25,6,ECO_300019380
642,Herenthoutsesteenweg 2,2023-07-27,15:00:00,45,40,5,ECO_300019380
642,Herenthoutsesteenweg 2,2023-07-27,16:00:00,84,77,7,ECO_300019380
642,Herenthoutsesteenweg 2,2023-07-27,17:00:00,61,54,7,ECO_300019380
642,Herenthoutsesteenweg 2,2023-07-27,18:00:00,98,91,7,ECO_300019380
642,Herenthoutsesteenweg 2,2023-07-27,19:00:00,70,66,4,ECO_300019380
642,Herenthoutsesteenweg 2,2023-07-27,20:00:00,188,180,8,ECO_300019380
642,Herenthoutsesteenweg 2,2023-07-27,21:00:00,133,129,4,ECO_300019380
642,Herenthoutsesteenweg 2,2023-07-27,22:00:00,74,67,7,ECO_300019380
642,Herenthoutsesteenweg 2,2023-07-27,23:00:00,45,39,6,ECO_300019380
642,Herenthoutsesteenweg 2,2023-07-28,00:00:00,34,29,5,ECO_300019380
642,Herenthoutsesteenweg 2,2023-07-28,01:00:00,16,15,1,ECO_300019380
642,Herenthoutsesteenweg 2,2023-07-28,02:00:00,14,10,4,ECO_300019380
642,Herenthoutsesteenweg 2,2023-07-28,03:00:00,5,1,4,ECO_300019380
642,Herenthoutsesteenweg 2,2023-07-28,04:00:00,0,0,0,ECO_300019380
642,Herenthoutsesteenweg 2,2023-07-28,05:00:00,10,2,8,ECO_300019380
642,Herenthoutsesteenweg 2,2023-07-28,06:00:00,4,2,2,ECO_300019380
642,Herenthoutsesteenweg 2,2023-07-28,07:00:00,14,13,1,ECO_300019380
642,Herenthoutsesteenweg 2,2023-07-28,08:00:00,19,17,2,ECO_300019380
642,Herenthoutsesteenweg 2,2023-07-28,09:00:00,51,47,4,ECO_300019380
642,Herenthoutsesteenweg 2,2023-07-28,10:00:00,86,85,1,ECO_300019380
642,Herenthoutsesteenweg 2,2023-07-28,11:00:00,144,141,3,ECO_300019380
642,Herenthoutsesteenweg 2,2023-07-28,12:00:00,119,113,6,ECO_300019380
642,Herenthoutsesteenweg 2,2023-07-28,13:00:00,84,80,4,ECO_300019380
642,Herenthoutsesteenweg 2,2023-07-28,14:00:00,88,77,11,ECO_300019380
642,Herenthoutsesteenweg 2,2023-07-28,15:00:00,148,134,14,ECO_300019380
642,Herenthoutsesteenweg 2,2023-07-28,16:00:00,229,218,11,ECO_300019380
642,Herenthoutsesteenweg 2,2023-07-28,17:00:00,248,230,18,ECO_300019380
642,Herenthoutsesteenweg 2,2023-07-28,18:00:00,142,129,13,ECO_300019380
642,Herenthoutsesteenweg 2,2023-07-28,19:00:00,193,180,13,ECO_300019380
642,Herenthoutsesteenweg 2,2023-07-28,20:00:00,283,271,12,ECO_300019380
642,Herenthoutsesteenweg 2,2023-07-28,21:00:00,230,220,10,ECO_300019380
642,Herenthoutsesteenweg 2,2023-07-28,22:00:00,240,230,10,ECO_300019380
642,Herenthoutsesteenweg 2,2023-07-28,23:00:00,115,113,2,ECO_300019380
642,Herenthoutsesteenweg 2,2023-07-29,00:00:00,77,72,5,ECO_300019380
642,Herenthoutsesteenweg 2,2023-07-29,01:00:00,41,37,4,ECO_300019380
642,Herenthoutsesteenweg 2,2023-07-29,02:00:00,35,28,7,ECO_300019380
642,Herenthoutsesteenweg 2,2023-07-29,03:00:00,8,0,8,ECO_300019380
642,Herenthoutsesteenweg 2,2023-07-29,04:00:00,13,3,10,ECO_300019380
642,Herenthoutsesteenweg 2,2023-07-29,05:00:00,10,3,7,ECO_300019380
642,Herenthoutsesteenweg 2,2023-07-29,06:00:00,6,4,2,ECO_300019380
642,Herenthoutsesteenweg 2,2023-07-29,07:00:00,10,10,0,ECO_300019380
642,Herenthoutsesteenweg 2,2023-07-29,08:00:00,10,9,1,ECO_300019380
642,Herenthoutsesteenweg 2,2023-07-29,09:00:00,23,21,2,ECO_300019380
642,Herenthoutsesteenweg 2,2023-07-29,10:00:00,45,39,6,ECO_300019380
642,Herenthoutsesteenweg 2,2023-07-29,11:00:00,82,72,10,ECO_300019380
642,Herenthoutsesteenweg 2,2023-07-29,12:00:00,101,91,10,ECO_300019380
642,Herenthoutsesteenweg 2,2023-07-29,13:00:00,105,96,9,ECO_300019380
642,Herenthoutsesteenweg 2,2023-07-29,14:00:00,84,79,5,ECO_300019380
642,Herenthoutsesteenweg 2,2023-07-29,15:00:00,69,63,6,ECO_300019380
642,Herenthoutsesteenweg 2,2023-07-29,16:00:00,47,46,1,ECO_300019380
642,Herenthoutsesteenweg 2,2023-07-29,17:00:00,68,63,5,ECO_300019380
642,Herenthoutsesteenweg 2,2023-07-29,18:00:00,49,46,3,ECO_300019380
642,Herenthoutsesteenweg 2,2023-07-29,19:00:00,27,26,1,ECO_300019380
642,Herenthoutsesteenweg 2,2023-07-29,20:00:00,44,39,5,ECO_300019380
642,Herenthoutsesteenweg 2,2023-07-29,21:00:00,38,34,4,ECO_300019380
642,Herenthoutsesteenweg 2,2023-07-29,22:00:00,28,22,6,ECO_300019380
642,Herenthoutsesteenweg 2,2023-07-29,23:00:00,24,17,7,ECO_300019380
642,Herenthoutsesteenweg 2,2023-07-30,00:00:00,9,8,1,ECO_300019380
642,Herenthoutsesteenweg 2,2023-07-30,01:00:00,4,3,1,ECO_300019380
642,Herenthoutsesteenweg 2,2023-07-30,02:00:00,10,8,2,ECO_300019380
642,Herenthoutsesteenweg 2,2023-07-30,03:00:00,12,9,3,ECO_300019380
642,Herenthoutsesteenweg 2,2023-07-30,04:00:00,4,2,2,ECO_300019380
642,Herenthoutsesteenweg 2,2023-07-30,05:00:00,7,7,0,ECO_300019380
642,Herenthoutsesteenweg 2,2023-07-30,06:00:00,3,3,0,ECO_300019380
642,Herenthoutsesteenweg 2,2023-07-30,07:00:00,0,0,0,ECO_300019380
642,Herenthoutsesteenweg 2,2023-07-30,08:00:00,10,9,1,ECO_300019380
642,Herenthoutsesteenweg 2,2023-07-30,09:00:00,25,24,1,ECO_300019380
642,Herenthoutsesteenweg 2,2023-07-30,10:00:00,99,73,26,ECO_300019380
642,Herenthoutsesteenweg 2,2023-07-30,11:00:00,123,108,15,ECO_300019380
642,Herenthoutsesteenweg 2,2023-07-30,12:00:00,164,141,23,ECO_300019380
642,Herenthoutsesteenweg 2,2023-07-30,13:00:00,128,105,23,ECO_300019380
642,Herenthoutsesteenweg 2,2023-07-30,14:00:00,83,73,10,ECO_300019380
642,Herenthoutsesteenweg 2,2023-07-30,15:00:00,93,89,4,ECO_300019380
642,Herenthoutsesteenweg 2,2023-07-30,16:00:00,79,66,13,ECO_300019380
642,Herenthoutsesteenweg 2,2023-07-30,17:00:00,80,69,11,ECO_300019380
642,Herenthoutsesteenweg 2,2023-07-30,18:00:00,83,72,11,ECO_300019380
642,Herenthoutsesteenweg 2,2023-07-30,19:00:00,66,58,8,ECO_300019380
642,Herenthoutsesteenweg 2,2023-07-30,20:00:00,24,23,1,ECO_300019380
642,Herenthoutsesteenweg 2,2023-07-30,21:00:00,14,13,1,ECO_300019380
642,Herenthoutsesteenweg 2,2023-07-30,22:00:00,12,8,4,ECO_300019380
642,Herenthoutsesteenweg 2,2023-07-30,23:00:00,18,16,2,ECO_300019380
642,Herenthoutsesteenweg 2,2023-07-31,00:00:00,10,9,1,ECO_300019380
642,Herenthoutsesteenweg 2,2023-07-31,01:00:00,1,1,0,ECO_300019380
642,Herenthoutsesteenweg 2,2023-07-31,02:00:00,2,2,0,ECO_300019380
642,Herenthoutsesteenweg 2,2023-07-31,03:00:00,0,0,0,ECO_300019380
642,Herenthoutsesteenweg 2,2023-07-31,04:00:00,0,0,0,ECO_300019380
642,Herenthoutsesteenweg 2,2023-07-31,05:00:00,3,1,2,ECO_300019380
642,Herenthoutsesteenweg 2,2023-07-31,06:00:00,1,1,0,ECO_300019380
642,Herenthoutsesteenweg 2,2023-07-31,07:00:00,12,10,2,ECO_300019380
642,Herenthoutsesteenweg 2,2023-07-31,08:00:00,20,16,4,ECO_300019380
642,Herenthoutsesteenweg 2,2023-07-31,09:00:00,46,43,3,ECO_300019380
642,Herenthoutsesteenweg 2,2023-07-31,10:00:00,50,48,2,ECO_300019380
642,Herenthoutsesteenweg 2,2023-07-31,11:00:00,39,38,1,ECO_300019380
642,Herenthoutsesteenweg 2,2023-07-31,12:00:00,100,95,5,ECO_300019380
642,Herenthoutsesteenweg 2,2023-07-31,13:00:00,53,52,1,ECO_300019380
642,Herenthoutsesteenweg 2,2023-07-31,14:00:00,45,41,4,ECO_300019380
642,Herenthoutsesteenweg 2,2023-07-31,15:00:00,78,73,5,ECO_300019380
642,Herenthoutsesteenweg 2,2023-07-31,16:00:00,62,57,5,ECO_300019380
642,Herenthoutsesteenweg 2,2023-07-31,17:00:00,49,44,5,ECO_300019380
642,Herenthoutsesteenweg 2,2023-07-31,18:00:00,77,66,11,ECO_300019380
642,Herenthoutsesteenweg 2,2023-07-31,19:00:00,32,26,6,ECO_300019380
642,Herenthoutsesteenweg 2,2023-07-31,20:00:00,14,11,3,ECO_300019380
642,Herenthoutsesteenweg 2,2023-07-31,21:00:00,26,23,3,ECO_300019380
642,Herenthoutsesteenweg 2,2023-07-31,22:00:00,6,5,1,ECO_300019380
642,Herenthoutsesteenweg 2,2023-07-31,23:00:00,18,15,3,ECO_300019380
642,Herenthoutsesteenweg 2,2023-08-01,00:00:00,12,12,0,ECO_300019380
642,Herenthoutsesteenweg 2,2023-08-01,01:00:00,3,3,0,ECO_300019380
642,Herenthoutsesteenweg 2,2023-08-01,02:00:00,3,0,3,ECO_300019380
642,Herenthoutsesteenweg 2,2023-08-01,03:00:00,1,1,0,ECO_300019380
642,Herenthoutsesteenweg 2,2023-08-01,04:00:00,0,0,0,ECO_300019380
642,Herenthoutsesteenweg 2,2023-08-01,05:00:00,1,1,0,ECO_300019380
642,Herenthoutsesteenweg 2,2023-08-01,06:00:00,2,2,0,ECO_300019380
642,Herenthoutsesteenweg 2,2023-08-01,07:00:00,15,12,3,ECO_300019380
642,Herenthoutsesteenweg 2,2023-08-01,08:00:00,36,28,8,ECO_300019380
642,Herenthoutsesteenweg 2,2023-08-01,09:00:00,96,87,9,ECO_300019380
642,Herenthoutsesteenweg 2,2023-08-01,10:00:00,71,70,1,ECO_300019380
642,Herenthoutsesteenweg 2,2023-08-01,11:00:00,101,98,3,ECO_300019380
642,Herenthoutsesteenweg 2,2023-08-01,12:00:00,76,73,3,ECO_300019380
642,Herenthoutsesteenweg 2,2023-08-01,13:00:00,97,89,8,ECO_300019380
642,Herenthoutsesteenweg 2,2023-08-01,14:00:00,84,78,6,ECO_300019380
642,Herenthoutsesteenweg 2,2023-08-01,15:00:00,108,106,2,ECO_300019380
642,Herenthoutsesteenweg 2,2023-08-01,16:00:00,138,130,8,ECO_300019380
642,Herenthoutsesteenweg 2,2023-08-01,17:00:00,88,80,8,ECO_300019380
642,Herenthoutsesteenweg 2,2023-08-01,18:00:00,152,138,14,ECO_300019380
642,Herenthoutsesteenweg 2,2023-08-01,19:00:00,118,101,17,ECO_300019380
642,Herenthoutsesteenweg 2,2023-08-01,20:00:00,72,61,11,ECO_300019380
642,Herenthoutsesteenweg 2,2023-08-01,21:00:00,75,64,11,ECO_300019380
642,Herenthoutsesteenweg 2,2023-08-01,22:00:00,27,25,2,ECO_300019380
642,Herenthoutsesteenweg 2,2023-08-01,23:00:00,39,30,9,ECO_300019380
642,Herenthoutsesteenweg 2,2023-08-02,00:00:00,24,19,5,ECO_300019380
642,Herenthoutsesteenweg 2,2023-08-02,01:00:00,3,2,1,ECO_300019380
642,Herenthoutsesteenweg 2,2023-08-02,02:00:00,6,6,0,ECO_300019380
642,Herenthoutsesteenweg 2,2023-08-02,03:00:00,4,3,1,ECO_300019380
642,Herenthoutsesteenweg 2,2023-08-02,04:00:00,5,3,2,ECO_300019380
642,Herenthoutsesteenweg 2,2023-08-02,05:00:00,0,0,0,ECO_300019380
642,Herenthoutsesteenweg 2,2023-08-02,06:00:00,3,3,0,ECO_300019380
642,Herenthoutsesteenweg 2,2023-08-02,07:00:00,18,17,1,ECO_300019380
642,Herenthoutsesteenweg 2,2023-08-02,08:00:00,26,21,5,ECO_300019380
642,Herenthoutsesteenweg 2,2023-08-02,09:00:00,48,46,2,ECO_300019380
642,Herenthoutsesteenweg 2,2023-08-02,10:00:00,46,41,5,ECO_300019380
642,Herenthoutsesteenweg 2,2023-08-02,11:00:00,21,21,0,ECO_300019380
642,Herenthoutsesteenweg 2,2023-08-02,12:00:00,38,36,2,ECO_300019380
642,Herenthoutsesteenweg 2,2023-08-02,13:00:00,40,37,3,ECO_300019380
642,Herenthoutsesteenweg 2,2023-08-02,14:00:00,41,35,6,ECO_300019380
642,Herenthoutsesteenweg 2,2023-08-02,15:00:00,58,54,4,ECO_300019380
642,Herenthoutsesteenweg 2,2023-08-02,16:00:00,64,57,7,ECO_300019380
642,Herenthoutsesteenweg 2,2023-08-02,17:00:00,68,62,6,ECO_300019380
642,Herenthoutsesteenweg 2,2023-08-02,18:00:00,107,99,8,ECO_300019380
642,Herenthoutsesteenweg 2,2023-08-02,19:00:00,62,54,8,ECO_300019380
642,Herenthoutsesteenweg 2,2023-08-02,20:00:00,36,30,6,ECO_300019380
642,Herenthoutsesteenweg 2,2023-08-02,21:00:00,38,32,6,ECO_300019380
642,Herenthoutsesteenweg 2,2023-08-02,22:00:00,22,21,1,ECO_300019380
642,Herenthoutsesteenweg 2,2023-08-02,23:00:00,32,26,6,ECO_300019380
642,Herenthoutsesteenweg 2,2023-08-03,00:00:00,11,9,2,ECO_300019380
642,Herenthoutsesteenweg 2,2023-08-03,01:00:00,11,9,2,ECO_300019380
642,Herenthoutsesteenweg 2,2023-08-03,02:00:00,7,7,0,ECO_300019380
642,Herenthoutsesteenweg 2,2023-08-03,03:00:00,3,3,0,ECO_300019380
642,Herenthoutsesteenweg 2,2023-08-03,04:00:00,0,0,0,ECO_300019380
642,Herenthoutsesteenweg 2,2023-08-03,05:00:00,0,0,0,ECO_300019380
642,Herenthoutsesteenweg 2,2023-08-03,06:00:00,1,1,0,ECO_300019380
642,Herenthoutsesteenweg 2,2023-08-03,07:00:00,14,13,1,ECO_300019380
642,Herenthoutsesteenweg 2,2023-08-03,08:00:00,25,18,7,ECO_300019380
642,Herenthoutsesteenweg 2,2023-08-03,09:00:00,62,61,1,ECO_300019380
642,Herenthoutsesteenweg 2,2023-08-03,10:00:00,58,54,4,ECO_300019380
642,Herenthoutsesteenweg 2,2023-08-03,11:00:00,42,41,1,ECO_300019380
642,Herenthoutsesteenweg 2,2023-08-03,12:00:00,31,30,1,ECO_300019380
642,Herenthoutsesteenweg 2,2023-08-03,13:00:00,42,40,2,ECO_300019380
642,Herenthoutsesteenweg 2,2023-08-03,14:00:00,36,28,8,ECO_300019380
642,Herenthoutsesteenweg 2,2023-08-03,15:00:00,50,47,3,ECO_300019380
642,Herenthoutsesteenweg 2,2023-08-03,16:00:00,55,50,5,ECO_300019380
642,Herenthoutsesteenweg 2,2023-08-03,17:00:00,46,44,2,ECO_300019380
642,Herenthoutsesteenweg 2,2023-08-03,18:00:00,88,81,7,ECO_300019380
642,Herenthoutsesteenweg 2,2023-08-03,19:00:00,97,86,11,ECO_300019380
642,Herenthoutsesteenweg 2,2023-08-03,20:00:00,61,56,5,ECO_300019380
642,Herenthoutsesteenweg 2,2023-08-03,21:00:00,55,43,12,ECO_300019380
642,Herenthoutsesteenweg 2,2023-08-03,22:00:00,19,17,2,ECO_300019380
642,Herenthoutsesteenweg 2,2023-08-03,23:00:00,41,33,8,ECO_300019380
642,Herenthoutsesteenweg 2,2023-08-04,00:00:00,15,15,0,ECO_300019380
642,Herenthoutsesteenweg 2,2023-08-04,01:00:00,7,3,4,ECO_300019380
642,Herenthoutsesteenweg 2,2023-08-04,02:00:00,7,3,4,ECO_300019380
642,Herenthoutsesteenweg 2,2023-08-04,03:00:00,3,2,1,ECO_300019380
642,Herenthoutsesteenweg 2,2023-08-04,04:00:00,1,1,0,ECO_300019380
642,Herenthoutsesteenweg 2,2023-08-04,05:00:00,0,0,0,ECO_300019380
642,Herenthoutsesteenweg 2,2023-08-04,06:00:00,1,1,0,ECO_300019380
642,Herenthoutsesteenweg 2,2023-08-04,07:00:00,12,10,2,ECO_300019380
642,Herenthoutsesteenweg 2,2023-08-04,08:00:00,28,21,7,ECO_300019380
642,Herenthoutsesteenweg 2,2023-08-04,09:00:00,75,73,2,ECO_300019380
642,Herenthoutsesteenweg 2,2023-08-04,10:00:00,70,65,5,ECO_300019380
642,Herenthoutsesteenweg 2,2023-08-04,11:00:00,83,75,8,ECO_300019380
642,Herenthoutsesteenweg 2,2023-08-04,12:00:00,74,68,6,ECO_300019380
642,Herenthoutsesteenweg 2,2023-08-04,13:00:00,56,50,6,ECO_300019380
642,Herenthoutsesteenweg 2,2023-08-04,14:00:00,59,53,6,ECO_300019380
642,Herenthoutsesteenweg 2,2023-08-04,15:00:00,92,87,5,ECO_300019380
642,Herenthoutsesteenweg 2,2023-08-04,16:00:00,108,96,12,ECO_300019380
642,Herenthoutsesteenweg 2,2023-08-04,17:00:00,108,98,10,ECO_300019380
642,Herenthoutsesteenweg 2,2023-08-04,18:00:00,117,108,9,ECO_300019380
642,Herenthoutsesteenweg 2,2023-08-04,19:00:00,91,83,8,ECO_300019380
642,Herenthoutsesteenweg 2,2023-08-04,20:00:00,71,62,9,ECO_300019380
642,Herenthoutsesteenweg 2,2023-08-04,21:00:00,47,43,4,ECO_300019380
642,Herenthoutsesteenweg 2,2023-08-04,22:00:00,39,37,2,ECO_300019380
642,Herenthoutsesteenweg 2,2023-08-04,23:00:00,34,27,7,ECO_300019380
642,Herenthoutsesteenweg 2,2023-08-05,00:00:00,18,14,4,ECO_300019380
642,Herenthoutsesteenweg 2,2023-08-05,01:00:00,12,8,4,ECO_300019380
642,Herenthoutsesteenweg 2,2023-08-05,02:00:00,4,3,1,ECO_300019380
642,Herenthoutsesteenweg 2,2023-08-05,03:00:00,15,13,2,ECO_300019380
642,Herenthoutsesteenweg 2,2023-08-05,04:00:00,3,1,2,ECO_300019380
642,Herenthoutsesteenweg 2,2023-08-05,05:00:00,2,2,0,ECO_300019380
642,Herenthoutsesteenweg 2,2023-08-05,06:00:00,4,3,1,ECO_300019380
642,Herenthoutsesteenweg 2,2023-08-05,07:00:00,2,1,1,ECO_300019380
642,Herenthoutsesteenweg 2,2023-08-05,08:00:00,5,5,0,ECO_300019380
642,Herenthoutsesteenweg 2,2023-08-05,09:00:00,21,16,5,ECO_300019380
642,Herenthoutsesteenweg 2,2023-08-05,10:00:00,35,28,7,ECO_300019380
642,Herenthoutsesteenweg 2,2023-08-05,11:00:00,113,101,12,ECO_300019380
642,Herenthoutsesteenweg 2,2023-08-05,12:00:00,112,105,7,ECO_300019380
642,Herenthoutsesteenweg 2,2023-08-05,13:00:00,112,97,15,ECO_300019380
642,Herenthoutsesteenweg 2,2023-08-05,14:00:00,70,59,11,ECO_300019380
642,Herenthoutsesteenweg 2,2023-08-05,15:00:00,54,48,6,ECO_300019380
642,Herenthoutsesteenweg 2,2023-08-05,16:00:00,30,26,4,ECO_300019380
642,Herenthoutsesteenweg 2,2023-08-05,17:00:00,26,24,2,ECO_300019380
642,Herenthoutsesteenweg 2,2023-08-05,18:00:00,27,26,1,ECO_300019380
642,Herenthoutsesteenweg 2,2023-08-05,19:00:00,27,25,2,ECO_300019380
642,Herenthoutsesteenweg 2,2023-08-05,20:00:00,26,14,12,ECO_300019380
642,Herenthoutsesteenweg 2,2023-08-05,21:00:00,17,10,7,ECO_300019380
642,Herenthoutsesteenweg 2,2023-08-05,22:00:00,21,16,5,ECO_300019380
642,Herenthoutsesteenweg 2,2023-08-05,23:00:00,11,11,0,ECO_300019380
642,Herenthoutsesteenweg 2,2023-08-06,00:00:00,10,9,1,ECO_300019380
642,Herenthoutsesteenweg 2,2023-08-06,01:00:00,6,6,0,ECO_300019380
642,Herenthoutsesteenweg 2,2023-08-06,02:00:00,9,6,3,ECO_300019380
642,Herenthoutsesteenweg 2,2023-08-06,03:00:00,4,3,1,ECO_300019380
642,Herenthoutsesteenweg 2,2023-08-06,04:00:00,9,9,0,ECO_300019380
642,Herenthoutsesteenweg 2,2023-08-06,05:00:00,5,2,3,ECO_300019380
642,Herenthoutsesteenweg 2,2023-08-06,06:00:00,2,1,1,ECO_300019380
642,Herenthoutsesteenweg 2,2023-08-06,07:00:00,0,0,0,ECO_300019380
642,Herenthoutsesteenweg 2,2023-08-06,08:00:00,8,7,1,ECO_300019380
642,Herenthoutsesteenweg 2,2023-08-06,09:00:00,2,2,0,ECO_300019380
642,Herenthoutsesteenweg 2,2023-08-06,10:00:00,3,2,1,ECO_300019380
642,Herenthoutsesteenweg 2,2023-08-06,11:00:00,11,11,0,ECO_300019380
642,Herenthoutsesteenweg 2,2023-08-06,12:00:00,39,30,9,ECO_300019380
642,Herenthoutsesteenweg 2,2023-08-06,13:00:00,23,22,1,ECO_300019380
642,Herenthoutsesteenweg 2,2023-08-06,14:00:00,17,16,1,ECO_300019380
642,Herenthoutsesteenweg 2,2023-08-06,15:00:00,22,20,2,ECO_300019380
642,Herenthoutsesteenweg 2,2023-08-06,16:00:00,26,24,2,ECO_300019380
642,Herenthoutsesteenweg 2,2023-08-06,17:00:00,17,10,7,ECO_300019380
642,Herenthoutsesteenweg 2,2023-08-06,18:00:00,7,7,0,ECO_300019380
642,Herenthoutsesteenweg 2,2023-08-06,19:00:00,18,16,2,ECO_300019380
642,Herenthoutsesteenweg 2,2023-08-06,20:00:00,13,11,2,ECO_300019380
642,Herenthoutsesteenweg 2,2023-08-06,21:00:00,19,17,2,ECO_300019380
642,Herenthoutsesteenweg 2,2023-08-06,22:00:00,15,11,4,ECO_300019380
642,Herenthoutsesteenweg 2,2023-08-06,23:00:00,10,9,1,ECO_300019380
642,Herenthoutsesteenweg 2,2023-08-07,00:00:00,2,2,0,ECO_300019380
642,Herenthoutsesteenweg 2,2023-08-07,01:00:00,2,1,1,ECO_300019380
642,Herenthoutsesteenweg 2,2023-08-07,02:00:00,1,1,0,ECO_300019380
642,Herenthoutsesteenweg 2,2023-08-07,03:00:00,0,0,0,ECO_300019380
642,Herenthoutsesteenweg 2,2023-08-07,04:00:00,2,2,0,ECO_300019380
642,Herenthoutsesteenweg 2,2023-08-07,05:00:00,1,1,0,ECO_300019380
642,Herenthoutsesteenweg 2,2023-08-07,06:00:00,5,4,1,ECO_300019380
642,Herenthoutsesteenweg 2,2023-08-07,07:00:00,23,20,3,ECO_300019380
642,Herenthoutsesteenweg 2,2023-08-07,08:00:00,45,37,8,ECO_300019380
642,Herenthoutsesteenweg 2,2023-08-07,09:00:00,84,78,6,ECO_300019380
642,Herenthoutsesteenweg 2,2023-08-07,10:00:00,87,81,6,ECO_300019380
642,Herenthoutsesteenweg 2,2023-08-07,11:00:00,59,56,3,ECO_300019380
642,Herenthoutsesteenweg 2,2023-08-07,12:00:00,79,75,4,ECO_300019380
642,Herenthoutsesteenweg 2,2023-08-07,13:00:00,76,67,9,ECO_300019380
642,Herenthoutsesteenweg 2,2023-08-07,14:00:00,76,65,11,ECO_300019380
642,Herenthoutsesteenweg 2,2023-08-07,15:00:00,99,86,13,ECO_300019380
642,Herenthoutsesteenweg 2,2023-08-07,16:00:00,150,126,24,ECO_300019380
642,Herenthoutsesteenweg 2,2023-08-07,17:00:00,126,111,15,ECO_300019380
642,Herenthoutsesteenweg 2,2023-08-07,18:00:00,159,144,15,ECO_300019380
642,Herenthoutsesteenweg 2,2023-08-07,19:00:00,132,116,16,ECO_300019380
642,Herenthoutsesteenweg 2,2023-08-07,20:00:00,76,61,15,ECO_300019380
642,Herenthoutsesteenweg 2,2023-08-07,21:00:00,71,59,12,ECO_300019380
642,Herenthoutsesteenweg 2,2023-08-07,22:00:00,45,38,7,ECO_300019380
642,Herenthoutsesteenweg 2,2023-08-07,23:00:00,30,20,10,ECO_300019380
642,Herenthoutsesteenweg 2,2023-08-08,00:00:00,30,24,6,ECO_300019380
642,Herenthoutsesteenweg 2,2023-08-08,01:00:00,8,5,3,ECO_300019380
642,Herenthoutsesteenweg 2,2023-08-08,02:00:00,6,2,4,ECO_300019380
642,Herenthoutsesteenweg 2,2023-08-08,03:00:00,2,1,1,ECO_300019380
642,Herenthoutsesteenweg 2,2023-08-08,04:00:00,0,0,0,ECO_300019380
642,Herenthoutsesteenweg 2,2023-08-08,05:00:00,2,1,1,ECO_300019380
642,Herenthoutsesteenweg 2,2023-08-08,06:00:00,1,1,0,ECO_300019380
642,Herenthoutsesteenweg 2,2023-08-08,07:00:00,20,17,3,ECO_300019380
642,Herenthoutsesteenweg 2,2023-08-08,08:00:00,69,56,13,ECO_300019380
642,Herenthoutsesteenweg 2,2023-08-08,09:00:00,122,111,11,ECO_300019380
642,Herenthoutsesteenweg 2,2023-08-08,10:00:00,109,105,4,ECO_300019380
642,Herenthoutsesteenweg 2,2023-08-08,11:00:00,75,69,6,ECO_300019380
642,Herenthoutsesteenweg 2,2023-08-08,12:00:00,74,65,9,ECO_300019380
642,Herenthoutsesteenweg 2,2023-08-08,13:00:00,89,80,9,ECO_300019380
642,Herenthoutsesteenweg 2,2023-08-08,14:00:00,58,51,7,ECO_300019380
642,Herenthoutsesteenweg 2,2023-08-08,15:00:00,109,99,10,ECO_300019380
642,Herenthoutsesteenweg 2,2023-08-08,16:00:00,117,98,19,ECO_300019380
642,Herenthoutsesteenweg 2,2023-08-08,17:00:00,153,139,14,ECO_300019380
642,Herenthoutsesteenweg 2,2023-08-08,18:00:00,176,154,22,ECO_300019380
642,Herenthoutsesteenweg 2,2023-08-08,19:00:00,100,86,14,ECO_300019380
642,Herenthoutsesteenweg 2,2023-08-08,20:00:00,70,49,21,ECO_300019380
642,Herenthoutsesteenweg 2,2023-08-08,21:00:00,61,50,11,ECO_300019380
642,Herenthoutsesteenweg 2,2023-08-08,22:00:00,26,21,5,ECO_300019380
642,Herenthoutsesteenweg 2,2023-08-08,23:00:00,12,9,3,ECO_300019380
642,Herenthoutsesteenweg 2,2023-08-09,00:00:00,20,15,5,ECO_300019380
642,Herenthoutsesteenweg 2,2023-08-09,01:00:00,1,1,0,ECO_300019380
642,Herenthoutsesteenweg 2,2023-08-09,02:00:00,1,1,0,ECO_300019380
642,Herenthoutsesteenweg 2,2023-08-09,03:00:00,8,6,2,ECO_300019380
642,Herenthoutsesteenweg 2,2023-08-09,04:00:00,0,0,0,ECO_300019380
642,Herenthoutsesteenweg 2,2023-08-09,05:00:00,0,0,0,ECO_300019380
642,Herenthoutsesteenweg 2,2023-08-09,06:00:00,1,1,0,ECO_300019380
642,Herenthoutsesteenweg 2,2023-08-09,07:00:00,19,16,3,ECO_300019380
642,Herenthoutsesteenweg 2,2023-08-09,08:00:00,58,48,10,ECO_300019380
642,Herenthoutsesteenweg 2,2023-08-09,09:00:00,107,101,6,ECO_300019380
642,Herenthoutsesteenweg 2,2023-08-09,10:00:00,111,106,5,ECO_300019380
642,Herenthoutsesteenweg 2,2023-08-09,11:00:00,108,105,3,ECO_300019380
642,Herenthoutsesteenweg 2,2023-08-09,12:00:00,114,106,8,ECO_300019380
642,Herenthoutsesteenweg 2,2023-08-09,13:00:00,98,90,8,ECO_300019380
642,Herenthoutsesteenweg 2,2023-08-09,14:00:00,106,88,18,ECO_300019380
642,Herenthoutsesteenweg 2,2023-08-09,15:00:00,156,138,18,ECO_300019380
642,Herenthoutsesteenweg 2,2023-08-09,16:00:00,177,163,14,ECO_300019380
642,Herenthoutsesteenweg 2,2023-08-09,17:00:00,158,141,17,ECO_300019380
642,Herenthoutsesteenweg 2,2023-08-09,18:00:00,204,187,17,ECO_300019380
642,Herenthoutsesteenweg 2,2023-08-09,19:00:00,102,81,21,ECO_300019380
642,Herenthoutsesteenweg 2,2023-08-09,20:00:00,102,86,16,ECO_300019380
642,Herenthoutsesteenweg 2,2023-08-09,21:00:00,75,66,9,ECO_300019380
642,Herenthoutsesteenweg 2,2023-08-09,22:00:00,53,48,5,ECO_300019380
642,Herenthoutsesteenweg 2,2023-08-09,23:00:00,37,27,10,ECO_300019380
642,Herenthoutsesteenweg 2,2023-08-10,00:00:00,32,31,1,ECO_300019380
642,Herenthoutsesteenweg 2,2023-08-10,01:00:00,2,2,0,ECO_300019380
642,Herenthoutsesteenweg 2,2023-08-10,02:00:00,4,4,0,ECO_300019380
642,Herenthoutsesteenweg 2,2023-08-10,03:00:00,2,2,0,ECO_300019380
642,Herenthoutsesteenweg 2,2023-08-10,04:00:00,1,1,0,ECO_300019380
642,Herenthoutsesteenweg 2,2023-08-10,05:00:00,0,0,0,ECO_300019380
642,Herenthoutsesteenweg 2,2023-08-10,06:00:00,3,2,1,ECO_300019380
642,Herenthoutsesteenweg 2,2023-08-10,07:00:00,18,15,3,ECO_300019380
642,Herenthoutsesteenweg 2,2023-08-10,08:00:00,64,56,8,ECO_300019380
642,Herenthoutsesteenweg 2,2023-08-10,09:00:00,126,118,8,ECO_300019380
642,Herenthoutsesteenweg 2,2023-08-10,10:00:00,106,105,1,ECO_300019380
642,Herenthoutsesteenweg 2,2023-08-10,11:00:00,86,82,4,ECO_300019380
642,Herenthoutsesteenweg 2,2023-08-10,12:00:00,160,149,11,ECO_300019380
642,Herenthoutsesteenweg 2,2023-08-10,13:00:00,143,122,21,ECO_300019380
642,Herenthoutsesteenweg 2,2023-08-10,14:00:00,120,106,14,ECO_300019380
642,Herenthoutsesteenweg 2,2023-08-10,15:00:00,232,221,11,ECO_300019380
642,Herenthoutsesteenweg 2,2023-08-10,16:00:00,227,210,17,ECO_300019380
642,Herenthoutsesteenweg 2,2023-08-10,17:00:00,236,210,26,ECO_300019380
642,Herenthoutsesteenweg 2,2023-08-10,18:00:00,271,230,41,ECO_300019380
642,Herenthoutsesteenweg 2,2023-08-10,19:00:00,152,129,23,ECO_300019380
642,Herenthoutsesteenweg 2,2023-08-10,20:00:00,120,100,20,ECO_300019380
642,Herenthoutsesteenweg 2,2023-08-10,21:00:00,126,109,17,ECO_300019380
642,Herenthoutsesteenweg 2,2023-08-10,22:00:00,53,42,11,ECO_300019380
642,Herenthoutsesteenweg 2,2023-08-10,23:00:00,45,29,16,ECO_300019380
642,Herenthoutsesteenweg 2,2023-08-11,00:00:00,31,28,3,ECO_300019380
642,Herenthoutsesteenweg 2,2023-08-11,01:00:00,10,8,2,ECO_300019380
642,Herenthoutsesteenweg 2,2023-08-11,02:00:00,6,5,1,ECO_300019380
642,Herenthoutsesteenweg 2,2023-08-11,03:00:00,8,4,4,ECO_300019380
642,Herenthoutsesteenweg 2,2023-08-11,04:00:00,1,1,0,ECO_300019380
642,Herenthoutsesteenweg 2,2023-08-11,05:00:00,2,1,1,ECO_300019380
642,Herenthoutsesteenweg 2,2023-08-11,06:00:00,2,2,0,ECO_300019380
642,Herenthoutsesteenweg 2,2023-08-11,07:00:00,23,19,4,ECO_300019380
642,Herenthoutsesteenweg 2,2023-08-11,08:00:00,56,46,10,ECO_300019380
642,Herenthoutsesteenweg 2,2023-08-11,09:00:00,101,91,10,ECO_300019380
642,Herenthoutsesteenweg 2,2023-08-11,10:00:00,135,132,3,ECO_300019380
642,Herenthoutsesteenweg 2,2023-08-11,11:00:00,211,201,10,ECO_300019380
642,Herenthoutsesteenweg 2,2023-08-11,12:00:00,189,181,8,ECO_300019380
642,Herenthoutsesteenweg 2,2023-08-11,13:00:00,149,137,12,ECO_300019380
642,Herenthoutsesteenweg 2,2023-08-11,14:00:00,222,197,25,ECO_300019380
642,Herenthoutsesteenweg 2,2023-08-11,15:00:00,205,183,22,ECO_300019380
642,Herenthoutsesteenweg 2,2023-08-11,16:00:00,238,214,24,ECO_300019380
642,Herenthoutsesteenweg 2,2023-08-11,17:00:00,185,162,23,ECO_300019380
642,Herenthoutsesteenweg 2,2023-08-11,18:00:00,201,174,27,ECO_300019380
642,Herenthoutsesteenweg 2,2023-08-11,19:00:00,121,104,17,ECO_300019380
642,Herenthoutsesteenweg 2,2023-08-11,20:00:00,105,87,18,ECO_300019380
642,Herenthoutsesteenweg 2,2023-08-11,21:00:00,61,44,17,ECO_300019380
642,Herenthoutsesteenweg 2,2023-08-11,22:00:00,39,27,12,ECO_300019380
642,Herenthoutsesteenweg 2,2023-08-11,23:00:00,42,40,2,ECO_300019380
642,Herenthoutsesteenweg 2,2023-08-12,00:00:00,34,29,5,ECO_300019380
642,Herenthoutsesteenweg 2,2023-08-12,01:00:00,15,10,5,ECO_300019380
642,Herenthoutsesteenweg 2,2023-08-12,02:00:00,15,8,7,ECO_300019380
642,Herenthoutsesteenweg 2,2023-08-12,03:00:00,13,7,6,ECO_300019380
642,Herenthoutsesteenweg 2,2023-08-12,04:00:00,5,1,4,ECO_300019380
642,Herenthoutsesteenweg 2,2023-08-12,05:00:00,2,2,0,ECO_300019380
642,Herenthoutsesteenweg 2,2023-08-12,06:00:00,1,1,0,ECO_300019380
642,Herenthoutsesteenweg 2,2023-08-12,07:00:00,7,7,0,ECO_300019380
642,Herenthoutsesteenweg 2,2023-08-12,08:00:00,5,5,0,ECO_300019380
642,Herenthoutsesteenweg 2,2023-08-12,09:00:00,11,8,3,ECO_300019380
642,Herenthoutsesteenweg 2,2023-08-12,10:00:00,23,23,0,ECO_300019380
642,Herenthoutsesteenweg 2,2023-08-12,11:00:00,28,27,1,ECO_300019380
642,Herenthoutsesteenweg 2,2023-08-12,12:00:00,41,37,4,ECO_300019380
642,Herenthoutsesteenweg 2,2023-08-12,13:00:00,69,59,10,ECO_300019380
642,Herenthoutsesteenweg 2,2023-08-12,14:00:00,96,86,10,ECO_300019380
642,Herenthoutsesteenweg 2,2023-08-12,15:00:00,116,111,5,ECO_300019380
642,Herenthoutsesteenweg 2,2023-08-12,16:00:00,150,141,9,ECO_300019380
642,Herenthoutsesteenweg 2,2023-08-12,17:00:00,136,123,13,ECO_300019380
642,Herenthoutsesteenweg 2,2023-08-12,18:00:00,104,93,11,ECO_300019380
642,Herenthoutsesteenweg 2,2023-08-12,19:00:00,86,73,13,ECO_300019380
642,Herenthoutsesteenweg 2,2023-08-12,20:00:00,76,68,8,ECO_300019380
642,Herenthoutsesteenweg 2,2023-08-12,21:00:00,70,62,8,ECO_300019380
642,Herenthoutsesteenweg 2,2023-08-12,22:00:00,69,65,4,ECO_300019380
642,Herenthoutsesteenweg 2,2023-08-12,23:00:00,38,33,5,ECO_300019380
642,Herenthoutsesteenweg 2,2023-08-13,00:00:00,28,24,4,ECO_300019380
642,Herenthoutsesteenweg 2,2023-08-13,01:00:00,13,11,2,ECO_300019380
642,Herenthoutsesteenweg 2,2023-08-13,02:00:00,12,7,5,ECO_300019380
642,Herenthoutsesteenweg 2,2023-08-13,03:00:00,16,11,5,ECO_300019380
642,Herenthoutsesteenweg 2,2023-08-13,04:00:00,4,2,2,ECO_300019380
642,Herenthoutsesteenweg 2,2023-08-13,05:00:00,9,6,3,ECO_300019380
642,Herenthoutsesteenweg 2,2023-08-13,06:00:00,6,2,4,ECO_300019380
642,Herenthoutsesteenweg 2,2023-08-13,07:00:00,9,8,1,ECO_300019380
642,Herenthoutsesteenweg 2,2023-08-13,08:00:00,10,10,0,ECO_300019380
642,Herenthoutsesteenweg 2,2023-08-13,09:00:00,24,23,1,ECO_300019380
642,Herenthoutsesteenweg 2,2023-08-13,10:00:00,62,51,11,ECO_300019380
642,Herenthoutsesteenweg 2,2023-08-13,11:00:00,200,173,27,ECO_300019380
642,Herenthoutsesteenweg 2,2023-08-13,12:00:00,218,193,25,ECO_300019380
642,Herenthoutsesteenweg 2,2023-08-13,13:00:00,134,110,24,ECO_300019380
642,Herenthoutsesteenweg 2,2023-08-13,14:00:00,94,82,12,ECO_300019380
642,Herenthoutsesteenweg 2,2023-08-13,15:00:00,162,150,12,ECO_300019380
642,Herenthoutsesteenweg 2,2023-08-13,16:00:00,153,138,15,ECO_300019380
642,Herenthoutsesteenweg 2,2023-08-13,17:00:00,132,123,9,ECO_300019380
642,Herenthoutsesteenweg 2,2023-08-13,18:00:00,154,127,27,ECO_300019380
642,Herenthoutsesteenweg 2,2023-08-13,19:00:00,93,84,9,ECO_300019380
642,Herenthoutsesteenweg 2,2023-08-13,20:00:00,80,70,10,ECO_300019380
642,Herenthoutsesteenweg 2,2023-08-13,21:00:00,63,48,15,ECO_300019380
642,Herenthoutsesteenweg 2,2023-08-13,22:00:00,59,50,9,ECO_300019380
642,Herenthoutsesteenweg 2,2023-08-13,23:00:00,54,50,4,ECO_300019380
642,Herenthoutsesteenweg 2,2023-08-14,00:00:00,20,15,5,ECO_300019380
642,Herenthoutsesteenweg 2,2023-08-14,01:00:00,11,7,4,ECO_300019380
642,Herenthoutsesteenweg 2,2023-08-14,02:00:00,11,5,6,ECO_300019380
642,Herenthoutsesteenweg 2,2023-08-14,03:00:00,2,2,0,ECO_300019380
642,Herenthoutsesteenweg 2,2023-08-14,04:00:00,0,0,0,ECO_300019380
642,Herenthoutsesteenweg 2,2023-08-14,05:00:00,1,0,1,ECO_300019380
642,Herenthoutsesteenweg 2,2023-08-14,06:00:00,3,3,0,ECO_300019380
642,Herenthoutsesteenweg 2,2023-08-14,07:00:00,14,8,6,ECO_300019380
642,Herenthoutsesteenweg 2,2023-08-14,08:00:00,20,16,4,ECO_300019380
642,Herenthoutsesteenweg 2,2023-08-14,09:00:00,51,38,13,ECO_300019380
642,Herenthoutsesteenweg 2,2023-08-14,10:00:00,91,84,7,ECO_300019380
642,Herenthoutsesteenweg 2,2023-08-14,11:00:00,70,63,7,ECO_300019380
642,Herenthoutsesteenweg 2,2023-08-14,12:00:00,109,97,12,ECO_300019380
642,Herenthoutsesteenweg 2,2023-08-14,13:00:00,124,104,20,ECO_300019380
642,Herenthoutsesteenweg 2,2023-08-14,14:00:00,124,112,12,ECO_300019380
642,Herenthoutsesteenweg 2,2023-08-14,15:00:00,199,182,17,ECO_300019380
642,Herenthoutsesteenweg 2,2023-08-14,16:00:00,268,248,20,ECO_300019380
642,Herenthoutsesteenweg 2,2023-08-14,17:00:00,215,203,12,ECO_300019380
642,Herenthoutsesteenweg 2,2023-08-14,18:00:00,170,134,36,ECO_300019380
642,Herenthoutsesteenweg 2,2023-08-14,19:00:00,162,136,26,ECO_300019380
642,Herenthoutsesteenweg 2,2023-08-14,20:00:00,124,94,30,ECO_300019380
642,Herenthoutsesteenweg 2,2023-08-14,21:00:00,112,95,17,ECO_300019380
642,Herenthoutsesteenweg 2,2023-08-14,22:00:00,66,61,5,ECO_300019380
642,Herenthoutsesteenweg 2,2023-08-14,23:00:00,37,32,5,ECO_300019380
642,Herenthoutsesteenweg 2,2023-08-15,00:00:00,37,28,9,ECO_300019380
642,Herenthoutsesteenweg 2,2023-08-15,01:00:00,18,16,2,ECO_300019380
642,Herenthoutsesteenweg 2,2023-08-15,02:00:00,17,10,7,ECO_300019380
642,Herenthoutsesteenweg 2,2023-08-15,03:00:00,8,4,4,ECO_300019380
642,Herenthoutsesteenweg 2,2023-08-15,04:00:00,12,10,2,ECO_300019380
642,Herenthoutsesteenweg 2,2023-08-15,05:00:00,5,1,4,ECO_300019380
642,Herenthoutsesteenweg 2,2023-08-15,06:00:00,5,0,5,ECO_300019380
642,Herenthoutsesteenweg 2,2023-08-15,07:00:00,10,5,5,ECO_300019380
642,Herenthoutsesteenweg 2,2023-08-15,08:00:00,10,10,0,ECO_300019380
642,Herenthoutsesteenweg 2,2023-08-15,09:00:00,16,12,4,ECO_300019380
642,Herenthoutsesteenweg 2,2023-08-15,10:00:00,48,44,4,ECO_300019380
642,Herenthoutsesteenweg 2,2023-08-15,11:00:00,99,89,10,ECO_300019380
642,Herenthoutsesteenweg 2,2023-08-15,12:00:00,139,118,21,ECO_300019380
642,Herenthoutsesteenweg 2,2023-08-15,13:00:00,184,157,27,ECO_300019380
642,Herenthoutsesteenweg 2,2023-08-15,14:00:00,107,97,10,ECO_300019380
642,Herenthoutsesteenweg 2,2023-08-15,15:00:00,169,147,22,ECO_300019380
642,Herenthoutsesteenweg 2,2023-08-15,16:00:00,229,197,32,ECO_300019380
642,Herenthoutsesteenweg 2,2023-08-15,17:00:00,219,198,21,ECO_300019380
642,Herenthoutsesteenweg 2,2023-08-15,18:00:00,188,155,33,ECO_300019380
642,Herenthoutsesteenweg 2,2023-08-15,19:00:00,140,116,24,ECO_300019380
642,Herenthoutsesteenweg 2,2023-08-15,20:00:00,154,131,23,ECO_300019380
642,Herenthoutsesteenweg 2,2023-08-15,21:00:00,106,80,26,ECO_300019380
642,Herenthoutsesteenweg 2,2023-08-15,22:00:00,70,54,16,ECO_300019380
642,Herenthoutsesteenweg 2,2023-08-15,23:00:00,50,44,6,ECO_300019380
642,Herenthoutsesteenweg 2,2023-08-16,00:00:00,16,13,3,ECO_300019380
642,Herenthoutsesteenweg 2,2023-08-16,01:00:00,9,7,2,ECO_300019380
642,Herenthoutsesteenweg 2,2023-08-16,02:00:00,2,2,0,ECO_300019380
642,Herenthoutsesteenweg 2,2023-08-16,03:00:00,4,2,2,ECO_300019380
642,Herenthoutsesteenweg 2,2023-08-16,04:00:00,0,0,0,ECO_300019380
642,Herenthoutsesteenweg 2,2023-08-16,05:00:00,0,0,0,ECO_300019380
642,Herenthoutsesteenweg 2,2023-08-16,06:00:00,3,3,0,ECO_300019380
642,Herenthoutsesteenweg 2,2023-08-16,07:00:00,29,22,7,ECO_300019380
642,Herenthoutsesteenweg 2,2023-08-16,08:00:00,58,48,10,ECO_300019380
642,Herenthoutsesteenweg 2,2023-08-16,09:00:00,125,109,16,ECO_300019380
642,Herenthoutsesteenweg 2,2023-08-16,10:00:00,125,117,8,ECO_300019380
642,Herenthoutsesteenweg 2,2023-08-16,11:00:00,104,96,8,ECO_300019380
642,Herenthoutsesteenweg 2,2023-08-16,12:00:00,110,103,7,ECO_300019380
642,Herenthoutsesteenweg 2,2023-08-16,13:00:00,104,91,13,ECO_300019380
642,Herenthoutsesteenweg 2,2023-08-16,14:00:00,115,97,18,ECO_300019380
642,Herenthoutsesteenweg 2,2023-08-16,15:00:00,134,128,6,ECO_300019380
642,Herenthoutsesteenweg 2,2023-08-16,16:00:00,204,186,18,ECO_300019380
642,Herenthoutsesteenweg 2,2023-08-16,17:00:00,191,173,18,ECO_300019380
642,Herenthoutsesteenweg 2,2023-08-16,18:00:00,185,164,21,ECO_300019380
642,Herenthoutsesteenweg 2,2023-08-16,19:00:00,154,136,18,ECO_300019380
642,Herenthoutsesteenweg 2,2023-08-16,20:00:00,137,114,23,ECO_300019380
642,Herenthoutsesteenweg 2,2023-08-16,21:00:00,92,71,21,ECO_300019380
642,Herenthoutsesteenweg 2,2023-08-16,22:00:00,50,33,17,ECO_300019380
642,Herenthoutsesteenweg 2,2023-08-16,23:00:00,64,53,11,ECO_300019380
642,Herenthoutsesteenweg 2,2023-08-17,00:00:00,42,32,10,ECO_300019380
642,Herenthoutsesteenweg 2,2023-08-17,01:00:00,7,3,4,ECO_300019380
642,Herenthoutsesteenweg 2,2023-08-17,02:00:00,6,6,0,ECO_300019380
642,Herenthoutsesteenweg 2,2023-08-17,03:00:00,4,2,2,ECO_300019380
642,Herenthoutsesteenweg 2,2023-08-17,04:00:00,0,0,0,ECO_300019380
642,Herenthoutsesteenweg 2,2023-08-17,05:00:00,0,0,0,ECO_300019380
642,Herenthoutsesteenweg 2,2023-08-17,06:00:00,4,4,0,ECO_300019380
642,Herenthoutsesteenweg 2,2023-08-17,07:00:00,34,27,7,ECO_300019380
642,Herenthoutsesteenweg 2,2023-08-17,08:00:00,66,56,10,ECO_300019380
642,Herenthoutsesteenweg 2,2023-08-17,09:00:00,134,117,17,ECO_300019380
642,Herenthoutsesteenweg 2,2023-08-17,10:00:00,122,119,3,ECO_300019380
642,Herenthoutsesteenweg 2,2023-08-17,11:00:00,121,110,11,ECO_300019380
642,Herenthoutsesteenweg 2,2023-08-17,12:00:00,101,90,11,ECO_300019380
642,Herenthoutsesteenweg 2,2023-08-17,13:00:00,106,87,19,ECO_300019380
642,Herenthoutsesteenweg 2,2023-08-17,14:00:00,117,102,15,ECO_300019380
642,Herenthoutsesteenweg 2,2023-08-17,15:00:00,135,128,7,ECO_300019380
642,Herenthoutsesteenweg 2,2023-08-17,16:00:00,182,159,23,ECO_300019380
642,Herenthoutsesteenweg 2,2023-08-17,17:00:00,142,121,21,ECO_300019380
642,Herenthoutsesteenweg 2,2023-08-17,18:00:00,186,142,44,ECO_300019380
642,Herenthoutsesteenweg 2,2023-08-17,19:00:00,148,120,28,ECO_300019380
642,Herenthoutsesteenweg 2,2023-08-17,20:00:00,90,69,21,ECO_300019380
642,Herenthoutsesteenweg 2,2023-08-17,21:00:00,84,69,15,ECO_300019380
642,Herenthoutsesteenweg 2,2023-08-17,22:00:00,47,41,6,ECO_300019380
642,Herenthoutsesteenweg 2,2023-08-17,23:00:00,57,47,10,ECO_300019380
642,Herenthoutsesteenweg 2,2023-08-18,00:00:00,30,24,6,ECO_300019380
642,Herenthoutsesteenweg 2,2023-08-18,01:00:00,5,3,2,ECO_300019380
642,Herenthoutsesteenweg 2,2023-08-18,02:00:00,3,3,0,ECO_300019380
642,Herenthoutsesteenweg 2,2023-08-18,03:00:00,1,1,0,ECO_300019380
642,Herenthoutsesteenweg 2,2023-08-18,04:00:00,2,1,1,ECO_300019380
642,Herenthoutsesteenweg 2,2023-08-18,05:00:00,1,0,1,ECO_300019380
642,Herenthoutsesteenweg 2,2023-08-18,06:00:00,4,4,0,ECO_300019380
642,Herenthoutsesteenweg 2,2023-08-18,07:00:00,29,22,7,ECO_300019380
642,Herenthoutsesteenweg 2,2023-08-18,08:00:00,53,42,11,ECO_300019380
642,Herenthoutsesteenweg 2,2023-08-18,09:00:00,125,114,11,ECO_300019380
642,Herenthoutsesteenweg 2,2023-08-18,10:00:00,127,117,10,ECO_300019380
642,Herenthoutsesteenweg 2,2023-08-18,11:00:00,148,129,19,ECO_300019380
642,Herenthoutsesteenweg 2,2023-08-18,12:00:00,137,126,11,ECO_300019380
642,Herenthoutsesteenweg 2,2023-08-18,13:00:00,176,154,22,ECO_300019380
642,Herenthoutsesteenweg 2,2023-08-18,14:00:00,128,113,15,ECO_300019380
642,Herenthoutsesteenweg 2,2023-08-18,15:00:00,146,135,11,ECO_300019380
642,Herenthoutsesteenweg 2,2023-08-18,16:00:00,207,178,29,ECO_300019380
642,Herenthoutsesteenweg 2,2023-08-18,17:00:00,183,154,29,ECO_300019380
642,Herenthoutsesteenweg 2,2023-08-18,18:00:00,209,191,18,ECO_300019380
642,Herenthoutsesteenweg 2,2023-08-18,19:00:00,136,122,14,ECO_300019380
642,Herenthoutsesteenweg 2,2023-08-18,20:00:00,128,106,22,ECO_300019380
642,Herenthoutsesteenweg 2,2023-08-18,21:00:00,97,80,17,ECO_300019380
642,Herenthoutsesteenweg 2,2023-08-18,22:00:00,85,74,11,ECO_300019380
642,Herenthoutsesteenweg 2,2023-08-18,23:00:00,35,27,8,ECO_300019380
642,Herenthoutsesteenweg 2,2023-08-19,00:00:00,49,44,5,ECO_300019380
642,Herenthoutsesteenweg 2,2023-08-19,01:00:00,33,14,19,ECO_300019380
642,Herenthoutsesteenweg 2,2023-08-19,02:00:00,28,19,9,ECO_300019380
642,Herenthoutsesteenweg 2,2023-08-19,03:00:00,18,15,3,ECO_300019380
642,Herenthoutsesteenweg 2,2023-08-19,04:00:00,6,3,3,ECO_300019380
642,Herenthoutsesteenweg 2,2023-08-19,05:00:00,5,1,4,ECO_300019380
642,Herenthoutsesteenweg 2,2023-08-19,06:00:00,6,1,5,ECO_300019380
642,Herenthoutsesteenweg 2,2023-08-19,07:00:00,7,7,0,ECO_300019380
642,Herenthoutsesteenweg 2,2023-08-19,08:00:00,21,18,3,ECO_300019380
642,Herenthoutsesteenweg 2,2023-08-19,09:00:00,20,20,0,ECO_300019380
642,Herenthoutsesteenweg 2,2023-08-19,10:00:00,48,43,5,ECO_300019380
642,Herenthoutsesteenweg 2,2023-08-19,11:00:00,96,84,12,ECO_300019380
642,Herenthoutsesteenweg 2,2023-08-19,12:00:00,164,151,13,ECO_300019380
642,Herenthoutsesteenweg 2,2023-08-19,13:00:00,169,151,18,ECO_300019380
642,Herenthoutsesteenweg 2,2023-08-19,14:00:00,104,87,17,ECO_300019380
642,Herenthoutsesteenweg 2,2023-08-19,15:00:00,146,137,9,ECO_300019380
642,Herenthoutsesteenweg 2,2023-08-19,16:00:00,172,144,28,ECO_300019380
642,Herenthoutsesteenweg 2,2023-08-19,17:00:00,130,117,13,ECO_300019380
642,Herenthoutsesteenweg 2,2023-08-19,18:00:00,127,112,15,ECO_300019380
642,Herenthoutsesteenweg 2,2023-08-19,19:00:00,89,75,14,ECO_300019380
642,Herenthoutsesteenweg 2,2023-08-19,20:00:00,108,85,23,ECO_300019380
642,Herenthoutsesteenweg 2,2023-08-19,21:00:00,83,71,12,ECO_300019380
642,Herenthoutsesteenweg 2,2023-08-19,22:00:00,55,46,9,ECO_300019380
642,Herenthoutsesteenweg 2,2023-08-19,23:00:00,78,64,14,ECO_300019380
642,Herenthoutsesteenweg 2,2023-08-20,00:00:00,35,30,5,ECO_300019380
642,Herenthoutsesteenweg 2,2023-08-20,01:00:00,21,21,0,ECO_300019380
642,Herenthoutsesteenweg 2,2023-08-20,02:00:00,30,21,9,ECO_300019380
642,Herenthoutsesteenweg 2,2023-08-20,03:00:00,32,26,6,ECO_300019380
642,Herenthoutsesteenweg 2,2023-08-20,04:00:00,13,11,2,ECO_300019380
642,Herenthoutsesteenweg 2,2023-08-20,05:00:00,2,2,0,ECO_300019380
642,Herenthoutsesteenweg 2,2023-08-20,06:00:00,3,3,0,ECO_300019380
642,Herenthoutsesteenweg 2,2023-08-20,07:00:00,2,2,0,ECO_300019380
642,Herenthoutsesteenweg 2,2023-08-20,08:00:00,14,12,2,ECO_300019380
642,Herenthoutsesteenweg 2,2023-08-20,09:00:00,26,24,2,ECO_300019380
642,Herenthoutsesteenweg 2,2023-08-20,10:00:00,72,67,5,ECO_300019380
642,Herenthoutsesteenweg 2,2023-08-20,11:00:00,164,145,19,ECO_300019380
642,Herenthoutsesteenweg 2,2023-08-20,12:00:00,310,272,38,ECO_300019380
642,Herenthoutsesteenweg 2,2023-08-20,13:00:00,204,159,45,ECO_300019380
642,Herenthoutsesteenweg 2,2023-08-20,14:00:00,146,120,26,ECO_300019380
642,Herenthoutsesteenweg 2,2023-08-20,15:00:00,240,208,32,ECO_300019380
642,Herenthoutsesteenweg 2,2023-08-20,16:00:00,269,251,18,ECO_300019380
642,Herenthoutsesteenweg 2,2023-08-20,17:00:00,206,170,36,ECO_300019380
642,Herenthoutsesteenweg 2,2023-08-20,18:00:00,178,153,25,ECO_300019380
642,Herenthoutsesteenweg 2,2023-08-20,19:00:00,164,146,18,ECO_300019380
642,Herenthoutsesteenweg 2,2023-08-20,20:00:00,143,123,20,ECO_300019380
642,Herenthoutsesteenweg 2,2023-08-20,21:00:00,97,74,23,ECO_300019380
642,Herenthoutsesteenweg 2,2023-08-20,22:00:00,80,67,13,ECO_300019380
642,Herenthoutsesteenweg 2,2023-08-20,23:00:00,79,68,11,ECO_300019380
642,Herenthoutsesteenweg 2,2023-08-21,00:00:00,36,33,3,ECO_300019380
642,Herenthoutsesteenweg 2,2023-08-21,01:00:00,14,12,2,ECO_300019380
642,Herenthoutsesteenweg 2,2023-08-21,02:00:00,4,2,2,ECO_300019380
642,Herenthoutsesteenweg 2,2023-08-21,03:00:00,9,4,5,ECO_300019380
642,Herenthoutsesteenweg 2,2023-08-21,04:00:00,5,5,0,ECO_300019380
642,Herenthoutsesteenweg 2,2023-08-21,05:00:00,5,2,3,ECO_300019380
642,Herenthoutsesteenweg 2,2023-08-21,06:00:00,5,4,1,ECO_300019380
642,Herenthoutsesteenweg 2,2023-08-21,07:00:00,26,24,2,ECO_300019380
642,Herenthoutsesteenweg 2,2023-08-21,08:00:00,57,44,13,ECO_300019380
642,Herenthoutsesteenweg 2,2023-08-21,09:00:00,126,120,6,ECO_300019380
642,Herenthoutsesteenweg 2,2023-08-21,10:00:00,123,121,2,ECO_300019380
642,Herenthoutsesteenweg 2,2023-08-21,11:00:00,117,106,11,ECO_300019380
642,Herenthoutsesteenweg 2,2023-08-21,12:00:00,108,101,7,ECO_300019380
642,Herenthoutsesteenweg 2,2023-08-21,13:00:00,134,121,13,ECO_300019380
642,Herenthoutsesteenweg 2,2023-08-21,14:00:00,120,105,15,ECO_300019380
642,Herenthoutsesteenweg 2,2023-08-21,15:00:00,191,174,17,ECO_300019380
642,Herenthoutsesteenweg 2,2023-08-21,16:00:00,217,193,24,ECO_300019380
642,Herenthoutsesteenweg 2,2023-08-21,17:00:00,203,181,22,ECO_300019380
642,Herenthoutsesteenweg 2,2023-08-21,18:00:00,212,186,26,ECO_300019380
642,Herenthoutsesteenweg 2,2023-08-21,19:00:00,157,129,28,ECO_300019380
642,Herenthoutsesteenweg 2,2023-08-21,20:00:00,128,109,19,ECO_300019380
642,Herenthoutsesteenweg 2,2023-08-21,21:00:00,87,81,6,ECO_300019380
642,Herenthoutsesteenweg 2,2023-08-21,22:00:00,68,48,20,ECO_300019380
642,Herenthoutsesteenweg 2,2023-08-21,23:00:00,39,28,11,ECO_300019380
642,Herenthoutsesteenweg 2,2023-08-22,00:00:00,27,19,8,ECO_300019380
642,Herenthoutsesteenweg 2,2023-08-22,01:00:00,12,8,4,ECO_300019380
642,Herenthoutsesteenweg 2,2023-08-22,02:00:00,6,4,2,ECO_300019380
642,Herenthoutsesteenweg 2,2023-08-22,03:00:00,3,3,0,ECO_300019380
642,Herenthoutsesteenweg 2,2023-08-22,04:00:00,4,1,3,ECO_300019380
642,Herenthoutsesteenweg 2,2023-08-22,05:00:00,2,2,0,ECO_300019380
642,Herenthoutsesteenweg 2,2023-08-22,06:00:00,2,2,0,ECO_300019380
642,Herenthoutsesteenweg 2,2023-08-22,07:00:00,30,25,5,ECO_300019380
642,Herenthoutsesteenweg 2,2023-08-22,08:00:00,76,65,11,ECO_300019380
642,Herenthoutsesteenweg 2,2023-08-22,09:00:00,151,144,7,ECO_300019380
642,Herenthoutsesteenweg 2,2023-08-22,10:00:00,149,146,3,ECO_300019380
642,Herenthoutsesteenweg 2,2023-08-22,11:00:00,125,114,11,ECO_300019380
642,Herenthoutsesteenweg 2,2023-08-22,12:00:00,123,115,8,ECO_300019380
642,Herenthoutsesteenweg 2,2023-08-22,13:00:00,153,141,12,ECO_300019380
642,Herenthoutsesteenweg 2,2023-08-22,14:00:00,153,127,26,ECO_300019380
642,Herenthoutsesteenweg 2,2023-08-22,15:00:00,229,203,26,ECO_300019380
642,Herenthoutsesteenweg 2,2023-08-22,16:00:00,232,208,24,ECO_300019380
642,Herenthoutsesteenweg 2,2023-08-22,17:00:00,161,128,33,ECO_300019380
642,Herenthoutsesteenweg 2,2023-08-22,18:00:00,248,207,41,ECO_300019380
642,Herenthoutsesteenweg 2,2023-08-22,19:00:00,180,140,40,ECO_300019380
642,Herenthoutsesteenweg 2,2023-08-22,20:00:00,119,101,18,ECO_300019380
642,Herenthoutsesteenweg 2,2023-08-22,21:00:00,123,101,22,ECO_300019380
642,Herenthoutsesteenweg 2,2023-08-22,22:00:00,65,49,16,ECO_300019380
642,Herenthoutsesteenweg 2,2023-08-22,23:00:00,41,36,5,ECO_300019380
642,Herenthoutsesteenweg 2,2023-08-23,00:00:00,37,32,5,ECO_300019380
642,Herenthoutsesteenweg 2,2023-08-23,01:00:00,22,8,14,ECO_300019380
642,Herenthoutsesteenweg 2,2023-08-23,02:00:00,10,7,3,ECO_300019380
642,Herenthoutsesteenweg 2,2023-08-23,03:00:00,2,1,1,ECO_300019380
642,Herenthoutsesteenweg 2,2023-08-23,04:00:00,3,2,1,ECO_300019380
642,Herenthoutsesteenweg 2,2023-08-23,05:00:00,0,0,0,ECO_300019380
642,Herenthoutsesteenweg 2,2023-08-23,06:00:00,5,5,0,ECO_300019380
642,Herenthoutsesteenweg 2,2023-08-23,07:00:00,29,27,2,ECO_300019380
642,Herenthoutsesteenweg 2,2023-08-23,08:00:00,82,68,14,ECO_300019380
642,Herenthoutsesteenweg 2,2023-08-23,09:00:00,134,127,7,ECO_300019380
642,Herenthoutsesteenweg 2,2023-08-23,10:00:00,137,129,8,ECO_300019380
642,Herenthoutsesteenweg 2,2023-08-23,11:00:00,123,115,8,ECO_300019380
642,Herenthoutsesteenweg 2,2023-08-23,12:00:00,151,138,13,ECO_300019380
642,Herenthoutsesteenweg 2,2023-08-23,13:00:00,142,121,21,ECO_300019380
642,Herenthoutsesteenweg 2,2023-08-23,14:00:00,125,107,18,ECO_300019380
642,Herenthoutsesteenweg 2,2023-08-23,15:00:00,171,153,18,ECO_300019380
642,Herenthoutsesteenweg 2,2023-08-23,16:00:00,241,213,28,ECO_300019380
642,Herenthoutsesteenweg 2,2023-08-23,17:00:00,176,160,16,ECO_300019380
642,Herenthoutsesteenweg 2,2023-08-23,18:00:00,252,223,29,ECO_300019380
642,Herenthoutsesteenweg 2,2023-08-23,19:00:00,169,142,27,ECO_300019380
642,Herenthoutsesteenweg 2,2023-08-23,20:00:00,149,132,17,ECO_300019380
642,Herenthoutsesteenweg 2,2023-08-23,21:00:00,143,111,32,ECO_300019380
642,Herenthoutsesteenweg 2,2023-08-23,22:00:00,99,82,17,ECO_300019380
642,Herenthoutsesteenweg 2,2023-08-23,23:00:00,77,60,17,ECO_300019380
642,Herenthoutsesteenweg 2,2023-08-24,00:00:00,43,35,8,ECO_300019380
642,Herenthoutsesteenweg 2,2023-08-24,01:00:00,15,10,5,ECO_300019380
642,Herenthoutsesteenweg 2,2023-08-24,02:00:00,5,4,1,ECO_300019380
642,Herenthoutsesteenweg 2,2023-08-24,03:00:00,3,2,1,ECO_300019380
642,Herenthoutsesteenweg 2,2023-08-24,04:00:00,2,1,1,ECO_300019380
642,Herenthoutsesteenweg 2,2023-08-24,05:00:00,0,0,0,ECO_300019380
642,Herenthoutsesteenweg 2,2023-08-24,06:00:00,6,4,2,ECO_300019380
642,Herenthoutsesteenweg 2,2023-08-24,07:00:00,17,17,0,ECO_300019380
642,Herenthoutsesteenweg 2,2023-08-24,08:00:00,59,52,7,ECO_300019380
642,Herenthoutsesteenweg 2,2023-08-24,09:00:00,130,119,11,ECO_300019380
642,Herenthoutsesteenweg 2,2023-08-24,10:00:00,141,135,6,ECO_300019380
642,Herenthoutsesteenweg 2,2023-08-24,11:00:00,114,101,13,ECO_300019380
642,Herenthoutsesteenweg 2,2023-08-24,12:00:00,134,125,9,ECO_300019380
642,Herenthoutsesteenweg 2,2023-08-24,13:00:00,105,94,11,ECO_300019380
642,Herenthoutsesteenweg 2,2023-08-24,14:00:00,77,59,18,ECO_300019380
642,Herenthoutsesteenweg 2,2023-08-24,15:00:00,67,61,6,ECO_300019380
642,Herenthoutsesteenweg 2,2023-08-24,16:00:00,98,90,8,ECO_300019380
642,Herenthoutsesteenweg 2,2023-08-24,17:00:00,85,70,15,ECO_300019380
642,Herenthoutsesteenweg 2,2023-08-24,18:00:00,139,121,18,ECO_300019380
642,Herenthoutsesteenweg 2,2023-08-24,19:00:00,123,103,20,ECO_300019380
642,Herenthoutsesteenweg 2,2023-08-24,20:00:00,99,89,10,ECO_300019380
642,Herenthoutsesteenweg 2,2023-08-24,21:00:00,83,70,13,ECO_300019380
642,Herenthoutsesteenweg 2,2023-08-24,22:00:00,43,35,8,ECO_300019380
642,Herenthoutsesteenweg 2,2023-08-24,23:00:00,31,23,8,ECO_300019380
642,Herenthoutsesteenweg 2,2023-08-25,00:00:00,22,19,3,ECO_300019380
642,Herenthoutsesteenweg 2,2023-08-25,01:00:00,9,6,3,ECO_300019380
642,Herenthoutsesteenweg 2,2023-08-25,02:00:00,6,3,3,ECO_300019380
642,Herenthoutsesteenweg 2,2023-08-25,03:00:00,1,0,1,ECO_300019380
642,Herenthoutsesteenweg 2,2023-08-25,04:00:00,3,0,3,ECO_300019380
642,Herenthoutsesteenweg 2,2023-08-25,05:00:00,1,1,0,ECO_300019380
642,Herenthoutsesteenweg 2,2023-08-25,06:00:00,6,6,0,ECO_300019380
642,Herenthoutsesteenweg 2,2023-08-25,07:00:00,22,21,1,ECO_300019380
642,Herenthoutsesteenweg 2,2023-08-25,08:00:00,51,40,11,ECO_300019380
642,Herenthoutsesteenweg 2,2023-08-25,09:00:00,80,69,11,ECO_300019380
642,Herenthoutsesteenweg 2,2023-08-25,10:00:00,36,36,0,ECO_300019380
642,Herenthoutsesteenweg 2,2023-08-25,11:00:00,32,30,2,ECO_300019380
642,Herenthoutsesteenweg 2,2023-08-25,12:00:00,28,23,5,ECO_300019380
642,Herenthoutsesteenweg 2,2023-08-25,13:00:00,57,55,2,ECO_300019380
642,Herenthoutsesteenweg 2,2023-08-25,14:00:00,56,45,11,ECO_300019380
642,Herenthoutsesteenweg 2,2023-08-25,15:00:00,52,44,8,ECO_300019380
642,Herenthoutsesteenweg 2,2023-08-25,16:00:00,112,94,18,ECO_300019380
642,Herenthoutsesteenweg 2,2023-08-25,17:00:00,95,85,10,ECO_300019380
642,Herenthoutsesteenweg 2,2023-08-25,18:00:00,96,91,5,ECO_300019380
642,Herenthoutsesteenweg 2,2023-08-25,19:00:00,65,54,11,ECO_300019380
642,Herenthoutsesteenweg 2,2023-08-25,20:00:00,66,55,11,ECO_300019380
642,Herenthoutsesteenweg 2,2023-08-25,21:00:00,45,38,7,ECO_300019380
642,Herenthoutsesteenweg 2,2023-08-25,22:00:00,63,62,1,ECO_300019380
642,Herenthoutsesteenweg 2,2023-08-25,23:00:00,66,62,4,ECO_300019380
642,Herenthoutsesteenweg 2,2023-08-26,00:00:00,35,32,3,ECO_300019380
642,Herenthoutsesteenweg 2,2023-08-26,01:00:00,25,20,5,ECO_300019380
642,Herenthoutsesteenweg 2,2023-08-26,02:00:00,16,14,2,ECO_300019380
642,Herenthoutsesteenweg 2,2023-08-26,03:00:00,6,2,4,ECO_300019380
642,Herenthoutsesteenweg 2,2023-08-26,04:00:00,10,9,1,ECO_300019380
642,Herenthoutsesteenweg 2,2023-08-26,05:00:00,0,0,0,ECO_300019380
642,Herenthoutsesteenweg 2,2023-08-26,06:00:00,4,2,2,ECO_300019380
642,Herenthoutsesteenweg 2,2023-08-26,07:00:00,1,1,0,ECO_300019380
642,Herenthoutsesteenweg 2,2023-08-26,08:00:00,12,10,2,ECO_300019380
642,Herenthoutsesteenweg 2,2023-08-26,09:00:00,20,16,4,ECO_300019380
642,Herenthoutsesteenweg 2,2023-08-26,10:00:00,65,60,5,ECO_300019380
642,Herenthoutsesteenweg 2,2023-08-26,11:00:00,93,90,3,ECO_300019380
642,Herenthoutsesteenweg 2,2023-08-26,12:00:00,114,105,9,ECO_300019380
642,Herenthoutsesteenweg 2,2023-08-26,13:00:00,119,95,24,ECO_300019380
642,Herenthoutsesteenweg 2,2023-08-26,14:00:00,105,94,11,ECO_300019380
642,Herenthoutsesteenweg 2,2023-08-26,15:00:00,156,139,17,ECO_300019380
642,Herenthoutsesteenweg 2,2023-08-26,16:00:00,150,141,9,ECO_300019380
642,Herenthoutsesteenweg 2,2023-08-26,17:00:00,134,116,18,ECO_300019380
642,Herenthoutsesteenweg 2,2023-08-26,18:00:00,94,82,12,ECO_300019380
642,Herenthoutsesteenweg 2,2023-08-26,19:00:00,79,64,15,ECO_300019380
642,Herenthoutsesteenweg 2,2023-08-26,20:00:00,54,41,13,ECO_300019380
642,Herenthoutsesteenweg 2,2023-08-26,21:00:00,46,39,7,ECO_300019380
642,Herenthoutsesteenweg 2,2023-08-26,22:00:00,62,51,11,ECO_300019380
642,Herenthoutsesteenweg 2,2023-08-26,23:00:00,47,42,5,ECO_300019380
642,Herenthoutsesteenweg 2,2023-08-27,00:00:00,30,27,3,ECO_300019380
642,Herenthoutsesteenweg 2,2023-08-27,01:00:00,24,18,6,ECO_300019380
642,Herenthoutsesteenweg 2,2023-08-27,02:00:00,18,16,2,ECO_300019380
642,Herenthoutsesteenweg 2,2023-08-27,03:00:00,23,15,8,ECO_300019380
642,Herenthoutsesteenweg 2,2023-08-27,04:00:00,8,6,2,ECO_300019380
642,Herenthoutsesteenweg 2,2023-08-27,05:00:00,6,4,2,ECO_300019380
642,Herenthoutsesteenweg 2,2023-08-27,06:00:00,2,1,1,ECO_300019380
642,Herenthoutsesteenweg 2,2023-08-27,07:00:00,1,1,0,ECO_300019380
642,Herenthoutsesteenweg 2,2023-08-27,08:00:00,6,6,0,ECO_300019380
642,Herenthoutsesteenweg 2,2023-08-27,09:00:00,21,20,1,ECO_300019380
642,Herenthoutsesteenweg 2,2023-08-27,10:00:00,64,53,11,ECO_300019380
642,Herenthoutsesteenweg 2,2023-08-27,11:00:00,128,116,12,ECO_300019380
642,Herenthoutsesteenweg 2,2023-08-27,12:00:00,227,215,12,ECO_300019380
642,Herenthoutsesteenweg 2,2023-08-27,13:00:00,185,161,24,ECO_300019380
642,Herenthoutsesteenweg 2,2023-08-27,14:00:00,131,127,4,ECO_300019380
642,Herenthoutsesteenweg 2,2023-08-27,15:00:00,144,138,6,ECO_300019380
642,Herenthoutsesteenweg 2,2023-08-27,16:00:00,62,58,4,ECO_300019380
642,Herenthoutsesteenweg 2,2023-08-27,17:00:00,62,53,9,ECO_300019380
642,Herenthoutsesteenweg 2,2023-08-27,18:00:00,87,83,4,ECO_300019380
642,Herenthoutsesteenweg 2,2023-08-27,19:00:00,68,61,7,ECO_300019380
642,Herenthoutsesteenweg 2,2023-08-27,20:00:00,63,54,9,ECO_300019380
642,Herenthoutsesteenweg 2,2023-08-27,21:00:00,39,34,5,ECO_300019380
642,Herenthoutsesteenweg 2,2023-08-27,22:00:00,28,24,4,ECO_300019380
642,Herenthoutsesteenweg 2,2023-08-27,23:00:00,24,17,7,ECO_300019380
642,Herenthoutsesteenweg 2,2023-08-28,00:00:00,17,15,2,ECO_300019380
642,Herenthoutsesteenweg 2,2023-08-28,01:00:00,5,2,3,ECO_300019380
642,Herenthoutsesteenweg 2,2023-08-28,02:00:00,6,6,0,ECO_300019380
642,Herenthoutsesteenweg 2,2023-08-28,03:00:00,1,0,1,ECO_300019380
642,Herenthoutsesteenweg 2,2023-08-28,04:00:00,0,0,0,ECO_300019380
642,Herenthoutsesteenweg 2,2023-08-28,05:00:00,2,2,0,ECO_300019380
642,Herenthoutsesteenweg 2,2023-08-28,06:00:00,4,4,0,ECO_300019380
642,Herenthoutsesteenweg 2,2023-08-28,07:00:00,31,24,7,ECO_300019380
642,Herenthoutsesteenweg 2,2023-08-28,08:00:00,56,48,8,ECO_300019380
642,Herenthoutsesteenweg 2,2023-08-28,09:00:00,107,98,9,ECO_300019380
642,Herenthoutsesteenweg 2,2023-08-28,10:00:00,120,113,7,ECO_300019380
642,Herenthoutsesteenweg 2,2023-08-28,11:00:00,92,83,9,ECO_300019380
642,Herenthoutsesteenweg 2,2023-08-28,12:00:00,76,68,8,ECO_300019380
642,Herenthoutsesteenweg 2,2023-08-28,13:00:00,93,86,7,ECO_300019380
642,Herenthoutsesteenweg 2,2023-08-28,14:00:00,77,60,17,ECO_300019380
642,Herenthoutsesteenweg 2,2023-08-28,15:00:00,126,115,11,ECO_300019380
642,Herenthoutsesteenweg 2,2023-08-28,16:00:00,162,150,12,ECO_300019380
642,Herenthoutsesteenweg 2,2023-08-28,17:00:00,107,99,8,ECO_300019380
642,Herenthoutsesteenweg 2,2023-08-28,18:00:00,119,104,15,ECO_300019380
642,Herenthoutsesteenweg 2,2023-08-28,19:00:00,81,70,11,ECO_300019380
642,Herenthoutsesteenweg 2,2023-08-28,20:00:00,59,52,7,ECO_300019380
642,Herenthoutsesteenweg 2,2023-08-28,21:00:00,49,41,8,ECO_300019380
642,Herenthoutsesteenweg 2,2023-08-28,22:00:00,18,14,4,ECO_300019380
642,Herenthoutsesteenweg 2,2023-08-28,23:00:00,21,17,4,ECO_300019380
642,Herenthoutsesteenweg 2,2023-08-29,00:00:00,21,19,2,ECO_300019380
642,Herenthoutsesteenweg 2,2023-08-29,01:00:00,5,3,2,ECO_300019380
642,Herenthoutsesteenweg 2,2023-08-29,02:00:00,10,10,0,ECO_300019380
642,Herenthoutsesteenweg 2,2023-08-29,03:00:00,3,2,1,ECO_300019380
642,Herenthoutsesteenweg 2,2023-08-29,04:00:00,0,0,0,ECO_300019380
642,Herenthoutsesteenweg 2,2023-08-29,05:00:00,0,0,0,ECO_300019380
642,Herenthoutsesteenweg 2,2023-08-29,06:00:00,4,4,0,ECO_300019380
642,Herenthoutsesteenweg 2,2023-08-29,07:00:00,25,22,3,ECO_300019380
642,Herenthoutsesteenweg 2,2023-08-29,08:00:00,59,53,6,ECO_300019380
642,Herenthoutsesteenweg 2,2023-08-29,09:00:00,129,123,6,ECO_300019380
642,Herenthoutsesteenweg 2,2023-08-29,10:00:00,115,109,6,ECO_300019380
642,Herenthoutsesteenweg 2,2023-08-29,11:00:00,106,99,7,ECO_300019380
642,Herenthoutsesteenweg 2,2023-08-29,12:00:00,106,100,6,ECO_300019380
642,Herenthoutsesteenweg 2,2023-08-29,13:00:00,109,104,5,ECO_300019380
642,Herenthoutsesteenweg 2,2023-08-29,14:00:00,124,111,13,ECO_300019380
642,Herenthoutsesteenweg 2,2023-08-29,15:00:00,185,158,27,ECO_300019380
642,Herenthoutsesteenweg 2,2023-08-29,16:00:00,164,158,6,ECO_300019380
642,Herenthoutsesteenweg 2,2023-08-29,17:00:00,133,118,15,ECO_300019380
642,Herenthoutsesteenweg 2,2023-08-29,18:00:00,155,144,11,ECO_300019380
642,Herenthoutsesteenweg 2,2023-08-29,19:00:00,123,112,11,ECO_300019380
642,Herenthoutsesteenweg 2,2023-08-29,20:00:00,81,71,10,ECO_300019380
642,Herenthoutsesteenweg 2,2023-08-29,21:00:00,96,87,9,ECO_300019380
642,Herenthoutsesteenweg 2,2023-08-29,22:00:00,53,49,4,ECO_300019380
642,Herenthoutsesteenweg 2,2023-08-29,23:00:00,30,27,3,ECO_300019380
642,Herenthoutsesteenweg 2,2023-08-30,00:00:00,27,20,7,ECO_300019380
642,Herenthoutsesteenweg 2,2023-08-30,01:00:00,9,6,3,ECO_300019380
642,Herenthoutsesteenweg 2,2023-08-30,02:00:00,13,11,2,ECO_300019380
642,Herenthoutsesteenweg 2,2023-08-30,03:00:00,4,4,0,ECO_300019380
642,Herenthoutsesteenweg 2,2023-08-30,04:00:00,2,1,1,ECO_300019380
642,Herenthoutsesteenweg 2,2023-08-30,05:00:00,2,2,0,ECO_300019380
642,Herenthoutsesteenweg 2,2023-08-30,06:00:00,3,3,0,ECO_300019380
642,Herenthoutsesteenweg 2,2023-08-30,07:00:00,24,22,2,ECO_300019380
642,Herenthoutsesteenweg 2,2023-08-30,08:00:00,51,43,8,ECO_300019380
642,Herenthoutsesteenweg 2,2023-08-30,09:00:00,82,79,3,ECO_300019380
642,Herenthoutsesteenweg 2,2023-08-30,10:00:00,54,54,0,ECO_300019380
642,Herenthoutsesteenweg 2,2023-08-30,11:00:00,43,43,0,ECO_300019380
642,Herenthoutsesteenweg 2,2023-08-30,12:00:00,28,28,0,ECO_300019380
642,Herenthoutsesteenweg 2,2023-08-30,13:00:00,54,53,1,ECO_300019380
642,Herenthoutsesteenweg 2,2023-08-30,14:00:00,68,61,7,ECO_300019380
642,Herenthoutsesteenweg 2,2023-08-30,15:00:00,74,69,5,ECO_300019380
642,Herenthoutsesteenweg 2,2023-08-30,16:00:00,114,108,6,ECO_300019380
642,Herenthoutsesteenweg 2,2023-08-30,17:00:00,91,83,8,ECO_300019380
642,Herenthoutsesteenweg 2,2023-08-30,18:00:00,141,126,15,ECO_300019380
642,Herenthoutsesteenweg 2,2023-08-30,19:00:00,91,77,14,ECO_300019380
642,Herenthoutsesteenweg 2,2023-08-30,20:00:00,125,120,5,ECO_300019380
642,Herenthoutsesteenweg 2,2023-08-30,21:00:00,108,86,22,ECO_300019380
642,Herenthoutsesteenweg 2,2023-08-30,22:00:00,52,39,13,ECO_300019380
642,Herenthoutsesteenweg 2,2023-08-30,23:00:00,45,39,6,ECO_300019380
642,Herenthoutsesteenweg 2,2023-08-31,00:00:00,21,19,2,ECO_300019380
642,Herenthoutsesteenweg 2,2023-08-31,01:00:00,14,9,5,ECO_300019380
642,Herenthoutsesteenweg 2,2023-08-31,02:00:00,7,6,1,ECO_300019380
642,Herenthoutsesteenweg 2,2023-08-31,03:00:00,1,1,0,ECO_300019380
642,Herenthoutsesteenweg 2,2023-08-31,04:00:00,0,0,0,ECO_300019380
642,Herenthoutsesteenweg 2,2023-08-31,05:00:00,0,0,0,ECO_300019380
642,Herenthoutsesteenweg 2,2023-08-31,06:00:00,4,4,0,ECO_300019380
642,Herenthoutsesteenweg 2,2023-08-31,07:00:00,28,25,3,ECO_300019380
642,Herenthoutsesteenweg 2,2023-08-31,08:00:00,57,46,11,ECO_300019380
642,Herenthoutsesteenweg 2,2023-08-31,09:00:00,121,116,5,ECO_300019380
642,Herenthoutsesteenweg 2,2023-08-31,10:00:00,116,110,6,ECO_300019380
642,Herenthoutsesteenweg 2,2023-08-31,11:00:00,111,105,6,ECO_300019380
642,Herenthoutsesteenweg 2,2023-08-31,12:00:00,128,120,8,ECO_300019380
642,Herenthoutsesteenweg 2,2023-08-31,13:00:00,126,115,11,ECO_300019380
642,Herenthoutsesteenweg 2,2023-08-31,14:00:00,116,108,8,ECO_300019380
642,Herenthoutsesteenweg 2,2023-08-31,15:00:00,134,128,6,ECO_300019380
642,Herenthoutsesteenweg 2,2023-08-31,16:00:00,153,144,9,ECO_300019380
642,Herenthoutsesteenweg 2,2023-08-31,17:00:00,145,135,10,ECO_300019380
642,Herenthoutsesteenweg 2,2023-08-31,18:00:00,165,150,15,ECO_300019380
642,Herenthoutsesteenweg 2,2023-08-31,19:00:00,122,114,8,ECO_300019380
642,Herenthoutsesteenweg 2,2023-08-31,20:00:00,82,73,9,ECO_300019380
642,Herenthoutsesteenweg 2,2023-08-31,21:00:00,75,60,15,ECO_300019380
642,Herenthoutsesteenweg 2,2023-08-31,22:00:00,36,28,8,ECO_300019380
642,Herenthoutsesteenweg 2,2023-08-31,23:00:00,41,30,11,ECO_300019380
642,Herenthoutsesteenweg 2,2023-09-01,00:00:00,23,21,2,ECO_300019380
642,Herenthoutsesteenweg 2,2023-09-01,01:00:00,15,12,3,ECO_300019380
642,Herenthoutsesteenweg 2,2023-09-01,02:00:00,5,2,3,ECO_300019380
642,Herenthoutsesteenweg 2,2023-09-01,03:00:00,1,1,0,ECO_300019380
642,Herenthoutsesteenweg 2,2023-09-01,04:00:00,1,1,0,ECO_300019380
642,Herenthoutsesteenweg 2,2023-09-01,05:00:00,0,0,0,ECO_300019380
642,Herenthoutsesteenweg 2,2023-09-01,06:00:00,3,3,0,ECO_300019380
642,Herenthoutsesteenweg 2,2023-09-01,07:00:00,16,15,1,ECO_300019380
642,Herenthoutsesteenweg 2,2023-09-01,08:00:00,40,33,7,ECO_300019380
642,Herenthoutsesteenweg 2,2023-09-01,09:00:00,67,65,2,ECO_300019380
642,Herenthoutsesteenweg 2,2023-09-01,10:00:00,183,182,1,ECO_300019380
642,Herenthoutsesteenweg 2,2023-09-01,11:00:00,119,116,3,ECO_300019380
642,Herenthoutsesteenweg 2,2023-09-01,12:00:00,82,81,1,ECO_300019380
642,Herenthoutsesteenweg 2,2023-09-01,13:00:00,18,17,1,ECO_300019380
642,Herenthoutsesteenweg 2,2023-09-01,14:00:00,95,88,7,ECO_300019380
642,Herenthoutsesteenweg 2,2023-09-01,15:00:00,57,55,2,ECO_300019380
642,Herenthoutsesteenweg 2,2023-09-01,16:00:00,93,83,10,ECO_300019380
642,Herenthoutsesteenweg 2,2023-09-01,17:00:00,121,115,6,ECO_300019380
642,Herenthoutsesteenweg 2,2023-09-01,18:00:00,111,103,8,ECO_300019380
642,Herenthoutsesteenweg 2,2023-09-01,19:00:00,83,80,3,ECO_300019380
642,Herenthoutsesteenweg 2,2023-09-01,20:00:00,66,58,8,ECO_300019380
642,Herenthoutsesteenweg 2,2023-09-01,21:00:00,65,59,6,ECO_300019380
642,Herenthoutsesteenweg 2,2023-09-01,22:00:00,49,45,4,ECO_300019380
642,Herenthoutsesteenweg 2,2023-09-01,23:00:00,28,24,4,ECO_300019380
642,Herenthoutsesteenweg 2,2023-09-02,00:00:00,27,24,3,ECO_300019380
642,Herenthoutsesteenweg 2,2023-09-02,01:00:00,11,9,2,ECO_300019380
642,Herenthoutsesteenweg 2,2023-09-02,02:00:00,9,4,5,ECO_300019380
642,Herenthoutsesteenweg 2,2023-09-02,03:00:00,15,14,1,ECO_300019380
642,Herenthoutsesteenweg 2,2023-09-02,04:00:00,2,1,1,ECO_300019380
642,Herenthoutsesteenweg 2,2023-09-02,05:00:00,7,4,3,ECO_300019380
642,Herenthoutsesteenweg 2,2023-09-02,06:00:00,2,2,0,ECO_300019380
642,Herenthoutsesteenweg 2,2023-09-02,07:00:00,3,3,0,ECO_300019380
642,Herenthoutsesteenweg 2,2023-09-02,08:00:00,20,16,4,ECO_300019380
642,Herenthoutsesteenweg 2,2023-09-02,09:00:00,25,22,3,ECO_300019380
642,Herenthoutsesteenweg 2,2023-09-02,10:00:00,56,51,5,ECO_300019380
642,Herenthoutsesteenweg 2,2023-09-02,11:00:00,111,102,9,ECO_300019380
642,Herenthoutsesteenweg 2,2023-09-02,12:00:00,105,97,8,ECO_300019380
642,Herenthoutsesteenweg 2,2023-09-02,13:00:00,110,103,7,ECO_300019380
642,Herenthoutsesteenweg 2,2023-09-02,14:00:00,150,129,21,ECO_300019380
642,Herenthoutsesteenweg 2,2023-09-02,15:00:00,225,207,18,ECO_300019380
642,Herenthoutsesteenweg 2,2023-09-02,16:00:00,238,220,18,ECO_300019380
642,Herenthoutsesteenweg 2,2023-09-02,17:00:00,188,165,23,ECO_300019380
642,Herenthoutsesteenweg 2,2023-09-02,18:00:00,153,140,13,ECO_300019380
642,Herenthoutsesteenweg 2,2023-09-02,19:00:00,112,96,16,ECO_300019380
642,Herenthoutsesteenweg 2,2023-09-02,20:00:00,70,61,9,ECO_300019380
642,Herenthoutsesteenweg 2,2023-09-02,21:00:00,79,58,21,ECO_300019380
642,Herenthoutsesteenweg 2,2023-09-02,22:00:00,77,68,9,ECO_300019380
642,Herenthoutsesteenweg 2,2023-09-02,23:00:00,35,30,5,ECO_300019380
642,Herenthoutsesteenweg 2,2023-09-03,00:00:00,11,10,1,ECO_300019380
642,Herenthoutsesteenweg 2,2023-09-03,01:00:00,19,15,4,ECO_300019380
642,Herenthoutsesteenweg 2,2023-09-03,02:00:00,19,13,6,ECO_300019380
642,Herenthoutsesteenweg 2,2023-09-03,03:00:00,17,14,3,ECO_300019380
642,Herenthoutsesteenweg 2,2023-09-03,04:00:00,2,2,0,ECO_300019380
642,Herenthoutsesteenweg 2,2023-09-03,05:00:00,5,4,1,ECO_300019380
642,Herenthoutsesteenweg 2,2023-09-03,06:00:00,1,0,1,ECO_300019380
642,Herenthoutsesteenweg 2,2023-09-03,07:00:00,0,0,0,ECO_300019380
642,Herenthoutsesteenweg 2,2023-09-03,08:00:00,23,20,3,ECO_300019380
642,Herenthoutsesteenweg 2,2023-09-03,09:00:00,26,22,4,ECO_300019380
642,Herenthoutsesteenweg 2,2023-09-03,10:00:00,102,90,12,ECO_300019380
642,Herenthoutsesteenweg 2,2023-09-03,11:00:00,155,138,17,ECO_300019380
642,Herenthoutsesteenweg 2,2023-09-03,12:00:00,204,179,25,ECO_300019380
642,Herenthoutsesteenweg 2,2023-09-03,13:00:00,161,129,32,ECO_300019380
642,Herenthoutsesteenweg 2,2023-09-03,14:00:00,118,95,23,ECO_300019380
642,Herenthoutsesteenweg 2,2023-09-03,15:00:00,185,170,15,ECO_300019380
642,Herenthoutsesteenweg 2,2023-09-03,16:00:00,284,274,10,ECO_300019380
642,Herenthoutsesteenweg 2,2023-09-03,17:00:00,194,182,12,ECO_300019380
642,Herenthoutsesteenweg 2,2023-09-03,18:00:00,159,136,23,ECO_300019380
642,Herenthoutsesteenweg 2,2023-09-03,19:00:00,124,105,19,ECO_300019380
642,Herenthoutsesteenweg 2,2023-09-03,20:00:00,113,96,17,ECO_300019380
642,Herenthoutsesteenweg 2,2023-09-03,21:00:00,103,88,15,ECO_300019380
642,Herenthoutsesteenweg 2,2023-09-03,22:00:00,49,40,9,ECO_300019380
642,Herenthoutsesteenweg 2,2023-09-03,23:00:00,16,10,6,ECO_300019380
642,Herenthoutsesteenweg 2,2023-09-04,00:00:00,7,6,1,ECO_300019380
642,Herenthoutsesteenweg 2,2023-09-04,01:00:00,5,4,1,ECO_300019380
642,Herenthoutsesteenweg 2,2023-09-04,02:00:00,2,1,1,ECO_300019380
642,Herenthoutsesteenweg 2,2023-09-04,03:00:00,2,1,1,ECO_300019380
642,Herenthoutsesteenweg 2,2023-09-04,04:00:00,0,0,0,ECO_300019380
642,Herenthoutsesteenweg 2,2023-09-04,05:00:00,0,0,0,ECO_300019380
642,Herenthoutsesteenweg 2,2023-09-04,06:00:00,3,3,0,ECO_300019380
642,Herenthoutsesteenweg 2,2023-09-04,07:00:00,26,22,4,ECO_300019380
642,Herenthoutsesteenweg 2,2023-09-04,08:00:00,60,50,10,ECO_300019380
642,Herenthoutsesteenweg 2,2023-09-04,09:00:00,239,226,13,ECO_300019380
642,Herenthoutsesteenweg 2,2023-09-04,10:00:00,730,714,16,ECO_300019380
642,Herenthoutsesteenweg 2,2023-09-04,11:00:00,122,112,10,ECO_300019380
642,Herenthoutsesteenweg 2,2023-09-04,12:00:00,107,98,9,ECO_300019380
642,Herenthoutsesteenweg 2,2023-09-04,13:00:00,117,107,10,ECO_300019380
642,Herenthoutsesteenweg 2,2023-09-04,14:00:00,111,96,15,ECO_300019380
642,Herenthoutsesteenweg 2,2023-09-04,15:00:00,197,185,12,ECO_300019380
642,Herenthoutsesteenweg 2,2023-09-04,16:00:00,155,143,12,ECO_300019380
642,Herenthoutsesteenweg 2,2023-09-04,17:00:00,228,214,14,ECO_300019380
642,Herenthoutsesteenweg 2,2023-09-04,18:00:00,213,190,23,ECO_300019380
642,Herenthoutsesteenweg 2,2023-09-04,19:00:00,169,156,13,ECO_300019380
642,Herenthoutsesteenweg 2,2023-09-04,20:00:00,138,118,20,ECO_300019380
642,Herenthoutsesteenweg 2,2023-09-04,21:00:00,96,86,10,ECO_300019380
642,Herenthoutsesteenweg 2,2023-09-04,22:00:00,63,45,18,ECO_300019380
642,Herenthoutsesteenweg 2,2023-09-04,23:00:00,24,22,2,ECO_300019380
642,Herenthoutsesteenweg 2,2023-09-05,00:00:00,19,17,2,ECO_300019380
642,Herenthoutsesteenweg 2,2023-09-05,01:00:00,5,2,3,ECO_300019380
642,Herenthoutsesteenweg 2,2023-09-05,02:00:00,1,1,0,ECO_300019380
642,Herenthoutsesteenweg 2,2023-09-05,03:00:00,2,2,0,ECO_300019380
642,Herenthoutsesteenweg 2,2023-09-05,04:00:00,0,0,0,ECO_300019380
642,Herenthoutsesteenweg 2,2023-09-05,05:00:00,2,1,1,ECO_300019380
642,Herenthoutsesteenweg 2,2023-09-05,06:00:00,3,2,1,ECO_300019380
642,Herenthoutsesteenweg 2,2023-09-05,07:00:00,27,25,2,ECO_300019380
642,Herenthoutsesteenweg 2,2023-09-05,08:00:00,78,71,7,ECO_300019380
642,Herenthoutsesteenweg 2,2023-09-05,09:00:00,236,231,5,ECO_300019380
642,Herenthoutsesteenweg 2,2023-09-05,10:00:00,747,734,13,ECO_300019380
642,Herenthoutsesteenweg 2,2023-09-05,11:00:00,139,130,9,ECO_300019380
642,Herenthoutsesteenweg 2,2023-09-05,12:00:00,136,124,12,ECO_300019380
642,Herenthoutsesteenweg 2,2023-09-05,13:00:00,108,101,7,ECO_300019380
642,Herenthoutsesteenweg 2,2023-09-05,14:00:00,111,104,7,ECO_300019380
642,Herenthoutsesteenweg 2,2023-09-05,15:00:00,170,158,12,ECO_300019380
642,Herenthoutsesteenweg 2,2023-09-05,16:00:00,200,180,20,ECO_300019380
642,Herenthoutsesteenweg 2,2023-09-05,17:00:00,242,210,32,ECO_300019380
642,Herenthoutsesteenweg 2,2023-09-05,18:00:00,256,227,29,ECO_300019380
642,Herenthoutsesteenweg 2,2023-09-05,19:00:00,160,143,17,ECO_300019380
642,Herenthoutsesteenweg 2,2023-09-05,20:00:00,142,127,15,ECO_300019380
642,Herenthoutsesteenweg 2,2023-09-05,21:00:00,135,123,12,ECO_300019380
642,Herenthoutsesteenweg 2,2023-09-05,22:00:00,92,82,10,ECO_300019380
642,Herenthoutsesteenweg 2,2023-09-05,23:00:00,47,41,6,ECO_300019380
642,Herenthoutsesteenweg 2,2023-09-06,00:00:00,37,28,9,ECO_300019380
642,Herenthoutsesteenweg 2,2023-09-06,01:00:00,10,6,4,ECO_300019380
642,Herenthoutsesteenweg 2,2023-09-06,02:00:00,6,2,4,ECO_300019380
642,Herenthoutsesteenweg 2,2023-09-06,03:00:00,3,1,2,ECO_300019380
642,Herenthoutsesteenweg 2,2023-09-06,04:00:00,0,0,0,ECO_300019380
642,Herenthoutsesteenweg 2,2023-09-06,05:00:00,0,0,0,ECO_300019380
642,Herenthoutsesteenweg 2,2023-09-06,06:00:00,2,2,0,ECO_300019380
642,Herenthoutsesteenweg 2,2023-09-06,07:00:00,31,29,2,ECO_300019380
642,Herenthoutsesteenweg 2,2023-09-06,08:00:00,82,71,11,ECO_300019380
642,Herenthoutsesteenweg 2,2023-09-06,09:00:00,160,155,5,ECO_300019380
642,Herenthoutsesteenweg 2,2023-09-06,10:00:00,289,280,9,ECO_300019380
642,Herenthoutsesteenweg 2,2023-09-06,11:00:00,168,153,15,ECO_300019380
642,Herenthoutsesteenweg 2,2023-09-06,12:00:00,128,125,3,ECO_300019380
642,Herenthoutsesteenweg 2,2023-09-06,13:00:00,143,128,15,ECO_300019380
642,Herenthoutsesteenweg 2,2023-09-06,14:00:00,207,182,25,ECO_300019380
642,Herenthoutsesteenweg 2,2023-09-06,15:00:00,197,187,10,ECO_300019380
642,Herenthoutsesteenweg 2,2023-09-06,16:00:00,248,236,12,ECO_300019380
642,Herenthoutsesteenweg 2,2023-09-06,17:00:00,201,179,22,ECO_300019380
642,Herenthoutsesteenweg 2,2023-09-06,18:00:00,249,223,26,ECO_300019380
642,Herenthoutsesteenweg 2,2023-09-06,19:00:00,184,167,17,ECO_300019380
642,Herenthoutsesteenweg 2,2023-09-06,20:00:00,169,153,16,ECO_300019380
642,Herenthoutsesteenweg 2,2023-09-06,21:00:00,107,95,12,ECO_300019380
642,Herenthoutsesteenweg 2,2023-09-06,22:00:00,73,47,26,ECO_300019380
642,Herenthoutsesteenweg 2,2023-09-06,23:00:00,64,52,12,ECO_300019380
642,Herenthoutsesteenweg 2,2023-09-07,00:00:00,27,23,4,ECO_300019380
642,Herenthoutsesteenweg 2,2023-09-07,01:00:00,6,4,2,ECO_300019380
642,Herenthoutsesteenweg 2,2023-09-07,02:00:00,14,12,2,ECO_300019380
642,Herenthoutsesteenweg 2,2023-09-07,03:00:00,1,1,0,ECO_300019380
642,Herenthoutsesteenweg 2,2023-09-07,04:00:00,2,2,0,ECO_300019380
642,Herenthoutsesteenweg 2,2023-09-07,05:00:00,0,0,0,ECO_300019380
642,Herenthoutsesteenweg 2,2023-09-07,06:00:00,1,1,0,ECO_300019380
642,Herenthoutsesteenweg 2,2023-09-07,07:00:00,28,25,3,ECO_300019380
642,Herenthoutsesteenweg 2,2023-09-07,08:00:00,70,66,4,ECO_300019380
642,Herenthoutsesteenweg 2,2023-09-07,09:00:00,257,249,8,ECO_300019380
642,Herenthoutsesteenweg 2,2023-09-07,10:00:00,696,685,11,ECO_300019380
642,Herenthoutsesteenweg 2,2023-09-07,11:00:00,151,138,13,ECO_300019380
642,Herenthoutsesteenweg 2,2023-09-07,12:00:00,144,131,13,ECO_300019380
642,Herenthoutsesteenweg 2,2023-09-07,13:00:00,128,114,14,ECO_300019380
642,Herenthoutsesteenweg 2,2023-09-07,14:00:00,120,107,13,ECO_300019380
642,Herenthoutsesteenweg 2,2023-09-07,15:00:00,178,166,12,ECO_300019380
642,Herenthoutsesteenweg 2,2023-09-07,16:00:00,151,137,14,ECO_300019380
642,Herenthoutsesteenweg 2,2023-09-07,17:00:00,215,191,24,ECO_300019380
642,Herenthoutsesteenweg 2,2023-09-07,18:00:00,238,210,28,ECO_300019380
642,Herenthoutsesteenweg 2,2023-09-07,19:00:00,174,161,13,ECO_300019380
642,Herenthoutsesteenweg 2,2023-09-07,20:00:00,138,124,14,ECO_300019380
642,Herenthoutsesteenweg 2,2023-09-07,21:00:00,123,116,7,ECO_300019380
642,Herenthoutsesteenweg 2,2023-09-07,22:00:00,63,58,5,ECO_300019380
642,Herenthoutsesteenweg 2,2023-09-07,23:00:00,43,40,3,ECO_300019380
642,Herenthoutsesteenweg 2,2023-09-08,00:00:00,22,19,3,ECO_300019380
642,Herenthoutsesteenweg 2,2023-09-08,01:00:00,7,4,3,ECO_300019380
642,Herenthoutsesteenweg 2,2023-09-08,02:00:00,10,10,0,ECO_300019380
642,Herenthoutsesteenweg 2,2023-09-08,03:00:00,2,1,1,ECO_300019380
642,Herenthoutsesteenweg 2,2023-09-08,04:00:00,3,1,2,ECO_300019380
642,Herenthoutsesteenweg 2,2023-09-08,05:00:00,0,0,0,ECO_300019380
642,Herenthoutsesteenweg 2,2023-09-08,06:00:00,2,1,1,ECO_300019380
642,Herenthoutsesteenweg 2,2023-09-08,07:00:00,27,27,0,ECO_300019380
642,Herenthoutsesteenweg 2,2023-09-08,08:00:00,55,48,7,ECO_300019380
642,Herenthoutsesteenweg 2,2023-09-08,09:00:00,229,222,7,ECO_300019380
642,Herenthoutsesteenweg 2,2023-09-08,10:00:00,722,701,21,ECO_300019380
642,Herenthoutsesteenweg 2,2023-09-08,11:00:00,215,197,18,ECO_300019380
642,Herenthoutsesteenweg 2,2023-09-08,12:00:00,210,197,13,ECO_300019380
642,Herenthoutsesteenweg 2,2023-09-08,13:00:00,162,141,21,ECO_300019380
642,Herenthoutsesteenweg 2,2023-09-08,14:00:00,117,97,20,ECO_300019380
642,Herenthoutsesteenweg 2,2023-09-08,15:00:00,127,117,10,ECO_300019380
642,Herenthoutsesteenweg 2,2023-09-08,16:00:00,184,165,19,ECO_300019380
642,Herenthoutsesteenweg 2,2023-09-08,17:00:00,207,193,14,ECO_300019380
642,Herenthoutsesteenweg 2,2023-09-08,18:00:00,190,166,24,ECO_300019380
642,Herenthoutsesteenweg 2,2023-09-08,19:00:00,139,119,20,ECO_300019380
642,Herenthoutsesteenweg 2,2023-09-08,20:00:00,128,106,22,ECO_300019380
642,Herenthoutsesteenweg 2,2023-09-08,21:00:00,113,106,7,ECO_300019380
642,Herenthoutsesteenweg 2,2023-09-08,22:00:00,78,65,13,ECO_300019380
642,Herenthoutsesteenweg 2,2023-09-08,23:00:00,43,34,9,ECO_300019380
642,Herenthoutsesteenweg 2,2023-09-09,00:00:00,23,23,0,ECO_300019380
642,Herenthoutsesteenweg 2,2023-09-09,01:00:00,14,11,3,ECO_300019380
642,Herenthoutsesteenweg 2,2023-09-09,02:00:00,8,7,1,ECO_300019380
642,Herenthoutsesteenweg 2,2023-09-09,03:00:00,9,8,1,ECO_300019380
642,Herenthoutsesteenweg 2,2023-09-09,04:00:00,1,1,0,ECO_300019380
642,Herenthoutsesteenweg 2,2023-09-09,05:00:00,2,0,2,ECO_300019380
642,Herenthoutsesteenweg 2,2023-09-09,06:00:00,5,2,3,ECO_300019380
642,Herenthoutsesteenweg 2,2023-09-09,07:00:00,12,11,1,ECO_300019380
642,Herenthoutsesteenweg 2,2023-09-09,08:00:00,23,18,5,ECO_300019380
642,Herenthoutsesteenweg 2,2023-09-09,09:00:00,18,18,0,ECO_300019380
642,Herenthoutsesteenweg 2,2023-09-09,10:00:00,96,95,1,ECO_300019380
642,Herenthoutsesteenweg 2,2023-09-09,11:00:00,112,104,8,ECO_300019380
642,Herenthoutsesteenweg 2,2023-09-09,12:00:00,188,161,27,ECO_300019380
642,Herenthoutsesteenweg 2,2023-09-09,13:00:00,179,154,25,ECO_300019380
642,Herenthoutsesteenweg 2,2023-09-09,14:00:00,164,147,17,ECO_300019380
642,Herenthoutsesteenweg 2,2023-09-09,15:00:00,202,184,18,ECO_300019380
642,Herenthoutsesteenweg 2,2023-09-09,16:00:00,168,152,16,ECO_300019380
642,Herenthoutsesteenweg 2,2023-09-09,17:00:00,157,132,25,ECO_300019380
642,Herenthoutsesteenweg 2,2023-09-09,18:00:00,135,113,22,ECO_300019380
642,Herenthoutsesteenweg 2,2023-09-09,19:00:00,95,84,11,ECO_300019380
642,Herenthoutsesteenweg 2,2023-09-09,20:00:00,86,78,8,ECO_300019380
642,Herenthoutsesteenweg 2,2023-09-09,21:00:00,64,54,10,ECO_300019380
642,Herenthoutsesteenweg 2,2023-09-09,22:00:00,73,60,13,ECO_300019380
642,Herenthoutsesteenweg 2,2023-09-09,23:00:00,54,49,5,ECO_300019380
642,Herenthoutsesteenweg 2,2023-09-10,00:00:00,30,25,5,ECO_300019380
642,Herenthoutsesteenweg 2,2023-09-10,01:00:00,29,27,2,ECO_300019380
642,Herenthoutsesteenweg 2,2023-09-10,02:00:00,16,16,0,ECO_300019380
642,Herenthoutsesteenweg 2,2023-09-10,03:00:00,17,14,3,ECO_300019380
642,Herenthoutsesteenweg 2,2023-09-10,04:00:00,3,2,1,ECO_300019380
642,Herenthoutsesteenweg 2,2023-09-10,05:00:00,8,6,2,ECO_300019380
642,Herenthoutsesteenweg 2,2023-09-10,06:00:00,0,0,0,ECO_300019380
642,Herenthoutsesteenweg 2,2023-09-10,07:00:00,6,6,0,ECO_300019380
642,Herenthoutsesteenweg 2,2023-09-10,08:00:00,9,9,0,ECO_300019380
642,Herenthoutsesteenweg 2,2023-09-10,09:00:00,28,25,3,ECO_300019380
642,Herenthoutsesteenweg 2,2023-09-10,10:00:00,81,71,10,ECO_300019380
642,Herenthoutsesteenweg 2,2023-09-10,11:00:00,174,135,39,ECO_300019380
642,Herenthoutsesteenweg 2,2023-09-10,12:00:00,213,187,26,ECO_300019380
642,Herenthoutsesteenweg 2,2023-09-10,13:00:00,198,165,33,ECO_300019380
642,Herenthoutsesteenweg 2,2023-09-10,14:00:00,132,116,16,ECO_300019380
642,Herenthoutsesteenweg 2,2023-09-10,15:00:00,138,132,6,ECO_300019380
642,Herenthoutsesteenweg 2,2023-09-10,16:00:00,190,186,4,ECO_300019380
642,Herenthoutsesteenweg 2,2023-09-10,17:00:00,148,133,15,ECO_300019380
642,Herenthoutsesteenweg 2,2023-09-10,18:00:00,111,98,13,ECO_300019380
642,Herenthoutsesteenweg 2,2023-09-10,19:00:00,117,102,15,ECO_300019380
642,Herenthoutsesteenweg 2,2023-09-10,20:00:00,100,83,17,ECO_300019380
642,Herenthoutsesteenweg 2,2023-09-10,21:00:00,67,51,16,ECO_300019380
642,Herenthoutsesteenweg 2,2023-09-10,22:00:00,56,49,7,ECO_300019380
642,Herenthoutsesteenweg 2,2023-09-10,23:00:00,25,19,6,ECO_300019380
642,Herenthoutsesteenweg 2,2023-09-11,00:00:00,17,16,1,ECO_300019380
642,Herenthoutsesteenweg 2,2023-09-11,01:00:00,5,2,3,ECO_300019380
642,Herenthoutsesteenweg 2,2023-09-11,02:00:00,1,1,0,ECO_300019380
642,Herenthoutsesteenweg 2,2023-09-11,03:00:00,1,1,0,ECO_300019380
642,Herenthoutsesteenweg 2,2023-09-11,04:00:00,1,1,0,ECO_300019380
642,Herenthoutsesteenweg 2,2023-09-11,05:00:00,0,0,0,ECO_300019380
642,Herenthoutsesteenweg 2,2023-09-11,06:00:00,3,3,0,ECO_300019380
642,Herenthoutsesteenweg 2,2023-09-11,07:00:00,33,28,5,ECO_300019380
642,Herenthoutsesteenweg 2,2023-09-11,08:00:00,59,54,5,ECO_300019380
642,Herenthoutsesteenweg 2,2023-09-11,09:00:00,227,218,9,ECO_300019380
642,Herenthoutsesteenweg 2,2023-09-11,10:00:00,741,721,20,ECO_300019380
642,Herenthoutsesteenweg 2,2023-09-11,11:00:00,151,140,11,ECO_300019380
642,Herenthoutsesteenweg 2,2023-09-11,12:00:00,131,121,10,ECO_300019380
642,Herenthoutsesteenweg 2,2023-09-11,13:00:00,110,97,13,ECO_300019380
642,Herenthoutsesteenweg 2,2023-09-11,14:00:00,118,112,6,ECO_300019380
642,Herenthoutsesteenweg 2,2023-09-11,15:00:00,169,156,13,ECO_300019380
642,Herenthoutsesteenweg 2,2023-09-11,16:00:00,165,146,19,ECO_300019380
642,Herenthoutsesteenweg 2,2023-09-11,17:00:00,208,194,14,ECO_300019380
642,Herenthoutsesteenweg 2,2023-09-11,18:00:00,224,195,29,ECO_300019380
642,Herenthoutsesteenweg 2,2023-09-11,19:00:00,148,122,26,ECO_300019380
642,Herenthoutsesteenweg 2,2023-09-11,20:00:00,89,75,14,ECO_300019380
642,Herenthoutsesteenweg 2,2023-09-11,21:00:00,58,48,10,ECO_300019380
642,Herenthoutsesteenweg 2,2023-09-11,22:00:00,12,8,4,ECO_300019380
642,Herenthoutsesteenweg 2,2023-09-11,23:00:00,13,10,3,ECO_300019380
642,Herenthoutsesteenweg 2,2023-09-12,00:00:00,28,26,2,ECO_300019380
642,Herenthoutsesteenweg 2,2023-09-12,01:00:00,9,9,0,ECO_300019380
642,Herenthoutsesteenweg 2,2023-09-12,02:00:00,1,1,0,ECO_300019380
642,Herenthoutsesteenweg 2,2023-09-12,03:00:00,0,0,0,ECO_300019380
642,Herenthoutsesteenweg 2,2023-09-12,04:00:00,0,0,0,ECO_300019380
642,Herenthoutsesteenweg 2,2023-09-12,05:00:00,0,0,0,ECO_300019380
642,Herenthoutsesteenweg 2,2023-09-12,06:00:00,2,2,0,ECO_300019380
642,Herenthoutsesteenweg 2,2023-09-12,07:00:00,23,21,2,ECO_300019380
642,Herenthoutsesteenweg 2,2023-09-12,08:00:00,52,46,6,ECO_300019380
642,Herenthoutsesteenweg 2,2023-09-12,09:00:00,203,196,7,ECO_300019380
642,Herenthoutsesteenweg 2,2023-09-12,10:00:00,703,691,12,ECO_300019380
642,Herenthoutsesteenweg 2,2023-09-12,11:00:00,113,106,7,ECO_300019380
642,Herenthoutsesteenweg 2,2023-09-12,12:00:00,73,68,5,ECO_300019380
642,Herenthoutsesteenweg 2,2023-09-12,13:00:00,80,72,8,ECO_300019380
642,Herenthoutsesteenweg 2,2023-09-12,14:00:00,120,113,7,ECO_300019380
642,Herenthoutsesteenweg 2,2023-09-12,15:00:00,224,215,9,ECO_300019380
642,Herenthoutsesteenweg 2,2023-09-12,16:00:00,122,111,11,ECO_300019380
642,Herenthoutsesteenweg 2,2023-09-12,17:00:00,223,212,11,ECO_300019380
642,Herenthoutsesteenweg 2,2023-09-12,18:00:00,183,168,15,ECO_300019380
642,Herenthoutsesteenweg 2,2023-09-12,19:00:00,95,85,10,ECO_300019380
642,Herenthoutsesteenweg 2,2023-09-12,20:00:00,84,73,11,ECO_300019380
642,Herenthoutsesteenweg 2,2023-09-12,21:00:00,69,55,14,ECO_300019380
642,Herenthoutsesteenweg 2,2023-09-12,22:00:00,26,20,6,ECO_300019380
642,Herenthoutsesteenweg 2,2023-09-12,23:00:00,22,17,5,ECO_300019380
642,Herenthoutsesteenweg 2,2023-09-13,00:00:00,27,24,3,ECO_300019380
642,Herenthoutsesteenweg 2,2023-09-13,01:00:00,4,3,1,ECO_300019380
642,Herenthoutsesteenweg 2,2023-09-13,02:00:00,1,1,0,ECO_300019380
642,Herenthoutsesteenweg 2,2023-09-13,03:00:00,0,0,0,ECO_300019380
642,Herenthoutsesteenweg 2,2023-09-13,04:00:00,0,0,0,ECO_300019380
642,Herenthoutsesteenweg 2,2023-09-13,05:00:00,0,0,0,ECO_300019380
642,Herenthoutsesteenweg 2,2023-09-13,06:00:00,3,3,0,ECO_300019380
642,Herenthoutsesteenweg 2,2023-09-13,07:00:00,25,22,3,ECO_300019380
642,Herenthoutsesteenweg 2,2023-09-13,08:00:00,56,48,8,ECO_300019380
642,Herenthoutsesteenweg 2,2023-09-13,09:00:00,189,180,9,ECO_300019380
642,Herenthoutsesteenweg 2,2023-09-13,10:00:00,679,666,13,ECO_300019380
642,Herenthoutsesteenweg 2,2023-09-13,11:00:00,129,126,3,ECO_300019380
642,Herenthoutsesteenweg 2,2023-09-13,12:00:00,87,81,6,ECO_300019380
642,Herenthoutsesteenweg 2,2023-09-13,13:00:00,70,66,4,ECO_300019380
642,Herenthoutsesteenweg 2,2023-09-13,14:00:00,185,167,18,ECO_300019380
642,Herenthoutsesteenweg 2,2023-09-13,15:00:00,136,126,10,ECO_300019380
642,Herenthoutsesteenweg 2,2023-09-13,16:00:00,156,146,10,ECO_300019380
642,Herenthoutsesteenweg 2,2023-09-13,17:00:00,129,115,14,ECO_300019380
642,Herenthoutsesteenweg 2,2023-09-13,18:00:00,196,177,19,ECO_300019380
642,Herenthoutsesteenweg 2,2023-09-13,19:00:00,134,127,7,ECO_300019380
642,Herenthoutsesteenweg 2,2023-09-13,20:00:00,104,93,11,ECO_300019380
642,Herenthoutsesteenweg 2,2023-09-13,21:00:00,72,61,11,ECO_300019380
642,Herenthoutsesteenweg 2,2023-09-13,22:00:00,63,43,20,ECO_300019380
642,Herenthoutsesteenweg 2,2023-09-13,23:00:00,35,31,4,ECO_300019380
642,Herenthoutsesteenweg 2,2023-09-14,00:00:00,26,22,4,ECO_300019380
642,Herenthoutsesteenweg 2,2023-09-14,01:00:00,9,8,1,ECO_300019380
642,Herenthoutsesteenweg 2,2023-09-14,02:00:00,5,4,1,ECO_300019380
642,Herenthoutsesteenweg 2,2023-09-14,03:00:00,1,1,0,ECO_300019380
642,Herenthoutsesteenweg 2,2023-09-14,04:00:00,0,0,0,ECO_300019380
642,Herenthoutsesteenweg 2,2023-09-14,05:00:00,0,0,0,ECO_300019380
642,Herenthoutsesteenweg 2,2023-09-14,06:00:00,2,2,0,ECO_300019380
642,Herenthoutsesteenweg 2,2023-09-14,07:00:00,19,16,3,ECO_300019380
642,Herenthoutsesteenweg 2,2023-09-14,08:00:00,68,57,11,ECO_300019380
642,Herenthoutsesteenweg 2,2023-09-14,09:00:00,223,219,4,ECO_300019380
642,Herenthoutsesteenweg 2,2023-09-14,10:00:00,722,715,7,ECO_300019380
642,Herenthoutsesteenweg 2,2023-09-14,11:00:00,116,109,7,ECO_300019380
642,Herenthoutsesteenweg 2,2023-09-14,12:00:00,84,80,4,ECO_300019380
642,Herenthoutsesteenweg 2,2023-09-14,13:00:00,94,88,6,ECO_300019380
642,Herenthoutsesteenweg 2,2023-09-14,14:00:00,100,88,12,ECO_300019380
642,Herenthoutsesteenweg 2,2023-09-14,15:00:00,170,158,12,ECO_300019380
642,Herenthoutsesteenweg 2,2023-09-14,16:00:00,150,133,17,ECO_300019380
642,Herenthoutsesteenweg 2,2023-09-14,17:00:00,202,186,16,ECO_300019380
642,Herenthoutsesteenweg 2,2023-09-14,18:00:00,224,199,25,ECO_300019380
642,Herenthoutsesteenweg 2,2023-09-14,19:00:00,152,137,15,ECO_300019380
642,Herenthoutsesteenweg 2,2023-09-14,20:00:00,127,114,13,ECO_300019380
642,Herenthoutsesteenweg 2,2023-09-14,21:00:00,84,78,6,ECO_300019380
642,Herenthoutsesteenweg 2,2023-09-14,22:00:00,40,32,8,ECO_300019380
642,Herenthoutsesteenweg 2,2023-09-14,23:00:00,32,26,6,ECO_300019380
642,Herenthoutsesteenweg 2,2023-09-15,00:00:00,30,24,6,ECO_300019380
642,Herenthoutsesteenweg 2,2023-09-15,01:00:00,8,8,0,ECO_300019380
642,Herenthoutsesteenweg 2,2023-09-15,02:00:00,4,2,2,ECO_300019380
642,Herenthoutsesteenweg 2,2023-09-15,03:00:00,2,2,0,ECO_300019380
642,Herenthoutsesteenweg 2,2023-09-15,04:00:00,0,0,0,ECO_300019380
642,Herenthoutsesteenweg 2,2023-09-15,05:00:00,1,0,1,ECO_300019380
642,Herenthoutsesteenweg 2,2023-09-15,06:00:00,2,2,0,ECO_300019380
642,Herenthoutsesteenweg 2,2023-09-15,07:00:00,26,21,5,ECO_300019380
642,Herenthoutsesteenweg 2,2023-09-15,08:00:00,57,48,9,ECO_300019380
642,Herenthoutsesteenweg 2,2023-09-15,09:00:00,173,170,3,ECO_300019380
642,Herenthoutsesteenweg 2,2023-09-15,10:00:00,712,705,7,ECO_300019380
642,Herenthoutsesteenweg 2,2023-09-15,11:00:00,177,171,6,ECO_300019380
642,Herenthoutsesteenweg 2,2023-09-15,12:00:00,200,179,21,ECO_300019380
642,Herenthoutsesteenweg 2,2023-09-15,13:00:00,144,136,8,ECO_300019380
642,Herenthoutsesteenweg 2,2023-09-15,14:00:00,126,111,15,ECO_300019380
642,Herenthoutsesteenweg 2,2023-09-15,15:00:00,158,146,12,ECO_300019380
642,Herenthoutsesteenweg 2,2023-09-15,16:00:00,175,157,18,ECO_300019380
642,Herenthoutsesteenweg 2,2023-09-15,17:00:00,221,206,15,ECO_300019380
642,Herenthoutsesteenweg 2,2023-09-15,18:00:00,234,218,16,ECO_300019380
642,Herenthoutsesteenweg 2,2023-09-15,19:00:00,145,135,10,ECO_300019380
642,Herenthoutsesteenweg 2,2023-09-15,20:00:00,93,84,9,ECO_300019380
642,Herenthoutsesteenweg 2,2023-09-15,21:00:00,76,61,15,ECO_300019380
642,Herenthoutsesteenweg 2,2023-09-15,22:00:00,82,64,18,ECO_300019380
642,Herenthoutsesteenweg 2,2023-09-15,23:00:00,27,23,4,ECO_300019380
642,Herenthoutsesteenweg 2,2023-09-16,00:00:00,29,26,3,ECO_300019380
642,Herenthoutsesteenweg 2,2023-09-16,01:00:00,12,6,6,ECO_300019380
642,Herenthoutsesteenweg 2,2023-09-16,02:00:00,11,10,1,ECO_300019380
642,Herenthoutsesteenweg 2,2023-09-16,03:00:00,3,2,1,ECO_300019380
642,Herenthoutsesteenweg 2,2023-09-16,04:00:00,9,8,1,ECO_300019380
642,Herenthoutsesteenweg 2,2023-09-16,05:00:00,8,5,3,ECO_300019380
642,Herenthoutsesteenweg 2,2023-09-16,06:00:00,2,1,1,ECO_300019380
642,Herenthoutsesteenweg 2,2023-09-16,07:00:00,9,9,0,ECO_300019380
642,Herenthoutsesteenweg 2,2023-09-16,08:00:00,11,10,1,ECO_300019380
642,Herenthoutsesteenweg 2,2023-09-16,09:00:00,19,18,1,ECO_300019380
642,Herenthoutsesteenweg 2,2023-09-16,10:00:00,64,61,3,ECO_300019380
642,Herenthoutsesteenweg 2,2023-09-16,11:00:00,121,115,6,ECO_300019380
642,Herenthoutsesteenweg 2,2023-09-16,12:00:00,134,119,15,ECO_300019380
642,Herenthoutsesteenweg 2,2023-09-16,13:00:00,120,111,9,ECO_300019380
642,Herenthoutsesteenweg 2,2023-09-16,14:00:00,154,143,11,ECO_300019380
642,Herenthoutsesteenweg 2,2023-09-16,15:00:00,240,221,19,ECO_300019380
642,Herenthoutsesteenweg 2,2023-09-16,16:00:00,168,146,22,ECO_300019380
642,Herenthoutsesteenweg 2,2023-09-16,17:00:00,124,102,22,ECO_300019380
642,Herenthoutsesteenweg 2,2023-09-16,18:00:00,153,126,27,ECO_300019380
642,Herenthoutsesteenweg 2,2023-09-16,19:00:00,96,77,19,ECO_300019380
642,Herenthoutsesteenweg 2,2023-09-16,20:00:00,84,66,18,ECO_300019380
642,Herenthoutsesteenweg 2,2023-09-16,21:00:00,52,46,6,ECO_300019380
642,Herenthoutsesteenweg 2,2023-09-16,22:00:00,49,44,5,ECO_300019380
642,Herenthoutsesteenweg 2,2023-09-16,23:00:00,35,15,20,ECO_300019380
642,Herenthoutsesteenweg 2,2023-09-17,00:00:00,16,13,3,ECO_300019380
642,Herenthoutsesteenweg 2,2023-09-17,01:00:00,12,11,1,ECO_300019380
642,Herenthoutsesteenweg 2,2023-09-17,02:00:00,11,4,7,ECO_300019380
642,Herenthoutsesteenweg 2,2023-09-17,03:00:00,7,7,0,ECO_300019380
642,Herenthoutsesteenweg 2,2023-09-17,04:00:00,7,6,1,ECO_300019380
642,Herenthoutsesteenweg 2,2023-09-17,05:00:00,5,2,3,ECO_300019380
642,Herenthoutsesteenweg 2,2023-09-17,06:00:00,1,0,1,ECO_300019380
642,Herenthoutsesteenweg 2,2023-09-17,07:00:00,5,4,1,ECO_300019380
642,Herenthoutsesteenweg 2,2023-09-17,08:00:00,8,7,1,ECO_300019380
642,Herenthoutsesteenweg 2,2023-09-17,09:00:00,33,33,0,ECO_300019380
642,Herenthoutsesteenweg 2,2023-09-17,10:00:00,66,59,7,ECO_300019380
642,Herenthoutsesteenweg 2,2023-09-17,11:00:00,110,100,10,ECO_300019380
642,Herenthoutsesteenweg 2,2023-09-17,12:00:00,150,138,12,ECO_300019380
642,Herenthoutsesteenweg 2,2023-09-17,13:00:00,144,123,21,ECO_300019380
642,Herenthoutsesteenweg 2,2023-09-17,14:00:00,127,107,20,ECO_300019380
642,Herenthoutsesteenweg 2,2023-09-17,15:00:00,103,95,8,ECO_300019380
642,Herenthoutsesteenweg 2,2023-09-17,16:00:00,187,165,22,ECO_300019380
642,Herenthoutsesteenweg 2,2023-09-17,17:00:00,160,136,24,ECO_300019380
642,Herenthoutsesteenweg 2,2023-09-17,18:00:00,147,128,19,ECO_300019380
642,Herenthoutsesteenweg 2,2023-09-17,19:00:00,100,95,5,ECO_300019380
642,Herenthoutsesteenweg 2,2023-09-17,20:00:00,73,65,8,ECO_300019380
642,Herenthoutsesteenweg 2,2023-09-17,21:00:00,55,45,10,ECO_300019380
642,Herenthoutsesteenweg 2,2023-09-17,22:00:00,31,24,7,ECO_300019380
642,Herenthoutsesteenweg 2,2023-09-17,23:00:00,18,12,6,ECO_300019380
642,Herenthoutsesteenweg 2,2023-09-18,00:00:00,6,6,0,ECO_300019380
642,Herenthoutsesteenweg 2,2023-09-18,01:00:00,2,0,2,ECO_300019380
642,Herenthoutsesteenweg 2,2023-09-18,02:00:00,0,0,0,ECO_300019380
642,Herenthoutsesteenweg 2,2023-09-18,03:00:00,0,0,0,ECO_300019380
642,Herenthoutsesteenweg 2,2023-09-18,04:00:00,0,0,0,ECO_300019380
642,Herenthoutsesteenweg 2,2023-09-18,05:00:00,0,0,0,ECO_300019380
642,Herenthoutsesteenweg 2,2023-09-18,06:00:00,1,1,0,ECO_300019380
642,Herenthoutsesteenweg 2,2023-09-18,07:00:00,17,15,2,ECO_300019380
642,Herenthoutsesteenweg 2,2023-09-18,08:00:00,44,40,4,ECO_300019380
642,Herenthoutsesteenweg 2,2023-09-18,09:00:00,222,213,9,ECO_300019380
642,Herenthoutsesteenweg 2,2023-09-18,10:00:00,635,632,3,ECO_300019380
642,Herenthoutsesteenweg 2,2023-09-18,11:00:00,79,73,6,ECO_300019380
642,Herenthoutsesteenweg 2,2023-09-18,12:00:00,68,68,0,ECO_300019380
642,Herenthoutsesteenweg 2,2023-09-18,13:00:00,68,65,3,ECO_300019380
642,Herenthoutsesteenweg 2,2023-09-18,14:00:00,84,78,6,ECO_300019380
642,Herenthoutsesteenweg 2,2023-09-18,15:00:00,89,84,5,ECO_300019380
642,Herenthoutsesteenweg 2,2023-09-18,16:00:00,99,93,6,ECO_300019380
642,Herenthoutsesteenweg 2,2023-09-18,17:00:00,155,147,8,ECO_300019380
642,Herenthoutsesteenweg 2,2023-09-18,18:00:00,169,157,12,ECO_300019380
642,Herenthoutsesteenweg 2,2023-09-18,19:00:00,80,65,15,ECO_300019380
642,Herenthoutsesteenweg 2,2023-09-18,20:00:00,56,44,12,ECO_300019380
642,Herenthoutsesteenweg 2,2023-09-18,21:00:00,37,36,1,ECO_300019380
642,Herenthoutsesteenweg 2,2023-09-18,22:00:00,20,17,3,ECO_300019380
642,Herenthoutsesteenweg 2,2023-09-18,23:00:00,18,14,4,ECO_300019380
642,Herenthoutsesteenweg 2,2023-09-19,00:00:00,21,20,1,ECO_300019380
642,Herenthoutsesteenweg 2,2023-09-19,01:00:00,3,2,1,ECO_300019380
642,Herenthoutsesteenweg 2,2023-09-19,02:00:00,1,0,1,ECO_300019380
642,Herenthoutsesteenweg 2,2023-09-19,03:00:00,1,1,0,ECO_300019380
642,Herenthoutsesteenweg 2,2023-09-19,04:00:00,0,0,0,ECO_300019380
642,Herenthoutsesteenweg 2,2023-09-19,05:00:00,0,0,0,ECO_300019380
642,Herenthoutsesteenweg 2,2023-09-19,06:00:00,1,1,0,ECO_300019380
642,Herenthoutsesteenweg 2,2023-09-19,07:00:00,17,17,0,ECO_300019380
642,Herenthoutsesteenweg 2,2023-09-19,08:00:00,69,61,8,ECO_300019380
642,Herenthoutsesteenweg 2,2023-09-19,09:00:00,203,188,15,ECO_300019380
642,Herenthoutsesteenweg 2,2023-09-19,10:00:00,642,616,26,ECO_300019380
642,Herenthoutsesteenweg 2,2023-09-19,11:00:00,112,103,9,ECO_300019380
642,Herenthoutsesteenweg 2,2023-09-19,12:00:00,85,81,4,ECO_300019380
642,Herenthoutsesteenweg 2,2023-09-19,13:00:00,78,73,5,ECO_300019380
642,Herenthoutsesteenweg 2,2023-09-19,14:00:00,80,71,9,ECO_300019380
642,Herenthoutsesteenweg 2,2023-09-19,15:00:00,115,110,5,ECO_300019380
642,Herenthoutsesteenweg 2,2023-09-19,16:00:00,128,119,9,ECO_300019380
642,Herenthoutsesteenweg 2,2023-09-19,17:00:00,161,146,15,ECO_300019380
642,Herenthoutsesteenweg 2,2023-09-19,18:00:00,178,164,14,ECO_300019380
642,Herenthoutsesteenweg 2,2023-09-19,19:00:00,121,109,12,ECO_300019380
642,Herenthoutsesteenweg 2,2023-09-19,20:00:00,80,68,12,ECO_300019380
642,Herenthoutsesteenweg 2,2023-09-19,21:00:00,43,35,8,ECO_300019380
642,Herenthoutsesteenweg 2,2023-09-19,22:00:00,31,25,6,ECO_300019380
642,Herenthoutsesteenweg 2,2023-09-19,23:00:00,27,22,5,ECO_300019380
642,Herenthoutsesteenweg 2,2023-09-20,00:00:00,17,16,1,ECO_300019380
642,Herenthoutsesteenweg 2,2023-09-20,01:00:00,6,4,2,ECO_300019380
642,Herenthoutsesteenweg 2,2023-09-20,02:00:00,0,0,0,ECO_300019380
642,Herenthoutsesteenweg 2,2023-09-20,03:00:00,1,1,0,ECO_300019380
642,Herenthoutsesteenweg 2,2023-09-20,04:00:00,0,0,0,ECO_300019380
642,Herenthoutsesteenweg 2,2023-09-20,05:00:00,0,0,0,ECO_300019380
642,Herenthoutsesteenweg 2,2023-09-20,06:00:00,2,2,0,ECO_300019380
642,Herenthoutsesteenweg 2,2023-09-20,07:00:00,20,17,3,ECO_300019380
642,Herenthoutsesteenweg 2,2023-09-20,08:00:00,63,55,8,ECO_300019380
642,Herenthoutsesteenweg 2,2023-09-20,09:00:00,211,197,14,ECO_300019380
642,Herenthoutsesteenweg 2,2023-09-20,10:00:00,638,598,40,ECO_300019380
642,Herenthoutsesteenweg 2,2023-09-20,11:00:00,94,90,4,ECO_300019380
642,Herenthoutsesteenweg 2,2023-09-20,12:00:00,98,86,12,ECO_300019380
642,Herenthoutsesteenweg 2,2023-09-20,13:00:00,84,76,8,ECO_300019380
642,Herenthoutsesteenweg 2,2023-09-20,14:00:00,151,140,11,ECO_300019380
642,Herenthoutsesteenweg 2,2023-09-20,15:00:00,128,114,14,ECO_300019380
642,Herenthoutsesteenweg 2,2023-09-20,16:00:00,148,132,16,ECO_300019380
642,Herenthoutsesteenweg 2,2023-09-20,17:00:00,118,101,17,ECO_300019380
642,Herenthoutsesteenweg 2,2023-09-20,18:00:00,145,124,21,ECO_300019380
642,Herenthoutsesteenweg 2,2023-09-20,19:00:00,133,119,14,ECO_300019380
642,Herenthoutsesteenweg 2,2023-09-20,20:00:00,78,68,10,ECO_300019380
642,Herenthoutsesteenweg 2,2023-09-20,21:00:00,56,49,7,ECO_300019380
642,Herenthoutsesteenweg 2,2023-09-20,22:00:00,27,18,9,ECO_300019380
642,Herenthoutsesteenweg 2,2023-09-20,23:00:00,20,14,6,ECO_300019380
642,Herenthoutsesteenweg 2,2023-09-21,00:00:00,19,15,4,ECO_300019380
642,Herenthoutsesteenweg 2,2023-09-21,01:00:00,8,6,2,ECO_300019380
642,Herenthoutsesteenweg 2,2023-09-21,02:00:00,3,3,0,ECO_300019380
642,Herenthoutsesteenweg 2,2023-09-21,03:00:00,2,2,0,ECO_300019380
642,Herenthoutsesteenweg 2,2023-09-21,04:00:00,0,0,0,ECO_300019380
642,Herenthoutsesteenweg 2,2023-09-21,05:00:00,0,0,0,ECO_300019380
642,Herenthoutsesteenweg 2,2023-09-21,06:00:00,2,0,2,ECO_300019380
642,Herenthoutsesteenweg 2,2023-09-21,07:00:00,20,18,2,ECO_300019380
642,Herenthoutsesteenweg 2,2023-09-21,08:00:00,52,48,4,ECO_300019380
642,Herenthoutsesteenweg 2,2023-09-21,09:00:00,133,128,5,ECO_300019380
642,Herenthoutsesteenweg 2,2023-09-21,10:00:00,422,419,3,ECO_300019380
642,Herenthoutsesteenweg 2,2023-09-21,11:00:00,47,47,0,ECO_300019380
642,Herenthoutsesteenweg 2,2023-09-21,12:00:00,24,23,1,ECO_300019380
642,Herenthoutsesteenweg 2,2023-09-21,13:00:00,36,32,4,ECO_300019380
642,Herenthoutsesteenweg 2,2023-09-21,14:00:00,38,33,5,ECO_300019380
642,Herenthoutsesteenweg 2,2023-09-21,15:00:00,26,24,2,ECO_300019380
642,Herenthoutsesteenweg 2,2023-09-21,16:00:00,37,33,4,ECO_300019380
642,Herenthoutsesteenweg 2,2023-09-21,17:00:00,74,65,9,ECO_300019380
642,Herenthoutsesteenweg 2,2023-09-21,18:00:00,66,56,10,ECO_300019380
642,Herenthoutsesteenweg 2,2023-09-21,19:00:00,62,58,4,ECO_300019380
642,Herenthoutsesteenweg 2,2023-09-21,20:00:00,37,29,8,ECO_300019380
642,Herenthoutsesteenweg 2,2023-09-21,21:00:00,32,30,2,ECO_300019380
642,Herenthoutsesteenweg 2,2023-09-21,22:00:00,19,13,6,ECO_300019380
642,Herenthoutsesteenweg 2,2023-09-21,23:00:00,19,18,1,ECO_300019380
642,Herenthoutsesteenweg 2,2023-09-22,00:00:00,21,18,3,ECO_300019380
642,Herenthoutsesteenweg 2,2023-09-22,01:00:00,5,4,1,ECO_300019380
642,Herenthoutsesteenweg 2,2023-09-22,02:00:00,1,0,1,ECO_300019380
642,Herenthoutsesteenweg 2,2023-09-22,03:00:00,0,0,0,ECO_300019380
642,Herenthoutsesteenweg 2,2023-09-22,04:00:00,0,0,0,ECO_300019380
642,Herenthoutsesteenweg 2,2023-09-22,05:00:00,0,0,0,ECO_300019380
642,Herenthoutsesteenweg 2,2023-09-22,06:00:00,1,1,0,ECO_300019380
642,Herenthoutsesteenweg 2,2023-09-22,07:00:00,21,21,0,ECO_300019380
642,Herenthoutsesteenweg 2,2023-09-22,08:00:00,38,35,3,ECO_300019380
642,Herenthoutsesteenweg 2,2023-09-22,09:00:00,149,143,6,ECO_300019380
642,Herenthoutsesteenweg 2,2023-09-22,10:00:00,645,636,9,ECO_300019380
642,Herenthoutsesteenweg 2,2023-09-22,11:00:00,133,127,6,ECO_300019380
642,Herenthoutsesteenweg 2,2023-09-22,12:00:00,99,93,6,ECO_300019380
642,Herenthoutsesteenweg 2,2023-09-22,13:00:00,97,91,6,ECO_300019380
642,Herenthoutsesteenweg 2,2023-09-22,14:00:00,86,76,10,ECO_300019380
642,Herenthoutsesteenweg 2,2023-09-22,15:00:00,84,78,6,ECO_300019380
642,Herenthoutsesteenweg 2,2023-09-22,16:00:00,142,133,9,ECO_300019380
642,Herenthoutsesteenweg 2,2023-09-22,17:00:00,153,140,13,ECO_300019380
642,Herenthoutsesteenweg 2,2023-09-22,18:00:00,113,101,12,ECO_300019380
642,Herenthoutsesteenweg 2,2023-09-22,19:00:00,66,56,10,ECO_300019380
642,Herenthoutsesteenweg 2,2023-09-22,20:00:00,27,23,4,ECO_300019380
642,Herenthoutsesteenweg 2,2023-09-22,21:00:00,34,29,5,ECO_300019380
642,Herenthoutsesteenweg 2,2023-09-22,22:00:00,21,16,5,ECO_300019380
642,Herenthoutsesteenweg 2,2023-09-22,23:00:00,12,9,3,ECO_300019380
642,Herenthoutsesteenweg 2,2023-09-23,00:00:00,20,15,5,ECO_300019380
642,Herenthoutsesteenweg 2,2023-09-23,01:00:00,9,8,1,ECO_300019380
642,Herenthoutsesteenweg 2,2023-09-23,02:00:00,7,5,2,ECO_300019380
642,Herenthoutsesteenweg 2,2023-09-23,03:00:00,10,8,2,ECO_300019380
642,Herenthoutsesteenweg 2,2023-09-23,04:00:00,3,3,0,ECO_300019380
642,Herenthoutsesteenweg 2,2023-09-23,05:00:00,3,1,2,ECO_300019380
642,Herenthoutsesteenweg 2,2023-09-23,06:00:00,3,1,2,ECO_300019380
642,Herenthoutsesteenweg 2,2023-09-23,07:00:00,6,6,0,ECO_300019380
642,Herenthoutsesteenweg 2,2023-09-23,08:00:00,14,12,2,ECO_300019380
642,Herenthoutsesteenweg 2,2023-09-23,09:00:00,12,10,2,ECO_300019380
642,Herenthoutsesteenweg 2,2023-09-23,10:00:00,49,46,3,ECO_300019380
642,Herenthoutsesteenweg 2,2023-09-23,11:00:00,104,95,9,ECO_300019380
642,Herenthoutsesteenweg 2,2023-09-23,12:00:00,131,123,8,ECO_300019380
642,Herenthoutsesteenweg 2,2023-09-23,13:00:00,88,82,6,ECO_300019380
642,Herenthoutsesteenweg 2,2023-09-23,14:00:00,112,102,10,ECO_300019380
642,Herenthoutsesteenweg 2,2023-09-23,15:00:00,137,117,20,ECO_300019380
642,Herenthoutsesteenweg 2,2023-09-23,16:00:00,137,123,14,ECO_300019380
642,Herenthoutsesteenweg 2,2023-09-23,17:00:00,74,70,4,ECO_300019380
642,Herenthoutsesteenweg 2,2023-09-23,18:00:00,109,99,10,ECO_300019380
642,Herenthoutsesteenweg 2,2023-09-23,19:00:00,65,59,6,ECO_300019380
642,Herenthoutsesteenweg 2,2023-09-23,20:00:00,62,54,8,ECO_300019380
642,Herenthoutsesteenweg 2,2023-09-23,21:00:00,55,44,11,ECO_300019380
642,Herenthoutsesteenweg 2,2023-09-23,22:00:00,25,25,0,ECO_300019380
642,Herenthoutsesteenweg 2,2023-09-23,23:00:00,19,18,1,ECO_300019380
642,Herenthoutsesteenweg 2,2023-09-24,00:00:00,27,25,2,ECO_300019380
642,Herenthoutsesteenweg 2,2023-09-24,01:00:00,6,5,1,ECO_300019380
642,Herenthoutsesteenweg 2,2023-09-24,02:00:00,9,7,2,ECO_300019380
642,Herenthoutsesteenweg 2,2023-09-24,03:00:00,12,9,3,ECO_300019380
642,Herenthoutsesteenweg 2,2023-09-24,04:00:00,6,5,1,ECO_300019380
642,Herenthoutsesteenweg 2,2023-09-24,05:00:00,5,5,0,ECO_300019380
642,Herenthoutsesteenweg 2,2023-09-24,06:00:00,4,3,1,ECO_300019380
642,Herenthoutsesteenweg 2,2023-09-24,07:00:00,2,2,0,ECO_300019380
642,Herenthoutsesteenweg 2,2023-09-24,08:00:00,17,16,1,ECO_300019380
642,Herenthoutsesteenweg 2,2023-09-24,09:00:00,14,14,0,ECO_300019380
642,Herenthoutsesteenweg 2,2023-09-24,10:00:00,71,65,6,ECO_300019380
642,Herenthoutsesteenweg 2,2023-09-24,11:00:00,164,162,2,ECO_300019380
642,Herenthoutsesteenweg 2,2023-09-24,12:00:00,126,108,18,ECO_300019380
642,Herenthoutsesteenweg 2,2023-09-24,13:00:00,168,142,26,ECO_300019380
642,Herenthoutsesteenweg 2,2023-09-24,14:00:00,108,88,20,ECO_300019380
642,Herenthoutsesteenweg 2,2023-09-24,15:00:00,177,156,21,ECO_300019380
642,Herenthoutsesteenweg 2,2023-09-24,16:00:00,187,183,4,ECO_300019380
642,Herenthoutsesteenweg 2,2023-09-24,17:00:00,129,117,12,ECO_300019380
642,Herenthoutsesteenweg 2,2023-09-24,18:00:00,96,75,21,ECO_300019380
642,Herenthoutsesteenweg 2,2023-09-24,19:00:00,80,73,7,ECO_300019380
642,Herenthoutsesteenweg 2,2023-09-24,20:00:00,65,52,13,ECO_300019380
642,Herenthoutsesteenweg 2,2023-09-24,21:00:00,55,41,14,ECO_300019380
642,Herenthoutsesteenweg 2,2023-09-24,22:00:00,22,17,5,ECO_300019380
642,Herenthoutsesteenweg 2,2023-09-24,23:00:00,12,10,2,ECO_300019380
642,Herenthoutsesteenweg 2,2023-09-25,00:00:00,4,4,0,ECO_300019380
642,Herenthoutsesteenweg 2,2023-09-25,01:00:00,5,3,2,ECO_300019380
642,Herenthoutsesteenweg 2,2023-09-25,02:00:00,3,3,0,ECO_300019380
642,Herenthoutsesteenweg 2,2023-09-25,03:00:00,0,0,0,ECO_300019380
642,Herenthoutsesteenweg 2,2023-09-25,04:00:00,0,0,0,ECO_300019380
642,Herenthoutsesteenweg 2,2023-09-25,05:00:00,1,1,0,ECO_300019380
642,Herenthoutsesteenweg 2,2023-09-25,06:00:00,1,1,0,ECO_300019380
642,Herenthoutsesteenweg 2,2023-09-25,07:00:00,23,20,3,ECO_300019380
642,Herenthoutsesteenweg 2,2023-09-25,08:00:00,46,44,2,ECO_300019380
642,Herenthoutsesteenweg 2,2023-09-25,09:00:00,218,205,13,ECO_300019380
642,Herenthoutsesteenweg 2,2023-09-25,10:00:00,665,648,17,ECO_300019380
642,Herenthoutsesteenweg 2,2023-09-25,11:00:00,102,98,4,ECO_300019380
642,Herenthoutsesteenweg 2,2023-09-25,12:00:00,93,90,3,ECO_300019380
642,Herenthoutsesteenweg 2,2023-09-25,13:00:00,87,79,8,ECO_300019380
642,Herenthoutsesteenweg 2,2023-09-25,14:00:00,93,88,5,ECO_300019380
642,Herenthoutsesteenweg 2,2023-09-25,15:00:00,142,125,17,ECO_300019380
642,Herenthoutsesteenweg 2,2023-09-25,16:00:00,148,131,17,ECO_300019380
642,Herenthoutsesteenweg 2,2023-09-25,17:00:00,208,188,20,ECO_300019380
642,Herenthoutsesteenweg 2,2023-09-25,18:00:00,212,194,18,ECO_300019380
642,Herenthoutsesteenweg 2,2023-09-25,19:00:00,157,135,22,ECO_300019380
642,Herenthoutsesteenweg 2,2023-09-25,20:00:00,98,83,15,ECO_300019380
642,Herenthoutsesteenweg 2,2023-09-25,21:00:00,60,54,6,ECO_300019380
642,Herenthoutsesteenweg 2,2023-09-25,22:00:00,35,29,6,ECO_300019380
642,Herenthoutsesteenweg 2,2023-09-25,23:00:00,28,25,3,ECO_300019380
642,Herenthoutsesteenweg 2,2023-09-26,00:00:00,15,12,3,ECO_300019380
642,Herenthoutsesteenweg 2,2023-09-26,01:00:00,3,1,2,ECO_300019380
642,Herenthoutsesteenweg 2,2023-09-26,02:00:00,4,4,0,ECO_300019380
642,Herenthoutsesteenweg 2,2023-09-26,03:00:00,0,0,0,ECO_300019380
642,Herenthoutsesteenweg 2,2023-09-26,04:00:00,0,0,0,ECO_300019380
642,Herenthoutsesteenweg 2,2023-09-26,05:00:00,2,1,1,ECO_300019380
642,Herenthoutsesteenweg 2,2023-09-26,06:00:00,2,2,0,ECO_300019380
642,Herenthoutsesteenweg 2,2023-09-26,07:00:00,24,21,3,ECO_300019380
642,Herenthoutsesteenweg 2,2023-09-26,08:00:00,69,64,5,ECO_300019380
642,Herenthoutsesteenweg 2,2023-09-26,09:00:00,213,204,9,ECO_300019380
642,Herenthoutsesteenweg 2,2023-09-26,10:00:00,662,654,8,ECO_300019380
642,Herenthoutsesteenweg 2,2023-09-26,11:00:00,127,122,5,ECO_300019380
642,Herenthoutsesteenweg 2,2023-09-26,12:00:00,102,94,8,ECO_300019380
642,Herenthoutsesteenweg 2,2023-09-26,13:00:00,112,99,13,ECO_300019380
642,Herenthoutsesteenweg 2,2023-09-26,14:00:00,117,102,15,ECO_300019380
642,Herenthoutsesteenweg 2,2023-09-26,15:00:00,165,160,5,ECO_300019380
642,Herenthoutsesteenweg 2,2023-09-26,16:00:00,156,147,9,ECO_300019380
642,Herenthoutsesteenweg 2,2023-09-26,17:00:00,178,151,27,ECO_300019380
642,Herenthoutsesteenweg 2,2023-09-26,18:00:00,231,206,25,ECO_300019380
642,Herenthoutsesteenweg 2,2023-09-26,19:00:00,142,121,21,ECO_300019380
642,Herenthoutsesteenweg 2,2023-09-26,20:00:00,79,63,16,ECO_300019380
642,Herenthoutsesteenweg 2,2023-09-26,21:00:00,57,48,9,ECO_300019380
642,Herenthoutsesteenweg 2,2023-09-26,22:00:00,31,27,4,ECO_300019380
642,Herenthoutsesteenweg 2,2023-09-26,23:00:00,29,23,6,ECO_300019380
642,Herenthoutsesteenweg 2,2023-09-27,00:00:00,29,24,5,ECO_300019380
642,Herenthoutsesteenweg 2,2023-09-27,01:00:00,4,3,1,ECO_300019380
