Meetpunt surrogate key,Meetpunt locatie,Datum,Tijd,Aantal fietsers,Aantal fietsers van,Aantal fietsers naar,Meetpunt code
655,Ringfietspad Zurenborgbrug,2022-08-22,00:00:00,21,13,8,FMN 06 B Zurenborgbrug Ringfietspad
655,Ringfietspad Zurenborgbrug,2022-08-22,01:00:00,7,3,4,FMN 06 B Zurenborgbrug Ringfietspad
655,Ringfietspad Zurenborgbrug,2022-08-22,02:00:00,4,3,1,FMN 06 B Zurenborgbrug Ringfietspad
655,Ringfietspad Zurenborgbrug,2022-08-22,03:00:00,4,2,2,FMN 06 B Zurenborgbrug Ringfietspad
655,Ringfietspad Zurenborgbrug,2022-08-22,04:00:00,21,12,9,FMN 06 B Zurenborgbrug Ringfietspad
655,Ringfietspad Zurenborgbrug,2022-08-22,05:00:00,42,23,19,FMN 06 B Zurenborgbrug Ringfietspad
655,Ringfietspad Zurenborgbrug,2022-08-22,06:00:00,137,76,61,FMN 06 B Zurenborgbrug Ringfietspad
655,Ringfietspad Zurenborgbrug,2022-08-22,07:00:00,332,211,121,FMN 06 B Zurenborgbrug Ringfietspad
655,Ringfietspad Zurenborgbrug,2022-08-22,08:00:00,385,203,182,FMN 06 B Zurenborgbrug Ringfietspad
655,Ringfietspad Zurenborgbrug,2022-08-22,09:00:00,147,70,77,FMN 06 B Zurenborgbrug Ringfietspad
655,Ringfietspad Zurenborgbrug,2022-08-22,10:00:00,85,41,44,FMN 06 B Zurenborgbrug Ringfietspad
655,Ringfietspad Zurenborgbrug,2022-08-22,11:00:00,141,66,75,FMN 06 B Zurenborgbrug Ringfietspad
655,Ringfietspad Zurenborgbrug,2022-08-22,12:00:00,195,102,93,FMN 06 B Zurenborgbrug Ringfietspad
655,Ringfietspad Zurenborgbrug,2022-08-22,13:00:00,204,97,107,FMN 06 B Zurenborgbrug Ringfietspad
655,Ringfietspad Zurenborgbrug,2022-08-22,14:00:00,205,90,115,FMN 06 B Zurenborgbrug Ringfietspad
655,Ringfietspad Zurenborgbrug,2022-08-22,15:00:00,242,110,132,FMN 06 B Zurenborgbrug Ringfietspad
655,Ringfietspad Zurenborgbrug,2022-08-22,16:00:00,447,201,246,FMN 06 B Zurenborgbrug Ringfietspad
655,Ringfietspad Zurenborgbrug,2022-08-22,17:00:00,489,188,301,FMN 06 B Zurenborgbrug Ringfietspad
655,Ringfietspad Zurenborgbrug,2022-08-22,18:00:00,237,108,129,FMN 06 B Zurenborgbrug Ringfietspad
655,Ringfietspad Zurenborgbrug,2022-08-22,19:00:00,206,58,148,FMN 06 B Zurenborgbrug Ringfietspad
655,Ringfietspad Zurenborgbrug,2022-08-22,20:00:00,146,60,86,FMN 06 B Zurenborgbrug Ringfietspad
655,Ringfietspad Zurenborgbrug,2022-08-22,21:00:00,77,35,42,FMN 06 B Zurenborgbrug Ringfietspad
655,Ringfietspad Zurenborgbrug,2022-08-22,22:00:00,83,27,56,FMN 06 B Zurenborgbrug Ringfietspad
655,Ringfietspad Zurenborgbrug,2022-08-22,23:00:00,100,74,26,FMN 06 B Zurenborgbrug Ringfietspad
655,Ringfietspad Zurenborgbrug,2022-08-23,00:00:00,27,17,10,FMN 06 B Zurenborgbrug Ringfietspad
655,Ringfietspad Zurenborgbrug,2022-08-23,01:00:00,7,5,2,FMN 06 B Zurenborgbrug Ringfietspad
655,Ringfietspad Zurenborgbrug,2022-08-23,02:00:00,7,5,2,FMN 06 B Zurenborgbrug Ringfietspad
655,Ringfietspad Zurenborgbrug,2022-08-23,03:00:00,3,0,3,FMN 06 B Zurenborgbrug Ringfietspad
655,Ringfietspad Zurenborgbrug,2022-08-23,04:00:00,14,11,3,FMN 06 B Zurenborgbrug Ringfietspad
655,Ringfietspad Zurenborgbrug,2022-08-23,05:00:00,62,33,29,FMN 06 B Zurenborgbrug Ringfietspad
655,Ringfietspad Zurenborgbrug,2022-08-23,06:00:00,161,86,75,FMN 06 B Zurenborgbrug Ringfietspad
655,Ringfietspad Zurenborgbrug,2022-08-23,07:00:00,362,246,116,FMN 06 B Zurenborgbrug Ringfietspad
655,Ringfietspad Zurenborgbrug,2022-08-23,08:00:00,490,273,217,FMN 06 B Zurenborgbrug Ringfietspad
655,Ringfietspad Zurenborgbrug,2022-08-23,09:00:00,190,122,68,FMN 06 B Zurenborgbrug Ringfietspad
655,Ringfietspad Zurenborgbrug,2022-08-23,10:00:00,143,74,69,FMN 06 B Zurenborgbrug Ringfietspad
655,Ringfietspad Zurenborgbrug,2022-08-23,11:00:00,171,92,79,FMN 06 B Zurenborgbrug Ringfietspad
655,Ringfietspad Zurenborgbrug,2022-08-23,12:00:00,196,99,97,FMN 06 B Zurenborgbrug Ringfietspad
655,Ringfietspad Zurenborgbrug,2022-08-23,13:00:00,234,101,133,FMN 06 B Zurenborgbrug Ringfietspad
655,Ringfietspad Zurenborgbrug,2022-08-23,14:00:00,237,80,157,FMN 06 B Zurenborgbrug Ringfietspad
655,Ringfietspad Zurenborgbrug,2022-08-23,15:00:00,281,119,162,FMN 06 B Zurenborgbrug Ringfietspad
655,Ringfietspad Zurenborgbrug,2022-08-23,16:00:00,543,221,322,FMN 06 B Zurenborgbrug Ringfietspad
655,Ringfietspad Zurenborgbrug,2022-08-23,17:00:00,562,216,346,FMN 06 B Zurenborgbrug Ringfietspad
655,Ringfietspad Zurenborgbrug,2022-08-23,18:00:00,333,134,199,FMN 06 B Zurenborgbrug Ringfietspad
655,Ringfietspad Zurenborgbrug,2022-08-23,19:00:00,253,85,168,FMN 06 B Zurenborgbrug Ringfietspad
655,Ringfietspad Zurenborgbrug,2022-08-23,20:00:00,156,77,79,FMN 06 B Zurenborgbrug Ringfietspad
655,Ringfietspad Zurenborgbrug,2022-08-23,21:00:00,109,50,59,FMN 06 B Zurenborgbrug Ringfietspad
655,Ringfietspad Zurenborgbrug,2022-08-23,22:00:00,107,37,70,FMN 06 B Zurenborgbrug Ringfietspad
655,Ringfietspad Zurenborgbrug,2022-08-23,23:00:00,92,72,20,FMN 06 B Zurenborgbrug Ringfietspad
655,Ringfietspad Zurenborgbrug,2022-08-24,00:00:00,34,22,12,FMN 06 B Zurenborgbrug Ringfietspad
655,Ringfietspad Zurenborgbrug,2022-08-24,01:00:00,18,10,8,FMN 06 B Zurenborgbrug Ringfietspad
655,Ringfietspad Zurenborgbrug,2022-08-24,02:00:00,4,2,2,FMN 06 B Zurenborgbrug Ringfietspad
655,Ringfietspad Zurenborgbrug,2022-08-24,03:00:00,5,1,4,FMN 06 B Zurenborgbrug Ringfietspad
655,Ringfietspad Zurenborgbrug,2022-08-24,04:00:00,20,12,8,FMN 06 B Zurenborgbrug Ringfietspad
655,Ringfietspad Zurenborgbrug,2022-08-24,05:00:00,44,22,22,FMN 06 B Zurenborgbrug Ringfietspad
655,Ringfietspad Zurenborgbrug,2022-08-24,06:00:00,146,79,67,FMN 06 B Zurenborgbrug Ringfietspad
655,Ringfietspad Zurenborgbrug,2022-08-24,07:00:00,331,212,119,FMN 06 B Zurenborgbrug Ringfietspad
655,Ringfietspad Zurenborgbrug,2022-08-24,08:00:00,413,224,189,FMN 06 B Zurenborgbrug Ringfietspad
655,Ringfietspad Zurenborgbrug,2022-08-24,09:00:00,186,82,104,FMN 06 B Zurenborgbrug Ringfietspad
655,Ringfietspad Zurenborgbrug,2022-08-24,10:00:00,158,73,85,FMN 06 B Zurenborgbrug Ringfietspad
655,Ringfietspad Zurenborgbrug,2022-08-24,11:00:00,184,81,103,FMN 06 B Zurenborgbrug Ringfietspad
655,Ringfietspad Zurenborgbrug,2022-08-24,12:00:00,230,105,125,FMN 06 B Zurenborgbrug Ringfietspad
655,Ringfietspad Zurenborgbrug,2022-08-24,13:00:00,201,108,93,FMN 06 B Zurenborgbrug Ringfietspad
655,Ringfietspad Zurenborgbrug,2022-08-24,14:00:00,244,111,133,FMN 06 B Zurenborgbrug Ringfietspad
655,Ringfietspad Zurenborgbrug,2022-08-24,15:00:00,279,119,160,FMN 06 B Zurenborgbrug Ringfietspad
655,Ringfietspad Zurenborgbrug,2022-08-24,16:00:00,439,181,258,FMN 06 B Zurenborgbrug Ringfietspad
655,Ringfietspad Zurenborgbrug,2022-08-24,17:00:00,515,216,299,FMN 06 B Zurenborgbrug Ringfietspad
655,Ringfietspad Zurenborgbrug,2022-08-24,18:00:00,310,139,171,FMN 06 B Zurenborgbrug Ringfietspad
655,Ringfietspad Zurenborgbrug,2022-08-24,19:00:00,216,88,128,FMN 06 B Zurenborgbrug Ringfietspad
655,Ringfietspad Zurenborgbrug,2022-08-24,20:00:00,186,94,92,FMN 06 B Zurenborgbrug Ringfietspad
655,Ringfietspad Zurenborgbrug,2022-08-24,21:00:00,131,56,75,FMN 06 B Zurenborgbrug Ringfietspad
655,Ringfietspad Zurenborgbrug,2022-08-24,22:00:00,123,67,56,FMN 06 B Zurenborgbrug Ringfietspad
655,Ringfietspad Zurenborgbrug,2022-08-24,23:00:00,56,18,38,FMN 06 B Zurenborgbrug Ringfietspad
655,Ringfietspad Zurenborgbrug,2022-08-25,00:00:00,30,16,14,FMN 06 B Zurenborgbrug Ringfietspad
655,Ringfietspad Zurenborgbrug,2022-08-25,01:00:00,15,7,8,FMN 06 B Zurenborgbrug Ringfietspad
655,Ringfietspad Zurenborgbrug,2022-08-25,02:00:00,8,5,3,FMN 06 B Zurenborgbrug Ringfietspad
655,Ringfietspad Zurenborgbrug,2022-08-25,03:00:00,6,3,3,FMN 06 B Zurenborgbrug Ringfietspad
655,Ringfietspad Zurenborgbrug,2022-08-25,04:00:00,16,13,3,FMN 06 B Zurenborgbrug Ringfietspad
655,Ringfietspad Zurenborgbrug,2022-08-25,05:00:00,74,42,32,FMN 06 B Zurenborgbrug Ringfietspad
655,Ringfietspad Zurenborgbrug,2022-08-25,06:00:00,143,80,63,FMN 06 B Zurenborgbrug Ringfietspad
655,Ringfietspad Zurenborgbrug,2022-08-25,07:00:00,349,208,141,FMN 06 B Zurenborgbrug Ringfietspad
655,Ringfietspad Zurenborgbrug,2022-08-25,08:00:00,490,282,208,FMN 06 B Zurenborgbrug Ringfietspad
655,Ringfietspad Zurenborgbrug,2022-08-25,09:00:00,240,142,98,FMN 06 B Zurenborgbrug Ringfietspad
655,Ringfietspad Zurenborgbrug,2022-08-25,10:00:00,144,81,63,FMN 06 B Zurenborgbrug Ringfietspad
655,Ringfietspad Zurenborgbrug,2022-08-25,11:00:00,153,71,82,FMN 06 B Zurenborgbrug Ringfietspad
655,Ringfietspad Zurenborgbrug,2022-08-25,12:00:00,193,94,99,FMN 06 B Zurenborgbrug Ringfietspad
655,Ringfietspad Zurenborgbrug,2022-08-25,13:00:00,226,98,128,FMN 06 B Zurenborgbrug Ringfietspad
655,Ringfietspad Zurenborgbrug,2022-08-25,14:00:00,199,74,125,FMN 06 B Zurenborgbrug Ringfietspad
655,Ringfietspad Zurenborgbrug,2022-08-25,15:00:00,287,121,166,FMN 06 B Zurenborgbrug Ringfietspad
655,Ringfietspad Zurenborgbrug,2022-08-25,16:00:00,484,204,280,FMN 06 B Zurenborgbrug Ringfietspad
655,Ringfietspad Zurenborgbrug,2022-08-25,17:00:00,500,195,305,FMN 06 B Zurenborgbrug Ringfietspad
655,Ringfietspad Zurenborgbrug,2022-08-25,18:00:00,332,134,198,FMN 06 B Zurenborgbrug Ringfietspad
655,Ringfietspad Zurenborgbrug,2022-08-25,19:00:00,272,80,192,FMN 06 B Zurenborgbrug Ringfietspad
655,Ringfietspad Zurenborgbrug,2022-08-25,20:00:00,158,55,103,FMN 06 B Zurenborgbrug Ringfietspad
655,Ringfietspad Zurenborgbrug,2022-08-25,21:00:00,112,47,65,FMN 06 B Zurenborgbrug Ringfietspad
655,Ringfietspad Zurenborgbrug,2022-08-25,22:00:00,102,52,50,FMN 06 B Zurenborgbrug Ringfietspad
655,Ringfietspad Zurenborgbrug,2022-08-25,23:00:00,111,86,25,FMN 06 B Zurenborgbrug Ringfietspad
655,Ringfietspad Zurenborgbrug,2022-08-26,00:00:00,37,19,18,FMN 06 B Zurenborgbrug Ringfietspad
655,Ringfietspad Zurenborgbrug,2022-08-26,01:00:00,18,12,6,FMN 06 B Zurenborgbrug Ringfietspad
655,Ringfietspad Zurenborgbrug,2022-08-26,02:00:00,9,9,0,FMN 06 B Zurenborgbrug Ringfietspad
655,Ringfietspad Zurenborgbrug,2022-08-26,03:00:00,5,2,3,FMN 06 B Zurenborgbrug Ringfietspad
655,Ringfietspad Zurenborgbrug,2022-08-26,04:00:00,18,10,8,FMN 06 B Zurenborgbrug Ringfietspad
655,Ringfietspad Zurenborgbrug,2022-08-26,05:00:00,44,28,16,FMN 06 B Zurenborgbrug Ringfietspad
655,Ringfietspad Zurenborgbrug,2022-08-26,06:00:00,110,58,52,FMN 06 B Zurenborgbrug Ringfietspad
655,Ringfietspad Zurenborgbrug,2022-08-26,07:00:00,268,168,100,FMN 06 B Zurenborgbrug Ringfietspad
655,Ringfietspad Zurenborgbrug,2022-08-26,08:00:00,361,180,181,FMN 06 B Zurenborgbrug Ringfietspad
655,Ringfietspad Zurenborgbrug,2022-08-26,09:00:00,161,80,81,FMN 06 B Zurenborgbrug Ringfietspad
655,Ringfietspad Zurenborgbrug,2022-08-26,10:00:00,116,54,62,FMN 06 B Zurenborgbrug Ringfietspad
655,Ringfietspad Zurenborgbrug,2022-08-26,11:00:00,131,71,60,FMN 06 B Zurenborgbrug Ringfietspad
655,Ringfietspad Zurenborgbrug,2022-08-26,12:00:00,194,82,112,FMN 06 B Zurenborgbrug Ringfietspad
655,Ringfietspad Zurenborgbrug,2022-08-26,13:00:00,178,76,102,FMN 06 B Zurenborgbrug Ringfietspad
655,Ringfietspad Zurenborgbrug,2022-08-26,14:00:00,186,87,99,FMN 06 B Zurenborgbrug Ringfietspad
655,Ringfietspad Zurenborgbrug,2022-08-26,15:00:00,253,107,146,FMN 06 B Zurenborgbrug Ringfietspad
655,Ringfietspad Zurenborgbrug,2022-08-26,16:00:00,368,169,199,FMN 06 B Zurenborgbrug Ringfietspad
655,Ringfietspad Zurenborgbrug,2022-08-26,17:00:00,353,148,205,FMN 06 B Zurenborgbrug Ringfietspad
655,Ringfietspad Zurenborgbrug,2022-08-26,18:00:00,246,100,146,FMN 06 B Zurenborgbrug Ringfietspad
655,Ringfietspad Zurenborgbrug,2022-08-26,19:00:00,173,60,113,FMN 06 B Zurenborgbrug Ringfietspad
655,Ringfietspad Zurenborgbrug,2022-08-26,20:00:00,119,55,64,FMN 06 B Zurenborgbrug Ringfietspad
655,Ringfietspad Zurenborgbrug,2022-08-26,21:00:00,83,34,49,FMN 06 B Zurenborgbrug Ringfietspad
655,Ringfietspad Zurenborgbrug,2022-08-26,22:00:00,107,67,40,FMN 06 B Zurenborgbrug Ringfietspad
655,Ringfietspad Zurenborgbrug,2022-08-26,23:00:00,72,46,26,FMN 06 B Zurenborgbrug Ringfietspad
655,Ringfietspad Zurenborgbrug,2022-08-27,00:00:00,35,14,21,FMN 06 B Zurenborgbrug Ringfietspad
655,Ringfietspad Zurenborgbrug,2022-08-27,01:00:00,23,8,15,FMN 06 B Zurenborgbrug Ringfietspad
655,Ringfietspad Zurenborgbrug,2022-08-27,02:00:00,10,7,3,FMN 06 B Zurenborgbrug Ringfietspad
655,Ringfietspad Zurenborgbrug,2022-08-27,03:00:00,14,7,7,FMN 06 B Zurenborgbrug Ringfietspad
655,Ringfietspad Zurenborgbrug,2022-08-27,04:00:00,12,6,6,FMN 06 B Zurenborgbrug Ringfietspad
655,Ringfietspad Zurenborgbrug,2022-08-27,05:00:00,15,9,6,FMN 06 B Zurenborgbrug Ringfietspad
655,Ringfietspad Zurenborgbrug,2022-08-27,06:00:00,29,19,10,FMN 06 B Zurenborgbrug Ringfietspad
655,Ringfietspad Zurenborgbrug,2022-08-27,07:00:00,47,31,16,FMN 06 B Zurenborgbrug Ringfietspad
655,Ringfietspad Zurenborgbrug,2022-08-27,08:00:00,53,29,24,FMN 06 B Zurenborgbrug Ringfietspad
655,Ringfietspad Zurenborgbrug,2022-08-27,09:00:00,150,58,92,FMN 06 B Zurenborgbrug Ringfietspad
655,Ringfietspad Zurenborgbrug,2022-08-27,10:00:00,153,78,75,FMN 06 B Zurenborgbrug Ringfietspad
655,Ringfietspad Zurenborgbrug,2022-08-27,11:00:00,208,96,112,FMN 06 B Zurenborgbrug Ringfietspad
655,Ringfietspad Zurenborgbrug,2022-08-27,12:00:00,184,80,104,FMN 06 B Zurenborgbrug Ringfietspad
655,Ringfietspad Zurenborgbrug,2022-08-27,13:00:00,219,88,131,FMN 06 B Zurenborgbrug Ringfietspad
655,Ringfietspad Zurenborgbrug,2022-08-27,14:00:00,233,89,144,FMN 06 B Zurenborgbrug Ringfietspad
655,Ringfietspad Zurenborgbrug,2022-08-27,15:00:00,233,108,125,FMN 06 B Zurenborgbrug Ringfietspad
655,Ringfietspad Zurenborgbrug,2022-08-27,16:00:00,201,98,103,FMN 06 B Zurenborgbrug Ringfietspad
655,Ringfietspad Zurenborgbrug,2022-08-27,17:00:00,170,88,82,FMN 06 B Zurenborgbrug Ringfietspad
655,Ringfietspad Zurenborgbrug,2022-08-27,18:00:00,143,65,78,FMN 06 B Zurenborgbrug Ringfietspad
655,Ringfietspad Zurenborgbrug,2022-08-27,19:00:00,138,74,64,FMN 06 B Zurenborgbrug Ringfietspad
655,Ringfietspad Zurenborgbrug,2022-08-27,20:00:00,106,40,66,FMN 06 B Zurenborgbrug Ringfietspad
655,Ringfietspad Zurenborgbrug,2022-08-27,21:00:00,58,28,30,FMN 06 B Zurenborgbrug Ringfietspad
655,Ringfietspad Zurenborgbrug,2022-08-27,22:00:00,64,25,39,FMN 06 B Zurenborgbrug Ringfietspad
655,Ringfietspad Zurenborgbrug,2022-08-27,23:00:00,70,31,39,FMN 06 B Zurenborgbrug Ringfietspad
655,Ringfietspad Zurenborgbrug,2022-08-28,00:00:00,38,10,28,FMN 06 B Zurenborgbrug Ringfietspad
655,Ringfietspad Zurenborgbrug,2022-08-28,01:00:00,29,11,18,FMN 06 B Zurenborgbrug Ringfietspad
655,Ringfietspad Zurenborgbrug,2022-08-28,02:00:00,14,4,10,FMN 06 B Zurenborgbrug Ringfietspad
655,Ringfietspad Zurenborgbrug,2022-08-28,03:00:00,9,2,7,FMN 06 B Zurenborgbrug Ringfietspad
655,Ringfietspad Zurenborgbrug,2022-08-28,04:00:00,13,5,8,FMN 06 B Zurenborgbrug Ringfietspad
655,Ringfietspad Zurenborgbrug,2022-08-28,05:00:00,13,8,5,FMN 06 B Zurenborgbrug Ringfietspad
655,Ringfietspad Zurenborgbrug,2022-08-28,06:00:00,25,12,13,FMN 06 B Zurenborgbrug Ringfietspad
655,Ringfietspad Zurenborgbrug,2022-08-28,07:00:00,32,18,14,FMN 06 B Zurenborgbrug Ringfietspad
655,Ringfietspad Zurenborgbrug,2022-08-28,08:00:00,47,18,29,FMN 06 B Zurenborgbrug Ringfietspad
655,Ringfietspad Zurenborgbrug,2022-08-28,09:00:00,143,52,91,FMN 06 B Zurenborgbrug Ringfietspad
655,Ringfietspad Zurenborgbrug,2022-08-28,10:00:00,149,64,85,FMN 06 B Zurenborgbrug Ringfietspad
655,Ringfietspad Zurenborgbrug,2022-08-28,11:00:00,180,87,93,FMN 06 B Zurenborgbrug Ringfietspad
655,Ringfietspad Zurenborgbrug,2022-08-28,12:00:00,202,81,121,FMN 06 B Zurenborgbrug Ringfietspad
655,Ringfietspad Zurenborgbrug,2022-08-28,13:00:00,250,113,137,FMN 06 B Zurenborgbrug Ringfietspad
655,Ringfietspad Zurenborgbrug,2022-08-28,14:00:00,334,161,173,FMN 06 B Zurenborgbrug Ringfietspad
655,Ringfietspad Zurenborgbrug,2022-08-28,15:00:00,310,124,186,FMN 06 B Zurenborgbrug Ringfietspad
655,Ringfietspad Zurenborgbrug,2022-08-28,16:00:00,230,119,111,FMN 06 B Zurenborgbrug Ringfietspad
655,Ringfietspad Zurenborgbrug,2022-08-28,17:00:00,202,122,80,FMN 06 B Zurenborgbrug Ringfietspad
655,Ringfietspad Zurenborgbrug,2022-08-28,18:00:00,184,103,81,FMN 06 B Zurenborgbrug Ringfietspad
655,Ringfietspad Zurenborgbrug,2022-08-28,19:00:00,136,56,80,FMN 06 B Zurenborgbrug Ringfietspad
655,Ringfietspad Zurenborgbrug,2022-08-28,20:00:00,127,66,61,FMN 06 B Zurenborgbrug Ringfietspad
655,Ringfietspad Zurenborgbrug,2022-08-28,21:00:00,111,42,69,FMN 06 B Zurenborgbrug Ringfietspad
655,Ringfietspad Zurenborgbrug,2022-08-28,22:00:00,54,12,42,FMN 06 B Zurenborgbrug Ringfietspad
655,Ringfietspad Zurenborgbrug,2022-08-28,23:00:00,24,14,10,FMN 06 B Zurenborgbrug Ringfietspad
655,Ringfietspad Zurenborgbrug,2022-08-29,00:00:00,12,6,6,FMN 06 B Zurenborgbrug Ringfietspad
655,Ringfietspad Zurenborgbrug,2022-08-29,01:00:00,10,5,5,FMN 06 B Zurenborgbrug Ringfietspad
655,Ringfietspad Zurenborgbrug,2022-08-29,02:00:00,2,1,1,FMN 06 B Zurenborgbrug Ringfietspad
655,Ringfietspad Zurenborgbrug,2022-08-29,03:00:00,5,1,4,FMN 06 B Zurenborgbrug Ringfietspad
655,Ringfietspad Zurenborgbrug,2022-08-29,04:00:00,15,11,4,FMN 06 B Zurenborgbrug Ringfietspad
655,Ringfietspad Zurenborgbrug,2022-08-29,05:00:00,62,37,25,FMN 06 B Zurenborgbrug Ringfietspad
655,Ringfietspad Zurenborgbrug,2022-08-29,06:00:00,152,89,63,FMN 06 B Zurenborgbrug Ringfietspad
655,Ringfietspad Zurenborgbrug,2022-08-29,07:00:00,372,225,147,FMN 06 B Zurenborgbrug Ringfietspad
655,Ringfietspad Zurenborgbrug,2022-08-29,08:00:00,497,284,213,FMN 06 B Zurenborgbrug Ringfietspad
655,Ringfietspad Zurenborgbrug,2022-08-29,09:00:00,174,103,71,FMN 06 B Zurenborgbrug Ringfietspad
655,Ringfietspad Zurenborgbrug,2022-08-29,10:00:00,135,59,76,FMN 06 B Zurenborgbrug Ringfietspad
655,Ringfietspad Zurenborgbrug,2022-08-29,11:00:00,136,67,69,FMN 06 B Zurenborgbrug Ringfietspad
655,Ringfietspad Zurenborgbrug,2022-08-29,12:00:00,209,100,109,FMN 06 B Zurenborgbrug Ringfietspad
655,Ringfietspad Zurenborgbrug,2022-08-29,13:00:00,216,108,108,FMN 06 B Zurenborgbrug Ringfietspad
655,Ringfietspad Zurenborgbrug,2022-08-29,14:00:00,239,99,140,FMN 06 B Zurenborgbrug Ringfietspad
655,Ringfietspad Zurenborgbrug,2022-08-29,15:00:00,330,127,203,FMN 06 B Zurenborgbrug Ringfietspad
655,Ringfietspad Zurenborgbrug,2022-08-29,16:00:00,439,189,250,FMN 06 B Zurenborgbrug Ringfietspad
655,Ringfietspad Zurenborgbrug,2022-08-29,17:00:00,540,222,318,FMN 06 B Zurenborgbrug Ringfietspad
655,Ringfietspad Zurenborgbrug,2022-08-29,18:00:00,296,125,171,FMN 06 B Zurenborgbrug Ringfietspad
655,Ringfietspad Zurenborgbrug,2022-08-29,19:00:00,190,87,103,FMN 06 B Zurenborgbrug Ringfietspad
655,Ringfietspad Zurenborgbrug,2022-08-29,20:00:00,155,73,82,FMN 06 B Zurenborgbrug Ringfietspad
655,Ringfietspad Zurenborgbrug,2022-08-29,21:00:00,102,44,58,FMN 06 B Zurenborgbrug Ringfietspad
655,Ringfietspad Zurenborgbrug,2022-08-29,22:00:00,94,28,66,FMN 06 B Zurenborgbrug Ringfietspad
655,Ringfietspad Zurenborgbrug,2022-08-29,23:00:00,50,27,23,FMN 06 B Zurenborgbrug Ringfietspad
655,Ringfietspad Zurenborgbrug,2022-08-30,00:00:00,11,6,5,FMN 06 B Zurenborgbrug Ringfietspad
655,Ringfietspad Zurenborgbrug,2022-08-30,01:00:00,9,4,5,FMN 06 B Zurenborgbrug Ringfietspad
655,Ringfietspad Zurenborgbrug,2022-08-30,02:00:00,6,2,4,FMN 06 B Zurenborgbrug Ringfietspad
655,Ringfietspad Zurenborgbrug,2022-08-30,03:00:00,5,1,4,FMN 06 B Zurenborgbrug Ringfietspad
655,Ringfietspad Zurenborgbrug,2022-08-30,04:00:00,18,11,7,FMN 06 B Zurenborgbrug Ringfietspad
655,Ringfietspad Zurenborgbrug,2022-08-30,05:00:00,54,31,23,FMN 06 B Zurenborgbrug Ringfietspad
655,Ringfietspad Zurenborgbrug,2022-08-30,06:00:00,157,81,76,FMN 06 B Zurenborgbrug Ringfietspad
655,Ringfietspad Zurenborgbrug,2022-08-30,07:00:00,449,265,184,FMN 06 B Zurenborgbrug Ringfietspad
655,Ringfietspad Zurenborgbrug,2022-08-30,08:00:00,583,295,288,FMN 06 B Zurenborgbrug Ringfietspad
655,Ringfietspad Zurenborgbrug,2022-08-30,09:00:00,200,110,90,FMN 06 B Zurenborgbrug Ringfietspad
655,Ringfietspad Zurenborgbrug,2022-08-30,10:00:00,131,57,74,FMN 06 B Zurenborgbrug Ringfietspad
655,Ringfietspad Zurenborgbrug,2022-08-30,11:00:00,165,73,92,FMN 06 B Zurenborgbrug Ringfietspad
655,Ringfietspad Zurenborgbrug,2022-08-30,12:00:00,173,91,82,FMN 06 B Zurenborgbrug Ringfietspad
655,Ringfietspad Zurenborgbrug,2022-08-30,13:00:00,224,107,117,FMN 06 B Zurenborgbrug Ringfietspad
655,Ringfietspad Zurenborgbrug,2022-08-30,14:00:00,232,107,125,FMN 06 B Zurenborgbrug Ringfietspad
655,Ringfietspad Zurenborgbrug,2022-08-30,15:00:00,301,120,181,FMN 06 B Zurenborgbrug Ringfietspad
655,Ringfietspad Zurenborgbrug,2022-08-30,16:00:00,513,239,274,FMN 06 B Zurenborgbrug Ringfietspad
655,Ringfietspad Zurenborgbrug,2022-08-30,17:00:00,582,260,322,FMN 06 B Zurenborgbrug Ringfietspad
655,Ringfietspad Zurenborgbrug,2022-08-30,18:00:00,348,124,224,FMN 06 B Zurenborgbrug Ringfietspad
655,Ringfietspad Zurenborgbrug,2022-08-30,19:00:00,280,91,189,FMN 06 B Zurenborgbrug Ringfietspad
655,Ringfietspad Zurenborgbrug,2022-08-30,20:00:00,180,74,106,FMN 06 B Zurenborgbrug Ringfietspad
655,Ringfietspad Zurenborgbrug,2022-08-30,21:00:00,102,39,63,FMN 06 B Zurenborgbrug Ringfietspad
655,Ringfietspad Zurenborgbrug,2022-08-30,22:00:00,127,65,62,FMN 06 B Zurenborgbrug Ringfietspad
655,Ringfietspad Zurenborgbrug,2022-08-30,23:00:00,113,92,21,FMN 06 B Zurenborgbrug Ringfietspad
655,Ringfietspad Zurenborgbrug,2022-08-31,00:00:00,46,35,11,FMN 06 B Zurenborgbrug Ringfietspad
655,Ringfietspad Zurenborgbrug,2022-08-31,01:00:00,13,4,9,FMN 06 B Zurenborgbrug Ringfietspad
655,Ringfietspad Zurenborgbrug,2022-08-31,02:00:00,2,0,2,FMN 06 B Zurenborgbrug Ringfietspad
655,Ringfietspad Zurenborgbrug,2022-08-31,03:00:00,6,3,3,FMN 06 B Zurenborgbrug Ringfietspad
655,Ringfietspad Zurenborgbrug,2022-08-31,04:00:00,14,6,8,FMN 06 B Zurenborgbrug Ringfietspad
655,Ringfietspad Zurenborgbrug,2022-08-31,05:00:00,58,38,20,FMN 06 B Zurenborgbrug Ringfietspad
655,Ringfietspad Zurenborgbrug,2022-08-31,06:00:00,142,78,64,FMN 06 B Zurenborgbrug Ringfietspad
655,Ringfietspad Zurenborgbrug,2022-08-31,07:00:00,340,195,145,FMN 06 B Zurenborgbrug Ringfietspad
655,Ringfietspad Zurenborgbrug,2022-08-31,08:00:00,437,255,182,FMN 06 B Zurenborgbrug Ringfietspad
655,Ringfietspad Zurenborgbrug,2022-08-31,09:00:00,188,94,94,FMN 06 B Zurenborgbrug Ringfietspad
655,Ringfietspad Zurenborgbrug,2022-08-31,10:00:00,146,57,89,FMN 06 B Zurenborgbrug Ringfietspad
655,Ringfietspad Zurenborgbrug,2022-08-31,11:00:00,163,84,79,FMN 06 B Zurenborgbrug Ringfietspad
655,Ringfietspad Zurenborgbrug,2022-08-31,12:00:00,237,120,117,FMN 06 B Zurenborgbrug Ringfietspad
655,Ringfietspad Zurenborgbrug,2022-08-31,13:00:00,252,129,123,FMN 06 B Zurenborgbrug Ringfietspad
655,Ringfietspad Zurenborgbrug,2022-08-31,14:00:00,272,123,149,FMN 06 B Zurenborgbrug Ringfietspad
655,Ringfietspad Zurenborgbrug,2022-08-31,15:00:00,296,126,170,FMN 06 B Zurenborgbrug Ringfietspad
655,Ringfietspad Zurenborgbrug,2022-08-31,16:00:00,496,196,300,FMN 06 B Zurenborgbrug Ringfietspad
655,Ringfietspad Zurenborgbrug,2022-08-31,17:00:00,525,199,326,FMN 06 B Zurenborgbrug Ringfietspad
655,Ringfietspad Zurenborgbrug,2022-08-31,18:00:00,389,143,246,FMN 06 B Zurenborgbrug Ringfietspad
655,Ringfietspad Zurenborgbrug,2022-08-31,19:00:00,353,82,271,FMN 06 B Zurenborgbrug Ringfietspad
655,Ringfietspad Zurenborgbrug,2022-08-31,20:00:00,175,73,102,FMN 06 B Zurenborgbrug Ringfietspad
655,Ringfietspad Zurenborgbrug,2022-08-31,21:00:00,107,49,58,FMN 06 B Zurenborgbrug Ringfietspad
655,Ringfietspad Zurenborgbrug,2022-08-31,22:00:00,129,78,51,FMN 06 B Zurenborgbrug Ringfietspad
655,Ringfietspad Zurenborgbrug,2022-08-31,23:00:00,165,144,21,FMN 06 B Zurenborgbrug Ringfietspad
655,Ringfietspad Zurenborgbrug,2022-09-01,00:00:00,45,36,9,FMN 06 B Zurenborgbrug Ringfietspad
655,Ringfietspad Zurenborgbrug,2022-09-01,01:00:00,8,4,4,FMN 06 B Zurenborgbrug Ringfietspad
655,Ringfietspad Zurenborgbrug,2022-09-01,02:00:00,2,1,1,FMN 06 B Zurenborgbrug Ringfietspad
655,Ringfietspad Zurenborgbrug,2022-09-01,03:00:00,1,1,0,FMN 06 B Zurenborgbrug Ringfietspad
655,Ringfietspad Zurenborgbrug,2022-09-01,04:00:00,16,10,6,FMN 06 B Zurenborgbrug Ringfietspad
655,Ringfietspad Zurenborgbrug,2022-09-01,05:00:00,46,28,18,FMN 06 B Zurenborgbrug Ringfietspad
655,Ringfietspad Zurenborgbrug,2022-09-01,06:00:00,155,94,61,FMN 06 B Zurenborgbrug Ringfietspad
655,Ringfietspad Zurenborgbrug,2022-09-01,07:00:00,510,287,223,FMN 06 B Zurenborgbrug Ringfietspad
655,Ringfietspad Zurenborgbrug,2022-09-01,08:00:00,674,383,291,FMN 06 B Zurenborgbrug Ringfietspad
655,Ringfietspad Zurenborgbrug,2022-09-01,09:00:00,313,156,157,FMN 06 B Zurenborgbrug Ringfietspad
655,Ringfietspad Zurenborgbrug,2022-09-01,10:00:00,167,82,85,FMN 06 B Zurenborgbrug Ringfietspad
655,Ringfietspad Zurenborgbrug,2022-09-01,11:00:00,151,84,67,FMN 06 B Zurenborgbrug Ringfietspad
655,Ringfietspad Zurenborgbrug,2022-09-01,12:00:00,214,119,95,FMN 06 B Zurenborgbrug Ringfietspad
655,Ringfietspad Zurenborgbrug,2022-09-01,13:00:00,259,136,123,FMN 06 B Zurenborgbrug Ringfietspad
655,Ringfietspad Zurenborgbrug,2022-09-01,14:00:00,260,112,148,FMN 06 B Zurenborgbrug Ringfietspad
655,Ringfietspad Zurenborgbrug,2022-09-01,15:00:00,410,145,265,FMN 06 B Zurenborgbrug Ringfietspad
655,Ringfietspad Zurenborgbrug,2022-09-01,16:00:00,627,268,359,FMN 06 B Zurenborgbrug Ringfietspad
655,Ringfietspad Zurenborgbrug,2022-09-01,17:00:00,567,222,345,FMN 06 B Zurenborgbrug Ringfietspad
655,Ringfietspad Zurenborgbrug,2022-09-01,18:00:00,351,157,194,FMN 06 B Zurenborgbrug Ringfietspad
655,Ringfietspad Zurenborgbrug,2022-09-01,19:00:00,212,82,130,FMN 06 B Zurenborgbrug Ringfietspad
655,Ringfietspad Zurenborgbrug,2022-09-01,20:00:00,165,84,81,FMN 06 B Zurenborgbrug Ringfietspad
655,Ringfietspad Zurenborgbrug,2022-09-01,21:00:00,105,48,57,FMN 06 B Zurenborgbrug Ringfietspad
655,Ringfietspad Zurenborgbrug,2022-09-01,22:00:00,91,31,60,FMN 06 B Zurenborgbrug Ringfietspad
655,Ringfietspad Zurenborgbrug,2022-09-01,23:00:00,78,48,30,FMN 06 B Zurenborgbrug Ringfietspad
655,Ringfietspad Zurenborgbrug,2022-09-02,00:00:00,21,11,10,FMN 06 B Zurenborgbrug Ringfietspad
655,Ringfietspad Zurenborgbrug,2022-09-02,01:00:00,9,2,7,FMN 06 B Zurenborgbrug Ringfietspad
655,Ringfietspad Zurenborgbrug,2022-09-02,02:00:00,6,1,5,FMN 06 B Zurenborgbrug Ringfietspad
655,Ringfietspad Zurenborgbrug,2022-09-02,03:00:00,4,2,2,FMN 06 B Zurenborgbrug Ringfietspad
655,Ringfietspad Zurenborgbrug,2022-09-02,04:00:00,14,4,10,FMN 06 B Zurenborgbrug Ringfietspad
655,Ringfietspad Zurenborgbrug,2022-09-02,05:00:00,48,31,17,FMN 06 B Zurenborgbrug Ringfietspad
655,Ringfietspad Zurenborgbrug,2022-09-02,06:00:00,117,67,50,FMN 06 B Zurenborgbrug Ringfietspad
655,Ringfietspad Zurenborgbrug,2022-09-02,07:00:00,514,278,236,FMN 06 B Zurenborgbrug Ringfietspad
655,Ringfietspad Zurenborgbrug,2022-09-02,08:00:00,596,326,270,FMN 06 B Zurenborgbrug Ringfietspad
655,Ringfietspad Zurenborgbrug,2022-09-02,09:00:00,182,101,81,FMN 06 B Zurenborgbrug Ringfietspad
655,Ringfietspad Zurenborgbrug,2022-09-02,10:00:00,152,73,79,FMN 06 B Zurenborgbrug Ringfietspad
655,Ringfietspad Zurenborgbrug,2022-09-02,11:00:00,165,86,79,FMN 06 B Zurenborgbrug Ringfietspad
655,Ringfietspad Zurenborgbrug,2022-09-02,12:00:00,229,114,115,FMN 06 B Zurenborgbrug Ringfietspad
655,Ringfietspad Zurenborgbrug,2022-09-02,13:00:00,240,125,115,FMN 06 B Zurenborgbrug Ringfietspad
655,Ringfietspad Zurenborgbrug,2022-09-02,14:00:00,238,108,130,FMN 06 B Zurenborgbrug Ringfietspad
655,Ringfietspad Zurenborgbrug,2022-09-02,15:00:00,393,162,231,FMN 06 B Zurenborgbrug Ringfietspad
655,Ringfietspad Zurenborgbrug,2022-09-02,16:00:00,556,267,289,FMN 06 B Zurenborgbrug Ringfietspad
655,Ringfietspad Zurenborgbrug,2022-09-02,17:00:00,472,172,300,FMN 06 B Zurenborgbrug Ringfietspad
655,Ringfietspad Zurenborgbrug,2022-09-02,18:00:00,318,116,202,FMN 06 B Zurenborgbrug Ringfietspad
655,Ringfietspad Zurenborgbrug,2022-09-02,19:00:00,267,71,196,FMN 06 B Zurenborgbrug Ringfietspad
655,Ringfietspad Zurenborgbrug,2022-09-02,20:00:00,162,65,97,FMN 06 B Zurenborgbrug Ringfietspad
655,Ringfietspad Zurenborgbrug,2022-09-02,21:00:00,116,52,64,FMN 06 B Zurenborgbrug Ringfietspad
655,Ringfietspad Zurenborgbrug,2022-09-02,22:00:00,78,38,40,FMN 06 B Zurenborgbrug Ringfietspad
655,Ringfietspad Zurenborgbrug,2022-09-02,23:00:00,135,95,40,FMN 06 B Zurenborgbrug Ringfietspad
655,Ringfietspad Zurenborgbrug,2022-09-03,00:00:00,71,44,27,FMN 06 B Zurenborgbrug Ringfietspad
655,Ringfietspad Zurenborgbrug,2022-09-03,01:00:00,28,8,20,FMN 06 B Zurenborgbrug Ringfietspad
655,Ringfietspad Zurenborgbrug,2022-09-03,02:00:00,17,11,6,FMN 06 B Zurenborgbrug Ringfietspad
655,Ringfietspad Zurenborgbrug,2022-09-03,03:00:00,10,4,6,FMN 06 B Zurenborgbrug Ringfietspad
655,Ringfietspad Zurenborgbrug,2022-09-03,04:00:00,10,4,6,FMN 06 B Zurenborgbrug Ringfietspad
655,Ringfietspad Zurenborgbrug,2022-09-03,05:00:00,24,12,12,FMN 06 B Zurenborgbrug Ringfietspad
655,Ringfietspad Zurenborgbrug,2022-09-03,06:00:00,35,20,15,FMN 06 B Zurenborgbrug Ringfietspad
655,Ringfietspad Zurenborgbrug,2022-09-03,07:00:00,36,23,13,FMN 06 B Zurenborgbrug Ringfietspad
655,Ringfietspad Zurenborgbrug,2022-09-03,08:00:00,94,38,56,FMN 06 B Zurenborgbrug Ringfietspad
655,Ringfietspad Zurenborgbrug,2022-09-03,09:00:00,115,55,60,FMN 06 B Zurenborgbrug Ringfietspad
655,Ringfietspad Zurenborgbrug,2022-09-03,10:00:00,103,49,54,FMN 06 B Zurenborgbrug Ringfietspad
655,Ringfietspad Zurenborgbrug,2022-09-03,11:00:00,164,82,82,FMN 06 B Zurenborgbrug Ringfietspad
655,Ringfietspad Zurenborgbrug,2022-09-03,12:00:00,178,77,101,FMN 06 B Zurenborgbrug Ringfietspad
655,Ringfietspad Zurenborgbrug,2022-09-03,13:00:00,189,72,117,FMN 06 B Zurenborgbrug Ringfietspad
655,Ringfietspad Zurenborgbrug,2022-09-03,14:00:00,211,87,124,FMN 06 B Zurenborgbrug Ringfietspad
655,Ringfietspad Zurenborgbrug,2022-09-03,15:00:00,230,105,125,FMN 06 B Zurenborgbrug Ringfietspad
655,Ringfietspad Zurenborgbrug,2022-09-03,16:00:00,159,72,87,FMN 06 B Zurenborgbrug Ringfietspad
655,Ringfietspad Zurenborgbrug,2022-09-03,17:00:00,184,106,78,FMN 06 B Zurenborgbrug Ringfietspad
655,Ringfietspad Zurenborgbrug,2022-09-03,18:00:00,180,91,89,FMN 06 B Zurenborgbrug Ringfietspad
655,Ringfietspad Zurenborgbrug,2022-09-03,19:00:00,178,61,117,FMN 06 B Zurenborgbrug Ringfietspad
655,Ringfietspad Zurenborgbrug,2022-09-03,20:00:00,103,54,49,FMN 06 B Zurenborgbrug Ringfietspad
655,Ringfietspad Zurenborgbrug,2022-09-03,21:00:00,71,40,31,FMN 06 B Zurenborgbrug Ringfietspad
655,Ringfietspad Zurenborgbrug,2022-09-03,22:00:00,65,33,32,FMN 06 B Zurenborgbrug Ringfietspad
655,Ringfietspad Zurenborgbrug,2022-09-03,23:00:00,109,81,28,FMN 06 B Zurenborgbrug Ringfietspad
655,Ringfietspad Zurenborgbrug,2022-09-04,00:00:00,53,33,20,FMN 06 B Zurenborgbrug Ringfietspad
655,Ringfietspad Zurenborgbrug,2022-09-04,01:00:00,33,8,25,FMN 06 B Zurenborgbrug Ringfietspad
655,Ringfietspad Zurenborgbrug,2022-09-04,02:00:00,12,2,10,FMN 06 B Zurenborgbrug Ringfietspad
655,Ringfietspad Zurenborgbrug,2022-09-04,03:00:00,15,3,12,FMN 06 B Zurenborgbrug Ringfietspad
655,Ringfietspad Zurenborgbrug,2022-09-04,04:00:00,14,6,8,FMN 06 B Zurenborgbrug Ringfietspad
655,Ringfietspad Zurenborgbrug,2022-09-04,05:00:00,14,5,9,FMN 06 B Zurenborgbrug Ringfietspad
655,Ringfietspad Zurenborgbrug,2022-09-04,06:00:00,21,8,13,FMN 06 B Zurenborgbrug Ringfietspad
655,Ringfietspad Zurenborgbrug,2022-09-04,07:00:00,30,18,12,FMN 06 B Zurenborgbrug Ringfietspad
655,Ringfietspad Zurenborgbrug,2022-09-04,08:00:00,62,31,31,FMN 06 B Zurenborgbrug Ringfietspad
655,Ringfietspad Zurenborgbrug,2022-09-04,09:00:00,145,63,82,FMN 06 B Zurenborgbrug Ringfietspad
655,Ringfietspad Zurenborgbrug,2022-09-04,10:00:00,199,94,105,FMN 06 B Zurenborgbrug Ringfietspad
655,Ringfietspad Zurenborgbrug,2022-09-04,11:00:00,202,108,94,FMN 06 B Zurenborgbrug Ringfietspad
655,Ringfietspad Zurenborgbrug,2022-09-04,12:00:00,263,127,136,FMN 06 B Zurenborgbrug Ringfietspad
655,Ringfietspad Zurenborgbrug,2022-09-04,13:00:00,295,151,144,FMN 06 B Zurenborgbrug Ringfietspad
655,Ringfietspad Zurenborgbrug,2022-09-04,14:00:00,363,134,229,FMN 06 B Zurenborgbrug Ringfietspad
655,Ringfietspad Zurenborgbrug,2022-09-04,15:00:00,301,118,183,FMN 06 B Zurenborgbrug Ringfietspad
655,Ringfietspad Zurenborgbrug,2022-09-04,16:00:00,242,109,133,FMN 06 B Zurenborgbrug Ringfietspad
655,Ringfietspad Zurenborgbrug,2022-09-04,17:00:00,237,116,121,FMN 06 B Zurenborgbrug Ringfietspad
655,Ringfietspad Zurenborgbrug,2022-09-04,18:00:00,257,164,93,FMN 06 B Zurenborgbrug Ringfietspad
655,Ringfietspad Zurenborgbrug,2022-09-04,19:00:00,188,120,68,FMN 06 B Zurenborgbrug Ringfietspad
655,Ringfietspad Zurenborgbrug,2022-09-04,20:00:00,119,65,54,FMN 06 B Zurenborgbrug Ringfietspad
655,Ringfietspad Zurenborgbrug,2022-09-04,21:00:00,69,33,36,FMN 06 B Zurenborgbrug Ringfietspad
655,Ringfietspad Zurenborgbrug,2022-09-04,22:00:00,37,13,24,FMN 06 B Zurenborgbrug Ringfietspad
655,Ringfietspad Zurenborgbrug,2022-09-04,23:00:00,33,20,13,FMN 06 B Zurenborgbrug Ringfietspad
655,Ringfietspad Zurenborgbrug,2022-09-05,00:00:00,26,15,11,FMN 06 B Zurenborgbrug Ringfietspad
655,Ringfietspad Zurenborgbrug,2022-09-05,01:00:00,6,4,2,FMN 06 B Zurenborgbrug Ringfietspad
655,Ringfietspad Zurenborgbrug,2022-09-05,02:00:00,2,1,1,FMN 06 B Zurenborgbrug Ringfietspad
655,Ringfietspad Zurenborgbrug,2022-09-05,03:00:00,1,1,0,FMN 06 B Zurenborgbrug Ringfietspad
655,Ringfietspad Zurenborgbrug,2022-09-05,04:00:00,21,11,10,FMN 06 B Zurenborgbrug Ringfietspad
655,Ringfietspad Zurenborgbrug,2022-09-05,05:00:00,57,36,21,FMN 06 B Zurenborgbrug Ringfietspad
655,Ringfietspad Zurenborgbrug,2022-09-05,06:00:00,151,89,62,FMN 06 B Zurenborgbrug Ringfietspad
655,Ringfietspad Zurenborgbrug,2022-09-05,07:00:00,576,342,234,FMN 06 B Zurenborgbrug Ringfietspad
655,Ringfietspad Zurenborgbrug,2022-09-05,08:00:00,694,393,301,FMN 06 B Zurenborgbrug Ringfietspad
655,Ringfietspad Zurenborgbrug,2022-09-05,09:00:00,203,106,97,FMN 06 B Zurenborgbrug Ringfietspad
655,Ringfietspad Zurenborgbrug,2022-09-05,10:00:00,144,57,87,FMN 06 B Zurenborgbrug Ringfietspad
655,Ringfietspad Zurenborgbrug,2022-09-05,11:00:00,146,71,75,FMN 06 B Zurenborgbrug Ringfietspad
655,Ringfietspad Zurenborgbrug,2022-09-05,12:00:00,226,123,103,FMN 06 B Zurenborgbrug Ringfietspad
655,Ringfietspad Zurenborgbrug,2022-09-05,13:00:00,179,78,101,FMN 06 B Zurenborgbrug Ringfietspad
655,Ringfietspad Zurenborgbrug,2022-09-05,14:00:00,212,102,110,FMN 06 B Zurenborgbrug Ringfietspad
655,Ringfietspad Zurenborgbrug,2022-09-05,15:00:00,414,180,234,FMN 06 B Zurenborgbrug Ringfietspad
655,Ringfietspad Zurenborgbrug,2022-09-05,16:00:00,641,280,361,FMN 06 B Zurenborgbrug Ringfietspad
655,Ringfietspad Zurenborgbrug,2022-09-05,17:00:00,602,242,360,FMN 06 B Zurenborgbrug Ringfietspad
655,Ringfietspad Zurenborgbrug,2022-09-05,18:00:00,337,149,188,FMN 06 B Zurenborgbrug Ringfietspad
655,Ringfietspad Zurenborgbrug,2022-09-05,19:00:00,194,70,124,FMN 06 B Zurenborgbrug Ringfietspad
655,Ringfietspad Zurenborgbrug,2022-09-05,20:00:00,164,63,101,FMN 06 B Zurenborgbrug Ringfietspad
655,Ringfietspad Zurenborgbrug,2022-09-05,21:00:00,79,33,46,FMN 06 B Zurenborgbrug Ringfietspad
655,Ringfietspad Zurenborgbrug,2022-09-05,22:00:00,117,78,39,FMN 06 B Zurenborgbrug Ringfietspad
655,Ringfietspad Zurenborgbrug,2022-09-05,23:00:00,62,49,13,FMN 06 B Zurenborgbrug Ringfietspad
655,Ringfietspad Zurenborgbrug,2022-09-06,00:00:00,12,5,7,FMN 06 B Zurenborgbrug Ringfietspad
655,Ringfietspad Zurenborgbrug,2022-09-06,01:00:00,3,2,1,FMN 06 B Zurenborgbrug Ringfietspad
655,Ringfietspad Zurenborgbrug,2022-09-06,02:00:00,4,3,1,FMN 06 B Zurenborgbrug Ringfietspad
655,Ringfietspad Zurenborgbrug,2022-09-06,03:00:00,1,0,1,FMN 06 B Zurenborgbrug Ringfietspad
655,Ringfietspad Zurenborgbrug,2022-09-06,04:00:00,21,10,11,FMN 06 B Zurenborgbrug Ringfietspad
655,Ringfietspad Zurenborgbrug,2022-09-06,05:00:00,63,33,30,FMN 06 B Zurenborgbrug Ringfietspad
655,Ringfietspad Zurenborgbrug,2022-09-06,06:00:00,152,86,66,FMN 06 B Zurenborgbrug Ringfietspad
655,Ringfietspad Zurenborgbrug,2022-09-06,07:00:00,575,339,236,FMN 06 B Zurenborgbrug Ringfietspad
655,Ringfietspad Zurenborgbrug,2022-09-06,08:00:00,697,401,296,FMN 06 B Zurenborgbrug Ringfietspad
655,Ringfietspad Zurenborgbrug,2022-09-06,09:00:00,210,116,94,FMN 06 B Zurenborgbrug Ringfietspad
655,Ringfietspad Zurenborgbrug,2022-09-06,10:00:00,139,66,73,FMN 06 B Zurenborgbrug Ringfietspad
655,Ringfietspad Zurenborgbrug,2022-09-06,11:00:00,153,85,68,FMN 06 B Zurenborgbrug Ringfietspad
655,Ringfietspad Zurenborgbrug,2022-09-06,12:00:00,222,124,98,FMN 06 B Zurenborgbrug Ringfietspad
655,Ringfietspad Zurenborgbrug,2022-09-06,13:00:00,205,102,103,FMN 06 B Zurenborgbrug Ringfietspad
655,Ringfietspad Zurenborgbrug,2022-09-06,14:00:00,252,108,144,FMN 06 B Zurenborgbrug Ringfietspad
655,Ringfietspad Zurenborgbrug,2022-09-06,15:00:00,363,145,218,FMN 06 B Zurenborgbrug Ringfietspad
655,Ringfietspad Zurenborgbrug,2022-09-06,16:00:00,735,295,440,FMN 06 B Zurenborgbrug Ringfietspad
655,Ringfietspad Zurenborgbrug,2022-09-06,17:00:00,630,235,395,FMN 06 B Zurenborgbrug Ringfietspad
655,Ringfietspad Zurenborgbrug,2022-09-06,18:00:00,315,119,196,FMN 06 B Zurenborgbrug Ringfietspad
655,Ringfietspad Zurenborgbrug,2022-09-06,19:00:00,203,67,136,FMN 06 B Zurenborgbrug Ringfietspad
655,Ringfietspad Zurenborgbrug,2022-09-06,20:00:00,180,71,109,FMN 06 B Zurenborgbrug Ringfietspad
655,Ringfietspad Zurenborgbrug,2022-09-06,21:00:00,111,48,63,FMN 06 B Zurenborgbrug Ringfietspad
655,Ringfietspad Zurenborgbrug,2022-09-06,22:00:00,108,43,65,FMN 06 B Zurenborgbrug Ringfietspad
655,Ringfietspad Zurenborgbrug,2022-09-06,23:00:00,56,40,16,FMN 06 B Zurenborgbrug Ringfietspad
655,Ringfietspad Zurenborgbrug,2022-09-07,00:00:00,13,4,9,FMN 06 B Zurenborgbrug Ringfietspad
655,Ringfietspad Zurenborgbrug,2022-09-07,01:00:00,8,6,2,FMN 06 B Zurenborgbrug Ringfietspad
655,Ringfietspad Zurenborgbrug,2022-09-07,02:00:00,3,1,2,FMN 06 B Zurenborgbrug Ringfietspad
655,Ringfietspad Zurenborgbrug,2022-09-07,03:00:00,2,0,2,FMN 06 B Zurenborgbrug Ringfietspad
655,Ringfietspad Zurenborgbrug,2022-09-07,04:00:00,22,8,14,FMN 06 B Zurenborgbrug Ringfietspad
655,Ringfietspad Zurenborgbrug,2022-09-07,05:00:00,51,29,22,FMN 06 B Zurenborgbrug Ringfietspad
655,Ringfietspad Zurenborgbrug,2022-09-07,06:00:00,144,80,64,FMN 06 B Zurenborgbrug Ringfietspad
655,Ringfietspad Zurenborgbrug,2022-09-07,07:00:00,451,258,193,FMN 06 B Zurenborgbrug Ringfietspad
655,Ringfietspad Zurenborgbrug,2022-09-07,08:00:00,558,308,250,FMN 06 B Zurenborgbrug Ringfietspad
655,Ringfietspad Zurenborgbrug,2022-09-07,09:00:00,174,80,94,FMN 06 B Zurenborgbrug Ringfietspad
655,Ringfietspad Zurenborgbrug,2022-09-07,10:00:00,116,71,45,FMN 06 B Zurenborgbrug Ringfietspad
655,Ringfietspad Zurenborgbrug,2022-09-07,11:00:00,179,113,66,FMN 06 B Zurenborgbrug Ringfietspad
655,Ringfietspad Zurenborgbrug,2022-09-07,12:00:00,416,204,212,FMN 06 B Zurenborgbrug Ringfietspad
655,Ringfietspad Zurenborgbrug,2022-09-07,13:00:00,289,144,145,FMN 06 B Zurenborgbrug Ringfietspad
655,Ringfietspad Zurenborgbrug,2022-09-07,14:00:00,255,111,144,FMN 06 B Zurenborgbrug Ringfietspad
655,Ringfietspad Zurenborgbrug,2022-09-07,15:00:00,260,104,156,FMN 06 B Zurenborgbrug Ringfietspad
655,Ringfietspad Zurenborgbrug,2022-09-07,16:00:00,419,184,235,FMN 06 B Zurenborgbrug Ringfietspad
655,Ringfietspad Zurenborgbrug,2022-09-07,17:00:00,485,187,298,FMN 06 B Zurenborgbrug Ringfietspad
655,Ringfietspad Zurenborgbrug,2022-09-07,18:00:00,336,142,194,FMN 06 B Zurenborgbrug Ringfietspad
655,Ringfietspad Zurenborgbrug,2022-09-07,19:00:00,195,80,115,FMN 06 B Zurenborgbrug Ringfietspad
655,Ringfietspad Zurenborgbrug,2022-09-07,20:00:00,138,72,66,FMN 06 B Zurenborgbrug Ringfietspad
655,Ringfietspad Zurenborgbrug,2022-09-07,21:00:00,118,44,74,FMN 06 B Zurenborgbrug Ringfietspad
655,Ringfietspad Zurenborgbrug,2022-09-07,22:00:00,86,29,57,FMN 06 B Zurenborgbrug Ringfietspad
655,Ringfietspad Zurenborgbrug,2022-09-07,23:00:00,38,19,19,FMN 06 B Zurenborgbrug Ringfietspad
655,Ringfietspad Zurenborgbrug,2022-09-08,00:00:00,18,10,8,FMN 06 B Zurenborgbrug Ringfietspad
655,Ringfietspad Zurenborgbrug,2022-09-08,01:00:00,12,6,6,FMN 06 B Zurenborgbrug Ringfietspad
655,Ringfietspad Zurenborgbrug,2022-09-08,02:00:00,4,0,4,FMN 06 B Zurenborgbrug Ringfietspad
655,Ringfietspad Zurenborgbrug,2022-09-08,03:00:00,5,2,3,FMN 06 B Zurenborgbrug Ringfietspad
655,Ringfietspad Zurenborgbrug,2022-09-08,04:00:00,15,8,7,FMN 06 B Zurenborgbrug Ringfietspad
655,Ringfietspad Zurenborgbrug,2022-09-08,05:00:00,40,24,16,FMN 06 B Zurenborgbrug Ringfietspad
655,Ringfietspad Zurenborgbrug,2022-09-08,06:00:00,129,66,63,FMN 06 B Zurenborgbrug Ringfietspad
655,Ringfietspad Zurenborgbrug,2022-09-08,07:00:00,423,254,169,FMN 06 B Zurenborgbrug Ringfietspad
655,Ringfietspad Zurenborgbrug,2022-09-08,08:00:00,630,367,263,FMN 06 B Zurenborgbrug Ringfietspad
655,Ringfietspad Zurenborgbrug,2022-09-08,09:00:00,172,87,85,FMN 06 B Zurenborgbrug Ringfietspad
655,Ringfietspad Zurenborgbrug,2022-09-08,10:00:00,92,52,40,FMN 06 B Zurenborgbrug Ringfietspad
655,Ringfietspad Zurenborgbrug,2022-09-08,11:00:00,111,54,57,FMN 06 B Zurenborgbrug Ringfietspad
655,Ringfietspad Zurenborgbrug,2022-09-08,12:00:00,195,88,107,FMN 06 B Zurenborgbrug Ringfietspad
655,Ringfietspad Zurenborgbrug,2022-09-08,13:00:00,177,87,90,FMN 06 B Zurenborgbrug Ringfietspad
655,Ringfietspad Zurenborgbrug,2022-09-08,14:00:00,140,69,71,FMN 06 B Zurenborgbrug Ringfietspad
655,Ringfietspad Zurenborgbrug,2022-09-08,15:00:00,265,107,158,FMN 06 B Zurenborgbrug Ringfietspad
655,Ringfietspad Zurenborgbrug,2022-09-08,16:00:00,548,242,306,FMN 06 B Zurenborgbrug Ringfietspad
655,Ringfietspad Zurenborgbrug,2022-09-08,17:00:00,445,170,275,FMN 06 B Zurenborgbrug Ringfietspad
655,Ringfietspad Zurenborgbrug,2022-09-08,18:00:00,254,104,150,FMN 06 B Zurenborgbrug Ringfietspad
655,Ringfietspad Zurenborgbrug,2022-09-08,19:00:00,157,58,99,FMN 06 B Zurenborgbrug Ringfietspad
655,Ringfietspad Zurenborgbrug,2022-09-08,20:00:00,95,39,56,FMN 06 B Zurenborgbrug Ringfietspad
655,Ringfietspad Zurenborgbrug,2022-09-08,21:00:00,95,41,54,FMN 06 B Zurenborgbrug Ringfietspad
655,Ringfietspad Zurenborgbrug,2022-09-08,22:00:00,65,27,38,FMN 06 B Zurenborgbrug Ringfietspad
655,Ringfietspad Zurenborgbrug,2022-09-08,23:00:00,49,20,29,FMN 06 B Zurenborgbrug Ringfietspad
655,Ringfietspad Zurenborgbrug,2022-09-09,00:00:00,14,6,8,FMN 06 B Zurenborgbrug Ringfietspad
655,Ringfietspad Zurenborgbrug,2022-09-09,01:00:00,8,1,7,FMN 06 B Zurenborgbrug Ringfietspad
655,Ringfietspad Zurenborgbrug,2022-09-09,02:00:00,8,2,6,FMN 06 B Zurenborgbrug Ringfietspad
655,Ringfietspad Zurenborgbrug,2022-09-09,03:00:00,3,2,1,FMN 06 B Zurenborgbrug Ringfietspad
655,Ringfietspad Zurenborgbrug,2022-09-09,04:00:00,16,8,8,FMN 06 B Zurenborgbrug Ringfietspad
655,Ringfietspad Zurenborgbrug,2022-09-09,05:00:00,35,22,13,FMN 06 B Zurenborgbrug Ringfietspad
655,Ringfietspad Zurenborgbrug,2022-09-09,06:00:00,93,54,39,FMN 06 B Zurenborgbrug Ringfietspad
655,Ringfietspad Zurenborgbrug,2022-09-09,07:00:00,334,185,149,FMN 06 B Zurenborgbrug Ringfietspad
655,Ringfietspad Zurenborgbrug,2022-09-09,08:00:00,477,253,224,FMN 06 B Zurenborgbrug Ringfietspad
655,Ringfietspad Zurenborgbrug,2022-09-09,09:00:00,133,84,49,FMN 06 B Zurenborgbrug Ringfietspad
655,Ringfietspad Zurenborgbrug,2022-09-09,10:00:00,80,48,32,FMN 06 B Zurenborgbrug Ringfietspad
655,Ringfietspad Zurenborgbrug,2022-09-09,11:00:00,91,36,55,FMN 06 B Zurenborgbrug Ringfietspad
655,Ringfietspad Zurenborgbrug,2022-09-09,12:00:00,128,49,79,FMN 06 B Zurenborgbrug Ringfietspad
655,Ringfietspad Zurenborgbrug,2022-09-09,13:00:00,136,59,77,FMN 06 B Zurenborgbrug Ringfietspad
655,Ringfietspad Zurenborgbrug,2022-09-09,14:00:00,166,85,81,FMN 06 B Zurenborgbrug Ringfietspad
655,Ringfietspad Zurenborgbrug,2022-09-09,15:00:00,253,97,156,FMN 06 B Zurenborgbrug Ringfietspad
655,Ringfietspad Zurenborgbrug,2022-09-09,16:00:00,454,188,266,FMN 06 B Zurenborgbrug Ringfietspad
655,Ringfietspad Zurenborgbrug,2022-09-09,17:00:00,315,125,190,FMN 06 B Zurenborgbrug Ringfietspad
655,Ringfietspad Zurenborgbrug,2022-09-09,18:00:00,191,76,115,FMN 06 B Zurenborgbrug Ringfietspad
655,Ringfietspad Zurenborgbrug,2022-09-09,19:00:00,127,52,75,FMN 06 B Zurenborgbrug Ringfietspad
655,Ringfietspad Zurenborgbrug,2022-09-09,20:00:00,94,46,48,FMN 06 B Zurenborgbrug Ringfietspad
655,Ringfietspad Zurenborgbrug,2022-09-09,21:00:00,40,12,28,FMN 06 B Zurenborgbrug Ringfietspad
655,Ringfietspad Zurenborgbrug,2022-09-09,22:00:00,98,56,42,FMN 06 B Zurenborgbrug Ringfietspad
655,Ringfietspad Zurenborgbrug,2022-09-09,23:00:00,46,13,33,FMN 06 B Zurenborgbrug Ringfietspad
655,Ringfietspad Zurenborgbrug,2022-09-10,00:00:00,37,16,21,FMN 06 B Zurenborgbrug Ringfietspad
655,Ringfietspad Zurenborgbrug,2022-09-10,01:00:00,22,9,13,FMN 06 B Zurenborgbrug Ringfietspad
655,Ringfietspad Zurenborgbrug,2022-09-10,02:00:00,15,7,8,FMN 06 B Zurenborgbrug Ringfietspad
655,Ringfietspad Zurenborgbrug,2022-09-10,03:00:00,23,2,21,FMN 06 B Zurenborgbrug Ringfietspad
655,Ringfietspad Zurenborgbrug,2022-09-10,04:00:00,4,4,0,FMN 06 B Zurenborgbrug Ringfietspad
655,Ringfietspad Zurenborgbrug,2022-09-10,05:00:00,11,7,4,FMN 06 B Zurenborgbrug Ringfietspad
655,Ringfietspad Zurenborgbrug,2022-09-10,06:00:00,21,13,8,FMN 06 B Zurenborgbrug Ringfietspad
655,Ringfietspad Zurenborgbrug,2022-09-10,07:00:00,21,15,6,FMN 06 B Zurenborgbrug Ringfietspad
655,Ringfietspad Zurenborgbrug,2022-09-10,08:00:00,33,25,8,FMN 06 B Zurenborgbrug Ringfietspad
655,Ringfietspad Zurenborgbrug,2022-09-10,09:00:00,33,24,9,FMN 06 B Zurenborgbrug Ringfietspad
655,Ringfietspad Zurenborgbrug,2022-09-10,10:00:00,33,15,18,FMN 06 B Zurenborgbrug Ringfietspad
655,Ringfietspad Zurenborgbrug,2022-09-10,11:00:00,40,23,17,FMN 06 B Zurenborgbrug Ringfietspad
655,Ringfietspad Zurenborgbrug,2022-09-10,12:00:00,57,19,38,FMN 06 B Zurenborgbrug Ringfietspad
655,Ringfietspad Zurenborgbrug,2022-09-10,13:00:00,60,29,31,FMN 06 B Zurenborgbrug Ringfietspad
655,Ringfietspad Zurenborgbrug,2022-09-10,14:00:00,67,30,37,FMN 06 B Zurenborgbrug Ringfietspad
655,Ringfietspad Zurenborgbrug,2022-09-10,15:00:00,86,28,58,FMN 06 B Zurenborgbrug Ringfietspad
655,Ringfietspad Zurenborgbrug,2022-09-10,16:00:00,99,51,48,FMN 06 B Zurenborgbrug Ringfietspad
655,Ringfietspad Zurenborgbrug,2022-09-10,17:00:00,120,54,66,FMN 06 B Zurenborgbrug Ringfietspad
655,Ringfietspad Zurenborgbrug,2022-09-10,18:00:00,102,55,47,FMN 06 B Zurenborgbrug Ringfietspad
655,Ringfietspad Zurenborgbrug,2022-09-10,19:00:00,108,40,68,FMN 06 B Zurenborgbrug Ringfietspad
655,Ringfietspad Zurenborgbrug,2022-09-10,20:00:00,106,36,70,FMN 06 B Zurenborgbrug Ringfietspad
655,Ringfietspad Zurenborgbrug,2022-09-10,21:00:00,52,16,36,FMN 06 B Zurenborgbrug Ringfietspad
655,Ringfietspad Zurenborgbrug,2022-09-10,22:00:00,67,45,22,FMN 06 B Zurenborgbrug Ringfietspad
655,Ringfietspad Zurenborgbrug,2022-09-10,23:00:00,45,26,19,FMN 06 B Zurenborgbrug Ringfietspad
655,Ringfietspad Zurenborgbrug,2022-09-11,00:00:00,34,19,15,FMN 06 B Zurenborgbrug Ringfietspad
655,Ringfietspad Zurenborgbrug,2022-09-11,01:00:00,26,14,12,FMN 06 B Zurenborgbrug Ringfietspad
655,Ringfietspad Zurenborgbrug,2022-09-11,02:00:00,15,6,9,FMN 06 B Zurenborgbrug Ringfietspad
655,Ringfietspad Zurenborgbrug,2022-09-11,03:00:00,6,1,5,FMN 06 B Zurenborgbrug Ringfietspad
655,Ringfietspad Zurenborgbrug,2022-09-11,04:00:00,9,3,6,FMN 06 B Zurenborgbrug Ringfietspad
655,Ringfietspad Zurenborgbrug,2022-09-11,05:00:00,12,6,6,FMN 06 B Zurenborgbrug Ringfietspad
655,Ringfietspad Zurenborgbrug,2022-09-11,06:00:00,25,11,14,FMN 06 B Zurenborgbrug Ringfietspad
655,Ringfietspad Zurenborgbrug,2022-09-11,07:00:00,32,16,16,FMN 06 B Zurenborgbrug Ringfietspad
655,Ringfietspad Zurenborgbrug,2022-09-11,08:00:00,76,29,47,FMN 06 B Zurenborgbrug Ringfietspad
655,Ringfietspad Zurenborgbrug,2022-09-11,09:00:00,142,64,78,FMN 06 B Zurenborgbrug Ringfietspad
655,Ringfietspad Zurenborgbrug,2022-09-11,10:00:00,166,94,72,FMN 06 B Zurenborgbrug Ringfietspad
655,Ringfietspad Zurenborgbrug,2022-09-11,11:00:00,183,79,104,FMN 06 B Zurenborgbrug Ringfietspad
655,Ringfietspad Zurenborgbrug,2022-09-11,12:00:00,218,117,101,FMN 06 B Zurenborgbrug Ringfietspad
655,Ringfietspad Zurenborgbrug,2022-09-11,13:00:00,289,140,149,FMN 06 B Zurenborgbrug Ringfietspad
655,Ringfietspad Zurenborgbrug,2022-09-11,14:00:00,302,122,180,FMN 06 B Zurenborgbrug Ringfietspad
655,Ringfietspad Zurenborgbrug,2022-09-11,15:00:00,284,104,180,FMN 06 B Zurenborgbrug Ringfietspad
655,Ringfietspad Zurenborgbrug,2022-09-11,16:00:00,245,108,137,FMN 06 B Zurenborgbrug Ringfietspad
655,Ringfietspad Zurenborgbrug,2022-09-11,17:00:00,232,101,131,FMN 06 B Zurenborgbrug Ringfietspad
655,Ringfietspad Zurenborgbrug,2022-09-11,18:00:00,206,110,96,FMN 06 B Zurenborgbrug Ringfietspad
655,Ringfietspad Zurenborgbrug,2022-09-11,19:00:00,209,65,144,FMN 06 B Zurenborgbrug Ringfietspad
655,Ringfietspad Zurenborgbrug,2022-09-11,20:00:00,88,46,42,FMN 06 B Zurenborgbrug Ringfietspad
655,Ringfietspad Zurenborgbrug,2022-09-11,21:00:00,61,29,32,FMN 06 B Zurenborgbrug Ringfietspad
655,Ringfietspad Zurenborgbrug,2022-09-11,22:00:00,96,77,19,FMN 06 B Zurenborgbrug Ringfietspad
655,Ringfietspad Zurenborgbrug,2022-09-11,23:00:00,35,16,19,FMN 06 B Zurenborgbrug Ringfietspad
655,Ringfietspad Zurenborgbrug,2022-09-12,00:00:00,8,6,2,FMN 06 B Zurenborgbrug Ringfietspad
655,Ringfietspad Zurenborgbrug,2022-09-12,01:00:00,1,0,1,FMN 06 B Zurenborgbrug Ringfietspad
655,Ringfietspad Zurenborgbrug,2022-09-12,02:00:00,3,1,2,FMN 06 B Zurenborgbrug Ringfietspad
655,Ringfietspad Zurenborgbrug,2022-09-12,03:00:00,3,3,0,FMN 06 B Zurenborgbrug Ringfietspad
655,Ringfietspad Zurenborgbrug,2022-09-12,04:00:00,19,12,7,FMN 06 B Zurenborgbrug Ringfietspad
655,Ringfietspad Zurenborgbrug,2022-09-12,05:00:00,57,32,25,FMN 06 B Zurenborgbrug Ringfietspad
655,Ringfietspad Zurenborgbrug,2022-09-12,06:00:00,160,92,68,FMN 06 B Zurenborgbrug Ringfietspad
655,Ringfietspad Zurenborgbrug,2022-09-12,07:00:00,519,292,227,FMN 06 B Zurenborgbrug Ringfietspad
655,Ringfietspad Zurenborgbrug,2022-09-12,08:00:00,657,370,287,FMN 06 B Zurenborgbrug Ringfietspad
655,Ringfietspad Zurenborgbrug,2022-09-12,09:00:00,194,104,90,FMN 06 B Zurenborgbrug Ringfietspad
655,Ringfietspad Zurenborgbrug,2022-09-12,10:00:00,131,87,44,FMN 06 B Zurenborgbrug Ringfietspad
655,Ringfietspad Zurenborgbrug,2022-09-12,11:00:00,175,81,94,FMN 06 B Zurenborgbrug Ringfietspad
655,Ringfietspad Zurenborgbrug,2022-09-12,12:00:00,310,172,138,FMN 06 B Zurenborgbrug Ringfietspad
655,Ringfietspad Zurenborgbrug,2022-09-12,13:00:00,264,121,143,FMN 06 B Zurenborgbrug Ringfietspad
655,Ringfietspad Zurenborgbrug,2022-09-12,14:00:00,288,147,141,FMN 06 B Zurenborgbrug Ringfietspad
655,Ringfietspad Zurenborgbrug,2022-09-12,15:00:00,443,180,263,FMN 06 B Zurenborgbrug Ringfietspad
655,Ringfietspad Zurenborgbrug,2022-09-12,16:00:00,642,309,333,FMN 06 B Zurenborgbrug Ringfietspad
655,Ringfietspad Zurenborgbrug,2022-09-12,17:00:00,649,253,396,FMN 06 B Zurenborgbrug Ringfietspad
655,Ringfietspad Zurenborgbrug,2022-09-12,18:00:00,392,167,225,FMN 06 B Zurenborgbrug Ringfietspad
655,Ringfietspad Zurenborgbrug,2022-09-12,19:00:00,276,85,191,FMN 06 B Zurenborgbrug Ringfietspad
655,Ringfietspad Zurenborgbrug,2022-09-12,20:00:00,201,60,141,FMN 06 B Zurenborgbrug Ringfietspad
655,Ringfietspad Zurenborgbrug,2022-09-12,21:00:00,85,33,52,FMN 06 B Zurenborgbrug Ringfietspad
655,Ringfietspad Zurenborgbrug,2022-09-12,22:00:00,104,31,73,FMN 06 B Zurenborgbrug Ringfietspad
655,Ringfietspad Zurenborgbrug,2022-09-12,23:00:00,122,94,28,FMN 06 B Zurenborgbrug Ringfietspad
655,Ringfietspad Zurenborgbrug,2022-09-13,00:00:00,24,18,6,FMN 06 B Zurenborgbrug Ringfietspad
655,Ringfietspad Zurenborgbrug,2022-09-13,01:00:00,6,1,5,FMN 06 B Zurenborgbrug Ringfietspad
655,Ringfietspad Zurenborgbrug,2022-09-13,02:00:00,2,2,0,FMN 06 B Zurenborgbrug Ringfietspad
655,Ringfietspad Zurenborgbrug,2022-09-13,03:00:00,2,0,2,FMN 06 B Zurenborgbrug Ringfietspad
655,Ringfietspad Zurenborgbrug,2022-09-13,04:00:00,17,10,7,FMN 06 B Zurenborgbrug Ringfietspad
655,Ringfietspad Zurenborgbrug,2022-09-13,05:00:00,51,25,26,FMN 06 B Zurenborgbrug Ringfietspad
655,Ringfietspad Zurenborgbrug,2022-09-13,06:00:00,160,94,66,FMN 06 B Zurenborgbrug Ringfietspad
655,Ringfietspad Zurenborgbrug,2022-09-13,07:00:00,529,309,220,FMN 06 B Zurenborgbrug Ringfietspad
655,Ringfietspad Zurenborgbrug,2022-09-13,08:00:00,661,375,286,FMN 06 B Zurenborgbrug Ringfietspad
655,Ringfietspad Zurenborgbrug,2022-09-13,09:00:00,188,108,80,FMN 06 B Zurenborgbrug Ringfietspad
655,Ringfietspad Zurenborgbrug,2022-09-13,10:00:00,129,73,56,FMN 06 B Zurenborgbrug Ringfietspad
655,Ringfietspad Zurenborgbrug,2022-09-13,11:00:00,188,82,106,FMN 06 B Zurenborgbrug Ringfietspad
655,Ringfietspad Zurenborgbrug,2022-09-13,12:00:00,232,136,96,FMN 06 B Zurenborgbrug Ringfietspad
655,Ringfietspad Zurenborgbrug,2022-09-13,13:00:00,260,104,156,FMN 06 B Zurenborgbrug Ringfietspad
655,Ringfietspad Zurenborgbrug,2022-09-13,14:00:00,247,119,128,FMN 06 B Zurenborgbrug Ringfietspad
655,Ringfietspad Zurenborgbrug,2022-09-13,15:00:00,376,137,239,FMN 06 B Zurenborgbrug Ringfietspad
655,Ringfietspad Zurenborgbrug,2022-09-13,16:00:00,556,224,332,FMN 06 B Zurenborgbrug Ringfietspad
655,Ringfietspad Zurenborgbrug,2022-09-13,17:00:00,520,201,319,FMN 06 B Zurenborgbrug Ringfietspad
655,Ringfietspad Zurenborgbrug,2022-09-13,18:00:00,308,123,185,FMN 06 B Zurenborgbrug Ringfietspad
655,Ringfietspad Zurenborgbrug,2022-09-13,19:00:00,185,78,107,FMN 06 B Zurenborgbrug Ringfietspad
655,Ringfietspad Zurenborgbrug,2022-09-13,20:00:00,108,45,63,FMN 06 B Zurenborgbrug Ringfietspad
655,Ringfietspad Zurenborgbrug,2022-09-13,21:00:00,73,33,40,FMN 06 B Zurenborgbrug Ringfietspad
655,Ringfietspad Zurenborgbrug,2022-09-13,22:00:00,82,35,47,FMN 06 B Zurenborgbrug Ringfietspad
655,Ringfietspad Zurenborgbrug,2022-09-13,23:00:00,31,11,20,FMN 06 B Zurenborgbrug Ringfietspad
655,Ringfietspad Zurenborgbrug,2022-09-14,00:00:00,9,4,5,FMN 06 B Zurenborgbrug Ringfietspad
655,Ringfietspad Zurenborgbrug,2022-09-14,01:00:00,6,2,4,FMN 06 B Zurenborgbrug Ringfietspad
655,Ringfietspad Zurenborgbrug,2022-09-14,02:00:00,1,1,0,FMN 06 B Zurenborgbrug Ringfietspad
655,Ringfietspad Zurenborgbrug,2022-09-14,03:00:00,1,0,1,FMN 06 B Zurenborgbrug Ringfietspad
655,Ringfietspad Zurenborgbrug,2022-09-14,04:00:00,13,9,4,FMN 06 B Zurenborgbrug Ringfietspad
655,Ringfietspad Zurenborgbrug,2022-09-14,05:00:00,37,18,19,FMN 06 B Zurenborgbrug Ringfietspad
655,Ringfietspad Zurenborgbrug,2022-09-14,06:00:00,101,45,56,FMN 06 B Zurenborgbrug Ringfietspad
655,Ringfietspad Zurenborgbrug,2022-09-14,07:00:00,277,148,129,FMN 06 B Zurenborgbrug Ringfietspad
655,Ringfietspad Zurenborgbrug,2022-09-14,08:00:00,367,207,160,FMN 06 B Zurenborgbrug Ringfietspad
655,Ringfietspad Zurenborgbrug,2022-09-14,09:00:00,90,55,35,FMN 06 B Zurenborgbrug Ringfietspad
655,Ringfietspad Zurenborgbrug,2022-09-14,10:00:00,48,21,27,FMN 06 B Zurenborgbrug Ringfietspad
655,Ringfietspad Zurenborgbrug,2022-09-14,11:00:00,69,39,30,FMN 06 B Zurenborgbrug Ringfietspad
655,Ringfietspad Zurenborgbrug,2022-09-14,12:00:00,193,101,92,FMN 06 B Zurenborgbrug Ringfietspad
655,Ringfietspad Zurenborgbrug,2022-09-14,13:00:00,133,65,68,FMN 06 B Zurenborgbrug Ringfietspad
655,Ringfietspad Zurenborgbrug,2022-09-14,14:00:00,90,33,57,FMN 06 B Zurenborgbrug Ringfietspad
655,Ringfietspad Zurenborgbrug,2022-09-14,15:00:00,120,42,78,FMN 06 B Zurenborgbrug Ringfietspad
655,Ringfietspad Zurenborgbrug,2022-09-14,16:00:00,190,72,118,FMN 06 B Zurenborgbrug Ringfietspad
655,Ringfietspad Zurenborgbrug,2022-09-14,17:00:00,262,105,157,FMN 06 B Zurenborgbrug Ringfietspad
655,Ringfietspad Zurenborgbrug,2022-09-14,18:00:00,168,83,85,FMN 06 B Zurenborgbrug Ringfietspad
655,Ringfietspad Zurenborgbrug,2022-09-14,19:00:00,116,66,50,FMN 06 B Zurenborgbrug Ringfietspad
655,Ringfietspad Zurenborgbrug,2022-09-14,20:00:00,73,30,43,FMN 06 B Zurenborgbrug Ringfietspad
655,Ringfietspad Zurenborgbrug,2022-09-14,21:00:00,52,19,33,FMN 06 B Zurenborgbrug Ringfietspad
655,Ringfietspad Zurenborgbrug,2022-09-14,22:00:00,79,36,43,FMN 06 B Zurenborgbrug Ringfietspad
655,Ringfietspad Zurenborgbrug,2022-09-14,23:00:00,32,12,20,FMN 06 B Zurenborgbrug Ringfietspad
655,Ringfietspad Zurenborgbrug,2022-09-15,00:00:00,13,4,9,FMN 06 B Zurenborgbrug Ringfietspad
655,Ringfietspad Zurenborgbrug,2022-09-15,01:00:00,6,1,5,FMN 06 B Zurenborgbrug Ringfietspad
655,Ringfietspad Zurenborgbrug,2022-09-15,02:00:00,5,2,3,FMN 06 B Zurenborgbrug Ringfietspad
655,Ringfietspad Zurenborgbrug,2022-09-15,03:00:00,3,2,1,FMN 06 B Zurenborgbrug Ringfietspad
655,Ringfietspad Zurenborgbrug,2022-09-15,04:00:00,23,14,9,FMN 06 B Zurenborgbrug Ringfietspad
655,Ringfietspad Zurenborgbrug,2022-09-15,05:00:00,41,24,17,FMN 06 B Zurenborgbrug Ringfietspad
655,Ringfietspad Zurenborgbrug,2022-09-15,06:00:00,123,67,56,FMN 06 B Zurenborgbrug Ringfietspad
655,Ringfietspad Zurenborgbrug,2022-09-15,07:00:00,418,243,175,FMN 06 B Zurenborgbrug Ringfietspad
655,Ringfietspad Zurenborgbrug,2022-09-15,08:00:00,617,355,262,FMN 06 B Zurenborgbrug Ringfietspad
655,Ringfietspad Zurenborgbrug,2022-09-15,09:00:00,152,82,70,FMN 06 B Zurenborgbrug Ringfietspad
655,Ringfietspad Zurenborgbrug,2022-09-15,10:00:00,101,51,50,FMN 06 B Zurenborgbrug Ringfietspad
655,Ringfietspad Zurenborgbrug,2022-09-15,11:00:00,118,55,63,FMN 06 B Zurenborgbrug Ringfietspad
655,Ringfietspad Zurenborgbrug,2022-09-15,12:00:00,179,83,96,FMN 06 B Zurenborgbrug Ringfietspad
655,Ringfietspad Zurenborgbrug,2022-09-15,13:00:00,185,80,105,FMN 06 B Zurenborgbrug Ringfietspad
655,Ringfietspad Zurenborgbrug,2022-09-15,14:00:00,177,75,102,FMN 06 B Zurenborgbrug Ringfietspad
655,Ringfietspad Zurenborgbrug,2022-09-15,15:00:00,293,113,180,FMN 06 B Zurenborgbrug Ringfietspad
655,Ringfietspad Zurenborgbrug,2022-09-15,16:00:00,546,221,325,FMN 06 B Zurenborgbrug Ringfietspad
655,Ringfietspad Zurenborgbrug,2022-09-15,17:00:00,488,168,320,FMN 06 B Zurenborgbrug Ringfietspad
655,Ringfietspad Zurenborgbrug,2022-09-15,18:00:00,301,132,169,FMN 06 B Zurenborgbrug Ringfietspad
655,Ringfietspad Zurenborgbrug,2022-09-15,19:00:00,164,67,97,FMN 06 B Zurenborgbrug Ringfietspad
655,Ringfietspad Zurenborgbrug,2022-09-15,20:00:00,92,37,55,FMN 06 B Zurenborgbrug Ringfietspad
655,Ringfietspad Zurenborgbrug,2022-09-15,21:00:00,95,32,63,FMN 06 B Zurenborgbrug Ringfietspad
655,Ringfietspad Zurenborgbrug,2022-09-15,22:00:00,63,21,42,FMN 06 B Zurenborgbrug Ringfietspad
655,Ringfietspad Zurenborgbrug,2022-09-15,23:00:00,41,19,22,FMN 06 B Zurenborgbrug Ringfietspad
655,Ringfietspad Zurenborgbrug,2022-09-16,00:00:00,13,8,5,FMN 06 B Zurenborgbrug Ringfietspad
655,Ringfietspad Zurenborgbrug,2022-09-16,01:00:00,9,3,6,FMN 06 B Zurenborgbrug Ringfietspad
655,Ringfietspad Zurenborgbrug,2022-09-16,02:00:00,2,1,1,FMN 06 B Zurenborgbrug Ringfietspad
655,Ringfietspad Zurenborgbrug,2022-09-16,03:00:00,2,0,2,FMN 06 B Zurenborgbrug Ringfietspad
655,Ringfietspad Zurenborgbrug,2022-09-16,04:00:00,19,15,4,FMN 06 B Zurenborgbrug Ringfietspad
655,Ringfietspad Zurenborgbrug,2022-09-16,05:00:00,35,22,13,FMN 06 B Zurenborgbrug Ringfietspad
655,Ringfietspad Zurenborgbrug,2022-09-16,06:00:00,104,57,47,FMN 06 B Zurenborgbrug Ringfietspad
655,Ringfietspad Zurenborgbrug,2022-09-16,07:00:00,303,173,130,FMN 06 B Zurenborgbrug Ringfietspad
655,Ringfietspad Zurenborgbrug,2022-09-16,08:00:00,388,225,163,FMN 06 B Zurenborgbrug Ringfietspad
655,Ringfietspad Zurenborgbrug,2022-09-16,09:00:00,157,67,90,FMN 06 B Zurenborgbrug Ringfietspad
655,Ringfietspad Zurenborgbrug,2022-09-16,10:00:00,52,28,24,FMN 06 B Zurenborgbrug Ringfietspad
655,Ringfietspad Zurenborgbrug,2022-09-16,11:00:00,43,15,28,FMN 06 B Zurenborgbrug Ringfietspad
655,Ringfietspad Zurenborgbrug,2022-09-16,12:00:00,111,50,61,FMN 06 B Zurenborgbrug Ringfietspad
655,Ringfietspad Zurenborgbrug,2022-09-16,13:00:00,90,33,57,FMN 06 B Zurenborgbrug Ringfietspad
655,Ringfietspad Zurenborgbrug,2022-09-16,14:00:00,129,74,55,FMN 06 B Zurenborgbrug Ringfietspad
655,Ringfietspad Zurenborgbrug,2022-09-16,15:00:00,207,90,117,FMN 06 B Zurenborgbrug Ringfietspad
655,Ringfietspad Zurenborgbrug,2022-09-16,16:00:00,332,151,181,FMN 06 B Zurenborgbrug Ringfietspad
655,Ringfietspad Zurenborgbrug,2022-09-16,17:00:00,259,99,160,FMN 06 B Zurenborgbrug Ringfietspad
655,Ringfietspad Zurenborgbrug,2022-09-16,18:00:00,153,65,88,FMN 06 B Zurenborgbrug Ringfietspad
655,Ringfietspad Zurenborgbrug,2022-09-16,19:00:00,113,24,89,FMN 06 B Zurenborgbrug Ringfietspad
655,Ringfietspad Zurenborgbrug,2022-09-16,20:00:00,64,19,45,FMN 06 B Zurenborgbrug Ringfietspad
655,Ringfietspad Zurenborgbrug,2022-09-16,21:00:00,46,16,30,FMN 06 B Zurenborgbrug Ringfietspad
655,Ringfietspad Zurenborgbrug,2022-09-16,22:00:00,42,17,25,FMN 06 B Zurenborgbrug Ringfietspad
655,Ringfietspad Zurenborgbrug,2022-09-16,23:00:00,62,33,29,FMN 06 B Zurenborgbrug Ringfietspad
655,Ringfietspad Zurenborgbrug,2022-09-17,00:00:00,34,27,7,FMN 06 B Zurenborgbrug Ringfietspad
655,Ringfietspad Zurenborgbrug,2022-09-17,01:00:00,15,7,8,FMN 06 B Zurenborgbrug Ringfietspad
655,Ringfietspad Zurenborgbrug,2022-09-17,02:00:00,5,2,3,FMN 06 B Zurenborgbrug Ringfietspad
655,Ringfietspad Zurenborgbrug,2022-09-17,03:00:00,4,4,0,FMN 06 B Zurenborgbrug Ringfietspad
655,Ringfietspad Zurenborgbrug,2022-09-17,04:00:00,8,7,1,FMN 06 B Zurenborgbrug Ringfietspad
655,Ringfietspad Zurenborgbrug,2022-09-17,05:00:00,11,5,6,FMN 06 B Zurenborgbrug Ringfietspad
655,Ringfietspad Zurenborgbrug,2022-09-17,06:00:00,22,13,9,FMN 06 B Zurenborgbrug Ringfietspad
655,Ringfietspad Zurenborgbrug,2022-09-17,07:00:00,17,10,7,FMN 06 B Zurenborgbrug Ringfietspad
655,Ringfietspad Zurenborgbrug,2022-09-17,08:00:00,45,21,24,FMN 06 B Zurenborgbrug Ringfietspad
655,Ringfietspad Zurenborgbrug,2022-09-17,09:00:00,83,50,33,FMN 06 B Zurenborgbrug Ringfietspad
655,Ringfietspad Zurenborgbrug,2022-09-17,10:00:00,59,27,32,FMN 06 B Zurenborgbrug Ringfietspad
655,Ringfietspad Zurenborgbrug,2022-09-17,11:00:00,78,29,49,FMN 06 B Zurenborgbrug Ringfietspad
655,Ringfietspad Zurenborgbrug,2022-09-17,12:00:00,83,39,44,FMN 06 B Zurenborgbrug Ringfietspad
655,Ringfietspad Zurenborgbrug,2022-09-17,13:00:00,91,43,48,FMN 06 B Zurenborgbrug Ringfietspad
655,Ringfietspad Zurenborgbrug,2022-09-17,14:00:00,98,44,54,FMN 06 B Zurenborgbrug Ringfietspad
655,Ringfietspad Zurenborgbrug,2022-09-17,15:00:00,94,50,44,FMN 06 B Zurenborgbrug Ringfietspad
655,Ringfietspad Zurenborgbrug,2022-09-17,16:00:00,94,36,58,FMN 06 B Zurenborgbrug Ringfietspad
655,Ringfietspad Zurenborgbrug,2022-09-17,17:00:00,95,44,51,FMN 06 B Zurenborgbrug Ringfietspad
655,Ringfietspad Zurenborgbrug,2022-09-17,18:00:00,91,35,56,FMN 06 B Zurenborgbrug Ringfietspad
655,Ringfietspad Zurenborgbrug,2022-09-17,19:00:00,69,29,40,FMN 06 B Zurenborgbrug Ringfietspad
655,Ringfietspad Zurenborgbrug,2022-09-17,20:00:00,64,28,36,FMN 06 B Zurenborgbrug Ringfietspad
655,Ringfietspad Zurenborgbrug,2022-09-17,21:00:00,29,11,18,FMN 06 B Zurenborgbrug Ringfietspad
655,Ringfietspad Zurenborgbrug,2022-09-17,22:00:00,32,17,15,FMN 06 B Zurenborgbrug Ringfietspad
655,Ringfietspad Zurenborgbrug,2022-09-17,23:00:00,28,8,20,FMN 06 B Zurenborgbrug Ringfietspad
655,Ringfietspad Zurenborgbrug,2022-09-18,00:00:00,30,12,18,FMN 06 B Zurenborgbrug Ringfietspad
655,Ringfietspad Zurenborgbrug,2022-09-18,01:00:00,17,13,4,FMN 06 B Zurenborgbrug Ringfietspad
655,Ringfietspad Zurenborgbrug,2022-09-18,02:00:00,13,8,5,FMN 06 B Zurenborgbrug Ringfietspad
655,Ringfietspad Zurenborgbrug,2022-09-18,03:00:00,5,3,2,FMN 06 B Zurenborgbrug Ringfietspad
655,Ringfietspad Zurenborgbrug,2022-09-18,04:00:00,5,3,2,FMN 06 B Zurenborgbrug Ringfietspad
655,Ringfietspad Zurenborgbrug,2022-09-18,05:00:00,5,5,0,FMN 06 B Zurenborgbrug Ringfietspad
655,Ringfietspad Zurenborgbrug,2022-09-18,06:00:00,16,6,10,FMN 06 B Zurenborgbrug Ringfietspad
655,Ringfietspad Zurenborgbrug,2022-09-18,07:00:00,13,5,8,FMN 06 B Zurenborgbrug Ringfietspad
655,Ringfietspad Zurenborgbrug,2022-09-18,08:00:00,19,12,7,FMN 06 B Zurenborgbrug Ringfietspad
655,Ringfietspad Zurenborgbrug,2022-09-18,09:00:00,41,15,26,FMN 06 B Zurenborgbrug Ringfietspad
655,Ringfietspad Zurenborgbrug,2022-09-18,10:00:00,59,31,28,FMN 06 B Zurenborgbrug Ringfietspad
655,Ringfietspad Zurenborgbrug,2022-09-18,11:00:00,61,32,29,FMN 06 B Zurenborgbrug Ringfietspad
655,Ringfietspad Zurenborgbrug,2022-09-18,12:00:00,46,26,20,FMN 06 B Zurenborgbrug Ringfietspad
655,Ringfietspad Zurenborgbrug,2022-09-18,13:00:00,78,28,50,FMN 06 B Zurenborgbrug Ringfietspad
655,Ringfietspad Zurenborgbrug,2022-09-18,14:00:00,106,49,57,FMN 06 B Zurenborgbrug Ringfietspad
655,Ringfietspad Zurenborgbrug,2022-09-18,15:00:00,58,27,31,FMN 06 B Zurenborgbrug Ringfietspad
655,Ringfietspad Zurenborgbrug,2022-09-18,16:00:00,78,46,32,FMN 06 B Zurenborgbrug Ringfietspad
655,Ringfietspad Zurenborgbrug,2022-09-18,17:00:00,68,35,33,FMN 06 B Zurenborgbrug Ringfietspad
655,Ringfietspad Zurenborgbrug,2022-09-18,18:00:00,50,25,25,FMN 06 B Zurenborgbrug Ringfietspad
655,Ringfietspad Zurenborgbrug,2022-09-18,19:00:00,39,14,25,FMN 06 B Zurenborgbrug Ringfietspad
655,Ringfietspad Zurenborgbrug,2022-09-18,20:00:00,23,9,14,FMN 06 B Zurenborgbrug Ringfietspad
655,Ringfietspad Zurenborgbrug,2022-09-18,21:00:00,26,7,19,FMN 06 B Zurenborgbrug Ringfietspad
655,Ringfietspad Zurenborgbrug,2022-09-18,22:00:00,31,14,17,FMN 06 B Zurenborgbrug Ringfietspad
655,Ringfietspad Zurenborgbrug,2022-09-18,23:00:00,13,9,4,FMN 06 B Zurenborgbrug Ringfietspad
655,Ringfietspad Zurenborgbrug,2022-09-19,00:00:00,2,1,1,FMN 06 B Zurenborgbrug Ringfietspad
655,Ringfietspad Zurenborgbrug,2022-09-19,01:00:00,2,1,1,FMN 06 B Zurenborgbrug Ringfietspad
655,Ringfietspad Zurenborgbrug,2022-09-19,02:00:00,0,0,0,FMN 06 B Zurenborgbrug Ringfietspad
655,Ringfietspad Zurenborgbrug,2022-09-19,03:00:00,2,1,1,FMN 06 B Zurenborgbrug Ringfietspad
655,Ringfietspad Zurenborgbrug,2022-09-19,04:00:00,13,10,3,FMN 06 B Zurenborgbrug Ringfietspad
655,Ringfietspad Zurenborgbrug,2022-09-19,05:00:00,39,19,20,FMN 06 B Zurenborgbrug Ringfietspad
655,Ringfietspad Zurenborgbrug,2022-09-19,06:00:00,110,64,46,FMN 06 B Zurenborgbrug Ringfietspad
655,Ringfietspad Zurenborgbrug,2022-09-19,07:00:00,397,205,192,FMN 06 B Zurenborgbrug Ringfietspad
655,Ringfietspad Zurenborgbrug,2022-09-19,08:00:00,537,291,246,FMN 06 B Zurenborgbrug Ringfietspad
655,Ringfietspad Zurenborgbrug,2022-09-19,09:00:00,138,76,62,FMN 06 B Zurenborgbrug Ringfietspad
655,Ringfietspad Zurenborgbrug,2022-09-19,10:00:00,112,61,51,FMN 06 B Zurenborgbrug Ringfietspad
655,Ringfietspad Zurenborgbrug,2022-09-19,11:00:00,105,49,56,FMN 06 B Zurenborgbrug Ringfietspad
655,Ringfietspad Zurenborgbrug,2022-09-19,12:00:00,188,89,99,FMN 06 B Zurenborgbrug Ringfietspad
655,Ringfietspad Zurenborgbrug,2022-09-19,13:00:00,181,80,101,FMN 06 B Zurenborgbrug Ringfietspad
655,Ringfietspad Zurenborgbrug,2022-09-19,14:00:00,212,80,132,FMN 06 B Zurenborgbrug Ringfietspad
655,Ringfietspad Zurenborgbrug,2022-09-19,15:00:00,314,113,201,FMN 06 B Zurenborgbrug Ringfietspad
655,Ringfietspad Zurenborgbrug,2022-09-19,16:00:00,518,216,302,FMN 06 B Zurenborgbrug Ringfietspad
655,Ringfietspad Zurenborgbrug,2022-09-19,17:00:00,495,193,302,FMN 06 B Zurenborgbrug Ringfietspad
655,Ringfietspad Zurenborgbrug,2022-09-19,18:00:00,290,118,172,FMN 06 B Zurenborgbrug Ringfietspad
655,Ringfietspad Zurenborgbrug,2022-09-19,19:00:00,130,56,74,FMN 06 B Zurenborgbrug Ringfietspad
655,Ringfietspad Zurenborgbrug,2022-09-19,20:00:00,81,42,39,FMN 06 B Zurenborgbrug Ringfietspad
655,Ringfietspad Zurenborgbrug,2022-09-19,21:00:00,49,15,34,FMN 06 B Zurenborgbrug Ringfietspad
655,Ringfietspad Zurenborgbrug,2022-09-19,22:00:00,81,26,55,FMN 06 B Zurenborgbrug Ringfietspad
655,Ringfietspad Zurenborgbrug,2022-09-19,23:00:00,28,14,14,FMN 06 B Zurenborgbrug Ringfietspad
655,Ringfietspad Zurenborgbrug,2022-09-20,00:00:00,6,1,5,FMN 06 B Zurenborgbrug Ringfietspad
655,Ringfietspad Zurenborgbrug,2022-09-20,01:00:00,4,2,2,FMN 06 B Zurenborgbrug Ringfietspad
655,Ringfietspad Zurenborgbrug,2022-09-20,02:00:00,2,0,2,FMN 06 B Zurenborgbrug Ringfietspad
655,Ringfietspad Zurenborgbrug,2022-09-20,03:00:00,1,0,1,FMN 06 B Zurenborgbrug Ringfietspad
655,Ringfietspad Zurenborgbrug,2022-09-20,04:00:00,18,13,5,FMN 06 B Zurenborgbrug Ringfietspad
655,Ringfietspad Zurenborgbrug,2022-09-20,05:00:00,45,23,22,FMN 06 B Zurenborgbrug Ringfietspad
655,Ringfietspad Zurenborgbrug,2022-09-20,06:00:00,152,84,68,FMN 06 B Zurenborgbrug Ringfietspad
655,Ringfietspad Zurenborgbrug,2022-09-20,07:00:00,479,269,210,FMN 06 B Zurenborgbrug Ringfietspad
655,Ringfietspad Zurenborgbrug,2022-09-20,08:00:00,626,351,275,FMN 06 B Zurenborgbrug Ringfietspad
655,Ringfietspad Zurenborgbrug,2022-09-20,09:00:00,160,89,71,FMN 06 B Zurenborgbrug Ringfietspad
655,Ringfietspad Zurenborgbrug,2022-09-20,10:00:00,121,66,55,FMN 06 B Zurenborgbrug Ringfietspad
655,Ringfietspad Zurenborgbrug,2022-09-20,11:00:00,137,55,82,FMN 06 B Zurenborgbrug Ringfietspad
655,Ringfietspad Zurenborgbrug,2022-09-20,12:00:00,201,85,116,FMN 06 B Zurenborgbrug Ringfietspad
655,Ringfietspad Zurenborgbrug,2022-09-20,13:00:00,197,91,106,FMN 06 B Zurenborgbrug Ringfietspad
655,Ringfietspad Zurenborgbrug,2022-09-20,14:00:00,180,87,93,FMN 06 B Zurenborgbrug Ringfietspad
655,Ringfietspad Zurenborgbrug,2022-09-20,15:00:00,334,141,193,FMN 06 B Zurenborgbrug Ringfietspad
655,Ringfietspad Zurenborgbrug,2022-09-20,16:00:00,600,223,377,FMN 06 B Zurenborgbrug Ringfietspad
655,Ringfietspad Zurenborgbrug,2022-09-20,17:00:00,557,212,345,FMN 06 B Zurenborgbrug Ringfietspad
655,Ringfietspad Zurenborgbrug,2022-09-20,18:00:00,326,134,192,FMN 06 B Zurenborgbrug Ringfietspad
655,Ringfietspad Zurenborgbrug,2022-09-20,19:00:00,191,74,117,FMN 06 B Zurenborgbrug Ringfietspad
655,Ringfietspad Zurenborgbrug,2022-09-20,20:00:00,114,55,59,FMN 06 B Zurenborgbrug Ringfietspad
655,Ringfietspad Zurenborgbrug,2022-09-20,21:00:00,73,26,47,FMN 06 B Zurenborgbrug Ringfietspad
655,Ringfietspad Zurenborgbrug,2022-09-20,22:00:00,79,33,46,FMN 06 B Zurenborgbrug Ringfietspad
655,Ringfietspad Zurenborgbrug,2022-09-20,23:00:00,39,15,24,FMN 06 B Zurenborgbrug Ringfietspad
655,Ringfietspad Zurenborgbrug,2022-09-21,00:00:00,8,1,7,FMN 06 B Zurenborgbrug Ringfietspad
655,Ringfietspad Zurenborgbrug,2022-09-21,01:00:00,7,5,2,FMN 06 B Zurenborgbrug Ringfietspad
655,Ringfietspad Zurenborgbrug,2022-09-21,02:00:00,3,0,3,FMN 06 B Zurenborgbrug Ringfietspad
655,Ringfietspad Zurenborgbrug,2022-09-21,03:00:00,1,0,1,FMN 06 B Zurenborgbrug Ringfietspad
655,Ringfietspad Zurenborgbrug,2022-09-21,04:00:00,20,12,8,FMN 06 B Zurenborgbrug Ringfietspad
655,Ringfietspad Zurenborgbrug,2022-09-21,05:00:00,43,26,17,FMN 06 B Zurenborgbrug Ringfietspad
655,Ringfietspad Zurenborgbrug,2022-09-21,06:00:00,127,67,60,FMN 06 B Zurenborgbrug Ringfietspad
655,Ringfietspad Zurenborgbrug,2022-09-21,07:00:00,432,242,190,FMN 06 B Zurenborgbrug Ringfietspad
655,Ringfietspad Zurenborgbrug,2022-09-21,08:00:00,500,282,218,FMN 06 B Zurenborgbrug Ringfietspad
655,Ringfietspad Zurenborgbrug,2022-09-21,09:00:00,163,92,71,FMN 06 B Zurenborgbrug Ringfietspad
655,Ringfietspad Zurenborgbrug,2022-09-21,10:00:00,122,55,67,FMN 06 B Zurenborgbrug Ringfietspad
655,Ringfietspad Zurenborgbrug,2022-09-21,11:00:00,181,94,87,FMN 06 B Zurenborgbrug Ringfietspad
655,Ringfietspad Zurenborgbrug,2022-09-21,12:00:00,389,189,200,FMN 06 B Zurenborgbrug Ringfietspad
655,Ringfietspad Zurenborgbrug,2022-09-21,13:00:00,326,143,183,FMN 06 B Zurenborgbrug Ringfietspad
655,Ringfietspad Zurenborgbrug,2022-09-21,14:00:00,288,127,161,FMN 06 B Zurenborgbrug Ringfietspad
655,Ringfietspad Zurenborgbrug,2022-09-21,15:00:00,284,113,171,FMN 06 B Zurenborgbrug Ringfietspad
655,Ringfietspad Zurenborgbrug,2022-09-21,16:00:00,488,210,278,FMN 06 B Zurenborgbrug Ringfietspad
655,Ringfietspad Zurenborgbrug,2022-09-21,17:00:00,547,206,341,FMN 06 B Zurenborgbrug Ringfietspad
655,Ringfietspad Zurenborgbrug,2022-09-21,18:00:00,335,138,197,FMN 06 B Zurenborgbrug Ringfietspad
655,Ringfietspad Zurenborgbrug,2022-09-21,19:00:00,205,66,139,FMN 06 B Zurenborgbrug Ringfietspad
655,Ringfietspad Zurenborgbrug,2022-09-21,20:00:00,135,40,95,FMN 06 B Zurenborgbrug Ringfietspad
655,Ringfietspad Zurenborgbrug,2022-09-21,21:00:00,89,34,55,FMN 06 B Zurenborgbrug Ringfietspad
655,Ringfietspad Zurenborgbrug,2022-09-21,22:00:00,83,37,46,FMN 06 B Zurenborgbrug Ringfietspad
655,Ringfietspad Zurenborgbrug,2022-09-21,23:00:00,56,28,28,FMN 06 B Zurenborgbrug Ringfietspad
655,Ringfietspad Zurenborgbrug,2022-09-22,00:00:00,12,7,5,FMN 06 B Zurenborgbrug Ringfietspad
655,Ringfietspad Zurenborgbrug,2022-09-22,01:00:00,6,3,3,FMN 06 B Zurenborgbrug Ringfietspad
655,Ringfietspad Zurenborgbrug,2022-09-22,02:00:00,6,4,2,FMN 06 B Zurenborgbrug Ringfietspad
655,Ringfietspad Zurenborgbrug,2022-09-22,03:00:00,4,3,1,FMN 06 B Zurenborgbrug Ringfietspad
655,Ringfietspad Zurenborgbrug,2022-09-22,04:00:00,15,11,4,FMN 06 B Zurenborgbrug Ringfietspad
655,Ringfietspad Zurenborgbrug,2022-09-22,05:00:00,47,30,17,FMN 06 B Zurenborgbrug Ringfietspad
655,Ringfietspad Zurenborgbrug,2022-09-22,06:00:00,136,76,60,FMN 06 B Zurenborgbrug Ringfietspad
655,Ringfietspad Zurenborgbrug,2022-09-22,07:00:00,399,224,175,FMN 06 B Zurenborgbrug Ringfietspad
655,Ringfietspad Zurenborgbrug,2022-09-22,08:00:00,602,325,277,FMN 06 B Zurenborgbrug Ringfietspad
655,Ringfietspad Zurenborgbrug,2022-09-22,09:00:00,177,97,80,FMN 06 B Zurenborgbrug Ringfietspad
655,Ringfietspad Zurenborgbrug,2022-09-22,10:00:00,125,70,55,FMN 06 B Zurenborgbrug Ringfietspad
655,Ringfietspad Zurenborgbrug,2022-09-22,11:00:00,164,79,85,FMN 06 B Zurenborgbrug Ringfietspad
655,Ringfietspad Zurenborgbrug,2022-09-22,12:00:00,250,127,123,FMN 06 B Zurenborgbrug Ringfietspad
655,Ringfietspad Zurenborgbrug,2022-09-22,13:00:00,266,133,133,FMN 06 B Zurenborgbrug Ringfietspad
655,Ringfietspad Zurenborgbrug,2022-09-22,14:00:00,251,85,166,FMN 06 B Zurenborgbrug Ringfietspad
655,Ringfietspad Zurenborgbrug,2022-09-22,15:00:00,345,128,217,FMN 06 B Zurenborgbrug Ringfietspad
655,Ringfietspad Zurenborgbrug,2022-09-22,16:00:00,568,219,349,FMN 06 B Zurenborgbrug Ringfietspad
655,Ringfietspad Zurenborgbrug,2022-09-22,17:00:00,523,182,341,FMN 06 B Zurenborgbrug Ringfietspad
655,Ringfietspad Zurenborgbrug,2022-09-22,18:00:00,342,150,192,FMN 06 B Zurenborgbrug Ringfietspad
655,Ringfietspad Zurenborgbrug,2022-09-22,19:00:00,220,93,127,FMN 06 B Zurenborgbrug Ringfietspad
655,Ringfietspad Zurenborgbrug,2022-09-22,20:00:00,97,47,50,FMN 06 B Zurenborgbrug Ringfietspad
655,Ringfietspad Zurenborgbrug,2022-09-22,21:00:00,95,25,70,FMN 06 B Zurenborgbrug Ringfietspad
655,Ringfietspad Zurenborgbrug,2022-09-22,22:00:00,109,56,53,FMN 06 B Zurenborgbrug Ringfietspad
655,Ringfietspad Zurenborgbrug,2022-09-22,23:00:00,37,19,18,FMN 06 B Zurenborgbrug Ringfietspad
655,Ringfietspad Zurenborgbrug,2022-09-23,00:00:00,10,6,4,FMN 06 B Zurenborgbrug Ringfietspad
655,Ringfietspad Zurenborgbrug,2022-09-23,01:00:00,7,1,6,FMN 06 B Zurenborgbrug Ringfietspad
655,Ringfietspad Zurenborgbrug,2022-09-23,02:00:00,5,1,4,FMN 06 B Zurenborgbrug Ringfietspad
655,Ringfietspad Zurenborgbrug,2022-09-23,03:00:00,2,0,2,FMN 06 B Zurenborgbrug Ringfietspad
655,Ringfietspad Zurenborgbrug,2022-09-23,04:00:00,18,15,3,FMN 06 B Zurenborgbrug Ringfietspad
655,Ringfietspad Zurenborgbrug,2022-09-23,05:00:00,45,24,21,FMN 06 B Zurenborgbrug Ringfietspad
655,Ringfietspad Zurenborgbrug,2022-09-23,06:00:00,114,65,49,FMN 06 B Zurenborgbrug Ringfietspad
655,Ringfietspad Zurenborgbrug,2022-09-23,07:00:00,349,187,162,FMN 06 B Zurenborgbrug Ringfietspad
655,Ringfietspad Zurenborgbrug,2022-09-23,08:00:00,501,281,220,FMN 06 B Zurenborgbrug Ringfietspad
655,Ringfietspad Zurenborgbrug,2022-09-23,09:00:00,204,137,67,FMN 06 B Zurenborgbrug Ringfietspad
655,Ringfietspad Zurenborgbrug,2022-09-23,10:00:00,113,59,54,FMN 06 B Zurenborgbrug Ringfietspad
655,Ringfietspad Zurenborgbrug,2022-09-23,11:00:00,108,40,68,FMN 06 B Zurenborgbrug Ringfietspad
655,Ringfietspad Zurenborgbrug,2022-09-23,12:00:00,195,92,103,FMN 06 B Zurenborgbrug Ringfietspad
655,Ringfietspad Zurenborgbrug,2022-09-23,13:00:00,177,89,88,FMN 06 B Zurenborgbrug Ringfietspad
655,Ringfietspad Zurenborgbrug,2022-09-23,14:00:00,178,65,113,FMN 06 B Zurenborgbrug Ringfietspad
655,Ringfietspad Zurenborgbrug,2022-09-23,15:00:00,302,139,163,FMN 06 B Zurenborgbrug Ringfietspad
655,Ringfietspad Zurenborgbrug,2022-09-23,16:00:00,453,187,266,FMN 06 B Zurenborgbrug Ringfietspad
655,Ringfietspad Zurenborgbrug,2022-09-23,17:00:00,374,128,246,FMN 06 B Zurenborgbrug Ringfietspad
655,Ringfietspad Zurenborgbrug,2022-09-23,18:00:00,235,100,135,FMN 06 B Zurenborgbrug Ringfietspad
655,Ringfietspad Zurenborgbrug,2022-09-23,19:00:00,125,56,69,FMN 06 B Zurenborgbrug Ringfietspad
655,Ringfietspad Zurenborgbrug,2022-09-23,20:00:00,61,22,39,FMN 06 B Zurenborgbrug Ringfietspad
655,Ringfietspad Zurenborgbrug,2022-09-23,21:00:00,51,20,31,FMN 06 B Zurenborgbrug Ringfietspad
655,Ringfietspad Zurenborgbrug,2022-09-23,22:00:00,65,29,36,FMN 06 B Zurenborgbrug Ringfietspad
655,Ringfietspad Zurenborgbrug,2022-09-23,23:00:00,36,15,21,FMN 06 B Zurenborgbrug Ringfietspad
655,Ringfietspad Zurenborgbrug,2022-09-24,00:00:00,33,13,20,FMN 06 B Zurenborgbrug Ringfietspad
655,Ringfietspad Zurenborgbrug,2022-09-24,01:00:00,15,2,13,FMN 06 B Zurenborgbrug Ringfietspad
655,Ringfietspad Zurenborgbrug,2022-09-24,02:00:00,13,9,4,FMN 06 B Zurenborgbrug Ringfietspad
655,Ringfietspad Zurenborgbrug,2022-09-24,03:00:00,8,2,6,FMN 06 B Zurenborgbrug Ringfietspad
655,Ringfietspad Zurenborgbrug,2022-09-24,04:00:00,7,4,3,FMN 06 B Zurenborgbrug Ringfietspad
655,Ringfietspad Zurenborgbrug,2022-09-24,05:00:00,15,7,8,FMN 06 B Zurenborgbrug Ringfietspad
655,Ringfietspad Zurenborgbrug,2022-09-24,06:00:00,17,12,5,FMN 06 B Zurenborgbrug Ringfietspad
655,Ringfietspad Zurenborgbrug,2022-09-24,07:00:00,16,8,8,FMN 06 B Zurenborgbrug Ringfietspad
655,Ringfietspad Zurenborgbrug,2022-09-24,08:00:00,52,31,21,FMN 06 B Zurenborgbrug Ringfietspad
655,Ringfietspad Zurenborgbrug,2022-09-24,09:00:00,78,39,39,FMN 06 B Zurenborgbrug Ringfietspad
655,Ringfietspad Zurenborgbrug,2022-09-24,10:00:00,59,29,30,FMN 06 B Zurenborgbrug Ringfietspad
655,Ringfietspad Zurenborgbrug,2022-09-24,11:00:00,61,33,28,FMN 06 B Zurenborgbrug Ringfietspad
655,Ringfietspad Zurenborgbrug,2022-09-24,12:00:00,75,31,44,FMN 06 B Zurenborgbrug Ringfietspad
655,Ringfietspad Zurenborgbrug,2022-09-24,13:00:00,101,35,66,FMN 06 B Zurenborgbrug Ringfietspad
655,Ringfietspad Zurenborgbrug,2022-09-24,14:00:00,103,46,57,FMN 06 B Zurenborgbrug Ringfietspad
655,Ringfietspad Zurenborgbrug,2022-09-24,15:00:00,88,35,53,FMN 06 B Zurenborgbrug Ringfietspad
655,Ringfietspad Zurenborgbrug,2022-09-24,16:00:00,103,42,61,FMN 06 B Zurenborgbrug Ringfietspad
655,Ringfietspad Zurenborgbrug,2022-09-24,17:00:00,91,50,41,FMN 06 B Zurenborgbrug Ringfietspad
655,Ringfietspad Zurenborgbrug,2022-09-24,18:00:00,97,43,54,FMN 06 B Zurenborgbrug Ringfietspad
655,Ringfietspad Zurenborgbrug,2022-09-24,19:00:00,82,40,42,FMN 06 B Zurenborgbrug Ringfietspad
655,Ringfietspad Zurenborgbrug,2022-09-24,20:00:00,52,14,38,FMN 06 B Zurenborgbrug Ringfietspad
655,Ringfietspad Zurenborgbrug,2022-09-24,21:00:00,33,20,13,FMN 06 B Zurenborgbrug Ringfietspad
655,Ringfietspad Zurenborgbrug,2022-09-24,22:00:00,26,10,16,FMN 06 B Zurenborgbrug Ringfietspad
655,Ringfietspad Zurenborgbrug,2022-09-24,23:00:00,40,19,21,FMN 06 B Zurenborgbrug Ringfietspad
655,Ringfietspad Zurenborgbrug,2022-09-25,00:00:00,31,20,11,FMN 06 B Zurenborgbrug Ringfietspad
655,Ringfietspad Zurenborgbrug,2022-09-25,01:00:00,18,3,15,FMN 06 B Zurenborgbrug Ringfietspad
655,Ringfietspad Zurenborgbrug,2022-09-25,02:00:00,12,4,8,FMN 06 B Zurenborgbrug Ringfietspad
655,Ringfietspad Zurenborgbrug,2022-09-25,03:00:00,1,1,0,FMN 06 B Zurenborgbrug Ringfietspad
655,Ringfietspad Zurenborgbrug,2022-09-25,04:00:00,7,5,2,FMN 06 B Zurenborgbrug Ringfietspad
655,Ringfietspad Zurenborgbrug,2022-09-25,05:00:00,8,5,3,FMN 06 B Zurenborgbrug Ringfietspad
655,Ringfietspad Zurenborgbrug,2022-09-25,06:00:00,12,6,6,FMN 06 B Zurenborgbrug Ringfietspad
655,Ringfietspad Zurenborgbrug,2022-09-25,07:00:00,19,7,12,FMN 06 B Zurenborgbrug Ringfietspad
655,Ringfietspad Zurenborgbrug,2022-09-25,08:00:00,64,31,33,FMN 06 B Zurenborgbrug Ringfietspad
655,Ringfietspad Zurenborgbrug,2022-09-25,09:00:00,105,42,63,FMN 06 B Zurenborgbrug Ringfietspad
655,Ringfietspad Zurenborgbrug,2022-09-25,10:00:00,129,61,68,FMN 06 B Zurenborgbrug Ringfietspad
655,Ringfietspad Zurenborgbrug,2022-09-25,11:00:00,174,64,110,FMN 06 B Zurenborgbrug Ringfietspad
655,Ringfietspad Zurenborgbrug,2022-09-25,12:00:00,234,119,115,FMN 06 B Zurenborgbrug Ringfietspad
655,Ringfietspad Zurenborgbrug,2022-09-25,13:00:00,191,92,99,FMN 06 B Zurenborgbrug Ringfietspad
655,Ringfietspad Zurenborgbrug,2022-09-25,14:00:00,213,120,93,FMN 06 B Zurenborgbrug Ringfietspad
655,Ringfietspad Zurenborgbrug,2022-09-25,15:00:00,177,89,88,FMN 06 B Zurenborgbrug Ringfietspad
655,Ringfietspad Zurenborgbrug,2022-09-25,16:00:00,177,73,104,FMN 06 B Zurenborgbrug Ringfietspad
655,Ringfietspad Zurenborgbrug,2022-09-25,17:00:00,164,90,74,FMN 06 B Zurenborgbrug Ringfietspad
655,Ringfietspad Zurenborgbrug,2022-09-25,18:00:00,133,74,59,FMN 06 B Zurenborgbrug Ringfietspad
655,Ringfietspad Zurenborgbrug,2022-09-25,19:00:00,108,41,67,FMN 06 B Zurenborgbrug Ringfietspad
655,Ringfietspad Zurenborgbrug,2022-09-25,20:00:00,56,24,32,FMN 06 B Zurenborgbrug Ringfietspad
655,Ringfietspad Zurenborgbrug,2022-09-25,21:00:00,43,20,23,FMN 06 B Zurenborgbrug Ringfietspad
655,Ringfietspad Zurenborgbrug,2022-09-25,22:00:00,34,19,15,FMN 06 B Zurenborgbrug Ringfietspad
655,Ringfietspad Zurenborgbrug,2022-09-25,23:00:00,21,6,15,FMN 06 B Zurenborgbrug Ringfietspad
655,Ringfietspad Zurenborgbrug,2022-09-26,00:00:00,7,3,4,FMN 06 B Zurenborgbrug Ringfietspad
655,Ringfietspad Zurenborgbrug,2022-09-26,01:00:00,4,1,3,FMN 06 B Zurenborgbrug Ringfietspad
655,Ringfietspad Zurenborgbrug,2022-09-26,02:00:00,3,2,1,FMN 06 B Zurenborgbrug Ringfietspad
655,Ringfietspad Zurenborgbrug,2022-09-26,03:00:00,4,3,1,FMN 06 B Zurenborgbrug Ringfietspad
655,Ringfietspad Zurenborgbrug,2022-09-26,04:00:00,21,13,8,FMN 06 B Zurenborgbrug Ringfietspad
655,Ringfietspad Zurenborgbrug,2022-09-26,05:00:00,36,22,14,FMN 06 B Zurenborgbrug Ringfietspad
655,Ringfietspad Zurenborgbrug,2022-09-26,06:00:00,104,59,45,FMN 06 B Zurenborgbrug Ringfietspad
655,Ringfietspad Zurenborgbrug,2022-09-26,07:00:00,342,185,157,FMN 06 B Zurenborgbrug Ringfietspad
655,Ringfietspad Zurenborgbrug,2022-09-26,08:00:00,574,330,244,FMN 06 B Zurenborgbrug Ringfietspad
655,Ringfietspad Zurenborgbrug,2022-09-26,09:00:00,152,89,63,FMN 06 B Zurenborgbrug Ringfietspad
655,Ringfietspad Zurenborgbrug,2022-09-26,10:00:00,114,59,55,FMN 06 B Zurenborgbrug Ringfietspad
655,Ringfietspad Zurenborgbrug,2022-09-26,11:00:00,73,29,44,FMN 06 B Zurenborgbrug Ringfietspad
655,Ringfietspad Zurenborgbrug,2022-09-26,12:00:00,145,68,77,FMN 06 B Zurenborgbrug Ringfietspad
655,Ringfietspad Zurenborgbrug,2022-09-26,13:00:00,93,32,61,FMN 06 B Zurenborgbrug Ringfietspad
655,Ringfietspad Zurenborgbrug,2022-09-26,14:00:00,123,43,80,FMN 06 B Zurenborgbrug Ringfietspad
655,Ringfietspad Zurenborgbrug,2022-09-26,15:00:00,189,67,122,FMN 06 B Zurenborgbrug Ringfietspad
655,Ringfietspad Zurenborgbrug,2022-09-26,16:00:00,372,159,213,FMN 06 B Zurenborgbrug Ringfietspad
655,Ringfietspad Zurenborgbrug,2022-09-26,17:00:00,359,140,219,FMN 06 B Zurenborgbrug Ringfietspad
655,Ringfietspad Zurenborgbrug,2022-09-26,18:00:00,242,98,144,FMN 06 B Zurenborgbrug Ringfietspad
655,Ringfietspad Zurenborgbrug,2022-09-26,19:00:00,106,42,64,FMN 06 B Zurenborgbrug Ringfietspad
655,Ringfietspad Zurenborgbrug,2022-09-26,20:00:00,68,24,44,FMN 06 B Zurenborgbrug Ringfietspad
655,Ringfietspad Zurenborgbrug,2022-09-26,21:00:00,60,21,39,FMN 06 B Zurenborgbrug Ringfietspad
655,Ringfietspad Zurenborgbrug,2022-09-26,22:00:00,51,23,28,FMN 06 B Zurenborgbrug Ringfietspad
655,Ringfietspad Zurenborgbrug,2022-09-26,23:00:00,30,9,21,FMN 06 B Zurenborgbrug Ringfietspad
655,Ringfietspad Zurenborgbrug,2022-09-27,00:00:00,4,1,3,FMN 06 B Zurenborgbrug Ringfietspad
655,Ringfietspad Zurenborgbrug,2022-09-27,01:00:00,2,0,2,FMN 06 B Zurenborgbrug Ringfietspad
655,Ringfietspad Zurenborgbrug,2022-09-27,02:00:00,1,1,0,FMN 06 B Zurenborgbrug Ringfietspad
655,Ringfietspad Zurenborgbrug,2022-09-27,03:00:00,1,0,1,FMN 06 B Zurenborgbrug Ringfietspad
655,Ringfietspad Zurenborgbrug,2022-09-27,04:00:00,9,7,2,FMN 06 B Zurenborgbrug Ringfietspad
655,Ringfietspad Zurenborgbrug,2022-09-27,05:00:00,38,20,18,FMN 06 B Zurenborgbrug Ringfietspad
655,Ringfietspad Zurenborgbrug,2022-09-27,06:00:00,80,38,42,FMN 06 B Zurenborgbrug Ringfietspad
655,Ringfietspad Zurenborgbrug,2022-09-27,07:00:00,324,182,142,FMN 06 B Zurenborgbrug Ringfietspad
655,Ringfietspad Zurenborgbrug,2022-09-27,08:00:00,513,309,204,FMN 06 B Zurenborgbrug Ringfietspad
655,Ringfietspad Zurenborgbrug,2022-09-27,09:00:00,153,99,54,FMN 06 B Zurenborgbrug Ringfietspad
655,Ringfietspad Zurenborgbrug,2022-09-27,10:00:00,78,45,33,FMN 06 B Zurenborgbrug Ringfietspad
655,Ringfietspad Zurenborgbrug,2022-09-27,11:00:00,74,32,42,FMN 06 B Zurenborgbrug Ringfietspad
655,Ringfietspad Zurenborgbrug,2022-09-27,12:00:00,142,69,73,FMN 06 B Zurenborgbrug Ringfietspad
655,Ringfietspad Zurenborgbrug,2022-09-27,13:00:00,134,55,79,FMN 06 B Zurenborgbrug Ringfietspad
655,Ringfietspad Zurenborgbrug,2022-09-27,14:00:00,116,48,68,FMN 06 B Zurenborgbrug Ringfietspad
655,Ringfietspad Zurenborgbrug,2022-09-27,15:00:00,273,136,137,FMN 06 B Zurenborgbrug Ringfietspad
655,Ringfietspad Zurenborgbrug,2022-09-27,16:00:00,410,158,252,FMN 06 B Zurenborgbrug Ringfietspad
655,Ringfietspad Zurenborgbrug,2022-09-27,17:00:00,390,128,262,FMN 06 B Zurenborgbrug Ringfietspad
655,Ringfietspad Zurenborgbrug,2022-09-27,18:00:00,252,90,162,FMN 06 B Zurenborgbrug Ringfietspad
655,Ringfietspad Zurenborgbrug,2022-09-27,19:00:00,114,43,71,FMN 06 B Zurenborgbrug Ringfietspad
655,Ringfietspad Zurenborgbrug,2022-09-27,20:00:00,84,42,42,FMN 06 B Zurenborgbrug Ringfietspad
655,Ringfietspad Zurenborgbrug,2022-09-27,21:00:00,52,20,32,FMN 06 B Zurenborgbrug Ringfietspad
655,Ringfietspad Zurenborgbrug,2022-09-27,22:00:00,50,14,36,FMN 06 B Zurenborgbrug Ringfietspad
655,Ringfietspad Zurenborgbrug,2022-09-27,23:00:00,25,8,17,FMN 06 B Zurenborgbrug Ringfietspad
655,Ringfietspad Zurenborgbrug,2022-09-28,00:00:00,10,3,7,FMN 06 B Zurenborgbrug Ringfietspad
655,Ringfietspad Zurenborgbrug,2022-09-28,01:00:00,1,1,0,FMN 06 B Zurenborgbrug Ringfietspad
655,Ringfietspad Zurenborgbrug,2022-09-28,02:00:00,3,0,3,FMN 06 B Zurenborgbrug Ringfietspad
655,Ringfietspad Zurenborgbrug,2022-09-28,03:00:00,3,2,1,FMN 06 B Zurenborgbrug Ringfietspad
655,Ringfietspad Zurenborgbrug,2022-09-28,04:00:00,14,7,7,FMN 06 B Zurenborgbrug Ringfietspad
655,Ringfietspad Zurenborgbrug,2022-09-28,05:00:00,36,21,15,FMN 06 B Zurenborgbrug Ringfietspad
655,Ringfietspad Zurenborgbrug,2022-09-28,06:00:00,97,46,51,FMN 06 B Zurenborgbrug Ringfietspad
655,Ringfietspad Zurenborgbrug,2022-09-28,07:00:00,383,233,150,FMN 06 B Zurenborgbrug Ringfietspad
655,Ringfietspad Zurenborgbrug,2022-09-28,08:00:00,464,265,199,FMN 06 B Zurenborgbrug Ringfietspad
655,Ringfietspad Zurenborgbrug,2022-09-28,09:00:00,150,75,75,FMN 06 B Zurenborgbrug Ringfietspad
655,Ringfietspad Zurenborgbrug,2022-09-28,10:00:00,107,66,41,FMN 06 B Zurenborgbrug Ringfietspad
655,Ringfietspad Zurenborgbrug,2022-09-28,11:00:00,128,68,60,FMN 06 B Zurenborgbrug Ringfietspad
655,Ringfietspad Zurenborgbrug,2022-09-28,12:00:00,325,174,151,FMN 06 B Zurenborgbrug Ringfietspad
655,Ringfietspad Zurenborgbrug,2022-09-28,13:00:00,248,104,144,FMN 06 B Zurenborgbrug Ringfietspad
655,Ringfietspad Zurenborgbrug,2022-09-28,14:00:00,172,67,105,FMN 06 B Zurenborgbrug Ringfietspad
655,Ringfietspad Zurenborgbrug,2022-09-28,15:00:00,202,71,131,FMN 06 B Zurenborgbrug Ringfietspad
655,Ringfietspad Zurenborgbrug,2022-09-28,16:00:00,313,101,212,FMN 06 B Zurenborgbrug Ringfietspad
655,Ringfietspad Zurenborgbrug,2022-09-28,17:00:00,379,143,236,FMN 06 B Zurenborgbrug Ringfietspad
655,Ringfietspad Zurenborgbrug,2022-09-28,18:00:00,293,99,194,FMN 06 B Zurenborgbrug Ringfietspad
655,Ringfietspad Zurenborgbrug,2022-09-28,19:00:00,181,74,107,FMN 06 B Zurenborgbrug Ringfietspad
655,Ringfietspad Zurenborgbrug,2022-09-28,20:00:00,80,32,48,FMN 06 B Zurenborgbrug Ringfietspad
655,Ringfietspad Zurenborgbrug,2022-09-28,21:00:00,84,39,45,FMN 06 B Zurenborgbrug Ringfietspad
655,Ringfietspad Zurenborgbrug,2022-09-28,22:00:00,72,22,50,FMN 06 B Zurenborgbrug Ringfietspad
655,Ringfietspad Zurenborgbrug,2022-09-28,23:00:00,31,11,20,FMN 06 B Zurenborgbrug Ringfietspad
655,Ringfietspad Zurenborgbrug,2022-09-29,00:00:00,17,4,13,FMN 06 B Zurenborgbrug Ringfietspad
655,Ringfietspad Zurenborgbrug,2022-09-29,01:00:00,10,1,9,FMN 06 B Zurenborgbrug Ringfietspad
655,Ringfietspad Zurenborgbrug,2022-09-29,02:00:00,0,0,0,FMN 06 B Zurenborgbrug Ringfietspad
655,Ringfietspad Zurenborgbrug,2022-09-29,03:00:00,2,2,0,FMN 06 B Zurenborgbrug Ringfietspad
655,Ringfietspad Zurenborgbrug,2022-09-29,04:00:00,14,11,3,FMN 06 B Zurenborgbrug Ringfietspad
655,Ringfietspad Zurenborgbrug,2022-09-29,05:00:00,45,20,25,FMN 06 B Zurenborgbrug Ringfietspad
655,Ringfietspad Zurenborgbrug,2022-09-29,06:00:00,120,64,56,FMN 06 B Zurenborgbrug Ringfietspad
655,Ringfietspad Zurenborgbrug,2022-09-29,07:00:00,359,199,160,FMN 06 B Zurenborgbrug Ringfietspad
655,Ringfietspad Zurenborgbrug,2022-09-29,08:00:00,550,309,241,FMN 06 B Zurenborgbrug Ringfietspad
655,Ringfietspad Zurenborgbrug,2022-09-29,09:00:00,156,89,67,FMN 06 B Zurenborgbrug Ringfietspad
655,Ringfietspad Zurenborgbrug,2022-09-29,10:00:00,92,44,48,FMN 06 B Zurenborgbrug Ringfietspad
655,Ringfietspad Zurenborgbrug,2022-09-29,11:00:00,119,48,71,FMN 06 B Zurenborgbrug Ringfietspad
655,Ringfietspad Zurenborgbrug,2022-09-29,12:00:00,182,84,98,FMN 06 B Zurenborgbrug Ringfietspad
655,Ringfietspad Zurenborgbrug,2022-09-29,13:00:00,199,87,112,FMN 06 B Zurenborgbrug Ringfietspad
655,Ringfietspad Zurenborgbrug,2022-09-29,14:00:00,202,86,116,FMN 06 B Zurenborgbrug Ringfietspad
655,Ringfietspad Zurenborgbrug,2022-09-29,15:00:00,302,99,203,FMN 06 B Zurenborgbrug Ringfietspad
655,Ringfietspad Zurenborgbrug,2022-09-29,16:00:00,496,208,288,FMN 06 B Zurenborgbrug Ringfietspad
655,Ringfietspad Zurenborgbrug,2022-09-29,17:00:00,498,164,334,FMN 06 B Zurenborgbrug Ringfietspad
655,Ringfietspad Zurenborgbrug,2022-09-29,18:00:00,312,123,189,FMN 06 B Zurenborgbrug Ringfietspad
655,Ringfietspad Zurenborgbrug,2022-09-29,19:00:00,168,66,102,FMN 06 B Zurenborgbrug Ringfietspad
655,Ringfietspad Zurenborgbrug,2022-09-29,20:00:00,83,35,48,FMN 06 B Zurenborgbrug Ringfietspad
655,Ringfietspad Zurenborgbrug,2022-09-29,21:00:00,100,37,63,FMN 06 B Zurenborgbrug Ringfietspad
655,Ringfietspad Zurenborgbrug,2022-09-29,22:00:00,101,44,57,FMN 06 B Zurenborgbrug Ringfietspad
655,Ringfietspad Zurenborgbrug,2022-09-29,23:00:00,44,18,26,FMN 06 B Zurenborgbrug Ringfietspad
655,Ringfietspad Zurenborgbrug,2022-09-30,00:00:00,14,7,7,FMN 06 B Zurenborgbrug Ringfietspad
655,Ringfietspad Zurenborgbrug,2022-09-30,01:00:00,14,8,6,FMN 06 B Zurenborgbrug Ringfietspad
655,Ringfietspad Zurenborgbrug,2022-09-30,02:00:00,1,1,0,FMN 06 B Zurenborgbrug Ringfietspad
655,Ringfietspad Zurenborgbrug,2022-09-30,03:00:00,4,4,0,FMN 06 B Zurenborgbrug Ringfietspad
655,Ringfietspad Zurenborgbrug,2022-09-30,04:00:00,13,7,6,FMN 06 B Zurenborgbrug Ringfietspad
655,Ringfietspad Zurenborgbrug,2022-09-30,05:00:00,38,21,17,FMN 06 B Zurenborgbrug Ringfietspad
655,Ringfietspad Zurenborgbrug,2022-09-30,06:00:00,90,41,49,FMN 06 B Zurenborgbrug Ringfietspad
655,Ringfietspad Zurenborgbrug,2022-09-30,07:00:00,351,195,156,FMN 06 B Zurenborgbrug Ringfietspad
655,Ringfietspad Zurenborgbrug,2022-09-30,08:00:00,478,275,203,FMN 06 B Zurenborgbrug Ringfietspad
655,Ringfietspad Zurenborgbrug,2022-09-30,09:00:00,169,103,66,FMN 06 B Zurenborgbrug Ringfietspad
655,Ringfietspad Zurenborgbrug,2022-09-30,10:00:00,109,66,43,FMN 06 B Zurenborgbrug Ringfietspad
655,Ringfietspad Zurenborgbrug,2022-09-30,11:00:00,119,54,65,FMN 06 B Zurenborgbrug Ringfietspad
655,Ringfietspad Zurenborgbrug,2022-09-30,12:00:00,218,86,132,FMN 06 B Zurenborgbrug Ringfietspad
655,Ringfietspad Zurenborgbrug,2022-09-30,13:00:00,242,110,132,FMN 06 B Zurenborgbrug Ringfietspad
655,Ringfietspad Zurenborgbrug,2022-09-30,14:00:00,197,88,109,FMN 06 B Zurenborgbrug Ringfietspad
655,Ringfietspad Zurenborgbrug,2022-09-30,15:00:00,298,110,188,FMN 06 B Zurenborgbrug Ringfietspad
655,Ringfietspad Zurenborgbrug,2022-09-30,16:00:00,464,198,266,FMN 06 B Zurenborgbrug Ringfietspad
655,Ringfietspad Zurenborgbrug,2022-09-30,17:00:00,374,146,228,FMN 06 B Zurenborgbrug Ringfietspad
655,Ringfietspad Zurenborgbrug,2022-09-30,18:00:00,258,112,146,FMN 06 B Zurenborgbrug Ringfietspad
655,Ringfietspad Zurenborgbrug,2022-09-30,19:00:00,139,49,90,FMN 06 B Zurenborgbrug Ringfietspad
655,Ringfietspad Zurenborgbrug,2022-09-30,20:00:00,76,29,47,FMN 06 B Zurenborgbrug Ringfietspad
655,Ringfietspad Zurenborgbrug,2022-09-30,21:00:00,75,26,49,FMN 06 B Zurenborgbrug Ringfietspad
655,Ringfietspad Zurenborgbrug,2022-09-30,22:00:00,88,39,49,FMN 06 B Zurenborgbrug Ringfietspad
655,Ringfietspad Zurenborgbrug,2022-09-30,23:00:00,53,21,32,FMN 06 B Zurenborgbrug Ringfietspad
655,Ringfietspad Zurenborgbrug,2022-10-01,00:00:00,17,5,12,FMN 06 B Zurenborgbrug Ringfietspad
655,Ringfietspad Zurenborgbrug,2022-10-01,01:00:00,15,6,9,FMN 06 B Zurenborgbrug Ringfietspad
655,Ringfietspad Zurenborgbrug,2022-10-01,02:00:00,8,5,3,FMN 06 B Zurenborgbrug Ringfietspad
655,Ringfietspad Zurenborgbrug,2022-10-01,03:00:00,11,5,6,FMN 06 B Zurenborgbrug Ringfietspad
655,Ringfietspad Zurenborgbrug,2022-10-01,04:00:00,19,15,4,FMN 06 B Zurenborgbrug Ringfietspad
655,Ringfietspad Zurenborgbrug,2022-10-01,05:00:00,11,7,4,FMN 06 B Zurenborgbrug Ringfietspad
655,Ringfietspad Zurenborgbrug,2022-10-01,06:00:00,32,23,9,FMN 06 B Zurenborgbrug Ringfietspad
655,Ringfietspad Zurenborgbrug,2022-10-01,07:00:00,31,15,16,FMN 06 B Zurenborgbrug Ringfietspad
655,Ringfietspad Zurenborgbrug,2022-10-01,08:00:00,94,28,66,FMN 06 B Zurenborgbrug Ringfietspad
655,Ringfietspad Zurenborgbrug,2022-10-01,09:00:00,70,28,42,FMN 06 B Zurenborgbrug Ringfietspad
655,Ringfietspad Zurenborgbrug,2022-10-01,10:00:00,94,33,61,FMN 06 B Zurenborgbrug Ringfietspad
655,Ringfietspad Zurenborgbrug,2022-10-01,11:00:00,86,42,44,FMN 06 B Zurenborgbrug Ringfietspad
655,Ringfietspad Zurenborgbrug,2022-10-01,12:00:00,105,41,64,FMN 06 B Zurenborgbrug Ringfietspad
655,Ringfietspad Zurenborgbrug,2022-10-01,13:00:00,124,64,60,FMN 06 B Zurenborgbrug Ringfietspad
655,Ringfietspad Zurenborgbrug,2022-10-01,14:00:00,148,65,83,FMN 06 B Zurenborgbrug Ringfietspad
655,Ringfietspad Zurenborgbrug,2022-10-01,15:00:00,114,58,56,FMN 06 B Zurenborgbrug Ringfietspad
655,Ringfietspad Zurenborgbrug,2022-10-01,16:00:00,108,58,50,FMN 06 B Zurenborgbrug Ringfietspad
655,Ringfietspad Zurenborgbrug,2022-10-01,17:00:00,153,77,76,FMN 06 B Zurenborgbrug Ringfietspad
655,Ringfietspad Zurenborgbrug,2022-10-01,18:00:00,127,65,62,FMN 06 B Zurenborgbrug Ringfietspad
655,Ringfietspad Zurenborgbrug,2022-10-01,19:00:00,68,35,33,FMN 06 B Zurenborgbrug Ringfietspad
655,Ringfietspad Zurenborgbrug,2022-10-01,20:00:00,58,31,27,FMN 06 B Zurenborgbrug Ringfietspad
655,Ringfietspad Zurenborgbrug,2022-10-01,21:00:00,58,17,41,FMN 06 B Zurenborgbrug Ringfietspad
655,Ringfietspad Zurenborgbrug,2022-10-01,22:00:00,48,16,32,FMN 06 B Zurenborgbrug Ringfietspad
655,Ringfietspad Zurenborgbrug,2022-10-01,23:00:00,52,26,26,FMN 06 B Zurenborgbrug Ringfietspad
655,Ringfietspad Zurenborgbrug,2022-10-02,00:00:00,33,14,19,FMN 06 B Zurenborgbrug Ringfietspad
655,Ringfietspad Zurenborgbrug,2022-10-02,01:00:00,42,11,31,FMN 06 B Zurenborgbrug Ringfietspad
655,Ringfietspad Zurenborgbrug,2022-10-02,02:00:00,11,5,6,FMN 06 B Zurenborgbrug Ringfietspad
655,Ringfietspad Zurenborgbrug,2022-10-02,03:00:00,7,0,7,FMN 06 B Zurenborgbrug Ringfietspad
655,Ringfietspad Zurenborgbrug,2022-10-02,04:00:00,4,3,1,FMN 06 B Zurenborgbrug Ringfietspad
655,Ringfietspad Zurenborgbrug,2022-10-02,05:00:00,13,6,7,FMN 06 B Zurenborgbrug Ringfietspad
655,Ringfietspad Zurenborgbrug,2022-10-02,06:00:00,12,7,5,FMN 06 B Zurenborgbrug Ringfietspad
655,Ringfietspad Zurenborgbrug,2022-10-02,07:00:00,13,5,8,FMN 06 B Zurenborgbrug Ringfietspad
655,Ringfietspad Zurenborgbrug,2022-10-02,08:00:00,45,16,29,FMN 06 B Zurenborgbrug Ringfietspad
655,Ringfietspad Zurenborgbrug,2022-10-02,09:00:00,64,24,40,FMN 06 B Zurenborgbrug Ringfietspad
655,Ringfietspad Zurenborgbrug,2022-10-02,10:00:00,83,38,45,FMN 06 B Zurenborgbrug Ringfietspad
655,Ringfietspad Zurenborgbrug,2022-10-02,11:00:00,124,64,60,FMN 06 B Zurenborgbrug Ringfietspad
655,Ringfietspad Zurenborgbrug,2022-10-02,12:00:00,117,64,53,FMN 06 B Zurenborgbrug Ringfietspad
655,Ringfietspad Zurenborgbrug,2022-10-02,13:00:00,151,74,77,FMN 06 B Zurenborgbrug Ringfietspad
655,Ringfietspad Zurenborgbrug,2022-10-02,14:00:00,163,74,89,FMN 06 B Zurenborgbrug Ringfietspad
655,Ringfietspad Zurenborgbrug,2022-10-02,15:00:00,142,71,71,FMN 06 B Zurenborgbrug Ringfietspad
655,Ringfietspad Zurenborgbrug,2022-10-02,16:00:00,111,61,50,FMN 06 B Zurenborgbrug Ringfietspad
655,Ringfietspad Zurenborgbrug,2022-10-02,17:00:00,120,56,64,FMN 06 B Zurenborgbrug Ringfietspad
655,Ringfietspad Zurenborgbrug,2022-10-02,18:00:00,128,52,76,FMN 06 B Zurenborgbrug Ringfietspad
655,Ringfietspad Zurenborgbrug,2022-10-02,19:00:00,77,34,43,FMN 06 B Zurenborgbrug Ringfietspad
655,Ringfietspad Zurenborgbrug,2022-10-02,20:00:00,68,25,43,FMN 06 B Zurenborgbrug Ringfietspad
655,Ringfietspad Zurenborgbrug,2022-10-02,21:00:00,41,23,18,FMN 06 B Zurenborgbrug Ringfietspad
655,Ringfietspad Zurenborgbrug,2022-10-02,22:00:00,38,20,18,FMN 06 B Zurenborgbrug Ringfietspad
655,Ringfietspad Zurenborgbrug,2022-10-02,23:00:00,32,15,17,FMN 06 B Zurenborgbrug Ringfietspad
655,Ringfietspad Zurenborgbrug,2022-10-03,00:00:00,12,5,7,FMN 06 B Zurenborgbrug Ringfietspad
655,Ringfietspad Zurenborgbrug,2022-10-03,01:00:00,11,4,7,FMN 06 B Zurenborgbrug Ringfietspad
655,Ringfietspad Zurenborgbrug,2022-10-03,02:00:00,3,0,3,FMN 06 B Zurenborgbrug Ringfietspad
655,Ringfietspad Zurenborgbrug,2022-10-03,03:00:00,1,1,0,FMN 06 B Zurenborgbrug Ringfietspad
655,Ringfietspad Zurenborgbrug,2022-10-03,04:00:00,17,10,7,FMN 06 B Zurenborgbrug Ringfietspad
655,Ringfietspad Zurenborgbrug,2022-10-03,05:00:00,49,21,28,FMN 06 B Zurenborgbrug Ringfietspad
655,Ringfietspad Zurenborgbrug,2022-10-03,06:00:00,127,74,53,FMN 06 B Zurenborgbrug Ringfietspad
655,Ringfietspad Zurenborgbrug,2022-10-03,07:00:00,395,237,158,FMN 06 B Zurenborgbrug Ringfietspad
655,Ringfietspad Zurenborgbrug,2022-10-03,08:00:00,495,302,193,FMN 06 B Zurenborgbrug Ringfietspad
655,Ringfietspad Zurenborgbrug,2022-10-03,09:00:00,143,83,60,FMN 06 B Zurenborgbrug Ringfietspad
655,Ringfietspad Zurenborgbrug,2022-10-03,10:00:00,125,70,55,FMN 06 B Zurenborgbrug Ringfietspad
655,Ringfietspad Zurenborgbrug,2022-10-03,11:00:00,109,40,69,FMN 06 B Zurenborgbrug Ringfietspad
655,Ringfietspad Zurenborgbrug,2022-10-03,12:00:00,193,88,105,FMN 06 B Zurenborgbrug Ringfietspad
655,Ringfietspad Zurenborgbrug,2022-10-03,13:00:00,191,88,103,FMN 06 B Zurenborgbrug Ringfietspad
655,Ringfietspad Zurenborgbrug,2022-10-03,14:00:00,185,83,102,FMN 06 B Zurenborgbrug Ringfietspad
655,Ringfietspad Zurenborgbrug,2022-10-03,15:00:00,262,121,141,FMN 06 B Zurenborgbrug Ringfietspad
655,Ringfietspad Zurenborgbrug,2022-10-03,16:00:00,468,154,314,FMN 06 B Zurenborgbrug Ringfietspad
655,Ringfietspad Zurenborgbrug,2022-10-03,17:00:00,540,183,357,FMN 06 B Zurenborgbrug Ringfietspad
655,Ringfietspad Zurenborgbrug,2022-10-03,18:00:00,361,123,238,FMN 06 B Zurenborgbrug Ringfietspad
655,Ringfietspad Zurenborgbrug,2022-10-03,19:00:00,149,59,90,FMN 06 B Zurenborgbrug Ringfietspad
655,Ringfietspad Zurenborgbrug,2022-10-03,20:00:00,104,43,61,FMN 06 B Zurenborgbrug Ringfietspad
655,Ringfietspad Zurenborgbrug,2022-10-03,21:00:00,75,33,42,FMN 06 B Zurenborgbrug Ringfietspad
655,Ringfietspad Zurenborgbrug,2022-10-03,22:00:00,83,30,53,FMN 06 B Zurenborgbrug Ringfietspad
655,Ringfietspad Zurenborgbrug,2022-10-03,23:00:00,28,6,22,FMN 06 B Zurenborgbrug Ringfietspad
655,Ringfietspad Zurenborgbrug,2022-10-04,00:00:00,12,7,5,FMN 06 B Zurenborgbrug Ringfietspad
655,Ringfietspad Zurenborgbrug,2022-10-04,01:00:00,3,0,3,FMN 06 B Zurenborgbrug Ringfietspad
655,Ringfietspad Zurenborgbrug,2022-10-04,02:00:00,1,0,1,FMN 06 B Zurenborgbrug Ringfietspad
655,Ringfietspad Zurenborgbrug,2022-10-04,03:00:00,2,1,1,FMN 06 B Zurenborgbrug Ringfietspad
655,Ringfietspad Zurenborgbrug,2022-10-04,04:00:00,16,11,5,FMN 06 B Zurenborgbrug Ringfietspad
655,Ringfietspad Zurenborgbrug,2022-10-04,05:00:00,51,28,23,FMN 06 B Zurenborgbrug Ringfietspad
655,Ringfietspad Zurenborgbrug,2022-10-04,06:00:00,161,85,76,FMN 06 B Zurenborgbrug Ringfietspad
655,Ringfietspad Zurenborgbrug,2022-10-04,07:00:00,527,337,190,FMN 06 B Zurenborgbrug Ringfietspad
655,Ringfietspad Zurenborgbrug,2022-10-04,08:00:00,683,426,257,FMN 06 B Zurenborgbrug Ringfietspad
655,Ringfietspad Zurenborgbrug,2022-10-04,09:00:00,178,111,67,FMN 06 B Zurenborgbrug Ringfietspad
655,Ringfietspad Zurenborgbrug,2022-10-04,10:00:00,115,57,58,FMN 06 B Zurenborgbrug Ringfietspad
655,Ringfietspad Zurenborgbrug,2022-10-04,11:00:00,126,55,71,FMN 06 B Zurenborgbrug Ringfietspad
655,Ringfietspad Zurenborgbrug,2022-10-04,12:00:00,230,110,120,FMN 06 B Zurenborgbrug Ringfietspad
655,Ringfietspad Zurenborgbrug,2022-10-04,13:00:00,245,120,125,FMN 06 B Zurenborgbrug Ringfietspad
655,Ringfietspad Zurenborgbrug,2022-10-04,14:00:00,251,141,110,FMN 06 B Zurenborgbrug Ringfietspad
655,Ringfietspad Zurenborgbrug,2022-10-04,15:00:00,324,157,167,FMN 06 B Zurenborgbrug Ringfietspad
655,Ringfietspad Zurenborgbrug,2022-10-04,16:00:00,622,230,392,FMN 06 B Zurenborgbrug Ringfietspad
655,Ringfietspad Zurenborgbrug,2022-10-04,17:00:00,624,216,408,FMN 06 B Zurenborgbrug Ringfietspad
655,Ringfietspad Zurenborgbrug,2022-10-04,18:00:00,376,129,247,FMN 06 B Zurenborgbrug Ringfietspad
655,Ringfietspad Zurenborgbrug,2022-10-04,19:00:00,188,74,114,FMN 06 B Zurenborgbrug Ringfietspad
655,Ringfietspad Zurenborgbrug,2022-10-04,20:00:00,119,51,68,FMN 06 B Zurenborgbrug Ringfietspad
655,Ringfietspad Zurenborgbrug,2022-10-04,21:00:00,89,25,64,FMN 06 B Zurenborgbrug Ringfietspad
655,Ringfietspad Zurenborgbrug,2022-10-04,22:00:00,102,41,61,FMN 06 B Zurenborgbrug Ringfietspad
655,Ringfietspad Zurenborgbrug,2022-10-04,23:00:00,46,18,28,FMN 06 B Zurenborgbrug Ringfietspad
655,Ringfietspad Zurenborgbrug,2022-10-05,00:00:00,25,11,14,FMN 06 B Zurenborgbrug Ringfietspad
655,Ringfietspad Zurenborgbrug,2022-10-05,01:00:00,5,3,2,FMN 06 B Zurenborgbrug Ringfietspad
655,Ringfietspad Zurenborgbrug,2022-10-05,02:00:00,4,2,2,FMN 06 B Zurenborgbrug Ringfietspad
655,Ringfietspad Zurenborgbrug,2022-10-05,03:00:00,2,1,1,FMN 06 B Zurenborgbrug Ringfietspad
655,Ringfietspad Zurenborgbrug,2022-10-05,04:00:00,19,12,7,FMN 06 B Zurenborgbrug Ringfietspad
655,Ringfietspad Zurenborgbrug,2022-10-05,05:00:00,57,27,30,FMN 06 B Zurenborgbrug Ringfietspad
655,Ringfietspad Zurenborgbrug,2022-10-05,06:00:00,157,86,71,FMN 06 B Zurenborgbrug Ringfietspad
655,Ringfietspad Zurenborgbrug,2022-10-05,07:00:00,504,304,200,FMN 06 B Zurenborgbrug Ringfietspad
655,Ringfietspad Zurenborgbrug,2022-10-05,08:00:00,626,368,258,FMN 06 B Zurenborgbrug Ringfietspad
655,Ringfietspad Zurenborgbrug,2022-10-05,09:00:00,196,112,84,FMN 06 B Zurenborgbrug Ringfietspad
655,Ringfietspad Zurenborgbrug,2022-10-05,10:00:00,131,67,64,FMN 06 B Zurenborgbrug Ringfietspad
655,Ringfietspad Zurenborgbrug,2022-10-05,11:00:00,130,65,65,FMN 06 B Zurenborgbrug Ringfietspad
655,Ringfietspad Zurenborgbrug,2022-10-05,12:00:00,376,173,203,FMN 06 B Zurenborgbrug Ringfietspad
655,Ringfietspad Zurenborgbrug,2022-10-05,13:00:00,293,146,147,FMN 06 B Zurenborgbrug Ringfietspad
655,Ringfietspad Zurenborgbrug,2022-10-05,14:00:00,223,101,122,FMN 06 B Zurenborgbrug Ringfietspad
655,Ringfietspad Zurenborgbrug,2022-10-05,15:00:00,257,114,143,FMN 06 B Zurenborgbrug Ringfietspad
655,Ringfietspad Zurenborgbrug,2022-10-05,16:00:00,452,170,282,FMN 06 B Zurenborgbrug Ringfietspad
655,Ringfietspad Zurenborgbrug,2022-10-05,17:00:00,518,186,332,FMN 06 B Zurenborgbrug Ringfietspad
655,Ringfietspad Zurenborgbrug,2022-10-05,18:00:00,331,131,200,FMN 06 B Zurenborgbrug Ringfietspad
655,Ringfietspad Zurenborgbrug,2022-10-05,19:00:00,167,75,92,FMN 06 B Zurenborgbrug Ringfietspad
655,Ringfietspad Zurenborgbrug,2022-10-05,20:00:00,92,39,53,FMN 06 B Zurenborgbrug Ringfietspad
655,Ringfietspad Zurenborgbrug,2022-10-05,21:00:00,88,39,49,FMN 06 B Zurenborgbrug Ringfietspad
655,Ringfietspad Zurenborgbrug,2022-10-05,22:00:00,83,39,44,FMN 06 B Zurenborgbrug Ringfietspad
655,Ringfietspad Zurenborgbrug,2022-10-05,23:00:00,25,11,14,FMN 06 B Zurenborgbrug Ringfietspad
655,Ringfietspad Zurenborgbrug,2022-10-06,00:00:00,15,7,8,FMN 06 B Zurenborgbrug Ringfietspad
655,Ringfietspad Zurenborgbrug,2022-10-06,01:00:00,3,1,2,FMN 06 B Zurenborgbrug Ringfietspad
655,Ringfietspad Zurenborgbrug,2022-10-06,02:00:00,3,1,2,FMN 06 B Zurenborgbrug Ringfietspad
655,Ringfietspad Zurenborgbrug,2022-10-06,03:00:00,2,1,1,FMN 06 B Zurenborgbrug Ringfietspad
655,Ringfietspad Zurenborgbrug,2022-10-06,04:00:00,17,10,7,FMN 06 B Zurenborgbrug Ringfietspad
655,Ringfietspad Zurenborgbrug,2022-10-06,05:00:00,47,26,21,FMN 06 B Zurenborgbrug Ringfietspad
655,Ringfietspad Zurenborgbrug,2022-10-06,06:00:00,138,83,55,FMN 06 B Zurenborgbrug Ringfietspad
655,Ringfietspad Zurenborgbrug,2022-10-06,07:00:00,477,294,183,FMN 06 B Zurenborgbrug Ringfietspad
655,Ringfietspad Zurenborgbrug,2022-10-06,08:00:00,658,382,276,FMN 06 B Zurenborgbrug Ringfietspad
655,Ringfietspad Zurenborgbrug,2022-10-06,09:00:00,222,141,81,FMN 06 B Zurenborgbrug Ringfietspad
655,Ringfietspad Zurenborgbrug,2022-10-06,10:00:00,139,79,60,FMN 06 B Zurenborgbrug Ringfietspad
655,Ringfietspad Zurenborgbrug,2022-10-06,11:00:00,122,63,59,FMN 06 B Zurenborgbrug Ringfietspad
655,Ringfietspad Zurenborgbrug,2022-10-06,12:00:00,244,130,114,FMN 06 B Zurenborgbrug Ringfietspad
655,Ringfietspad Zurenborgbrug,2022-10-06,13:00:00,265,104,161,FMN 06 B Zurenborgbrug Ringfietspad
655,Ringfietspad Zurenborgbrug,2022-10-06,14:00:00,255,109,146,FMN 06 B Zurenborgbrug Ringfietspad
655,Ringfietspad Zurenborgbrug,2022-10-06,15:00:00,324,127,197,FMN 06 B Zurenborgbrug Ringfietspad
655,Ringfietspad Zurenborgbrug,2022-10-06,16:00:00,612,250,362,FMN 06 B Zurenborgbrug Ringfietspad
655,Ringfietspad Zurenborgbrug,2022-10-06,17:00:00,592,200,392,FMN 06 B Zurenborgbrug Ringfietspad
655,Ringfietspad Zurenborgbrug,2022-10-06,18:00:00,385,142,243,FMN 06 B Zurenborgbrug Ringfietspad
655,Ringfietspad Zurenborgbrug,2022-10-06,19:00:00,178,74,104,FMN 06 B Zurenborgbrug Ringfietspad
655,Ringfietspad Zurenborgbrug,2022-10-06,20:00:00,116,62,54,FMN 06 B Zurenborgbrug Ringfietspad
655,Ringfietspad Zurenborgbrug,2022-10-06,21:00:00,111,38,73,FMN 06 B Zurenborgbrug Ringfietspad
655,Ringfietspad Zurenborgbrug,2022-10-06,22:00:00,94,41,53,FMN 06 B Zurenborgbrug Ringfietspad
655,Ringfietspad Zurenborgbrug,2022-10-06,23:00:00,36,10,26,FMN 06 B Zurenborgbrug Ringfietspad
655,Ringfietspad Zurenborgbrug,2022-10-07,00:00:00,18,10,8,FMN 06 B Zurenborgbrug Ringfietspad
655,Ringfietspad Zurenborgbrug,2022-10-07,01:00:00,7,0,7,FMN 06 B Zurenborgbrug Ringfietspad
655,Ringfietspad Zurenborgbrug,2022-10-07,02:00:00,6,1,5,FMN 06 B Zurenborgbrug Ringfietspad
655,Ringfietspad Zurenborgbrug,2022-10-07,03:00:00,2,1,1,FMN 06 B Zurenborgbrug Ringfietspad
655,Ringfietspad Zurenborgbrug,2022-10-07,04:00:00,15,8,7,FMN 06 B Zurenborgbrug Ringfietspad
655,Ringfietspad Zurenborgbrug,2022-10-07,05:00:00,52,29,23,FMN 06 B Zurenborgbrug Ringfietspad
655,Ringfietspad Zurenborgbrug,2022-10-07,06:00:00,126,73,53,FMN 06 B Zurenborgbrug Ringfietspad
655,Ringfietspad Zurenborgbrug,2022-10-07,07:00:00,392,222,170,FMN 06 B Zurenborgbrug Ringfietspad
655,Ringfietspad Zurenborgbrug,2022-10-07,08:00:00,586,339,247,FMN 06 B Zurenborgbrug Ringfietspad
655,Ringfietspad Zurenborgbrug,2022-10-07,09:00:00,178,94,84,FMN 06 B Zurenborgbrug Ringfietspad
655,Ringfietspad Zurenborgbrug,2022-10-07,10:00:00,150,92,58,FMN 06 B Zurenborgbrug Ringfietspad
655,Ringfietspad Zurenborgbrug,2022-10-07,11:00:00,120,54,66,FMN 06 B Zurenborgbrug Ringfietspad
655,Ringfietspad Zurenborgbrug,2022-10-07,12:00:00,221,89,132,FMN 06 B Zurenborgbrug Ringfietspad
655,Ringfietspad Zurenborgbrug,2022-10-07,13:00:00,216,81,135,FMN 06 B Zurenborgbrug Ringfietspad
655,Ringfietspad Zurenborgbrug,2022-10-07,14:00:00,225,101,124,FMN 06 B Zurenborgbrug Ringfietspad
655,Ringfietspad Zurenborgbrug,2022-10-07,15:00:00,370,151,219,FMN 06 B Zurenborgbrug Ringfietspad
655,Ringfietspad Zurenborgbrug,2022-10-07,16:00:00,507,210,297,FMN 06 B Zurenborgbrug Ringfietspad
655,Ringfietspad Zurenborgbrug,2022-10-07,17:00:00,402,150,252,FMN 06 B Zurenborgbrug Ringfietspad
655,Ringfietspad Zurenborgbrug,2022-10-07,18:00:00,311,124,187,FMN 06 B Zurenborgbrug Ringfietspad
655,Ringfietspad Zurenborgbrug,2022-10-07,19:00:00,271,97,174,FMN 06 B Zurenborgbrug Ringfietspad
655,Ringfietspad Zurenborgbrug,2022-10-07,20:00:00,118,44,74,FMN 06 B Zurenborgbrug Ringfietspad
655,Ringfietspad Zurenborgbrug,2022-10-07,21:00:00,66,28,38,FMN 06 B Zurenborgbrug Ringfietspad
655,Ringfietspad Zurenborgbrug,2022-10-07,22:00:00,93,49,44,FMN 06 B Zurenborgbrug Ringfietspad
655,Ringfietspad Zurenborgbrug,2022-10-07,23:00:00,109,78,31,FMN 06 B Zurenborgbrug Ringfietspad
655,Ringfietspad Zurenborgbrug,2022-10-08,00:00:00,62,34,28,FMN 06 B Zurenborgbrug Ringfietspad
655,Ringfietspad Zurenborgbrug,2022-10-08,01:00:00,37,22,15,FMN 06 B Zurenborgbrug Ringfietspad
655,Ringfietspad Zurenborgbrug,2022-10-08,02:00:00,10,7,3,FMN 06 B Zurenborgbrug Ringfietspad
655,Ringfietspad Zurenborgbrug,2022-10-08,03:00:00,6,3,3,FMN 06 B Zurenborgbrug Ringfietspad
655,Ringfietspad Zurenborgbrug,2022-10-08,04:00:00,6,5,1,FMN 06 B Zurenborgbrug Ringfietspad
655,Ringfietspad Zurenborgbrug,2022-10-08,05:00:00,9,5,4,FMN 06 B Zurenborgbrug Ringfietspad
655,Ringfietspad Zurenborgbrug,2022-10-08,06:00:00,30,25,5,FMN 06 B Zurenborgbrug Ringfietspad
655,Ringfietspad Zurenborgbrug,2022-10-08,07:00:00,32,21,11,FMN 06 B Zurenborgbrug Ringfietspad
655,Ringfietspad Zurenborgbrug,2022-10-08,08:00:00,78,44,34,FMN 06 B Zurenborgbrug Ringfietspad
655,Ringfietspad Zurenborgbrug,2022-10-08,09:00:00,98,39,59,FMN 06 B Zurenborgbrug Ringfietspad
655,Ringfietspad Zurenborgbrug,2022-10-08,10:00:00,117,39,78,FMN 06 B Zurenborgbrug Ringfietspad
655,Ringfietspad Zurenborgbrug,2022-10-08,11:00:00,126,57,69,FMN 06 B Zurenborgbrug Ringfietspad
655,Ringfietspad Zurenborgbrug,2022-10-08,12:00:00,146,65,81,FMN 06 B Zurenborgbrug Ringfietspad
655,Ringfietspad Zurenborgbrug,2022-10-08,13:00:00,179,95,84,FMN 06 B Zurenborgbrug Ringfietspad
655,Ringfietspad Zurenborgbrug,2022-10-08,14:00:00,244,115,129,FMN 06 B Zurenborgbrug Ringfietspad
655,Ringfietspad Zurenborgbrug,2022-10-08,15:00:00,180,77,103,FMN 06 B Zurenborgbrug Ringfietspad
655,Ringfietspad Zurenborgbrug,2022-10-08,16:00:00,213,87,126,FMN 06 B Zurenborgbrug Ringfietspad
655,Ringfietspad Zurenborgbrug,2022-10-08,17:00:00,180,87,93,FMN 06 B Zurenborgbrug Ringfietspad
655,Ringfietspad Zurenborgbrug,2022-10-08,18:00:00,150,68,82,FMN 06 B Zurenborgbrug Ringfietspad
655,Ringfietspad Zurenborgbrug,2022-10-08,19:00:00,125,58,67,FMN 06 B Zurenborgbrug Ringfietspad
655,Ringfietspad Zurenborgbrug,2022-10-08,20:00:00,74,27,47,FMN 06 B Zurenborgbrug Ringfietspad
655,Ringfietspad Zurenborgbrug,2022-10-08,21:00:00,42,15,27,FMN 06 B Zurenborgbrug Ringfietspad
655,Ringfietspad Zurenborgbrug,2022-10-08,22:00:00,64,41,23,FMN 06 B Zurenborgbrug Ringfietspad
655,Ringfietspad Zurenborgbrug,2022-10-08,23:00:00,47,23,24,FMN 06 B Zurenborgbrug Ringfietspad
655,Ringfietspad Zurenborgbrug,2022-10-09,00:00:00,33,16,17,FMN 06 B Zurenborgbrug Ringfietspad
655,Ringfietspad Zurenborgbrug,2022-10-09,01:00:00,30,16,14,FMN 06 B Zurenborgbrug Ringfietspad
655,Ringfietspad Zurenborgbrug,2022-10-09,02:00:00,9,4,5,FMN 06 B Zurenborgbrug Ringfietspad
655,Ringfietspad Zurenborgbrug,2022-10-09,03:00:00,19,6,13,FMN 06 B Zurenborgbrug Ringfietspad
655,Ringfietspad Zurenborgbrug,2022-10-09,04:00:00,12,7,5,FMN 06 B Zurenborgbrug Ringfietspad
655,Ringfietspad Zurenborgbrug,2022-10-09,05:00:00,13,7,6,FMN 06 B Zurenborgbrug Ringfietspad
655,Ringfietspad Zurenborgbrug,2022-10-09,06:00:00,14,8,6,FMN 06 B Zurenborgbrug Ringfietspad
655,Ringfietspad Zurenborgbrug,2022-10-09,07:00:00,18,8,10,FMN 06 B Zurenborgbrug Ringfietspad
655,Ringfietspad Zurenborgbrug,2022-10-09,08:00:00,50,17,33,FMN 06 B Zurenborgbrug Ringfietspad
655,Ringfietspad Zurenborgbrug,2022-10-09,09:00:00,92,44,48,FMN 06 B Zurenborgbrug Ringfietspad
655,Ringfietspad Zurenborgbrug,2022-10-09,10:00:00,122,61,61,FMN 06 B Zurenborgbrug Ringfietspad
655,Ringfietspad Zurenborgbrug,2022-10-09,11:00:00,147,55,92,FMN 06 B Zurenborgbrug Ringfietspad
655,Ringfietspad Zurenborgbrug,2022-10-09,12:00:00,208,95,113,FMN 06 B Zurenborgbrug Ringfietspad
655,Ringfietspad Zurenborgbrug,2022-10-09,13:00:00,279,91,188,FMN 06 B Zurenborgbrug Ringfietspad
655,Ringfietspad Zurenborgbrug,2022-10-09,14:00:00,330,105,225,FMN 06 B Zurenborgbrug Ringfietspad
655,Ringfietspad Zurenborgbrug,2022-10-09,15:00:00,273,133,140,FMN 06 B Zurenborgbrug Ringfietspad
655,Ringfietspad Zurenborgbrug,2022-10-09,16:00:00,251,136,115,FMN 06 B Zurenborgbrug Ringfietspad
655,Ringfietspad Zurenborgbrug,2022-10-09,17:00:00,225,149,76,FMN 06 B Zurenborgbrug Ringfietspad
655,Ringfietspad Zurenborgbrug,2022-10-09,18:00:00,186,120,66,FMN 06 B Zurenborgbrug Ringfietspad
655,Ringfietspad Zurenborgbrug,2022-10-09,19:00:00,96,49,47,FMN 06 B Zurenborgbrug Ringfietspad
655,Ringfietspad Zurenborgbrug,2022-10-09,20:00:00,46,23,23,FMN 06 B Zurenborgbrug Ringfietspad
655,Ringfietspad Zurenborgbrug,2022-10-09,21:00:00,38,17,21,FMN 06 B Zurenborgbrug Ringfietspad
655,Ringfietspad Zurenborgbrug,2022-10-09,22:00:00,40,24,16,FMN 06 B Zurenborgbrug Ringfietspad
655,Ringfietspad Zurenborgbrug,2022-10-09,23:00:00,18,12,6,FMN 06 B Zurenborgbrug Ringfietspad
655,Ringfietspad Zurenborgbrug,2022-10-10,00:00:00,7,2,5,FMN 06 B Zurenborgbrug Ringfietspad
655,Ringfietspad Zurenborgbrug,2022-10-10,01:00:00,4,1,3,FMN 06 B Zurenborgbrug Ringfietspad
655,Ringfietspad Zurenborgbrug,2022-10-10,02:00:00,2,1,1,FMN 06 B Zurenborgbrug Ringfietspad
655,Ringfietspad Zurenborgbrug,2022-10-10,03:00:00,5,2,3,FMN 06 B Zurenborgbrug Ringfietspad
655,Ringfietspad Zurenborgbrug,2022-10-10,04:00:00,12,6,6,FMN 06 B Zurenborgbrug Ringfietspad
655,Ringfietspad Zurenborgbrug,2022-10-10,05:00:00,41,20,21,FMN 06 B Zurenborgbrug Ringfietspad
655,Ringfietspad Zurenborgbrug,2022-10-10,06:00:00,132,66,66,FMN 06 B Zurenborgbrug Ringfietspad
655,Ringfietspad Zurenborgbrug,2022-10-10,07:00:00,448,267,181,FMN 06 B Zurenborgbrug Ringfietspad
655,Ringfietspad Zurenborgbrug,2022-10-10,08:00:00,619,347,272,FMN 06 B Zurenborgbrug Ringfietspad
655,Ringfietspad Zurenborgbrug,2022-10-10,09:00:00,166,92,74,FMN 06 B Zurenborgbrug Ringfietspad
655,Ringfietspad Zurenborgbrug,2022-10-10,10:00:00,134,67,67,FMN 06 B Zurenborgbrug Ringfietspad
655,Ringfietspad Zurenborgbrug,2022-10-10,11:00:00,102,53,49,FMN 06 B Zurenborgbrug Ringfietspad
655,Ringfietspad Zurenborgbrug,2022-10-10,12:00:00,194,83,111,FMN 06 B Zurenborgbrug Ringfietspad
655,Ringfietspad Zurenborgbrug,2022-10-10,13:00:00,185,89,96,FMN 06 B Zurenborgbrug Ringfietspad
655,Ringfietspad Zurenborgbrug,2022-10-10,14:00:00,126,50,76,FMN 06 B Zurenborgbrug Ringfietspad
655,Ringfietspad Zurenborgbrug,2022-10-10,15:00:00,328,126,202,FMN 06 B Zurenborgbrug Ringfietspad
655,Ringfietspad Zurenborgbrug,2022-10-10,16:00:00,544,229,315,FMN 06 B Zurenborgbrug Ringfietspad
655,Ringfietspad Zurenborgbrug,2022-10-10,17:00:00,491,157,334,FMN 06 B Zurenborgbrug Ringfietspad
655,Ringfietspad Zurenborgbrug,2022-10-10,18:00:00,277,113,164,FMN 06 B Zurenborgbrug Ringfietspad
655,Ringfietspad Zurenborgbrug,2022-10-10,19:00:00,157,52,105,FMN 06 B Zurenborgbrug Ringfietspad
655,Ringfietspad Zurenborgbrug,2022-10-10,20:00:00,98,47,51,FMN 06 B Zurenborgbrug Ringfietspad
655,Ringfietspad Zurenborgbrug,2022-10-10,21:00:00,73,26,47,FMN 06 B Zurenborgbrug Ringfietspad
655,Ringfietspad Zurenborgbrug,2022-10-10,22:00:00,69,21,48,FMN 06 B Zurenborgbrug Ringfietspad
655,Ringfietspad Zurenborgbrug,2022-10-10,23:00:00,15,5,10,FMN 06 B Zurenborgbrug Ringfietspad
655,Ringfietspad Zurenborgbrug,2022-10-11,00:00:00,9,3,6,FMN 06 B Zurenborgbrug Ringfietspad
655,Ringfietspad Zurenborgbrug,2022-10-11,01:00:00,1,0,1,FMN 06 B Zurenborgbrug Ringfietspad
655,Ringfietspad Zurenborgbrug,2022-10-11,02:00:00,2,1,1,FMN 06 B Zurenborgbrug Ringfietspad
655,Ringfietspad Zurenborgbrug,2022-10-11,03:00:00,4,1,3,FMN 06 B Zurenborgbrug Ringfietspad
655,Ringfietspad Zurenborgbrug,2022-10-11,04:00:00,11,7,4,FMN 06 B Zurenborgbrug Ringfietspad
655,Ringfietspad Zurenborgbrug,2022-10-11,05:00:00,56,26,30,FMN 06 B Zurenborgbrug Ringfietspad
655,Ringfietspad Zurenborgbrug,2022-10-11,06:00:00,137,73,64,FMN 06 B Zurenborgbrug Ringfietspad
655,Ringfietspad Zurenborgbrug,2022-10-11,07:00:00,474,289,185,FMN 06 B Zurenborgbrug Ringfietspad
655,Ringfietspad Zurenborgbrug,2022-10-11,08:00:00,690,376,314,FMN 06 B Zurenborgbrug Ringfietspad
655,Ringfietspad Zurenborgbrug,2022-10-11,09:00:00,178,94,84,FMN 06 B Zurenborgbrug Ringfietspad
655,Ringfietspad Zurenborgbrug,2022-10-11,10:00:00,119,64,55,FMN 06 B Zurenborgbrug Ringfietspad
655,Ringfietspad Zurenborgbrug,2022-10-11,11:00:00,116,54,62,FMN 06 B Zurenborgbrug Ringfietspad
655,Ringfietspad Zurenborgbrug,2022-10-11,12:00:00,209,104,105,FMN 06 B Zurenborgbrug Ringfietspad
655,Ringfietspad Zurenborgbrug,2022-10-11,13:00:00,221,98,123,FMN 06 B Zurenborgbrug Ringfietspad
655,Ringfietspad Zurenborgbrug,2022-10-11,14:00:00,219,90,129,FMN 06 B Zurenborgbrug Ringfietspad
655,Ringfietspad Zurenborgbrug,2022-10-11,15:00:00,318,130,188,FMN 06 B Zurenborgbrug Ringfietspad
655,Ringfietspad Zurenborgbrug,2022-10-11,16:00:00,593,239,354,FMN 06 B Zurenborgbrug Ringfietspad
655,Ringfietspad Zurenborgbrug,2022-10-11,17:00:00,616,220,396,FMN 06 B Zurenborgbrug Ringfietspad
655,Ringfietspad Zurenborgbrug,2022-10-11,18:00:00,378,125,253,FMN 06 B Zurenborgbrug Ringfietspad
655,Ringfietspad Zurenborgbrug,2022-10-11,19:00:00,178,69,109,FMN 06 B Zurenborgbrug Ringfietspad
655,Ringfietspad Zurenborgbrug,2022-10-11,20:00:00,102,42,60,FMN 06 B Zurenborgbrug Ringfietspad
655,Ringfietspad Zurenborgbrug,2022-10-11,21:00:00,81,30,51,FMN 06 B Zurenborgbrug Ringfietspad
655,Ringfietspad Zurenborgbrug,2022-10-11,22:00:00,78,27,51,FMN 06 B Zurenborgbrug Ringfietspad
655,Ringfietspad Zurenborgbrug,2022-10-11,23:00:00,30,12,18,FMN 06 B Zurenborgbrug Ringfietspad
655,Ringfietspad Zurenborgbrug,2022-10-12,00:00:00,19,6,13,FMN 06 B Zurenborgbrug Ringfietspad
655,Ringfietspad Zurenborgbrug,2022-10-12,01:00:00,4,1,3,FMN 06 B Zurenborgbrug Ringfietspad
655,Ringfietspad Zurenborgbrug,2022-10-12,02:00:00,1,0,1,FMN 06 B Zurenborgbrug Ringfietspad
655,Ringfietspad Zurenborgbrug,2022-10-12,03:00:00,5,4,1,FMN 06 B Zurenborgbrug Ringfietspad
655,Ringfietspad Zurenborgbrug,2022-10-12,04:00:00,13,8,5,FMN 06 B Zurenborgbrug Ringfietspad
655,Ringfietspad Zurenborgbrug,2022-10-12,05:00:00,56,32,24,FMN 06 B Zurenborgbrug Ringfietspad
655,Ringfietspad Zurenborgbrug,2022-10-12,06:00:00,132,73,59,FMN 06 B Zurenborgbrug Ringfietspad
655,Ringfietspad Zurenborgbrug,2022-10-12,07:00:00,399,244,155,FMN 06 B Zurenborgbrug Ringfietspad
655,Ringfietspad Zurenborgbrug,2022-10-12,08:00:00,535,305,230,FMN 06 B Zurenborgbrug Ringfietspad
655,Ringfietspad Zurenborgbrug,2022-10-12,09:00:00,181,96,85,FMN 06 B Zurenborgbrug Ringfietspad
655,Ringfietspad Zurenborgbrug,2022-10-12,10:00:00,132,70,62,FMN 06 B Zurenborgbrug Ringfietspad
655,Ringfietspad Zurenborgbrug,2022-10-12,11:00:00,146,74,72,FMN 06 B Zurenborgbrug Ringfietspad
655,Ringfietspad Zurenborgbrug,2022-10-12,12:00:00,338,150,188,FMN 06 B Zurenborgbrug Ringfietspad
655,Ringfietspad Zurenborgbrug,2022-10-12,13:00:00,282,118,164,FMN 06 B Zurenborgbrug Ringfietspad
655,Ringfietspad Zurenborgbrug,2022-10-12,14:00:00,208,89,119,FMN 06 B Zurenborgbrug Ringfietspad
655,Ringfietspad Zurenborgbrug,2022-10-12,15:00:00,264,101,163,FMN 06 B Zurenborgbrug Ringfietspad
655,Ringfietspad Zurenborgbrug,2022-10-12,16:00:00,456,174,282,FMN 06 B Zurenborgbrug Ringfietspad
655,Ringfietspad Zurenborgbrug,2022-10-12,17:00:00,489,166,323,FMN 06 B Zurenborgbrug Ringfietspad
655,Ringfietspad Zurenborgbrug,2022-10-12,18:00:00,307,116,191,FMN 06 B Zurenborgbrug Ringfietspad
655,Ringfietspad Zurenborgbrug,2022-10-12,19:00:00,156,59,97,FMN 06 B Zurenborgbrug Ringfietspad
655,Ringfietspad Zurenborgbrug,2022-10-12,20:00:00,87,47,40,FMN 06 B Zurenborgbrug Ringfietspad
655,Ringfietspad Zurenborgbrug,2022-10-12,21:00:00,94,39,55,FMN 06 B Zurenborgbrug Ringfietspad
655,Ringfietspad Zurenborgbrug,2022-10-12,22:00:00,100,41,59,FMN 06 B Zurenborgbrug Ringfietspad
655,Ringfietspad Zurenborgbrug,2022-10-12,23:00:00,35,14,21,FMN 06 B Zurenborgbrug Ringfietspad
655,Ringfietspad Zurenborgbrug,2022-10-13,00:00:00,11,6,5,FMN 06 B Zurenborgbrug Ringfietspad
655,Ringfietspad Zurenborgbrug,2022-10-13,01:00:00,1,1,0,FMN 06 B Zurenborgbrug Ringfietspad
655,Ringfietspad Zurenborgbrug,2022-10-13,02:00:00,3,2,1,FMN 06 B Zurenborgbrug Ringfietspad
655,Ringfietspad Zurenborgbrug,2022-10-13,03:00:00,4,0,4,FMN 06 B Zurenborgbrug Ringfietspad
655,Ringfietspad Zurenborgbrug,2022-10-13,04:00:00,14,8,6,FMN 06 B Zurenborgbrug Ringfietspad
655,Ringfietspad Zurenborgbrug,2022-10-13,05:00:00,56,29,27,FMN 06 B Zurenborgbrug Ringfietspad
655,Ringfietspad Zurenborgbrug,2022-10-13,06:00:00,128,75,53,FMN 06 B Zurenborgbrug Ringfietspad
655,Ringfietspad Zurenborgbrug,2022-10-13,07:00:00,435,275,160,FMN 06 B Zurenborgbrug Ringfietspad
655,Ringfietspad Zurenborgbrug,2022-10-13,08:00:00,639,386,253,FMN 06 B Zurenborgbrug Ringfietspad
655,Ringfietspad Zurenborgbrug,2022-10-13,09:00:00,180,99,81,FMN 06 B Zurenborgbrug Ringfietspad
655,Ringfietspad Zurenborgbrug,2022-10-13,10:00:00,148,71,77,FMN 06 B Zurenborgbrug Ringfietspad
655,Ringfietspad Zurenborgbrug,2022-10-13,11:00:00,102,46,56,FMN 06 B Zurenborgbrug Ringfietspad
655,Ringfietspad Zurenborgbrug,2022-10-13,12:00:00,123,79,44,FMN 06 B Zurenborgbrug Ringfietspad
655,Ringfietspad Zurenborgbrug,2022-10-13,13:00:00,188,97,91,FMN 06 B Zurenborgbrug Ringfietspad
655,Ringfietspad Zurenborgbrug,2022-10-13,14:00:00,150,67,83,FMN 06 B Zurenborgbrug Ringfietspad
655,Ringfietspad Zurenborgbrug,2022-10-13,15:00:00,277,96,181,FMN 06 B Zurenborgbrug Ringfietspad
655,Ringfietspad Zurenborgbrug,2022-10-13,16:00:00,509,225,284,FMN 06 B Zurenborgbrug Ringfietspad
655,Ringfietspad Zurenborgbrug,2022-10-13,17:00:00,503,160,343,FMN 06 B Zurenborgbrug Ringfietspad
655,Ringfietspad Zurenborgbrug,2022-10-13,18:00:00,279,105,174,FMN 06 B Zurenborgbrug Ringfietspad
655,Ringfietspad Zurenborgbrug,2022-10-13,19:00:00,145,67,78,FMN 06 B Zurenborgbrug Ringfietspad
655,Ringfietspad Zurenborgbrug,2022-10-13,20:00:00,98,48,50,FMN 06 B Zurenborgbrug Ringfietspad
655,Ringfietspad Zurenborgbrug,2022-10-13,21:00:00,81,37,44,FMN 06 B Zurenborgbrug Ringfietspad
655,Ringfietspad Zurenborgbrug,2022-10-13,22:00:00,82,33,49,FMN 06 B Zurenborgbrug Ringfietspad
655,Ringfietspad Zurenborgbrug,2022-10-13,23:00:00,32,9,23,FMN 06 B Zurenborgbrug Ringfietspad
655,Ringfietspad Zurenborgbrug,2022-10-14,00:00:00,16,7,9,FMN 06 B Zurenborgbrug Ringfietspad
655,Ringfietspad Zurenborgbrug,2022-10-14,01:00:00,11,5,6,FMN 06 B Zurenborgbrug Ringfietspad
655,Ringfietspad Zurenborgbrug,2022-10-14,02:00:00,4,1,3,FMN 06 B Zurenborgbrug Ringfietspad
655,Ringfietspad Zurenborgbrug,2022-10-14,03:00:00,6,3,3,FMN 06 B Zurenborgbrug Ringfietspad
655,Ringfietspad Zurenborgbrug,2022-10-14,04:00:00,11,6,5,FMN 06 B Zurenborgbrug Ringfietspad
655,Ringfietspad Zurenborgbrug,2022-10-14,05:00:00,46,23,23,FMN 06 B Zurenborgbrug Ringfietspad
655,Ringfietspad Zurenborgbrug,2022-10-14,06:00:00,109,69,40,FMN 06 B Zurenborgbrug Ringfietspad
655,Ringfietspad Zurenborgbrug,2022-10-14,07:00:00,358,223,135,FMN 06 B Zurenborgbrug Ringfietspad
655,Ringfietspad Zurenborgbrug,2022-10-14,08:00:00,528,310,218,FMN 06 B Zurenborgbrug Ringfietspad
655,Ringfietspad Zurenborgbrug,2022-10-14,09:00:00,146,86,60,FMN 06 B Zurenborgbrug Ringfietspad
655,Ringfietspad Zurenborgbrug,2022-10-14,10:00:00,104,65,39,FMN 06 B Zurenborgbrug Ringfietspad
655,Ringfietspad Zurenborgbrug,2022-10-14,11:00:00,82,38,44,FMN 06 B Zurenborgbrug Ringfietspad
655,Ringfietspad Zurenborgbrug,2022-10-14,12:00:00,143,56,87,FMN 06 B Zurenborgbrug Ringfietspad
655,Ringfietspad Zurenborgbrug,2022-10-14,13:00:00,171,78,93,FMN 06 B Zurenborgbrug Ringfietspad
655,Ringfietspad Zurenborgbrug,2022-10-14,14:00:00,129,52,77,FMN 06 B Zurenborgbrug Ringfietspad
655,Ringfietspad Zurenborgbrug,2022-10-14,15:00:00,254,88,166,FMN 06 B Zurenborgbrug Ringfietspad
655,Ringfietspad Zurenborgbrug,2022-10-14,16:00:00,471,189,282,FMN 06 B Zurenborgbrug Ringfietspad
655,Ringfietspad Zurenborgbrug,2022-10-14,17:00:00,376,130,246,FMN 06 B Zurenborgbrug Ringfietspad
655,Ringfietspad Zurenborgbrug,2022-10-14,18:00:00,245,99,146,FMN 06 B Zurenborgbrug Ringfietspad
655,Ringfietspad Zurenborgbrug,2022-10-14,19:00:00,153,60,93,FMN 06 B Zurenborgbrug Ringfietspad
655,Ringfietspad Zurenborgbrug,2022-10-14,20:00:00,97,45,52,FMN 06 B Zurenborgbrug Ringfietspad
655,Ringfietspad Zurenborgbrug,2022-10-14,21:00:00,67,35,32,FMN 06 B Zurenborgbrug Ringfietspad
655,Ringfietspad Zurenborgbrug,2022-10-14,22:00:00,68,23,45,FMN 06 B Zurenborgbrug Ringfietspad
655,Ringfietspad Zurenborgbrug,2022-10-14,23:00:00,50,17,33,FMN 06 B Zurenborgbrug Ringfietspad
655,Ringfietspad Zurenborgbrug,2022-10-15,00:00:00,38,18,20,FMN 06 B Zurenborgbrug Ringfietspad
655,Ringfietspad Zurenborgbrug,2022-10-15,01:00:00,18,10,8,FMN 06 B Zurenborgbrug Ringfietspad
655,Ringfietspad Zurenborgbrug,2022-10-15,02:00:00,22,9,13,FMN 06 B Zurenborgbrug Ringfietspad
655,Ringfietspad Zurenborgbrug,2022-10-15,03:00:00,16,11,5,FMN 06 B Zurenborgbrug Ringfietspad
655,Ringfietspad Zurenborgbrug,2022-10-15,04:00:00,3,1,2,FMN 06 B Zurenborgbrug Ringfietspad
655,Ringfietspad Zurenborgbrug,2022-10-15,05:00:00,15,8,7,FMN 06 B Zurenborgbrug Ringfietspad
655,Ringfietspad Zurenborgbrug,2022-10-15,06:00:00,42,25,17,FMN 06 B Zurenborgbrug Ringfietspad
655,Ringfietspad Zurenborgbrug,2022-10-15,07:00:00,22,12,10,FMN 06 B Zurenborgbrug Ringfietspad
655,Ringfietspad Zurenborgbrug,2022-10-15,08:00:00,59,36,23,FMN 06 B Zurenborgbrug Ringfietspad
655,Ringfietspad Zurenborgbrug,2022-10-15,09:00:00,91,45,46,FMN 06 B Zurenborgbrug Ringfietspad
655,Ringfietspad Zurenborgbrug,2022-10-15,10:00:00,77,34,43,FMN 06 B Zurenborgbrug Ringfietspad
655,Ringfietspad Zurenborgbrug,2022-10-15,11:00:00,72,40,32,FMN 06 B Zurenborgbrug Ringfietspad
655,Ringfietspad Zurenborgbrug,2022-10-15,12:00:00,110,62,48,FMN 06 B Zurenborgbrug Ringfietspad
655,Ringfietspad Zurenborgbrug,2022-10-15,13:00:00,107,37,70,FMN 06 B Zurenborgbrug Ringfietspad
655,Ringfietspad Zurenborgbrug,2022-10-15,14:00:00,148,58,90,FMN 06 B Zurenborgbrug Ringfietspad
655,Ringfietspad Zurenborgbrug,2022-10-15,15:00:00,144,72,72,FMN 06 B Zurenborgbrug Ringfietspad
655,Ringfietspad Zurenborgbrug,2022-10-15,16:00:00,166,65,101,FMN 06 B Zurenborgbrug Ringfietspad
655,Ringfietspad Zurenborgbrug,2022-10-15,17:00:00,167,89,78,FMN 06 B Zurenborgbrug Ringfietspad
655,Ringfietspad Zurenborgbrug,2022-10-15,18:00:00,136,71,65,FMN 06 B Zurenborgbrug Ringfietspad
655,Ringfietspad Zurenborgbrug,2022-10-15,19:00:00,94,48,46,FMN 06 B Zurenborgbrug Ringfietspad
655,Ringfietspad Zurenborgbrug,2022-10-15,20:00:00,80,25,55,FMN 06 B Zurenborgbrug Ringfietspad
655,Ringfietspad Zurenborgbrug,2022-10-15,21:00:00,49,22,27,FMN 06 B Zurenborgbrug Ringfietspad
655,Ringfietspad Zurenborgbrug,2022-10-15,22:00:00,59,28,31,FMN 06 B Zurenborgbrug Ringfietspad
655,Ringfietspad Zurenborgbrug,2022-10-15,23:00:00,37,16,21,FMN 06 B Zurenborgbrug Ringfietspad
655,Ringfietspad Zurenborgbrug,2022-10-16,00:00:00,40,18,22,FMN 06 B Zurenborgbrug Ringfietspad
655,Ringfietspad Zurenborgbrug,2022-10-16,01:00:00,38,27,11,FMN 06 B Zurenborgbrug Ringfietspad
655,Ringfietspad Zurenborgbrug,2022-10-16,02:00:00,18,11,7,FMN 06 B Zurenborgbrug Ringfietspad
655,Ringfietspad Zurenborgbrug,2022-10-16,03:00:00,10,2,8,FMN 06 B Zurenborgbrug Ringfietspad
655,Ringfietspad Zurenborgbrug,2022-10-16,04:00:00,9,5,4,FMN 06 B Zurenborgbrug Ringfietspad
655,Ringfietspad Zurenborgbrug,2022-10-16,05:00:00,9,5,4,FMN 06 B Zurenborgbrug Ringfietspad
655,Ringfietspad Zurenborgbrug,2022-10-16,06:00:00,20,10,10,FMN 06 B Zurenborgbrug Ringfietspad
655,Ringfietspad Zurenborgbrug,2022-10-16,07:00:00,25,12,13,FMN 06 B Zurenborgbrug Ringfietspad
655,Ringfietspad Zurenborgbrug,2022-10-16,08:00:00,50,20,30,FMN 06 B Zurenborgbrug Ringfietspad
655,Ringfietspad Zurenborgbrug,2022-10-16,09:00:00,124,55,69,FMN 06 B Zurenborgbrug Ringfietspad
655,Ringfietspad Zurenborgbrug,2022-10-16,10:00:00,150,69,81,FMN 06 B Zurenborgbrug Ringfietspad
655,Ringfietspad Zurenborgbrug,2022-10-16,11:00:00,190,95,95,FMN 06 B Zurenborgbrug Ringfietspad
655,Ringfietspad Zurenborgbrug,2022-10-16,12:00:00,181,99,82,FMN 06 B Zurenborgbrug Ringfietspad
655,Ringfietspad Zurenborgbrug,2022-10-16,13:00:00,225,109,116,FMN 06 B Zurenborgbrug Ringfietspad
655,Ringfietspad Zurenborgbrug,2022-10-16,14:00:00,257,113,144,FMN 06 B Zurenborgbrug Ringfietspad
655,Ringfietspad Zurenborgbrug,2022-10-16,15:00:00,248,107,141,FMN 06 B Zurenborgbrug Ringfietspad
655,Ringfietspad Zurenborgbrug,2022-10-16,16:00:00,196,105,91,FMN 06 B Zurenborgbrug Ringfietspad
655,Ringfietspad Zurenborgbrug,2022-10-16,17:00:00,180,102,78,FMN 06 B Zurenborgbrug Ringfietspad
655,Ringfietspad Zurenborgbrug,2022-10-16,18:00:00,123,53,70,FMN 06 B Zurenborgbrug Ringfietspad
655,Ringfietspad Zurenborgbrug,2022-10-16,19:00:00,85,33,52,FMN 06 B Zurenborgbrug Ringfietspad
655,Ringfietspad Zurenborgbrug,2022-10-16,20:00:00,55,29,26,FMN 06 B Zurenborgbrug Ringfietspad
655,Ringfietspad Zurenborgbrug,2022-10-16,21:00:00,42,22,20,FMN 06 B Zurenborgbrug Ringfietspad
655,Ringfietspad Zurenborgbrug,2022-10-16,22:00:00,38,21,17,FMN 06 B Zurenborgbrug Ringfietspad
655,Ringfietspad Zurenborgbrug,2022-10-16,23:00:00,13,7,6,FMN 06 B Zurenborgbrug Ringfietspad
655,Ringfietspad Zurenborgbrug,2022-10-17,00:00:00,7,4,3,FMN 06 B Zurenborgbrug Ringfietspad
655,Ringfietspad Zurenborgbrug,2022-10-17,01:00:00,7,5,2,FMN 06 B Zurenborgbrug Ringfietspad
655,Ringfietspad Zurenborgbrug,2022-10-17,02:00:00,6,3,3,FMN 06 B Zurenborgbrug Ringfietspad
655,Ringfietspad Zurenborgbrug,2022-10-17,03:00:00,5,3,2,FMN 06 B Zurenborgbrug Ringfietspad
655,Ringfietspad Zurenborgbrug,2022-10-17,04:00:00,19,15,4,FMN 06 B Zurenborgbrug Ringfietspad
655,Ringfietspad Zurenborgbrug,2022-10-17,05:00:00,64,32,32,FMN 06 B Zurenborgbrug Ringfietspad
655,Ringfietspad Zurenborgbrug,2022-10-17,06:00:00,142,88,54,FMN 06 B Zurenborgbrug Ringfietspad
655,Ringfietspad Zurenborgbrug,2022-10-17,07:00:00,450,257,193,FMN 06 B Zurenborgbrug Ringfietspad
655,Ringfietspad Zurenborgbrug,2022-10-17,08:00:00,649,399,250,FMN 06 B Zurenborgbrug Ringfietspad
655,Ringfietspad Zurenborgbrug,2022-10-17,09:00:00,148,98,50,FMN 06 B Zurenborgbrug Ringfietspad
655,Ringfietspad Zurenborgbrug,2022-10-17,10:00:00,70,33,37,FMN 06 B Zurenborgbrug Ringfietspad
655,Ringfietspad Zurenborgbrug,2022-10-17,11:00:00,73,33,40,FMN 06 B Zurenborgbrug Ringfietspad
655,Ringfietspad Zurenborgbrug,2022-10-17,12:00:00,129,67,62,FMN 06 B Zurenborgbrug Ringfietspad
655,Ringfietspad Zurenborgbrug,2022-10-17,13:00:00,141,58,83,FMN 06 B Zurenborgbrug Ringfietspad
655,Ringfietspad Zurenborgbrug,2022-10-17,14:00:00,121,61,60,FMN 06 B Zurenborgbrug Ringfietspad
655,Ringfietspad Zurenborgbrug,2022-10-17,15:00:00,292,105,187,FMN 06 B Zurenborgbrug Ringfietspad
655,Ringfietspad Zurenborgbrug,2022-10-17,16:00:00,491,198,293,FMN 06 B Zurenborgbrug Ringfietspad
655,Ringfietspad Zurenborgbrug,2022-10-17,17:00:00,477,168,309,FMN 06 B Zurenborgbrug Ringfietspad
655,Ringfietspad Zurenborgbrug,2022-10-17,18:00:00,303,125,178,FMN 06 B Zurenborgbrug Ringfietspad
655,Ringfietspad Zurenborgbrug,2022-10-17,19:00:00,138,49,89,FMN 06 B Zurenborgbrug Ringfietspad
655,Ringfietspad Zurenborgbrug,2022-10-17,20:00:00,89,34,55,FMN 06 B Zurenborgbrug Ringfietspad
655,Ringfietspad Zurenborgbrug,2022-10-17,21:00:00,74,26,48,FMN 06 B Zurenborgbrug Ringfietspad
655,Ringfietspad Zurenborgbrug,2022-10-17,22:00:00,71,30,41,FMN 06 B Zurenborgbrug Ringfietspad
655,Ringfietspad Zurenborgbrug,2022-10-17,23:00:00,24,11,13,FMN 06 B Zurenborgbrug Ringfietspad
655,Ringfietspad Zurenborgbrug,2022-10-18,00:00:00,7,2,5,FMN 06 B Zurenborgbrug Ringfietspad
655,Ringfietspad Zurenborgbrug,2022-10-18,01:00:00,5,1,4,FMN 06 B Zurenborgbrug Ringfietspad
655,Ringfietspad Zurenborgbrug,2022-10-18,02:00:00,4,2,2,FMN 06 B Zurenborgbrug Ringfietspad
655,Ringfietspad Zurenborgbrug,2022-10-18,03:00:00,3,1,2,FMN 06 B Zurenborgbrug Ringfietspad
655,Ringfietspad Zurenborgbrug,2022-10-18,04:00:00,17,12,5,FMN 06 B Zurenborgbrug Ringfietspad
655,Ringfietspad Zurenborgbrug,2022-10-18,05:00:00,62,32,30,FMN 06 B Zurenborgbrug Ringfietspad
655,Ringfietspad Zurenborgbrug,2022-10-18,06:00:00,159,96,63,FMN 06 B Zurenborgbrug Ringfietspad
655,Ringfietspad Zurenborgbrug,2022-10-18,07:00:00,568,351,217,FMN 06 B Zurenborgbrug Ringfietspad
655,Ringfietspad Zurenborgbrug,2022-10-18,08:00:00,845,476,369,FMN 06 B Zurenborgbrug Ringfietspad
655,Ringfietspad Zurenborgbrug,2022-10-18,09:00:00,189,115,74,FMN 06 B Zurenborgbrug Ringfietspad
655,Ringfietspad Zurenborgbrug,2022-10-18,10:00:00,139,64,75,FMN 06 B Zurenborgbrug Ringfietspad
655,Ringfietspad Zurenborgbrug,2022-10-18,11:00:00,135,50,85,FMN 06 B Zurenborgbrug Ringfietspad
655,Ringfietspad Zurenborgbrug,2022-10-18,12:00:00,234,115,119,FMN 06 B Zurenborgbrug Ringfietspad
655,Ringfietspad Zurenborgbrug,2022-10-18,13:00:00,243,118,125,FMN 06 B Zurenborgbrug Ringfietspad
655,Ringfietspad Zurenborgbrug,2022-10-18,14:00:00,288,139,149,FMN 06 B Zurenborgbrug Ringfietspad
655,Ringfietspad Zurenborgbrug,2022-10-18,15:00:00,424,177,247,FMN 06 B Zurenborgbrug Ringfietspad
655,Ringfietspad Zurenborgbrug,2022-10-18,16:00:00,675,274,401,FMN 06 B Zurenborgbrug Ringfietspad
655,Ringfietspad Zurenborgbrug,2022-10-18,17:00:00,709,268,441,FMN 06 B Zurenborgbrug Ringfietspad
655,Ringfietspad Zurenborgbrug,2022-10-18,18:00:00,407,150,257,FMN 06 B Zurenborgbrug Ringfietspad
655,Ringfietspad Zurenborgbrug,2022-10-18,19:00:00,201,76,125,FMN 06 B Zurenborgbrug Ringfietspad
655,Ringfietspad Zurenborgbrug,2022-10-18,20:00:00,104,48,56,FMN 06 B Zurenborgbrug Ringfietspad
655,Ringfietspad Zurenborgbrug,2022-10-18,21:00:00,114,41,73,FMN 06 B Zurenborgbrug Ringfietspad
655,Ringfietspad Zurenborgbrug,2022-10-18,22:00:00,118,51,67,FMN 06 B Zurenborgbrug Ringfietspad
655,Ringfietspad Zurenborgbrug,2022-10-18,23:00:00,61,27,34,FMN 06 B Zurenborgbrug Ringfietspad
655,Ringfietspad Zurenborgbrug,2022-10-19,00:00:00,18,10,8,FMN 06 B Zurenborgbrug Ringfietspad
655,Ringfietspad Zurenborgbrug,2022-10-19,01:00:00,11,2,9,FMN 06 B Zurenborgbrug Ringfietspad
655,Ringfietspad Zurenborgbrug,2022-10-19,02:00:00,5,2,3,FMN 06 B Zurenborgbrug Ringfietspad
655,Ringfietspad Zurenborgbrug,2022-10-19,03:00:00,6,4,2,FMN 06 B Zurenborgbrug Ringfietspad
655,Ringfietspad Zurenborgbrug,2022-10-19,04:00:00,21,15,6,FMN 06 B Zurenborgbrug Ringfietspad
655,Ringfietspad Zurenborgbrug,2022-10-19,05:00:00,65,38,27,FMN 06 B Zurenborgbrug Ringfietspad
655,Ringfietspad Zurenborgbrug,2022-10-19,06:00:00,142,82,60,FMN 06 B Zurenborgbrug Ringfietspad
655,Ringfietspad Zurenborgbrug,2022-10-19,07:00:00,473,288,185,FMN 06 B Zurenborgbrug Ringfietspad
655,Ringfietspad Zurenborgbrug,2022-10-19,08:00:00,699,394,305,FMN 06 B Zurenborgbrug Ringfietspad
655,Ringfietspad Zurenborgbrug,2022-10-19,09:00:00,203,104,99,FMN 06 B Zurenborgbrug Ringfietspad
655,Ringfietspad Zurenborgbrug,2022-10-19,10:00:00,146,73,73,FMN 06 B Zurenborgbrug Ringfietspad
655,Ringfietspad Zurenborgbrug,2022-10-19,11:00:00,162,65,97,FMN 06 B Zurenborgbrug Ringfietspad
655,Ringfietspad Zurenborgbrug,2022-10-19,12:00:00,408,199,209,FMN 06 B Zurenborgbrug Ringfietspad
655,Ringfietspad Zurenborgbrug,2022-10-19,13:00:00,302,123,179,FMN 06 B Zurenborgbrug Ringfietspad
655,Ringfietspad Zurenborgbrug,2022-10-19,14:00:00,261,127,134,FMN 06 B Zurenborgbrug Ringfietspad
655,Ringfietspad Zurenborgbrug,2022-10-19,15:00:00,284,113,171,FMN 06 B Zurenborgbrug Ringfietspad
655,Ringfietspad Zurenborgbrug,2022-10-19,16:00:00,496,186,310,FMN 06 B Zurenborgbrug Ringfietspad
655,Ringfietspad Zurenborgbrug,2022-10-19,17:00:00,536,203,333,FMN 06 B Zurenborgbrug Ringfietspad
655,Ringfietspad Zurenborgbrug,2022-10-19,18:00:00,384,160,224,FMN 06 B Zurenborgbrug Ringfietspad
655,Ringfietspad Zurenborgbrug,2022-10-19,19:00:00,166,61,105,FMN 06 B Zurenborgbrug Ringfietspad
655,Ringfietspad Zurenborgbrug,2022-10-19,20:00:00,133,50,83,FMN 06 B Zurenborgbrug Ringfietspad
655,Ringfietspad Zurenborgbrug,2022-10-19,21:00:00,98,44,54,FMN 06 B Zurenborgbrug Ringfietspad
655,Ringfietspad Zurenborgbrug,2022-10-19,22:00:00,99,33,66,FMN 06 B Zurenborgbrug Ringfietspad
655,Ringfietspad Zurenborgbrug,2022-10-19,23:00:00,51,33,18,FMN 06 B Zurenborgbrug Ringfietspad
655,Ringfietspad Zurenborgbrug,2022-10-20,00:00:00,23,12,11,FMN 06 B Zurenborgbrug Ringfietspad
655,Ringfietspad Zurenborgbrug,2022-10-20,01:00:00,8,3,5,FMN 06 B Zurenborgbrug Ringfietspad
655,Ringfietspad Zurenborgbrug,2022-10-20,02:00:00,4,3,1,FMN 06 B Zurenborgbrug Ringfietspad
655,Ringfietspad Zurenborgbrug,2022-10-20,03:00:00,3,1,2,FMN 06 B Zurenborgbrug Ringfietspad
655,Ringfietspad Zurenborgbrug,2022-10-20,04:00:00,18,13,5,FMN 06 B Zurenborgbrug Ringfietspad
655,Ringfietspad Zurenborgbrug,2022-10-20,05:00:00,54,30,24,FMN 06 B Zurenborgbrug Ringfietspad
655,Ringfietspad Zurenborgbrug,2022-10-20,06:00:00,130,76,54,FMN 06 B Zurenborgbrug Ringfietspad
655,Ringfietspad Zurenborgbrug,2022-10-20,07:00:00,444,279,165,FMN 06 B Zurenborgbrug Ringfietspad
655,Ringfietspad Zurenborgbrug,2022-10-20,08:00:00,709,419,290,FMN 06 B Zurenborgbrug Ringfietspad
655,Ringfietspad Zurenborgbrug,2022-10-20,09:00:00,206,112,94,FMN 06 B Zurenborgbrug Ringfietspad
655,Ringfietspad Zurenborgbrug,2022-10-20,10:00:00,107,60,47,FMN 06 B Zurenborgbrug Ringfietspad
655,Ringfietspad Zurenborgbrug,2022-10-20,11:00:00,82,42,40,FMN 06 B Zurenborgbrug Ringfietspad
655,Ringfietspad Zurenborgbrug,2022-10-20,12:00:00,134,68,66,FMN 06 B Zurenborgbrug Ringfietspad
655,Ringfietspad Zurenborgbrug,2022-10-20,13:00:00,158,66,92,FMN 06 B Zurenborgbrug Ringfietspad
655,Ringfietspad Zurenborgbrug,2022-10-20,14:00:00,128,42,86,FMN 06 B Zurenborgbrug Ringfietspad
655,Ringfietspad Zurenborgbrug,2022-10-20,15:00:00,276,103,173,FMN 06 B Zurenborgbrug Ringfietspad
655,Ringfietspad Zurenborgbrug,2022-10-20,16:00:00,580,221,359,FMN 06 B Zurenborgbrug Ringfietspad
655,Ringfietspad Zurenborgbrug,2022-10-20,17:00:00,598,194,404,FMN 06 B Zurenborgbrug Ringfietspad
655,Ringfietspad Zurenborgbrug,2022-10-20,18:00:00,336,121,215,FMN 06 B Zurenborgbrug Ringfietspad
655,Ringfietspad Zurenborgbrug,2022-10-20,19:00:00,175,77,98,FMN 06 B Zurenborgbrug Ringfietspad
655,Ringfietspad Zurenborgbrug,2022-10-20,20:00:00,106,54,52,FMN 06 B Zurenborgbrug Ringfietspad
655,Ringfietspad Zurenborgbrug,2022-10-20,21:00:00,161,91,70,FMN 06 B Zurenborgbrug Ringfietspad
655,Ringfietspad Zurenborgbrug,2022-10-20,22:00:00,102,59,43,FMN 06 B Zurenborgbrug Ringfietspad
655,Ringfietspad Zurenborgbrug,2022-10-20,23:00:00,46,25,21,FMN 06 B Zurenborgbrug Ringfietspad
655,Ringfietspad Zurenborgbrug,2022-10-21,00:00:00,14,5,9,FMN 06 B Zurenborgbrug Ringfietspad
655,Ringfietspad Zurenborgbrug,2022-10-21,01:00:00,11,4,7,FMN 06 B Zurenborgbrug Ringfietspad
655,Ringfietspad Zurenborgbrug,2022-10-21,02:00:00,7,3,4,FMN 06 B Zurenborgbrug Ringfietspad
655,Ringfietspad Zurenborgbrug,2022-10-21,03:00:00,5,4,1,FMN 06 B Zurenborgbrug Ringfietspad
655,Ringfietspad Zurenborgbrug,2022-10-21,04:00:00,18,14,4,FMN 06 B Zurenborgbrug Ringfietspad
655,Ringfietspad Zurenborgbrug,2022-10-21,05:00:00,55,26,29,FMN 06 B Zurenborgbrug Ringfietspad
655,Ringfietspad Zurenborgbrug,2022-10-21,06:00:00,130,78,52,FMN 06 B Zurenborgbrug Ringfietspad
655,Ringfietspad Zurenborgbrug,2022-10-21,07:00:00,377,198,179,FMN 06 B Zurenborgbrug Ringfietspad
655,Ringfietspad Zurenborgbrug,2022-10-21,08:00:00,609,343,266,FMN 06 B Zurenborgbrug Ringfietspad
655,Ringfietspad Zurenborgbrug,2022-10-21,09:00:00,152,76,76,FMN 06 B Zurenborgbrug Ringfietspad
655,Ringfietspad Zurenborgbrug,2022-10-21,10:00:00,128,87,41,FMN 06 B Zurenborgbrug Ringfietspad
655,Ringfietspad Zurenborgbrug,2022-10-21,11:00:00,130,65,65,FMN 06 B Zurenborgbrug Ringfietspad
655,Ringfietspad Zurenborgbrug,2022-10-21,12:00:00,186,83,103,FMN 06 B Zurenborgbrug Ringfietspad
655,Ringfietspad Zurenborgbrug,2022-10-21,13:00:00,236,97,139,FMN 06 B Zurenborgbrug Ringfietspad
655,Ringfietspad Zurenborgbrug,2022-10-21,14:00:00,184,75,109,FMN 06 B Zurenborgbrug Ringfietspad
655,Ringfietspad Zurenborgbrug,2022-10-21,15:00:00,329,132,197,FMN 06 B Zurenborgbrug Ringfietspad
655,Ringfietspad Zurenborgbrug,2022-10-21,16:00:00,548,247,301,FMN 06 B Zurenborgbrug Ringfietspad
655,Ringfietspad Zurenborgbrug,2022-10-21,17:00:00,465,178,287,FMN 06 B Zurenborgbrug Ringfietspad
655,Ringfietspad Zurenborgbrug,2022-10-21,18:00:00,322,139,183,FMN 06 B Zurenborgbrug Ringfietspad
655,Ringfietspad Zurenborgbrug,2022-10-21,19:00:00,166,69,97,FMN 06 B Zurenborgbrug Ringfietspad
655,Ringfietspad Zurenborgbrug,2022-10-21,20:00:00,103,38,65,FMN 06 B Zurenborgbrug Ringfietspad
655,Ringfietspad Zurenborgbrug,2022-10-21,21:00:00,85,33,52,FMN 06 B Zurenborgbrug Ringfietspad
655,Ringfietspad Zurenborgbrug,2022-10-21,22:00:00,96,50,46,FMN 06 B Zurenborgbrug Ringfietspad
655,Ringfietspad Zurenborgbrug,2022-10-21,23:00:00,75,31,44,FMN 06 B Zurenborgbrug Ringfietspad
655,Ringfietspad Zurenborgbrug,2022-10-22,00:00:00,52,23,29,FMN 06 B Zurenborgbrug Ringfietspad
655,Ringfietspad Zurenborgbrug,2022-10-22,01:00:00,18,10,8,FMN 06 B Zurenborgbrug Ringfietspad
655,Ringfietspad Zurenborgbrug,2022-10-22,02:00:00,17,12,5,FMN 06 B Zurenborgbrug Ringfietspad
655,Ringfietspad Zurenborgbrug,2022-10-22,03:00:00,11,7,4,FMN 06 B Zurenborgbrug Ringfietspad
655,Ringfietspad Zurenborgbrug,2022-10-22,04:00:00,18,13,5,FMN 06 B Zurenborgbrug Ringfietspad
655,Ringfietspad Zurenborgbrug,2022-10-22,05:00:00,10,6,4,FMN 06 B Zurenborgbrug Ringfietspad
655,Ringfietspad Zurenborgbrug,2022-10-22,06:00:00,32,21,11,FMN 06 B Zurenborgbrug Ringfietspad
655,Ringfietspad Zurenborgbrug,2022-10-22,07:00:00,40,29,11,FMN 06 B Zurenborgbrug Ringfietspad
655,Ringfietspad Zurenborgbrug,2022-10-22,08:00:00,57,29,28,FMN 06 B Zurenborgbrug Ringfietspad
655,Ringfietspad Zurenborgbrug,2022-10-22,09:00:00,126,56,70,FMN 06 B Zurenborgbrug Ringfietspad
655,Ringfietspad Zurenborgbrug,2022-10-22,10:00:00,119,58,61,FMN 06 B Zurenborgbrug Ringfietspad
655,Ringfietspad Zurenborgbrug,2022-10-22,11:00:00,124,63,61,FMN 06 B Zurenborgbrug Ringfietspad
655,Ringfietspad Zurenborgbrug,2022-10-22,12:00:00,144,62,82,FMN 06 B Zurenborgbrug Ringfietspad
655,Ringfietspad Zurenborgbrug,2022-10-22,13:00:00,247,104,143,FMN 06 B Zurenborgbrug Ringfietspad
655,Ringfietspad Zurenborgbrug,2022-10-22,14:00:00,215,98,117,FMN 06 B Zurenborgbrug Ringfietspad
655,Ringfietspad Zurenborgbrug,2022-10-22,15:00:00,185,81,104,FMN 06 B Zurenborgbrug Ringfietspad
655,Ringfietspad Zurenborgbrug,2022-10-22,16:00:00,197,108,89,FMN 06 B Zurenborgbrug Ringfietspad
655,Ringfietspad Zurenborgbrug,2022-10-22,17:00:00,213,99,114,FMN 06 B Zurenborgbrug Ringfietspad
655,Ringfietspad Zurenborgbrug,2022-10-22,18:00:00,153,66,87,FMN 06 B Zurenborgbrug Ringfietspad
655,Ringfietspad Zurenborgbrug,2022-10-22,19:00:00,117,50,67,FMN 06 B Zurenborgbrug Ringfietspad
655,Ringfietspad Zurenborgbrug,2022-10-22,20:00:00,79,36,43,FMN 06 B Zurenborgbrug Ringfietspad
655,Ringfietspad Zurenborgbrug,2022-10-22,21:00:00,70,25,45,FMN 06 B Zurenborgbrug Ringfietspad
655,Ringfietspad Zurenborgbrug,2022-10-22,22:00:00,59,28,31,FMN 06 B Zurenborgbrug Ringfietspad
655,Ringfietspad Zurenborgbrug,2022-10-22,23:00:00,45,27,18,FMN 06 B Zurenborgbrug Ringfietspad
655,Ringfietspad Zurenborgbrug,2022-10-23,00:00:00,49,34,15,FMN 06 B Zurenborgbrug Ringfietspad
655,Ringfietspad Zurenborgbrug,2022-10-23,01:00:00,28,10,18,FMN 06 B Zurenborgbrug Ringfietspad
655,Ringfietspad Zurenborgbrug,2022-10-23,02:00:00,28,15,13,FMN 06 B Zurenborgbrug Ringfietspad
655,Ringfietspad Zurenborgbrug,2022-10-23,03:00:00,8,4,4,FMN 06 B Zurenborgbrug Ringfietspad
655,Ringfietspad Zurenborgbrug,2022-10-23,04:00:00,7,4,3,FMN 06 B Zurenborgbrug Ringfietspad
655,Ringfietspad Zurenborgbrug,2022-10-23,05:00:00,11,5,6,FMN 06 B Zurenborgbrug Ringfietspad
655,Ringfietspad Zurenborgbrug,2022-10-23,06:00:00,21,11,10,FMN 06 B Zurenborgbrug Ringfietspad
655,Ringfietspad Zurenborgbrug,2022-10-23,07:00:00,23,13,10,FMN 06 B Zurenborgbrug Ringfietspad
655,Ringfietspad Zurenborgbrug,2022-10-23,08:00:00,57,26,31,FMN 06 B Zurenborgbrug Ringfietspad
655,Ringfietspad Zurenborgbrug,2022-10-23,09:00:00,124,58,66,FMN 06 B Zurenborgbrug Ringfietspad
655,Ringfietspad Zurenborgbrug,2022-10-23,10:00:00,114,58,56,FMN 06 B Zurenborgbrug Ringfietspad
655,Ringfietspad Zurenborgbrug,2022-10-23,11:00:00,131,46,85,FMN 06 B Zurenborgbrug Ringfietspad
655,Ringfietspad Zurenborgbrug,2022-10-23,12:00:00,261,89,172,FMN 06 B Zurenborgbrug Ringfietspad
655,Ringfietspad Zurenborgbrug,2022-10-23,13:00:00,174,72,102,FMN 06 B Zurenborgbrug Ringfietspad
655,Ringfietspad Zurenborgbrug,2022-10-23,14:00:00,166,74,92,FMN 06 B Zurenborgbrug Ringfietspad
655,Ringfietspad Zurenborgbrug,2022-10-23,15:00:00,207,134,73,FMN 06 B Zurenborgbrug Ringfietspad
655,Ringfietspad Zurenborgbrug,2022-10-23,16:00:00,213,137,76,FMN 06 B Zurenborgbrug Ringfietspad
655,Ringfietspad Zurenborgbrug,2022-10-23,17:00:00,172,88,84,FMN 06 B Zurenborgbrug Ringfietspad
655,Ringfietspad Zurenborgbrug,2022-10-23,18:00:00,128,61,67,FMN 06 B Zurenborgbrug Ringfietspad
655,Ringfietspad Zurenborgbrug,2022-10-23,19:00:00,78,31,47,FMN 06 B Zurenborgbrug Ringfietspad
655,Ringfietspad Zurenborgbrug,2022-10-23,20:00:00,46,25,21,FMN 06 B Zurenborgbrug Ringfietspad
655,Ringfietspad Zurenborgbrug,2022-10-23,21:00:00,32,13,19,FMN 06 B Zurenborgbrug Ringfietspad
655,Ringfietspad Zurenborgbrug,2022-10-23,22:00:00,27,13,14,FMN 06 B Zurenborgbrug Ringfietspad
655,Ringfietspad Zurenborgbrug,2022-10-23,23:00:00,22,13,9,FMN 06 B Zurenborgbrug Ringfietspad
655,Ringfietspad Zurenborgbrug,2022-10-24,00:00:00,10,4,6,FMN 06 B Zurenborgbrug Ringfietspad
655,Ringfietspad Zurenborgbrug,2022-10-24,01:00:00,4,2,2,FMN 06 B Zurenborgbrug Ringfietspad
655,Ringfietspad Zurenborgbrug,2022-10-24,02:00:00,2,1,1,FMN 06 B Zurenborgbrug Ringfietspad
655,Ringfietspad Zurenborgbrug,2022-10-24,03:00:00,1,1,0,FMN 06 B Zurenborgbrug Ringfietspad
655,Ringfietspad Zurenborgbrug,2022-10-24,04:00:00,17,9,8,FMN 06 B Zurenborgbrug Ringfietspad
655,Ringfietspad Zurenborgbrug,2022-10-24,05:00:00,59,33,26,FMN 06 B Zurenborgbrug Ringfietspad
655,Ringfietspad Zurenborgbrug,2022-10-24,06:00:00,125,76,49,FMN 06 B Zurenborgbrug Ringfietspad
655,Ringfietspad Zurenborgbrug,2022-10-24,07:00:00,434,245,189,FMN 06 B Zurenborgbrug Ringfietspad
655,Ringfietspad Zurenborgbrug,2022-10-24,08:00:00,674,387,287,FMN 06 B Zurenborgbrug Ringfietspad
655,Ringfietspad Zurenborgbrug,2022-10-24,09:00:00,202,95,107,FMN 06 B Zurenborgbrug Ringfietspad
655,Ringfietspad Zurenborgbrug,2022-10-24,10:00:00,129,59,70,FMN 06 B Zurenborgbrug Ringfietspad
655,Ringfietspad Zurenborgbrug,2022-10-24,11:00:00,102,48,54,FMN 06 B Zurenborgbrug Ringfietspad
655,Ringfietspad Zurenborgbrug,2022-10-24,12:00:00,187,105,82,FMN 06 B Zurenborgbrug Ringfietspad
655,Ringfietspad Zurenborgbrug,2022-10-24,13:00:00,187,87,100,FMN 06 B Zurenborgbrug Ringfietspad
655,Ringfietspad Zurenborgbrug,2022-10-24,14:00:00,140,54,86,FMN 06 B Zurenborgbrug Ringfietspad
655,Ringfietspad Zurenborgbrug,2022-10-24,15:00:00,299,116,183,FMN 06 B Zurenborgbrug Ringfietspad
655,Ringfietspad Zurenborgbrug,2022-10-24,16:00:00,523,226,297,FMN 06 B Zurenborgbrug Ringfietspad
655,Ringfietspad Zurenborgbrug,2022-10-24,17:00:00,518,191,327,FMN 06 B Zurenborgbrug Ringfietspad
655,Ringfietspad Zurenborgbrug,2022-10-24,18:00:00,321,112,209,FMN 06 B Zurenborgbrug Ringfietspad
655,Ringfietspad Zurenborgbrug,2022-10-24,19:00:00,138,41,97,FMN 06 B Zurenborgbrug Ringfietspad
655,Ringfietspad Zurenborgbrug,2022-10-24,20:00:00,100,43,57,FMN 06 B Zurenborgbrug Ringfietspad
655,Ringfietspad Zurenborgbrug,2022-10-24,21:00:00,75,24,51,FMN 06 B Zurenborgbrug Ringfietspad
655,Ringfietspad Zurenborgbrug,2022-10-24,22:00:00,75,25,50,FMN 06 B Zurenborgbrug Ringfietspad
655,Ringfietspad Zurenborgbrug,2022-10-24,23:00:00,31,13,18,FMN 06 B Zurenborgbrug Ringfietspad
655,Ringfietspad Zurenborgbrug,2022-10-25,00:00:00,15,7,8,FMN 06 B Zurenborgbrug Ringfietspad
655,Ringfietspad Zurenborgbrug,2022-10-25,01:00:00,7,2,5,FMN 06 B Zurenborgbrug Ringfietspad
655,Ringfietspad Zurenborgbrug,2022-10-25,02:00:00,1,1,0,FMN 06 B Zurenborgbrug Ringfietspad
655,Ringfietspad Zurenborgbrug,2022-10-25,03:00:00,3,2,1,FMN 06 B Zurenborgbrug Ringfietspad
655,Ringfietspad Zurenborgbrug,2022-10-25,04:00:00,20,12,8,FMN 06 B Zurenborgbrug Ringfietspad
655,Ringfietspad Zurenborgbrug,2022-10-25,05:00:00,63,35,28,FMN 06 B Zurenborgbrug Ringfietspad
655,Ringfietspad Zurenborgbrug,2022-10-25,06:00:00,149,87,62,FMN 06 B Zurenborgbrug Ringfietspad
655,Ringfietspad Zurenborgbrug,2022-10-25,07:00:00,547,333,214,FMN 06 B Zurenborgbrug Ringfietspad
655,Ringfietspad Zurenborgbrug,2022-10-25,08:00:00,742,437,305,FMN 06 B Zurenborgbrug Ringfietspad
655,Ringfietspad Zurenborgbrug,2022-10-25,09:00:00,233,135,98,FMN 06 B Zurenborgbrug Ringfietspad
655,Ringfietspad Zurenborgbrug,2022-10-25,10:00:00,140,75,65,FMN 06 B Zurenborgbrug Ringfietspad
655,Ringfietspad Zurenborgbrug,2022-10-25,11:00:00,115,56,59,FMN 06 B Zurenborgbrug Ringfietspad
655,Ringfietspad Zurenborgbrug,2022-10-25,12:00:00,189,101,88,FMN 06 B Zurenborgbrug Ringfietspad
655,Ringfietspad Zurenborgbrug,2022-10-25,13:00:00,225,103,122,FMN 06 B Zurenborgbrug Ringfietspad
655,Ringfietspad Zurenborgbrug,2022-10-25,14:00:00,219,76,143,FMN 06 B Zurenborgbrug Ringfietspad
655,Ringfietspad Zurenborgbrug,2022-10-25,15:00:00,352,140,212,FMN 06 B Zurenborgbrug Ringfietspad
655,Ringfietspad Zurenborgbrug,2022-10-25,16:00:00,631,258,373,FMN 06 B Zurenborgbrug Ringfietspad
655,Ringfietspad Zurenborgbrug,2022-10-25,17:00:00,606,217,389,FMN 06 B Zurenborgbrug Ringfietspad
655,Ringfietspad Zurenborgbrug,2022-10-25,18:00:00,399,136,263,FMN 06 B Zurenborgbrug Ringfietspad
655,Ringfietspad Zurenborgbrug,2022-10-25,19:00:00,207,84,123,FMN 06 B Zurenborgbrug Ringfietspad
655,Ringfietspad Zurenborgbrug,2022-10-25,20:00:00,117,58,59,FMN 06 B Zurenborgbrug Ringfietspad
655,Ringfietspad Zurenborgbrug,2022-10-25,21:00:00,93,21,72,FMN 06 B Zurenborgbrug Ringfietspad
655,Ringfietspad Zurenborgbrug,2022-10-25,22:00:00,96,31,65,FMN 06 B Zurenborgbrug Ringfietspad
655,Ringfietspad Zurenborgbrug,2022-10-25,23:00:00,36,9,27,FMN 06 B Zurenborgbrug Ringfietspad
655,Ringfietspad Zurenborgbrug,2022-10-26,00:00:00,11,3,8,FMN 06 B Zurenborgbrug Ringfietspad
655,Ringfietspad Zurenborgbrug,2022-10-26,01:00:00,11,4,7,FMN 06 B Zurenborgbrug Ringfietspad
655,Ringfietspad Zurenborgbrug,2022-10-26,02:00:00,0,0,0,FMN 06 B Zurenborgbrug Ringfietspad
655,Ringfietspad Zurenborgbrug,2022-10-26,03:00:00,5,3,2,FMN 06 B Zurenborgbrug Ringfietspad
655,Ringfietspad Zurenborgbrug,2022-10-26,04:00:00,21,11,10,FMN 06 B Zurenborgbrug Ringfietspad
655,Ringfietspad Zurenborgbrug,2022-10-26,05:00:00,64,35,29,FMN 06 B Zurenborgbrug Ringfietspad
655,Ringfietspad Zurenborgbrug,2022-10-26,06:00:00,162,87,75,FMN 06 B Zurenborgbrug Ringfietspad
655,Ringfietspad Zurenborgbrug,2022-10-26,07:00:00,493,301,192,FMN 06 B Zurenborgbrug Ringfietspad
655,Ringfietspad Zurenborgbrug,2022-10-26,08:00:00,599,340,259,FMN 06 B Zurenborgbrug Ringfietspad
655,Ringfietspad Zurenborgbrug,2022-10-26,09:00:00,198,106,92,FMN 06 B Zurenborgbrug Ringfietspad
655,Ringfietspad Zurenborgbrug,2022-10-26,10:00:00,178,117,61,FMN 06 B Zurenborgbrug Ringfietspad
655,Ringfietspad Zurenborgbrug,2022-10-26,11:00:00,150,82,68,FMN 06 B Zurenborgbrug Ringfietspad
655,Ringfietspad Zurenborgbrug,2022-10-26,12:00:00,388,195,193,FMN 06 B Zurenborgbrug Ringfietspad
655,Ringfietspad Zurenborgbrug,2022-10-26,13:00:00,308,138,170,FMN 06 B Zurenborgbrug Ringfietspad
655,Ringfietspad Zurenborgbrug,2022-10-26,14:00:00,246,101,145,FMN 06 B Zurenborgbrug Ringfietspad
655,Ringfietspad Zurenborgbrug,2022-10-26,15:00:00,276,91,185,FMN 06 B Zurenborgbrug Ringfietspad
655,Ringfietspad Zurenborgbrug,2022-10-26,16:00:00,520,201,319,FMN 06 B Zurenborgbrug Ringfietspad
655,Ringfietspad Zurenborgbrug,2022-10-26,17:00:00,528,203,325,FMN 06 B Zurenborgbrug Ringfietspad
655,Ringfietspad Zurenborgbrug,2022-10-26,18:00:00,367,143,224,FMN 06 B Zurenborgbrug Ringfietspad
655,Ringfietspad Zurenborgbrug,2022-10-26,19:00:00,164,77,87,FMN 06 B Zurenborgbrug Ringfietspad
655,Ringfietspad Zurenborgbrug,2022-10-26,20:00:00,124,54,70,FMN 06 B Zurenborgbrug Ringfietspad
655,Ringfietspad Zurenborgbrug,2022-10-26,21:00:00,106,48,58,FMN 06 B Zurenborgbrug Ringfietspad
655,Ringfietspad Zurenborgbrug,2022-10-26,22:00:00,108,42,66,FMN 06 B Zurenborgbrug Ringfietspad
655,Ringfietspad Zurenborgbrug,2022-10-26,23:00:00,59,30,29,FMN 06 B Zurenborgbrug Ringfietspad
655,Ringfietspad Zurenborgbrug,2022-10-27,00:00:00,21,16,5,FMN 06 B Zurenborgbrug Ringfietspad
655,Ringfietspad Zurenborgbrug,2022-10-27,01:00:00,9,6,3,FMN 06 B Zurenborgbrug Ringfietspad
655,Ringfietspad Zurenborgbrug,2022-10-27,02:00:00,6,1,5,FMN 06 B Zurenborgbrug Ringfietspad
655,Ringfietspad Zurenborgbrug,2022-10-27,03:00:00,6,4,2,FMN 06 B Zurenborgbrug Ringfietspad
655,Ringfietspad Zurenborgbrug,2022-10-27,04:00:00,24,13,11,FMN 06 B Zurenborgbrug Ringfietspad
655,Ringfietspad Zurenborgbrug,2022-10-27,05:00:00,67,41,26,FMN 06 B Zurenborgbrug Ringfietspad
655,Ringfietspad Zurenborgbrug,2022-10-27,06:00:00,176,114,62,FMN 06 B Zurenborgbrug Ringfietspad
655,Ringfietspad Zurenborgbrug,2022-10-27,07:00:00,536,333,203,FMN 06 B Zurenborgbrug Ringfietspad
655,Ringfietspad Zurenborgbrug,2022-10-27,08:00:00,718,425,293,FMN 06 B Zurenborgbrug Ringfietspad
655,Ringfietspad Zurenborgbrug,2022-10-27,09:00:00,210,116,94,FMN 06 B Zurenborgbrug Ringfietspad
655,Ringfietspad Zurenborgbrug,2022-10-27,10:00:00,106,59,47,FMN 06 B Zurenborgbrug Ringfietspad
655,Ringfietspad Zurenborgbrug,2022-10-27,11:00:00,126,56,70,FMN 06 B Zurenborgbrug Ringfietspad
655,Ringfietspad Zurenborgbrug,2022-10-27,12:00:00,211,113,98,FMN 06 B Zurenborgbrug Ringfietspad
655,Ringfietspad Zurenborgbrug,2022-10-27,13:00:00,204,101,103,FMN 06 B Zurenborgbrug Ringfietspad
655,Ringfietspad Zurenborgbrug,2022-10-27,14:00:00,183,82,101,FMN 06 B Zurenborgbrug Ringfietspad
655,Ringfietspad Zurenborgbrug,2022-10-27,15:00:00,372,130,242,FMN 06 B Zurenborgbrug Ringfietspad
655,Ringfietspad Zurenborgbrug,2022-10-27,16:00:00,607,244,363,FMN 06 B Zurenborgbrug Ringfietspad
655,Ringfietspad Zurenborgbrug,2022-10-27,17:00:00,580,205,375,FMN 06 B Zurenborgbrug Ringfietspad
655,Ringfietspad Zurenborgbrug,2022-10-27,18:00:00,402,144,258,FMN 06 B Zurenborgbrug Ringfietspad
655,Ringfietspad Zurenborgbrug,2022-10-27,19:00:00,203,80,123,FMN 06 B Zurenborgbrug Ringfietspad
655,Ringfietspad Zurenborgbrug,2022-10-27,20:00:00,133,57,76,FMN 06 B Zurenborgbrug Ringfietspad
655,Ringfietspad Zurenborgbrug,2022-10-27,21:00:00,74,31,43,FMN 06 B Zurenborgbrug Ringfietspad
655,Ringfietspad Zurenborgbrug,2022-10-27,22:00:00,97,43,54,FMN 06 B Zurenborgbrug Ringfietspad
655,Ringfietspad Zurenborgbrug,2022-10-27,23:00:00,66,26,40,FMN 06 B Zurenborgbrug Ringfietspad
655,Ringfietspad Zurenborgbrug,2022-10-28,00:00:00,21,10,11,FMN 06 B Zurenborgbrug Ringfietspad
655,Ringfietspad Zurenborgbrug,2022-10-28,01:00:00,20,7,13,FMN 06 B Zurenborgbrug Ringfietspad
655,Ringfietspad Zurenborgbrug,2022-10-28,02:00:00,3,1,2,FMN 06 B Zurenborgbrug Ringfietspad
655,Ringfietspad Zurenborgbrug,2022-10-28,03:00:00,3,3,0,FMN 06 B Zurenborgbrug Ringfietspad
655,Ringfietspad Zurenborgbrug,2022-10-28,04:00:00,15,10,5,FMN 06 B Zurenborgbrug Ringfietspad
655,Ringfietspad Zurenborgbrug,2022-10-28,05:00:00,52,33,19,FMN 06 B Zurenborgbrug Ringfietspad
655,Ringfietspad Zurenborgbrug,2022-10-28,06:00:00,143,77,66,FMN 06 B Zurenborgbrug Ringfietspad
655,Ringfietspad Zurenborgbrug,2022-10-28,07:00:00,407,233,174,FMN 06 B Zurenborgbrug Ringfietspad
655,Ringfietspad Zurenborgbrug,2022-10-28,08:00:00,607,334,273,FMN 06 B Zurenborgbrug Ringfietspad
655,Ringfietspad Zurenborgbrug,2022-10-28,09:00:00,192,114,78,FMN 06 B Zurenborgbrug Ringfietspad
655,Ringfietspad Zurenborgbrug,2022-10-28,10:00:00,144,80,64,FMN 06 B Zurenborgbrug Ringfietspad
655,Ringfietspad Zurenborgbrug,2022-10-28,11:00:00,144,82,62,FMN 06 B Zurenborgbrug Ringfietspad
655,Ringfietspad Zurenborgbrug,2022-10-28,12:00:00,238,105,133,FMN 06 B Zurenborgbrug Ringfietspad
655,Ringfietspad Zurenborgbrug,2022-10-28,13:00:00,230,106,124,FMN 06 B Zurenborgbrug Ringfietspad
655,Ringfietspad Zurenborgbrug,2022-10-28,14:00:00,241,115,126,FMN 06 B Zurenborgbrug Ringfietspad
655,Ringfietspad Zurenborgbrug,2022-10-28,15:00:00,383,134,249,FMN 06 B Zurenborgbrug Ringfietspad
655,Ringfietspad Zurenborgbrug,2022-10-28,16:00:00,535,231,304,FMN 06 B Zurenborgbrug Ringfietspad
655,Ringfietspad Zurenborgbrug,2022-10-28,17:00:00,475,178,297,FMN 06 B Zurenborgbrug Ringfietspad
655,Ringfietspad Zurenborgbrug,2022-10-28,18:00:00,300,108,192,FMN 06 B Zurenborgbrug Ringfietspad
655,Ringfietspad Zurenborgbrug,2022-10-28,19:00:00,211,65,146,FMN 06 B Zurenborgbrug Ringfietspad
655,Ringfietspad Zurenborgbrug,2022-10-28,20:00:00,171,69,102,FMN 06 B Zurenborgbrug Ringfietspad
655,Ringfietspad Zurenborgbrug,2022-10-28,21:00:00,100,45,55,FMN 06 B Zurenborgbrug Ringfietspad
655,Ringfietspad Zurenborgbrug,2022-10-28,22:00:00,66,31,35,FMN 06 B Zurenborgbrug Ringfietspad
655,Ringfietspad Zurenborgbrug,2022-10-28,23:00:00,105,70,35,FMN 06 B Zurenborgbrug Ringfietspad
655,Ringfietspad Zurenborgbrug,2022-10-29,00:00:00,47,32,15,FMN 06 B Zurenborgbrug Ringfietspad
655,Ringfietspad Zurenborgbrug,2022-10-29,01:00:00,27,10,17,FMN 06 B Zurenborgbrug Ringfietspad
655,Ringfietspad Zurenborgbrug,2022-10-29,02:00:00,21,14,7,FMN 06 B Zurenborgbrug Ringfietspad
655,Ringfietspad Zurenborgbrug,2022-10-29,03:00:00,9,6,3,FMN 06 B Zurenborgbrug Ringfietspad
655,Ringfietspad Zurenborgbrug,2022-10-29,04:00:00,12,6,6,FMN 06 B Zurenborgbrug Ringfietspad
655,Ringfietspad Zurenborgbrug,2022-10-29,05:00:00,18,11,7,FMN 06 B Zurenborgbrug Ringfietspad
655,Ringfietspad Zurenborgbrug,2022-10-29,06:00:00,23,16,7,FMN 06 B Zurenborgbrug Ringfietspad
655,Ringfietspad Zurenborgbrug,2022-10-29,07:00:00,43,24,19,FMN 06 B Zurenborgbrug Ringfietspad
655,Ringfietspad Zurenborgbrug,2022-10-29,08:00:00,55,29,26,FMN 06 B Zurenborgbrug Ringfietspad
655,Ringfietspad Zurenborgbrug,2022-10-29,09:00:00,99,39,60,FMN 06 B Zurenborgbrug Ringfietspad
655,Ringfietspad Zurenborgbrug,2022-10-29,10:00:00,123,49,74,FMN 06 B Zurenborgbrug Ringfietspad
655,Ringfietspad Zurenborgbrug,2022-10-29,11:00:00,192,104,88,FMN 06 B Zurenborgbrug Ringfietspad
655,Ringfietspad Zurenborgbrug,2022-10-29,12:00:00,181,90,91,FMN 06 B Zurenborgbrug Ringfietspad
655,Ringfietspad Zurenborgbrug,2022-10-29,13:00:00,209,117,92,FMN 06 B Zurenborgbrug Ringfietspad
655,Ringfietspad Zurenborgbrug,2022-10-29,14:00:00,260,120,140,FMN 06 B Zurenborgbrug Ringfietspad
655,Ringfietspad Zurenborgbrug,2022-10-29,15:00:00,225,103,122,FMN 06 B Zurenborgbrug Ringfietspad
655,Ringfietspad Zurenborgbrug,2022-10-29,16:00:00,207,104,103,FMN 06 B Zurenborgbrug Ringfietspad
655,Ringfietspad Zurenborgbrug,2022-10-29,17:00:00,198,83,115,FMN 06 B Zurenborgbrug Ringfietspad
655,Ringfietspad Zurenborgbrug,2022-10-29,18:00:00,197,103,94,FMN 06 B Zurenborgbrug Ringfietspad
655,Ringfietspad Zurenborgbrug,2022-10-29,19:00:00,150,48,102,FMN 06 B Zurenborgbrug Ringfietspad
655,Ringfietspad Zurenborgbrug,2022-10-29,20:00:00,101,35,66,FMN 06 B Zurenborgbrug Ringfietspad
655,Ringfietspad Zurenborgbrug,2022-10-29,21:00:00,55,24,31,FMN 06 B Zurenborgbrug Ringfietspad
655,Ringfietspad Zurenborgbrug,2022-10-29,22:00:00,91,51,40,FMN 06 B Zurenborgbrug Ringfietspad
655,Ringfietspad Zurenborgbrug,2022-10-29,23:00:00,93,57,36,FMN 06 B Zurenborgbrug Ringfietspad
655,Ringfietspad Zurenborgbrug,2022-10-30,00:00:00,49,28,21,FMN 06 B Zurenborgbrug Ringfietspad
655,Ringfietspad Zurenborgbrug,2022-10-30,01:00:00,32,15,17,FMN 06 B Zurenborgbrug Ringfietspad
655,Ringfietspad Zurenborgbrug,2022-10-30,02:00:00,35,16,19,FMN 06 B Zurenborgbrug Ringfietspad
655,Ringfietspad Zurenborgbrug,2022-10-30,03:00:00,7,2,5,FMN 06 B Zurenborgbrug Ringfietspad
655,Ringfietspad Zurenborgbrug,2022-10-30,04:00:00,9,3,6,FMN 06 B Zurenborgbrug Ringfietspad
655,Ringfietspad Zurenborgbrug,2022-10-30,05:00:00,15,9,6,FMN 06 B Zurenborgbrug Ringfietspad
655,Ringfietspad Zurenborgbrug,2022-10-30,06:00:00,12,5,7,FMN 06 B Zurenborgbrug Ringfietspad
655,Ringfietspad Zurenborgbrug,2022-10-30,07:00:00,32,15,17,FMN 06 B Zurenborgbrug Ringfietspad
655,Ringfietspad Zurenborgbrug,2022-10-30,08:00:00,50,21,29,FMN 06 B Zurenborgbrug Ringfietspad
655,Ringfietspad Zurenborgbrug,2022-10-30,09:00:00,144,46,98,FMN 06 B Zurenborgbrug Ringfietspad
655,Ringfietspad Zurenborgbrug,2022-10-30,10:00:00,149,66,83,FMN 06 B Zurenborgbrug Ringfietspad
655,Ringfietspad Zurenborgbrug,2022-10-30,11:00:00,170,73,97,FMN 06 B Zurenborgbrug Ringfietspad
655,Ringfietspad Zurenborgbrug,2022-10-30,12:00:00,181,93,88,FMN 06 B Zurenborgbrug Ringfietspad
655,Ringfietspad Zurenborgbrug,2022-10-30,13:00:00,233,116,117,FMN 06 B Zurenborgbrug Ringfietspad
655,Ringfietspad Zurenborgbrug,2022-10-30,14:00:00,240,132,108,FMN 06 B Zurenborgbrug Ringfietspad
655,Ringfietspad Zurenborgbrug,2022-10-30,15:00:00,256,133,123,FMN 06 B Zurenborgbrug Ringfietspad
655,Ringfietspad Zurenborgbrug,2022-10-30,16:00:00,234,106,128,FMN 06 B Zurenborgbrug Ringfietspad
655,Ringfietspad Zurenborgbrug,2022-10-30,17:00:00,157,63,94,FMN 06 B Zurenborgbrug Ringfietspad
655,Ringfietspad Zurenborgbrug,2022-10-30,18:00:00,110,46,64,FMN 06 B Zurenborgbrug Ringfietspad
655,Ringfietspad Zurenborgbrug,2022-10-30,19:00:00,73,34,39,FMN 06 B Zurenborgbrug Ringfietspad
655,Ringfietspad Zurenborgbrug,2022-10-30,20:00:00,83,41,42,FMN 06 B Zurenborgbrug Ringfietspad
655,Ringfietspad Zurenborgbrug,2022-10-30,21:00:00,46,25,21,FMN 06 B Zurenborgbrug Ringfietspad
655,Ringfietspad Zurenborgbrug,2022-10-30,22:00:00,53,27,26,FMN 06 B Zurenborgbrug Ringfietspad
655,Ringfietspad Zurenborgbrug,2022-10-30,23:00:00,30,21,9,FMN 06 B Zurenborgbrug Ringfietspad
655,Ringfietspad Zurenborgbrug,2022-10-31,00:00:00,6,4,2,FMN 06 B Zurenborgbrug Ringfietspad
655,Ringfietspad Zurenborgbrug,2022-10-31,01:00:00,11,4,7,FMN 06 B Zurenborgbrug Ringfietspad
655,Ringfietspad Zurenborgbrug,2022-10-31,02:00:00,9,8,1,FMN 06 B Zurenborgbrug Ringfietspad
655,Ringfietspad Zurenborgbrug,2022-10-31,03:00:00,3,0,3,FMN 06 B Zurenborgbrug Ringfietspad
655,Ringfietspad Zurenborgbrug,2022-10-31,04:00:00,11,6,5,FMN 06 B Zurenborgbrug Ringfietspad
655,Ringfietspad Zurenborgbrug,2022-10-31,05:00:00,38,22,16,FMN 06 B Zurenborgbrug Ringfietspad
655,Ringfietspad Zurenborgbrug,2022-10-31,06:00:00,62,40,22,FMN 06 B Zurenborgbrug Ringfietspad
655,Ringfietspad Zurenborgbrug,2022-10-31,07:00:00,138,83,55,FMN 06 B Zurenborgbrug Ringfietspad
655,Ringfietspad Zurenborgbrug,2022-10-31,08:00:00,161,83,78,FMN 06 B Zurenborgbrug Ringfietspad
655,Ringfietspad Zurenborgbrug,2022-10-31,09:00:00,98,54,44,FMN 06 B Zurenborgbrug Ringfietspad
655,Ringfietspad Zurenborgbrug,2022-10-31,10:00:00,71,35,36,FMN 06 B Zurenborgbrug Ringfietspad
655,Ringfietspad Zurenborgbrug,2022-10-31,11:00:00,87,38,49,FMN 06 B Zurenborgbrug Ringfietspad
655,Ringfietspad Zurenborgbrug,2022-10-31,12:00:00,116,62,54,FMN 06 B Zurenborgbrug Ringfietspad
655,Ringfietspad Zurenborgbrug,2022-10-31,13:00:00,132,57,75,FMN 06 B Zurenborgbrug Ringfietspad
655,Ringfietspad Zurenborgbrug,2022-10-31,14:00:00,155,82,73,FMN 06 B Zurenborgbrug Ringfietspad
655,Ringfietspad Zurenborgbrug,2022-10-31,15:00:00,188,80,108,FMN 06 B Zurenborgbrug Ringfietspad
655,Ringfietspad Zurenborgbrug,2022-10-31,16:00:00,228,96,132,FMN 06 B Zurenborgbrug Ringfietspad
655,Ringfietspad Zurenborgbrug,2022-10-31,17:00:00,212,89,123,FMN 06 B Zurenborgbrug Ringfietspad
655,Ringfietspad Zurenborgbrug,2022-10-31,18:00:00,140,54,86,FMN 06 B Zurenborgbrug Ringfietspad
655,Ringfietspad Zurenborgbrug,2022-10-31,19:00:00,110,37,73,FMN 06 B Zurenborgbrug Ringfietspad
655,Ringfietspad Zurenborgbrug,2022-10-31,20:00:00,82,37,45,FMN 06 B Zurenborgbrug Ringfietspad
655,Ringfietspad Zurenborgbrug,2022-10-31,21:00:00,55,23,32,FMN 06 B Zurenborgbrug Ringfietspad
655,Ringfietspad Zurenborgbrug,2022-10-31,22:00:00,51,18,33,FMN 06 B Zurenborgbrug Ringfietspad
655,Ringfietspad Zurenborgbrug,2022-10-31,23:00:00,30,12,18,FMN 06 B Zurenborgbrug Ringfietspad
655,Ringfietspad Zurenborgbrug,2022-11-01,00:00:00,14,5,9,FMN 06 B Zurenborgbrug Ringfietspad
655,Ringfietspad Zurenborgbrug,2022-11-01,01:00:00,17,10,7,FMN 06 B Zurenborgbrug Ringfietspad
655,Ringfietspad Zurenborgbrug,2022-11-01,02:00:00,9,2,7,FMN 06 B Zurenborgbrug Ringfietspad
655,Ringfietspad Zurenborgbrug,2022-11-01,03:00:00,8,2,6,FMN 06 B Zurenborgbrug Ringfietspad
655,Ringfietspad Zurenborgbrug,2022-11-01,04:00:00,6,5,1,FMN 06 B Zurenborgbrug Ringfietspad
655,Ringfietspad Zurenborgbrug,2022-11-01,05:00:00,18,9,9,FMN 06 B Zurenborgbrug Ringfietspad
655,Ringfietspad Zurenborgbrug,2022-11-01,06:00:00,20,10,10,FMN 06 B Zurenborgbrug Ringfietspad
655,Ringfietspad Zurenborgbrug,2022-11-01,07:00:00,24,14,10,FMN 06 B Zurenborgbrug Ringfietspad
655,Ringfietspad Zurenborgbrug,2022-11-01,08:00:00,40,22,18,FMN 06 B Zurenborgbrug Ringfietspad
655,Ringfietspad Zurenborgbrug,2022-11-01,09:00:00,82,39,43,FMN 06 B Zurenborgbrug Ringfietspad
655,Ringfietspad Zurenborgbrug,2022-11-01,10:00:00,94,49,45,FMN 06 B Zurenborgbrug Ringfietspad
655,Ringfietspad Zurenborgbrug,2022-11-01,11:00:00,105,49,56,FMN 06 B Zurenborgbrug Ringfietspad
655,Ringfietspad Zurenborgbrug,2022-11-01,12:00:00,134,70,64,FMN 06 B Zurenborgbrug Ringfietspad
655,Ringfietspad Zurenborgbrug,2022-11-01,13:00:00,142,61,81,FMN 06 B Zurenborgbrug Ringfietspad
655,Ringfietspad Zurenborgbrug,2022-11-01,14:00:00,161,76,85,FMN 06 B Zurenborgbrug Ringfietspad
655,Ringfietspad Zurenborgbrug,2022-11-01,15:00:00,142,67,75,FMN 06 B Zurenborgbrug Ringfietspad
655,Ringfietspad Zurenborgbrug,2022-11-01,16:00:00,146,62,84,FMN 06 B Zurenborgbrug Ringfietspad
655,Ringfietspad Zurenborgbrug,2022-11-01,17:00:00,141,67,74,FMN 06 B Zurenborgbrug Ringfietspad
655,Ringfietspad Zurenborgbrug,2022-11-01,18:00:00,91,34,57,FMN 06 B Zurenborgbrug Ringfietspad
655,Ringfietspad Zurenborgbrug,2022-11-01,19:00:00,58,14,44,FMN 06 B Zurenborgbrug Ringfietspad
655,Ringfietspad Zurenborgbrug,2022-11-01,20:00:00,79,32,47,FMN 06 B Zurenborgbrug Ringfietspad
655,Ringfietspad Zurenborgbrug,2022-11-01,21:00:00,26,15,11,FMN 06 B Zurenborgbrug Ringfietspad
655,Ringfietspad Zurenborgbrug,2022-11-01,22:00:00,47,29,18,FMN 06 B Zurenborgbrug Ringfietspad
655,Ringfietspad Zurenborgbrug,2022-11-01,23:00:00,34,17,17,FMN 06 B Zurenborgbrug Ringfietspad
655,Ringfietspad Zurenborgbrug,2022-11-02,00:00:00,11,7,4,FMN 06 B Zurenborgbrug Ringfietspad
655,Ringfietspad Zurenborgbrug,2022-11-02,01:00:00,3,0,3,FMN 06 B Zurenborgbrug Ringfietspad
655,Ringfietspad Zurenborgbrug,2022-11-02,02:00:00,5,2,3,FMN 06 B Zurenborgbrug Ringfietspad
655,Ringfietspad Zurenborgbrug,2022-11-02,03:00:00,1,1,0,FMN 06 B Zurenborgbrug Ringfietspad
655,Ringfietspad Zurenborgbrug,2022-11-02,04:00:00,13,9,4,FMN 06 B Zurenborgbrug Ringfietspad
655,Ringfietspad Zurenborgbrug,2022-11-02,05:00:00,50,29,21,FMN 06 B Zurenborgbrug Ringfietspad
655,Ringfietspad Zurenborgbrug,2022-11-02,06:00:00,109,51,58,FMN 06 B Zurenborgbrug Ringfietspad
655,Ringfietspad Zurenborgbrug,2022-11-02,07:00:00,221,133,88,FMN 06 B Zurenborgbrug Ringfietspad
655,Ringfietspad Zurenborgbrug,2022-11-02,08:00:00,281,157,124,FMN 06 B Zurenborgbrug Ringfietspad
655,Ringfietspad Zurenborgbrug,2022-11-02,09:00:00,116,59,57,FMN 06 B Zurenborgbrug Ringfietspad
655,Ringfietspad Zurenborgbrug,2022-11-02,10:00:00,101,54,47,FMN 06 B Zurenborgbrug Ringfietspad
655,Ringfietspad Zurenborgbrug,2022-11-02,11:00:00,110,54,56,FMN 06 B Zurenborgbrug Ringfietspad
655,Ringfietspad Zurenborgbrug,2022-11-02,12:00:00,145,84,61,FMN 06 B Zurenborgbrug Ringfietspad
655,Ringfietspad Zurenborgbrug,2022-11-02,13:00:00,177,83,94,FMN 06 B Zurenborgbrug Ringfietspad
655,Ringfietspad Zurenborgbrug,2022-11-02,14:00:00,168,83,85,FMN 06 B Zurenborgbrug Ringfietspad
655,Ringfietspad Zurenborgbrug,2022-11-02,15:00:00,186,70,116,FMN 06 B Zurenborgbrug Ringfietspad
655,Ringfietspad Zurenborgbrug,2022-11-02,16:00:00,321,132,189,FMN 06 B Zurenborgbrug Ringfietspad
655,Ringfietspad Zurenborgbrug,2022-11-02,17:00:00,345,134,211,FMN 06 B Zurenborgbrug Ringfietspad
655,Ringfietspad Zurenborgbrug,2022-11-02,18:00:00,213,77,136,FMN 06 B Zurenborgbrug Ringfietspad
655,Ringfietspad Zurenborgbrug,2022-11-02,19:00:00,130,58,72,FMN 06 B Zurenborgbrug Ringfietspad
655,Ringfietspad Zurenborgbrug,2022-11-02,20:00:00,84,37,47,FMN 06 B Zurenborgbrug Ringfietspad
655,Ringfietspad Zurenborgbrug,2022-11-02,21:00:00,54,30,24,FMN 06 B Zurenborgbrug Ringfietspad
655,Ringfietspad Zurenborgbrug,2022-11-02,22:00:00,53,19,34,FMN 06 B Zurenborgbrug Ringfietspad
655,Ringfietspad Zurenborgbrug,2022-11-02,23:00:00,38,20,18,FMN 06 B Zurenborgbrug Ringfietspad
655,Ringfietspad Zurenborgbrug,2022-11-03,00:00:00,20,12,8,FMN 06 B Zurenborgbrug Ringfietspad
655,Ringfietspad Zurenborgbrug,2022-11-03,01:00:00,11,4,7,FMN 06 B Zurenborgbrug Ringfietspad
655,Ringfietspad Zurenborgbrug,2022-11-03,02:00:00,5,1,4,FMN 06 B Zurenborgbrug Ringfietspad
655,Ringfietspad Zurenborgbrug,2022-11-03,03:00:00,0,0,0,FMN 06 B Zurenborgbrug Ringfietspad
655,Ringfietspad Zurenborgbrug,2022-11-03,04:00:00,12,10,2,FMN 06 B Zurenborgbrug Ringfietspad
655,Ringfietspad Zurenborgbrug,2022-11-03,05:00:00,53,32,21,FMN 06 B Zurenborgbrug Ringfietspad
655,Ringfietspad Zurenborgbrug,2022-11-03,06:00:00,112,67,45,FMN 06 B Zurenborgbrug Ringfietspad
655,Ringfietspad Zurenborgbrug,2022-11-03,07:00:00,270,174,96,FMN 06 B Zurenborgbrug Ringfietspad
655,Ringfietspad Zurenborgbrug,2022-11-03,08:00:00,357,225,132,FMN 06 B Zurenborgbrug Ringfietspad
655,Ringfietspad Zurenborgbrug,2022-11-03,09:00:00,136,73,63,FMN 06 B Zurenborgbrug Ringfietspad
655,Ringfietspad Zurenborgbrug,2022-11-03,10:00:00,101,59,42,FMN 06 B Zurenborgbrug Ringfietspad
655,Ringfietspad Zurenborgbrug,2022-11-03,11:00:00,92,39,53,FMN 06 B Zurenborgbrug Ringfietspad
655,Ringfietspad Zurenborgbrug,2022-11-03,12:00:00,116,51,65,FMN 06 B Zurenborgbrug Ringfietspad
655,Ringfietspad Zurenborgbrug,2022-11-03,13:00:00,138,60,78,FMN 06 B Zurenborgbrug Ringfietspad
655,Ringfietspad Zurenborgbrug,2022-11-03,14:00:00,112,45,67,FMN 06 B Zurenborgbrug Ringfietspad
655,Ringfietspad Zurenborgbrug,2022-11-03,15:00:00,172,65,107,FMN 06 B Zurenborgbrug Ringfietspad
655,Ringfietspad Zurenborgbrug,2022-11-03,16:00:00,278,102,176,FMN 06 B Zurenborgbrug Ringfietspad
655,Ringfietspad Zurenborgbrug,2022-11-03,17:00:00,303,110,193,FMN 06 B Zurenborgbrug Ringfietspad
655,Ringfietspad Zurenborgbrug,2022-11-03,18:00:00,188,77,111,FMN 06 B Zurenborgbrug Ringfietspad
655,Ringfietspad Zurenborgbrug,2022-11-03,19:00:00,140,37,103,FMN 06 B Zurenborgbrug Ringfietspad
655,Ringfietspad Zurenborgbrug,2022-11-03,20:00:00,94,34,60,FMN 06 B Zurenborgbrug Ringfietspad
655,Ringfietspad Zurenborgbrug,2022-11-03,21:00:00,37,15,22,FMN 06 B Zurenborgbrug Ringfietspad
655,Ringfietspad Zurenborgbrug,2022-11-03,22:00:00,56,24,32,FMN 06 B Zurenborgbrug Ringfietspad
655,Ringfietspad Zurenborgbrug,2022-11-03,23:00:00,96,75,21,FMN 06 B Zurenborgbrug Ringfietspad
655,Ringfietspad Zurenborgbrug,2022-11-04,00:00:00,16,8,8,FMN 06 B Zurenborgbrug Ringfietspad
655,Ringfietspad Zurenborgbrug,2022-11-04,01:00:00,8,5,3,FMN 06 B Zurenborgbrug Ringfietspad
655,Ringfietspad Zurenborgbrug,2022-11-04,02:00:00,5,2,3,FMN 06 B Zurenborgbrug Ringfietspad
655,Ringfietspad Zurenborgbrug,2022-11-04,03:00:00,4,1,3,FMN 06 B Zurenborgbrug Ringfietspad
655,Ringfietspad Zurenborgbrug,2022-11-04,04:00:00,16,10,6,FMN 06 B Zurenborgbrug Ringfietspad
655,Ringfietspad Zurenborgbrug,2022-11-04,05:00:00,52,26,26,FMN 06 B Zurenborgbrug Ringfietspad
655,Ringfietspad Zurenborgbrug,2022-11-04,06:00:00,98,58,40,FMN 06 B Zurenborgbrug Ringfietspad
655,Ringfietspad Zurenborgbrug,2022-11-04,07:00:00,179,105,74,FMN 06 B Zurenborgbrug Ringfietspad
655,Ringfietspad Zurenborgbrug,2022-11-04,08:00:00,247,147,100,FMN 06 B Zurenborgbrug Ringfietspad
655,Ringfietspad Zurenborgbrug,2022-11-04,09:00:00,109,66,43,FMN 06 B Zurenborgbrug Ringfietspad
655,Ringfietspad Zurenborgbrug,2022-11-04,10:00:00,91,60,31,FMN 06 B Zurenborgbrug Ringfietspad
655,Ringfietspad Zurenborgbrug,2022-11-04,11:00:00,73,37,36,FMN 06 B Zurenborgbrug Ringfietspad
655,Ringfietspad Zurenborgbrug,2022-11-04,12:00:00,135,55,80,FMN 06 B Zurenborgbrug Ringfietspad
655,Ringfietspad Zurenborgbrug,2022-11-04,13:00:00,151,73,78,FMN 06 B Zurenborgbrug Ringfietspad
655,Ringfietspad Zurenborgbrug,2022-11-04,14:00:00,127,57,70,FMN 06 B Zurenborgbrug Ringfietspad
655,Ringfietspad Zurenborgbrug,2022-11-04,15:00:00,179,55,124,FMN 06 B Zurenborgbrug Ringfietspad
655,Ringfietspad Zurenborgbrug,2022-11-04,16:00:00,256,96,160,FMN 06 B Zurenborgbrug Ringfietspad
655,Ringfietspad Zurenborgbrug,2022-11-04,17:00:00,243,93,150,FMN 06 B Zurenborgbrug Ringfietspad
655,Ringfietspad Zurenborgbrug,2022-11-04,18:00:00,227,83,144,FMN 06 B Zurenborgbrug Ringfietspad
655,Ringfietspad Zurenborgbrug,2022-11-04,19:00:00,104,40,64,FMN 06 B Zurenborgbrug Ringfietspad
655,Ringfietspad Zurenborgbrug,2022-11-04,20:00:00,94,31,63,FMN 06 B Zurenborgbrug Ringfietspad
655,Ringfietspad Zurenborgbrug,2022-11-04,21:00:00,67,31,36,FMN 06 B Zurenborgbrug Ringfietspad
655,Ringfietspad Zurenborgbrug,2022-11-04,22:00:00,85,39,46,FMN 06 B Zurenborgbrug Ringfietspad
655,Ringfietspad Zurenborgbrug,2022-11-04,23:00:00,40,19,21,FMN 06 B Zurenborgbrug Ringfietspad
655,Ringfietspad Zurenborgbrug,2022-11-05,00:00:00,37,15,22,FMN 06 B Zurenborgbrug Ringfietspad
655,Ringfietspad Zurenborgbrug,2022-11-05,01:00:00,15,7,8,FMN 06 B Zurenborgbrug Ringfietspad
655,Ringfietspad Zurenborgbrug,2022-11-05,02:00:00,11,4,7,FMN 06 B Zurenborgbrug Ringfietspad
655,Ringfietspad Zurenborgbrug,2022-11-05,03:00:00,3,2,1,FMN 06 B Zurenborgbrug Ringfietspad
655,Ringfietspad Zurenborgbrug,2022-11-05,04:00:00,15,11,4,FMN 06 B Zurenborgbrug Ringfietspad
655,Ringfietspad Zurenborgbrug,2022-11-05,05:00:00,12,6,6,FMN 06 B Zurenborgbrug Ringfietspad
655,Ringfietspad Zurenborgbrug,2022-11-05,06:00:00,23,11,12,FMN 06 B Zurenborgbrug Ringfietspad
655,Ringfietspad Zurenborgbrug,2022-11-05,07:00:00,36,21,15,FMN 06 B Zurenborgbrug Ringfietspad
655,Ringfietspad Zurenborgbrug,2022-11-05,08:00:00,47,22,25,FMN 06 B Zurenborgbrug Ringfietspad
655,Ringfietspad Zurenborgbrug,2022-11-05,09:00:00,97,35,62,FMN 06 B Zurenborgbrug Ringfietspad
655,Ringfietspad Zurenborgbrug,2022-11-05,10:00:00,120,70,50,FMN 06 B Zurenborgbrug Ringfietspad
655,Ringfietspad Zurenborgbrug,2022-11-05,11:00:00,97,58,39,FMN 06 B Zurenborgbrug Ringfietspad
655,Ringfietspad Zurenborgbrug,2022-11-05,12:00:00,138,57,81,FMN 06 B Zurenborgbrug Ringfietspad
655,Ringfietspad Zurenborgbrug,2022-11-05,13:00:00,129,61,68,FMN 06 B Zurenborgbrug Ringfietspad
655,Ringfietspad Zurenborgbrug,2022-11-05,14:00:00,152,79,73,FMN 06 B Zurenborgbrug Ringfietspad
655,Ringfietspad Zurenborgbrug,2022-11-05,15:00:00,152,64,88,FMN 06 B Zurenborgbrug Ringfietspad
655,Ringfietspad Zurenborgbrug,2022-11-05,16:00:00,143,60,83,FMN 06 B Zurenborgbrug Ringfietspad
655,Ringfietspad Zurenborgbrug,2022-11-05,17:00:00,119,58,61,FMN 06 B Zurenborgbrug Ringfietspad
655,Ringfietspad Zurenborgbrug,2022-11-05,18:00:00,115,46,69,FMN 06 B Zurenborgbrug Ringfietspad
655,Ringfietspad Zurenborgbrug,2022-11-05,19:00:00,63,31,32,FMN 06 B Zurenborgbrug Ringfietspad
655,Ringfietspad Zurenborgbrug,2022-11-05,20:00:00,78,39,39,FMN 06 B Zurenborgbrug Ringfietspad
655,Ringfietspad Zurenborgbrug,2022-11-05,21:00:00,40,19,21,FMN 06 B Zurenborgbrug Ringfietspad
655,Ringfietspad Zurenborgbrug,2022-11-05,22:00:00,44,27,17,FMN 06 B Zurenborgbrug Ringfietspad
655,Ringfietspad Zurenborgbrug,2022-11-05,23:00:00,33,18,15,FMN 06 B Zurenborgbrug Ringfietspad
655,Ringfietspad Zurenborgbrug,2022-11-06,00:00:00,40,21,19,FMN 06 B Zurenborgbrug Ringfietspad
655,Ringfietspad Zurenborgbrug,2022-11-06,01:00:00,14,5,9,FMN 06 B Zurenborgbrug Ringfietspad
655,Ringfietspad Zurenborgbrug,2022-11-06,02:00:00,16,7,9,FMN 06 B Zurenborgbrug Ringfietspad
655,Ringfietspad Zurenborgbrug,2022-11-06,03:00:00,7,2,5,FMN 06 B Zurenborgbrug Ringfietspad
655,Ringfietspad Zurenborgbrug,2022-11-06,04:00:00,1,1,0,FMN 06 B Zurenborgbrug Ringfietspad
655,Ringfietspad Zurenborgbrug,2022-11-06,05:00:00,8,4,4,FMN 06 B Zurenborgbrug Ringfietspad
655,Ringfietspad Zurenborgbrug,2022-11-06,06:00:00,17,9,8,FMN 06 B Zurenborgbrug Ringfietspad
655,Ringfietspad Zurenborgbrug,2022-11-06,07:00:00,9,6,3,FMN 06 B Zurenborgbrug Ringfietspad
655,Ringfietspad Zurenborgbrug,2022-11-06,08:00:00,35,12,23,FMN 06 B Zurenborgbrug Ringfietspad
655,Ringfietspad Zurenborgbrug,2022-11-06,09:00:00,63,26,37,FMN 06 B Zurenborgbrug Ringfietspad
655,Ringfietspad Zurenborgbrug,2022-11-06,10:00:00,72,39,33,FMN 06 B Zurenborgbrug Ringfietspad
655,Ringfietspad Zurenborgbrug,2022-11-06,11:00:00,70,32,38,FMN 06 B Zurenborgbrug Ringfietspad
655,Ringfietspad Zurenborgbrug,2022-11-06,12:00:00,87,44,43,FMN 06 B Zurenborgbrug Ringfietspad
655,Ringfietspad Zurenborgbrug,2022-11-06,13:00:00,75,35,40,FMN 06 B Zurenborgbrug Ringfietspad
655,Ringfietspad Zurenborgbrug,2022-11-06,14:00:00,56,20,36,FMN 06 B Zurenborgbrug Ringfietspad
655,Ringfietspad Zurenborgbrug,2022-11-06,15:00:00,46,18,28,FMN 06 B Zurenborgbrug Ringfietspad
655,Ringfietspad Zurenborgbrug,2022-11-06,16:00:00,61,21,40,FMN 06 B Zurenborgbrug Ringfietspad
655,Ringfietspad Zurenborgbrug,2022-11-06,17:00:00,97,31,66,FMN 06 B Zurenborgbrug Ringfietspad
655,Ringfietspad Zurenborgbrug,2022-11-06,18:00:00,48,20,28,FMN 06 B Zurenborgbrug Ringfietspad
655,Ringfietspad Zurenborgbrug,2022-11-06,19:00:00,39,13,26,FMN 06 B Zurenborgbrug Ringfietspad
655,Ringfietspad Zurenborgbrug,2022-11-06,20:00:00,61,36,25,FMN 06 B Zurenborgbrug Ringfietspad
655,Ringfietspad Zurenborgbrug,2022-11-06,21:00:00,71,53,18,FMN 06 B Zurenborgbrug Ringfietspad
655,Ringfietspad Zurenborgbrug,2022-11-06,22:00:00,29,22,7,FMN 06 B Zurenborgbrug Ringfietspad
655,Ringfietspad Zurenborgbrug,2022-11-06,23:00:00,18,10,8,FMN 06 B Zurenborgbrug Ringfietspad
655,Ringfietspad Zurenborgbrug,2022-11-07,00:00:00,4,2,2,FMN 06 B Zurenborgbrug Ringfietspad
655,Ringfietspad Zurenborgbrug,2022-11-07,01:00:00,2,1,1,FMN 06 B Zurenborgbrug Ringfietspad
655,Ringfietspad Zurenborgbrug,2022-11-07,02:00:00,1,1,0,FMN 06 B Zurenborgbrug Ringfietspad
655,Ringfietspad Zurenborgbrug,2022-11-07,03:00:00,1,0,1,FMN 06 B Zurenborgbrug Ringfietspad
655,Ringfietspad Zurenborgbrug,2022-11-07,04:00:00,14,8,6,FMN 06 B Zurenborgbrug Ringfietspad
655,Ringfietspad Zurenborgbrug,2022-11-07,05:00:00,49,24,25,FMN 06 B Zurenborgbrug Ringfietspad
655,Ringfietspad Zurenborgbrug,2022-11-07,06:00:00,135,82,53,FMN 06 B Zurenborgbrug Ringfietspad
655,Ringfietspad Zurenborgbrug,2022-11-07,07:00:00,359,217,142,FMN 06 B Zurenborgbrug Ringfietspad
655,Ringfietspad Zurenborgbrug,2022-11-07,08:00:00,579,331,248,FMN 06 B Zurenborgbrug Ringfietspad
655,Ringfietspad Zurenborgbrug,2022-11-07,09:00:00,145,76,69,FMN 06 B Zurenborgbrug Ringfietspad
655,Ringfietspad Zurenborgbrug,2022-11-07,10:00:00,102,46,56,FMN 06 B Zurenborgbrug Ringfietspad
655,Ringfietspad Zurenborgbrug,2022-11-07,11:00:00,92,37,55,FMN 06 B Zurenborgbrug Ringfietspad
655,Ringfietspad Zurenborgbrug,2022-11-07,12:00:00,132,66,66,FMN 06 B Zurenborgbrug Ringfietspad
655,Ringfietspad Zurenborgbrug,2022-11-07,13:00:00,178,89,89,FMN 06 B Zurenborgbrug Ringfietspad
655,Ringfietspad Zurenborgbrug,2022-11-07,14:00:00,149,59,90,FMN 06 B Zurenborgbrug Ringfietspad
655,Ringfietspad Zurenborgbrug,2022-11-07,15:00:00,271,100,171,FMN 06 B Zurenborgbrug Ringfietspad
655,Ringfietspad Zurenborgbrug,2022-11-07,16:00:00,470,187,283,FMN 06 B Zurenborgbrug Ringfietspad
655,Ringfietspad Zurenborgbrug,2022-11-07,17:00:00,443,159,284,FMN 06 B Zurenborgbrug Ringfietspad
655,Ringfietspad Zurenborgbrug,2022-11-07,18:00:00,265,117,148,FMN 06 B Zurenborgbrug Ringfietspad
655,Ringfietspad Zurenborgbrug,2022-11-07,19:00:00,137,44,93,FMN 06 B Zurenborgbrug Ringfietspad
655,Ringfietspad Zurenborgbrug,2022-11-07,20:00:00,77,37,40,FMN 06 B Zurenborgbrug Ringfietspad
655,Ringfietspad Zurenborgbrug,2022-11-07,21:00:00,79,29,50,FMN 06 B Zurenborgbrug Ringfietspad
655,Ringfietspad Zurenborgbrug,2022-11-07,22:00:00,71,24,47,FMN 06 B Zurenborgbrug Ringfietspad
655,Ringfietspad Zurenborgbrug,2022-11-07,23:00:00,31,10,21,FMN 06 B Zurenborgbrug Ringfietspad
655,Ringfietspad Zurenborgbrug,2022-11-08,00:00:00,8,3,5,FMN 06 B Zurenborgbrug Ringfietspad
655,Ringfietspad Zurenborgbrug,2022-11-08,01:00:00,5,1,4,FMN 06 B Zurenborgbrug Ringfietspad
655,Ringfietspad Zurenborgbrug,2022-11-08,02:00:00,1,0,1,FMN 06 B Zurenborgbrug Ringfietspad
655,Ringfietspad Zurenborgbrug,2022-11-08,03:00:00,0,0,0,FMN 06 B Zurenborgbrug Ringfietspad
655,Ringfietspad Zurenborgbrug,2022-11-08,04:00:00,15,9,6,FMN 06 B Zurenborgbrug Ringfietspad
655,Ringfietspad Zurenborgbrug,2022-11-08,05:00:00,58,30,28,FMN 06 B Zurenborgbrug Ringfietspad
655,Ringfietspad Zurenborgbrug,2022-11-08,06:00:00,133,76,57,FMN 06 B Zurenborgbrug Ringfietspad
655,Ringfietspad Zurenborgbrug,2022-11-08,07:00:00,493,310,183,FMN 06 B Zurenborgbrug Ringfietspad
655,Ringfietspad Zurenborgbrug,2022-11-08,08:00:00,717,438,279,FMN 06 B Zurenborgbrug Ringfietspad
655,Ringfietspad Zurenborgbrug,2022-11-08,09:00:00,171,98,73,FMN 06 B Zurenborgbrug Ringfietspad
655,Ringfietspad Zurenborgbrug,2022-11-08,10:00:00,120,74,46,FMN 06 B Zurenborgbrug Ringfietspad
655,Ringfietspad Zurenborgbrug,2022-11-08,11:00:00,96,52,44,FMN 06 B Zurenborgbrug Ringfietspad
655,Ringfietspad Zurenborgbrug,2022-11-08,12:00:00,182,87,95,FMN 06 B Zurenborgbrug Ringfietspad
655,Ringfietspad Zurenborgbrug,2022-11-08,13:00:00,172,72,100,FMN 06 B Zurenborgbrug Ringfietspad
655,Ringfietspad Zurenborgbrug,2022-11-08,14:00:00,153,60,93,FMN 06 B Zurenborgbrug Ringfietspad
655,Ringfietspad Zurenborgbrug,2022-11-08,15:00:00,290,121,169,FMN 06 B Zurenborgbrug Ringfietspad
655,Ringfietspad Zurenborgbrug,2022-11-08,16:00:00,545,224,321,FMN 06 B Zurenborgbrug Ringfietspad
655,Ringfietspad Zurenborgbrug,2022-11-08,17:00:00,526,202,324,FMN 06 B Zurenborgbrug Ringfietspad
655,Ringfietspad Zurenborgbrug,2022-11-08,18:00:00,319,112,207,FMN 06 B Zurenborgbrug Ringfietspad
655,Ringfietspad Zurenborgbrug,2022-11-08,19:00:00,162,63,99,FMN 06 B Zurenborgbrug Ringfietspad
655,Ringfietspad Zurenborgbrug,2022-11-08,20:00:00,99,38,61,FMN 06 B Zurenborgbrug Ringfietspad
655,Ringfietspad Zurenborgbrug,2022-11-08,21:00:00,96,39,57,FMN 06 B Zurenborgbrug Ringfietspad
655,Ringfietspad Zurenborgbrug,2022-11-08,22:00:00,91,31,60,FMN 06 B Zurenborgbrug Ringfietspad
655,Ringfietspad Zurenborgbrug,2022-11-08,23:00:00,49,31,18,FMN 06 B Zurenborgbrug Ringfietspad
655,Ringfietspad Zurenborgbrug,2022-11-09,00:00:00,21,8,13,FMN 06 B Zurenborgbrug Ringfietspad
655,Ringfietspad Zurenborgbrug,2022-11-09,01:00:00,6,2,4,FMN 06 B Zurenborgbrug Ringfietspad
655,Ringfietspad Zurenborgbrug,2022-11-09,02:00:00,4,1,3,FMN 06 B Zurenborgbrug Ringfietspad
655,Ringfietspad Zurenborgbrug,2022-11-09,03:00:00,3,2,1,FMN 06 B Zurenborgbrug Ringfietspad
655,Ringfietspad Zurenborgbrug,2022-11-09,04:00:00,11,6,5,FMN 06 B Zurenborgbrug Ringfietspad
655,Ringfietspad Zurenborgbrug,2022-11-09,05:00:00,37,22,15,FMN 06 B Zurenborgbrug Ringfietspad
655,Ringfietspad Zurenborgbrug,2022-11-09,06:00:00,105,63,42,FMN 06 B Zurenborgbrug Ringfietspad
655,Ringfietspad Zurenborgbrug,2022-11-09,07:00:00,402,236,166,FMN 06 B Zurenborgbrug Ringfietspad
655,Ringfietspad Zurenborgbrug,2022-11-09,08:00:00,524,329,195,FMN 06 B Zurenborgbrug Ringfietspad
655,Ringfietspad Zurenborgbrug,2022-11-09,09:00:00,175,102,73,FMN 06 B Zurenborgbrug Ringfietspad
655,Ringfietspad Zurenborgbrug,2022-11-09,10:00:00,134,72,62,FMN 06 B Zurenborgbrug Ringfietspad
655,Ringfietspad Zurenborgbrug,2022-11-09,11:00:00,126,63,63,FMN 06 B Zurenborgbrug Ringfietspad
655,Ringfietspad Zurenborgbrug,2022-11-09,12:00:00,280,116,164,FMN 06 B Zurenborgbrug Ringfietspad
655,Ringfietspad Zurenborgbrug,2022-11-09,13:00:00,200,86,114,FMN 06 B Zurenborgbrug Ringfietspad
655,Ringfietspad Zurenborgbrug,2022-11-09,14:00:00,167,81,86,FMN 06 B Zurenborgbrug Ringfietspad
655,Ringfietspad Zurenborgbrug,2022-11-09,15:00:00,217,83,134,FMN 06 B Zurenborgbrug Ringfietspad
655,Ringfietspad Zurenborgbrug,2022-11-09,16:00:00,384,139,245,FMN 06 B Zurenborgbrug Ringfietspad
655,Ringfietspad Zurenborgbrug,2022-11-09,17:00:00,435,153,282,FMN 06 B Zurenborgbrug Ringfietspad
655,Ringfietspad Zurenborgbrug,2022-11-09,18:00:00,277,123,154,FMN 06 B Zurenborgbrug Ringfietspad
655,Ringfietspad Zurenborgbrug,2022-11-09,19:00:00,162,66,96,FMN 06 B Zurenborgbrug Ringfietspad
655,Ringfietspad Zurenborgbrug,2022-11-09,20:00:00,110,35,75,FMN 06 B Zurenborgbrug Ringfietspad
655,Ringfietspad Zurenborgbrug,2022-11-09,21:00:00,78,34,44,FMN 06 B Zurenborgbrug Ringfietspad
655,Ringfietspad Zurenborgbrug,2022-11-09,22:00:00,103,47,56,FMN 06 B Zurenborgbrug Ringfietspad
655,Ringfietspad Zurenborgbrug,2022-11-09,23:00:00,41,26,15,FMN 06 B Zurenborgbrug Ringfietspad
655,Ringfietspad Zurenborgbrug,2022-11-10,00:00:00,24,14,10,FMN 06 B Zurenborgbrug Ringfietspad
655,Ringfietspad Zurenborgbrug,2022-11-10,01:00:00,5,2,3,FMN 06 B Zurenborgbrug Ringfietspad
655,Ringfietspad Zurenborgbrug,2022-11-10,02:00:00,4,2,2,FMN 06 B Zurenborgbrug Ringfietspad
655,Ringfietspad Zurenborgbrug,2022-11-10,03:00:00,3,2,1,FMN 06 B Zurenborgbrug Ringfietspad
655,Ringfietspad Zurenborgbrug,2022-11-10,04:00:00,15,8,7,FMN 06 B Zurenborgbrug Ringfietspad
655,Ringfietspad Zurenborgbrug,2022-11-10,05:00:00,45,24,21,FMN 06 B Zurenborgbrug Ringfietspad
655,Ringfietspad Zurenborgbrug,2022-11-10,06:00:00,124,74,50,FMN 06 B Zurenborgbrug Ringfietspad
655,Ringfietspad Zurenborgbrug,2022-11-10,07:00:00,442,262,180,FMN 06 B Zurenborgbrug Ringfietspad
655,Ringfietspad Zurenborgbrug,2022-11-10,08:00:00,634,362,272,FMN 06 B Zurenborgbrug Ringfietspad
655,Ringfietspad Zurenborgbrug,2022-11-10,09:00:00,192,114,78,FMN 06 B Zurenborgbrug Ringfietspad
655,Ringfietspad Zurenborgbrug,2022-11-10,10:00:00,135,77,58,FMN 06 B Zurenborgbrug Ringfietspad
655,Ringfietspad Zurenborgbrug,2022-11-10,11:00:00,119,52,67,FMN 06 B Zurenborgbrug Ringfietspad
655,Ringfietspad Zurenborgbrug,2022-11-10,12:00:00,194,93,101,FMN 06 B Zurenborgbrug Ringfietspad
655,Ringfietspad Zurenborgbrug,2022-11-10,13:00:00,205,90,115,FMN 06 B Zurenborgbrug Ringfietspad
655,Ringfietspad Zurenborgbrug,2022-11-10,14:00:00,185,97,88,FMN 06 B Zurenborgbrug Ringfietspad
655,Ringfietspad Zurenborgbrug,2022-11-10,15:00:00,317,114,203,FMN 06 B Zurenborgbrug Ringfietspad
655,Ringfietspad Zurenborgbrug,2022-11-10,16:00:00,507,229,278,FMN 06 B Zurenborgbrug Ringfietspad
655,Ringfietspad Zurenborgbrug,2022-11-10,17:00:00,520,182,338,FMN 06 B Zurenborgbrug Ringfietspad
655,Ringfietspad Zurenborgbrug,2022-11-10,18:00:00,313,113,200,FMN 06 B Zurenborgbrug Ringfietspad
655,Ringfietspad Zurenborgbrug,2022-11-10,19:00:00,202,76,126,FMN 06 B Zurenborgbrug Ringfietspad
655,Ringfietspad Zurenborgbrug,2022-11-10,20:00:00,124,56,68,FMN 06 B Zurenborgbrug Ringfietspad
655,Ringfietspad Zurenborgbrug,2022-11-10,21:00:00,94,32,62,FMN 06 B Zurenborgbrug Ringfietspad
655,Ringfietspad Zurenborgbrug,2022-11-10,22:00:00,90,46,44,FMN 06 B Zurenborgbrug Ringfietspad
655,Ringfietspad Zurenborgbrug,2022-11-10,23:00:00,77,44,33,FMN 06 B Zurenborgbrug Ringfietspad
655,Ringfietspad Zurenborgbrug,2022-11-11,00:00:00,36,18,18,FMN 06 B Zurenborgbrug Ringfietspad
655,Ringfietspad Zurenborgbrug,2022-11-11,01:00:00,17,6,11,FMN 06 B Zurenborgbrug Ringfietspad
655,Ringfietspad Zurenborgbrug,2022-11-11,02:00:00,21,8,13,FMN 06 B Zurenborgbrug Ringfietspad
655,Ringfietspad Zurenborgbrug,2022-11-11,03:00:00,22,8,14,FMN 06 B Zurenborgbrug Ringfietspad
655,Ringfietspad Zurenborgbrug,2022-11-11,04:00:00,18,5,13,FMN 06 B Zurenborgbrug Ringfietspad
655,Ringfietspad Zurenborgbrug,2022-11-11,05:00:00,15,7,8,FMN 06 B Zurenborgbrug Ringfietspad
655,Ringfietspad Zurenborgbrug,2022-11-11,06:00:00,18,11,7,FMN 06 B Zurenborgbrug Ringfietspad
655,Ringfietspad Zurenborgbrug,2022-11-11,07:00:00,23,13,10,FMN 06 B Zurenborgbrug Ringfietspad
655,Ringfietspad Zurenborgbrug,2022-11-11,08:00:00,45,26,19,FMN 06 B Zurenborgbrug Ringfietspad
655,Ringfietspad Zurenborgbrug,2022-11-11,09:00:00,70,28,42,FMN 06 B Zurenborgbrug Ringfietspad
655,Ringfietspad Zurenborgbrug,2022-11-11,10:00:00,104,48,56,FMN 06 B Zurenborgbrug Ringfietspad
655,Ringfietspad Zurenborgbrug,2022-11-11,11:00:00,110,64,46,FMN 06 B Zurenborgbrug Ringfietspad
655,Ringfietspad Zurenborgbrug,2022-11-11,12:00:00,123,66,57,FMN 06 B Zurenborgbrug Ringfietspad
655,Ringfietspad Zurenborgbrug,2022-11-11,13:00:00,216,77,139,FMN 06 B Zurenborgbrug Ringfietspad
655,Ringfietspad Zurenborgbrug,2022-11-11,14:00:00,200,84,116,FMN 06 B Zurenborgbrug Ringfietspad
655,Ringfietspad Zurenborgbrug,2022-11-11,15:00:00,178,83,95,FMN 06 B Zurenborgbrug Ringfietspad
655,Ringfietspad Zurenborgbrug,2022-11-11,16:00:00,178,87,91,FMN 06 B Zurenborgbrug Ringfietspad
655,Ringfietspad Zurenborgbrug,2022-11-11,17:00:00,164,87,77,FMN 06 B Zurenborgbrug Ringfietspad
655,Ringfietspad Zurenborgbrug,2022-11-11,18:00:00,85,26,59,FMN 06 B Zurenborgbrug Ringfietspad
655,Ringfietspad Zurenborgbrug,2022-11-11,19:00:00,97,33,64,FMN 06 B Zurenborgbrug Ringfietspad
655,Ringfietspad Zurenborgbrug,2022-11-11,20:00:00,60,25,35,FMN 06 B Zurenborgbrug Ringfietspad
655,Ringfietspad Zurenborgbrug,2022-11-11,21:00:00,46,20,26,FMN 06 B Zurenborgbrug Ringfietspad
655,Ringfietspad Zurenborgbrug,2022-11-11,22:00:00,54,30,24,FMN 06 B Zurenborgbrug Ringfietspad
655,Ringfietspad Zurenborgbrug,2022-11-11,23:00:00,28,17,11,FMN 06 B Zurenborgbrug Ringfietspad
655,Ringfietspad Zurenborgbrug,2022-11-12,00:00:00,24,12,12,FMN 06 B Zurenborgbrug Ringfietspad
655,Ringfietspad Zurenborgbrug,2022-11-12,01:00:00,15,4,11,FMN 06 B Zurenborgbrug Ringfietspad
655,Ringfietspad Zurenborgbrug,2022-11-12,02:00:00,6,4,2,FMN 06 B Zurenborgbrug Ringfietspad
655,Ringfietspad Zurenborgbrug,2022-11-12,03:00:00,10,2,8,FMN 06 B Zurenborgbrug Ringfietspad
655,Ringfietspad Zurenborgbrug,2022-11-12,04:00:00,8,5,3,FMN 06 B Zurenborgbrug Ringfietspad
655,Ringfietspad Zurenborgbrug,2022-11-12,05:00:00,10,6,4,FMN 06 B Zurenborgbrug Ringfietspad
655,Ringfietspad Zurenborgbrug,2022-11-12,06:00:00,24,10,14,FMN 06 B Zurenborgbrug Ringfietspad
655,Ringfietspad Zurenborgbrug,2022-11-12,07:00:00,29,14,15,FMN 06 B Zurenborgbrug Ringfietspad
655,Ringfietspad Zurenborgbrug,2022-11-12,08:00:00,51,20,31,FMN 06 B Zurenborgbrug Ringfietspad
655,Ringfietspad Zurenborgbrug,2022-11-12,09:00:00,76,21,55,FMN 06 B Zurenborgbrug Ringfietspad
655,Ringfietspad Zurenborgbrug,2022-11-12,10:00:00,105,49,56,FMN 06 B Zurenborgbrug Ringfietspad
655,Ringfietspad Zurenborgbrug,2022-11-12,11:00:00,126,70,56,FMN 06 B Zurenborgbrug Ringfietspad
655,Ringfietspad Zurenborgbrug,2022-11-12,12:00:00,139,62,77,FMN 06 B Zurenborgbrug Ringfietspad
655,Ringfietspad Zurenborgbrug,2022-11-12,13:00:00,236,97,139,FMN 06 B Zurenborgbrug Ringfietspad
655,Ringfietspad Zurenborgbrug,2022-11-12,14:00:00,243,130,113,FMN 06 B Zurenborgbrug Ringfietspad
655,Ringfietspad Zurenborgbrug,2022-11-12,15:00:00,184,85,99,FMN 06 B Zurenborgbrug Ringfietspad
655,Ringfietspad Zurenborgbrug,2022-11-12,16:00:00,216,120,96,FMN 06 B Zurenborgbrug Ringfietspad
655,Ringfietspad Zurenborgbrug,2022-11-12,17:00:00,201,86,115,FMN 06 B Zurenborgbrug Ringfietspad
655,Ringfietspad Zurenborgbrug,2022-11-12,18:00:00,139,42,97,FMN 06 B Zurenborgbrug Ringfietspad
655,Ringfietspad Zurenborgbrug,2022-11-12,19:00:00,114,56,58,FMN 06 B Zurenborgbrug Ringfietspad
655,Ringfietspad Zurenborgbrug,2022-11-12,20:00:00,113,65,48,FMN 06 B Zurenborgbrug Ringfietspad
655,Ringfietspad Zurenborgbrug,2022-11-12,21:00:00,41,21,20,FMN 06 B Zurenborgbrug Ringfietspad
655,Ringfietspad Zurenborgbrug,2022-11-12,22:00:00,59,32,27,FMN 06 B Zurenborgbrug Ringfietspad
655,Ringfietspad Zurenborgbrug,2022-11-12,23:00:00,93,56,37,FMN 06 B Zurenborgbrug Ringfietspad
655,Ringfietspad Zurenborgbrug,2022-11-13,00:00:00,40,13,27,FMN 06 B Zurenborgbrug Ringfietspad
655,Ringfietspad Zurenborgbrug,2022-11-13,01:00:00,20,5,15,FMN 06 B Zurenborgbrug Ringfietspad
655,Ringfietspad Zurenborgbrug,2022-11-13,02:00:00,22,7,15,FMN 06 B Zurenborgbrug Ringfietspad
655,Ringfietspad Zurenborgbrug,2022-11-13,03:00:00,14,3,11,FMN 06 B Zurenborgbrug Ringfietspad
655,Ringfietspad Zurenborgbrug,2022-11-13,04:00:00,17,9,8,FMN 06 B Zurenborgbrug Ringfietspad
655,Ringfietspad Zurenborgbrug,2022-11-13,05:00:00,18,14,4,FMN 06 B Zurenborgbrug Ringfietspad
655,Ringfietspad Zurenborgbrug,2022-11-13,06:00:00,12,6,6,FMN 06 B Zurenborgbrug Ringfietspad
655,Ringfietspad Zurenborgbrug,2022-11-13,07:00:00,28,10,18,FMN 06 B Zurenborgbrug Ringfietspad
655,Ringfietspad Zurenborgbrug,2022-11-13,08:00:00,48,10,38,FMN 06 B Zurenborgbrug Ringfietspad
655,Ringfietspad Zurenborgbrug,2022-11-13,09:00:00,99,41,58,FMN 06 B Zurenborgbrug Ringfietspad
655,Ringfietspad Zurenborgbrug,2022-11-13,10:00:00,105,45,60,FMN 06 B Zurenborgbrug Ringfietspad
655,Ringfietspad Zurenborgbrug,2022-11-13,11:00:00,132,73,59,FMN 06 B Zurenborgbrug Ringfietspad
655,Ringfietspad Zurenborgbrug,2022-11-13,12:00:00,137,64,73,FMN 06 B Zurenborgbrug Ringfietspad
655,Ringfietspad Zurenborgbrug,2022-11-13,13:00:00,195,90,105,FMN 06 B Zurenborgbrug Ringfietspad
655,Ringfietspad Zurenborgbrug,2022-11-13,14:00:00,212,102,110,FMN 06 B Zurenborgbrug Ringfietspad
655,Ringfietspad Zurenborgbrug,2022-11-13,15:00:00,195,80,115,FMN 06 B Zurenborgbrug Ringfietspad
655,Ringfietspad Zurenborgbrug,2022-11-13,16:00:00,187,100,87,FMN 06 B Zurenborgbrug Ringfietspad
655,Ringfietspad Zurenborgbrug,2022-11-13,17:00:00,138,69,69,FMN 06 B Zurenborgbrug Ringfietspad
655,Ringfietspad Zurenborgbrug,2022-11-13,18:00:00,76,31,45,FMN 06 B Zurenborgbrug Ringfietspad
655,Ringfietspad Zurenborgbrug,2022-11-13,19:00:00,77,44,33,FMN 06 B Zurenborgbrug Ringfietspad
655,Ringfietspad Zurenborgbrug,2022-11-13,20:00:00,52,21,31,FMN 06 B Zurenborgbrug Ringfietspad
655,Ringfietspad Zurenborgbrug,2022-11-13,21:00:00,38,19,19,FMN 06 B Zurenborgbrug Ringfietspad
655,Ringfietspad Zurenborgbrug,2022-11-13,22:00:00,31,21,10,FMN 06 B Zurenborgbrug Ringfietspad
655,Ringfietspad Zurenborgbrug,2022-11-13,23:00:00,20,11,9,FMN 06 B Zurenborgbrug Ringfietspad
655,Ringfietspad Zurenborgbrug,2022-11-14,00:00:00,7,5,2,FMN 06 B Zurenborgbrug Ringfietspad
655,Ringfietspad Zurenborgbrug,2022-11-14,01:00:00,0,0,0,FMN 06 B Zurenborgbrug Ringfietspad
655,Ringfietspad Zurenborgbrug,2022-11-14,02:00:00,0,0,0,FMN 06 B Zurenborgbrug Ringfietspad
655,Ringfietspad Zurenborgbrug,2022-11-14,03:00:00,5,2,3,FMN 06 B Zurenborgbrug Ringfietspad
655,Ringfietspad Zurenborgbrug,2022-11-14,04:00:00,16,12,4,FMN 06 B Zurenborgbrug Ringfietspad
655,Ringfietspad Zurenborgbrug,2022-11-14,05:00:00,46,25,21,FMN 06 B Zurenborgbrug Ringfietspad
655,Ringfietspad Zurenborgbrug,2022-11-14,06:00:00,142,74,68,FMN 06 B Zurenborgbrug Ringfietspad
655,Ringfietspad Zurenborgbrug,2022-11-14,07:00:00,462,265,197,FMN 06 B Zurenborgbrug Ringfietspad
655,Ringfietspad Zurenborgbrug,2022-11-14,08:00:00,644,383,261,FMN 06 B Zurenborgbrug Ringfietspad
655,Ringfietspad Zurenborgbrug,2022-11-14,09:00:00,159,91,68,FMN 06 B Zurenborgbrug Ringfietspad
655,Ringfietspad Zurenborgbrug,2022-11-14,10:00:00,117,66,51,FMN 06 B Zurenborgbrug Ringfietspad
655,Ringfietspad Zurenborgbrug,2022-11-14,11:00:00,100,43,57,FMN 06 B Zurenborgbrug Ringfietspad
655,Ringfietspad Zurenborgbrug,2022-11-14,12:00:00,193,101,92,FMN 06 B Zurenborgbrug Ringfietspad
655,Ringfietspad Zurenborgbrug,2022-11-14,13:00:00,184,88,96,FMN 06 B Zurenborgbrug Ringfietspad
655,Ringfietspad Zurenborgbrug,2022-11-14,14:00:00,170,67,103,FMN 06 B Zurenborgbrug Ringfietspad
655,Ringfietspad Zurenborgbrug,2022-11-14,15:00:00,340,140,200,FMN 06 B Zurenborgbrug Ringfietspad
655,Ringfietspad Zurenborgbrug,2022-11-14,16:00:00,545,222,323,FMN 06 B Zurenborgbrug Ringfietspad
655,Ringfietspad Zurenborgbrug,2022-11-14,17:00:00,471,154,317,FMN 06 B Zurenborgbrug Ringfietspad
655,Ringfietspad Zurenborgbrug,2022-11-14,18:00:00,246,117,129,FMN 06 B Zurenborgbrug Ringfietspad
655,Ringfietspad Zurenborgbrug,2022-11-14,19:00:00,151,58,93,FMN 06 B Zurenborgbrug Ringfietspad
655,Ringfietspad Zurenborgbrug,2022-11-14,20:00:00,97,42,55,FMN 06 B Zurenborgbrug Ringfietspad
655,Ringfietspad Zurenborgbrug,2022-11-14,21:00:00,87,32,55,FMN 06 B Zurenborgbrug Ringfietspad
655,Ringfietspad Zurenborgbrug,2022-11-14,22:00:00,75,32,43,FMN 06 B Zurenborgbrug Ringfietspad
655,Ringfietspad Zurenborgbrug,2022-11-14,23:00:00,21,6,15,FMN 06 B Zurenborgbrug Ringfietspad
655,Ringfietspad Zurenborgbrug,2022-11-15,00:00:00,11,3,8,FMN 06 B Zurenborgbrug Ringfietspad
655,Ringfietspad Zurenborgbrug,2022-11-15,01:00:00,2,0,2,FMN 06 B Zurenborgbrug Ringfietspad
655,Ringfietspad Zurenborgbrug,2022-11-15,02:00:00,2,2,0,FMN 06 B Zurenborgbrug Ringfietspad
655,Ringfietspad Zurenborgbrug,2022-11-15,03:00:00,2,1,1,FMN 06 B Zurenborgbrug Ringfietspad
655,Ringfietspad Zurenborgbrug,2022-11-15,04:00:00,17,13,4,FMN 06 B Zurenborgbrug Ringfietspad
655,Ringfietspad Zurenborgbrug,2022-11-15,05:00:00,53,26,27,FMN 06 B Zurenborgbrug Ringfietspad
655,Ringfietspad Zurenborgbrug,2022-11-15,06:00:00,145,80,65,FMN 06 B Zurenborgbrug Ringfietspad
655,Ringfietspad Zurenborgbrug,2022-11-15,07:00:00,466,286,180,FMN 06 B Zurenborgbrug Ringfietspad
655,Ringfietspad Zurenborgbrug,2022-11-15,08:00:00,672,390,282,FMN 06 B Zurenborgbrug Ringfietspad
655,Ringfietspad Zurenborgbrug,2022-11-15,09:00:00,184,115,69,FMN 06 B Zurenborgbrug Ringfietspad
655,Ringfietspad Zurenborgbrug,2022-11-15,10:00:00,122,65,57,FMN 06 B Zurenborgbrug Ringfietspad
655,Ringfietspad Zurenborgbrug,2022-11-15,11:00:00,103,62,41,FMN 06 B Zurenborgbrug Ringfietspad
655,Ringfietspad Zurenborgbrug,2022-11-15,12:00:00,173,80,93,FMN 06 B Zurenborgbrug Ringfietspad
655,Ringfietspad Zurenborgbrug,2022-11-15,13:00:00,153,58,95,FMN 06 B Zurenborgbrug Ringfietspad
655,Ringfietspad Zurenborgbrug,2022-11-15,14:00:00,148,58,90,FMN 06 B Zurenborgbrug Ringfietspad
655,Ringfietspad Zurenborgbrug,2022-11-15,15:00:00,276,104,172,FMN 06 B Zurenborgbrug Ringfietspad
655,Ringfietspad Zurenborgbrug,2022-11-15,16:00:00,500,189,311,FMN 06 B Zurenborgbrug Ringfietspad
655,Ringfietspad Zurenborgbrug,2022-11-15,17:00:00,433,141,292,FMN 06 B Zurenborgbrug Ringfietspad
655,Ringfietspad Zurenborgbrug,2022-11-15,18:00:00,252,93,159,FMN 06 B Zurenborgbrug Ringfietspad
655,Ringfietspad Zurenborgbrug,2022-11-15,19:00:00,115,44,71,FMN 06 B Zurenborgbrug Ringfietspad
655,Ringfietspad Zurenborgbrug,2022-11-15,20:00:00,68,28,40,FMN 06 B Zurenborgbrug Ringfietspad
655,Ringfietspad Zurenborgbrug,2022-11-15,21:00:00,69,34,35,FMN 06 B Zurenborgbrug Ringfietspad
655,Ringfietspad Zurenborgbrug,2022-11-15,22:00:00,73,27,46,FMN 06 B Zurenborgbrug Ringfietspad
655,Ringfietspad Zurenborgbrug,2022-11-15,23:00:00,26,9,17,FMN 06 B Zurenborgbrug Ringfietspad
655,Ringfietspad Zurenborgbrug,2022-11-16,00:00:00,13,6,7,FMN 06 B Zurenborgbrug Ringfietspad
655,Ringfietspad Zurenborgbrug,2022-11-16,01:00:00,2,0,2,FMN 06 B Zurenborgbrug Ringfietspad
655,Ringfietspad Zurenborgbrug,2022-11-16,02:00:00,3,0,3,FMN 06 B Zurenborgbrug Ringfietspad
655,Ringfietspad Zurenborgbrug,2022-11-16,03:00:00,6,4,2,FMN 06 B Zurenborgbrug Ringfietspad
655,Ringfietspad Zurenborgbrug,2022-11-16,04:00:00,16,11,5,FMN 06 B Zurenborgbrug Ringfietspad
655,Ringfietspad Zurenborgbrug,2022-11-16,05:00:00,47,27,20,FMN 06 B Zurenborgbrug Ringfietspad
655,Ringfietspad Zurenborgbrug,2022-11-16,06:00:00,130,73,57,FMN 06 B Zurenborgbrug Ringfietspad
655,Ringfietspad Zurenborgbrug,2022-11-16,07:00:00,399,234,165,FMN 06 B Zurenborgbrug Ringfietspad
655,Ringfietspad Zurenborgbrug,2022-11-16,08:00:00,551,310,241,FMN 06 B Zurenborgbrug Ringfietspad
655,Ringfietspad Zurenborgbrug,2022-11-16,09:00:00,174,104,70,FMN 06 B Zurenborgbrug Ringfietspad
655,Ringfietspad Zurenborgbrug,2022-11-16,10:00:00,101,58,43,FMN 06 B Zurenborgbrug Ringfietspad
655,Ringfietspad Zurenborgbrug,2022-11-16,11:00:00,153,70,83,FMN 06 B Zurenborgbrug Ringfietspad
655,Ringfietspad Zurenborgbrug,2022-11-16,12:00:00,301,134,167,FMN 06 B Zurenborgbrug Ringfietspad
655,Ringfietspad Zurenborgbrug,2022-11-16,13:00:00,222,100,122,FMN 06 B Zurenborgbrug Ringfietspad
655,Ringfietspad Zurenborgbrug,2022-11-16,14:00:00,146,70,76,FMN 06 B Zurenborgbrug Ringfietspad
655,Ringfietspad Zurenborgbrug,2022-11-16,15:00:00,201,79,122,FMN 06 B Zurenborgbrug Ringfietspad
655,Ringfietspad Zurenborgbrug,2022-11-16,16:00:00,346,130,216,FMN 06 B Zurenborgbrug Ringfietspad
655,Ringfietspad Zurenborgbrug,2022-11-16,17:00:00,409,150,259,FMN 06 B Zurenborgbrug Ringfietspad
655,Ringfietspad Zurenborgbrug,2022-11-16,18:00:00,249,93,156,FMN 06 B Zurenborgbrug Ringfietspad
655,Ringfietspad Zurenborgbrug,2022-11-16,19:00:00,120,52,68,FMN 06 B Zurenborgbrug Ringfietspad
655,Ringfietspad Zurenborgbrug,2022-11-16,20:00:00,92,35,57,FMN 06 B Zurenborgbrug Ringfietspad
655,Ringfietspad Zurenborgbrug,2022-11-16,21:00:00,77,23,54,FMN 06 B Zurenborgbrug Ringfietspad
655,Ringfietspad Zurenborgbrug,2022-11-16,22:00:00,66,28,38,FMN 06 B Zurenborgbrug Ringfietspad
655,Ringfietspad Zurenborgbrug,2022-11-16,23:00:00,22,16,6,FMN 06 B Zurenborgbrug Ringfietspad
655,Ringfietspad Zurenborgbrug,2022-11-17,00:00:00,9,5,4,FMN 06 B Zurenborgbrug Ringfietspad
655,Ringfietspad Zurenborgbrug,2022-11-17,01:00:00,4,2,2,FMN 06 B Zurenborgbrug Ringfietspad
655,Ringfietspad Zurenborgbrug,2022-11-17,02:00:00,4,1,3,FMN 06 B Zurenborgbrug Ringfietspad
655,Ringfietspad Zurenborgbrug,2022-11-17,03:00:00,4,4,0,FMN 06 B Zurenborgbrug Ringfietspad
655,Ringfietspad Zurenborgbrug,2022-11-17,04:00:00,16,13,3,FMN 06 B Zurenborgbrug Ringfietspad
655,Ringfietspad Zurenborgbrug,2022-11-17,05:00:00,36,20,16,FMN 06 B Zurenborgbrug Ringfietspad
655,Ringfietspad Zurenborgbrug,2022-11-17,06:00:00,105,62,43,FMN 06 B Zurenborgbrug Ringfietspad
655,Ringfietspad Zurenborgbrug,2022-11-17,07:00:00,323,182,141,FMN 06 B Zurenborgbrug Ringfietspad
655,Ringfietspad Zurenborgbrug,2022-11-17,08:00:00,500,284,216,FMN 06 B Zurenborgbrug Ringfietspad
655,Ringfietspad Zurenborgbrug,2022-11-17,09:00:00,125,76,49,FMN 06 B Zurenborgbrug Ringfietspad
655,Ringfietspad Zurenborgbrug,2022-11-17,10:00:00,68,45,23,FMN 06 B Zurenborgbrug Ringfietspad
655,Ringfietspad Zurenborgbrug,2022-11-17,11:00:00,62,29,33,FMN 06 B Zurenborgbrug Ringfietspad
655,Ringfietspad Zurenborgbrug,2022-11-17,12:00:00,135,55,80,FMN 06 B Zurenborgbrug Ringfietspad
655,Ringfietspad Zurenborgbrug,2022-11-17,13:00:00,130,58,72,FMN 06 B Zurenborgbrug Ringfietspad
655,Ringfietspad Zurenborgbrug,2022-11-17,14:00:00,107,51,56,FMN 06 B Zurenborgbrug Ringfietspad
655,Ringfietspad Zurenborgbrug,2022-11-17,15:00:00,207,80,127,FMN 06 B Zurenborgbrug Ringfietspad
655,Ringfietspad Zurenborgbrug,2022-11-17,16:00:00,403,172,231,FMN 06 B Zurenborgbrug Ringfietspad
655,Ringfietspad Zurenborgbrug,2022-11-17,17:00:00,391,146,245,FMN 06 B Zurenborgbrug Ringfietspad
655,Ringfietspad Zurenborgbrug,2022-11-17,18:00:00,240,96,144,FMN 06 B Zurenborgbrug Ringfietspad
655,Ringfietspad Zurenborgbrug,2022-11-17,19:00:00,146,59,87,FMN 06 B Zurenborgbrug Ringfietspad
655,Ringfietspad Zurenborgbrug,2022-11-17,20:00:00,63,27,36,FMN 06 B Zurenborgbrug Ringfietspad
655,Ringfietspad Zurenborgbrug,2022-11-17,21:00:00,66,24,42,FMN 06 B Zurenborgbrug Ringfietspad
655,Ringfietspad Zurenborgbrug,2022-11-17,22:00:00,69,29,40,FMN 06 B Zurenborgbrug Ringfietspad
655,Ringfietspad Zurenborgbrug,2022-11-17,23:00:00,35,12,23,FMN 06 B Zurenborgbrug Ringfietspad
655,Ringfietspad Zurenborgbrug,2022-11-18,00:00:00,23,10,13,FMN 06 B Zurenborgbrug Ringfietspad
655,Ringfietspad Zurenborgbrug,2022-11-18,01:00:00,8,1,7,FMN 06 B Zurenborgbrug Ringfietspad
655,Ringfietspad Zurenborgbrug,2022-11-18,02:00:00,4,2,2,FMN 06 B Zurenborgbrug Ringfietspad
655,Ringfietspad Zurenborgbrug,2022-11-18,03:00:00,3,2,1,FMN 06 B Zurenborgbrug Ringfietspad
655,Ringfietspad Zurenborgbrug,2022-11-18,04:00:00,17,14,3,FMN 06 B Zurenborgbrug Ringfietspad
655,Ringfietspad Zurenborgbrug,2022-11-18,05:00:00,49,26,23,FMN 06 B Zurenborgbrug Ringfietspad
655,Ringfietspad Zurenborgbrug,2022-11-18,06:00:00,96,59,37,FMN 06 B Zurenborgbrug Ringfietspad
655,Ringfietspad Zurenborgbrug,2022-11-18,07:00:00,332,174,158,FMN 06 B Zurenborgbrug Ringfietspad
655,Ringfietspad Zurenborgbrug,2022-11-18,08:00:00,520,283,237,FMN 06 B Zurenborgbrug Ringfietspad
655,Ringfietspad Zurenborgbrug,2022-11-18,09:00:00,158,92,66,FMN 06 B Zurenborgbrug Ringfietspad
655,Ringfietspad Zurenborgbrug,2022-11-18,10:00:00,111,56,55,FMN 06 B Zurenborgbrug Ringfietspad
655,Ringfietspad Zurenborgbrug,2022-11-18,11:00:00,100,47,53,FMN 06 B Zurenborgbrug Ringfietspad
655,Ringfietspad Zurenborgbrug,2022-11-18,12:00:00,138,60,78,FMN 06 B Zurenborgbrug Ringfietspad
655,Ringfietspad Zurenborgbrug,2022-11-18,13:00:00,113,55,58,FMN 06 B Zurenborgbrug Ringfietspad
655,Ringfietspad Zurenborgbrug,2022-11-18,14:00:00,139,53,86,FMN 06 B Zurenborgbrug Ringfietspad
655,Ringfietspad Zurenborgbrug,2022-11-18,15:00:00,224,90,134,FMN 06 B Zurenborgbrug Ringfietspad
655,Ringfietspad Zurenborgbrug,2022-11-18,16:00:00,402,164,238,FMN 06 B Zurenborgbrug Ringfietspad
655,Ringfietspad Zurenborgbrug,2022-11-18,17:00:00,325,133,192,FMN 06 B Zurenborgbrug Ringfietspad
655,Ringfietspad Zurenborgbrug,2022-11-18,18:00:00,181,78,103,FMN 06 B Zurenborgbrug Ringfietspad
655,Ringfietspad Zurenborgbrug,2022-11-18,19:00:00,110,37,73,FMN 06 B Zurenborgbrug Ringfietspad
655,Ringfietspad Zurenborgbrug,2022-11-18,20:00:00,66,23,43,FMN 06 B Zurenborgbrug Ringfietspad
655,Ringfietspad Zurenborgbrug,2022-11-18,21:00:00,38,22,16,FMN 06 B Zurenborgbrug Ringfietspad
655,Ringfietspad Zurenborgbrug,2022-11-18,22:00:00,62,31,31,FMN 06 B Zurenborgbrug Ringfietspad
655,Ringfietspad Zurenborgbrug,2022-11-18,23:00:00,39,21,18,FMN 06 B Zurenborgbrug Ringfietspad
655,Ringfietspad Zurenborgbrug,2022-11-19,00:00:00,28,12,16,FMN 06 B Zurenborgbrug Ringfietspad
655,Ringfietspad Zurenborgbrug,2022-11-19,01:00:00,19,8,11,FMN 06 B Zurenborgbrug Ringfietspad
655,Ringfietspad Zurenborgbrug,2022-11-19,02:00:00,10,2,8,FMN 06 B Zurenborgbrug Ringfietspad
655,Ringfietspad Zurenborgbrug,2022-11-19,03:00:00,8,6,2,FMN 06 B Zurenborgbrug Ringfietspad
655,Ringfietspad Zurenborgbrug,2022-11-19,04:00:00,5,4,1,FMN 06 B Zurenborgbrug Ringfietspad
655,Ringfietspad Zurenborgbrug,2022-11-19,05:00:00,16,9,7,FMN 06 B Zurenborgbrug Ringfietspad
655,Ringfietspad Zurenborgbrug,2022-11-19,06:00:00,15,9,6,FMN 06 B Zurenborgbrug Ringfietspad
655,Ringfietspad Zurenborgbrug,2022-11-19,07:00:00,14,9,5,FMN 06 B Zurenborgbrug Ringfietspad
655,Ringfietspad Zurenborgbrug,2022-11-19,08:00:00,53,22,31,FMN 06 B Zurenborgbrug Ringfietspad
655,Ringfietspad Zurenborgbrug,2022-11-19,09:00:00,57,26,31,FMN 06 B Zurenborgbrug Ringfietspad
655,Ringfietspad Zurenborgbrug,2022-11-19,10:00:00,52,26,26,FMN 06 B Zurenborgbrug Ringfietspad
655,Ringfietspad Zurenborgbrug,2022-11-19,11:00:00,99,53,46,FMN 06 B Zurenborgbrug Ringfietspad
655,Ringfietspad Zurenborgbrug,2022-11-19,12:00:00,109,37,72,FMN 06 B Zurenborgbrug Ringfietspad
655,Ringfietspad Zurenborgbrug,2022-11-19,13:00:00,90,44,46,FMN 06 B Zurenborgbrug Ringfietspad
655,Ringfietspad Zurenborgbrug,2022-11-19,14:00:00,109,50,59,FMN 06 B Zurenborgbrug Ringfietspad
655,Ringfietspad Zurenborgbrug,2022-11-19,15:00:00,80,35,45,FMN 06 B Zurenborgbrug Ringfietspad
655,Ringfietspad Zurenborgbrug,2022-11-19,16:00:00,91,35,56,FMN 06 B Zurenborgbrug Ringfietspad
655,Ringfietspad Zurenborgbrug,2022-11-19,17:00:00,130,57,73,FMN 06 B Zurenborgbrug Ringfietspad
655,Ringfietspad Zurenborgbrug,2022-11-19,18:00:00,91,36,55,FMN 06 B Zurenborgbrug Ringfietspad
655,Ringfietspad Zurenborgbrug,2022-11-19,19:00:00,90,36,54,FMN 06 B Zurenborgbrug Ringfietspad
655,Ringfietspad Zurenborgbrug,2022-11-19,20:00:00,53,18,35,FMN 06 B Zurenborgbrug Ringfietspad
655,Ringfietspad Zurenborgbrug,2022-11-19,21:00:00,41,26,15,FMN 06 B Zurenborgbrug Ringfietspad
655,Ringfietspad Zurenborgbrug,2022-11-19,22:00:00,39,23,16,FMN 06 B Zurenborgbrug Ringfietspad
655,Ringfietspad Zurenborgbrug,2022-11-19,23:00:00,54,21,33,FMN 06 B Zurenborgbrug Ringfietspad
655,Ringfietspad Zurenborgbrug,2022-11-20,00:00:00,27,15,12,FMN 06 B Zurenborgbrug Ringfietspad
655,Ringfietspad Zurenborgbrug,2022-11-20,01:00:00,17,11,6,FMN 06 B Zurenborgbrug Ringfietspad
655,Ringfietspad Zurenborgbrug,2022-11-20,02:00:00,15,4,11,FMN 06 B Zurenborgbrug Ringfietspad
655,Ringfietspad Zurenborgbrug,2022-11-20,03:00:00,10,7,3,FMN 06 B Zurenborgbrug Ringfietspad
655,Ringfietspad Zurenborgbrug,2022-11-20,04:00:00,4,2,2,FMN 06 B Zurenborgbrug Ringfietspad
655,Ringfietspad Zurenborgbrug,2022-11-20,05:00:00,5,3,2,FMN 06 B Zurenborgbrug Ringfietspad
655,Ringfietspad Zurenborgbrug,2022-11-20,06:00:00,18,8,10,FMN 06 B Zurenborgbrug Ringfietspad
655,Ringfietspad Zurenborgbrug,2022-11-20,07:00:00,18,9,9,FMN 06 B Zurenborgbrug Ringfietspad
655,Ringfietspad Zurenborgbrug,2022-11-20,08:00:00,26,17,9,FMN 06 B Zurenborgbrug Ringfietspad
655,Ringfietspad Zurenborgbrug,2022-11-20,09:00:00,59,38,21,FMN 06 B Zurenborgbrug Ringfietspad
655,Ringfietspad Zurenborgbrug,2022-11-20,10:00:00,69,27,42,FMN 06 B Zurenborgbrug Ringfietspad
655,Ringfietspad Zurenborgbrug,2022-11-20,11:00:00,66,30,36,FMN 06 B Zurenborgbrug Ringfietspad
655,Ringfietspad Zurenborgbrug,2022-11-20,12:00:00,84,40,44,FMN 06 B Zurenborgbrug Ringfietspad
655,Ringfietspad Zurenborgbrug,2022-11-20,13:00:00,80,44,36,FMN 06 B Zurenborgbrug Ringfietspad
655,Ringfietspad Zurenborgbrug,2022-11-20,14:00:00,53,23,30,FMN 06 B Zurenborgbrug Ringfietspad
655,Ringfietspad Zurenborgbrug,2022-11-20,15:00:00,76,29,47,FMN 06 B Zurenborgbrug Ringfietspad
655,Ringfietspad Zurenborgbrug,2022-11-20,16:00:00,49,24,25,FMN 06 B Zurenborgbrug Ringfietspad
655,Ringfietspad Zurenborgbrug,2022-11-20,17:00:00,75,32,43,FMN 06 B Zurenborgbrug Ringfietspad
655,Ringfietspad Zurenborgbrug,2022-11-20,18:00:00,46,18,28,FMN 06 B Zurenborgbrug Ringfietspad
655,Ringfietspad Zurenborgbrug,2022-11-20,19:00:00,64,29,35,FMN 06 B Zurenborgbrug Ringfietspad
655,Ringfietspad Zurenborgbrug,2022-11-20,20:00:00,40,17,23,FMN 06 B Zurenborgbrug Ringfietspad
655,Ringfietspad Zurenborgbrug,2022-11-20,21:00:00,25,6,19,FMN 06 B Zurenborgbrug Ringfietspad
655,Ringfietspad Zurenborgbrug,2022-11-20,22:00:00,32,15,17,FMN 06 B Zurenborgbrug Ringfietspad
655,Ringfietspad Zurenborgbrug,2022-11-20,23:00:00,12,6,6,FMN 06 B Zurenborgbrug Ringfietspad
655,Ringfietspad Zurenborgbrug,2022-11-21,00:00:00,1,0,1,FMN 06 B Zurenborgbrug Ringfietspad
655,Ringfietspad Zurenborgbrug,2022-11-21,01:00:00,2,1,1,FMN 06 B Zurenborgbrug Ringfietspad
655,Ringfietspad Zurenborgbrug,2022-11-21,02:00:00,1,1,0,FMN 06 B Zurenborgbrug Ringfietspad
655,Ringfietspad Zurenborgbrug,2022-11-21,03:00:00,1,0,1,FMN 06 B Zurenborgbrug Ringfietspad
655,Ringfietspad Zurenborgbrug,2022-11-21,04:00:00,8,6,2,FMN 06 B Zurenborgbrug Ringfietspad
655,Ringfietspad Zurenborgbrug,2022-11-21,05:00:00,49,24,25,FMN 06 B Zurenborgbrug Ringfietspad
655,Ringfietspad Zurenborgbrug,2022-11-21,06:00:00,128,71,57,FMN 06 B Zurenborgbrug Ringfietspad
655,Ringfietspad Zurenborgbrug,2022-11-21,07:00:00,371,215,156,FMN 06 B Zurenborgbrug Ringfietspad
655,Ringfietspad Zurenborgbrug,2022-11-21,08:00:00,544,292,252,FMN 06 B Zurenborgbrug Ringfietspad
655,Ringfietspad Zurenborgbrug,2022-11-21,09:00:00,129,79,50,FMN 06 B Zurenborgbrug Ringfietspad
655,Ringfietspad Zurenborgbrug,2022-11-21,10:00:00,101,53,48,FMN 06 B Zurenborgbrug Ringfietspad
655,Ringfietspad Zurenborgbrug,2022-11-21,11:00:00,80,40,40,FMN 06 B Zurenborgbrug Ringfietspad
655,Ringfietspad Zurenborgbrug,2022-11-21,12:00:00,175,88,87,FMN 06 B Zurenborgbrug Ringfietspad
655,Ringfietspad Zurenborgbrug,2022-11-21,13:00:00,153,64,89,FMN 06 B Zurenborgbrug Ringfietspad
655,Ringfietspad Zurenborgbrug,2022-11-21,14:00:00,135,52,83,FMN 06 B Zurenborgbrug Ringfietspad
655,Ringfietspad Zurenborgbrug,2022-11-21,15:00:00,275,114,161,FMN 06 B Zurenborgbrug Ringfietspad
655,Ringfietspad Zurenborgbrug,2022-11-21,16:00:00,458,185,273,FMN 06 B Zurenborgbrug Ringfietspad
655,Ringfietspad Zurenborgbrug,2022-11-21,17:00:00,372,141,231,FMN 06 B Zurenborgbrug Ringfietspad
655,Ringfietspad Zurenborgbrug,2022-11-21,18:00:00,202,80,122,FMN 06 B Zurenborgbrug Ringfietspad
655,Ringfietspad Zurenborgbrug,2022-11-21,19:00:00,102,33,69,FMN 06 B Zurenborgbrug Ringfietspad
655,Ringfietspad Zurenborgbrug,2022-11-21,20:00:00,63,24,39,FMN 06 B Zurenborgbrug Ringfietspad
655,Ringfietspad Zurenborgbrug,2022-11-21,21:00:00,53,25,28,FMN 06 B Zurenborgbrug Ringfietspad
655,Ringfietspad Zurenborgbrug,2022-11-21,22:00:00,74,29,45,FMN 06 B Zurenborgbrug Ringfietspad
655,Ringfietspad Zurenborgbrug,2022-11-21,23:00:00,21,12,9,FMN 06 B Zurenborgbrug Ringfietspad
655,Ringfietspad Zurenborgbrug,2022-11-22,00:00:00,11,6,5,FMN 06 B Zurenborgbrug Ringfietspad
655,Ringfietspad Zurenborgbrug,2022-11-22,01:00:00,5,1,4,FMN 06 B Zurenborgbrug Ringfietspad
655,Ringfietspad Zurenborgbrug,2022-11-22,02:00:00,1,1,0,FMN 06 B Zurenborgbrug Ringfietspad
655,Ringfietspad Zurenborgbrug,2022-11-22,03:00:00,2,1,1,FMN 06 B Zurenborgbrug Ringfietspad
655,Ringfietspad Zurenborgbrug,2022-11-22,04:00:00,12,5,7,FMN 06 B Zurenborgbrug Ringfietspad
655,Ringfietspad Zurenborgbrug,2022-11-22,05:00:00,49,24,25,FMN 06 B Zurenborgbrug Ringfietspad
655,Ringfietspad Zurenborgbrug,2022-11-22,06:00:00,146,86,60,FMN 06 B Zurenborgbrug Ringfietspad
655,Ringfietspad Zurenborgbrug,2022-11-22,07:00:00,382,221,161,FMN 06 B Zurenborgbrug Ringfietspad
655,Ringfietspad Zurenborgbrug,2022-11-22,08:00:00,613,337,276,FMN 06 B Zurenborgbrug Ringfietspad
655,Ringfietspad Zurenborgbrug,2022-11-22,09:00:00,160,92,68,FMN 06 B Zurenborgbrug Ringfietspad
655,Ringfietspad Zurenborgbrug,2022-11-22,10:00:00,90,50,40,FMN 06 B Zurenborgbrug Ringfietspad
655,Ringfietspad Zurenborgbrug,2022-11-22,11:00:00,84,38,46,FMN 06 B Zurenborgbrug Ringfietspad
655,Ringfietspad Zurenborgbrug,2022-11-22,12:00:00,128,65,63,FMN 06 B Zurenborgbrug Ringfietspad
655,Ringfietspad Zurenborgbrug,2022-11-22,13:00:00,161,70,91,FMN 06 B Zurenborgbrug Ringfietspad
655,Ringfietspad Zurenborgbrug,2022-11-22,14:00:00,126,46,80,FMN 06 B Zurenborgbrug Ringfietspad
655,Ringfietspad Zurenborgbrug,2022-11-22,15:00:00,228,85,143,FMN 06 B Zurenborgbrug Ringfietspad
655,Ringfietspad Zurenborgbrug,2022-11-22,16:00:00,482,166,316,FMN 06 B Zurenborgbrug Ringfietspad
655,Ringfietspad Zurenborgbrug,2022-11-22,17:00:00,452,147,305,FMN 06 B Zurenborgbrug Ringfietspad
655,Ringfietspad Zurenborgbrug,2022-11-22,18:00:00,237,83,154,FMN 06 B Zurenborgbrug Ringfietspad
655,Ringfietspad Zurenborgbrug,2022-11-22,19:00:00,130,44,86,FMN 06 B Zurenborgbrug Ringfietspad
655,Ringfietspad Zurenborgbrug,2022-11-22,20:00:00,74,38,36,FMN 06 B Zurenborgbrug Ringfietspad
655,Ringfietspad Zurenborgbrug,2022-11-22,21:00:00,60,26,34,FMN 06 B Zurenborgbrug Ringfietspad
655,Ringfietspad Zurenborgbrug,2022-11-22,22:00:00,68,23,45,FMN 06 B Zurenborgbrug Ringfietspad
655,Ringfietspad Zurenborgbrug,2022-11-22,23:00:00,35,18,17,FMN 06 B Zurenborgbrug Ringfietspad
655,Ringfietspad Zurenborgbrug,2022-11-23,00:00:00,10,3,7,FMN 06 B Zurenborgbrug Ringfietspad
655,Ringfietspad Zurenborgbrug,2022-11-23,01:00:00,8,4,4,FMN 06 B Zurenborgbrug Ringfietspad
655,Ringfietspad Zurenborgbrug,2022-11-23,02:00:00,5,1,4,FMN 06 B Zurenborgbrug Ringfietspad
655,Ringfietspad Zurenborgbrug,2022-11-23,03:00:00,3,2,1,FMN 06 B Zurenborgbrug Ringfietspad
655,Ringfietspad Zurenborgbrug,2022-11-23,04:00:00,14,8,6,FMN 06 B Zurenborgbrug Ringfietspad
655,Ringfietspad Zurenborgbrug,2022-11-23,05:00:00,55,31,24,FMN 06 B Zurenborgbrug Ringfietspad
655,Ringfietspad Zurenborgbrug,2022-11-23,06:00:00,103,52,51,FMN 06 B Zurenborgbrug Ringfietspad
655,Ringfietspad Zurenborgbrug,2022-11-23,07:00:00,331,182,149,FMN 06 B Zurenborgbrug Ringfietspad
655,Ringfietspad Zurenborgbrug,2022-11-23,08:00:00,484,278,206,FMN 06 B Zurenborgbrug Ringfietspad
655,Ringfietspad Zurenborgbrug,2022-11-23,09:00:00,129,67,62,FMN 06 B Zurenborgbrug Ringfietspad
655,Ringfietspad Zurenborgbrug,2022-11-23,10:00:00,106,56,50,FMN 06 B Zurenborgbrug Ringfietspad
655,Ringfietspad Zurenborgbrug,2022-11-23,11:00:00,79,40,39,FMN 06 B Zurenborgbrug Ringfietspad
655,Ringfietspad Zurenborgbrug,2022-11-23,12:00:00,254,127,127,FMN 06 B Zurenborgbrug Ringfietspad
655,Ringfietspad Zurenborgbrug,2022-11-23,13:00:00,156,68,88,FMN 06 B Zurenborgbrug Ringfietspad
655,Ringfietspad Zurenborgbrug,2022-11-23,14:00:00,81,37,44,FMN 06 B Zurenborgbrug Ringfietspad
655,Ringfietspad Zurenborgbrug,2022-11-23,15:00:00,153,55,98,FMN 06 B Zurenborgbrug Ringfietspad
655,Ringfietspad Zurenborgbrug,2022-11-23,16:00:00,272,94,178,FMN 06 B Zurenborgbrug Ringfietspad
655,Ringfietspad Zurenborgbrug,2022-11-23,17:00:00,352,120,232,FMN 06 B Zurenborgbrug Ringfietspad
655,Ringfietspad Zurenborgbrug,2022-11-23,18:00:00,215,88,127,FMN 06 B Zurenborgbrug Ringfietspad
655,Ringfietspad Zurenborgbrug,2022-11-23,19:00:00,141,47,94,FMN 06 B Zurenborgbrug Ringfietspad
655,Ringfietspad Zurenborgbrug,2022-11-23,20:00:00,68,21,47,FMN 06 B Zurenborgbrug Ringfietspad
655,Ringfietspad Zurenborgbrug,2022-11-23,21:00:00,63,27,36,FMN 06 B Zurenborgbrug Ringfietspad
655,Ringfietspad Zurenborgbrug,2022-11-23,22:00:00,95,38,57,FMN 06 B Zurenborgbrug Ringfietspad
655,Ringfietspad Zurenborgbrug,2022-11-23,23:00:00,53,39,14,FMN 06 B Zurenborgbrug Ringfietspad
655,Ringfietspad Zurenborgbrug,2022-11-24,00:00:00,20,15,5,FMN 06 B Zurenborgbrug Ringfietspad
655,Ringfietspad Zurenborgbrug,2022-11-24,01:00:00,3,2,1,FMN 06 B Zurenborgbrug Ringfietspad
655,Ringfietspad Zurenborgbrug,2022-11-24,02:00:00,1,0,1,FMN 06 B Zurenborgbrug Ringfietspad
655,Ringfietspad Zurenborgbrug,2022-11-24,03:00:00,2,2,0,FMN 06 B Zurenborgbrug Ringfietspad
655,Ringfietspad Zurenborgbrug,2022-11-24,04:00:00,6,2,4,FMN 06 B Zurenborgbrug Ringfietspad
655,Ringfietspad Zurenborgbrug,2022-11-24,05:00:00,49,29,20,FMN 06 B Zurenborgbrug Ringfietspad
655,Ringfietspad Zurenborgbrug,2022-11-24,06:00:00,121,77,44,FMN 06 B Zurenborgbrug Ringfietspad
655,Ringfietspad Zurenborgbrug,2022-11-24,07:00:00,388,226,162,FMN 06 B Zurenborgbrug Ringfietspad
655,Ringfietspad Zurenborgbrug,2022-11-24,08:00:00,621,361,260,FMN 06 B Zurenborgbrug Ringfietspad
655,Ringfietspad Zurenborgbrug,2022-11-24,09:00:00,152,90,62,FMN 06 B Zurenborgbrug Ringfietspad
655,Ringfietspad Zurenborgbrug,2022-11-24,10:00:00,145,94,51,FMN 06 B Zurenborgbrug Ringfietspad
655,Ringfietspad Zurenborgbrug,2022-11-24,11:00:00,78,29,49,FMN 06 B Zurenborgbrug Ringfietspad
655,Ringfietspad Zurenborgbrug,2022-11-24,12:00:00,165,82,83,FMN 06 B Zurenborgbrug Ringfietspad
655,Ringfietspad Zurenborgbrug,2022-11-24,13:00:00,157,69,88,FMN 06 B Zurenborgbrug Ringfietspad
655,Ringfietspad Zurenborgbrug,2022-11-24,14:00:00,135,56,79,FMN 06 B Zurenborgbrug Ringfietspad
655,Ringfietspad Zurenborgbrug,2022-11-24,15:00:00,309,109,200,FMN 06 B Zurenborgbrug Ringfietspad
655,Ringfietspad Zurenborgbrug,2022-11-24,16:00:00,472,197,275,FMN 06 B Zurenborgbrug Ringfietspad
655,Ringfietspad Zurenborgbrug,2022-11-24,17:00:00,454,155,299,FMN 06 B Zurenborgbrug Ringfietspad
655,Ringfietspad Zurenborgbrug,2022-11-24,18:00:00,256,102,154,FMN 06 B Zurenborgbrug Ringfietspad
655,Ringfietspad Zurenborgbrug,2022-11-24,19:00:00,158,55,103,FMN 06 B Zurenborgbrug Ringfietspad
655,Ringfietspad Zurenborgbrug,2022-11-24,20:00:00,91,34,57,FMN 06 B Zurenborgbrug Ringfietspad
655,Ringfietspad Zurenborgbrug,2022-11-24,21:00:00,79,32,47,FMN 06 B Zurenborgbrug Ringfietspad
655,Ringfietspad Zurenborgbrug,2022-11-24,22:00:00,102,32,70,FMN 06 B Zurenborgbrug Ringfietspad
655,Ringfietspad Zurenborgbrug,2022-11-24,23:00:00,45,26,19,FMN 06 B Zurenborgbrug Ringfietspad
655,Ringfietspad Zurenborgbrug,2022-11-25,00:00:00,18,9,9,FMN 06 B Zurenborgbrug Ringfietspad
655,Ringfietspad Zurenborgbrug,2022-11-25,01:00:00,11,7,4,FMN 06 B Zurenborgbrug Ringfietspad
655,Ringfietspad Zurenborgbrug,2022-11-25,02:00:00,4,2,2,FMN 06 B Zurenborgbrug Ringfietspad
655,Ringfietspad Zurenborgbrug,2022-11-25,03:00:00,1,1,0,FMN 06 B Zurenborgbrug Ringfietspad
655,Ringfietspad Zurenborgbrug,2022-11-25,04:00:00,10,6,4,FMN 06 B Zurenborgbrug Ringfietspad
655,Ringfietspad Zurenborgbrug,2022-11-25,05:00:00,51,29,22,FMN 06 B Zurenborgbrug Ringfietspad
655,Ringfietspad Zurenborgbrug,2022-11-25,06:00:00,97,59,38,FMN 06 B Zurenborgbrug Ringfietspad
655,Ringfietspad Zurenborgbrug,2022-11-25,07:00:00,349,189,160,FMN 06 B Zurenborgbrug Ringfietspad
655,Ringfietspad Zurenborgbrug,2022-11-25,08:00:00,494,272,222,FMN 06 B Zurenborgbrug Ringfietspad
655,Ringfietspad Zurenborgbrug,2022-11-25,09:00:00,129,83,46,FMN 06 B Zurenborgbrug Ringfietspad
655,Ringfietspad Zurenborgbrug,2022-11-25,10:00:00,103,63,40,FMN 06 B Zurenborgbrug Ringfietspad
655,Ringfietspad Zurenborgbrug,2022-11-25,11:00:00,94,44,50,FMN 06 B Zurenborgbrug Ringfietspad
655,Ringfietspad Zurenborgbrug,2022-11-25,12:00:00,165,72,93,FMN 06 B Zurenborgbrug Ringfietspad
655,Ringfietspad Zurenborgbrug,2022-11-25,13:00:00,151,64,87,FMN 06 B Zurenborgbrug Ringfietspad
655,Ringfietspad Zurenborgbrug,2022-11-25,14:00:00,163,69,94,FMN 06 B Zurenborgbrug Ringfietspad
655,Ringfietspad Zurenborgbrug,2022-11-25,15:00:00,283,105,178,FMN 06 B Zurenborgbrug Ringfietspad
655,Ringfietspad Zurenborgbrug,2022-11-25,16:00:00,434,174,260,FMN 06 B Zurenborgbrug Ringfietspad
655,Ringfietspad Zurenborgbrug,2022-11-25,17:00:00,337,122,215,FMN 06 B Zurenborgbrug Ringfietspad
655,Ringfietspad Zurenborgbrug,2022-11-25,18:00:00,169,66,103,FMN 06 B Zurenborgbrug Ringfietspad
655,Ringfietspad Zurenborgbrug,2022-11-25,19:00:00,101,43,58,FMN 06 B Zurenborgbrug Ringfietspad
655,Ringfietspad Zurenborgbrug,2022-11-25,20:00:00,73,30,43,FMN 06 B Zurenborgbrug Ringfietspad
655,Ringfietspad Zurenborgbrug,2022-11-25,21:00:00,56,23,33,FMN 06 B Zurenborgbrug Ringfietspad
655,Ringfietspad Zurenborgbrug,2022-11-25,22:00:00,55,21,34,FMN 06 B Zurenborgbrug Ringfietspad
655,Ringfietspad Zurenborgbrug,2022-11-25,23:00:00,53,21,32,FMN 06 B Zurenborgbrug Ringfietspad
655,Ringfietspad Zurenborgbrug,2022-11-26,00:00:00,48,17,31,FMN 06 B Zurenborgbrug Ringfietspad
655,Ringfietspad Zurenborgbrug,2022-11-26,01:00:00,30,9,21,FMN 06 B Zurenborgbrug Ringfietspad
655,Ringfietspad Zurenborgbrug,2022-11-26,02:00:00,5,3,2,FMN 06 B Zurenborgbrug Ringfietspad
655,Ringfietspad Zurenborgbrug,2022-11-26,03:00:00,7,5,2,FMN 06 B Zurenborgbrug Ringfietspad
655,Ringfietspad Zurenborgbrug,2022-11-26,04:00:00,8,4,4,FMN 06 B Zurenborgbrug Ringfietspad
655,Ringfietspad Zurenborgbrug,2022-11-26,05:00:00,18,12,6,FMN 06 B Zurenborgbrug Ringfietspad
655,Ringfietspad Zurenborgbrug,2022-11-26,06:00:00,22,12,10,FMN 06 B Zurenborgbrug Ringfietspad
655,Ringfietspad Zurenborgbrug,2022-11-26,07:00:00,35,20,15,FMN 06 B Zurenborgbrug Ringfietspad
655,Ringfietspad Zurenborgbrug,2022-11-26,08:00:00,60,34,26,FMN 06 B Zurenborgbrug Ringfietspad
655,Ringfietspad Zurenborgbrug,2022-11-26,09:00:00,79,30,49,FMN 06 B Zurenborgbrug Ringfietspad
655,Ringfietspad Zurenborgbrug,2022-11-26,10:00:00,82,41,41,FMN 06 B Zurenborgbrug Ringfietspad
655,Ringfietspad Zurenborgbrug,2022-11-26,11:00:00,82,37,45,FMN 06 B Zurenborgbrug Ringfietspad
655,Ringfietspad Zurenborgbrug,2022-11-26,12:00:00,120,49,71,FMN 06 B Zurenborgbrug Ringfietspad
655,Ringfietspad Zurenborgbrug,2022-11-26,13:00:00,159,62,97,FMN 06 B Zurenborgbrug Ringfietspad
655,Ringfietspad Zurenborgbrug,2022-11-26,14:00:00,141,68,73,FMN 06 B Zurenborgbrug Ringfietspad
655,Ringfietspad Zurenborgbrug,2022-11-26,15:00:00,118,55,63,FMN 06 B Zurenborgbrug Ringfietspad
655,Ringfietspad Zurenborgbrug,2022-11-26,16:00:00,123,68,55,FMN 06 B Zurenborgbrug Ringfietspad
655,Ringfietspad Zurenborgbrug,2022-11-26,17:00:00,112,56,56,FMN 06 B Zurenborgbrug Ringfietspad
655,Ringfietspad Zurenborgbrug,2022-11-26,18:00:00,103,48,55,FMN 06 B Zurenborgbrug Ringfietspad
655,Ringfietspad Zurenborgbrug,2022-11-26,19:00:00,83,40,43,FMN 06 B Zurenborgbrug Ringfietspad
655,Ringfietspad Zurenborgbrug,2022-11-26,20:00:00,61,24,37,FMN 06 B Zurenborgbrug Ringfietspad
655,Ringfietspad Zurenborgbrug,2022-11-26,21:00:00,55,28,27,FMN 06 B Zurenborgbrug Ringfietspad
655,Ringfietspad Zurenborgbrug,2022-11-26,22:00:00,49,23,26,FMN 06 B Zurenborgbrug Ringfietspad
655,Ringfietspad Zurenborgbrug,2022-11-26,23:00:00,38,16,22,FMN 06 B Zurenborgbrug Ringfietspad
655,Ringfietspad Zurenborgbrug,2022-11-27,00:00:00,41,22,19,FMN 06 B Zurenborgbrug Ringfietspad
655,Ringfietspad Zurenborgbrug,2022-11-27,01:00:00,15,11,4,FMN 06 B Zurenborgbrug Ringfietspad
655,Ringfietspad Zurenborgbrug,2022-11-27,02:00:00,19,6,13,FMN 06 B Zurenborgbrug Ringfietspad
655,Ringfietspad Zurenborgbrug,2022-11-27,03:00:00,3,1,2,FMN 06 B Zurenborgbrug Ringfietspad
655,Ringfietspad Zurenborgbrug,2022-11-27,04:00:00,5,3,2,FMN 06 B Zurenborgbrug Ringfietspad
655,Ringfietspad Zurenborgbrug,2022-11-27,05:00:00,11,8,3,FMN 06 B Zurenborgbrug Ringfietspad
655,Ringfietspad Zurenborgbrug,2022-11-27,06:00:00,13,9,4,FMN 06 B Zurenborgbrug Ringfietspad
655,Ringfietspad Zurenborgbrug,2022-11-27,07:00:00,9,4,5,FMN 06 B Zurenborgbrug Ringfietspad
655,Ringfietspad Zurenborgbrug,2022-11-27,08:00:00,27,6,21,FMN 06 B Zurenborgbrug Ringfietspad
655,Ringfietspad Zurenborgbrug,2022-11-27,09:00:00,44,20,24,FMN 06 B Zurenborgbrug Ringfietspad
655,Ringfietspad Zurenborgbrug,2022-11-27,10:00:00,53,29,24,FMN 06 B Zurenborgbrug Ringfietspad
655,Ringfietspad Zurenborgbrug,2022-11-27,11:00:00,63,33,30,FMN 06 B Zurenborgbrug Ringfietspad
655,Ringfietspad Zurenborgbrug,2022-11-27,12:00:00,59,41,18,FMN 06 B Zurenborgbrug Ringfietspad
655,Ringfietspad Zurenborgbrug,2022-11-27,13:00:00,101,41,60,FMN 06 B Zurenborgbrug Ringfietspad
655,Ringfietspad Zurenborgbrug,2022-11-27,14:00:00,57,30,27,FMN 06 B Zurenborgbrug Ringfietspad
655,Ringfietspad Zurenborgbrug,2022-11-27,15:00:00,46,17,29,FMN 06 B Zurenborgbrug Ringfietspad
655,Ringfietspad Zurenborgbrug,2022-11-27,16:00:00,68,36,32,FMN 06 B Zurenborgbrug Ringfietspad
655,Ringfietspad Zurenborgbrug,2022-11-27,17:00:00,53,23,30,FMN 06 B Zurenborgbrug Ringfietspad
655,Ringfietspad Zurenborgbrug,2022-11-27,18:00:00,47,26,21,FMN 06 B Zurenborgbrug Ringfietspad
655,Ringfietspad Zurenborgbrug,2022-11-27,19:00:00,26,11,15,FMN 06 B Zurenborgbrug Ringfietspad
655,Ringfietspad Zurenborgbrug,2022-11-27,20:00:00,25,13,12,FMN 06 B Zurenborgbrug Ringfietspad
655,Ringfietspad Zurenborgbrug,2022-11-27,21:00:00,12,9,3,FMN 06 B Zurenborgbrug Ringfietspad
655,Ringfietspad Zurenborgbrug,2022-11-27,22:00:00,18,9,9,FMN 06 B Zurenborgbrug Ringfietspad
655,Ringfietspad Zurenborgbrug,2022-11-27,23:00:00,4,1,3,FMN 06 B Zurenborgbrug Ringfietspad
655,Ringfietspad Zurenborgbrug,2022-11-28,00:00:00,5,4,1,FMN 06 B Zurenborgbrug Ringfietspad
655,Ringfietspad Zurenborgbrug,2022-11-28,01:00:00,4,1,3,FMN 06 B Zurenborgbrug Ringfietspad
655,Ringfietspad Zurenborgbrug,2022-11-28,02:00:00,0,0,0,FMN 06 B Zurenborgbrug Ringfietspad
655,Ringfietspad Zurenborgbrug,2022-11-28,03:00:00,1,0,1,FMN 06 B Zurenborgbrug Ringfietspad
655,Ringfietspad Zurenborgbrug,2022-11-28,04:00:00,12,6,6,FMN 06 B Zurenborgbrug Ringfietspad
655,Ringfietspad Zurenborgbrug,2022-11-28,05:00:00,42,23,19,FMN 06 B Zurenborgbrug Ringfietspad
655,Ringfietspad Zurenborgbrug,2022-11-28,06:00:00,98,62,36,FMN 06 B Zurenborgbrug Ringfietspad
655,Ringfietspad Zurenborgbrug,2022-11-28,07:00:00,339,189,150,FMN 06 B Zurenborgbrug Ringfietspad
655,Ringfietspad Zurenborgbrug,2022-11-28,08:00:00,548,336,212,FMN 06 B Zurenborgbrug Ringfietspad
655,Ringfietspad Zurenborgbrug,2022-11-28,09:00:00,120,63,57,FMN 06 B Zurenborgbrug Ringfietspad
655,Ringfietspad Zurenborgbrug,2022-11-28,10:00:00,73,42,31,FMN 06 B Zurenborgbrug Ringfietspad
655,Ringfietspad Zurenborgbrug,2022-11-28,11:00:00,73,35,38,FMN 06 B Zurenborgbrug Ringfietspad
655,Ringfietspad Zurenborgbrug,2022-11-28,12:00:00,149,77,72,FMN 06 B Zurenborgbrug Ringfietspad
655,Ringfietspad Zurenborgbrug,2022-11-28,13:00:00,138,63,75,FMN 06 B Zurenborgbrug Ringfietspad
655,Ringfietspad Zurenborgbrug,2022-11-28,14:00:00,121,52,69,FMN 06 B Zurenborgbrug Ringfietspad
655,Ringfietspad Zurenborgbrug,2022-11-28,15:00:00,267,115,152,FMN 06 B Zurenborgbrug Ringfietspad
655,Ringfietspad Zurenborgbrug,2022-11-28,16:00:00,385,152,233,FMN 06 B Zurenborgbrug Ringfietspad
655,Ringfietspad Zurenborgbrug,2022-11-28,17:00:00,406,147,259,FMN 06 B Zurenborgbrug Ringfietspad
655,Ringfietspad Zurenborgbrug,2022-11-28,18:00:00,246,94,152,FMN 06 B Zurenborgbrug Ringfietspad
655,Ringfietspad Zurenborgbrug,2022-11-28,19:00:00,100,32,68,FMN 06 B Zurenborgbrug Ringfietspad
655,Ringfietspad Zurenborgbrug,2022-11-28,20:00:00,85,31,54,FMN 06 B Zurenborgbrug Ringfietspad
655,Ringfietspad Zurenborgbrug,2022-11-28,21:00:00,65,26,39,FMN 06 B Zurenborgbrug Ringfietspad
655,Ringfietspad Zurenborgbrug,2022-11-28,22:00:00,63,25,38,FMN 06 B Zurenborgbrug Ringfietspad
655,Ringfietspad Zurenborgbrug,2022-11-28,23:00:00,13,4,9,FMN 06 B Zurenborgbrug Ringfietspad
655,Ringfietspad Zurenborgbrug,2022-11-29,00:00:00,3,1,2,FMN 06 B Zurenborgbrug Ringfietspad
655,Ringfietspad Zurenborgbrug,2022-11-29,01:00:00,4,3,1,FMN 06 B Zurenborgbrug Ringfietspad
655,Ringfietspad Zurenborgbrug,2022-11-29,02:00:00,2,0,2,FMN 06 B Zurenborgbrug Ringfietspad
655,Ringfietspad Zurenborgbrug,2022-11-29,03:00:00,3,2,1,FMN 06 B Zurenborgbrug Ringfietspad
655,Ringfietspad Zurenborgbrug,2022-11-29,04:00:00,14,9,5,FMN 06 B Zurenborgbrug Ringfietspad
655,Ringfietspad Zurenborgbrug,2022-11-29,05:00:00,56,30,26,FMN 06 B Zurenborgbrug Ringfietspad
655,Ringfietspad Zurenborgbrug,2022-11-29,06:00:00,135,78,57,FMN 06 B Zurenborgbrug Ringfietspad
655,Ringfietspad Zurenborgbrug,2022-11-29,07:00:00,427,249,178,FMN 06 B Zurenborgbrug Ringfietspad
655,Ringfietspad Zurenborgbrug,2022-11-29,08:00:00,133,73,60,FMN 06 B Zurenborgbrug Ringfietspad
655,Ringfietspad Zurenborgbrug,2022-11-29,09:00:00,179,94,85,FMN 06 B Zurenborgbrug Ringfietspad
655,Ringfietspad Zurenborgbrug,2022-11-29,10:00:00,95,50,45,FMN 06 B Zurenborgbrug Ringfietspad
655,Ringfietspad Zurenborgbrug,2022-11-29,11:00:00,88,37,51,FMN 06 B Zurenborgbrug Ringfietspad
655,Ringfietspad Zurenborgbrug,2022-11-29,12:00:00,147,77,70,FMN 06 B Zurenborgbrug Ringfietspad
655,Ringfietspad Zurenborgbrug,2022-11-29,13:00:00,155,74,81,FMN 06 B Zurenborgbrug Ringfietspad
655,Ringfietspad Zurenborgbrug,2022-11-29,14:00:00,150,60,90,FMN 06 B Zurenborgbrug Ringfietspad
655,Ringfietspad Zurenborgbrug,2022-11-29,15:00:00,233,88,145,FMN 06 B Zurenborgbrug Ringfietspad
655,Ringfietspad Zurenborgbrug,2022-11-29,16:00:00,546,216,330,FMN 06 B Zurenborgbrug Ringfietspad
655,Ringfietspad Zurenborgbrug,2022-11-29,17:00:00,434,135,299,FMN 06 B Zurenborgbrug Ringfietspad
655,Ringfietspad Zurenborgbrug,2022-11-29,18:00:00,252,88,164,FMN 06 B Zurenborgbrug Ringfietspad
655,Ringfietspad Zurenborgbrug,2022-11-29,19:00:00,127,52,75,FMN 06 B Zurenborgbrug Ringfietspad
655,Ringfietspad Zurenborgbrug,2022-11-29,20:00:00,69,28,41,FMN 06 B Zurenborgbrug Ringfietspad
655,Ringfietspad Zurenborgbrug,2022-11-29,21:00:00,66,27,39,FMN 06 B Zurenborgbrug Ringfietspad
655,Ringfietspad Zurenborgbrug,2022-11-29,22:00:00,59,21,38,FMN 06 B Zurenborgbrug Ringfietspad
655,Ringfietspad Zurenborgbrug,2022-11-29,23:00:00,0,0,0,FMN 06 B Zurenborgbrug Ringfietspad
655,Ringfietspad Zurenborgbrug,2022-11-30,00:00:00,0,0,0,FMN 06 B Zurenborgbrug Ringfietspad
655,Ringfietspad Zurenborgbrug,2022-11-30,01:00:00,0,0,0,FMN 06 B Zurenborgbrug Ringfietspad
655,Ringfietspad Zurenborgbrug,2022-11-30,02:00:00,0,0,0,FMN 06 B Zurenborgbrug Ringfietspad
655,Ringfietspad Zurenborgbrug,2022-11-30,03:00:00,0,0,0,FMN 06 B Zurenborgbrug Ringfietspad
655,Ringfietspad Zurenborgbrug,2022-11-30,04:00:00,0,0,0,FMN 06 B Zurenborgbrug Ringfietspad
655,Ringfietspad Zurenborgbrug,2022-11-30,05:00:00,0,0,0,FMN 06 B Zurenborgbrug Ringfietspad
655,Ringfietspad Zurenborgbrug,2022-11-30,06:00:00,0,0,0,FMN 06 B Zurenborgbrug Ringfietspad
655,Ringfietspad Zurenborgbrug,2022-11-30,07:00:00,0,0,0,FMN 06 B Zurenborgbrug Ringfietspad
655,Ringfietspad Zurenborgbrug,2022-11-30,08:00:00,0,0,0,FMN 06 B Zurenborgbrug Ringfietspad
655,Ringfietspad Zurenborgbrug,2022-11-30,09:00:00,96,59,37,FMN 06 B Zurenborgbrug Ringfietspad
655,Ringfietspad Zurenborgbrug,2022-11-30,10:00:00,82,47,35,FMN 06 B Zurenborgbrug Ringfietspad
655,Ringfietspad Zurenborgbrug,2022-11-30,11:00:00,96,39,57,FMN 06 B Zurenborgbrug Ringfietspad
655,Ringfietspad Zurenborgbrug,2022-11-30,12:00:00,294,154,140,FMN 06 B Zurenborgbrug Ringfietspad
655,Ringfietspad Zurenborgbrug,2022-11-30,13:00:00,212,83,129,FMN 06 B Zurenborgbrug Ringfietspad
655,Ringfietspad Zurenborgbrug,2022-11-30,14:00:00,145,69,76,FMN 06 B Zurenborgbrug Ringfietspad
655,Ringfietspad Zurenborgbrug,2022-11-30,15:00:00,171,68,103,FMN 06 B Zurenborgbrug Ringfietspad
655,Ringfietspad Zurenborgbrug,2022-11-30,16:00:00,294,102,192,FMN 06 B Zurenborgbrug Ringfietspad
655,Ringfietspad Zurenborgbrug,2022-11-30,17:00:00,397,140,257,FMN 06 B Zurenborgbrug Ringfietspad
655,Ringfietspad Zurenborgbrug,2022-11-30,18:00:00,231,93,138,FMN 06 B Zurenborgbrug Ringfietspad
655,Ringfietspad Zurenborgbrug,2022-11-30,19:00:00,46,19,27,FMN 06 B Zurenborgbrug Ringfietspad
655,Ringfietspad Zurenborgbrug,2022-11-30,20:00:00,0,0,0,FMN 06 B Zurenborgbrug Ringfietspad
655,Ringfietspad Zurenborgbrug,2022-11-30,21:00:00,0,0,0,FMN 06 B Zurenborgbrug Ringfietspad
655,Ringfietspad Zurenborgbrug,2022-11-30,22:00:00,0,0,0,FMN 06 B Zurenborgbrug Ringfietspad
655,Ringfietspad Zurenborgbrug,2022-11-30,23:00:00,0,0,0,FMN 06 B Zurenborgbrug Ringfietspad
655,Ringfietspad Zurenborgbrug,2022-12-01,00:00:00,0,0,0,FMN 06 B Zurenborgbrug Ringfietspad
655,Ringfietspad Zurenborgbrug,2022-12-01,01:00:00,0,0,0,FMN 06 B Zurenborgbrug Ringfietspad
655,Ringfietspad Zurenborgbrug,2022-12-01,02:00:00,0,0,0,FMN 06 B Zurenborgbrug Ringfietspad
655,Ringfietspad Zurenborgbrug,2022-12-01,03:00:00,0,0,0,FMN 06 B Zurenborgbrug Ringfietspad
655,Ringfietspad Zurenborgbrug,2022-12-01,04:00:00,0,0,0,FMN 06 B Zurenborgbrug Ringfietspad
655,Ringfietspad Zurenborgbrug,2022-12-01,05:00:00,0,0,0,FMN 06 B Zurenborgbrug Ringfietspad
655,Ringfietspad Zurenborgbrug,2022-12-01,06:00:00,0,0,0,FMN 06 B Zurenborgbrug Ringfietspad
655,Ringfietspad Zurenborgbrug,2022-12-01,07:00:00,0,0,0,FMN 06 B Zurenborgbrug Ringfietspad
655,Ringfietspad Zurenborgbrug,2022-12-01,08:00:00,0,0,0,FMN 06 B Zurenborgbrug Ringfietspad
655,Ringfietspad Zurenborgbrug,2022-12-01,09:00:00,113,60,53,FMN 06 B Zurenborgbrug Ringfietspad
655,Ringfietspad Zurenborgbrug,2022-12-01,10:00:00,110,70,40,FMN 06 B Zurenborgbrug Ringfietspad
655,Ringfietspad Zurenborgbrug,2022-12-01,11:00:00,93,41,52,FMN 06 B Zurenborgbrug Ringfietspad
655,Ringfietspad Zurenborgbrug,2022-12-01,12:00:00,149,72,77,FMN 06 B Zurenborgbrug Ringfietspad
655,Ringfietspad Zurenborgbrug,2022-12-01,13:00:00,150,64,86,FMN 06 B Zurenborgbrug Ringfietspad
655,Ringfietspad Zurenborgbrug,2022-12-01,14:00:00,133,50,83,FMN 06 B Zurenborgbrug Ringfietspad
655,Ringfietspad Zurenborgbrug,2022-12-01,15:00:00,329,121,208,FMN 06 B Zurenborgbrug Ringfietspad
655,Ringfietspad Zurenborgbrug,2022-12-01,16:00:00,457,168,289,FMN 06 B Zurenborgbrug Ringfietspad
655,Ringfietspad Zurenborgbrug,2022-12-01,17:00:00,353,109,244,FMN 06 B Zurenborgbrug Ringfietspad
655,Ringfietspad Zurenborgbrug,2022-12-01,18:00:00,286,96,190,FMN 06 B Zurenborgbrug Ringfietspad
655,Ringfietspad Zurenborgbrug,2022-12-01,19:00:00,169,82,87,FMN 06 B Zurenborgbrug Ringfietspad
655,Ringfietspad Zurenborgbrug,2022-12-01,20:00:00,71,28,43,FMN 06 B Zurenborgbrug Ringfietspad
655,Ringfietspad Zurenborgbrug,2022-12-01,21:00:00,79,32,47,FMN 06 B Zurenborgbrug Ringfietspad
655,Ringfietspad Zurenborgbrug,2022-12-01,22:00:00,74,23,51,FMN 06 B Zurenborgbrug Ringfietspad
655,Ringfietspad Zurenborgbrug,2022-12-01,23:00:00,36,18,18,FMN 06 B Zurenborgbrug Ringfietspad
655,Ringfietspad Zurenborgbrug,2022-12-02,00:00:00,24,19,5,FMN 06 B Zurenborgbrug Ringfietspad
655,Ringfietspad Zurenborgbrug,2022-12-02,01:00:00,5,0,5,FMN 06 B Zurenborgbrug Ringfietspad
655,Ringfietspad Zurenborgbrug,2022-12-02,02:00:00,0,0,0,FMN 06 B Zurenborgbrug Ringfietspad
655,Ringfietspad Zurenborgbrug,2022-12-02,03:00:00,0,0,0,FMN 06 B Zurenborgbrug Ringfietspad
655,Ringfietspad Zurenborgbrug,2022-12-02,04:00:00,0,0,0,FMN 06 B Zurenborgbrug Ringfietspad
655,Ringfietspad Zurenborgbrug,2022-12-02,05:00:00,0,0,0,FMN 06 B Zurenborgbrug Ringfietspad
655,Ringfietspad Zurenborgbrug,2022-12-02,06:00:00,0,0,0,FMN 06 B Zurenborgbrug Ringfietspad
655,Ringfietspad Zurenborgbrug,2022-12-02,07:00:00,0,0,0,FMN 06 B Zurenborgbrug Ringfietspad
655,Ringfietspad Zurenborgbrug,2022-12-02,08:00:00,0,0,0,FMN 06 B Zurenborgbrug Ringfietspad
655,Ringfietspad Zurenborgbrug,2022-12-02,09:00:00,23,11,12,FMN 06 B Zurenborgbrug Ringfietspad
655,Ringfietspad Zurenborgbrug,2022-12-02,10:00:00,99,62,37,FMN 06 B Zurenborgbrug Ringfietspad
655,Ringfietspad Zurenborgbrug,2022-12-02,11:00:00,91,52,39,FMN 06 B Zurenborgbrug Ringfietspad
655,Ringfietspad Zurenborgbrug,2022-12-02,12:00:00,127,68,59,FMN 06 B Zurenborgbrug Ringfietspad
655,Ringfietspad Zurenborgbrug,2022-12-02,13:00:00,140,66,74,FMN 06 B Zurenborgbrug Ringfietspad
655,Ringfietspad Zurenborgbrug,2022-12-02,14:00:00,144,48,96,FMN 06 B Zurenborgbrug Ringfietspad
655,Ringfietspad Zurenborgbrug,2022-12-02,15:00:00,221,69,152,FMN 06 B Zurenborgbrug Ringfietspad
655,Ringfietspad Zurenborgbrug,2022-12-02,16:00:00,393,148,245,FMN 06 B Zurenborgbrug Ringfietspad
655,Ringfietspad Zurenborgbrug,2022-12-02,17:00:00,319,103,216,FMN 06 B Zurenborgbrug Ringfietspad
655,Ringfietspad Zurenborgbrug,2022-12-02,18:00:00,172,58,114,FMN 06 B Zurenborgbrug Ringfietspad
655,Ringfietspad Zurenborgbrug,2022-12-02,19:00:00,134,47,87,FMN 06 B Zurenborgbrug Ringfietspad
655,Ringfietspad Zurenborgbrug,2022-12-02,20:00:00,72,40,32,FMN 06 B Zurenborgbrug Ringfietspad
655,Ringfietspad Zurenborgbrug,2022-12-02,21:00:00,37,9,28,FMN 06 B Zurenborgbrug Ringfietspad
655,Ringfietspad Zurenborgbrug,2022-12-02,22:00:00,62,23,39,FMN 06 B Zurenborgbrug Ringfietspad
655,Ringfietspad Zurenborgbrug,2022-12-02,23:00:00,63,30,33,FMN 06 B Zurenborgbrug Ringfietspad
655,Ringfietspad Zurenborgbrug,2022-12-03,00:00:00,32,17,15,FMN 06 B Zurenborgbrug Ringfietspad
655,Ringfietspad Zurenborgbrug,2022-12-03,01:00:00,21,7,14,FMN 06 B Zurenborgbrug Ringfietspad
655,Ringfietspad Zurenborgbrug,2022-12-03,02:00:00,13,5,8,FMN 06 B Zurenborgbrug Ringfietspad
655,Ringfietspad Zurenborgbrug,2022-12-03,03:00:00,19,8,11,FMN 06 B Zurenborgbrug Ringfietspad
655,Ringfietspad Zurenborgbrug,2022-12-03,04:00:00,11,6,5,FMN 06 B Zurenborgbrug Ringfietspad
655,Ringfietspad Zurenborgbrug,2022-12-03,05:00:00,15,8,7,FMN 06 B Zurenborgbrug Ringfietspad
655,Ringfietspad Zurenborgbrug,2022-12-03,06:00:00,27,18,9,FMN 06 B Zurenborgbrug Ringfietspad
655,Ringfietspad Zurenborgbrug,2022-12-03,07:00:00,19,10,9,FMN 06 B Zurenborgbrug Ringfietspad
655,Ringfietspad Zurenborgbrug,2022-12-03,08:00:00,46,26,20,FMN 06 B Zurenborgbrug Ringfietspad
655,Ringfietspad Zurenborgbrug,2022-12-03,09:00:00,70,30,40,FMN 06 B Zurenborgbrug Ringfietspad
655,Ringfietspad Zurenborgbrug,2022-12-03,10:00:00,62,27,35,FMN 06 B Zurenborgbrug Ringfietspad
655,Ringfietspad Zurenborgbrug,2022-12-03,11:00:00,73,36,37,FMN 06 B Zurenborgbrug Ringfietspad
655,Ringfietspad Zurenborgbrug,2022-12-03,12:00:00,96,50,46,FMN 06 B Zurenborgbrug Ringfietspad
655,Ringfietspad Zurenborgbrug,2022-12-03,13:00:00,100,45,55,FMN 06 B Zurenborgbrug Ringfietspad
655,Ringfietspad Zurenborgbrug,2022-12-03,14:00:00,109,40,69,FMN 06 B Zurenborgbrug Ringfietspad
655,Ringfietspad Zurenborgbrug,2022-12-03,15:00:00,103,44,59,FMN 06 B Zurenborgbrug Ringfietspad
655,Ringfietspad Zurenborgbrug,2022-12-03,16:00:00,102,42,60,FMN 06 B Zurenborgbrug Ringfietspad
655,Ringfietspad Zurenborgbrug,2022-12-03,17:00:00,110,48,62,FMN 06 B Zurenborgbrug Ringfietspad
655,Ringfietspad Zurenborgbrug,2022-12-03,18:00:00,60,28,32,FMN 06 B Zurenborgbrug Ringfietspad
655,Ringfietspad Zurenborgbrug,2022-12-03,19:00:00,84,25,59,FMN 06 B Zurenborgbrug Ringfietspad
655,Ringfietspad Zurenborgbrug,2022-12-03,20:00:00,47,19,28,FMN 06 B Zurenborgbrug Ringfietspad
655,Ringfietspad Zurenborgbrug,2022-12-03,21:00:00,27,9,18,FMN 06 B Zurenborgbrug Ringfietspad
655,Ringfietspad Zurenborgbrug,2022-12-03,22:00:00,47,22,25,FMN 06 B Zurenborgbrug Ringfietspad
655,Ringfietspad Zurenborgbrug,2022-12-03,23:00:00,51,30,21,FMN 06 B Zurenborgbrug Ringfietspad
655,Ringfietspad Zurenborgbrug,2022-12-04,00:00:00,32,14,18,FMN 06 B Zurenborgbrug Ringfietspad
655,Ringfietspad Zurenborgbrug,2022-12-04,01:00:00,21,8,13,FMN 06 B Zurenborgbrug Ringfietspad
655,Ringfietspad Zurenborgbrug,2022-12-04,02:00:00,17,8,9,FMN 06 B Zurenborgbrug Ringfietspad
655,Ringfietspad Zurenborgbrug,2022-12-04,03:00:00,5,2,3,FMN 06 B Zurenborgbrug Ringfietspad
655,Ringfietspad Zurenborgbrug,2022-12-04,04:00:00,6,6,0,FMN 06 B Zurenborgbrug Ringfietspad
655,Ringfietspad Zurenborgbrug,2022-12-04,05:00:00,5,2,3,FMN 06 B Zurenborgbrug Ringfietspad
655,Ringfietspad Zurenborgbrug,2022-12-04,06:00:00,13,7,6,FMN 06 B Zurenborgbrug Ringfietspad
655,Ringfietspad Zurenborgbrug,2022-12-04,07:00:00,10,6,4,FMN 06 B Zurenborgbrug Ringfietspad
655,Ringfietspad Zurenborgbrug,2022-12-04,08:00:00,35,13,22,FMN 06 B Zurenborgbrug Ringfietspad
655,Ringfietspad Zurenborgbrug,2022-12-04,09:00:00,71,30,41,FMN 06 B Zurenborgbrug Ringfietspad
655,Ringfietspad Zurenborgbrug,2022-12-04,10:00:00,50,22,28,FMN 06 B Zurenborgbrug Ringfietspad
655,Ringfietspad Zurenborgbrug,2022-12-04,11:00:00,72,28,44,FMN 06 B Zurenborgbrug Ringfietspad
655,Ringfietspad Zurenborgbrug,2022-12-04,12:00:00,75,42,33,FMN 06 B Zurenborgbrug Ringfietspad
655,Ringfietspad Zurenborgbrug,2022-12-04,13:00:00,71,29,42,FMN 06 B Zurenborgbrug Ringfietspad
655,Ringfietspad Zurenborgbrug,2022-12-04,14:00:00,69,25,44,FMN 06 B Zurenborgbrug Ringfietspad
655,Ringfietspad Zurenborgbrug,2022-12-04,15:00:00,68,32,36,FMN 06 B Zurenborgbrug Ringfietspad
655,Ringfietspad Zurenborgbrug,2022-12-04,16:00:00,66,42,24,FMN 06 B Zurenborgbrug Ringfietspad
655,Ringfietspad Zurenborgbrug,2022-12-04,17:00:00,66,26,40,FMN 06 B Zurenborgbrug Ringfietspad
655,Ringfietspad Zurenborgbrug,2022-12-04,18:00:00,50,23,27,FMN 06 B Zurenborgbrug Ringfietspad
655,Ringfietspad Zurenborgbrug,2022-12-04,19:00:00,25,10,15,FMN 06 B Zurenborgbrug Ringfietspad
655,Ringfietspad Zurenborgbrug,2022-12-04,20:00:00,26,8,18,FMN 06 B Zurenborgbrug Ringfietspad
655,Ringfietspad Zurenborgbrug,2022-12-04,21:00:00,27,10,17,FMN 06 B Zurenborgbrug Ringfietspad
655,Ringfietspad Zurenborgbrug,2022-12-04,22:00:00,25,12,13,FMN 06 B Zurenborgbrug Ringfietspad
655,Ringfietspad Zurenborgbrug,2022-12-04,23:00:00,12,4,8,FMN 06 B Zurenborgbrug Ringfietspad
655,Ringfietspad Zurenborgbrug,2022-12-05,00:00:00,5,4,1,FMN 06 B Zurenborgbrug Ringfietspad
655,Ringfietspad Zurenborgbrug,2022-12-05,01:00:00,3,2,1,FMN 06 B Zurenborgbrug Ringfietspad
655,Ringfietspad Zurenborgbrug,2022-12-05,02:00:00,4,1,3,FMN 06 B Zurenborgbrug Ringfietspad
655,Ringfietspad Zurenborgbrug,2022-12-05,03:00:00,1,0,1,FMN 06 B Zurenborgbrug Ringfietspad
655,Ringfietspad Zurenborgbrug,2022-12-05,04:00:00,11,7,4,FMN 06 B Zurenborgbrug Ringfietspad
655,Ringfietspad Zurenborgbrug,2022-12-05,05:00:00,36,19,17,FMN 06 B Zurenborgbrug Ringfietspad
655,Ringfietspad Zurenborgbrug,2022-12-05,06:00:00,85,44,41,FMN 06 B Zurenborgbrug Ringfietspad
655,Ringfietspad Zurenborgbrug,2022-12-05,07:00:00,296,163,133,FMN 06 B Zurenborgbrug Ringfietspad
655,Ringfietspad Zurenborgbrug,2022-12-05,08:00:00,477,280,197,FMN 06 B Zurenborgbrug Ringfietspad
655,Ringfietspad Zurenborgbrug,2022-12-05,09:00:00,128,71,57,FMN 06 B Zurenborgbrug Ringfietspad
655,Ringfietspad Zurenborgbrug,2022-12-05,10:00:00,60,34,26,FMN 06 B Zurenborgbrug Ringfietspad
655,Ringfietspad Zurenborgbrug,2022-12-05,11:00:00,64,30,34,FMN 06 B Zurenborgbrug Ringfietspad
655,Ringfietspad Zurenborgbrug,2022-12-05,12:00:00,144,67,77,FMN 06 B Zurenborgbrug Ringfietspad
655,Ringfietspad Zurenborgbrug,2022-12-05,13:00:00,112,52,60,FMN 06 B Zurenborgbrug Ringfietspad
655,Ringfietspad Zurenborgbrug,2022-12-05,14:00:00,87,33,54,FMN 06 B Zurenborgbrug Ringfietspad
655,Ringfietspad Zurenborgbrug,2022-12-05,15:00:00,205,72,133,FMN 06 B Zurenborgbrug Ringfietspad
655,Ringfietspad Zurenborgbrug,2022-12-05,16:00:00,335,133,202,FMN 06 B Zurenborgbrug Ringfietspad
655,Ringfietspad Zurenborgbrug,2022-12-05,17:00:00,342,118,224,FMN 06 B Zurenborgbrug Ringfietspad
655,Ringfietspad Zurenborgbrug,2022-12-05,18:00:00,189,70,119,FMN 06 B Zurenborgbrug Ringfietspad
655,Ringfietspad Zurenborgbrug,2022-12-05,19:00:00,77,32,45,FMN 06 B Zurenborgbrug Ringfietspad
655,Ringfietspad Zurenborgbrug,2022-12-05,20:00:00,65,33,32,FMN 06 B Zurenborgbrug Ringfietspad
655,Ringfietspad Zurenborgbrug,2022-12-05,21:00:00,49,12,37,FMN 06 B Zurenborgbrug Ringfietspad
655,Ringfietspad Zurenborgbrug,2022-12-05,22:00:00,49,18,31,FMN 06 B Zurenborgbrug Ringfietspad
655,Ringfietspad Zurenborgbrug,2022-12-05,23:00:00,18,5,13,FMN 06 B Zurenborgbrug Ringfietspad
655,Ringfietspad Zurenborgbrug,2022-12-06,00:00:00,4,1,3,FMN 06 B Zurenborgbrug Ringfietspad
655,Ringfietspad Zurenborgbrug,2022-12-06,01:00:00,2,1,1,FMN 06 B Zurenborgbrug Ringfietspad
655,Ringfietspad Zurenborgbrug,2022-12-06,02:00:00,2,0,2,FMN 06 B Zurenborgbrug Ringfietspad
655,Ringfietspad Zurenborgbrug,2022-12-06,03:00:00,2,1,1,FMN 06 B Zurenborgbrug Ringfietspad
655,Ringfietspad Zurenborgbrug,2022-12-06,04:00:00,13,6,7,FMN 06 B Zurenborgbrug Ringfietspad
655,Ringfietspad Zurenborgbrug,2022-12-06,05:00:00,49,27,22,FMN 06 B Zurenborgbrug Ringfietspad
655,Ringfietspad Zurenborgbrug,2022-12-06,06:00:00,130,75,55,FMN 06 B Zurenborgbrug Ringfietspad
655,Ringfietspad Zurenborgbrug,2022-12-06,07:00:00,397,218,179,FMN 06 B Zurenborgbrug Ringfietspad
655,Ringfietspad Zurenborgbrug,2022-12-06,08:00:00,573,342,231,FMN 06 B Zurenborgbrug Ringfietspad
655,Ringfietspad Zurenborgbrug,2022-12-06,09:00:00,135,77,58,FMN 06 B Zurenborgbrug Ringfietspad
655,Ringfietspad Zurenborgbrug,2022-12-06,10:00:00,93,51,42,FMN 06 B Zurenborgbrug Ringfietspad
655,Ringfietspad Zurenborgbrug,2022-12-06,11:00:00,91,50,41,FMN 06 B Zurenborgbrug Ringfietspad
655,Ringfietspad Zurenborgbrug,2022-12-06,12:00:00,165,86,79,FMN 06 B Zurenborgbrug Ringfietspad
655,Ringfietspad Zurenborgbrug,2022-12-06,13:00:00,142,66,76,FMN 06 B Zurenborgbrug Ringfietspad
655,Ringfietspad Zurenborgbrug,2022-12-06,14:00:00,133,61,72,FMN 06 B Zurenborgbrug Ringfietspad
655,Ringfietspad Zurenborgbrug,2022-12-06,15:00:00,250,99,151,FMN 06 B Zurenborgbrug Ringfietspad
655,Ringfietspad Zurenborgbrug,2022-12-06,16:00:00,414,173,241,FMN 06 B Zurenborgbrug Ringfietspad
655,Ringfietspad Zurenborgbrug,2022-12-06,17:00:00,414,125,289,FMN 06 B Zurenborgbrug Ringfietspad
655,Ringfietspad Zurenborgbrug,2022-12-06,18:00:00,219,80,139,FMN 06 B Zurenborgbrug Ringfietspad
655,Ringfietspad Zurenborgbrug,2022-12-06,19:00:00,114,48,66,FMN 06 B Zurenborgbrug Ringfietspad
655,Ringfietspad Zurenborgbrug,2022-12-06,20:00:00,62,27,35,FMN 06 B Zurenborgbrug Ringfietspad
655,Ringfietspad Zurenborgbrug,2022-12-06,21:00:00,52,18,34,FMN 06 B Zurenborgbrug Ringfietspad
655,Ringfietspad Zurenborgbrug,2022-12-06,22:00:00,75,24,51,FMN 06 B Zurenborgbrug Ringfietspad
655,Ringfietspad Zurenborgbrug,2022-12-06,23:00:00,29,13,16,FMN 06 B Zurenborgbrug Ringfietspad
655,Ringfietspad Zurenborgbrug,2022-12-07,00:00:00,6,4,2,FMN 06 B Zurenborgbrug Ringfietspad
655,Ringfietspad Zurenborgbrug,2022-12-07,01:00:00,0,0,0,FMN 06 B Zurenborgbrug Ringfietspad
655,Ringfietspad Zurenborgbrug,2022-12-07,02:00:00,4,0,4,FMN 06 B Zurenborgbrug Ringfietspad
655,Ringfietspad Zurenborgbrug,2022-12-07,03:00:00,3,1,2,FMN 06 B Zurenborgbrug Ringfietspad
655,Ringfietspad Zurenborgbrug,2022-12-07,04:00:00,13,6,7,FMN 06 B Zurenborgbrug Ringfietspad
655,Ringfietspad Zurenborgbrug,2022-12-07,05:00:00,46,30,16,FMN 06 B Zurenborgbrug Ringfietspad
655,Ringfietspad Zurenborgbrug,2022-12-07,06:00:00,93,55,38,FMN 06 B Zurenborgbrug Ringfietspad
655,Ringfietspad Zurenborgbrug,2022-12-07,07:00:00,324,177,147,FMN 06 B Zurenborgbrug Ringfietspad
655,Ringfietspad Zurenborgbrug,2022-12-07,08:00:00,430,255,175,FMN 06 B Zurenborgbrug Ringfietspad
655,Ringfietspad Zurenborgbrug,2022-12-07,09:00:00,128,74,54,FMN 06 B Zurenborgbrug Ringfietspad
655,Ringfietspad Zurenborgbrug,2022-12-07,10:00:00,111,53,58,FMN 06 B Zurenborgbrug Ringfietspad
655,Ringfietspad Zurenborgbrug,2022-12-07,11:00:00,114,53,61,FMN 06 B Zurenborgbrug Ringfietspad
655,Ringfietspad Zurenborgbrug,2022-12-07,12:00:00,248,127,121,FMN 06 B Zurenborgbrug Ringfietspad
655,Ringfietspad Zurenborgbrug,2022-12-07,13:00:00,158,60,98,FMN 06 B Zurenborgbrug Ringfietspad
655,Ringfietspad Zurenborgbrug,2022-12-07,14:00:00,104,45,59,FMN 06 B Zurenborgbrug Ringfietspad
655,Ringfietspad Zurenborgbrug,2022-12-07,15:00:00,151,47,104,FMN 06 B Zurenborgbrug Ringfietspad
655,Ringfietspad Zurenborgbrug,2022-12-07,16:00:00,260,94,166,FMN 06 B Zurenborgbrug Ringfietspad
655,Ringfietspad Zurenborgbrug,2022-12-07,17:00:00,325,114,211,FMN 06 B Zurenborgbrug Ringfietspad
655,Ringfietspad Zurenborgbrug,2022-12-07,18:00:00,197,67,130,FMN 06 B Zurenborgbrug Ringfietspad
655,Ringfietspad Zurenborgbrug,2022-12-07,19:00:00,87,37,50,FMN 06 B Zurenborgbrug Ringfietspad
655,Ringfietspad Zurenborgbrug,2022-12-07,20:00:00,74,15,59,FMN 06 B Zurenborgbrug Ringfietspad
655,Ringfietspad Zurenborgbrug,2022-12-07,21:00:00,57,21,36,FMN 06 B Zurenborgbrug Ringfietspad
655,Ringfietspad Zurenborgbrug,2022-12-07,22:00:00,65,25,40,FMN 06 B Zurenborgbrug Ringfietspad
655,Ringfietspad Zurenborgbrug,2022-12-07,23:00:00,32,17,15,FMN 06 B Zurenborgbrug Ringfietspad
655,Ringfietspad Zurenborgbrug,2022-12-08,00:00:00,13,6,7,FMN 06 B Zurenborgbrug Ringfietspad
655,Ringfietspad Zurenborgbrug,2022-12-08,01:00:00,5,2,3,FMN 06 B Zurenborgbrug Ringfietspad
655,Ringfietspad Zurenborgbrug,2022-12-08,02:00:00,0,0,0,FMN 06 B Zurenborgbrug Ringfietspad
655,Ringfietspad Zurenborgbrug,2022-12-08,03:00:00,2,1,1,FMN 06 B Zurenborgbrug Ringfietspad
655,Ringfietspad Zurenborgbrug,2022-12-08,04:00:00,0,0,0,FMN 06 B Zurenborgbrug Ringfietspad
655,Ringfietspad Zurenborgbrug,2022-12-08,05:00:00,0,0,0,FMN 06 B Zurenborgbrug Ringfietspad
655,Ringfietspad Zurenborgbrug,2022-12-08,06:00:00,0,0,0,FMN 06 B Zurenborgbrug Ringfietspad
655,Ringfietspad Zurenborgbrug,2022-12-08,07:00:00,0,0,0,FMN 06 B Zurenborgbrug Ringfietspad
655,Ringfietspad Zurenborgbrug,2022-12-08,08:00:00,0,0,0,FMN 06 B Zurenborgbrug Ringfietspad
655,Ringfietspad Zurenborgbrug,2022-12-08,09:00:00,0,0,0,FMN 06 B Zurenborgbrug Ringfietspad
655,Ringfietspad Zurenborgbrug,2022-12-08,10:00:00,39,24,15,FMN 06 B Zurenborgbrug Ringfietspad
655,Ringfietspad Zurenborgbrug,2022-12-08,11:00:00,92,49,43,FMN 06 B Zurenborgbrug Ringfietspad
655,Ringfietspad Zurenborgbrug,2022-12-08,12:00:00,126,62,64,FMN 06 B Zurenborgbrug Ringfietspad
655,Ringfietspad Zurenborgbrug,2022-12-08,13:00:00,130,72,58,FMN 06 B Zurenborgbrug Ringfietspad
655,Ringfietspad Zurenborgbrug,2022-12-08,14:00:00,95,35,60,FMN 06 B Zurenborgbrug Ringfietspad
655,Ringfietspad Zurenborgbrug,2022-12-08,15:00:00,178,71,107,FMN 06 B Zurenborgbrug Ringfietspad
655,Ringfietspad Zurenborgbrug,2022-12-08,16:00:00,373,142,231,FMN 06 B Zurenborgbrug Ringfietspad
655,Ringfietspad Zurenborgbrug,2022-12-08,17:00:00,361,131,230,FMN 06 B Zurenborgbrug Ringfietspad
655,Ringfietspad Zurenborgbrug,2022-12-08,18:00:00,223,70,153,FMN 06 B Zurenborgbrug Ringfietspad
655,Ringfietspad Zurenborgbrug,2022-12-08,19:00:00,112,32,80,FMN 06 B Zurenborgbrug Ringfietspad
655,Ringfietspad Zurenborgbrug,2022-12-08,20:00:00,51,20,31,FMN 06 B Zurenborgbrug Ringfietspad
655,Ringfietspad Zurenborgbrug,2022-12-08,21:00:00,0,0,0,FMN 06 B Zurenborgbrug Ringfietspad
655,Ringfietspad Zurenborgbrug,2022-12-08,22:00:00,0,0,0,FMN 06 B Zurenborgbrug Ringfietspad
655,Ringfietspad Zurenborgbrug,2022-12-08,23:00:00,0,0,0,FMN 06 B Zurenborgbrug Ringfietspad
655,Ringfietspad Zurenborgbrug,2022-12-09,00:00:00,0,0,0,FMN 06 B Zurenborgbrug Ringfietspad
655,Ringfietspad Zurenborgbrug,2022-12-09,01:00:00,0,0,0,FMN 06 B Zurenborgbrug Ringfietspad
655,Ringfietspad Zurenborgbrug,2022-12-09,02:00:00,0,0,0,FMN 06 B Zurenborgbrug Ringfietspad
655,Ringfietspad Zurenborgbrug,2022-12-09,03:00:00,0,0,0,FMN 06 B Zurenborgbrug Ringfietspad
655,Ringfietspad Zurenborgbrug,2022-12-09,04:00:00,0,0,0,FMN 06 B Zurenborgbrug Ringfietspad
655,Ringfietspad Zurenborgbrug,2022-12-09,05:00:00,0,0,0,FMN 06 B Zurenborgbrug Ringfietspad
655,Ringfietspad Zurenborgbrug,2022-12-09,06:00:00,0,0,0,FMN 06 B Zurenborgbrug Ringfietspad
655,Ringfietspad Zurenborgbrug,2022-12-09,07:00:00,0,0,0,FMN 06 B Zurenborgbrug Ringfietspad
655,Ringfietspad Zurenborgbrug,2022-12-09,08:00:00,0,0,0,FMN 06 B Zurenborgbrug Ringfietspad
655,Ringfietspad Zurenborgbrug,2022-12-09,09:00:00,0,0,0,FMN 06 B Zurenborgbrug Ringfietspad
655,Ringfietspad Zurenborgbrug,2022-12-09,10:00:00,63,36,27,FMN 06 B Zurenborgbrug Ringfietspad
655,Ringfietspad Zurenborgbrug,2022-12-09,11:00:00,86,45,41,FMN 06 B Zurenborgbrug Ringfietspad
655,Ringfietspad Zurenborgbrug,2022-12-09,12:00:00,136,63,73,FMN 06 B Zurenborgbrug Ringfietspad
655,Ringfietspad Zurenborgbrug,2022-12-09,13:00:00,113,37,76,FMN 06 B Zurenborgbrug Ringfietspad
655,Ringfietspad Zurenborgbrug,2022-12-09,14:00:00,107,41,66,FMN 06 B Zurenborgbrug Ringfietspad
655,Ringfietspad Zurenborgbrug,2022-12-09,15:00:00,207,75,132,FMN 06 B Zurenborgbrug Ringfietspad
655,Ringfietspad Zurenborgbrug,2022-12-09,16:00:00,313,137,176,FMN 06 B Zurenborgbrug Ringfietspad
655,Ringfietspad Zurenborgbrug,2022-12-09,17:00:00,246,80,166,FMN 06 B Zurenborgbrug Ringfietspad
655,Ringfietspad Zurenborgbrug,2022-12-09,18:00:00,163,62,101,FMN 06 B Zurenborgbrug Ringfietspad
655,Ringfietspad Zurenborgbrug,2022-12-09,19:00:00,99,33,66,FMN 06 B Zurenborgbrug Ringfietspad
655,Ringfietspad Zurenborgbrug,2022-12-09,20:00:00,68,33,35,FMN 06 B Zurenborgbrug Ringfietspad
655,Ringfietspad Zurenborgbrug,2022-12-09,21:00:00,46,21,25,FMN 06 B Zurenborgbrug Ringfietspad
655,Ringfietspad Zurenborgbrug,2022-12-09,22:00:00,36,13,23,FMN 06 B Zurenborgbrug Ringfietspad
655,Ringfietspad Zurenborgbrug,2022-12-09,23:00:00,54,31,23,FMN 06 B Zurenborgbrug Ringfietspad
655,Ringfietspad Zurenborgbrug,2022-12-10,00:00:00,12,3,9,FMN 06 B Zurenborgbrug Ringfietspad
655,Ringfietspad Zurenborgbrug,2022-12-10,01:00:00,0,0,0,FMN 06 B Zurenborgbrug Ringfietspad
655,Ringfietspad Zurenborgbrug,2022-12-10,02:00:00,0,0,0,FMN 06 B Zurenborgbrug Ringfietspad
655,Ringfietspad Zurenborgbrug,2022-12-10,03:00:00,0,0,0,FMN 06 B Zurenborgbrug Ringfietspad
655,Ringfietspad Zurenborgbrug,2022-12-10,04:00:00,0,0,0,FMN 06 B Zurenborgbrug Ringfietspad
655,Ringfietspad Zurenborgbrug,2022-12-10,05:00:00,0,0,0,FMN 06 B Zurenborgbrug Ringfietspad
655,Ringfietspad Zurenborgbrug,2022-12-10,06:00:00,0,0,0,FMN 06 B Zurenborgbrug Ringfietspad
655,Ringfietspad Zurenborgbrug,2022-12-10,07:00:00,0,0,0,FMN 06 B Zurenborgbrug Ringfietspad
655,Ringfietspad Zurenborgbrug,2022-12-10,08:00:00,0,0,0,FMN 06 B Zurenborgbrug Ringfietspad
655,Ringfietspad Zurenborgbrug,2022-12-10,09:00:00,0,0,0,FMN 06 B Zurenborgbrug Ringfietspad
655,Ringfietspad Zurenborgbrug,2022-12-10,10:00:00,0,0,0,FMN 06 B Zurenborgbrug Ringfietspad
655,Ringfietspad Zurenborgbrug,2022-12-10,11:00:00,11,4,7,FMN 06 B Zurenborgbrug Ringfietspad
655,Ringfietspad Zurenborgbrug,2022-12-10,12:00:00,54,25,29,FMN 06 B Zurenborgbrug Ringfietspad
655,Ringfietspad Zurenborgbrug,2022-12-10,13:00:00,72,29,43,FMN 06 B Zurenborgbrug Ringfietspad
655,Ringfietspad Zurenborgbrug,2022-12-10,14:00:00,65,30,35,FMN 06 B Zurenborgbrug Ringfietspad
655,Ringfietspad Zurenborgbrug,2022-12-10,15:00:00,49,22,27,FMN 06 B Zurenborgbrug Ringfietspad
655,Ringfietspad Zurenborgbrug,2022-12-10,16:00:00,47,25,22,FMN 06 B Zurenborgbrug Ringfietspad
655,Ringfietspad Zurenborgbrug,2022-12-10,17:00:00,59,32,27,FMN 06 B Zurenborgbrug Ringfietspad
655,Ringfietspad Zurenborgbrug,2022-12-10,18:00:00,0,0,0,FMN 06 B Zurenborgbrug Ringfietspad
655,Ringfietspad Zurenborgbrug,2022-12-10,19:00:00,0,0,0,FMN 06 B Zurenborgbrug Ringfietspad
655,Ringfietspad Zurenborgbrug,2022-12-10,20:00:00,0,0,0,FMN 06 B Zurenborgbrug Ringfietspad
655,Ringfietspad Zurenborgbrug,2022-12-10,21:00:00,0,0,0,FMN 06 B Zurenborgbrug Ringfietspad
655,Ringfietspad Zurenborgbrug,2022-12-10,22:00:00,0,0,0,FMN 06 B Zurenborgbrug Ringfietspad
655,Ringfietspad Zurenborgbrug,2022-12-10,23:00:00,0,0,0,FMN 06 B Zurenborgbrug Ringfietspad
655,Ringfietspad Zurenborgbrug,2022-12-11,00:00:00,0,0,0,FMN 06 B Zurenborgbrug Ringfietspad
655,Ringfietspad Zurenborgbrug,2022-12-11,01:00:00,0,0,0,FMN 06 B Zurenborgbrug Ringfietspad
655,Ringfietspad Zurenborgbrug,2022-12-11,02:00:00,0,0,0,FMN 06 B Zurenborgbrug Ringfietspad
655,Ringfietspad Zurenborgbrug,2022-12-11,03:00:00,0,0,0,FMN 06 B Zurenborgbrug Ringfietspad
655,Ringfietspad Zurenborgbrug,2022-12-11,04:00:00,0,0,0,FMN 06 B Zurenborgbrug Ringfietspad
655,Ringfietspad Zurenborgbrug,2022-12-11,05:00:00,0,0,0,FMN 06 B Zurenborgbrug Ringfietspad
655,Ringfietspad Zurenborgbrug,2022-12-11,06:00:00,0,0,0,FMN 06 B Zurenborgbrug Ringfietspad
655,Ringfietspad Zurenborgbrug,2022-12-11,07:00:00,0,0,0,FMN 06 B Zurenborgbrug Ringfietspad
655,Ringfietspad Zurenborgbrug,2022-12-11,08:00:00,0,0,0,FMN 06 B Zurenborgbrug Ringfietspad
655,Ringfietspad Zurenborgbrug,2022-12-11,09:00:00,0,0,0,FMN 06 B Zurenborgbrug Ringfietspad
655,Ringfietspad Zurenborgbrug,2022-12-11,10:00:00,0,0,0,FMN 06 B Zurenborgbrug Ringfietspad
655,Ringfietspad Zurenborgbrug,2022-12-11,11:00:00,0,0,0,FMN 06 B Zurenborgbrug Ringfietspad
655,Ringfietspad Zurenborgbrug,2022-12-11,12:00:00,14,9,5,FMN 06 B Zurenborgbrug Ringfietspad
655,Ringfietspad Zurenborgbrug,2022-12-11,13:00:00,73,34,39,FMN 06 B Zurenborgbrug Ringfietspad
655,Ringfietspad Zurenborgbrug,2022-12-11,14:00:00,69,31,38,FMN 06 B Zurenborgbrug Ringfietspad
655,Ringfietspad Zurenborgbrug,2022-12-11,15:00:00,57,31,26,FMN 06 B Zurenborgbrug Ringfietspad
655,Ringfietspad Zurenborgbrug,2022-12-11,16:00:00,47,17,30,FMN 06 B Zurenborgbrug Ringfietspad
655,Ringfietspad Zurenborgbrug,2022-12-11,17:00:00,40,18,22,FMN 06 B Zurenborgbrug Ringfietspad
655,Ringfietspad Zurenborgbrug,2022-12-11,18:00:00,34,7,27,FMN 06 B Zurenborgbrug Ringfietspad
655,Ringfietspad Zurenborgbrug,2022-12-11,19:00:00,0,0,0,FMN 06 B Zurenborgbrug Ringfietspad
655,Ringfietspad Zurenborgbrug,2022-12-11,20:00:00,0,0,0,FMN 06 B Zurenborgbrug Ringfietspad
655,Ringfietspad Zurenborgbrug,2022-12-11,21:00:00,0,0,0,FMN 06 B Zurenborgbrug Ringfietspad
655,Ringfietspad Zurenborgbrug,2022-12-11,22:00:00,0,0,0,FMN 06 B Zurenborgbrug Ringfietspad
655,Ringfietspad Zurenborgbrug,2022-12-11,23:00:00,0,0,0,FMN 06 B Zurenborgbrug Ringfietspad
655,Ringfietspad Zurenborgbrug,2022-12-12,00:00:00,0,0,0,FMN 06 B Zurenborgbrug Ringfietspad
655,Ringfietspad Zurenborgbrug,2022-12-12,01:00:00,0,0,0,FMN 06 B Zurenborgbrug Ringfietspad
655,Ringfietspad Zurenborgbrug,2022-12-12,02:00:00,0,0,0,FMN 06 B Zurenborgbrug Ringfietspad
655,Ringfietspad Zurenborgbrug,2022-12-12,03:00:00,0,0,0,FMN 06 B Zurenborgbrug Ringfietspad
655,Ringfietspad Zurenborgbrug,2022-12-12,04:00:00,0,0,0,FMN 06 B Zurenborgbrug Ringfietspad
655,Ringfietspad Zurenborgbrug,2022-12-12,05:00:00,0,0,0,FMN 06 B Zurenborgbrug Ringfietspad
655,Ringfietspad Zurenborgbrug,2022-12-12,06:00:00,0,0,0,FMN 06 B Zurenborgbrug Ringfietspad
655,Ringfietspad Zurenborgbrug,2022-12-12,07:00:00,0,0,0,FMN 06 B Zurenborgbrug Ringfietspad
655,Ringfietspad Zurenborgbrug,2022-12-12,08:00:00,0,0,0,FMN 06 B Zurenborgbrug Ringfietspad
655,Ringfietspad Zurenborgbrug,2022-12-12,09:00:00,0,0,0,FMN 06 B Zurenborgbrug Ringfietspad
655,Ringfietspad Zurenborgbrug,2022-12-12,10:00:00,47,26,21,FMN 06 B Zurenborgbrug Ringfietspad
655,Ringfietspad Zurenborgbrug,2022-12-12,11:00:00,78,36,42,FMN 06 B Zurenborgbrug Ringfietspad
655,Ringfietspad Zurenborgbrug,2022-12-12,12:00:00,133,53,80,FMN 06 B Zurenborgbrug Ringfietspad
655,Ringfietspad Zurenborgbrug,2022-12-12,13:00:00,136,69,67,FMN 06 B Zurenborgbrug Ringfietspad
655,Ringfietspad Zurenborgbrug,2022-12-12,14:00:00,107,39,68,FMN 06 B Zurenborgbrug Ringfietspad
655,Ringfietspad Zurenborgbrug,2022-12-12,15:00:00,199,79,120,FMN 06 B Zurenborgbrug Ringfietspad
655,Ringfietspad Zurenborgbrug,2022-12-12,16:00:00,283,109,174,FMN 06 B Zurenborgbrug Ringfietspad
655,Ringfietspad Zurenborgbrug,2022-12-12,17:00:00,319,119,200,FMN 06 B Zurenborgbrug Ringfietspad
655,Ringfietspad Zurenborgbrug,2022-12-12,18:00:00,203,79,124,FMN 06 B Zurenborgbrug Ringfietspad
655,Ringfietspad Zurenborgbrug,2022-12-12,19:00:00,81,34,47,FMN 06 B Zurenborgbrug Ringfietspad
655,Ringfietspad Zurenborgbrug,2022-12-12,20:00:00,54,21,33,FMN 06 B Zurenborgbrug Ringfietspad
655,Ringfietspad Zurenborgbrug,2022-12-12,21:00:00,45,17,28,FMN 06 B Zurenborgbrug Ringfietspad
655,Ringfietspad Zurenborgbrug,2022-12-12,22:00:00,49,17,32,FMN 06 B Zurenborgbrug Ringfietspad
655,Ringfietspad Zurenborgbrug,2022-12-12,23:00:00,16,7,9,FMN 06 B Zurenborgbrug Ringfietspad
655,Ringfietspad Zurenborgbrug,2022-12-13,00:00:00,6,4,2,FMN 06 B Zurenborgbrug Ringfietspad
655,Ringfietspad Zurenborgbrug,2022-12-13,01:00:00,0,0,0,FMN 06 B Zurenborgbrug Ringfietspad
655,Ringfietspad Zurenborgbrug,2022-12-13,02:00:00,0,0,0,FMN 06 B Zurenborgbrug Ringfietspad
655,Ringfietspad Zurenborgbrug,2022-12-13,03:00:00,0,0,0,FMN 06 B Zurenborgbrug Ringfietspad
655,Ringfietspad Zurenborgbrug,2022-12-13,04:00:00,0,0,0,FMN 06 B Zurenborgbrug Ringfietspad
655,Ringfietspad Zurenborgbrug,2022-12-13,05:00:00,0,0,0,FMN 06 B Zurenborgbrug Ringfietspad
655,Ringfietspad Zurenborgbrug,2022-12-13,06:00:00,0,0,0,FMN 06 B Zurenborgbrug Ringfietspad
655,Ringfietspad Zurenborgbrug,2022-12-13,07:00:00,0,0,0,FMN 06 B Zurenborgbrug Ringfietspad
655,Ringfietspad Zurenborgbrug,2022-12-13,08:00:00,0,0,0,FMN 06 B Zurenborgbrug Ringfietspad
655,Ringfietspad Zurenborgbrug,2022-12-13,09:00:00,81,38,43,FMN 06 B Zurenborgbrug Ringfietspad
655,Ringfietspad Zurenborgbrug,2022-12-13,10:00:00,92,41,51,FMN 06 B Zurenborgbrug Ringfietspad
655,Ringfietspad Zurenborgbrug,2022-12-13,11:00:00,80,36,44,FMN 06 B Zurenborgbrug Ringfietspad
655,Ringfietspad Zurenborgbrug,2022-12-13,12:00:00,143,87,56,FMN 06 B Zurenborgbrug Ringfietspad
655,Ringfietspad Zurenborgbrug,2022-12-13,13:00:00,103,51,52,FMN 06 B Zurenborgbrug Ringfietspad
655,Ringfietspad Zurenborgbrug,2022-12-13,14:00:00,69,30,39,FMN 06 B Zurenborgbrug Ringfietspad
655,Ringfietspad Zurenborgbrug,2022-12-13,15:00:00,185,71,114,FMN 06 B Zurenborgbrug Ringfietspad
655,Ringfietspad Zurenborgbrug,2022-12-13,16:00:00,295,114,181,FMN 06 B Zurenborgbrug Ringfietspad
655,Ringfietspad Zurenborgbrug,2022-12-13,17:00:00,341,116,225,FMN 06 B Zurenborgbrug Ringfietspad
655,Ringfietspad Zurenborgbrug,2022-12-13,18:00:00,179,56,123,FMN 06 B Zurenborgbrug Ringfietspad
655,Ringfietspad Zurenborgbrug,2022-12-13,19:00:00,81,21,60,FMN 06 B Zurenborgbrug Ringfietspad
655,Ringfietspad Zurenborgbrug,2022-12-13,20:00:00,42,22,20,FMN 06 B Zurenborgbrug Ringfietspad
655,Ringfietspad Zurenborgbrug,2022-12-13,21:00:00,42,19,23,FMN 06 B Zurenborgbrug Ringfietspad
655,Ringfietspad Zurenborgbrug,2022-12-13,22:00:00,50,17,33,FMN 06 B Zurenborgbrug Ringfietspad
655,Ringfietspad Zurenborgbrug,2022-12-13,23:00:00,10,7,3,FMN 06 B Zurenborgbrug Ringfietspad
655,Ringfietspad Zurenborgbrug,2022-12-14,00:00:00,0,0,0,FMN 06 B Zurenborgbrug Ringfietspad
655,Ringfietspad Zurenborgbrug,2022-12-14,01:00:00,0,0,0,FMN 06 B Zurenborgbrug Ringfietspad
655,Ringfietspad Zurenborgbrug,2022-12-14,02:00:00,0,0,0,FMN 06 B Zurenborgbrug Ringfietspad
655,Ringfietspad Zurenborgbrug,2022-12-14,03:00:00,0,0,0,FMN 06 B Zurenborgbrug Ringfietspad
655,Ringfietspad Zurenborgbrug,2022-12-14,04:00:00,0,0,0,FMN 06 B Zurenborgbrug Ringfietspad
655,Ringfietspad Zurenborgbrug,2022-12-14,05:00:00,0,0,0,FMN 06 B Zurenborgbrug Ringfietspad
655,Ringfietspad Zurenborgbrug,2022-12-14,06:00:00,0,0,0,FMN 06 B Zurenborgbrug Ringfietspad
655,Ringfietspad Zurenborgbrug,2022-12-14,07:00:00,0,0,0,FMN 06 B Zurenborgbrug Ringfietspad
655,Ringfietspad Zurenborgbrug,2022-12-14,08:00:00,0,0,0,FMN 06 B Zurenborgbrug Ringfietspad
655,Ringfietspad Zurenborgbrug,2022-12-14,09:00:00,0,0,0,FMN 06 B Zurenborgbrug Ringfietspad
655,Ringfietspad Zurenborgbrug,2022-12-14,10:00:00,117,75,42,FMN 06 B Zurenborgbrug Ringfietspad
655,Ringfietspad Zurenborgbrug,2022-12-14,11:00:00,82,33,49,FMN 06 B Zurenborgbrug Ringfietspad
655,Ringfietspad Zurenborgbrug,2022-12-14,12:00:00,194,90,104,FMN 06 B Zurenborgbrug Ringfietspad
655,Ringfietspad Zurenborgbrug,2022-12-14,13:00:00,130,52,78,FMN 06 B Zurenborgbrug Ringfietspad
655,Ringfietspad Zurenborgbrug,2022-12-14,14:00:00,90,27,63,FMN 06 B Zurenborgbrug Ringfietspad
655,Ringfietspad Zurenborgbrug,2022-12-14,15:00:00,115,40,75,FMN 06 B Zurenborgbrug Ringfietspad
655,Ringfietspad Zurenborgbrug,2022-12-14,16:00:00,205,77,128,FMN 06 B Zurenborgbrug Ringfietspad
655,Ringfietspad Zurenborgbrug,2022-12-14,17:00:00,247,75,172,FMN 06 B Zurenborgbrug Ringfietspad
655,Ringfietspad Zurenborgbrug,2022-12-14,18:00:00,31,18,13,FMN 06 B Zurenborgbrug Ringfietspad
655,Ringfietspad Zurenborgbrug,2022-12-14,19:00:00,0,0,0,FMN 06 B Zurenborgbrug Ringfietspad
655,Ringfietspad Zurenborgbrug,2022-12-14,20:00:00,0,0,0,FMN 06 B Zurenborgbrug Ringfietspad
655,Ringfietspad Zurenborgbrug,2022-12-14,21:00:00,0,0,0,FMN 06 B Zurenborgbrug Ringfietspad
655,Ringfietspad Zurenborgbrug,2022-12-14,22:00:00,0,0,0,FMN 06 B Zurenborgbrug Ringfietspad
655,Ringfietspad Zurenborgbrug,2022-12-14,23:00:00,0,0,0,FMN 06 B Zurenborgbrug Ringfietspad
655,Ringfietspad Zurenborgbrug,2022-12-15,00:00:00,0,0,0,FMN 06 B Zurenborgbrug Ringfietspad
655,Ringfietspad Zurenborgbrug,2022-12-15,01:00:00,0,0,0,FMN 06 B Zurenborgbrug Ringfietspad
655,Ringfietspad Zurenborgbrug,2022-12-15,02:00:00,0,0,0,FMN 06 B Zurenborgbrug Ringfietspad
655,Ringfietspad Zurenborgbrug,2022-12-15,03:00:00,0,0,0,FMN 06 B Zurenborgbrug Ringfietspad
655,Ringfietspad Zurenborgbrug,2022-12-15,04:00:00,0,0,0,FMN 06 B Zurenborgbrug Ringfietspad
655,Ringfietspad Zurenborgbrug,2022-12-15,05:00:00,0,0,0,FMN 06 B Zurenborgbrug Ringfietspad
655,Ringfietspad Zurenborgbrug,2022-12-15,06:00:00,0,0,0,FMN 06 B Zurenborgbrug Ringfietspad
655,Ringfietspad Zurenborgbrug,2022-12-15,07:00:00,0,0,0,FMN 06 B Zurenborgbrug Ringfietspad
655,Ringfietspad Zurenborgbrug,2022-12-15,08:00:00,0,0,0,FMN 06 B Zurenborgbrug Ringfietspad
655,Ringfietspad Zurenborgbrug,2022-12-15,09:00:00,68,34,34,FMN 06 B Zurenborgbrug Ringfietspad
655,Ringfietspad Zurenborgbrug,2022-12-15,10:00:00,108,44,64,FMN 06 B Zurenborgbrug Ringfietspad
655,Ringfietspad Zurenborgbrug,2022-12-15,11:00:00,83,39,44,FMN 06 B Zurenborgbrug Ringfietspad
655,Ringfietspad Zurenborgbrug,2022-12-15,12:00:00,157,102,55,FMN 06 B Zurenborgbrug Ringfietspad
655,Ringfietspad Zurenborgbrug,2022-12-15,13:00:00,113,56,57,FMN 06 B Zurenborgbrug Ringfietspad
655,Ringfietspad Zurenborgbrug,2022-12-15,14:00:00,95,34,61,FMN 06 B Zurenborgbrug Ringfietspad
655,Ringfietspad Zurenborgbrug,2022-12-15,15:00:00,149,48,101,FMN 06 B Zurenborgbrug Ringfietspad
655,Ringfietspad Zurenborgbrug,2022-12-15,16:00:00,249,95,154,FMN 06 B Zurenborgbrug Ringfietspad
655,Ringfietspad Zurenborgbrug,2022-12-15,17:00:00,134,43,91,FMN 06 B Zurenborgbrug Ringfietspad
655,Ringfietspad Zurenborgbrug,2022-12-15,18:00:00,0,0,0,FMN 06 B Zurenborgbrug Ringfietspad
655,Ringfietspad Zurenborgbrug,2022-12-15,19:00:00,0,0,0,FMN 06 B Zurenborgbrug Ringfietspad
655,Ringfietspad Zurenborgbrug,2022-12-15,20:00:00,0,0,0,FMN 06 B Zurenborgbrug Ringfietspad
655,Ringfietspad Zurenborgbrug,2022-12-15,21:00:00,0,0,0,FMN 06 B Zurenborgbrug Ringfietspad
655,Ringfietspad Zurenborgbrug,2022-12-15,22:00:00,0,0,0,FMN 06 B Zurenborgbrug Ringfietspad
655,Ringfietspad Zurenborgbrug,2022-12-15,23:00:00,0,0,0,FMN 06 B Zurenborgbrug Ringfietspad
655,Ringfietspad Zurenborgbrug,2022-12-16,00:00:00,0,0,0,FMN 06 B Zurenborgbrug Ringfietspad
655,Ringfietspad Zurenborgbrug,2022-12-16,01:00:00,0,0,0,FMN 06 B Zurenborgbrug Ringfietspad
655,Ringfietspad Zurenborgbrug,2022-12-16,02:00:00,0,0,0,FMN 06 B Zurenborgbrug Ringfietspad
655,Ringfietspad Zurenborgbrug,2022-12-16,03:00:00,0,0,0,FMN 06 B Zurenborgbrug Ringfietspad
655,Ringfietspad Zurenborgbrug,2022-12-16,04:00:00,0,0,0,FMN 06 B Zurenborgbrug Ringfietspad
655,Ringfietspad Zurenborgbrug,2022-12-16,05:00:00,0,0,0,FMN 06 B Zurenborgbrug Ringfietspad
655,Ringfietspad Zurenborgbrug,2022-12-16,06:00:00,0,0,0,FMN 06 B Zurenborgbrug Ringfietspad
655,Ringfietspad Zurenborgbrug,2022-12-16,07:00:00,0,0,0,FMN 06 B Zurenborgbrug Ringfietspad
655,Ringfietspad Zurenborgbrug,2022-12-16,08:00:00,0,0,0,FMN 06 B Zurenborgbrug Ringfietspad
655,Ringfietspad Zurenborgbrug,2022-12-16,09:00:00,68,33,35,FMN 06 B Zurenborgbrug Ringfietspad
655,Ringfietspad Zurenborgbrug,2022-12-16,10:00:00,103,49,54,FMN 06 B Zurenborgbrug Ringfietspad
655,Ringfietspad Zurenborgbrug,2022-12-16,11:00:00,85,38,47,FMN 06 B Zurenborgbrug Ringfietspad
655,Ringfietspad Zurenborgbrug,2022-12-16,12:00:00,136,66,70,FMN 06 B Zurenborgbrug Ringfietspad
655,Ringfietspad Zurenborgbrug,2022-12-16,13:00:00,106,51,55,FMN 06 B Zurenborgbrug Ringfietspad
655,Ringfietspad Zurenborgbrug,2022-12-16,14:00:00,94,43,51,FMN 06 B Zurenborgbrug Ringfietspad
655,Ringfietspad Zurenborgbrug,2022-12-16,15:00:00,152,58,94,FMN 06 B Zurenborgbrug Ringfietspad
655,Ringfietspad Zurenborgbrug,2022-12-16,16:00:00,244,94,150,FMN 06 B Zurenborgbrug Ringfietspad
655,Ringfietspad Zurenborgbrug,2022-12-16,17:00:00,45,10,35,FMN 06 B Zurenborgbrug Ringfietspad
655,Ringfietspad Zurenborgbrug,2022-12-16,18:00:00,0,0,0,FMN 06 B Zurenborgbrug Ringfietspad
655,Ringfietspad Zurenborgbrug,2022-12-16,19:00:00,0,0,0,FMN 06 B Zurenborgbrug Ringfietspad
655,Ringfietspad Zurenborgbrug,2022-12-16,20:00:00,0,0,0,FMN 06 B Zurenborgbrug Ringfietspad
655,Ringfietspad Zurenborgbrug,2022-12-16,21:00:00,0,0,0,FMN 06 B Zurenborgbrug Ringfietspad
655,Ringfietspad Zurenborgbrug,2022-12-16,22:00:00,0,0,0,FMN 06 B Zurenborgbrug Ringfietspad
655,Ringfietspad Zurenborgbrug,2022-12-16,23:00:00,0,0,0,FMN 06 B Zurenborgbrug Ringfietspad
655,Ringfietspad Zurenborgbrug,2022-12-17,00:00:00,0,0,0,FMN 06 B Zurenborgbrug Ringfietspad
655,Ringfietspad Zurenborgbrug,2022-12-17,01:00:00,0,0,0,FMN 06 B Zurenborgbrug Ringfietspad
655,Ringfietspad Zurenborgbrug,2022-12-17,02:00:00,0,0,0,FMN 06 B Zurenborgbrug Ringfietspad
655,Ringfietspad Zurenborgbrug,2022-12-17,03:00:00,0,0,0,FMN 06 B Zurenborgbrug Ringfietspad
655,Ringfietspad Zurenborgbrug,2022-12-17,04:00:00,0,0,0,FMN 06 B Zurenborgbrug Ringfietspad
655,Ringfietspad Zurenborgbrug,2022-12-17,05:00:00,0,0,0,FMN 06 B Zurenborgbrug Ringfietspad
655,Ringfietspad Zurenborgbrug,2022-12-17,06:00:00,0,0,0,FMN 06 B Zurenborgbrug Ringfietspad
655,Ringfietspad Zurenborgbrug,2022-12-17,07:00:00,0,0,0,FMN 06 B Zurenborgbrug Ringfietspad
655,Ringfietspad Zurenborgbrug,2022-12-17,08:00:00,0,0,0,FMN 06 B Zurenborgbrug Ringfietspad
655,Ringfietspad Zurenborgbrug,2022-12-17,09:00:00,24,12,12,FMN 06 B Zurenborgbrug Ringfietspad
655,Ringfietspad Zurenborgbrug,2022-12-17,10:00:00,31,12,19,FMN 06 B Zurenborgbrug Ringfietspad
655,Ringfietspad Zurenborgbrug,2022-12-17,11:00:00,51,23,28,FMN 06 B Zurenborgbrug Ringfietspad
655,Ringfietspad Zurenborgbrug,2022-12-17,12:00:00,58,22,36,FMN 06 B Zurenborgbrug Ringfietspad
655,Ringfietspad Zurenborgbrug,2022-12-17,13:00:00,54,29,25,FMN 06 B Zurenborgbrug Ringfietspad
655,Ringfietspad Zurenborgbrug,2022-12-17,14:00:00,70,33,37,FMN 06 B Zurenborgbrug Ringfietspad
655,Ringfietspad Zurenborgbrug,2022-12-17,15:00:00,73,39,34,FMN 06 B Zurenborgbrug Ringfietspad
655,Ringfietspad Zurenborgbrug,2022-12-17,16:00:00,58,29,29,FMN 06 B Zurenborgbrug Ringfietspad
655,Ringfietspad Zurenborgbrug,2022-12-17,17:00:00,21,9,12,FMN 06 B Zurenborgbrug Ringfietspad
655,Ringfietspad Zurenborgbrug,2022-12-17,18:00:00,0,0,0,FMN 06 B Zurenborgbrug Ringfietspad
655,Ringfietspad Zurenborgbrug,2022-12-17,19:00:00,0,0,0,FMN 06 B Zurenborgbrug Ringfietspad
655,Ringfietspad Zurenborgbrug,2022-12-17,20:00:00,0,0,0,FMN 06 B Zurenborgbrug Ringfietspad
655,Ringfietspad Zurenborgbrug,2022-12-17,21:00:00,0,0,0,FMN 06 B Zurenborgbrug Ringfietspad
655,Ringfietspad Zurenborgbrug,2022-12-17,22:00:00,0,0,0,FMN 06 B Zurenborgbrug Ringfietspad
655,Ringfietspad Zurenborgbrug,2022-12-17,23:00:00,0,0,0,FMN 06 B Zurenborgbrug Ringfietspad
655,Ringfietspad Zurenborgbrug,2022-12-18,00:00:00,0,0,0,FMN 06 B Zurenborgbrug Ringfietspad
655,Ringfietspad Zurenborgbrug,2022-12-18,01:00:00,0,0,0,FMN 06 B Zurenborgbrug Ringfietspad
655,Ringfietspad Zurenborgbrug,2022-12-18,02:00:00,0,0,0,FMN 06 B Zurenborgbrug Ringfietspad
655,Ringfietspad Zurenborgbrug,2022-12-18,03:00:00,0,0,0,FMN 06 B Zurenborgbrug Ringfietspad
655,Ringfietspad Zurenborgbrug,2022-12-18,04:00:00,0,0,0,FMN 06 B Zurenborgbrug Ringfietspad
655,Ringfietspad Zurenborgbrug,2022-12-18,05:00:00,0,0,0,FMN 06 B Zurenborgbrug Ringfietspad
655,Ringfietspad Zurenborgbrug,2022-12-18,06:00:00,0,0,0,FMN 06 B Zurenborgbrug Ringfietspad
655,Ringfietspad Zurenborgbrug,2022-12-18,07:00:00,0,0,0,FMN 06 B Zurenborgbrug Ringfietspad
655,Ringfietspad Zurenborgbrug,2022-12-18,08:00:00,0,0,0,FMN 06 B Zurenborgbrug Ringfietspad
655,Ringfietspad Zurenborgbrug,2022-12-18,09:00:00,31,11,20,FMN 06 B Zurenborgbrug Ringfietspad
655,Ringfietspad Zurenborgbrug,2022-12-18,10:00:00,27,13,14,FMN 06 B Zurenborgbrug Ringfietspad
655,Ringfietspad Zurenborgbrug,2022-12-18,11:00:00,42,17,25,FMN 06 B Zurenborgbrug Ringfietspad
655,Ringfietspad Zurenborgbrug,2022-12-18,12:00:00,41,21,20,FMN 06 B Zurenborgbrug Ringfietspad
655,Ringfietspad Zurenborgbrug,2022-12-18,13:00:00,44,19,25,FMN 06 B Zurenborgbrug Ringfietspad
655,Ringfietspad Zurenborgbrug,2022-12-18,14:00:00,56,28,28,FMN 06 B Zurenborgbrug Ringfietspad
655,Ringfietspad Zurenborgbrug,2022-12-18,15:00:00,39,19,20,FMN 06 B Zurenborgbrug Ringfietspad
655,Ringfietspad Zurenborgbrug,2022-12-18,16:00:00,44,24,20,FMN 06 B Zurenborgbrug Ringfietspad
655,Ringfietspad Zurenborgbrug,2022-12-18,17:00:00,22,12,10,FMN 06 B Zurenborgbrug Ringfietspad
655,Ringfietspad Zurenborgbrug,2022-12-18,18:00:00,27,12,15,FMN 06 B Zurenborgbrug Ringfietspad
655,Ringfietspad Zurenborgbrug,2022-12-18,19:00:00,35,9,26,FMN 06 B Zurenborgbrug Ringfietspad
655,Ringfietspad Zurenborgbrug,2022-12-18,20:00:00,12,2,10,FMN 06 B Zurenborgbrug Ringfietspad
655,Ringfietspad Zurenborgbrug,2022-12-18,21:00:00,11,4,7,FMN 06 B Zurenborgbrug Ringfietspad
655,Ringfietspad Zurenborgbrug,2022-12-18,22:00:00,6,2,4,FMN 06 B Zurenborgbrug Ringfietspad
655,Ringfietspad Zurenborgbrug,2022-12-18,23:00:00,4,0,4,FMN 06 B Zurenborgbrug Ringfietspad
655,Ringfietspad Zurenborgbrug,2022-12-19,00:00:00,4,1,3,FMN 06 B Zurenborgbrug Ringfietspad
655,Ringfietspad Zurenborgbrug,2022-12-19,01:00:00,2,0,2,FMN 06 B Zurenborgbrug Ringfietspad
655,Ringfietspad Zurenborgbrug,2022-12-19,02:00:00,1,0,1,FMN 06 B Zurenborgbrug Ringfietspad
655,Ringfietspad Zurenborgbrug,2022-12-19,03:00:00,1,0,1,FMN 06 B Zurenborgbrug Ringfietspad
655,Ringfietspad Zurenborgbrug,2022-12-19,04:00:00,3,2,1,FMN 06 B Zurenborgbrug Ringfietspad
655,Ringfietspad Zurenborgbrug,2022-12-19,05:00:00,21,10,11,FMN 06 B Zurenborgbrug Ringfietspad
655,Ringfietspad Zurenborgbrug,2022-12-19,06:00:00,71,43,28,FMN 06 B Zurenborgbrug Ringfietspad
655,Ringfietspad Zurenborgbrug,2022-12-19,07:00:00,221,120,101,FMN 06 B Zurenborgbrug Ringfietspad
655,Ringfietspad Zurenborgbrug,2022-12-19,08:00:00,389,229,160,FMN 06 B Zurenborgbrug Ringfietspad
655,Ringfietspad Zurenborgbrug,2022-12-19,09:00:00,107,57,50,FMN 06 B Zurenborgbrug Ringfietspad
655,Ringfietspad Zurenborgbrug,2022-12-19,10:00:00,83,47,36,FMN 06 B Zurenborgbrug Ringfietspad
655,Ringfietspad Zurenborgbrug,2022-12-19,11:00:00,69,32,37,FMN 06 B Zurenborgbrug Ringfietspad
655,Ringfietspad Zurenborgbrug,2022-12-19,12:00:00,119,59,60,FMN 06 B Zurenborgbrug Ringfietspad
655,Ringfietspad Zurenborgbrug,2022-12-19,13:00:00,97,47,50,FMN 06 B Zurenborgbrug Ringfietspad
655,Ringfietspad Zurenborgbrug,2022-12-19,14:00:00,68,25,43,FMN 06 B Zurenborgbrug Ringfietspad
655,Ringfietspad Zurenborgbrug,2022-12-19,15:00:00,148,49,99,FMN 06 B Zurenborgbrug Ringfietspad
655,Ringfietspad Zurenborgbrug,2022-12-19,16:00:00,255,108,147,FMN 06 B Zurenborgbrug Ringfietspad
655,Ringfietspad Zurenborgbrug,2022-12-19,17:00:00,260,82,178,FMN 06 B Zurenborgbrug Ringfietspad
655,Ringfietspad Zurenborgbrug,2022-12-19,18:00:00,180,82,98,FMN 06 B Zurenborgbrug Ringfietspad
655,Ringfietspad Zurenborgbrug,2022-12-19,19:00:00,78,31,47,FMN 06 B Zurenborgbrug Ringfietspad
655,Ringfietspad Zurenborgbrug,2022-12-19,20:00:00,56,31,25,FMN 06 B Zurenborgbrug Ringfietspad
655,Ringfietspad Zurenborgbrug,2022-12-19,21:00:00,49,14,35,FMN 06 B Zurenborgbrug Ringfietspad
655,Ringfietspad Zurenborgbrug,2022-12-19,22:00:00,49,14,35,FMN 06 B Zurenborgbrug Ringfietspad
655,Ringfietspad Zurenborgbrug,2022-12-19,23:00:00,25,7,18,FMN 06 B Zurenborgbrug Ringfietspad
655,Ringfietspad Zurenborgbrug,2022-12-20,00:00:00,1,1,0,FMN 06 B Zurenborgbrug Ringfietspad
655,Ringfietspad Zurenborgbrug,2022-12-20,01:00:00,0,0,0,FMN 06 B Zurenborgbrug Ringfietspad
655,Ringfietspad Zurenborgbrug,2022-12-20,02:00:00,0,0,0,FMN 06 B Zurenborgbrug Ringfietspad
655,Ringfietspad Zurenborgbrug,2022-12-20,03:00:00,0,0,0,FMN 06 B Zurenborgbrug Ringfietspad
655,Ringfietspad Zurenborgbrug,2022-12-20,04:00:00,0,0,0,FMN 06 B Zurenborgbrug Ringfietspad
655,Ringfietspad Zurenborgbrug,2022-12-20,05:00:00,0,0,0,FMN 06 B Zurenborgbrug Ringfietspad
655,Ringfietspad Zurenborgbrug,2022-12-20,06:00:00,0,0,0,FMN 06 B Zurenborgbrug Ringfietspad
655,Ringfietspad Zurenborgbrug,2022-12-20,07:00:00,0,0,0,FMN 06 B Zurenborgbrug Ringfietspad
655,Ringfietspad Zurenborgbrug,2022-12-20,08:00:00,0,0,0,FMN 06 B Zurenborgbrug Ringfietspad
655,Ringfietspad Zurenborgbrug,2022-12-20,09:00:00,0,0,0,FMN 06 B Zurenborgbrug Ringfietspad
655,Ringfietspad Zurenborgbrug,2022-12-20,10:00:00,0,0,0,FMN 06 B Zurenborgbrug Ringfietspad
655,Ringfietspad Zurenborgbrug,2022-12-20,11:00:00,0,0,0,FMN 06 B Zurenborgbrug Ringfietspad
655,Ringfietspad Zurenborgbrug,2022-12-20,12:00:00,0,0,0,FMN 06 B Zurenborgbrug Ringfietspad
655,Ringfietspad Zurenborgbrug,2022-12-20,13:00:00,0,0,0,FMN 06 B Zurenborgbrug Ringfietspad
655,Ringfietspad Zurenborgbrug,2022-12-20,14:00:00,0,0,0,FMN 06 B Zurenborgbrug Ringfietspad
655,Ringfietspad Zurenborgbrug,2022-12-20,15:00:00,0,0,0,FMN 06 B Zurenborgbrug Ringfietspad
655,Ringfietspad Zurenborgbrug,2022-12-20,16:00:00,0,0,0,FMN 06 B Zurenborgbrug Ringfietspad
655,Ringfietspad Zurenborgbrug,2022-12-20,17:00:00,0,0,0,FMN 06 B Zurenborgbrug Ringfietspad
655,Ringfietspad Zurenborgbrug,2022-12-20,18:00:00,0,0,0,FMN 06 B Zurenborgbrug Ringfietspad
655,Ringfietspad Zurenborgbrug,2022-12-20,19:00:00,0,0,0,FMN 06 B Zurenborgbrug Ringfietspad
655,Ringfietspad Zurenborgbrug,2022-12-20,20:00:00,0,0,0,FMN 06 B Zurenborgbrug Ringfietspad
655,Ringfietspad Zurenborgbrug,2022-12-20,21:00:00,0,0,0,FMN 06 B Zurenborgbrug Ringfietspad
655,Ringfietspad Zurenborgbrug,2022-12-20,22:00:00,0,0,0,FMN 06 B Zurenborgbrug Ringfietspad
655,Ringfietspad Zurenborgbrug,2022-12-20,23:00:00,0,0,0,FMN 06 B Zurenborgbrug Ringfietspad
655,Ringfietspad Zurenborgbrug,2022-12-21,00:00:00,0,0,0,FMN 06 B Zurenborgbrug Ringfietspad
655,Ringfietspad Zurenborgbrug,2022-12-21,01:00:00,0,0,0,FMN 06 B Zurenborgbrug Ringfietspad
655,Ringfietspad Zurenborgbrug,2022-12-21,02:00:00,0,0,0,FMN 06 B Zurenborgbrug Ringfietspad
655,Ringfietspad Zurenborgbrug,2022-12-21,03:00:00,0,0,0,FMN 06 B Zurenborgbrug Ringfietspad
655,Ringfietspad Zurenborgbrug,2022-12-21,04:00:00,0,0,0,FMN 06 B Zurenborgbrug Ringfietspad
655,Ringfietspad Zurenborgbrug,2022-12-21,05:00:00,0,0,0,FMN 06 B Zurenborgbrug Ringfietspad
655,Ringfietspad Zurenborgbrug,2022-12-21,06:00:00,0,0,0,FMN 06 B Zurenborgbrug Ringfietspad
655,Ringfietspad Zurenborgbrug,2022-12-21,07:00:00,0,0,0,FMN 06 B Zurenborgbrug Ringfietspad
655,Ringfietspad Zurenborgbrug,2022-12-21,08:00:00,0,0,0,FMN 06 B Zurenborgbrug Ringfietspad
655,Ringfietspad Zurenborgbrug,2022-12-21,09:00:00,0,0,0,FMN 06 B Zurenborgbrug Ringfietspad
655,Ringfietspad Zurenborgbrug,2022-12-21,10:00:00,54,32,22,FMN 06 B Zurenborgbrug Ringfietspad
655,Ringfietspad Zurenborgbrug,2022-12-21,11:00:00,117,53,64,FMN 06 B Zurenborgbrug Ringfietspad
655,Ringfietspad Zurenborgbrug,2022-12-21,12:00:00,168,70,98,FMN 06 B Zurenborgbrug Ringfietspad
655,Ringfietspad Zurenborgbrug,2022-12-21,13:00:00,140,75,65,FMN 06 B Zurenborgbrug Ringfietspad
655,Ringfietspad Zurenborgbrug,2022-12-21,14:00:00,122,45,77,FMN 06 B Zurenborgbrug Ringfietspad
655,Ringfietspad Zurenborgbrug,2022-12-21,15:00:00,156,56,100,FMN 06 B Zurenborgbrug Ringfietspad
655,Ringfietspad Zurenborgbrug,2022-12-21,16:00:00,236,79,157,FMN 06 B Zurenborgbrug Ringfietspad
655,Ringfietspad Zurenborgbrug,2022-12-21,17:00:00,229,83,146,FMN 06 B Zurenborgbrug Ringfietspad
655,Ringfietspad Zurenborgbrug,2022-12-21,18:00:00,141,57,84,FMN 06 B Zurenborgbrug Ringfietspad
655,Ringfietspad Zurenborgbrug,2022-12-21,19:00:00,86,32,54,FMN 06 B Zurenborgbrug Ringfietspad
655,Ringfietspad Zurenborgbrug,2022-12-21,20:00:00,47,21,26,FMN 06 B Zurenborgbrug Ringfietspad
655,Ringfietspad Zurenborgbrug,2022-12-21,21:00:00,45,17,28,FMN 06 B Zurenborgbrug Ringfietspad
655,Ringfietspad Zurenborgbrug,2022-12-21,22:00:00,8,3,5,FMN 06 B Zurenborgbrug Ringfietspad
655,Ringfietspad Zurenborgbrug,2022-12-21,23:00:00,0,0,0,FMN 06 B Zurenborgbrug Ringfietspad
655,Ringfietspad Zurenborgbrug,2022-12-22,00:00:00,0,0,0,FMN 06 B Zurenborgbrug Ringfietspad
655,Ringfietspad Zurenborgbrug,2022-12-22,01:00:00,0,0,0,FMN 06 B Zurenborgbrug Ringfietspad
655,Ringfietspad Zurenborgbrug,2022-12-22,02:00:00,0,0,0,FMN 06 B Zurenborgbrug Ringfietspad
655,Ringfietspad Zurenborgbrug,2022-12-22,03:00:00,0,0,0,FMN 06 B Zurenborgbrug Ringfietspad
655,Ringfietspad Zurenborgbrug,2022-12-22,04:00:00,0,0,0,FMN 06 B Zurenborgbrug Ringfietspad
655,Ringfietspad Zurenborgbrug,2022-12-22,05:00:00,0,0,0,FMN 06 B Zurenborgbrug Ringfietspad
655,Ringfietspad Zurenborgbrug,2022-12-22,06:00:00,0,0,0,FMN 06 B Zurenborgbrug Ringfietspad
655,Ringfietspad Zurenborgbrug,2022-12-22,07:00:00,0,0,0,FMN 06 B Zurenborgbrug Ringfietspad
655,Ringfietspad Zurenborgbrug,2022-12-22,08:00:00,0,0,0,FMN 06 B Zurenborgbrug Ringfietspad
655,Ringfietspad Zurenborgbrug,2022-12-22,09:00:00,0,0,0,FMN 06 B Zurenborgbrug Ringfietspad
655,Ringfietspad Zurenborgbrug,2022-12-22,10:00:00,0,0,0,FMN 06 B Zurenborgbrug Ringfietspad
655,Ringfietspad Zurenborgbrug,2022-12-22,11:00:00,25,14,11,FMN 06 B Zurenborgbrug Ringfietspad
655,Ringfietspad Zurenborgbrug,2022-12-22,12:00:00,129,75,54,FMN 06 B Zurenborgbrug Ringfietspad
655,Ringfietspad Zurenborgbrug,2022-12-22,13:00:00,145,72,73,FMN 06 B Zurenborgbrug Ringfietspad
655,Ringfietspad Zurenborgbrug,2022-12-22,14:00:00,90,30,60,FMN 06 B Zurenborgbrug Ringfietspad
655,Ringfietspad Zurenborgbrug,2022-12-22,15:00:00,152,43,109,FMN 06 B Zurenborgbrug Ringfietspad
655,Ringfietspad Zurenborgbrug,2022-12-22,16:00:00,245,75,170,FMN 06 B Zurenborgbrug Ringfietspad
655,Ringfietspad Zurenborgbrug,2022-12-22,17:00:00,149,57,92,FMN 06 B Zurenborgbrug Ringfietspad
655,Ringfietspad Zurenborgbrug,2022-12-22,18:00:00,0,0,0,FMN 06 B Zurenborgbrug Ringfietspad
655,Ringfietspad Zurenborgbrug,2022-12-22,19:00:00,0,0,0,FMN 06 B Zurenborgbrug Ringfietspad
655,Ringfietspad Zurenborgbrug,2022-12-22,20:00:00,0,0,0,FMN 06 B Zurenborgbrug Ringfietspad
655,Ringfietspad Zurenborgbrug,2022-12-22,21:00:00,0,0,0,FMN 06 B Zurenborgbrug Ringfietspad
655,Ringfietspad Zurenborgbrug,2022-12-22,22:00:00,0,0,0,FMN 06 B Zurenborgbrug Ringfietspad
655,Ringfietspad Zurenborgbrug,2022-12-22,23:00:00,0,0,0,FMN 06 B Zurenborgbrug Ringfietspad
655,Ringfietspad Zurenborgbrug,2022-12-23,00:00:00,0,0,0,FMN 06 B Zurenborgbrug Ringfietspad
655,Ringfietspad Zurenborgbrug,2022-12-23,01:00:00,0,0,0,FMN 06 B Zurenborgbrug Ringfietspad
655,Ringfietspad Zurenborgbrug,2022-12-23,02:00:00,0,0,0,FMN 06 B Zurenborgbrug Ringfietspad
655,Ringfietspad Zurenborgbrug,2022-12-23,03:00:00,0,0,0,FMN 06 B Zurenborgbrug Ringfietspad
655,Ringfietspad Zurenborgbrug,2022-12-23,04:00:00,0,0,0,FMN 06 B Zurenborgbrug Ringfietspad
655,Ringfietspad Zurenborgbrug,2022-12-23,05:00:00,0,0,0,FMN 06 B Zurenborgbrug Ringfietspad
655,Ringfietspad Zurenborgbrug,2022-12-23,06:00:00,0,0,0,FMN 06 B Zurenborgbrug Ringfietspad
655,Ringfietspad Zurenborgbrug,2022-12-23,07:00:00,0,0,0,FMN 06 B Zurenborgbrug Ringfietspad
655,Ringfietspad Zurenborgbrug,2022-12-23,08:00:00,0,0,0,FMN 06 B Zurenborgbrug Ringfietspad
655,Ringfietspad Zurenborgbrug,2022-12-23,09:00:00,0,0,0,FMN 06 B Zurenborgbrug Ringfietspad
655,Ringfietspad Zurenborgbrug,2022-12-23,10:00:00,0,0,0,FMN 06 B Zurenborgbrug Ringfietspad
655,Ringfietspad Zurenborgbrug,2022-12-23,11:00:00,0,0,0,FMN 06 B Zurenborgbrug Ringfietspad
655,Ringfietspad Zurenborgbrug,2022-12-23,12:00:00,0,0,0,FMN 06 B Zurenborgbrug Ringfietspad
655,Ringfietspad Zurenborgbrug,2022-12-23,13:00:00,48,23,25,FMN 06 B Zurenborgbrug Ringfietspad
655,Ringfietspad Zurenborgbrug,2022-12-23,14:00:00,108,41,67,FMN 06 B Zurenborgbrug Ringfietspad
655,Ringfietspad Zurenborgbrug,2022-12-23,15:00:00,142,73,69,FMN 06 B Zurenborgbrug Ringfietspad
655,Ringfietspad Zurenborgbrug,2022-12-23,16:00:00,188,74,114,FMN 06 B Zurenborgbrug Ringfietspad
655,Ringfietspad Zurenborgbrug,2022-12-23,17:00:00,42,18,24,FMN 06 B Zurenborgbrug Ringfietspad
655,Ringfietspad Zurenborgbrug,2022-12-23,18:00:00,0,0,0,FMN 06 B Zurenborgbrug Ringfietspad
655,Ringfietspad Zurenborgbrug,2022-12-23,19:00:00,0,0,0,FMN 06 B Zurenborgbrug Ringfietspad
655,Ringfietspad Zurenborgbrug,2022-12-23,20:00:00,0,0,0,FMN 06 B Zurenborgbrug Ringfietspad
655,Ringfietspad Zurenborgbrug,2022-12-23,21:00:00,0,0,0,FMN 06 B Zurenborgbrug Ringfietspad
655,Ringfietspad Zurenborgbrug,2022-12-23,22:00:00,0,0,0,FMN 06 B Zurenborgbrug Ringfietspad
655,Ringfietspad Zurenborgbrug,2022-12-23,23:00:00,0,0,0,FMN 06 B Zurenborgbrug Ringfietspad
655,Ringfietspad Zurenborgbrug,2022-12-24,00:00:00,0,0,0,FMN 06 B Zurenborgbrug Ringfietspad
655,Ringfietspad Zurenborgbrug,2022-12-24,01:00:00,0,0,0,FMN 06 B Zurenborgbrug Ringfietspad
655,Ringfietspad Zurenborgbrug,2022-12-24,02:00:00,0,0,0,FMN 06 B Zurenborgbrug Ringfietspad
655,Ringfietspad Zurenborgbrug,2022-12-24,03:00:00,0,0,0,FMN 06 B Zurenborgbrug Ringfietspad
655,Ringfietspad Zurenborgbrug,2022-12-24,04:00:00,0,0,0,FMN 06 B Zurenborgbrug Ringfietspad
655,Ringfietspad Zurenborgbrug,2022-12-24,05:00:00,0,0,0,FMN 06 B Zurenborgbrug Ringfietspad
655,Ringfietspad Zurenborgbrug,2022-12-24,06:00:00,0,0,0,FMN 06 B Zurenborgbrug Ringfietspad
655,Ringfietspad Zurenborgbrug,2022-12-24,07:00:00,0,0,0,FMN 06 B Zurenborgbrug Ringfietspad
655,Ringfietspad Zurenborgbrug,2022-12-24,08:00:00,0,0,0,FMN 06 B Zurenborgbrug Ringfietspad
655,Ringfietspad Zurenborgbrug,2022-12-24,09:00:00,0,0,0,FMN 06 B Zurenborgbrug Ringfietspad
655,Ringfietspad Zurenborgbrug,2022-12-24,10:00:00,33,15,18,FMN 06 B Zurenborgbrug Ringfietspad
655,Ringfietspad Zurenborgbrug,2022-12-24,11:00:00,52,25,27,FMN 06 B Zurenborgbrug Ringfietspad
655,Ringfietspad Zurenborgbrug,2022-12-24,12:00:00,71,33,38,FMN 06 B Zurenborgbrug Ringfietspad
655,Ringfietspad Zurenborgbrug,2022-12-24,13:00:00,74,32,42,FMN 06 B Zurenborgbrug Ringfietspad
655,Ringfietspad Zurenborgbrug,2022-12-24,14:00:00,73,35,38,FMN 06 B Zurenborgbrug Ringfietspad
655,Ringfietspad Zurenborgbrug,2022-12-24,15:00:00,66,30,36,FMN 06 B Zurenborgbrug Ringfietspad
655,Ringfietspad Zurenborgbrug,2022-12-24,16:00:00,29,12,17,FMN 06 B Zurenborgbrug Ringfietspad
655,Ringfietspad Zurenborgbrug,2022-12-24,17:00:00,0,0,0,FMN 06 B Zurenborgbrug Ringfietspad
655,Ringfietspad Zurenborgbrug,2022-12-24,18:00:00,0,0,0,FMN 06 B Zurenborgbrug Ringfietspad
655,Ringfietspad Zurenborgbrug,2022-12-24,19:00:00,0,0,0,FMN 06 B Zurenborgbrug Ringfietspad
655,Ringfietspad Zurenborgbrug,2022-12-24,20:00:00,0,0,0,FMN 06 B Zurenborgbrug Ringfietspad
655,Ringfietspad Zurenborgbrug,2022-12-24,21:00:00,0,0,0,FMN 06 B Zurenborgbrug Ringfietspad
655,Ringfietspad Zurenborgbrug,2022-12-24,22:00:00,0,0,0,FMN 06 B Zurenborgbrug Ringfietspad
655,Ringfietspad Zurenborgbrug,2022-12-24,23:00:00,0,0,0,FMN 06 B Zurenborgbrug Ringfietspad
655,Ringfietspad Zurenborgbrug,2022-12-25,00:00:00,0,0,0,FMN 06 B Zurenborgbrug Ringfietspad
655,Ringfietspad Zurenborgbrug,2022-12-25,01:00:00,0,0,0,FMN 06 B Zurenborgbrug Ringfietspad
655,Ringfietspad Zurenborgbrug,2022-12-25,02:00:00,0,0,0,FMN 06 B Zurenborgbrug Ringfietspad
655,Ringfietspad Zurenborgbrug,2022-12-25,03:00:00,0,0,0,FMN 06 B Zurenborgbrug Ringfietspad
655,Ringfietspad Zurenborgbrug,2022-12-25,04:00:00,0,0,0,FMN 06 B Zurenborgbrug Ringfietspad
655,Ringfietspad Zurenborgbrug,2022-12-25,05:00:00,0,0,0,FMN 06 B Zurenborgbrug Ringfietspad
655,Ringfietspad Zurenborgbrug,2022-12-25,06:00:00,0,0,0,FMN 06 B Zurenborgbrug Ringfietspad
655,Ringfietspad Zurenborgbrug,2022-12-25,07:00:00,0,0,0,FMN 06 B Zurenborgbrug Ringfietspad
655,Ringfietspad Zurenborgbrug,2022-12-25,08:00:00,0,0,0,FMN 06 B Zurenborgbrug Ringfietspad
655,Ringfietspad Zurenborgbrug,2022-12-25,09:00:00,0,0,0,FMN 06 B Zurenborgbrug Ringfietspad
655,Ringfietspad Zurenborgbrug,2022-12-25,10:00:00,18,8,10,FMN 06 B Zurenborgbrug Ringfietspad
655,Ringfietspad Zurenborgbrug,2022-12-25,11:00:00,35,18,17,FMN 06 B Zurenborgbrug Ringfietspad
655,Ringfietspad Zurenborgbrug,2022-12-25,12:00:00,25,13,12,FMN 06 B Zurenborgbrug Ringfietspad
655,Ringfietspad Zurenborgbrug,2022-12-25,13:00:00,24,15,9,FMN 06 B Zurenborgbrug Ringfietspad
655,Ringfietspad Zurenborgbrug,2022-12-25,14:00:00,26,16,10,FMN 06 B Zurenborgbrug Ringfietspad
655,Ringfietspad Zurenborgbrug,2022-12-25,15:00:00,24,10,14,FMN 06 B Zurenborgbrug Ringfietspad
655,Ringfietspad Zurenborgbrug,2022-12-25,16:00:00,20,12,8,FMN 06 B Zurenborgbrug Ringfietspad
655,Ringfietspad Zurenborgbrug,2022-12-25,17:00:00,26,13,13,FMN 06 B Zurenborgbrug Ringfietspad
655,Ringfietspad Zurenborgbrug,2022-12-25,18:00:00,4,1,3,FMN 06 B Zurenborgbrug Ringfietspad
655,Ringfietspad Zurenborgbrug,2022-12-25,19:00:00,0,0,0,FMN 06 B Zurenborgbrug Ringfietspad
655,Ringfietspad Zurenborgbrug,2022-12-25,20:00:00,0,0,0,FMN 06 B Zurenborgbrug Ringfietspad
655,Ringfietspad Zurenborgbrug,2022-12-25,21:00:00,0,0,0,FMN 06 B Zurenborgbrug Ringfietspad
655,Ringfietspad Zurenborgbrug,2022-12-25,22:00:00,0,0,0,FMN 06 B Zurenborgbrug Ringfietspad
655,Ringfietspad Zurenborgbrug,2022-12-25,23:00:00,0,0,0,FMN 06 B Zurenborgbrug Ringfietspad
655,Ringfietspad Zurenborgbrug,2022-12-26,00:00:00,0,0,0,FMN 06 B Zurenborgbrug Ringfietspad
655,Ringfietspad Zurenborgbrug,2022-12-26,01:00:00,0,0,0,FMN 06 B Zurenborgbrug Ringfietspad
655,Ringfietspad Zurenborgbrug,2022-12-26,02:00:00,0,0,0,FMN 06 B Zurenborgbrug Ringfietspad
655,Ringfietspad Zurenborgbrug,2022-12-26,03:00:00,0,0,0,FMN 06 B Zurenborgbrug Ringfietspad
655,Ringfietspad Zurenborgbrug,2022-12-26,04:00:00,0,0,0,FMN 06 B Zurenborgbrug Ringfietspad
655,Ringfietspad Zurenborgbrug,2022-12-26,05:00:00,0,0,0,FMN 06 B Zurenborgbrug Ringfietspad
655,Ringfietspad Zurenborgbrug,2022-12-26,06:00:00,0,0,0,FMN 06 B Zurenborgbrug Ringfietspad
655,Ringfietspad Zurenborgbrug,2022-12-26,07:00:00,0,0,0,FMN 06 B Zurenborgbrug Ringfietspad
655,Ringfietspad Zurenborgbrug,2022-12-26,08:00:00,0,0,0,FMN 06 B Zurenborgbrug Ringfietspad
655,Ringfietspad Zurenborgbrug,2022-12-26,09:00:00,12,5,7,FMN 06 B Zurenborgbrug Ringfietspad
655,Ringfietspad Zurenborgbrug,2022-12-26,10:00:00,44,20,24,FMN 06 B Zurenborgbrug Ringfietspad
655,Ringfietspad Zurenborgbrug,2022-12-26,11:00:00,31,16,15,FMN 06 B Zurenborgbrug Ringfietspad
655,Ringfietspad Zurenborgbrug,2022-12-26,12:00:00,47,21,26,FMN 06 B Zurenborgbrug Ringfietspad
655,Ringfietspad Zurenborgbrug,2022-12-26,13:00:00,69,39,30,FMN 06 B Zurenborgbrug Ringfietspad
655,Ringfietspad Zurenborgbrug,2022-12-26,14:00:00,64,34,30,FMN 06 B Zurenborgbrug Ringfietspad
655,Ringfietspad Zurenborgbrug,2022-12-26,15:00:00,82,41,41,FMN 06 B Zurenborgbrug Ringfietspad
655,Ringfietspad Zurenborgbrug,2022-12-26,16:00:00,99,33,66,FMN 06 B Zurenborgbrug Ringfietspad
655,Ringfietspad Zurenborgbrug,2022-12-26,17:00:00,97,52,45,FMN 06 B Zurenborgbrug Ringfietspad
655,Ringfietspad Zurenborgbrug,2022-12-26,18:00:00,64,32,32,FMN 06 B Zurenborgbrug Ringfietspad
655,Ringfietspad Zurenborgbrug,2022-12-26,19:00:00,57,16,41,FMN 06 B Zurenborgbrug Ringfietspad
655,Ringfietspad Zurenborgbrug,2022-12-26,20:00:00,0,0,0,FMN 06 B Zurenborgbrug Ringfietspad
655,Ringfietspad Zurenborgbrug,2022-12-26,21:00:00,0,0,0,FMN 06 B Zurenborgbrug Ringfietspad
655,Ringfietspad Zurenborgbrug,2022-12-26,22:00:00,0,0,0,FMN 06 B Zurenborgbrug Ringfietspad
655,Ringfietspad Zurenborgbrug,2022-12-26,23:00:00,0,0,0,FMN 06 B Zurenborgbrug Ringfietspad
655,Ringfietspad Zurenborgbrug,2022-12-27,00:00:00,0,0,0,FMN 06 B Zurenborgbrug Ringfietspad
655,Ringfietspad Zurenborgbrug,2022-12-27,01:00:00,0,0,0,FMN 06 B Zurenborgbrug Ringfietspad
655,Ringfietspad Zurenborgbrug,2022-12-27,02:00:00,0,0,0,FMN 06 B Zurenborgbrug Ringfietspad
655,Ringfietspad Zurenborgbrug,2022-12-27,03:00:00,0,0,0,FMN 06 B Zurenborgbrug Ringfietspad
655,Ringfietspad Zurenborgbrug,2022-12-27,04:00:00,0,0,0,FMN 06 B Zurenborgbrug Ringfietspad
655,Ringfietspad Zurenborgbrug,2022-12-27,05:00:00,0,0,0,FMN 06 B Zurenborgbrug Ringfietspad
655,Ringfietspad Zurenborgbrug,2022-12-27,06:00:00,0,0,0,FMN 06 B Zurenborgbrug Ringfietspad
655,Ringfietspad Zurenborgbrug,2022-12-27,07:00:00,0,0,0,FMN 06 B Zurenborgbrug Ringfietspad
655,Ringfietspad Zurenborgbrug,2022-12-27,08:00:00,0,0,0,FMN 06 B Zurenborgbrug Ringfietspad
655,Ringfietspad Zurenborgbrug,2022-12-27,09:00:00,0,0,0,FMN 06 B Zurenborgbrug Ringfietspad
655,Ringfietspad Zurenborgbrug,2022-12-27,10:00:00,4,1,3,FMN 06 B Zurenborgbrug Ringfietspad
655,Ringfietspad Zurenborgbrug,2022-12-27,11:00:00,85,41,44,FMN 06 B Zurenborgbrug Ringfietspad
655,Ringfietspad Zurenborgbrug,2022-12-27,12:00:00,98,42,56,FMN 06 B Zurenborgbrug Ringfietspad
655,Ringfietspad Zurenborgbrug,2022-12-27,13:00:00,110,55,55,FMN 06 B Zurenborgbrug Ringfietspad
655,Ringfietspad Zurenborgbrug,2022-12-27,14:00:00,92,37,55,FMN 06 B Zurenborgbrug Ringfietspad
655,Ringfietspad Zurenborgbrug,2022-12-27,15:00:00,92,37,55,FMN 06 B Zurenborgbrug Ringfietspad
655,Ringfietspad Zurenborgbrug,2022-12-27,16:00:00,54,26,28,FMN 06 B Zurenborgbrug Ringfietspad
655,Ringfietspad Zurenborgbrug,2022-12-27,17:00:00,0,0,0,FMN 06 B Zurenborgbrug Ringfietspad
655,Ringfietspad Zurenborgbrug,2022-12-27,18:00:00,0,0,0,FMN 06 B Zurenborgbrug Ringfietspad
655,Ringfietspad Zurenborgbrug,2022-12-27,19:00:00,0,0,0,FMN 06 B Zurenborgbrug Ringfietspad
655,Ringfietspad Zurenborgbrug,2022-12-27,20:00:00,0,0,0,FMN 06 B Zurenborgbrug Ringfietspad
655,Ringfietspad Zurenborgbrug,2022-12-27,21:00:00,0,0,0,FMN 06 B Zurenborgbrug Ringfietspad
655,Ringfietspad Zurenborgbrug,2022-12-27,22:00:00,0,0,0,FMN 06 B Zurenborgbrug Ringfietspad
655,Ringfietspad Zurenborgbrug,2022-12-27,23:00:00,0,0,0,FMN 06 B Zurenborgbrug Ringfietspad
655,Ringfietspad Zurenborgbrug,2022-12-28,00:00:00,0,0,0,FMN 06 B Zurenborgbrug Ringfietspad
655,Ringfietspad Zurenborgbrug,2022-12-28,01:00:00,0,0,0,FMN 06 B Zurenborgbrug Ringfietspad
655,Ringfietspad Zurenborgbrug,2022-12-28,02:00:00,0,0,0,FMN 06 B Zurenborgbrug Ringfietspad
655,Ringfietspad Zurenborgbrug,2022-12-28,03:00:00,0,0,0,FMN 06 B Zurenborgbrug Ringfietspad
655,Ringfietspad Zurenborgbrug,2022-12-28,04:00:00,0,0,0,FMN 06 B Zurenborgbrug Ringfietspad
655,Ringfietspad Zurenborgbrug,2022-12-28,05:00:00,0,0,0,FMN 06 B Zurenborgbrug Ringfietspad
655,Ringfietspad Zurenborgbrug,2022-12-28,06:00:00,0,0,0,FMN 06 B Zurenborgbrug Ringfietspad
655,Ringfietspad Zurenborgbrug,2022-12-28,07:00:00,0,0,0,FMN 06 B Zurenborgbrug Ringfietspad
655,Ringfietspad Zurenborgbrug,2022-12-28,08:00:00,0,0,0,FMN 06 B Zurenborgbrug Ringfietspad
655,Ringfietspad Zurenborgbrug,2022-12-28,09:00:00,0,0,0,FMN 06 B Zurenborgbrug Ringfietspad
655,Ringfietspad Zurenborgbrug,2022-12-28,10:00:00,0,0,0,FMN 06 B Zurenborgbrug Ringfietspad
655,Ringfietspad Zurenborgbrug,2022-12-28,11:00:00,17,9,8,FMN 06 B Zurenborgbrug Ringfietspad
655,Ringfietspad Zurenborgbrug,2022-12-28,12:00:00,53,27,26,FMN 06 B Zurenborgbrug Ringfietspad
655,Ringfietspad Zurenborgbrug,2022-12-28,13:00:00,48,23,25,FMN 06 B Zurenborgbrug Ringfietspad
655,Ringfietspad Zurenborgbrug,2022-12-28,14:00:00,82,43,39,FMN 06 B Zurenborgbrug Ringfietspad
655,Ringfietspad Zurenborgbrug,2022-12-28,15:00:00,75,27,48,FMN 06 B Zurenborgbrug Ringfietspad
655,Ringfietspad Zurenborgbrug,2022-12-28,16:00:00,106,43,63,FMN 06 B Zurenborgbrug Ringfietspad
655,Ringfietspad Zurenborgbrug,2022-12-28,17:00:00,57,30,27,FMN 06 B Zurenborgbrug Ringfietspad
655,Ringfietspad Zurenborgbrug,2022-12-28,18:00:00,0,0,0,FMN 06 B Zurenborgbrug Ringfietspad
655,Ringfietspad Zurenborgbrug,2022-12-28,19:00:00,0,0,0,FMN 06 B Zurenborgbrug Ringfietspad
655,Ringfietspad Zurenborgbrug,2022-12-28,20:00:00,0,0,0,FMN 06 B Zurenborgbrug Ringfietspad
655,Ringfietspad Zurenborgbrug,2022-12-28,21:00:00,0,0,0,FMN 06 B Zurenborgbrug Ringfietspad
655,Ringfietspad Zurenborgbrug,2022-12-28,22:00:00,0,0,0,FMN 06 B Zurenborgbrug Ringfietspad
655,Ringfietspad Zurenborgbrug,2022-12-28,23:00:00,0,0,0,FMN 06 B Zurenborgbrug Ringfietspad
655,Ringfietspad Zurenborgbrug,2022-12-29,00:00:00,0,0,0,FMN 06 B Zurenborgbrug Ringfietspad
655,Ringfietspad Zurenborgbrug,2022-12-29,01:00:00,0,0,0,FMN 06 B Zurenborgbrug Ringfietspad
655,Ringfietspad Zurenborgbrug,2022-12-29,02:00:00,0,0,0,FMN 06 B Zurenborgbrug Ringfietspad
655,Ringfietspad Zurenborgbrug,2022-12-29,03:00:00,0,0,0,FMN 06 B Zurenborgbrug Ringfietspad
655,Ringfietspad Zurenborgbrug,2022-12-29,04:00:00,0,0,0,FMN 06 B Zurenborgbrug Ringfietspad
655,Ringfietspad Zurenborgbrug,2022-12-29,05:00:00,0,0,0,FMN 06 B Zurenborgbrug Ringfietspad
655,Ringfietspad Zurenborgbrug,2022-12-29,06:00:00,0,0,0,FMN 06 B Zurenborgbrug Ringfietspad
655,Ringfietspad Zurenborgbrug,2022-12-29,07:00:00,0,0,0,FMN 06 B Zurenborgbrug Ringfietspad
655,Ringfietspad Zurenborgbrug,2022-12-29,08:00:00,0,0,0,FMN 06 B Zurenborgbrug Ringfietspad
655,Ringfietspad Zurenborgbrug,2022-12-29,09:00:00,0,0,0,FMN 06 B Zurenborgbrug Ringfietspad
655,Ringfietspad Zurenborgbrug,2022-12-29,10:00:00,12,4,8,FMN 06 B Zurenborgbrug Ringfietspad
655,Ringfietspad Zurenborgbrug,2022-12-29,11:00:00,50,21,29,FMN 06 B Zurenborgbrug Ringfietspad
655,Ringfietspad Zurenborgbrug,2022-12-29,12:00:00,61,38,23,FMN 06 B Zurenborgbrug Ringfietspad
655,Ringfietspad Zurenborgbrug,2022-12-29,13:00:00,50,24,26,FMN 06 B Zurenborgbrug Ringfietspad
655,Ringfietspad Zurenborgbrug,2022-12-29,14:00:00,61,27,34,FMN 06 B Zurenborgbrug Ringfietspad
655,Ringfietspad Zurenborgbrug,2022-12-29,15:00:00,74,38,36,FMN 06 B Zurenborgbrug Ringfietspad
655,Ringfietspad Zurenborgbrug,2022-12-29,16:00:00,105,47,58,FMN 06 B Zurenborgbrug Ringfietspad
655,Ringfietspad Zurenborgbrug,2022-12-29,17:00:00,128,53,75,FMN 06 B Zurenborgbrug Ringfietspad
655,Ringfietspad Zurenborgbrug,2022-12-29,18:00:00,94,33,61,FMN 06 B Zurenborgbrug Ringfietspad
655,Ringfietspad Zurenborgbrug,2022-12-29,19:00:00,67,17,50,FMN 06 B Zurenborgbrug Ringfietspad
655,Ringfietspad Zurenborgbrug,2022-12-29,20:00:00,47,28,19,FMN 06 B Zurenborgbrug Ringfietspad
655,Ringfietspad Zurenborgbrug,2022-12-29,21:00:00,50,20,30,FMN 06 B Zurenborgbrug Ringfietspad
655,Ringfietspad Zurenborgbrug,2022-12-29,22:00:00,24,12,12,FMN 06 B Zurenborgbrug Ringfietspad
655,Ringfietspad Zurenborgbrug,2022-12-29,23:00:00,0,0,0,FMN 06 B Zurenborgbrug Ringfietspad
655,Ringfietspad Zurenborgbrug,2022-12-30,00:00:00,5,3,2,FMN 06 B Zurenborgbrug Ringfietspad
655,Ringfietspad Zurenborgbrug,2022-12-30,01:00:00,1,0,1,FMN 06 B Zurenborgbrug Ringfietspad
655,Ringfietspad Zurenborgbrug,2022-12-30,02:00:00,2,2,0,FMN 06 B Zurenborgbrug Ringfietspad
655,Ringfietspad Zurenborgbrug,2022-12-30,03:00:00,1,0,1,FMN 06 B Zurenborgbrug Ringfietspad
655,Ringfietspad Zurenborgbrug,2022-12-30,04:00:00,5,4,1,FMN 06 B Zurenborgbrug Ringfietspad
655,Ringfietspad Zurenborgbrug,2022-12-30,05:00:00,9,6,3,FMN 06 B Zurenborgbrug Ringfietspad
655,Ringfietspad Zurenborgbrug,2022-12-30,06:00:00,36,19,17,FMN 06 B Zurenborgbrug Ringfietspad
655,Ringfietspad Zurenborgbrug,2022-12-30,07:00:00,82,52,30,FMN 06 B Zurenborgbrug Ringfietspad
655,Ringfietspad Zurenborgbrug,2022-12-30,08:00:00,110,61,49,FMN 06 B Zurenborgbrug Ringfietspad
655,Ringfietspad Zurenborgbrug,2022-12-30,09:00:00,41,22,19,FMN 06 B Zurenborgbrug Ringfietspad
655,Ringfietspad Zurenborgbrug,2022-12-30,10:00:00,38,21,17,FMN 06 B Zurenborgbrug Ringfietspad
655,Ringfietspad Zurenborgbrug,2022-12-30,11:00:00,32,16,16,FMN 06 B Zurenborgbrug Ringfietspad
655,Ringfietspad Zurenborgbrug,2022-12-30,12:00:00,53,22,31,FMN 06 B Zurenborgbrug Ringfietspad
655,Ringfietspad Zurenborgbrug,2022-12-30,13:00:00,56,19,37,FMN 06 B Zurenborgbrug Ringfietspad
655,Ringfietspad Zurenborgbrug,2022-12-30,14:00:00,56,20,36,FMN 06 B Zurenborgbrug Ringfietspad
655,Ringfietspad Zurenborgbrug,2022-12-30,15:00:00,70,24,46,FMN 06 B Zurenborgbrug Ringfietspad
655,Ringfietspad Zurenborgbrug,2022-12-30,16:00:00,128,51,77,FMN 06 B Zurenborgbrug Ringfietspad
655,Ringfietspad Zurenborgbrug,2022-12-30,17:00:00,101,40,61,FMN 06 B Zurenborgbrug Ringfietspad
655,Ringfietspad Zurenborgbrug,2022-12-30,18:00:00,60,26,34,FMN 06 B Zurenborgbrug Ringfietspad
655,Ringfietspad Zurenborgbrug,2022-12-30,19:00:00,37,16,21,FMN 06 B Zurenborgbrug Ringfietspad
655,Ringfietspad Zurenborgbrug,2022-12-30,20:00:00,22,12,10,FMN 06 B Zurenborgbrug Ringfietspad
655,Ringfietspad Zurenborgbrug,2022-12-30,21:00:00,16,7,9,FMN 06 B Zurenborgbrug Ringfietspad
655,Ringfietspad Zurenborgbrug,2022-12-30,22:00:00,23,8,15,FMN 06 B Zurenborgbrug Ringfietspad
655,Ringfietspad Zurenborgbrug,2022-12-30,23:00:00,21,9,12,FMN 06 B Zurenborgbrug Ringfietspad
655,Ringfietspad Zurenborgbrug,2022-12-31,00:00:00,19,10,9,FMN 06 B Zurenborgbrug Ringfietspad
655,Ringfietspad Zurenborgbrug,2022-12-31,01:00:00,6,3,3,FMN 06 B Zurenborgbrug Ringfietspad
655,Ringfietspad Zurenborgbrug,2022-12-31,02:00:00,1,0,1,FMN 06 B Zurenborgbrug Ringfietspad
655,Ringfietspad Zurenborgbrug,2022-12-31,03:00:00,2,1,1,FMN 06 B Zurenborgbrug Ringfietspad
655,Ringfietspad Zurenborgbrug,2022-12-31,04:00:00,5,1,4,FMN 06 B Zurenborgbrug Ringfietspad
655,Ringfietspad Zurenborgbrug,2022-12-31,05:00:00,3,1,2,FMN 06 B Zurenborgbrug Ringfietspad
655,Ringfietspad Zurenborgbrug,2022-12-31,06:00:00,10,8,2,FMN 06 B Zurenborgbrug Ringfietspad
655,Ringfietspad Zurenborgbrug,2022-12-31,07:00:00,16,8,8,FMN 06 B Zurenborgbrug Ringfietspad
655,Ringfietspad Zurenborgbrug,2022-12-31,08:00:00,29,15,14,FMN 06 B Zurenborgbrug Ringfietspad
655,Ringfietspad Zurenborgbrug,2022-12-31,09:00:00,35,17,18,FMN 06 B Zurenborgbrug Ringfietspad
655,Ringfietspad Zurenborgbrug,2022-12-31,10:00:00,52,27,25,FMN 06 B Zurenborgbrug Ringfietspad
655,Ringfietspad Zurenborgbrug,2022-12-31,11:00:00,55,27,28,FMN 06 B Zurenborgbrug Ringfietspad
655,Ringfietspad Zurenborgbrug,2022-12-31,12:00:00,59,30,29,FMN 06 B Zurenborgbrug Ringfietspad
655,Ringfietspad Zurenborgbrug,2022-12-31,13:00:00,91,44,47,FMN 06 B Zurenborgbrug Ringfietspad
655,Ringfietspad Zurenborgbrug,2022-12-31,14:00:00,78,40,38,FMN 06 B Zurenborgbrug Ringfietspad
655,Ringfietspad Zurenborgbrug,2022-12-31,15:00:00,66,32,34,FMN 06 B Zurenborgbrug Ringfietspad
655,Ringfietspad Zurenborgbrug,2022-12-31,16:00:00,63,36,27,FMN 06 B Zurenborgbrug Ringfietspad
655,Ringfietspad Zurenborgbrug,2022-12-31,17:00:00,62,29,33,FMN 06 B Zurenborgbrug Ringfietspad
655,Ringfietspad Zurenborgbrug,2022-12-31,18:00:00,54,26,28,FMN 06 B Zurenborgbrug Ringfietspad
655,Ringfietspad Zurenborgbrug,2022-12-31,19:00:00,54,26,28,FMN 06 B Zurenborgbrug Ringfietspad
655,Ringfietspad Zurenborgbrug,2022-12-31,20:00:00,28,11,17,FMN 06 B Zurenborgbrug Ringfietspad
655,Ringfietspad Zurenborgbrug,2022-12-31,21:00:00,24,11,13,FMN 06 B Zurenborgbrug Ringfietspad
655,Ringfietspad Zurenborgbrug,2022-12-31,22:00:00,27,18,9,FMN 06 B Zurenborgbrug Ringfietspad
655,Ringfietspad Zurenborgbrug,2022-12-31,23:00:00,25,10,15,FMN 06 B Zurenborgbrug Ringfietspad
655,Ringfietspad Zurenborgbrug,2023-01-01,00:00:00,0,0,0,FMN 06 B Zurenborgbrug Ringfietspad
655,Ringfietspad Zurenborgbrug,2023-01-01,01:00:00,0,0,0,FMN 06 B Zurenborgbrug Ringfietspad
655,Ringfietspad Zurenborgbrug,2023-01-01,02:00:00,0,0,0,FMN 06 B Zurenborgbrug Ringfietspad
655,Ringfietspad Zurenborgbrug,2023-01-01,03:00:00,0,0,0,FMN 06 B Zurenborgbrug Ringfietspad
655,Ringfietspad Zurenborgbrug,2023-01-01,04:00:00,0,0,0,FMN 06 B Zurenborgbrug Ringfietspad
655,Ringfietspad Zurenborgbrug,2023-01-01,05:00:00,0,0,0,FMN 06 B Zurenborgbrug Ringfietspad
655,Ringfietspad Zurenborgbrug,2023-01-01,06:00:00,0,0,0,FMN 06 B Zurenborgbrug Ringfietspad
655,Ringfietspad Zurenborgbrug,2023-01-01,07:00:00,0,0,0,FMN 06 B Zurenborgbrug Ringfietspad
655,Ringfietspad Zurenborgbrug,2023-01-01,08:00:00,0,0,0,FMN 06 B Zurenborgbrug Ringfietspad
655,Ringfietspad Zurenborgbrug,2023-01-01,09:00:00,0,0,0,FMN 06 B Zurenborgbrug Ringfietspad
655,Ringfietspad Zurenborgbrug,2023-01-01,10:00:00,0,0,0,FMN 06 B Zurenborgbrug Ringfietspad
655,Ringfietspad Zurenborgbrug,2023-01-01,11:00:00,19,6,13,FMN 06 B Zurenborgbrug Ringfietspad
655,Ringfietspad Zurenborgbrug,2023-01-01,12:00:00,39,13,26,FMN 06 B Zurenborgbrug Ringfietspad
655,Ringfietspad Zurenborgbrug,2023-01-01,13:00:00,69,31,38,FMN 06 B Zurenborgbrug Ringfietspad
655,Ringfietspad Zurenborgbrug,2023-01-01,14:00:00,68,33,35,FMN 06 B Zurenborgbrug Ringfietspad
655,Ringfietspad Zurenborgbrug,2023-01-01,15:00:00,37,22,15,FMN 06 B Zurenborgbrug Ringfietspad
655,Ringfietspad Zurenborgbrug,2023-01-01,16:00:00,0,0,0,FMN 06 B Zurenborgbrug Ringfietspad
655,Ringfietspad Zurenborgbrug,2023-01-01,17:00:00,0,0,0,FMN 06 B Zurenborgbrug Ringfietspad
655,Ringfietspad Zurenborgbrug,2023-01-01,18:00:00,0,0,0,FMN 06 B Zurenborgbrug Ringfietspad
655,Ringfietspad Zurenborgbrug,2023-01-01,19:00:00,0,0,0,FMN 06 B Zurenborgbrug Ringfietspad
655,Ringfietspad Zurenborgbrug,2023-01-01,20:00:00,0,0,0,FMN 06 B Zurenborgbrug Ringfietspad
655,Ringfietspad Zurenborgbrug,2023-01-01,21:00:00,0,0,0,FMN 06 B Zurenborgbrug Ringfietspad
655,Ringfietspad Zurenborgbrug,2023-01-01,22:00:00,0,0,0,FMN 06 B Zurenborgbrug Ringfietspad
655,Ringfietspad Zurenborgbrug,2023-01-01,23:00:00,0,0,0,FMN 06 B Zurenborgbrug Ringfietspad
655,Ringfietspad Zurenborgbrug,2023-01-02,00:00:00,0,0,0,FMN 06 B Zurenborgbrug Ringfietspad
655,Ringfietspad Zurenborgbrug,2023-01-02,01:00:00,0,0,0,FMN 06 B Zurenborgbrug Ringfietspad
655,Ringfietspad Zurenborgbrug,2023-01-02,02:00:00,0,0,0,FMN 06 B Zurenborgbrug Ringfietspad
655,Ringfietspad Zurenborgbrug,2023-01-02,03:00:00,0,0,0,FMN 06 B Zurenborgbrug Ringfietspad
655,Ringfietspad Zurenborgbrug,2023-01-02,04:00:00,0,0,0,FMN 06 B Zurenborgbrug Ringfietspad
655,Ringfietspad Zurenborgbrug,2023-01-02,05:00:00,0,0,0,FMN 06 B Zurenborgbrug Ringfietspad
655,Ringfietspad Zurenborgbrug,2023-01-02,06:00:00,0,0,0,FMN 06 B Zurenborgbrug Ringfietspad
655,Ringfietspad Zurenborgbrug,2023-01-02,07:00:00,0,0,0,FMN 06 B Zurenborgbrug Ringfietspad
655,Ringfietspad Zurenborgbrug,2023-01-02,08:00:00,0,0,0,FMN 06 B Zurenborgbrug Ringfietspad
655,Ringfietspad Zurenborgbrug,2023-01-02,09:00:00,0,0,0,FMN 06 B Zurenborgbrug Ringfietspad
655,Ringfietspad Zurenborgbrug,2023-01-02,10:00:00,24,13,11,FMN 06 B Zurenborgbrug Ringfietspad
655,Ringfietspad Zurenborgbrug,2023-01-02,11:00:00,41,22,19,FMN 06 B Zurenborgbrug Ringfietspad
655,Ringfietspad Zurenborgbrug,2023-01-02,12:00:00,69,35,34,FMN 06 B Zurenborgbrug Ringfietspad
655,Ringfietspad Zurenborgbrug,2023-01-02,13:00:00,81,37,44,FMN 06 B Zurenborgbrug Ringfietspad
655,Ringfietspad Zurenborgbrug,2023-01-02,14:00:00,29,12,17,FMN 06 B Zurenborgbrug Ringfietspad
655,Ringfietspad Zurenborgbrug,2023-01-02,15:00:00,0,0,0,FMN 06 B Zurenborgbrug Ringfietspad
655,Ringfietspad Zurenborgbrug,2023-01-02,16:00:00,0,0,0,FMN 06 B Zurenborgbrug Ringfietspad
655,Ringfietspad Zurenborgbrug,2023-01-02,17:00:00,0,0,0,FMN 06 B Zurenborgbrug Ringfietspad
655,Ringfietspad Zurenborgbrug,2023-01-02,18:00:00,0,0,0,FMN 06 B Zurenborgbrug Ringfietspad
655,Ringfietspad Zurenborgbrug,2023-01-02,19:00:00,0,0,0,FMN 06 B Zurenborgbrug Ringfietspad
655,Ringfietspad Zurenborgbrug,2023-01-02,20:00:00,0,0,0,FMN 06 B Zurenborgbrug Ringfietspad
655,Ringfietspad Zurenborgbrug,2023-01-02,21:00:00,0,0,0,FMN 06 B Zurenborgbrug Ringfietspad
655,Ringfietspad Zurenborgbrug,2023-01-02,22:00:00,0,0,0,FMN 06 B Zurenborgbrug Ringfietspad
655,Ringfietspad Zurenborgbrug,2023-01-02,23:00:00,0,0,0,FMN 06 B Zurenborgbrug Ringfietspad
655,Ringfietspad Zurenborgbrug,2023-01-03,00:00:00,0,0,0,FMN 06 B Zurenborgbrug Ringfietspad
655,Ringfietspad Zurenborgbrug,2023-01-03,01:00:00,0,0,0,FMN 06 B Zurenborgbrug Ringfietspad
655,Ringfietspad Zurenborgbrug,2023-01-03,02:00:00,0,0,0,FMN 06 B Zurenborgbrug Ringfietspad
655,Ringfietspad Zurenborgbrug,2023-01-03,03:00:00,0,0,0,FMN 06 B Zurenborgbrug Ringfietspad
655,Ringfietspad Zurenborgbrug,2023-01-03,04:00:00,0,0,0,FMN 06 B Zurenborgbrug Ringfietspad
655,Ringfietspad Zurenborgbrug,2023-01-03,05:00:00,0,0,0,FMN 06 B Zurenborgbrug Ringfietspad
655,Ringfietspad Zurenborgbrug,2023-01-03,06:00:00,0,0,0,FMN 06 B Zurenborgbrug Ringfietspad
655,Ringfietspad Zurenborgbrug,2023-01-03,07:00:00,0,0,0,FMN 06 B Zurenborgbrug Ringfietspad
655,Ringfietspad Zurenborgbrug,2023-01-03,08:00:00,0,0,0,FMN 06 B Zurenborgbrug Ringfietspad
655,Ringfietspad Zurenborgbrug,2023-01-03,09:00:00,0,0,0,FMN 06 B Zurenborgbrug Ringfietspad
655,Ringfietspad Zurenborgbrug,2023-01-03,10:00:00,21,9,12,FMN 06 B Zurenborgbrug Ringfietspad
655,Ringfietspad Zurenborgbrug,2023-01-03,11:00:00,73,38,35,FMN 06 B Zurenborgbrug Ringfietspad
655,Ringfietspad Zurenborgbrug,2023-01-03,12:00:00,82,50,32,FMN 06 B Zurenborgbrug Ringfietspad
655,Ringfietspad Zurenborgbrug,2023-01-03,13:00:00,105,54,51,FMN 06 B Zurenborgbrug Ringfietspad
655,Ringfietspad Zurenborgbrug,2023-01-03,14:00:00,85,41,44,FMN 06 B Zurenborgbrug Ringfietspad
655,Ringfietspad Zurenborgbrug,2023-01-03,15:00:00,93,35,58,FMN 06 B Zurenborgbrug Ringfietspad
655,Ringfietspad Zurenborgbrug,2023-01-03,16:00:00,132,48,84,FMN 06 B Zurenborgbrug Ringfietspad
655,Ringfietspad Zurenborgbrug,2023-01-03,17:00:00,0,0,0,FMN 06 B Zurenborgbrug Ringfietspad
655,Ringfietspad Zurenborgbrug,2023-01-03,18:00:00,0,0,0,FMN 06 B Zurenborgbrug Ringfietspad
655,Ringfietspad Zurenborgbrug,2023-01-03,19:00:00,0,0,0,FMN 06 B Zurenborgbrug Ringfietspad
655,Ringfietspad Zurenborgbrug,2023-01-03,20:00:00,0,0,0,FMN 06 B Zurenborgbrug Ringfietspad
655,Ringfietspad Zurenborgbrug,2023-01-03,21:00:00,0,0,0,FMN 06 B Zurenborgbrug Ringfietspad
655,Ringfietspad Zurenborgbrug,2023-01-03,22:00:00,0,0,0,FMN 06 B Zurenborgbrug Ringfietspad
655,Ringfietspad Zurenborgbrug,2023-01-03,23:00:00,0,0,0,FMN 06 B Zurenborgbrug Ringfietspad
655,Ringfietspad Zurenborgbrug,2023-01-04,00:00:00,0,0,0,FMN 06 B Zurenborgbrug Ringfietspad
655,Ringfietspad Zurenborgbrug,2023-01-04,01:00:00,0,0,0,FMN 06 B Zurenborgbrug Ringfietspad
655,Ringfietspad Zurenborgbrug,2023-01-04,02:00:00,0,0,0,FMN 06 B Zurenborgbrug Ringfietspad
655,Ringfietspad Zurenborgbrug,2023-01-04,03:00:00,0,0,0,FMN 06 B Zurenborgbrug Ringfietspad
655,Ringfietspad Zurenborgbrug,2023-01-04,04:00:00,0,0,0,FMN 06 B Zurenborgbrug Ringfietspad
655,Ringfietspad Zurenborgbrug,2023-01-04,05:00:00,0,0,0,FMN 06 B Zurenborgbrug Ringfietspad
655,Ringfietspad Zurenborgbrug,2023-01-04,06:00:00,0,0,0,FMN 06 B Zurenborgbrug Ringfietspad
655,Ringfietspad Zurenborgbrug,2023-01-04,07:00:00,0,0,0,FMN 06 B Zurenborgbrug Ringfietspad
655,Ringfietspad Zurenborgbrug,2023-01-04,08:00:00,0,0,0,FMN 06 B Zurenborgbrug Ringfietspad
655,Ringfietspad Zurenborgbrug,2023-01-04,09:00:00,0,0,0,FMN 06 B Zurenborgbrug Ringfietspad
655,Ringfietspad Zurenborgbrug,2023-01-04,10:00:00,8,4,4,FMN 06 B Zurenborgbrug Ringfietspad
655,Ringfietspad Zurenborgbrug,2023-01-04,11:00:00,45,18,27,FMN 06 B Zurenborgbrug Ringfietspad
655,Ringfietspad Zurenborgbrug,2023-01-04,12:00:00,62,39,23,FMN 06 B Zurenborgbrug Ringfietspad
655,Ringfietspad Zurenborgbrug,2023-01-04,13:00:00,72,30,42,FMN 06 B Zurenborgbrug Ringfietspad
655,Ringfietspad Zurenborgbrug,2023-01-04,14:00:00,60,26,34,FMN 06 B Zurenborgbrug Ringfietspad
655,Ringfietspad Zurenborgbrug,2023-01-04,15:00:00,81,23,58,FMN 06 B Zurenborgbrug Ringfietspad
655,Ringfietspad Zurenborgbrug,2023-01-04,16:00:00,142,58,84,FMN 06 B Zurenborgbrug Ringfietspad
655,Ringfietspad Zurenborgbrug,2023-01-04,17:00:00,220,82,138,FMN 06 B Zurenborgbrug Ringfietspad
655,Ringfietspad Zurenborgbrug,2023-01-04,18:00:00,119,52,67,FMN 06 B Zurenborgbrug Ringfietspad
655,Ringfietspad Zurenborgbrug,2023-01-04,19:00:00,77,24,53,FMN 06 B Zurenborgbrug Ringfietspad
655,Ringfietspad Zurenborgbrug,2023-01-04,20:00:00,60,39,21,FMN 06 B Zurenborgbrug Ringfietspad
655,Ringfietspad Zurenborgbrug,2023-01-04,21:00:00,41,16,25,FMN 06 B Zurenborgbrug Ringfietspad
655,Ringfietspad Zurenborgbrug,2023-01-04,22:00:00,53,22,31,FMN 06 B Zurenborgbrug Ringfietspad
655,Ringfietspad Zurenborgbrug,2023-01-04,23:00:00,19,10,9,FMN 06 B Zurenborgbrug Ringfietspad
655,Ringfietspad Zurenborgbrug,2023-01-05,00:00:00,14,7,7,FMN 06 B Zurenborgbrug Ringfietspad
655,Ringfietspad Zurenborgbrug,2023-01-05,01:00:00,5,2,3,FMN 06 B Zurenborgbrug Ringfietspad
655,Ringfietspad Zurenborgbrug,2023-01-05,02:00:00,0,0,0,FMN 06 B Zurenborgbrug Ringfietspad
655,Ringfietspad Zurenborgbrug,2023-01-05,03:00:00,0,0,0,FMN 06 B Zurenborgbrug Ringfietspad
655,Ringfietspad Zurenborgbrug,2023-01-05,04:00:00,0,0,0,FMN 06 B Zurenborgbrug Ringfietspad
655,Ringfietspad Zurenborgbrug,2023-01-05,05:00:00,0,0,0,FMN 06 B Zurenborgbrug Ringfietspad
655,Ringfietspad Zurenborgbrug,2023-01-05,06:00:00,0,0,0,FMN 06 B Zurenborgbrug Ringfietspad
655,Ringfietspad Zurenborgbrug,2023-01-05,07:00:00,0,0,0,FMN 06 B Zurenborgbrug Ringfietspad
655,Ringfietspad Zurenborgbrug,2023-01-05,08:00:00,0,0,0,FMN 06 B Zurenborgbrug Ringfietspad
655,Ringfietspad Zurenborgbrug,2023-01-05,09:00:00,0,0,0,FMN 06 B Zurenborgbrug Ringfietspad
655,Ringfietspad Zurenborgbrug,2023-01-05,10:00:00,65,27,38,FMN 06 B Zurenborgbrug Ringfietspad
655,Ringfietspad Zurenborgbrug,2023-01-05,11:00:00,59,21,38,FMN 06 B Zurenborgbrug Ringfietspad
655,Ringfietspad Zurenborgbrug,2023-01-05,12:00:00,90,44,46,FMN 06 B Zurenborgbrug Ringfietspad
655,Ringfietspad Zurenborgbrug,2023-01-05,13:00:00,122,61,61,FMN 06 B Zurenborgbrug Ringfietspad
655,Ringfietspad Zurenborgbrug,2023-01-05,14:00:00,77,29,48,FMN 06 B Zurenborgbrug Ringfietspad
655,Ringfietspad Zurenborgbrug,2023-01-05,15:00:00,104,38,66,FMN 06 B Zurenborgbrug Ringfietspad
655,Ringfietspad Zurenborgbrug,2023-01-05,16:00:00,207,70,137,FMN 06 B Zurenborgbrug Ringfietspad
655,Ringfietspad Zurenborgbrug,2023-01-05,17:00:00,248,90,158,FMN 06 B Zurenborgbrug Ringfietspad
655,Ringfietspad Zurenborgbrug,2023-01-05,18:00:00,136,53,83,FMN 06 B Zurenborgbrug Ringfietspad
655,Ringfietspad Zurenborgbrug,2023-01-05,19:00:00,71,27,44,FMN 06 B Zurenborgbrug Ringfietspad
655,Ringfietspad Zurenborgbrug,2023-01-05,20:00:00,57,28,29,FMN 06 B Zurenborgbrug Ringfietspad
655,Ringfietspad Zurenborgbrug,2023-01-05,21:00:00,33,15,18,FMN 06 B Zurenborgbrug Ringfietspad
655,Ringfietspad Zurenborgbrug,2023-01-05,22:00:00,43,12,31,FMN 06 B Zurenborgbrug Ringfietspad
655,Ringfietspad Zurenborgbrug,2023-01-05,23:00:00,20,6,14,FMN 06 B Zurenborgbrug Ringfietspad
655,Ringfietspad Zurenborgbrug,2023-01-06,00:00:00,5,2,3,FMN 06 B Zurenborgbrug Ringfietspad
655,Ringfietspad Zurenborgbrug,2023-01-06,01:00:00,0,0,0,FMN 06 B Zurenborgbrug Ringfietspad
655,Ringfietspad Zurenborgbrug,2023-01-06,02:00:00,0,0,0,FMN 06 B Zurenborgbrug Ringfietspad
655,Ringfietspad Zurenborgbrug,2023-01-06,03:00:00,0,0,0,FMN 06 B Zurenborgbrug Ringfietspad
655,Ringfietspad Zurenborgbrug,2023-01-06,04:00:00,0,0,0,FMN 06 B Zurenborgbrug Ringfietspad
655,Ringfietspad Zurenborgbrug,2023-01-06,05:00:00,0,0,0,FMN 06 B Zurenborgbrug Ringfietspad
655,Ringfietspad Zurenborgbrug,2023-01-06,06:00:00,0,0,0,FMN 06 B Zurenborgbrug Ringfietspad
655,Ringfietspad Zurenborgbrug,2023-01-06,07:00:00,0,0,0,FMN 06 B Zurenborgbrug Ringfietspad
655,Ringfietspad Zurenborgbrug,2023-01-06,08:00:00,0,0,0,FMN 06 B Zurenborgbrug Ringfietspad
655,Ringfietspad Zurenborgbrug,2023-01-06,09:00:00,0,0,0,FMN 06 B Zurenborgbrug Ringfietspad
655,Ringfietspad Zurenborgbrug,2023-01-06,10:00:00,30,15,15,FMN 06 B Zurenborgbrug Ringfietspad
655,Ringfietspad Zurenborgbrug,2023-01-06,11:00:00,52,22,30,FMN 06 B Zurenborgbrug Ringfietspad
655,Ringfietspad Zurenborgbrug,2023-01-06,12:00:00,47,21,26,FMN 06 B Zurenborgbrug Ringfietspad
655,Ringfietspad Zurenborgbrug,2023-01-06,13:00:00,0,0,0,FMN 06 B Zurenborgbrug Ringfietspad
655,Ringfietspad Zurenborgbrug,2023-01-06,14:00:00,47,22,25,FMN 06 B Zurenborgbrug Ringfietspad
655,Ringfietspad Zurenborgbrug,2023-01-06,15:00:00,95,32,63,FMN 06 B Zurenborgbrug Ringfietspad
655,Ringfietspad Zurenborgbrug,2023-01-06,16:00:00,105,39,66,FMN 06 B Zurenborgbrug Ringfietspad
655,Ringfietspad Zurenborgbrug,2023-01-06,17:00:00,0,0,0,FMN 06 B Zurenborgbrug Ringfietspad
655,Ringfietspad Zurenborgbrug,2023-01-06,18:00:00,0,0,0,FMN 06 B Zurenborgbrug Ringfietspad
655,Ringfietspad Zurenborgbrug,2023-01-06,19:00:00,0,0,0,FMN 06 B Zurenborgbrug Ringfietspad
655,Ringfietspad Zurenborgbrug,2023-01-06,20:00:00,0,0,0,FMN 06 B Zurenborgbrug Ringfietspad
655,Ringfietspad Zurenborgbrug,2023-01-06,21:00:00,0,0,0,FMN 06 B Zurenborgbrug Ringfietspad
655,Ringfietspad Zurenborgbrug,2023-01-06,22:00:00,0,0,0,FMN 06 B Zurenborgbrug Ringfietspad
655,Ringfietspad Zurenborgbrug,2023-01-06,23:00:00,0,0,0,FMN 06 B Zurenborgbrug Ringfietspad
655,Ringfietspad Zurenborgbrug,2023-01-07,00:00:00,0,0,0,FMN 06 B Zurenborgbrug Ringfietspad
655,Ringfietspad Zurenborgbrug,2023-01-07,01:00:00,0,0,0,FMN 06 B Zurenborgbrug Ringfietspad
655,Ringfietspad Zurenborgbrug,2023-01-07,02:00:00,0,0,0,FMN 06 B Zurenborgbrug Ringfietspad
655,Ringfietspad Zurenborgbrug,2023-01-07,03:00:00,0,0,0,FMN 06 B Zurenborgbrug Ringfietspad
655,Ringfietspad Zurenborgbrug,2023-01-07,04:00:00,0,0,0,FMN 06 B Zurenborgbrug Ringfietspad
655,Ringfietspad Zurenborgbrug,2023-01-07,05:00:00,0,0,0,FMN 06 B Zurenborgbrug Ringfietspad
655,Ringfietspad Zurenborgbrug,2023-01-07,06:00:00,0,0,0,FMN 06 B Zurenborgbrug Ringfietspad
655,Ringfietspad Zurenborgbrug,2023-01-07,07:00:00,0,0,0,FMN 06 B Zurenborgbrug Ringfietspad
655,Ringfietspad Zurenborgbrug,2023-01-07,08:00:00,0,0,0,FMN 06 B Zurenborgbrug Ringfietspad
655,Ringfietspad Zurenborgbrug,2023-01-07,09:00:00,0,0,0,FMN 06 B Zurenborgbrug Ringfietspad
655,Ringfietspad Zurenborgbrug,2023-01-07,10:00:00,69,38,31,FMN 06 B Zurenborgbrug Ringfietspad
655,Ringfietspad Zurenborgbrug,2023-01-07,11:00:00,85,30,55,FMN 06 B Zurenborgbrug Ringfietspad
655,Ringfietspad Zurenborgbrug,2023-01-07,12:00:00,99,38,61,FMN 06 B Zurenborgbrug Ringfietspad
655,Ringfietspad Zurenborgbrug,2023-01-07,13:00:00,103,60,43,FMN 06 B Zurenborgbrug Ringfietspad
655,Ringfietspad Zurenborgbrug,2023-01-07,14:00:00,18,13,5,FMN 06 B Zurenborgbrug Ringfietspad
655,Ringfietspad Zurenborgbrug,2023-01-07,15:00:00,0,0,0,FMN 06 B Zurenborgbrug Ringfietspad
655,Ringfietspad Zurenborgbrug,2023-01-07,16:00:00,0,0,0,FMN 06 B Zurenborgbrug Ringfietspad
655,Ringfietspad Zurenborgbrug,2023-01-07,17:00:00,0,0,0,FMN 06 B Zurenborgbrug Ringfietspad
655,Ringfietspad Zurenborgbrug,2023-01-07,18:00:00,0,0,0,FMN 06 B Zurenborgbrug Ringfietspad
655,Ringfietspad Zurenborgbrug,2023-01-07,19:00:00,0,0,0,FMN 06 B Zurenborgbrug Ringfietspad
655,Ringfietspad Zurenborgbrug,2023-01-07,20:00:00,0,0,0,FMN 06 B Zurenborgbrug Ringfietspad
655,Ringfietspad Zurenborgbrug,2023-01-07,21:00:00,0,0,0,FMN 06 B Zurenborgbrug Ringfietspad
655,Ringfietspad Zurenborgbrug,2023-01-07,22:00:00,0,0,0,FMN 06 B Zurenborgbrug Ringfietspad
655,Ringfietspad Zurenborgbrug,2023-01-07,23:00:00,0,0,0,FMN 06 B Zurenborgbrug Ringfietspad
655,Ringfietspad Zurenborgbrug,2023-01-08,00:00:00,0,0,0,FMN 06 B Zurenborgbrug Ringfietspad
655,Ringfietspad Zurenborgbrug,2023-01-08,01:00:00,0,0,0,FMN 06 B Zurenborgbrug Ringfietspad
655,Ringfietspad Zurenborgbrug,2023-01-08,02:00:00,0,0,0,FMN 06 B Zurenborgbrug Ringfietspad
655,Ringfietspad Zurenborgbrug,2023-01-08,03:00:00,0,0,0,FMN 06 B Zurenborgbrug Ringfietspad
655,Ringfietspad Zurenborgbrug,2023-01-08,04:00:00,0,0,0,FMN 06 B Zurenborgbrug Ringfietspad
655,Ringfietspad Zurenborgbrug,2023-01-08,05:00:00,0,0,0,FMN 06 B Zurenborgbrug Ringfietspad
655,Ringfietspad Zurenborgbrug,2023-01-08,06:00:00,0,0,0,FMN 06 B Zurenborgbrug Ringfietspad
655,Ringfietspad Zurenborgbrug,2023-01-08,07:00:00,0,0,0,FMN 06 B Zurenborgbrug Ringfietspad
655,Ringfietspad Zurenborgbrug,2023-01-08,08:00:00,0,0,0,FMN 06 B Zurenborgbrug Ringfietspad
655,Ringfietspad Zurenborgbrug,2023-01-08,09:00:00,42,13,29,FMN 06 B Zurenborgbrug Ringfietspad
655,Ringfietspad Zurenborgbrug,2023-01-08,10:00:00,55,23,32,FMN 06 B Zurenborgbrug Ringfietspad
655,Ringfietspad Zurenborgbrug,2023-01-08,11:00:00,88,43,45,FMN 06 B Zurenborgbrug Ringfietspad
655,Ringfietspad Zurenborgbrug,2023-01-08,12:00:00,114,59,55,FMN 06 B Zurenborgbrug Ringfietspad
655,Ringfietspad Zurenborgbrug,2023-01-08,13:00:00,130,60,70,FMN 06 B Zurenborgbrug Ringfietspad
655,Ringfietspad Zurenborgbrug,2023-01-08,14:00:00,94,52,42,FMN 06 B Zurenborgbrug Ringfietspad
655,Ringfietspad Zurenborgbrug,2023-01-08,15:00:00,89,43,46,FMN 06 B Zurenborgbrug Ringfietspad
655,Ringfietspad Zurenborgbrug,2023-01-08,16:00:00,80,39,41,FMN 06 B Zurenborgbrug Ringfietspad
655,Ringfietspad Zurenborgbrug,2023-01-08,17:00:00,25,17,8,FMN 06 B Zurenborgbrug Ringfietspad
655,Ringfietspad Zurenborgbrug,2023-01-08,18:00:00,0,0,0,FMN 06 B Zurenborgbrug Ringfietspad
655,Ringfietspad Zurenborgbrug,2023-01-08,19:00:00,0,0,0,FMN 06 B Zurenborgbrug Ringfietspad
655,Ringfietspad Zurenborgbrug,2023-01-08,20:00:00,0,0,0,FMN 06 B Zurenborgbrug Ringfietspad
655,Ringfietspad Zurenborgbrug,2023-01-08,21:00:00,0,0,0,FMN 06 B Zurenborgbrug Ringfietspad
655,Ringfietspad Zurenborgbrug,2023-01-08,22:00:00,0,0,0,FMN 06 B Zurenborgbrug Ringfietspad
655,Ringfietspad Zurenborgbrug,2023-01-08,23:00:00,0,0,0,FMN 06 B Zurenborgbrug Ringfietspad
655,Ringfietspad Zurenborgbrug,2023-01-09,00:00:00,0,0,0,FMN 06 B Zurenborgbrug Ringfietspad
655,Ringfietspad Zurenborgbrug,2023-01-09,01:00:00,0,0,0,FMN 06 B Zurenborgbrug Ringfietspad
655,Ringfietspad Zurenborgbrug,2023-01-09,02:00:00,0,0,0,FMN 06 B Zurenborgbrug Ringfietspad
655,Ringfietspad Zurenborgbrug,2023-01-09,03:00:00,0,0,0,FMN 06 B Zurenborgbrug Ringfietspad
655,Ringfietspad Zurenborgbrug,2023-01-09,04:00:00,0,0,0,FMN 06 B Zurenborgbrug Ringfietspad
655,Ringfietspad Zurenborgbrug,2023-01-09,05:00:00,0,0,0,FMN 06 B Zurenborgbrug Ringfietspad
655,Ringfietspad Zurenborgbrug,2023-01-09,06:00:00,0,0,0,FMN 06 B Zurenborgbrug Ringfietspad
655,Ringfietspad Zurenborgbrug,2023-01-09,07:00:00,0,0,0,FMN 06 B Zurenborgbrug Ringfietspad
655,Ringfietspad Zurenborgbrug,2023-01-09,08:00:00,0,0,0,FMN 06 B Zurenborgbrug Ringfietspad
655,Ringfietspad Zurenborgbrug,2023-01-09,09:00:00,0,0,0,FMN 06 B Zurenborgbrug Ringfietspad
655,Ringfietspad Zurenborgbrug,2023-01-09,10:00:00,52,24,28,FMN 06 B Zurenborgbrug Ringfietspad
655,Ringfietspad Zurenborgbrug,2023-01-09,11:00:00,52,25,27,FMN 06 B Zurenborgbrug Ringfietspad
655,Ringfietspad Zurenborgbrug,2023-01-09,12:00:00,128,67,61,FMN 06 B Zurenborgbrug Ringfietspad
655,Ringfietspad Zurenborgbrug,2023-01-09,13:00:00,84,38,46,FMN 06 B Zurenborgbrug Ringfietspad
655,Ringfietspad Zurenborgbrug,2023-01-09,14:00:00,26,4,22,FMN 06 B Zurenborgbrug Ringfietspad
655,Ringfietspad Zurenborgbrug,2023-01-09,15:00:00,0,0,0,FMN 06 B Zurenborgbrug Ringfietspad
655,Ringfietspad Zurenborgbrug,2023-01-09,16:00:00,0,0,0,FMN 06 B Zurenborgbrug Ringfietspad
655,Ringfietspad Zurenborgbrug,2023-01-09,17:00:00,0,0,0,FMN 06 B Zurenborgbrug Ringfietspad
655,Ringfietspad Zurenborgbrug,2023-01-09,18:00:00,0,0,0,FMN 06 B Zurenborgbrug Ringfietspad
655,Ringfietspad Zurenborgbrug,2023-01-09,19:00:00,0,0,0,FMN 06 B Zurenborgbrug Ringfietspad
655,Ringfietspad Zurenborgbrug,2023-01-09,20:00:00,0,0,0,FMN 06 B Zurenborgbrug Ringfietspad
655,Ringfietspad Zurenborgbrug,2023-01-09,21:00:00,0,0,0,FMN 06 B Zurenborgbrug Ringfietspad
655,Ringfietspad Zurenborgbrug,2023-01-09,22:00:00,0,0,0,FMN 06 B Zurenborgbrug Ringfietspad
655,Ringfietspad Zurenborgbrug,2023-01-09,23:00:00,0,0,0,FMN 06 B Zurenborgbrug Ringfietspad
655,Ringfietspad Zurenborgbrug,2023-01-10,00:00:00,0,0,0,FMN 06 B Zurenborgbrug Ringfietspad
655,Ringfietspad Zurenborgbrug,2023-01-10,01:00:00,0,0,0,FMN 06 B Zurenborgbrug Ringfietspad
655,Ringfietspad Zurenborgbrug,2023-01-10,02:00:00,0,0,0,FMN 06 B Zurenborgbrug Ringfietspad
655,Ringfietspad Zurenborgbrug,2023-01-10,03:00:00,0,0,0,FMN 06 B Zurenborgbrug Ringfietspad
655,Ringfietspad Zurenborgbrug,2023-01-10,04:00:00,0,0,0,FMN 06 B Zurenborgbrug Ringfietspad
655,Ringfietspad Zurenborgbrug,2023-01-10,05:00:00,0,0,0,FMN 06 B Zurenborgbrug Ringfietspad
655,Ringfietspad Zurenborgbrug,2023-01-10,06:00:00,0,0,0,FMN 06 B Zurenborgbrug Ringfietspad
655,Ringfietspad Zurenborgbrug,2023-01-10,07:00:00,0,0,0,FMN 06 B Zurenborgbrug Ringfietspad
655,Ringfietspad Zurenborgbrug,2023-01-10,08:00:00,32,7,25,FMN 06 B Zurenborgbrug Ringfietspad
655,Ringfietspad Zurenborgbrug,2023-01-10,09:00:00,278,140,138,FMN 06 B Zurenborgbrug Ringfietspad
655,Ringfietspad Zurenborgbrug,2023-01-10,10:00:00,103,48,55,FMN 06 B Zurenborgbrug Ringfietspad
655,Ringfietspad Zurenborgbrug,2023-01-10,11:00:00,101,60,41,FMN 06 B Zurenborgbrug Ringfietspad
655,Ringfietspad Zurenborgbrug,2023-01-10,12:00:00,159,80,79,FMN 06 B Zurenborgbrug Ringfietspad
655,Ringfietspad Zurenborgbrug,2023-01-10,13:00:00,135,79,56,FMN 06 B Zurenborgbrug Ringfietspad
655,Ringfietspad Zurenborgbrug,2023-01-10,14:00:00,108,39,69,FMN 06 B Zurenborgbrug Ringfietspad
655,Ringfietspad Zurenborgbrug,2023-01-10,15:00:00,0,0,0,FMN 06 B Zurenborgbrug Ringfietspad
655,Ringfietspad Zurenborgbrug,2023-01-10,16:00:00,0,0,0,FMN 06 B Zurenborgbrug Ringfietspad
655,Ringfietspad Zurenborgbrug,2023-01-10,17:00:00,0,0,0,FMN 06 B Zurenborgbrug Ringfietspad
655,Ringfietspad Zurenborgbrug,2023-01-10,18:00:00,0,0,0,FMN 06 B Zurenborgbrug Ringfietspad
655,Ringfietspad Zurenborgbrug,2023-01-10,19:00:00,0,0,0,FMN 06 B Zurenborgbrug Ringfietspad
655,Ringfietspad Zurenborgbrug,2023-01-10,20:00:00,0,0,0,FMN 06 B Zurenborgbrug Ringfietspad
655,Ringfietspad Zurenborgbrug,2023-01-10,21:00:00,0,0,0,FMN 06 B Zurenborgbrug Ringfietspad
655,Ringfietspad Zurenborgbrug,2023-01-10,22:00:00,0,0,0,FMN 06 B Zurenborgbrug Ringfietspad
655,Ringfietspad Zurenborgbrug,2023-01-10,23:00:00,0,0,0,FMN 06 B Zurenborgbrug Ringfietspad
655,Ringfietspad Zurenborgbrug,2023-01-11,00:00:00,0,0,0,FMN 06 B Zurenborgbrug Ringfietspad
655,Ringfietspad Zurenborgbrug,2023-01-11,01:00:00,0,0,0,FMN 06 B Zurenborgbrug Ringfietspad
655,Ringfietspad Zurenborgbrug,2023-01-11,02:00:00,0,0,0,FMN 06 B Zurenborgbrug Ringfietspad
655,Ringfietspad Zurenborgbrug,2023-01-11,03:00:00,0,0,0,FMN 06 B Zurenborgbrug Ringfietspad
655,Ringfietspad Zurenborgbrug,2023-01-11,04:00:00,0,0,0,FMN 06 B Zurenborgbrug Ringfietspad
655,Ringfietspad Zurenborgbrug,2023-01-11,05:00:00,0,0,0,FMN 06 B Zurenborgbrug Ringfietspad
655,Ringfietspad Zurenborgbrug,2023-01-11,06:00:00,0,0,0,FMN 06 B Zurenborgbrug Ringfietspad
655,Ringfietspad Zurenborgbrug,2023-01-11,07:00:00,0,0,0,FMN 06 B Zurenborgbrug Ringfietspad
655,Ringfietspad Zurenborgbrug,2023-01-11,08:00:00,0,0,0,FMN 06 B Zurenborgbrug Ringfietspad
655,Ringfietspad Zurenborgbrug,2023-01-11,09:00:00,47,24,23,FMN 06 B Zurenborgbrug Ringfietspad
655,Ringfietspad Zurenborgbrug,2023-01-11,10:00:00,88,54,34,FMN 06 B Zurenborgbrug Ringfietspad
655,Ringfietspad Zurenborgbrug,2023-01-11,11:00:00,87,38,49,FMN 06 B Zurenborgbrug Ringfietspad
655,Ringfietspad Zurenborgbrug,2023-01-11,12:00:00,276,125,151,FMN 06 B Zurenborgbrug Ringfietspad
655,Ringfietspad Zurenborgbrug,2023-01-11,13:00:00,171,79,92,FMN 06 B Zurenborgbrug Ringfietspad
655,Ringfietspad Zurenborgbrug,2023-01-11,14:00:00,139,55,84,FMN 06 B Zurenborgbrug Ringfietspad
655,Ringfietspad Zurenborgbrug,2023-01-11,15:00:00,171,61,110,FMN 06 B Zurenborgbrug Ringfietspad
655,Ringfietspad Zurenborgbrug,2023-01-11,16:00:00,293,112,181,FMN 06 B Zurenborgbrug Ringfietspad
655,Ringfietspad Zurenborgbrug,2023-01-11,17:00:00,356,129,227,FMN 06 B Zurenborgbrug Ringfietspad
655,Ringfietspad Zurenborgbrug,2023-01-11,18:00:00,210,86,124,FMN 06 B Zurenborgbrug Ringfietspad
655,Ringfietspad Zurenborgbrug,2023-01-11,19:00:00,117,55,62,FMN 06 B Zurenborgbrug Ringfietspad
655,Ringfietspad Zurenborgbrug,2023-01-11,20:00:00,64,28,36,FMN 06 B Zurenborgbrug Ringfietspad
655,Ringfietspad Zurenborgbrug,2023-01-11,21:00:00,51,17,34,FMN 06 B Zurenborgbrug Ringfietspad
655,Ringfietspad Zurenborgbrug,2023-01-11,22:00:00,73,31,42,FMN 06 B Zurenborgbrug Ringfietspad
655,Ringfietspad Zurenborgbrug,2023-01-11,23:00:00,34,15,19,FMN 06 B Zurenborgbrug Ringfietspad
655,Ringfietspad Zurenborgbrug,2023-01-12,00:00:00,10,6,4,FMN 06 B Zurenborgbrug Ringfietspad
655,Ringfietspad Zurenborgbrug,2023-01-12,01:00:00,4,2,2,FMN 06 B Zurenborgbrug Ringfietspad
655,Ringfietspad Zurenborgbrug,2023-01-12,02:00:00,0,0,0,FMN 06 B Zurenborgbrug Ringfietspad
655,Ringfietspad Zurenborgbrug,2023-01-12,03:00:00,0,0,0,FMN 06 B Zurenborgbrug Ringfietspad
655,Ringfietspad Zurenborgbrug,2023-01-12,04:00:00,0,0,0,FMN 06 B Zurenborgbrug Ringfietspad
655,Ringfietspad Zurenborgbrug,2023-01-12,05:00:00,0,0,0,FMN 06 B Zurenborgbrug Ringfietspad
655,Ringfietspad Zurenborgbrug,2023-01-12,06:00:00,0,0,0,FMN 06 B Zurenborgbrug Ringfietspad
655,Ringfietspad Zurenborgbrug,2023-01-12,07:00:00,0,0,0,FMN 06 B Zurenborgbrug Ringfietspad
655,Ringfietspad Zurenborgbrug,2023-01-12,08:00:00,0,0,0,FMN 06 B Zurenborgbrug Ringfietspad
655,Ringfietspad Zurenborgbrug,2023-01-12,09:00:00,0,0,0,FMN 06 B Zurenborgbrug Ringfietspad
655,Ringfietspad Zurenborgbrug,2023-01-12,10:00:00,19,11,8,FMN 06 B Zurenborgbrug Ringfietspad
655,Ringfietspad Zurenborgbrug,2023-01-12,11:00:00,50,26,24,FMN 06 B Zurenborgbrug Ringfietspad
655,Ringfietspad Zurenborgbrug,2023-01-12,12:00:00,81,50,31,FMN 06 B Zurenborgbrug Ringfietspad
655,Ringfietspad Zurenborgbrug,2023-01-12,13:00:00,59,28,31,FMN 06 B Zurenborgbrug Ringfietspad
655,Ringfietspad Zurenborgbrug,2023-01-12,14:00:00,49,17,32,FMN 06 B Zurenborgbrug Ringfietspad
655,Ringfietspad Zurenborgbrug,2023-01-12,15:00:00,104,37,67,FMN 06 B Zurenborgbrug Ringfietspad
655,Ringfietspad Zurenborgbrug,2023-01-12,16:00:00,242,110,132,FMN 06 B Zurenborgbrug Ringfietspad
655,Ringfietspad Zurenborgbrug,2023-01-12,17:00:00,219,78,141,FMN 06 B Zurenborgbrug Ringfietspad
655,Ringfietspad Zurenborgbrug,2023-01-12,18:00:00,124,47,77,FMN 06 B Zurenborgbrug Ringfietspad
655,Ringfietspad Zurenborgbrug,2023-01-12,19:00:00,23,4,19,FMN 06 B Zurenborgbrug Ringfietspad
655,Ringfietspad Zurenborgbrug,2023-01-12,20:00:00,0,0,0,FMN 06 B Zurenborgbrug Ringfietspad
655,Ringfietspad Zurenborgbrug,2023-01-12,21:00:00,0,0,0,FMN 06 B Zurenborgbrug Ringfietspad
655,Ringfietspad Zurenborgbrug,2023-01-12,22:00:00,0,0,0,FMN 06 B Zurenborgbrug Ringfietspad
655,Ringfietspad Zurenborgbrug,2023-01-12,23:00:00,0,0,0,FMN 06 B Zurenborgbrug Ringfietspad
655,Ringfietspad Zurenborgbrug,2023-01-13,00:00:00,0,0,0,FMN 06 B Zurenborgbrug Ringfietspad
655,Ringfietspad Zurenborgbrug,2023-01-13,01:00:00,0,0,0,FMN 06 B Zurenborgbrug Ringfietspad
655,Ringfietspad Zurenborgbrug,2023-01-13,02:00:00,0,0,0,FMN 06 B Zurenborgbrug Ringfietspad
655,Ringfietspad Zurenborgbrug,2023-01-13,03:00:00,0,0,0,FMN 06 B Zurenborgbrug Ringfietspad
655,Ringfietspad Zurenborgbrug,2023-01-13,04:00:00,0,0,0,FMN 06 B Zurenborgbrug Ringfietspad
655,Ringfietspad Zurenborgbrug,2023-01-13,05:00:00,0,0,0,FMN 06 B Zurenborgbrug Ringfietspad
655,Ringfietspad Zurenborgbrug,2023-01-13,06:00:00,0,0,0,FMN 06 B Zurenborgbrug Ringfietspad
655,Ringfietspad Zurenborgbrug,2023-01-13,07:00:00,0,0,0,FMN 06 B Zurenborgbrug Ringfietspad
655,Ringfietspad Zurenborgbrug,2023-01-13,08:00:00,0,0,0,FMN 06 B Zurenborgbrug Ringfietspad
655,Ringfietspad Zurenborgbrug,2023-01-13,09:00:00,68,34,34,FMN 06 B Zurenborgbrug Ringfietspad
655,Ringfietspad Zurenborgbrug,2023-01-13,10:00:00,67,30,37,FMN 06 B Zurenborgbrug Ringfietspad
655,Ringfietspad Zurenborgbrug,2023-01-13,11:00:00,67,32,35,FMN 06 B Zurenborgbrug Ringfietspad
655,Ringfietspad Zurenborgbrug,2023-01-13,12:00:00,128,59,69,FMN 06 B Zurenborgbrug Ringfietspad
655,Ringfietspad Zurenborgbrug,2023-01-13,13:00:00,110,61,49,FMN 06 B Zurenborgbrug Ringfietspad
655,Ringfietspad Zurenborgbrug,2023-01-13,14:00:00,115,42,73,FMN 06 B Zurenborgbrug Ringfietspad
655,Ringfietspad Zurenborgbrug,2023-01-13,15:00:00,209,90,119,FMN 06 B Zurenborgbrug Ringfietspad
655,Ringfietspad Zurenborgbrug,2023-01-13,16:00:00,326,138,188,FMN 06 B Zurenborgbrug Ringfietspad
655,Ringfietspad Zurenborgbrug,2023-01-13,17:00:00,0,0,0,FMN 06 B Zurenborgbrug Ringfietspad
655,Ringfietspad Zurenborgbrug,2023-01-13,18:00:00,0,0,0,FMN 06 B Zurenborgbrug Ringfietspad
655,Ringfietspad Zurenborgbrug,2023-01-13,19:00:00,0,0,0,FMN 06 B Zurenborgbrug Ringfietspad
655,Ringfietspad Zurenborgbrug,2023-01-13,20:00:00,0,0,0,FMN 06 B Zurenborgbrug Ringfietspad
655,Ringfietspad Zurenborgbrug,2023-01-13,21:00:00,0,0,0,FMN 06 B Zurenborgbrug Ringfietspad
655,Ringfietspad Zurenborgbrug,2023-01-13,22:00:00,0,0,0,FMN 06 B Zurenborgbrug Ringfietspad
655,Ringfietspad Zurenborgbrug,2023-01-13,23:00:00,0,0,0,FMN 06 B Zurenborgbrug Ringfietspad
655,Ringfietspad Zurenborgbrug,2023-01-14,00:00:00,0,0,0,FMN 06 B Zurenborgbrug Ringfietspad
655,Ringfietspad Zurenborgbrug,2023-01-14,01:00:00,0,0,0,FMN 06 B Zurenborgbrug Ringfietspad
655,Ringfietspad Zurenborgbrug,2023-01-14,02:00:00,0,0,0,FMN 06 B Zurenborgbrug Ringfietspad
655,Ringfietspad Zurenborgbrug,2023-01-14,03:00:00,0,0,0,FMN 06 B Zurenborgbrug Ringfietspad
655,Ringfietspad Zurenborgbrug,2023-01-14,04:00:00,0,0,0,FMN 06 B Zurenborgbrug Ringfietspad
655,Ringfietspad Zurenborgbrug,2023-01-14,05:00:00,0,0,0,FMN 06 B Zurenborgbrug Ringfietspad
655,Ringfietspad Zurenborgbrug,2023-01-14,06:00:00,0,0,0,FMN 06 B Zurenborgbrug Ringfietspad
655,Ringfietspad Zurenborgbrug,2023-01-14,07:00:00,0,0,0,FMN 06 B Zurenborgbrug Ringfietspad
655,Ringfietspad Zurenborgbrug,2023-01-14,08:00:00,0,0,0,FMN 06 B Zurenborgbrug Ringfietspad
655,Ringfietspad Zurenborgbrug,2023-01-14,09:00:00,0,0,0,FMN 06 B Zurenborgbrug Ringfietspad
655,Ringfietspad Zurenborgbrug,2023-01-14,10:00:00,0,0,0,FMN 06 B Zurenborgbrug Ringfietspad
655,Ringfietspad Zurenborgbrug,2023-01-14,11:00:00,0,0,0,FMN 06 B Zurenborgbrug Ringfietspad
655,Ringfietspad Zurenborgbrug,2023-01-14,12:00:00,35,19,16,FMN 06 B Zurenborgbrug Ringfietspad
655,Ringfietspad Zurenborgbrug,2023-01-14,13:00:00,34,17,17,FMN 06 B Zurenborgbrug Ringfietspad
655,Ringfietspad Zurenborgbrug,2023-01-14,14:00:00,41,20,21,FMN 06 B Zurenborgbrug Ringfietspad
655,Ringfietspad Zurenborgbrug,2023-01-14,15:00:00,43,18,25,FMN 06 B Zurenborgbrug Ringfietspad
655,Ringfietspad Zurenborgbrug,2023-01-14,16:00:00,41,22,19,FMN 06 B Zurenborgbrug Ringfietspad
655,Ringfietspad Zurenborgbrug,2023-01-14,17:00:00,54,25,29,FMN 06 B Zurenborgbrug Ringfietspad
655,Ringfietspad Zurenborgbrug,2023-01-14,18:00:00,31,12,19,FMN 06 B Zurenborgbrug Ringfietspad
655,Ringfietspad Zurenborgbrug,2023-01-14,19:00:00,38,19,19,FMN 06 B Zurenborgbrug Ringfietspad
655,Ringfietspad Zurenborgbrug,2023-01-14,20:00:00,25,14,11,FMN 06 B Zurenborgbrug Ringfietspad
655,Ringfietspad Zurenborgbrug,2023-01-14,21:00:00,19,8,11,FMN 06 B Zurenborgbrug Ringfietspad
655,Ringfietspad Zurenborgbrug,2023-01-14,22:00:00,15,7,8,FMN 06 B Zurenborgbrug Ringfietspad
655,Ringfietspad Zurenborgbrug,2023-01-14,23:00:00,32,12,20,FMN 06 B Zurenborgbrug Ringfietspad
655,Ringfietspad Zurenborgbrug,2023-01-15,00:00:00,19,7,12,FMN 06 B Zurenborgbrug Ringfietspad
655,Ringfietspad Zurenborgbrug,2023-01-15,01:00:00,13,5,8,FMN 06 B Zurenborgbrug Ringfietspad
655,Ringfietspad Zurenborgbrug,2023-01-15,02:00:00,0,0,0,FMN 06 B Zurenborgbrug Ringfietspad
655,Ringfietspad Zurenborgbrug,2023-01-15,03:00:00,0,0,0,FMN 06 B Zurenborgbrug Ringfietspad
655,Ringfietspad Zurenborgbrug,2023-01-15,04:00:00,0,0,0,FMN 06 B Zurenborgbrug Ringfietspad
655,Ringfietspad Zurenborgbrug,2023-01-15,05:00:00,0,0,0,FMN 06 B Zurenborgbrug Ringfietspad
655,Ringfietspad Zurenborgbrug,2023-01-15,06:00:00,0,0,0,FMN 06 B Zurenborgbrug Ringfietspad
655,Ringfietspad Zurenborgbrug,2023-01-15,07:00:00,0,0,0,FMN 06 B Zurenborgbrug Ringfietspad
655,Ringfietspad Zurenborgbrug,2023-01-15,08:00:00,0,0,0,FMN 06 B Zurenborgbrug Ringfietspad
655,Ringfietspad Zurenborgbrug,2023-01-15,09:00:00,0,0,0,FMN 06 B Zurenborgbrug Ringfietspad
655,Ringfietspad Zurenborgbrug,2023-01-15,10:00:00,0,0,0,FMN 06 B Zurenborgbrug Ringfietspad
655,Ringfietspad Zurenborgbrug,2023-01-15,11:00:00,0,0,0,FMN 06 B Zurenborgbrug Ringfietspad
655,Ringfietspad Zurenborgbrug,2023-01-15,12:00:00,0,0,0,FMN 06 B Zurenborgbrug Ringfietspad
655,Ringfietspad Zurenborgbrug,2023-01-15,13:00:00,0,0,0,FMN 06 B Zurenborgbrug Ringfietspad
655,Ringfietspad Zurenborgbrug,2023-01-15,14:00:00,0,0,0,FMN 06 B Zurenborgbrug Ringfietspad
655,Ringfietspad Zurenborgbrug,2023-01-15,15:00:00,0,0,0,FMN 06 B Zurenborgbrug Ringfietspad
655,Ringfietspad Zurenborgbrug,2023-01-15,16:00:00,0,0,0,FMN 06 B Zurenborgbrug Ringfietspad
655,Ringfietspad Zurenborgbrug,2023-01-15,17:00:00,0,0,0,FMN 06 B Zurenborgbrug Ringfietspad
655,Ringfietspad Zurenborgbrug,2023-01-15,18:00:00,0,0,0,FMN 06 B Zurenborgbrug Ringfietspad
655,Ringfietspad Zurenborgbrug,2023-01-15,19:00:00,0,0,0,FMN 06 B Zurenborgbrug Ringfietspad
655,Ringfietspad Zurenborgbrug,2023-01-15,20:00:00,0,0,0,FMN 06 B Zurenborgbrug Ringfietspad
655,Ringfietspad Zurenborgbrug,2023-01-15,21:00:00,0,0,0,FMN 06 B Zurenborgbrug Ringfietspad
655,Ringfietspad Zurenborgbrug,2023-01-15,22:00:00,0,0,0,FMN 06 B Zurenborgbrug Ringfietspad
655,Ringfietspad Zurenborgbrug,2023-01-15,23:00:00,0,0,0,FMN 06 B Zurenborgbrug Ringfietspad
655,Ringfietspad Zurenborgbrug,2023-01-16,00:00:00,0,0,0,FMN 06 B Zurenborgbrug Ringfietspad
655,Ringfietspad Zurenborgbrug,2023-01-16,01:00:00,0,0,0,FMN 06 B Zurenborgbrug Ringfietspad
655,Ringfietspad Zurenborgbrug,2023-01-16,02:00:00,0,0,0,FMN 06 B Zurenborgbrug Ringfietspad
655,Ringfietspad Zurenborgbrug,2023-01-16,03:00:00,0,0,0,FMN 06 B Zurenborgbrug Ringfietspad
655,Ringfietspad Zurenborgbrug,2023-01-16,04:00:00,0,0,0,FMN 06 B Zurenborgbrug Ringfietspad
655,Ringfietspad Zurenborgbrug,2023-01-16,05:00:00,0,0,0,FMN 06 B Zurenborgbrug Ringfietspad
655,Ringfietspad Zurenborgbrug,2023-01-16,06:00:00,0,0,0,FMN 06 B Zurenborgbrug Ringfietspad
655,Ringfietspad Zurenborgbrug,2023-01-16,07:00:00,0,0,0,FMN 06 B Zurenborgbrug Ringfietspad
655,Ringfietspad Zurenborgbrug,2023-01-16,08:00:00,0,0,0,FMN 06 B Zurenborgbrug Ringfietspad
655,Ringfietspad Zurenborgbrug,2023-01-16,09:00:00,4,3,1,FMN 06 B Zurenborgbrug Ringfietspad
655,Ringfietspad Zurenborgbrug,2023-01-16,10:00:00,59,34,25,FMN 06 B Zurenborgbrug Ringfietspad
655,Ringfietspad Zurenborgbrug,2023-01-16,11:00:00,42,11,31,FMN 06 B Zurenborgbrug Ringfietspad
655,Ringfietspad Zurenborgbrug,2023-01-16,12:00:00,90,41,49,FMN 06 B Zurenborgbrug Ringfietspad
655,Ringfietspad Zurenborgbrug,2023-01-16,13:00:00,86,40,46,FMN 06 B Zurenborgbrug Ringfietspad
655,Ringfietspad Zurenborgbrug,2023-01-16,14:00:00,55,19,36,FMN 06 B Zurenborgbrug Ringfietspad
655,Ringfietspad Zurenborgbrug,2023-01-16,15:00:00,153,56,97,FMN 06 B Zurenborgbrug Ringfietspad
655,Ringfietspad Zurenborgbrug,2023-01-16,16:00:00,293,141,152,FMN 06 B Zurenborgbrug Ringfietspad
655,Ringfietspad Zurenborgbrug,2023-01-16,17:00:00,267,89,178,FMN 06 B Zurenborgbrug Ringfietspad
655,Ringfietspad Zurenborgbrug,2023-01-16,18:00:00,141,52,89,FMN 06 B Zurenborgbrug Ringfietspad
655,Ringfietspad Zurenborgbrug,2023-01-16,19:00:00,83,28,55,FMN 06 B Zurenborgbrug Ringfietspad
655,Ringfietspad Zurenborgbrug,2023-01-16,20:00:00,46,24,22,FMN 06 B Zurenborgbrug Ringfietspad
655,Ringfietspad Zurenborgbrug,2023-01-16,21:00:00,42,12,30,FMN 06 B Zurenborgbrug Ringfietspad
655,Ringfietspad Zurenborgbrug,2023-01-16,22:00:00,40,10,30,FMN 06 B Zurenborgbrug Ringfietspad
655,Ringfietspad Zurenborgbrug,2023-01-16,23:00:00,6,1,5,FMN 06 B Zurenborgbrug Ringfietspad
655,Ringfietspad Zurenborgbrug,2023-01-17,00:00:00,1,1,0,FMN 06 B Zurenborgbrug Ringfietspad
655,Ringfietspad Zurenborgbrug,2023-01-17,01:00:00,0,0,0,FMN 06 B Zurenborgbrug Ringfietspad
655,Ringfietspad Zurenborgbrug,2023-01-17,02:00:00,0,0,0,FMN 06 B Zurenborgbrug Ringfietspad
655,Ringfietspad Zurenborgbrug,2023-01-17,03:00:00,0,0,0,FMN 06 B Zurenborgbrug Ringfietspad
655,Ringfietspad Zurenborgbrug,2023-01-17,04:00:00,0,0,0,FMN 06 B Zurenborgbrug Ringfietspad
655,Ringfietspad Zurenborgbrug,2023-01-17,05:00:00,0,0,0,FMN 06 B Zurenborgbrug Ringfietspad
655,Ringfietspad Zurenborgbrug,2023-01-17,06:00:00,0,0,0,FMN 06 B Zurenborgbrug Ringfietspad
655,Ringfietspad Zurenborgbrug,2023-01-17,07:00:00,0,0,0,FMN 06 B Zurenborgbrug Ringfietspad
655,Ringfietspad Zurenborgbrug,2023-01-17,08:00:00,0,0,0,FMN 06 B Zurenborgbrug Ringfietspad
655,Ringfietspad Zurenborgbrug,2023-01-17,09:00:00,122,61,61,FMN 06 B Zurenborgbrug Ringfietspad
655,Ringfietspad Zurenborgbrug,2023-01-17,10:00:00,59,29,30,FMN 06 B Zurenborgbrug Ringfietspad
655,Ringfietspad Zurenborgbrug,2023-01-17,11:00:00,77,35,42,FMN 06 B Zurenborgbrug Ringfietspad
655,Ringfietspad Zurenborgbrug,2023-01-17,12:00:00,101,43,58,FMN 06 B Zurenborgbrug Ringfietspad
655,Ringfietspad Zurenborgbrug,2023-01-17,13:00:00,88,42,46,FMN 06 B Zurenborgbrug Ringfietspad
655,Ringfietspad Zurenborgbrug,2023-01-17,14:00:00,0,0,0,FMN 06 B Zurenborgbrug Ringfietspad
655,Ringfietspad Zurenborgbrug,2023-01-17,15:00:00,0,0,0,FMN 06 B Zurenborgbrug Ringfietspad
655,Ringfietspad Zurenborgbrug,2023-01-17,16:00:00,242,112,130,FMN 06 B Zurenborgbrug Ringfietspad
655,Ringfietspad Zurenborgbrug,2023-01-17,17:00:00,349,133,216,FMN 06 B Zurenborgbrug Ringfietspad
655,Ringfietspad Zurenborgbrug,2023-01-17,18:00:00,184,64,120,FMN 06 B Zurenborgbrug Ringfietspad
655,Ringfietspad Zurenborgbrug,2023-01-17,19:00:00,94,33,61,FMN 06 B Zurenborgbrug Ringfietspad
655,Ringfietspad Zurenborgbrug,2023-01-17,20:00:00,45,24,21,FMN 06 B Zurenborgbrug Ringfietspad
655,Ringfietspad Zurenborgbrug,2023-01-17,21:00:00,60,23,37,FMN 06 B Zurenborgbrug Ringfietspad
655,Ringfietspad Zurenborgbrug,2023-01-17,22:00:00,44,17,27,FMN 06 B Zurenborgbrug Ringfietspad
655,Ringfietspad Zurenborgbrug,2023-01-17,23:00:00,32,14,18,FMN 06 B Zurenborgbrug Ringfietspad
655,Ringfietspad Zurenborgbrug,2023-01-18,00:00:00,7,5,2,FMN 06 B Zurenborgbrug Ringfietspad
655,Ringfietspad Zurenborgbrug,2023-01-18,01:00:00,0,0,0,FMN 06 B Zurenborgbrug Ringfietspad
655,Ringfietspad Zurenborgbrug,2023-01-18,02:00:00,0,0,0,FMN 06 B Zurenborgbrug Ringfietspad
655,Ringfietspad Zurenborgbrug,2023-01-18,03:00:00,0,0,0,FMN 06 B Zurenborgbrug Ringfietspad
655,Ringfietspad Zurenborgbrug,2023-01-18,04:00:00,0,0,0,FMN 06 B Zurenborgbrug Ringfietspad
655,Ringfietspad Zurenborgbrug,2023-01-18,05:00:00,0,0,0,FMN 06 B Zurenborgbrug Ringfietspad
655,Ringfietspad Zurenborgbrug,2023-01-18,06:00:00,0,0,0,FMN 06 B Zurenborgbrug Ringfietspad
655,Ringfietspad Zurenborgbrug,2023-01-18,07:00:00,0,0,0,FMN 06 B Zurenborgbrug Ringfietspad
655,Ringfietspad Zurenborgbrug,2023-01-18,08:00:00,0,0,0,FMN 06 B Zurenborgbrug Ringfietspad
655,Ringfietspad Zurenborgbrug,2023-01-18,09:00:00,2,0,2,FMN 06 B Zurenborgbrug Ringfietspad
655,Ringfietspad Zurenborgbrug,2023-01-18,10:00:00,0,0,0,FMN 06 B Zurenborgbrug Ringfietspad
655,Ringfietspad Zurenborgbrug,2023-01-18,11:00:00,0,0,0,FMN 06 B Zurenborgbrug Ringfietspad
655,Ringfietspad Zurenborgbrug,2023-01-18,12:00:00,0,0,0,FMN 06 B Zurenborgbrug Ringfietspad
655,Ringfietspad Zurenborgbrug,2023-01-18,13:00:00,139,65,74,FMN 06 B Zurenborgbrug Ringfietspad
655,Ringfietspad Zurenborgbrug,2023-01-18,14:00:00,105,36,69,FMN 06 B Zurenborgbrug Ringfietspad
655,Ringfietspad Zurenborgbrug,2023-01-18,15:00:00,150,53,97,FMN 06 B Zurenborgbrug Ringfietspad
655,Ringfietspad Zurenborgbrug,2023-01-18,16:00:00,250,95,155,FMN 06 B Zurenborgbrug Ringfietspad
655,Ringfietspad Zurenborgbrug,2023-01-18,17:00:00,320,127,193,FMN 06 B Zurenborgbrug Ringfietspad
655,Ringfietspad Zurenborgbrug,2023-01-18,18:00:00,175,79,96,FMN 06 B Zurenborgbrug Ringfietspad
655,Ringfietspad Zurenborgbrug,2023-01-18,19:00:00,90,38,52,FMN 06 B Zurenborgbrug Ringfietspad
655,Ringfietspad Zurenborgbrug,2023-01-18,20:00:00,72,31,41,FMN 06 B Zurenborgbrug Ringfietspad
655,Ringfietspad Zurenborgbrug,2023-01-18,21:00:00,61,22,39,FMN 06 B Zurenborgbrug Ringfietspad
655,Ringfietspad Zurenborgbrug,2023-01-18,22:00:00,56,21,35,FMN 06 B Zurenborgbrug Ringfietspad
655,Ringfietspad Zurenborgbrug,2023-01-18,23:00:00,24,13,11,FMN 06 B Zurenborgbrug Ringfietspad
655,Ringfietspad Zurenborgbrug,2023-01-19,00:00:00,11,7,4,FMN 06 B Zurenborgbrug Ringfietspad
655,Ringfietspad Zurenborgbrug,2023-01-19,01:00:00,4,3,1,FMN 06 B Zurenborgbrug Ringfietspad
655,Ringfietspad Zurenborgbrug,2023-01-19,02:00:00,0,0,0,FMN 06 B Zurenborgbrug Ringfietspad
655,Ringfietspad Zurenborgbrug,2023-01-19,03:00:00,0,0,0,FMN 06 B Zurenborgbrug Ringfietspad
655,Ringfietspad Zurenborgbrug,2023-01-19,04:00:00,0,0,0,FMN 06 B Zurenborgbrug Ringfietspad
655,Ringfietspad Zurenborgbrug,2023-01-19,05:00:00,0,0,0,FMN 06 B Zurenborgbrug Ringfietspad
655,Ringfietspad Zurenborgbrug,2023-01-19,06:00:00,0,0,0,FMN 06 B Zurenborgbrug Ringfietspad
655,Ringfietspad Zurenborgbrug,2023-01-19,07:00:00,0,0,0,FMN 06 B Zurenborgbrug Ringfietspad
655,Ringfietspad Zurenborgbrug,2023-01-19,08:00:00,0,0,0,FMN 06 B Zurenborgbrug Ringfietspad
655,Ringfietspad Zurenborgbrug,2023-01-19,09:00:00,107,57,50,FMN 06 B Zurenborgbrug Ringfietspad
655,Ringfietspad Zurenborgbrug,2023-01-19,10:00:00,67,32,35,FMN 06 B Zurenborgbrug Ringfietspad
655,Ringfietspad Zurenborgbrug,2023-01-19,11:00:00,58,32,26,FMN 06 B Zurenborgbrug Ringfietspad
655,Ringfietspad Zurenborgbrug,2023-01-19,12:00:00,96,49,47,FMN 06 B Zurenborgbrug Ringfietspad
655,Ringfietspad Zurenborgbrug,2023-01-19,13:00:00,91,45,46,FMN 06 B Zurenborgbrug Ringfietspad
655,Ringfietspad Zurenborgbrug,2023-01-19,14:00:00,90,31,59,FMN 06 B Zurenborgbrug Ringfietspad
655,Ringfietspad Zurenborgbrug,2023-01-19,15:00:00,161,62,99,FMN 06 B Zurenborgbrug Ringfietspad
655,Ringfietspad Zurenborgbrug,2023-01-19,16:00:00,309,140,169,FMN 06 B Zurenborgbrug Ringfietspad
655,Ringfietspad Zurenborgbrug,2023-01-19,17:00:00,292,93,199,FMN 06 B Zurenborgbrug Ringfietspad
655,Ringfietspad Zurenborgbrug,2023-01-19,18:00:00,184,86,98,FMN 06 B Zurenborgbrug Ringfietspad
655,Ringfietspad Zurenborgbrug,2023-01-19,19:00:00,89,34,55,FMN 06 B Zurenborgbrug Ringfietspad
655,Ringfietspad Zurenborgbrug,2023-01-19,20:00:00,68,30,38,FMN 06 B Zurenborgbrug Ringfietspad
655,Ringfietspad Zurenborgbrug,2023-01-19,21:00:00,65,23,42,FMN 06 B Zurenborgbrug Ringfietspad
655,Ringfietspad Zurenborgbrug,2023-01-19,22:00:00,34,13,21,FMN 06 B Zurenborgbrug Ringfietspad
655,Ringfietspad Zurenborgbrug,2023-01-19,23:00:00,21,7,14,FMN 06 B Zurenborgbrug Ringfietspad
655,Ringfietspad Zurenborgbrug,2023-01-20,00:00:00,14,8,6,FMN 06 B Zurenborgbrug Ringfietspad
655,Ringfietspad Zurenborgbrug,2023-01-20,01:00:00,2,0,2,FMN 06 B Zurenborgbrug Ringfietspad
655,Ringfietspad Zurenborgbrug,2023-01-20,02:00:00,0,0,0,FMN 06 B Zurenborgbrug Ringfietspad
655,Ringfietspad Zurenborgbrug,2023-01-20,03:00:00,0,0,0,FMN 06 B Zurenborgbrug Ringfietspad
655,Ringfietspad Zurenborgbrug,2023-01-20,04:00:00,0,0,0,FMN 06 B Zurenborgbrug Ringfietspad
655,Ringfietspad Zurenborgbrug,2023-01-20,05:00:00,0,0,0,FMN 06 B Zurenborgbrug Ringfietspad
655,Ringfietspad Zurenborgbrug,2023-01-20,06:00:00,0,0,0,FMN 06 B Zurenborgbrug Ringfietspad
655,Ringfietspad Zurenborgbrug,2023-01-20,07:00:00,0,0,0,FMN 06 B Zurenborgbrug Ringfietspad
655,Ringfietspad Zurenborgbrug,2023-01-20,08:00:00,0,0,0,FMN 06 B Zurenborgbrug Ringfietspad
655,Ringfietspad Zurenborgbrug,2023-01-20,09:00:00,0,0,0,FMN 06 B Zurenborgbrug Ringfietspad
655,Ringfietspad Zurenborgbrug,2023-01-20,10:00:00,0,0,0,FMN 06 B Zurenborgbrug Ringfietspad
655,Ringfietspad Zurenborgbrug,2023-01-20,11:00:00,0,0,0,FMN 06 B Zurenborgbrug Ringfietspad
655,Ringfietspad Zurenborgbrug,2023-01-20,12:00:00,0,0,0,FMN 06 B Zurenborgbrug Ringfietspad
655,Ringfietspad Zurenborgbrug,2023-01-20,13:00:00,0,0,0,FMN 06 B Zurenborgbrug Ringfietspad
655,Ringfietspad Zurenborgbrug,2023-01-20,14:00:00,0,0,0,FMN 06 B Zurenborgbrug Ringfietspad
655,Ringfietspad Zurenborgbrug,2023-01-20,15:00:00,0,0,0,FMN 06 B Zurenborgbrug Ringfietspad
655,Ringfietspad Zurenborgbrug,2023-01-20,16:00:00,0,0,0,FMN 06 B Zurenborgbrug Ringfietspad
655,Ringfietspad Zurenborgbrug,2023-01-20,17:00:00,0,0,0,FMN 06 B Zurenborgbrug Ringfietspad
655,Ringfietspad Zurenborgbrug,2023-01-20,18:00:00,0,0,0,FMN 06 B Zurenborgbrug Ringfietspad
655,Ringfietspad Zurenborgbrug,2023-01-20,19:00:00,0,0,0,FMN 06 B Zurenborgbrug Ringfietspad
655,Ringfietspad Zurenborgbrug,2023-01-20,20:00:00,0,0,0,FMN 06 B Zurenborgbrug Ringfietspad
655,Ringfietspad Zurenborgbrug,2023-01-20,21:00:00,0,0,0,FMN 06 B Zurenborgbrug Ringfietspad
655,Ringfietspad Zurenborgbrug,2023-01-20,22:00:00,0,0,0,FMN 06 B Zurenborgbrug Ringfietspad
655,Ringfietspad Zurenborgbrug,2023-01-20,23:00:00,0,0,0,FMN 06 B Zurenborgbrug Ringfietspad
655,Ringfietspad Zurenborgbrug,2023-01-21,00:00:00,0,0,0,FMN 06 B Zurenborgbrug Ringfietspad
655,Ringfietspad Zurenborgbrug,2023-01-21,01:00:00,0,0,0,FMN 06 B Zurenborgbrug Ringfietspad
655,Ringfietspad Zurenborgbrug,2023-01-21,02:00:00,0,0,0,FMN 06 B Zurenborgbrug Ringfietspad
655,Ringfietspad Zurenborgbrug,2023-01-21,03:00:00,0,0,0,FMN 06 B Zurenborgbrug Ringfietspad
655,Ringfietspad Zurenborgbrug,2023-01-21,04:00:00,0,0,0,FMN 06 B Zurenborgbrug Ringfietspad
655,Ringfietspad Zurenborgbrug,2023-01-21,05:00:00,0,0,0,FMN 06 B Zurenborgbrug Ringfietspad
655,Ringfietspad Zurenborgbrug,2023-01-21,06:00:00,0,0,0,FMN 06 B Zurenborgbrug Ringfietspad
655,Ringfietspad Zurenborgbrug,2023-01-21,07:00:00,0,0,0,FMN 06 B Zurenborgbrug Ringfietspad
655,Ringfietspad Zurenborgbrug,2023-01-21,08:00:00,0,0,0,FMN 06 B Zurenborgbrug Ringfietspad
655,Ringfietspad Zurenborgbrug,2023-01-21,09:00:00,30,10,20,FMN 06 B Zurenborgbrug Ringfietspad
655,Ringfietspad Zurenborgbrug,2023-01-21,10:00:00,46,25,21,FMN 06 B Zurenborgbrug Ringfietspad
655,Ringfietspad Zurenborgbrug,2023-01-21,11:00:00,60,26,34,FMN 06 B Zurenborgbrug Ringfietspad
655,Ringfietspad Zurenborgbrug,2023-01-21,12:00:00,74,30,44,FMN 06 B Zurenborgbrug Ringfietspad
655,Ringfietspad Zurenborgbrug,2023-01-21,13:00:00,83,33,50,FMN 06 B Zurenborgbrug Ringfietspad
655,Ringfietspad Zurenborgbrug,2023-01-21,14:00:00,75,26,49,FMN 06 B Zurenborgbrug Ringfietspad
655,Ringfietspad Zurenborgbrug,2023-01-21,15:00:00,79,40,39,FMN 06 B Zurenborgbrug Ringfietspad
655,Ringfietspad Zurenborgbrug,2023-01-21,16:00:00,70,29,41,FMN 06 B Zurenborgbrug Ringfietspad
655,Ringfietspad Zurenborgbrug,2023-01-21,17:00:00,67,35,32,FMN 06 B Zurenborgbrug Ringfietspad
655,Ringfietspad Zurenborgbrug,2023-01-21,18:00:00,47,18,29,FMN 06 B Zurenborgbrug Ringfietspad
655,Ringfietspad Zurenborgbrug,2023-01-21,19:00:00,48,20,28,FMN 06 B Zurenborgbrug Ringfietspad
655,Ringfietspad Zurenborgbrug,2023-01-21,20:00:00,32,14,18,FMN 06 B Zurenborgbrug Ringfietspad
655,Ringfietspad Zurenborgbrug,2023-01-21,21:00:00,23,12,11,FMN 06 B Zurenborgbrug Ringfietspad
655,Ringfietspad Zurenborgbrug,2023-01-21,22:00:00,31,13,18,FMN 06 B Zurenborgbrug Ringfietspad
655,Ringfietspad Zurenborgbrug,2023-01-21,23:00:00,18,9,9,FMN 06 B Zurenborgbrug Ringfietspad
655,Ringfietspad Zurenborgbrug,2023-01-22,00:00:00,17,7,10,FMN 06 B Zurenborgbrug Ringfietspad
655,Ringfietspad Zurenborgbrug,2023-01-22,01:00:00,16,8,8,FMN 06 B Zurenborgbrug Ringfietspad
655,Ringfietspad Zurenborgbrug,2023-01-22,02:00:00,0,0,0,FMN 06 B Zurenborgbrug Ringfietspad
655,Ringfietspad Zurenborgbrug,2023-01-22,03:00:00,0,0,0,FMN 06 B Zurenborgbrug Ringfietspad
655,Ringfietspad Zurenborgbrug,2023-01-22,04:00:00,0,0,0,FMN 06 B Zurenborgbrug Ringfietspad
655,Ringfietspad Zurenborgbrug,2023-01-22,05:00:00,0,0,0,FMN 06 B Zurenborgbrug Ringfietspad
655,Ringfietspad Zurenborgbrug,2023-01-22,06:00:00,0,0,0,FMN 06 B Zurenborgbrug Ringfietspad
655,Ringfietspad Zurenborgbrug,2023-01-22,07:00:00,0,0,0,FMN 06 B Zurenborgbrug Ringfietspad
655,Ringfietspad Zurenborgbrug,2023-01-22,08:00:00,0,0,0,FMN 06 B Zurenborgbrug Ringfietspad
655,Ringfietspad Zurenborgbrug,2023-01-22,09:00:00,17,5,12,FMN 06 B Zurenborgbrug Ringfietspad
655,Ringfietspad Zurenborgbrug,2023-01-22,10:00:00,30,17,13,FMN 06 B Zurenborgbrug Ringfietspad
655,Ringfietspad Zurenborgbrug,2023-01-22,11:00:00,61,28,33,FMN 06 B Zurenborgbrug Ringfietspad
655,Ringfietspad Zurenborgbrug,2023-01-22,12:00:00,115,32,83,FMN 06 B Zurenborgbrug Ringfietspad
655,Ringfietspad Zurenborgbrug,2023-01-22,13:00:00,71,33,38,FMN 06 B Zurenborgbrug Ringfietspad
655,Ringfietspad Zurenborgbrug,2023-01-22,14:00:00,63,23,40,FMN 06 B Zurenborgbrug Ringfietspad
655,Ringfietspad Zurenborgbrug,2023-01-22,15:00:00,80,46,34,FMN 06 B Zurenborgbrug Ringfietspad
655,Ringfietspad Zurenborgbrug,2023-01-22,16:00:00,81,52,29,FMN 06 B Zurenborgbrug Ringfietspad
655,Ringfietspad Zurenborgbrug,2023-01-22,17:00:00,56,33,23,FMN 06 B Zurenborgbrug Ringfietspad
655,Ringfietspad Zurenborgbrug,2023-01-22,18:00:00,43,21,22,FMN 06 B Zurenborgbrug Ringfietspad
655,Ringfietspad Zurenborgbrug,2023-01-22,19:00:00,30,13,17,FMN 06 B Zurenborgbrug Ringfietspad
655,Ringfietspad Zurenborgbrug,2023-01-22,20:00:00,23,10,13,FMN 06 B Zurenborgbrug Ringfietspad
655,Ringfietspad Zurenborgbrug,2023-01-22,21:00:00,29,12,17,FMN 06 B Zurenborgbrug Ringfietspad
655,Ringfietspad Zurenborgbrug,2023-01-22,22:00:00,14,6,8,FMN 06 B Zurenborgbrug Ringfietspad
655,Ringfietspad Zurenborgbrug,2023-01-22,23:00:00,12,6,6,FMN 06 B Zurenborgbrug Ringfietspad
655,Ringfietspad Zurenborgbrug,2023-01-23,00:00:00,3,0,3,FMN 06 B Zurenborgbrug Ringfietspad
655,Ringfietspad Zurenborgbrug,2023-01-23,01:00:00,2,1,1,FMN 06 B Zurenborgbrug Ringfietspad
655,Ringfietspad Zurenborgbrug,2023-01-23,02:00:00,0,0,0,FMN 06 B Zurenborgbrug Ringfietspad
655,Ringfietspad Zurenborgbrug,2023-01-23,03:00:00,0,0,0,FMN 06 B Zurenborgbrug Ringfietspad
655,Ringfietspad Zurenborgbrug,2023-01-23,04:00:00,0,0,0,FMN 06 B Zurenborgbrug Ringfietspad
655,Ringfietspad Zurenborgbrug,2023-01-23,05:00:00,0,0,0,FMN 06 B Zurenborgbrug Ringfietspad
655,Ringfietspad Zurenborgbrug,2023-01-23,06:00:00,0,0,0,FMN 06 B Zurenborgbrug Ringfietspad
655,Ringfietspad Zurenborgbrug,2023-01-23,07:00:00,0,0,0,FMN 06 B Zurenborgbrug Ringfietspad
655,Ringfietspad Zurenborgbrug,2023-01-23,08:00:00,0,0,0,FMN 06 B Zurenborgbrug Ringfietspad
655,Ringfietspad Zurenborgbrug,2023-01-23,09:00:00,22,12,10,FMN 06 B Zurenborgbrug Ringfietspad
655,Ringfietspad Zurenborgbrug,2023-01-23,10:00:00,70,31,39,FMN 06 B Zurenborgbrug Ringfietspad
655,Ringfietspad Zurenborgbrug,2023-01-23,11:00:00,63,30,33,FMN 06 B Zurenborgbrug Ringfietspad
655,Ringfietspad Zurenborgbrug,2023-01-23,12:00:00,101,51,50,FMN 06 B Zurenborgbrug Ringfietspad
655,Ringfietspad Zurenborgbrug,2023-01-23,13:00:00,108,50,58,FMN 06 B Zurenborgbrug Ringfietspad
655,Ringfietspad Zurenborgbrug,2023-01-23,14:00:00,93,35,58,FMN 06 B Zurenborgbrug Ringfietspad
655,Ringfietspad Zurenborgbrug,2023-01-23,15:00:00,181,63,118,FMN 06 B Zurenborgbrug Ringfietspad
655,Ringfietspad Zurenborgbrug,2023-01-23,16:00:00,336,154,182,FMN 06 B Zurenborgbrug Ringfietspad
655,Ringfietspad Zurenborgbrug,2023-01-23,17:00:00,355,119,236,FMN 06 B Zurenborgbrug Ringfietspad
655,Ringfietspad Zurenborgbrug,2023-01-23,18:00:00,169,77,92,FMN 06 B Zurenborgbrug Ringfietspad
655,Ringfietspad Zurenborgbrug,2023-01-23,19:00:00,90,34,56,FMN 06 B Zurenborgbrug Ringfietspad
655,Ringfietspad Zurenborgbrug,2023-01-23,20:00:00,53,16,37,FMN 06 B Zurenborgbrug Ringfietspad
655,Ringfietspad Zurenborgbrug,2023-01-23,21:00:00,47,25,22,FMN 06 B Zurenborgbrug Ringfietspad
655,Ringfietspad Zurenborgbrug,2023-01-23,22:00:00,46,16,30,FMN 06 B Zurenborgbrug Ringfietspad
655,Ringfietspad Zurenborgbrug,2023-01-23,23:00:00,10,3,7,FMN 06 B Zurenborgbrug Ringfietspad
655,Ringfietspad Zurenborgbrug,2023-01-24,00:00:00,3,2,1,FMN 06 B Zurenborgbrug Ringfietspad
655,Ringfietspad Zurenborgbrug,2023-01-24,01:00:00,3,0,3,FMN 06 B Zurenborgbrug Ringfietspad
655,Ringfietspad Zurenborgbrug,2023-01-24,02:00:00,0,0,0,FMN 06 B Zurenborgbrug Ringfietspad
655,Ringfietspad Zurenborgbrug,2023-01-24,03:00:00,0,0,0,FMN 06 B Zurenborgbrug Ringfietspad
655,Ringfietspad Zurenborgbrug,2023-01-24,04:00:00,0,0,0,FMN 06 B Zurenborgbrug Ringfietspad
655,Ringfietspad Zurenborgbrug,2023-01-24,05:00:00,0,0,0,FMN 06 B Zurenborgbrug Ringfietspad
655,Ringfietspad Zurenborgbrug,2023-01-24,06:00:00,0,0,0,FMN 06 B Zurenborgbrug Ringfietspad
655,Ringfietspad Zurenborgbrug,2023-01-24,07:00:00,0,0,0,FMN 06 B Zurenborgbrug Ringfietspad
655,Ringfietspad Zurenborgbrug,2023-01-24,08:00:00,0,0,0,FMN 06 B Zurenborgbrug Ringfietspad
655,Ringfietspad Zurenborgbrug,2023-01-24,09:00:00,0,0,0,FMN 06 B Zurenborgbrug Ringfietspad
655,Ringfietspad Zurenborgbrug,2023-01-24,10:00:00,7,2,5,FMN 06 B Zurenborgbrug Ringfietspad
655,Ringfietspad Zurenborgbrug,2023-01-24,11:00:00,70,31,39,FMN 06 B Zurenborgbrug Ringfietspad
655,Ringfietspad Zurenborgbrug,2023-01-24,12:00:00,110,53,57,FMN 06 B Zurenborgbrug Ringfietspad
655,Ringfietspad Zurenborgbrug,2023-01-24,13:00:00,109,47,62,FMN 06 B Zurenborgbrug Ringfietspad
655,Ringfietspad Zurenborgbrug,2023-01-24,14:00:00,109,46,63,FMN 06 B Zurenborgbrug Ringfietspad
655,Ringfietspad Zurenborgbrug,2023-01-24,15:00:00,220,88,132,FMN 06 B Zurenborgbrug Ringfietspad
655,Ringfietspad Zurenborgbrug,2023-01-24,16:00:00,397,161,236,FMN 06 B Zurenborgbrug Ringfietspad
655,Ringfietspad Zurenborgbrug,2023-01-24,17:00:00,412,145,267,FMN 06 B Zurenborgbrug Ringfietspad
655,Ringfietspad Zurenborgbrug,2023-01-24,18:00:00,215,94,121,FMN 06 B Zurenborgbrug Ringfietspad
655,Ringfietspad Zurenborgbrug,2023-01-24,19:00:00,115,40,75,FMN 06 B Zurenborgbrug Ringfietspad
655,Ringfietspad Zurenborgbrug,2023-01-24,20:00:00,67,32,35,FMN 06 B Zurenborgbrug Ringfietspad
655,Ringfietspad Zurenborgbrug,2023-01-24,21:00:00,50,21,29,FMN 06 B Zurenborgbrug Ringfietspad
655,Ringfietspad Zurenborgbrug,2023-01-24,22:00:00,62,24,38,FMN 06 B Zurenborgbrug Ringfietspad
655,Ringfietspad Zurenborgbrug,2023-01-24,23:00:00,29,11,18,FMN 06 B Zurenborgbrug Ringfietspad
655,Ringfietspad Zurenborgbrug,2023-01-25,00:00:00,11,5,6,FMN 06 B Zurenborgbrug Ringfietspad
655,Ringfietspad Zurenborgbrug,2023-01-25,01:00:00,1,1,0,FMN 06 B Zurenborgbrug Ringfietspad
655,Ringfietspad Zurenborgbrug,2023-01-25,02:00:00,0,0,0,FMN 06 B Zurenborgbrug Ringfietspad
655,Ringfietspad Zurenborgbrug,2023-01-25,03:00:00,0,0,0,FMN 06 B Zurenborgbrug Ringfietspad
655,Ringfietspad Zurenborgbrug,2023-01-25,04:00:00,0,0,0,FMN 06 B Zurenborgbrug Ringfietspad
655,Ringfietspad Zurenborgbrug,2023-01-25,05:00:00,0,0,0,FMN 06 B Zurenborgbrug Ringfietspad
655,Ringfietspad Zurenborgbrug,2023-01-25,06:00:00,0,0,0,FMN 06 B Zurenborgbrug Ringfietspad
655,Ringfietspad Zurenborgbrug,2023-01-25,07:00:00,0,0,0,FMN 06 B Zurenborgbrug Ringfietspad
655,Ringfietspad Zurenborgbrug,2023-01-25,08:00:00,0,0,0,FMN 06 B Zurenborgbrug Ringfietspad
655,Ringfietspad Zurenborgbrug,2023-01-25,09:00:00,0,0,0,FMN 06 B Zurenborgbrug Ringfietspad
655,Ringfietspad Zurenborgbrug,2023-01-25,10:00:00,18,8,10,FMN 06 B Zurenborgbrug Ringfietspad
655,Ringfietspad Zurenborgbrug,2023-01-25,11:00:00,81,42,39,FMN 06 B Zurenborgbrug Ringfietspad
655,Ringfietspad Zurenborgbrug,2023-01-25,12:00:00,250,126,124,FMN 06 B Zurenborgbrug Ringfietspad
655,Ringfietspad Zurenborgbrug,2023-01-25,13:00:00,131,46,85,FMN 06 B Zurenborgbrug Ringfietspad
655,Ringfietspad Zurenborgbrug,2023-01-25,14:00:00,100,37,63,FMN 06 B Zurenborgbrug Ringfietspad
655,Ringfietspad Zurenborgbrug,2023-01-25,15:00:00,130,46,84,FMN 06 B Zurenborgbrug Ringfietspad
655,Ringfietspad Zurenborgbrug,2023-01-25,16:00:00,249,99,150,FMN 06 B Zurenborgbrug Ringfietspad
655,Ringfietspad Zurenborgbrug,2023-01-25,17:00:00,341,122,219,FMN 06 B Zurenborgbrug Ringfietspad
655,Ringfietspad Zurenborgbrug,2023-01-25,18:00:00,184,69,115,FMN 06 B Zurenborgbrug Ringfietspad
655,Ringfietspad Zurenborgbrug,2023-01-25,19:00:00,110,48,62,FMN 06 B Zurenborgbrug Ringfietspad
655,Ringfietspad Zurenborgbrug,2023-01-25,20:00:00,58,23,35,FMN 06 B Zurenborgbrug Ringfietspad
655,Ringfietspad Zurenborgbrug,2023-01-25,21:00:00,70,31,39,FMN 06 B Zurenborgbrug Ringfietspad
655,Ringfietspad Zurenborgbrug,2023-01-25,22:00:00,57,17,40,FMN 06 B Zurenborgbrug Ringfietspad
655,Ringfietspad Zurenborgbrug,2023-01-25,23:00:00,16,8,8,FMN 06 B Zurenborgbrug Ringfietspad
655,Ringfietspad Zurenborgbrug,2023-01-26,00:00:00,3,1,2,FMN 06 B Zurenborgbrug Ringfietspad
655,Ringfietspad Zurenborgbrug,2023-01-26,01:00:00,2,0,2,FMN 06 B Zurenborgbrug Ringfietspad
655,Ringfietspad Zurenborgbrug,2023-01-26,02:00:00,0,0,0,FMN 06 B Zurenborgbrug Ringfietspad
655,Ringfietspad Zurenborgbrug,2023-01-26,03:00:00,0,0,0,FMN 06 B Zurenborgbrug Ringfietspad
655,Ringfietspad Zurenborgbrug,2023-01-26,04:00:00,0,0,0,FMN 06 B Zurenborgbrug Ringfietspad
655,Ringfietspad Zurenborgbrug,2023-01-26,05:00:00,0,0,0,FMN 06 B Zurenborgbrug Ringfietspad
655,Ringfietspad Zurenborgbrug,2023-01-26,06:00:00,0,0,0,FMN 06 B Zurenborgbrug Ringfietspad
655,Ringfietspad Zurenborgbrug,2023-01-26,07:00:00,0,0,0,FMN 06 B Zurenborgbrug Ringfietspad
655,Ringfietspad Zurenborgbrug,2023-01-26,08:00:00,0,0,0,FMN 06 B Zurenborgbrug Ringfietspad
655,Ringfietspad Zurenborgbrug,2023-01-26,09:00:00,0,0,0,FMN 06 B Zurenborgbrug Ringfietspad
655,Ringfietspad Zurenborgbrug,2023-01-26,10:00:00,33,18,15,FMN 06 B Zurenborgbrug Ringfietspad
655,Ringfietspad Zurenborgbrug,2023-01-26,11:00:00,61,35,26,FMN 06 B Zurenborgbrug Ringfietspad
655,Ringfietspad Zurenborgbrug,2023-01-26,12:00:00,92,47,45,FMN 06 B Zurenborgbrug Ringfietspad
655,Ringfietspad Zurenborgbrug,2023-01-26,13:00:00,103,52,51,FMN 06 B Zurenborgbrug Ringfietspad
655,Ringfietspad Zurenborgbrug,2023-01-26,14:00:00,81,24,57,FMN 06 B Zurenborgbrug Ringfietspad
655,Ringfietspad Zurenborgbrug,2023-01-26,15:00:00,174,62,112,FMN 06 B Zurenborgbrug Ringfietspad
655,Ringfietspad Zurenborgbrug,2023-01-26,16:00:00,339,142,197,FMN 06 B Zurenborgbrug Ringfietspad
655,Ringfietspad Zurenborgbrug,2023-01-26,17:00:00,348,112,236,FMN 06 B Zurenborgbrug Ringfietspad
655,Ringfietspad Zurenborgbrug,2023-01-26,18:00:00,209,79,130,FMN 06 B Zurenborgbrug Ringfietspad
655,Ringfietspad Zurenborgbrug,2023-01-26,19:00:00,117,38,79,FMN 06 B Zurenborgbrug Ringfietspad
655,Ringfietspad Zurenborgbrug,2023-01-26,20:00:00,4,0,4,FMN 06 B Zurenborgbrug Ringfietspad
655,Ringfietspad Zurenborgbrug,2023-01-26,21:00:00,0,0,0,FMN 06 B Zurenborgbrug Ringfietspad
655,Ringfietspad Zurenborgbrug,2023-01-26,22:00:00,0,0,0,FMN 06 B Zurenborgbrug Ringfietspad
655,Ringfietspad Zurenborgbrug,2023-01-26,23:00:00,0,0,0,FMN 06 B Zurenborgbrug Ringfietspad
655,Ringfietspad Zurenborgbrug,2023-01-27,00:00:00,0,0,0,FMN 06 B Zurenborgbrug Ringfietspad
655,Ringfietspad Zurenborgbrug,2023-01-27,01:00:00,0,0,0,FMN 06 B Zurenborgbrug Ringfietspad
655,Ringfietspad Zurenborgbrug,2023-01-27,02:00:00,0,0,0,FMN 06 B Zurenborgbrug Ringfietspad
655,Ringfietspad Zurenborgbrug,2023-01-27,03:00:00,0,0,0,FMN 06 B Zurenborgbrug Ringfietspad
655,Ringfietspad Zurenborgbrug,2023-01-27,04:00:00,0,0,0,FMN 06 B Zurenborgbrug Ringfietspad
655,Ringfietspad Zurenborgbrug,2023-01-27,05:00:00,0,0,0,FMN 06 B Zurenborgbrug Ringfietspad
655,Ringfietspad Zurenborgbrug,2023-01-27,06:00:00,0,0,0,FMN 06 B Zurenborgbrug Ringfietspad
655,Ringfietspad Zurenborgbrug,2023-01-27,07:00:00,0,0,0,FMN 06 B Zurenborgbrug Ringfietspad
655,Ringfietspad Zurenborgbrug,2023-01-27,08:00:00,0,0,0,FMN 06 B Zurenborgbrug Ringfietspad
655,Ringfietspad Zurenborgbrug,2023-01-27,09:00:00,0,0,0,FMN 06 B Zurenborgbrug Ringfietspad
655,Ringfietspad Zurenborgbrug,2023-01-27,10:00:00,52,23,29,FMN 06 B Zurenborgbrug Ringfietspad
655,Ringfietspad Zurenborgbrug,2023-01-27,11:00:00,94,45,49,FMN 06 B Zurenborgbrug Ringfietspad
655,Ringfietspad Zurenborgbrug,2023-01-27,12:00:00,117,53,64,FMN 06 B Zurenborgbrug Ringfietspad
655,Ringfietspad Zurenborgbrug,2023-01-27,13:00:00,111,52,59,FMN 06 B Zurenborgbrug Ringfietspad
655,Ringfietspad Zurenborgbrug,2023-01-27,14:00:00,133,50,83,FMN 06 B Zurenborgbrug Ringfietspad
655,Ringfietspad Zurenborgbrug,2023-01-27,15:00:00,198,75,123,FMN 06 B Zurenborgbrug Ringfietspad
655,Ringfietspad Zurenborgbrug,2023-01-27,16:00:00,329,136,193,FMN 06 B Zurenborgbrug Ringfietspad
655,Ringfietspad Zurenborgbrug,2023-01-27,17:00:00,282,95,187,FMN 06 B Zurenborgbrug Ringfietspad
655,Ringfietspad Zurenborgbrug,2023-01-27,18:00:00,170,66,104,FMN 06 B Zurenborgbrug Ringfietspad
655,Ringfietspad Zurenborgbrug,2023-01-27,19:00:00,102,37,65,FMN 06 B Zurenborgbrug Ringfietspad
655,Ringfietspad Zurenborgbrug,2023-01-27,20:00:00,67,30,37,FMN 06 B Zurenborgbrug Ringfietspad
655,Ringfietspad Zurenborgbrug,2023-01-27,21:00:00,57,25,32,FMN 06 B Zurenborgbrug Ringfietspad
655,Ringfietspad Zurenborgbrug,2023-01-27,22:00:00,1,0,1,FMN 06 B Zurenborgbrug Ringfietspad
655,Ringfietspad Zurenborgbrug,2023-01-27,23:00:00,0,0,0,FMN 06 B Zurenborgbrug Ringfietspad
655,Ringfietspad Zurenborgbrug,2023-01-28,00:00:00,0,0,0,FMN 06 B Zurenborgbrug Ringfietspad
655,Ringfietspad Zurenborgbrug,2023-01-28,01:00:00,0,0,0,FMN 06 B Zurenborgbrug Ringfietspad
655,Ringfietspad Zurenborgbrug,2023-01-28,02:00:00,0,0,0,FMN 06 B Zurenborgbrug Ringfietspad
655,Ringfietspad Zurenborgbrug,2023-01-28,03:00:00,0,0,0,FMN 06 B Zurenborgbrug Ringfietspad
655,Ringfietspad Zurenborgbrug,2023-01-28,04:00:00,0,0,0,FMN 06 B Zurenborgbrug Ringfietspad
655,Ringfietspad Zurenborgbrug,2023-01-28,05:00:00,0,0,0,FMN 06 B Zurenborgbrug Ringfietspad
655,Ringfietspad Zurenborgbrug,2023-01-28,06:00:00,0,0,0,FMN 06 B Zurenborgbrug Ringfietspad
655,Ringfietspad Zurenborgbrug,2023-01-28,07:00:00,0,0,0,FMN 06 B Zurenborgbrug Ringfietspad
655,Ringfietspad Zurenborgbrug,2023-01-28,08:00:00,0,0,0,FMN 06 B Zurenborgbrug Ringfietspad
655,Ringfietspad Zurenborgbrug,2023-01-28,09:00:00,0,0,0,FMN 06 B Zurenborgbrug Ringfietspad
655,Ringfietspad Zurenborgbrug,2023-01-28,10:00:00,34,16,18,FMN 06 B Zurenborgbrug Ringfietspad
655,Ringfietspad Zurenborgbrug,2023-01-28,11:00:00,68,34,34,FMN 06 B Zurenborgbrug Ringfietspad
655,Ringfietspad Zurenborgbrug,2023-01-28,12:00:00,91,46,45,FMN 06 B Zurenborgbrug Ringfietspad
655,Ringfietspad Zurenborgbrug,2023-01-28,13:00:00,116,54,62,FMN 06 B Zurenborgbrug Ringfietspad
655,Ringfietspad Zurenborgbrug,2023-01-28,14:00:00,110,60,50,FMN 06 B Zurenborgbrug Ringfietspad
655,Ringfietspad Zurenborgbrug,2023-01-28,15:00:00,92,33,59,FMN 06 B Zurenborgbrug Ringfietspad
655,Ringfietspad Zurenborgbrug,2023-01-28,16:00:00,105,41,64,FMN 06 B Zurenborgbrug Ringfietspad
655,Ringfietspad Zurenborgbrug,2023-01-28,17:00:00,81,37,44,FMN 06 B Zurenborgbrug Ringfietspad
655,Ringfietspad Zurenborgbrug,2023-01-28,18:00:00,85,29,56,FMN 06 B Zurenborgbrug Ringfietspad
655,Ringfietspad Zurenborgbrug,2023-01-28,19:00:00,81,38,43,FMN 06 B Zurenborgbrug Ringfietspad
655,Ringfietspad Zurenborgbrug,2023-01-28,20:00:00,50,23,27,FMN 06 B Zurenborgbrug Ringfietspad
655,Ringfietspad Zurenborgbrug,2023-01-28,21:00:00,29,14,15,FMN 06 B Zurenborgbrug Ringfietspad
655,Ringfietspad Zurenborgbrug,2023-01-28,22:00:00,42,26,16,FMN 06 B Zurenborgbrug Ringfietspad
655,Ringfietspad Zurenborgbrug,2023-01-28,23:00:00,43,25,18,FMN 06 B Zurenborgbrug Ringfietspad
655,Ringfietspad Zurenborgbrug,2023-01-29,00:00:00,22,6,16,FMN 06 B Zurenborgbrug Ringfietspad
655,Ringfietspad Zurenborgbrug,2023-01-29,01:00:00,19,6,13,FMN 06 B Zurenborgbrug Ringfietspad
655,Ringfietspad Zurenborgbrug,2023-01-29,02:00:00,0,0,0,FMN 06 B Zurenborgbrug Ringfietspad
655,Ringfietspad Zurenborgbrug,2023-01-29,03:00:00,0,0,0,FMN 06 B Zurenborgbrug Ringfietspad
655,Ringfietspad Zurenborgbrug,2023-01-29,04:00:00,0,0,0,FMN 06 B Zurenborgbrug Ringfietspad
655,Ringfietspad Zurenborgbrug,2023-01-29,05:00:00,0,0,0,FMN 06 B Zurenborgbrug Ringfietspad
655,Ringfietspad Zurenborgbrug,2023-01-29,06:00:00,0,0,0,FMN 06 B Zurenborgbrug Ringfietspad
655,Ringfietspad Zurenborgbrug,2023-01-29,07:00:00,0,0,0,FMN 06 B Zurenborgbrug Ringfietspad
655,Ringfietspad Zurenborgbrug,2023-01-29,08:00:00,0,0,0,FMN 06 B Zurenborgbrug Ringfietspad
655,Ringfietspad Zurenborgbrug,2023-01-29,09:00:00,0,0,0,FMN 06 B Zurenborgbrug Ringfietspad
655,Ringfietspad Zurenborgbrug,2023-01-29,10:00:00,25,9,16,FMN 06 B Zurenborgbrug Ringfietspad
655,Ringfietspad Zurenborgbrug,2023-01-29,11:00:00,78,38,40,FMN 06 B Zurenborgbrug Ringfietspad
655,Ringfietspad Zurenborgbrug,2023-01-29,12:00:00,108,66,42,FMN 06 B Zurenborgbrug Ringfietspad
655,Ringfietspad Zurenborgbrug,2023-01-29,13:00:00,112,61,51,FMN 06 B Zurenborgbrug Ringfietspad
655,Ringfietspad Zurenborgbrug,2023-01-29,14:00:00,71,27,44,FMN 06 B Zurenborgbrug Ringfietspad
655,Ringfietspad Zurenborgbrug,2023-01-29,15:00:00,85,36,49,FMN 06 B Zurenborgbrug Ringfietspad
655,Ringfietspad Zurenborgbrug,2023-01-29,16:00:00,55,36,19,FMN 06 B Zurenborgbrug Ringfietspad
655,Ringfietspad Zurenborgbrug,2023-01-29,17:00:00,84,46,38,FMN 06 B Zurenborgbrug Ringfietspad
655,Ringfietspad Zurenborgbrug,2023-01-29,18:00:00,58,31,27,FMN 06 B Zurenborgbrug Ringfietspad
655,Ringfietspad Zurenborgbrug,2023-01-29,19:00:00,52,25,27,FMN 06 B Zurenborgbrug Ringfietspad
655,Ringfietspad Zurenborgbrug,2023-01-29,20:00:00,35,17,18,FMN 06 B Zurenborgbrug Ringfietspad
655,Ringfietspad Zurenborgbrug,2023-01-29,21:00:00,24,6,18,FMN 06 B Zurenborgbrug Ringfietspad
655,Ringfietspad Zurenborgbrug,2023-01-29,22:00:00,16,7,9,FMN 06 B Zurenborgbrug Ringfietspad
655,Ringfietspad Zurenborgbrug,2023-01-29,23:00:00,13,6,7,FMN 06 B Zurenborgbrug Ringfietspad
655,Ringfietspad Zurenborgbrug,2023-01-30,00:00:00,7,3,4,FMN 06 B Zurenborgbrug Ringfietspad
655,Ringfietspad Zurenborgbrug,2023-01-30,01:00:00,1,1,0,FMN 06 B Zurenborgbrug Ringfietspad
655,Ringfietspad Zurenborgbrug,2023-01-30,02:00:00,0,0,0,FMN 06 B Zurenborgbrug Ringfietspad
655,Ringfietspad Zurenborgbrug,2023-01-30,03:00:00,0,0,0,FMN 06 B Zurenborgbrug Ringfietspad
655,Ringfietspad Zurenborgbrug,2023-01-30,04:00:00,0,0,0,FMN 06 B Zurenborgbrug Ringfietspad
655,Ringfietspad Zurenborgbrug,2023-01-30,05:00:00,0,0,0,FMN 06 B Zurenborgbrug Ringfietspad
655,Ringfietspad Zurenborgbrug,2023-01-30,06:00:00,0,0,0,FMN 06 B Zurenborgbrug Ringfietspad
655,Ringfietspad Zurenborgbrug,2023-01-30,07:00:00,0,0,0,FMN 06 B Zurenborgbrug Ringfietspad
655,Ringfietspad Zurenborgbrug,2023-01-30,08:00:00,77,47,30,FMN 06 B Zurenborgbrug Ringfietspad
655,Ringfietspad Zurenborgbrug,2023-01-30,09:00:00,131,75,56,FMN 06 B Zurenborgbrug Ringfietspad
655,Ringfietspad Zurenborgbrug,2023-01-30,10:00:00,55,18,37,FMN 06 B Zurenborgbrug Ringfietspad
655,Ringfietspad Zurenborgbrug,2023-01-30,11:00:00,91,38,53,FMN 06 B Zurenborgbrug Ringfietspad
655,Ringfietspad Zurenborgbrug,2023-01-30,12:00:00,141,69,72,FMN 06 B Zurenborgbrug Ringfietspad
655,Ringfietspad Zurenborgbrug,2023-01-30,13:00:00,111,58,53,FMN 06 B Zurenborgbrug Ringfietspad
655,Ringfietspad Zurenborgbrug,2023-01-30,14:00:00,125,56,69,FMN 06 B Zurenborgbrug Ringfietspad
655,Ringfietspad Zurenborgbrug,2023-01-30,15:00:00,215,82,133,FMN 06 B Zurenborgbrug Ringfietspad
655,Ringfietspad Zurenborgbrug,2023-01-30,16:00:00,395,167,228,FMN 06 B Zurenborgbrug Ringfietspad
655,Ringfietspad Zurenborgbrug,2023-01-30,17:00:00,398,138,260,FMN 06 B Zurenborgbrug Ringfietspad
655,Ringfietspad Zurenborgbrug,2023-01-30,18:00:00,217,81,136,FMN 06 B Zurenborgbrug Ringfietspad
655,Ringfietspad Zurenborgbrug,2023-01-30,19:00:00,92,28,64,FMN 06 B Zurenborgbrug Ringfietspad
655,Ringfietspad Zurenborgbrug,2023-01-30,20:00:00,64,27,37,FMN 06 B Zurenborgbrug Ringfietspad
655,Ringfietspad Zurenborgbrug,2023-01-30,21:00:00,59,22,37,FMN 06 B Zurenborgbrug Ringfietspad
655,Ringfietspad Zurenborgbrug,2023-01-30,22:00:00,54,17,37,FMN 06 B Zurenborgbrug Ringfietspad
655,Ringfietspad Zurenborgbrug,2023-01-30,23:00:00,18,6,12,FMN 06 B Zurenborgbrug Ringfietspad
655,Ringfietspad Zurenborgbrug,2023-01-31,00:00:00,6,4,2,FMN 06 B Zurenborgbrug Ringfietspad
655,Ringfietspad Zurenborgbrug,2023-01-31,01:00:00,4,0,4,FMN 06 B Zurenborgbrug Ringfietspad
655,Ringfietspad Zurenborgbrug,2023-01-31,02:00:00,0,0,0,FMN 06 B Zurenborgbrug Ringfietspad
655,Ringfietspad Zurenborgbrug,2023-01-31,03:00:00,0,0,0,FMN 06 B Zurenborgbrug Ringfietspad
655,Ringfietspad Zurenborgbrug,2023-01-31,04:00:00,0,0,0,FMN 06 B Zurenborgbrug Ringfietspad
655,Ringfietspad Zurenborgbrug,2023-01-31,05:00:00,0,0,0,FMN 06 B Zurenborgbrug Ringfietspad
655,Ringfietspad Zurenborgbrug,2023-01-31,06:00:00,0,0,0,FMN 06 B Zurenborgbrug Ringfietspad
655,Ringfietspad Zurenborgbrug,2023-01-31,07:00:00,0,0,0,FMN 06 B Zurenborgbrug Ringfietspad
655,Ringfietspad Zurenborgbrug,2023-01-31,08:00:00,0,0,0,FMN 06 B Zurenborgbrug Ringfietspad
655,Ringfietspad Zurenborgbrug,2023-01-31,09:00:00,107,65,42,FMN 06 B Zurenborgbrug Ringfietspad
655,Ringfietspad Zurenborgbrug,2023-01-31,10:00:00,77,36,41,FMN 06 B Zurenborgbrug Ringfietspad
655,Ringfietspad Zurenborgbrug,2023-01-31,11:00:00,61,27,34,FMN 06 B Zurenborgbrug Ringfietspad
655,Ringfietspad Zurenborgbrug,2023-01-31,12:00:00,122,64,58,FMN 06 B Zurenborgbrug Ringfietspad
655,Ringfietspad Zurenborgbrug,2023-01-31,13:00:00,123,55,68,FMN 06 B Zurenborgbrug Ringfietspad
655,Ringfietspad Zurenborgbrug,2023-01-31,14:00:00,67,33,34,FMN 06 B Zurenborgbrug Ringfietspad
655,Ringfietspad Zurenborgbrug,2023-01-31,15:00:00,210,77,133,FMN 06 B Zurenborgbrug Ringfietspad
655,Ringfietspad Zurenborgbrug,2023-01-31,16:00:00,391,154,237,FMN 06 B Zurenborgbrug Ringfietspad
655,Ringfietspad Zurenborgbrug,2023-01-31,17:00:00,399,153,246,FMN 06 B Zurenborgbrug Ringfietspad
655,Ringfietspad Zurenborgbrug,2023-01-31,18:00:00,241,95,146,FMN 06 B Zurenborgbrug Ringfietspad
655,Ringfietspad Zurenborgbrug,2023-01-31,19:00:00,116,36,80,FMN 06 B Zurenborgbrug Ringfietspad
655,Ringfietspad Zurenborgbrug,2023-01-31,20:00:00,56,18,38,FMN 06 B Zurenborgbrug Ringfietspad
655,Ringfietspad Zurenborgbrug,2023-01-31,21:00:00,63,23,40,FMN 06 B Zurenborgbrug Ringfietspad
655,Ringfietspad Zurenborgbrug,2023-01-31,22:00:00,69,26,43,FMN 06 B Zurenborgbrug Ringfietspad
655,Ringfietspad Zurenborgbrug,2023-01-31,23:00:00,28,13,15,FMN 06 B Zurenborgbrug Ringfietspad
655,Ringfietspad Zurenborgbrug,2023-02-01,00:00:00,14,8,6,FMN 06 B Zurenborgbrug Ringfietspad
655,Ringfietspad Zurenborgbrug,2023-02-01,01:00:00,3,2,1,FMN 06 B Zurenborgbrug Ringfietspad
655,Ringfietspad Zurenborgbrug,2023-02-01,02:00:00,0,0,0,FMN 06 B Zurenborgbrug Ringfietspad
655,Ringfietspad Zurenborgbrug,2023-02-01,03:00:00,0,0,0,FMN 06 B Zurenborgbrug Ringfietspad
655,Ringfietspad Zurenborgbrug,2023-02-01,04:00:00,0,0,0,FMN 06 B Zurenborgbrug Ringfietspad
655,Ringfietspad Zurenborgbrug,2023-02-01,05:00:00,0,0,0,FMN 06 B Zurenborgbrug Ringfietspad
655,Ringfietspad Zurenborgbrug,2023-02-01,06:00:00,0,0,0,FMN 06 B Zurenborgbrug Ringfietspad
655,Ringfietspad Zurenborgbrug,2023-02-01,07:00:00,0,0,0,FMN 06 B Zurenborgbrug Ringfietspad
655,Ringfietspad Zurenborgbrug,2023-02-01,08:00:00,98,52,46,FMN 06 B Zurenborgbrug Ringfietspad
655,Ringfietspad Zurenborgbrug,2023-02-01,09:00:00,114,68,46,FMN 06 B Zurenborgbrug Ringfietspad
655,Ringfietspad Zurenborgbrug,2023-02-01,10:00:00,61,30,31,FMN 06 B Zurenborgbrug Ringfietspad
655,Ringfietspad Zurenborgbrug,2023-02-01,11:00:00,91,47,44,FMN 06 B Zurenborgbrug Ringfietspad
655,Ringfietspad Zurenborgbrug,2023-02-01,12:00:00,248,122,126,FMN 06 B Zurenborgbrug Ringfietspad
655,Ringfietspad Zurenborgbrug,2023-02-01,13:00:00,157,67,90,FMN 06 B Zurenborgbrug Ringfietspad
655,Ringfietspad Zurenborgbrug,2023-02-01,14:00:00,131,52,79,FMN 06 B Zurenborgbrug Ringfietspad
655,Ringfietspad Zurenborgbrug,2023-02-01,15:00:00,176,67,109,FMN 06 B Zurenborgbrug Ringfietspad
655,Ringfietspad Zurenborgbrug,2023-02-01,16:00:00,255,94,161,FMN 06 B Zurenborgbrug Ringfietspad
655,Ringfietspad Zurenborgbrug,2023-02-01,17:00:00,343,125,218,FMN 06 B Zurenborgbrug Ringfietspad
655,Ringfietspad Zurenborgbrug,2023-02-01,18:00:00,180,84,96,FMN 06 B Zurenborgbrug Ringfietspad
655,Ringfietspad Zurenborgbrug,2023-02-01,19:00:00,106,44,62,FMN 06 B Zurenborgbrug Ringfietspad
655,Ringfietspad Zurenborgbrug,2023-02-01,20:00:00,61,17,44,FMN 06 B Zurenborgbrug Ringfietspad
655,Ringfietspad Zurenborgbrug,2023-02-01,21:00:00,69,33,36,FMN 06 B Zurenborgbrug Ringfietspad
655,Ringfietspad Zurenborgbrug,2023-02-01,22:00:00,80,29,51,FMN 06 B Zurenborgbrug Ringfietspad
655,Ringfietspad Zurenborgbrug,2023-02-01,23:00:00,28,10,18,FMN 06 B Zurenborgbrug Ringfietspad
655,Ringfietspad Zurenborgbrug,2023-02-02,00:00:00,12,6,6,FMN 06 B Zurenborgbrug Ringfietspad
655,Ringfietspad Zurenborgbrug,2023-02-02,01:00:00,6,3,3,FMN 06 B Zurenborgbrug Ringfietspad
655,Ringfietspad Zurenborgbrug,2023-02-02,02:00:00,0,0,0,FMN 06 B Zurenborgbrug Ringfietspad
655,Ringfietspad Zurenborgbrug,2023-02-02,03:00:00,0,0,0,FMN 06 B Zurenborgbrug Ringfietspad
655,Ringfietspad Zurenborgbrug,2023-02-02,04:00:00,0,0,0,FMN 06 B Zurenborgbrug Ringfietspad
655,Ringfietspad Zurenborgbrug,2023-02-02,05:00:00,0,0,0,FMN 06 B Zurenborgbrug Ringfietspad
655,Ringfietspad Zurenborgbrug,2023-02-02,06:00:00,0,0,0,FMN 06 B Zurenborgbrug Ringfietspad
655,Ringfietspad Zurenborgbrug,2023-02-02,07:00:00,0,0,0,FMN 06 B Zurenborgbrug Ringfietspad
655,Ringfietspad Zurenborgbrug,2023-02-02,08:00:00,0,0,0,FMN 06 B Zurenborgbrug Ringfietspad
655,Ringfietspad Zurenborgbrug,2023-02-02,09:00:00,1,1,0,FMN 06 B Zurenborgbrug Ringfietspad
655,Ringfietspad Zurenborgbrug,2023-02-02,10:00:00,0,0,0,FMN 06 B Zurenborgbrug Ringfietspad
655,Ringfietspad Zurenborgbrug,2023-02-02,11:00:00,0,0,0,FMN 06 B Zurenborgbrug Ringfietspad
655,Ringfietspad Zurenborgbrug,2023-02-02,12:00:00,0,0,0,FMN 06 B Zurenborgbrug Ringfietspad
655,Ringfietspad Zurenborgbrug,2023-02-02,13:00:00,79,41,38,FMN 06 B Zurenborgbrug Ringfietspad
655,Ringfietspad Zurenborgbrug,2023-02-02,14:00:00,101,35,66,FMN 06 B Zurenborgbrug Ringfietspad
655,Ringfietspad Zurenborgbrug,2023-02-02,15:00:00,214,60,154,FMN 06 B Zurenborgbrug Ringfietspad
655,Ringfietspad Zurenborgbrug,2023-02-02,16:00:00,357,145,212,FMN 06 B Zurenborgbrug Ringfietspad
655,Ringfietspad Zurenborgbrug,2023-02-02,17:00:00,389,143,246,FMN 06 B Zurenborgbrug Ringfietspad
655,Ringfietspad Zurenborgbrug,2023-02-02,18:00:00,223,91,132,FMN 06 B Zurenborgbrug Ringfietspad
655,Ringfietspad Zurenborgbrug,2023-02-02,19:00:00,101,33,68,FMN 06 B Zurenborgbrug Ringfietspad
655,Ringfietspad Zurenborgbrug,2023-02-02,20:00:00,78,30,48,FMN 06 B Zurenborgbrug Ringfietspad
655,Ringfietspad Zurenborgbrug,2023-02-02,21:00:00,66,19,47,FMN 06 B Zurenborgbrug Ringfietspad
655,Ringfietspad Zurenborgbrug,2023-02-02,22:00:00,52,23,29,FMN 06 B Zurenborgbrug Ringfietspad
655,Ringfietspad Zurenborgbrug,2023-02-02,23:00:00,40,16,24,FMN 06 B Zurenborgbrug Ringfietspad
655,Ringfietspad Zurenborgbrug,2023-02-03,00:00:00,16,11,5,FMN 06 B Zurenborgbrug Ringfietspad
655,Ringfietspad Zurenborgbrug,2023-02-03,01:00:00,7,1,6,FMN 06 B Zurenborgbrug Ringfietspad
655,Ringfietspad Zurenborgbrug,2023-02-03,02:00:00,0,0,0,FMN 06 B Zurenborgbrug Ringfietspad
655,Ringfietspad Zurenborgbrug,2023-02-03,03:00:00,0,0,0,FMN 06 B Zurenborgbrug Ringfietspad
655,Ringfietspad Zurenborgbrug,2023-02-03,04:00:00,0,0,0,FMN 06 B Zurenborgbrug Ringfietspad
655,Ringfietspad Zurenborgbrug,2023-02-03,05:00:00,0,0,0,FMN 06 B Zurenborgbrug Ringfietspad
655,Ringfietspad Zurenborgbrug,2023-02-03,06:00:00,0,0,0,FMN 06 B Zurenborgbrug Ringfietspad
655,Ringfietspad Zurenborgbrug,2023-02-03,07:00:00,0,0,0,FMN 06 B Zurenborgbrug Ringfietspad
655,Ringfietspad Zurenborgbrug,2023-02-03,08:00:00,0,0,0,FMN 06 B Zurenborgbrug Ringfietspad
655,Ringfietspad Zurenborgbrug,2023-02-03,09:00:00,54,25,29,FMN 06 B Zurenborgbrug Ringfietspad
655,Ringfietspad Zurenborgbrug,2023-02-03,10:00:00,69,37,32,FMN 06 B Zurenborgbrug Ringfietspad
655,Ringfietspad Zurenborgbrug,2023-02-03,11:00:00,80,42,38,FMN 06 B Zurenborgbrug Ringfietspad
655,Ringfietspad Zurenborgbrug,2023-02-03,12:00:00,127,58,69,FMN 06 B Zurenborgbrug Ringfietspad
655,Ringfietspad Zurenborgbrug,2023-02-03,13:00:00,118,54,64,FMN 06 B Zurenborgbrug Ringfietspad
655,Ringfietspad Zurenborgbrug,2023-02-03,14:00:00,137,57,80,FMN 06 B Zurenborgbrug Ringfietspad
655,Ringfietspad Zurenborgbrug,2023-02-03,15:00:00,190,71,119,FMN 06 B Zurenborgbrug Ringfietspad
655,Ringfietspad Zurenborgbrug,2023-02-03,16:00:00,294,124,170,FMN 06 B Zurenborgbrug Ringfietspad
655,Ringfietspad Zurenborgbrug,2023-02-03,17:00:00,316,131,185,FMN 06 B Zurenborgbrug Ringfietspad
655,Ringfietspad Zurenborgbrug,2023-02-03,18:00:00,158,62,96,FMN 06 B Zurenborgbrug Ringfietspad
655,Ringfietspad Zurenborgbrug,2023-02-03,19:00:00,103,40,63,FMN 06 B Zurenborgbrug Ringfietspad
655,Ringfietspad Zurenborgbrug,2023-02-03,20:00:00,89,41,48,FMN 06 B Zurenborgbrug Ringfietspad
655,Ringfietspad Zurenborgbrug,2023-02-03,21:00:00,53,12,41,FMN 06 B Zurenborgbrug Ringfietspad
655,Ringfietspad Zurenborgbrug,2023-02-03,22:00:00,50,14,36,FMN 06 B Zurenborgbrug Ringfietspad
655,Ringfietspad Zurenborgbrug,2023-02-03,23:00:00,57,36,21,FMN 06 B Zurenborgbrug Ringfietspad
655,Ringfietspad Zurenborgbrug,2023-02-04,00:00:00,24,11,13,FMN 06 B Zurenborgbrug Ringfietspad
655,Ringfietspad Zurenborgbrug,2023-02-04,01:00:00,18,4,14,FMN 06 B Zurenborgbrug Ringfietspad
655,Ringfietspad Zurenborgbrug,2023-02-04,02:00:00,0,0,0,FMN 06 B Zurenborgbrug Ringfietspad
655,Ringfietspad Zurenborgbrug,2023-02-04,03:00:00,0,0,0,FMN 06 B Zurenborgbrug Ringfietspad
655,Ringfietspad Zurenborgbrug,2023-02-04,04:00:00,0,0,0,FMN 06 B Zurenborgbrug Ringfietspad
655,Ringfietspad Zurenborgbrug,2023-02-04,05:00:00,0,0,0,FMN 06 B Zurenborgbrug Ringfietspad
655,Ringfietspad Zurenborgbrug,2023-02-04,06:00:00,0,0,0,FMN 06 B Zurenborgbrug Ringfietspad
655,Ringfietspad Zurenborgbrug,2023-02-04,07:00:00,0,0,0,FMN 06 B Zurenborgbrug Ringfietspad
655,Ringfietspad Zurenborgbrug,2023-02-04,08:00:00,0,0,0,FMN 06 B Zurenborgbrug Ringfietspad
655,Ringfietspad Zurenborgbrug,2023-02-04,09:00:00,0,0,0,FMN 06 B Zurenborgbrug Ringfietspad
655,Ringfietspad Zurenborgbrug,2023-02-04,10:00:00,19,11,8,FMN 06 B Zurenborgbrug Ringfietspad
655,Ringfietspad Zurenborgbrug,2023-02-04,11:00:00,61,35,26,FMN 06 B Zurenborgbrug Ringfietspad
655,Ringfietspad Zurenborgbrug,2023-02-04,12:00:00,87,43,44,FMN 06 B Zurenborgbrug Ringfietspad
655,Ringfietspad Zurenborgbrug,2023-02-04,13:00:00,97,47,50,FMN 06 B Zurenborgbrug Ringfietspad
655,Ringfietspad Zurenborgbrug,2023-02-04,14:00:00,81,34,47,FMN 06 B Zurenborgbrug Ringfietspad
655,Ringfietspad Zurenborgbrug,2023-02-04,15:00:00,85,32,53,FMN 06 B Zurenborgbrug Ringfietspad
655,Ringfietspad Zurenborgbrug,2023-02-04,16:00:00,97,43,54,FMN 06 B Zurenborgbrug Ringfietspad
655,Ringfietspad Zurenborgbrug,2023-02-04,17:00:00,78,38,40,FMN 06 B Zurenborgbrug Ringfietspad
655,Ringfietspad Zurenborgbrug,2023-02-04,18:00:00,76,43,33,FMN 06 B Zurenborgbrug Ringfietspad
655,Ringfietspad Zurenborgbrug,2023-02-04,19:00:00,61,35,26,FMN 06 B Zurenborgbrug Ringfietspad
655,Ringfietspad Zurenborgbrug,2023-02-04,20:00:00,46,22,24,FMN 06 B Zurenborgbrug Ringfietspad
655,Ringfietspad Zurenborgbrug,2023-02-04,21:00:00,35,17,18,FMN 06 B Zurenborgbrug Ringfietspad
655,Ringfietspad Zurenborgbrug,2023-02-04,22:00:00,37,15,22,FMN 06 B Zurenborgbrug Ringfietspad
655,Ringfietspad Zurenborgbrug,2023-02-04,23:00:00,29,12,17,FMN 06 B Zurenborgbrug Ringfietspad
655,Ringfietspad Zurenborgbrug,2023-02-05,00:00:00,31,11,20,FMN 06 B Zurenborgbrug Ringfietspad
655,Ringfietspad Zurenborgbrug,2023-02-05,01:00:00,21,6,15,FMN 06 B Zurenborgbrug Ringfietspad
655,Ringfietspad Zurenborgbrug,2023-02-05,02:00:00,0,0,0,FMN 06 B Zurenborgbrug Ringfietspad
655,Ringfietspad Zurenborgbrug,2023-02-05,03:00:00,0,0,0,FMN 06 B Zurenborgbrug Ringfietspad
655,Ringfietspad Zurenborgbrug,2023-02-05,04:00:00,0,0,0,FMN 06 B Zurenborgbrug Ringfietspad
655,Ringfietspad Zurenborgbrug,2023-02-05,05:00:00,0,0,0,FMN 06 B Zurenborgbrug Ringfietspad
655,Ringfietspad Zurenborgbrug,2023-02-05,06:00:00,0,0,0,FMN 06 B Zurenborgbrug Ringfietspad
655,Ringfietspad Zurenborgbrug,2023-02-05,07:00:00,0,0,0,FMN 06 B Zurenborgbrug Ringfietspad
655,Ringfietspad Zurenborgbrug,2023-02-05,08:00:00,0,0,0,FMN 06 B Zurenborgbrug Ringfietspad
655,Ringfietspad Zurenborgbrug,2023-02-05,09:00:00,41,15,26,FMN 06 B Zurenborgbrug Ringfietspad
655,Ringfietspad Zurenborgbrug,2023-02-05,10:00:00,91,16,75,FMN 06 B Zurenborgbrug Ringfietspad
655,Ringfietspad Zurenborgbrug,2023-02-05,11:00:00,99,33,66,FMN 06 B Zurenborgbrug Ringfietspad
655,Ringfietspad Zurenborgbrug,2023-02-05,12:00:00,169,45,124,FMN 06 B Zurenborgbrug Ringfietspad
655,Ringfietspad Zurenborgbrug,2023-02-05,13:00:00,126,69,57,FMN 06 B Zurenborgbrug Ringfietspad
655,Ringfietspad Zurenborgbrug,2023-02-05,14:00:00,97,42,55,FMN 06 B Zurenborgbrug Ringfietspad
655,Ringfietspad Zurenborgbrug,2023-02-05,15:00:00,115,72,43,FMN 06 B Zurenborgbrug Ringfietspad
655,Ringfietspad Zurenborgbrug,2023-02-05,16:00:00,125,81,44,FMN 06 B Zurenborgbrug Ringfietspad
655,Ringfietspad Zurenborgbrug,2023-02-05,17:00:00,99,59,40,FMN 06 B Zurenborgbrug Ringfietspad
655,Ringfietspad Zurenborgbrug,2023-02-05,18:00:00,74,35,39,FMN 06 B Zurenborgbrug Ringfietspad
655,Ringfietspad Zurenborgbrug,2023-02-05,19:00:00,67,22,45,FMN 06 B Zurenborgbrug Ringfietspad
655,Ringfietspad Zurenborgbrug,2023-02-05,20:00:00,32,11,21,FMN 06 B Zurenborgbrug Ringfietspad
655,Ringfietspad Zurenborgbrug,2023-02-05,21:00:00,42,21,21,FMN 06 B Zurenborgbrug Ringfietspad
655,Ringfietspad Zurenborgbrug,2023-02-05,22:00:00,30,19,11,FMN 06 B Zurenborgbrug Ringfietspad
655,Ringfietspad Zurenborgbrug,2023-02-05,23:00:00,21,6,15,FMN 06 B Zurenborgbrug Ringfietspad
655,Ringfietspad Zurenborgbrug,2023-02-06,00:00:00,4,1,3,FMN 06 B Zurenborgbrug Ringfietspad
655,Ringfietspad Zurenborgbrug,2023-02-06,01:00:00,3,2,1,FMN 06 B Zurenborgbrug Ringfietspad
655,Ringfietspad Zurenborgbrug,2023-02-06,02:00:00,0,0,0,FMN 06 B Zurenborgbrug Ringfietspad
655,Ringfietspad Zurenborgbrug,2023-02-06,03:00:00,0,0,0,FMN 06 B Zurenborgbrug Ringfietspad
655,Ringfietspad Zurenborgbrug,2023-02-06,04:00:00,0,0,0,FMN 06 B Zurenborgbrug Ringfietspad
655,Ringfietspad Zurenborgbrug,2023-02-06,05:00:00,0,0,0,FMN 06 B Zurenborgbrug Ringfietspad
655,Ringfietspad Zurenborgbrug,2023-02-06,06:00:00,0,0,0,FMN 06 B Zurenborgbrug Ringfietspad
655,Ringfietspad Zurenborgbrug,2023-02-06,07:00:00,0,0,0,FMN 06 B Zurenborgbrug Ringfietspad
655,Ringfietspad Zurenborgbrug,2023-02-06,08:00:00,219,112,107,FMN 06 B Zurenborgbrug Ringfietspad
655,Ringfietspad Zurenborgbrug,2023-02-06,09:00:00,144,75,69,FMN 06 B Zurenborgbrug Ringfietspad
655,Ringfietspad Zurenborgbrug,2023-02-06,10:00:00,72,42,30,FMN 06 B Zurenborgbrug Ringfietspad
655,Ringfietspad Zurenborgbrug,2023-02-06,11:00:00,94,38,56,FMN 06 B Zurenborgbrug Ringfietspad
655,Ringfietspad Zurenborgbrug,2023-02-06,12:00:00,144,74,70,FMN 06 B Zurenborgbrug Ringfietspad
655,Ringfietspad Zurenborgbrug,2023-02-06,13:00:00,118,52,66,FMN 06 B Zurenborgbrug Ringfietspad
655,Ringfietspad Zurenborgbrug,2023-02-06,14:00:00,136,61,75,FMN 06 B Zurenborgbrug Ringfietspad
655,Ringfietspad Zurenborgbrug,2023-02-06,15:00:00,259,112,147,FMN 06 B Zurenborgbrug Ringfietspad
655,Ringfietspad Zurenborgbrug,2023-02-06,16:00:00,419,173,246,FMN 06 B Zurenborgbrug Ringfietspad
655,Ringfietspad Zurenborgbrug,2023-02-06,17:00:00,429,170,259,FMN 06 B Zurenborgbrug Ringfietspad
655,Ringfietspad Zurenborgbrug,2023-02-06,18:00:00,237,105,132,FMN 06 B Zurenborgbrug Ringfietspad
655,Ringfietspad Zurenborgbrug,2023-02-06,19:00:00,103,38,65,FMN 06 B Zurenborgbrug Ringfietspad
655,Ringfietspad Zurenborgbrug,2023-02-06,20:00:00,70,27,43,FMN 06 B Zurenborgbrug Ringfietspad
655,Ringfietspad Zurenborgbrug,2023-02-06,21:00:00,74,17,57,FMN 06 B Zurenborgbrug Ringfietspad
655,Ringfietspad Zurenborgbrug,2023-02-06,22:00:00,62,21,41,FMN 06 B Zurenborgbrug Ringfietspad
655,Ringfietspad Zurenborgbrug,2023-02-06,23:00:00,16,7,9,FMN 06 B Zurenborgbrug Ringfietspad
655,Ringfietspad Zurenborgbrug,2023-02-07,00:00:00,8,5,3,FMN 06 B Zurenborgbrug Ringfietspad
655,Ringfietspad Zurenborgbrug,2023-02-07,01:00:00,3,1,2,FMN 06 B Zurenborgbrug Ringfietspad
655,Ringfietspad Zurenborgbrug,2023-02-07,02:00:00,2,1,1,FMN 06 B Zurenborgbrug Ringfietspad
655,Ringfietspad Zurenborgbrug,2023-02-07,03:00:00,2,2,0,FMN 06 B Zurenborgbrug Ringfietspad
655,Ringfietspad Zurenborgbrug,2023-02-07,04:00:00,16,12,4,FMN 06 B Zurenborgbrug Ringfietspad
655,Ringfietspad Zurenborgbrug,2023-02-07,05:00:00,48,29,19,FMN 06 B Zurenborgbrug Ringfietspad
655,Ringfietspad Zurenborgbrug,2023-02-07,06:00:00,106,64,42,FMN 06 B Zurenborgbrug Ringfietspad
655,Ringfietspad Zurenborgbrug,2023-02-07,07:00:00,341,190,151,FMN 06 B Zurenborgbrug Ringfietspad
655,Ringfietspad Zurenborgbrug,2023-02-07,08:00:00,542,287,255,FMN 06 B Zurenborgbrug Ringfietspad
655,Ringfietspad Zurenborgbrug,2023-02-07,09:00:00,144,80,64,FMN 06 B Zurenborgbrug Ringfietspad
655,Ringfietspad Zurenborgbrug,2023-02-07,10:00:00,82,40,42,FMN 06 B Zurenborgbrug Ringfietspad
655,Ringfietspad Zurenborgbrug,2023-02-07,11:00:00,63,34,29,FMN 06 B Zurenborgbrug Ringfietspad
655,Ringfietspad Zurenborgbrug,2023-02-07,12:00:00,141,72,69,FMN 06 B Zurenborgbrug Ringfietspad
655,Ringfietspad Zurenborgbrug,2023-02-07,13:00:00,131,61,70,FMN 06 B Zurenborgbrug Ringfietspad
655,Ringfietspad Zurenborgbrug,2023-02-07,14:00:00,119,44,75,FMN 06 B Zurenborgbrug Ringfietspad
655,Ringfietspad Zurenborgbrug,2023-02-07,15:00:00,221,90,131,FMN 06 B Zurenborgbrug Ringfietspad
655,Ringfietspad Zurenborgbrug,2023-02-07,16:00:00,487,194,293,FMN 06 B Zurenborgbrug Ringfietspad
655,Ringfietspad Zurenborgbrug,2023-02-07,17:00:00,483,194,289,FMN 06 B Zurenborgbrug Ringfietspad
655,Ringfietspad Zurenborgbrug,2023-02-07,18:00:00,251,102,149,FMN 06 B Zurenborgbrug Ringfietspad
655,Ringfietspad Zurenborgbrug,2023-02-07,19:00:00,129,52,77,FMN 06 B Zurenborgbrug Ringfietspad
655,Ringfietspad Zurenborgbrug,2023-02-07,20:00:00,70,39,31,FMN 06 B Zurenborgbrug Ringfietspad
655,Ringfietspad Zurenborgbrug,2023-02-07,21:00:00,61,23,38,FMN 06 B Zurenborgbrug Ringfietspad
655,Ringfietspad Zurenborgbrug,2023-02-07,22:00:00,60,21,39,FMN 06 B Zurenborgbrug Ringfietspad
655,Ringfietspad Zurenborgbrug,2023-02-07,23:00:00,35,14,21,FMN 06 B Zurenborgbrug Ringfietspad
655,Ringfietspad Zurenborgbrug,2023-02-08,00:00:00,8,4,4,FMN 06 B Zurenborgbrug Ringfietspad
655,Ringfietspad Zurenborgbrug,2023-02-08,01:00:00,3,0,3,FMN 06 B Zurenborgbrug Ringfietspad
655,Ringfietspad Zurenborgbrug,2023-02-08,02:00:00,4,3,1,FMN 06 B Zurenborgbrug Ringfietspad
655,Ringfietspad Zurenborgbrug,2023-02-08,03:00:00,1,0,1,FMN 06 B Zurenborgbrug Ringfietspad
655,Ringfietspad Zurenborgbrug,2023-02-08,04:00:00,19,10,9,FMN 06 B Zurenborgbrug Ringfietspad
655,Ringfietspad Zurenborgbrug,2023-02-08,05:00:00,42,27,15,FMN 06 B Zurenborgbrug Ringfietspad
655,Ringfietspad Zurenborgbrug,2023-02-08,06:00:00,102,55,47,FMN 06 B Zurenborgbrug Ringfietspad
655,Ringfietspad Zurenborgbrug,2023-02-08,07:00:00,268,148,120,FMN 06 B Zurenborgbrug Ringfietspad
655,Ringfietspad Zurenborgbrug,2023-02-08,08:00:00,416,203,213,FMN 06 B Zurenborgbrug Ringfietspad
655,Ringfietspad Zurenborgbrug,2023-02-08,09:00:00,138,71,67,FMN 06 B Zurenborgbrug Ringfietspad
655,Ringfietspad Zurenborgbrug,2023-02-08,10:00:00,77,35,42,FMN 06 B Zurenborgbrug Ringfietspad
655,Ringfietspad Zurenborgbrug,2023-02-08,11:00:00,85,38,47,FMN 06 B Zurenborgbrug Ringfietspad
655,Ringfietspad Zurenborgbrug,2023-02-08,12:00:00,282,137,145,FMN 06 B Zurenborgbrug Ringfietspad
655,Ringfietspad Zurenborgbrug,2023-02-08,13:00:00,173,70,103,FMN 06 B Zurenborgbrug Ringfietspad
655,Ringfietspad Zurenborgbrug,2023-02-08,14:00:00,139,68,71,FMN 06 B Zurenborgbrug Ringfietspad
655,Ringfietspad Zurenborgbrug,2023-02-08,15:00:00,180,64,116,FMN 06 B Zurenborgbrug Ringfietspad
655,Ringfietspad Zurenborgbrug,2023-02-08,16:00:00,284,114,170,FMN 06 B Zurenborgbrug Ringfietspad
655,Ringfietspad Zurenborgbrug,2023-02-08,17:00:00,335,136,199,FMN 06 B Zurenborgbrug Ringfietspad
655,Ringfietspad Zurenborgbrug,2023-02-08,18:00:00,247,105,142,FMN 06 B Zurenborgbrug Ringfietspad
655,Ringfietspad Zurenborgbrug,2023-02-08,19:00:00,106,42,64,FMN 06 B Zurenborgbrug Ringfietspad
655,Ringfietspad Zurenborgbrug,2023-02-08,20:00:00,68,25,43,FMN 06 B Zurenborgbrug Ringfietspad
655,Ringfietspad Zurenborgbrug,2023-02-08,21:00:00,69,28,41,FMN 06 B Zurenborgbrug Ringfietspad
655,Ringfietspad Zurenborgbrug,2023-02-08,22:00:00,57,15,42,FMN 06 B Zurenborgbrug Ringfietspad
655,Ringfietspad Zurenborgbrug,2023-02-08,23:00:00,18,10,8,FMN 06 B Zurenborgbrug Ringfietspad
655,Ringfietspad Zurenborgbrug,2023-02-09,00:00:00,7,3,4,FMN 06 B Zurenborgbrug Ringfietspad
655,Ringfietspad Zurenborgbrug,2023-02-09,01:00:00,8,2,6,FMN 06 B Zurenborgbrug Ringfietspad
655,Ringfietspad Zurenborgbrug,2023-02-09,02:00:00,4,3,1,FMN 06 B Zurenborgbrug Ringfietspad
655,Ringfietspad Zurenborgbrug,2023-02-09,03:00:00,2,0,2,FMN 06 B Zurenborgbrug Ringfietspad
655,Ringfietspad Zurenborgbrug,2023-02-09,04:00:00,19,13,6,FMN 06 B Zurenborgbrug Ringfietspad
655,Ringfietspad Zurenborgbrug,2023-02-09,05:00:00,42,24,18,FMN 06 B Zurenborgbrug Ringfietspad
655,Ringfietspad Zurenborgbrug,2023-02-09,06:00:00,94,50,44,FMN 06 B Zurenborgbrug Ringfietspad
655,Ringfietspad Zurenborgbrug,2023-02-09,07:00:00,327,191,136,FMN 06 B Zurenborgbrug Ringfietspad
655,Ringfietspad Zurenborgbrug,2023-02-09,08:00:00,511,265,246,FMN 06 B Zurenborgbrug Ringfietspad
655,Ringfietspad Zurenborgbrug,2023-02-09,09:00:00,144,76,68,FMN 06 B Zurenborgbrug Ringfietspad
655,Ringfietspad Zurenborgbrug,2023-02-09,10:00:00,72,37,35,FMN 06 B Zurenborgbrug Ringfietspad
655,Ringfietspad Zurenborgbrug,2023-02-09,11:00:00,67,33,34,FMN 06 B Zurenborgbrug Ringfietspad
655,Ringfietspad Zurenborgbrug,2023-02-09,12:00:00,148,58,90,FMN 06 B Zurenborgbrug Ringfietspad
655,Ringfietspad Zurenborgbrug,2023-02-09,13:00:00,111,52,59,FMN 06 B Zurenborgbrug Ringfietspad
655,Ringfietspad Zurenborgbrug,2023-02-09,14:00:00,129,44,85,FMN 06 B Zurenborgbrug Ringfietspad
655,Ringfietspad Zurenborgbrug,2023-02-09,15:00:00,241,101,140,FMN 06 B Zurenborgbrug Ringfietspad
655,Ringfietspad Zurenborgbrug,2023-02-09,16:00:00,409,157,252,FMN 06 B Zurenborgbrug Ringfietspad
655,Ringfietspad Zurenborgbrug,2023-02-09,17:00:00,444,161,283,FMN 06 B Zurenborgbrug Ringfietspad
655,Ringfietspad Zurenborgbrug,2023-02-09,18:00:00,225,79,146,FMN 06 B Zurenborgbrug Ringfietspad
655,Ringfietspad Zurenborgbrug,2023-02-09,19:00:00,120,39,81,FMN 06 B Zurenborgbrug Ringfietspad
655,Ringfietspad Zurenborgbrug,2023-02-09,20:00:00,100,50,50,FMN 06 B Zurenborgbrug Ringfietspad
655,Ringfietspad Zurenborgbrug,2023-02-09,21:00:00,74,26,48,FMN 06 B Zurenborgbrug Ringfietspad
655,Ringfietspad Zurenborgbrug,2023-02-09,22:00:00,74,41,33,FMN 06 B Zurenborgbrug Ringfietspad
655,Ringfietspad Zurenborgbrug,2023-02-09,23:00:00,28,13,15,FMN 06 B Zurenborgbrug Ringfietspad
655,Ringfietspad Zurenborgbrug,2023-02-10,00:00:00,22,18,4,FMN 06 B Zurenborgbrug Ringfietspad
655,Ringfietspad Zurenborgbrug,2023-02-10,01:00:00,6,2,4,FMN 06 B Zurenborgbrug Ringfietspad
655,Ringfietspad Zurenborgbrug,2023-02-10,02:00:00,1,0,1,FMN 06 B Zurenborgbrug Ringfietspad
655,Ringfietspad Zurenborgbrug,2023-02-10,03:00:00,2,1,1,FMN 06 B Zurenborgbrug Ringfietspad
655,Ringfietspad Zurenborgbrug,2023-02-10,04:00:00,14,10,4,FMN 06 B Zurenborgbrug Ringfietspad
655,Ringfietspad Zurenborgbrug,2023-02-10,05:00:00,30,14,16,FMN 06 B Zurenborgbrug Ringfietspad
655,Ringfietspad Zurenborgbrug,2023-02-10,06:00:00,84,49,35,FMN 06 B Zurenborgbrug Ringfietspad
655,Ringfietspad Zurenborgbrug,2023-02-10,07:00:00,276,144,132,FMN 06 B Zurenborgbrug Ringfietspad
655,Ringfietspad Zurenborgbrug,2023-02-10,08:00:00,422,213,209,FMN 06 B Zurenborgbrug Ringfietspad
655,Ringfietspad Zurenborgbrug,2023-02-10,09:00:00,117,66,51,FMN 06 B Zurenborgbrug Ringfietspad
655,Ringfietspad Zurenborgbrug,2023-02-10,10:00:00,70,39,31,FMN 06 B Zurenborgbrug Ringfietspad
655,Ringfietspad Zurenborgbrug,2023-02-10,11:00:00,92,37,55,FMN 06 B Zurenborgbrug Ringfietspad
655,Ringfietspad Zurenborgbrug,2023-02-10,12:00:00,110,52,58,FMN 06 B Zurenborgbrug Ringfietspad
655,Ringfietspad Zurenborgbrug,2023-02-10,13:00:00,122,57,65,FMN 06 B Zurenborgbrug Ringfietspad
655,Ringfietspad Zurenborgbrug,2023-02-10,14:00:00,129,51,78,FMN 06 B Zurenborgbrug Ringfietspad
655,Ringfietspad Zurenborgbrug,2023-02-10,15:00:00,195,65,130,FMN 06 B Zurenborgbrug Ringfietspad
655,Ringfietspad Zurenborgbrug,2023-02-10,16:00:00,355,170,185,FMN 06 B Zurenborgbrug Ringfietspad
655,Ringfietspad Zurenborgbrug,2023-02-10,17:00:00,289,129,160,FMN 06 B Zurenborgbrug Ringfietspad
655,Ringfietspad Zurenborgbrug,2023-02-10,18:00:00,181,73,108,FMN 06 B Zurenborgbrug Ringfietspad
655,Ringfietspad Zurenborgbrug,2023-02-10,19:00:00,113,48,65,FMN 06 B Zurenborgbrug Ringfietspad
655,Ringfietspad Zurenborgbrug,2023-02-10,20:00:00,87,36,51,FMN 06 B Zurenborgbrug Ringfietspad
655,Ringfietspad Zurenborgbrug,2023-02-10,21:00:00,49,19,30,FMN 06 B Zurenborgbrug Ringfietspad
655,Ringfietspad Zurenborgbrug,2023-02-10,22:00:00,49,17,32,FMN 06 B Zurenborgbrug Ringfietspad
655,Ringfietspad Zurenborgbrug,2023-02-10,23:00:00,34,12,22,FMN 06 B Zurenborgbrug Ringfietspad
655,Ringfietspad Zurenborgbrug,2023-02-11,00:00:00,43,30,13,FMN 06 B Zurenborgbrug Ringfietspad
655,Ringfietspad Zurenborgbrug,2023-02-11,01:00:00,15,9,6,FMN 06 B Zurenborgbrug Ringfietspad
655,Ringfietspad Zurenborgbrug,2023-02-11,02:00:00,15,6,9,FMN 06 B Zurenborgbrug Ringfietspad
655,Ringfietspad Zurenborgbrug,2023-02-11,03:00:00,17,13,4,FMN 06 B Zurenborgbrug Ringfietspad
655,Ringfietspad Zurenborgbrug,2023-02-11,04:00:00,11,9,2,FMN 06 B Zurenborgbrug Ringfietspad
655,Ringfietspad Zurenborgbrug,2023-02-11,05:00:00,14,8,6,FMN 06 B Zurenborgbrug Ringfietspad
655,Ringfietspad Zurenborgbrug,2023-02-11,06:00:00,18,13,5,FMN 06 B Zurenborgbrug Ringfietspad
655,Ringfietspad Zurenborgbrug,2023-02-11,07:00:00,22,10,12,FMN 06 B Zurenborgbrug Ringfietspad
655,Ringfietspad Zurenborgbrug,2023-02-11,08:00:00,60,29,31,FMN 06 B Zurenborgbrug Ringfietspad
655,Ringfietspad Zurenborgbrug,2023-02-11,09:00:00,80,33,47,FMN 06 B Zurenborgbrug Ringfietspad
655,Ringfietspad Zurenborgbrug,2023-02-11,10:00:00,68,30,38,FMN 06 B Zurenborgbrug Ringfietspad
655,Ringfietspad Zurenborgbrug,2023-02-11,11:00:00,132,53,79,FMN 06 B Zurenborgbrug Ringfietspad
655,Ringfietspad Zurenborgbrug,2023-02-11,12:00:00,121,53,68,FMN 06 B Zurenborgbrug Ringfietspad
655,Ringfietspad Zurenborgbrug,2023-02-11,13:00:00,142,63,79,FMN 06 B Zurenborgbrug Ringfietspad
655,Ringfietspad Zurenborgbrug,2023-02-11,14:00:00,143,64,79,FMN 06 B Zurenborgbrug Ringfietspad
655,Ringfietspad Zurenborgbrug,2023-02-11,15:00:00,115,55,60,FMN 06 B Zurenborgbrug Ringfietspad
655,Ringfietspad Zurenborgbrug,2023-02-11,16:00:00,107,53,54,FMN 06 B Zurenborgbrug Ringfietspad
655,Ringfietspad Zurenborgbrug,2023-02-11,17:00:00,132,65,67,FMN 06 B Zurenborgbrug Ringfietspad
655,Ringfietspad Zurenborgbrug,2023-02-11,18:00:00,87,37,50,FMN 06 B Zurenborgbrug Ringfietspad
655,Ringfietspad Zurenborgbrug,2023-02-11,19:00:00,87,31,56,FMN 06 B Zurenborgbrug Ringfietspad
655,Ringfietspad Zurenborgbrug,2023-02-11,20:00:00,53,21,32,FMN 06 B Zurenborgbrug Ringfietspad
655,Ringfietspad Zurenborgbrug,2023-02-11,21:00:00,37,9,28,FMN 06 B Zurenborgbrug Ringfietspad
655,Ringfietspad Zurenborgbrug,2023-02-11,22:00:00,52,27,25,FMN 06 B Zurenborgbrug Ringfietspad
655,Ringfietspad Zurenborgbrug,2023-02-11,23:00:00,21,8,13,FMN 06 B Zurenborgbrug Ringfietspad
655,Ringfietspad Zurenborgbrug,2023-02-12,00:00:00,33,18,15,FMN 06 B Zurenborgbrug Ringfietspad
655,Ringfietspad Zurenborgbrug,2023-02-12,01:00:00,30,18,12,FMN 06 B Zurenborgbrug Ringfietspad
655,Ringfietspad Zurenborgbrug,2023-02-12,02:00:00,18,13,5,FMN 06 B Zurenborgbrug Ringfietspad
655,Ringfietspad Zurenborgbrug,2023-02-12,03:00:00,9,5,4,FMN 06 B Zurenborgbrug Ringfietspad
655,Ringfietspad Zurenborgbrug,2023-02-12,04:00:00,10,9,1,FMN 06 B Zurenborgbrug Ringfietspad
655,Ringfietspad Zurenborgbrug,2023-02-12,05:00:00,9,6,3,FMN 06 B Zurenborgbrug Ringfietspad
655,Ringfietspad Zurenborgbrug,2023-02-12,06:00:00,16,11,5,FMN 06 B Zurenborgbrug Ringfietspad
655,Ringfietspad Zurenborgbrug,2023-02-12,07:00:00,13,6,7,FMN 06 B Zurenborgbrug Ringfietspad
655,Ringfietspad Zurenborgbrug,2023-02-12,08:00:00,52,21,31,FMN 06 B Zurenborgbrug Ringfietspad
655,Ringfietspad Zurenborgbrug,2023-02-12,09:00:00,101,33,68,FMN 06 B Zurenborgbrug Ringfietspad
655,Ringfietspad Zurenborgbrug,2023-02-12,10:00:00,92,53,39,FMN 06 B Zurenborgbrug Ringfietspad
655,Ringfietspad Zurenborgbrug,2023-02-12,11:00:00,122,65,57,FMN 06 B Zurenborgbrug Ringfietspad
655,Ringfietspad Zurenborgbrug,2023-02-12,12:00:00,119,49,70,FMN 06 B Zurenborgbrug Ringfietspad
655,Ringfietspad Zurenborgbrug,2023-02-12,13:00:00,131,64,67,FMN 06 B Zurenborgbrug Ringfietspad
655,Ringfietspad Zurenborgbrug,2023-02-12,14:00:00,92,41,51,FMN 06 B Zurenborgbrug Ringfietspad
655,Ringfietspad Zurenborgbrug,2023-02-12,15:00:00,103,46,57,FMN 06 B Zurenborgbrug Ringfietspad
655,Ringfietspad Zurenborgbrug,2023-02-12,16:00:00,90,49,41,FMN 06 B Zurenborgbrug Ringfietspad
655,Ringfietspad Zurenborgbrug,2023-02-12,17:00:00,80,44,36,FMN 06 B Zurenborgbrug Ringfietspad
655,Ringfietspad Zurenborgbrug,2023-02-12,18:00:00,66,29,37,FMN 06 B Zurenborgbrug Ringfietspad
655,Ringfietspad Zurenborgbrug,2023-02-12,19:00:00,52,24,28,FMN 06 B Zurenborgbrug Ringfietspad
655,Ringfietspad Zurenborgbrug,2023-02-12,20:00:00,37,21,16,FMN 06 B Zurenborgbrug Ringfietspad
655,Ringfietspad Zurenborgbrug,2023-02-12,21:00:00,34,13,21,FMN 06 B Zurenborgbrug Ringfietspad
655,Ringfietspad Zurenborgbrug,2023-02-12,22:00:00,27,13,14,FMN 06 B Zurenborgbrug Ringfietspad
655,Ringfietspad Zurenborgbrug,2023-02-12,23:00:00,17,8,9,FMN 06 B Zurenborgbrug Ringfietspad
655,Ringfietspad Zurenborgbrug,2023-02-13,00:00:00,3,2,1,FMN 06 B Zurenborgbrug Ringfietspad
655,Ringfietspad Zurenborgbrug,2023-02-13,01:00:00,5,3,2,FMN 06 B Zurenborgbrug Ringfietspad
655,Ringfietspad Zurenborgbrug,2023-02-13,02:00:00,4,2,2,FMN 06 B Zurenborgbrug Ringfietspad
655,Ringfietspad Zurenborgbrug,2023-02-13,03:00:00,2,1,1,FMN 06 B Zurenborgbrug Ringfietspad
655,Ringfietspad Zurenborgbrug,2023-02-13,04:00:00,12,8,4,FMN 06 B Zurenborgbrug Ringfietspad
655,Ringfietspad Zurenborgbrug,2023-02-13,05:00:00,50,25,25,FMN 06 B Zurenborgbrug Ringfietspad
655,Ringfietspad Zurenborgbrug,2023-02-13,06:00:00,106,61,45,FMN 06 B Zurenborgbrug Ringfietspad
655,Ringfietspad Zurenborgbrug,2023-02-13,07:00:00,358,206,152,FMN 06 B Zurenborgbrug Ringfietspad
655,Ringfietspad Zurenborgbrug,2023-02-13,08:00:00,525,288,237,FMN 06 B Zurenborgbrug Ringfietspad
655,Ringfietspad Zurenborgbrug,2023-02-13,09:00:00,147,87,60,FMN 06 B Zurenborgbrug Ringfietspad
655,Ringfietspad Zurenborgbrug,2023-02-13,10:00:00,97,57,40,FMN 06 B Zurenborgbrug Ringfietspad
655,Ringfietspad Zurenborgbrug,2023-02-13,11:00:00,89,35,54,FMN 06 B Zurenborgbrug Ringfietspad
655,Ringfietspad Zurenborgbrug,2023-02-13,12:00:00,182,92,90,FMN 06 B Zurenborgbrug Ringfietspad
655,Ringfietspad Zurenborgbrug,2023-02-13,13:00:00,181,93,88,FMN 06 B Zurenborgbrug Ringfietspad
655,Ringfietspad Zurenborgbrug,2023-02-13,14:00:00,170,65,105,FMN 06 B Zurenborgbrug Ringfietspad
655,Ringfietspad Zurenborgbrug,2023-02-13,15:00:00,293,117,176,FMN 06 B Zurenborgbrug Ringfietspad
655,Ringfietspad Zurenborgbrug,2023-02-13,16:00:00,481,209,272,FMN 06 B Zurenborgbrug Ringfietspad
655,Ringfietspad Zurenborgbrug,2023-02-13,17:00:00,469,176,293,FMN 06 B Zurenborgbrug Ringfietspad
655,Ringfietspad Zurenborgbrug,2023-02-13,18:00:00,260,126,134,FMN 06 B Zurenborgbrug Ringfietspad
655,Ringfietspad Zurenborgbrug,2023-02-13,19:00:00,114,39,75,FMN 06 B Zurenborgbrug Ringfietspad
655,Ringfietspad Zurenborgbrug,2023-02-13,20:00:00,77,32,45,FMN 06 B Zurenborgbrug Ringfietspad
655,Ringfietspad Zurenborgbrug,2023-02-13,21:00:00,63,24,39,FMN 06 B Zurenborgbrug Ringfietspad
655,Ringfietspad Zurenborgbrug,2023-02-13,22:00:00,89,30,59,FMN 06 B Zurenborgbrug Ringfietspad
655,Ringfietspad Zurenborgbrug,2023-02-13,23:00:00,21,8,13,FMN 06 B Zurenborgbrug Ringfietspad
655,Ringfietspad Zurenborgbrug,2023-02-14,00:00:00,5,2,3,FMN 06 B Zurenborgbrug Ringfietspad
655,Ringfietspad Zurenborgbrug,2023-02-14,01:00:00,5,2,3,FMN 06 B Zurenborgbrug Ringfietspad
655,Ringfietspad Zurenborgbrug,2023-02-14,02:00:00,1,1,0,FMN 06 B Zurenborgbrug Ringfietspad
655,Ringfietspad Zurenborgbrug,2023-02-14,03:00:00,3,2,1,FMN 06 B Zurenborgbrug Ringfietspad
655,Ringfietspad Zurenborgbrug,2023-02-14,04:00:00,14,8,6,FMN 06 B Zurenborgbrug Ringfietspad
655,Ringfietspad Zurenborgbrug,2023-02-14,05:00:00,55,27,28,FMN 06 B Zurenborgbrug Ringfietspad
655,Ringfietspad Zurenborgbrug,2023-02-14,06:00:00,139,80,59,FMN 06 B Zurenborgbrug Ringfietspad
655,Ringfietspad Zurenborgbrug,2023-02-14,07:00:00,419,223,196,FMN 06 B Zurenborgbrug Ringfietspad
655,Ringfietspad Zurenborgbrug,2023-02-14,08:00:00,641,377,264,FMN 06 B Zurenborgbrug Ringfietspad
655,Ringfietspad Zurenborgbrug,2023-02-14,09:00:00,172,99,73,FMN 06 B Zurenborgbrug Ringfietspad
655,Ringfietspad Zurenborgbrug,2023-02-14,10:00:00,101,54,47,FMN 06 B Zurenborgbrug Ringfietspad
655,Ringfietspad Zurenborgbrug,2023-02-14,11:00:00,121,56,65,FMN 06 B Zurenborgbrug Ringfietspad
655,Ringfietspad Zurenborgbrug,2023-02-14,12:00:00,168,83,85,FMN 06 B Zurenborgbrug Ringfietspad
655,Ringfietspad Zurenborgbrug,2023-02-14,13:00:00,216,96,120,FMN 06 B Zurenborgbrug Ringfietspad
655,Ringfietspad Zurenborgbrug,2023-02-14,14:00:00,192,91,101,FMN 06 B Zurenborgbrug Ringfietspad
655,Ringfietspad Zurenborgbrug,2023-02-14,15:00:00,279,106,173,FMN 06 B Zurenborgbrug Ringfietspad
655,Ringfietspad Zurenborgbrug,2023-02-14,16:00:00,551,215,336,FMN 06 B Zurenborgbrug Ringfietspad
655,Ringfietspad Zurenborgbrug,2023-02-14,17:00:00,558,197,361,FMN 06 B Zurenborgbrug Ringfietspad
655,Ringfietspad Zurenborgbrug,2023-02-14,18:00:00,296,123,173,FMN 06 B Zurenborgbrug Ringfietspad
655,Ringfietspad Zurenborgbrug,2023-02-14,19:00:00,133,45,88,FMN 06 B Zurenborgbrug Ringfietspad
655,Ringfietspad Zurenborgbrug,2023-02-14,20:00:00,83,38,45,FMN 06 B Zurenborgbrug Ringfietspad
655,Ringfietspad Zurenborgbrug,2023-02-14,21:00:00,70,27,43,FMN 06 B Zurenborgbrug Ringfietspad
655,Ringfietspad Zurenborgbrug,2023-02-14,22:00:00,89,33,56,FMN 06 B Zurenborgbrug Ringfietspad
655,Ringfietspad Zurenborgbrug,2023-02-14,23:00:00,38,18,20,FMN 06 B Zurenborgbrug Ringfietspad
655,Ringfietspad Zurenborgbrug,2023-02-15,00:00:00,12,8,4,FMN 06 B Zurenborgbrug Ringfietspad
655,Ringfietspad Zurenborgbrug,2023-02-15,01:00:00,2,1,1,FMN 06 B Zurenborgbrug Ringfietspad
655,Ringfietspad Zurenborgbrug,2023-02-15,02:00:00,0,0,0,FMN 06 B Zurenborgbrug Ringfietspad
655,Ringfietspad Zurenborgbrug,2023-02-15,03:00:00,6,3,3,FMN 06 B Zurenborgbrug Ringfietspad
655,Ringfietspad Zurenborgbrug,2023-02-15,04:00:00,13,4,9,FMN 06 B Zurenborgbrug Ringfietspad
655,Ringfietspad Zurenborgbrug,2023-02-15,05:00:00,45,25,20,FMN 06 B Zurenborgbrug Ringfietspad
655,Ringfietspad Zurenborgbrug,2023-02-15,06:00:00,107,56,51,FMN 06 B Zurenborgbrug Ringfietspad
655,Ringfietspad Zurenborgbrug,2023-02-15,07:00:00,383,226,157,FMN 06 B Zurenborgbrug Ringfietspad
655,Ringfietspad Zurenborgbrug,2023-02-15,08:00:00,502,272,230,FMN 06 B Zurenborgbrug Ringfietspad
655,Ringfietspad Zurenborgbrug,2023-02-15,09:00:00,145,78,67,FMN 06 B Zurenborgbrug Ringfietspad
655,Ringfietspad Zurenborgbrug,2023-02-15,10:00:00,110,66,44,FMN 06 B Zurenborgbrug Ringfietspad
655,Ringfietspad Zurenborgbrug,2023-02-15,11:00:00,125,59,66,FMN 06 B Zurenborgbrug Ringfietspad
655,Ringfietspad Zurenborgbrug,2023-02-15,12:00:00,318,148,170,FMN 06 B Zurenborgbrug Ringfietspad
655,Ringfietspad Zurenborgbrug,2023-02-15,13:00:00,236,92,144,FMN 06 B Zurenborgbrug Ringfietspad
655,Ringfietspad Zurenborgbrug,2023-02-15,14:00:00,161,65,96,FMN 06 B Zurenborgbrug Ringfietspad
655,Ringfietspad Zurenborgbrug,2023-02-15,15:00:00,243,98,145,FMN 06 B Zurenborgbrug Ringfietspad
655,Ringfietspad Zurenborgbrug,2023-02-15,16:00:00,368,158,210,FMN 06 B Zurenborgbrug Ringfietspad
655,Ringfietspad Zurenborgbrug,2023-02-15,17:00:00,421,170,251,FMN 06 B Zurenborgbrug Ringfietspad
655,Ringfietspad Zurenborgbrug,2023-02-15,18:00:00,277,102,175,FMN 06 B Zurenborgbrug Ringfietspad
655,Ringfietspad Zurenborgbrug,2023-02-15,19:00:00,141,54,87,FMN 06 B Zurenborgbrug Ringfietspad
655,Ringfietspad Zurenborgbrug,2023-02-15,20:00:00,78,24,54,FMN 06 B Zurenborgbrug Ringfietspad
655,Ringfietspad Zurenborgbrug,2023-02-15,21:00:00,94,44,50,FMN 06 B Zurenborgbrug Ringfietspad
655,Ringfietspad Zurenborgbrug,2023-02-15,22:00:00,88,31,57,FMN 06 B Zurenborgbrug Ringfietspad
655,Ringfietspad Zurenborgbrug,2023-02-15,23:00:00,19,9,10,FMN 06 B Zurenborgbrug Ringfietspad
655,Ringfietspad Zurenborgbrug,2023-02-16,00:00:00,12,5,7,FMN 06 B Zurenborgbrug Ringfietspad
655,Ringfietspad Zurenborgbrug,2023-02-16,01:00:00,3,2,1,FMN 06 B Zurenborgbrug Ringfietspad
655,Ringfietspad Zurenborgbrug,2023-02-16,02:00:00,6,3,3,FMN 06 B Zurenborgbrug Ringfietspad
655,Ringfietspad Zurenborgbrug,2023-02-16,03:00:00,2,1,1,FMN 06 B Zurenborgbrug Ringfietspad
655,Ringfietspad Zurenborgbrug,2023-02-16,04:00:00,14,8,6,FMN 06 B Zurenborgbrug Ringfietspad
655,Ringfietspad Zurenborgbrug,2023-02-16,05:00:00,39,18,21,FMN 06 B Zurenborgbrug Ringfietspad
655,Ringfietspad Zurenborgbrug,2023-02-16,06:00:00,126,76,50,FMN 06 B Zurenborgbrug Ringfietspad
655,Ringfietspad Zurenborgbrug,2023-02-16,07:00:00,360,221,139,FMN 06 B Zurenborgbrug Ringfietspad
655,Ringfietspad Zurenborgbrug,2023-02-16,08:00:00,554,318,236,FMN 06 B Zurenborgbrug Ringfietspad
655,Ringfietspad Zurenborgbrug,2023-02-16,09:00:00,147,100,47,FMN 06 B Zurenborgbrug Ringfietspad
655,Ringfietspad Zurenborgbrug,2023-02-16,10:00:00,69,35,34,FMN 06 B Zurenborgbrug Ringfietspad
655,Ringfietspad Zurenborgbrug,2023-02-16,11:00:00,61,25,36,FMN 06 B Zurenborgbrug Ringfietspad
655,Ringfietspad Zurenborgbrug,2023-02-16,12:00:00,129,56,73,FMN 06 B Zurenborgbrug Ringfietspad
655,Ringfietspad Zurenborgbrug,2023-02-16,13:00:00,139,72,67,FMN 06 B Zurenborgbrug Ringfietspad
655,Ringfietspad Zurenborgbrug,2023-02-16,14:00:00,107,53,54,FMN 06 B Zurenborgbrug Ringfietspad
655,Ringfietspad Zurenborgbrug,2023-02-16,15:00:00,253,99,154,FMN 06 B Zurenborgbrug Ringfietspad
655,Ringfietspad Zurenborgbrug,2023-02-16,16:00:00,402,159,243,FMN 06 B Zurenborgbrug Ringfietspad
655,Ringfietspad Zurenborgbrug,2023-02-16,17:00:00,426,134,292,FMN 06 B Zurenborgbrug Ringfietspad
655,Ringfietspad Zurenborgbrug,2023-02-16,18:00:00,219,77,142,FMN 06 B Zurenborgbrug Ringfietspad
655,Ringfietspad Zurenborgbrug,2023-02-16,19:00:00,119,49,70,FMN 06 B Zurenborgbrug Ringfietspad
655,Ringfietspad Zurenborgbrug,2023-02-16,20:00:00,87,40,47,FMN 06 B Zurenborgbrug Ringfietspad
655,Ringfietspad Zurenborgbrug,2023-02-16,21:00:00,60,17,43,FMN 06 B Zurenborgbrug Ringfietspad
655,Ringfietspad Zurenborgbrug,2023-02-16,22:00:00,67,27,40,FMN 06 B Zurenborgbrug Ringfietspad
655,Ringfietspad Zurenborgbrug,2023-02-16,23:00:00,29,13,16,FMN 06 B Zurenborgbrug Ringfietspad
655,Ringfietspad Zurenborgbrug,2023-02-17,00:00:00,17,9,8,FMN 06 B Zurenborgbrug Ringfietspad
655,Ringfietspad Zurenborgbrug,2023-02-17,01:00:00,1,0,1,FMN 06 B Zurenborgbrug Ringfietspad
655,Ringfietspad Zurenborgbrug,2023-02-17,02:00:00,1,1,0,FMN 06 B Zurenborgbrug Ringfietspad
655,Ringfietspad Zurenborgbrug,2023-02-17,03:00:00,5,1,4,FMN 06 B Zurenborgbrug Ringfietspad
655,Ringfietspad Zurenborgbrug,2023-02-17,04:00:00,12,5,7,FMN 06 B Zurenborgbrug Ringfietspad
655,Ringfietspad Zurenborgbrug,2023-02-17,05:00:00,40,22,18,FMN 06 B Zurenborgbrug Ringfietspad
655,Ringfietspad Zurenborgbrug,2023-02-17,06:00:00,94,54,40,FMN 06 B Zurenborgbrug Ringfietspad
655,Ringfietspad Zurenborgbrug,2023-02-17,07:00:00,278,162,116,FMN 06 B Zurenborgbrug Ringfietspad
655,Ringfietspad Zurenborgbrug,2023-02-17,08:00:00,474,269,205,FMN 06 B Zurenborgbrug Ringfietspad
655,Ringfietspad Zurenborgbrug,2023-02-17,09:00:00,112,67,45,FMN 06 B Zurenborgbrug Ringfietspad
655,Ringfietspad Zurenborgbrug,2023-02-17,10:00:00,82,48,34,FMN 06 B Zurenborgbrug Ringfietspad
655,Ringfietspad Zurenborgbrug,2023-02-17,11:00:00,69,28,41,FMN 06 B Zurenborgbrug Ringfietspad
655,Ringfietspad Zurenborgbrug,2023-02-17,12:00:00,253,90,163,FMN 06 B Zurenborgbrug Ringfietspad
655,Ringfietspad Zurenborgbrug,2023-02-17,13:00:00,113,50,63,FMN 06 B Zurenborgbrug Ringfietspad
655,Ringfietspad Zurenborgbrug,2023-02-17,14:00:00,154,70,84,FMN 06 B Zurenborgbrug Ringfietspad
655,Ringfietspad Zurenborgbrug,2023-02-17,15:00:00,253,136,117,FMN 06 B Zurenborgbrug Ringfietspad
655,Ringfietspad Zurenborgbrug,2023-02-17,16:00:00,369,150,219,FMN 06 B Zurenborgbrug Ringfietspad
655,Ringfietspad Zurenborgbrug,2023-02-17,17:00:00,343,124,219,FMN 06 B Zurenborgbrug Ringfietspad
655,Ringfietspad Zurenborgbrug,2023-02-17,18:00:00,180,71,109,FMN 06 B Zurenborgbrug Ringfietspad
655,Ringfietspad Zurenborgbrug,2023-02-17,19:00:00,91,34,57,FMN 06 B Zurenborgbrug Ringfietspad
655,Ringfietspad Zurenborgbrug,2023-02-17,20:00:00,63,36,27,FMN 06 B Zurenborgbrug Ringfietspad
655,Ringfietspad Zurenborgbrug,2023-02-17,21:00:00,42,20,22,FMN 06 B Zurenborgbrug Ringfietspad
655,Ringfietspad Zurenborgbrug,2023-02-17,22:00:00,67,29,38,FMN 06 B Zurenborgbrug Ringfietspad
655,Ringfietspad Zurenborgbrug,2023-02-17,23:00:00,37,16,21,FMN 06 B Zurenborgbrug Ringfietspad
655,Ringfietspad Zurenborgbrug,2023-02-18,00:00:00,23,7,16,FMN 06 B Zurenborgbrug Ringfietspad
655,Ringfietspad Zurenborgbrug,2023-02-18,01:00:00,12,6,6,FMN 06 B Zurenborgbrug Ringfietspad
655,Ringfietspad Zurenborgbrug,2023-02-18,02:00:00,7,4,3,FMN 06 B Zurenborgbrug Ringfietspad
655,Ringfietspad Zurenborgbrug,2023-02-18,03:00:00,5,2,3,FMN 06 B Zurenborgbrug Ringfietspad
655,Ringfietspad Zurenborgbrug,2023-02-18,04:00:00,8,6,2,FMN 06 B Zurenborgbrug Ringfietspad
655,Ringfietspad Zurenborgbrug,2023-02-18,05:00:00,10,7,3,FMN 06 B Zurenborgbrug Ringfietspad
655,Ringfietspad Zurenborgbrug,2023-02-18,06:00:00,23,9,14,FMN 06 B Zurenborgbrug Ringfietspad
655,Ringfietspad Zurenborgbrug,2023-02-18,07:00:00,17,8,9,FMN 06 B Zurenborgbrug Ringfietspad
655,Ringfietspad Zurenborgbrug,2023-02-18,08:00:00,35,20,15,FMN 06 B Zurenborgbrug Ringfietspad
655,Ringfietspad Zurenborgbrug,2023-02-18,09:00:00,69,33,36,FMN 06 B Zurenborgbrug Ringfietspad
655,Ringfietspad Zurenborgbrug,2023-02-18,10:00:00,88,40,48,FMN 06 B Zurenborgbrug Ringfietspad
655,Ringfietspad Zurenborgbrug,2023-02-18,11:00:00,64,33,31,FMN 06 B Zurenborgbrug Ringfietspad
655,Ringfietspad Zurenborgbrug,2023-02-18,12:00:00,106,55,51,FMN 06 B Zurenborgbrug Ringfietspad
655,Ringfietspad Zurenborgbrug,2023-02-18,13:00:00,86,34,52,FMN 06 B Zurenborgbrug Ringfietspad
655,Ringfietspad Zurenborgbrug,2023-02-18,14:00:00,104,44,60,FMN 06 B Zurenborgbrug Ringfietspad
655,Ringfietspad Zurenborgbrug,2023-02-18,15:00:00,115,41,74,FMN 06 B Zurenborgbrug Ringfietspad
655,Ringfietspad Zurenborgbrug,2023-02-18,16:00:00,80,38,42,FMN 06 B Zurenborgbrug Ringfietspad
655,Ringfietspad Zurenborgbrug,2023-02-18,17:00:00,84,42,42,FMN 06 B Zurenborgbrug Ringfietspad
655,Ringfietspad Zurenborgbrug,2023-02-18,18:00:00,125,68,57,FMN 06 B Zurenborgbrug Ringfietspad
655,Ringfietspad Zurenborgbrug,2023-02-18,19:00:00,87,29,58,FMN 06 B Zurenborgbrug Ringfietspad
655,Ringfietspad Zurenborgbrug,2023-02-18,20:00:00,56,28,28,FMN 06 B Zurenborgbrug Ringfietspad
655,Ringfietspad Zurenborgbrug,2023-02-18,21:00:00,39,13,26,FMN 06 B Zurenborgbrug Ringfietspad
655,Ringfietspad Zurenborgbrug,2023-02-18,22:00:00,71,48,23,FMN 06 B Zurenborgbrug Ringfietspad
655,Ringfietspad Zurenborgbrug,2023-02-18,23:00:00,33,16,17,FMN 06 B Zurenborgbrug Ringfietspad
655,Ringfietspad Zurenborgbrug,2023-02-19,00:00:00,26,13,13,FMN 06 B Zurenborgbrug Ringfietspad
655,Ringfietspad Zurenborgbrug,2023-02-19,01:00:00,21,9,12,FMN 06 B Zurenborgbrug Ringfietspad
655,Ringfietspad Zurenborgbrug,2023-02-19,02:00:00,14,4,10,FMN 06 B Zurenborgbrug Ringfietspad
655,Ringfietspad Zurenborgbrug,2023-02-19,03:00:00,8,1,7,FMN 06 B Zurenborgbrug Ringfietspad
655,Ringfietspad Zurenborgbrug,2023-02-19,04:00:00,5,4,1,FMN 06 B Zurenborgbrug Ringfietspad
655,Ringfietspad Zurenborgbrug,2023-02-19,05:00:00,8,5,3,FMN 06 B Zurenborgbrug Ringfietspad
655,Ringfietspad Zurenborgbrug,2023-02-19,06:00:00,24,11,13,FMN 06 B Zurenborgbrug Ringfietspad
655,Ringfietspad Zurenborgbrug,2023-02-19,07:00:00,14,2,12,FMN 06 B Zurenborgbrug Ringfietspad
655,Ringfietspad Zurenborgbrug,2023-02-19,08:00:00,46,13,33,FMN 06 B Zurenborgbrug Ringfietspad
655,Ringfietspad Zurenborgbrug,2023-02-19,09:00:00,97,35,62,FMN 06 B Zurenborgbrug Ringfietspad
655,Ringfietspad Zurenborgbrug,2023-02-19,10:00:00,82,34,48,FMN 06 B Zurenborgbrug Ringfietspad
655,Ringfietspad Zurenborgbrug,2023-02-19,11:00:00,92,44,48,FMN 06 B Zurenborgbrug Ringfietspad
655,Ringfietspad Zurenborgbrug,2023-02-19,12:00:00,119,49,70,FMN 06 B Zurenborgbrug Ringfietspad
655,Ringfietspad Zurenborgbrug,2023-02-19,13:00:00,82,34,48,FMN 06 B Zurenborgbrug Ringfietspad
655,Ringfietspad Zurenborgbrug,2023-02-19,14:00:00,105,56,49,FMN 06 B Zurenborgbrug Ringfietspad
655,Ringfietspad Zurenborgbrug,2023-02-19,15:00:00,110,52,58,FMN 06 B Zurenborgbrug Ringfietspad
655,Ringfietspad Zurenborgbrug,2023-02-19,16:00:00,117,51,66,FMN 06 B Zurenborgbrug Ringfietspad
655,Ringfietspad Zurenborgbrug,2023-02-19,17:00:00,91,50,41,FMN 06 B Zurenborgbrug Ringfietspad
655,Ringfietspad Zurenborgbrug,2023-02-19,18:00:00,63,24,39,FMN 06 B Zurenborgbrug Ringfietspad
655,Ringfietspad Zurenborgbrug,2023-02-19,19:00:00,76,35,41,FMN 06 B Zurenborgbrug Ringfietspad
655,Ringfietspad Zurenborgbrug,2023-02-19,20:00:00,41,22,19,FMN 06 B Zurenborgbrug Ringfietspad
655,Ringfietspad Zurenborgbrug,2023-02-19,21:00:00,41,12,29,FMN 06 B Zurenborgbrug Ringfietspad
655,Ringfietspad Zurenborgbrug,2023-02-19,22:00:00,26,16,10,FMN 06 B Zurenborgbrug Ringfietspad
655,Ringfietspad Zurenborgbrug,2023-02-19,23:00:00,28,15,13,FMN 06 B Zurenborgbrug Ringfietspad
655,Ringfietspad Zurenborgbrug,2023-02-20,00:00:00,6,1,5,FMN 06 B Zurenborgbrug Ringfietspad
655,Ringfietspad Zurenborgbrug,2023-02-20,01:00:00,4,2,2,FMN 06 B Zurenborgbrug Ringfietspad
655,Ringfietspad Zurenborgbrug,2023-02-20,02:00:00,0,0,0,FMN 06 B Zurenborgbrug Ringfietspad
655,Ringfietspad Zurenborgbrug,2023-02-20,03:00:00,3,2,1,FMN 06 B Zurenborgbrug Ringfietspad
655,Ringfietspad Zurenborgbrug,2023-02-20,04:00:00,18,12,6,FMN 06 B Zurenborgbrug Ringfietspad
655,Ringfietspad Zurenborgbrug,2023-02-20,05:00:00,48,23,25,FMN 06 B Zurenborgbrug Ringfietspad
655,Ringfietspad Zurenborgbrug,2023-02-20,06:00:00,101,55,46,FMN 06 B Zurenborgbrug Ringfietspad
655,Ringfietspad Zurenborgbrug,2023-02-20,07:00:00,241,154,87,FMN 06 B Zurenborgbrug Ringfietspad
655,Ringfietspad Zurenborgbrug,2023-02-20,08:00:00,345,203,142,FMN 06 B Zurenborgbrug Ringfietspad
655,Ringfietspad Zurenborgbrug,2023-02-20,09:00:00,92,54,38,FMN 06 B Zurenborgbrug Ringfietspad
655,Ringfietspad Zurenborgbrug,2023-02-20,10:00:00,93,55,38,FMN 06 B Zurenborgbrug Ringfietspad
655,Ringfietspad Zurenborgbrug,2023-02-20,11:00:00,62,37,25,FMN 06 B Zurenborgbrug Ringfietspad
655,Ringfietspad Zurenborgbrug,2023-02-20,12:00:00,120,54,66,FMN 06 B Zurenborgbrug Ringfietspad
655,Ringfietspad Zurenborgbrug,2023-02-20,13:00:00,117,51,66,FMN 06 B Zurenborgbrug Ringfietspad
655,Ringfietspad Zurenborgbrug,2023-02-20,14:00:00,112,40,72,FMN 06 B Zurenborgbrug Ringfietspad
655,Ringfietspad Zurenborgbrug,2023-02-20,15:00:00,151,54,97,FMN 06 B Zurenborgbrug Ringfietspad
655,Ringfietspad Zurenborgbrug,2023-02-20,16:00:00,277,109,168,FMN 06 B Zurenborgbrug Ringfietspad
655,Ringfietspad Zurenborgbrug,2023-02-20,17:00:00,357,127,230,FMN 06 B Zurenborgbrug Ringfietspad
655,Ringfietspad Zurenborgbrug,2023-02-20,18:00:00,190,66,124,FMN 06 B Zurenborgbrug Ringfietspad
655,Ringfietspad Zurenborgbrug,2023-02-20,19:00:00,75,30,45,FMN 06 B Zurenborgbrug Ringfietspad
655,Ringfietspad Zurenborgbrug,2023-02-20,20:00:00,51,16,35,FMN 06 B Zurenborgbrug Ringfietspad
655,Ringfietspad Zurenborgbrug,2023-02-20,21:00:00,41,12,29,FMN 06 B Zurenborgbrug Ringfietspad
655,Ringfietspad Zurenborgbrug,2023-02-20,22:00:00,49,16,33,FMN 06 B Zurenborgbrug Ringfietspad
655,Ringfietspad Zurenborgbrug,2023-02-20,23:00:00,24,8,16,FMN 06 B Zurenborgbrug Ringfietspad
655,Ringfietspad Zurenborgbrug,2023-02-21,00:00:00,12,2,10,FMN 06 B Zurenborgbrug Ringfietspad
655,Ringfietspad Zurenborgbrug,2023-02-21,01:00:00,0,0,0,FMN 06 B Zurenborgbrug Ringfietspad
655,Ringfietspad Zurenborgbrug,2023-02-21,02:00:00,5,2,3,FMN 06 B Zurenborgbrug Ringfietspad
655,Ringfietspad Zurenborgbrug,2023-02-21,03:00:00,4,3,1,FMN 06 B Zurenborgbrug Ringfietspad
655,Ringfietspad Zurenborgbrug,2023-02-21,04:00:00,19,13,6,FMN 06 B Zurenborgbrug Ringfietspad
655,Ringfietspad Zurenborgbrug,2023-02-21,05:00:00,55,27,28,FMN 06 B Zurenborgbrug Ringfietspad
655,Ringfietspad Zurenborgbrug,2023-02-21,06:00:00,107,62,45,FMN 06 B Zurenborgbrug Ringfietspad
655,Ringfietspad Zurenborgbrug,2023-02-21,07:00:00,273,178,95,FMN 06 B Zurenborgbrug Ringfietspad
655,Ringfietspad Zurenborgbrug,2023-02-21,08:00:00,367,219,148,FMN 06 B Zurenborgbrug Ringfietspad
655,Ringfietspad Zurenborgbrug,2023-02-21,09:00:00,117,65,52,FMN 06 B Zurenborgbrug Ringfietspad
655,Ringfietspad Zurenborgbrug,2023-02-21,10:00:00,71,33,38,FMN 06 B Zurenborgbrug Ringfietspad
655,Ringfietspad Zurenborgbrug,2023-02-21,11:00:00,60,29,31,FMN 06 B Zurenborgbrug Ringfietspad
655,Ringfietspad Zurenborgbrug,2023-02-21,12:00:00,81,40,41,FMN 06 B Zurenborgbrug Ringfietspad
655,Ringfietspad Zurenborgbrug,2023-02-21,13:00:00,121,53,68,FMN 06 B Zurenborgbrug Ringfietspad
655,Ringfietspad Zurenborgbrug,2023-02-21,14:00:00,125,60,65,FMN 06 B Zurenborgbrug Ringfietspad
655,Ringfietspad Zurenborgbrug,2023-02-21,15:00:00,161,55,106,FMN 06 B Zurenborgbrug Ringfietspad
655,Ringfietspad Zurenborgbrug,2023-02-21,16:00:00,291,99,192,FMN 06 B Zurenborgbrug Ringfietspad
655,Ringfietspad Zurenborgbrug,2023-02-21,17:00:00,346,122,224,FMN 06 B Zurenborgbrug Ringfietspad
655,Ringfietspad Zurenborgbrug,2023-02-21,18:00:00,203,77,126,FMN 06 B Zurenborgbrug Ringfietspad
655,Ringfietspad Zurenborgbrug,2023-02-21,19:00:00,86,23,63,FMN 06 B Zurenborgbrug Ringfietspad
655,Ringfietspad Zurenborgbrug,2023-02-21,20:00:00,51,23,28,FMN 06 B Zurenborgbrug Ringfietspad
655,Ringfietspad Zurenborgbrug,2023-02-21,21:00:00,58,24,34,FMN 06 B Zurenborgbrug Ringfietspad
655,Ringfietspad Zurenborgbrug,2023-02-21,22:00:00,42,13,29,FMN 06 B Zurenborgbrug Ringfietspad
655,Ringfietspad Zurenborgbrug,2023-02-21,23:00:00,17,8,9,FMN 06 B Zurenborgbrug Ringfietspad
655,Ringfietspad Zurenborgbrug,2023-02-22,00:00:00,9,3,6,FMN 06 B Zurenborgbrug Ringfietspad
655,Ringfietspad Zurenborgbrug,2023-02-22,01:00:00,5,0,5,FMN 06 B Zurenborgbrug Ringfietspad
655,Ringfietspad Zurenborgbrug,2023-02-22,02:00:00,1,1,0,FMN 06 B Zurenborgbrug Ringfietspad
655,Ringfietspad Zurenborgbrug,2023-02-22,03:00:00,3,2,1,FMN 06 B Zurenborgbrug Ringfietspad
655,Ringfietspad Zurenborgbrug,2023-02-22,04:00:00,17,10,7,FMN 06 B Zurenborgbrug Ringfietspad
655,Ringfietspad Zurenborgbrug,2023-02-22,05:00:00,38,22,16,FMN 06 B Zurenborgbrug Ringfietspad
655,Ringfietspad Zurenborgbrug,2023-02-22,06:00:00,101,56,45,FMN 06 B Zurenborgbrug Ringfietspad
655,Ringfietspad Zurenborgbrug,2023-02-22,07:00:00,176,110,66,FMN 06 B Zurenborgbrug Ringfietspad
655,Ringfietspad Zurenborgbrug,2023-02-22,08:00:00,283,148,135,FMN 06 B Zurenborgbrug Ringfietspad
655,Ringfietspad Zurenborgbrug,2023-02-22,09:00:00,113,64,49,FMN 06 B Zurenborgbrug Ringfietspad
655,Ringfietspad Zurenborgbrug,2023-02-22,10:00:00,76,46,30,FMN 06 B Zurenborgbrug Ringfietspad
655,Ringfietspad Zurenborgbrug,2023-02-22,11:00:00,77,29,48,FMN 06 B Zurenborgbrug Ringfietspad
655,Ringfietspad Zurenborgbrug,2023-02-22,12:00:00,89,31,58,FMN 06 B Zurenborgbrug Ringfietspad
655,Ringfietspad Zurenborgbrug,2023-02-22,13:00:00,124,65,59,FMN 06 B Zurenborgbrug Ringfietspad
655,Ringfietspad Zurenborgbrug,2023-02-22,14:00:00,119,54,65,FMN 06 B Zurenborgbrug Ringfietspad
655,Ringfietspad Zurenborgbrug,2023-02-22,15:00:00,134,49,85,FMN 06 B Zurenborgbrug Ringfietspad
655,Ringfietspad Zurenborgbrug,2023-02-22,16:00:00,271,113,158,FMN 06 B Zurenborgbrug Ringfietspad
655,Ringfietspad Zurenborgbrug,2023-02-22,17:00:00,282,90,192,FMN 06 B Zurenborgbrug Ringfietspad
655,Ringfietspad Zurenborgbrug,2023-02-22,18:00:00,168,66,102,FMN 06 B Zurenborgbrug Ringfietspad
655,Ringfietspad Zurenborgbrug,2023-02-22,19:00:00,116,51,65,FMN 06 B Zurenborgbrug Ringfietspad
655,Ringfietspad Zurenborgbrug,2023-02-22,20:00:00,67,26,41,FMN 06 B Zurenborgbrug Ringfietspad
655,Ringfietspad Zurenborgbrug,2023-02-22,21:00:00,57,27,30,FMN 06 B Zurenborgbrug Ringfietspad
655,Ringfietspad Zurenborgbrug,2023-02-22,22:00:00,54,30,24,FMN 06 B Zurenborgbrug Ringfietspad
655,Ringfietspad Zurenborgbrug,2023-02-22,23:00:00,21,14,7,FMN 06 B Zurenborgbrug Ringfietspad
655,Ringfietspad Zurenborgbrug,2023-02-23,00:00:00,13,8,5,FMN 06 B Zurenborgbrug Ringfietspad
655,Ringfietspad Zurenborgbrug,2023-02-23,01:00:00,5,1,4,FMN 06 B Zurenborgbrug Ringfietspad
655,Ringfietspad Zurenborgbrug,2023-02-23,02:00:00,0,0,0,FMN 06 B Zurenborgbrug Ringfietspad
655,Ringfietspad Zurenborgbrug,2023-02-23,03:00:00,0,0,0,FMN 06 B Zurenborgbrug Ringfietspad
655,Ringfietspad Zurenborgbrug,2023-02-23,04:00:00,0,0,0,FMN 06 B Zurenborgbrug Ringfietspad
655,Ringfietspad Zurenborgbrug,2023-02-23,05:00:00,0,0,0,FMN 06 B Zurenborgbrug Ringfietspad
655,Ringfietspad Zurenborgbrug,2023-02-23,06:00:00,0,0,0,FMN 06 B Zurenborgbrug Ringfietspad
655,Ringfietspad Zurenborgbrug,2023-02-23,07:00:00,0,0,0,FMN 06 B Zurenborgbrug Ringfietspad
655,Ringfietspad Zurenborgbrug,2023-02-23,08:00:00,301,165,136,FMN 06 B Zurenborgbrug Ringfietspad
655,Ringfietspad Zurenborgbrug,2023-02-23,09:00:00,125,78,47,FMN 06 B Zurenborgbrug Ringfietspad
655,Ringfietspad Zurenborgbrug,2023-02-23,10:00:00,81,53,28,FMN 06 B Zurenborgbrug Ringfietspad
655,Ringfietspad Zurenborgbrug,2023-02-23,11:00:00,81,42,39,FMN 06 B Zurenborgbrug Ringfietspad
655,Ringfietspad Zurenborgbrug,2023-02-23,12:00:00,107,44,63,FMN 06 B Zurenborgbrug Ringfietspad
655,Ringfietspad Zurenborgbrug,2023-02-23,13:00:00,118,58,60,FMN 06 B Zurenborgbrug Ringfietspad
655,Ringfietspad Zurenborgbrug,2023-02-23,14:00:00,100,37,63,FMN 06 B Zurenborgbrug Ringfietspad
655,Ringfietspad Zurenborgbrug,2023-02-23,15:00:00,152,52,100,FMN 06 B Zurenborgbrug Ringfietspad
655,Ringfietspad Zurenborgbrug,2023-02-23,16:00:00,270,94,176,FMN 06 B Zurenborgbrug Ringfietspad
655,Ringfietspad Zurenborgbrug,2023-02-23,17:00:00,325,106,219,FMN 06 B Zurenborgbrug Ringfietspad
655,Ringfietspad Zurenborgbrug,2023-02-23,18:00:00,213,75,138,FMN 06 B Zurenborgbrug Ringfietspad
655,Ringfietspad Zurenborgbrug,2023-02-23,19:00:00,130,54,76,FMN 06 B Zurenborgbrug Ringfietspad
655,Ringfietspad Zurenborgbrug,2023-02-23,20:00:00,62,24,38,FMN 06 B Zurenborgbrug Ringfietspad
655,Ringfietspad Zurenborgbrug,2023-02-23,21:00:00,55,26,29,FMN 06 B Zurenborgbrug Ringfietspad
655,Ringfietspad Zurenborgbrug,2023-02-23,22:00:00,49,23,26,FMN 06 B Zurenborgbrug Ringfietspad
655,Ringfietspad Zurenborgbrug,2023-02-23,23:00:00,40,14,26,FMN 06 B Zurenborgbrug Ringfietspad
655,Ringfietspad Zurenborgbrug,2023-02-24,00:00:00,18,6,12,FMN 06 B Zurenborgbrug Ringfietspad
655,Ringfietspad Zurenborgbrug,2023-02-24,01:00:00,11,7,4,FMN 06 B Zurenborgbrug Ringfietspad
655,Ringfietspad Zurenborgbrug,2023-02-24,02:00:00,4,2,2,FMN 06 B Zurenborgbrug Ringfietspad
655,Ringfietspad Zurenborgbrug,2023-02-24,03:00:00,3,0,3,FMN 06 B Zurenborgbrug Ringfietspad
655,Ringfietspad Zurenborgbrug,2023-02-24,04:00:00,12,7,5,FMN 06 B Zurenborgbrug Ringfietspad
655,Ringfietspad Zurenborgbrug,2023-02-24,05:00:00,39,18,21,FMN 06 B Zurenborgbrug Ringfietspad
655,Ringfietspad Zurenborgbrug,2023-02-24,06:00:00,74,40,34,FMN 06 B Zurenborgbrug Ringfietspad
655,Ringfietspad Zurenborgbrug,2023-02-24,07:00:00,165,97,68,FMN 06 B Zurenborgbrug Ringfietspad
655,Ringfietspad Zurenborgbrug,2023-02-24,08:00:00,267,163,104,FMN 06 B Zurenborgbrug Ringfietspad
655,Ringfietspad Zurenborgbrug,2023-02-24,09:00:00,97,57,40,FMN 06 B Zurenborgbrug Ringfietspad
655,Ringfietspad Zurenborgbrug,2023-02-24,10:00:00,73,38,35,FMN 06 B Zurenborgbrug Ringfietspad
655,Ringfietspad Zurenborgbrug,2023-02-24,11:00:00,81,42,39,FMN 06 B Zurenborgbrug Ringfietspad
655,Ringfietspad Zurenborgbrug,2023-02-24,12:00:00,101,51,50,FMN 06 B Zurenborgbrug Ringfietspad
655,Ringfietspad Zurenborgbrug,2023-02-24,13:00:00,131,66,65,FMN 06 B Zurenborgbrug Ringfietspad
655,Ringfietspad Zurenborgbrug,2023-02-24,14:00:00,91,40,51,FMN 06 B Zurenborgbrug Ringfietspad
655,Ringfietspad Zurenborgbrug,2023-02-24,15:00:00,127,46,81,FMN 06 B Zurenborgbrug Ringfietspad
655,Ringfietspad Zurenborgbrug,2023-02-24,16:00:00,223,88,135,FMN 06 B Zurenborgbrug Ringfietspad
655,Ringfietspad Zurenborgbrug,2023-02-24,17:00:00,221,82,139,FMN 06 B Zurenborgbrug Ringfietspad
655,Ringfietspad Zurenborgbrug,2023-02-24,18:00:00,122,39,83,FMN 06 B Zurenborgbrug Ringfietspad
655,Ringfietspad Zurenborgbrug,2023-02-24,19:00:00,101,44,57,FMN 06 B Zurenborgbrug Ringfietspad
655,Ringfietspad Zurenborgbrug,2023-02-24,20:00:00,51,16,35,FMN 06 B Zurenborgbrug Ringfietspad
655,Ringfietspad Zurenborgbrug,2023-02-24,21:00:00,37,8,29,FMN 06 B Zurenborgbrug Ringfietspad
655,Ringfietspad Zurenborgbrug,2023-02-24,22:00:00,47,20,27,FMN 06 B Zurenborgbrug Ringfietspad
655,Ringfietspad Zurenborgbrug,2023-02-24,23:00:00,50,22,28,FMN 06 B Zurenborgbrug Ringfietspad
655,Ringfietspad Zurenborgbrug,2023-02-25,00:00:00,20,4,16,FMN 06 B Zurenborgbrug Ringfietspad
655,Ringfietspad Zurenborgbrug,2023-02-25,01:00:00,22,10,12,FMN 06 B Zurenborgbrug Ringfietspad
655,Ringfietspad Zurenborgbrug,2023-02-25,02:00:00,0,0,0,FMN 06 B Zurenborgbrug Ringfietspad
655,Ringfietspad Zurenborgbrug,2023-02-25,03:00:00,0,0,0,FMN 06 B Zurenborgbrug Ringfietspad
655,Ringfietspad Zurenborgbrug,2023-02-25,04:00:00,0,0,0,FMN 06 B Zurenborgbrug Ringfietspad
655,Ringfietspad Zurenborgbrug,2023-02-25,05:00:00,0,0,0,FMN 06 B Zurenborgbrug Ringfietspad
655,Ringfietspad Zurenborgbrug,2023-02-25,06:00:00,0,0,0,FMN 06 B Zurenborgbrug Ringfietspad
655,Ringfietspad Zurenborgbrug,2023-02-25,07:00:00,2,1,1,FMN 06 B Zurenborgbrug Ringfietspad
655,Ringfietspad Zurenborgbrug,2023-02-25,08:00:00,53,18,35,FMN 06 B Zurenborgbrug Ringfietspad
655,Ringfietspad Zurenborgbrug,2023-02-25,09:00:00,69,31,38,FMN 06 B Zurenborgbrug Ringfietspad
655,Ringfietspad Zurenborgbrug,2023-02-25,10:00:00,73,24,49,FMN 06 B Zurenborgbrug Ringfietspad
655,Ringfietspad Zurenborgbrug,2023-02-25,11:00:00,63,27,36,FMN 06 B Zurenborgbrug Ringfietspad
655,Ringfietspad Zurenborgbrug,2023-02-25,12:00:00,86,42,44,FMN 06 B Zurenborgbrug Ringfietspad
655,Ringfietspad Zurenborgbrug,2023-02-25,13:00:00,93,47,46,FMN 06 B Zurenborgbrug Ringfietspad
655,Ringfietspad Zurenborgbrug,2023-02-25,14:00:00,83,21,62,FMN 06 B Zurenborgbrug Ringfietspad
655,Ringfietspad Zurenborgbrug,2023-02-25,15:00:00,89,31,58,FMN 06 B Zurenborgbrug Ringfietspad
655,Ringfietspad Zurenborgbrug,2023-02-25,16:00:00,81,43,38,FMN 06 B Zurenborgbrug Ringfietspad
655,Ringfietspad Zurenborgbrug,2023-02-25,17:00:00,78,37,41,FMN 06 B Zurenborgbrug Ringfietspad
655,Ringfietspad Zurenborgbrug,2023-02-25,18:00:00,96,49,47,FMN 06 B Zurenborgbrug Ringfietspad
655,Ringfietspad Zurenborgbrug,2023-02-25,19:00:00,47,23,24,FMN 06 B Zurenborgbrug Ringfietspad
655,Ringfietspad Zurenborgbrug,2023-02-25,20:00:00,53,21,32,FMN 06 B Zurenborgbrug Ringfietspad
655,Ringfietspad Zurenborgbrug,2023-02-25,21:00:00,30,14,16,FMN 06 B Zurenborgbrug Ringfietspad
655,Ringfietspad Zurenborgbrug,2023-02-25,22:00:00,40,18,22,FMN 06 B Zurenborgbrug Ringfietspad
655,Ringfietspad Zurenborgbrug,2023-02-25,23:00:00,30,16,14,FMN 06 B Zurenborgbrug Ringfietspad
655,Ringfietspad Zurenborgbrug,2023-02-26,00:00:00,24,7,17,FMN 06 B Zurenborgbrug Ringfietspad
655,Ringfietspad Zurenborgbrug,2023-02-26,01:00:00,11,4,7,FMN 06 B Zurenborgbrug Ringfietspad
655,Ringfietspad Zurenborgbrug,2023-02-26,02:00:00,10,4,6,FMN 06 B Zurenborgbrug Ringfietspad
655,Ringfietspad Zurenborgbrug,2023-02-26,03:00:00,7,1,6,FMN 06 B Zurenborgbrug Ringfietspad
655,Ringfietspad Zurenborgbrug,2023-02-26,04:00:00,5,0,5,FMN 06 B Zurenborgbrug Ringfietspad
655,Ringfietspad Zurenborgbrug,2023-02-26,05:00:00,11,7,4,FMN 06 B Zurenborgbrug Ringfietspad
655,Ringfietspad Zurenborgbrug,2023-02-26,06:00:00,12,5,7,FMN 06 B Zurenborgbrug Ringfietspad
655,Ringfietspad Zurenborgbrug,2023-02-26,07:00:00,14,7,7,FMN 06 B Zurenborgbrug Ringfietspad
655,Ringfietspad Zurenborgbrug,2023-02-26,08:00:00,37,10,27,FMN 06 B Zurenborgbrug Ringfietspad
655,Ringfietspad Zurenborgbrug,2023-02-26,09:00:00,109,27,82,FMN 06 B Zurenborgbrug Ringfietspad
655,Ringfietspad Zurenborgbrug,2023-02-26,10:00:00,102,44,58,FMN 06 B Zurenborgbrug Ringfietspad
655,Ringfietspad Zurenborgbrug,2023-02-26,11:00:00,140,54,86,FMN 06 B Zurenborgbrug Ringfietspad
655,Ringfietspad Zurenborgbrug,2023-02-26,12:00:00,149,72,77,FMN 06 B Zurenborgbrug Ringfietspad
655,Ringfietspad Zurenborgbrug,2023-02-26,13:00:00,137,70,67,FMN 06 B Zurenborgbrug Ringfietspad
655,Ringfietspad Zurenborgbrug,2023-02-26,14:00:00,159,63,96,FMN 06 B Zurenborgbrug Ringfietspad
655,Ringfietspad Zurenborgbrug,2023-02-26,15:00:00,112,54,58,FMN 06 B Zurenborgbrug Ringfietspad
655,Ringfietspad Zurenborgbrug,2023-02-26,16:00:00,109,58,51,FMN 06 B Zurenborgbrug Ringfietspad
655,Ringfietspad Zurenborgbrug,2023-02-26,17:00:00,104,64,40,FMN 06 B Zurenborgbrug Ringfietspad
655,Ringfietspad Zurenborgbrug,2023-02-26,18:00:00,78,33,45,FMN 06 B Zurenborgbrug Ringfietspad
655,Ringfietspad Zurenborgbrug,2023-02-26,19:00:00,55,22,33,FMN 06 B Zurenborgbrug Ringfietspad
655,Ringfietspad Zurenborgbrug,2023-02-26,20:00:00,40,26,14,FMN 06 B Zurenborgbrug Ringfietspad
655,Ringfietspad Zurenborgbrug,2023-02-26,21:00:00,33,16,17,FMN 06 B Zurenborgbrug Ringfietspad
655,Ringfietspad Zurenborgbrug,2023-02-26,22:00:00,27,12,15,FMN 06 B Zurenborgbrug Ringfietspad
655,Ringfietspad Zurenborgbrug,2023-02-26,23:00:00,16,4,12,FMN 06 B Zurenborgbrug Ringfietspad
655,Ringfietspad Zurenborgbrug,2023-02-27,00:00:00,5,2,3,FMN 06 B Zurenborgbrug Ringfietspad
655,Ringfietspad Zurenborgbrug,2023-02-27,01:00:00,6,1,5,FMN 06 B Zurenborgbrug Ringfietspad
655,Ringfietspad Zurenborgbrug,2023-02-27,02:00:00,2,0,2,FMN 06 B Zurenborgbrug Ringfietspad
655,Ringfietspad Zurenborgbrug,2023-02-27,03:00:00,5,3,2,FMN 06 B Zurenborgbrug Ringfietspad
655,Ringfietspad Zurenborgbrug,2023-02-27,04:00:00,17,11,6,FMN 06 B Zurenborgbrug Ringfietspad
655,Ringfietspad Zurenborgbrug,2023-02-27,05:00:00,49,27,22,FMN 06 B Zurenborgbrug Ringfietspad
655,Ringfietspad Zurenborgbrug,2023-02-27,06:00:00,108,59,49,FMN 06 B Zurenborgbrug Ringfietspad
655,Ringfietspad Zurenborgbrug,2023-02-27,07:00:00,364,202,162,FMN 06 B Zurenborgbrug Ringfietspad
655,Ringfietspad Zurenborgbrug,2023-02-27,08:00:00,577,341,236,FMN 06 B Zurenborgbrug Ringfietspad
655,Ringfietspad Zurenborgbrug,2023-02-27,09:00:00,127,73,54,FMN 06 B Zurenborgbrug Ringfietspad
655,Ringfietspad Zurenborgbrug,2023-02-27,10:00:00,96,61,35,FMN 06 B Zurenborgbrug Ringfietspad
655,Ringfietspad Zurenborgbrug,2023-02-27,11:00:00,94,37,57,FMN 06 B Zurenborgbrug Ringfietspad
655,Ringfietspad Zurenborgbrug,2023-02-27,12:00:00,145,67,78,FMN 06 B Zurenborgbrug Ringfietspad
655,Ringfietspad Zurenborgbrug,2023-02-27,13:00:00,169,76,93,FMN 06 B Zurenborgbrug Ringfietspad
655,Ringfietspad Zurenborgbrug,2023-02-27,14:00:00,156,71,85,FMN 06 B Zurenborgbrug Ringfietspad
655,Ringfietspad Zurenborgbrug,2023-02-27,15:00:00,252,97,155,FMN 06 B Zurenborgbrug Ringfietspad
655,Ringfietspad Zurenborgbrug,2023-02-27,16:00:00,502,225,277,FMN 06 B Zurenborgbrug Ringfietspad
655,Ringfietspad Zurenborgbrug,2023-02-27,17:00:00,465,170,295,FMN 06 B Zurenborgbrug Ringfietspad
655,Ringfietspad Zurenborgbrug,2023-02-27,18:00:00,303,135,168,FMN 06 B Zurenborgbrug Ringfietspad
655,Ringfietspad Zurenborgbrug,2023-02-27,19:00:00,104,26,78,FMN 06 B Zurenborgbrug Ringfietspad
655,Ringfietspad Zurenborgbrug,2023-02-27,20:00:00,96,43,53,FMN 06 B Zurenborgbrug Ringfietspad
655,Ringfietspad Zurenborgbrug,2023-02-27,21:00:00,67,24,43,FMN 06 B Zurenborgbrug Ringfietspad
655,Ringfietspad Zurenborgbrug,2023-02-27,22:00:00,73,29,44,FMN 06 B Zurenborgbrug Ringfietspad
655,Ringfietspad Zurenborgbrug,2023-02-27,23:00:00,15,4,11,FMN 06 B Zurenborgbrug Ringfietspad
655,Ringfietspad Zurenborgbrug,2023-02-28,00:00:00,6,4,2,FMN 06 B Zurenborgbrug Ringfietspad
655,Ringfietspad Zurenborgbrug,2023-02-28,01:00:00,5,2,3,FMN 06 B Zurenborgbrug Ringfietspad
655,Ringfietspad Zurenborgbrug,2023-02-28,02:00:00,1,1,0,FMN 06 B Zurenborgbrug Ringfietspad
655,Ringfietspad Zurenborgbrug,2023-02-28,03:00:00,8,4,4,FMN 06 B Zurenborgbrug Ringfietspad
655,Ringfietspad Zurenborgbrug,2023-02-28,04:00:00,12,8,4,FMN 06 B Zurenborgbrug Ringfietspad
655,Ringfietspad Zurenborgbrug,2023-02-28,05:00:00,45,26,19,FMN 06 B Zurenborgbrug Ringfietspad
655,Ringfietspad Zurenborgbrug,2023-02-28,06:00:00,133,72,61,FMN 06 B Zurenborgbrug Ringfietspad
655,Ringfietspad Zurenborgbrug,2023-02-28,07:00:00,411,249,162,FMN 06 B Zurenborgbrug Ringfietspad
655,Ringfietspad Zurenborgbrug,2023-02-28,08:00:00,602,334,268,FMN 06 B Zurenborgbrug Ringfietspad
655,Ringfietspad Zurenborgbrug,2023-02-28,09:00:00,155,83,72,FMN 06 B Zurenborgbrug Ringfietspad
655,Ringfietspad Zurenborgbrug,2023-02-28,10:00:00,84,42,42,FMN 06 B Zurenborgbrug Ringfietspad
655,Ringfietspad Zurenborgbrug,2023-02-28,11:00:00,76,31,45,FMN 06 B Zurenborgbrug Ringfietspad
655,Ringfietspad Zurenborgbrug,2023-02-28,12:00:00,126,68,58,FMN 06 B Zurenborgbrug Ringfietspad
655,Ringfietspad Zurenborgbrug,2023-02-28,13:00:00,147,78,69,FMN 06 B Zurenborgbrug Ringfietspad
655,Ringfietspad Zurenborgbrug,2023-02-28,14:00:00,169,69,100,FMN 06 B Zurenborgbrug Ringfietspad
655,Ringfietspad Zurenborgbrug,2023-02-28,15:00:00,228,79,149,FMN 06 B Zurenborgbrug Ringfietspad
655,Ringfietspad Zurenborgbrug,2023-02-28,16:00:00,489,205,284,FMN 06 B Zurenborgbrug Ringfietspad
655,Ringfietspad Zurenborgbrug,2023-02-28,17:00:00,490,167,323,FMN 06 B Zurenborgbrug Ringfietspad
655,Ringfietspad Zurenborgbrug,2023-02-28,18:00:00,291,109,182,FMN 06 B Zurenborgbrug Ringfietspad
655,Ringfietspad Zurenborgbrug,2023-02-28,19:00:00,136,49,87,FMN 06 B Zurenborgbrug Ringfietspad
655,Ringfietspad Zurenborgbrug,2023-02-28,20:00:00,81,35,46,FMN 06 B Zurenborgbrug Ringfietspad
655,Ringfietspad Zurenborgbrug,2023-02-28,21:00:00,78,35,43,FMN 06 B Zurenborgbrug Ringfietspad
655,Ringfietspad Zurenborgbrug,2023-02-28,22:00:00,78,20,58,FMN 06 B Zurenborgbrug Ringfietspad
655,Ringfietspad Zurenborgbrug,2023-02-28,23:00:00,43,24,19,FMN 06 B Zurenborgbrug Ringfietspad
655,Ringfietspad Zurenborgbrug,2023-03-01,00:00:00,17,11,6,FMN 06 B Zurenborgbrug Ringfietspad
655,Ringfietspad Zurenborgbrug,2023-03-01,01:00:00,5,4,1,FMN 06 B Zurenborgbrug Ringfietspad
655,Ringfietspad Zurenborgbrug,2023-03-01,02:00:00,4,2,2,FMN 06 B Zurenborgbrug Ringfietspad
655,Ringfietspad Zurenborgbrug,2023-03-01,03:00:00,2,1,1,FMN 06 B Zurenborgbrug Ringfietspad
655,Ringfietspad Zurenborgbrug,2023-03-01,04:00:00,20,11,9,FMN 06 B Zurenborgbrug Ringfietspad
655,Ringfietspad Zurenborgbrug,2023-03-01,05:00:00,43,25,18,FMN 06 B Zurenborgbrug Ringfietspad
655,Ringfietspad Zurenborgbrug,2023-03-01,06:00:00,122,68,54,FMN 06 B Zurenborgbrug Ringfietspad
655,Ringfietspad Zurenborgbrug,2023-03-01,07:00:00,343,200,143,FMN 06 B Zurenborgbrug Ringfietspad
655,Ringfietspad Zurenborgbrug,2023-03-01,08:00:00,503,264,239,FMN 06 B Zurenborgbrug Ringfietspad
655,Ringfietspad Zurenborgbrug,2023-03-01,09:00:00,144,74,70,FMN 06 B Zurenborgbrug Ringfietspad
655,Ringfietspad Zurenborgbrug,2023-03-01,10:00:00,114,69,45,FMN 06 B Zurenborgbrug Ringfietspad
655,Ringfietspad Zurenborgbrug,2023-03-01,11:00:00,103,47,56,FMN 06 B Zurenborgbrug Ringfietspad
655,Ringfietspad Zurenborgbrug,2023-03-01,12:00:00,300,160,140,FMN 06 B Zurenborgbrug Ringfietspad
655,Ringfietspad Zurenborgbrug,2023-03-01,13:00:00,206,87,119,FMN 06 B Zurenborgbrug Ringfietspad
655,Ringfietspad Zurenborgbrug,2023-03-01,14:00:00,151,67,84,FMN 06 B Zurenborgbrug Ringfietspad
655,Ringfietspad Zurenborgbrug,2023-03-01,15:00:00,214,75,139,FMN 06 B Zurenborgbrug Ringfietspad
655,Ringfietspad Zurenborgbrug,2023-03-01,16:00:00,301,109,192,FMN 06 B Zurenborgbrug Ringfietspad
655,Ringfietspad Zurenborgbrug,2023-03-01,17:00:00,417,153,264,FMN 06 B Zurenborgbrug Ringfietspad
655,Ringfietspad Zurenborgbrug,2023-03-01,18:00:00,272,116,156,FMN 06 B Zurenborgbrug Ringfietspad
655,Ringfietspad Zurenborgbrug,2023-03-01,19:00:00,131,48,83,FMN 06 B Zurenborgbrug Ringfietspad
655,Ringfietspad Zurenborgbrug,2023-03-01,20:00:00,90,35,55,FMN 06 B Zurenborgbrug Ringfietspad
655,Ringfietspad Zurenborgbrug,2023-03-01,21:00:00,85,39,46,FMN 06 B Zurenborgbrug Ringfietspad
655,Ringfietspad Zurenborgbrug,2023-03-01,22:00:00,81,25,56,FMN 06 B Zurenborgbrug Ringfietspad
655,Ringfietspad Zurenborgbrug,2023-03-01,23:00:00,23,12,11,FMN 06 B Zurenborgbrug Ringfietspad
655,Ringfietspad Zurenborgbrug,2023-03-02,00:00:00,11,5,6,FMN 06 B Zurenborgbrug Ringfietspad
655,Ringfietspad Zurenborgbrug,2023-03-02,01:00:00,3,1,2,FMN 06 B Zurenborgbrug Ringfietspad
655,Ringfietspad Zurenborgbrug,2023-03-02,02:00:00,2,0,2,FMN 06 B Zurenborgbrug Ringfietspad
655,Ringfietspad Zurenborgbrug,2023-03-02,03:00:00,3,1,2,FMN 06 B Zurenborgbrug Ringfietspad
655,Ringfietspad Zurenborgbrug,2023-03-02,04:00:00,14,7,7,FMN 06 B Zurenborgbrug Ringfietspad
655,Ringfietspad Zurenborgbrug,2023-03-02,05:00:00,48,28,20,FMN 06 B Zurenborgbrug Ringfietspad
655,Ringfietspad Zurenborgbrug,2023-03-02,06:00:00,113,69,44,FMN 06 B Zurenborgbrug Ringfietspad
655,Ringfietspad Zurenborgbrug,2023-03-02,07:00:00,366,219,147,FMN 06 B Zurenborgbrug Ringfietspad
655,Ringfietspad Zurenborgbrug,2023-03-02,08:00:00,609,337,272,FMN 06 B Zurenborgbrug Ringfietspad
655,Ringfietspad Zurenborgbrug,2023-03-02,09:00:00,154,100,54,FMN 06 B Zurenborgbrug Ringfietspad
655,Ringfietspad Zurenborgbrug,2023-03-02,10:00:00,105,57,48,FMN 06 B Zurenborgbrug Ringfietspad
655,Ringfietspad Zurenborgbrug,2023-03-02,11:00:00,107,55,52,FMN 06 B Zurenborgbrug Ringfietspad
655,Ringfietspad Zurenborgbrug,2023-03-02,12:00:00,180,87,93,FMN 06 B Zurenborgbrug Ringfietspad
655,Ringfietspad Zurenborgbrug,2023-03-02,13:00:00,182,84,98,FMN 06 B Zurenborgbrug Ringfietspad
655,Ringfietspad Zurenborgbrug,2023-03-02,14:00:00,160,70,90,FMN 06 B Zurenborgbrug Ringfietspad
655,Ringfietspad Zurenborgbrug,2023-03-02,15:00:00,249,90,159,FMN 06 B Zurenborgbrug Ringfietspad
655,Ringfietspad Zurenborgbrug,2023-03-02,16:00:00,476,196,280,FMN 06 B Zurenborgbrug Ringfietspad
655,Ringfietspad Zurenborgbrug,2023-03-02,17:00:00,494,183,311,FMN 06 B Zurenborgbrug Ringfietspad
655,Ringfietspad Zurenborgbrug,2023-03-02,18:00:00,307,123,184,FMN 06 B Zurenborgbrug Ringfietspad
655,Ringfietspad Zurenborgbrug,2023-03-02,19:00:00,209,62,147,FMN 06 B Zurenborgbrug Ringfietspad
655,Ringfietspad Zurenborgbrug,2023-03-02,20:00:00,86,28,58,FMN 06 B Zurenborgbrug Ringfietspad
655,Ringfietspad Zurenborgbrug,2023-03-02,21:00:00,67,25,42,FMN 06 B Zurenborgbrug Ringfietspad
655,Ringfietspad Zurenborgbrug,2023-03-02,22:00:00,83,29,54,FMN 06 B Zurenborgbrug Ringfietspad
655,Ringfietspad Zurenborgbrug,2023-03-02,23:00:00,53,31,22,FMN 06 B Zurenborgbrug Ringfietspad
655,Ringfietspad Zurenborgbrug,2023-03-03,00:00:00,70,63,7,FMN 06 B Zurenborgbrug Ringfietspad
655,Ringfietspad Zurenborgbrug,2023-03-03,01:00:00,25,21,4,FMN 06 B Zurenborgbrug Ringfietspad
655,Ringfietspad Zurenborgbrug,2023-03-03,02:00:00,6,3,3,FMN 06 B Zurenborgbrug Ringfietspad
655,Ringfietspad Zurenborgbrug,2023-03-03,03:00:00,4,3,1,FMN 06 B Zurenborgbrug Ringfietspad
655,Ringfietspad Zurenborgbrug,2023-03-03,04:00:00,10,6,4,FMN 06 B Zurenborgbrug Ringfietspad
655,Ringfietspad Zurenborgbrug,2023-03-03,05:00:00,41,22,19,FMN 06 B Zurenborgbrug Ringfietspad
655,Ringfietspad Zurenborgbrug,2023-03-03,06:00:00,103,66,37,FMN 06 B Zurenborgbrug Ringfietspad
655,Ringfietspad Zurenborgbrug,2023-03-03,07:00:00,285,165,120,FMN 06 B Zurenborgbrug Ringfietspad
655,Ringfietspad Zurenborgbrug,2023-03-03,08:00:00,502,275,227,FMN 06 B Zurenborgbrug Ringfietspad
655,Ringfietspad Zurenborgbrug,2023-03-03,09:00:00,130,71,59,FMN 06 B Zurenborgbrug Ringfietspad
655,Ringfietspad Zurenborgbrug,2023-03-03,10:00:00,86,50,36,FMN 06 B Zurenborgbrug Ringfietspad
655,Ringfietspad Zurenborgbrug,2023-03-03,11:00:00,78,37,41,FMN 06 B Zurenborgbrug Ringfietspad
655,Ringfietspad Zurenborgbrug,2023-03-03,12:00:00,148,69,79,FMN 06 B Zurenborgbrug Ringfietspad
655,Ringfietspad Zurenborgbrug,2023-03-03,13:00:00,142,60,82,FMN 06 B Zurenborgbrug Ringfietspad
655,Ringfietspad Zurenborgbrug,2023-03-03,14:00:00,153,74,79,FMN 06 B Zurenborgbrug Ringfietspad
655,Ringfietspad Zurenborgbrug,2023-03-03,15:00:00,229,86,143,FMN 06 B Zurenborgbrug Ringfietspad
655,Ringfietspad Zurenborgbrug,2023-03-03,16:00:00,395,161,234,FMN 06 B Zurenborgbrug Ringfietspad
655,Ringfietspad Zurenborgbrug,2023-03-03,17:00:00,332,121,211,FMN 06 B Zurenborgbrug Ringfietspad
655,Ringfietspad Zurenborgbrug,2023-03-03,18:00:00,229,92,137,FMN 06 B Zurenborgbrug Ringfietspad
655,Ringfietspad Zurenborgbrug,2023-03-03,19:00:00,118,51,67,FMN 06 B Zurenborgbrug Ringfietspad
655,Ringfietspad Zurenborgbrug,2023-03-03,20:00:00,85,42,43,FMN 06 B Zurenborgbrug Ringfietspad
655,Ringfietspad Zurenborgbrug,2023-03-03,21:00:00,50,16,34,FMN 06 B Zurenborgbrug Ringfietspad
655,Ringfietspad Zurenborgbrug,2023-03-03,22:00:00,78,37,41,FMN 06 B Zurenborgbrug Ringfietspad
655,Ringfietspad Zurenborgbrug,2023-03-03,23:00:00,33,11,22,FMN 06 B Zurenborgbrug Ringfietspad
655,Ringfietspad Zurenborgbrug,2023-03-04,00:00:00,39,16,23,FMN 06 B Zurenborgbrug Ringfietspad
655,Ringfietspad Zurenborgbrug,2023-03-04,01:00:00,11,5,6,FMN 06 B Zurenborgbrug Ringfietspad
655,Ringfietspad Zurenborgbrug,2023-03-04,02:00:00,6,3,3,FMN 06 B Zurenborgbrug Ringfietspad
655,Ringfietspad Zurenborgbrug,2023-03-04,03:00:00,7,2,5,FMN 06 B Zurenborgbrug Ringfietspad
655,Ringfietspad Zurenborgbrug,2023-03-04,04:00:00,9,7,2,FMN 06 B Zurenborgbrug Ringfietspad
655,Ringfietspad Zurenborgbrug,2023-03-04,05:00:00,7,4,3,FMN 06 B Zurenborgbrug Ringfietspad
655,Ringfietspad Zurenborgbrug,2023-03-04,06:00:00,22,14,8,FMN 06 B Zurenborgbrug Ringfietspad
655,Ringfietspad Zurenborgbrug,2023-03-04,07:00:00,25,18,7,FMN 06 B Zurenborgbrug Ringfietspad
655,Ringfietspad Zurenborgbrug,2023-03-04,08:00:00,42,17,25,FMN 06 B Zurenborgbrug Ringfietspad
655,Ringfietspad Zurenborgbrug,2023-03-04,09:00:00,101,21,80,FMN 06 B Zurenborgbrug Ringfietspad
655,Ringfietspad Zurenborgbrug,2023-03-04,10:00:00,90,41,49,FMN 06 B Zurenborgbrug Ringfietspad
655,Ringfietspad Zurenborgbrug,2023-03-04,11:00:00,92,43,49,FMN 06 B Zurenborgbrug Ringfietspad
655,Ringfietspad Zurenborgbrug,2023-03-04,12:00:00,126,58,68,FMN 06 B Zurenborgbrug Ringfietspad
655,Ringfietspad Zurenborgbrug,2023-03-04,13:00:00,112,54,58,FMN 06 B Zurenborgbrug Ringfietspad
655,Ringfietspad Zurenborgbrug,2023-03-04,14:00:00,112,48,64,FMN 06 B Zurenborgbrug Ringfietspad
655,Ringfietspad Zurenborgbrug,2023-03-04,15:00:00,100,46,54,FMN 06 B Zurenborgbrug Ringfietspad
655,Ringfietspad Zurenborgbrug,2023-03-04,16:00:00,82,42,40,FMN 06 B Zurenborgbrug Ringfietspad
655,Ringfietspad Zurenborgbrug,2023-03-04,17:00:00,100,51,49,FMN 06 B Zurenborgbrug Ringfietspad
655,Ringfietspad Zurenborgbrug,2023-03-04,18:00:00,89,36,53,FMN 06 B Zurenborgbrug Ringfietspad
655,Ringfietspad Zurenborgbrug,2023-03-04,19:00:00,70,27,43,FMN 06 B Zurenborgbrug Ringfietspad
655,Ringfietspad Zurenborgbrug,2023-03-04,20:00:00,43,21,22,FMN 06 B Zurenborgbrug Ringfietspad
655,Ringfietspad Zurenborgbrug,2023-03-04,21:00:00,29,11,18,FMN 06 B Zurenborgbrug Ringfietspad
655,Ringfietspad Zurenborgbrug,2023-03-04,22:00:00,52,18,34,FMN 06 B Zurenborgbrug Ringfietspad
655,Ringfietspad Zurenborgbrug,2023-03-04,23:00:00,47,22,25,FMN 06 B Zurenborgbrug Ringfietspad
655,Ringfietspad Zurenborgbrug,2023-03-05,00:00:00,30,18,12,FMN 06 B Zurenborgbrug Ringfietspad
655,Ringfietspad Zurenborgbrug,2023-03-05,01:00:00,24,10,14,FMN 06 B Zurenborgbrug Ringfietspad
655,Ringfietspad Zurenborgbrug,2023-03-05,02:00:00,15,4,11,FMN 06 B Zurenborgbrug Ringfietspad
655,Ringfietspad Zurenborgbrug,2023-03-05,03:00:00,10,5,5,FMN 06 B Zurenborgbrug Ringfietspad
655,Ringfietspad Zurenborgbrug,2023-03-05,04:00:00,5,3,2,FMN 06 B Zurenborgbrug Ringfietspad
655,Ringfietspad Zurenborgbrug,2023-03-05,05:00:00,10,6,4,FMN 06 B Zurenborgbrug Ringfietspad
655,Ringfietspad Zurenborgbrug,2023-03-05,06:00:00,11,5,6,FMN 06 B Zurenborgbrug Ringfietspad
655,Ringfietspad Zurenborgbrug,2023-03-05,07:00:00,17,5,12,FMN 06 B Zurenborgbrug Ringfietspad
655,Ringfietspad Zurenborgbrug,2023-03-05,08:00:00,43,14,29,FMN 06 B Zurenborgbrug Ringfietspad
655,Ringfietspad Zurenborgbrug,2023-03-05,09:00:00,50,18,32,FMN 06 B Zurenborgbrug Ringfietspad
655,Ringfietspad Zurenborgbrug,2023-03-05,10:00:00,82,30,52,FMN 06 B Zurenborgbrug Ringfietspad
655,Ringfietspad Zurenborgbrug,2023-03-05,11:00:00,61,20,41,FMN 06 B Zurenborgbrug Ringfietspad
655,Ringfietspad Zurenborgbrug,2023-03-05,12:00:00,102,52,50,FMN 06 B Zurenborgbrug Ringfietspad
655,Ringfietspad Zurenborgbrug,2023-03-05,13:00:00,101,54,47,FMN 06 B Zurenborgbrug Ringfietspad
655,Ringfietspad Zurenborgbrug,2023-03-05,14:00:00,137,49,88,FMN 06 B Zurenborgbrug Ringfietspad
655,Ringfietspad Zurenborgbrug,2023-03-05,15:00:00,131,34,97,FMN 06 B Zurenborgbrug Ringfietspad
655,Ringfietspad Zurenborgbrug,2023-03-05,16:00:00,61,26,35,FMN 06 B Zurenborgbrug Ringfietspad
655,Ringfietspad Zurenborgbrug,2023-03-05,17:00:00,65,46,19,FMN 06 B Zurenborgbrug Ringfietspad
655,Ringfietspad Zurenborgbrug,2023-03-05,18:00:00,118,82,36,FMN 06 B Zurenborgbrug Ringfietspad
655,Ringfietspad Zurenborgbrug,2023-03-05,19:00:00,73,48,25,FMN 06 B Zurenborgbrug Ringfietspad
655,Ringfietspad Zurenborgbrug,2023-03-05,20:00:00,47,27,20,FMN 06 B Zurenborgbrug Ringfietspad
655,Ringfietspad Zurenborgbrug,2023-03-05,21:00:00,29,10,19,FMN 06 B Zurenborgbrug Ringfietspad
655,Ringfietspad Zurenborgbrug,2023-03-05,22:00:00,28,11,17,FMN 06 B Zurenborgbrug Ringfietspad
655,Ringfietspad Zurenborgbrug,2023-03-05,23:00:00,10,3,7,FMN 06 B Zurenborgbrug Ringfietspad
655,Ringfietspad Zurenborgbrug,2023-03-06,00:00:00,9,6,3,FMN 06 B Zurenborgbrug Ringfietspad
655,Ringfietspad Zurenborgbrug,2023-03-06,01:00:00,2,0,2,FMN 06 B Zurenborgbrug Ringfietspad
655,Ringfietspad Zurenborgbrug,2023-03-06,02:00:00,2,0,2,FMN 06 B Zurenborgbrug Ringfietspad
655,Ringfietspad Zurenborgbrug,2023-03-06,03:00:00,6,2,4,FMN 06 B Zurenborgbrug Ringfietspad
655,Ringfietspad Zurenborgbrug,2023-03-06,04:00:00,13,6,7,FMN 06 B Zurenborgbrug Ringfietspad
655,Ringfietspad Zurenborgbrug,2023-03-06,05:00:00,43,20,23,FMN 06 B Zurenborgbrug Ringfietspad
655,Ringfietspad Zurenborgbrug,2023-03-06,06:00:00,96,47,49,FMN 06 B Zurenborgbrug Ringfietspad
655,Ringfietspad Zurenborgbrug,2023-03-06,07:00:00,353,207,146,FMN 06 B Zurenborgbrug Ringfietspad
655,Ringfietspad Zurenborgbrug,2023-03-06,08:00:00,556,309,247,FMN 06 B Zurenborgbrug Ringfietspad
655,Ringfietspad Zurenborgbrug,2023-03-06,09:00:00,127,79,48,FMN 06 B Zurenborgbrug Ringfietspad
655,Ringfietspad Zurenborgbrug,2023-03-06,10:00:00,75,41,34,FMN 06 B Zurenborgbrug Ringfietspad
655,Ringfietspad Zurenborgbrug,2023-03-06,11:00:00,73,31,42,FMN 06 B Zurenborgbrug Ringfietspad
655,Ringfietspad Zurenborgbrug,2023-03-06,12:00:00,129,74,55,FMN 06 B Zurenborgbrug Ringfietspad
655,Ringfietspad Zurenborgbrug,2023-03-06,13:00:00,139,67,72,FMN 06 B Zurenborgbrug Ringfietspad
655,Ringfietspad Zurenborgbrug,2023-03-06,14:00:00,136,55,81,FMN 06 B Zurenborgbrug Ringfietspad
655,Ringfietspad Zurenborgbrug,2023-03-06,15:00:00,239,97,142,FMN 06 B Zurenborgbrug Ringfietspad
655,Ringfietspad Zurenborgbrug,2023-03-06,16:00:00,466,185,281,FMN 06 B Zurenborgbrug Ringfietspad
655,Ringfietspad Zurenborgbrug,2023-03-06,17:00:00,423,141,282,FMN 06 B Zurenborgbrug Ringfietspad
655,Ringfietspad Zurenborgbrug,2023-03-06,18:00:00,253,104,149,FMN 06 B Zurenborgbrug Ringfietspad
655,Ringfietspad Zurenborgbrug,2023-03-06,19:00:00,87,32,55,FMN 06 B Zurenborgbrug Ringfietspad
655,Ringfietspad Zurenborgbrug,2023-03-06,20:00:00,65,26,39,FMN 06 B Zurenborgbrug Ringfietspad
655,Ringfietspad Zurenborgbrug,2023-03-06,21:00:00,62,28,34,FMN 06 B Zurenborgbrug Ringfietspad
655,Ringfietspad Zurenborgbrug,2023-03-06,22:00:00,64,23,41,FMN 06 B Zurenborgbrug Ringfietspad
655,Ringfietspad Zurenborgbrug,2023-03-06,23:00:00,21,12,9,FMN 06 B Zurenborgbrug Ringfietspad
655,Ringfietspad Zurenborgbrug,2023-03-07,00:00:00,4,2,2,FMN 06 B Zurenborgbrug Ringfietspad
655,Ringfietspad Zurenborgbrug,2023-03-07,01:00:00,5,1,4,FMN 06 B Zurenborgbrug Ringfietspad
655,Ringfietspad Zurenborgbrug,2023-03-07,02:00:00,2,2,0,FMN 06 B Zurenborgbrug Ringfietspad
655,Ringfietspad Zurenborgbrug,2023-03-07,03:00:00,2,2,0,FMN 06 B Zurenborgbrug Ringfietspad
655,Ringfietspad Zurenborgbrug,2023-03-07,04:00:00,13,7,6,FMN 06 B Zurenborgbrug Ringfietspad
655,Ringfietspad Zurenborgbrug,2023-03-07,05:00:00,44,23,21,FMN 06 B Zurenborgbrug Ringfietspad
655,Ringfietspad Zurenborgbrug,2023-03-07,06:00:00,103,54,49,FMN 06 B Zurenborgbrug Ringfietspad
655,Ringfietspad Zurenborgbrug,2023-03-07,07:00:00,330,200,130,FMN 06 B Zurenborgbrug Ringfietspad
655,Ringfietspad Zurenborgbrug,2023-03-07,08:00:00,484,276,208,FMN 06 B Zurenborgbrug Ringfietspad
655,Ringfietspad Zurenborgbrug,2023-03-07,09:00:00,109,62,47,FMN 06 B Zurenborgbrug Ringfietspad
655,Ringfietspad Zurenborgbrug,2023-03-07,10:00:00,61,30,31,FMN 06 B Zurenborgbrug Ringfietspad
655,Ringfietspad Zurenborgbrug,2023-03-07,11:00:00,58,28,30,FMN 06 B Zurenborgbrug Ringfietspad
655,Ringfietspad Zurenborgbrug,2023-03-07,12:00:00,79,40,39,FMN 06 B Zurenborgbrug Ringfietspad
655,Ringfietspad Zurenborgbrug,2023-03-07,13:00:00,101,48,53,FMN 06 B Zurenborgbrug Ringfietspad
655,Ringfietspad Zurenborgbrug,2023-03-07,14:00:00,82,35,47,FMN 06 B Zurenborgbrug Ringfietspad
655,Ringfietspad Zurenborgbrug,2023-03-07,15:00:00,165,65,100,FMN 06 B Zurenborgbrug Ringfietspad
655,Ringfietspad Zurenborgbrug,2023-03-07,16:00:00,356,140,216,FMN 06 B Zurenborgbrug Ringfietspad
655,Ringfietspad Zurenborgbrug,2023-03-07,17:00:00,324,112,212,FMN 06 B Zurenborgbrug Ringfietspad
655,Ringfietspad Zurenborgbrug,2023-03-07,18:00:00,212,76,136,FMN 06 B Zurenborgbrug Ringfietspad
655,Ringfietspad Zurenborgbrug,2023-03-07,19:00:00,93,35,58,FMN 06 B Zurenborgbrug Ringfietspad
655,Ringfietspad Zurenborgbrug,2023-03-07,20:00:00,46,20,26,FMN 06 B Zurenborgbrug Ringfietspad
655,Ringfietspad Zurenborgbrug,2023-03-07,21:00:00,64,31,33,FMN 06 B Zurenborgbrug Ringfietspad
655,Ringfietspad Zurenborgbrug,2023-03-07,22:00:00,58,23,35,FMN 06 B Zurenborgbrug Ringfietspad
655,Ringfietspad Zurenborgbrug,2023-03-07,23:00:00,18,6,12,FMN 06 B Zurenborgbrug Ringfietspad
655,Ringfietspad Zurenborgbrug,2023-03-08,00:00:00,4,1,3,FMN 06 B Zurenborgbrug Ringfietspad
655,Ringfietspad Zurenborgbrug,2023-03-08,01:00:00,0,0,0,FMN 06 B Zurenborgbrug Ringfietspad
655,Ringfietspad Zurenborgbrug,2023-03-08,02:00:00,1,1,0,FMN 06 B Zurenborgbrug Ringfietspad
655,Ringfietspad Zurenborgbrug,2023-03-08,03:00:00,3,1,2,FMN 06 B Zurenborgbrug Ringfietspad
655,Ringfietspad Zurenborgbrug,2023-03-08,04:00:00,12,8,4,FMN 06 B Zurenborgbrug Ringfietspad
655,Ringfietspad Zurenborgbrug,2023-03-08,05:00:00,32,17,15,FMN 06 B Zurenborgbrug Ringfietspad
655,Ringfietspad Zurenborgbrug,2023-03-08,06:00:00,70,38,32,FMN 06 B Zurenborgbrug Ringfietspad
655,Ringfietspad Zurenborgbrug,2023-03-08,07:00:00,202,106,96,FMN 06 B Zurenborgbrug Ringfietspad
655,Ringfietspad Zurenborgbrug,2023-03-08,08:00:00,275,139,136,FMN 06 B Zurenborgbrug Ringfietspad
655,Ringfietspad Zurenborgbrug,2023-03-08,09:00:00,68,39,29,FMN 06 B Zurenborgbrug Ringfietspad
655,Ringfietspad Zurenborgbrug,2023-03-08,10:00:00,40,28,12,FMN 06 B Zurenborgbrug Ringfietspad
655,Ringfietspad Zurenborgbrug,2023-03-08,11:00:00,48,20,28,FMN 06 B Zurenborgbrug Ringfietspad
655,Ringfietspad Zurenborgbrug,2023-03-08,12:00:00,161,81,80,FMN 06 B Zurenborgbrug Ringfietspad
655,Ringfietspad Zurenborgbrug,2023-03-08,13:00:00,126,45,81,FMN 06 B Zurenborgbrug Ringfietspad
655,Ringfietspad Zurenborgbrug,2023-03-08,14:00:00,87,43,44,FMN 06 B Zurenborgbrug Ringfietspad
655,Ringfietspad Zurenborgbrug,2023-03-08,15:00:00,121,50,71,FMN 06 B Zurenborgbrug Ringfietspad
655,Ringfietspad Zurenborgbrug,2023-03-08,16:00:00,194,81,113,FMN 06 B Zurenborgbrug Ringfietspad
655,Ringfietspad Zurenborgbrug,2023-03-08,17:00:00,207,73,134,FMN 06 B Zurenborgbrug Ringfietspad
655,Ringfietspad Zurenborgbrug,2023-03-08,18:00:00,139,58,81,FMN 06 B Zurenborgbrug Ringfietspad
655,Ringfietspad Zurenborgbrug,2023-03-08,19:00:00,98,36,62,FMN 06 B Zurenborgbrug Ringfietspad
655,Ringfietspad Zurenborgbrug,2023-03-08,20:00:00,50,23,27,FMN 06 B Zurenborgbrug Ringfietspad
655,Ringfietspad Zurenborgbrug,2023-03-08,21:00:00,51,20,31,FMN 06 B Zurenborgbrug Ringfietspad
655,Ringfietspad Zurenborgbrug,2023-03-08,22:00:00,44,20,24,FMN 06 B Zurenborgbrug Ringfietspad
655,Ringfietspad Zurenborgbrug,2023-03-08,23:00:00,9,4,5,FMN 06 B Zurenborgbrug Ringfietspad
655,Ringfietspad Zurenborgbrug,2023-03-09,00:00:00,5,2,3,FMN 06 B Zurenborgbrug Ringfietspad
655,Ringfietspad Zurenborgbrug,2023-03-09,01:00:00,1,0,1,FMN 06 B Zurenborgbrug Ringfietspad
655,Ringfietspad Zurenborgbrug,2023-03-09,02:00:00,2,2,0,FMN 06 B Zurenborgbrug Ringfietspad
655,Ringfietspad Zurenborgbrug,2023-03-09,03:00:00,1,0,1,FMN 06 B Zurenborgbrug Ringfietspad
655,Ringfietspad Zurenborgbrug,2023-03-09,04:00:00,12,7,5,FMN 06 B Zurenborgbrug Ringfietspad
655,Ringfietspad Zurenborgbrug,2023-03-09,05:00:00,30,14,16,FMN 06 B Zurenborgbrug Ringfietspad
655,Ringfietspad Zurenborgbrug,2023-03-09,06:00:00,75,43,32,FMN 06 B Zurenborgbrug Ringfietspad
655,Ringfietspad Zurenborgbrug,2023-03-09,07:00:00,298,172,126,FMN 06 B Zurenborgbrug Ringfietspad
655,Ringfietspad Zurenborgbrug,2023-03-09,08:00:00,473,265,208,FMN 06 B Zurenborgbrug Ringfietspad
655,Ringfietspad Zurenborgbrug,2023-03-09,09:00:00,121,72,49,FMN 06 B Zurenborgbrug Ringfietspad
655,Ringfietspad Zurenborgbrug,2023-03-09,10:00:00,79,46,33,FMN 06 B Zurenborgbrug Ringfietspad
655,Ringfietspad Zurenborgbrug,2023-03-09,11:00:00,65,25,40,FMN 06 B Zurenborgbrug Ringfietspad
655,Ringfietspad Zurenborgbrug,2023-03-09,12:00:00,107,45,62,FMN 06 B Zurenborgbrug Ringfietspad
655,Ringfietspad Zurenborgbrug,2023-03-09,13:00:00,86,45,41,FMN 06 B Zurenborgbrug Ringfietspad
655,Ringfietspad Zurenborgbrug,2023-03-09,14:00:00,89,43,46,FMN 06 B Zurenborgbrug Ringfietspad
655,Ringfietspad Zurenborgbrug,2023-03-09,15:00:00,153,58,95,FMN 06 B Zurenborgbrug Ringfietspad
655,Ringfietspad Zurenborgbrug,2023-03-09,16:00:00,384,148,236,FMN 06 B Zurenborgbrug Ringfietspad
655,Ringfietspad Zurenborgbrug,2023-03-09,17:00:00,297,107,190,FMN 06 B Zurenborgbrug Ringfietspad
655,Ringfietspad Zurenborgbrug,2023-03-09,18:00:00,216,80,136,FMN 06 B Zurenborgbrug Ringfietspad
655,Ringfietspad Zurenborgbrug,2023-03-09,19:00:00,74,27,47,FMN 06 B Zurenborgbrug Ringfietspad
655,Ringfietspad Zurenborgbrug,2023-03-09,20:00:00,75,31,44,FMN 06 B Zurenborgbrug Ringfietspad
655,Ringfietspad Zurenborgbrug,2023-03-09,21:00:00,46,19,27,FMN 06 B Zurenborgbrug Ringfietspad
655,Ringfietspad Zurenborgbrug,2023-03-09,22:00:00,44,21,23,FMN 06 B Zurenborgbrug Ringfietspad
655,Ringfietspad Zurenborgbrug,2023-03-09,23:00:00,13,7,6,FMN 06 B Zurenborgbrug Ringfietspad
655,Ringfietspad Zurenborgbrug,2023-03-10,00:00:00,14,6,8,FMN 06 B Zurenborgbrug Ringfietspad
655,Ringfietspad Zurenborgbrug,2023-03-10,01:00:00,3,1,2,FMN 06 B Zurenborgbrug Ringfietspad
655,Ringfietspad Zurenborgbrug,2023-03-10,02:00:00,2,1,1,FMN 06 B Zurenborgbrug Ringfietspad
655,Ringfietspad Zurenborgbrug,2023-03-10,03:00:00,2,1,1,FMN 06 B Zurenborgbrug Ringfietspad
655,Ringfietspad Zurenborgbrug,2023-03-10,04:00:00,13,8,5,FMN 06 B Zurenborgbrug Ringfietspad
655,Ringfietspad Zurenborgbrug,2023-03-10,05:00:00,25,13,12,FMN 06 B Zurenborgbrug Ringfietspad
655,Ringfietspad Zurenborgbrug,2023-03-10,06:00:00,60,35,25,FMN 06 B Zurenborgbrug Ringfietspad
655,Ringfietspad Zurenborgbrug,2023-03-10,07:00:00,235,121,114,FMN 06 B Zurenborgbrug Ringfietspad
655,Ringfietspad Zurenborgbrug,2023-03-10,08:00:00,420,232,188,FMN 06 B Zurenborgbrug Ringfietspad
655,Ringfietspad Zurenborgbrug,2023-03-10,09:00:00,105,57,48,FMN 06 B Zurenborgbrug Ringfietspad
655,Ringfietspad Zurenborgbrug,2023-03-10,10:00:00,60,31,29,FMN 06 B Zurenborgbrug Ringfietspad
655,Ringfietspad Zurenborgbrug,2023-03-10,11:00:00,70,33,37,FMN 06 B Zurenborgbrug Ringfietspad
655,Ringfietspad Zurenborgbrug,2023-03-10,12:00:00,108,47,61,FMN 06 B Zurenborgbrug Ringfietspad
655,Ringfietspad Zurenborgbrug,2023-03-10,13:00:00,102,48,54,FMN 06 B Zurenborgbrug Ringfietspad
655,Ringfietspad Zurenborgbrug,2023-03-10,14:00:00,101,46,55,FMN 06 B Zurenborgbrug Ringfietspad
655,Ringfietspad Zurenborgbrug,2023-03-10,15:00:00,166,53,113,FMN 06 B Zurenborgbrug Ringfietspad
655,Ringfietspad Zurenborgbrug,2023-03-10,16:00:00,298,130,168,FMN 06 B Zurenborgbrug Ringfietspad
655,Ringfietspad Zurenborgbrug,2023-03-10,17:00:00,261,109,152,FMN 06 B Zurenborgbrug Ringfietspad
655,Ringfietspad Zurenborgbrug,2023-03-10,18:00:00,144,56,88,FMN 06 B Zurenborgbrug Ringfietspad
655,Ringfietspad Zurenborgbrug,2023-03-10,19:00:00,83,34,49,FMN 06 B Zurenborgbrug Ringfietspad
655,Ringfietspad Zurenborgbrug,2023-03-10,20:00:00,64,20,44,FMN 06 B Zurenborgbrug Ringfietspad
655,Ringfietspad Zurenborgbrug,2023-03-10,21:00:00,42,21,21,FMN 06 B Zurenborgbrug Ringfietspad
655,Ringfietspad Zurenborgbrug,2023-03-10,22:00:00,42,16,26,FMN 06 B Zurenborgbrug Ringfietspad
655,Ringfietspad Zurenborgbrug,2023-03-10,23:00:00,45,23,22,FMN 06 B Zurenborgbrug Ringfietspad
655,Ringfietspad Zurenborgbrug,2023-03-11,00:00:00,41,23,18,FMN 06 B Zurenborgbrug Ringfietspad
655,Ringfietspad Zurenborgbrug,2023-03-11,01:00:00,9,3,6,FMN 06 B Zurenborgbrug Ringfietspad
655,Ringfietspad Zurenborgbrug,2023-03-11,02:00:00,8,4,4,FMN 06 B Zurenborgbrug Ringfietspad
655,Ringfietspad Zurenborgbrug,2023-03-11,03:00:00,13,5,8,FMN 06 B Zurenborgbrug Ringfietspad
655,Ringfietspad Zurenborgbrug,2023-03-11,04:00:00,8,5,3,FMN 06 B Zurenborgbrug Ringfietspad
655,Ringfietspad Zurenborgbrug,2023-03-11,05:00:00,10,1,9,FMN 06 B Zurenborgbrug Ringfietspad
655,Ringfietspad Zurenborgbrug,2023-03-11,06:00:00,11,9,2,FMN 06 B Zurenborgbrug Ringfietspad
655,Ringfietspad Zurenborgbrug,2023-03-11,07:00:00,22,13,9,FMN 06 B Zurenborgbrug Ringfietspad
655,Ringfietspad Zurenborgbrug,2023-03-11,08:00:00,49,18,31,FMN 06 B Zurenborgbrug Ringfietspad
655,Ringfietspad Zurenborgbrug,2023-03-11,09:00:00,69,32,37,FMN 06 B Zurenborgbrug Ringfietspad
655,Ringfietspad Zurenborgbrug,2023-03-11,10:00:00,98,43,55,FMN 06 B Zurenborgbrug Ringfietspad
655,Ringfietspad Zurenborgbrug,2023-03-11,11:00:00,100,45,55,FMN 06 B Zurenborgbrug Ringfietspad
655,Ringfietspad Zurenborgbrug,2023-03-11,12:00:00,120,63,57,FMN 06 B Zurenborgbrug Ringfietspad
655,Ringfietspad Zurenborgbrug,2023-03-11,13:00:00,162,69,93,FMN 06 B Zurenborgbrug Ringfietspad
655,Ringfietspad Zurenborgbrug,2023-03-11,14:00:00,176,74,102,FMN 06 B Zurenborgbrug Ringfietspad
655,Ringfietspad Zurenborgbrug,2023-03-11,15:00:00,136,56,80,FMN 06 B Zurenborgbrug Ringfietspad
655,Ringfietspad Zurenborgbrug,2023-03-11,16:00:00,163,74,89,FMN 06 B Zurenborgbrug Ringfietspad
655,Ringfietspad Zurenborgbrug,2023-03-11,17:00:00,166,69,97,FMN 06 B Zurenborgbrug Ringfietspad
655,Ringfietspad Zurenborgbrug,2023-03-11,18:00:00,118,63,55,FMN 06 B Zurenborgbrug Ringfietspad
655,Ringfietspad Zurenborgbrug,2023-03-11,19:00:00,87,33,54,FMN 06 B Zurenborgbrug Ringfietspad
655,Ringfietspad Zurenborgbrug,2023-03-11,20:00:00,51,17,34,FMN 06 B Zurenborgbrug Ringfietspad
655,Ringfietspad Zurenborgbrug,2023-03-11,21:00:00,56,22,34,FMN 06 B Zurenborgbrug Ringfietspad
655,Ringfietspad Zurenborgbrug,2023-03-11,22:00:00,45,17,28,FMN 06 B Zurenborgbrug Ringfietspad
655,Ringfietspad Zurenborgbrug,2023-03-11,23:00:00,55,32,23,FMN 06 B Zurenborgbrug Ringfietspad
655,Ringfietspad Zurenborgbrug,2023-03-12,00:00:00,36,15,21,FMN 06 B Zurenborgbrug Ringfietspad
655,Ringfietspad Zurenborgbrug,2023-03-12,01:00:00,11,4,7,FMN 06 B Zurenborgbrug Ringfietspad
655,Ringfietspad Zurenborgbrug,2023-03-12,02:00:00,13,4,9,FMN 06 B Zurenborgbrug Ringfietspad
655,Ringfietspad Zurenborgbrug,2023-03-12,03:00:00,8,4,4,FMN 06 B Zurenborgbrug Ringfietspad
655,Ringfietspad Zurenborgbrug,2023-03-12,04:00:00,6,2,4,FMN 06 B Zurenborgbrug Ringfietspad
655,Ringfietspad Zurenborgbrug,2023-03-12,05:00:00,12,11,1,FMN 06 B Zurenborgbrug Ringfietspad
655,Ringfietspad Zurenborgbrug,2023-03-12,06:00:00,14,9,5,FMN 06 B Zurenborgbrug Ringfietspad
655,Ringfietspad Zurenborgbrug,2023-03-12,07:00:00,16,5,11,FMN 06 B Zurenborgbrug Ringfietspad
655,Ringfietspad Zurenborgbrug,2023-03-12,08:00:00,31,13,18,FMN 06 B Zurenborgbrug Ringfietspad
655,Ringfietspad Zurenborgbrug,2023-03-12,09:00:00,73,33,40,FMN 06 B Zurenborgbrug Ringfietspad
655,Ringfietspad Zurenborgbrug,2023-03-12,10:00:00,62,27,35,FMN 06 B Zurenborgbrug Ringfietspad
655,Ringfietspad Zurenborgbrug,2023-03-12,11:00:00,90,32,58,FMN 06 B Zurenborgbrug Ringfietspad
655,Ringfietspad Zurenborgbrug,2023-03-12,12:00:00,91,44,47,FMN 06 B Zurenborgbrug Ringfietspad
655,Ringfietspad Zurenborgbrug,2023-03-12,13:00:00,99,51,48,FMN 06 B Zurenborgbrug Ringfietspad
655,Ringfietspad Zurenborgbrug,2023-03-12,14:00:00,95,41,54,FMN 06 B Zurenborgbrug Ringfietspad
655,Ringfietspad Zurenborgbrug,2023-03-12,15:00:00,91,38,53,FMN 06 B Zurenborgbrug Ringfietspad
655,Ringfietspad Zurenborgbrug,2023-03-12,16:00:00,110,49,61,FMN 06 B Zurenborgbrug Ringfietspad
655,Ringfietspad Zurenborgbrug,2023-03-12,17:00:00,84,49,35,FMN 06 B Zurenborgbrug Ringfietspad
655,Ringfietspad Zurenborgbrug,2023-03-12,18:00:00,70,41,29,FMN 06 B Zurenborgbrug Ringfietspad
655,Ringfietspad Zurenborgbrug,2023-03-12,19:00:00,43,17,26,FMN 06 B Zurenborgbrug Ringfietspad
655,Ringfietspad Zurenborgbrug,2023-03-12,20:00:00,39,18,21,FMN 06 B Zurenborgbrug Ringfietspad
655,Ringfietspad Zurenborgbrug,2023-03-12,21:00:00,21,12,9,FMN 06 B Zurenborgbrug Ringfietspad
655,Ringfietspad Zurenborgbrug,2023-03-12,22:00:00,28,13,15,FMN 06 B Zurenborgbrug Ringfietspad
655,Ringfietspad Zurenborgbrug,2023-03-12,23:00:00,7,4,3,FMN 06 B Zurenborgbrug Ringfietspad
655,Ringfietspad Zurenborgbrug,2023-03-13,00:00:00,4,2,2,FMN 06 B Zurenborgbrug Ringfietspad
655,Ringfietspad Zurenborgbrug,2023-03-13,01:00:00,4,0,4,FMN 06 B Zurenborgbrug Ringfietspad
655,Ringfietspad Zurenborgbrug,2023-03-13,02:00:00,1,0,1,FMN 06 B Zurenborgbrug Ringfietspad
655,Ringfietspad Zurenborgbrug,2023-03-13,03:00:00,3,3,0,FMN 06 B Zurenborgbrug Ringfietspad
655,Ringfietspad Zurenborgbrug,2023-03-13,04:00:00,13,9,4,FMN 06 B Zurenborgbrug Ringfietspad
655,Ringfietspad Zurenborgbrug,2023-03-13,05:00:00,49,24,25,FMN 06 B Zurenborgbrug Ringfietspad
655,Ringfietspad Zurenborgbrug,2023-03-13,06:00:00,100,55,45,FMN 06 B Zurenborgbrug Ringfietspad
655,Ringfietspad Zurenborgbrug,2023-03-13,07:00:00,350,199,151,FMN 06 B Zurenborgbrug Ringfietspad
655,Ringfietspad Zurenborgbrug,2023-03-13,08:00:00,534,309,225,FMN 06 B Zurenborgbrug Ringfietspad
655,Ringfietspad Zurenborgbrug,2023-03-13,09:00:00,122,66,56,FMN 06 B Zurenborgbrug Ringfietspad
655,Ringfietspad Zurenborgbrug,2023-03-13,10:00:00,82,48,34,FMN 06 B Zurenborgbrug Ringfietspad
655,Ringfietspad Zurenborgbrug,2023-03-13,11:00:00,76,33,43,FMN 06 B Zurenborgbrug Ringfietspad
655,Ringfietspad Zurenborgbrug,2023-03-13,12:00:00,134,65,69,FMN 06 B Zurenborgbrug Ringfietspad
655,Ringfietspad Zurenborgbrug,2023-03-13,13:00:00,153,78,75,FMN 06 B Zurenborgbrug Ringfietspad
655,Ringfietspad Zurenborgbrug,2023-03-13,14:00:00,139,58,81,FMN 06 B Zurenborgbrug Ringfietspad
655,Ringfietspad Zurenborgbrug,2023-03-13,15:00:00,252,100,152,FMN 06 B Zurenborgbrug Ringfietspad
655,Ringfietspad Zurenborgbrug,2023-03-13,16:00:00,434,204,230,FMN 06 B Zurenborgbrug Ringfietspad
655,Ringfietspad Zurenborgbrug,2023-03-13,17:00:00,409,156,253,FMN 06 B Zurenborgbrug Ringfietspad
655,Ringfietspad Zurenborgbrug,2023-03-13,18:00:00,270,122,148,FMN 06 B Zurenborgbrug Ringfietspad
655,Ringfietspad Zurenborgbrug,2023-03-13,19:00:00,141,43,98,FMN 06 B Zurenborgbrug Ringfietspad
655,Ringfietspad Zurenborgbrug,2023-03-13,20:00:00,88,38,50,FMN 06 B Zurenborgbrug Ringfietspad
655,Ringfietspad Zurenborgbrug,2023-03-13,21:00:00,72,24,48,FMN 06 B Zurenborgbrug Ringfietspad
655,Ringfietspad Zurenborgbrug,2023-03-13,22:00:00,81,35,46,FMN 06 B Zurenborgbrug Ringfietspad
655,Ringfietspad Zurenborgbrug,2023-03-13,23:00:00,18,12,6,FMN 06 B Zurenborgbrug Ringfietspad
655,Ringfietspad Zurenborgbrug,2023-03-14,00:00:00,5,4,1,FMN 06 B Zurenborgbrug Ringfietspad
655,Ringfietspad Zurenborgbrug,2023-03-14,01:00:00,5,1,4,FMN 06 B Zurenborgbrug Ringfietspad
655,Ringfietspad Zurenborgbrug,2023-03-14,02:00:00,1,0,1,FMN 06 B Zurenborgbrug Ringfietspad
655,Ringfietspad Zurenborgbrug,2023-03-14,03:00:00,6,5,1,FMN 06 B Zurenborgbrug Ringfietspad
655,Ringfietspad Zurenborgbrug,2023-03-14,04:00:00,12,5,7,FMN 06 B Zurenborgbrug Ringfietspad
655,Ringfietspad Zurenborgbrug,2023-03-14,05:00:00,52,30,22,FMN 06 B Zurenborgbrug Ringfietspad
655,Ringfietspad Zurenborgbrug,2023-03-14,06:00:00,118,67,51,FMN 06 B Zurenborgbrug Ringfietspad
655,Ringfietspad Zurenborgbrug,2023-03-14,07:00:00,324,186,138,FMN 06 B Zurenborgbrug Ringfietspad
655,Ringfietspad Zurenborgbrug,2023-03-14,08:00:00,526,295,231,FMN 06 B Zurenborgbrug Ringfietspad
655,Ringfietspad Zurenborgbrug,2023-03-14,09:00:00,123,85,38,FMN 06 B Zurenborgbrug Ringfietspad
655,Ringfietspad Zurenborgbrug,2023-03-14,10:00:00,61,34,27,FMN 06 B Zurenborgbrug Ringfietspad
655,Ringfietspad Zurenborgbrug,2023-03-14,11:00:00,59,35,24,FMN 06 B Zurenborgbrug Ringfietspad
655,Ringfietspad Zurenborgbrug,2023-03-14,12:00:00,117,49,68,FMN 06 B Zurenborgbrug Ringfietspad
655,Ringfietspad Zurenborgbrug,2023-03-14,13:00:00,116,50,66,FMN 06 B Zurenborgbrug Ringfietspad
655,Ringfietspad Zurenborgbrug,2023-03-14,14:00:00,120,51,69,FMN 06 B Zurenborgbrug Ringfietspad
655,Ringfietspad Zurenborgbrug,2023-03-14,15:00:00,237,119,118,FMN 06 B Zurenborgbrug Ringfietspad
655,Ringfietspad Zurenborgbrug,2023-03-14,16:00:00,393,153,240,FMN 06 B Zurenborgbrug Ringfietspad
655,Ringfietspad Zurenborgbrug,2023-03-14,17:00:00,379,133,246,FMN 06 B Zurenborgbrug Ringfietspad
655,Ringfietspad Zurenborgbrug,2023-03-14,18:00:00,247,94,153,FMN 06 B Zurenborgbrug Ringfietspad
655,Ringfietspad Zurenborgbrug,2023-03-14,19:00:00,130,49,81,FMN 06 B Zurenborgbrug Ringfietspad
655,Ringfietspad Zurenborgbrug,2023-03-14,20:00:00,75,36,39,FMN 06 B Zurenborgbrug Ringfietspad
655,Ringfietspad Zurenborgbrug,2023-03-14,21:00:00,68,27,41,FMN 06 B Zurenborgbrug Ringfietspad
655,Ringfietspad Zurenborgbrug,2023-03-14,22:00:00,61,25,36,FMN 06 B Zurenborgbrug Ringfietspad
655,Ringfietspad Zurenborgbrug,2023-03-14,23:00:00,36,20,16,FMN 06 B Zurenborgbrug Ringfietspad
655,Ringfietspad Zurenborgbrug,2023-03-15,00:00:00,13,4,9,FMN 06 B Zurenborgbrug Ringfietspad
655,Ringfietspad Zurenborgbrug,2023-03-15,01:00:00,5,1,4,FMN 06 B Zurenborgbrug Ringfietspad
655,Ringfietspad Zurenborgbrug,2023-03-15,02:00:00,1,1,0,FMN 06 B Zurenborgbrug Ringfietspad
655,Ringfietspad Zurenborgbrug,2023-03-15,03:00:00,5,1,4,FMN 06 B Zurenborgbrug Ringfietspad
655,Ringfietspad Zurenborgbrug,2023-03-15,04:00:00,13,7,6,FMN 06 B Zurenborgbrug Ringfietspad
655,Ringfietspad Zurenborgbrug,2023-03-15,05:00:00,34,19,15,FMN 06 B Zurenborgbrug Ringfietspad
655,Ringfietspad Zurenborgbrug,2023-03-15,06:00:00,117,68,49,FMN 06 B Zurenborgbrug Ringfietspad
655,Ringfietspad Zurenborgbrug,2023-03-15,07:00:00,292,165,127,FMN 06 B Zurenborgbrug Ringfietspad
655,Ringfietspad Zurenborgbrug,2023-03-15,08:00:00,455,265,190,FMN 06 B Zurenborgbrug Ringfietspad
655,Ringfietspad Zurenborgbrug,2023-03-15,09:00:00,131,69,62,FMN 06 B Zurenborgbrug Ringfietspad
655,Ringfietspad Zurenborgbrug,2023-03-15,10:00:00,99,59,40,FMN 06 B Zurenborgbrug Ringfietspad
655,Ringfietspad Zurenborgbrug,2023-03-15,11:00:00,90,43,47,FMN 06 B Zurenborgbrug Ringfietspad
655,Ringfietspad Zurenborgbrug,2023-03-15,12:00:00,249,98,151,FMN 06 B Zurenborgbrug Ringfietspad
655,Ringfietspad Zurenborgbrug,2023-03-15,13:00:00,219,98,121,FMN 06 B Zurenborgbrug Ringfietspad
655,Ringfietspad Zurenborgbrug,2023-03-15,14:00:00,186,77,109,FMN 06 B Zurenborgbrug Ringfietspad
655,Ringfietspad Zurenborgbrug,2023-03-15,15:00:00,198,68,130,FMN 06 B Zurenborgbrug Ringfietspad
655,Ringfietspad Zurenborgbrug,2023-03-15,16:00:00,334,135,199,FMN 06 B Zurenborgbrug Ringfietspad
655,Ringfietspad Zurenborgbrug,2023-03-15,17:00:00,371,142,229,FMN 06 B Zurenborgbrug Ringfietspad
655,Ringfietspad Zurenborgbrug,2023-03-15,18:00:00,258,119,139,FMN 06 B Zurenborgbrug Ringfietspad
655,Ringfietspad Zurenborgbrug,2023-03-15,19:00:00,129,68,61,FMN 06 B Zurenborgbrug Ringfietspad
655,Ringfietspad Zurenborgbrug,2023-03-15,20:00:00,77,38,39,FMN 06 B Zurenborgbrug Ringfietspad
655,Ringfietspad Zurenborgbrug,2023-03-15,21:00:00,81,29,52,FMN 06 B Zurenborgbrug Ringfietspad
655,Ringfietspad Zurenborgbrug,2023-03-15,22:00:00,78,25,53,FMN 06 B Zurenborgbrug Ringfietspad
655,Ringfietspad Zurenborgbrug,2023-03-15,23:00:00,34,8,26,FMN 06 B Zurenborgbrug Ringfietspad
655,Ringfietspad Zurenborgbrug,2023-03-16,00:00:00,9,0,9,FMN 06 B Zurenborgbrug Ringfietspad
655,Ringfietspad Zurenborgbrug,2023-03-16,01:00:00,8,2,6,FMN 06 B Zurenborgbrug Ringfietspad
655,Ringfietspad Zurenborgbrug,2023-03-16,02:00:00,3,0,3,FMN 06 B Zurenborgbrug Ringfietspad
655,Ringfietspad Zurenborgbrug,2023-03-16,03:00:00,5,2,3,FMN 06 B Zurenborgbrug Ringfietspad
655,Ringfietspad Zurenborgbrug,2023-03-16,04:00:00,16,10,6,FMN 06 B Zurenborgbrug Ringfietspad
655,Ringfietspad Zurenborgbrug,2023-03-16,05:00:00,48,29,19,FMN 06 B Zurenborgbrug Ringfietspad
655,Ringfietspad Zurenborgbrug,2023-03-16,06:00:00,103,63,40,FMN 06 B Zurenborgbrug Ringfietspad
655,Ringfietspad Zurenborgbrug,2023-03-16,07:00:00,358,206,152,FMN 06 B Zurenborgbrug Ringfietspad
655,Ringfietspad Zurenborgbrug,2023-03-16,08:00:00,598,352,246,FMN 06 B Zurenborgbrug Ringfietspad
655,Ringfietspad Zurenborgbrug,2023-03-16,09:00:00,169,92,77,FMN 06 B Zurenborgbrug Ringfietspad
655,Ringfietspad Zurenborgbrug,2023-03-16,10:00:00,95,54,41,FMN 06 B Zurenborgbrug Ringfietspad
655,Ringfietspad Zurenborgbrug,2023-03-16,11:00:00,92,41,51,FMN 06 B Zurenborgbrug Ringfietspad
655,Ringfietspad Zurenborgbrug,2023-03-16,12:00:00,168,93,75,FMN 06 B Zurenborgbrug Ringfietspad
655,Ringfietspad Zurenborgbrug,2023-03-16,13:00:00,179,101,78,FMN 06 B Zurenborgbrug Ringfietspad
655,Ringfietspad Zurenborgbrug,2023-03-16,14:00:00,175,76,99,FMN 06 B Zurenborgbrug Ringfietspad
655,Ringfietspad Zurenborgbrug,2023-03-16,15:00:00,286,111,175,FMN 06 B Zurenborgbrug Ringfietspad
655,Ringfietspad Zurenborgbrug,2023-03-16,16:00:00,489,213,276,FMN 06 B Zurenborgbrug Ringfietspad
655,Ringfietspad Zurenborgbrug,2023-03-16,17:00:00,466,175,291,FMN 06 B Zurenborgbrug Ringfietspad
655,Ringfietspad Zurenborgbrug,2023-03-16,18:00:00,316,123,193,FMN 06 B Zurenborgbrug Ringfietspad
655,Ringfietspad Zurenborgbrug,2023-03-16,19:00:00,138,67,71,FMN 06 B Zurenborgbrug Ringfietspad
655,Ringfietspad Zurenborgbrug,2023-03-16,20:00:00,109,51,58,FMN 06 B Zurenborgbrug Ringfietspad
655,Ringfietspad Zurenborgbrug,2023-03-16,21:00:00,76,22,54,FMN 06 B Zurenborgbrug Ringfietspad
655,Ringfietspad Zurenborgbrug,2023-03-16,22:00:00,80,27,53,FMN 06 B Zurenborgbrug Ringfietspad
655,Ringfietspad Zurenborgbrug,2023-03-16,23:00:00,38,18,20,FMN 06 B Zurenborgbrug Ringfietspad
655,Ringfietspad Zurenborgbrug,2023-03-17,00:00:00,18,9,9,FMN 06 B Zurenborgbrug Ringfietspad
655,Ringfietspad Zurenborgbrug,2023-03-17,01:00:00,5,2,3,FMN 06 B Zurenborgbrug Ringfietspad
655,Ringfietspad Zurenborgbrug,2023-03-17,02:00:00,1,1,0,FMN 06 B Zurenborgbrug Ringfietspad
655,Ringfietspad Zurenborgbrug,2023-03-17,03:00:00,2,1,1,FMN 06 B Zurenborgbrug Ringfietspad
655,Ringfietspad Zurenborgbrug,2023-03-17,04:00:00,15,8,7,FMN 06 B Zurenborgbrug Ringfietspad
655,Ringfietspad Zurenborgbrug,2023-03-17,05:00:00,46,26,20,FMN 06 B Zurenborgbrug Ringfietspad
655,Ringfietspad Zurenborgbrug,2023-03-17,06:00:00,116,76,40,FMN 06 B Zurenborgbrug Ringfietspad
655,Ringfietspad Zurenborgbrug,2023-03-17,07:00:00,342,190,152,FMN 06 B Zurenborgbrug Ringfietspad
655,Ringfietspad Zurenborgbrug,2023-03-17,08:00:00,537,307,230,FMN 06 B Zurenborgbrug Ringfietspad
655,Ringfietspad Zurenborgbrug,2023-03-17,09:00:00,158,98,60,FMN 06 B Zurenborgbrug Ringfietspad
655,Ringfietspad Zurenborgbrug,2023-03-17,10:00:00,92,58,34,FMN 06 B Zurenborgbrug Ringfietspad
655,Ringfietspad Zurenborgbrug,2023-03-17,11:00:00,106,65,41,FMN 06 B Zurenborgbrug Ringfietspad
655,Ringfietspad Zurenborgbrug,2023-03-17,12:00:00,168,86,82,FMN 06 B Zurenborgbrug Ringfietspad
655,Ringfietspad Zurenborgbrug,2023-03-17,13:00:00,198,98,100,FMN 06 B Zurenborgbrug Ringfietspad
655,Ringfietspad Zurenborgbrug,2023-03-17,14:00:00,180,79,101,FMN 06 B Zurenborgbrug Ringfietspad
655,Ringfietspad Zurenborgbrug,2023-03-17,15:00:00,276,105,171,FMN 06 B Zurenborgbrug Ringfietspad
655,Ringfietspad Zurenborgbrug,2023-03-17,16:00:00,440,186,254,FMN 06 B Zurenborgbrug Ringfietspad
655,Ringfietspad Zurenborgbrug,2023-03-17,17:00:00,363,123,240,FMN 06 B Zurenborgbrug Ringfietspad
655,Ringfietspad Zurenborgbrug,2023-03-17,18:00:00,245,88,157,FMN 06 B Zurenborgbrug Ringfietspad
655,Ringfietspad Zurenborgbrug,2023-03-17,19:00:00,133,52,81,FMN 06 B Zurenborgbrug Ringfietspad
655,Ringfietspad Zurenborgbrug,2023-03-17,20:00:00,88,37,51,FMN 06 B Zurenborgbrug Ringfietspad
655,Ringfietspad Zurenborgbrug,2023-03-17,21:00:00,66,26,40,FMN 06 B Zurenborgbrug Ringfietspad
655,Ringfietspad Zurenborgbrug,2023-03-17,22:00:00,56,24,32,FMN 06 B Zurenborgbrug Ringfietspad
655,Ringfietspad Zurenborgbrug,2023-03-17,23:00:00,55,28,27,FMN 06 B Zurenborgbrug Ringfietspad
655,Ringfietspad Zurenborgbrug,2023-03-18,00:00:00,38,21,17,FMN 06 B Zurenborgbrug Ringfietspad
655,Ringfietspad Zurenborgbrug,2023-03-18,01:00:00,26,12,14,FMN 06 B Zurenborgbrug Ringfietspad
655,Ringfietspad Zurenborgbrug,2023-03-18,02:00:00,25,18,7,FMN 06 B Zurenborgbrug Ringfietspad
655,Ringfietspad Zurenborgbrug,2023-03-18,03:00:00,14,8,6,FMN 06 B Zurenborgbrug Ringfietspad
655,Ringfietspad Zurenborgbrug,2023-03-18,04:00:00,6,3,3,FMN 06 B Zurenborgbrug Ringfietspad
655,Ringfietspad Zurenborgbrug,2023-03-18,05:00:00,12,5,7,FMN 06 B Zurenborgbrug Ringfietspad
655,Ringfietspad Zurenborgbrug,2023-03-18,06:00:00,21,13,8,FMN 06 B Zurenborgbrug Ringfietspad
655,Ringfietspad Zurenborgbrug,2023-03-18,07:00:00,36,14,22,FMN 06 B Zurenborgbrug Ringfietspad
655,Ringfietspad Zurenborgbrug,2023-03-18,08:00:00,65,27,38,FMN 06 B Zurenborgbrug Ringfietspad
655,Ringfietspad Zurenborgbrug,2023-03-18,09:00:00,124,60,64,FMN 06 B Zurenborgbrug Ringfietspad
655,Ringfietspad Zurenborgbrug,2023-03-18,10:00:00,125,52,73,FMN 06 B Zurenborgbrug Ringfietspad
655,Ringfietspad Zurenborgbrug,2023-03-18,11:00:00,143,84,59,FMN 06 B Zurenborgbrug Ringfietspad
655,Ringfietspad Zurenborgbrug,2023-03-18,12:00:00,143,61,82,FMN 06 B Zurenborgbrug Ringfietspad
655,Ringfietspad Zurenborgbrug,2023-03-18,13:00:00,143,60,83,FMN 06 B Zurenborgbrug Ringfietspad
655,Ringfietspad Zurenborgbrug,2023-03-18,14:00:00,164,90,74,FMN 06 B Zurenborgbrug Ringfietspad
655,Ringfietspad Zurenborgbrug,2023-03-18,15:00:00,162,82,80,FMN 06 B Zurenborgbrug Ringfietspad
655,Ringfietspad Zurenborgbrug,2023-03-18,16:00:00,147,88,59,FMN 06 B Zurenborgbrug Ringfietspad
655,Ringfietspad Zurenborgbrug,2023-03-18,17:00:00,127,74,53,FMN 06 B Zurenborgbrug Ringfietspad
655,Ringfietspad Zurenborgbrug,2023-03-18,18:00:00,88,37,51,FMN 06 B Zurenborgbrug Ringfietspad
655,Ringfietspad Zurenborgbrug,2023-03-18,19:00:00,66,26,40,FMN 06 B Zurenborgbrug Ringfietspad
655,Ringfietspad Zurenborgbrug,2023-03-18,20:00:00,52,18,34,FMN 06 B Zurenborgbrug Ringfietspad
655,Ringfietspad Zurenborgbrug,2023-03-18,21:00:00,48,17,31,FMN 06 B Zurenborgbrug Ringfietspad
655,Ringfietspad Zurenborgbrug,2023-03-18,22:00:00,34,16,18,FMN 06 B Zurenborgbrug Ringfietspad
655,Ringfietspad Zurenborgbrug,2023-03-18,23:00:00,38,19,19,FMN 06 B Zurenborgbrug Ringfietspad
655,Ringfietspad Zurenborgbrug,2023-03-19,00:00:00,31,19,12,FMN 06 B Zurenborgbrug Ringfietspad
655,Ringfietspad Zurenborgbrug,2023-03-19,01:00:00,12,7,5,FMN 06 B Zurenborgbrug Ringfietspad
655,Ringfietspad Zurenborgbrug,2023-03-19,02:00:00,16,10,6,FMN 06 B Zurenborgbrug Ringfietspad
655,Ringfietspad Zurenborgbrug,2023-03-19,03:00:00,4,2,2,FMN 06 B Zurenborgbrug Ringfietspad
655,Ringfietspad Zurenborgbrug,2023-03-19,04:00:00,9,5,4,FMN 06 B Zurenborgbrug Ringfietspad
655,Ringfietspad Zurenborgbrug,2023-03-19,05:00:00,10,6,4,FMN 06 B Zurenborgbrug Ringfietspad
655,Ringfietspad Zurenborgbrug,2023-03-19,06:00:00,25,12,13,FMN 06 B Zurenborgbrug Ringfietspad
655,Ringfietspad Zurenborgbrug,2023-03-19,07:00:00,27,9,18,FMN 06 B Zurenborgbrug Ringfietspad
655,Ringfietspad Zurenborgbrug,2023-03-19,08:00:00,54,18,36,FMN 06 B Zurenborgbrug Ringfietspad
655,Ringfietspad Zurenborgbrug,2023-03-19,09:00:00,96,43,53,FMN 06 B Zurenborgbrug Ringfietspad
655,Ringfietspad Zurenborgbrug,2023-03-19,10:00:00,88,41,47,FMN 06 B Zurenborgbrug Ringfietspad
655,Ringfietspad Zurenborgbrug,2023-03-19,11:00:00,125,67,58,FMN 06 B Zurenborgbrug Ringfietspad
655,Ringfietspad Zurenborgbrug,2023-03-19,12:00:00,214,72,142,FMN 06 B Zurenborgbrug Ringfietspad
655,Ringfietspad Zurenborgbrug,2023-03-19,13:00:00,142,61,81,FMN 06 B Zurenborgbrug Ringfietspad
655,Ringfietspad Zurenborgbrug,2023-03-19,14:00:00,132,58,74,FMN 06 B Zurenborgbrug Ringfietspad
655,Ringfietspad Zurenborgbrug,2023-03-19,15:00:00,178,90,88,FMN 06 B Zurenborgbrug Ringfietspad
655,Ringfietspad Zurenborgbrug,2023-03-19,16:00:00,150,97,53,FMN 06 B Zurenborgbrug Ringfietspad
655,Ringfietspad Zurenborgbrug,2023-03-19,17:00:00,141,74,67,FMN 06 B Zurenborgbrug Ringfietspad
655,Ringfietspad Zurenborgbrug,2023-03-19,18:00:00,99,46,53,FMN 06 B Zurenborgbrug Ringfietspad
655,Ringfietspad Zurenborgbrug,2023-03-19,19:00:00,69,18,51,FMN 06 B Zurenborgbrug Ringfietspad
655,Ringfietspad Zurenborgbrug,2023-03-19,20:00:00,45,17,28,FMN 06 B Zurenborgbrug Ringfietspad
655,Ringfietspad Zurenborgbrug,2023-03-19,21:00:00,45,23,22,FMN 06 B Zurenborgbrug Ringfietspad
655,Ringfietspad Zurenborgbrug,2023-03-19,22:00:00,37,18,19,FMN 06 B Zurenborgbrug Ringfietspad
655,Ringfietspad Zurenborgbrug,2023-03-19,23:00:00,30,20,10,FMN 06 B Zurenborgbrug Ringfietspad
655,Ringfietspad Zurenborgbrug,2023-03-20,00:00:00,7,4,3,FMN 06 B Zurenborgbrug Ringfietspad
655,Ringfietspad Zurenborgbrug,2023-03-20,01:00:00,3,2,1,FMN 06 B Zurenborgbrug Ringfietspad
655,Ringfietspad Zurenborgbrug,2023-03-20,02:00:00,0,0,0,FMN 06 B Zurenborgbrug Ringfietspad
655,Ringfietspad Zurenborgbrug,2023-03-20,03:00:00,5,2,3,FMN 06 B Zurenborgbrug Ringfietspad
655,Ringfietspad Zurenborgbrug,2023-03-20,04:00:00,17,11,6,FMN 06 B Zurenborgbrug Ringfietspad
655,Ringfietspad Zurenborgbrug,2023-03-20,05:00:00,48,23,25,FMN 06 B Zurenborgbrug Ringfietspad
655,Ringfietspad Zurenborgbrug,2023-03-20,06:00:00,145,86,59,FMN 06 B Zurenborgbrug Ringfietspad
655,Ringfietspad Zurenborgbrug,2023-03-20,07:00:00,419,242,177,FMN 06 B Zurenborgbrug Ringfietspad
655,Ringfietspad Zurenborgbrug,2023-03-20,08:00:00,614,352,262,FMN 06 B Zurenborgbrug Ringfietspad
655,Ringfietspad Zurenborgbrug,2023-03-20,09:00:00,140,67,73,FMN 06 B Zurenborgbrug Ringfietspad
655,Ringfietspad Zurenborgbrug,2023-03-20,10:00:00,100,62,38,FMN 06 B Zurenborgbrug Ringfietspad
655,Ringfietspad Zurenborgbrug,2023-03-20,11:00:00,69,38,31,FMN 06 B Zurenborgbrug Ringfietspad
655,Ringfietspad Zurenborgbrug,2023-03-20,12:00:00,131,61,70,FMN 06 B Zurenborgbrug Ringfietspad
655,Ringfietspad Zurenborgbrug,2023-03-20,13:00:00,146,62,84,FMN 06 B Zurenborgbrug Ringfietspad
655,Ringfietspad Zurenborgbrug,2023-03-20,14:00:00,131,58,73,FMN 06 B Zurenborgbrug Ringfietspad
655,Ringfietspad Zurenborgbrug,2023-03-20,15:00:00,288,114,174,FMN 06 B Zurenborgbrug Ringfietspad
655,Ringfietspad Zurenborgbrug,2023-03-20,16:00:00,435,185,250,FMN 06 B Zurenborgbrug Ringfietspad
655,Ringfietspad Zurenborgbrug,2023-03-20,17:00:00,491,158,333,FMN 06 B Zurenborgbrug Ringfietspad
655,Ringfietspad Zurenborgbrug,2023-03-20,18:00:00,290,121,169,FMN 06 B Zurenborgbrug Ringfietspad
655,Ringfietspad Zurenborgbrug,2023-03-20,19:00:00,123,52,71,FMN 06 B Zurenborgbrug Ringfietspad
655,Ringfietspad Zurenborgbrug,2023-03-20,20:00:00,75,31,44,FMN 06 B Zurenborgbrug Ringfietspad
655,Ringfietspad Zurenborgbrug,2023-03-20,21:00:00,67,24,43,FMN 06 B Zurenborgbrug Ringfietspad
655,Ringfietspad Zurenborgbrug,2023-03-20,22:00:00,58,21,37,FMN 06 B Zurenborgbrug Ringfietspad
655,Ringfietspad Zurenborgbrug,2023-03-20,23:00:00,18,5,13,FMN 06 B Zurenborgbrug Ringfietspad
655,Ringfietspad Zurenborgbrug,2023-03-21,00:00:00,12,4,8,FMN 06 B Zurenborgbrug Ringfietspad
655,Ringfietspad Zurenborgbrug,2023-03-21,01:00:00,2,0,2,FMN 06 B Zurenborgbrug Ringfietspad
655,Ringfietspad Zurenborgbrug,2023-03-21,02:00:00,1,1,0,FMN 06 B Zurenborgbrug Ringfietspad
655,Ringfietspad Zurenborgbrug,2023-03-21,03:00:00,2,1,1,FMN 06 B Zurenborgbrug Ringfietspad
655,Ringfietspad Zurenborgbrug,2023-03-21,04:00:00,16,10,6,FMN 06 B Zurenborgbrug Ringfietspad
655,Ringfietspad Zurenborgbrug,2023-03-21,05:00:00,41,23,18,FMN 06 B Zurenborgbrug Ringfietspad
655,Ringfietspad Zurenborgbrug,2023-03-21,06:00:00,125,69,56,FMN 06 B Zurenborgbrug Ringfietspad
655,Ringfietspad Zurenborgbrug,2023-03-21,07:00:00,357,205,152,FMN 06 B Zurenborgbrug Ringfietspad
655,Ringfietspad Zurenborgbrug,2023-03-21,08:00:00,575,337,238,FMN 06 B Zurenborgbrug Ringfietspad
655,Ringfietspad Zurenborgbrug,2023-03-21,09:00:00,144,83,61,FMN 06 B Zurenborgbrug Ringfietspad
655,Ringfietspad Zurenborgbrug,2023-03-21,10:00:00,100,52,48,FMN 06 B Zurenborgbrug Ringfietspad
655,Ringfietspad Zurenborgbrug,2023-03-21,11:00:00,79,38,41,FMN 06 B Zurenborgbrug Ringfietspad
655,Ringfietspad Zurenborgbrug,2023-03-21,12:00:00,136,71,65,FMN 06 B Zurenborgbrug Ringfietspad
655,Ringfietspad Zurenborgbrug,2023-03-21,13:00:00,184,85,99,FMN 06 B Zurenborgbrug Ringfietspad
655,Ringfietspad Zurenborgbrug,2023-03-21,14:00:00,143,65,78,FMN 06 B Zurenborgbrug Ringfietspad
655,Ringfietspad Zurenborgbrug,2023-03-21,15:00:00,233,92,141,FMN 06 B Zurenborgbrug Ringfietspad
655,Ringfietspad Zurenborgbrug,2023-03-21,16:00:00,497,207,290,FMN 06 B Zurenborgbrug Ringfietspad
655,Ringfietspad Zurenborgbrug,2023-03-21,17:00:00,470,176,294,FMN 06 B Zurenborgbrug Ringfietspad
655,Ringfietspad Zurenborgbrug,2023-03-21,18:00:00,265,107,158,FMN 06 B Zurenborgbrug Ringfietspad
655,Ringfietspad Zurenborgbrug,2023-03-21,19:00:00,144,58,86,FMN 06 B Zurenborgbrug Ringfietspad
655,Ringfietspad Zurenborgbrug,2023-03-21,20:00:00,88,44,44,FMN 06 B Zurenborgbrug Ringfietspad
655,Ringfietspad Zurenborgbrug,2023-03-21,21:00:00,79,28,51,FMN 06 B Zurenborgbrug Ringfietspad
655,Ringfietspad Zurenborgbrug,2023-03-21,22:00:00,79,31,48,FMN 06 B Zurenborgbrug Ringfietspad
655,Ringfietspad Zurenborgbrug,2023-03-21,23:00:00,34,15,19,FMN 06 B Zurenborgbrug Ringfietspad
655,Ringfietspad Zurenborgbrug,2023-03-22,00:00:00,3,2,1,FMN 06 B Zurenborgbrug Ringfietspad
655,Ringfietspad Zurenborgbrug,2023-03-22,01:00:00,3,1,2,FMN 06 B Zurenborgbrug Ringfietspad
655,Ringfietspad Zurenborgbrug,2023-03-22,02:00:00,1,1,0,FMN 06 B Zurenborgbrug Ringfietspad
655,Ringfietspad Zurenborgbrug,2023-03-22,03:00:00,2,1,1,FMN 06 B Zurenborgbrug Ringfietspad
655,Ringfietspad Zurenborgbrug,2023-03-22,04:00:00,12,7,5,FMN 06 B Zurenborgbrug Ringfietspad
655,Ringfietspad Zurenborgbrug,2023-03-22,05:00:00,48,30,18,FMN 06 B Zurenborgbrug Ringfietspad
655,Ringfietspad Zurenborgbrug,2023-03-22,06:00:00,132,79,53,FMN 06 B Zurenborgbrug Ringfietspad
655,Ringfietspad Zurenborgbrug,2023-03-22,07:00:00,371,217,154,FMN 06 B Zurenborgbrug Ringfietspad
655,Ringfietspad Zurenborgbrug,2023-03-22,08:00:00,526,284,242,FMN 06 B Zurenborgbrug Ringfietspad
655,Ringfietspad Zurenborgbrug,2023-03-22,09:00:00,116,64,52,FMN 06 B Zurenborgbrug Ringfietspad
655,Ringfietspad Zurenborgbrug,2023-03-22,10:00:00,80,44,36,FMN 06 B Zurenborgbrug Ringfietspad
655,Ringfietspad Zurenborgbrug,2023-03-22,11:00:00,87,49,38,FMN 06 B Zurenborgbrug Ringfietspad
655,Ringfietspad Zurenborgbrug,2023-03-22,12:00:00,260,129,131,FMN 06 B Zurenborgbrug Ringfietspad
655,Ringfietspad Zurenborgbrug,2023-03-22,13:00:00,191,82,109,FMN 06 B Zurenborgbrug Ringfietspad
655,Ringfietspad Zurenborgbrug,2023-03-22,14:00:00,118,42,76,FMN 06 B Zurenborgbrug Ringfietspad
655,Ringfietspad Zurenborgbrug,2023-03-22,15:00:00,169,59,110,FMN 06 B Zurenborgbrug Ringfietspad
655,Ringfietspad Zurenborgbrug,2023-03-22,16:00:00,265,114,151,FMN 06 B Zurenborgbrug Ringfietspad
655,Ringfietspad Zurenborgbrug,2023-03-22,17:00:00,363,135,228,FMN 06 B Zurenborgbrug Ringfietspad
655,Ringfietspad Zurenborgbrug,2023-03-22,18:00:00,247,107,140,FMN 06 B Zurenborgbrug Ringfietspad
655,Ringfietspad Zurenborgbrug,2023-03-22,19:00:00,112,46,66,FMN 06 B Zurenborgbrug Ringfietspad
655,Ringfietspad Zurenborgbrug,2023-03-22,20:00:00,69,27,42,FMN 06 B Zurenborgbrug Ringfietspad
655,Ringfietspad Zurenborgbrug,2023-03-22,21:00:00,70,26,44,FMN 06 B Zurenborgbrug Ringfietspad
655,Ringfietspad Zurenborgbrug,2023-03-22,22:00:00,72,29,43,FMN 06 B Zurenborgbrug Ringfietspad
655,Ringfietspad Zurenborgbrug,2023-03-22,23:00:00,23,12,11,FMN 06 B Zurenborgbrug Ringfietspad
655,Ringfietspad Zurenborgbrug,2023-03-23,00:00:00,10,5,5,FMN 06 B Zurenborgbrug Ringfietspad
655,Ringfietspad Zurenborgbrug,2023-03-23,01:00:00,2,1,1,FMN 06 B Zurenborgbrug Ringfietspad
655,Ringfietspad Zurenborgbrug,2023-03-23,02:00:00,0,0,0,FMN 06 B Zurenborgbrug Ringfietspad
655,Ringfietspad Zurenborgbrug,2023-03-23,03:00:00,5,4,1,FMN 06 B Zurenborgbrug Ringfietspad
655,Ringfietspad Zurenborgbrug,2023-03-23,04:00:00,12,6,6,FMN 06 B Zurenborgbrug Ringfietspad
655,Ringfietspad Zurenborgbrug,2023-03-23,05:00:00,37,25,12,FMN 06 B Zurenborgbrug Ringfietspad
655,Ringfietspad Zurenborgbrug,2023-03-23,06:00:00,98,59,39,FMN 06 B Zurenborgbrug Ringfietspad
655,Ringfietspad Zurenborgbrug,2023-03-23,07:00:00,287,175,112,FMN 06 B Zurenborgbrug Ringfietspad
655,Ringfietspad Zurenborgbrug,2023-03-23,08:00:00,483,281,202,FMN 06 B Zurenborgbrug Ringfietspad
655,Ringfietspad Zurenborgbrug,2023-03-23,09:00:00,136,88,48,FMN 06 B Zurenborgbrug Ringfietspad
655,Ringfietspad Zurenborgbrug,2023-03-23,10:00:00,83,45,38,FMN 06 B Zurenborgbrug Ringfietspad
655,Ringfietspad Zurenborgbrug,2023-03-23,11:00:00,81,40,41,FMN 06 B Zurenborgbrug Ringfietspad
655,Ringfietspad Zurenborgbrug,2023-03-23,12:00:00,134,62,72,FMN 06 B Zurenborgbrug Ringfietspad
655,Ringfietspad Zurenborgbrug,2023-03-23,13:00:00,149,73,76,FMN 06 B Zurenborgbrug Ringfietspad
655,Ringfietspad Zurenborgbrug,2023-03-23,14:00:00,105,44,61,FMN 06 B Zurenborgbrug Ringfietspad
655,Ringfietspad Zurenborgbrug,2023-03-23,15:00:00,195,73,122,FMN 06 B Zurenborgbrug Ringfietspad
655,Ringfietspad Zurenborgbrug,2023-03-23,16:00:00,385,159,226,FMN 06 B Zurenborgbrug Ringfietspad
655,Ringfietspad Zurenborgbrug,2023-03-23,17:00:00,368,125,243,FMN 06 B Zurenborgbrug Ringfietspad
655,Ringfietspad Zurenborgbrug,2023-03-23,18:00:00,232,83,149,FMN 06 B Zurenborgbrug Ringfietspad
655,Ringfietspad Zurenborgbrug,2023-03-23,19:00:00,131,41,90,FMN 06 B Zurenborgbrug Ringfietspad
655,Ringfietspad Zurenborgbrug,2023-03-23,20:00:00,92,40,52,FMN 06 B Zurenborgbrug Ringfietspad
655,Ringfietspad Zurenborgbrug,2023-03-23,21:00:00,71,23,48,FMN 06 B Zurenborgbrug Ringfietspad
655,Ringfietspad Zurenborgbrug,2023-03-23,22:00:00,75,35,40,FMN 06 B Zurenborgbrug Ringfietspad
655,Ringfietspad Zurenborgbrug,2023-03-23,23:00:00,28,15,13,FMN 06 B Zurenborgbrug Ringfietspad
655,Ringfietspad Zurenborgbrug,2023-03-24,00:00:00,11,8,3,FMN 06 B Zurenborgbrug Ringfietspad
655,Ringfietspad Zurenborgbrug,2023-03-24,01:00:00,3,1,2,FMN 06 B Zurenborgbrug Ringfietspad
655,Ringfietspad Zurenborgbrug,2023-03-24,02:00:00,5,1,4,FMN 06 B Zurenborgbrug Ringfietspad
655,Ringfietspad Zurenborgbrug,2023-03-24,03:00:00,4,2,2,FMN 06 B Zurenborgbrug Ringfietspad
655,Ringfietspad Zurenborgbrug,2023-03-24,04:00:00,13,8,5,FMN 06 B Zurenborgbrug Ringfietspad
655,Ringfietspad Zurenborgbrug,2023-03-24,05:00:00,38,25,13,FMN 06 B Zurenborgbrug Ringfietspad
655,Ringfietspad Zurenborgbrug,2023-03-24,06:00:00,105,61,44,FMN 06 B Zurenborgbrug Ringfietspad
655,Ringfietspad Zurenborgbrug,2023-03-24,07:00:00,306,187,119,FMN 06 B Zurenborgbrug Ringfietspad
655,Ringfietspad Zurenborgbrug,2023-03-24,08:00:00,434,278,156,FMN 06 B Zurenborgbrug Ringfietspad
655,Ringfietspad Zurenborgbrug,2023-03-24,09:00:00,137,80,57,FMN 06 B Zurenborgbrug Ringfietspad
655,Ringfietspad Zurenborgbrug,2023-03-24,10:00:00,94,50,44,FMN 06 B Zurenborgbrug Ringfietspad
655,Ringfietspad Zurenborgbrug,2023-03-24,11:00:00,76,34,42,FMN 06 B Zurenborgbrug Ringfietspad
655,Ringfietspad Zurenborgbrug,2023-03-24,12:00:00,113,44,69,FMN 06 B Zurenborgbrug Ringfietspad
655,Ringfietspad Zurenborgbrug,2023-03-24,13:00:00,133,65,68,FMN 06 B Zurenborgbrug Ringfietspad
655,Ringfietspad Zurenborgbrug,2023-03-24,14:00:00,122,54,68,FMN 06 B Zurenborgbrug Ringfietspad
655,Ringfietspad Zurenborgbrug,2023-03-24,15:00:00,204,75,129,FMN 06 B Zurenborgbrug Ringfietspad
655,Ringfietspad Zurenborgbrug,2023-03-24,16:00:00,354,128,226,FMN 06 B Zurenborgbrug Ringfietspad
655,Ringfietspad Zurenborgbrug,2023-03-24,17:00:00,339,122,217,FMN 06 B Zurenborgbrug Ringfietspad
655,Ringfietspad Zurenborgbrug,2023-03-24,18:00:00,169,66,103,FMN 06 B Zurenborgbrug Ringfietspad
655,Ringfietspad Zurenborgbrug,2023-03-24,19:00:00,110,55,55,FMN 06 B Zurenborgbrug Ringfietspad
655,Ringfietspad Zurenborgbrug,2023-03-24,20:00:00,99,30,69,FMN 06 B Zurenborgbrug Ringfietspad
655,Ringfietspad Zurenborgbrug,2023-03-24,21:00:00,43,14,29,FMN 06 B Zurenborgbrug Ringfietspad
655,Ringfietspad Zurenborgbrug,2023-03-24,22:00:00,52,29,23,FMN 06 B Zurenborgbrug Ringfietspad
655,Ringfietspad Zurenborgbrug,2023-03-24,23:00:00,45,25,20,FMN 06 B Zurenborgbrug Ringfietspad
655,Ringfietspad Zurenborgbrug,2023-03-25,00:00:00,31,18,13,FMN 06 B Zurenborgbrug Ringfietspad
655,Ringfietspad Zurenborgbrug,2023-03-25,01:00:00,15,7,8,FMN 06 B Zurenborgbrug Ringfietspad
655,Ringfietspad Zurenborgbrug,2023-03-25,02:00:00,9,4,5,FMN 06 B Zurenborgbrug Ringfietspad
655,Ringfietspad Zurenborgbrug,2023-03-25,03:00:00,6,1,5,FMN 06 B Zurenborgbrug Ringfietspad
655,Ringfietspad Zurenborgbrug,2023-03-25,04:00:00,6,2,4,FMN 06 B Zurenborgbrug Ringfietspad
655,Ringfietspad Zurenborgbrug,2023-03-25,05:00:00,5,2,3,FMN 06 B Zurenborgbrug Ringfietspad
655,Ringfietspad Zurenborgbrug,2023-03-25,06:00:00,20,15,5,FMN 06 B Zurenborgbrug Ringfietspad
655,Ringfietspad Zurenborgbrug,2023-03-25,07:00:00,25,15,10,FMN 06 B Zurenborgbrug Ringfietspad
655,Ringfietspad Zurenborgbrug,2023-03-25,08:00:00,41,17,24,FMN 06 B Zurenborgbrug Ringfietspad
655,Ringfietspad Zurenborgbrug,2023-03-25,09:00:00,74,29,45,FMN 06 B Zurenborgbrug Ringfietspad
655,Ringfietspad Zurenborgbrug,2023-03-25,10:00:00,68,36,32,FMN 06 B Zurenborgbrug Ringfietspad
655,Ringfietspad Zurenborgbrug,2023-03-25,11:00:00,96,37,59,FMN 06 B Zurenborgbrug Ringfietspad
655,Ringfietspad Zurenborgbrug,2023-03-25,12:00:00,72,31,41,FMN 06 B Zurenborgbrug Ringfietspad
655,Ringfietspad Zurenborgbrug,2023-03-25,13:00:00,105,61,44,FMN 06 B Zurenborgbrug Ringfietspad
655,Ringfietspad Zurenborgbrug,2023-03-25,14:00:00,103,38,65,FMN 06 B Zurenborgbrug Ringfietspad
655,Ringfietspad Zurenborgbrug,2023-03-25,15:00:00,109,65,44,FMN 06 B Zurenborgbrug Ringfietspad
655,Ringfietspad Zurenborgbrug,2023-03-25,16:00:00,78,41,37,FMN 06 B Zurenborgbrug Ringfietspad
655,Ringfietspad Zurenborgbrug,2023-03-25,17:00:00,108,53,55,FMN 06 B Zurenborgbrug Ringfietspad
655,Ringfietspad Zurenborgbrug,2023-03-25,18:00:00,82,34,48,FMN 06 B Zurenborgbrug Ringfietspad
655,Ringfietspad Zurenborgbrug,2023-03-25,19:00:00,89,31,58,FMN 06 B Zurenborgbrug Ringfietspad
655,Ringfietspad Zurenborgbrug,2023-03-25,20:00:00,76,33,43,FMN 06 B Zurenborgbrug Ringfietspad
655,Ringfietspad Zurenborgbrug,2023-03-25,21:00:00,35,18,17,FMN 06 B Zurenborgbrug Ringfietspad
655,Ringfietspad Zurenborgbrug,2023-03-25,22:00:00,52,30,22,FMN 06 B Zurenborgbrug Ringfietspad
655,Ringfietspad Zurenborgbrug,2023-03-25,23:00:00,55,37,18,FMN 06 B Zurenborgbrug Ringfietspad
655,Ringfietspad Zurenborgbrug,2023-03-26,00:00:00,33,13,20,FMN 06 B Zurenborgbrug Ringfietspad
655,Ringfietspad Zurenborgbrug,2023-03-26,01:00:00,30,11,19,FMN 06 B Zurenborgbrug Ringfietspad
655,Ringfietspad Zurenborgbrug,2023-03-26,02:00:00,0,0,0,FMN 06 B Zurenborgbrug Ringfietspad
655,Ringfietspad Zurenborgbrug,2023-03-26,03:00:00,14,6,8,FMN 06 B Zurenborgbrug Ringfietspad
655,Ringfietspad Zurenborgbrug,2023-03-26,04:00:00,7,2,5,FMN 06 B Zurenborgbrug Ringfietspad
655,Ringfietspad Zurenborgbrug,2023-03-26,05:00:00,9,8,1,FMN 06 B Zurenborgbrug Ringfietspad
655,Ringfietspad Zurenborgbrug,2023-03-26,06:00:00,12,6,6,FMN 06 B Zurenborgbrug Ringfietspad
655,Ringfietspad Zurenborgbrug,2023-03-26,07:00:00,14,5,9,FMN 06 B Zurenborgbrug Ringfietspad
655,Ringfietspad Zurenborgbrug,2023-03-26,08:00:00,19,11,8,FMN 06 B Zurenborgbrug Ringfietspad
655,Ringfietspad Zurenborgbrug,2023-03-26,09:00:00,32,12,20,FMN 06 B Zurenborgbrug Ringfietspad
655,Ringfietspad Zurenborgbrug,2023-03-26,10:00:00,34,13,21,FMN 06 B Zurenborgbrug Ringfietspad
655,Ringfietspad Zurenborgbrug,2023-03-26,11:00:00,29,14,15,FMN 06 B Zurenborgbrug Ringfietspad
655,Ringfietspad Zurenborgbrug,2023-03-26,12:00:00,60,35,25,FMN 06 B Zurenborgbrug Ringfietspad
655,Ringfietspad Zurenborgbrug,2023-03-26,13:00:00,61,28,33,FMN 06 B Zurenborgbrug Ringfietspad
655,Ringfietspad Zurenborgbrug,2023-03-26,14:00:00,76,25,51,FMN 06 B Zurenborgbrug Ringfietspad
655,Ringfietspad Zurenborgbrug,2023-03-26,15:00:00,52,20,32,FMN 06 B Zurenborgbrug Ringfietspad
655,Ringfietspad Zurenborgbrug,2023-03-26,16:00:00,38,17,21,FMN 06 B Zurenborgbrug Ringfietspad
655,Ringfietspad Zurenborgbrug,2023-03-26,17:00:00,57,29,28,FMN 06 B Zurenborgbrug Ringfietspad
655,Ringfietspad Zurenborgbrug,2023-03-26,18:00:00,62,39,23,FMN 06 B Zurenborgbrug Ringfietspad
655,Ringfietspad Zurenborgbrug,2023-03-26,19:00:00,41,14,27,FMN 06 B Zurenborgbrug Ringfietspad
655,Ringfietspad Zurenborgbrug,2023-03-26,20:00:00,47,24,23,FMN 06 B Zurenborgbrug Ringfietspad
655,Ringfietspad Zurenborgbrug,2023-03-26,21:00:00,32,13,19,FMN 06 B Zurenborgbrug Ringfietspad
655,Ringfietspad Zurenborgbrug,2023-03-26,22:00:00,29,18,11,FMN 06 B Zurenborgbrug Ringfietspad
655,Ringfietspad Zurenborgbrug,2023-03-26,23:00:00,25,14,11,FMN 06 B Zurenborgbrug Ringfietspad
655,Ringfietspad Zurenborgbrug,2023-03-27,00:00:00,13,7,6,FMN 06 B Zurenborgbrug Ringfietspad
655,Ringfietspad Zurenborgbrug,2023-03-27,01:00:00,6,4,2,FMN 06 B Zurenborgbrug Ringfietspad
655,Ringfietspad Zurenborgbrug,2023-03-27,02:00:00,4,1,3,FMN 06 B Zurenborgbrug Ringfietspad
655,Ringfietspad Zurenborgbrug,2023-03-27,03:00:00,4,1,3,FMN 06 B Zurenborgbrug Ringfietspad
655,Ringfietspad Zurenborgbrug,2023-03-27,04:00:00,11,5,6,FMN 06 B Zurenborgbrug Ringfietspad
655,Ringfietspad Zurenborgbrug,2023-03-27,05:00:00,46,24,22,FMN 06 B Zurenborgbrug Ringfietspad
655,Ringfietspad Zurenborgbrug,2023-03-27,06:00:00,110,63,47,FMN 06 B Zurenborgbrug Ringfietspad
655,Ringfietspad Zurenborgbrug,2023-03-27,07:00:00,366,211,155,FMN 06 B Zurenborgbrug Ringfietspad
655,Ringfietspad Zurenborgbrug,2023-03-27,08:00:00,558,311,247,FMN 06 B Zurenborgbrug Ringfietspad
655,Ringfietspad Zurenborgbrug,2023-03-27,09:00:00,123,69,54,FMN 06 B Zurenborgbrug Ringfietspad
655,Ringfietspad Zurenborgbrug,2023-03-27,10:00:00,85,45,40,FMN 06 B Zurenborgbrug Ringfietspad
655,Ringfietspad Zurenborgbrug,2023-03-27,11:00:00,78,44,34,FMN 06 B Zurenborgbrug Ringfietspad
655,Ringfietspad Zurenborgbrug,2023-03-27,12:00:00,127,60,67,FMN 06 B Zurenborgbrug Ringfietspad
655,Ringfietspad Zurenborgbrug,2023-03-27,13:00:00,161,79,82,FMN 06 B Zurenborgbrug Ringfietspad
655,Ringfietspad Zurenborgbrug,2023-03-27,14:00:00,122,50,72,FMN 06 B Zurenborgbrug Ringfietspad
655,Ringfietspad Zurenborgbrug,2023-03-27,15:00:00,252,94,158,FMN 06 B Zurenborgbrug Ringfietspad
655,Ringfietspad Zurenborgbrug,2023-03-27,16:00:00,428,201,227,FMN 06 B Zurenborgbrug Ringfietspad
655,Ringfietspad Zurenborgbrug,2023-03-27,17:00:00,479,178,301,FMN 06 B Zurenborgbrug Ringfietspad
655,Ringfietspad Zurenborgbrug,2023-03-27,18:00:00,326,137,189,FMN 06 B Zurenborgbrug Ringfietspad
655,Ringfietspad Zurenborgbrug,2023-03-27,19:00:00,142,54,88,FMN 06 B Zurenborgbrug Ringfietspad
655,Ringfietspad Zurenborgbrug,2023-03-27,20:00:00,89,39,50,FMN 06 B Zurenborgbrug Ringfietspad
655,Ringfietspad Zurenborgbrug,2023-03-27,21:00:00,56,28,28,FMN 06 B Zurenborgbrug Ringfietspad
655,Ringfietspad Zurenborgbrug,2023-03-27,22:00:00,71,16,55,FMN 06 B Zurenborgbrug Ringfietspad
655,Ringfietspad Zurenborgbrug,2023-03-27,23:00:00,30,14,16,FMN 06 B Zurenborgbrug Ringfietspad
655,Ringfietspad Zurenborgbrug,2023-03-28,00:00:00,16,7,9,FMN 06 B Zurenborgbrug Ringfietspad
655,Ringfietspad Zurenborgbrug,2023-03-28,01:00:00,3,1,2,FMN 06 B Zurenborgbrug Ringfietspad
655,Ringfietspad Zurenborgbrug,2023-03-28,02:00:00,3,2,1,FMN 06 B Zurenborgbrug Ringfietspad
655,Ringfietspad Zurenborgbrug,2023-03-28,03:00:00,5,3,2,FMN 06 B Zurenborgbrug Ringfietspad
655,Ringfietspad Zurenborgbrug,2023-03-28,04:00:00,15,8,7,FMN 06 B Zurenborgbrug Ringfietspad
655,Ringfietspad Zurenborgbrug,2023-03-28,05:00:00,44,27,17,FMN 06 B Zurenborgbrug Ringfietspad
655,Ringfietspad Zurenborgbrug,2023-03-28,06:00:00,113,59,54,FMN 06 B Zurenborgbrug Ringfietspad
655,Ringfietspad Zurenborgbrug,2023-03-28,07:00:00,382,209,173,FMN 06 B Zurenborgbrug Ringfietspad
655,Ringfietspad Zurenborgbrug,2023-03-28,08:00:00,627,350,277,FMN 06 B Zurenborgbrug Ringfietspad
655,Ringfietspad Zurenborgbrug,2023-03-28,09:00:00,165,91,74,FMN 06 B Zurenborgbrug Ringfietspad
655,Ringfietspad Zurenborgbrug,2023-03-28,10:00:00,115,67,48,FMN 06 B Zurenborgbrug Ringfietspad
655,Ringfietspad Zurenborgbrug,2023-03-28,11:00:00,97,50,47,FMN 06 B Zurenborgbrug Ringfietspad
655,Ringfietspad Zurenborgbrug,2023-03-28,12:00:00,165,79,86,FMN 06 B Zurenborgbrug Ringfietspad
655,Ringfietspad Zurenborgbrug,2023-03-28,13:00:00,141,73,68,FMN 06 B Zurenborgbrug Ringfietspad
655,Ringfietspad Zurenborgbrug,2023-03-28,14:00:00,151,60,91,FMN 06 B Zurenborgbrug Ringfietspad
655,Ringfietspad Zurenborgbrug,2023-03-28,15:00:00,266,112,154,FMN 06 B Zurenborgbrug Ringfietspad
655,Ringfietspad Zurenborgbrug,2023-03-28,16:00:00,484,192,292,FMN 06 B Zurenborgbrug Ringfietspad
655,Ringfietspad Zurenborgbrug,2023-03-28,17:00:00,511,183,328,FMN 06 B Zurenborgbrug Ringfietspad
655,Ringfietspad Zurenborgbrug,2023-03-28,18:00:00,271,110,161,FMN 06 B Zurenborgbrug Ringfietspad
655,Ringfietspad Zurenborgbrug,2023-03-28,19:00:00,138,45,93,FMN 06 B Zurenborgbrug Ringfietspad
655,Ringfietspad Zurenborgbrug,2023-03-28,20:00:00,96,43,53,FMN 06 B Zurenborgbrug Ringfietspad
655,Ringfietspad Zurenborgbrug,2023-03-28,21:00:00,75,32,43,FMN 06 B Zurenborgbrug Ringfietspad
655,Ringfietspad Zurenborgbrug,2023-03-28,22:00:00,77,28,49,FMN 06 B Zurenborgbrug Ringfietspad
655,Ringfietspad Zurenborgbrug,2023-03-28,23:00:00,39,20,19,FMN 06 B Zurenborgbrug Ringfietspad
655,Ringfietspad Zurenborgbrug,2023-03-29,00:00:00,13,6,7,FMN 06 B Zurenborgbrug Ringfietspad
655,Ringfietspad Zurenborgbrug,2023-03-29,01:00:00,4,1,3,FMN 06 B Zurenborgbrug Ringfietspad
655,Ringfietspad Zurenborgbrug,2023-03-29,02:00:00,3,2,1,FMN 06 B Zurenborgbrug Ringfietspad
655,Ringfietspad Zurenborgbrug,2023-03-29,03:00:00,7,4,3,FMN 06 B Zurenborgbrug Ringfietspad
655,Ringfietspad Zurenborgbrug,2023-03-29,04:00:00,18,9,9,FMN 06 B Zurenborgbrug Ringfietspad
655,Ringfietspad Zurenborgbrug,2023-03-29,05:00:00,34,17,17,FMN 06 B Zurenborgbrug Ringfietspad
655,Ringfietspad Zurenborgbrug,2023-03-29,06:00:00,120,78,42,FMN 06 B Zurenborgbrug Ringfietspad
655,Ringfietspad Zurenborgbrug,2023-03-29,07:00:00,330,186,144,FMN 06 B Zurenborgbrug Ringfietspad
655,Ringfietspad Zurenborgbrug,2023-03-29,08:00:00,523,276,247,FMN 06 B Zurenborgbrug Ringfietspad
655,Ringfietspad Zurenborgbrug,2023-03-29,09:00:00,145,74,71,FMN 06 B Zurenborgbrug Ringfietspad
655,Ringfietspad Zurenborgbrug,2023-03-29,10:00:00,92,58,34,FMN 06 B Zurenborgbrug Ringfietspad
655,Ringfietspad Zurenborgbrug,2023-03-29,11:00:00,124,63,61,FMN 06 B Zurenborgbrug Ringfietspad
655,Ringfietspad Zurenborgbrug,2023-03-29,12:00:00,295,157,138,FMN 06 B Zurenborgbrug Ringfietspad
655,Ringfietspad Zurenborgbrug,2023-03-29,13:00:00,191,98,93,FMN 06 B Zurenborgbrug Ringfietspad
655,Ringfietspad Zurenborgbrug,2023-03-29,14:00:00,161,74,87,FMN 06 B Zurenborgbrug Ringfietspad
655,Ringfietspad Zurenborgbrug,2023-03-29,15:00:00,245,86,159,FMN 06 B Zurenborgbrug Ringfietspad
655,Ringfietspad Zurenborgbrug,2023-03-29,16:00:00,392,149,243,FMN 06 B Zurenborgbrug Ringfietspad
655,Ringfietspad Zurenborgbrug,2023-03-29,17:00:00,446,166,280,FMN 06 B Zurenborgbrug Ringfietspad
655,Ringfietspad Zurenborgbrug,2023-03-29,18:00:00,288,145,143,FMN 06 B Zurenborgbrug Ringfietspad
655,Ringfietspad Zurenborgbrug,2023-03-29,19:00:00,178,76,102,FMN 06 B Zurenborgbrug Ringfietspad
655,Ringfietspad Zurenborgbrug,2023-03-29,20:00:00,108,46,62,FMN 06 B Zurenborgbrug Ringfietspad
655,Ringfietspad Zurenborgbrug,2023-03-29,21:00:00,87,30,57,FMN 06 B Zurenborgbrug Ringfietspad
655,Ringfietspad Zurenborgbrug,2023-03-29,22:00:00,90,31,59,FMN 06 B Zurenborgbrug Ringfietspad
655,Ringfietspad Zurenborgbrug,2023-03-29,23:00:00,40,22,18,FMN 06 B Zurenborgbrug Ringfietspad
655,Ringfietspad Zurenborgbrug,2023-03-30,00:00:00,11,5,6,FMN 06 B Zurenborgbrug Ringfietspad
655,Ringfietspad Zurenborgbrug,2023-03-30,01:00:00,10,7,3,FMN 06 B Zurenborgbrug Ringfietspad
655,Ringfietspad Zurenborgbrug,2023-03-30,02:00:00,3,2,1,FMN 06 B Zurenborgbrug Ringfietspad
655,Ringfietspad Zurenborgbrug,2023-03-30,03:00:00,5,3,2,FMN 06 B Zurenborgbrug Ringfietspad
655,Ringfietspad Zurenborgbrug,2023-03-30,04:00:00,19,12,7,FMN 06 B Zurenborgbrug Ringfietspad
655,Ringfietspad Zurenborgbrug,2023-03-30,05:00:00,42,24,18,FMN 06 B Zurenborgbrug Ringfietspad
655,Ringfietspad Zurenborgbrug,2023-03-30,06:00:00,94,54,40,FMN 06 B Zurenborgbrug Ringfietspad
655,Ringfietspad Zurenborgbrug,2023-03-30,07:00:00,334,188,146,FMN 06 B Zurenborgbrug Ringfietspad
655,Ringfietspad Zurenborgbrug,2023-03-30,08:00:00,589,342,247,FMN 06 B Zurenborgbrug Ringfietspad
655,Ringfietspad Zurenborgbrug,2023-03-30,09:00:00,163,98,65,FMN 06 B Zurenborgbrug Ringfietspad
655,Ringfietspad Zurenborgbrug,2023-03-30,10:00:00,99,58,41,FMN 06 B Zurenborgbrug Ringfietspad
655,Ringfietspad Zurenborgbrug,2023-03-30,11:00:00,97,48,49,FMN 06 B Zurenborgbrug Ringfietspad
655,Ringfietspad Zurenborgbrug,2023-03-30,12:00:00,137,64,73,FMN 06 B Zurenborgbrug Ringfietspad
655,Ringfietspad Zurenborgbrug,2023-03-30,13:00:00,135,59,76,FMN 06 B Zurenborgbrug Ringfietspad
655,Ringfietspad Zurenborgbrug,2023-03-30,14:00:00,129,58,71,FMN 06 B Zurenborgbrug Ringfietspad
655,Ringfietspad Zurenborgbrug,2023-03-30,15:00:00,208,89,119,FMN 06 B Zurenborgbrug Ringfietspad
655,Ringfietspad Zurenborgbrug,2023-03-30,16:00:00,423,184,239,FMN 06 B Zurenborgbrug Ringfietspad
655,Ringfietspad Zurenborgbrug,2023-03-30,17:00:00,394,151,243,FMN 06 B Zurenborgbrug Ringfietspad
655,Ringfietspad Zurenborgbrug,2023-03-30,18:00:00,251,101,150,FMN 06 B Zurenborgbrug Ringfietspad
655,Ringfietspad Zurenborgbrug,2023-03-30,19:00:00,149,54,95,FMN 06 B Zurenborgbrug Ringfietspad
655,Ringfietspad Zurenborgbrug,2023-03-30,20:00:00,99,46,53,FMN 06 B Zurenborgbrug Ringfietspad
655,Ringfietspad Zurenborgbrug,2023-03-30,21:00:00,83,29,54,FMN 06 B Zurenborgbrug Ringfietspad
655,Ringfietspad Zurenborgbrug,2023-03-30,22:00:00,102,39,63,FMN 06 B Zurenborgbrug Ringfietspad
655,Ringfietspad Zurenborgbrug,2023-03-30,23:00:00,33,9,24,FMN 06 B Zurenborgbrug Ringfietspad
655,Ringfietspad Zurenborgbrug,2023-03-31,00:00:00,22,8,14,FMN 06 B Zurenborgbrug Ringfietspad
655,Ringfietspad Zurenborgbrug,2023-03-31,01:00:00,12,6,6,FMN 06 B Zurenborgbrug Ringfietspad
655,Ringfietspad Zurenborgbrug,2023-03-31,02:00:00,7,3,4,FMN 06 B Zurenborgbrug Ringfietspad
655,Ringfietspad Zurenborgbrug,2023-03-31,03:00:00,4,3,1,FMN 06 B Zurenborgbrug Ringfietspad
655,Ringfietspad Zurenborgbrug,2023-03-31,04:00:00,9,7,2,FMN 06 B Zurenborgbrug Ringfietspad
655,Ringfietspad Zurenborgbrug,2023-03-31,05:00:00,28,18,10,FMN 06 B Zurenborgbrug Ringfietspad
655,Ringfietspad Zurenborgbrug,2023-03-31,06:00:00,64,38,26,FMN 06 B Zurenborgbrug Ringfietspad
655,Ringfietspad Zurenborgbrug,2023-03-31,07:00:00,188,106,82,FMN 06 B Zurenborgbrug Ringfietspad
655,Ringfietspad Zurenborgbrug,2023-03-31,08:00:00,351,190,161,FMN 06 B Zurenborgbrug Ringfietspad
655,Ringfietspad Zurenborgbrug,2023-03-31,09:00:00,108,64,44,FMN 06 B Zurenborgbrug Ringfietspad
655,Ringfietspad Zurenborgbrug,2023-03-31,10:00:00,63,31,32,FMN 06 B Zurenborgbrug Ringfietspad
655,Ringfietspad Zurenborgbrug,2023-03-31,11:00:00,69,38,31,FMN 06 B Zurenborgbrug Ringfietspad
655,Ringfietspad Zurenborgbrug,2023-03-31,12:00:00,82,44,38,FMN 06 B Zurenborgbrug Ringfietspad
655,Ringfietspad Zurenborgbrug,2023-03-31,13:00:00,97,45,52,FMN 06 B Zurenborgbrug Ringfietspad
655,Ringfietspad Zurenborgbrug,2023-03-31,14:00:00,105,51,54,FMN 06 B Zurenborgbrug Ringfietspad
655,Ringfietspad Zurenborgbrug,2023-03-31,15:00:00,168,58,110,FMN 06 B Zurenborgbrug Ringfietspad
655,Ringfietspad Zurenborgbrug,2023-03-31,16:00:00,240,107,133,FMN 06 B Zurenborgbrug Ringfietspad
655,Ringfietspad Zurenborgbrug,2023-03-31,17:00:00,230,86,144,FMN 06 B Zurenborgbrug Ringfietspad
655,Ringfietspad Zurenborgbrug,2023-03-31,18:00:00,166,71,95,FMN 06 B Zurenborgbrug Ringfietspad
655,Ringfietspad Zurenborgbrug,2023-03-31,19:00:00,96,40,56,FMN 06 B Zurenborgbrug Ringfietspad
655,Ringfietspad Zurenborgbrug,2023-03-31,20:00:00,70,20,50,FMN 06 B Zurenborgbrug Ringfietspad
655,Ringfietspad Zurenborgbrug,2023-03-31,21:00:00,59,28,31,FMN 06 B Zurenborgbrug Ringfietspad
655,Ringfietspad Zurenborgbrug,2023-03-31,22:00:00,52,25,27,FMN 06 B Zurenborgbrug Ringfietspad
655,Ringfietspad Zurenborgbrug,2023-03-31,23:00:00,44,18,26,FMN 06 B Zurenborgbrug Ringfietspad
655,Ringfietspad Zurenborgbrug,2023-04-01,00:00:00,29,13,16,FMN 06 B Zurenborgbrug Ringfietspad
655,Ringfietspad Zurenborgbrug,2023-04-01,01:00:00,23,17,6,FMN 06 B Zurenborgbrug Ringfietspad
655,Ringfietspad Zurenborgbrug,2023-04-01,02:00:00,10,4,6,FMN 06 B Zurenborgbrug Ringfietspad
655,Ringfietspad Zurenborgbrug,2023-04-01,03:00:00,10,4,6,FMN 06 B Zurenborgbrug Ringfietspad
655,Ringfietspad Zurenborgbrug,2023-04-01,04:00:00,11,4,7,FMN 06 B Zurenborgbrug Ringfietspad
655,Ringfietspad Zurenborgbrug,2023-04-01,05:00:00,12,8,4,FMN 06 B Zurenborgbrug Ringfietspad
655,Ringfietspad Zurenborgbrug,2023-04-01,06:00:00,14,8,6,FMN 06 B Zurenborgbrug Ringfietspad
655,Ringfietspad Zurenborgbrug,2023-04-01,07:00:00,22,14,8,FMN 06 B Zurenborgbrug Ringfietspad
655,Ringfietspad Zurenborgbrug,2023-04-01,08:00:00,29,16,13,FMN 06 B Zurenborgbrug Ringfietspad
655,Ringfietspad Zurenborgbrug,2023-04-01,09:00:00,42,18,24,FMN 06 B Zurenborgbrug Ringfietspad
655,Ringfietspad Zurenborgbrug,2023-04-01,10:00:00,35,15,20,FMN 06 B Zurenborgbrug Ringfietspad
655,Ringfietspad Zurenborgbrug,2023-04-01,11:00:00,46,25,21,FMN 06 B Zurenborgbrug Ringfietspad
655,Ringfietspad Zurenborgbrug,2023-04-01,12:00:00,43,17,26,FMN 06 B Zurenborgbrug Ringfietspad
655,Ringfietspad Zurenborgbrug,2023-04-01,13:00:00,56,25,31,FMN 06 B Zurenborgbrug Ringfietspad
655,Ringfietspad Zurenborgbrug,2023-04-01,14:00:00,53,16,37,FMN 06 B Zurenborgbrug Ringfietspad
655,Ringfietspad Zurenborgbrug,2023-04-01,15:00:00,58,36,22,FMN 06 B Zurenborgbrug Ringfietspad
655,Ringfietspad Zurenborgbrug,2023-04-01,16:00:00,52,23,29,FMN 06 B Zurenborgbrug Ringfietspad
655,Ringfietspad Zurenborgbrug,2023-04-01,17:00:00,61,30,31,FMN 06 B Zurenborgbrug Ringfietspad
655,Ringfietspad Zurenborgbrug,2023-04-01,18:00:00,55,27,28,FMN 06 B Zurenborgbrug Ringfietspad
655,Ringfietspad Zurenborgbrug,2023-04-01,19:00:00,39,12,27,FMN 06 B Zurenborgbrug Ringfietspad
655,Ringfietspad Zurenborgbrug,2023-04-01,20:00:00,33,11,22,FMN 06 B Zurenborgbrug Ringfietspad
655,Ringfietspad Zurenborgbrug,2023-04-01,21:00:00,26,11,15,FMN 06 B Zurenborgbrug Ringfietspad
655,Ringfietspad Zurenborgbrug,2023-04-01,22:00:00,30,16,14,FMN 06 B Zurenborgbrug Ringfietspad
655,Ringfietspad Zurenborgbrug,2023-04-01,23:00:00,15,3,12,FMN 06 B Zurenborgbrug Ringfietspad
655,Ringfietspad Zurenborgbrug,2023-04-02,00:00:00,14,4,10,FMN 06 B Zurenborgbrug Ringfietspad
655,Ringfietspad Zurenborgbrug,2023-04-02,01:00:00,16,6,10,FMN 06 B Zurenborgbrug Ringfietspad
655,Ringfietspad Zurenborgbrug,2023-04-02,02:00:00,6,3,3,FMN 06 B Zurenborgbrug Ringfietspad
655,Ringfietspad Zurenborgbrug,2023-04-02,03:00:00,17,5,12,FMN 06 B Zurenborgbrug Ringfietspad
655,Ringfietspad Zurenborgbrug,2023-04-02,04:00:00,3,2,1,FMN 06 B Zurenborgbrug Ringfietspad
655,Ringfietspad Zurenborgbrug,2023-04-02,05:00:00,10,6,4,FMN 06 B Zurenborgbrug Ringfietspad
655,Ringfietspad Zurenborgbrug,2023-04-02,06:00:00,15,9,6,FMN 06 B Zurenborgbrug Ringfietspad
655,Ringfietspad Zurenborgbrug,2023-04-02,07:00:00,15,6,9,FMN 06 B Zurenborgbrug Ringfietspad
655,Ringfietspad Zurenborgbrug,2023-04-02,08:00:00,53,23,30,FMN 06 B Zurenborgbrug Ringfietspad
655,Ringfietspad Zurenborgbrug,2023-04-02,09:00:00,108,38,70,FMN 06 B Zurenborgbrug Ringfietspad
655,Ringfietspad Zurenborgbrug,2023-04-02,10:00:00,91,37,54,FMN 06 B Zurenborgbrug Ringfietspad
655,Ringfietspad Zurenborgbrug,2023-04-02,11:00:00,111,44,67,FMN 06 B Zurenborgbrug Ringfietspad
655,Ringfietspad Zurenborgbrug,2023-04-02,12:00:00,129,55,74,FMN 06 B Zurenborgbrug Ringfietspad
655,Ringfietspad Zurenborgbrug,2023-04-02,13:00:00,145,68,77,FMN 06 B Zurenborgbrug Ringfietspad
655,Ringfietspad Zurenborgbrug,2023-04-02,14:00:00,110,49,61,FMN 06 B Zurenborgbrug Ringfietspad
655,Ringfietspad Zurenborgbrug,2023-04-02,15:00:00,105,44,61,FMN 06 B Zurenborgbrug Ringfietspad
655,Ringfietspad Zurenborgbrug,2023-04-02,16:00:00,70,37,33,FMN 06 B Zurenborgbrug Ringfietspad
655,Ringfietspad Zurenborgbrug,2023-04-02,17:00:00,80,31,49,FMN 06 B Zurenborgbrug Ringfietspad
655,Ringfietspad Zurenborgbrug,2023-04-02,18:00:00,91,37,54,FMN 06 B Zurenborgbrug Ringfietspad
655,Ringfietspad Zurenborgbrug,2023-04-02,19:00:00,77,22,55,FMN 06 B Zurenborgbrug Ringfietspad
655,Ringfietspad Zurenborgbrug,2023-04-02,20:00:00,60,26,34,FMN 06 B Zurenborgbrug Ringfietspad
655,Ringfietspad Zurenborgbrug,2023-04-02,21:00:00,42,15,27,FMN 06 B Zurenborgbrug Ringfietspad
655,Ringfietspad Zurenborgbrug,2023-04-02,22:00:00,32,15,17,FMN 06 B Zurenborgbrug Ringfietspad
655,Ringfietspad Zurenborgbrug,2023-04-02,23:00:00,23,6,17,FMN 06 B Zurenborgbrug Ringfietspad
655,Ringfietspad Zurenborgbrug,2023-04-03,00:00:00,11,6,5,FMN 06 B Zurenborgbrug Ringfietspad
655,Ringfietspad Zurenborgbrug,2023-04-03,01:00:00,4,3,1,FMN 06 B Zurenborgbrug Ringfietspad
655,Ringfietspad Zurenborgbrug,2023-04-03,02:00:00,0,0,0,FMN 06 B Zurenborgbrug Ringfietspad
655,Ringfietspad Zurenborgbrug,2023-04-03,03:00:00,4,2,2,FMN 06 B Zurenborgbrug Ringfietspad
655,Ringfietspad Zurenborgbrug,2023-04-03,04:00:00,15,9,6,FMN 06 B Zurenborgbrug Ringfietspad
655,Ringfietspad Zurenborgbrug,2023-04-03,05:00:00,45,26,19,FMN 06 B Zurenborgbrug Ringfietspad
655,Ringfietspad Zurenborgbrug,2023-04-03,06:00:00,92,54,38,FMN 06 B Zurenborgbrug Ringfietspad
655,Ringfietspad Zurenborgbrug,2023-04-03,07:00:00,238,145,93,FMN 06 B Zurenborgbrug Ringfietspad
655,Ringfietspad Zurenborgbrug,2023-04-03,08:00:00,319,178,141,FMN 06 B Zurenborgbrug Ringfietspad
655,Ringfietspad Zurenborgbrug,2023-04-03,09:00:00,114,65,49,FMN 06 B Zurenborgbrug Ringfietspad
655,Ringfietspad Zurenborgbrug,2023-04-03,10:00:00,85,38,47,FMN 06 B Zurenborgbrug Ringfietspad
655,Ringfietspad Zurenborgbrug,2023-04-03,11:00:00,92,45,47,FMN 06 B Zurenborgbrug Ringfietspad
655,Ringfietspad Zurenborgbrug,2023-04-03,12:00:00,126,56,70,FMN 06 B Zurenborgbrug Ringfietspad
655,Ringfietspad Zurenborgbrug,2023-04-03,13:00:00,151,74,77,FMN 06 B Zurenborgbrug Ringfietspad
655,Ringfietspad Zurenborgbrug,2023-04-03,14:00:00,149,49,100,FMN 06 B Zurenborgbrug Ringfietspad
655,Ringfietspad Zurenborgbrug,2023-04-03,15:00:00,178,71,107,FMN 06 B Zurenborgbrug Ringfietspad
655,Ringfietspad Zurenborgbrug,2023-04-03,16:00:00,319,135,184,FMN 06 B Zurenborgbrug Ringfietspad
655,Ringfietspad Zurenborgbrug,2023-04-03,17:00:00,385,138,247,FMN 06 B Zurenborgbrug Ringfietspad
655,Ringfietspad Zurenborgbrug,2023-04-03,18:00:00,244,108,136,FMN 06 B Zurenborgbrug Ringfietspad
655,Ringfietspad Zurenborgbrug,2023-04-03,19:00:00,128,50,78,FMN 06 B Zurenborgbrug Ringfietspad
655,Ringfietspad Zurenborgbrug,2023-04-03,20:00:00,59,26,33,FMN 06 B Zurenborgbrug Ringfietspad
655,Ringfietspad Zurenborgbrug,2023-04-03,21:00:00,43,16,27,FMN 06 B Zurenborgbrug Ringfietspad
655,Ringfietspad Zurenborgbrug,2023-04-03,22:00:00,59,23,36,FMN 06 B Zurenborgbrug Ringfietspad
655,Ringfietspad Zurenborgbrug,2023-04-03,23:00:00,20,7,13,FMN 06 B Zurenborgbrug Ringfietspad
655,Ringfietspad Zurenborgbrug,2023-04-04,00:00:00,15,8,7,FMN 06 B Zurenborgbrug Ringfietspad
655,Ringfietspad Zurenborgbrug,2023-04-04,01:00:00,4,1,3,FMN 06 B Zurenborgbrug Ringfietspad
655,Ringfietspad Zurenborgbrug,2023-04-04,02:00:00,1,0,1,FMN 06 B Zurenborgbrug Ringfietspad
655,Ringfietspad Zurenborgbrug,2023-04-04,03:00:00,5,3,2,FMN 06 B Zurenborgbrug Ringfietspad
655,Ringfietspad Zurenborgbrug,2023-04-04,04:00:00,13,8,5,FMN 06 B Zurenborgbrug Ringfietspad
655,Ringfietspad Zurenborgbrug,2023-04-04,05:00:00,49,27,22,FMN 06 B Zurenborgbrug Ringfietspad
655,Ringfietspad Zurenborgbrug,2023-04-04,06:00:00,96,56,40,FMN 06 B Zurenborgbrug Ringfietspad
655,Ringfietspad Zurenborgbrug,2023-04-04,07:00:00,269,165,104,FMN 06 B Zurenborgbrug Ringfietspad
655,Ringfietspad Zurenborgbrug,2023-04-04,08:00:00,369,208,161,FMN 06 B Zurenborgbrug Ringfietspad
655,Ringfietspad Zurenborgbrug,2023-04-04,09:00:00,138,79,59,FMN 06 B Zurenborgbrug Ringfietspad
655,Ringfietspad Zurenborgbrug,2023-04-04,10:00:00,76,37,39,FMN 06 B Zurenborgbrug Ringfietspad
655,Ringfietspad Zurenborgbrug,2023-04-04,11:00:00,90,38,52,FMN 06 B Zurenborgbrug Ringfietspad
655,Ringfietspad Zurenborgbrug,2023-04-04,12:00:00,145,70,75,FMN 06 B Zurenborgbrug Ringfietspad
655,Ringfietspad Zurenborgbrug,2023-04-04,13:00:00,167,81,86,FMN 06 B Zurenborgbrug Ringfietspad
655,Ringfietspad Zurenborgbrug,2023-04-04,14:00:00,165,71,94,FMN 06 B Zurenborgbrug Ringfietspad
655,Ringfietspad Zurenborgbrug,2023-04-04,15:00:00,197,78,119,FMN 06 B Zurenborgbrug Ringfietspad
655,Ringfietspad Zurenborgbrug,2023-04-04,16:00:00,361,158,203,FMN 06 B Zurenborgbrug Ringfietspad
655,Ringfietspad Zurenborgbrug,2023-04-04,17:00:00,430,146,284,FMN 06 B Zurenborgbrug Ringfietspad
655,Ringfietspad Zurenborgbrug,2023-04-04,18:00:00,244,108,136,FMN 06 B Zurenborgbrug Ringfietspad
655,Ringfietspad Zurenborgbrug,2023-04-04,19:00:00,155,63,92,FMN 06 B Zurenborgbrug Ringfietspad
655,Ringfietspad Zurenborgbrug,2023-04-04,20:00:00,88,43,45,FMN 06 B Zurenborgbrug Ringfietspad
655,Ringfietspad Zurenborgbrug,2023-04-04,21:00:00,61,27,34,FMN 06 B Zurenborgbrug Ringfietspad
655,Ringfietspad Zurenborgbrug,2023-04-04,22:00:00,63,27,36,FMN 06 B Zurenborgbrug Ringfietspad
655,Ringfietspad Zurenborgbrug,2023-04-04,23:00:00,35,17,18,FMN 06 B Zurenborgbrug Ringfietspad
655,Ringfietspad Zurenborgbrug,2023-04-05,00:00:00,16,10,6,FMN 06 B Zurenborgbrug Ringfietspad
655,Ringfietspad Zurenborgbrug,2023-04-05,01:00:00,13,8,5,FMN 06 B Zurenborgbrug Ringfietspad
655,Ringfietspad Zurenborgbrug,2023-04-05,02:00:00,3,1,2,FMN 06 B Zurenborgbrug Ringfietspad
655,Ringfietspad Zurenborgbrug,2023-04-05,03:00:00,5,4,1,FMN 06 B Zurenborgbrug Ringfietspad
655,Ringfietspad Zurenborgbrug,2023-04-05,04:00:00,18,10,8,FMN 06 B Zurenborgbrug Ringfietspad
655,Ringfietspad Zurenborgbrug,2023-04-05,05:00:00,41,23,18,FMN 06 B Zurenborgbrug Ringfietspad
655,Ringfietspad Zurenborgbrug,2023-04-05,06:00:00,97,54,43,FMN 06 B Zurenborgbrug Ringfietspad
655,Ringfietspad Zurenborgbrug,2023-04-05,07:00:00,225,141,84,FMN 06 B Zurenborgbrug Ringfietspad
655,Ringfietspad Zurenborgbrug,2023-04-05,08:00:00,343,207,136,FMN 06 B Zurenborgbrug Ringfietspad
655,Ringfietspad Zurenborgbrug,2023-04-05,09:00:00,127,68,59,FMN 06 B Zurenborgbrug Ringfietspad
655,Ringfietspad Zurenborgbrug,2023-04-05,10:00:00,85,36,49,FMN 06 B Zurenborgbrug Ringfietspad
655,Ringfietspad Zurenborgbrug,2023-04-05,11:00:00,93,45,48,FMN 06 B Zurenborgbrug Ringfietspad
655,Ringfietspad Zurenborgbrug,2023-04-05,12:00:00,176,76,100,FMN 06 B Zurenborgbrug Ringfietspad
655,Ringfietspad Zurenborgbrug,2023-04-05,13:00:00,181,82,99,FMN 06 B Zurenborgbrug Ringfietspad
655,Ringfietspad Zurenborgbrug,2023-04-05,14:00:00,183,69,114,FMN 06 B Zurenborgbrug Ringfietspad
655,Ringfietspad Zurenborgbrug,2023-04-05,15:00:00,199,80,119,FMN 06 B Zurenborgbrug Ringfietspad
655,Ringfietspad Zurenborgbrug,2023-04-05,16:00:00,338,129,209,FMN 06 B Zurenborgbrug Ringfietspad
655,Ringfietspad Zurenborgbrug,2023-04-05,17:00:00,426,179,247,FMN 06 B Zurenborgbrug Ringfietspad
655,Ringfietspad Zurenborgbrug,2023-04-05,18:00:00,266,115,151,FMN 06 B Zurenborgbrug Ringfietspad
655,Ringfietspad Zurenborgbrug,2023-04-05,19:00:00,138,58,80,FMN 06 B Zurenborgbrug Ringfietspad
655,Ringfietspad Zurenborgbrug,2023-04-05,20:00:00,88,36,52,FMN 06 B Zurenborgbrug Ringfietspad
655,Ringfietspad Zurenborgbrug,2023-04-05,21:00:00,63,28,35,FMN 06 B Zurenborgbrug Ringfietspad
655,Ringfietspad Zurenborgbrug,2023-04-05,22:00:00,60,19,41,FMN 06 B Zurenborgbrug Ringfietspad
655,Ringfietspad Zurenborgbrug,2023-04-05,23:00:00,32,14,18,FMN 06 B Zurenborgbrug Ringfietspad
655,Ringfietspad Zurenborgbrug,2023-04-06,00:00:00,16,9,7,FMN 06 B Zurenborgbrug Ringfietspad
655,Ringfietspad Zurenborgbrug,2023-04-06,01:00:00,7,3,4,FMN 06 B Zurenborgbrug Ringfietspad
655,Ringfietspad Zurenborgbrug,2023-04-06,02:00:00,4,2,2,FMN 06 B Zurenborgbrug Ringfietspad
655,Ringfietspad Zurenborgbrug,2023-04-06,03:00:00,5,4,1,FMN 06 B Zurenborgbrug Ringfietspad
655,Ringfietspad Zurenborgbrug,2023-04-06,04:00:00,15,12,3,FMN 06 B Zurenborgbrug Ringfietspad
655,Ringfietspad Zurenborgbrug,2023-04-06,05:00:00,37,18,19,FMN 06 B Zurenborgbrug Ringfietspad
655,Ringfietspad Zurenborgbrug,2023-04-06,06:00:00,93,48,45,FMN 06 B Zurenborgbrug Ringfietspad
655,Ringfietspad Zurenborgbrug,2023-04-06,07:00:00,210,130,80,FMN 06 B Zurenborgbrug Ringfietspad
655,Ringfietspad Zurenborgbrug,2023-04-06,08:00:00,290,188,102,FMN 06 B Zurenborgbrug Ringfietspad
655,Ringfietspad Zurenborgbrug,2023-04-06,09:00:00,109,61,48,FMN 06 B Zurenborgbrug Ringfietspad
655,Ringfietspad Zurenborgbrug,2023-04-06,10:00:00,56,32,24,FMN 06 B Zurenborgbrug Ringfietspad
655,Ringfietspad Zurenborgbrug,2023-04-06,11:00:00,51,34,17,FMN 06 B Zurenborgbrug Ringfietspad
655,Ringfietspad Zurenborgbrug,2023-04-06,12:00:00,84,37,47,FMN 06 B Zurenborgbrug Ringfietspad
655,Ringfietspad Zurenborgbrug,2023-04-06,13:00:00,81,38,43,FMN 06 B Zurenborgbrug Ringfietspad
655,Ringfietspad Zurenborgbrug,2023-04-06,14:00:00,74,26,48,FMN 06 B Zurenborgbrug Ringfietspad
655,Ringfietspad Zurenborgbrug,2023-04-06,15:00:00,91,33,58,FMN 06 B Zurenborgbrug Ringfietspad
655,Ringfietspad Zurenborgbrug,2023-04-06,16:00:00,231,73,158,FMN 06 B Zurenborgbrug Ringfietspad
655,Ringfietspad Zurenborgbrug,2023-04-06,17:00:00,247,88,159,FMN 06 B Zurenborgbrug Ringfietspad
655,Ringfietspad Zurenborgbrug,2023-04-06,18:00:00,160,66,94,FMN 06 B Zurenborgbrug Ringfietspad
655,Ringfietspad Zurenborgbrug,2023-04-06,19:00:00,90,36,54,FMN 06 B Zurenborgbrug Ringfietspad
655,Ringfietspad Zurenborgbrug,2023-04-06,20:00:00,63,24,39,FMN 06 B Zurenborgbrug Ringfietspad
655,Ringfietspad Zurenborgbrug,2023-04-06,21:00:00,41,19,22,FMN 06 B Zurenborgbrug Ringfietspad
655,Ringfietspad Zurenborgbrug,2023-04-06,22:00:00,60,27,33,FMN 06 B Zurenborgbrug Ringfietspad
655,Ringfietspad Zurenborgbrug,2023-04-06,23:00:00,33,11,22,FMN 06 B Zurenborgbrug Ringfietspad
655,Ringfietspad Zurenborgbrug,2023-04-07,00:00:00,10,4,6,FMN 06 B Zurenborgbrug Ringfietspad
655,Ringfietspad Zurenborgbrug,2023-04-07,01:00:00,4,2,2,FMN 06 B Zurenborgbrug Ringfietspad
655,Ringfietspad Zurenborgbrug,2023-04-07,02:00:00,7,0,7,FMN 06 B Zurenborgbrug Ringfietspad
655,Ringfietspad Zurenborgbrug,2023-04-07,03:00:00,3,2,1,FMN 06 B Zurenborgbrug Ringfietspad
655,Ringfietspad Zurenborgbrug,2023-04-07,04:00:00,17,10,7,FMN 06 B Zurenborgbrug Ringfietspad
655,Ringfietspad Zurenborgbrug,2023-04-07,05:00:00,32,16,16,FMN 06 B Zurenborgbrug Ringfietspad
655,Ringfietspad Zurenborgbrug,2023-04-07,06:00:00,64,38,26,FMN 06 B Zurenborgbrug Ringfietspad
655,Ringfietspad Zurenborgbrug,2023-04-07,07:00:00,138,81,57,FMN 06 B Zurenborgbrug Ringfietspad
655,Ringfietspad Zurenborgbrug,2023-04-07,08:00:00,222,126,96,FMN 06 B Zurenborgbrug Ringfietspad
655,Ringfietspad Zurenborgbrug,2023-04-07,09:00:00,102,55,47,FMN 06 B Zurenborgbrug Ringfietspad
655,Ringfietspad Zurenborgbrug,2023-04-07,10:00:00,71,37,34,FMN 06 B Zurenborgbrug Ringfietspad
655,Ringfietspad Zurenborgbrug,2023-04-07,11:00:00,86,40,46,FMN 06 B Zurenborgbrug Ringfietspad
655,Ringfietspad Zurenborgbrug,2023-04-07,12:00:00,106,45,61,FMN 06 B Zurenborgbrug Ringfietspad
655,Ringfietspad Zurenborgbrug,2023-04-07,13:00:00,107,59,48,FMN 06 B Zurenborgbrug Ringfietspad
655,Ringfietspad Zurenborgbrug,2023-04-07,14:00:00,146,62,84,FMN 06 B Zurenborgbrug Ringfietspad
655,Ringfietspad Zurenborgbrug,2023-04-07,15:00:00,134,55,79,FMN 06 B Zurenborgbrug Ringfietspad
655,Ringfietspad Zurenborgbrug,2023-04-07,16:00:00,226,99,127,FMN 06 B Zurenborgbrug Ringfietspad
655,Ringfietspad Zurenborgbrug,2023-04-07,17:00:00,201,79,122,FMN 06 B Zurenborgbrug Ringfietspad
655,Ringfietspad Zurenborgbrug,2023-04-07,18:00:00,142,74,68,FMN 06 B Zurenborgbrug Ringfietspad
655,Ringfietspad Zurenborgbrug,2023-04-07,19:00:00,107,36,71,FMN 06 B Zurenborgbrug Ringfietspad
655,Ringfietspad Zurenborgbrug,2023-04-07,20:00:00,75,27,48,FMN 06 B Zurenborgbrug Ringfietspad
655,Ringfietspad Zurenborgbrug,2023-04-07,21:00:00,48,16,32,FMN 06 B Zurenborgbrug Ringfietspad
655,Ringfietspad Zurenborgbrug,2023-04-07,22:00:00,49,22,27,FMN 06 B Zurenborgbrug Ringfietspad
655,Ringfietspad Zurenborgbrug,2023-04-07,23:00:00,47,24,23,FMN 06 B Zurenborgbrug Ringfietspad
655,Ringfietspad Zurenborgbrug,2023-04-08,00:00:00,31,20,11,FMN 06 B Zurenborgbrug Ringfietspad
655,Ringfietspad Zurenborgbrug,2023-04-08,01:00:00,16,8,8,FMN 06 B Zurenborgbrug Ringfietspad
655,Ringfietspad Zurenborgbrug,2023-04-08,02:00:00,4,3,1,FMN 06 B Zurenborgbrug Ringfietspad
655,Ringfietspad Zurenborgbrug,2023-04-08,03:00:00,4,2,2,FMN 06 B Zurenborgbrug Ringfietspad
655,Ringfietspad Zurenborgbrug,2023-04-08,04:00:00,9,4,5,FMN 06 B Zurenborgbrug Ringfietspad
655,Ringfietspad Zurenborgbrug,2023-04-08,05:00:00,10,5,5,FMN 06 B Zurenborgbrug Ringfietspad
655,Ringfietspad Zurenborgbrug,2023-04-08,06:00:00,24,15,9,FMN 06 B Zurenborgbrug Ringfietspad
655,Ringfietspad Zurenborgbrug,2023-04-08,07:00:00,31,9,22,FMN 06 B Zurenborgbrug Ringfietspad
655,Ringfietspad Zurenborgbrug,2023-04-08,08:00:00,49,15,34,FMN 06 B Zurenborgbrug Ringfietspad
655,Ringfietspad Zurenborgbrug,2023-04-08,09:00:00,91,24,67,FMN 06 B Zurenborgbrug Ringfietspad
655,Ringfietspad Zurenborgbrug,2023-04-08,10:00:00,89,41,48,FMN 06 B Zurenborgbrug Ringfietspad
655,Ringfietspad Zurenborgbrug,2023-04-08,11:00:00,95,46,49,FMN 06 B Zurenborgbrug Ringfietspad
655,Ringfietspad Zurenborgbrug,2023-04-08,12:00:00,123,55,68,FMN 06 B Zurenborgbrug Ringfietspad
655,Ringfietspad Zurenborgbrug,2023-04-08,13:00:00,150,68,82,FMN 06 B Zurenborgbrug Ringfietspad
655,Ringfietspad Zurenborgbrug,2023-04-08,14:00:00,184,78,106,FMN 06 B Zurenborgbrug Ringfietspad
655,Ringfietspad Zurenborgbrug,2023-04-08,15:00:00,154,79,75,FMN 06 B Zurenborgbrug Ringfietspad
655,Ringfietspad Zurenborgbrug,2023-04-08,16:00:00,162,84,78,FMN 06 B Zurenborgbrug Ringfietspad
655,Ringfietspad Zurenborgbrug,2023-04-08,17:00:00,128,57,71,FMN 06 B Zurenborgbrug Ringfietspad
655,Ringfietspad Zurenborgbrug,2023-04-08,18:00:00,134,67,67,FMN 06 B Zurenborgbrug Ringfietspad
655,Ringfietspad Zurenborgbrug,2023-04-08,19:00:00,100,39,61,FMN 06 B Zurenborgbrug Ringfietspad
655,Ringfietspad Zurenborgbrug,2023-04-08,20:00:00,65,32,33,FMN 06 B Zurenborgbrug Ringfietspad
655,Ringfietspad Zurenborgbrug,2023-04-08,21:00:00,42,14,28,FMN 06 B Zurenborgbrug Ringfietspad
655,Ringfietspad Zurenborgbrug,2023-04-08,22:00:00,49,25,24,FMN 06 B Zurenborgbrug Ringfietspad
655,Ringfietspad Zurenborgbrug,2023-04-08,23:00:00,30,12,18,FMN 06 B Zurenborgbrug Ringfietspad
655,Ringfietspad Zurenborgbrug,2023-04-09,00:00:00,26,13,13,FMN 06 B Zurenborgbrug Ringfietspad
655,Ringfietspad Zurenborgbrug,2023-04-09,01:00:00,16,11,5,FMN 06 B Zurenborgbrug Ringfietspad
655,Ringfietspad Zurenborgbrug,2023-04-09,02:00:00,12,8,4,FMN 06 B Zurenborgbrug Ringfietspad
655,Ringfietspad Zurenborgbrug,2023-04-09,03:00:00,13,5,8,FMN 06 B Zurenborgbrug Ringfietspad
655,Ringfietspad Zurenborgbrug,2023-04-09,04:00:00,3,3,0,FMN 06 B Zurenborgbrug Ringfietspad
655,Ringfietspad Zurenborgbrug,2023-04-09,05:00:00,5,2,3,FMN 06 B Zurenborgbrug Ringfietspad
655,Ringfietspad Zurenborgbrug,2023-04-09,06:00:00,15,10,5,FMN 06 B Zurenborgbrug Ringfietspad
655,Ringfietspad Zurenborgbrug,2023-04-09,07:00:00,19,7,12,FMN 06 B Zurenborgbrug Ringfietspad
655,Ringfietspad Zurenborgbrug,2023-04-09,08:00:00,60,20,40,FMN 06 B Zurenborgbrug Ringfietspad
655,Ringfietspad Zurenborgbrug,2023-04-09,09:00:00,90,53,37,FMN 06 B Zurenborgbrug Ringfietspad
655,Ringfietspad Zurenborgbrug,2023-04-09,10:00:00,124,54,70,FMN 06 B Zurenborgbrug Ringfietspad
655,Ringfietspad Zurenborgbrug,2023-04-09,11:00:00,159,60,99,FMN 06 B Zurenborgbrug Ringfietspad
655,Ringfietspad Zurenborgbrug,2023-04-09,12:00:00,178,91,87,FMN 06 B Zurenborgbrug Ringfietspad
655,Ringfietspad Zurenborgbrug,2023-04-09,13:00:00,169,49,120,FMN 06 B Zurenborgbrug Ringfietspad
655,Ringfietspad Zurenborgbrug,2023-04-09,14:00:00,259,97,162,FMN 06 B Zurenborgbrug Ringfietspad
655,Ringfietspad Zurenborgbrug,2023-04-09,15:00:00,218,93,125,FMN 06 B Zurenborgbrug Ringfietspad
655,Ringfietspad Zurenborgbrug,2023-04-09,16:00:00,173,83,90,FMN 06 B Zurenborgbrug Ringfietspad
655,Ringfietspad Zurenborgbrug,2023-04-09,17:00:00,178,86,92,FMN 06 B Zurenborgbrug Ringfietspad
655,Ringfietspad Zurenborgbrug,2023-04-09,18:00:00,171,112,59,FMN 06 B Zurenborgbrug Ringfietspad
655,Ringfietspad Zurenborgbrug,2023-04-09,19:00:00,113,63,50,FMN 06 B Zurenborgbrug Ringfietspad
655,Ringfietspad Zurenborgbrug,2023-04-09,20:00:00,102,66,36,FMN 06 B Zurenborgbrug Ringfietspad
655,Ringfietspad Zurenborgbrug,2023-04-09,21:00:00,76,38,38,FMN 06 B Zurenborgbrug Ringfietspad
655,Ringfietspad Zurenborgbrug,2023-04-09,22:00:00,43,18,25,FMN 06 B Zurenborgbrug Ringfietspad
655,Ringfietspad Zurenborgbrug,2023-04-09,23:00:00,35,16,19,FMN 06 B Zurenborgbrug Ringfietspad
655,Ringfietspad Zurenborgbrug,2023-04-10,00:00:00,24,11,13,FMN 06 B Zurenborgbrug Ringfietspad
655,Ringfietspad Zurenborgbrug,2023-04-10,01:00:00,10,4,6,FMN 06 B Zurenborgbrug Ringfietspad
655,Ringfietspad Zurenborgbrug,2023-04-10,02:00:00,5,3,2,FMN 06 B Zurenborgbrug Ringfietspad
655,Ringfietspad Zurenborgbrug,2023-04-10,03:00:00,5,3,2,FMN 06 B Zurenborgbrug Ringfietspad
655,Ringfietspad Zurenborgbrug,2023-04-10,04:00:00,3,2,1,FMN 06 B Zurenborgbrug Ringfietspad
655,Ringfietspad Zurenborgbrug,2023-04-10,05:00:00,12,6,6,FMN 06 B Zurenborgbrug Ringfietspad
655,Ringfietspad Zurenborgbrug,2023-04-10,06:00:00,19,9,10,FMN 06 B Zurenborgbrug Ringfietspad
655,Ringfietspad Zurenborgbrug,2023-04-10,07:00:00,17,6,11,FMN 06 B Zurenborgbrug Ringfietspad
655,Ringfietspad Zurenborgbrug,2023-04-10,08:00:00,51,25,26,FMN 06 B Zurenborgbrug Ringfietspad
655,Ringfietspad Zurenborgbrug,2023-04-10,09:00:00,63,34,29,FMN 06 B Zurenborgbrug Ringfietspad
655,Ringfietspad Zurenborgbrug,2023-04-10,10:00:00,101,40,61,FMN 06 B Zurenborgbrug Ringfietspad
655,Ringfietspad Zurenborgbrug,2023-04-10,11:00:00,108,53,55,FMN 06 B Zurenborgbrug Ringfietspad
655,Ringfietspad Zurenborgbrug,2023-04-10,12:00:00,120,64,56,FMN 06 B Zurenborgbrug Ringfietspad
655,Ringfietspad Zurenborgbrug,2023-04-10,13:00:00,112,58,54,FMN 06 B Zurenborgbrug Ringfietspad
655,Ringfietspad Zurenborgbrug,2023-04-10,14:00:00,103,49,54,FMN 06 B Zurenborgbrug Ringfietspad
655,Ringfietspad Zurenborgbrug,2023-04-10,15:00:00,72,36,36,FMN 06 B Zurenborgbrug Ringfietspad
655,Ringfietspad Zurenborgbrug,2023-04-10,16:00:00,66,41,25,FMN 06 B Zurenborgbrug Ringfietspad
655,Ringfietspad Zurenborgbrug,2023-04-10,17:00:00,67,23,44,FMN 06 B Zurenborgbrug Ringfietspad
655,Ringfietspad Zurenborgbrug,2023-04-10,18:00:00,59,27,32,FMN 06 B Zurenborgbrug Ringfietspad
655,Ringfietspad Zurenborgbrug,2023-04-10,19:00:00,32,15,17,FMN 06 B Zurenborgbrug Ringfietspad
655,Ringfietspad Zurenborgbrug,2023-04-10,20:00:00,31,21,10,FMN 06 B Zurenborgbrug Ringfietspad
655,Ringfietspad Zurenborgbrug,2023-04-10,21:00:00,37,17,20,FMN 06 B Zurenborgbrug Ringfietspad
655,Ringfietspad Zurenborgbrug,2023-04-10,22:00:00,27,12,15,FMN 06 B Zurenborgbrug Ringfietspad
655,Ringfietspad Zurenborgbrug,2023-04-10,23:00:00,22,9,13,FMN 06 B Zurenborgbrug Ringfietspad
655,Ringfietspad Zurenborgbrug,2023-04-11,00:00:00,10,4,6,FMN 06 B Zurenborgbrug Ringfietspad
655,Ringfietspad Zurenborgbrug,2023-04-11,01:00:00,3,2,1,FMN 06 B Zurenborgbrug Ringfietspad
655,Ringfietspad Zurenborgbrug,2023-04-11,02:00:00,0,0,0,FMN 06 B Zurenborgbrug Ringfietspad
655,Ringfietspad Zurenborgbrug,2023-04-11,03:00:00,3,1,2,FMN 06 B Zurenborgbrug Ringfietspad
655,Ringfietspad Zurenborgbrug,2023-04-11,04:00:00,14,9,5,FMN 06 B Zurenborgbrug Ringfietspad
655,Ringfietspad Zurenborgbrug,2023-04-11,05:00:00,52,34,18,FMN 06 B Zurenborgbrug Ringfietspad
655,Ringfietspad Zurenborgbrug,2023-04-11,06:00:00,110,61,49,FMN 06 B Zurenborgbrug Ringfietspad
655,Ringfietspad Zurenborgbrug,2023-04-11,07:00:00,257,144,113,FMN 06 B Zurenborgbrug Ringfietspad
655,Ringfietspad Zurenborgbrug,2023-04-11,08:00:00,343,205,138,FMN 06 B Zurenborgbrug Ringfietspad
655,Ringfietspad Zurenborgbrug,2023-04-11,09:00:00,139,69,70,FMN 06 B Zurenborgbrug Ringfietspad
655,Ringfietspad Zurenborgbrug,2023-04-11,10:00:00,106,57,49,FMN 06 B Zurenborgbrug Ringfietspad
655,Ringfietspad Zurenborgbrug,2023-04-11,11:00:00,82,33,49,FMN 06 B Zurenborgbrug Ringfietspad
655,Ringfietspad Zurenborgbrug,2023-04-11,12:00:00,124,65,59,FMN 06 B Zurenborgbrug Ringfietspad
655,Ringfietspad Zurenborgbrug,2023-04-11,13:00:00,123,64,59,FMN 06 B Zurenborgbrug Ringfietspad
655,Ringfietspad Zurenborgbrug,2023-04-11,14:00:00,138,49,89,FMN 06 B Zurenborgbrug Ringfietspad
655,Ringfietspad Zurenborgbrug,2023-04-11,15:00:00,200,88,112,FMN 06 B Zurenborgbrug Ringfietspad
655,Ringfietspad Zurenborgbrug,2023-04-11,16:00:00,314,119,195,FMN 06 B Zurenborgbrug Ringfietspad
655,Ringfietspad Zurenborgbrug,2023-04-11,17:00:00,382,141,241,FMN 06 B Zurenborgbrug Ringfietspad
655,Ringfietspad Zurenborgbrug,2023-04-11,18:00:00,226,99,127,FMN 06 B Zurenborgbrug Ringfietspad
655,Ringfietspad Zurenborgbrug,2023-04-11,19:00:00,132,56,76,FMN 06 B Zurenborgbrug Ringfietspad
655,Ringfietspad Zurenborgbrug,2023-04-11,20:00:00,70,29,41,FMN 06 B Zurenborgbrug Ringfietspad
655,Ringfietspad Zurenborgbrug,2023-04-11,21:00:00,52,22,30,FMN 06 B Zurenborgbrug Ringfietspad
655,Ringfietspad Zurenborgbrug,2023-04-11,22:00:00,60,23,37,FMN 06 B Zurenborgbrug Ringfietspad
655,Ringfietspad Zurenborgbrug,2023-04-11,23:00:00,35,24,11,FMN 06 B Zurenborgbrug Ringfietspad
655,Ringfietspad Zurenborgbrug,2023-04-12,00:00:00,10,6,4,FMN 06 B Zurenborgbrug Ringfietspad
655,Ringfietspad Zurenborgbrug,2023-04-12,01:00:00,3,0,3,FMN 06 B Zurenborgbrug Ringfietspad
655,Ringfietspad Zurenborgbrug,2023-04-12,02:00:00,5,3,2,FMN 06 B Zurenborgbrug Ringfietspad
655,Ringfietspad Zurenborgbrug,2023-04-12,03:00:00,6,2,4,FMN 06 B Zurenborgbrug Ringfietspad
655,Ringfietspad Zurenborgbrug,2023-04-12,04:00:00,14,8,6,FMN 06 B Zurenborgbrug Ringfietspad
655,Ringfietspad Zurenborgbrug,2023-04-12,05:00:00,30,18,12,FMN 06 B Zurenborgbrug Ringfietspad
655,Ringfietspad Zurenborgbrug,2023-04-12,06:00:00,71,38,33,FMN 06 B Zurenborgbrug Ringfietspad
655,Ringfietspad Zurenborgbrug,2023-04-12,07:00:00,161,90,71,FMN 06 B Zurenborgbrug Ringfietspad
655,Ringfietspad Zurenborgbrug,2023-04-12,08:00:00,194,105,89,FMN 06 B Zurenborgbrug Ringfietspad
655,Ringfietspad Zurenborgbrug,2023-04-12,09:00:00,97,53,44,FMN 06 B Zurenborgbrug Ringfietspad
655,Ringfietspad Zurenborgbrug,2023-04-12,10:00:00,48,28,20,FMN 06 B Zurenborgbrug Ringfietspad
655,Ringfietspad Zurenborgbrug,2023-04-12,11:00:00,60,30,30,FMN 06 B Zurenborgbrug Ringfietspad
655,Ringfietspad Zurenborgbrug,2023-04-12,12:00:00,69,43,26,FMN 06 B Zurenborgbrug Ringfietspad
655,Ringfietspad Zurenborgbrug,2023-04-12,13:00:00,81,32,49,FMN 06 B Zurenborgbrug Ringfietspad
655,Ringfietspad Zurenborgbrug,2023-04-12,14:00:00,62,19,43,FMN 06 B Zurenborgbrug Ringfietspad
655,Ringfietspad Zurenborgbrug,2023-04-12,15:00:00,101,32,69,FMN 06 B Zurenborgbrug Ringfietspad
655,Ringfietspad Zurenborgbrug,2023-04-12,16:00:00,171,79,92,FMN 06 B Zurenborgbrug Ringfietspad
655,Ringfietspad Zurenborgbrug,2023-04-12,17:00:00,264,104,160,FMN 06 B Zurenborgbrug Ringfietspad
655,Ringfietspad Zurenborgbrug,2023-04-12,18:00:00,152,63,89,FMN 06 B Zurenborgbrug Ringfietspad
655,Ringfietspad Zurenborgbrug,2023-04-12,19:00:00,136,56,80,FMN 06 B Zurenborgbrug Ringfietspad
655,Ringfietspad Zurenborgbrug,2023-04-12,20:00:00,95,35,60,FMN 06 B Zurenborgbrug Ringfietspad
655,Ringfietspad Zurenborgbrug,2023-04-12,21:00:00,65,34,31,FMN 06 B Zurenborgbrug Ringfietspad
655,Ringfietspad Zurenborgbrug,2023-04-12,22:00:00,57,21,36,FMN 06 B Zurenborgbrug Ringfietspad
655,Ringfietspad Zurenborgbrug,2023-04-12,23:00:00,24,17,7,FMN 06 B Zurenborgbrug Ringfietspad
655,Ringfietspad Zurenborgbrug,2023-04-13,00:00:00,15,9,6,FMN 06 B Zurenborgbrug Ringfietspad
655,Ringfietspad Zurenborgbrug,2023-04-13,01:00:00,3,1,2,FMN 06 B Zurenborgbrug Ringfietspad
655,Ringfietspad Zurenborgbrug,2023-04-13,02:00:00,0,0,0,FMN 06 B Zurenborgbrug Ringfietspad
655,Ringfietspad Zurenborgbrug,2023-04-13,03:00:00,3,0,3,FMN 06 B Zurenborgbrug Ringfietspad
655,Ringfietspad Zurenborgbrug,2023-04-13,04:00:00,12,7,5,FMN 06 B Zurenborgbrug Ringfietspad
655,Ringfietspad Zurenborgbrug,2023-04-13,05:00:00,41,22,19,FMN 06 B Zurenborgbrug Ringfietspad
655,Ringfietspad Zurenborgbrug,2023-04-13,06:00:00,98,50,48,FMN 06 B Zurenborgbrug Ringfietspad
655,Ringfietspad Zurenborgbrug,2023-04-13,07:00:00,229,130,99,FMN 06 B Zurenborgbrug Ringfietspad
655,Ringfietspad Zurenborgbrug,2023-04-13,08:00:00,300,177,123,FMN 06 B Zurenborgbrug Ringfietspad
655,Ringfietspad Zurenborgbrug,2023-04-13,09:00:00,156,80,76,FMN 06 B Zurenborgbrug Ringfietspad
655,Ringfietspad Zurenborgbrug,2023-04-13,10:00:00,71,41,30,FMN 06 B Zurenborgbrug Ringfietspad
655,Ringfietspad Zurenborgbrug,2023-04-13,11:00:00,85,49,36,FMN 06 B Zurenborgbrug Ringfietspad
655,Ringfietspad Zurenborgbrug,2023-04-13,12:00:00,91,51,40,FMN 06 B Zurenborgbrug Ringfietspad
655,Ringfietspad Zurenborgbrug,2023-04-13,13:00:00,124,61,63,FMN 06 B Zurenborgbrug Ringfietspad
655,Ringfietspad Zurenborgbrug,2023-04-13,14:00:00,119,51,68,FMN 06 B Zurenborgbrug Ringfietspad
655,Ringfietspad Zurenborgbrug,2023-04-13,15:00:00,168,67,101,FMN 06 B Zurenborgbrug Ringfietspad
655,Ringfietspad Zurenborgbrug,2023-04-13,16:00:00,276,111,165,FMN 06 B Zurenborgbrug Ringfietspad
655,Ringfietspad Zurenborgbrug,2023-04-13,17:00:00,384,157,227,FMN 06 B Zurenborgbrug Ringfietspad
655,Ringfietspad Zurenborgbrug,2023-04-13,18:00:00,236,100,136,FMN 06 B Zurenborgbrug Ringfietspad
655,Ringfietspad Zurenborgbrug,2023-04-13,19:00:00,139,62,77,FMN 06 B Zurenborgbrug Ringfietspad
655,Ringfietspad Zurenborgbrug,2023-04-13,20:00:00,96,42,54,FMN 06 B Zurenborgbrug Ringfietspad
655,Ringfietspad Zurenborgbrug,2023-04-13,21:00:00,57,21,36,FMN 06 B Zurenborgbrug Ringfietspad
655,Ringfietspad Zurenborgbrug,2023-04-13,22:00:00,69,32,37,FMN 06 B Zurenborgbrug Ringfietspad
655,Ringfietspad Zurenborgbrug,2023-04-13,23:00:00,34,15,19,FMN 06 B Zurenborgbrug Ringfietspad
655,Ringfietspad Zurenborgbrug,2023-04-14,00:00:00,28,16,12,FMN 06 B Zurenborgbrug Ringfietspad
655,Ringfietspad Zurenborgbrug,2023-04-14,01:00:00,10,4,6,FMN 06 B Zurenborgbrug Ringfietspad
655,Ringfietspad Zurenborgbrug,2023-04-14,02:00:00,2,1,1,FMN 06 B Zurenborgbrug Ringfietspad
655,Ringfietspad Zurenborgbrug,2023-04-14,03:00:00,4,1,3,FMN 06 B Zurenborgbrug Ringfietspad
655,Ringfietspad Zurenborgbrug,2023-04-14,04:00:00,13,7,6,FMN 06 B Zurenborgbrug Ringfietspad
655,Ringfietspad Zurenborgbrug,2023-04-14,05:00:00,37,19,18,FMN 06 B Zurenborgbrug Ringfietspad
655,Ringfietspad Zurenborgbrug,2023-04-14,06:00:00,96,58,38,FMN 06 B Zurenborgbrug Ringfietspad
655,Ringfietspad Zurenborgbrug,2023-04-14,07:00:00,196,101,95,FMN 06 B Zurenborgbrug Ringfietspad
655,Ringfietspad Zurenborgbrug,2023-04-14,08:00:00,274,159,115,FMN 06 B Zurenborgbrug Ringfietspad
655,Ringfietspad Zurenborgbrug,2023-04-14,09:00:00,134,76,58,FMN 06 B Zurenborgbrug Ringfietspad
655,Ringfietspad Zurenborgbrug,2023-04-14,10:00:00,92,43,49,FMN 06 B Zurenborgbrug Ringfietspad
655,Ringfietspad Zurenborgbrug,2023-04-14,11:00:00,129,63,66,FMN 06 B Zurenborgbrug Ringfietspad
655,Ringfietspad Zurenborgbrug,2023-04-14,12:00:00,120,65,55,FMN 06 B Zurenborgbrug Ringfietspad
655,Ringfietspad Zurenborgbrug,2023-04-14,13:00:00,169,81,88,FMN 06 B Zurenborgbrug Ringfietspad
655,Ringfietspad Zurenborgbrug,2023-04-14,14:00:00,170,83,87,FMN 06 B Zurenborgbrug Ringfietspad
655,Ringfietspad Zurenborgbrug,2023-04-14,15:00:00,190,81,109,FMN 06 B Zurenborgbrug Ringfietspad
655,Ringfietspad Zurenborgbrug,2023-04-14,16:00:00,298,130,168,FMN 06 B Zurenborgbrug Ringfietspad
655,Ringfietspad Zurenborgbrug,2023-04-14,17:00:00,304,128,176,FMN 06 B Zurenborgbrug Ringfietspad
655,Ringfietspad Zurenborgbrug,2023-04-14,18:00:00,205,83,122,FMN 06 B Zurenborgbrug Ringfietspad
655,Ringfietspad Zurenborgbrug,2023-04-14,19:00:00,152,60,92,FMN 06 B Zurenborgbrug Ringfietspad
655,Ringfietspad Zurenborgbrug,2023-04-14,20:00:00,72,38,34,FMN 06 B Zurenborgbrug Ringfietspad
655,Ringfietspad Zurenborgbrug,2023-04-14,21:00:00,47,15,32,FMN 06 B Zurenborgbrug Ringfietspad
655,Ringfietspad Zurenborgbrug,2023-04-14,22:00:00,66,30,36,FMN 06 B Zurenborgbrug Ringfietspad
655,Ringfietspad Zurenborgbrug,2023-04-14,23:00:00,53,20,33,FMN 06 B Zurenborgbrug Ringfietspad
655,Ringfietspad Zurenborgbrug,2023-04-15,00:00:00,34,17,17,FMN 06 B Zurenborgbrug Ringfietspad
655,Ringfietspad Zurenborgbrug,2023-04-15,01:00:00,12,2,10,FMN 06 B Zurenborgbrug Ringfietspad
655,Ringfietspad Zurenborgbrug,2023-04-15,02:00:00,13,8,5,FMN 06 B Zurenborgbrug Ringfietspad
655,Ringfietspad Zurenborgbrug,2023-04-15,03:00:00,12,10,2,FMN 06 B Zurenborgbrug Ringfietspad
655,Ringfietspad Zurenborgbrug,2023-04-15,04:00:00,11,7,4,FMN 06 B Zurenborgbrug Ringfietspad
655,Ringfietspad Zurenborgbrug,2023-04-15,05:00:00,9,1,8,FMN 06 B Zurenborgbrug Ringfietspad
655,Ringfietspad Zurenborgbrug,2023-04-15,06:00:00,28,17,11,FMN 06 B Zurenborgbrug Ringfietspad
655,Ringfietspad Zurenborgbrug,2023-04-15,07:00:00,27,17,10,FMN 06 B Zurenborgbrug Ringfietspad
655,Ringfietspad Zurenborgbrug,2023-04-15,08:00:00,41,21,20,FMN 06 B Zurenborgbrug Ringfietspad
655,Ringfietspad Zurenborgbrug,2023-04-15,09:00:00,78,28,50,FMN 06 B Zurenborgbrug Ringfietspad
655,Ringfietspad Zurenborgbrug,2023-04-15,10:00:00,141,53,88,FMN 06 B Zurenborgbrug Ringfietspad
655,Ringfietspad Zurenborgbrug,2023-04-15,11:00:00,133,59,74,FMN 06 B Zurenborgbrug Ringfietspad
655,Ringfietspad Zurenborgbrug,2023-04-15,12:00:00,165,72,93,FMN 06 B Zurenborgbrug Ringfietspad
655,Ringfietspad Zurenborgbrug,2023-04-15,13:00:00,228,98,130,FMN 06 B Zurenborgbrug Ringfietspad
655,Ringfietspad Zurenborgbrug,2023-04-15,14:00:00,262,102,160,FMN 06 B Zurenborgbrug Ringfietspad
655,Ringfietspad Zurenborgbrug,2023-04-15,15:00:00,235,100,135,FMN 06 B Zurenborgbrug Ringfietspad
655,Ringfietspad Zurenborgbrug,2023-04-15,16:00:00,173,96,77,FMN 06 B Zurenborgbrug Ringfietspad
655,Ringfietspad Zurenborgbrug,2023-04-15,17:00:00,193,108,85,FMN 06 B Zurenborgbrug Ringfietspad
655,Ringfietspad Zurenborgbrug,2023-04-15,18:00:00,176,89,87,FMN 06 B Zurenborgbrug Ringfietspad
655,Ringfietspad Zurenborgbrug,2023-04-15,19:00:00,128,42,86,FMN 06 B Zurenborgbrug Ringfietspad
655,Ringfietspad Zurenborgbrug,2023-04-15,20:00:00,62,22,40,FMN 06 B Zurenborgbrug Ringfietspad
655,Ringfietspad Zurenborgbrug,2023-04-15,21:00:00,63,34,29,FMN 06 B Zurenborgbrug Ringfietspad
655,Ringfietspad Zurenborgbrug,2023-04-15,22:00:00,45,21,24,FMN 06 B Zurenborgbrug Ringfietspad
655,Ringfietspad Zurenborgbrug,2023-04-15,23:00:00,36,23,13,FMN 06 B Zurenborgbrug Ringfietspad
655,Ringfietspad Zurenborgbrug,2023-04-16,00:00:00,28,16,12,FMN 06 B Zurenborgbrug Ringfietspad
655,Ringfietspad Zurenborgbrug,2023-04-16,01:00:00,23,12,11,FMN 06 B Zurenborgbrug Ringfietspad
655,Ringfietspad Zurenborgbrug,2023-04-16,02:00:00,12,3,9,FMN 06 B Zurenborgbrug Ringfietspad
655,Ringfietspad Zurenborgbrug,2023-04-16,03:00:00,11,5,6,FMN 06 B Zurenborgbrug Ringfietspad
655,Ringfietspad Zurenborgbrug,2023-04-16,04:00:00,3,1,2,FMN 06 B Zurenborgbrug Ringfietspad
655,Ringfietspad Zurenborgbrug,2023-04-16,05:00:00,6,3,3,FMN 06 B Zurenborgbrug Ringfietspad
655,Ringfietspad Zurenborgbrug,2023-04-16,06:00:00,21,14,7,FMN 06 B Zurenborgbrug Ringfietspad
655,Ringfietspad Zurenborgbrug,2023-04-16,07:00:00,21,13,8,FMN 06 B Zurenborgbrug Ringfietspad
655,Ringfietspad Zurenborgbrug,2023-04-16,08:00:00,43,20,23,FMN 06 B Zurenborgbrug Ringfietspad
655,Ringfietspad Zurenborgbrug,2023-04-16,09:00:00,46,14,32,FMN 06 B Zurenborgbrug Ringfietspad
655,Ringfietspad Zurenborgbrug,2023-04-16,10:00:00,91,45,46,FMN 06 B Zurenborgbrug Ringfietspad
655,Ringfietspad Zurenborgbrug,2023-04-16,11:00:00,103,41,62,FMN 06 B Zurenborgbrug Ringfietspad
655,Ringfietspad Zurenborgbrug,2023-04-16,12:00:00,114,53,61,FMN 06 B Zurenborgbrug Ringfietspad
655,Ringfietspad Zurenborgbrug,2023-04-16,13:00:00,89,47,42,FMN 06 B Zurenborgbrug Ringfietspad
655,Ringfietspad Zurenborgbrug,2023-04-16,14:00:00,112,49,63,FMN 06 B Zurenborgbrug Ringfietspad
655,Ringfietspad Zurenborgbrug,2023-04-16,15:00:00,104,46,58,FMN 06 B Zurenborgbrug Ringfietspad
655,Ringfietspad Zurenborgbrug,2023-04-16,16:00:00,95,39,56,FMN 06 B Zurenborgbrug Ringfietspad
655,Ringfietspad Zurenborgbrug,2023-04-16,17:00:00,169,47,122,FMN 06 B Zurenborgbrug Ringfietspad
655,Ringfietspad Zurenborgbrug,2023-04-16,18:00:00,80,37,43,FMN 06 B Zurenborgbrug Ringfietspad
655,Ringfietspad Zurenborgbrug,2023-04-16,19:00:00,75,28,47,FMN 06 B Zurenborgbrug Ringfietspad
655,Ringfietspad Zurenborgbrug,2023-04-16,20:00:00,113,82,31,FMN 06 B Zurenborgbrug Ringfietspad
655,Ringfietspad Zurenborgbrug,2023-04-16,21:00:00,67,45,22,FMN 06 B Zurenborgbrug Ringfietspad
655,Ringfietspad Zurenborgbrug,2023-04-16,22:00:00,46,22,24,FMN 06 B Zurenborgbrug Ringfietspad
655,Ringfietspad Zurenborgbrug,2023-04-16,23:00:00,24,14,10,FMN 06 B Zurenborgbrug Ringfietspad
655,Ringfietspad Zurenborgbrug,2023-04-17,00:00:00,12,9,3,FMN 06 B Zurenborgbrug Ringfietspad
655,Ringfietspad Zurenborgbrug,2023-04-17,01:00:00,8,6,2,FMN 06 B Zurenborgbrug Ringfietspad
655,Ringfietspad Zurenborgbrug,2023-04-17,02:00:00,3,1,2,FMN 06 B Zurenborgbrug Ringfietspad
655,Ringfietspad Zurenborgbrug,2023-04-17,03:00:00,5,3,2,FMN 06 B Zurenborgbrug Ringfietspad
655,Ringfietspad Zurenborgbrug,2023-04-17,04:00:00,15,10,5,FMN 06 B Zurenborgbrug Ringfietspad
655,Ringfietspad Zurenborgbrug,2023-04-17,05:00:00,61,37,24,FMN 06 B Zurenborgbrug Ringfietspad
655,Ringfietspad Zurenborgbrug,2023-04-17,06:00:00,160,88,72,FMN 06 B Zurenborgbrug Ringfietspad
655,Ringfietspad Zurenborgbrug,2023-04-17,07:00:00,498,279,219,FMN 06 B Zurenborgbrug Ringfietspad
655,Ringfietspad Zurenborgbrug,2023-04-17,08:00:00,645,368,277,FMN 06 B Zurenborgbrug Ringfietspad
655,Ringfietspad Zurenborgbrug,2023-04-17,09:00:00,167,85,82,FMN 06 B Zurenborgbrug Ringfietspad
655,Ringfietspad Zurenborgbrug,2023-04-17,10:00:00,123,74,49,FMN 06 B Zurenborgbrug Ringfietspad
655,Ringfietspad Zurenborgbrug,2023-04-17,11:00:00,97,49,48,FMN 06 B Zurenborgbrug Ringfietspad
655,Ringfietspad Zurenborgbrug,2023-04-17,12:00:00,169,77,92,FMN 06 B Zurenborgbrug Ringfietspad
655,Ringfietspad Zurenborgbrug,2023-04-17,13:00:00,171,86,85,FMN 06 B Zurenborgbrug Ringfietspad
655,Ringfietspad Zurenborgbrug,2023-04-17,14:00:00,200,82,118,FMN 06 B Zurenborgbrug Ringfietspad
655,Ringfietspad Zurenborgbrug,2023-04-17,15:00:00,319,128,191,FMN 06 B Zurenborgbrug Ringfietspad
655,Ringfietspad Zurenborgbrug,2023-04-17,16:00:00,561,227,334,FMN 06 B Zurenborgbrug Ringfietspad
655,Ringfietspad Zurenborgbrug,2023-04-17,17:00:00,554,219,335,FMN 06 B Zurenborgbrug Ringfietspad
655,Ringfietspad Zurenborgbrug,2023-04-17,18:00:00,374,153,221,FMN 06 B Zurenborgbrug Ringfietspad
655,Ringfietspad Zurenborgbrug,2023-04-17,19:00:00,173,63,110,FMN 06 B Zurenborgbrug Ringfietspad
655,Ringfietspad Zurenborgbrug,2023-04-17,20:00:00,118,48,70,FMN 06 B Zurenborgbrug Ringfietspad
655,Ringfietspad Zurenborgbrug,2023-04-17,21:00:00,94,38,56,FMN 06 B Zurenborgbrug Ringfietspad
655,Ringfietspad Zurenborgbrug,2023-04-17,22:00:00,82,30,52,FMN 06 B Zurenborgbrug Ringfietspad
655,Ringfietspad Zurenborgbrug,2023-04-17,23:00:00,21,6,15,FMN 06 B Zurenborgbrug Ringfietspad
655,Ringfietspad Zurenborgbrug,2023-04-18,00:00:00,17,8,9,FMN 06 B Zurenborgbrug Ringfietspad
655,Ringfietspad Zurenborgbrug,2023-04-18,01:00:00,6,3,3,FMN 06 B Zurenborgbrug Ringfietspad
655,Ringfietspad Zurenborgbrug,2023-04-18,02:00:00,1,0,1,FMN 06 B Zurenborgbrug Ringfietspad
655,Ringfietspad Zurenborgbrug,2023-04-18,03:00:00,3,2,1,FMN 06 B Zurenborgbrug Ringfietspad
655,Ringfietspad Zurenborgbrug,2023-04-18,04:00:00,14,10,4,FMN 06 B Zurenborgbrug Ringfietspad
655,Ringfietspad Zurenborgbrug,2023-04-18,05:00:00,56,27,29,FMN 06 B Zurenborgbrug Ringfietspad
655,Ringfietspad Zurenborgbrug,2023-04-18,06:00:00,177,105,72,FMN 06 B Zurenborgbrug Ringfietspad
655,Ringfietspad Zurenborgbrug,2023-04-18,07:00:00,570,327,243,FMN 06 B Zurenborgbrug Ringfietspad
655,Ringfietspad Zurenborgbrug,2023-04-18,08:00:00,783,460,323,FMN 06 B Zurenborgbrug Ringfietspad
655,Ringfietspad Zurenborgbrug,2023-04-18,09:00:00,203,116,87,FMN 06 B Zurenborgbrug Ringfietspad
655,Ringfietspad Zurenborgbrug,2023-04-18,10:00:00,132,76,56,FMN 06 B Zurenborgbrug Ringfietspad
655,Ringfietspad Zurenborgbrug,2023-04-18,11:00:00,106,53,53,FMN 06 B Zurenborgbrug Ringfietspad
655,Ringfietspad Zurenborgbrug,2023-04-18,12:00:00,181,91,90,FMN 06 B Zurenborgbrug Ringfietspad
655,Ringfietspad Zurenborgbrug,2023-04-18,13:00:00,207,97,110,FMN 06 B Zurenborgbrug Ringfietspad
655,Ringfietspad Zurenborgbrug,2023-04-18,14:00:00,166,65,101,FMN 06 B Zurenborgbrug Ringfietspad
655,Ringfietspad Zurenborgbrug,2023-04-18,15:00:00,326,133,193,FMN 06 B Zurenborgbrug Ringfietspad
655,Ringfietspad Zurenborgbrug,2023-04-18,16:00:00,605,254,351,FMN 06 B Zurenborgbrug Ringfietspad
655,Ringfietspad Zurenborgbrug,2023-04-18,17:00:00,621,201,420,FMN 06 B Zurenborgbrug Ringfietspad
655,Ringfietspad Zurenborgbrug,2023-04-18,18:00:00,387,156,231,FMN 06 B Zurenborgbrug Ringfietspad
655,Ringfietspad Zurenborgbrug,2023-04-18,19:00:00,212,68,144,FMN 06 B Zurenborgbrug Ringfietspad
655,Ringfietspad Zurenborgbrug,2023-04-18,20:00:00,125,55,70,FMN 06 B Zurenborgbrug Ringfietspad
655,Ringfietspad Zurenborgbrug,2023-04-18,21:00:00,96,49,47,FMN 06 B Zurenborgbrug Ringfietspad
655,Ringfietspad Zurenborgbrug,2023-04-18,22:00:00,90,46,44,FMN 06 B Zurenborgbrug Ringfietspad
655,Ringfietspad Zurenborgbrug,2023-04-18,23:00:00,52,32,20,FMN 06 B Zurenborgbrug Ringfietspad
655,Ringfietspad Zurenborgbrug,2023-04-19,00:00:00,21,13,8,FMN 06 B Zurenborgbrug Ringfietspad
655,Ringfietspad Zurenborgbrug,2023-04-19,01:00:00,6,0,6,FMN 06 B Zurenborgbrug Ringfietspad
655,Ringfietspad Zurenborgbrug,2023-04-19,02:00:00,2,0,2,FMN 06 B Zurenborgbrug Ringfietspad
655,Ringfietspad Zurenborgbrug,2023-04-19,03:00:00,4,1,3,FMN 06 B Zurenborgbrug Ringfietspad
655,Ringfietspad Zurenborgbrug,2023-04-19,04:00:00,13,7,6,FMN 06 B Zurenborgbrug Ringfietspad
655,Ringfietspad Zurenborgbrug,2023-04-19,05:00:00,57,36,21,FMN 06 B Zurenborgbrug Ringfietspad
655,Ringfietspad Zurenborgbrug,2023-04-19,06:00:00,142,80,62,FMN 06 B Zurenborgbrug Ringfietspad
655,Ringfietspad Zurenborgbrug,2023-04-19,07:00:00,459,243,216,FMN 06 B Zurenborgbrug Ringfietspad
655,Ringfietspad Zurenborgbrug,2023-04-19,08:00:00,618,335,283,FMN 06 B Zurenborgbrug Ringfietspad
655,Ringfietspad Zurenborgbrug,2023-04-19,09:00:00,191,101,90,FMN 06 B Zurenborgbrug Ringfietspad
655,Ringfietspad Zurenborgbrug,2023-04-19,10:00:00,146,71,75,FMN 06 B Zurenborgbrug Ringfietspad
655,Ringfietspad Zurenborgbrug,2023-04-19,11:00:00,179,93,86,FMN 06 B Zurenborgbrug Ringfietspad
655,Ringfietspad Zurenborgbrug,2023-04-19,12:00:00,438,227,211,FMN 06 B Zurenborgbrug Ringfietspad
655,Ringfietspad Zurenborgbrug,2023-04-19,13:00:00,297,131,166,FMN 06 B Zurenborgbrug Ringfietspad
655,Ringfietspad Zurenborgbrug,2023-04-19,14:00:00,244,106,138,FMN 06 B Zurenborgbrug Ringfietspad
655,Ringfietspad Zurenborgbrug,2023-04-19,15:00:00,280,107,173,FMN 06 B Zurenborgbrug Ringfietspad
655,Ringfietspad Zurenborgbrug,2023-04-19,16:00:00,468,212,256,FMN 06 B Zurenborgbrug Ringfietspad
655,Ringfietspad Zurenborgbrug,2023-04-19,17:00:00,512,203,309,FMN 06 B Zurenborgbrug Ringfietspad
655,Ringfietspad Zurenborgbrug,2023-04-19,18:00:00,394,158,236,FMN 06 B Zurenborgbrug Ringfietspad
655,Ringfietspad Zurenborgbrug,2023-04-19,19:00:00,260,104,156,FMN 06 B Zurenborgbrug Ringfietspad
655,Ringfietspad Zurenborgbrug,2023-04-19,20:00:00,149,62,87,FMN 06 B Zurenborgbrug Ringfietspad
655,Ringfietspad Zurenborgbrug,2023-04-19,21:00:00,120,57,63,FMN 06 B Zurenborgbrug Ringfietspad
655,Ringfietspad Zurenborgbrug,2023-04-19,22:00:00,100,35,65,FMN 06 B Zurenborgbrug Ringfietspad
655,Ringfietspad Zurenborgbrug,2023-04-19,23:00:00,42,20,22,FMN 06 B Zurenborgbrug Ringfietspad
655,Ringfietspad Zurenborgbrug,2023-04-20,00:00:00,20,9,11,FMN 06 B Zurenborgbrug Ringfietspad
655,Ringfietspad Zurenborgbrug,2023-04-20,01:00:00,8,2,6,FMN 06 B Zurenborgbrug Ringfietspad
655,Ringfietspad Zurenborgbrug,2023-04-20,02:00:00,4,3,1,FMN 06 B Zurenborgbrug Ringfietspad
655,Ringfietspad Zurenborgbrug,2023-04-20,03:00:00,3,1,2,FMN 06 B Zurenborgbrug Ringfietspad
655,Ringfietspad Zurenborgbrug,2023-04-20,04:00:00,19,13,6,FMN 06 B Zurenborgbrug Ringfietspad
655,Ringfietspad Zurenborgbrug,2023-04-20,05:00:00,44,26,18,FMN 06 B Zurenborgbrug Ringfietspad
655,Ringfietspad Zurenborgbrug,2023-04-20,06:00:00,157,90,67,FMN 06 B Zurenborgbrug Ringfietspad
655,Ringfietspad Zurenborgbrug,2023-04-20,07:00:00,436,255,181,FMN 06 B Zurenborgbrug Ringfietspad
655,Ringfietspad Zurenborgbrug,2023-04-20,08:00:00,681,404,277,FMN 06 B Zurenborgbrug Ringfietspad
655,Ringfietspad Zurenborgbrug,2023-04-20,09:00:00,194,97,97,FMN 06 B Zurenborgbrug Ringfietspad
655,Ringfietspad Zurenborgbrug,2023-04-20,10:00:00,98,55,43,FMN 06 B Zurenborgbrug Ringfietspad
655,Ringfietspad Zurenborgbrug,2023-04-20,11:00:00,91,47,44,FMN 06 B Zurenborgbrug Ringfietspad
655,Ringfietspad Zurenborgbrug,2023-04-20,12:00:00,147,63,84,FMN 06 B Zurenborgbrug Ringfietspad
655,Ringfietspad Zurenborgbrug,2023-04-20,13:00:00,159,72,87,FMN 06 B Zurenborgbrug Ringfietspad
655,Ringfietspad Zurenborgbrug,2023-04-20,14:00:00,145,58,87,FMN 06 B Zurenborgbrug Ringfietspad
655,Ringfietspad Zurenborgbrug,2023-04-20,15:00:00,269,105,164,FMN 06 B Zurenborgbrug Ringfietspad
655,Ringfietspad Zurenborgbrug,2023-04-20,16:00:00,441,175,266,FMN 06 B Zurenborgbrug Ringfietspad
655,Ringfietspad Zurenborgbrug,2023-04-20,17:00:00,446,153,293,FMN 06 B Zurenborgbrug Ringfietspad
655,Ringfietspad Zurenborgbrug,2023-04-20,18:00:00,333,133,200,FMN 06 B Zurenborgbrug Ringfietspad
655,Ringfietspad Zurenborgbrug,2023-04-20,19:00:00,163,58,105,FMN 06 B Zurenborgbrug Ringfietspad
655,Ringfietspad Zurenborgbrug,2023-04-20,20:00:00,135,53,82,FMN 06 B Zurenborgbrug Ringfietspad
655,Ringfietspad Zurenborgbrug,2023-04-20,21:00:00,95,42,53,FMN 06 B Zurenborgbrug Ringfietspad
655,Ringfietspad Zurenborgbrug,2023-04-20,22:00:00,74,32,42,FMN 06 B Zurenborgbrug Ringfietspad
655,Ringfietspad Zurenborgbrug,2023-04-20,23:00:00,58,38,20,FMN 06 B Zurenborgbrug Ringfietspad
655,Ringfietspad Zurenborgbrug,2023-04-21,00:00:00,18,10,8,FMN 06 B Zurenborgbrug Ringfietspad
655,Ringfietspad Zurenborgbrug,2023-04-21,01:00:00,13,5,8,FMN 06 B Zurenborgbrug Ringfietspad
655,Ringfietspad Zurenborgbrug,2023-04-21,02:00:00,10,4,6,FMN 06 B Zurenborgbrug Ringfietspad
655,Ringfietspad Zurenborgbrug,2023-04-21,03:00:00,6,2,4,FMN 06 B Zurenborgbrug Ringfietspad
655,Ringfietspad Zurenborgbrug,2023-04-21,04:00:00,16,8,8,FMN 06 B Zurenborgbrug Ringfietspad
655,Ringfietspad Zurenborgbrug,2023-04-21,05:00:00,38,23,15,FMN 06 B Zurenborgbrug Ringfietspad
655,Ringfietspad Zurenborgbrug,2023-04-21,06:00:00,125,78,47,FMN 06 B Zurenborgbrug Ringfietspad
655,Ringfietspad Zurenborgbrug,2023-04-21,07:00:00,347,198,149,FMN 06 B Zurenborgbrug Ringfietspad
655,Ringfietspad Zurenborgbrug,2023-04-21,08:00:00,507,294,213,FMN 06 B Zurenborgbrug Ringfietspad
655,Ringfietspad Zurenborgbrug,2023-04-21,09:00:00,156,84,72,FMN 06 B Zurenborgbrug Ringfietspad
655,Ringfietspad Zurenborgbrug,2023-04-21,10:00:00,135,85,50,FMN 06 B Zurenborgbrug Ringfietspad
655,Ringfietspad Zurenborgbrug,2023-04-21,11:00:00,131,69,62,FMN 06 B Zurenborgbrug Ringfietspad
655,Ringfietspad Zurenborgbrug,2023-04-21,12:00:00,215,97,118,FMN 06 B Zurenborgbrug Ringfietspad
655,Ringfietspad Zurenborgbrug,2023-04-21,13:00:00,243,97,146,FMN 06 B Zurenborgbrug Ringfietspad
655,Ringfietspad Zurenborgbrug,2023-04-21,14:00:00,230,90,140,FMN 06 B Zurenborgbrug Ringfietspad
655,Ringfietspad Zurenborgbrug,2023-04-21,15:00:00,344,154,190,FMN 06 B Zurenborgbrug Ringfietspad
655,Ringfietspad Zurenborgbrug,2023-04-21,16:00:00,506,219,287,FMN 06 B Zurenborgbrug Ringfietspad
655,Ringfietspad Zurenborgbrug,2023-04-21,17:00:00,454,166,288,FMN 06 B Zurenborgbrug Ringfietspad
655,Ringfietspad Zurenborgbrug,2023-04-21,18:00:00,276,123,153,FMN 06 B Zurenborgbrug Ringfietspad
655,Ringfietspad Zurenborgbrug,2023-04-21,19:00:00,223,79,144,FMN 06 B Zurenborgbrug Ringfietspad
655,Ringfietspad Zurenborgbrug,2023-04-21,20:00:00,94,41,53,FMN 06 B Zurenborgbrug Ringfietspad
655,Ringfietspad Zurenborgbrug,2023-04-21,21:00:00,71,31,40,FMN 06 B Zurenborgbrug Ringfietspad
655,Ringfietspad Zurenborgbrug,2023-04-21,22:00:00,84,54,30,FMN 06 B Zurenborgbrug Ringfietspad
655,Ringfietspad Zurenborgbrug,2023-04-21,23:00:00,58,27,31,FMN 06 B Zurenborgbrug Ringfietspad
655,Ringfietspad Zurenborgbrug,2023-04-22,00:00:00,40,17,23,FMN 06 B Zurenborgbrug Ringfietspad
655,Ringfietspad Zurenborgbrug,2023-04-22,01:00:00,20,10,10,FMN 06 B Zurenborgbrug Ringfietspad
655,Ringfietspad Zurenborgbrug,2023-04-22,02:00:00,16,8,8,FMN 06 B Zurenborgbrug Ringfietspad
655,Ringfietspad Zurenborgbrug,2023-04-22,03:00:00,9,3,6,FMN 06 B Zurenborgbrug Ringfietspad
655,Ringfietspad Zurenborgbrug,2023-04-22,04:00:00,5,2,3,FMN 06 B Zurenborgbrug Ringfietspad
655,Ringfietspad Zurenborgbrug,2023-04-22,05:00:00,9,6,3,FMN 06 B Zurenborgbrug Ringfietspad
655,Ringfietspad Zurenborgbrug,2023-04-22,06:00:00,22,15,7,FMN 06 B Zurenborgbrug Ringfietspad
655,Ringfietspad Zurenborgbrug,2023-04-22,07:00:00,34,15,19,FMN 06 B Zurenborgbrug Ringfietspad
655,Ringfietspad Zurenborgbrug,2023-04-22,08:00:00,84,44,40,FMN 06 B Zurenborgbrug Ringfietspad
655,Ringfietspad Zurenborgbrug,2023-04-22,09:00:00,118,47,71,FMN 06 B Zurenborgbrug Ringfietspad
655,Ringfietspad Zurenborgbrug,2023-04-22,10:00:00,104,54,50,FMN 06 B Zurenborgbrug Ringfietspad
655,Ringfietspad Zurenborgbrug,2023-04-22,11:00:00,114,60,54,FMN 06 B Zurenborgbrug Ringfietspad
655,Ringfietspad Zurenborgbrug,2023-04-22,12:00:00,104,55,49,FMN 06 B Zurenborgbrug Ringfietspad
655,Ringfietspad Zurenborgbrug,2023-04-22,13:00:00,89,42,47,FMN 06 B Zurenborgbrug Ringfietspad
655,Ringfietspad Zurenborgbrug,2023-04-22,14:00:00,101,42,59,FMN 06 B Zurenborgbrug Ringfietspad
655,Ringfietspad Zurenborgbrug,2023-04-22,15:00:00,89,38,51,FMN 06 B Zurenborgbrug Ringfietspad
655,Ringfietspad Zurenborgbrug,2023-04-22,16:00:00,80,41,39,FMN 06 B Zurenborgbrug Ringfietspad
655,Ringfietspad Zurenborgbrug,2023-04-22,17:00:00,87,45,42,FMN 06 B Zurenborgbrug Ringfietspad
655,Ringfietspad Zurenborgbrug,2023-04-22,18:00:00,96,33,63,FMN 06 B Zurenborgbrug Ringfietspad
655,Ringfietspad Zurenborgbrug,2023-04-22,19:00:00,98,43,55,FMN 06 B Zurenborgbrug Ringfietspad
655,Ringfietspad Zurenborgbrug,2023-04-22,20:00:00,76,25,51,FMN 06 B Zurenborgbrug Ringfietspad
655,Ringfietspad Zurenborgbrug,2023-04-22,21:00:00,43,19,24,FMN 06 B Zurenborgbrug Ringfietspad
655,Ringfietspad Zurenborgbrug,2023-04-22,22:00:00,46,19,27,FMN 06 B Zurenborgbrug Ringfietspad
655,Ringfietspad Zurenborgbrug,2023-04-22,23:00:00,45,32,13,FMN 06 B Zurenborgbrug Ringfietspad
655,Ringfietspad Zurenborgbrug,2023-04-23,00:00:00,36,15,21,FMN 06 B Zurenborgbrug Ringfietspad
655,Ringfietspad Zurenborgbrug,2023-04-23,01:00:00,20,13,7,FMN 06 B Zurenborgbrug Ringfietspad
655,Ringfietspad Zurenborgbrug,2023-04-23,02:00:00,14,8,6,FMN 06 B Zurenborgbrug Ringfietspad
655,Ringfietspad Zurenborgbrug,2023-04-23,03:00:00,12,9,3,FMN 06 B Zurenborgbrug Ringfietspad
655,Ringfietspad Zurenborgbrug,2023-04-23,04:00:00,6,2,4,FMN 06 B Zurenborgbrug Ringfietspad
655,Ringfietspad Zurenborgbrug,2023-04-23,05:00:00,13,6,7,FMN 06 B Zurenborgbrug Ringfietspad
655,Ringfietspad Zurenborgbrug,2023-04-23,06:00:00,19,11,8,FMN 06 B Zurenborgbrug Ringfietspad
655,Ringfietspad Zurenborgbrug,2023-04-23,07:00:00,34,18,16,FMN 06 B Zurenborgbrug Ringfietspad
655,Ringfietspad Zurenborgbrug,2023-04-23,08:00:00,62,26,36,FMN 06 B Zurenborgbrug Ringfietspad
655,Ringfietspad Zurenborgbrug,2023-04-23,09:00:00,140,65,75,FMN 06 B Zurenborgbrug Ringfietspad
655,Ringfietspad Zurenborgbrug,2023-04-23,10:00:00,170,76,94,FMN 06 B Zurenborgbrug Ringfietspad
655,Ringfietspad Zurenborgbrug,2023-04-23,11:00:00,166,70,96,FMN 06 B Zurenborgbrug Ringfietspad
655,Ringfietspad Zurenborgbrug,2023-04-23,12:00:00,212,100,112,FMN 06 B Zurenborgbrug Ringfietspad
655,Ringfietspad Zurenborgbrug,2023-04-23,13:00:00,202,121,81,FMN 06 B Zurenborgbrug Ringfietspad
655,Ringfietspad Zurenborgbrug,2023-04-23,14:00:00,104,57,47,FMN 06 B Zurenborgbrug Ringfietspad
655,Ringfietspad Zurenborgbrug,2023-04-23,15:00:00,64,20,44,FMN 06 B Zurenborgbrug Ringfietspad
655,Ringfietspad Zurenborgbrug,2023-04-23,16:00:00,76,33,43,FMN 06 B Zurenborgbrug Ringfietspad
655,Ringfietspad Zurenborgbrug,2023-04-23,17:00:00,86,47,39,FMN 06 B Zurenborgbrug Ringfietspad
655,Ringfietspad Zurenborgbrug,2023-04-23,18:00:00,86,48,38,FMN 06 B Zurenborgbrug Ringfietspad
655,Ringfietspad Zurenborgbrug,2023-04-23,19:00:00,67,24,43,FMN 06 B Zurenborgbrug Ringfietspad
655,Ringfietspad Zurenborgbrug,2023-04-23,20:00:00,32,13,19,FMN 06 B Zurenborgbrug Ringfietspad
655,Ringfietspad Zurenborgbrug,2023-04-23,21:00:00,44,20,24,FMN 06 B Zurenborgbrug Ringfietspad
655,Ringfietspad Zurenborgbrug,2023-04-23,22:00:00,31,20,11,FMN 06 B Zurenborgbrug Ringfietspad
655,Ringfietspad Zurenborgbrug,2023-04-23,23:00:00,17,7,10,FMN 06 B Zurenborgbrug Ringfietspad
655,Ringfietspad Zurenborgbrug,2023-04-24,00:00:00,6,2,4,FMN 06 B Zurenborgbrug Ringfietspad
655,Ringfietspad Zurenborgbrug,2023-04-24,01:00:00,3,2,1,FMN 06 B Zurenborgbrug Ringfietspad
655,Ringfietspad Zurenborgbrug,2023-04-24,02:00:00,5,2,3,FMN 06 B Zurenborgbrug Ringfietspad
655,Ringfietspad Zurenborgbrug,2023-04-24,03:00:00,2,1,1,FMN 06 B Zurenborgbrug Ringfietspad
655,Ringfietspad Zurenborgbrug,2023-04-24,04:00:00,17,7,10,FMN 06 B Zurenborgbrug Ringfietspad
655,Ringfietspad Zurenborgbrug,2023-04-24,05:00:00,41,23,18,FMN 06 B Zurenborgbrug Ringfietspad
655,Ringfietspad Zurenborgbrug,2023-04-24,06:00:00,92,47,45,FMN 06 B Zurenborgbrug Ringfietspad
655,Ringfietspad Zurenborgbrug,2023-04-24,07:00:00,255,137,118,FMN 06 B Zurenborgbrug Ringfietspad
655,Ringfietspad Zurenborgbrug,2023-04-24,08:00:00,479,280,199,FMN 06 B Zurenborgbrug Ringfietspad
655,Ringfietspad Zurenborgbrug,2023-04-24,09:00:00,189,77,112,FMN 06 B Zurenborgbrug Ringfietspad
655,Ringfietspad Zurenborgbrug,2023-04-24,10:00:00,86,56,30,FMN 06 B Zurenborgbrug Ringfietspad
655,Ringfietspad Zurenborgbrug,2023-04-24,11:00:00,74,36,38,FMN 06 B Zurenborgbrug Ringfietspad
655,Ringfietspad Zurenborgbrug,2023-04-24,12:00:00,132,57,75,FMN 06 B Zurenborgbrug Ringfietspad
655,Ringfietspad Zurenborgbrug,2023-04-24,13:00:00,144,72,72,FMN 06 B Zurenborgbrug Ringfietspad
655,Ringfietspad Zurenborgbrug,2023-04-24,14:00:00,112,46,66,FMN 06 B Zurenborgbrug Ringfietspad
655,Ringfietspad Zurenborgbrug,2023-04-24,15:00:00,221,88,133,FMN 06 B Zurenborgbrug Ringfietspad
655,Ringfietspad Zurenborgbrug,2023-04-24,16:00:00,377,176,201,FMN 06 B Zurenborgbrug Ringfietspad
655,Ringfietspad Zurenborgbrug,2023-04-24,17:00:00,407,173,234,FMN 06 B Zurenborgbrug Ringfietspad
655,Ringfietspad Zurenborgbrug,2023-04-24,18:00:00,276,115,161,FMN 06 B Zurenborgbrug Ringfietspad
655,Ringfietspad Zurenborgbrug,2023-04-24,19:00:00,135,50,85,FMN 06 B Zurenborgbrug Ringfietspad
655,Ringfietspad Zurenborgbrug,2023-04-24,20:00:00,110,53,57,FMN 06 B Zurenborgbrug Ringfietspad
655,Ringfietspad Zurenborgbrug,2023-04-24,21:00:00,75,23,52,FMN 06 B Zurenborgbrug Ringfietspad
655,Ringfietspad Zurenborgbrug,2023-04-24,22:00:00,69,28,41,FMN 06 B Zurenborgbrug Ringfietspad
655,Ringfietspad Zurenborgbrug,2023-04-24,23:00:00,23,7,16,FMN 06 B Zurenborgbrug Ringfietspad
655,Ringfietspad Zurenborgbrug,2023-04-25,00:00:00,9,4,5,FMN 06 B Zurenborgbrug Ringfietspad
655,Ringfietspad Zurenborgbrug,2023-04-25,01:00:00,5,2,3,FMN 06 B Zurenborgbrug Ringfietspad
655,Ringfietspad Zurenborgbrug,2023-04-25,02:00:00,0,0,0,FMN 06 B Zurenborgbrug Ringfietspad
655,Ringfietspad Zurenborgbrug,2023-04-25,03:00:00,2,0,2,FMN 06 B Zurenborgbrug Ringfietspad
655,Ringfietspad Zurenborgbrug,2023-04-25,04:00:00,18,9,9,FMN 06 B Zurenborgbrug Ringfietspad
655,Ringfietspad Zurenborgbrug,2023-04-25,05:00:00,42,21,21,FMN 06 B Zurenborgbrug Ringfietspad
655,Ringfietspad Zurenborgbrug,2023-04-25,06:00:00,171,101,70,FMN 06 B Zurenborgbrug Ringfietspad
655,Ringfietspad Zurenborgbrug,2023-04-25,07:00:00,477,279,198,FMN 06 B Zurenborgbrug Ringfietspad
655,Ringfietspad Zurenborgbrug,2023-04-25,08:00:00,704,420,284,FMN 06 B Zurenborgbrug Ringfietspad
655,Ringfietspad Zurenborgbrug,2023-04-25,09:00:00,175,99,76,FMN 06 B Zurenborgbrug Ringfietspad
655,Ringfietspad Zurenborgbrug,2023-04-25,10:00:00,137,92,45,FMN 06 B Zurenborgbrug Ringfietspad
655,Ringfietspad Zurenborgbrug,2023-04-25,11:00:00,100,57,43,FMN 06 B Zurenborgbrug Ringfietspad
655,Ringfietspad Zurenborgbrug,2023-04-25,12:00:00,200,88,112,FMN 06 B Zurenborgbrug Ringfietspad
655,Ringfietspad Zurenborgbrug,2023-04-25,13:00:00,216,108,108,FMN 06 B Zurenborgbrug Ringfietspad
655,Ringfietspad Zurenborgbrug,2023-04-25,14:00:00,173,70,103,FMN 06 B Zurenborgbrug Ringfietspad
655,Ringfietspad Zurenborgbrug,2023-04-25,15:00:00,321,127,194,FMN 06 B Zurenborgbrug Ringfietspad
655,Ringfietspad Zurenborgbrug,2023-04-25,16:00:00,578,238,340,FMN 06 B Zurenborgbrug Ringfietspad
655,Ringfietspad Zurenborgbrug,2023-04-25,17:00:00,599,233,366,FMN 06 B Zurenborgbrug Ringfietspad
655,Ringfietspad Zurenborgbrug,2023-04-25,18:00:00,411,132,279,FMN 06 B Zurenborgbrug Ringfietspad
655,Ringfietspad Zurenborgbrug,2023-04-25,19:00:00,209,75,134,FMN 06 B Zurenborgbrug Ringfietspad
655,Ringfietspad Zurenborgbrug,2023-04-25,20:00:00,136,64,72,FMN 06 B Zurenborgbrug Ringfietspad
655,Ringfietspad Zurenborgbrug,2023-04-25,21:00:00,98,42,56,FMN 06 B Zurenborgbrug Ringfietspad
655,Ringfietspad Zurenborgbrug,2023-04-25,22:00:00,89,30,59,FMN 06 B Zurenborgbrug Ringfietspad
655,Ringfietspad Zurenborgbrug,2023-04-25,23:00:00,62,39,23,FMN 06 B Zurenborgbrug Ringfietspad
655,Ringfietspad Zurenborgbrug,2023-04-26,00:00:00,20,13,7,FMN 06 B Zurenborgbrug Ringfietspad
655,Ringfietspad Zurenborgbrug,2023-04-26,01:00:00,2,2,0,FMN 06 B Zurenborgbrug Ringfietspad
655,Ringfietspad Zurenborgbrug,2023-04-26,02:00:00,8,4,4,FMN 06 B Zurenborgbrug Ringfietspad
655,Ringfietspad Zurenborgbrug,2023-04-26,03:00:00,5,0,5,FMN 06 B Zurenborgbrug Ringfietspad
655,Ringfietspad Zurenborgbrug,2023-04-26,04:00:00,14,6,8,FMN 06 B Zurenborgbrug Ringfietspad
655,Ringfietspad Zurenborgbrug,2023-04-26,05:00:00,38,22,16,FMN 06 B Zurenborgbrug Ringfietspad
655,Ringfietspad Zurenborgbrug,2023-04-26,06:00:00,140,84,56,FMN 06 B Zurenborgbrug Ringfietspad
655,Ringfietspad Zurenborgbrug,2023-04-26,07:00:00,416,230,186,FMN 06 B Zurenborgbrug Ringfietspad
655,Ringfietspad Zurenborgbrug,2023-04-26,08:00:00,577,327,250,FMN 06 B Zurenborgbrug Ringfietspad
655,Ringfietspad Zurenborgbrug,2023-04-26,09:00:00,163,88,75,FMN 06 B Zurenborgbrug Ringfietspad
655,Ringfietspad Zurenborgbrug,2023-04-26,10:00:00,116,67,49,FMN 06 B Zurenborgbrug Ringfietspad
655,Ringfietspad Zurenborgbrug,2023-04-26,11:00:00,141,67,74,FMN 06 B Zurenborgbrug Ringfietspad
655,Ringfietspad Zurenborgbrug,2023-04-26,12:00:00,327,161,166,FMN 06 B Zurenborgbrug Ringfietspad
655,Ringfietspad Zurenborgbrug,2023-04-26,13:00:00,260,126,134,FMN 06 B Zurenborgbrug Ringfietspad
655,Ringfietspad Zurenborgbrug,2023-04-26,14:00:00,238,130,108,FMN 06 B Zurenborgbrug Ringfietspad
655,Ringfietspad Zurenborgbrug,2023-04-26,15:00:00,238,102,136,FMN 06 B Zurenborgbrug Ringfietspad
655,Ringfietspad Zurenborgbrug,2023-04-26,16:00:00,407,173,234,FMN 06 B Zurenborgbrug Ringfietspad
655,Ringfietspad Zurenborgbrug,2023-04-26,17:00:00,507,191,316,FMN 06 B Zurenborgbrug Ringfietspad
655,Ringfietspad Zurenborgbrug,2023-04-26,18:00:00,342,135,207,FMN 06 B Zurenborgbrug Ringfietspad
655,Ringfietspad Zurenborgbrug,2023-04-26,19:00:00,186,77,109,FMN 06 B Zurenborgbrug Ringfietspad
655,Ringfietspad Zurenborgbrug,2023-04-26,20:00:00,124,55,69,FMN 06 B Zurenborgbrug Ringfietspad
655,Ringfietspad Zurenborgbrug,2023-04-26,21:00:00,105,32,73,FMN 06 B Zurenborgbrug Ringfietspad
655,Ringfietspad Zurenborgbrug,2023-04-26,22:00:00,85,35,50,FMN 06 B Zurenborgbrug Ringfietspad
655,Ringfietspad Zurenborgbrug,2023-04-26,23:00:00,31,20,11,FMN 06 B Zurenborgbrug Ringfietspad
655,Ringfietspad Zurenborgbrug,2023-04-27,00:00:00,9,3,6,FMN 06 B Zurenborgbrug Ringfietspad
655,Ringfietspad Zurenborgbrug,2023-04-27,01:00:00,7,4,3,FMN 06 B Zurenborgbrug Ringfietspad
655,Ringfietspad Zurenborgbrug,2023-04-27,02:00:00,6,1,5,FMN 06 B Zurenborgbrug Ringfietspad
655,Ringfietspad Zurenborgbrug,2023-04-27,03:00:00,1,1,0,FMN 06 B Zurenborgbrug Ringfietspad
655,Ringfietspad Zurenborgbrug,2023-04-27,04:00:00,13,6,7,FMN 06 B Zurenborgbrug Ringfietspad
655,Ringfietspad Zurenborgbrug,2023-04-27,05:00:00,56,34,22,FMN 06 B Zurenborgbrug Ringfietspad
655,Ringfietspad Zurenborgbrug,2023-04-27,06:00:00,152,92,60,FMN 06 B Zurenborgbrug Ringfietspad
655,Ringfietspad Zurenborgbrug,2023-04-27,07:00:00,491,283,208,FMN 06 B Zurenborgbrug Ringfietspad
655,Ringfietspad Zurenborgbrug,2023-04-27,08:00:00,679,401,278,FMN 06 B Zurenborgbrug Ringfietspad
655,Ringfietspad Zurenborgbrug,2023-04-27,09:00:00,233,128,105,FMN 06 B Zurenborgbrug Ringfietspad
655,Ringfietspad Zurenborgbrug,2023-04-27,10:00:00,129,71,58,FMN 06 B Zurenborgbrug Ringfietspad
655,Ringfietspad Zurenborgbrug,2023-04-27,11:00:00,133,66,67,FMN 06 B Zurenborgbrug Ringfietspad
655,Ringfietspad Zurenborgbrug,2023-04-27,12:00:00,215,97,118,FMN 06 B Zurenborgbrug Ringfietspad
655,Ringfietspad Zurenborgbrug,2023-04-27,13:00:00,212,105,107,FMN 06 B Zurenborgbrug Ringfietspad
655,Ringfietspad Zurenborgbrug,2023-04-27,14:00:00,186,74,112,FMN 06 B Zurenborgbrug Ringfietspad
655,Ringfietspad Zurenborgbrug,2023-04-27,15:00:00,362,128,234,FMN 06 B Zurenborgbrug Ringfietspad
655,Ringfietspad Zurenborgbrug,2023-04-27,16:00:00,551,219,332,FMN 06 B Zurenborgbrug Ringfietspad
655,Ringfietspad Zurenborgbrug,2023-04-27,17:00:00,604,248,356,FMN 06 B Zurenborgbrug Ringfietspad
655,Ringfietspad Zurenborgbrug,2023-04-27,18:00:00,387,141,246,FMN 06 B Zurenborgbrug Ringfietspad
655,Ringfietspad Zurenborgbrug,2023-04-27,19:00:00,213,83,130,FMN 06 B Zurenborgbrug Ringfietspad
655,Ringfietspad Zurenborgbrug,2023-04-27,20:00:00,128,52,76,FMN 06 B Zurenborgbrug Ringfietspad
655,Ringfietspad Zurenborgbrug,2023-04-27,21:00:00,94,42,52,FMN 06 B Zurenborgbrug Ringfietspad
655,Ringfietspad Zurenborgbrug,2023-04-27,22:00:00,104,47,57,FMN 06 B Zurenborgbrug Ringfietspad
655,Ringfietspad Zurenborgbrug,2023-04-27,23:00:00,50,20,30,FMN 06 B Zurenborgbrug Ringfietspad
655,Ringfietspad Zurenborgbrug,2023-04-28,00:00:00,28,12,16,FMN 06 B Zurenborgbrug Ringfietspad
655,Ringfietspad Zurenborgbrug,2023-04-28,01:00:00,3,0,3,FMN 06 B Zurenborgbrug Ringfietspad
655,Ringfietspad Zurenborgbrug,2023-04-28,02:00:00,3,1,2,FMN 06 B Zurenborgbrug Ringfietspad
655,Ringfietspad Zurenborgbrug,2023-04-28,03:00:00,2,0,2,FMN 06 B Zurenborgbrug Ringfietspad
655,Ringfietspad Zurenborgbrug,2023-04-28,04:00:00,12,7,5,FMN 06 B Zurenborgbrug Ringfietspad
655,Ringfietspad Zurenborgbrug,2023-04-28,05:00:00,45,27,18,FMN 06 B Zurenborgbrug Ringfietspad
655,Ringfietspad Zurenborgbrug,2023-04-28,06:00:00,123,73,50,FMN 06 B Zurenborgbrug Ringfietspad
655,Ringfietspad Zurenborgbrug,2023-04-28,07:00:00,327,166,161,FMN 06 B Zurenborgbrug Ringfietspad
655,Ringfietspad Zurenborgbrug,2023-04-28,08:00:00,465,271,194,FMN 06 B Zurenborgbrug Ringfietspad
655,Ringfietspad Zurenborgbrug,2023-04-28,09:00:00,140,83,57,FMN 06 B Zurenborgbrug Ringfietspad
655,Ringfietspad Zurenborgbrug,2023-04-28,10:00:00,99,61,38,FMN 06 B Zurenborgbrug Ringfietspad
655,Ringfietspad Zurenborgbrug,2023-04-28,11:00:00,95,43,52,FMN 06 B Zurenborgbrug Ringfietspad
655,Ringfietspad Zurenborgbrug,2023-04-28,12:00:00,196,81,115,FMN 06 B Zurenborgbrug Ringfietspad
655,Ringfietspad Zurenborgbrug,2023-04-28,13:00:00,139,62,77,FMN 06 B Zurenborgbrug Ringfietspad
655,Ringfietspad Zurenborgbrug,2023-04-28,14:00:00,145,46,99,FMN 06 B Zurenborgbrug Ringfietspad
655,Ringfietspad Zurenborgbrug,2023-04-28,15:00:00,269,113,156,FMN 06 B Zurenborgbrug Ringfietspad
655,Ringfietspad Zurenborgbrug,2023-04-28,16:00:00,382,165,217,FMN 06 B Zurenborgbrug Ringfietspad
655,Ringfietspad Zurenborgbrug,2023-04-28,17:00:00,310,121,189,FMN 06 B Zurenborgbrug Ringfietspad
655,Ringfietspad Zurenborgbrug,2023-04-28,18:00:00,213,89,124,FMN 06 B Zurenborgbrug Ringfietspad
655,Ringfietspad Zurenborgbrug,2023-04-28,19:00:00,135,44,91,FMN 06 B Zurenborgbrug Ringfietspad
655,Ringfietspad Zurenborgbrug,2023-04-28,20:00:00,99,44,55,FMN 06 B Zurenborgbrug Ringfietspad
655,Ringfietspad Zurenborgbrug,2023-04-28,21:00:00,64,34,30,FMN 06 B Zurenborgbrug Ringfietspad
655,Ringfietspad Zurenborgbrug,2023-04-28,22:00:00,85,42,43,FMN 06 B Zurenborgbrug Ringfietspad
655,Ringfietspad Zurenborgbrug,2023-04-28,23:00:00,60,29,31,FMN 06 B Zurenborgbrug Ringfietspad
655,Ringfietspad Zurenborgbrug,2023-04-29,00:00:00,28,15,13,FMN 06 B Zurenborgbrug Ringfietspad
655,Ringfietspad Zurenborgbrug,2023-04-29,01:00:00,19,7,12,FMN 06 B Zurenborgbrug Ringfietspad
655,Ringfietspad Zurenborgbrug,2023-04-29,02:00:00,11,6,5,FMN 06 B Zurenborgbrug Ringfietspad
655,Ringfietspad Zurenborgbrug,2023-04-29,03:00:00,7,4,3,FMN 06 B Zurenborgbrug Ringfietspad
655,Ringfietspad Zurenborgbrug,2023-04-29,04:00:00,6,3,3,FMN 06 B Zurenborgbrug Ringfietspad
655,Ringfietspad Zurenborgbrug,2023-04-29,05:00:00,16,10,6,FMN 06 B Zurenborgbrug Ringfietspad
655,Ringfietspad Zurenborgbrug,2023-04-29,06:00:00,21,12,9,FMN 06 B Zurenborgbrug Ringfietspad
655,Ringfietspad Zurenborgbrug,2023-04-29,07:00:00,24,11,13,FMN 06 B Zurenborgbrug Ringfietspad
655,Ringfietspad Zurenborgbrug,2023-04-29,08:00:00,42,24,18,FMN 06 B Zurenborgbrug Ringfietspad
655,Ringfietspad Zurenborgbrug,2023-04-29,09:00:00,109,44,65,FMN 06 B Zurenborgbrug Ringfietspad
655,Ringfietspad Zurenborgbrug,2023-04-29,10:00:00,115,38,77,FMN 06 B Zurenborgbrug Ringfietspad
655,Ringfietspad Zurenborgbrug,2023-04-29,11:00:00,110,46,64,FMN 06 B Zurenborgbrug Ringfietspad
655,Ringfietspad Zurenborgbrug,2023-04-29,12:00:00,132,60,72,FMN 06 B Zurenborgbrug Ringfietspad
655,Ringfietspad Zurenborgbrug,2023-04-29,13:00:00,143,71,72,FMN 06 B Zurenborgbrug Ringfietspad
655,Ringfietspad Zurenborgbrug,2023-04-29,14:00:00,177,75,102,FMN 06 B Zurenborgbrug Ringfietspad
655,Ringfietspad Zurenborgbrug,2023-04-29,15:00:00,150,72,78,FMN 06 B Zurenborgbrug Ringfietspad
655,Ringfietspad Zurenborgbrug,2023-04-29,16:00:00,129,54,75,FMN 06 B Zurenborgbrug Ringfietspad
655,Ringfietspad Zurenborgbrug,2023-04-29,17:00:00,139,64,75,FMN 06 B Zurenborgbrug Ringfietspad
655,Ringfietspad Zurenborgbrug,2023-04-29,18:00:00,110,47,63,FMN 06 B Zurenborgbrug Ringfietspad
655,Ringfietspad Zurenborgbrug,2023-04-29,19:00:00,108,45,63,FMN 06 B Zurenborgbrug Ringfietspad
655,Ringfietspad Zurenborgbrug,2023-04-29,20:00:00,70,26,44,FMN 06 B Zurenborgbrug Ringfietspad
655,Ringfietspad Zurenborgbrug,2023-04-29,21:00:00,61,26,35,FMN 06 B Zurenborgbrug Ringfietspad
655,Ringfietspad Zurenborgbrug,2023-04-29,22:00:00,54,17,37,FMN 06 B Zurenborgbrug Ringfietspad
655,Ringfietspad Zurenborgbrug,2023-04-29,23:00:00,39,26,13,FMN 06 B Zurenborgbrug Ringfietspad
655,Ringfietspad Zurenborgbrug,2023-04-30,00:00:00,32,13,19,FMN 06 B Zurenborgbrug Ringfietspad
655,Ringfietspad Zurenborgbrug,2023-04-30,01:00:00,21,14,7,FMN 06 B Zurenborgbrug Ringfietspad
655,Ringfietspad Zurenborgbrug,2023-04-30,02:00:00,11,6,5,FMN 06 B Zurenborgbrug Ringfietspad
655,Ringfietspad Zurenborgbrug,2023-04-30,03:00:00,9,5,4,FMN 06 B Zurenborgbrug Ringfietspad
655,Ringfietspad Zurenborgbrug,2023-04-30,04:00:00,11,7,4,FMN 06 B Zurenborgbrug Ringfietspad
655,Ringfietspad Zurenborgbrug,2023-04-30,05:00:00,15,7,8,FMN 06 B Zurenborgbrug Ringfietspad
655,Ringfietspad Zurenborgbrug,2023-04-30,06:00:00,20,10,10,FMN 06 B Zurenborgbrug Ringfietspad
655,Ringfietspad Zurenborgbrug,2023-04-30,07:00:00,27,10,17,FMN 06 B Zurenborgbrug Ringfietspad
655,Ringfietspad Zurenborgbrug,2023-04-30,08:00:00,47,20,27,FMN 06 B Zurenborgbrug Ringfietspad
655,Ringfietspad Zurenborgbrug,2023-04-30,09:00:00,157,51,106,FMN 06 B Zurenborgbrug Ringfietspad
655,Ringfietspad Zurenborgbrug,2023-04-30,10:00:00,149,70,79,FMN 06 B Zurenborgbrug Ringfietspad
655,Ringfietspad Zurenborgbrug,2023-04-30,11:00:00,209,85,124,FMN 06 B Zurenborgbrug Ringfietspad
655,Ringfietspad Zurenborgbrug,2023-04-30,12:00:00,214,101,113,FMN 06 B Zurenborgbrug Ringfietspad
655,Ringfietspad Zurenborgbrug,2023-04-30,13:00:00,315,120,195,FMN 06 B Zurenborgbrug Ringfietspad
655,Ringfietspad Zurenborgbrug,2023-04-30,14:00:00,277,116,161,FMN 06 B Zurenborgbrug Ringfietspad
655,Ringfietspad Zurenborgbrug,2023-04-30,15:00:00,266,109,157,FMN 06 B Zurenborgbrug Ringfietspad
655,Ringfietspad Zurenborgbrug,2023-04-30,16:00:00,226,125,101,FMN 06 B Zurenborgbrug Ringfietspad
655,Ringfietspad Zurenborgbrug,2023-04-30,17:00:00,185,107,78,FMN 06 B Zurenborgbrug Ringfietspad
655,Ringfietspad Zurenborgbrug,2023-04-30,18:00:00,194,100,94,FMN 06 B Zurenborgbrug Ringfietspad
655,Ringfietspad Zurenborgbrug,2023-04-30,19:00:00,116,46,70,FMN 06 B Zurenborgbrug Ringfietspad
655,Ringfietspad Zurenborgbrug,2023-04-30,20:00:00,126,54,72,FMN 06 B Zurenborgbrug Ringfietspad
655,Ringfietspad Zurenborgbrug,2023-04-30,21:00:00,81,53,28,FMN 06 B Zurenborgbrug Ringfietspad
655,Ringfietspad Zurenborgbrug,2023-04-30,22:00:00,63,20,43,FMN 06 B Zurenborgbrug Ringfietspad
655,Ringfietspad Zurenborgbrug,2023-04-30,23:00:00,47,22,25,FMN 06 B Zurenborgbrug Ringfietspad
655,Ringfietspad Zurenborgbrug,2023-05-01,00:00:00,17,4,13,FMN 06 B Zurenborgbrug Ringfietspad
655,Ringfietspad Zurenborgbrug,2023-05-01,01:00:00,10,8,2,FMN 06 B Zurenborgbrug Ringfietspad
655,Ringfietspad Zurenborgbrug,2023-05-01,02:00:00,6,5,1,FMN 06 B Zurenborgbrug Ringfietspad
655,Ringfietspad Zurenborgbrug,2023-05-01,03:00:00,5,2,3,FMN 06 B Zurenborgbrug Ringfietspad
655,Ringfietspad Zurenborgbrug,2023-05-01,04:00:00,8,5,3,FMN 06 B Zurenborgbrug Ringfietspad
655,Ringfietspad Zurenborgbrug,2023-05-01,05:00:00,14,8,6,FMN 06 B Zurenborgbrug Ringfietspad
655,Ringfietspad Zurenborgbrug,2023-05-01,06:00:00,27,15,12,FMN 06 B Zurenborgbrug Ringfietspad
655,Ringfietspad Zurenborgbrug,2023-05-01,07:00:00,27,16,11,FMN 06 B Zurenborgbrug Ringfietspad
655,Ringfietspad Zurenborgbrug,2023-05-01,08:00:00,72,40,32,FMN 06 B Zurenborgbrug Ringfietspad
655,Ringfietspad Zurenborgbrug,2023-05-01,09:00:00,181,76,105,FMN 06 B Zurenborgbrug Ringfietspad
655,Ringfietspad Zurenborgbrug,2023-05-01,10:00:00,277,76,201,FMN 06 B Zurenborgbrug Ringfietspad
655,Ringfietspad Zurenborgbrug,2023-05-01,11:00:00,347,98,249,FMN 06 B Zurenborgbrug Ringfietspad
655,Ringfietspad Zurenborgbrug,2023-05-01,12:00:00,171,58,113,FMN 06 B Zurenborgbrug Ringfietspad
655,Ringfietspad Zurenborgbrug,2023-05-01,13:00:00,271,95,176,FMN 06 B Zurenborgbrug Ringfietspad
655,Ringfietspad Zurenborgbrug,2023-05-01,14:00:00,285,128,157,FMN 06 B Zurenborgbrug Ringfietspad
655,Ringfietspad Zurenborgbrug,2023-05-01,15:00:00,225,100,125,FMN 06 B Zurenborgbrug Ringfietspad
655,Ringfietspad Zurenborgbrug,2023-05-01,16:00:00,157,73,84,FMN 06 B Zurenborgbrug Ringfietspad
655,Ringfietspad Zurenborgbrug,2023-05-01,17:00:00,206,100,106,FMN 06 B Zurenborgbrug Ringfietspad
655,Ringfietspad Zurenborgbrug,2023-05-01,18:00:00,162,76,86,FMN 06 B Zurenborgbrug Ringfietspad
655,Ringfietspad Zurenborgbrug,2023-05-01,19:00:00,134,65,69,FMN 06 B Zurenborgbrug Ringfietspad
655,Ringfietspad Zurenborgbrug,2023-05-01,20:00:00,64,27,37,FMN 06 B Zurenborgbrug Ringfietspad
655,Ringfietspad Zurenborgbrug,2023-05-01,21:00:00,57,23,34,FMN 06 B Zurenborgbrug Ringfietspad
655,Ringfietspad Zurenborgbrug,2023-05-01,22:00:00,66,41,25,FMN 06 B Zurenborgbrug Ringfietspad
655,Ringfietspad Zurenborgbrug,2023-05-01,23:00:00,11,5,6,FMN 06 B Zurenborgbrug Ringfietspad
655,Ringfietspad Zurenborgbrug,2023-05-02,00:00:00,11,4,7,FMN 06 B Zurenborgbrug Ringfietspad
655,Ringfietspad Zurenborgbrug,2023-05-02,01:00:00,3,0,3,FMN 06 B Zurenborgbrug Ringfietspad
655,Ringfietspad Zurenborgbrug,2023-05-02,02:00:00,4,2,2,FMN 06 B Zurenborgbrug Ringfietspad
655,Ringfietspad Zurenborgbrug,2023-05-02,03:00:00,2,1,1,FMN 06 B Zurenborgbrug Ringfietspad
655,Ringfietspad Zurenborgbrug,2023-05-02,04:00:00,21,12,9,FMN 06 B Zurenborgbrug Ringfietspad
655,Ringfietspad Zurenborgbrug,2023-05-02,05:00:00,48,29,19,FMN 06 B Zurenborgbrug Ringfietspad
655,Ringfietspad Zurenborgbrug,2023-05-02,06:00:00,158,91,67,FMN 06 B Zurenborgbrug Ringfietspad
655,Ringfietspad Zurenborgbrug,2023-05-02,07:00:00,498,285,213,FMN 06 B Zurenborgbrug Ringfietspad
655,Ringfietspad Zurenborgbrug,2023-05-02,08:00:00,736,417,319,FMN 06 B Zurenborgbrug Ringfietspad
655,Ringfietspad Zurenborgbrug,2023-05-02,09:00:00,226,133,93,FMN 06 B Zurenborgbrug Ringfietspad
655,Ringfietspad Zurenborgbrug,2023-05-02,10:00:00,141,83,58,FMN 06 B Zurenborgbrug Ringfietspad
655,Ringfietspad Zurenborgbrug,2023-05-02,11:00:00,108,61,47,FMN 06 B Zurenborgbrug Ringfietspad
655,Ringfietspad Zurenborgbrug,2023-05-02,12:00:00,192,89,103,FMN 06 B Zurenborgbrug Ringfietspad
655,Ringfietspad Zurenborgbrug,2023-05-02,13:00:00,224,108,116,FMN 06 B Zurenborgbrug Ringfietspad
655,Ringfietspad Zurenborgbrug,2023-05-02,14:00:00,203,79,124,FMN 06 B Zurenborgbrug Ringfietspad
655,Ringfietspad Zurenborgbrug,2023-05-02,15:00:00,330,128,202,FMN 06 B Zurenborgbrug Ringfietspad
655,Ringfietspad Zurenborgbrug,2023-05-02,16:00:00,598,260,338,FMN 06 B Zurenborgbrug Ringfietspad
655,Ringfietspad Zurenborgbrug,2023-05-02,17:00:00,665,245,420,FMN 06 B Zurenborgbrug Ringfietspad
655,Ringfietspad Zurenborgbrug,2023-05-02,18:00:00,399,136,263,FMN 06 B Zurenborgbrug Ringfietspad
655,Ringfietspad Zurenborgbrug,2023-05-02,19:00:00,218,79,139,FMN 06 B Zurenborgbrug Ringfietspad
655,Ringfietspad Zurenborgbrug,2023-05-02,20:00:00,129,65,64,FMN 06 B Zurenborgbrug Ringfietspad
655,Ringfietspad Zurenborgbrug,2023-05-02,21:00:00,106,49,57,FMN 06 B Zurenborgbrug Ringfietspad
655,Ringfietspad Zurenborgbrug,2023-05-02,22:00:00,84,30,54,FMN 06 B Zurenborgbrug Ringfietspad
655,Ringfietspad Zurenborgbrug,2023-05-02,23:00:00,26,12,14,FMN 06 B Zurenborgbrug Ringfietspad
655,Ringfietspad Zurenborgbrug,2023-05-03,00:00:00,7,5,2,FMN 06 B Zurenborgbrug Ringfietspad
655,Ringfietspad Zurenborgbrug,2023-05-03,01:00:00,6,2,4,FMN 06 B Zurenborgbrug Ringfietspad
655,Ringfietspad Zurenborgbrug,2023-05-03,02:00:00,2,1,1,FMN 06 B Zurenborgbrug Ringfietspad
655,Ringfietspad Zurenborgbrug,2023-05-03,03:00:00,1,0,1,FMN 06 B Zurenborgbrug Ringfietspad
655,Ringfietspad Zurenborgbrug,2023-05-03,04:00:00,22,12,10,FMN 06 B Zurenborgbrug Ringfietspad
655,Ringfietspad Zurenborgbrug,2023-05-03,05:00:00,49,29,20,FMN 06 B Zurenborgbrug Ringfietspad
655,Ringfietspad Zurenborgbrug,2023-05-03,06:00:00,168,104,64,FMN 06 B Zurenborgbrug Ringfietspad
655,Ringfietspad Zurenborgbrug,2023-05-03,07:00:00,444,246,198,FMN 06 B Zurenborgbrug Ringfietspad
655,Ringfietspad Zurenborgbrug,2023-05-03,08:00:00,647,364,283,FMN 06 B Zurenborgbrug Ringfietspad
655,Ringfietspad Zurenborgbrug,2023-05-03,09:00:00,194,105,89,FMN 06 B Zurenborgbrug Ringfietspad
655,Ringfietspad Zurenborgbrug,2023-05-03,10:00:00,143,87,56,FMN 06 B Zurenborgbrug Ringfietspad
655,Ringfietspad Zurenborgbrug,2023-05-03,11:00:00,184,89,95,FMN 06 B Zurenborgbrug Ringfietspad
655,Ringfietspad Zurenborgbrug,2023-05-03,12:00:00,436,210,226,FMN 06 B Zurenborgbrug Ringfietspad
655,Ringfietspad Zurenborgbrug,2023-05-03,13:00:00,303,156,147,FMN 06 B Zurenborgbrug Ringfietspad
655,Ringfietspad Zurenborgbrug,2023-05-03,14:00:00,262,91,171,FMN 06 B Zurenborgbrug Ringfietspad
655,Ringfietspad Zurenborgbrug,2023-05-03,15:00:00,332,132,200,FMN 06 B Zurenborgbrug Ringfietspad
655,Ringfietspad Zurenborgbrug,2023-05-03,16:00:00,468,193,275,FMN 06 B Zurenborgbrug Ringfietspad
655,Ringfietspad Zurenborgbrug,2023-05-03,17:00:00,556,208,348,FMN 06 B Zurenborgbrug Ringfietspad
655,Ringfietspad Zurenborgbrug,2023-05-03,18:00:00,455,193,262,FMN 06 B Zurenborgbrug Ringfietspad
655,Ringfietspad Zurenborgbrug,2023-05-03,19:00:00,220,89,131,FMN 06 B Zurenborgbrug Ringfietspad
655,Ringfietspad Zurenborgbrug,2023-05-03,20:00:00,187,71,116,FMN 06 B Zurenborgbrug Ringfietspad
655,Ringfietspad Zurenborgbrug,2023-05-03,21:00:00,146,58,88,FMN 06 B Zurenborgbrug Ringfietspad
655,Ringfietspad Zurenborgbrug,2023-05-03,22:00:00,107,47,60,FMN 06 B Zurenborgbrug Ringfietspad
655,Ringfietspad Zurenborgbrug,2023-05-03,23:00:00,45,20,25,FMN 06 B Zurenborgbrug Ringfietspad
655,Ringfietspad Zurenborgbrug,2023-05-04,00:00:00,11,7,4,FMN 06 B Zurenborgbrug Ringfietspad
655,Ringfietspad Zurenborgbrug,2023-05-04,01:00:00,6,2,4,FMN 06 B Zurenborgbrug Ringfietspad
655,Ringfietspad Zurenborgbrug,2023-05-04,02:00:00,0,0,0,FMN 06 B Zurenborgbrug Ringfietspad
655,Ringfietspad Zurenborgbrug,2023-05-04,03:00:00,2,1,1,FMN 06 B Zurenborgbrug Ringfietspad
655,Ringfietspad Zurenborgbrug,2023-05-04,04:00:00,18,14,4,FMN 06 B Zurenborgbrug Ringfietspad
655,Ringfietspad Zurenborgbrug,2023-05-04,05:00:00,61,42,19,FMN 06 B Zurenborgbrug Ringfietspad
655,Ringfietspad Zurenborgbrug,2023-05-04,06:00:00,187,118,69,FMN 06 B Zurenborgbrug Ringfietspad
655,Ringfietspad Zurenborgbrug,2023-05-04,07:00:00,538,296,242,FMN 06 B Zurenborgbrug Ringfietspad
655,Ringfietspad Zurenborgbrug,2023-05-04,08:00:00,746,444,302,FMN 06 B Zurenborgbrug Ringfietspad
655,Ringfietspad Zurenborgbrug,2023-05-04,09:00:00,234,126,108,FMN 06 B Zurenborgbrug Ringfietspad
655,Ringfietspad Zurenborgbrug,2023-05-04,10:00:00,146,74,72,FMN 06 B Zurenborgbrug Ringfietspad
655,Ringfietspad Zurenborgbrug,2023-05-04,11:00:00,161,82,79,FMN 06 B Zurenborgbrug Ringfietspad
655,Ringfietspad Zurenborgbrug,2023-05-04,12:00:00,236,105,131,FMN 06 B Zurenborgbrug Ringfietspad
655,Ringfietspad Zurenborgbrug,2023-05-04,13:00:00,307,147,160,FMN 06 B Zurenborgbrug Ringfietspad
655,Ringfietspad Zurenborgbrug,2023-05-04,14:00:00,290,140,150,FMN 06 B Zurenborgbrug Ringfietspad
655,Ringfietspad Zurenborgbrug,2023-05-04,15:00:00,436,179,257,FMN 06 B Zurenborgbrug Ringfietspad
655,Ringfietspad Zurenborgbrug,2023-05-04,16:00:00,676,273,403,FMN 06 B Zurenborgbrug Ringfietspad
655,Ringfietspad Zurenborgbrug,2023-05-04,17:00:00,632,248,384,FMN 06 B Zurenborgbrug Ringfietspad
655,Ringfietspad Zurenborgbrug,2023-05-04,18:00:00,424,178,246,FMN 06 B Zurenborgbrug Ringfietspad
655,Ringfietspad Zurenborgbrug,2023-05-04,19:00:00,275,102,173,FMN 06 B Zurenborgbrug Ringfietspad
655,Ringfietspad Zurenborgbrug,2023-05-04,20:00:00,181,104,77,FMN 06 B Zurenborgbrug Ringfietspad
655,Ringfietspad Zurenborgbrug,2023-05-04,21:00:00,125,54,71,FMN 06 B Zurenborgbrug Ringfietspad
655,Ringfietspad Zurenborgbrug,2023-05-04,22:00:00,106,49,57,FMN 06 B Zurenborgbrug Ringfietspad
655,Ringfietspad Zurenborgbrug,2023-05-04,23:00:00,49,20,29,FMN 06 B Zurenborgbrug Ringfietspad
655,Ringfietspad Zurenborgbrug,2023-05-05,00:00:00,11,4,7,FMN 06 B Zurenborgbrug Ringfietspad
655,Ringfietspad Zurenborgbrug,2023-05-05,01:00:00,10,6,4,FMN 06 B Zurenborgbrug Ringfietspad
655,Ringfietspad Zurenborgbrug,2023-05-05,02:00:00,3,1,2,FMN 06 B Zurenborgbrug Ringfietspad
655,Ringfietspad Zurenborgbrug,2023-05-05,03:00:00,1,1,0,FMN 06 B Zurenborgbrug Ringfietspad
655,Ringfietspad Zurenborgbrug,2023-05-05,04:00:00,17,12,5,FMN 06 B Zurenborgbrug Ringfietspad
655,Ringfietspad Zurenborgbrug,2023-05-05,05:00:00,52,33,19,FMN 06 B Zurenborgbrug Ringfietspad
655,Ringfietspad Zurenborgbrug,2023-05-05,06:00:00,146,83,63,FMN 06 B Zurenborgbrug Ringfietspad
655,Ringfietspad Zurenborgbrug,2023-05-05,07:00:00,328,182,146,FMN 06 B Zurenborgbrug Ringfietspad
655,Ringfietspad Zurenborgbrug,2023-05-05,08:00:00,526,302,224,FMN 06 B Zurenborgbrug Ringfietspad
655,Ringfietspad Zurenborgbrug,2023-05-05,09:00:00,194,108,86,FMN 06 B Zurenborgbrug Ringfietspad
655,Ringfietspad Zurenborgbrug,2023-05-05,10:00:00,109,53,56,FMN 06 B Zurenborgbrug Ringfietspad
655,Ringfietspad Zurenborgbrug,2023-05-05,11:00:00,86,44,42,FMN 06 B Zurenborgbrug Ringfietspad
655,Ringfietspad Zurenborgbrug,2023-05-05,12:00:00,147,60,87,FMN 06 B Zurenborgbrug Ringfietspad
655,Ringfietspad Zurenborgbrug,2023-05-05,13:00:00,157,73,84,FMN 06 B Zurenborgbrug Ringfietspad
655,Ringfietspad Zurenborgbrug,2023-05-05,14:00:00,146,53,93,FMN 06 B Zurenborgbrug Ringfietspad
655,Ringfietspad Zurenborgbrug,2023-05-05,15:00:00,314,110,204,FMN 06 B Zurenborgbrug Ringfietspad
655,Ringfietspad Zurenborgbrug,2023-05-05,16:00:00,408,167,241,FMN 06 B Zurenborgbrug Ringfietspad
655,Ringfietspad Zurenborgbrug,2023-05-05,17:00:00,355,128,227,FMN 06 B Zurenborgbrug Ringfietspad
655,Ringfietspad Zurenborgbrug,2023-05-05,18:00:00,236,100,136,FMN 06 B Zurenborgbrug Ringfietspad
655,Ringfietspad Zurenborgbrug,2023-05-05,19:00:00,151,59,92,FMN 06 B Zurenborgbrug Ringfietspad
655,Ringfietspad Zurenborgbrug,2023-05-05,20:00:00,99,40,59,FMN 06 B Zurenborgbrug Ringfietspad
655,Ringfietspad Zurenborgbrug,2023-05-05,21:00:00,77,38,39,FMN 06 B Zurenborgbrug Ringfietspad
655,Ringfietspad Zurenborgbrug,2023-05-05,22:00:00,59,25,34,FMN 06 B Zurenborgbrug Ringfietspad
655,Ringfietspad Zurenborgbrug,2023-05-05,23:00:00,47,14,33,FMN 06 B Zurenborgbrug Ringfietspad
655,Ringfietspad Zurenborgbrug,2023-05-06,00:00:00,36,22,14,FMN 06 B Zurenborgbrug Ringfietspad
655,Ringfietspad Zurenborgbrug,2023-05-06,01:00:00,27,11,16,FMN 06 B Zurenborgbrug Ringfietspad
655,Ringfietspad Zurenborgbrug,2023-05-06,02:00:00,19,7,12,FMN 06 B Zurenborgbrug Ringfietspad
655,Ringfietspad Zurenborgbrug,2023-05-06,03:00:00,13,7,6,FMN 06 B Zurenborgbrug Ringfietspad
655,Ringfietspad Zurenborgbrug,2023-05-06,04:00:00,4,4,0,FMN 06 B Zurenborgbrug Ringfietspad
655,Ringfietspad Zurenborgbrug,2023-05-06,05:00:00,19,12,7,FMN 06 B Zurenborgbrug Ringfietspad
655,Ringfietspad Zurenborgbrug,2023-05-06,06:00:00,25,16,9,FMN 06 B Zurenborgbrug Ringfietspad
655,Ringfietspad Zurenborgbrug,2023-05-06,07:00:00,46,25,21,FMN 06 B Zurenborgbrug Ringfietspad
655,Ringfietspad Zurenborgbrug,2023-05-06,08:00:00,93,49,44,FMN 06 B Zurenborgbrug Ringfietspad
655,Ringfietspad Zurenborgbrug,2023-05-06,09:00:00,154,84,70,FMN 06 B Zurenborgbrug Ringfietspad
655,Ringfietspad Zurenborgbrug,2023-05-06,10:00:00,156,76,80,FMN 06 B Zurenborgbrug Ringfietspad
655,Ringfietspad Zurenborgbrug,2023-05-06,11:00:00,143,63,80,FMN 06 B Zurenborgbrug Ringfietspad
655,Ringfietspad Zurenborgbrug,2023-05-06,12:00:00,177,81,96,FMN 06 B Zurenborgbrug Ringfietspad
655,Ringfietspad Zurenborgbrug,2023-05-06,13:00:00,208,100,108,FMN 06 B Zurenborgbrug Ringfietspad
655,Ringfietspad Zurenborgbrug,2023-05-06,14:00:00,185,87,98,FMN 06 B Zurenborgbrug Ringfietspad
655,Ringfietspad Zurenborgbrug,2023-05-06,15:00:00,202,86,116,FMN 06 B Zurenborgbrug Ringfietspad
655,Ringfietspad Zurenborgbrug,2023-05-06,16:00:00,179,85,94,FMN 06 B Zurenborgbrug Ringfietspad
655,Ringfietspad Zurenborgbrug,2023-05-06,17:00:00,162,75,87,FMN 06 B Zurenborgbrug Ringfietspad
655,Ringfietspad Zurenborgbrug,2023-05-06,18:00:00,123,47,76,FMN 06 B Zurenborgbrug Ringfietspad
655,Ringfietspad Zurenborgbrug,2023-05-06,19:00:00,125,62,63,FMN 06 B Zurenborgbrug Ringfietspad
655,Ringfietspad Zurenborgbrug,2023-05-06,20:00:00,87,39,48,FMN 06 B Zurenborgbrug Ringfietspad
655,Ringfietspad Zurenborgbrug,2023-05-06,21:00:00,79,27,52,FMN 06 B Zurenborgbrug Ringfietspad
655,Ringfietspad Zurenborgbrug,2023-05-06,22:00:00,74,30,44,FMN 06 B Zurenborgbrug Ringfietspad
655,Ringfietspad Zurenborgbrug,2023-05-06,23:00:00,42,14,28,FMN 06 B Zurenborgbrug Ringfietspad
655,Ringfietspad Zurenborgbrug,2023-05-07,00:00:00,32,11,21,FMN 06 B Zurenborgbrug Ringfietspad
655,Ringfietspad Zurenborgbrug,2023-05-07,01:00:00,25,11,14,FMN 06 B Zurenborgbrug Ringfietspad
655,Ringfietspad Zurenborgbrug,2023-05-07,02:00:00,12,5,7,FMN 06 B Zurenborgbrug Ringfietspad
655,Ringfietspad Zurenborgbrug,2023-05-07,03:00:00,6,2,4,FMN 06 B Zurenborgbrug Ringfietspad
655,Ringfietspad Zurenborgbrug,2023-05-07,04:00:00,7,4,3,FMN 06 B Zurenborgbrug Ringfietspad
655,Ringfietspad Zurenborgbrug,2023-05-07,05:00:00,10,5,5,FMN 06 B Zurenborgbrug Ringfietspad
655,Ringfietspad Zurenborgbrug,2023-05-07,06:00:00,18,11,7,FMN 06 B Zurenborgbrug Ringfietspad
655,Ringfietspad Zurenborgbrug,2023-05-07,07:00:00,22,11,11,FMN 06 B Zurenborgbrug Ringfietspad
655,Ringfietspad Zurenborgbrug,2023-05-07,08:00:00,42,14,28,FMN 06 B Zurenborgbrug Ringfietspad
655,Ringfietspad Zurenborgbrug,2023-05-07,09:00:00,109,52,57,FMN 06 B Zurenborgbrug Ringfietspad
655,Ringfietspad Zurenborgbrug,2023-05-07,10:00:00,89,49,40,FMN 06 B Zurenborgbrug Ringfietspad
655,Ringfietspad Zurenborgbrug,2023-05-07,11:00:00,126,76,50,FMN 06 B Zurenborgbrug Ringfietspad
655,Ringfietspad Zurenborgbrug,2023-05-07,12:00:00,110,56,54,FMN 06 B Zurenborgbrug Ringfietspad
655,Ringfietspad Zurenborgbrug,2023-05-07,13:00:00,121,53,68,FMN 06 B Zurenborgbrug Ringfietspad
655,Ringfietspad Zurenborgbrug,2023-05-07,14:00:00,96,39,57,FMN 06 B Zurenborgbrug Ringfietspad
655,Ringfietspad Zurenborgbrug,2023-05-07,15:00:00,132,74,58,FMN 06 B Zurenborgbrug Ringfietspad
655,Ringfietspad Zurenborgbrug,2023-05-07,16:00:00,142,47,95,FMN 06 B Zurenborgbrug Ringfietspad
655,Ringfietspad Zurenborgbrug,2023-05-07,17:00:00,184,46,138,FMN 06 B Zurenborgbrug Ringfietspad
655,Ringfietspad Zurenborgbrug,2023-05-07,18:00:00,130,68,62,FMN 06 B Zurenborgbrug Ringfietspad
655,Ringfietspad Zurenborgbrug,2023-05-07,19:00:00,78,48,30,FMN 06 B Zurenborgbrug Ringfietspad
655,Ringfietspad Zurenborgbrug,2023-05-07,20:00:00,54,30,24,FMN 06 B Zurenborgbrug Ringfietspad
655,Ringfietspad Zurenborgbrug,2023-05-07,21:00:00,114,94,20,FMN 06 B Zurenborgbrug Ringfietspad
655,Ringfietspad Zurenborgbrug,2023-05-07,22:00:00,45,24,21,FMN 06 B Zurenborgbrug Ringfietspad
655,Ringfietspad Zurenborgbrug,2023-05-07,23:00:00,17,11,6,FMN 06 B Zurenborgbrug Ringfietspad
655,Ringfietspad Zurenborgbrug,2023-05-08,00:00:00,9,5,4,FMN 06 B Zurenborgbrug Ringfietspad
655,Ringfietspad Zurenborgbrug,2023-05-08,01:00:00,6,3,3,FMN 06 B Zurenborgbrug Ringfietspad
655,Ringfietspad Zurenborgbrug,2023-05-08,02:00:00,3,0,3,FMN 06 B Zurenborgbrug Ringfietspad
655,Ringfietspad Zurenborgbrug,2023-05-08,03:00:00,3,2,1,FMN 06 B Zurenborgbrug Ringfietspad
655,Ringfietspad Zurenborgbrug,2023-05-08,04:00:00,15,8,7,FMN 06 B Zurenborgbrug Ringfietspad
655,Ringfietspad Zurenborgbrug,2023-05-08,05:00:00,50,33,17,FMN 06 B Zurenborgbrug Ringfietspad
655,Ringfietspad Zurenborgbrug,2023-05-08,06:00:00,151,90,61,FMN 06 B Zurenborgbrug Ringfietspad
655,Ringfietspad Zurenborgbrug,2023-05-08,07:00:00,428,254,174,FMN 06 B Zurenborgbrug Ringfietspad
655,Ringfietspad Zurenborgbrug,2023-05-08,08:00:00,665,368,297,FMN 06 B Zurenborgbrug Ringfietspad
655,Ringfietspad Zurenborgbrug,2023-05-08,09:00:00,172,93,79,FMN 06 B Zurenborgbrug Ringfietspad
655,Ringfietspad Zurenborgbrug,2023-05-08,10:00:00,143,88,55,FMN 06 B Zurenborgbrug Ringfietspad
655,Ringfietspad Zurenborgbrug,2023-05-08,11:00:00,111,56,55,FMN 06 B Zurenborgbrug Ringfietspad
655,Ringfietspad Zurenborgbrug,2023-05-08,12:00:00,201,98,103,FMN 06 B Zurenborgbrug Ringfietspad
655,Ringfietspad Zurenborgbrug,2023-05-08,13:00:00,214,105,109,FMN 06 B Zurenborgbrug Ringfietspad
655,Ringfietspad Zurenborgbrug,2023-05-08,14:00:00,186,87,99,FMN 06 B Zurenborgbrug Ringfietspad
655,Ringfietspad Zurenborgbrug,2023-05-08,15:00:00,304,113,191,FMN 06 B Zurenborgbrug Ringfietspad
655,Ringfietspad Zurenborgbrug,2023-05-08,16:00:00,557,251,306,FMN 06 B Zurenborgbrug Ringfietspad
655,Ringfietspad Zurenborgbrug,2023-05-08,17:00:00,561,230,331,FMN 06 B Zurenborgbrug Ringfietspad
655,Ringfietspad Zurenborgbrug,2023-05-08,18:00:00,351,142,209,FMN 06 B Zurenborgbrug Ringfietspad
655,Ringfietspad Zurenborgbrug,2023-05-08,19:00:00,159,58,101,FMN 06 B Zurenborgbrug Ringfietspad
655,Ringfietspad Zurenborgbrug,2023-05-08,20:00:00,126,59,67,FMN 06 B Zurenborgbrug Ringfietspad
655,Ringfietspad Zurenborgbrug,2023-05-08,21:00:00,104,38,66,FMN 06 B Zurenborgbrug Ringfietspad
655,Ringfietspad Zurenborgbrug,2023-05-08,22:00:00,93,29,64,FMN 06 B Zurenborgbrug Ringfietspad
655,Ringfietspad Zurenborgbrug,2023-05-08,23:00:00,28,12,16,FMN 06 B Zurenborgbrug Ringfietspad
655,Ringfietspad Zurenborgbrug,2023-05-09,00:00:00,11,5,6,FMN 06 B Zurenborgbrug Ringfietspad
655,Ringfietspad Zurenborgbrug,2023-05-09,01:00:00,7,4,3,FMN 06 B Zurenborgbrug Ringfietspad
655,Ringfietspad Zurenborgbrug,2023-05-09,02:00:00,1,0,1,FMN 06 B Zurenborgbrug Ringfietspad
655,Ringfietspad Zurenborgbrug,2023-05-09,03:00:00,1,0,1,FMN 06 B Zurenborgbrug Ringfietspad
655,Ringfietspad Zurenborgbrug,2023-05-09,04:00:00,16,8,8,FMN 06 B Zurenborgbrug Ringfietspad
655,Ringfietspad Zurenborgbrug,2023-05-09,05:00:00,47,29,18,FMN 06 B Zurenborgbrug Ringfietspad
655,Ringfietspad Zurenborgbrug,2023-05-09,06:00:00,141,83,58,FMN 06 B Zurenborgbrug Ringfietspad
655,Ringfietspad Zurenborgbrug,2023-05-09,07:00:00,406,244,162,FMN 06 B Zurenborgbrug Ringfietspad
655,Ringfietspad Zurenborgbrug,2023-05-09,08:00:00,551,323,228,FMN 06 B Zurenborgbrug Ringfietspad
655,Ringfietspad Zurenborgbrug,2023-05-09,09:00:00,133,70,63,FMN 06 B Zurenborgbrug Ringfietspad
655,Ringfietspad Zurenborgbrug,2023-05-09,10:00:00,86,49,37,FMN 06 B Zurenborgbrug Ringfietspad
655,Ringfietspad Zurenborgbrug,2023-05-09,11:00:00,61,29,32,FMN 06 B Zurenborgbrug Ringfietspad
655,Ringfietspad Zurenborgbrug,2023-05-09,12:00:00,100,47,53,FMN 06 B Zurenborgbrug Ringfietspad
655,Ringfietspad Zurenborgbrug,2023-05-09,13:00:00,125,50,75,FMN 06 B Zurenborgbrug Ringfietspad
655,Ringfietspad Zurenborgbrug,2023-05-09,14:00:00,98,39,59,FMN 06 B Zurenborgbrug Ringfietspad
655,Ringfietspad Zurenborgbrug,2023-05-09,15:00:00,198,74,124,FMN 06 B Zurenborgbrug Ringfietspad
655,Ringfietspad Zurenborgbrug,2023-05-09,16:00:00,404,165,239,FMN 06 B Zurenborgbrug Ringfietspad
655,Ringfietspad Zurenborgbrug,2023-05-09,17:00:00,389,133,256,FMN 06 B Zurenborgbrug Ringfietspad
655,Ringfietspad Zurenborgbrug,2023-05-09,18:00:00,222,73,149,FMN 06 B Zurenborgbrug Ringfietspad
655,Ringfietspad Zurenborgbrug,2023-05-09,19:00:00,115,41,74,FMN 06 B Zurenborgbrug Ringfietspad
655,Ringfietspad Zurenborgbrug,2023-05-09,20:00:00,70,27,43,FMN 06 B Zurenborgbrug Ringfietspad
655,Ringfietspad Zurenborgbrug,2023-05-09,21:00:00,55,21,34,FMN 06 B Zurenborgbrug Ringfietspad
655,Ringfietspad Zurenborgbrug,2023-05-09,22:00:00,66,29,37,FMN 06 B Zurenborgbrug Ringfietspad
655,Ringfietspad Zurenborgbrug,2023-05-09,23:00:00,40,20,20,FMN 06 B Zurenborgbrug Ringfietspad
655,Ringfietspad Zurenborgbrug,2023-05-10,00:00:00,11,5,6,FMN 06 B Zurenborgbrug Ringfietspad
655,Ringfietspad Zurenborgbrug,2023-05-10,01:00:00,6,4,2,FMN 06 B Zurenborgbrug Ringfietspad
655,Ringfietspad Zurenborgbrug,2023-05-10,02:00:00,1,1,0,FMN 06 B Zurenborgbrug Ringfietspad
655,Ringfietspad Zurenborgbrug,2023-05-10,03:00:00,9,6,3,FMN 06 B Zurenborgbrug Ringfietspad
655,Ringfietspad Zurenborgbrug,2023-05-10,04:00:00,13,4,9,FMN 06 B Zurenborgbrug Ringfietspad
655,Ringfietspad Zurenborgbrug,2023-05-10,05:00:00,40,25,15,FMN 06 B Zurenborgbrug Ringfietspad
655,Ringfietspad Zurenborgbrug,2023-05-10,06:00:00,133,82,51,FMN 06 B Zurenborgbrug Ringfietspad
655,Ringfietspad Zurenborgbrug,2023-05-10,07:00:00,320,177,143,FMN 06 B Zurenborgbrug Ringfietspad
655,Ringfietspad Zurenborgbrug,2023-05-10,08:00:00,529,290,239,FMN 06 B Zurenborgbrug Ringfietspad
655,Ringfietspad Zurenborgbrug,2023-05-10,09:00:00,159,94,65,FMN 06 B Zurenborgbrug Ringfietspad
655,Ringfietspad Zurenborgbrug,2023-05-10,10:00:00,140,72,68,FMN 06 B Zurenborgbrug Ringfietspad
655,Ringfietspad Zurenborgbrug,2023-05-10,11:00:00,138,57,81,FMN 06 B Zurenborgbrug Ringfietspad
655,Ringfietspad Zurenborgbrug,2023-05-10,12:00:00,342,180,162,FMN 06 B Zurenborgbrug Ringfietspad
655,Ringfietspad Zurenborgbrug,2023-05-10,13:00:00,192,83,109,FMN 06 B Zurenborgbrug Ringfietspad
655,Ringfietspad Zurenborgbrug,2023-05-10,14:00:00,119,51,68,FMN 06 B Zurenborgbrug Ringfietspad
655,Ringfietspad Zurenborgbrug,2023-05-10,15:00:00,190,67,123,FMN 06 B Zurenborgbrug Ringfietspad
655,Ringfietspad Zurenborgbrug,2023-05-10,16:00:00,315,137,178,FMN 06 B Zurenborgbrug Ringfietspad
655,Ringfietspad Zurenborgbrug,2023-05-10,17:00:00,313,111,202,FMN 06 B Zurenborgbrug Ringfietspad
655,Ringfietspad Zurenborgbrug,2023-05-10,18:00:00,255,114,141,FMN 06 B Zurenborgbrug Ringfietspad
655,Ringfietspad Zurenborgbrug,2023-05-10,19:00:00,126,62,64,FMN 06 B Zurenborgbrug Ringfietspad
655,Ringfietspad Zurenborgbrug,2023-05-10,20:00:00,106,40,66,FMN 06 B Zurenborgbrug Ringfietspad
655,Ringfietspad Zurenborgbrug,2023-05-10,21:00:00,81,36,45,FMN 06 B Zurenborgbrug Ringfietspad
655,Ringfietspad Zurenborgbrug,2023-05-10,22:00:00,78,27,51,FMN 06 B Zurenborgbrug Ringfietspad
655,Ringfietspad Zurenborgbrug,2023-05-10,23:00:00,28,15,13,FMN 06 B Zurenborgbrug Ringfietspad
655,Ringfietspad Zurenborgbrug,2023-05-11,00:00:00,9,1,8,FMN 06 B Zurenborgbrug Ringfietspad
655,Ringfietspad Zurenborgbrug,2023-05-11,01:00:00,4,1,3,FMN 06 B Zurenborgbrug Ringfietspad
655,Ringfietspad Zurenborgbrug,2023-05-11,02:00:00,7,3,4,FMN 06 B Zurenborgbrug Ringfietspad
655,Ringfietspad Zurenborgbrug,2023-05-11,03:00:00,2,2,0,FMN 06 B Zurenborgbrug Ringfietspad
655,Ringfietspad Zurenborgbrug,2023-05-11,04:00:00,21,10,11,FMN 06 B Zurenborgbrug Ringfietspad
655,Ringfietspad Zurenborgbrug,2023-05-11,05:00:00,49,27,22,FMN 06 B Zurenborgbrug Ringfietspad
655,Ringfietspad Zurenborgbrug,2023-05-11,06:00:00,147,93,54,FMN 06 B Zurenborgbrug Ringfietspad
655,Ringfietspad Zurenborgbrug,2023-05-11,07:00:00,437,263,174,FMN 06 B Zurenborgbrug Ringfietspad
655,Ringfietspad Zurenborgbrug,2023-05-11,08:00:00,652,395,257,FMN 06 B Zurenborgbrug Ringfietspad
655,Ringfietspad Zurenborgbrug,2023-05-11,09:00:00,191,110,81,FMN 06 B Zurenborgbrug Ringfietspad
655,Ringfietspad Zurenborgbrug,2023-05-11,10:00:00,145,80,65,FMN 06 B Zurenborgbrug Ringfietspad
655,Ringfietspad Zurenborgbrug,2023-05-11,11:00:00,105,51,54,FMN 06 B Zurenborgbrug Ringfietspad
655,Ringfietspad Zurenborgbrug,2023-05-11,12:00:00,159,85,74,FMN 06 B Zurenborgbrug Ringfietspad
655,Ringfietspad Zurenborgbrug,2023-05-11,13:00:00,207,107,100,FMN 06 B Zurenborgbrug Ringfietspad
655,Ringfietspad Zurenborgbrug,2023-05-11,14:00:00,191,84,107,FMN 06 B Zurenborgbrug Ringfietspad
655,Ringfietspad Zurenborgbrug,2023-05-11,15:00:00,314,128,186,FMN 06 B Zurenborgbrug Ringfietspad
655,Ringfietspad Zurenborgbrug,2023-05-11,16:00:00,475,198,277,FMN 06 B Zurenborgbrug Ringfietspad
655,Ringfietspad Zurenborgbrug,2023-05-11,17:00:00,504,180,324,FMN 06 B Zurenborgbrug Ringfietspad
655,Ringfietspad Zurenborgbrug,2023-05-11,18:00:00,330,132,198,FMN 06 B Zurenborgbrug Ringfietspad
655,Ringfietspad Zurenborgbrug,2023-05-11,19:00:00,207,69,138,FMN 06 B Zurenborgbrug Ringfietspad
655,Ringfietspad Zurenborgbrug,2023-05-11,20:00:00,153,73,80,FMN 06 B Zurenborgbrug Ringfietspad
655,Ringfietspad Zurenborgbrug,2023-05-11,21:00:00,92,32,60,FMN 06 B Zurenborgbrug Ringfietspad
655,Ringfietspad Zurenborgbrug,2023-05-11,22:00:00,98,42,56,FMN 06 B Zurenborgbrug Ringfietspad
655,Ringfietspad Zurenborgbrug,2023-05-11,23:00:00,51,26,25,FMN 06 B Zurenborgbrug Ringfietspad
655,Ringfietspad Zurenborgbrug,2023-05-12,00:00:00,28,14,14,FMN 06 B Zurenborgbrug Ringfietspad
655,Ringfietspad Zurenborgbrug,2023-05-12,01:00:00,12,8,4,FMN 06 B Zurenborgbrug Ringfietspad
655,Ringfietspad Zurenborgbrug,2023-05-12,02:00:00,4,0,4,FMN 06 B Zurenborgbrug Ringfietspad
655,Ringfietspad Zurenborgbrug,2023-05-12,03:00:00,3,3,0,FMN 06 B Zurenborgbrug Ringfietspad
655,Ringfietspad Zurenborgbrug,2023-05-12,04:00:00,12,6,6,FMN 06 B Zurenborgbrug Ringfietspad
655,Ringfietspad Zurenborgbrug,2023-05-12,05:00:00,34,19,15,FMN 06 B Zurenborgbrug Ringfietspad
655,Ringfietspad Zurenborgbrug,2023-05-12,06:00:00,96,60,36,FMN 06 B Zurenborgbrug Ringfietspad
655,Ringfietspad Zurenborgbrug,2023-05-12,07:00:00,241,130,111,FMN 06 B Zurenborgbrug Ringfietspad
655,Ringfietspad Zurenborgbrug,2023-05-12,08:00:00,401,226,175,FMN 06 B Zurenborgbrug Ringfietspad
655,Ringfietspad Zurenborgbrug,2023-05-12,09:00:00,111,70,41,FMN 06 B Zurenborgbrug Ringfietspad
655,Ringfietspad Zurenborgbrug,2023-05-12,10:00:00,102,63,39,FMN 06 B Zurenborgbrug Ringfietspad
655,Ringfietspad Zurenborgbrug,2023-05-12,11:00:00,91,52,39,FMN 06 B Zurenborgbrug Ringfietspad
655,Ringfietspad Zurenborgbrug,2023-05-12,12:00:00,147,70,77,FMN 06 B Zurenborgbrug Ringfietspad
655,Ringfietspad Zurenborgbrug,2023-05-12,13:00:00,154,60,94,FMN 06 B Zurenborgbrug Ringfietspad
655,Ringfietspad Zurenborgbrug,2023-05-12,14:00:00,174,82,92,FMN 06 B Zurenborgbrug Ringfietspad
655,Ringfietspad Zurenborgbrug,2023-05-12,15:00:00,235,91,144,FMN 06 B Zurenborgbrug Ringfietspad
655,Ringfietspad Zurenborgbrug,2023-05-12,16:00:00,374,155,219,FMN 06 B Zurenborgbrug Ringfietspad
655,Ringfietspad Zurenborgbrug,2023-05-12,17:00:00,338,137,201,FMN 06 B Zurenborgbrug Ringfietspad
655,Ringfietspad Zurenborgbrug,2023-05-12,18:00:00,225,94,131,FMN 06 B Zurenborgbrug Ringfietspad
655,Ringfietspad Zurenborgbrug,2023-05-12,19:00:00,144,51,93,FMN 06 B Zurenborgbrug Ringfietspad
655,Ringfietspad Zurenborgbrug,2023-05-12,20:00:00,132,53,79,FMN 06 B Zurenborgbrug Ringfietspad
655,Ringfietspad Zurenborgbrug,2023-05-12,21:00:00,78,31,47,FMN 06 B Zurenborgbrug Ringfietspad
655,Ringfietspad Zurenborgbrug,2023-05-12,22:00:00,75,40,35,FMN 06 B Zurenborgbrug Ringfietspad
655,Ringfietspad Zurenborgbrug,2023-05-12,23:00:00,78,46,32,FMN 06 B Zurenborgbrug Ringfietspad
655,Ringfietspad Zurenborgbrug,2023-05-13,00:00:00,40,21,19,FMN 06 B Zurenborgbrug Ringfietspad
655,Ringfietspad Zurenborgbrug,2023-05-13,01:00:00,34,15,19,FMN 06 B Zurenborgbrug Ringfietspad
655,Ringfietspad Zurenborgbrug,2023-05-13,02:00:00,13,7,6,FMN 06 B Zurenborgbrug Ringfietspad
655,Ringfietspad Zurenborgbrug,2023-05-13,03:00:00,11,3,8,FMN 06 B Zurenborgbrug Ringfietspad
655,Ringfietspad Zurenborgbrug,2023-05-13,04:00:00,13,10,3,FMN 06 B Zurenborgbrug Ringfietspad
655,Ringfietspad Zurenborgbrug,2023-05-13,05:00:00,20,10,10,FMN 06 B Zurenborgbrug Ringfietspad
655,Ringfietspad Zurenborgbrug,2023-05-13,06:00:00,32,17,15,FMN 06 B Zurenborgbrug Ringfietspad
655,Ringfietspad Zurenborgbrug,2023-05-13,07:00:00,50,24,26,FMN 06 B Zurenborgbrug Ringfietspad
655,Ringfietspad Zurenborgbrug,2023-05-13,08:00:00,87,38,49,FMN 06 B Zurenborgbrug Ringfietspad
655,Ringfietspad Zurenborgbrug,2023-05-13,09:00:00,164,79,85,FMN 06 B Zurenborgbrug Ringfietspad
655,Ringfietspad Zurenborgbrug,2023-05-13,10:00:00,217,96,121,FMN 06 B Zurenborgbrug Ringfietspad
655,Ringfietspad Zurenborgbrug,2023-05-13,11:00:00,210,97,113,FMN 06 B Zurenborgbrug Ringfietspad
655,Ringfietspad Zurenborgbrug,2023-05-13,12:00:00,253,115,138,FMN 06 B Zurenborgbrug Ringfietspad
655,Ringfietspad Zurenborgbrug,2023-05-13,13:00:00,304,134,170,FMN 06 B Zurenborgbrug Ringfietspad
655,Ringfietspad Zurenborgbrug,2023-05-13,14:00:00,273,105,168,FMN 06 B Zurenborgbrug Ringfietspad
655,Ringfietspad Zurenborgbrug,2023-05-13,15:00:00,245,124,121,FMN 06 B Zurenborgbrug Ringfietspad
655,Ringfietspad Zurenborgbrug,2023-05-13,16:00:00,218,109,109,FMN 06 B Zurenborgbrug Ringfietspad
655,Ringfietspad Zurenborgbrug,2023-05-13,17:00:00,208,120,88,FMN 06 B Zurenborgbrug Ringfietspad
655,Ringfietspad Zurenborgbrug,2023-05-13,18:00:00,174,74,100,FMN 06 B Zurenborgbrug Ringfietspad
655,Ringfietspad Zurenborgbrug,2023-05-13,19:00:00,171,62,109,FMN 06 B Zurenborgbrug Ringfietspad
655,Ringfietspad Zurenborgbrug,2023-05-13,20:00:00,110,46,64,FMN 06 B Zurenborgbrug Ringfietspad
655,Ringfietspad Zurenborgbrug,2023-05-13,21:00:00,95,46,49,FMN 06 B Zurenborgbrug Ringfietspad
655,Ringfietspad Zurenborgbrug,2023-05-13,22:00:00,58,29,29,FMN 06 B Zurenborgbrug Ringfietspad
655,Ringfietspad Zurenborgbrug,2023-05-13,23:00:00,94,61,33,FMN 06 B Zurenborgbrug Ringfietspad
655,Ringfietspad Zurenborgbrug,2023-05-14,00:00:00,42,25,17,FMN 06 B Zurenborgbrug Ringfietspad
655,Ringfietspad Zurenborgbrug,2023-05-14,01:00:00,24,13,11,FMN 06 B Zurenborgbrug Ringfietspad
655,Ringfietspad Zurenborgbrug,2023-05-14,02:00:00,10,6,4,FMN 06 B Zurenborgbrug Ringfietspad
655,Ringfietspad Zurenborgbrug,2023-05-14,03:00:00,11,6,5,FMN 06 B Zurenborgbrug Ringfietspad
655,Ringfietspad Zurenborgbrug,2023-05-14,04:00:00,5,2,3,FMN 06 B Zurenborgbrug Ringfietspad
655,Ringfietspad Zurenborgbrug,2023-05-14,05:00:00,15,6,9,FMN 06 B Zurenborgbrug Ringfietspad
655,Ringfietspad Zurenborgbrug,2023-05-14,06:00:00,27,15,12,FMN 06 B Zurenborgbrug Ringfietspad
655,Ringfietspad Zurenborgbrug,2023-05-14,07:00:00,24,9,15,FMN 06 B Zurenborgbrug Ringfietspad
655,Ringfietspad Zurenborgbrug,2023-05-14,08:00:00,95,34,61,FMN 06 B Zurenborgbrug Ringfietspad
655,Ringfietspad Zurenborgbrug,2023-05-14,09:00:00,155,63,92,FMN 06 B Zurenborgbrug Ringfietspad
655,Ringfietspad Zurenborgbrug,2023-05-14,10:00:00,203,49,154,FMN 06 B Zurenborgbrug Ringfietspad
655,Ringfietspad Zurenborgbrug,2023-05-14,11:00:00,209,90,119,FMN 06 B Zurenborgbrug Ringfietspad
655,Ringfietspad Zurenborgbrug,2023-05-14,12:00:00,367,125,242,FMN 06 B Zurenborgbrug Ringfietspad
655,Ringfietspad Zurenborgbrug,2023-05-14,13:00:00,249,117,132,FMN 06 B Zurenborgbrug Ringfietspad
655,Ringfietspad Zurenborgbrug,2023-05-14,14:00:00,254,116,138,FMN 06 B Zurenborgbrug Ringfietspad
655,Ringfietspad Zurenborgbrug,2023-05-14,15:00:00,269,134,135,FMN 06 B Zurenborgbrug Ringfietspad
655,Ringfietspad Zurenborgbrug,2023-05-14,16:00:00,276,174,102,FMN 06 B Zurenborgbrug Ringfietspad
655,Ringfietspad Zurenborgbrug,2023-05-14,17:00:00,244,142,102,FMN 06 B Zurenborgbrug Ringfietspad
655,Ringfietspad Zurenborgbrug,2023-05-14,18:00:00,178,94,84,FMN 06 B Zurenborgbrug Ringfietspad
655,Ringfietspad Zurenborgbrug,2023-05-14,19:00:00,141,42,99,FMN 06 B Zurenborgbrug Ringfietspad
655,Ringfietspad Zurenborgbrug,2023-05-14,20:00:00,69,28,41,FMN 06 B Zurenborgbrug Ringfietspad
655,Ringfietspad Zurenborgbrug,2023-05-14,21:00:00,69,39,30,FMN 06 B Zurenborgbrug Ringfietspad
655,Ringfietspad Zurenborgbrug,2023-05-14,22:00:00,49,25,24,FMN 06 B Zurenborgbrug Ringfietspad
655,Ringfietspad Zurenborgbrug,2023-05-14,23:00:00,49,36,13,FMN 06 B Zurenborgbrug Ringfietspad
655,Ringfietspad Zurenborgbrug,2023-05-15,00:00:00,14,7,7,FMN 06 B Zurenborgbrug Ringfietspad
655,Ringfietspad Zurenborgbrug,2023-05-15,01:00:00,2,1,1,FMN 06 B Zurenborgbrug Ringfietspad
655,Ringfietspad Zurenborgbrug,2023-05-15,02:00:00,3,1,2,FMN 06 B Zurenborgbrug Ringfietspad
655,Ringfietspad Zurenborgbrug,2023-05-15,03:00:00,2,1,1,FMN 06 B Zurenborgbrug Ringfietspad
655,Ringfietspad Zurenborgbrug,2023-05-15,04:00:00,26,16,10,FMN 06 B Zurenborgbrug Ringfietspad
655,Ringfietspad Zurenborgbrug,2023-05-15,05:00:00,49,28,21,FMN 06 B Zurenborgbrug Ringfietspad
655,Ringfietspad Zurenborgbrug,2023-05-15,06:00:00,134,82,52,FMN 06 B Zurenborgbrug Ringfietspad
655,Ringfietspad Zurenborgbrug,2023-05-15,07:00:00,397,219,178,FMN 06 B Zurenborgbrug Ringfietspad
655,Ringfietspad Zurenborgbrug,2023-05-15,08:00:00,629,337,292,FMN 06 B Zurenborgbrug Ringfietspad
655,Ringfietspad Zurenborgbrug,2023-05-15,09:00:00,187,110,77,FMN 06 B Zurenborgbrug Ringfietspad
655,Ringfietspad Zurenborgbrug,2023-05-15,10:00:00,112,65,47,FMN 06 B Zurenborgbrug Ringfietspad
655,Ringfietspad Zurenborgbrug,2023-05-15,11:00:00,99,55,44,FMN 06 B Zurenborgbrug Ringfietspad
655,Ringfietspad Zurenborgbrug,2023-05-15,12:00:00,184,83,101,FMN 06 B Zurenborgbrug Ringfietspad
655,Ringfietspad Zurenborgbrug,2023-05-15,13:00:00,132,54,78,FMN 06 B Zurenborgbrug Ringfietspad
655,Ringfietspad Zurenborgbrug,2023-05-15,14:00:00,126,48,78,FMN 06 B Zurenborgbrug Ringfietspad
655,Ringfietspad Zurenborgbrug,2023-05-15,15:00:00,240,99,141,FMN 06 B Zurenborgbrug Ringfietspad
655,Ringfietspad Zurenborgbrug,2023-05-15,16:00:00,443,183,260,FMN 06 B Zurenborgbrug Ringfietspad
655,Ringfietspad Zurenborgbrug,2023-05-15,17:00:00,465,175,290,FMN 06 B Zurenborgbrug Ringfietspad
655,Ringfietspad Zurenborgbrug,2023-05-15,18:00:00,315,117,198,FMN 06 B Zurenborgbrug Ringfietspad
655,Ringfietspad Zurenborgbrug,2023-05-15,19:00:00,107,29,78,FMN 06 B Zurenborgbrug Ringfietspad
655,Ringfietspad Zurenborgbrug,2023-05-15,20:00:00,77,32,45,FMN 06 B Zurenborgbrug Ringfietspad
655,Ringfietspad Zurenborgbrug,2023-05-15,21:00:00,72,26,46,FMN 06 B Zurenborgbrug Ringfietspad
655,Ringfietspad Zurenborgbrug,2023-05-15,22:00:00,67,27,40,FMN 06 B Zurenborgbrug Ringfietspad
655,Ringfietspad Zurenborgbrug,2023-05-15,23:00:00,15,8,7,FMN 06 B Zurenborgbrug Ringfietspad
655,Ringfietspad Zurenborgbrug,2023-05-16,00:00:00,14,5,9,FMN 06 B Zurenborgbrug Ringfietspad
655,Ringfietspad Zurenborgbrug,2023-05-16,01:00:00,4,2,2,FMN 06 B Zurenborgbrug Ringfietspad
655,Ringfietspad Zurenborgbrug,2023-05-16,02:00:00,3,0,3,FMN 06 B Zurenborgbrug Ringfietspad
655,Ringfietspad Zurenborgbrug,2023-05-16,03:00:00,7,3,4,FMN 06 B Zurenborgbrug Ringfietspad
655,Ringfietspad Zurenborgbrug,2023-05-16,04:00:00,18,11,7,FMN 06 B Zurenborgbrug Ringfietspad
655,Ringfietspad Zurenborgbrug,2023-05-16,05:00:00,57,34,23,FMN 06 B Zurenborgbrug Ringfietspad
655,Ringfietspad Zurenborgbrug,2023-05-16,06:00:00,139,86,53,FMN 06 B Zurenborgbrug Ringfietspad
655,Ringfietspad Zurenborgbrug,2023-05-16,07:00:00,461,251,210,FMN 06 B Zurenborgbrug Ringfietspad
655,Ringfietspad Zurenborgbrug,2023-05-16,08:00:00,692,390,302,FMN 06 B Zurenborgbrug Ringfietspad
655,Ringfietspad Zurenborgbrug,2023-05-16,09:00:00,198,109,89,FMN 06 B Zurenborgbrug Ringfietspad
655,Ringfietspad Zurenborgbrug,2023-05-16,10:00:00,136,59,77,FMN 06 B Zurenborgbrug Ringfietspad
655,Ringfietspad Zurenborgbrug,2023-05-16,11:00:00,139,77,62,FMN 06 B Zurenborgbrug Ringfietspad
655,Ringfietspad Zurenborgbrug,2023-05-16,12:00:00,195,101,94,FMN 06 B Zurenborgbrug Ringfietspad
655,Ringfietspad Zurenborgbrug,2023-05-16,13:00:00,179,86,93,FMN 06 B Zurenborgbrug Ringfietspad
655,Ringfietspad Zurenborgbrug,2023-05-16,14:00:00,183,84,99,FMN 06 B Zurenborgbrug Ringfietspad
655,Ringfietspad Zurenborgbrug,2023-05-16,15:00:00,306,118,188,FMN 06 B Zurenborgbrug Ringfietspad
655,Ringfietspad Zurenborgbrug,2023-05-16,16:00:00,600,241,359,FMN 06 B Zurenborgbrug Ringfietspad
655,Ringfietspad Zurenborgbrug,2023-05-16,17:00:00,568,204,364,FMN 06 B Zurenborgbrug Ringfietspad
655,Ringfietspad Zurenborgbrug,2023-05-16,18:00:00,358,136,222,FMN 06 B Zurenborgbrug Ringfietspad
655,Ringfietspad Zurenborgbrug,2023-05-16,19:00:00,188,69,119,FMN 06 B Zurenborgbrug Ringfietspad
655,Ringfietspad Zurenborgbrug,2023-05-16,20:00:00,131,55,76,FMN 06 B Zurenborgbrug Ringfietspad
655,Ringfietspad Zurenborgbrug,2023-05-16,21:00:00,124,51,73,FMN 06 B Zurenborgbrug Ringfietspad
655,Ringfietspad Zurenborgbrug,2023-05-16,22:00:00,111,39,72,FMN 06 B Zurenborgbrug Ringfietspad
655,Ringfietspad Zurenborgbrug,2023-05-16,23:00:00,35,10,25,FMN 06 B Zurenborgbrug Ringfietspad
655,Ringfietspad Zurenborgbrug,2023-05-17,00:00:00,17,8,9,FMN 06 B Zurenborgbrug Ringfietspad
655,Ringfietspad Zurenborgbrug,2023-05-17,01:00:00,7,2,5,FMN 06 B Zurenborgbrug Ringfietspad
655,Ringfietspad Zurenborgbrug,2023-05-17,02:00:00,2,1,1,FMN 06 B Zurenborgbrug Ringfietspad
655,Ringfietspad Zurenborgbrug,2023-05-17,03:00:00,3,3,0,FMN 06 B Zurenborgbrug Ringfietspad
655,Ringfietspad Zurenborgbrug,2023-05-17,04:00:00,20,9,11,FMN 06 B Zurenborgbrug Ringfietspad
655,Ringfietspad Zurenborgbrug,2023-05-17,05:00:00,38,24,14,FMN 06 B Zurenborgbrug Ringfietspad
655,Ringfietspad Zurenborgbrug,2023-05-17,06:00:00,131,82,49,FMN 06 B Zurenborgbrug Ringfietspad
655,Ringfietspad Zurenborgbrug,2023-05-17,07:00:00,389,218,171,FMN 06 B Zurenborgbrug Ringfietspad
655,Ringfietspad Zurenborgbrug,2023-05-17,08:00:00,556,297,259,FMN 06 B Zurenborgbrug Ringfietspad
655,Ringfietspad Zurenborgbrug,2023-05-17,09:00:00,179,107,72,FMN 06 B Zurenborgbrug Ringfietspad
655,Ringfietspad Zurenborgbrug,2023-05-17,10:00:00,138,76,62,FMN 06 B Zurenborgbrug Ringfietspad
655,Ringfietspad Zurenborgbrug,2023-05-17,11:00:00,135,67,68,FMN 06 B Zurenborgbrug Ringfietspad
655,Ringfietspad Zurenborgbrug,2023-05-17,12:00:00,348,196,152,FMN 06 B Zurenborgbrug Ringfietspad
655,Ringfietspad Zurenborgbrug,2023-05-17,13:00:00,317,139,178,FMN 06 B Zurenborgbrug Ringfietspad
655,Ringfietspad Zurenborgbrug,2023-05-17,14:00:00,257,106,151,FMN 06 B Zurenborgbrug Ringfietspad
655,Ringfietspad Zurenborgbrug,2023-05-17,15:00:00,278,117,161,FMN 06 B Zurenborgbrug Ringfietspad
655,Ringfietspad Zurenborgbrug,2023-05-17,16:00:00,356,131,225,FMN 06 B Zurenborgbrug Ringfietspad
655,Ringfietspad Zurenborgbrug,2023-05-17,17:00:00,462,189,273,FMN 06 B Zurenborgbrug Ringfietspad
655,Ringfietspad Zurenborgbrug,2023-05-17,18:00:00,340,131,209,FMN 06 B Zurenborgbrug Ringfietspad
655,Ringfietspad Zurenborgbrug,2023-05-17,19:00:00,210,96,114,FMN 06 B Zurenborgbrug Ringfietspad
655,Ringfietspad Zurenborgbrug,2023-05-17,20:00:00,156,70,86,FMN 06 B Zurenborgbrug Ringfietspad
655,Ringfietspad Zurenborgbrug,2023-05-17,21:00:00,131,64,67,FMN 06 B Zurenborgbrug Ringfietspad
655,Ringfietspad Zurenborgbrug,2023-05-17,22:00:00,98,37,61,FMN 06 B Zurenborgbrug Ringfietspad
655,Ringfietspad Zurenborgbrug,2023-05-17,23:00:00,63,34,29,FMN 06 B Zurenborgbrug Ringfietspad
655,Ringfietspad Zurenborgbrug,2023-05-18,00:00:00,16,6,10,FMN 06 B Zurenborgbrug Ringfietspad
655,Ringfietspad Zurenborgbrug,2023-05-18,01:00:00,12,2,10,FMN 06 B Zurenborgbrug Ringfietspad
655,Ringfietspad Zurenborgbrug,2023-05-18,02:00:00,13,3,10,FMN 06 B Zurenborgbrug Ringfietspad
655,Ringfietspad Zurenborgbrug,2023-05-18,03:00:00,7,5,2,FMN 06 B Zurenborgbrug Ringfietspad
655,Ringfietspad Zurenborgbrug,2023-05-18,04:00:00,11,9,2,FMN 06 B Zurenborgbrug Ringfietspad
655,Ringfietspad Zurenborgbrug,2023-05-18,05:00:00,11,4,7,FMN 06 B Zurenborgbrug Ringfietspad
655,Ringfietspad Zurenborgbrug,2023-05-18,06:00:00,30,15,15,FMN 06 B Zurenborgbrug Ringfietspad
655,Ringfietspad Zurenborgbrug,2023-05-18,07:00:00,27,11,16,FMN 06 B Zurenborgbrug Ringfietspad
655,Ringfietspad Zurenborgbrug,2023-05-18,08:00:00,45,24,21,FMN 06 B Zurenborgbrug Ringfietspad
655,Ringfietspad Zurenborgbrug,2023-05-18,09:00:00,102,46,56,FMN 06 B Zurenborgbrug Ringfietspad
655,Ringfietspad Zurenborgbrug,2023-05-18,10:00:00,129,33,96,FMN 06 B Zurenborgbrug Ringfietspad
655,Ringfietspad Zurenborgbrug,2023-05-18,11:00:00,165,66,99,FMN 06 B Zurenborgbrug Ringfietspad
655,Ringfietspad Zurenborgbrug,2023-05-18,12:00:00,198,102,96,FMN 06 B Zurenborgbrug Ringfietspad
655,Ringfietspad Zurenborgbrug,2023-05-18,13:00:00,228,119,109,FMN 06 B Zurenborgbrug Ringfietspad
655,Ringfietspad Zurenborgbrug,2023-05-18,14:00:00,249,124,125,FMN 06 B Zurenborgbrug Ringfietspad
655,Ringfietspad Zurenborgbrug,2023-05-18,15:00:00,266,125,141,FMN 06 B Zurenborgbrug Ringfietspad
655,Ringfietspad Zurenborgbrug,2023-05-18,16:00:00,224,125,99,FMN 06 B Zurenborgbrug Ringfietspad
655,Ringfietspad Zurenborgbrug,2023-05-18,17:00:00,167,75,92,FMN 06 B Zurenborgbrug Ringfietspad
655,Ringfietspad Zurenborgbrug,2023-05-18,18:00:00,152,63,89,FMN 06 B Zurenborgbrug Ringfietspad
655,Ringfietspad Zurenborgbrug,2023-05-18,19:00:00,155,50,105,FMN 06 B Zurenborgbrug Ringfietspad
655,Ringfietspad Zurenborgbrug,2023-05-18,20:00:00,113,44,69,FMN 06 B Zurenborgbrug Ringfietspad
655,Ringfietspad Zurenborgbrug,2023-05-18,21:00:00,85,40,45,FMN 06 B Zurenborgbrug Ringfietspad
655,Ringfietspad Zurenborgbrug,2023-05-18,22:00:00,64,25,39,FMN 06 B Zurenborgbrug Ringfietspad
655,Ringfietspad Zurenborgbrug,2023-05-18,23:00:00,60,33,27,FMN 06 B Zurenborgbrug Ringfietspad
655,Ringfietspad Zurenborgbrug,2023-05-19,00:00:00,36,7,29,FMN 06 B Zurenborgbrug Ringfietspad
655,Ringfietspad Zurenborgbrug,2023-05-19,01:00:00,26,6,20,FMN 06 B Zurenborgbrug Ringfietspad
655,Ringfietspad Zurenborgbrug,2023-05-19,02:00:00,6,1,5,FMN 06 B Zurenborgbrug Ringfietspad
655,Ringfietspad Zurenborgbrug,2023-05-19,03:00:00,6,5,1,FMN 06 B Zurenborgbrug Ringfietspad
655,Ringfietspad Zurenborgbrug,2023-05-19,04:00:00,22,13,9,FMN 06 B Zurenborgbrug Ringfietspad
655,Ringfietspad Zurenborgbrug,2023-05-19,05:00:00,22,12,10,FMN 06 B Zurenborgbrug Ringfietspad
655,Ringfietspad Zurenborgbrug,2023-05-19,06:00:00,65,33,32,FMN 06 B Zurenborgbrug Ringfietspad
655,Ringfietspad Zurenborgbrug,2023-05-19,07:00:00,121,65,56,FMN 06 B Zurenborgbrug Ringfietspad
655,Ringfietspad Zurenborgbrug,2023-05-19,08:00:00,143,83,60,FMN 06 B Zurenborgbrug Ringfietspad
655,Ringfietspad Zurenborgbrug,2023-05-19,09:00:00,143,83,60,FMN 06 B Zurenborgbrug Ringfietspad
655,Ringfietspad Zurenborgbrug,2023-05-19,10:00:00,118,55,63,FMN 06 B Zurenborgbrug Ringfietspad
655,Ringfietspad Zurenborgbrug,2023-05-19,11:00:00,147,62,85,FMN 06 B Zurenborgbrug Ringfietspad
655,Ringfietspad Zurenborgbrug,2023-05-19,12:00:00,210,104,106,FMN 06 B Zurenborgbrug Ringfietspad
655,Ringfietspad Zurenborgbrug,2023-05-19,13:00:00,208,106,102,FMN 06 B Zurenborgbrug Ringfietspad
655,Ringfietspad Zurenborgbrug,2023-05-19,14:00:00,254,118,136,FMN 06 B Zurenborgbrug Ringfietspad
655,Ringfietspad Zurenborgbrug,2023-05-19,15:00:00,199,93,106,FMN 06 B Zurenborgbrug Ringfietspad
655,Ringfietspad Zurenborgbrug,2023-05-19,16:00:00,273,125,148,FMN 06 B Zurenborgbrug Ringfietspad
655,Ringfietspad Zurenborgbrug,2023-05-19,17:00:00,233,99,134,FMN 06 B Zurenborgbrug Ringfietspad
655,Ringfietspad Zurenborgbrug,2023-05-19,18:00:00,212,92,120,FMN 06 B Zurenborgbrug Ringfietspad
655,Ringfietspad Zurenborgbrug,2023-05-19,19:00:00,131,55,76,FMN 06 B Zurenborgbrug Ringfietspad
655,Ringfietspad Zurenborgbrug,2023-05-19,20:00:00,107,47,60,FMN 06 B Zurenborgbrug Ringfietspad
655,Ringfietspad Zurenborgbrug,2023-05-19,21:00:00,63,23,40,FMN 06 B Zurenborgbrug Ringfietspad
655,Ringfietspad Zurenborgbrug,2023-05-19,22:00:00,78,35,43,FMN 06 B Zurenborgbrug Ringfietspad
655,Ringfietspad Zurenborgbrug,2023-05-19,23:00:00,45,20,25,FMN 06 B Zurenborgbrug Ringfietspad
655,Ringfietspad Zurenborgbrug,2023-05-20,00:00:00,41,22,19,FMN 06 B Zurenborgbrug Ringfietspad
655,Ringfietspad Zurenborgbrug,2023-05-20,01:00:00,9,4,5,FMN 06 B Zurenborgbrug Ringfietspad
655,Ringfietspad Zurenborgbrug,2023-05-20,02:00:00,14,3,11,FMN 06 B Zurenborgbrug Ringfietspad
655,Ringfietspad Zurenborgbrug,2023-05-20,03:00:00,6,5,1,FMN 06 B Zurenborgbrug Ringfietspad
655,Ringfietspad Zurenborgbrug,2023-05-20,04:00:00,16,8,8,FMN 06 B Zurenborgbrug Ringfietspad
655,Ringfietspad Zurenborgbrug,2023-05-20,05:00:00,20,13,7,FMN 06 B Zurenborgbrug Ringfietspad
655,Ringfietspad Zurenborgbrug,2023-05-20,06:00:00,32,25,7,FMN 06 B Zurenborgbrug Ringfietspad
655,Ringfietspad Zurenborgbrug,2023-05-20,07:00:00,34,13,21,FMN 06 B Zurenborgbrug Ringfietspad
655,Ringfietspad Zurenborgbrug,2023-05-20,08:00:00,67,29,38,FMN 06 B Zurenborgbrug Ringfietspad
655,Ringfietspad Zurenborgbrug,2023-05-20,09:00:00,122,59,63,FMN 06 B Zurenborgbrug Ringfietspad
655,Ringfietspad Zurenborgbrug,2023-05-20,10:00:00,146,59,87,FMN 06 B Zurenborgbrug Ringfietspad
655,Ringfietspad Zurenborgbrug,2023-05-20,11:00:00,165,76,89,FMN 06 B Zurenborgbrug Ringfietspad
655,Ringfietspad Zurenborgbrug,2023-05-20,12:00:00,162,81,81,FMN 06 B Zurenborgbrug Ringfietspad
655,Ringfietspad Zurenborgbrug,2023-05-20,13:00:00,196,88,108,FMN 06 B Zurenborgbrug Ringfietspad
655,Ringfietspad Zurenborgbrug,2023-05-20,14:00:00,248,129,119,FMN 06 B Zurenborgbrug Ringfietspad
655,Ringfietspad Zurenborgbrug,2023-05-20,15:00:00,218,102,116,FMN 06 B Zurenborgbrug Ringfietspad
655,Ringfietspad Zurenborgbrug,2023-05-20,16:00:00,193,81,112,FMN 06 B Zurenborgbrug Ringfietspad
655,Ringfietspad Zurenborgbrug,2023-05-20,17:00:00,206,92,114,FMN 06 B Zurenborgbrug Ringfietspad
655,Ringfietspad Zurenborgbrug,2023-05-20,18:00:00,141,50,91,FMN 06 B Zurenborgbrug Ringfietspad
655,Ringfietspad Zurenborgbrug,2023-05-20,19:00:00,131,39,92,FMN 06 B Zurenborgbrug Ringfietspad
655,Ringfietspad Zurenborgbrug,2023-05-20,20:00:00,126,47,79,FMN 06 B Zurenborgbrug Ringfietspad
655,Ringfietspad Zurenborgbrug,2023-05-20,21:00:00,73,27,46,FMN 06 B Zurenborgbrug Ringfietspad
655,Ringfietspad Zurenborgbrug,2023-05-20,22:00:00,72,36,36,FMN 06 B Zurenborgbrug Ringfietspad
655,Ringfietspad Zurenborgbrug,2023-05-20,23:00:00,83,44,39,FMN 06 B Zurenborgbrug Ringfietspad
655,Ringfietspad Zurenborgbrug,2023-05-21,00:00:00,28,17,11,FMN 06 B Zurenborgbrug Ringfietspad
655,Ringfietspad Zurenborgbrug,2023-05-21,01:00:00,18,13,5,FMN 06 B Zurenborgbrug Ringfietspad
655,Ringfietspad Zurenborgbrug,2023-05-21,02:00:00,9,7,2,FMN 06 B Zurenborgbrug Ringfietspad
655,Ringfietspad Zurenborgbrug,2023-05-21,03:00:00,10,3,7,FMN 06 B Zurenborgbrug Ringfietspad
655,Ringfietspad Zurenborgbrug,2023-05-21,04:00:00,8,3,5,FMN 06 B Zurenborgbrug Ringfietspad
655,Ringfietspad Zurenborgbrug,2023-05-21,05:00:00,21,14,7,FMN 06 B Zurenborgbrug Ringfietspad
655,Ringfietspad Zurenborgbrug,2023-05-21,06:00:00,19,11,8,FMN 06 B Zurenborgbrug Ringfietspad
655,Ringfietspad Zurenborgbrug,2023-05-21,07:00:00,27,14,13,FMN 06 B Zurenborgbrug Ringfietspad
655,Ringfietspad Zurenborgbrug,2023-05-21,08:00:00,60,13,47,FMN 06 B Zurenborgbrug Ringfietspad
655,Ringfietspad Zurenborgbrug,2023-05-21,09:00:00,128,51,77,FMN 06 B Zurenborgbrug Ringfietspad
655,Ringfietspad Zurenborgbrug,2023-05-21,10:00:00,186,75,111,FMN 06 B Zurenborgbrug Ringfietspad
655,Ringfietspad Zurenborgbrug,2023-05-21,11:00:00,228,107,121,FMN 06 B Zurenborgbrug Ringfietspad
655,Ringfietspad Zurenborgbrug,2023-05-21,12:00:00,249,129,120,FMN 06 B Zurenborgbrug Ringfietspad
655,Ringfietspad Zurenborgbrug,2023-05-21,13:00:00,279,155,124,FMN 06 B Zurenborgbrug Ringfietspad
655,Ringfietspad Zurenborgbrug,2023-05-21,14:00:00,328,144,184,FMN 06 B Zurenborgbrug Ringfietspad
655,Ringfietspad Zurenborgbrug,2023-05-21,15:00:00,289,113,176,FMN 06 B Zurenborgbrug Ringfietspad
655,Ringfietspad Zurenborgbrug,2023-05-21,16:00:00,233,108,125,FMN 06 B Zurenborgbrug Ringfietspad
655,Ringfietspad Zurenborgbrug,2023-05-21,17:00:00,254,132,122,FMN 06 B Zurenborgbrug Ringfietspad
655,Ringfietspad Zurenborgbrug,2023-05-21,18:00:00,158,81,77,FMN 06 B Zurenborgbrug Ringfietspad
655,Ringfietspad Zurenborgbrug,2023-05-21,19:00:00,138,62,76,FMN 06 B Zurenborgbrug Ringfietspad
655,Ringfietspad Zurenborgbrug,2023-05-21,20:00:00,112,49,63,FMN 06 B Zurenborgbrug Ringfietspad
655,Ringfietspad Zurenborgbrug,2023-05-21,21:00:00,72,33,39,FMN 06 B Zurenborgbrug Ringfietspad
655,Ringfietspad Zurenborgbrug,2023-05-21,22:00:00,49,26,23,FMN 06 B Zurenborgbrug Ringfietspad
655,Ringfietspad Zurenborgbrug,2023-05-21,23:00:00,23,8,15,FMN 06 B Zurenborgbrug Ringfietspad
655,Ringfietspad Zurenborgbrug,2023-05-22,00:00:00,10,5,5,FMN 06 B Zurenborgbrug Ringfietspad
655,Ringfietspad Zurenborgbrug,2023-05-22,01:00:00,5,5,0,FMN 06 B Zurenborgbrug Ringfietspad
655,Ringfietspad Zurenborgbrug,2023-05-22,02:00:00,3,1,2,FMN 06 B Zurenborgbrug Ringfietspad
655,Ringfietspad Zurenborgbrug,2023-05-22,03:00:00,2,0,2,FMN 06 B Zurenborgbrug Ringfietspad
655,Ringfietspad Zurenborgbrug,2023-05-22,04:00:00,19,14,5,FMN 06 B Zurenborgbrug Ringfietspad
655,Ringfietspad Zurenborgbrug,2023-05-22,05:00:00,55,28,27,FMN 06 B Zurenborgbrug Ringfietspad
655,Ringfietspad Zurenborgbrug,2023-05-22,06:00:00,140,82,58,FMN 06 B Zurenborgbrug Ringfietspad
655,Ringfietspad Zurenborgbrug,2023-05-22,07:00:00,471,269,202,FMN 06 B Zurenborgbrug Ringfietspad
655,Ringfietspad Zurenborgbrug,2023-05-22,08:00:00,697,392,305,FMN 06 B Zurenborgbrug Ringfietspad
655,Ringfietspad Zurenborgbrug,2023-05-22,09:00:00,214,112,102,FMN 06 B Zurenborgbrug Ringfietspad
655,Ringfietspad Zurenborgbrug,2023-05-22,10:00:00,131,81,50,FMN 06 B Zurenborgbrug Ringfietspad
655,Ringfietspad Zurenborgbrug,2023-05-22,11:00:00,115,48,67,FMN 06 B Zurenborgbrug Ringfietspad
655,Ringfietspad Zurenborgbrug,2023-05-22,12:00:00,209,102,107,FMN 06 B Zurenborgbrug Ringfietspad
655,Ringfietspad Zurenborgbrug,2023-05-22,13:00:00,171,88,83,FMN 06 B Zurenborgbrug Ringfietspad
655,Ringfietspad Zurenborgbrug,2023-05-22,14:00:00,192,82,110,FMN 06 B Zurenborgbrug Ringfietspad
655,Ringfietspad Zurenborgbrug,2023-05-22,15:00:00,346,138,208,FMN 06 B Zurenborgbrug Ringfietspad
655,Ringfietspad Zurenborgbrug,2023-05-22,16:00:00,610,250,360,FMN 06 B Zurenborgbrug Ringfietspad
655,Ringfietspad Zurenborgbrug,2023-05-22,17:00:00,573,213,360,FMN 06 B Zurenborgbrug Ringfietspad
655,Ringfietspad Zurenborgbrug,2023-05-22,18:00:00,355,145,210,FMN 06 B Zurenborgbrug Ringfietspad
655,Ringfietspad Zurenborgbrug,2023-05-22,19:00:00,219,78,141,FMN 06 B Zurenborgbrug Ringfietspad
655,Ringfietspad Zurenborgbrug,2023-05-22,20:00:00,144,63,81,FMN 06 B Zurenborgbrug Ringfietspad
655,Ringfietspad Zurenborgbrug,2023-05-22,21:00:00,125,59,66,FMN 06 B Zurenborgbrug Ringfietspad
655,Ringfietspad Zurenborgbrug,2023-05-22,22:00:00,95,35,60,FMN 06 B Zurenborgbrug Ringfietspad
655,Ringfietspad Zurenborgbrug,2023-05-22,23:00:00,40,19,21,FMN 06 B Zurenborgbrug Ringfietspad
655,Ringfietspad Zurenborgbrug,2023-05-23,00:00:00,9,3,6,FMN 06 B Zurenborgbrug Ringfietspad
655,Ringfietspad Zurenborgbrug,2023-05-23,01:00:00,9,5,4,FMN 06 B Zurenborgbrug Ringfietspad
655,Ringfietspad Zurenborgbrug,2023-05-23,02:00:00,2,2,0,FMN 06 B Zurenborgbrug Ringfietspad
655,Ringfietspad Zurenborgbrug,2023-05-23,03:00:00,3,1,2,FMN 06 B Zurenborgbrug Ringfietspad
655,Ringfietspad Zurenborgbrug,2023-05-23,04:00:00,17,8,9,FMN 06 B Zurenborgbrug Ringfietspad
655,Ringfietspad Zurenborgbrug,2023-05-23,05:00:00,68,41,27,FMN 06 B Zurenborgbrug Ringfietspad
655,Ringfietspad Zurenborgbrug,2023-05-23,06:00:00,169,97,72,FMN 06 B Zurenborgbrug Ringfietspad
655,Ringfietspad Zurenborgbrug,2023-05-23,07:00:00,522,304,218,FMN 06 B Zurenborgbrug Ringfietspad
655,Ringfietspad Zurenborgbrug,2023-05-23,08:00:00,805,476,329,FMN 06 B Zurenborgbrug Ringfietspad
655,Ringfietspad Zurenborgbrug,2023-05-23,09:00:00,245,142,103,FMN 06 B Zurenborgbrug Ringfietspad
655,Ringfietspad Zurenborgbrug,2023-05-23,10:00:00,141,70,71,FMN 06 B Zurenborgbrug Ringfietspad
655,Ringfietspad Zurenborgbrug,2023-05-23,11:00:00,116,60,56,FMN 06 B Zurenborgbrug Ringfietspad
655,Ringfietspad Zurenborgbrug,2023-05-23,12:00:00,227,112,115,FMN 06 B Zurenborgbrug Ringfietspad
655,Ringfietspad Zurenborgbrug,2023-05-23,13:00:00,224,99,125,FMN 06 B Zurenborgbrug Ringfietspad
655,Ringfietspad Zurenborgbrug,2023-05-23,14:00:00,189,75,114,FMN 06 B Zurenborgbrug Ringfietspad
655,Ringfietspad Zurenborgbrug,2023-05-23,15:00:00,390,164,226,FMN 06 B Zurenborgbrug Ringfietspad
655,Ringfietspad Zurenborgbrug,2023-05-23,16:00:00,598,246,352,FMN 06 B Zurenborgbrug Ringfietspad
655,Ringfietspad Zurenborgbrug,2023-05-23,17:00:00,653,245,408,FMN 06 B Zurenborgbrug Ringfietspad
655,Ringfietspad Zurenborgbrug,2023-05-23,18:00:00,384,146,238,FMN 06 B Zurenborgbrug Ringfietspad
655,Ringfietspad Zurenborgbrug,2023-05-23,19:00:00,194,66,128,FMN 06 B Zurenborgbrug Ringfietspad
655,Ringfietspad Zurenborgbrug,2023-05-23,20:00:00,124,47,77,FMN 06 B Zurenborgbrug Ringfietspad
655,Ringfietspad Zurenborgbrug,2023-05-23,21:00:00,143,54,89,FMN 06 B Zurenborgbrug Ringfietspad
655,Ringfietspad Zurenborgbrug,2023-05-23,22:00:00,124,52,72,FMN 06 B Zurenborgbrug Ringfietspad
655,Ringfietspad Zurenborgbrug,2023-05-23,23:00:00,45,19,26,FMN 06 B Zurenborgbrug Ringfietspad
655,Ringfietspad Zurenborgbrug,2023-05-24,00:00:00,9,5,4,FMN 06 B Zurenborgbrug Ringfietspad
655,Ringfietspad Zurenborgbrug,2023-05-24,01:00:00,4,1,3,FMN 06 B Zurenborgbrug Ringfietspad
655,Ringfietspad Zurenborgbrug,2023-05-24,02:00:00,2,0,2,FMN 06 B Zurenborgbrug Ringfietspad
655,Ringfietspad Zurenborgbrug,2023-05-24,03:00:00,3,2,1,FMN 06 B Zurenborgbrug Ringfietspad
655,Ringfietspad Zurenborgbrug,2023-05-24,04:00:00,16,8,8,FMN 06 B Zurenborgbrug Ringfietspad
655,Ringfietspad Zurenborgbrug,2023-05-24,05:00:00,57,31,26,FMN 06 B Zurenborgbrug Ringfietspad
655,Ringfietspad Zurenborgbrug,2023-05-24,06:00:00,143,77,66,FMN 06 B Zurenborgbrug Ringfietspad
655,Ringfietspad Zurenborgbrug,2023-05-24,07:00:00,462,257,205,FMN 06 B Zurenborgbrug Ringfietspad
655,Ringfietspad Zurenborgbrug,2023-05-24,08:00:00,590,293,297,FMN 06 B Zurenborgbrug Ringfietspad
655,Ringfietspad Zurenborgbrug,2023-05-24,09:00:00,201,96,105,FMN 06 B Zurenborgbrug Ringfietspad
655,Ringfietspad Zurenborgbrug,2023-05-24,10:00:00,172,72,100,FMN 06 B Zurenborgbrug Ringfietspad
655,Ringfietspad Zurenborgbrug,2023-05-24,11:00:00,178,93,85,FMN 06 B Zurenborgbrug Ringfietspad
655,Ringfietspad Zurenborgbrug,2023-05-24,12:00:00,388,194,194,FMN 06 B Zurenborgbrug Ringfietspad
655,Ringfietspad Zurenborgbrug,2023-05-24,13:00:00,277,125,152,FMN 06 B Zurenborgbrug Ringfietspad
655,Ringfietspad Zurenborgbrug,2023-05-24,14:00:00,233,87,146,FMN 06 B Zurenborgbrug Ringfietspad
655,Ringfietspad Zurenborgbrug,2023-05-24,15:00:00,278,119,159,FMN 06 B Zurenborgbrug Ringfietspad
655,Ringfietspad Zurenborgbrug,2023-05-24,16:00:00,422,161,261,FMN 06 B Zurenborgbrug Ringfietspad
655,Ringfietspad Zurenborgbrug,2023-05-24,17:00:00,510,199,311,FMN 06 B Zurenborgbrug Ringfietspad
655,Ringfietspad Zurenborgbrug,2023-05-24,18:00:00,356,148,208,FMN 06 B Zurenborgbrug Ringfietspad
655,Ringfietspad Zurenborgbrug,2023-05-24,19:00:00,265,92,173,FMN 06 B Zurenborgbrug Ringfietspad
655,Ringfietspad Zurenborgbrug,2023-05-24,20:00:00,127,48,79,FMN 06 B Zurenborgbrug Ringfietspad
655,Ringfietspad Zurenborgbrug,2023-05-24,21:00:00,146,84,62,FMN 06 B Zurenborgbrug Ringfietspad
655,Ringfietspad Zurenborgbrug,2023-05-24,22:00:00,108,33,75,FMN 06 B Zurenborgbrug Ringfietspad
655,Ringfietspad Zurenborgbrug,2023-05-24,23:00:00,44,22,22,FMN 06 B Zurenborgbrug Ringfietspad
655,Ringfietspad Zurenborgbrug,2023-05-25,00:00:00,15,6,9,FMN 06 B Zurenborgbrug Ringfietspad
655,Ringfietspad Zurenborgbrug,2023-05-25,01:00:00,6,1,5,FMN 06 B Zurenborgbrug Ringfietspad
655,Ringfietspad Zurenborgbrug,2023-05-25,02:00:00,2,2,0,FMN 06 B Zurenborgbrug Ringfietspad
655,Ringfietspad Zurenborgbrug,2023-05-25,03:00:00,3,1,2,FMN 06 B Zurenborgbrug Ringfietspad
655,Ringfietspad Zurenborgbrug,2023-05-25,04:00:00,23,13,10,FMN 06 B Zurenborgbrug Ringfietspad
655,Ringfietspad Zurenborgbrug,2023-05-25,05:00:00,55,29,26,FMN 06 B Zurenborgbrug Ringfietspad
655,Ringfietspad Zurenborgbrug,2023-05-25,06:00:00,141,84,57,FMN 06 B Zurenborgbrug Ringfietspad
655,Ringfietspad Zurenborgbrug,2023-05-25,07:00:00,476,276,200,FMN 06 B Zurenborgbrug Ringfietspad
655,Ringfietspad Zurenborgbrug,2023-05-25,08:00:00,723,405,318,FMN 06 B Zurenborgbrug Ringfietspad
655,Ringfietspad Zurenborgbrug,2023-05-25,09:00:00,249,150,99,FMN 06 B Zurenborgbrug Ringfietspad
655,Ringfietspad Zurenborgbrug,2023-05-25,10:00:00,187,114,73,FMN 06 B Zurenborgbrug Ringfietspad
655,Ringfietspad Zurenborgbrug,2023-05-25,11:00:00,144,68,76,FMN 06 B Zurenborgbrug Ringfietspad
655,Ringfietspad Zurenborgbrug,2023-05-25,12:00:00,235,104,131,FMN 06 B Zurenborgbrug Ringfietspad
655,Ringfietspad Zurenborgbrug,2023-05-25,13:00:00,227,114,113,FMN 06 B Zurenborgbrug Ringfietspad
655,Ringfietspad Zurenborgbrug,2023-05-25,14:00:00,196,81,115,FMN 06 B Zurenborgbrug Ringfietspad
655,Ringfietspad Zurenborgbrug,2023-05-25,15:00:00,330,126,204,FMN 06 B Zurenborgbrug Ringfietspad
655,Ringfietspad Zurenborgbrug,2023-05-25,16:00:00,551,235,316,FMN 06 B Zurenborgbrug Ringfietspad
655,Ringfietspad Zurenborgbrug,2023-05-25,17:00:00,592,214,378,FMN 06 B Zurenborgbrug Ringfietspad
655,Ringfietspad Zurenborgbrug,2023-05-25,18:00:00,395,155,240,FMN 06 B Zurenborgbrug Ringfietspad
655,Ringfietspad Zurenborgbrug,2023-05-25,19:00:00,236,88,148,FMN 06 B Zurenborgbrug Ringfietspad
655,Ringfietspad Zurenborgbrug,2023-05-25,20:00:00,140,68,72,FMN 06 B Zurenborgbrug Ringfietspad
655,Ringfietspad Zurenborgbrug,2023-05-25,21:00:00,109,37,72,FMN 06 B Zurenborgbrug Ringfietspad
655,Ringfietspad Zurenborgbrug,2023-05-25,22:00:00,112,46,66,FMN 06 B Zurenborgbrug Ringfietspad
655,Ringfietspad Zurenborgbrug,2023-05-25,23:00:00,57,34,23,FMN 06 B Zurenborgbrug Ringfietspad
655,Ringfietspad Zurenborgbrug,2023-05-26,00:00:00,23,7,16,FMN 06 B Zurenborgbrug Ringfietspad
655,Ringfietspad Zurenborgbrug,2023-05-26,01:00:00,6,2,4,FMN 06 B Zurenborgbrug Ringfietspad
655,Ringfietspad Zurenborgbrug,2023-05-26,02:00:00,6,2,4,FMN 06 B Zurenborgbrug Ringfietspad
655,Ringfietspad Zurenborgbrug,2023-05-26,03:00:00,4,2,2,FMN 06 B Zurenborgbrug Ringfietspad
655,Ringfietspad Zurenborgbrug,2023-05-26,04:00:00,18,10,8,FMN 06 B Zurenborgbrug Ringfietspad
655,Ringfietspad Zurenborgbrug,2023-05-26,05:00:00,54,28,26,FMN 06 B Zurenborgbrug Ringfietspad
655,Ringfietspad Zurenborgbrug,2023-05-26,06:00:00,116,70,46,FMN 06 B Zurenborgbrug Ringfietspad
655,Ringfietspad Zurenborgbrug,2023-05-26,07:00:00,399,218,181,FMN 06 B Zurenborgbrug Ringfietspad
655,Ringfietspad Zurenborgbrug,2023-05-26,08:00:00,561,273,288,FMN 06 B Zurenborgbrug Ringfietspad
655,Ringfietspad Zurenborgbrug,2023-05-26,09:00:00,169,81,88,FMN 06 B Zurenborgbrug Ringfietspad
655,Ringfietspad Zurenborgbrug,2023-05-26,10:00:00,138,76,62,FMN 06 B Zurenborgbrug Ringfietspad
655,Ringfietspad Zurenborgbrug,2023-05-26,11:00:00,142,78,64,FMN 06 B Zurenborgbrug Ringfietspad
655,Ringfietspad Zurenborgbrug,2023-05-26,12:00:00,209,107,102,FMN 06 B Zurenborgbrug Ringfietspad
655,Ringfietspad Zurenborgbrug,2023-05-26,13:00:00,240,117,123,FMN 06 B Zurenborgbrug Ringfietspad
655,Ringfietspad Zurenborgbrug,2023-05-26,14:00:00,227,100,127,FMN 06 B Zurenborgbrug Ringfietspad
655,Ringfietspad Zurenborgbrug,2023-05-26,15:00:00,375,150,225,FMN 06 B Zurenborgbrug Ringfietspad
655,Ringfietspad Zurenborgbrug,2023-05-26,16:00:00,500,207,293,FMN 06 B Zurenborgbrug Ringfietspad
655,Ringfietspad Zurenborgbrug,2023-05-26,17:00:00,397,162,235,FMN 06 B Zurenborgbrug Ringfietspad
655,Ringfietspad Zurenborgbrug,2023-05-26,18:00:00,306,127,179,FMN 06 B Zurenborgbrug Ringfietspad
655,Ringfietspad Zurenborgbrug,2023-05-26,19:00:00,195,67,128,FMN 06 B Zurenborgbrug Ringfietspad
655,Ringfietspad Zurenborgbrug,2023-05-26,20:00:00,140,66,74,FMN 06 B Zurenborgbrug Ringfietspad
655,Ringfietspad Zurenborgbrug,2023-05-26,21:00:00,95,36,59,FMN 06 B Zurenborgbrug Ringfietspad
655,Ringfietspad Zurenborgbrug,2023-05-26,22:00:00,113,50,63,FMN 06 B Zurenborgbrug Ringfietspad
655,Ringfietspad Zurenborgbrug,2023-05-26,23:00:00,65,23,42,FMN 06 B Zurenborgbrug Ringfietspad
655,Ringfietspad Zurenborgbrug,2023-05-27,00:00:00,37,17,20,FMN 06 B Zurenborgbrug Ringfietspad
655,Ringfietspad Zurenborgbrug,2023-05-27,01:00:00,22,13,9,FMN 06 B Zurenborgbrug Ringfietspad
655,Ringfietspad Zurenborgbrug,2023-05-27,02:00:00,11,2,9,FMN 06 B Zurenborgbrug Ringfietspad
655,Ringfietspad Zurenborgbrug,2023-05-27,03:00:00,8,3,5,FMN 06 B Zurenborgbrug Ringfietspad
655,Ringfietspad Zurenborgbrug,2023-05-27,04:00:00,10,7,3,FMN 06 B Zurenborgbrug Ringfietspad
655,Ringfietspad Zurenborgbrug,2023-05-27,05:00:00,20,9,11,FMN 06 B Zurenborgbrug Ringfietspad
655,Ringfietspad Zurenborgbrug,2023-05-27,06:00:00,26,17,9,FMN 06 B Zurenborgbrug Ringfietspad
655,Ringfietspad Zurenborgbrug,2023-05-27,07:00:00,44,19,25,FMN 06 B Zurenborgbrug Ringfietspad
655,Ringfietspad Zurenborgbrug,2023-05-27,08:00:00,64,31,33,FMN 06 B Zurenborgbrug Ringfietspad
655,Ringfietspad Zurenborgbrug,2023-05-27,09:00:00,139,59,80,FMN 06 B Zurenborgbrug Ringfietspad
655,Ringfietspad Zurenborgbrug,2023-05-27,10:00:00,158,60,98,FMN 06 B Zurenborgbrug Ringfietspad
655,Ringfietspad Zurenborgbrug,2023-05-27,11:00:00,202,101,101,FMN 06 B Zurenborgbrug Ringfietspad
655,Ringfietspad Zurenborgbrug,2023-05-27,12:00:00,193,107,86,FMN 06 B Zurenborgbrug Ringfietspad
655,Ringfietspad Zurenborgbrug,2023-05-27,13:00:00,262,113,149,FMN 06 B Zurenborgbrug Ringfietspad
655,Ringfietspad Zurenborgbrug,2023-05-27,14:00:00,334,141,193,FMN 06 B Zurenborgbrug Ringfietspad
655,Ringfietspad Zurenborgbrug,2023-05-27,15:00:00,250,99,151,FMN 06 B Zurenborgbrug Ringfietspad
655,Ringfietspad Zurenborgbrug,2023-05-27,16:00:00,205,109,96,FMN 06 B Zurenborgbrug Ringfietspad
655,Ringfietspad Zurenborgbrug,2023-05-27,17:00:00,201,94,107,FMN 06 B Zurenborgbrug Ringfietspad
655,Ringfietspad Zurenborgbrug,2023-05-27,18:00:00,252,93,159,FMN 06 B Zurenborgbrug Ringfietspad
655,Ringfietspad Zurenborgbrug,2023-05-27,19:00:00,134,56,78,FMN 06 B Zurenborgbrug Ringfietspad
655,Ringfietspad Zurenborgbrug,2023-05-27,20:00:00,124,51,73,FMN 06 B Zurenborgbrug Ringfietspad
655,Ringfietspad Zurenborgbrug,2023-05-27,21:00:00,104,55,49,FMN 06 B Zurenborgbrug Ringfietspad
655,Ringfietspad Zurenborgbrug,2023-05-27,22:00:00,120,73,47,FMN 06 B Zurenborgbrug Ringfietspad
655,Ringfietspad Zurenborgbrug,2023-05-27,23:00:00,52,27,25,FMN 06 B Zurenborgbrug Ringfietspad
655,Ringfietspad Zurenborgbrug,2023-05-28,00:00:00,78,31,47,FMN 06 B Zurenborgbrug Ringfietspad
655,Ringfietspad Zurenborgbrug,2023-05-28,01:00:00,28,15,13,FMN 06 B Zurenborgbrug Ringfietspad
655,Ringfietspad Zurenborgbrug,2023-05-28,02:00:00,22,13,9,FMN 06 B Zurenborgbrug Ringfietspad
655,Ringfietspad Zurenborgbrug,2023-05-28,03:00:00,8,3,5,FMN 06 B Zurenborgbrug Ringfietspad
655,Ringfietspad Zurenborgbrug,2023-05-28,04:00:00,5,1,4,FMN 06 B Zurenborgbrug Ringfietspad
655,Ringfietspad Zurenborgbrug,2023-05-28,05:00:00,14,8,6,FMN 06 B Zurenborgbrug Ringfietspad
655,Ringfietspad Zurenborgbrug,2023-05-28,06:00:00,12,6,6,FMN 06 B Zurenborgbrug Ringfietspad
655,Ringfietspad Zurenborgbrug,2023-05-28,07:00:00,38,20,18,FMN 06 B Zurenborgbrug Ringfietspad
655,Ringfietspad Zurenborgbrug,2023-05-28,08:00:00,54,27,27,FMN 06 B Zurenborgbrug Ringfietspad
655,Ringfietspad Zurenborgbrug,2023-05-28,09:00:00,117,46,71,FMN 06 B Zurenborgbrug Ringfietspad
655,Ringfietspad Zurenborgbrug,2023-05-28,10:00:00,223,57,166,FMN 06 B Zurenborgbrug Ringfietspad
655,Ringfietspad Zurenborgbrug,2023-05-28,11:00:00,333,86,247,FMN 06 B Zurenborgbrug Ringfietspad
655,Ringfietspad Zurenborgbrug,2023-05-28,12:00:00,348,121,227,FMN 06 B Zurenborgbrug Ringfietspad
655,Ringfietspad Zurenborgbrug,2023-05-28,13:00:00,267,104,163,FMN 06 B Zurenborgbrug Ringfietspad
655,Ringfietspad Zurenborgbrug,2023-05-28,14:00:00,281,107,174,FMN 06 B Zurenborgbrug Ringfietspad
655,Ringfietspad Zurenborgbrug,2023-05-28,15:00:00,263,127,136,FMN 06 B Zurenborgbrug Ringfietspad
655,Ringfietspad Zurenborgbrug,2023-05-28,16:00:00,346,208,138,FMN 06 B Zurenborgbrug Ringfietspad
655,Ringfietspad Zurenborgbrug,2023-05-28,17:00:00,308,190,118,FMN 06 B Zurenborgbrug Ringfietspad
655,Ringfietspad Zurenborgbrug,2023-05-28,18:00:00,246,103,143,FMN 06 B Zurenborgbrug Ringfietspad
655,Ringfietspad Zurenborgbrug,2023-05-28,19:00:00,143,73,70,FMN 06 B Zurenborgbrug Ringfietspad
655,Ringfietspad Zurenborgbrug,2023-05-28,20:00:00,125,65,60,FMN 06 B Zurenborgbrug Ringfietspad
655,Ringfietspad Zurenborgbrug,2023-05-28,21:00:00,89,39,50,FMN 06 B Zurenborgbrug Ringfietspad
655,Ringfietspad Zurenborgbrug,2023-05-28,22:00:00,102,71,31,FMN 06 B Zurenborgbrug Ringfietspad
655,Ringfietspad Zurenborgbrug,2023-05-28,23:00:00,44,14,30,FMN 06 B Zurenborgbrug Ringfietspad
655,Ringfietspad Zurenborgbrug,2023-05-29,00:00:00,49,22,27,FMN 06 B Zurenborgbrug Ringfietspad
655,Ringfietspad Zurenborgbrug,2023-05-29,01:00:00,21,12,9,FMN 06 B Zurenborgbrug Ringfietspad
655,Ringfietspad Zurenborgbrug,2023-05-29,02:00:00,15,2,13,FMN 06 B Zurenborgbrug Ringfietspad
655,Ringfietspad Zurenborgbrug,2023-05-29,03:00:00,7,4,3,FMN 06 B Zurenborgbrug Ringfietspad
655,Ringfietspad Zurenborgbrug,2023-05-29,04:00:00,4,3,1,FMN 06 B Zurenborgbrug Ringfietspad
655,Ringfietspad Zurenborgbrug,2023-05-29,05:00:00,12,8,4,FMN 06 B Zurenborgbrug Ringfietspad
655,Ringfietspad Zurenborgbrug,2023-05-29,06:00:00,25,13,12,FMN 06 B Zurenborgbrug Ringfietspad
655,Ringfietspad Zurenborgbrug,2023-05-29,07:00:00,27,15,12,FMN 06 B Zurenborgbrug Ringfietspad
655,Ringfietspad Zurenborgbrug,2023-05-29,08:00:00,36,15,21,FMN 06 B Zurenborgbrug Ringfietspad
655,Ringfietspad Zurenborgbrug,2023-05-29,09:00:00,122,33,89,FMN 06 B Zurenborgbrug Ringfietspad
655,Ringfietspad Zurenborgbrug,2023-05-29,10:00:00,133,39,94,FMN 06 B Zurenborgbrug Ringfietspad
655,Ringfietspad Zurenborgbrug,2023-05-29,11:00:00,201,92,109,FMN 06 B Zurenborgbrug Ringfietspad
655,Ringfietspad Zurenborgbrug,2023-05-29,12:00:00,228,98,130,FMN 06 B Zurenborgbrug Ringfietspad
655,Ringfietspad Zurenborgbrug,2023-05-29,13:00:00,232,112,120,FMN 06 B Zurenborgbrug Ringfietspad
655,Ringfietspad Zurenborgbrug,2023-05-29,14:00:00,330,125,205,FMN 06 B Zurenborgbrug Ringfietspad
655,Ringfietspad Zurenborgbrug,2023-05-29,15:00:00,304,107,197,FMN 06 B Zurenborgbrug Ringfietspad
655,Ringfietspad Zurenborgbrug,2023-05-29,16:00:00,239,112,127,FMN 06 B Zurenborgbrug Ringfietspad
655,Ringfietspad Zurenborgbrug,2023-05-29,17:00:00,213,106,107,FMN 06 B Zurenborgbrug Ringfietspad
655,Ringfietspad Zurenborgbrug,2023-05-29,18:00:00,171,96,75,FMN 06 B Zurenborgbrug Ringfietspad
655,Ringfietspad Zurenborgbrug,2023-05-29,19:00:00,139,67,72,FMN 06 B Zurenborgbrug Ringfietspad
655,Ringfietspad Zurenborgbrug,2023-05-29,20:00:00,113,58,55,FMN 06 B Zurenborgbrug Ringfietspad
655,Ringfietspad Zurenborgbrug,2023-05-29,21:00:00,90,47,43,FMN 06 B Zurenborgbrug Ringfietspad
655,Ringfietspad Zurenborgbrug,2023-05-29,22:00:00,56,35,21,FMN 06 B Zurenborgbrug Ringfietspad
655,Ringfietspad Zurenborgbrug,2023-05-29,23:00:00,31,17,14,FMN 06 B Zurenborgbrug Ringfietspad
655,Ringfietspad Zurenborgbrug,2023-05-30,00:00:00,13,7,6,FMN 06 B Zurenborgbrug Ringfietspad
655,Ringfietspad Zurenborgbrug,2023-05-30,01:00:00,6,4,2,FMN 06 B Zurenborgbrug Ringfietspad
655,Ringfietspad Zurenborgbrug,2023-05-30,02:00:00,2,0,2,FMN 06 B Zurenborgbrug Ringfietspad
655,Ringfietspad Zurenborgbrug,2023-05-30,03:00:00,4,2,2,FMN 06 B Zurenborgbrug Ringfietspad
655,Ringfietspad Zurenborgbrug,2023-05-30,04:00:00,16,10,6,FMN 06 B Zurenborgbrug Ringfietspad
655,Ringfietspad Zurenborgbrug,2023-05-30,05:00:00,60,37,23,FMN 06 B Zurenborgbrug Ringfietspad
655,Ringfietspad Zurenborgbrug,2023-05-30,06:00:00,160,95,65,FMN 06 B Zurenborgbrug Ringfietspad
655,Ringfietspad Zurenborgbrug,2023-05-30,07:00:00,499,297,202,FMN 06 B Zurenborgbrug Ringfietspad
655,Ringfietspad Zurenborgbrug,2023-05-30,08:00:00,717,374,343,FMN 06 B Zurenborgbrug Ringfietspad
655,Ringfietspad Zurenborgbrug,2023-05-30,09:00:00,205,122,83,FMN 06 B Zurenborgbrug Ringfietspad
655,Ringfietspad Zurenborgbrug,2023-05-30,10:00:00,128,59,69,FMN 06 B Zurenborgbrug Ringfietspad
655,Ringfietspad Zurenborgbrug,2023-05-30,11:00:00,171,105,66,FMN 06 B Zurenborgbrug Ringfietspad
655,Ringfietspad Zurenborgbrug,2023-05-30,12:00:00,197,89,108,FMN 06 B Zurenborgbrug Ringfietspad
655,Ringfietspad Zurenborgbrug,2023-05-30,13:00:00,198,86,112,FMN 06 B Zurenborgbrug Ringfietspad
655,Ringfietspad Zurenborgbrug,2023-05-30,14:00:00,205,84,121,FMN 06 B Zurenborgbrug Ringfietspad
655,Ringfietspad Zurenborgbrug,2023-05-30,15:00:00,351,129,222,FMN 06 B Zurenborgbrug Ringfietspad
655,Ringfietspad Zurenborgbrug,2023-05-30,16:00:00,633,258,375,FMN 06 B Zurenborgbrug Ringfietspad
655,Ringfietspad Zurenborgbrug,2023-05-30,17:00:00,673,255,418,FMN 06 B Zurenborgbrug Ringfietspad
655,Ringfietspad Zurenborgbrug,2023-05-30,18:00:00,377,152,225,FMN 06 B Zurenborgbrug Ringfietspad
655,Ringfietspad Zurenborgbrug,2023-05-30,19:00:00,238,93,145,FMN 06 B Zurenborgbrug Ringfietspad
655,Ringfietspad Zurenborgbrug,2023-05-30,20:00:00,145,68,77,FMN 06 B Zurenborgbrug Ringfietspad
655,Ringfietspad Zurenborgbrug,2023-05-30,21:00:00,121,48,73,FMN 06 B Zurenborgbrug Ringfietspad
655,Ringfietspad Zurenborgbrug,2023-05-30,22:00:00,111,49,62,FMN 06 B Zurenborgbrug Ringfietspad
655,Ringfietspad Zurenborgbrug,2023-05-30,23:00:00,50,20,30,FMN 06 B Zurenborgbrug Ringfietspad
655,Ringfietspad Zurenborgbrug,2023-05-31,00:00:00,10,5,5,FMN 06 B Zurenborgbrug Ringfietspad
655,Ringfietspad Zurenborgbrug,2023-05-31,01:00:00,4,3,1,FMN 06 B Zurenborgbrug Ringfietspad
655,Ringfietspad Zurenborgbrug,2023-05-31,02:00:00,2,1,1,FMN 06 B Zurenborgbrug Ringfietspad
655,Ringfietspad Zurenborgbrug,2023-05-31,03:00:00,2,1,1,FMN 06 B Zurenborgbrug Ringfietspad
655,Ringfietspad Zurenborgbrug,2023-05-31,04:00:00,18,9,9,FMN 06 B Zurenborgbrug Ringfietspad
655,Ringfietspad Zurenborgbrug,2023-05-31,05:00:00,63,35,28,FMN 06 B Zurenborgbrug Ringfietspad
655,Ringfietspad Zurenborgbrug,2023-05-31,06:00:00,179,96,83,FMN 06 B Zurenborgbrug Ringfietspad
655,Ringfietspad Zurenborgbrug,2023-05-31,07:00:00,461,256,205,FMN 06 B Zurenborgbrug Ringfietspad
655,Ringfietspad Zurenborgbrug,2023-05-31,08:00:00,633,313,320,FMN 06 B Zurenborgbrug Ringfietspad
655,Ringfietspad Zurenborgbrug,2023-05-31,09:00:00,178,101,77,FMN 06 B Zurenborgbrug Ringfietspad
655,Ringfietspad Zurenborgbrug,2023-05-31,10:00:00,167,76,91,FMN 06 B Zurenborgbrug Ringfietspad
655,Ringfietspad Zurenborgbrug,2023-05-31,11:00:00,164,70,94,FMN 06 B Zurenborgbrug Ringfietspad
655,Ringfietspad Zurenborgbrug,2023-05-31,12:00:00,457,226,231,FMN 06 B Zurenborgbrug Ringfietspad
655,Ringfietspad Zurenborgbrug,2023-05-31,13:00:00,281,143,138,FMN 06 B Zurenborgbrug Ringfietspad
655,Ringfietspad Zurenborgbrug,2023-05-31,14:00:00,289,139,150,FMN 06 B Zurenborgbrug Ringfietspad
655,Ringfietspad Zurenborgbrug,2023-05-31,15:00:00,349,131,218,FMN 06 B Zurenborgbrug Ringfietspad
655,Ringfietspad Zurenborgbrug,2023-05-31,16:00:00,476,202,274,FMN 06 B Zurenborgbrug Ringfietspad
655,Ringfietspad Zurenborgbrug,2023-05-31,17:00:00,549,229,320,FMN 06 B Zurenborgbrug Ringfietspad
655,Ringfietspad Zurenborgbrug,2023-05-31,18:00:00,438,176,262,FMN 06 B Zurenborgbrug Ringfietspad
655,Ringfietspad Zurenborgbrug,2023-05-31,19:00:00,279,104,175,FMN 06 B Zurenborgbrug Ringfietspad
655,Ringfietspad Zurenborgbrug,2023-05-31,20:00:00,178,62,116,FMN 06 B Zurenborgbrug Ringfietspad
655,Ringfietspad Zurenborgbrug,2023-05-31,21:00:00,174,85,89,FMN 06 B Zurenborgbrug Ringfietspad
655,Ringfietspad Zurenborgbrug,2023-05-31,22:00:00,135,68,67,FMN 06 B Zurenborgbrug Ringfietspad
655,Ringfietspad Zurenborgbrug,2023-05-31,23:00:00,49,25,24,FMN 06 B Zurenborgbrug Ringfietspad
655,Ringfietspad Zurenborgbrug,2023-06-01,00:00:00,17,10,7,FMN 06 B Zurenborgbrug Ringfietspad
655,Ringfietspad Zurenborgbrug,2023-06-01,01:00:00,7,1,6,FMN 06 B Zurenborgbrug Ringfietspad
655,Ringfietspad Zurenborgbrug,2023-06-01,02:00:00,4,2,2,FMN 06 B Zurenborgbrug Ringfietspad
655,Ringfietspad Zurenborgbrug,2023-06-01,03:00:00,4,3,1,FMN 06 B Zurenborgbrug Ringfietspad
655,Ringfietspad Zurenborgbrug,2023-06-01,04:00:00,17,13,4,FMN 06 B Zurenborgbrug Ringfietspad
655,Ringfietspad Zurenborgbrug,2023-06-01,05:00:00,61,36,25,FMN 06 B Zurenborgbrug Ringfietspad
655,Ringfietspad Zurenborgbrug,2023-06-01,06:00:00,172,92,80,FMN 06 B Zurenborgbrug Ringfietspad
655,Ringfietspad Zurenborgbrug,2023-06-01,07:00:00,535,309,226,FMN 06 B Zurenborgbrug Ringfietspad
655,Ringfietspad Zurenborgbrug,2023-06-01,08:00:00,689,383,306,FMN 06 B Zurenborgbrug Ringfietspad
655,Ringfietspad Zurenborgbrug,2023-06-01,09:00:00,221,114,107,FMN 06 B Zurenborgbrug Ringfietspad
655,Ringfietspad Zurenborgbrug,2023-06-01,10:00:00,125,75,50,FMN 06 B Zurenborgbrug Ringfietspad
655,Ringfietspad Zurenborgbrug,2023-06-01,11:00:00,168,79,89,FMN 06 B Zurenborgbrug Ringfietspad
655,Ringfietspad Zurenborgbrug,2023-06-01,12:00:00,280,138,142,FMN 06 B Zurenborgbrug Ringfietspad
655,Ringfietspad Zurenborgbrug,2023-06-01,13:00:00,217,93,124,FMN 06 B Zurenborgbrug Ringfietspad
655,Ringfietspad Zurenborgbrug,2023-06-01,14:00:00,263,105,158,FMN 06 B Zurenborgbrug Ringfietspad
655,Ringfietspad Zurenborgbrug,2023-06-01,15:00:00,385,167,218,FMN 06 B Zurenborgbrug Ringfietspad
655,Ringfietspad Zurenborgbrug,2023-06-01,16:00:00,654,272,382,FMN 06 B Zurenborgbrug Ringfietspad
655,Ringfietspad Zurenborgbrug,2023-06-01,17:00:00,639,250,389,FMN 06 B Zurenborgbrug Ringfietspad
655,Ringfietspad Zurenborgbrug,2023-06-01,18:00:00,395,167,228,FMN 06 B Zurenborgbrug Ringfietspad
655,Ringfietspad Zurenborgbrug,2023-06-01,19:00:00,304,109,195,FMN 06 B Zurenborgbrug Ringfietspad
655,Ringfietspad Zurenborgbrug,2023-06-01,20:00:00,159,57,102,FMN 06 B Zurenborgbrug Ringfietspad
655,Ringfietspad Zurenborgbrug,2023-06-01,21:00:00,135,49,86,FMN 06 B Zurenborgbrug Ringfietspad
655,Ringfietspad Zurenborgbrug,2023-06-01,22:00:00,131,63,68,FMN 06 B Zurenborgbrug Ringfietspad
655,Ringfietspad Zurenborgbrug,2023-06-01,23:00:00,59,29,30,FMN 06 B Zurenborgbrug Ringfietspad
655,Ringfietspad Zurenborgbrug,2023-06-02,00:00:00,24,9,15,FMN 06 B Zurenborgbrug Ringfietspad
655,Ringfietspad Zurenborgbrug,2023-06-02,01:00:00,9,3,6,FMN 06 B Zurenborgbrug Ringfietspad
655,Ringfietspad Zurenborgbrug,2023-06-02,02:00:00,0,0,0,FMN 06 B Zurenborgbrug Ringfietspad
655,Ringfietspad Zurenborgbrug,2023-06-02,03:00:00,3,2,1,FMN 06 B Zurenborgbrug Ringfietspad
655,Ringfietspad Zurenborgbrug,2023-06-02,04:00:00,17,12,5,FMN 06 B Zurenborgbrug Ringfietspad
655,Ringfietspad Zurenborgbrug,2023-06-02,05:00:00,54,29,25,FMN 06 B Zurenborgbrug Ringfietspad
655,Ringfietspad Zurenborgbrug,2023-06-02,06:00:00,146,81,65,FMN 06 B Zurenborgbrug Ringfietspad
655,Ringfietspad Zurenborgbrug,2023-06-02,07:00:00,377,206,171,FMN 06 B Zurenborgbrug Ringfietspad
655,Ringfietspad Zurenborgbrug,2023-06-02,08:00:00,589,293,296,FMN 06 B Zurenborgbrug Ringfietspad
655,Ringfietspad Zurenborgbrug,2023-06-02,09:00:00,189,107,82,FMN 06 B Zurenborgbrug Ringfietspad
655,Ringfietspad Zurenborgbrug,2023-06-02,10:00:00,122,58,64,FMN 06 B Zurenborgbrug Ringfietspad
655,Ringfietspad Zurenborgbrug,2023-06-02,11:00:00,128,59,69,FMN 06 B Zurenborgbrug Ringfietspad
655,Ringfietspad Zurenborgbrug,2023-06-02,12:00:00,214,86,128,FMN 06 B Zurenborgbrug Ringfietspad
655,Ringfietspad Zurenborgbrug,2023-06-02,13:00:00,195,98,97,FMN 06 B Zurenborgbrug Ringfietspad
655,Ringfietspad Zurenborgbrug,2023-06-02,14:00:00,236,110,126,FMN 06 B Zurenborgbrug Ringfietspad
655,Ringfietspad Zurenborgbrug,2023-06-02,15:00:00,370,148,222,FMN 06 B Zurenborgbrug Ringfietspad
655,Ringfietspad Zurenborgbrug,2023-06-02,16:00:00,549,245,304,FMN 06 B Zurenborgbrug Ringfietspad
655,Ringfietspad Zurenborgbrug,2023-06-02,17:00:00,457,193,264,FMN 06 B Zurenborgbrug Ringfietspad
655,Ringfietspad Zurenborgbrug,2023-06-02,18:00:00,326,134,192,FMN 06 B Zurenborgbrug Ringfietspad
655,Ringfietspad Zurenborgbrug,2023-06-02,19:00:00,207,68,139,FMN 06 B Zurenborgbrug Ringfietspad
655,Ringfietspad Zurenborgbrug,2023-06-02,20:00:00,140,65,75,FMN 06 B Zurenborgbrug Ringfietspad
655,Ringfietspad Zurenborgbrug,2023-06-02,21:00:00,86,39,47,FMN 06 B Zurenborgbrug Ringfietspad
655,Ringfietspad Zurenborgbrug,2023-06-02,22:00:00,97,54,43,FMN 06 B Zurenborgbrug Ringfietspad
655,Ringfietspad Zurenborgbrug,2023-06-02,23:00:00,75,31,44,FMN 06 B Zurenborgbrug Ringfietspad
655,Ringfietspad Zurenborgbrug,2023-06-03,00:00:00,40,19,21,FMN 06 B Zurenborgbrug Ringfietspad
655,Ringfietspad Zurenborgbrug,2023-06-03,01:00:00,25,11,14,FMN 06 B Zurenborgbrug Ringfietspad
655,Ringfietspad Zurenborgbrug,2023-06-03,02:00:00,16,10,6,FMN 06 B Zurenborgbrug Ringfietspad
655,Ringfietspad Zurenborgbrug,2023-06-03,03:00:00,5,2,3,FMN 06 B Zurenborgbrug Ringfietspad
655,Ringfietspad Zurenborgbrug,2023-06-03,04:00:00,7,5,2,FMN 06 B Zurenborgbrug Ringfietspad
655,Ringfietspad Zurenborgbrug,2023-06-03,05:00:00,28,17,11,FMN 06 B Zurenborgbrug Ringfietspad
655,Ringfietspad Zurenborgbrug,2023-06-03,06:00:00,30,19,11,FMN 06 B Zurenborgbrug Ringfietspad
655,Ringfietspad Zurenborgbrug,2023-06-03,07:00:00,54,25,29,FMN 06 B Zurenborgbrug Ringfietspad
655,Ringfietspad Zurenborgbrug,2023-06-03,08:00:00,79,40,39,FMN 06 B Zurenborgbrug Ringfietspad
655,Ringfietspad Zurenborgbrug,2023-06-03,09:00:00,179,92,87,FMN 06 B Zurenborgbrug Ringfietspad
655,Ringfietspad Zurenborgbrug,2023-06-03,10:00:00,218,104,114,FMN 06 B Zurenborgbrug Ringfietspad
655,Ringfietspad Zurenborgbrug,2023-06-03,11:00:00,245,101,144,FMN 06 B Zurenborgbrug Ringfietspad
655,Ringfietspad Zurenborgbrug,2023-06-03,12:00:00,249,103,146,FMN 06 B Zurenborgbrug Ringfietspad
655,Ringfietspad Zurenborgbrug,2023-06-03,13:00:00,322,159,163,FMN 06 B Zurenborgbrug Ringfietspad
655,Ringfietspad Zurenborgbrug,2023-06-03,14:00:00,372,117,255,FMN 06 B Zurenborgbrug Ringfietspad
655,Ringfietspad Zurenborgbrug,2023-06-03,15:00:00,342,132,210,FMN 06 B Zurenborgbrug Ringfietspad
655,Ringfietspad Zurenborgbrug,2023-06-03,16:00:00,302,146,156,FMN 06 B Zurenborgbrug Ringfietspad
655,Ringfietspad Zurenborgbrug,2023-06-03,17:00:00,282,144,138,FMN 06 B Zurenborgbrug Ringfietspad
655,Ringfietspad Zurenborgbrug,2023-06-03,18:00:00,274,144,130,FMN 06 B Zurenborgbrug Ringfietspad
655,Ringfietspad Zurenborgbrug,2023-06-03,19:00:00,150,84,66,FMN 06 B Zurenborgbrug Ringfietspad
655,Ringfietspad Zurenborgbrug,2023-06-03,20:00:00,147,69,78,FMN 06 B Zurenborgbrug Ringfietspad
655,Ringfietspad Zurenborgbrug,2023-06-03,21:00:00,83,42,41,FMN 06 B Zurenborgbrug Ringfietspad
655,Ringfietspad Zurenborgbrug,2023-06-03,22:00:00,119,56,63,FMN 06 B Zurenborgbrug Ringfietspad
655,Ringfietspad Zurenborgbrug,2023-06-03,23:00:00,78,40,38,FMN 06 B Zurenborgbrug Ringfietspad
655,Ringfietspad Zurenborgbrug,2023-06-04,00:00:00,55,24,31,FMN 06 B Zurenborgbrug Ringfietspad
655,Ringfietspad Zurenborgbrug,2023-06-04,01:00:00,32,18,14,FMN 06 B Zurenborgbrug Ringfietspad
655,Ringfietspad Zurenborgbrug,2023-06-04,02:00:00,14,8,6,FMN 06 B Zurenborgbrug Ringfietspad
655,Ringfietspad Zurenborgbrug,2023-06-04,03:00:00,15,3,12,FMN 06 B Zurenborgbrug Ringfietspad
655,Ringfietspad Zurenborgbrug,2023-06-04,04:00:00,12,8,4,FMN 06 B Zurenborgbrug Ringfietspad
655,Ringfietspad Zurenborgbrug,2023-06-04,05:00:00,15,12,3,FMN 06 B Zurenborgbrug Ringfietspad
655,Ringfietspad Zurenborgbrug,2023-06-04,06:00:00,14,5,9,FMN 06 B Zurenborgbrug Ringfietspad
655,Ringfietspad Zurenborgbrug,2023-06-04,07:00:00,39,14,25,FMN 06 B Zurenborgbrug Ringfietspad
655,Ringfietspad Zurenborgbrug,2023-06-04,08:00:00,74,19,55,FMN 06 B Zurenborgbrug Ringfietspad
655,Ringfietspad Zurenborgbrug,2023-06-04,09:00:00,214,70,144,FMN 06 B Zurenborgbrug Ringfietspad
655,Ringfietspad Zurenborgbrug,2023-06-04,10:00:00,246,78,168,FMN 06 B Zurenborgbrug Ringfietspad
655,Ringfietspad Zurenborgbrug,2023-06-04,11:00:00,272,97,175,FMN 06 B Zurenborgbrug Ringfietspad
655,Ringfietspad Zurenborgbrug,2023-06-04,12:00:00,306,148,158,FMN 06 B Zurenborgbrug Ringfietspad
655,Ringfietspad Zurenborgbrug,2023-06-04,13:00:00,270,97,173,FMN 06 B Zurenborgbrug Ringfietspad
655,Ringfietspad Zurenborgbrug,2023-06-04,14:00:00,408,130,278,FMN 06 B Zurenborgbrug Ringfietspad
655,Ringfietspad Zurenborgbrug,2023-06-04,15:00:00,440,208,232,FMN 06 B Zurenborgbrug Ringfietspad
655,Ringfietspad Zurenborgbrug,2023-06-04,16:00:00,466,228,238,FMN 06 B Zurenborgbrug Ringfietspad
655,Ringfietspad Zurenborgbrug,2023-06-04,17:00:00,455,212,243,FMN 06 B Zurenborgbrug Ringfietspad
655,Ringfietspad Zurenborgbrug,2023-06-04,18:00:00,262,150,112,FMN 06 B Zurenborgbrug Ringfietspad
655,Ringfietspad Zurenborgbrug,2023-06-04,19:00:00,169,91,78,FMN 06 B Zurenborgbrug Ringfietspad
655,Ringfietspad Zurenborgbrug,2023-06-04,20:00:00,117,59,58,FMN 06 B Zurenborgbrug Ringfietspad
655,Ringfietspad Zurenborgbrug,2023-06-04,21:00:00,173,77,96,FMN 06 B Zurenborgbrug Ringfietspad
655,Ringfietspad Zurenborgbrug,2023-06-04,22:00:00,89,42,47,FMN 06 B Zurenborgbrug Ringfietspad
655,Ringfietspad Zurenborgbrug,2023-06-04,23:00:00,29,19,10,FMN 06 B Zurenborgbrug Ringfietspad
655,Ringfietspad Zurenborgbrug,2023-06-05,00:00:00,127,118,9,FMN 06 B Zurenborgbrug Ringfietspad
655,Ringfietspad Zurenborgbrug,2023-06-05,01:00:00,51,46,5,FMN 06 B Zurenborgbrug Ringfietspad
655,Ringfietspad Zurenborgbrug,2023-06-05,02:00:00,12,9,3,FMN 06 B Zurenborgbrug Ringfietspad
655,Ringfietspad Zurenborgbrug,2023-06-05,03:00:00,11,6,5,FMN 06 B Zurenborgbrug Ringfietspad
655,Ringfietspad Zurenborgbrug,2023-06-05,04:00:00,23,13,10,FMN 06 B Zurenborgbrug Ringfietspad
655,Ringfietspad Zurenborgbrug,2023-06-05,05:00:00,55,33,22,FMN 06 B Zurenborgbrug Ringfietspad
655,Ringfietspad Zurenborgbrug,2023-06-05,06:00:00,141,73,68,FMN 06 B Zurenborgbrug Ringfietspad
655,Ringfietspad Zurenborgbrug,2023-06-05,07:00:00,485,262,223,FMN 06 B Zurenborgbrug Ringfietspad
655,Ringfietspad Zurenborgbrug,2023-06-05,08:00:00,719,370,349,FMN 06 B Zurenborgbrug Ringfietspad
655,Ringfietspad Zurenborgbrug,2023-06-05,09:00:00,238,154,84,FMN 06 B Zurenborgbrug Ringfietspad
655,Ringfietspad Zurenborgbrug,2023-06-05,10:00:00,141,66,75,FMN 06 B Zurenborgbrug Ringfietspad
655,Ringfietspad Zurenborgbrug,2023-06-05,11:00:00,159,67,92,FMN 06 B Zurenborgbrug Ringfietspad
655,Ringfietspad Zurenborgbrug,2023-06-05,12:00:00,234,110,124,FMN 06 B Zurenborgbrug Ringfietspad
655,Ringfietspad Zurenborgbrug,2023-06-05,13:00:00,169,84,85,FMN 06 B Zurenborgbrug Ringfietspad
655,Ringfietspad Zurenborgbrug,2023-06-05,14:00:00,179,68,111,FMN 06 B Zurenborgbrug Ringfietspad
655,Ringfietspad Zurenborgbrug,2023-06-05,15:00:00,348,143,205,FMN 06 B Zurenborgbrug Ringfietspad
655,Ringfietspad Zurenborgbrug,2023-06-05,16:00:00,639,273,366,FMN 06 B Zurenborgbrug Ringfietspad
655,Ringfietspad Zurenborgbrug,2023-06-05,17:00:00,649,253,396,FMN 06 B Zurenborgbrug Ringfietspad
655,Ringfietspad Zurenborgbrug,2023-06-05,18:00:00,365,166,199,FMN 06 B Zurenborgbrug Ringfietspad
655,Ringfietspad Zurenborgbrug,2023-06-05,19:00:00,187,70,117,FMN 06 B Zurenborgbrug Ringfietspad
655,Ringfietspad Zurenborgbrug,2023-06-05,20:00:00,154,48,106,FMN 06 B Zurenborgbrug Ringfietspad
655,Ringfietspad Zurenborgbrug,2023-06-05,21:00:00,123,55,68,FMN 06 B Zurenborgbrug Ringfietspad
655,Ringfietspad Zurenborgbrug,2023-06-05,22:00:00,102,38,64,FMN 06 B Zurenborgbrug Ringfietspad
655,Ringfietspad Zurenborgbrug,2023-06-05,23:00:00,45,26,19,FMN 06 B Zurenborgbrug Ringfietspad
655,Ringfietspad Zurenborgbrug,2023-06-06,00:00:00,19,14,5,FMN 06 B Zurenborgbrug Ringfietspad
655,Ringfietspad Zurenborgbrug,2023-06-06,01:00:00,4,1,3,FMN 06 B Zurenborgbrug Ringfietspad
655,Ringfietspad Zurenborgbrug,2023-06-06,02:00:00,3,2,1,FMN 06 B Zurenborgbrug Ringfietspad
655,Ringfietspad Zurenborgbrug,2023-06-06,03:00:00,4,1,3,FMN 06 B Zurenborgbrug Ringfietspad
655,Ringfietspad Zurenborgbrug,2023-06-06,04:00:00,18,12,6,FMN 06 B Zurenborgbrug Ringfietspad
655,Ringfietspad Zurenborgbrug,2023-06-06,05:00:00,73,47,26,FMN 06 B Zurenborgbrug Ringfietspad
655,Ringfietspad Zurenborgbrug,2023-06-06,06:00:00,157,84,73,FMN 06 B Zurenborgbrug Ringfietspad
655,Ringfietspad Zurenborgbrug,2023-06-06,07:00:00,564,327,237,FMN 06 B Zurenborgbrug Ringfietspad
655,Ringfietspad Zurenborgbrug,2023-06-06,08:00:00,743,401,342,FMN 06 B Zurenborgbrug Ringfietspad
655,Ringfietspad Zurenborgbrug,2023-06-06,09:00:00,234,136,98,FMN 06 B Zurenborgbrug Ringfietspad
655,Ringfietspad Zurenborgbrug,2023-06-06,10:00:00,191,105,86,FMN 06 B Zurenborgbrug Ringfietspad
655,Ringfietspad Zurenborgbrug,2023-06-06,11:00:00,158,72,86,FMN 06 B Zurenborgbrug Ringfietspad
655,Ringfietspad Zurenborgbrug,2023-06-06,12:00:00,209,98,111,FMN 06 B Zurenborgbrug Ringfietspad
655,Ringfietspad Zurenborgbrug,2023-06-06,13:00:00,127,44,83,FMN 06 B Zurenborgbrug Ringfietspad
655,Ringfietspad Zurenborgbrug,2023-06-06,14:00:00,192,80,112,FMN 06 B Zurenborgbrug Ringfietspad
655,Ringfietspad Zurenborgbrug,2023-06-06,15:00:00,424,161,263,FMN 06 B Zurenborgbrug Ringfietspad
655,Ringfietspad Zurenborgbrug,2023-06-06,16:00:00,731,308,423,FMN 06 B Zurenborgbrug Ringfietspad
655,Ringfietspad Zurenborgbrug,2023-06-06,17:00:00,739,267,472,FMN 06 B Zurenborgbrug Ringfietspad
655,Ringfietspad Zurenborgbrug,2023-06-06,18:00:00,380,143,237,FMN 06 B Zurenborgbrug Ringfietspad
655,Ringfietspad Zurenborgbrug,2023-06-06,19:00:00,246,85,161,FMN 06 B Zurenborgbrug Ringfietspad
655,Ringfietspad Zurenborgbrug,2023-06-06,20:00:00,143,60,83,FMN 06 B Zurenborgbrug Ringfietspad
655,Ringfietspad Zurenborgbrug,2023-06-06,21:00:00,148,68,80,FMN 06 B Zurenborgbrug Ringfietspad
655,Ringfietspad Zurenborgbrug,2023-06-06,22:00:00,117,37,80,FMN 06 B Zurenborgbrug Ringfietspad
655,Ringfietspad Zurenborgbrug,2023-06-06,23:00:00,79,44,35,FMN 06 B Zurenborgbrug Ringfietspad
655,Ringfietspad Zurenborgbrug,2023-06-07,00:00:00,26,16,10,FMN 06 B Zurenborgbrug Ringfietspad
655,Ringfietspad Zurenborgbrug,2023-06-07,01:00:00,3,1,2,FMN 06 B Zurenborgbrug Ringfietspad
655,Ringfietspad Zurenborgbrug,2023-06-07,02:00:00,2,1,1,FMN 06 B Zurenborgbrug Ringfietspad
655,Ringfietspad Zurenborgbrug,2023-06-07,03:00:00,5,2,3,FMN 06 B Zurenborgbrug Ringfietspad
655,Ringfietspad Zurenborgbrug,2023-06-07,04:00:00,19,7,12,FMN 06 B Zurenborgbrug Ringfietspad
655,Ringfietspad Zurenborgbrug,2023-06-07,05:00:00,56,32,24,FMN 06 B Zurenborgbrug Ringfietspad
655,Ringfietspad Zurenborgbrug,2023-06-07,06:00:00,163,83,80,FMN 06 B Zurenborgbrug Ringfietspad
655,Ringfietspad Zurenborgbrug,2023-06-07,07:00:00,528,314,214,FMN 06 B Zurenborgbrug Ringfietspad
655,Ringfietspad Zurenborgbrug,2023-06-07,08:00:00,710,357,353,FMN 06 B Zurenborgbrug Ringfietspad
655,Ringfietspad Zurenborgbrug,2023-06-07,09:00:00,199,115,84,FMN 06 B Zurenborgbrug Ringfietspad
655,Ringfietspad Zurenborgbrug,2023-06-07,10:00:00,143,65,78,FMN 06 B Zurenborgbrug Ringfietspad
655,Ringfietspad Zurenborgbrug,2023-06-07,11:00:00,200,103,97,FMN 06 B Zurenborgbrug Ringfietspad
655,Ringfietspad Zurenborgbrug,2023-06-07,12:00:00,451,225,226,FMN 06 B Zurenborgbrug Ringfietspad
655,Ringfietspad Zurenborgbrug,2023-06-07,13:00:00,294,140,154,FMN 06 B Zurenborgbrug Ringfietspad
655,Ringfietspad Zurenborgbrug,2023-06-07,14:00:00,279,119,160,FMN 06 B Zurenborgbrug Ringfietspad
655,Ringfietspad Zurenborgbrug,2023-06-07,15:00:00,278,108,170,FMN 06 B Zurenborgbrug Ringfietspad
655,Ringfietspad Zurenborgbrug,2023-06-07,16:00:00,486,228,258,FMN 06 B Zurenborgbrug Ringfietspad
655,Ringfietspad Zurenborgbrug,2023-06-07,17:00:00,580,231,349,FMN 06 B Zurenborgbrug Ringfietspad
655,Ringfietspad Zurenborgbrug,2023-06-07,18:00:00,415,176,239,FMN 06 B Zurenborgbrug Ringfietspad
655,Ringfietspad Zurenborgbrug,2023-06-07,19:00:00,261,94,167,FMN 06 B Zurenborgbrug Ringfietspad
655,Ringfietspad Zurenborgbrug,2023-06-07,20:00:00,190,77,113,FMN 06 B Zurenborgbrug Ringfietspad
655,Ringfietspad Zurenborgbrug,2023-06-07,21:00:00,189,92,97,FMN 06 B Zurenborgbrug Ringfietspad
655,Ringfietspad Zurenborgbrug,2023-06-07,22:00:00,139,40,99,FMN 06 B Zurenborgbrug Ringfietspad
655,Ringfietspad Zurenborgbrug,2023-06-07,23:00:00,49,24,25,FMN 06 B Zurenborgbrug Ringfietspad
655,Ringfietspad Zurenborgbrug,2023-06-08,00:00:00,25,13,12,FMN 06 B Zurenborgbrug Ringfietspad
655,Ringfietspad Zurenborgbrug,2023-06-08,01:00:00,5,0,5,FMN 06 B Zurenborgbrug Ringfietspad
655,Ringfietspad Zurenborgbrug,2023-06-08,02:00:00,1,0,1,FMN 06 B Zurenborgbrug Ringfietspad
655,Ringfietspad Zurenborgbrug,2023-06-08,03:00:00,8,3,5,FMN 06 B Zurenborgbrug Ringfietspad
655,Ringfietspad Zurenborgbrug,2023-06-08,04:00:00,23,14,9,FMN 06 B Zurenborgbrug Ringfietspad
655,Ringfietspad Zurenborgbrug,2023-06-08,05:00:00,62,36,26,FMN 06 B Zurenborgbrug Ringfietspad
655,Ringfietspad Zurenborgbrug,2023-06-08,06:00:00,171,100,71,FMN 06 B Zurenborgbrug Ringfietspad
655,Ringfietspad Zurenborgbrug,2023-06-08,07:00:00,584,365,219,FMN 06 B Zurenborgbrug Ringfietspad
655,Ringfietspad Zurenborgbrug,2023-06-08,08:00:00,761,399,362,FMN 06 B Zurenborgbrug Ringfietspad
655,Ringfietspad Zurenborgbrug,2023-06-08,09:00:00,278,133,145,FMN 06 B Zurenborgbrug Ringfietspad
655,Ringfietspad Zurenborgbrug,2023-06-08,10:00:00,161,84,77,FMN 06 B Zurenborgbrug Ringfietspad
655,Ringfietspad Zurenborgbrug,2023-06-08,11:00:00,176,75,101,FMN 06 B Zurenborgbrug Ringfietspad
655,Ringfietspad Zurenborgbrug,2023-06-08,12:00:00,274,147,127,FMN 06 B Zurenborgbrug Ringfietspad
655,Ringfietspad Zurenborgbrug,2023-06-08,13:00:00,301,137,164,FMN 06 B Zurenborgbrug Ringfietspad
655,Ringfietspad Zurenborgbrug,2023-06-08,14:00:00,247,103,144,FMN 06 B Zurenborgbrug Ringfietspad
655,Ringfietspad Zurenborgbrug,2023-06-08,15:00:00,386,171,215,FMN 06 B Zurenborgbrug Ringfietspad
655,Ringfietspad Zurenborgbrug,2023-06-08,16:00:00,672,302,370,FMN 06 B Zurenborgbrug Ringfietspad
655,Ringfietspad Zurenborgbrug,2023-06-08,17:00:00,678,257,421,FMN 06 B Zurenborgbrug Ringfietspad
655,Ringfietspad Zurenborgbrug,2023-06-08,18:00:00,408,162,246,FMN 06 B Zurenborgbrug Ringfietspad
655,Ringfietspad Zurenborgbrug,2023-06-08,19:00:00,318,107,211,FMN 06 B Zurenborgbrug Ringfietspad
655,Ringfietspad Zurenborgbrug,2023-06-08,20:00:00,172,82,90,FMN 06 B Zurenborgbrug Ringfietspad
655,Ringfietspad Zurenborgbrug,2023-06-08,21:00:00,213,80,133,FMN 06 B Zurenborgbrug Ringfietspad
655,Ringfietspad Zurenborgbrug,2023-06-08,22:00:00,142,80,62,FMN 06 B Zurenborgbrug Ringfietspad
655,Ringfietspad Zurenborgbrug,2023-06-08,23:00:00,78,45,33,FMN 06 B Zurenborgbrug Ringfietspad
655,Ringfietspad Zurenborgbrug,2023-06-09,00:00:00,29,15,14,FMN 06 B Zurenborgbrug Ringfietspad
655,Ringfietspad Zurenborgbrug,2023-06-09,01:00:00,19,9,10,FMN 06 B Zurenborgbrug Ringfietspad
655,Ringfietspad Zurenborgbrug,2023-06-09,02:00:00,5,4,1,FMN 06 B Zurenborgbrug Ringfietspad
655,Ringfietspad Zurenborgbrug,2023-06-09,03:00:00,9,3,6,FMN 06 B Zurenborgbrug Ringfietspad
655,Ringfietspad Zurenborgbrug,2023-06-09,04:00:00,20,12,8,FMN 06 B Zurenborgbrug Ringfietspad
655,Ringfietspad Zurenborgbrug,2023-06-09,05:00:00,65,36,29,FMN 06 B Zurenborgbrug Ringfietspad
655,Ringfietspad Zurenborgbrug,2023-06-09,06:00:00,168,96,72,FMN 06 B Zurenborgbrug Ringfietspad
655,Ringfietspad Zurenborgbrug,2023-06-09,07:00:00,457,252,205,FMN 06 B Zurenborgbrug Ringfietspad
655,Ringfietspad Zurenborgbrug,2023-06-09,08:00:00,628,312,316,FMN 06 B Zurenborgbrug Ringfietspad
655,Ringfietspad Zurenborgbrug,2023-06-09,09:00:00,209,119,90,FMN 06 B Zurenborgbrug Ringfietspad
655,Ringfietspad Zurenborgbrug,2023-06-09,10:00:00,192,88,104,FMN 06 B Zurenborgbrug Ringfietspad
655,Ringfietspad Zurenborgbrug,2023-06-09,11:00:00,209,99,110,FMN 06 B Zurenborgbrug Ringfietspad
655,Ringfietspad Zurenborgbrug,2023-06-09,12:00:00,264,134,130,FMN 06 B Zurenborgbrug Ringfietspad
655,Ringfietspad Zurenborgbrug,2023-06-09,13:00:00,223,95,128,FMN 06 B Zurenborgbrug Ringfietspad
655,Ringfietspad Zurenborgbrug,2023-06-09,14:00:00,299,132,167,FMN 06 B Zurenborgbrug Ringfietspad
655,Ringfietspad Zurenborgbrug,2023-06-09,15:00:00,402,176,226,FMN 06 B Zurenborgbrug Ringfietspad
655,Ringfietspad Zurenborgbrug,2023-06-09,16:00:00,619,278,341,FMN 06 B Zurenborgbrug Ringfietspad
655,Ringfietspad Zurenborgbrug,2023-06-09,17:00:00,470,188,282,FMN 06 B Zurenborgbrug Ringfietspad
655,Ringfietspad Zurenborgbrug,2023-06-09,18:00:00,357,158,199,FMN 06 B Zurenborgbrug Ringfietspad
655,Ringfietspad Zurenborgbrug,2023-06-09,19:00:00,227,98,129,FMN 06 B Zurenborgbrug Ringfietspad
655,Ringfietspad Zurenborgbrug,2023-06-09,20:00:00,140,61,79,FMN 06 B Zurenborgbrug Ringfietspad
655,Ringfietspad Zurenborgbrug,2023-06-09,21:00:00,147,52,95,FMN 06 B Zurenborgbrug Ringfietspad
655,Ringfietspad Zurenborgbrug,2023-06-09,22:00:00,113,40,73,FMN 06 B Zurenborgbrug Ringfietspad
655,Ringfietspad Zurenborgbrug,2023-06-09,23:00:00,92,37,55,FMN 06 B Zurenborgbrug Ringfietspad
655,Ringfietspad Zurenborgbrug,2023-06-10,00:00:00,56,27,29,FMN 06 B Zurenborgbrug Ringfietspad
655,Ringfietspad Zurenborgbrug,2023-06-10,01:00:00,42,20,22,FMN 06 B Zurenborgbrug Ringfietspad
655,Ringfietspad Zurenborgbrug,2023-06-10,02:00:00,18,9,9,FMN 06 B Zurenborgbrug Ringfietspad
655,Ringfietspad Zurenborgbrug,2023-06-10,03:00:00,3,1,2,FMN 06 B Zurenborgbrug Ringfietspad
655,Ringfietspad Zurenborgbrug,2023-06-10,04:00:00,8,4,4,FMN 06 B Zurenborgbrug Ringfietspad
655,Ringfietspad Zurenborgbrug,2023-06-10,05:00:00,12,10,2,FMN 06 B Zurenborgbrug Ringfietspad
655,Ringfietspad Zurenborgbrug,2023-06-10,06:00:00,49,24,25,FMN 06 B Zurenborgbrug Ringfietspad
655,Ringfietspad Zurenborgbrug,2023-06-10,07:00:00,66,31,35,FMN 06 B Zurenborgbrug Ringfietspad
655,Ringfietspad Zurenborgbrug,2023-06-10,08:00:00,118,46,72,FMN 06 B Zurenborgbrug Ringfietspad
655,Ringfietspad Zurenborgbrug,2023-06-10,09:00:00,192,84,108,FMN 06 B Zurenborgbrug Ringfietspad
655,Ringfietspad Zurenborgbrug,2023-06-10,10:00:00,190,90,100,FMN 06 B Zurenborgbrug Ringfietspad
655,Ringfietspad Zurenborgbrug,2023-06-10,11:00:00,204,108,96,FMN 06 B Zurenborgbrug Ringfietspad
655,Ringfietspad Zurenborgbrug,2023-06-10,12:00:00,201,93,108,FMN 06 B Zurenborgbrug Ringfietspad
655,Ringfietspad Zurenborgbrug,2023-06-10,13:00:00,205,101,104,FMN 06 B Zurenborgbrug Ringfietspad
655,Ringfietspad Zurenborgbrug,2023-06-10,14:00:00,239,100,139,FMN 06 B Zurenborgbrug Ringfietspad
655,Ringfietspad Zurenborgbrug,2023-06-10,15:00:00,231,109,122,FMN 06 B Zurenborgbrug Ringfietspad
655,Ringfietspad Zurenborgbrug,2023-06-10,16:00:00,209,106,103,FMN 06 B Zurenborgbrug Ringfietspad
655,Ringfietspad Zurenborgbrug,2023-06-10,17:00:00,181,77,104,FMN 06 B Zurenborgbrug Ringfietspad
655,Ringfietspad Zurenborgbrug,2023-06-10,18:00:00,180,80,100,FMN 06 B Zurenborgbrug Ringfietspad
655,Ringfietspad Zurenborgbrug,2023-06-10,19:00:00,150,80,70,FMN 06 B Zurenborgbrug Ringfietspad
655,Ringfietspad Zurenborgbrug,2023-06-10,20:00:00,161,66,95,FMN 06 B Zurenborgbrug Ringfietspad
655,Ringfietspad Zurenborgbrug,2023-06-10,21:00:00,108,52,56,FMN 06 B Zurenborgbrug Ringfietspad
655,Ringfietspad Zurenborgbrug,2023-06-10,22:00:00,84,41,43,FMN 06 B Zurenborgbrug Ringfietspad
655,Ringfietspad Zurenborgbrug,2023-06-10,23:00:00,104,43,61,FMN 06 B Zurenborgbrug Ringfietspad
655,Ringfietspad Zurenborgbrug,2023-06-11,00:00:00,55,22,33,FMN 06 B Zurenborgbrug Ringfietspad
655,Ringfietspad Zurenborgbrug,2023-06-11,01:00:00,42,23,19,FMN 06 B Zurenborgbrug Ringfietspad
655,Ringfietspad Zurenborgbrug,2023-06-11,02:00:00,13,10,3,FMN 06 B Zurenborgbrug Ringfietspad
655,Ringfietspad Zurenborgbrug,2023-06-11,03:00:00,14,7,7,FMN 06 B Zurenborgbrug Ringfietspad
655,Ringfietspad Zurenborgbrug,2023-06-11,04:00:00,5,1,4,FMN 06 B Zurenborgbrug Ringfietspad
655,Ringfietspad Zurenborgbrug,2023-06-11,05:00:00,16,9,7,FMN 06 B Zurenborgbrug Ringfietspad
655,Ringfietspad Zurenborgbrug,2023-06-11,06:00:00,23,14,9,FMN 06 B Zurenborgbrug Ringfietspad
655,Ringfietspad Zurenborgbrug,2023-06-11,07:00:00,40,15,25,FMN 06 B Zurenborgbrug Ringfietspad
655,Ringfietspad Zurenborgbrug,2023-06-11,08:00:00,97,32,65,FMN 06 B Zurenborgbrug Ringfietspad
655,Ringfietspad Zurenborgbrug,2023-06-11,09:00:00,191,70,121,FMN 06 B Zurenborgbrug Ringfietspad
655,Ringfietspad Zurenborgbrug,2023-06-11,10:00:00,226,93,133,FMN 06 B Zurenborgbrug Ringfietspad
655,Ringfietspad Zurenborgbrug,2023-06-11,11:00:00,227,109,118,FMN 06 B Zurenborgbrug Ringfietspad
655,Ringfietspad Zurenborgbrug,2023-06-11,12:00:00,241,130,111,FMN 06 B Zurenborgbrug Ringfietspad
655,Ringfietspad Zurenborgbrug,2023-06-11,13:00:00,326,150,176,FMN 06 B Zurenborgbrug Ringfietspad
655,Ringfietspad Zurenborgbrug,2023-06-11,14:00:00,251,114,137,FMN 06 B Zurenborgbrug Ringfietspad
655,Ringfietspad Zurenborgbrug,2023-06-11,15:00:00,219,115,104,FMN 06 B Zurenborgbrug Ringfietspad
655,Ringfietspad Zurenborgbrug,2023-06-11,16:00:00,208,110,98,FMN 06 B Zurenborgbrug Ringfietspad
655,Ringfietspad Zurenborgbrug,2023-06-11,17:00:00,207,122,85,FMN 06 B Zurenborgbrug Ringfietspad
655,Ringfietspad Zurenborgbrug,2023-06-11,18:00:00,182,79,103,FMN 06 B Zurenborgbrug Ringfietspad
655,Ringfietspad Zurenborgbrug,2023-06-11,19:00:00,151,67,84,FMN 06 B Zurenborgbrug Ringfietspad
655,Ringfietspad Zurenborgbrug,2023-06-11,20:00:00,105,43,62,FMN 06 B Zurenborgbrug Ringfietspad
655,Ringfietspad Zurenborgbrug,2023-06-11,21:00:00,107,55,52,FMN 06 B Zurenborgbrug Ringfietspad
655,Ringfietspad Zurenborgbrug,2023-06-11,22:00:00,71,38,33,FMN 06 B Zurenborgbrug Ringfietspad
655,Ringfietspad Zurenborgbrug,2023-06-11,23:00:00,48,21,27,FMN 06 B Zurenborgbrug Ringfietspad
655,Ringfietspad Zurenborgbrug,2023-06-12,00:00:00,13,5,8,FMN 06 B Zurenborgbrug Ringfietspad
655,Ringfietspad Zurenborgbrug,2023-06-12,01:00:00,5,3,2,FMN 06 B Zurenborgbrug Ringfietspad
655,Ringfietspad Zurenborgbrug,2023-06-12,02:00:00,2,1,1,FMN 06 B Zurenborgbrug Ringfietspad
655,Ringfietspad Zurenborgbrug,2023-06-12,03:00:00,5,2,3,FMN 06 B Zurenborgbrug Ringfietspad
655,Ringfietspad Zurenborgbrug,2023-06-12,04:00:00,26,17,9,FMN 06 B Zurenborgbrug Ringfietspad
655,Ringfietspad Zurenborgbrug,2023-06-12,05:00:00,78,51,27,FMN 06 B Zurenborgbrug Ringfietspad
655,Ringfietspad Zurenborgbrug,2023-06-12,06:00:00,202,110,92,FMN 06 B Zurenborgbrug Ringfietspad
655,Ringfietspad Zurenborgbrug,2023-06-12,07:00:00,601,347,254,FMN 06 B Zurenborgbrug Ringfietspad
655,Ringfietspad Zurenborgbrug,2023-06-12,08:00:00,753,415,338,FMN 06 B Zurenborgbrug Ringfietspad
655,Ringfietspad Zurenborgbrug,2023-06-12,09:00:00,256,144,112,FMN 06 B Zurenborgbrug Ringfietspad
655,Ringfietspad Zurenborgbrug,2023-06-12,10:00:00,174,81,93,FMN 06 B Zurenborgbrug Ringfietspad
655,Ringfietspad Zurenborgbrug,2023-06-12,11:00:00,191,71,120,FMN 06 B Zurenborgbrug Ringfietspad
655,Ringfietspad Zurenborgbrug,2023-06-12,12:00:00,303,154,149,FMN 06 B Zurenborgbrug Ringfietspad
655,Ringfietspad Zurenborgbrug,2023-06-12,13:00:00,224,102,122,FMN 06 B Zurenborgbrug Ringfietspad
655,Ringfietspad Zurenborgbrug,2023-06-12,14:00:00,233,92,141,FMN 06 B Zurenborgbrug Ringfietspad
655,Ringfietspad Zurenborgbrug,2023-06-12,15:00:00,362,149,213,FMN 06 B Zurenborgbrug Ringfietspad
655,Ringfietspad Zurenborgbrug,2023-06-12,16:00:00,634,280,354,FMN 06 B Zurenborgbrug Ringfietspad
655,Ringfietspad Zurenborgbrug,2023-06-12,17:00:00,644,255,389,FMN 06 B Zurenborgbrug Ringfietspad
655,Ringfietspad Zurenborgbrug,2023-06-12,18:00:00,389,174,215,FMN 06 B Zurenborgbrug Ringfietspad
655,Ringfietspad Zurenborgbrug,2023-06-12,19:00:00,230,93,137,FMN 06 B Zurenborgbrug Ringfietspad
655,Ringfietspad Zurenborgbrug,2023-06-12,20:00:00,146,61,85,FMN 06 B Zurenborgbrug Ringfietspad
655,Ringfietspad Zurenborgbrug,2023-06-12,21:00:00,135,59,76,FMN 06 B Zurenborgbrug Ringfietspad
655,Ringfietspad Zurenborgbrug,2023-06-12,22:00:00,100,49,51,FMN 06 B Zurenborgbrug Ringfietspad
655,Ringfietspad Zurenborgbrug,2023-06-12,23:00:00,43,15,28,FMN 06 B Zurenborgbrug Ringfietspad
655,Ringfietspad Zurenborgbrug,2023-06-13,00:00:00,14,5,9,FMN 06 B Zurenborgbrug Ringfietspad
655,Ringfietspad Zurenborgbrug,2023-06-13,01:00:00,7,2,5,FMN 06 B Zurenborgbrug Ringfietspad
655,Ringfietspad Zurenborgbrug,2023-06-13,02:00:00,3,1,2,FMN 06 B Zurenborgbrug Ringfietspad
655,Ringfietspad Zurenborgbrug,2023-06-13,03:00:00,5,2,3,FMN 06 B Zurenborgbrug Ringfietspad
655,Ringfietspad Zurenborgbrug,2023-06-13,04:00:00,26,17,9,FMN 06 B Zurenborgbrug Ringfietspad
655,Ringfietspad Zurenborgbrug,2023-06-13,05:00:00,88,53,35,FMN 06 B Zurenborgbrug Ringfietspad
655,Ringfietspad Zurenborgbrug,2023-06-13,06:00:00,217,124,93,FMN 06 B Zurenborgbrug Ringfietspad
655,Ringfietspad Zurenborgbrug,2023-06-13,07:00:00,661,391,270,FMN 06 B Zurenborgbrug Ringfietspad
655,Ringfietspad Zurenborgbrug,2023-06-13,08:00:00,856,470,386,FMN 06 B Zurenborgbrug Ringfietspad
655,Ringfietspad Zurenborgbrug,2023-06-13,09:00:00,291,167,124,FMN 06 B Zurenborgbrug Ringfietspad
655,Ringfietspad Zurenborgbrug,2023-06-13,10:00:00,181,79,102,FMN 06 B Zurenborgbrug Ringfietspad
655,Ringfietspad Zurenborgbrug,2023-06-13,11:00:00,210,107,103,FMN 06 B Zurenborgbrug Ringfietspad
655,Ringfietspad Zurenborgbrug,2023-06-13,12:00:00,290,128,162,FMN 06 B Zurenborgbrug Ringfietspad
655,Ringfietspad Zurenborgbrug,2023-06-13,13:00:00,214,98,116,FMN 06 B Zurenborgbrug Ringfietspad
655,Ringfietspad Zurenborgbrug,2023-06-13,14:00:00,289,120,169,FMN 06 B Zurenborgbrug Ringfietspad
655,Ringfietspad Zurenborgbrug,2023-06-13,15:00:00,373,152,221,FMN 06 B Zurenborgbrug Ringfietspad
655,Ringfietspad Zurenborgbrug,2023-06-13,16:00:00,704,280,424,FMN 06 B Zurenborgbrug Ringfietspad
655,Ringfietspad Zurenborgbrug,2023-06-13,17:00:00,717,296,421,FMN 06 B Zurenborgbrug Ringfietspad
655,Ringfietspad Zurenborgbrug,2023-06-13,18:00:00,430,172,258,FMN 06 B Zurenborgbrug Ringfietspad
655,Ringfietspad Zurenborgbrug,2023-06-13,19:00:00,282,100,182,FMN 06 B Zurenborgbrug Ringfietspad
655,Ringfietspad Zurenborgbrug,2023-06-13,20:00:00,157,73,84,FMN 06 B Zurenborgbrug Ringfietspad
655,Ringfietspad Zurenborgbrug,2023-06-13,21:00:00,149,66,83,FMN 06 B Zurenborgbrug Ringfietspad
655,Ringfietspad Zurenborgbrug,2023-06-13,22:00:00,147,66,81,FMN 06 B Zurenborgbrug Ringfietspad
655,Ringfietspad Zurenborgbrug,2023-06-13,23:00:00,87,54,33,FMN 06 B Zurenborgbrug Ringfietspad
655,Ringfietspad Zurenborgbrug,2023-06-14,00:00:00,21,11,10,FMN 06 B Zurenborgbrug Ringfietspad
655,Ringfietspad Zurenborgbrug,2023-06-14,01:00:00,12,10,2,FMN 06 B Zurenborgbrug Ringfietspad
655,Ringfietspad Zurenborgbrug,2023-06-14,02:00:00,7,4,3,FMN 06 B Zurenborgbrug Ringfietspad
655,Ringfietspad Zurenborgbrug,2023-06-14,03:00:00,5,3,2,FMN 06 B Zurenborgbrug Ringfietspad
655,Ringfietspad Zurenborgbrug,2023-06-14,04:00:00,29,18,11,FMN 06 B Zurenborgbrug Ringfietspad
655,Ringfietspad Zurenborgbrug,2023-06-14,05:00:00,73,43,30,FMN 06 B Zurenborgbrug Ringfietspad
655,Ringfietspad Zurenborgbrug,2023-06-14,06:00:00,203,110,93,FMN 06 B Zurenborgbrug Ringfietspad
655,Ringfietspad Zurenborgbrug,2023-06-14,07:00:00,577,335,242,FMN 06 B Zurenborgbrug Ringfietspad
655,Ringfietspad Zurenborgbrug,2023-06-14,08:00:00,658,353,305,FMN 06 B Zurenborgbrug Ringfietspad
655,Ringfietspad Zurenborgbrug,2023-06-14,09:00:00,227,108,119,FMN 06 B Zurenborgbrug Ringfietspad
655,Ringfietspad Zurenborgbrug,2023-06-14,10:00:00,198,103,95,FMN 06 B Zurenborgbrug Ringfietspad
655,Ringfietspad Zurenborgbrug,2023-06-14,11:00:00,244,130,114,FMN 06 B Zurenborgbrug Ringfietspad
655,Ringfietspad Zurenborgbrug,2023-06-14,12:00:00,424,185,239,FMN 06 B Zurenborgbrug Ringfietspad
655,Ringfietspad Zurenborgbrug,2023-06-14,13:00:00,307,146,161,FMN 06 B Zurenborgbrug Ringfietspad
655,Ringfietspad Zurenborgbrug,2023-06-14,14:00:00,270,126,144,FMN 06 B Zurenborgbrug Ringfietspad
655,Ringfietspad Zurenborgbrug,2023-06-14,15:00:00,330,152,178,FMN 06 B Zurenborgbrug Ringfietspad
655,Ringfietspad Zurenborgbrug,2023-06-14,16:00:00,495,193,302,FMN 06 B Zurenborgbrug Ringfietspad
655,Ringfietspad Zurenborgbrug,2023-06-14,17:00:00,596,242,354,FMN 06 B Zurenborgbrug Ringfietspad
655,Ringfietspad Zurenborgbrug,2023-06-14,18:00:00,420,179,241,FMN 06 B Zurenborgbrug Ringfietspad
655,Ringfietspad Zurenborgbrug,2023-06-14,19:00:00,293,112,181,FMN 06 B Zurenborgbrug Ringfietspad
655,Ringfietspad Zurenborgbrug,2023-06-14,20:00:00,226,78,148,FMN 06 B Zurenborgbrug Ringfietspad
655,Ringfietspad Zurenborgbrug,2023-06-14,21:00:00,164,72,92,FMN 06 B Zurenborgbrug Ringfietspad
655,Ringfietspad Zurenborgbrug,2023-06-14,22:00:00,153,65,88,FMN 06 B Zurenborgbrug Ringfietspad
655,Ringfietspad Zurenborgbrug,2023-06-14,23:00:00,80,59,21,FMN 06 B Zurenborgbrug Ringfietspad
655,Ringfietspad Zurenborgbrug,2023-06-15,00:00:00,52,34,18,FMN 06 B Zurenborgbrug Ringfietspad
655,Ringfietspad Zurenborgbrug,2023-06-15,01:00:00,9,5,4,FMN 06 B Zurenborgbrug Ringfietspad
655,Ringfietspad Zurenborgbrug,2023-06-15,02:00:00,3,0,3,FMN 06 B Zurenborgbrug Ringfietspad
655,Ringfietspad Zurenborgbrug,2023-06-15,03:00:00,5,2,3,FMN 06 B Zurenborgbrug Ringfietspad
655,Ringfietspad Zurenborgbrug,2023-06-15,04:00:00,27,16,11,FMN 06 B Zurenborgbrug Ringfietspad
655,Ringfietspad Zurenborgbrug,2023-06-15,05:00:00,61,37,24,FMN 06 B Zurenborgbrug Ringfietspad
655,Ringfietspad Zurenborgbrug,2023-06-15,06:00:00,185,104,81,FMN 06 B Zurenborgbrug Ringfietspad
655,Ringfietspad Zurenborgbrug,2023-06-15,07:00:00,639,359,280,FMN 06 B Zurenborgbrug Ringfietspad
655,Ringfietspad Zurenborgbrug,2023-06-15,08:00:00,770,432,338,FMN 06 B Zurenborgbrug Ringfietspad
655,Ringfietspad Zurenborgbrug,2023-06-15,09:00:00,231,123,108,FMN 06 B Zurenborgbrug Ringfietspad
655,Ringfietspad Zurenborgbrug,2023-06-15,10:00:00,199,88,111,FMN 06 B Zurenborgbrug Ringfietspad
655,Ringfietspad Zurenborgbrug,2023-06-15,11:00:00,201,89,112,FMN 06 B Zurenborgbrug Ringfietspad
655,Ringfietspad Zurenborgbrug,2023-06-15,12:00:00,267,139,128,FMN 06 B Zurenborgbrug Ringfietspad
655,Ringfietspad Zurenborgbrug,2023-06-15,13:00:00,275,146,129,FMN 06 B Zurenborgbrug Ringfietspad
655,Ringfietspad Zurenborgbrug,2023-06-15,14:00:00,235,91,144,FMN 06 B Zurenborgbrug Ringfietspad
655,Ringfietspad Zurenborgbrug,2023-06-15,15:00:00,428,177,251,FMN 06 B Zurenborgbrug Ringfietspad
655,Ringfietspad Zurenborgbrug,2023-06-15,16:00:00,626,259,367,FMN 06 B Zurenborgbrug Ringfietspad
655,Ringfietspad Zurenborgbrug,2023-06-15,17:00:00,600,218,382,FMN 06 B Zurenborgbrug Ringfietspad
655,Ringfietspad Zurenborgbrug,2023-06-15,18:00:00,440,182,258,FMN 06 B Zurenborgbrug Ringfietspad
655,Ringfietspad Zurenborgbrug,2023-06-15,19:00:00,321,107,214,FMN 06 B Zurenborgbrug Ringfietspad
655,Ringfietspad Zurenborgbrug,2023-06-15,20:00:00,242,93,149,FMN 06 B Zurenborgbrug Ringfietspad
655,Ringfietspad Zurenborgbrug,2023-06-15,21:00:00,128,57,71,FMN 06 B Zurenborgbrug Ringfietspad
655,Ringfietspad Zurenborgbrug,2023-06-15,22:00:00,152,85,67,FMN 06 B Zurenborgbrug Ringfietspad
655,Ringfietspad Zurenborgbrug,2023-06-15,23:00:00,105,70,35,FMN 06 B Zurenborgbrug Ringfietspad
655,Ringfietspad Zurenborgbrug,2023-06-16,00:00:00,56,47,9,FMN 06 B Zurenborgbrug Ringfietspad
655,Ringfietspad Zurenborgbrug,2023-06-16,01:00:00,11,6,5,FMN 06 B Zurenborgbrug Ringfietspad
655,Ringfietspad Zurenborgbrug,2023-06-16,02:00:00,8,2,6,FMN 06 B Zurenborgbrug Ringfietspad
655,Ringfietspad Zurenborgbrug,2023-06-16,03:00:00,7,1,6,FMN 06 B Zurenborgbrug Ringfietspad
655,Ringfietspad Zurenborgbrug,2023-06-16,04:00:00,24,13,11,FMN 06 B Zurenborgbrug Ringfietspad
655,Ringfietspad Zurenborgbrug,2023-06-16,05:00:00,49,31,18,FMN 06 B Zurenborgbrug Ringfietspad
655,Ringfietspad Zurenborgbrug,2023-06-16,06:00:00,160,88,72,FMN 06 B Zurenborgbrug Ringfietspad
655,Ringfietspad Zurenborgbrug,2023-06-16,07:00:00,457,250,207,FMN 06 B Zurenborgbrug Ringfietspad
655,Ringfietspad Zurenborgbrug,2023-06-16,08:00:00,603,328,275,FMN 06 B Zurenborgbrug Ringfietspad
655,Ringfietspad Zurenborgbrug,2023-06-16,09:00:00,239,131,108,FMN 06 B Zurenborgbrug Ringfietspad
655,Ringfietspad Zurenborgbrug,2023-06-16,10:00:00,183,95,88,FMN 06 B Zurenborgbrug Ringfietspad
655,Ringfietspad Zurenborgbrug,2023-06-16,11:00:00,238,104,134,FMN 06 B Zurenborgbrug Ringfietspad
655,Ringfietspad Zurenborgbrug,2023-06-16,12:00:00,273,123,150,FMN 06 B Zurenborgbrug Ringfietspad
655,Ringfietspad Zurenborgbrug,2023-06-16,13:00:00,207,101,106,FMN 06 B Zurenborgbrug Ringfietspad
655,Ringfietspad Zurenborgbrug,2023-06-16,14:00:00,245,97,148,FMN 06 B Zurenborgbrug Ringfietspad
655,Ringfietspad Zurenborgbrug,2023-06-16,15:00:00,429,157,272,FMN 06 B Zurenborgbrug Ringfietspad
655,Ringfietspad Zurenborgbrug,2023-06-16,16:00:00,567,241,326,FMN 06 B Zurenborgbrug Ringfietspad
655,Ringfietspad Zurenborgbrug,2023-06-16,17:00:00,461,213,248,FMN 06 B Zurenborgbrug Ringfietspad
655,Ringfietspad Zurenborgbrug,2023-06-16,18:00:00,346,142,204,FMN 06 B Zurenborgbrug Ringfietspad
655,Ringfietspad Zurenborgbrug,2023-06-16,19:00:00,303,101,202,FMN 06 B Zurenborgbrug Ringfietspad
655,Ringfietspad Zurenborgbrug,2023-06-16,20:00:00,202,74,128,FMN 06 B Zurenborgbrug Ringfietspad
655,Ringfietspad Zurenborgbrug,2023-06-16,21:00:00,120,57,63,FMN 06 B Zurenborgbrug Ringfietspad
655,Ringfietspad Zurenborgbrug,2023-06-16,22:00:00,132,78,54,FMN 06 B Zurenborgbrug Ringfietspad
655,Ringfietspad Zurenborgbrug,2023-06-16,23:00:00,150,90,60,FMN 06 B Zurenborgbrug Ringfietspad
655,Ringfietspad Zurenborgbrug,2023-06-17,00:00:00,94,59,35,FMN 06 B Zurenborgbrug Ringfietspad
655,Ringfietspad Zurenborgbrug,2023-06-17,01:00:00,46,21,25,FMN 06 B Zurenborgbrug Ringfietspad
655,Ringfietspad Zurenborgbrug,2023-06-17,02:00:00,20,7,13,FMN 06 B Zurenborgbrug Ringfietspad
655,Ringfietspad Zurenborgbrug,2023-06-17,03:00:00,9,3,6,FMN 06 B Zurenborgbrug Ringfietspad
655,Ringfietspad Zurenborgbrug,2023-06-17,04:00:00,12,4,8,FMN 06 B Zurenborgbrug Ringfietspad
655,Ringfietspad Zurenborgbrug,2023-06-17,05:00:00,19,10,9,FMN 06 B Zurenborgbrug Ringfietspad
655,Ringfietspad Zurenborgbrug,2023-06-17,06:00:00,40,24,16,FMN 06 B Zurenborgbrug Ringfietspad
655,Ringfietspad Zurenborgbrug,2023-06-17,07:00:00,74,41,33,FMN 06 B Zurenborgbrug Ringfietspad
655,Ringfietspad Zurenborgbrug,2023-06-17,08:00:00,94,53,41,FMN 06 B Zurenborgbrug Ringfietspad
655,Ringfietspad Zurenborgbrug,2023-06-17,09:00:00,128,53,75,FMN 06 B Zurenborgbrug Ringfietspad
655,Ringfietspad Zurenborgbrug,2023-06-17,10:00:00,163,72,91,FMN 06 B Zurenborgbrug Ringfietspad
655,Ringfietspad Zurenborgbrug,2023-06-17,11:00:00,195,96,99,FMN 06 B Zurenborgbrug Ringfietspad
655,Ringfietspad Zurenborgbrug,2023-06-17,12:00:00,224,122,102,FMN 06 B Zurenborgbrug Ringfietspad
655,Ringfietspad Zurenborgbrug,2023-06-17,13:00:00,243,124,119,FMN 06 B Zurenborgbrug Ringfietspad
655,Ringfietspad Zurenborgbrug,2023-06-17,14:00:00,239,81,158,FMN 06 B Zurenborgbrug Ringfietspad
655,Ringfietspad Zurenborgbrug,2023-06-17,15:00:00,274,133,141,FMN 06 B Zurenborgbrug Ringfietspad
655,Ringfietspad Zurenborgbrug,2023-06-17,16:00:00,229,110,119,FMN 06 B Zurenborgbrug Ringfietspad
655,Ringfietspad Zurenborgbrug,2023-06-17,17:00:00,238,114,124,FMN 06 B Zurenborgbrug Ringfietspad
655,Ringfietspad Zurenborgbrug,2023-06-17,18:00:00,234,115,119,FMN 06 B Zurenborgbrug Ringfietspad
655,Ringfietspad Zurenborgbrug,2023-06-17,19:00:00,168,62,106,FMN 06 B Zurenborgbrug Ringfietspad
655,Ringfietspad Zurenborgbrug,2023-06-17,20:00:00,148,60,88,FMN 06 B Zurenborgbrug Ringfietspad
655,Ringfietspad Zurenborgbrug,2023-06-17,21:00:00,97,45,52,FMN 06 B Zurenborgbrug Ringfietspad
655,Ringfietspad Zurenborgbrug,2023-06-17,22:00:00,104,64,40,FMN 06 B Zurenborgbrug Ringfietspad
655,Ringfietspad Zurenborgbrug,2023-06-17,23:00:00,75,46,29,FMN 06 B Zurenborgbrug Ringfietspad
655,Ringfietspad Zurenborgbrug,2023-06-18,00:00:00,59,24,35,FMN 06 B Zurenborgbrug Ringfietspad
655,Ringfietspad Zurenborgbrug,2023-06-18,01:00:00,38,21,17,FMN 06 B Zurenborgbrug Ringfietspad
655,Ringfietspad Zurenborgbrug,2023-06-18,02:00:00,24,14,10,FMN 06 B Zurenborgbrug Ringfietspad
655,Ringfietspad Zurenborgbrug,2023-06-18,03:00:00,20,12,8,FMN 06 B Zurenborgbrug Ringfietspad
655,Ringfietspad Zurenborgbrug,2023-06-18,04:00:00,7,3,4,FMN 06 B Zurenborgbrug Ringfietspad
655,Ringfietspad Zurenborgbrug,2023-06-18,05:00:00,21,9,12,FMN 06 B Zurenborgbrug Ringfietspad
655,Ringfietspad Zurenborgbrug,2023-06-18,06:00:00,23,16,7,FMN 06 B Zurenborgbrug Ringfietspad
655,Ringfietspad Zurenborgbrug,2023-06-18,07:00:00,32,16,16,FMN 06 B Zurenborgbrug Ringfietspad
655,Ringfietspad Zurenborgbrug,2023-06-18,08:00:00,79,29,50,FMN 06 B Zurenborgbrug Ringfietspad
655,Ringfietspad Zurenborgbrug,2023-06-18,09:00:00,124,48,76,FMN 06 B Zurenborgbrug Ringfietspad
655,Ringfietspad Zurenborgbrug,2023-06-18,10:00:00,111,42,69,FMN 06 B Zurenborgbrug Ringfietspad
655,Ringfietspad Zurenborgbrug,2023-06-18,11:00:00,125,52,73,FMN 06 B Zurenborgbrug Ringfietspad
655,Ringfietspad Zurenborgbrug,2023-06-18,12:00:00,126,68,58,FMN 06 B Zurenborgbrug Ringfietspad
655,Ringfietspad Zurenborgbrug,2023-06-18,13:00:00,156,83,73,FMN 06 B Zurenborgbrug Ringfietspad
655,Ringfietspad Zurenborgbrug,2023-06-18,14:00:00,221,85,136,FMN 06 B Zurenborgbrug Ringfietspad
655,Ringfietspad Zurenborgbrug,2023-06-18,15:00:00,166,67,99,FMN 06 B Zurenborgbrug Ringfietspad
655,Ringfietspad Zurenborgbrug,2023-06-18,16:00:00,191,81,110,FMN 06 B Zurenborgbrug Ringfietspad
655,Ringfietspad Zurenborgbrug,2023-06-18,17:00:00,198,93,105,FMN 06 B Zurenborgbrug Ringfietspad
655,Ringfietspad Zurenborgbrug,2023-06-18,18:00:00,153,76,77,FMN 06 B Zurenborgbrug Ringfietspad
655,Ringfietspad Zurenborgbrug,2023-06-18,19:00:00,149,55,94,FMN 06 B Zurenborgbrug Ringfietspad
655,Ringfietspad Zurenborgbrug,2023-06-18,20:00:00,131,48,83,FMN 06 B Zurenborgbrug Ringfietspad
655,Ringfietspad Zurenborgbrug,2023-06-18,21:00:00,85,35,50,FMN 06 B Zurenborgbrug Ringfietspad
655,Ringfietspad Zurenborgbrug,2023-06-18,22:00:00,43,16,27,FMN 06 B Zurenborgbrug Ringfietspad
655,Ringfietspad Zurenborgbrug,2023-06-18,23:00:00,107,97,10,FMN 06 B Zurenborgbrug Ringfietspad
655,Ringfietspad Zurenborgbrug,2023-06-19,00:00:00,41,38,3,FMN 06 B Zurenborgbrug Ringfietspad
655,Ringfietspad Zurenborgbrug,2023-06-19,01:00:00,6,4,2,FMN 06 B Zurenborgbrug Ringfietspad
655,Ringfietspad Zurenborgbrug,2023-06-19,02:00:00,2,1,1,FMN 06 B Zurenborgbrug Ringfietspad
655,Ringfietspad Zurenborgbrug,2023-06-19,03:00:00,11,6,5,FMN 06 B Zurenborgbrug Ringfietspad
655,Ringfietspad Zurenborgbrug,2023-06-19,04:00:00,26,11,15,FMN 06 B Zurenborgbrug Ringfietspad
655,Ringfietspad Zurenborgbrug,2023-06-19,05:00:00,56,33,23,FMN 06 B Zurenborgbrug Ringfietspad
655,Ringfietspad Zurenborgbrug,2023-06-19,06:00:00,193,108,85,FMN 06 B Zurenborgbrug Ringfietspad
655,Ringfietspad Zurenborgbrug,2023-06-19,07:00:00,589,350,239,FMN 06 B Zurenborgbrug Ringfietspad
655,Ringfietspad Zurenborgbrug,2023-06-19,08:00:00,743,384,359,FMN 06 B Zurenborgbrug Ringfietspad
655,Ringfietspad Zurenborgbrug,2023-06-19,09:00:00,231,146,85,FMN 06 B Zurenborgbrug Ringfietspad
655,Ringfietspad Zurenborgbrug,2023-06-19,10:00:00,142,66,76,FMN 06 B Zurenborgbrug Ringfietspad
655,Ringfietspad Zurenborgbrug,2023-06-19,11:00:00,172,81,91,FMN 06 B Zurenborgbrug Ringfietspad
655,Ringfietspad Zurenborgbrug,2023-06-19,12:00:00,339,180,159,FMN 06 B Zurenborgbrug Ringfietspad
655,Ringfietspad Zurenborgbrug,2023-06-19,13:00:00,242,116,126,FMN 06 B Zurenborgbrug Ringfietspad
655,Ringfietspad Zurenborgbrug,2023-06-19,14:00:00,248,110,138,FMN 06 B Zurenborgbrug Ringfietspad
655,Ringfietspad Zurenborgbrug,2023-06-19,15:00:00,361,145,216,FMN 06 B Zurenborgbrug Ringfietspad
655,Ringfietspad Zurenborgbrug,2023-06-19,16:00:00,602,272,330,FMN 06 B Zurenborgbrug Ringfietspad
655,Ringfietspad Zurenborgbrug,2023-06-19,17:00:00,619,240,379,FMN 06 B Zurenborgbrug Ringfietspad
655,Ringfietspad Zurenborgbrug,2023-06-19,18:00:00,390,171,219,FMN 06 B Zurenborgbrug Ringfietspad
655,Ringfietspad Zurenborgbrug,2023-06-19,19:00:00,198,95,103,FMN 06 B Zurenborgbrug Ringfietspad
655,Ringfietspad Zurenborgbrug,2023-06-19,20:00:00,150,77,73,FMN 06 B Zurenborgbrug Ringfietspad
655,Ringfietspad Zurenborgbrug,2023-06-19,21:00:00,148,56,92,FMN 06 B Zurenborgbrug Ringfietspad
655,Ringfietspad Zurenborgbrug,2023-06-19,22:00:00,118,40,78,FMN 06 B Zurenborgbrug Ringfietspad
655,Ringfietspad Zurenborgbrug,2023-06-19,23:00:00,37,15,22,FMN 06 B Zurenborgbrug Ringfietspad
655,Ringfietspad Zurenborgbrug,2023-06-20,00:00:00,10,6,4,FMN 06 B Zurenborgbrug Ringfietspad
655,Ringfietspad Zurenborgbrug,2023-06-20,01:00:00,7,2,5,FMN 06 B Zurenborgbrug Ringfietspad
655,Ringfietspad Zurenborgbrug,2023-06-20,02:00:00,3,1,2,FMN 06 B Zurenborgbrug Ringfietspad
655,Ringfietspad Zurenborgbrug,2023-06-20,03:00:00,7,3,4,FMN 06 B Zurenborgbrug Ringfietspad
655,Ringfietspad Zurenborgbrug,2023-06-20,04:00:00,20,11,9,FMN 06 B Zurenborgbrug Ringfietspad
655,Ringfietspad Zurenborgbrug,2023-06-20,05:00:00,66,33,33,FMN 06 B Zurenborgbrug Ringfietspad
655,Ringfietspad Zurenborgbrug,2023-06-20,06:00:00,183,109,74,FMN 06 B Zurenborgbrug Ringfietspad
655,Ringfietspad Zurenborgbrug,2023-06-20,07:00:00,574,341,233,FMN 06 B Zurenborgbrug Ringfietspad
655,Ringfietspad Zurenborgbrug,2023-06-20,08:00:00,704,414,290,FMN 06 B Zurenborgbrug Ringfietspad
655,Ringfietspad Zurenborgbrug,2023-06-20,09:00:00,250,122,128,FMN 06 B Zurenborgbrug Ringfietspad
655,Ringfietspad Zurenborgbrug,2023-06-20,10:00:00,232,91,141,FMN 06 B Zurenborgbrug Ringfietspad
655,Ringfietspad Zurenborgbrug,2023-06-20,11:00:00,188,89,99,FMN 06 B Zurenborgbrug Ringfietspad
655,Ringfietspad Zurenborgbrug,2023-06-20,12:00:00,270,133,137,FMN 06 B Zurenborgbrug Ringfietspad
655,Ringfietspad Zurenborgbrug,2023-06-20,13:00:00,230,112,118,FMN 06 B Zurenborgbrug Ringfietspad
655,Ringfietspad Zurenborgbrug,2023-06-20,14:00:00,193,84,109,FMN 06 B Zurenborgbrug Ringfietspad
655,Ringfietspad Zurenborgbrug,2023-06-20,15:00:00,403,156,247,FMN 06 B Zurenborgbrug Ringfietspad
655,Ringfietspad Zurenborgbrug,2023-06-20,16:00:00,546,221,325,FMN 06 B Zurenborgbrug Ringfietspad
655,Ringfietspad Zurenborgbrug,2023-06-20,17:00:00,509,211,298,FMN 06 B Zurenborgbrug Ringfietspad
655,Ringfietspad Zurenborgbrug,2023-06-20,18:00:00,221,83,138,FMN 06 B Zurenborgbrug Ringfietspad
655,Ringfietspad Zurenborgbrug,2023-06-20,19:00:00,106,45,61,FMN 06 B Zurenborgbrug Ringfietspad
655,Ringfietspad Zurenborgbrug,2023-06-20,20:00:00,76,35,41,FMN 06 B Zurenborgbrug Ringfietspad
655,Ringfietspad Zurenborgbrug,2023-06-20,21:00:00,65,20,45,FMN 06 B Zurenborgbrug Ringfietspad
655,Ringfietspad Zurenborgbrug,2023-06-20,22:00:00,88,26,62,FMN 06 B Zurenborgbrug Ringfietspad
655,Ringfietspad Zurenborgbrug,2023-06-20,23:00:00,25,5,20,FMN 06 B Zurenborgbrug Ringfietspad
655,Ringfietspad Zurenborgbrug,2023-06-21,00:00:00,15,12,3,FMN 06 B Zurenborgbrug Ringfietspad
655,Ringfietspad Zurenborgbrug,2023-06-21,01:00:00,4,2,2,FMN 06 B Zurenborgbrug Ringfietspad
655,Ringfietspad Zurenborgbrug,2023-06-21,02:00:00,1,0,1,FMN 06 B Zurenborgbrug Ringfietspad
655,Ringfietspad Zurenborgbrug,2023-06-21,03:00:00,3,2,1,FMN 06 B Zurenborgbrug Ringfietspad
655,Ringfietspad Zurenborgbrug,2023-06-21,04:00:00,19,6,13,FMN 06 B Zurenborgbrug Ringfietspad
655,Ringfietspad Zurenborgbrug,2023-06-21,05:00:00,62,44,18,FMN 06 B Zurenborgbrug Ringfietspad
655,Ringfietspad Zurenborgbrug,2023-06-21,06:00:00,188,103,85,FMN 06 B Zurenborgbrug Ringfietspad
655,Ringfietspad Zurenborgbrug,2023-06-21,07:00:00,504,288,216,FMN 06 B Zurenborgbrug Ringfietspad
655,Ringfietspad Zurenborgbrug,2023-06-21,08:00:00,651,368,283,FMN 06 B Zurenborgbrug Ringfietspad
655,Ringfietspad Zurenborgbrug,2023-06-21,09:00:00,238,120,118,FMN 06 B Zurenborgbrug Ringfietspad
655,Ringfietspad Zurenborgbrug,2023-06-21,10:00:00,196,69,127,FMN 06 B Zurenborgbrug Ringfietspad
655,Ringfietspad Zurenborgbrug,2023-06-21,11:00:00,236,129,107,FMN 06 B Zurenborgbrug Ringfietspad
655,Ringfietspad Zurenborgbrug,2023-06-21,12:00:00,395,216,179,FMN 06 B Zurenborgbrug Ringfietspad
655,Ringfietspad Zurenborgbrug,2023-06-21,13:00:00,298,154,144,FMN 06 B Zurenborgbrug Ringfietspad
655,Ringfietspad Zurenborgbrug,2023-06-21,14:00:00,263,101,162,FMN 06 B Zurenborgbrug Ringfietspad
655,Ringfietspad Zurenborgbrug,2023-06-21,15:00:00,300,123,177,FMN 06 B Zurenborgbrug Ringfietspad
655,Ringfietspad Zurenborgbrug,2023-06-21,16:00:00,488,203,285,FMN 06 B Zurenborgbrug Ringfietspad
655,Ringfietspad Zurenborgbrug,2023-06-21,17:00:00,572,232,340,FMN 06 B Zurenborgbrug Ringfietspad
655,Ringfietspad Zurenborgbrug,2023-06-21,18:00:00,454,191,263,FMN 06 B Zurenborgbrug Ringfietspad
655,Ringfietspad Zurenborgbrug,2023-06-21,19:00:00,350,116,234,FMN 06 B Zurenborgbrug Ringfietspad
655,Ringfietspad Zurenborgbrug,2023-06-21,20:00:00,234,90,144,FMN 06 B Zurenborgbrug Ringfietspad
655,Ringfietspad Zurenborgbrug,2023-06-21,21:00:00,183,79,104,FMN 06 B Zurenborgbrug Ringfietspad
655,Ringfietspad Zurenborgbrug,2023-06-21,22:00:00,187,104,83,FMN 06 B Zurenborgbrug Ringfietspad
655,Ringfietspad Zurenborgbrug,2023-06-21,23:00:00,117,87,30,FMN 06 B Zurenborgbrug Ringfietspad
655,Ringfietspad Zurenborgbrug,2023-06-22,00:00:00,26,13,13,FMN 06 B Zurenborgbrug Ringfietspad
655,Ringfietspad Zurenborgbrug,2023-06-22,01:00:00,10,6,4,FMN 06 B Zurenborgbrug Ringfietspad
655,Ringfietspad Zurenborgbrug,2023-06-22,02:00:00,6,3,3,FMN 06 B Zurenborgbrug Ringfietspad
655,Ringfietspad Zurenborgbrug,2023-06-22,03:00:00,11,5,6,FMN 06 B Zurenborgbrug Ringfietspad
655,Ringfietspad Zurenborgbrug,2023-06-22,04:00:00,22,12,10,FMN 06 B Zurenborgbrug Ringfietspad
655,Ringfietspad Zurenborgbrug,2023-06-22,05:00:00,51,32,19,FMN 06 B Zurenborgbrug Ringfietspad
655,Ringfietspad Zurenborgbrug,2023-06-22,06:00:00,172,107,65,FMN 06 B Zurenborgbrug Ringfietspad
655,Ringfietspad Zurenborgbrug,2023-06-22,07:00:00,481,294,187,FMN 06 B Zurenborgbrug Ringfietspad
655,Ringfietspad Zurenborgbrug,2023-06-22,08:00:00,581,356,225,FMN 06 B Zurenborgbrug Ringfietspad
655,Ringfietspad Zurenborgbrug,2023-06-22,09:00:00,223,105,118,FMN 06 B Zurenborgbrug Ringfietspad
655,Ringfietspad Zurenborgbrug,2023-06-22,10:00:00,157,57,100,FMN 06 B Zurenborgbrug Ringfietspad
655,Ringfietspad Zurenborgbrug,2023-06-22,11:00:00,169,82,87,FMN 06 B Zurenborgbrug Ringfietspad
655,Ringfietspad Zurenborgbrug,2023-06-22,12:00:00,206,106,100,FMN 06 B Zurenborgbrug Ringfietspad
655,Ringfietspad Zurenborgbrug,2023-06-22,13:00:00,122,56,66,FMN 06 B Zurenborgbrug Ringfietspad
655,Ringfietspad Zurenborgbrug,2023-06-22,14:00:00,113,45,68,FMN 06 B Zurenborgbrug Ringfietspad
655,Ringfietspad Zurenborgbrug,2023-06-22,15:00:00,230,75,155,FMN 06 B Zurenborgbrug Ringfietspad
655,Ringfietspad Zurenborgbrug,2023-06-22,16:00:00,328,139,189,FMN 06 B Zurenborgbrug Ringfietspad
655,Ringfietspad Zurenborgbrug,2023-06-22,17:00:00,372,124,248,FMN 06 B Zurenborgbrug Ringfietspad
655,Ringfietspad Zurenborgbrug,2023-06-22,18:00:00,205,78,127,FMN 06 B Zurenborgbrug Ringfietspad
655,Ringfietspad Zurenborgbrug,2023-06-22,19:00:00,172,43,129,FMN 06 B Zurenborgbrug Ringfietspad
655,Ringfietspad Zurenborgbrug,2023-06-22,20:00:00,172,51,121,FMN 06 B Zurenborgbrug Ringfietspad
655,Ringfietspad Zurenborgbrug,2023-06-22,21:00:00,85,33,52,FMN 06 B Zurenborgbrug Ringfietspad
655,Ringfietspad Zurenborgbrug,2023-06-22,22:00:00,85,41,44,FMN 06 B Zurenborgbrug Ringfietspad
655,Ringfietspad Zurenborgbrug,2023-06-22,23:00:00,87,68,19,FMN 06 B Zurenborgbrug Ringfietspad
655,Ringfietspad Zurenborgbrug,2023-06-23,00:00:00,32,25,7,FMN 06 B Zurenborgbrug Ringfietspad
655,Ringfietspad Zurenborgbrug,2023-06-23,01:00:00,13,7,6,FMN 06 B Zurenborgbrug Ringfietspad
655,Ringfietspad Zurenborgbrug,2023-06-23,02:00:00,2,0,2,FMN 06 B Zurenborgbrug Ringfietspad
655,Ringfietspad Zurenborgbrug,2023-06-23,03:00:00,3,1,2,FMN 06 B Zurenborgbrug Ringfietspad
655,Ringfietspad Zurenborgbrug,2023-06-23,04:00:00,21,12,9,FMN 06 B Zurenborgbrug Ringfietspad
655,Ringfietspad Zurenborgbrug,2023-06-23,05:00:00,50,31,19,FMN 06 B Zurenborgbrug Ringfietspad
655,Ringfietspad Zurenborgbrug,2023-06-23,06:00:00,147,88,59,FMN 06 B Zurenborgbrug Ringfietspad
655,Ringfietspad Zurenborgbrug,2023-06-23,07:00:00,432,229,203,FMN 06 B Zurenborgbrug Ringfietspad
655,Ringfietspad Zurenborgbrug,2023-06-23,08:00:00,501,268,233,FMN 06 B Zurenborgbrug Ringfietspad
655,Ringfietspad Zurenborgbrug,2023-06-23,09:00:00,258,154,104,FMN 06 B Zurenborgbrug Ringfietspad
655,Ringfietspad Zurenborgbrug,2023-06-23,10:00:00,204,79,125,FMN 06 B Zurenborgbrug Ringfietspad
655,Ringfietspad Zurenborgbrug,2023-06-23,11:00:00,211,112,99,FMN 06 B Zurenborgbrug Ringfietspad
655,Ringfietspad Zurenborgbrug,2023-06-23,12:00:00,269,145,124,FMN 06 B Zurenborgbrug Ringfietspad
655,Ringfietspad Zurenborgbrug,2023-06-23,13:00:00,261,130,131,FMN 06 B Zurenborgbrug Ringfietspad
655,Ringfietspad Zurenborgbrug,2023-06-23,14:00:00,308,114,194,FMN 06 B Zurenborgbrug Ringfietspad
655,Ringfietspad Zurenborgbrug,2023-06-23,15:00:00,398,170,228,FMN 06 B Zurenborgbrug Ringfietspad
655,Ringfietspad Zurenborgbrug,2023-06-23,16:00:00,481,231,250,FMN 06 B Zurenborgbrug Ringfietspad
655,Ringfietspad Zurenborgbrug,2023-06-23,17:00:00,483,182,301,FMN 06 B Zurenborgbrug Ringfietspad
655,Ringfietspad Zurenborgbrug,2023-06-23,18:00:00,329,133,196,FMN 06 B Zurenborgbrug Ringfietspad
655,Ringfietspad Zurenborgbrug,2023-06-23,19:00:00,279,101,178,FMN 06 B Zurenborgbrug Ringfietspad
655,Ringfietspad Zurenborgbrug,2023-06-23,20:00:00,184,73,111,FMN 06 B Zurenborgbrug Ringfietspad
655,Ringfietspad Zurenborgbrug,2023-06-23,21:00:00,138,55,83,FMN 06 B Zurenborgbrug Ringfietspad
655,Ringfietspad Zurenborgbrug,2023-06-23,22:00:00,146,63,83,FMN 06 B Zurenborgbrug Ringfietspad
655,Ringfietspad Zurenborgbrug,2023-06-23,23:00:00,116,54,62,FMN 06 B Zurenborgbrug Ringfietspad
655,Ringfietspad Zurenborgbrug,2023-06-24,00:00:00,66,41,25,FMN 06 B Zurenborgbrug Ringfietspad
655,Ringfietspad Zurenborgbrug,2023-06-24,01:00:00,58,37,21,FMN 06 B Zurenborgbrug Ringfietspad
655,Ringfietspad Zurenborgbrug,2023-06-24,02:00:00,14,6,8,FMN 06 B Zurenborgbrug Ringfietspad
655,Ringfietspad Zurenborgbrug,2023-06-24,03:00:00,10,7,3,FMN 06 B Zurenborgbrug Ringfietspad
655,Ringfietspad Zurenborgbrug,2023-06-24,04:00:00,13,8,5,FMN 06 B Zurenborgbrug Ringfietspad
655,Ringfietspad Zurenborgbrug,2023-06-24,05:00:00,15,7,8,FMN 06 B Zurenborgbrug Ringfietspad
655,Ringfietspad Zurenborgbrug,2023-06-24,06:00:00,42,25,17,FMN 06 B Zurenborgbrug Ringfietspad
655,Ringfietspad Zurenborgbrug,2023-06-24,07:00:00,44,24,20,FMN 06 B Zurenborgbrug Ringfietspad
655,Ringfietspad Zurenborgbrug,2023-06-24,08:00:00,94,45,49,FMN 06 B Zurenborgbrug Ringfietspad
655,Ringfietspad Zurenborgbrug,2023-06-24,09:00:00,180,99,81,FMN 06 B Zurenborgbrug Ringfietspad
655,Ringfietspad Zurenborgbrug,2023-06-24,10:00:00,189,84,105,FMN 06 B Zurenborgbrug Ringfietspad
655,Ringfietspad Zurenborgbrug,2023-06-24,11:00:00,209,111,98,FMN 06 B Zurenborgbrug Ringfietspad
655,Ringfietspad Zurenborgbrug,2023-06-24,12:00:00,232,109,123,FMN 06 B Zurenborgbrug Ringfietspad
655,Ringfietspad Zurenborgbrug,2023-06-24,13:00:00,198,86,112,FMN 06 B Zurenborgbrug Ringfietspad
655,Ringfietspad Zurenborgbrug,2023-06-24,14:00:00,289,120,169,FMN 06 B Zurenborgbrug Ringfietspad
655,Ringfietspad Zurenborgbrug,2023-06-24,15:00:00,253,104,149,FMN 06 B Zurenborgbrug Ringfietspad
655,Ringfietspad Zurenborgbrug,2023-06-24,16:00:00,251,108,143,FMN 06 B Zurenborgbrug Ringfietspad
655,Ringfietspad Zurenborgbrug,2023-06-24,17:00:00,271,152,119,FMN 06 B Zurenborgbrug Ringfietspad
655,Ringfietspad Zurenborgbrug,2023-06-24,18:00:00,196,98,98,FMN 06 B Zurenborgbrug Ringfietspad
655,Ringfietspad Zurenborgbrug,2023-06-24,19:00:00,205,120,85,FMN 06 B Zurenborgbrug Ringfietspad
655,Ringfietspad Zurenborgbrug,2023-06-24,20:00:00,136,65,71,FMN 06 B Zurenborgbrug Ringfietspad
655,Ringfietspad Zurenborgbrug,2023-06-24,21:00:00,124,51,73,FMN 06 B Zurenborgbrug Ringfietspad
655,Ringfietspad Zurenborgbrug,2023-06-24,22:00:00,103,52,51,FMN 06 B Zurenborgbrug Ringfietspad
655,Ringfietspad Zurenborgbrug,2023-06-24,23:00:00,77,35,42,FMN 06 B Zurenborgbrug Ringfietspad
655,Ringfietspad Zurenborgbrug,2023-06-25,00:00:00,60,28,32,FMN 06 B Zurenborgbrug Ringfietspad
655,Ringfietspad Zurenborgbrug,2023-06-25,01:00:00,37,20,17,FMN 06 B Zurenborgbrug Ringfietspad
655,Ringfietspad Zurenborgbrug,2023-06-25,02:00:00,25,15,10,FMN 06 B Zurenborgbrug Ringfietspad
655,Ringfietspad Zurenborgbrug,2023-06-25,03:00:00,23,12,11,FMN 06 B Zurenborgbrug Ringfietspad
655,Ringfietspad Zurenborgbrug,2023-06-25,04:00:00,11,4,7,FMN 06 B Zurenborgbrug Ringfietspad
655,Ringfietspad Zurenborgbrug,2023-06-25,05:00:00,9,2,7,FMN 06 B Zurenborgbrug Ringfietspad
655,Ringfietspad Zurenborgbrug,2023-06-25,06:00:00,22,12,10,FMN 06 B Zurenborgbrug Ringfietspad
655,Ringfietspad Zurenborgbrug,2023-06-25,07:00:00,31,13,18,FMN 06 B Zurenborgbrug Ringfietspad
655,Ringfietspad Zurenborgbrug,2023-06-25,08:00:00,94,43,51,FMN 06 B Zurenborgbrug Ringfietspad
655,Ringfietspad Zurenborgbrug,2023-06-25,09:00:00,165,69,96,FMN 06 B Zurenborgbrug Ringfietspad
655,Ringfietspad Zurenborgbrug,2023-06-25,10:00:00,226,102,124,FMN 06 B Zurenborgbrug Ringfietspad
655,Ringfietspad Zurenborgbrug,2023-06-25,11:00:00,240,113,127,FMN 06 B Zurenborgbrug Ringfietspad
655,Ringfietspad Zurenborgbrug,2023-06-25,12:00:00,225,109,116,FMN 06 B Zurenborgbrug Ringfietspad
655,Ringfietspad Zurenborgbrug,2023-06-25,13:00:00,147,78,69,FMN 06 B Zurenborgbrug Ringfietspad
655,Ringfietspad Zurenborgbrug,2023-06-25,14:00:00,206,78,128,FMN 06 B Zurenborgbrug Ringfietspad
655,Ringfietspad Zurenborgbrug,2023-06-25,15:00:00,224,103,121,FMN 06 B Zurenborgbrug Ringfietspad
655,Ringfietspad Zurenborgbrug,2023-06-25,16:00:00,210,107,103,FMN 06 B Zurenborgbrug Ringfietspad
655,Ringfietspad Zurenborgbrug,2023-06-25,17:00:00,234,108,126,FMN 06 B Zurenborgbrug Ringfietspad
655,Ringfietspad Zurenborgbrug,2023-06-25,18:00:00,218,81,137,FMN 06 B Zurenborgbrug Ringfietspad
655,Ringfietspad Zurenborgbrug,2023-06-25,19:00:00,206,59,147,FMN 06 B Zurenborgbrug Ringfietspad
655,Ringfietspad Zurenborgbrug,2023-06-25,20:00:00,188,65,123,FMN 06 B Zurenborgbrug Ringfietspad
655,Ringfietspad Zurenborgbrug,2023-06-25,21:00:00,122,74,48,FMN 06 B Zurenborgbrug Ringfietspad
655,Ringfietspad Zurenborgbrug,2023-06-25,22:00:00,121,60,61,FMN 06 B Zurenborgbrug Ringfietspad
655,Ringfietspad Zurenborgbrug,2023-06-25,23:00:00,110,83,27,FMN 06 B Zurenborgbrug Ringfietspad
655,Ringfietspad Zurenborgbrug,2023-06-26,00:00:00,37,28,9,FMN 06 B Zurenborgbrug Ringfietspad
655,Ringfietspad Zurenborgbrug,2023-06-26,01:00:00,10,5,5,FMN 06 B Zurenborgbrug Ringfietspad
655,Ringfietspad Zurenborgbrug,2023-06-26,02:00:00,10,7,3,FMN 06 B Zurenborgbrug Ringfietspad
655,Ringfietspad Zurenborgbrug,2023-06-26,03:00:00,6,3,3,FMN 06 B Zurenborgbrug Ringfietspad
655,Ringfietspad Zurenborgbrug,2023-06-26,04:00:00,26,15,11,FMN 06 B Zurenborgbrug Ringfietspad
655,Ringfietspad Zurenborgbrug,2023-06-26,05:00:00,58,27,31,FMN 06 B Zurenborgbrug Ringfietspad
655,Ringfietspad Zurenborgbrug,2023-06-26,06:00:00,204,121,83,FMN 06 B Zurenborgbrug Ringfietspad
655,Ringfietspad Zurenborgbrug,2023-06-26,07:00:00,501,278,223,FMN 06 B Zurenborgbrug Ringfietspad
655,Ringfietspad Zurenborgbrug,2023-06-26,08:00:00,716,413,303,FMN 06 B Zurenborgbrug Ringfietspad
655,Ringfietspad Zurenborgbrug,2023-06-26,09:00:00,254,132,122,FMN 06 B Zurenborgbrug Ringfietspad
655,Ringfietspad Zurenborgbrug,2023-06-26,10:00:00,134,71,63,FMN 06 B Zurenborgbrug Ringfietspad
655,Ringfietspad Zurenborgbrug,2023-06-26,11:00:00,198,100,98,FMN 06 B Zurenborgbrug Ringfietspad
655,Ringfietspad Zurenborgbrug,2023-06-26,12:00:00,265,132,133,FMN 06 B Zurenborgbrug Ringfietspad
655,Ringfietspad Zurenborgbrug,2023-06-26,13:00:00,261,94,167,FMN 06 B Zurenborgbrug Ringfietspad
655,Ringfietspad Zurenborgbrug,2023-06-26,14:00:00,262,109,153,FMN 06 B Zurenborgbrug Ringfietspad
655,Ringfietspad Zurenborgbrug,2023-06-26,15:00:00,362,135,227,FMN 06 B Zurenborgbrug Ringfietspad
655,Ringfietspad Zurenborgbrug,2023-06-26,16:00:00,554,224,330,FMN 06 B Zurenborgbrug Ringfietspad
655,Ringfietspad Zurenborgbrug,2023-06-26,17:00:00,652,253,399,FMN 06 B Zurenborgbrug Ringfietspad
655,Ringfietspad Zurenborgbrug,2023-06-26,18:00:00,380,155,225,FMN 06 B Zurenborgbrug Ringfietspad
655,Ringfietspad Zurenborgbrug,2023-06-26,19:00:00,251,96,155,FMN 06 B Zurenborgbrug Ringfietspad
655,Ringfietspad Zurenborgbrug,2023-06-26,20:00:00,160,73,87,FMN 06 B Zurenborgbrug Ringfietspad
655,Ringfietspad Zurenborgbrug,2023-06-26,21:00:00,137,76,61,FMN 06 B Zurenborgbrug Ringfietspad
655,Ringfietspad Zurenborgbrug,2023-06-26,22:00:00,120,56,64,FMN 06 B Zurenborgbrug Ringfietspad
655,Ringfietspad Zurenborgbrug,2023-06-26,23:00:00,62,25,37,FMN 06 B Zurenborgbrug Ringfietspad
655,Ringfietspad Zurenborgbrug,2023-06-27,00:00:00,16,6,10,FMN 06 B Zurenborgbrug Ringfietspad
655,Ringfietspad Zurenborgbrug,2023-06-27,01:00:00,9,4,5,FMN 06 B Zurenborgbrug Ringfietspad
655,Ringfietspad Zurenborgbrug,2023-06-27,02:00:00,3,3,0,FMN 06 B Zurenborgbrug Ringfietspad
655,Ringfietspad Zurenborgbrug,2023-06-27,03:00:00,10,5,5,FMN 06 B Zurenborgbrug Ringfietspad
655,Ringfietspad Zurenborgbrug,2023-06-27,04:00:00,25,13,12,FMN 06 B Zurenborgbrug Ringfietspad
655,Ringfietspad Zurenborgbrug,2023-06-27,05:00:00,53,27,26,FMN 06 B Zurenborgbrug Ringfietspad
655,Ringfietspad Zurenborgbrug,2023-06-27,06:00:00,190,112,78,FMN 06 B Zurenborgbrug Ringfietspad
655,Ringfietspad Zurenborgbrug,2023-06-27,07:00:00,578,340,238,FMN 06 B Zurenborgbrug Ringfietspad
655,Ringfietspad Zurenborgbrug,2023-06-27,08:00:00,761,450,311,FMN 06 B Zurenborgbrug Ringfietspad
655,Ringfietspad Zurenborgbrug,2023-06-27,09:00:00,273,119,154,FMN 06 B Zurenborgbrug Ringfietspad
655,Ringfietspad Zurenborgbrug,2023-06-27,10:00:00,164,72,92,FMN 06 B Zurenborgbrug Ringfietspad
655,Ringfietspad Zurenborgbrug,2023-06-27,11:00:00,177,87,90,FMN 06 B Zurenborgbrug Ringfietspad
655,Ringfietspad Zurenborgbrug,2023-06-27,12:00:00,220,106,114,FMN 06 B Zurenborgbrug Ringfietspad
655,Ringfietspad Zurenborgbrug,2023-06-27,13:00:00,241,116,125,FMN 06 B Zurenborgbrug Ringfietspad
655,Ringfietspad Zurenborgbrug,2023-06-27,14:00:00,330,154,176,FMN 06 B Zurenborgbrug Ringfietspad
655,Ringfietspad Zurenborgbrug,2023-06-27,15:00:00,377,140,237,FMN 06 B Zurenborgbrug Ringfietspad
655,Ringfietspad Zurenborgbrug,2023-06-27,16:00:00,556,219,337,FMN 06 B Zurenborgbrug Ringfietspad
655,Ringfietspad Zurenborgbrug,2023-06-27,17:00:00,663,256,407,FMN 06 B Zurenborgbrug Ringfietspad
655,Ringfietspad Zurenborgbrug,2023-06-27,18:00:00,377,155,222,FMN 06 B Zurenborgbrug Ringfietspad
655,Ringfietspad Zurenborgbrug,2023-06-27,19:00:00,247,111,136,FMN 06 B Zurenborgbrug Ringfietspad
655,Ringfietspad Zurenborgbrug,2023-06-27,20:00:00,224,95,129,FMN 06 B Zurenborgbrug Ringfietspad
655,Ringfietspad Zurenborgbrug,2023-06-27,21:00:00,156,66,90,FMN 06 B Zurenborgbrug Ringfietspad
655,Ringfietspad Zurenborgbrug,2023-06-27,22:00:00,106,44,62,FMN 06 B Zurenborgbrug Ringfietspad
655,Ringfietspad Zurenborgbrug,2023-06-27,23:00:00,77,38,39,FMN 06 B Zurenborgbrug Ringfietspad
655,Ringfietspad Zurenborgbrug,2023-06-28,00:00:00,16,10,6,FMN 06 B Zurenborgbrug Ringfietspad
655,Ringfietspad Zurenborgbrug,2023-06-28,01:00:00,15,8,7,FMN 06 B Zurenborgbrug Ringfietspad
655,Ringfietspad Zurenborgbrug,2023-06-28,02:00:00,4,3,1,FMN 06 B Zurenborgbrug Ringfietspad
655,Ringfietspad Zurenborgbrug,2023-06-28,03:00:00,2,1,1,FMN 06 B Zurenborgbrug Ringfietspad
655,Ringfietspad Zurenborgbrug,2023-06-28,04:00:00,16,9,7,FMN 06 B Zurenborgbrug Ringfietspad
655,Ringfietspad Zurenborgbrug,2023-06-28,05:00:00,45,24,21,FMN 06 B Zurenborgbrug Ringfietspad
655,Ringfietspad Zurenborgbrug,2023-06-28,06:00:00,163,104,59,FMN 06 B Zurenborgbrug Ringfietspad
655,Ringfietspad Zurenborgbrug,2023-06-28,07:00:00,435,261,174,FMN 06 B Zurenborgbrug Ringfietspad
655,Ringfietspad Zurenborgbrug,2023-06-28,08:00:00,540,301,239,FMN 06 B Zurenborgbrug Ringfietspad
655,Ringfietspad Zurenborgbrug,2023-06-28,09:00:00,176,82,94,FMN 06 B Zurenborgbrug Ringfietspad
655,Ringfietspad Zurenborgbrug,2023-06-28,10:00:00,133,60,73,FMN 06 B Zurenborgbrug Ringfietspad
655,Ringfietspad Zurenborgbrug,2023-06-28,11:00:00,176,106,70,FMN 06 B Zurenborgbrug Ringfietspad
655,Ringfietspad Zurenborgbrug,2023-06-28,12:00:00,328,168,160,FMN 06 B Zurenborgbrug Ringfietspad
655,Ringfietspad Zurenborgbrug,2023-06-28,13:00:00,277,141,136,FMN 06 B Zurenborgbrug Ringfietspad
655,Ringfietspad Zurenborgbrug,2023-06-28,14:00:00,273,111,162,FMN 06 B Zurenborgbrug Ringfietspad
655,Ringfietspad Zurenborgbrug,2023-06-28,15:00:00,318,126,192,FMN 06 B Zurenborgbrug Ringfietspad
655,Ringfietspad Zurenborgbrug,2023-06-28,16:00:00,498,194,304,FMN 06 B Zurenborgbrug Ringfietspad
655,Ringfietspad Zurenborgbrug,2023-06-28,17:00:00,557,213,344,FMN 06 B Zurenborgbrug Ringfietspad
655,Ringfietspad Zurenborgbrug,2023-06-28,18:00:00,385,174,211,FMN 06 B Zurenborgbrug Ringfietspad
655,Ringfietspad Zurenborgbrug,2023-06-28,19:00:00,248,110,138,FMN 06 B Zurenborgbrug Ringfietspad
655,Ringfietspad Zurenborgbrug,2023-06-28,20:00:00,157,71,86,FMN 06 B Zurenborgbrug Ringfietspad
655,Ringfietspad Zurenborgbrug,2023-06-28,21:00:00,132,48,84,FMN 06 B Zurenborgbrug Ringfietspad
655,Ringfietspad Zurenborgbrug,2023-06-28,22:00:00,133,59,74,FMN 06 B Zurenborgbrug Ringfietspad
655,Ringfietspad Zurenborgbrug,2023-06-28,23:00:00,73,24,49,FMN 06 B Zurenborgbrug Ringfietspad
655,Ringfietspad Zurenborgbrug,2023-06-29,00:00:00,25,14,11,FMN 06 B Zurenborgbrug Ringfietspad
655,Ringfietspad Zurenborgbrug,2023-06-29,01:00:00,18,11,7,FMN 06 B Zurenborgbrug Ringfietspad
655,Ringfietspad Zurenborgbrug,2023-06-29,02:00:00,8,0,8,FMN 06 B Zurenborgbrug Ringfietspad
655,Ringfietspad Zurenborgbrug,2023-06-29,03:00:00,4,1,3,FMN 06 B Zurenborgbrug Ringfietspad
655,Ringfietspad Zurenborgbrug,2023-06-29,04:00:00,19,10,9,FMN 06 B Zurenborgbrug Ringfietspad
655,Ringfietspad Zurenborgbrug,2023-06-29,05:00:00,56,33,23,FMN 06 B Zurenborgbrug Ringfietspad
655,Ringfietspad Zurenborgbrug,2023-06-29,06:00:00,179,116,63,FMN 06 B Zurenborgbrug Ringfietspad
655,Ringfietspad Zurenborgbrug,2023-06-29,07:00:00,426,256,170,FMN 06 B Zurenborgbrug Ringfietspad
655,Ringfietspad Zurenborgbrug,2023-06-29,08:00:00,623,374,249,FMN 06 B Zurenborgbrug Ringfietspad
655,Ringfietspad Zurenborgbrug,2023-06-29,09:00:00,222,119,103,FMN 06 B Zurenborgbrug Ringfietspad
655,Ringfietspad Zurenborgbrug,2023-06-29,10:00:00,125,62,63,FMN 06 B Zurenborgbrug Ringfietspad
655,Ringfietspad Zurenborgbrug,2023-06-29,11:00:00,187,67,120,FMN 06 B Zurenborgbrug Ringfietspad
655,Ringfietspad Zurenborgbrug,2023-06-29,12:00:00,212,99,113,FMN 06 B Zurenborgbrug Ringfietspad
655,Ringfietspad Zurenborgbrug,2023-06-29,13:00:00,256,154,102,FMN 06 B Zurenborgbrug Ringfietspad
655,Ringfietspad Zurenborgbrug,2023-06-29,14:00:00,208,89,119,FMN 06 B Zurenborgbrug Ringfietspad
655,Ringfietspad Zurenborgbrug,2023-06-29,15:00:00,297,124,173,FMN 06 B Zurenborgbrug Ringfietspad
655,Ringfietspad Zurenborgbrug,2023-06-29,16:00:00,505,203,302,FMN 06 B Zurenborgbrug Ringfietspad
655,Ringfietspad Zurenborgbrug,2023-06-29,17:00:00,491,186,305,FMN 06 B Zurenborgbrug Ringfietspad
655,Ringfietspad Zurenborgbrug,2023-06-29,18:00:00,356,139,217,FMN 06 B Zurenborgbrug Ringfietspad
655,Ringfietspad Zurenborgbrug,2023-06-29,19:00:00,271,78,193,FMN 06 B Zurenborgbrug Ringfietspad
655,Ringfietspad Zurenborgbrug,2023-06-29,20:00:00,199,79,120,FMN 06 B Zurenborgbrug Ringfietspad
655,Ringfietspad Zurenborgbrug,2023-06-29,21:00:00,117,59,58,FMN 06 B Zurenborgbrug Ringfietspad
655,Ringfietspad Zurenborgbrug,2023-06-29,22:00:00,128,55,73,FMN 06 B Zurenborgbrug Ringfietspad
655,Ringfietspad Zurenborgbrug,2023-06-29,23:00:00,164,123,41,FMN 06 B Zurenborgbrug Ringfietspad
655,Ringfietspad Zurenborgbrug,2023-06-30,00:00:00,52,30,22,FMN 06 B Zurenborgbrug Ringfietspad
655,Ringfietspad Zurenborgbrug,2023-06-30,01:00:00,20,10,10,FMN 06 B Zurenborgbrug Ringfietspad
655,Ringfietspad Zurenborgbrug,2023-06-30,02:00:00,11,6,5,FMN 06 B Zurenborgbrug Ringfietspad
655,Ringfietspad Zurenborgbrug,2023-06-30,03:00:00,5,1,4,FMN 06 B Zurenborgbrug Ringfietspad
655,Ringfietspad Zurenborgbrug,2023-06-30,04:00:00,21,14,7,FMN 06 B Zurenborgbrug Ringfietspad
655,Ringfietspad Zurenborgbrug,2023-06-30,05:00:00,60,28,32,FMN 06 B Zurenborgbrug Ringfietspad
655,Ringfietspad Zurenborgbrug,2023-06-30,06:00:00,158,89,69,FMN 06 B Zurenborgbrug Ringfietspad
655,Ringfietspad Zurenborgbrug,2023-06-30,07:00:00,322,193,129,FMN 06 B Zurenborgbrug Ringfietspad
655,Ringfietspad Zurenborgbrug,2023-06-30,08:00:00,479,246,233,FMN 06 B Zurenborgbrug Ringfietspad
655,Ringfietspad Zurenborgbrug,2023-06-30,09:00:00,287,143,144,FMN 06 B Zurenborgbrug Ringfietspad
655,Ringfietspad Zurenborgbrug,2023-06-30,10:00:00,189,84,105,FMN 06 B Zurenborgbrug Ringfietspad
655,Ringfietspad Zurenborgbrug,2023-06-30,11:00:00,191,103,88,FMN 06 B Zurenborgbrug Ringfietspad
655,Ringfietspad Zurenborgbrug,2023-06-30,12:00:00,303,148,155,FMN 06 B Zurenborgbrug Ringfietspad
655,Ringfietspad Zurenborgbrug,2023-06-30,13:00:00,232,93,139,FMN 06 B Zurenborgbrug Ringfietspad
655,Ringfietspad Zurenborgbrug,2023-06-30,14:00:00,274,112,162,FMN 06 B Zurenborgbrug Ringfietspad
655,Ringfietspad Zurenborgbrug,2023-06-30,15:00:00,333,144,189,FMN 06 B Zurenborgbrug Ringfietspad
655,Ringfietspad Zurenborgbrug,2023-06-30,16:00:00,439,197,242,FMN 06 B Zurenborgbrug Ringfietspad
655,Ringfietspad Zurenborgbrug,2023-06-30,17:00:00,412,171,241,FMN 06 B Zurenborgbrug Ringfietspad
655,Ringfietspad Zurenborgbrug,2023-06-30,18:00:00,355,168,187,FMN 06 B Zurenborgbrug Ringfietspad
655,Ringfietspad Zurenborgbrug,2023-06-30,19:00:00,206,88,118,FMN 06 B Zurenborgbrug Ringfietspad
655,Ringfietspad Zurenborgbrug,2023-06-30,20:00:00,163,82,81,FMN 06 B Zurenborgbrug Ringfietspad
655,Ringfietspad Zurenborgbrug,2023-06-30,21:00:00,113,49,64,FMN 06 B Zurenborgbrug Ringfietspad
655,Ringfietspad Zurenborgbrug,2023-06-30,22:00:00,108,47,61,FMN 06 B Zurenborgbrug Ringfietspad
655,Ringfietspad Zurenborgbrug,2023-06-30,23:00:00,95,40,55,FMN 06 B Zurenborgbrug Ringfietspad
655,Ringfietspad Zurenborgbrug,2023-07-01,00:00:00,78,36,42,FMN 06 B Zurenborgbrug Ringfietspad
655,Ringfietspad Zurenborgbrug,2023-07-01,01:00:00,38,22,16,FMN 06 B Zurenborgbrug Ringfietspad
655,Ringfietspad Zurenborgbrug,2023-07-01,02:00:00,20,11,9,FMN 06 B Zurenborgbrug Ringfietspad
655,Ringfietspad Zurenborgbrug,2023-07-01,03:00:00,11,7,4,FMN 06 B Zurenborgbrug Ringfietspad
655,Ringfietspad Zurenborgbrug,2023-07-01,04:00:00,9,7,2,FMN 06 B Zurenborgbrug Ringfietspad
655,Ringfietspad Zurenborgbrug,2023-07-01,05:00:00,8,3,5,FMN 06 B Zurenborgbrug Ringfietspad
655,Ringfietspad Zurenborgbrug,2023-07-01,06:00:00,16,10,6,FMN 06 B Zurenborgbrug Ringfietspad
655,Ringfietspad Zurenborgbrug,2023-07-01,07:00:00,38,21,17,FMN 06 B Zurenborgbrug Ringfietspad
655,Ringfietspad Zurenborgbrug,2023-07-01,08:00:00,61,38,23,FMN 06 B Zurenborgbrug Ringfietspad
655,Ringfietspad Zurenborgbrug,2023-07-01,09:00:00,77,47,30,FMN 06 B Zurenborgbrug Ringfietspad
655,Ringfietspad Zurenborgbrug,2023-07-01,10:00:00,91,33,58,FMN 06 B Zurenborgbrug Ringfietspad
655,Ringfietspad Zurenborgbrug,2023-07-01,11:00:00,82,36,46,FMN 06 B Zurenborgbrug Ringfietspad
655,Ringfietspad Zurenborgbrug,2023-07-01,12:00:00,94,45,49,FMN 06 B Zurenborgbrug Ringfietspad
655,Ringfietspad Zurenborgbrug,2023-07-01,13:00:00,88,36,52,FMN 06 B Zurenborgbrug Ringfietspad
655,Ringfietspad Zurenborgbrug,2023-07-01,14:00:00,85,40,45,FMN 06 B Zurenborgbrug Ringfietspad
655,Ringfietspad Zurenborgbrug,2023-07-01,15:00:00,101,32,69,FMN 06 B Zurenborgbrug Ringfietspad
655,Ringfietspad Zurenborgbrug,2023-07-01,16:00:00,94,43,51,FMN 06 B Zurenborgbrug Ringfietspad
655,Ringfietspad Zurenborgbrug,2023-07-01,17:00:00,111,46,65,FMN 06 B Zurenborgbrug Ringfietspad
655,Ringfietspad Zurenborgbrug,2023-07-01,18:00:00,101,43,58,FMN 06 B Zurenborgbrug Ringfietspad
655,Ringfietspad Zurenborgbrug,2023-07-01,19:00:00,79,34,45,FMN 06 B Zurenborgbrug Ringfietspad
655,Ringfietspad Zurenborgbrug,2023-07-01,20:00:00,90,31,59,FMN 06 B Zurenborgbrug Ringfietspad
655,Ringfietspad Zurenborgbrug,2023-07-01,21:00:00,66,33,33,FMN 06 B Zurenborgbrug Ringfietspad
655,Ringfietspad Zurenborgbrug,2023-07-01,22:00:00,52,29,23,FMN 06 B Zurenborgbrug Ringfietspad
655,Ringfietspad Zurenborgbrug,2023-07-01,23:00:00,25,13,12,FMN 06 B Zurenborgbrug Ringfietspad
655,Ringfietspad Zurenborgbrug,2023-07-02,00:00:00,43,14,29,FMN 06 B Zurenborgbrug Ringfietspad
655,Ringfietspad Zurenborgbrug,2023-07-02,01:00:00,20,6,14,FMN 06 B Zurenborgbrug Ringfietspad
655,Ringfietspad Zurenborgbrug,2023-07-02,02:00:00,17,9,8,FMN 06 B Zurenborgbrug Ringfietspad
655,Ringfietspad Zurenborgbrug,2023-07-02,03:00:00,14,9,5,FMN 06 B Zurenborgbrug Ringfietspad
655,Ringfietspad Zurenborgbrug,2023-07-02,04:00:00,7,3,4,FMN 06 B Zurenborgbrug Ringfietspad
655,Ringfietspad Zurenborgbrug,2023-07-02,05:00:00,12,5,7,FMN 06 B Zurenborgbrug Ringfietspad
655,Ringfietspad Zurenborgbrug,2023-07-02,06:00:00,14,6,8,FMN 06 B Zurenborgbrug Ringfietspad
655,Ringfietspad Zurenborgbrug,2023-07-02,07:00:00,46,28,18,FMN 06 B Zurenborgbrug Ringfietspad
655,Ringfietspad Zurenborgbrug,2023-07-02,08:00:00,65,22,43,FMN 06 B Zurenborgbrug Ringfietspad
655,Ringfietspad Zurenborgbrug,2023-07-02,09:00:00,132,51,81,FMN 06 B Zurenborgbrug Ringfietspad
655,Ringfietspad Zurenborgbrug,2023-07-02,10:00:00,137,61,76,FMN 06 B Zurenborgbrug Ringfietspad
655,Ringfietspad Zurenborgbrug,2023-07-02,11:00:00,142,59,83,FMN 06 B Zurenborgbrug Ringfietspad
655,Ringfietspad Zurenborgbrug,2023-07-02,12:00:00,169,81,88,FMN 06 B Zurenborgbrug Ringfietspad
655,Ringfietspad Zurenborgbrug,2023-07-02,13:00:00,185,75,110,FMN 06 B Zurenborgbrug Ringfietspad
655,Ringfietspad Zurenborgbrug,2023-07-02,14:00:00,214,84,130,FMN 06 B Zurenborgbrug Ringfietspad
655,Ringfietspad Zurenborgbrug,2023-07-02,15:00:00,259,85,174,FMN 06 B Zurenborgbrug Ringfietspad
655,Ringfietspad Zurenborgbrug,2023-07-02,16:00:00,192,86,106,FMN 06 B Zurenborgbrug Ringfietspad
655,Ringfietspad Zurenborgbrug,2023-07-02,17:00:00,225,128,97,FMN 06 B Zurenborgbrug Ringfietspad
655,Ringfietspad Zurenborgbrug,2023-07-02,18:00:00,162,85,77,FMN 06 B Zurenborgbrug Ringfietspad
655,Ringfietspad Zurenborgbrug,2023-07-02,19:00:00,139,66,73,FMN 06 B Zurenborgbrug Ringfietspad
655,Ringfietspad Zurenborgbrug,2023-07-02,20:00:00,116,58,58,FMN 06 B Zurenborgbrug Ringfietspad
655,Ringfietspad Zurenborgbrug,2023-07-02,21:00:00,85,42,43,FMN 06 B Zurenborgbrug Ringfietspad
655,Ringfietspad Zurenborgbrug,2023-07-02,22:00:00,56,27,29,FMN 06 B Zurenborgbrug Ringfietspad
655,Ringfietspad Zurenborgbrug,2023-07-02,23:00:00,26,13,13,FMN 06 B Zurenborgbrug Ringfietspad
655,Ringfietspad Zurenborgbrug,2023-07-03,00:00:00,25,13,12,FMN 06 B Zurenborgbrug Ringfietspad
655,Ringfietspad Zurenborgbrug,2023-07-03,01:00:00,8,0,8,FMN 06 B Zurenborgbrug Ringfietspad
655,Ringfietspad Zurenborgbrug,2023-07-03,02:00:00,6,1,5,FMN 06 B Zurenborgbrug Ringfietspad
655,Ringfietspad Zurenborgbrug,2023-07-03,03:00:00,5,2,3,FMN 06 B Zurenborgbrug Ringfietspad
655,Ringfietspad Zurenborgbrug,2023-07-03,04:00:00,15,9,6,FMN 06 B Zurenborgbrug Ringfietspad
655,Ringfietspad Zurenborgbrug,2023-07-03,05:00:00,57,35,22,FMN 06 B Zurenborgbrug Ringfietspad
655,Ringfietspad Zurenborgbrug,2023-07-03,06:00:00,159,95,64,FMN 06 B Zurenborgbrug Ringfietspad
655,Ringfietspad Zurenborgbrug,2023-07-03,07:00:00,348,208,140,FMN 06 B Zurenborgbrug Ringfietspad
655,Ringfietspad Zurenborgbrug,2023-07-03,08:00:00,516,290,226,FMN 06 B Zurenborgbrug Ringfietspad
655,Ringfietspad Zurenborgbrug,2023-07-03,09:00:00,211,127,84,FMN 06 B Zurenborgbrug Ringfietspad
655,Ringfietspad Zurenborgbrug,2023-07-03,10:00:00,127,62,65,FMN 06 B Zurenborgbrug Ringfietspad
655,Ringfietspad Zurenborgbrug,2023-07-03,11:00:00,148,90,58,FMN 06 B Zurenborgbrug Ringfietspad
655,Ringfietspad Zurenborgbrug,2023-07-03,12:00:00,179,81,98,FMN 06 B Zurenborgbrug Ringfietspad
655,Ringfietspad Zurenborgbrug,2023-07-03,13:00:00,186,90,96,FMN 06 B Zurenborgbrug Ringfietspad
655,Ringfietspad Zurenborgbrug,2023-07-03,14:00:00,185,79,106,FMN 06 B Zurenborgbrug Ringfietspad
655,Ringfietspad Zurenborgbrug,2023-07-03,15:00:00,258,84,174,FMN 06 B Zurenborgbrug Ringfietspad
655,Ringfietspad Zurenborgbrug,2023-07-03,16:00:00,446,159,287,FMN 06 B Zurenborgbrug Ringfietspad
655,Ringfietspad Zurenborgbrug,2023-07-03,17:00:00,525,198,327,FMN 06 B Zurenborgbrug Ringfietspad
655,Ringfietspad Zurenborgbrug,2023-07-03,18:00:00,297,123,174,FMN 06 B Zurenborgbrug Ringfietspad
655,Ringfietspad Zurenborgbrug,2023-07-03,19:00:00,137,65,72,FMN 06 B Zurenborgbrug Ringfietspad
655,Ringfietspad Zurenborgbrug,2023-07-03,20:00:00,96,44,52,FMN 06 B Zurenborgbrug Ringfietspad
655,Ringfietspad Zurenborgbrug,2023-07-03,21:00:00,96,37,59,FMN 06 B Zurenborgbrug Ringfietspad
655,Ringfietspad Zurenborgbrug,2023-07-03,22:00:00,93,40,53,FMN 06 B Zurenborgbrug Ringfietspad
655,Ringfietspad Zurenborgbrug,2023-07-03,23:00:00,43,16,27,FMN 06 B Zurenborgbrug Ringfietspad
655,Ringfietspad Zurenborgbrug,2023-07-04,00:00:00,18,4,14,FMN 06 B Zurenborgbrug Ringfietspad
655,Ringfietspad Zurenborgbrug,2023-07-04,01:00:00,9,2,7,FMN 06 B Zurenborgbrug Ringfietspad
655,Ringfietspad Zurenborgbrug,2023-07-04,02:00:00,3,1,2,FMN 06 B Zurenborgbrug Ringfietspad
655,Ringfietspad Zurenborgbrug,2023-07-04,03:00:00,3,1,2,FMN 06 B Zurenborgbrug Ringfietspad
655,Ringfietspad Zurenborgbrug,2023-07-04,04:00:00,13,9,4,FMN 06 B Zurenborgbrug Ringfietspad
655,Ringfietspad Zurenborgbrug,2023-07-04,05:00:00,53,35,18,FMN 06 B Zurenborgbrug Ringfietspad
655,Ringfietspad Zurenborgbrug,2023-07-04,06:00:00,161,85,76,FMN 06 B Zurenborgbrug Ringfietspad
655,Ringfietspad Zurenborgbrug,2023-07-04,07:00:00,392,245,147,FMN 06 B Zurenborgbrug Ringfietspad
655,Ringfietspad Zurenborgbrug,2023-07-04,08:00:00,549,323,226,FMN 06 B Zurenborgbrug Ringfietspad
655,Ringfietspad Zurenborgbrug,2023-07-04,09:00:00,219,127,92,FMN 06 B Zurenborgbrug Ringfietspad
655,Ringfietspad Zurenborgbrug,2023-07-04,10:00:00,127,65,62,FMN 06 B Zurenborgbrug Ringfietspad
655,Ringfietspad Zurenborgbrug,2023-07-04,11:00:00,118,56,62,FMN 06 B Zurenborgbrug Ringfietspad
655,Ringfietspad Zurenborgbrug,2023-07-04,12:00:00,169,85,84,FMN 06 B Zurenborgbrug Ringfietspad
655,Ringfietspad Zurenborgbrug,2023-07-04,13:00:00,195,96,99,FMN 06 B Zurenborgbrug Ringfietspad
655,Ringfietspad Zurenborgbrug,2023-07-04,14:00:00,157,64,93,FMN 06 B Zurenborgbrug Ringfietspad
655,Ringfietspad Zurenborgbrug,2023-07-04,15:00:00,283,104,179,FMN 06 B Zurenborgbrug Ringfietspad
655,Ringfietspad Zurenborgbrug,2023-07-04,16:00:00,439,181,258,FMN 06 B Zurenborgbrug Ringfietspad
655,Ringfietspad Zurenborgbrug,2023-07-04,17:00:00,532,181,351,FMN 06 B Zurenborgbrug Ringfietspad
655,Ringfietspad Zurenborgbrug,2023-07-04,18:00:00,319,117,202,FMN 06 B Zurenborgbrug Ringfietspad
655,Ringfietspad Zurenborgbrug,2023-07-04,19:00:00,185,62,123,FMN 06 B Zurenborgbrug Ringfietspad
655,Ringfietspad Zurenborgbrug,2023-07-04,20:00:00,121,61,60,FMN 06 B Zurenborgbrug Ringfietspad
655,Ringfietspad Zurenborgbrug,2023-07-04,21:00:00,75,29,46,FMN 06 B Zurenborgbrug Ringfietspad
655,Ringfietspad Zurenborgbrug,2023-07-04,22:00:00,81,33,48,FMN 06 B Zurenborgbrug Ringfietspad
655,Ringfietspad Zurenborgbrug,2023-07-04,23:00:00,60,38,22,FMN 06 B Zurenborgbrug Ringfietspad
655,Ringfietspad Zurenborgbrug,2023-07-05,00:00:00,5,2,3,FMN 06 B Zurenborgbrug Ringfietspad
655,Ringfietspad Zurenborgbrug,2023-07-05,01:00:00,7,6,1,FMN 06 B Zurenborgbrug Ringfietspad
655,Ringfietspad Zurenborgbrug,2023-07-05,02:00:00,5,2,3,FMN 06 B Zurenborgbrug Ringfietspad
655,Ringfietspad Zurenborgbrug,2023-07-05,03:00:00,5,4,1,FMN 06 B Zurenborgbrug Ringfietspad
655,Ringfietspad Zurenborgbrug,2023-07-05,04:00:00,12,5,7,FMN 06 B Zurenborgbrug Ringfietspad
655,Ringfietspad Zurenborgbrug,2023-07-05,05:00:00,49,30,19,FMN 06 B Zurenborgbrug Ringfietspad
655,Ringfietspad Zurenborgbrug,2023-07-05,06:00:00,105,49,56,FMN 06 B Zurenborgbrug Ringfietspad
655,Ringfietspad Zurenborgbrug,2023-07-05,07:00:00,232,141,91,FMN 06 B Zurenborgbrug Ringfietspad
655,Ringfietspad Zurenborgbrug,2023-07-05,08:00:00,342,189,153,FMN 06 B Zurenborgbrug Ringfietspad
655,Ringfietspad Zurenborgbrug,2023-07-05,09:00:00,154,98,56,FMN 06 B Zurenborgbrug Ringfietspad
655,Ringfietspad Zurenborgbrug,2023-07-05,10:00:00,70,35,35,FMN 06 B Zurenborgbrug Ringfietspad
655,Ringfietspad Zurenborgbrug,2023-07-05,11:00:00,86,42,44,FMN 06 B Zurenborgbrug Ringfietspad
655,Ringfietspad Zurenborgbrug,2023-07-05,12:00:00,155,87,68,FMN 06 B Zurenborgbrug Ringfietspad
655,Ringfietspad Zurenborgbrug,2023-07-05,13:00:00,144,69,75,FMN 06 B Zurenborgbrug Ringfietspad
655,Ringfietspad Zurenborgbrug,2023-07-05,14:00:00,110,56,54,FMN 06 B Zurenborgbrug Ringfietspad
655,Ringfietspad Zurenborgbrug,2023-07-05,15:00:00,184,50,134,FMN 06 B Zurenborgbrug Ringfietspad
655,Ringfietspad Zurenborgbrug,2023-07-05,16:00:00,335,135,200,FMN 06 B Zurenborgbrug Ringfietspad
655,Ringfietspad Zurenborgbrug,2023-07-05,17:00:00,372,165,207,FMN 06 B Zurenborgbrug Ringfietspad
655,Ringfietspad Zurenborgbrug,2023-07-05,18:00:00,211,100,111,FMN 06 B Zurenborgbrug Ringfietspad
655,Ringfietspad Zurenborgbrug,2023-07-05,19:00:00,123,57,66,FMN 06 B Zurenborgbrug Ringfietspad
655,Ringfietspad Zurenborgbrug,2023-07-05,20:00:00,83,31,52,FMN 06 B Zurenborgbrug Ringfietspad
655,Ringfietspad Zurenborgbrug,2023-07-05,21:00:00,79,32,47,FMN 06 B Zurenborgbrug Ringfietspad
655,Ringfietspad Zurenborgbrug,2023-07-05,22:00:00,68,24,44,FMN 06 B Zurenborgbrug Ringfietspad
655,Ringfietspad Zurenborgbrug,2023-07-05,23:00:00,28,15,13,FMN 06 B Zurenborgbrug Ringfietspad
655,Ringfietspad Zurenborgbrug,2023-07-06,00:00:00,17,5,12,FMN 06 B Zurenborgbrug Ringfietspad
655,Ringfietspad Zurenborgbrug,2023-07-06,01:00:00,6,0,6,FMN 06 B Zurenborgbrug Ringfietspad
655,Ringfietspad Zurenborgbrug,2023-07-06,02:00:00,4,2,2,FMN 06 B Zurenborgbrug Ringfietspad
655,Ringfietspad Zurenborgbrug,2023-07-06,03:00:00,4,3,1,FMN 06 B Zurenborgbrug Ringfietspad
655,Ringfietspad Zurenborgbrug,2023-07-06,04:00:00,18,12,6,FMN 06 B Zurenborgbrug Ringfietspad
655,Ringfietspad Zurenborgbrug,2023-07-06,05:00:00,56,27,29,FMN 06 B Zurenborgbrug Ringfietspad
655,Ringfietspad Zurenborgbrug,2023-07-06,06:00:00,157,87,70,FMN 06 B Zurenborgbrug Ringfietspad
655,Ringfietspad Zurenborgbrug,2023-07-06,07:00:00,348,219,129,FMN 06 B Zurenborgbrug Ringfietspad
655,Ringfietspad Zurenborgbrug,2023-07-06,08:00:00,510,297,213,FMN 06 B Zurenborgbrug Ringfietspad
655,Ringfietspad Zurenborgbrug,2023-07-06,09:00:00,199,115,84,FMN 06 B Zurenborgbrug Ringfietspad
655,Ringfietspad Zurenborgbrug,2023-07-06,10:00:00,136,65,71,FMN 06 B Zurenborgbrug Ringfietspad
655,Ringfietspad Zurenborgbrug,2023-07-06,11:00:00,152,87,65,FMN 06 B Zurenborgbrug Ringfietspad
655,Ringfietspad Zurenborgbrug,2023-07-06,12:00:00,165,81,84,FMN 06 B Zurenborgbrug Ringfietspad
655,Ringfietspad Zurenborgbrug,2023-07-06,13:00:00,204,98,106,FMN 06 B Zurenborgbrug Ringfietspad
655,Ringfietspad Zurenborgbrug,2023-07-06,14:00:00,214,93,121,FMN 06 B Zurenborgbrug Ringfietspad
655,Ringfietspad Zurenborgbrug,2023-07-06,15:00:00,244,96,148,FMN 06 B Zurenborgbrug Ringfietspad
655,Ringfietspad Zurenborgbrug,2023-07-06,16:00:00,466,202,264,FMN 06 B Zurenborgbrug Ringfietspad
655,Ringfietspad Zurenborgbrug,2023-07-06,17:00:00,504,176,328,FMN 06 B Zurenborgbrug Ringfietspad
655,Ringfietspad Zurenborgbrug,2023-07-06,18:00:00,360,141,219,FMN 06 B Zurenborgbrug Ringfietspad
655,Ringfietspad Zurenborgbrug,2023-07-06,19:00:00,214,72,142,FMN 06 B Zurenborgbrug Ringfietspad
655,Ringfietspad Zurenborgbrug,2023-07-06,20:00:00,134,49,85,FMN 06 B Zurenborgbrug Ringfietspad
655,Ringfietspad Zurenborgbrug,2023-07-06,21:00:00,123,60,63,FMN 06 B Zurenborgbrug Ringfietspad
655,Ringfietspad Zurenborgbrug,2023-07-06,22:00:00,85,33,52,FMN 06 B Zurenborgbrug Ringfietspad
655,Ringfietspad Zurenborgbrug,2023-07-06,23:00:00,111,75,36,FMN 06 B Zurenborgbrug Ringfietspad
655,Ringfietspad Zurenborgbrug,2023-07-07,00:00:00,35,20,15,FMN 06 B Zurenborgbrug Ringfietspad
655,Ringfietspad Zurenborgbrug,2023-07-07,01:00:00,12,3,9,FMN 06 B Zurenborgbrug Ringfietspad
655,Ringfietspad Zurenborgbrug,2023-07-07,02:00:00,6,3,3,FMN 06 B Zurenborgbrug Ringfietspad
655,Ringfietspad Zurenborgbrug,2023-07-07,03:00:00,2,2,0,FMN 06 B Zurenborgbrug Ringfietspad
655,Ringfietspad Zurenborgbrug,2023-07-07,04:00:00,20,9,11,FMN 06 B Zurenborgbrug Ringfietspad
655,Ringfietspad Zurenborgbrug,2023-07-07,05:00:00,54,34,20,FMN 06 B Zurenborgbrug Ringfietspad
655,Ringfietspad Zurenborgbrug,2023-07-07,06:00:00,144,76,68,FMN 06 B Zurenborgbrug Ringfietspad
655,Ringfietspad Zurenborgbrug,2023-07-07,07:00:00,260,143,117,FMN 06 B Zurenborgbrug Ringfietspad
655,Ringfietspad Zurenborgbrug,2023-07-07,08:00:00,360,198,162,FMN 06 B Zurenborgbrug Ringfietspad
655,Ringfietspad Zurenborgbrug,2023-07-07,09:00:00,210,119,91,FMN 06 B Zurenborgbrug Ringfietspad
655,Ringfietspad Zurenborgbrug,2023-07-07,10:00:00,171,94,77,FMN 06 B Zurenborgbrug Ringfietspad
655,Ringfietspad Zurenborgbrug,2023-07-07,11:00:00,165,77,88,FMN 06 B Zurenborgbrug Ringfietspad
655,Ringfietspad Zurenborgbrug,2023-07-07,12:00:00,210,105,105,FMN 06 B Zurenborgbrug Ringfietspad
655,Ringfietspad Zurenborgbrug,2023-07-07,13:00:00,232,99,133,FMN 06 B Zurenborgbrug Ringfietspad
655,Ringfietspad Zurenborgbrug,2023-07-07,14:00:00,212,93,119,FMN 06 B Zurenborgbrug Ringfietspad
655,Ringfietspad Zurenborgbrug,2023-07-07,15:00:00,322,151,171,FMN 06 B Zurenborgbrug Ringfietspad
655,Ringfietspad Zurenborgbrug,2023-07-07,16:00:00,414,178,236,FMN 06 B Zurenborgbrug Ringfietspad
655,Ringfietspad Zurenborgbrug,2023-07-07,17:00:00,460,189,271,FMN 06 B Zurenborgbrug Ringfietspad
655,Ringfietspad Zurenborgbrug,2023-07-07,18:00:00,358,108,250,FMN 06 B Zurenborgbrug Ringfietspad
655,Ringfietspad Zurenborgbrug,2023-07-07,19:00:00,301,83,218,FMN 06 B Zurenborgbrug Ringfietspad
655,Ringfietspad Zurenborgbrug,2023-07-07,20:00:00,166,59,107,FMN 06 B Zurenborgbrug Ringfietspad
655,Ringfietspad Zurenborgbrug,2023-07-07,21:00:00,116,37,79,FMN 06 B Zurenborgbrug Ringfietspad
655,Ringfietspad Zurenborgbrug,2023-07-07,22:00:00,103,50,53,FMN 06 B Zurenborgbrug Ringfietspad
655,Ringfietspad Zurenborgbrug,2023-07-07,23:00:00,135,93,42,FMN 06 B Zurenborgbrug Ringfietspad
655,Ringfietspad Zurenborgbrug,2023-07-08,00:00:00,60,42,18,FMN 06 B Zurenborgbrug Ringfietspad
655,Ringfietspad Zurenborgbrug,2023-07-08,01:00:00,41,18,23,FMN 06 B Zurenborgbrug Ringfietspad
655,Ringfietspad Zurenborgbrug,2023-07-08,02:00:00,13,6,7,FMN 06 B Zurenborgbrug Ringfietspad
655,Ringfietspad Zurenborgbrug,2023-07-08,03:00:00,10,5,5,FMN 06 B Zurenborgbrug Ringfietspad
655,Ringfietspad Zurenborgbrug,2023-07-08,04:00:00,12,9,3,FMN 06 B Zurenborgbrug Ringfietspad
655,Ringfietspad Zurenborgbrug,2023-07-08,05:00:00,21,11,10,FMN 06 B Zurenborgbrug Ringfietspad
655,Ringfietspad Zurenborgbrug,2023-07-08,06:00:00,41,24,17,FMN 06 B Zurenborgbrug Ringfietspad
655,Ringfietspad Zurenborgbrug,2023-07-08,07:00:00,37,22,15,FMN 06 B Zurenborgbrug Ringfietspad
655,Ringfietspad Zurenborgbrug,2023-07-08,08:00:00,84,46,38,FMN 06 B Zurenborgbrug Ringfietspad
655,Ringfietspad Zurenborgbrug,2023-07-08,09:00:00,121,55,66,FMN 06 B Zurenborgbrug Ringfietspad
655,Ringfietspad Zurenborgbrug,2023-07-08,10:00:00,166,83,83,FMN 06 B Zurenborgbrug Ringfietspad
655,Ringfietspad Zurenborgbrug,2023-07-08,11:00:00,167,89,78,FMN 06 B Zurenborgbrug Ringfietspad
655,Ringfietspad Zurenborgbrug,2023-07-08,12:00:00,144,67,77,FMN 06 B Zurenborgbrug Ringfietspad
655,Ringfietspad Zurenborgbrug,2023-07-08,13:00:00,128,60,68,FMN 06 B Zurenborgbrug Ringfietspad
655,Ringfietspad Zurenborgbrug,2023-07-08,14:00:00,146,51,95,FMN 06 B Zurenborgbrug Ringfietspad
655,Ringfietspad Zurenborgbrug,2023-07-08,15:00:00,186,83,103,FMN 06 B Zurenborgbrug Ringfietspad
655,Ringfietspad Zurenborgbrug,2023-07-08,16:00:00,182,76,106,FMN 06 B Zurenborgbrug Ringfietspad
655,Ringfietspad Zurenborgbrug,2023-07-08,17:00:00,87,46,41,FMN 06 B Zurenborgbrug Ringfietspad
655,Ringfietspad Zurenborgbrug,2023-07-08,18:00:00,169,57,112,FMN 06 B Zurenborgbrug Ringfietspad
655,Ringfietspad Zurenborgbrug,2023-07-08,19:00:00,145,60,85,FMN 06 B Zurenborgbrug Ringfietspad
655,Ringfietspad Zurenborgbrug,2023-07-08,20:00:00,103,50,53,FMN 06 B Zurenborgbrug Ringfietspad
655,Ringfietspad Zurenborgbrug,2023-07-08,21:00:00,94,48,46,FMN 06 B Zurenborgbrug Ringfietspad
655,Ringfietspad Zurenborgbrug,2023-07-08,22:00:00,93,49,44,FMN 06 B Zurenborgbrug Ringfietspad
655,Ringfietspad Zurenborgbrug,2023-07-08,23:00:00,68,32,36,FMN 06 B Zurenborgbrug Ringfietspad
655,Ringfietspad Zurenborgbrug,2023-07-09,00:00:00,52,34,18,FMN 06 B Zurenborgbrug Ringfietspad
655,Ringfietspad Zurenborgbrug,2023-07-09,01:00:00,18,4,14,FMN 06 B Zurenborgbrug Ringfietspad
655,Ringfietspad Zurenborgbrug,2023-07-09,02:00:00,17,13,4,FMN 06 B Zurenborgbrug Ringfietspad
655,Ringfietspad Zurenborgbrug,2023-07-09,03:00:00,3,1,2,FMN 06 B Zurenborgbrug Ringfietspad
655,Ringfietspad Zurenborgbrug,2023-07-09,04:00:00,9,8,1,FMN 06 B Zurenborgbrug Ringfietspad
655,Ringfietspad Zurenborgbrug,2023-07-09,05:00:00,8,2,6,FMN 06 B Zurenborgbrug Ringfietspad
655,Ringfietspad Zurenborgbrug,2023-07-09,06:00:00,28,17,11,FMN 06 B Zurenborgbrug Ringfietspad
655,Ringfietspad Zurenborgbrug,2023-07-09,07:00:00,51,27,24,FMN 06 B Zurenborgbrug Ringfietspad
655,Ringfietspad Zurenborgbrug,2023-07-09,08:00:00,70,29,41,FMN 06 B Zurenborgbrug Ringfietspad
655,Ringfietspad Zurenborgbrug,2023-07-09,09:00:00,158,59,99,FMN 06 B Zurenborgbrug Ringfietspad
655,Ringfietspad Zurenborgbrug,2023-07-09,10:00:00,183,82,101,FMN 06 B Zurenborgbrug Ringfietspad
655,Ringfietspad Zurenborgbrug,2023-07-09,11:00:00,170,88,82,FMN 06 B Zurenborgbrug Ringfietspad
655,Ringfietspad Zurenborgbrug,2023-07-09,12:00:00,199,83,116,FMN 06 B Zurenborgbrug Ringfietspad
655,Ringfietspad Zurenborgbrug,2023-07-09,13:00:00,165,76,89,FMN 06 B Zurenborgbrug Ringfietspad
655,Ringfietspad Zurenborgbrug,2023-07-09,14:00:00,155,85,70,FMN 06 B Zurenborgbrug Ringfietspad
655,Ringfietspad Zurenborgbrug,2023-07-09,15:00:00,50,28,22,FMN 06 B Zurenborgbrug Ringfietspad
655,Ringfietspad Zurenborgbrug,2023-07-09,16:00:00,81,51,30,FMN 06 B Zurenborgbrug Ringfietspad
655,Ringfietspad Zurenborgbrug,2023-07-09,17:00:00,91,52,39,FMN 06 B Zurenborgbrug Ringfietspad
655,Ringfietspad Zurenborgbrug,2023-07-09,18:00:00,87,41,46,FMN 06 B Zurenborgbrug Ringfietspad
655,Ringfietspad Zurenborgbrug,2023-07-09,19:00:00,103,48,55,FMN 06 B Zurenborgbrug Ringfietspad
655,Ringfietspad Zurenborgbrug,2023-07-09,20:00:00,80,38,42,FMN 06 B Zurenborgbrug Ringfietspad
655,Ringfietspad Zurenborgbrug,2023-07-09,21:00:00,68,30,38,FMN 06 B Zurenborgbrug Ringfietspad
655,Ringfietspad Zurenborgbrug,2023-07-09,22:00:00,41,19,22,FMN 06 B Zurenborgbrug Ringfietspad
655,Ringfietspad Zurenborgbrug,2023-07-09,23:00:00,20,5,15,FMN 06 B Zurenborgbrug Ringfietspad
655,Ringfietspad Zurenborgbrug,2023-07-10,00:00:00,12,8,4,FMN 06 B Zurenborgbrug Ringfietspad
655,Ringfietspad Zurenborgbrug,2023-07-10,01:00:00,6,5,1,FMN 06 B Zurenborgbrug Ringfietspad
655,Ringfietspad Zurenborgbrug,2023-07-10,02:00:00,8,5,3,FMN 06 B Zurenborgbrug Ringfietspad
655,Ringfietspad Zurenborgbrug,2023-07-10,03:00:00,2,1,1,FMN 06 B Zurenborgbrug Ringfietspad
655,Ringfietspad Zurenborgbrug,2023-07-10,04:00:00,24,12,12,FMN 06 B Zurenborgbrug Ringfietspad
655,Ringfietspad Zurenborgbrug,2023-07-10,05:00:00,68,44,24,FMN 06 B Zurenborgbrug Ringfietspad
655,Ringfietspad Zurenborgbrug,2023-07-10,06:00:00,143,73,70,FMN 06 B Zurenborgbrug Ringfietspad
655,Ringfietspad Zurenborgbrug,2023-07-10,07:00:00,321,197,124,FMN 06 B Zurenborgbrug Ringfietspad
655,Ringfietspad Zurenborgbrug,2023-07-10,08:00:00,363,200,163,FMN 06 B Zurenborgbrug Ringfietspad
655,Ringfietspad Zurenborgbrug,2023-07-10,09:00:00,146,87,59,FMN 06 B Zurenborgbrug Ringfietspad
655,Ringfietspad Zurenborgbrug,2023-07-10,10:00:00,126,58,68,FMN 06 B Zurenborgbrug Ringfietspad
655,Ringfietspad Zurenborgbrug,2023-07-10,11:00:00,125,60,65,FMN 06 B Zurenborgbrug Ringfietspad
655,Ringfietspad Zurenborgbrug,2023-07-10,12:00:00,149,70,79,FMN 06 B Zurenborgbrug Ringfietspad
655,Ringfietspad Zurenborgbrug,2023-07-10,13:00:00,175,75,100,FMN 06 B Zurenborgbrug Ringfietspad
655,Ringfietspad Zurenborgbrug,2023-07-10,14:00:00,199,105,94,FMN 06 B Zurenborgbrug Ringfietspad
655,Ringfietspad Zurenborgbrug,2023-07-10,15:00:00,256,99,157,FMN 06 B Zurenborgbrug Ringfietspad
655,Ringfietspad Zurenborgbrug,2023-07-10,16:00:00,396,172,224,FMN 06 B Zurenborgbrug Ringfietspad
655,Ringfietspad Zurenborgbrug,2023-07-10,17:00:00,483,172,311,FMN 06 B Zurenborgbrug Ringfietspad
655,Ringfietspad Zurenborgbrug,2023-07-10,18:00:00,288,119,169,FMN 06 B Zurenborgbrug Ringfietspad
655,Ringfietspad Zurenborgbrug,2023-07-10,19:00:00,242,91,151,FMN 06 B Zurenborgbrug Ringfietspad
655,Ringfietspad Zurenborgbrug,2023-07-10,20:00:00,129,49,80,FMN 06 B Zurenborgbrug Ringfietspad
655,Ringfietspad Zurenborgbrug,2023-07-10,21:00:00,119,55,64,FMN 06 B Zurenborgbrug Ringfietspad
655,Ringfietspad Zurenborgbrug,2023-07-10,22:00:00,138,76,62,FMN 06 B Zurenborgbrug Ringfietspad
655,Ringfietspad Zurenborgbrug,2023-07-10,23:00:00,90,60,30,FMN 06 B Zurenborgbrug Ringfietspad
655,Ringfietspad Zurenborgbrug,2023-07-11,00:00:00,31,19,12,FMN 06 B Zurenborgbrug Ringfietspad
655,Ringfietspad Zurenborgbrug,2023-07-11,01:00:00,10,5,5,FMN 06 B Zurenborgbrug Ringfietspad
655,Ringfietspad Zurenborgbrug,2023-07-11,02:00:00,4,3,1,FMN 06 B Zurenborgbrug Ringfietspad
655,Ringfietspad Zurenborgbrug,2023-07-11,03:00:00,7,4,3,FMN 06 B Zurenborgbrug Ringfietspad
655,Ringfietspad Zurenborgbrug,2023-07-11,04:00:00,22,9,13,FMN 06 B Zurenborgbrug Ringfietspad
655,Ringfietspad Zurenborgbrug,2023-07-11,05:00:00,64,40,24,FMN 06 B Zurenborgbrug Ringfietspad
655,Ringfietspad Zurenborgbrug,2023-07-11,06:00:00,141,76,65,FMN 06 B Zurenborgbrug Ringfietspad
655,Ringfietspad Zurenborgbrug,2023-07-11,07:00:00,356,216,140,FMN 06 B Zurenborgbrug Ringfietspad
655,Ringfietspad Zurenborgbrug,2023-07-11,08:00:00,393,232,161,FMN 06 B Zurenborgbrug Ringfietspad
655,Ringfietspad Zurenborgbrug,2023-07-11,09:00:00,180,105,75,FMN 06 B Zurenborgbrug Ringfietspad
655,Ringfietspad Zurenborgbrug,2023-07-11,10:00:00,162,75,87,FMN 06 B Zurenborgbrug Ringfietspad
655,Ringfietspad Zurenborgbrug,2023-07-11,11:00:00,133,72,61,FMN 06 B Zurenborgbrug Ringfietspad
655,Ringfietspad Zurenborgbrug,2023-07-11,12:00:00,164,73,91,FMN 06 B Zurenborgbrug Ringfietspad
655,Ringfietspad Zurenborgbrug,2023-07-11,13:00:00,180,89,91,FMN 06 B Zurenborgbrug Ringfietspad
655,Ringfietspad Zurenborgbrug,2023-07-11,14:00:00,200,88,112,FMN 06 B Zurenborgbrug Ringfietspad
655,Ringfietspad Zurenborgbrug,2023-07-11,15:00:00,252,106,146,FMN 06 B Zurenborgbrug Ringfietspad
655,Ringfietspad Zurenborgbrug,2023-07-11,16:00:00,398,160,238,FMN 06 B Zurenborgbrug Ringfietspad
655,Ringfietspad Zurenborgbrug,2023-07-11,17:00:00,474,201,273,FMN 06 B Zurenborgbrug Ringfietspad
655,Ringfietspad Zurenborgbrug,2023-07-11,18:00:00,298,134,164,FMN 06 B Zurenborgbrug Ringfietspad
655,Ringfietspad Zurenborgbrug,2023-07-11,19:00:00,154,56,98,FMN 06 B Zurenborgbrug Ringfietspad
655,Ringfietspad Zurenborgbrug,2023-07-11,20:00:00,122,55,67,FMN 06 B Zurenborgbrug Ringfietspad
655,Ringfietspad Zurenborgbrug,2023-07-11,21:00:00,125,49,76,FMN 06 B Zurenborgbrug Ringfietspad
655,Ringfietspad Zurenborgbrug,2023-07-11,22:00:00,83,27,56,FMN 06 B Zurenborgbrug Ringfietspad
655,Ringfietspad Zurenborgbrug,2023-07-11,23:00:00,42,28,14,FMN 06 B Zurenborgbrug Ringfietspad
655,Ringfietspad Zurenborgbrug,2023-07-12,00:00:00,14,7,7,FMN 06 B Zurenborgbrug Ringfietspad
655,Ringfietspad Zurenborgbrug,2023-07-12,01:00:00,9,4,5,FMN 06 B Zurenborgbrug Ringfietspad
655,Ringfietspad Zurenborgbrug,2023-07-12,02:00:00,6,5,1,FMN 06 B Zurenborgbrug Ringfietspad
655,Ringfietspad Zurenborgbrug,2023-07-12,03:00:00,2,2,0,FMN 06 B Zurenborgbrug Ringfietspad
655,Ringfietspad Zurenborgbrug,2023-07-12,04:00:00,22,10,12,FMN 06 B Zurenborgbrug Ringfietspad
655,Ringfietspad Zurenborgbrug,2023-07-12,05:00:00,68,46,22,FMN 06 B Zurenborgbrug Ringfietspad
655,Ringfietspad Zurenborgbrug,2023-07-12,06:00:00,159,81,78,FMN 06 B Zurenborgbrug Ringfietspad
655,Ringfietspad Zurenborgbrug,2023-07-12,07:00:00,294,188,106,FMN 06 B Zurenborgbrug Ringfietspad
655,Ringfietspad Zurenborgbrug,2023-07-12,08:00:00,420,246,174,FMN 06 B Zurenborgbrug Ringfietspad
655,Ringfietspad Zurenborgbrug,2023-07-12,09:00:00,186,100,86,FMN 06 B Zurenborgbrug Ringfietspad
655,Ringfietspad Zurenborgbrug,2023-07-12,10:00:00,118,62,56,FMN 06 B Zurenborgbrug Ringfietspad
655,Ringfietspad Zurenborgbrug,2023-07-12,11:00:00,156,85,71,FMN 06 B Zurenborgbrug Ringfietspad
655,Ringfietspad Zurenborgbrug,2023-07-12,12:00:00,147,67,80,FMN 06 B Zurenborgbrug Ringfietspad
655,Ringfietspad Zurenborgbrug,2023-07-12,13:00:00,202,84,118,FMN 06 B Zurenborgbrug Ringfietspad
655,Ringfietspad Zurenborgbrug,2023-07-12,14:00:00,211,93,118,FMN 06 B Zurenborgbrug Ringfietspad
655,Ringfietspad Zurenborgbrug,2023-07-12,15:00:00,237,112,125,FMN 06 B Zurenborgbrug Ringfietspad
655,Ringfietspad Zurenborgbrug,2023-07-12,16:00:00,394,153,241,FMN 06 B Zurenborgbrug Ringfietspad
655,Ringfietspad Zurenborgbrug,2023-07-12,17:00:00,462,161,301,FMN 06 B Zurenborgbrug Ringfietspad
655,Ringfietspad Zurenborgbrug,2023-07-12,18:00:00,285,115,170,FMN 06 B Zurenborgbrug Ringfietspad
655,Ringfietspad Zurenborgbrug,2023-07-12,19:00:00,160,74,86,FMN 06 B Zurenborgbrug Ringfietspad
655,Ringfietspad Zurenborgbrug,2023-07-12,20:00:00,141,62,79,FMN 06 B Zurenborgbrug Ringfietspad
655,Ringfietspad Zurenborgbrug,2023-07-12,21:00:00,98,44,54,FMN 06 B Zurenborgbrug Ringfietspad
655,Ringfietspad Zurenborgbrug,2023-07-12,22:00:00,73,31,42,FMN 06 B Zurenborgbrug Ringfietspad
655,Ringfietspad Zurenborgbrug,2023-07-12,23:00:00,49,23,26,FMN 06 B Zurenborgbrug Ringfietspad
655,Ringfietspad Zurenborgbrug,2023-07-13,00:00:00,23,11,12,FMN 06 B Zurenborgbrug Ringfietspad
655,Ringfietspad Zurenborgbrug,2023-07-13,01:00:00,9,3,6,FMN 06 B Zurenborgbrug Ringfietspad
655,Ringfietspad Zurenborgbrug,2023-07-13,02:00:00,2,0,2,FMN 06 B Zurenborgbrug Ringfietspad
655,Ringfietspad Zurenborgbrug,2023-07-13,03:00:00,3,1,2,FMN 06 B Zurenborgbrug Ringfietspad
655,Ringfietspad Zurenborgbrug,2023-07-13,04:00:00,20,13,7,FMN 06 B Zurenborgbrug Ringfietspad
655,Ringfietspad Zurenborgbrug,2023-07-13,05:00:00,53,30,23,FMN 06 B Zurenborgbrug Ringfietspad
655,Ringfietspad Zurenborgbrug,2023-07-13,06:00:00,134,73,61,FMN 06 B Zurenborgbrug Ringfietspad
655,Ringfietspad Zurenborgbrug,2023-07-13,07:00:00,318,196,122,FMN 06 B Zurenborgbrug Ringfietspad
655,Ringfietspad Zurenborgbrug,2023-07-13,08:00:00,462,263,199,FMN 06 B Zurenborgbrug Ringfietspad
655,Ringfietspad Zurenborgbrug,2023-07-13,09:00:00,179,107,72,FMN 06 B Zurenborgbrug Ringfietspad
655,Ringfietspad Zurenborgbrug,2023-07-13,10:00:00,134,77,57,FMN 06 B Zurenborgbrug Ringfietspad
655,Ringfietspad Zurenborgbrug,2023-07-13,11:00:00,137,77,60,FMN 06 B Zurenborgbrug Ringfietspad
655,Ringfietspad Zurenborgbrug,2023-07-13,12:00:00,131,58,73,FMN 06 B Zurenborgbrug Ringfietspad
655,Ringfietspad Zurenborgbrug,2023-07-13,13:00:00,155,64,91,FMN 06 B Zurenborgbrug Ringfietspad
655,Ringfietspad Zurenborgbrug,2023-07-13,14:00:00,124,56,68,FMN 06 B Zurenborgbrug Ringfietspad
655,Ringfietspad Zurenborgbrug,2023-07-13,15:00:00,193,64,129,FMN 06 B Zurenborgbrug Ringfietspad
655,Ringfietspad Zurenborgbrug,2023-07-13,16:00:00,390,173,217,FMN 06 B Zurenborgbrug Ringfietspad
655,Ringfietspad Zurenborgbrug,2023-07-13,17:00:00,434,163,271,FMN 06 B Zurenborgbrug Ringfietspad
655,Ringfietspad Zurenborgbrug,2023-07-13,18:00:00,302,106,196,FMN 06 B Zurenborgbrug Ringfietspad
655,Ringfietspad Zurenborgbrug,2023-07-13,19:00:00,281,86,195,FMN 06 B Zurenborgbrug Ringfietspad
655,Ringfietspad Zurenborgbrug,2023-07-13,20:00:00,160,48,112,FMN 06 B Zurenborgbrug Ringfietspad
655,Ringfietspad Zurenborgbrug,2023-07-13,21:00:00,101,39,62,FMN 06 B Zurenborgbrug Ringfietspad
655,Ringfietspad Zurenborgbrug,2023-07-13,22:00:00,118,64,54,FMN 06 B Zurenborgbrug Ringfietspad
655,Ringfietspad Zurenborgbrug,2023-07-13,23:00:00,131,110,21,FMN 06 B Zurenborgbrug Ringfietspad
655,Ringfietspad Zurenborgbrug,2023-07-14,00:00:00,48,33,15,FMN 06 B Zurenborgbrug Ringfietspad
655,Ringfietspad Zurenborgbrug,2023-07-14,01:00:00,7,4,3,FMN 06 B Zurenborgbrug Ringfietspad
655,Ringfietspad Zurenborgbrug,2023-07-14,02:00:00,12,11,1,FMN 06 B Zurenborgbrug Ringfietspad
655,Ringfietspad Zurenborgbrug,2023-07-14,03:00:00,7,5,2,FMN 06 B Zurenborgbrug Ringfietspad
655,Ringfietspad Zurenborgbrug,2023-07-14,04:00:00,15,14,1,FMN 06 B Zurenborgbrug Ringfietspad
655,Ringfietspad Zurenborgbrug,2023-07-14,05:00:00,54,34,20,FMN 06 B Zurenborgbrug Ringfietspad
655,Ringfietspad Zurenborgbrug,2023-07-14,06:00:00,117,65,52,FMN 06 B Zurenborgbrug Ringfietspad
655,Ringfietspad Zurenborgbrug,2023-07-14,07:00:00,248,158,90,FMN 06 B Zurenborgbrug Ringfietspad
655,Ringfietspad Zurenborgbrug,2023-07-14,08:00:00,326,168,158,FMN 06 B Zurenborgbrug Ringfietspad
655,Ringfietspad Zurenborgbrug,2023-07-14,09:00:00,159,98,61,FMN 06 B Zurenborgbrug Ringfietspad
655,Ringfietspad Zurenborgbrug,2023-07-14,10:00:00,133,67,66,FMN 06 B Zurenborgbrug Ringfietspad
655,Ringfietspad Zurenborgbrug,2023-07-14,11:00:00,133,68,65,FMN 06 B Zurenborgbrug Ringfietspad
655,Ringfietspad Zurenborgbrug,2023-07-14,12:00:00,170,64,106,FMN 06 B Zurenborgbrug Ringfietspad
655,Ringfietspad Zurenborgbrug,2023-07-14,13:00:00,201,95,106,FMN 06 B Zurenborgbrug Ringfietspad
655,Ringfietspad Zurenborgbrug,2023-07-14,14:00:00,199,96,103,FMN 06 B Zurenborgbrug Ringfietspad
655,Ringfietspad Zurenborgbrug,2023-07-14,15:00:00,309,143,166,FMN 06 B Zurenborgbrug Ringfietspad
655,Ringfietspad Zurenborgbrug,2023-07-14,16:00:00,341,158,183,FMN 06 B Zurenborgbrug Ringfietspad
655,Ringfietspad Zurenborgbrug,2023-07-14,17:00:00,335,128,207,FMN 06 B Zurenborgbrug Ringfietspad
655,Ringfietspad Zurenborgbrug,2023-07-14,18:00:00,268,94,174,FMN 06 B Zurenborgbrug Ringfietspad
655,Ringfietspad Zurenborgbrug,2023-07-14,19:00:00,188,64,124,FMN 06 B Zurenborgbrug Ringfietspad
655,Ringfietspad Zurenborgbrug,2023-07-14,20:00:00,117,49,68,FMN 06 B Zurenborgbrug Ringfietspad
655,Ringfietspad Zurenborgbrug,2023-07-14,21:00:00,101,49,52,FMN 06 B Zurenborgbrug Ringfietspad
655,Ringfietspad Zurenborgbrug,2023-07-14,22:00:00,109,71,38,FMN 06 B Zurenborgbrug Ringfietspad
655,Ringfietspad Zurenborgbrug,2023-07-14,23:00:00,65,33,32,FMN 06 B Zurenborgbrug Ringfietspad
655,Ringfietspad Zurenborgbrug,2023-07-15,00:00:00,33,14,19,FMN 06 B Zurenborgbrug Ringfietspad
655,Ringfietspad Zurenborgbrug,2023-07-15,01:00:00,25,12,13,FMN 06 B Zurenborgbrug Ringfietspad
655,Ringfietspad Zurenborgbrug,2023-07-15,02:00:00,16,6,10,FMN 06 B Zurenborgbrug Ringfietspad
655,Ringfietspad Zurenborgbrug,2023-07-15,03:00:00,10,6,4,FMN 06 B Zurenborgbrug Ringfietspad
655,Ringfietspad Zurenborgbrug,2023-07-15,04:00:00,13,9,4,FMN 06 B Zurenborgbrug Ringfietspad
655,Ringfietspad Zurenborgbrug,2023-07-15,05:00:00,14,6,8,FMN 06 B Zurenborgbrug Ringfietspad
655,Ringfietspad Zurenborgbrug,2023-07-15,06:00:00,26,17,9,FMN 06 B Zurenborgbrug Ringfietspad
655,Ringfietspad Zurenborgbrug,2023-07-15,07:00:00,45,28,17,FMN 06 B Zurenborgbrug Ringfietspad
655,Ringfietspad Zurenborgbrug,2023-07-15,08:00:00,63,30,33,FMN 06 B Zurenborgbrug Ringfietspad
655,Ringfietspad Zurenborgbrug,2023-07-15,09:00:00,105,53,52,FMN 06 B Zurenborgbrug Ringfietspad
655,Ringfietspad Zurenborgbrug,2023-07-15,10:00:00,128,68,60,FMN 06 B Zurenborgbrug Ringfietspad
655,Ringfietspad Zurenborgbrug,2023-07-15,11:00:00,134,64,70,FMN 06 B Zurenborgbrug Ringfietspad
655,Ringfietspad Zurenborgbrug,2023-07-15,12:00:00,142,70,72,FMN 06 B Zurenborgbrug Ringfietspad
655,Ringfietspad Zurenborgbrug,2023-07-15,13:00:00,158,75,83,FMN 06 B Zurenborgbrug Ringfietspad
655,Ringfietspad Zurenborgbrug,2023-07-15,14:00:00,158,78,80,FMN 06 B Zurenborgbrug Ringfietspad
655,Ringfietspad Zurenborgbrug,2023-07-15,15:00:00,147,62,85,FMN 06 B Zurenborgbrug Ringfietspad
655,Ringfietspad Zurenborgbrug,2023-07-15,16:00:00,160,63,97,FMN 06 B Zurenborgbrug Ringfietspad
655,Ringfietspad Zurenborgbrug,2023-07-15,17:00:00,139,62,77,FMN 06 B Zurenborgbrug Ringfietspad
655,Ringfietspad Zurenborgbrug,2023-07-15,18:00:00,164,61,103,FMN 06 B Zurenborgbrug Ringfietspad
655,Ringfietspad Zurenborgbrug,2023-07-15,19:00:00,127,47,80,FMN 06 B Zurenborgbrug Ringfietspad
655,Ringfietspad Zurenborgbrug,2023-07-15,20:00:00,105,41,64,FMN 06 B Zurenborgbrug Ringfietspad
655,Ringfietspad Zurenborgbrug,2023-07-15,21:00:00,62,30,32,FMN 06 B Zurenborgbrug Ringfietspad
655,Ringfietspad Zurenborgbrug,2023-07-15,22:00:00,39,16,23,FMN 06 B Zurenborgbrug Ringfietspad
655,Ringfietspad Zurenborgbrug,2023-07-15,23:00:00,66,38,28,FMN 06 B Zurenborgbrug Ringfietspad
655,Ringfietspad Zurenborgbrug,2023-07-16,00:00:00,86,68,18,FMN 06 B Zurenborgbrug Ringfietspad
655,Ringfietspad Zurenborgbrug,2023-07-16,01:00:00,21,13,8,FMN 06 B Zurenborgbrug Ringfietspad
655,Ringfietspad Zurenborgbrug,2023-07-16,02:00:00,18,4,14,FMN 06 B Zurenborgbrug Ringfietspad
655,Ringfietspad Zurenborgbrug,2023-07-16,03:00:00,10,4,6,FMN 06 B Zurenborgbrug Ringfietspad
655,Ringfietspad Zurenborgbrug,2023-07-16,04:00:00,30,4,26,FMN 06 B Zurenborgbrug Ringfietspad
655,Ringfietspad Zurenborgbrug,2023-07-16,05:00:00,4,1,3,FMN 06 B Zurenborgbrug Ringfietspad
655,Ringfietspad Zurenborgbrug,2023-07-16,06:00:00,22,20,2,FMN 06 B Zurenborgbrug Ringfietspad
655,Ringfietspad Zurenborgbrug,2023-07-16,07:00:00,49,31,18,FMN 06 B Zurenborgbrug Ringfietspad
655,Ringfietspad Zurenborgbrug,2023-07-16,08:00:00,45,18,27,FMN 06 B Zurenborgbrug Ringfietspad
655,Ringfietspad Zurenborgbrug,2023-07-16,09:00:00,86,25,61,FMN 06 B Zurenborgbrug Ringfietspad
655,Ringfietspad Zurenborgbrug,2023-07-16,10:00:00,147,68,79,FMN 06 B Zurenborgbrug Ringfietspad
655,Ringfietspad Zurenborgbrug,2023-07-16,11:00:00,160,69,91,FMN 06 B Zurenborgbrug Ringfietspad
655,Ringfietspad Zurenborgbrug,2023-07-16,12:00:00,135,83,52,FMN 06 B Zurenborgbrug Ringfietspad
655,Ringfietspad Zurenborgbrug,2023-07-16,13:00:00,157,74,83,FMN 06 B Zurenborgbrug Ringfietspad
655,Ringfietspad Zurenborgbrug,2023-07-16,14:00:00,189,91,98,FMN 06 B Zurenborgbrug Ringfietspad
655,Ringfietspad Zurenborgbrug,2023-07-16,15:00:00,155,65,90,FMN 06 B Zurenborgbrug Ringfietspad
655,Ringfietspad Zurenborgbrug,2023-07-16,16:00:00,129,55,74,FMN 06 B Zurenborgbrug Ringfietspad
655,Ringfietspad Zurenborgbrug,2023-07-16,17:00:00,123,55,68,FMN 06 B Zurenborgbrug Ringfietspad
655,Ringfietspad Zurenborgbrug,2023-07-16,18:00:00,120,73,47,FMN 06 B Zurenborgbrug Ringfietspad
655,Ringfietspad Zurenborgbrug,2023-07-16,19:00:00,75,36,39,FMN 06 B Zurenborgbrug Ringfietspad
655,Ringfietspad Zurenborgbrug,2023-07-16,20:00:00,81,39,42,FMN 06 B Zurenborgbrug Ringfietspad
655,Ringfietspad Zurenborgbrug,2023-07-16,21:00:00,56,21,35,FMN 06 B Zurenborgbrug Ringfietspad
655,Ringfietspad Zurenborgbrug,2023-07-16,22:00:00,49,17,32,FMN 06 B Zurenborgbrug Ringfietspad
655,Ringfietspad Zurenborgbrug,2023-07-16,23:00:00,22,7,15,FMN 06 B Zurenborgbrug Ringfietspad
655,Ringfietspad Zurenborgbrug,2023-07-17,00:00:00,14,7,7,FMN 06 B Zurenborgbrug Ringfietspad
655,Ringfietspad Zurenborgbrug,2023-07-17,01:00:00,6,3,3,FMN 06 B Zurenborgbrug Ringfietspad
655,Ringfietspad Zurenborgbrug,2023-07-17,02:00:00,3,2,1,FMN 06 B Zurenborgbrug Ringfietspad
655,Ringfietspad Zurenborgbrug,2023-07-17,03:00:00,5,1,4,FMN 06 B Zurenborgbrug Ringfietspad
655,Ringfietspad Zurenborgbrug,2023-07-17,04:00:00,12,7,5,FMN 06 B Zurenborgbrug Ringfietspad
655,Ringfietspad Zurenborgbrug,2023-07-17,05:00:00,65,41,24,FMN 06 B Zurenborgbrug Ringfietspad
655,Ringfietspad Zurenborgbrug,2023-07-17,06:00:00,129,75,54,FMN 06 B Zurenborgbrug Ringfietspad
655,Ringfietspad Zurenborgbrug,2023-07-17,07:00:00,266,173,93,FMN 06 B Zurenborgbrug Ringfietspad
655,Ringfietspad Zurenborgbrug,2023-07-17,08:00:00,375,216,159,FMN 06 B Zurenborgbrug Ringfietspad
655,Ringfietspad Zurenborgbrug,2023-07-17,09:00:00,151,77,74,FMN 06 B Zurenborgbrug Ringfietspad
655,Ringfietspad Zurenborgbrug,2023-07-17,10:00:00,145,59,86,FMN 06 B Zurenborgbrug Ringfietspad
655,Ringfietspad Zurenborgbrug,2023-07-17,11:00:00,119,51,68,FMN 06 B Zurenborgbrug Ringfietspad
655,Ringfietspad Zurenborgbrug,2023-07-17,12:00:00,111,61,50,FMN 06 B Zurenborgbrug Ringfietspad
655,Ringfietspad Zurenborgbrug,2023-07-17,13:00:00,130,66,64,FMN 06 B Zurenborgbrug Ringfietspad
655,Ringfietspad Zurenborgbrug,2023-07-17,14:00:00,143,72,71,FMN 06 B Zurenborgbrug Ringfietspad
655,Ringfietspad Zurenborgbrug,2023-07-17,15:00:00,179,64,115,FMN 06 B Zurenborgbrug Ringfietspad
655,Ringfietspad Zurenborgbrug,2023-07-17,16:00:00,297,129,168,FMN 06 B Zurenborgbrug Ringfietspad
655,Ringfietspad Zurenborgbrug,2023-07-17,17:00:00,420,169,251,FMN 06 B Zurenborgbrug Ringfietspad
655,Ringfietspad Zurenborgbrug,2023-07-17,18:00:00,240,98,142,FMN 06 B Zurenborgbrug Ringfietspad
655,Ringfietspad Zurenborgbrug,2023-07-17,19:00:00,154,60,94,FMN 06 B Zurenborgbrug Ringfietspad
655,Ringfietspad Zurenborgbrug,2023-07-17,20:00:00,113,47,66,FMN 06 B Zurenborgbrug Ringfietspad
655,Ringfietspad Zurenborgbrug,2023-07-17,21:00:00,73,36,37,FMN 06 B Zurenborgbrug Ringfietspad
655,Ringfietspad Zurenborgbrug,2023-07-17,22:00:00,80,32,48,FMN 06 B Zurenborgbrug Ringfietspad
655,Ringfietspad Zurenborgbrug,2023-07-17,23:00:00,44,20,24,FMN 06 B Zurenborgbrug Ringfietspad
655,Ringfietspad Zurenborgbrug,2023-07-18,00:00:00,19,5,14,FMN 06 B Zurenborgbrug Ringfietspad
655,Ringfietspad Zurenborgbrug,2023-07-18,01:00:00,6,3,3,FMN 06 B Zurenborgbrug Ringfietspad
655,Ringfietspad Zurenborgbrug,2023-07-18,02:00:00,5,2,3,FMN 06 B Zurenborgbrug Ringfietspad
655,Ringfietspad Zurenborgbrug,2023-07-18,03:00:00,8,2,6,FMN 06 B Zurenborgbrug Ringfietspad
655,Ringfietspad Zurenborgbrug,2023-07-18,04:00:00,19,4,15,FMN 06 B Zurenborgbrug Ringfietspad
655,Ringfietspad Zurenborgbrug,2023-07-18,05:00:00,58,39,19,FMN 06 B Zurenborgbrug Ringfietspad
655,Ringfietspad Zurenborgbrug,2023-07-18,06:00:00,151,77,74,FMN 06 B Zurenborgbrug Ringfietspad
655,Ringfietspad Zurenborgbrug,2023-07-18,07:00:00,314,185,129,FMN 06 B Zurenborgbrug Ringfietspad
655,Ringfietspad Zurenborgbrug,2023-07-18,08:00:00,401,258,143,FMN 06 B Zurenborgbrug Ringfietspad
655,Ringfietspad Zurenborgbrug,2023-07-18,09:00:00,181,108,73,FMN 06 B Zurenborgbrug Ringfietspad
655,Ringfietspad Zurenborgbrug,2023-07-18,10:00:00,125,61,64,FMN 06 B Zurenborgbrug Ringfietspad
655,Ringfietspad Zurenborgbrug,2023-07-18,11:00:00,158,74,84,FMN 06 B Zurenborgbrug Ringfietspad
655,Ringfietspad Zurenborgbrug,2023-07-18,12:00:00,201,111,90,FMN 06 B Zurenborgbrug Ringfietspad
655,Ringfietspad Zurenborgbrug,2023-07-18,13:00:00,246,120,126,FMN 06 B Zurenborgbrug Ringfietspad
655,Ringfietspad Zurenborgbrug,2023-07-18,14:00:00,252,113,139,FMN 06 B Zurenborgbrug Ringfietspad
655,Ringfietspad Zurenborgbrug,2023-07-18,15:00:00,342,124,218,FMN 06 B Zurenborgbrug Ringfietspad
655,Ringfietspad Zurenborgbrug,2023-07-18,16:00:00,422,176,246,FMN 06 B Zurenborgbrug Ringfietspad
655,Ringfietspad Zurenborgbrug,2023-07-18,17:00:00,504,169,335,FMN 06 B Zurenborgbrug Ringfietspad
655,Ringfietspad Zurenborgbrug,2023-07-18,18:00:00,287,126,161,FMN 06 B Zurenborgbrug Ringfietspad
655,Ringfietspad Zurenborgbrug,2023-07-18,19:00:00,208,94,114,FMN 06 B Zurenborgbrug Ringfietspad
655,Ringfietspad Zurenborgbrug,2023-07-18,20:00:00,133,62,71,FMN 06 B Zurenborgbrug Ringfietspad
655,Ringfietspad Zurenborgbrug,2023-07-18,21:00:00,119,52,67,FMN 06 B Zurenborgbrug Ringfietspad
655,Ringfietspad Zurenborgbrug,2023-07-18,22:00:00,106,42,64,FMN 06 B Zurenborgbrug Ringfietspad
655,Ringfietspad Zurenborgbrug,2023-07-18,23:00:00,39,13,26,FMN 06 B Zurenborgbrug Ringfietspad
655,Ringfietspad Zurenborgbrug,2023-07-19,00:00:00,14,4,10,FMN 06 B Zurenborgbrug Ringfietspad
655,Ringfietspad Zurenborgbrug,2023-07-19,01:00:00,5,2,3,FMN 06 B Zurenborgbrug Ringfietspad
655,Ringfietspad Zurenborgbrug,2023-07-19,02:00:00,4,1,3,FMN 06 B Zurenborgbrug Ringfietspad
655,Ringfietspad Zurenborgbrug,2023-07-19,03:00:00,1,1,0,FMN 06 B Zurenborgbrug Ringfietspad
655,Ringfietspad Zurenborgbrug,2023-07-19,04:00:00,22,10,12,FMN 06 B Zurenborgbrug Ringfietspad
655,Ringfietspad Zurenborgbrug,2023-07-19,05:00:00,53,33,20,FMN 06 B Zurenborgbrug Ringfietspad
655,Ringfietspad Zurenborgbrug,2023-07-19,06:00:00,142,71,71,FMN 06 B Zurenborgbrug Ringfietspad
655,Ringfietspad Zurenborgbrug,2023-07-19,07:00:00,288,175,113,FMN 06 B Zurenborgbrug Ringfietspad
655,Ringfietspad Zurenborgbrug,2023-07-19,08:00:00,391,242,149,FMN 06 B Zurenborgbrug Ringfietspad
655,Ringfietspad Zurenborgbrug,2023-07-19,09:00:00,178,104,74,FMN 06 B Zurenborgbrug Ringfietspad
655,Ringfietspad Zurenborgbrug,2023-07-19,10:00:00,127,62,65,FMN 06 B Zurenborgbrug Ringfietspad
655,Ringfietspad Zurenborgbrug,2023-07-19,11:00:00,134,67,67,FMN 06 B Zurenborgbrug Ringfietspad
655,Ringfietspad Zurenborgbrug,2023-07-19,12:00:00,154,81,73,FMN 06 B Zurenborgbrug Ringfietspad
655,Ringfietspad Zurenborgbrug,2023-07-19,13:00:00,156,67,89,FMN 06 B Zurenborgbrug Ringfietspad
655,Ringfietspad Zurenborgbrug,2023-07-19,14:00:00,156,66,90,FMN 06 B Zurenborgbrug Ringfietspad
655,Ringfietspad Zurenborgbrug,2023-07-19,15:00:00,225,87,138,FMN 06 B Zurenborgbrug Ringfietspad
655,Ringfietspad Zurenborgbrug,2023-07-19,16:00:00,315,134,181,FMN 06 B Zurenborgbrug Ringfietspad
655,Ringfietspad Zurenborgbrug,2023-07-19,17:00:00,329,129,200,FMN 06 B Zurenborgbrug Ringfietspad
655,Ringfietspad Zurenborgbrug,2023-07-19,18:00:00,236,89,147,FMN 06 B Zurenborgbrug Ringfietspad
655,Ringfietspad Zurenborgbrug,2023-07-19,19:00:00,135,54,81,FMN 06 B Zurenborgbrug Ringfietspad
655,Ringfietspad Zurenborgbrug,2023-07-19,20:00:00,128,60,68,FMN 06 B Zurenborgbrug Ringfietspad
655,Ringfietspad Zurenborgbrug,2023-07-19,21:00:00,89,35,54,FMN 06 B Zurenborgbrug Ringfietspad
655,Ringfietspad Zurenborgbrug,2023-07-19,22:00:00,79,30,49,FMN 06 B Zurenborgbrug Ringfietspad
655,Ringfietspad Zurenborgbrug,2023-07-19,23:00:00,38,15,23,FMN 06 B Zurenborgbrug Ringfietspad
655,Ringfietspad Zurenborgbrug,2023-07-20,00:00:00,19,5,14,FMN 06 B Zurenborgbrug Ringfietspad
655,Ringfietspad Zurenborgbrug,2023-07-20,01:00:00,7,1,6,FMN 06 B Zurenborgbrug Ringfietspad
655,Ringfietspad Zurenborgbrug,2023-07-20,02:00:00,2,1,1,FMN 06 B Zurenborgbrug Ringfietspad
655,Ringfietspad Zurenborgbrug,2023-07-20,03:00:00,2,1,1,FMN 06 B Zurenborgbrug Ringfietspad
655,Ringfietspad Zurenborgbrug,2023-07-20,04:00:00,11,5,6,FMN 06 B Zurenborgbrug Ringfietspad
655,Ringfietspad Zurenborgbrug,2023-07-20,05:00:00,46,30,16,FMN 06 B Zurenborgbrug Ringfietspad
655,Ringfietspad Zurenborgbrug,2023-07-20,06:00:00,138,70,68,FMN 06 B Zurenborgbrug Ringfietspad
655,Ringfietspad Zurenborgbrug,2023-07-20,07:00:00,218,141,77,FMN 06 B Zurenborgbrug Ringfietspad
655,Ringfietspad Zurenborgbrug,2023-07-20,08:00:00,329,205,124,FMN 06 B Zurenborgbrug Ringfietspad
655,Ringfietspad Zurenborgbrug,2023-07-20,09:00:00,110,65,45,FMN 06 B Zurenborgbrug Ringfietspad
655,Ringfietspad Zurenborgbrug,2023-07-20,10:00:00,137,75,62,FMN 06 B Zurenborgbrug Ringfietspad
655,Ringfietspad Zurenborgbrug,2023-07-20,11:00:00,148,66,82,FMN 06 B Zurenborgbrug Ringfietspad
655,Ringfietspad Zurenborgbrug,2023-07-20,12:00:00,164,70,94,FMN 06 B Zurenborgbrug Ringfietspad
655,Ringfietspad Zurenborgbrug,2023-07-20,13:00:00,173,84,89,FMN 06 B Zurenborgbrug Ringfietspad
655,Ringfietspad Zurenborgbrug,2023-07-20,14:00:00,155,68,87,FMN 06 B Zurenborgbrug Ringfietspad
655,Ringfietspad Zurenborgbrug,2023-07-20,15:00:00,206,82,124,FMN 06 B Zurenborgbrug Ringfietspad
655,Ringfietspad Zurenborgbrug,2023-07-20,16:00:00,335,139,196,FMN 06 B Zurenborgbrug Ringfietspad
655,Ringfietspad Zurenborgbrug,2023-07-20,17:00:00,360,143,217,FMN 06 B Zurenborgbrug Ringfietspad
655,Ringfietspad Zurenborgbrug,2023-07-20,18:00:00,207,77,130,FMN 06 B Zurenborgbrug Ringfietspad
655,Ringfietspad Zurenborgbrug,2023-07-20,19:00:00,148,58,90,FMN 06 B Zurenborgbrug Ringfietspad
655,Ringfietspad Zurenborgbrug,2023-07-20,20:00:00,107,37,70,FMN 06 B Zurenborgbrug Ringfietspad
655,Ringfietspad Zurenborgbrug,2023-07-20,21:00:00,94,41,53,FMN 06 B Zurenborgbrug Ringfietspad
655,Ringfietspad Zurenborgbrug,2023-07-20,22:00:00,82,39,43,FMN 06 B Zurenborgbrug Ringfietspad
655,Ringfietspad Zurenborgbrug,2023-07-20,23:00:00,49,21,28,FMN 06 B Zurenborgbrug Ringfietspad
655,Ringfietspad Zurenborgbrug,2023-07-21,00:00:00,30,13,17,FMN 06 B Zurenborgbrug Ringfietspad
655,Ringfietspad Zurenborgbrug,2023-07-21,01:00:00,19,6,13,FMN 06 B Zurenborgbrug Ringfietspad
655,Ringfietspad Zurenborgbrug,2023-07-21,02:00:00,7,2,5,FMN 06 B Zurenborgbrug Ringfietspad
655,Ringfietspad Zurenborgbrug,2023-07-21,03:00:00,10,6,4,FMN 06 B Zurenborgbrug Ringfietspad
655,Ringfietspad Zurenborgbrug,2023-07-21,04:00:00,7,5,2,FMN 06 B Zurenborgbrug Ringfietspad
655,Ringfietspad Zurenborgbrug,2023-07-21,05:00:00,15,8,7,FMN 06 B Zurenborgbrug Ringfietspad
655,Ringfietspad Zurenborgbrug,2023-07-21,06:00:00,22,16,6,FMN 06 B Zurenborgbrug Ringfietspad
655,Ringfietspad Zurenborgbrug,2023-07-21,07:00:00,33,15,18,FMN 06 B Zurenborgbrug Ringfietspad
655,Ringfietspad Zurenborgbrug,2023-07-21,08:00:00,58,28,30,FMN 06 B Zurenborgbrug Ringfietspad
655,Ringfietspad Zurenborgbrug,2023-07-21,09:00:00,109,52,57,FMN 06 B Zurenborgbrug Ringfietspad
655,Ringfietspad Zurenborgbrug,2023-07-21,10:00:00,153,45,108,FMN 06 B Zurenborgbrug Ringfietspad
655,Ringfietspad Zurenborgbrug,2023-07-21,11:00:00,142,70,72,FMN 06 B Zurenborgbrug Ringfietspad
655,Ringfietspad Zurenborgbrug,2023-07-21,12:00:00,77,31,46,FMN 06 B Zurenborgbrug Ringfietspad
655,Ringfietspad Zurenborgbrug,2023-07-21,13:00:00,105,49,56,FMN 06 B Zurenborgbrug Ringfietspad
655,Ringfietspad Zurenborgbrug,2023-07-21,14:00:00,118,52,66,FMN 06 B Zurenborgbrug Ringfietspad
655,Ringfietspad Zurenborgbrug,2023-07-21,15:00:00,128,54,74,FMN 06 B Zurenborgbrug Ringfietspad
655,Ringfietspad Zurenborgbrug,2023-07-21,16:00:00,139,67,72,FMN 06 B Zurenborgbrug Ringfietspad
655,Ringfietspad Zurenborgbrug,2023-07-21,17:00:00,140,60,80,FMN 06 B Zurenborgbrug Ringfietspad
655,Ringfietspad Zurenborgbrug,2023-07-21,18:00:00,130,47,83,FMN 06 B Zurenborgbrug Ringfietspad
655,Ringfietspad Zurenborgbrug,2023-07-21,19:00:00,130,48,82,FMN 06 B Zurenborgbrug Ringfietspad
655,Ringfietspad Zurenborgbrug,2023-07-21,20:00:00,81,34,47,FMN 06 B Zurenborgbrug Ringfietspad
655,Ringfietspad Zurenborgbrug,2023-07-21,21:00:00,73,31,42,FMN 06 B Zurenborgbrug Ringfietspad
655,Ringfietspad Zurenborgbrug,2023-07-21,22:00:00,72,38,34,FMN 06 B Zurenborgbrug Ringfietspad
655,Ringfietspad Zurenborgbrug,2023-07-21,23:00:00,33,25,8,FMN 06 B Zurenborgbrug Ringfietspad
655,Ringfietspad Zurenborgbrug,2023-07-22,00:00:00,41,28,13,FMN 06 B Zurenborgbrug Ringfietspad
655,Ringfietspad Zurenborgbrug,2023-07-22,01:00:00,7,0,7,FMN 06 B Zurenborgbrug Ringfietspad
655,Ringfietspad Zurenborgbrug,2023-07-22,02:00:00,8,3,5,FMN 06 B Zurenborgbrug Ringfietspad
655,Ringfietspad Zurenborgbrug,2023-07-22,03:00:00,9,6,3,FMN 06 B Zurenborgbrug Ringfietspad
655,Ringfietspad Zurenborgbrug,2023-07-22,04:00:00,5,1,4,FMN 06 B Zurenborgbrug Ringfietspad
655,Ringfietspad Zurenborgbrug,2023-07-22,05:00:00,13,7,6,FMN 06 B Zurenborgbrug Ringfietspad
655,Ringfietspad Zurenborgbrug,2023-07-22,06:00:00,28,12,16,FMN 06 B Zurenborgbrug Ringfietspad
655,Ringfietspad Zurenborgbrug,2023-07-22,07:00:00,28,11,17,FMN 06 B Zurenborgbrug Ringfietspad
655,Ringfietspad Zurenborgbrug,2023-07-22,08:00:00,63,34,29,FMN 06 B Zurenborgbrug Ringfietspad
655,Ringfietspad Zurenborgbrug,2023-07-22,09:00:00,94,60,34,FMN 06 B Zurenborgbrug Ringfietspad
655,Ringfietspad Zurenborgbrug,2023-07-22,10:00:00,107,55,52,FMN 06 B Zurenborgbrug Ringfietspad
655,Ringfietspad Zurenborgbrug,2023-07-22,11:00:00,126,59,67,FMN 06 B Zurenborgbrug Ringfietspad
655,Ringfietspad Zurenborgbrug,2023-07-22,12:00:00,150,66,84,FMN 06 B Zurenborgbrug Ringfietspad
655,Ringfietspad Zurenborgbrug,2023-07-22,13:00:00,167,80,87,FMN 06 B Zurenborgbrug Ringfietspad
655,Ringfietspad Zurenborgbrug,2023-07-22,14:00:00,175,80,95,FMN 06 B Zurenborgbrug Ringfietspad
655,Ringfietspad Zurenborgbrug,2023-07-22,15:00:00,153,57,96,FMN 06 B Zurenborgbrug Ringfietspad
655,Ringfietspad Zurenborgbrug,2023-07-22,16:00:00,98,48,50,FMN 06 B Zurenborgbrug Ringfietspad
655,Ringfietspad Zurenborgbrug,2023-07-22,17:00:00,126,59,67,FMN 06 B Zurenborgbrug Ringfietspad
655,Ringfietspad Zurenborgbrug,2023-07-22,18:00:00,129,47,82,FMN 06 B Zurenborgbrug Ringfietspad
655,Ringfietspad Zurenborgbrug,2023-07-22,19:00:00,135,40,95,FMN 06 B Zurenborgbrug Ringfietspad
655,Ringfietspad Zurenborgbrug,2023-07-22,20:00:00,91,23,68,FMN 06 B Zurenborgbrug Ringfietspad
655,Ringfietspad Zurenborgbrug,2023-07-22,21:00:00,50,31,19,FMN 06 B Zurenborgbrug Ringfietspad
655,Ringfietspad Zurenborgbrug,2023-07-22,22:00:00,55,25,30,FMN 06 B Zurenborgbrug Ringfietspad
655,Ringfietspad Zurenborgbrug,2023-07-22,23:00:00,109,90,19,FMN 06 B Zurenborgbrug Ringfietspad
655,Ringfietspad Zurenborgbrug,2023-07-23,00:00:00,31,23,8,FMN 06 B Zurenborgbrug Ringfietspad
655,Ringfietspad Zurenborgbrug,2023-07-23,01:00:00,10,4,6,FMN 06 B Zurenborgbrug Ringfietspad
655,Ringfietspad Zurenborgbrug,2023-07-23,02:00:00,12,7,5,FMN 06 B Zurenborgbrug Ringfietspad
655,Ringfietspad Zurenborgbrug,2023-07-23,03:00:00,7,1,6,FMN 06 B Zurenborgbrug Ringfietspad
655,Ringfietspad Zurenborgbrug,2023-07-23,04:00:00,3,0,3,FMN 06 B Zurenborgbrug Ringfietspad
655,Ringfietspad Zurenborgbrug,2023-07-23,05:00:00,14,4,10,FMN 06 B Zurenborgbrug Ringfietspad
655,Ringfietspad Zurenborgbrug,2023-07-23,06:00:00,21,13,8,FMN 06 B Zurenborgbrug Ringfietspad
655,Ringfietspad Zurenborgbrug,2023-07-23,07:00:00,17,7,10,FMN 06 B Zurenborgbrug Ringfietspad
655,Ringfietspad Zurenborgbrug,2023-07-23,08:00:00,30,12,18,FMN 06 B Zurenborgbrug Ringfietspad
655,Ringfietspad Zurenborgbrug,2023-07-23,09:00:00,49,36,13,FMN 06 B Zurenborgbrug Ringfietspad
655,Ringfietspad Zurenborgbrug,2023-07-23,10:00:00,46,19,27,FMN 06 B Zurenborgbrug Ringfietspad
655,Ringfietspad Zurenborgbrug,2023-07-23,11:00:00,71,28,43,FMN 06 B Zurenborgbrug Ringfietspad
655,Ringfietspad Zurenborgbrug,2023-07-23,12:00:00,69,33,36,FMN 06 B Zurenborgbrug Ringfietspad
655,Ringfietspad Zurenborgbrug,2023-07-23,13:00:00,90,34,56,FMN 06 B Zurenborgbrug Ringfietspad
655,Ringfietspad Zurenborgbrug,2023-07-23,14:00:00,109,58,51,FMN 06 B Zurenborgbrug Ringfietspad
655,Ringfietspad Zurenborgbrug,2023-07-23,15:00:00,114,47,67,FMN 06 B Zurenborgbrug Ringfietspad
655,Ringfietspad Zurenborgbrug,2023-07-23,16:00:00,153,43,110,FMN 06 B Zurenborgbrug Ringfietspad
655,Ringfietspad Zurenborgbrug,2023-07-23,17:00:00,129,51,78,FMN 06 B Zurenborgbrug Ringfietspad
655,Ringfietspad Zurenborgbrug,2023-07-23,18:00:00,90,37,53,FMN 06 B Zurenborgbrug Ringfietspad
655,Ringfietspad Zurenborgbrug,2023-07-23,19:00:00,49,27,22,FMN 06 B Zurenborgbrug Ringfietspad
655,Ringfietspad Zurenborgbrug,2023-07-23,20:00:00,48,27,21,FMN 06 B Zurenborgbrug Ringfietspad
655,Ringfietspad Zurenborgbrug,2023-07-23,21:00:00,92,65,27,FMN 06 B Zurenborgbrug Ringfietspad
655,Ringfietspad Zurenborgbrug,2023-07-23,22:00:00,48,27,21,FMN 06 B Zurenborgbrug Ringfietspad
655,Ringfietspad Zurenborgbrug,2023-07-23,23:00:00,38,27,11,FMN 06 B Zurenborgbrug Ringfietspad
655,Ringfietspad Zurenborgbrug,2023-07-24,00:00:00,5,1,4,FMN 06 B Zurenborgbrug Ringfietspad
655,Ringfietspad Zurenborgbrug,2023-07-24,01:00:00,7,5,2,FMN 06 B Zurenborgbrug Ringfietspad
655,Ringfietspad Zurenborgbrug,2023-07-24,02:00:00,4,2,2,FMN 06 B Zurenborgbrug Ringfietspad
655,Ringfietspad Zurenborgbrug,2023-07-24,03:00:00,4,3,1,FMN 06 B Zurenborgbrug Ringfietspad
655,Ringfietspad Zurenborgbrug,2023-07-24,04:00:00,17,11,6,FMN 06 B Zurenborgbrug Ringfietspad
655,Ringfietspad Zurenborgbrug,2023-07-24,05:00:00,37,23,14,FMN 06 B Zurenborgbrug Ringfietspad
655,Ringfietspad Zurenborgbrug,2023-07-24,06:00:00,86,48,38,FMN 06 B Zurenborgbrug Ringfietspad
655,Ringfietspad Zurenborgbrug,2023-07-24,07:00:00,182,112,70,FMN 06 B Zurenborgbrug Ringfietspad
655,Ringfietspad Zurenborgbrug,2023-07-24,08:00:00,269,161,108,FMN 06 B Zurenborgbrug Ringfietspad
655,Ringfietspad Zurenborgbrug,2023-07-24,09:00:00,87,48,39,FMN 06 B Zurenborgbrug Ringfietspad
655,Ringfietspad Zurenborgbrug,2023-07-24,10:00:00,68,34,34,FMN 06 B Zurenborgbrug Ringfietspad
655,Ringfietspad Zurenborgbrug,2023-07-24,11:00:00,81,47,34,FMN 06 B Zurenborgbrug Ringfietspad
655,Ringfietspad Zurenborgbrug,2023-07-24,12:00:00,94,42,52,FMN 06 B Zurenborgbrug Ringfietspad
655,Ringfietspad Zurenborgbrug,2023-07-24,13:00:00,91,37,54,FMN 06 B Zurenborgbrug Ringfietspad
655,Ringfietspad Zurenborgbrug,2023-07-24,14:00:00,107,40,67,FMN 06 B Zurenborgbrug Ringfietspad
655,Ringfietspad Zurenborgbrug,2023-07-24,15:00:00,124,50,74,FMN 06 B Zurenborgbrug Ringfietspad
655,Ringfietspad Zurenborgbrug,2023-07-24,16:00:00,229,96,133,FMN 06 B Zurenborgbrug Ringfietspad
655,Ringfietspad Zurenborgbrug,2023-07-24,17:00:00,258,92,166,FMN 06 B Zurenborgbrug Ringfietspad
655,Ringfietspad Zurenborgbrug,2023-07-24,18:00:00,190,80,110,FMN 06 B Zurenborgbrug Ringfietspad
655,Ringfietspad Zurenborgbrug,2023-07-24,19:00:00,86,38,48,FMN 06 B Zurenborgbrug Ringfietspad
655,Ringfietspad Zurenborgbrug,2023-07-24,20:00:00,69,29,40,FMN 06 B Zurenborgbrug Ringfietspad
655,Ringfietspad Zurenborgbrug,2023-07-24,21:00:00,58,22,36,FMN 06 B Zurenborgbrug Ringfietspad
655,Ringfietspad Zurenborgbrug,2023-07-24,22:00:00,44,23,21,FMN 06 B Zurenborgbrug Ringfietspad
655,Ringfietspad Zurenborgbrug,2023-07-24,23:00:00,24,5,19,FMN 06 B Zurenborgbrug Ringfietspad
655,Ringfietspad Zurenborgbrug,2023-07-25,00:00:00,12,8,4,FMN 06 B Zurenborgbrug Ringfietspad
655,Ringfietspad Zurenborgbrug,2023-07-25,01:00:00,9,3,6,FMN 06 B Zurenborgbrug Ringfietspad
655,Ringfietspad Zurenborgbrug,2023-07-25,02:00:00,2,1,1,FMN 06 B Zurenborgbrug Ringfietspad
655,Ringfietspad Zurenborgbrug,2023-07-25,03:00:00,4,2,2,FMN 06 B Zurenborgbrug Ringfietspad
655,Ringfietspad Zurenborgbrug,2023-07-25,04:00:00,16,10,6,FMN 06 B Zurenborgbrug Ringfietspad
655,Ringfietspad Zurenborgbrug,2023-07-25,05:00:00,55,33,22,FMN 06 B Zurenborgbrug Ringfietspad
655,Ringfietspad Zurenborgbrug,2023-07-25,06:00:00,117,60,57,FMN 06 B Zurenborgbrug Ringfietspad
655,Ringfietspad Zurenborgbrug,2023-07-25,07:00:00,241,149,92,FMN 06 B Zurenborgbrug Ringfietspad
655,Ringfietspad Zurenborgbrug,2023-07-25,08:00:00,302,183,119,FMN 06 B Zurenborgbrug Ringfietspad
655,Ringfietspad Zurenborgbrug,2023-07-25,09:00:00,132,73,59,FMN 06 B Zurenborgbrug Ringfietspad
655,Ringfietspad Zurenborgbrug,2023-07-25,10:00:00,84,45,39,FMN 06 B Zurenborgbrug Ringfietspad
655,Ringfietspad Zurenborgbrug,2023-07-25,11:00:00,115,65,50,FMN 06 B Zurenborgbrug Ringfietspad
655,Ringfietspad Zurenborgbrug,2023-07-25,12:00:00,130,63,67,FMN 06 B Zurenborgbrug Ringfietspad
655,Ringfietspad Zurenborgbrug,2023-07-25,13:00:00,155,79,76,FMN 06 B Zurenborgbrug Ringfietspad
655,Ringfietspad Zurenborgbrug,2023-07-25,14:00:00,160,66,94,FMN 06 B Zurenborgbrug Ringfietspad
655,Ringfietspad Zurenborgbrug,2023-07-25,15:00:00,248,95,153,FMN 06 B Zurenborgbrug Ringfietspad
655,Ringfietspad Zurenborgbrug,2023-07-25,16:00:00,348,129,219,FMN 06 B Zurenborgbrug Ringfietspad
655,Ringfietspad Zurenborgbrug,2023-07-25,17:00:00,385,146,239,FMN 06 B Zurenborgbrug Ringfietspad
655,Ringfietspad Zurenborgbrug,2023-07-25,18:00:00,297,114,183,FMN 06 B Zurenborgbrug Ringfietspad
655,Ringfietspad Zurenborgbrug,2023-07-25,19:00:00,219,66,153,FMN 06 B Zurenborgbrug Ringfietspad
655,Ringfietspad Zurenborgbrug,2023-07-25,20:00:00,133,40,93,FMN 06 B Zurenborgbrug Ringfietspad
655,Ringfietspad Zurenborgbrug,2023-07-25,21:00:00,88,33,55,FMN 06 B Zurenborgbrug Ringfietspad
655,Ringfietspad Zurenborgbrug,2023-07-25,22:00:00,76,32,44,FMN 06 B Zurenborgbrug Ringfietspad
655,Ringfietspad Zurenborgbrug,2023-07-25,23:00:00,84,62,22,FMN 06 B Zurenborgbrug Ringfietspad
655,Ringfietspad Zurenborgbrug,2023-07-26,00:00:00,46,39,7,FMN 06 B Zurenborgbrug Ringfietspad
655,Ringfietspad Zurenborgbrug,2023-07-26,01:00:00,5,2,3,FMN 06 B Zurenborgbrug Ringfietspad
655,Ringfietspad Zurenborgbrug,2023-07-26,02:00:00,7,4,3,FMN 06 B Zurenborgbrug Ringfietspad
655,Ringfietspad Zurenborgbrug,2023-07-26,03:00:00,7,4,3,FMN 06 B Zurenborgbrug Ringfietspad
655,Ringfietspad Zurenborgbrug,2023-07-26,04:00:00,15,11,4,FMN 06 B Zurenborgbrug Ringfietspad
655,Ringfietspad Zurenborgbrug,2023-07-26,05:00:00,43,25,18,FMN 06 B Zurenborgbrug Ringfietspad
655,Ringfietspad Zurenborgbrug,2023-07-26,06:00:00,149,83,66,FMN 06 B Zurenborgbrug Ringfietspad
655,Ringfietspad Zurenborgbrug,2023-07-26,07:00:00,281,159,122,FMN 06 B Zurenborgbrug Ringfietspad
655,Ringfietspad Zurenborgbrug,2023-07-26,08:00:00,294,152,142,FMN 06 B Zurenborgbrug Ringfietspad
655,Ringfietspad Zurenborgbrug,2023-07-26,09:00:00,166,97,69,FMN 06 B Zurenborgbrug Ringfietspad
655,Ringfietspad Zurenborgbrug,2023-07-26,10:00:00,109,54,55,FMN 06 B Zurenborgbrug Ringfietspad
655,Ringfietspad Zurenborgbrug,2023-07-26,11:00:00,122,62,60,FMN 06 B Zurenborgbrug Ringfietspad
655,Ringfietspad Zurenborgbrug,2023-07-26,12:00:00,178,85,93,FMN 06 B Zurenborgbrug Ringfietspad
655,Ringfietspad Zurenborgbrug,2023-07-26,13:00:00,175,93,82,FMN 06 B Zurenborgbrug Ringfietspad
655,Ringfietspad Zurenborgbrug,2023-07-26,14:00:00,175,76,99,FMN 06 B Zurenborgbrug Ringfietspad
655,Ringfietspad Zurenborgbrug,2023-07-26,15:00:00,241,87,154,FMN 06 B Zurenborgbrug Ringfietspad
655,Ringfietspad Zurenborgbrug,2023-07-26,16:00:00,348,159,189,FMN 06 B Zurenborgbrug Ringfietspad
655,Ringfietspad Zurenborgbrug,2023-07-26,17:00:00,408,174,234,FMN 06 B Zurenborgbrug Ringfietspad
655,Ringfietspad Zurenborgbrug,2023-07-26,18:00:00,310,120,190,FMN 06 B Zurenborgbrug Ringfietspad
655,Ringfietspad Zurenborgbrug,2023-07-26,19:00:00,236,71,165,FMN 06 B Zurenborgbrug Ringfietspad
655,Ringfietspad Zurenborgbrug,2023-07-26,20:00:00,159,42,117,FMN 06 B Zurenborgbrug Ringfietspad
655,Ringfietspad Zurenborgbrug,2023-07-26,21:00:00,89,46,43,FMN 06 B Zurenborgbrug Ringfietspad
655,Ringfietspad Zurenborgbrug,2023-07-26,22:00:00,101,59,42,FMN 06 B Zurenborgbrug Ringfietspad
655,Ringfietspad Zurenborgbrug,2023-07-26,23:00:00,116,91,25,FMN 06 B Zurenborgbrug Ringfietspad
655,Ringfietspad Zurenborgbrug,2023-07-27,00:00:00,60,49,11,FMN 06 B Zurenborgbrug Ringfietspad
655,Ringfietspad Zurenborgbrug,2023-07-27,01:00:00,10,2,8,FMN 06 B Zurenborgbrug Ringfietspad
655,Ringfietspad Zurenborgbrug,2023-07-27,02:00:00,1,0,1,FMN 06 B Zurenborgbrug Ringfietspad
655,Ringfietspad Zurenborgbrug,2023-07-27,03:00:00,5,2,3,FMN 06 B Zurenborgbrug Ringfietspad
655,Ringfietspad Zurenborgbrug,2023-07-27,04:00:00,14,12,2,FMN 06 B Zurenborgbrug Ringfietspad
655,Ringfietspad Zurenborgbrug,2023-07-27,05:00:00,33,22,11,FMN 06 B Zurenborgbrug Ringfietspad
655,Ringfietspad Zurenborgbrug,2023-07-27,06:00:00,87,48,39,FMN 06 B Zurenborgbrug Ringfietspad
655,Ringfietspad Zurenborgbrug,2023-07-27,07:00:00,145,89,56,FMN 06 B Zurenborgbrug Ringfietspad
655,Ringfietspad Zurenborgbrug,2023-07-27,08:00:00,241,136,105,FMN 06 B Zurenborgbrug Ringfietspad
655,Ringfietspad Zurenborgbrug,2023-07-27,09:00:00,75,44,31,FMN 06 B Zurenborgbrug Ringfietspad
655,Ringfietspad Zurenborgbrug,2023-07-27,10:00:00,54,30,24,FMN 06 B Zurenborgbrug Ringfietspad
655,Ringfietspad Zurenborgbrug,2023-07-27,11:00:00,67,33,34,FMN 06 B Zurenborgbrug Ringfietspad
655,Ringfietspad Zurenborgbrug,2023-07-27,12:00:00,66,32,34,FMN 06 B Zurenborgbrug Ringfietspad
655,Ringfietspad Zurenborgbrug,2023-07-27,13:00:00,78,44,34,FMN 06 B Zurenborgbrug Ringfietspad
655,Ringfietspad Zurenborgbrug,2023-07-27,14:00:00,71,23,48,FMN 06 B Zurenborgbrug Ringfietspad
655,Ringfietspad Zurenborgbrug,2023-07-27,15:00:00,97,35,62,FMN 06 B Zurenborgbrug Ringfietspad
655,Ringfietspad Zurenborgbrug,2023-07-27,16:00:00,151,51,100,FMN 06 B Zurenborgbrug Ringfietspad
655,Ringfietspad Zurenborgbrug,2023-07-27,17:00:00,206,89,117,FMN 06 B Zurenborgbrug Ringfietspad
655,Ringfietspad Zurenborgbrug,2023-07-27,18:00:00,168,54,114,FMN 06 B Zurenborgbrug Ringfietspad
655,Ringfietspad Zurenborgbrug,2023-07-27,19:00:00,129,36,93,FMN 06 B Zurenborgbrug Ringfietspad
655,Ringfietspad Zurenborgbrug,2023-07-27,20:00:00,67,19,48,FMN 06 B Zurenborgbrug Ringfietspad
655,Ringfietspad Zurenborgbrug,2023-07-27,21:00:00,55,23,32,FMN 06 B Zurenborgbrug Ringfietspad
655,Ringfietspad Zurenborgbrug,2023-07-27,22:00:00,55,34,21,FMN 06 B Zurenborgbrug Ringfietspad
655,Ringfietspad Zurenborgbrug,2023-07-27,23:00:00,59,44,15,FMN 06 B Zurenborgbrug Ringfietspad
655,Ringfietspad Zurenborgbrug,2023-07-28,00:00:00,23,11,12,FMN 06 B Zurenborgbrug Ringfietspad
655,Ringfietspad Zurenborgbrug,2023-07-28,01:00:00,11,4,7,FMN 06 B Zurenborgbrug Ringfietspad
655,Ringfietspad Zurenborgbrug,2023-07-28,02:00:00,5,1,4,FMN 06 B Zurenborgbrug Ringfietspad
655,Ringfietspad Zurenborgbrug,2023-07-28,03:00:00,2,1,1,FMN 06 B Zurenborgbrug Ringfietspad
655,Ringfietspad Zurenborgbrug,2023-07-28,04:00:00,15,11,4,FMN 06 B Zurenborgbrug Ringfietspad
655,Ringfietspad Zurenborgbrug,2023-07-28,05:00:00,41,26,15,FMN 06 B Zurenborgbrug Ringfietspad
655,Ringfietspad Zurenborgbrug,2023-07-28,06:00:00,92,55,37,FMN 06 B Zurenborgbrug Ringfietspad
655,Ringfietspad Zurenborgbrug,2023-07-28,07:00:00,183,101,82,FMN 06 B Zurenborgbrug Ringfietspad
655,Ringfietspad Zurenborgbrug,2023-07-28,08:00:00,232,127,105,FMN 06 B Zurenborgbrug Ringfietspad
655,Ringfietspad Zurenborgbrug,2023-07-28,09:00:00,110,62,48,FMN 06 B Zurenborgbrug Ringfietspad
655,Ringfietspad Zurenborgbrug,2023-07-28,10:00:00,82,41,41,FMN 06 B Zurenborgbrug Ringfietspad
655,Ringfietspad Zurenborgbrug,2023-07-28,11:00:00,124,70,54,FMN 06 B Zurenborgbrug Ringfietspad
655,Ringfietspad Zurenborgbrug,2023-07-28,12:00:00,153,63,90,FMN 06 B Zurenborgbrug Ringfietspad
655,Ringfietspad Zurenborgbrug,2023-07-28,13:00:00,159,59,100,FMN 06 B Zurenborgbrug Ringfietspad
655,Ringfietspad Zurenborgbrug,2023-07-28,14:00:00,170,85,85,FMN 06 B Zurenborgbrug Ringfietspad
655,Ringfietspad Zurenborgbrug,2023-07-28,15:00:00,192,83,109,FMN 06 B Zurenborgbrug Ringfietspad
655,Ringfietspad Zurenborgbrug,2023-07-28,16:00:00,280,133,147,FMN 06 B Zurenborgbrug Ringfietspad
655,Ringfietspad Zurenborgbrug,2023-07-28,17:00:00,266,107,159,FMN 06 B Zurenborgbrug Ringfietspad
655,Ringfietspad Zurenborgbrug,2023-07-28,18:00:00,215,84,131,FMN 06 B Zurenborgbrug Ringfietspad
655,Ringfietspad Zurenborgbrug,2023-07-28,19:00:00,168,46,122,FMN 06 B Zurenborgbrug Ringfietspad
655,Ringfietspad Zurenborgbrug,2023-07-28,20:00:00,111,42,69,FMN 06 B Zurenborgbrug Ringfietspad
655,Ringfietspad Zurenborgbrug,2023-07-28,21:00:00,89,34,55,FMN 06 B Zurenborgbrug Ringfietspad
655,Ringfietspad Zurenborgbrug,2023-07-28,22:00:00,71,39,32,FMN 06 B Zurenborgbrug Ringfietspad
655,Ringfietspad Zurenborgbrug,2023-07-28,23:00:00,83,55,28,FMN 06 B Zurenborgbrug Ringfietspad
655,Ringfietspad Zurenborgbrug,2023-07-29,00:00:00,56,34,22,FMN 06 B Zurenborgbrug Ringfietspad
655,Ringfietspad Zurenborgbrug,2023-07-29,01:00:00,22,11,11,FMN 06 B Zurenborgbrug Ringfietspad
655,Ringfietspad Zurenborgbrug,2023-07-29,02:00:00,26,9,17,FMN 06 B Zurenborgbrug Ringfietspad
655,Ringfietspad Zurenborgbrug,2023-07-29,03:00:00,16,1,15,FMN 06 B Zurenborgbrug Ringfietspad
655,Ringfietspad Zurenborgbrug,2023-07-29,04:00:00,11,6,5,FMN 06 B Zurenborgbrug Ringfietspad
655,Ringfietspad Zurenborgbrug,2023-07-29,05:00:00,20,8,12,FMN 06 B Zurenborgbrug Ringfietspad
655,Ringfietspad Zurenborgbrug,2023-07-29,06:00:00,23,14,9,FMN 06 B Zurenborgbrug Ringfietspad
655,Ringfietspad Zurenborgbrug,2023-07-29,07:00:00,36,20,16,FMN 06 B Zurenborgbrug Ringfietspad
655,Ringfietspad Zurenborgbrug,2023-07-29,08:00:00,51,21,30,FMN 06 B Zurenborgbrug Ringfietspad
655,Ringfietspad Zurenborgbrug,2023-07-29,09:00:00,55,22,33,FMN 06 B Zurenborgbrug Ringfietspad
655,Ringfietspad Zurenborgbrug,2023-07-29,10:00:00,67,30,37,FMN 06 B Zurenborgbrug Ringfietspad
655,Ringfietspad Zurenborgbrug,2023-07-29,11:00:00,129,73,56,FMN 06 B Zurenborgbrug Ringfietspad
655,Ringfietspad Zurenborgbrug,2023-07-29,12:00:00,89,44,45,FMN 06 B Zurenborgbrug Ringfietspad
655,Ringfietspad Zurenborgbrug,2023-07-29,13:00:00,56,27,29,FMN 06 B Zurenborgbrug Ringfietspad
655,Ringfietspad Zurenborgbrug,2023-07-29,14:00:00,124,52,72,FMN 06 B Zurenborgbrug Ringfietspad
655,Ringfietspad Zurenborgbrug,2023-07-29,15:00:00,124,59,65,FMN 06 B Zurenborgbrug Ringfietspad
655,Ringfietspad Zurenborgbrug,2023-07-29,16:00:00,107,52,55,FMN 06 B Zurenborgbrug Ringfietspad
655,Ringfietspad Zurenborgbrug,2023-07-29,17:00:00,109,63,46,FMN 06 B Zurenborgbrug Ringfietspad
655,Ringfietspad Zurenborgbrug,2023-07-29,18:00:00,115,56,59,FMN 06 B Zurenborgbrug Ringfietspad
655,Ringfietspad Zurenborgbrug,2023-07-29,19:00:00,111,44,67,FMN 06 B Zurenborgbrug Ringfietspad
655,Ringfietspad Zurenborgbrug,2023-07-29,20:00:00,84,41,43,FMN 06 B Zurenborgbrug Ringfietspad
655,Ringfietspad Zurenborgbrug,2023-07-29,21:00:00,70,29,41,FMN 06 B Zurenborgbrug Ringfietspad
655,Ringfietspad Zurenborgbrug,2023-07-29,22:00:00,83,49,34,FMN 06 B Zurenborgbrug Ringfietspad
655,Ringfietspad Zurenborgbrug,2023-07-29,23:00:00,48,22,26,FMN 06 B Zurenborgbrug Ringfietspad
655,Ringfietspad Zurenborgbrug,2023-07-30,00:00:00,33,10,23,FMN 06 B Zurenborgbrug Ringfietspad
655,Ringfietspad Zurenborgbrug,2023-07-30,01:00:00,27,5,22,FMN 06 B Zurenborgbrug Ringfietspad
655,Ringfietspad Zurenborgbrug,2023-07-30,02:00:00,15,4,11,FMN 06 B Zurenborgbrug Ringfietspad
655,Ringfietspad Zurenborgbrug,2023-07-30,03:00:00,21,3,18,FMN 06 B Zurenborgbrug Ringfietspad
655,Ringfietspad Zurenborgbrug,2023-07-30,04:00:00,8,0,8,FMN 06 B Zurenborgbrug Ringfietspad
655,Ringfietspad Zurenborgbrug,2023-07-30,05:00:00,12,5,7,FMN 06 B Zurenborgbrug Ringfietspad
655,Ringfietspad Zurenborgbrug,2023-07-30,06:00:00,24,16,8,FMN 06 B Zurenborgbrug Ringfietspad
655,Ringfietspad Zurenborgbrug,2023-07-30,07:00:00,25,10,15,FMN 06 B Zurenborgbrug Ringfietspad
655,Ringfietspad Zurenborgbrug,2023-07-30,08:00:00,44,18,26,FMN 06 B Zurenborgbrug Ringfietspad
655,Ringfietspad Zurenborgbrug,2023-07-30,09:00:00,94,42,52,FMN 06 B Zurenborgbrug Ringfietspad
655,Ringfietspad Zurenborgbrug,2023-07-30,10:00:00,135,61,74,FMN 06 B Zurenborgbrug Ringfietspad
655,Ringfietspad Zurenborgbrug,2023-07-30,11:00:00,150,62,88,FMN 06 B Zurenborgbrug Ringfietspad
655,Ringfietspad Zurenborgbrug,2023-07-30,12:00:00,247,91,156,FMN 06 B Zurenborgbrug Ringfietspad
655,Ringfietspad Zurenborgbrug,2023-07-30,13:00:00,204,85,119,FMN 06 B Zurenborgbrug Ringfietspad
655,Ringfietspad Zurenborgbrug,2023-07-30,14:00:00,196,65,131,FMN 06 B Zurenborgbrug Ringfietspad
655,Ringfietspad Zurenborgbrug,2023-07-30,15:00:00,202,101,101,FMN 06 B Zurenborgbrug Ringfietspad
655,Ringfietspad Zurenborgbrug,2023-07-30,16:00:00,236,142,94,FMN 06 B Zurenborgbrug Ringfietspad
655,Ringfietspad Zurenborgbrug,2023-07-30,17:00:00,156,105,51,FMN 06 B Zurenborgbrug Ringfietspad
655,Ringfietspad Zurenborgbrug,2023-07-30,18:00:00,154,86,68,FMN 06 B Zurenborgbrug Ringfietspad
655,Ringfietspad Zurenborgbrug,2023-07-30,19:00:00,57,24,33,FMN 06 B Zurenborgbrug Ringfietspad
655,Ringfietspad Zurenborgbrug,2023-07-30,20:00:00,46,21,25,FMN 06 B Zurenborgbrug Ringfietspad
655,Ringfietspad Zurenborgbrug,2023-07-30,21:00:00,43,18,25,FMN 06 B Zurenborgbrug Ringfietspad
655,Ringfietspad Zurenborgbrug,2023-07-30,22:00:00,36,19,17,FMN 06 B Zurenborgbrug Ringfietspad
655,Ringfietspad Zurenborgbrug,2023-07-30,23:00:00,19,6,13,FMN 06 B Zurenborgbrug Ringfietspad
655,Ringfietspad Zurenborgbrug,2023-07-31,00:00:00,10,6,4,FMN 06 B Zurenborgbrug Ringfietspad
655,Ringfietspad Zurenborgbrug,2023-07-31,01:00:00,7,3,4,FMN 06 B Zurenborgbrug Ringfietspad
655,Ringfietspad Zurenborgbrug,2023-07-31,02:00:00,5,1,4,FMN 06 B Zurenborgbrug Ringfietspad
655,Ringfietspad Zurenborgbrug,2023-07-31,03:00:00,4,1,3,FMN 06 B Zurenborgbrug Ringfietspad
655,Ringfietspad Zurenborgbrug,2023-07-31,04:00:00,11,5,6,FMN 06 B Zurenborgbrug Ringfietspad
655,Ringfietspad Zurenborgbrug,2023-07-31,05:00:00,42,31,11,FMN 06 B Zurenborgbrug Ringfietspad
655,Ringfietspad Zurenborgbrug,2023-07-31,06:00:00,86,46,40,FMN 06 B Zurenborgbrug Ringfietspad
655,Ringfietspad Zurenborgbrug,2023-07-31,07:00:00,188,111,77,FMN 06 B Zurenborgbrug Ringfietspad
655,Ringfietspad Zurenborgbrug,2023-07-31,08:00:00,249,141,108,FMN 06 B Zurenborgbrug Ringfietspad
655,Ringfietspad Zurenborgbrug,2023-07-31,09:00:00,74,48,26,FMN 06 B Zurenborgbrug Ringfietspad
655,Ringfietspad Zurenborgbrug,2023-07-31,10:00:00,74,33,41,FMN 06 B Zurenborgbrug Ringfietspad
655,Ringfietspad Zurenborgbrug,2023-07-31,11:00:00,66,32,34,FMN 06 B Zurenborgbrug Ringfietspad
655,Ringfietspad Zurenborgbrug,2023-07-31,12:00:00,80,43,37,FMN 06 B Zurenborgbrug Ringfietspad
655,Ringfietspad Zurenborgbrug,2023-07-31,13:00:00,105,51,54,FMN 06 B Zurenborgbrug Ringfietspad
655,Ringfietspad Zurenborgbrug,2023-07-31,14:00:00,113,37,76,FMN 06 B Zurenborgbrug Ringfietspad
655,Ringfietspad Zurenborgbrug,2023-07-31,15:00:00,108,40,68,FMN 06 B Zurenborgbrug Ringfietspad
655,Ringfietspad Zurenborgbrug,2023-07-31,16:00:00,193,79,114,FMN 06 B Zurenborgbrug Ringfietspad
655,Ringfietspad Zurenborgbrug,2023-07-31,17:00:00,239,87,152,FMN 06 B Zurenborgbrug Ringfietspad
655,Ringfietspad Zurenborgbrug,2023-07-31,18:00:00,122,46,76,FMN 06 B Zurenborgbrug Ringfietspad
655,Ringfietspad Zurenborgbrug,2023-07-31,19:00:00,48,16,32,FMN 06 B Zurenborgbrug Ringfietspad
655,Ringfietspad Zurenborgbrug,2023-07-31,20:00:00,39,13,26,FMN 06 B Zurenborgbrug Ringfietspad
655,Ringfietspad Zurenborgbrug,2023-07-31,21:00:00,37,13,24,FMN 06 B Zurenborgbrug Ringfietspad
655,Ringfietspad Zurenborgbrug,2023-07-31,22:00:00,39,11,28,FMN 06 B Zurenborgbrug Ringfietspad
655,Ringfietspad Zurenborgbrug,2023-07-31,23:00:00,23,13,10,FMN 06 B Zurenborgbrug Ringfietspad
655,Ringfietspad Zurenborgbrug,2023-08-01,00:00:00,13,4,9,FMN 06 B Zurenborgbrug Ringfietspad
655,Ringfietspad Zurenborgbrug,2023-08-01,01:00:00,2,1,1,FMN 06 B Zurenborgbrug Ringfietspad
655,Ringfietspad Zurenborgbrug,2023-08-01,02:00:00,1,1,0,FMN 06 B Zurenborgbrug Ringfietspad
655,Ringfietspad Zurenborgbrug,2023-08-01,03:00:00,0,0,0,FMN 06 B Zurenborgbrug Ringfietspad
655,Ringfietspad Zurenborgbrug,2023-08-01,04:00:00,11,4,7,FMN 06 B Zurenborgbrug Ringfietspad
655,Ringfietspad Zurenborgbrug,2023-08-01,05:00:00,51,30,21,FMN 06 B Zurenborgbrug Ringfietspad
655,Ringfietspad Zurenborgbrug,2023-08-01,06:00:00,103,59,44,FMN 06 B Zurenborgbrug Ringfietspad
655,Ringfietspad Zurenborgbrug,2023-08-01,07:00:00,270,145,125,FMN 06 B Zurenborgbrug Ringfietspad
655,Ringfietspad Zurenborgbrug,2023-08-01,08:00:00,326,185,141,FMN 06 B Zurenborgbrug Ringfietspad
655,Ringfietspad Zurenborgbrug,2023-08-01,09:00:00,116,70,46,FMN 06 B Zurenborgbrug Ringfietspad
655,Ringfietspad Zurenborgbrug,2023-08-01,10:00:00,74,31,43,FMN 06 B Zurenborgbrug Ringfietspad
655,Ringfietspad Zurenborgbrug,2023-08-01,11:00:00,98,45,53,FMN 06 B Zurenborgbrug Ringfietspad
655,Ringfietspad Zurenborgbrug,2023-08-01,12:00:00,106,61,45,FMN 06 B Zurenborgbrug Ringfietspad
655,Ringfietspad Zurenborgbrug,2023-08-01,13:00:00,130,62,68,FMN 06 B Zurenborgbrug Ringfietspad
655,Ringfietspad Zurenborgbrug,2023-08-01,14:00:00,144,59,85,FMN 06 B Zurenborgbrug Ringfietspad
655,Ringfietspad Zurenborgbrug,2023-08-01,15:00:00,162,67,95,FMN 06 B Zurenborgbrug Ringfietspad
655,Ringfietspad Zurenborgbrug,2023-08-01,16:00:00,311,131,180,FMN 06 B Zurenborgbrug Ringfietspad
655,Ringfietspad Zurenborgbrug,2023-08-01,17:00:00,394,153,241,FMN 06 B Zurenborgbrug Ringfietspad
655,Ringfietspad Zurenborgbrug,2023-08-01,18:00:00,229,94,135,FMN 06 B Zurenborgbrug Ringfietspad
655,Ringfietspad Zurenborgbrug,2023-08-01,19:00:00,130,51,79,FMN 06 B Zurenborgbrug Ringfietspad
655,Ringfietspad Zurenborgbrug,2023-08-01,20:00:00,105,53,52,FMN 06 B Zurenborgbrug Ringfietspad
655,Ringfietspad Zurenborgbrug,2023-08-01,21:00:00,72,39,33,FMN 06 B Zurenborgbrug Ringfietspad
655,Ringfietspad Zurenborgbrug,2023-08-01,22:00:00,75,32,43,FMN 06 B Zurenborgbrug Ringfietspad
655,Ringfietspad Zurenborgbrug,2023-08-01,23:00:00,31,10,21,FMN 06 B Zurenborgbrug Ringfietspad
655,Ringfietspad Zurenborgbrug,2023-08-02,00:00:00,12,4,8,FMN 06 B Zurenborgbrug Ringfietspad
655,Ringfietspad Zurenborgbrug,2023-08-02,01:00:00,12,3,9,FMN 06 B Zurenborgbrug Ringfietspad
655,Ringfietspad Zurenborgbrug,2023-08-02,02:00:00,4,3,1,FMN 06 B Zurenborgbrug Ringfietspad
655,Ringfietspad Zurenborgbrug,2023-08-02,03:00:00,6,2,4,FMN 06 B Zurenborgbrug Ringfietspad
655,Ringfietspad Zurenborgbrug,2023-08-02,04:00:00,11,4,7,FMN 06 B Zurenborgbrug Ringfietspad
655,Ringfietspad Zurenborgbrug,2023-08-02,05:00:00,27,19,8,FMN 06 B Zurenborgbrug Ringfietspad
655,Ringfietspad Zurenborgbrug,2023-08-02,06:00:00,82,51,31,FMN 06 B Zurenborgbrug Ringfietspad
655,Ringfietspad Zurenborgbrug,2023-08-02,07:00:00,178,100,78,FMN 06 B Zurenborgbrug Ringfietspad
655,Ringfietspad Zurenborgbrug,2023-08-02,08:00:00,181,106,75,FMN 06 B Zurenborgbrug Ringfietspad
655,Ringfietspad Zurenborgbrug,2023-08-02,09:00:00,75,43,32,FMN 06 B Zurenborgbrug Ringfietspad
655,Ringfietspad Zurenborgbrug,2023-08-02,10:00:00,66,36,30,FMN 06 B Zurenborgbrug Ringfietspad
655,Ringfietspad Zurenborgbrug,2023-08-02,11:00:00,51,23,28,FMN 06 B Zurenborgbrug Ringfietspad
655,Ringfietspad Zurenborgbrug,2023-08-02,12:00:00,80,41,39,FMN 06 B Zurenborgbrug Ringfietspad
655,Ringfietspad Zurenborgbrug,2023-08-02,13:00:00,86,42,44,FMN 06 B Zurenborgbrug Ringfietspad
655,Ringfietspad Zurenborgbrug,2023-08-02,14:00:00,89,36,53,FMN 06 B Zurenborgbrug Ringfietspad
655,Ringfietspad Zurenborgbrug,2023-08-02,15:00:00,150,58,92,FMN 06 B Zurenborgbrug Ringfietspad
655,Ringfietspad Zurenborgbrug,2023-08-02,16:00:00,217,88,129,FMN 06 B Zurenborgbrug Ringfietspad
655,Ringfietspad Zurenborgbrug,2023-08-02,17:00:00,264,105,159,FMN 06 B Zurenborgbrug Ringfietspad
655,Ringfietspad Zurenborgbrug,2023-08-02,18:00:00,170,72,98,FMN 06 B Zurenborgbrug Ringfietspad
655,Ringfietspad Zurenborgbrug,2023-08-02,19:00:00,102,29,73,FMN 06 B Zurenborgbrug Ringfietspad
655,Ringfietspad Zurenborgbrug,2023-08-02,20:00:00,110,36,74,FMN 06 B Zurenborgbrug Ringfietspad
655,Ringfietspad Zurenborgbrug,2023-08-02,21:00:00,43,21,22,FMN 06 B Zurenborgbrug Ringfietspad
655,Ringfietspad Zurenborgbrug,2023-08-02,22:00:00,95,57,38,FMN 06 B Zurenborgbrug Ringfietspad
655,Ringfietspad Zurenborgbrug,2023-08-02,23:00:00,29,20,9,FMN 06 B Zurenborgbrug Ringfietspad
655,Ringfietspad Zurenborgbrug,2023-08-03,00:00:00,7,3,4,FMN 06 B Zurenborgbrug Ringfietspad
655,Ringfietspad Zurenborgbrug,2023-08-03,01:00:00,1,0,1,FMN 06 B Zurenborgbrug Ringfietspad
655,Ringfietspad Zurenborgbrug,2023-08-03,02:00:00,4,3,1,FMN 06 B Zurenborgbrug Ringfietspad
655,Ringfietspad Zurenborgbrug,2023-08-03,03:00:00,5,2,3,FMN 06 B Zurenborgbrug Ringfietspad
655,Ringfietspad Zurenborgbrug,2023-08-03,04:00:00,11,4,7,FMN 06 B Zurenborgbrug Ringfietspad
655,Ringfietspad Zurenborgbrug,2023-08-03,05:00:00,24,16,8,FMN 06 B Zurenborgbrug Ringfietspad
655,Ringfietspad Zurenborgbrug,2023-08-03,06:00:00,86,51,35,FMN 06 B Zurenborgbrug Ringfietspad
655,Ringfietspad Zurenborgbrug,2023-08-03,07:00:00,228,144,84,FMN 06 B Zurenborgbrug Ringfietspad
655,Ringfietspad Zurenborgbrug,2023-08-03,08:00:00,292,162,130,FMN 06 B Zurenborgbrug Ringfietspad
655,Ringfietspad Zurenborgbrug,2023-08-03,09:00:00,92,52,40,FMN 06 B Zurenborgbrug Ringfietspad
655,Ringfietspad Zurenborgbrug,2023-08-03,10:00:00,63,28,35,FMN 06 B Zurenborgbrug Ringfietspad
655,Ringfietspad Zurenborgbrug,2023-08-03,11:00:00,62,37,25,FMN 06 B Zurenborgbrug Ringfietspad
655,Ringfietspad Zurenborgbrug,2023-08-03,12:00:00,75,41,34,FMN 06 B Zurenborgbrug Ringfietspad
655,Ringfietspad Zurenborgbrug,2023-08-03,13:00:00,50,27,23,FMN 06 B Zurenborgbrug Ringfietspad
655,Ringfietspad Zurenborgbrug,2023-08-03,14:00:00,71,30,41,FMN 06 B Zurenborgbrug Ringfietspad
655,Ringfietspad Zurenborgbrug,2023-08-03,15:00:00,109,42,67,FMN 06 B Zurenborgbrug Ringfietspad
655,Ringfietspad Zurenborgbrug,2023-08-03,16:00:00,256,96,160,FMN 06 B Zurenborgbrug Ringfietspad
655,Ringfietspad Zurenborgbrug,2023-08-03,17:00:00,308,103,205,FMN 06 B Zurenborgbrug Ringfietspad
655,Ringfietspad Zurenborgbrug,2023-08-03,18:00:00,173,80,93,FMN 06 B Zurenborgbrug Ringfietspad
655,Ringfietspad Zurenborgbrug,2023-08-03,19:00:00,138,55,83,FMN 06 B Zurenborgbrug Ringfietspad
655,Ringfietspad Zurenborgbrug,2023-08-03,20:00:00,125,56,69,FMN 06 B Zurenborgbrug Ringfietspad
655,Ringfietspad Zurenborgbrug,2023-08-03,21:00:00,61,26,35,FMN 06 B Zurenborgbrug Ringfietspad
655,Ringfietspad Zurenborgbrug,2023-08-03,22:00:00,71,42,29,FMN 06 B Zurenborgbrug Ringfietspad
655,Ringfietspad Zurenborgbrug,2023-08-03,23:00:00,23,7,16,FMN 06 B Zurenborgbrug Ringfietspad
655,Ringfietspad Zurenborgbrug,2023-08-04,00:00:00,16,10,6,FMN 06 B Zurenborgbrug Ringfietspad
655,Ringfietspad Zurenborgbrug,2023-08-04,01:00:00,10,3,7,FMN 06 B Zurenborgbrug Ringfietspad
655,Ringfietspad Zurenborgbrug,2023-08-04,02:00:00,6,5,1,FMN 06 B Zurenborgbrug Ringfietspad
655,Ringfietspad Zurenborgbrug,2023-08-04,03:00:00,4,3,1,FMN 06 B Zurenborgbrug Ringfietspad
655,Ringfietspad Zurenborgbrug,2023-08-04,04:00:00,7,2,5,FMN 06 B Zurenborgbrug Ringfietspad
655,Ringfietspad Zurenborgbrug,2023-08-04,05:00:00,41,24,17,FMN 06 B Zurenborgbrug Ringfietspad
655,Ringfietspad Zurenborgbrug,2023-08-04,06:00:00,92,59,33,FMN 06 B Zurenborgbrug Ringfietspad
655,Ringfietspad Zurenborgbrug,2023-08-04,07:00:00,162,88,74,FMN 06 B Zurenborgbrug Ringfietspad
655,Ringfietspad Zurenborgbrug,2023-08-04,08:00:00,213,117,96,FMN 06 B Zurenborgbrug Ringfietspad
655,Ringfietspad Zurenborgbrug,2023-08-04,09:00:00,73,42,31,FMN 06 B Zurenborgbrug Ringfietspad
655,Ringfietspad Zurenborgbrug,2023-08-04,10:00:00,74,38,36,FMN 06 B Zurenborgbrug Ringfietspad
655,Ringfietspad Zurenborgbrug,2023-08-04,11:00:00,68,37,31,FMN 06 B Zurenborgbrug Ringfietspad
655,Ringfietspad Zurenborgbrug,2023-08-04,12:00:00,148,82,66,FMN 06 B Zurenborgbrug Ringfietspad
655,Ringfietspad Zurenborgbrug,2023-08-04,13:00:00,145,68,77,FMN 06 B Zurenborgbrug Ringfietspad
655,Ringfietspad Zurenborgbrug,2023-08-04,14:00:00,149,67,82,FMN 06 B Zurenborgbrug Ringfietspad
655,Ringfietspad Zurenborgbrug,2023-08-04,15:00:00,170,65,105,FMN 06 B Zurenborgbrug Ringfietspad
655,Ringfietspad Zurenborgbrug,2023-08-04,16:00:00,264,115,149,FMN 06 B Zurenborgbrug Ringfietspad
655,Ringfietspad Zurenborgbrug,2023-08-04,17:00:00,294,117,177,FMN 06 B Zurenborgbrug Ringfietspad
655,Ringfietspad Zurenborgbrug,2023-08-04,18:00:00,194,76,118,FMN 06 B Zurenborgbrug Ringfietspad
655,Ringfietspad Zurenborgbrug,2023-08-04,19:00:00,157,51,106,FMN 06 B Zurenborgbrug Ringfietspad
655,Ringfietspad Zurenborgbrug,2023-08-04,20:00:00,98,32,66,FMN 06 B Zurenborgbrug Ringfietspad
655,Ringfietspad Zurenborgbrug,2023-08-04,21:00:00,76,36,40,FMN 06 B Zurenborgbrug Ringfietspad
655,Ringfietspad Zurenborgbrug,2023-08-04,22:00:00,77,44,33,FMN 06 B Zurenborgbrug Ringfietspad
655,Ringfietspad Zurenborgbrug,2023-08-04,23:00:00,65,46,19,FMN 06 B Zurenborgbrug Ringfietspad
655,Ringfietspad Zurenborgbrug,2023-08-05,00:00:00,43,29,14,FMN 06 B Zurenborgbrug Ringfietspad
655,Ringfietspad Zurenborgbrug,2023-08-05,01:00:00,16,5,11,FMN 06 B Zurenborgbrug Ringfietspad
655,Ringfietspad Zurenborgbrug,2023-08-05,02:00:00,8,4,4,FMN 06 B Zurenborgbrug Ringfietspad
655,Ringfietspad Zurenborgbrug,2023-08-05,03:00:00,3,2,1,FMN 06 B Zurenborgbrug Ringfietspad
655,Ringfietspad Zurenborgbrug,2023-08-05,04:00:00,5,3,2,FMN 06 B Zurenborgbrug Ringfietspad
655,Ringfietspad Zurenborgbrug,2023-08-05,05:00:00,14,4,10,FMN 06 B Zurenborgbrug Ringfietspad
655,Ringfietspad Zurenborgbrug,2023-08-05,06:00:00,21,9,12,FMN 06 B Zurenborgbrug Ringfietspad
655,Ringfietspad Zurenborgbrug,2023-08-05,07:00:00,19,8,11,FMN 06 B Zurenborgbrug Ringfietspad
655,Ringfietspad Zurenborgbrug,2023-08-05,08:00:00,47,28,19,FMN 06 B Zurenborgbrug Ringfietspad
655,Ringfietspad Zurenborgbrug,2023-08-05,09:00:00,64,31,33,FMN 06 B Zurenborgbrug Ringfietspad
655,Ringfietspad Zurenborgbrug,2023-08-05,10:00:00,94,49,45,FMN 06 B Zurenborgbrug Ringfietspad
655,Ringfietspad Zurenborgbrug,2023-08-05,11:00:00,98,53,45,FMN 06 B Zurenborgbrug Ringfietspad
655,Ringfietspad Zurenborgbrug,2023-08-05,12:00:00,95,52,43,FMN 06 B Zurenborgbrug Ringfietspad
655,Ringfietspad Zurenborgbrug,2023-08-05,13:00:00,81,38,43,FMN 06 B Zurenborgbrug Ringfietspad
655,Ringfietspad Zurenborgbrug,2023-08-05,14:00:00,79,27,52,FMN 06 B Zurenborgbrug Ringfietspad
655,Ringfietspad Zurenborgbrug,2023-08-05,15:00:00,50,27,23,FMN 06 B Zurenborgbrug Ringfietspad
655,Ringfietspad Zurenborgbrug,2023-08-05,16:00:00,49,22,27,FMN 06 B Zurenborgbrug Ringfietspad
655,Ringfietspad Zurenborgbrug,2023-08-05,17:00:00,66,40,26,FMN 06 B Zurenborgbrug Ringfietspad
655,Ringfietspad Zurenborgbrug,2023-08-05,18:00:00,60,21,39,FMN 06 B Zurenborgbrug Ringfietspad
655,Ringfietspad Zurenborgbrug,2023-08-05,19:00:00,70,23,47,FMN 06 B Zurenborgbrug Ringfietspad
655,Ringfietspad Zurenborgbrug,2023-08-05,20:00:00,47,17,30,FMN 06 B Zurenborgbrug Ringfietspad
655,Ringfietspad Zurenborgbrug,2023-08-05,21:00:00,16,6,10,FMN 06 B Zurenborgbrug Ringfietspad
655,Ringfietspad Zurenborgbrug,2023-08-05,22:00:00,27,18,9,FMN 06 B Zurenborgbrug Ringfietspad
655,Ringfietspad Zurenborgbrug,2023-08-05,23:00:00,37,22,15,FMN 06 B Zurenborgbrug Ringfietspad
655,Ringfietspad Zurenborgbrug,2023-08-06,00:00:00,27,16,11,FMN 06 B Zurenborgbrug Ringfietspad
655,Ringfietspad Zurenborgbrug,2023-08-06,01:00:00,13,4,9,FMN 06 B Zurenborgbrug Ringfietspad
655,Ringfietspad Zurenborgbrug,2023-08-06,02:00:00,11,7,4,FMN 06 B Zurenborgbrug Ringfietspad
655,Ringfietspad Zurenborgbrug,2023-08-06,03:00:00,8,5,3,FMN 06 B Zurenborgbrug Ringfietspad
655,Ringfietspad Zurenborgbrug,2023-08-06,04:00:00,1,1,0,FMN 06 B Zurenborgbrug Ringfietspad
655,Ringfietspad Zurenborgbrug,2023-08-06,05:00:00,7,4,3,FMN 06 B Zurenborgbrug Ringfietspad
655,Ringfietspad Zurenborgbrug,2023-08-06,06:00:00,7,4,3,FMN 06 B Zurenborgbrug Ringfietspad
655,Ringfietspad Zurenborgbrug,2023-08-06,07:00:00,12,6,6,FMN 06 B Zurenborgbrug Ringfietspad
655,Ringfietspad Zurenborgbrug,2023-08-06,08:00:00,8,2,6,FMN 06 B Zurenborgbrug Ringfietspad
655,Ringfietspad Zurenborgbrug,2023-08-06,09:00:00,21,11,10,FMN 06 B Zurenborgbrug Ringfietspad
655,Ringfietspad Zurenborgbrug,2023-08-06,10:00:00,42,16,26,FMN 06 B Zurenborgbrug Ringfietspad
655,Ringfietspad Zurenborgbrug,2023-08-06,11:00:00,41,17,24,FMN 06 B Zurenborgbrug Ringfietspad
655,Ringfietspad Zurenborgbrug,2023-08-06,12:00:00,38,14,24,FMN 06 B Zurenborgbrug Ringfietspad
655,Ringfietspad Zurenborgbrug,2023-08-06,13:00:00,42,20,22,FMN 06 B Zurenborgbrug Ringfietspad
655,Ringfietspad Zurenborgbrug,2023-08-06,14:00:00,28,8,20,FMN 06 B Zurenborgbrug Ringfietspad
655,Ringfietspad Zurenborgbrug,2023-08-06,15:00:00,33,18,15,FMN 06 B Zurenborgbrug Ringfietspad
655,Ringfietspad Zurenborgbrug,2023-08-06,16:00:00,35,20,15,FMN 06 B Zurenborgbrug Ringfietspad
655,Ringfietspad Zurenborgbrug,2023-08-06,17:00:00,27,10,17,FMN 06 B Zurenborgbrug Ringfietspad
655,Ringfietspad Zurenborgbrug,2023-08-06,18:00:00,46,21,25,FMN 06 B Zurenborgbrug Ringfietspad
655,Ringfietspad Zurenborgbrug,2023-08-06,19:00:00,42,21,21,FMN 06 B Zurenborgbrug Ringfietspad
655,Ringfietspad Zurenborgbrug,2023-08-06,20:00:00,46,18,28,FMN 06 B Zurenborgbrug Ringfietspad
655,Ringfietspad Zurenborgbrug,2023-08-06,21:00:00,38,22,16,FMN 06 B Zurenborgbrug Ringfietspad
655,Ringfietspad Zurenborgbrug,2023-08-06,22:00:00,21,9,12,FMN 06 B Zurenborgbrug Ringfietspad
655,Ringfietspad Zurenborgbrug,2023-08-06,23:00:00,19,9,10,FMN 06 B Zurenborgbrug Ringfietspad
655,Ringfietspad Zurenborgbrug,2023-08-07,00:00:00,10,8,2,FMN 06 B Zurenborgbrug Ringfietspad
655,Ringfietspad Zurenborgbrug,2023-08-07,01:00:00,7,4,3,FMN 06 B Zurenborgbrug Ringfietspad
655,Ringfietspad Zurenborgbrug,2023-08-07,02:00:00,3,2,1,FMN 06 B Zurenborgbrug Ringfietspad
655,Ringfietspad Zurenborgbrug,2023-08-07,03:00:00,6,4,2,FMN 06 B Zurenborgbrug Ringfietspad
655,Ringfietspad Zurenborgbrug,2023-08-07,04:00:00,21,10,11,FMN 06 B Zurenborgbrug Ringfietspad
655,Ringfietspad Zurenborgbrug,2023-08-07,05:00:00,45,31,14,FMN 06 B Zurenborgbrug Ringfietspad
655,Ringfietspad Zurenborgbrug,2023-08-07,06:00:00,126,69,57,FMN 06 B Zurenborgbrug Ringfietspad
655,Ringfietspad Zurenborgbrug,2023-08-07,07:00:00,250,141,109,FMN 06 B Zurenborgbrug Ringfietspad
655,Ringfietspad Zurenborgbrug,2023-08-07,08:00:00,326,168,158,FMN 06 B Zurenborgbrug Ringfietspad
655,Ringfietspad Zurenborgbrug,2023-08-07,09:00:00,114,73,41,FMN 06 B Zurenborgbrug Ringfietspad
655,Ringfietspad Zurenborgbrug,2023-08-07,10:00:00,85,39,46,FMN 06 B Zurenborgbrug Ringfietspad
655,Ringfietspad Zurenborgbrug,2023-08-07,11:00:00,98,54,44,FMN 06 B Zurenborgbrug Ringfietspad
655,Ringfietspad Zurenborgbrug,2023-08-07,12:00:00,125,60,65,FMN 06 B Zurenborgbrug Ringfietspad
655,Ringfietspad Zurenborgbrug,2023-08-07,13:00:00,138,67,71,FMN 06 B Zurenborgbrug Ringfietspad
655,Ringfietspad Zurenborgbrug,2023-08-07,14:00:00,126,59,67,FMN 06 B Zurenborgbrug Ringfietspad
655,Ringfietspad Zurenborgbrug,2023-08-07,15:00:00,190,80,110,FMN 06 B Zurenborgbrug Ringfietspad
655,Ringfietspad Zurenborgbrug,2023-08-07,16:00:00,325,137,188,FMN 06 B Zurenborgbrug Ringfietspad
655,Ringfietspad Zurenborgbrug,2023-08-07,17:00:00,452,172,280,FMN 06 B Zurenborgbrug Ringfietspad
655,Ringfietspad Zurenborgbrug,2023-08-07,18:00:00,240,101,139,FMN 06 B Zurenborgbrug Ringfietspad
655,Ringfietspad Zurenborgbrug,2023-08-07,19:00:00,183,60,123,FMN 06 B Zurenborgbrug Ringfietspad
655,Ringfietspad Zurenborgbrug,2023-08-07,20:00:00,115,38,77,FMN 06 B Zurenborgbrug Ringfietspad
655,Ringfietspad Zurenborgbrug,2023-08-07,21:00:00,88,48,40,FMN 06 B Zurenborgbrug Ringfietspad
655,Ringfietspad Zurenborgbrug,2023-08-07,22:00:00,66,30,36,FMN 06 B Zurenborgbrug Ringfietspad
655,Ringfietspad Zurenborgbrug,2023-08-07,23:00:00,91,73,18,FMN 06 B Zurenborgbrug Ringfietspad
655,Ringfietspad Zurenborgbrug,2023-08-08,00:00:00,26,21,5,FMN 06 B Zurenborgbrug Ringfietspad
655,Ringfietspad Zurenborgbrug,2023-08-08,01:00:00,12,7,5,FMN 06 B Zurenborgbrug Ringfietspad
655,Ringfietspad Zurenborgbrug,2023-08-08,02:00:00,3,2,1,FMN 06 B Zurenborgbrug Ringfietspad
655,Ringfietspad Zurenborgbrug,2023-08-08,03:00:00,3,2,1,FMN 06 B Zurenborgbrug Ringfietspad
655,Ringfietspad Zurenborgbrug,2023-08-08,04:00:00,17,10,7,FMN 06 B Zurenborgbrug Ringfietspad
655,Ringfietspad Zurenborgbrug,2023-08-08,05:00:00,54,33,21,FMN 06 B Zurenborgbrug Ringfietspad
655,Ringfietspad Zurenborgbrug,2023-08-08,06:00:00,162,96,66,FMN 06 B Zurenborgbrug Ringfietspad
655,Ringfietspad Zurenborgbrug,2023-08-08,07:00:00,310,191,119,FMN 06 B Zurenborgbrug Ringfietspad
655,Ringfietspad Zurenborgbrug,2023-08-08,08:00:00,390,229,161,FMN 06 B Zurenborgbrug Ringfietspad
655,Ringfietspad Zurenborgbrug,2023-08-08,09:00:00,147,79,68,FMN 06 B Zurenborgbrug Ringfietspad
655,Ringfietspad Zurenborgbrug,2023-08-08,10:00:00,99,35,64,FMN 06 B Zurenborgbrug Ringfietspad
655,Ringfietspad Zurenborgbrug,2023-08-08,11:00:00,95,48,47,FMN 06 B Zurenborgbrug Ringfietspad
655,Ringfietspad Zurenborgbrug,2023-08-08,12:00:00,107,63,44,FMN 06 B Zurenborgbrug Ringfietspad
655,Ringfietspad Zurenborgbrug,2023-08-08,13:00:00,138,62,76,FMN 06 B Zurenborgbrug Ringfietspad
655,Ringfietspad Zurenborgbrug,2023-08-08,14:00:00,156,63,93,FMN 06 B Zurenborgbrug Ringfietspad
655,Ringfietspad Zurenborgbrug,2023-08-08,15:00:00,195,69,126,FMN 06 B Zurenborgbrug Ringfietspad
655,Ringfietspad Zurenborgbrug,2023-08-08,16:00:00,392,165,227,FMN 06 B Zurenborgbrug Ringfietspad
655,Ringfietspad Zurenborgbrug,2023-08-08,17:00:00,450,168,282,FMN 06 B Zurenborgbrug Ringfietspad
655,Ringfietspad Zurenborgbrug,2023-08-08,18:00:00,233,85,148,FMN 06 B Zurenborgbrug Ringfietspad
655,Ringfietspad Zurenborgbrug,2023-08-08,19:00:00,128,37,91,FMN 06 B Zurenborgbrug Ringfietspad
655,Ringfietspad Zurenborgbrug,2023-08-08,20:00:00,79,37,42,FMN 06 B Zurenborgbrug Ringfietspad
655,Ringfietspad Zurenborgbrug,2023-08-08,21:00:00,36,17,19,FMN 06 B Zurenborgbrug Ringfietspad
655,Ringfietspad Zurenborgbrug,2023-08-08,22:00:00,56,20,36,FMN 06 B Zurenborgbrug Ringfietspad
655,Ringfietspad Zurenborgbrug,2023-08-08,23:00:00,64,48,16,FMN 06 B Zurenborgbrug Ringfietspad
655,Ringfietspad Zurenborgbrug,2023-08-09,00:00:00,23,15,8,FMN 06 B Zurenborgbrug Ringfietspad
655,Ringfietspad Zurenborgbrug,2023-08-09,01:00:00,4,2,2,FMN 06 B Zurenborgbrug Ringfietspad
655,Ringfietspad Zurenborgbrug,2023-08-09,02:00:00,1,0,1,FMN 06 B Zurenborgbrug Ringfietspad
655,Ringfietspad Zurenborgbrug,2023-08-09,03:00:00,3,2,1,FMN 06 B Zurenborgbrug Ringfietspad
655,Ringfietspad Zurenborgbrug,2023-08-09,04:00:00,14,8,6,FMN 06 B Zurenborgbrug Ringfietspad
655,Ringfietspad Zurenborgbrug,2023-08-09,05:00:00,49,34,15,FMN 06 B Zurenborgbrug Ringfietspad
655,Ringfietspad Zurenborgbrug,2023-08-09,06:00:00,128,75,53,FMN 06 B Zurenborgbrug Ringfietspad
655,Ringfietspad Zurenborgbrug,2023-08-09,07:00:00,303,189,114,FMN 06 B Zurenborgbrug Ringfietspad
655,Ringfietspad Zurenborgbrug,2023-08-09,08:00:00,320,165,155,FMN 06 B Zurenborgbrug Ringfietspad
655,Ringfietspad Zurenborgbrug,2023-08-09,09:00:00,133,75,58,FMN 06 B Zurenborgbrug Ringfietspad
655,Ringfietspad Zurenborgbrug,2023-08-09,10:00:00,155,99,56,FMN 06 B Zurenborgbrug Ringfietspad
655,Ringfietspad Zurenborgbrug,2023-08-09,11:00:00,144,76,68,FMN 06 B Zurenborgbrug Ringfietspad
655,Ringfietspad Zurenborgbrug,2023-08-09,12:00:00,157,76,81,FMN 06 B Zurenborgbrug Ringfietspad
655,Ringfietspad Zurenborgbrug,2023-08-09,13:00:00,161,78,83,FMN 06 B Zurenborgbrug Ringfietspad
655,Ringfietspad Zurenborgbrug,2023-08-09,14:00:00,227,84,143,FMN 06 B Zurenborgbrug Ringfietspad
655,Ringfietspad Zurenborgbrug,2023-08-09,15:00:00,252,99,153,FMN 06 B Zurenborgbrug Ringfietspad
655,Ringfietspad Zurenborgbrug,2023-08-09,16:00:00,380,161,219,FMN 06 B Zurenborgbrug Ringfietspad
655,Ringfietspad Zurenborgbrug,2023-08-09,17:00:00,473,184,289,FMN 06 B Zurenborgbrug Ringfietspad
655,Ringfietspad Zurenborgbrug,2023-08-09,18:00:00,312,110,202,FMN 06 B Zurenborgbrug Ringfietspad
655,Ringfietspad Zurenborgbrug,2023-08-09,19:00:00,210,72,138,FMN 06 B Zurenborgbrug Ringfietspad
655,Ringfietspad Zurenborgbrug,2023-08-09,20:00:00,117,44,73,FMN 06 B Zurenborgbrug Ringfietspad
655,Ringfietspad Zurenborgbrug,2023-08-09,21:00:00,104,54,50,FMN 06 B Zurenborgbrug Ringfietspad
655,Ringfietspad Zurenborgbrug,2023-08-09,22:00:00,116,48,68,FMN 06 B Zurenborgbrug Ringfietspad
655,Ringfietspad Zurenborgbrug,2023-08-09,23:00:00,60,33,27,FMN 06 B Zurenborgbrug Ringfietspad
655,Ringfietspad Zurenborgbrug,2023-08-10,00:00:00,57,42,15,FMN 06 B Zurenborgbrug Ringfietspad
655,Ringfietspad Zurenborgbrug,2023-08-10,01:00:00,17,8,9,FMN 06 B Zurenborgbrug Ringfietspad
655,Ringfietspad Zurenborgbrug,2023-08-10,02:00:00,3,3,0,FMN 06 B Zurenborgbrug Ringfietspad
655,Ringfietspad Zurenborgbrug,2023-08-10,03:00:00,2,2,0,FMN 06 B Zurenborgbrug Ringfietspad
655,Ringfietspad Zurenborgbrug,2023-08-10,04:00:00,16,9,7,FMN 06 B Zurenborgbrug Ringfietspad
655,Ringfietspad Zurenborgbrug,2023-08-10,05:00:00,63,40,23,FMN 06 B Zurenborgbrug Ringfietspad
655,Ringfietspad Zurenborgbrug,2023-08-10,06:00:00,142,79,63,FMN 06 B Zurenborgbrug Ringfietspad
655,Ringfietspad Zurenborgbrug,2023-08-10,07:00:00,329,199,130,FMN 06 B Zurenborgbrug Ringfietspad
655,Ringfietspad Zurenborgbrug,2023-08-10,08:00:00,391,221,170,FMN 06 B Zurenborgbrug Ringfietspad
655,Ringfietspad Zurenborgbrug,2023-08-10,09:00:00,191,104,87,FMN 06 B Zurenborgbrug Ringfietspad
655,Ringfietspad Zurenborgbrug,2023-08-10,10:00:00,143,75,68,FMN 06 B Zurenborgbrug Ringfietspad
655,Ringfietspad Zurenborgbrug,2023-08-10,11:00:00,168,82,86,FMN 06 B Zurenborgbrug Ringfietspad
655,Ringfietspad Zurenborgbrug,2023-08-10,12:00:00,180,95,85,FMN 06 B Zurenborgbrug Ringfietspad
655,Ringfietspad Zurenborgbrug,2023-08-10,13:00:00,211,115,96,FMN 06 B Zurenborgbrug Ringfietspad
655,Ringfietspad Zurenborgbrug,2023-08-10,14:00:00,207,79,128,FMN 06 B Zurenborgbrug Ringfietspad
655,Ringfietspad Zurenborgbrug,2023-08-10,15:00:00,258,96,162,FMN 06 B Zurenborgbrug Ringfietspad
655,Ringfietspad Zurenborgbrug,2023-08-10,16:00:00,450,158,292,FMN 06 B Zurenborgbrug Ringfietspad
655,Ringfietspad Zurenborgbrug,2023-08-10,17:00:00,508,192,316,FMN 06 B Zurenborgbrug Ringfietspad
655,Ringfietspad Zurenborgbrug,2023-08-10,18:00:00,398,126,272,FMN 06 B Zurenborgbrug Ringfietspad
655,Ringfietspad Zurenborgbrug,2023-08-10,19:00:00,199,79,120,FMN 06 B Zurenborgbrug Ringfietspad
655,Ringfietspad Zurenborgbrug,2023-08-10,20:00:00,160,94,66,FMN 06 B Zurenborgbrug Ringfietspad
655,Ringfietspad Zurenborgbrug,2023-08-10,21:00:00,130,70,60,FMN 06 B Zurenborgbrug Ringfietspad
655,Ringfietspad Zurenborgbrug,2023-08-10,22:00:00,126,73,53,FMN 06 B Zurenborgbrug Ringfietspad
655,Ringfietspad Zurenborgbrug,2023-08-10,23:00:00,51,37,14,FMN 06 B Zurenborgbrug Ringfietspad
655,Ringfietspad Zurenborgbrug,2023-08-11,00:00:00,51,33,18,FMN 06 B Zurenborgbrug Ringfietspad
655,Ringfietspad Zurenborgbrug,2023-08-11,01:00:00,14,6,8,FMN 06 B Zurenborgbrug Ringfietspad
655,Ringfietspad Zurenborgbrug,2023-08-11,02:00:00,13,3,10,FMN 06 B Zurenborgbrug Ringfietspad
655,Ringfietspad Zurenborgbrug,2023-08-11,03:00:00,3,3,0,FMN 06 B Zurenborgbrug Ringfietspad
655,Ringfietspad Zurenborgbrug,2023-08-11,04:00:00,16,11,5,FMN 06 B Zurenborgbrug Ringfietspad
655,Ringfietspad Zurenborgbrug,2023-08-11,05:00:00,55,35,20,FMN 06 B Zurenborgbrug Ringfietspad
655,Ringfietspad Zurenborgbrug,2023-08-11,06:00:00,121,74,47,FMN 06 B Zurenborgbrug Ringfietspad
655,Ringfietspad Zurenborgbrug,2023-08-11,07:00:00,218,118,100,FMN 06 B Zurenborgbrug Ringfietspad
655,Ringfietspad Zurenborgbrug,2023-08-11,08:00:00,300,152,148,FMN 06 B Zurenborgbrug Ringfietspad
655,Ringfietspad Zurenborgbrug,2023-08-11,09:00:00,124,81,43,FMN 06 B Zurenborgbrug Ringfietspad
655,Ringfietspad Zurenborgbrug,2023-08-11,10:00:00,154,83,71,FMN 06 B Zurenborgbrug Ringfietspad
655,Ringfietspad Zurenborgbrug,2023-08-11,11:00:00,182,98,84,FMN 06 B Zurenborgbrug Ringfietspad
655,Ringfietspad Zurenborgbrug,2023-08-11,12:00:00,200,95,105,FMN 06 B Zurenborgbrug Ringfietspad
655,Ringfietspad Zurenborgbrug,2023-08-11,13:00:00,251,77,174,FMN 06 B Zurenborgbrug Ringfietspad
655,Ringfietspad Zurenborgbrug,2023-08-11,14:00:00,213,82,131,FMN 06 B Zurenborgbrug Ringfietspad
655,Ringfietspad Zurenborgbrug,2023-08-11,15:00:00,280,149,131,FMN 06 B Zurenborgbrug Ringfietspad
655,Ringfietspad Zurenborgbrug,2023-08-11,16:00:00,360,173,187,FMN 06 B Zurenborgbrug Ringfietspad
655,Ringfietspad Zurenborgbrug,2023-08-11,17:00:00,356,137,219,FMN 06 B Zurenborgbrug Ringfietspad
655,Ringfietspad Zurenborgbrug,2023-08-11,18:00:00,267,94,173,FMN 06 B Zurenborgbrug Ringfietspad
655,Ringfietspad Zurenborgbrug,2023-08-11,19:00:00,185,55,130,FMN 06 B Zurenborgbrug Ringfietspad
655,Ringfietspad Zurenborgbrug,2023-08-11,20:00:00,106,24,82,FMN 06 B Zurenborgbrug Ringfietspad
655,Ringfietspad Zurenborgbrug,2023-08-11,21:00:00,77,38,39,FMN 06 B Zurenborgbrug Ringfietspad
655,Ringfietspad Zurenborgbrug,2023-08-11,22:00:00,89,51,38,FMN 06 B Zurenborgbrug Ringfietspad
655,Ringfietspad Zurenborgbrug,2023-08-11,23:00:00,90,64,26,FMN 06 B Zurenborgbrug Ringfietspad
655,Ringfietspad Zurenborgbrug,2023-08-12,00:00:00,61,41,20,FMN 06 B Zurenborgbrug Ringfietspad
655,Ringfietspad Zurenborgbrug,2023-08-12,01:00:00,32,22,10,FMN 06 B Zurenborgbrug Ringfietspad
655,Ringfietspad Zurenborgbrug,2023-08-12,02:00:00,18,6,12,FMN 06 B Zurenborgbrug Ringfietspad
655,Ringfietspad Zurenborgbrug,2023-08-12,03:00:00,11,6,5,FMN 06 B Zurenborgbrug Ringfietspad
655,Ringfietspad Zurenborgbrug,2023-08-12,04:00:00,9,3,6,FMN 06 B Zurenborgbrug Ringfietspad
655,Ringfietspad Zurenborgbrug,2023-08-12,05:00:00,16,11,5,FMN 06 B Zurenborgbrug Ringfietspad
655,Ringfietspad Zurenborgbrug,2023-08-12,06:00:00,28,17,11,FMN 06 B Zurenborgbrug Ringfietspad
655,Ringfietspad Zurenborgbrug,2023-08-12,07:00:00,19,10,9,FMN 06 B Zurenborgbrug Ringfietspad
655,Ringfietspad Zurenborgbrug,2023-08-12,08:00:00,26,17,9,FMN 06 B Zurenborgbrug Ringfietspad
655,Ringfietspad Zurenborgbrug,2023-08-12,09:00:00,73,43,30,FMN 06 B Zurenborgbrug Ringfietspad
655,Ringfietspad Zurenborgbrug,2023-08-12,10:00:00,80,29,51,FMN 06 B Zurenborgbrug Ringfietspad
655,Ringfietspad Zurenborgbrug,2023-08-12,11:00:00,96,46,50,FMN 06 B Zurenborgbrug Ringfietspad
655,Ringfietspad Zurenborgbrug,2023-08-12,12:00:00,118,47,71,FMN 06 B Zurenborgbrug Ringfietspad
655,Ringfietspad Zurenborgbrug,2023-08-12,13:00:00,141,58,83,FMN 06 B Zurenborgbrug Ringfietspad
655,Ringfietspad Zurenborgbrug,2023-08-12,14:00:00,146,66,80,FMN 06 B Zurenborgbrug Ringfietspad
655,Ringfietspad Zurenborgbrug,2023-08-12,15:00:00,184,87,97,FMN 06 B Zurenborgbrug Ringfietspad
655,Ringfietspad Zurenborgbrug,2023-08-12,16:00:00,140,67,73,FMN 06 B Zurenborgbrug Ringfietspad
655,Ringfietspad Zurenborgbrug,2023-08-12,17:00:00,151,71,80,FMN 06 B Zurenborgbrug Ringfietspad
655,Ringfietspad Zurenborgbrug,2023-08-12,18:00:00,145,62,83,FMN 06 B Zurenborgbrug Ringfietspad
655,Ringfietspad Zurenborgbrug,2023-08-12,19:00:00,120,31,89,FMN 06 B Zurenborgbrug Ringfietspad
655,Ringfietspad Zurenborgbrug,2023-08-12,20:00:00,78,29,49,FMN 06 B Zurenborgbrug Ringfietspad
655,Ringfietspad Zurenborgbrug,2023-08-12,21:00:00,56,30,26,FMN 06 B Zurenborgbrug Ringfietspad
655,Ringfietspad Zurenborgbrug,2023-08-12,22:00:00,62,37,25,FMN 06 B Zurenborgbrug Ringfietspad
655,Ringfietspad Zurenborgbrug,2023-08-12,23:00:00,71,51,20,FMN 06 B Zurenborgbrug Ringfietspad
655,Ringfietspad Zurenborgbrug,2023-08-13,00:00:00,20,11,9,FMN 06 B Zurenborgbrug Ringfietspad
655,Ringfietspad Zurenborgbrug,2023-08-13,01:00:00,16,5,11,FMN 06 B Zurenborgbrug Ringfietspad
655,Ringfietspad Zurenborgbrug,2023-08-13,02:00:00,10,2,8,FMN 06 B Zurenborgbrug Ringfietspad
655,Ringfietspad Zurenborgbrug,2023-08-13,03:00:00,9,3,6,FMN 06 B Zurenborgbrug Ringfietspad
655,Ringfietspad Zurenborgbrug,2023-08-13,04:00:00,14,3,11,FMN 06 B Zurenborgbrug Ringfietspad
655,Ringfietspad Zurenborgbrug,2023-08-13,05:00:00,14,8,6,FMN 06 B Zurenborgbrug Ringfietspad
655,Ringfietspad Zurenborgbrug,2023-08-13,06:00:00,20,6,14,FMN 06 B Zurenborgbrug Ringfietspad
655,Ringfietspad Zurenborgbrug,2023-08-13,07:00:00,34,16,18,FMN 06 B Zurenborgbrug Ringfietspad
655,Ringfietspad Zurenborgbrug,2023-08-13,08:00:00,73,16,57,FMN 06 B Zurenborgbrug Ringfietspad
655,Ringfietspad Zurenborgbrug,2023-08-13,09:00:00,78,40,38,FMN 06 B Zurenborgbrug Ringfietspad
655,Ringfietspad Zurenborgbrug,2023-08-13,10:00:00,132,57,75,FMN 06 B Zurenborgbrug Ringfietspad
655,Ringfietspad Zurenborgbrug,2023-08-13,11:00:00,161,78,83,FMN 06 B Zurenborgbrug Ringfietspad
655,Ringfietspad Zurenborgbrug,2023-08-13,12:00:00,217,101,116,FMN 06 B Zurenborgbrug Ringfietspad
655,Ringfietspad Zurenborgbrug,2023-08-13,13:00:00,216,104,112,FMN 06 B Zurenborgbrug Ringfietspad
655,Ringfietspad Zurenborgbrug,2023-08-13,14:00:00,277,139,138,FMN 06 B Zurenborgbrug Ringfietspad
655,Ringfietspad Zurenborgbrug,2023-08-13,15:00:00,273,129,144,FMN 06 B Zurenborgbrug Ringfietspad
655,Ringfietspad Zurenborgbrug,2023-08-13,16:00:00,221,93,128,FMN 06 B Zurenborgbrug Ringfietspad
655,Ringfietspad Zurenborgbrug,2023-08-13,17:00:00,168,92,76,FMN 06 B Zurenborgbrug Ringfietspad
655,Ringfietspad Zurenborgbrug,2023-08-13,18:00:00,195,130,65,FMN 06 B Zurenborgbrug Ringfietspad
655,Ringfietspad Zurenborgbrug,2023-08-13,19:00:00,116,53,63,FMN 06 B Zurenborgbrug Ringfietspad
655,Ringfietspad Zurenborgbrug,2023-08-13,20:00:00,97,52,45,FMN 06 B Zurenborgbrug Ringfietspad
655,Ringfietspad Zurenborgbrug,2023-08-13,21:00:00,63,34,29,FMN 06 B Zurenborgbrug Ringfietspad
655,Ringfietspad Zurenborgbrug,2023-08-13,22:00:00,45,14,31,FMN 06 B Zurenborgbrug Ringfietspad
655,Ringfietspad Zurenborgbrug,2023-08-13,23:00:00,28,16,12,FMN 06 B Zurenborgbrug Ringfietspad
655,Ringfietspad Zurenborgbrug,2023-08-14,00:00:00,18,7,11,FMN 06 B Zurenborgbrug Ringfietspad
655,Ringfietspad Zurenborgbrug,2023-08-14,01:00:00,13,7,6,FMN 06 B Zurenborgbrug Ringfietspad
655,Ringfietspad Zurenborgbrug,2023-08-14,02:00:00,4,3,1,FMN 06 B Zurenborgbrug Ringfietspad
655,Ringfietspad Zurenborgbrug,2023-08-14,03:00:00,10,7,3,FMN 06 B Zurenborgbrug Ringfietspad
655,Ringfietspad Zurenborgbrug,2023-08-14,04:00:00,13,8,5,FMN 06 B Zurenborgbrug Ringfietspad
655,Ringfietspad Zurenborgbrug,2023-08-14,05:00:00,35,20,15,FMN 06 B Zurenborgbrug Ringfietspad
655,Ringfietspad Zurenborgbrug,2023-08-14,06:00:00,71,36,35,FMN 06 B Zurenborgbrug Ringfietspad
655,Ringfietspad Zurenborgbrug,2023-08-14,07:00:00,165,88,77,FMN 06 B Zurenborgbrug Ringfietspad
655,Ringfietspad Zurenborgbrug,2023-08-14,08:00:00,201,94,107,FMN 06 B Zurenborgbrug Ringfietspad
655,Ringfietspad Zurenborgbrug,2023-08-14,09:00:00,116,65,51,FMN 06 B Zurenborgbrug Ringfietspad
655,Ringfietspad Zurenborgbrug,2023-08-14,10:00:00,164,78,86,FMN 06 B Zurenborgbrug Ringfietspad
655,Ringfietspad Zurenborgbrug,2023-08-14,11:00:00,169,93,76,FMN 06 B Zurenborgbrug Ringfietspad
655,Ringfietspad Zurenborgbrug,2023-08-14,12:00:00,165,82,83,FMN 06 B Zurenborgbrug Ringfietspad
655,Ringfietspad Zurenborgbrug,2023-08-14,13:00:00,191,90,101,FMN 06 B Zurenborgbrug Ringfietspad
655,Ringfietspad Zurenborgbrug,2023-08-14,14:00:00,242,108,134,FMN 06 B Zurenborgbrug Ringfietspad
655,Ringfietspad Zurenborgbrug,2023-08-14,15:00:00,230,102,128,FMN 06 B Zurenborgbrug Ringfietspad
655,Ringfietspad Zurenborgbrug,2023-08-14,16:00:00,314,145,169,FMN 06 B Zurenborgbrug Ringfietspad
655,Ringfietspad Zurenborgbrug,2023-08-14,17:00:00,322,142,180,FMN 06 B Zurenborgbrug Ringfietspad
655,Ringfietspad Zurenborgbrug,2023-08-14,18:00:00,183,76,107,FMN 06 B Zurenborgbrug Ringfietspad
655,Ringfietspad Zurenborgbrug,2023-08-14,19:00:00,134,58,76,FMN 06 B Zurenborgbrug Ringfietspad
655,Ringfietspad Zurenborgbrug,2023-08-14,20:00:00,104,41,63,FMN 06 B Zurenborgbrug Ringfietspad
655,Ringfietspad Zurenborgbrug,2023-08-14,21:00:00,87,43,44,FMN 06 B Zurenborgbrug Ringfietspad
655,Ringfietspad Zurenborgbrug,2023-08-14,22:00:00,67,33,34,FMN 06 B Zurenborgbrug Ringfietspad
655,Ringfietspad Zurenborgbrug,2023-08-14,23:00:00,38,12,26,FMN 06 B Zurenborgbrug Ringfietspad
655,Ringfietspad Zurenborgbrug,2023-08-15,00:00:00,22,10,12,FMN 06 B Zurenborgbrug Ringfietspad
655,Ringfietspad Zurenborgbrug,2023-08-15,01:00:00,14,7,7,FMN 06 B Zurenborgbrug Ringfietspad
655,Ringfietspad Zurenborgbrug,2023-08-15,02:00:00,13,2,11,FMN 06 B Zurenborgbrug Ringfietspad
655,Ringfietspad Zurenborgbrug,2023-08-15,03:00:00,4,3,1,FMN 06 B Zurenborgbrug Ringfietspad
655,Ringfietspad Zurenborgbrug,2023-08-15,04:00:00,6,3,3,FMN 06 B Zurenborgbrug Ringfietspad
655,Ringfietspad Zurenborgbrug,2023-08-15,05:00:00,9,5,4,FMN 06 B Zurenborgbrug Ringfietspad
655,Ringfietspad Zurenborgbrug,2023-08-15,06:00:00,24,13,11,FMN 06 B Zurenborgbrug Ringfietspad
655,Ringfietspad Zurenborgbrug,2023-08-15,07:00:00,38,20,18,FMN 06 B Zurenborgbrug Ringfietspad
655,Ringfietspad Zurenborgbrug,2023-08-15,08:00:00,55,26,29,FMN 06 B Zurenborgbrug Ringfietspad
655,Ringfietspad Zurenborgbrug,2023-08-15,09:00:00,94,44,50,FMN 06 B Zurenborgbrug Ringfietspad
655,Ringfietspad Zurenborgbrug,2023-08-15,10:00:00,154,63,91,FMN 06 B Zurenborgbrug Ringfietspad
655,Ringfietspad Zurenborgbrug,2023-08-15,11:00:00,173,97,76,FMN 06 B Zurenborgbrug Ringfietspad
655,Ringfietspad Zurenborgbrug,2023-08-15,12:00:00,233,117,116,FMN 06 B Zurenborgbrug Ringfietspad
655,Ringfietspad Zurenborgbrug,2023-08-15,13:00:00,245,111,134,FMN 06 B Zurenborgbrug Ringfietspad
655,Ringfietspad Zurenborgbrug,2023-08-15,14:00:00,261,133,128,FMN 06 B Zurenborgbrug Ringfietspad
655,Ringfietspad Zurenborgbrug,2023-08-15,15:00:00,257,113,144,FMN 06 B Zurenborgbrug Ringfietspad
655,Ringfietspad Zurenborgbrug,2023-08-15,16:00:00,265,128,137,FMN 06 B Zurenborgbrug Ringfietspad
655,Ringfietspad Zurenborgbrug,2023-08-15,17:00:00,209,108,101,FMN 06 B Zurenborgbrug Ringfietspad
655,Ringfietspad Zurenborgbrug,2023-08-15,18:00:00,166,78,88,FMN 06 B Zurenborgbrug Ringfietspad
655,Ringfietspad Zurenborgbrug,2023-08-15,19:00:00,143,73,70,FMN 06 B Zurenborgbrug Ringfietspad
655,Ringfietspad Zurenborgbrug,2023-08-15,20:00:00,119,61,58,FMN 06 B Zurenborgbrug Ringfietspad
655,Ringfietspad Zurenborgbrug,2023-08-15,21:00:00,89,47,42,FMN 06 B Zurenborgbrug Ringfietspad
655,Ringfietspad Zurenborgbrug,2023-08-15,22:00:00,40,14,26,FMN 06 B Zurenborgbrug Ringfietspad
655,Ringfietspad Zurenborgbrug,2023-08-15,23:00:00,39,10,29,FMN 06 B Zurenborgbrug Ringfietspad
655,Ringfietspad Zurenborgbrug,2023-08-16,00:00:00,21,12,9,FMN 06 B Zurenborgbrug Ringfietspad
655,Ringfietspad Zurenborgbrug,2023-08-16,01:00:00,8,4,4,FMN 06 B Zurenborgbrug Ringfietspad
655,Ringfietspad Zurenborgbrug,2023-08-16,02:00:00,6,4,2,FMN 06 B Zurenborgbrug Ringfietspad
655,Ringfietspad Zurenborgbrug,2023-08-16,03:00:00,8,2,6,FMN 06 B Zurenborgbrug Ringfietspad
655,Ringfietspad Zurenborgbrug,2023-08-16,04:00:00,16,9,7,FMN 06 B Zurenborgbrug Ringfietspad
655,Ringfietspad Zurenborgbrug,2023-08-16,05:00:00,51,33,18,FMN 06 B Zurenborgbrug Ringfietspad
655,Ringfietspad Zurenborgbrug,2023-08-16,06:00:00,145,83,62,FMN 06 B Zurenborgbrug Ringfietspad
655,Ringfietspad Zurenborgbrug,2023-08-16,07:00:00,329,204,125,FMN 06 B Zurenborgbrug Ringfietspad
655,Ringfietspad Zurenborgbrug,2023-08-16,08:00:00,400,224,176,FMN 06 B Zurenborgbrug Ringfietspad
655,Ringfietspad Zurenborgbrug,2023-08-16,09:00:00,150,86,64,FMN 06 B Zurenborgbrug Ringfietspad
655,Ringfietspad Zurenborgbrug,2023-08-16,10:00:00,99,49,50,FMN 06 B Zurenborgbrug Ringfietspad
655,Ringfietspad Zurenborgbrug,2023-08-16,11:00:00,115,55,60,FMN 06 B Zurenborgbrug Ringfietspad
655,Ringfietspad Zurenborgbrug,2023-08-16,12:00:00,160,70,90,FMN 06 B Zurenborgbrug Ringfietspad
655,Ringfietspad Zurenborgbrug,2023-08-16,13:00:00,161,77,84,FMN 06 B Zurenborgbrug Ringfietspad
655,Ringfietspad Zurenborgbrug,2023-08-16,14:00:00,198,83,115,FMN 06 B Zurenborgbrug Ringfietspad
655,Ringfietspad Zurenborgbrug,2023-08-16,15:00:00,228,86,142,FMN 06 B Zurenborgbrug Ringfietspad
655,Ringfietspad Zurenborgbrug,2023-08-16,16:00:00,412,174,238,FMN 06 B Zurenborgbrug Ringfietspad
655,Ringfietspad Zurenborgbrug,2023-08-16,17:00:00,496,190,306,FMN 06 B Zurenborgbrug Ringfietspad
655,Ringfietspad Zurenborgbrug,2023-08-16,18:00:00,317,123,194,FMN 06 B Zurenborgbrug Ringfietspad
655,Ringfietspad Zurenborgbrug,2023-08-16,19:00:00,182,58,124,FMN 06 B Zurenborgbrug Ringfietspad
655,Ringfietspad Zurenborgbrug,2023-08-16,20:00:00,122,48,74,FMN 06 B Zurenborgbrug Ringfietspad
655,Ringfietspad Zurenborgbrug,2023-08-16,21:00:00,135,64,71,FMN 06 B Zurenborgbrug Ringfietspad
655,Ringfietspad Zurenborgbrug,2023-08-16,22:00:00,71,39,32,FMN 06 B Zurenborgbrug Ringfietspad
655,Ringfietspad Zurenborgbrug,2023-08-16,23:00:00,42,23,19,FMN 06 B Zurenborgbrug Ringfietspad
655,Ringfietspad Zurenborgbrug,2023-08-17,00:00:00,19,7,12,FMN 06 B Zurenborgbrug Ringfietspad
655,Ringfietspad Zurenborgbrug,2023-08-17,01:00:00,10,6,4,FMN 06 B Zurenborgbrug Ringfietspad
655,Ringfietspad Zurenborgbrug,2023-08-17,02:00:00,2,0,2,FMN 06 B Zurenborgbrug Ringfietspad
655,Ringfietspad Zurenborgbrug,2023-08-17,03:00:00,11,6,5,FMN 06 B Zurenborgbrug Ringfietspad
655,Ringfietspad Zurenborgbrug,2023-08-17,04:00:00,15,10,5,FMN 06 B Zurenborgbrug Ringfietspad
655,Ringfietspad Zurenborgbrug,2023-08-17,05:00:00,50,30,20,FMN 06 B Zurenborgbrug Ringfietspad
655,Ringfietspad Zurenborgbrug,2023-08-17,06:00:00,155,84,71,FMN 06 B Zurenborgbrug Ringfietspad
655,Ringfietspad Zurenborgbrug,2023-08-17,07:00:00,343,225,118,FMN 06 B Zurenborgbrug Ringfietspad
655,Ringfietspad Zurenborgbrug,2023-08-17,08:00:00,467,271,196,FMN 06 B Zurenborgbrug Ringfietspad
655,Ringfietspad Zurenborgbrug,2023-08-17,09:00:00,162,83,79,FMN 06 B Zurenborgbrug Ringfietspad
655,Ringfietspad Zurenborgbrug,2023-08-17,10:00:00,124,64,60,FMN 06 B Zurenborgbrug Ringfietspad
655,Ringfietspad Zurenborgbrug,2023-08-17,11:00:00,126,66,60,FMN 06 B Zurenborgbrug Ringfietspad
655,Ringfietspad Zurenborgbrug,2023-08-17,12:00:00,174,87,87,FMN 06 B Zurenborgbrug Ringfietspad
655,Ringfietspad Zurenborgbrug,2023-08-17,13:00:00,195,95,100,FMN 06 B Zurenborgbrug Ringfietspad
655,Ringfietspad Zurenborgbrug,2023-08-17,14:00:00,181,84,97,FMN 06 B Zurenborgbrug Ringfietspad
655,Ringfietspad Zurenborgbrug,2023-08-17,15:00:00,255,100,155,FMN 06 B Zurenborgbrug Ringfietspad
655,Ringfietspad Zurenborgbrug,2023-08-17,16:00:00,430,180,250,FMN 06 B Zurenborgbrug Ringfietspad
655,Ringfietspad Zurenborgbrug,2023-08-17,17:00:00,454,167,287,FMN 06 B Zurenborgbrug Ringfietspad
655,Ringfietspad Zurenborgbrug,2023-08-17,18:00:00,308,113,195,FMN 06 B Zurenborgbrug Ringfietspad
655,Ringfietspad Zurenborgbrug,2023-08-17,19:00:00,173,69,104,FMN 06 B Zurenborgbrug Ringfietspad
655,Ringfietspad Zurenborgbrug,2023-08-17,20:00:00,134,70,64,FMN 06 B Zurenborgbrug Ringfietspad
655,Ringfietspad Zurenborgbrug,2023-08-17,21:00:00,73,29,44,FMN 06 B Zurenborgbrug Ringfietspad
655,Ringfietspad Zurenborgbrug,2023-08-17,22:00:00,63,28,35,FMN 06 B Zurenborgbrug Ringfietspad
655,Ringfietspad Zurenborgbrug,2023-08-17,23:00:00,39,21,18,FMN 06 B Zurenborgbrug Ringfietspad
655,Ringfietspad Zurenborgbrug,2023-08-18,00:00:00,23,10,13,FMN 06 B Zurenborgbrug Ringfietspad
655,Ringfietspad Zurenborgbrug,2023-08-18,01:00:00,15,3,12,FMN 06 B Zurenborgbrug Ringfietspad
655,Ringfietspad Zurenborgbrug,2023-08-18,02:00:00,9,3,6,FMN 06 B Zurenborgbrug Ringfietspad
655,Ringfietspad Zurenborgbrug,2023-08-18,03:00:00,4,3,1,FMN 06 B Zurenborgbrug Ringfietspad
655,Ringfietspad Zurenborgbrug,2023-08-18,04:00:00,16,12,4,FMN 06 B Zurenborgbrug Ringfietspad
655,Ringfietspad Zurenborgbrug,2023-08-18,05:00:00,58,36,22,FMN 06 B Zurenborgbrug Ringfietspad
655,Ringfietspad Zurenborgbrug,2023-08-18,06:00:00,137,72,65,FMN 06 B Zurenborgbrug Ringfietspad
655,Ringfietspad Zurenborgbrug,2023-08-18,07:00:00,264,148,116,FMN 06 B Zurenborgbrug Ringfietspad
655,Ringfietspad Zurenborgbrug,2023-08-18,08:00:00,323,174,149,FMN 06 B Zurenborgbrug Ringfietspad
655,Ringfietspad Zurenborgbrug,2023-08-18,09:00:00,188,99,89,FMN 06 B Zurenborgbrug Ringfietspad
655,Ringfietspad Zurenborgbrug,2023-08-18,10:00:00,128,61,67,FMN 06 B Zurenborgbrug Ringfietspad
655,Ringfietspad Zurenborgbrug,2023-08-18,11:00:00,150,74,76,FMN 06 B Zurenborgbrug Ringfietspad
655,Ringfietspad Zurenborgbrug,2023-08-18,12:00:00,210,87,123,FMN 06 B Zurenborgbrug Ringfietspad
655,Ringfietspad Zurenborgbrug,2023-08-18,13:00:00,253,105,148,FMN 06 B Zurenborgbrug Ringfietspad
655,Ringfietspad Zurenborgbrug,2023-08-18,14:00:00,241,120,121,FMN 06 B Zurenborgbrug Ringfietspad
655,Ringfietspad Zurenborgbrug,2023-08-18,15:00:00,280,145,135,FMN 06 B Zurenborgbrug Ringfietspad
655,Ringfietspad Zurenborgbrug,2023-08-18,16:00:00,408,174,234,FMN 06 B Zurenborgbrug Ringfietspad
655,Ringfietspad Zurenborgbrug,2023-08-18,17:00:00,390,161,229,FMN 06 B Zurenborgbrug Ringfietspad
655,Ringfietspad Zurenborgbrug,2023-08-18,18:00:00,312,123,189,FMN 06 B Zurenborgbrug Ringfietspad
655,Ringfietspad Zurenborgbrug,2023-08-18,19:00:00,227,83,144,FMN 06 B Zurenborgbrug Ringfietspad
655,Ringfietspad Zurenborgbrug,2023-08-18,20:00:00,142,67,75,FMN 06 B Zurenborgbrug Ringfietspad
655,Ringfietspad Zurenborgbrug,2023-08-18,21:00:00,97,45,52,FMN 06 B Zurenborgbrug Ringfietspad
655,Ringfietspad Zurenborgbrug,2023-08-18,22:00:00,80,36,44,FMN 06 B Zurenborgbrug Ringfietspad
655,Ringfietspad Zurenborgbrug,2023-08-18,23:00:00,116,88,28,FMN 06 B Zurenborgbrug Ringfietspad
655,Ringfietspad Zurenborgbrug,2023-08-19,00:00:00,81,54,27,FMN 06 B Zurenborgbrug Ringfietspad
655,Ringfietspad Zurenborgbrug,2023-08-19,01:00:00,27,14,13,FMN 06 B Zurenborgbrug Ringfietspad
655,Ringfietspad Zurenborgbrug,2023-08-19,02:00:00,15,10,5,FMN 06 B Zurenborgbrug Ringfietspad
655,Ringfietspad Zurenborgbrug,2023-08-19,03:00:00,4,1,3,FMN 06 B Zurenborgbrug Ringfietspad
655,Ringfietspad Zurenborgbrug,2023-08-19,04:00:00,9,6,3,FMN 06 B Zurenborgbrug Ringfietspad
655,Ringfietspad Zurenborgbrug,2023-08-19,05:00:00,15,4,11,FMN 06 B Zurenborgbrug Ringfietspad
655,Ringfietspad Zurenborgbrug,2023-08-19,06:00:00,31,12,19,FMN 06 B Zurenborgbrug Ringfietspad
655,Ringfietspad Zurenborgbrug,2023-08-19,07:00:00,38,19,19,FMN 06 B Zurenborgbrug Ringfietspad
655,Ringfietspad Zurenborgbrug,2023-08-19,08:00:00,71,32,39,FMN 06 B Zurenborgbrug Ringfietspad
655,Ringfietspad Zurenborgbrug,2023-08-19,09:00:00,107,61,46,FMN 06 B Zurenborgbrug Ringfietspad
655,Ringfietspad Zurenborgbrug,2023-08-19,10:00:00,117,59,58,FMN 06 B Zurenborgbrug Ringfietspad
655,Ringfietspad Zurenborgbrug,2023-08-19,11:00:00,168,74,94,FMN 06 B Zurenborgbrug Ringfietspad
655,Ringfietspad Zurenborgbrug,2023-08-19,12:00:00,151,76,75,FMN 06 B Zurenborgbrug Ringfietspad
655,Ringfietspad Zurenborgbrug,2023-08-19,13:00:00,182,83,99,FMN 06 B Zurenborgbrug Ringfietspad
655,Ringfietspad Zurenborgbrug,2023-08-19,14:00:00,179,61,118,FMN 06 B Zurenborgbrug Ringfietspad
655,Ringfietspad Zurenborgbrug,2023-08-19,15:00:00,211,101,110,FMN 06 B Zurenborgbrug Ringfietspad
655,Ringfietspad Zurenborgbrug,2023-08-19,16:00:00,191,84,107,FMN 06 B Zurenborgbrug Ringfietspad
655,Ringfietspad Zurenborgbrug,2023-08-19,17:00:00,159,60,99,FMN 06 B Zurenborgbrug Ringfietspad
655,Ringfietspad Zurenborgbrug,2023-08-19,18:00:00,177,73,104,FMN 06 B Zurenborgbrug Ringfietspad
655,Ringfietspad Zurenborgbrug,2023-08-19,19:00:00,175,64,111,FMN 06 B Zurenborgbrug Ringfietspad
655,Ringfietspad Zurenborgbrug,2023-08-19,20:00:00,123,39,84,FMN 06 B Zurenborgbrug Ringfietspad
655,Ringfietspad Zurenborgbrug,2023-08-19,21:00:00,86,41,45,FMN 06 B Zurenborgbrug Ringfietspad
655,Ringfietspad Zurenborgbrug,2023-08-19,22:00:00,96,70,26,FMN 06 B Zurenborgbrug Ringfietspad
655,Ringfietspad Zurenborgbrug,2023-08-19,23:00:00,75,50,25,FMN 06 B Zurenborgbrug Ringfietspad
655,Ringfietspad Zurenborgbrug,2023-08-20,00:00:00,66,44,22,FMN 06 B Zurenborgbrug Ringfietspad
655,Ringfietspad Zurenborgbrug,2023-08-20,01:00:00,27,11,16,FMN 06 B Zurenborgbrug Ringfietspad
655,Ringfietspad Zurenborgbrug,2023-08-20,02:00:00,7,3,4,FMN 06 B Zurenborgbrug Ringfietspad
655,Ringfietspad Zurenborgbrug,2023-08-20,03:00:00,11,6,5,FMN 06 B Zurenborgbrug Ringfietspad
655,Ringfietspad Zurenborgbrug,2023-08-20,04:00:00,10,5,5,FMN 06 B Zurenborgbrug Ringfietspad
655,Ringfietspad Zurenborgbrug,2023-08-20,05:00:00,14,3,11,FMN 06 B Zurenborgbrug Ringfietspad
655,Ringfietspad Zurenborgbrug,2023-08-20,06:00:00,27,17,10,FMN 06 B Zurenborgbrug Ringfietspad
655,Ringfietspad Zurenborgbrug,2023-08-20,07:00:00,36,17,19,FMN 06 B Zurenborgbrug Ringfietspad
655,Ringfietspad Zurenborgbrug,2023-08-20,08:00:00,66,20,46,FMN 06 B Zurenborgbrug Ringfietspad
655,Ringfietspad Zurenborgbrug,2023-08-20,09:00:00,139,62,77,FMN 06 B Zurenborgbrug Ringfietspad
655,Ringfietspad Zurenborgbrug,2023-08-20,10:00:00,184,92,92,FMN 06 B Zurenborgbrug Ringfietspad
655,Ringfietspad Zurenborgbrug,2023-08-20,11:00:00,227,118,109,FMN 06 B Zurenborgbrug Ringfietspad
655,Ringfietspad Zurenborgbrug,2023-08-20,12:00:00,231,141,90,FMN 06 B Zurenborgbrug Ringfietspad
655,Ringfietspad Zurenborgbrug,2023-08-20,13:00:00,261,112,149,FMN 06 B Zurenborgbrug Ringfietspad
655,Ringfietspad Zurenborgbrug,2023-08-20,14:00:00,313,125,188,FMN 06 B Zurenborgbrug Ringfietspad
655,Ringfietspad Zurenborgbrug,2023-08-20,15:00:00,249,111,138,FMN 06 B Zurenborgbrug Ringfietspad
655,Ringfietspad Zurenborgbrug,2023-08-20,16:00:00,244,112,132,FMN 06 B Zurenborgbrug Ringfietspad
655,Ringfietspad Zurenborgbrug,2023-08-20,17:00:00,220,104,116,FMN 06 B Zurenborgbrug Ringfietspad
655,Ringfietspad Zurenborgbrug,2023-08-20,18:00:00,183,77,106,FMN 06 B Zurenborgbrug Ringfietspad
655,Ringfietspad Zurenborgbrug,2023-08-20,19:00:00,239,80,159,FMN 06 B Zurenborgbrug Ringfietspad
655,Ringfietspad Zurenborgbrug,2023-08-20,20:00:00,125,64,61,FMN 06 B Zurenborgbrug Ringfietspad
655,Ringfietspad Zurenborgbrug,2023-08-20,21:00:00,116,43,73,FMN 06 B Zurenborgbrug Ringfietspad
655,Ringfietspad Zurenborgbrug,2023-08-20,22:00:00,103,79,24,FMN 06 B Zurenborgbrug Ringfietspad
655,Ringfietspad Zurenborgbrug,2023-08-20,23:00:00,58,39,19,FMN 06 B Zurenborgbrug Ringfietspad
655,Ringfietspad Zurenborgbrug,2023-08-21,00:00:00,11,7,4,FMN 06 B Zurenborgbrug Ringfietspad
655,Ringfietspad Zurenborgbrug,2023-08-21,01:00:00,5,2,3,FMN 06 B Zurenborgbrug Ringfietspad
655,Ringfietspad Zurenborgbrug,2023-08-21,02:00:00,11,3,8,FMN 06 B Zurenborgbrug Ringfietspad
655,Ringfietspad Zurenborgbrug,2023-08-21,03:00:00,7,3,4,FMN 06 B Zurenborgbrug Ringfietspad
655,Ringfietspad Zurenborgbrug,2023-08-21,04:00:00,24,17,7,FMN 06 B Zurenborgbrug Ringfietspad
655,Ringfietspad Zurenborgbrug,2023-08-21,05:00:00,62,45,17,FMN 06 B Zurenborgbrug Ringfietspad
655,Ringfietspad Zurenborgbrug,2023-08-21,06:00:00,193,103,90,FMN 06 B Zurenborgbrug Ringfietspad
655,Ringfietspad Zurenborgbrug,2023-08-21,07:00:00,364,228,136,FMN 06 B Zurenborgbrug Ringfietspad
655,Ringfietspad Zurenborgbrug,2023-08-21,08:00:00,509,293,216,FMN 06 B Zurenborgbrug Ringfietspad
655,Ringfietspad Zurenborgbrug,2023-08-21,09:00:00,215,126,89,FMN 06 B Zurenborgbrug Ringfietspad
655,Ringfietspad Zurenborgbrug,2023-08-21,10:00:00,150,76,74,FMN 06 B Zurenborgbrug Ringfietspad
655,Ringfietspad Zurenborgbrug,2023-08-21,11:00:00,132,66,66,FMN 06 B Zurenborgbrug Ringfietspad
655,Ringfietspad Zurenborgbrug,2023-08-21,12:00:00,191,102,89,FMN 06 B Zurenborgbrug Ringfietspad
655,Ringfietspad Zurenborgbrug,2023-08-21,13:00:00,198,96,102,FMN 06 B Zurenborgbrug Ringfietspad
655,Ringfietspad Zurenborgbrug,2023-08-21,14:00:00,207,88,119,FMN 06 B Zurenborgbrug Ringfietspad
655,Ringfietspad Zurenborgbrug,2023-08-21,15:00:00,268,112,156,FMN 06 B Zurenborgbrug Ringfietspad
655,Ringfietspad Zurenborgbrug,2023-08-21,16:00:00,521,220,301,FMN 06 B Zurenborgbrug Ringfietspad
655,Ringfietspad Zurenborgbrug,2023-08-21,17:00:00,568,234,334,FMN 06 B Zurenborgbrug Ringfietspad
655,Ringfietspad Zurenborgbrug,2023-08-21,18:00:00,311,129,182,FMN 06 B Zurenborgbrug Ringfietspad
655,Ringfietspad Zurenborgbrug,2023-08-21,19:00:00,217,96,121,FMN 06 B Zurenborgbrug Ringfietspad
655,Ringfietspad Zurenborgbrug,2023-08-21,20:00:00,168,80,88,FMN 06 B Zurenborgbrug Ringfietspad
655,Ringfietspad Zurenborgbrug,2023-08-21,21:00:00,114,33,81,FMN 06 B Zurenborgbrug Ringfietspad
655,Ringfietspad Zurenborgbrug,2023-08-21,22:00:00,95,41,54,FMN 06 B Zurenborgbrug Ringfietspad
655,Ringfietspad Zurenborgbrug,2023-08-21,23:00:00,31,9,22,FMN 06 B Zurenborgbrug Ringfietspad
655,Ringfietspad Zurenborgbrug,2023-08-22,00:00:00,19,11,8,FMN 06 B Zurenborgbrug Ringfietspad
655,Ringfietspad Zurenborgbrug,2023-08-22,01:00:00,13,7,6,FMN 06 B Zurenborgbrug Ringfietspad
655,Ringfietspad Zurenborgbrug,2023-08-22,02:00:00,2,0,2,FMN 06 B Zurenborgbrug Ringfietspad
655,Ringfietspad Zurenborgbrug,2023-08-22,03:00:00,4,3,1,FMN 06 B Zurenborgbrug Ringfietspad
655,Ringfietspad Zurenborgbrug,2023-08-22,04:00:00,23,17,6,FMN 06 B Zurenborgbrug Ringfietspad
655,Ringfietspad Zurenborgbrug,2023-08-22,05:00:00,74,39,35,FMN 06 B Zurenborgbrug Ringfietspad
655,Ringfietspad Zurenborgbrug,2023-08-22,06:00:00,201,111,90,FMN 06 B Zurenborgbrug Ringfietspad
655,Ringfietspad Zurenborgbrug,2023-08-22,07:00:00,462,310,152,FMN 06 B Zurenborgbrug Ringfietspad
655,Ringfietspad Zurenborgbrug,2023-08-22,08:00:00,572,324,248,FMN 06 B Zurenborgbrug Ringfietspad
655,Ringfietspad Zurenborgbrug,2023-08-22,09:00:00,253,135,118,FMN 06 B Zurenborgbrug Ringfietspad
655,Ringfietspad Zurenborgbrug,2023-08-22,10:00:00,155,62,93,FMN 06 B Zurenborgbrug Ringfietspad
655,Ringfietspad Zurenborgbrug,2023-08-22,11:00:00,162,83,79,FMN 06 B Zurenborgbrug Ringfietspad
655,Ringfietspad Zurenborgbrug,2023-08-22,12:00:00,210,91,119,FMN 06 B Zurenborgbrug Ringfietspad
655,Ringfietspad Zurenborgbrug,2023-08-22,13:00:00,215,103,112,FMN 06 B Zurenborgbrug Ringfietspad
655,Ringfietspad Zurenborgbrug,2023-08-22,14:00:00,229,99,130,FMN 06 B Zurenborgbrug Ringfietspad
655,Ringfietspad Zurenborgbrug,2023-08-22,15:00:00,314,143,171,FMN 06 B Zurenborgbrug Ringfietspad
655,Ringfietspad Zurenborgbrug,2023-08-22,16:00:00,525,221,304,FMN 06 B Zurenborgbrug Ringfietspad
655,Ringfietspad Zurenborgbrug,2023-08-22,17:00:00,645,239,406,FMN 06 B Zurenborgbrug Ringfietspad
655,Ringfietspad Zurenborgbrug,2023-08-22,18:00:00,397,144,253,FMN 06 B Zurenborgbrug Ringfietspad
655,Ringfietspad Zurenborgbrug,2023-08-22,19:00:00,371,90,281,FMN 06 B Zurenborgbrug Ringfietspad
655,Ringfietspad Zurenborgbrug,2023-08-22,20:00:00,228,83,145,FMN 06 B Zurenborgbrug Ringfietspad
655,Ringfietspad Zurenborgbrug,2023-08-22,21:00:00,137,72,65,FMN 06 B Zurenborgbrug Ringfietspad
655,Ringfietspad Zurenborgbrug,2023-08-22,22:00:00,123,63,60,FMN 06 B Zurenborgbrug Ringfietspad
655,Ringfietspad Zurenborgbrug,2023-08-22,23:00:00,177,157,20,FMN 06 B Zurenborgbrug Ringfietspad
655,Ringfietspad Zurenborgbrug,2023-08-23,00:00:00,63,50,13,FMN 06 B Zurenborgbrug Ringfietspad
655,Ringfietspad Zurenborgbrug,2023-08-23,01:00:00,14,9,5,FMN 06 B Zurenborgbrug Ringfietspad
655,Ringfietspad Zurenborgbrug,2023-08-23,02:00:00,4,3,1,FMN 06 B Zurenborgbrug Ringfietspad
655,Ringfietspad Zurenborgbrug,2023-08-23,03:00:00,9,4,5,FMN 06 B Zurenborgbrug Ringfietspad
655,Ringfietspad Zurenborgbrug,2023-08-23,04:00:00,20,13,7,FMN 06 B Zurenborgbrug Ringfietspad
655,Ringfietspad Zurenborgbrug,2023-08-23,05:00:00,60,34,26,FMN 06 B Zurenborgbrug Ringfietspad
655,Ringfietspad Zurenborgbrug,2023-08-23,06:00:00,165,92,73,FMN 06 B Zurenborgbrug Ringfietspad
655,Ringfietspad Zurenborgbrug,2023-08-23,07:00:00,371,226,145,FMN 06 B Zurenborgbrug Ringfietspad
655,Ringfietspad Zurenborgbrug,2023-08-23,08:00:00,474,254,220,FMN 06 B Zurenborgbrug Ringfietspad
655,Ringfietspad Zurenborgbrug,2023-08-23,09:00:00,199,103,96,FMN 06 B Zurenborgbrug Ringfietspad
655,Ringfietspad Zurenborgbrug,2023-08-23,10:00:00,146,72,74,FMN 06 B Zurenborgbrug Ringfietspad
655,Ringfietspad Zurenborgbrug,2023-08-23,11:00:00,182,94,88,FMN 06 B Zurenborgbrug Ringfietspad
655,Ringfietspad Zurenborgbrug,2023-08-23,12:00:00,243,120,123,FMN 06 B Zurenborgbrug Ringfietspad
655,Ringfietspad Zurenborgbrug,2023-08-23,13:00:00,228,116,112,FMN 06 B Zurenborgbrug Ringfietspad
655,Ringfietspad Zurenborgbrug,2023-08-23,14:00:00,243,98,145,FMN 06 B Zurenborgbrug Ringfietspad
655,Ringfietspad Zurenborgbrug,2023-08-23,15:00:00,318,128,190,FMN 06 B Zurenborgbrug Ringfietspad
655,Ringfietspad Zurenborgbrug,2023-08-23,16:00:00,533,209,324,FMN 06 B Zurenborgbrug Ringfietspad
655,Ringfietspad Zurenborgbrug,2023-08-23,17:00:00,547,232,315,FMN 06 B Zurenborgbrug Ringfietspad
655,Ringfietspad Zurenborgbrug,2023-08-23,18:00:00,431,153,278,FMN 06 B Zurenborgbrug Ringfietspad
655,Ringfietspad Zurenborgbrug,2023-08-23,19:00:00,261,109,152,FMN 06 B Zurenborgbrug Ringfietspad
655,Ringfietspad Zurenborgbrug,2023-08-23,20:00:00,206,70,136,FMN 06 B Zurenborgbrug Ringfietspad
655,Ringfietspad Zurenborgbrug,2023-08-23,21:00:00,140,75,65,FMN 06 B Zurenborgbrug Ringfietspad
655,Ringfietspad Zurenborgbrug,2023-08-23,22:00:00,116,57,59,FMN 06 B Zurenborgbrug Ringfietspad
655,Ringfietspad Zurenborgbrug,2023-08-23,23:00:00,117,82,35,FMN 06 B Zurenborgbrug Ringfietspad
655,Ringfietspad Zurenborgbrug,2023-08-24,00:00:00,25,14,11,FMN 06 B Zurenborgbrug Ringfietspad
655,Ringfietspad Zurenborgbrug,2023-08-24,01:00:00,10,5,5,FMN 06 B Zurenborgbrug Ringfietspad
655,Ringfietspad Zurenborgbrug,2023-08-24,02:00:00,3,0,3,FMN 06 B Zurenborgbrug Ringfietspad
655,Ringfietspad Zurenborgbrug,2023-08-24,03:00:00,7,5,2,FMN 06 B Zurenborgbrug Ringfietspad
655,Ringfietspad Zurenborgbrug,2023-08-24,04:00:00,21,13,8,FMN 06 B Zurenborgbrug Ringfietspad
655,Ringfietspad Zurenborgbrug,2023-08-24,05:00:00,54,33,21,FMN 06 B Zurenborgbrug Ringfietspad
655,Ringfietspad Zurenborgbrug,2023-08-24,06:00:00,171,93,78,FMN 06 B Zurenborgbrug Ringfietspad
655,Ringfietspad Zurenborgbrug,2023-08-24,07:00:00,365,252,113,FMN 06 B Zurenborgbrug Ringfietspad
655,Ringfietspad Zurenborgbrug,2023-08-24,08:00:00,521,288,233,FMN 06 B Zurenborgbrug Ringfietspad
655,Ringfietspad Zurenborgbrug,2023-08-24,09:00:00,205,109,96,FMN 06 B Zurenborgbrug Ringfietspad
655,Ringfietspad Zurenborgbrug,2023-08-24,10:00:00,125,65,60,FMN 06 B Zurenborgbrug Ringfietspad
655,Ringfietspad Zurenborgbrug,2023-08-24,11:00:00,137,77,60,FMN 06 B Zurenborgbrug Ringfietspad
655,Ringfietspad Zurenborgbrug,2023-08-24,12:00:00,103,48,55,FMN 06 B Zurenborgbrug Ringfietspad
655,Ringfietspad Zurenborgbrug,2023-08-24,13:00:00,137,70,67,FMN 06 B Zurenborgbrug Ringfietspad
655,Ringfietspad Zurenborgbrug,2023-08-24,14:00:00,152,74,78,FMN 06 B Zurenborgbrug Ringfietspad
655,Ringfietspad Zurenborgbrug,2023-08-24,15:00:00,220,84,136,FMN 06 B Zurenborgbrug Ringfietspad
655,Ringfietspad Zurenborgbrug,2023-08-24,16:00:00,393,156,237,FMN 06 B Zurenborgbrug Ringfietspad
655,Ringfietspad Zurenborgbrug,2023-08-24,17:00:00,507,180,327,FMN 06 B Zurenborgbrug Ringfietspad
655,Ringfietspad Zurenborgbrug,2023-08-24,18:00:00,312,112,200,FMN 06 B Zurenborgbrug Ringfietspad
655,Ringfietspad Zurenborgbrug,2023-08-24,19:00:00,229,85,144,FMN 06 B Zurenborgbrug Ringfietspad
655,Ringfietspad Zurenborgbrug,2023-08-24,20:00:00,168,65,103,FMN 06 B Zurenborgbrug Ringfietspad
655,Ringfietspad Zurenborgbrug,2023-08-24,21:00:00,99,43,56,FMN 06 B Zurenborgbrug Ringfietspad
655,Ringfietspad Zurenborgbrug,2023-08-24,22:00:00,85,41,44,FMN 06 B Zurenborgbrug Ringfietspad
655,Ringfietspad Zurenborgbrug,2023-08-24,23:00:00,101,77,24,FMN 06 B Zurenborgbrug Ringfietspad
655,Ringfietspad Zurenborgbrug,2023-08-25,00:00:00,32,24,8,FMN 06 B Zurenborgbrug Ringfietspad
655,Ringfietspad Zurenborgbrug,2023-08-25,01:00:00,10,2,8,FMN 06 B Zurenborgbrug Ringfietspad
655,Ringfietspad Zurenborgbrug,2023-08-25,02:00:00,3,2,1,FMN 06 B Zurenborgbrug Ringfietspad
655,Ringfietspad Zurenborgbrug,2023-08-25,03:00:00,2,2,0,FMN 06 B Zurenborgbrug Ringfietspad
655,Ringfietspad Zurenborgbrug,2023-08-25,04:00:00,18,13,5,FMN 06 B Zurenborgbrug Ringfietspad
655,Ringfietspad Zurenborgbrug,2023-08-25,05:00:00,53,29,24,FMN 06 B Zurenborgbrug Ringfietspad
655,Ringfietspad Zurenborgbrug,2023-08-25,06:00:00,125,70,55,FMN 06 B Zurenborgbrug Ringfietspad
655,Ringfietspad Zurenborgbrug,2023-08-25,07:00:00,237,140,97,FMN 06 B Zurenborgbrug Ringfietspad
655,Ringfietspad Zurenborgbrug,2023-08-25,08:00:00,318,202,116,FMN 06 B Zurenborgbrug Ringfietspad
655,Ringfietspad Zurenborgbrug,2023-08-25,09:00:00,144,87,57,FMN 06 B Zurenborgbrug Ringfietspad
655,Ringfietspad Zurenborgbrug,2023-08-25,10:00:00,112,55,57,FMN 06 B Zurenborgbrug Ringfietspad
655,Ringfietspad Zurenborgbrug,2023-08-25,11:00:00,100,50,50,FMN 06 B Zurenborgbrug Ringfietspad
655,Ringfietspad Zurenborgbrug,2023-08-25,12:00:00,135,64,71,FMN 06 B Zurenborgbrug Ringfietspad
655,Ringfietspad Zurenborgbrug,2023-08-25,13:00:00,146,58,88,FMN 06 B Zurenborgbrug Ringfietspad
655,Ringfietspad Zurenborgbrug,2023-08-25,14:00:00,161,61,100,FMN 06 B Zurenborgbrug Ringfietspad
655,Ringfietspad Zurenborgbrug,2023-08-25,15:00:00,210,83,127,FMN 06 B Zurenborgbrug Ringfietspad
655,Ringfietspad Zurenborgbrug,2023-08-25,16:00:00,330,133,197,FMN 06 B Zurenborgbrug Ringfietspad
655,Ringfietspad Zurenborgbrug,2023-08-25,17:00:00,291,113,178,FMN 06 B Zurenborgbrug Ringfietspad
655,Ringfietspad Zurenborgbrug,2023-08-25,18:00:00,236,84,152,FMN 06 B Zurenborgbrug Ringfietspad
655,Ringfietspad Zurenborgbrug,2023-08-25,19:00:00,153,58,95,FMN 06 B Zurenborgbrug Ringfietspad
655,Ringfietspad Zurenborgbrug,2023-08-25,20:00:00,130,36,94,FMN 06 B Zurenborgbrug Ringfietspad
655,Ringfietspad Zurenborgbrug,2023-08-25,21:00:00,79,48,31,FMN 06 B Zurenborgbrug Ringfietspad
655,Ringfietspad Zurenborgbrug,2023-08-25,22:00:00,60,32,28,FMN 06 B Zurenborgbrug Ringfietspad
655,Ringfietspad Zurenborgbrug,2023-08-25,23:00:00,75,48,27,FMN 06 B Zurenborgbrug Ringfietspad
655,Ringfietspad Zurenborgbrug,2023-08-26,00:00:00,55,42,13,FMN 06 B Zurenborgbrug Ringfietspad
655,Ringfietspad Zurenborgbrug,2023-08-26,01:00:00,31,13,18,FMN 06 B Zurenborgbrug Ringfietspad
655,Ringfietspad Zurenborgbrug,2023-08-26,02:00:00,9,2,7,FMN 06 B Zurenborgbrug Ringfietspad
655,Ringfietspad Zurenborgbrug,2023-08-26,03:00:00,10,3,7,FMN 06 B Zurenborgbrug Ringfietspad
655,Ringfietspad Zurenborgbrug,2023-08-26,04:00:00,8,7,1,FMN 06 B Zurenborgbrug Ringfietspad
655,Ringfietspad Zurenborgbrug,2023-08-26,05:00:00,18,10,8,FMN 06 B Zurenborgbrug Ringfietspad
655,Ringfietspad Zurenborgbrug,2023-08-26,06:00:00,24,15,9,FMN 06 B Zurenborgbrug Ringfietspad
655,Ringfietspad Zurenborgbrug,2023-08-26,07:00:00,50,30,20,FMN 06 B Zurenborgbrug Ringfietspad
655,Ringfietspad Zurenborgbrug,2023-08-26,08:00:00,70,33,37,FMN 06 B Zurenborgbrug Ringfietspad
655,Ringfietspad Zurenborgbrug,2023-08-26,09:00:00,123,51,72,FMN 06 B Zurenborgbrug Ringfietspad
655,Ringfietspad Zurenborgbrug,2023-08-26,10:00:00,123,61,62,FMN 06 B Zurenborgbrug Ringfietspad
655,Ringfietspad Zurenborgbrug,2023-08-26,11:00:00,134,60,74,FMN 06 B Zurenborgbrug Ringfietspad
655,Ringfietspad Zurenborgbrug,2023-08-26,12:00:00,136,75,61,FMN 06 B Zurenborgbrug Ringfietspad
655,Ringfietspad Zurenborgbrug,2023-08-26,13:00:00,184,73,111,FMN 06 B Zurenborgbrug Ringfietspad
655,Ringfietspad Zurenborgbrug,2023-08-26,14:00:00,200,97,103,FMN 06 B Zurenborgbrug Ringfietspad
655,Ringfietspad Zurenborgbrug,2023-08-26,15:00:00,148,49,99,FMN 06 B Zurenborgbrug Ringfietspad
655,Ringfietspad Zurenborgbrug,2023-08-26,16:00:00,162,74,88,FMN 06 B Zurenborgbrug Ringfietspad
655,Ringfietspad Zurenborgbrug,2023-08-26,17:00:00,123,66,57,FMN 06 B Zurenborgbrug Ringfietspad
655,Ringfietspad Zurenborgbrug,2023-08-26,18:00:00,138,54,84,FMN 06 B Zurenborgbrug Ringfietspad
655,Ringfietspad Zurenborgbrug,2023-08-26,19:00:00,145,38,107,FMN 06 B Zurenborgbrug Ringfietspad
655,Ringfietspad Zurenborgbrug,2023-08-26,20:00:00,113,34,79,FMN 06 B Zurenborgbrug Ringfietspad
655,Ringfietspad Zurenborgbrug,2023-08-26,21:00:00,77,34,43,FMN 06 B Zurenborgbrug Ringfietspad
655,Ringfietspad Zurenborgbrug,2023-08-26,22:00:00,53,27,26,FMN 06 B Zurenborgbrug Ringfietspad
655,Ringfietspad Zurenborgbrug,2023-08-26,23:00:00,90,70,20,FMN 06 B Zurenborgbrug Ringfietspad
655,Ringfietspad Zurenborgbrug,2023-08-27,00:00:00,76,62,14,FMN 06 B Zurenborgbrug Ringfietspad
655,Ringfietspad Zurenborgbrug,2023-08-27,01:00:00,27,14,13,FMN 06 B Zurenborgbrug Ringfietspad
655,Ringfietspad Zurenborgbrug,2023-08-27,02:00:00,19,12,7,FMN 06 B Zurenborgbrug Ringfietspad
655,Ringfietspad Zurenborgbrug,2023-08-27,03:00:00,8,4,4,FMN 06 B Zurenborgbrug Ringfietspad
655,Ringfietspad Zurenborgbrug,2023-08-27,04:00:00,7,5,2,FMN 06 B Zurenborgbrug Ringfietspad
655,Ringfietspad Zurenborgbrug,2023-08-27,05:00:00,9,5,4,FMN 06 B Zurenborgbrug Ringfietspad
655,Ringfietspad Zurenborgbrug,2023-08-27,06:00:00,15,10,5,FMN 06 B Zurenborgbrug Ringfietspad
655,Ringfietspad Zurenborgbrug,2023-08-27,07:00:00,36,18,18,FMN 06 B Zurenborgbrug Ringfietspad
655,Ringfietspad Zurenborgbrug,2023-08-27,08:00:00,54,26,28,FMN 06 B Zurenborgbrug Ringfietspad
655,Ringfietspad Zurenborgbrug,2023-08-27,09:00:00,97,47,50,FMN 06 B Zurenborgbrug Ringfietspad
655,Ringfietspad Zurenborgbrug,2023-08-27,10:00:00,110,57,53,FMN 06 B Zurenborgbrug Ringfietspad
655,Ringfietspad Zurenborgbrug,2023-08-27,11:00:00,183,106,77,FMN 06 B Zurenborgbrug Ringfietspad
655,Ringfietspad Zurenborgbrug,2023-08-27,12:00:00,157,72,85,FMN 06 B Zurenborgbrug Ringfietspad
655,Ringfietspad Zurenborgbrug,2023-08-27,13:00:00,131,70,61,FMN 06 B Zurenborgbrug Ringfietspad
655,Ringfietspad Zurenborgbrug,2023-08-27,14:00:00,158,86,72,FMN 06 B Zurenborgbrug Ringfietspad
655,Ringfietspad Zurenborgbrug,2023-08-27,15:00:00,73,37,36,FMN 06 B Zurenborgbrug Ringfietspad
655,Ringfietspad Zurenborgbrug,2023-08-27,16:00:00,105,38,67,FMN 06 B Zurenborgbrug Ringfietspad
655,Ringfietspad Zurenborgbrug,2023-08-27,17:00:00,137,52,85,FMN 06 B Zurenborgbrug Ringfietspad
655,Ringfietspad Zurenborgbrug,2023-08-27,18:00:00,117,47,70,FMN 06 B Zurenborgbrug Ringfietspad
655,Ringfietspad Zurenborgbrug,2023-08-27,19:00:00,160,44,116,FMN 06 B Zurenborgbrug Ringfietspad
655,Ringfietspad Zurenborgbrug,2023-08-27,20:00:00,123,33,90,FMN 06 B Zurenborgbrug Ringfietspad
655,Ringfietspad Zurenborgbrug,2023-08-27,21:00:00,40,19,21,FMN 06 B Zurenborgbrug Ringfietspad
655,Ringfietspad Zurenborgbrug,2023-08-27,22:00:00,58,25,33,FMN 06 B Zurenborgbrug Ringfietspad
655,Ringfietspad Zurenborgbrug,2023-08-27,23:00:00,106,93,13,FMN 06 B Zurenborgbrug Ringfietspad
655,Ringfietspad Zurenborgbrug,2023-08-28,00:00:00,31,24,7,FMN 06 B Zurenborgbrug Ringfietspad
655,Ringfietspad Zurenborgbrug,2023-08-28,01:00:00,3,2,1,FMN 06 B Zurenborgbrug Ringfietspad
655,Ringfietspad Zurenborgbrug,2023-08-28,02:00:00,4,1,3,FMN 06 B Zurenborgbrug Ringfietspad
655,Ringfietspad Zurenborgbrug,2023-08-28,03:00:00,1,1,0,FMN 06 B Zurenborgbrug Ringfietspad
655,Ringfietspad Zurenborgbrug,2023-08-28,04:00:00,16,6,10,FMN 06 B Zurenborgbrug Ringfietspad
655,Ringfietspad Zurenborgbrug,2023-08-28,05:00:00,52,30,22,FMN 06 B Zurenborgbrug Ringfietspad
655,Ringfietspad Zurenborgbrug,2023-08-28,06:00:00,169,100,69,FMN 06 B Zurenborgbrug Ringfietspad
655,Ringfietspad Zurenborgbrug,2023-08-28,07:00:00,348,221,127,FMN 06 B Zurenborgbrug Ringfietspad
655,Ringfietspad Zurenborgbrug,2023-08-28,08:00:00,485,266,219,FMN 06 B Zurenborgbrug Ringfietspad
655,Ringfietspad Zurenborgbrug,2023-08-28,09:00:00,201,114,87,FMN 06 B Zurenborgbrug Ringfietspad
655,Ringfietspad Zurenborgbrug,2023-08-28,10:00:00,105,47,58,FMN 06 B Zurenborgbrug Ringfietspad
655,Ringfietspad Zurenborgbrug,2023-08-28,11:00:00,138,75,63,FMN 06 B Zurenborgbrug Ringfietspad
655,Ringfietspad Zurenborgbrug,2023-08-28,12:00:00,186,87,99,FMN 06 B Zurenborgbrug Ringfietspad
655,Ringfietspad Zurenborgbrug,2023-08-28,13:00:00,179,91,88,FMN 06 B Zurenborgbrug Ringfietspad
655,Ringfietspad Zurenborgbrug,2023-08-28,14:00:00,184,89,95,FMN 06 B Zurenborgbrug Ringfietspad
655,Ringfietspad Zurenborgbrug,2023-08-28,15:00:00,262,96,166,FMN 06 B Zurenborgbrug Ringfietspad
655,Ringfietspad Zurenborgbrug,2023-08-28,16:00:00,435,180,255,FMN 06 B Zurenborgbrug Ringfietspad
655,Ringfietspad Zurenborgbrug,2023-08-28,17:00:00,474,187,287,FMN 06 B Zurenborgbrug Ringfietspad
655,Ringfietspad Zurenborgbrug,2023-08-28,18:00:00,224,89,135,FMN 06 B Zurenborgbrug Ringfietspad
655,Ringfietspad Zurenborgbrug,2023-08-28,19:00:00,134,52,82,FMN 06 B Zurenborgbrug Ringfietspad
655,Ringfietspad Zurenborgbrug,2023-08-28,20:00:00,74,31,43,FMN 06 B Zurenborgbrug Ringfietspad
655,Ringfietspad Zurenborgbrug,2023-08-28,21:00:00,62,19,43,FMN 06 B Zurenborgbrug Ringfietspad
655,Ringfietspad Zurenborgbrug,2023-08-28,22:00:00,76,20,56,FMN 06 B Zurenborgbrug Ringfietspad
655,Ringfietspad Zurenborgbrug,2023-08-28,23:00:00,28,9,19,FMN 06 B Zurenborgbrug Ringfietspad
655,Ringfietspad Zurenborgbrug,2023-08-29,00:00:00,11,6,5,FMN 06 B Zurenborgbrug Ringfietspad
655,Ringfietspad Zurenborgbrug,2023-08-29,01:00:00,2,1,1,FMN 06 B Zurenborgbrug Ringfietspad
655,Ringfietspad Zurenborgbrug,2023-08-29,02:00:00,4,4,0,FMN 06 B Zurenborgbrug Ringfietspad
655,Ringfietspad Zurenborgbrug,2023-08-29,03:00:00,6,5,1,FMN 06 B Zurenborgbrug Ringfietspad
655,Ringfietspad Zurenborgbrug,2023-08-29,04:00:00,15,7,8,FMN 06 B Zurenborgbrug Ringfietspad
655,Ringfietspad Zurenborgbrug,2023-08-29,05:00:00,50,27,23,FMN 06 B Zurenborgbrug Ringfietspad
655,Ringfietspad Zurenborgbrug,2023-08-29,06:00:00,189,107,82,FMN 06 B Zurenborgbrug Ringfietspad
655,Ringfietspad Zurenborgbrug,2023-08-29,07:00:00,410,261,149,FMN 06 B Zurenborgbrug Ringfietspad
655,Ringfietspad Zurenborgbrug,2023-08-29,08:00:00,630,362,268,FMN 06 B Zurenborgbrug Ringfietspad
655,Ringfietspad Zurenborgbrug,2023-08-29,09:00:00,205,114,91,FMN 06 B Zurenborgbrug Ringfietspad
655,Ringfietspad Zurenborgbrug,2023-08-29,10:00:00,147,85,62,FMN 06 B Zurenborgbrug Ringfietspad
655,Ringfietspad Zurenborgbrug,2023-08-29,11:00:00,147,77,70,FMN 06 B Zurenborgbrug Ringfietspad
655,Ringfietspad Zurenborgbrug,2023-08-29,12:00:00,166,91,75,FMN 06 B Zurenborgbrug Ringfietspad
655,Ringfietspad Zurenborgbrug,2023-08-29,13:00:00,226,107,119,FMN 06 B Zurenborgbrug Ringfietspad
655,Ringfietspad Zurenborgbrug,2023-08-29,14:00:00,201,95,106,FMN 06 B Zurenborgbrug Ringfietspad
655,Ringfietspad Zurenborgbrug,2023-08-29,15:00:00,298,125,173,FMN 06 B Zurenborgbrug Ringfietspad
655,Ringfietspad Zurenborgbrug,2023-08-29,16:00:00,491,188,303,FMN 06 B Zurenborgbrug Ringfietspad
655,Ringfietspad Zurenborgbrug,2023-08-29,17:00:00,620,250,370,FMN 06 B Zurenborgbrug Ringfietspad
655,Ringfietspad Zurenborgbrug,2023-08-29,18:00:00,314,130,184,FMN 06 B Zurenborgbrug Ringfietspad
655,Ringfietspad Zurenborgbrug,2023-08-29,19:00:00,191,70,121,FMN 06 B Zurenborgbrug Ringfietspad
655,Ringfietspad Zurenborgbrug,2023-08-29,20:00:00,158,65,93,FMN 06 B Zurenborgbrug Ringfietspad
655,Ringfietspad Zurenborgbrug,2023-08-29,21:00:00,99,47,52,FMN 06 B Zurenborgbrug Ringfietspad
655,Ringfietspad Zurenborgbrug,2023-08-29,22:00:00,94,35,59,FMN 06 B Zurenborgbrug Ringfietspad
655,Ringfietspad Zurenborgbrug,2023-08-29,23:00:00,43,12,31,FMN 06 B Zurenborgbrug Ringfietspad
655,Ringfietspad Zurenborgbrug,2023-08-30,00:00:00,31,23,8,FMN 06 B Zurenborgbrug Ringfietspad
655,Ringfietspad Zurenborgbrug,2023-08-30,01:00:00,11,6,5,FMN 06 B Zurenborgbrug Ringfietspad
655,Ringfietspad Zurenborgbrug,2023-08-30,02:00:00,2,1,1,FMN 06 B Zurenborgbrug Ringfietspad
655,Ringfietspad Zurenborgbrug,2023-08-30,03:00:00,4,2,2,FMN 06 B Zurenborgbrug Ringfietspad
655,Ringfietspad Zurenborgbrug,2023-08-30,04:00:00,17,6,11,FMN 06 B Zurenborgbrug Ringfietspad
655,Ringfietspad Zurenborgbrug,2023-08-30,05:00:00,47,25,22,FMN 06 B Zurenborgbrug Ringfietspad
655,Ringfietspad Zurenborgbrug,2023-08-30,06:00:00,184,102,82,FMN 06 B Zurenborgbrug Ringfietspad
655,Ringfietspad Zurenborgbrug,2023-08-30,07:00:00,267,162,105,FMN 06 B Zurenborgbrug Ringfietspad
655,Ringfietspad Zurenborgbrug,2023-08-30,08:00:00,343,182,161,FMN 06 B Zurenborgbrug Ringfietspad
655,Ringfietspad Zurenborgbrug,2023-08-30,09:00:00,145,76,69,FMN 06 B Zurenborgbrug Ringfietspad
655,Ringfietspad Zurenborgbrug,2023-08-30,10:00:00,89,52,37,FMN 06 B Zurenborgbrug Ringfietspad
655,Ringfietspad Zurenborgbrug,2023-08-30,11:00:00,128,61,67,FMN 06 B Zurenborgbrug Ringfietspad
655,Ringfietspad Zurenborgbrug,2023-08-30,12:00:00,164,83,81,FMN 06 B Zurenborgbrug Ringfietspad
655,Ringfietspad Zurenborgbrug,2023-08-30,13:00:00,149,80,69,FMN 06 B Zurenborgbrug Ringfietspad
655,Ringfietspad Zurenborgbrug,2023-08-30,14:00:00,169,70,99,FMN 06 B Zurenborgbrug Ringfietspad
655,Ringfietspad Zurenborgbrug,2023-08-30,15:00:00,224,83,141,FMN 06 B Zurenborgbrug Ringfietspad
655,Ringfietspad Zurenborgbrug,2023-08-30,16:00:00,349,146,203,FMN 06 B Zurenborgbrug Ringfietspad
655,Ringfietspad Zurenborgbrug,2023-08-30,17:00:00,392,173,219,FMN 06 B Zurenborgbrug Ringfietspad
655,Ringfietspad Zurenborgbrug,2023-08-30,18:00:00,290,96,194,FMN 06 B Zurenborgbrug Ringfietspad
655,Ringfietspad Zurenborgbrug,2023-08-30,19:00:00,214,88,126,FMN 06 B Zurenborgbrug Ringfietspad
655,Ringfietspad Zurenborgbrug,2023-08-30,20:00:00,154,61,93,FMN 06 B Zurenborgbrug Ringfietspad
655,Ringfietspad Zurenborgbrug,2023-08-30,21:00:00,101,46,55,FMN 06 B Zurenborgbrug Ringfietspad
655,Ringfietspad Zurenborgbrug,2023-08-30,22:00:00,96,39,57,FMN 06 B Zurenborgbrug Ringfietspad
655,Ringfietspad Zurenborgbrug,2023-08-30,23:00:00,80,50,30,FMN 06 B Zurenborgbrug Ringfietspad
655,Ringfietspad Zurenborgbrug,2023-08-31,00:00:00,21,12,9,FMN 06 B Zurenborgbrug Ringfietspad
655,Ringfietspad Zurenborgbrug,2023-08-31,01:00:00,12,7,5,FMN 06 B Zurenborgbrug Ringfietspad
655,Ringfietspad Zurenborgbrug,2023-08-31,02:00:00,3,1,2,FMN 06 B Zurenborgbrug Ringfietspad
655,Ringfietspad Zurenborgbrug,2023-08-31,03:00:00,2,2,0,FMN 06 B Zurenborgbrug Ringfietspad
655,Ringfietspad Zurenborgbrug,2023-08-31,04:00:00,16,9,7,FMN 06 B Zurenborgbrug Ringfietspad
655,Ringfietspad Zurenborgbrug,2023-08-31,05:00:00,54,29,25,FMN 06 B Zurenborgbrug Ringfietspad
655,Ringfietspad Zurenborgbrug,2023-08-31,06:00:00,162,95,67,FMN 06 B Zurenborgbrug Ringfietspad
655,Ringfietspad Zurenborgbrug,2023-08-31,07:00:00,362,234,128,FMN 06 B Zurenborgbrug Ringfietspad
655,Ringfietspad Zurenborgbrug,2023-08-31,08:00:00,529,299,230,FMN 06 B Zurenborgbrug Ringfietspad
655,Ringfietspad Zurenborgbrug,2023-08-31,09:00:00,224,122,102,FMN 06 B Zurenborgbrug Ringfietspad
655,Ringfietspad Zurenborgbrug,2023-08-31,10:00:00,133,64,69,FMN 06 B Zurenborgbrug Ringfietspad
655,Ringfietspad Zurenborgbrug,2023-08-31,11:00:00,151,66,85,FMN 06 B Zurenborgbrug Ringfietspad
655,Ringfietspad Zurenborgbrug,2023-08-31,12:00:00,200,104,96,FMN 06 B Zurenborgbrug Ringfietspad
655,Ringfietspad Zurenborgbrug,2023-08-31,13:00:00,226,114,112,FMN 06 B Zurenborgbrug Ringfietspad
655,Ringfietspad Zurenborgbrug,2023-08-31,14:00:00,232,104,128,FMN 06 B Zurenborgbrug Ringfietspad
655,Ringfietspad Zurenborgbrug,2023-08-31,15:00:00,248,103,145,FMN 06 B Zurenborgbrug Ringfietspad
655,Ringfietspad Zurenborgbrug,2023-08-31,16:00:00,463,188,275,FMN 06 B Zurenborgbrug Ringfietspad
655,Ringfietspad Zurenborgbrug,2023-08-31,17:00:00,555,204,351,FMN 06 B Zurenborgbrug Ringfietspad
655,Ringfietspad Zurenborgbrug,2023-08-31,18:00:00,324,145,179,FMN 06 B Zurenborgbrug Ringfietspad
655,Ringfietspad Zurenborgbrug,2023-08-31,19:00:00,249,83,166,FMN 06 B Zurenborgbrug Ringfietspad
655,Ringfietspad Zurenborgbrug,2023-08-31,20:00:00,156,54,102,FMN 06 B Zurenborgbrug Ringfietspad
655,Ringfietspad Zurenborgbrug,2023-08-31,21:00:00,72,33,39,FMN 06 B Zurenborgbrug Ringfietspad
655,Ringfietspad Zurenborgbrug,2023-08-31,22:00:00,110,51,59,FMN 06 B Zurenborgbrug Ringfietspad
655,Ringfietspad Zurenborgbrug,2023-08-31,23:00:00,94,62,32,FMN 06 B Zurenborgbrug Ringfietspad
655,Ringfietspad Zurenborgbrug,2023-09-01,00:00:00,34,12,22,FMN 06 B Zurenborgbrug Ringfietspad
655,Ringfietspad Zurenborgbrug,2023-09-01,01:00:00,3,1,2,FMN 06 B Zurenborgbrug Ringfietspad
655,Ringfietspad Zurenborgbrug,2023-09-01,02:00:00,7,4,3,FMN 06 B Zurenborgbrug Ringfietspad
655,Ringfietspad Zurenborgbrug,2023-09-01,03:00:00,4,2,2,FMN 06 B Zurenborgbrug Ringfietspad
655,Ringfietspad Zurenborgbrug,2023-09-01,04:00:00,12,9,3,FMN 06 B Zurenborgbrug Ringfietspad
655,Ringfietspad Zurenborgbrug,2023-09-01,05:00:00,42,23,19,FMN 06 B Zurenborgbrug Ringfietspad
655,Ringfietspad Zurenborgbrug,2023-09-01,06:00:00,125,69,56,FMN 06 B Zurenborgbrug Ringfietspad
655,Ringfietspad Zurenborgbrug,2023-09-01,07:00:00,304,162,142,FMN 06 B Zurenborgbrug Ringfietspad
655,Ringfietspad Zurenborgbrug,2023-09-01,08:00:00,369,220,149,FMN 06 B Zurenborgbrug Ringfietspad
655,Ringfietspad Zurenborgbrug,2023-09-01,09:00:00,188,87,101,FMN 06 B Zurenborgbrug Ringfietspad
655,Ringfietspad Zurenborgbrug,2023-09-01,10:00:00,67,39,28,FMN 06 B Zurenborgbrug Ringfietspad
655,Ringfietspad Zurenborgbrug,2023-09-01,11:00:00,50,18,32,FMN 06 B Zurenborgbrug Ringfietspad
655,Ringfietspad Zurenborgbrug,2023-09-01,12:00:00,96,37,59,FMN 06 B Zurenborgbrug Ringfietspad
655,Ringfietspad Zurenborgbrug,2023-09-01,13:00:00,117,59,58,FMN 06 B Zurenborgbrug Ringfietspad
655,Ringfietspad Zurenborgbrug,2023-09-01,14:00:00,171,67,104,FMN 06 B Zurenborgbrug Ringfietspad
655,Ringfietspad Zurenborgbrug,2023-09-01,15:00:00,274,90,184,FMN 06 B Zurenborgbrug Ringfietspad
655,Ringfietspad Zurenborgbrug,2023-09-01,16:00:00,354,173,181,FMN 06 B Zurenborgbrug Ringfietspad
655,Ringfietspad Zurenborgbrug,2023-09-01,17:00:00,349,140,209,FMN 06 B Zurenborgbrug Ringfietspad
655,Ringfietspad Zurenborgbrug,2023-09-01,18:00:00,204,93,111,FMN 06 B Zurenborgbrug Ringfietspad
655,Ringfietspad Zurenborgbrug,2023-09-01,19:00:00,169,58,111,FMN 06 B Zurenborgbrug Ringfietspad
655,Ringfietspad Zurenborgbrug,2023-09-01,20:00:00,105,40,65,FMN 06 B Zurenborgbrug Ringfietspad
655,Ringfietspad Zurenborgbrug,2023-09-01,21:00:00,64,31,33,FMN 06 B Zurenborgbrug Ringfietspad
655,Ringfietspad Zurenborgbrug,2023-09-01,22:00:00,116,70,46,FMN 06 B Zurenborgbrug Ringfietspad
655,Ringfietspad Zurenborgbrug,2023-09-01,23:00:00,33,16,17,FMN 06 B Zurenborgbrug Ringfietspad
655,Ringfietspad Zurenborgbrug,2023-09-02,00:00:00,33,14,19,FMN 06 B Zurenborgbrug Ringfietspad
655,Ringfietspad Zurenborgbrug,2023-09-02,01:00:00,23,10,13,FMN 06 B Zurenborgbrug Ringfietspad
655,Ringfietspad Zurenborgbrug,2023-09-02,02:00:00,13,3,10,FMN 06 B Zurenborgbrug Ringfietspad
655,Ringfietspad Zurenborgbrug,2023-09-02,03:00:00,13,6,7,FMN 06 B Zurenborgbrug Ringfietspad
655,Ringfietspad Zurenborgbrug,2023-09-02,04:00:00,10,5,5,FMN 06 B Zurenborgbrug Ringfietspad
655,Ringfietspad Zurenborgbrug,2023-09-02,05:00:00,14,7,7,FMN 06 B Zurenborgbrug Ringfietspad
655,Ringfietspad Zurenborgbrug,2023-09-02,06:00:00,26,14,12,FMN 06 B Zurenborgbrug Ringfietspad
655,Ringfietspad Zurenborgbrug,2023-09-02,07:00:00,31,19,12,FMN 06 B Zurenborgbrug Ringfietspad
655,Ringfietspad Zurenborgbrug,2023-09-02,08:00:00,69,35,34,FMN 06 B Zurenborgbrug Ringfietspad
655,Ringfietspad Zurenborgbrug,2023-09-02,09:00:00,100,33,67,FMN 06 B Zurenborgbrug Ringfietspad
655,Ringfietspad Zurenborgbrug,2023-09-02,10:00:00,127,57,70,FMN 06 B Zurenborgbrug Ringfietspad
655,Ringfietspad Zurenborgbrug,2023-09-02,11:00:00,148,61,87,FMN 06 B Zurenborgbrug Ringfietspad
655,Ringfietspad Zurenborgbrug,2023-09-02,12:00:00,188,92,96,FMN 06 B Zurenborgbrug Ringfietspad
655,Ringfietspad Zurenborgbrug,2023-09-02,13:00:00,154,67,87,FMN 06 B Zurenborgbrug Ringfietspad
655,Ringfietspad Zurenborgbrug,2023-09-02,14:00:00,256,97,159,FMN 06 B Zurenborgbrug Ringfietspad
655,Ringfietspad Zurenborgbrug,2023-09-02,15:00:00,220,99,121,FMN 06 B Zurenborgbrug Ringfietspad
655,Ringfietspad Zurenborgbrug,2023-09-02,16:00:00,212,118,94,FMN 06 B Zurenborgbrug Ringfietspad
655,Ringfietspad Zurenborgbrug,2023-09-02,17:00:00,199,98,101,FMN 06 B Zurenborgbrug Ringfietspad
655,Ringfietspad Zurenborgbrug,2023-09-02,18:00:00,185,84,101,FMN 06 B Zurenborgbrug Ringfietspad
655,Ringfietspad Zurenborgbrug,2023-09-02,19:00:00,153,75,78,FMN 06 B Zurenborgbrug Ringfietspad
655,Ringfietspad Zurenborgbrug,2023-09-02,20:00:00,112,60,52,FMN 06 B Zurenborgbrug Ringfietspad
655,Ringfietspad Zurenborgbrug,2023-09-02,21:00:00,100,54,46,FMN 06 B Zurenborgbrug Ringfietspad
655,Ringfietspad Zurenborgbrug,2023-09-02,22:00:00,60,22,38,FMN 06 B Zurenborgbrug Ringfietspad
655,Ringfietspad Zurenborgbrug,2023-09-02,23:00:00,37,16,21,FMN 06 B Zurenborgbrug Ringfietspad
655,Ringfietspad Zurenborgbrug,2023-09-03,00:00:00,39,13,26,FMN 06 B Zurenborgbrug Ringfietspad
655,Ringfietspad Zurenborgbrug,2023-09-03,01:00:00,14,5,9,FMN 06 B Zurenborgbrug Ringfietspad
655,Ringfietspad Zurenborgbrug,2023-09-03,02:00:00,16,6,10,FMN 06 B Zurenborgbrug Ringfietspad
655,Ringfietspad Zurenborgbrug,2023-09-03,03:00:00,10,4,6,FMN 06 B Zurenborgbrug Ringfietspad
655,Ringfietspad Zurenborgbrug,2023-09-03,04:00:00,7,1,6,FMN 06 B Zurenborgbrug Ringfietspad
655,Ringfietspad Zurenborgbrug,2023-09-03,05:00:00,6,2,4,FMN 06 B Zurenborgbrug Ringfietspad
655,Ringfietspad Zurenborgbrug,2023-09-03,06:00:00,21,9,12,FMN 06 B Zurenborgbrug Ringfietspad
655,Ringfietspad Zurenborgbrug,2023-09-03,07:00:00,39,17,22,FMN 06 B Zurenborgbrug Ringfietspad
655,Ringfietspad Zurenborgbrug,2023-09-03,08:00:00,54,22,32,FMN 06 B Zurenborgbrug Ringfietspad
655,Ringfietspad Zurenborgbrug,2023-09-03,09:00:00,134,69,65,FMN 06 B Zurenborgbrug Ringfietspad
655,Ringfietspad Zurenborgbrug,2023-09-03,10:00:00,177,81,96,FMN 06 B Zurenborgbrug Ringfietspad
655,Ringfietspad Zurenborgbrug,2023-09-03,11:00:00,217,89,128,FMN 06 B Zurenborgbrug Ringfietspad
655,Ringfietspad Zurenborgbrug,2023-09-03,12:00:00,266,138,128,FMN 06 B Zurenborgbrug Ringfietspad
655,Ringfietspad Zurenborgbrug,2023-09-03,13:00:00,359,158,201,FMN 06 B Zurenborgbrug Ringfietspad
655,Ringfietspad Zurenborgbrug,2023-09-03,14:00:00,353,135,218,FMN 06 B Zurenborgbrug Ringfietspad
655,Ringfietspad Zurenborgbrug,2023-09-03,15:00:00,326,146,180,FMN 06 B Zurenborgbrug Ringfietspad
655,Ringfietspad Zurenborgbrug,2023-09-03,16:00:00,281,144,137,FMN 06 B Zurenborgbrug Ringfietspad
655,Ringfietspad Zurenborgbrug,2023-09-03,17:00:00,313,187,126,FMN 06 B Zurenborgbrug Ringfietspad
655,Ringfietspad Zurenborgbrug,2023-09-03,18:00:00,180,95,85,FMN 06 B Zurenborgbrug Ringfietspad
655,Ringfietspad Zurenborgbrug,2023-09-03,19:00:00,158,79,79,FMN 06 B Zurenborgbrug Ringfietspad
655,Ringfietspad Zurenborgbrug,2023-09-03,20:00:00,107,51,56,FMN 06 B Zurenborgbrug Ringfietspad
655,Ringfietspad Zurenborgbrug,2023-09-03,21:00:00,84,34,50,FMN 06 B Zurenborgbrug Ringfietspad
655,Ringfietspad Zurenborgbrug,2023-09-03,22:00:00,44,19,25,FMN 06 B Zurenborgbrug Ringfietspad
655,Ringfietspad Zurenborgbrug,2023-09-03,23:00:00,30,10,20,FMN 06 B Zurenborgbrug Ringfietspad
655,Ringfietspad Zurenborgbrug,2023-09-04,00:00:00,12,4,8,FMN 06 B Zurenborgbrug Ringfietspad
655,Ringfietspad Zurenborgbrug,2023-09-04,01:00:00,6,3,3,FMN 06 B Zurenborgbrug Ringfietspad
655,Ringfietspad Zurenborgbrug,2023-09-04,02:00:00,2,0,2,FMN 06 B Zurenborgbrug Ringfietspad
655,Ringfietspad Zurenborgbrug,2023-09-04,03:00:00,2,1,1,FMN 06 B Zurenborgbrug Ringfietspad
655,Ringfietspad Zurenborgbrug,2023-09-04,04:00:00,32,22,10,FMN 06 B Zurenborgbrug Ringfietspad
655,Ringfietspad Zurenborgbrug,2023-09-04,05:00:00,65,44,21,FMN 06 B Zurenborgbrug Ringfietspad
655,Ringfietspad Zurenborgbrug,2023-09-04,06:00:00,214,132,82,FMN 06 B Zurenborgbrug Ringfietspad
655,Ringfietspad Zurenborgbrug,2023-09-04,07:00:00,619,361,258,FMN 06 B Zurenborgbrug Ringfietspad
655,Ringfietspad Zurenborgbrug,2023-09-04,08:00:00,816,454,362,FMN 06 B Zurenborgbrug Ringfietspad
655,Ringfietspad Zurenborgbrug,2023-09-04,09:00:00,255,135,120,FMN 06 B Zurenborgbrug Ringfietspad
655,Ringfietspad Zurenborgbrug,2023-09-04,10:00:00,161,79,82,FMN 06 B Zurenborgbrug Ringfietspad
655,Ringfietspad Zurenborgbrug,2023-09-04,11:00:00,158,74,84,FMN 06 B Zurenborgbrug Ringfietspad
655,Ringfietspad Zurenborgbrug,2023-09-04,12:00:00,248,126,122,FMN 06 B Zurenborgbrug Ringfietspad
655,Ringfietspad Zurenborgbrug,2023-09-04,13:00:00,227,102,125,FMN 06 B Zurenborgbrug Ringfietspad
655,Ringfietspad Zurenborgbrug,2023-09-04,14:00:00,265,107,158,FMN 06 B Zurenborgbrug Ringfietspad
655,Ringfietspad Zurenborgbrug,2023-09-04,15:00:00,453,163,290,FMN 06 B Zurenborgbrug Ringfietspad
655,Ringfietspad Zurenborgbrug,2023-09-04,16:00:00,761,329,432,FMN 06 B Zurenborgbrug Ringfietspad
655,Ringfietspad Zurenborgbrug,2023-09-04,17:00:00,670,281,389,FMN 06 B Zurenborgbrug Ringfietspad
655,Ringfietspad Zurenborgbrug,2023-09-04,18:00:00,369,159,210,FMN 06 B Zurenborgbrug Ringfietspad
655,Ringfietspad Zurenborgbrug,2023-09-04,19:00:00,215,94,121,FMN 06 B Zurenborgbrug Ringfietspad
655,Ringfietspad Zurenborgbrug,2023-09-04,20:00:00,172,77,95,FMN 06 B Zurenborgbrug Ringfietspad
655,Ringfietspad Zurenborgbrug,2023-09-04,21:00:00,128,50,78,FMN 06 B Zurenborgbrug Ringfietspad
655,Ringfietspad Zurenborgbrug,2023-09-04,22:00:00,96,39,57,FMN 06 B Zurenborgbrug Ringfietspad
655,Ringfietspad Zurenborgbrug,2023-09-04,23:00:00,24,8,16,FMN 06 B Zurenborgbrug Ringfietspad
655,Ringfietspad Zurenborgbrug,2023-09-05,00:00:00,13,5,8,FMN 06 B Zurenborgbrug Ringfietspad
655,Ringfietspad Zurenborgbrug,2023-09-05,01:00:00,2,1,1,FMN 06 B Zurenborgbrug Ringfietspad
655,Ringfietspad Zurenborgbrug,2023-09-05,02:00:00,8,2,6,FMN 06 B Zurenborgbrug Ringfietspad
655,Ringfietspad Zurenborgbrug,2023-09-05,03:00:00,0,0,0,FMN 06 B Zurenborgbrug Ringfietspad
655,Ringfietspad Zurenborgbrug,2023-09-05,04:00:00,27,21,6,FMN 06 B Zurenborgbrug Ringfietspad
655,Ringfietspad Zurenborgbrug,2023-09-05,05:00:00,77,47,30,FMN 06 B Zurenborgbrug Ringfietspad
655,Ringfietspad Zurenborgbrug,2023-09-05,06:00:00,238,142,96,FMN 06 B Zurenborgbrug Ringfietspad
655,Ringfietspad Zurenborgbrug,2023-09-05,07:00:00,697,403,294,FMN 06 B Zurenborgbrug Ringfietspad
655,Ringfietspad Zurenborgbrug,2023-09-05,08:00:00,861,483,378,FMN 06 B Zurenborgbrug Ringfietspad
655,Ringfietspad Zurenborgbrug,2023-09-05,09:00:00,251,150,101,FMN 06 B Zurenborgbrug Ringfietspad
655,Ringfietspad Zurenborgbrug,2023-09-05,10:00:00,162,82,80,FMN 06 B Zurenborgbrug Ringfietspad
655,Ringfietspad Zurenborgbrug,2023-09-05,11:00:00,167,81,86,FMN 06 B Zurenborgbrug Ringfietspad
655,Ringfietspad Zurenborgbrug,2023-09-05,12:00:00,213,113,100,FMN 06 B Zurenborgbrug Ringfietspad
655,Ringfietspad Zurenborgbrug,2023-09-05,13:00:00,281,121,160,FMN 06 B Zurenborgbrug Ringfietspad
655,Ringfietspad Zurenborgbrug,2023-09-05,14:00:00,309,104,205,FMN 06 B Zurenborgbrug Ringfietspad
655,Ringfietspad Zurenborgbrug,2023-09-05,15:00:00,446,186,260,FMN 06 B Zurenborgbrug Ringfietspad
655,Ringfietspad Zurenborgbrug,2023-09-05,16:00:00,826,356,470,FMN 06 B Zurenborgbrug Ringfietspad
655,Ringfietspad Zurenborgbrug,2023-09-05,17:00:00,777,295,482,FMN 06 B Zurenborgbrug Ringfietspad
655,Ringfietspad Zurenborgbrug,2023-09-05,18:00:00,471,187,284,FMN 06 B Zurenborgbrug Ringfietspad
655,Ringfietspad Zurenborgbrug,2023-09-05,19:00:00,262,75,187,FMN 06 B Zurenborgbrug Ringfietspad
655,Ringfietspad Zurenborgbrug,2023-09-05,20:00:00,204,84,120,FMN 06 B Zurenborgbrug Ringfietspad
655,Ringfietspad Zurenborgbrug,2023-09-05,21:00:00,112,58,54,FMN 06 B Zurenborgbrug Ringfietspad
655,Ringfietspad Zurenborgbrug,2023-09-05,22:00:00,145,72,73,FMN 06 B Zurenborgbrug Ringfietspad
655,Ringfietspad Zurenborgbrug,2023-09-05,23:00:00,102,69,33,FMN 06 B Zurenborgbrug Ringfietspad
655,Ringfietspad Zurenborgbrug,2023-09-06,00:00:00,32,24,8,FMN 06 B Zurenborgbrug Ringfietspad
655,Ringfietspad Zurenborgbrug,2023-09-06,01:00:00,5,3,2,FMN 06 B Zurenborgbrug Ringfietspad
655,Ringfietspad Zurenborgbrug,2023-09-06,02:00:00,4,2,2,FMN 06 B Zurenborgbrug Ringfietspad
655,Ringfietspad Zurenborgbrug,2023-09-06,03:00:00,5,0,5,FMN 06 B Zurenborgbrug Ringfietspad
655,Ringfietspad Zurenborgbrug,2023-09-06,04:00:00,28,18,10,FMN 06 B Zurenborgbrug Ringfietspad
655,Ringfietspad Zurenborgbrug,2023-09-06,05:00:00,67,42,25,FMN 06 B Zurenborgbrug Ringfietspad
655,Ringfietspad Zurenborgbrug,2023-09-06,06:00:00,198,106,92,FMN 06 B Zurenborgbrug Ringfietspad
655,Ringfietspad Zurenborgbrug,2023-09-06,07:00:00,559,309,250,FMN 06 B Zurenborgbrug Ringfietspad
655,Ringfietspad Zurenborgbrug,2023-09-06,08:00:00,720,407,313,FMN 06 B Zurenborgbrug Ringfietspad
655,Ringfietspad Zurenborgbrug,2023-09-06,09:00:00,221,118,103,FMN 06 B Zurenborgbrug Ringfietspad
655,Ringfietspad Zurenborgbrug,2023-09-06,10:00:00,160,93,67,FMN 06 B Zurenborgbrug Ringfietspad
655,Ringfietspad Zurenborgbrug,2023-09-06,11:00:00,199,98,101,FMN 06 B Zurenborgbrug Ringfietspad
655,Ringfietspad Zurenborgbrug,2023-09-06,12:00:00,502,248,254,FMN 06 B Zurenborgbrug Ringfietspad
655,Ringfietspad Zurenborgbrug,2023-09-06,13:00:00,334,167,167,FMN 06 B Zurenborgbrug Ringfietspad
655,Ringfietspad Zurenborgbrug,2023-09-06,14:00:00,321,136,185,FMN 06 B Zurenborgbrug Ringfietspad
655,Ringfietspad Zurenborgbrug,2023-09-06,15:00:00,334,135,199,FMN 06 B Zurenborgbrug Ringfietspad
655,Ringfietspad Zurenborgbrug,2023-09-06,16:00:00,522,201,321,FMN 06 B Zurenborgbrug Ringfietspad
655,Ringfietspad Zurenborgbrug,2023-09-06,17:00:00,607,239,368,FMN 06 B Zurenborgbrug Ringfietspad
655,Ringfietspad Zurenborgbrug,2023-09-06,18:00:00,411,172,239,FMN 06 B Zurenborgbrug Ringfietspad
655,Ringfietspad Zurenborgbrug,2023-09-06,19:00:00,304,114,190,FMN 06 B Zurenborgbrug Ringfietspad
655,Ringfietspad Zurenborgbrug,2023-09-06,20:00:00,201,68,133,FMN 06 B Zurenborgbrug Ringfietspad
655,Ringfietspad Zurenborgbrug,2023-09-06,21:00:00,108,43,65,FMN 06 B Zurenborgbrug Ringfietspad
655,Ringfietspad Zurenborgbrug,2023-09-06,22:00:00,127,62,65,FMN 06 B Zurenborgbrug Ringfietspad
655,Ringfietspad Zurenborgbrug,2023-09-06,23:00:00,67,47,20,FMN 06 B Zurenborgbrug Ringfietspad
655,Ringfietspad Zurenborgbrug,2023-09-07,00:00:00,38,22,16,FMN 06 B Zurenborgbrug Ringfietspad
655,Ringfietspad Zurenborgbrug,2023-09-07,01:00:00,13,8,5,FMN 06 B Zurenborgbrug Ringfietspad
655,Ringfietspad Zurenborgbrug,2023-09-07,02:00:00,3,2,1,FMN 06 B Zurenborgbrug Ringfietspad
655,Ringfietspad Zurenborgbrug,2023-09-07,03:00:00,5,0,5,FMN 06 B Zurenborgbrug Ringfietspad
655,Ringfietspad Zurenborgbrug,2023-09-07,04:00:00,30,19,11,FMN 06 B Zurenborgbrug Ringfietspad
655,Ringfietspad Zurenborgbrug,2023-09-07,05:00:00,64,41,23,FMN 06 B Zurenborgbrug Ringfietspad
655,Ringfietspad Zurenborgbrug,2023-09-07,06:00:00,184,102,82,FMN 06 B Zurenborgbrug Ringfietspad
655,Ringfietspad Zurenborgbrug,2023-09-07,07:00:00,614,355,259,FMN 06 B Zurenborgbrug Ringfietspad
655,Ringfietspad Zurenborgbrug,2023-09-07,08:00:00,862,498,364,FMN 06 B Zurenborgbrug Ringfietspad
655,Ringfietspad Zurenborgbrug,2023-09-07,09:00:00,225,127,98,FMN 06 B Zurenborgbrug Ringfietspad
655,Ringfietspad Zurenborgbrug,2023-09-07,10:00:00,140,63,77,FMN 06 B Zurenborgbrug Ringfietspad
655,Ringfietspad Zurenborgbrug,2023-09-07,11:00:00,180,107,73,FMN 06 B Zurenborgbrug Ringfietspad
655,Ringfietspad Zurenborgbrug,2023-09-07,12:00:00,261,120,141,FMN 06 B Zurenborgbrug Ringfietspad
655,Ringfietspad Zurenborgbrug,2023-09-07,13:00:00,246,132,114,FMN 06 B Zurenborgbrug Ringfietspad
655,Ringfietspad Zurenborgbrug,2023-09-07,14:00:00,279,118,161,FMN 06 B Zurenborgbrug Ringfietspad
655,Ringfietspad Zurenborgbrug,2023-09-07,15:00:00,430,150,280,FMN 06 B Zurenborgbrug Ringfietspad
655,Ringfietspad Zurenborgbrug,2023-09-07,16:00:00,730,308,422,FMN 06 B Zurenborgbrug Ringfietspad
655,Ringfietspad Zurenborgbrug,2023-09-07,17:00:00,665,251,414,FMN 06 B Zurenborgbrug Ringfietspad
655,Ringfietspad Zurenborgbrug,2023-09-07,18:00:00,463,218,245,FMN 06 B Zurenborgbrug Ringfietspad
655,Ringfietspad Zurenborgbrug,2023-09-07,19:00:00,238,93,145,FMN 06 B Zurenborgbrug Ringfietspad
655,Ringfietspad Zurenborgbrug,2023-09-07,20:00:00,182,85,97,FMN 06 B Zurenborgbrug Ringfietspad
655,Ringfietspad Zurenborgbrug,2023-09-07,21:00:00,145,59,86,FMN 06 B Zurenborgbrug Ringfietspad
655,Ringfietspad Zurenborgbrug,2023-09-07,22:00:00,124,50,74,FMN 06 B Zurenborgbrug Ringfietspad
655,Ringfietspad Zurenborgbrug,2023-09-07,23:00:00,40,15,25,FMN 06 B Zurenborgbrug Ringfietspad
655,Ringfietspad Zurenborgbrug,2023-09-08,00:00:00,17,12,5,FMN 06 B Zurenborgbrug Ringfietspad
655,Ringfietspad Zurenborgbrug,2023-09-08,01:00:00,11,3,8,FMN 06 B Zurenborgbrug Ringfietspad
655,Ringfietspad Zurenborgbrug,2023-09-08,02:00:00,2,2,0,FMN 06 B Zurenborgbrug Ringfietspad
655,Ringfietspad Zurenborgbrug,2023-09-08,03:00:00,2,0,2,FMN 06 B Zurenborgbrug Ringfietspad
655,Ringfietspad Zurenborgbrug,2023-09-08,04:00:00,24,15,9,FMN 06 B Zurenborgbrug Ringfietspad
655,Ringfietspad Zurenborgbrug,2023-09-08,05:00:00,59,33,26,FMN 06 B Zurenborgbrug Ringfietspad
655,Ringfietspad Zurenborgbrug,2023-09-08,06:00:00,164,97,67,FMN 06 B Zurenborgbrug Ringfietspad
655,Ringfietspad Zurenborgbrug,2023-09-08,07:00:00,517,292,225,FMN 06 B Zurenborgbrug Ringfietspad
655,Ringfietspad Zurenborgbrug,2023-09-08,08:00:00,619,326,293,FMN 06 B Zurenborgbrug Ringfietspad
655,Ringfietspad Zurenborgbrug,2023-09-08,09:00:00,230,123,107,FMN 06 B Zurenborgbrug Ringfietspad
655,Ringfietspad Zurenborgbrug,2023-09-08,10:00:00,179,85,94,FMN 06 B Zurenborgbrug Ringfietspad
655,Ringfietspad Zurenborgbrug,2023-09-08,11:00:00,178,84,94,FMN 06 B Zurenborgbrug Ringfietspad
655,Ringfietspad Zurenborgbrug,2023-09-08,12:00:00,276,139,137,FMN 06 B Zurenborgbrug Ringfietspad
655,Ringfietspad Zurenborgbrug,2023-09-08,13:00:00,255,132,123,FMN 06 B Zurenborgbrug Ringfietspad
655,Ringfietspad Zurenborgbrug,2023-09-08,14:00:00,259,116,143,FMN 06 B Zurenborgbrug Ringfietspad
655,Ringfietspad Zurenborgbrug,2023-09-08,15:00:00,429,176,253,FMN 06 B Zurenborgbrug Ringfietspad
655,Ringfietspad Zurenborgbrug,2023-09-08,16:00:00,644,263,381,FMN 06 B Zurenborgbrug Ringfietspad
655,Ringfietspad Zurenborgbrug,2023-09-08,17:00:00,508,207,301,FMN 06 B Zurenborgbrug Ringfietspad
655,Ringfietspad Zurenborgbrug,2023-09-08,18:00:00,353,132,221,FMN 06 B Zurenborgbrug Ringfietspad
655,Ringfietspad Zurenborgbrug,2023-09-08,19:00:00,304,97,207,FMN 06 B Zurenborgbrug Ringfietspad
655,Ringfietspad Zurenborgbrug,2023-09-08,20:00:00,203,64,139,FMN 06 B Zurenborgbrug Ringfietspad
655,Ringfietspad Zurenborgbrug,2023-09-08,21:00:00,85,41,44,FMN 06 B Zurenborgbrug Ringfietspad
655,Ringfietspad Zurenborgbrug,2023-09-08,22:00:00,154,101,53,FMN 06 B Zurenborgbrug Ringfietspad
655,Ringfietspad Zurenborgbrug,2023-09-08,23:00:00,172,126,46,FMN 06 B Zurenborgbrug Ringfietspad
655,Ringfietspad Zurenborgbrug,2023-09-09,00:00:00,137,104,33,FMN 06 B Zurenborgbrug Ringfietspad
655,Ringfietspad Zurenborgbrug,2023-09-09,01:00:00,44,15,29,FMN 06 B Zurenborgbrug Ringfietspad
655,Ringfietspad Zurenborgbrug,2023-09-09,02:00:00,17,10,7,FMN 06 B Zurenborgbrug Ringfietspad
655,Ringfietspad Zurenborgbrug,2023-09-09,03:00:00,10,6,4,FMN 06 B Zurenborgbrug Ringfietspad
655,Ringfietspad Zurenborgbrug,2023-09-09,04:00:00,16,5,11,FMN 06 B Zurenborgbrug Ringfietspad
655,Ringfietspad Zurenborgbrug,2023-09-09,05:00:00,16,8,8,FMN 06 B Zurenborgbrug Ringfietspad
655,Ringfietspad Zurenborgbrug,2023-09-09,06:00:00,30,16,14,FMN 06 B Zurenborgbrug Ringfietspad
655,Ringfietspad Zurenborgbrug,2023-09-09,07:00:00,48,25,23,FMN 06 B Zurenborgbrug Ringfietspad
655,Ringfietspad Zurenborgbrug,2023-09-09,08:00:00,114,60,54,FMN 06 B Zurenborgbrug Ringfietspad
655,Ringfietspad Zurenborgbrug,2023-09-09,09:00:00,147,79,68,FMN 06 B Zurenborgbrug Ringfietspad
655,Ringfietspad Zurenborgbrug,2023-09-09,10:00:00,187,98,89,FMN 06 B Zurenborgbrug Ringfietspad
655,Ringfietspad Zurenborgbrug,2023-09-09,11:00:00,227,113,114,FMN 06 B Zurenborgbrug Ringfietspad
655,Ringfietspad Zurenborgbrug,2023-09-09,12:00:00,247,87,160,FMN 06 B Zurenborgbrug Ringfietspad
655,Ringfietspad Zurenborgbrug,2023-09-09,13:00:00,253,108,145,FMN 06 B Zurenborgbrug Ringfietspad
655,Ringfietspad Zurenborgbrug,2023-09-09,14:00:00,296,158,138,FMN 06 B Zurenborgbrug Ringfietspad
655,Ringfietspad Zurenborgbrug,2023-09-09,15:00:00,248,99,149,FMN 06 B Zurenborgbrug Ringfietspad
655,Ringfietspad Zurenborgbrug,2023-09-09,16:00:00,230,110,120,FMN 06 B Zurenborgbrug Ringfietspad
655,Ringfietspad Zurenborgbrug,2023-09-09,17:00:00,215,101,114,FMN 06 B Zurenborgbrug Ringfietspad
655,Ringfietspad Zurenborgbrug,2023-09-09,18:00:00,215,105,110,FMN 06 B Zurenborgbrug Ringfietspad
655,Ringfietspad Zurenborgbrug,2023-09-09,19:00:00,209,85,124,FMN 06 B Zurenborgbrug Ringfietspad
655,Ringfietspad Zurenborgbrug,2023-09-09,20:00:00,184,50,134,FMN 06 B Zurenborgbrug Ringfietspad
655,Ringfietspad Zurenborgbrug,2023-09-09,21:00:00,104,38,66,FMN 06 B Zurenborgbrug Ringfietspad
655,Ringfietspad Zurenborgbrug,2023-09-09,22:00:00,99,63,36,FMN 06 B Zurenborgbrug Ringfietspad
655,Ringfietspad Zurenborgbrug,2023-09-09,23:00:00,90,61,29,FMN 06 B Zurenborgbrug Ringfietspad
655,Ringfietspad Zurenborgbrug,2023-09-10,00:00:00,62,33,29,FMN 06 B Zurenborgbrug Ringfietspad
655,Ringfietspad Zurenborgbrug,2023-09-10,01:00:00,28,13,15,FMN 06 B Zurenborgbrug Ringfietspad
655,Ringfietspad Zurenborgbrug,2023-09-10,02:00:00,17,8,9,FMN 06 B Zurenborgbrug Ringfietspad
655,Ringfietspad Zurenborgbrug,2023-09-10,03:00:00,13,2,11,FMN 06 B Zurenborgbrug Ringfietspad
655,Ringfietspad Zurenborgbrug,2023-09-10,04:00:00,13,4,9,FMN 06 B Zurenborgbrug Ringfietspad
655,Ringfietspad Zurenborgbrug,2023-09-10,05:00:00,16,10,6,FMN 06 B Zurenborgbrug Ringfietspad
655,Ringfietspad Zurenborgbrug,2023-09-10,06:00:00,21,12,9,FMN 06 B Zurenborgbrug Ringfietspad
655,Ringfietspad Zurenborgbrug,2023-09-10,07:00:00,34,13,21,FMN 06 B Zurenborgbrug Ringfietspad
655,Ringfietspad Zurenborgbrug,2023-09-10,08:00:00,68,23,45,FMN 06 B Zurenborgbrug Ringfietspad
655,Ringfietspad Zurenborgbrug,2023-09-10,09:00:00,194,83,111,FMN 06 B Zurenborgbrug Ringfietspad
655,Ringfietspad Zurenborgbrug,2023-09-10,10:00:00,185,68,117,FMN 06 B Zurenborgbrug Ringfietspad
655,Ringfietspad Zurenborgbrug,2023-09-10,11:00:00,219,116,103,FMN 06 B Zurenborgbrug Ringfietspad
655,Ringfietspad Zurenborgbrug,2023-09-10,12:00:00,257,129,128,FMN 06 B Zurenborgbrug Ringfietspad
655,Ringfietspad Zurenborgbrug,2023-09-10,13:00:00,245,113,132,FMN 06 B Zurenborgbrug Ringfietspad
655,Ringfietspad Zurenborgbrug,2023-09-10,14:00:00,229,133,96,FMN 06 B Zurenborgbrug Ringfietspad
655,Ringfietspad Zurenborgbrug,2023-09-10,15:00:00,162,88,74,FMN 06 B Zurenborgbrug Ringfietspad
655,Ringfietspad Zurenborgbrug,2023-09-10,16:00:00,212,97,115,FMN 06 B Zurenborgbrug Ringfietspad
655,Ringfietspad Zurenborgbrug,2023-09-10,17:00:00,193,117,76,FMN 06 B Zurenborgbrug Ringfietspad
655,Ringfietspad Zurenborgbrug,2023-09-10,18:00:00,185,83,102,FMN 06 B Zurenborgbrug Ringfietspad
655,Ringfietspad Zurenborgbrug,2023-09-10,19:00:00,152,73,79,FMN 06 B Zurenborgbrug Ringfietspad
655,Ringfietspad Zurenborgbrug,2023-09-10,20:00:00,127,61,66,FMN 06 B Zurenborgbrug Ringfietspad
655,Ringfietspad Zurenborgbrug,2023-09-10,21:00:00,101,54,47,FMN 06 B Zurenborgbrug Ringfietspad
655,Ringfietspad Zurenborgbrug,2023-09-10,22:00:00,55,22,33,FMN 06 B Zurenborgbrug Ringfietspad
655,Ringfietspad Zurenborgbrug,2023-09-10,23:00:00,19,9,10,FMN 06 B Zurenborgbrug Ringfietspad
655,Ringfietspad Zurenborgbrug,2023-09-11,00:00:00,20,11,9,FMN 06 B Zurenborgbrug Ringfietspad
655,Ringfietspad Zurenborgbrug,2023-09-11,01:00:00,15,6,9,FMN 06 B Zurenborgbrug Ringfietspad
655,Ringfietspad Zurenborgbrug,2023-09-11,02:00:00,3,2,1,FMN 06 B Zurenborgbrug Ringfietspad
655,Ringfietspad Zurenborgbrug,2023-09-11,03:00:00,5,3,2,FMN 06 B Zurenborgbrug Ringfietspad
655,Ringfietspad Zurenborgbrug,2023-09-11,04:00:00,20,11,9,FMN 06 B Zurenborgbrug Ringfietspad
655,Ringfietspad Zurenborgbrug,2023-09-11,05:00:00,58,35,23,FMN 06 B Zurenborgbrug Ringfietspad
655,Ringfietspad Zurenborgbrug,2023-09-11,06:00:00,218,125,93,FMN 06 B Zurenborgbrug Ringfietspad
655,Ringfietspad Zurenborgbrug,2023-09-11,07:00:00,603,329,274,FMN 06 B Zurenborgbrug Ringfietspad
655,Ringfietspad Zurenborgbrug,2023-09-11,08:00:00,884,515,369,FMN 06 B Zurenborgbrug Ringfietspad
655,Ringfietspad Zurenborgbrug,2023-09-11,09:00:00,217,119,98,FMN 06 B Zurenborgbrug Ringfietspad
655,Ringfietspad Zurenborgbrug,2023-09-11,10:00:00,140,66,74,FMN 06 B Zurenborgbrug Ringfietspad
655,Ringfietspad Zurenborgbrug,2023-09-11,11:00:00,164,86,78,FMN 06 B Zurenborgbrug Ringfietspad
655,Ringfietspad Zurenborgbrug,2023-09-11,12:00:00,250,114,136,FMN 06 B Zurenborgbrug Ringfietspad
655,Ringfietspad Zurenborgbrug,2023-09-11,13:00:00,223,106,117,FMN 06 B Zurenborgbrug Ringfietspad
655,Ringfietspad Zurenborgbrug,2023-09-11,14:00:00,211,101,110,FMN 06 B Zurenborgbrug Ringfietspad
655,Ringfietspad Zurenborgbrug,2023-09-11,15:00:00,450,168,282,FMN 06 B Zurenborgbrug Ringfietspad
655,Ringfietspad Zurenborgbrug,2023-09-11,16:00:00,743,308,435,FMN 06 B Zurenborgbrug Ringfietspad
655,Ringfietspad Zurenborgbrug,2023-09-11,17:00:00,655,276,379,FMN 06 B Zurenborgbrug Ringfietspad
655,Ringfietspad Zurenborgbrug,2023-09-11,18:00:00,391,178,213,FMN 06 B Zurenborgbrug Ringfietspad
655,Ringfietspad Zurenborgbrug,2023-09-11,19:00:00,196,90,106,FMN 06 B Zurenborgbrug Ringfietspad
655,Ringfietspad Zurenborgbrug,2023-09-11,20:00:00,158,73,85,FMN 06 B Zurenborgbrug Ringfietspad
655,Ringfietspad Zurenborgbrug,2023-09-11,21:00:00,117,37,80,FMN 06 B Zurenborgbrug Ringfietspad
655,Ringfietspad Zurenborgbrug,2023-09-11,22:00:00,86,23,63,FMN 06 B Zurenborgbrug Ringfietspad
655,Ringfietspad Zurenborgbrug,2023-09-11,23:00:00,44,12,32,FMN 06 B Zurenborgbrug Ringfietspad
655,Ringfietspad Zurenborgbrug,2023-09-12,00:00:00,13,6,7,FMN 06 B Zurenborgbrug Ringfietspad
655,Ringfietspad Zurenborgbrug,2023-09-12,01:00:00,6,3,3,FMN 06 B Zurenborgbrug Ringfietspad
655,Ringfietspad Zurenborgbrug,2023-09-12,02:00:00,3,0,3,FMN 06 B Zurenborgbrug Ringfietspad
655,Ringfietspad Zurenborgbrug,2023-09-12,03:00:00,5,4,1,FMN 06 B Zurenborgbrug Ringfietspad
655,Ringfietspad Zurenborgbrug,2023-09-12,04:00:00,22,11,11,FMN 06 B Zurenborgbrug Ringfietspad
655,Ringfietspad Zurenborgbrug,2023-09-12,05:00:00,69,43,26,FMN 06 B Zurenborgbrug Ringfietspad
655,Ringfietspad Zurenborgbrug,2023-09-12,06:00:00,200,114,86,FMN 06 B Zurenborgbrug Ringfietspad
655,Ringfietspad Zurenborgbrug,2023-09-12,07:00:00,600,337,263,FMN 06 B Zurenborgbrug Ringfietspad
655,Ringfietspad Zurenborgbrug,2023-09-12,08:00:00,804,475,329,FMN 06 B Zurenborgbrug Ringfietspad
655,Ringfietspad Zurenborgbrug,2023-09-12,09:00:00,213,109,104,FMN 06 B Zurenborgbrug Ringfietspad
655,Ringfietspad Zurenborgbrug,2023-09-12,10:00:00,125,69,56,FMN 06 B Zurenborgbrug Ringfietspad
655,Ringfietspad Zurenborgbrug,2023-09-12,11:00:00,135,75,60,FMN 06 B Zurenborgbrug Ringfietspad
655,Ringfietspad Zurenborgbrug,2023-09-12,12:00:00,202,99,103,FMN 06 B Zurenborgbrug Ringfietspad
655,Ringfietspad Zurenborgbrug,2023-09-12,13:00:00,207,99,108,FMN 06 B Zurenborgbrug Ringfietspad
655,Ringfietspad Zurenborgbrug,2023-09-12,14:00:00,214,90,124,FMN 06 B Zurenborgbrug Ringfietspad
655,Ringfietspad Zurenborgbrug,2023-09-12,15:00:00,400,167,233,FMN 06 B Zurenborgbrug Ringfietspad
655,Ringfietspad Zurenborgbrug,2023-09-12,16:00:00,706,296,410,FMN 06 B Zurenborgbrug Ringfietspad
655,Ringfietspad Zurenborgbrug,2023-09-12,17:00:00,673,260,413,FMN 06 B Zurenborgbrug Ringfietspad
655,Ringfietspad Zurenborgbrug,2023-09-12,18:00:00,363,145,218,FMN 06 B Zurenborgbrug Ringfietspad
655,Ringfietspad Zurenborgbrug,2023-09-12,19:00:00,190,80,110,FMN 06 B Zurenborgbrug Ringfietspad
655,Ringfietspad Zurenborgbrug,2023-09-12,20:00:00,114,70,44,FMN 06 B Zurenborgbrug Ringfietspad
655,Ringfietspad Zurenborgbrug,2023-09-12,21:00:00,105,37,68,FMN 06 B Zurenborgbrug Ringfietspad
655,Ringfietspad Zurenborgbrug,2023-09-12,22:00:00,105,37,68,FMN 06 B Zurenborgbrug Ringfietspad
655,Ringfietspad Zurenborgbrug,2023-09-12,23:00:00,27,8,19,FMN 06 B Zurenborgbrug Ringfietspad
655,Ringfietspad Zurenborgbrug,2023-09-13,00:00:00,11,6,5,FMN 06 B Zurenborgbrug Ringfietspad
655,Ringfietspad Zurenborgbrug,2023-09-13,01:00:00,7,2,5,FMN 06 B Zurenborgbrug Ringfietspad
655,Ringfietspad Zurenborgbrug,2023-09-13,02:00:00,3,2,1,FMN 06 B Zurenborgbrug Ringfietspad
655,Ringfietspad Zurenborgbrug,2023-09-13,03:00:00,1,1,0,FMN 06 B Zurenborgbrug Ringfietspad
655,Ringfietspad Zurenborgbrug,2023-09-13,04:00:00,15,7,8,FMN 06 B Zurenborgbrug Ringfietspad
655,Ringfietspad Zurenborgbrug,2023-09-13,05:00:00,62,38,24,FMN 06 B Zurenborgbrug Ringfietspad
655,Ringfietspad Zurenborgbrug,2023-09-13,06:00:00,181,105,76,FMN 06 B Zurenborgbrug Ringfietspad
655,Ringfietspad Zurenborgbrug,2023-09-13,07:00:00,503,275,228,FMN 06 B Zurenborgbrug Ringfietspad
655,Ringfietspad Zurenborgbrug,2023-09-13,08:00:00,658,372,286,FMN 06 B Zurenborgbrug Ringfietspad
655,Ringfietspad Zurenborgbrug,2023-09-13,09:00:00,196,95,101,FMN 06 B Zurenborgbrug Ringfietspad
655,Ringfietspad Zurenborgbrug,2023-09-13,10:00:00,116,53,63,FMN 06 B Zurenborgbrug Ringfietspad
655,Ringfietspad Zurenborgbrug,2023-09-13,11:00:00,150,89,61,FMN 06 B Zurenborgbrug Ringfietspad
655,Ringfietspad Zurenborgbrug,2023-09-13,12:00:00,445,221,224,FMN 06 B Zurenborgbrug Ringfietspad
655,Ringfietspad Zurenborgbrug,2023-09-13,13:00:00,283,134,149,FMN 06 B Zurenborgbrug Ringfietspad
655,Ringfietspad Zurenborgbrug,2023-09-13,14:00:00,205,77,128,FMN 06 B Zurenborgbrug Ringfietspad
655,Ringfietspad Zurenborgbrug,2023-09-13,15:00:00,275,103,172,FMN 06 B Zurenborgbrug Ringfietspad
655,Ringfietspad Zurenborgbrug,2023-09-13,16:00:00,446,183,263,FMN 06 B Zurenborgbrug Ringfietspad
655,Ringfietspad Zurenborgbrug,2023-09-13,17:00:00,508,190,318,FMN 06 B Zurenborgbrug Ringfietspad
655,Ringfietspad Zurenborgbrug,2023-09-13,18:00:00,376,155,221,FMN 06 B Zurenborgbrug Ringfietspad
655,Ringfietspad Zurenborgbrug,2023-09-13,19:00:00,232,87,145,FMN 06 B Zurenborgbrug Ringfietspad
655,Ringfietspad Zurenborgbrug,2023-09-13,20:00:00,152,65,87,FMN 06 B Zurenborgbrug Ringfietspad
655,Ringfietspad Zurenborgbrug,2023-09-13,21:00:00,125,65,60,FMN 06 B Zurenborgbrug Ringfietspad
655,Ringfietspad Zurenborgbrug,2023-09-13,22:00:00,112,41,71,FMN 06 B Zurenborgbrug Ringfietspad
655,Ringfietspad Zurenborgbrug,2023-09-13,23:00:00,41,14,27,FMN 06 B Zurenborgbrug Ringfietspad
655,Ringfietspad Zurenborgbrug,2023-09-14,00:00:00,20,12,8,FMN 06 B Zurenborgbrug Ringfietspad
655,Ringfietspad Zurenborgbrug,2023-09-14,01:00:00,11,5,6,FMN 06 B Zurenborgbrug Ringfietspad
655,Ringfietspad Zurenborgbrug,2023-09-14,02:00:00,1,1,0,FMN 06 B Zurenborgbrug Ringfietspad
655,Ringfietspad Zurenborgbrug,2023-09-14,03:00:00,3,1,2,FMN 06 B Zurenborgbrug Ringfietspad
655,Ringfietspad Zurenborgbrug,2023-09-14,04:00:00,20,10,10,FMN 06 B Zurenborgbrug Ringfietspad
655,Ringfietspad Zurenborgbrug,2023-09-14,05:00:00,55,33,22,FMN 06 B Zurenborgbrug Ringfietspad
655,Ringfietspad Zurenborgbrug,2023-09-14,06:00:00,174,99,75,FMN 06 B Zurenborgbrug Ringfietspad
655,Ringfietspad Zurenborgbrug,2023-09-14,07:00:00,599,340,259,FMN 06 B Zurenborgbrug Ringfietspad
655,Ringfietspad Zurenborgbrug,2023-09-14,08:00:00,776,440,336,FMN 06 B Zurenborgbrug Ringfietspad
655,Ringfietspad Zurenborgbrug,2023-09-14,09:00:00,210,109,101,FMN 06 B Zurenborgbrug Ringfietspad
655,Ringfietspad Zurenborgbrug,2023-09-14,10:00:00,119,58,61,FMN 06 B Zurenborgbrug Ringfietspad
655,Ringfietspad Zurenborgbrug,2023-09-14,11:00:00,128,72,56,FMN 06 B Zurenborgbrug Ringfietspad
655,Ringfietspad Zurenborgbrug,2023-09-14,12:00:00,252,139,113,FMN 06 B Zurenborgbrug Ringfietspad
655,Ringfietspad Zurenborgbrug,2023-09-14,13:00:00,274,143,131,FMN 06 B Zurenborgbrug Ringfietspad
655,Ringfietspad Zurenborgbrug,2023-09-14,14:00:00,225,100,125,FMN 06 B Zurenborgbrug Ringfietspad
655,Ringfietspad Zurenborgbrug,2023-09-14,15:00:00,445,173,272,FMN 06 B Zurenborgbrug Ringfietspad
655,Ringfietspad Zurenborgbrug,2023-09-14,16:00:00,690,293,397,FMN 06 B Zurenborgbrug Ringfietspad
655,Ringfietspad Zurenborgbrug,2023-09-14,17:00:00,657,242,415,FMN 06 B Zurenborgbrug Ringfietspad
655,Ringfietspad Zurenborgbrug,2023-09-14,18:00:00,437,191,246,FMN 06 B Zurenborgbrug Ringfietspad
655,Ringfietspad Zurenborgbrug,2023-09-14,19:00:00,257,119,138,FMN 06 B Zurenborgbrug Ringfietspad
655,Ringfietspad Zurenborgbrug,2023-09-14,20:00:00,153,67,86,FMN 06 B Zurenborgbrug Ringfietspad
655,Ringfietspad Zurenborgbrug,2023-09-14,21:00:00,141,63,78,FMN 06 B Zurenborgbrug Ringfietspad
655,Ringfietspad Zurenborgbrug,2023-09-14,22:00:00,126,45,81,FMN 06 B Zurenborgbrug Ringfietspad
655,Ringfietspad Zurenborgbrug,2023-09-14,23:00:00,50,20,30,FMN 06 B Zurenborgbrug Ringfietspad
655,Ringfietspad Zurenborgbrug,2023-09-15,00:00:00,25,12,13,FMN 06 B Zurenborgbrug Ringfietspad
655,Ringfietspad Zurenborgbrug,2023-09-15,01:00:00,7,1,6,FMN 06 B Zurenborgbrug Ringfietspad
655,Ringfietspad Zurenborgbrug,2023-09-15,02:00:00,4,1,3,FMN 06 B Zurenborgbrug Ringfietspad
655,Ringfietspad Zurenborgbrug,2023-09-15,03:00:00,3,3,0,FMN 06 B Zurenborgbrug Ringfietspad
655,Ringfietspad Zurenborgbrug,2023-09-15,04:00:00,19,8,11,FMN 06 B Zurenborgbrug Ringfietspad
655,Ringfietspad Zurenborgbrug,2023-09-15,05:00:00,52,29,23,FMN 06 B Zurenborgbrug Ringfietspad
655,Ringfietspad Zurenborgbrug,2023-09-15,06:00:00,158,87,71,FMN 06 B Zurenborgbrug Ringfietspad
655,Ringfietspad Zurenborgbrug,2023-09-15,07:00:00,478,271,207,FMN 06 B Zurenborgbrug Ringfietspad
655,Ringfietspad Zurenborgbrug,2023-09-15,08:00:00,692,412,280,FMN 06 B Zurenborgbrug Ringfietspad
655,Ringfietspad Zurenborgbrug,2023-09-15,09:00:00,236,142,94,FMN 06 B Zurenborgbrug Ringfietspad
655,Ringfietspad Zurenborgbrug,2023-09-15,10:00:00,135,73,62,FMN 06 B Zurenborgbrug Ringfietspad
655,Ringfietspad Zurenborgbrug,2023-09-15,11:00:00,158,77,81,FMN 06 B Zurenborgbrug Ringfietspad
655,Ringfietspad Zurenborgbrug,2023-09-15,12:00:00,295,121,174,FMN 06 B Zurenborgbrug Ringfietspad
655,Ringfietspad Zurenborgbrug,2023-09-15,13:00:00,248,133,115,FMN 06 B Zurenborgbrug Ringfietspad
655,Ringfietspad Zurenborgbrug,2023-09-15,14:00:00,301,120,181,FMN 06 B Zurenborgbrug Ringfietspad
655,Ringfietspad Zurenborgbrug,2023-09-15,15:00:00,388,171,217,FMN 06 B Zurenborgbrug Ringfietspad
655,Ringfietspad Zurenborgbrug,2023-09-15,16:00:00,671,251,420,FMN 06 B Zurenborgbrug Ringfietspad
655,Ringfietspad Zurenborgbrug,2023-09-15,17:00:00,479,216,263,FMN 06 B Zurenborgbrug Ringfietspad
655,Ringfietspad Zurenborgbrug,2023-09-15,18:00:00,319,150,169,FMN 06 B Zurenborgbrug Ringfietspad
655,Ringfietspad Zurenborgbrug,2023-09-15,19:00:00,226,98,128,FMN 06 B Zurenborgbrug Ringfietspad
655,Ringfietspad Zurenborgbrug,2023-09-15,20:00:00,122,57,65,FMN 06 B Zurenborgbrug Ringfietspad
655,Ringfietspad Zurenborgbrug,2023-09-15,21:00:00,75,34,41,FMN 06 B Zurenborgbrug Ringfietspad
655,Ringfietspad Zurenborgbrug,2023-09-15,22:00:00,94,47,47,FMN 06 B Zurenborgbrug Ringfietspad
655,Ringfietspad Zurenborgbrug,2023-09-15,23:00:00,74,44,30,FMN 06 B Zurenborgbrug Ringfietspad
655,Ringfietspad Zurenborgbrug,2023-09-16,00:00:00,55,26,29,FMN 06 B Zurenborgbrug Ringfietspad
655,Ringfietspad Zurenborgbrug,2023-09-16,01:00:00,41,14,27,FMN 06 B Zurenborgbrug Ringfietspad
655,Ringfietspad Zurenborgbrug,2023-09-16,02:00:00,17,7,10,FMN 06 B Zurenborgbrug Ringfietspad
655,Ringfietspad Zurenborgbrug,2023-09-16,03:00:00,5,1,4,FMN 06 B Zurenborgbrug Ringfietspad
655,Ringfietspad Zurenborgbrug,2023-09-16,04:00:00,10,7,3,FMN 06 B Zurenborgbrug Ringfietspad
655,Ringfietspad Zurenborgbrug,2023-09-16,05:00:00,17,7,10,FMN 06 B Zurenborgbrug Ringfietspad
655,Ringfietspad Zurenborgbrug,2023-09-16,06:00:00,28,15,13,FMN 06 B Zurenborgbrug Ringfietspad
655,Ringfietspad Zurenborgbrug,2023-09-16,07:00:00,32,16,16,FMN 06 B Zurenborgbrug Ringfietspad
655,Ringfietspad Zurenborgbrug,2023-09-16,08:00:00,103,56,47,FMN 06 B Zurenborgbrug Ringfietspad
655,Ringfietspad Zurenborgbrug,2023-09-16,09:00:00,176,67,109,FMN 06 B Zurenborgbrug Ringfietspad
655,Ringfietspad Zurenborgbrug,2023-09-16,10:00:00,160,70,90,FMN 06 B Zurenborgbrug Ringfietspad
655,Ringfietspad Zurenborgbrug,2023-09-16,11:00:00,194,103,91,FMN 06 B Zurenborgbrug Ringfietspad
655,Ringfietspad Zurenborgbrug,2023-09-16,12:00:00,235,116,119,FMN 06 B Zurenborgbrug Ringfietspad
655,Ringfietspad Zurenborgbrug,2023-09-16,13:00:00,217,103,114,FMN 06 B Zurenborgbrug Ringfietspad
655,Ringfietspad Zurenborgbrug,2023-09-16,14:00:00,250,119,131,FMN 06 B Zurenborgbrug Ringfietspad
655,Ringfietspad Zurenborgbrug,2023-09-16,15:00:00,248,130,118,FMN 06 B Zurenborgbrug Ringfietspad
655,Ringfietspad Zurenborgbrug,2023-09-16,16:00:00,213,106,107,FMN 06 B Zurenborgbrug Ringfietspad
655,Ringfietspad Zurenborgbrug,2023-09-16,17:00:00,198,95,103,FMN 06 B Zurenborgbrug Ringfietspad
655,Ringfietspad Zurenborgbrug,2023-09-16,18:00:00,181,79,102,FMN 06 B Zurenborgbrug Ringfietspad
655,Ringfietspad Zurenborgbrug,2023-09-16,19:00:00,148,72,76,FMN 06 B Zurenborgbrug Ringfietspad
655,Ringfietspad Zurenborgbrug,2023-09-16,20:00:00,89,35,54,FMN 06 B Zurenborgbrug Ringfietspad
655,Ringfietspad Zurenborgbrug,2023-09-16,21:00:00,61,21,40,FMN 06 B Zurenborgbrug Ringfietspad
655,Ringfietspad Zurenborgbrug,2023-09-16,22:00:00,70,25,45,FMN 06 B Zurenborgbrug Ringfietspad
655,Ringfietspad Zurenborgbrug,2023-09-16,23:00:00,55,27,28,FMN 06 B Zurenborgbrug Ringfietspad
655,Ringfietspad Zurenborgbrug,2023-09-17,00:00:00,44,19,25,FMN 06 B Zurenborgbrug Ringfietspad
655,Ringfietspad Zurenborgbrug,2023-09-17,01:00:00,28,14,14,FMN 06 B Zurenborgbrug Ringfietspad
655,Ringfietspad Zurenborgbrug,2023-09-17,02:00:00,21,7,14,FMN 06 B Zurenborgbrug Ringfietspad
655,Ringfietspad Zurenborgbrug,2023-09-17,03:00:00,9,7,2,FMN 06 B Zurenborgbrug Ringfietspad
655,Ringfietspad Zurenborgbrug,2023-09-17,04:00:00,8,6,2,FMN 06 B Zurenborgbrug Ringfietspad
655,Ringfietspad Zurenborgbrug,2023-09-17,05:00:00,8,4,4,FMN 06 B Zurenborgbrug Ringfietspad
655,Ringfietspad Zurenborgbrug,2023-09-17,06:00:00,20,9,11,FMN 06 B Zurenborgbrug Ringfietspad
655,Ringfietspad Zurenborgbrug,2023-09-17,07:00:00,42,24,18,FMN 06 B Zurenborgbrug Ringfietspad
655,Ringfietspad Zurenborgbrug,2023-09-17,08:00:00,46,18,28,FMN 06 B Zurenborgbrug Ringfietspad
655,Ringfietspad Zurenborgbrug,2023-09-17,09:00:00,106,43,63,FMN 06 B Zurenborgbrug Ringfietspad
655,Ringfietspad Zurenborgbrug,2023-09-17,10:00:00,134,63,71,FMN 06 B Zurenborgbrug Ringfietspad
655,Ringfietspad Zurenborgbrug,2023-09-17,11:00:00,160,77,83,FMN 06 B Zurenborgbrug Ringfietspad
655,Ringfietspad Zurenborgbrug,2023-09-17,12:00:00,172,87,85,FMN 06 B Zurenborgbrug Ringfietspad
655,Ringfietspad Zurenborgbrug,2023-09-17,13:00:00,239,110,129,FMN 06 B Zurenborgbrug Ringfietspad
655,Ringfietspad Zurenborgbrug,2023-09-17,14:00:00,244,126,118,FMN 06 B Zurenborgbrug Ringfietspad
655,Ringfietspad Zurenborgbrug,2023-09-17,15:00:00,197,88,109,FMN 06 B Zurenborgbrug Ringfietspad
655,Ringfietspad Zurenborgbrug,2023-09-17,16:00:00,242,121,121,FMN 06 B Zurenborgbrug Ringfietspad
655,Ringfietspad Zurenborgbrug,2023-09-17,17:00:00,172,86,86,FMN 06 B Zurenborgbrug Ringfietspad
655,Ringfietspad Zurenborgbrug,2023-09-17,18:00:00,155,77,78,FMN 06 B Zurenborgbrug Ringfietspad
655,Ringfietspad Zurenborgbrug,2023-09-17,19:00:00,109,43,66,FMN 06 B Zurenborgbrug Ringfietspad
655,Ringfietspad Zurenborgbrug,2023-09-17,20:00:00,78,42,36,FMN 06 B Zurenborgbrug Ringfietspad
655,Ringfietspad Zurenborgbrug,2023-09-17,21:00:00,52,14,38,FMN 06 B Zurenborgbrug Ringfietspad
655,Ringfietspad Zurenborgbrug,2023-09-17,22:00:00,40,17,23,FMN 06 B Zurenborgbrug Ringfietspad
655,Ringfietspad Zurenborgbrug,2023-09-17,23:00:00,26,8,18,FMN 06 B Zurenborgbrug Ringfietspad
655,Ringfietspad Zurenborgbrug,2023-09-18,00:00:00,12,7,5,FMN 06 B Zurenborgbrug Ringfietspad
655,Ringfietspad Zurenborgbrug,2023-09-18,01:00:00,11,4,7,FMN 06 B Zurenborgbrug Ringfietspad
655,Ringfietspad Zurenborgbrug,2023-09-18,02:00:00,4,2,2,FMN 06 B Zurenborgbrug Ringfietspad
655,Ringfietspad Zurenborgbrug,2023-09-18,03:00:00,0,0,0,FMN 06 B Zurenborgbrug Ringfietspad
655,Ringfietspad Zurenborgbrug,2023-09-18,04:00:00,19,15,4,FMN 06 B Zurenborgbrug Ringfietspad
655,Ringfietspad Zurenborgbrug,2023-09-18,05:00:00,49,29,20,FMN 06 B Zurenborgbrug Ringfietspad
655,Ringfietspad Zurenborgbrug,2023-09-18,06:00:00,164,95,69,FMN 06 B Zurenborgbrug Ringfietspad
655,Ringfietspad Zurenborgbrug,2023-09-18,07:00:00,512,313,199,FMN 06 B Zurenborgbrug Ringfietspad
655,Ringfietspad Zurenborgbrug,2023-09-18,08:00:00,758,426,332,FMN 06 B Zurenborgbrug Ringfietspad
655,Ringfietspad Zurenborgbrug,2023-09-18,09:00:00,225,126,99,FMN 06 B Zurenborgbrug Ringfietspad
655,Ringfietspad Zurenborgbrug,2023-09-18,10:00:00,101,63,38,FMN 06 B Zurenborgbrug Ringfietspad
655,Ringfietspad Zurenborgbrug,2023-09-18,11:00:00,111,49,62,FMN 06 B Zurenborgbrug Ringfietspad
655,Ringfietspad Zurenborgbrug,2023-09-18,12:00:00,205,97,108,FMN 06 B Zurenborgbrug Ringfietspad
655,Ringfietspad Zurenborgbrug,2023-09-18,13:00:00,160,76,84,FMN 06 B Zurenborgbrug Ringfietspad
655,Ringfietspad Zurenborgbrug,2023-09-18,14:00:00,201,81,120,FMN 06 B Zurenborgbrug Ringfietspad
655,Ringfietspad Zurenborgbrug,2023-09-18,15:00:00,366,139,227,FMN 06 B Zurenborgbrug Ringfietspad
655,Ringfietspad Zurenborgbrug,2023-09-18,16:00:00,562,215,347,FMN 06 B Zurenborgbrug Ringfietspad
655,Ringfietspad Zurenborgbrug,2023-09-18,17:00:00,572,247,325,FMN 06 B Zurenborgbrug Ringfietspad
655,Ringfietspad Zurenborgbrug,2023-09-18,18:00:00,347,158,189,FMN 06 B Zurenborgbrug Ringfietspad
655,Ringfietspad Zurenborgbrug,2023-09-18,19:00:00,165,82,83,FMN 06 B Zurenborgbrug Ringfietspad
655,Ringfietspad Zurenborgbrug,2023-09-18,20:00:00,114,43,71,FMN 06 B Zurenborgbrug Ringfietspad
655,Ringfietspad Zurenborgbrug,2023-09-18,21:00:00,104,37,67,FMN 06 B Zurenborgbrug Ringfietspad
655,Ringfietspad Zurenborgbrug,2023-09-18,22:00:00,78,24,54,FMN 06 B Zurenborgbrug Ringfietspad
655,Ringfietspad Zurenborgbrug,2023-09-18,23:00:00,40,20,20,FMN 06 B Zurenborgbrug Ringfietspad
655,Ringfietspad Zurenborgbrug,2023-09-19,00:00:00,11,5,6,FMN 06 B Zurenborgbrug Ringfietspad
655,Ringfietspad Zurenborgbrug,2023-09-19,01:00:00,3,2,1,FMN 06 B Zurenborgbrug Ringfietspad
655,Ringfietspad Zurenborgbrug,2023-09-19,02:00:00,5,3,2,FMN 06 B Zurenborgbrug Ringfietspad
655,Ringfietspad Zurenborgbrug,2023-09-19,03:00:00,2,1,1,FMN 06 B Zurenborgbrug Ringfietspad
655,Ringfietspad Zurenborgbrug,2023-09-19,04:00:00,20,15,5,FMN 06 B Zurenborgbrug Ringfietspad
655,Ringfietspad Zurenborgbrug,2023-09-19,05:00:00,51,28,23,FMN 06 B Zurenborgbrug Ringfietspad
655,Ringfietspad Zurenborgbrug,2023-09-19,06:00:00,194,108,86,FMN 06 B Zurenborgbrug Ringfietspad
655,Ringfietspad Zurenborgbrug,2023-09-19,07:00:00,577,336,241,FMN 06 B Zurenborgbrug Ringfietspad
655,Ringfietspad Zurenborgbrug,2023-09-19,08:00:00,775,437,338,FMN 06 B Zurenborgbrug Ringfietspad
655,Ringfietspad Zurenborgbrug,2023-09-19,09:00:00,228,127,101,FMN 06 B Zurenborgbrug Ringfietspad
655,Ringfietspad Zurenborgbrug,2023-09-19,10:00:00,118,69,49,FMN 06 B Zurenborgbrug Ringfietspad
655,Ringfietspad Zurenborgbrug,2023-09-19,11:00:00,117,48,69,FMN 06 B Zurenborgbrug Ringfietspad
655,Ringfietspad Zurenborgbrug,2023-09-19,12:00:00,202,91,111,FMN 06 B Zurenborgbrug Ringfietspad
655,Ringfietspad Zurenborgbrug,2023-09-19,13:00:00,223,110,113,FMN 06 B Zurenborgbrug Ringfietspad
655,Ringfietspad Zurenborgbrug,2023-09-19,14:00:00,213,93,120,FMN 06 B Zurenborgbrug Ringfietspad
655,Ringfietspad Zurenborgbrug,2023-09-19,15:00:00,343,143,200,FMN 06 B Zurenborgbrug Ringfietspad
655,Ringfietspad Zurenborgbrug,2023-09-19,16:00:00,678,289,389,FMN 06 B Zurenborgbrug Ringfietspad
655,Ringfietspad Zurenborgbrug,2023-09-19,17:00:00,631,234,397,FMN 06 B Zurenborgbrug Ringfietspad
655,Ringfietspad Zurenborgbrug,2023-09-19,18:00:00,359,151,208,FMN 06 B Zurenborgbrug Ringfietspad
655,Ringfietspad Zurenborgbrug,2023-09-19,19:00:00,177,75,102,FMN 06 B Zurenborgbrug Ringfietspad
655,Ringfietspad Zurenborgbrug,2023-09-19,20:00:00,100,50,50,FMN 06 B Zurenborgbrug Ringfietspad
655,Ringfietspad Zurenborgbrug,2023-09-19,21:00:00,95,31,64,FMN 06 B Zurenborgbrug Ringfietspad
655,Ringfietspad Zurenborgbrug,2023-09-19,22:00:00,89,34,55,FMN 06 B Zurenborgbrug Ringfietspad
655,Ringfietspad Zurenborgbrug,2023-09-19,23:00:00,48,21,27,FMN 06 B Zurenborgbrug Ringfietspad
655,Ringfietspad Zurenborgbrug,2023-09-20,00:00:00,7,5,2,FMN 06 B Zurenborgbrug Ringfietspad
655,Ringfietspad Zurenborgbrug,2023-09-20,01:00:00,7,5,2,FMN 06 B Zurenborgbrug Ringfietspad
655,Ringfietspad Zurenborgbrug,2023-09-20,02:00:00,2,0,2,FMN 06 B Zurenborgbrug Ringfietspad
655,Ringfietspad Zurenborgbrug,2023-09-20,03:00:00,4,2,2,FMN 06 B Zurenborgbrug Ringfietspad
655,Ringfietspad Zurenborgbrug,2023-09-20,04:00:00,18,11,7,FMN 06 B Zurenborgbrug Ringfietspad
655,Ringfietspad Zurenborgbrug,2023-09-20,05:00:00,46,32,14,FMN 06 B Zurenborgbrug Ringfietspad
655,Ringfietspad Zurenborgbrug,2023-09-20,06:00:00,171,90,81,FMN 06 B Zurenborgbrug Ringfietspad
655,Ringfietspad Zurenborgbrug,2023-09-20,07:00:00,518,281,237,FMN 06 B Zurenborgbrug Ringfietspad
655,Ringfietspad Zurenborgbrug,2023-09-20,08:00:00,623,335,288,FMN 06 B Zurenborgbrug Ringfietspad
655,Ringfietspad Zurenborgbrug,2023-09-20,09:00:00,208,114,94,FMN 06 B Zurenborgbrug Ringfietspad
655,Ringfietspad Zurenborgbrug,2023-09-20,10:00:00,125,67,58,FMN 06 B Zurenborgbrug Ringfietspad
655,Ringfietspad Zurenborgbrug,2023-09-20,11:00:00,156,75,81,FMN 06 B Zurenborgbrug Ringfietspad
655,Ringfietspad Zurenborgbrug,2023-09-20,12:00:00,413,210,203,FMN 06 B Zurenborgbrug Ringfietspad
655,Ringfietspad Zurenborgbrug,2023-09-20,13:00:00,254,113,141,FMN 06 B Zurenborgbrug Ringfietspad
655,Ringfietspad Zurenborgbrug,2023-09-20,14:00:00,220,103,117,FMN 06 B Zurenborgbrug Ringfietspad
655,Ringfietspad Zurenborgbrug,2023-09-20,15:00:00,278,115,163,FMN 06 B Zurenborgbrug Ringfietspad
655,Ringfietspad Zurenborgbrug,2023-09-20,16:00:00,469,186,283,FMN 06 B Zurenborgbrug Ringfietspad
655,Ringfietspad Zurenborgbrug,2023-09-20,17:00:00,518,212,306,FMN 06 B Zurenborgbrug Ringfietspad
655,Ringfietspad Zurenborgbrug,2023-09-20,18:00:00,378,168,210,FMN 06 B Zurenborgbrug Ringfietspad
655,Ringfietspad Zurenborgbrug,2023-09-20,19:00:00,229,78,151,FMN 06 B Zurenborgbrug Ringfietspad
655,Ringfietspad Zurenborgbrug,2023-09-20,20:00:00,125,58,67,FMN 06 B Zurenborgbrug Ringfietspad
655,Ringfietspad Zurenborgbrug,2023-09-20,21:00:00,115,44,71,FMN 06 B Zurenborgbrug Ringfietspad
655,Ringfietspad Zurenborgbrug,2023-09-20,22:00:00,81,32,49,FMN 06 B Zurenborgbrug Ringfietspad
655,Ringfietspad Zurenborgbrug,2023-09-20,23:00:00,30,12,18,FMN 06 B Zurenborgbrug Ringfietspad
655,Ringfietspad Zurenborgbrug,2023-09-21,00:00:00,16,4,12,FMN 06 B Zurenborgbrug Ringfietspad
655,Ringfietspad Zurenborgbrug,2023-09-21,01:00:00,3,2,1,FMN 06 B Zurenborgbrug Ringfietspad
655,Ringfietspad Zurenborgbrug,2023-09-21,02:00:00,3,0,3,FMN 06 B Zurenborgbrug Ringfietspad
655,Ringfietspad Zurenborgbrug,2023-09-21,03:00:00,4,1,3,FMN 06 B Zurenborgbrug Ringfietspad
655,Ringfietspad Zurenborgbrug,2023-09-21,04:00:00,16,14,2,FMN 06 B Zurenborgbrug Ringfietspad
655,Ringfietspad Zurenborgbrug,2023-09-21,05:00:00,38,25,13,FMN 06 B Zurenborgbrug Ringfietspad
655,Ringfietspad Zurenborgbrug,2023-09-21,06:00:00,118,69,49,FMN 06 B Zurenborgbrug Ringfietspad
655,Ringfietspad Zurenborgbrug,2023-09-21,07:00:00,387,226,161,FMN 06 B Zurenborgbrug Ringfietspad
655,Ringfietspad Zurenborgbrug,2023-09-21,08:00:00,543,301,242,FMN 06 B Zurenborgbrug Ringfietspad
655,Ringfietspad Zurenborgbrug,2023-09-21,09:00:00,163,93,70,FMN 06 B Zurenborgbrug Ringfietspad
655,Ringfietspad Zurenborgbrug,2023-09-21,10:00:00,63,33,30,FMN 06 B Zurenborgbrug Ringfietspad
655,Ringfietspad Zurenborgbrug,2023-09-21,11:00:00,52,28,24,FMN 06 B Zurenborgbrug Ringfietspad
655,Ringfietspad Zurenborgbrug,2023-09-21,12:00:00,129,55,74,FMN 06 B Zurenborgbrug Ringfietspad
655,Ringfietspad Zurenborgbrug,2023-09-21,13:00:00,77,34,43,FMN 06 B Zurenborgbrug Ringfietspad
655,Ringfietspad Zurenborgbrug,2023-09-21,14:00:00,112,44,68,FMN 06 B Zurenborgbrug Ringfietspad
655,Ringfietspad Zurenborgbrug,2023-09-21,15:00:00,234,87,147,FMN 06 B Zurenborgbrug Ringfietspad
655,Ringfietspad Zurenborgbrug,2023-09-21,16:00:00,412,149,263,FMN 06 B Zurenborgbrug Ringfietspad
655,Ringfietspad Zurenborgbrug,2023-09-21,17:00:00,376,137,239,FMN 06 B Zurenborgbrug Ringfietspad
655,Ringfietspad Zurenborgbrug,2023-09-21,18:00:00,248,99,149,FMN 06 B Zurenborgbrug Ringfietspad
655,Ringfietspad Zurenborgbrug,2023-09-21,19:00:00,136,50,86,FMN 06 B Zurenborgbrug Ringfietspad
655,Ringfietspad Zurenborgbrug,2023-09-21,20:00:00,75,39,36,FMN 06 B Zurenborgbrug Ringfietspad
655,Ringfietspad Zurenborgbrug,2023-09-21,21:00:00,80,34,46,FMN 06 B Zurenborgbrug Ringfietspad
655,Ringfietspad Zurenborgbrug,2023-09-21,22:00:00,68,38,30,FMN 06 B Zurenborgbrug Ringfietspad
655,Ringfietspad Zurenborgbrug,2023-09-21,23:00:00,31,10,21,FMN 06 B Zurenborgbrug Ringfietspad
655,Ringfietspad Zurenborgbrug,2023-09-22,00:00:00,18,6,12,FMN 06 B Zurenborgbrug Ringfietspad
655,Ringfietspad Zurenborgbrug,2023-09-22,01:00:00,9,4,5,FMN 06 B Zurenborgbrug Ringfietspad
655,Ringfietspad Zurenborgbrug,2023-09-22,02:00:00,3,0,3,FMN 06 B Zurenborgbrug Ringfietspad
655,Ringfietspad Zurenborgbrug,2023-09-22,03:00:00,2,1,1,FMN 06 B Zurenborgbrug Ringfietspad
655,Ringfietspad Zurenborgbrug,2023-09-22,04:00:00,16,13,3,FMN 06 B Zurenborgbrug Ringfietspad
655,Ringfietspad Zurenborgbrug,2023-09-22,05:00:00,50,38,12,FMN 06 B Zurenborgbrug Ringfietspad
655,Ringfietspad Zurenborgbrug,2023-09-22,06:00:00,130,72,58,FMN 06 B Zurenborgbrug Ringfietspad
655,Ringfietspad Zurenborgbrug,2023-09-22,07:00:00,388,207,181,FMN 06 B Zurenborgbrug Ringfietspad
655,Ringfietspad Zurenborgbrug,2023-09-22,08:00:00,575,337,238,FMN 06 B Zurenborgbrug Ringfietspad
655,Ringfietspad Zurenborgbrug,2023-09-22,09:00:00,203,71,132,FMN 06 B Zurenborgbrug Ringfietspad
655,Ringfietspad Zurenborgbrug,2023-09-22,10:00:00,105,52,53,FMN 06 B Zurenborgbrug Ringfietspad
655,Ringfietspad Zurenborgbrug,2023-09-22,11:00:00,120,78,42,FMN 06 B Zurenborgbrug Ringfietspad
655,Ringfietspad Zurenborgbrug,2023-09-22,12:00:00,187,80,107,FMN 06 B Zurenborgbrug Ringfietspad
655,Ringfietspad Zurenborgbrug,2023-09-22,13:00:00,202,116,86,FMN 06 B Zurenborgbrug Ringfietspad
655,Ringfietspad Zurenborgbrug,2023-09-22,14:00:00,202,72,130,FMN 06 B Zurenborgbrug Ringfietspad
655,Ringfietspad Zurenborgbrug,2023-09-22,15:00:00,312,120,192,FMN 06 B Zurenborgbrug Ringfietspad
655,Ringfietspad Zurenborgbrug,2023-09-22,16:00:00,454,208,246,FMN 06 B Zurenborgbrug Ringfietspad
655,Ringfietspad Zurenborgbrug,2023-09-22,17:00:00,338,121,217,FMN 06 B Zurenborgbrug Ringfietspad
655,Ringfietspad Zurenborgbrug,2023-09-22,18:00:00,221,88,133,FMN 06 B Zurenborgbrug Ringfietspad
655,Ringfietspad Zurenborgbrug,2023-09-22,19:00:00,136,67,69,FMN 06 B Zurenborgbrug Ringfietspad
655,Ringfietspad Zurenborgbrug,2023-09-22,20:00:00,80,39,41,FMN 06 B Zurenborgbrug Ringfietspad
655,Ringfietspad Zurenborgbrug,2023-09-22,21:00:00,62,24,38,FMN 06 B Zurenborgbrug Ringfietspad
655,Ringfietspad Zurenborgbrug,2023-09-22,22:00:00,82,38,44,FMN 06 B Zurenborgbrug Ringfietspad
655,Ringfietspad Zurenborgbrug,2023-09-22,23:00:00,49,18,31,FMN 06 B Zurenborgbrug Ringfietspad
655,Ringfietspad Zurenborgbrug,2023-09-23,00:00:00,25,10,15,FMN 06 B Zurenborgbrug Ringfietspad
655,Ringfietspad Zurenborgbrug,2023-09-23,01:00:00,18,9,9,FMN 06 B Zurenborgbrug Ringfietspad
655,Ringfietspad Zurenborgbrug,2023-09-23,02:00:00,6,1,5,FMN 06 B Zurenborgbrug Ringfietspad
655,Ringfietspad Zurenborgbrug,2023-09-23,03:00:00,8,2,6,FMN 06 B Zurenborgbrug Ringfietspad
655,Ringfietspad Zurenborgbrug,2023-09-23,04:00:00,3,1,2,FMN 06 B Zurenborgbrug Ringfietspad
655,Ringfietspad Zurenborgbrug,2023-09-23,05:00:00,20,13,7,FMN 06 B Zurenborgbrug Ringfietspad
655,Ringfietspad Zurenborgbrug,2023-09-23,06:00:00,17,9,8,FMN 06 B Zurenborgbrug Ringfietspad
655,Ringfietspad Zurenborgbrug,2023-09-23,07:00:00,48,30,18,FMN 06 B Zurenborgbrug Ringfietspad
655,Ringfietspad Zurenborgbrug,2023-09-23,08:00:00,90,37,53,FMN 06 B Zurenborgbrug Ringfietspad
655,Ringfietspad Zurenborgbrug,2023-09-23,09:00:00,132,73,59,FMN 06 B Zurenborgbrug Ringfietspad
655,Ringfietspad Zurenborgbrug,2023-09-23,10:00:00,115,43,72,FMN 06 B Zurenborgbrug Ringfietspad
655,Ringfietspad Zurenborgbrug,2023-09-23,11:00:00,165,70,95,FMN 06 B Zurenborgbrug Ringfietspad
655,Ringfietspad Zurenborgbrug,2023-09-23,12:00:00,167,79,88,FMN 06 B Zurenborgbrug Ringfietspad
655,Ringfietspad Zurenborgbrug,2023-09-23,13:00:00,230,88,142,FMN 06 B Zurenborgbrug Ringfietspad
655,Ringfietspad Zurenborgbrug,2023-09-23,14:00:00,229,94,135,FMN 06 B Zurenborgbrug Ringfietspad
655,Ringfietspad Zurenborgbrug,2023-09-23,15:00:00,176,82,94,FMN 06 B Zurenborgbrug Ringfietspad
655,Ringfietspad Zurenborgbrug,2023-09-23,16:00:00,210,107,103,FMN 06 B Zurenborgbrug Ringfietspad
655,Ringfietspad Zurenborgbrug,2023-09-23,17:00:00,189,103,86,FMN 06 B Zurenborgbrug Ringfietspad
655,Ringfietspad Zurenborgbrug,2023-09-23,18:00:00,196,86,110,FMN 06 B Zurenborgbrug Ringfietspad
655,Ringfietspad Zurenborgbrug,2023-09-23,19:00:00,182,54,128,FMN 06 B Zurenborgbrug Ringfietspad
655,Ringfietspad Zurenborgbrug,2023-09-23,20:00:00,138,42,96,FMN 06 B Zurenborgbrug Ringfietspad
655,Ringfietspad Zurenborgbrug,2023-09-23,21:00:00,52,22,30,FMN 06 B Zurenborgbrug Ringfietspad
655,Ringfietspad Zurenborgbrug,2023-09-23,22:00:00,63,30,33,FMN 06 B Zurenborgbrug Ringfietspad
655,Ringfietspad Zurenborgbrug,2023-09-23,23:00:00,102,81,21,FMN 06 B Zurenborgbrug Ringfietspad
655,Ringfietspad Zurenborgbrug,2023-09-24,00:00:00,57,32,25,FMN 06 B Zurenborgbrug Ringfietspad
655,Ringfietspad Zurenborgbrug,2023-09-24,01:00:00,25,11,14,FMN 06 B Zurenborgbrug Ringfietspad
655,Ringfietspad Zurenborgbrug,2023-09-24,02:00:00,9,4,5,FMN 06 B Zurenborgbrug Ringfietspad
655,Ringfietspad Zurenborgbrug,2023-09-24,03:00:00,13,7,6,FMN 06 B Zurenborgbrug Ringfietspad
655,Ringfietspad Zurenborgbrug,2023-09-24,04:00:00,9,4,5,FMN 06 B Zurenborgbrug Ringfietspad
655,Ringfietspad Zurenborgbrug,2023-09-24,05:00:00,17,8,9,FMN 06 B Zurenborgbrug Ringfietspad
655,Ringfietspad Zurenborgbrug,2023-09-24,06:00:00,19,9,10,FMN 06 B Zurenborgbrug Ringfietspad
655,Ringfietspad Zurenborgbrug,2023-09-24,07:00:00,20,8,12,FMN 06 B Zurenborgbrug Ringfietspad
655,Ringfietspad Zurenborgbrug,2023-09-24,08:00:00,76,28,48,FMN 06 B Zurenborgbrug Ringfietspad
655,Ringfietspad Zurenborgbrug,2023-09-24,09:00:00,116,51,65,FMN 06 B Zurenborgbrug Ringfietspad
655,Ringfietspad Zurenborgbrug,2023-09-24,10:00:00,164,70,94,FMN 06 B Zurenborgbrug Ringfietspad
655,Ringfietspad Zurenborgbrug,2023-09-24,11:00:00,207,90,117,FMN 06 B Zurenborgbrug Ringfietspad
655,Ringfietspad Zurenborgbrug,2023-09-24,12:00:00,266,142,124,FMN 06 B Zurenborgbrug Ringfietspad
655,Ringfietspad Zurenborgbrug,2023-09-24,13:00:00,287,126,161,FMN 06 B Zurenborgbrug Ringfietspad
655,Ringfietspad Zurenborgbrug,2023-09-24,14:00:00,324,137,187,FMN 06 B Zurenborgbrug Ringfietspad
655,Ringfietspad Zurenborgbrug,2023-09-24,15:00:00,242,111,131,FMN 06 B Zurenborgbrug Ringfietspad
655,Ringfietspad Zurenborgbrug,2023-09-24,16:00:00,231,121,110,FMN 06 B Zurenborgbrug Ringfietspad
655,Ringfietspad Zurenborgbrug,2023-09-24,17:00:00,247,133,114,FMN 06 B Zurenborgbrug Ringfietspad
655,Ringfietspad Zurenborgbrug,2023-09-24,18:00:00,184,99,85,FMN 06 B Zurenborgbrug Ringfietspad
655,Ringfietspad Zurenborgbrug,2023-09-24,19:00:00,128,53,75,FMN 06 B Zurenborgbrug Ringfietspad
655,Ringfietspad Zurenborgbrug,2023-09-24,20:00:00,77,38,39,FMN 06 B Zurenborgbrug Ringfietspad
655,Ringfietspad Zurenborgbrug,2023-09-24,21:00:00,57,27,30,FMN 06 B Zurenborgbrug Ringfietspad
655,Ringfietspad Zurenborgbrug,2023-09-24,22:00:00,49,23,26,FMN 06 B Zurenborgbrug Ringfietspad
655,Ringfietspad Zurenborgbrug,2023-09-24,23:00:00,29,11,18,FMN 06 B Zurenborgbrug Ringfietspad
655,Ringfietspad Zurenborgbrug,2023-09-25,00:00:00,11,6,5,FMN 06 B Zurenborgbrug Ringfietspad
655,Ringfietspad Zurenborgbrug,2023-09-25,01:00:00,1,0,1,FMN 06 B Zurenborgbrug Ringfietspad
655,Ringfietspad Zurenborgbrug,2023-09-25,02:00:00,1,1,0,FMN 06 B Zurenborgbrug Ringfietspad
655,Ringfietspad Zurenborgbrug,2023-09-25,03:00:00,4,1,3,FMN 06 B Zurenborgbrug Ringfietspad
655,Ringfietspad Zurenborgbrug,2023-09-25,04:00:00,16,10,6,FMN 06 B Zurenborgbrug Ringfietspad
655,Ringfietspad Zurenborgbrug,2023-09-25,05:00:00,57,37,20,FMN 06 B Zurenborgbrug Ringfietspad
655,Ringfietspad Zurenborgbrug,2023-09-25,06:00:00,178,97,81,FMN 06 B Zurenborgbrug Ringfietspad
655,Ringfietspad Zurenborgbrug,2023-09-25,07:00:00,566,340,226,FMN 06 B Zurenborgbrug Ringfietspad
655,Ringfietspad Zurenborgbrug,2023-09-25,08:00:00,776,444,332,FMN 06 B Zurenborgbrug Ringfietspad
655,Ringfietspad Zurenborgbrug,2023-09-25,09:00:00,244,141,103,FMN 06 B Zurenborgbrug Ringfietspad
655,Ringfietspad Zurenborgbrug,2023-09-25,10:00:00,140,82,58,FMN 06 B Zurenborgbrug Ringfietspad
655,Ringfietspad Zurenborgbrug,2023-09-25,11:00:00,145,66,79,FMN 06 B Zurenborgbrug Ringfietspad
655,Ringfietspad Zurenborgbrug,2023-09-25,12:00:00,267,119,148,FMN 06 B Zurenborgbrug Ringfietspad
655,Ringfietspad Zurenborgbrug,2023-09-25,13:00:00,213,104,109,FMN 06 B Zurenborgbrug Ringfietspad
655,Ringfietspad Zurenborgbrug,2023-09-25,14:00:00,256,110,146,FMN 06 B Zurenborgbrug Ringfietspad
655,Ringfietspad Zurenborgbrug,2023-09-25,15:00:00,387,150,237,FMN 06 B Zurenborgbrug Ringfietspad
655,Ringfietspad Zurenborgbrug,2023-09-25,16:00:00,740,314,426,FMN 06 B Zurenborgbrug Ringfietspad
655,Ringfietspad Zurenborgbrug,2023-09-25,17:00:00,685,277,408,FMN 06 B Zurenborgbrug Ringfietspad
655,Ringfietspad Zurenborgbrug,2023-09-25,18:00:00,385,162,223,FMN 06 B Zurenborgbrug Ringfietspad
655,Ringfietspad Zurenborgbrug,2023-09-25,19:00:00,205,94,111,FMN 06 B Zurenborgbrug Ringfietspad
655,Ringfietspad Zurenborgbrug,2023-09-25,20:00:00,145,58,87,FMN 06 B Zurenborgbrug Ringfietspad
655,Ringfietspad Zurenborgbrug,2023-09-25,21:00:00,105,41,64,FMN 06 B Zurenborgbrug Ringfietspad
655,Ringfietspad Zurenborgbrug,2023-09-25,22:00:00,105,30,75,FMN 06 B Zurenborgbrug Ringfietspad
655,Ringfietspad Zurenborgbrug,2023-09-25,23:00:00,32,7,25,FMN 06 B Zurenborgbrug Ringfietspad
655,Ringfietspad Zurenborgbrug,2023-09-26,00:00:00,17,7,10,FMN 06 B Zurenborgbrug Ringfietspad
655,Ringfietspad Zurenborgbrug,2023-09-26,01:00:00,7,0,7,FMN 06 B Zurenborgbrug Ringfietspad
655,Ringfietspad Zurenborgbrug,2023-09-26,02:00:00,5,3,2,FMN 06 B Zurenborgbrug Ringfietspad
655,Ringfietspad Zurenborgbrug,2023-09-26,03:00:00,6,1,5,FMN 06 B Zurenborgbrug Ringfietspad
655,Ringfietspad Zurenborgbrug,2023-09-26,04:00:00,11,7,4,FMN 06 B Zurenborgbrug Ringfietspad
655,Ringfietspad Zurenborgbrug,2023-09-26,05:00:00,68,37,31,FMN 06 B Zurenborgbrug Ringfietspad
655,Ringfietspad Zurenborgbrug,2023-09-26,06:00:00,200,113,87,FMN 06 B Zurenborgbrug Ringfietspad
655,Ringfietspad Zurenborgbrug,2023-09-26,07:00:00,646,394,252,FMN 06 B Zurenborgbrug Ringfietspad
655,Ringfietspad Zurenborgbrug,2023-09-26,08:00:00,889,524,365,FMN 06 B Zurenborgbrug Ringfietspad
655,Ringfietspad Zurenborgbrug,2023-09-26,09:00:00,249,153,96,FMN 06 B Zurenborgbrug Ringfietspad
655,Ringfietspad Zurenborgbrug,2023-09-26,10:00:00,158,92,66,FMN 06 B Zurenborgbrug Ringfietspad
655,Ringfietspad Zurenborgbrug,2023-09-26,11:00:00,154,74,80,FMN 06 B Zurenborgbrug Ringfietspad
655,Ringfietspad Zurenborgbrug,2023-09-26,12:00:00,270,117,153,FMN 06 B Zurenborgbrug Ringfietspad
655,Ringfietspad Zurenborgbrug,2023-09-26,13:00:00,252,132,120,FMN 06 B Zurenborgbrug Ringfietspad
655,Ringfietspad Zurenborgbrug,2023-09-26,14:00:00,247,112,135,FMN 06 B Zurenborgbrug Ringfietspad
655,Ringfietspad Zurenborgbrug,2023-09-26,15:00:00,426,166,260,FMN 06 B Zurenborgbrug Ringfietspad
655,Ringfietspad Zurenborgbrug,2023-09-26,16:00:00,789,316,473,FMN 06 B Zurenborgbrug Ringfietspad
655,Ringfietspad Zurenborgbrug,2023-09-26,17:00:00,706,267,439,FMN 06 B Zurenborgbrug Ringfietspad
655,Ringfietspad Zurenborgbrug,2023-09-26,18:00:00,449,173,276,FMN 06 B Zurenborgbrug Ringfietspad
655,Ringfietspad Zurenborgbrug,2023-09-26,19:00:00,263,94,169,FMN 06 B Zurenborgbrug Ringfietspad
655,Ringfietspad Zurenborgbrug,2023-09-26,20:00:00,128,53,75,FMN 06 B Zurenborgbrug Ringfietspad
655,Ringfietspad Zurenborgbrug,2023-09-26,21:00:00,100,33,67,FMN 06 B Zurenborgbrug Ringfietspad
655,Ringfietspad Zurenborgbrug,2023-09-26,22:00:00,124,45,79,FMN 06 B Zurenborgbrug Ringfietspad
655,Ringfietspad Zurenborgbrug,2023-09-26,23:00:00,33,15,18,FMN 06 B Zurenborgbrug Ringfietspad
655,Ringfietspad Zurenborgbrug,2023-09-27,00:00:00,11,6,5,FMN 06 B Zurenborgbrug Ringfietspad
655,Ringfietspad Zurenborgbrug,2023-09-27,01:00:00,5,2,3,FMN 06 B Zurenborgbrug Ringfietspad
655,Ringfietspad Zurenborgbrug,2023-09-27,02:00:00,1,1,0,FMN 06 B Zurenborgbrug Ringfietspad
655,Ringfietspad Zurenborgbrug,2023-09-27,03:00:00,3,2,1,FMN 06 B Zurenborgbrug Ringfietspad
655,Ringfietspad Zurenborgbrug,2023-09-27,04:00:00,14,6,8,FMN 06 B Zurenborgbrug Ringfietspad
655,Ringfietspad Zurenborgbrug,2023-09-27,05:00:00,51,33,18,FMN 06 B Zurenborgbrug Ringfietspad
655,Ringfietspad Zurenborgbrug,2023-09-27,06:00:00,183,98,85,FMN 06 B Zurenborgbrug Ringfietspad
655,Ringfietspad Zurenborgbrug,2023-09-27,07:00:00,575,346,229,FMN 06 B Zurenborgbrug Ringfietspad
655,Ringfietspad Zurenborgbrug,2023-09-27,08:00:00,714,417,297,FMN 06 B Zurenborgbrug Ringfietspad
655,Ringfietspad Zurenborgbrug,2023-09-27,09:00:00,201,108,93,FMN 06 B Zurenborgbrug Ringfietspad
655,Ringfietspad Zurenborgbrug,2023-09-27,10:00:00,174,101,73,FMN 06 B Zurenborgbrug Ringfietspad
655,Ringfietspad Zurenborgbrug,2023-09-27,11:00:00,174,79,95,FMN 06 B Zurenborgbrug Ringfietspad
655,Ringfietspad Zurenborgbrug,2023-09-27,12:00:00,417,202,215,FMN 06 B Zurenborgbrug Ringfietspad
655,Ringfietspad Zurenborgbrug,2023-09-27,13:00:00,319,159,160,FMN 06 B Zurenborgbrug Ringfietspad
655,Ringfietspad Zurenborgbrug,2023-09-27,14:00:00,268,116,152,FMN 06 B Zurenborgbrug Ringfietspad
655,Ringfietspad Zurenborgbrug,2023-09-27,15:00:00,329,128,201,FMN 06 B Zurenborgbrug Ringfietspad
655,Ringfietspad Zurenborgbrug,2023-09-27,16:00:00,559,223,336,FMN 06 B Zurenborgbrug Ringfietspad
655,Ringfietspad Zurenborgbrug,2023-09-27,17:00:00,597,238,359,FMN 06 B Zurenborgbrug Ringfietspad
655,Ringfietspad Zurenborgbrug,2023-09-27,18:00:00,434,189,245,FMN 06 B Zurenborgbrug Ringfietspad
655,Ringfietspad Zurenborgbrug,2023-09-27,19:00:00,295,98,197,FMN 06 B Zurenborgbrug Ringfietspad
655,Ringfietspad Zurenborgbrug,2023-09-27,20:00:00,178,56,122,FMN 06 B Zurenborgbrug Ringfietspad
655,Ringfietspad Zurenborgbrug,2023-09-27,21:00:00,124,58,66,FMN 06 B Zurenborgbrug Ringfietspad
655,Ringfietspad Zurenborgbrug,2023-09-27,22:00:00,118,35,83,FMN 06 B Zurenborgbrug Ringfietspad
655,Ringfietspad Zurenborgbrug,2023-09-27,23:00:00,157,122,35,FMN 06 B Zurenborgbrug Ringfietspad
