Meetpunt surrogate key,Meetpunt locatie,Datum,Tijd,Aantal fietsers,Aantal fietsers van,Aantal fietsers naar,Meetpunt code
662,Luitenant Lippenslaan 200,2022-11-10,00:00:00,14,8,6,FMN 15 Luitenant Lippenslaan
662,Luitenant Lippenslaan 200,2022-11-10,01:00:00,5,1,4,FMN 15 Luitenant Lippenslaan
662,Luitenant Lippenslaan 200,2022-11-10,02:00:00,5,1,4,FMN 15 Luitenant Lippenslaan
662,Luitenant Lippenslaan 200,2022-11-10,03:00:00,4,4,0,FMN 15 Luitenant Lippenslaan
662,Luitenant Lippenslaan 200,2022-11-10,04:00:00,6,6,0,FMN 15 Luitenant Lippenslaan
662,Luitenant Lippenslaan 200,2022-11-10,05:00:00,18,12,6,FMN 15 Luitenant Lippenslaan
662,Luitenant Lippenslaan 200,2022-11-10,06:00:00,62,50,12,FMN 15 Luitenant Lippenslaan
662,Luitenant Lippenslaan 200,2022-11-10,07:00:00,175,163,12,FMN 15 Luitenant Lippenslaan
662,Luitenant Lippenslaan 200,2022-11-10,08:00:00,341,321,20,FMN 15 Luitenant Lippenslaan
662,Luitenant Lippenslaan 200,2022-11-10,09:00:00,183,159,24,FMN 15 Luitenant Lippenslaan
662,Luitenant Lippenslaan 200,2022-11-10,10:00:00,107,99,8,FMN 15 Luitenant Lippenslaan
662,Luitenant Lippenslaan 200,2022-11-10,11:00:00,105,85,20,FMN 15 Luitenant Lippenslaan
662,Luitenant Lippenslaan 200,2022-11-10,12:00:00,132,114,18,FMN 15 Luitenant Lippenslaan
662,Luitenant Lippenslaan 200,2022-11-10,13:00:00,107,87,20,FMN 15 Luitenant Lippenslaan
662,Luitenant Lippenslaan 200,2022-11-10,14:00:00,98,76,22,FMN 15 Luitenant Lippenslaan
662,Luitenant Lippenslaan 200,2022-11-10,15:00:00,139,97,42,FMN 15 Luitenant Lippenslaan
662,Luitenant Lippenslaan 200,2022-11-10,16:00:00,184,126,58,FMN 15 Luitenant Lippenslaan
662,Luitenant Lippenslaan 200,2022-11-10,17:00:00,179,145,34,FMN 15 Luitenant Lippenslaan
662,Luitenant Lippenslaan 200,2022-11-10,18:00:00,157,121,36,FMN 15 Luitenant Lippenslaan
662,Luitenant Lippenslaan 200,2022-11-10,19:00:00,135,111,24,FMN 15 Luitenant Lippenslaan
662,Luitenant Lippenslaan 200,2022-11-10,20:00:00,92,76,16,FMN 15 Luitenant Lippenslaan
662,Luitenant Lippenslaan 200,2022-11-10,21:00:00,50,38,12,FMN 15 Luitenant Lippenslaan
662,Luitenant Lippenslaan 200,2022-11-10,22:00:00,29,23,6,FMN 15 Luitenant Lippenslaan
662,Luitenant Lippenslaan 200,2022-11-10,23:00:00,34,26,8,FMN 15 Luitenant Lippenslaan
662,Luitenant Lippenslaan 200,2022-11-11,00:00:00,23,13,10,FMN 15 Luitenant Lippenslaan
662,Luitenant Lippenslaan 200,2022-11-11,01:00:00,27,13,14,FMN 15 Luitenant Lippenslaan
662,Luitenant Lippenslaan 200,2022-11-11,02:00:00,15,5,10,FMN 15 Luitenant Lippenslaan
662,Luitenant Lippenslaan 200,2022-11-11,03:00:00,10,8,2,FMN 15 Luitenant Lippenslaan
662,Luitenant Lippenslaan 200,2022-11-11,04:00:00,6,2,4,FMN 15 Luitenant Lippenslaan
662,Luitenant Lippenslaan 200,2022-11-11,05:00:00,16,14,2,FMN 15 Luitenant Lippenslaan
662,Luitenant Lippenslaan 200,2022-11-11,06:00:00,18,10,8,FMN 15 Luitenant Lippenslaan
662,Luitenant Lippenslaan 200,2022-11-11,07:00:00,18,16,2,FMN 15 Luitenant Lippenslaan
662,Luitenant Lippenslaan 200,2022-11-11,08:00:00,31,25,6,FMN 15 Luitenant Lippenslaan
662,Luitenant Lippenslaan 200,2022-11-11,09:00:00,48,48,0,FMN 15 Luitenant Lippenslaan
662,Luitenant Lippenslaan 200,2022-11-11,10:00:00,55,47,8,FMN 15 Luitenant Lippenslaan
662,Luitenant Lippenslaan 200,2022-11-11,11:00:00,100,84,16,FMN 15 Luitenant Lippenslaan
662,Luitenant Lippenslaan 200,2022-11-11,12:00:00,107,93,14,FMN 15 Luitenant Lippenslaan
662,Luitenant Lippenslaan 200,2022-11-11,13:00:00,91,71,20,FMN 15 Luitenant Lippenslaan
662,Luitenant Lippenslaan 200,2022-11-11,14:00:00,105,71,34,FMN 15 Luitenant Lippenslaan
662,Luitenant Lippenslaan 200,2022-11-11,15:00:00,101,77,24,FMN 15 Luitenant Lippenslaan
662,Luitenant Lippenslaan 200,2022-11-11,16:00:00,125,82,43,FMN 15 Luitenant Lippenslaan
662,Luitenant Lippenslaan 200,2022-11-11,17:00:00,101,73,28,FMN 15 Luitenant Lippenslaan
662,Luitenant Lippenslaan 200,2022-11-11,18:00:00,98,90,8,FMN 15 Luitenant Lippenslaan
662,Luitenant Lippenslaan 200,2022-11-11,19:00:00,85,65,20,FMN 15 Luitenant Lippenslaan
662,Luitenant Lippenslaan 200,2022-11-11,20:00:00,65,57,8,FMN 15 Luitenant Lippenslaan
662,Luitenant Lippenslaan 200,2022-11-11,21:00:00,44,26,18,FMN 15 Luitenant Lippenslaan
662,Luitenant Lippenslaan 200,2022-11-11,22:00:00,23,15,8,FMN 15 Luitenant Lippenslaan
662,Luitenant Lippenslaan 200,2022-11-11,23:00:00,28,16,12,FMN 15 Luitenant Lippenslaan
662,Luitenant Lippenslaan 200,2022-11-12,00:00:00,24,16,8,FMN 15 Luitenant Lippenslaan
662,Luitenant Lippenslaan 200,2022-11-12,01:00:00,7,5,2,FMN 15 Luitenant Lippenslaan
662,Luitenant Lippenslaan 200,2022-11-12,02:00:00,17,9,8,FMN 15 Luitenant Lippenslaan
662,Luitenant Lippenslaan 200,2022-11-12,03:00:00,6,4,2,FMN 15 Luitenant Lippenslaan
662,Luitenant Lippenslaan 200,2022-11-12,04:00:00,8,6,2,FMN 15 Luitenant Lippenslaan
662,Luitenant Lippenslaan 200,2022-11-12,05:00:00,14,12,2,FMN 15 Luitenant Lippenslaan
662,Luitenant Lippenslaan 200,2022-11-12,06:00:00,31,17,14,FMN 15 Luitenant Lippenslaan
662,Luitenant Lippenslaan 200,2022-11-12,07:00:00,24,22,2,FMN 15 Luitenant Lippenslaan
662,Luitenant Lippenslaan 200,2022-11-12,08:00:00,51,39,12,FMN 15 Luitenant Lippenslaan
662,Luitenant Lippenslaan 200,2022-11-12,09:00:00,126,112,14,FMN 15 Luitenant Lippenslaan
662,Luitenant Lippenslaan 200,2022-11-12,10:00:00,99,87,12,FMN 15 Luitenant Lippenslaan
662,Luitenant Lippenslaan 200,2022-11-12,11:00:00,131,109,22,FMN 15 Luitenant Lippenslaan
662,Luitenant Lippenslaan 200,2022-11-12,12:00:00,150,124,26,FMN 15 Luitenant Lippenslaan
662,Luitenant Lippenslaan 200,2022-11-12,13:00:00,180,156,24,FMN 15 Luitenant Lippenslaan
662,Luitenant Lippenslaan 200,2022-11-12,14:00:00,156,126,30,FMN 15 Luitenant Lippenslaan
662,Luitenant Lippenslaan 200,2022-11-12,15:00:00,129,103,26,FMN 15 Luitenant Lippenslaan
662,Luitenant Lippenslaan 200,2022-11-12,16:00:00,147,115,32,FMN 15 Luitenant Lippenslaan
662,Luitenant Lippenslaan 200,2022-11-12,17:00:00,144,124,20,FMN 15 Luitenant Lippenslaan
662,Luitenant Lippenslaan 200,2022-11-12,18:00:00,133,106,27,FMN 15 Luitenant Lippenslaan
662,Luitenant Lippenslaan 200,2022-11-12,19:00:00,99,79,20,FMN 15 Luitenant Lippenslaan
662,Luitenant Lippenslaan 200,2022-11-12,20:00:00,71,61,10,FMN 15 Luitenant Lippenslaan
662,Luitenant Lippenslaan 200,2022-11-12,21:00:00,39,25,14,FMN 15 Luitenant Lippenslaan
662,Luitenant Lippenslaan 200,2022-11-12,22:00:00,50,38,12,FMN 15 Luitenant Lippenslaan
662,Luitenant Lippenslaan 200,2022-11-12,23:00:00,31,25,6,FMN 15 Luitenant Lippenslaan
662,Luitenant Lippenslaan 200,2022-11-13,00:00:00,28,22,6,FMN 15 Luitenant Lippenslaan
662,Luitenant Lippenslaan 200,2022-11-13,01:00:00,22,10,12,FMN 15 Luitenant Lippenslaan
662,Luitenant Lippenslaan 200,2022-11-13,02:00:00,2,2,0,FMN 15 Luitenant Lippenslaan
662,Luitenant Lippenslaan 200,2022-11-13,03:00:00,8,6,2,FMN 15 Luitenant Lippenslaan
662,Luitenant Lippenslaan 200,2022-11-13,04:00:00,5,1,4,FMN 15 Luitenant Lippenslaan
662,Luitenant Lippenslaan 200,2022-11-13,05:00:00,9,5,4,FMN 15 Luitenant Lippenslaan
662,Luitenant Lippenslaan 200,2022-11-13,06:00:00,11,9,2,FMN 15 Luitenant Lippenslaan
662,Luitenant Lippenslaan 200,2022-11-13,07:00:00,11,7,4,FMN 15 Luitenant Lippenslaan
662,Luitenant Lippenslaan 200,2022-11-13,08:00:00,26,16,10,FMN 15 Luitenant Lippenslaan
662,Luitenant Lippenslaan 200,2022-11-13,09:00:00,57,49,8,FMN 15 Luitenant Lippenslaan
662,Luitenant Lippenslaan 200,2022-11-13,10:00:00,74,70,4,FMN 15 Luitenant Lippenslaan
662,Luitenant Lippenslaan 200,2022-11-13,11:00:00,91,81,10,FMN 15 Luitenant Lippenslaan
662,Luitenant Lippenslaan 200,2022-11-13,12:00:00,99,81,18,FMN 15 Luitenant Lippenslaan
662,Luitenant Lippenslaan 200,2022-11-13,13:00:00,148,120,28,FMN 15 Luitenant Lippenslaan
662,Luitenant Lippenslaan 200,2022-11-13,14:00:00,139,124,15,FMN 15 Luitenant Lippenslaan
662,Luitenant Lippenslaan 200,2022-11-13,15:00:00,107,83,24,FMN 15 Luitenant Lippenslaan
662,Luitenant Lippenslaan 200,2022-11-13,16:00:00,92,72,20,FMN 15 Luitenant Lippenslaan
662,Luitenant Lippenslaan 200,2022-11-13,17:00:00,81,69,12,FMN 15 Luitenant Lippenslaan
662,Luitenant Lippenslaan 200,2022-11-13,18:00:00,72,58,14,FMN 15 Luitenant Lippenslaan
662,Luitenant Lippenslaan 200,2022-11-13,19:00:00,51,41,10,FMN 15 Luitenant Lippenslaan
662,Luitenant Lippenslaan 200,2022-11-13,20:00:00,48,34,14,FMN 15 Luitenant Lippenslaan
662,Luitenant Lippenslaan 200,2022-11-13,21:00:00,18,16,2,FMN 15 Luitenant Lippenslaan
662,Luitenant Lippenslaan 200,2022-11-13,22:00:00,23,13,10,FMN 15 Luitenant Lippenslaan
662,Luitenant Lippenslaan 200,2022-11-13,23:00:00,7,7,0,FMN 15 Luitenant Lippenslaan
662,Luitenant Lippenslaan 200,2022-11-14,00:00:00,10,2,8,FMN 15 Luitenant Lippenslaan
662,Luitenant Lippenslaan 200,2022-11-14,01:00:00,3,3,0,FMN 15 Luitenant Lippenslaan
662,Luitenant Lippenslaan 200,2022-11-14,02:00:00,6,2,4,FMN 15 Luitenant Lippenslaan
662,Luitenant Lippenslaan 200,2022-11-14,03:00:00,3,1,2,FMN 15 Luitenant Lippenslaan
662,Luitenant Lippenslaan 200,2022-11-14,04:00:00,8,8,0,FMN 15 Luitenant Lippenslaan
662,Luitenant Lippenslaan 200,2022-11-14,05:00:00,23,19,4,FMN 15 Luitenant Lippenslaan
662,Luitenant Lippenslaan 200,2022-11-14,06:00:00,69,57,12,FMN 15 Luitenant Lippenslaan
662,Luitenant Lippenslaan 200,2022-11-14,07:00:00,190,176,14,FMN 15 Luitenant Lippenslaan
662,Luitenant Lippenslaan 200,2022-11-14,08:00:00,366,346,20,FMN 15 Luitenant Lippenslaan
662,Luitenant Lippenslaan 200,2022-11-14,09:00:00,147,131,16,FMN 15 Luitenant Lippenslaan
662,Luitenant Lippenslaan 200,2022-11-14,10:00:00,99,91,8,FMN 15 Luitenant Lippenslaan
662,Luitenant Lippenslaan 200,2022-11-14,11:00:00,84,70,14,FMN 15 Luitenant Lippenslaan
662,Luitenant Lippenslaan 200,2022-11-14,12:00:00,119,103,16,FMN 15 Luitenant Lippenslaan
662,Luitenant Lippenslaan 200,2022-11-14,13:00:00,116,86,30,FMN 15 Luitenant Lippenslaan
662,Luitenant Lippenslaan 200,2022-11-14,14:00:00,100,74,26,FMN 15 Luitenant Lippenslaan
662,Luitenant Lippenslaan 200,2022-11-14,15:00:00,139,107,32,FMN 15 Luitenant Lippenslaan
662,Luitenant Lippenslaan 200,2022-11-14,16:00:00,172,128,44,FMN 15 Luitenant Lippenslaan
662,Luitenant Lippenslaan 200,2022-11-14,17:00:00,174,144,30,FMN 15 Luitenant Lippenslaan
662,Luitenant Lippenslaan 200,2022-11-14,18:00:00,141,107,34,FMN 15 Luitenant Lippenslaan
662,Luitenant Lippenslaan 200,2022-11-14,19:00:00,108,76,32,FMN 15 Luitenant Lippenslaan
662,Luitenant Lippenslaan 200,2022-11-14,20:00:00,70,50,20,FMN 15 Luitenant Lippenslaan
662,Luitenant Lippenslaan 200,2022-11-14,21:00:00,46,26,20,FMN 15 Luitenant Lippenslaan
662,Luitenant Lippenslaan 200,2022-11-14,22:00:00,23,15,8,FMN 15 Luitenant Lippenslaan
662,Luitenant Lippenslaan 200,2022-11-14,23:00:00,21,17,4,FMN 15 Luitenant Lippenslaan
662,Luitenant Lippenslaan 200,2022-11-15,00:00:00,10,4,6,FMN 15 Luitenant Lippenslaan
662,Luitenant Lippenslaan 200,2022-11-15,01:00:00,5,3,2,FMN 15 Luitenant Lippenslaan
662,Luitenant Lippenslaan 200,2022-11-15,02:00:00,2,0,2,FMN 15 Luitenant Lippenslaan
662,Luitenant Lippenslaan 200,2022-11-15,03:00:00,6,2,4,FMN 15 Luitenant Lippenslaan
662,Luitenant Lippenslaan 200,2022-11-15,04:00:00,7,5,2,FMN 15 Luitenant Lippenslaan
662,Luitenant Lippenslaan 200,2022-11-15,05:00:00,13,13,0,FMN 15 Luitenant Lippenslaan
662,Luitenant Lippenslaan 200,2022-11-15,06:00:00,67,53,14,FMN 15 Luitenant Lippenslaan
662,Luitenant Lippenslaan 200,2022-11-15,07:00:00,177,159,18,FMN 15 Luitenant Lippenslaan
662,Luitenant Lippenslaan 200,2022-11-15,08:00:00,326,306,20,FMN 15 Luitenant Lippenslaan
662,Luitenant Lippenslaan 200,2022-11-15,09:00:00,146,140,6,FMN 15 Luitenant Lippenslaan
662,Luitenant Lippenslaan 200,2022-11-15,10:00:00,101,95,6,FMN 15 Luitenant Lippenslaan
662,Luitenant Lippenslaan 200,2022-11-15,11:00:00,90,78,12,FMN 15 Luitenant Lippenslaan
662,Luitenant Lippenslaan 200,2022-11-15,12:00:00,121,101,20,FMN 15 Luitenant Lippenslaan
662,Luitenant Lippenslaan 200,2022-11-15,13:00:00,93,85,8,FMN 15 Luitenant Lippenslaan
662,Luitenant Lippenslaan 200,2022-11-15,14:00:00,89,77,12,FMN 15 Luitenant Lippenslaan
662,Luitenant Lippenslaan 200,2022-11-15,15:00:00,106,68,38,FMN 15 Luitenant Lippenslaan
662,Luitenant Lippenslaan 200,2022-11-15,16:00:00,113,95,18,FMN 15 Luitenant Lippenslaan
662,Luitenant Lippenslaan 200,2022-11-15,17:00:00,120,96,24,FMN 15 Luitenant Lippenslaan
662,Luitenant Lippenslaan 200,2022-11-15,18:00:00,89,71,18,FMN 15 Luitenant Lippenslaan
662,Luitenant Lippenslaan 200,2022-11-15,19:00:00,74,52,22,FMN 15 Luitenant Lippenslaan
662,Luitenant Lippenslaan 200,2022-11-15,20:00:00,51,47,4,FMN 15 Luitenant Lippenslaan
662,Luitenant Lippenslaan 200,2022-11-15,21:00:00,38,32,6,FMN 15 Luitenant Lippenslaan
662,Luitenant Lippenslaan 200,2022-11-15,22:00:00,27,19,8,FMN 15 Luitenant Lippenslaan
662,Luitenant Lippenslaan 200,2022-11-15,23:00:00,13,11,2,FMN 15 Luitenant Lippenslaan
662,Luitenant Lippenslaan 200,2022-11-16,00:00:00,15,5,10,FMN 15 Luitenant Lippenslaan
662,Luitenant Lippenslaan 200,2022-11-16,01:00:00,6,4,2,FMN 15 Luitenant Lippenslaan
662,Luitenant Lippenslaan 200,2022-11-16,02:00:00,2,0,2,FMN 15 Luitenant Lippenslaan
662,Luitenant Lippenslaan 200,2022-11-16,03:00:00,3,1,2,FMN 15 Luitenant Lippenslaan
662,Luitenant Lippenslaan 200,2022-11-16,04:00:00,10,10,0,FMN 15 Luitenant Lippenslaan
662,Luitenant Lippenslaan 200,2022-11-16,05:00:00,17,15,2,FMN 15 Luitenant Lippenslaan
662,Luitenant Lippenslaan 200,2022-11-16,06:00:00,61,43,18,FMN 15 Luitenant Lippenslaan
662,Luitenant Lippenslaan 200,2022-11-16,07:00:00,124,120,4,FMN 15 Luitenant Lippenslaan
662,Luitenant Lippenslaan 200,2022-11-16,08:00:00,196,182,14,FMN 15 Luitenant Lippenslaan
662,Luitenant Lippenslaan 200,2022-11-16,09:00:00,106,100,6,FMN 15 Luitenant Lippenslaan
662,Luitenant Lippenslaan 200,2022-11-16,10:00:00,90,82,8,FMN 15 Luitenant Lippenslaan
662,Luitenant Lippenslaan 200,2022-11-16,11:00:00,88,76,12,FMN 15 Luitenant Lippenslaan
662,Luitenant Lippenslaan 200,2022-11-16,12:00:00,146,98,48,FMN 15 Luitenant Lippenslaan
662,Luitenant Lippenslaan 200,2022-11-16,13:00:00,109,83,26,FMN 15 Luitenant Lippenslaan
662,Luitenant Lippenslaan 200,2022-11-16,14:00:00,73,59,14,FMN 15 Luitenant Lippenslaan
662,Luitenant Lippenslaan 200,2022-11-16,15:00:00,80,68,12,FMN 15 Luitenant Lippenslaan
662,Luitenant Lippenslaan 200,2022-11-16,16:00:00,94,78,16,FMN 15 Luitenant Lippenslaan
662,Luitenant Lippenslaan 200,2022-11-16,17:00:00,116,90,26,FMN 15 Luitenant Lippenslaan
662,Luitenant Lippenslaan 200,2022-11-16,18:00:00,103,69,34,FMN 15 Luitenant Lippenslaan
662,Luitenant Lippenslaan 200,2022-11-16,19:00:00,71,57,14,FMN 15 Luitenant Lippenslaan
662,Luitenant Lippenslaan 200,2022-11-16,20:00:00,51,35,16,FMN 15 Luitenant Lippenslaan
662,Luitenant Lippenslaan 200,2022-11-16,21:00:00,29,19,10,FMN 15 Luitenant Lippenslaan
662,Luitenant Lippenslaan 200,2022-11-16,22:00:00,25,19,6,FMN 15 Luitenant Lippenslaan
662,Luitenant Lippenslaan 200,2022-11-16,23:00:00,14,10,4,FMN 15 Luitenant Lippenslaan
662,Luitenant Lippenslaan 200,2022-11-17,00:00:00,15,7,8,FMN 15 Luitenant Lippenslaan
662,Luitenant Lippenslaan 200,2022-11-17,01:00:00,5,1,4,FMN 15 Luitenant Lippenslaan
662,Luitenant Lippenslaan 200,2022-11-17,02:00:00,5,3,2,FMN 15 Luitenant Lippenslaan
662,Luitenant Lippenslaan 200,2022-11-17,03:00:00,2,0,2,FMN 15 Luitenant Lippenslaan
662,Luitenant Lippenslaan 200,2022-11-17,04:00:00,6,6,0,FMN 15 Luitenant Lippenslaan
662,Luitenant Lippenslaan 200,2022-11-17,05:00:00,11,9,2,FMN 15 Luitenant Lippenslaan
662,Luitenant Lippenslaan 200,2022-11-17,06:00:00,57,41,16,FMN 15 Luitenant Lippenslaan
662,Luitenant Lippenslaan 200,2022-11-17,07:00:00,127,117,10,FMN 15 Luitenant Lippenslaan
662,Luitenant Lippenslaan 200,2022-11-17,08:00:00,280,244,36,FMN 15 Luitenant Lippenslaan
662,Luitenant Lippenslaan 200,2022-11-17,09:00:00,110,102,8,FMN 15 Luitenant Lippenslaan
662,Luitenant Lippenslaan 200,2022-11-17,10:00:00,46,40,6,FMN 15 Luitenant Lippenslaan
662,Luitenant Lippenslaan 200,2022-11-17,11:00:00,36,32,4,FMN 15 Luitenant Lippenslaan
662,Luitenant Lippenslaan 200,2022-11-17,12:00:00,53,47,6,FMN 15 Luitenant Lippenslaan
662,Luitenant Lippenslaan 200,2022-11-17,13:00:00,67,53,14,FMN 15 Luitenant Lippenslaan
662,Luitenant Lippenslaan 200,2022-11-17,14:00:00,69,49,20,FMN 15 Luitenant Lippenslaan
662,Luitenant Lippenslaan 200,2022-11-17,15:00:00,86,68,18,FMN 15 Luitenant Lippenslaan
662,Luitenant Lippenslaan 200,2022-11-17,16:00:00,100,70,30,FMN 15 Luitenant Lippenslaan
662,Luitenant Lippenslaan 200,2022-11-17,17:00:00,165,109,56,FMN 15 Luitenant Lippenslaan
662,Luitenant Lippenslaan 200,2022-11-17,18:00:00,103,85,18,FMN 15 Luitenant Lippenslaan
662,Luitenant Lippenslaan 200,2022-11-17,19:00:00,81,53,28,FMN 15 Luitenant Lippenslaan
662,Luitenant Lippenslaan 200,2022-11-17,20:00:00,63,45,18,FMN 15 Luitenant Lippenslaan
662,Luitenant Lippenslaan 200,2022-11-17,21:00:00,22,18,4,FMN 15 Luitenant Lippenslaan
662,Luitenant Lippenslaan 200,2022-11-17,22:00:00,22,12,10,FMN 15 Luitenant Lippenslaan
662,Luitenant Lippenslaan 200,2022-11-17,23:00:00,29,11,18,FMN 15 Luitenant Lippenslaan
662,Luitenant Lippenslaan 200,2022-11-18,00:00:00,11,3,8,FMN 15 Luitenant Lippenslaan
662,Luitenant Lippenslaan 200,2022-11-18,01:00:00,3,3,0,FMN 15 Luitenant Lippenslaan
662,Luitenant Lippenslaan 200,2022-11-18,02:00:00,2,2,0,FMN 15 Luitenant Lippenslaan
662,Luitenant Lippenslaan 200,2022-11-18,03:00:00,2,0,2,FMN 15 Luitenant Lippenslaan
662,Luitenant Lippenslaan 200,2022-11-18,04:00:00,5,5,0,FMN 15 Luitenant Lippenslaan
662,Luitenant Lippenslaan 200,2022-11-18,05:00:00,10,8,2,FMN 15 Luitenant Lippenslaan
662,Luitenant Lippenslaan 200,2022-11-18,06:00:00,38,30,8,FMN 15 Luitenant Lippenslaan
662,Luitenant Lippenslaan 200,2022-11-18,07:00:00,84,80,4,FMN 15 Luitenant Lippenslaan
662,Luitenant Lippenslaan 200,2022-11-18,08:00:00,177,159,18,FMN 15 Luitenant Lippenslaan
662,Luitenant Lippenslaan 200,2022-11-18,09:00:00,78,76,2,FMN 15 Luitenant Lippenslaan
662,Luitenant Lippenslaan 200,2022-11-18,10:00:00,73,65,8,FMN 15 Luitenant Lippenslaan
662,Luitenant Lippenslaan 200,2022-11-18,11:00:00,64,50,14,FMN 15 Luitenant Lippenslaan
662,Luitenant Lippenslaan 200,2022-11-18,12:00:00,89,67,22,FMN 15 Luitenant Lippenslaan
662,Luitenant Lippenslaan 200,2022-11-18,13:00:00,59,51,8,FMN 15 Luitenant Lippenslaan
662,Luitenant Lippenslaan 200,2022-11-18,14:00:00,45,35,10,FMN 15 Luitenant Lippenslaan
662,Luitenant Lippenslaan 200,2022-11-18,15:00:00,77,55,22,FMN 15 Luitenant Lippenslaan
662,Luitenant Lippenslaan 200,2022-11-18,16:00:00,70,52,18,FMN 15 Luitenant Lippenslaan
662,Luitenant Lippenslaan 200,2022-11-18,17:00:00,82,58,24,FMN 15 Luitenant Lippenslaan
662,Luitenant Lippenslaan 200,2022-11-18,18:00:00,68,58,10,FMN 15 Luitenant Lippenslaan
662,Luitenant Lippenslaan 200,2022-11-18,19:00:00,60,54,6,FMN 15 Luitenant Lippenslaan
662,Luitenant Lippenslaan 200,2022-11-18,20:00:00,43,29,14,FMN 15 Luitenant Lippenslaan
662,Luitenant Lippenslaan 200,2022-11-18,21:00:00,40,26,14,FMN 15 Luitenant Lippenslaan
662,Luitenant Lippenslaan 200,2022-11-18,22:00:00,23,11,12,FMN 15 Luitenant Lippenslaan
662,Luitenant Lippenslaan 200,2022-11-18,23:00:00,26,16,10,FMN 15 Luitenant Lippenslaan
662,Luitenant Lippenslaan 200,2022-11-19,00:00:00,20,14,6,FMN 15 Luitenant Lippenslaan
662,Luitenant Lippenslaan 200,2022-11-19,01:00:00,17,11,6,FMN 15 Luitenant Lippenslaan
662,Luitenant Lippenslaan 200,2022-11-19,02:00:00,10,4,6,FMN 15 Luitenant Lippenslaan
662,Luitenant Lippenslaan 200,2022-11-19,03:00:00,17,11,6,FMN 15 Luitenant Lippenslaan
662,Luitenant Lippenslaan 200,2022-11-19,04:00:00,4,4,0,FMN 15 Luitenant Lippenslaan
662,Luitenant Lippenslaan 200,2022-11-19,05:00:00,7,7,0,FMN 15 Luitenant Lippenslaan
662,Luitenant Lippenslaan 200,2022-11-19,06:00:00,13,7,6,FMN 15 Luitenant Lippenslaan
662,Luitenant Lippenslaan 200,2022-11-19,07:00:00,18,16,2,FMN 15 Luitenant Lippenslaan
662,Luitenant Lippenslaan 200,2022-11-19,08:00:00,27,23,4,FMN 15 Luitenant Lippenslaan
662,Luitenant Lippenslaan 200,2022-11-19,09:00:00,33,25,8,FMN 15 Luitenant Lippenslaan
662,Luitenant Lippenslaan 200,2022-11-19,10:00:00,23,15,8,FMN 15 Luitenant Lippenslaan
662,Luitenant Lippenslaan 200,2022-11-19,11:00:00,44,24,20,FMN 15 Luitenant Lippenslaan
662,Luitenant Lippenslaan 200,2022-11-19,12:00:00,33,25,8,FMN 15 Luitenant Lippenslaan
662,Luitenant Lippenslaan 200,2022-11-19,13:00:00,23,21,2,FMN 15 Luitenant Lippenslaan
662,Luitenant Lippenslaan 200,2022-11-19,14:00:00,31,25,6,FMN 15 Luitenant Lippenslaan
662,Luitenant Lippenslaan 200,2022-11-19,15:00:00,36,18,18,FMN 15 Luitenant Lippenslaan
662,Luitenant Lippenslaan 200,2022-11-19,16:00:00,39,21,18,FMN 15 Luitenant Lippenslaan
662,Luitenant Lippenslaan 200,2022-11-19,17:00:00,32,22,10,FMN 15 Luitenant Lippenslaan
662,Luitenant Lippenslaan 200,2022-11-19,18:00:00,14,12,2,FMN 15 Luitenant Lippenslaan
662,Luitenant Lippenslaan 200,2022-11-19,19:00:00,38,24,14,FMN 15 Luitenant Lippenslaan
662,Luitenant Lippenslaan 200,2022-11-19,20:00:00,31,21,10,FMN 15 Luitenant Lippenslaan
662,Luitenant Lippenslaan 200,2022-11-19,21:00:00,23,13,10,FMN 15 Luitenant Lippenslaan
662,Luitenant Lippenslaan 200,2022-11-19,22:00:00,14,10,4,FMN 15 Luitenant Lippenslaan
662,Luitenant Lippenslaan 200,2022-11-19,23:00:00,16,6,10,FMN 15 Luitenant Lippenslaan
662,Luitenant Lippenslaan 200,2022-11-20,00:00:00,11,3,8,FMN 15 Luitenant Lippenslaan
662,Luitenant Lippenslaan 200,2022-11-20,01:00:00,5,1,4,FMN 15 Luitenant Lippenslaan
662,Luitenant Lippenslaan 200,2022-11-20,02:00:00,10,6,4,FMN 15 Luitenant Lippenslaan
662,Luitenant Lippenslaan 200,2022-11-20,03:00:00,3,1,2,FMN 15 Luitenant Lippenslaan
662,Luitenant Lippenslaan 200,2022-11-20,04:00:00,11,3,8,FMN 15 Luitenant Lippenslaan
662,Luitenant Lippenslaan 200,2022-11-20,05:00:00,4,4,0,FMN 15 Luitenant Lippenslaan
662,Luitenant Lippenslaan 200,2022-11-20,06:00:00,15,11,4,FMN 15 Luitenant Lippenslaan
662,Luitenant Lippenslaan 200,2022-11-20,07:00:00,22,16,6,FMN 15 Luitenant Lippenslaan
662,Luitenant Lippenslaan 200,2022-11-20,08:00:00,34,28,6,FMN 15 Luitenant Lippenslaan
662,Luitenant Lippenslaan 200,2022-11-20,09:00:00,59,47,12,FMN 15 Luitenant Lippenslaan
662,Luitenant Lippenslaan 200,2022-11-20,10:00:00,53,49,4,FMN 15 Luitenant Lippenslaan
662,Luitenant Lippenslaan 200,2022-11-20,11:00:00,62,52,10,FMN 15 Luitenant Lippenslaan
662,Luitenant Lippenslaan 200,2022-11-20,12:00:00,57,49,8,FMN 15 Luitenant Lippenslaan
662,Luitenant Lippenslaan 200,2022-11-20,13:00:00,67,59,8,FMN 15 Luitenant Lippenslaan
662,Luitenant Lippenslaan 200,2022-11-20,14:00:00,59,33,26,FMN 15 Luitenant Lippenslaan
662,Luitenant Lippenslaan 200,2022-11-20,15:00:00,52,38,14,FMN 15 Luitenant Lippenslaan
662,Luitenant Lippenslaan 200,2022-11-20,16:00:00,46,36,10,FMN 15 Luitenant Lippenslaan
662,Luitenant Lippenslaan 200,2022-11-20,17:00:00,48,32,16,FMN 15 Luitenant Lippenslaan
662,Luitenant Lippenslaan 200,2022-11-20,18:00:00,67,51,16,FMN 15 Luitenant Lippenslaan
662,Luitenant Lippenslaan 200,2022-11-20,19:00:00,59,37,22,FMN 15 Luitenant Lippenslaan
662,Luitenant Lippenslaan 200,2022-11-20,20:00:00,56,34,22,FMN 15 Luitenant Lippenslaan
662,Luitenant Lippenslaan 200,2022-11-20,21:00:00,30,16,14,FMN 15 Luitenant Lippenslaan
662,Luitenant Lippenslaan 200,2022-11-20,22:00:00,19,15,4,FMN 15 Luitenant Lippenslaan
662,Luitenant Lippenslaan 200,2022-11-20,23:00:00,10,6,4,FMN 15 Luitenant Lippenslaan
662,Luitenant Lippenslaan 200,2022-11-21,00:00:00,4,4,0,FMN 15 Luitenant Lippenslaan
662,Luitenant Lippenslaan 200,2022-11-21,01:00:00,7,3,4,FMN 15 Luitenant Lippenslaan
662,Luitenant Lippenslaan 200,2022-11-21,02:00:00,2,2,0,FMN 15 Luitenant Lippenslaan
662,Luitenant Lippenslaan 200,2022-11-21,03:00:00,3,3,0,FMN 15 Luitenant Lippenslaan
662,Luitenant Lippenslaan 200,2022-11-21,04:00:00,9,9,0,FMN 15 Luitenant Lippenslaan
662,Luitenant Lippenslaan 200,2022-11-21,05:00:00,14,12,2,FMN 15 Luitenant Lippenslaan
662,Luitenant Lippenslaan 200,2022-11-21,06:00:00,53,45,8,FMN 15 Luitenant Lippenslaan
662,Luitenant Lippenslaan 200,2022-11-21,07:00:00,131,119,12,FMN 15 Luitenant Lippenslaan
662,Luitenant Lippenslaan 200,2022-11-21,08:00:00,240,217,23,FMN 15 Luitenant Lippenslaan
662,Luitenant Lippenslaan 200,2022-11-21,09:00:00,105,103,2,FMN 15 Luitenant Lippenslaan
662,Luitenant Lippenslaan 200,2022-11-21,10:00:00,81,69,12,FMN 15 Luitenant Lippenslaan
662,Luitenant Lippenslaan 200,2022-11-21,11:00:00,79,67,12,FMN 15 Luitenant Lippenslaan
662,Luitenant Lippenslaan 200,2022-11-21,12:00:00,104,82,22,FMN 15 Luitenant Lippenslaan
662,Luitenant Lippenslaan 200,2022-11-21,13:00:00,101,77,24,FMN 15 Luitenant Lippenslaan
662,Luitenant Lippenslaan 200,2022-11-21,14:00:00,71,55,16,FMN 15 Luitenant Lippenslaan
662,Luitenant Lippenslaan 200,2022-11-21,15:00:00,96,62,34,FMN 15 Luitenant Lippenslaan
662,Luitenant Lippenslaan 200,2022-11-21,16:00:00,140,104,36,FMN 15 Luitenant Lippenslaan
662,Luitenant Lippenslaan 200,2022-11-21,17:00:00,143,117,26,FMN 15 Luitenant Lippenslaan
662,Luitenant Lippenslaan 200,2022-11-21,18:00:00,79,65,14,FMN 15 Luitenant Lippenslaan
662,Luitenant Lippenslaan 200,2022-11-21,19:00:00,73,45,28,FMN 15 Luitenant Lippenslaan
662,Luitenant Lippenslaan 200,2022-11-21,20:00:00,34,28,6,FMN 15 Luitenant Lippenslaan
662,Luitenant Lippenslaan 200,2022-11-21,21:00:00,45,25,20,FMN 15 Luitenant Lippenslaan
662,Luitenant Lippenslaan 200,2022-11-21,22:00:00,38,20,18,FMN 15 Luitenant Lippenslaan
662,Luitenant Lippenslaan 200,2022-11-21,23:00:00,15,9,6,FMN 15 Luitenant Lippenslaan
662,Luitenant Lippenslaan 200,2022-11-22,00:00:00,9,5,4,FMN 15 Luitenant Lippenslaan
662,Luitenant Lippenslaan 200,2022-11-22,01:00:00,0,0,0,FMN 15 Luitenant Lippenslaan
662,Luitenant Lippenslaan 200,2022-11-22,02:00:00,6,2,4,FMN 15 Luitenant Lippenslaan
662,Luitenant Lippenslaan 200,2022-11-22,03:00:00,1,1,0,FMN 15 Luitenant Lippenslaan
662,Luitenant Lippenslaan 200,2022-11-22,04:00:00,8,8,0,FMN 15 Luitenant Lippenslaan
662,Luitenant Lippenslaan 200,2022-11-22,05:00:00,16,12,4,FMN 15 Luitenant Lippenslaan
662,Luitenant Lippenslaan 200,2022-11-22,06:00:00,64,48,16,FMN 15 Luitenant Lippenslaan
662,Luitenant Lippenslaan 200,2022-11-22,07:00:00,151,137,14,FMN 15 Luitenant Lippenslaan
662,Luitenant Lippenslaan 200,2022-11-22,08:00:00,268,248,20,FMN 15 Luitenant Lippenslaan
662,Luitenant Lippenslaan 200,2022-11-22,09:00:00,120,114,6,FMN 15 Luitenant Lippenslaan
662,Luitenant Lippenslaan 200,2022-11-22,10:00:00,88,72,16,FMN 15 Luitenant Lippenslaan
662,Luitenant Lippenslaan 200,2022-11-22,11:00:00,54,42,12,FMN 15 Luitenant Lippenslaan
662,Luitenant Lippenslaan 200,2022-11-22,12:00:00,113,93,20,FMN 15 Luitenant Lippenslaan
662,Luitenant Lippenslaan 200,2022-11-22,13:00:00,86,74,12,FMN 15 Luitenant Lippenslaan
662,Luitenant Lippenslaan 200,2022-11-22,14:00:00,58,44,14,FMN 15 Luitenant Lippenslaan
662,Luitenant Lippenslaan 200,2022-11-22,15:00:00,84,58,26,FMN 15 Luitenant Lippenslaan
662,Luitenant Lippenslaan 200,2022-11-22,16:00:00,131,83,48,FMN 15 Luitenant Lippenslaan
662,Luitenant Lippenslaan 200,2022-11-22,17:00:00,140,98,42,FMN 15 Luitenant Lippenslaan
662,Luitenant Lippenslaan 200,2022-11-22,18:00:00,100,78,22,FMN 15 Luitenant Lippenslaan
662,Luitenant Lippenslaan 200,2022-11-22,19:00:00,93,66,27,FMN 15 Luitenant Lippenslaan
662,Luitenant Lippenslaan 200,2022-11-22,20:00:00,54,48,6,FMN 15 Luitenant Lippenslaan
662,Luitenant Lippenslaan 200,2022-11-22,21:00:00,39,27,12,FMN 15 Luitenant Lippenslaan
662,Luitenant Lippenslaan 200,2022-11-22,22:00:00,25,21,4,FMN 15 Luitenant Lippenslaan
662,Luitenant Lippenslaan 200,2022-11-22,23:00:00,30,22,8,FMN 15 Luitenant Lippenslaan
662,Luitenant Lippenslaan 200,2022-11-23,00:00:00,11,7,4,FMN 15 Luitenant Lippenslaan
662,Luitenant Lippenslaan 200,2022-11-23,01:00:00,5,1,4,FMN 15 Luitenant Lippenslaan
662,Luitenant Lippenslaan 200,2022-11-23,02:00:00,3,1,2,FMN 15 Luitenant Lippenslaan
662,Luitenant Lippenslaan 200,2022-11-23,03:00:00,5,3,2,FMN 15 Luitenant Lippenslaan
662,Luitenant Lippenslaan 200,2022-11-23,04:00:00,7,5,2,FMN 15 Luitenant Lippenslaan
662,Luitenant Lippenslaan 200,2022-11-23,05:00:00,12,8,4,FMN 15 Luitenant Lippenslaan
662,Luitenant Lippenslaan 200,2022-11-23,06:00:00,23,21,2,FMN 15 Luitenant Lippenslaan
662,Luitenant Lippenslaan 200,2022-11-23,07:00:00,65,63,2,FMN 15 Luitenant Lippenslaan
662,Luitenant Lippenslaan 200,2022-11-23,08:00:00,85,78,7,FMN 15 Luitenant Lippenslaan
662,Luitenant Lippenslaan 200,2022-11-23,09:00:00,41,37,4,FMN 15 Luitenant Lippenslaan
662,Luitenant Lippenslaan 200,2022-11-23,10:00:00,49,41,8,FMN 15 Luitenant Lippenslaan
662,Luitenant Lippenslaan 200,2022-11-23,11:00:00,45,33,12,FMN 15 Luitenant Lippenslaan
662,Luitenant Lippenslaan 200,2022-11-23,12:00:00,106,72,34,FMN 15 Luitenant Lippenslaan
662,Luitenant Lippenslaan 200,2022-11-23,13:00:00,55,43,12,FMN 15 Luitenant Lippenslaan
662,Luitenant Lippenslaan 200,2022-11-23,14:00:00,41,35,6,FMN 15 Luitenant Lippenslaan
662,Luitenant Lippenslaan 200,2022-11-23,15:00:00,52,38,14,FMN 15 Luitenant Lippenslaan
662,Luitenant Lippenslaan 200,2022-11-23,16:00:00,58,50,8,FMN 15 Luitenant Lippenslaan
662,Luitenant Lippenslaan 200,2022-11-23,17:00:00,77,45,32,FMN 15 Luitenant Lippenslaan
662,Luitenant Lippenslaan 200,2022-11-23,18:00:00,57,49,8,FMN 15 Luitenant Lippenslaan
662,Luitenant Lippenslaan 200,2022-11-23,19:00:00,56,42,14,FMN 15 Luitenant Lippenslaan
662,Luitenant Lippenslaan 200,2022-11-23,20:00:00,29,21,8,FMN 15 Luitenant Lippenslaan
662,Luitenant Lippenslaan 200,2022-11-23,21:00:00,21,13,8,FMN 15 Luitenant Lippenslaan
662,Luitenant Lippenslaan 200,2022-11-23,22:00:00,40,22,18,FMN 15 Luitenant Lippenslaan
662,Luitenant Lippenslaan 200,2022-11-23,23:00:00,13,11,2,FMN 15 Luitenant Lippenslaan
662,Luitenant Lippenslaan 200,2022-11-24,00:00:00,15,7,8,FMN 15 Luitenant Lippenslaan
662,Luitenant Lippenslaan 200,2022-11-24,01:00:00,5,1,4,FMN 15 Luitenant Lippenslaan
662,Luitenant Lippenslaan 200,2022-11-24,02:00:00,7,3,4,FMN 15 Luitenant Lippenslaan
662,Luitenant Lippenslaan 200,2022-11-24,03:00:00,2,2,0,FMN 15 Luitenant Lippenslaan
662,Luitenant Lippenslaan 200,2022-11-24,04:00:00,7,5,2,FMN 15 Luitenant Lippenslaan
662,Luitenant Lippenslaan 200,2022-11-24,05:00:00,17,13,4,FMN 15 Luitenant Lippenslaan
662,Luitenant Lippenslaan 200,2022-11-24,06:00:00,32,24,8,FMN 15 Luitenant Lippenslaan
662,Luitenant Lippenslaan 200,2022-11-24,07:00:00,109,97,12,FMN 15 Luitenant Lippenslaan
662,Luitenant Lippenslaan 200,2022-11-24,08:00:00,190,168,22,FMN 15 Luitenant Lippenslaan
662,Luitenant Lippenslaan 200,2022-11-24,09:00:00,108,96,12,FMN 15 Luitenant Lippenslaan
662,Luitenant Lippenslaan 200,2022-11-24,10:00:00,68,50,18,FMN 15 Luitenant Lippenslaan
662,Luitenant Lippenslaan 200,2022-11-24,11:00:00,82,70,12,FMN 15 Luitenant Lippenslaan
662,Luitenant Lippenslaan 200,2022-11-24,12:00:00,95,79,16,FMN 15 Luitenant Lippenslaan
662,Luitenant Lippenslaan 200,2022-11-24,13:00:00,89,77,12,FMN 15 Luitenant Lippenslaan
662,Luitenant Lippenslaan 200,2022-11-24,14:00:00,67,57,10,FMN 15 Luitenant Lippenslaan
662,Luitenant Lippenslaan 200,2022-11-24,15:00:00,94,72,22,FMN 15 Luitenant Lippenslaan
662,Luitenant Lippenslaan 200,2022-11-24,16:00:00,123,77,46,FMN 15 Luitenant Lippenslaan
662,Luitenant Lippenslaan 200,2022-11-24,17:00:00,132,106,26,FMN 15 Luitenant Lippenslaan
662,Luitenant Lippenslaan 200,2022-11-24,18:00:00,84,66,18,FMN 15 Luitenant Lippenslaan
662,Luitenant Lippenslaan 200,2022-11-24,19:00:00,70,52,18,FMN 15 Luitenant Lippenslaan
662,Luitenant Lippenslaan 200,2022-11-24,20:00:00,30,24,6,FMN 15 Luitenant Lippenslaan
662,Luitenant Lippenslaan 200,2022-11-24,21:00:00,27,21,6,FMN 15 Luitenant Lippenslaan
662,Luitenant Lippenslaan 200,2022-11-24,22:00:00,27,15,12,FMN 15 Luitenant Lippenslaan
662,Luitenant Lippenslaan 200,2022-11-24,23:00:00,12,10,2,FMN 15 Luitenant Lippenslaan
662,Luitenant Lippenslaan 200,2022-11-25,00:00:00,8,2,6,FMN 15 Luitenant Lippenslaan
662,Luitenant Lippenslaan 200,2022-11-25,01:00:00,3,1,2,FMN 15 Luitenant Lippenslaan
662,Luitenant Lippenslaan 200,2022-11-25,02:00:00,6,0,6,FMN 15 Luitenant Lippenslaan
662,Luitenant Lippenslaan 200,2022-11-25,03:00:00,6,4,2,FMN 15 Luitenant Lippenslaan
662,Luitenant Lippenslaan 200,2022-11-25,04:00:00,6,4,2,FMN 15 Luitenant Lippenslaan
662,Luitenant Lippenslaan 200,2022-11-25,05:00:00,14,10,4,FMN 15 Luitenant Lippenslaan
662,Luitenant Lippenslaan 200,2022-11-25,06:00:00,28,24,4,FMN 15 Luitenant Lippenslaan
662,Luitenant Lippenslaan 200,2022-11-25,07:00:00,65,61,4,FMN 15 Luitenant Lippenslaan
662,Luitenant Lippenslaan 200,2022-11-25,08:00:00,132,118,14,FMN 15 Luitenant Lippenslaan
662,Luitenant Lippenslaan 200,2022-11-25,09:00:00,63,57,6,FMN 15 Luitenant Lippenslaan
662,Luitenant Lippenslaan 200,2022-11-25,10:00:00,66,56,10,FMN 15 Luitenant Lippenslaan
662,Luitenant Lippenslaan 200,2022-11-25,11:00:00,84,64,20,FMN 15 Luitenant Lippenslaan
662,Luitenant Lippenslaan 200,2022-11-25,12:00:00,109,91,18,FMN 15 Luitenant Lippenslaan
662,Luitenant Lippenslaan 200,2022-11-25,13:00:00,99,81,18,FMN 15 Luitenant Lippenslaan
662,Luitenant Lippenslaan 200,2022-11-25,14:00:00,80,60,20,FMN 15 Luitenant Lippenslaan
662,Luitenant Lippenslaan 200,2022-11-25,15:00:00,89,65,24,FMN 15 Luitenant Lippenslaan
662,Luitenant Lippenslaan 200,2022-11-25,16:00:00,87,72,15,FMN 15 Luitenant Lippenslaan
662,Luitenant Lippenslaan 200,2022-11-25,17:00:00,72,52,20,FMN 15 Luitenant Lippenslaan
662,Luitenant Lippenslaan 200,2022-11-25,18:00:00,86,58,28,FMN 15 Luitenant Lippenslaan
662,Luitenant Lippenslaan 200,2022-11-25,19:00:00,73,61,12,FMN 15 Luitenant Lippenslaan
662,Luitenant Lippenslaan 200,2022-11-25,20:00:00,31,25,6,FMN 15 Luitenant Lippenslaan
662,Luitenant Lippenslaan 200,2022-11-25,21:00:00,26,20,6,FMN 15 Luitenant Lippenslaan
662,Luitenant Lippenslaan 200,2022-11-25,22:00:00,21,11,10,FMN 15 Luitenant Lippenslaan
662,Luitenant Lippenslaan 200,2022-11-25,23:00:00,14,8,6,FMN 15 Luitenant Lippenslaan
662,Luitenant Lippenslaan 200,2022-11-26,00:00:00,17,11,6,FMN 15 Luitenant Lippenslaan
662,Luitenant Lippenslaan 200,2022-11-26,01:00:00,6,4,2,FMN 15 Luitenant Lippenslaan
662,Luitenant Lippenslaan 200,2022-11-26,02:00:00,10,4,6,FMN 15 Luitenant Lippenslaan
662,Luitenant Lippenslaan 200,2022-11-26,03:00:00,20,4,16,FMN 15 Luitenant Lippenslaan
662,Luitenant Lippenslaan 200,2022-11-26,04:00:00,13,5,8,FMN 15 Luitenant Lippenslaan
662,Luitenant Lippenslaan 200,2022-11-26,05:00:00,15,7,8,FMN 15 Luitenant Lippenslaan
662,Luitenant Lippenslaan 200,2022-11-26,06:00:00,14,10,4,FMN 15 Luitenant Lippenslaan
662,Luitenant Lippenslaan 200,2022-11-26,07:00:00,23,15,8,FMN 15 Luitenant Lippenslaan
662,Luitenant Lippenslaan 200,2022-11-26,08:00:00,38,30,8,FMN 15 Luitenant Lippenslaan
662,Luitenant Lippenslaan 200,2022-11-26,09:00:00,80,72,8,FMN 15 Luitenant Lippenslaan
662,Luitenant Lippenslaan 200,2022-11-26,10:00:00,94,80,14,FMN 15 Luitenant Lippenslaan
662,Luitenant Lippenslaan 200,2022-11-26,11:00:00,99,77,22,FMN 15 Luitenant Lippenslaan
662,Luitenant Lippenslaan 200,2022-11-26,12:00:00,111,101,10,FMN 15 Luitenant Lippenslaan
662,Luitenant Lippenslaan 200,2022-11-26,13:00:00,154,122,32,FMN 15 Luitenant Lippenslaan
662,Luitenant Lippenslaan 200,2022-11-26,14:00:00,150,112,38,FMN 15 Luitenant Lippenslaan
662,Luitenant Lippenslaan 200,2022-11-26,15:00:00,131,95,36,FMN 15 Luitenant Lippenslaan
662,Luitenant Lippenslaan 200,2022-11-26,16:00:00,97,75,22,FMN 15 Luitenant Lippenslaan
662,Luitenant Lippenslaan 200,2022-11-26,17:00:00,122,96,26,FMN 15 Luitenant Lippenslaan
662,Luitenant Lippenslaan 200,2022-11-26,18:00:00,116,88,28,FMN 15 Luitenant Lippenslaan
662,Luitenant Lippenslaan 200,2022-11-26,19:00:00,78,58,20,FMN 15 Luitenant Lippenslaan
662,Luitenant Lippenslaan 200,2022-11-26,20:00:00,73,59,14,FMN 15 Luitenant Lippenslaan
662,Luitenant Lippenslaan 200,2022-11-26,21:00:00,48,22,26,FMN 15 Luitenant Lippenslaan
662,Luitenant Lippenslaan 200,2022-11-26,22:00:00,41,25,16,FMN 15 Luitenant Lippenslaan
662,Luitenant Lippenslaan 200,2022-11-26,23:00:00,23,13,10,FMN 15 Luitenant Lippenslaan
662,Luitenant Lippenslaan 200,2022-11-27,00:00:00,31,15,16,FMN 15 Luitenant Lippenslaan
662,Luitenant Lippenslaan 200,2022-11-27,01:00:00,12,8,4,FMN 15 Luitenant Lippenslaan
662,Luitenant Lippenslaan 200,2022-11-27,02:00:00,13,9,4,FMN 15 Luitenant Lippenslaan
662,Luitenant Lippenslaan 200,2022-11-27,03:00:00,11,9,2,FMN 15 Luitenant Lippenslaan
662,Luitenant Lippenslaan 200,2022-11-27,04:00:00,2,0,2,FMN 15 Luitenant Lippenslaan
662,Luitenant Lippenslaan 200,2022-11-27,05:00:00,12,6,6,FMN 15 Luitenant Lippenslaan
662,Luitenant Lippenslaan 200,2022-11-27,06:00:00,12,10,2,FMN 15 Luitenant Lippenslaan
662,Luitenant Lippenslaan 200,2022-11-27,07:00:00,19,15,4,FMN 15 Luitenant Lippenslaan
662,Luitenant Lippenslaan 200,2022-11-27,08:00:00,35,21,14,FMN 15 Luitenant Lippenslaan
662,Luitenant Lippenslaan 200,2022-11-27,09:00:00,43,41,2,FMN 15 Luitenant Lippenslaan
662,Luitenant Lippenslaan 200,2022-11-27,10:00:00,40,32,8,FMN 15 Luitenant Lippenslaan
662,Luitenant Lippenslaan 200,2022-11-27,11:00:00,44,36,8,FMN 15 Luitenant Lippenslaan
662,Luitenant Lippenslaan 200,2022-11-27,12:00:00,75,65,10,FMN 15 Luitenant Lippenslaan
662,Luitenant Lippenslaan 200,2022-11-27,13:00:00,121,101,20,FMN 15 Luitenant Lippenslaan
662,Luitenant Lippenslaan 200,2022-11-27,14:00:00,57,49,8,FMN 15 Luitenant Lippenslaan
662,Luitenant Lippenslaan 200,2022-11-27,15:00:00,43,23,20,FMN 15 Luitenant Lippenslaan
662,Luitenant Lippenslaan 200,2022-11-27,16:00:00,68,50,18,FMN 15 Luitenant Lippenslaan
662,Luitenant Lippenslaan 200,2022-11-27,17:00:00,60,44,16,FMN 15 Luitenant Lippenslaan
662,Luitenant Lippenslaan 200,2022-11-27,18:00:00,67,33,34,FMN 15 Luitenant Lippenslaan
662,Luitenant Lippenslaan 200,2022-11-27,19:00:00,56,46,10,FMN 15 Luitenant Lippenslaan
662,Luitenant Lippenslaan 200,2022-11-27,20:00:00,30,24,6,FMN 15 Luitenant Lippenslaan
662,Luitenant Lippenslaan 200,2022-11-27,21:00:00,30,18,12,FMN 15 Luitenant Lippenslaan
662,Luitenant Lippenslaan 200,2022-11-27,22:00:00,20,14,6,FMN 15 Luitenant Lippenslaan
662,Luitenant Lippenslaan 200,2022-11-27,23:00:00,10,8,2,FMN 15 Luitenant Lippenslaan
662,Luitenant Lippenslaan 200,2022-11-28,00:00:00,9,3,6,FMN 15 Luitenant Lippenslaan
662,Luitenant Lippenslaan 200,2022-11-28,01:00:00,9,3,6,FMN 15 Luitenant Lippenslaan
662,Luitenant Lippenslaan 200,2022-11-28,02:00:00,2,0,2,FMN 15 Luitenant Lippenslaan
662,Luitenant Lippenslaan 200,2022-11-28,03:00:00,3,1,2,FMN 15 Luitenant Lippenslaan
662,Luitenant Lippenslaan 200,2022-11-28,04:00:00,9,7,2,FMN 15 Luitenant Lippenslaan
662,Luitenant Lippenslaan 200,2022-11-28,05:00:00,7,3,4,FMN 15 Luitenant Lippenslaan
662,Luitenant Lippenslaan 200,2022-11-28,06:00:00,30,30,0,FMN 15 Luitenant Lippenslaan
662,Luitenant Lippenslaan 200,2022-11-28,07:00:00,91,81,10,FMN 15 Luitenant Lippenslaan
662,Luitenant Lippenslaan 200,2022-11-28,08:00:00,177,169,8,FMN 15 Luitenant Lippenslaan
662,Luitenant Lippenslaan 200,2022-11-28,09:00:00,86,80,6,FMN 15 Luitenant Lippenslaan
662,Luitenant Lippenslaan 200,2022-11-28,10:00:00,42,40,2,FMN 15 Luitenant Lippenslaan
662,Luitenant Lippenslaan 200,2022-11-28,11:00:00,48,44,4,FMN 15 Luitenant Lippenslaan
662,Luitenant Lippenslaan 200,2022-11-28,12:00:00,51,43,8,FMN 15 Luitenant Lippenslaan
662,Luitenant Lippenslaan 200,2022-11-28,13:00:00,52,40,12,FMN 15 Luitenant Lippenslaan
662,Luitenant Lippenslaan 200,2022-11-28,14:00:00,62,46,16,FMN 15 Luitenant Lippenslaan
662,Luitenant Lippenslaan 200,2022-11-28,15:00:00,61,47,14,FMN 15 Luitenant Lippenslaan
662,Luitenant Lippenslaan 200,2022-11-28,16:00:00,76,64,12,FMN 15 Luitenant Lippenslaan
662,Luitenant Lippenslaan 200,2022-11-28,17:00:00,93,67,26,FMN 15 Luitenant Lippenslaan
662,Luitenant Lippenslaan 200,2022-11-28,18:00:00,66,46,20,FMN 15 Luitenant Lippenslaan
662,Luitenant Lippenslaan 200,2022-11-28,19:00:00,64,50,14,FMN 15 Luitenant Lippenslaan
662,Luitenant Lippenslaan 200,2022-11-28,20:00:00,43,27,16,FMN 15 Luitenant Lippenslaan
662,Luitenant Lippenslaan 200,2022-11-28,21:00:00,26,20,6,FMN 15 Luitenant Lippenslaan
662,Luitenant Lippenslaan 200,2022-11-28,22:00:00,18,6,12,FMN 15 Luitenant Lippenslaan
662,Luitenant Lippenslaan 200,2022-11-28,23:00:00,8,4,4,FMN 15 Luitenant Lippenslaan
662,Luitenant Lippenslaan 200,2022-11-29,00:00:00,3,1,2,FMN 15 Luitenant Lippenslaan
662,Luitenant Lippenslaan 200,2022-11-29,01:00:00,1,1,0,FMN 15 Luitenant Lippenslaan
662,Luitenant Lippenslaan 200,2022-11-29,02:00:00,4,2,2,FMN 15 Luitenant Lippenslaan
662,Luitenant Lippenslaan 200,2022-11-29,03:00:00,0,0,0,FMN 15 Luitenant Lippenslaan
662,Luitenant Lippenslaan 200,2022-11-29,04:00:00,5,5,0,FMN 15 Luitenant Lippenslaan
662,Luitenant Lippenslaan 200,2022-11-29,05:00:00,12,10,2,FMN 15 Luitenant Lippenslaan
662,Luitenant Lippenslaan 200,2022-11-29,06:00:00,46,38,8,FMN 15 Luitenant Lippenslaan
662,Luitenant Lippenslaan 200,2022-11-29,07:00:00,152,142,10,FMN 15 Luitenant Lippenslaan
662,Luitenant Lippenslaan 200,2022-11-29,08:00:00,298,282,16,FMN 15 Luitenant Lippenslaan
662,Luitenant Lippenslaan 200,2022-11-29,09:00:00,113,105,8,FMN 15 Luitenant Lippenslaan
662,Luitenant Lippenslaan 200,2022-11-29,10:00:00,73,67,6,FMN 15 Luitenant Lippenslaan
662,Luitenant Lippenslaan 200,2022-11-29,11:00:00,67,57,10,FMN 15 Luitenant Lippenslaan
662,Luitenant Lippenslaan 200,2022-11-29,12:00:00,115,103,12,FMN 15 Luitenant Lippenslaan
662,Luitenant Lippenslaan 200,2022-11-29,13:00:00,109,97,12,FMN 15 Luitenant Lippenslaan
662,Luitenant Lippenslaan 200,2022-11-29,14:00:00,85,65,20,FMN 15 Luitenant Lippenslaan
662,Luitenant Lippenslaan 200,2022-11-29,15:00:00,93,79,14,FMN 15 Luitenant Lippenslaan
662,Luitenant Lippenslaan 200,2022-11-29,16:00:00,142,116,26,FMN 15 Luitenant Lippenslaan
662,Luitenant Lippenslaan 200,2022-11-29,17:00:00,124,94,30,FMN 15 Luitenant Lippenslaan
662,Luitenant Lippenslaan 200,2022-11-29,18:00:00,99,83,16,FMN 15 Luitenant Lippenslaan
662,Luitenant Lippenslaan 200,2022-11-29,19:00:00,75,57,18,FMN 15 Luitenant Lippenslaan
662,Luitenant Lippenslaan 200,2022-11-29,20:00:00,38,30,8,FMN 15 Luitenant Lippenslaan
662,Luitenant Lippenslaan 200,2022-11-29,21:00:00,40,24,16,FMN 15 Luitenant Lippenslaan
662,Luitenant Lippenslaan 200,2022-11-29,22:00:00,30,20,10,FMN 15 Luitenant Lippenslaan
662,Luitenant Lippenslaan 200,2022-11-29,23:00:00,22,16,6,FMN 15 Luitenant Lippenslaan
662,Luitenant Lippenslaan 200,2022-11-30,00:00:00,8,2,6,FMN 15 Luitenant Lippenslaan
662,Luitenant Lippenslaan 200,2022-11-30,01:00:00,8,6,2,FMN 15 Luitenant Lippenslaan
662,Luitenant Lippenslaan 200,2022-11-30,02:00:00,6,0,6,FMN 15 Luitenant Lippenslaan
662,Luitenant Lippenslaan 200,2022-11-30,03:00:00,0,0,0,FMN 15 Luitenant Lippenslaan
662,Luitenant Lippenslaan 200,2022-11-30,04:00:00,10,6,4,FMN 15 Luitenant Lippenslaan
662,Luitenant Lippenslaan 200,2022-11-30,05:00:00,22,16,6,FMN 15 Luitenant Lippenslaan
662,Luitenant Lippenslaan 200,2022-11-30,06:00:00,54,44,10,FMN 15 Luitenant Lippenslaan
662,Luitenant Lippenslaan 200,2022-11-30,07:00:00,138,126,12,FMN 15 Luitenant Lippenslaan
662,Luitenant Lippenslaan 200,2022-11-30,08:00:00,259,247,12,FMN 15 Luitenant Lippenslaan
662,Luitenant Lippenslaan 200,2022-11-30,09:00:00,117,109,8,FMN 15 Luitenant Lippenslaan
662,Luitenant Lippenslaan 200,2022-11-30,10:00:00,73,63,10,FMN 15 Luitenant Lippenslaan
662,Luitenant Lippenslaan 200,2022-11-30,11:00:00,71,61,10,FMN 15 Luitenant Lippenslaan
662,Luitenant Lippenslaan 200,2022-11-30,12:00:00,119,87,32,FMN 15 Luitenant Lippenslaan
662,Luitenant Lippenslaan 200,2022-11-30,13:00:00,127,103,24,FMN 15 Luitenant Lippenslaan
662,Luitenant Lippenslaan 200,2022-11-30,14:00:00,90,76,14,FMN 15 Luitenant Lippenslaan
662,Luitenant Lippenslaan 200,2022-11-30,15:00:00,120,80,40,FMN 15 Luitenant Lippenslaan
662,Luitenant Lippenslaan 200,2022-11-30,16:00:00,112,84,28,FMN 15 Luitenant Lippenslaan
662,Luitenant Lippenslaan 200,2022-11-30,17:00:00,152,116,36,FMN 15 Luitenant Lippenslaan
662,Luitenant Lippenslaan 200,2022-11-30,18:00:00,136,106,30,FMN 15 Luitenant Lippenslaan
662,Luitenant Lippenslaan 200,2022-11-30,19:00:00,101,77,24,FMN 15 Luitenant Lippenslaan
662,Luitenant Lippenslaan 200,2022-11-30,20:00:00,54,38,16,FMN 15 Luitenant Lippenslaan
662,Luitenant Lippenslaan 200,2022-11-30,21:00:00,56,34,22,FMN 15 Luitenant Lippenslaan
662,Luitenant Lippenslaan 200,2022-11-30,22:00:00,58,34,24,FMN 15 Luitenant Lippenslaan
662,Luitenant Lippenslaan 200,2022-11-30,23:00:00,20,14,6,FMN 15 Luitenant Lippenslaan
662,Luitenant Lippenslaan 200,2022-12-01,00:00:00,1,1,0,FMN 15 Luitenant Lippenslaan
662,Luitenant Lippenslaan 200,2022-12-01,01:00:00,7,3,4,FMN 15 Luitenant Lippenslaan
662,Luitenant Lippenslaan 200,2022-12-01,02:00:00,7,3,4,FMN 15 Luitenant Lippenslaan
662,Luitenant Lippenslaan 200,2022-12-01,03:00:00,3,1,2,FMN 15 Luitenant Lippenslaan
662,Luitenant Lippenslaan 200,2022-12-01,04:00:00,7,5,2,FMN 15 Luitenant Lippenslaan
662,Luitenant Lippenslaan 200,2022-12-01,05:00:00,22,16,6,FMN 15 Luitenant Lippenslaan
662,Luitenant Lippenslaan 200,2022-12-01,06:00:00,58,48,10,FMN 15 Luitenant Lippenslaan
662,Luitenant Lippenslaan 200,2022-12-01,07:00:00,157,147,10,FMN 15 Luitenant Lippenslaan
662,Luitenant Lippenslaan 200,2022-12-01,08:00:00,313,296,17,FMN 15 Luitenant Lippenslaan
662,Luitenant Lippenslaan 200,2022-12-01,09:00:00,115,105,10,FMN 15 Luitenant Lippenslaan
662,Luitenant Lippenslaan 200,2022-12-01,10:00:00,100,90,10,FMN 15 Luitenant Lippenslaan
662,Luitenant Lippenslaan 200,2022-12-01,11:00:00,75,59,16,FMN 15 Luitenant Lippenslaan
662,Luitenant Lippenslaan 200,2022-12-01,12:00:00,110,98,12,FMN 15 Luitenant Lippenslaan
662,Luitenant Lippenslaan 200,2022-12-01,13:00:00,93,71,22,FMN 15 Luitenant Lippenslaan
662,Luitenant Lippenslaan 200,2022-12-01,14:00:00,104,82,22,FMN 15 Luitenant Lippenslaan
662,Luitenant Lippenslaan 200,2022-12-01,15:00:00,119,85,34,FMN 15 Luitenant Lippenslaan
662,Luitenant Lippenslaan 200,2022-12-01,16:00:00,118,82,36,FMN 15 Luitenant Lippenslaan
662,Luitenant Lippenslaan 200,2022-12-01,17:00:00,126,94,32,FMN 15 Luitenant Lippenslaan
662,Luitenant Lippenslaan 200,2022-12-01,18:00:00,125,91,34,FMN 15 Luitenant Lippenslaan
662,Luitenant Lippenslaan 200,2022-12-01,19:00:00,111,85,26,FMN 15 Luitenant Lippenslaan
662,Luitenant Lippenslaan 200,2022-12-01,20:00:00,61,47,14,FMN 15 Luitenant Lippenslaan
662,Luitenant Lippenslaan 200,2022-12-01,21:00:00,48,28,20,FMN 15 Luitenant Lippenslaan
662,Luitenant Lippenslaan 200,2022-12-01,22:00:00,39,27,12,FMN 15 Luitenant Lippenslaan
662,Luitenant Lippenslaan 200,2022-12-01,23:00:00,11,5,6,FMN 15 Luitenant Lippenslaan
662,Luitenant Lippenslaan 200,2022-12-02,00:00:00,14,4,10,FMN 15 Luitenant Lippenslaan
662,Luitenant Lippenslaan 200,2022-12-02,01:00:00,10,2,8,FMN 15 Luitenant Lippenslaan
662,Luitenant Lippenslaan 200,2022-12-02,02:00:00,3,1,2,FMN 15 Luitenant Lippenslaan
662,Luitenant Lippenslaan 200,2022-12-02,03:00:00,4,0,4,FMN 15 Luitenant Lippenslaan
662,Luitenant Lippenslaan 200,2022-12-02,04:00:00,5,5,0,FMN 15 Luitenant Lippenslaan
662,Luitenant Lippenslaan 200,2022-12-02,05:00:00,12,6,6,FMN 15 Luitenant Lippenslaan
662,Luitenant Lippenslaan 200,2022-12-02,06:00:00,49,35,14,FMN 15 Luitenant Lippenslaan
662,Luitenant Lippenslaan 200,2022-12-02,07:00:00,125,115,10,FMN 15 Luitenant Lippenslaan
662,Luitenant Lippenslaan 200,2022-12-02,08:00:00,209,195,14,FMN 15 Luitenant Lippenslaan
662,Luitenant Lippenslaan 200,2022-12-02,09:00:00,96,88,8,FMN 15 Luitenant Lippenslaan
662,Luitenant Lippenslaan 200,2022-12-02,10:00:00,80,74,6,FMN 15 Luitenant Lippenslaan
662,Luitenant Lippenslaan 200,2022-12-02,11:00:00,52,44,8,FMN 15 Luitenant Lippenslaan
662,Luitenant Lippenslaan 200,2022-12-02,12:00:00,70,54,16,FMN 15 Luitenant Lippenslaan
662,Luitenant Lippenslaan 200,2022-12-02,13:00:00,62,48,14,FMN 15 Luitenant Lippenslaan
662,Luitenant Lippenslaan 200,2022-12-02,14:00:00,77,43,34,FMN 15 Luitenant Lippenslaan
662,Luitenant Lippenslaan 200,2022-12-02,15:00:00,68,50,18,FMN 15 Luitenant Lippenslaan
662,Luitenant Lippenslaan 200,2022-12-02,16:00:00,108,82,26,FMN 15 Luitenant Lippenslaan
662,Luitenant Lippenslaan 200,2022-12-02,17:00:00,109,71,38,FMN 15 Luitenant Lippenslaan
662,Luitenant Lippenslaan 200,2022-12-02,18:00:00,77,67,10,FMN 15 Luitenant Lippenslaan
662,Luitenant Lippenslaan 200,2022-12-02,19:00:00,113,93,20,FMN 15 Luitenant Lippenslaan
662,Luitenant Lippenslaan 200,2022-12-02,20:00:00,47,33,14,FMN 15 Luitenant Lippenslaan
662,Luitenant Lippenslaan 200,2022-12-02,21:00:00,35,21,14,FMN 15 Luitenant Lippenslaan
662,Luitenant Lippenslaan 200,2022-12-02,22:00:00,29,23,6,FMN 15 Luitenant Lippenslaan
662,Luitenant Lippenslaan 200,2022-12-02,23:00:00,26,12,14,FMN 15 Luitenant Lippenslaan
662,Luitenant Lippenslaan 200,2022-12-03,00:00:00,30,18,12,FMN 15 Luitenant Lippenslaan
662,Luitenant Lippenslaan 200,2022-12-03,01:00:00,11,7,4,FMN 15 Luitenant Lippenslaan
662,Luitenant Lippenslaan 200,2022-12-03,02:00:00,12,6,6,FMN 15 Luitenant Lippenslaan
662,Luitenant Lippenslaan 200,2022-12-03,03:00:00,7,3,4,FMN 15 Luitenant Lippenslaan
662,Luitenant Lippenslaan 200,2022-12-03,04:00:00,10,10,0,FMN 15 Luitenant Lippenslaan
662,Luitenant Lippenslaan 200,2022-12-03,05:00:00,10,8,2,FMN 15 Luitenant Lippenslaan
662,Luitenant Lippenslaan 200,2022-12-03,06:00:00,24,14,10,FMN 15 Luitenant Lippenslaan
662,Luitenant Lippenslaan 200,2022-12-03,07:00:00,19,17,2,FMN 15 Luitenant Lippenslaan
662,Luitenant Lippenslaan 200,2022-12-03,08:00:00,25,18,7,FMN 15 Luitenant Lippenslaan
662,Luitenant Lippenslaan 200,2022-12-03,09:00:00,47,43,4,FMN 15 Luitenant Lippenslaan
662,Luitenant Lippenslaan 200,2022-12-03,10:00:00,56,50,6,FMN 15 Luitenant Lippenslaan
662,Luitenant Lippenslaan 200,2022-12-03,11:00:00,59,55,4,FMN 15 Luitenant Lippenslaan
662,Luitenant Lippenslaan 200,2022-12-03,12:00:00,58,46,12,FMN 15 Luitenant Lippenslaan
662,Luitenant Lippenslaan 200,2022-12-03,13:00:00,61,51,10,FMN 15 Luitenant Lippenslaan
662,Luitenant Lippenslaan 200,2022-12-03,14:00:00,65,51,14,FMN 15 Luitenant Lippenslaan
662,Luitenant Lippenslaan 200,2022-12-03,15:00:00,53,39,14,FMN 15 Luitenant Lippenslaan
662,Luitenant Lippenslaan 200,2022-12-03,16:00:00,67,57,10,FMN 15 Luitenant Lippenslaan
662,Luitenant Lippenslaan 200,2022-12-03,17:00:00,49,37,12,FMN 15 Luitenant Lippenslaan
662,Luitenant Lippenslaan 200,2022-12-03,18:00:00,64,46,18,FMN 15 Luitenant Lippenslaan
662,Luitenant Lippenslaan 200,2022-12-03,19:00:00,47,35,12,FMN 15 Luitenant Lippenslaan
662,Luitenant Lippenslaan 200,2022-12-03,20:00:00,36,32,4,FMN 15 Luitenant Lippenslaan
662,Luitenant Lippenslaan 200,2022-12-03,21:00:00,25,17,8,FMN 15 Luitenant Lippenslaan
662,Luitenant Lippenslaan 200,2022-12-03,22:00:00,24,20,4,FMN 15 Luitenant Lippenslaan
662,Luitenant Lippenslaan 200,2022-12-03,23:00:00,21,13,8,FMN 15 Luitenant Lippenslaan
662,Luitenant Lippenslaan 200,2022-12-04,00:00:00,7,5,2,FMN 15 Luitenant Lippenslaan
662,Luitenant Lippenslaan 200,2022-12-04,01:00:00,10,8,2,FMN 15 Luitenant Lippenslaan
662,Luitenant Lippenslaan 200,2022-12-04,02:00:00,14,6,8,FMN 15 Luitenant Lippenslaan
662,Luitenant Lippenslaan 200,2022-12-04,03:00:00,7,3,4,FMN 15 Luitenant Lippenslaan
662,Luitenant Lippenslaan 200,2022-12-04,04:00:00,2,2,0,FMN 15 Luitenant Lippenslaan
662,Luitenant Lippenslaan 200,2022-12-04,05:00:00,9,7,2,FMN 15 Luitenant Lippenslaan
662,Luitenant Lippenslaan 200,2022-12-04,06:00:00,12,6,6,FMN 15 Luitenant Lippenslaan
662,Luitenant Lippenslaan 200,2022-12-04,07:00:00,9,7,2,FMN 15 Luitenant Lippenslaan
662,Luitenant Lippenslaan 200,2022-12-04,08:00:00,11,11,0,FMN 15 Luitenant Lippenslaan
662,Luitenant Lippenslaan 200,2022-12-04,09:00:00,44,40,4,FMN 15 Luitenant Lippenslaan
662,Luitenant Lippenslaan 200,2022-12-04,10:00:00,44,38,6,FMN 15 Luitenant Lippenslaan
662,Luitenant Lippenslaan 200,2022-12-04,11:00:00,63,49,14,FMN 15 Luitenant Lippenslaan
662,Luitenant Lippenslaan 200,2022-12-04,12:00:00,69,57,12,FMN 15 Luitenant Lippenslaan
662,Luitenant Lippenslaan 200,2022-12-04,13:00:00,60,38,22,FMN 15 Luitenant Lippenslaan
662,Luitenant Lippenslaan 200,2022-12-04,14:00:00,46,28,18,FMN 15 Luitenant Lippenslaan
662,Luitenant Lippenslaan 200,2022-12-04,15:00:00,48,34,14,FMN 15 Luitenant Lippenslaan
662,Luitenant Lippenslaan 200,2022-12-04,16:00:00,30,20,10,FMN 15 Luitenant Lippenslaan
662,Luitenant Lippenslaan 200,2022-12-04,17:00:00,38,26,12,FMN 15 Luitenant Lippenslaan
662,Luitenant Lippenslaan 200,2022-12-04,18:00:00,34,32,2,FMN 15 Luitenant Lippenslaan
662,Luitenant Lippenslaan 200,2022-12-04,19:00:00,52,26,26,FMN 15 Luitenant Lippenslaan
662,Luitenant Lippenslaan 200,2022-12-04,20:00:00,30,18,12,FMN 15 Luitenant Lippenslaan
662,Luitenant Lippenslaan 200,2022-12-04,21:00:00,19,11,8,FMN 15 Luitenant Lippenslaan
662,Luitenant Lippenslaan 200,2022-12-04,22:00:00,11,5,6,FMN 15 Luitenant Lippenslaan
662,Luitenant Lippenslaan 200,2022-12-04,23:00:00,9,7,2,FMN 15 Luitenant Lippenslaan
662,Luitenant Lippenslaan 200,2022-12-05,00:00:00,2,0,2,FMN 15 Luitenant Lippenslaan
662,Luitenant Lippenslaan 200,2022-12-05,01:00:00,0,0,0,FMN 15 Luitenant Lippenslaan
662,Luitenant Lippenslaan 200,2022-12-05,02:00:00,3,1,2,FMN 15 Luitenant Lippenslaan
662,Luitenant Lippenslaan 200,2022-12-05,03:00:00,3,1,2,FMN 15 Luitenant Lippenslaan
662,Luitenant Lippenslaan 200,2022-12-05,04:00:00,4,2,2,FMN 15 Luitenant Lippenslaan
662,Luitenant Lippenslaan 200,2022-12-05,05:00:00,17,9,8,FMN 15 Luitenant Lippenslaan
662,Luitenant Lippenslaan 200,2022-12-05,06:00:00,41,37,4,FMN 15 Luitenant Lippenslaan
662,Luitenant Lippenslaan 200,2022-12-05,07:00:00,115,113,2,FMN 15 Luitenant Lippenslaan
662,Luitenant Lippenslaan 200,2022-12-05,08:00:00,246,232,14,FMN 15 Luitenant Lippenslaan
662,Luitenant Lippenslaan 200,2022-12-05,09:00:00,110,104,6,FMN 15 Luitenant Lippenslaan
662,Luitenant Lippenslaan 200,2022-12-05,10:00:00,71,63,8,FMN 15 Luitenant Lippenslaan
662,Luitenant Lippenslaan 200,2022-12-05,11:00:00,53,45,8,FMN 15 Luitenant Lippenslaan
662,Luitenant Lippenslaan 200,2022-12-05,12:00:00,79,67,12,FMN 15 Luitenant Lippenslaan
662,Luitenant Lippenslaan 200,2022-12-05,13:00:00,59,53,6,FMN 15 Luitenant Lippenslaan
662,Luitenant Lippenslaan 200,2022-12-05,14:00:00,70,54,16,FMN 15 Luitenant Lippenslaan
662,Luitenant Lippenslaan 200,2022-12-05,15:00:00,92,58,34,FMN 15 Luitenant Lippenslaan
662,Luitenant Lippenslaan 200,2022-12-05,16:00:00,108,82,26,FMN 15 Luitenant Lippenslaan
662,Luitenant Lippenslaan 200,2022-12-05,17:00:00,115,89,26,FMN 15 Luitenant Lippenslaan
662,Luitenant Lippenslaan 200,2022-12-05,18:00:00,81,65,16,FMN 15 Luitenant Lippenslaan
662,Luitenant Lippenslaan 200,2022-12-05,19:00:00,83,69,14,FMN 15 Luitenant Lippenslaan
662,Luitenant Lippenslaan 200,2022-12-05,20:00:00,41,29,12,FMN 15 Luitenant Lippenslaan
662,Luitenant Lippenslaan 200,2022-12-05,21:00:00,45,23,22,FMN 15 Luitenant Lippenslaan
662,Luitenant Lippenslaan 200,2022-12-05,22:00:00,34,20,14,FMN 15 Luitenant Lippenslaan
662,Luitenant Lippenslaan 200,2022-12-05,23:00:00,5,5,0,FMN 15 Luitenant Lippenslaan
662,Luitenant Lippenslaan 200,2022-12-06,00:00:00,2,2,0,FMN 15 Luitenant Lippenslaan
662,Luitenant Lippenslaan 200,2022-12-06,01:00:00,6,2,4,FMN 15 Luitenant Lippenslaan
662,Luitenant Lippenslaan 200,2022-12-06,02:00:00,3,1,2,FMN 15 Luitenant Lippenslaan
662,Luitenant Lippenslaan 200,2022-12-06,03:00:00,3,3,0,FMN 15 Luitenant Lippenslaan
662,Luitenant Lippenslaan 200,2022-12-06,04:00:00,8,6,2,FMN 15 Luitenant Lippenslaan
662,Luitenant Lippenslaan 200,2022-12-06,05:00:00,16,16,0,FMN 15 Luitenant Lippenslaan
662,Luitenant Lippenslaan 200,2022-12-06,06:00:00,56,48,8,FMN 15 Luitenant Lippenslaan
662,Luitenant Lippenslaan 200,2022-12-06,07:00:00,179,167,12,FMN 15 Luitenant Lippenslaan
662,Luitenant Lippenslaan 200,2022-12-06,08:00:00,334,316,18,FMN 15 Luitenant Lippenslaan
662,Luitenant Lippenslaan 200,2022-12-06,09:00:00,122,116,6,FMN 15 Luitenant Lippenslaan
662,Luitenant Lippenslaan 200,2022-12-06,10:00:00,82,70,12,FMN 15 Luitenant Lippenslaan
662,Luitenant Lippenslaan 200,2022-12-06,11:00:00,71,61,10,FMN 15 Luitenant Lippenslaan
662,Luitenant Lippenslaan 200,2022-12-06,12:00:00,123,113,10,FMN 15 Luitenant Lippenslaan
662,Luitenant Lippenslaan 200,2022-12-06,13:00:00,113,87,26,FMN 15 Luitenant Lippenslaan
662,Luitenant Lippenslaan 200,2022-12-06,14:00:00,57,45,12,FMN 15 Luitenant Lippenslaan
662,Luitenant Lippenslaan 200,2022-12-06,15:00:00,110,78,32,FMN 15 Luitenant Lippenslaan
662,Luitenant Lippenslaan 200,2022-12-06,16:00:00,117,85,32,FMN 15 Luitenant Lippenslaan
662,Luitenant Lippenslaan 200,2022-12-06,17:00:00,102,96,6,FMN 15 Luitenant Lippenslaan
662,Luitenant Lippenslaan 200,2022-12-06,18:00:00,83,63,20,FMN 15 Luitenant Lippenslaan
662,Luitenant Lippenslaan 200,2022-12-06,19:00:00,72,50,22,FMN 15 Luitenant Lippenslaan
662,Luitenant Lippenslaan 200,2022-12-06,20:00:00,42,28,14,FMN 15 Luitenant Lippenslaan
662,Luitenant Lippenslaan 200,2022-12-06,21:00:00,27,17,10,FMN 15 Luitenant Lippenslaan
662,Luitenant Lippenslaan 200,2022-12-06,22:00:00,23,17,6,FMN 15 Luitenant Lippenslaan
662,Luitenant Lippenslaan 200,2022-12-06,23:00:00,18,8,10,FMN 15 Luitenant Lippenslaan
662,Luitenant Lippenslaan 200,2022-12-07,00:00:00,2,0,2,FMN 15 Luitenant Lippenslaan
662,Luitenant Lippenslaan 200,2022-12-07,01:00:00,1,1,0,FMN 15 Luitenant Lippenslaan
662,Luitenant Lippenslaan 200,2022-12-07,02:00:00,3,1,2,FMN 15 Luitenant Lippenslaan
662,Luitenant Lippenslaan 200,2022-12-07,03:00:00,1,1,0,FMN 15 Luitenant Lippenslaan
662,Luitenant Lippenslaan 200,2022-12-07,04:00:00,4,2,2,FMN 15 Luitenant Lippenslaan
662,Luitenant Lippenslaan 200,2022-12-07,05:00:00,15,11,4,FMN 15 Luitenant Lippenslaan
662,Luitenant Lippenslaan 200,2022-12-07,06:00:00,55,45,10,FMN 15 Luitenant Lippenslaan
662,Luitenant Lippenslaan 200,2022-12-07,07:00:00,104,96,8,FMN 15 Luitenant Lippenslaan
662,Luitenant Lippenslaan 200,2022-12-07,08:00:00,212,200,12,FMN 15 Luitenant Lippenslaan
662,Luitenant Lippenslaan 200,2022-12-07,09:00:00,88,78,10,FMN 15 Luitenant Lippenslaan
662,Luitenant Lippenslaan 200,2022-12-07,10:00:00,71,57,14,FMN 15 Luitenant Lippenslaan
662,Luitenant Lippenslaan 200,2022-12-07,11:00:00,70,54,16,FMN 15 Luitenant Lippenslaan
662,Luitenant Lippenslaan 200,2022-12-07,12:00:00,106,82,24,FMN 15 Luitenant Lippenslaan
662,Luitenant Lippenslaan 200,2022-12-07,13:00:00,80,70,10,FMN 15 Luitenant Lippenslaan
662,Luitenant Lippenslaan 200,2022-12-07,14:00:00,58,38,20,FMN 15 Luitenant Lippenslaan
662,Luitenant Lippenslaan 200,2022-12-07,15:00:00,72,40,32,FMN 15 Luitenant Lippenslaan
662,Luitenant Lippenslaan 200,2022-12-07,16:00:00,75,55,20,FMN 15 Luitenant Lippenslaan
662,Luitenant Lippenslaan 200,2022-12-07,17:00:00,97,77,20,FMN 15 Luitenant Lippenslaan
662,Luitenant Lippenslaan 200,2022-12-07,18:00:00,74,60,14,FMN 15 Luitenant Lippenslaan
662,Luitenant Lippenslaan 200,2022-12-07,19:00:00,57,44,13,FMN 15 Luitenant Lippenslaan
662,Luitenant Lippenslaan 200,2022-12-07,20:00:00,48,36,12,FMN 15 Luitenant Lippenslaan
662,Luitenant Lippenslaan 200,2022-12-07,21:00:00,37,27,10,FMN 15 Luitenant Lippenslaan
662,Luitenant Lippenslaan 200,2022-12-07,22:00:00,26,14,12,FMN 15 Luitenant Lippenslaan
662,Luitenant Lippenslaan 200,2022-12-07,23:00:00,10,6,4,FMN 15 Luitenant Lippenslaan
662,Luitenant Lippenslaan 200,2022-12-08,00:00:00,8,4,4,FMN 15 Luitenant Lippenslaan
662,Luitenant Lippenslaan 200,2022-12-08,01:00:00,4,2,2,FMN 15 Luitenant Lippenslaan
662,Luitenant Lippenslaan 200,2022-12-08,02:00:00,5,1,4,FMN 15 Luitenant Lippenslaan
662,Luitenant Lippenslaan 200,2022-12-08,03:00:00,4,4,0,FMN 15 Luitenant Lippenslaan
662,Luitenant Lippenslaan 200,2022-12-08,04:00:00,4,2,2,FMN 15 Luitenant Lippenslaan
662,Luitenant Lippenslaan 200,2022-12-08,05:00:00,17,13,4,FMN 15 Luitenant Lippenslaan
662,Luitenant Lippenslaan 200,2022-12-08,06:00:00,50,40,10,FMN 15 Luitenant Lippenslaan
662,Luitenant Lippenslaan 200,2022-12-08,07:00:00,114,100,14,FMN 15 Luitenant Lippenslaan
662,Luitenant Lippenslaan 200,2022-12-08,08:00:00,214,190,24,FMN 15 Luitenant Lippenslaan
662,Luitenant Lippenslaan 200,2022-12-08,09:00:00,104,98,6,FMN 15 Luitenant Lippenslaan
662,Luitenant Lippenslaan 200,2022-12-08,10:00:00,53,43,10,FMN 15 Luitenant Lippenslaan
662,Luitenant Lippenslaan 200,2022-12-08,11:00:00,77,61,16,FMN 15 Luitenant Lippenslaan
662,Luitenant Lippenslaan 200,2022-12-08,12:00:00,55,49,6,FMN 15 Luitenant Lippenslaan
662,Luitenant Lippenslaan 200,2022-12-08,13:00:00,64,46,18,FMN 15 Luitenant Lippenslaan
662,Luitenant Lippenslaan 200,2022-12-08,14:00:00,37,25,12,FMN 15 Luitenant Lippenslaan
662,Luitenant Lippenslaan 200,2022-12-08,15:00:00,63,49,14,FMN 15 Luitenant Lippenslaan
662,Luitenant Lippenslaan 200,2022-12-08,16:00:00,88,62,26,FMN 15 Luitenant Lippenslaan
662,Luitenant Lippenslaan 200,2022-12-08,17:00:00,92,70,22,FMN 15 Luitenant Lippenslaan
662,Luitenant Lippenslaan 200,2022-12-08,18:00:00,75,61,14,FMN 15 Luitenant Lippenslaan
662,Luitenant Lippenslaan 200,2022-12-08,19:00:00,50,38,12,FMN 15 Luitenant Lippenslaan
662,Luitenant Lippenslaan 200,2022-12-08,20:00:00,26,16,10,FMN 15 Luitenant Lippenslaan
662,Luitenant Lippenslaan 200,2022-12-08,21:00:00,16,10,6,FMN 15 Luitenant Lippenslaan
662,Luitenant Lippenslaan 200,2022-12-08,22:00:00,23,11,12,FMN 15 Luitenant Lippenslaan
662,Luitenant Lippenslaan 200,2022-12-08,23:00:00,5,5,0,FMN 15 Luitenant Lippenslaan
662,Luitenant Lippenslaan 200,2022-12-09,00:00:00,5,1,4,FMN 15 Luitenant Lippenslaan
662,Luitenant Lippenslaan 200,2022-12-09,01:00:00,4,0,4,FMN 15 Luitenant Lippenslaan
662,Luitenant Lippenslaan 200,2022-12-09,02:00:00,6,2,4,FMN 15 Luitenant Lippenslaan
662,Luitenant Lippenslaan 200,2022-12-09,03:00:00,3,3,0,FMN 15 Luitenant Lippenslaan
662,Luitenant Lippenslaan 200,2022-12-09,04:00:00,7,1,6,FMN 15 Luitenant Lippenslaan
662,Luitenant Lippenslaan 200,2022-12-09,05:00:00,14,6,8,FMN 15 Luitenant Lippenslaan
662,Luitenant Lippenslaan 200,2022-12-09,06:00:00,32,24,8,FMN 15 Luitenant Lippenslaan
662,Luitenant Lippenslaan 200,2022-12-09,07:00:00,76,64,12,FMN 15 Luitenant Lippenslaan
662,Luitenant Lippenslaan 200,2022-12-09,08:00:00,111,101,10,FMN 15 Luitenant Lippenslaan
662,Luitenant Lippenslaan 200,2022-12-09,09:00:00,69,58,11,FMN 15 Luitenant Lippenslaan
662,Luitenant Lippenslaan 200,2022-12-09,10:00:00,53,40,13,FMN 15 Luitenant Lippenslaan
662,Luitenant Lippenslaan 200,2022-12-09,11:00:00,62,44,18,FMN 15 Luitenant Lippenslaan
662,Luitenant Lippenslaan 200,2022-12-09,12:00:00,57,49,8,FMN 15 Luitenant Lippenslaan
662,Luitenant Lippenslaan 200,2022-12-09,13:00:00,58,42,16,FMN 15 Luitenant Lippenslaan
662,Luitenant Lippenslaan 200,2022-12-09,14:00:00,65,53,12,FMN 15 Luitenant Lippenslaan
662,Luitenant Lippenslaan 200,2022-12-09,15:00:00,66,44,22,FMN 15 Luitenant Lippenslaan
662,Luitenant Lippenslaan 200,2022-12-09,16:00:00,71,49,22,FMN 15 Luitenant Lippenslaan
662,Luitenant Lippenslaan 200,2022-12-09,17:00:00,61,47,14,FMN 15 Luitenant Lippenslaan
662,Luitenant Lippenslaan 200,2022-12-09,18:00:00,73,50,23,FMN 15 Luitenant Lippenslaan
662,Luitenant Lippenslaan 200,2022-12-09,19:00:00,41,31,10,FMN 15 Luitenant Lippenslaan
662,Luitenant Lippenslaan 200,2022-12-09,20:00:00,14,10,4,FMN 15 Luitenant Lippenslaan
662,Luitenant Lippenslaan 200,2022-12-09,21:00:00,11,5,6,FMN 15 Luitenant Lippenslaan
662,Luitenant Lippenslaan 200,2022-12-09,22:00:00,9,7,2,FMN 15 Luitenant Lippenslaan
662,Luitenant Lippenslaan 200,2022-12-09,23:00:00,9,5,4,FMN 15 Luitenant Lippenslaan
662,Luitenant Lippenslaan 200,2022-12-10,00:00:00,6,2,4,FMN 15 Luitenant Lippenslaan
662,Luitenant Lippenslaan 200,2022-12-10,01:00:00,8,4,4,FMN 15 Luitenant Lippenslaan
662,Luitenant Lippenslaan 200,2022-12-10,02:00:00,2,0,2,FMN 15 Luitenant Lippenslaan
662,Luitenant Lippenslaan 200,2022-12-10,03:00:00,1,1,0,FMN 15 Luitenant Lippenslaan
662,Luitenant Lippenslaan 200,2022-12-10,04:00:00,2,0,2,FMN 15 Luitenant Lippenslaan
662,Luitenant Lippenslaan 200,2022-12-10,05:00:00,5,5,0,FMN 15 Luitenant Lippenslaan
662,Luitenant Lippenslaan 200,2022-12-10,06:00:00,9,7,2,FMN 15 Luitenant Lippenslaan
662,Luitenant Lippenslaan 200,2022-12-10,07:00:00,12,10,2,FMN 15 Luitenant Lippenslaan
662,Luitenant Lippenslaan 200,2022-12-10,08:00:00,11,11,0,FMN 15 Luitenant Lippenslaan
662,Luitenant Lippenslaan 200,2022-12-10,09:00:00,21,21,0,FMN 15 Luitenant Lippenslaan
662,Luitenant Lippenslaan 200,2022-12-10,10:00:00,22,18,4,FMN 15 Luitenant Lippenslaan
662,Luitenant Lippenslaan 200,2022-12-10,11:00:00,24,18,6,FMN 15 Luitenant Lippenslaan
662,Luitenant Lippenslaan 200,2022-12-10,12:00:00,23,23,0,FMN 15 Luitenant Lippenslaan
662,Luitenant Lippenslaan 200,2022-12-10,13:00:00,31,22,9,FMN 15 Luitenant Lippenslaan
662,Luitenant Lippenslaan 200,2022-12-10,14:00:00,45,37,8,FMN 15 Luitenant Lippenslaan
662,Luitenant Lippenslaan 200,2022-12-10,15:00:00,25,21,4,FMN 15 Luitenant Lippenslaan
662,Luitenant Lippenslaan 200,2022-12-10,16:00:00,32,26,6,FMN 15 Luitenant Lippenslaan
662,Luitenant Lippenslaan 200,2022-12-10,17:00:00,44,24,20,FMN 15 Luitenant Lippenslaan
662,Luitenant Lippenslaan 200,2022-12-10,18:00:00,51,43,8,FMN 15 Luitenant Lippenslaan
662,Luitenant Lippenslaan 200,2022-12-10,19:00:00,28,16,12,FMN 15 Luitenant Lippenslaan
662,Luitenant Lippenslaan 200,2022-12-10,20:00:00,17,7,10,FMN 15 Luitenant Lippenslaan
662,Luitenant Lippenslaan 200,2022-12-10,21:00:00,16,10,6,FMN 15 Luitenant Lippenslaan
662,Luitenant Lippenslaan 200,2022-12-10,22:00:00,20,12,8,FMN 15 Luitenant Lippenslaan
662,Luitenant Lippenslaan 200,2022-12-10,23:00:00,19,9,10,FMN 15 Luitenant Lippenslaan
662,Luitenant Lippenslaan 200,2022-12-11,00:00:00,5,3,2,FMN 15 Luitenant Lippenslaan
662,Luitenant Lippenslaan 200,2022-12-11,01:00:00,7,3,4,FMN 15 Luitenant Lippenslaan
662,Luitenant Lippenslaan 200,2022-12-11,02:00:00,8,4,4,FMN 15 Luitenant Lippenslaan
662,Luitenant Lippenslaan 200,2022-12-11,03:00:00,8,4,4,FMN 15 Luitenant Lippenslaan
662,Luitenant Lippenslaan 200,2022-12-11,04:00:00,3,1,2,FMN 15 Luitenant Lippenslaan
662,Luitenant Lippenslaan 200,2022-12-11,05:00:00,6,6,0,FMN 15 Luitenant Lippenslaan
662,Luitenant Lippenslaan 200,2022-12-11,06:00:00,12,8,4,FMN 15 Luitenant Lippenslaan
662,Luitenant Lippenslaan 200,2022-12-11,07:00:00,11,7,4,FMN 15 Luitenant Lippenslaan
662,Luitenant Lippenslaan 200,2022-12-11,08:00:00,17,15,2,FMN 15 Luitenant Lippenslaan
662,Luitenant Lippenslaan 200,2022-12-11,09:00:00,19,17,2,FMN 15 Luitenant Lippenslaan
662,Luitenant Lippenslaan 200,2022-12-11,10:00:00,27,21,6,FMN 15 Luitenant Lippenslaan
662,Luitenant Lippenslaan 200,2022-12-11,11:00:00,24,22,2,FMN 15 Luitenant Lippenslaan
662,Luitenant Lippenslaan 200,2022-12-11,12:00:00,39,29,10,FMN 15 Luitenant Lippenslaan
662,Luitenant Lippenslaan 200,2022-12-11,13:00:00,51,37,14,FMN 15 Luitenant Lippenslaan
662,Luitenant Lippenslaan 200,2022-12-11,14:00:00,48,42,6,FMN 15 Luitenant Lippenslaan
662,Luitenant Lippenslaan 200,2022-12-11,15:00:00,38,28,10,FMN 15 Luitenant Lippenslaan
662,Luitenant Lippenslaan 200,2022-12-11,16:00:00,28,26,2,FMN 15 Luitenant Lippenslaan
662,Luitenant Lippenslaan 200,2022-12-11,17:00:00,35,21,14,FMN 15 Luitenant Lippenslaan
662,Luitenant Lippenslaan 200,2022-12-11,18:00:00,22,16,6,FMN 15 Luitenant Lippenslaan
662,Luitenant Lippenslaan 200,2022-12-11,19:00:00,23,15,8,FMN 15 Luitenant Lippenslaan
662,Luitenant Lippenslaan 200,2022-12-11,20:00:00,25,13,12,FMN 15 Luitenant Lippenslaan
662,Luitenant Lippenslaan 200,2022-12-11,21:00:00,15,9,6,FMN 15 Luitenant Lippenslaan
662,Luitenant Lippenslaan 200,2022-12-11,22:00:00,13,9,4,FMN 15 Luitenant Lippenslaan
662,Luitenant Lippenslaan 200,2022-12-11,23:00:00,12,2,10,FMN 15 Luitenant Lippenslaan
662,Luitenant Lippenslaan 200,2022-12-12,00:00:00,3,1,2,FMN 15 Luitenant Lippenslaan
662,Luitenant Lippenslaan 200,2022-12-12,01:00:00,3,1,2,FMN 15 Luitenant Lippenslaan
662,Luitenant Lippenslaan 200,2022-12-12,02:00:00,0,0,0,FMN 15 Luitenant Lippenslaan
662,Luitenant Lippenslaan 200,2022-12-12,03:00:00,3,1,2,FMN 15 Luitenant Lippenslaan
662,Luitenant Lippenslaan 200,2022-12-12,04:00:00,2,2,0,FMN 15 Luitenant Lippenslaan
662,Luitenant Lippenslaan 200,2022-12-12,05:00:00,5,5,0,FMN 15 Luitenant Lippenslaan
662,Luitenant Lippenslaan 200,2022-12-12,06:00:00,13,11,2,FMN 15 Luitenant Lippenslaan
662,Luitenant Lippenslaan 200,2022-12-12,07:00:00,45,41,4,FMN 15 Luitenant Lippenslaan
662,Luitenant Lippenslaan 200,2022-12-12,08:00:00,73,57,16,FMN 15 Luitenant Lippenslaan
662,Luitenant Lippenslaan 200,2022-12-12,09:00:00,19,19,0,FMN 15 Luitenant Lippenslaan
662,Luitenant Lippenslaan 200,2022-12-12,10:00:00,41,33,8,FMN 15 Luitenant Lippenslaan
662,Luitenant Lippenslaan 200,2022-12-12,11:00:00,31,27,4,FMN 15 Luitenant Lippenslaan
662,Luitenant Lippenslaan 200,2022-12-12,12:00:00,43,29,14,FMN 15 Luitenant Lippenslaan
662,Luitenant Lippenslaan 200,2022-12-12,13:00:00,47,43,4,FMN 15 Luitenant Lippenslaan
662,Luitenant Lippenslaan 200,2022-12-12,14:00:00,47,37,10,FMN 15 Luitenant Lippenslaan
662,Luitenant Lippenslaan 200,2022-12-12,15:00:00,64,48,16,FMN 15 Luitenant Lippenslaan
662,Luitenant Lippenslaan 200,2022-12-12,16:00:00,46,40,6,FMN 15 Luitenant Lippenslaan
662,Luitenant Lippenslaan 200,2022-12-12,17:00:00,44,30,14,FMN 15 Luitenant Lippenslaan
662,Luitenant Lippenslaan 200,2022-12-12,18:00:00,39,23,16,FMN 15 Luitenant Lippenslaan
662,Luitenant Lippenslaan 200,2022-12-12,19:00:00,26,22,4,FMN 15 Luitenant Lippenslaan
662,Luitenant Lippenslaan 200,2022-12-12,20:00:00,14,10,4,FMN 15 Luitenant Lippenslaan
662,Luitenant Lippenslaan 200,2022-12-12,21:00:00,14,8,6,FMN 15 Luitenant Lippenslaan
662,Luitenant Lippenslaan 200,2022-12-12,22:00:00,15,7,8,FMN 15 Luitenant Lippenslaan
662,Luitenant Lippenslaan 200,2022-12-12,23:00:00,1,1,0,FMN 15 Luitenant Lippenslaan
662,Luitenant Lippenslaan 200,2022-12-13,00:00:00,1,1,0,FMN 15 Luitenant Lippenslaan
662,Luitenant Lippenslaan 200,2022-12-13,01:00:00,2,0,2,FMN 15 Luitenant Lippenslaan
662,Luitenant Lippenslaan 200,2022-12-13,02:00:00,2,0,2,FMN 15 Luitenant Lippenslaan
662,Luitenant Lippenslaan 200,2022-12-13,03:00:00,0,0,0,FMN 15 Luitenant Lippenslaan
662,Luitenant Lippenslaan 200,2022-12-13,04:00:00,3,3,0,FMN 15 Luitenant Lippenslaan
662,Luitenant Lippenslaan 200,2022-12-13,05:00:00,4,2,2,FMN 15 Luitenant Lippenslaan
662,Luitenant Lippenslaan 200,2022-12-13,06:00:00,19,17,2,FMN 15 Luitenant Lippenslaan
662,Luitenant Lippenslaan 200,2022-12-13,07:00:00,50,44,6,FMN 15 Luitenant Lippenslaan
662,Luitenant Lippenslaan 200,2022-12-13,08:00:00,78,64,14,FMN 15 Luitenant Lippenslaan
662,Luitenant Lippenslaan 200,2022-12-13,09:00:00,31,23,8,FMN 15 Luitenant Lippenslaan
662,Luitenant Lippenslaan 200,2022-12-13,10:00:00,25,25,0,FMN 15 Luitenant Lippenslaan
662,Luitenant Lippenslaan 200,2022-12-13,11:00:00,40,26,14,FMN 15 Luitenant Lippenslaan
662,Luitenant Lippenslaan 200,2022-12-13,12:00:00,64,52,12,FMN 15 Luitenant Lippenslaan
662,Luitenant Lippenslaan 200,2022-12-13,13:00:00,45,41,4,FMN 15 Luitenant Lippenslaan
662,Luitenant Lippenslaan 200,2022-12-13,14:00:00,20,16,4,FMN 15 Luitenant Lippenslaan
662,Luitenant Lippenslaan 200,2022-12-13,15:00:00,50,34,16,FMN 15 Luitenant Lippenslaan
662,Luitenant Lippenslaan 200,2022-12-13,16:00:00,54,44,10,FMN 15 Luitenant Lippenslaan
662,Luitenant Lippenslaan 200,2022-12-13,17:00:00,43,29,14,FMN 15 Luitenant Lippenslaan
662,Luitenant Lippenslaan 200,2022-12-13,18:00:00,27,25,2,FMN 15 Luitenant Lippenslaan
662,Luitenant Lippenslaan 200,2022-12-13,19:00:00,32,28,4,FMN 15 Luitenant Lippenslaan
662,Luitenant Lippenslaan 200,2022-12-13,20:00:00,9,5,4,FMN 15 Luitenant Lippenslaan
662,Luitenant Lippenslaan 200,2022-12-13,21:00:00,11,9,2,FMN 15 Luitenant Lippenslaan
662,Luitenant Lippenslaan 200,2022-12-13,22:00:00,9,5,4,FMN 15 Luitenant Lippenslaan
662,Luitenant Lippenslaan 200,2022-12-13,23:00:00,6,4,2,FMN 15 Luitenant Lippenslaan
662,Luitenant Lippenslaan 200,2022-12-14,00:00:00,0,0,0,FMN 15 Luitenant Lippenslaan
662,Luitenant Lippenslaan 200,2022-12-14,01:00:00,0,0,0,FMN 15 Luitenant Lippenslaan
662,Luitenant Lippenslaan 200,2022-12-14,02:00:00,0,0,0,FMN 15 Luitenant Lippenslaan
662,Luitenant Lippenslaan 200,2022-12-14,03:00:00,1,1,0,FMN 15 Luitenant Lippenslaan
662,Luitenant Lippenslaan 200,2022-12-14,04:00:00,3,3,0,FMN 15 Luitenant Lippenslaan
662,Luitenant Lippenslaan 200,2022-12-14,05:00:00,7,5,2,FMN 15 Luitenant Lippenslaan
662,Luitenant Lippenslaan 200,2022-12-14,06:00:00,29,19,10,FMN 15 Luitenant Lippenslaan
662,Luitenant Lippenslaan 200,2022-12-14,07:00:00,45,41,4,FMN 15 Luitenant Lippenslaan
662,Luitenant Lippenslaan 200,2022-12-14,08:00:00,97,83,14,FMN 15 Luitenant Lippenslaan
662,Luitenant Lippenslaan 200,2022-12-14,09:00:00,31,27,4,FMN 15 Luitenant Lippenslaan
662,Luitenant Lippenslaan 200,2022-12-14,10:00:00,36,28,8,FMN 15 Luitenant Lippenslaan
662,Luitenant Lippenslaan 200,2022-12-14,11:00:00,25,23,2,FMN 15 Luitenant Lippenslaan
662,Luitenant Lippenslaan 200,2022-12-14,12:00:00,68,48,20,FMN 15 Luitenant Lippenslaan
662,Luitenant Lippenslaan 200,2022-12-14,13:00:00,79,63,16,FMN 15 Luitenant Lippenslaan
662,Luitenant Lippenslaan 200,2022-12-14,14:00:00,49,37,12,FMN 15 Luitenant Lippenslaan
662,Luitenant Lippenslaan 200,2022-12-14,15:00:00,52,34,18,FMN 15 Luitenant Lippenslaan
662,Luitenant Lippenslaan 200,2022-12-14,16:00:00,43,33,10,FMN 15 Luitenant Lippenslaan
662,Luitenant Lippenslaan 200,2022-12-14,17:00:00,52,36,16,FMN 15 Luitenant Lippenslaan
662,Luitenant Lippenslaan 200,2022-12-14,18:00:00,40,32,8,FMN 15 Luitenant Lippenslaan
662,Luitenant Lippenslaan 200,2022-12-14,19:00:00,33,25,8,FMN 15 Luitenant Lippenslaan
662,Luitenant Lippenslaan 200,2022-12-14,20:00:00,25,21,4,FMN 15 Luitenant Lippenslaan
662,Luitenant Lippenslaan 200,2022-12-14,21:00:00,12,6,6,FMN 15 Luitenant Lippenslaan
662,Luitenant Lippenslaan 200,2022-12-14,22:00:00,23,11,12,FMN 15 Luitenant Lippenslaan
662,Luitenant Lippenslaan 200,2022-12-14,23:00:00,8,4,4,FMN 15 Luitenant Lippenslaan
662,Luitenant Lippenslaan 200,2022-12-15,00:00:00,10,2,8,FMN 15 Luitenant Lippenslaan
662,Luitenant Lippenslaan 200,2022-12-15,01:00:00,2,0,2,FMN 15 Luitenant Lippenslaan
662,Luitenant Lippenslaan 200,2022-12-15,02:00:00,3,1,2,FMN 15 Luitenant Lippenslaan
662,Luitenant Lippenslaan 200,2022-12-15,03:00:00,0,0,0,FMN 15 Luitenant Lippenslaan
662,Luitenant Lippenslaan 200,2022-12-15,04:00:00,4,4,0,FMN 15 Luitenant Lippenslaan
662,Luitenant Lippenslaan 200,2022-12-15,05:00:00,4,2,2,FMN 15 Luitenant Lippenslaan
662,Luitenant Lippenslaan 200,2022-12-15,06:00:00,20,14,6,FMN 15 Luitenant Lippenslaan
662,Luitenant Lippenslaan 200,2022-12-15,07:00:00,32,28,4,FMN 15 Luitenant Lippenslaan
662,Luitenant Lippenslaan 200,2022-12-15,08:00:00,57,53,4,FMN 15 Luitenant Lippenslaan
662,Luitenant Lippenslaan 200,2022-12-15,09:00:00,33,31,2,FMN 15 Luitenant Lippenslaan
662,Luitenant Lippenslaan 200,2022-12-15,10:00:00,23,15,8,FMN 15 Luitenant Lippenslaan
662,Luitenant Lippenslaan 200,2022-12-15,11:00:00,26,26,0,FMN 15 Luitenant Lippenslaan
662,Luitenant Lippenslaan 200,2022-12-15,12:00:00,65,51,14,FMN 15 Luitenant Lippenslaan
662,Luitenant Lippenslaan 200,2022-12-15,13:00:00,59,55,4,FMN 15 Luitenant Lippenslaan
662,Luitenant Lippenslaan 200,2022-12-15,14:00:00,45,35,10,FMN 15 Luitenant Lippenslaan
662,Luitenant Lippenslaan 200,2022-12-15,15:00:00,50,38,12,FMN 15 Luitenant Lippenslaan
662,Luitenant Lippenslaan 200,2022-12-15,16:00:00,57,43,14,FMN 15 Luitenant Lippenslaan
662,Luitenant Lippenslaan 200,2022-12-15,17:00:00,48,40,8,FMN 15 Luitenant Lippenslaan
662,Luitenant Lippenslaan 200,2022-12-15,18:00:00,40,32,8,FMN 15 Luitenant Lippenslaan
662,Luitenant Lippenslaan 200,2022-12-15,19:00:00,28,20,8,FMN 15 Luitenant Lippenslaan
662,Luitenant Lippenslaan 200,2022-12-15,20:00:00,19,17,2,FMN 15 Luitenant Lippenslaan
662,Luitenant Lippenslaan 200,2022-12-15,21:00:00,18,10,8,FMN 15 Luitenant Lippenslaan
662,Luitenant Lippenslaan 200,2022-12-15,22:00:00,9,5,4,FMN 15 Luitenant Lippenslaan
662,Luitenant Lippenslaan 200,2022-12-15,23:00:00,8,2,6,FMN 15 Luitenant Lippenslaan
662,Luitenant Lippenslaan 200,2022-12-16,00:00:00,3,1,2,FMN 15 Luitenant Lippenslaan
662,Luitenant Lippenslaan 200,2022-12-16,01:00:00,3,1,2,FMN 15 Luitenant Lippenslaan
662,Luitenant Lippenslaan 200,2022-12-16,02:00:00,0,0,0,FMN 15 Luitenant Lippenslaan
662,Luitenant Lippenslaan 200,2022-12-16,03:00:00,1,1,0,FMN 15 Luitenant Lippenslaan
662,Luitenant Lippenslaan 200,2022-12-16,04:00:00,1,1,0,FMN 15 Luitenant Lippenslaan
662,Luitenant Lippenslaan 200,2022-12-16,05:00:00,8,8,0,FMN 15 Luitenant Lippenslaan
662,Luitenant Lippenslaan 200,2022-12-16,06:00:00,20,14,6,FMN 15 Luitenant Lippenslaan
662,Luitenant Lippenslaan 200,2022-12-16,07:00:00,52,46,6,FMN 15 Luitenant Lippenslaan
662,Luitenant Lippenslaan 200,2022-12-16,08:00:00,84,74,10,FMN 15 Luitenant Lippenslaan
662,Luitenant Lippenslaan 200,2022-12-16,09:00:00,35,33,2,FMN 15 Luitenant Lippenslaan
662,Luitenant Lippenslaan 200,2022-12-16,10:00:00,60,54,6,FMN 15 Luitenant Lippenslaan
662,Luitenant Lippenslaan 200,2022-12-16,11:00:00,61,50,11,FMN 15 Luitenant Lippenslaan
662,Luitenant Lippenslaan 200,2022-12-16,12:00:00,90,78,12,FMN 15 Luitenant Lippenslaan
662,Luitenant Lippenslaan 200,2022-12-16,13:00:00,81,65,16,FMN 15 Luitenant Lippenslaan
662,Luitenant Lippenslaan 200,2022-12-16,14:00:00,64,46,18,FMN 15 Luitenant Lippenslaan
662,Luitenant Lippenslaan 200,2022-12-16,15:00:00,70,56,14,FMN 15 Luitenant Lippenslaan
662,Luitenant Lippenslaan 200,2022-12-16,16:00:00,67,53,14,FMN 15 Luitenant Lippenslaan
662,Luitenant Lippenslaan 200,2022-12-16,17:00:00,64,50,14,FMN 15 Luitenant Lippenslaan
662,Luitenant Lippenslaan 200,2022-12-16,18:00:00,63,49,14,FMN 15 Luitenant Lippenslaan
662,Luitenant Lippenslaan 200,2022-12-16,19:00:00,45,33,12,FMN 15 Luitenant Lippenslaan
662,Luitenant Lippenslaan 200,2022-12-16,20:00:00,25,23,2,FMN 15 Luitenant Lippenslaan
662,Luitenant Lippenslaan 200,2022-12-16,21:00:00,17,11,6,FMN 15 Luitenant Lippenslaan
662,Luitenant Lippenslaan 200,2022-12-16,22:00:00,13,9,4,FMN 15 Luitenant Lippenslaan
662,Luitenant Lippenslaan 200,2022-12-16,23:00:00,14,8,6,FMN 15 Luitenant Lippenslaan
662,Luitenant Lippenslaan 200,2022-12-17,00:00:00,6,4,2,FMN 15 Luitenant Lippenslaan
662,Luitenant Lippenslaan 200,2022-12-17,01:00:00,3,3,0,FMN 15 Luitenant Lippenslaan
662,Luitenant Lippenslaan 200,2022-12-17,02:00:00,4,0,4,FMN 15 Luitenant Lippenslaan
662,Luitenant Lippenslaan 200,2022-12-17,03:00:00,5,3,2,FMN 15 Luitenant Lippenslaan
662,Luitenant Lippenslaan 200,2022-12-17,04:00:00,2,2,0,FMN 15 Luitenant Lippenslaan
662,Luitenant Lippenslaan 200,2022-12-17,05:00:00,3,1,2,FMN 15 Luitenant Lippenslaan
662,Luitenant Lippenslaan 200,2022-12-17,06:00:00,1,1,0,FMN 15 Luitenant Lippenslaan
662,Luitenant Lippenslaan 200,2022-12-17,07:00:00,4,2,2,FMN 15 Luitenant Lippenslaan
662,Luitenant Lippenslaan 200,2022-12-17,08:00:00,7,5,2,FMN 15 Luitenant Lippenslaan
662,Luitenant Lippenslaan 200,2022-12-17,09:00:00,8,8,0,FMN 15 Luitenant Lippenslaan
662,Luitenant Lippenslaan 200,2022-12-17,10:00:00,16,16,0,FMN 15 Luitenant Lippenslaan
662,Luitenant Lippenslaan 200,2022-12-17,11:00:00,29,25,4,FMN 15 Luitenant Lippenslaan
662,Luitenant Lippenslaan 200,2022-12-17,12:00:00,35,23,12,FMN 15 Luitenant Lippenslaan
662,Luitenant Lippenslaan 200,2022-12-17,13:00:00,47,39,8,FMN 15 Luitenant Lippenslaan
662,Luitenant Lippenslaan 200,2022-12-17,14:00:00,24,20,4,FMN 15 Luitenant Lippenslaan
662,Luitenant Lippenslaan 200,2022-12-17,15:00:00,30,22,8,FMN 15 Luitenant Lippenslaan
662,Luitenant Lippenslaan 200,2022-12-17,16:00:00,18,16,2,FMN 15 Luitenant Lippenslaan
662,Luitenant Lippenslaan 200,2022-12-17,17:00:00,16,12,4,FMN 15 Luitenant Lippenslaan
662,Luitenant Lippenslaan 200,2022-12-17,18:00:00,23,15,8,FMN 15 Luitenant Lippenslaan
662,Luitenant Lippenslaan 200,2022-12-17,19:00:00,28,19,9,FMN 15 Luitenant Lippenslaan
662,Luitenant Lippenslaan 200,2022-12-17,20:00:00,20,12,8,FMN 15 Luitenant Lippenslaan
662,Luitenant Lippenslaan 200,2022-12-17,21:00:00,6,6,0,FMN 15 Luitenant Lippenslaan
662,Luitenant Lippenslaan 200,2022-12-17,22:00:00,2,2,0,FMN 15 Luitenant Lippenslaan
662,Luitenant Lippenslaan 200,2022-12-17,23:00:00,5,3,2,FMN 15 Luitenant Lippenslaan
662,Luitenant Lippenslaan 200,2022-12-18,00:00:00,0,0,0,FMN 15 Luitenant Lippenslaan
662,Luitenant Lippenslaan 200,2022-12-18,01:00:00,2,2,0,FMN 15 Luitenant Lippenslaan
662,Luitenant Lippenslaan 200,2022-12-18,02:00:00,1,1,0,FMN 15 Luitenant Lippenslaan
662,Luitenant Lippenslaan 200,2022-12-18,03:00:00,1,1,0,FMN 15 Luitenant Lippenslaan
662,Luitenant Lippenslaan 200,2022-12-18,04:00:00,2,2,0,FMN 15 Luitenant Lippenslaan
662,Luitenant Lippenslaan 200,2022-12-18,05:00:00,1,1,0,FMN 15 Luitenant Lippenslaan
662,Luitenant Lippenslaan 200,2022-12-18,06:00:00,1,1,0,FMN 15 Luitenant Lippenslaan
662,Luitenant Lippenslaan 200,2022-12-18,07:00:00,5,1,4,FMN 15 Luitenant Lippenslaan
662,Luitenant Lippenslaan 200,2022-12-18,08:00:00,8,2,6,FMN 15 Luitenant Lippenslaan
662,Luitenant Lippenslaan 200,2022-12-18,09:00:00,12,12,0,FMN 15 Luitenant Lippenslaan
662,Luitenant Lippenslaan 200,2022-12-18,10:00:00,16,12,4,FMN 15 Luitenant Lippenslaan
662,Luitenant Lippenslaan 200,2022-12-18,11:00:00,20,18,2,FMN 15 Luitenant Lippenslaan
662,Luitenant Lippenslaan 200,2022-12-18,12:00:00,17,13,4,FMN 15 Luitenant Lippenslaan
662,Luitenant Lippenslaan 200,2022-12-18,13:00:00,26,24,2,FMN 15 Luitenant Lippenslaan
662,Luitenant Lippenslaan 200,2022-12-18,14:00:00,30,16,14,FMN 15 Luitenant Lippenslaan
662,Luitenant Lippenslaan 200,2022-12-18,15:00:00,25,15,10,FMN 15 Luitenant Lippenslaan
662,Luitenant Lippenslaan 200,2022-12-18,16:00:00,14,10,4,FMN 15 Luitenant Lippenslaan
662,Luitenant Lippenslaan 200,2022-12-18,17:00:00,13,7,6,FMN 15 Luitenant Lippenslaan
662,Luitenant Lippenslaan 200,2022-12-18,18:00:00,17,11,6,FMN 15 Luitenant Lippenslaan
662,Luitenant Lippenslaan 200,2022-12-18,19:00:00,21,13,8,FMN 15 Luitenant Lippenslaan
662,Luitenant Lippenslaan 200,2022-12-18,20:00:00,8,4,4,FMN 15 Luitenant Lippenslaan
662,Luitenant Lippenslaan 200,2022-12-18,21:00:00,6,6,0,FMN 15 Luitenant Lippenslaan
662,Luitenant Lippenslaan 200,2022-12-18,22:00:00,5,1,4,FMN 15 Luitenant Lippenslaan
662,Luitenant Lippenslaan 200,2022-12-18,23:00:00,3,1,2,FMN 15 Luitenant Lippenslaan
662,Luitenant Lippenslaan 200,2022-12-19,00:00:00,1,1,0,FMN 15 Luitenant Lippenslaan
662,Luitenant Lippenslaan 200,2022-12-19,01:00:00,0,0,0,FMN 15 Luitenant Lippenslaan
662,Luitenant Lippenslaan 200,2022-12-19,02:00:00,1,1,0,FMN 15 Luitenant Lippenslaan
662,Luitenant Lippenslaan 200,2022-12-19,03:00:00,2,2,0,FMN 15 Luitenant Lippenslaan
662,Luitenant Lippenslaan 200,2022-12-19,04:00:00,6,4,2,FMN 15 Luitenant Lippenslaan
662,Luitenant Lippenslaan 200,2022-12-19,05:00:00,9,9,0,FMN 15 Luitenant Lippenslaan
662,Luitenant Lippenslaan 200,2022-12-19,06:00:00,33,29,4,FMN 15 Luitenant Lippenslaan
662,Luitenant Lippenslaan 200,2022-12-19,07:00:00,116,104,12,FMN 15 Luitenant Lippenslaan
662,Luitenant Lippenslaan 200,2022-12-19,08:00:00,238,232,6,FMN 15 Luitenant Lippenslaan
662,Luitenant Lippenslaan 200,2022-12-19,09:00:00,99,89,10,FMN 15 Luitenant Lippenslaan
662,Luitenant Lippenslaan 200,2022-12-19,10:00:00,82,68,14,FMN 15 Luitenant Lippenslaan
662,Luitenant Lippenslaan 200,2022-12-19,11:00:00,50,38,12,FMN 15 Luitenant Lippenslaan
662,Luitenant Lippenslaan 200,2022-12-19,12:00:00,88,70,18,FMN 15 Luitenant Lippenslaan
662,Luitenant Lippenslaan 200,2022-12-19,13:00:00,82,64,18,FMN 15 Luitenant Lippenslaan
662,Luitenant Lippenslaan 200,2022-12-19,14:00:00,65,49,16,FMN 15 Luitenant Lippenslaan
662,Luitenant Lippenslaan 200,2022-12-19,15:00:00,79,55,24,FMN 15 Luitenant Lippenslaan
662,Luitenant Lippenslaan 200,2022-12-19,16:00:00,101,85,16,FMN 15 Luitenant Lippenslaan
662,Luitenant Lippenslaan 200,2022-12-19,17:00:00,107,87,20,FMN 15 Luitenant Lippenslaan
662,Luitenant Lippenslaan 200,2022-12-19,18:00:00,90,74,16,FMN 15 Luitenant Lippenslaan
662,Luitenant Lippenslaan 200,2022-12-19,19:00:00,66,44,22,FMN 15 Luitenant Lippenslaan
662,Luitenant Lippenslaan 200,2022-12-19,20:00:00,52,34,18,FMN 15 Luitenant Lippenslaan
662,Luitenant Lippenslaan 200,2022-12-19,21:00:00,32,22,10,FMN 15 Luitenant Lippenslaan
662,Luitenant Lippenslaan 200,2022-12-19,22:00:00,31,21,10,FMN 15 Luitenant Lippenslaan
662,Luitenant Lippenslaan 200,2022-12-19,23:00:00,17,11,6,FMN 15 Luitenant Lippenslaan
662,Luitenant Lippenslaan 200,2022-12-20,00:00:00,6,4,2,FMN 15 Luitenant Lippenslaan
662,Luitenant Lippenslaan 200,2022-12-20,01:00:00,5,3,2,FMN 15 Luitenant Lippenslaan
662,Luitenant Lippenslaan 200,2022-12-20,02:00:00,5,3,2,FMN 15 Luitenant Lippenslaan
662,Luitenant Lippenslaan 200,2022-12-20,03:00:00,2,2,0,FMN 15 Luitenant Lippenslaan
662,Luitenant Lippenslaan 200,2022-12-20,04:00:00,1,1,0,FMN 15 Luitenant Lippenslaan
662,Luitenant Lippenslaan 200,2022-12-20,05:00:00,12,12,0,FMN 15 Luitenant Lippenslaan
662,Luitenant Lippenslaan 200,2022-12-20,06:00:00,36,32,4,FMN 15 Luitenant Lippenslaan
662,Luitenant Lippenslaan 200,2022-12-20,07:00:00,94,92,2,FMN 15 Luitenant Lippenslaan
662,Luitenant Lippenslaan 200,2022-12-20,08:00:00,192,182,10,FMN 15 Luitenant Lippenslaan
662,Luitenant Lippenslaan 200,2022-12-20,09:00:00,69,63,6,FMN 15 Luitenant Lippenslaan
662,Luitenant Lippenslaan 200,2022-12-20,10:00:00,67,61,6,FMN 15 Luitenant Lippenslaan
662,Luitenant Lippenslaan 200,2022-12-20,11:00:00,42,30,12,FMN 15 Luitenant Lippenslaan
662,Luitenant Lippenslaan 200,2022-12-20,12:00:00,51,39,12,FMN 15 Luitenant Lippenslaan
662,Luitenant Lippenslaan 200,2022-12-20,13:00:00,51,37,14,FMN 15 Luitenant Lippenslaan
662,Luitenant Lippenslaan 200,2022-12-20,14:00:00,26,18,8,FMN 15 Luitenant Lippenslaan
662,Luitenant Lippenslaan 200,2022-12-20,15:00:00,41,27,14,FMN 15 Luitenant Lippenslaan
662,Luitenant Lippenslaan 200,2022-12-20,16:00:00,37,29,8,FMN 15 Luitenant Lippenslaan
662,Luitenant Lippenslaan 200,2022-12-20,17:00:00,48,40,8,FMN 15 Luitenant Lippenslaan
662,Luitenant Lippenslaan 200,2022-12-20,18:00:00,55,47,8,FMN 15 Luitenant Lippenslaan
662,Luitenant Lippenslaan 200,2022-12-20,19:00:00,44,34,10,FMN 15 Luitenant Lippenslaan
662,Luitenant Lippenslaan 200,2022-12-20,20:00:00,17,13,4,FMN 15 Luitenant Lippenslaan
662,Luitenant Lippenslaan 200,2022-12-20,21:00:00,9,3,6,FMN 15 Luitenant Lippenslaan
662,Luitenant Lippenslaan 200,2022-12-20,22:00:00,12,10,2,FMN 15 Luitenant Lippenslaan
662,Luitenant Lippenslaan 200,2022-12-20,23:00:00,11,7,4,FMN 15 Luitenant Lippenslaan
662,Luitenant Lippenslaan 200,2022-12-21,00:00:00,6,4,2,FMN 15 Luitenant Lippenslaan
662,Luitenant Lippenslaan 200,2022-12-21,01:00:00,2,0,2,FMN 15 Luitenant Lippenslaan
662,Luitenant Lippenslaan 200,2022-12-21,02:00:00,4,0,4,FMN 15 Luitenant Lippenslaan
662,Luitenant Lippenslaan 200,2022-12-21,03:00:00,2,2,0,FMN 15 Luitenant Lippenslaan
662,Luitenant Lippenslaan 200,2022-12-21,04:00:00,3,1,2,FMN 15 Luitenant Lippenslaan
662,Luitenant Lippenslaan 200,2022-12-21,05:00:00,11,11,0,FMN 15 Luitenant Lippenslaan
662,Luitenant Lippenslaan 200,2022-12-21,06:00:00,36,30,6,FMN 15 Luitenant Lippenslaan
662,Luitenant Lippenslaan 200,2022-12-21,07:00:00,75,67,8,FMN 15 Luitenant Lippenslaan
662,Luitenant Lippenslaan 200,2022-12-21,08:00:00,110,102,8,FMN 15 Luitenant Lippenslaan
662,Luitenant Lippenslaan 200,2022-12-21,09:00:00,73,65,8,FMN 15 Luitenant Lippenslaan
662,Luitenant Lippenslaan 200,2022-12-21,10:00:00,50,44,6,FMN 15 Luitenant Lippenslaan
662,Luitenant Lippenslaan 200,2022-12-21,11:00:00,64,54,10,FMN 15 Luitenant Lippenslaan
662,Luitenant Lippenslaan 200,2022-12-21,12:00:00,70,62,8,FMN 15 Luitenant Lippenslaan
662,Luitenant Lippenslaan 200,2022-12-21,13:00:00,47,43,4,FMN 15 Luitenant Lippenslaan
662,Luitenant Lippenslaan 200,2022-12-21,14:00:00,51,39,12,FMN 15 Luitenant Lippenslaan
662,Luitenant Lippenslaan 200,2022-12-21,15:00:00,51,45,6,FMN 15 Luitenant Lippenslaan
662,Luitenant Lippenslaan 200,2022-12-21,16:00:00,42,30,12,FMN 15 Luitenant Lippenslaan
662,Luitenant Lippenslaan 200,2022-12-21,17:00:00,48,38,10,FMN 15 Luitenant Lippenslaan
662,Luitenant Lippenslaan 200,2022-12-21,18:00:00,63,50,13,FMN 15 Luitenant Lippenslaan
662,Luitenant Lippenslaan 200,2022-12-21,19:00:00,48,40,8,FMN 15 Luitenant Lippenslaan
662,Luitenant Lippenslaan 200,2022-12-21,20:00:00,26,24,2,FMN 15 Luitenant Lippenslaan
662,Luitenant Lippenslaan 200,2022-12-21,21:00:00,25,13,12,FMN 15 Luitenant Lippenslaan
662,Luitenant Lippenslaan 200,2022-12-21,22:00:00,23,13,10,FMN 15 Luitenant Lippenslaan
662,Luitenant Lippenslaan 200,2022-12-21,23:00:00,10,6,4,FMN 15 Luitenant Lippenslaan
662,Luitenant Lippenslaan 200,2022-12-22,00:00:00,12,6,6,FMN 15 Luitenant Lippenslaan
662,Luitenant Lippenslaan 200,2022-12-22,01:00:00,6,2,4,FMN 15 Luitenant Lippenslaan
662,Luitenant Lippenslaan 200,2022-12-22,02:00:00,3,1,2,FMN 15 Luitenant Lippenslaan
662,Luitenant Lippenslaan 200,2022-12-22,03:00:00,4,2,2,FMN 15 Luitenant Lippenslaan
662,Luitenant Lippenslaan 200,2022-12-22,04:00:00,6,4,2,FMN 15 Luitenant Lippenslaan
662,Luitenant Lippenslaan 200,2022-12-22,05:00:00,13,13,0,FMN 15 Luitenant Lippenslaan
662,Luitenant Lippenslaan 200,2022-12-22,06:00:00,32,28,4,FMN 15 Luitenant Lippenslaan
662,Luitenant Lippenslaan 200,2022-12-22,07:00:00,84,76,8,FMN 15 Luitenant Lippenslaan
662,Luitenant Lippenslaan 200,2022-12-22,08:00:00,173,151,22,FMN 15 Luitenant Lippenslaan
662,Luitenant Lippenslaan 200,2022-12-22,09:00:00,84,80,4,FMN 15 Luitenant Lippenslaan
662,Luitenant Lippenslaan 200,2022-12-22,10:00:00,69,65,4,FMN 15 Luitenant Lippenslaan
662,Luitenant Lippenslaan 200,2022-12-22,11:00:00,69,59,10,FMN 15 Luitenant Lippenslaan
662,Luitenant Lippenslaan 200,2022-12-22,12:00:00,72,62,10,FMN 15 Luitenant Lippenslaan
662,Luitenant Lippenslaan 200,2022-12-22,13:00:00,67,59,8,FMN 15 Luitenant Lippenslaan
662,Luitenant Lippenslaan 200,2022-12-22,14:00:00,54,38,16,FMN 15 Luitenant Lippenslaan
662,Luitenant Lippenslaan 200,2022-12-22,15:00:00,46,34,12,FMN 15 Luitenant Lippenslaan
662,Luitenant Lippenslaan 200,2022-12-22,16:00:00,58,50,8,FMN 15 Luitenant Lippenslaan
662,Luitenant Lippenslaan 200,2022-12-22,17:00:00,90,76,14,FMN 15 Luitenant Lippenslaan
662,Luitenant Lippenslaan 200,2022-12-22,18:00:00,97,81,16,FMN 15 Luitenant Lippenslaan
662,Luitenant Lippenslaan 200,2022-12-22,19:00:00,62,54,8,FMN 15 Luitenant Lippenslaan
662,Luitenant Lippenslaan 200,2022-12-22,20:00:00,36,20,16,FMN 15 Luitenant Lippenslaan
662,Luitenant Lippenslaan 200,2022-12-22,21:00:00,29,21,8,FMN 15 Luitenant Lippenslaan
662,Luitenant Lippenslaan 200,2022-12-22,22:00:00,21,9,12,FMN 15 Luitenant Lippenslaan
662,Luitenant Lippenslaan 200,2022-12-22,23:00:00,7,1,6,FMN 15 Luitenant Lippenslaan
662,Luitenant Lippenslaan 200,2022-12-23,00:00:00,6,6,0,FMN 15 Luitenant Lippenslaan
662,Luitenant Lippenslaan 200,2022-12-23,01:00:00,4,0,4,FMN 15 Luitenant Lippenslaan
662,Luitenant Lippenslaan 200,2022-12-23,02:00:00,6,2,4,FMN 15 Luitenant Lippenslaan
662,Luitenant Lippenslaan 200,2022-12-23,03:00:00,4,4,0,FMN 15 Luitenant Lippenslaan
662,Luitenant Lippenslaan 200,2022-12-23,04:00:00,7,5,2,FMN 15 Luitenant Lippenslaan
662,Luitenant Lippenslaan 200,2022-12-23,05:00:00,8,8,0,FMN 15 Luitenant Lippenslaan
662,Luitenant Lippenslaan 200,2022-12-23,06:00:00,18,16,2,FMN 15 Luitenant Lippenslaan
662,Luitenant Lippenslaan 200,2022-12-23,07:00:00,80,66,14,FMN 15 Luitenant Lippenslaan
662,Luitenant Lippenslaan 200,2022-12-23,08:00:00,145,138,7,FMN 15 Luitenant Lippenslaan
662,Luitenant Lippenslaan 200,2022-12-23,09:00:00,73,67,6,FMN 15 Luitenant Lippenslaan
662,Luitenant Lippenslaan 200,2022-12-23,10:00:00,45,39,6,FMN 15 Luitenant Lippenslaan
662,Luitenant Lippenslaan 200,2022-12-23,11:00:00,40,30,10,FMN 15 Luitenant Lippenslaan
662,Luitenant Lippenslaan 200,2022-12-23,12:00:00,47,29,18,FMN 15 Luitenant Lippenslaan
662,Luitenant Lippenslaan 200,2022-12-23,13:00:00,27,25,2,FMN 15 Luitenant Lippenslaan
662,Luitenant Lippenslaan 200,2022-12-23,14:00:00,54,44,10,FMN 15 Luitenant Lippenslaan
662,Luitenant Lippenslaan 200,2022-12-23,15:00:00,59,49,10,FMN 15 Luitenant Lippenslaan
662,Luitenant Lippenslaan 200,2022-12-23,16:00:00,85,55,30,FMN 15 Luitenant Lippenslaan
662,Luitenant Lippenslaan 200,2022-12-23,17:00:00,85,69,16,FMN 15 Luitenant Lippenslaan
662,Luitenant Lippenslaan 200,2022-12-23,18:00:00,87,61,26,FMN 15 Luitenant Lippenslaan
662,Luitenant Lippenslaan 200,2022-12-23,19:00:00,81,73,8,FMN 15 Luitenant Lippenslaan
662,Luitenant Lippenslaan 200,2022-12-23,20:00:00,53,37,16,FMN 15 Luitenant Lippenslaan
662,Luitenant Lippenslaan 200,2022-12-23,21:00:00,38,28,10,FMN 15 Luitenant Lippenslaan
662,Luitenant Lippenslaan 200,2022-12-23,22:00:00,17,11,6,FMN 15 Luitenant Lippenslaan
662,Luitenant Lippenslaan 200,2022-12-23,23:00:00,15,3,12,FMN 15 Luitenant Lippenslaan
662,Luitenant Lippenslaan 200,2022-12-24,00:00:00,19,13,6,FMN 15 Luitenant Lippenslaan
662,Luitenant Lippenslaan 200,2022-12-24,01:00:00,16,6,10,FMN 15 Luitenant Lippenslaan
662,Luitenant Lippenslaan 200,2022-12-24,02:00:00,7,7,0,FMN 15 Luitenant Lippenslaan
662,Luitenant Lippenslaan 200,2022-12-24,03:00:00,4,4,0,FMN 15 Luitenant Lippenslaan
662,Luitenant Lippenslaan 200,2022-12-24,04:00:00,7,5,2,FMN 15 Luitenant Lippenslaan
662,Luitenant Lippenslaan 200,2022-12-24,05:00:00,5,5,0,FMN 15 Luitenant Lippenslaan
662,Luitenant Lippenslaan 200,2022-12-24,06:00:00,7,5,2,FMN 15 Luitenant Lippenslaan
662,Luitenant Lippenslaan 200,2022-12-24,07:00:00,11,9,2,FMN 15 Luitenant Lippenslaan
662,Luitenant Lippenslaan 200,2022-12-24,08:00:00,19,15,4,FMN 15 Luitenant Lippenslaan
662,Luitenant Lippenslaan 200,2022-12-24,09:00:00,27,25,2,FMN 15 Luitenant Lippenslaan
662,Luitenant Lippenslaan 200,2022-12-24,10:00:00,58,48,10,FMN 15 Luitenant Lippenslaan
662,Luitenant Lippenslaan 200,2022-12-24,11:00:00,48,42,6,FMN 15 Luitenant Lippenslaan
662,Luitenant Lippenslaan 200,2022-12-24,12:00:00,71,55,16,FMN 15 Luitenant Lippenslaan
662,Luitenant Lippenslaan 200,2022-12-24,13:00:00,75,65,10,FMN 15 Luitenant Lippenslaan
662,Luitenant Lippenslaan 200,2022-12-24,14:00:00,45,39,6,FMN 15 Luitenant Lippenslaan
662,Luitenant Lippenslaan 200,2022-12-24,15:00:00,57,43,14,FMN 15 Luitenant Lippenslaan
662,Luitenant Lippenslaan 200,2022-12-24,16:00:00,42,32,10,FMN 15 Luitenant Lippenslaan
662,Luitenant Lippenslaan 200,2022-12-24,17:00:00,42,20,22,FMN 15 Luitenant Lippenslaan
662,Luitenant Lippenslaan 200,2022-12-24,18:00:00,28,18,10,FMN 15 Luitenant Lippenslaan
662,Luitenant Lippenslaan 200,2022-12-24,19:00:00,24,18,6,FMN 15 Luitenant Lippenslaan
662,Luitenant Lippenslaan 200,2022-12-24,20:00:00,22,14,8,FMN 15 Luitenant Lippenslaan
662,Luitenant Lippenslaan 200,2022-12-24,21:00:00,12,6,6,FMN 15 Luitenant Lippenslaan
662,Luitenant Lippenslaan 200,2022-12-24,22:00:00,17,13,4,FMN 15 Luitenant Lippenslaan
662,Luitenant Lippenslaan 200,2022-12-24,23:00:00,20,14,6,FMN 15 Luitenant Lippenslaan
662,Luitenant Lippenslaan 200,2022-12-25,00:00:00,15,9,6,FMN 15 Luitenant Lippenslaan
662,Luitenant Lippenslaan 200,2022-12-25,01:00:00,12,12,0,FMN 15 Luitenant Lippenslaan
662,Luitenant Lippenslaan 200,2022-12-25,02:00:00,3,1,2,FMN 15 Luitenant Lippenslaan
662,Luitenant Lippenslaan 200,2022-12-25,03:00:00,5,5,0,FMN 15 Luitenant Lippenslaan
662,Luitenant Lippenslaan 200,2022-12-25,04:00:00,3,1,2,FMN 15 Luitenant Lippenslaan
662,Luitenant Lippenslaan 200,2022-12-25,05:00:00,3,1,2,FMN 15 Luitenant Lippenslaan
662,Luitenant Lippenslaan 200,2022-12-25,06:00:00,9,5,4,FMN 15 Luitenant Lippenslaan
662,Luitenant Lippenslaan 200,2022-12-25,07:00:00,5,5,0,FMN 15 Luitenant Lippenslaan
662,Luitenant Lippenslaan 200,2022-12-25,08:00:00,8,4,4,FMN 15 Luitenant Lippenslaan
662,Luitenant Lippenslaan 200,2022-12-25,09:00:00,16,10,6,FMN 15 Luitenant Lippenslaan
662,Luitenant Lippenslaan 200,2022-12-25,10:00:00,8,8,0,FMN 15 Luitenant Lippenslaan
662,Luitenant Lippenslaan 200,2022-12-25,11:00:00,23,15,8,FMN 15 Luitenant Lippenslaan
662,Luitenant Lippenslaan 200,2022-12-25,12:00:00,23,17,6,FMN 15 Luitenant Lippenslaan
662,Luitenant Lippenslaan 200,2022-12-25,13:00:00,27,15,12,FMN 15 Luitenant Lippenslaan
662,Luitenant Lippenslaan 200,2022-12-25,14:00:00,26,16,10,FMN 15 Luitenant Lippenslaan
662,Luitenant Lippenslaan 200,2022-12-25,15:00:00,21,13,8,FMN 15 Luitenant Lippenslaan
662,Luitenant Lippenslaan 200,2022-12-25,16:00:00,12,12,0,FMN 15 Luitenant Lippenslaan
662,Luitenant Lippenslaan 200,2022-12-25,17:00:00,24,18,6,FMN 15 Luitenant Lippenslaan
662,Luitenant Lippenslaan 200,2022-12-25,18:00:00,20,12,8,FMN 15 Luitenant Lippenslaan
662,Luitenant Lippenslaan 200,2022-12-25,19:00:00,26,24,2,FMN 15 Luitenant Lippenslaan
662,Luitenant Lippenslaan 200,2022-12-25,20:00:00,17,13,4,FMN 15 Luitenant Lippenslaan
662,Luitenant Lippenslaan 200,2022-12-25,21:00:00,10,6,4,FMN 15 Luitenant Lippenslaan
662,Luitenant Lippenslaan 200,2022-12-25,22:00:00,14,10,4,FMN 15 Luitenant Lippenslaan
662,Luitenant Lippenslaan 200,2022-12-25,23:00:00,8,6,2,FMN 15 Luitenant Lippenslaan
662,Luitenant Lippenslaan 200,2022-12-26,00:00:00,5,1,4,FMN 15 Luitenant Lippenslaan
662,Luitenant Lippenslaan 200,2022-12-26,01:00:00,5,1,4,FMN 15 Luitenant Lippenslaan
662,Luitenant Lippenslaan 200,2022-12-26,02:00:00,2,2,0,FMN 15 Luitenant Lippenslaan
662,Luitenant Lippenslaan 200,2022-12-26,03:00:00,3,1,2,FMN 15 Luitenant Lippenslaan
662,Luitenant Lippenslaan 200,2022-12-26,04:00:00,1,1,0,FMN 15 Luitenant Lippenslaan
662,Luitenant Lippenslaan 200,2022-12-26,05:00:00,9,7,2,FMN 15 Luitenant Lippenslaan
662,Luitenant Lippenslaan 200,2022-12-26,06:00:00,13,11,2,FMN 15 Luitenant Lippenslaan
662,Luitenant Lippenslaan 200,2022-12-26,07:00:00,17,17,0,FMN 15 Luitenant Lippenslaan
662,Luitenant Lippenslaan 200,2022-12-26,08:00:00,17,17,0,FMN 15 Luitenant Lippenslaan
662,Luitenant Lippenslaan 200,2022-12-26,09:00:00,33,29,4,FMN 15 Luitenant Lippenslaan
662,Luitenant Lippenslaan 200,2022-12-26,10:00:00,38,30,8,FMN 15 Luitenant Lippenslaan
662,Luitenant Lippenslaan 200,2022-12-26,11:00:00,21,21,0,FMN 15 Luitenant Lippenslaan
662,Luitenant Lippenslaan 200,2022-12-26,12:00:00,45,41,4,FMN 15 Luitenant Lippenslaan
662,Luitenant Lippenslaan 200,2022-12-26,13:00:00,33,21,12,FMN 15 Luitenant Lippenslaan
662,Luitenant Lippenslaan 200,2022-12-26,14:00:00,33,21,12,FMN 15 Luitenant Lippenslaan
662,Luitenant Lippenslaan 200,2022-12-26,15:00:00,25,19,6,FMN 15 Luitenant Lippenslaan
662,Luitenant Lippenslaan 200,2022-12-26,16:00:00,40,36,4,FMN 15 Luitenant Lippenslaan
662,Luitenant Lippenslaan 200,2022-12-26,17:00:00,35,17,18,FMN 15 Luitenant Lippenslaan
662,Luitenant Lippenslaan 200,2022-12-26,18:00:00,24,16,8,FMN 15 Luitenant Lippenslaan
662,Luitenant Lippenslaan 200,2022-12-26,19:00:00,23,15,8,FMN 15 Luitenant Lippenslaan
662,Luitenant Lippenslaan 200,2022-12-26,20:00:00,17,11,6,FMN 15 Luitenant Lippenslaan
662,Luitenant Lippenslaan 200,2022-12-26,21:00:00,9,9,0,FMN 15 Luitenant Lippenslaan
662,Luitenant Lippenslaan 200,2022-12-26,22:00:00,8,2,6,FMN 15 Luitenant Lippenslaan
662,Luitenant Lippenslaan 200,2022-12-26,23:00:00,5,3,2,FMN 15 Luitenant Lippenslaan
662,Luitenant Lippenslaan 200,2022-12-27,00:00:00,2,0,2,FMN 15 Luitenant Lippenslaan
662,Luitenant Lippenslaan 200,2022-12-27,01:00:00,8,4,4,FMN 15 Luitenant Lippenslaan
662,Luitenant Lippenslaan 200,2022-12-27,02:00:00,8,2,6,FMN 15 Luitenant Lippenslaan
662,Luitenant Lippenslaan 200,2022-12-27,03:00:00,0,0,0,FMN 15 Luitenant Lippenslaan
662,Luitenant Lippenslaan 200,2022-12-27,04:00:00,4,2,2,FMN 15 Luitenant Lippenslaan
662,Luitenant Lippenslaan 200,2022-12-27,05:00:00,6,6,0,FMN 15 Luitenant Lippenslaan
662,Luitenant Lippenslaan 200,2022-12-27,06:00:00,17,13,4,FMN 15 Luitenant Lippenslaan
662,Luitenant Lippenslaan 200,2022-12-27,07:00:00,52,44,8,FMN 15 Luitenant Lippenslaan
662,Luitenant Lippenslaan 200,2022-12-27,08:00:00,55,49,6,FMN 15 Luitenant Lippenslaan
662,Luitenant Lippenslaan 200,2022-12-27,09:00:00,62,50,12,FMN 15 Luitenant Lippenslaan
662,Luitenant Lippenslaan 200,2022-12-27,10:00:00,60,56,4,FMN 15 Luitenant Lippenslaan
662,Luitenant Lippenslaan 200,2022-12-27,11:00:00,78,64,14,FMN 15 Luitenant Lippenslaan
662,Luitenant Lippenslaan 200,2022-12-27,12:00:00,99,85,14,FMN 15 Luitenant Lippenslaan
662,Luitenant Lippenslaan 200,2022-12-27,13:00:00,57,49,8,FMN 15 Luitenant Lippenslaan
662,Luitenant Lippenslaan 200,2022-12-27,14:00:00,80,58,22,FMN 15 Luitenant Lippenslaan
662,Luitenant Lippenslaan 200,2022-12-27,15:00:00,80,64,16,FMN 15 Luitenant Lippenslaan
662,Luitenant Lippenslaan 200,2022-12-27,16:00:00,95,77,18,FMN 15 Luitenant Lippenslaan
662,Luitenant Lippenslaan 200,2022-12-27,17:00:00,85,54,31,FMN 15 Luitenant Lippenslaan
662,Luitenant Lippenslaan 200,2022-12-27,18:00:00,97,73,24,FMN 15 Luitenant Lippenslaan
662,Luitenant Lippenslaan 200,2022-12-27,19:00:00,79,65,14,FMN 15 Luitenant Lippenslaan
662,Luitenant Lippenslaan 200,2022-12-27,20:00:00,31,27,4,FMN 15 Luitenant Lippenslaan
662,Luitenant Lippenslaan 200,2022-12-27,21:00:00,31,15,16,FMN 15 Luitenant Lippenslaan
662,Luitenant Lippenslaan 200,2022-12-27,22:00:00,22,12,10,FMN 15 Luitenant Lippenslaan
662,Luitenant Lippenslaan 200,2022-12-27,23:00:00,19,11,8,FMN 15 Luitenant Lippenslaan
662,Luitenant Lippenslaan 200,2022-12-28,00:00:00,8,4,4,FMN 15 Luitenant Lippenslaan
662,Luitenant Lippenslaan 200,2022-12-28,01:00:00,11,5,6,FMN 15 Luitenant Lippenslaan
662,Luitenant Lippenslaan 200,2022-12-28,02:00:00,2,0,2,FMN 15 Luitenant Lippenslaan
662,Luitenant Lippenslaan 200,2022-12-28,03:00:00,4,2,2,FMN 15 Luitenant Lippenslaan
662,Luitenant Lippenslaan 200,2022-12-28,04:00:00,7,7,0,FMN 15 Luitenant Lippenslaan
662,Luitenant Lippenslaan 200,2022-12-28,05:00:00,12,8,4,FMN 15 Luitenant Lippenslaan
662,Luitenant Lippenslaan 200,2022-12-28,06:00:00,18,14,4,FMN 15 Luitenant Lippenslaan
662,Luitenant Lippenslaan 200,2022-12-28,07:00:00,51,43,8,FMN 15 Luitenant Lippenslaan
662,Luitenant Lippenslaan 200,2022-12-28,08:00:00,77,71,6,FMN 15 Luitenant Lippenslaan
662,Luitenant Lippenslaan 200,2022-12-28,09:00:00,51,51,0,FMN 15 Luitenant Lippenslaan
662,Luitenant Lippenslaan 200,2022-12-28,10:00:00,51,37,14,FMN 15 Luitenant Lippenslaan
662,Luitenant Lippenslaan 200,2022-12-28,11:00:00,42,38,4,FMN 15 Luitenant Lippenslaan
662,Luitenant Lippenslaan 200,2022-12-28,12:00:00,54,46,8,FMN 15 Luitenant Lippenslaan
662,Luitenant Lippenslaan 200,2022-12-28,13:00:00,51,43,8,FMN 15 Luitenant Lippenslaan
662,Luitenant Lippenslaan 200,2022-12-28,14:00:00,72,58,14,FMN 15 Luitenant Lippenslaan
662,Luitenant Lippenslaan 200,2022-12-28,15:00:00,38,36,2,FMN 15 Luitenant Lippenslaan
662,Luitenant Lippenslaan 200,2022-12-28,16:00:00,78,66,12,FMN 15 Luitenant Lippenslaan
662,Luitenant Lippenslaan 200,2022-12-28,17:00:00,45,33,12,FMN 15 Luitenant Lippenslaan
662,Luitenant Lippenslaan 200,2022-12-28,18:00:00,77,49,28,FMN 15 Luitenant Lippenslaan
662,Luitenant Lippenslaan 200,2022-12-28,19:00:00,59,45,14,FMN 15 Luitenant Lippenslaan
662,Luitenant Lippenslaan 200,2022-12-28,20:00:00,38,26,12,FMN 15 Luitenant Lippenslaan
662,Luitenant Lippenslaan 200,2022-12-28,21:00:00,30,16,14,FMN 15 Luitenant Lippenslaan
662,Luitenant Lippenslaan 200,2022-12-28,22:00:00,16,12,4,FMN 15 Luitenant Lippenslaan
662,Luitenant Lippenslaan 200,2022-12-28,23:00:00,12,8,4,FMN 15 Luitenant Lippenslaan
662,Luitenant Lippenslaan 200,2022-12-29,00:00:00,5,5,0,FMN 15 Luitenant Lippenslaan
662,Luitenant Lippenslaan 200,2022-12-29,01:00:00,7,3,4,FMN 15 Luitenant Lippenslaan
662,Luitenant Lippenslaan 200,2022-12-29,02:00:00,7,1,6,FMN 15 Luitenant Lippenslaan
662,Luitenant Lippenslaan 200,2022-12-29,03:00:00,3,1,2,FMN 15 Luitenant Lippenslaan
662,Luitenant Lippenslaan 200,2022-12-29,04:00:00,3,3,0,FMN 15 Luitenant Lippenslaan
662,Luitenant Lippenslaan 200,2022-12-29,05:00:00,7,7,0,FMN 15 Luitenant Lippenslaan
662,Luitenant Lippenslaan 200,2022-12-29,06:00:00,19,13,6,FMN 15 Luitenant Lippenslaan
662,Luitenant Lippenslaan 200,2022-12-29,07:00:00,38,34,4,FMN 15 Luitenant Lippenslaan
662,Luitenant Lippenslaan 200,2022-12-29,08:00:00,47,39,8,FMN 15 Luitenant Lippenslaan
662,Luitenant Lippenslaan 200,2022-12-29,09:00:00,34,28,6,FMN 15 Luitenant Lippenslaan
662,Luitenant Lippenslaan 200,2022-12-29,10:00:00,40,36,4,FMN 15 Luitenant Lippenslaan
662,Luitenant Lippenslaan 200,2022-12-29,11:00:00,43,37,6,FMN 15 Luitenant Lippenslaan
662,Luitenant Lippenslaan 200,2022-12-29,12:00:00,45,37,8,FMN 15 Luitenant Lippenslaan
662,Luitenant Lippenslaan 200,2022-12-29,13:00:00,34,28,6,FMN 15 Luitenant Lippenslaan
662,Luitenant Lippenslaan 200,2022-12-29,14:00:00,34,30,4,FMN 15 Luitenant Lippenslaan
662,Luitenant Lippenslaan 200,2022-12-29,15:00:00,29,25,4,FMN 15 Luitenant Lippenslaan
662,Luitenant Lippenslaan 200,2022-12-29,16:00:00,26,22,4,FMN 15 Luitenant Lippenslaan
662,Luitenant Lippenslaan 200,2022-12-29,17:00:00,47,33,14,FMN 15 Luitenant Lippenslaan
662,Luitenant Lippenslaan 200,2022-12-29,18:00:00,38,26,12,FMN 15 Luitenant Lippenslaan
662,Luitenant Lippenslaan 200,2022-12-29,19:00:00,43,33,10,FMN 15 Luitenant Lippenslaan
662,Luitenant Lippenslaan 200,2022-12-29,20:00:00,31,21,10,FMN 15 Luitenant Lippenslaan
662,Luitenant Lippenslaan 200,2022-12-29,21:00:00,21,15,6,FMN 15 Luitenant Lippenslaan
662,Luitenant Lippenslaan 200,2022-12-29,22:00:00,17,9,8,FMN 15 Luitenant Lippenslaan
662,Luitenant Lippenslaan 200,2022-12-29,23:00:00,15,9,6,FMN 15 Luitenant Lippenslaan
662,Luitenant Lippenslaan 200,2022-12-30,00:00:00,13,9,4,FMN 15 Luitenant Lippenslaan
662,Luitenant Lippenslaan 200,2022-12-30,01:00:00,4,2,2,FMN 15 Luitenant Lippenslaan
662,Luitenant Lippenslaan 200,2022-12-30,02:00:00,5,1,4,FMN 15 Luitenant Lippenslaan
662,Luitenant Lippenslaan 200,2022-12-30,03:00:00,0,0,0,FMN 15 Luitenant Lippenslaan
662,Luitenant Lippenslaan 200,2022-12-30,04:00:00,4,2,2,FMN 15 Luitenant Lippenslaan
662,Luitenant Lippenslaan 200,2022-12-30,05:00:00,12,10,2,FMN 15 Luitenant Lippenslaan
662,Luitenant Lippenslaan 200,2022-12-30,06:00:00,19,13,6,FMN 15 Luitenant Lippenslaan
662,Luitenant Lippenslaan 200,2022-12-30,07:00:00,35,33,2,FMN 15 Luitenant Lippenslaan
662,Luitenant Lippenslaan 200,2022-12-30,08:00:00,56,50,6,FMN 15 Luitenant Lippenslaan
662,Luitenant Lippenslaan 200,2022-12-30,09:00:00,62,58,4,FMN 15 Luitenant Lippenslaan
662,Luitenant Lippenslaan 200,2022-12-30,10:00:00,51,47,4,FMN 15 Luitenant Lippenslaan
662,Luitenant Lippenslaan 200,2022-12-30,11:00:00,53,49,4,FMN 15 Luitenant Lippenslaan
662,Luitenant Lippenslaan 200,2022-12-30,12:00:00,53,39,14,FMN 15 Luitenant Lippenslaan
662,Luitenant Lippenslaan 200,2022-12-30,13:00:00,48,32,16,FMN 15 Luitenant Lippenslaan
662,Luitenant Lippenslaan 200,2022-12-30,14:00:00,42,32,10,FMN 15 Luitenant Lippenslaan
662,Luitenant Lippenslaan 200,2022-12-30,15:00:00,60,54,6,FMN 15 Luitenant Lippenslaan
662,Luitenant Lippenslaan 200,2022-12-30,16:00:00,59,49,10,FMN 15 Luitenant Lippenslaan
662,Luitenant Lippenslaan 200,2022-12-30,17:00:00,90,74,16,FMN 15 Luitenant Lippenslaan
662,Luitenant Lippenslaan 200,2022-12-30,18:00:00,87,65,22,FMN 15 Luitenant Lippenslaan
662,Luitenant Lippenslaan 200,2022-12-30,19:00:00,89,53,36,FMN 15 Luitenant Lippenslaan
662,Luitenant Lippenslaan 200,2022-12-30,20:00:00,64,48,16,FMN 15 Luitenant Lippenslaan
662,Luitenant Lippenslaan 200,2022-12-30,21:00:00,51,27,24,FMN 15 Luitenant Lippenslaan
662,Luitenant Lippenslaan 200,2022-12-30,22:00:00,23,13,10,FMN 15 Luitenant Lippenslaan
662,Luitenant Lippenslaan 200,2022-12-30,23:00:00,21,13,8,FMN 15 Luitenant Lippenslaan
662,Luitenant Lippenslaan 200,2022-12-31,00:00:00,15,11,4,FMN 15 Luitenant Lippenslaan
662,Luitenant Lippenslaan 200,2022-12-31,01:00:00,9,7,2,FMN 15 Luitenant Lippenslaan
662,Luitenant Lippenslaan 200,2022-12-31,02:00:00,5,5,0,FMN 15 Luitenant Lippenslaan
662,Luitenant Lippenslaan 200,2022-12-31,03:00:00,3,1,2,FMN 15 Luitenant Lippenslaan
662,Luitenant Lippenslaan 200,2022-12-31,04:00:00,4,2,2,FMN 15 Luitenant Lippenslaan
662,Luitenant Lippenslaan 200,2022-12-31,05:00:00,9,5,4,FMN 15 Luitenant Lippenslaan
662,Luitenant Lippenslaan 200,2022-12-31,06:00:00,7,5,2,FMN 15 Luitenant Lippenslaan
662,Luitenant Lippenslaan 200,2022-12-31,07:00:00,13,11,2,FMN 15 Luitenant Lippenslaan
662,Luitenant Lippenslaan 200,2022-12-31,08:00:00,11,9,2,FMN 15 Luitenant Lippenslaan
662,Luitenant Lippenslaan 200,2022-12-31,09:00:00,30,24,6,FMN 15 Luitenant Lippenslaan
662,Luitenant Lippenslaan 200,2022-12-31,10:00:00,47,39,8,FMN 15 Luitenant Lippenslaan
662,Luitenant Lippenslaan 200,2022-12-31,11:00:00,65,59,6,FMN 15 Luitenant Lippenslaan
662,Luitenant Lippenslaan 200,2022-12-31,12:00:00,38,32,6,FMN 15 Luitenant Lippenslaan
662,Luitenant Lippenslaan 200,2022-12-31,13:00:00,49,45,4,FMN 15 Luitenant Lippenslaan
662,Luitenant Lippenslaan 200,2022-12-31,14:00:00,47,39,8,FMN 15 Luitenant Lippenslaan
662,Luitenant Lippenslaan 200,2022-12-31,15:00:00,49,35,14,FMN 15 Luitenant Lippenslaan
662,Luitenant Lippenslaan 200,2022-12-31,16:00:00,62,42,20,FMN 15 Luitenant Lippenslaan
662,Luitenant Lippenslaan 200,2022-12-31,17:00:00,80,54,26,FMN 15 Luitenant Lippenslaan
662,Luitenant Lippenslaan 200,2022-12-31,18:00:00,106,86,20,FMN 15 Luitenant Lippenslaan
662,Luitenant Lippenslaan 200,2022-12-31,19:00:00,60,44,16,FMN 15 Luitenant Lippenslaan
662,Luitenant Lippenslaan 200,2022-12-31,20:00:00,42,30,12,FMN 15 Luitenant Lippenslaan
662,Luitenant Lippenslaan 200,2022-12-31,21:00:00,20,18,2,FMN 15 Luitenant Lippenslaan
662,Luitenant Lippenslaan 200,2022-12-31,22:00:00,42,24,18,FMN 15 Luitenant Lippenslaan
662,Luitenant Lippenslaan 200,2022-12-31,23:00:00,60,50,10,FMN 15 Luitenant Lippenslaan
662,Luitenant Lippenslaan 200,2023-01-01,00:00:00,32,14,18,FMN 15 Luitenant Lippenslaan
662,Luitenant Lippenslaan 200,2023-01-01,01:00:00,50,38,12,FMN 15 Luitenant Lippenslaan
662,Luitenant Lippenslaan 200,2023-01-01,02:00:00,49,25,24,FMN 15 Luitenant Lippenslaan
662,Luitenant Lippenslaan 200,2023-01-01,03:00:00,26,16,10,FMN 15 Luitenant Lippenslaan
662,Luitenant Lippenslaan 200,2023-01-01,04:00:00,17,9,8,FMN 15 Luitenant Lippenslaan
662,Luitenant Lippenslaan 200,2023-01-01,05:00:00,15,3,12,FMN 15 Luitenant Lippenslaan
662,Luitenant Lippenslaan 200,2023-01-01,06:00:00,6,4,2,FMN 15 Luitenant Lippenslaan
662,Luitenant Lippenslaan 200,2023-01-01,07:00:00,8,4,4,FMN 15 Luitenant Lippenslaan
662,Luitenant Lippenslaan 200,2023-01-01,08:00:00,2,2,0,FMN 15 Luitenant Lippenslaan
662,Luitenant Lippenslaan 200,2023-01-01,09:00:00,9,7,2,FMN 15 Luitenant Lippenslaan
662,Luitenant Lippenslaan 200,2023-01-01,10:00:00,17,13,4,FMN 15 Luitenant Lippenslaan
662,Luitenant Lippenslaan 200,2023-01-01,11:00:00,22,12,10,FMN 15 Luitenant Lippenslaan
662,Luitenant Lippenslaan 200,2023-01-01,12:00:00,29,17,12,FMN 15 Luitenant Lippenslaan
662,Luitenant Lippenslaan 200,2023-01-01,13:00:00,36,32,4,FMN 15 Luitenant Lippenslaan
662,Luitenant Lippenslaan 200,2023-01-01,14:00:00,27,25,2,FMN 15 Luitenant Lippenslaan
662,Luitenant Lippenslaan 200,2023-01-01,15:00:00,40,26,14,FMN 15 Luitenant Lippenslaan
662,Luitenant Lippenslaan 200,2023-01-01,16:00:00,46,24,22,FMN 15 Luitenant Lippenslaan
662,Luitenant Lippenslaan 200,2023-01-01,17:00:00,45,27,18,FMN 15 Luitenant Lippenslaan
662,Luitenant Lippenslaan 200,2023-01-01,18:00:00,25,15,10,FMN 15 Luitenant Lippenslaan
662,Luitenant Lippenslaan 200,2023-01-01,19:00:00,25,17,8,FMN 15 Luitenant Lippenslaan
662,Luitenant Lippenslaan 200,2023-01-01,20:00:00,25,23,2,FMN 15 Luitenant Lippenslaan
662,Luitenant Lippenslaan 200,2023-01-01,21:00:00,21,17,4,FMN 15 Luitenant Lippenslaan
662,Luitenant Lippenslaan 200,2023-01-01,22:00:00,18,8,10,FMN 15 Luitenant Lippenslaan
662,Luitenant Lippenslaan 200,2023-01-01,23:00:00,17,9,8,FMN 15 Luitenant Lippenslaan
662,Luitenant Lippenslaan 200,2023-01-02,00:00:00,4,4,0,FMN 15 Luitenant Lippenslaan
662,Luitenant Lippenslaan 200,2023-01-02,01:00:00,6,0,6,FMN 15 Luitenant Lippenslaan
662,Luitenant Lippenslaan 200,2023-01-02,02:00:00,7,1,6,FMN 15 Luitenant Lippenslaan
662,Luitenant Lippenslaan 200,2023-01-02,03:00:00,8,4,4,FMN 15 Luitenant Lippenslaan
662,Luitenant Lippenslaan 200,2023-01-02,04:00:00,5,3,2,FMN 15 Luitenant Lippenslaan
662,Luitenant Lippenslaan 200,2023-01-02,05:00:00,6,2,4,FMN 15 Luitenant Lippenslaan
662,Luitenant Lippenslaan 200,2023-01-02,06:00:00,24,20,4,FMN 15 Luitenant Lippenslaan
662,Luitenant Lippenslaan 200,2023-01-02,07:00:00,43,37,6,FMN 15 Luitenant Lippenslaan
662,Luitenant Lippenslaan 200,2023-01-02,08:00:00,68,62,6,FMN 15 Luitenant Lippenslaan
662,Luitenant Lippenslaan 200,2023-01-02,09:00:00,33,29,4,FMN 15 Luitenant Lippenslaan
662,Luitenant Lippenslaan 200,2023-01-02,10:00:00,32,30,2,FMN 15 Luitenant Lippenslaan
662,Luitenant Lippenslaan 200,2023-01-02,11:00:00,34,26,8,FMN 15 Luitenant Lippenslaan
662,Luitenant Lippenslaan 200,2023-01-02,12:00:00,60,48,12,FMN 15 Luitenant Lippenslaan
662,Luitenant Lippenslaan 200,2023-01-02,13:00:00,40,32,8,FMN 15 Luitenant Lippenslaan
662,Luitenant Lippenslaan 200,2023-01-02,14:00:00,33,29,4,FMN 15 Luitenant Lippenslaan
662,Luitenant Lippenslaan 200,2023-01-02,15:00:00,41,25,16,FMN 15 Luitenant Lippenslaan
662,Luitenant Lippenslaan 200,2023-01-02,16:00:00,26,22,4,FMN 15 Luitenant Lippenslaan
662,Luitenant Lippenslaan 200,2023-01-02,17:00:00,46,36,10,FMN 15 Luitenant Lippenslaan
662,Luitenant Lippenslaan 200,2023-01-02,18:00:00,49,33,16,FMN 15 Luitenant Lippenslaan
662,Luitenant Lippenslaan 200,2023-01-02,19:00:00,28,22,6,FMN 15 Luitenant Lippenslaan
662,Luitenant Lippenslaan 200,2023-01-02,20:00:00,25,15,10,FMN 15 Luitenant Lippenslaan
662,Luitenant Lippenslaan 200,2023-01-02,21:00:00,17,11,6,FMN 15 Luitenant Lippenslaan
662,Luitenant Lippenslaan 200,2023-01-02,22:00:00,6,4,2,FMN 15 Luitenant Lippenslaan
662,Luitenant Lippenslaan 200,2023-01-02,23:00:00,3,3,0,FMN 15 Luitenant Lippenslaan
662,Luitenant Lippenslaan 200,2023-01-03,00:00:00,1,1,0,FMN 15 Luitenant Lippenslaan
662,Luitenant Lippenslaan 200,2023-01-03,01:00:00,2,0,2,FMN 15 Luitenant Lippenslaan
662,Luitenant Lippenslaan 200,2023-01-03,02:00:00,6,0,6,FMN 15 Luitenant Lippenslaan
662,Luitenant Lippenslaan 200,2023-01-03,03:00:00,6,4,2,FMN 15 Luitenant Lippenslaan
662,Luitenant Lippenslaan 200,2023-01-03,04:00:00,7,5,2,FMN 15 Luitenant Lippenslaan
662,Luitenant Lippenslaan 200,2023-01-03,05:00:00,9,7,2,FMN 15 Luitenant Lippenslaan
662,Luitenant Lippenslaan 200,2023-01-03,06:00:00,41,35,6,FMN 15 Luitenant Lippenslaan
662,Luitenant Lippenslaan 200,2023-01-03,07:00:00,72,66,6,FMN 15 Luitenant Lippenslaan
662,Luitenant Lippenslaan 200,2023-01-03,08:00:00,137,127,10,FMN 15 Luitenant Lippenslaan
662,Luitenant Lippenslaan 200,2023-01-03,09:00:00,89,83,6,FMN 15 Luitenant Lippenslaan
662,Luitenant Lippenslaan 200,2023-01-03,10:00:00,71,61,10,FMN 15 Luitenant Lippenslaan
662,Luitenant Lippenslaan 200,2023-01-03,11:00:00,72,56,16,FMN 15 Luitenant Lippenslaan
662,Luitenant Lippenslaan 200,2023-01-03,12:00:00,97,69,28,FMN 15 Luitenant Lippenslaan
662,Luitenant Lippenslaan 200,2023-01-03,13:00:00,71,65,6,FMN 15 Luitenant Lippenslaan
662,Luitenant Lippenslaan 200,2023-01-03,14:00:00,75,59,16,FMN 15 Luitenant Lippenslaan
662,Luitenant Lippenslaan 200,2023-01-03,15:00:00,63,55,8,FMN 15 Luitenant Lippenslaan
662,Luitenant Lippenslaan 200,2023-01-03,16:00:00,93,81,12,FMN 15 Luitenant Lippenslaan
662,Luitenant Lippenslaan 200,2023-01-03,17:00:00,106,72,34,FMN 15 Luitenant Lippenslaan
662,Luitenant Lippenslaan 200,2023-01-03,18:00:00,89,67,22,FMN 15 Luitenant Lippenslaan
662,Luitenant Lippenslaan 200,2023-01-03,19:00:00,58,36,22,FMN 15 Luitenant Lippenslaan
662,Luitenant Lippenslaan 200,2023-01-03,20:00:00,35,23,12,FMN 15 Luitenant Lippenslaan
662,Luitenant Lippenslaan 200,2023-01-03,21:00:00,30,20,10,FMN 15 Luitenant Lippenslaan
662,Luitenant Lippenslaan 200,2023-01-03,22:00:00,22,16,6,FMN 15 Luitenant Lippenslaan
662,Luitenant Lippenslaan 200,2023-01-03,23:00:00,19,9,10,FMN 15 Luitenant Lippenslaan
662,Luitenant Lippenslaan 200,2023-01-04,00:00:00,2,2,0,FMN 15 Luitenant Lippenslaan
662,Luitenant Lippenslaan 200,2023-01-04,01:00:00,5,3,2,FMN 15 Luitenant Lippenslaan
662,Luitenant Lippenslaan 200,2023-01-04,02:00:00,4,2,2,FMN 15 Luitenant Lippenslaan
662,Luitenant Lippenslaan 200,2023-01-04,03:00:00,3,1,2,FMN 15 Luitenant Lippenslaan
662,Luitenant Lippenslaan 200,2023-01-04,04:00:00,8,4,4,FMN 15 Luitenant Lippenslaan
662,Luitenant Lippenslaan 200,2023-01-04,05:00:00,15,13,2,FMN 15 Luitenant Lippenslaan
662,Luitenant Lippenslaan 200,2023-01-04,06:00:00,29,25,4,FMN 15 Luitenant Lippenslaan
662,Luitenant Lippenslaan 200,2023-01-04,07:00:00,56,54,2,FMN 15 Luitenant Lippenslaan
662,Luitenant Lippenslaan 200,2023-01-04,08:00:00,122,114,8,FMN 15 Luitenant Lippenslaan
662,Luitenant Lippenslaan 200,2023-01-04,09:00:00,55,51,4,FMN 15 Luitenant Lippenslaan
662,Luitenant Lippenslaan 200,2023-01-04,10:00:00,40,36,4,FMN 15 Luitenant Lippenslaan
662,Luitenant Lippenslaan 200,2023-01-04,11:00:00,35,29,6,FMN 15 Luitenant Lippenslaan
662,Luitenant Lippenslaan 200,2023-01-04,12:00:00,59,47,12,FMN 15 Luitenant Lippenslaan
662,Luitenant Lippenslaan 200,2023-01-04,13:00:00,42,38,4,FMN 15 Luitenant Lippenslaan
662,Luitenant Lippenslaan 200,2023-01-04,14:00:00,39,31,8,FMN 15 Luitenant Lippenslaan
662,Luitenant Lippenslaan 200,2023-01-04,15:00:00,44,34,10,FMN 15 Luitenant Lippenslaan
662,Luitenant Lippenslaan 200,2023-01-04,16:00:00,76,62,14,FMN 15 Luitenant Lippenslaan
662,Luitenant Lippenslaan 200,2023-01-04,17:00:00,75,53,22,FMN 15 Luitenant Lippenslaan
662,Luitenant Lippenslaan 200,2023-01-04,18:00:00,85,59,26,FMN 15 Luitenant Lippenslaan
662,Luitenant Lippenslaan 200,2023-01-04,19:00:00,47,35,12,FMN 15 Luitenant Lippenslaan
662,Luitenant Lippenslaan 200,2023-01-04,20:00:00,43,27,16,FMN 15 Luitenant Lippenslaan
662,Luitenant Lippenslaan 200,2023-01-04,21:00:00,20,16,4,FMN 15 Luitenant Lippenslaan
662,Luitenant Lippenslaan 200,2023-01-04,22:00:00,17,7,10,FMN 15 Luitenant Lippenslaan
662,Luitenant Lippenslaan 200,2023-01-04,23:00:00,4,2,2,FMN 15 Luitenant Lippenslaan
662,Luitenant Lippenslaan 200,2023-01-05,00:00:00,3,3,0,FMN 15 Luitenant Lippenslaan
662,Luitenant Lippenslaan 200,2023-01-05,01:00:00,0,0,0,FMN 15 Luitenant Lippenslaan
662,Luitenant Lippenslaan 200,2023-01-05,02:00:00,8,2,6,FMN 15 Luitenant Lippenslaan
662,Luitenant Lippenslaan 200,2023-01-05,03:00:00,9,5,4,FMN 15 Luitenant Lippenslaan
662,Luitenant Lippenslaan 200,2023-01-05,04:00:00,4,2,2,FMN 15 Luitenant Lippenslaan
662,Luitenant Lippenslaan 200,2023-01-05,05:00:00,8,8,0,FMN 15 Luitenant Lippenslaan
662,Luitenant Lippenslaan 200,2023-01-05,06:00:00,18,16,2,FMN 15 Luitenant Lippenslaan
662,Luitenant Lippenslaan 200,2023-01-05,07:00:00,52,46,6,FMN 15 Luitenant Lippenslaan
662,Luitenant Lippenslaan 200,2023-01-05,08:00:00,109,101,8,FMN 15 Luitenant Lippenslaan
662,Luitenant Lippenslaan 200,2023-01-05,09:00:00,63,57,6,FMN 15 Luitenant Lippenslaan
662,Luitenant Lippenslaan 200,2023-01-05,10:00:00,55,43,12,FMN 15 Luitenant Lippenslaan
662,Luitenant Lippenslaan 200,2023-01-05,11:00:00,47,43,4,FMN 15 Luitenant Lippenslaan
662,Luitenant Lippenslaan 200,2023-01-05,12:00:00,63,47,16,FMN 15 Luitenant Lippenslaan
662,Luitenant Lippenslaan 200,2023-01-05,13:00:00,90,76,14,FMN 15 Luitenant Lippenslaan
662,Luitenant Lippenslaan 200,2023-01-05,14:00:00,68,52,16,FMN 15 Luitenant Lippenslaan
662,Luitenant Lippenslaan 200,2023-01-05,15:00:00,50,42,8,FMN 15 Luitenant Lippenslaan
662,Luitenant Lippenslaan 200,2023-01-05,16:00:00,80,64,16,FMN 15 Luitenant Lippenslaan
662,Luitenant Lippenslaan 200,2023-01-05,17:00:00,84,63,21,FMN 15 Luitenant Lippenslaan
662,Luitenant Lippenslaan 200,2023-01-05,18:00:00,72,54,18,FMN 15 Luitenant Lippenslaan
662,Luitenant Lippenslaan 200,2023-01-05,19:00:00,67,51,16,FMN 15 Luitenant Lippenslaan
662,Luitenant Lippenslaan 200,2023-01-05,20:00:00,34,26,8,FMN 15 Luitenant Lippenslaan
662,Luitenant Lippenslaan 200,2023-01-05,21:00:00,30,20,10,FMN 15 Luitenant Lippenslaan
662,Luitenant Lippenslaan 200,2023-01-05,22:00:00,37,15,22,FMN 15 Luitenant Lippenslaan
662,Luitenant Lippenslaan 200,2023-01-05,23:00:00,10,6,4,FMN 15 Luitenant Lippenslaan
662,Luitenant Lippenslaan 200,2023-01-06,00:00:00,3,1,2,FMN 15 Luitenant Lippenslaan
662,Luitenant Lippenslaan 200,2023-01-06,01:00:00,1,1,0,FMN 15 Luitenant Lippenslaan
662,Luitenant Lippenslaan 200,2023-01-06,02:00:00,3,1,2,FMN 15 Luitenant Lippenslaan
662,Luitenant Lippenslaan 200,2023-01-06,03:00:00,2,2,0,FMN 15 Luitenant Lippenslaan
662,Luitenant Lippenslaan 200,2023-01-06,04:00:00,6,4,2,FMN 15 Luitenant Lippenslaan
662,Luitenant Lippenslaan 200,2023-01-06,05:00:00,9,7,2,FMN 15 Luitenant Lippenslaan
662,Luitenant Lippenslaan 200,2023-01-06,06:00:00,22,18,4,FMN 15 Luitenant Lippenslaan
662,Luitenant Lippenslaan 200,2023-01-06,07:00:00,38,36,2,FMN 15 Luitenant Lippenslaan
662,Luitenant Lippenslaan 200,2023-01-06,08:00:00,74,66,8,FMN 15 Luitenant Lippenslaan
662,Luitenant Lippenslaan 200,2023-01-06,09:00:00,77,69,8,FMN 15 Luitenant Lippenslaan
662,Luitenant Lippenslaan 200,2023-01-06,10:00:00,70,64,6,FMN 15 Luitenant Lippenslaan
662,Luitenant Lippenslaan 200,2023-01-06,11:00:00,64,52,12,FMN 15 Luitenant Lippenslaan
662,Luitenant Lippenslaan 200,2023-01-06,12:00:00,82,62,20,FMN 15 Luitenant Lippenslaan
662,Luitenant Lippenslaan 200,2023-01-06,13:00:00,70,60,10,FMN 15 Luitenant Lippenslaan
662,Luitenant Lippenslaan 200,2023-01-06,14:00:00,60,48,12,FMN 15 Luitenant Lippenslaan
662,Luitenant Lippenslaan 200,2023-01-06,15:00:00,63,43,20,FMN 15 Luitenant Lippenslaan
662,Luitenant Lippenslaan 200,2023-01-06,16:00:00,60,36,24,FMN 15 Luitenant Lippenslaan
662,Luitenant Lippenslaan 200,2023-01-06,17:00:00,88,72,16,FMN 15 Luitenant Lippenslaan
662,Luitenant Lippenslaan 200,2023-01-06,18:00:00,73,51,22,FMN 15 Luitenant Lippenslaan
662,Luitenant Lippenslaan 200,2023-01-06,19:00:00,74,60,14,FMN 15 Luitenant Lippenslaan
662,Luitenant Lippenslaan 200,2023-01-06,20:00:00,37,31,6,FMN 15 Luitenant Lippenslaan
662,Luitenant Lippenslaan 200,2023-01-06,21:00:00,33,27,6,FMN 15 Luitenant Lippenslaan
662,Luitenant Lippenslaan 200,2023-01-06,22:00:00,19,11,8,FMN 15 Luitenant Lippenslaan
662,Luitenant Lippenslaan 200,2023-01-06,23:00:00,19,9,10,FMN 15 Luitenant Lippenslaan
662,Luitenant Lippenslaan 200,2023-01-07,00:00:00,10,4,6,FMN 15 Luitenant Lippenslaan
662,Luitenant Lippenslaan 200,2023-01-07,01:00:00,9,3,6,FMN 15 Luitenant Lippenslaan
662,Luitenant Lippenslaan 200,2023-01-07,02:00:00,7,1,6,FMN 15 Luitenant Lippenslaan
662,Luitenant Lippenslaan 200,2023-01-07,03:00:00,3,3,0,FMN 15 Luitenant Lippenslaan
662,Luitenant Lippenslaan 200,2023-01-07,04:00:00,7,3,4,FMN 15 Luitenant Lippenslaan
662,Luitenant Lippenslaan 200,2023-01-07,05:00:00,7,7,0,FMN 15 Luitenant Lippenslaan
662,Luitenant Lippenslaan 200,2023-01-07,06:00:00,9,7,2,FMN 15 Luitenant Lippenslaan
662,Luitenant Lippenslaan 200,2023-01-07,07:00:00,17,13,4,FMN 15 Luitenant Lippenslaan
662,Luitenant Lippenslaan 200,2023-01-07,08:00:00,26,20,6,FMN 15 Luitenant Lippenslaan
662,Luitenant Lippenslaan 200,2023-01-07,09:00:00,51,39,12,FMN 15 Luitenant Lippenslaan
662,Luitenant Lippenslaan 200,2023-01-07,10:00:00,58,56,2,FMN 15 Luitenant Lippenslaan
662,Luitenant Lippenslaan 200,2023-01-07,11:00:00,53,43,10,FMN 15 Luitenant Lippenslaan
662,Luitenant Lippenslaan 200,2023-01-07,12:00:00,76,68,8,FMN 15 Luitenant Lippenslaan
662,Luitenant Lippenslaan 200,2023-01-07,13:00:00,84,66,18,FMN 15 Luitenant Lippenslaan
662,Luitenant Lippenslaan 200,2023-01-07,14:00:00,71,53,18,FMN 15 Luitenant Lippenslaan
662,Luitenant Lippenslaan 200,2023-01-07,15:00:00,49,39,10,FMN 15 Luitenant Lippenslaan
662,Luitenant Lippenslaan 200,2023-01-07,16:00:00,54,36,18,FMN 15 Luitenant Lippenslaan
662,Luitenant Lippenslaan 200,2023-01-07,17:00:00,39,27,12,FMN 15 Luitenant Lippenslaan
662,Luitenant Lippenslaan 200,2023-01-07,18:00:00,39,33,6,FMN 15 Luitenant Lippenslaan
662,Luitenant Lippenslaan 200,2023-01-07,19:00:00,59,41,18,FMN 15 Luitenant Lippenslaan
662,Luitenant Lippenslaan 200,2023-01-07,20:00:00,37,37,0,FMN 15 Luitenant Lippenslaan
662,Luitenant Lippenslaan 200,2023-01-07,21:00:00,23,19,4,FMN 15 Luitenant Lippenslaan
662,Luitenant Lippenslaan 200,2023-01-07,22:00:00,16,14,2,FMN 15 Luitenant Lippenslaan
662,Luitenant Lippenslaan 200,2023-01-07,23:00:00,29,13,16,FMN 15 Luitenant Lippenslaan
662,Luitenant Lippenslaan 200,2023-01-08,00:00:00,20,16,4,FMN 15 Luitenant Lippenslaan
662,Luitenant Lippenslaan 200,2023-01-08,01:00:00,5,1,4,FMN 15 Luitenant Lippenslaan
662,Luitenant Lippenslaan 200,2023-01-08,02:00:00,3,1,2,FMN 15 Luitenant Lippenslaan
662,Luitenant Lippenslaan 200,2023-01-08,03:00:00,1,1,0,FMN 15 Luitenant Lippenslaan
662,Luitenant Lippenslaan 200,2023-01-08,04:00:00,5,3,2,FMN 15 Luitenant Lippenslaan
662,Luitenant Lippenslaan 200,2023-01-08,05:00:00,3,3,0,FMN 15 Luitenant Lippenslaan
662,Luitenant Lippenslaan 200,2023-01-08,06:00:00,7,7,0,FMN 15 Luitenant Lippenslaan
662,Luitenant Lippenslaan 200,2023-01-08,07:00:00,7,7,0,FMN 15 Luitenant Lippenslaan
662,Luitenant Lippenslaan 200,2023-01-08,08:00:00,11,7,4,FMN 15 Luitenant Lippenslaan
662,Luitenant Lippenslaan 200,2023-01-08,09:00:00,24,18,6,FMN 15 Luitenant Lippenslaan
662,Luitenant Lippenslaan 200,2023-01-08,10:00:00,23,21,2,FMN 15 Luitenant Lippenslaan
662,Luitenant Lippenslaan 200,2023-01-08,11:00:00,44,26,18,FMN 15 Luitenant Lippenslaan
662,Luitenant Lippenslaan 200,2023-01-08,12:00:00,64,50,14,FMN 15 Luitenant Lippenslaan
662,Luitenant Lippenslaan 200,2023-01-08,13:00:00,91,71,20,FMN 15 Luitenant Lippenslaan
662,Luitenant Lippenslaan 200,2023-01-08,14:00:00,73,63,10,FMN 15 Luitenant Lippenslaan
662,Luitenant Lippenslaan 200,2023-01-08,15:00:00,57,45,12,FMN 15 Luitenant Lippenslaan
662,Luitenant Lippenslaan 200,2023-01-08,16:00:00,61,47,14,FMN 15 Luitenant Lippenslaan
662,Luitenant Lippenslaan 200,2023-01-08,17:00:00,43,35,8,FMN 15 Luitenant Lippenslaan
662,Luitenant Lippenslaan 200,2023-01-08,18:00:00,29,21,8,FMN 15 Luitenant Lippenslaan
662,Luitenant Lippenslaan 200,2023-01-08,19:00:00,34,22,12,FMN 15 Luitenant Lippenslaan
662,Luitenant Lippenslaan 200,2023-01-08,20:00:00,19,13,6,FMN 15 Luitenant Lippenslaan
662,Luitenant Lippenslaan 200,2023-01-08,21:00:00,8,8,0,FMN 15 Luitenant Lippenslaan
662,Luitenant Lippenslaan 200,2023-01-08,22:00:00,5,3,2,FMN 15 Luitenant Lippenslaan
662,Luitenant Lippenslaan 200,2023-01-08,23:00:00,10,2,8,FMN 15 Luitenant Lippenslaan
662,Luitenant Lippenslaan 200,2023-01-09,00:00:00,2,2,0,FMN 15 Luitenant Lippenslaan
662,Luitenant Lippenslaan 200,2023-01-09,01:00:00,1,1,0,FMN 15 Luitenant Lippenslaan
662,Luitenant Lippenslaan 200,2023-01-09,02:00:00,4,0,4,FMN 15 Luitenant Lippenslaan
662,Luitenant Lippenslaan 200,2023-01-09,03:00:00,11,5,6,FMN 15 Luitenant Lippenslaan
662,Luitenant Lippenslaan 200,2023-01-09,04:00:00,7,5,2,FMN 15 Luitenant Lippenslaan
662,Luitenant Lippenslaan 200,2023-01-09,05:00:00,15,13,2,FMN 15 Luitenant Lippenslaan
662,Luitenant Lippenslaan 200,2023-01-09,06:00:00,47,37,10,FMN 15 Luitenant Lippenslaan
662,Luitenant Lippenslaan 200,2023-01-09,07:00:00,148,132,16,FMN 15 Luitenant Lippenslaan
662,Luitenant Lippenslaan 200,2023-01-09,08:00:00,363,345,18,FMN 15 Luitenant Lippenslaan
662,Luitenant Lippenslaan 200,2023-01-09,09:00:00,113,107,6,FMN 15 Luitenant Lippenslaan
662,Luitenant Lippenslaan 200,2023-01-09,10:00:00,74,66,8,FMN 15 Luitenant Lippenslaan
662,Luitenant Lippenslaan 200,2023-01-09,11:00:00,44,38,6,FMN 15 Luitenant Lippenslaan
662,Luitenant Lippenslaan 200,2023-01-09,12:00:00,83,67,16,FMN 15 Luitenant Lippenslaan
662,Luitenant Lippenslaan 200,2023-01-09,13:00:00,62,50,12,FMN 15 Luitenant Lippenslaan
662,Luitenant Lippenslaan 200,2023-01-09,14:00:00,59,49,10,FMN 15 Luitenant Lippenslaan
662,Luitenant Lippenslaan 200,2023-01-09,15:00:00,82,44,38,FMN 15 Luitenant Lippenslaan
662,Luitenant Lippenslaan 200,2023-01-09,16:00:00,108,86,22,FMN 15 Luitenant Lippenslaan
662,Luitenant Lippenslaan 200,2023-01-09,17:00:00,116,98,18,FMN 15 Luitenant Lippenslaan
662,Luitenant Lippenslaan 200,2023-01-09,18:00:00,111,81,30,FMN 15 Luitenant Lippenslaan
662,Luitenant Lippenslaan 200,2023-01-09,19:00:00,74,54,20,FMN 15 Luitenant Lippenslaan
662,Luitenant Lippenslaan 200,2023-01-09,20:00:00,47,37,10,FMN 15 Luitenant Lippenslaan
662,Luitenant Lippenslaan 200,2023-01-09,21:00:00,31,27,4,FMN 15 Luitenant Lippenslaan
662,Luitenant Lippenslaan 200,2023-01-09,22:00:00,23,17,6,FMN 15 Luitenant Lippenslaan
662,Luitenant Lippenslaan 200,2023-01-09,23:00:00,12,12,0,FMN 15 Luitenant Lippenslaan
662,Luitenant Lippenslaan 200,2023-01-10,00:00:00,4,2,2,FMN 15 Luitenant Lippenslaan
662,Luitenant Lippenslaan 200,2023-01-10,01:00:00,1,1,0,FMN 15 Luitenant Lippenslaan
662,Luitenant Lippenslaan 200,2023-01-10,02:00:00,2,0,2,FMN 15 Luitenant Lippenslaan
662,Luitenant Lippenslaan 200,2023-01-10,03:00:00,4,2,2,FMN 15 Luitenant Lippenslaan
662,Luitenant Lippenslaan 200,2023-01-10,04:00:00,4,4,0,FMN 15 Luitenant Lippenslaan
662,Luitenant Lippenslaan 200,2023-01-10,05:00:00,13,13,0,FMN 15 Luitenant Lippenslaan
662,Luitenant Lippenslaan 200,2023-01-10,06:00:00,32,28,4,FMN 15 Luitenant Lippenslaan
662,Luitenant Lippenslaan 200,2023-01-10,07:00:00,136,118,18,FMN 15 Luitenant Lippenslaan
662,Luitenant Lippenslaan 200,2023-01-10,08:00:00,255,241,14,FMN 15 Luitenant Lippenslaan
662,Luitenant Lippenslaan 200,2023-01-10,09:00:00,95,83,12,FMN 15 Luitenant Lippenslaan
662,Luitenant Lippenslaan 200,2023-01-10,10:00:00,63,55,8,FMN 15 Luitenant Lippenslaan
662,Luitenant Lippenslaan 200,2023-01-10,11:00:00,53,41,12,FMN 15 Luitenant Lippenslaan
662,Luitenant Lippenslaan 200,2023-01-10,12:00:00,81,69,12,FMN 15 Luitenant Lippenslaan
662,Luitenant Lippenslaan 200,2023-01-10,13:00:00,55,49,6,FMN 15 Luitenant Lippenslaan
662,Luitenant Lippenslaan 200,2023-01-10,14:00:00,49,37,12,FMN 15 Luitenant Lippenslaan
662,Luitenant Lippenslaan 200,2023-01-10,15:00:00,66,50,16,FMN 15 Luitenant Lippenslaan
662,Luitenant Lippenslaan 200,2023-01-10,16:00:00,102,86,16,FMN 15 Luitenant Lippenslaan
662,Luitenant Lippenslaan 200,2023-01-10,17:00:00,97,81,16,FMN 15 Luitenant Lippenslaan
662,Luitenant Lippenslaan 200,2023-01-10,18:00:00,93,79,14,FMN 15 Luitenant Lippenslaan
662,Luitenant Lippenslaan 200,2023-01-10,19:00:00,47,37,10,FMN 15 Luitenant Lippenslaan
662,Luitenant Lippenslaan 200,2023-01-10,20:00:00,46,36,10,FMN 15 Luitenant Lippenslaan
662,Luitenant Lippenslaan 200,2023-01-10,21:00:00,24,18,6,FMN 15 Luitenant Lippenslaan
662,Luitenant Lippenslaan 200,2023-01-10,22:00:00,26,14,12,FMN 15 Luitenant Lippenslaan
662,Luitenant Lippenslaan 200,2023-01-10,23:00:00,19,9,10,FMN 15 Luitenant Lippenslaan
662,Luitenant Lippenslaan 200,2023-01-11,00:00:00,5,3,2,FMN 15 Luitenant Lippenslaan
662,Luitenant Lippenslaan 200,2023-01-11,01:00:00,2,0,2,FMN 15 Luitenant Lippenslaan
662,Luitenant Lippenslaan 200,2023-01-11,02:00:00,4,2,2,FMN 15 Luitenant Lippenslaan
662,Luitenant Lippenslaan 200,2023-01-11,03:00:00,4,2,2,FMN 15 Luitenant Lippenslaan
662,Luitenant Lippenslaan 200,2023-01-11,04:00:00,6,6,0,FMN 15 Luitenant Lippenslaan
662,Luitenant Lippenslaan 200,2023-01-11,05:00:00,17,13,4,FMN 15 Luitenant Lippenslaan
662,Luitenant Lippenslaan 200,2023-01-11,06:00:00,40,36,4,FMN 15 Luitenant Lippenslaan
662,Luitenant Lippenslaan 200,2023-01-11,07:00:00,133,115,18,FMN 15 Luitenant Lippenslaan
662,Luitenant Lippenslaan 200,2023-01-11,08:00:00,232,206,26,FMN 15 Luitenant Lippenslaan
662,Luitenant Lippenslaan 200,2023-01-11,09:00:00,82,72,10,FMN 15 Luitenant Lippenslaan
662,Luitenant Lippenslaan 200,2023-01-11,10:00:00,45,45,0,FMN 15 Luitenant Lippenslaan
662,Luitenant Lippenslaan 200,2023-01-11,11:00:00,55,37,18,FMN 15 Luitenant Lippenslaan
662,Luitenant Lippenslaan 200,2023-01-11,12:00:00,97,79,18,FMN 15 Luitenant Lippenslaan
662,Luitenant Lippenslaan 200,2023-01-11,13:00:00,75,67,8,FMN 15 Luitenant Lippenslaan
662,Luitenant Lippenslaan 200,2023-01-11,14:00:00,71,59,12,FMN 15 Luitenant Lippenslaan
662,Luitenant Lippenslaan 200,2023-01-11,15:00:00,74,60,14,FMN 15 Luitenant Lippenslaan
662,Luitenant Lippenslaan 200,2023-01-11,16:00:00,77,63,14,FMN 15 Luitenant Lippenslaan
662,Luitenant Lippenslaan 200,2023-01-11,17:00:00,92,74,18,FMN 15 Luitenant Lippenslaan
662,Luitenant Lippenslaan 200,2023-01-11,18:00:00,49,43,6,FMN 15 Luitenant Lippenslaan
662,Luitenant Lippenslaan 200,2023-01-11,19:00:00,67,47,20,FMN 15 Luitenant Lippenslaan
662,Luitenant Lippenslaan 200,2023-01-11,20:00:00,49,27,22,FMN 15 Luitenant Lippenslaan
662,Luitenant Lippenslaan 200,2023-01-11,21:00:00,12,10,2,FMN 15 Luitenant Lippenslaan
662,Luitenant Lippenslaan 200,2023-01-11,22:00:00,22,16,6,FMN 15 Luitenant Lippenslaan
662,Luitenant Lippenslaan 200,2023-01-11,23:00:00,10,8,2,FMN 15 Luitenant Lippenslaan
662,Luitenant Lippenslaan 200,2023-01-12,00:00:00,1,1,0,FMN 15 Luitenant Lippenslaan
662,Luitenant Lippenslaan 200,2023-01-12,01:00:00,1,1,0,FMN 15 Luitenant Lippenslaan
662,Luitenant Lippenslaan 200,2023-01-12,02:00:00,5,3,2,FMN 15 Luitenant Lippenslaan
662,Luitenant Lippenslaan 200,2023-01-12,03:00:00,0,0,0,FMN 15 Luitenant Lippenslaan
662,Luitenant Lippenslaan 200,2023-01-12,04:00:00,4,2,2,FMN 15 Luitenant Lippenslaan
662,Luitenant Lippenslaan 200,2023-01-12,05:00:00,11,9,2,FMN 15 Luitenant Lippenslaan
662,Luitenant Lippenslaan 200,2023-01-12,06:00:00,33,27,6,FMN 15 Luitenant Lippenslaan
662,Luitenant Lippenslaan 200,2023-01-12,07:00:00,95,85,10,FMN 15 Luitenant Lippenslaan
662,Luitenant Lippenslaan 200,2023-01-12,08:00:00,174,168,6,FMN 15 Luitenant Lippenslaan
662,Luitenant Lippenslaan 200,2023-01-12,09:00:00,75,69,6,FMN 15 Luitenant Lippenslaan
662,Luitenant Lippenslaan 200,2023-01-12,10:00:00,43,37,6,FMN 15 Luitenant Lippenslaan
662,Luitenant Lippenslaan 200,2023-01-12,11:00:00,36,32,4,FMN 15 Luitenant Lippenslaan
662,Luitenant Lippenslaan 200,2023-01-12,12:00:00,35,25,10,FMN 15 Luitenant Lippenslaan
662,Luitenant Lippenslaan 200,2023-01-12,13:00:00,35,27,8,FMN 15 Luitenant Lippenslaan
662,Luitenant Lippenslaan 200,2023-01-12,14:00:00,33,23,10,FMN 15 Luitenant Lippenslaan
662,Luitenant Lippenslaan 200,2023-01-12,15:00:00,43,25,18,FMN 15 Luitenant Lippenslaan
662,Luitenant Lippenslaan 200,2023-01-12,16:00:00,59,45,14,FMN 15 Luitenant Lippenslaan
662,Luitenant Lippenslaan 200,2023-01-12,17:00:00,75,59,16,FMN 15 Luitenant Lippenslaan
662,Luitenant Lippenslaan 200,2023-01-12,18:00:00,57,49,8,FMN 15 Luitenant Lippenslaan
662,Luitenant Lippenslaan 200,2023-01-12,19:00:00,50,32,18,FMN 15 Luitenant Lippenslaan
662,Luitenant Lippenslaan 200,2023-01-12,20:00:00,36,26,10,FMN 15 Luitenant Lippenslaan
662,Luitenant Lippenslaan 200,2023-01-12,21:00:00,15,13,2,FMN 15 Luitenant Lippenslaan
662,Luitenant Lippenslaan 200,2023-01-12,22:00:00,20,10,10,FMN 15 Luitenant Lippenslaan
662,Luitenant Lippenslaan 200,2023-01-12,23:00:00,8,4,4,FMN 15 Luitenant Lippenslaan
662,Luitenant Lippenslaan 200,2023-01-13,00:00:00,10,4,6,FMN 15 Luitenant Lippenslaan
662,Luitenant Lippenslaan 200,2023-01-13,01:00:00,3,1,2,FMN 15 Luitenant Lippenslaan
662,Luitenant Lippenslaan 200,2023-01-13,02:00:00,2,0,2,FMN 15 Luitenant Lippenslaan
662,Luitenant Lippenslaan 200,2023-01-13,03:00:00,0,0,0,FMN 15 Luitenant Lippenslaan
662,Luitenant Lippenslaan 200,2023-01-13,04:00:00,5,5,0,FMN 15 Luitenant Lippenslaan
662,Luitenant Lippenslaan 200,2023-01-13,05:00:00,9,7,2,FMN 15 Luitenant Lippenslaan
662,Luitenant Lippenslaan 200,2023-01-13,06:00:00,23,19,4,FMN 15 Luitenant Lippenslaan
662,Luitenant Lippenslaan 200,2023-01-13,07:00:00,92,82,10,FMN 15 Luitenant Lippenslaan
662,Luitenant Lippenslaan 200,2023-01-13,08:00:00,155,137,18,FMN 15 Luitenant Lippenslaan
662,Luitenant Lippenslaan 200,2023-01-13,09:00:00,79,75,4,FMN 15 Luitenant Lippenslaan
662,Luitenant Lippenslaan 200,2023-01-13,10:00:00,57,52,5,FMN 15 Luitenant Lippenslaan
662,Luitenant Lippenslaan 200,2023-01-13,11:00:00,46,32,14,FMN 15 Luitenant Lippenslaan
662,Luitenant Lippenslaan 200,2023-01-13,12:00:00,59,47,12,FMN 15 Luitenant Lippenslaan
662,Luitenant Lippenslaan 200,2023-01-13,13:00:00,62,50,12,FMN 15 Luitenant Lippenslaan
662,Luitenant Lippenslaan 200,2023-01-13,14:00:00,33,27,6,FMN 15 Luitenant Lippenslaan
662,Luitenant Lippenslaan 200,2023-01-13,15:00:00,50,40,10,FMN 15 Luitenant Lippenslaan
662,Luitenant Lippenslaan 200,2023-01-13,16:00:00,75,63,12,FMN 15 Luitenant Lippenslaan
662,Luitenant Lippenslaan 200,2023-01-13,17:00:00,71,57,14,FMN 15 Luitenant Lippenslaan
662,Luitenant Lippenslaan 200,2023-01-13,18:00:00,67,53,14,FMN 15 Luitenant Lippenslaan
662,Luitenant Lippenslaan 200,2023-01-13,19:00:00,55,47,8,FMN 15 Luitenant Lippenslaan
662,Luitenant Lippenslaan 200,2023-01-13,20:00:00,39,31,8,FMN 15 Luitenant Lippenslaan
662,Luitenant Lippenslaan 200,2023-01-13,21:00:00,20,16,4,FMN 15 Luitenant Lippenslaan
662,Luitenant Lippenslaan 200,2023-01-13,22:00:00,12,8,4,FMN 15 Luitenant Lippenslaan
662,Luitenant Lippenslaan 200,2023-01-13,23:00:00,31,19,12,FMN 15 Luitenant Lippenslaan
662,Luitenant Lippenslaan 200,2023-01-14,00:00:00,3,3,0,FMN 15 Luitenant Lippenslaan
662,Luitenant Lippenslaan 200,2023-01-14,01:00:00,8,4,4,FMN 15 Luitenant Lippenslaan
662,Luitenant Lippenslaan 200,2023-01-14,02:00:00,11,5,6,FMN 15 Luitenant Lippenslaan
662,Luitenant Lippenslaan 200,2023-01-14,03:00:00,3,1,2,FMN 15 Luitenant Lippenslaan
662,Luitenant Lippenslaan 200,2023-01-14,04:00:00,10,4,6,FMN 15 Luitenant Lippenslaan
662,Luitenant Lippenslaan 200,2023-01-14,05:00:00,6,4,2,FMN 15 Luitenant Lippenslaan
662,Luitenant Lippenslaan 200,2023-01-14,06:00:00,13,11,2,FMN 15 Luitenant Lippenslaan
662,Luitenant Lippenslaan 200,2023-01-14,07:00:00,14,12,2,FMN 15 Luitenant Lippenslaan
662,Luitenant Lippenslaan 200,2023-01-14,08:00:00,51,43,8,FMN 15 Luitenant Lippenslaan
662,Luitenant Lippenslaan 200,2023-01-14,09:00:00,53,45,8,FMN 15 Luitenant Lippenslaan
662,Luitenant Lippenslaan 200,2023-01-14,10:00:00,47,42,5,FMN 15 Luitenant Lippenslaan
662,Luitenant Lippenslaan 200,2023-01-14,11:00:00,57,47,10,FMN 15 Luitenant Lippenslaan
662,Luitenant Lippenslaan 200,2023-01-14,12:00:00,47,37,10,FMN 15 Luitenant Lippenslaan
662,Luitenant Lippenslaan 200,2023-01-14,13:00:00,42,38,4,FMN 15 Luitenant Lippenslaan
662,Luitenant Lippenslaan 200,2023-01-14,14:00:00,49,41,8,FMN 15 Luitenant Lippenslaan
662,Luitenant Lippenslaan 200,2023-01-14,15:00:00,58,48,10,FMN 15 Luitenant Lippenslaan
662,Luitenant Lippenslaan 200,2023-01-14,16:00:00,47,39,8,FMN 15 Luitenant Lippenslaan
662,Luitenant Lippenslaan 200,2023-01-14,17:00:00,60,44,16,FMN 15 Luitenant Lippenslaan
662,Luitenant Lippenslaan 200,2023-01-14,18:00:00,51,47,4,FMN 15 Luitenant Lippenslaan
662,Luitenant Lippenslaan 200,2023-01-14,19:00:00,55,45,10,FMN 15 Luitenant Lippenslaan
662,Luitenant Lippenslaan 200,2023-01-14,20:00:00,62,40,22,FMN 15 Luitenant Lippenslaan
662,Luitenant Lippenslaan 200,2023-01-14,21:00:00,32,26,6,FMN 15 Luitenant Lippenslaan
662,Luitenant Lippenslaan 200,2023-01-14,22:00:00,27,17,10,FMN 15 Luitenant Lippenslaan
662,Luitenant Lippenslaan 200,2023-01-14,23:00:00,10,8,2,FMN 15 Luitenant Lippenslaan
662,Luitenant Lippenslaan 200,2023-01-15,00:00:00,31,19,12,FMN 15 Luitenant Lippenslaan
662,Luitenant Lippenslaan 200,2023-01-15,01:00:00,9,7,2,FMN 15 Luitenant Lippenslaan
662,Luitenant Lippenslaan 200,2023-01-15,02:00:00,13,7,6,FMN 15 Luitenant Lippenslaan
662,Luitenant Lippenslaan 200,2023-01-15,03:00:00,3,1,2,FMN 15 Luitenant Lippenslaan
662,Luitenant Lippenslaan 200,2023-01-15,04:00:00,5,3,2,FMN 15 Luitenant Lippenslaan
662,Luitenant Lippenslaan 200,2023-01-15,05:00:00,1,1,0,FMN 15 Luitenant Lippenslaan
662,Luitenant Lippenslaan 200,2023-01-15,06:00:00,6,4,2,FMN 15 Luitenant Lippenslaan
662,Luitenant Lippenslaan 200,2023-01-15,07:00:00,11,7,4,FMN 15 Luitenant Lippenslaan
662,Luitenant Lippenslaan 200,2023-01-15,08:00:00,13,11,2,FMN 15 Luitenant Lippenslaan
662,Luitenant Lippenslaan 200,2023-01-15,09:00:00,26,24,2,FMN 15 Luitenant Lippenslaan
662,Luitenant Lippenslaan 200,2023-01-15,10:00:00,57,45,12,FMN 15 Luitenant Lippenslaan
662,Luitenant Lippenslaan 200,2023-01-15,11:00:00,49,37,12,FMN 15 Luitenant Lippenslaan
662,Luitenant Lippenslaan 200,2023-01-15,12:00:00,63,43,20,FMN 15 Luitenant Lippenslaan
662,Luitenant Lippenslaan 200,2023-01-15,13:00:00,73,47,26,FMN 15 Luitenant Lippenslaan
662,Luitenant Lippenslaan 200,2023-01-15,14:00:00,57,49,8,FMN 15 Luitenant Lippenslaan
662,Luitenant Lippenslaan 200,2023-01-15,15:00:00,56,48,8,FMN 15 Luitenant Lippenslaan
662,Luitenant Lippenslaan 200,2023-01-15,16:00:00,55,37,18,FMN 15 Luitenant Lippenslaan
662,Luitenant Lippenslaan 200,2023-01-15,17:00:00,42,30,12,FMN 15 Luitenant Lippenslaan
662,Luitenant Lippenslaan 200,2023-01-15,18:00:00,33,25,8,FMN 15 Luitenant Lippenslaan
662,Luitenant Lippenslaan 200,2023-01-15,19:00:00,31,27,4,FMN 15 Luitenant Lippenslaan
662,Luitenant Lippenslaan 200,2023-01-15,20:00:00,14,10,4,FMN 15 Luitenant Lippenslaan
662,Luitenant Lippenslaan 200,2023-01-15,21:00:00,21,15,6,FMN 15 Luitenant Lippenslaan
662,Luitenant Lippenslaan 200,2023-01-15,22:00:00,15,9,6,FMN 15 Luitenant Lippenslaan
662,Luitenant Lippenslaan 200,2023-01-15,23:00:00,7,3,4,FMN 15 Luitenant Lippenslaan
662,Luitenant Lippenslaan 200,2023-01-16,00:00:00,3,1,2,FMN 15 Luitenant Lippenslaan
662,Luitenant Lippenslaan 200,2023-01-16,01:00:00,2,0,2,FMN 15 Luitenant Lippenslaan
662,Luitenant Lippenslaan 200,2023-01-16,02:00:00,7,1,6,FMN 15 Luitenant Lippenslaan
662,Luitenant Lippenslaan 200,2023-01-16,03:00:00,0,0,0,FMN 15 Luitenant Lippenslaan
662,Luitenant Lippenslaan 200,2023-01-16,04:00:00,10,6,4,FMN 15 Luitenant Lippenslaan
662,Luitenant Lippenslaan 200,2023-01-16,05:00:00,18,12,6,FMN 15 Luitenant Lippenslaan
662,Luitenant Lippenslaan 200,2023-01-16,06:00:00,35,31,4,FMN 15 Luitenant Lippenslaan
662,Luitenant Lippenslaan 200,2023-01-16,07:00:00,111,107,4,FMN 15 Luitenant Lippenslaan
662,Luitenant Lippenslaan 200,2023-01-16,08:00:00,237,217,20,FMN 15 Luitenant Lippenslaan
662,Luitenant Lippenslaan 200,2023-01-16,09:00:00,96,84,12,FMN 15 Luitenant Lippenslaan
662,Luitenant Lippenslaan 200,2023-01-16,10:00:00,52,52,0,FMN 15 Luitenant Lippenslaan
662,Luitenant Lippenslaan 200,2023-01-16,11:00:00,45,35,10,FMN 15 Luitenant Lippenslaan
662,Luitenant Lippenslaan 200,2023-01-16,12:00:00,47,37,10,FMN 15 Luitenant Lippenslaan
662,Luitenant Lippenslaan 200,2023-01-16,13:00:00,54,46,8,FMN 15 Luitenant Lippenslaan
662,Luitenant Lippenslaan 200,2023-01-16,14:00:00,50,40,10,FMN 15 Luitenant Lippenslaan
662,Luitenant Lippenslaan 200,2023-01-16,15:00:00,79,55,24,FMN 15 Luitenant Lippenslaan
662,Luitenant Lippenslaan 200,2023-01-16,16:00:00,90,60,30,FMN 15 Luitenant Lippenslaan
662,Luitenant Lippenslaan 200,2023-01-16,17:00:00,75,65,10,FMN 15 Luitenant Lippenslaan
662,Luitenant Lippenslaan 200,2023-01-16,18:00:00,66,52,14,FMN 15 Luitenant Lippenslaan
662,Luitenant Lippenslaan 200,2023-01-16,19:00:00,54,36,18,FMN 15 Luitenant Lippenslaan
662,Luitenant Lippenslaan 200,2023-01-16,20:00:00,40,30,10,FMN 15 Luitenant Lippenslaan
662,Luitenant Lippenslaan 200,2023-01-16,21:00:00,33,19,14,FMN 15 Luitenant Lippenslaan
662,Luitenant Lippenslaan 200,2023-01-16,22:00:00,17,17,0,FMN 15 Luitenant Lippenslaan
662,Luitenant Lippenslaan 200,2023-01-16,23:00:00,3,3,0,FMN 15 Luitenant Lippenslaan
662,Luitenant Lippenslaan 200,2023-01-17,00:00:00,7,3,4,FMN 15 Luitenant Lippenslaan
662,Luitenant Lippenslaan 200,2023-01-17,01:00:00,0,0,0,FMN 15 Luitenant Lippenslaan
662,Luitenant Lippenslaan 200,2023-01-17,02:00:00,2,0,2,FMN 15 Luitenant Lippenslaan
662,Luitenant Lippenslaan 200,2023-01-17,03:00:00,1,1,0,FMN 15 Luitenant Lippenslaan
662,Luitenant Lippenslaan 200,2023-01-17,04:00:00,10,10,0,FMN 15 Luitenant Lippenslaan
662,Luitenant Lippenslaan 200,2023-01-17,05:00:00,14,10,4,FMN 15 Luitenant Lippenslaan
662,Luitenant Lippenslaan 200,2023-01-17,06:00:00,26,26,0,FMN 15 Luitenant Lippenslaan
662,Luitenant Lippenslaan 200,2023-01-17,07:00:00,71,63,8,FMN 15 Luitenant Lippenslaan
662,Luitenant Lippenslaan 200,2023-01-17,08:00:00,201,167,34,FMN 15 Luitenant Lippenslaan
662,Luitenant Lippenslaan 200,2023-01-17,09:00:00,98,90,8,FMN 15 Luitenant Lippenslaan
662,Luitenant Lippenslaan 200,2023-01-17,10:00:00,47,43,4,FMN 15 Luitenant Lippenslaan
662,Luitenant Lippenslaan 200,2023-01-17,11:00:00,53,41,12,FMN 15 Luitenant Lippenslaan
662,Luitenant Lippenslaan 200,2023-01-17,12:00:00,82,68,14,FMN 15 Luitenant Lippenslaan
662,Luitenant Lippenslaan 200,2023-01-17,13:00:00,98,84,14,FMN 15 Luitenant Lippenslaan
662,Luitenant Lippenslaan 200,2023-01-17,14:00:00,76,64,12,FMN 15 Luitenant Lippenslaan
662,Luitenant Lippenslaan 200,2023-01-17,15:00:00,113,79,34,FMN 15 Luitenant Lippenslaan
662,Luitenant Lippenslaan 200,2023-01-17,16:00:00,108,80,28,FMN 15 Luitenant Lippenslaan
662,Luitenant Lippenslaan 200,2023-01-17,17:00:00,83,69,14,FMN 15 Luitenant Lippenslaan
662,Luitenant Lippenslaan 200,2023-01-17,18:00:00,57,39,18,FMN 15 Luitenant Lippenslaan
662,Luitenant Lippenslaan 200,2023-01-17,19:00:00,45,33,12,FMN 15 Luitenant Lippenslaan
662,Luitenant Lippenslaan 200,2023-01-17,20:00:00,26,22,4,FMN 15 Luitenant Lippenslaan
662,Luitenant Lippenslaan 200,2023-01-17,21:00:00,25,17,8,FMN 15 Luitenant Lippenslaan
662,Luitenant Lippenslaan 200,2023-01-17,22:00:00,11,9,2,FMN 15 Luitenant Lippenslaan
662,Luitenant Lippenslaan 200,2023-01-17,23:00:00,10,6,4,FMN 15 Luitenant Lippenslaan
662,Luitenant Lippenslaan 200,2023-01-18,00:00:00,0,0,0,FMN 15 Luitenant Lippenslaan
662,Luitenant Lippenslaan 200,2023-01-18,01:00:00,0,0,0,FMN 15 Luitenant Lippenslaan
662,Luitenant Lippenslaan 200,2023-01-18,02:00:00,9,1,8,FMN 15 Luitenant Lippenslaan
662,Luitenant Lippenslaan 200,2023-01-18,03:00:00,2,0,2,FMN 15 Luitenant Lippenslaan
662,Luitenant Lippenslaan 200,2023-01-18,04:00:00,5,5,0,FMN 15 Luitenant Lippenslaan
662,Luitenant Lippenslaan 200,2023-01-18,05:00:00,15,7,8,FMN 15 Luitenant Lippenslaan
662,Luitenant Lippenslaan 200,2023-01-18,06:00:00,16,12,4,FMN 15 Luitenant Lippenslaan
662,Luitenant Lippenslaan 200,2023-01-18,07:00:00,66,60,6,FMN 15 Luitenant Lippenslaan
662,Luitenant Lippenslaan 200,2023-01-18,08:00:00,135,113,22,FMN 15 Luitenant Lippenslaan
662,Luitenant Lippenslaan 200,2023-01-18,09:00:00,61,55,6,FMN 15 Luitenant Lippenslaan
662,Luitenant Lippenslaan 200,2023-01-18,10:00:00,58,50,8,FMN 15 Luitenant Lippenslaan
662,Luitenant Lippenslaan 200,2023-01-18,11:00:00,49,41,8,FMN 15 Luitenant Lippenslaan
662,Luitenant Lippenslaan 200,2023-01-18,12:00:00,96,76,20,FMN 15 Luitenant Lippenslaan
662,Luitenant Lippenslaan 200,2023-01-18,13:00:00,88,70,18,FMN 15 Luitenant Lippenslaan
662,Luitenant Lippenslaan 200,2023-01-18,14:00:00,72,56,16,FMN 15 Luitenant Lippenslaan
662,Luitenant Lippenslaan 200,2023-01-18,15:00:00,90,59,31,FMN 15 Luitenant Lippenslaan
662,Luitenant Lippenslaan 200,2023-01-18,16:00:00,108,90,18,FMN 15 Luitenant Lippenslaan
662,Luitenant Lippenslaan 200,2023-01-18,17:00:00,106,92,14,FMN 15 Luitenant Lippenslaan
662,Luitenant Lippenslaan 200,2023-01-18,18:00:00,77,61,16,FMN 15 Luitenant Lippenslaan
662,Luitenant Lippenslaan 200,2023-01-18,19:00:00,45,37,8,FMN 15 Luitenant Lippenslaan
662,Luitenant Lippenslaan 200,2023-01-18,20:00:00,28,24,4,FMN 15 Luitenant Lippenslaan
662,Luitenant Lippenslaan 200,2023-01-18,21:00:00,20,12,8,FMN 15 Luitenant Lippenslaan
662,Luitenant Lippenslaan 200,2023-01-18,22:00:00,15,15,0,FMN 15 Luitenant Lippenslaan
662,Luitenant Lippenslaan 200,2023-01-18,23:00:00,17,7,10,FMN 15 Luitenant Lippenslaan
662,Luitenant Lippenslaan 200,2023-01-19,00:00:00,15,3,12,FMN 15 Luitenant Lippenslaan
662,Luitenant Lippenslaan 200,2023-01-19,01:00:00,8,1,7,FMN 15 Luitenant Lippenslaan
662,Luitenant Lippenslaan 200,2023-01-19,02:00:00,6,3,3,FMN 15 Luitenant Lippenslaan
662,Luitenant Lippenslaan 200,2023-01-19,03:00:00,2,1,1,FMN 15 Luitenant Lippenslaan
662,Luitenant Lippenslaan 200,2023-01-19,04:00:00,10,3,7,FMN 15 Luitenant Lippenslaan
662,Luitenant Lippenslaan 200,2023-01-19,05:00:00,19,11,8,FMN 15 Luitenant Lippenslaan
662,Luitenant Lippenslaan 200,2023-01-19,06:00:00,75,28,47,FMN 15 Luitenant Lippenslaan
662,Luitenant Lippenslaan 200,2023-01-19,07:00:00,210,84,126,FMN 15 Luitenant Lippenslaan
662,Luitenant Lippenslaan 200,2023-01-19,08:00:00,476,185,291,FMN 15 Luitenant Lippenslaan
662,Luitenant Lippenslaan 200,2023-01-19,09:00:00,183,73,110,FMN 15 Luitenant Lippenslaan
662,Luitenant Lippenslaan 200,2023-01-19,10:00:00,110,48,62,FMN 15 Luitenant Lippenslaan
662,Luitenant Lippenslaan 200,2023-01-19,11:00:00,84,28,56,FMN 15 Luitenant Lippenslaan
662,Luitenant Lippenslaan 200,2023-01-19,12:00:00,129,61,68,FMN 15 Luitenant Lippenslaan
662,Luitenant Lippenslaan 200,2023-01-19,13:00:00,114,48,66,FMN 15 Luitenant Lippenslaan
662,Luitenant Lippenslaan 200,2023-01-19,14:00:00,93,32,61,FMN 15 Luitenant Lippenslaan
662,Luitenant Lippenslaan 200,2023-01-19,15:00:00,126,49,77,FMN 15 Luitenant Lippenslaan
662,Luitenant Lippenslaan 200,2023-01-19,16:00:00,156,62,94,FMN 15 Luitenant Lippenslaan
662,Luitenant Lippenslaan 200,2023-01-19,17:00:00,192,72,120,FMN 15 Luitenant Lippenslaan
662,Luitenant Lippenslaan 200,2023-01-19,18:00:00,164,68,96,FMN 15 Luitenant Lippenslaan
662,Luitenant Lippenslaan 200,2023-01-19,19:00:00,147,58,89,FMN 15 Luitenant Lippenslaan
662,Luitenant Lippenslaan 200,2023-01-19,20:00:00,81,27,54,FMN 15 Luitenant Lippenslaan
662,Luitenant Lippenslaan 200,2023-01-19,21:00:00,38,7,31,FMN 15 Luitenant Lippenslaan
662,Luitenant Lippenslaan 200,2023-01-19,22:00:00,43,13,30,FMN 15 Luitenant Lippenslaan
662,Luitenant Lippenslaan 200,2023-01-19,23:00:00,21,5,16,FMN 15 Luitenant Lippenslaan
662,Luitenant Lippenslaan 200,2023-01-20,00:00:00,11,0,11,FMN 15 Luitenant Lippenslaan
662,Luitenant Lippenslaan 200,2023-01-20,01:00:00,6,3,3,FMN 15 Luitenant Lippenslaan
662,Luitenant Lippenslaan 200,2023-01-20,02:00:00,8,1,7,FMN 15 Luitenant Lippenslaan
662,Luitenant Lippenslaan 200,2023-01-20,03:00:00,4,2,2,FMN 15 Luitenant Lippenslaan
662,Luitenant Lippenslaan 200,2023-01-20,04:00:00,16,11,5,FMN 15 Luitenant Lippenslaan
662,Luitenant Lippenslaan 200,2023-01-20,05:00:00,28,10,18,FMN 15 Luitenant Lippenslaan
662,Luitenant Lippenslaan 200,2023-01-20,06:00:00,87,36,51,FMN 15 Luitenant Lippenslaan
662,Luitenant Lippenslaan 200,2023-01-20,07:00:00,245,116,129,FMN 15 Luitenant Lippenslaan
662,Luitenant Lippenslaan 200,2023-01-20,08:00:00,347,96,251,FMN 15 Luitenant Lippenslaan
662,Luitenant Lippenslaan 200,2023-01-20,09:00:00,152,36,116,FMN 15 Luitenant Lippenslaan
662,Luitenant Lippenslaan 200,2023-01-20,10:00:00,123,43,80,FMN 15 Luitenant Lippenslaan
662,Luitenant Lippenslaan 200,2023-01-20,11:00:00,84,27,57,FMN 15 Luitenant Lippenslaan
662,Luitenant Lippenslaan 200,2023-01-20,12:00:00,125,45,80,FMN 15 Luitenant Lippenslaan
662,Luitenant Lippenslaan 200,2023-01-20,13:00:00,113,35,78,FMN 15 Luitenant Lippenslaan
662,Luitenant Lippenslaan 200,2023-01-20,14:00:00,95,32,63,FMN 15 Luitenant Lippenslaan
662,Luitenant Lippenslaan 200,2023-01-20,15:00:00,134,58,76,FMN 15 Luitenant Lippenslaan
662,Luitenant Lippenslaan 200,2023-01-20,16:00:00,156,55,101,FMN 15 Luitenant Lippenslaan
662,Luitenant Lippenslaan 200,2023-01-20,17:00:00,189,66,123,FMN 15 Luitenant Lippenslaan
662,Luitenant Lippenslaan 200,2023-01-20,18:00:00,175,66,109,FMN 15 Luitenant Lippenslaan
662,Luitenant Lippenslaan 200,2023-01-20,19:00:00,160,60,100,FMN 15 Luitenant Lippenslaan
662,Luitenant Lippenslaan 200,2023-01-20,20:00:00,86,32,54,FMN 15 Luitenant Lippenslaan
662,Luitenant Lippenslaan 200,2023-01-20,21:00:00,73,16,57,FMN 15 Luitenant Lippenslaan
662,Luitenant Lippenslaan 200,2023-01-20,22:00:00,42,13,29,FMN 15 Luitenant Lippenslaan
662,Luitenant Lippenslaan 200,2023-01-20,23:00:00,30,7,23,FMN 15 Luitenant Lippenslaan
662,Luitenant Lippenslaan 200,2023-01-21,00:00:00,32,11,21,FMN 15 Luitenant Lippenslaan
662,Luitenant Lippenslaan 200,2023-01-21,01:00:00,16,5,11,FMN 15 Luitenant Lippenslaan
662,Luitenant Lippenslaan 200,2023-01-21,02:00:00,13,7,6,FMN 15 Luitenant Lippenslaan
662,Luitenant Lippenslaan 200,2023-01-21,03:00:00,7,5,2,FMN 15 Luitenant Lippenslaan
662,Luitenant Lippenslaan 200,2023-01-21,04:00:00,6,3,3,FMN 15 Luitenant Lippenslaan
662,Luitenant Lippenslaan 200,2023-01-21,05:00:00,15,6,9,FMN 15 Luitenant Lippenslaan
662,Luitenant Lippenslaan 200,2023-01-21,06:00:00,25,9,16,FMN 15 Luitenant Lippenslaan
662,Luitenant Lippenslaan 200,2023-01-21,07:00:00,48,19,29,FMN 15 Luitenant Lippenslaan
662,Luitenant Lippenslaan 200,2023-01-21,08:00:00,83,32,51,FMN 15 Luitenant Lippenslaan
662,Luitenant Lippenslaan 200,2023-01-21,09:00:00,141,59,82,FMN 15 Luitenant Lippenslaan
662,Luitenant Lippenslaan 200,2023-01-21,10:00:00,155,71,84,FMN 15 Luitenant Lippenslaan
662,Luitenant Lippenslaan 200,2023-01-21,11:00:00,163,75,88,FMN 15 Luitenant Lippenslaan
662,Luitenant Lippenslaan 200,2023-01-21,12:00:00,169,87,82,FMN 15 Luitenant Lippenslaan
662,Luitenant Lippenslaan 200,2023-01-21,13:00:00,178,80,98,FMN 15 Luitenant Lippenslaan
662,Luitenant Lippenslaan 200,2023-01-21,14:00:00,186,90,96,FMN 15 Luitenant Lippenslaan
662,Luitenant Lippenslaan 200,2023-01-21,15:00:00,149,54,95,FMN 15 Luitenant Lippenslaan
662,Luitenant Lippenslaan 200,2023-01-21,16:00:00,168,78,90,FMN 15 Luitenant Lippenslaan
662,Luitenant Lippenslaan 200,2023-01-21,17:00:00,155,68,87,FMN 15 Luitenant Lippenslaan
662,Luitenant Lippenslaan 200,2023-01-21,18:00:00,152,67,85,FMN 15 Luitenant Lippenslaan
662,Luitenant Lippenslaan 200,2023-01-21,19:00:00,133,50,83,FMN 15 Luitenant Lippenslaan
662,Luitenant Lippenslaan 200,2023-01-21,20:00:00,95,38,57,FMN 15 Luitenant Lippenslaan
662,Luitenant Lippenslaan 200,2023-01-21,21:00:00,66,20,46,FMN 15 Luitenant Lippenslaan
662,Luitenant Lippenslaan 200,2023-01-21,22:00:00,55,21,34,FMN 15 Luitenant Lippenslaan
662,Luitenant Lippenslaan 200,2023-01-21,23:00:00,45,14,31,FMN 15 Luitenant Lippenslaan
662,Luitenant Lippenslaan 200,2023-01-22,00:00:00,30,9,21,FMN 15 Luitenant Lippenslaan
662,Luitenant Lippenslaan 200,2023-01-22,01:00:00,22,4,18,FMN 15 Luitenant Lippenslaan
662,Luitenant Lippenslaan 200,2023-01-22,02:00:00,8,4,4,FMN 15 Luitenant Lippenslaan
662,Luitenant Lippenslaan 200,2023-01-22,03:00:00,6,1,5,FMN 15 Luitenant Lippenslaan
662,Luitenant Lippenslaan 200,2023-01-22,04:00:00,14,7,7,FMN 15 Luitenant Lippenslaan
662,Luitenant Lippenslaan 200,2023-01-22,05:00:00,16,7,9,FMN 15 Luitenant Lippenslaan
662,Luitenant Lippenslaan 200,2023-01-22,06:00:00,18,8,10,FMN 15 Luitenant Lippenslaan
662,Luitenant Lippenslaan 200,2023-01-22,07:00:00,18,9,9,FMN 15 Luitenant Lippenslaan
662,Luitenant Lippenslaan 200,2023-01-22,08:00:00,42,16,26,FMN 15 Luitenant Lippenslaan
662,Luitenant Lippenslaan 200,2023-01-22,09:00:00,96,38,58,FMN 15 Luitenant Lippenslaan
662,Luitenant Lippenslaan 200,2023-01-22,10:00:00,127,63,64,FMN 15 Luitenant Lippenslaan
662,Luitenant Lippenslaan 200,2023-01-22,11:00:00,125,52,73,FMN 15 Luitenant Lippenslaan
662,Luitenant Lippenslaan 200,2023-01-22,12:00:00,127,48,79,FMN 15 Luitenant Lippenslaan
662,Luitenant Lippenslaan 200,2023-01-22,13:00:00,136,49,87,FMN 15 Luitenant Lippenslaan
662,Luitenant Lippenslaan 200,2023-01-22,14:00:00,124,42,82,FMN 15 Luitenant Lippenslaan
662,Luitenant Lippenslaan 200,2023-01-22,15:00:00,110,40,70,FMN 15 Luitenant Lippenslaan
662,Luitenant Lippenslaan 200,2023-01-22,16:00:00,131,53,78,FMN 15 Luitenant Lippenslaan
662,Luitenant Lippenslaan 200,2023-01-22,17:00:00,133,46,87,FMN 15 Luitenant Lippenslaan
662,Luitenant Lippenslaan 200,2023-01-22,18:00:00,139,57,82,FMN 15 Luitenant Lippenslaan
662,Luitenant Lippenslaan 200,2023-01-22,19:00:00,101,43,58,FMN 15 Luitenant Lippenslaan
662,Luitenant Lippenslaan 200,2023-01-22,20:00:00,66,21,45,FMN 15 Luitenant Lippenslaan
662,Luitenant Lippenslaan 200,2023-01-22,21:00:00,65,20,45,FMN 15 Luitenant Lippenslaan
662,Luitenant Lippenslaan 200,2023-01-22,22:00:00,40,24,16,FMN 15 Luitenant Lippenslaan
662,Luitenant Lippenslaan 200,2023-01-22,23:00:00,18,7,11,FMN 15 Luitenant Lippenslaan
662,Luitenant Lippenslaan 200,2023-01-23,00:00:00,17,3,14,FMN 15 Luitenant Lippenslaan
662,Luitenant Lippenslaan 200,2023-01-23,01:00:00,6,2,4,FMN 15 Luitenant Lippenslaan
662,Luitenant Lippenslaan 200,2023-01-23,02:00:00,6,1,5,FMN 15 Luitenant Lippenslaan
662,Luitenant Lippenslaan 200,2023-01-23,03:00:00,4,2,2,FMN 15 Luitenant Lippenslaan
662,Luitenant Lippenslaan 200,2023-01-23,04:00:00,19,10,9,FMN 15 Luitenant Lippenslaan
662,Luitenant Lippenslaan 200,2023-01-23,05:00:00,24,12,12,FMN 15 Luitenant Lippenslaan
662,Luitenant Lippenslaan 200,2023-01-23,06:00:00,88,50,38,FMN 15 Luitenant Lippenslaan
662,Luitenant Lippenslaan 200,2023-01-23,07:00:00,273,149,124,FMN 15 Luitenant Lippenslaan
662,Luitenant Lippenslaan 200,2023-01-23,08:00:00,597,353,244,FMN 15 Luitenant Lippenslaan
662,Luitenant Lippenslaan 200,2023-01-23,09:00:00,225,113,112,FMN 15 Luitenant Lippenslaan
662,Luitenant Lippenslaan 200,2023-01-23,10:00:00,140,78,62,FMN 15 Luitenant Lippenslaan
662,Luitenant Lippenslaan 200,2023-01-23,11:00:00,109,57,52,FMN 15 Luitenant Lippenslaan
662,Luitenant Lippenslaan 200,2023-01-23,12:00:00,149,77,72,FMN 15 Luitenant Lippenslaan
662,Luitenant Lippenslaan 200,2023-01-23,13:00:00,133,63,70,FMN 15 Luitenant Lippenslaan
662,Luitenant Lippenslaan 200,2023-01-23,14:00:00,120,53,67,FMN 15 Luitenant Lippenslaan
662,Luitenant Lippenslaan 200,2023-01-23,15:00:00,138,65,73,FMN 15 Luitenant Lippenslaan
662,Luitenant Lippenslaan 200,2023-01-23,16:00:00,191,96,95,FMN 15 Luitenant Lippenslaan
662,Luitenant Lippenslaan 200,2023-01-23,17:00:00,207,101,106,FMN 15 Luitenant Lippenslaan
662,Luitenant Lippenslaan 200,2023-01-23,18:00:00,187,93,94,FMN 15 Luitenant Lippenslaan
662,Luitenant Lippenslaan 200,2023-01-23,19:00:00,135,66,69,FMN 15 Luitenant Lippenslaan
662,Luitenant Lippenslaan 200,2023-01-23,20:00:00,101,44,57,FMN 15 Luitenant Lippenslaan
662,Luitenant Lippenslaan 200,2023-01-23,21:00:00,65,33,32,FMN 15 Luitenant Lippenslaan
662,Luitenant Lippenslaan 200,2023-01-23,22:00:00,60,24,36,FMN 15 Luitenant Lippenslaan
662,Luitenant Lippenslaan 200,2023-01-23,23:00:00,26,6,20,FMN 15 Luitenant Lippenslaan
662,Luitenant Lippenslaan 200,2023-01-24,00:00:00,15,5,10,FMN 15 Luitenant Lippenslaan
662,Luitenant Lippenslaan 200,2023-01-24,01:00:00,7,2,5,FMN 15 Luitenant Lippenslaan
662,Luitenant Lippenslaan 200,2023-01-24,02:00:00,8,0,8,FMN 15 Luitenant Lippenslaan
662,Luitenant Lippenslaan 200,2023-01-24,03:00:00,6,3,3,FMN 15 Luitenant Lippenslaan
662,Luitenant Lippenslaan 200,2023-01-24,04:00:00,17,10,7,FMN 15 Luitenant Lippenslaan
662,Luitenant Lippenslaan 200,2023-01-24,05:00:00,31,19,12,FMN 15 Luitenant Lippenslaan
662,Luitenant Lippenslaan 200,2023-01-24,06:00:00,134,71,63,FMN 15 Luitenant Lippenslaan
662,Luitenant Lippenslaan 200,2023-01-24,07:00:00,369,185,184,FMN 15 Luitenant Lippenslaan
662,Luitenant Lippenslaan 200,2023-01-24,08:00:00,785,412,373,FMN 15 Luitenant Lippenslaan
662,Luitenant Lippenslaan 200,2023-01-24,09:00:00,272,136,136,FMN 15 Luitenant Lippenslaan
662,Luitenant Lippenslaan 200,2023-01-24,10:00:00,159,74,85,FMN 15 Luitenant Lippenslaan
662,Luitenant Lippenslaan 200,2023-01-24,11:00:00,130,56,74,FMN 15 Luitenant Lippenslaan
662,Luitenant Lippenslaan 200,2023-01-24,12:00:00,164,80,84,FMN 15 Luitenant Lippenslaan
662,Luitenant Lippenslaan 200,2023-01-24,13:00:00,143,59,84,FMN 15 Luitenant Lippenslaan
662,Luitenant Lippenslaan 200,2023-01-24,14:00:00,123,55,68,FMN 15 Luitenant Lippenslaan
662,Luitenant Lippenslaan 200,2023-01-24,15:00:00,160,71,89,FMN 15 Luitenant Lippenslaan
662,Luitenant Lippenslaan 200,2023-01-24,16:00:00,223,99,124,FMN 15 Luitenant Lippenslaan
662,Luitenant Lippenslaan 200,2023-01-24,17:00:00,234,109,125,FMN 15 Luitenant Lippenslaan
662,Luitenant Lippenslaan 200,2023-01-24,18:00:00,205,89,116,FMN 15 Luitenant Lippenslaan
662,Luitenant Lippenslaan 200,2023-01-24,19:00:00,153,80,73,FMN 15 Luitenant Lippenslaan
662,Luitenant Lippenslaan 200,2023-01-24,20:00:00,101,41,60,FMN 15 Luitenant Lippenslaan
662,Luitenant Lippenslaan 200,2023-01-24,21:00:00,73,22,51,FMN 15 Luitenant Lippenslaan
662,Luitenant Lippenslaan 200,2023-01-24,22:00:00,51,21,30,FMN 15 Luitenant Lippenslaan
662,Luitenant Lippenslaan 200,2023-01-24,23:00:00,29,8,21,FMN 15 Luitenant Lippenslaan
662,Luitenant Lippenslaan 200,2023-01-25,00:00:00,9,1,8,FMN 15 Luitenant Lippenslaan
662,Luitenant Lippenslaan 200,2023-01-25,01:00:00,8,3,5,FMN 15 Luitenant Lippenslaan
662,Luitenant Lippenslaan 200,2023-01-25,02:00:00,7,1,6,FMN 15 Luitenant Lippenslaan
662,Luitenant Lippenslaan 200,2023-01-25,03:00:00,3,1,2,FMN 15 Luitenant Lippenslaan
662,Luitenant Lippenslaan 200,2023-01-25,04:00:00,18,10,8,FMN 15 Luitenant Lippenslaan
662,Luitenant Lippenslaan 200,2023-01-25,05:00:00,46,25,21,FMN 15 Luitenant Lippenslaan
662,Luitenant Lippenslaan 200,2023-01-25,06:00:00,111,54,57,FMN 15 Luitenant Lippenslaan
662,Luitenant Lippenslaan 200,2023-01-25,07:00:00,315,161,154,FMN 15 Luitenant Lippenslaan
662,Luitenant Lippenslaan 200,2023-01-25,08:00:00,608,336,272,FMN 15 Luitenant Lippenslaan
662,Luitenant Lippenslaan 200,2023-01-25,09:00:00,222,111,111,FMN 15 Luitenant Lippenslaan
662,Luitenant Lippenslaan 200,2023-01-25,10:00:00,157,78,79,FMN 15 Luitenant Lippenslaan
662,Luitenant Lippenslaan 200,2023-01-25,11:00:00,115,45,70,FMN 15 Luitenant Lippenslaan
662,Luitenant Lippenslaan 200,2023-01-25,12:00:00,194,96,98,FMN 15 Luitenant Lippenslaan
662,Luitenant Lippenslaan 200,2023-01-25,13:00:00,166,81,85,FMN 15 Luitenant Lippenslaan
662,Luitenant Lippenslaan 200,2023-01-25,14:00:00,139,70,69,FMN 15 Luitenant Lippenslaan
662,Luitenant Lippenslaan 200,2023-01-25,15:00:00,137,59,78,FMN 15 Luitenant Lippenslaan
662,Luitenant Lippenslaan 200,2023-01-25,16:00:00,191,94,97,FMN 15 Luitenant Lippenslaan
662,Luitenant Lippenslaan 200,2023-01-25,17:00:00,230,102,128,FMN 15 Luitenant Lippenslaan
662,Luitenant Lippenslaan 200,2023-01-25,18:00:00,178,80,98,FMN 15 Luitenant Lippenslaan
662,Luitenant Lippenslaan 200,2023-01-25,19:00:00,151,65,86,FMN 15 Luitenant Lippenslaan
662,Luitenant Lippenslaan 200,2023-01-25,20:00:00,87,43,44,FMN 15 Luitenant Lippenslaan
662,Luitenant Lippenslaan 200,2023-01-25,21:00:00,60,29,31,FMN 15 Luitenant Lippenslaan
662,Luitenant Lippenslaan 200,2023-01-25,22:00:00,50,19,31,FMN 15 Luitenant Lippenslaan
662,Luitenant Lippenslaan 200,2023-01-25,23:00:00,33,10,23,FMN 15 Luitenant Lippenslaan
662,Luitenant Lippenslaan 200,2023-01-26,00:00:00,15,4,11,FMN 15 Luitenant Lippenslaan
662,Luitenant Lippenslaan 200,2023-01-26,01:00:00,8,3,5,FMN 15 Luitenant Lippenslaan
662,Luitenant Lippenslaan 200,2023-01-26,02:00:00,6,0,6,FMN 15 Luitenant Lippenslaan
662,Luitenant Lippenslaan 200,2023-01-26,03:00:00,6,3,3,FMN 15 Luitenant Lippenslaan
662,Luitenant Lippenslaan 200,2023-01-26,04:00:00,12,5,7,FMN 15 Luitenant Lippenslaan
662,Luitenant Lippenslaan 200,2023-01-26,05:00:00,24,14,10,FMN 15 Luitenant Lippenslaan
662,Luitenant Lippenslaan 200,2023-01-26,06:00:00,100,53,47,FMN 15 Luitenant Lippenslaan
662,Luitenant Lippenslaan 200,2023-01-26,07:00:00,294,149,145,FMN 15 Luitenant Lippenslaan
662,Luitenant Lippenslaan 200,2023-01-26,08:00:00,558,276,282,FMN 15 Luitenant Lippenslaan
662,Luitenant Lippenslaan 200,2023-01-26,09:00:00,230,107,123,FMN 15 Luitenant Lippenslaan
662,Luitenant Lippenslaan 200,2023-01-26,10:00:00,129,63,66,FMN 15 Luitenant Lippenslaan
662,Luitenant Lippenslaan 200,2023-01-26,11:00:00,111,50,61,FMN 15 Luitenant Lippenslaan
662,Luitenant Lippenslaan 200,2023-01-26,12:00:00,155,87,68,FMN 15 Luitenant Lippenslaan
662,Luitenant Lippenslaan 200,2023-01-26,13:00:00,133,70,63,FMN 15 Luitenant Lippenslaan
662,Luitenant Lippenslaan 200,2023-01-26,14:00:00,124,64,60,FMN 15 Luitenant Lippenslaan
662,Luitenant Lippenslaan 200,2023-01-26,15:00:00,149,65,84,FMN 15 Luitenant Lippenslaan
662,Luitenant Lippenslaan 200,2023-01-26,16:00:00,235,114,121,FMN 15 Luitenant Lippenslaan
662,Luitenant Lippenslaan 200,2023-01-26,17:00:00,252,127,125,FMN 15 Luitenant Lippenslaan
662,Luitenant Lippenslaan 200,2023-01-26,18:00:00,239,114,125,FMN 15 Luitenant Lippenslaan
662,Luitenant Lippenslaan 200,2023-01-26,19:00:00,176,77,99,FMN 15 Luitenant Lippenslaan
662,Luitenant Lippenslaan 200,2023-01-26,20:00:00,98,40,58,FMN 15 Luitenant Lippenslaan
662,Luitenant Lippenslaan 200,2023-01-26,21:00:00,71,25,46,FMN 15 Luitenant Lippenslaan
662,Luitenant Lippenslaan 200,2023-01-26,22:00:00,60,22,38,FMN 15 Luitenant Lippenslaan
662,Luitenant Lippenslaan 200,2023-01-26,23:00:00,24,5,19,FMN 15 Luitenant Lippenslaan
662,Luitenant Lippenslaan 200,2023-01-27,00:00:00,18,6,12,FMN 15 Luitenant Lippenslaan
662,Luitenant Lippenslaan 200,2023-01-27,01:00:00,6,2,4,FMN 15 Luitenant Lippenslaan
662,Luitenant Lippenslaan 200,2023-01-27,02:00:00,5,0,5,FMN 15 Luitenant Lippenslaan
662,Luitenant Lippenslaan 200,2023-01-27,03:00:00,1,0,1,FMN 15 Luitenant Lippenslaan
662,Luitenant Lippenslaan 200,2023-01-27,04:00:00,18,9,9,FMN 15 Luitenant Lippenslaan
662,Luitenant Lippenslaan 200,2023-01-27,05:00:00,25,13,12,FMN 15 Luitenant Lippenslaan
662,Luitenant Lippenslaan 200,2023-01-27,06:00:00,89,57,32,FMN 15 Luitenant Lippenslaan
662,Luitenant Lippenslaan 200,2023-01-27,07:00:00,245,125,120,FMN 15 Luitenant Lippenslaan
662,Luitenant Lippenslaan 200,2023-01-27,08:00:00,554,312,242,FMN 15 Luitenant Lippenslaan
662,Luitenant Lippenslaan 200,2023-01-27,09:00:00,238,135,103,FMN 15 Luitenant Lippenslaan
662,Luitenant Lippenslaan 200,2023-01-27,10:00:00,152,82,70,FMN 15 Luitenant Lippenslaan
662,Luitenant Lippenslaan 200,2023-01-27,11:00:00,124,61,63,FMN 15 Luitenant Lippenslaan
662,Luitenant Lippenslaan 200,2023-01-27,12:00:00,165,81,84,FMN 15 Luitenant Lippenslaan
662,Luitenant Lippenslaan 200,2023-01-27,13:00:00,139,64,75,FMN 15 Luitenant Lippenslaan
662,Luitenant Lippenslaan 200,2023-01-27,14:00:00,127,61,66,FMN 15 Luitenant Lippenslaan
662,Luitenant Lippenslaan 200,2023-01-27,15:00:00,177,87,90,FMN 15 Luitenant Lippenslaan
662,Luitenant Lippenslaan 200,2023-01-27,16:00:00,213,107,106,FMN 15 Luitenant Lippenslaan
662,Luitenant Lippenslaan 200,2023-01-27,17:00:00,233,121,112,FMN 15 Luitenant Lippenslaan
662,Luitenant Lippenslaan 200,2023-01-27,18:00:00,226,114,112,FMN 15 Luitenant Lippenslaan
662,Luitenant Lippenslaan 200,2023-01-27,19:00:00,187,81,106,FMN 15 Luitenant Lippenslaan
662,Luitenant Lippenslaan 200,2023-01-27,20:00:00,120,62,58,FMN 15 Luitenant Lippenslaan
662,Luitenant Lippenslaan 200,2023-01-27,21:00:00,90,38,52,FMN 15 Luitenant Lippenslaan
662,Luitenant Lippenslaan 200,2023-01-27,22:00:00,58,23,35,FMN 15 Luitenant Lippenslaan
662,Luitenant Lippenslaan 200,2023-01-27,23:00:00,51,26,25,FMN 15 Luitenant Lippenslaan
662,Luitenant Lippenslaan 200,2023-01-28,00:00:00,27,11,16,FMN 15 Luitenant Lippenslaan
662,Luitenant Lippenslaan 200,2023-01-28,01:00:00,32,18,14,FMN 15 Luitenant Lippenslaan
662,Luitenant Lippenslaan 200,2023-01-28,02:00:00,10,6,4,FMN 15 Luitenant Lippenslaan
662,Luitenant Lippenslaan 200,2023-01-28,03:00:00,12,8,4,FMN 15 Luitenant Lippenslaan
662,Luitenant Lippenslaan 200,2023-01-28,04:00:00,12,5,7,FMN 15 Luitenant Lippenslaan
662,Luitenant Lippenslaan 200,2023-01-28,05:00:00,18,7,11,FMN 15 Luitenant Lippenslaan
662,Luitenant Lippenslaan 200,2023-01-28,06:00:00,34,15,19,FMN 15 Luitenant Lippenslaan
662,Luitenant Lippenslaan 200,2023-01-28,07:00:00,35,14,21,FMN 15 Luitenant Lippenslaan
662,Luitenant Lippenslaan 200,2023-01-28,08:00:00,113,69,44,FMN 15 Luitenant Lippenslaan
662,Luitenant Lippenslaan 200,2023-01-28,09:00:00,155,72,83,FMN 15 Luitenant Lippenslaan
662,Luitenant Lippenslaan 200,2023-01-28,10:00:00,179,82,97,FMN 15 Luitenant Lippenslaan
662,Luitenant Lippenslaan 200,2023-01-28,11:00:00,177,91,86,FMN 15 Luitenant Lippenslaan
662,Luitenant Lippenslaan 200,2023-01-28,12:00:00,176,98,78,FMN 15 Luitenant Lippenslaan
662,Luitenant Lippenslaan 200,2023-01-28,13:00:00,195,98,97,FMN 15 Luitenant Lippenslaan
662,Luitenant Lippenslaan 200,2023-01-28,14:00:00,205,110,95,FMN 15 Luitenant Lippenslaan
662,Luitenant Lippenslaan 200,2023-01-28,15:00:00,166,82,84,FMN 15 Luitenant Lippenslaan
662,Luitenant Lippenslaan 200,2023-01-28,16:00:00,162,95,67,FMN 15 Luitenant Lippenslaan
662,Luitenant Lippenslaan 200,2023-01-28,17:00:00,170,75,95,FMN 15 Luitenant Lippenslaan
662,Luitenant Lippenslaan 200,2023-01-28,18:00:00,181,90,91,FMN 15 Luitenant Lippenslaan
662,Luitenant Lippenslaan 200,2023-01-28,19:00:00,167,89,78,FMN 15 Luitenant Lippenslaan
662,Luitenant Lippenslaan 200,2023-01-28,20:00:00,101,46,55,FMN 15 Luitenant Lippenslaan
662,Luitenant Lippenslaan 200,2023-01-28,21:00:00,83,38,45,FMN 15 Luitenant Lippenslaan
662,Luitenant Lippenslaan 200,2023-01-28,22:00:00,60,23,37,FMN 15 Luitenant Lippenslaan
662,Luitenant Lippenslaan 200,2023-01-28,23:00:00,44,12,32,FMN 15 Luitenant Lippenslaan
662,Luitenant Lippenslaan 200,2023-01-29,00:00:00,30,10,20,FMN 15 Luitenant Lippenslaan
662,Luitenant Lippenslaan 200,2023-01-29,01:00:00,16,9,7,FMN 15 Luitenant Lippenslaan
662,Luitenant Lippenslaan 200,2023-01-29,02:00:00,4,1,3,FMN 15 Luitenant Lippenslaan
662,Luitenant Lippenslaan 200,2023-01-29,03:00:00,5,4,1,FMN 15 Luitenant Lippenslaan
662,Luitenant Lippenslaan 200,2023-01-29,04:00:00,2,1,1,FMN 15 Luitenant Lippenslaan
662,Luitenant Lippenslaan 200,2023-01-29,05:00:00,7,3,4,FMN 15 Luitenant Lippenslaan
662,Luitenant Lippenslaan 200,2023-01-29,06:00:00,19,8,11,FMN 15 Luitenant Lippenslaan
662,Luitenant Lippenslaan 200,2023-01-29,07:00:00,27,11,16,FMN 15 Luitenant Lippenslaan
662,Luitenant Lippenslaan 200,2023-01-29,08:00:00,54,24,30,FMN 15 Luitenant Lippenslaan
662,Luitenant Lippenslaan 200,2023-01-29,09:00:00,106,52,54,FMN 15 Luitenant Lippenslaan
662,Luitenant Lippenslaan 200,2023-01-29,10:00:00,103,43,60,FMN 15 Luitenant Lippenslaan
662,Luitenant Lippenslaan 200,2023-01-29,11:00:00,120,53,67,FMN 15 Luitenant Lippenslaan
662,Luitenant Lippenslaan 200,2023-01-29,12:00:00,146,77,69,FMN 15 Luitenant Lippenslaan
662,Luitenant Lippenslaan 200,2023-01-29,13:00:00,142,73,69,FMN 15 Luitenant Lippenslaan
662,Luitenant Lippenslaan 200,2023-01-29,14:00:00,148,73,75,FMN 15 Luitenant Lippenslaan
662,Luitenant Lippenslaan 200,2023-01-29,15:00:00,135,71,64,FMN 15 Luitenant Lippenslaan
662,Luitenant Lippenslaan 200,2023-01-29,16:00:00,100,53,47,FMN 15 Luitenant Lippenslaan
662,Luitenant Lippenslaan 200,2023-01-29,17:00:00,107,53,54,FMN 15 Luitenant Lippenslaan
662,Luitenant Lippenslaan 200,2023-01-29,18:00:00,118,55,63,FMN 15 Luitenant Lippenslaan
662,Luitenant Lippenslaan 200,2023-01-29,19:00:00,96,47,49,FMN 15 Luitenant Lippenslaan
662,Luitenant Lippenslaan 200,2023-01-29,20:00:00,57,31,26,FMN 15 Luitenant Lippenslaan
662,Luitenant Lippenslaan 200,2023-01-29,21:00:00,67,25,42,FMN 15 Luitenant Lippenslaan
662,Luitenant Lippenslaan 200,2023-01-29,22:00:00,37,10,27,FMN 15 Luitenant Lippenslaan
662,Luitenant Lippenslaan 200,2023-01-29,23:00:00,20,9,11,FMN 15 Luitenant Lippenslaan
662,Luitenant Lippenslaan 200,2023-01-30,00:00:00,12,6,6,FMN 15 Luitenant Lippenslaan
662,Luitenant Lippenslaan 200,2023-01-30,01:00:00,6,2,4,FMN 15 Luitenant Lippenslaan
662,Luitenant Lippenslaan 200,2023-01-30,02:00:00,4,1,3,FMN 15 Luitenant Lippenslaan
662,Luitenant Lippenslaan 200,2023-01-30,03:00:00,2,1,1,FMN 15 Luitenant Lippenslaan
662,Luitenant Lippenslaan 200,2023-01-30,04:00:00,15,7,8,FMN 15 Luitenant Lippenslaan
662,Luitenant Lippenslaan 200,2023-01-30,05:00:00,25,12,13,FMN 15 Luitenant Lippenslaan
662,Luitenant Lippenslaan 200,2023-01-30,06:00:00,93,59,34,FMN 15 Luitenant Lippenslaan
662,Luitenant Lippenslaan 200,2023-01-30,07:00:00,290,165,125,FMN 15 Luitenant Lippenslaan
662,Luitenant Lippenslaan 200,2023-01-30,08:00:00,602,326,276,FMN 15 Luitenant Lippenslaan
662,Luitenant Lippenslaan 200,2023-01-30,09:00:00,237,134,103,FMN 15 Luitenant Lippenslaan
662,Luitenant Lippenslaan 200,2023-01-30,10:00:00,167,103,64,FMN 15 Luitenant Lippenslaan
662,Luitenant Lippenslaan 200,2023-01-30,11:00:00,103,47,56,FMN 15 Luitenant Lippenslaan
662,Luitenant Lippenslaan 200,2023-01-30,12:00:00,156,85,71,FMN 15 Luitenant Lippenslaan
662,Luitenant Lippenslaan 200,2023-01-30,13:00:00,123,62,61,FMN 15 Luitenant Lippenslaan
662,Luitenant Lippenslaan 200,2023-01-30,14:00:00,126,66,60,FMN 15 Luitenant Lippenslaan
662,Luitenant Lippenslaan 200,2023-01-30,15:00:00,128,71,57,FMN 15 Luitenant Lippenslaan
662,Luitenant Lippenslaan 200,2023-01-30,16:00:00,204,103,101,FMN 15 Luitenant Lippenslaan
662,Luitenant Lippenslaan 200,2023-01-30,17:00:00,225,128,97,FMN 15 Luitenant Lippenslaan
662,Luitenant Lippenslaan 200,2023-01-30,18:00:00,189,92,97,FMN 15 Luitenant Lippenslaan
662,Luitenant Lippenslaan 200,2023-01-30,19:00:00,141,71,70,FMN 15 Luitenant Lippenslaan
662,Luitenant Lippenslaan 200,2023-01-30,20:00:00,102,56,46,FMN 15 Luitenant Lippenslaan
662,Luitenant Lippenslaan 200,2023-01-30,21:00:00,66,37,29,FMN 15 Luitenant Lippenslaan
662,Luitenant Lippenslaan 200,2023-01-30,22:00:00,65,27,38,FMN 15 Luitenant Lippenslaan
662,Luitenant Lippenslaan 200,2023-01-30,23:00:00,22,14,8,FMN 15 Luitenant Lippenslaan
662,Luitenant Lippenslaan 200,2023-01-31,00:00:00,7,3,4,FMN 15 Luitenant Lippenslaan
662,Luitenant Lippenslaan 200,2023-01-31,01:00:00,4,2,2,FMN 15 Luitenant Lippenslaan
662,Luitenant Lippenslaan 200,2023-01-31,02:00:00,1,0,1,FMN 15 Luitenant Lippenslaan
662,Luitenant Lippenslaan 200,2023-01-31,03:00:00,2,1,1,FMN 15 Luitenant Lippenslaan
662,Luitenant Lippenslaan 200,2023-01-31,04:00:00,13,8,5,FMN 15 Luitenant Lippenslaan
662,Luitenant Lippenslaan 200,2023-01-31,05:00:00,26,13,13,FMN 15 Luitenant Lippenslaan
662,Luitenant Lippenslaan 200,2023-01-31,06:00:00,122,64,58,FMN 15 Luitenant Lippenslaan
662,Luitenant Lippenslaan 200,2023-01-31,07:00:00,330,176,154,FMN 15 Luitenant Lippenslaan
662,Luitenant Lippenslaan 200,2023-01-31,08:00:00,775,435,340,FMN 15 Luitenant Lippenslaan
662,Luitenant Lippenslaan 200,2023-01-31,09:00:00,268,153,115,FMN 15 Luitenant Lippenslaan
662,Luitenant Lippenslaan 200,2023-01-31,10:00:00,131,65,66,FMN 15 Luitenant Lippenslaan
662,Luitenant Lippenslaan 200,2023-01-31,11:00:00,129,69,60,FMN 15 Luitenant Lippenslaan
662,Luitenant Lippenslaan 200,2023-01-31,12:00:00,168,91,77,FMN 15 Luitenant Lippenslaan
662,Luitenant Lippenslaan 200,2023-01-31,13:00:00,141,72,69,FMN 15 Luitenant Lippenslaan
662,Luitenant Lippenslaan 200,2023-01-31,14:00:00,96,50,46,FMN 15 Luitenant Lippenslaan
662,Luitenant Lippenslaan 200,2023-01-31,15:00:00,141,67,74,FMN 15 Luitenant Lippenslaan
662,Luitenant Lippenslaan 200,2023-01-31,16:00:00,203,110,93,FMN 15 Luitenant Lippenslaan
662,Luitenant Lippenslaan 200,2023-01-31,17:00:00,223,124,99,FMN 15 Luitenant Lippenslaan
662,Luitenant Lippenslaan 200,2023-01-31,18:00:00,174,76,98,FMN 15 Luitenant Lippenslaan
662,Luitenant Lippenslaan 200,2023-01-31,19:00:00,144,63,81,FMN 15 Luitenant Lippenslaan
662,Luitenant Lippenslaan 200,2023-01-31,20:00:00,92,49,43,FMN 15 Luitenant Lippenslaan
662,Luitenant Lippenslaan 200,2023-01-31,21:00:00,63,26,37,FMN 15 Luitenant Lippenslaan
662,Luitenant Lippenslaan 200,2023-01-31,22:00:00,51,23,28,FMN 15 Luitenant Lippenslaan
662,Luitenant Lippenslaan 200,2023-01-31,23:00:00,32,13,19,FMN 15 Luitenant Lippenslaan
662,Luitenant Lippenslaan 200,2023-02-01,00:00:00,0,0,0,FMN 15 Luitenant Lippenslaan
662,Luitenant Lippenslaan 200,2023-02-01,01:00:00,3,2,1,FMN 15 Luitenant Lippenslaan
662,Luitenant Lippenslaan 200,2023-02-01,02:00:00,4,1,3,FMN 15 Luitenant Lippenslaan
662,Luitenant Lippenslaan 200,2023-02-01,03:00:00,6,4,2,FMN 15 Luitenant Lippenslaan
662,Luitenant Lippenslaan 200,2023-02-01,04:00:00,14,9,5,FMN 15 Luitenant Lippenslaan
662,Luitenant Lippenslaan 200,2023-02-01,05:00:00,35,24,11,FMN 15 Luitenant Lippenslaan
662,Luitenant Lippenslaan 200,2023-02-01,06:00:00,92,53,39,FMN 15 Luitenant Lippenslaan
662,Luitenant Lippenslaan 200,2023-02-01,07:00:00,264,159,105,FMN 15 Luitenant Lippenslaan
662,Luitenant Lippenslaan 200,2023-02-01,08:00:00,521,326,195,FMN 15 Luitenant Lippenslaan
662,Luitenant Lippenslaan 200,2023-02-01,09:00:00,209,126,83,FMN 15 Luitenant Lippenslaan
662,Luitenant Lippenslaan 200,2023-02-01,10:00:00,125,71,54,FMN 15 Luitenant Lippenslaan
662,Luitenant Lippenslaan 200,2023-02-01,11:00:00,121,71,50,FMN 15 Luitenant Lippenslaan
662,Luitenant Lippenslaan 200,2023-02-01,12:00:00,180,103,77,FMN 15 Luitenant Lippenslaan
662,Luitenant Lippenslaan 200,2023-02-01,13:00:00,156,86,70,FMN 15 Luitenant Lippenslaan
662,Luitenant Lippenslaan 200,2023-02-01,14:00:00,135,82,53,FMN 15 Luitenant Lippenslaan
662,Luitenant Lippenslaan 200,2023-02-01,15:00:00,146,81,65,FMN 15 Luitenant Lippenslaan
662,Luitenant Lippenslaan 200,2023-02-01,16:00:00,181,100,81,FMN 15 Luitenant Lippenslaan
662,Luitenant Lippenslaan 200,2023-02-01,17:00:00,213,113,100,FMN 15 Luitenant Lippenslaan
662,Luitenant Lippenslaan 200,2023-02-01,18:00:00,167,80,87,FMN 15 Luitenant Lippenslaan
662,Luitenant Lippenslaan 200,2023-02-01,19:00:00,146,81,65,FMN 15 Luitenant Lippenslaan
662,Luitenant Lippenslaan 200,2023-02-01,20:00:00,91,49,42,FMN 15 Luitenant Lippenslaan
662,Luitenant Lippenslaan 200,2023-02-01,21:00:00,66,36,30,FMN 15 Luitenant Lippenslaan
662,Luitenant Lippenslaan 200,2023-02-01,22:00:00,50,27,23,FMN 15 Luitenant Lippenslaan
662,Luitenant Lippenslaan 200,2023-02-01,23:00:00,31,19,12,FMN 15 Luitenant Lippenslaan
662,Luitenant Lippenslaan 200,2023-02-02,00:00:00,0,0,0,FMN 15 Luitenant Lippenslaan
662,Luitenant Lippenslaan 200,2023-02-02,01:00:00,5,3,2,FMN 15 Luitenant Lippenslaan
662,Luitenant Lippenslaan 200,2023-02-02,02:00:00,5,3,2,FMN 15 Luitenant Lippenslaan
662,Luitenant Lippenslaan 200,2023-02-02,03:00:00,3,2,1,FMN 15 Luitenant Lippenslaan
662,Luitenant Lippenslaan 200,2023-02-02,04:00:00,11,5,6,FMN 15 Luitenant Lippenslaan
662,Luitenant Lippenslaan 200,2023-02-02,05:00:00,23,12,11,FMN 15 Luitenant Lippenslaan
662,Luitenant Lippenslaan 200,2023-02-02,06:00:00,90,48,42,FMN 15 Luitenant Lippenslaan
662,Luitenant Lippenslaan 200,2023-02-02,07:00:00,272,180,92,FMN 15 Luitenant Lippenslaan
662,Luitenant Lippenslaan 200,2023-02-02,08:00:00,551,343,208,FMN 15 Luitenant Lippenslaan
662,Luitenant Lippenslaan 200,2023-02-02,09:00:00,254,152,102,FMN 15 Luitenant Lippenslaan
662,Luitenant Lippenslaan 200,2023-02-02,10:00:00,112,69,43,FMN 15 Luitenant Lippenslaan
662,Luitenant Lippenslaan 200,2023-02-02,11:00:00,111,70,41,FMN 15 Luitenant Lippenslaan
662,Luitenant Lippenslaan 200,2023-02-02,12:00:00,128,81,47,FMN 15 Luitenant Lippenslaan
662,Luitenant Lippenslaan 200,2023-02-02,13:00:00,110,66,44,FMN 15 Luitenant Lippenslaan
662,Luitenant Lippenslaan 200,2023-02-02,14:00:00,107,63,44,FMN 15 Luitenant Lippenslaan
662,Luitenant Lippenslaan 200,2023-02-02,15:00:00,119,63,56,FMN 15 Luitenant Lippenslaan
662,Luitenant Lippenslaan 200,2023-02-02,16:00:00,181,104,77,FMN 15 Luitenant Lippenslaan
662,Luitenant Lippenslaan 200,2023-02-02,17:00:00,216,121,95,FMN 15 Luitenant Lippenslaan
662,Luitenant Lippenslaan 200,2023-02-02,18:00:00,193,113,80,FMN 15 Luitenant Lippenslaan
662,Luitenant Lippenslaan 200,2023-02-02,19:00:00,156,95,61,FMN 15 Luitenant Lippenslaan
662,Luitenant Lippenslaan 200,2023-02-02,20:00:00,90,49,41,FMN 15 Luitenant Lippenslaan
662,Luitenant Lippenslaan 200,2023-02-02,21:00:00,59,33,26,FMN 15 Luitenant Lippenslaan
662,Luitenant Lippenslaan 200,2023-02-02,22:00:00,49,26,23,FMN 15 Luitenant Lippenslaan
662,Luitenant Lippenslaan 200,2023-02-02,23:00:00,22,12,10,FMN 15 Luitenant Lippenslaan
662,Luitenant Lippenslaan 200,2023-02-03,00:00:00,0,0,0,FMN 15 Luitenant Lippenslaan
662,Luitenant Lippenslaan 200,2023-02-03,01:00:00,9,1,8,FMN 15 Luitenant Lippenslaan
662,Luitenant Lippenslaan 200,2023-02-03,02:00:00,10,3,7,FMN 15 Luitenant Lippenslaan
662,Luitenant Lippenslaan 200,2023-02-03,03:00:00,5,1,4,FMN 15 Luitenant Lippenslaan
662,Luitenant Lippenslaan 200,2023-02-03,04:00:00,17,4,13,FMN 15 Luitenant Lippenslaan
662,Luitenant Lippenslaan 200,2023-02-03,05:00:00,37,10,27,FMN 15 Luitenant Lippenslaan
662,Luitenant Lippenslaan 200,2023-02-03,06:00:00,79,22,57,FMN 15 Luitenant Lippenslaan
662,Luitenant Lippenslaan 200,2023-02-03,07:00:00,264,55,209,FMN 15 Luitenant Lippenslaan
662,Luitenant Lippenslaan 200,2023-02-03,08:00:00,528,92,436,FMN 15 Luitenant Lippenslaan
662,Luitenant Lippenslaan 200,2023-02-03,09:00:00,231,61,170,FMN 15 Luitenant Lippenslaan
662,Luitenant Lippenslaan 200,2023-02-03,10:00:00,168,43,125,FMN 15 Luitenant Lippenslaan
662,Luitenant Lippenslaan 200,2023-02-03,11:00:00,154,46,108,FMN 15 Luitenant Lippenslaan
662,Luitenant Lippenslaan 200,2023-02-03,12:00:00,188,55,133,FMN 15 Luitenant Lippenslaan
662,Luitenant Lippenslaan 200,2023-02-03,13:00:00,168,51,117,FMN 15 Luitenant Lippenslaan
662,Luitenant Lippenslaan 200,2023-02-03,14:00:00,134,32,102,FMN 15 Luitenant Lippenslaan
662,Luitenant Lippenslaan 200,2023-02-03,15:00:00,181,52,129,FMN 15 Luitenant Lippenslaan
662,Luitenant Lippenslaan 200,2023-02-03,16:00:00,225,64,161,FMN 15 Luitenant Lippenslaan
662,Luitenant Lippenslaan 200,2023-02-03,17:00:00,240,59,181,FMN 15 Luitenant Lippenslaan
662,Luitenant Lippenslaan 200,2023-02-03,18:00:00,236,58,178,FMN 15 Luitenant Lippenslaan
662,Luitenant Lippenslaan 200,2023-02-03,19:00:00,210,50,160,FMN 15 Luitenant Lippenslaan
662,Luitenant Lippenslaan 200,2023-02-03,20:00:00,125,30,95,FMN 15 Luitenant Lippenslaan
662,Luitenant Lippenslaan 200,2023-02-03,21:00:00,95,23,72,FMN 15 Luitenant Lippenslaan
662,Luitenant Lippenslaan 200,2023-02-03,22:00:00,65,16,49,FMN 15 Luitenant Lippenslaan
662,Luitenant Lippenslaan 200,2023-02-03,23:00:00,45,9,36,FMN 15 Luitenant Lippenslaan
662,Luitenant Lippenslaan 200,2023-02-04,00:00:00,0,0,0,FMN 15 Luitenant Lippenslaan
662,Luitenant Lippenslaan 200,2023-02-04,01:00:00,17,5,12,FMN 15 Luitenant Lippenslaan
662,Luitenant Lippenslaan 200,2023-02-04,02:00:00,15,4,11,FMN 15 Luitenant Lippenslaan
662,Luitenant Lippenslaan 200,2023-02-04,03:00:00,6,5,1,FMN 15 Luitenant Lippenslaan
662,Luitenant Lippenslaan 200,2023-02-04,04:00:00,12,3,9,FMN 15 Luitenant Lippenslaan
662,Luitenant Lippenslaan 200,2023-02-04,05:00:00,13,3,10,FMN 15 Luitenant Lippenslaan
662,Luitenant Lippenslaan 200,2023-02-04,06:00:00,32,12,20,FMN 15 Luitenant Lippenslaan
662,Luitenant Lippenslaan 200,2023-02-04,07:00:00,38,13,25,FMN 15 Luitenant Lippenslaan
662,Luitenant Lippenslaan 200,2023-02-04,08:00:00,71,20,51,FMN 15 Luitenant Lippenslaan
662,Luitenant Lippenslaan 200,2023-02-04,09:00:00,113,26,87,FMN 15 Luitenant Lippenslaan
662,Luitenant Lippenslaan 200,2023-02-04,10:00:00,151,39,112,FMN 15 Luitenant Lippenslaan
662,Luitenant Lippenslaan 200,2023-02-04,11:00:00,145,33,112,FMN 15 Luitenant Lippenslaan
662,Luitenant Lippenslaan 200,2023-02-04,12:00:00,149,44,105,FMN 15 Luitenant Lippenslaan
662,Luitenant Lippenslaan 200,2023-02-04,13:00:00,182,51,131,FMN 15 Luitenant Lippenslaan
662,Luitenant Lippenslaan 200,2023-02-04,14:00:00,153,39,114,FMN 15 Luitenant Lippenslaan
662,Luitenant Lippenslaan 200,2023-02-04,15:00:00,134,28,106,FMN 15 Luitenant Lippenslaan
662,Luitenant Lippenslaan 200,2023-02-04,16:00:00,129,40,89,FMN 15 Luitenant Lippenslaan
662,Luitenant Lippenslaan 200,2023-02-04,17:00:00,146,38,108,FMN 15 Luitenant Lippenslaan
662,Luitenant Lippenslaan 200,2023-02-04,18:00:00,159,41,118,FMN 15 Luitenant Lippenslaan
662,Luitenant Lippenslaan 200,2023-02-04,19:00:00,131,39,92,FMN 15 Luitenant Lippenslaan
662,Luitenant Lippenslaan 200,2023-02-04,20:00:00,103,29,74,FMN 15 Luitenant Lippenslaan
662,Luitenant Lippenslaan 200,2023-02-04,21:00:00,56,10,46,FMN 15 Luitenant Lippenslaan
662,Luitenant Lippenslaan 200,2023-02-04,22:00:00,47,11,36,FMN 15 Luitenant Lippenslaan
662,Luitenant Lippenslaan 200,2023-02-04,23:00:00,47,16,31,FMN 15 Luitenant Lippenslaan
662,Luitenant Lippenslaan 200,2023-02-05,00:00:00,0,0,0,FMN 15 Luitenant Lippenslaan
662,Luitenant Lippenslaan 200,2023-02-05,01:00:00,25,9,16,FMN 15 Luitenant Lippenslaan
662,Luitenant Lippenslaan 200,2023-02-05,02:00:00,18,7,11,FMN 15 Luitenant Lippenslaan
662,Luitenant Lippenslaan 200,2023-02-05,03:00:00,13,4,9,FMN 15 Luitenant Lippenslaan
662,Luitenant Lippenslaan 200,2023-02-05,04:00:00,13,6,7,FMN 15 Luitenant Lippenslaan
662,Luitenant Lippenslaan 200,2023-02-05,05:00:00,11,2,9,FMN 15 Luitenant Lippenslaan
662,Luitenant Lippenslaan 200,2023-02-05,06:00:00,22,9,13,FMN 15 Luitenant Lippenslaan
662,Luitenant Lippenslaan 200,2023-02-05,07:00:00,19,6,13,FMN 15 Luitenant Lippenslaan
662,Luitenant Lippenslaan 200,2023-02-05,08:00:00,36,10,26,FMN 15 Luitenant Lippenslaan
662,Luitenant Lippenslaan 200,2023-02-05,09:00:00,82,24,58,FMN 15 Luitenant Lippenslaan
662,Luitenant Lippenslaan 200,2023-02-05,10:00:00,97,30,67,FMN 15 Luitenant Lippenslaan
662,Luitenant Lippenslaan 200,2023-02-05,11:00:00,100,27,73,FMN 15 Luitenant Lippenslaan
662,Luitenant Lippenslaan 200,2023-02-05,12:00:00,114,41,73,FMN 15 Luitenant Lippenslaan
662,Luitenant Lippenslaan 200,2023-02-05,13:00:00,122,40,82,FMN 15 Luitenant Lippenslaan
662,Luitenant Lippenslaan 200,2023-02-05,14:00:00,126,50,76,FMN 15 Luitenant Lippenslaan
662,Luitenant Lippenslaan 200,2023-02-05,15:00:00,110,39,71,FMN 15 Luitenant Lippenslaan
662,Luitenant Lippenslaan 200,2023-02-05,16:00:00,100,23,77,FMN 15 Luitenant Lippenslaan
662,Luitenant Lippenslaan 200,2023-02-05,17:00:00,105,32,73,FMN 15 Luitenant Lippenslaan
662,Luitenant Lippenslaan 200,2023-02-05,18:00:00,94,21,73,FMN 15 Luitenant Lippenslaan
662,Luitenant Lippenslaan 200,2023-02-05,19:00:00,100,32,68,FMN 15 Luitenant Lippenslaan
662,Luitenant Lippenslaan 200,2023-02-05,20:00:00,52,18,34,FMN 15 Luitenant Lippenslaan
662,Luitenant Lippenslaan 200,2023-02-05,21:00:00,69,15,54,FMN 15 Luitenant Lippenslaan
662,Luitenant Lippenslaan 200,2023-02-05,22:00:00,41,15,26,FMN 15 Luitenant Lippenslaan
662,Luitenant Lippenslaan 200,2023-02-05,23:00:00,13,7,6,FMN 15 Luitenant Lippenslaan
662,Luitenant Lippenslaan 200,2023-02-06,00:00:00,0,0,0,FMN 15 Luitenant Lippenslaan
662,Luitenant Lippenslaan 200,2023-02-06,01:00:00,8,5,3,FMN 15 Luitenant Lippenslaan
662,Luitenant Lippenslaan 200,2023-02-06,02:00:00,5,1,4,FMN 15 Luitenant Lippenslaan
662,Luitenant Lippenslaan 200,2023-02-06,03:00:00,6,2,4,FMN 15 Luitenant Lippenslaan
662,Luitenant Lippenslaan 200,2023-02-06,04:00:00,19,5,14,FMN 15 Luitenant Lippenslaan
662,Luitenant Lippenslaan 200,2023-02-06,05:00:00,23,6,17,FMN 15 Luitenant Lippenslaan
662,Luitenant Lippenslaan 200,2023-02-06,06:00:00,93,29,64,FMN 15 Luitenant Lippenslaan
662,Luitenant Lippenslaan 200,2023-02-06,07:00:00,256,75,181,FMN 15 Luitenant Lippenslaan
662,Luitenant Lippenslaan 200,2023-02-06,08:00:00,549,160,389,FMN 15 Luitenant Lippenslaan
662,Luitenant Lippenslaan 200,2023-02-06,09:00:00,212,64,148,FMN 15 Luitenant Lippenslaan
662,Luitenant Lippenslaan 200,2023-02-06,10:00:00,137,44,93,FMN 15 Luitenant Lippenslaan
662,Luitenant Lippenslaan 200,2023-02-06,11:00:00,108,33,75,FMN 15 Luitenant Lippenslaan
662,Luitenant Lippenslaan 200,2023-02-06,12:00:00,170,59,111,FMN 15 Luitenant Lippenslaan
662,Luitenant Lippenslaan 200,2023-02-06,13:00:00,132,48,84,FMN 15 Luitenant Lippenslaan
662,Luitenant Lippenslaan 200,2023-02-06,14:00:00,119,34,85,FMN 15 Luitenant Lippenslaan
662,Luitenant Lippenslaan 200,2023-02-06,15:00:00,153,55,98,FMN 15 Luitenant Lippenslaan
662,Luitenant Lippenslaan 200,2023-02-06,16:00:00,225,63,162,FMN 15 Luitenant Lippenslaan
662,Luitenant Lippenslaan 200,2023-02-06,17:00:00,213,67,146,FMN 15 Luitenant Lippenslaan
662,Luitenant Lippenslaan 200,2023-02-06,18:00:00,176,46,130,FMN 15 Luitenant Lippenslaan
662,Luitenant Lippenslaan 200,2023-02-06,19:00:00,138,45,93,FMN 15 Luitenant Lippenslaan
662,Luitenant Lippenslaan 200,2023-02-06,20:00:00,89,25,64,FMN 15 Luitenant Lippenslaan
662,Luitenant Lippenslaan 200,2023-02-06,21:00:00,75,23,52,FMN 15 Luitenant Lippenslaan
662,Luitenant Lippenslaan 200,2023-02-06,22:00:00,56,12,44,FMN 15 Luitenant Lippenslaan
662,Luitenant Lippenslaan 200,2023-02-06,23:00:00,28,8,20,FMN 15 Luitenant Lippenslaan
662,Luitenant Lippenslaan 200,2023-02-07,00:00:00,0,0,0,FMN 15 Luitenant Lippenslaan
662,Luitenant Lippenslaan 200,2023-02-07,01:00:00,7,4,3,FMN 15 Luitenant Lippenslaan
662,Luitenant Lippenslaan 200,2023-02-07,02:00:00,6,3,3,FMN 15 Luitenant Lippenslaan
662,Luitenant Lippenslaan 200,2023-02-07,03:00:00,9,6,3,FMN 15 Luitenant Lippenslaan
662,Luitenant Lippenslaan 200,2023-02-07,04:00:00,10,2,8,FMN 15 Luitenant Lippenslaan
662,Luitenant Lippenslaan 200,2023-02-07,05:00:00,22,6,16,FMN 15 Luitenant Lippenslaan
662,Luitenant Lippenslaan 200,2023-02-07,06:00:00,110,33,77,FMN 15 Luitenant Lippenslaan
662,Luitenant Lippenslaan 200,2023-02-07,07:00:00,303,85,218,FMN 15 Luitenant Lippenslaan
662,Luitenant Lippenslaan 200,2023-02-07,08:00:00,618,168,450,FMN 15 Luitenant Lippenslaan
662,Luitenant Lippenslaan 200,2023-02-07,09:00:00,251,77,174,FMN 15 Luitenant Lippenslaan
662,Luitenant Lippenslaan 200,2023-02-07,10:00:00,145,38,107,FMN 15 Luitenant Lippenslaan
662,Luitenant Lippenslaan 200,2023-02-07,11:00:00,153,47,106,FMN 15 Luitenant Lippenslaan
662,Luitenant Lippenslaan 200,2023-02-07,12:00:00,169,67,102,FMN 15 Luitenant Lippenslaan
662,Luitenant Lippenslaan 200,2023-02-07,13:00:00,150,45,105,FMN 15 Luitenant Lippenslaan
662,Luitenant Lippenslaan 200,2023-02-07,14:00:00,121,31,90,FMN 15 Luitenant Lippenslaan
662,Luitenant Lippenslaan 200,2023-02-07,15:00:00,135,44,91,FMN 15 Luitenant Lippenslaan
662,Luitenant Lippenslaan 200,2023-02-07,16:00:00,205,71,134,FMN 15 Luitenant Lippenslaan
662,Luitenant Lippenslaan 200,2023-02-07,17:00:00,213,65,148,FMN 15 Luitenant Lippenslaan
662,Luitenant Lippenslaan 200,2023-02-07,18:00:00,168,57,111,FMN 15 Luitenant Lippenslaan
662,Luitenant Lippenslaan 200,2023-02-07,19:00:00,113,36,77,FMN 15 Luitenant Lippenslaan
662,Luitenant Lippenslaan 200,2023-02-07,20:00:00,74,23,51,FMN 15 Luitenant Lippenslaan
662,Luitenant Lippenslaan 200,2023-02-07,21:00:00,65,17,48,FMN 15 Luitenant Lippenslaan
662,Luitenant Lippenslaan 200,2023-02-07,22:00:00,55,13,42,FMN 15 Luitenant Lippenslaan
662,Luitenant Lippenslaan 200,2023-02-07,23:00:00,31,10,21,FMN 15 Luitenant Lippenslaan
662,Luitenant Lippenslaan 200,2023-02-08,00:00:00,3,2,1,FMN 15 Luitenant Lippenslaan
662,Luitenant Lippenslaan 200,2023-02-08,01:00:00,5,2,3,FMN 15 Luitenant Lippenslaan
662,Luitenant Lippenslaan 200,2023-02-08,02:00:00,8,5,3,FMN 15 Luitenant Lippenslaan
662,Luitenant Lippenslaan 200,2023-02-08,03:00:00,4,1,3,FMN 15 Luitenant Lippenslaan
662,Luitenant Lippenslaan 200,2023-02-08,04:00:00,8,0,8,FMN 15 Luitenant Lippenslaan
662,Luitenant Lippenslaan 200,2023-02-08,05:00:00,19,1,18,FMN 15 Luitenant Lippenslaan
662,Luitenant Lippenslaan 200,2023-02-08,06:00:00,53,7,46,FMN 15 Luitenant Lippenslaan
662,Luitenant Lippenslaan 200,2023-02-08,07:00:00,159,7,152,FMN 15 Luitenant Lippenslaan
662,Luitenant Lippenslaan 200,2023-02-08,08:00:00,299,8,291,FMN 15 Luitenant Lippenslaan
662,Luitenant Lippenslaan 200,2023-02-08,09:00:00,113,4,109,FMN 15 Luitenant Lippenslaan
662,Luitenant Lippenslaan 200,2023-02-08,10:00:00,84,4,80,FMN 15 Luitenant Lippenslaan
662,Luitenant Lippenslaan 200,2023-02-08,11:00:00,62,2,60,FMN 15 Luitenant Lippenslaan
662,Luitenant Lippenslaan 200,2023-02-08,12:00:00,136,25,111,FMN 15 Luitenant Lippenslaan
662,Luitenant Lippenslaan 200,2023-02-08,13:00:00,104,10,94,FMN 15 Luitenant Lippenslaan
662,Luitenant Lippenslaan 200,2023-02-08,14:00:00,79,6,73,FMN 15 Luitenant Lippenslaan
662,Luitenant Lippenslaan 200,2023-02-08,15:00:00,114,18,96,FMN 15 Luitenant Lippenslaan
662,Luitenant Lippenslaan 200,2023-02-08,16:00:00,119,8,111,FMN 15 Luitenant Lippenslaan
662,Luitenant Lippenslaan 200,2023-02-08,17:00:00,133,16,117,FMN 15 Luitenant Lippenslaan
662,Luitenant Lippenslaan 200,2023-02-08,18:00:00,119,16,103,FMN 15 Luitenant Lippenslaan
662,Luitenant Lippenslaan 200,2023-02-08,19:00:00,94,14,80,FMN 15 Luitenant Lippenslaan
662,Luitenant Lippenslaan 200,2023-02-08,20:00:00,47,5,42,FMN 15 Luitenant Lippenslaan
662,Luitenant Lippenslaan 200,2023-02-08,21:00:00,26,11,15,FMN 15 Luitenant Lippenslaan
662,Luitenant Lippenslaan 200,2023-02-08,22:00:00,39,7,32,FMN 15 Luitenant Lippenslaan
662,Luitenant Lippenslaan 200,2023-02-08,23:00:00,20,3,17,FMN 15 Luitenant Lippenslaan
662,Luitenant Lippenslaan 200,2023-02-09,00:00:00,9,4,5,FMN 15 Luitenant Lippenslaan
662,Luitenant Lippenslaan 200,2023-02-09,01:00:00,5,1,4,FMN 15 Luitenant Lippenslaan
662,Luitenant Lippenslaan 200,2023-02-09,02:00:00,5,4,1,FMN 15 Luitenant Lippenslaan
662,Luitenant Lippenslaan 200,2023-02-09,03:00:00,2,0,2,FMN 15 Luitenant Lippenslaan
662,Luitenant Lippenslaan 200,2023-02-09,04:00:00,11,1,10,FMN 15 Luitenant Lippenslaan
662,Luitenant Lippenslaan 200,2023-02-09,05:00:00,15,0,15,FMN 15 Luitenant Lippenslaan
662,Luitenant Lippenslaan 200,2023-02-09,06:00:00,71,8,63,FMN 15 Luitenant Lippenslaan
662,Luitenant Lippenslaan 200,2023-02-09,07:00:00,193,7,186,FMN 15 Luitenant Lippenslaan
662,Luitenant Lippenslaan 200,2023-02-09,08:00:00,386,7,379,FMN 15 Luitenant Lippenslaan
662,Luitenant Lippenslaan 200,2023-02-09,09:00:00,154,3,151,FMN 15 Luitenant Lippenslaan
662,Luitenant Lippenslaan 200,2023-02-09,10:00:00,92,5,87,FMN 15 Luitenant Lippenslaan
662,Luitenant Lippenslaan 200,2023-02-09,11:00:00,72,6,66,FMN 15 Luitenant Lippenslaan
662,Luitenant Lippenslaan 200,2023-02-09,12:00:00,85,9,76,FMN 15 Luitenant Lippenslaan
662,Luitenant Lippenslaan 200,2023-02-09,13:00:00,84,6,78,FMN 15 Luitenant Lippenslaan
662,Luitenant Lippenslaan 200,2023-02-09,14:00:00,63,10,53,FMN 15 Luitenant Lippenslaan
662,Luitenant Lippenslaan 200,2023-02-09,15:00:00,100,12,88,FMN 15 Luitenant Lippenslaan
662,Luitenant Lippenslaan 200,2023-02-09,16:00:00,130,18,112,FMN 15 Luitenant Lippenslaan
662,Luitenant Lippenslaan 200,2023-02-09,17:00:00,154,14,140,FMN 15 Luitenant Lippenslaan
662,Luitenant Lippenslaan 200,2023-02-09,18:00:00,141,10,131,FMN 15 Luitenant Lippenslaan
662,Luitenant Lippenslaan 200,2023-02-09,19:00:00,112,10,102,FMN 15 Luitenant Lippenslaan
662,Luitenant Lippenslaan 200,2023-02-09,20:00:00,83,12,71,FMN 15 Luitenant Lippenslaan
662,Luitenant Lippenslaan 200,2023-02-09,21:00:00,55,16,39,FMN 15 Luitenant Lippenslaan
662,Luitenant Lippenslaan 200,2023-02-09,22:00:00,36,6,30,FMN 15 Luitenant Lippenslaan
662,Luitenant Lippenslaan 200,2023-02-09,23:00:00,14,3,11,FMN 15 Luitenant Lippenslaan
662,Luitenant Lippenslaan 200,2023-02-10,00:00:00,10,2,8,FMN 15 Luitenant Lippenslaan
662,Luitenant Lippenslaan 200,2023-02-10,01:00:00,9,2,7,FMN 15 Luitenant Lippenslaan
662,Luitenant Lippenslaan 200,2023-02-10,02:00:00,4,4,0,FMN 15 Luitenant Lippenslaan
662,Luitenant Lippenslaan 200,2023-02-10,03:00:00,4,2,2,FMN 15 Luitenant Lippenslaan
662,Luitenant Lippenslaan 200,2023-02-10,04:00:00,3,0,3,FMN 15 Luitenant Lippenslaan
662,Luitenant Lippenslaan 200,2023-02-10,05:00:00,19,3,16,FMN 15 Luitenant Lippenslaan
662,Luitenant Lippenslaan 200,2023-02-10,06:00:00,49,6,43,FMN 15 Luitenant Lippenslaan
662,Luitenant Lippenslaan 200,2023-02-10,07:00:00,171,4,167,FMN 15 Luitenant Lippenslaan
662,Luitenant Lippenslaan 200,2023-02-10,08:00:00,360,4,356,FMN 15 Luitenant Lippenslaan
662,Luitenant Lippenslaan 200,2023-02-10,09:00:00,117,2,115,FMN 15 Luitenant Lippenslaan
662,Luitenant Lippenslaan 200,2023-02-10,10:00:00,84,4,80,FMN 15 Luitenant Lippenslaan
662,Luitenant Lippenslaan 200,2023-02-10,11:00:00,77,3,74,FMN 15 Luitenant Lippenslaan
662,Luitenant Lippenslaan 200,2023-02-10,12:00:00,97,14,83,FMN 15 Luitenant Lippenslaan
662,Luitenant Lippenslaan 200,2023-02-10,13:00:00,88,9,79,FMN 15 Luitenant Lippenslaan
662,Luitenant Lippenslaan 200,2023-02-10,14:00:00,61,7,54,FMN 15 Luitenant Lippenslaan
662,Luitenant Lippenslaan 200,2023-02-10,15:00:00,92,10,82,FMN 15 Luitenant Lippenslaan
662,Luitenant Lippenslaan 200,2023-02-10,16:00:00,121,8,113,FMN 15 Luitenant Lippenslaan
662,Luitenant Lippenslaan 200,2023-02-10,17:00:00,146,22,124,FMN 15 Luitenant Lippenslaan
662,Luitenant Lippenslaan 200,2023-02-10,18:00:00,135,17,118,FMN 15 Luitenant Lippenslaan
662,Luitenant Lippenslaan 200,2023-02-10,19:00:00,126,10,116,FMN 15 Luitenant Lippenslaan
662,Luitenant Lippenslaan 200,2023-02-10,20:00:00,85,10,75,FMN 15 Luitenant Lippenslaan
662,Luitenant Lippenslaan 200,2023-02-10,21:00:00,51,3,48,FMN 15 Luitenant Lippenslaan
662,Luitenant Lippenslaan 200,2023-02-10,22:00:00,38,4,34,FMN 15 Luitenant Lippenslaan
662,Luitenant Lippenslaan 200,2023-02-10,23:00:00,31,12,19,FMN 15 Luitenant Lippenslaan
662,Luitenant Lippenslaan 200,2023-02-11,00:00:00,27,10,17,FMN 15 Luitenant Lippenslaan
662,Luitenant Lippenslaan 200,2023-02-11,01:00:00,10,1,9,FMN 15 Luitenant Lippenslaan
662,Luitenant Lippenslaan 200,2023-02-11,02:00:00,9,2,7,FMN 15 Luitenant Lippenslaan
662,Luitenant Lippenslaan 200,2023-02-11,03:00:00,4,2,2,FMN 15 Luitenant Lippenslaan
662,Luitenant Lippenslaan 200,2023-02-11,04:00:00,6,2,4,FMN 15 Luitenant Lippenslaan
662,Luitenant Lippenslaan 200,2023-02-11,05:00:00,12,2,10,FMN 15 Luitenant Lippenslaan
662,Luitenant Lippenslaan 200,2023-02-11,06:00:00,22,3,19,FMN 15 Luitenant Lippenslaan
662,Luitenant Lippenslaan 200,2023-02-11,07:00:00,25,4,21,FMN 15 Luitenant Lippenslaan
662,Luitenant Lippenslaan 200,2023-02-11,08:00:00,68,6,62,FMN 15 Luitenant Lippenslaan
662,Luitenant Lippenslaan 200,2023-02-11,09:00:00,83,9,74,FMN 15 Luitenant Lippenslaan
662,Luitenant Lippenslaan 200,2023-02-11,10:00:00,91,5,86,FMN 15 Luitenant Lippenslaan
662,Luitenant Lippenslaan 200,2023-02-11,11:00:00,92,9,83,FMN 15 Luitenant Lippenslaan
662,Luitenant Lippenslaan 200,2023-02-11,12:00:00,106,10,96,FMN 15 Luitenant Lippenslaan
662,Luitenant Lippenslaan 200,2023-02-11,13:00:00,138,10,128,FMN 15 Luitenant Lippenslaan
662,Luitenant Lippenslaan 200,2023-02-11,14:00:00,122,17,105,FMN 15 Luitenant Lippenslaan
662,Luitenant Lippenslaan 200,2023-02-11,15:00:00,85,7,78,FMN 15 Luitenant Lippenslaan
662,Luitenant Lippenslaan 200,2023-02-11,16:00:00,100,11,89,FMN 15 Luitenant Lippenslaan
662,Luitenant Lippenslaan 200,2023-02-11,17:00:00,122,14,108,FMN 15 Luitenant Lippenslaan
662,Luitenant Lippenslaan 200,2023-02-11,18:00:00,112,6,106,FMN 15 Luitenant Lippenslaan
662,Luitenant Lippenslaan 200,2023-02-11,19:00:00,105,10,95,FMN 15 Luitenant Lippenslaan
662,Luitenant Lippenslaan 200,2023-02-11,20:00:00,59,6,53,FMN 15 Luitenant Lippenslaan
662,Luitenant Lippenslaan 200,2023-02-11,21:00:00,36,5,31,FMN 15 Luitenant Lippenslaan
662,Luitenant Lippenslaan 200,2023-02-11,22:00:00,26,1,25,FMN 15 Luitenant Lippenslaan
662,Luitenant Lippenslaan 200,2023-02-11,23:00:00,18,6,12,FMN 15 Luitenant Lippenslaan
662,Luitenant Lippenslaan 200,2023-02-12,00:00:00,32,5,27,FMN 15 Luitenant Lippenslaan
662,Luitenant Lippenslaan 200,2023-02-12,01:00:00,23,2,21,FMN 15 Luitenant Lippenslaan
662,Luitenant Lippenslaan 200,2023-02-12,02:00:00,12,4,8,FMN 15 Luitenant Lippenslaan
662,Luitenant Lippenslaan 200,2023-02-12,03:00:00,19,2,17,FMN 15 Luitenant Lippenslaan
662,Luitenant Lippenslaan 200,2023-02-12,04:00:00,9,5,4,FMN 15 Luitenant Lippenslaan
662,Luitenant Lippenslaan 200,2023-02-12,05:00:00,8,1,7,FMN 15 Luitenant Lippenslaan
662,Luitenant Lippenslaan 200,2023-02-12,06:00:00,16,4,12,FMN 15 Luitenant Lippenslaan
662,Luitenant Lippenslaan 200,2023-02-12,07:00:00,14,2,12,FMN 15 Luitenant Lippenslaan
662,Luitenant Lippenslaan 200,2023-02-12,08:00:00,29,2,27,FMN 15 Luitenant Lippenslaan
662,Luitenant Lippenslaan 200,2023-02-12,09:00:00,67,6,61,FMN 15 Luitenant Lippenslaan
662,Luitenant Lippenslaan 200,2023-02-12,10:00:00,75,5,70,FMN 15 Luitenant Lippenslaan
662,Luitenant Lippenslaan 200,2023-02-12,11:00:00,67,7,60,FMN 15 Luitenant Lippenslaan
662,Luitenant Lippenslaan 200,2023-02-12,12:00:00,76,5,71,FMN 15 Luitenant Lippenslaan
662,Luitenant Lippenslaan 200,2023-02-12,13:00:00,91,7,84,FMN 15 Luitenant Lippenslaan
662,Luitenant Lippenslaan 200,2023-02-12,14:00:00,72,3,69,FMN 15 Luitenant Lippenslaan
662,Luitenant Lippenslaan 200,2023-02-12,15:00:00,59,6,53,FMN 15 Luitenant Lippenslaan
662,Luitenant Lippenslaan 200,2023-02-12,16:00:00,63,3,60,FMN 15 Luitenant Lippenslaan
662,Luitenant Lippenslaan 200,2023-02-12,17:00:00,67,6,61,FMN 15 Luitenant Lippenslaan
662,Luitenant Lippenslaan 200,2023-02-12,18:00:00,85,10,75,FMN 15 Luitenant Lippenslaan
662,Luitenant Lippenslaan 200,2023-02-12,19:00:00,62,13,49,FMN 15 Luitenant Lippenslaan
662,Luitenant Lippenslaan 200,2023-02-12,20:00:00,50,3,47,FMN 15 Luitenant Lippenslaan
662,Luitenant Lippenslaan 200,2023-02-12,21:00:00,31,3,28,FMN 15 Luitenant Lippenslaan
662,Luitenant Lippenslaan 200,2023-02-12,22:00:00,28,6,22,FMN 15 Luitenant Lippenslaan
662,Luitenant Lippenslaan 200,2023-02-12,23:00:00,8,2,6,FMN 15 Luitenant Lippenslaan
662,Luitenant Lippenslaan 200,2023-02-13,00:00:00,3,0,3,FMN 15 Luitenant Lippenslaan
662,Luitenant Lippenslaan 200,2023-02-13,01:00:00,3,1,2,FMN 15 Luitenant Lippenslaan
662,Luitenant Lippenslaan 200,2023-02-13,02:00:00,8,4,4,FMN 15 Luitenant Lippenslaan
662,Luitenant Lippenslaan 200,2023-02-13,03:00:00,5,1,4,FMN 15 Luitenant Lippenslaan
662,Luitenant Lippenslaan 200,2023-02-13,04:00:00,11,0,11,FMN 15 Luitenant Lippenslaan
662,Luitenant Lippenslaan 200,2023-02-13,05:00:00,12,3,9,FMN 15 Luitenant Lippenslaan
662,Luitenant Lippenslaan 200,2023-02-13,06:00:00,62,3,59,FMN 15 Luitenant Lippenslaan
662,Luitenant Lippenslaan 200,2023-02-13,07:00:00,184,4,180,FMN 15 Luitenant Lippenslaan
662,Luitenant Lippenslaan 200,2023-02-13,08:00:00,400,11,389,FMN 15 Luitenant Lippenslaan
662,Luitenant Lippenslaan 200,2023-02-13,09:00:00,139,3,136,FMN 15 Luitenant Lippenslaan
662,Luitenant Lippenslaan 200,2023-02-13,10:00:00,84,4,80,FMN 15 Luitenant Lippenslaan
662,Luitenant Lippenslaan 200,2023-02-13,11:00:00,87,6,81,FMN 15 Luitenant Lippenslaan
662,Luitenant Lippenslaan 200,2023-02-13,12:00:00,110,12,98,FMN 15 Luitenant Lippenslaan
662,Luitenant Lippenslaan 200,2023-02-13,13:00:00,94,6,88,FMN 15 Luitenant Lippenslaan
662,Luitenant Lippenslaan 200,2023-02-13,14:00:00,79,8,71,FMN 15 Luitenant Lippenslaan
662,Luitenant Lippenslaan 200,2023-02-13,15:00:00,117,19,98,FMN 15 Luitenant Lippenslaan
662,Luitenant Lippenslaan 200,2023-02-13,16:00:00,154,17,137,FMN 15 Luitenant Lippenslaan
662,Luitenant Lippenslaan 200,2023-02-13,17:00:00,154,14,140,FMN 15 Luitenant Lippenslaan
662,Luitenant Lippenslaan 200,2023-02-13,18:00:00,135,11,124,FMN 15 Luitenant Lippenslaan
662,Luitenant Lippenslaan 200,2023-02-13,19:00:00,88,14,74,FMN 15 Luitenant Lippenslaan
662,Luitenant Lippenslaan 200,2023-02-13,20:00:00,64,8,56,FMN 15 Luitenant Lippenslaan
662,Luitenant Lippenslaan 200,2023-02-13,21:00:00,45,8,37,FMN 15 Luitenant Lippenslaan
662,Luitenant Lippenslaan 200,2023-02-13,22:00:00,29,3,26,FMN 15 Luitenant Lippenslaan
662,Luitenant Lippenslaan 200,2023-02-13,23:00:00,8,2,6,FMN 15 Luitenant Lippenslaan
662,Luitenant Lippenslaan 200,2023-02-14,00:00:00,10,4,6,FMN 15 Luitenant Lippenslaan
662,Luitenant Lippenslaan 200,2023-02-14,01:00:00,3,2,1,FMN 15 Luitenant Lippenslaan
662,Luitenant Lippenslaan 200,2023-02-14,02:00:00,5,4,1,FMN 15 Luitenant Lippenslaan
662,Luitenant Lippenslaan 200,2023-02-14,03:00:00,4,1,3,FMN 15 Luitenant Lippenslaan
662,Luitenant Lippenslaan 200,2023-02-14,04:00:00,10,2,8,FMN 15 Luitenant Lippenslaan
662,Luitenant Lippenslaan 200,2023-02-14,05:00:00,22,4,18,FMN 15 Luitenant Lippenslaan
662,Luitenant Lippenslaan 200,2023-02-14,06:00:00,81,5,76,FMN 15 Luitenant Lippenslaan
662,Luitenant Lippenslaan 200,2023-02-14,07:00:00,220,11,209,FMN 15 Luitenant Lippenslaan
662,Luitenant Lippenslaan 200,2023-02-14,08:00:00,477,7,470,FMN 15 Luitenant Lippenslaan
662,Luitenant Lippenslaan 200,2023-02-14,09:00:00,178,7,171,FMN 15 Luitenant Lippenslaan
662,Luitenant Lippenslaan 200,2023-02-14,10:00:00,94,4,90,FMN 15 Luitenant Lippenslaan
662,Luitenant Lippenslaan 200,2023-02-14,11:00:00,100,7,93,FMN 15 Luitenant Lippenslaan
662,Luitenant Lippenslaan 200,2023-02-14,12:00:00,119,4,115,FMN 15 Luitenant Lippenslaan
662,Luitenant Lippenslaan 200,2023-02-14,13:00:00,112,10,102,FMN 15 Luitenant Lippenslaan
662,Luitenant Lippenslaan 200,2023-02-14,14:00:00,108,6,102,FMN 15 Luitenant Lippenslaan
662,Luitenant Lippenslaan 200,2023-02-14,15:00:00,124,20,104,FMN 15 Luitenant Lippenslaan
662,Luitenant Lippenslaan 200,2023-02-14,16:00:00,167,18,149,FMN 15 Luitenant Lippenslaan
662,Luitenant Lippenslaan 200,2023-02-14,17:00:00,166,15,151,FMN 15 Luitenant Lippenslaan
662,Luitenant Lippenslaan 200,2023-02-14,18:00:00,150,16,134,FMN 15 Luitenant Lippenslaan
662,Luitenant Lippenslaan 200,2023-02-14,19:00:00,95,10,85,FMN 15 Luitenant Lippenslaan
662,Luitenant Lippenslaan 200,2023-02-14,20:00:00,71,13,58,FMN 15 Luitenant Lippenslaan
662,Luitenant Lippenslaan 200,2023-02-14,21:00:00,54,9,45,FMN 15 Luitenant Lippenslaan
662,Luitenant Lippenslaan 200,2023-02-14,22:00:00,33,6,27,FMN 15 Luitenant Lippenslaan
662,Luitenant Lippenslaan 200,2023-02-14,23:00:00,20,7,13,FMN 15 Luitenant Lippenslaan
662,Luitenant Lippenslaan 200,2023-02-15,00:00:00,10,4,6,FMN 15 Luitenant Lippenslaan
662,Luitenant Lippenslaan 200,2023-02-15,01:00:00,3,1,2,FMN 15 Luitenant Lippenslaan
662,Luitenant Lippenslaan 200,2023-02-15,02:00:00,8,4,4,FMN 15 Luitenant Lippenslaan
662,Luitenant Lippenslaan 200,2023-02-15,03:00:00,6,2,4,FMN 15 Luitenant Lippenslaan
662,Luitenant Lippenslaan 200,2023-02-15,04:00:00,10,0,10,FMN 15 Luitenant Lippenslaan
662,Luitenant Lippenslaan 200,2023-02-15,05:00:00,21,2,19,FMN 15 Luitenant Lippenslaan
662,Luitenant Lippenslaan 200,2023-02-15,06:00:00,61,2,59,FMN 15 Luitenant Lippenslaan
662,Luitenant Lippenslaan 200,2023-02-15,07:00:00,183,8,175,FMN 15 Luitenant Lippenslaan
662,Luitenant Lippenslaan 200,2023-02-15,08:00:00,375,8,367,FMN 15 Luitenant Lippenslaan
662,Luitenant Lippenslaan 200,2023-02-15,09:00:00,163,7,156,FMN 15 Luitenant Lippenslaan
662,Luitenant Lippenslaan 200,2023-02-15,10:00:00,119,6,113,FMN 15 Luitenant Lippenslaan
662,Luitenant Lippenslaan 200,2023-02-15,11:00:00,80,5,75,FMN 15 Luitenant Lippenslaan
662,Luitenant Lippenslaan 200,2023-02-15,12:00:00,139,17,122,FMN 15 Luitenant Lippenslaan
662,Luitenant Lippenslaan 200,2023-02-15,13:00:00,140,12,128,FMN 15 Luitenant Lippenslaan
662,Luitenant Lippenslaan 200,2023-02-15,14:00:00,101,5,96,FMN 15 Luitenant Lippenslaan
662,Luitenant Lippenslaan 200,2023-02-15,15:00:00,119,16,103,FMN 15 Luitenant Lippenslaan
662,Luitenant Lippenslaan 200,2023-02-15,16:00:00,144,18,126,FMN 15 Luitenant Lippenslaan
662,Luitenant Lippenslaan 200,2023-02-15,17:00:00,185,16,169,FMN 15 Luitenant Lippenslaan
662,Luitenant Lippenslaan 200,2023-02-15,18:00:00,134,16,118,FMN 15 Luitenant Lippenslaan
662,Luitenant Lippenslaan 200,2023-02-15,19:00:00,111,18,93,FMN 15 Luitenant Lippenslaan
662,Luitenant Lippenslaan 200,2023-02-15,20:00:00,66,7,59,FMN 15 Luitenant Lippenslaan
662,Luitenant Lippenslaan 200,2023-02-15,21:00:00,42,9,33,FMN 15 Luitenant Lippenslaan
662,Luitenant Lippenslaan 200,2023-02-15,22:00:00,34,7,27,FMN 15 Luitenant Lippenslaan
662,Luitenant Lippenslaan 200,2023-02-15,23:00:00,18,4,14,FMN 15 Luitenant Lippenslaan
662,Luitenant Lippenslaan 200,2023-02-16,00:00:00,13,2,11,FMN 15 Luitenant Lippenslaan
662,Luitenant Lippenslaan 200,2023-02-16,01:00:00,4,3,1,FMN 15 Luitenant Lippenslaan
662,Luitenant Lippenslaan 200,2023-02-16,02:00:00,10,3,7,FMN 15 Luitenant Lippenslaan
662,Luitenant Lippenslaan 200,2023-02-16,03:00:00,3,1,2,FMN 15 Luitenant Lippenslaan
662,Luitenant Lippenslaan 200,2023-02-16,04:00:00,6,0,6,FMN 15 Luitenant Lippenslaan
662,Luitenant Lippenslaan 200,2023-02-16,05:00:00,18,2,16,FMN 15 Luitenant Lippenslaan
662,Luitenant Lippenslaan 200,2023-02-16,06:00:00,66,5,61,FMN 15 Luitenant Lippenslaan
662,Luitenant Lippenslaan 200,2023-02-16,07:00:00,201,7,194,FMN 15 Luitenant Lippenslaan
662,Luitenant Lippenslaan 200,2023-02-16,08:00:00,470,9,461,FMN 15 Luitenant Lippenslaan
662,Luitenant Lippenslaan 200,2023-02-16,09:00:00,170,2,168,FMN 15 Luitenant Lippenslaan
662,Luitenant Lippenslaan 200,2023-02-16,10:00:00,91,4,87,FMN 15 Luitenant Lippenslaan
662,Luitenant Lippenslaan 200,2023-02-16,11:00:00,90,9,81,FMN 15 Luitenant Lippenslaan
662,Luitenant Lippenslaan 200,2023-02-16,12:00:00,90,3,87,FMN 15 Luitenant Lippenslaan
662,Luitenant Lippenslaan 200,2023-02-16,13:00:00,76,5,71,FMN 15 Luitenant Lippenslaan
662,Luitenant Lippenslaan 200,2023-02-16,14:00:00,73,6,67,FMN 15 Luitenant Lippenslaan
662,Luitenant Lippenslaan 200,2023-02-16,15:00:00,96,12,84,FMN 15 Luitenant Lippenslaan
662,Luitenant Lippenslaan 200,2023-02-16,16:00:00,149,20,129,FMN 15 Luitenant Lippenslaan
662,Luitenant Lippenslaan 200,2023-02-16,17:00:00,155,12,143,FMN 15 Luitenant Lippenslaan
662,Luitenant Lippenslaan 200,2023-02-16,18:00:00,142,12,130,FMN 15 Luitenant Lippenslaan
662,Luitenant Lippenslaan 200,2023-02-16,19:00:00,86,12,74,FMN 15 Luitenant Lippenslaan
662,Luitenant Lippenslaan 200,2023-02-16,20:00:00,59,7,52,FMN 15 Luitenant Lippenslaan
662,Luitenant Lippenslaan 200,2023-02-16,21:00:00,36,5,31,FMN 15 Luitenant Lippenslaan
662,Luitenant Lippenslaan 200,2023-02-16,22:00:00,35,5,30,FMN 15 Luitenant Lippenslaan
662,Luitenant Lippenslaan 200,2023-02-16,23:00:00,17,6,11,FMN 15 Luitenant Lippenslaan
662,Luitenant Lippenslaan 200,2023-02-17,00:00:00,5,1,4,FMN 15 Luitenant Lippenslaan
662,Luitenant Lippenslaan 200,2023-02-17,01:00:00,7,5,2,FMN 15 Luitenant Lippenslaan
662,Luitenant Lippenslaan 200,2023-02-17,02:00:00,5,4,1,FMN 15 Luitenant Lippenslaan
662,Luitenant Lippenslaan 200,2023-02-17,03:00:00,5,3,2,FMN 15 Luitenant Lippenslaan
662,Luitenant Lippenslaan 200,2023-02-17,04:00:00,8,1,7,FMN 15 Luitenant Lippenslaan
662,Luitenant Lippenslaan 200,2023-02-17,05:00:00,17,2,15,FMN 15 Luitenant Lippenslaan
662,Luitenant Lippenslaan 200,2023-02-17,06:00:00,46,1,45,FMN 15 Luitenant Lippenslaan
662,Luitenant Lippenslaan 200,2023-02-17,07:00:00,187,6,181,FMN 15 Luitenant Lippenslaan
662,Luitenant Lippenslaan 200,2023-02-17,08:00:00,350,5,345,FMN 15 Luitenant Lippenslaan
662,Luitenant Lippenslaan 200,2023-02-17,09:00:00,134,3,131,FMN 15 Luitenant Lippenslaan
662,Luitenant Lippenslaan 200,2023-02-17,10:00:00,110,4,106,FMN 15 Luitenant Lippenslaan
662,Luitenant Lippenslaan 200,2023-02-17,11:00:00,73,5,68,FMN 15 Luitenant Lippenslaan
662,Luitenant Lippenslaan 200,2023-02-17,12:00:00,104,4,100,FMN 15 Luitenant Lippenslaan
662,Luitenant Lippenslaan 200,2023-02-17,13:00:00,76,10,66,FMN 15 Luitenant Lippenslaan
662,Luitenant Lippenslaan 200,2023-02-17,14:00:00,63,12,51,FMN 15 Luitenant Lippenslaan
662,Luitenant Lippenslaan 200,2023-02-17,15:00:00,125,18,107,FMN 15 Luitenant Lippenslaan
662,Luitenant Lippenslaan 200,2023-02-17,16:00:00,130,14,116,FMN 15 Luitenant Lippenslaan
662,Luitenant Lippenslaan 200,2023-02-17,17:00:00,133,7,126,FMN 15 Luitenant Lippenslaan
662,Luitenant Lippenslaan 200,2023-02-17,18:00:00,139,18,121,FMN 15 Luitenant Lippenslaan
662,Luitenant Lippenslaan 200,2023-02-17,19:00:00,140,11,129,FMN 15 Luitenant Lippenslaan
662,Luitenant Lippenslaan 200,2023-02-17,20:00:00,78,10,68,FMN 15 Luitenant Lippenslaan
662,Luitenant Lippenslaan 200,2023-02-17,21:00:00,46,9,37,FMN 15 Luitenant Lippenslaan
662,Luitenant Lippenslaan 200,2023-02-17,22:00:00,44,9,35,FMN 15 Luitenant Lippenslaan
662,Luitenant Lippenslaan 200,2023-02-17,23:00:00,33,6,27,FMN 15 Luitenant Lippenslaan
662,Luitenant Lippenslaan 200,2023-02-18,00:00:00,16,8,8,FMN 15 Luitenant Lippenslaan
662,Luitenant Lippenslaan 200,2023-02-18,01:00:00,20,9,11,FMN 15 Luitenant Lippenslaan
662,Luitenant Lippenslaan 200,2023-02-18,02:00:00,12,3,9,FMN 15 Luitenant Lippenslaan
662,Luitenant Lippenslaan 200,2023-02-18,03:00:00,10,5,5,FMN 15 Luitenant Lippenslaan
662,Luitenant Lippenslaan 200,2023-02-18,04:00:00,12,3,9,FMN 15 Luitenant Lippenslaan
662,Luitenant Lippenslaan 200,2023-02-18,05:00:00,10,1,9,FMN 15 Luitenant Lippenslaan
662,Luitenant Lippenslaan 200,2023-02-18,06:00:00,18,1,17,FMN 15 Luitenant Lippenslaan
662,Luitenant Lippenslaan 200,2023-02-18,07:00:00,17,0,17,FMN 15 Luitenant Lippenslaan
662,Luitenant Lippenslaan 200,2023-02-18,08:00:00,64,4,60,FMN 15 Luitenant Lippenslaan
662,Luitenant Lippenslaan 200,2023-02-18,09:00:00,64,2,62,FMN 15 Luitenant Lippenslaan
662,Luitenant Lippenslaan 200,2023-02-18,10:00:00,87,2,85,FMN 15 Luitenant Lippenslaan
662,Luitenant Lippenslaan 200,2023-02-18,11:00:00,97,5,92,FMN 15 Luitenant Lippenslaan
662,Luitenant Lippenslaan 200,2023-02-18,12:00:00,106,10,96,FMN 15 Luitenant Lippenslaan
662,Luitenant Lippenslaan 200,2023-02-18,13:00:00,93,8,85,FMN 15 Luitenant Lippenslaan
662,Luitenant Lippenslaan 200,2023-02-18,14:00:00,86,3,83,FMN 15 Luitenant Lippenslaan
662,Luitenant Lippenslaan 200,2023-02-18,15:00:00,80,14,66,FMN 15 Luitenant Lippenslaan
662,Luitenant Lippenslaan 200,2023-02-18,16:00:00,72,7,65,FMN 15 Luitenant Lippenslaan
662,Luitenant Lippenslaan 200,2023-02-18,17:00:00,105,11,94,FMN 15 Luitenant Lippenslaan
662,Luitenant Lippenslaan 200,2023-02-18,18:00:00,123,12,111,FMN 15 Luitenant Lippenslaan
662,Luitenant Lippenslaan 200,2023-02-18,19:00:00,96,5,91,FMN 15 Luitenant Lippenslaan
662,Luitenant Lippenslaan 200,2023-02-18,20:00:00,55,7,48,FMN 15 Luitenant Lippenslaan
662,Luitenant Lippenslaan 200,2023-02-18,21:00:00,51,7,44,FMN 15 Luitenant Lippenslaan
662,Luitenant Lippenslaan 200,2023-02-18,22:00:00,37,6,31,FMN 15 Luitenant Lippenslaan
662,Luitenant Lippenslaan 200,2023-02-18,23:00:00,24,5,19,FMN 15 Luitenant Lippenslaan
662,Luitenant Lippenslaan 200,2023-02-19,00:00:00,23,4,19,FMN 15 Luitenant Lippenslaan
662,Luitenant Lippenslaan 200,2023-02-19,01:00:00,13,2,11,FMN 15 Luitenant Lippenslaan
662,Luitenant Lippenslaan 200,2023-02-19,02:00:00,9,3,6,FMN 15 Luitenant Lippenslaan
662,Luitenant Lippenslaan 200,2023-02-19,03:00:00,15,4,11,FMN 15 Luitenant Lippenslaan
662,Luitenant Lippenslaan 200,2023-02-19,04:00:00,4,1,3,FMN 15 Luitenant Lippenslaan
662,Luitenant Lippenslaan 200,2023-02-19,05:00:00,11,4,7,FMN 15 Luitenant Lippenslaan
662,Luitenant Lippenslaan 200,2023-02-19,06:00:00,15,2,13,FMN 15 Luitenant Lippenslaan
662,Luitenant Lippenslaan 200,2023-02-19,07:00:00,15,2,13,FMN 15 Luitenant Lippenslaan
662,Luitenant Lippenslaan 200,2023-02-19,08:00:00,32,1,31,FMN 15 Luitenant Lippenslaan
662,Luitenant Lippenslaan 200,2023-02-19,09:00:00,53,4,49,FMN 15 Luitenant Lippenslaan
662,Luitenant Lippenslaan 200,2023-02-19,10:00:00,77,5,72,FMN 15 Luitenant Lippenslaan
662,Luitenant Lippenslaan 200,2023-02-19,11:00:00,102,10,92,FMN 15 Luitenant Lippenslaan
662,Luitenant Lippenslaan 200,2023-02-19,12:00:00,73,12,61,FMN 15 Luitenant Lippenslaan
662,Luitenant Lippenslaan 200,2023-02-19,13:00:00,83,9,74,FMN 15 Luitenant Lippenslaan
662,Luitenant Lippenslaan 200,2023-02-19,14:00:00,110,8,102,FMN 15 Luitenant Lippenslaan
662,Luitenant Lippenslaan 200,2023-02-19,15:00:00,74,12,62,FMN 15 Luitenant Lippenslaan
662,Luitenant Lippenslaan 200,2023-02-19,16:00:00,75,11,64,FMN 15 Luitenant Lippenslaan
662,Luitenant Lippenslaan 200,2023-02-19,17:00:00,86,10,76,FMN 15 Luitenant Lippenslaan
662,Luitenant Lippenslaan 200,2023-02-19,18:00:00,82,10,72,FMN 15 Luitenant Lippenslaan
662,Luitenant Lippenslaan 200,2023-02-19,19:00:00,71,8,63,FMN 15 Luitenant Lippenslaan
662,Luitenant Lippenslaan 200,2023-02-19,20:00:00,55,11,44,FMN 15 Luitenant Lippenslaan
662,Luitenant Lippenslaan 200,2023-02-19,21:00:00,52,9,43,FMN 15 Luitenant Lippenslaan
662,Luitenant Lippenslaan 200,2023-02-19,22:00:00,18,6,12,FMN 15 Luitenant Lippenslaan
662,Luitenant Lippenslaan 200,2023-02-19,23:00:00,11,1,10,FMN 15 Luitenant Lippenslaan
662,Luitenant Lippenslaan 200,2023-02-20,00:00:00,3,1,2,FMN 15 Luitenant Lippenslaan
662,Luitenant Lippenslaan 200,2023-02-20,01:00:00,5,3,2,FMN 15 Luitenant Lippenslaan
662,Luitenant Lippenslaan 200,2023-02-20,02:00:00,4,3,1,FMN 15 Luitenant Lippenslaan
662,Luitenant Lippenslaan 200,2023-02-20,03:00:00,8,5,3,FMN 15 Luitenant Lippenslaan
662,Luitenant Lippenslaan 200,2023-02-20,04:00:00,10,0,10,FMN 15 Luitenant Lippenslaan
662,Luitenant Lippenslaan 200,2023-02-20,05:00:00,16,1,15,FMN 15 Luitenant Lippenslaan
662,Luitenant Lippenslaan 200,2023-02-20,06:00:00,56,5,51,FMN 15 Luitenant Lippenslaan
662,Luitenant Lippenslaan 200,2023-02-20,07:00:00,106,2,104,FMN 15 Luitenant Lippenslaan
662,Luitenant Lippenslaan 200,2023-02-20,08:00:00,257,6,251,FMN 15 Luitenant Lippenslaan
662,Luitenant Lippenslaan 200,2023-02-20,09:00:00,142,8,134,FMN 15 Luitenant Lippenslaan
662,Luitenant Lippenslaan 200,2023-02-20,10:00:00,95,3,92,FMN 15 Luitenant Lippenslaan
662,Luitenant Lippenslaan 200,2023-02-20,11:00:00,62,8,54,FMN 15 Luitenant Lippenslaan
662,Luitenant Lippenslaan 200,2023-02-20,12:00:00,99,11,88,FMN 15 Luitenant Lippenslaan
662,Luitenant Lippenslaan 200,2023-02-20,13:00:00,63,6,57,FMN 15 Luitenant Lippenslaan
662,Luitenant Lippenslaan 200,2023-02-20,14:00:00,78,5,73,FMN 15 Luitenant Lippenslaan
662,Luitenant Lippenslaan 200,2023-02-20,15:00:00,80,5,75,FMN 15 Luitenant Lippenslaan
662,Luitenant Lippenslaan 200,2023-02-20,16:00:00,104,13,91,FMN 15 Luitenant Lippenslaan
662,Luitenant Lippenslaan 200,2023-02-20,17:00:00,132,22,110,FMN 15 Luitenant Lippenslaan
662,Luitenant Lippenslaan 200,2023-02-20,18:00:00,106,15,91,FMN 15 Luitenant Lippenslaan
662,Luitenant Lippenslaan 200,2023-02-20,19:00:00,58,7,51,FMN 15 Luitenant Lippenslaan
662,Luitenant Lippenslaan 200,2023-02-20,20:00:00,58,9,49,FMN 15 Luitenant Lippenslaan
662,Luitenant Lippenslaan 200,2023-02-20,21:00:00,20,5,15,FMN 15 Luitenant Lippenslaan
662,Luitenant Lippenslaan 200,2023-02-20,22:00:00,27,6,21,FMN 15 Luitenant Lippenslaan
662,Luitenant Lippenslaan 200,2023-02-20,23:00:00,13,2,11,FMN 15 Luitenant Lippenslaan
662,Luitenant Lippenslaan 200,2023-02-21,00:00:00,5,1,4,FMN 15 Luitenant Lippenslaan
662,Luitenant Lippenslaan 200,2023-02-21,01:00:00,8,5,3,FMN 15 Luitenant Lippenslaan
662,Luitenant Lippenslaan 200,2023-02-21,02:00:00,8,5,3,FMN 15 Luitenant Lippenslaan
662,Luitenant Lippenslaan 200,2023-02-21,03:00:00,3,1,2,FMN 15 Luitenant Lippenslaan
662,Luitenant Lippenslaan 200,2023-02-21,04:00:00,6,0,6,FMN 15 Luitenant Lippenslaan
662,Luitenant Lippenslaan 200,2023-02-21,05:00:00,21,1,20,FMN 15 Luitenant Lippenslaan
662,Luitenant Lippenslaan 200,2023-02-21,06:00:00,64,5,59,FMN 15 Luitenant Lippenslaan
662,Luitenant Lippenslaan 200,2023-02-21,07:00:00,154,4,150,FMN 15 Luitenant Lippenslaan
662,Luitenant Lippenslaan 200,2023-02-21,08:00:00,287,10,277,FMN 15 Luitenant Lippenslaan
662,Luitenant Lippenslaan 200,2023-02-21,09:00:00,145,7,138,FMN 15 Luitenant Lippenslaan
662,Luitenant Lippenslaan 200,2023-02-21,10:00:00,91,3,88,FMN 15 Luitenant Lippenslaan
662,Luitenant Lippenslaan 200,2023-02-21,11:00:00,82,9,73,FMN 15 Luitenant Lippenslaan
662,Luitenant Lippenslaan 200,2023-02-21,12:00:00,86,7,79,FMN 15 Luitenant Lippenslaan
662,Luitenant Lippenslaan 200,2023-02-21,13:00:00,97,4,93,FMN 15 Luitenant Lippenslaan
662,Luitenant Lippenslaan 200,2023-02-21,14:00:00,97,6,91,FMN 15 Luitenant Lippenslaan
662,Luitenant Lippenslaan 200,2023-02-21,15:00:00,72,8,64,FMN 15 Luitenant Lippenslaan
662,Luitenant Lippenslaan 200,2023-02-21,16:00:00,108,19,89,FMN 15 Luitenant Lippenslaan
662,Luitenant Lippenslaan 200,2023-02-21,17:00:00,139,16,123,FMN 15 Luitenant Lippenslaan
662,Luitenant Lippenslaan 200,2023-02-21,18:00:00,100,15,85,FMN 15 Luitenant Lippenslaan
662,Luitenant Lippenslaan 200,2023-02-21,19:00:00,76,5,71,FMN 15 Luitenant Lippenslaan
662,Luitenant Lippenslaan 200,2023-02-21,20:00:00,58,7,51,FMN 15 Luitenant Lippenslaan
662,Luitenant Lippenslaan 200,2023-02-21,21:00:00,33,6,27,FMN 15 Luitenant Lippenslaan
662,Luitenant Lippenslaan 200,2023-02-21,22:00:00,32,5,27,FMN 15 Luitenant Lippenslaan
662,Luitenant Lippenslaan 200,2023-02-21,23:00:00,10,3,7,FMN 15 Luitenant Lippenslaan
662,Luitenant Lippenslaan 200,2023-02-22,00:00:00,4,1,3,FMN 15 Luitenant Lippenslaan
662,Luitenant Lippenslaan 200,2023-02-22,01:00:00,5,4,1,FMN 15 Luitenant Lippenslaan
662,Luitenant Lippenslaan 200,2023-02-22,02:00:00,6,4,2,FMN 15 Luitenant Lippenslaan
662,Luitenant Lippenslaan 200,2023-02-22,03:00:00,4,1,3,FMN 15 Luitenant Lippenslaan
662,Luitenant Lippenslaan 200,2023-02-22,04:00:00,7,0,7,FMN 15 Luitenant Lippenslaan
662,Luitenant Lippenslaan 200,2023-02-22,05:00:00,15,1,14,FMN 15 Luitenant Lippenslaan
662,Luitenant Lippenslaan 200,2023-02-22,06:00:00,60,3,57,FMN 15 Luitenant Lippenslaan
662,Luitenant Lippenslaan 200,2023-02-22,07:00:00,127,8,119,FMN 15 Luitenant Lippenslaan
662,Luitenant Lippenslaan 200,2023-02-22,08:00:00,240,5,235,FMN 15 Luitenant Lippenslaan
662,Luitenant Lippenslaan 200,2023-02-22,09:00:00,125,2,123,FMN 15 Luitenant Lippenslaan
662,Luitenant Lippenslaan 200,2023-02-22,10:00:00,86,4,82,FMN 15 Luitenant Lippenslaan
662,Luitenant Lippenslaan 200,2023-02-22,11:00:00,66,3,63,FMN 15 Luitenant Lippenslaan
662,Luitenant Lippenslaan 200,2023-02-22,12:00:00,88,9,79,FMN 15 Luitenant Lippenslaan
662,Luitenant Lippenslaan 200,2023-02-22,13:00:00,92,11,81,FMN 15 Luitenant Lippenslaan
662,Luitenant Lippenslaan 200,2023-02-22,14:00:00,92,12,80,FMN 15 Luitenant Lippenslaan
662,Luitenant Lippenslaan 200,2023-02-22,15:00:00,82,5,77,FMN 15 Luitenant Lippenslaan
662,Luitenant Lippenslaan 200,2023-02-22,16:00:00,116,12,104,FMN 15 Luitenant Lippenslaan
662,Luitenant Lippenslaan 200,2023-02-22,17:00:00,127,12,115,FMN 15 Luitenant Lippenslaan
662,Luitenant Lippenslaan 200,2023-02-22,18:00:00,114,10,104,FMN 15 Luitenant Lippenslaan
662,Luitenant Lippenslaan 200,2023-02-22,19:00:00,86,18,68,FMN 15 Luitenant Lippenslaan
662,Luitenant Lippenslaan 200,2023-02-22,20:00:00,61,14,47,FMN 15 Luitenant Lippenslaan
662,Luitenant Lippenslaan 200,2023-02-22,21:00:00,33,7,26,FMN 15 Luitenant Lippenslaan
662,Luitenant Lippenslaan 200,2023-02-22,22:00:00,34,9,25,FMN 15 Luitenant Lippenslaan
662,Luitenant Lippenslaan 200,2023-02-22,23:00:00,16,3,13,FMN 15 Luitenant Lippenslaan
662,Luitenant Lippenslaan 200,2023-02-23,00:00:00,5,2,3,FMN 15 Luitenant Lippenslaan
662,Luitenant Lippenslaan 200,2023-02-23,01:00:00,4,3,1,FMN 15 Luitenant Lippenslaan
662,Luitenant Lippenslaan 200,2023-02-23,02:00:00,6,5,1,FMN 15 Luitenant Lippenslaan
662,Luitenant Lippenslaan 200,2023-02-23,03:00:00,2,1,1,FMN 15 Luitenant Lippenslaan
662,Luitenant Lippenslaan 200,2023-02-23,04:00:00,8,2,6,FMN 15 Luitenant Lippenslaan
662,Luitenant Lippenslaan 200,2023-02-23,05:00:00,14,1,13,FMN 15 Luitenant Lippenslaan
662,Luitenant Lippenslaan 200,2023-02-23,06:00:00,65,5,60,FMN 15 Luitenant Lippenslaan
662,Luitenant Lippenslaan 200,2023-02-23,07:00:00,134,8,126,FMN 15 Luitenant Lippenslaan
662,Luitenant Lippenslaan 200,2023-02-23,08:00:00,271,3,268,FMN 15 Luitenant Lippenslaan
662,Luitenant Lippenslaan 200,2023-02-23,09:00:00,142,7,135,FMN 15 Luitenant Lippenslaan
662,Luitenant Lippenslaan 200,2023-02-23,10:00:00,80,2,78,FMN 15 Luitenant Lippenslaan
662,Luitenant Lippenslaan 200,2023-02-23,11:00:00,69,7,62,FMN 15 Luitenant Lippenslaan
662,Luitenant Lippenslaan 200,2023-02-23,12:00:00,88,8,80,FMN 15 Luitenant Lippenslaan
662,Luitenant Lippenslaan 200,2023-02-23,13:00:00,80,8,72,FMN 15 Luitenant Lippenslaan
662,Luitenant Lippenslaan 200,2023-02-23,14:00:00,94,12,82,FMN 15 Luitenant Lippenslaan
662,Luitenant Lippenslaan 200,2023-02-23,15:00:00,78,7,71,FMN 15 Luitenant Lippenslaan
662,Luitenant Lippenslaan 200,2023-02-23,16:00:00,129,14,115,FMN 15 Luitenant Lippenslaan
662,Luitenant Lippenslaan 200,2023-02-23,17:00:00,141,14,127,FMN 15 Luitenant Lippenslaan
662,Luitenant Lippenslaan 200,2023-02-23,18:00:00,135,12,123,FMN 15 Luitenant Lippenslaan
662,Luitenant Lippenslaan 200,2023-02-23,19:00:00,98,12,86,FMN 15 Luitenant Lippenslaan
662,Luitenant Lippenslaan 200,2023-02-23,20:00:00,63,12,51,FMN 15 Luitenant Lippenslaan
662,Luitenant Lippenslaan 200,2023-02-23,21:00:00,47,9,38,FMN 15 Luitenant Lippenslaan
662,Luitenant Lippenslaan 200,2023-02-23,22:00:00,46,12,34,FMN 15 Luitenant Lippenslaan
662,Luitenant Lippenslaan 200,2023-02-23,23:00:00,17,5,12,FMN 15 Luitenant Lippenslaan
662,Luitenant Lippenslaan 200,2023-02-24,00:00:00,9,3,6,FMN 15 Luitenant Lippenslaan
662,Luitenant Lippenslaan 200,2023-02-24,01:00:00,3,2,1,FMN 15 Luitenant Lippenslaan
662,Luitenant Lippenslaan 200,2023-02-24,02:00:00,6,5,1,FMN 15 Luitenant Lippenslaan
662,Luitenant Lippenslaan 200,2023-02-24,03:00:00,5,3,2,FMN 15 Luitenant Lippenslaan
662,Luitenant Lippenslaan 200,2023-02-24,04:00:00,8,0,8,FMN 15 Luitenant Lippenslaan
662,Luitenant Lippenslaan 200,2023-02-24,05:00:00,14,1,13,FMN 15 Luitenant Lippenslaan
662,Luitenant Lippenslaan 200,2023-02-24,06:00:00,53,4,49,FMN 15 Luitenant Lippenslaan
662,Luitenant Lippenslaan 200,2023-02-24,07:00:00,92,6,86,FMN 15 Luitenant Lippenslaan
662,Luitenant Lippenslaan 200,2023-02-24,08:00:00,208,7,201,FMN 15 Luitenant Lippenslaan
662,Luitenant Lippenslaan 200,2023-02-24,09:00:00,132,2,130,FMN 15 Luitenant Lippenslaan
662,Luitenant Lippenslaan 200,2023-02-24,10:00:00,87,4,83,FMN 15 Luitenant Lippenslaan
662,Luitenant Lippenslaan 200,2023-02-24,11:00:00,74,9,65,FMN 15 Luitenant Lippenslaan
662,Luitenant Lippenslaan 200,2023-02-24,12:00:00,90,10,80,FMN 15 Luitenant Lippenslaan
662,Luitenant Lippenslaan 200,2023-02-24,13:00:00,92,5,87,FMN 15 Luitenant Lippenslaan
662,Luitenant Lippenslaan 200,2023-02-24,14:00:00,62,13,49,FMN 15 Luitenant Lippenslaan
662,Luitenant Lippenslaan 200,2023-02-24,15:00:00,83,8,75,FMN 15 Luitenant Lippenslaan
662,Luitenant Lippenslaan 200,2023-02-24,16:00:00,89,12,77,FMN 15 Luitenant Lippenslaan
662,Luitenant Lippenslaan 200,2023-02-24,17:00:00,116,12,104,FMN 15 Luitenant Lippenslaan
662,Luitenant Lippenslaan 200,2023-02-24,18:00:00,119,11,108,FMN 15 Luitenant Lippenslaan
662,Luitenant Lippenslaan 200,2023-02-24,19:00:00,106,15,91,FMN 15 Luitenant Lippenslaan
662,Luitenant Lippenslaan 200,2023-02-24,20:00:00,55,6,49,FMN 15 Luitenant Lippenslaan
662,Luitenant Lippenslaan 200,2023-02-24,21:00:00,45,2,43,FMN 15 Luitenant Lippenslaan
662,Luitenant Lippenslaan 200,2023-02-24,22:00:00,34,1,33,FMN 15 Luitenant Lippenslaan
662,Luitenant Lippenslaan 200,2023-02-24,23:00:00,30,7,23,FMN 15 Luitenant Lippenslaan
662,Luitenant Lippenslaan 200,2023-02-25,00:00:00,18,8,10,FMN 15 Luitenant Lippenslaan
662,Luitenant Lippenslaan 200,2023-02-25,01:00:00,14,6,8,FMN 15 Luitenant Lippenslaan
662,Luitenant Lippenslaan 200,2023-02-25,02:00:00,6,2,4,FMN 15 Luitenant Lippenslaan
662,Luitenant Lippenslaan 200,2023-02-25,03:00:00,11,4,7,FMN 15 Luitenant Lippenslaan
662,Luitenant Lippenslaan 200,2023-02-25,04:00:00,10,2,8,FMN 15 Luitenant Lippenslaan
662,Luitenant Lippenslaan 200,2023-02-25,05:00:00,6,1,5,FMN 15 Luitenant Lippenslaan
662,Luitenant Lippenslaan 200,2023-02-25,06:00:00,16,2,14,FMN 15 Luitenant Lippenslaan
662,Luitenant Lippenslaan 200,2023-02-25,07:00:00,21,2,19,FMN 15 Luitenant Lippenslaan
662,Luitenant Lippenslaan 200,2023-02-25,08:00:00,43,3,40,FMN 15 Luitenant Lippenslaan
662,Luitenant Lippenslaan 200,2023-02-25,09:00:00,74,3,71,FMN 15 Luitenant Lippenslaan
662,Luitenant Lippenslaan 200,2023-02-25,10:00:00,80,4,76,FMN 15 Luitenant Lippenslaan
662,Luitenant Lippenslaan 200,2023-02-25,11:00:00,104,5,99,FMN 15 Luitenant Lippenslaan
662,Luitenant Lippenslaan 200,2023-02-25,12:00:00,71,3,68,FMN 15 Luitenant Lippenslaan
662,Luitenant Lippenslaan 200,2023-02-25,13:00:00,112,10,102,FMN 15 Luitenant Lippenslaan
662,Luitenant Lippenslaan 200,2023-02-25,14:00:00,117,5,112,FMN 15 Luitenant Lippenslaan
662,Luitenant Lippenslaan 200,2023-02-25,15:00:00,99,6,93,FMN 15 Luitenant Lippenslaan
662,Luitenant Lippenslaan 200,2023-02-25,16:00:00,83,17,66,FMN 15 Luitenant Lippenslaan
662,Luitenant Lippenslaan 200,2023-02-25,17:00:00,102,9,93,FMN 15 Luitenant Lippenslaan
662,Luitenant Lippenslaan 200,2023-02-25,18:00:00,86,8,78,FMN 15 Luitenant Lippenslaan
662,Luitenant Lippenslaan 200,2023-02-25,19:00:00,92,8,84,FMN 15 Luitenant Lippenslaan
662,Luitenant Lippenslaan 200,2023-02-25,20:00:00,60,10,50,FMN 15 Luitenant Lippenslaan
662,Luitenant Lippenslaan 200,2023-02-25,21:00:00,57,8,49,FMN 15 Luitenant Lippenslaan
662,Luitenant Lippenslaan 200,2023-02-25,22:00:00,39,4,35,FMN 15 Luitenant Lippenslaan
662,Luitenant Lippenslaan 200,2023-02-25,23:00:00,25,7,18,FMN 15 Luitenant Lippenslaan
662,Luitenant Lippenslaan 200,2023-02-26,00:00:00,15,5,10,FMN 15 Luitenant Lippenslaan
662,Luitenant Lippenslaan 200,2023-02-26,01:00:00,10,4,6,FMN 15 Luitenant Lippenslaan
662,Luitenant Lippenslaan 200,2023-02-26,02:00:00,7,1,6,FMN 15 Luitenant Lippenslaan
662,Luitenant Lippenslaan 200,2023-02-26,03:00:00,6,3,3,FMN 15 Luitenant Lippenslaan
662,Luitenant Lippenslaan 200,2023-02-26,04:00:00,5,1,4,FMN 15 Luitenant Lippenslaan
662,Luitenant Lippenslaan 200,2023-02-26,05:00:00,8,3,5,FMN 15 Luitenant Lippenslaan
662,Luitenant Lippenslaan 200,2023-02-26,06:00:00,12,4,8,FMN 15 Luitenant Lippenslaan
662,Luitenant Lippenslaan 200,2023-02-26,07:00:00,9,1,8,FMN 15 Luitenant Lippenslaan
662,Luitenant Lippenslaan 200,2023-02-26,08:00:00,23,4,19,FMN 15 Luitenant Lippenslaan
662,Luitenant Lippenslaan 200,2023-02-26,09:00:00,42,3,39,FMN 15 Luitenant Lippenslaan
662,Luitenant Lippenslaan 200,2023-02-26,10:00:00,76,6,70,FMN 15 Luitenant Lippenslaan
662,Luitenant Lippenslaan 200,2023-02-26,11:00:00,76,3,73,FMN 15 Luitenant Lippenslaan
662,Luitenant Lippenslaan 200,2023-02-26,12:00:00,80,7,73,FMN 15 Luitenant Lippenslaan
662,Luitenant Lippenslaan 200,2023-02-26,13:00:00,106,9,97,FMN 15 Luitenant Lippenslaan
662,Luitenant Lippenslaan 200,2023-02-26,14:00:00,95,3,92,FMN 15 Luitenant Lippenslaan
662,Luitenant Lippenslaan 200,2023-02-26,15:00:00,74,6,68,FMN 15 Luitenant Lippenslaan
662,Luitenant Lippenslaan 200,2023-02-26,16:00:00,78,10,68,FMN 15 Luitenant Lippenslaan
662,Luitenant Lippenslaan 200,2023-02-26,17:00:00,72,13,59,FMN 15 Luitenant Lippenslaan
662,Luitenant Lippenslaan 200,2023-02-26,18:00:00,64,12,52,FMN 15 Luitenant Lippenslaan
662,Luitenant Lippenslaan 200,2023-02-26,19:00:00,56,10,46,FMN 15 Luitenant Lippenslaan
662,Luitenant Lippenslaan 200,2023-02-26,20:00:00,39,8,31,FMN 15 Luitenant Lippenslaan
662,Luitenant Lippenslaan 200,2023-02-26,21:00:00,31,6,25,FMN 15 Luitenant Lippenslaan
662,Luitenant Lippenslaan 200,2023-02-26,22:00:00,22,7,15,FMN 15 Luitenant Lippenslaan
662,Luitenant Lippenslaan 200,2023-02-26,23:00:00,12,3,9,FMN 15 Luitenant Lippenslaan
662,Luitenant Lippenslaan 200,2023-02-27,00:00:00,8,2,6,FMN 15 Luitenant Lippenslaan
662,Luitenant Lippenslaan 200,2023-02-27,01:00:00,1,0,1,FMN 15 Luitenant Lippenslaan
662,Luitenant Lippenslaan 200,2023-02-27,02:00:00,0,0,0,FMN 15 Luitenant Lippenslaan
662,Luitenant Lippenslaan 200,2023-02-27,03:00:00,4,1,3,FMN 15 Luitenant Lippenslaan
662,Luitenant Lippenslaan 200,2023-02-27,04:00:00,9,3,6,FMN 15 Luitenant Lippenslaan
662,Luitenant Lippenslaan 200,2023-02-27,05:00:00,19,3,16,FMN 15 Luitenant Lippenslaan
662,Luitenant Lippenslaan 200,2023-02-27,06:00:00,51,2,49,FMN 15 Luitenant Lippenslaan
662,Luitenant Lippenslaan 200,2023-02-27,07:00:00,182,10,172,FMN 15 Luitenant Lippenslaan
662,Luitenant Lippenslaan 200,2023-02-27,08:00:00,338,14,324,FMN 15 Luitenant Lippenslaan
662,Luitenant Lippenslaan 200,2023-02-27,09:00:00,158,4,154,FMN 15 Luitenant Lippenslaan
662,Luitenant Lippenslaan 200,2023-02-27,10:00:00,79,3,76,FMN 15 Luitenant Lippenslaan
662,Luitenant Lippenslaan 200,2023-02-27,11:00:00,68,10,58,FMN 15 Luitenant Lippenslaan
662,Luitenant Lippenslaan 200,2023-02-27,12:00:00,113,10,103,FMN 15 Luitenant Lippenslaan
662,Luitenant Lippenslaan 200,2023-02-27,13:00:00,68,9,59,FMN 15 Luitenant Lippenslaan
662,Luitenant Lippenslaan 200,2023-02-27,14:00:00,63,5,58,FMN 15 Luitenant Lippenslaan
662,Luitenant Lippenslaan 200,2023-02-27,15:00:00,118,25,93,FMN 15 Luitenant Lippenslaan
662,Luitenant Lippenslaan 200,2023-02-27,16:00:00,142,17,125,FMN 15 Luitenant Lippenslaan
662,Luitenant Lippenslaan 200,2023-02-27,17:00:00,146,9,137,FMN 15 Luitenant Lippenslaan
662,Luitenant Lippenslaan 200,2023-02-27,18:00:00,129,17,112,FMN 15 Luitenant Lippenslaan
662,Luitenant Lippenslaan 200,2023-02-27,19:00:00,84,16,68,FMN 15 Luitenant Lippenslaan
662,Luitenant Lippenslaan 200,2023-02-27,20:00:00,67,12,55,FMN 15 Luitenant Lippenslaan
662,Luitenant Lippenslaan 200,2023-02-27,21:00:00,37,11,26,FMN 15 Luitenant Lippenslaan
662,Luitenant Lippenslaan 200,2023-02-27,22:00:00,35,4,31,FMN 15 Luitenant Lippenslaan
662,Luitenant Lippenslaan 200,2023-02-27,23:00:00,7,1,6,FMN 15 Luitenant Lippenslaan
662,Luitenant Lippenslaan 200,2023-02-28,00:00:00,7,1,6,FMN 15 Luitenant Lippenslaan
662,Luitenant Lippenslaan 200,2023-02-28,01:00:00,1,1,0,FMN 15 Luitenant Lippenslaan
662,Luitenant Lippenslaan 200,2023-02-28,02:00:00,3,3,0,FMN 15 Luitenant Lippenslaan
662,Luitenant Lippenslaan 200,2023-02-28,03:00:00,3,1,2,FMN 15 Luitenant Lippenslaan
662,Luitenant Lippenslaan 200,2023-02-28,04:00:00,10,1,9,FMN 15 Luitenant Lippenslaan
662,Luitenant Lippenslaan 200,2023-02-28,05:00:00,13,2,11,FMN 15 Luitenant Lippenslaan
662,Luitenant Lippenslaan 200,2023-02-28,06:00:00,76,3,73,FMN 15 Luitenant Lippenslaan
662,Luitenant Lippenslaan 200,2023-02-28,07:00:00,220,7,213,FMN 15 Luitenant Lippenslaan
662,Luitenant Lippenslaan 200,2023-02-28,08:00:00,452,18,434,FMN 15 Luitenant Lippenslaan
662,Luitenant Lippenslaan 200,2023-02-28,09:00:00,189,11,178,FMN 15 Luitenant Lippenslaan
662,Luitenant Lippenslaan 200,2023-02-28,10:00:00,101,7,94,FMN 15 Luitenant Lippenslaan
662,Luitenant Lippenslaan 200,2023-02-28,11:00:00,102,11,91,FMN 15 Luitenant Lippenslaan
662,Luitenant Lippenslaan 200,2023-02-28,12:00:00,126,7,119,FMN 15 Luitenant Lippenslaan
662,Luitenant Lippenslaan 200,2023-02-28,13:00:00,119,7,112,FMN 15 Luitenant Lippenslaan
662,Luitenant Lippenslaan 200,2023-02-28,14:00:00,94,13,81,FMN 15 Luitenant Lippenslaan
662,Luitenant Lippenslaan 200,2023-02-28,15:00:00,118,26,92,FMN 15 Luitenant Lippenslaan
662,Luitenant Lippenslaan 200,2023-02-28,16:00:00,149,19,130,FMN 15 Luitenant Lippenslaan
662,Luitenant Lippenslaan 200,2023-02-28,17:00:00,151,17,134,FMN 15 Luitenant Lippenslaan
662,Luitenant Lippenslaan 200,2023-02-28,18:00:00,113,21,92,FMN 15 Luitenant Lippenslaan
662,Luitenant Lippenslaan 200,2023-02-28,19:00:00,80,7,73,FMN 15 Luitenant Lippenslaan
662,Luitenant Lippenslaan 200,2023-02-28,20:00:00,40,8,32,FMN 15 Luitenant Lippenslaan
662,Luitenant Lippenslaan 200,2023-02-28,21:00:00,42,11,31,FMN 15 Luitenant Lippenslaan
662,Luitenant Lippenslaan 200,2023-02-28,22:00:00,26,4,22,FMN 15 Luitenant Lippenslaan
662,Luitenant Lippenslaan 200,2023-02-28,23:00:00,12,2,10,FMN 15 Luitenant Lippenslaan
662,Luitenant Lippenslaan 200,2023-03-01,00:00:00,9,3,6,FMN 15 Luitenant Lippenslaan
662,Luitenant Lippenslaan 200,2023-03-01,01:00:00,1,1,0,FMN 15 Luitenant Lippenslaan
662,Luitenant Lippenslaan 200,2023-03-01,02:00:00,3,3,0,FMN 15 Luitenant Lippenslaan
662,Luitenant Lippenslaan 200,2023-03-01,03:00:00,3,1,2,FMN 15 Luitenant Lippenslaan
662,Luitenant Lippenslaan 200,2023-03-01,04:00:00,9,0,9,FMN 15 Luitenant Lippenslaan
662,Luitenant Lippenslaan 200,2023-03-01,05:00:00,19,3,16,FMN 15 Luitenant Lippenslaan
662,Luitenant Lippenslaan 200,2023-03-01,06:00:00,56,2,54,FMN 15 Luitenant Lippenslaan
662,Luitenant Lippenslaan 200,2023-03-01,07:00:00,158,6,152,FMN 15 Luitenant Lippenslaan
662,Luitenant Lippenslaan 200,2023-03-01,08:00:00,310,11,299,FMN 15 Luitenant Lippenslaan
662,Luitenant Lippenslaan 200,2023-03-01,09:00:00,152,3,149,FMN 15 Luitenant Lippenslaan
662,Luitenant Lippenslaan 200,2023-03-01,10:00:00,114,7,107,FMN 15 Luitenant Lippenslaan
662,Luitenant Lippenslaan 200,2023-03-01,11:00:00,80,8,72,FMN 15 Luitenant Lippenslaan
662,Luitenant Lippenslaan 200,2023-03-01,12:00:00,143,24,119,FMN 15 Luitenant Lippenslaan
662,Luitenant Lippenslaan 200,2023-03-01,13:00:00,127,9,118,FMN 15 Luitenant Lippenslaan
662,Luitenant Lippenslaan 200,2023-03-01,14:00:00,82,7,75,FMN 15 Luitenant Lippenslaan
662,Luitenant Lippenslaan 200,2023-03-01,15:00:00,130,17,113,FMN 15 Luitenant Lippenslaan
662,Luitenant Lippenslaan 200,2023-03-01,16:00:00,143,18,125,FMN 15 Luitenant Lippenslaan
662,Luitenant Lippenslaan 200,2023-03-01,17:00:00,164,19,145,FMN 15 Luitenant Lippenslaan
662,Luitenant Lippenslaan 200,2023-03-01,18:00:00,142,16,126,FMN 15 Luitenant Lippenslaan
662,Luitenant Lippenslaan 200,2023-03-01,19:00:00,96,14,82,FMN 15 Luitenant Lippenslaan
662,Luitenant Lippenslaan 200,2023-03-01,20:00:00,60,14,46,FMN 15 Luitenant Lippenslaan
662,Luitenant Lippenslaan 200,2023-03-01,21:00:00,39,9,30,FMN 15 Luitenant Lippenslaan
662,Luitenant Lippenslaan 200,2023-03-01,22:00:00,37,10,27,FMN 15 Luitenant Lippenslaan
662,Luitenant Lippenslaan 200,2023-03-01,23:00:00,14,4,10,FMN 15 Luitenant Lippenslaan
662,Luitenant Lippenslaan 200,2023-03-02,00:00:00,9,2,7,FMN 15 Luitenant Lippenslaan
662,Luitenant Lippenslaan 200,2023-03-02,01:00:00,4,4,0,FMN 15 Luitenant Lippenslaan
662,Luitenant Lippenslaan 200,2023-03-02,02:00:00,3,2,1,FMN 15 Luitenant Lippenslaan
662,Luitenant Lippenslaan 200,2023-03-02,03:00:00,5,2,3,FMN 15 Luitenant Lippenslaan
662,Luitenant Lippenslaan 200,2023-03-02,04:00:00,13,1,12,FMN 15 Luitenant Lippenslaan
662,Luitenant Lippenslaan 200,2023-03-02,05:00:00,16,2,14,FMN 15 Luitenant Lippenslaan
662,Luitenant Lippenslaan 200,2023-03-02,06:00:00,58,5,53,FMN 15 Luitenant Lippenslaan
662,Luitenant Lippenslaan 200,2023-03-02,07:00:00,180,9,171,FMN 15 Luitenant Lippenslaan
662,Luitenant Lippenslaan 200,2023-03-02,08:00:00,388,11,377,FMN 15 Luitenant Lippenslaan
662,Luitenant Lippenslaan 200,2023-03-02,09:00:00,185,7,178,FMN 15 Luitenant Lippenslaan
662,Luitenant Lippenslaan 200,2023-03-02,10:00:00,82,6,76,FMN 15 Luitenant Lippenslaan
662,Luitenant Lippenslaan 200,2023-03-02,11:00:00,78,6,72,FMN 15 Luitenant Lippenslaan
662,Luitenant Lippenslaan 200,2023-03-02,12:00:00,115,8,107,FMN 15 Luitenant Lippenslaan
662,Luitenant Lippenslaan 200,2023-03-02,13:00:00,90,6,84,FMN 15 Luitenant Lippenslaan
662,Luitenant Lippenslaan 200,2023-03-02,14:00:00,81,11,70,FMN 15 Luitenant Lippenslaan
662,Luitenant Lippenslaan 200,2023-03-02,15:00:00,114,19,95,FMN 15 Luitenant Lippenslaan
662,Luitenant Lippenslaan 200,2023-03-02,16:00:00,146,16,130,FMN 15 Luitenant Lippenslaan
662,Luitenant Lippenslaan 200,2023-03-02,17:00:00,172,13,159,FMN 15 Luitenant Lippenslaan
662,Luitenant Lippenslaan 200,2023-03-02,18:00:00,167,18,149,FMN 15 Luitenant Lippenslaan
662,Luitenant Lippenslaan 200,2023-03-02,19:00:00,121,18,103,FMN 15 Luitenant Lippenslaan
662,Luitenant Lippenslaan 200,2023-03-02,20:00:00,69,13,56,FMN 15 Luitenant Lippenslaan
662,Luitenant Lippenslaan 200,2023-03-02,21:00:00,44,7,37,FMN 15 Luitenant Lippenslaan
662,Luitenant Lippenslaan 200,2023-03-02,22:00:00,41,9,32,FMN 15 Luitenant Lippenslaan
662,Luitenant Lippenslaan 200,2023-03-02,23:00:00,17,3,14,FMN 15 Luitenant Lippenslaan
662,Luitenant Lippenslaan 200,2023-03-03,00:00:00,21,2,19,FMN 15 Luitenant Lippenslaan
662,Luitenant Lippenslaan 200,2023-03-03,01:00:00,3,1,2,FMN 15 Luitenant Lippenslaan
662,Luitenant Lippenslaan 200,2023-03-03,02:00:00,8,5,3,FMN 15 Luitenant Lippenslaan
662,Luitenant Lippenslaan 200,2023-03-03,03:00:00,2,0,2,FMN 15 Luitenant Lippenslaan
662,Luitenant Lippenslaan 200,2023-03-03,04:00:00,10,2,8,FMN 15 Luitenant Lippenslaan
662,Luitenant Lippenslaan 200,2023-03-03,05:00:00,14,3,11,FMN 15 Luitenant Lippenslaan
662,Luitenant Lippenslaan 200,2023-03-03,06:00:00,57,5,52,FMN 15 Luitenant Lippenslaan
662,Luitenant Lippenslaan 200,2023-03-03,07:00:00,189,8,181,FMN 15 Luitenant Lippenslaan
662,Luitenant Lippenslaan 200,2023-03-03,08:00:00,403,7,396,FMN 15 Luitenant Lippenslaan
662,Luitenant Lippenslaan 200,2023-03-03,09:00:00,145,8,137,FMN 15 Luitenant Lippenslaan
662,Luitenant Lippenslaan 200,2023-03-03,10:00:00,83,3,80,FMN 15 Luitenant Lippenslaan
662,Luitenant Lippenslaan 200,2023-03-03,11:00:00,84,4,80,FMN 15 Luitenant Lippenslaan
662,Luitenant Lippenslaan 200,2023-03-03,12:00:00,112,6,106,FMN 15 Luitenant Lippenslaan
662,Luitenant Lippenslaan 200,2023-03-03,13:00:00,83,11,72,FMN 15 Luitenant Lippenslaan
662,Luitenant Lippenslaan 200,2023-03-03,14:00:00,86,12,74,FMN 15 Luitenant Lippenslaan
662,Luitenant Lippenslaan 200,2023-03-03,15:00:00,124,19,105,FMN 15 Luitenant Lippenslaan
662,Luitenant Lippenslaan 200,2023-03-03,16:00:00,111,7,104,FMN 15 Luitenant Lippenslaan
662,Luitenant Lippenslaan 200,2023-03-03,17:00:00,141,12,129,FMN 15 Luitenant Lippenslaan
662,Luitenant Lippenslaan 200,2023-03-03,18:00:00,156,15,141,FMN 15 Luitenant Lippenslaan
662,Luitenant Lippenslaan 200,2023-03-03,19:00:00,130,18,112,FMN 15 Luitenant Lippenslaan
662,Luitenant Lippenslaan 200,2023-03-03,20:00:00,75,11,64,FMN 15 Luitenant Lippenslaan
662,Luitenant Lippenslaan 200,2023-03-03,21:00:00,58,5,53,FMN 15 Luitenant Lippenslaan
662,Luitenant Lippenslaan 200,2023-03-03,22:00:00,32,5,27,FMN 15 Luitenant Lippenslaan
662,Luitenant Lippenslaan 200,2023-03-03,23:00:00,31,5,26,FMN 15 Luitenant Lippenslaan
662,Luitenant Lippenslaan 200,2023-03-04,00:00:00,29,5,24,FMN 15 Luitenant Lippenslaan
662,Luitenant Lippenslaan 200,2023-03-04,01:00:00,14,3,11,FMN 15 Luitenant Lippenslaan
662,Luitenant Lippenslaan 200,2023-03-04,02:00:00,12,3,9,FMN 15 Luitenant Lippenslaan
662,Luitenant Lippenslaan 200,2023-03-04,03:00:00,16,3,13,FMN 15 Luitenant Lippenslaan
662,Luitenant Lippenslaan 200,2023-03-04,04:00:00,13,1,12,FMN 15 Luitenant Lippenslaan
662,Luitenant Lippenslaan 200,2023-03-04,05:00:00,11,0,11,FMN 15 Luitenant Lippenslaan
662,Luitenant Lippenslaan 200,2023-03-04,06:00:00,20,2,18,FMN 15 Luitenant Lippenslaan
662,Luitenant Lippenslaan 200,2023-03-04,07:00:00,19,1,18,FMN 15 Luitenant Lippenslaan
662,Luitenant Lippenslaan 200,2023-03-04,08:00:00,43,2,41,FMN 15 Luitenant Lippenslaan
662,Luitenant Lippenslaan 200,2023-03-04,09:00:00,94,6,88,FMN 15 Luitenant Lippenslaan
662,Luitenant Lippenslaan 200,2023-03-04,10:00:00,105,11,94,FMN 15 Luitenant Lippenslaan
662,Luitenant Lippenslaan 200,2023-03-04,11:00:00,104,3,101,FMN 15 Luitenant Lippenslaan
662,Luitenant Lippenslaan 200,2023-03-04,12:00:00,121,10,111,FMN 15 Luitenant Lippenslaan
662,Luitenant Lippenslaan 200,2023-03-04,13:00:00,123,10,113,FMN 15 Luitenant Lippenslaan
662,Luitenant Lippenslaan 200,2023-03-04,14:00:00,90,4,86,FMN 15 Luitenant Lippenslaan
662,Luitenant Lippenslaan 200,2023-03-04,15:00:00,97,11,86,FMN 15 Luitenant Lippenslaan
662,Luitenant Lippenslaan 200,2023-03-04,16:00:00,77,12,65,FMN 15 Luitenant Lippenslaan
662,Luitenant Lippenslaan 200,2023-03-04,17:00:00,82,8,74,FMN 15 Luitenant Lippenslaan
662,Luitenant Lippenslaan 200,2023-03-04,18:00:00,109,10,99,FMN 15 Luitenant Lippenslaan
662,Luitenant Lippenslaan 200,2023-03-04,19:00:00,76,7,69,FMN 15 Luitenant Lippenslaan
662,Luitenant Lippenslaan 200,2023-03-04,20:00:00,57,9,48,FMN 15 Luitenant Lippenslaan
662,Luitenant Lippenslaan 200,2023-03-04,21:00:00,37,5,32,FMN 15 Luitenant Lippenslaan
662,Luitenant Lippenslaan 200,2023-03-04,22:00:00,29,5,24,FMN 15 Luitenant Lippenslaan
662,Luitenant Lippenslaan 200,2023-03-04,23:00:00,27,6,21,FMN 15 Luitenant Lippenslaan
662,Luitenant Lippenslaan 200,2023-03-05,00:00:00,24,5,19,FMN 15 Luitenant Lippenslaan
662,Luitenant Lippenslaan 200,2023-03-05,01:00:00,16,3,13,FMN 15 Luitenant Lippenslaan
662,Luitenant Lippenslaan 200,2023-03-05,02:00:00,10,1,9,FMN 15 Luitenant Lippenslaan
662,Luitenant Lippenslaan 200,2023-03-05,03:00:00,5,1,4,FMN 15 Luitenant Lippenslaan
662,Luitenant Lippenslaan 200,2023-03-05,04:00:00,5,1,4,FMN 15 Luitenant Lippenslaan
662,Luitenant Lippenslaan 200,2023-03-05,05:00:00,9,1,8,FMN 15 Luitenant Lippenslaan
662,Luitenant Lippenslaan 200,2023-03-05,06:00:00,18,3,15,FMN 15 Luitenant Lippenslaan
662,Luitenant Lippenslaan 200,2023-03-05,07:00:00,17,1,16,FMN 15 Luitenant Lippenslaan
662,Luitenant Lippenslaan 200,2023-03-05,08:00:00,29,3,26,FMN 15 Luitenant Lippenslaan
662,Luitenant Lippenslaan 200,2023-03-05,09:00:00,57,5,52,FMN 15 Luitenant Lippenslaan
662,Luitenant Lippenslaan 200,2023-03-05,10:00:00,72,4,68,FMN 15 Luitenant Lippenslaan
662,Luitenant Lippenslaan 200,2023-03-05,11:00:00,67,8,59,FMN 15 Luitenant Lippenslaan
662,Luitenant Lippenslaan 200,2023-03-05,12:00:00,85,5,80,FMN 15 Luitenant Lippenslaan
662,Luitenant Lippenslaan 200,2023-03-05,13:00:00,96,10,86,FMN 15 Luitenant Lippenslaan
662,Luitenant Lippenslaan 200,2023-03-05,14:00:00,79,3,76,FMN 15 Luitenant Lippenslaan
662,Luitenant Lippenslaan 200,2023-03-05,15:00:00,79,7,72,FMN 15 Luitenant Lippenslaan
662,Luitenant Lippenslaan 200,2023-03-05,16:00:00,64,6,58,FMN 15 Luitenant Lippenslaan
662,Luitenant Lippenslaan 200,2023-03-05,17:00:00,72,8,64,FMN 15 Luitenant Lippenslaan
662,Luitenant Lippenslaan 200,2023-03-05,18:00:00,77,5,72,FMN 15 Luitenant Lippenslaan
662,Luitenant Lippenslaan 200,2023-03-05,19:00:00,41,3,38,FMN 15 Luitenant Lippenslaan
662,Luitenant Lippenslaan 200,2023-03-05,20:00:00,37,7,30,FMN 15 Luitenant Lippenslaan
662,Luitenant Lippenslaan 200,2023-03-05,21:00:00,41,10,31,FMN 15 Luitenant Lippenslaan
662,Luitenant Lippenslaan 200,2023-03-05,22:00:00,28,6,22,FMN 15 Luitenant Lippenslaan
662,Luitenant Lippenslaan 200,2023-03-05,23:00:00,8,1,7,FMN 15 Luitenant Lippenslaan
662,Luitenant Lippenslaan 200,2023-03-06,00:00:00,6,2,4,FMN 15 Luitenant Lippenslaan
662,Luitenant Lippenslaan 200,2023-03-06,01:00:00,6,3,3,FMN 15 Luitenant Lippenslaan
662,Luitenant Lippenslaan 200,2023-03-06,02:00:00,3,3,0,FMN 15 Luitenant Lippenslaan
662,Luitenant Lippenslaan 200,2023-03-06,03:00:00,5,2,3,FMN 15 Luitenant Lippenslaan
662,Luitenant Lippenslaan 200,2023-03-06,04:00:00,4,0,4,FMN 15 Luitenant Lippenslaan
662,Luitenant Lippenslaan 200,2023-03-06,05:00:00,12,1,11,FMN 15 Luitenant Lippenslaan
662,Luitenant Lippenslaan 200,2023-03-06,06:00:00,69,5,64,FMN 15 Luitenant Lippenslaan
662,Luitenant Lippenslaan 200,2023-03-06,07:00:00,187,5,182,FMN 15 Luitenant Lippenslaan
662,Luitenant Lippenslaan 200,2023-03-06,08:00:00,413,12,401,FMN 15 Luitenant Lippenslaan
662,Luitenant Lippenslaan 200,2023-03-06,09:00:00,140,4,136,FMN 15 Luitenant Lippenslaan
662,Luitenant Lippenslaan 200,2023-03-06,10:00:00,66,5,61,FMN 15 Luitenant Lippenslaan
662,Luitenant Lippenslaan 200,2023-03-06,11:00:00,72,3,69,FMN 15 Luitenant Lippenslaan
662,Luitenant Lippenslaan 200,2023-03-06,12:00:00,97,7,90,FMN 15 Luitenant Lippenslaan
662,Luitenant Lippenslaan 200,2023-03-06,13:00:00,76,3,73,FMN 15 Luitenant Lippenslaan
662,Luitenant Lippenslaan 200,2023-03-06,14:00:00,70,17,53,FMN 15 Luitenant Lippenslaan
662,Luitenant Lippenslaan 200,2023-03-06,15:00:00,86,19,67,FMN 15 Luitenant Lippenslaan
662,Luitenant Lippenslaan 200,2023-03-06,16:00:00,144,16,128,FMN 15 Luitenant Lippenslaan
662,Luitenant Lippenslaan 200,2023-03-06,17:00:00,134,15,119,FMN 15 Luitenant Lippenslaan
662,Luitenant Lippenslaan 200,2023-03-06,18:00:00,115,15,100,FMN 15 Luitenant Lippenslaan
662,Luitenant Lippenslaan 200,2023-03-06,19:00:00,92,15,77,FMN 15 Luitenant Lippenslaan
662,Luitenant Lippenslaan 200,2023-03-06,20:00:00,44,5,39,FMN 15 Luitenant Lippenslaan
662,Luitenant Lippenslaan 200,2023-03-06,21:00:00,40,16,24,FMN 15 Luitenant Lippenslaan
662,Luitenant Lippenslaan 200,2023-03-06,22:00:00,34,6,28,FMN 15 Luitenant Lippenslaan
662,Luitenant Lippenslaan 200,2023-03-06,23:00:00,16,4,12,FMN 15 Luitenant Lippenslaan
662,Luitenant Lippenslaan 200,2023-03-07,00:00:00,4,0,4,FMN 15 Luitenant Lippenslaan
662,Luitenant Lippenslaan 200,2023-03-07,01:00:00,4,1,3,FMN 15 Luitenant Lippenslaan
662,Luitenant Lippenslaan 200,2023-03-07,02:00:00,5,4,1,FMN 15 Luitenant Lippenslaan
662,Luitenant Lippenslaan 200,2023-03-07,03:00:00,3,1,2,FMN 15 Luitenant Lippenslaan
662,Luitenant Lippenslaan 200,2023-03-07,04:00:00,5,0,5,FMN 15 Luitenant Lippenslaan
662,Luitenant Lippenslaan 200,2023-03-07,05:00:00,13,1,12,FMN 15 Luitenant Lippenslaan
662,Luitenant Lippenslaan 200,2023-03-07,06:00:00,58,5,53,FMN 15 Luitenant Lippenslaan
662,Luitenant Lippenslaan 200,2023-03-07,07:00:00,192,8,184,FMN 15 Luitenant Lippenslaan
662,Luitenant Lippenslaan 200,2023-03-07,08:00:00,378,7,371,FMN 15 Luitenant Lippenslaan
662,Luitenant Lippenslaan 200,2023-03-07,09:00:00,124,2,122,FMN 15 Luitenant Lippenslaan
662,Luitenant Lippenslaan 200,2023-03-07,10:00:00,69,2,67,FMN 15 Luitenant Lippenslaan
662,Luitenant Lippenslaan 200,2023-03-07,11:00:00,58,3,55,FMN 15 Luitenant Lippenslaan
662,Luitenant Lippenslaan 200,2023-03-07,12:00:00,76,4,72,FMN 15 Luitenant Lippenslaan
662,Luitenant Lippenslaan 200,2023-03-07,13:00:00,60,5,55,FMN 15 Luitenant Lippenslaan
662,Luitenant Lippenslaan 200,2023-03-07,14:00:00,57,11,46,FMN 15 Luitenant Lippenslaan
662,Luitenant Lippenslaan 200,2023-03-07,15:00:00,77,20,57,FMN 15 Luitenant Lippenslaan
662,Luitenant Lippenslaan 200,2023-03-07,16:00:00,105,11,94,FMN 15 Luitenant Lippenslaan
662,Luitenant Lippenslaan 200,2023-03-07,17:00:00,116,21,95,FMN 15 Luitenant Lippenslaan
662,Luitenant Lippenslaan 200,2023-03-07,18:00:00,87,6,81,FMN 15 Luitenant Lippenslaan
662,Luitenant Lippenslaan 200,2023-03-07,19:00:00,64,11,53,FMN 15 Luitenant Lippenslaan
662,Luitenant Lippenslaan 200,2023-03-07,20:00:00,49,4,45,FMN 15 Luitenant Lippenslaan
662,Luitenant Lippenslaan 200,2023-03-07,21:00:00,31,7,24,FMN 15 Luitenant Lippenslaan
662,Luitenant Lippenslaan 200,2023-03-07,22:00:00,25,5,20,FMN 15 Luitenant Lippenslaan
662,Luitenant Lippenslaan 200,2023-03-07,23:00:00,12,4,8,FMN 15 Luitenant Lippenslaan
662,Luitenant Lippenslaan 200,2023-03-08,00:00:00,10,2,8,FMN 15 Luitenant Lippenslaan
662,Luitenant Lippenslaan 200,2023-03-08,01:00:00,2,1,1,FMN 15 Luitenant Lippenslaan
662,Luitenant Lippenslaan 200,2023-03-08,02:00:00,2,2,0,FMN 15 Luitenant Lippenslaan
662,Luitenant Lippenslaan 200,2023-03-08,03:00:00,2,1,1,FMN 15 Luitenant Lippenslaan
662,Luitenant Lippenslaan 200,2023-03-08,04:00:00,10,3,7,FMN 15 Luitenant Lippenslaan
662,Luitenant Lippenslaan 200,2023-03-08,05:00:00,15,4,11,FMN 15 Luitenant Lippenslaan
662,Luitenant Lippenslaan 200,2023-03-08,06:00:00,43,2,41,FMN 15 Luitenant Lippenslaan
662,Luitenant Lippenslaan 200,2023-03-08,07:00:00,142,4,138,FMN 15 Luitenant Lippenslaan
662,Luitenant Lippenslaan 200,2023-03-08,08:00:00,206,4,202,FMN 15 Luitenant Lippenslaan
662,Luitenant Lippenslaan 200,2023-03-08,09:00:00,80,2,78,FMN 15 Luitenant Lippenslaan
662,Luitenant Lippenslaan 200,2023-03-08,10:00:00,40,1,39,FMN 15 Luitenant Lippenslaan
662,Luitenant Lippenslaan 200,2023-03-08,11:00:00,46,4,42,FMN 15 Luitenant Lippenslaan
662,Luitenant Lippenslaan 200,2023-03-08,12:00:00,84,11,73,FMN 15 Luitenant Lippenslaan
662,Luitenant Lippenslaan 200,2023-03-08,13:00:00,81,5,76,FMN 15 Luitenant Lippenslaan
662,Luitenant Lippenslaan 200,2023-03-08,14:00:00,64,8,56,FMN 15 Luitenant Lippenslaan
662,Luitenant Lippenslaan 200,2023-03-08,15:00:00,81,9,72,FMN 15 Luitenant Lippenslaan
662,Luitenant Lippenslaan 200,2023-03-08,16:00:00,79,10,69,FMN 15 Luitenant Lippenslaan
662,Luitenant Lippenslaan 200,2023-03-08,17:00:00,90,8,82,FMN 15 Luitenant Lippenslaan
662,Luitenant Lippenslaan 200,2023-03-08,18:00:00,77,10,67,FMN 15 Luitenant Lippenslaan
662,Luitenant Lippenslaan 200,2023-03-08,19:00:00,78,14,64,FMN 15 Luitenant Lippenslaan
662,Luitenant Lippenslaan 200,2023-03-08,20:00:00,41,5,36,FMN 15 Luitenant Lippenslaan
662,Luitenant Lippenslaan 200,2023-03-08,21:00:00,31,6,25,FMN 15 Luitenant Lippenslaan
662,Luitenant Lippenslaan 200,2023-03-08,22:00:00,32,10,22,FMN 15 Luitenant Lippenslaan
662,Luitenant Lippenslaan 200,2023-03-08,23:00:00,11,3,8,FMN 15 Luitenant Lippenslaan
662,Luitenant Lippenslaan 200,2023-03-09,00:00:00,7,1,6,FMN 15 Luitenant Lippenslaan
662,Luitenant Lippenslaan 200,2023-03-09,01:00:00,1,1,0,FMN 15 Luitenant Lippenslaan
662,Luitenant Lippenslaan 200,2023-03-09,02:00:00,5,5,0,FMN 15 Luitenant Lippenslaan
662,Luitenant Lippenslaan 200,2023-03-09,03:00:00,3,2,1,FMN 15 Luitenant Lippenslaan
662,Luitenant Lippenslaan 200,2023-03-09,04:00:00,8,2,6,FMN 15 Luitenant Lippenslaan
662,Luitenant Lippenslaan 200,2023-03-09,05:00:00,17,2,15,FMN 15 Luitenant Lippenslaan
662,Luitenant Lippenslaan 200,2023-03-09,06:00:00,47,4,43,FMN 15 Luitenant Lippenslaan
662,Luitenant Lippenslaan 200,2023-03-09,07:00:00,175,6,169,FMN 15 Luitenant Lippenslaan
662,Luitenant Lippenslaan 200,2023-03-09,08:00:00,434,6,428,FMN 15 Luitenant Lippenslaan
662,Luitenant Lippenslaan 200,2023-03-09,09:00:00,153,4,149,FMN 15 Luitenant Lippenslaan
662,Luitenant Lippenslaan 200,2023-03-09,10:00:00,69,4,65,FMN 15 Luitenant Lippenslaan
662,Luitenant Lippenslaan 200,2023-03-09,11:00:00,62,3,59,FMN 15 Luitenant Lippenslaan
662,Luitenant Lippenslaan 200,2023-03-09,12:00:00,59,7,52,FMN 15 Luitenant Lippenslaan
662,Luitenant Lippenslaan 200,2023-03-09,13:00:00,58,5,53,FMN 15 Luitenant Lippenslaan
662,Luitenant Lippenslaan 200,2023-03-09,14:00:00,52,8,44,FMN 15 Luitenant Lippenslaan
662,Luitenant Lippenslaan 200,2023-03-09,15:00:00,95,19,76,FMN 15 Luitenant Lippenslaan
662,Luitenant Lippenslaan 200,2023-03-09,16:00:00,95,10,85,FMN 15 Luitenant Lippenslaan
662,Luitenant Lippenslaan 200,2023-03-09,17:00:00,118,13,105,FMN 15 Luitenant Lippenslaan
662,Luitenant Lippenslaan 200,2023-03-09,18:00:00,108,9,99,FMN 15 Luitenant Lippenslaan
662,Luitenant Lippenslaan 200,2023-03-09,19:00:00,75,12,63,FMN 15 Luitenant Lippenslaan
662,Luitenant Lippenslaan 200,2023-03-09,20:00:00,55,7,48,FMN 15 Luitenant Lippenslaan
662,Luitenant Lippenslaan 200,2023-03-09,21:00:00,41,13,28,FMN 15 Luitenant Lippenslaan
662,Luitenant Lippenslaan 200,2023-03-09,22:00:00,26,6,20,FMN 15 Luitenant Lippenslaan
662,Luitenant Lippenslaan 200,2023-03-09,23:00:00,12,1,11,FMN 15 Luitenant Lippenslaan
662,Luitenant Lippenslaan 200,2023-03-10,00:00:00,8,2,6,FMN 15 Luitenant Lippenslaan
662,Luitenant Lippenslaan 200,2023-03-10,01:00:00,3,0,3,FMN 15 Luitenant Lippenslaan
662,Luitenant Lippenslaan 200,2023-03-10,02:00:00,6,5,1,FMN 15 Luitenant Lippenslaan
662,Luitenant Lippenslaan 200,2023-03-10,03:00:00,3,1,2,FMN 15 Luitenant Lippenslaan
662,Luitenant Lippenslaan 200,2023-03-10,04:00:00,10,2,8,FMN 15 Luitenant Lippenslaan
662,Luitenant Lippenslaan 200,2023-03-10,05:00:00,16,3,13,FMN 15 Luitenant Lippenslaan
662,Luitenant Lippenslaan 200,2023-03-10,06:00:00,43,5,38,FMN 15 Luitenant Lippenslaan
662,Luitenant Lippenslaan 200,2023-03-10,07:00:00,183,5,178,FMN 15 Luitenant Lippenslaan
662,Luitenant Lippenslaan 200,2023-03-10,08:00:00,370,8,362,FMN 15 Luitenant Lippenslaan
662,Luitenant Lippenslaan 200,2023-03-10,09:00:00,117,2,115,FMN 15 Luitenant Lippenslaan
662,Luitenant Lippenslaan 200,2023-03-10,10:00:00,67,1,66,FMN 15 Luitenant Lippenslaan
662,Luitenant Lippenslaan 200,2023-03-10,11:00:00,57,4,53,FMN 15 Luitenant Lippenslaan
662,Luitenant Lippenslaan 200,2023-03-10,12:00:00,98,7,91,FMN 15 Luitenant Lippenslaan
662,Luitenant Lippenslaan 200,2023-03-10,13:00:00,93,10,83,FMN 15 Luitenant Lippenslaan
662,Luitenant Lippenslaan 200,2023-03-10,14:00:00,63,11,52,FMN 15 Luitenant Lippenslaan
662,Luitenant Lippenslaan 200,2023-03-10,15:00:00,89,14,75,FMN 15 Luitenant Lippenslaan
662,Luitenant Lippenslaan 200,2023-03-10,16:00:00,92,7,85,FMN 15 Luitenant Lippenslaan
662,Luitenant Lippenslaan 200,2023-03-10,17:00:00,127,18,109,FMN 15 Luitenant Lippenslaan
662,Luitenant Lippenslaan 200,2023-03-10,18:00:00,86,4,82,FMN 15 Luitenant Lippenslaan
662,Luitenant Lippenslaan 200,2023-03-10,19:00:00,113,17,96,FMN 15 Luitenant Lippenslaan
662,Luitenant Lippenslaan 200,2023-03-10,20:00:00,43,3,40,FMN 15 Luitenant Lippenslaan
662,Luitenant Lippenslaan 200,2023-03-10,21:00:00,56,11,45,FMN 15 Luitenant Lippenslaan
662,Luitenant Lippenslaan 200,2023-03-10,22:00:00,21,7,14,FMN 15 Luitenant Lippenslaan
662,Luitenant Lippenslaan 200,2023-03-10,23:00:00,17,4,13,FMN 15 Luitenant Lippenslaan
662,Luitenant Lippenslaan 200,2023-03-11,00:00:00,23,6,17,FMN 15 Luitenant Lippenslaan
662,Luitenant Lippenslaan 200,2023-03-11,01:00:00,8,1,7,FMN 15 Luitenant Lippenslaan
662,Luitenant Lippenslaan 200,2023-03-11,02:00:00,12,4,8,FMN 15 Luitenant Lippenslaan
662,Luitenant Lippenslaan 200,2023-03-11,03:00:00,5,1,4,FMN 15 Luitenant Lippenslaan
662,Luitenant Lippenslaan 200,2023-03-11,04:00:00,14,2,12,FMN 15 Luitenant Lippenslaan
662,Luitenant Lippenslaan 200,2023-03-11,05:00:00,10,1,9,FMN 15 Luitenant Lippenslaan
662,Luitenant Lippenslaan 200,2023-03-11,06:00:00,13,3,10,FMN 15 Luitenant Lippenslaan
662,Luitenant Lippenslaan 200,2023-03-11,07:00:00,25,3,22,FMN 15 Luitenant Lippenslaan
662,Luitenant Lippenslaan 200,2023-03-11,08:00:00,48,4,44,FMN 15 Luitenant Lippenslaan
662,Luitenant Lippenslaan 200,2023-03-11,09:00:00,83,6,77,FMN 15 Luitenant Lippenslaan
662,Luitenant Lippenslaan 200,2023-03-11,10:00:00,116,4,112,FMN 15 Luitenant Lippenslaan
662,Luitenant Lippenslaan 200,2023-03-11,11:00:00,120,9,111,FMN 15 Luitenant Lippenslaan
662,Luitenant Lippenslaan 200,2023-03-11,12:00:00,94,12,82,FMN 15 Luitenant Lippenslaan
662,Luitenant Lippenslaan 200,2023-03-11,13:00:00,134,8,126,FMN 15 Luitenant Lippenslaan
662,Luitenant Lippenslaan 200,2023-03-11,14:00:00,103,10,93,FMN 15 Luitenant Lippenslaan
662,Luitenant Lippenslaan 200,2023-03-11,15:00:00,107,11,96,FMN 15 Luitenant Lippenslaan
662,Luitenant Lippenslaan 200,2023-03-11,16:00:00,105,10,95,FMN 15 Luitenant Lippenslaan
662,Luitenant Lippenslaan 200,2023-03-11,17:00:00,134,14,120,FMN 15 Luitenant Lippenslaan
662,Luitenant Lippenslaan 200,2023-03-11,18:00:00,123,11,112,FMN 15 Luitenant Lippenslaan
662,Luitenant Lippenslaan 200,2023-03-11,19:00:00,96,12,84,FMN 15 Luitenant Lippenslaan
662,Luitenant Lippenslaan 200,2023-03-11,20:00:00,71,10,61,FMN 15 Luitenant Lippenslaan
662,Luitenant Lippenslaan 200,2023-03-11,21:00:00,44,5,39,FMN 15 Luitenant Lippenslaan
662,Luitenant Lippenslaan 200,2023-03-11,22:00:00,24,5,19,FMN 15 Luitenant Lippenslaan
662,Luitenant Lippenslaan 200,2023-03-11,23:00:00,19,2,17,FMN 15 Luitenant Lippenslaan
662,Luitenant Lippenslaan 200,2023-03-12,00:00:00,36,9,27,FMN 15 Luitenant Lippenslaan
662,Luitenant Lippenslaan 200,2023-03-12,01:00:00,18,3,15,FMN 15 Luitenant Lippenslaan
662,Luitenant Lippenslaan 200,2023-03-12,02:00:00,10,1,9,FMN 15 Luitenant Lippenslaan
662,Luitenant Lippenslaan 200,2023-03-12,03:00:00,10,7,3,FMN 15 Luitenant Lippenslaan
662,Luitenant Lippenslaan 200,2023-03-12,04:00:00,3,1,2,FMN 15 Luitenant Lippenslaan
662,Luitenant Lippenslaan 200,2023-03-12,05:00:00,8,2,6,FMN 15 Luitenant Lippenslaan
662,Luitenant Lippenslaan 200,2023-03-12,06:00:00,15,4,11,FMN 15 Luitenant Lippenslaan
662,Luitenant Lippenslaan 200,2023-03-12,07:00:00,9,1,8,FMN 15 Luitenant Lippenslaan
662,Luitenant Lippenslaan 200,2023-03-12,08:00:00,31,5,26,FMN 15 Luitenant Lippenslaan
662,Luitenant Lippenslaan 200,2023-03-12,09:00:00,44,3,41,FMN 15 Luitenant Lippenslaan
662,Luitenant Lippenslaan 200,2023-03-12,10:00:00,56,5,51,FMN 15 Luitenant Lippenslaan
662,Luitenant Lippenslaan 200,2023-03-12,11:00:00,69,11,58,FMN 15 Luitenant Lippenslaan
662,Luitenant Lippenslaan 200,2023-03-12,12:00:00,57,11,46,FMN 15 Luitenant Lippenslaan
662,Luitenant Lippenslaan 200,2023-03-12,13:00:00,90,11,79,FMN 15 Luitenant Lippenslaan
662,Luitenant Lippenslaan 200,2023-03-12,14:00:00,100,8,92,FMN 15 Luitenant Lippenslaan
662,Luitenant Lippenslaan 200,2023-03-12,15:00:00,49,6,43,FMN 15 Luitenant Lippenslaan
662,Luitenant Lippenslaan 200,2023-03-12,16:00:00,82,10,72,FMN 15 Luitenant Lippenslaan
662,Luitenant Lippenslaan 200,2023-03-12,17:00:00,67,5,62,FMN 15 Luitenant Lippenslaan
662,Luitenant Lippenslaan 200,2023-03-12,18:00:00,77,8,69,FMN 15 Luitenant Lippenslaan
662,Luitenant Lippenslaan 200,2023-03-12,19:00:00,63,11,52,FMN 15 Luitenant Lippenslaan
662,Luitenant Lippenslaan 200,2023-03-12,20:00:00,32,5,27,FMN 15 Luitenant Lippenslaan
662,Luitenant Lippenslaan 200,2023-03-12,21:00:00,31,9,22,FMN 15 Luitenant Lippenslaan
662,Luitenant Lippenslaan 200,2023-03-12,22:00:00,23,8,15,FMN 15 Luitenant Lippenslaan
662,Luitenant Lippenslaan 200,2023-03-12,23:00:00,8,2,6,FMN 15 Luitenant Lippenslaan
662,Luitenant Lippenslaan 200,2023-03-13,00:00:00,11,3,8,FMN 15 Luitenant Lippenslaan
662,Luitenant Lippenslaan 200,2023-03-13,01:00:00,2,1,1,FMN 15 Luitenant Lippenslaan
662,Luitenant Lippenslaan 200,2023-03-13,02:00:00,5,3,2,FMN 15 Luitenant Lippenslaan
662,Luitenant Lippenslaan 200,2023-03-13,03:00:00,3,1,2,FMN 15 Luitenant Lippenslaan
662,Luitenant Lippenslaan 200,2023-03-13,04:00:00,8,0,8,FMN 15 Luitenant Lippenslaan
662,Luitenant Lippenslaan 200,2023-03-13,05:00:00,17,4,13,FMN 15 Luitenant Lippenslaan
662,Luitenant Lippenslaan 200,2023-03-13,06:00:00,69,7,62,FMN 15 Luitenant Lippenslaan
662,Luitenant Lippenslaan 200,2023-03-13,07:00:00,182,6,176,FMN 15 Luitenant Lippenslaan
662,Luitenant Lippenslaan 200,2023-03-13,08:00:00,396,6,390,FMN 15 Luitenant Lippenslaan
662,Luitenant Lippenslaan 200,2023-03-13,09:00:00,149,9,140,FMN 15 Luitenant Lippenslaan
662,Luitenant Lippenslaan 200,2023-03-13,10:00:00,91,6,85,FMN 15 Luitenant Lippenslaan
662,Luitenant Lippenslaan 200,2023-03-13,11:00:00,73,9,64,FMN 15 Luitenant Lippenslaan
662,Luitenant Lippenslaan 200,2023-03-13,12:00:00,74,6,68,FMN 15 Luitenant Lippenslaan
662,Luitenant Lippenslaan 200,2023-03-13,13:00:00,55,5,50,FMN 15 Luitenant Lippenslaan
662,Luitenant Lippenslaan 200,2023-03-13,14:00:00,72,9,63,FMN 15 Luitenant Lippenslaan
662,Luitenant Lippenslaan 200,2023-03-13,15:00:00,103,29,74,FMN 15 Luitenant Lippenslaan
662,Luitenant Lippenslaan 200,2023-03-13,16:00:00,148,16,132,FMN 15 Luitenant Lippenslaan
662,Luitenant Lippenslaan 200,2023-03-13,17:00:00,136,19,117,FMN 15 Luitenant Lippenslaan
662,Luitenant Lippenslaan 200,2023-03-13,18:00:00,108,13,95,FMN 15 Luitenant Lippenslaan
662,Luitenant Lippenslaan 200,2023-03-13,19:00:00,120,22,98,FMN 15 Luitenant Lippenslaan
662,Luitenant Lippenslaan 200,2023-03-13,20:00:00,64,4,60,FMN 15 Luitenant Lippenslaan
662,Luitenant Lippenslaan 200,2023-03-13,21:00:00,48,15,33,FMN 15 Luitenant Lippenslaan
662,Luitenant Lippenslaan 200,2023-03-13,22:00:00,24,5,19,FMN 15 Luitenant Lippenslaan
662,Luitenant Lippenslaan 200,2023-03-13,23:00:00,7,2,5,FMN 15 Luitenant Lippenslaan
662,Luitenant Lippenslaan 200,2023-03-14,00:00:00,12,3,9,FMN 15 Luitenant Lippenslaan
662,Luitenant Lippenslaan 200,2023-03-14,01:00:00,3,2,1,FMN 15 Luitenant Lippenslaan
662,Luitenant Lippenslaan 200,2023-03-14,02:00:00,3,3,0,FMN 15 Luitenant Lippenslaan
662,Luitenant Lippenslaan 200,2023-03-14,03:00:00,4,1,3,FMN 15 Luitenant Lippenslaan
662,Luitenant Lippenslaan 200,2023-03-14,04:00:00,7,1,6,FMN 15 Luitenant Lippenslaan
662,Luitenant Lippenslaan 200,2023-03-14,05:00:00,17,2,15,FMN 15 Luitenant Lippenslaan
662,Luitenant Lippenslaan 200,2023-03-14,06:00:00,66,9,57,FMN 15 Luitenant Lippenslaan
662,Luitenant Lippenslaan 200,2023-03-14,07:00:00,168,2,166,FMN 15 Luitenant Lippenslaan
662,Luitenant Lippenslaan 200,2023-03-14,08:00:00,387,9,378,FMN 15 Luitenant Lippenslaan
662,Luitenant Lippenslaan 200,2023-03-14,09:00:00,155,11,144,FMN 15 Luitenant Lippenslaan
662,Luitenant Lippenslaan 200,2023-03-14,10:00:00,71,6,65,FMN 15 Luitenant Lippenslaan
662,Luitenant Lippenslaan 200,2023-03-14,11:00:00,77,5,72,FMN 15 Luitenant Lippenslaan
662,Luitenant Lippenslaan 200,2023-03-14,12:00:00,87,9,78,FMN 15 Luitenant Lippenslaan
662,Luitenant Lippenslaan 200,2023-03-14,13:00:00,69,10,59,FMN 15 Luitenant Lippenslaan
662,Luitenant Lippenslaan 200,2023-03-14,14:00:00,55,7,48,FMN 15 Luitenant Lippenslaan
662,Luitenant Lippenslaan 200,2023-03-14,15:00:00,90,14,76,FMN 15 Luitenant Lippenslaan
662,Luitenant Lippenslaan 200,2023-03-14,16:00:00,124,18,106,FMN 15 Luitenant Lippenslaan
662,Luitenant Lippenslaan 200,2023-03-14,17:00:00,131,11,120,FMN 15 Luitenant Lippenslaan
662,Luitenant Lippenslaan 200,2023-03-14,18:00:00,126,14,112,FMN 15 Luitenant Lippenslaan
662,Luitenant Lippenslaan 200,2023-03-14,19:00:00,97,11,86,FMN 15 Luitenant Lippenslaan
662,Luitenant Lippenslaan 200,2023-03-14,20:00:00,59,12,47,FMN 15 Luitenant Lippenslaan
662,Luitenant Lippenslaan 200,2023-03-14,21:00:00,35,12,23,FMN 15 Luitenant Lippenslaan
662,Luitenant Lippenslaan 200,2023-03-14,22:00:00,31,7,24,FMN 15 Luitenant Lippenslaan
662,Luitenant Lippenslaan 200,2023-03-14,23:00:00,14,5,9,FMN 15 Luitenant Lippenslaan
662,Luitenant Lippenslaan 200,2023-03-15,00:00:00,9,4,5,FMN 15 Luitenant Lippenslaan
662,Luitenant Lippenslaan 200,2023-03-15,01:00:00,5,0,5,FMN 15 Luitenant Lippenslaan
662,Luitenant Lippenslaan 200,2023-03-15,02:00:00,5,5,0,FMN 15 Luitenant Lippenslaan
662,Luitenant Lippenslaan 200,2023-03-15,03:00:00,2,0,2,FMN 15 Luitenant Lippenslaan
662,Luitenant Lippenslaan 200,2023-03-15,04:00:00,8,1,7,FMN 15 Luitenant Lippenslaan
662,Luitenant Lippenslaan 200,2023-03-15,05:00:00,21,1,20,FMN 15 Luitenant Lippenslaan
662,Luitenant Lippenslaan 200,2023-03-15,06:00:00,65,3,62,FMN 15 Luitenant Lippenslaan
662,Luitenant Lippenslaan 200,2023-03-15,07:00:00,195,6,189,FMN 15 Luitenant Lippenslaan
662,Luitenant Lippenslaan 200,2023-03-15,08:00:00,374,8,366,FMN 15 Luitenant Lippenslaan
662,Luitenant Lippenslaan 200,2023-03-15,09:00:00,165,7,158,FMN 15 Luitenant Lippenslaan
662,Luitenant Lippenslaan 200,2023-03-15,10:00:00,103,4,99,FMN 15 Luitenant Lippenslaan
662,Luitenant Lippenslaan 200,2023-03-15,11:00:00,78,5,73,FMN 15 Luitenant Lippenslaan
662,Luitenant Lippenslaan 200,2023-03-15,12:00:00,133,17,116,FMN 15 Luitenant Lippenslaan
662,Luitenant Lippenslaan 200,2023-03-15,13:00:00,118,10,108,FMN 15 Luitenant Lippenslaan
662,Luitenant Lippenslaan 200,2023-03-15,14:00:00,94,9,85,FMN 15 Luitenant Lippenslaan
662,Luitenant Lippenslaan 200,2023-03-15,15:00:00,99,15,84,FMN 15 Luitenant Lippenslaan
662,Luitenant Lippenslaan 200,2023-03-15,16:00:00,138,20,118,FMN 15 Luitenant Lippenslaan
662,Luitenant Lippenslaan 200,2023-03-15,17:00:00,170,20,150,FMN 15 Luitenant Lippenslaan
662,Luitenant Lippenslaan 200,2023-03-15,18:00:00,148,18,130,FMN 15 Luitenant Lippenslaan
662,Luitenant Lippenslaan 200,2023-03-15,19:00:00,114,16,98,FMN 15 Luitenant Lippenslaan
662,Luitenant Lippenslaan 200,2023-03-15,20:00:00,69,15,54,FMN 15 Luitenant Lippenslaan
662,Luitenant Lippenslaan 200,2023-03-15,21:00:00,48,13,35,FMN 15 Luitenant Lippenslaan
662,Luitenant Lippenslaan 200,2023-03-15,22:00:00,40,7,33,FMN 15 Luitenant Lippenslaan
662,Luitenant Lippenslaan 200,2023-03-15,23:00:00,25,9,16,FMN 15 Luitenant Lippenslaan
662,Luitenant Lippenslaan 200,2023-03-16,00:00:00,8,2,6,FMN 15 Luitenant Lippenslaan
662,Luitenant Lippenslaan 200,2023-03-16,01:00:00,9,5,4,FMN 15 Luitenant Lippenslaan
662,Luitenant Lippenslaan 200,2023-03-16,02:00:00,2,2,0,FMN 15 Luitenant Lippenslaan
662,Luitenant Lippenslaan 200,2023-03-16,03:00:00,6,3,3,FMN 15 Luitenant Lippenslaan
662,Luitenant Lippenslaan 200,2023-03-16,04:00:00,9,0,9,FMN 15 Luitenant Lippenslaan
662,Luitenant Lippenslaan 200,2023-03-16,05:00:00,21,2,19,FMN 15 Luitenant Lippenslaan
662,Luitenant Lippenslaan 200,2023-03-16,06:00:00,62,4,58,FMN 15 Luitenant Lippenslaan
662,Luitenant Lippenslaan 200,2023-03-16,07:00:00,216,8,208,FMN 15 Luitenant Lippenslaan
662,Luitenant Lippenslaan 200,2023-03-16,08:00:00,450,8,442,FMN 15 Luitenant Lippenslaan
662,Luitenant Lippenslaan 200,2023-03-16,09:00:00,201,8,193,FMN 15 Luitenant Lippenslaan
662,Luitenant Lippenslaan 200,2023-03-16,10:00:00,156,8,148,FMN 15 Luitenant Lippenslaan
662,Luitenant Lippenslaan 200,2023-03-16,11:00:00,83,8,75,FMN 15 Luitenant Lippenslaan
662,Luitenant Lippenslaan 200,2023-03-16,12:00:00,120,10,110,FMN 15 Luitenant Lippenslaan
662,Luitenant Lippenslaan 200,2023-03-16,13:00:00,95,9,86,FMN 15 Luitenant Lippenslaan
662,Luitenant Lippenslaan 200,2023-03-16,14:00:00,80,9,71,FMN 15 Luitenant Lippenslaan
662,Luitenant Lippenslaan 200,2023-03-16,15:00:00,105,13,92,FMN 15 Luitenant Lippenslaan
662,Luitenant Lippenslaan 200,2023-03-16,16:00:00,155,26,129,FMN 15 Luitenant Lippenslaan
662,Luitenant Lippenslaan 200,2023-03-16,17:00:00,168,13,155,FMN 15 Luitenant Lippenslaan
662,Luitenant Lippenslaan 200,2023-03-16,18:00:00,173,13,160,FMN 15 Luitenant Lippenslaan
662,Luitenant Lippenslaan 200,2023-03-16,19:00:00,128,15,113,FMN 15 Luitenant Lippenslaan
662,Luitenant Lippenslaan 200,2023-03-16,20:00:00,62,7,55,FMN 15 Luitenant Lippenslaan
662,Luitenant Lippenslaan 200,2023-03-16,21:00:00,43,13,30,FMN 15 Luitenant Lippenslaan
662,Luitenant Lippenslaan 200,2023-03-16,22:00:00,44,7,37,FMN 15 Luitenant Lippenslaan
662,Luitenant Lippenslaan 200,2023-03-16,23:00:00,12,2,10,FMN 15 Luitenant Lippenslaan
662,Luitenant Lippenslaan 200,2023-03-17,00:00:00,18,4,14,FMN 15 Luitenant Lippenslaan
662,Luitenant Lippenslaan 200,2023-03-17,01:00:00,3,1,2,FMN 15 Luitenant Lippenslaan
662,Luitenant Lippenslaan 200,2023-03-17,02:00:00,4,4,0,FMN 15 Luitenant Lippenslaan
662,Luitenant Lippenslaan 200,2023-03-17,03:00:00,5,1,4,FMN 15 Luitenant Lippenslaan
662,Luitenant Lippenslaan 200,2023-03-17,04:00:00,10,2,8,FMN 15 Luitenant Lippenslaan
662,Luitenant Lippenslaan 200,2023-03-17,05:00:00,22,3,19,FMN 15 Luitenant Lippenslaan
662,Luitenant Lippenslaan 200,2023-03-17,06:00:00,65,6,59,FMN 15 Luitenant Lippenslaan
662,Luitenant Lippenslaan 200,2023-03-17,07:00:00,205,3,202,FMN 15 Luitenant Lippenslaan
662,Luitenant Lippenslaan 200,2023-03-17,08:00:00,379,5,374,FMN 15 Luitenant Lippenslaan
662,Luitenant Lippenslaan 200,2023-03-17,09:00:00,147,5,142,FMN 15 Luitenant Lippenslaan
662,Luitenant Lippenslaan 200,2023-03-17,10:00:00,91,5,86,FMN 15 Luitenant Lippenslaan
662,Luitenant Lippenslaan 200,2023-03-17,11:00:00,78,6,72,FMN 15 Luitenant Lippenslaan
662,Luitenant Lippenslaan 200,2023-03-17,12:00:00,125,13,112,FMN 15 Luitenant Lippenslaan
662,Luitenant Lippenslaan 200,2023-03-17,13:00:00,121,7,114,FMN 15 Luitenant Lippenslaan
662,Luitenant Lippenslaan 200,2023-03-17,14:00:00,91,20,71,FMN 15 Luitenant Lippenslaan
662,Luitenant Lippenslaan 200,2023-03-17,15:00:00,114,14,100,FMN 15 Luitenant Lippenslaan
662,Luitenant Lippenslaan 200,2023-03-17,16:00:00,159,21,138,FMN 15 Luitenant Lippenslaan
662,Luitenant Lippenslaan 200,2023-03-17,17:00:00,178,20,158,FMN 15 Luitenant Lippenslaan
662,Luitenant Lippenslaan 200,2023-03-17,18:00:00,148,10,138,FMN 15 Luitenant Lippenslaan
662,Luitenant Lippenslaan 200,2023-03-17,19:00:00,121,16,105,FMN 15 Luitenant Lippenslaan
662,Luitenant Lippenslaan 200,2023-03-17,20:00:00,114,11,103,FMN 15 Luitenant Lippenslaan
662,Luitenant Lippenslaan 200,2023-03-17,21:00:00,65,14,51,FMN 15 Luitenant Lippenslaan
662,Luitenant Lippenslaan 200,2023-03-17,22:00:00,27,5,22,FMN 15 Luitenant Lippenslaan
662,Luitenant Lippenslaan 200,2023-03-17,23:00:00,24,5,19,FMN 15 Luitenant Lippenslaan
662,Luitenant Lippenslaan 200,2023-03-18,00:00:00,32,8,24,FMN 15 Luitenant Lippenslaan
662,Luitenant Lippenslaan 200,2023-03-18,01:00:00,21,4,17,FMN 15 Luitenant Lippenslaan
662,Luitenant Lippenslaan 200,2023-03-18,02:00:00,8,2,6,FMN 15 Luitenant Lippenslaan
662,Luitenant Lippenslaan 200,2023-03-18,03:00:00,9,2,7,FMN 15 Luitenant Lippenslaan
662,Luitenant Lippenslaan 200,2023-03-18,04:00:00,7,2,5,FMN 15 Luitenant Lippenslaan
662,Luitenant Lippenslaan 200,2023-03-18,05:00:00,7,0,7,FMN 15 Luitenant Lippenslaan
662,Luitenant Lippenslaan 200,2023-03-18,06:00:00,22,6,16,FMN 15 Luitenant Lippenslaan
662,Luitenant Lippenslaan 200,2023-03-18,07:00:00,34,4,30,FMN 15 Luitenant Lippenslaan
662,Luitenant Lippenslaan 200,2023-03-18,08:00:00,65,3,62,FMN 15 Luitenant Lippenslaan
662,Luitenant Lippenslaan 200,2023-03-18,09:00:00,120,7,113,FMN 15 Luitenant Lippenslaan
662,Luitenant Lippenslaan 200,2023-03-18,10:00:00,112,10,102,FMN 15 Luitenant Lippenslaan
662,Luitenant Lippenslaan 200,2023-03-18,11:00:00,87,4,83,FMN 15 Luitenant Lippenslaan
662,Luitenant Lippenslaan 200,2023-03-18,12:00:00,120,11,109,FMN 15 Luitenant Lippenslaan
662,Luitenant Lippenslaan 200,2023-03-18,13:00:00,107,4,103,FMN 15 Luitenant Lippenslaan
662,Luitenant Lippenslaan 200,2023-03-18,14:00:00,93,7,86,FMN 15 Luitenant Lippenslaan
662,Luitenant Lippenslaan 200,2023-03-18,15:00:00,102,10,92,FMN 15 Luitenant Lippenslaan
662,Luitenant Lippenslaan 200,2023-03-18,16:00:00,90,17,73,FMN 15 Luitenant Lippenslaan
662,Luitenant Lippenslaan 200,2023-03-18,17:00:00,123,8,115,FMN 15 Luitenant Lippenslaan
662,Luitenant Lippenslaan 200,2023-03-18,18:00:00,103,10,93,FMN 15 Luitenant Lippenslaan
662,Luitenant Lippenslaan 200,2023-03-18,19:00:00,64,11,53,FMN 15 Luitenant Lippenslaan
662,Luitenant Lippenslaan 200,2023-03-18,20:00:00,63,5,58,FMN 15 Luitenant Lippenslaan
662,Luitenant Lippenslaan 200,2023-03-18,21:00:00,42,6,36,FMN 15 Luitenant Lippenslaan
662,Luitenant Lippenslaan 200,2023-03-18,22:00:00,23,4,19,FMN 15 Luitenant Lippenslaan
662,Luitenant Lippenslaan 200,2023-03-18,23:00:00,38,12,26,FMN 15 Luitenant Lippenslaan
662,Luitenant Lippenslaan 200,2023-03-19,00:00:00,22,9,13,FMN 15 Luitenant Lippenslaan
662,Luitenant Lippenslaan 200,2023-03-19,01:00:00,18,1,17,FMN 15 Luitenant Lippenslaan
662,Luitenant Lippenslaan 200,2023-03-19,02:00:00,12,4,8,FMN 15 Luitenant Lippenslaan
662,Luitenant Lippenslaan 200,2023-03-19,03:00:00,9,4,5,FMN 15 Luitenant Lippenslaan
662,Luitenant Lippenslaan 200,2023-03-19,04:00:00,8,2,6,FMN 15 Luitenant Lippenslaan
662,Luitenant Lippenslaan 200,2023-03-19,05:00:00,6,1,5,FMN 15 Luitenant Lippenslaan
662,Luitenant Lippenslaan 200,2023-03-19,06:00:00,18,4,14,FMN 15 Luitenant Lippenslaan
662,Luitenant Lippenslaan 200,2023-03-19,07:00:00,17,0,17,FMN 15 Luitenant Lippenslaan
662,Luitenant Lippenslaan 200,2023-03-19,08:00:00,28,6,22,FMN 15 Luitenant Lippenslaan
662,Luitenant Lippenslaan 200,2023-03-19,09:00:00,71,8,63,FMN 15 Luitenant Lippenslaan
662,Luitenant Lippenslaan 200,2023-03-19,10:00:00,79,4,75,FMN 15 Luitenant Lippenslaan
662,Luitenant Lippenslaan 200,2023-03-19,11:00:00,78,11,67,FMN 15 Luitenant Lippenslaan
662,Luitenant Lippenslaan 200,2023-03-19,12:00:00,96,6,90,FMN 15 Luitenant Lippenslaan
662,Luitenant Lippenslaan 200,2023-03-19,13:00:00,98,4,94,FMN 15 Luitenant Lippenslaan
662,Luitenant Lippenslaan 200,2023-03-19,14:00:00,95,6,89,FMN 15 Luitenant Lippenslaan
662,Luitenant Lippenslaan 200,2023-03-19,15:00:00,88,10,78,FMN 15 Luitenant Lippenslaan
662,Luitenant Lippenslaan 200,2023-03-19,16:00:00,92,10,82,FMN 15 Luitenant Lippenslaan
662,Luitenant Lippenslaan 200,2023-03-19,17:00:00,73,11,62,FMN 15 Luitenant Lippenslaan
662,Luitenant Lippenslaan 200,2023-03-19,18:00:00,71,21,50,FMN 15 Luitenant Lippenslaan
662,Luitenant Lippenslaan 200,2023-03-19,19:00:00,61,8,53,FMN 15 Luitenant Lippenslaan
662,Luitenant Lippenslaan 200,2023-03-19,20:00:00,40,6,34,FMN 15 Luitenant Lippenslaan
662,Luitenant Lippenslaan 200,2023-03-19,21:00:00,42,9,33,FMN 15 Luitenant Lippenslaan
662,Luitenant Lippenslaan 200,2023-03-19,22:00:00,29,5,24,FMN 15 Luitenant Lippenslaan
662,Luitenant Lippenslaan 200,2023-03-19,23:00:00,25,9,16,FMN 15 Luitenant Lippenslaan
662,Luitenant Lippenslaan 200,2023-03-20,00:00:00,4,1,3,FMN 15 Luitenant Lippenslaan
662,Luitenant Lippenslaan 200,2023-03-20,01:00:00,4,2,2,FMN 15 Luitenant Lippenslaan
662,Luitenant Lippenslaan 200,2023-03-20,02:00:00,6,5,1,FMN 15 Luitenant Lippenslaan
662,Luitenant Lippenslaan 200,2023-03-20,03:00:00,3,0,3,FMN 15 Luitenant Lippenslaan
662,Luitenant Lippenslaan 200,2023-03-20,04:00:00,4,0,4,FMN 15 Luitenant Lippenslaan
662,Luitenant Lippenslaan 200,2023-03-20,05:00:00,15,4,11,FMN 15 Luitenant Lippenslaan
662,Luitenant Lippenslaan 200,2023-03-20,06:00:00,75,9,66,FMN 15 Luitenant Lippenslaan
662,Luitenant Lippenslaan 200,2023-03-20,07:00:00,216,4,212,FMN 15 Luitenant Lippenslaan
662,Luitenant Lippenslaan 200,2023-03-20,08:00:00,435,11,424,FMN 15 Luitenant Lippenslaan
662,Luitenant Lippenslaan 200,2023-03-20,09:00:00,137,4,133,FMN 15 Luitenant Lippenslaan
662,Luitenant Lippenslaan 200,2023-03-20,10:00:00,77,5,72,FMN 15 Luitenant Lippenslaan
662,Luitenant Lippenslaan 200,2023-03-20,11:00:00,74,8,66,FMN 15 Luitenant Lippenslaan
662,Luitenant Lippenslaan 200,2023-03-20,12:00:00,101,11,90,FMN 15 Luitenant Lippenslaan
662,Luitenant Lippenslaan 200,2023-03-20,13:00:00,92,9,83,FMN 15 Luitenant Lippenslaan
662,Luitenant Lippenslaan 200,2023-03-20,14:00:00,71,9,62,FMN 15 Luitenant Lippenslaan
662,Luitenant Lippenslaan 200,2023-03-20,15:00:00,102,16,86,FMN 15 Luitenant Lippenslaan
662,Luitenant Lippenslaan 200,2023-03-20,16:00:00,125,21,104,FMN 15 Luitenant Lippenslaan
662,Luitenant Lippenslaan 200,2023-03-20,17:00:00,154,16,138,FMN 15 Luitenant Lippenslaan
662,Luitenant Lippenslaan 200,2023-03-20,18:00:00,121,15,106,FMN 15 Luitenant Lippenslaan
662,Luitenant Lippenslaan 200,2023-03-20,19:00:00,93,14,79,FMN 15 Luitenant Lippenslaan
662,Luitenant Lippenslaan 200,2023-03-20,20:00:00,59,4,55,FMN 15 Luitenant Lippenslaan
662,Luitenant Lippenslaan 200,2023-03-20,21:00:00,34,12,22,FMN 15 Luitenant Lippenslaan
662,Luitenant Lippenslaan 200,2023-03-20,22:00:00,40,8,32,FMN 15 Luitenant Lippenslaan
662,Luitenant Lippenslaan 200,2023-03-20,23:00:00,14,6,8,FMN 15 Luitenant Lippenslaan
662,Luitenant Lippenslaan 200,2023-03-21,00:00:00,6,1,5,FMN 15 Luitenant Lippenslaan
662,Luitenant Lippenslaan 200,2023-03-21,01:00:00,4,2,2,FMN 15 Luitenant Lippenslaan
662,Luitenant Lippenslaan 200,2023-03-21,02:00:00,5,5,0,FMN 15 Luitenant Lippenslaan
662,Luitenant Lippenslaan 200,2023-03-21,03:00:00,2,1,1,FMN 15 Luitenant Lippenslaan
662,Luitenant Lippenslaan 200,2023-03-21,04:00:00,8,0,8,FMN 15 Luitenant Lippenslaan
662,Luitenant Lippenslaan 200,2023-03-21,05:00:00,15,0,15,FMN 15 Luitenant Lippenslaan
662,Luitenant Lippenslaan 200,2023-03-21,06:00:00,69,9,60,FMN 15 Luitenant Lippenslaan
662,Luitenant Lippenslaan 200,2023-03-21,07:00:00,207,6,201,FMN 15 Luitenant Lippenslaan
662,Luitenant Lippenslaan 200,2023-03-21,08:00:00,422,5,417,FMN 15 Luitenant Lippenslaan
662,Luitenant Lippenslaan 200,2023-03-21,09:00:00,159,7,152,FMN 15 Luitenant Lippenslaan
662,Luitenant Lippenslaan 200,2023-03-21,10:00:00,83,5,78,FMN 15 Luitenant Lippenslaan
662,Luitenant Lippenslaan 200,2023-03-21,11:00:00,87,10,77,FMN 15 Luitenant Lippenslaan
662,Luitenant Lippenslaan 200,2023-03-21,12:00:00,99,13,86,FMN 15 Luitenant Lippenslaan
662,Luitenant Lippenslaan 200,2023-03-21,13:00:00,83,9,74,FMN 15 Luitenant Lippenslaan
662,Luitenant Lippenslaan 200,2023-03-21,14:00:00,70,9,61,FMN 15 Luitenant Lippenslaan
662,Luitenant Lippenslaan 200,2023-03-21,15:00:00,105,16,89,FMN 15 Luitenant Lippenslaan
662,Luitenant Lippenslaan 200,2023-03-21,16:00:00,131,15,116,FMN 15 Luitenant Lippenslaan
662,Luitenant Lippenslaan 200,2023-03-21,17:00:00,119,17,102,FMN 15 Luitenant Lippenslaan
662,Luitenant Lippenslaan 200,2023-03-21,18:00:00,141,21,120,FMN 15 Luitenant Lippenslaan
662,Luitenant Lippenslaan 200,2023-03-21,19:00:00,92,10,82,FMN 15 Luitenant Lippenslaan
662,Luitenant Lippenslaan 200,2023-03-21,20:00:00,64,12,52,FMN 15 Luitenant Lippenslaan
662,Luitenant Lippenslaan 200,2023-03-21,21:00:00,38,6,32,FMN 15 Luitenant Lippenslaan
662,Luitenant Lippenslaan 200,2023-03-21,22:00:00,33,8,25,FMN 15 Luitenant Lippenslaan
662,Luitenant Lippenslaan 200,2023-03-21,23:00:00,14,2,12,FMN 15 Luitenant Lippenslaan
662,Luitenant Lippenslaan 200,2023-03-22,00:00:00,12,4,8,FMN 15 Luitenant Lippenslaan
662,Luitenant Lippenslaan 200,2023-03-22,01:00:00,1,0,1,FMN 15 Luitenant Lippenslaan
662,Luitenant Lippenslaan 200,2023-03-22,02:00:00,7,4,3,FMN 15 Luitenant Lippenslaan
662,Luitenant Lippenslaan 200,2023-03-22,03:00:00,6,2,4,FMN 15 Luitenant Lippenslaan
662,Luitenant Lippenslaan 200,2023-03-22,04:00:00,7,1,6,FMN 15 Luitenant Lippenslaan
662,Luitenant Lippenslaan 200,2023-03-22,05:00:00,24,3,21,FMN 15 Luitenant Lippenslaan
662,Luitenant Lippenslaan 200,2023-03-22,06:00:00,58,6,52,FMN 15 Luitenant Lippenslaan
662,Luitenant Lippenslaan 200,2023-03-22,07:00:00,197,6,191,FMN 15 Luitenant Lippenslaan
662,Luitenant Lippenslaan 200,2023-03-22,08:00:00,381,8,373,FMN 15 Luitenant Lippenslaan
662,Luitenant Lippenslaan 200,2023-03-22,09:00:00,128,8,120,FMN 15 Luitenant Lippenslaan
662,Luitenant Lippenslaan 200,2023-03-22,10:00:00,65,8,57,FMN 15 Luitenant Lippenslaan
662,Luitenant Lippenslaan 200,2023-03-22,11:00:00,55,4,51,FMN 15 Luitenant Lippenslaan
662,Luitenant Lippenslaan 200,2023-03-22,12:00:00,114,17,97,FMN 15 Luitenant Lippenslaan
662,Luitenant Lippenslaan 200,2023-03-22,13:00:00,101,7,94,FMN 15 Luitenant Lippenslaan
662,Luitenant Lippenslaan 200,2023-03-22,14:00:00,71,10,61,FMN 15 Luitenant Lippenslaan
662,Luitenant Lippenslaan 200,2023-03-22,15:00:00,106,11,95,FMN 15 Luitenant Lippenslaan
662,Luitenant Lippenslaan 200,2023-03-22,16:00:00,96,9,87,FMN 15 Luitenant Lippenslaan
662,Luitenant Lippenslaan 200,2023-03-22,17:00:00,119,16,103,FMN 15 Luitenant Lippenslaan
662,Luitenant Lippenslaan 200,2023-03-22,18:00:00,103,7,96,FMN 15 Luitenant Lippenslaan
662,Luitenant Lippenslaan 200,2023-03-22,19:00:00,78,14,64,FMN 15 Luitenant Lippenslaan
662,Luitenant Lippenslaan 200,2023-03-22,20:00:00,52,5,47,FMN 15 Luitenant Lippenslaan
662,Luitenant Lippenslaan 200,2023-03-22,21:00:00,34,8,26,FMN 15 Luitenant Lippenslaan
662,Luitenant Lippenslaan 200,2023-03-22,22:00:00,36,13,23,FMN 15 Luitenant Lippenslaan
662,Luitenant Lippenslaan 200,2023-03-22,23:00:00,11,2,9,FMN 15 Luitenant Lippenslaan
662,Luitenant Lippenslaan 200,2023-03-23,00:00:00,8,1,7,FMN 15 Luitenant Lippenslaan
662,Luitenant Lippenslaan 200,2023-03-23,01:00:00,1,0,1,FMN 15 Luitenant Lippenslaan
662,Luitenant Lippenslaan 200,2023-03-23,02:00:00,5,4,1,FMN 15 Luitenant Lippenslaan
662,Luitenant Lippenslaan 200,2023-03-23,03:00:00,4,2,2,FMN 15 Luitenant Lippenslaan
662,Luitenant Lippenslaan 200,2023-03-23,04:00:00,7,0,7,FMN 15 Luitenant Lippenslaan
662,Luitenant Lippenslaan 200,2023-03-23,05:00:00,16,0,16,FMN 15 Luitenant Lippenslaan
662,Luitenant Lippenslaan 200,2023-03-23,06:00:00,64,6,58,FMN 15 Luitenant Lippenslaan
662,Luitenant Lippenslaan 200,2023-03-23,07:00:00,149,7,142,FMN 15 Luitenant Lippenslaan
662,Luitenant Lippenslaan 200,2023-03-23,08:00:00,374,10,364,FMN 15 Luitenant Lippenslaan
662,Luitenant Lippenslaan 200,2023-03-23,09:00:00,143,5,138,FMN 15 Luitenant Lippenslaan
662,Luitenant Lippenslaan 200,2023-03-23,10:00:00,83,5,78,FMN 15 Luitenant Lippenslaan
662,Luitenant Lippenslaan 200,2023-03-23,11:00:00,65,7,58,FMN 15 Luitenant Lippenslaan
662,Luitenant Lippenslaan 200,2023-03-23,12:00:00,99,5,94,FMN 15 Luitenant Lippenslaan
662,Luitenant Lippenslaan 200,2023-03-23,13:00:00,81,3,78,FMN 15 Luitenant Lippenslaan
662,Luitenant Lippenslaan 200,2023-03-23,14:00:00,60,8,52,FMN 15 Luitenant Lippenslaan
662,Luitenant Lippenslaan 200,2023-03-23,15:00:00,82,14,68,FMN 15 Luitenant Lippenslaan
662,Luitenant Lippenslaan 200,2023-03-23,16:00:00,132,19,113,FMN 15 Luitenant Lippenslaan
662,Luitenant Lippenslaan 200,2023-03-23,17:00:00,169,16,153,FMN 15 Luitenant Lippenslaan
662,Luitenant Lippenslaan 200,2023-03-23,18:00:00,152,22,130,FMN 15 Luitenant Lippenslaan
662,Luitenant Lippenslaan 200,2023-03-23,19:00:00,101,10,91,FMN 15 Luitenant Lippenslaan
662,Luitenant Lippenslaan 200,2023-03-23,20:00:00,78,4,74,FMN 15 Luitenant Lippenslaan
662,Luitenant Lippenslaan 200,2023-03-23,21:00:00,35,8,27,FMN 15 Luitenant Lippenslaan
662,Luitenant Lippenslaan 200,2023-03-23,22:00:00,51,16,35,FMN 15 Luitenant Lippenslaan
662,Luitenant Lippenslaan 200,2023-03-23,23:00:00,14,3,11,FMN 15 Luitenant Lippenslaan
662,Luitenant Lippenslaan 200,2023-03-24,00:00:00,13,4,9,FMN 15 Luitenant Lippenslaan
662,Luitenant Lippenslaan 200,2023-03-24,01:00:00,5,2,3,FMN 15 Luitenant Lippenslaan
662,Luitenant Lippenslaan 200,2023-03-24,02:00:00,8,4,4,FMN 15 Luitenant Lippenslaan
662,Luitenant Lippenslaan 200,2023-03-24,03:00:00,1,1,0,FMN 15 Luitenant Lippenslaan
662,Luitenant Lippenslaan 200,2023-03-24,04:00:00,6,2,4,FMN 15 Luitenant Lippenslaan
662,Luitenant Lippenslaan 200,2023-03-24,05:00:00,14,1,13,FMN 15 Luitenant Lippenslaan
662,Luitenant Lippenslaan 200,2023-03-24,06:00:00,59,6,53,FMN 15 Luitenant Lippenslaan
662,Luitenant Lippenslaan 200,2023-03-24,07:00:00,180,6,174,FMN 15 Luitenant Lippenslaan
662,Luitenant Lippenslaan 200,2023-03-24,08:00:00,357,9,348,FMN 15 Luitenant Lippenslaan
662,Luitenant Lippenslaan 200,2023-03-24,09:00:00,163,7,156,FMN 15 Luitenant Lippenslaan
662,Luitenant Lippenslaan 200,2023-03-24,10:00:00,109,7,102,FMN 15 Luitenant Lippenslaan
662,Luitenant Lippenslaan 200,2023-03-24,11:00:00,75,8,67,FMN 15 Luitenant Lippenslaan
662,Luitenant Lippenslaan 200,2023-03-24,12:00:00,99,15,84,FMN 15 Luitenant Lippenslaan
662,Luitenant Lippenslaan 200,2023-03-24,13:00:00,84,12,72,FMN 15 Luitenant Lippenslaan
662,Luitenant Lippenslaan 200,2023-03-24,14:00:00,78,12,66,FMN 15 Luitenant Lippenslaan
662,Luitenant Lippenslaan 200,2023-03-24,15:00:00,78,11,67,FMN 15 Luitenant Lippenslaan
662,Luitenant Lippenslaan 200,2023-03-24,16:00:00,120,21,99,FMN 15 Luitenant Lippenslaan
662,Luitenant Lippenslaan 200,2023-03-24,17:00:00,129,13,116,FMN 15 Luitenant Lippenslaan
662,Luitenant Lippenslaan 200,2023-03-24,18:00:00,130,16,114,FMN 15 Luitenant Lippenslaan
662,Luitenant Lippenslaan 200,2023-03-24,19:00:00,100,14,86,FMN 15 Luitenant Lippenslaan
662,Luitenant Lippenslaan 200,2023-03-24,20:00:00,89,8,81,FMN 15 Luitenant Lippenslaan
662,Luitenant Lippenslaan 200,2023-03-24,21:00:00,56,14,42,FMN 15 Luitenant Lippenslaan
662,Luitenant Lippenslaan 200,2023-03-24,22:00:00,33,8,25,FMN 15 Luitenant Lippenslaan
662,Luitenant Lippenslaan 200,2023-03-24,23:00:00,31,8,23,FMN 15 Luitenant Lippenslaan
662,Luitenant Lippenslaan 200,2023-03-25,00:00:00,28,9,19,FMN 15 Luitenant Lippenslaan
662,Luitenant Lippenslaan 200,2023-03-25,01:00:00,15,1,14,FMN 15 Luitenant Lippenslaan
662,Luitenant Lippenslaan 200,2023-03-25,02:00:00,6,3,3,FMN 15 Luitenant Lippenslaan
662,Luitenant Lippenslaan 200,2023-03-25,03:00:00,5,2,3,FMN 15 Luitenant Lippenslaan
662,Luitenant Lippenslaan 200,2023-03-25,04:00:00,5,2,3,FMN 15 Luitenant Lippenslaan
662,Luitenant Lippenslaan 200,2023-03-25,05:00:00,10,1,9,FMN 15 Luitenant Lippenslaan
662,Luitenant Lippenslaan 200,2023-03-25,06:00:00,22,7,15,FMN 15 Luitenant Lippenslaan
662,Luitenant Lippenslaan 200,2023-03-25,07:00:00,25,0,25,FMN 15 Luitenant Lippenslaan
662,Luitenant Lippenslaan 200,2023-03-25,08:00:00,53,2,51,FMN 15 Luitenant Lippenslaan
662,Luitenant Lippenslaan 200,2023-03-25,09:00:00,88,8,80,FMN 15 Luitenant Lippenslaan
662,Luitenant Lippenslaan 200,2023-03-25,10:00:00,73,3,70,FMN 15 Luitenant Lippenslaan
662,Luitenant Lippenslaan 200,2023-03-25,11:00:00,97,7,90,FMN 15 Luitenant Lippenslaan
662,Luitenant Lippenslaan 200,2023-03-25,12:00:00,78,4,74,FMN 15 Luitenant Lippenslaan
662,Luitenant Lippenslaan 200,2023-03-25,13:00:00,75,11,64,FMN 15 Luitenant Lippenslaan
662,Luitenant Lippenslaan 200,2023-03-25,14:00:00,69,10,59,FMN 15 Luitenant Lippenslaan
662,Luitenant Lippenslaan 200,2023-03-25,15:00:00,91,8,83,FMN 15 Luitenant Lippenslaan
662,Luitenant Lippenslaan 200,2023-03-25,16:00:00,69,13,56,FMN 15 Luitenant Lippenslaan
662,Luitenant Lippenslaan 200,2023-03-25,17:00:00,79,16,63,FMN 15 Luitenant Lippenslaan
662,Luitenant Lippenslaan 200,2023-03-25,18:00:00,81,11,70,FMN 15 Luitenant Lippenslaan
662,Luitenant Lippenslaan 200,2023-03-25,19:00:00,69,10,59,FMN 15 Luitenant Lippenslaan
662,Luitenant Lippenslaan 200,2023-03-25,20:00:00,77,6,71,FMN 15 Luitenant Lippenslaan
662,Luitenant Lippenslaan 200,2023-03-25,21:00:00,32,5,27,FMN 15 Luitenant Lippenslaan
662,Luitenant Lippenslaan 200,2023-03-25,22:00:00,36,11,25,FMN 15 Luitenant Lippenslaan
662,Luitenant Lippenslaan 200,2023-03-25,23:00:00,18,6,12,FMN 15 Luitenant Lippenslaan
662,Luitenant Lippenslaan 200,2023-03-26,00:00:00,26,4,22,FMN 15 Luitenant Lippenslaan
662,Luitenant Lippenslaan 200,2023-03-26,01:00:00,28,2,26,FMN 15 Luitenant Lippenslaan
662,Luitenant Lippenslaan 200,2023-03-26,02:00:00,0,0,0,FMN 15 Luitenant Lippenslaan
662,Luitenant Lippenslaan 200,2023-03-26,03:00:00,5,4,1,FMN 15 Luitenant Lippenslaan
662,Luitenant Lippenslaan 200,2023-03-26,04:00:00,7,2,5,FMN 15 Luitenant Lippenslaan
662,Luitenant Lippenslaan 200,2023-03-26,05:00:00,6,2,4,FMN 15 Luitenant Lippenslaan
662,Luitenant Lippenslaan 200,2023-03-26,06:00:00,10,1,9,FMN 15 Luitenant Lippenslaan
662,Luitenant Lippenslaan 200,2023-03-26,07:00:00,15,5,10,FMN 15 Luitenant Lippenslaan
662,Luitenant Lippenslaan 200,2023-03-26,08:00:00,19,2,17,FMN 15 Luitenant Lippenslaan
662,Luitenant Lippenslaan 200,2023-03-26,09:00:00,35,1,34,FMN 15 Luitenant Lippenslaan
662,Luitenant Lippenslaan 200,2023-03-26,10:00:00,29,5,24,FMN 15 Luitenant Lippenslaan
662,Luitenant Lippenslaan 200,2023-03-26,11:00:00,39,6,33,FMN 15 Luitenant Lippenslaan
662,Luitenant Lippenslaan 200,2023-03-26,12:00:00,61,7,54,FMN 15 Luitenant Lippenslaan
662,Luitenant Lippenslaan 200,2023-03-26,13:00:00,48,1,47,FMN 15 Luitenant Lippenslaan
662,Luitenant Lippenslaan 200,2023-03-26,14:00:00,57,9,48,FMN 15 Luitenant Lippenslaan
662,Luitenant Lippenslaan 200,2023-03-26,15:00:00,45,10,35,FMN 15 Luitenant Lippenslaan
662,Luitenant Lippenslaan 200,2023-03-26,16:00:00,62,6,56,FMN 15 Luitenant Lippenslaan
662,Luitenant Lippenslaan 200,2023-03-26,17:00:00,67,7,60,FMN 15 Luitenant Lippenslaan
662,Luitenant Lippenslaan 200,2023-03-26,18:00:00,66,9,57,FMN 15 Luitenant Lippenslaan
662,Luitenant Lippenslaan 200,2023-03-26,19:00:00,55,9,46,FMN 15 Luitenant Lippenslaan
662,Luitenant Lippenslaan 200,2023-03-26,20:00:00,36,7,29,FMN 15 Luitenant Lippenslaan
662,Luitenant Lippenslaan 200,2023-03-26,21:00:00,43,9,34,FMN 15 Luitenant Lippenslaan
662,Luitenant Lippenslaan 200,2023-03-26,22:00:00,30,8,22,FMN 15 Luitenant Lippenslaan
662,Luitenant Lippenslaan 200,2023-03-26,23:00:00,14,4,10,FMN 15 Luitenant Lippenslaan
662,Luitenant Lippenslaan 200,2023-03-27,00:00:00,6,2,4,FMN 15 Luitenant Lippenslaan
662,Luitenant Lippenslaan 200,2023-03-27,01:00:00,6,3,3,FMN 15 Luitenant Lippenslaan
662,Luitenant Lippenslaan 200,2023-03-27,02:00:00,5,3,2,FMN 15 Luitenant Lippenslaan
662,Luitenant Lippenslaan 200,2023-03-27,03:00:00,2,1,1,FMN 15 Luitenant Lippenslaan
662,Luitenant Lippenslaan 200,2023-03-27,04:00:00,11,1,10,FMN 15 Luitenant Lippenslaan
662,Luitenant Lippenslaan 200,2023-03-27,05:00:00,11,1,10,FMN 15 Luitenant Lippenslaan
662,Luitenant Lippenslaan 200,2023-03-27,06:00:00,65,6,59,FMN 15 Luitenant Lippenslaan
662,Luitenant Lippenslaan 200,2023-03-27,07:00:00,173,6,167,FMN 15 Luitenant Lippenslaan
662,Luitenant Lippenslaan 200,2023-03-27,08:00:00,398,13,385,FMN 15 Luitenant Lippenslaan
662,Luitenant Lippenslaan 200,2023-03-27,09:00:00,164,5,159,FMN 15 Luitenant Lippenslaan
662,Luitenant Lippenslaan 200,2023-03-27,10:00:00,71,2,69,FMN 15 Luitenant Lippenslaan
662,Luitenant Lippenslaan 200,2023-03-27,11:00:00,65,6,59,FMN 15 Luitenant Lippenslaan
662,Luitenant Lippenslaan 200,2023-03-27,12:00:00,101,7,94,FMN 15 Luitenant Lippenslaan
662,Luitenant Lippenslaan 200,2023-03-27,13:00:00,84,5,79,FMN 15 Luitenant Lippenslaan
662,Luitenant Lippenslaan 200,2023-03-27,14:00:00,72,11,61,FMN 15 Luitenant Lippenslaan
662,Luitenant Lippenslaan 200,2023-03-27,15:00:00,77,13,64,FMN 15 Luitenant Lippenslaan
662,Luitenant Lippenslaan 200,2023-03-27,16:00:00,120,13,107,FMN 15 Luitenant Lippenslaan
662,Luitenant Lippenslaan 200,2023-03-27,17:00:00,138,19,119,FMN 15 Luitenant Lippenslaan
662,Luitenant Lippenslaan 200,2023-03-27,18:00:00,124,10,114,FMN 15 Luitenant Lippenslaan
662,Luitenant Lippenslaan 200,2023-03-27,19:00:00,95,18,77,FMN 15 Luitenant Lippenslaan
662,Luitenant Lippenslaan 200,2023-03-27,20:00:00,61,7,54,FMN 15 Luitenant Lippenslaan
662,Luitenant Lippenslaan 200,2023-03-27,21:00:00,50,12,38,FMN 15 Luitenant Lippenslaan
662,Luitenant Lippenslaan 200,2023-03-27,22:00:00,37,8,29,FMN 15 Luitenant Lippenslaan
662,Luitenant Lippenslaan 200,2023-03-27,23:00:00,28,11,17,FMN 15 Luitenant Lippenslaan
662,Luitenant Lippenslaan 200,2023-03-28,00:00:00,12,5,7,FMN 15 Luitenant Lippenslaan
662,Luitenant Lippenslaan 200,2023-03-28,01:00:00,3,2,1,FMN 15 Luitenant Lippenslaan
662,Luitenant Lippenslaan 200,2023-03-28,02:00:00,6,5,1,FMN 15 Luitenant Lippenslaan
662,Luitenant Lippenslaan 200,2023-03-28,03:00:00,2,1,1,FMN 15 Luitenant Lippenslaan
662,Luitenant Lippenslaan 200,2023-03-28,04:00:00,9,1,8,FMN 15 Luitenant Lippenslaan
662,Luitenant Lippenslaan 200,2023-03-28,05:00:00,12,0,12,FMN 15 Luitenant Lippenslaan
662,Luitenant Lippenslaan 200,2023-03-28,06:00:00,66,7,59,FMN 15 Luitenant Lippenslaan
662,Luitenant Lippenslaan 200,2023-03-28,07:00:00,194,11,183,FMN 15 Luitenant Lippenslaan
662,Luitenant Lippenslaan 200,2023-03-28,08:00:00,470,12,458,FMN 15 Luitenant Lippenslaan
662,Luitenant Lippenslaan 200,2023-03-28,09:00:00,167,7,160,FMN 15 Luitenant Lippenslaan
662,Luitenant Lippenslaan 200,2023-03-28,10:00:00,84,3,81,FMN 15 Luitenant Lippenslaan
662,Luitenant Lippenslaan 200,2023-03-28,11:00:00,91,14,77,FMN 15 Luitenant Lippenslaan
662,Luitenant Lippenslaan 200,2023-03-28,12:00:00,111,12,99,FMN 15 Luitenant Lippenslaan
662,Luitenant Lippenslaan 200,2023-03-28,13:00:00,81,7,74,FMN 15 Luitenant Lippenslaan
662,Luitenant Lippenslaan 200,2023-03-28,14:00:00,77,11,66,FMN 15 Luitenant Lippenslaan
662,Luitenant Lippenslaan 200,2023-03-28,15:00:00,109,13,96,FMN 15 Luitenant Lippenslaan
662,Luitenant Lippenslaan 200,2023-03-28,16:00:00,118,16,102,FMN 15 Luitenant Lippenslaan
662,Luitenant Lippenslaan 200,2023-03-28,17:00:00,162,18,144,FMN 15 Luitenant Lippenslaan
662,Luitenant Lippenslaan 200,2023-03-28,18:00:00,130,11,119,FMN 15 Luitenant Lippenslaan
662,Luitenant Lippenslaan 200,2023-03-28,19:00:00,74,7,67,FMN 15 Luitenant Lippenslaan
662,Luitenant Lippenslaan 200,2023-03-28,20:00:00,52,7,45,FMN 15 Luitenant Lippenslaan
662,Luitenant Lippenslaan 200,2023-03-28,21:00:00,48,9,39,FMN 15 Luitenant Lippenslaan
662,Luitenant Lippenslaan 200,2023-03-28,22:00:00,33,7,26,FMN 15 Luitenant Lippenslaan
662,Luitenant Lippenslaan 200,2023-03-28,23:00:00,21,9,12,FMN 15 Luitenant Lippenslaan
662,Luitenant Lippenslaan 200,2023-03-29,00:00:00,10,2,8,FMN 15 Luitenant Lippenslaan
662,Luitenant Lippenslaan 200,2023-03-29,01:00:00,5,1,4,FMN 15 Luitenant Lippenslaan
662,Luitenant Lippenslaan 200,2023-03-29,02:00:00,3,2,1,FMN 15 Luitenant Lippenslaan
662,Luitenant Lippenslaan 200,2023-03-29,03:00:00,2,1,1,FMN 15 Luitenant Lippenslaan
662,Luitenant Lippenslaan 200,2023-03-29,04:00:00,13,1,12,FMN 15 Luitenant Lippenslaan
662,Luitenant Lippenslaan 200,2023-03-29,05:00:00,16,0,16,FMN 15 Luitenant Lippenslaan
662,Luitenant Lippenslaan 200,2023-03-29,06:00:00,73,11,62,FMN 15 Luitenant Lippenslaan
662,Luitenant Lippenslaan 200,2023-03-29,07:00:00,175,2,173,FMN 15 Luitenant Lippenslaan
662,Luitenant Lippenslaan 200,2023-03-29,08:00:00,365,15,350,FMN 15 Luitenant Lippenslaan
662,Luitenant Lippenslaan 200,2023-03-29,09:00:00,146,4,142,FMN 15 Luitenant Lippenslaan
662,Luitenant Lippenslaan 200,2023-03-29,10:00:00,85,4,81,FMN 15 Luitenant Lippenslaan
662,Luitenant Lippenslaan 200,2023-03-29,11:00:00,91,5,86,FMN 15 Luitenant Lippenslaan
662,Luitenant Lippenslaan 200,2023-03-29,12:00:00,112,12,100,FMN 15 Luitenant Lippenslaan
662,Luitenant Lippenslaan 200,2023-03-29,13:00:00,106,7,99,FMN 15 Luitenant Lippenslaan
662,Luitenant Lippenslaan 200,2023-03-29,14:00:00,92,12,80,FMN 15 Luitenant Lippenslaan
662,Luitenant Lippenslaan 200,2023-03-29,15:00:00,112,8,104,FMN 15 Luitenant Lippenslaan
662,Luitenant Lippenslaan 200,2023-03-29,16:00:00,114,18,96,FMN 15 Luitenant Lippenslaan
662,Luitenant Lippenslaan 200,2023-03-29,17:00:00,175,19,156,FMN 15 Luitenant Lippenslaan
662,Luitenant Lippenslaan 200,2023-03-29,18:00:00,143,12,131,FMN 15 Luitenant Lippenslaan
662,Luitenant Lippenslaan 200,2023-03-29,19:00:00,125,19,106,FMN 15 Luitenant Lippenslaan
662,Luitenant Lippenslaan 200,2023-03-29,20:00:00,77,12,65,FMN 15 Luitenant Lippenslaan
662,Luitenant Lippenslaan 200,2023-03-29,21:00:00,65,5,60,FMN 15 Luitenant Lippenslaan
662,Luitenant Lippenslaan 200,2023-03-29,22:00:00,49,13,36,FMN 15 Luitenant Lippenslaan
662,Luitenant Lippenslaan 200,2023-03-29,23:00:00,27,13,14,FMN 15 Luitenant Lippenslaan
662,Luitenant Lippenslaan 200,2023-03-30,00:00:00,10,2,8,FMN 15 Luitenant Lippenslaan
662,Luitenant Lippenslaan 200,2023-03-30,01:00:00,8,3,5,FMN 15 Luitenant Lippenslaan
662,Luitenant Lippenslaan 200,2023-03-30,02:00:00,4,3,1,FMN 15 Luitenant Lippenslaan
662,Luitenant Lippenslaan 200,2023-03-30,03:00:00,3,3,0,FMN 15 Luitenant Lippenslaan
662,Luitenant Lippenslaan 200,2023-03-30,04:00:00,10,1,9,FMN 15 Luitenant Lippenslaan
662,Luitenant Lippenslaan 200,2023-03-30,05:00:00,16,2,14,FMN 15 Luitenant Lippenslaan
662,Luitenant Lippenslaan 200,2023-03-30,06:00:00,72,8,64,FMN 15 Luitenant Lippenslaan
662,Luitenant Lippenslaan 200,2023-03-30,07:00:00,167,11,156,FMN 15 Luitenant Lippenslaan
662,Luitenant Lippenslaan 200,2023-03-30,08:00:00,407,8,399,FMN 15 Luitenant Lippenslaan
662,Luitenant Lippenslaan 200,2023-03-30,09:00:00,171,5,166,FMN 15 Luitenant Lippenslaan
662,Luitenant Lippenslaan 200,2023-03-30,10:00:00,86,7,79,FMN 15 Luitenant Lippenslaan
662,Luitenant Lippenslaan 200,2023-03-30,11:00:00,75,5,70,FMN 15 Luitenant Lippenslaan
662,Luitenant Lippenslaan 200,2023-03-30,12:00:00,79,8,71,FMN 15 Luitenant Lippenslaan
662,Luitenant Lippenslaan 200,2023-03-30,13:00:00,74,4,70,FMN 15 Luitenant Lippenslaan
662,Luitenant Lippenslaan 200,2023-03-30,14:00:00,66,7,59,FMN 15 Luitenant Lippenslaan
662,Luitenant Lippenslaan 200,2023-03-30,15:00:00,105,23,82,FMN 15 Luitenant Lippenslaan
662,Luitenant Lippenslaan 200,2023-03-30,16:00:00,110,11,99,FMN 15 Luitenant Lippenslaan
662,Luitenant Lippenslaan 200,2023-03-30,17:00:00,145,11,134,FMN 15 Luitenant Lippenslaan
662,Luitenant Lippenslaan 200,2023-03-30,18:00:00,156,19,137,FMN 15 Luitenant Lippenslaan
662,Luitenant Lippenslaan 200,2023-03-30,19:00:00,125,21,104,FMN 15 Luitenant Lippenslaan
662,Luitenant Lippenslaan 200,2023-03-30,20:00:00,80,13,67,FMN 15 Luitenant Lippenslaan
662,Luitenant Lippenslaan 200,2023-03-30,21:00:00,51,7,44,FMN 15 Luitenant Lippenslaan
662,Luitenant Lippenslaan 200,2023-03-30,22:00:00,50,10,40,FMN 15 Luitenant Lippenslaan
662,Luitenant Lippenslaan 200,2023-03-30,23:00:00,23,9,14,FMN 15 Luitenant Lippenslaan
662,Luitenant Lippenslaan 200,2023-03-31,00:00:00,10,2,8,FMN 15 Luitenant Lippenslaan
662,Luitenant Lippenslaan 200,2023-03-31,01:00:00,5,3,2,FMN 15 Luitenant Lippenslaan
662,Luitenant Lippenslaan 200,2023-03-31,02:00:00,8,5,3,FMN 15 Luitenant Lippenslaan
662,Luitenant Lippenslaan 200,2023-03-31,03:00:00,3,2,1,FMN 15 Luitenant Lippenslaan
662,Luitenant Lippenslaan 200,2023-03-31,04:00:00,13,3,10,FMN 15 Luitenant Lippenslaan
662,Luitenant Lippenslaan 200,2023-03-31,05:00:00,11,2,9,FMN 15 Luitenant Lippenslaan
662,Luitenant Lippenslaan 200,2023-03-31,06:00:00,33,3,30,FMN 15 Luitenant Lippenslaan
662,Luitenant Lippenslaan 200,2023-03-31,07:00:00,96,2,94,FMN 15 Luitenant Lippenslaan
662,Luitenant Lippenslaan 200,2023-03-31,08:00:00,265,3,262,FMN 15 Luitenant Lippenslaan
662,Luitenant Lippenslaan 200,2023-03-31,09:00:00,122,7,115,FMN 15 Luitenant Lippenslaan
662,Luitenant Lippenslaan 200,2023-03-31,10:00:00,63,3,60,FMN 15 Luitenant Lippenslaan
662,Luitenant Lippenslaan 200,2023-03-31,11:00:00,52,5,47,FMN 15 Luitenant Lippenslaan
662,Luitenant Lippenslaan 200,2023-03-31,12:00:00,62,5,57,FMN 15 Luitenant Lippenslaan
662,Luitenant Lippenslaan 200,2023-03-31,13:00:00,66,8,58,FMN 15 Luitenant Lippenslaan
662,Luitenant Lippenslaan 200,2023-03-31,14:00:00,53,6,47,FMN 15 Luitenant Lippenslaan
662,Luitenant Lippenslaan 200,2023-03-31,15:00:00,74,14,60,FMN 15 Luitenant Lippenslaan
662,Luitenant Lippenslaan 200,2023-03-31,16:00:00,73,5,68,FMN 15 Luitenant Lippenslaan
662,Luitenant Lippenslaan 200,2023-03-31,17:00:00,112,15,97,FMN 15 Luitenant Lippenslaan
662,Luitenant Lippenslaan 200,2023-03-31,18:00:00,110,17,93,FMN 15 Luitenant Lippenslaan
662,Luitenant Lippenslaan 200,2023-03-31,19:00:00,96,9,87,FMN 15 Luitenant Lippenslaan
662,Luitenant Lippenslaan 200,2023-03-31,20:00:00,67,11,56,FMN 15 Luitenant Lippenslaan
662,Luitenant Lippenslaan 200,2023-03-31,21:00:00,46,3,43,FMN 15 Luitenant Lippenslaan
662,Luitenant Lippenslaan 200,2023-03-31,22:00:00,34,5,29,FMN 15 Luitenant Lippenslaan
662,Luitenant Lippenslaan 200,2023-03-31,23:00:00,20,5,15,FMN 15 Luitenant Lippenslaan
662,Luitenant Lippenslaan 200,2023-04-01,00:00:00,14,6,8,FMN 15 Luitenant Lippenslaan
662,Luitenant Lippenslaan 200,2023-04-01,01:00:00,17,13,4,FMN 15 Luitenant Lippenslaan
662,Luitenant Lippenslaan 200,2023-04-01,02:00:00,15,5,10,FMN 15 Luitenant Lippenslaan
662,Luitenant Lippenslaan 200,2023-04-01,03:00:00,4,3,1,FMN 15 Luitenant Lippenslaan
662,Luitenant Lippenslaan 200,2023-04-01,04:00:00,4,1,3,FMN 15 Luitenant Lippenslaan
662,Luitenant Lippenslaan 200,2023-04-01,05:00:00,7,1,6,FMN 15 Luitenant Lippenslaan
662,Luitenant Lippenslaan 200,2023-04-01,06:00:00,19,4,15,FMN 15 Luitenant Lippenslaan
662,Luitenant Lippenslaan 200,2023-04-01,07:00:00,17,0,17,FMN 15 Luitenant Lippenslaan
662,Luitenant Lippenslaan 200,2023-04-01,08:00:00,44,3,41,FMN 15 Luitenant Lippenslaan
662,Luitenant Lippenslaan 200,2023-04-01,09:00:00,50,3,47,FMN 15 Luitenant Lippenslaan
662,Luitenant Lippenslaan 200,2023-04-01,10:00:00,53,2,51,FMN 15 Luitenant Lippenslaan
662,Luitenant Lippenslaan 200,2023-04-01,11:00:00,54,6,48,FMN 15 Luitenant Lippenslaan
662,Luitenant Lippenslaan 200,2023-04-01,12:00:00,47,4,43,FMN 15 Luitenant Lippenslaan
662,Luitenant Lippenslaan 200,2023-04-01,13:00:00,55,1,54,FMN 15 Luitenant Lippenslaan
662,Luitenant Lippenslaan 200,2023-04-01,14:00:00,53,4,49,FMN 15 Luitenant Lippenslaan
662,Luitenant Lippenslaan 200,2023-04-01,15:00:00,50,7,43,FMN 15 Luitenant Lippenslaan
662,Luitenant Lippenslaan 200,2023-04-01,16:00:00,64,11,53,FMN 15 Luitenant Lippenslaan
662,Luitenant Lippenslaan 200,2023-04-01,17:00:00,56,11,45,FMN 15 Luitenant Lippenslaan
662,Luitenant Lippenslaan 200,2023-04-01,18:00:00,56,10,46,FMN 15 Luitenant Lippenslaan
662,Luitenant Lippenslaan 200,2023-04-01,19:00:00,52,12,40,FMN 15 Luitenant Lippenslaan
662,Luitenant Lippenslaan 200,2023-04-01,20:00:00,47,8,39,FMN 15 Luitenant Lippenslaan
662,Luitenant Lippenslaan 200,2023-04-01,21:00:00,34,4,30,FMN 15 Luitenant Lippenslaan
662,Luitenant Lippenslaan 200,2023-04-01,22:00:00,41,16,25,FMN 15 Luitenant Lippenslaan
662,Luitenant Lippenslaan 200,2023-04-01,23:00:00,20,4,16,FMN 15 Luitenant Lippenslaan
662,Luitenant Lippenslaan 200,2023-04-02,00:00:00,19,4,15,FMN 15 Luitenant Lippenslaan
662,Luitenant Lippenslaan 200,2023-04-02,01:00:00,11,3,8,FMN 15 Luitenant Lippenslaan
662,Luitenant Lippenslaan 200,2023-04-02,02:00:00,10,3,7,FMN 15 Luitenant Lippenslaan
662,Luitenant Lippenslaan 200,2023-04-02,03:00:00,7,2,5,FMN 15 Luitenant Lippenslaan
662,Luitenant Lippenslaan 200,2023-04-02,04:00:00,6,3,3,FMN 15 Luitenant Lippenslaan
662,Luitenant Lippenslaan 200,2023-04-02,05:00:00,9,1,8,FMN 15 Luitenant Lippenslaan
662,Luitenant Lippenslaan 200,2023-04-02,06:00:00,16,5,11,FMN 15 Luitenant Lippenslaan
662,Luitenant Lippenslaan 200,2023-04-02,07:00:00,12,2,10,FMN 15 Luitenant Lippenslaan
662,Luitenant Lippenslaan 200,2023-04-02,08:00:00,25,4,21,FMN 15 Luitenant Lippenslaan
662,Luitenant Lippenslaan 200,2023-04-02,09:00:00,55,2,53,FMN 15 Luitenant Lippenslaan
662,Luitenant Lippenslaan 200,2023-04-02,10:00:00,68,6,62,FMN 15 Luitenant Lippenslaan
662,Luitenant Lippenslaan 200,2023-04-02,11:00:00,70,1,69,FMN 15 Luitenant Lippenslaan
662,Luitenant Lippenslaan 200,2023-04-02,12:00:00,74,2,72,FMN 15 Luitenant Lippenslaan
662,Luitenant Lippenslaan 200,2023-04-02,13:00:00,78,3,75,FMN 15 Luitenant Lippenslaan
662,Luitenant Lippenslaan 200,2023-04-02,14:00:00,94,11,83,FMN 15 Luitenant Lippenslaan
662,Luitenant Lippenslaan 200,2023-04-02,15:00:00,76,11,65,FMN 15 Luitenant Lippenslaan
662,Luitenant Lippenslaan 200,2023-04-02,16:00:00,44,5,39,FMN 15 Luitenant Lippenslaan
662,Luitenant Lippenslaan 200,2023-04-02,17:00:00,69,7,62,FMN 15 Luitenant Lippenslaan
662,Luitenant Lippenslaan 200,2023-04-02,18:00:00,75,10,65,FMN 15 Luitenant Lippenslaan
662,Luitenant Lippenslaan 200,2023-04-02,19:00:00,85,9,76,FMN 15 Luitenant Lippenslaan
662,Luitenant Lippenslaan 200,2023-04-02,20:00:00,43,8,35,FMN 15 Luitenant Lippenslaan
662,Luitenant Lippenslaan 200,2023-04-02,21:00:00,41,3,38,FMN 15 Luitenant Lippenslaan
662,Luitenant Lippenslaan 200,2023-04-02,22:00:00,43,8,35,FMN 15 Luitenant Lippenslaan
662,Luitenant Lippenslaan 200,2023-04-02,23:00:00,15,3,12,FMN 15 Luitenant Lippenslaan
662,Luitenant Lippenslaan 200,2023-04-03,00:00:00,18,10,8,FMN 15 Luitenant Lippenslaan
662,Luitenant Lippenslaan 200,2023-04-03,01:00:00,9,3,6,FMN 15 Luitenant Lippenslaan
662,Luitenant Lippenslaan 200,2023-04-03,02:00:00,6,3,3,FMN 15 Luitenant Lippenslaan
662,Luitenant Lippenslaan 200,2023-04-03,03:00:00,4,2,2,FMN 15 Luitenant Lippenslaan
662,Luitenant Lippenslaan 200,2023-04-03,04:00:00,11,1,10,FMN 15 Luitenant Lippenslaan
662,Luitenant Lippenslaan 200,2023-04-03,05:00:00,20,0,20,FMN 15 Luitenant Lippenslaan
662,Luitenant Lippenslaan 200,2023-04-03,06:00:00,60,3,57,FMN 15 Luitenant Lippenslaan
662,Luitenant Lippenslaan 200,2023-04-03,07:00:00,122,4,118,FMN 15 Luitenant Lippenslaan
662,Luitenant Lippenslaan 200,2023-04-03,08:00:00,267,5,262,FMN 15 Luitenant Lippenslaan
662,Luitenant Lippenslaan 200,2023-04-03,09:00:00,134,5,129,FMN 15 Luitenant Lippenslaan
662,Luitenant Lippenslaan 200,2023-04-03,10:00:00,58,5,53,FMN 15 Luitenant Lippenslaan
662,Luitenant Lippenslaan 200,2023-04-03,11:00:00,72,6,66,FMN 15 Luitenant Lippenslaan
662,Luitenant Lippenslaan 200,2023-04-03,12:00:00,89,8,81,FMN 15 Luitenant Lippenslaan
662,Luitenant Lippenslaan 200,2023-04-03,13:00:00,81,5,76,FMN 15 Luitenant Lippenslaan
662,Luitenant Lippenslaan 200,2023-04-03,14:00:00,65,6,59,FMN 15 Luitenant Lippenslaan
662,Luitenant Lippenslaan 200,2023-04-03,15:00:00,81,10,71,FMN 15 Luitenant Lippenslaan
662,Luitenant Lippenslaan 200,2023-04-03,16:00:00,133,21,112,FMN 15 Luitenant Lippenslaan
662,Luitenant Lippenslaan 200,2023-04-03,17:00:00,128,9,119,FMN 15 Luitenant Lippenslaan
662,Luitenant Lippenslaan 200,2023-04-03,18:00:00,115,19,96,FMN 15 Luitenant Lippenslaan
662,Luitenant Lippenslaan 200,2023-04-03,19:00:00,75,15,60,FMN 15 Luitenant Lippenslaan
662,Luitenant Lippenslaan 200,2023-04-03,20:00:00,69,9,60,FMN 15 Luitenant Lippenslaan
662,Luitenant Lippenslaan 200,2023-04-03,21:00:00,47,4,43,FMN 15 Luitenant Lippenslaan
662,Luitenant Lippenslaan 200,2023-04-03,22:00:00,41,10,31,FMN 15 Luitenant Lippenslaan
662,Luitenant Lippenslaan 200,2023-04-03,23:00:00,19,7,12,FMN 15 Luitenant Lippenslaan
662,Luitenant Lippenslaan 200,2023-04-04,00:00:00,8,3,5,FMN 15 Luitenant Lippenslaan
662,Luitenant Lippenslaan 200,2023-04-04,01:00:00,1,0,1,FMN 15 Luitenant Lippenslaan
662,Luitenant Lippenslaan 200,2023-04-04,02:00:00,5,4,1,FMN 15 Luitenant Lippenslaan
662,Luitenant Lippenslaan 200,2023-04-04,03:00:00,6,2,4,FMN 15 Luitenant Lippenslaan
662,Luitenant Lippenslaan 200,2023-04-04,04:00:00,7,1,6,FMN 15 Luitenant Lippenslaan
662,Luitenant Lippenslaan 200,2023-04-04,05:00:00,17,0,17,FMN 15 Luitenant Lippenslaan
662,Luitenant Lippenslaan 200,2023-04-04,06:00:00,63,4,59,FMN 15 Luitenant Lippenslaan
662,Luitenant Lippenslaan 200,2023-04-04,07:00:00,159,8,151,FMN 15 Luitenant Lippenslaan
662,Luitenant Lippenslaan 200,2023-04-04,08:00:00,279,4,275,FMN 15 Luitenant Lippenslaan
662,Luitenant Lippenslaan 200,2023-04-04,09:00:00,142,6,136,FMN 15 Luitenant Lippenslaan
662,Luitenant Lippenslaan 200,2023-04-04,10:00:00,84,3,81,FMN 15 Luitenant Lippenslaan
662,Luitenant Lippenslaan 200,2023-04-04,11:00:00,85,6,79,FMN 15 Luitenant Lippenslaan
662,Luitenant Lippenslaan 200,2023-04-04,12:00:00,75,4,71,FMN 15 Luitenant Lippenslaan
662,Luitenant Lippenslaan 200,2023-04-04,13:00:00,79,8,71,FMN 15 Luitenant Lippenslaan
662,Luitenant Lippenslaan 200,2023-04-04,14:00:00,76,10,66,FMN 15 Luitenant Lippenslaan
662,Luitenant Lippenslaan 200,2023-04-04,15:00:00,86,8,78,FMN 15 Luitenant Lippenslaan
662,Luitenant Lippenslaan 200,2023-04-04,16:00:00,119,21,98,FMN 15 Luitenant Lippenslaan
662,Luitenant Lippenslaan 200,2023-04-04,17:00:00,136,17,119,FMN 15 Luitenant Lippenslaan
662,Luitenant Lippenslaan 200,2023-04-04,18:00:00,128,16,112,FMN 15 Luitenant Lippenslaan
662,Luitenant Lippenslaan 200,2023-04-04,19:00:00,75,6,69,FMN 15 Luitenant Lippenslaan
662,Luitenant Lippenslaan 200,2023-04-04,20:00:00,59,10,49,FMN 15 Luitenant Lippenslaan
662,Luitenant Lippenslaan 200,2023-04-04,21:00:00,45,2,43,FMN 15 Luitenant Lippenslaan
662,Luitenant Lippenslaan 200,2023-04-04,22:00:00,44,7,37,FMN 15 Luitenant Lippenslaan
662,Luitenant Lippenslaan 200,2023-04-04,23:00:00,26,8,18,FMN 15 Luitenant Lippenslaan
662,Luitenant Lippenslaan 200,2023-04-05,00:00:00,16,7,9,FMN 15 Luitenant Lippenslaan
662,Luitenant Lippenslaan 200,2023-04-05,01:00:00,10,2,8,FMN 15 Luitenant Lippenslaan
662,Luitenant Lippenslaan 200,2023-04-05,02:00:00,8,4,4,FMN 15 Luitenant Lippenslaan
662,Luitenant Lippenslaan 200,2023-04-05,03:00:00,8,3,5,FMN 15 Luitenant Lippenslaan
662,Luitenant Lippenslaan 200,2023-04-05,04:00:00,11,2,9,FMN 15 Luitenant Lippenslaan
662,Luitenant Lippenslaan 200,2023-04-05,05:00:00,16,1,15,FMN 15 Luitenant Lippenslaan
662,Luitenant Lippenslaan 200,2023-04-05,06:00:00,60,5,55,FMN 15 Luitenant Lippenslaan
662,Luitenant Lippenslaan 200,2023-04-05,07:00:00,129,8,121,FMN 15 Luitenant Lippenslaan
662,Luitenant Lippenslaan 200,2023-04-05,08:00:00,245,6,239,FMN 15 Luitenant Lippenslaan
662,Luitenant Lippenslaan 200,2023-04-05,09:00:00,136,4,132,FMN 15 Luitenant Lippenslaan
662,Luitenant Lippenslaan 200,2023-04-05,10:00:00,89,8,81,FMN 15 Luitenant Lippenslaan
662,Luitenant Lippenslaan 200,2023-04-05,11:00:00,74,7,67,FMN 15 Luitenant Lippenslaan
662,Luitenant Lippenslaan 200,2023-04-05,12:00:00,89,6,83,FMN 15 Luitenant Lippenslaan
662,Luitenant Lippenslaan 200,2023-04-05,13:00:00,103,8,95,FMN 15 Luitenant Lippenslaan
662,Luitenant Lippenslaan 200,2023-04-05,14:00:00,84,6,78,FMN 15 Luitenant Lippenslaan
662,Luitenant Lippenslaan 200,2023-04-05,15:00:00,84,8,76,FMN 15 Luitenant Lippenslaan
662,Luitenant Lippenslaan 200,2023-04-05,16:00:00,128,16,112,FMN 15 Luitenant Lippenslaan
662,Luitenant Lippenslaan 200,2023-04-05,17:00:00,118,9,109,FMN 15 Luitenant Lippenslaan
662,Luitenant Lippenslaan 200,2023-04-05,18:00:00,94,14,80,FMN 15 Luitenant Lippenslaan
662,Luitenant Lippenslaan 200,2023-04-05,19:00:00,84,18,66,FMN 15 Luitenant Lippenslaan
662,Luitenant Lippenslaan 200,2023-04-05,20:00:00,56,8,48,FMN 15 Luitenant Lippenslaan
662,Luitenant Lippenslaan 200,2023-04-05,21:00:00,42,4,38,FMN 15 Luitenant Lippenslaan
662,Luitenant Lippenslaan 200,2023-04-05,22:00:00,37,8,29,FMN 15 Luitenant Lippenslaan
662,Luitenant Lippenslaan 200,2023-04-05,23:00:00,22,12,10,FMN 15 Luitenant Lippenslaan
662,Luitenant Lippenslaan 200,2023-04-06,00:00:00,10,4,6,FMN 15 Luitenant Lippenslaan
662,Luitenant Lippenslaan 200,2023-04-06,01:00:00,12,3,9,FMN 15 Luitenant Lippenslaan
662,Luitenant Lippenslaan 200,2023-04-06,02:00:00,9,5,4,FMN 15 Luitenant Lippenslaan
662,Luitenant Lippenslaan 200,2023-04-06,03:00:00,4,0,4,FMN 15 Luitenant Lippenslaan
662,Luitenant Lippenslaan 200,2023-04-06,04:00:00,10,2,8,FMN 15 Luitenant Lippenslaan
662,Luitenant Lippenslaan 200,2023-04-06,05:00:00,12,2,10,FMN 15 Luitenant Lippenslaan
662,Luitenant Lippenslaan 200,2023-04-06,06:00:00,49,3,46,FMN 15 Luitenant Lippenslaan
662,Luitenant Lippenslaan 200,2023-04-06,07:00:00,132,7,125,FMN 15 Luitenant Lippenslaan
662,Luitenant Lippenslaan 200,2023-04-06,08:00:00,218,2,216,FMN 15 Luitenant Lippenslaan
662,Luitenant Lippenslaan 200,2023-04-06,09:00:00,117,4,113,FMN 15 Luitenant Lippenslaan
662,Luitenant Lippenslaan 200,2023-04-06,10:00:00,53,2,51,FMN 15 Luitenant Lippenslaan
662,Luitenant Lippenslaan 200,2023-04-06,11:00:00,53,5,48,FMN 15 Luitenant Lippenslaan
662,Luitenant Lippenslaan 200,2023-04-06,12:00:00,39,3,36,FMN 15 Luitenant Lippenslaan
662,Luitenant Lippenslaan 200,2023-04-06,13:00:00,66,3,63,FMN 15 Luitenant Lippenslaan
662,Luitenant Lippenslaan 200,2023-04-06,14:00:00,49,4,45,FMN 15 Luitenant Lippenslaan
662,Luitenant Lippenslaan 200,2023-04-06,15:00:00,49,8,41,FMN 15 Luitenant Lippenslaan
662,Luitenant Lippenslaan 200,2023-04-06,16:00:00,90,9,81,FMN 15 Luitenant Lippenslaan
662,Luitenant Lippenslaan 200,2023-04-06,17:00:00,110,15,95,FMN 15 Luitenant Lippenslaan
662,Luitenant Lippenslaan 200,2023-04-06,18:00:00,79,6,73,FMN 15 Luitenant Lippenslaan
662,Luitenant Lippenslaan 200,2023-04-06,19:00:00,60,7,53,FMN 15 Luitenant Lippenslaan
662,Luitenant Lippenslaan 200,2023-04-06,20:00:00,35,11,24,FMN 15 Luitenant Lippenslaan
662,Luitenant Lippenslaan 200,2023-04-06,21:00:00,29,3,26,FMN 15 Luitenant Lippenslaan
662,Luitenant Lippenslaan 200,2023-04-06,22:00:00,30,3,27,FMN 15 Luitenant Lippenslaan
662,Luitenant Lippenslaan 200,2023-04-06,23:00:00,15,8,7,FMN 15 Luitenant Lippenslaan
662,Luitenant Lippenslaan 200,2023-04-07,00:00:00,6,3,3,FMN 15 Luitenant Lippenslaan
662,Luitenant Lippenslaan 200,2023-04-07,01:00:00,8,3,5,FMN 15 Luitenant Lippenslaan
662,Luitenant Lippenslaan 200,2023-04-07,02:00:00,7,4,3,FMN 15 Luitenant Lippenslaan
662,Luitenant Lippenslaan 200,2023-04-07,03:00:00,2,2,0,FMN 15 Luitenant Lippenslaan
662,Luitenant Lippenslaan 200,2023-04-07,04:00:00,8,2,6,FMN 15 Luitenant Lippenslaan
662,Luitenant Lippenslaan 200,2023-04-07,05:00:00,12,0,12,FMN 15 Luitenant Lippenslaan
662,Luitenant Lippenslaan 200,2023-04-07,06:00:00,46,6,40,FMN 15 Luitenant Lippenslaan
662,Luitenant Lippenslaan 200,2023-04-07,07:00:00,85,5,80,FMN 15 Luitenant Lippenslaan
662,Luitenant Lippenslaan 200,2023-04-07,08:00:00,172,5,167,FMN 15 Luitenant Lippenslaan
662,Luitenant Lippenslaan 200,2023-04-07,09:00:00,97,2,95,FMN 15 Luitenant Lippenslaan
662,Luitenant Lippenslaan 200,2023-04-07,10:00:00,80,0,80,FMN 15 Luitenant Lippenslaan
662,Luitenant Lippenslaan 200,2023-04-07,11:00:00,63,8,55,FMN 15 Luitenant Lippenslaan
662,Luitenant Lippenslaan 200,2023-04-07,12:00:00,82,11,71,FMN 15 Luitenant Lippenslaan
662,Luitenant Lippenslaan 200,2023-04-07,13:00:00,85,8,77,FMN 15 Luitenant Lippenslaan
662,Luitenant Lippenslaan 200,2023-04-07,14:00:00,77,6,71,FMN 15 Luitenant Lippenslaan
662,Luitenant Lippenslaan 200,2023-04-07,15:00:00,89,10,79,FMN 15 Luitenant Lippenslaan
662,Luitenant Lippenslaan 200,2023-04-07,16:00:00,92,11,81,FMN 15 Luitenant Lippenslaan
662,Luitenant Lippenslaan 200,2023-04-07,17:00:00,116,11,105,FMN 15 Luitenant Lippenslaan
662,Luitenant Lippenslaan 200,2023-04-07,18:00:00,132,12,120,FMN 15 Luitenant Lippenslaan
662,Luitenant Lippenslaan 200,2023-04-07,19:00:00,100,9,91,FMN 15 Luitenant Lippenslaan
662,Luitenant Lippenslaan 200,2023-04-07,20:00:00,71,13,58,FMN 15 Luitenant Lippenslaan
662,Luitenant Lippenslaan 200,2023-04-07,21:00:00,59,4,55,FMN 15 Luitenant Lippenslaan
662,Luitenant Lippenslaan 200,2023-04-07,22:00:00,45,5,40,FMN 15 Luitenant Lippenslaan
662,Luitenant Lippenslaan 200,2023-04-07,23:00:00,30,11,19,FMN 15 Luitenant Lippenslaan
662,Luitenant Lippenslaan 200,2023-04-08,00:00:00,28,10,18,FMN 15 Luitenant Lippenslaan
662,Luitenant Lippenslaan 200,2023-04-08,01:00:00,11,4,7,FMN 15 Luitenant Lippenslaan
662,Luitenant Lippenslaan 200,2023-04-08,02:00:00,10,5,5,FMN 15 Luitenant Lippenslaan
662,Luitenant Lippenslaan 200,2023-04-08,03:00:00,7,3,4,FMN 15 Luitenant Lippenslaan
662,Luitenant Lippenslaan 200,2023-04-08,04:00:00,5,0,5,FMN 15 Luitenant Lippenslaan
662,Luitenant Lippenslaan 200,2023-04-08,05:00:00,13,2,11,FMN 15 Luitenant Lippenslaan
662,Luitenant Lippenslaan 200,2023-04-08,06:00:00,16,4,12,FMN 15 Luitenant Lippenslaan
662,Luitenant Lippenslaan 200,2023-04-08,07:00:00,19,2,17,FMN 15 Luitenant Lippenslaan
662,Luitenant Lippenslaan 200,2023-04-08,08:00:00,41,4,37,FMN 15 Luitenant Lippenslaan
662,Luitenant Lippenslaan 200,2023-04-08,09:00:00,63,1,62,FMN 15 Luitenant Lippenslaan
662,Luitenant Lippenslaan 200,2023-04-08,10:00:00,102,4,98,FMN 15 Luitenant Lippenslaan
662,Luitenant Lippenslaan 200,2023-04-08,11:00:00,72,3,69,FMN 15 Luitenant Lippenslaan
662,Luitenant Lippenslaan 200,2023-04-08,12:00:00,80,9,71,FMN 15 Luitenant Lippenslaan
662,Luitenant Lippenslaan 200,2023-04-08,13:00:00,109,2,107,FMN 15 Luitenant Lippenslaan
662,Luitenant Lippenslaan 200,2023-04-08,14:00:00,95,13,82,FMN 15 Luitenant Lippenslaan
662,Luitenant Lippenslaan 200,2023-04-08,15:00:00,98,5,93,FMN 15 Luitenant Lippenslaan
662,Luitenant Lippenslaan 200,2023-04-08,16:00:00,87,12,75,FMN 15 Luitenant Lippenslaan
662,Luitenant Lippenslaan 200,2023-04-08,17:00:00,103,9,94,FMN 15 Luitenant Lippenslaan
662,Luitenant Lippenslaan 200,2023-04-08,18:00:00,102,17,85,FMN 15 Luitenant Lippenslaan
662,Luitenant Lippenslaan 200,2023-04-08,19:00:00,92,11,81,FMN 15 Luitenant Lippenslaan
662,Luitenant Lippenslaan 200,2023-04-08,20:00:00,64,12,52,FMN 15 Luitenant Lippenslaan
662,Luitenant Lippenslaan 200,2023-04-08,21:00:00,51,9,42,FMN 15 Luitenant Lippenslaan
662,Luitenant Lippenslaan 200,2023-04-08,22:00:00,38,9,29,FMN 15 Luitenant Lippenslaan
662,Luitenant Lippenslaan 200,2023-04-08,23:00:00,37,10,27,FMN 15 Luitenant Lippenslaan
662,Luitenant Lippenslaan 200,2023-04-09,00:00:00,19,4,15,FMN 15 Luitenant Lippenslaan
662,Luitenant Lippenslaan 200,2023-04-09,01:00:00,8,2,6,FMN 15 Luitenant Lippenslaan
662,Luitenant Lippenslaan 200,2023-04-09,02:00:00,6,2,4,FMN 15 Luitenant Lippenslaan
662,Luitenant Lippenslaan 200,2023-04-09,03:00:00,7,3,4,FMN 15 Luitenant Lippenslaan
662,Luitenant Lippenslaan 200,2023-04-09,04:00:00,5,2,3,FMN 15 Luitenant Lippenslaan
662,Luitenant Lippenslaan 200,2023-04-09,05:00:00,6,0,6,FMN 15 Luitenant Lippenslaan
662,Luitenant Lippenslaan 200,2023-04-09,06:00:00,13,3,10,FMN 15 Luitenant Lippenslaan
662,Luitenant Lippenslaan 200,2023-04-09,07:00:00,12,2,10,FMN 15 Luitenant Lippenslaan
662,Luitenant Lippenslaan 200,2023-04-09,08:00:00,26,4,22,FMN 15 Luitenant Lippenslaan
662,Luitenant Lippenslaan 200,2023-04-09,09:00:00,55,4,51,FMN 15 Luitenant Lippenslaan
662,Luitenant Lippenslaan 200,2023-04-09,10:00:00,65,6,59,FMN 15 Luitenant Lippenslaan
662,Luitenant Lippenslaan 200,2023-04-09,11:00:00,57,6,51,FMN 15 Luitenant Lippenslaan
662,Luitenant Lippenslaan 200,2023-04-09,12:00:00,58,11,47,FMN 15 Luitenant Lippenslaan
662,Luitenant Lippenslaan 200,2023-04-09,13:00:00,83,5,78,FMN 15 Luitenant Lippenslaan
662,Luitenant Lippenslaan 200,2023-04-09,14:00:00,74,8,66,FMN 15 Luitenant Lippenslaan
662,Luitenant Lippenslaan 200,2023-04-09,15:00:00,67,12,55,FMN 15 Luitenant Lippenslaan
662,Luitenant Lippenslaan 200,2023-04-09,16:00:00,71,6,65,FMN 15 Luitenant Lippenslaan
662,Luitenant Lippenslaan 200,2023-04-09,17:00:00,89,5,84,FMN 15 Luitenant Lippenslaan
662,Luitenant Lippenslaan 200,2023-04-09,18:00:00,106,14,92,FMN 15 Luitenant Lippenslaan
662,Luitenant Lippenslaan 200,2023-04-09,19:00:00,86,15,71,FMN 15 Luitenant Lippenslaan
662,Luitenant Lippenslaan 200,2023-04-09,20:00:00,64,10,54,FMN 15 Luitenant Lippenslaan
662,Luitenant Lippenslaan 200,2023-04-09,21:00:00,59,3,56,FMN 15 Luitenant Lippenslaan
662,Luitenant Lippenslaan 200,2023-04-09,22:00:00,40,4,36,FMN 15 Luitenant Lippenslaan
662,Luitenant Lippenslaan 200,2023-04-09,23:00:00,29,9,20,FMN 15 Luitenant Lippenslaan
662,Luitenant Lippenslaan 200,2023-04-10,00:00:00,15,6,9,FMN 15 Luitenant Lippenslaan
662,Luitenant Lippenslaan 200,2023-04-10,01:00:00,11,3,8,FMN 15 Luitenant Lippenslaan
662,Luitenant Lippenslaan 200,2023-04-10,02:00:00,4,3,1,FMN 15 Luitenant Lippenslaan
662,Luitenant Lippenslaan 200,2023-04-10,03:00:00,3,1,2,FMN 15 Luitenant Lippenslaan
662,Luitenant Lippenslaan 200,2023-04-10,04:00:00,2,1,1,FMN 15 Luitenant Lippenslaan
662,Luitenant Lippenslaan 200,2023-04-10,05:00:00,5,0,5,FMN 15 Luitenant Lippenslaan
662,Luitenant Lippenslaan 200,2023-04-10,06:00:00,22,6,16,FMN 15 Luitenant Lippenslaan
662,Luitenant Lippenslaan 200,2023-04-10,07:00:00,14,2,12,FMN 15 Luitenant Lippenslaan
662,Luitenant Lippenslaan 200,2023-04-10,08:00:00,31,5,26,FMN 15 Luitenant Lippenslaan
662,Luitenant Lippenslaan 200,2023-04-10,09:00:00,49,2,47,FMN 15 Luitenant Lippenslaan
662,Luitenant Lippenslaan 200,2023-04-10,10:00:00,63,2,61,FMN 15 Luitenant Lippenslaan
662,Luitenant Lippenslaan 200,2023-04-10,11:00:00,61,4,57,FMN 15 Luitenant Lippenslaan
662,Luitenant Lippenslaan 200,2023-04-10,12:00:00,74,9,65,FMN 15 Luitenant Lippenslaan
662,Luitenant Lippenslaan 200,2023-04-10,13:00:00,68,1,67,FMN 15 Luitenant Lippenslaan
662,Luitenant Lippenslaan 200,2023-04-10,14:00:00,58,6,52,FMN 15 Luitenant Lippenslaan
662,Luitenant Lippenslaan 200,2023-04-10,15:00:00,38,5,33,FMN 15 Luitenant Lippenslaan
662,Luitenant Lippenslaan 200,2023-04-10,16:00:00,43,5,38,FMN 15 Luitenant Lippenslaan
662,Luitenant Lippenslaan 200,2023-04-10,17:00:00,58,10,48,FMN 15 Luitenant Lippenslaan
662,Luitenant Lippenslaan 200,2023-04-10,18:00:00,52,6,46,FMN 15 Luitenant Lippenslaan
662,Luitenant Lippenslaan 200,2023-04-10,19:00:00,48,12,36,FMN 15 Luitenant Lippenslaan
662,Luitenant Lippenslaan 200,2023-04-10,20:00:00,37,7,30,FMN 15 Luitenant Lippenslaan
662,Luitenant Lippenslaan 200,2023-04-10,21:00:00,37,4,33,FMN 15 Luitenant Lippenslaan
662,Luitenant Lippenslaan 200,2023-04-10,22:00:00,32,5,27,FMN 15 Luitenant Lippenslaan
662,Luitenant Lippenslaan 200,2023-04-10,23:00:00,25,10,15,FMN 15 Luitenant Lippenslaan
662,Luitenant Lippenslaan 200,2023-04-11,00:00:00,11,4,7,FMN 15 Luitenant Lippenslaan
662,Luitenant Lippenslaan 200,2023-04-11,01:00:00,7,2,5,FMN 15 Luitenant Lippenslaan
662,Luitenant Lippenslaan 200,2023-04-11,02:00:00,9,5,4,FMN 15 Luitenant Lippenslaan
662,Luitenant Lippenslaan 200,2023-04-11,03:00:00,5,0,5,FMN 15 Luitenant Lippenslaan
662,Luitenant Lippenslaan 200,2023-04-11,04:00:00,9,1,8,FMN 15 Luitenant Lippenslaan
662,Luitenant Lippenslaan 200,2023-04-11,05:00:00,20,1,19,FMN 15 Luitenant Lippenslaan
662,Luitenant Lippenslaan 200,2023-04-11,06:00:00,62,4,58,FMN 15 Luitenant Lippenslaan
662,Luitenant Lippenslaan 200,2023-04-11,07:00:00,137,7,130,FMN 15 Luitenant Lippenslaan
662,Luitenant Lippenslaan 200,2023-04-11,08:00:00,252,4,248,FMN 15 Luitenant Lippenslaan
662,Luitenant Lippenslaan 200,2023-04-11,09:00:00,133,2,131,FMN 15 Luitenant Lippenslaan
662,Luitenant Lippenslaan 200,2023-04-11,10:00:00,77,4,73,FMN 15 Luitenant Lippenslaan
662,Luitenant Lippenslaan 200,2023-04-11,11:00:00,72,8,64,FMN 15 Luitenant Lippenslaan
662,Luitenant Lippenslaan 200,2023-04-11,12:00:00,69,7,62,FMN 15 Luitenant Lippenslaan
662,Luitenant Lippenslaan 200,2023-04-11,13:00:00,95,1,94,FMN 15 Luitenant Lippenslaan
662,Luitenant Lippenslaan 200,2023-04-11,14:00:00,80,7,73,FMN 15 Luitenant Lippenslaan
662,Luitenant Lippenslaan 200,2023-04-11,15:00:00,104,6,98,FMN 15 Luitenant Lippenslaan
662,Luitenant Lippenslaan 200,2023-04-11,16:00:00,93,9,84,FMN 15 Luitenant Lippenslaan
662,Luitenant Lippenslaan 200,2023-04-11,17:00:00,141,16,125,FMN 15 Luitenant Lippenslaan
662,Luitenant Lippenslaan 200,2023-04-11,18:00:00,112,15,97,FMN 15 Luitenant Lippenslaan
662,Luitenant Lippenslaan 200,2023-04-11,19:00:00,73,12,61,FMN 15 Luitenant Lippenslaan
662,Luitenant Lippenslaan 200,2023-04-11,20:00:00,66,21,45,FMN 15 Luitenant Lippenslaan
662,Luitenant Lippenslaan 200,2023-04-11,21:00:00,41,5,36,FMN 15 Luitenant Lippenslaan
662,Luitenant Lippenslaan 200,2023-04-11,22:00:00,52,7,45,FMN 15 Luitenant Lippenslaan
662,Luitenant Lippenslaan 200,2023-04-11,23:00:00,32,13,19,FMN 15 Luitenant Lippenslaan
662,Luitenant Lippenslaan 200,2023-04-12,00:00:00,9,4,5,FMN 15 Luitenant Lippenslaan
662,Luitenant Lippenslaan 200,2023-04-12,01:00:00,1,1,0,FMN 15 Luitenant Lippenslaan
662,Luitenant Lippenslaan 200,2023-04-12,02:00:00,9,6,3,FMN 15 Luitenant Lippenslaan
662,Luitenant Lippenslaan 200,2023-04-12,03:00:00,1,1,0,FMN 15 Luitenant Lippenslaan
662,Luitenant Lippenslaan 200,2023-04-12,04:00:00,7,1,6,FMN 15 Luitenant Lippenslaan
662,Luitenant Lippenslaan 200,2023-04-12,05:00:00,17,1,16,FMN 15 Luitenant Lippenslaan
662,Luitenant Lippenslaan 200,2023-04-12,06:00:00,49,6,43,FMN 15 Luitenant Lippenslaan
662,Luitenant Lippenslaan 200,2023-04-12,07:00:00,91,1,90,FMN 15 Luitenant Lippenslaan
662,Luitenant Lippenslaan 200,2023-04-12,08:00:00,160,4,156,FMN 15 Luitenant Lippenslaan
662,Luitenant Lippenslaan 200,2023-04-12,09:00:00,107,5,102,FMN 15 Luitenant Lippenslaan
662,Luitenant Lippenslaan 200,2023-04-12,10:00:00,45,4,41,FMN 15 Luitenant Lippenslaan
662,Luitenant Lippenslaan 200,2023-04-12,11:00:00,53,5,48,FMN 15 Luitenant Lippenslaan
662,Luitenant Lippenslaan 200,2023-04-12,12:00:00,53,4,49,FMN 15 Luitenant Lippenslaan
662,Luitenant Lippenslaan 200,2023-04-12,13:00:00,52,4,48,FMN 15 Luitenant Lippenslaan
662,Luitenant Lippenslaan 200,2023-04-12,14:00:00,56,5,51,FMN 15 Luitenant Lippenslaan
662,Luitenant Lippenslaan 200,2023-04-12,15:00:00,57,13,44,FMN 15 Luitenant Lippenslaan
662,Luitenant Lippenslaan 200,2023-04-12,16:00:00,85,11,74,FMN 15 Luitenant Lippenslaan
662,Luitenant Lippenslaan 200,2023-04-12,17:00:00,108,9,99,FMN 15 Luitenant Lippenslaan
662,Luitenant Lippenslaan 200,2023-04-12,18:00:00,88,18,70,FMN 15 Luitenant Lippenslaan
662,Luitenant Lippenslaan 200,2023-04-12,19:00:00,88,19,69,FMN 15 Luitenant Lippenslaan
662,Luitenant Lippenslaan 200,2023-04-12,20:00:00,64,12,52,FMN 15 Luitenant Lippenslaan
662,Luitenant Lippenslaan 200,2023-04-12,21:00:00,55,5,50,FMN 15 Luitenant Lippenslaan
662,Luitenant Lippenslaan 200,2023-04-12,22:00:00,54,10,44,FMN 15 Luitenant Lippenslaan
662,Luitenant Lippenslaan 200,2023-04-12,23:00:00,27,11,16,FMN 15 Luitenant Lippenslaan
662,Luitenant Lippenslaan 200,2023-04-13,00:00:00,6,3,3,FMN 15 Luitenant Lippenslaan
662,Luitenant Lippenslaan 200,2023-04-13,01:00:00,4,3,1,FMN 15 Luitenant Lippenslaan
662,Luitenant Lippenslaan 200,2023-04-13,02:00:00,11,7,4,FMN 15 Luitenant Lippenslaan
662,Luitenant Lippenslaan 200,2023-04-13,03:00:00,3,2,1,FMN 15 Luitenant Lippenslaan
662,Luitenant Lippenslaan 200,2023-04-13,04:00:00,8,1,7,FMN 15 Luitenant Lippenslaan
662,Luitenant Lippenslaan 200,2023-04-13,05:00:00,16,1,15,FMN 15 Luitenant Lippenslaan
662,Luitenant Lippenslaan 200,2023-04-13,06:00:00,50,4,46,FMN 15 Luitenant Lippenslaan
662,Luitenant Lippenslaan 200,2023-04-13,07:00:00,117,6,111,FMN 15 Luitenant Lippenslaan
662,Luitenant Lippenslaan 200,2023-04-13,08:00:00,255,8,247,FMN 15 Luitenant Lippenslaan
662,Luitenant Lippenslaan 200,2023-04-13,09:00:00,131,3,128,FMN 15 Luitenant Lippenslaan
662,Luitenant Lippenslaan 200,2023-04-13,10:00:00,76,4,72,FMN 15 Luitenant Lippenslaan
662,Luitenant Lippenslaan 200,2023-04-13,11:00:00,79,9,70,FMN 15 Luitenant Lippenslaan
662,Luitenant Lippenslaan 200,2023-04-13,12:00:00,63,5,58,FMN 15 Luitenant Lippenslaan
662,Luitenant Lippenslaan 200,2023-04-13,13:00:00,84,9,75,FMN 15 Luitenant Lippenslaan
662,Luitenant Lippenslaan 200,2023-04-13,14:00:00,74,10,64,FMN 15 Luitenant Lippenslaan
662,Luitenant Lippenslaan 200,2023-04-13,15:00:00,76,8,68,FMN 15 Luitenant Lippenslaan
662,Luitenant Lippenslaan 200,2023-04-13,16:00:00,92,5,87,FMN 15 Luitenant Lippenslaan
662,Luitenant Lippenslaan 200,2023-04-13,17:00:00,132,12,120,FMN 15 Luitenant Lippenslaan
662,Luitenant Lippenslaan 200,2023-04-13,18:00:00,129,13,116,FMN 15 Luitenant Lippenslaan
662,Luitenant Lippenslaan 200,2023-04-13,19:00:00,91,12,79,FMN 15 Luitenant Lippenslaan
662,Luitenant Lippenslaan 200,2023-04-13,20:00:00,74,18,56,FMN 15 Luitenant Lippenslaan
662,Luitenant Lippenslaan 200,2023-04-13,21:00:00,53,7,46,FMN 15 Luitenant Lippenslaan
662,Luitenant Lippenslaan 200,2023-04-13,22:00:00,49,4,45,FMN 15 Luitenant Lippenslaan
662,Luitenant Lippenslaan 200,2023-04-13,23:00:00,34,17,17,FMN 15 Luitenant Lippenslaan
662,Luitenant Lippenslaan 200,2023-04-14,00:00:00,20,10,10,FMN 15 Luitenant Lippenslaan
662,Luitenant Lippenslaan 200,2023-04-14,01:00:00,15,5,10,FMN 15 Luitenant Lippenslaan
662,Luitenant Lippenslaan 200,2023-04-14,02:00:00,7,5,2,FMN 15 Luitenant Lippenslaan
662,Luitenant Lippenslaan 200,2023-04-14,03:00:00,5,3,2,FMN 15 Luitenant Lippenslaan
662,Luitenant Lippenslaan 200,2023-04-14,04:00:00,6,1,5,FMN 15 Luitenant Lippenslaan
662,Luitenant Lippenslaan 200,2023-04-14,05:00:00,17,3,14,FMN 15 Luitenant Lippenslaan
662,Luitenant Lippenslaan 200,2023-04-14,06:00:00,50,3,47,FMN 15 Luitenant Lippenslaan
662,Luitenant Lippenslaan 200,2023-04-14,07:00:00,102,9,93,FMN 15 Luitenant Lippenslaan
662,Luitenant Lippenslaan 200,2023-04-14,08:00:00,197,4,193,FMN 15 Luitenant Lippenslaan
662,Luitenant Lippenslaan 200,2023-04-14,09:00:00,113,5,108,FMN 15 Luitenant Lippenslaan
662,Luitenant Lippenslaan 200,2023-04-14,10:00:00,79,5,74,FMN 15 Luitenant Lippenslaan
662,Luitenant Lippenslaan 200,2023-04-14,11:00:00,77,8,69,FMN 15 Luitenant Lippenslaan
662,Luitenant Lippenslaan 200,2023-04-14,12:00:00,101,9,92,FMN 15 Luitenant Lippenslaan
662,Luitenant Lippenslaan 200,2023-04-14,13:00:00,87,8,79,FMN 15 Luitenant Lippenslaan
662,Luitenant Lippenslaan 200,2023-04-14,14:00:00,89,8,81,FMN 15 Luitenant Lippenslaan
662,Luitenant Lippenslaan 200,2023-04-14,15:00:00,115,22,93,FMN 15 Luitenant Lippenslaan
662,Luitenant Lippenslaan 200,2023-04-14,16:00:00,107,10,97,FMN 15 Luitenant Lippenslaan
662,Luitenant Lippenslaan 200,2023-04-14,17:00:00,104,6,98,FMN 15 Luitenant Lippenslaan
662,Luitenant Lippenslaan 200,2023-04-14,18:00:00,124,16,108,FMN 15 Luitenant Lippenslaan
662,Luitenant Lippenslaan 200,2023-04-14,19:00:00,115,16,99,FMN 15 Luitenant Lippenslaan
662,Luitenant Lippenslaan 200,2023-04-14,20:00:00,77,13,64,FMN 15 Luitenant Lippenslaan
662,Luitenant Lippenslaan 200,2023-04-14,21:00:00,56,6,50,FMN 15 Luitenant Lippenslaan
662,Luitenant Lippenslaan 200,2023-04-14,22:00:00,62,7,55,FMN 15 Luitenant Lippenslaan
662,Luitenant Lippenslaan 200,2023-04-14,23:00:00,37,18,19,FMN 15 Luitenant Lippenslaan
662,Luitenant Lippenslaan 200,2023-04-15,00:00:00,39,14,25,FMN 15 Luitenant Lippenslaan
662,Luitenant Lippenslaan 200,2023-04-15,01:00:00,21,6,15,FMN 15 Luitenant Lippenslaan
662,Luitenant Lippenslaan 200,2023-04-15,02:00:00,17,7,10,FMN 15 Luitenant Lippenslaan
662,Luitenant Lippenslaan 200,2023-04-15,03:00:00,7,0,7,FMN 15 Luitenant Lippenslaan
662,Luitenant Lippenslaan 200,2023-04-15,04:00:00,9,2,7,FMN 15 Luitenant Lippenslaan
662,Luitenant Lippenslaan 200,2023-04-15,05:00:00,16,2,14,FMN 15 Luitenant Lippenslaan
662,Luitenant Lippenslaan 200,2023-04-15,06:00:00,17,3,14,FMN 15 Luitenant Lippenslaan
662,Luitenant Lippenslaan 200,2023-04-15,07:00:00,33,5,28,FMN 15 Luitenant Lippenslaan
662,Luitenant Lippenslaan 200,2023-04-15,08:00:00,42,1,41,FMN 15 Luitenant Lippenslaan
662,Luitenant Lippenslaan 200,2023-04-15,09:00:00,74,5,69,FMN 15 Luitenant Lippenslaan
662,Luitenant Lippenslaan 200,2023-04-15,10:00:00,124,6,118,FMN 15 Luitenant Lippenslaan
662,Luitenant Lippenslaan 200,2023-04-15,11:00:00,99,7,92,FMN 15 Luitenant Lippenslaan
662,Luitenant Lippenslaan 200,2023-04-15,12:00:00,116,9,107,FMN 15 Luitenant Lippenslaan
662,Luitenant Lippenslaan 200,2023-04-15,13:00:00,124,9,115,FMN 15 Luitenant Lippenslaan
662,Luitenant Lippenslaan 200,2023-04-15,14:00:00,143,14,129,FMN 15 Luitenant Lippenslaan
662,Luitenant Lippenslaan 200,2023-04-15,15:00:00,102,18,84,FMN 15 Luitenant Lippenslaan
662,Luitenant Lippenslaan 200,2023-04-15,16:00:00,99,6,93,FMN 15 Luitenant Lippenslaan
662,Luitenant Lippenslaan 200,2023-04-15,17:00:00,101,10,91,FMN 15 Luitenant Lippenslaan
662,Luitenant Lippenslaan 200,2023-04-15,18:00:00,110,9,101,FMN 15 Luitenant Lippenslaan
662,Luitenant Lippenslaan 200,2023-04-15,19:00:00,92,15,77,FMN 15 Luitenant Lippenslaan
662,Luitenant Lippenslaan 200,2023-04-15,20:00:00,83,15,68,FMN 15 Luitenant Lippenslaan
662,Luitenant Lippenslaan 200,2023-04-15,21:00:00,55,9,46,FMN 15 Luitenant Lippenslaan
662,Luitenant Lippenslaan 200,2023-04-15,22:00:00,50,10,40,FMN 15 Luitenant Lippenslaan
662,Luitenant Lippenslaan 200,2023-04-15,23:00:00,32,10,22,FMN 15 Luitenant Lippenslaan
662,Luitenant Lippenslaan 200,2023-04-16,00:00:00,32,12,20,FMN 15 Luitenant Lippenslaan
662,Luitenant Lippenslaan 200,2023-04-16,01:00:00,15,4,11,FMN 15 Luitenant Lippenslaan
662,Luitenant Lippenslaan 200,2023-04-16,02:00:00,13,5,8,FMN 15 Luitenant Lippenslaan
662,Luitenant Lippenslaan 200,2023-04-16,03:00:00,6,5,1,FMN 15 Luitenant Lippenslaan
662,Luitenant Lippenslaan 200,2023-04-16,04:00:00,7,3,4,FMN 15 Luitenant Lippenslaan
662,Luitenant Lippenslaan 200,2023-04-16,05:00:00,13,2,11,FMN 15 Luitenant Lippenslaan
662,Luitenant Lippenslaan 200,2023-04-16,06:00:00,18,4,14,FMN 15 Luitenant Lippenslaan
662,Luitenant Lippenslaan 200,2023-04-16,07:00:00,15,2,13,FMN 15 Luitenant Lippenslaan
662,Luitenant Lippenslaan 200,2023-04-16,08:00:00,18,1,17,FMN 15 Luitenant Lippenslaan
662,Luitenant Lippenslaan 200,2023-04-16,09:00:00,57,2,55,FMN 15 Luitenant Lippenslaan
662,Luitenant Lippenslaan 200,2023-04-16,10:00:00,53,5,48,FMN 15 Luitenant Lippenslaan
662,Luitenant Lippenslaan 200,2023-04-16,11:00:00,49,2,47,FMN 15 Luitenant Lippenslaan
662,Luitenant Lippenslaan 200,2023-04-16,12:00:00,71,11,60,FMN 15 Luitenant Lippenslaan
662,Luitenant Lippenslaan 200,2023-04-16,13:00:00,80,6,74,FMN 15 Luitenant Lippenslaan
662,Luitenant Lippenslaan 200,2023-04-16,14:00:00,84,9,75,FMN 15 Luitenant Lippenslaan
662,Luitenant Lippenslaan 200,2023-04-16,15:00:00,58,8,50,FMN 15 Luitenant Lippenslaan
662,Luitenant Lippenslaan 200,2023-04-16,16:00:00,73,11,62,FMN 15 Luitenant Lippenslaan
662,Luitenant Lippenslaan 200,2023-04-16,17:00:00,70,8,62,FMN 15 Luitenant Lippenslaan
662,Luitenant Lippenslaan 200,2023-04-16,18:00:00,85,10,75,FMN 15 Luitenant Lippenslaan
662,Luitenant Lippenslaan 200,2023-04-16,19:00:00,52,12,40,FMN 15 Luitenant Lippenslaan
662,Luitenant Lippenslaan 200,2023-04-16,20:00:00,61,10,51,FMN 15 Luitenant Lippenslaan
662,Luitenant Lippenslaan 200,2023-04-16,21:00:00,50,7,43,FMN 15 Luitenant Lippenslaan
662,Luitenant Lippenslaan 200,2023-04-16,22:00:00,47,6,41,FMN 15 Luitenant Lippenslaan
662,Luitenant Lippenslaan 200,2023-04-16,23:00:00,19,7,12,FMN 15 Luitenant Lippenslaan
662,Luitenant Lippenslaan 200,2023-04-17,00:00:00,19,13,6,FMN 15 Luitenant Lippenslaan
662,Luitenant Lippenslaan 200,2023-04-17,01:00:00,5,3,2,FMN 15 Luitenant Lippenslaan
662,Luitenant Lippenslaan 200,2023-04-17,02:00:00,5,4,1,FMN 15 Luitenant Lippenslaan
662,Luitenant Lippenslaan 200,2023-04-17,03:00:00,3,1,2,FMN 15 Luitenant Lippenslaan
662,Luitenant Lippenslaan 200,2023-04-17,04:00:00,8,2,6,FMN 15 Luitenant Lippenslaan
662,Luitenant Lippenslaan 200,2023-04-17,05:00:00,26,6,20,FMN 15 Luitenant Lippenslaan
662,Luitenant Lippenslaan 200,2023-04-17,06:00:00,67,4,63,FMN 15 Luitenant Lippenslaan
662,Luitenant Lippenslaan 200,2023-04-17,07:00:00,218,9,209,FMN 15 Luitenant Lippenslaan
662,Luitenant Lippenslaan 200,2023-04-17,08:00:00,437,8,429,FMN 15 Luitenant Lippenslaan
662,Luitenant Lippenslaan 200,2023-04-17,09:00:00,158,11,147,FMN 15 Luitenant Lippenslaan
662,Luitenant Lippenslaan 200,2023-04-17,10:00:00,68,0,68,FMN 15 Luitenant Lippenslaan
662,Luitenant Lippenslaan 200,2023-04-17,11:00:00,68,2,66,FMN 15 Luitenant Lippenslaan
662,Luitenant Lippenslaan 200,2023-04-17,12:00:00,99,12,87,FMN 15 Luitenant Lippenslaan
662,Luitenant Lippenslaan 200,2023-04-17,13:00:00,62,5,57,FMN 15 Luitenant Lippenslaan
662,Luitenant Lippenslaan 200,2023-04-17,14:00:00,88,14,74,FMN 15 Luitenant Lippenslaan
662,Luitenant Lippenslaan 200,2023-04-17,15:00:00,96,20,76,FMN 15 Luitenant Lippenslaan
662,Luitenant Lippenslaan 200,2023-04-17,16:00:00,151,12,139,FMN 15 Luitenant Lippenslaan
662,Luitenant Lippenslaan 200,2023-04-17,17:00:00,168,20,148,FMN 15 Luitenant Lippenslaan
662,Luitenant Lippenslaan 200,2023-04-17,18:00:00,119,16,103,FMN 15 Luitenant Lippenslaan
662,Luitenant Lippenslaan 200,2023-04-17,19:00:00,92,16,76,FMN 15 Luitenant Lippenslaan
662,Luitenant Lippenslaan 200,2023-04-17,20:00:00,90,13,77,FMN 15 Luitenant Lippenslaan
662,Luitenant Lippenslaan 200,2023-04-17,21:00:00,65,10,55,FMN 15 Luitenant Lippenslaan
662,Luitenant Lippenslaan 200,2023-04-17,22:00:00,66,12,54,FMN 15 Luitenant Lippenslaan
662,Luitenant Lippenslaan 200,2023-04-17,23:00:00,30,10,20,FMN 15 Luitenant Lippenslaan
662,Luitenant Lippenslaan 200,2023-04-18,00:00:00,17,7,10,FMN 15 Luitenant Lippenslaan
662,Luitenant Lippenslaan 200,2023-04-18,01:00:00,18,8,10,FMN 15 Luitenant Lippenslaan
662,Luitenant Lippenslaan 200,2023-04-18,02:00:00,7,5,2,FMN 15 Luitenant Lippenslaan
662,Luitenant Lippenslaan 200,2023-04-18,03:00:00,7,4,3,FMN 15 Luitenant Lippenslaan
662,Luitenant Lippenslaan 200,2023-04-18,04:00:00,8,2,6,FMN 15 Luitenant Lippenslaan
662,Luitenant Lippenslaan 200,2023-04-18,05:00:00,26,4,22,FMN 15 Luitenant Lippenslaan
662,Luitenant Lippenslaan 200,2023-04-18,06:00:00,75,10,65,FMN 15 Luitenant Lippenslaan
662,Luitenant Lippenslaan 200,2023-04-18,07:00:00,250,7,243,FMN 15 Luitenant Lippenslaan
662,Luitenant Lippenslaan 200,2023-04-18,08:00:00,499,7,492,FMN 15 Luitenant Lippenslaan
662,Luitenant Lippenslaan 200,2023-04-18,09:00:00,183,5,178,FMN 15 Luitenant Lippenslaan
662,Luitenant Lippenslaan 200,2023-04-18,10:00:00,96,3,93,FMN 15 Luitenant Lippenslaan
662,Luitenant Lippenslaan 200,2023-04-18,11:00:00,80,7,73,FMN 15 Luitenant Lippenslaan
662,Luitenant Lippenslaan 200,2023-04-18,12:00:00,94,10,84,FMN 15 Luitenant Lippenslaan
662,Luitenant Lippenslaan 200,2023-04-18,13:00:00,94,3,91,FMN 15 Luitenant Lippenslaan
662,Luitenant Lippenslaan 200,2023-04-18,14:00:00,93,10,83,FMN 15 Luitenant Lippenslaan
662,Luitenant Lippenslaan 200,2023-04-18,15:00:00,110,11,99,FMN 15 Luitenant Lippenslaan
662,Luitenant Lippenslaan 200,2023-04-18,16:00:00,141,15,126,FMN 15 Luitenant Lippenslaan
662,Luitenant Lippenslaan 200,2023-04-18,17:00:00,149,15,134,FMN 15 Luitenant Lippenslaan
662,Luitenant Lippenslaan 200,2023-04-18,18:00:00,150,17,133,FMN 15 Luitenant Lippenslaan
662,Luitenant Lippenslaan 200,2023-04-18,19:00:00,108,11,97,FMN 15 Luitenant Lippenslaan
662,Luitenant Lippenslaan 200,2023-04-18,20:00:00,81,9,72,FMN 15 Luitenant Lippenslaan
662,Luitenant Lippenslaan 200,2023-04-18,21:00:00,60,7,53,FMN 15 Luitenant Lippenslaan
662,Luitenant Lippenslaan 200,2023-04-18,22:00:00,54,6,48,FMN 15 Luitenant Lippenslaan
662,Luitenant Lippenslaan 200,2023-04-18,23:00:00,32,9,23,FMN 15 Luitenant Lippenslaan
662,Luitenant Lippenslaan 200,2023-04-19,00:00:00,15,9,6,FMN 15 Luitenant Lippenslaan
662,Luitenant Lippenslaan 200,2023-04-19,01:00:00,10,5,5,FMN 15 Luitenant Lippenslaan
662,Luitenant Lippenslaan 200,2023-04-19,02:00:00,7,6,1,FMN 15 Luitenant Lippenslaan
662,Luitenant Lippenslaan 200,2023-04-19,03:00:00,6,4,2,FMN 15 Luitenant Lippenslaan
662,Luitenant Lippenslaan 200,2023-04-19,04:00:00,8,2,6,FMN 15 Luitenant Lippenslaan
662,Luitenant Lippenslaan 200,2023-04-19,05:00:00,28,5,23,FMN 15 Luitenant Lippenslaan
662,Luitenant Lippenslaan 200,2023-04-19,06:00:00,69,6,63,FMN 15 Luitenant Lippenslaan
662,Luitenant Lippenslaan 200,2023-04-19,07:00:00,239,8,231,FMN 15 Luitenant Lippenslaan
662,Luitenant Lippenslaan 200,2023-04-19,08:00:00,405,8,397,FMN 15 Luitenant Lippenslaan
662,Luitenant Lippenslaan 200,2023-04-19,09:00:00,169,7,162,FMN 15 Luitenant Lippenslaan
662,Luitenant Lippenslaan 200,2023-04-19,10:00:00,98,7,91,FMN 15 Luitenant Lippenslaan
662,Luitenant Lippenslaan 200,2023-04-19,11:00:00,102,7,95,FMN 15 Luitenant Lippenslaan
662,Luitenant Lippenslaan 200,2023-04-19,12:00:00,147,24,123,FMN 15 Luitenant Lippenslaan
662,Luitenant Lippenslaan 200,2023-04-19,13:00:00,119,9,110,FMN 15 Luitenant Lippenslaan
662,Luitenant Lippenslaan 200,2023-04-19,14:00:00,113,11,102,FMN 15 Luitenant Lippenslaan
662,Luitenant Lippenslaan 200,2023-04-19,15:00:00,110,13,97,FMN 15 Luitenant Lippenslaan
662,Luitenant Lippenslaan 200,2023-04-19,16:00:00,165,19,146,FMN 15 Luitenant Lippenslaan
662,Luitenant Lippenslaan 200,2023-04-19,17:00:00,162,17,145,FMN 15 Luitenant Lippenslaan
662,Luitenant Lippenslaan 200,2023-04-19,18:00:00,176,16,160,FMN 15 Luitenant Lippenslaan
662,Luitenant Lippenslaan 200,2023-04-19,19:00:00,121,12,109,FMN 15 Luitenant Lippenslaan
662,Luitenant Lippenslaan 200,2023-04-19,20:00:00,92,14,78,FMN 15 Luitenant Lippenslaan
662,Luitenant Lippenslaan 200,2023-04-19,21:00:00,66,7,59,FMN 15 Luitenant Lippenslaan
662,Luitenant Lippenslaan 200,2023-04-19,22:00:00,57,8,49,FMN 15 Luitenant Lippenslaan
662,Luitenant Lippenslaan 200,2023-04-19,23:00:00,32,10,22,FMN 15 Luitenant Lippenslaan
662,Luitenant Lippenslaan 200,2023-04-20,00:00:00,31,18,13,FMN 15 Luitenant Lippenslaan
662,Luitenant Lippenslaan 200,2023-04-20,01:00:00,5,3,2,FMN 15 Luitenant Lippenslaan
662,Luitenant Lippenslaan 200,2023-04-20,02:00:00,6,5,1,FMN 15 Luitenant Lippenslaan
662,Luitenant Lippenslaan 200,2023-04-20,03:00:00,2,2,0,FMN 15 Luitenant Lippenslaan
662,Luitenant Lippenslaan 200,2023-04-20,04:00:00,9,0,9,FMN 15 Luitenant Lippenslaan
662,Luitenant Lippenslaan 200,2023-04-20,05:00:00,11,4,7,FMN 15 Luitenant Lippenslaan
662,Luitenant Lippenslaan 200,2023-04-20,06:00:00,69,5,64,FMN 15 Luitenant Lippenslaan
662,Luitenant Lippenslaan 200,2023-04-20,07:00:00,219,16,203,FMN 15 Luitenant Lippenslaan
662,Luitenant Lippenslaan 200,2023-04-20,08:00:00,457,11,446,FMN 15 Luitenant Lippenslaan
662,Luitenant Lippenslaan 200,2023-04-20,09:00:00,171,6,165,FMN 15 Luitenant Lippenslaan
662,Luitenant Lippenslaan 200,2023-04-20,10:00:00,99,8,91,FMN 15 Luitenant Lippenslaan
662,Luitenant Lippenslaan 200,2023-04-20,11:00:00,66,8,58,FMN 15 Luitenant Lippenslaan
662,Luitenant Lippenslaan 200,2023-04-20,12:00:00,96,6,90,FMN 15 Luitenant Lippenslaan
662,Luitenant Lippenslaan 200,2023-04-20,13:00:00,85,4,81,FMN 15 Luitenant Lippenslaan
662,Luitenant Lippenslaan 200,2023-04-20,14:00:00,55,3,52,FMN 15 Luitenant Lippenslaan
662,Luitenant Lippenslaan 200,2023-04-20,15:00:00,93,12,81,FMN 15 Luitenant Lippenslaan
662,Luitenant Lippenslaan 200,2023-04-20,16:00:00,132,19,113,FMN 15 Luitenant Lippenslaan
662,Luitenant Lippenslaan 200,2023-04-20,17:00:00,146,16,130,FMN 15 Luitenant Lippenslaan
662,Luitenant Lippenslaan 200,2023-04-20,18:00:00,173,22,151,FMN 15 Luitenant Lippenslaan
662,Luitenant Lippenslaan 200,2023-04-20,19:00:00,112,7,105,FMN 15 Luitenant Lippenslaan
662,Luitenant Lippenslaan 200,2023-04-20,20:00:00,101,9,92,FMN 15 Luitenant Lippenslaan
662,Luitenant Lippenslaan 200,2023-04-20,21:00:00,40,7,33,FMN 15 Luitenant Lippenslaan
662,Luitenant Lippenslaan 200,2023-04-20,22:00:00,49,6,43,FMN 15 Luitenant Lippenslaan
662,Luitenant Lippenslaan 200,2023-04-20,23:00:00,36,14,22,FMN 15 Luitenant Lippenslaan
662,Luitenant Lippenslaan 200,2023-04-21,00:00:00,17,6,11,FMN 15 Luitenant Lippenslaan
662,Luitenant Lippenslaan 200,2023-04-21,01:00:00,9,4,5,FMN 15 Luitenant Lippenslaan
662,Luitenant Lippenslaan 200,2023-04-21,02:00:00,7,5,2,FMN 15 Luitenant Lippenslaan
662,Luitenant Lippenslaan 200,2023-04-21,03:00:00,5,2,3,FMN 15 Luitenant Lippenslaan
662,Luitenant Lippenslaan 200,2023-04-21,04:00:00,6,0,6,FMN 15 Luitenant Lippenslaan
662,Luitenant Lippenslaan 200,2023-04-21,05:00:00,10,0,10,FMN 15 Luitenant Lippenslaan
662,Luitenant Lippenslaan 200,2023-04-21,06:00:00,54,5,49,FMN 15 Luitenant Lippenslaan
662,Luitenant Lippenslaan 200,2023-04-21,07:00:00,181,4,177,FMN 15 Luitenant Lippenslaan
662,Luitenant Lippenslaan 200,2023-04-21,08:00:00,376,17,359,FMN 15 Luitenant Lippenslaan
662,Luitenant Lippenslaan 200,2023-04-21,09:00:00,165,10,155,FMN 15 Luitenant Lippenslaan
662,Luitenant Lippenslaan 200,2023-04-21,10:00:00,101,5,96,FMN 15 Luitenant Lippenslaan
662,Luitenant Lippenslaan 200,2023-04-21,11:00:00,104,7,97,FMN 15 Luitenant Lippenslaan
662,Luitenant Lippenslaan 200,2023-04-21,12:00:00,108,11,97,FMN 15 Luitenant Lippenslaan
662,Luitenant Lippenslaan 200,2023-04-21,13:00:00,116,14,102,FMN 15 Luitenant Lippenslaan
662,Luitenant Lippenslaan 200,2023-04-21,14:00:00,110,16,94,FMN 15 Luitenant Lippenslaan
662,Luitenant Lippenslaan 200,2023-04-21,15:00:00,118,16,102,FMN 15 Luitenant Lippenslaan
662,Luitenant Lippenslaan 200,2023-04-21,16:00:00,140,6,134,FMN 15 Luitenant Lippenslaan
662,Luitenant Lippenslaan 200,2023-04-21,17:00:00,145,18,127,FMN 15 Luitenant Lippenslaan
662,Luitenant Lippenslaan 200,2023-04-21,18:00:00,140,15,125,FMN 15 Luitenant Lippenslaan
662,Luitenant Lippenslaan 200,2023-04-21,19:00:00,130,20,110,FMN 15 Luitenant Lippenslaan
662,Luitenant Lippenslaan 200,2023-04-21,20:00:00,89,8,81,FMN 15 Luitenant Lippenslaan
662,Luitenant Lippenslaan 200,2023-04-21,21:00:00,48,5,43,FMN 15 Luitenant Lippenslaan
662,Luitenant Lippenslaan 200,2023-04-21,22:00:00,50,5,45,FMN 15 Luitenant Lippenslaan
662,Luitenant Lippenslaan 200,2023-04-21,23:00:00,42,11,31,FMN 15 Luitenant Lippenslaan
662,Luitenant Lippenslaan 200,2023-04-22,00:00:00,16,2,14,FMN 15 Luitenant Lippenslaan
662,Luitenant Lippenslaan 200,2023-04-22,01:00:00,25,6,19,FMN 15 Luitenant Lippenslaan
662,Luitenant Lippenslaan 200,2023-04-22,02:00:00,9,2,7,FMN 15 Luitenant Lippenslaan
662,Luitenant Lippenslaan 200,2023-04-22,03:00:00,6,3,3,FMN 15 Luitenant Lippenslaan
662,Luitenant Lippenslaan 200,2023-04-22,04:00:00,14,4,10,FMN 15 Luitenant Lippenslaan
662,Luitenant Lippenslaan 200,2023-04-22,05:00:00,11,1,10,FMN 15 Luitenant Lippenslaan
662,Luitenant Lippenslaan 200,2023-04-22,06:00:00,14,2,12,FMN 15 Luitenant Lippenslaan
662,Luitenant Lippenslaan 200,2023-04-22,07:00:00,20,2,18,FMN 15 Luitenant Lippenslaan
662,Luitenant Lippenslaan 200,2023-04-22,08:00:00,68,6,62,FMN 15 Luitenant Lippenslaan
662,Luitenant Lippenslaan 200,2023-04-22,09:00:00,139,4,135,FMN 15 Luitenant Lippenslaan
662,Luitenant Lippenslaan 200,2023-04-22,10:00:00,108,3,105,FMN 15 Luitenant Lippenslaan
662,Luitenant Lippenslaan 200,2023-04-22,11:00:00,91,6,85,FMN 15 Luitenant Lippenslaan
662,Luitenant Lippenslaan 200,2023-04-22,12:00:00,76,10,66,FMN 15 Luitenant Lippenslaan
662,Luitenant Lippenslaan 200,2023-04-22,13:00:00,68,4,64,FMN 15 Luitenant Lippenslaan
662,Luitenant Lippenslaan 200,2023-04-22,14:00:00,94,6,88,FMN 15 Luitenant Lippenslaan
662,Luitenant Lippenslaan 200,2023-04-22,15:00:00,59,3,56,FMN 15 Luitenant Lippenslaan
662,Luitenant Lippenslaan 200,2023-04-22,16:00:00,60,4,56,FMN 15 Luitenant Lippenslaan
662,Luitenant Lippenslaan 200,2023-04-22,17:00:00,77,8,69,FMN 15 Luitenant Lippenslaan
662,Luitenant Lippenslaan 200,2023-04-22,18:00:00,81,11,70,FMN 15 Luitenant Lippenslaan
662,Luitenant Lippenslaan 200,2023-04-22,19:00:00,91,11,80,FMN 15 Luitenant Lippenslaan
662,Luitenant Lippenslaan 200,2023-04-22,20:00:00,58,3,55,FMN 15 Luitenant Lippenslaan
662,Luitenant Lippenslaan 200,2023-04-22,21:00:00,48,8,40,FMN 15 Luitenant Lippenslaan
662,Luitenant Lippenslaan 200,2023-04-22,22:00:00,35,6,29,FMN 15 Luitenant Lippenslaan
662,Luitenant Lippenslaan 200,2023-04-22,23:00:00,34,12,22,FMN 15 Luitenant Lippenslaan
662,Luitenant Lippenslaan 200,2023-04-23,00:00:00,11,2,9,FMN 15 Luitenant Lippenslaan
662,Luitenant Lippenslaan 200,2023-04-23,01:00:00,12,3,9,FMN 15 Luitenant Lippenslaan
662,Luitenant Lippenslaan 200,2023-04-23,02:00:00,11,4,7,FMN 15 Luitenant Lippenslaan
662,Luitenant Lippenslaan 200,2023-04-23,03:00:00,5,2,3,FMN 15 Luitenant Lippenslaan
662,Luitenant Lippenslaan 200,2023-04-23,04:00:00,7,2,5,FMN 15 Luitenant Lippenslaan
662,Luitenant Lippenslaan 200,2023-04-23,05:00:00,9,3,6,FMN 15 Luitenant Lippenslaan
662,Luitenant Lippenslaan 200,2023-04-23,06:00:00,17,5,12,FMN 15 Luitenant Lippenslaan
662,Luitenant Lippenslaan 200,2023-04-23,07:00:00,35,1,34,FMN 15 Luitenant Lippenslaan
662,Luitenant Lippenslaan 200,2023-04-23,08:00:00,40,3,37,FMN 15 Luitenant Lippenslaan
662,Luitenant Lippenslaan 200,2023-04-23,09:00:00,105,1,104,FMN 15 Luitenant Lippenslaan
662,Luitenant Lippenslaan 200,2023-04-23,10:00:00,110,4,106,FMN 15 Luitenant Lippenslaan
662,Luitenant Lippenslaan 200,2023-04-23,11:00:00,127,8,119,FMN 15 Luitenant Lippenslaan
662,Luitenant Lippenslaan 200,2023-04-23,12:00:00,177,10,167,FMN 15 Luitenant Lippenslaan
662,Luitenant Lippenslaan 200,2023-04-23,13:00:00,165,16,149,FMN 15 Luitenant Lippenslaan
662,Luitenant Lippenslaan 200,2023-04-23,14:00:00,91,3,88,FMN 15 Luitenant Lippenslaan
662,Luitenant Lippenslaan 200,2023-04-23,15:00:00,77,7,70,FMN 15 Luitenant Lippenslaan
662,Luitenant Lippenslaan 200,2023-04-23,16:00:00,54,10,44,FMN 15 Luitenant Lippenslaan
662,Luitenant Lippenslaan 200,2023-04-23,17:00:00,72,8,64,FMN 15 Luitenant Lippenslaan
662,Luitenant Lippenslaan 200,2023-04-23,18:00:00,71,9,62,FMN 15 Luitenant Lippenslaan
662,Luitenant Lippenslaan 200,2023-04-23,19:00:00,53,9,44,FMN 15 Luitenant Lippenslaan
662,Luitenant Lippenslaan 200,2023-04-23,20:00:00,32,6,26,FMN 15 Luitenant Lippenslaan
662,Luitenant Lippenslaan 200,2023-04-23,21:00:00,28,2,26,FMN 15 Luitenant Lippenslaan
662,Luitenant Lippenslaan 200,2023-04-23,22:00:00,28,9,19,FMN 15 Luitenant Lippenslaan
662,Luitenant Lippenslaan 200,2023-04-23,23:00:00,15,1,14,FMN 15 Luitenant Lippenslaan
662,Luitenant Lippenslaan 200,2023-04-24,00:00:00,6,3,3,FMN 15 Luitenant Lippenslaan
662,Luitenant Lippenslaan 200,2023-04-24,01:00:00,6,2,4,FMN 15 Luitenant Lippenslaan
662,Luitenant Lippenslaan 200,2023-04-24,02:00:00,5,3,2,FMN 15 Luitenant Lippenslaan
662,Luitenant Lippenslaan 200,2023-04-24,03:00:00,4,1,3,FMN 15 Luitenant Lippenslaan
662,Luitenant Lippenslaan 200,2023-04-24,04:00:00,6,0,6,FMN 15 Luitenant Lippenslaan
662,Luitenant Lippenslaan 200,2023-04-24,05:00:00,12,2,10,FMN 15 Luitenant Lippenslaan
662,Luitenant Lippenslaan 200,2023-04-24,06:00:00,45,5,40,FMN 15 Luitenant Lippenslaan
662,Luitenant Lippenslaan 200,2023-04-24,07:00:00,144,6,138,FMN 15 Luitenant Lippenslaan
662,Luitenant Lippenslaan 200,2023-04-24,08:00:00,354,14,340,FMN 15 Luitenant Lippenslaan
662,Luitenant Lippenslaan 200,2023-04-24,09:00:00,135,4,131,FMN 15 Luitenant Lippenslaan
662,Luitenant Lippenslaan 200,2023-04-24,10:00:00,70,4,66,FMN 15 Luitenant Lippenslaan
662,Luitenant Lippenslaan 200,2023-04-24,11:00:00,61,5,56,FMN 15 Luitenant Lippenslaan
662,Luitenant Lippenslaan 200,2023-04-24,12:00:00,85,11,74,FMN 15 Luitenant Lippenslaan
662,Luitenant Lippenslaan 200,2023-04-24,13:00:00,69,8,61,FMN 15 Luitenant Lippenslaan
662,Luitenant Lippenslaan 200,2023-04-24,14:00:00,70,6,64,FMN 15 Luitenant Lippenslaan
662,Luitenant Lippenslaan 200,2023-04-24,15:00:00,80,10,70,FMN 15 Luitenant Lippenslaan
662,Luitenant Lippenslaan 200,2023-04-24,16:00:00,137,13,124,FMN 15 Luitenant Lippenslaan
662,Luitenant Lippenslaan 200,2023-04-24,17:00:00,163,9,154,FMN 15 Luitenant Lippenslaan
662,Luitenant Lippenslaan 200,2023-04-24,18:00:00,127,13,114,FMN 15 Luitenant Lippenslaan
662,Luitenant Lippenslaan 200,2023-04-24,19:00:00,89,13,76,FMN 15 Luitenant Lippenslaan
662,Luitenant Lippenslaan 200,2023-04-24,20:00:00,63,7,56,FMN 15 Luitenant Lippenslaan
662,Luitenant Lippenslaan 200,2023-04-24,21:00:00,34,6,28,FMN 15 Luitenant Lippenslaan
662,Luitenant Lippenslaan 200,2023-04-24,22:00:00,62,12,50,FMN 15 Luitenant Lippenslaan
662,Luitenant Lippenslaan 200,2023-04-24,23:00:00,16,3,13,FMN 15 Luitenant Lippenslaan
662,Luitenant Lippenslaan 200,2023-04-25,00:00:00,5,2,3,FMN 15 Luitenant Lippenslaan
662,Luitenant Lippenslaan 200,2023-04-25,01:00:00,8,2,6,FMN 15 Luitenant Lippenslaan
662,Luitenant Lippenslaan 200,2023-04-25,02:00:00,5,2,3,FMN 15 Luitenant Lippenslaan
662,Luitenant Lippenslaan 200,2023-04-25,03:00:00,3,1,2,FMN 15 Luitenant Lippenslaan
662,Luitenant Lippenslaan 200,2023-04-25,04:00:00,9,2,7,FMN 15 Luitenant Lippenslaan
662,Luitenant Lippenslaan 200,2023-04-25,05:00:00,13,0,13,FMN 15 Luitenant Lippenslaan
662,Luitenant Lippenslaan 200,2023-04-25,06:00:00,88,7,81,FMN 15 Luitenant Lippenslaan
662,Luitenant Lippenslaan 200,2023-04-25,07:00:00,233,9,224,FMN 15 Luitenant Lippenslaan
662,Luitenant Lippenslaan 200,2023-04-25,08:00:00,538,11,527,FMN 15 Luitenant Lippenslaan
662,Luitenant Lippenslaan 200,2023-04-25,09:00:00,169,7,162,FMN 15 Luitenant Lippenslaan
662,Luitenant Lippenslaan 200,2023-04-25,10:00:00,94,8,86,FMN 15 Luitenant Lippenslaan
662,Luitenant Lippenslaan 200,2023-04-25,11:00:00,80,10,70,FMN 15 Luitenant Lippenslaan
662,Luitenant Lippenslaan 200,2023-04-25,12:00:00,94,10,84,FMN 15 Luitenant Lippenslaan
662,Luitenant Lippenslaan 200,2023-04-25,13:00:00,106,8,98,FMN 15 Luitenant Lippenslaan
662,Luitenant Lippenslaan 200,2023-04-25,14:00:00,74,10,64,FMN 15 Luitenant Lippenslaan
662,Luitenant Lippenslaan 200,2023-04-25,15:00:00,120,20,100,FMN 15 Luitenant Lippenslaan
662,Luitenant Lippenslaan 200,2023-04-25,16:00:00,161,29,132,FMN 15 Luitenant Lippenslaan
662,Luitenant Lippenslaan 200,2023-04-25,17:00:00,143,10,133,FMN 15 Luitenant Lippenslaan
662,Luitenant Lippenslaan 200,2023-04-25,18:00:00,150,18,132,FMN 15 Luitenant Lippenslaan
662,Luitenant Lippenslaan 200,2023-04-25,19:00:00,109,13,96,FMN 15 Luitenant Lippenslaan
662,Luitenant Lippenslaan 200,2023-04-25,20:00:00,78,10,68,FMN 15 Luitenant Lippenslaan
662,Luitenant Lippenslaan 200,2023-04-25,21:00:00,64,15,49,FMN 15 Luitenant Lippenslaan
662,Luitenant Lippenslaan 200,2023-04-25,22:00:00,32,8,24,FMN 15 Luitenant Lippenslaan
662,Luitenant Lippenslaan 200,2023-04-25,23:00:00,26,5,21,FMN 15 Luitenant Lippenslaan
662,Luitenant Lippenslaan 200,2023-04-26,00:00:00,4,0,4,FMN 15 Luitenant Lippenslaan
662,Luitenant Lippenslaan 200,2023-04-26,01:00:00,3,0,3,FMN 15 Luitenant Lippenslaan
662,Luitenant Lippenslaan 200,2023-04-26,02:00:00,7,4,3,FMN 15 Luitenant Lippenslaan
662,Luitenant Lippenslaan 200,2023-04-26,03:00:00,2,1,1,FMN 15 Luitenant Lippenslaan
662,Luitenant Lippenslaan 200,2023-04-26,04:00:00,9,3,6,FMN 15 Luitenant Lippenslaan
662,Luitenant Lippenslaan 200,2023-04-26,05:00:00,22,4,18,FMN 15 Luitenant Lippenslaan
662,Luitenant Lippenslaan 200,2023-04-26,06:00:00,69,7,62,FMN 15 Luitenant Lippenslaan
662,Luitenant Lippenslaan 200,2023-04-26,07:00:00,203,7,196,FMN 15 Luitenant Lippenslaan
662,Luitenant Lippenslaan 200,2023-04-26,08:00:00,409,11,398,FMN 15 Luitenant Lippenslaan
662,Luitenant Lippenslaan 200,2023-04-26,09:00:00,167,7,160,FMN 15 Luitenant Lippenslaan
662,Luitenant Lippenslaan 200,2023-04-26,10:00:00,129,6,123,FMN 15 Luitenant Lippenslaan
662,Luitenant Lippenslaan 200,2023-04-26,11:00:00,91,7,84,FMN 15 Luitenant Lippenslaan
662,Luitenant Lippenslaan 200,2023-04-26,12:00:00,142,20,122,FMN 15 Luitenant Lippenslaan
662,Luitenant Lippenslaan 200,2023-04-26,13:00:00,119,8,111,FMN 15 Luitenant Lippenslaan
662,Luitenant Lippenslaan 200,2023-04-26,14:00:00,90,11,79,FMN 15 Luitenant Lippenslaan
662,Luitenant Lippenslaan 200,2023-04-26,15:00:00,141,13,128,FMN 15 Luitenant Lippenslaan
662,Luitenant Lippenslaan 200,2023-04-26,16:00:00,122,14,108,FMN 15 Luitenant Lippenslaan
662,Luitenant Lippenslaan 200,2023-04-26,17:00:00,190,11,179,FMN 15 Luitenant Lippenslaan
662,Luitenant Lippenslaan 200,2023-04-26,18:00:00,140,16,124,FMN 15 Luitenant Lippenslaan
662,Luitenant Lippenslaan 200,2023-04-26,19:00:00,114,14,100,FMN 15 Luitenant Lippenslaan
662,Luitenant Lippenslaan 200,2023-04-26,20:00:00,73,6,67,FMN 15 Luitenant Lippenslaan
662,Luitenant Lippenslaan 200,2023-04-26,21:00:00,57,15,42,FMN 15 Luitenant Lippenslaan
662,Luitenant Lippenslaan 200,2023-04-26,22:00:00,43,9,34,FMN 15 Luitenant Lippenslaan
662,Luitenant Lippenslaan 200,2023-04-26,23:00:00,23,5,18,FMN 15 Luitenant Lippenslaan
662,Luitenant Lippenslaan 200,2023-04-27,00:00:00,13,4,9,FMN 15 Luitenant Lippenslaan
662,Luitenant Lippenslaan 200,2023-04-27,01:00:00,3,2,1,FMN 15 Luitenant Lippenslaan
662,Luitenant Lippenslaan 200,2023-04-27,02:00:00,5,3,2,FMN 15 Luitenant Lippenslaan
662,Luitenant Lippenslaan 200,2023-04-27,03:00:00,2,2,0,FMN 15 Luitenant Lippenslaan
662,Luitenant Lippenslaan 200,2023-04-27,04:00:00,13,3,10,FMN 15 Luitenant Lippenslaan
662,Luitenant Lippenslaan 200,2023-04-27,05:00:00,20,4,16,FMN 15 Luitenant Lippenslaan
662,Luitenant Lippenslaan 200,2023-04-27,06:00:00,66,6,60,FMN 15 Luitenant Lippenslaan
662,Luitenant Lippenslaan 200,2023-04-27,07:00:00,246,10,236,FMN 15 Luitenant Lippenslaan
662,Luitenant Lippenslaan 200,2023-04-27,08:00:00,454,32,422,FMN 15 Luitenant Lippenslaan
662,Luitenant Lippenslaan 200,2023-04-27,09:00:00,162,13,149,FMN 15 Luitenant Lippenslaan
662,Luitenant Lippenslaan 200,2023-04-27,10:00:00,90,6,84,FMN 15 Luitenant Lippenslaan
662,Luitenant Lippenslaan 200,2023-04-27,11:00:00,72,4,68,FMN 15 Luitenant Lippenslaan
662,Luitenant Lippenslaan 200,2023-04-27,12:00:00,135,7,128,FMN 15 Luitenant Lippenslaan
662,Luitenant Lippenslaan 200,2023-04-27,13:00:00,105,9,96,FMN 15 Luitenant Lippenslaan
662,Luitenant Lippenslaan 200,2023-04-27,14:00:00,94,6,88,FMN 15 Luitenant Lippenslaan
662,Luitenant Lippenslaan 200,2023-04-27,15:00:00,120,16,104,FMN 15 Luitenant Lippenslaan
662,Luitenant Lippenslaan 200,2023-04-27,16:00:00,164,24,140,FMN 15 Luitenant Lippenslaan
662,Luitenant Lippenslaan 200,2023-04-27,17:00:00,159,13,146,FMN 15 Luitenant Lippenslaan
662,Luitenant Lippenslaan 200,2023-04-27,18:00:00,157,18,139,FMN 15 Luitenant Lippenslaan
662,Luitenant Lippenslaan 200,2023-04-27,19:00:00,127,3,124,FMN 15 Luitenant Lippenslaan
662,Luitenant Lippenslaan 200,2023-04-27,20:00:00,88,15,73,FMN 15 Luitenant Lippenslaan
662,Luitenant Lippenslaan 200,2023-04-27,21:00:00,57,8,49,FMN 15 Luitenant Lippenslaan
662,Luitenant Lippenslaan 200,2023-04-27,22:00:00,46,6,40,FMN 15 Luitenant Lippenslaan
662,Luitenant Lippenslaan 200,2023-04-27,23:00:00,17,5,12,FMN 15 Luitenant Lippenslaan
662,Luitenant Lippenslaan 200,2023-04-28,00:00:00,8,5,3,FMN 15 Luitenant Lippenslaan
662,Luitenant Lippenslaan 200,2023-04-28,01:00:00,6,4,2,FMN 15 Luitenant Lippenslaan
662,Luitenant Lippenslaan 200,2023-04-28,02:00:00,5,3,2,FMN 15 Luitenant Lippenslaan
662,Luitenant Lippenslaan 200,2023-04-28,03:00:00,1,1,0,FMN 15 Luitenant Lippenslaan
662,Luitenant Lippenslaan 200,2023-04-28,04:00:00,12,3,9,FMN 15 Luitenant Lippenslaan
662,Luitenant Lippenslaan 200,2023-04-28,05:00:00,17,4,13,FMN 15 Luitenant Lippenslaan
662,Luitenant Lippenslaan 200,2023-04-28,06:00:00,65,7,58,FMN 15 Luitenant Lippenslaan
662,Luitenant Lippenslaan 200,2023-04-28,07:00:00,165,7,158,FMN 15 Luitenant Lippenslaan
662,Luitenant Lippenslaan 200,2023-04-28,08:00:00,363,21,342,FMN 15 Luitenant Lippenslaan
662,Luitenant Lippenslaan 200,2023-04-28,09:00:00,157,12,145,FMN 15 Luitenant Lippenslaan
662,Luitenant Lippenslaan 200,2023-04-28,10:00:00,85,11,74,FMN 15 Luitenant Lippenslaan
662,Luitenant Lippenslaan 200,2023-04-28,11:00:00,88,10,78,FMN 15 Luitenant Lippenslaan
662,Luitenant Lippenslaan 200,2023-04-28,12:00:00,136,18,118,FMN 15 Luitenant Lippenslaan
662,Luitenant Lippenslaan 200,2023-04-28,13:00:00,86,9,77,FMN 15 Luitenant Lippenslaan
662,Luitenant Lippenslaan 200,2023-04-28,14:00:00,88,18,70,FMN 15 Luitenant Lippenslaan
662,Luitenant Lippenslaan 200,2023-04-28,15:00:00,117,21,96,FMN 15 Luitenant Lippenslaan
662,Luitenant Lippenslaan 200,2023-04-28,16:00:00,121,23,98,FMN 15 Luitenant Lippenslaan
662,Luitenant Lippenslaan 200,2023-04-28,17:00:00,145,16,129,FMN 15 Luitenant Lippenslaan
662,Luitenant Lippenslaan 200,2023-04-28,18:00:00,151,22,129,FMN 15 Luitenant Lippenslaan
662,Luitenant Lippenslaan 200,2023-04-28,19:00:00,99,16,83,FMN 15 Luitenant Lippenslaan
662,Luitenant Lippenslaan 200,2023-04-28,20:00:00,59,12,47,FMN 15 Luitenant Lippenslaan
662,Luitenant Lippenslaan 200,2023-04-28,21:00:00,55,7,48,FMN 15 Luitenant Lippenslaan
662,Luitenant Lippenslaan 200,2023-04-28,22:00:00,45,10,35,FMN 15 Luitenant Lippenslaan
662,Luitenant Lippenslaan 200,2023-04-28,23:00:00,44,15,29,FMN 15 Luitenant Lippenslaan
662,Luitenant Lippenslaan 200,2023-04-29,00:00:00,23,7,16,FMN 15 Luitenant Lippenslaan
662,Luitenant Lippenslaan 200,2023-04-29,01:00:00,14,2,12,FMN 15 Luitenant Lippenslaan
662,Luitenant Lippenslaan 200,2023-04-29,02:00:00,11,4,7,FMN 15 Luitenant Lippenslaan
662,Luitenant Lippenslaan 200,2023-04-29,03:00:00,4,1,3,FMN 15 Luitenant Lippenslaan
662,Luitenant Lippenslaan 200,2023-04-29,04:00:00,6,0,6,FMN 15 Luitenant Lippenslaan
662,Luitenant Lippenslaan 200,2023-04-29,05:00:00,13,1,12,FMN 15 Luitenant Lippenslaan
662,Luitenant Lippenslaan 200,2023-04-29,06:00:00,21,6,15,FMN 15 Luitenant Lippenslaan
662,Luitenant Lippenslaan 200,2023-04-29,07:00:00,28,4,24,FMN 15 Luitenant Lippenslaan
662,Luitenant Lippenslaan 200,2023-04-29,08:00:00,52,6,46,FMN 15 Luitenant Lippenslaan
662,Luitenant Lippenslaan 200,2023-04-29,09:00:00,102,10,92,FMN 15 Luitenant Lippenslaan
662,Luitenant Lippenslaan 200,2023-04-29,10:00:00,88,11,77,FMN 15 Luitenant Lippenslaan
662,Luitenant Lippenslaan 200,2023-04-29,11:00:00,96,6,90,FMN 15 Luitenant Lippenslaan
662,Luitenant Lippenslaan 200,2023-04-29,12:00:00,97,13,84,FMN 15 Luitenant Lippenslaan
662,Luitenant Lippenslaan 200,2023-04-29,13:00:00,90,14,76,FMN 15 Luitenant Lippenslaan
662,Luitenant Lippenslaan 200,2023-04-29,14:00:00,121,12,109,FMN 15 Luitenant Lippenslaan
662,Luitenant Lippenslaan 200,2023-04-29,15:00:00,96,12,84,FMN 15 Luitenant Lippenslaan
662,Luitenant Lippenslaan 200,2023-04-29,16:00:00,81,9,72,FMN 15 Luitenant Lippenslaan
662,Luitenant Lippenslaan 200,2023-04-29,17:00:00,121,21,100,FMN 15 Luitenant Lippenslaan
662,Luitenant Lippenslaan 200,2023-04-29,18:00:00,112,31,81,FMN 15 Luitenant Lippenslaan
662,Luitenant Lippenslaan 200,2023-04-29,19:00:00,89,17,72,FMN 15 Luitenant Lippenslaan
662,Luitenant Lippenslaan 200,2023-04-29,20:00:00,76,16,60,FMN 15 Luitenant Lippenslaan
662,Luitenant Lippenslaan 200,2023-04-29,21:00:00,49,16,33,FMN 15 Luitenant Lippenslaan
662,Luitenant Lippenslaan 200,2023-04-29,22:00:00,34,5,29,FMN 15 Luitenant Lippenslaan
662,Luitenant Lippenslaan 200,2023-04-29,23:00:00,45,9,36,FMN 15 Luitenant Lippenslaan
662,Luitenant Lippenslaan 200,2023-04-30,00:00:00,31,8,23,FMN 15 Luitenant Lippenslaan
662,Luitenant Lippenslaan 200,2023-04-30,01:00:00,22,6,16,FMN 15 Luitenant Lippenslaan
662,Luitenant Lippenslaan 200,2023-04-30,02:00:00,9,2,7,FMN 15 Luitenant Lippenslaan
662,Luitenant Lippenslaan 200,2023-04-30,03:00:00,3,2,1,FMN 15 Luitenant Lippenslaan
662,Luitenant Lippenslaan 200,2023-04-30,04:00:00,7,2,5,FMN 15 Luitenant Lippenslaan
662,Luitenant Lippenslaan 200,2023-04-30,05:00:00,7,2,5,FMN 15 Luitenant Lippenslaan
662,Luitenant Lippenslaan 200,2023-04-30,06:00:00,25,2,23,FMN 15 Luitenant Lippenslaan
662,Luitenant Lippenslaan 200,2023-04-30,07:00:00,18,2,16,FMN 15 Luitenant Lippenslaan
662,Luitenant Lippenslaan 200,2023-04-30,08:00:00,43,3,40,FMN 15 Luitenant Lippenslaan
662,Luitenant Lippenslaan 200,2023-04-30,09:00:00,94,4,90,FMN 15 Luitenant Lippenslaan
662,Luitenant Lippenslaan 200,2023-04-30,10:00:00,80,7,73,FMN 15 Luitenant Lippenslaan
662,Luitenant Lippenslaan 200,2023-04-30,11:00:00,76,8,68,FMN 15 Luitenant Lippenslaan
662,Luitenant Lippenslaan 200,2023-04-30,12:00:00,99,17,82,FMN 15 Luitenant Lippenslaan
662,Luitenant Lippenslaan 200,2023-04-30,13:00:00,112,15,97,FMN 15 Luitenant Lippenslaan
662,Luitenant Lippenslaan 200,2023-04-30,14:00:00,124,22,102,FMN 15 Luitenant Lippenslaan
662,Luitenant Lippenslaan 200,2023-04-30,15:00:00,97,15,82,FMN 15 Luitenant Lippenslaan
662,Luitenant Lippenslaan 200,2023-04-30,16:00:00,101,11,90,FMN 15 Luitenant Lippenslaan
662,Luitenant Lippenslaan 200,2023-04-30,17:00:00,129,9,120,FMN 15 Luitenant Lippenslaan
662,Luitenant Lippenslaan 200,2023-04-30,18:00:00,106,14,92,FMN 15 Luitenant Lippenslaan
662,Luitenant Lippenslaan 200,2023-04-30,19:00:00,105,15,90,FMN 15 Luitenant Lippenslaan
662,Luitenant Lippenslaan 200,2023-04-30,20:00:00,62,12,50,FMN 15 Luitenant Lippenslaan
662,Luitenant Lippenslaan 200,2023-04-30,21:00:00,45,9,36,FMN 15 Luitenant Lippenslaan
662,Luitenant Lippenslaan 200,2023-04-30,22:00:00,39,8,31,FMN 15 Luitenant Lippenslaan
662,Luitenant Lippenslaan 200,2023-04-30,23:00:00,27,8,19,FMN 15 Luitenant Lippenslaan
662,Luitenant Lippenslaan 200,2023-05-01,00:00:00,22,9,13,FMN 15 Luitenant Lippenslaan
662,Luitenant Lippenslaan 200,2023-05-01,01:00:00,9,5,4,FMN 15 Luitenant Lippenslaan
662,Luitenant Lippenslaan 200,2023-05-01,02:00:00,5,2,3,FMN 15 Luitenant Lippenslaan
662,Luitenant Lippenslaan 200,2023-05-01,03:00:00,6,3,3,FMN 15 Luitenant Lippenslaan
662,Luitenant Lippenslaan 200,2023-05-01,04:00:00,11,2,9,FMN 15 Luitenant Lippenslaan
662,Luitenant Lippenslaan 200,2023-05-01,05:00:00,9,2,7,FMN 15 Luitenant Lippenslaan
662,Luitenant Lippenslaan 200,2023-05-01,06:00:00,21,6,15,FMN 15 Luitenant Lippenslaan
662,Luitenant Lippenslaan 200,2023-05-01,07:00:00,19,4,15,FMN 15 Luitenant Lippenslaan
662,Luitenant Lippenslaan 200,2023-05-01,08:00:00,20,2,18,FMN 15 Luitenant Lippenslaan
662,Luitenant Lippenslaan 200,2023-05-01,09:00:00,65,6,59,FMN 15 Luitenant Lippenslaan
662,Luitenant Lippenslaan 200,2023-05-01,10:00:00,81,4,77,FMN 15 Luitenant Lippenslaan
662,Luitenant Lippenslaan 200,2023-05-01,11:00:00,72,15,57,FMN 15 Luitenant Lippenslaan
662,Luitenant Lippenslaan 200,2023-05-01,12:00:00,73,7,66,FMN 15 Luitenant Lippenslaan
662,Luitenant Lippenslaan 200,2023-05-01,13:00:00,87,20,67,FMN 15 Luitenant Lippenslaan
662,Luitenant Lippenslaan 200,2023-05-01,14:00:00,81,9,72,FMN 15 Luitenant Lippenslaan
662,Luitenant Lippenslaan 200,2023-05-01,15:00:00,69,8,61,FMN 15 Luitenant Lippenslaan
662,Luitenant Lippenslaan 200,2023-05-01,16:00:00,79,17,62,FMN 15 Luitenant Lippenslaan
662,Luitenant Lippenslaan 200,2023-05-01,17:00:00,105,12,93,FMN 15 Luitenant Lippenslaan
662,Luitenant Lippenslaan 200,2023-05-01,18:00:00,106,18,88,FMN 15 Luitenant Lippenslaan
662,Luitenant Lippenslaan 200,2023-05-01,19:00:00,75,21,54,FMN 15 Luitenant Lippenslaan
662,Luitenant Lippenslaan 200,2023-05-01,20:00:00,59,13,46,FMN 15 Luitenant Lippenslaan
662,Luitenant Lippenslaan 200,2023-05-01,21:00:00,56,20,36,FMN 15 Luitenant Lippenslaan
662,Luitenant Lippenslaan 200,2023-05-01,22:00:00,48,18,30,FMN 15 Luitenant Lippenslaan
662,Luitenant Lippenslaan 200,2023-05-01,23:00:00,22,4,18,FMN 15 Luitenant Lippenslaan
662,Luitenant Lippenslaan 200,2023-05-02,00:00:00,10,3,7,FMN 15 Luitenant Lippenslaan
662,Luitenant Lippenslaan 200,2023-05-02,01:00:00,4,1,3,FMN 15 Luitenant Lippenslaan
662,Luitenant Lippenslaan 200,2023-05-02,02:00:00,5,4,1,FMN 15 Luitenant Lippenslaan
662,Luitenant Lippenslaan 200,2023-05-02,03:00:00,4,3,1,FMN 15 Luitenant Lippenslaan
662,Luitenant Lippenslaan 200,2023-05-02,04:00:00,8,0,8,FMN 15 Luitenant Lippenslaan
662,Luitenant Lippenslaan 200,2023-05-02,05:00:00,18,5,13,FMN 15 Luitenant Lippenslaan
662,Luitenant Lippenslaan 200,2023-05-02,06:00:00,81,20,61,FMN 15 Luitenant Lippenslaan
662,Luitenant Lippenslaan 200,2023-05-02,07:00:00,196,12,184,FMN 15 Luitenant Lippenslaan
662,Luitenant Lippenslaan 200,2023-05-02,08:00:00,474,29,445,FMN 15 Luitenant Lippenslaan
662,Luitenant Lippenslaan 200,2023-05-02,09:00:00,164,14,150,FMN 15 Luitenant Lippenslaan
662,Luitenant Lippenslaan 200,2023-05-02,10:00:00,85,5,80,FMN 15 Luitenant Lippenslaan
662,Luitenant Lippenslaan 200,2023-05-02,11:00:00,88,10,78,FMN 15 Luitenant Lippenslaan
662,Luitenant Lippenslaan 200,2023-05-02,12:00:00,100,16,84,FMN 15 Luitenant Lippenslaan
662,Luitenant Lippenslaan 200,2023-05-02,13:00:00,109,17,92,FMN 15 Luitenant Lippenslaan
662,Luitenant Lippenslaan 200,2023-05-02,14:00:00,68,10,58,FMN 15 Luitenant Lippenslaan
662,Luitenant Lippenslaan 200,2023-05-02,15:00:00,112,18,94,FMN 15 Luitenant Lippenslaan
662,Luitenant Lippenslaan 200,2023-05-02,16:00:00,154,28,126,FMN 15 Luitenant Lippenslaan
662,Luitenant Lippenslaan 200,2023-05-02,17:00:00,188,37,151,FMN 15 Luitenant Lippenslaan
662,Luitenant Lippenslaan 200,2023-05-02,18:00:00,181,26,155,FMN 15 Luitenant Lippenslaan
662,Luitenant Lippenslaan 200,2023-05-02,19:00:00,105,11,94,FMN 15 Luitenant Lippenslaan
662,Luitenant Lippenslaan 200,2023-05-02,20:00:00,85,14,71,FMN 15 Luitenant Lippenslaan
662,Luitenant Lippenslaan 200,2023-05-02,21:00:00,71,15,56,FMN 15 Luitenant Lippenslaan
662,Luitenant Lippenslaan 200,2023-05-02,22:00:00,46,10,36,FMN 15 Luitenant Lippenslaan
662,Luitenant Lippenslaan 200,2023-05-02,23:00:00,25,1,24,FMN 15 Luitenant Lippenslaan
662,Luitenant Lippenslaan 200,2023-05-03,00:00:00,11,3,8,FMN 15 Luitenant Lippenslaan
662,Luitenant Lippenslaan 200,2023-05-03,01:00:00,6,4,2,FMN 15 Luitenant Lippenslaan
662,Luitenant Lippenslaan 200,2023-05-03,02:00:00,5,3,2,FMN 15 Luitenant Lippenslaan
662,Luitenant Lippenslaan 200,2023-05-03,03:00:00,1,1,0,FMN 15 Luitenant Lippenslaan
662,Luitenant Lippenslaan 200,2023-05-03,04:00:00,9,3,6,FMN 15 Luitenant Lippenslaan
662,Luitenant Lippenslaan 200,2023-05-03,05:00:00,26,4,22,FMN 15 Luitenant Lippenslaan
662,Luitenant Lippenslaan 200,2023-05-03,06:00:00,90,9,81,FMN 15 Luitenant Lippenslaan
662,Luitenant Lippenslaan 200,2023-05-03,07:00:00,213,8,205,FMN 15 Luitenant Lippenslaan
662,Luitenant Lippenslaan 200,2023-05-03,08:00:00,402,23,379,FMN 15 Luitenant Lippenslaan
662,Luitenant Lippenslaan 200,2023-05-03,09:00:00,163,17,146,FMN 15 Luitenant Lippenslaan
662,Luitenant Lippenslaan 200,2023-05-03,10:00:00,99,10,89,FMN 15 Luitenant Lippenslaan
662,Luitenant Lippenslaan 200,2023-05-03,11:00:00,81,9,72,FMN 15 Luitenant Lippenslaan
662,Luitenant Lippenslaan 200,2023-05-03,12:00:00,143,26,117,FMN 15 Luitenant Lippenslaan
662,Luitenant Lippenslaan 200,2023-05-03,13:00:00,133,14,119,FMN 15 Luitenant Lippenslaan
662,Luitenant Lippenslaan 200,2023-05-03,14:00:00,123,18,105,FMN 15 Luitenant Lippenslaan
662,Luitenant Lippenslaan 200,2023-05-03,15:00:00,123,12,111,FMN 15 Luitenant Lippenslaan
662,Luitenant Lippenslaan 200,2023-05-03,16:00:00,140,17,123,FMN 15 Luitenant Lippenslaan
662,Luitenant Lippenslaan 200,2023-05-03,17:00:00,195,20,175,FMN 15 Luitenant Lippenslaan
662,Luitenant Lippenslaan 200,2023-05-03,18:00:00,170,15,155,FMN 15 Luitenant Lippenslaan
662,Luitenant Lippenslaan 200,2023-05-03,19:00:00,137,17,120,FMN 15 Luitenant Lippenslaan
662,Luitenant Lippenslaan 200,2023-05-03,20:00:00,84,9,75,FMN 15 Luitenant Lippenslaan
662,Luitenant Lippenslaan 200,2023-05-03,21:00:00,71,18,53,FMN 15 Luitenant Lippenslaan
662,Luitenant Lippenslaan 200,2023-05-03,22:00:00,63,13,50,FMN 15 Luitenant Lippenslaan
662,Luitenant Lippenslaan 200,2023-05-03,23:00:00,22,5,17,FMN 15 Luitenant Lippenslaan
662,Luitenant Lippenslaan 200,2023-05-04,00:00:00,9,2,7,FMN 15 Luitenant Lippenslaan
662,Luitenant Lippenslaan 200,2023-05-04,01:00:00,8,5,3,FMN 15 Luitenant Lippenslaan
662,Luitenant Lippenslaan 200,2023-05-04,02:00:00,5,3,2,FMN 15 Luitenant Lippenslaan
662,Luitenant Lippenslaan 200,2023-05-04,03:00:00,4,1,3,FMN 15 Luitenant Lippenslaan
662,Luitenant Lippenslaan 200,2023-05-04,04:00:00,11,3,8,FMN 15 Luitenant Lippenslaan
662,Luitenant Lippenslaan 200,2023-05-04,05:00:00,23,4,19,FMN 15 Luitenant Lippenslaan
662,Luitenant Lippenslaan 200,2023-05-04,06:00:00,87,7,80,FMN 15 Luitenant Lippenslaan
662,Luitenant Lippenslaan 200,2023-05-04,07:00:00,241,9,232,FMN 15 Luitenant Lippenslaan
662,Luitenant Lippenslaan 200,2023-05-04,08:00:00,518,22,496,FMN 15 Luitenant Lippenslaan
662,Luitenant Lippenslaan 200,2023-05-04,09:00:00,182,13,169,FMN 15 Luitenant Lippenslaan
662,Luitenant Lippenslaan 200,2023-05-04,10:00:00,93,9,84,FMN 15 Luitenant Lippenslaan
662,Luitenant Lippenslaan 200,2023-05-04,11:00:00,98,11,87,FMN 15 Luitenant Lippenslaan
662,Luitenant Lippenslaan 200,2023-05-04,12:00:00,130,14,116,FMN 15 Luitenant Lippenslaan
662,Luitenant Lippenslaan 200,2023-05-04,13:00:00,128,11,117,FMN 15 Luitenant Lippenslaan
662,Luitenant Lippenslaan 200,2023-05-04,14:00:00,109,8,101,FMN 15 Luitenant Lippenslaan
662,Luitenant Lippenslaan 200,2023-05-04,15:00:00,146,15,131,FMN 15 Luitenant Lippenslaan
662,Luitenant Lippenslaan 200,2023-05-04,16:00:00,185,25,160,FMN 15 Luitenant Lippenslaan
662,Luitenant Lippenslaan 200,2023-05-04,17:00:00,180,15,165,FMN 15 Luitenant Lippenslaan
662,Luitenant Lippenslaan 200,2023-05-04,18:00:00,212,18,194,FMN 15 Luitenant Lippenslaan
662,Luitenant Lippenslaan 200,2023-05-04,19:00:00,160,13,147,FMN 15 Luitenant Lippenslaan
662,Luitenant Lippenslaan 200,2023-05-04,20:00:00,97,15,82,FMN 15 Luitenant Lippenslaan
662,Luitenant Lippenslaan 200,2023-05-04,21:00:00,65,10,55,FMN 15 Luitenant Lippenslaan
662,Luitenant Lippenslaan 200,2023-05-04,22:00:00,51,13,38,FMN 15 Luitenant Lippenslaan
662,Luitenant Lippenslaan 200,2023-05-04,23:00:00,28,3,25,FMN 15 Luitenant Lippenslaan
662,Luitenant Lippenslaan 200,2023-05-05,00:00:00,16,4,12,FMN 15 Luitenant Lippenslaan
662,Luitenant Lippenslaan 200,2023-05-05,01:00:00,11,7,4,FMN 15 Luitenant Lippenslaan
662,Luitenant Lippenslaan 200,2023-05-05,02:00:00,8,6,2,FMN 15 Luitenant Lippenslaan
662,Luitenant Lippenslaan 200,2023-05-05,03:00:00,3,2,1,FMN 15 Luitenant Lippenslaan
662,Luitenant Lippenslaan 200,2023-05-05,04:00:00,9,1,8,FMN 15 Luitenant Lippenslaan
662,Luitenant Lippenslaan 200,2023-05-05,05:00:00,11,1,10,FMN 15 Luitenant Lippenslaan
662,Luitenant Lippenslaan 200,2023-05-05,06:00:00,62,6,56,FMN 15 Luitenant Lippenslaan
662,Luitenant Lippenslaan 200,2023-05-05,07:00:00,184,11,173,FMN 15 Luitenant Lippenslaan
662,Luitenant Lippenslaan 200,2023-05-05,08:00:00,372,23,349,FMN 15 Luitenant Lippenslaan
662,Luitenant Lippenslaan 200,2023-05-05,09:00:00,148,9,139,FMN 15 Luitenant Lippenslaan
662,Luitenant Lippenslaan 200,2023-05-05,10:00:00,106,13,93,FMN 15 Luitenant Lippenslaan
662,Luitenant Lippenslaan 200,2023-05-05,11:00:00,45,5,40,FMN 15 Luitenant Lippenslaan
662,Luitenant Lippenslaan 200,2023-05-05,12:00:00,93,15,78,FMN 15 Luitenant Lippenslaan
662,Luitenant Lippenslaan 200,2023-05-05,13:00:00,73,6,67,FMN 15 Luitenant Lippenslaan
662,Luitenant Lippenslaan 200,2023-05-05,14:00:00,72,13,59,FMN 15 Luitenant Lippenslaan
662,Luitenant Lippenslaan 200,2023-05-05,15:00:00,113,25,88,FMN 15 Luitenant Lippenslaan
662,Luitenant Lippenslaan 200,2023-05-05,16:00:00,127,18,109,FMN 15 Luitenant Lippenslaan
662,Luitenant Lippenslaan 200,2023-05-05,17:00:00,138,15,123,FMN 15 Luitenant Lippenslaan
662,Luitenant Lippenslaan 200,2023-05-05,18:00:00,147,22,125,FMN 15 Luitenant Lippenslaan
662,Luitenant Lippenslaan 200,2023-05-05,19:00:00,127,16,111,FMN 15 Luitenant Lippenslaan
662,Luitenant Lippenslaan 200,2023-05-05,20:00:00,84,12,72,FMN 15 Luitenant Lippenslaan
662,Luitenant Lippenslaan 200,2023-05-05,21:00:00,61,18,43,FMN 15 Luitenant Lippenslaan
662,Luitenant Lippenslaan 200,2023-05-05,22:00:00,64,11,53,FMN 15 Luitenant Lippenslaan
662,Luitenant Lippenslaan 200,2023-05-05,23:00:00,36,6,30,FMN 15 Luitenant Lippenslaan
662,Luitenant Lippenslaan 200,2023-05-06,00:00:00,28,8,20,FMN 15 Luitenant Lippenslaan
662,Luitenant Lippenslaan 200,2023-05-06,01:00:00,20,3,17,FMN 15 Luitenant Lippenslaan
662,Luitenant Lippenslaan 200,2023-05-06,02:00:00,18,5,13,FMN 15 Luitenant Lippenslaan
662,Luitenant Lippenslaan 200,2023-05-06,03:00:00,10,1,9,FMN 15 Luitenant Lippenslaan
662,Luitenant Lippenslaan 200,2023-05-06,04:00:00,11,0,11,FMN 15 Luitenant Lippenslaan
662,Luitenant Lippenslaan 200,2023-05-06,05:00:00,13,3,10,FMN 15 Luitenant Lippenslaan
662,Luitenant Lippenslaan 200,2023-05-06,06:00:00,22,7,15,FMN 15 Luitenant Lippenslaan
662,Luitenant Lippenslaan 200,2023-05-06,07:00:00,33,6,27,FMN 15 Luitenant Lippenslaan
662,Luitenant Lippenslaan 200,2023-05-06,08:00:00,71,13,58,FMN 15 Luitenant Lippenslaan
662,Luitenant Lippenslaan 200,2023-05-06,09:00:00,128,12,116,FMN 15 Luitenant Lippenslaan
662,Luitenant Lippenslaan 200,2023-05-06,10:00:00,117,11,106,FMN 15 Luitenant Lippenslaan
662,Luitenant Lippenslaan 200,2023-05-06,11:00:00,101,7,94,FMN 15 Luitenant Lippenslaan
662,Luitenant Lippenslaan 200,2023-05-06,12:00:00,132,13,119,FMN 15 Luitenant Lippenslaan
662,Luitenant Lippenslaan 200,2023-05-06,13:00:00,153,11,142,FMN 15 Luitenant Lippenslaan
662,Luitenant Lippenslaan 200,2023-05-06,14:00:00,116,14,102,FMN 15 Luitenant Lippenslaan
662,Luitenant Lippenslaan 200,2023-05-06,15:00:00,87,12,75,FMN 15 Luitenant Lippenslaan
662,Luitenant Lippenslaan 200,2023-05-06,16:00:00,91,9,82,FMN 15 Luitenant Lippenslaan
662,Luitenant Lippenslaan 200,2023-05-06,17:00:00,89,11,78,FMN 15 Luitenant Lippenslaan
662,Luitenant Lippenslaan 200,2023-05-06,18:00:00,105,16,89,FMN 15 Luitenant Lippenslaan
662,Luitenant Lippenslaan 200,2023-05-06,19:00:00,79,19,60,FMN 15 Luitenant Lippenslaan
662,Luitenant Lippenslaan 200,2023-05-06,20:00:00,83,17,66,FMN 15 Luitenant Lippenslaan
662,Luitenant Lippenslaan 200,2023-05-06,21:00:00,78,20,58,FMN 15 Luitenant Lippenslaan
662,Luitenant Lippenslaan 200,2023-05-06,22:00:00,75,20,55,FMN 15 Luitenant Lippenslaan
662,Luitenant Lippenslaan 200,2023-05-06,23:00:00,41,11,30,FMN 15 Luitenant Lippenslaan
662,Luitenant Lippenslaan 200,2023-05-07,00:00:00,35,11,24,FMN 15 Luitenant Lippenslaan
662,Luitenant Lippenslaan 200,2023-05-07,01:00:00,21,8,13,FMN 15 Luitenant Lippenslaan
662,Luitenant Lippenslaan 200,2023-05-07,02:00:00,16,5,11,FMN 15 Luitenant Lippenslaan
662,Luitenant Lippenslaan 200,2023-05-07,03:00:00,7,5,2,FMN 15 Luitenant Lippenslaan
662,Luitenant Lippenslaan 200,2023-05-07,04:00:00,9,3,6,FMN 15 Luitenant Lippenslaan
662,Luitenant Lippenslaan 200,2023-05-07,05:00:00,9,3,6,FMN 15 Luitenant Lippenslaan
662,Luitenant Lippenslaan 200,2023-05-07,06:00:00,15,3,12,FMN 15 Luitenant Lippenslaan
662,Luitenant Lippenslaan 200,2023-05-07,07:00:00,18,3,15,FMN 15 Luitenant Lippenslaan
662,Luitenant Lippenslaan 200,2023-05-07,08:00:00,44,6,38,FMN 15 Luitenant Lippenslaan
662,Luitenant Lippenslaan 200,2023-05-07,09:00:00,74,9,65,FMN 15 Luitenant Lippenslaan
662,Luitenant Lippenslaan 200,2023-05-07,10:00:00,52,10,42,FMN 15 Luitenant Lippenslaan
662,Luitenant Lippenslaan 200,2023-05-07,11:00:00,61,7,54,FMN 15 Luitenant Lippenslaan
662,Luitenant Lippenslaan 200,2023-05-07,12:00:00,73,8,65,FMN 15 Luitenant Lippenslaan
662,Luitenant Lippenslaan 200,2023-05-07,13:00:00,68,7,61,FMN 15 Luitenant Lippenslaan
662,Luitenant Lippenslaan 200,2023-05-07,14:00:00,98,19,79,FMN 15 Luitenant Lippenslaan
662,Luitenant Lippenslaan 200,2023-05-07,15:00:00,66,11,55,FMN 15 Luitenant Lippenslaan
662,Luitenant Lippenslaan 200,2023-05-07,16:00:00,73,7,66,FMN 15 Luitenant Lippenslaan
662,Luitenant Lippenslaan 200,2023-05-07,17:00:00,79,17,62,FMN 15 Luitenant Lippenslaan
662,Luitenant Lippenslaan 200,2023-05-07,18:00:00,65,18,47,FMN 15 Luitenant Lippenslaan
662,Luitenant Lippenslaan 200,2023-05-07,19:00:00,52,11,41,FMN 15 Luitenant Lippenslaan
662,Luitenant Lippenslaan 200,2023-05-07,20:00:00,56,12,44,FMN 15 Luitenant Lippenslaan
662,Luitenant Lippenslaan 200,2023-05-07,21:00:00,59,18,41,FMN 15 Luitenant Lippenslaan
662,Luitenant Lippenslaan 200,2023-05-07,22:00:00,25,6,19,FMN 15 Luitenant Lippenslaan
662,Luitenant Lippenslaan 200,2023-05-07,23:00:00,14,5,9,FMN 15 Luitenant Lippenslaan
662,Luitenant Lippenslaan 200,2023-05-08,00:00:00,11,8,3,FMN 15 Luitenant Lippenslaan
662,Luitenant Lippenslaan 200,2023-05-08,01:00:00,4,2,2,FMN 15 Luitenant Lippenslaan
662,Luitenant Lippenslaan 200,2023-05-08,02:00:00,5,3,2,FMN 15 Luitenant Lippenslaan
662,Luitenant Lippenslaan 200,2023-05-08,03:00:00,2,0,2,FMN 15 Luitenant Lippenslaan
662,Luitenant Lippenslaan 200,2023-05-08,04:00:00,11,2,9,FMN 15 Luitenant Lippenslaan
662,Luitenant Lippenslaan 200,2023-05-08,05:00:00,16,7,9,FMN 15 Luitenant Lippenslaan
662,Luitenant Lippenslaan 200,2023-05-08,06:00:00,82,12,70,FMN 15 Luitenant Lippenslaan
662,Luitenant Lippenslaan 200,2023-05-08,07:00:00,208,10,198,FMN 15 Luitenant Lippenslaan
662,Luitenant Lippenslaan 200,2023-05-08,08:00:00,443,29,414,FMN 15 Luitenant Lippenslaan
662,Luitenant Lippenslaan 200,2023-05-08,09:00:00,165,12,153,FMN 15 Luitenant Lippenslaan
662,Luitenant Lippenslaan 200,2023-05-08,10:00:00,98,10,88,FMN 15 Luitenant Lippenslaan
662,Luitenant Lippenslaan 200,2023-05-08,11:00:00,71,8,63,FMN 15 Luitenant Lippenslaan
662,Luitenant Lippenslaan 200,2023-05-08,12:00:00,99,15,84,FMN 15 Luitenant Lippenslaan
662,Luitenant Lippenslaan 200,2023-05-08,13:00:00,98,12,86,FMN 15 Luitenant Lippenslaan
662,Luitenant Lippenslaan 200,2023-05-08,14:00:00,96,13,83,FMN 15 Luitenant Lippenslaan
662,Luitenant Lippenslaan 200,2023-05-08,15:00:00,109,27,82,FMN 15 Luitenant Lippenslaan
662,Luitenant Lippenslaan 200,2023-05-08,16:00:00,138,27,111,FMN 15 Luitenant Lippenslaan
662,Luitenant Lippenslaan 200,2023-05-08,17:00:00,153,21,132,FMN 15 Luitenant Lippenslaan
662,Luitenant Lippenslaan 200,2023-05-08,18:00:00,133,19,114,FMN 15 Luitenant Lippenslaan
662,Luitenant Lippenslaan 200,2023-05-08,19:00:00,114,24,90,FMN 15 Luitenant Lippenslaan
662,Luitenant Lippenslaan 200,2023-05-08,20:00:00,90,19,71,FMN 15 Luitenant Lippenslaan
662,Luitenant Lippenslaan 200,2023-05-08,21:00:00,62,15,47,FMN 15 Luitenant Lippenslaan
662,Luitenant Lippenslaan 200,2023-05-08,22:00:00,52,11,41,FMN 15 Luitenant Lippenslaan
662,Luitenant Lippenslaan 200,2023-05-08,23:00:00,22,7,15,FMN 15 Luitenant Lippenslaan
662,Luitenant Lippenslaan 200,2023-05-09,00:00:00,6,3,3,FMN 15 Luitenant Lippenslaan
662,Luitenant Lippenslaan 200,2023-05-09,01:00:00,5,3,2,FMN 15 Luitenant Lippenslaan
662,Luitenant Lippenslaan 200,2023-05-09,02:00:00,6,4,2,FMN 15 Luitenant Lippenslaan
662,Luitenant Lippenslaan 200,2023-05-09,03:00:00,2,2,0,FMN 15 Luitenant Lippenslaan
662,Luitenant Lippenslaan 200,2023-05-09,04:00:00,16,7,9,FMN 15 Luitenant Lippenslaan
662,Luitenant Lippenslaan 200,2023-05-09,05:00:00,17,2,15,FMN 15 Luitenant Lippenslaan
662,Luitenant Lippenslaan 200,2023-05-09,06:00:00,69,13,56,FMN 15 Luitenant Lippenslaan
662,Luitenant Lippenslaan 200,2023-05-09,07:00:00,189,13,176,FMN 15 Luitenant Lippenslaan
662,Luitenant Lippenslaan 200,2023-05-09,08:00:00,433,26,407,FMN 15 Luitenant Lippenslaan
662,Luitenant Lippenslaan 200,2023-05-09,09:00:00,136,4,132,FMN 15 Luitenant Lippenslaan
662,Luitenant Lippenslaan 200,2023-05-09,10:00:00,79,10,69,FMN 15 Luitenant Lippenslaan
662,Luitenant Lippenslaan 200,2023-05-09,11:00:00,44,8,36,FMN 15 Luitenant Lippenslaan
662,Luitenant Lippenslaan 200,2023-05-09,12:00:00,67,9,58,FMN 15 Luitenant Lippenslaan
662,Luitenant Lippenslaan 200,2023-05-09,13:00:00,58,6,52,FMN 15 Luitenant Lippenslaan
662,Luitenant Lippenslaan 200,2023-05-09,14:00:00,43,7,36,FMN 15 Luitenant Lippenslaan
662,Luitenant Lippenslaan 200,2023-05-09,15:00:00,70,12,58,FMN 15 Luitenant Lippenslaan
662,Luitenant Lippenslaan 200,2023-05-09,16:00:00,106,18,88,FMN 15 Luitenant Lippenslaan
662,Luitenant Lippenslaan 200,2023-05-09,17:00:00,103,11,92,FMN 15 Luitenant Lippenslaan
662,Luitenant Lippenslaan 200,2023-05-09,18:00:00,99,14,85,FMN 15 Luitenant Lippenslaan
662,Luitenant Lippenslaan 200,2023-05-09,19:00:00,56,12,44,FMN 15 Luitenant Lippenslaan
662,Luitenant Lippenslaan 200,2023-05-09,20:00:00,56,11,45,FMN 15 Luitenant Lippenslaan
662,Luitenant Lippenslaan 200,2023-05-09,21:00:00,33,7,26,FMN 15 Luitenant Lippenslaan
662,Luitenant Lippenslaan 200,2023-05-09,22:00:00,20,8,12,FMN 15 Luitenant Lippenslaan
662,Luitenant Lippenslaan 200,2023-05-09,23:00:00,17,5,12,FMN 15 Luitenant Lippenslaan
662,Luitenant Lippenslaan 200,2023-05-10,00:00:00,5,2,3,FMN 15 Luitenant Lippenslaan
662,Luitenant Lippenslaan 200,2023-05-10,01:00:00,4,2,2,FMN 15 Luitenant Lippenslaan
662,Luitenant Lippenslaan 200,2023-05-10,02:00:00,7,5,2,FMN 15 Luitenant Lippenslaan
662,Luitenant Lippenslaan 200,2023-05-10,03:00:00,4,2,2,FMN 15 Luitenant Lippenslaan
662,Luitenant Lippenslaan 200,2023-05-10,04:00:00,13,2,11,FMN 15 Luitenant Lippenslaan
662,Luitenant Lippenslaan 200,2023-05-10,05:00:00,24,6,18,FMN 15 Luitenant Lippenslaan
662,Luitenant Lippenslaan 200,2023-05-10,06:00:00,63,10,53,FMN 15 Luitenant Lippenslaan
662,Luitenant Lippenslaan 200,2023-05-10,07:00:00,179,11,168,FMN 15 Luitenant Lippenslaan
662,Luitenant Lippenslaan 200,2023-05-10,08:00:00,380,17,363,FMN 15 Luitenant Lippenslaan
662,Luitenant Lippenslaan 200,2023-05-10,09:00:00,147,12,135,FMN 15 Luitenant Lippenslaan
662,Luitenant Lippenslaan 200,2023-05-10,10:00:00,107,13,94,FMN 15 Luitenant Lippenslaan
662,Luitenant Lippenslaan 200,2023-05-10,11:00:00,77,10,67,FMN 15 Luitenant Lippenslaan
662,Luitenant Lippenslaan 200,2023-05-10,12:00:00,138,15,123,FMN 15 Luitenant Lippenslaan
662,Luitenant Lippenslaan 200,2023-05-10,13:00:00,79,10,69,FMN 15 Luitenant Lippenslaan
662,Luitenant Lippenslaan 200,2023-05-10,14:00:00,72,11,61,FMN 15 Luitenant Lippenslaan
662,Luitenant Lippenslaan 200,2023-05-10,15:00:00,91,13,78,FMN 15 Luitenant Lippenslaan
662,Luitenant Lippenslaan 200,2023-05-10,16:00:00,91,16,75,FMN 15 Luitenant Lippenslaan
662,Luitenant Lippenslaan 200,2023-05-10,17:00:00,121,15,106,FMN 15 Luitenant Lippenslaan
662,Luitenant Lippenslaan 200,2023-05-10,18:00:00,126,19,107,FMN 15 Luitenant Lippenslaan
662,Luitenant Lippenslaan 200,2023-05-10,19:00:00,94,12,82,FMN 15 Luitenant Lippenslaan
662,Luitenant Lippenslaan 200,2023-05-10,20:00:00,66,12,54,FMN 15 Luitenant Lippenslaan
662,Luitenant Lippenslaan 200,2023-05-10,21:00:00,46,10,36,FMN 15 Luitenant Lippenslaan
662,Luitenant Lippenslaan 200,2023-05-10,22:00:00,40,8,32,FMN 15 Luitenant Lippenslaan
662,Luitenant Lippenslaan 200,2023-05-10,23:00:00,27,6,21,FMN 15 Luitenant Lippenslaan
662,Luitenant Lippenslaan 200,2023-05-11,00:00:00,16,6,10,FMN 15 Luitenant Lippenslaan
662,Luitenant Lippenslaan 200,2023-05-11,01:00:00,5,0,5,FMN 15 Luitenant Lippenslaan
662,Luitenant Lippenslaan 200,2023-05-11,02:00:00,5,5,0,FMN 15 Luitenant Lippenslaan
662,Luitenant Lippenslaan 200,2023-05-11,03:00:00,3,0,3,FMN 15 Luitenant Lippenslaan
662,Luitenant Lippenslaan 200,2023-05-11,04:00:00,14,2,12,FMN 15 Luitenant Lippenslaan
662,Luitenant Lippenslaan 200,2023-05-11,05:00:00,14,4,10,FMN 15 Luitenant Lippenslaan
662,Luitenant Lippenslaan 200,2023-05-11,06:00:00,75,6,69,FMN 15 Luitenant Lippenslaan
662,Luitenant Lippenslaan 200,2023-05-11,07:00:00,218,15,203,FMN 15 Luitenant Lippenslaan
662,Luitenant Lippenslaan 200,2023-05-11,08:00:00,456,27,429,FMN 15 Luitenant Lippenslaan
662,Luitenant Lippenslaan 200,2023-05-11,09:00:00,165,9,156,FMN 15 Luitenant Lippenslaan
662,Luitenant Lippenslaan 200,2023-05-11,10:00:00,90,10,80,FMN 15 Luitenant Lippenslaan
662,Luitenant Lippenslaan 200,2023-05-11,11:00:00,62,9,53,FMN 15 Luitenant Lippenslaan
662,Luitenant Lippenslaan 200,2023-05-11,12:00:00,109,13,96,FMN 15 Luitenant Lippenslaan
662,Luitenant Lippenslaan 200,2023-05-11,13:00:00,93,10,83,FMN 15 Luitenant Lippenslaan
662,Luitenant Lippenslaan 200,2023-05-11,14:00:00,77,14,63,FMN 15 Luitenant Lippenslaan
662,Luitenant Lippenslaan 200,2023-05-11,15:00:00,98,24,74,FMN 15 Luitenant Lippenslaan
662,Luitenant Lippenslaan 200,2023-05-11,16:00:00,139,14,125,FMN 15 Luitenant Lippenslaan
662,Luitenant Lippenslaan 200,2023-05-11,17:00:00,163,13,150,FMN 15 Luitenant Lippenslaan
662,Luitenant Lippenslaan 200,2023-05-11,18:00:00,144,15,129,FMN 15 Luitenant Lippenslaan
662,Luitenant Lippenslaan 200,2023-05-11,19:00:00,127,14,113,FMN 15 Luitenant Lippenslaan
662,Luitenant Lippenslaan 200,2023-05-11,20:00:00,94,15,79,FMN 15 Luitenant Lippenslaan
662,Luitenant Lippenslaan 200,2023-05-11,21:00:00,54,13,41,FMN 15 Luitenant Lippenslaan
662,Luitenant Lippenslaan 200,2023-05-11,22:00:00,46,11,35,FMN 15 Luitenant Lippenslaan
662,Luitenant Lippenslaan 200,2023-05-11,23:00:00,33,10,23,FMN 15 Luitenant Lippenslaan
662,Luitenant Lippenslaan 200,2023-05-12,00:00:00,6,2,4,FMN 15 Luitenant Lippenslaan
662,Luitenant Lippenslaan 200,2023-05-12,01:00:00,6,5,1,FMN 15 Luitenant Lippenslaan
662,Luitenant Lippenslaan 200,2023-05-12,02:00:00,3,2,1,FMN 15 Luitenant Lippenslaan
662,Luitenant Lippenslaan 200,2023-05-12,03:00:00,1,1,0,FMN 15 Luitenant Lippenslaan
662,Luitenant Lippenslaan 200,2023-05-12,04:00:00,10,4,6,FMN 15 Luitenant Lippenslaan
662,Luitenant Lippenslaan 200,2023-05-12,05:00:00,20,6,14,FMN 15 Luitenant Lippenslaan
662,Luitenant Lippenslaan 200,2023-05-12,06:00:00,49,10,39,FMN 15 Luitenant Lippenslaan
662,Luitenant Lippenslaan 200,2023-05-12,07:00:00,133,6,127,FMN 15 Luitenant Lippenslaan
662,Luitenant Lippenslaan 200,2023-05-12,08:00:00,298,12,286,FMN 15 Luitenant Lippenslaan
662,Luitenant Lippenslaan 200,2023-05-12,09:00:00,134,9,125,FMN 15 Luitenant Lippenslaan
662,Luitenant Lippenslaan 200,2023-05-12,10:00:00,81,9,72,FMN 15 Luitenant Lippenslaan
662,Luitenant Lippenslaan 200,2023-05-12,11:00:00,61,4,57,FMN 15 Luitenant Lippenslaan
662,Luitenant Lippenslaan 200,2023-05-12,12:00:00,107,25,82,FMN 15 Luitenant Lippenslaan
662,Luitenant Lippenslaan 200,2023-05-12,13:00:00,93,8,85,FMN 15 Luitenant Lippenslaan
662,Luitenant Lippenslaan 200,2023-05-12,14:00:00,61,11,50,FMN 15 Luitenant Lippenslaan
662,Luitenant Lippenslaan 200,2023-05-12,15:00:00,103,22,81,FMN 15 Luitenant Lippenslaan
662,Luitenant Lippenslaan 200,2023-05-12,16:00:00,123,22,101,FMN 15 Luitenant Lippenslaan
662,Luitenant Lippenslaan 200,2023-05-12,17:00:00,154,19,135,FMN 15 Luitenant Lippenslaan
662,Luitenant Lippenslaan 200,2023-05-12,18:00:00,135,25,110,FMN 15 Luitenant Lippenslaan
662,Luitenant Lippenslaan 200,2023-05-12,19:00:00,112,16,96,FMN 15 Luitenant Lippenslaan
662,Luitenant Lippenslaan 200,2023-05-12,20:00:00,93,21,72,FMN 15 Luitenant Lippenslaan
662,Luitenant Lippenslaan 200,2023-05-12,21:00:00,83,17,66,FMN 15 Luitenant Lippenslaan
662,Luitenant Lippenslaan 200,2023-05-12,22:00:00,50,12,38,FMN 15 Luitenant Lippenslaan
662,Luitenant Lippenslaan 200,2023-05-12,23:00:00,31,8,23,FMN 15 Luitenant Lippenslaan
662,Luitenant Lippenslaan 200,2023-05-13,00:00:00,39,11,28,FMN 15 Luitenant Lippenslaan
662,Luitenant Lippenslaan 200,2023-05-13,01:00:00,24,8,16,FMN 15 Luitenant Lippenslaan
662,Luitenant Lippenslaan 200,2023-05-13,02:00:00,13,4,9,FMN 15 Luitenant Lippenslaan
662,Luitenant Lippenslaan 200,2023-05-13,03:00:00,17,5,12,FMN 15 Luitenant Lippenslaan
662,Luitenant Lippenslaan 200,2023-05-13,04:00:00,10,3,7,FMN 15 Luitenant Lippenslaan
662,Luitenant Lippenslaan 200,2023-05-13,05:00:00,14,3,11,FMN 15 Luitenant Lippenslaan
662,Luitenant Lippenslaan 200,2023-05-13,06:00:00,25,10,15,FMN 15 Luitenant Lippenslaan
662,Luitenant Lippenslaan 200,2023-05-13,07:00:00,27,3,24,FMN 15 Luitenant Lippenslaan
662,Luitenant Lippenslaan 200,2023-05-13,08:00:00,83,7,76,FMN 15 Luitenant Lippenslaan
662,Luitenant Lippenslaan 200,2023-05-13,09:00:00,126,12,114,FMN 15 Luitenant Lippenslaan
662,Luitenant Lippenslaan 200,2023-05-13,10:00:00,129,10,119,FMN 15 Luitenant Lippenslaan
662,Luitenant Lippenslaan 200,2023-05-13,11:00:00,159,11,148,FMN 15 Luitenant Lippenslaan
662,Luitenant Lippenslaan 200,2023-05-13,12:00:00,112,14,98,FMN 15 Luitenant Lippenslaan
662,Luitenant Lippenslaan 200,2023-05-13,13:00:00,172,10,162,FMN 15 Luitenant Lippenslaan
662,Luitenant Lippenslaan 200,2023-05-13,14:00:00,149,26,123,FMN 15 Luitenant Lippenslaan
662,Luitenant Lippenslaan 200,2023-05-13,15:00:00,125,13,112,FMN 15 Luitenant Lippenslaan
662,Luitenant Lippenslaan 200,2023-05-13,16:00:00,93,9,84,FMN 15 Luitenant Lippenslaan
662,Luitenant Lippenslaan 200,2023-05-13,17:00:00,110,6,104,FMN 15 Luitenant Lippenslaan
662,Luitenant Lippenslaan 200,2023-05-13,18:00:00,93,18,75,FMN 15 Luitenant Lippenslaan
662,Luitenant Lippenslaan 200,2023-05-13,19:00:00,122,28,94,FMN 15 Luitenant Lippenslaan
662,Luitenant Lippenslaan 200,2023-05-13,20:00:00,69,12,57,FMN 15 Luitenant Lippenslaan
662,Luitenant Lippenslaan 200,2023-05-13,21:00:00,80,10,70,FMN 15 Luitenant Lippenslaan
662,Luitenant Lippenslaan 200,2023-05-13,22:00:00,42,12,30,FMN 15 Luitenant Lippenslaan
662,Luitenant Lippenslaan 200,2023-05-13,23:00:00,51,11,40,FMN 15 Luitenant Lippenslaan
662,Luitenant Lippenslaan 200,2023-05-14,00:00:00,28,8,20,FMN 15 Luitenant Lippenslaan
662,Luitenant Lippenslaan 200,2023-05-14,01:00:00,27,6,21,FMN 15 Luitenant Lippenslaan
662,Luitenant Lippenslaan 200,2023-05-14,02:00:00,12,4,8,FMN 15 Luitenant Lippenslaan
662,Luitenant Lippenslaan 200,2023-05-14,03:00:00,7,4,3,FMN 15 Luitenant Lippenslaan
662,Luitenant Lippenslaan 200,2023-05-14,04:00:00,8,1,7,FMN 15 Luitenant Lippenslaan
662,Luitenant Lippenslaan 200,2023-05-14,05:00:00,8,1,7,FMN 15 Luitenant Lippenslaan
662,Luitenant Lippenslaan 200,2023-05-14,06:00:00,25,4,21,FMN 15 Luitenant Lippenslaan
662,Luitenant Lippenslaan 200,2023-05-14,07:00:00,21,2,19,FMN 15 Luitenant Lippenslaan
662,Luitenant Lippenslaan 200,2023-05-14,08:00:00,39,4,35,FMN 15 Luitenant Lippenslaan
662,Luitenant Lippenslaan 200,2023-05-14,09:00:00,76,6,70,FMN 15 Luitenant Lippenslaan
662,Luitenant Lippenslaan 200,2023-05-14,10:00:00,70,11,59,FMN 15 Luitenant Lippenslaan
662,Luitenant Lippenslaan 200,2023-05-14,11:00:00,77,9,68,FMN 15 Luitenant Lippenslaan
662,Luitenant Lippenslaan 200,2023-05-14,12:00:00,113,13,100,FMN 15 Luitenant Lippenslaan
662,Luitenant Lippenslaan 200,2023-05-14,13:00:00,126,15,111,FMN 15 Luitenant Lippenslaan
662,Luitenant Lippenslaan 200,2023-05-14,14:00:00,93,8,85,FMN 15 Luitenant Lippenslaan
662,Luitenant Lippenslaan 200,2023-05-14,15:00:00,113,12,101,FMN 15 Luitenant Lippenslaan
662,Luitenant Lippenslaan 200,2023-05-14,16:00:00,117,18,99,FMN 15 Luitenant Lippenslaan
662,Luitenant Lippenslaan 200,2023-05-14,17:00:00,110,11,99,FMN 15 Luitenant Lippenslaan
662,Luitenant Lippenslaan 200,2023-05-14,18:00:00,106,20,86,FMN 15 Luitenant Lippenslaan
662,Luitenant Lippenslaan 200,2023-05-14,19:00:00,82,9,73,FMN 15 Luitenant Lippenslaan
662,Luitenant Lippenslaan 200,2023-05-14,20:00:00,57,10,47,FMN 15 Luitenant Lippenslaan
662,Luitenant Lippenslaan 200,2023-05-14,21:00:00,61,19,42,FMN 15 Luitenant Lippenslaan
662,Luitenant Lippenslaan 200,2023-05-14,22:00:00,26,8,18,FMN 15 Luitenant Lippenslaan
662,Luitenant Lippenslaan 200,2023-05-14,23:00:00,29,9,20,FMN 15 Luitenant Lippenslaan
662,Luitenant Lippenslaan 200,2023-05-15,00:00:00,11,4,7,FMN 15 Luitenant Lippenslaan
662,Luitenant Lippenslaan 200,2023-05-15,01:00:00,4,2,2,FMN 15 Luitenant Lippenslaan
662,Luitenant Lippenslaan 200,2023-05-15,02:00:00,4,2,2,FMN 15 Luitenant Lippenslaan
662,Luitenant Lippenslaan 200,2023-05-15,03:00:00,5,2,3,FMN 15 Luitenant Lippenslaan
662,Luitenant Lippenslaan 200,2023-05-15,04:00:00,8,1,7,FMN 15 Luitenant Lippenslaan
662,Luitenant Lippenslaan 200,2023-05-15,05:00:00,21,6,15,FMN 15 Luitenant Lippenslaan
662,Luitenant Lippenslaan 200,2023-05-15,06:00:00,77,10,67,FMN 15 Luitenant Lippenslaan
662,Luitenant Lippenslaan 200,2023-05-15,07:00:00,192,10,182,FMN 15 Luitenant Lippenslaan
662,Luitenant Lippenslaan 200,2023-05-15,08:00:00,419,31,388,FMN 15 Luitenant Lippenslaan
662,Luitenant Lippenslaan 200,2023-05-15,09:00:00,155,14,141,FMN 15 Luitenant Lippenslaan
662,Luitenant Lippenslaan 200,2023-05-15,10:00:00,81,9,72,FMN 15 Luitenant Lippenslaan
662,Luitenant Lippenslaan 200,2023-05-15,11:00:00,94,11,83,FMN 15 Luitenant Lippenslaan
662,Luitenant Lippenslaan 200,2023-05-15,12:00:00,87,13,74,FMN 15 Luitenant Lippenslaan
662,Luitenant Lippenslaan 200,2023-05-15,13:00:00,64,11,53,FMN 15 Luitenant Lippenslaan
662,Luitenant Lippenslaan 200,2023-05-15,14:00:00,64,14,50,FMN 15 Luitenant Lippenslaan
662,Luitenant Lippenslaan 200,2023-05-15,15:00:00,68,15,53,FMN 15 Luitenant Lippenslaan
662,Luitenant Lippenslaan 200,2023-05-15,16:00:00,124,18,106,FMN 15 Luitenant Lippenslaan
662,Luitenant Lippenslaan 200,2023-05-15,17:00:00,111,14,97,FMN 15 Luitenant Lippenslaan
662,Luitenant Lippenslaan 200,2023-05-15,18:00:00,115,15,100,FMN 15 Luitenant Lippenslaan
662,Luitenant Lippenslaan 200,2023-05-15,19:00:00,96,22,74,FMN 15 Luitenant Lippenslaan
662,Luitenant Lippenslaan 200,2023-05-15,20:00:00,51,10,41,FMN 15 Luitenant Lippenslaan
662,Luitenant Lippenslaan 200,2023-05-15,21:00:00,45,11,34,FMN 15 Luitenant Lippenslaan
662,Luitenant Lippenslaan 200,2023-05-15,22:00:00,31,6,25,FMN 15 Luitenant Lippenslaan
662,Luitenant Lippenslaan 200,2023-05-15,23:00:00,18,6,12,FMN 15 Luitenant Lippenslaan
662,Luitenant Lippenslaan 200,2023-05-16,00:00:00,8,4,4,FMN 15 Luitenant Lippenslaan
662,Luitenant Lippenslaan 200,2023-05-16,01:00:00,10,5,5,FMN 15 Luitenant Lippenslaan
662,Luitenant Lippenslaan 200,2023-05-16,02:00:00,5,1,4,FMN 15 Luitenant Lippenslaan
662,Luitenant Lippenslaan 200,2023-05-16,03:00:00,4,1,3,FMN 15 Luitenant Lippenslaan
662,Luitenant Lippenslaan 200,2023-05-16,04:00:00,9,1,8,FMN 15 Luitenant Lippenslaan
662,Luitenant Lippenslaan 200,2023-05-16,05:00:00,17,4,13,FMN 15 Luitenant Lippenslaan
662,Luitenant Lippenslaan 200,2023-05-16,06:00:00,68,15,53,FMN 15 Luitenant Lippenslaan
662,Luitenant Lippenslaan 200,2023-05-16,07:00:00,221,13,208,FMN 15 Luitenant Lippenslaan
662,Luitenant Lippenslaan 200,2023-05-16,08:00:00,473,37,436,FMN 15 Luitenant Lippenslaan
662,Luitenant Lippenslaan 200,2023-05-16,09:00:00,182,12,170,FMN 15 Luitenant Lippenslaan
662,Luitenant Lippenslaan 200,2023-05-16,10:00:00,96,7,89,FMN 15 Luitenant Lippenslaan
662,Luitenant Lippenslaan 200,2023-05-16,11:00:00,77,14,63,FMN 15 Luitenant Lippenslaan
662,Luitenant Lippenslaan 200,2023-05-16,12:00:00,107,19,88,FMN 15 Luitenant Lippenslaan
662,Luitenant Lippenslaan 200,2023-05-16,13:00:00,95,8,87,FMN 15 Luitenant Lippenslaan
662,Luitenant Lippenslaan 200,2023-05-16,14:00:00,66,7,59,FMN 15 Luitenant Lippenslaan
662,Luitenant Lippenslaan 200,2023-05-16,15:00:00,101,19,82,FMN 15 Luitenant Lippenslaan
662,Luitenant Lippenslaan 200,2023-05-16,16:00:00,152,27,125,FMN 15 Luitenant Lippenslaan
662,Luitenant Lippenslaan 200,2023-05-16,17:00:00,174,36,138,FMN 15 Luitenant Lippenslaan
662,Luitenant Lippenslaan 200,2023-05-16,18:00:00,149,22,127,FMN 15 Luitenant Lippenslaan
662,Luitenant Lippenslaan 200,2023-05-16,19:00:00,102,21,81,FMN 15 Luitenant Lippenslaan
662,Luitenant Lippenslaan 200,2023-05-16,20:00:00,65,15,50,FMN 15 Luitenant Lippenslaan
662,Luitenant Lippenslaan 200,2023-05-16,21:00:00,45,9,36,FMN 15 Luitenant Lippenslaan
662,Luitenant Lippenslaan 200,2023-05-16,22:00:00,42,9,33,FMN 15 Luitenant Lippenslaan
662,Luitenant Lippenslaan 200,2023-05-16,23:00:00,20,6,14,FMN 15 Luitenant Lippenslaan
662,Luitenant Lippenslaan 200,2023-05-17,00:00:00,13,7,6,FMN 15 Luitenant Lippenslaan
662,Luitenant Lippenslaan 200,2023-05-17,01:00:00,6,2,4,FMN 15 Luitenant Lippenslaan
662,Luitenant Lippenslaan 200,2023-05-17,02:00:00,5,3,2,FMN 15 Luitenant Lippenslaan
662,Luitenant Lippenslaan 200,2023-05-17,03:00:00,9,2,7,FMN 15 Luitenant Lippenslaan
662,Luitenant Lippenslaan 200,2023-05-17,04:00:00,12,3,9,FMN 15 Luitenant Lippenslaan
662,Luitenant Lippenslaan 200,2023-05-17,05:00:00,20,4,16,FMN 15 Luitenant Lippenslaan
662,Luitenant Lippenslaan 200,2023-05-17,06:00:00,73,12,61,FMN 15 Luitenant Lippenslaan
662,Luitenant Lippenslaan 200,2023-05-17,07:00:00,191,17,174,FMN 15 Luitenant Lippenslaan
662,Luitenant Lippenslaan 200,2023-05-17,08:00:00,348,19,329,FMN 15 Luitenant Lippenslaan
662,Luitenant Lippenslaan 200,2023-05-17,09:00:00,154,12,142,FMN 15 Luitenant Lippenslaan
662,Luitenant Lippenslaan 200,2023-05-17,10:00:00,85,10,75,FMN 15 Luitenant Lippenslaan
662,Luitenant Lippenslaan 200,2023-05-17,11:00:00,69,16,53,FMN 15 Luitenant Lippenslaan
662,Luitenant Lippenslaan 200,2023-05-17,12:00:00,148,27,121,FMN 15 Luitenant Lippenslaan
662,Luitenant Lippenslaan 200,2023-05-17,13:00:00,137,9,128,FMN 15 Luitenant Lippenslaan
662,Luitenant Lippenslaan 200,2023-05-17,14:00:00,139,21,118,FMN 15 Luitenant Lippenslaan
662,Luitenant Lippenslaan 200,2023-05-17,15:00:00,110,15,95,FMN 15 Luitenant Lippenslaan
662,Luitenant Lippenslaan 200,2023-05-17,16:00:00,164,19,145,FMN 15 Luitenant Lippenslaan
662,Luitenant Lippenslaan 200,2023-05-17,17:00:00,173,16,157,FMN 15 Luitenant Lippenslaan
662,Luitenant Lippenslaan 200,2023-05-17,18:00:00,169,18,151,FMN 15 Luitenant Lippenslaan
662,Luitenant Lippenslaan 200,2023-05-17,19:00:00,142,21,121,FMN 15 Luitenant Lippenslaan
662,Luitenant Lippenslaan 200,2023-05-17,20:00:00,117,21,96,FMN 15 Luitenant Lippenslaan
662,Luitenant Lippenslaan 200,2023-05-17,21:00:00,69,14,55,FMN 15 Luitenant Lippenslaan
662,Luitenant Lippenslaan 200,2023-05-17,22:00:00,60,13,47,FMN 15 Luitenant Lippenslaan
662,Luitenant Lippenslaan 200,2023-05-17,23:00:00,27,6,21,FMN 15 Luitenant Lippenslaan
662,Luitenant Lippenslaan 200,2023-05-18,00:00:00,19,7,12,FMN 15 Luitenant Lippenslaan
662,Luitenant Lippenslaan 200,2023-05-18,01:00:00,13,3,10,FMN 15 Luitenant Lippenslaan
662,Luitenant Lippenslaan 200,2023-05-18,02:00:00,10,4,6,FMN 15 Luitenant Lippenslaan
662,Luitenant Lippenslaan 200,2023-05-18,03:00:00,5,3,2,FMN 15 Luitenant Lippenslaan
662,Luitenant Lippenslaan 200,2023-05-18,04:00:00,9,3,6,FMN 15 Luitenant Lippenslaan
662,Luitenant Lippenslaan 200,2023-05-18,05:00:00,11,1,10,FMN 15 Luitenant Lippenslaan
662,Luitenant Lippenslaan 200,2023-05-18,06:00:00,15,4,11,FMN 15 Luitenant Lippenslaan
662,Luitenant Lippenslaan 200,2023-05-18,07:00:00,15,1,14,FMN 15 Luitenant Lippenslaan
662,Luitenant Lippenslaan 200,2023-05-18,08:00:00,40,10,30,FMN 15 Luitenant Lippenslaan
662,Luitenant Lippenslaan 200,2023-05-18,09:00:00,70,10,60,FMN 15 Luitenant Lippenslaan
662,Luitenant Lippenslaan 200,2023-05-18,10:00:00,80,10,70,FMN 15 Luitenant Lippenslaan
662,Luitenant Lippenslaan 200,2023-05-18,11:00:00,81,8,73,FMN 15 Luitenant Lippenslaan
662,Luitenant Lippenslaan 200,2023-05-18,12:00:00,76,11,65,FMN 15 Luitenant Lippenslaan
662,Luitenant Lippenslaan 200,2023-05-18,13:00:00,95,14,81,FMN 15 Luitenant Lippenslaan
662,Luitenant Lippenslaan 200,2023-05-18,14:00:00,113,15,98,FMN 15 Luitenant Lippenslaan
662,Luitenant Lippenslaan 200,2023-05-18,15:00:00,105,9,96,FMN 15 Luitenant Lippenslaan
662,Luitenant Lippenslaan 200,2023-05-18,16:00:00,98,8,90,FMN 15 Luitenant Lippenslaan
662,Luitenant Lippenslaan 200,2023-05-18,17:00:00,84,7,77,FMN 15 Luitenant Lippenslaan
662,Luitenant Lippenslaan 200,2023-05-18,18:00:00,116,13,103,FMN 15 Luitenant Lippenslaan
662,Luitenant Lippenslaan 200,2023-05-18,19:00:00,115,19,96,FMN 15 Luitenant Lippenslaan
662,Luitenant Lippenslaan 200,2023-05-18,20:00:00,79,19,60,FMN 15 Luitenant Lippenslaan
662,Luitenant Lippenslaan 200,2023-05-18,21:00:00,78,20,58,FMN 15 Luitenant Lippenslaan
662,Luitenant Lippenslaan 200,2023-05-18,22:00:00,32,8,24,FMN 15 Luitenant Lippenslaan
662,Luitenant Lippenslaan 200,2023-05-18,23:00:00,31,10,21,FMN 15 Luitenant Lippenslaan
662,Luitenant Lippenslaan 200,2023-05-19,00:00:00,19,2,17,FMN 15 Luitenant Lippenslaan
662,Luitenant Lippenslaan 200,2023-05-19,01:00:00,9,4,5,FMN 15 Luitenant Lippenslaan
662,Luitenant Lippenslaan 200,2023-05-19,02:00:00,17,6,11,FMN 15 Luitenant Lippenslaan
662,Luitenant Lippenslaan 200,2023-05-19,03:00:00,7,2,5,FMN 15 Luitenant Lippenslaan
662,Luitenant Lippenslaan 200,2023-05-19,04:00:00,14,2,12,FMN 15 Luitenant Lippenslaan
662,Luitenant Lippenslaan 200,2023-05-19,05:00:00,13,2,11,FMN 15 Luitenant Lippenslaan
662,Luitenant Lippenslaan 200,2023-05-19,06:00:00,41,9,32,FMN 15 Luitenant Lippenslaan
662,Luitenant Lippenslaan 200,2023-05-19,07:00:00,40,3,37,FMN 15 Luitenant Lippenslaan
662,Luitenant Lippenslaan 200,2023-05-19,08:00:00,96,7,89,FMN 15 Luitenant Lippenslaan
662,Luitenant Lippenslaan 200,2023-05-19,09:00:00,109,6,103,FMN 15 Luitenant Lippenslaan
662,Luitenant Lippenslaan 200,2023-05-19,10:00:00,95,11,84,FMN 15 Luitenant Lippenslaan
662,Luitenant Lippenslaan 200,2023-05-19,11:00:00,105,6,99,FMN 15 Luitenant Lippenslaan
662,Luitenant Lippenslaan 200,2023-05-19,12:00:00,93,14,79,FMN 15 Luitenant Lippenslaan
662,Luitenant Lippenslaan 200,2023-05-19,13:00:00,120,9,111,FMN 15 Luitenant Lippenslaan
662,Luitenant Lippenslaan 200,2023-05-19,14:00:00,125,12,113,FMN 15 Luitenant Lippenslaan
662,Luitenant Lippenslaan 200,2023-05-19,15:00:00,122,16,106,FMN 15 Luitenant Lippenslaan
662,Luitenant Lippenslaan 200,2023-05-19,16:00:00,118,11,107,FMN 15 Luitenant Lippenslaan
662,Luitenant Lippenslaan 200,2023-05-19,17:00:00,137,19,118,FMN 15 Luitenant Lippenslaan
662,Luitenant Lippenslaan 200,2023-05-19,18:00:00,116,15,101,FMN 15 Luitenant Lippenslaan
662,Luitenant Lippenslaan 200,2023-05-19,19:00:00,131,17,114,FMN 15 Luitenant Lippenslaan
662,Luitenant Lippenslaan 200,2023-05-19,20:00:00,73,10,63,FMN 15 Luitenant Lippenslaan
662,Luitenant Lippenslaan 200,2023-05-19,21:00:00,57,9,48,FMN 15 Luitenant Lippenslaan
662,Luitenant Lippenslaan 200,2023-05-19,22:00:00,37,6,31,FMN 15 Luitenant Lippenslaan
662,Luitenant Lippenslaan 200,2023-05-19,23:00:00,29,10,19,FMN 15 Luitenant Lippenslaan
662,Luitenant Lippenslaan 200,2023-05-20,00:00:00,28,9,19,FMN 15 Luitenant Lippenslaan
662,Luitenant Lippenslaan 200,2023-05-20,01:00:00,12,4,8,FMN 15 Luitenant Lippenslaan
662,Luitenant Lippenslaan 200,2023-05-20,02:00:00,6,4,2,FMN 15 Luitenant Lippenslaan
662,Luitenant Lippenslaan 200,2023-05-20,03:00:00,7,3,4,FMN 15 Luitenant Lippenslaan
662,Luitenant Lippenslaan 200,2023-05-20,04:00:00,12,2,10,FMN 15 Luitenant Lippenslaan
662,Luitenant Lippenslaan 200,2023-05-20,05:00:00,14,2,12,FMN 15 Luitenant Lippenslaan
662,Luitenant Lippenslaan 200,2023-05-20,06:00:00,17,4,13,FMN 15 Luitenant Lippenslaan
662,Luitenant Lippenslaan 200,2023-05-20,07:00:00,28,5,23,FMN 15 Luitenant Lippenslaan
662,Luitenant Lippenslaan 200,2023-05-20,08:00:00,55,8,47,FMN 15 Luitenant Lippenslaan
662,Luitenant Lippenslaan 200,2023-05-20,09:00:00,77,7,70,FMN 15 Luitenant Lippenslaan
662,Luitenant Lippenslaan 200,2023-05-20,10:00:00,105,7,98,FMN 15 Luitenant Lippenslaan
662,Luitenant Lippenslaan 200,2023-05-20,11:00:00,88,12,76,FMN 15 Luitenant Lippenslaan
662,Luitenant Lippenslaan 200,2023-05-20,12:00:00,114,9,105,FMN 15 Luitenant Lippenslaan
662,Luitenant Lippenslaan 200,2023-05-20,13:00:00,138,16,122,FMN 15 Luitenant Lippenslaan
662,Luitenant Lippenslaan 200,2023-05-20,14:00:00,133,15,118,FMN 15 Luitenant Lippenslaan
662,Luitenant Lippenslaan 200,2023-05-20,15:00:00,120,8,112,FMN 15 Luitenant Lippenslaan
662,Luitenant Lippenslaan 200,2023-05-20,16:00:00,111,10,101,FMN 15 Luitenant Lippenslaan
662,Luitenant Lippenslaan 200,2023-05-20,17:00:00,86,9,77,FMN 15 Luitenant Lippenslaan
662,Luitenant Lippenslaan 200,2023-05-20,18:00:00,100,21,79,FMN 15 Luitenant Lippenslaan
662,Luitenant Lippenslaan 200,2023-05-20,19:00:00,76,10,66,FMN 15 Luitenant Lippenslaan
662,Luitenant Lippenslaan 200,2023-05-20,20:00:00,79,10,69,FMN 15 Luitenant Lippenslaan
662,Luitenant Lippenslaan 200,2023-05-20,21:00:00,68,13,55,FMN 15 Luitenant Lippenslaan
662,Luitenant Lippenslaan 200,2023-05-20,22:00:00,37,7,30,FMN 15 Luitenant Lippenslaan
662,Luitenant Lippenslaan 200,2023-05-20,23:00:00,29,8,21,FMN 15 Luitenant Lippenslaan
662,Luitenant Lippenslaan 200,2023-05-21,00:00:00,20,6,14,FMN 15 Luitenant Lippenslaan
662,Luitenant Lippenslaan 200,2023-05-21,01:00:00,16,4,12,FMN 15 Luitenant Lippenslaan
662,Luitenant Lippenslaan 200,2023-05-21,02:00:00,10,2,8,FMN 15 Luitenant Lippenslaan
662,Luitenant Lippenslaan 200,2023-05-21,03:00:00,7,4,3,FMN 15 Luitenant Lippenslaan
662,Luitenant Lippenslaan 200,2023-05-21,04:00:00,6,3,3,FMN 15 Luitenant Lippenslaan
662,Luitenant Lippenslaan 200,2023-05-21,05:00:00,9,0,9,FMN 15 Luitenant Lippenslaan
662,Luitenant Lippenslaan 200,2023-05-21,06:00:00,13,7,6,FMN 15 Luitenant Lippenslaan
662,Luitenant Lippenslaan 200,2023-05-21,07:00:00,16,1,15,FMN 15 Luitenant Lippenslaan
662,Luitenant Lippenslaan 200,2023-05-21,08:00:00,38,2,36,FMN 15 Luitenant Lippenslaan
662,Luitenant Lippenslaan 200,2023-05-21,09:00:00,74,4,70,FMN 15 Luitenant Lippenslaan
662,Luitenant Lippenslaan 200,2023-05-21,10:00:00,81,12,69,FMN 15 Luitenant Lippenslaan
662,Luitenant Lippenslaan 200,2023-05-21,11:00:00,100,11,89,FMN 15 Luitenant Lippenslaan
662,Luitenant Lippenslaan 200,2023-05-21,12:00:00,106,10,96,FMN 15 Luitenant Lippenslaan
662,Luitenant Lippenslaan 200,2023-05-21,13:00:00,121,15,106,FMN 15 Luitenant Lippenslaan
662,Luitenant Lippenslaan 200,2023-05-21,14:00:00,120,19,101,FMN 15 Luitenant Lippenslaan
662,Luitenant Lippenslaan 200,2023-05-21,15:00:00,115,18,97,FMN 15 Luitenant Lippenslaan
662,Luitenant Lippenslaan 200,2023-05-21,16:00:00,106,15,91,FMN 15 Luitenant Lippenslaan
662,Luitenant Lippenslaan 200,2023-05-21,17:00:00,100,14,86,FMN 15 Luitenant Lippenslaan
662,Luitenant Lippenslaan 200,2023-05-21,18:00:00,122,19,103,FMN 15 Luitenant Lippenslaan
662,Luitenant Lippenslaan 200,2023-05-21,19:00:00,104,20,84,FMN 15 Luitenant Lippenslaan
662,Luitenant Lippenslaan 200,2023-05-21,20:00:00,78,15,63,FMN 15 Luitenant Lippenslaan
662,Luitenant Lippenslaan 200,2023-05-21,21:00:00,58,6,52,FMN 15 Luitenant Lippenslaan
662,Luitenant Lippenslaan 200,2023-05-21,22:00:00,35,11,24,FMN 15 Luitenant Lippenslaan
662,Luitenant Lippenslaan 200,2023-05-21,23:00:00,23,7,16,FMN 15 Luitenant Lippenslaan
662,Luitenant Lippenslaan 200,2023-05-22,00:00:00,12,6,6,FMN 15 Luitenant Lippenslaan
662,Luitenant Lippenslaan 200,2023-05-22,01:00:00,4,1,3,FMN 15 Luitenant Lippenslaan
662,Luitenant Lippenslaan 200,2023-05-22,02:00:00,7,4,3,FMN 15 Luitenant Lippenslaan
662,Luitenant Lippenslaan 200,2023-05-22,03:00:00,5,2,3,FMN 15 Luitenant Lippenslaan
662,Luitenant Lippenslaan 200,2023-05-22,04:00:00,14,5,9,FMN 15 Luitenant Lippenslaan
662,Luitenant Lippenslaan 200,2023-05-22,05:00:00,25,6,19,FMN 15 Luitenant Lippenslaan
662,Luitenant Lippenslaan 200,2023-05-22,06:00:00,75,10,65,FMN 15 Luitenant Lippenslaan
662,Luitenant Lippenslaan 200,2023-05-22,07:00:00,223,19,204,FMN 15 Luitenant Lippenslaan
662,Luitenant Lippenslaan 200,2023-05-22,08:00:00,448,31,417,FMN 15 Luitenant Lippenslaan
662,Luitenant Lippenslaan 200,2023-05-22,09:00:00,172,9,163,FMN 15 Luitenant Lippenslaan
662,Luitenant Lippenslaan 200,2023-05-22,10:00:00,88,11,77,FMN 15 Luitenant Lippenslaan
662,Luitenant Lippenslaan 200,2023-05-22,11:00:00,86,13,73,FMN 15 Luitenant Lippenslaan
662,Luitenant Lippenslaan 200,2023-05-22,12:00:00,91,12,79,FMN 15 Luitenant Lippenslaan
662,Luitenant Lippenslaan 200,2023-05-22,13:00:00,79,15,64,FMN 15 Luitenant Lippenslaan
662,Luitenant Lippenslaan 200,2023-05-22,14:00:00,111,17,94,FMN 15 Luitenant Lippenslaan
662,Luitenant Lippenslaan 200,2023-05-22,15:00:00,119,23,96,FMN 15 Luitenant Lippenslaan
662,Luitenant Lippenslaan 200,2023-05-22,16:00:00,145,25,120,FMN 15 Luitenant Lippenslaan
662,Luitenant Lippenslaan 200,2023-05-22,17:00:00,184,24,160,FMN 15 Luitenant Lippenslaan
662,Luitenant Lippenslaan 200,2023-05-22,18:00:00,146,22,124,FMN 15 Luitenant Lippenslaan
662,Luitenant Lippenslaan 200,2023-05-22,19:00:00,110,23,87,FMN 15 Luitenant Lippenslaan
662,Luitenant Lippenslaan 200,2023-05-22,20:00:00,83,20,63,FMN 15 Luitenant Lippenslaan
662,Luitenant Lippenslaan 200,2023-05-22,21:00:00,54,13,41,FMN 15 Luitenant Lippenslaan
662,Luitenant Lippenslaan 200,2023-05-22,22:00:00,60,13,47,FMN 15 Luitenant Lippenslaan
662,Luitenant Lippenslaan 200,2023-05-22,23:00:00,16,9,7,FMN 15 Luitenant Lippenslaan
662,Luitenant Lippenslaan 200,2023-05-23,00:00:00,6,4,2,FMN 15 Luitenant Lippenslaan
662,Luitenant Lippenslaan 200,2023-05-23,01:00:00,3,2,1,FMN 15 Luitenant Lippenslaan
662,Luitenant Lippenslaan 200,2023-05-23,02:00:00,7,6,1,FMN 15 Luitenant Lippenslaan
662,Luitenant Lippenslaan 200,2023-05-23,03:00:00,4,2,2,FMN 15 Luitenant Lippenslaan
662,Luitenant Lippenslaan 200,2023-05-23,04:00:00,14,5,9,FMN 15 Luitenant Lippenslaan
662,Luitenant Lippenslaan 200,2023-05-23,05:00:00,24,8,16,FMN 15 Luitenant Lippenslaan
662,Luitenant Lippenslaan 200,2023-05-23,06:00:00,70,8,62,FMN 15 Luitenant Lippenslaan
662,Luitenant Lippenslaan 200,2023-05-23,07:00:00,220,9,211,FMN 15 Luitenant Lippenslaan
662,Luitenant Lippenslaan 200,2023-05-23,08:00:00,520,35,485,FMN 15 Luitenant Lippenslaan
662,Luitenant Lippenslaan 200,2023-05-23,09:00:00,187,13,174,FMN 15 Luitenant Lippenslaan
662,Luitenant Lippenslaan 200,2023-05-23,10:00:00,103,16,87,FMN 15 Luitenant Lippenslaan
662,Luitenant Lippenslaan 200,2023-05-23,11:00:00,68,13,55,FMN 15 Luitenant Lippenslaan
662,Luitenant Lippenslaan 200,2023-05-23,12:00:00,108,16,92,FMN 15 Luitenant Lippenslaan
662,Luitenant Lippenslaan 200,2023-05-23,13:00:00,97,16,81,FMN 15 Luitenant Lippenslaan
662,Luitenant Lippenslaan 200,2023-05-23,14:00:00,84,12,72,FMN 15 Luitenant Lippenslaan
662,Luitenant Lippenslaan 200,2023-05-23,15:00:00,87,15,72,FMN 15 Luitenant Lippenslaan
662,Luitenant Lippenslaan 200,2023-05-23,16:00:00,158,39,119,FMN 15 Luitenant Lippenslaan
662,Luitenant Lippenslaan 200,2023-05-23,17:00:00,149,21,128,FMN 15 Luitenant Lippenslaan
662,Luitenant Lippenslaan 200,2023-05-23,18:00:00,136,21,115,FMN 15 Luitenant Lippenslaan
662,Luitenant Lippenslaan 200,2023-05-23,19:00:00,105,14,91,FMN 15 Luitenant Lippenslaan
662,Luitenant Lippenslaan 200,2023-05-23,20:00:00,78,14,64,FMN 15 Luitenant Lippenslaan
662,Luitenant Lippenslaan 200,2023-05-23,21:00:00,64,8,56,FMN 15 Luitenant Lippenslaan
662,Luitenant Lippenslaan 200,2023-05-23,22:00:00,45,9,36,FMN 15 Luitenant Lippenslaan
662,Luitenant Lippenslaan 200,2023-05-23,23:00:00,18,4,14,FMN 15 Luitenant Lippenslaan
662,Luitenant Lippenslaan 200,2023-05-24,00:00:00,15,8,7,FMN 15 Luitenant Lippenslaan
662,Luitenant Lippenslaan 200,2023-05-24,01:00:00,4,3,1,FMN 15 Luitenant Lippenslaan
662,Luitenant Lippenslaan 200,2023-05-24,02:00:00,3,2,1,FMN 15 Luitenant Lippenslaan
662,Luitenant Lippenslaan 200,2023-05-24,03:00:00,2,0,2,FMN 15 Luitenant Lippenslaan
662,Luitenant Lippenslaan 200,2023-05-24,04:00:00,15,5,10,FMN 15 Luitenant Lippenslaan
662,Luitenant Lippenslaan 200,2023-05-24,05:00:00,26,6,20,FMN 15 Luitenant Lippenslaan
662,Luitenant Lippenslaan 200,2023-05-24,06:00:00,75,13,62,FMN 15 Luitenant Lippenslaan
662,Luitenant Lippenslaan 200,2023-05-24,07:00:00,205,18,187,FMN 15 Luitenant Lippenslaan
662,Luitenant Lippenslaan 200,2023-05-24,08:00:00,399,21,378,FMN 15 Luitenant Lippenslaan
662,Luitenant Lippenslaan 200,2023-05-24,09:00:00,146,10,136,FMN 15 Luitenant Lippenslaan
662,Luitenant Lippenslaan 200,2023-05-24,10:00:00,105,8,97,FMN 15 Luitenant Lippenslaan
662,Luitenant Lippenslaan 200,2023-05-24,11:00:00,60,11,49,FMN 15 Luitenant Lippenslaan
662,Luitenant Lippenslaan 200,2023-05-24,12:00:00,149,25,124,FMN 15 Luitenant Lippenslaan
662,Luitenant Lippenslaan 200,2023-05-24,13:00:00,123,12,111,FMN 15 Luitenant Lippenslaan
662,Luitenant Lippenslaan 200,2023-05-24,14:00:00,104,17,87,FMN 15 Luitenant Lippenslaan
662,Luitenant Lippenslaan 200,2023-05-24,15:00:00,115,17,98,FMN 15 Luitenant Lippenslaan
662,Luitenant Lippenslaan 200,2023-05-24,16:00:00,130,11,119,FMN 15 Luitenant Lippenslaan
662,Luitenant Lippenslaan 200,2023-05-24,17:00:00,177,19,158,FMN 15 Luitenant Lippenslaan
662,Luitenant Lippenslaan 200,2023-05-24,18:00:00,149,22,127,FMN 15 Luitenant Lippenslaan
662,Luitenant Lippenslaan 200,2023-05-24,19:00:00,126,14,112,FMN 15 Luitenant Lippenslaan
662,Luitenant Lippenslaan 200,2023-05-24,20:00:00,61,13,48,FMN 15 Luitenant Lippenslaan
662,Luitenant Lippenslaan 200,2023-05-24,21:00:00,41,12,29,FMN 15 Luitenant Lippenslaan
662,Luitenant Lippenslaan 200,2023-05-24,22:00:00,47,15,32,FMN 15 Luitenant Lippenslaan
662,Luitenant Lippenslaan 200,2023-05-24,23:00:00,34,9,25,FMN 15 Luitenant Lippenslaan
662,Luitenant Lippenslaan 200,2023-05-25,00:00:00,11,4,7,FMN 15 Luitenant Lippenslaan
662,Luitenant Lippenslaan 200,2023-05-25,01:00:00,5,1,4,FMN 15 Luitenant Lippenslaan
662,Luitenant Lippenslaan 200,2023-05-25,02:00:00,8,5,3,FMN 15 Luitenant Lippenslaan
662,Luitenant Lippenslaan 200,2023-05-25,03:00:00,2,1,1,FMN 15 Luitenant Lippenslaan
662,Luitenant Lippenslaan 200,2023-05-25,04:00:00,11,3,8,FMN 15 Luitenant Lippenslaan
662,Luitenant Lippenslaan 200,2023-05-25,05:00:00,26,6,20,FMN 15 Luitenant Lippenslaan
662,Luitenant Lippenslaan 200,2023-05-25,06:00:00,67,9,58,FMN 15 Luitenant Lippenslaan
662,Luitenant Lippenslaan 200,2023-05-25,07:00:00,237,14,223,FMN 15 Luitenant Lippenslaan
662,Luitenant Lippenslaan 200,2023-05-25,08:00:00,471,33,438,FMN 15 Luitenant Lippenslaan
662,Luitenant Lippenslaan 200,2023-05-25,09:00:00,151,10,141,FMN 15 Luitenant Lippenslaan
662,Luitenant Lippenslaan 200,2023-05-25,10:00:00,105,9,96,FMN 15 Luitenant Lippenslaan
662,Luitenant Lippenslaan 200,2023-05-25,11:00:00,77,10,67,FMN 15 Luitenant Lippenslaan
662,Luitenant Lippenslaan 200,2023-05-25,12:00:00,106,14,92,FMN 15 Luitenant Lippenslaan
662,Luitenant Lippenslaan 200,2023-05-25,13:00:00,92,13,79,FMN 15 Luitenant Lippenslaan
662,Luitenant Lippenslaan 200,2023-05-25,14:00:00,102,12,90,FMN 15 Luitenant Lippenslaan
662,Luitenant Lippenslaan 200,2023-05-25,15:00:00,109,19,90,FMN 15 Luitenant Lippenslaan
662,Luitenant Lippenslaan 200,2023-05-25,16:00:00,158,26,132,FMN 15 Luitenant Lippenslaan
662,Luitenant Lippenslaan 200,2023-05-25,17:00:00,156,21,135,FMN 15 Luitenant Lippenslaan
662,Luitenant Lippenslaan 200,2023-05-25,18:00:00,182,26,156,FMN 15 Luitenant Lippenslaan
662,Luitenant Lippenslaan 200,2023-05-25,19:00:00,153,26,127,FMN 15 Luitenant Lippenslaan
662,Luitenant Lippenslaan 200,2023-05-25,20:00:00,95,14,81,FMN 15 Luitenant Lippenslaan
662,Luitenant Lippenslaan 200,2023-05-25,21:00:00,68,19,49,FMN 15 Luitenant Lippenslaan
662,Luitenant Lippenslaan 200,2023-05-25,22:00:00,41,8,33,FMN 15 Luitenant Lippenslaan
662,Luitenant Lippenslaan 200,2023-05-25,23:00:00,25,6,19,FMN 15 Luitenant Lippenslaan
662,Luitenant Lippenslaan 200,2023-05-26,00:00:00,16,7,9,FMN 15 Luitenant Lippenslaan
662,Luitenant Lippenslaan 200,2023-05-26,01:00:00,10,6,4,FMN 15 Luitenant Lippenslaan
662,Luitenant Lippenslaan 200,2023-05-26,02:00:00,3,1,2,FMN 15 Luitenant Lippenslaan
662,Luitenant Lippenslaan 200,2023-05-26,03:00:00,3,1,2,FMN 15 Luitenant Lippenslaan
662,Luitenant Lippenslaan 200,2023-05-26,04:00:00,9,2,7,FMN 15 Luitenant Lippenslaan
662,Luitenant Lippenslaan 200,2023-05-26,05:00:00,23,5,18,FMN 15 Luitenant Lippenslaan
662,Luitenant Lippenslaan 200,2023-05-26,06:00:00,56,12,44,FMN 15 Luitenant Lippenslaan
662,Luitenant Lippenslaan 200,2023-05-26,07:00:00,194,14,180,FMN 15 Luitenant Lippenslaan
662,Luitenant Lippenslaan 200,2023-05-26,08:00:00,406,27,379,FMN 15 Luitenant Lippenslaan
662,Luitenant Lippenslaan 200,2023-05-26,09:00:00,171,17,154,FMN 15 Luitenant Lippenslaan
662,Luitenant Lippenslaan 200,2023-05-26,10:00:00,104,10,94,FMN 15 Luitenant Lippenslaan
662,Luitenant Lippenslaan 200,2023-05-26,11:00:00,109,17,92,FMN 15 Luitenant Lippenslaan
662,Luitenant Lippenslaan 200,2023-05-26,12:00:00,108,14,94,FMN 15 Luitenant Lippenslaan
662,Luitenant Lippenslaan 200,2023-05-26,13:00:00,108,10,98,FMN 15 Luitenant Lippenslaan
662,Luitenant Lippenslaan 200,2023-05-26,14:00:00,109,17,92,FMN 15 Luitenant Lippenslaan
662,Luitenant Lippenslaan 200,2023-05-26,15:00:00,141,30,111,FMN 15 Luitenant Lippenslaan
662,Luitenant Lippenslaan 200,2023-05-26,16:00:00,174,23,151,FMN 15 Luitenant Lippenslaan
662,Luitenant Lippenslaan 200,2023-05-26,17:00:00,171,17,154,FMN 15 Luitenant Lippenslaan
662,Luitenant Lippenslaan 200,2023-05-26,18:00:00,155,18,137,FMN 15 Luitenant Lippenslaan
662,Luitenant Lippenslaan 200,2023-05-26,19:00:00,124,13,111,FMN 15 Luitenant Lippenslaan
662,Luitenant Lippenslaan 200,2023-05-26,20:00:00,107,23,84,FMN 15 Luitenant Lippenslaan
662,Luitenant Lippenslaan 200,2023-05-26,21:00:00,70,7,63,FMN 15 Luitenant Lippenslaan
662,Luitenant Lippenslaan 200,2023-05-26,22:00:00,47,17,30,FMN 15 Luitenant Lippenslaan
662,Luitenant Lippenslaan 200,2023-05-26,23:00:00,43,6,37,FMN 15 Luitenant Lippenslaan
662,Luitenant Lippenslaan 200,2023-05-27,00:00:00,25,11,14,FMN 15 Luitenant Lippenslaan
662,Luitenant Lippenslaan 200,2023-05-27,01:00:00,17,4,13,FMN 15 Luitenant Lippenslaan
662,Luitenant Lippenslaan 200,2023-05-27,02:00:00,5,3,2,FMN 15 Luitenant Lippenslaan
662,Luitenant Lippenslaan 200,2023-05-27,03:00:00,2,1,1,FMN 15 Luitenant Lippenslaan
662,Luitenant Lippenslaan 200,2023-05-27,04:00:00,7,2,5,FMN 15 Luitenant Lippenslaan
662,Luitenant Lippenslaan 200,2023-05-27,05:00:00,10,2,8,FMN 15 Luitenant Lippenslaan
662,Luitenant Lippenslaan 200,2023-05-27,06:00:00,23,6,17,FMN 15 Luitenant Lippenslaan
662,Luitenant Lippenslaan 200,2023-05-27,07:00:00,24,3,21,FMN 15 Luitenant Lippenslaan
662,Luitenant Lippenslaan 200,2023-05-27,08:00:00,55,5,50,FMN 15 Luitenant Lippenslaan
662,Luitenant Lippenslaan 200,2023-05-27,09:00:00,101,9,92,FMN 15 Luitenant Lippenslaan
662,Luitenant Lippenslaan 200,2023-05-27,10:00:00,119,10,109,FMN 15 Luitenant Lippenslaan
662,Luitenant Lippenslaan 200,2023-05-27,11:00:00,123,10,113,FMN 15 Luitenant Lippenslaan
662,Luitenant Lippenslaan 200,2023-05-27,12:00:00,122,7,115,FMN 15 Luitenant Lippenslaan
662,Luitenant Lippenslaan 200,2023-05-27,13:00:00,145,7,138,FMN 15 Luitenant Lippenslaan
662,Luitenant Lippenslaan 200,2023-05-27,14:00:00,148,10,138,FMN 15 Luitenant Lippenslaan
662,Luitenant Lippenslaan 200,2023-05-27,15:00:00,137,11,126,FMN 15 Luitenant Lippenslaan
662,Luitenant Lippenslaan 200,2023-05-27,16:00:00,111,11,100,FMN 15 Luitenant Lippenslaan
662,Luitenant Lippenslaan 200,2023-05-27,17:00:00,111,15,96,FMN 15 Luitenant Lippenslaan
662,Luitenant Lippenslaan 200,2023-05-27,18:00:00,129,10,119,FMN 15 Luitenant Lippenslaan
662,Luitenant Lippenslaan 200,2023-05-27,19:00:00,108,18,90,FMN 15 Luitenant Lippenslaan
662,Luitenant Lippenslaan 200,2023-05-27,20:00:00,96,6,90,FMN 15 Luitenant Lippenslaan
662,Luitenant Lippenslaan 200,2023-05-27,21:00:00,68,10,58,FMN 15 Luitenant Lippenslaan
662,Luitenant Lippenslaan 200,2023-05-27,22:00:00,75,10,65,FMN 15 Luitenant Lippenslaan
662,Luitenant Lippenslaan 200,2023-05-27,23:00:00,40,10,30,FMN 15 Luitenant Lippenslaan
662,Luitenant Lippenslaan 200,2023-05-28,00:00:00,30,4,26,FMN 15 Luitenant Lippenslaan
662,Luitenant Lippenslaan 200,2023-05-28,01:00:00,8,0,8,FMN 15 Luitenant Lippenslaan
662,Luitenant Lippenslaan 200,2023-05-28,02:00:00,13,2,11,FMN 15 Luitenant Lippenslaan
662,Luitenant Lippenslaan 200,2023-05-28,03:00:00,5,3,2,FMN 15 Luitenant Lippenslaan
662,Luitenant Lippenslaan 200,2023-05-28,04:00:00,7,2,5,FMN 15 Luitenant Lippenslaan
662,Luitenant Lippenslaan 200,2023-05-28,05:00:00,10,3,7,FMN 15 Luitenant Lippenslaan
662,Luitenant Lippenslaan 200,2023-05-28,06:00:00,23,4,19,FMN 15 Luitenant Lippenslaan
662,Luitenant Lippenslaan 200,2023-05-28,07:00:00,21,4,17,FMN 15 Luitenant Lippenslaan
662,Luitenant Lippenslaan 200,2023-05-28,08:00:00,31,1,30,FMN 15 Luitenant Lippenslaan
662,Luitenant Lippenslaan 200,2023-05-28,09:00:00,67,7,60,FMN 15 Luitenant Lippenslaan
662,Luitenant Lippenslaan 200,2023-05-28,10:00:00,103,16,87,FMN 15 Luitenant Lippenslaan
662,Luitenant Lippenslaan 200,2023-05-28,11:00:00,89,15,74,FMN 15 Luitenant Lippenslaan
662,Luitenant Lippenslaan 200,2023-05-28,12:00:00,89,13,76,FMN 15 Luitenant Lippenslaan
662,Luitenant Lippenslaan 200,2023-05-28,13:00:00,93,10,83,FMN 15 Luitenant Lippenslaan
662,Luitenant Lippenslaan 200,2023-05-28,14:00:00,121,8,113,FMN 15 Luitenant Lippenslaan
662,Luitenant Lippenslaan 200,2023-05-28,15:00:00,92,7,85,FMN 15 Luitenant Lippenslaan
662,Luitenant Lippenslaan 200,2023-05-28,16:00:00,115,14,101,FMN 15 Luitenant Lippenslaan
662,Luitenant Lippenslaan 200,2023-05-28,17:00:00,123,16,107,FMN 15 Luitenant Lippenslaan
662,Luitenant Lippenslaan 200,2023-05-28,18:00:00,124,9,115,FMN 15 Luitenant Lippenslaan
662,Luitenant Lippenslaan 200,2023-05-28,19:00:00,75,5,70,FMN 15 Luitenant Lippenslaan
662,Luitenant Lippenslaan 200,2023-05-28,20:00:00,83,13,70,FMN 15 Luitenant Lippenslaan
662,Luitenant Lippenslaan 200,2023-05-28,21:00:00,66,11,55,FMN 15 Luitenant Lippenslaan
662,Luitenant Lippenslaan 200,2023-05-28,22:00:00,51,10,41,FMN 15 Luitenant Lippenslaan
662,Luitenant Lippenslaan 200,2023-05-28,23:00:00,26,5,21,FMN 15 Luitenant Lippenslaan
662,Luitenant Lippenslaan 200,2023-05-29,00:00:00,30,7,23,FMN 15 Luitenant Lippenslaan
662,Luitenant Lippenslaan 200,2023-05-29,01:00:00,14,2,12,FMN 15 Luitenant Lippenslaan
662,Luitenant Lippenslaan 200,2023-05-29,02:00:00,8,1,7,FMN 15 Luitenant Lippenslaan
662,Luitenant Lippenslaan 200,2023-05-29,03:00:00,5,1,4,FMN 15 Luitenant Lippenslaan
662,Luitenant Lippenslaan 200,2023-05-29,04:00:00,9,2,7,FMN 15 Luitenant Lippenslaan
662,Luitenant Lippenslaan 200,2023-05-29,05:00:00,7,1,6,FMN 15 Luitenant Lippenslaan
662,Luitenant Lippenslaan 200,2023-05-29,06:00:00,19,4,15,FMN 15 Luitenant Lippenslaan
662,Luitenant Lippenslaan 200,2023-05-29,07:00:00,19,2,17,FMN 15 Luitenant Lippenslaan
662,Luitenant Lippenslaan 200,2023-05-29,08:00:00,20,1,19,FMN 15 Luitenant Lippenslaan
662,Luitenant Lippenslaan 200,2023-05-29,09:00:00,55,4,51,FMN 15 Luitenant Lippenslaan
662,Luitenant Lippenslaan 200,2023-05-29,10:00:00,83,7,76,FMN 15 Luitenant Lippenslaan
662,Luitenant Lippenslaan 200,2023-05-29,11:00:00,72,10,62,FMN 15 Luitenant Lippenslaan
662,Luitenant Lippenslaan 200,2023-05-29,12:00:00,100,16,84,FMN 15 Luitenant Lippenslaan
662,Luitenant Lippenslaan 200,2023-05-29,13:00:00,114,11,103,FMN 15 Luitenant Lippenslaan
662,Luitenant Lippenslaan 200,2023-05-29,14:00:00,101,20,81,FMN 15 Luitenant Lippenslaan
662,Luitenant Lippenslaan 200,2023-05-29,15:00:00,90,9,81,FMN 15 Luitenant Lippenslaan
662,Luitenant Lippenslaan 200,2023-05-29,16:00:00,91,7,84,FMN 15 Luitenant Lippenslaan
662,Luitenant Lippenslaan 200,2023-05-29,17:00:00,116,14,102,FMN 15 Luitenant Lippenslaan
662,Luitenant Lippenslaan 200,2023-05-29,18:00:00,131,14,117,FMN 15 Luitenant Lippenslaan
662,Luitenant Lippenslaan 200,2023-05-29,19:00:00,102,11,91,FMN 15 Luitenant Lippenslaan
662,Luitenant Lippenslaan 200,2023-05-29,20:00:00,68,12,56,FMN 15 Luitenant Lippenslaan
662,Luitenant Lippenslaan 200,2023-05-29,21:00:00,57,9,48,FMN 15 Luitenant Lippenslaan
662,Luitenant Lippenslaan 200,2023-05-29,22:00:00,48,12,36,FMN 15 Luitenant Lippenslaan
662,Luitenant Lippenslaan 200,2023-05-29,23:00:00,24,7,17,FMN 15 Luitenant Lippenslaan
662,Luitenant Lippenslaan 200,2023-05-30,00:00:00,10,2,8,FMN 15 Luitenant Lippenslaan
662,Luitenant Lippenslaan 200,2023-05-30,01:00:00,4,1,3,FMN 15 Luitenant Lippenslaan
662,Luitenant Lippenslaan 200,2023-05-30,02:00:00,5,3,2,FMN 15 Luitenant Lippenslaan
662,Luitenant Lippenslaan 200,2023-05-30,03:00:00,5,3,2,FMN 15 Luitenant Lippenslaan
662,Luitenant Lippenslaan 200,2023-05-30,04:00:00,13,3,10,FMN 15 Luitenant Lippenslaan
662,Luitenant Lippenslaan 200,2023-05-30,05:00:00,24,2,22,FMN 15 Luitenant Lippenslaan
662,Luitenant Lippenslaan 200,2023-05-30,06:00:00,83,11,72,FMN 15 Luitenant Lippenslaan
662,Luitenant Lippenslaan 200,2023-05-30,07:00:00,228,12,216,FMN 15 Luitenant Lippenslaan
662,Luitenant Lippenslaan 200,2023-05-30,08:00:00,466,19,447,FMN 15 Luitenant Lippenslaan
662,Luitenant Lippenslaan 200,2023-05-30,09:00:00,170,20,150,FMN 15 Luitenant Lippenslaan
662,Luitenant Lippenslaan 200,2023-05-30,10:00:00,97,12,85,FMN 15 Luitenant Lippenslaan
662,Luitenant Lippenslaan 200,2023-05-30,11:00:00,82,11,71,FMN 15 Luitenant Lippenslaan
662,Luitenant Lippenslaan 200,2023-05-30,12:00:00,126,23,103,FMN 15 Luitenant Lippenslaan
662,Luitenant Lippenslaan 200,2023-05-30,13:00:00,104,10,94,FMN 15 Luitenant Lippenslaan
662,Luitenant Lippenslaan 200,2023-05-30,14:00:00,92,12,80,FMN 15 Luitenant Lippenslaan
662,Luitenant Lippenslaan 200,2023-05-30,15:00:00,117,19,98,FMN 15 Luitenant Lippenslaan
662,Luitenant Lippenslaan 200,2023-05-30,16:00:00,158,29,129,FMN 15 Luitenant Lippenslaan
662,Luitenant Lippenslaan 200,2023-05-30,17:00:00,162,16,146,FMN 15 Luitenant Lippenslaan
662,Luitenant Lippenslaan 200,2023-05-30,18:00:00,172,24,148,FMN 15 Luitenant Lippenslaan
662,Luitenant Lippenslaan 200,2023-05-30,19:00:00,122,10,112,FMN 15 Luitenant Lippenslaan
662,Luitenant Lippenslaan 200,2023-05-30,20:00:00,78,10,68,FMN 15 Luitenant Lippenslaan
662,Luitenant Lippenslaan 200,2023-05-30,21:00:00,68,14,54,FMN 15 Luitenant Lippenslaan
662,Luitenant Lippenslaan 200,2023-05-30,22:00:00,44,11,33,FMN 15 Luitenant Lippenslaan
662,Luitenant Lippenslaan 200,2023-05-30,23:00:00,33,10,23,FMN 15 Luitenant Lippenslaan
662,Luitenant Lippenslaan 200,2023-05-31,00:00:00,15,11,4,FMN 15 Luitenant Lippenslaan
662,Luitenant Lippenslaan 200,2023-05-31,01:00:00,11,4,7,FMN 15 Luitenant Lippenslaan
662,Luitenant Lippenslaan 200,2023-05-31,02:00:00,5,2,3,FMN 15 Luitenant Lippenslaan
662,Luitenant Lippenslaan 200,2023-05-31,03:00:00,6,2,4,FMN 15 Luitenant Lippenslaan
662,Luitenant Lippenslaan 200,2023-05-31,04:00:00,11,3,8,FMN 15 Luitenant Lippenslaan
662,Luitenant Lippenslaan 200,2023-05-31,05:00:00,25,1,24,FMN 15 Luitenant Lippenslaan
662,Luitenant Lippenslaan 200,2023-05-31,06:00:00,87,11,76,FMN 15 Luitenant Lippenslaan
662,Luitenant Lippenslaan 200,2023-05-31,07:00:00,223,10,213,FMN 15 Luitenant Lippenslaan
662,Luitenant Lippenslaan 200,2023-05-31,08:00:00,415,18,397,FMN 15 Luitenant Lippenslaan
662,Luitenant Lippenslaan 200,2023-05-31,09:00:00,170,18,152,FMN 15 Luitenant Lippenslaan
662,Luitenant Lippenslaan 200,2023-05-31,10:00:00,101,10,91,FMN 15 Luitenant Lippenslaan
662,Luitenant Lippenslaan 200,2023-05-31,11:00:00,98,14,84,FMN 15 Luitenant Lippenslaan
662,Luitenant Lippenslaan 200,2023-05-31,12:00:00,149,24,125,FMN 15 Luitenant Lippenslaan
662,Luitenant Lippenslaan 200,2023-05-31,13:00:00,148,18,130,FMN 15 Luitenant Lippenslaan
662,Luitenant Lippenslaan 200,2023-05-31,14:00:00,106,13,93,FMN 15 Luitenant Lippenslaan
662,Luitenant Lippenslaan 200,2023-05-31,15:00:00,125,15,110,FMN 15 Luitenant Lippenslaan
662,Luitenant Lippenslaan 200,2023-05-31,16:00:00,145,13,132,FMN 15 Luitenant Lippenslaan
662,Luitenant Lippenslaan 200,2023-05-31,17:00:00,192,23,169,FMN 15 Luitenant Lippenslaan
662,Luitenant Lippenslaan 200,2023-05-31,18:00:00,166,19,147,FMN 15 Luitenant Lippenslaan
662,Luitenant Lippenslaan 200,2023-05-31,19:00:00,166,23,143,FMN 15 Luitenant Lippenslaan
662,Luitenant Lippenslaan 200,2023-05-31,20:00:00,93,10,83,FMN 15 Luitenant Lippenslaan
662,Luitenant Lippenslaan 200,2023-05-31,21:00:00,54,13,41,FMN 15 Luitenant Lippenslaan
662,Luitenant Lippenslaan 200,2023-05-31,22:00:00,69,18,51,FMN 15 Luitenant Lippenslaan
662,Luitenant Lippenslaan 200,2023-05-31,23:00:00,22,8,14,FMN 15 Luitenant Lippenslaan
662,Luitenant Lippenslaan 200,2023-06-01,00:00:00,19,8,11,FMN 15 Luitenant Lippenslaan
662,Luitenant Lippenslaan 200,2023-06-01,01:00:00,5,2,3,FMN 15 Luitenant Lippenslaan
662,Luitenant Lippenslaan 200,2023-06-01,02:00:00,7,3,4,FMN 15 Luitenant Lippenslaan
662,Luitenant Lippenslaan 200,2023-06-01,03:00:00,5,3,2,FMN 15 Luitenant Lippenslaan
662,Luitenant Lippenslaan 200,2023-06-01,04:00:00,10,3,7,FMN 15 Luitenant Lippenslaan
662,Luitenant Lippenslaan 200,2023-06-01,05:00:00,27,6,21,FMN 15 Luitenant Lippenslaan
662,Luitenant Lippenslaan 200,2023-06-01,06:00:00,84,14,70,FMN 15 Luitenant Lippenslaan
662,Luitenant Lippenslaan 200,2023-06-01,07:00:00,241,15,226,FMN 15 Luitenant Lippenslaan
662,Luitenant Lippenslaan 200,2023-06-01,08:00:00,459,18,441,FMN 15 Luitenant Lippenslaan
662,Luitenant Lippenslaan 200,2023-06-01,09:00:00,167,14,153,FMN 15 Luitenant Lippenslaan
662,Luitenant Lippenslaan 200,2023-06-01,10:00:00,99,9,90,FMN 15 Luitenant Lippenslaan
662,Luitenant Lippenslaan 200,2023-06-01,11:00:00,77,8,69,FMN 15 Luitenant Lippenslaan
662,Luitenant Lippenslaan 200,2023-06-01,12:00:00,122,16,106,FMN 15 Luitenant Lippenslaan
662,Luitenant Lippenslaan 200,2023-06-01,13:00:00,96,13,83,FMN 15 Luitenant Lippenslaan
662,Luitenant Lippenslaan 200,2023-06-01,14:00:00,92,13,79,FMN 15 Luitenant Lippenslaan
662,Luitenant Lippenslaan 200,2023-06-01,15:00:00,144,25,119,FMN 15 Luitenant Lippenslaan
662,Luitenant Lippenslaan 200,2023-06-01,16:00:00,151,24,127,FMN 15 Luitenant Lippenslaan
662,Luitenant Lippenslaan 200,2023-06-01,17:00:00,197,23,174,FMN 15 Luitenant Lippenslaan
662,Luitenant Lippenslaan 200,2023-06-01,18:00:00,173,22,151,FMN 15 Luitenant Lippenslaan
662,Luitenant Lippenslaan 200,2023-06-01,19:00:00,121,29,92,FMN 15 Luitenant Lippenslaan
662,Luitenant Lippenslaan 200,2023-06-01,20:00:00,92,22,70,FMN 15 Luitenant Lippenslaan
662,Luitenant Lippenslaan 200,2023-06-01,21:00:00,63,13,50,FMN 15 Luitenant Lippenslaan
662,Luitenant Lippenslaan 200,2023-06-01,22:00:00,55,15,40,FMN 15 Luitenant Lippenslaan
662,Luitenant Lippenslaan 200,2023-06-01,23:00:00,33,15,18,FMN 15 Luitenant Lippenslaan
662,Luitenant Lippenslaan 200,2023-06-02,00:00:00,15,8,7,FMN 15 Luitenant Lippenslaan
662,Luitenant Lippenslaan 200,2023-06-02,01:00:00,4,2,2,FMN 15 Luitenant Lippenslaan
662,Luitenant Lippenslaan 200,2023-06-02,02:00:00,4,3,1,FMN 15 Luitenant Lippenslaan
662,Luitenant Lippenslaan 200,2023-06-02,03:00:00,6,3,3,FMN 15 Luitenant Lippenslaan
662,Luitenant Lippenslaan 200,2023-06-02,04:00:00,6,2,4,FMN 15 Luitenant Lippenslaan
662,Luitenant Lippenslaan 200,2023-06-02,05:00:00,25,2,23,FMN 15 Luitenant Lippenslaan
662,Luitenant Lippenslaan 200,2023-06-02,06:00:00,74,13,61,FMN 15 Luitenant Lippenslaan
662,Luitenant Lippenslaan 200,2023-06-02,07:00:00,216,14,202,FMN 15 Luitenant Lippenslaan
662,Luitenant Lippenslaan 200,2023-06-02,08:00:00,393,23,370,FMN 15 Luitenant Lippenslaan
662,Luitenant Lippenslaan 200,2023-06-02,09:00:00,162,8,154,FMN 15 Luitenant Lippenslaan
662,Luitenant Lippenslaan 200,2023-06-02,10:00:00,90,9,81,FMN 15 Luitenant Lippenslaan
662,Luitenant Lippenslaan 200,2023-06-02,11:00:00,77,8,69,FMN 15 Luitenant Lippenslaan
662,Luitenant Lippenslaan 200,2023-06-02,12:00:00,98,13,85,FMN 15 Luitenant Lippenslaan
662,Luitenant Lippenslaan 200,2023-06-02,13:00:00,102,18,84,FMN 15 Luitenant Lippenslaan
662,Luitenant Lippenslaan 200,2023-06-02,14:00:00,144,22,122,FMN 15 Luitenant Lippenslaan
662,Luitenant Lippenslaan 200,2023-06-02,15:00:00,143,32,111,FMN 15 Luitenant Lippenslaan
662,Luitenant Lippenslaan 200,2023-06-02,16:00:00,167,28,139,FMN 15 Luitenant Lippenslaan
662,Luitenant Lippenslaan 200,2023-06-02,17:00:00,209,15,194,FMN 15 Luitenant Lippenslaan
662,Luitenant Lippenslaan 200,2023-06-02,18:00:00,159,18,141,FMN 15 Luitenant Lippenslaan
662,Luitenant Lippenslaan 200,2023-06-02,19:00:00,146,17,129,FMN 15 Luitenant Lippenslaan
662,Luitenant Lippenslaan 200,2023-06-02,20:00:00,82,20,62,FMN 15 Luitenant Lippenslaan
662,Luitenant Lippenslaan 200,2023-06-02,21:00:00,68,10,58,FMN 15 Luitenant Lippenslaan
662,Luitenant Lippenslaan 200,2023-06-02,22:00:00,59,13,46,FMN 15 Luitenant Lippenslaan
662,Luitenant Lippenslaan 200,2023-06-02,23:00:00,48,11,37,FMN 15 Luitenant Lippenslaan
662,Luitenant Lippenslaan 200,2023-06-03,00:00:00,26,8,18,FMN 15 Luitenant Lippenslaan
662,Luitenant Lippenslaan 200,2023-06-03,01:00:00,21,7,14,FMN 15 Luitenant Lippenslaan
662,Luitenant Lippenslaan 200,2023-06-03,02:00:00,11,4,7,FMN 15 Luitenant Lippenslaan
662,Luitenant Lippenslaan 200,2023-06-03,03:00:00,8,1,7,FMN 15 Luitenant Lippenslaan
662,Luitenant Lippenslaan 200,2023-06-03,04:00:00,15,6,9,FMN 15 Luitenant Lippenslaan
662,Luitenant Lippenslaan 200,2023-06-03,05:00:00,15,2,13,FMN 15 Luitenant Lippenslaan
662,Luitenant Lippenslaan 200,2023-06-03,06:00:00,22,4,18,FMN 15 Luitenant Lippenslaan
662,Luitenant Lippenslaan 200,2023-06-03,07:00:00,35,8,27,FMN 15 Luitenant Lippenslaan
662,Luitenant Lippenslaan 200,2023-06-03,08:00:00,50,10,40,FMN 15 Luitenant Lippenslaan
662,Luitenant Lippenslaan 200,2023-06-03,09:00:00,108,9,99,FMN 15 Luitenant Lippenslaan
662,Luitenant Lippenslaan 200,2023-06-03,10:00:00,118,12,106,FMN 15 Luitenant Lippenslaan
662,Luitenant Lippenslaan 200,2023-06-03,11:00:00,116,10,106,FMN 15 Luitenant Lippenslaan
662,Luitenant Lippenslaan 200,2023-06-03,12:00:00,107,3,104,FMN 15 Luitenant Lippenslaan
662,Luitenant Lippenslaan 200,2023-06-03,13:00:00,104,6,98,FMN 15 Luitenant Lippenslaan
662,Luitenant Lippenslaan 200,2023-06-03,14:00:00,132,13,119,FMN 15 Luitenant Lippenslaan
662,Luitenant Lippenslaan 200,2023-06-03,15:00:00,138,15,123,FMN 15 Luitenant Lippenslaan
662,Luitenant Lippenslaan 200,2023-06-03,16:00:00,140,12,128,FMN 15 Luitenant Lippenslaan
662,Luitenant Lippenslaan 200,2023-06-03,17:00:00,130,12,118,FMN 15 Luitenant Lippenslaan
662,Luitenant Lippenslaan 200,2023-06-03,18:00:00,144,13,131,FMN 15 Luitenant Lippenslaan
662,Luitenant Lippenslaan 200,2023-06-03,19:00:00,140,19,121,FMN 15 Luitenant Lippenslaan
662,Luitenant Lippenslaan 200,2023-06-03,20:00:00,91,15,76,FMN 15 Luitenant Lippenslaan
662,Luitenant Lippenslaan 200,2023-06-03,21:00:00,61,9,52,FMN 15 Luitenant Lippenslaan
662,Luitenant Lippenslaan 200,2023-06-03,22:00:00,47,13,34,FMN 15 Luitenant Lippenslaan
662,Luitenant Lippenslaan 200,2023-06-03,23:00:00,34,11,23,FMN 15 Luitenant Lippenslaan
662,Luitenant Lippenslaan 200,2023-06-04,00:00:00,33,7,26,FMN 15 Luitenant Lippenslaan
662,Luitenant Lippenslaan 200,2023-06-04,01:00:00,27,8,19,FMN 15 Luitenant Lippenslaan
662,Luitenant Lippenslaan 200,2023-06-04,02:00:00,15,4,11,FMN 15 Luitenant Lippenslaan
662,Luitenant Lippenslaan 200,2023-06-04,03:00:00,20,3,17,FMN 15 Luitenant Lippenslaan
662,Luitenant Lippenslaan 200,2023-06-04,04:00:00,7,2,5,FMN 15 Luitenant Lippenslaan
662,Luitenant Lippenslaan 200,2023-06-04,05:00:00,8,2,6,FMN 15 Luitenant Lippenslaan
662,Luitenant Lippenslaan 200,2023-06-04,06:00:00,15,3,12,FMN 15 Luitenant Lippenslaan
662,Luitenant Lippenslaan 200,2023-06-04,07:00:00,23,3,20,FMN 15 Luitenant Lippenslaan
662,Luitenant Lippenslaan 200,2023-06-04,08:00:00,51,5,46,FMN 15 Luitenant Lippenslaan
662,Luitenant Lippenslaan 200,2023-06-04,09:00:00,75,6,69,FMN 15 Luitenant Lippenslaan
662,Luitenant Lippenslaan 200,2023-06-04,10:00:00,93,6,87,FMN 15 Luitenant Lippenslaan
662,Luitenant Lippenslaan 200,2023-06-04,11:00:00,138,16,122,FMN 15 Luitenant Lippenslaan
662,Luitenant Lippenslaan 200,2023-06-04,12:00:00,120,8,112,FMN 15 Luitenant Lippenslaan
662,Luitenant Lippenslaan 200,2023-06-04,13:00:00,135,17,118,FMN 15 Luitenant Lippenslaan
662,Luitenant Lippenslaan 200,2023-06-04,14:00:00,173,26,147,FMN 15 Luitenant Lippenslaan
662,Luitenant Lippenslaan 200,2023-06-04,15:00:00,124,13,111,FMN 15 Luitenant Lippenslaan
662,Luitenant Lippenslaan 200,2023-06-04,16:00:00,134,20,114,FMN 15 Luitenant Lippenslaan
662,Luitenant Lippenslaan 200,2023-06-04,17:00:00,166,18,148,FMN 15 Luitenant Lippenslaan
662,Luitenant Lippenslaan 200,2023-06-04,18:00:00,146,18,128,FMN 15 Luitenant Lippenslaan
662,Luitenant Lippenslaan 200,2023-06-04,19:00:00,93,9,84,FMN 15 Luitenant Lippenslaan
662,Luitenant Lippenslaan 200,2023-06-04,20:00:00,80,18,62,FMN 15 Luitenant Lippenslaan
662,Luitenant Lippenslaan 200,2023-06-04,21:00:00,73,15,58,FMN 15 Luitenant Lippenslaan
662,Luitenant Lippenslaan 200,2023-06-04,22:00:00,32,13,19,FMN 15 Luitenant Lippenslaan
662,Luitenant Lippenslaan 200,2023-06-04,23:00:00,27,9,18,FMN 15 Luitenant Lippenslaan
662,Luitenant Lippenslaan 200,2023-06-05,00:00:00,31,2,29,FMN 15 Luitenant Lippenslaan
662,Luitenant Lippenslaan 200,2023-06-05,01:00:00,19,7,12,FMN 15 Luitenant Lippenslaan
662,Luitenant Lippenslaan 200,2023-06-05,02:00:00,9,6,3,FMN 15 Luitenant Lippenslaan
662,Luitenant Lippenslaan 200,2023-06-05,03:00:00,5,1,4,FMN 15 Luitenant Lippenslaan
662,Luitenant Lippenslaan 200,2023-06-05,04:00:00,13,5,8,FMN 15 Luitenant Lippenslaan
662,Luitenant Lippenslaan 200,2023-06-05,05:00:00,23,4,19,FMN 15 Luitenant Lippenslaan
662,Luitenant Lippenslaan 200,2023-06-05,06:00:00,81,11,70,FMN 15 Luitenant Lippenslaan
662,Luitenant Lippenslaan 200,2023-06-05,07:00:00,220,13,207,FMN 15 Luitenant Lippenslaan
662,Luitenant Lippenslaan 200,2023-06-05,08:00:00,438,37,401,FMN 15 Luitenant Lippenslaan
662,Luitenant Lippenslaan 200,2023-06-05,09:00:00,172,11,161,FMN 15 Luitenant Lippenslaan
662,Luitenant Lippenslaan 200,2023-06-05,10:00:00,92,11,81,FMN 15 Luitenant Lippenslaan
662,Luitenant Lippenslaan 200,2023-06-05,11:00:00,82,12,70,FMN 15 Luitenant Lippenslaan
662,Luitenant Lippenslaan 200,2023-06-05,12:00:00,97,8,89,FMN 15 Luitenant Lippenslaan
662,Luitenant Lippenslaan 200,2023-06-05,13:00:00,107,16,91,FMN 15 Luitenant Lippenslaan
662,Luitenant Lippenslaan 200,2023-06-05,14:00:00,92,6,86,FMN 15 Luitenant Lippenslaan
662,Luitenant Lippenslaan 200,2023-06-05,15:00:00,140,25,115,FMN 15 Luitenant Lippenslaan
662,Luitenant Lippenslaan 200,2023-06-05,16:00:00,206,25,181,FMN 15 Luitenant Lippenslaan
662,Luitenant Lippenslaan 200,2023-06-05,17:00:00,231,19,212,FMN 15 Luitenant Lippenslaan
662,Luitenant Lippenslaan 200,2023-06-05,18:00:00,190,17,173,FMN 15 Luitenant Lippenslaan
662,Luitenant Lippenslaan 200,2023-06-05,19:00:00,109,14,95,FMN 15 Luitenant Lippenslaan
662,Luitenant Lippenslaan 200,2023-06-05,20:00:00,107,14,93,FMN 15 Luitenant Lippenslaan
662,Luitenant Lippenslaan 200,2023-06-05,21:00:00,71,9,62,FMN 15 Luitenant Lippenslaan
662,Luitenant Lippenslaan 200,2023-06-05,22:00:00,59,8,51,FMN 15 Luitenant Lippenslaan
662,Luitenant Lippenslaan 200,2023-06-05,23:00:00,32,8,24,FMN 15 Luitenant Lippenslaan
662,Luitenant Lippenslaan 200,2023-06-06,00:00:00,6,4,2,FMN 15 Luitenant Lippenslaan
662,Luitenant Lippenslaan 200,2023-06-06,01:00:00,6,3,3,FMN 15 Luitenant Lippenslaan
662,Luitenant Lippenslaan 200,2023-06-06,02:00:00,5,4,1,FMN 15 Luitenant Lippenslaan
662,Luitenant Lippenslaan 200,2023-06-06,03:00:00,3,0,3,FMN 15 Luitenant Lippenslaan
662,Luitenant Lippenslaan 200,2023-06-06,04:00:00,13,2,11,FMN 15 Luitenant Lippenslaan
662,Luitenant Lippenslaan 200,2023-06-06,05:00:00,26,6,20,FMN 15 Luitenant Lippenslaan
662,Luitenant Lippenslaan 200,2023-06-06,06:00:00,91,11,80,FMN 15 Luitenant Lippenslaan
662,Luitenant Lippenslaan 200,2023-06-06,07:00:00,254,11,243,FMN 15 Luitenant Lippenslaan
662,Luitenant Lippenslaan 200,2023-06-06,08:00:00,556,40,516,FMN 15 Luitenant Lippenslaan
662,Luitenant Lippenslaan 200,2023-06-06,09:00:00,179,9,170,FMN 15 Luitenant Lippenslaan
662,Luitenant Lippenslaan 200,2023-06-06,10:00:00,122,10,112,FMN 15 Luitenant Lippenslaan
662,Luitenant Lippenslaan 200,2023-06-06,11:00:00,116,18,98,FMN 15 Luitenant Lippenslaan
662,Luitenant Lippenslaan 200,2023-06-06,12:00:00,108,9,99,FMN 15 Luitenant Lippenslaan
662,Luitenant Lippenslaan 200,2023-06-06,13:00:00,120,14,106,FMN 15 Luitenant Lippenslaan
662,Luitenant Lippenslaan 200,2023-06-06,14:00:00,100,12,88,FMN 15 Luitenant Lippenslaan
662,Luitenant Lippenslaan 200,2023-06-06,15:00:00,135,18,117,FMN 15 Luitenant Lippenslaan
662,Luitenant Lippenslaan 200,2023-06-06,16:00:00,163,35,128,FMN 15 Luitenant Lippenslaan
662,Luitenant Lippenslaan 200,2023-06-06,17:00:00,172,19,153,FMN 15 Luitenant Lippenslaan
662,Luitenant Lippenslaan 200,2023-06-06,18:00:00,136,14,122,FMN 15 Luitenant Lippenslaan
662,Luitenant Lippenslaan 200,2023-06-06,19:00:00,104,14,90,FMN 15 Luitenant Lippenslaan
662,Luitenant Lippenslaan 200,2023-06-06,20:00:00,79,17,62,FMN 15 Luitenant Lippenslaan
662,Luitenant Lippenslaan 200,2023-06-06,21:00:00,70,20,50,FMN 15 Luitenant Lippenslaan
662,Luitenant Lippenslaan 200,2023-06-06,22:00:00,58,15,43,FMN 15 Luitenant Lippenslaan
662,Luitenant Lippenslaan 200,2023-06-06,23:00:00,31,8,23,FMN 15 Luitenant Lippenslaan
662,Luitenant Lippenslaan 200,2023-06-07,00:00:00,12,4,8,FMN 15 Luitenant Lippenslaan
662,Luitenant Lippenslaan 200,2023-06-07,01:00:00,4,4,0,FMN 15 Luitenant Lippenslaan
662,Luitenant Lippenslaan 200,2023-06-07,02:00:00,6,3,3,FMN 15 Luitenant Lippenslaan
662,Luitenant Lippenslaan 200,2023-06-07,03:00:00,7,2,5,FMN 15 Luitenant Lippenslaan
662,Luitenant Lippenslaan 200,2023-06-07,04:00:00,13,3,10,FMN 15 Luitenant Lippenslaan
662,Luitenant Lippenslaan 200,2023-06-07,05:00:00,26,5,21,FMN 15 Luitenant Lippenslaan
662,Luitenant Lippenslaan 200,2023-06-07,06:00:00,85,12,73,FMN 15 Luitenant Lippenslaan
662,Luitenant Lippenslaan 200,2023-06-07,07:00:00,213,11,202,FMN 15 Luitenant Lippenslaan
662,Luitenant Lippenslaan 200,2023-06-07,08:00:00,441,24,417,FMN 15 Luitenant Lippenslaan
662,Luitenant Lippenslaan 200,2023-06-07,09:00:00,164,18,146,FMN 15 Luitenant Lippenslaan
662,Luitenant Lippenslaan 200,2023-06-07,10:00:00,142,15,127,FMN 15 Luitenant Lippenslaan
662,Luitenant Lippenslaan 200,2023-06-07,11:00:00,114,19,95,FMN 15 Luitenant Lippenslaan
662,Luitenant Lippenslaan 200,2023-06-07,12:00:00,147,17,130,FMN 15 Luitenant Lippenslaan
662,Luitenant Lippenslaan 200,2023-06-07,13:00:00,145,13,132,FMN 15 Luitenant Lippenslaan
662,Luitenant Lippenslaan 200,2023-06-07,14:00:00,94,11,83,FMN 15 Luitenant Lippenslaan
662,Luitenant Lippenslaan 200,2023-06-07,15:00:00,127,18,109,FMN 15 Luitenant Lippenslaan
662,Luitenant Lippenslaan 200,2023-06-07,16:00:00,171,18,153,FMN 15 Luitenant Lippenslaan
662,Luitenant Lippenslaan 200,2023-06-07,17:00:00,196,18,178,FMN 15 Luitenant Lippenslaan
662,Luitenant Lippenslaan 200,2023-06-07,18:00:00,154,15,139,FMN 15 Luitenant Lippenslaan
662,Luitenant Lippenslaan 200,2023-06-07,19:00:00,134,18,116,FMN 15 Luitenant Lippenslaan
662,Luitenant Lippenslaan 200,2023-06-07,20:00:00,85,10,75,FMN 15 Luitenant Lippenslaan
662,Luitenant Lippenslaan 200,2023-06-07,21:00:00,60,20,40,FMN 15 Luitenant Lippenslaan
662,Luitenant Lippenslaan 200,2023-06-07,22:00:00,48,14,34,FMN 15 Luitenant Lippenslaan
662,Luitenant Lippenslaan 200,2023-06-07,23:00:00,28,10,18,FMN 15 Luitenant Lippenslaan
662,Luitenant Lippenslaan 200,2023-06-08,00:00:00,21,9,12,FMN 15 Luitenant Lippenslaan
662,Luitenant Lippenslaan 200,2023-06-08,01:00:00,2,1,1,FMN 15 Luitenant Lippenslaan
662,Luitenant Lippenslaan 200,2023-06-08,02:00:00,2,1,1,FMN 15 Luitenant Lippenslaan
662,Luitenant Lippenslaan 200,2023-06-08,03:00:00,6,3,3,FMN 15 Luitenant Lippenslaan
662,Luitenant Lippenslaan 200,2023-06-08,04:00:00,9,4,5,FMN 15 Luitenant Lippenslaan
662,Luitenant Lippenslaan 200,2023-06-08,05:00:00,15,12,3,FMN 15 Luitenant Lippenslaan
662,Luitenant Lippenslaan 200,2023-06-08,06:00:00,57,23,34,FMN 15 Luitenant Lippenslaan
662,Luitenant Lippenslaan 200,2023-06-08,07:00:00,126,38,88,FMN 15 Luitenant Lippenslaan
662,Luitenant Lippenslaan 200,2023-06-08,08:00:00,250,72,178,FMN 15 Luitenant Lippenslaan
662,Luitenant Lippenslaan 200,2023-06-08,09:00:00,71,23,48,FMN 15 Luitenant Lippenslaan
662,Luitenant Lippenslaan 200,2023-06-08,10:00:00,52,18,34,FMN 15 Luitenant Lippenslaan
662,Luitenant Lippenslaan 200,2023-06-08,11:00:00,52,16,36,FMN 15 Luitenant Lippenslaan
662,Luitenant Lippenslaan 200,2023-06-08,12:00:00,39,5,34,FMN 15 Luitenant Lippenslaan
662,Luitenant Lippenslaan 200,2023-06-08,13:00:00,76,23,53,FMN 15 Luitenant Lippenslaan
662,Luitenant Lippenslaan 200,2023-06-08,14:00:00,69,12,57,FMN 15 Luitenant Lippenslaan
662,Luitenant Lippenslaan 200,2023-06-08,15:00:00,116,24,92,FMN 15 Luitenant Lippenslaan
662,Luitenant Lippenslaan 200,2023-06-08,16:00:00,144,31,113,FMN 15 Luitenant Lippenslaan
662,Luitenant Lippenslaan 200,2023-06-08,17:00:00,162,34,128,FMN 15 Luitenant Lippenslaan
662,Luitenant Lippenslaan 200,2023-06-08,18:00:00,170,12,158,FMN 15 Luitenant Lippenslaan
662,Luitenant Lippenslaan 200,2023-06-08,19:00:00,146,22,124,FMN 15 Luitenant Lippenslaan
662,Luitenant Lippenslaan 200,2023-06-08,20:00:00,83,20,63,FMN 15 Luitenant Lippenslaan
662,Luitenant Lippenslaan 200,2023-06-08,21:00:00,48,14,34,FMN 15 Luitenant Lippenslaan
662,Luitenant Lippenslaan 200,2023-06-08,22:00:00,44,9,35,FMN 15 Luitenant Lippenslaan
662,Luitenant Lippenslaan 200,2023-06-08,23:00:00,19,5,14,FMN 15 Luitenant Lippenslaan
662,Luitenant Lippenslaan 200,2023-06-09,00:00:00,14,7,7,FMN 15 Luitenant Lippenslaan
662,Luitenant Lippenslaan 200,2023-06-09,01:00:00,7,5,2,FMN 15 Luitenant Lippenslaan
662,Luitenant Lippenslaan 200,2023-06-09,02:00:00,5,3,2,FMN 15 Luitenant Lippenslaan
662,Luitenant Lippenslaan 200,2023-06-09,03:00:00,8,4,4,FMN 15 Luitenant Lippenslaan
662,Luitenant Lippenslaan 200,2023-06-09,04:00:00,13,5,8,FMN 15 Luitenant Lippenslaan
662,Luitenant Lippenslaan 200,2023-06-09,05:00:00,12,7,5,FMN 15 Luitenant Lippenslaan
662,Luitenant Lippenslaan 200,2023-06-09,06:00:00,44,17,27,FMN 15 Luitenant Lippenslaan
662,Luitenant Lippenslaan 200,2023-06-09,07:00:00,108,34,74,FMN 15 Luitenant Lippenslaan
662,Luitenant Lippenslaan 200,2023-06-09,08:00:00,226,51,175,FMN 15 Luitenant Lippenslaan
662,Luitenant Lippenslaan 200,2023-06-09,09:00:00,84,19,65,FMN 15 Luitenant Lippenslaan
662,Luitenant Lippenslaan 200,2023-06-09,10:00:00,67,18,49,FMN 15 Luitenant Lippenslaan
662,Luitenant Lippenslaan 200,2023-06-09,11:00:00,61,12,49,FMN 15 Luitenant Lippenslaan
662,Luitenant Lippenslaan 200,2023-06-09,12:00:00,59,13,46,FMN 15 Luitenant Lippenslaan
662,Luitenant Lippenslaan 200,2023-06-09,13:00:00,75,19,56,FMN 15 Luitenant Lippenslaan
662,Luitenant Lippenslaan 200,2023-06-09,14:00:00,107,20,87,FMN 15 Luitenant Lippenslaan
662,Luitenant Lippenslaan 200,2023-06-09,15:00:00,130,32,98,FMN 15 Luitenant Lippenslaan
662,Luitenant Lippenslaan 200,2023-06-09,16:00:00,169,24,145,FMN 15 Luitenant Lippenslaan
662,Luitenant Lippenslaan 200,2023-06-09,17:00:00,204,12,192,FMN 15 Luitenant Lippenslaan
662,Luitenant Lippenslaan 200,2023-06-09,18:00:00,172,14,158,FMN 15 Luitenant Lippenslaan
662,Luitenant Lippenslaan 200,2023-06-09,19:00:00,178,29,149,FMN 15 Luitenant Lippenslaan
662,Luitenant Lippenslaan 200,2023-06-09,20:00:00,99,16,83,FMN 15 Luitenant Lippenslaan
662,Luitenant Lippenslaan 200,2023-06-09,21:00:00,102,15,87,FMN 15 Luitenant Lippenslaan
662,Luitenant Lippenslaan 200,2023-06-09,22:00:00,54,14,40,FMN 15 Luitenant Lippenslaan
662,Luitenant Lippenslaan 200,2023-06-09,23:00:00,70,18,52,FMN 15 Luitenant Lippenslaan
662,Luitenant Lippenslaan 200,2023-06-10,00:00:00,32,8,24,FMN 15 Luitenant Lippenslaan
662,Luitenant Lippenslaan 200,2023-06-10,01:00:00,22,4,18,FMN 15 Luitenant Lippenslaan
662,Luitenant Lippenslaan 200,2023-06-10,02:00:00,6,0,6,FMN 15 Luitenant Lippenslaan
662,Luitenant Lippenslaan 200,2023-06-10,03:00:00,5,3,2,FMN 15 Luitenant Lippenslaan
662,Luitenant Lippenslaan 200,2023-06-10,04:00:00,8,3,5,FMN 15 Luitenant Lippenslaan
662,Luitenant Lippenslaan 200,2023-06-10,05:00:00,11,1,10,FMN 15 Luitenant Lippenslaan
662,Luitenant Lippenslaan 200,2023-06-10,06:00:00,19,4,15,FMN 15 Luitenant Lippenslaan
662,Luitenant Lippenslaan 200,2023-06-10,07:00:00,35,5,30,FMN 15 Luitenant Lippenslaan
662,Luitenant Lippenslaan 200,2023-06-10,08:00:00,44,7,37,FMN 15 Luitenant Lippenslaan
662,Luitenant Lippenslaan 200,2023-06-10,09:00:00,107,11,96,FMN 15 Luitenant Lippenslaan
662,Luitenant Lippenslaan 200,2023-06-10,10:00:00,146,8,138,FMN 15 Luitenant Lippenslaan
662,Luitenant Lippenslaan 200,2023-06-10,11:00:00,120,9,111,FMN 15 Luitenant Lippenslaan
662,Luitenant Lippenslaan 200,2023-06-10,12:00:00,124,10,114,FMN 15 Luitenant Lippenslaan
662,Luitenant Lippenslaan 200,2023-06-10,13:00:00,122,13,109,FMN 15 Luitenant Lippenslaan
662,Luitenant Lippenslaan 200,2023-06-10,14:00:00,131,17,114,FMN 15 Luitenant Lippenslaan
662,Luitenant Lippenslaan 200,2023-06-10,15:00:00,92,18,74,FMN 15 Luitenant Lippenslaan
662,Luitenant Lippenslaan 200,2023-06-10,16:00:00,100,16,84,FMN 15 Luitenant Lippenslaan
662,Luitenant Lippenslaan 200,2023-06-10,17:00:00,126,13,113,FMN 15 Luitenant Lippenslaan
662,Luitenant Lippenslaan 200,2023-06-10,18:00:00,132,13,119,FMN 15 Luitenant Lippenslaan
662,Luitenant Lippenslaan 200,2023-06-10,19:00:00,114,16,98,FMN 15 Luitenant Lippenslaan
662,Luitenant Lippenslaan 200,2023-06-10,20:00:00,100,16,84,FMN 15 Luitenant Lippenslaan
662,Luitenant Lippenslaan 200,2023-06-10,21:00:00,60,9,51,FMN 15 Luitenant Lippenslaan
662,Luitenant Lippenslaan 200,2023-06-10,22:00:00,58,6,52,FMN 15 Luitenant Lippenslaan
662,Luitenant Lippenslaan 200,2023-06-10,23:00:00,71,14,57,FMN 15 Luitenant Lippenslaan
662,Luitenant Lippenslaan 200,2023-06-11,00:00:00,29,7,22,FMN 15 Luitenant Lippenslaan
662,Luitenant Lippenslaan 200,2023-06-11,01:00:00,16,1,15,FMN 15 Luitenant Lippenslaan
662,Luitenant Lippenslaan 200,2023-06-11,02:00:00,31,10,21,FMN 15 Luitenant Lippenslaan
662,Luitenant Lippenslaan 200,2023-06-11,03:00:00,11,2,9,FMN 15 Luitenant Lippenslaan
662,Luitenant Lippenslaan 200,2023-06-11,04:00:00,14,6,8,FMN 15 Luitenant Lippenslaan
662,Luitenant Lippenslaan 200,2023-06-11,05:00:00,8,1,7,FMN 15 Luitenant Lippenslaan
662,Luitenant Lippenslaan 200,2023-06-11,06:00:00,21,1,20,FMN 15 Luitenant Lippenslaan
662,Luitenant Lippenslaan 200,2023-06-11,07:00:00,26,7,19,FMN 15 Luitenant Lippenslaan
662,Luitenant Lippenslaan 200,2023-06-11,08:00:00,43,1,42,FMN 15 Luitenant Lippenslaan
662,Luitenant Lippenslaan 200,2023-06-11,09:00:00,104,10,94,FMN 15 Luitenant Lippenslaan
662,Luitenant Lippenslaan 200,2023-06-11,10:00:00,96,8,88,FMN 15 Luitenant Lippenslaan
662,Luitenant Lippenslaan 200,2023-06-11,11:00:00,95,18,77,FMN 15 Luitenant Lippenslaan
662,Luitenant Lippenslaan 200,2023-06-11,12:00:00,124,14,110,FMN 15 Luitenant Lippenslaan
662,Luitenant Lippenslaan 200,2023-06-11,13:00:00,108,12,96,FMN 15 Luitenant Lippenslaan
662,Luitenant Lippenslaan 200,2023-06-11,14:00:00,119,25,94,FMN 15 Luitenant Lippenslaan
662,Luitenant Lippenslaan 200,2023-06-11,15:00:00,100,17,83,FMN 15 Luitenant Lippenslaan
662,Luitenant Lippenslaan 200,2023-06-11,16:00:00,97,8,89,FMN 15 Luitenant Lippenslaan
662,Luitenant Lippenslaan 200,2023-06-11,17:00:00,126,9,117,FMN 15 Luitenant Lippenslaan
662,Luitenant Lippenslaan 200,2023-06-11,18:00:00,141,18,123,FMN 15 Luitenant Lippenslaan
662,Luitenant Lippenslaan 200,2023-06-11,19:00:00,107,19,88,FMN 15 Luitenant Lippenslaan
662,Luitenant Lippenslaan 200,2023-06-11,20:00:00,79,10,69,FMN 15 Luitenant Lippenslaan
662,Luitenant Lippenslaan 200,2023-06-11,21:00:00,84,13,71,FMN 15 Luitenant Lippenslaan
662,Luitenant Lippenslaan 200,2023-06-11,22:00:00,46,9,37,FMN 15 Luitenant Lippenslaan
662,Luitenant Lippenslaan 200,2023-06-11,23:00:00,42,12,30,FMN 15 Luitenant Lippenslaan
662,Luitenant Lippenslaan 200,2023-06-12,00:00:00,18,7,11,FMN 15 Luitenant Lippenslaan
662,Luitenant Lippenslaan 200,2023-06-12,01:00:00,2,2,0,FMN 15 Luitenant Lippenslaan
662,Luitenant Lippenslaan 200,2023-06-12,02:00:00,5,2,3,FMN 15 Luitenant Lippenslaan
662,Luitenant Lippenslaan 200,2023-06-12,03:00:00,7,3,4,FMN 15 Luitenant Lippenslaan
662,Luitenant Lippenslaan 200,2023-06-12,04:00:00,15,5,10,FMN 15 Luitenant Lippenslaan
662,Luitenant Lippenslaan 200,2023-06-12,05:00:00,26,4,22,FMN 15 Luitenant Lippenslaan
662,Luitenant Lippenslaan 200,2023-06-12,06:00:00,91,5,86,FMN 15 Luitenant Lippenslaan
662,Luitenant Lippenslaan 200,2023-06-12,07:00:00,251,6,245,FMN 15 Luitenant Lippenslaan
662,Luitenant Lippenslaan 200,2023-06-12,08:00:00,462,13,449,FMN 15 Luitenant Lippenslaan
662,Luitenant Lippenslaan 200,2023-06-12,09:00:00,167,7,160,FMN 15 Luitenant Lippenslaan
662,Luitenant Lippenslaan 200,2023-06-12,10:00:00,104,10,94,FMN 15 Luitenant Lippenslaan
662,Luitenant Lippenslaan 200,2023-06-12,11:00:00,87,8,79,FMN 15 Luitenant Lippenslaan
662,Luitenant Lippenslaan 200,2023-06-12,12:00:00,155,23,132,FMN 15 Luitenant Lippenslaan
662,Luitenant Lippenslaan 200,2023-06-12,13:00:00,95,8,87,FMN 15 Luitenant Lippenslaan
662,Luitenant Lippenslaan 200,2023-06-12,14:00:00,113,18,95,FMN 15 Luitenant Lippenslaan
662,Luitenant Lippenslaan 200,2023-06-12,15:00:00,112,15,97,FMN 15 Luitenant Lippenslaan
662,Luitenant Lippenslaan 200,2023-06-12,16:00:00,158,19,139,FMN 15 Luitenant Lippenslaan
662,Luitenant Lippenslaan 200,2023-06-12,17:00:00,171,15,156,FMN 15 Luitenant Lippenslaan
662,Luitenant Lippenslaan 200,2023-06-12,18:00:00,159,17,142,FMN 15 Luitenant Lippenslaan
662,Luitenant Lippenslaan 200,2023-06-12,19:00:00,116,13,103,FMN 15 Luitenant Lippenslaan
662,Luitenant Lippenslaan 200,2023-06-12,20:00:00,60,7,53,FMN 15 Luitenant Lippenslaan
662,Luitenant Lippenslaan 200,2023-06-12,21:00:00,76,18,58,FMN 15 Luitenant Lippenslaan
662,Luitenant Lippenslaan 200,2023-06-12,22:00:00,69,12,57,FMN 15 Luitenant Lippenslaan
662,Luitenant Lippenslaan 200,2023-06-12,23:00:00,28,6,22,FMN 15 Luitenant Lippenslaan
662,Luitenant Lippenslaan 200,2023-06-13,00:00:00,23,6,17,FMN 15 Luitenant Lippenslaan
662,Luitenant Lippenslaan 200,2023-06-13,01:00:00,8,4,4,FMN 15 Luitenant Lippenslaan
662,Luitenant Lippenslaan 200,2023-06-13,02:00:00,6,3,3,FMN 15 Luitenant Lippenslaan
662,Luitenant Lippenslaan 200,2023-06-13,03:00:00,7,4,3,FMN 15 Luitenant Lippenslaan
662,Luitenant Lippenslaan 200,2023-06-13,04:00:00,11,3,8,FMN 15 Luitenant Lippenslaan
662,Luitenant Lippenslaan 200,2023-06-13,05:00:00,25,2,23,FMN 15 Luitenant Lippenslaan
662,Luitenant Lippenslaan 200,2023-06-13,06:00:00,93,5,88,FMN 15 Luitenant Lippenslaan
662,Luitenant Lippenslaan 200,2023-06-13,07:00:00,266,11,255,FMN 15 Luitenant Lippenslaan
662,Luitenant Lippenslaan 200,2023-06-13,08:00:00,486,17,469,FMN 15 Luitenant Lippenslaan
662,Luitenant Lippenslaan 200,2023-06-13,09:00:00,157,9,148,FMN 15 Luitenant Lippenslaan
662,Luitenant Lippenslaan 200,2023-06-13,10:00:00,112,9,103,FMN 15 Luitenant Lippenslaan
662,Luitenant Lippenslaan 200,2023-06-13,11:00:00,79,9,70,FMN 15 Luitenant Lippenslaan
662,Luitenant Lippenslaan 200,2023-06-13,12:00:00,136,16,120,FMN 15 Luitenant Lippenslaan
662,Luitenant Lippenslaan 200,2023-06-13,13:00:00,125,16,109,FMN 15 Luitenant Lippenslaan
662,Luitenant Lippenslaan 200,2023-06-13,14:00:00,85,7,78,FMN 15 Luitenant Lippenslaan
662,Luitenant Lippenslaan 200,2023-06-13,15:00:00,124,13,111,FMN 15 Luitenant Lippenslaan
662,Luitenant Lippenslaan 200,2023-06-13,16:00:00,172,26,146,FMN 15 Luitenant Lippenslaan
662,Luitenant Lippenslaan 200,2023-06-13,17:00:00,187,18,169,FMN 15 Luitenant Lippenslaan
662,Luitenant Lippenslaan 200,2023-06-13,18:00:00,173,16,157,FMN 15 Luitenant Lippenslaan
662,Luitenant Lippenslaan 200,2023-06-13,19:00:00,127,23,104,FMN 15 Luitenant Lippenslaan
662,Luitenant Lippenslaan 200,2023-06-13,20:00:00,106,9,97,FMN 15 Luitenant Lippenslaan
662,Luitenant Lippenslaan 200,2023-06-13,21:00:00,73,14,59,FMN 15 Luitenant Lippenslaan
662,Luitenant Lippenslaan 200,2023-06-13,22:00:00,77,22,55,FMN 15 Luitenant Lippenslaan
662,Luitenant Lippenslaan 200,2023-06-13,23:00:00,41,7,34,FMN 15 Luitenant Lippenslaan
662,Luitenant Lippenslaan 200,2023-06-14,00:00:00,29,6,23,FMN 15 Luitenant Lippenslaan
662,Luitenant Lippenslaan 200,2023-06-14,01:00:00,10,3,7,FMN 15 Luitenant Lippenslaan
662,Luitenant Lippenslaan 200,2023-06-14,02:00:00,8,4,4,FMN 15 Luitenant Lippenslaan
662,Luitenant Lippenslaan 200,2023-06-14,03:00:00,5,1,4,FMN 15 Luitenant Lippenslaan
662,Luitenant Lippenslaan 200,2023-06-14,04:00:00,9,2,7,FMN 15 Luitenant Lippenslaan
662,Luitenant Lippenslaan 200,2023-06-14,05:00:00,24,3,21,FMN 15 Luitenant Lippenslaan
662,Luitenant Lippenslaan 200,2023-06-14,06:00:00,84,7,77,FMN 15 Luitenant Lippenslaan
662,Luitenant Lippenslaan 200,2023-06-14,07:00:00,254,14,240,FMN 15 Luitenant Lippenslaan
662,Luitenant Lippenslaan 200,2023-06-14,08:00:00,410,17,393,FMN 15 Luitenant Lippenslaan
662,Luitenant Lippenslaan 200,2023-06-14,09:00:00,133,15,118,FMN 15 Luitenant Lippenslaan
662,Luitenant Lippenslaan 200,2023-06-14,10:00:00,96,15,81,FMN 15 Luitenant Lippenslaan
662,Luitenant Lippenslaan 200,2023-06-14,11:00:00,79,14,65,FMN 15 Luitenant Lippenslaan
662,Luitenant Lippenslaan 200,2023-06-14,12:00:00,67,16,51,FMN 15 Luitenant Lippenslaan
662,Luitenant Lippenslaan 200,2023-06-14,13:00:00,88,9,79,FMN 15 Luitenant Lippenslaan
662,Luitenant Lippenslaan 200,2023-06-14,14:00:00,48,4,44,FMN 15 Luitenant Lippenslaan
662,Luitenant Lippenslaan 200,2023-06-14,15:00:00,0,0,0,FMN 15 Luitenant Lippenslaan
662,Luitenant Lippenslaan 200,2023-06-14,16:00:00,0,0,0,FMN 15 Luitenant Lippenslaan
662,Luitenant Lippenslaan 200,2023-06-14,17:00:00,0,0,0,FMN 15 Luitenant Lippenslaan
662,Luitenant Lippenslaan 200,2023-06-14,18:00:00,0,0,0,FMN 15 Luitenant Lippenslaan
662,Luitenant Lippenslaan 200,2023-06-14,19:00:00,0,0,0,FMN 15 Luitenant Lippenslaan
662,Luitenant Lippenslaan 200,2023-06-14,20:00:00,0,0,0,FMN 15 Luitenant Lippenslaan
662,Luitenant Lippenslaan 200,2023-06-14,21:00:00,0,0,0,FMN 15 Luitenant Lippenslaan
662,Luitenant Lippenslaan 200,2023-06-14,22:00:00,0,0,0,FMN 15 Luitenant Lippenslaan
662,Luitenant Lippenslaan 200,2023-06-14,23:00:00,0,0,0,FMN 15 Luitenant Lippenslaan
662,Luitenant Lippenslaan 200,2023-06-15,00:00:00,0,0,0,FMN 15 Luitenant Lippenslaan
662,Luitenant Lippenslaan 200,2023-06-15,01:00:00,20,2,18,FMN 15 Luitenant Lippenslaan
662,Luitenant Lippenslaan 200,2023-06-15,02:00:00,16,7,9,FMN 15 Luitenant Lippenslaan
662,Luitenant Lippenslaan 200,2023-06-15,03:00:00,5,3,2,FMN 15 Luitenant Lippenslaan
662,Luitenant Lippenslaan 200,2023-06-15,04:00:00,17,2,15,FMN 15 Luitenant Lippenslaan
662,Luitenant Lippenslaan 200,2023-06-15,05:00:00,47,4,43,FMN 15 Luitenant Lippenslaan
662,Luitenant Lippenslaan 200,2023-06-15,06:00:00,162,30,132,FMN 15 Luitenant Lippenslaan
662,Luitenant Lippenslaan 200,2023-06-15,07:00:00,455,78,377,FMN 15 Luitenant Lippenslaan
662,Luitenant Lippenslaan 200,2023-06-15,08:00:00,958,140,818,FMN 15 Luitenant Lippenslaan
662,Luitenant Lippenslaan 200,2023-06-15,09:00:00,413,83,330,FMN 15 Luitenant Lippenslaan
662,Luitenant Lippenslaan 200,2023-06-15,10:00:00,233,41,192,FMN 15 Luitenant Lippenslaan
662,Luitenant Lippenslaan 200,2023-06-15,11:00:00,201,50,151,FMN 15 Luitenant Lippenslaan
662,Luitenant Lippenslaan 200,2023-06-15,12:00:00,260,59,201,FMN 15 Luitenant Lippenslaan
662,Luitenant Lippenslaan 200,2023-06-15,13:00:00,261,62,199,FMN 15 Luitenant Lippenslaan
662,Luitenant Lippenslaan 200,2023-06-15,14:00:00,210,49,161,FMN 15 Luitenant Lippenslaan
662,Luitenant Lippenslaan 200,2023-06-15,15:00:00,251,51,200,FMN 15 Luitenant Lippenslaan
662,Luitenant Lippenslaan 200,2023-06-15,16:00:00,340,65,275,FMN 15 Luitenant Lippenslaan
662,Luitenant Lippenslaan 200,2023-06-15,17:00:00,408,91,317,FMN 15 Luitenant Lippenslaan
662,Luitenant Lippenslaan 200,2023-06-15,18:00:00,387,71,316,FMN 15 Luitenant Lippenslaan
662,Luitenant Lippenslaan 200,2023-06-15,19:00:00,280,52,228,FMN 15 Luitenant Lippenslaan
662,Luitenant Lippenslaan 200,2023-06-15,20:00:00,201,40,161,FMN 15 Luitenant Lippenslaan
662,Luitenant Lippenslaan 200,2023-06-15,21:00:00,134,31,103,FMN 15 Luitenant Lippenslaan
662,Luitenant Lippenslaan 200,2023-06-15,22:00:00,107,27,80,FMN 15 Luitenant Lippenslaan
662,Luitenant Lippenslaan 200,2023-06-15,23:00:00,55,15,40,FMN 15 Luitenant Lippenslaan
662,Luitenant Lippenslaan 200,2023-06-16,00:00:00,0,0,0,FMN 15 Luitenant Lippenslaan
662,Luitenant Lippenslaan 200,2023-06-16,01:00:00,18,7,11,FMN 15 Luitenant Lippenslaan
662,Luitenant Lippenslaan 200,2023-06-16,02:00:00,11,3,8,FMN 15 Luitenant Lippenslaan
662,Luitenant Lippenslaan 200,2023-06-16,03:00:00,5,3,2,FMN 15 Luitenant Lippenslaan
662,Luitenant Lippenslaan 200,2023-06-16,04:00:00,18,5,13,FMN 15 Luitenant Lippenslaan
662,Luitenant Lippenslaan 200,2023-06-16,05:00:00,44,8,36,FMN 15 Luitenant Lippenslaan
662,Luitenant Lippenslaan 200,2023-06-16,06:00:00,140,27,113,FMN 15 Luitenant Lippenslaan
662,Luitenant Lippenslaan 200,2023-06-16,07:00:00,408,63,345,FMN 15 Luitenant Lippenslaan
662,Luitenant Lippenslaan 200,2023-06-16,08:00:00,834,116,718,FMN 15 Luitenant Lippenslaan
662,Luitenant Lippenslaan 200,2023-06-16,09:00:00,366,68,298,FMN 15 Luitenant Lippenslaan
662,Luitenant Lippenslaan 200,2023-06-16,10:00:00,239,50,189,FMN 15 Luitenant Lippenslaan
662,Luitenant Lippenslaan 200,2023-06-16,11:00:00,202,50,152,FMN 15 Luitenant Lippenslaan
662,Luitenant Lippenslaan 200,2023-06-16,12:00:00,277,67,210,FMN 15 Luitenant Lippenslaan
662,Luitenant Lippenslaan 200,2023-06-16,13:00:00,260,62,198,FMN 15 Luitenant Lippenslaan
662,Luitenant Lippenslaan 200,2023-06-16,14:00:00,237,54,183,FMN 15 Luitenant Lippenslaan
662,Luitenant Lippenslaan 200,2023-06-16,15:00:00,292,65,227,FMN 15 Luitenant Lippenslaan
662,Luitenant Lippenslaan 200,2023-06-16,16:00:00,342,73,269,FMN 15 Luitenant Lippenslaan
662,Luitenant Lippenslaan 200,2023-06-16,17:00:00,398,73,325,FMN 15 Luitenant Lippenslaan
662,Luitenant Lippenslaan 200,2023-06-16,18:00:00,362,74,288,FMN 15 Luitenant Lippenslaan
662,Luitenant Lippenslaan 200,2023-06-16,19:00:00,325,56,269,FMN 15 Luitenant Lippenslaan
662,Luitenant Lippenslaan 200,2023-06-16,20:00:00,223,42,181,FMN 15 Luitenant Lippenslaan
662,Luitenant Lippenslaan 200,2023-06-16,21:00:00,166,31,135,FMN 15 Luitenant Lippenslaan
662,Luitenant Lippenslaan 200,2023-06-16,22:00:00,102,20,82,FMN 15 Luitenant Lippenslaan
662,Luitenant Lippenslaan 200,2023-06-16,23:00:00,87,24,63,FMN 15 Luitenant Lippenslaan
662,Luitenant Lippenslaan 200,2023-06-17,00:00:00,0,0,0,FMN 15 Luitenant Lippenslaan
662,Luitenant Lippenslaan 200,2023-06-17,01:00:00,32,7,25,FMN 15 Luitenant Lippenslaan
662,Luitenant Lippenslaan 200,2023-06-17,02:00:00,29,9,20,FMN 15 Luitenant Lippenslaan
662,Luitenant Lippenslaan 200,2023-06-17,03:00:00,15,6,9,FMN 15 Luitenant Lippenslaan
662,Luitenant Lippenslaan 200,2023-06-17,04:00:00,17,10,7,FMN 15 Luitenant Lippenslaan
662,Luitenant Lippenslaan 200,2023-06-17,05:00:00,25,4,21,FMN 15 Luitenant Lippenslaan
662,Luitenant Lippenslaan 200,2023-06-17,06:00:00,43,10,33,FMN 15 Luitenant Lippenslaan
662,Luitenant Lippenslaan 200,2023-06-17,07:00:00,67,13,54,FMN 15 Luitenant Lippenslaan
662,Luitenant Lippenslaan 200,2023-06-17,08:00:00,115,19,96,FMN 15 Luitenant Lippenslaan
662,Luitenant Lippenslaan 200,2023-06-17,09:00:00,196,39,157,FMN 15 Luitenant Lippenslaan
662,Luitenant Lippenslaan 200,2023-06-17,10:00:00,260,51,209,FMN 15 Luitenant Lippenslaan
662,Luitenant Lippenslaan 200,2023-06-17,11:00:00,256,55,201,FMN 15 Luitenant Lippenslaan
662,Luitenant Lippenslaan 200,2023-06-17,12:00:00,252,55,197,FMN 15 Luitenant Lippenslaan
662,Luitenant Lippenslaan 200,2023-06-17,13:00:00,283,58,225,FMN 15 Luitenant Lippenslaan
662,Luitenant Lippenslaan 200,2023-06-17,14:00:00,268,52,216,FMN 15 Luitenant Lippenslaan
662,Luitenant Lippenslaan 200,2023-06-17,15:00:00,241,48,193,FMN 15 Luitenant Lippenslaan
662,Luitenant Lippenslaan 200,2023-06-17,16:00:00,229,49,180,FMN 15 Luitenant Lippenslaan
662,Luitenant Lippenslaan 200,2023-06-17,17:00:00,254,60,194,FMN 15 Luitenant Lippenslaan
662,Luitenant Lippenslaan 200,2023-06-17,18:00:00,255,55,200,FMN 15 Luitenant Lippenslaan
662,Luitenant Lippenslaan 200,2023-06-17,19:00:00,224,40,184,FMN 15 Luitenant Lippenslaan
662,Luitenant Lippenslaan 200,2023-06-17,20:00:00,161,27,134,FMN 15 Luitenant Lippenslaan
662,Luitenant Lippenslaan 200,2023-06-17,21:00:00,111,21,90,FMN 15 Luitenant Lippenslaan
662,Luitenant Lippenslaan 200,2023-06-17,22:00:00,104,27,77,FMN 15 Luitenant Lippenslaan
662,Luitenant Lippenslaan 200,2023-06-17,23:00:00,68,17,51,FMN 15 Luitenant Lippenslaan
662,Luitenant Lippenslaan 200,2023-06-18,00:00:00,0,0,0,FMN 15 Luitenant Lippenslaan
662,Luitenant Lippenslaan 200,2023-06-18,01:00:00,32,9,23,FMN 15 Luitenant Lippenslaan
662,Luitenant Lippenslaan 200,2023-06-18,02:00:00,23,6,17,FMN 15 Luitenant Lippenslaan
662,Luitenant Lippenslaan 200,2023-06-18,03:00:00,24,8,16,FMN 15 Luitenant Lippenslaan
662,Luitenant Lippenslaan 200,2023-06-18,04:00:00,14,3,11,FMN 15 Luitenant Lippenslaan
662,Luitenant Lippenslaan 200,2023-06-18,05:00:00,20,9,11,FMN 15 Luitenant Lippenslaan
662,Luitenant Lippenslaan 200,2023-06-18,06:00:00,50,13,37,FMN 15 Luitenant Lippenslaan
662,Luitenant Lippenslaan 200,2023-06-18,07:00:00,34,7,27,FMN 15 Luitenant Lippenslaan
662,Luitenant Lippenslaan 200,2023-06-18,08:00:00,60,11,49,FMN 15 Luitenant Lippenslaan
662,Luitenant Lippenslaan 200,2023-06-18,09:00:00,140,25,115,FMN 15 Luitenant Lippenslaan
662,Luitenant Lippenslaan 200,2023-06-18,10:00:00,154,29,125,FMN 15 Luitenant Lippenslaan
662,Luitenant Lippenslaan 200,2023-06-18,11:00:00,161,34,127,FMN 15 Luitenant Lippenslaan
662,Luitenant Lippenslaan 200,2023-06-18,12:00:00,196,33,163,FMN 15 Luitenant Lippenslaan
662,Luitenant Lippenslaan 200,2023-06-18,13:00:00,201,45,156,FMN 15 Luitenant Lippenslaan
662,Luitenant Lippenslaan 200,2023-06-18,14:00:00,197,35,162,FMN 15 Luitenant Lippenslaan
662,Luitenant Lippenslaan 200,2023-06-18,15:00:00,182,39,143,FMN 15 Luitenant Lippenslaan
662,Luitenant Lippenslaan 200,2023-06-18,16:00:00,166,39,127,FMN 15 Luitenant Lippenslaan
662,Luitenant Lippenslaan 200,2023-06-18,17:00:00,168,31,137,FMN 15 Luitenant Lippenslaan
662,Luitenant Lippenslaan 200,2023-06-18,18:00:00,177,33,144,FMN 15 Luitenant Lippenslaan
662,Luitenant Lippenslaan 200,2023-06-18,19:00:00,148,27,121,FMN 15 Luitenant Lippenslaan
662,Luitenant Lippenslaan 200,2023-06-18,20:00:00,108,23,85,FMN 15 Luitenant Lippenslaan
662,Luitenant Lippenslaan 200,2023-06-18,21:00:00,84,16,68,FMN 15 Luitenant Lippenslaan
662,Luitenant Lippenslaan 200,2023-06-18,22:00:00,57,16,41,FMN 15 Luitenant Lippenslaan
662,Luitenant Lippenslaan 200,2023-06-18,23:00:00,34,9,25,FMN 15 Luitenant Lippenslaan
662,Luitenant Lippenslaan 200,2023-06-19,00:00:00,0,0,0,FMN 15 Luitenant Lippenslaan
662,Luitenant Lippenslaan 200,2023-06-19,01:00:00,12,6,6,FMN 15 Luitenant Lippenslaan
662,Luitenant Lippenslaan 200,2023-06-19,02:00:00,18,5,13,FMN 15 Luitenant Lippenslaan
662,Luitenant Lippenslaan 200,2023-06-19,03:00:00,11,3,8,FMN 15 Luitenant Lippenslaan
662,Luitenant Lippenslaan 200,2023-06-19,04:00:00,23,6,17,FMN 15 Luitenant Lippenslaan
662,Luitenant Lippenslaan 200,2023-06-19,05:00:00,42,12,30,FMN 15 Luitenant Lippenslaan
662,Luitenant Lippenslaan 200,2023-06-19,06:00:00,159,29,130,FMN 15 Luitenant Lippenslaan
662,Luitenant Lippenslaan 200,2023-06-19,07:00:00,422,75,347,FMN 15 Luitenant Lippenslaan
662,Luitenant Lippenslaan 200,2023-06-19,08:00:00,879,162,717,FMN 15 Luitenant Lippenslaan
662,Luitenant Lippenslaan 200,2023-06-19,09:00:00,365,63,302,FMN 15 Luitenant Lippenslaan
662,Luitenant Lippenslaan 200,2023-06-19,10:00:00,239,48,191,FMN 15 Luitenant Lippenslaan
662,Luitenant Lippenslaan 200,2023-06-19,11:00:00,182,39,143,FMN 15 Luitenant Lippenslaan
662,Luitenant Lippenslaan 200,2023-06-19,12:00:00,249,55,194,FMN 15 Luitenant Lippenslaan
662,Luitenant Lippenslaan 200,2023-06-19,13:00:00,210,47,163,FMN 15 Luitenant Lippenslaan
662,Luitenant Lippenslaan 200,2023-06-19,14:00:00,215,42,173,FMN 15 Luitenant Lippenslaan
662,Luitenant Lippenslaan 200,2023-06-19,15:00:00,230,45,185,FMN 15 Luitenant Lippenslaan
662,Luitenant Lippenslaan 200,2023-06-19,16:00:00,333,63,270,FMN 15 Luitenant Lippenslaan
662,Luitenant Lippenslaan 200,2023-06-19,17:00:00,361,74,287,FMN 15 Luitenant Lippenslaan
662,Luitenant Lippenslaan 200,2023-06-19,18:00:00,312,57,255,FMN 15 Luitenant Lippenslaan
662,Luitenant Lippenslaan 200,2023-06-19,19:00:00,230,60,170,FMN 15 Luitenant Lippenslaan
662,Luitenant Lippenslaan 200,2023-06-19,20:00:00,169,36,133,FMN 15 Luitenant Lippenslaan
662,Luitenant Lippenslaan 200,2023-06-19,21:00:00,113,28,85,FMN 15 Luitenant Lippenslaan
662,Luitenant Lippenslaan 200,2023-06-19,22:00:00,108,25,83,FMN 15 Luitenant Lippenslaan
662,Luitenant Lippenslaan 200,2023-06-19,23:00:00,44,10,34,FMN 15 Luitenant Lippenslaan
662,Luitenant Lippenslaan 200,2023-06-20,00:00:00,0,0,0,FMN 15 Luitenant Lippenslaan
662,Luitenant Lippenslaan 200,2023-06-20,01:00:00,6,2,4,FMN 15 Luitenant Lippenslaan
662,Luitenant Lippenslaan 200,2023-06-20,02:00:00,9,5,4,FMN 15 Luitenant Lippenslaan
662,Luitenant Lippenslaan 200,2023-06-20,03:00:00,9,4,5,FMN 15 Luitenant Lippenslaan
662,Luitenant Lippenslaan 200,2023-06-20,04:00:00,25,6,19,FMN 15 Luitenant Lippenslaan
662,Luitenant Lippenslaan 200,2023-06-20,05:00:00,40,8,32,FMN 15 Luitenant Lippenslaan
662,Luitenant Lippenslaan 200,2023-06-20,06:00:00,167,31,136,FMN 15 Luitenant Lippenslaan
662,Luitenant Lippenslaan 200,2023-06-20,07:00:00,434,75,359,FMN 15 Luitenant Lippenslaan
662,Luitenant Lippenslaan 200,2023-06-20,08:00:00,945,140,805,FMN 15 Luitenant Lippenslaan
662,Luitenant Lippenslaan 200,2023-06-20,09:00:00,352,62,290,FMN 15 Luitenant Lippenslaan
662,Luitenant Lippenslaan 200,2023-06-20,10:00:00,207,39,168,FMN 15 Luitenant Lippenslaan
662,Luitenant Lippenslaan 200,2023-06-20,11:00:00,179,37,142,FMN 15 Luitenant Lippenslaan
662,Luitenant Lippenslaan 200,2023-06-20,12:00:00,205,47,158,FMN 15 Luitenant Lippenslaan
662,Luitenant Lippenslaan 200,2023-06-20,13:00:00,217,50,167,FMN 15 Luitenant Lippenslaan
662,Luitenant Lippenslaan 200,2023-06-20,14:00:00,171,38,133,FMN 15 Luitenant Lippenslaan
662,Luitenant Lippenslaan 200,2023-06-20,15:00:00,224,47,177,FMN 15 Luitenant Lippenslaan
662,Luitenant Lippenslaan 200,2023-06-20,16:00:00,290,64,226,FMN 15 Luitenant Lippenslaan
662,Luitenant Lippenslaan 200,2023-06-20,17:00:00,312,56,256,FMN 15 Luitenant Lippenslaan
662,Luitenant Lippenslaan 200,2023-06-20,18:00:00,281,43,238,FMN 15 Luitenant Lippenslaan
662,Luitenant Lippenslaan 200,2023-06-20,19:00:00,204,45,159,FMN 15 Luitenant Lippenslaan
662,Luitenant Lippenslaan 200,2023-06-20,20:00:00,140,28,112,FMN 15 Luitenant Lippenslaan
662,Luitenant Lippenslaan 200,2023-06-20,21:00:00,107,23,84,FMN 15 Luitenant Lippenslaan
662,Luitenant Lippenslaan 200,2023-06-20,22:00:00,77,13,64,FMN 15 Luitenant Lippenslaan
662,Luitenant Lippenslaan 200,2023-06-20,23:00:00,61,14,47,FMN 15 Luitenant Lippenslaan
662,Luitenant Lippenslaan 200,2023-06-21,00:00:00,0,0,0,FMN 15 Luitenant Lippenslaan
662,Luitenant Lippenslaan 200,2023-06-21,01:00:00,8,0,8,FMN 15 Luitenant Lippenslaan
662,Luitenant Lippenslaan 200,2023-06-21,02:00:00,13,6,7,FMN 15 Luitenant Lippenslaan
662,Luitenant Lippenslaan 200,2023-06-21,03:00:00,8,1,7,FMN 15 Luitenant Lippenslaan
662,Luitenant Lippenslaan 200,2023-06-21,04:00:00,27,8,19,FMN 15 Luitenant Lippenslaan
662,Luitenant Lippenslaan 200,2023-06-21,05:00:00,47,8,39,FMN 15 Luitenant Lippenslaan
662,Luitenant Lippenslaan 200,2023-06-21,06:00:00,177,29,148,FMN 15 Luitenant Lippenslaan
662,Luitenant Lippenslaan 200,2023-06-21,07:00:00,459,65,394,FMN 15 Luitenant Lippenslaan
662,Luitenant Lippenslaan 200,2023-06-21,08:00:00,886,124,762,FMN 15 Luitenant Lippenslaan
662,Luitenant Lippenslaan 200,2023-06-21,09:00:00,385,68,317,FMN 15 Luitenant Lippenslaan
662,Luitenant Lippenslaan 200,2023-06-21,10:00:00,240,40,200,FMN 15 Luitenant Lippenslaan
662,Luitenant Lippenslaan 200,2023-06-21,11:00:00,202,43,159,FMN 15 Luitenant Lippenslaan
662,Luitenant Lippenslaan 200,2023-06-21,12:00:00,314,69,245,FMN 15 Luitenant Lippenslaan
662,Luitenant Lippenslaan 200,2023-06-21,13:00:00,288,49,239,FMN 15 Luitenant Lippenslaan
662,Luitenant Lippenslaan 200,2023-06-21,14:00:00,227,45,182,FMN 15 Luitenant Lippenslaan
662,Luitenant Lippenslaan 200,2023-06-21,15:00:00,267,54,213,FMN 15 Luitenant Lippenslaan
662,Luitenant Lippenslaan 200,2023-06-21,16:00:00,321,64,257,FMN 15 Luitenant Lippenslaan
662,Luitenant Lippenslaan 200,2023-06-21,17:00:00,362,64,298,FMN 15 Luitenant Lippenslaan
662,Luitenant Lippenslaan 200,2023-06-21,18:00:00,314,52,262,FMN 15 Luitenant Lippenslaan
662,Luitenant Lippenslaan 200,2023-06-21,19:00:00,259,52,207,FMN 15 Luitenant Lippenslaan
662,Luitenant Lippenslaan 200,2023-06-21,20:00:00,170,37,133,FMN 15 Luitenant Lippenslaan
662,Luitenant Lippenslaan 200,2023-06-21,21:00:00,101,23,78,FMN 15 Luitenant Lippenslaan
662,Luitenant Lippenslaan 200,2023-06-21,22:00:00,109,21,88,FMN 15 Luitenant Lippenslaan
662,Luitenant Lippenslaan 200,2023-06-21,23:00:00,53,10,43,FMN 15 Luitenant Lippenslaan
662,Luitenant Lippenslaan 200,2023-06-22,00:00:00,0,0,0,FMN 15 Luitenant Lippenslaan
662,Luitenant Lippenslaan 200,2023-06-22,01:00:00,9,4,5,FMN 15 Luitenant Lippenslaan
662,Luitenant Lippenslaan 200,2023-06-22,02:00:00,10,5,5,FMN 15 Luitenant Lippenslaan
662,Luitenant Lippenslaan 200,2023-06-22,03:00:00,6,1,5,FMN 15 Luitenant Lippenslaan
662,Luitenant Lippenslaan 200,2023-06-22,04:00:00,11,2,9,FMN 15 Luitenant Lippenslaan
662,Luitenant Lippenslaan 200,2023-06-22,05:00:00,32,9,23,FMN 15 Luitenant Lippenslaan
662,Luitenant Lippenslaan 200,2023-06-22,06:00:00,121,29,92,FMN 15 Luitenant Lippenslaan
662,Luitenant Lippenslaan 200,2023-06-22,07:00:00,330,68,262,FMN 15 Luitenant Lippenslaan
662,Luitenant Lippenslaan 200,2023-06-22,08:00:00,692,110,582,FMN 15 Luitenant Lippenslaan
662,Luitenant Lippenslaan 200,2023-06-22,09:00:00,274,63,211,FMN 15 Luitenant Lippenslaan
662,Luitenant Lippenslaan 200,2023-06-22,10:00:00,179,31,148,FMN 15 Luitenant Lippenslaan
662,Luitenant Lippenslaan 200,2023-06-22,11:00:00,144,42,102,FMN 15 Luitenant Lippenslaan
662,Luitenant Lippenslaan 200,2023-06-22,12:00:00,163,39,124,FMN 15 Luitenant Lippenslaan
662,Luitenant Lippenslaan 200,2023-06-22,13:00:00,165,32,133,FMN 15 Luitenant Lippenslaan
662,Luitenant Lippenslaan 200,2023-06-22,14:00:00,144,30,114,FMN 15 Luitenant Lippenslaan
662,Luitenant Lippenslaan 200,2023-06-22,15:00:00,182,39,143,FMN 15 Luitenant Lippenslaan
662,Luitenant Lippenslaan 200,2023-06-22,16:00:00,238,58,180,FMN 15 Luitenant Lippenslaan
662,Luitenant Lippenslaan 200,2023-06-22,17:00:00,279,59,220,FMN 15 Luitenant Lippenslaan
662,Luitenant Lippenslaan 200,2023-06-22,18:00:00,272,54,218,FMN 15 Luitenant Lippenslaan
662,Luitenant Lippenslaan 200,2023-06-22,19:00:00,217,48,169,FMN 15 Luitenant Lippenslaan
662,Luitenant Lippenslaan 200,2023-06-22,20:00:00,147,29,118,FMN 15 Luitenant Lippenslaan
662,Luitenant Lippenslaan 200,2023-06-22,21:00:00,92,21,71,FMN 15 Luitenant Lippenslaan
662,Luitenant Lippenslaan 200,2023-06-22,22:00:00,74,17,57,FMN 15 Luitenant Lippenslaan
662,Luitenant Lippenslaan 200,2023-06-22,23:00:00,43,18,25,FMN 15 Luitenant Lippenslaan
662,Luitenant Lippenslaan 200,2023-06-23,00:00:00,0,0,0,FMN 15 Luitenant Lippenslaan
662,Luitenant Lippenslaan 200,2023-06-23,01:00:00,18,6,12,FMN 15 Luitenant Lippenslaan
662,Luitenant Lippenslaan 200,2023-06-23,02:00:00,13,4,9,FMN 15 Luitenant Lippenslaan
662,Luitenant Lippenslaan 200,2023-06-23,03:00:00,14,8,6,FMN 15 Luitenant Lippenslaan
662,Luitenant Lippenslaan 200,2023-06-23,04:00:00,22,5,17,FMN 15 Luitenant Lippenslaan
662,Luitenant Lippenslaan 200,2023-06-23,05:00:00,33,6,27,FMN 15 Luitenant Lippenslaan
662,Luitenant Lippenslaan 200,2023-06-23,06:00:00,153,27,126,FMN 15 Luitenant Lippenslaan
662,Luitenant Lippenslaan 200,2023-06-23,07:00:00,418,77,341,FMN 15 Luitenant Lippenslaan
662,Luitenant Lippenslaan 200,2023-06-23,08:00:00,816,104,712,FMN 15 Luitenant Lippenslaan
662,Luitenant Lippenslaan 200,2023-06-23,09:00:00,367,59,308,FMN 15 Luitenant Lippenslaan
662,Luitenant Lippenslaan 200,2023-06-23,10:00:00,252,49,203,FMN 15 Luitenant Lippenslaan
662,Luitenant Lippenslaan 200,2023-06-23,11:00:00,214,55,159,FMN 15 Luitenant Lippenslaan
662,Luitenant Lippenslaan 200,2023-06-23,12:00:00,283,53,230,FMN 15 Luitenant Lippenslaan
662,Luitenant Lippenslaan 200,2023-06-23,13:00:00,274,71,203,FMN 15 Luitenant Lippenslaan
662,Luitenant Lippenslaan 200,2023-06-23,14:00:00,239,50,189,FMN 15 Luitenant Lippenslaan
662,Luitenant Lippenslaan 200,2023-06-23,15:00:00,284,61,223,FMN 15 Luitenant Lippenslaan
662,Luitenant Lippenslaan 200,2023-06-23,16:00:00,341,71,270,FMN 15 Luitenant Lippenslaan
662,Luitenant Lippenslaan 200,2023-06-23,17:00:00,371,65,306,FMN 15 Luitenant Lippenslaan
662,Luitenant Lippenslaan 200,2023-06-23,18:00:00,355,65,290,FMN 15 Luitenant Lippenslaan
662,Luitenant Lippenslaan 200,2023-06-23,19:00:00,318,60,258,FMN 15 Luitenant Lippenslaan
662,Luitenant Lippenslaan 200,2023-06-23,20:00:00,205,50,155,FMN 15 Luitenant Lippenslaan
662,Luitenant Lippenslaan 200,2023-06-23,21:00:00,165,24,141,FMN 15 Luitenant Lippenslaan
662,Luitenant Lippenslaan 200,2023-06-23,22:00:00,120,20,100,FMN 15 Luitenant Lippenslaan
662,Luitenant Lippenslaan 200,2023-06-23,23:00:00,80,23,57,FMN 15 Luitenant Lippenslaan
662,Luitenant Lippenslaan 200,2023-06-24,00:00:00,0,0,0,FMN 15 Luitenant Lippenslaan
662,Luitenant Lippenslaan 200,2023-06-24,01:00:00,34,6,28,FMN 15 Luitenant Lippenslaan
662,Luitenant Lippenslaan 200,2023-06-24,02:00:00,34,6,28,FMN 15 Luitenant Lippenslaan
662,Luitenant Lippenslaan 200,2023-06-24,03:00:00,24,7,17,FMN 15 Luitenant Lippenslaan
662,Luitenant Lippenslaan 200,2023-06-24,04:00:00,27,9,18,FMN 15 Luitenant Lippenslaan
662,Luitenant Lippenslaan 200,2023-06-24,05:00:00,32,7,25,FMN 15 Luitenant Lippenslaan
662,Luitenant Lippenslaan 200,2023-06-24,06:00:00,46,11,35,FMN 15 Luitenant Lippenslaan
662,Luitenant Lippenslaan 200,2023-06-24,07:00:00,65,14,51,FMN 15 Luitenant Lippenslaan
662,Luitenant Lippenslaan 200,2023-06-24,08:00:00,160,31,129,FMN 15 Luitenant Lippenslaan
662,Luitenant Lippenslaan 200,2023-06-24,09:00:00,226,33,193,FMN 15 Luitenant Lippenslaan
662,Luitenant Lippenslaan 200,2023-06-24,10:00:00,285,56,229,FMN 15 Luitenant Lippenslaan
662,Luitenant Lippenslaan 200,2023-06-24,11:00:00,269,54,215,FMN 15 Luitenant Lippenslaan
662,Luitenant Lippenslaan 200,2023-06-24,12:00:00,293,59,234,FMN 15 Luitenant Lippenslaan
662,Luitenant Lippenslaan 200,2023-06-24,13:00:00,316,62,254,FMN 15 Luitenant Lippenslaan
662,Luitenant Lippenslaan 200,2023-06-24,14:00:00,293,54,239,FMN 15 Luitenant Lippenslaan
662,Luitenant Lippenslaan 200,2023-06-24,15:00:00,261,47,214,FMN 15 Luitenant Lippenslaan
662,Luitenant Lippenslaan 200,2023-06-24,16:00:00,238,55,183,FMN 15 Luitenant Lippenslaan
662,Luitenant Lippenslaan 200,2023-06-24,17:00:00,272,51,221,FMN 15 Luitenant Lippenslaan
662,Luitenant Lippenslaan 200,2023-06-24,18:00:00,287,55,232,FMN 15 Luitenant Lippenslaan
662,Luitenant Lippenslaan 200,2023-06-24,19:00:00,227,49,178,FMN 15 Luitenant Lippenslaan
662,Luitenant Lippenslaan 200,2023-06-24,20:00:00,176,43,133,FMN 15 Luitenant Lippenslaan
662,Luitenant Lippenslaan 200,2023-06-24,21:00:00,123,17,106,FMN 15 Luitenant Lippenslaan
662,Luitenant Lippenslaan 200,2023-06-24,22:00:00,114,19,95,FMN 15 Luitenant Lippenslaan
662,Luitenant Lippenslaan 200,2023-06-24,23:00:00,74,21,53,FMN 15 Luitenant Lippenslaan
662,Luitenant Lippenslaan 200,2023-06-25,00:00:00,0,0,0,FMN 15 Luitenant Lippenslaan
662,Luitenant Lippenslaan 200,2023-06-25,01:00:00,43,8,35,FMN 15 Luitenant Lippenslaan
662,Luitenant Lippenslaan 200,2023-06-25,02:00:00,27,6,21,FMN 15 Luitenant Lippenslaan
662,Luitenant Lippenslaan 200,2023-06-25,03:00:00,27,10,17,FMN 15 Luitenant Lippenslaan
662,Luitenant Lippenslaan 200,2023-06-25,04:00:00,22,6,16,FMN 15 Luitenant Lippenslaan
662,Luitenant Lippenslaan 200,2023-06-25,05:00:00,21,10,11,FMN 15 Luitenant Lippenslaan
662,Luitenant Lippenslaan 200,2023-06-25,06:00:00,34,8,26,FMN 15 Luitenant Lippenslaan
662,Luitenant Lippenslaan 200,2023-06-25,07:00:00,38,6,32,FMN 15 Luitenant Lippenslaan
662,Luitenant Lippenslaan 200,2023-06-25,08:00:00,80,14,66,FMN 15 Luitenant Lippenslaan
662,Luitenant Lippenslaan 200,2023-06-25,09:00:00,160,32,128,FMN 15 Luitenant Lippenslaan
662,Luitenant Lippenslaan 200,2023-06-25,10:00:00,192,36,156,FMN 15 Luitenant Lippenslaan
662,Luitenant Lippenslaan 200,2023-06-25,11:00:00,211,49,162,FMN 15 Luitenant Lippenslaan
662,Luitenant Lippenslaan 200,2023-06-25,12:00:00,229,48,181,FMN 15 Luitenant Lippenslaan
662,Luitenant Lippenslaan 200,2023-06-25,13:00:00,267,59,208,FMN 15 Luitenant Lippenslaan
662,Luitenant Lippenslaan 200,2023-06-25,14:00:00,260,49,211,FMN 15 Luitenant Lippenslaan
662,Luitenant Lippenslaan 200,2023-06-25,15:00:00,209,41,168,FMN 15 Luitenant Lippenslaan
662,Luitenant Lippenslaan 200,2023-06-25,16:00:00,218,37,181,FMN 15 Luitenant Lippenslaan
662,Luitenant Lippenslaan 200,2023-06-25,17:00:00,215,39,176,FMN 15 Luitenant Lippenslaan
662,Luitenant Lippenslaan 200,2023-06-25,18:00:00,216,41,175,FMN 15 Luitenant Lippenslaan
662,Luitenant Lippenslaan 200,2023-06-25,19:00:00,186,36,150,FMN 15 Luitenant Lippenslaan
662,Luitenant Lippenslaan 200,2023-06-25,20:00:00,131,28,103,FMN 15 Luitenant Lippenslaan
662,Luitenant Lippenslaan 200,2023-06-25,21:00:00,117,21,96,FMN 15 Luitenant Lippenslaan
662,Luitenant Lippenslaan 200,2023-06-25,22:00:00,87,23,64,FMN 15 Luitenant Lippenslaan
662,Luitenant Lippenslaan 200,2023-06-25,23:00:00,51,12,39,FMN 15 Luitenant Lippenslaan
662,Luitenant Lippenslaan 200,2023-06-26,00:00:00,0,0,0,FMN 15 Luitenant Lippenslaan
662,Luitenant Lippenslaan 200,2023-06-26,01:00:00,12,1,11,FMN 15 Luitenant Lippenslaan
662,Luitenant Lippenslaan 200,2023-06-26,02:00:00,17,7,10,FMN 15 Luitenant Lippenslaan
662,Luitenant Lippenslaan 200,2023-06-26,03:00:00,5,2,3,FMN 15 Luitenant Lippenslaan
662,Luitenant Lippenslaan 200,2023-06-26,04:00:00,22,11,11,FMN 15 Luitenant Lippenslaan
662,Luitenant Lippenslaan 200,2023-06-26,05:00:00,38,11,27,FMN 15 Luitenant Lippenslaan
662,Luitenant Lippenslaan 200,2023-06-26,06:00:00,134,27,107,FMN 15 Luitenant Lippenslaan
662,Luitenant Lippenslaan 200,2023-06-26,07:00:00,389,75,314,FMN 15 Luitenant Lippenslaan
662,Luitenant Lippenslaan 200,2023-06-26,08:00:00,821,167,654,FMN 15 Luitenant Lippenslaan
662,Luitenant Lippenslaan 200,2023-06-26,09:00:00,314,65,249,FMN 15 Luitenant Lippenslaan
662,Luitenant Lippenslaan 200,2023-06-26,10:00:00,205,48,157,FMN 15 Luitenant Lippenslaan
662,Luitenant Lippenslaan 200,2023-06-26,11:00:00,183,42,141,FMN 15 Luitenant Lippenslaan
662,Luitenant Lippenslaan 200,2023-06-26,12:00:00,204,51,153,FMN 15 Luitenant Lippenslaan
662,Luitenant Lippenslaan 200,2023-06-26,13:00:00,181,45,136,FMN 15 Luitenant Lippenslaan
662,Luitenant Lippenslaan 200,2023-06-26,14:00:00,199,46,153,FMN 15 Luitenant Lippenslaan
662,Luitenant Lippenslaan 200,2023-06-26,15:00:00,213,49,164,FMN 15 Luitenant Lippenslaan
662,Luitenant Lippenslaan 200,2023-06-26,16:00:00,319,69,250,FMN 15 Luitenant Lippenslaan
662,Luitenant Lippenslaan 200,2023-06-26,17:00:00,323,74,249,FMN 15 Luitenant Lippenslaan
662,Luitenant Lippenslaan 200,2023-06-26,18:00:00,284,52,232,FMN 15 Luitenant Lippenslaan
662,Luitenant Lippenslaan 200,2023-06-26,19:00:00,200,38,162,FMN 15 Luitenant Lippenslaan
662,Luitenant Lippenslaan 200,2023-06-26,20:00:00,138,32,106,FMN 15 Luitenant Lippenslaan
662,Luitenant Lippenslaan 200,2023-06-26,21:00:00,100,21,79,FMN 15 Luitenant Lippenslaan
662,Luitenant Lippenslaan 200,2023-06-26,22:00:00,88,17,71,FMN 15 Luitenant Lippenslaan
662,Luitenant Lippenslaan 200,2023-06-26,23:00:00,40,13,27,FMN 15 Luitenant Lippenslaan
662,Luitenant Lippenslaan 200,2023-06-27,00:00:00,0,0,0,FMN 15 Luitenant Lippenslaan
662,Luitenant Lippenslaan 200,2023-06-27,01:00:00,9,3,6,FMN 15 Luitenant Lippenslaan
662,Luitenant Lippenslaan 200,2023-06-27,02:00:00,7,6,1,FMN 15 Luitenant Lippenslaan
662,Luitenant Lippenslaan 200,2023-06-27,03:00:00,9,5,4,FMN 15 Luitenant Lippenslaan
662,Luitenant Lippenslaan 200,2023-06-27,04:00:00,13,5,8,FMN 15 Luitenant Lippenslaan
662,Luitenant Lippenslaan 200,2023-06-27,05:00:00,40,13,27,FMN 15 Luitenant Lippenslaan
662,Luitenant Lippenslaan 200,2023-06-27,06:00:00,170,33,137,FMN 15 Luitenant Lippenslaan
662,Luitenant Lippenslaan 200,2023-06-27,07:00:00,464,85,379,FMN 15 Luitenant Lippenslaan
662,Luitenant Lippenslaan 200,2023-06-27,08:00:00,975,151,824,FMN 15 Luitenant Lippenslaan
662,Luitenant Lippenslaan 200,2023-06-27,09:00:00,375,69,306,FMN 15 Luitenant Lippenslaan
662,Luitenant Lippenslaan 200,2023-06-27,10:00:00,211,48,163,FMN 15 Luitenant Lippenslaan
662,Luitenant Lippenslaan 200,2023-06-27,11:00:00,178,38,140,FMN 15 Luitenant Lippenslaan
662,Luitenant Lippenslaan 200,2023-06-27,12:00:00,237,56,181,FMN 15 Luitenant Lippenslaan
662,Luitenant Lippenslaan 200,2023-06-27,13:00:00,228,51,177,FMN 15 Luitenant Lippenslaan
662,Luitenant Lippenslaan 200,2023-06-27,14:00:00,172,41,131,FMN 15 Luitenant Lippenslaan
662,Luitenant Lippenslaan 200,2023-06-27,15:00:00,238,50,188,FMN 15 Luitenant Lippenslaan
662,Luitenant Lippenslaan 200,2023-06-27,16:00:00,316,82,234,FMN 15 Luitenant Lippenslaan
662,Luitenant Lippenslaan 200,2023-06-27,17:00:00,318,64,254,FMN 15 Luitenant Lippenslaan
662,Luitenant Lippenslaan 200,2023-06-27,18:00:00,275,52,223,FMN 15 Luitenant Lippenslaan
662,Luitenant Lippenslaan 200,2023-06-27,19:00:00,206,48,158,FMN 15 Luitenant Lippenslaan
662,Luitenant Lippenslaan 200,2023-06-27,20:00:00,135,23,112,FMN 15 Luitenant Lippenslaan
662,Luitenant Lippenslaan 200,2023-06-27,21:00:00,115,21,94,FMN 15 Luitenant Lippenslaan
662,Luitenant Lippenslaan 200,2023-06-27,22:00:00,73,19,54,FMN 15 Luitenant Lippenslaan
662,Luitenant Lippenslaan 200,2023-06-27,23:00:00,51,16,35,FMN 15 Luitenant Lippenslaan
662,Luitenant Lippenslaan 200,2023-06-28,00:00:00,0,0,0,FMN 15 Luitenant Lippenslaan
662,Luitenant Lippenslaan 200,2023-06-28,01:00:00,6,0,6,FMN 15 Luitenant Lippenslaan
662,Luitenant Lippenslaan 200,2023-06-28,02:00:00,12,2,10,FMN 15 Luitenant Lippenslaan
662,Luitenant Lippenslaan 200,2023-06-28,03:00:00,12,3,9,FMN 15 Luitenant Lippenslaan
662,Luitenant Lippenslaan 200,2023-06-28,04:00:00,20,5,15,FMN 15 Luitenant Lippenslaan
662,Luitenant Lippenslaan 200,2023-06-28,05:00:00,64,12,52,FMN 15 Luitenant Lippenslaan
662,Luitenant Lippenslaan 200,2023-06-28,06:00:00,150,29,121,FMN 15 Luitenant Lippenslaan
662,Luitenant Lippenslaan 200,2023-06-28,07:00:00,412,63,349,FMN 15 Luitenant Lippenslaan
662,Luitenant Lippenslaan 200,2023-06-28,08:00:00,809,116,693,FMN 15 Luitenant Lippenslaan
662,Luitenant Lippenslaan 200,2023-06-28,09:00:00,342,54,288,FMN 15 Luitenant Lippenslaan
662,Luitenant Lippenslaan 200,2023-06-28,10:00:00,224,38,186,FMN 15 Luitenant Lippenslaan
662,Luitenant Lippenslaan 200,2023-06-28,11:00:00,183,34,149,FMN 15 Luitenant Lippenslaan
662,Luitenant Lippenslaan 200,2023-06-28,12:00:00,282,57,225,FMN 15 Luitenant Lippenslaan
662,Luitenant Lippenslaan 200,2023-06-28,13:00:00,262,45,217,FMN 15 Luitenant Lippenslaan
662,Luitenant Lippenslaan 200,2023-06-28,14:00:00,193,36,157,FMN 15 Luitenant Lippenslaan
662,Luitenant Lippenslaan 200,2023-06-28,15:00:00,239,38,201,FMN 15 Luitenant Lippenslaan
662,Luitenant Lippenslaan 200,2023-06-28,16:00:00,295,61,234,FMN 15 Luitenant Lippenslaan
662,Luitenant Lippenslaan 200,2023-06-28,17:00:00,341,57,284,FMN 15 Luitenant Lippenslaan
662,Luitenant Lippenslaan 200,2023-06-28,18:00:00,296,57,239,FMN 15 Luitenant Lippenslaan
662,Luitenant Lippenslaan 200,2023-06-28,19:00:00,231,47,184,FMN 15 Luitenant Lippenslaan
662,Luitenant Lippenslaan 200,2023-06-28,20:00:00,157,27,130,FMN 15 Luitenant Lippenslaan
662,Luitenant Lippenslaan 200,2023-06-28,21:00:00,87,22,65,FMN 15 Luitenant Lippenslaan
662,Luitenant Lippenslaan 200,2023-06-28,22:00:00,110,29,81,FMN 15 Luitenant Lippenslaan
662,Luitenant Lippenslaan 200,2023-06-28,23:00:00,39,11,28,FMN 15 Luitenant Lippenslaan
662,Luitenant Lippenslaan 200,2023-06-29,00:00:00,0,0,0,FMN 15 Luitenant Lippenslaan
662,Luitenant Lippenslaan 200,2023-06-29,01:00:00,11,0,11,FMN 15 Luitenant Lippenslaan
662,Luitenant Lippenslaan 200,2023-06-29,02:00:00,5,2,3,FMN 15 Luitenant Lippenslaan
662,Luitenant Lippenslaan 200,2023-06-29,03:00:00,4,2,2,FMN 15 Luitenant Lippenslaan
662,Luitenant Lippenslaan 200,2023-06-29,04:00:00,14,6,8,FMN 15 Luitenant Lippenslaan
662,Luitenant Lippenslaan 200,2023-06-29,05:00:00,40,11,29,FMN 15 Luitenant Lippenslaan
662,Luitenant Lippenslaan 200,2023-06-29,06:00:00,126,21,105,FMN 15 Luitenant Lippenslaan
662,Luitenant Lippenslaan 200,2023-06-29,07:00:00,364,68,296,FMN 15 Luitenant Lippenslaan
662,Luitenant Lippenslaan 200,2023-06-29,08:00:00,773,135,638,FMN 15 Luitenant Lippenslaan
662,Luitenant Lippenslaan 200,2023-06-29,09:00:00,314,69,245,FMN 15 Luitenant Lippenslaan
662,Luitenant Lippenslaan 200,2023-06-29,10:00:00,197,47,150,FMN 15 Luitenant Lippenslaan
662,Luitenant Lippenslaan 200,2023-06-29,11:00:00,162,36,126,FMN 15 Luitenant Lippenslaan
662,Luitenant Lippenslaan 200,2023-06-29,12:00:00,211,51,160,FMN 15 Luitenant Lippenslaan
662,Luitenant Lippenslaan 200,2023-06-29,13:00:00,200,52,148,FMN 15 Luitenant Lippenslaan
662,Luitenant Lippenslaan 200,2023-06-29,14:00:00,170,40,130,FMN 15 Luitenant Lippenslaan
662,Luitenant Lippenslaan 200,2023-06-29,15:00:00,206,45,161,FMN 15 Luitenant Lippenslaan
662,Luitenant Lippenslaan 200,2023-06-29,16:00:00,263,58,205,FMN 15 Luitenant Lippenslaan
662,Luitenant Lippenslaan 200,2023-06-29,17:00:00,318,77,241,FMN 15 Luitenant Lippenslaan
662,Luitenant Lippenslaan 200,2023-06-29,18:00:00,320,65,255,FMN 15 Luitenant Lippenslaan
662,Luitenant Lippenslaan 200,2023-06-29,19:00:00,228,49,179,FMN 15 Luitenant Lippenslaan
662,Luitenant Lippenslaan 200,2023-06-29,20:00:00,142,24,118,FMN 15 Luitenant Lippenslaan
662,Luitenant Lippenslaan 200,2023-06-29,21:00:00,99,25,74,FMN 15 Luitenant Lippenslaan
662,Luitenant Lippenslaan 200,2023-06-29,22:00:00,70,19,51,FMN 15 Luitenant Lippenslaan
662,Luitenant Lippenslaan 200,2023-06-29,23:00:00,48,23,25,FMN 15 Luitenant Lippenslaan
662,Luitenant Lippenslaan 200,2023-06-30,00:00:00,0,0,0,FMN 15 Luitenant Lippenslaan
662,Luitenant Lippenslaan 200,2023-06-30,01:00:00,10,2,8,FMN 15 Luitenant Lippenslaan
662,Luitenant Lippenslaan 200,2023-06-30,02:00:00,12,4,8,FMN 15 Luitenant Lippenslaan
662,Luitenant Lippenslaan 200,2023-06-30,03:00:00,5,3,2,FMN 15 Luitenant Lippenslaan
662,Luitenant Lippenslaan 200,2023-06-30,04:00:00,14,0,14,FMN 15 Luitenant Lippenslaan
662,Luitenant Lippenslaan 200,2023-06-30,05:00:00,31,6,25,FMN 15 Luitenant Lippenslaan
662,Luitenant Lippenslaan 200,2023-06-30,06:00:00,109,25,84,FMN 15 Luitenant Lippenslaan
662,Luitenant Lippenslaan 200,2023-06-30,07:00:00,322,52,270,FMN 15 Luitenant Lippenslaan
662,Luitenant Lippenslaan 200,2023-06-30,08:00:00,679,100,579,FMN 15 Luitenant Lippenslaan
662,Luitenant Lippenslaan 200,2023-06-30,09:00:00,301,55,246,FMN 15 Luitenant Lippenslaan
662,Luitenant Lippenslaan 200,2023-06-30,10:00:00,233,53,180,FMN 15 Luitenant Lippenslaan
662,Luitenant Lippenslaan 200,2023-06-30,11:00:00,179,46,133,FMN 15 Luitenant Lippenslaan
662,Luitenant Lippenslaan 200,2023-06-30,12:00:00,232,53,179,FMN 15 Luitenant Lippenslaan
662,Luitenant Lippenslaan 200,2023-06-30,13:00:00,211,44,167,FMN 15 Luitenant Lippenslaan
662,Luitenant Lippenslaan 200,2023-06-30,14:00:00,188,49,139,FMN 15 Luitenant Lippenslaan
662,Luitenant Lippenslaan 200,2023-06-30,15:00:00,253,58,195,FMN 15 Luitenant Lippenslaan
662,Luitenant Lippenslaan 200,2023-06-30,16:00:00,281,61,220,FMN 15 Luitenant Lippenslaan
662,Luitenant Lippenslaan 200,2023-06-30,17:00:00,322,63,259,FMN 15 Luitenant Lippenslaan
662,Luitenant Lippenslaan 200,2023-06-30,18:00:00,309,63,246,FMN 15 Luitenant Lippenslaan
662,Luitenant Lippenslaan 200,2023-06-30,19:00:00,278,60,218,FMN 15 Luitenant Lippenslaan
662,Luitenant Lippenslaan 200,2023-06-30,20:00:00,175,39,136,FMN 15 Luitenant Lippenslaan
662,Luitenant Lippenslaan 200,2023-06-30,21:00:00,141,31,110,FMN 15 Luitenant Lippenslaan
662,Luitenant Lippenslaan 200,2023-06-30,22:00:00,111,25,86,FMN 15 Luitenant Lippenslaan
662,Luitenant Lippenslaan 200,2023-06-30,23:00:00,67,16,51,FMN 15 Luitenant Lippenslaan
662,Luitenant Lippenslaan 200,2023-07-01,00:00:00,0,0,0,FMN 15 Luitenant Lippenslaan
662,Luitenant Lippenslaan 200,2023-07-01,01:00:00,27,11,16,FMN 15 Luitenant Lippenslaan
662,Luitenant Lippenslaan 200,2023-07-01,02:00:00,10,2,8,FMN 15 Luitenant Lippenslaan
662,Luitenant Lippenslaan 200,2023-07-01,03:00:00,14,6,8,FMN 15 Luitenant Lippenslaan
662,Luitenant Lippenslaan 200,2023-07-01,04:00:00,9,1,8,FMN 15 Luitenant Lippenslaan
662,Luitenant Lippenslaan 200,2023-07-01,05:00:00,19,3,16,FMN 15 Luitenant Lippenslaan
662,Luitenant Lippenslaan 200,2023-07-01,06:00:00,27,7,20,FMN 15 Luitenant Lippenslaan
662,Luitenant Lippenslaan 200,2023-07-01,07:00:00,41,6,35,FMN 15 Luitenant Lippenslaan
662,Luitenant Lippenslaan 200,2023-07-01,08:00:00,76,12,64,FMN 15 Luitenant Lippenslaan
662,Luitenant Lippenslaan 200,2023-07-01,09:00:00,142,22,120,FMN 15 Luitenant Lippenslaan
662,Luitenant Lippenslaan 200,2023-07-01,10:00:00,150,33,117,FMN 15 Luitenant Lippenslaan
662,Luitenant Lippenslaan 200,2023-07-01,11:00:00,174,35,139,FMN 15 Luitenant Lippenslaan
662,Luitenant Lippenslaan 200,2023-07-01,12:00:00,161,36,125,FMN 15 Luitenant Lippenslaan
662,Luitenant Lippenslaan 200,2023-07-01,13:00:00,201,43,158,FMN 15 Luitenant Lippenslaan
662,Luitenant Lippenslaan 200,2023-07-01,14:00:00,168,28,140,FMN 15 Luitenant Lippenslaan
662,Luitenant Lippenslaan 200,2023-07-01,15:00:00,168,37,131,FMN 15 Luitenant Lippenslaan
662,Luitenant Lippenslaan 200,2023-07-01,16:00:00,153,30,123,FMN 15 Luitenant Lippenslaan
662,Luitenant Lippenslaan 200,2023-07-01,17:00:00,157,26,131,FMN 15 Luitenant Lippenslaan
662,Luitenant Lippenslaan 200,2023-07-01,18:00:00,169,36,133,FMN 15 Luitenant Lippenslaan
662,Luitenant Lippenslaan 200,2023-07-01,19:00:00,148,34,114,FMN 15 Luitenant Lippenslaan
662,Luitenant Lippenslaan 200,2023-07-01,20:00:00,113,22,91,FMN 15 Luitenant Lippenslaan
662,Luitenant Lippenslaan 200,2023-07-01,21:00:00,80,15,65,FMN 15 Luitenant Lippenslaan
662,Luitenant Lippenslaan 200,2023-07-01,22:00:00,72,20,52,FMN 15 Luitenant Lippenslaan
662,Luitenant Lippenslaan 200,2023-07-01,23:00:00,55,14,41,FMN 15 Luitenant Lippenslaan
662,Luitenant Lippenslaan 200,2023-07-02,00:00:00,0,0,0,FMN 15 Luitenant Lippenslaan
662,Luitenant Lippenslaan 200,2023-07-02,01:00:00,38,9,29,FMN 15 Luitenant Lippenslaan
662,Luitenant Lippenslaan 200,2023-07-02,02:00:00,26,4,22,FMN 15 Luitenant Lippenslaan
662,Luitenant Lippenslaan 200,2023-07-02,03:00:00,16,4,12,FMN 15 Luitenant Lippenslaan
662,Luitenant Lippenslaan 200,2023-07-02,04:00:00,19,2,17,FMN 15 Luitenant Lippenslaan
662,Luitenant Lippenslaan 200,2023-07-02,05:00:00,16,6,10,FMN 15 Luitenant Lippenslaan
662,Luitenant Lippenslaan 200,2023-07-02,06:00:00,29,7,22,FMN 15 Luitenant Lippenslaan
662,Luitenant Lippenslaan 200,2023-07-02,07:00:00,29,5,24,FMN 15 Luitenant Lippenslaan
662,Luitenant Lippenslaan 200,2023-07-02,08:00:00,63,11,52,FMN 15 Luitenant Lippenslaan
662,Luitenant Lippenslaan 200,2023-07-02,09:00:00,134,22,112,FMN 15 Luitenant Lippenslaan
662,Luitenant Lippenslaan 200,2023-07-02,10:00:00,160,26,134,FMN 15 Luitenant Lippenslaan
662,Luitenant Lippenslaan 200,2023-07-02,11:00:00,167,36,131,FMN 15 Luitenant Lippenslaan
662,Luitenant Lippenslaan 200,2023-07-02,12:00:00,190,37,153,FMN 15 Luitenant Lippenslaan
662,Luitenant Lippenslaan 200,2023-07-02,13:00:00,209,43,166,FMN 15 Luitenant Lippenslaan
662,Luitenant Lippenslaan 200,2023-07-02,14:00:00,212,44,168,FMN 15 Luitenant Lippenslaan
662,Luitenant Lippenslaan 200,2023-07-02,15:00:00,168,39,129,FMN 15 Luitenant Lippenslaan
662,Luitenant Lippenslaan 200,2023-07-02,16:00:00,169,37,132,FMN 15 Luitenant Lippenslaan
662,Luitenant Lippenslaan 200,2023-07-02,17:00:00,193,36,157,FMN 15 Luitenant Lippenslaan
662,Luitenant Lippenslaan 200,2023-07-02,18:00:00,182,33,149,FMN 15 Luitenant Lippenslaan
662,Luitenant Lippenslaan 200,2023-07-02,19:00:00,150,32,118,FMN 15 Luitenant Lippenslaan
662,Luitenant Lippenslaan 200,2023-07-02,20:00:00,108,21,87,FMN 15 Luitenant Lippenslaan
662,Luitenant Lippenslaan 200,2023-07-02,21:00:00,98,21,77,FMN 15 Luitenant Lippenslaan
662,Luitenant Lippenslaan 200,2023-07-02,22:00:00,77,15,62,FMN 15 Luitenant Lippenslaan
662,Luitenant Lippenslaan 200,2023-07-02,23:00:00,36,11,25,FMN 15 Luitenant Lippenslaan
662,Luitenant Lippenslaan 200,2023-07-03,00:00:00,0,0,0,FMN 15 Luitenant Lippenslaan
662,Luitenant Lippenslaan 200,2023-07-03,01:00:00,12,3,9,FMN 15 Luitenant Lippenslaan
662,Luitenant Lippenslaan 200,2023-07-03,02:00:00,12,5,7,FMN 15 Luitenant Lippenslaan
662,Luitenant Lippenslaan 200,2023-07-03,03:00:00,7,2,5,FMN 15 Luitenant Lippenslaan
662,Luitenant Lippenslaan 200,2023-07-03,04:00:00,13,3,10,FMN 15 Luitenant Lippenslaan
662,Luitenant Lippenslaan 200,2023-07-03,05:00:00,38,10,28,FMN 15 Luitenant Lippenslaan
662,Luitenant Lippenslaan 200,2023-07-03,06:00:00,116,23,93,FMN 15 Luitenant Lippenslaan
662,Luitenant Lippenslaan 200,2023-07-03,07:00:00,312,54,258,FMN 15 Luitenant Lippenslaan
662,Luitenant Lippenslaan 200,2023-07-03,08:00:00,644,124,520,FMN 15 Luitenant Lippenslaan
662,Luitenant Lippenslaan 200,2023-07-03,09:00:00,270,48,222,FMN 15 Luitenant Lippenslaan
662,Luitenant Lippenslaan 200,2023-07-03,10:00:00,176,42,134,FMN 15 Luitenant Lippenslaan
662,Luitenant Lippenslaan 200,2023-07-03,11:00:00,151,37,114,FMN 15 Luitenant Lippenslaan
662,Luitenant Lippenslaan 200,2023-07-03,12:00:00,189,41,148,FMN 15 Luitenant Lippenslaan
662,Luitenant Lippenslaan 200,2023-07-03,13:00:00,160,38,122,FMN 15 Luitenant Lippenslaan
662,Luitenant Lippenslaan 200,2023-07-03,14:00:00,177,35,142,FMN 15 Luitenant Lippenslaan
662,Luitenant Lippenslaan 200,2023-07-03,15:00:00,181,47,134,FMN 15 Luitenant Lippenslaan
662,Luitenant Lippenslaan 200,2023-07-03,16:00:00,246,46,200,FMN 15 Luitenant Lippenslaan
662,Luitenant Lippenslaan 200,2023-07-03,17:00:00,264,46,218,FMN 15 Luitenant Lippenslaan
662,Luitenant Lippenslaan 200,2023-07-03,18:00:00,221,45,176,FMN 15 Luitenant Lippenslaan
662,Luitenant Lippenslaan 200,2023-07-03,19:00:00,163,35,128,FMN 15 Luitenant Lippenslaan
662,Luitenant Lippenslaan 200,2023-07-03,20:00:00,129,30,99,FMN 15 Luitenant Lippenslaan
662,Luitenant Lippenslaan 200,2023-07-03,21:00:00,91,24,67,FMN 15 Luitenant Lippenslaan
662,Luitenant Lippenslaan 200,2023-07-03,22:00:00,87,19,68,FMN 15 Luitenant Lippenslaan
662,Luitenant Lippenslaan 200,2023-07-03,23:00:00,37,10,27,FMN 15 Luitenant Lippenslaan
662,Luitenant Lippenslaan 200,2023-07-04,00:00:00,0,0,0,FMN 15 Luitenant Lippenslaan
662,Luitenant Lippenslaan 200,2023-07-04,01:00:00,6,2,4,FMN 15 Luitenant Lippenslaan
662,Luitenant Lippenslaan 200,2023-07-04,02:00:00,4,4,0,FMN 15 Luitenant Lippenslaan
662,Luitenant Lippenslaan 200,2023-07-04,03:00:00,6,1,5,FMN 15 Luitenant Lippenslaan
662,Luitenant Lippenslaan 200,2023-07-04,04:00:00,18,4,14,FMN 15 Luitenant Lippenslaan
662,Luitenant Lippenslaan 200,2023-07-04,05:00:00,27,9,18,FMN 15 Luitenant Lippenslaan
662,Luitenant Lippenslaan 200,2023-07-04,06:00:00,107,24,83,FMN 15 Luitenant Lippenslaan
662,Luitenant Lippenslaan 200,2023-07-04,07:00:00,305,57,248,FMN 15 Luitenant Lippenslaan
662,Luitenant Lippenslaan 200,2023-07-04,08:00:00,631,127,504,FMN 15 Luitenant Lippenslaan
662,Luitenant Lippenslaan 200,2023-07-04,09:00:00,255,61,194,FMN 15 Luitenant Lippenslaan
662,Luitenant Lippenslaan 200,2023-07-04,10:00:00,127,31,96,FMN 15 Luitenant Lippenslaan
662,Luitenant Lippenslaan 200,2023-07-04,11:00:00,120,30,90,FMN 15 Luitenant Lippenslaan
662,Luitenant Lippenslaan 200,2023-07-04,12:00:00,164,48,116,FMN 15 Luitenant Lippenslaan
662,Luitenant Lippenslaan 200,2023-07-04,13:00:00,138,33,105,FMN 15 Luitenant Lippenslaan
662,Luitenant Lippenslaan 200,2023-07-04,14:00:00,110,23,87,FMN 15 Luitenant Lippenslaan
662,Luitenant Lippenslaan 200,2023-07-04,15:00:00,134,31,103,FMN 15 Luitenant Lippenslaan
662,Luitenant Lippenslaan 200,2023-07-04,16:00:00,203,50,153,FMN 15 Luitenant Lippenslaan
662,Luitenant Lippenslaan 200,2023-07-04,17:00:00,211,51,160,FMN 15 Luitenant Lippenslaan
662,Luitenant Lippenslaan 200,2023-07-04,18:00:00,203,49,154,FMN 15 Luitenant Lippenslaan
662,Luitenant Lippenslaan 200,2023-07-04,19:00:00,130,28,102,FMN 15 Luitenant Lippenslaan
662,Luitenant Lippenslaan 200,2023-07-04,20:00:00,104,25,79,FMN 15 Luitenant Lippenslaan
662,Luitenant Lippenslaan 200,2023-07-04,21:00:00,71,19,52,FMN 15 Luitenant Lippenslaan
662,Luitenant Lippenslaan 200,2023-07-04,22:00:00,56,10,46,FMN 15 Luitenant Lippenslaan
662,Luitenant Lippenslaan 200,2023-07-04,23:00:00,35,9,26,FMN 15 Luitenant Lippenslaan
662,Luitenant Lippenslaan 200,2023-07-05,00:00:00,0,0,0,FMN 15 Luitenant Lippenslaan
662,Luitenant Lippenslaan 200,2023-07-05,01:00:00,3,0,3,FMN 15 Luitenant Lippenslaan
662,Luitenant Lippenslaan 200,2023-07-05,02:00:00,5,0,5,FMN 15 Luitenant Lippenslaan
662,Luitenant Lippenslaan 200,2023-07-05,03:00:00,8,1,7,FMN 15 Luitenant Lippenslaan
662,Luitenant Lippenslaan 200,2023-07-05,04:00:00,15,4,11,FMN 15 Luitenant Lippenslaan
662,Luitenant Lippenslaan 200,2023-07-05,05:00:00,31,9,22,FMN 15 Luitenant Lippenslaan
662,Luitenant Lippenslaan 200,2023-07-05,06:00:00,93,29,64,FMN 15 Luitenant Lippenslaan
662,Luitenant Lippenslaan 200,2023-07-05,07:00:00,223,46,177,FMN 15 Luitenant Lippenslaan
662,Luitenant Lippenslaan 200,2023-07-05,08:00:00,447,84,363,FMN 15 Luitenant Lippenslaan
662,Luitenant Lippenslaan 200,2023-07-05,09:00:00,182,41,141,FMN 15 Luitenant Lippenslaan
662,Luitenant Lippenslaan 200,2023-07-05,10:00:00,137,24,113,FMN 15 Luitenant Lippenslaan
662,Luitenant Lippenslaan 200,2023-07-05,11:00:00,108,22,86,FMN 15 Luitenant Lippenslaan
662,Luitenant Lippenslaan 200,2023-07-05,12:00:00,145,44,101,FMN 15 Luitenant Lippenslaan
662,Luitenant Lippenslaan 200,2023-07-05,13:00:00,141,37,104,FMN 15 Luitenant Lippenslaan
662,Luitenant Lippenslaan 200,2023-07-05,14:00:00,119,30,89,FMN 15 Luitenant Lippenslaan
662,Luitenant Lippenslaan 200,2023-07-05,15:00:00,140,31,109,FMN 15 Luitenant Lippenslaan
662,Luitenant Lippenslaan 200,2023-07-05,16:00:00,167,51,116,FMN 15 Luitenant Lippenslaan
662,Luitenant Lippenslaan 200,2023-07-05,17:00:00,166,35,131,FMN 15 Luitenant Lippenslaan
662,Luitenant Lippenslaan 200,2023-07-05,18:00:00,143,28,115,FMN 15 Luitenant Lippenslaan
662,Luitenant Lippenslaan 200,2023-07-05,19:00:00,119,28,91,FMN 15 Luitenant Lippenslaan
662,Luitenant Lippenslaan 200,2023-07-05,20:00:00,83,17,66,FMN 15 Luitenant Lippenslaan
662,Luitenant Lippenslaan 200,2023-07-05,21:00:00,57,12,45,FMN 15 Luitenant Lippenslaan
662,Luitenant Lippenslaan 200,2023-07-05,22:00:00,54,12,42,FMN 15 Luitenant Lippenslaan
662,Luitenant Lippenslaan 200,2023-07-05,23:00:00,22,9,13,FMN 15 Luitenant Lippenslaan
662,Luitenant Lippenslaan 200,2023-07-06,00:00:00,5,0,5,FMN 15 Luitenant Lippenslaan
662,Luitenant Lippenslaan 200,2023-07-06,01:00:00,6,0,6,FMN 15 Luitenant Lippenslaan
662,Luitenant Lippenslaan 200,2023-07-06,02:00:00,2,0,2,FMN 15 Luitenant Lippenslaan
662,Luitenant Lippenslaan 200,2023-07-06,03:00:00,3,0,3,FMN 15 Luitenant Lippenslaan
662,Luitenant Lippenslaan 200,2023-07-06,04:00:00,10,0,10,FMN 15 Luitenant Lippenslaan
662,Luitenant Lippenslaan 200,2023-07-06,05:00:00,8,0,8,FMN 15 Luitenant Lippenslaan
662,Luitenant Lippenslaan 200,2023-07-06,06:00:00,41,0,41,FMN 15 Luitenant Lippenslaan
662,Luitenant Lippenslaan 200,2023-07-06,07:00:00,139,0,139,FMN 15 Luitenant Lippenslaan
662,Luitenant Lippenslaan 200,2023-07-06,08:00:00,296,6,290,FMN 15 Luitenant Lippenslaan
662,Luitenant Lippenslaan 200,2023-07-06,09:00:00,270,144,126,FMN 15 Luitenant Lippenslaan
662,Luitenant Lippenslaan 200,2023-07-06,10:00:00,176,112,64,FMN 15 Luitenant Lippenslaan
662,Luitenant Lippenslaan 200,2023-07-06,11:00:00,140,84,56,FMN 15 Luitenant Lippenslaan
662,Luitenant Lippenslaan 200,2023-07-06,12:00:00,150,83,67,FMN 15 Luitenant Lippenslaan
662,Luitenant Lippenslaan 200,2023-07-06,13:00:00,161,95,66,FMN 15 Luitenant Lippenslaan
662,Luitenant Lippenslaan 200,2023-07-06,14:00:00,125,79,46,FMN 15 Luitenant Lippenslaan
662,Luitenant Lippenslaan 200,2023-07-06,15:00:00,166,89,77,FMN 15 Luitenant Lippenslaan
662,Luitenant Lippenslaan 200,2023-07-06,16:00:00,209,118,91,FMN 15 Luitenant Lippenslaan
662,Luitenant Lippenslaan 200,2023-07-06,17:00:00,264,155,109,FMN 15 Luitenant Lippenslaan
662,Luitenant Lippenslaan 200,2023-07-06,18:00:00,236,116,120,FMN 15 Luitenant Lippenslaan
662,Luitenant Lippenslaan 200,2023-07-06,19:00:00,178,103,75,FMN 15 Luitenant Lippenslaan
662,Luitenant Lippenslaan 200,2023-07-06,20:00:00,132,75,57,FMN 15 Luitenant Lippenslaan
662,Luitenant Lippenslaan 200,2023-07-06,21:00:00,86,55,31,FMN 15 Luitenant Lippenslaan
662,Luitenant Lippenslaan 200,2023-07-06,22:00:00,72,34,38,FMN 15 Luitenant Lippenslaan
662,Luitenant Lippenslaan 200,2023-07-06,23:00:00,44,30,14,FMN 15 Luitenant Lippenslaan
662,Luitenant Lippenslaan 200,2023-07-07,00:00:00,29,22,7,FMN 15 Luitenant Lippenslaan
662,Luitenant Lippenslaan 200,2023-07-07,01:00:00,9,7,2,FMN 15 Luitenant Lippenslaan
662,Luitenant Lippenslaan 200,2023-07-07,02:00:00,6,5,1,FMN 15 Luitenant Lippenslaan
662,Luitenant Lippenslaan 200,2023-07-07,03:00:00,2,2,0,FMN 15 Luitenant Lippenslaan
662,Luitenant Lippenslaan 200,2023-07-07,04:00:00,16,9,7,FMN 15 Luitenant Lippenslaan
662,Luitenant Lippenslaan 200,2023-07-07,05:00:00,33,22,11,FMN 15 Luitenant Lippenslaan
662,Luitenant Lippenslaan 200,2023-07-07,06:00:00,98,54,44,FMN 15 Luitenant Lippenslaan
662,Luitenant Lippenslaan 200,2023-07-07,07:00:00,236,106,130,FMN 15 Luitenant Lippenslaan
662,Luitenant Lippenslaan 200,2023-07-07,08:00:00,516,234,282,FMN 15 Luitenant Lippenslaan
662,Luitenant Lippenslaan 200,2023-07-07,09:00:00,283,171,112,FMN 15 Luitenant Lippenslaan
662,Luitenant Lippenslaan 200,2023-07-07,10:00:00,182,108,74,FMN 15 Luitenant Lippenslaan
662,Luitenant Lippenslaan 200,2023-07-07,11:00:00,157,101,56,FMN 15 Luitenant Lippenslaan
662,Luitenant Lippenslaan 200,2023-07-07,12:00:00,173,87,86,FMN 15 Luitenant Lippenslaan
662,Luitenant Lippenslaan 200,2023-07-07,13:00:00,199,115,84,FMN 15 Luitenant Lippenslaan
662,Luitenant Lippenslaan 200,2023-07-07,14:00:00,158,86,72,FMN 15 Luitenant Lippenslaan
662,Luitenant Lippenslaan 200,2023-07-07,15:00:00,164,81,83,FMN 15 Luitenant Lippenslaan
662,Luitenant Lippenslaan 200,2023-07-07,16:00:00,218,113,105,FMN 15 Luitenant Lippenslaan
662,Luitenant Lippenslaan 200,2023-07-07,17:00:00,261,138,123,FMN 15 Luitenant Lippenslaan
662,Luitenant Lippenslaan 200,2023-07-07,18:00:00,252,138,114,FMN 15 Luitenant Lippenslaan
662,Luitenant Lippenslaan 200,2023-07-07,19:00:00,211,105,106,FMN 15 Luitenant Lippenslaan
662,Luitenant Lippenslaan 200,2023-07-07,20:00:00,170,98,72,FMN 15 Luitenant Lippenslaan
662,Luitenant Lippenslaan 200,2023-07-07,21:00:00,124,80,44,FMN 15 Luitenant Lippenslaan
662,Luitenant Lippenslaan 200,2023-07-07,22:00:00,96,53,43,FMN 15 Luitenant Lippenslaan
662,Luitenant Lippenslaan 200,2023-07-07,23:00:00,88,61,27,FMN 15 Luitenant Lippenslaan
662,Luitenant Lippenslaan 200,2023-07-08,00:00:00,49,31,18,FMN 15 Luitenant Lippenslaan
662,Luitenant Lippenslaan 200,2023-07-08,01:00:00,36,22,14,FMN 15 Luitenant Lippenslaan
662,Luitenant Lippenslaan 200,2023-07-08,02:00:00,11,6,5,FMN 15 Luitenant Lippenslaan
662,Luitenant Lippenslaan 200,2023-07-08,03:00:00,12,4,8,FMN 15 Luitenant Lippenslaan
662,Luitenant Lippenslaan 200,2023-07-08,04:00:00,17,12,5,FMN 15 Luitenant Lippenslaan
662,Luitenant Lippenslaan 200,2023-07-08,05:00:00,10,4,6,FMN 15 Luitenant Lippenslaan
662,Luitenant Lippenslaan 200,2023-07-08,06:00:00,26,15,11,FMN 15 Luitenant Lippenslaan
662,Luitenant Lippenslaan 200,2023-07-08,07:00:00,44,29,15,FMN 15 Luitenant Lippenslaan
662,Luitenant Lippenslaan 200,2023-07-08,08:00:00,80,46,34,FMN 15 Luitenant Lippenslaan
662,Luitenant Lippenslaan 200,2023-07-08,09:00:00,145,95,50,FMN 15 Luitenant Lippenslaan
662,Luitenant Lippenslaan 200,2023-07-08,10:00:00,176,102,74,FMN 15 Luitenant Lippenslaan
662,Luitenant Lippenslaan 200,2023-07-08,11:00:00,171,99,72,FMN 15 Luitenant Lippenslaan
662,Luitenant Lippenslaan 200,2023-07-08,12:00:00,186,105,81,FMN 15 Luitenant Lippenslaan
662,Luitenant Lippenslaan 200,2023-07-08,13:00:00,175,91,84,FMN 15 Luitenant Lippenslaan
662,Luitenant Lippenslaan 200,2023-07-08,14:00:00,164,85,79,FMN 15 Luitenant Lippenslaan
662,Luitenant Lippenslaan 200,2023-07-08,15:00:00,149,78,71,FMN 15 Luitenant Lippenslaan
662,Luitenant Lippenslaan 200,2023-07-08,16:00:00,127,74,53,FMN 15 Luitenant Lippenslaan
662,Luitenant Lippenslaan 200,2023-07-08,17:00:00,189,113,76,FMN 15 Luitenant Lippenslaan
662,Luitenant Lippenslaan 200,2023-07-08,18:00:00,187,115,72,FMN 15 Luitenant Lippenslaan
662,Luitenant Lippenslaan 200,2023-07-08,19:00:00,161,88,73,FMN 15 Luitenant Lippenslaan
662,Luitenant Lippenslaan 200,2023-07-08,20:00:00,113,62,51,FMN 15 Luitenant Lippenslaan
662,Luitenant Lippenslaan 200,2023-07-08,21:00:00,89,58,31,FMN 15 Luitenant Lippenslaan
662,Luitenant Lippenslaan 200,2023-07-08,22:00:00,71,43,28,FMN 15 Luitenant Lippenslaan
662,Luitenant Lippenslaan 200,2023-07-08,23:00:00,64,44,20,FMN 15 Luitenant Lippenslaan
662,Luitenant Lippenslaan 200,2023-07-09,00:00:00,31,22,9,FMN 15 Luitenant Lippenslaan
662,Luitenant Lippenslaan 200,2023-07-09,01:00:00,26,17,9,FMN 15 Luitenant Lippenslaan
662,Luitenant Lippenslaan 200,2023-07-09,02:00:00,21,15,6,FMN 15 Luitenant Lippenslaan
662,Luitenant Lippenslaan 200,2023-07-09,03:00:00,18,13,5,FMN 15 Luitenant Lippenslaan
662,Luitenant Lippenslaan 200,2023-07-09,04:00:00,8,5,3,FMN 15 Luitenant Lippenslaan
662,Luitenant Lippenslaan 200,2023-07-09,05:00:00,16,8,8,FMN 15 Luitenant Lippenslaan
662,Luitenant Lippenslaan 200,2023-07-09,06:00:00,21,11,10,FMN 15 Luitenant Lippenslaan
662,Luitenant Lippenslaan 200,2023-07-09,07:00:00,33,27,6,FMN 15 Luitenant Lippenslaan
662,Luitenant Lippenslaan 200,2023-07-09,08:00:00,43,28,15,FMN 15 Luitenant Lippenslaan
662,Luitenant Lippenslaan 200,2023-07-09,09:00:00,99,55,44,FMN 15 Luitenant Lippenslaan
662,Luitenant Lippenslaan 200,2023-07-09,10:00:00,115,72,43,FMN 15 Luitenant Lippenslaan
662,Luitenant Lippenslaan 200,2023-07-09,11:00:00,118,71,47,FMN 15 Luitenant Lippenslaan
662,Luitenant Lippenslaan 200,2023-07-09,12:00:00,116,63,53,FMN 15 Luitenant Lippenslaan
662,Luitenant Lippenslaan 200,2023-07-09,13:00:00,114,60,54,FMN 15 Luitenant Lippenslaan
662,Luitenant Lippenslaan 200,2023-07-09,14:00:00,137,75,62,FMN 15 Luitenant Lippenslaan
662,Luitenant Lippenslaan 200,2023-07-09,15:00:00,67,21,46,FMN 15 Luitenant Lippenslaan
662,Luitenant Lippenslaan 200,2023-07-09,16:00:00,89,39,50,FMN 15 Luitenant Lippenslaan
662,Luitenant Lippenslaan 200,2023-07-09,17:00:00,98,53,45,FMN 15 Luitenant Lippenslaan
662,Luitenant Lippenslaan 200,2023-07-09,18:00:00,113,62,51,FMN 15 Luitenant Lippenslaan
662,Luitenant Lippenslaan 200,2023-07-09,19:00:00,106,64,42,FMN 15 Luitenant Lippenslaan
662,Luitenant Lippenslaan 200,2023-07-09,20:00:00,95,59,36,FMN 15 Luitenant Lippenslaan
662,Luitenant Lippenslaan 200,2023-07-09,21:00:00,71,44,27,FMN 15 Luitenant Lippenslaan
662,Luitenant Lippenslaan 200,2023-07-09,22:00:00,47,31,16,FMN 15 Luitenant Lippenslaan
662,Luitenant Lippenslaan 200,2023-07-09,23:00:00,28,18,10,FMN 15 Luitenant Lippenslaan
662,Luitenant Lippenslaan 200,2023-07-10,00:00:00,22,16,6,FMN 15 Luitenant Lippenslaan
662,Luitenant Lippenslaan 200,2023-07-10,01:00:00,9,5,4,FMN 15 Luitenant Lippenslaan
662,Luitenant Lippenslaan 200,2023-07-10,02:00:00,7,5,2,FMN 15 Luitenant Lippenslaan
662,Luitenant Lippenslaan 200,2023-07-10,03:00:00,4,1,3,FMN 15 Luitenant Lippenslaan
662,Luitenant Lippenslaan 200,2023-07-10,04:00:00,17,10,7,FMN 15 Luitenant Lippenslaan
662,Luitenant Lippenslaan 200,2023-07-10,05:00:00,32,15,17,FMN 15 Luitenant Lippenslaan
662,Luitenant Lippenslaan 200,2023-07-10,06:00:00,101,51,50,FMN 15 Luitenant Lippenslaan
662,Luitenant Lippenslaan 200,2023-07-10,07:00:00,236,108,128,FMN 15 Luitenant Lippenslaan
662,Luitenant Lippenslaan 200,2023-07-10,08:00:00,485,209,276,FMN 15 Luitenant Lippenslaan
662,Luitenant Lippenslaan 200,2023-07-10,09:00:00,239,121,118,FMN 15 Luitenant Lippenslaan
662,Luitenant Lippenslaan 200,2023-07-10,10:00:00,137,74,63,FMN 15 Luitenant Lippenslaan
662,Luitenant Lippenslaan 200,2023-07-10,11:00:00,145,95,50,FMN 15 Luitenant Lippenslaan
662,Luitenant Lippenslaan 200,2023-07-10,12:00:00,156,80,76,FMN 15 Luitenant Lippenslaan
662,Luitenant Lippenslaan 200,2023-07-10,13:00:00,152,86,66,FMN 15 Luitenant Lippenslaan
662,Luitenant Lippenslaan 200,2023-07-10,14:00:00,138,82,56,FMN 15 Luitenant Lippenslaan
662,Luitenant Lippenslaan 200,2023-07-10,15:00:00,143,76,67,FMN 15 Luitenant Lippenslaan
662,Luitenant Lippenslaan 200,2023-07-10,16:00:00,226,122,104,FMN 15 Luitenant Lippenslaan
662,Luitenant Lippenslaan 200,2023-07-10,17:00:00,248,136,112,FMN 15 Luitenant Lippenslaan
662,Luitenant Lippenslaan 200,2023-07-10,18:00:00,226,125,101,FMN 15 Luitenant Lippenslaan
662,Luitenant Lippenslaan 200,2023-07-10,19:00:00,151,84,67,FMN 15 Luitenant Lippenslaan
662,Luitenant Lippenslaan 200,2023-07-10,20:00:00,121,70,51,FMN 15 Luitenant Lippenslaan
662,Luitenant Lippenslaan 200,2023-07-10,21:00:00,87,54,33,FMN 15 Luitenant Lippenslaan
662,Luitenant Lippenslaan 200,2023-07-10,22:00:00,83,53,30,FMN 15 Luitenant Lippenslaan
662,Luitenant Lippenslaan 200,2023-07-10,23:00:00,57,50,7,FMN 15 Luitenant Lippenslaan
662,Luitenant Lippenslaan 200,2023-07-11,00:00:00,20,17,3,FMN 15 Luitenant Lippenslaan
662,Luitenant Lippenslaan 200,2023-07-11,01:00:00,9,9,0,FMN 15 Luitenant Lippenslaan
662,Luitenant Lippenslaan 200,2023-07-11,02:00:00,3,2,1,FMN 15 Luitenant Lippenslaan
662,Luitenant Lippenslaan 200,2023-07-11,03:00:00,2,2,0,FMN 15 Luitenant Lippenslaan
662,Luitenant Lippenslaan 200,2023-07-11,04:00:00,14,9,5,FMN 15 Luitenant Lippenslaan
662,Luitenant Lippenslaan 200,2023-07-11,05:00:00,32,21,11,FMN 15 Luitenant Lippenslaan
662,Luitenant Lippenslaan 200,2023-07-11,06:00:00,98,44,54,FMN 15 Luitenant Lippenslaan
662,Luitenant Lippenslaan 200,2023-07-11,07:00:00,261,115,146,FMN 15 Luitenant Lippenslaan
662,Luitenant Lippenslaan 200,2023-07-11,08:00:00,500,195,305,FMN 15 Luitenant Lippenslaan
662,Luitenant Lippenslaan 200,2023-07-11,09:00:00,261,141,120,FMN 15 Luitenant Lippenslaan
662,Luitenant Lippenslaan 200,2023-07-11,10:00:00,161,104,57,FMN 15 Luitenant Lippenslaan
662,Luitenant Lippenslaan 200,2023-07-11,11:00:00,149,90,59,FMN 15 Luitenant Lippenslaan
662,Luitenant Lippenslaan 200,2023-07-11,12:00:00,135,63,72,FMN 15 Luitenant Lippenslaan
662,Luitenant Lippenslaan 200,2023-07-11,13:00:00,159,86,73,FMN 15 Luitenant Lippenslaan
662,Luitenant Lippenslaan 200,2023-07-11,14:00:00,139,86,53,FMN 15 Luitenant Lippenslaan
662,Luitenant Lippenslaan 200,2023-07-11,15:00:00,179,105,74,FMN 15 Luitenant Lippenslaan
662,Luitenant Lippenslaan 200,2023-07-11,16:00:00,217,131,86,FMN 15 Luitenant Lippenslaan
662,Luitenant Lippenslaan 200,2023-07-11,17:00:00,251,152,99,FMN 15 Luitenant Lippenslaan
662,Luitenant Lippenslaan 200,2023-07-11,18:00:00,219,129,90,FMN 15 Luitenant Lippenslaan
662,Luitenant Lippenslaan 200,2023-07-11,19:00:00,148,87,61,FMN 15 Luitenant Lippenslaan
662,Luitenant Lippenslaan 200,2023-07-11,20:00:00,117,74,43,FMN 15 Luitenant Lippenslaan
662,Luitenant Lippenslaan 200,2023-07-11,21:00:00,84,54,30,FMN 15 Luitenant Lippenslaan
662,Luitenant Lippenslaan 200,2023-07-11,22:00:00,72,38,34,FMN 15 Luitenant Lippenslaan
662,Luitenant Lippenslaan 200,2023-07-11,23:00:00,37,27,10,FMN 15 Luitenant Lippenslaan
662,Luitenant Lippenslaan 200,2023-07-12,00:00:00,23,16,7,FMN 15 Luitenant Lippenslaan
662,Luitenant Lippenslaan 200,2023-07-12,01:00:00,12,9,3,FMN 15 Luitenant Lippenslaan
662,Luitenant Lippenslaan 200,2023-07-12,02:00:00,4,1,3,FMN 15 Luitenant Lippenslaan
662,Luitenant Lippenslaan 200,2023-07-12,03:00:00,4,3,1,FMN 15 Luitenant Lippenslaan
662,Luitenant Lippenslaan 200,2023-07-12,04:00:00,18,10,8,FMN 15 Luitenant Lippenslaan
662,Luitenant Lippenslaan 200,2023-07-12,05:00:00,44,24,20,FMN 15 Luitenant Lippenslaan
662,Luitenant Lippenslaan 200,2023-07-12,06:00:00,114,66,48,FMN 15 Luitenant Lippenslaan
662,Luitenant Lippenslaan 200,2023-07-12,07:00:00,269,132,137,FMN 15 Luitenant Lippenslaan
662,Luitenant Lippenslaan 200,2023-07-12,08:00:00,476,222,254,FMN 15 Luitenant Lippenslaan
662,Luitenant Lippenslaan 200,2023-07-12,09:00:00,266,156,110,FMN 15 Luitenant Lippenslaan
662,Luitenant Lippenslaan 200,2023-07-12,10:00:00,147,72,75,FMN 15 Luitenant Lippenslaan
662,Luitenant Lippenslaan 200,2023-07-12,11:00:00,120,72,48,FMN 15 Luitenant Lippenslaan
662,Luitenant Lippenslaan 200,2023-07-12,12:00:00,173,85,88,FMN 15 Luitenant Lippenslaan
662,Luitenant Lippenslaan 200,2023-07-12,13:00:00,151,80,71,FMN 15 Luitenant Lippenslaan
662,Luitenant Lippenslaan 200,2023-07-12,14:00:00,147,89,58,FMN 15 Luitenant Lippenslaan
662,Luitenant Lippenslaan 200,2023-07-12,15:00:00,152,84,68,FMN 15 Luitenant Lippenslaan
662,Luitenant Lippenslaan 200,2023-07-12,16:00:00,192,112,80,FMN 15 Luitenant Lippenslaan
662,Luitenant Lippenslaan 200,2023-07-12,17:00:00,233,125,108,FMN 15 Luitenant Lippenslaan
662,Luitenant Lippenslaan 200,2023-07-12,18:00:00,212,120,92,FMN 15 Luitenant Lippenslaan
662,Luitenant Lippenslaan 200,2023-07-12,19:00:00,146,70,76,FMN 15 Luitenant Lippenslaan
662,Luitenant Lippenslaan 200,2023-07-12,20:00:00,105,67,38,FMN 15 Luitenant Lippenslaan
662,Luitenant Lippenslaan 200,2023-07-12,21:00:00,84,44,40,FMN 15 Luitenant Lippenslaan
662,Luitenant Lippenslaan 200,2023-07-12,22:00:00,68,36,32,FMN 15 Luitenant Lippenslaan
662,Luitenant Lippenslaan 200,2023-07-12,23:00:00,32,20,12,FMN 15 Luitenant Lippenslaan
662,Luitenant Lippenslaan 200,2023-07-13,00:00:00,18,12,6,FMN 15 Luitenant Lippenslaan
662,Luitenant Lippenslaan 200,2023-07-13,01:00:00,11,6,5,FMN 15 Luitenant Lippenslaan
662,Luitenant Lippenslaan 200,2023-07-13,02:00:00,7,4,3,FMN 15 Luitenant Lippenslaan
662,Luitenant Lippenslaan 200,2023-07-13,03:00:00,4,3,1,FMN 15 Luitenant Lippenslaan
662,Luitenant Lippenslaan 200,2023-07-13,04:00:00,17,10,7,FMN 15 Luitenant Lippenslaan
662,Luitenant Lippenslaan 200,2023-07-13,05:00:00,29,21,8,FMN 15 Luitenant Lippenslaan
662,Luitenant Lippenslaan 200,2023-07-13,06:00:00,96,51,45,FMN 15 Luitenant Lippenslaan
662,Luitenant Lippenslaan 200,2023-07-13,07:00:00,244,116,128,FMN 15 Luitenant Lippenslaan
662,Luitenant Lippenslaan 200,2023-07-13,08:00:00,522,237,285,FMN 15 Luitenant Lippenslaan
662,Luitenant Lippenslaan 200,2023-07-13,09:00:00,242,120,122,FMN 15 Luitenant Lippenslaan
662,Luitenant Lippenslaan 200,2023-07-13,10:00:00,153,87,66,FMN 15 Luitenant Lippenslaan
662,Luitenant Lippenslaan 200,2023-07-13,11:00:00,145,91,54,FMN 15 Luitenant Lippenslaan
662,Luitenant Lippenslaan 200,2023-07-13,12:00:00,136,69,67,FMN 15 Luitenant Lippenslaan
662,Luitenant Lippenslaan 200,2023-07-13,13:00:00,112,63,49,FMN 15 Luitenant Lippenslaan
662,Luitenant Lippenslaan 200,2023-07-13,14:00:00,110,55,55,FMN 15 Luitenant Lippenslaan
662,Luitenant Lippenslaan 200,2023-07-13,15:00:00,147,75,72,FMN 15 Luitenant Lippenslaan
662,Luitenant Lippenslaan 200,2023-07-13,16:00:00,186,91,95,FMN 15 Luitenant Lippenslaan
662,Luitenant Lippenslaan 200,2023-07-13,17:00:00,245,128,117,FMN 15 Luitenant Lippenslaan
662,Luitenant Lippenslaan 200,2023-07-13,18:00:00,224,115,109,FMN 15 Luitenant Lippenslaan
662,Luitenant Lippenslaan 200,2023-07-13,19:00:00,182,106,76,FMN 15 Luitenant Lippenslaan
662,Luitenant Lippenslaan 200,2023-07-13,20:00:00,117,71,46,FMN 15 Luitenant Lippenslaan
662,Luitenant Lippenslaan 200,2023-07-13,21:00:00,69,42,27,FMN 15 Luitenant Lippenslaan
662,Luitenant Lippenslaan 200,2023-07-13,22:00:00,71,46,25,FMN 15 Luitenant Lippenslaan
662,Luitenant Lippenslaan 200,2023-07-13,23:00:00,58,52,6,FMN 15 Luitenant Lippenslaan
662,Luitenant Lippenslaan 200,2023-07-14,00:00:00,23,17,6,FMN 15 Luitenant Lippenslaan
662,Luitenant Lippenslaan 200,2023-07-14,01:00:00,7,2,5,FMN 15 Luitenant Lippenslaan
662,Luitenant Lippenslaan 200,2023-07-14,02:00:00,6,2,4,FMN 15 Luitenant Lippenslaan
662,Luitenant Lippenslaan 200,2023-07-14,03:00:00,9,4,5,FMN 15 Luitenant Lippenslaan
662,Luitenant Lippenslaan 200,2023-07-14,04:00:00,14,9,5,FMN 15 Luitenant Lippenslaan
662,Luitenant Lippenslaan 200,2023-07-14,05:00:00,30,23,7,FMN 15 Luitenant Lippenslaan
662,Luitenant Lippenslaan 200,2023-07-14,06:00:00,94,57,37,FMN 15 Luitenant Lippenslaan
662,Luitenant Lippenslaan 200,2023-07-14,07:00:00,199,90,109,FMN 15 Luitenant Lippenslaan
662,Luitenant Lippenslaan 200,2023-07-14,08:00:00,441,192,249,FMN 15 Luitenant Lippenslaan
662,Luitenant Lippenslaan 200,2023-07-14,09:00:00,211,116,95,FMN 15 Luitenant Lippenslaan
662,Luitenant Lippenslaan 200,2023-07-14,10:00:00,146,82,64,FMN 15 Luitenant Lippenslaan
662,Luitenant Lippenslaan 200,2023-07-14,11:00:00,161,90,71,FMN 15 Luitenant Lippenslaan
662,Luitenant Lippenslaan 200,2023-07-14,12:00:00,169,94,75,FMN 15 Luitenant Lippenslaan
662,Luitenant Lippenslaan 200,2023-07-14,13:00:00,174,104,70,FMN 15 Luitenant Lippenslaan
662,Luitenant Lippenslaan 200,2023-07-14,14:00:00,154,77,77,FMN 15 Luitenant Lippenslaan
662,Luitenant Lippenslaan 200,2023-07-14,15:00:00,169,92,77,FMN 15 Luitenant Lippenslaan
662,Luitenant Lippenslaan 200,2023-07-14,16:00:00,203,108,95,FMN 15 Luitenant Lippenslaan
662,Luitenant Lippenslaan 200,2023-07-14,17:00:00,245,124,121,FMN 15 Luitenant Lippenslaan
662,Luitenant Lippenslaan 200,2023-07-14,18:00:00,207,97,110,FMN 15 Luitenant Lippenslaan
662,Luitenant Lippenslaan 200,2023-07-14,19:00:00,201,108,93,FMN 15 Luitenant Lippenslaan
662,Luitenant Lippenslaan 200,2023-07-14,20:00:00,151,85,66,FMN 15 Luitenant Lippenslaan
662,Luitenant Lippenslaan 200,2023-07-14,21:00:00,96,55,41,FMN 15 Luitenant Lippenslaan
662,Luitenant Lippenslaan 200,2023-07-14,22:00:00,84,48,36,FMN 15 Luitenant Lippenslaan
662,Luitenant Lippenslaan 200,2023-07-14,23:00:00,49,23,26,FMN 15 Luitenant Lippenslaan
662,Luitenant Lippenslaan 200,2023-07-15,00:00:00,22,17,5,FMN 15 Luitenant Lippenslaan
662,Luitenant Lippenslaan 200,2023-07-15,01:00:00,14,8,6,FMN 15 Luitenant Lippenslaan
662,Luitenant Lippenslaan 200,2023-07-15,02:00:00,11,8,3,FMN 15 Luitenant Lippenslaan
662,Luitenant Lippenslaan 200,2023-07-15,03:00:00,26,19,7,FMN 15 Luitenant Lippenslaan
662,Luitenant Lippenslaan 200,2023-07-15,04:00:00,15,9,6,FMN 15 Luitenant Lippenslaan
662,Luitenant Lippenslaan 200,2023-07-15,05:00:00,19,8,11,FMN 15 Luitenant Lippenslaan
662,Luitenant Lippenslaan 200,2023-07-15,06:00:00,43,25,18,FMN 15 Luitenant Lippenslaan
662,Luitenant Lippenslaan 200,2023-07-15,07:00:00,29,16,13,FMN 15 Luitenant Lippenslaan
662,Luitenant Lippenslaan 200,2023-07-15,08:00:00,70,33,37,FMN 15 Luitenant Lippenslaan
662,Luitenant Lippenslaan 200,2023-07-15,09:00:00,118,65,53,FMN 15 Luitenant Lippenslaan
662,Luitenant Lippenslaan 200,2023-07-15,10:00:00,152,93,59,FMN 15 Luitenant Lippenslaan
662,Luitenant Lippenslaan 200,2023-07-15,11:00:00,153,85,68,FMN 15 Luitenant Lippenslaan
662,Luitenant Lippenslaan 200,2023-07-15,12:00:00,150,84,66,FMN 15 Luitenant Lippenslaan
662,Luitenant Lippenslaan 200,2023-07-15,13:00:00,163,92,71,FMN 15 Luitenant Lippenslaan
662,Luitenant Lippenslaan 200,2023-07-15,14:00:00,164,89,75,FMN 15 Luitenant Lippenslaan
662,Luitenant Lippenslaan 200,2023-07-15,15:00:00,150,81,69,FMN 15 Luitenant Lippenslaan
662,Luitenant Lippenslaan 200,2023-07-15,16:00:00,139,69,70,FMN 15 Luitenant Lippenslaan
662,Luitenant Lippenslaan 200,2023-07-15,17:00:00,137,68,69,FMN 15 Luitenant Lippenslaan
662,Luitenant Lippenslaan 200,2023-07-15,18:00:00,143,79,64,FMN 15 Luitenant Lippenslaan
662,Luitenant Lippenslaan 200,2023-07-15,19:00:00,131,71,60,FMN 15 Luitenant Lippenslaan
662,Luitenant Lippenslaan 200,2023-07-15,20:00:00,96,51,45,FMN 15 Luitenant Lippenslaan
662,Luitenant Lippenslaan 200,2023-07-15,21:00:00,75,47,28,FMN 15 Luitenant Lippenslaan
662,Luitenant Lippenslaan 200,2023-07-15,22:00:00,89,62,27,FMN 15 Luitenant Lippenslaan
662,Luitenant Lippenslaan 200,2023-07-15,23:00:00,56,35,21,FMN 15 Luitenant Lippenslaan
662,Luitenant Lippenslaan 200,2023-07-16,00:00:00,52,42,10,FMN 15 Luitenant Lippenslaan
662,Luitenant Lippenslaan 200,2023-07-16,01:00:00,16,6,10,FMN 15 Luitenant Lippenslaan
662,Luitenant Lippenslaan 200,2023-07-16,02:00:00,12,8,4,FMN 15 Luitenant Lippenslaan
662,Luitenant Lippenslaan 200,2023-07-16,03:00:00,7,6,1,FMN 15 Luitenant Lippenslaan
662,Luitenant Lippenslaan 200,2023-07-16,04:00:00,10,5,5,FMN 15 Luitenant Lippenslaan
662,Luitenant Lippenslaan 200,2023-07-16,05:00:00,12,4,8,FMN 15 Luitenant Lippenslaan
662,Luitenant Lippenslaan 200,2023-07-16,06:00:00,23,13,10,FMN 15 Luitenant Lippenslaan
662,Luitenant Lippenslaan 200,2023-07-16,07:00:00,40,31,9,FMN 15 Luitenant Lippenslaan
662,Luitenant Lippenslaan 200,2023-07-16,08:00:00,48,28,20,FMN 15 Luitenant Lippenslaan
662,Luitenant Lippenslaan 200,2023-07-16,09:00:00,98,64,34,FMN 15 Luitenant Lippenslaan
662,Luitenant Lippenslaan 200,2023-07-16,10:00:00,97,56,41,FMN 15 Luitenant Lippenslaan
662,Luitenant Lippenslaan 200,2023-07-16,11:00:00,103,55,48,FMN 15 Luitenant Lippenslaan
662,Luitenant Lippenslaan 200,2023-07-16,12:00:00,122,71,51,FMN 15 Luitenant Lippenslaan
662,Luitenant Lippenslaan 200,2023-07-16,13:00:00,126,73,53,FMN 15 Luitenant Lippenslaan
662,Luitenant Lippenslaan 200,2023-07-16,14:00:00,123,64,59,FMN 15 Luitenant Lippenslaan
662,Luitenant Lippenslaan 200,2023-07-16,15:00:00,103,56,47,FMN 15 Luitenant Lippenslaan
662,Luitenant Lippenslaan 200,2023-07-16,16:00:00,100,56,44,FMN 15 Luitenant Lippenslaan
662,Luitenant Lippenslaan 200,2023-07-16,17:00:00,101,54,47,FMN 15 Luitenant Lippenslaan
662,Luitenant Lippenslaan 200,2023-07-16,18:00:00,126,78,48,FMN 15 Luitenant Lippenslaan
662,Luitenant Lippenslaan 200,2023-07-16,19:00:00,79,39,40,FMN 15 Luitenant Lippenslaan
662,Luitenant Lippenslaan 200,2023-07-16,20:00:00,79,44,35,FMN 15 Luitenant Lippenslaan
662,Luitenant Lippenslaan 200,2023-07-16,21:00:00,49,28,21,FMN 15 Luitenant Lippenslaan
662,Luitenant Lippenslaan 200,2023-07-16,22:00:00,38,26,12,FMN 15 Luitenant Lippenslaan
662,Luitenant Lippenslaan 200,2023-07-16,23:00:00,12,7,5,FMN 15 Luitenant Lippenslaan
662,Luitenant Lippenslaan 200,2023-07-18,00:00:00,7,5,2,FMN 15 Luitenant Lippenslaan
662,Luitenant Lippenslaan 200,2023-07-18,01:00:00,12,9,3,FMN 15 Luitenant Lippenslaan
662,Luitenant Lippenslaan 200,2023-07-18,02:00:00,4,1,3,FMN 15 Luitenant Lippenslaan
662,Luitenant Lippenslaan 200,2023-07-18,03:00:00,4,3,1,FMN 15 Luitenant Lippenslaan
662,Luitenant Lippenslaan 200,2023-07-18,04:00:00,14,13,1,FMN 15 Luitenant Lippenslaan
662,Luitenant Lippenslaan 200,2023-07-18,05:00:00,16,13,3,FMN 15 Luitenant Lippenslaan
662,Luitenant Lippenslaan 200,2023-07-18,06:00:00,54,50,4,FMN 15 Luitenant Lippenslaan
662,Luitenant Lippenslaan 200,2023-07-18,07:00:00,121,114,7,FMN 15 Luitenant Lippenslaan
662,Luitenant Lippenslaan 200,2023-07-18,08:00:00,256,247,9,FMN 15 Luitenant Lippenslaan
662,Luitenant Lippenslaan 200,2023-07-18,09:00:00,138,131,7,FMN 15 Luitenant Lippenslaan
662,Luitenant Lippenslaan 200,2023-07-18,10:00:00,92,86,6,FMN 15 Luitenant Lippenslaan
662,Luitenant Lippenslaan 200,2023-07-18,11:00:00,86,84,2,FMN 15 Luitenant Lippenslaan
662,Luitenant Lippenslaan 200,2023-07-18,12:00:00,95,90,5,FMN 15 Luitenant Lippenslaan
662,Luitenant Lippenslaan 200,2023-07-18,13:00:00,96,94,2,FMN 15 Luitenant Lippenslaan
662,Luitenant Lippenslaan 200,2023-07-18,14:00:00,80,69,11,FMN 15 Luitenant Lippenslaan
662,Luitenant Lippenslaan 200,2023-07-18,15:00:00,89,81,8,FMN 15 Luitenant Lippenslaan
662,Luitenant Lippenslaan 200,2023-07-18,16:00:00,97,87,10,FMN 15 Luitenant Lippenslaan
662,Luitenant Lippenslaan 200,2023-07-18,17:00:00,150,136,14,FMN 15 Luitenant Lippenslaan
662,Luitenant Lippenslaan 200,2023-07-18,18:00:00,118,110,8,FMN 15 Luitenant Lippenslaan
662,Luitenant Lippenslaan 200,2023-07-18,19:00:00,100,82,18,FMN 15 Luitenant Lippenslaan
662,Luitenant Lippenslaan 200,2023-07-18,20:00:00,73,64,9,FMN 15 Luitenant Lippenslaan
662,Luitenant Lippenslaan 200,2023-07-18,21:00:00,70,60,10,FMN 15 Luitenant Lippenslaan
662,Luitenant Lippenslaan 200,2023-07-18,22:00:00,51,38,13,FMN 15 Luitenant Lippenslaan
662,Luitenant Lippenslaan 200,2023-07-18,23:00:00,26,19,7,FMN 15 Luitenant Lippenslaan
662,Luitenant Lippenslaan 200,2023-07-19,00:00:00,18,11,7,FMN 15 Luitenant Lippenslaan
662,Luitenant Lippenslaan 200,2023-07-19,01:00:00,3,1,2,FMN 15 Luitenant Lippenslaan
662,Luitenant Lippenslaan 200,2023-07-19,02:00:00,6,3,3,FMN 15 Luitenant Lippenslaan
662,Luitenant Lippenslaan 200,2023-07-19,03:00:00,5,5,0,FMN 15 Luitenant Lippenslaan
662,Luitenant Lippenslaan 200,2023-07-19,04:00:00,9,8,1,FMN 15 Luitenant Lippenslaan
662,Luitenant Lippenslaan 200,2023-07-19,05:00:00,27,21,6,FMN 15 Luitenant Lippenslaan
662,Luitenant Lippenslaan 200,2023-07-19,06:00:00,54,45,9,FMN 15 Luitenant Lippenslaan
662,Luitenant Lippenslaan 200,2023-07-19,07:00:00,105,99,6,FMN 15 Luitenant Lippenslaan
662,Luitenant Lippenslaan 200,2023-07-19,08:00:00,228,215,13,FMN 15 Luitenant Lippenslaan
662,Luitenant Lippenslaan 200,2023-07-19,09:00:00,118,111,7,FMN 15 Luitenant Lippenslaan
662,Luitenant Lippenslaan 200,2023-07-19,10:00:00,90,79,11,FMN 15 Luitenant Lippenslaan
662,Luitenant Lippenslaan 200,2023-07-19,11:00:00,86,78,8,FMN 15 Luitenant Lippenslaan
662,Luitenant Lippenslaan 200,2023-07-19,12:00:00,100,85,15,FMN 15 Luitenant Lippenslaan
662,Luitenant Lippenslaan 200,2023-07-19,13:00:00,87,85,2,FMN 15 Luitenant Lippenslaan
662,Luitenant Lippenslaan 200,2023-07-19,14:00:00,110,100,10,FMN 15 Luitenant Lippenslaan
662,Luitenant Lippenslaan 200,2023-07-19,15:00:00,85,73,12,FMN 15 Luitenant Lippenslaan
662,Luitenant Lippenslaan 200,2023-07-19,16:00:00,105,95,10,FMN 15 Luitenant Lippenslaan
662,Luitenant Lippenslaan 200,2023-07-19,17:00:00,135,118,17,FMN 15 Luitenant Lippenslaan
662,Luitenant Lippenslaan 200,2023-07-19,18:00:00,116,102,14,FMN 15 Luitenant Lippenslaan
662,Luitenant Lippenslaan 200,2023-07-19,19:00:00,75,67,8,FMN 15 Luitenant Lippenslaan
662,Luitenant Lippenslaan 200,2023-07-19,20:00:00,67,55,12,FMN 15 Luitenant Lippenslaan
662,Luitenant Lippenslaan 200,2023-07-19,21:00:00,60,45,15,FMN 15 Luitenant Lippenslaan
662,Luitenant Lippenslaan 200,2023-07-19,22:00:00,44,24,20,FMN 15 Luitenant Lippenslaan
662,Luitenant Lippenslaan 200,2023-07-19,23:00:00,28,25,3,FMN 15 Luitenant Lippenslaan
662,Luitenant Lippenslaan 200,2023-07-20,00:00:00,12,8,4,FMN 15 Luitenant Lippenslaan
662,Luitenant Lippenslaan 200,2023-07-20,01:00:00,8,2,6,FMN 15 Luitenant Lippenslaan
662,Luitenant Lippenslaan 200,2023-07-20,02:00:00,6,3,3,FMN 15 Luitenant Lippenslaan
662,Luitenant Lippenslaan 200,2023-07-20,03:00:00,2,1,1,FMN 15 Luitenant Lippenslaan
662,Luitenant Lippenslaan 200,2023-07-20,04:00:00,9,8,1,FMN 15 Luitenant Lippenslaan
662,Luitenant Lippenslaan 200,2023-07-20,05:00:00,21,15,6,FMN 15 Luitenant Lippenslaan
662,Luitenant Lippenslaan 200,2023-07-20,06:00:00,57,48,9,FMN 15 Luitenant Lippenslaan
662,Luitenant Lippenslaan 200,2023-07-20,07:00:00,109,101,8,FMN 15 Luitenant Lippenslaan
662,Luitenant Lippenslaan 200,2023-07-20,08:00:00,216,202,14,FMN 15 Luitenant Lippenslaan
662,Luitenant Lippenslaan 200,2023-07-20,09:00:00,123,117,6,FMN 15 Luitenant Lippenslaan
662,Luitenant Lippenslaan 200,2023-07-20,10:00:00,92,85,7,FMN 15 Luitenant Lippenslaan
662,Luitenant Lippenslaan 200,2023-07-20,11:00:00,84,81,3,FMN 15 Luitenant Lippenslaan
662,Luitenant Lippenslaan 200,2023-07-20,12:00:00,95,88,7,FMN 15 Luitenant Lippenslaan
662,Luitenant Lippenslaan 200,2023-07-20,13:00:00,110,100,10,FMN 15 Luitenant Lippenslaan
662,Luitenant Lippenslaan 200,2023-07-20,14:00:00,82,75,7,FMN 15 Luitenant Lippenslaan
662,Luitenant Lippenslaan 200,2023-07-20,15:00:00,95,86,9,FMN 15 Luitenant Lippenslaan
662,Luitenant Lippenslaan 200,2023-07-20,16:00:00,124,113,11,FMN 15 Luitenant Lippenslaan
662,Luitenant Lippenslaan 200,2023-07-20,17:00:00,120,110,10,FMN 15 Luitenant Lippenslaan
662,Luitenant Lippenslaan 200,2023-07-20,18:00:00,112,99,13,FMN 15 Luitenant Lippenslaan
662,Luitenant Lippenslaan 200,2023-07-20,19:00:00,105,91,14,FMN 15 Luitenant Lippenslaan
662,Luitenant Lippenslaan 200,2023-07-20,20:00:00,68,60,8,FMN 15 Luitenant Lippenslaan
662,Luitenant Lippenslaan 200,2023-07-20,21:00:00,69,60,9,FMN 15 Luitenant Lippenslaan
662,Luitenant Lippenslaan 200,2023-07-20,22:00:00,51,39,12,FMN 15 Luitenant Lippenslaan
662,Luitenant Lippenslaan 200,2023-07-20,23:00:00,44,38,6,FMN 15 Luitenant Lippenslaan
662,Luitenant Lippenslaan 200,2023-07-21,00:00:00,21,12,9,FMN 15 Luitenant Lippenslaan
662,Luitenant Lippenslaan 200,2023-07-21,01:00:00,13,12,1,FMN 15 Luitenant Lippenslaan
662,Luitenant Lippenslaan 200,2023-07-21,02:00:00,3,1,2,FMN 15 Luitenant Lippenslaan
662,Luitenant Lippenslaan 200,2023-07-21,03:00:00,8,5,3,FMN 15 Luitenant Lippenslaan
662,Luitenant Lippenslaan 200,2023-07-21,04:00:00,6,4,2,FMN 15 Luitenant Lippenslaan
662,Luitenant Lippenslaan 200,2023-07-21,05:00:00,4,3,1,FMN 15 Luitenant Lippenslaan
662,Luitenant Lippenslaan 200,2023-07-21,06:00:00,23,20,3,FMN 15 Luitenant Lippenslaan
662,Luitenant Lippenslaan 200,2023-07-21,07:00:00,17,15,2,FMN 15 Luitenant Lippenslaan
662,Luitenant Lippenslaan 200,2023-07-21,08:00:00,26,23,3,FMN 15 Luitenant Lippenslaan
662,Luitenant Lippenslaan 200,2023-07-21,09:00:00,53,47,6,FMN 15 Luitenant Lippenslaan
662,Luitenant Lippenslaan 200,2023-07-21,10:00:00,59,55,4,FMN 15 Luitenant Lippenslaan
662,Luitenant Lippenslaan 200,2023-07-21,11:00:00,75,62,13,FMN 15 Luitenant Lippenslaan
662,Luitenant Lippenslaan 200,2023-07-21,12:00:00,30,25,5,FMN 15 Luitenant Lippenslaan
662,Luitenant Lippenslaan 200,2023-07-21,13:00:00,71,62,9,FMN 15 Luitenant Lippenslaan
662,Luitenant Lippenslaan 200,2023-07-21,14:00:00,58,50,8,FMN 15 Luitenant Lippenslaan
662,Luitenant Lippenslaan 200,2023-07-21,15:00:00,67,54,13,FMN 15 Luitenant Lippenslaan
662,Luitenant Lippenslaan 200,2023-07-21,16:00:00,67,60,7,FMN 15 Luitenant Lippenslaan
662,Luitenant Lippenslaan 200,2023-07-21,17:00:00,75,70,5,FMN 15 Luitenant Lippenslaan
662,Luitenant Lippenslaan 200,2023-07-21,18:00:00,89,78,11,FMN 15 Luitenant Lippenslaan
662,Luitenant Lippenslaan 200,2023-07-21,19:00:00,87,75,12,FMN 15 Luitenant Lippenslaan
662,Luitenant Lippenslaan 200,2023-07-21,20:00:00,76,65,11,FMN 15 Luitenant Lippenslaan
662,Luitenant Lippenslaan 200,2023-07-21,21:00:00,51,41,10,FMN 15 Luitenant Lippenslaan
662,Luitenant Lippenslaan 200,2023-07-21,22:00:00,46,34,12,FMN 15 Luitenant Lippenslaan
662,Luitenant Lippenslaan 200,2023-07-21,23:00:00,34,25,9,FMN 15 Luitenant Lippenslaan
662,Luitenant Lippenslaan 200,2023-07-22,00:00:00,25,13,12,FMN 15 Luitenant Lippenslaan
662,Luitenant Lippenslaan 200,2023-07-22,01:00:00,14,10,4,FMN 15 Luitenant Lippenslaan
662,Luitenant Lippenslaan 200,2023-07-22,02:00:00,6,3,3,FMN 15 Luitenant Lippenslaan
662,Luitenant Lippenslaan 200,2023-07-22,03:00:00,6,6,0,FMN 15 Luitenant Lippenslaan
662,Luitenant Lippenslaan 200,2023-07-22,04:00:00,13,12,1,FMN 15 Luitenant Lippenslaan
662,Luitenant Lippenslaan 200,2023-07-22,05:00:00,8,6,2,FMN 15 Luitenant Lippenslaan
662,Luitenant Lippenslaan 200,2023-07-22,06:00:00,27,25,2,FMN 15 Luitenant Lippenslaan
662,Luitenant Lippenslaan 200,2023-07-22,07:00:00,33,25,8,FMN 15 Luitenant Lippenslaan
662,Luitenant Lippenslaan 200,2023-07-22,08:00:00,28,24,4,FMN 15 Luitenant Lippenslaan
662,Luitenant Lippenslaan 200,2023-07-22,09:00:00,83,80,3,FMN 15 Luitenant Lippenslaan
662,Luitenant Lippenslaan 200,2023-07-22,10:00:00,87,84,3,FMN 15 Luitenant Lippenslaan
662,Luitenant Lippenslaan 200,2023-07-22,11:00:00,88,82,6,FMN 15 Luitenant Lippenslaan
662,Luitenant Lippenslaan 200,2023-07-22,12:00:00,71,63,8,FMN 15 Luitenant Lippenslaan
662,Luitenant Lippenslaan 200,2023-07-22,13:00:00,85,81,4,FMN 15 Luitenant Lippenslaan
662,Luitenant Lippenslaan 200,2023-07-22,14:00:00,72,63,9,FMN 15 Luitenant Lippenslaan
662,Luitenant Lippenslaan 200,2023-07-22,15:00:00,95,82,13,FMN 15 Luitenant Lippenslaan
662,Luitenant Lippenslaan 200,2023-07-22,16:00:00,60,54,6,FMN 15 Luitenant Lippenslaan
662,Luitenant Lippenslaan 200,2023-07-22,17:00:00,76,72,4,FMN 15 Luitenant Lippenslaan
662,Luitenant Lippenslaan 200,2023-07-22,18:00:00,77,64,13,FMN 15 Luitenant Lippenslaan
662,Luitenant Lippenslaan 200,2023-07-22,19:00:00,69,61,8,FMN 15 Luitenant Lippenslaan
662,Luitenant Lippenslaan 200,2023-07-22,20:00:00,51,48,3,FMN 15 Luitenant Lippenslaan
662,Luitenant Lippenslaan 200,2023-07-22,21:00:00,46,39,7,FMN 15 Luitenant Lippenslaan
662,Luitenant Lippenslaan 200,2023-07-22,22:00:00,30,25,5,FMN 15 Luitenant Lippenslaan
662,Luitenant Lippenslaan 200,2023-07-22,23:00:00,27,22,5,FMN 15 Luitenant Lippenslaan
662,Luitenant Lippenslaan 200,2023-07-23,00:00:00,18,16,2,FMN 15 Luitenant Lippenslaan
662,Luitenant Lippenslaan 200,2023-07-23,01:00:00,10,9,1,FMN 15 Luitenant Lippenslaan
662,Luitenant Lippenslaan 200,2023-07-23,02:00:00,4,4,0,FMN 15 Luitenant Lippenslaan
662,Luitenant Lippenslaan 200,2023-07-23,03:00:00,6,6,0,FMN 15 Luitenant Lippenslaan
662,Luitenant Lippenslaan 200,2023-07-23,04:00:00,8,5,3,FMN 15 Luitenant Lippenslaan
662,Luitenant Lippenslaan 200,2023-07-23,05:00:00,9,5,4,FMN 15 Luitenant Lippenslaan
662,Luitenant Lippenslaan 200,2023-07-23,06:00:00,11,10,1,FMN 15 Luitenant Lippenslaan
662,Luitenant Lippenslaan 200,2023-07-23,07:00:00,13,11,2,FMN 15 Luitenant Lippenslaan
662,Luitenant Lippenslaan 200,2023-07-23,08:00:00,12,10,2,FMN 15 Luitenant Lippenslaan
662,Luitenant Lippenslaan 200,2023-07-23,09:00:00,21,19,2,FMN 15 Luitenant Lippenslaan
662,Luitenant Lippenslaan 200,2023-07-23,10:00:00,34,29,5,FMN 15 Luitenant Lippenslaan
662,Luitenant Lippenslaan 200,2023-07-23,11:00:00,47,40,7,FMN 15 Luitenant Lippenslaan
662,Luitenant Lippenslaan 200,2023-07-23,12:00:00,56,51,5,FMN 15 Luitenant Lippenslaan
662,Luitenant Lippenslaan 200,2023-07-23,13:00:00,57,54,3,FMN 15 Luitenant Lippenslaan
662,Luitenant Lippenslaan 200,2023-07-23,14:00:00,62,52,10,FMN 15 Luitenant Lippenslaan
662,Luitenant Lippenslaan 200,2023-07-23,15:00:00,64,52,12,FMN 15 Luitenant Lippenslaan
662,Luitenant Lippenslaan 200,2023-07-23,16:00:00,61,54,7,FMN 15 Luitenant Lippenslaan
662,Luitenant Lippenslaan 200,2023-07-23,17:00:00,51,48,3,FMN 15 Luitenant Lippenslaan
662,Luitenant Lippenslaan 200,2023-07-23,18:00:00,44,34,10,FMN 15 Luitenant Lippenslaan
662,Luitenant Lippenslaan 200,2023-07-23,19:00:00,37,32,5,FMN 15 Luitenant Lippenslaan
662,Luitenant Lippenslaan 200,2023-07-23,20:00:00,30,27,3,FMN 15 Luitenant Lippenslaan
662,Luitenant Lippenslaan 200,2023-07-23,21:00:00,40,29,11,FMN 15 Luitenant Lippenslaan
662,Luitenant Lippenslaan 200,2023-07-23,22:00:00,20,17,3,FMN 15 Luitenant Lippenslaan
662,Luitenant Lippenslaan 200,2023-07-23,23:00:00,17,12,5,FMN 15 Luitenant Lippenslaan
662,Luitenant Lippenslaan 200,2023-07-24,00:00:00,8,4,4,FMN 15 Luitenant Lippenslaan
662,Luitenant Lippenslaan 200,2023-07-24,01:00:00,5,3,2,FMN 15 Luitenant Lippenslaan
662,Luitenant Lippenslaan 200,2023-07-24,02:00:00,6,2,4,FMN 15 Luitenant Lippenslaan
662,Luitenant Lippenslaan 200,2023-07-24,03:00:00,1,1,0,FMN 15 Luitenant Lippenslaan
662,Luitenant Lippenslaan 200,2023-07-24,04:00:00,8,7,1,FMN 15 Luitenant Lippenslaan
662,Luitenant Lippenslaan 200,2023-07-24,05:00:00,17,14,3,FMN 15 Luitenant Lippenslaan
662,Luitenant Lippenslaan 200,2023-07-24,06:00:00,30,29,1,FMN 15 Luitenant Lippenslaan
662,Luitenant Lippenslaan 200,2023-07-24,07:00:00,86,81,5,FMN 15 Luitenant Lippenslaan
662,Luitenant Lippenslaan 200,2023-07-24,08:00:00,168,156,12,FMN 15 Luitenant Lippenslaan
662,Luitenant Lippenslaan 200,2023-07-24,09:00:00,68,66,2,FMN 15 Luitenant Lippenslaan
662,Luitenant Lippenslaan 200,2023-07-24,10:00:00,59,54,5,FMN 15 Luitenant Lippenslaan
662,Luitenant Lippenslaan 200,2023-07-24,11:00:00,48,44,4,FMN 15 Luitenant Lippenslaan
662,Luitenant Lippenslaan 200,2023-07-24,12:00:00,59,54,5,FMN 15 Luitenant Lippenslaan
662,Luitenant Lippenslaan 200,2023-07-24,13:00:00,78,71,7,FMN 15 Luitenant Lippenslaan
662,Luitenant Lippenslaan 200,2023-07-24,14:00:00,59,54,5,FMN 15 Luitenant Lippenslaan
662,Luitenant Lippenslaan 200,2023-07-24,15:00:00,45,41,4,FMN 15 Luitenant Lippenslaan
662,Luitenant Lippenslaan 200,2023-07-24,16:00:00,62,52,10,FMN 15 Luitenant Lippenslaan
662,Luitenant Lippenslaan 200,2023-07-24,17:00:00,73,63,10,FMN 15 Luitenant Lippenslaan
662,Luitenant Lippenslaan 200,2023-07-24,18:00:00,81,71,10,FMN 15 Luitenant Lippenslaan
662,Luitenant Lippenslaan 200,2023-07-24,19:00:00,70,54,16,FMN 15 Luitenant Lippenslaan
662,Luitenant Lippenslaan 200,2023-07-24,20:00:00,49,41,8,FMN 15 Luitenant Lippenslaan
662,Luitenant Lippenslaan 200,2023-07-24,21:00:00,43,34,9,FMN 15 Luitenant Lippenslaan
662,Luitenant Lippenslaan 200,2023-07-24,22:00:00,26,17,9,FMN 15 Luitenant Lippenslaan
662,Luitenant Lippenslaan 200,2023-07-24,23:00:00,17,11,6,FMN 15 Luitenant Lippenslaan
662,Luitenant Lippenslaan 200,2023-07-25,00:00:00,6,4,2,FMN 15 Luitenant Lippenslaan
662,Luitenant Lippenslaan 200,2023-07-25,01:00:00,8,5,3,FMN 15 Luitenant Lippenslaan
662,Luitenant Lippenslaan 200,2023-07-25,02:00:00,6,2,4,FMN 15 Luitenant Lippenslaan
662,Luitenant Lippenslaan 200,2023-07-25,03:00:00,8,6,2,FMN 15 Luitenant Lippenslaan
662,Luitenant Lippenslaan 200,2023-07-25,04:00:00,10,9,1,FMN 15 Luitenant Lippenslaan
662,Luitenant Lippenslaan 200,2023-07-25,05:00:00,15,12,3,FMN 15 Luitenant Lippenslaan
662,Luitenant Lippenslaan 200,2023-07-25,06:00:00,53,50,3,FMN 15 Luitenant Lippenslaan
662,Luitenant Lippenslaan 200,2023-07-25,07:00:00,101,90,11,FMN 15 Luitenant Lippenslaan
662,Luitenant Lippenslaan 200,2023-07-25,08:00:00,190,170,20,FMN 15 Luitenant Lippenslaan
662,Luitenant Lippenslaan 200,2023-07-25,09:00:00,101,91,10,FMN 15 Luitenant Lippenslaan
662,Luitenant Lippenslaan 200,2023-07-25,10:00:00,81,76,5,FMN 15 Luitenant Lippenslaan
662,Luitenant Lippenslaan 200,2023-07-25,11:00:00,69,63,6,FMN 15 Luitenant Lippenslaan
662,Luitenant Lippenslaan 200,2023-07-25,12:00:00,86,78,8,FMN 15 Luitenant Lippenslaan
662,Luitenant Lippenslaan 200,2023-07-25,13:00:00,103,94,9,FMN 15 Luitenant Lippenslaan
662,Luitenant Lippenslaan 200,2023-07-25,14:00:00,98,91,7,FMN 15 Luitenant Lippenslaan
662,Luitenant Lippenslaan 200,2023-07-25,15:00:00,100,87,13,FMN 15 Luitenant Lippenslaan
662,Luitenant Lippenslaan 200,2023-07-25,16:00:00,102,97,5,FMN 15 Luitenant Lippenslaan
662,Luitenant Lippenslaan 200,2023-07-25,17:00:00,139,128,11,FMN 15 Luitenant Lippenslaan
662,Luitenant Lippenslaan 200,2023-07-25,18:00:00,128,116,12,FMN 15 Luitenant Lippenslaan
662,Luitenant Lippenslaan 200,2023-07-25,19:00:00,81,75,6,FMN 15 Luitenant Lippenslaan
662,Luitenant Lippenslaan 200,2023-07-25,20:00:00,76,66,10,FMN 15 Luitenant Lippenslaan
662,Luitenant Lippenslaan 200,2023-07-25,21:00:00,40,36,4,FMN 15 Luitenant Lippenslaan
662,Luitenant Lippenslaan 200,2023-07-25,22:00:00,45,37,8,FMN 15 Luitenant Lippenslaan
662,Luitenant Lippenslaan 200,2023-07-25,23:00:00,48,41,7,FMN 15 Luitenant Lippenslaan
662,Luitenant Lippenslaan 200,2023-07-26,00:00:00,34,27,7,FMN 15 Luitenant Lippenslaan
662,Luitenant Lippenslaan 200,2023-07-26,01:00:00,9,5,4,FMN 15 Luitenant Lippenslaan
662,Luitenant Lippenslaan 200,2023-07-26,02:00:00,3,1,2,FMN 15 Luitenant Lippenslaan
662,Luitenant Lippenslaan 200,2023-07-26,03:00:00,4,2,2,FMN 15 Luitenant Lippenslaan
662,Luitenant Lippenslaan 200,2023-07-26,04:00:00,11,10,1,FMN 15 Luitenant Lippenslaan
662,Luitenant Lippenslaan 200,2023-07-26,05:00:00,19,13,6,FMN 15 Luitenant Lippenslaan
662,Luitenant Lippenslaan 200,2023-07-26,06:00:00,52,47,5,FMN 15 Luitenant Lippenslaan
662,Luitenant Lippenslaan 200,2023-07-26,07:00:00,118,109,9,FMN 15 Luitenant Lippenslaan
662,Luitenant Lippenslaan 200,2023-07-26,08:00:00,196,192,4,FMN 15 Luitenant Lippenslaan
662,Luitenant Lippenslaan 200,2023-07-26,09:00:00,110,103,7,FMN 15 Luitenant Lippenslaan
662,Luitenant Lippenslaan 200,2023-07-26,10:00:00,75,72,3,FMN 15 Luitenant Lippenslaan
662,Luitenant Lippenslaan 200,2023-07-26,11:00:00,79,71,8,FMN 15 Luitenant Lippenslaan
662,Luitenant Lippenslaan 200,2023-07-26,12:00:00,79,72,7,FMN 15 Luitenant Lippenslaan
662,Luitenant Lippenslaan 200,2023-07-26,13:00:00,84,83,1,FMN 15 Luitenant Lippenslaan
662,Luitenant Lippenslaan 200,2023-07-26,14:00:00,103,98,5,FMN 15 Luitenant Lippenslaan
662,Luitenant Lippenslaan 200,2023-07-26,15:00:00,96,92,4,FMN 15 Luitenant Lippenslaan
662,Luitenant Lippenslaan 200,2023-07-26,16:00:00,112,101,11,FMN 15 Luitenant Lippenslaan
662,Luitenant Lippenslaan 200,2023-07-26,17:00:00,135,119,16,FMN 15 Luitenant Lippenslaan
662,Luitenant Lippenslaan 200,2023-07-26,18:00:00,100,86,14,FMN 15 Luitenant Lippenslaan
662,Luitenant Lippenslaan 200,2023-07-26,19:00:00,74,61,13,FMN 15 Luitenant Lippenslaan
662,Luitenant Lippenslaan 200,2023-07-26,20:00:00,80,72,8,FMN 15 Luitenant Lippenslaan
662,Luitenant Lippenslaan 200,2023-07-26,21:00:00,46,37,9,FMN 15 Luitenant Lippenslaan
662,Luitenant Lippenslaan 200,2023-07-26,22:00:00,42,28,14,FMN 15 Luitenant Lippenslaan
662,Luitenant Lippenslaan 200,2023-07-26,23:00:00,46,39,7,FMN 15 Luitenant Lippenslaan
662,Luitenant Lippenslaan 200,2023-07-27,00:00:00,32,28,4,FMN 15 Luitenant Lippenslaan
662,Luitenant Lippenslaan 200,2023-07-27,01:00:00,8,5,3,FMN 15 Luitenant Lippenslaan
662,Luitenant Lippenslaan 200,2023-07-27,02:00:00,7,4,3,FMN 15 Luitenant Lippenslaan
662,Luitenant Lippenslaan 200,2023-07-27,03:00:00,0,0,0,FMN 15 Luitenant Lippenslaan
662,Luitenant Lippenslaan 200,2023-07-27,04:00:00,9,7,2,FMN 15 Luitenant Lippenslaan
662,Luitenant Lippenslaan 200,2023-07-27,05:00:00,11,9,2,FMN 15 Luitenant Lippenslaan
662,Luitenant Lippenslaan 200,2023-07-27,06:00:00,32,28,4,FMN 15 Luitenant Lippenslaan
662,Luitenant Lippenslaan 200,2023-07-27,07:00:00,66,62,4,FMN 15 Luitenant Lippenslaan
662,Luitenant Lippenslaan 200,2023-07-27,08:00:00,137,129,8,FMN 15 Luitenant Lippenslaan
662,Luitenant Lippenslaan 200,2023-07-27,09:00:00,92,85,7,FMN 15 Luitenant Lippenslaan
662,Luitenant Lippenslaan 200,2023-07-27,10:00:00,47,43,4,FMN 15 Luitenant Lippenslaan
662,Luitenant Lippenslaan 200,2023-07-27,11:00:00,54,48,6,FMN 15 Luitenant Lippenslaan
662,Luitenant Lippenslaan 200,2023-07-27,12:00:00,36,32,4,FMN 15 Luitenant Lippenslaan
662,Luitenant Lippenslaan 200,2023-07-27,13:00:00,46,44,2,FMN 15 Luitenant Lippenslaan
662,Luitenant Lippenslaan 200,2023-07-27,14:00:00,60,55,5,FMN 15 Luitenant Lippenslaan
662,Luitenant Lippenslaan 200,2023-07-27,15:00:00,53,48,5,FMN 15 Luitenant Lippenslaan
662,Luitenant Lippenslaan 200,2023-07-27,16:00:00,62,51,11,FMN 15 Luitenant Lippenslaan
662,Luitenant Lippenslaan 200,2023-07-27,17:00:00,86,74,12,FMN 15 Luitenant Lippenslaan
662,Luitenant Lippenslaan 200,2023-07-27,18:00:00,71,60,11,FMN 15 Luitenant Lippenslaan
662,Luitenant Lippenslaan 200,2023-07-27,19:00:00,59,49,10,FMN 15 Luitenant Lippenslaan
662,Luitenant Lippenslaan 200,2023-07-27,20:00:00,41,33,8,FMN 15 Luitenant Lippenslaan
662,Luitenant Lippenslaan 200,2023-07-27,21:00:00,25,22,3,FMN 15 Luitenant Lippenslaan
662,Luitenant Lippenslaan 200,2023-07-27,22:00:00,39,28,11,FMN 15 Luitenant Lippenslaan
662,Luitenant Lippenslaan 200,2023-07-27,23:00:00,32,28,4,FMN 15 Luitenant Lippenslaan
662,Luitenant Lippenslaan 200,2023-07-28,00:00:00,21,17,4,FMN 15 Luitenant Lippenslaan
662,Luitenant Lippenslaan 200,2023-07-28,01:00:00,8,4,4,FMN 15 Luitenant Lippenslaan
662,Luitenant Lippenslaan 200,2023-07-28,02:00:00,8,3,5,FMN 15 Luitenant Lippenslaan
662,Luitenant Lippenslaan 200,2023-07-28,03:00:00,4,2,2,FMN 15 Luitenant Lippenslaan
662,Luitenant Lippenslaan 200,2023-07-28,04:00:00,6,5,1,FMN 15 Luitenant Lippenslaan
662,Luitenant Lippenslaan 200,2023-07-28,05:00:00,7,5,2,FMN 15 Luitenant Lippenslaan
662,Luitenant Lippenslaan 200,2023-07-28,06:00:00,37,32,5,FMN 15 Luitenant Lippenslaan
662,Luitenant Lippenslaan 200,2023-07-28,07:00:00,79,70,9,FMN 15 Luitenant Lippenslaan
662,Luitenant Lippenslaan 200,2023-07-28,08:00:00,138,130,8,FMN 15 Luitenant Lippenslaan
662,Luitenant Lippenslaan 200,2023-07-28,09:00:00,105,97,8,FMN 15 Luitenant Lippenslaan
662,Luitenant Lippenslaan 200,2023-07-28,10:00:00,81,78,3,FMN 15 Luitenant Lippenslaan
662,Luitenant Lippenslaan 200,2023-07-28,11:00:00,102,95,7,FMN 15 Luitenant Lippenslaan
662,Luitenant Lippenslaan 200,2023-07-28,12:00:00,87,81,6,FMN 15 Luitenant Lippenslaan
662,Luitenant Lippenslaan 200,2023-07-28,13:00:00,83,77,6,FMN 15 Luitenant Lippenslaan
662,Luitenant Lippenslaan 200,2023-07-28,14:00:00,85,68,17,FMN 15 Luitenant Lippenslaan
662,Luitenant Lippenslaan 200,2023-07-28,15:00:00,104,93,11,FMN 15 Luitenant Lippenslaan
662,Luitenant Lippenslaan 200,2023-07-28,16:00:00,116,99,17,FMN 15 Luitenant Lippenslaan
662,Luitenant Lippenslaan 200,2023-07-28,17:00:00,113,102,11,FMN 15 Luitenant Lippenslaan
662,Luitenant Lippenslaan 200,2023-07-28,18:00:00,118,96,22,FMN 15 Luitenant Lippenslaan
662,Luitenant Lippenslaan 200,2023-07-28,19:00:00,86,75,11,FMN 15 Luitenant Lippenslaan
662,Luitenant Lippenslaan 200,2023-07-28,20:00:00,67,54,13,FMN 15 Luitenant Lippenslaan
662,Luitenant Lippenslaan 200,2023-07-28,21:00:00,49,39,10,FMN 15 Luitenant Lippenslaan
662,Luitenant Lippenslaan 200,2023-07-28,22:00:00,43,30,13,FMN 15 Luitenant Lippenslaan
662,Luitenant Lippenslaan 200,2023-07-28,23:00:00,44,35,9,FMN 15 Luitenant Lippenslaan
662,Luitenant Lippenslaan 200,2023-07-29,00:00:00,24,18,6,FMN 15 Luitenant Lippenslaan
662,Luitenant Lippenslaan 200,2023-07-29,01:00:00,15,8,7,FMN 15 Luitenant Lippenslaan
662,Luitenant Lippenslaan 200,2023-07-29,02:00:00,10,8,2,FMN 15 Luitenant Lippenslaan
662,Luitenant Lippenslaan 200,2023-07-29,03:00:00,14,12,2,FMN 15 Luitenant Lippenslaan
662,Luitenant Lippenslaan 200,2023-07-29,04:00:00,10,9,1,FMN 15 Luitenant Lippenslaan
662,Luitenant Lippenslaan 200,2023-07-29,05:00:00,10,9,1,FMN 15 Luitenant Lippenslaan
662,Luitenant Lippenslaan 200,2023-07-29,06:00:00,15,12,3,FMN 15 Luitenant Lippenslaan
662,Luitenant Lippenslaan 200,2023-07-29,07:00:00,21,19,2,FMN 15 Luitenant Lippenslaan
662,Luitenant Lippenslaan 200,2023-07-29,08:00:00,34,34,0,FMN 15 Luitenant Lippenslaan
662,Luitenant Lippenslaan 200,2023-07-29,09:00:00,70,65,5,FMN 15 Luitenant Lippenslaan
662,Luitenant Lippenslaan 200,2023-07-29,10:00:00,75,72,3,FMN 15 Luitenant Lippenslaan
662,Luitenant Lippenslaan 200,2023-07-29,11:00:00,81,77,4,FMN 15 Luitenant Lippenslaan
662,Luitenant Lippenslaan 200,2023-07-29,12:00:00,77,69,8,FMN 15 Luitenant Lippenslaan
662,Luitenant Lippenslaan 200,2023-07-29,13:00:00,45,35,10,FMN 15 Luitenant Lippenslaan
662,Luitenant Lippenslaan 200,2023-07-29,14:00:00,64,58,6,FMN 15 Luitenant Lippenslaan
662,Luitenant Lippenslaan 200,2023-07-29,15:00:00,63,56,7,FMN 15 Luitenant Lippenslaan
662,Luitenant Lippenslaan 200,2023-07-29,16:00:00,48,40,8,FMN 15 Luitenant Lippenslaan
662,Luitenant Lippenslaan 200,2023-07-29,17:00:00,80,71,9,FMN 15 Luitenant Lippenslaan
662,Luitenant Lippenslaan 200,2023-07-29,18:00:00,80,67,13,FMN 15 Luitenant Lippenslaan
662,Luitenant Lippenslaan 200,2023-07-29,19:00:00,65,52,13,FMN 15 Luitenant Lippenslaan
662,Luitenant Lippenslaan 200,2023-07-29,20:00:00,59,52,7,FMN 15 Luitenant Lippenslaan
662,Luitenant Lippenslaan 200,2023-07-29,21:00:00,69,61,8,FMN 15 Luitenant Lippenslaan
662,Luitenant Lippenslaan 200,2023-07-29,22:00:00,45,36,9,FMN 15 Luitenant Lippenslaan
662,Luitenant Lippenslaan 200,2023-07-29,23:00:00,33,27,6,FMN 15 Luitenant Lippenslaan
662,Luitenant Lippenslaan 200,2023-07-30,00:00:00,17,13,4,FMN 15 Luitenant Lippenslaan
662,Luitenant Lippenslaan 200,2023-07-30,01:00:00,16,13,3,FMN 15 Luitenant Lippenslaan
662,Luitenant Lippenslaan 200,2023-07-30,02:00:00,10,8,2,FMN 15 Luitenant Lippenslaan
662,Luitenant Lippenslaan 200,2023-07-30,03:00:00,15,10,5,FMN 15 Luitenant Lippenslaan
662,Luitenant Lippenslaan 200,2023-07-30,04:00:00,12,9,3,FMN 15 Luitenant Lippenslaan
662,Luitenant Lippenslaan 200,2023-07-30,05:00:00,8,7,1,FMN 15 Luitenant Lippenslaan
662,Luitenant Lippenslaan 200,2023-07-30,06:00:00,9,8,1,FMN 15 Luitenant Lippenslaan
662,Luitenant Lippenslaan 200,2023-07-30,07:00:00,13,12,1,FMN 15 Luitenant Lippenslaan
662,Luitenant Lippenslaan 200,2023-07-30,08:00:00,31,27,4,FMN 15 Luitenant Lippenslaan
662,Luitenant Lippenslaan 200,2023-07-30,09:00:00,35,32,3,FMN 15 Luitenant Lippenslaan
662,Luitenant Lippenslaan 200,2023-07-30,10:00:00,47,45,2,FMN 15 Luitenant Lippenslaan
662,Luitenant Lippenslaan 200,2023-07-30,11:00:00,58,56,2,FMN 15 Luitenant Lippenslaan
662,Luitenant Lippenslaan 200,2023-07-30,12:00:00,73,66,7,FMN 15 Luitenant Lippenslaan
662,Luitenant Lippenslaan 200,2023-07-30,13:00:00,84,72,12,FMN 15 Luitenant Lippenslaan
662,Luitenant Lippenslaan 200,2023-07-30,14:00:00,85,75,10,FMN 15 Luitenant Lippenslaan
662,Luitenant Lippenslaan 200,2023-07-30,15:00:00,66,59,7,FMN 15 Luitenant Lippenslaan
662,Luitenant Lippenslaan 200,2023-07-30,16:00:00,63,61,2,FMN 15 Luitenant Lippenslaan
662,Luitenant Lippenslaan 200,2023-07-30,17:00:00,67,63,4,FMN 15 Luitenant Lippenslaan
662,Luitenant Lippenslaan 200,2023-07-30,18:00:00,61,56,5,FMN 15 Luitenant Lippenslaan
662,Luitenant Lippenslaan 200,2023-07-30,19:00:00,33,27,6,FMN 15 Luitenant Lippenslaan
662,Luitenant Lippenslaan 200,2023-07-30,20:00:00,27,21,6,FMN 15 Luitenant Lippenslaan
662,Luitenant Lippenslaan 200,2023-07-30,21:00:00,27,23,4,FMN 15 Luitenant Lippenslaan
662,Luitenant Lippenslaan 200,2023-07-30,22:00:00,23,15,8,FMN 15 Luitenant Lippenslaan
662,Luitenant Lippenslaan 200,2023-07-30,23:00:00,6,3,3,FMN 15 Luitenant Lippenslaan
662,Luitenant Lippenslaan 200,2023-07-31,00:00:00,10,9,1,FMN 15 Luitenant Lippenslaan
662,Luitenant Lippenslaan 200,2023-07-31,01:00:00,5,2,3,FMN 15 Luitenant Lippenslaan
662,Luitenant Lippenslaan 200,2023-07-31,02:00:00,3,2,1,FMN 15 Luitenant Lippenslaan
662,Luitenant Lippenslaan 200,2023-07-31,03:00:00,2,0,2,FMN 15 Luitenant Lippenslaan
662,Luitenant Lippenslaan 200,2023-07-31,04:00:00,8,6,2,FMN 15 Luitenant Lippenslaan
662,Luitenant Lippenslaan 200,2023-07-31,05:00:00,16,14,2,FMN 15 Luitenant Lippenslaan
662,Luitenant Lippenslaan 200,2023-07-31,06:00:00,45,38,7,FMN 15 Luitenant Lippenslaan
662,Luitenant Lippenslaan 200,2023-07-31,07:00:00,68,65,3,FMN 15 Luitenant Lippenslaan
662,Luitenant Lippenslaan 200,2023-07-31,08:00:00,132,125,7,FMN 15 Luitenant Lippenslaan
662,Luitenant Lippenslaan 200,2023-07-31,09:00:00,70,66,4,FMN 15 Luitenant Lippenslaan
662,Luitenant Lippenslaan 200,2023-07-31,10:00:00,67,61,6,FMN 15 Luitenant Lippenslaan
662,Luitenant Lippenslaan 200,2023-07-31,11:00:00,48,41,7,FMN 15 Luitenant Lippenslaan
662,Luitenant Lippenslaan 200,2023-07-31,12:00:00,67,61,6,FMN 15 Luitenant Lippenslaan
662,Luitenant Lippenslaan 200,2023-07-31,13:00:00,59,51,8,FMN 15 Luitenant Lippenslaan
662,Luitenant Lippenslaan 200,2023-07-31,14:00:00,73,62,11,FMN 15 Luitenant Lippenslaan
662,Luitenant Lippenslaan 200,2023-07-31,15:00:00,66,54,12,FMN 15 Luitenant Lippenslaan
662,Luitenant Lippenslaan 200,2023-07-31,16:00:00,46,37,9,FMN 15 Luitenant Lippenslaan
662,Luitenant Lippenslaan 200,2023-07-31,17:00:00,61,55,6,FMN 15 Luitenant Lippenslaan
662,Luitenant Lippenslaan 200,2023-07-31,18:00:00,54,46,8,FMN 15 Luitenant Lippenslaan
662,Luitenant Lippenslaan 200,2023-07-31,19:00:00,27,20,7,FMN 15 Luitenant Lippenslaan
662,Luitenant Lippenslaan 200,2023-07-31,20:00:00,20,18,2,FMN 15 Luitenant Lippenslaan
662,Luitenant Lippenslaan 200,2023-07-31,21:00:00,22,20,2,FMN 15 Luitenant Lippenslaan
662,Luitenant Lippenslaan 200,2023-07-31,22:00:00,27,18,9,FMN 15 Luitenant Lippenslaan
662,Luitenant Lippenslaan 200,2023-07-31,23:00:00,10,9,1,FMN 15 Luitenant Lippenslaan
662,Luitenant Lippenslaan 200,2023-08-01,00:00:00,7,4,3,FMN 15 Luitenant Lippenslaan
662,Luitenant Lippenslaan 200,2023-08-01,01:00:00,6,5,1,FMN 15 Luitenant Lippenslaan
662,Luitenant Lippenslaan 200,2023-08-01,02:00:00,3,2,1,FMN 15 Luitenant Lippenslaan
662,Luitenant Lippenslaan 200,2023-08-01,03:00:00,1,0,1,FMN 15 Luitenant Lippenslaan
662,Luitenant Lippenslaan 200,2023-08-01,04:00:00,4,4,0,FMN 15 Luitenant Lippenslaan
662,Luitenant Lippenslaan 200,2023-08-01,05:00:00,17,13,4,FMN 15 Luitenant Lippenslaan
662,Luitenant Lippenslaan 200,2023-08-01,06:00:00,51,44,7,FMN 15 Luitenant Lippenslaan
662,Luitenant Lippenslaan 200,2023-08-01,07:00:00,88,84,4,FMN 15 Luitenant Lippenslaan
662,Luitenant Lippenslaan 200,2023-08-01,08:00:00,198,192,6,FMN 15 Luitenant Lippenslaan
662,Luitenant Lippenslaan 200,2023-08-01,09:00:00,120,113,7,FMN 15 Luitenant Lippenslaan
662,Luitenant Lippenslaan 200,2023-08-01,10:00:00,56,51,5,FMN 15 Luitenant Lippenslaan
662,Luitenant Lippenslaan 200,2023-08-01,11:00:00,62,58,4,FMN 15 Luitenant Lippenslaan
662,Luitenant Lippenslaan 200,2023-08-01,12:00:00,74,67,7,FMN 15 Luitenant Lippenslaan
662,Luitenant Lippenslaan 200,2023-08-01,13:00:00,75,65,10,FMN 15 Luitenant Lippenslaan
662,Luitenant Lippenslaan 200,2023-08-01,14:00:00,77,68,9,FMN 15 Luitenant Lippenslaan
662,Luitenant Lippenslaan 200,2023-08-01,15:00:00,85,73,12,FMN 15 Luitenant Lippenslaan
662,Luitenant Lippenslaan 200,2023-08-01,16:00:00,104,88,16,FMN 15 Luitenant Lippenslaan
662,Luitenant Lippenslaan 200,2023-08-01,17:00:00,115,98,17,FMN 15 Luitenant Lippenslaan
662,Luitenant Lippenslaan 200,2023-08-01,18:00:00,110,98,12,FMN 15 Luitenant Lippenslaan
662,Luitenant Lippenslaan 200,2023-08-01,19:00:00,70,64,6,FMN 15 Luitenant Lippenslaan
662,Luitenant Lippenslaan 200,2023-08-01,20:00:00,66,53,13,FMN 15 Luitenant Lippenslaan
662,Luitenant Lippenslaan 200,2023-08-01,21:00:00,42,37,5,FMN 15 Luitenant Lippenslaan
662,Luitenant Lippenslaan 200,2023-08-01,22:00:00,62,40,22,FMN 15 Luitenant Lippenslaan
662,Luitenant Lippenslaan 200,2023-08-01,23:00:00,27,21,6,FMN 15 Luitenant Lippenslaan
662,Luitenant Lippenslaan 200,2023-08-02,00:00:00,13,10,3,FMN 15 Luitenant Lippenslaan
662,Luitenant Lippenslaan 200,2023-08-02,01:00:00,9,4,5,FMN 15 Luitenant Lippenslaan
662,Luitenant Lippenslaan 200,2023-08-02,02:00:00,4,1,3,FMN 15 Luitenant Lippenslaan
662,Luitenant Lippenslaan 200,2023-08-02,03:00:00,1,1,0,FMN 15 Luitenant Lippenslaan
662,Luitenant Lippenslaan 200,2023-08-02,04:00:00,7,6,1,FMN 15 Luitenant Lippenslaan
662,Luitenant Lippenslaan 200,2023-08-02,05:00:00,16,12,4,FMN 15 Luitenant Lippenslaan
662,Luitenant Lippenslaan 200,2023-08-02,06:00:00,39,30,9,FMN 15 Luitenant Lippenslaan
662,Luitenant Lippenslaan 200,2023-08-02,07:00:00,64,57,7,FMN 15 Luitenant Lippenslaan
662,Luitenant Lippenslaan 200,2023-08-02,08:00:00,135,124,11,FMN 15 Luitenant Lippenslaan
662,Luitenant Lippenslaan 200,2023-08-02,09:00:00,62,59,3,FMN 15 Luitenant Lippenslaan
662,Luitenant Lippenslaan 200,2023-08-02,10:00:00,44,42,2,FMN 15 Luitenant Lippenslaan
662,Luitenant Lippenslaan 200,2023-08-02,11:00:00,44,39,5,FMN 15 Luitenant Lippenslaan
662,Luitenant Lippenslaan 200,2023-08-02,12:00:00,58,54,4,FMN 15 Luitenant Lippenslaan
662,Luitenant Lippenslaan 200,2023-08-02,13:00:00,58,54,4,FMN 15 Luitenant Lippenslaan
662,Luitenant Lippenslaan 200,2023-08-02,14:00:00,68,56,12,FMN 15 Luitenant Lippenslaan
662,Luitenant Lippenslaan 200,2023-08-02,15:00:00,66,59,7,FMN 15 Luitenant Lippenslaan
662,Luitenant Lippenslaan 200,2023-08-02,16:00:00,97,84,13,FMN 15 Luitenant Lippenslaan
662,Luitenant Lippenslaan 200,2023-08-02,17:00:00,105,99,6,FMN 15 Luitenant Lippenslaan
662,Luitenant Lippenslaan 200,2023-08-02,18:00:00,102,87,15,FMN 15 Luitenant Lippenslaan
662,Luitenant Lippenslaan 200,2023-08-02,19:00:00,49,35,14,FMN 15 Luitenant Lippenslaan
662,Luitenant Lippenslaan 200,2023-08-02,20:00:00,41,32,9,FMN 15 Luitenant Lippenslaan
662,Luitenant Lippenslaan 200,2023-08-02,21:00:00,30,25,5,FMN 15 Luitenant Lippenslaan
662,Luitenant Lippenslaan 200,2023-08-02,22:00:00,42,34,8,FMN 15 Luitenant Lippenslaan
662,Luitenant Lippenslaan 200,2023-08-02,23:00:00,23,20,3,FMN 15 Luitenant Lippenslaan
662,Luitenant Lippenslaan 200,2023-08-03,00:00:00,7,3,4,FMN 15 Luitenant Lippenslaan
662,Luitenant Lippenslaan 200,2023-08-03,01:00:00,8,7,1,FMN 15 Luitenant Lippenslaan
662,Luitenant Lippenslaan 200,2023-08-03,02:00:00,4,1,3,FMN 15 Luitenant Lippenslaan
662,Luitenant Lippenslaan 200,2023-08-03,03:00:00,1,1,0,FMN 15 Luitenant Lippenslaan
662,Luitenant Lippenslaan 200,2023-08-03,04:00:00,9,6,3,FMN 15 Luitenant Lippenslaan
662,Luitenant Lippenslaan 200,2023-08-03,05:00:00,15,13,2,FMN 15 Luitenant Lippenslaan
662,Luitenant Lippenslaan 200,2023-08-03,06:00:00,38,33,5,FMN 15 Luitenant Lippenslaan
662,Luitenant Lippenslaan 200,2023-08-03,07:00:00,92,84,8,FMN 15 Luitenant Lippenslaan
662,Luitenant Lippenslaan 200,2023-08-03,08:00:00,159,154,5,FMN 15 Luitenant Lippenslaan
662,Luitenant Lippenslaan 200,2023-08-03,09:00:00,97,95,2,FMN 15 Luitenant Lippenslaan
662,Luitenant Lippenslaan 200,2023-08-03,10:00:00,56,49,7,FMN 15 Luitenant Lippenslaan
662,Luitenant Lippenslaan 200,2023-08-03,11:00:00,41,37,4,FMN 15 Luitenant Lippenslaan
662,Luitenant Lippenslaan 200,2023-08-03,12:00:00,41,37,4,FMN 15 Luitenant Lippenslaan
662,Luitenant Lippenslaan 200,2023-08-03,13:00:00,49,43,6,FMN 15 Luitenant Lippenslaan
662,Luitenant Lippenslaan 200,2023-08-03,14:00:00,56,44,12,FMN 15 Luitenant Lippenslaan
662,Luitenant Lippenslaan 200,2023-08-03,15:00:00,62,55,7,FMN 15 Luitenant Lippenslaan
662,Luitenant Lippenslaan 200,2023-08-03,16:00:00,77,65,12,FMN 15 Luitenant Lippenslaan
662,Luitenant Lippenslaan 200,2023-08-03,17:00:00,93,73,20,FMN 15 Luitenant Lippenslaan
662,Luitenant Lippenslaan 200,2023-08-03,18:00:00,112,97,15,FMN 15 Luitenant Lippenslaan
662,Luitenant Lippenslaan 200,2023-08-03,19:00:00,72,59,13,FMN 15 Luitenant Lippenslaan
662,Luitenant Lippenslaan 200,2023-08-03,20:00:00,41,37,4,FMN 15 Luitenant Lippenslaan
662,Luitenant Lippenslaan 200,2023-08-03,21:00:00,61,50,11,FMN 15 Luitenant Lippenslaan
662,Luitenant Lippenslaan 200,2023-08-03,22:00:00,37,30,7,FMN 15 Luitenant Lippenslaan
662,Luitenant Lippenslaan 200,2023-08-03,23:00:00,25,17,8,FMN 15 Luitenant Lippenslaan
662,Luitenant Lippenslaan 200,2023-08-04,00:00:00,24,15,9,FMN 15 Luitenant Lippenslaan
662,Luitenant Lippenslaan 200,2023-08-04,01:00:00,3,1,2,FMN 15 Luitenant Lippenslaan
662,Luitenant Lippenslaan 200,2023-08-04,02:00:00,4,2,2,FMN 15 Luitenant Lippenslaan
662,Luitenant Lippenslaan 200,2023-08-04,03:00:00,4,2,2,FMN 15 Luitenant Lippenslaan
662,Luitenant Lippenslaan 200,2023-08-04,04:00:00,6,5,1,FMN 15 Luitenant Lippenslaan
662,Luitenant Lippenslaan 200,2023-08-04,05:00:00,20,18,2,FMN 15 Luitenant Lippenslaan
662,Luitenant Lippenslaan 200,2023-08-04,06:00:00,40,33,7,FMN 15 Luitenant Lippenslaan
662,Luitenant Lippenslaan 200,2023-08-04,07:00:00,70,60,10,FMN 15 Luitenant Lippenslaan
662,Luitenant Lippenslaan 200,2023-08-04,08:00:00,124,116,8,FMN 15 Luitenant Lippenslaan
662,Luitenant Lippenslaan 200,2023-08-04,09:00:00,72,69,3,FMN 15 Luitenant Lippenslaan
662,Luitenant Lippenslaan 200,2023-08-04,10:00:00,61,55,6,FMN 15 Luitenant Lippenslaan
662,Luitenant Lippenslaan 200,2023-08-04,11:00:00,80,70,10,FMN 15 Luitenant Lippenslaan
662,Luitenant Lippenslaan 200,2023-08-04,12:00:00,82,75,7,FMN 15 Luitenant Lippenslaan
662,Luitenant Lippenslaan 200,2023-08-04,13:00:00,89,82,7,FMN 15 Luitenant Lippenslaan
662,Luitenant Lippenslaan 200,2023-08-04,14:00:00,78,67,11,FMN 15 Luitenant Lippenslaan
662,Luitenant Lippenslaan 200,2023-08-04,15:00:00,91,84,7,FMN 15 Luitenant Lippenslaan
662,Luitenant Lippenslaan 200,2023-08-04,16:00:00,94,85,9,FMN 15 Luitenant Lippenslaan
662,Luitenant Lippenslaan 200,2023-08-04,17:00:00,132,122,10,FMN 15 Luitenant Lippenslaan
662,Luitenant Lippenslaan 200,2023-08-04,18:00:00,108,98,10,FMN 15 Luitenant Lippenslaan
662,Luitenant Lippenslaan 200,2023-08-04,19:00:00,90,72,18,FMN 15 Luitenant Lippenslaan
662,Luitenant Lippenslaan 200,2023-08-04,20:00:00,60,51,9,FMN 15 Luitenant Lippenslaan
662,Luitenant Lippenslaan 200,2023-08-04,21:00:00,52,37,15,FMN 15 Luitenant Lippenslaan
662,Luitenant Lippenslaan 200,2023-08-04,22:00:00,41,34,7,FMN 15 Luitenant Lippenslaan
662,Luitenant Lippenslaan 200,2023-08-04,23:00:00,52,41,11,FMN 15 Luitenant Lippenslaan
662,Luitenant Lippenslaan 200,2023-08-05,00:00:00,29,20,9,FMN 15 Luitenant Lippenslaan
662,Luitenant Lippenslaan 200,2023-08-05,01:00:00,15,10,5,FMN 15 Luitenant Lippenslaan
662,Luitenant Lippenslaan 200,2023-08-05,02:00:00,14,8,6,FMN 15 Luitenant Lippenslaan
662,Luitenant Lippenslaan 200,2023-08-05,03:00:00,7,5,2,FMN 15 Luitenant Lippenslaan
662,Luitenant Lippenslaan 200,2023-08-05,04:00:00,6,5,1,FMN 15 Luitenant Lippenslaan
662,Luitenant Lippenslaan 200,2023-08-05,05:00:00,10,6,4,FMN 15 Luitenant Lippenslaan
662,Luitenant Lippenslaan 200,2023-08-05,06:00:00,16,13,3,FMN 15 Luitenant Lippenslaan
662,Luitenant Lippenslaan 200,2023-08-05,07:00:00,20,19,1,FMN 15 Luitenant Lippenslaan
662,Luitenant Lippenslaan 200,2023-08-05,08:00:00,40,34,6,FMN 15 Luitenant Lippenslaan
662,Luitenant Lippenslaan 200,2023-08-05,09:00:00,65,62,3,FMN 15 Luitenant Lippenslaan
662,Luitenant Lippenslaan 200,2023-08-05,10:00:00,90,80,10,FMN 15 Luitenant Lippenslaan
662,Luitenant Lippenslaan 200,2023-08-05,11:00:00,65,60,5,FMN 15 Luitenant Lippenslaan
662,Luitenant Lippenslaan 200,2023-08-05,12:00:00,84,82,2,FMN 15 Luitenant Lippenslaan
662,Luitenant Lippenslaan 200,2023-08-05,13:00:00,47,40,7,FMN 15 Luitenant Lippenslaan
662,Luitenant Lippenslaan 200,2023-08-05,14:00:00,46,39,7,FMN 15 Luitenant Lippenslaan
662,Luitenant Lippenslaan 200,2023-08-05,15:00:00,54,43,11,FMN 15 Luitenant Lippenslaan
662,Luitenant Lippenslaan 200,2023-08-05,16:00:00,37,32,5,FMN 15 Luitenant Lippenslaan
662,Luitenant Lippenslaan 200,2023-08-05,17:00:00,54,47,7,FMN 15 Luitenant Lippenslaan
662,Luitenant Lippenslaan 200,2023-08-05,18:00:00,64,55,9,FMN 15 Luitenant Lippenslaan
662,Luitenant Lippenslaan 200,2023-08-05,19:00:00,61,54,7,FMN 15 Luitenant Lippenslaan
662,Luitenant Lippenslaan 200,2023-08-05,20:00:00,49,40,9,FMN 15 Luitenant Lippenslaan
662,Luitenant Lippenslaan 200,2023-08-05,21:00:00,28,20,8,FMN 15 Luitenant Lippenslaan
662,Luitenant Lippenslaan 200,2023-08-05,22:00:00,21,16,5,FMN 15 Luitenant Lippenslaan
662,Luitenant Lippenslaan 200,2023-08-05,23:00:00,19,15,4,FMN 15 Luitenant Lippenslaan
662,Luitenant Lippenslaan 200,2023-08-06,00:00:00,17,9,8,FMN 15 Luitenant Lippenslaan
662,Luitenant Lippenslaan 200,2023-08-06,01:00:00,17,9,8,FMN 15 Luitenant Lippenslaan
662,Luitenant Lippenslaan 200,2023-08-06,02:00:00,11,6,5,FMN 15 Luitenant Lippenslaan
662,Luitenant Lippenslaan 200,2023-08-06,03:00:00,4,4,0,FMN 15 Luitenant Lippenslaan
662,Luitenant Lippenslaan 200,2023-08-06,04:00:00,1,0,1,FMN 15 Luitenant Lippenslaan
662,Luitenant Lippenslaan 200,2023-08-06,05:00:00,1,1,0,FMN 15 Luitenant Lippenslaan
662,Luitenant Lippenslaan 200,2023-08-06,06:00:00,14,12,2,FMN 15 Luitenant Lippenslaan
662,Luitenant Lippenslaan 200,2023-08-06,07:00:00,4,4,0,FMN 15 Luitenant Lippenslaan
662,Luitenant Lippenslaan 200,2023-08-06,08:00:00,11,11,0,FMN 15 Luitenant Lippenslaan
662,Luitenant Lippenslaan 200,2023-08-06,09:00:00,24,21,3,FMN 15 Luitenant Lippenslaan
662,Luitenant Lippenslaan 200,2023-08-06,10:00:00,34,34,0,FMN 15 Luitenant Lippenslaan
662,Luitenant Lippenslaan 200,2023-08-06,11:00:00,38,30,8,FMN 15 Luitenant Lippenslaan
662,Luitenant Lippenslaan 200,2023-08-06,12:00:00,29,28,1,FMN 15 Luitenant Lippenslaan
662,Luitenant Lippenslaan 200,2023-08-06,13:00:00,47,44,3,FMN 15 Luitenant Lippenslaan
662,Luitenant Lippenslaan 200,2023-08-06,14:00:00,42,37,5,FMN 15 Luitenant Lippenslaan
662,Luitenant Lippenslaan 200,2023-08-06,15:00:00,31,26,5,FMN 15 Luitenant Lippenslaan
662,Luitenant Lippenslaan 200,2023-08-06,16:00:00,33,25,8,FMN 15 Luitenant Lippenslaan
662,Luitenant Lippenslaan 200,2023-08-06,17:00:00,26,23,3,FMN 15 Luitenant Lippenslaan
662,Luitenant Lippenslaan 200,2023-08-06,18:00:00,23,18,5,FMN 15 Luitenant Lippenslaan
662,Luitenant Lippenslaan 200,2023-08-06,19:00:00,37,31,6,FMN 15 Luitenant Lippenslaan
662,Luitenant Lippenslaan 200,2023-08-06,20:00:00,37,32,5,FMN 15 Luitenant Lippenslaan
662,Luitenant Lippenslaan 200,2023-08-06,21:00:00,44,36,8,FMN 15 Luitenant Lippenslaan
662,Luitenant Lippenslaan 200,2023-08-06,22:00:00,22,16,6,FMN 15 Luitenant Lippenslaan
662,Luitenant Lippenslaan 200,2023-08-06,23:00:00,15,13,2,FMN 15 Luitenant Lippenslaan
662,Luitenant Lippenslaan 200,2023-08-07,00:00:00,9,5,4,FMN 15 Luitenant Lippenslaan
662,Luitenant Lippenslaan 200,2023-08-07,01:00:00,6,4,2,FMN 15 Luitenant Lippenslaan
662,Luitenant Lippenslaan 200,2023-08-07,02:00:00,9,3,6,FMN 15 Luitenant Lippenslaan
662,Luitenant Lippenslaan 200,2023-08-07,03:00:00,4,3,1,FMN 15 Luitenant Lippenslaan
662,Luitenant Lippenslaan 200,2023-08-07,04:00:00,10,10,0,FMN 15 Luitenant Lippenslaan
662,Luitenant Lippenslaan 200,2023-08-07,05:00:00,21,16,5,FMN 15 Luitenant Lippenslaan
662,Luitenant Lippenslaan 200,2023-08-07,06:00:00,44,36,8,FMN 15 Luitenant Lippenslaan
662,Luitenant Lippenslaan 200,2023-08-07,07:00:00,91,83,8,FMN 15 Luitenant Lippenslaan
662,Luitenant Lippenslaan 200,2023-08-07,08:00:00,183,172,11,FMN 15 Luitenant Lippenslaan
662,Luitenant Lippenslaan 200,2023-08-07,09:00:00,94,86,8,FMN 15 Luitenant Lippenslaan
662,Luitenant Lippenslaan 200,2023-08-07,10:00:00,64,62,2,FMN 15 Luitenant Lippenslaan
662,Luitenant Lippenslaan 200,2023-08-07,11:00:00,67,61,6,FMN 15 Luitenant Lippenslaan
662,Luitenant Lippenslaan 200,2023-08-07,12:00:00,89,79,10,FMN 15 Luitenant Lippenslaan
662,Luitenant Lippenslaan 200,2023-08-07,13:00:00,68,61,7,FMN 15 Luitenant Lippenslaan
662,Luitenant Lippenslaan 200,2023-08-07,14:00:00,78,73,5,FMN 15 Luitenant Lippenslaan
662,Luitenant Lippenslaan 200,2023-08-07,15:00:00,83,72,11,FMN 15 Luitenant Lippenslaan
662,Luitenant Lippenslaan 200,2023-08-07,16:00:00,116,104,12,FMN 15 Luitenant Lippenslaan
662,Luitenant Lippenslaan 200,2023-08-07,17:00:00,138,118,20,FMN 15 Luitenant Lippenslaan
662,Luitenant Lippenslaan 200,2023-08-07,18:00:00,102,80,22,FMN 15 Luitenant Lippenslaan
662,Luitenant Lippenslaan 200,2023-08-07,19:00:00,76,59,17,FMN 15 Luitenant Lippenslaan
662,Luitenant Lippenslaan 200,2023-08-07,20:00:00,59,51,8,FMN 15 Luitenant Lippenslaan
662,Luitenant Lippenslaan 200,2023-08-07,21:00:00,48,40,8,FMN 15 Luitenant Lippenslaan
662,Luitenant Lippenslaan 200,2023-08-07,22:00:00,49,35,14,FMN 15 Luitenant Lippenslaan
662,Luitenant Lippenslaan 200,2023-08-07,23:00:00,38,32,6,FMN 15 Luitenant Lippenslaan
662,Luitenant Lippenslaan 200,2023-08-08,00:00:00,17,15,2,FMN 15 Luitenant Lippenslaan
662,Luitenant Lippenslaan 200,2023-08-08,01:00:00,11,5,6,FMN 15 Luitenant Lippenslaan
662,Luitenant Lippenslaan 200,2023-08-08,02:00:00,12,9,3,FMN 15 Luitenant Lippenslaan
662,Luitenant Lippenslaan 200,2023-08-08,03:00:00,2,2,0,FMN 15 Luitenant Lippenslaan
662,Luitenant Lippenslaan 200,2023-08-08,04:00:00,10,10,0,FMN 15 Luitenant Lippenslaan
662,Luitenant Lippenslaan 200,2023-08-08,05:00:00,19,13,6,FMN 15 Luitenant Lippenslaan
662,Luitenant Lippenslaan 200,2023-08-08,06:00:00,48,41,7,FMN 15 Luitenant Lippenslaan
662,Luitenant Lippenslaan 200,2023-08-08,07:00:00,115,103,12,FMN 15 Luitenant Lippenslaan
662,Luitenant Lippenslaan 200,2023-08-08,08:00:00,210,193,17,FMN 15 Luitenant Lippenslaan
662,Luitenant Lippenslaan 200,2023-08-08,09:00:00,118,114,4,FMN 15 Luitenant Lippenslaan
662,Luitenant Lippenslaan 200,2023-08-08,10:00:00,54,49,5,FMN 15 Luitenant Lippenslaan
662,Luitenant Lippenslaan 200,2023-08-08,11:00:00,56,47,9,FMN 15 Luitenant Lippenslaan
662,Luitenant Lippenslaan 200,2023-08-08,12:00:00,86,78,8,FMN 15 Luitenant Lippenslaan
662,Luitenant Lippenslaan 200,2023-08-08,13:00:00,71,62,9,FMN 15 Luitenant Lippenslaan
662,Luitenant Lippenslaan 200,2023-08-08,14:00:00,61,53,8,FMN 15 Luitenant Lippenslaan
662,Luitenant Lippenslaan 200,2023-08-08,15:00:00,77,66,11,FMN 15 Luitenant Lippenslaan
662,Luitenant Lippenslaan 200,2023-08-08,16:00:00,94,83,11,FMN 15 Luitenant Lippenslaan
662,Luitenant Lippenslaan 200,2023-08-08,17:00:00,122,102,20,FMN 15 Luitenant Lippenslaan
662,Luitenant Lippenslaan 200,2023-08-08,18:00:00,88,76,12,FMN 15 Luitenant Lippenslaan
662,Luitenant Lippenslaan 200,2023-08-08,19:00:00,65,50,15,FMN 15 Luitenant Lippenslaan
662,Luitenant Lippenslaan 200,2023-08-08,20:00:00,47,31,16,FMN 15 Luitenant Lippenslaan
662,Luitenant Lippenslaan 200,2023-08-08,21:00:00,27,20,7,FMN 15 Luitenant Lippenslaan
662,Luitenant Lippenslaan 200,2023-08-08,22:00:00,27,22,5,FMN 15 Luitenant Lippenslaan
662,Luitenant Lippenslaan 200,2023-08-08,23:00:00,22,19,3,FMN 15 Luitenant Lippenslaan
662,Luitenant Lippenslaan 200,2023-08-09,00:00:00,16,13,3,FMN 15 Luitenant Lippenslaan
662,Luitenant Lippenslaan 200,2023-08-09,01:00:00,7,3,4,FMN 15 Luitenant Lippenslaan
662,Luitenant Lippenslaan 200,2023-08-09,02:00:00,4,3,1,FMN 15 Luitenant Lippenslaan
662,Luitenant Lippenslaan 200,2023-08-09,03:00:00,2,1,1,FMN 15 Luitenant Lippenslaan
662,Luitenant Lippenslaan 200,2023-08-09,04:00:00,15,11,4,FMN 15 Luitenant Lippenslaan
662,Luitenant Lippenslaan 200,2023-08-09,05:00:00,21,18,3,FMN 15 Luitenant Lippenslaan
662,Luitenant Lippenslaan 200,2023-08-09,06:00:00,53,47,6,FMN 15 Luitenant Lippenslaan
662,Luitenant Lippenslaan 200,2023-08-09,07:00:00,100,89,11,FMN 15 Luitenant Lippenslaan
662,Luitenant Lippenslaan 200,2023-08-09,08:00:00,165,151,14,FMN 15 Luitenant Lippenslaan
662,Luitenant Lippenslaan 200,2023-08-09,09:00:00,124,121,3,FMN 15 Luitenant Lippenslaan
662,Luitenant Lippenslaan 200,2023-08-09,10:00:00,85,82,3,FMN 15 Luitenant Lippenslaan
662,Luitenant Lippenslaan 200,2023-08-09,11:00:00,82,78,4,FMN 15 Luitenant Lippenslaan
662,Luitenant Lippenslaan 200,2023-08-09,12:00:00,81,70,11,FMN 15 Luitenant Lippenslaan
662,Luitenant Lippenslaan 200,2023-08-09,13:00:00,88,82,6,FMN 15 Luitenant Lippenslaan
662,Luitenant Lippenslaan 200,2023-08-09,14:00:00,81,75,6,FMN 15 Luitenant Lippenslaan
662,Luitenant Lippenslaan 200,2023-08-09,15:00:00,115,104,11,FMN 15 Luitenant Lippenslaan
662,Luitenant Lippenslaan 200,2023-08-09,16:00:00,117,102,15,FMN 15 Luitenant Lippenslaan
662,Luitenant Lippenslaan 200,2023-08-09,17:00:00,146,129,17,FMN 15 Luitenant Lippenslaan
662,Luitenant Lippenslaan 200,2023-08-09,18:00:00,110,90,20,FMN 15 Luitenant Lippenslaan
662,Luitenant Lippenslaan 200,2023-08-09,19:00:00,87,72,15,FMN 15 Luitenant Lippenslaan
662,Luitenant Lippenslaan 200,2023-08-09,20:00:00,68,62,6,FMN 15 Luitenant Lippenslaan
662,Luitenant Lippenslaan 200,2023-08-09,21:00:00,75,58,17,FMN 15 Luitenant Lippenslaan
662,Luitenant Lippenslaan 200,2023-08-09,22:00:00,59,42,17,FMN 15 Luitenant Lippenslaan
662,Luitenant Lippenslaan 200,2023-08-09,23:00:00,45,37,8,FMN 15 Luitenant Lippenslaan
662,Luitenant Lippenslaan 200,2023-08-10,00:00:00,26,21,5,FMN 15 Luitenant Lippenslaan
662,Luitenant Lippenslaan 200,2023-08-10,01:00:00,4,3,1,FMN 15 Luitenant Lippenslaan
662,Luitenant Lippenslaan 200,2023-08-10,02:00:00,8,4,4,FMN 15 Luitenant Lippenslaan
662,Luitenant Lippenslaan 200,2023-08-10,03:00:00,1,1,0,FMN 15 Luitenant Lippenslaan
662,Luitenant Lippenslaan 200,2023-08-10,04:00:00,6,5,1,FMN 15 Luitenant Lippenslaan
662,Luitenant Lippenslaan 200,2023-08-10,05:00:00,23,17,6,FMN 15 Luitenant Lippenslaan
662,Luitenant Lippenslaan 200,2023-08-10,06:00:00,58,46,12,FMN 15 Luitenant Lippenslaan
662,Luitenant Lippenslaan 200,2023-08-10,07:00:00,130,114,16,FMN 15 Luitenant Lippenslaan
662,Luitenant Lippenslaan 200,2023-08-10,08:00:00,211,200,11,FMN 15 Luitenant Lippenslaan
662,Luitenant Lippenslaan 200,2023-08-10,09:00:00,129,123,6,FMN 15 Luitenant Lippenslaan
662,Luitenant Lippenslaan 200,2023-08-10,10:00:00,98,95,3,FMN 15 Luitenant Lippenslaan
662,Luitenant Lippenslaan 200,2023-08-10,11:00:00,93,85,8,FMN 15 Luitenant Lippenslaan
662,Luitenant Lippenslaan 200,2023-08-10,12:00:00,114,104,10,FMN 15 Luitenant Lippenslaan
662,Luitenant Lippenslaan 200,2023-08-10,13:00:00,95,89,6,FMN 15 Luitenant Lippenslaan
662,Luitenant Lippenslaan 200,2023-08-10,14:00:00,85,80,5,FMN 15 Luitenant Lippenslaan
662,Luitenant Lippenslaan 200,2023-08-10,15:00:00,118,109,9,FMN 15 Luitenant Lippenslaan
662,Luitenant Lippenslaan 200,2023-08-10,16:00:00,143,125,18,FMN 15 Luitenant Lippenslaan
662,Luitenant Lippenslaan 200,2023-08-10,17:00:00,155,143,12,FMN 15 Luitenant Lippenslaan
662,Luitenant Lippenslaan 200,2023-08-10,18:00:00,123,108,15,FMN 15 Luitenant Lippenslaan
662,Luitenant Lippenslaan 200,2023-08-10,19:00:00,111,99,12,FMN 15 Luitenant Lippenslaan
662,Luitenant Lippenslaan 200,2023-08-10,20:00:00,72,57,15,FMN 15 Luitenant Lippenslaan
662,Luitenant Lippenslaan 200,2023-08-10,21:00:00,94,82,12,FMN 15 Luitenant Lippenslaan
662,Luitenant Lippenslaan 200,2023-08-10,22:00:00,62,54,8,FMN 15 Luitenant Lippenslaan
662,Luitenant Lippenslaan 200,2023-08-10,23:00:00,29,22,7,FMN 15 Luitenant Lippenslaan
662,Luitenant Lippenslaan 200,2023-08-11,00:00:00,27,19,8,FMN 15 Luitenant Lippenslaan
662,Luitenant Lippenslaan 200,2023-08-11,01:00:00,15,14,1,FMN 15 Luitenant Lippenslaan
662,Luitenant Lippenslaan 200,2023-08-11,02:00:00,4,2,2,FMN 15 Luitenant Lippenslaan
662,Luitenant Lippenslaan 200,2023-08-11,03:00:00,0,0,0,FMN 15 Luitenant Lippenslaan
662,Luitenant Lippenslaan 200,2023-08-11,04:00:00,10,9,1,FMN 15 Luitenant Lippenslaan
662,Luitenant Lippenslaan 200,2023-08-11,05:00:00,21,12,9,FMN 15 Luitenant Lippenslaan
662,Luitenant Lippenslaan 200,2023-08-11,06:00:00,51,45,6,FMN 15 Luitenant Lippenslaan
662,Luitenant Lippenslaan 200,2023-08-11,07:00:00,87,77,10,FMN 15 Luitenant Lippenslaan
662,Luitenant Lippenslaan 200,2023-08-11,08:00:00,173,168,5,FMN 15 Luitenant Lippenslaan
662,Luitenant Lippenslaan 200,2023-08-11,09:00:00,128,122,6,FMN 15 Luitenant Lippenslaan
662,Luitenant Lippenslaan 200,2023-08-11,10:00:00,91,89,2,FMN 15 Luitenant Lippenslaan
662,Luitenant Lippenslaan 200,2023-08-11,11:00:00,90,81,9,FMN 15 Luitenant Lippenslaan
662,Luitenant Lippenslaan 200,2023-08-11,12:00:00,98,89,9,FMN 15 Luitenant Lippenslaan
662,Luitenant Lippenslaan 200,2023-08-11,13:00:00,89,80,9,FMN 15 Luitenant Lippenslaan
662,Luitenant Lippenslaan 200,2023-08-11,14:00:00,104,90,14,FMN 15 Luitenant Lippenslaan
662,Luitenant Lippenslaan 200,2023-08-11,15:00:00,137,112,25,FMN 15 Luitenant Lippenslaan
662,Luitenant Lippenslaan 200,2023-08-11,16:00:00,121,111,10,FMN 15 Luitenant Lippenslaan
662,Luitenant Lippenslaan 200,2023-08-11,17:00:00,140,130,10,FMN 15 Luitenant Lippenslaan
662,Luitenant Lippenslaan 200,2023-08-11,18:00:00,149,137,12,FMN 15 Luitenant Lippenslaan
662,Luitenant Lippenslaan 200,2023-08-11,19:00:00,106,88,18,FMN 15 Luitenant Lippenslaan
662,Luitenant Lippenslaan 200,2023-08-11,20:00:00,89,72,17,FMN 15 Luitenant Lippenslaan
662,Luitenant Lippenslaan 200,2023-08-11,21:00:00,60,50,10,FMN 15 Luitenant Lippenslaan
662,Luitenant Lippenslaan 200,2023-08-11,22:00:00,55,44,11,FMN 15 Luitenant Lippenslaan
662,Luitenant Lippenslaan 200,2023-08-11,23:00:00,56,50,6,FMN 15 Luitenant Lippenslaan
662,Luitenant Lippenslaan 200,2023-08-12,00:00:00,42,29,13,FMN 15 Luitenant Lippenslaan
662,Luitenant Lippenslaan 200,2023-08-12,01:00:00,14,6,8,FMN 15 Luitenant Lippenslaan
662,Luitenant Lippenslaan 200,2023-08-12,02:00:00,10,6,4,FMN 15 Luitenant Lippenslaan
662,Luitenant Lippenslaan 200,2023-08-12,03:00:00,5,4,1,FMN 15 Luitenant Lippenslaan
662,Luitenant Lippenslaan 200,2023-08-12,04:00:00,8,3,5,FMN 15 Luitenant Lippenslaan
662,Luitenant Lippenslaan 200,2023-08-12,05:00:00,8,5,3,FMN 15 Luitenant Lippenslaan
662,Luitenant Lippenslaan 200,2023-08-12,06:00:00,11,10,1,FMN 15 Luitenant Lippenslaan
662,Luitenant Lippenslaan 200,2023-08-12,07:00:00,19,16,3,FMN 15 Luitenant Lippenslaan
662,Luitenant Lippenslaan 200,2023-08-12,08:00:00,19,16,3,FMN 15 Luitenant Lippenslaan
662,Luitenant Lippenslaan 200,2023-08-12,09:00:00,56,55,1,FMN 15 Luitenant Lippenslaan
662,Luitenant Lippenslaan 200,2023-08-12,10:00:00,72,67,5,FMN 15 Luitenant Lippenslaan
662,Luitenant Lippenslaan 200,2023-08-12,11:00:00,75,73,2,FMN 15 Luitenant Lippenslaan
662,Luitenant Lippenslaan 200,2023-08-12,12:00:00,105,99,6,FMN 15 Luitenant Lippenslaan
662,Luitenant Lippenslaan 200,2023-08-12,13:00:00,142,131,11,FMN 15 Luitenant Lippenslaan
662,Luitenant Lippenslaan 200,2023-08-12,14:00:00,121,117,4,FMN 15 Luitenant Lippenslaan
662,Luitenant Lippenslaan 200,2023-08-12,15:00:00,143,132,11,FMN 15 Luitenant Lippenslaan
662,Luitenant Lippenslaan 200,2023-08-12,16:00:00,71,60,11,FMN 15 Luitenant Lippenslaan
662,Luitenant Lippenslaan 200,2023-08-12,17:00:00,105,86,19,FMN 15 Luitenant Lippenslaan
662,Luitenant Lippenslaan 200,2023-08-12,18:00:00,100,79,21,FMN 15 Luitenant Lippenslaan
662,Luitenant Lippenslaan 200,2023-08-12,19:00:00,91,77,14,FMN 15 Luitenant Lippenslaan
662,Luitenant Lippenslaan 200,2023-08-12,20:00:00,69,58,11,FMN 15 Luitenant Lippenslaan
662,Luitenant Lippenslaan 200,2023-08-12,21:00:00,56,46,10,FMN 15 Luitenant Lippenslaan
662,Luitenant Lippenslaan 200,2023-08-12,22:00:00,53,38,15,FMN 15 Luitenant Lippenslaan
662,Luitenant Lippenslaan 200,2023-08-12,23:00:00,40,30,10,FMN 15 Luitenant Lippenslaan
662,Luitenant Lippenslaan 200,2023-08-13,00:00:00,22,18,4,FMN 15 Luitenant Lippenslaan
662,Luitenant Lippenslaan 200,2023-08-13,01:00:00,19,15,4,FMN 15 Luitenant Lippenslaan
662,Luitenant Lippenslaan 200,2023-08-13,02:00:00,8,1,7,FMN 15 Luitenant Lippenslaan
662,Luitenant Lippenslaan 200,2023-08-13,03:00:00,4,4,0,FMN 15 Luitenant Lippenslaan
662,Luitenant Lippenslaan 200,2023-08-13,04:00:00,9,5,4,FMN 15 Luitenant Lippenslaan
662,Luitenant Lippenslaan 200,2023-08-13,05:00:00,9,7,2,FMN 15 Luitenant Lippenslaan
662,Luitenant Lippenslaan 200,2023-08-13,06:00:00,11,11,0,FMN 15 Luitenant Lippenslaan
662,Luitenant Lippenslaan 200,2023-08-13,07:00:00,12,11,1,FMN 15 Luitenant Lippenslaan
662,Luitenant Lippenslaan 200,2023-08-13,08:00:00,22,19,3,FMN 15 Luitenant Lippenslaan
662,Luitenant Lippenslaan 200,2023-08-13,09:00:00,55,50,5,FMN 15 Luitenant Lippenslaan
662,Luitenant Lippenslaan 200,2023-08-13,10:00:00,64,63,1,FMN 15 Luitenant Lippenslaan
662,Luitenant Lippenslaan 200,2023-08-13,11:00:00,83,77,6,FMN 15 Luitenant Lippenslaan
662,Luitenant Lippenslaan 200,2023-08-13,12:00:00,89,79,10,FMN 15 Luitenant Lippenslaan
662,Luitenant Lippenslaan 200,2023-08-13,13:00:00,73,64,9,FMN 15 Luitenant Lippenslaan
662,Luitenant Lippenslaan 200,2023-08-13,14:00:00,88,75,13,FMN 15 Luitenant Lippenslaan
662,Luitenant Lippenslaan 200,2023-08-13,15:00:00,93,83,10,FMN 15 Luitenant Lippenslaan
662,Luitenant Lippenslaan 200,2023-08-13,16:00:00,101,83,18,FMN 15 Luitenant Lippenslaan
662,Luitenant Lippenslaan 200,2023-08-13,17:00:00,99,89,10,FMN 15 Luitenant Lippenslaan
662,Luitenant Lippenslaan 200,2023-08-13,18:00:00,88,78,10,FMN 15 Luitenant Lippenslaan
662,Luitenant Lippenslaan 200,2023-08-13,19:00:00,67,57,10,FMN 15 Luitenant Lippenslaan
662,Luitenant Lippenslaan 200,2023-08-13,20:00:00,60,56,4,FMN 15 Luitenant Lippenslaan
662,Luitenant Lippenslaan 200,2023-08-13,21:00:00,52,37,15,FMN 15 Luitenant Lippenslaan
662,Luitenant Lippenslaan 200,2023-08-13,22:00:00,29,18,11,FMN 15 Luitenant Lippenslaan
662,Luitenant Lippenslaan 200,2023-08-13,23:00:00,20,14,6,FMN 15 Luitenant Lippenslaan
662,Luitenant Lippenslaan 200,2023-08-14,00:00:00,6,4,2,FMN 15 Luitenant Lippenslaan
662,Luitenant Lippenslaan 200,2023-08-14,01:00:00,9,7,2,FMN 15 Luitenant Lippenslaan
662,Luitenant Lippenslaan 200,2023-08-14,02:00:00,6,3,3,FMN 15 Luitenant Lippenslaan
662,Luitenant Lippenslaan 200,2023-08-14,03:00:00,3,3,0,FMN 15 Luitenant Lippenslaan
662,Luitenant Lippenslaan 200,2023-08-14,04:00:00,10,8,2,FMN 15 Luitenant Lippenslaan
662,Luitenant Lippenslaan 200,2023-08-14,05:00:00,9,7,2,FMN 15 Luitenant Lippenslaan
662,Luitenant Lippenslaan 200,2023-08-14,06:00:00,44,36,8,FMN 15 Luitenant Lippenslaan
662,Luitenant Lippenslaan 200,2023-08-14,07:00:00,57,50,7,FMN 15 Luitenant Lippenslaan
662,Luitenant Lippenslaan 200,2023-08-14,08:00:00,104,99,5,FMN 15 Luitenant Lippenslaan
662,Luitenant Lippenslaan 200,2023-08-14,09:00:00,83,78,5,FMN 15 Luitenant Lippenslaan
662,Luitenant Lippenslaan 200,2023-08-14,10:00:00,94,87,7,FMN 15 Luitenant Lippenslaan
662,Luitenant Lippenslaan 200,2023-08-14,11:00:00,102,90,12,FMN 15 Luitenant Lippenslaan
662,Luitenant Lippenslaan 200,2023-08-14,12:00:00,88,83,5,FMN 15 Luitenant Lippenslaan
662,Luitenant Lippenslaan 200,2023-08-14,13:00:00,95,90,5,FMN 15 Luitenant Lippenslaan
662,Luitenant Lippenslaan 200,2023-08-14,14:00:00,90,80,10,FMN 15 Luitenant Lippenslaan
662,Luitenant Lippenslaan 200,2023-08-14,15:00:00,111,89,22,FMN 15 Luitenant Lippenslaan
662,Luitenant Lippenslaan 200,2023-08-14,16:00:00,107,92,15,FMN 15 Luitenant Lippenslaan
662,Luitenant Lippenslaan 200,2023-08-14,17:00:00,121,113,8,FMN 15 Luitenant Lippenslaan
662,Luitenant Lippenslaan 200,2023-08-14,18:00:00,113,99,14,FMN 15 Luitenant Lippenslaan
662,Luitenant Lippenslaan 200,2023-08-14,19:00:00,87,67,20,FMN 15 Luitenant Lippenslaan
662,Luitenant Lippenslaan 200,2023-08-14,20:00:00,69,64,5,FMN 15 Luitenant Lippenslaan
662,Luitenant Lippenslaan 200,2023-08-14,21:00:00,45,36,9,FMN 15 Luitenant Lippenslaan
662,Luitenant Lippenslaan 200,2023-08-14,22:00:00,47,36,11,FMN 15 Luitenant Lippenslaan
662,Luitenant Lippenslaan 200,2023-08-14,23:00:00,34,25,9,FMN 15 Luitenant Lippenslaan
662,Luitenant Lippenslaan 200,2023-08-15,00:00:00,0,0,0,FMN 15 Luitenant Lippenslaan
662,Luitenant Lippenslaan 200,2023-08-15,01:00:00,9,7,2,FMN 15 Luitenant Lippenslaan
662,Luitenant Lippenslaan 200,2023-08-15,02:00:00,7,6,1,FMN 15 Luitenant Lippenslaan
662,Luitenant Lippenslaan 200,2023-08-15,03:00:00,3,3,0,FMN 15 Luitenant Lippenslaan
662,Luitenant Lippenslaan 200,2023-08-15,04:00:00,3,2,1,FMN 15 Luitenant Lippenslaan
662,Luitenant Lippenslaan 200,2023-08-15,05:00:00,5,4,1,FMN 15 Luitenant Lippenslaan
662,Luitenant Lippenslaan 200,2023-08-15,06:00:00,14,13,1,FMN 15 Luitenant Lippenslaan
662,Luitenant Lippenslaan 200,2023-08-15,07:00:00,9,6,3,FMN 15 Luitenant Lippenslaan
662,Luitenant Lippenslaan 200,2023-08-15,08:00:00,37,36,1,FMN 15 Luitenant Lippenslaan
662,Luitenant Lippenslaan 200,2023-08-15,09:00:00,71,67,4,FMN 15 Luitenant Lippenslaan
662,Luitenant Lippenslaan 200,2023-08-15,10:00:00,111,102,9,FMN 15 Luitenant Lippenslaan
662,Luitenant Lippenslaan 200,2023-08-15,11:00:00,105,94,11,FMN 15 Luitenant Lippenslaan
662,Luitenant Lippenslaan 200,2023-08-15,12:00:00,114,109,5,FMN 15 Luitenant Lippenslaan
662,Luitenant Lippenslaan 200,2023-08-15,13:00:00,116,104,12,FMN 15 Luitenant Lippenslaan
662,Luitenant Lippenslaan 200,2023-08-15,14:00:00,121,104,17,FMN 15 Luitenant Lippenslaan
662,Luitenant Lippenslaan 200,2023-08-15,15:00:00,103,95,8,FMN 15 Luitenant Lippenslaan
662,Luitenant Lippenslaan 200,2023-08-15,16:00:00,106,97,9,FMN 15 Luitenant Lippenslaan
662,Luitenant Lippenslaan 200,2023-08-15,17:00:00,119,108,11,FMN 15 Luitenant Lippenslaan
662,Luitenant Lippenslaan 200,2023-08-15,18:00:00,84,74,10,FMN 15 Luitenant Lippenslaan
662,Luitenant Lippenslaan 200,2023-08-15,19:00:00,75,63,12,FMN 15 Luitenant Lippenslaan
662,Luitenant Lippenslaan 200,2023-08-15,20:00:00,86,73,13,FMN 15 Luitenant Lippenslaan
662,Luitenant Lippenslaan 200,2023-08-15,21:00:00,60,49,11,FMN 15 Luitenant Lippenslaan
662,Luitenant Lippenslaan 200,2023-08-15,22:00:00,30,25,5,FMN 15 Luitenant Lippenslaan
662,Luitenant Lippenslaan 200,2023-08-15,23:00:00,18,14,4,FMN 15 Luitenant Lippenslaan
662,Luitenant Lippenslaan 200,2023-08-16,00:00:00,14,10,4,FMN 15 Luitenant Lippenslaan
662,Luitenant Lippenslaan 200,2023-08-16,01:00:00,5,4,1,FMN 15 Luitenant Lippenslaan
662,Luitenant Lippenslaan 200,2023-08-16,02:00:00,3,1,2,FMN 15 Luitenant Lippenslaan
662,Luitenant Lippenslaan 200,2023-08-16,03:00:00,5,5,0,FMN 15 Luitenant Lippenslaan
662,Luitenant Lippenslaan 200,2023-08-16,04:00:00,12,9,3,FMN 15 Luitenant Lippenslaan
662,Luitenant Lippenslaan 200,2023-08-16,05:00:00,28,20,8,FMN 15 Luitenant Lippenslaan
662,Luitenant Lippenslaan 200,2023-08-16,06:00:00,72,63,9,FMN 15 Luitenant Lippenslaan
662,Luitenant Lippenslaan 200,2023-08-16,07:00:00,129,115,14,FMN 15 Luitenant Lippenslaan
662,Luitenant Lippenslaan 200,2023-08-16,08:00:00,240,227,13,FMN 15 Luitenant Lippenslaan
662,Luitenant Lippenslaan 200,2023-08-16,09:00:00,130,124,6,FMN 15 Luitenant Lippenslaan
662,Luitenant Lippenslaan 200,2023-08-16,10:00:00,75,70,5,FMN 15 Luitenant Lippenslaan
662,Luitenant Lippenslaan 200,2023-08-16,11:00:00,68,65,3,FMN 15 Luitenant Lippenslaan
662,Luitenant Lippenslaan 200,2023-08-16,12:00:00,95,86,9,FMN 15 Luitenant Lippenslaan
662,Luitenant Lippenslaan 200,2023-08-16,13:00:00,81,76,5,FMN 15 Luitenant Lippenslaan
662,Luitenant Lippenslaan 200,2023-08-16,14:00:00,117,108,9,FMN 15 Luitenant Lippenslaan
662,Luitenant Lippenslaan 200,2023-08-16,15:00:00,98,90,8,FMN 15 Luitenant Lippenslaan
662,Luitenant Lippenslaan 200,2023-08-16,16:00:00,117,97,20,FMN 15 Luitenant Lippenslaan
662,Luitenant Lippenslaan 200,2023-08-16,17:00:00,131,113,18,FMN 15 Luitenant Lippenslaan
662,Luitenant Lippenslaan 200,2023-08-16,18:00:00,129,110,19,FMN 15 Luitenant Lippenslaan
662,Luitenant Lippenslaan 200,2023-08-16,19:00:00,94,81,13,FMN 15 Luitenant Lippenslaan
662,Luitenant Lippenslaan 200,2023-08-16,20:00:00,82,78,4,FMN 15 Luitenant Lippenslaan
662,Luitenant Lippenslaan 200,2023-08-16,21:00:00,49,34,15,FMN 15 Luitenant Lippenslaan
662,Luitenant Lippenslaan 200,2023-08-16,22:00:00,48,34,14,FMN 15 Luitenant Lippenslaan
662,Luitenant Lippenslaan 200,2023-08-16,23:00:00,28,21,7,FMN 15 Luitenant Lippenslaan
662,Luitenant Lippenslaan 200,2023-08-17,00:00:00,18,11,7,FMN 15 Luitenant Lippenslaan
662,Luitenant Lippenslaan 200,2023-08-17,01:00:00,11,7,4,FMN 15 Luitenant Lippenslaan
662,Luitenant Lippenslaan 200,2023-08-17,02:00:00,6,5,1,FMN 15 Luitenant Lippenslaan
662,Luitenant Lippenslaan 200,2023-08-17,03:00:00,2,2,0,FMN 15 Luitenant Lippenslaan
662,Luitenant Lippenslaan 200,2023-08-17,04:00:00,9,7,2,FMN 15 Luitenant Lippenslaan
662,Luitenant Lippenslaan 200,2023-08-17,05:00:00,24,17,7,FMN 15 Luitenant Lippenslaan
662,Luitenant Lippenslaan 200,2023-08-17,06:00:00,50,44,6,FMN 15 Luitenant Lippenslaan
662,Luitenant Lippenslaan 200,2023-08-17,07:00:00,136,121,15,FMN 15 Luitenant Lippenslaan
662,Luitenant Lippenslaan 200,2023-08-17,08:00:00,271,258,13,FMN 15 Luitenant Lippenslaan
662,Luitenant Lippenslaan 200,2023-08-17,09:00:00,138,132,6,FMN 15 Luitenant Lippenslaan
662,Luitenant Lippenslaan 200,2023-08-17,10:00:00,82,80,2,FMN 15 Luitenant Lippenslaan
662,Luitenant Lippenslaan 200,2023-08-17,11:00:00,95,83,12,FMN 15 Luitenant Lippenslaan
662,Luitenant Lippenslaan 200,2023-08-17,12:00:00,91,77,14,FMN 15 Luitenant Lippenslaan
662,Luitenant Lippenslaan 200,2023-08-17,13:00:00,121,110,11,FMN 15 Luitenant Lippenslaan
662,Luitenant Lippenslaan 200,2023-08-17,14:00:00,94,83,11,FMN 15 Luitenant Lippenslaan
662,Luitenant Lippenslaan 200,2023-08-17,15:00:00,84,72,12,FMN 15 Luitenant Lippenslaan
662,Luitenant Lippenslaan 200,2023-08-17,16:00:00,102,85,17,FMN 15 Luitenant Lippenslaan
662,Luitenant Lippenslaan 200,2023-08-17,17:00:00,146,135,11,FMN 15 Luitenant Lippenslaan
662,Luitenant Lippenslaan 200,2023-08-17,18:00:00,134,115,19,FMN 15 Luitenant Lippenslaan
662,Luitenant Lippenslaan 200,2023-08-17,19:00:00,95,79,16,FMN 15 Luitenant Lippenslaan
662,Luitenant Lippenslaan 200,2023-08-17,20:00:00,77,66,11,FMN 15 Luitenant Lippenslaan
662,Luitenant Lippenslaan 200,2023-08-17,21:00:00,46,33,13,FMN 15 Luitenant Lippenslaan
662,Luitenant Lippenslaan 200,2023-08-17,22:00:00,44,35,9,FMN 15 Luitenant Lippenslaan
662,Luitenant Lippenslaan 200,2023-08-17,23:00:00,26,20,6,FMN 15 Luitenant Lippenslaan
662,Luitenant Lippenslaan 200,2023-08-18,00:00:00,16,12,4,FMN 15 Luitenant Lippenslaan
662,Luitenant Lippenslaan 200,2023-08-18,01:00:00,12,5,7,FMN 15 Luitenant Lippenslaan
662,Luitenant Lippenslaan 200,2023-08-18,02:00:00,5,4,1,FMN 15 Luitenant Lippenslaan
662,Luitenant Lippenslaan 200,2023-08-18,03:00:00,2,0,2,FMN 15 Luitenant Lippenslaan
662,Luitenant Lippenslaan 200,2023-08-18,04:00:00,11,7,4,FMN 15 Luitenant Lippenslaan
662,Luitenant Lippenslaan 200,2023-08-18,05:00:00,24,16,8,FMN 15 Luitenant Lippenslaan
662,Luitenant Lippenslaan 200,2023-08-18,06:00:00,55,46,9,FMN 15 Luitenant Lippenslaan
662,Luitenant Lippenslaan 200,2023-08-18,07:00:00,102,89,13,FMN 15 Luitenant Lippenslaan
662,Luitenant Lippenslaan 200,2023-08-18,08:00:00,203,187,16,FMN 15 Luitenant Lippenslaan
662,Luitenant Lippenslaan 200,2023-08-18,09:00:00,101,94,7,FMN 15 Luitenant Lippenslaan
662,Luitenant Lippenslaan 200,2023-08-18,10:00:00,97,89,8,FMN 15 Luitenant Lippenslaan
662,Luitenant Lippenslaan 200,2023-08-18,11:00:00,80,68,12,FMN 15 Luitenant Lippenslaan
662,Luitenant Lippenslaan 200,2023-08-18,12:00:00,72,66,6,FMN 15 Luitenant Lippenslaan
662,Luitenant Lippenslaan 200,2023-08-18,13:00:00,82,79,3,FMN 15 Luitenant Lippenslaan
662,Luitenant Lippenslaan 200,2023-08-18,14:00:00,97,86,11,FMN 15 Luitenant Lippenslaan
662,Luitenant Lippenslaan 200,2023-08-18,15:00:00,136,118,18,FMN 15 Luitenant Lippenslaan
662,Luitenant Lippenslaan 200,2023-08-18,16:00:00,162,143,19,FMN 15 Luitenant Lippenslaan
662,Luitenant Lippenslaan 200,2023-08-18,17:00:00,164,143,21,FMN 15 Luitenant Lippenslaan
662,Luitenant Lippenslaan 200,2023-08-18,18:00:00,162,145,17,FMN 15 Luitenant Lippenslaan
662,Luitenant Lippenslaan 200,2023-08-18,19:00:00,112,92,20,FMN 15 Luitenant Lippenslaan
662,Luitenant Lippenslaan 200,2023-08-18,20:00:00,125,107,18,FMN 15 Luitenant Lippenslaan
662,Luitenant Lippenslaan 200,2023-08-18,21:00:00,86,70,16,FMN 15 Luitenant Lippenslaan
662,Luitenant Lippenslaan 200,2023-08-18,22:00:00,47,37,10,FMN 15 Luitenant Lippenslaan
662,Luitenant Lippenslaan 200,2023-08-18,23:00:00,48,43,5,FMN 15 Luitenant Lippenslaan
662,Luitenant Lippenslaan 200,2023-08-19,00:00:00,33,23,10,FMN 15 Luitenant Lippenslaan
662,Luitenant Lippenslaan 200,2023-08-19,01:00:00,23,15,8,FMN 15 Luitenant Lippenslaan
662,Luitenant Lippenslaan 200,2023-08-19,02:00:00,9,6,3,FMN 15 Luitenant Lippenslaan
662,Luitenant Lippenslaan 200,2023-08-19,03:00:00,7,5,2,FMN 15 Luitenant Lippenslaan
662,Luitenant Lippenslaan 200,2023-08-19,04:00:00,8,7,1,FMN 15 Luitenant Lippenslaan
662,Luitenant Lippenslaan 200,2023-08-19,05:00:00,13,10,3,FMN 15 Luitenant Lippenslaan
662,Luitenant Lippenslaan 200,2023-08-19,06:00:00,15,13,2,FMN 15 Luitenant Lippenslaan
662,Luitenant Lippenslaan 200,2023-08-19,07:00:00,22,19,3,FMN 15 Luitenant Lippenslaan
662,Luitenant Lippenslaan 200,2023-08-19,08:00:00,31,27,4,FMN 15 Luitenant Lippenslaan
662,Luitenant Lippenslaan 200,2023-08-19,09:00:00,91,87,4,FMN 15 Luitenant Lippenslaan
662,Luitenant Lippenslaan 200,2023-08-19,10:00:00,99,94,5,FMN 15 Luitenant Lippenslaan
662,Luitenant Lippenslaan 200,2023-08-19,11:00:00,92,85,7,FMN 15 Luitenant Lippenslaan
662,Luitenant Lippenslaan 200,2023-08-19,12:00:00,89,79,10,FMN 15 Luitenant Lippenslaan
662,Luitenant Lippenslaan 200,2023-08-19,13:00:00,104,92,12,FMN 15 Luitenant Lippenslaan
662,Luitenant Lippenslaan 200,2023-08-19,14:00:00,119,105,14,FMN 15 Luitenant Lippenslaan
662,Luitenant Lippenslaan 200,2023-08-19,15:00:00,106,94,12,FMN 15 Luitenant Lippenslaan
662,Luitenant Lippenslaan 200,2023-08-19,16:00:00,106,92,14,FMN 15 Luitenant Lippenslaan
662,Luitenant Lippenslaan 200,2023-08-19,17:00:00,99,87,12,FMN 15 Luitenant Lippenslaan
662,Luitenant Lippenslaan 200,2023-08-19,18:00:00,98,80,18,FMN 15 Luitenant Lippenslaan
662,Luitenant Lippenslaan 200,2023-08-19,19:00:00,116,100,16,FMN 15 Luitenant Lippenslaan
662,Luitenant Lippenslaan 200,2023-08-19,20:00:00,85,75,10,FMN 15 Luitenant Lippenslaan
662,Luitenant Lippenslaan 200,2023-08-19,21:00:00,67,56,11,FMN 15 Luitenant Lippenslaan
662,Luitenant Lippenslaan 200,2023-08-19,22:00:00,39,30,9,FMN 15 Luitenant Lippenslaan
662,Luitenant Lippenslaan 200,2023-08-19,23:00:00,30,23,7,FMN 15 Luitenant Lippenslaan
662,Luitenant Lippenslaan 200,2023-08-20,00:00:00,22,17,5,FMN 15 Luitenant Lippenslaan
662,Luitenant Lippenslaan 200,2023-08-20,01:00:00,22,16,6,FMN 15 Luitenant Lippenslaan
662,Luitenant Lippenslaan 200,2023-08-20,02:00:00,7,4,3,FMN 15 Luitenant Lippenslaan
662,Luitenant Lippenslaan 200,2023-08-20,03:00:00,16,9,7,FMN 15 Luitenant Lippenslaan
662,Luitenant Lippenslaan 200,2023-08-20,04:00:00,9,7,2,FMN 15 Luitenant Lippenslaan
662,Luitenant Lippenslaan 200,2023-08-20,05:00:00,12,11,1,FMN 15 Luitenant Lippenslaan
662,Luitenant Lippenslaan 200,2023-08-20,06:00:00,24,22,2,FMN 15 Luitenant Lippenslaan
662,Luitenant Lippenslaan 200,2023-08-20,07:00:00,20,20,0,FMN 15 Luitenant Lippenslaan
662,Luitenant Lippenslaan 200,2023-08-20,08:00:00,27,23,4,FMN 15 Luitenant Lippenslaan
662,Luitenant Lippenslaan 200,2023-08-20,09:00:00,61,56,5,FMN 15 Luitenant Lippenslaan
662,Luitenant Lippenslaan 200,2023-08-20,10:00:00,79,75,4,FMN 15 Luitenant Lippenslaan
662,Luitenant Lippenslaan 200,2023-08-20,11:00:00,99,94,5,FMN 15 Luitenant Lippenslaan
662,Luitenant Lippenslaan 200,2023-08-20,12:00:00,98,92,6,FMN 15 Luitenant Lippenslaan
662,Luitenant Lippenslaan 200,2023-08-20,13:00:00,136,125,11,FMN 15 Luitenant Lippenslaan
662,Luitenant Lippenslaan 200,2023-08-20,14:00:00,91,86,5,FMN 15 Luitenant Lippenslaan
662,Luitenant Lippenslaan 200,2023-08-20,15:00:00,114,104,10,FMN 15 Luitenant Lippenslaan
662,Luitenant Lippenslaan 200,2023-08-20,16:00:00,124,114,10,FMN 15 Luitenant Lippenslaan
662,Luitenant Lippenslaan 200,2023-08-20,17:00:00,123,105,18,FMN 15 Luitenant Lippenslaan
662,Luitenant Lippenslaan 200,2023-08-20,18:00:00,134,113,21,FMN 15 Luitenant Lippenslaan
662,Luitenant Lippenslaan 200,2023-08-20,19:00:00,97,78,19,FMN 15 Luitenant Lippenslaan
662,Luitenant Lippenslaan 200,2023-08-20,20:00:00,71,57,14,FMN 15 Luitenant Lippenslaan
662,Luitenant Lippenslaan 200,2023-08-20,21:00:00,59,47,12,FMN 15 Luitenant Lippenslaan
662,Luitenant Lippenslaan 200,2023-08-20,22:00:00,52,41,11,FMN 15 Luitenant Lippenslaan
662,Luitenant Lippenslaan 200,2023-08-20,23:00:00,43,32,11,FMN 15 Luitenant Lippenslaan
662,Luitenant Lippenslaan 200,2023-08-21,00:00:00,10,9,1,FMN 15 Luitenant Lippenslaan
662,Luitenant Lippenslaan 200,2023-08-21,01:00:00,8,5,3,FMN 15 Luitenant Lippenslaan
662,Luitenant Lippenslaan 200,2023-08-21,02:00:00,4,2,2,FMN 15 Luitenant Lippenslaan
662,Luitenant Lippenslaan 200,2023-08-21,03:00:00,3,3,0,FMN 15 Luitenant Lippenslaan
662,Luitenant Lippenslaan 200,2023-08-21,04:00:00,12,12,0,FMN 15 Luitenant Lippenslaan
662,Luitenant Lippenslaan 200,2023-08-21,05:00:00,30,25,5,FMN 15 Luitenant Lippenslaan
662,Luitenant Lippenslaan 200,2023-08-21,06:00:00,74,69,5,FMN 15 Luitenant Lippenslaan
662,Luitenant Lippenslaan 200,2023-08-21,07:00:00,156,148,8,FMN 15 Luitenant Lippenslaan
662,Luitenant Lippenslaan 200,2023-08-21,08:00:00,289,287,2,FMN 15 Luitenant Lippenslaan
662,Luitenant Lippenslaan 200,2023-08-21,09:00:00,163,155,8,FMN 15 Luitenant Lippenslaan
662,Luitenant Lippenslaan 200,2023-08-21,10:00:00,98,93,5,FMN 15 Luitenant Lippenslaan
662,Luitenant Lippenslaan 200,2023-08-21,11:00:00,78,72,6,FMN 15 Luitenant Lippenslaan
662,Luitenant Lippenslaan 200,2023-08-21,12:00:00,99,90,9,FMN 15 Luitenant Lippenslaan
662,Luitenant Lippenslaan 200,2023-08-21,13:00:00,97,90,7,FMN 15 Luitenant Lippenslaan
662,Luitenant Lippenslaan 200,2023-08-21,14:00:00,108,91,17,FMN 15 Luitenant Lippenslaan
662,Luitenant Lippenslaan 200,2023-08-21,15:00:00,97,81,16,FMN 15 Luitenant Lippenslaan
662,Luitenant Lippenslaan 200,2023-08-21,16:00:00,146,132,14,FMN 15 Luitenant Lippenslaan
662,Luitenant Lippenslaan 200,2023-08-21,17:00:00,169,151,18,FMN 15 Luitenant Lippenslaan
662,Luitenant Lippenslaan 200,2023-08-21,18:00:00,165,146,19,FMN 15 Luitenant Lippenslaan
662,Luitenant Lippenslaan 200,2023-08-21,19:00:00,101,86,15,FMN 15 Luitenant Lippenslaan
662,Luitenant Lippenslaan 200,2023-08-21,20:00:00,95,82,13,FMN 15 Luitenant Lippenslaan
662,Luitenant Lippenslaan 200,2023-08-21,21:00:00,66,56,10,FMN 15 Luitenant Lippenslaan
662,Luitenant Lippenslaan 200,2023-08-21,22:00:00,61,49,12,FMN 15 Luitenant Lippenslaan
662,Luitenant Lippenslaan 200,2023-08-21,23:00:00,28,19,9,FMN 15 Luitenant Lippenslaan
662,Luitenant Lippenslaan 200,2023-08-22,00:00:00,15,14,1,FMN 15 Luitenant Lippenslaan
662,Luitenant Lippenslaan 200,2023-08-22,01:00:00,9,7,2,FMN 15 Luitenant Lippenslaan
662,Luitenant Lippenslaan 200,2023-08-22,02:00:00,7,2,5,FMN 15 Luitenant Lippenslaan
662,Luitenant Lippenslaan 200,2023-08-22,03:00:00,2,0,2,FMN 15 Luitenant Lippenslaan
662,Luitenant Lippenslaan 200,2023-08-22,04:00:00,9,8,1,FMN 15 Luitenant Lippenslaan
662,Luitenant Lippenslaan 200,2023-08-22,05:00:00,25,24,1,FMN 15 Luitenant Lippenslaan
662,Luitenant Lippenslaan 200,2023-08-22,06:00:00,80,73,7,FMN 15 Luitenant Lippenslaan
662,Luitenant Lippenslaan 200,2023-08-22,07:00:00,166,157,9,FMN 15 Luitenant Lippenslaan
662,Luitenant Lippenslaan 200,2023-08-22,08:00:00,368,357,11,FMN 15 Luitenant Lippenslaan
662,Luitenant Lippenslaan 200,2023-08-22,09:00:00,184,178,6,FMN 15 Luitenant Lippenslaan
662,Luitenant Lippenslaan 200,2023-08-22,10:00:00,131,127,4,FMN 15 Luitenant Lippenslaan
662,Luitenant Lippenslaan 200,2023-08-22,11:00:00,92,84,8,FMN 15 Luitenant Lippenslaan
662,Luitenant Lippenslaan 200,2023-08-22,12:00:00,106,99,7,FMN 15 Luitenant Lippenslaan
662,Luitenant Lippenslaan 200,2023-08-22,13:00:00,95,83,12,FMN 15 Luitenant Lippenslaan
662,Luitenant Lippenslaan 200,2023-08-22,14:00:00,94,79,15,FMN 15 Luitenant Lippenslaan
662,Luitenant Lippenslaan 200,2023-08-22,15:00:00,126,105,21,FMN 15 Luitenant Lippenslaan
662,Luitenant Lippenslaan 200,2023-08-22,16:00:00,151,134,17,FMN 15 Luitenant Lippenslaan
662,Luitenant Lippenslaan 200,2023-08-22,17:00:00,169,152,17,FMN 15 Luitenant Lippenslaan
662,Luitenant Lippenslaan 200,2023-08-22,18:00:00,165,148,17,FMN 15 Luitenant Lippenslaan
662,Luitenant Lippenslaan 200,2023-08-22,19:00:00,118,105,13,FMN 15 Luitenant Lippenslaan
662,Luitenant Lippenslaan 200,2023-08-22,20:00:00,114,101,13,FMN 15 Luitenant Lippenslaan
662,Luitenant Lippenslaan 200,2023-08-22,21:00:00,63,45,18,FMN 15 Luitenant Lippenslaan
662,Luitenant Lippenslaan 200,2023-08-22,22:00:00,66,53,13,FMN 15 Luitenant Lippenslaan
662,Luitenant Lippenslaan 200,2023-08-22,23:00:00,63,54,9,FMN 15 Luitenant Lippenslaan
662,Luitenant Lippenslaan 200,2023-08-23,00:00:00,32,26,6,FMN 15 Luitenant Lippenslaan
662,Luitenant Lippenslaan 200,2023-08-23,01:00:00,14,10,4,FMN 15 Luitenant Lippenslaan
662,Luitenant Lippenslaan 200,2023-08-23,02:00:00,5,2,3,FMN 15 Luitenant Lippenslaan
662,Luitenant Lippenslaan 200,2023-08-23,03:00:00,3,3,0,FMN 15 Luitenant Lippenslaan
662,Luitenant Lippenslaan 200,2023-08-23,04:00:00,8,8,0,FMN 15 Luitenant Lippenslaan
662,Luitenant Lippenslaan 200,2023-08-23,05:00:00,31,27,4,FMN 15 Luitenant Lippenslaan
662,Luitenant Lippenslaan 200,2023-08-23,06:00:00,69,62,7,FMN 15 Luitenant Lippenslaan
662,Luitenant Lippenslaan 200,2023-08-23,07:00:00,164,159,5,FMN 15 Luitenant Lippenslaan
662,Luitenant Lippenslaan 200,2023-08-23,08:00:00,297,283,14,FMN 15 Luitenant Lippenslaan
662,Luitenant Lippenslaan 200,2023-08-23,09:00:00,167,164,3,FMN 15 Luitenant Lippenslaan
662,Luitenant Lippenslaan 200,2023-08-23,10:00:00,87,80,7,FMN 15 Luitenant Lippenslaan
662,Luitenant Lippenslaan 200,2023-08-23,11:00:00,112,107,5,FMN 15 Luitenant Lippenslaan
662,Luitenant Lippenslaan 200,2023-08-23,12:00:00,138,130,8,FMN 15 Luitenant Lippenslaan
662,Luitenant Lippenslaan 200,2023-08-23,13:00:00,109,96,13,FMN 15 Luitenant Lippenslaan
662,Luitenant Lippenslaan 200,2023-08-23,14:00:00,107,98,9,FMN 15 Luitenant Lippenslaan
662,Luitenant Lippenslaan 200,2023-08-23,15:00:00,100,93,7,FMN 15 Luitenant Lippenslaan
662,Luitenant Lippenslaan 200,2023-08-23,16:00:00,122,110,12,FMN 15 Luitenant Lippenslaan
662,Luitenant Lippenslaan 200,2023-08-23,17:00:00,103,88,15,FMN 15 Luitenant Lippenslaan
662,Luitenant Lippenslaan 200,2023-08-23,18:00:00,0,0,0,FMN 15 Luitenant Lippenslaan
662,Luitenant Lippenslaan 200,2023-08-23,19:00:00,0,0,0,FMN 15 Luitenant Lippenslaan
662,Luitenant Lippenslaan 200,2023-08-23,20:00:00,0,0,0,FMN 15 Luitenant Lippenslaan
662,Luitenant Lippenslaan 200,2023-08-23,21:00:00,0,0,0,FMN 15 Luitenant Lippenslaan
662,Luitenant Lippenslaan 200,2023-08-23,22:00:00,0,0,0,FMN 15 Luitenant Lippenslaan
662,Luitenant Lippenslaan 200,2023-08-23,23:00:00,0,0,0,FMN 15 Luitenant Lippenslaan
