Meetpunt surrogate key,Meetpunt locatie,Datum,Tijd,Aantal fietsers,Aantal fietsers van,Aantal fietsers naar,Meetpunt code
649,Ernest Van Dijckkaai,2022-08-22,00:00:00,46,13,33,FMN 01 Ernest Van Dijckkaai
649,Ernest Van Dijckkaai,2022-08-22,01:00:00,23,7,16,FMN 01 Ernest Van Dijckkaai
649,Ernest Van Dijckkaai,2022-08-22,02:00:00,21,5,16,FMN 01 Ernest Van Dijckkaai
649,Ernest Van Dijckkaai,2022-08-22,03:00:00,24,6,18,FMN 01 Ernest Van Dijckkaai
649,Ernest Van Dijckkaai,2022-08-22,04:00:00,60,41,19,FMN 01 Ernest Van Dijckkaai
649,Ernest Van Dijckkaai,2022-08-22,05:00:00,108,64,44,FMN 01 Ernest Van Dijckkaai
649,Ernest Van Dijckkaai,2022-08-22,06:00:00,264,173,91,FMN 01 Ernest Van Dijckkaai
649,Ernest Van Dijckkaai,2022-08-22,07:00:00,354,213,141,FMN 01 Ernest Van Dijckkaai
649,Ernest Van Dijckkaai,2022-08-22,08:00:00,434,269,165,FMN 01 Ernest Van Dijckkaai
649,Ernest Van Dijckkaai,2022-08-22,09:00:00,300,180,120,FMN 01 Ernest Van Dijckkaai
649,Ernest Van Dijckkaai,2022-08-22,10:00:00,163,100,63,FMN 01 Ernest Van Dijckkaai
649,Ernest Van Dijckkaai,2022-08-22,11:00:00,234,130,104,FMN 01 Ernest Van Dijckkaai
649,Ernest Van Dijckkaai,2022-08-22,12:00:00,309,176,133,FMN 01 Ernest Van Dijckkaai
649,Ernest Van Dijckkaai,2022-08-22,13:00:00,326,195,131,FMN 01 Ernest Van Dijckkaai
649,Ernest Van Dijckkaai,2022-08-22,14:00:00,415,211,204,FMN 01 Ernest Van Dijckkaai
649,Ernest Van Dijckkaai,2022-08-22,15:00:00,409,197,212,FMN 01 Ernest Van Dijckkaai
649,Ernest Van Dijckkaai,2022-08-22,16:00:00,609,244,365,FMN 01 Ernest Van Dijckkaai
649,Ernest Van Dijckkaai,2022-08-22,17:00:00,706,310,396,FMN 01 Ernest Van Dijckkaai
649,Ernest Van Dijckkaai,2022-08-22,18:00:00,435,205,230,FMN 01 Ernest Van Dijckkaai
649,Ernest Van Dijckkaai,2022-08-22,19:00:00,386,171,215,FMN 01 Ernest Van Dijckkaai
649,Ernest Van Dijckkaai,2022-08-22,20:00:00,316,167,149,FMN 01 Ernest Van Dijckkaai
649,Ernest Van Dijckkaai,2022-08-22,21:00:00,272,128,144,FMN 01 Ernest Van Dijckkaai
649,Ernest Van Dijckkaai,2022-08-22,22:00:00,291,106,185,FMN 01 Ernest Van Dijckkaai
649,Ernest Van Dijckkaai,2022-08-22,23:00:00,79,33,46,FMN 01 Ernest Van Dijckkaai
649,Ernest Van Dijckkaai,2022-08-23,00:00:00,40,15,25,FMN 01 Ernest Van Dijckkaai
649,Ernest Van Dijckkaai,2022-08-23,01:00:00,26,6,20,FMN 01 Ernest Van Dijckkaai
649,Ernest Van Dijckkaai,2022-08-23,02:00:00,15,5,10,FMN 01 Ernest Van Dijckkaai
649,Ernest Van Dijckkaai,2022-08-23,03:00:00,11,6,5,FMN 01 Ernest Van Dijckkaai
649,Ernest Van Dijckkaai,2022-08-23,04:00:00,70,45,25,FMN 01 Ernest Van Dijckkaai
649,Ernest Van Dijckkaai,2022-08-23,05:00:00,128,85,43,FMN 01 Ernest Van Dijckkaai
649,Ernest Van Dijckkaai,2022-08-23,06:00:00,310,189,121,FMN 01 Ernest Van Dijckkaai
649,Ernest Van Dijckkaai,2022-08-23,07:00:00,461,280,181,FMN 01 Ernest Van Dijckkaai
649,Ernest Van Dijckkaai,2022-08-23,08:00:00,533,338,195,FMN 01 Ernest Van Dijckkaai
649,Ernest Van Dijckkaai,2022-08-23,09:00:00,349,190,159,FMN 01 Ernest Van Dijckkaai
649,Ernest Van Dijckkaai,2022-08-23,10:00:00,265,144,121,FMN 01 Ernest Van Dijckkaai
649,Ernest Van Dijckkaai,2022-08-23,11:00:00,277,146,131,FMN 01 Ernest Van Dijckkaai
649,Ernest Van Dijckkaai,2022-08-23,12:00:00,330,178,152,FMN 01 Ernest Van Dijckkaai
649,Ernest Van Dijckkaai,2022-08-23,13:00:00,406,240,166,FMN 01 Ernest Van Dijckkaai
649,Ernest Van Dijckkaai,2022-08-23,14:00:00,459,224,235,FMN 01 Ernest Van Dijckkaai
649,Ernest Van Dijckkaai,2022-08-23,15:00:00,439,224,215,FMN 01 Ernest Van Dijckkaai
649,Ernest Van Dijckkaai,2022-08-23,16:00:00,701,292,409,FMN 01 Ernest Van Dijckkaai
649,Ernest Van Dijckkaai,2022-08-23,17:00:00,804,344,460,FMN 01 Ernest Van Dijckkaai
649,Ernest Van Dijckkaai,2022-08-23,18:00:00,625,332,293,FMN 01 Ernest Van Dijckkaai
649,Ernest Van Dijckkaai,2022-08-23,19:00:00,394,208,186,FMN 01 Ernest Van Dijckkaai
649,Ernest Van Dijckkaai,2022-08-23,20:00:00,354,154,200,FMN 01 Ernest Van Dijckkaai
649,Ernest Van Dijckkaai,2022-08-23,21:00:00,262,137,125,FMN 01 Ernest Van Dijckkaai
649,Ernest Van Dijckkaai,2022-08-23,22:00:00,288,94,194,FMN 01 Ernest Van Dijckkaai
649,Ernest Van Dijckkaai,2022-08-23,23:00:00,166,66,100,FMN 01 Ernest Van Dijckkaai
649,Ernest Van Dijckkaai,2022-08-24,00:00:00,84,30,54,FMN 01 Ernest Van Dijckkaai
649,Ernest Van Dijckkaai,2022-08-24,01:00:00,32,8,24,FMN 01 Ernest Van Dijckkaai
649,Ernest Van Dijckkaai,2022-08-24,02:00:00,33,8,25,FMN 01 Ernest Van Dijckkaai
649,Ernest Van Dijckkaai,2022-08-24,03:00:00,9,2,7,FMN 01 Ernest Van Dijckkaai
649,Ernest Van Dijckkaai,2022-08-24,04:00:00,67,47,20,FMN 01 Ernest Van Dijckkaai
649,Ernest Van Dijckkaai,2022-08-24,05:00:00,143,90,53,FMN 01 Ernest Van Dijckkaai
649,Ernest Van Dijckkaai,2022-08-24,06:00:00,309,182,127,FMN 01 Ernest Van Dijckkaai
649,Ernest Van Dijckkaai,2022-08-24,07:00:00,419,267,152,FMN 01 Ernest Van Dijckkaai
649,Ernest Van Dijckkaai,2022-08-24,08:00:00,549,344,205,FMN 01 Ernest Van Dijckkaai
649,Ernest Van Dijckkaai,2022-08-24,09:00:00,315,185,130,FMN 01 Ernest Van Dijckkaai
649,Ernest Van Dijckkaai,2022-08-24,10:00:00,290,160,130,FMN 01 Ernest Van Dijckkaai
649,Ernest Van Dijckkaai,2022-08-24,11:00:00,314,167,147,FMN 01 Ernest Van Dijckkaai
649,Ernest Van Dijckkaai,2022-08-24,12:00:00,436,223,213,FMN 01 Ernest Van Dijckkaai
649,Ernest Van Dijckkaai,2022-08-24,13:00:00,390,212,178,FMN 01 Ernest Van Dijckkaai
649,Ernest Van Dijckkaai,2022-08-24,14:00:00,502,260,242,FMN 01 Ernest Van Dijckkaai
649,Ernest Van Dijckkaai,2022-08-24,15:00:00,483,251,232,FMN 01 Ernest Van Dijckkaai
649,Ernest Van Dijckkaai,2022-08-24,16:00:00,692,278,414,FMN 01 Ernest Van Dijckkaai
649,Ernest Van Dijckkaai,2022-08-24,17:00:00,805,353,452,FMN 01 Ernest Van Dijckkaai
649,Ernest Van Dijckkaai,2022-08-24,18:00:00,570,264,306,FMN 01 Ernest Van Dijckkaai
649,Ernest Van Dijckkaai,2022-08-24,19:00:00,379,194,185,FMN 01 Ernest Van Dijckkaai
649,Ernest Van Dijckkaai,2022-08-24,20:00:00,370,201,169,FMN 01 Ernest Van Dijckkaai
649,Ernest Van Dijckkaai,2022-08-24,21:00:00,353,205,148,FMN 01 Ernest Van Dijckkaai
649,Ernest Van Dijckkaai,2022-08-24,22:00:00,291,120,171,FMN 01 Ernest Van Dijckkaai
649,Ernest Van Dijckkaai,2022-08-24,23:00:00,170,72,98,FMN 01 Ernest Van Dijckkaai
649,Ernest Van Dijckkaai,2022-08-25,00:00:00,122,36,86,FMN 01 Ernest Van Dijckkaai
649,Ernest Van Dijckkaai,2022-08-25,01:00:00,67,17,50,FMN 01 Ernest Van Dijckkaai
649,Ernest Van Dijckkaai,2022-08-25,02:00:00,20,11,9,FMN 01 Ernest Van Dijckkaai
649,Ernest Van Dijckkaai,2022-08-25,03:00:00,21,5,16,FMN 01 Ernest Van Dijckkaai
649,Ernest Van Dijckkaai,2022-08-25,04:00:00,77,51,26,FMN 01 Ernest Van Dijckkaai
649,Ernest Van Dijckkaai,2022-08-25,05:00:00,144,90,54,FMN 01 Ernest Van Dijckkaai
649,Ernest Van Dijckkaai,2022-08-25,06:00:00,283,171,112,FMN 01 Ernest Van Dijckkaai
649,Ernest Van Dijckkaai,2022-08-25,07:00:00,413,250,163,FMN 01 Ernest Van Dijckkaai
649,Ernest Van Dijckkaai,2022-08-25,08:00:00,560,329,231,FMN 01 Ernest Van Dijckkaai
649,Ernest Van Dijckkaai,2022-08-25,09:00:00,387,206,181,FMN 01 Ernest Van Dijckkaai
649,Ernest Van Dijckkaai,2022-08-25,10:00:00,283,138,145,FMN 01 Ernest Van Dijckkaai
649,Ernest Van Dijckkaai,2022-08-25,11:00:00,335,191,144,FMN 01 Ernest Van Dijckkaai
649,Ernest Van Dijckkaai,2022-08-25,12:00:00,389,228,161,FMN 01 Ernest Van Dijckkaai
649,Ernest Van Dijckkaai,2022-08-25,13:00:00,448,244,204,FMN 01 Ernest Van Dijckkaai
649,Ernest Van Dijckkaai,2022-08-25,14:00:00,441,222,219,FMN 01 Ernest Van Dijckkaai
649,Ernest Van Dijckkaai,2022-08-25,15:00:00,488,259,229,FMN 01 Ernest Van Dijckkaai
649,Ernest Van Dijckkaai,2022-08-25,16:00:00,753,351,402,FMN 01 Ernest Van Dijckkaai
649,Ernest Van Dijckkaai,2022-08-25,17:00:00,763,368,395,FMN 01 Ernest Van Dijckkaai
649,Ernest Van Dijckkaai,2022-08-25,18:00:00,605,296,309,FMN 01 Ernest Van Dijckkaai
649,Ernest Van Dijckkaai,2022-08-25,19:00:00,451,210,241,FMN 01 Ernest Van Dijckkaai
649,Ernest Van Dijckkaai,2022-08-25,20:00:00,382,198,184,FMN 01 Ernest Van Dijckkaai
649,Ernest Van Dijckkaai,2022-08-25,21:00:00,300,139,161,FMN 01 Ernest Van Dijckkaai
649,Ernest Van Dijckkaai,2022-08-25,22:00:00,244,98,146,FMN 01 Ernest Van Dijckkaai
649,Ernest Van Dijckkaai,2022-08-25,23:00:00,187,65,122,FMN 01 Ernest Van Dijckkaai
649,Ernest Van Dijckkaai,2022-08-26,00:00:00,121,51,70,FMN 01 Ernest Van Dijckkaai
649,Ernest Van Dijckkaai,2022-08-26,01:00:00,57,25,32,FMN 01 Ernest Van Dijckkaai
649,Ernest Van Dijckkaai,2022-08-26,02:00:00,27,7,20,FMN 01 Ernest Van Dijckkaai
649,Ernest Van Dijckkaai,2022-08-26,03:00:00,46,9,37,FMN 01 Ernest Van Dijckkaai
649,Ernest Van Dijckkaai,2022-08-26,04:00:00,70,36,34,FMN 01 Ernest Van Dijckkaai
649,Ernest Van Dijckkaai,2022-08-26,05:00:00,121,83,38,FMN 01 Ernest Van Dijckkaai
649,Ernest Van Dijckkaai,2022-08-26,06:00:00,244,140,104,FMN 01 Ernest Van Dijckkaai
649,Ernest Van Dijckkaai,2022-08-26,07:00:00,275,162,113,FMN 01 Ernest Van Dijckkaai
649,Ernest Van Dijckkaai,2022-08-26,08:00:00,421,246,175,FMN 01 Ernest Van Dijckkaai
649,Ernest Van Dijckkaai,2022-08-26,09:00:00,269,149,120,FMN 01 Ernest Van Dijckkaai
649,Ernest Van Dijckkaai,2022-08-26,10:00:00,234,148,86,FMN 01 Ernest Van Dijckkaai
649,Ernest Van Dijckkaai,2022-08-26,11:00:00,226,122,104,FMN 01 Ernest Van Dijckkaai
649,Ernest Van Dijckkaai,2022-08-26,12:00:00,340,170,170,FMN 01 Ernest Van Dijckkaai
649,Ernest Van Dijckkaai,2022-08-26,13:00:00,279,165,114,FMN 01 Ernest Van Dijckkaai
649,Ernest Van Dijckkaai,2022-08-26,14:00:00,328,127,201,FMN 01 Ernest Van Dijckkaai
649,Ernest Van Dijckkaai,2022-08-26,15:00:00,388,197,191,FMN 01 Ernest Van Dijckkaai
649,Ernest Van Dijckkaai,2022-08-26,16:00:00,540,251,289,FMN 01 Ernest Van Dijckkaai
649,Ernest Van Dijckkaai,2022-08-26,17:00:00,574,274,300,FMN 01 Ernest Van Dijckkaai
649,Ernest Van Dijckkaai,2022-08-26,18:00:00,467,239,228,FMN 01 Ernest Van Dijckkaai
649,Ernest Van Dijckkaai,2022-08-26,19:00:00,396,205,191,FMN 01 Ernest Van Dijckkaai
649,Ernest Van Dijckkaai,2022-08-26,20:00:00,324,141,183,FMN 01 Ernest Van Dijckkaai
649,Ernest Van Dijckkaai,2022-08-26,21:00:00,284,172,112,FMN 01 Ernest Van Dijckkaai
649,Ernest Van Dijckkaai,2022-08-26,22:00:00,276,121,155,FMN 01 Ernest Van Dijckkaai
649,Ernest Van Dijckkaai,2022-08-26,23:00:00,197,68,129,FMN 01 Ernest Van Dijckkaai
649,Ernest Van Dijckkaai,2022-08-27,00:00:00,174,48,126,FMN 01 Ernest Van Dijckkaai
649,Ernest Van Dijckkaai,2022-08-27,01:00:00,71,18,53,FMN 01 Ernest Van Dijckkaai
649,Ernest Van Dijckkaai,2022-08-27,02:00:00,64,21,43,FMN 01 Ernest Van Dijckkaai
649,Ernest Van Dijckkaai,2022-08-27,03:00:00,57,12,45,FMN 01 Ernest Van Dijckkaai
649,Ernest Van Dijckkaai,2022-08-27,04:00:00,63,41,22,FMN 01 Ernest Van Dijckkaai
649,Ernest Van Dijckkaai,2022-08-27,05:00:00,57,22,35,FMN 01 Ernest Van Dijckkaai
649,Ernest Van Dijckkaai,2022-08-27,06:00:00,71,27,44,FMN 01 Ernest Van Dijckkaai
649,Ernest Van Dijckkaai,2022-08-27,07:00:00,49,26,23,FMN 01 Ernest Van Dijckkaai
649,Ernest Van Dijckkaai,2022-08-27,08:00:00,99,61,38,FMN 01 Ernest Van Dijckkaai
649,Ernest Van Dijckkaai,2022-08-27,09:00:00,202,113,89,FMN 01 Ernest Van Dijckkaai
649,Ernest Van Dijckkaai,2022-08-27,10:00:00,269,171,98,FMN 01 Ernest Van Dijckkaai
649,Ernest Van Dijckkaai,2022-08-27,11:00:00,372,219,153,FMN 01 Ernest Van Dijckkaai
649,Ernest Van Dijckkaai,2022-08-27,12:00:00,448,231,217,FMN 01 Ernest Van Dijckkaai
649,Ernest Van Dijckkaai,2022-08-27,13:00:00,396,222,174,FMN 01 Ernest Van Dijckkaai
649,Ernest Van Dijckkaai,2022-08-27,14:00:00,474,230,244,FMN 01 Ernest Van Dijckkaai
649,Ernest Van Dijckkaai,2022-08-27,15:00:00,519,262,257,FMN 01 Ernest Van Dijckkaai
649,Ernest Van Dijckkaai,2022-08-27,16:00:00,480,240,240,FMN 01 Ernest Van Dijckkaai
649,Ernest Van Dijckkaai,2022-08-27,17:00:00,438,215,223,FMN 01 Ernest Van Dijckkaai
649,Ernest Van Dijckkaai,2022-08-27,18:00:00,385,178,207,FMN 01 Ernest Van Dijckkaai
649,Ernest Van Dijckkaai,2022-08-27,19:00:00,367,177,190,FMN 01 Ernest Van Dijckkaai
649,Ernest Van Dijckkaai,2022-08-27,20:00:00,284,142,142,FMN 01 Ernest Van Dijckkaai
649,Ernest Van Dijckkaai,2022-08-27,21:00:00,260,184,76,FMN 01 Ernest Van Dijckkaai
649,Ernest Van Dijckkaai,2022-08-27,22:00:00,210,100,110,FMN 01 Ernest Van Dijckkaai
649,Ernest Van Dijckkaai,2022-08-27,23:00:00,165,54,111,FMN 01 Ernest Van Dijckkaai
649,Ernest Van Dijckkaai,2022-08-28,00:00:00,166,41,125,FMN 01 Ernest Van Dijckkaai
649,Ernest Van Dijckkaai,2022-08-28,01:00:00,88,42,46,FMN 01 Ernest Van Dijckkaai
649,Ernest Van Dijckkaai,2022-08-28,02:00:00,66,21,45,FMN 01 Ernest Van Dijckkaai
649,Ernest Van Dijckkaai,2022-08-28,03:00:00,37,12,25,FMN 01 Ernest Van Dijckkaai
649,Ernest Van Dijckkaai,2022-08-28,04:00:00,48,13,35,FMN 01 Ernest Van Dijckkaai
649,Ernest Van Dijckkaai,2022-08-28,05:00:00,34,19,15,FMN 01 Ernest Van Dijckkaai
649,Ernest Van Dijckkaai,2022-08-28,06:00:00,44,20,24,FMN 01 Ernest Van Dijckkaai
649,Ernest Van Dijckkaai,2022-08-28,07:00:00,39,13,26,FMN 01 Ernest Van Dijckkaai
649,Ernest Van Dijckkaai,2022-08-28,08:00:00,84,53,31,FMN 01 Ernest Van Dijckkaai
649,Ernest Van Dijckkaai,2022-08-28,09:00:00,181,123,58,FMN 01 Ernest Van Dijckkaai
649,Ernest Van Dijckkaai,2022-08-28,10:00:00,340,203,137,FMN 01 Ernest Van Dijckkaai
649,Ernest Van Dijckkaai,2022-08-28,11:00:00,356,204,152,FMN 01 Ernest Van Dijckkaai
649,Ernest Van Dijckkaai,2022-08-28,12:00:00,414,205,209,FMN 01 Ernest Van Dijckkaai
649,Ernest Van Dijckkaai,2022-08-28,13:00:00,560,277,283,FMN 01 Ernest Van Dijckkaai
649,Ernest Van Dijckkaai,2022-08-28,14:00:00,752,375,377,FMN 01 Ernest Van Dijckkaai
649,Ernest Van Dijckkaai,2022-08-28,15:00:00,634,332,302,FMN 01 Ernest Van Dijckkaai
649,Ernest Van Dijckkaai,2022-08-28,16:00:00,635,291,344,FMN 01 Ernest Van Dijckkaai
649,Ernest Van Dijckkaai,2022-08-28,17:00:00,510,235,275,FMN 01 Ernest Van Dijckkaai
649,Ernest Van Dijckkaai,2022-08-28,18:00:00,448,182,266,FMN 01 Ernest Van Dijckkaai
649,Ernest Van Dijckkaai,2022-08-28,19:00:00,347,136,211,FMN 01 Ernest Van Dijckkaai
649,Ernest Van Dijckkaai,2022-08-28,20:00:00,254,111,143,FMN 01 Ernest Van Dijckkaai
649,Ernest Van Dijckkaai,2022-08-28,21:00:00,192,82,110,FMN 01 Ernest Van Dijckkaai
649,Ernest Van Dijckkaai,2022-08-28,22:00:00,150,77,73,FMN 01 Ernest Van Dijckkaai
649,Ernest Van Dijckkaai,2022-08-28,23:00:00,86,37,49,FMN 01 Ernest Van Dijckkaai
649,Ernest Van Dijckkaai,2022-08-29,00:00:00,40,17,23,FMN 01 Ernest Van Dijckkaai
649,Ernest Van Dijckkaai,2022-08-29,01:00:00,19,6,13,FMN 01 Ernest Van Dijckkaai
649,Ernest Van Dijckkaai,2022-08-29,02:00:00,19,12,7,FMN 01 Ernest Van Dijckkaai
649,Ernest Van Dijckkaai,2022-08-29,03:00:00,12,5,7,FMN 01 Ernest Van Dijckkaai
649,Ernest Van Dijckkaai,2022-08-29,04:00:00,69,43,26,FMN 01 Ernest Van Dijckkaai
649,Ernest Van Dijckkaai,2022-08-29,05:00:00,130,91,39,FMN 01 Ernest Van Dijckkaai
649,Ernest Van Dijckkaai,2022-08-29,06:00:00,254,160,94,FMN 01 Ernest Van Dijckkaai
649,Ernest Van Dijckkaai,2022-08-29,07:00:00,372,227,145,FMN 01 Ernest Van Dijckkaai
649,Ernest Van Dijckkaai,2022-08-29,08:00:00,508,315,193,FMN 01 Ernest Van Dijckkaai
649,Ernest Van Dijckkaai,2022-08-29,09:00:00,282,171,111,FMN 01 Ernest Van Dijckkaai
649,Ernest Van Dijckkaai,2022-08-29,10:00:00,208,108,100,FMN 01 Ernest Van Dijckkaai
649,Ernest Van Dijckkaai,2022-08-29,11:00:00,188,107,81,FMN 01 Ernest Van Dijckkaai
649,Ernest Van Dijckkaai,2022-08-29,12:00:00,281,164,117,FMN 01 Ernest Van Dijckkaai
649,Ernest Van Dijckkaai,2022-08-29,13:00:00,313,171,142,FMN 01 Ernest Van Dijckkaai
649,Ernest Van Dijckkaai,2022-08-29,14:00:00,382,181,201,FMN 01 Ernest Van Dijckkaai
649,Ernest Van Dijckkaai,2022-08-29,15:00:00,452,200,252,FMN 01 Ernest Van Dijckkaai
649,Ernest Van Dijckkaai,2022-08-29,16:00:00,640,283,357,FMN 01 Ernest Van Dijckkaai
649,Ernest Van Dijckkaai,2022-08-29,17:00:00,758,332,426,FMN 01 Ernest Van Dijckkaai
649,Ernest Van Dijckkaai,2022-08-29,18:00:00,542,257,285,FMN 01 Ernest Van Dijckkaai
649,Ernest Van Dijckkaai,2022-08-29,19:00:00,295,150,145,FMN 01 Ernest Van Dijckkaai
649,Ernest Van Dijckkaai,2022-08-29,20:00:00,277,132,145,FMN 01 Ernest Van Dijckkaai
649,Ernest Van Dijckkaai,2022-08-29,21:00:00,206,83,123,FMN 01 Ernest Van Dijckkaai
649,Ernest Van Dijckkaai,2022-08-29,22:00:00,199,87,112,FMN 01 Ernest Van Dijckkaai
649,Ernest Van Dijckkaai,2022-08-29,23:00:00,76,26,50,FMN 01 Ernest Van Dijckkaai
649,Ernest Van Dijckkaai,2022-08-30,00:00:00,37,9,28,FMN 01 Ernest Van Dijckkaai
649,Ernest Van Dijckkaai,2022-08-30,01:00:00,20,4,16,FMN 01 Ernest Van Dijckkaai
649,Ernest Van Dijckkaai,2022-08-30,02:00:00,16,4,12,FMN 01 Ernest Van Dijckkaai
649,Ernest Van Dijckkaai,2022-08-30,03:00:00,6,2,4,FMN 01 Ernest Van Dijckkaai
649,Ernest Van Dijckkaai,2022-08-30,04:00:00,70,42,28,FMN 01 Ernest Van Dijckkaai
649,Ernest Van Dijckkaai,2022-08-30,05:00:00,136,97,39,FMN 01 Ernest Van Dijckkaai
649,Ernest Van Dijckkaai,2022-08-30,06:00:00,305,193,112,FMN 01 Ernest Van Dijckkaai
649,Ernest Van Dijckkaai,2022-08-30,07:00:00,466,281,185,FMN 01 Ernest Van Dijckkaai
649,Ernest Van Dijckkaai,2022-08-30,08:00:00,626,380,246,FMN 01 Ernest Van Dijckkaai
649,Ernest Van Dijckkaai,2022-08-30,09:00:00,353,225,128,FMN 01 Ernest Van Dijckkaai
649,Ernest Van Dijckkaai,2022-08-30,10:00:00,235,132,103,FMN 01 Ernest Van Dijckkaai
649,Ernest Van Dijckkaai,2022-08-30,11:00:00,280,164,116,FMN 01 Ernest Van Dijckkaai
649,Ernest Van Dijckkaai,2022-08-30,12:00:00,347,201,146,FMN 01 Ernest Van Dijckkaai
649,Ernest Van Dijckkaai,2022-08-30,13:00:00,329,167,162,FMN 01 Ernest Van Dijckkaai
649,Ernest Van Dijckkaai,2022-08-30,14:00:00,427,196,231,FMN 01 Ernest Van Dijckkaai
649,Ernest Van Dijckkaai,2022-08-30,15:00:00,491,241,250,FMN 01 Ernest Van Dijckkaai
649,Ernest Van Dijckkaai,2022-08-30,16:00:00,719,334,385,FMN 01 Ernest Van Dijckkaai
649,Ernest Van Dijckkaai,2022-08-30,17:00:00,831,373,458,FMN 01 Ernest Van Dijckkaai
649,Ernest Van Dijckkaai,2022-08-30,18:00:00,559,263,296,FMN 01 Ernest Van Dijckkaai
649,Ernest Van Dijckkaai,2022-08-30,19:00:00,381,208,173,FMN 01 Ernest Van Dijckkaai
649,Ernest Van Dijckkaai,2022-08-30,20:00:00,291,147,144,FMN 01 Ernest Van Dijckkaai
649,Ernest Van Dijckkaai,2022-08-30,21:00:00,227,99,128,FMN 01 Ernest Van Dijckkaai
649,Ernest Van Dijckkaai,2022-08-30,22:00:00,215,71,144,FMN 01 Ernest Van Dijckkaai
649,Ernest Van Dijckkaai,2022-08-30,23:00:00,129,43,86,FMN 01 Ernest Van Dijckkaai
649,Ernest Van Dijckkaai,2022-08-31,00:00:00,61,24,37,FMN 01 Ernest Van Dijckkaai
649,Ernest Van Dijckkaai,2022-08-31,01:00:00,41,17,24,FMN 01 Ernest Van Dijckkaai
649,Ernest Van Dijckkaai,2022-08-31,02:00:00,20,3,17,FMN 01 Ernest Van Dijckkaai
649,Ernest Van Dijckkaai,2022-08-31,03:00:00,22,7,15,FMN 01 Ernest Van Dijckkaai
649,Ernest Van Dijckkaai,2022-08-31,04:00:00,83,50,33,FMN 01 Ernest Van Dijckkaai
649,Ernest Van Dijckkaai,2022-08-31,05:00:00,129,89,40,FMN 01 Ernest Van Dijckkaai
649,Ernest Van Dijckkaai,2022-08-31,06:00:00,303,201,102,FMN 01 Ernest Van Dijckkaai
649,Ernest Van Dijckkaai,2022-08-31,07:00:00,399,252,147,FMN 01 Ernest Van Dijckkaai
649,Ernest Van Dijckkaai,2022-08-31,08:00:00,535,330,205,FMN 01 Ernest Van Dijckkaai
649,Ernest Van Dijckkaai,2022-08-31,09:00:00,302,178,124,FMN 01 Ernest Van Dijckkaai
649,Ernest Van Dijckkaai,2022-08-31,10:00:00,215,120,95,FMN 01 Ernest Van Dijckkaai
649,Ernest Van Dijckkaai,2022-08-31,11:00:00,262,149,113,FMN 01 Ernest Van Dijckkaai
649,Ernest Van Dijckkaai,2022-08-31,12:00:00,348,197,151,FMN 01 Ernest Van Dijckkaai
649,Ernest Van Dijckkaai,2022-08-31,13:00:00,374,200,174,FMN 01 Ernest Van Dijckkaai
649,Ernest Van Dijckkaai,2022-08-31,14:00:00,427,196,231,FMN 01 Ernest Van Dijckkaai
649,Ernest Van Dijckkaai,2022-08-31,15:00:00,467,216,251,FMN 01 Ernest Van Dijckkaai
649,Ernest Van Dijckkaai,2022-08-31,16:00:00,640,289,351,FMN 01 Ernest Van Dijckkaai
649,Ernest Van Dijckkaai,2022-08-31,17:00:00,749,296,453,FMN 01 Ernest Van Dijckkaai
649,Ernest Van Dijckkaai,2022-08-31,18:00:00,538,255,283,FMN 01 Ernest Van Dijckkaai
649,Ernest Van Dijckkaai,2022-08-31,19:00:00,355,176,179,FMN 01 Ernest Van Dijckkaai
649,Ernest Van Dijckkaai,2022-08-31,20:00:00,302,128,174,FMN 01 Ernest Van Dijckkaai
649,Ernest Van Dijckkaai,2022-08-31,21:00:00,204,106,98,FMN 01 Ernest Van Dijckkaai
649,Ernest Van Dijckkaai,2022-08-31,22:00:00,203,69,134,FMN 01 Ernest Van Dijckkaai
649,Ernest Van Dijckkaai,2022-08-31,23:00:00,105,35,70,FMN 01 Ernest Van Dijckkaai
649,Ernest Van Dijckkaai,2022-09-01,00:00:00,52,24,28,FMN 01 Ernest Van Dijckkaai
649,Ernest Van Dijckkaai,2022-09-01,01:00:00,23,2,21,FMN 01 Ernest Van Dijckkaai
649,Ernest Van Dijckkaai,2022-09-01,02:00:00,16,5,11,FMN 01 Ernest Van Dijckkaai
649,Ernest Van Dijckkaai,2022-09-01,03:00:00,10,1,9,FMN 01 Ernest Van Dijckkaai
649,Ernest Van Dijckkaai,2022-09-01,04:00:00,72,42,30,FMN 01 Ernest Van Dijckkaai
649,Ernest Van Dijckkaai,2022-09-01,05:00:00,146,102,44,FMN 01 Ernest Van Dijckkaai
649,Ernest Van Dijckkaai,2022-09-01,06:00:00,277,170,107,FMN 01 Ernest Van Dijckkaai
649,Ernest Van Dijckkaai,2022-09-01,07:00:00,469,288,181,FMN 01 Ernest Van Dijckkaai
649,Ernest Van Dijckkaai,2022-09-01,08:00:00,662,401,261,FMN 01 Ernest Van Dijckkaai
649,Ernest Van Dijckkaai,2022-09-01,09:00:00,414,253,161,FMN 01 Ernest Van Dijckkaai
649,Ernest Van Dijckkaai,2022-09-01,10:00:00,270,154,116,FMN 01 Ernest Van Dijckkaai
649,Ernest Van Dijckkaai,2022-09-01,11:00:00,276,138,138,FMN 01 Ernest Van Dijckkaai
649,Ernest Van Dijckkaai,2022-09-01,12:00:00,428,220,208,FMN 01 Ernest Van Dijckkaai
649,Ernest Van Dijckkaai,2022-09-01,13:00:00,348,187,161,FMN 01 Ernest Van Dijckkaai
649,Ernest Van Dijckkaai,2022-09-01,14:00:00,467,231,236,FMN 01 Ernest Van Dijckkaai
649,Ernest Van Dijckkaai,2022-09-01,15:00:00,546,276,270,FMN 01 Ernest Van Dijckkaai
649,Ernest Van Dijckkaai,2022-09-01,16:00:00,721,299,422,FMN 01 Ernest Van Dijckkaai
649,Ernest Van Dijckkaai,2022-09-01,17:00:00,780,345,435,FMN 01 Ernest Van Dijckkaai
649,Ernest Van Dijckkaai,2022-09-01,18:00:00,605,298,307,FMN 01 Ernest Van Dijckkaai
649,Ernest Van Dijckkaai,2022-09-01,19:00:00,409,194,215,FMN 01 Ernest Van Dijckkaai
649,Ernest Van Dijckkaai,2022-09-01,20:00:00,359,166,193,FMN 01 Ernest Van Dijckkaai
649,Ernest Van Dijckkaai,2022-09-01,21:00:00,257,107,150,FMN 01 Ernest Van Dijckkaai
649,Ernest Van Dijckkaai,2022-09-01,22:00:00,243,95,148,FMN 01 Ernest Van Dijckkaai
649,Ernest Van Dijckkaai,2022-09-01,23:00:00,136,53,83,FMN 01 Ernest Van Dijckkaai
649,Ernest Van Dijckkaai,2022-09-02,00:00:00,84,33,51,FMN 01 Ernest Van Dijckkaai
649,Ernest Van Dijckkaai,2022-09-02,01:00:00,30,14,16,FMN 01 Ernest Van Dijckkaai
649,Ernest Van Dijckkaai,2022-09-02,02:00:00,34,7,27,FMN 01 Ernest Van Dijckkaai
649,Ernest Van Dijckkaai,2022-09-02,03:00:00,31,9,22,FMN 01 Ernest Van Dijckkaai
649,Ernest Van Dijckkaai,2022-09-02,04:00:00,93,47,46,FMN 01 Ernest Van Dijckkaai
649,Ernest Van Dijckkaai,2022-09-02,05:00:00,147,91,56,FMN 01 Ernest Van Dijckkaai
649,Ernest Van Dijckkaai,2022-09-02,06:00:00,264,161,103,FMN 01 Ernest Van Dijckkaai
649,Ernest Van Dijckkaai,2022-09-02,07:00:00,468,286,182,FMN 01 Ernest Van Dijckkaai
649,Ernest Van Dijckkaai,2022-09-02,08:00:00,579,354,225,FMN 01 Ernest Van Dijckkaai
649,Ernest Van Dijckkaai,2022-09-02,09:00:00,288,187,101,FMN 01 Ernest Van Dijckkaai
649,Ernest Van Dijckkaai,2022-09-02,10:00:00,283,140,143,FMN 01 Ernest Van Dijckkaai
649,Ernest Van Dijckkaai,2022-09-02,11:00:00,239,131,108,FMN 01 Ernest Van Dijckkaai
649,Ernest Van Dijckkaai,2022-09-02,12:00:00,392,205,187,FMN 01 Ernest Van Dijckkaai
649,Ernest Van Dijckkaai,2022-09-02,13:00:00,401,212,189,FMN 01 Ernest Van Dijckkaai
649,Ernest Van Dijckkaai,2022-09-02,14:00:00,487,232,255,FMN 01 Ernest Van Dijckkaai
649,Ernest Van Dijckkaai,2022-09-02,15:00:00,558,233,325,FMN 01 Ernest Van Dijckkaai
649,Ernest Van Dijckkaai,2022-09-02,16:00:00,677,287,390,FMN 01 Ernest Van Dijckkaai
649,Ernest Van Dijckkaai,2022-09-02,17:00:00,696,311,385,FMN 01 Ernest Van Dijckkaai
649,Ernest Van Dijckkaai,2022-09-02,18:00:00,477,216,261,FMN 01 Ernest Van Dijckkaai
649,Ernest Van Dijckkaai,2022-09-02,19:00:00,425,233,192,FMN 01 Ernest Van Dijckkaai
649,Ernest Van Dijckkaai,2022-09-02,20:00:00,369,184,185,FMN 01 Ernest Van Dijckkaai
649,Ernest Van Dijckkaai,2022-09-02,21:00:00,289,163,126,FMN 01 Ernest Van Dijckkaai
649,Ernest Van Dijckkaai,2022-09-02,22:00:00,259,113,146,FMN 01 Ernest Van Dijckkaai
649,Ernest Van Dijckkaai,2022-09-02,23:00:00,235,78,157,FMN 01 Ernest Van Dijckkaai
649,Ernest Van Dijckkaai,2022-09-03,00:00:00,122,38,84,FMN 01 Ernest Van Dijckkaai
649,Ernest Van Dijckkaai,2022-09-03,01:00:00,100,25,75,FMN 01 Ernest Van Dijckkaai
649,Ernest Van Dijckkaai,2022-09-03,02:00:00,75,25,50,FMN 01 Ernest Van Dijckkaai
649,Ernest Van Dijckkaai,2022-09-03,03:00:00,60,21,39,FMN 01 Ernest Van Dijckkaai
649,Ernest Van Dijckkaai,2022-09-03,04:00:00,45,18,27,FMN 01 Ernest Van Dijckkaai
649,Ernest Van Dijckkaai,2022-09-03,05:00:00,59,35,24,FMN 01 Ernest Van Dijckkaai
649,Ernest Van Dijckkaai,2022-09-03,06:00:00,58,25,33,FMN 01 Ernest Van Dijckkaai
649,Ernest Van Dijckkaai,2022-09-03,07:00:00,46,11,35,FMN 01 Ernest Van Dijckkaai
649,Ernest Van Dijckkaai,2022-09-03,08:00:00,119,58,61,FMN 01 Ernest Van Dijckkaai
649,Ernest Van Dijckkaai,2022-09-03,09:00:00,210,96,114,FMN 01 Ernest Van Dijckkaai
649,Ernest Van Dijckkaai,2022-09-03,10:00:00,237,123,114,FMN 01 Ernest Van Dijckkaai
649,Ernest Van Dijckkaai,2022-09-03,11:00:00,305,183,122,FMN 01 Ernest Van Dijckkaai
649,Ernest Van Dijckkaai,2022-09-03,12:00:00,345,182,163,FMN 01 Ernest Van Dijckkaai
649,Ernest Van Dijckkaai,2022-09-03,13:00:00,418,230,188,FMN 01 Ernest Van Dijckkaai
649,Ernest Van Dijckkaai,2022-09-03,14:00:00,493,241,252,FMN 01 Ernest Van Dijckkaai
649,Ernest Van Dijckkaai,2022-09-03,15:00:00,455,243,212,FMN 01 Ernest Van Dijckkaai
649,Ernest Van Dijckkaai,2022-09-03,16:00:00,502,255,247,FMN 01 Ernest Van Dijckkaai
649,Ernest Van Dijckkaai,2022-09-03,17:00:00,522,244,278,FMN 01 Ernest Van Dijckkaai
649,Ernest Van Dijckkaai,2022-09-03,18:00:00,415,213,202,FMN 01 Ernest Van Dijckkaai
649,Ernest Van Dijckkaai,2022-09-03,19:00:00,330,166,164,FMN 01 Ernest Van Dijckkaai
649,Ernest Van Dijckkaai,2022-09-03,20:00:00,277,150,127,FMN 01 Ernest Van Dijckkaai
649,Ernest Van Dijckkaai,2022-09-03,21:00:00,202,95,107,FMN 01 Ernest Van Dijckkaai
649,Ernest Van Dijckkaai,2022-09-03,22:00:00,222,106,116,FMN 01 Ernest Van Dijckkaai
649,Ernest Van Dijckkaai,2022-09-03,23:00:00,207,86,121,FMN 01 Ernest Van Dijckkaai
649,Ernest Van Dijckkaai,2022-09-04,00:00:00,132,61,71,FMN 01 Ernest Van Dijckkaai
649,Ernest Van Dijckkaai,2022-09-04,01:00:00,122,61,61,FMN 01 Ernest Van Dijckkaai
649,Ernest Van Dijckkaai,2022-09-04,02:00:00,86,24,62,FMN 01 Ernest Van Dijckkaai
649,Ernest Van Dijckkaai,2022-09-04,03:00:00,81,18,63,FMN 01 Ernest Van Dijckkaai
649,Ernest Van Dijckkaai,2022-09-04,04:00:00,57,17,40,FMN 01 Ernest Van Dijckkaai
649,Ernest Van Dijckkaai,2022-09-04,05:00:00,41,26,15,FMN 01 Ernest Van Dijckkaai
649,Ernest Van Dijckkaai,2022-09-04,06:00:00,56,26,30,FMN 01 Ernest Van Dijckkaai
649,Ernest Van Dijckkaai,2022-09-04,07:00:00,49,23,26,FMN 01 Ernest Van Dijckkaai
649,Ernest Van Dijckkaai,2022-09-04,08:00:00,103,47,56,FMN 01 Ernest Van Dijckkaai
649,Ernest Van Dijckkaai,2022-09-04,09:00:00,173,96,77,FMN 01 Ernest Van Dijckkaai
649,Ernest Van Dijckkaai,2022-09-04,10:00:00,266,174,92,FMN 01 Ernest Van Dijckkaai
649,Ernest Van Dijckkaai,2022-09-04,11:00:00,413,227,186,FMN 01 Ernest Van Dijckkaai
649,Ernest Van Dijckkaai,2022-09-04,12:00:00,422,241,181,FMN 01 Ernest Van Dijckkaai
649,Ernest Van Dijckkaai,2022-09-04,13:00:00,440,265,175,FMN 01 Ernest Van Dijckkaai
649,Ernest Van Dijckkaai,2022-09-04,14:00:00,619,331,288,FMN 01 Ernest Van Dijckkaai
649,Ernest Van Dijckkaai,2022-09-04,15:00:00,592,332,260,FMN 01 Ernest Van Dijckkaai
649,Ernest Van Dijckkaai,2022-09-04,16:00:00,523,267,256,FMN 01 Ernest Van Dijckkaai
649,Ernest Van Dijckkaai,2022-09-04,17:00:00,473,242,231,FMN 01 Ernest Van Dijckkaai
649,Ernest Van Dijckkaai,2022-09-04,18:00:00,462,210,252,FMN 01 Ernest Van Dijckkaai
649,Ernest Van Dijckkaai,2022-09-04,19:00:00,364,160,204,FMN 01 Ernest Van Dijckkaai
649,Ernest Van Dijckkaai,2022-09-04,20:00:00,303,119,184,FMN 01 Ernest Van Dijckkaai
649,Ernest Van Dijckkaai,2022-09-04,21:00:00,192,71,121,FMN 01 Ernest Van Dijckkaai
649,Ernest Van Dijckkaai,2022-09-04,22:00:00,130,39,91,FMN 01 Ernest Van Dijckkaai
649,Ernest Van Dijckkaai,2022-09-04,23:00:00,77,20,57,FMN 01 Ernest Van Dijckkaai
649,Ernest Van Dijckkaai,2022-09-05,00:00:00,63,28,35,FMN 01 Ernest Van Dijckkaai
649,Ernest Van Dijckkaai,2022-09-05,01:00:00,32,5,27,FMN 01 Ernest Van Dijckkaai
649,Ernest Van Dijckkaai,2022-09-05,02:00:00,20,10,10,FMN 01 Ernest Van Dijckkaai
649,Ernest Van Dijckkaai,2022-09-05,03:00:00,23,2,21,FMN 01 Ernest Van Dijckkaai
649,Ernest Van Dijckkaai,2022-09-05,04:00:00,73,48,25,FMN 01 Ernest Van Dijckkaai
649,Ernest Van Dijckkaai,2022-09-05,05:00:00,141,85,56,FMN 01 Ernest Van Dijckkaai
649,Ernest Van Dijckkaai,2022-09-05,06:00:00,276,172,104,FMN 01 Ernest Van Dijckkaai
649,Ernest Van Dijckkaai,2022-09-05,07:00:00,552,344,208,FMN 01 Ernest Van Dijckkaai
649,Ernest Van Dijckkaai,2022-09-05,08:00:00,679,416,263,FMN 01 Ernest Van Dijckkaai
649,Ernest Van Dijckkaai,2022-09-05,09:00:00,261,165,96,FMN 01 Ernest Van Dijckkaai
649,Ernest Van Dijckkaai,2022-09-05,10:00:00,214,119,95,FMN 01 Ernest Van Dijckkaai
649,Ernest Van Dijckkaai,2022-09-05,11:00:00,203,110,93,FMN 01 Ernest Van Dijckkaai
649,Ernest Van Dijckkaai,2022-09-05,12:00:00,277,151,126,FMN 01 Ernest Van Dijckkaai
649,Ernest Van Dijckkaai,2022-09-05,13:00:00,320,181,139,FMN 01 Ernest Van Dijckkaai
649,Ernest Van Dijckkaai,2022-09-05,14:00:00,341,148,193,FMN 01 Ernest Van Dijckkaai
649,Ernest Van Dijckkaai,2022-09-05,15:00:00,429,200,229,FMN 01 Ernest Van Dijckkaai
649,Ernest Van Dijckkaai,2022-09-05,16:00:00,723,315,408,FMN 01 Ernest Van Dijckkaai
649,Ernest Van Dijckkaai,2022-09-05,17:00:00,742,305,437,FMN 01 Ernest Van Dijckkaai
649,Ernest Van Dijckkaai,2022-09-05,18:00:00,411,176,235,FMN 01 Ernest Van Dijckkaai
649,Ernest Van Dijckkaai,2022-09-05,19:00:00,238,114,124,FMN 01 Ernest Van Dijckkaai
649,Ernest Van Dijckkaai,2022-09-05,20:00:00,203,100,103,FMN 01 Ernest Van Dijckkaai
649,Ernest Van Dijckkaai,2022-09-05,21:00:00,105,57,48,FMN 01 Ernest Van Dijckkaai
649,Ernest Van Dijckkaai,2022-09-05,22:00:00,129,48,81,FMN 01 Ernest Van Dijckkaai
649,Ernest Van Dijckkaai,2022-09-05,23:00:00,45,18,27,FMN 01 Ernest Van Dijckkaai
649,Ernest Van Dijckkaai,2022-09-06,00:00:00,28,12,16,FMN 01 Ernest Van Dijckkaai
649,Ernest Van Dijckkaai,2022-09-06,01:00:00,11,2,9,FMN 01 Ernest Van Dijckkaai
649,Ernest Van Dijckkaai,2022-09-06,02:00:00,9,1,8,FMN 01 Ernest Van Dijckkaai
649,Ernest Van Dijckkaai,2022-09-06,03:00:00,14,5,9,FMN 01 Ernest Van Dijckkaai
649,Ernest Van Dijckkaai,2022-09-06,04:00:00,63,41,22,FMN 01 Ernest Van Dijckkaai
649,Ernest Van Dijckkaai,2022-09-06,05:00:00,134,82,52,FMN 01 Ernest Van Dijckkaai
649,Ernest Van Dijckkaai,2022-09-06,06:00:00,298,190,108,FMN 01 Ernest Van Dijckkaai
649,Ernest Van Dijckkaai,2022-09-06,07:00:00,547,332,215,FMN 01 Ernest Van Dijckkaai
649,Ernest Van Dijckkaai,2022-09-06,08:00:00,759,462,297,FMN 01 Ernest Van Dijckkaai
649,Ernest Van Dijckkaai,2022-09-06,09:00:00,334,180,154,FMN 01 Ernest Van Dijckkaai
649,Ernest Van Dijckkaai,2022-09-06,10:00:00,245,140,105,FMN 01 Ernest Van Dijckkaai
649,Ernest Van Dijckkaai,2022-09-06,11:00:00,227,132,95,FMN 01 Ernest Van Dijckkaai
649,Ernest Van Dijckkaai,2022-09-06,12:00:00,341,185,156,FMN 01 Ernest Van Dijckkaai
649,Ernest Van Dijckkaai,2022-09-06,13:00:00,364,210,154,FMN 01 Ernest Van Dijckkaai
649,Ernest Van Dijckkaai,2022-09-06,14:00:00,397,173,224,FMN 01 Ernest Van Dijckkaai
649,Ernest Van Dijckkaai,2022-09-06,15:00:00,504,235,269,FMN 01 Ernest Van Dijckkaai
649,Ernest Van Dijckkaai,2022-09-06,16:00:00,816,371,445,FMN 01 Ernest Van Dijckkaai
649,Ernest Van Dijckkaai,2022-09-06,17:00:00,798,326,472,FMN 01 Ernest Van Dijckkaai
649,Ernest Van Dijckkaai,2022-09-06,18:00:00,484,234,250,FMN 01 Ernest Van Dijckkaai
649,Ernest Van Dijckkaai,2022-09-06,19:00:00,318,146,172,FMN 01 Ernest Van Dijckkaai
649,Ernest Van Dijckkaai,2022-09-06,20:00:00,242,123,119,FMN 01 Ernest Van Dijckkaai
649,Ernest Van Dijckkaai,2022-09-06,21:00:00,187,93,94,FMN 01 Ernest Van Dijckkaai
649,Ernest Van Dijckkaai,2022-09-06,22:00:00,178,85,93,FMN 01 Ernest Van Dijckkaai
649,Ernest Van Dijckkaai,2022-09-06,23:00:00,46,22,24,FMN 01 Ernest Van Dijckkaai
649,Ernest Van Dijckkaai,2022-09-07,00:00:00,19,5,14,FMN 01 Ernest Van Dijckkaai
649,Ernest Van Dijckkaai,2022-09-07,01:00:00,14,6,8,FMN 01 Ernest Van Dijckkaai
649,Ernest Van Dijckkaai,2022-09-07,02:00:00,7,3,4,FMN 01 Ernest Van Dijckkaai
649,Ernest Van Dijckkaai,2022-09-07,03:00:00,7,3,4,FMN 01 Ernest Van Dijckkaai
649,Ernest Van Dijckkaai,2022-09-07,04:00:00,56,27,29,FMN 01 Ernest Van Dijckkaai
649,Ernest Van Dijckkaai,2022-09-07,05:00:00,119,81,38,FMN 01 Ernest Van Dijckkaai
649,Ernest Van Dijckkaai,2022-09-07,06:00:00,297,194,103,FMN 01 Ernest Van Dijckkaai
649,Ernest Van Dijckkaai,2022-09-07,07:00:00,458,275,183,FMN 01 Ernest Van Dijckkaai
649,Ernest Van Dijckkaai,2022-09-07,08:00:00,623,392,231,FMN 01 Ernest Van Dijckkaai
649,Ernest Van Dijckkaai,2022-09-07,09:00:00,294,194,100,FMN 01 Ernest Van Dijckkaai
649,Ernest Van Dijckkaai,2022-09-07,10:00:00,197,111,86,FMN 01 Ernest Van Dijckkaai
649,Ernest Van Dijckkaai,2022-09-07,11:00:00,251,123,128,FMN 01 Ernest Van Dijckkaai
649,Ernest Van Dijckkaai,2022-09-07,12:00:00,391,203,188,FMN 01 Ernest Van Dijckkaai
649,Ernest Van Dijckkaai,2022-09-07,13:00:00,341,191,150,FMN 01 Ernest Van Dijckkaai
649,Ernest Van Dijckkaai,2022-09-07,14:00:00,398,180,218,FMN 01 Ernest Van Dijckkaai
649,Ernest Van Dijckkaai,2022-09-07,15:00:00,393,184,209,FMN 01 Ernest Van Dijckkaai
649,Ernest Van Dijckkaai,2022-09-07,16:00:00,570,248,322,FMN 01 Ernest Van Dijckkaai
649,Ernest Van Dijckkaai,2022-09-07,17:00:00,778,310,468,FMN 01 Ernest Van Dijckkaai
649,Ernest Van Dijckkaai,2022-09-07,18:00:00,500,253,247,FMN 01 Ernest Van Dijckkaai
649,Ernest Van Dijckkaai,2022-09-07,19:00:00,321,161,160,FMN 01 Ernest Van Dijckkaai
649,Ernest Van Dijckkaai,2022-09-07,20:00:00,233,116,117,FMN 01 Ernest Van Dijckkaai
649,Ernest Van Dijckkaai,2022-09-07,21:00:00,199,89,110,FMN 01 Ernest Van Dijckkaai
649,Ernest Van Dijckkaai,2022-09-07,22:00:00,205,71,134,FMN 01 Ernest Van Dijckkaai
649,Ernest Van Dijckkaai,2022-09-07,23:00:00,96,36,60,FMN 01 Ernest Van Dijckkaai
649,Ernest Van Dijckkaai,2022-09-08,00:00:00,46,28,18,FMN 01 Ernest Van Dijckkaai
649,Ernest Van Dijckkaai,2022-09-08,01:00:00,23,5,18,FMN 01 Ernest Van Dijckkaai
649,Ernest Van Dijckkaai,2022-09-08,02:00:00,11,1,10,FMN 01 Ernest Van Dijckkaai
649,Ernest Van Dijckkaai,2022-09-08,03:00:00,19,8,11,FMN 01 Ernest Van Dijckkaai
649,Ernest Van Dijckkaai,2022-09-08,04:00:00,41,22,19,FMN 01 Ernest Van Dijckkaai
649,Ernest Van Dijckkaai,2022-09-08,05:00:00,103,61,42,FMN 01 Ernest Van Dijckkaai
649,Ernest Van Dijckkaai,2022-09-08,06:00:00,230,135,95,FMN 01 Ernest Van Dijckkaai
649,Ernest Van Dijckkaai,2022-09-08,07:00:00,428,271,157,FMN 01 Ernest Van Dijckkaai
649,Ernest Van Dijckkaai,2022-09-08,08:00:00,641,367,274,FMN 01 Ernest Van Dijckkaai
649,Ernest Van Dijckkaai,2022-09-08,09:00:00,296,173,123,FMN 01 Ernest Van Dijckkaai
649,Ernest Van Dijckkaai,2022-09-08,10:00:00,212,124,88,FMN 01 Ernest Van Dijckkaai
649,Ernest Van Dijckkaai,2022-09-08,11:00:00,205,102,103,FMN 01 Ernest Van Dijckkaai
649,Ernest Van Dijckkaai,2022-09-08,12:00:00,317,180,137,FMN 01 Ernest Van Dijckkaai
649,Ernest Van Dijckkaai,2022-09-08,13:00:00,270,145,125,FMN 01 Ernest Van Dijckkaai
649,Ernest Van Dijckkaai,2022-09-08,14:00:00,346,161,185,FMN 01 Ernest Van Dijckkaai
649,Ernest Van Dijckkaai,2022-09-08,15:00:00,387,218,169,FMN 01 Ernest Van Dijckkaai
649,Ernest Van Dijckkaai,2022-09-08,16:00:00,595,259,336,FMN 01 Ernest Van Dijckkaai
649,Ernest Van Dijckkaai,2022-09-08,17:00:00,631,289,342,FMN 01 Ernest Van Dijckkaai
649,Ernest Van Dijckkaai,2022-09-08,18:00:00,384,181,203,FMN 01 Ernest Van Dijckkaai
649,Ernest Van Dijckkaai,2022-09-08,19:00:00,236,108,128,FMN 01 Ernest Van Dijckkaai
649,Ernest Van Dijckkaai,2022-09-08,20:00:00,135,56,79,FMN 01 Ernest Van Dijckkaai
649,Ernest Van Dijckkaai,2022-09-08,21:00:00,119,52,67,FMN 01 Ernest Van Dijckkaai
649,Ernest Van Dijckkaai,2022-09-08,22:00:00,123,51,72,FMN 01 Ernest Van Dijckkaai
649,Ernest Van Dijckkaai,2022-09-08,23:00:00,58,27,31,FMN 01 Ernest Van Dijckkaai
649,Ernest Van Dijckkaai,2022-09-09,00:00:00,54,31,23,FMN 01 Ernest Van Dijckkaai
649,Ernest Van Dijckkaai,2022-09-09,01:00:00,26,9,17,FMN 01 Ernest Van Dijckkaai
649,Ernest Van Dijckkaai,2022-09-09,02:00:00,22,12,10,FMN 01 Ernest Van Dijckkaai
649,Ernest Van Dijckkaai,2022-09-09,03:00:00,22,2,20,FMN 01 Ernest Van Dijckkaai
649,Ernest Van Dijckkaai,2022-09-09,04:00:00,75,29,46,FMN 01 Ernest Van Dijckkaai
649,Ernest Van Dijckkaai,2022-09-09,05:00:00,105,58,47,FMN 01 Ernest Van Dijckkaai
649,Ernest Van Dijckkaai,2022-09-09,06:00:00,198,107,91,FMN 01 Ernest Van Dijckkaai
649,Ernest Van Dijckkaai,2022-09-09,07:00:00,368,222,146,FMN 01 Ernest Van Dijckkaai
649,Ernest Van Dijckkaai,2022-09-09,08:00:00,486,296,190,FMN 01 Ernest Van Dijckkaai
649,Ernest Van Dijckkaai,2022-09-09,09:00:00,255,158,97,FMN 01 Ernest Van Dijckkaai
649,Ernest Van Dijckkaai,2022-09-09,10:00:00,156,89,67,FMN 01 Ernest Van Dijckkaai
649,Ernest Van Dijckkaai,2022-09-09,11:00:00,146,72,74,FMN 01 Ernest Van Dijckkaai
649,Ernest Van Dijckkaai,2022-09-09,12:00:00,217,120,97,FMN 01 Ernest Van Dijckkaai
649,Ernest Van Dijckkaai,2022-09-09,13:00:00,199,104,95,FMN 01 Ernest Van Dijckkaai
649,Ernest Van Dijckkaai,2022-09-09,14:00:00,244,123,121,FMN 01 Ernest Van Dijckkaai
649,Ernest Van Dijckkaai,2022-09-09,15:00:00,355,164,191,FMN 01 Ernest Van Dijckkaai
649,Ernest Van Dijckkaai,2022-09-09,16:00:00,483,208,275,FMN 01 Ernest Van Dijckkaai
649,Ernest Van Dijckkaai,2022-09-09,17:00:00,379,170,209,FMN 01 Ernest Van Dijckkaai
649,Ernest Van Dijckkaai,2022-09-09,18:00:00,293,138,155,FMN 01 Ernest Van Dijckkaai
649,Ernest Van Dijckkaai,2022-09-09,19:00:00,214,105,109,FMN 01 Ernest Van Dijckkaai
649,Ernest Van Dijckkaai,2022-09-09,20:00:00,154,76,78,FMN 01 Ernest Van Dijckkaai
649,Ernest Van Dijckkaai,2022-09-09,21:00:00,124,64,60,FMN 01 Ernest Van Dijckkaai
649,Ernest Van Dijckkaai,2022-09-09,22:00:00,150,73,77,FMN 01 Ernest Van Dijckkaai
649,Ernest Van Dijckkaai,2022-09-09,23:00:00,127,47,80,FMN 01 Ernest Van Dijckkaai
649,Ernest Van Dijckkaai,2022-09-10,00:00:00,84,28,56,FMN 01 Ernest Van Dijckkaai
649,Ernest Van Dijckkaai,2022-09-10,01:00:00,82,42,40,FMN 01 Ernest Van Dijckkaai
649,Ernest Van Dijckkaai,2022-09-10,02:00:00,57,14,43,FMN 01 Ernest Van Dijckkaai
649,Ernest Van Dijckkaai,2022-09-10,03:00:00,39,10,29,FMN 01 Ernest Van Dijckkaai
649,Ernest Van Dijckkaai,2022-09-10,04:00:00,40,13,27,FMN 01 Ernest Van Dijckkaai
649,Ernest Van Dijckkaai,2022-09-10,05:00:00,32,16,16,FMN 01 Ernest Van Dijckkaai
649,Ernest Van Dijckkaai,2022-09-10,06:00:00,28,18,10,FMN 01 Ernest Van Dijckkaai
649,Ernest Van Dijckkaai,2022-09-10,07:00:00,27,10,17,FMN 01 Ernest Van Dijckkaai
649,Ernest Van Dijckkaai,2022-09-10,08:00:00,49,26,23,FMN 01 Ernest Van Dijckkaai
649,Ernest Van Dijckkaai,2022-09-10,09:00:00,68,28,40,FMN 01 Ernest Van Dijckkaai
649,Ernest Van Dijckkaai,2022-09-10,10:00:00,60,37,23,FMN 01 Ernest Van Dijckkaai
649,Ernest Van Dijckkaai,2022-09-10,11:00:00,109,71,38,FMN 01 Ernest Van Dijckkaai
649,Ernest Van Dijckkaai,2022-09-10,12:00:00,116,72,44,FMN 01 Ernest Van Dijckkaai
649,Ernest Van Dijckkaai,2022-09-10,13:00:00,115,63,52,FMN 01 Ernest Van Dijckkaai
649,Ernest Van Dijckkaai,2022-09-10,14:00:00,149,76,73,FMN 01 Ernest Van Dijckkaai
649,Ernest Van Dijckkaai,2022-09-10,15:00:00,232,125,107,FMN 01 Ernest Van Dijckkaai
649,Ernest Van Dijckkaai,2022-09-10,16:00:00,217,102,115,FMN 01 Ernest Van Dijckkaai
649,Ernest Van Dijckkaai,2022-09-10,17:00:00,239,137,102,FMN 01 Ernest Van Dijckkaai
649,Ernest Van Dijckkaai,2022-09-10,18:00:00,231,112,119,FMN 01 Ernest Van Dijckkaai
649,Ernest Van Dijckkaai,2022-09-10,19:00:00,208,99,109,FMN 01 Ernest Van Dijckkaai
649,Ernest Van Dijckkaai,2022-09-10,20:00:00,182,92,90,FMN 01 Ernest Van Dijckkaai
649,Ernest Van Dijckkaai,2022-09-10,21:00:00,124,60,64,FMN 01 Ernest Van Dijckkaai
649,Ernest Van Dijckkaai,2022-09-10,22:00:00,123,70,53,FMN 01 Ernest Van Dijckkaai
649,Ernest Van Dijckkaai,2022-09-10,23:00:00,106,47,59,FMN 01 Ernest Van Dijckkaai
649,Ernest Van Dijckkaai,2022-09-11,00:00:00,104,51,53,FMN 01 Ernest Van Dijckkaai
649,Ernest Van Dijckkaai,2022-09-11,01:00:00,84,38,46,FMN 01 Ernest Van Dijckkaai
649,Ernest Van Dijckkaai,2022-09-11,02:00:00,48,12,36,FMN 01 Ernest Van Dijckkaai
649,Ernest Van Dijckkaai,2022-09-11,03:00:00,55,13,42,FMN 01 Ernest Van Dijckkaai
649,Ernest Van Dijckkaai,2022-09-11,04:00:00,39,17,22,FMN 01 Ernest Van Dijckkaai
649,Ernest Van Dijckkaai,2022-09-11,05:00:00,30,15,15,FMN 01 Ernest Van Dijckkaai
649,Ernest Van Dijckkaai,2022-09-11,06:00:00,63,28,35,FMN 01 Ernest Van Dijckkaai
649,Ernest Van Dijckkaai,2022-09-11,07:00:00,60,40,20,FMN 01 Ernest Van Dijckkaai
649,Ernest Van Dijckkaai,2022-09-11,08:00:00,330,274,56,FMN 01 Ernest Van Dijckkaai
649,Ernest Van Dijckkaai,2022-09-11,09:00:00,338,207,131,FMN 01 Ernest Van Dijckkaai
649,Ernest Van Dijckkaai,2022-09-11,10:00:00,585,155,430,FMN 01 Ernest Van Dijckkaai
649,Ernest Van Dijckkaai,2022-09-11,11:00:00,488,219,269,FMN 01 Ernest Van Dijckkaai
649,Ernest Van Dijckkaai,2022-09-11,12:00:00,702,294,408,FMN 01 Ernest Van Dijckkaai
649,Ernest Van Dijckkaai,2022-09-11,13:00:00,678,398,280,FMN 01 Ernest Van Dijckkaai
649,Ernest Van Dijckkaai,2022-09-11,14:00:00,830,370,460,FMN 01 Ernest Van Dijckkaai
649,Ernest Van Dijckkaai,2022-09-11,15:00:00,791,347,444,FMN 01 Ernest Van Dijckkaai
649,Ernest Van Dijckkaai,2022-09-11,16:00:00,739,300,439,FMN 01 Ernest Van Dijckkaai
649,Ernest Van Dijckkaai,2022-09-11,17:00:00,646,314,332,FMN 01 Ernest Van Dijckkaai
649,Ernest Van Dijckkaai,2022-09-11,18:00:00,470,199,271,FMN 01 Ernest Van Dijckkaai
649,Ernest Van Dijckkaai,2022-09-11,19:00:00,302,118,184,FMN 01 Ernest Van Dijckkaai
649,Ernest Van Dijckkaai,2022-09-11,20:00:00,219,113,106,FMN 01 Ernest Van Dijckkaai
649,Ernest Van Dijckkaai,2022-09-11,21:00:00,165,83,82,FMN 01 Ernest Van Dijckkaai
649,Ernest Van Dijckkaai,2022-09-11,22:00:00,104,37,67,FMN 01 Ernest Van Dijckkaai
649,Ernest Van Dijckkaai,2022-09-11,23:00:00,54,18,36,FMN 01 Ernest Van Dijckkaai
649,Ernest Van Dijckkaai,2022-09-12,00:00:00,22,9,13,FMN 01 Ernest Van Dijckkaai
649,Ernest Van Dijckkaai,2022-09-12,01:00:00,29,9,20,FMN 01 Ernest Van Dijckkaai
649,Ernest Van Dijckkaai,2022-09-12,02:00:00,8,4,4,FMN 01 Ernest Van Dijckkaai
649,Ernest Van Dijckkaai,2022-09-12,03:00:00,20,9,11,FMN 01 Ernest Van Dijckkaai
649,Ernest Van Dijckkaai,2022-09-12,04:00:00,56,37,19,FMN 01 Ernest Van Dijckkaai
649,Ernest Van Dijckkaai,2022-09-12,05:00:00,134,101,33,FMN 01 Ernest Van Dijckkaai
649,Ernest Van Dijckkaai,2022-09-12,06:00:00,263,162,101,FMN 01 Ernest Van Dijckkaai
649,Ernest Van Dijckkaai,2022-09-12,07:00:00,507,311,196,FMN 01 Ernest Van Dijckkaai
649,Ernest Van Dijckkaai,2022-09-12,08:00:00,705,421,284,FMN 01 Ernest Van Dijckkaai
649,Ernest Van Dijckkaai,2022-09-12,09:00:00,272,178,94,FMN 01 Ernest Van Dijckkaai
649,Ernest Van Dijckkaai,2022-09-12,10:00:00,182,101,81,FMN 01 Ernest Van Dijckkaai
649,Ernest Van Dijckkaai,2022-09-12,11:00:00,272,142,130,FMN 01 Ernest Van Dijckkaai
649,Ernest Van Dijckkaai,2022-09-12,12:00:00,363,220,143,FMN 01 Ernest Van Dijckkaai
649,Ernest Van Dijckkaai,2022-09-12,13:00:00,343,199,144,FMN 01 Ernest Van Dijckkaai
649,Ernest Van Dijckkaai,2022-09-12,14:00:00,455,221,234,FMN 01 Ernest Van Dijckkaai
649,Ernest Van Dijckkaai,2022-09-12,15:00:00,483,228,255,FMN 01 Ernest Van Dijckkaai
649,Ernest Van Dijckkaai,2022-09-12,16:00:00,764,314,450,FMN 01 Ernest Van Dijckkaai
649,Ernest Van Dijckkaai,2022-09-12,17:00:00,832,375,457,FMN 01 Ernest Van Dijckkaai
649,Ernest Van Dijckkaai,2022-09-12,18:00:00,526,260,266,FMN 01 Ernest Van Dijckkaai
649,Ernest Van Dijckkaai,2022-09-12,19:00:00,323,145,178,FMN 01 Ernest Van Dijckkaai
649,Ernest Van Dijckkaai,2022-09-12,20:00:00,230,112,118,FMN 01 Ernest Van Dijckkaai
649,Ernest Van Dijckkaai,2022-09-12,21:00:00,200,91,109,FMN 01 Ernest Van Dijckkaai
649,Ernest Van Dijckkaai,2022-09-12,22:00:00,169,71,98,FMN 01 Ernest Van Dijckkaai
649,Ernest Van Dijckkaai,2022-09-12,23:00:00,92,29,63,FMN 01 Ernest Van Dijckkaai
649,Ernest Van Dijckkaai,2022-09-13,00:00:00,31,11,20,FMN 01 Ernest Van Dijckkaai
649,Ernest Van Dijckkaai,2022-09-13,01:00:00,18,8,10,FMN 01 Ernest Van Dijckkaai
649,Ernest Van Dijckkaai,2022-09-13,02:00:00,7,2,5,FMN 01 Ernest Van Dijckkaai
649,Ernest Van Dijckkaai,2022-09-13,03:00:00,14,3,11,FMN 01 Ernest Van Dijckkaai
649,Ernest Van Dijckkaai,2022-09-13,04:00:00,60,38,22,FMN 01 Ernest Van Dijckkaai
649,Ernest Van Dijckkaai,2022-09-13,05:00:00,131,101,30,FMN 01 Ernest Van Dijckkaai
649,Ernest Van Dijckkaai,2022-09-13,06:00:00,293,173,120,FMN 01 Ernest Van Dijckkaai
649,Ernest Van Dijckkaai,2022-09-13,07:00:00,460,269,191,FMN 01 Ernest Van Dijckkaai
649,Ernest Van Dijckkaai,2022-09-13,08:00:00,693,432,261,FMN 01 Ernest Van Dijckkaai
649,Ernest Van Dijckkaai,2022-09-13,09:00:00,300,179,121,FMN 01 Ernest Van Dijckkaai
649,Ernest Van Dijckkaai,2022-09-13,10:00:00,191,105,86,FMN 01 Ernest Van Dijckkaai
649,Ernest Van Dijckkaai,2022-09-13,11:00:00,171,93,78,FMN 01 Ernest Van Dijckkaai
649,Ernest Van Dijckkaai,2022-09-13,12:00:00,309,163,146,FMN 01 Ernest Van Dijckkaai
649,Ernest Van Dijckkaai,2022-09-13,13:00:00,301,176,125,FMN 01 Ernest Van Dijckkaai
649,Ernest Van Dijckkaai,2022-09-13,14:00:00,368,155,213,FMN 01 Ernest Van Dijckkaai
649,Ernest Van Dijckkaai,2022-09-13,15:00:00,414,209,205,FMN 01 Ernest Van Dijckkaai
649,Ernest Van Dijckkaai,2022-09-13,16:00:00,562,238,324,FMN 01 Ernest Van Dijckkaai
649,Ernest Van Dijckkaai,2022-09-13,17:00:00,664,290,374,FMN 01 Ernest Van Dijckkaai
649,Ernest Van Dijckkaai,2022-09-13,18:00:00,388,166,222,FMN 01 Ernest Van Dijckkaai
649,Ernest Van Dijckkaai,2022-09-13,19:00:00,209,92,117,FMN 01 Ernest Van Dijckkaai
649,Ernest Van Dijckkaai,2022-09-13,20:00:00,167,89,78,FMN 01 Ernest Van Dijckkaai
649,Ernest Van Dijckkaai,2022-09-13,21:00:00,132,54,78,FMN 01 Ernest Van Dijckkaai
649,Ernest Van Dijckkaai,2022-09-13,22:00:00,133,46,87,FMN 01 Ernest Van Dijckkaai
649,Ernest Van Dijckkaai,2022-09-13,23:00:00,51,29,22,FMN 01 Ernest Van Dijckkaai
649,Ernest Van Dijckkaai,2022-09-14,00:00:00,29,11,18,FMN 01 Ernest Van Dijckkaai
649,Ernest Van Dijckkaai,2022-09-14,01:00:00,10,5,5,FMN 01 Ernest Van Dijckkaai
649,Ernest Van Dijckkaai,2022-09-14,02:00:00,11,6,5,FMN 01 Ernest Van Dijckkaai
649,Ernest Van Dijckkaai,2022-09-14,03:00:00,12,1,11,FMN 01 Ernest Van Dijckkaai
649,Ernest Van Dijckkaai,2022-09-14,04:00:00,44,28,16,FMN 01 Ernest Van Dijckkaai
649,Ernest Van Dijckkaai,2022-09-14,05:00:00,84,60,24,FMN 01 Ernest Van Dijckkaai
649,Ernest Van Dijckkaai,2022-09-14,06:00:00,177,107,70,FMN 01 Ernest Van Dijckkaai
649,Ernest Van Dijckkaai,2022-09-14,07:00:00,278,166,112,FMN 01 Ernest Van Dijckkaai
649,Ernest Van Dijckkaai,2022-09-14,08:00:00,379,227,152,FMN 01 Ernest Van Dijckkaai
649,Ernest Van Dijckkaai,2022-09-14,09:00:00,212,110,102,FMN 01 Ernest Van Dijckkaai
649,Ernest Van Dijckkaai,2022-09-14,10:00:00,99,55,44,FMN 01 Ernest Van Dijckkaai
649,Ernest Van Dijckkaai,2022-09-14,11:00:00,87,44,43,FMN 01 Ernest Van Dijckkaai
649,Ernest Van Dijckkaai,2022-09-14,12:00:00,155,71,84,FMN 01 Ernest Van Dijckkaai
649,Ernest Van Dijckkaai,2022-09-14,13:00:00,136,76,60,FMN 01 Ernest Van Dijckkaai
649,Ernest Van Dijckkaai,2022-09-14,14:00:00,108,38,70,FMN 01 Ernest Van Dijckkaai
649,Ernest Van Dijckkaai,2022-09-14,15:00:00,137,57,80,FMN 01 Ernest Van Dijckkaai
649,Ernest Van Dijckkaai,2022-09-14,16:00:00,279,103,176,FMN 01 Ernest Van Dijckkaai
649,Ernest Van Dijckkaai,2022-09-14,17:00:00,375,162,213,FMN 01 Ernest Van Dijckkaai
649,Ernest Van Dijckkaai,2022-09-14,18:00:00,278,121,157,FMN 01 Ernest Van Dijckkaai
649,Ernest Van Dijckkaai,2022-09-14,19:00:00,148,69,79,FMN 01 Ernest Van Dijckkaai
649,Ernest Van Dijckkaai,2022-09-14,20:00:00,129,65,64,FMN 01 Ernest Van Dijckkaai
649,Ernest Van Dijckkaai,2022-09-14,21:00:00,111,48,63,FMN 01 Ernest Van Dijckkaai
649,Ernest Van Dijckkaai,2022-09-14,22:00:00,126,59,67,FMN 01 Ernest Van Dijckkaai
649,Ernest Van Dijckkaai,2022-09-14,23:00:00,58,23,35,FMN 01 Ernest Van Dijckkaai
649,Ernest Van Dijckkaai,2022-09-15,00:00:00,17,10,7,FMN 01 Ernest Van Dijckkaai
649,Ernest Van Dijckkaai,2022-09-15,01:00:00,20,9,11,FMN 01 Ernest Van Dijckkaai
649,Ernest Van Dijckkaai,2022-09-15,02:00:00,3,1,2,FMN 01 Ernest Van Dijckkaai
649,Ernest Van Dijckkaai,2022-09-15,03:00:00,14,3,11,FMN 01 Ernest Van Dijckkaai
649,Ernest Van Dijckkaai,2022-09-15,04:00:00,42,29,13,FMN 01 Ernest Van Dijckkaai
649,Ernest Van Dijckkaai,2022-09-15,05:00:00,115,87,28,FMN 01 Ernest Van Dijckkaai
649,Ernest Van Dijckkaai,2022-09-15,06:00:00,248,148,100,FMN 01 Ernest Van Dijckkaai
649,Ernest Van Dijckkaai,2022-09-15,07:00:00,412,234,178,FMN 01 Ernest Van Dijckkaai
649,Ernest Van Dijckkaai,2022-09-15,08:00:00,619,356,263,FMN 01 Ernest Van Dijckkaai
649,Ernest Van Dijckkaai,2022-09-15,09:00:00,291,177,114,FMN 01 Ernest Van Dijckkaai
649,Ernest Van Dijckkaai,2022-09-15,10:00:00,206,109,97,FMN 01 Ernest Van Dijckkaai
649,Ernest Van Dijckkaai,2022-09-15,11:00:00,174,96,78,FMN 01 Ernest Van Dijckkaai
649,Ernest Van Dijckkaai,2022-09-15,12:00:00,249,114,135,FMN 01 Ernest Van Dijckkaai
649,Ernest Van Dijckkaai,2022-09-15,13:00:00,228,112,116,FMN 01 Ernest Van Dijckkaai
649,Ernest Van Dijckkaai,2022-09-15,14:00:00,301,130,171,FMN 01 Ernest Van Dijckkaai
649,Ernest Van Dijckkaai,2022-09-15,15:00:00,405,217,188,FMN 01 Ernest Van Dijckkaai
649,Ernest Van Dijckkaai,2022-09-15,16:00:00,601,266,335,FMN 01 Ernest Van Dijckkaai
649,Ernest Van Dijckkaai,2022-09-15,17:00:00,671,288,383,FMN 01 Ernest Van Dijckkaai
649,Ernest Van Dijckkaai,2022-09-15,18:00:00,416,207,209,FMN 01 Ernest Van Dijckkaai
649,Ernest Van Dijckkaai,2022-09-15,19:00:00,263,128,135,FMN 01 Ernest Van Dijckkaai
649,Ernest Van Dijckkaai,2022-09-15,20:00:00,240,107,133,FMN 01 Ernest Van Dijckkaai
649,Ernest Van Dijckkaai,2022-09-15,21:00:00,161,75,86,FMN 01 Ernest Van Dijckkaai
649,Ernest Van Dijckkaai,2022-09-15,22:00:00,202,83,119,FMN 01 Ernest Van Dijckkaai
649,Ernest Van Dijckkaai,2022-09-15,23:00:00,134,59,75,FMN 01 Ernest Van Dijckkaai
649,Ernest Van Dijckkaai,2022-09-16,00:00:00,71,43,28,FMN 01 Ernest Van Dijckkaai
649,Ernest Van Dijckkaai,2022-09-16,01:00:00,36,20,16,FMN 01 Ernest Van Dijckkaai
649,Ernest Van Dijckkaai,2022-09-16,02:00:00,24,12,12,FMN 01 Ernest Van Dijckkaai
649,Ernest Van Dijckkaai,2022-09-16,03:00:00,21,2,19,FMN 01 Ernest Van Dijckkaai
649,Ernest Van Dijckkaai,2022-09-16,04:00:00,62,30,32,FMN 01 Ernest Van Dijckkaai
649,Ernest Van Dijckkaai,2022-09-16,05:00:00,110,64,46,FMN 01 Ernest Van Dijckkaai
649,Ernest Van Dijckkaai,2022-09-16,06:00:00,215,128,87,FMN 01 Ernest Van Dijckkaai
649,Ernest Van Dijckkaai,2022-09-16,07:00:00,286,174,112,FMN 01 Ernest Van Dijckkaai
649,Ernest Van Dijckkaai,2022-09-16,08:00:00,389,228,161,FMN 01 Ernest Van Dijckkaai
649,Ernest Van Dijckkaai,2022-09-16,09:00:00,208,136,72,FMN 01 Ernest Van Dijckkaai
649,Ernest Van Dijckkaai,2022-09-16,10:00:00,122,77,45,FMN 01 Ernest Van Dijckkaai
649,Ernest Van Dijckkaai,2022-09-16,11:00:00,118,61,57,FMN 01 Ernest Van Dijckkaai
649,Ernest Van Dijckkaai,2022-09-16,12:00:00,175,88,87,FMN 01 Ernest Van Dijckkaai
649,Ernest Van Dijckkaai,2022-09-16,13:00:00,140,78,62,FMN 01 Ernest Van Dijckkaai
649,Ernest Van Dijckkaai,2022-09-16,14:00:00,195,78,117,FMN 01 Ernest Van Dijckkaai
649,Ernest Van Dijckkaai,2022-09-16,15:00:00,252,119,133,FMN 01 Ernest Van Dijckkaai
649,Ernest Van Dijckkaai,2022-09-16,16:00:00,402,183,219,FMN 01 Ernest Van Dijckkaai
649,Ernest Van Dijckkaai,2022-09-16,17:00:00,348,134,214,FMN 01 Ernest Van Dijckkaai
649,Ernest Van Dijckkaai,2022-09-16,18:00:00,212,107,105,FMN 01 Ernest Van Dijckkaai
649,Ernest Van Dijckkaai,2022-09-16,19:00:00,149,66,83,FMN 01 Ernest Van Dijckkaai
649,Ernest Van Dijckkaai,2022-09-16,20:00:00,84,43,41,FMN 01 Ernest Van Dijckkaai
649,Ernest Van Dijckkaai,2022-09-16,21:00:00,90,45,45,FMN 01 Ernest Van Dijckkaai
649,Ernest Van Dijckkaai,2022-09-16,22:00:00,92,35,57,FMN 01 Ernest Van Dijckkaai
649,Ernest Van Dijckkaai,2022-09-16,23:00:00,59,24,35,FMN 01 Ernest Van Dijckkaai
649,Ernest Van Dijckkaai,2022-09-17,00:00:00,44,22,22,FMN 01 Ernest Van Dijckkaai
649,Ernest Van Dijckkaai,2022-09-17,01:00:00,46,22,24,FMN 01 Ernest Van Dijckkaai
649,Ernest Van Dijckkaai,2022-09-17,02:00:00,55,20,35,FMN 01 Ernest Van Dijckkaai
649,Ernest Van Dijckkaai,2022-09-17,03:00:00,33,4,29,FMN 01 Ernest Van Dijckkaai
649,Ernest Van Dijckkaai,2022-09-17,04:00:00,26,4,22,FMN 01 Ernest Van Dijckkaai
649,Ernest Van Dijckkaai,2022-09-17,05:00:00,30,16,14,FMN 01 Ernest Van Dijckkaai
649,Ernest Van Dijckkaai,2022-09-17,06:00:00,27,9,18,FMN 01 Ernest Van Dijckkaai
649,Ernest Van Dijckkaai,2022-09-17,07:00:00,24,9,15,FMN 01 Ernest Van Dijckkaai
649,Ernest Van Dijckkaai,2022-09-17,08:00:00,62,40,22,FMN 01 Ernest Van Dijckkaai
649,Ernest Van Dijckkaai,2022-09-17,09:00:00,103,55,48,FMN 01 Ernest Van Dijckkaai
649,Ernest Van Dijckkaai,2022-09-17,10:00:00,131,72,59,FMN 01 Ernest Van Dijckkaai
649,Ernest Van Dijckkaai,2022-09-17,11:00:00,136,74,62,FMN 01 Ernest Van Dijckkaai
649,Ernest Van Dijckkaai,2022-09-17,12:00:00,149,71,78,FMN 01 Ernest Van Dijckkaai
649,Ernest Van Dijckkaai,2022-09-17,13:00:00,156,85,71,FMN 01 Ernest Van Dijckkaai
649,Ernest Van Dijckkaai,2022-09-17,14:00:00,176,88,88,FMN 01 Ernest Van Dijckkaai
649,Ernest Van Dijckkaai,2022-09-17,15:00:00,145,69,76,FMN 01 Ernest Van Dijckkaai
649,Ernest Van Dijckkaai,2022-09-17,16:00:00,143,77,66,FMN 01 Ernest Van Dijckkaai
649,Ernest Van Dijckkaai,2022-09-17,17:00:00,190,114,76,FMN 01 Ernest Van Dijckkaai
649,Ernest Van Dijckkaai,2022-09-17,18:00:00,191,89,102,FMN 01 Ernest Van Dijckkaai
649,Ernest Van Dijckkaai,2022-09-17,19:00:00,110,43,67,FMN 01 Ernest Van Dijckkaai
649,Ernest Van Dijckkaai,2022-09-17,20:00:00,71,38,33,FMN 01 Ernest Van Dijckkaai
649,Ernest Van Dijckkaai,2022-09-17,21:00:00,51,24,27,FMN 01 Ernest Van Dijckkaai
649,Ernest Van Dijckkaai,2022-09-17,22:00:00,69,33,36,FMN 01 Ernest Van Dijckkaai
649,Ernest Van Dijckkaai,2022-09-17,23:00:00,68,34,34,FMN 01 Ernest Van Dijckkaai
649,Ernest Van Dijckkaai,2022-09-18,00:00:00,35,12,23,FMN 01 Ernest Van Dijckkaai
649,Ernest Van Dijckkaai,2022-09-18,01:00:00,38,12,26,FMN 01 Ernest Van Dijckkaai
649,Ernest Van Dijckkaai,2022-09-18,02:00:00,21,5,16,FMN 01 Ernest Van Dijckkaai
649,Ernest Van Dijckkaai,2022-09-18,03:00:00,20,3,17,FMN 01 Ernest Van Dijckkaai
649,Ernest Van Dijckkaai,2022-09-18,04:00:00,18,6,12,FMN 01 Ernest Van Dijckkaai
649,Ernest Van Dijckkaai,2022-09-18,05:00:00,19,7,12,FMN 01 Ernest Van Dijckkaai
649,Ernest Van Dijckkaai,2022-09-18,06:00:00,21,9,12,FMN 01 Ernest Van Dijckkaai
649,Ernest Van Dijckkaai,2022-09-18,07:00:00,27,16,11,FMN 01 Ernest Van Dijckkaai
649,Ernest Van Dijckkaai,2022-09-18,08:00:00,30,12,18,FMN 01 Ernest Van Dijckkaai
649,Ernest Van Dijckkaai,2022-09-18,09:00:00,86,60,26,FMN 01 Ernest Van Dijckkaai
649,Ernest Van Dijckkaai,2022-09-18,10:00:00,113,75,38,FMN 01 Ernest Van Dijckkaai
649,Ernest Van Dijckkaai,2022-09-18,11:00:00,163,89,74,FMN 01 Ernest Van Dijckkaai
649,Ernest Van Dijckkaai,2022-09-18,12:00:00,217,114,103,FMN 01 Ernest Van Dijckkaai
649,Ernest Van Dijckkaai,2022-09-18,13:00:00,217,106,111,FMN 01 Ernest Van Dijckkaai
649,Ernest Van Dijckkaai,2022-09-18,14:00:00,249,139,110,FMN 01 Ernest Van Dijckkaai
649,Ernest Van Dijckkaai,2022-09-18,15:00:00,240,117,123,FMN 01 Ernest Van Dijckkaai
649,Ernest Van Dijckkaai,2022-09-18,16:00:00,226,82,144,FMN 01 Ernest Van Dijckkaai
649,Ernest Van Dijckkaai,2022-09-18,17:00:00,175,79,96,FMN 01 Ernest Van Dijckkaai
649,Ernest Van Dijckkaai,2022-09-18,18:00:00,115,41,74,FMN 01 Ernest Van Dijckkaai
649,Ernest Van Dijckkaai,2022-09-18,19:00:00,84,40,44,FMN 01 Ernest Van Dijckkaai
649,Ernest Van Dijckkaai,2022-09-18,20:00:00,64,24,40,FMN 01 Ernest Van Dijckkaai
649,Ernest Van Dijckkaai,2022-09-18,21:00:00,48,25,23,FMN 01 Ernest Van Dijckkaai
649,Ernest Van Dijckkaai,2022-09-18,22:00:00,51,15,36,FMN 01 Ernest Van Dijckkaai
649,Ernest Van Dijckkaai,2022-09-18,23:00:00,32,12,20,FMN 01 Ernest Van Dijckkaai
649,Ernest Van Dijckkaai,2022-09-19,00:00:00,13,7,6,FMN 01 Ernest Van Dijckkaai
649,Ernest Van Dijckkaai,2022-09-19,01:00:00,12,4,8,FMN 01 Ernest Van Dijckkaai
649,Ernest Van Dijckkaai,2022-09-19,02:00:00,8,4,4,FMN 01 Ernest Van Dijckkaai
649,Ernest Van Dijckkaai,2022-09-19,03:00:00,6,3,3,FMN 01 Ernest Van Dijckkaai
649,Ernest Van Dijckkaai,2022-09-19,04:00:00,41,29,12,FMN 01 Ernest Van Dijckkaai
649,Ernest Van Dijckkaai,2022-09-19,05:00:00,97,62,35,FMN 01 Ernest Van Dijckkaai
649,Ernest Van Dijckkaai,2022-09-19,06:00:00,245,164,81,FMN 01 Ernest Van Dijckkaai
649,Ernest Van Dijckkaai,2022-09-19,07:00:00,425,262,163,FMN 01 Ernest Van Dijckkaai
649,Ernest Van Dijckkaai,2022-09-19,08:00:00,601,366,235,FMN 01 Ernest Van Dijckkaai
649,Ernest Van Dijckkaai,2022-09-19,09:00:00,279,181,98,FMN 01 Ernest Van Dijckkaai
649,Ernest Van Dijckkaai,2022-09-19,10:00:00,171,99,72,FMN 01 Ernest Van Dijckkaai
649,Ernest Van Dijckkaai,2022-09-19,11:00:00,165,91,74,FMN 01 Ernest Van Dijckkaai
649,Ernest Van Dijckkaai,2022-09-19,12:00:00,284,149,135,FMN 01 Ernest Van Dijckkaai
649,Ernest Van Dijckkaai,2022-09-19,13:00:00,291,152,139,FMN 01 Ernest Van Dijckkaai
649,Ernest Van Dijckkaai,2022-09-19,14:00:00,305,138,167,FMN 01 Ernest Van Dijckkaai
649,Ernest Van Dijckkaai,2022-09-19,15:00:00,399,178,221,FMN 01 Ernest Van Dijckkaai
649,Ernest Van Dijckkaai,2022-09-19,16:00:00,597,262,335,FMN 01 Ernest Van Dijckkaai
649,Ernest Van Dijckkaai,2022-09-19,17:00:00,656,280,376,FMN 01 Ernest Van Dijckkaai
649,Ernest Van Dijckkaai,2022-09-19,18:00:00,434,204,230,FMN 01 Ernest Van Dijckkaai
649,Ernest Van Dijckkaai,2022-09-19,19:00:00,244,103,141,FMN 01 Ernest Van Dijckkaai
649,Ernest Van Dijckkaai,2022-09-19,20:00:00,124,55,69,FMN 01 Ernest Van Dijckkaai
649,Ernest Van Dijckkaai,2022-09-19,21:00:00,136,65,71,FMN 01 Ernest Van Dijckkaai
649,Ernest Van Dijckkaai,2022-09-19,22:00:00,154,42,112,FMN 01 Ernest Van Dijckkaai
649,Ernest Van Dijckkaai,2022-09-19,23:00:00,55,23,32,FMN 01 Ernest Van Dijckkaai
649,Ernest Van Dijckkaai,2022-09-20,00:00:00,18,9,9,FMN 01 Ernest Van Dijckkaai
649,Ernest Van Dijckkaai,2022-09-20,01:00:00,8,1,7,FMN 01 Ernest Van Dijckkaai
649,Ernest Van Dijckkaai,2022-09-20,02:00:00,5,2,3,FMN 01 Ernest Van Dijckkaai
649,Ernest Van Dijckkaai,2022-09-20,03:00:00,5,4,1,FMN 01 Ernest Van Dijckkaai
649,Ernest Van Dijckkaai,2022-09-20,04:00:00,47,28,19,FMN 01 Ernest Van Dijckkaai
649,Ernest Van Dijckkaai,2022-09-20,05:00:00,131,87,44,FMN 01 Ernest Van Dijckkaai
649,Ernest Van Dijckkaai,2022-09-20,06:00:00,273,189,84,FMN 01 Ernest Van Dijckkaai
649,Ernest Van Dijckkaai,2022-09-20,07:00:00,516,315,201,FMN 01 Ernest Van Dijckkaai
649,Ernest Van Dijckkaai,2022-09-20,08:00:00,712,418,294,FMN 01 Ernest Van Dijckkaai
649,Ernest Van Dijckkaai,2022-09-20,09:00:00,372,235,137,FMN 01 Ernest Van Dijckkaai
649,Ernest Van Dijckkaai,2022-09-20,10:00:00,205,122,83,FMN 01 Ernest Van Dijckkaai
649,Ernest Van Dijckkaai,2022-09-20,11:00:00,174,91,83,FMN 01 Ernest Van Dijckkaai
649,Ernest Van Dijckkaai,2022-09-20,12:00:00,321,184,137,FMN 01 Ernest Van Dijckkaai
649,Ernest Van Dijckkaai,2022-09-20,13:00:00,284,154,130,FMN 01 Ernest Van Dijckkaai
649,Ernest Van Dijckkaai,2022-09-20,14:00:00,319,133,186,FMN 01 Ernest Van Dijckkaai
649,Ernest Van Dijckkaai,2022-09-20,15:00:00,365,164,201,FMN 01 Ernest Van Dijckkaai
649,Ernest Van Dijckkaai,2022-09-20,16:00:00,654,264,390,FMN 01 Ernest Van Dijckkaai
649,Ernest Van Dijckkaai,2022-09-20,17:00:00,739,310,429,FMN 01 Ernest Van Dijckkaai
649,Ernest Van Dijckkaai,2022-09-20,18:00:00,506,245,261,FMN 01 Ernest Van Dijckkaai
649,Ernest Van Dijckkaai,2022-09-20,19:00:00,260,135,125,FMN 01 Ernest Van Dijckkaai
649,Ernest Van Dijckkaai,2022-09-20,20:00:00,179,86,93,FMN 01 Ernest Van Dijckkaai
649,Ernest Van Dijckkaai,2022-09-20,21:00:00,145,68,77,FMN 01 Ernest Van Dijckkaai
649,Ernest Van Dijckkaai,2022-09-20,22:00:00,140,51,89,FMN 01 Ernest Van Dijckkaai
649,Ernest Van Dijckkaai,2022-09-20,23:00:00,62,28,34,FMN 01 Ernest Van Dijckkaai
649,Ernest Van Dijckkaai,2022-09-21,00:00:00,29,9,20,FMN 01 Ernest Van Dijckkaai
649,Ernest Van Dijckkaai,2022-09-21,01:00:00,15,3,12,FMN 01 Ernest Van Dijckkaai
649,Ernest Van Dijckkaai,2022-09-21,02:00:00,12,1,11,FMN 01 Ernest Van Dijckkaai
649,Ernest Van Dijckkaai,2022-09-21,03:00:00,20,5,15,FMN 01 Ernest Van Dijckkaai
649,Ernest Van Dijckkaai,2022-09-21,04:00:00,57,37,20,FMN 01 Ernest Van Dijckkaai
649,Ernest Van Dijckkaai,2022-09-21,05:00:00,133,91,42,FMN 01 Ernest Van Dijckkaai
649,Ernest Van Dijckkaai,2022-09-21,06:00:00,281,191,90,FMN 01 Ernest Van Dijckkaai
649,Ernest Van Dijckkaai,2022-09-21,07:00:00,511,311,200,FMN 01 Ernest Van Dijckkaai
649,Ernest Van Dijckkaai,2022-09-21,08:00:00,645,397,248,FMN 01 Ernest Van Dijckkaai
649,Ernest Van Dijckkaai,2022-09-21,09:00:00,322,206,116,FMN 01 Ernest Van Dijckkaai
649,Ernest Van Dijckkaai,2022-09-21,10:00:00,207,130,77,FMN 01 Ernest Van Dijckkaai
649,Ernest Van Dijckkaai,2022-09-21,11:00:00,252,132,120,FMN 01 Ernest Van Dijckkaai
649,Ernest Van Dijckkaai,2022-09-21,12:00:00,406,210,196,FMN 01 Ernest Van Dijckkaai
649,Ernest Van Dijckkaai,2022-09-21,13:00:00,372,193,179,FMN 01 Ernest Van Dijckkaai
649,Ernest Van Dijckkaai,2022-09-21,14:00:00,417,195,222,FMN 01 Ernest Van Dijckkaai
649,Ernest Van Dijckkaai,2022-09-21,15:00:00,418,187,231,FMN 01 Ernest Van Dijckkaai
649,Ernest Van Dijckkaai,2022-09-21,16:00:00,676,271,405,FMN 01 Ernest Van Dijckkaai
649,Ernest Van Dijckkaai,2022-09-21,17:00:00,759,341,418,FMN 01 Ernest Van Dijckkaai
649,Ernest Van Dijckkaai,2022-09-21,18:00:00,498,244,254,FMN 01 Ernest Van Dijckkaai
649,Ernest Van Dijckkaai,2022-09-21,19:00:00,281,118,163,FMN 01 Ernest Van Dijckkaai
649,Ernest Van Dijckkaai,2022-09-21,20:00:00,208,113,95,FMN 01 Ernest Van Dijckkaai
649,Ernest Van Dijckkaai,2022-09-21,21:00:00,183,73,110,FMN 01 Ernest Van Dijckkaai
649,Ernest Van Dijckkaai,2022-09-21,22:00:00,202,71,131,FMN 01 Ernest Van Dijckkaai
649,Ernest Van Dijckkaai,2022-09-21,23:00:00,76,34,42,FMN 01 Ernest Van Dijckkaai
649,Ernest Van Dijckkaai,2022-09-22,00:00:00,59,25,34,FMN 01 Ernest Van Dijckkaai
649,Ernest Van Dijckkaai,2022-09-22,01:00:00,33,6,27,FMN 01 Ernest Van Dijckkaai
649,Ernest Van Dijckkaai,2022-09-22,02:00:00,13,6,7,FMN 01 Ernest Van Dijckkaai
649,Ernest Van Dijckkaai,2022-09-22,03:00:00,16,4,12,FMN 01 Ernest Van Dijckkaai
649,Ernest Van Dijckkaai,2022-09-22,04:00:00,65,41,24,FMN 01 Ernest Van Dijckkaai
649,Ernest Van Dijckkaai,2022-09-22,05:00:00,135,91,44,FMN 01 Ernest Van Dijckkaai
649,Ernest Van Dijckkaai,2022-09-22,06:00:00,264,170,94,FMN 01 Ernest Van Dijckkaai
649,Ernest Van Dijckkaai,2022-09-22,07:00:00,483,308,175,FMN 01 Ernest Van Dijckkaai
649,Ernest Van Dijckkaai,2022-09-22,08:00:00,709,425,284,FMN 01 Ernest Van Dijckkaai
649,Ernest Van Dijckkaai,2022-09-22,09:00:00,337,205,132,FMN 01 Ernest Van Dijckkaai
649,Ernest Van Dijckkaai,2022-09-22,10:00:00,267,139,128,FMN 01 Ernest Van Dijckkaai
649,Ernest Van Dijckkaai,2022-09-22,11:00:00,236,115,121,FMN 01 Ernest Van Dijckkaai
649,Ernest Van Dijckkaai,2022-09-22,12:00:00,405,216,189,FMN 01 Ernest Van Dijckkaai
649,Ernest Van Dijckkaai,2022-09-22,13:00:00,373,198,175,FMN 01 Ernest Van Dijckkaai
649,Ernest Van Dijckkaai,2022-09-22,14:00:00,494,248,246,FMN 01 Ernest Van Dijckkaai
649,Ernest Van Dijckkaai,2022-09-22,15:00:00,581,304,277,FMN 01 Ernest Van Dijckkaai
649,Ernest Van Dijckkaai,2022-09-22,16:00:00,748,298,450,FMN 01 Ernest Van Dijckkaai
649,Ernest Van Dijckkaai,2022-09-22,17:00:00,816,369,447,FMN 01 Ernest Van Dijckkaai
649,Ernest Van Dijckkaai,2022-09-22,18:00:00,566,298,268,FMN 01 Ernest Van Dijckkaai
649,Ernest Van Dijckkaai,2022-09-22,19:00:00,322,160,162,FMN 01 Ernest Van Dijckkaai
649,Ernest Van Dijckkaai,2022-09-22,20:00:00,205,93,112,FMN 01 Ernest Van Dijckkaai
649,Ernest Van Dijckkaai,2022-09-22,21:00:00,170,86,84,FMN 01 Ernest Van Dijckkaai
649,Ernest Van Dijckkaai,2022-09-22,22:00:00,190,76,114,FMN 01 Ernest Van Dijckkaai
649,Ernest Van Dijckkaai,2022-09-22,23:00:00,103,55,48,FMN 01 Ernest Van Dijckkaai
649,Ernest Van Dijckkaai,2022-09-23,00:00:00,64,36,28,FMN 01 Ernest Van Dijckkaai
649,Ernest Van Dijckkaai,2022-09-23,01:00:00,49,29,20,FMN 01 Ernest Van Dijckkaai
649,Ernest Van Dijckkaai,2022-09-23,02:00:00,33,9,24,FMN 01 Ernest Van Dijckkaai
649,Ernest Van Dijckkaai,2022-09-23,03:00:00,44,7,37,FMN 01 Ernest Van Dijckkaai
649,Ernest Van Dijckkaai,2022-09-23,04:00:00,70,33,37,FMN 01 Ernest Van Dijckkaai
649,Ernest Van Dijckkaai,2022-09-23,05:00:00,120,80,40,FMN 01 Ernest Van Dijckkaai
649,Ernest Van Dijckkaai,2022-09-23,06:00:00,230,140,90,FMN 01 Ernest Van Dijckkaai
649,Ernest Van Dijckkaai,2022-09-23,07:00:00,393,241,152,FMN 01 Ernest Van Dijckkaai
649,Ernest Van Dijckkaai,2022-09-23,08:00:00,545,336,209,FMN 01 Ernest Van Dijckkaai
649,Ernest Van Dijckkaai,2022-09-23,09:00:00,356,230,126,FMN 01 Ernest Van Dijckkaai
649,Ernest Van Dijckkaai,2022-09-23,10:00:00,263,150,113,FMN 01 Ernest Van Dijckkaai
649,Ernest Van Dijckkaai,2022-09-23,11:00:00,268,141,127,FMN 01 Ernest Van Dijckkaai
649,Ernest Van Dijckkaai,2022-09-23,12:00:00,327,170,157,FMN 01 Ernest Van Dijckkaai
649,Ernest Van Dijckkaai,2022-09-23,13:00:00,313,177,136,FMN 01 Ernest Van Dijckkaai
649,Ernest Van Dijckkaai,2022-09-23,14:00:00,356,172,184,FMN 01 Ernest Van Dijckkaai
649,Ernest Van Dijckkaai,2022-09-23,15:00:00,461,201,260,FMN 01 Ernest Van Dijckkaai
649,Ernest Van Dijckkaai,2022-09-23,16:00:00,645,255,390,FMN 01 Ernest Van Dijckkaai
649,Ernest Van Dijckkaai,2022-09-23,17:00:00,526,210,316,FMN 01 Ernest Van Dijckkaai
649,Ernest Van Dijckkaai,2022-09-23,18:00:00,322,154,168,FMN 01 Ernest Van Dijckkaai
649,Ernest Van Dijckkaai,2022-09-23,19:00:00,167,84,83,FMN 01 Ernest Van Dijckkaai
649,Ernest Van Dijckkaai,2022-09-23,20:00:00,163,100,63,FMN 01 Ernest Van Dijckkaai
649,Ernest Van Dijckkaai,2022-09-23,21:00:00,127,77,50,FMN 01 Ernest Van Dijckkaai
649,Ernest Van Dijckkaai,2022-09-23,22:00:00,144,59,85,FMN 01 Ernest Van Dijckkaai
649,Ernest Van Dijckkaai,2022-09-23,23:00:00,113,30,83,FMN 01 Ernest Van Dijckkaai
649,Ernest Van Dijckkaai,2022-09-24,00:00:00,70,36,34,FMN 01 Ernest Van Dijckkaai
649,Ernest Van Dijckkaai,2022-09-24,01:00:00,52,23,29,FMN 01 Ernest Van Dijckkaai
649,Ernest Van Dijckkaai,2022-09-24,02:00:00,60,32,28,FMN 01 Ernest Van Dijckkaai
649,Ernest Van Dijckkaai,2022-09-24,03:00:00,40,15,25,FMN 01 Ernest Van Dijckkaai
649,Ernest Van Dijckkaai,2022-09-24,04:00:00,44,32,12,FMN 01 Ernest Van Dijckkaai
649,Ernest Van Dijckkaai,2022-09-24,05:00:00,41,21,20,FMN 01 Ernest Van Dijckkaai
649,Ernest Van Dijckkaai,2022-09-24,06:00:00,31,15,16,FMN 01 Ernest Van Dijckkaai
649,Ernest Van Dijckkaai,2022-09-24,07:00:00,23,9,14,FMN 01 Ernest Van Dijckkaai
649,Ernest Van Dijckkaai,2022-09-24,08:00:00,80,49,31,FMN 01 Ernest Van Dijckkaai
649,Ernest Van Dijckkaai,2022-09-24,09:00:00,111,63,48,FMN 01 Ernest Van Dijckkaai
649,Ernest Van Dijckkaai,2022-09-24,10:00:00,105,54,51,FMN 01 Ernest Van Dijckkaai
649,Ernest Van Dijckkaai,2022-09-24,11:00:00,115,61,54,FMN 01 Ernest Van Dijckkaai
649,Ernest Van Dijckkaai,2022-09-24,12:00:00,147,77,70,FMN 01 Ernest Van Dijckkaai
649,Ernest Van Dijckkaai,2022-09-24,13:00:00,188,99,89,FMN 01 Ernest Van Dijckkaai
649,Ernest Van Dijckkaai,2022-09-24,14:00:00,179,82,97,FMN 01 Ernest Van Dijckkaai
649,Ernest Van Dijckkaai,2022-09-24,15:00:00,166,75,91,FMN 01 Ernest Van Dijckkaai
649,Ernest Van Dijckkaai,2022-09-24,16:00:00,185,98,87,FMN 01 Ernest Van Dijckkaai
649,Ernest Van Dijckkaai,2022-09-24,17:00:00,207,107,100,FMN 01 Ernest Van Dijckkaai
649,Ernest Van Dijckkaai,2022-09-24,18:00:00,167,87,80,FMN 01 Ernest Van Dijckkaai
649,Ernest Van Dijckkaai,2022-09-24,19:00:00,147,60,87,FMN 01 Ernest Van Dijckkaai
649,Ernest Van Dijckkaai,2022-09-24,20:00:00,133,62,71,FMN 01 Ernest Van Dijckkaai
649,Ernest Van Dijckkaai,2022-09-24,21:00:00,103,47,56,FMN 01 Ernest Van Dijckkaai
649,Ernest Van Dijckkaai,2022-09-24,22:00:00,113,50,63,FMN 01 Ernest Van Dijckkaai
649,Ernest Van Dijckkaai,2022-09-24,23:00:00,137,80,57,FMN 01 Ernest Van Dijckkaai
649,Ernest Van Dijckkaai,2022-09-25,00:00:00,107,70,37,FMN 01 Ernest Van Dijckkaai
649,Ernest Van Dijckkaai,2022-09-25,01:00:00,82,49,33,FMN 01 Ernest Van Dijckkaai
649,Ernest Van Dijckkaai,2022-09-25,02:00:00,56,27,29,FMN 01 Ernest Van Dijckkaai
649,Ernest Van Dijckkaai,2022-09-25,03:00:00,43,18,25,FMN 01 Ernest Van Dijckkaai
649,Ernest Van Dijckkaai,2022-09-25,04:00:00,50,12,38,FMN 01 Ernest Van Dijckkaai
649,Ernest Van Dijckkaai,2022-09-25,05:00:00,35,18,17,FMN 01 Ernest Van Dijckkaai
649,Ernest Van Dijckkaai,2022-09-25,06:00:00,40,14,26,FMN 01 Ernest Van Dijckkaai
649,Ernest Van Dijckkaai,2022-09-25,07:00:00,21,8,13,FMN 01 Ernest Van Dijckkaai
649,Ernest Van Dijckkaai,2022-09-25,08:00:00,55,37,18,FMN 01 Ernest Van Dijckkaai
649,Ernest Van Dijckkaai,2022-09-25,09:00:00,120,66,54,FMN 01 Ernest Van Dijckkaai
649,Ernest Van Dijckkaai,2022-09-25,10:00:00,211,97,114,FMN 01 Ernest Van Dijckkaai
649,Ernest Van Dijckkaai,2022-09-25,11:00:00,322,177,145,FMN 01 Ernest Van Dijckkaai
649,Ernest Van Dijckkaai,2022-09-25,12:00:00,386,198,188,FMN 01 Ernest Van Dijckkaai
649,Ernest Van Dijckkaai,2022-09-25,13:00:00,429,221,208,FMN 01 Ernest Van Dijckkaai
649,Ernest Van Dijckkaai,2022-09-25,14:00:00,499,236,263,FMN 01 Ernest Van Dijckkaai
649,Ernest Van Dijckkaai,2022-09-25,15:00:00,476,247,229,FMN 01 Ernest Van Dijckkaai
649,Ernest Van Dijckkaai,2022-09-25,16:00:00,531,303,228,FMN 01 Ernest Van Dijckkaai
649,Ernest Van Dijckkaai,2022-09-25,17:00:00,427,225,202,FMN 01 Ernest Van Dijckkaai
649,Ernest Van Dijckkaai,2022-09-25,18:00:00,320,145,175,FMN 01 Ernest Van Dijckkaai
649,Ernest Van Dijckkaai,2022-09-25,19:00:00,196,103,93,FMN 01 Ernest Van Dijckkaai
649,Ernest Van Dijckkaai,2022-09-25,20:00:00,139,74,65,FMN 01 Ernest Van Dijckkaai
649,Ernest Van Dijckkaai,2022-09-25,21:00:00,116,54,62,FMN 01 Ernest Van Dijckkaai
649,Ernest Van Dijckkaai,2022-09-25,22:00:00,90,46,44,FMN 01 Ernest Van Dijckkaai
649,Ernest Van Dijckkaai,2022-09-25,23:00:00,45,23,22,FMN 01 Ernest Van Dijckkaai
649,Ernest Van Dijckkaai,2022-09-26,00:00:00,20,10,10,FMN 01 Ernest Van Dijckkaai
649,Ernest Van Dijckkaai,2022-09-26,01:00:00,11,2,9,FMN 01 Ernest Van Dijckkaai
649,Ernest Van Dijckkaai,2022-09-26,02:00:00,4,0,4,FMN 01 Ernest Van Dijckkaai
649,Ernest Van Dijckkaai,2022-09-26,03:00:00,6,1,5,FMN 01 Ernest Van Dijckkaai
649,Ernest Van Dijckkaai,2022-09-26,04:00:00,49,33,16,FMN 01 Ernest Van Dijckkaai
649,Ernest Van Dijckkaai,2022-09-26,05:00:00,110,82,28,FMN 01 Ernest Van Dijckkaai
649,Ernest Van Dijckkaai,2022-09-26,06:00:00,206,136,70,FMN 01 Ernest Van Dijckkaai
649,Ernest Van Dijckkaai,2022-09-26,07:00:00,399,267,132,FMN 01 Ernest Van Dijckkaai
649,Ernest Van Dijckkaai,2022-09-26,08:00:00,553,341,212,FMN 01 Ernest Van Dijckkaai
649,Ernest Van Dijckkaai,2022-09-26,09:00:00,249,171,78,FMN 01 Ernest Van Dijckkaai
649,Ernest Van Dijckkaai,2022-09-26,10:00:00,124,71,53,FMN 01 Ernest Van Dijckkaai
649,Ernest Van Dijckkaai,2022-09-26,11:00:00,85,46,39,FMN 01 Ernest Van Dijckkaai
649,Ernest Van Dijckkaai,2022-09-26,12:00:00,174,80,94,FMN 01 Ernest Van Dijckkaai
649,Ernest Van Dijckkaai,2022-09-26,13:00:00,154,82,72,FMN 01 Ernest Van Dijckkaai
649,Ernest Van Dijckkaai,2022-09-26,14:00:00,181,68,113,FMN 01 Ernest Van Dijckkaai
649,Ernest Van Dijckkaai,2022-09-26,15:00:00,221,98,123,FMN 01 Ernest Van Dijckkaai
649,Ernest Van Dijckkaai,2022-09-26,16:00:00,424,141,283,FMN 01 Ernest Van Dijckkaai
649,Ernest Van Dijckkaai,2022-09-26,17:00:00,431,179,252,FMN 01 Ernest Van Dijckkaai
649,Ernest Van Dijckkaai,2022-09-26,18:00:00,322,143,179,FMN 01 Ernest Van Dijckkaai
649,Ernest Van Dijckkaai,2022-09-26,19:00:00,159,67,92,FMN 01 Ernest Van Dijckkaai
649,Ernest Van Dijckkaai,2022-09-26,20:00:00,82,33,49,FMN 01 Ernest Van Dijckkaai
649,Ernest Van Dijckkaai,2022-09-26,21:00:00,98,46,52,FMN 01 Ernest Van Dijckkaai
649,Ernest Van Dijckkaai,2022-09-26,22:00:00,89,28,61,FMN 01 Ernest Van Dijckkaai
649,Ernest Van Dijckkaai,2022-09-26,23:00:00,42,14,28,FMN 01 Ernest Van Dijckkaai
649,Ernest Van Dijckkaai,2022-09-27,00:00:00,20,8,12,FMN 01 Ernest Van Dijckkaai
649,Ernest Van Dijckkaai,2022-09-27,01:00:00,12,4,8,FMN 01 Ernest Van Dijckkaai
649,Ernest Van Dijckkaai,2022-09-27,02:00:00,4,1,3,FMN 01 Ernest Van Dijckkaai
649,Ernest Van Dijckkaai,2022-09-27,03:00:00,11,3,8,FMN 01 Ernest Van Dijckkaai
649,Ernest Van Dijckkaai,2022-09-27,04:00:00,41,31,10,FMN 01 Ernest Van Dijckkaai
649,Ernest Van Dijckkaai,2022-09-27,05:00:00,84,62,22,FMN 01 Ernest Van Dijckkaai
649,Ernest Van Dijckkaai,2022-09-27,06:00:00,176,110,66,FMN 01 Ernest Van Dijckkaai
649,Ernest Van Dijckkaai,2022-09-27,07:00:00,363,234,129,FMN 01 Ernest Van Dijckkaai
649,Ernest Van Dijckkaai,2022-09-27,08:00:00,504,313,191,FMN 01 Ernest Van Dijckkaai
649,Ernest Van Dijckkaai,2022-09-27,09:00:00,236,169,67,FMN 01 Ernest Van Dijckkaai
649,Ernest Van Dijckkaai,2022-09-27,10:00:00,124,84,40,FMN 01 Ernest Van Dijckkaai
649,Ernest Van Dijckkaai,2022-09-27,11:00:00,81,45,36,FMN 01 Ernest Van Dijckkaai
649,Ernest Van Dijckkaai,2022-09-27,12:00:00,232,129,103,FMN 01 Ernest Van Dijckkaai
649,Ernest Van Dijckkaai,2022-09-27,13:00:00,207,116,91,FMN 01 Ernest Van Dijckkaai
649,Ernest Van Dijckkaai,2022-09-27,14:00:00,195,80,115,FMN 01 Ernest Van Dijckkaai
649,Ernest Van Dijckkaai,2022-09-27,15:00:00,258,123,135,FMN 01 Ernest Van Dijckkaai
649,Ernest Van Dijckkaai,2022-09-27,16:00:00,417,159,258,FMN 01 Ernest Van Dijckkaai
649,Ernest Van Dijckkaai,2022-09-27,17:00:00,480,196,284,FMN 01 Ernest Van Dijckkaai
649,Ernest Van Dijckkaai,2022-09-27,18:00:00,302,127,175,FMN 01 Ernest Van Dijckkaai
649,Ernest Van Dijckkaai,2022-09-27,19:00:00,174,89,85,FMN 01 Ernest Van Dijckkaai
649,Ernest Van Dijckkaai,2022-09-27,20:00:00,89,40,49,FMN 01 Ernest Van Dijckkaai
649,Ernest Van Dijckkaai,2022-09-27,21:00:00,93,37,56,FMN 01 Ernest Van Dijckkaai
649,Ernest Van Dijckkaai,2022-09-27,22:00:00,114,43,71,FMN 01 Ernest Van Dijckkaai
649,Ernest Van Dijckkaai,2022-09-27,23:00:00,56,29,27,FMN 01 Ernest Van Dijckkaai
649,Ernest Van Dijckkaai,2022-09-28,00:00:00,23,14,9,FMN 01 Ernest Van Dijckkaai
649,Ernest Van Dijckkaai,2022-09-28,01:00:00,11,6,5,FMN 01 Ernest Van Dijckkaai
649,Ernest Van Dijckkaai,2022-09-28,02:00:00,8,1,7,FMN 01 Ernest Van Dijckkaai
649,Ernest Van Dijckkaai,2022-09-28,03:00:00,3,1,2,FMN 01 Ernest Van Dijckkaai
649,Ernest Van Dijckkaai,2022-09-28,04:00:00,46,30,16,FMN 01 Ernest Van Dijckkaai
649,Ernest Van Dijckkaai,2022-09-28,05:00:00,91,62,29,FMN 01 Ernest Van Dijckkaai
649,Ernest Van Dijckkaai,2022-09-28,06:00:00,207,136,71,FMN 01 Ernest Van Dijckkaai
649,Ernest Van Dijckkaai,2022-09-28,07:00:00,425,275,150,FMN 01 Ernest Van Dijckkaai
649,Ernest Van Dijckkaai,2022-09-28,08:00:00,510,315,195,FMN 01 Ernest Van Dijckkaai
649,Ernest Van Dijckkaai,2022-09-28,09:00:00,242,165,77,FMN 01 Ernest Van Dijckkaai
649,Ernest Van Dijckkaai,2022-09-28,10:00:00,174,93,81,FMN 01 Ernest Van Dijckkaai
649,Ernest Van Dijckkaai,2022-09-28,11:00:00,174,96,78,FMN 01 Ernest Van Dijckkaai
649,Ernest Van Dijckkaai,2022-09-28,12:00:00,302,151,151,FMN 01 Ernest Van Dijckkaai
649,Ernest Van Dijckkaai,2022-09-28,13:00:00,290,148,142,FMN 01 Ernest Van Dijckkaai
649,Ernest Van Dijckkaai,2022-09-28,14:00:00,213,79,134,FMN 01 Ernest Van Dijckkaai
649,Ernest Van Dijckkaai,2022-09-28,15:00:00,254,108,146,FMN 01 Ernest Van Dijckkaai
649,Ernest Van Dijckkaai,2022-09-28,16:00:00,512,201,311,FMN 01 Ernest Van Dijckkaai
649,Ernest Van Dijckkaai,2022-09-28,17:00:00,539,238,301,FMN 01 Ernest Van Dijckkaai
649,Ernest Van Dijckkaai,2022-09-28,18:00:00,380,179,201,FMN 01 Ernest Van Dijckkaai
649,Ernest Van Dijckkaai,2022-09-28,19:00:00,220,115,105,FMN 01 Ernest Van Dijckkaai
649,Ernest Van Dijckkaai,2022-09-28,20:00:00,152,66,86,FMN 01 Ernest Van Dijckkaai
649,Ernest Van Dijckkaai,2022-09-28,21:00:00,122,57,65,FMN 01 Ernest Van Dijckkaai
649,Ernest Van Dijckkaai,2022-09-28,22:00:00,161,53,108,FMN 01 Ernest Van Dijckkaai
649,Ernest Van Dijckkaai,2022-09-28,23:00:00,64,22,42,FMN 01 Ernest Van Dijckkaai
649,Ernest Van Dijckkaai,2022-09-29,00:00:00,44,26,18,FMN 01 Ernest Van Dijckkaai
649,Ernest Van Dijckkaai,2022-09-29,01:00:00,20,8,12,FMN 01 Ernest Van Dijckkaai
649,Ernest Van Dijckkaai,2022-09-29,02:00:00,7,2,5,FMN 01 Ernest Van Dijckkaai
649,Ernest Van Dijckkaai,2022-09-29,03:00:00,17,4,13,FMN 01 Ernest Van Dijckkaai
649,Ernest Van Dijckkaai,2022-09-29,04:00:00,46,29,17,FMN 01 Ernest Van Dijckkaai
649,Ernest Van Dijckkaai,2022-09-29,05:00:00,128,85,43,FMN 01 Ernest Van Dijckkaai
649,Ernest Van Dijckkaai,2022-09-29,06:00:00,272,169,103,FMN 01 Ernest Van Dijckkaai
649,Ernest Van Dijckkaai,2022-09-29,07:00:00,413,248,165,FMN 01 Ernest Van Dijckkaai
649,Ernest Van Dijckkaai,2022-09-29,08:00:00,603,354,249,FMN 01 Ernest Van Dijckkaai
649,Ernest Van Dijckkaai,2022-09-29,09:00:00,283,162,121,FMN 01 Ernest Van Dijckkaai
649,Ernest Van Dijckkaai,2022-09-29,10:00:00,207,109,98,FMN 01 Ernest Van Dijckkaai
649,Ernest Van Dijckkaai,2022-09-29,11:00:00,209,115,94,FMN 01 Ernest Van Dijckkaai
649,Ernest Van Dijckkaai,2022-09-29,12:00:00,346,170,176,FMN 01 Ernest Van Dijckkaai
649,Ernest Van Dijckkaai,2022-09-29,13:00:00,286,155,131,FMN 01 Ernest Van Dijckkaai
649,Ernest Van Dijckkaai,2022-09-29,14:00:00,480,231,249,FMN 01 Ernest Van Dijckkaai
649,Ernest Van Dijckkaai,2022-09-29,15:00:00,429,211,218,FMN 01 Ernest Van Dijckkaai
649,Ernest Van Dijckkaai,2022-09-29,16:00:00,572,252,320,FMN 01 Ernest Van Dijckkaai
649,Ernest Van Dijckkaai,2022-09-29,17:00:00,606,312,294,FMN 01 Ernest Van Dijckkaai
649,Ernest Van Dijckkaai,2022-09-29,18:00:00,402,185,217,FMN 01 Ernest Van Dijckkaai
649,Ernest Van Dijckkaai,2022-09-29,19:00:00,236,102,134,FMN 01 Ernest Van Dijckkaai
649,Ernest Van Dijckkaai,2022-09-29,20:00:00,190,93,97,FMN 01 Ernest Van Dijckkaai
649,Ernest Van Dijckkaai,2022-09-29,21:00:00,198,67,131,FMN 01 Ernest Van Dijckkaai
649,Ernest Van Dijckkaai,2022-09-29,22:00:00,188,71,117,FMN 01 Ernest Van Dijckkaai
649,Ernest Van Dijckkaai,2022-09-29,23:00:00,113,49,64,FMN 01 Ernest Van Dijckkaai
649,Ernest Van Dijckkaai,2022-09-30,00:00:00,66,23,43,FMN 01 Ernest Van Dijckkaai
649,Ernest Van Dijckkaai,2022-09-30,01:00:00,60,16,44,FMN 01 Ernest Van Dijckkaai
649,Ernest Van Dijckkaai,2022-09-30,02:00:00,28,11,17,FMN 01 Ernest Van Dijckkaai
649,Ernest Van Dijckkaai,2022-09-30,03:00:00,37,3,34,FMN 01 Ernest Van Dijckkaai
649,Ernest Van Dijckkaai,2022-09-30,04:00:00,53,25,28,FMN 01 Ernest Van Dijckkaai
649,Ernest Van Dijckkaai,2022-09-30,05:00:00,120,76,44,FMN 01 Ernest Van Dijckkaai
649,Ernest Van Dijckkaai,2022-09-30,06:00:00,239,149,90,FMN 01 Ernest Van Dijckkaai
649,Ernest Van Dijckkaai,2022-09-30,07:00:00,340,221,119,FMN 01 Ernest Van Dijckkaai
649,Ernest Van Dijckkaai,2022-09-30,08:00:00,563,353,210,FMN 01 Ernest Van Dijckkaai
649,Ernest Van Dijckkaai,2022-09-30,09:00:00,302,204,98,FMN 01 Ernest Van Dijckkaai
649,Ernest Van Dijckkaai,2022-09-30,10:00:00,244,149,95,FMN 01 Ernest Van Dijckkaai
649,Ernest Van Dijckkaai,2022-09-30,11:00:00,252,148,104,FMN 01 Ernest Van Dijckkaai
649,Ernest Van Dijckkaai,2022-09-30,12:00:00,392,209,183,FMN 01 Ernest Van Dijckkaai
649,Ernest Van Dijckkaai,2022-09-30,13:00:00,367,207,160,FMN 01 Ernest Van Dijckkaai
649,Ernest Van Dijckkaai,2022-09-30,14:00:00,426,203,223,FMN 01 Ernest Van Dijckkaai
649,Ernest Van Dijckkaai,2022-09-30,15:00:00,501,266,235,FMN 01 Ernest Van Dijckkaai
649,Ernest Van Dijckkaai,2022-09-30,16:00:00,647,275,372,FMN 01 Ernest Van Dijckkaai
649,Ernest Van Dijckkaai,2022-09-30,17:00:00,610,292,318,FMN 01 Ernest Van Dijckkaai
649,Ernest Van Dijckkaai,2022-09-30,18:00:00,439,193,246,FMN 01 Ernest Van Dijckkaai
649,Ernest Van Dijckkaai,2022-09-30,19:00:00,272,157,115,FMN 01 Ernest Van Dijckkaai
649,Ernest Van Dijckkaai,2022-09-30,20:00:00,174,91,83,FMN 01 Ernest Van Dijckkaai
649,Ernest Van Dijckkaai,2022-09-30,21:00:00,169,92,77,FMN 01 Ernest Van Dijckkaai
649,Ernest Van Dijckkaai,2022-09-30,22:00:00,173,66,107,FMN 01 Ernest Van Dijckkaai
649,Ernest Van Dijckkaai,2022-09-30,23:00:00,116,56,60,FMN 01 Ernest Van Dijckkaai
649,Ernest Van Dijckkaai,2022-10-01,00:00:00,62,26,36,FMN 01 Ernest Van Dijckkaai
649,Ernest Van Dijckkaai,2022-10-01,01:00:00,62,28,34,FMN 01 Ernest Van Dijckkaai
649,Ernest Van Dijckkaai,2022-10-01,02:00:00,42,4,38,FMN 01 Ernest Van Dijckkaai
649,Ernest Van Dijckkaai,2022-10-01,03:00:00,45,10,35,FMN 01 Ernest Van Dijckkaai
649,Ernest Van Dijckkaai,2022-10-01,04:00:00,39,14,25,FMN 01 Ernest Van Dijckkaai
649,Ernest Van Dijckkaai,2022-10-01,05:00:00,42,28,14,FMN 01 Ernest Van Dijckkaai
649,Ernest Van Dijckkaai,2022-10-01,06:00:00,37,17,20,FMN 01 Ernest Van Dijckkaai
649,Ernest Van Dijckkaai,2022-10-01,07:00:00,42,16,26,FMN 01 Ernest Van Dijckkaai
649,Ernest Van Dijckkaai,2022-10-01,08:00:00,44,27,17,FMN 01 Ernest Van Dijckkaai
649,Ernest Van Dijckkaai,2022-10-01,09:00:00,91,56,35,FMN 01 Ernest Van Dijckkaai
649,Ernest Van Dijckkaai,2022-10-01,10:00:00,125,74,51,FMN 01 Ernest Van Dijckkaai
649,Ernest Van Dijckkaai,2022-10-01,11:00:00,142,86,56,FMN 01 Ernest Van Dijckkaai
649,Ernest Van Dijckkaai,2022-10-01,12:00:00,170,86,84,FMN 01 Ernest Van Dijckkaai
649,Ernest Van Dijckkaai,2022-10-01,13:00:00,207,114,93,FMN 01 Ernest Van Dijckkaai
649,Ernest Van Dijckkaai,2022-10-01,14:00:00,242,127,115,FMN 01 Ernest Van Dijckkaai
649,Ernest Van Dijckkaai,2022-10-01,15:00:00,318,198,120,FMN 01 Ernest Van Dijckkaai
649,Ernest Van Dijckkaai,2022-10-01,16:00:00,279,152,127,FMN 01 Ernest Van Dijckkaai
649,Ernest Van Dijckkaai,2022-10-01,17:00:00,311,160,151,FMN 01 Ernest Van Dijckkaai
649,Ernest Van Dijckkaai,2022-10-01,18:00:00,271,138,133,FMN 01 Ernest Van Dijckkaai
649,Ernest Van Dijckkaai,2022-10-01,19:00:00,213,107,106,FMN 01 Ernest Van Dijckkaai
649,Ernest Van Dijckkaai,2022-10-01,20:00:00,183,100,83,FMN 01 Ernest Van Dijckkaai
649,Ernest Van Dijckkaai,2022-10-01,21:00:00,136,73,63,FMN 01 Ernest Van Dijckkaai
649,Ernest Van Dijckkaai,2022-10-01,22:00:00,152,72,80,FMN 01 Ernest Van Dijckkaai
649,Ernest Van Dijckkaai,2022-10-01,23:00:00,159,50,109,FMN 01 Ernest Van Dijckkaai
649,Ernest Van Dijckkaai,2022-10-02,00:00:00,131,62,69,FMN 01 Ernest Van Dijckkaai
649,Ernest Van Dijckkaai,2022-10-02,01:00:00,89,40,49,FMN 01 Ernest Van Dijckkaai
649,Ernest Van Dijckkaai,2022-10-02,02:00:00,73,25,48,FMN 01 Ernest Van Dijckkaai
649,Ernest Van Dijckkaai,2022-10-02,03:00:00,54,8,46,FMN 01 Ernest Van Dijckkaai
649,Ernest Van Dijckkaai,2022-10-02,04:00:00,38,5,33,FMN 01 Ernest Van Dijckkaai
649,Ernest Van Dijckkaai,2022-10-02,05:00:00,18,9,9,FMN 01 Ernest Van Dijckkaai
649,Ernest Van Dijckkaai,2022-10-02,06:00:00,34,16,18,FMN 01 Ernest Van Dijckkaai
649,Ernest Van Dijckkaai,2022-10-02,07:00:00,37,11,26,FMN 01 Ernest Van Dijckkaai
649,Ernest Van Dijckkaai,2022-10-02,08:00:00,47,25,22,FMN 01 Ernest Van Dijckkaai
649,Ernest Van Dijckkaai,2022-10-02,09:00:00,118,57,61,FMN 01 Ernest Van Dijckkaai
649,Ernest Van Dijckkaai,2022-10-02,10:00:00,148,87,61,FMN 01 Ernest Van Dijckkaai
649,Ernest Van Dijckkaai,2022-10-02,11:00:00,199,122,77,FMN 01 Ernest Van Dijckkaai
649,Ernest Van Dijckkaai,2022-10-02,12:00:00,283,154,129,FMN 01 Ernest Van Dijckkaai
649,Ernest Van Dijckkaai,2022-10-02,13:00:00,264,151,113,FMN 01 Ernest Van Dijckkaai
649,Ernest Van Dijckkaai,2022-10-02,14:00:00,285,148,137,FMN 01 Ernest Van Dijckkaai
649,Ernest Van Dijckkaai,2022-10-02,15:00:00,347,174,173,FMN 01 Ernest Van Dijckkaai
649,Ernest Van Dijckkaai,2022-10-02,16:00:00,300,141,159,FMN 01 Ernest Van Dijckkaai
649,Ernest Van Dijckkaai,2022-10-02,17:00:00,344,174,170,FMN 01 Ernest Van Dijckkaai
649,Ernest Van Dijckkaai,2022-10-02,18:00:00,256,119,137,FMN 01 Ernest Van Dijckkaai
649,Ernest Van Dijckkaai,2022-10-02,19:00:00,177,85,92,FMN 01 Ernest Van Dijckkaai
649,Ernest Van Dijckkaai,2022-10-02,20:00:00,110,66,44,FMN 01 Ernest Van Dijckkaai
649,Ernest Van Dijckkaai,2022-10-02,21:00:00,122,69,53,FMN 01 Ernest Van Dijckkaai
649,Ernest Van Dijckkaai,2022-10-02,22:00:00,85,32,53,FMN 01 Ernest Van Dijckkaai
649,Ernest Van Dijckkaai,2022-10-02,23:00:00,59,24,35,FMN 01 Ernest Van Dijckkaai
649,Ernest Van Dijckkaai,2022-10-03,00:00:00,23,8,15,FMN 01 Ernest Van Dijckkaai
649,Ernest Van Dijckkaai,2022-10-03,01:00:00,6,2,4,FMN 01 Ernest Van Dijckkaai
649,Ernest Van Dijckkaai,2022-10-03,02:00:00,9,2,7,FMN 01 Ernest Van Dijckkaai
649,Ernest Van Dijckkaai,2022-10-03,03:00:00,3,1,2,FMN 01 Ernest Van Dijckkaai
649,Ernest Van Dijckkaai,2022-10-03,04:00:00,51,31,20,FMN 01 Ernest Van Dijckkaai
649,Ernest Van Dijckkaai,2022-10-03,05:00:00,120,89,31,FMN 01 Ernest Van Dijckkaai
649,Ernest Van Dijckkaai,2022-10-03,06:00:00,241,156,85,FMN 01 Ernest Van Dijckkaai
649,Ernest Van Dijckkaai,2022-10-03,07:00:00,438,290,148,FMN 01 Ernest Van Dijckkaai
649,Ernest Van Dijckkaai,2022-10-03,08:00:00,585,345,240,FMN 01 Ernest Van Dijckkaai
649,Ernest Van Dijckkaai,2022-10-03,09:00:00,245,167,78,FMN 01 Ernest Van Dijckkaai
649,Ernest Van Dijckkaai,2022-10-03,10:00:00,205,114,91,FMN 01 Ernest Van Dijckkaai
649,Ernest Van Dijckkaai,2022-10-03,11:00:00,233,117,116,FMN 01 Ernest Van Dijckkaai
649,Ernest Van Dijckkaai,2022-10-03,12:00:00,307,171,136,FMN 01 Ernest Van Dijckkaai
649,Ernest Van Dijckkaai,2022-10-03,13:00:00,302,168,134,FMN 01 Ernest Van Dijckkaai
649,Ernest Van Dijckkaai,2022-10-03,14:00:00,323,139,184,FMN 01 Ernest Van Dijckkaai
649,Ernest Van Dijckkaai,2022-10-03,15:00:00,411,208,203,FMN 01 Ernest Van Dijckkaai
649,Ernest Van Dijckkaai,2022-10-03,16:00:00,633,244,389,FMN 01 Ernest Van Dijckkaai
649,Ernest Van Dijckkaai,2022-10-03,17:00:00,706,306,400,FMN 01 Ernest Van Dijckkaai
649,Ernest Van Dijckkaai,2022-10-03,18:00:00,469,209,260,FMN 01 Ernest Van Dijckkaai
649,Ernest Van Dijckkaai,2022-10-03,19:00:00,250,117,133,FMN 01 Ernest Van Dijckkaai
649,Ernest Van Dijckkaai,2022-10-03,20:00:00,138,68,70,FMN 01 Ernest Van Dijckkaai
649,Ernest Van Dijckkaai,2022-10-03,21:00:00,170,65,105,FMN 01 Ernest Van Dijckkaai
649,Ernest Van Dijckkaai,2022-10-03,22:00:00,177,59,118,FMN 01 Ernest Van Dijckkaai
649,Ernest Van Dijckkaai,2022-10-03,23:00:00,49,21,28,FMN 01 Ernest Van Dijckkaai
649,Ernest Van Dijckkaai,2022-10-04,00:00:00,19,7,12,FMN 01 Ernest Van Dijckkaai
649,Ernest Van Dijckkaai,2022-10-04,01:00:00,22,4,18,FMN 01 Ernest Van Dijckkaai
649,Ernest Van Dijckkaai,2022-10-04,02:00:00,7,3,4,FMN 01 Ernest Van Dijckkaai
649,Ernest Van Dijckkaai,2022-10-04,03:00:00,9,1,8,FMN 01 Ernest Van Dijckkaai
649,Ernest Van Dijckkaai,2022-10-04,04:00:00,52,34,18,FMN 01 Ernest Van Dijckkaai
649,Ernest Van Dijckkaai,2022-10-04,05:00:00,115,74,41,FMN 01 Ernest Van Dijckkaai
649,Ernest Van Dijckkaai,2022-10-04,06:00:00,312,205,107,FMN 01 Ernest Van Dijckkaai
649,Ernest Van Dijckkaai,2022-10-04,07:00:00,525,319,206,FMN 01 Ernest Van Dijckkaai
649,Ernest Van Dijckkaai,2022-10-04,08:00:00,741,469,272,FMN 01 Ernest Van Dijckkaai
649,Ernest Van Dijckkaai,2022-10-04,09:00:00,378,243,135,FMN 01 Ernest Van Dijckkaai
649,Ernest Van Dijckkaai,2022-10-04,10:00:00,238,145,93,FMN 01 Ernest Van Dijckkaai
649,Ernest Van Dijckkaai,2022-10-04,11:00:00,213,112,101,FMN 01 Ernest Van Dijckkaai
649,Ernest Van Dijckkaai,2022-10-04,12:00:00,392,222,170,FMN 01 Ernest Van Dijckkaai
649,Ernest Van Dijckkaai,2022-10-04,13:00:00,380,185,195,FMN 01 Ernest Van Dijckkaai
649,Ernest Van Dijckkaai,2022-10-04,14:00:00,402,196,206,FMN 01 Ernest Van Dijckkaai
649,Ernest Van Dijckkaai,2022-10-04,15:00:00,470,229,241,FMN 01 Ernest Van Dijckkaai
649,Ernest Van Dijckkaai,2022-10-04,16:00:00,786,331,455,FMN 01 Ernest Van Dijckkaai
649,Ernest Van Dijckkaai,2022-10-04,17:00:00,853,327,526,FMN 01 Ernest Van Dijckkaai
649,Ernest Van Dijckkaai,2022-10-04,18:00:00,548,241,307,FMN 01 Ernest Van Dijckkaai
649,Ernest Van Dijckkaai,2022-10-04,19:00:00,267,130,137,FMN 01 Ernest Van Dijckkaai
649,Ernest Van Dijckkaai,2022-10-04,20:00:00,179,77,102,FMN 01 Ernest Van Dijckkaai
649,Ernest Van Dijckkaai,2022-10-04,21:00:00,136,56,80,FMN 01 Ernest Van Dijckkaai
649,Ernest Van Dijckkaai,2022-10-04,22:00:00,201,77,124,FMN 01 Ernest Van Dijckkaai
649,Ernest Van Dijckkaai,2022-10-04,23:00:00,60,29,31,FMN 01 Ernest Van Dijckkaai
649,Ernest Van Dijckkaai,2022-10-05,00:00:00,36,20,16,FMN 01 Ernest Van Dijckkaai
649,Ernest Van Dijckkaai,2022-10-05,01:00:00,34,8,26,FMN 01 Ernest Van Dijckkaai
649,Ernest Van Dijckkaai,2022-10-05,02:00:00,18,8,10,FMN 01 Ernest Van Dijckkaai
649,Ernest Van Dijckkaai,2022-10-05,03:00:00,10,3,7,FMN 01 Ernest Van Dijckkaai
649,Ernest Van Dijckkaai,2022-10-05,04:00:00,52,33,19,FMN 01 Ernest Van Dijckkaai
649,Ernest Van Dijckkaai,2022-10-05,05:00:00,122,77,45,FMN 01 Ernest Van Dijckkaai
649,Ernest Van Dijckkaai,2022-10-05,06:00:00,294,188,106,FMN 01 Ernest Van Dijckkaai
649,Ernest Van Dijckkaai,2022-10-05,07:00:00,474,310,164,FMN 01 Ernest Van Dijckkaai
649,Ernest Van Dijckkaai,2022-10-05,08:00:00,620,398,222,FMN 01 Ernest Van Dijckkaai
649,Ernest Van Dijckkaai,2022-10-05,09:00:00,281,183,98,FMN 01 Ernest Van Dijckkaai
649,Ernest Van Dijckkaai,2022-10-05,10:00:00,211,111,100,FMN 01 Ernest Van Dijckkaai
649,Ernest Van Dijckkaai,2022-10-05,11:00:00,217,115,102,FMN 01 Ernest Van Dijckkaai
649,Ernest Van Dijckkaai,2022-10-05,12:00:00,382,209,173,FMN 01 Ernest Van Dijckkaai
649,Ernest Van Dijckkaai,2022-10-05,13:00:00,373,210,163,FMN 01 Ernest Van Dijckkaai
649,Ernest Van Dijckkaai,2022-10-05,14:00:00,329,147,182,FMN 01 Ernest Van Dijckkaai
649,Ernest Van Dijckkaai,2022-10-05,15:00:00,398,184,214,FMN 01 Ernest Van Dijckkaai
649,Ernest Van Dijckkaai,2022-10-05,16:00:00,575,242,333,FMN 01 Ernest Van Dijckkaai
649,Ernest Van Dijckkaai,2022-10-05,17:00:00,619,248,371,FMN 01 Ernest Van Dijckkaai
649,Ernest Van Dijckkaai,2022-10-05,18:00:00,423,222,201,FMN 01 Ernest Van Dijckkaai
649,Ernest Van Dijckkaai,2022-10-05,19:00:00,260,116,144,FMN 01 Ernest Van Dijckkaai
649,Ernest Van Dijckkaai,2022-10-05,20:00:00,152,75,77,FMN 01 Ernest Van Dijckkaai
649,Ernest Van Dijckkaai,2022-10-05,21:00:00,121,53,68,FMN 01 Ernest Van Dijckkaai
649,Ernest Van Dijckkaai,2022-10-05,22:00:00,171,57,114,FMN 01 Ernest Van Dijckkaai
649,Ernest Van Dijckkaai,2022-10-05,23:00:00,102,47,55,FMN 01 Ernest Van Dijckkaai
649,Ernest Van Dijckkaai,2022-10-06,00:00:00,38,15,23,FMN 01 Ernest Van Dijckkaai
649,Ernest Van Dijckkaai,2022-10-06,01:00:00,35,10,25,FMN 01 Ernest Van Dijckkaai
649,Ernest Van Dijckkaai,2022-10-06,02:00:00,12,3,9,FMN 01 Ernest Van Dijckkaai
649,Ernest Van Dijckkaai,2022-10-06,03:00:00,22,4,18,FMN 01 Ernest Van Dijckkaai
649,Ernest Van Dijckkaai,2022-10-06,04:00:00,67,42,25,FMN 01 Ernest Van Dijckkaai
649,Ernest Van Dijckkaai,2022-10-06,05:00:00,109,75,34,FMN 01 Ernest Van Dijckkaai
649,Ernest Van Dijckkaai,2022-10-06,06:00:00,251,159,92,FMN 01 Ernest Van Dijckkaai
649,Ernest Van Dijckkaai,2022-10-06,07:00:00,546,357,189,FMN 01 Ernest Van Dijckkaai
649,Ernest Van Dijckkaai,2022-10-06,08:00:00,749,431,318,FMN 01 Ernest Van Dijckkaai
649,Ernest Van Dijckkaai,2022-10-06,09:00:00,312,202,110,FMN 01 Ernest Van Dijckkaai
649,Ernest Van Dijckkaai,2022-10-06,10:00:00,257,136,121,FMN 01 Ernest Van Dijckkaai
649,Ernest Van Dijckkaai,2022-10-06,11:00:00,282,142,140,FMN 01 Ernest Van Dijckkaai
649,Ernest Van Dijckkaai,2022-10-06,12:00:00,403,215,188,FMN 01 Ernest Van Dijckkaai
649,Ernest Van Dijckkaai,2022-10-06,13:00:00,345,177,168,FMN 01 Ernest Van Dijckkaai
649,Ernest Van Dijckkaai,2022-10-06,14:00:00,392,200,192,FMN 01 Ernest Van Dijckkaai
649,Ernest Van Dijckkaai,2022-10-06,15:00:00,506,283,223,FMN 01 Ernest Van Dijckkaai
649,Ernest Van Dijckkaai,2022-10-06,16:00:00,746,318,428,FMN 01 Ernest Van Dijckkaai
649,Ernest Van Dijckkaai,2022-10-06,17:00:00,802,362,440,FMN 01 Ernest Van Dijckkaai
649,Ernest Van Dijckkaai,2022-10-06,18:00:00,546,274,272,FMN 01 Ernest Van Dijckkaai
649,Ernest Van Dijckkaai,2022-10-06,19:00:00,326,165,161,FMN 01 Ernest Van Dijckkaai
649,Ernest Van Dijckkaai,2022-10-06,20:00:00,235,88,147,FMN 01 Ernest Van Dijckkaai
649,Ernest Van Dijckkaai,2022-10-06,21:00:00,206,105,101,FMN 01 Ernest Van Dijckkaai
649,Ernest Van Dijckkaai,2022-10-06,22:00:00,188,67,121,FMN 01 Ernest Van Dijckkaai
649,Ernest Van Dijckkaai,2022-10-06,23:00:00,113,43,70,FMN 01 Ernest Van Dijckkaai
649,Ernest Van Dijckkaai,2022-10-07,00:00:00,100,64,36,FMN 01 Ernest Van Dijckkaai
649,Ernest Van Dijckkaai,2022-10-07,01:00:00,40,24,16,FMN 01 Ernest Van Dijckkaai
649,Ernest Van Dijckkaai,2022-10-07,02:00:00,42,11,31,FMN 01 Ernest Van Dijckkaai
649,Ernest Van Dijckkaai,2022-10-07,03:00:00,61,2,59,FMN 01 Ernest Van Dijckkaai
649,Ernest Van Dijckkaai,2022-10-07,04:00:00,74,28,46,FMN 01 Ernest Van Dijckkaai
649,Ernest Van Dijckkaai,2022-10-07,05:00:00,132,72,60,FMN 01 Ernest Van Dijckkaai
649,Ernest Van Dijckkaai,2022-10-07,06:00:00,257,166,91,FMN 01 Ernest Van Dijckkaai
649,Ernest Van Dijckkaai,2022-10-07,07:00:00,438,267,171,FMN 01 Ernest Van Dijckkaai
649,Ernest Van Dijckkaai,2022-10-07,08:00:00,574,351,223,FMN 01 Ernest Van Dijckkaai
649,Ernest Van Dijckkaai,2022-10-07,09:00:00,348,227,121,FMN 01 Ernest Van Dijckkaai
649,Ernest Van Dijckkaai,2022-10-07,10:00:00,264,162,102,FMN 01 Ernest Van Dijckkaai
649,Ernest Van Dijckkaai,2022-10-07,11:00:00,253,142,111,FMN 01 Ernest Van Dijckkaai
649,Ernest Van Dijckkaai,2022-10-07,12:00:00,397,213,184,FMN 01 Ernest Van Dijckkaai
649,Ernest Van Dijckkaai,2022-10-07,13:00:00,398,228,170,FMN 01 Ernest Van Dijckkaai
649,Ernest Van Dijckkaai,2022-10-07,14:00:00,464,199,265,FMN 01 Ernest Van Dijckkaai
649,Ernest Van Dijckkaai,2022-10-07,15:00:00,529,286,243,FMN 01 Ernest Van Dijckkaai
649,Ernest Van Dijckkaai,2022-10-07,16:00:00,702,293,409,FMN 01 Ernest Van Dijckkaai
649,Ernest Van Dijckkaai,2022-10-07,17:00:00,648,285,363,FMN 01 Ernest Van Dijckkaai
649,Ernest Van Dijckkaai,2022-10-07,18:00:00,471,224,247,FMN 01 Ernest Van Dijckkaai
649,Ernest Van Dijckkaai,2022-10-07,19:00:00,324,175,149,FMN 01 Ernest Van Dijckkaai
649,Ernest Van Dijckkaai,2022-10-07,20:00:00,205,104,101,FMN 01 Ernest Van Dijckkaai
649,Ernest Van Dijckkaai,2022-10-07,21:00:00,176,90,86,FMN 01 Ernest Van Dijckkaai
649,Ernest Van Dijckkaai,2022-10-07,22:00:00,235,90,145,FMN 01 Ernest Van Dijckkaai
649,Ernest Van Dijckkaai,2022-10-07,23:00:00,158,59,99,FMN 01 Ernest Van Dijckkaai
649,Ernest Van Dijckkaai,2022-10-08,00:00:00,142,55,87,FMN 01 Ernest Van Dijckkaai
649,Ernest Van Dijckkaai,2022-10-08,01:00:00,94,44,50,FMN 01 Ernest Van Dijckkaai
649,Ernest Van Dijckkaai,2022-10-08,02:00:00,61,22,39,FMN 01 Ernest Van Dijckkaai
649,Ernest Van Dijckkaai,2022-10-08,03:00:00,38,17,21,FMN 01 Ernest Van Dijckkaai
649,Ernest Van Dijckkaai,2022-10-08,04:00:00,48,29,19,FMN 01 Ernest Van Dijckkaai
649,Ernest Van Dijckkaai,2022-10-08,05:00:00,46,20,26,FMN 01 Ernest Van Dijckkaai
649,Ernest Van Dijckkaai,2022-10-08,06:00:00,48,25,23,FMN 01 Ernest Van Dijckkaai
649,Ernest Van Dijckkaai,2022-10-08,07:00:00,48,18,30,FMN 01 Ernest Van Dijckkaai
649,Ernest Van Dijckkaai,2022-10-08,08:00:00,76,36,40,FMN 01 Ernest Van Dijckkaai
649,Ernest Van Dijckkaai,2022-10-08,09:00:00,161,92,69,FMN 01 Ernest Van Dijckkaai
649,Ernest Van Dijckkaai,2022-10-08,10:00:00,208,118,90,FMN 01 Ernest Van Dijckkaai
649,Ernest Van Dijckkaai,2022-10-08,11:00:00,229,123,106,FMN 01 Ernest Van Dijckkaai
649,Ernest Van Dijckkaai,2022-10-08,12:00:00,294,129,165,FMN 01 Ernest Van Dijckkaai
649,Ernest Van Dijckkaai,2022-10-08,13:00:00,301,187,114,FMN 01 Ernest Van Dijckkaai
649,Ernest Van Dijckkaai,2022-10-08,14:00:00,419,239,180,FMN 01 Ernest Van Dijckkaai
649,Ernest Van Dijckkaai,2022-10-08,15:00:00,476,246,230,FMN 01 Ernest Van Dijckkaai
649,Ernest Van Dijckkaai,2022-10-08,16:00:00,445,237,208,FMN 01 Ernest Van Dijckkaai
649,Ernest Van Dijckkaai,2022-10-08,17:00:00,406,169,237,FMN 01 Ernest Van Dijckkaai
649,Ernest Van Dijckkaai,2022-10-08,18:00:00,405,216,189,FMN 01 Ernest Van Dijckkaai
649,Ernest Van Dijckkaai,2022-10-08,19:00:00,257,145,112,FMN 01 Ernest Van Dijckkaai
649,Ernest Van Dijckkaai,2022-10-08,20:00:00,176,84,92,FMN 01 Ernest Van Dijckkaai
649,Ernest Van Dijckkaai,2022-10-08,21:00:00,129,61,68,FMN 01 Ernest Van Dijckkaai
649,Ernest Van Dijckkaai,2022-10-08,22:00:00,174,52,122,FMN 01 Ernest Van Dijckkaai
649,Ernest Van Dijckkaai,2022-10-08,23:00:00,128,58,70,FMN 01 Ernest Van Dijckkaai
649,Ernest Van Dijckkaai,2022-10-09,00:00:00,137,63,74,FMN 01 Ernest Van Dijckkaai
649,Ernest Van Dijckkaai,2022-10-09,01:00:00,117,46,71,FMN 01 Ernest Van Dijckkaai
649,Ernest Van Dijckkaai,2022-10-09,02:00:00,41,10,31,FMN 01 Ernest Van Dijckkaai
649,Ernest Van Dijckkaai,2022-10-09,03:00:00,40,10,30,FMN 01 Ernest Van Dijckkaai
649,Ernest Van Dijckkaai,2022-10-09,04:00:00,53,13,40,FMN 01 Ernest Van Dijckkaai
649,Ernest Van Dijckkaai,2022-10-09,05:00:00,43,16,27,FMN 01 Ernest Van Dijckkaai
649,Ernest Van Dijckkaai,2022-10-09,06:00:00,37,14,23,FMN 01 Ernest Van Dijckkaai
649,Ernest Van Dijckkaai,2022-10-09,07:00:00,38,8,30,FMN 01 Ernest Van Dijckkaai
649,Ernest Van Dijckkaai,2022-10-09,08:00:00,66,37,29,FMN 01 Ernest Van Dijckkaai
649,Ernest Van Dijckkaai,2022-10-09,09:00:00,124,69,55,FMN 01 Ernest Van Dijckkaai
649,Ernest Van Dijckkaai,2022-10-09,10:00:00,243,116,127,FMN 01 Ernest Van Dijckkaai
649,Ernest Van Dijckkaai,2022-10-09,11:00:00,271,170,101,FMN 01 Ernest Van Dijckkaai
649,Ernest Van Dijckkaai,2022-10-09,12:00:00,340,189,151,FMN 01 Ernest Van Dijckkaai
649,Ernest Van Dijckkaai,2022-10-09,13:00:00,515,302,213,FMN 01 Ernest Van Dijckkaai
649,Ernest Van Dijckkaai,2022-10-09,14:00:00,634,347,287,FMN 01 Ernest Van Dijckkaai
649,Ernest Van Dijckkaai,2022-10-09,15:00:00,559,288,271,FMN 01 Ernest Van Dijckkaai
649,Ernest Van Dijckkaai,2022-10-09,16:00:00,629,318,311,FMN 01 Ernest Van Dijckkaai
649,Ernest Van Dijckkaai,2022-10-09,17:00:00,432,206,226,FMN 01 Ernest Van Dijckkaai
649,Ernest Van Dijckkaai,2022-10-09,18:00:00,308,152,156,FMN 01 Ernest Van Dijckkaai
649,Ernest Van Dijckkaai,2022-10-09,19:00:00,210,110,100,FMN 01 Ernest Van Dijckkaai
649,Ernest Van Dijckkaai,2022-10-09,20:00:00,136,50,86,FMN 01 Ernest Van Dijckkaai
649,Ernest Van Dijckkaai,2022-10-09,21:00:00,91,30,61,FMN 01 Ernest Van Dijckkaai
649,Ernest Van Dijckkaai,2022-10-09,22:00:00,85,40,45,FMN 01 Ernest Van Dijckkaai
649,Ernest Van Dijckkaai,2022-10-09,23:00:00,38,11,27,FMN 01 Ernest Van Dijckkaai
649,Ernest Van Dijckkaai,2022-10-10,00:00:00,16,6,10,FMN 01 Ernest Van Dijckkaai
649,Ernest Van Dijckkaai,2022-10-10,01:00:00,10,5,5,FMN 01 Ernest Van Dijckkaai
649,Ernest Van Dijckkaai,2022-10-10,02:00:00,12,5,7,FMN 01 Ernest Van Dijckkaai
649,Ernest Van Dijckkaai,2022-10-10,03:00:00,14,8,6,FMN 01 Ernest Van Dijckkaai
649,Ernest Van Dijckkaai,2022-10-10,04:00:00,67,43,24,FMN 01 Ernest Van Dijckkaai
649,Ernest Van Dijckkaai,2022-10-10,05:00:00,129,93,36,FMN 01 Ernest Van Dijckkaai
649,Ernest Van Dijckkaai,2022-10-10,06:00:00,274,175,99,FMN 01 Ernest Van Dijckkaai
649,Ernest Van Dijckkaai,2022-10-10,07:00:00,484,313,171,FMN 01 Ernest Van Dijckkaai
649,Ernest Van Dijckkaai,2022-10-10,08:00:00,680,426,254,FMN 01 Ernest Van Dijckkaai
649,Ernest Van Dijckkaai,2022-10-10,09:00:00,292,185,107,FMN 01 Ernest Van Dijckkaai
649,Ernest Van Dijckkaai,2022-10-10,10:00:00,176,96,80,FMN 01 Ernest Van Dijckkaai
649,Ernest Van Dijckkaai,2022-10-10,11:00:00,163,92,71,FMN 01 Ernest Van Dijckkaai
649,Ernest Van Dijckkaai,2022-10-10,12:00:00,276,144,132,FMN 01 Ernest Van Dijckkaai
649,Ernest Van Dijckkaai,2022-10-10,13:00:00,320,176,144,FMN 01 Ernest Van Dijckkaai
649,Ernest Van Dijckkaai,2022-10-10,14:00:00,303,123,180,FMN 01 Ernest Van Dijckkaai
649,Ernest Van Dijckkaai,2022-10-10,15:00:00,367,159,208,FMN 01 Ernest Van Dijckkaai
649,Ernest Van Dijckkaai,2022-10-10,16:00:00,611,235,376,FMN 01 Ernest Van Dijckkaai
649,Ernest Van Dijckkaai,2022-10-10,17:00:00,621,256,365,FMN 01 Ernest Van Dijckkaai
649,Ernest Van Dijckkaai,2022-10-10,18:00:00,441,191,250,FMN 01 Ernest Van Dijckkaai
649,Ernest Van Dijckkaai,2022-10-10,19:00:00,211,84,127,FMN 01 Ernest Van Dijckkaai
649,Ernest Van Dijckkaai,2022-10-10,20:00:00,125,55,70,FMN 01 Ernest Van Dijckkaai
649,Ernest Van Dijckkaai,2022-10-10,21:00:00,125,59,66,FMN 01 Ernest Van Dijckkaai
649,Ernest Van Dijckkaai,2022-10-10,22:00:00,136,43,93,FMN 01 Ernest Van Dijckkaai
649,Ernest Van Dijckkaai,2022-10-10,23:00:00,34,15,19,FMN 01 Ernest Van Dijckkaai
649,Ernest Van Dijckkaai,2022-10-11,00:00:00,23,7,16,FMN 01 Ernest Van Dijckkaai
649,Ernest Van Dijckkaai,2022-10-11,01:00:00,16,4,12,FMN 01 Ernest Van Dijckkaai
649,Ernest Van Dijckkaai,2022-10-11,02:00:00,9,4,5,FMN 01 Ernest Van Dijckkaai
649,Ernest Van Dijckkaai,2022-10-11,03:00:00,14,7,7,FMN 01 Ernest Van Dijckkaai
649,Ernest Van Dijckkaai,2022-10-11,04:00:00,56,35,21,FMN 01 Ernest Van Dijckkaai
649,Ernest Van Dijckkaai,2022-10-11,05:00:00,138,98,40,FMN 01 Ernest Van Dijckkaai
649,Ernest Van Dijckkaai,2022-10-11,06:00:00,301,195,106,FMN 01 Ernest Van Dijckkaai
649,Ernest Van Dijckkaai,2022-10-11,07:00:00,518,309,209,FMN 01 Ernest Van Dijckkaai
649,Ernest Van Dijckkaai,2022-10-11,08:00:00,768,483,285,FMN 01 Ernest Van Dijckkaai
649,Ernest Van Dijckkaai,2022-10-11,09:00:00,326,207,119,FMN 01 Ernest Van Dijckkaai
649,Ernest Van Dijckkaai,2022-10-11,10:00:00,201,119,82,FMN 01 Ernest Van Dijckkaai
649,Ernest Van Dijckkaai,2022-10-11,11:00:00,197,99,98,FMN 01 Ernest Van Dijckkaai
649,Ernest Van Dijckkaai,2022-10-11,12:00:00,337,203,134,FMN 01 Ernest Van Dijckkaai
649,Ernest Van Dijckkaai,2022-10-11,13:00:00,346,192,154,FMN 01 Ernest Van Dijckkaai
649,Ernest Van Dijckkaai,2022-10-11,14:00:00,386,162,224,FMN 01 Ernest Van Dijckkaai
649,Ernest Van Dijckkaai,2022-10-11,15:00:00,489,229,260,FMN 01 Ernest Van Dijckkaai
649,Ernest Van Dijckkaai,2022-10-11,16:00:00,814,334,480,FMN 01 Ernest Van Dijckkaai
649,Ernest Van Dijckkaai,2022-10-11,17:00:00,834,345,489,FMN 01 Ernest Van Dijckkaai
649,Ernest Van Dijckkaai,2022-10-11,18:00:00,553,233,320,FMN 01 Ernest Van Dijckkaai
649,Ernest Van Dijckkaai,2022-10-11,19:00:00,294,149,145,FMN 01 Ernest Van Dijckkaai
649,Ernest Van Dijckkaai,2022-10-11,20:00:00,193,99,94,FMN 01 Ernest Van Dijckkaai
649,Ernest Van Dijckkaai,2022-10-11,21:00:00,137,58,79,FMN 01 Ernest Van Dijckkaai
649,Ernest Van Dijckkaai,2022-10-11,22:00:00,184,74,110,FMN 01 Ernest Van Dijckkaai
649,Ernest Van Dijckkaai,2022-10-11,23:00:00,63,30,33,FMN 01 Ernest Van Dijckkaai
649,Ernest Van Dijckkaai,2022-10-12,00:00:00,41,19,22,FMN 01 Ernest Van Dijckkaai
649,Ernest Van Dijckkaai,2022-10-12,01:00:00,17,6,11,FMN 01 Ernest Van Dijckkaai
649,Ernest Van Dijckkaai,2022-10-12,02:00:00,6,3,3,FMN 01 Ernest Van Dijckkaai
649,Ernest Van Dijckkaai,2022-10-12,03:00:00,20,6,14,FMN 01 Ernest Van Dijckkaai
649,Ernest Van Dijckkaai,2022-10-12,04:00:00,57,38,19,FMN 01 Ernest Van Dijckkaai
649,Ernest Van Dijckkaai,2022-10-12,05:00:00,133,93,40,FMN 01 Ernest Van Dijckkaai
649,Ernest Van Dijckkaai,2022-10-12,06:00:00,255,172,83,FMN 01 Ernest Van Dijckkaai
649,Ernest Van Dijckkaai,2022-10-12,07:00:00,491,302,189,FMN 01 Ernest Van Dijckkaai
649,Ernest Van Dijckkaai,2022-10-12,08:00:00,632,405,227,FMN 01 Ernest Van Dijckkaai
649,Ernest Van Dijckkaai,2022-10-12,09:00:00,292,201,91,FMN 01 Ernest Van Dijckkaai
649,Ernest Van Dijckkaai,2022-10-12,10:00:00,186,104,82,FMN 01 Ernest Van Dijckkaai
649,Ernest Van Dijckkaai,2022-10-12,11:00:00,250,133,117,FMN 01 Ernest Van Dijckkaai
649,Ernest Van Dijckkaai,2022-10-12,12:00:00,379,202,177,FMN 01 Ernest Van Dijckkaai
649,Ernest Van Dijckkaai,2022-10-12,13:00:00,370,204,166,FMN 01 Ernest Van Dijckkaai
649,Ernest Van Dijckkaai,2022-10-12,14:00:00,362,175,187,FMN 01 Ernest Van Dijckkaai
649,Ernest Van Dijckkaai,2022-10-12,15:00:00,408,187,221,FMN 01 Ernest Van Dijckkaai
649,Ernest Van Dijckkaai,2022-10-12,16:00:00,597,245,352,FMN 01 Ernest Van Dijckkaai
649,Ernest Van Dijckkaai,2022-10-12,17:00:00,672,259,413,FMN 01 Ernest Van Dijckkaai
649,Ernest Van Dijckkaai,2022-10-12,18:00:00,462,200,262,FMN 01 Ernest Van Dijckkaai
649,Ernest Van Dijckkaai,2022-10-12,19:00:00,258,131,127,FMN 01 Ernest Van Dijckkaai
649,Ernest Van Dijckkaai,2022-10-12,20:00:00,158,70,88,FMN 01 Ernest Van Dijckkaai
649,Ernest Van Dijckkaai,2022-10-12,21:00:00,160,79,81,FMN 01 Ernest Van Dijckkaai
649,Ernest Van Dijckkaai,2022-10-12,22:00:00,170,53,117,FMN 01 Ernest Van Dijckkaai
649,Ernest Van Dijckkaai,2022-10-12,23:00:00,71,32,39,FMN 01 Ernest Van Dijckkaai
649,Ernest Van Dijckkaai,2022-10-13,00:00:00,45,19,26,FMN 01 Ernest Van Dijckkaai
649,Ernest Van Dijckkaai,2022-10-13,01:00:00,14,6,8,FMN 01 Ernest Van Dijckkaai
649,Ernest Van Dijckkaai,2022-10-13,02:00:00,16,3,13,FMN 01 Ernest Van Dijckkaai
649,Ernest Van Dijckkaai,2022-10-13,03:00:00,27,8,19,FMN 01 Ernest Van Dijckkaai
649,Ernest Van Dijckkaai,2022-10-13,04:00:00,52,33,19,FMN 01 Ernest Van Dijckkaai
649,Ernest Van Dijckkaai,2022-10-13,05:00:00,121,89,32,FMN 01 Ernest Van Dijckkaai
649,Ernest Van Dijckkaai,2022-10-13,06:00:00,269,178,91,FMN 01 Ernest Van Dijckkaai
649,Ernest Van Dijckkaai,2022-10-13,07:00:00,437,254,183,FMN 01 Ernest Van Dijckkaai
649,Ernest Van Dijckkaai,2022-10-13,08:00:00,694,408,286,FMN 01 Ernest Van Dijckkaai
649,Ernest Van Dijckkaai,2022-10-13,09:00:00,309,180,129,FMN 01 Ernest Van Dijckkaai
649,Ernest Van Dijckkaai,2022-10-13,10:00:00,198,104,94,FMN 01 Ernest Van Dijckkaai
649,Ernest Van Dijckkaai,2022-10-13,11:00:00,199,118,81,FMN 01 Ernest Van Dijckkaai
649,Ernest Van Dijckkaai,2022-10-13,12:00:00,319,183,136,FMN 01 Ernest Van Dijckkaai
649,Ernest Van Dijckkaai,2022-10-13,13:00:00,324,155,169,FMN 01 Ernest Van Dijckkaai
649,Ernest Van Dijckkaai,2022-10-13,14:00:00,260,125,135,FMN 01 Ernest Van Dijckkaai
649,Ernest Van Dijckkaai,2022-10-13,15:00:00,422,233,189,FMN 01 Ernest Van Dijckkaai
649,Ernest Van Dijckkaai,2022-10-13,16:00:00,556,238,318,FMN 01 Ernest Van Dijckkaai
649,Ernest Van Dijckkaai,2022-10-13,17:00:00,603,279,324,FMN 01 Ernest Van Dijckkaai
649,Ernest Van Dijckkaai,2022-10-13,18:00:00,408,203,205,FMN 01 Ernest Van Dijckkaai
649,Ernest Van Dijckkaai,2022-10-13,19:00:00,209,100,109,FMN 01 Ernest Van Dijckkaai
649,Ernest Van Dijckkaai,2022-10-13,20:00:00,129,67,62,FMN 01 Ernest Van Dijckkaai
649,Ernest Van Dijckkaai,2022-10-13,21:00:00,142,62,80,FMN 01 Ernest Van Dijckkaai
649,Ernest Van Dijckkaai,2022-10-13,22:00:00,176,48,128,FMN 01 Ernest Van Dijckkaai
649,Ernest Van Dijckkaai,2022-10-13,23:00:00,92,44,48,FMN 01 Ernest Van Dijckkaai
649,Ernest Van Dijckkaai,2022-10-14,00:00:00,70,43,27,FMN 01 Ernest Van Dijckkaai
649,Ernest Van Dijckkaai,2022-10-14,01:00:00,36,17,19,FMN 01 Ernest Van Dijckkaai
649,Ernest Van Dijckkaai,2022-10-14,02:00:00,34,4,30,FMN 01 Ernest Van Dijckkaai
649,Ernest Van Dijckkaai,2022-10-14,03:00:00,30,6,24,FMN 01 Ernest Van Dijckkaai
649,Ernest Van Dijckkaai,2022-10-14,04:00:00,76,40,36,FMN 01 Ernest Van Dijckkaai
649,Ernest Van Dijckkaai,2022-10-14,05:00:00,117,72,45,FMN 01 Ernest Van Dijckkaai
649,Ernest Van Dijckkaai,2022-10-14,06:00:00,236,146,90,FMN 01 Ernest Van Dijckkaai
649,Ernest Van Dijckkaai,2022-10-14,07:00:00,359,223,136,FMN 01 Ernest Van Dijckkaai
649,Ernest Van Dijckkaai,2022-10-14,08:00:00,500,306,194,FMN 01 Ernest Van Dijckkaai
649,Ernest Van Dijckkaai,2022-10-14,09:00:00,233,144,89,FMN 01 Ernest Van Dijckkaai
649,Ernest Van Dijckkaai,2022-10-14,10:00:00,182,107,75,FMN 01 Ernest Van Dijckkaai
649,Ernest Van Dijckkaai,2022-10-14,11:00:00,160,89,71,FMN 01 Ernest Van Dijckkaai
649,Ernest Van Dijckkaai,2022-10-14,12:00:00,231,118,113,FMN 01 Ernest Van Dijckkaai
649,Ernest Van Dijckkaai,2022-10-14,13:00:00,283,115,168,FMN 01 Ernest Van Dijckkaai
649,Ernest Van Dijckkaai,2022-10-14,14:00:00,226,98,128,FMN 01 Ernest Van Dijckkaai
649,Ernest Van Dijckkaai,2022-10-14,15:00:00,410,206,204,FMN 01 Ernest Van Dijckkaai
649,Ernest Van Dijckkaai,2022-10-14,16:00:00,527,217,310,FMN 01 Ernest Van Dijckkaai
649,Ernest Van Dijckkaai,2022-10-14,17:00:00,473,231,242,FMN 01 Ernest Van Dijckkaai
649,Ernest Van Dijckkaai,2022-10-14,18:00:00,362,184,178,FMN 01 Ernest Van Dijckkaai
649,Ernest Van Dijckkaai,2022-10-14,19:00:00,243,116,127,FMN 01 Ernest Van Dijckkaai
649,Ernest Van Dijckkaai,2022-10-14,20:00:00,192,96,96,FMN 01 Ernest Van Dijckkaai
649,Ernest Van Dijckkaai,2022-10-14,21:00:00,186,94,92,FMN 01 Ernest Van Dijckkaai
649,Ernest Van Dijckkaai,2022-10-14,22:00:00,178,64,114,FMN 01 Ernest Van Dijckkaai
649,Ernest Van Dijckkaai,2022-10-14,23:00:00,158,53,105,FMN 01 Ernest Van Dijckkaai
649,Ernest Van Dijckkaai,2022-10-15,00:00:00,135,46,89,FMN 01 Ernest Van Dijckkaai
649,Ernest Van Dijckkaai,2022-10-15,01:00:00,83,35,48,FMN 01 Ernest Van Dijckkaai
649,Ernest Van Dijckkaai,2022-10-15,02:00:00,68,39,29,FMN 01 Ernest Van Dijckkaai
649,Ernest Van Dijckkaai,2022-10-15,03:00:00,55,32,23,FMN 01 Ernest Van Dijckkaai
649,Ernest Van Dijckkaai,2022-10-15,04:00:00,51,27,24,FMN 01 Ernest Van Dijckkaai
649,Ernest Van Dijckkaai,2022-10-15,05:00:00,53,31,22,FMN 01 Ernest Van Dijckkaai
649,Ernest Van Dijckkaai,2022-10-15,06:00:00,42,18,24,FMN 01 Ernest Van Dijckkaai
649,Ernest Van Dijckkaai,2022-10-15,07:00:00,46,18,28,FMN 01 Ernest Van Dijckkaai
649,Ernest Van Dijckkaai,2022-10-15,08:00:00,62,38,24,FMN 01 Ernest Van Dijckkaai
649,Ernest Van Dijckkaai,2022-10-15,09:00:00,123,67,56,FMN 01 Ernest Van Dijckkaai
649,Ernest Van Dijckkaai,2022-10-15,10:00:00,121,65,56,FMN 01 Ernest Van Dijckkaai
649,Ernest Van Dijckkaai,2022-10-15,11:00:00,153,76,77,FMN 01 Ernest Van Dijckkaai
649,Ernest Van Dijckkaai,2022-10-15,12:00:00,175,104,71,FMN 01 Ernest Van Dijckkaai
649,Ernest Van Dijckkaai,2022-10-15,13:00:00,194,106,88,FMN 01 Ernest Van Dijckkaai
649,Ernest Van Dijckkaai,2022-10-15,14:00:00,242,127,115,FMN 01 Ernest Van Dijckkaai
649,Ernest Van Dijckkaai,2022-10-15,15:00:00,264,143,121,FMN 01 Ernest Van Dijckkaai
649,Ernest Van Dijckkaai,2022-10-15,16:00:00,342,178,164,FMN 01 Ernest Van Dijckkaai
649,Ernest Van Dijckkaai,2022-10-15,17:00:00,345,187,158,FMN 01 Ernest Van Dijckkaai
649,Ernest Van Dijckkaai,2022-10-15,18:00:00,317,151,166,FMN 01 Ernest Van Dijckkaai
649,Ernest Van Dijckkaai,2022-10-15,19:00:00,223,116,107,FMN 01 Ernest Van Dijckkaai
649,Ernest Van Dijckkaai,2022-10-15,20:00:00,200,118,82,FMN 01 Ernest Van Dijckkaai
649,Ernest Van Dijckkaai,2022-10-15,21:00:00,153,72,81,FMN 01 Ernest Van Dijckkaai
649,Ernest Van Dijckkaai,2022-10-15,22:00:00,150,64,86,FMN 01 Ernest Van Dijckkaai
649,Ernest Van Dijckkaai,2022-10-15,23:00:00,112,37,75,FMN 01 Ernest Van Dijckkaai
649,Ernest Van Dijckkaai,2022-10-16,00:00:00,116,46,70,FMN 01 Ernest Van Dijckkaai
649,Ernest Van Dijckkaai,2022-10-16,01:00:00,85,17,68,FMN 01 Ernest Van Dijckkaai
649,Ernest Van Dijckkaai,2022-10-16,02:00:00,57,24,33,FMN 01 Ernest Van Dijckkaai
649,Ernest Van Dijckkaai,2022-10-16,03:00:00,51,20,31,FMN 01 Ernest Van Dijckkaai
649,Ernest Van Dijckkaai,2022-10-16,04:00:00,59,16,43,FMN 01 Ernest Van Dijckkaai
649,Ernest Van Dijckkaai,2022-10-16,05:00:00,30,13,17,FMN 01 Ernest Van Dijckkaai
649,Ernest Van Dijckkaai,2022-10-16,06:00:00,39,19,20,FMN 01 Ernest Van Dijckkaai
649,Ernest Van Dijckkaai,2022-10-16,07:00:00,35,16,19,FMN 01 Ernest Van Dijckkaai
649,Ernest Van Dijckkaai,2022-10-16,08:00:00,71,38,33,FMN 01 Ernest Van Dijckkaai
649,Ernest Van Dijckkaai,2022-10-16,09:00:00,169,118,51,FMN 01 Ernest Van Dijckkaai
649,Ernest Van Dijckkaai,2022-10-16,10:00:00,197,120,77,FMN 01 Ernest Van Dijckkaai
649,Ernest Van Dijckkaai,2022-10-16,11:00:00,304,158,146,FMN 01 Ernest Van Dijckkaai
649,Ernest Van Dijckkaai,2022-10-16,12:00:00,376,197,179,FMN 01 Ernest Van Dijckkaai
649,Ernest Van Dijckkaai,2022-10-16,13:00:00,396,192,204,FMN 01 Ernest Van Dijckkaai
649,Ernest Van Dijckkaai,2022-10-16,14:00:00,511,267,244,FMN 01 Ernest Van Dijckkaai
649,Ernest Van Dijckkaai,2022-10-16,15:00:00,520,301,219,FMN 01 Ernest Van Dijckkaai
649,Ernest Van Dijckkaai,2022-10-16,16:00:00,439,215,224,FMN 01 Ernest Van Dijckkaai
649,Ernest Van Dijckkaai,2022-10-16,17:00:00,354,150,204,FMN 01 Ernest Van Dijckkaai
649,Ernest Van Dijckkaai,2022-10-16,18:00:00,253,121,132,FMN 01 Ernest Van Dijckkaai
649,Ernest Van Dijckkaai,2022-10-16,19:00:00,196,79,117,FMN 01 Ernest Van Dijckkaai
649,Ernest Van Dijckkaai,2022-10-16,20:00:00,127,65,62,FMN 01 Ernest Van Dijckkaai
649,Ernest Van Dijckkaai,2022-10-16,21:00:00,77,37,40,FMN 01 Ernest Van Dijckkaai
649,Ernest Van Dijckkaai,2022-10-16,22:00:00,68,27,41,FMN 01 Ernest Van Dijckkaai
649,Ernest Van Dijckkaai,2022-10-16,23:00:00,34,13,21,FMN 01 Ernest Van Dijckkaai
649,Ernest Van Dijckkaai,2022-10-17,00:00:00,17,6,11,FMN 01 Ernest Van Dijckkaai
649,Ernest Van Dijckkaai,2022-10-17,01:00:00,13,7,6,FMN 01 Ernest Van Dijckkaai
649,Ernest Van Dijckkaai,2022-10-17,02:00:00,6,5,1,FMN 01 Ernest Van Dijckkaai
649,Ernest Van Dijckkaai,2022-10-17,03:00:00,5,3,2,FMN 01 Ernest Van Dijckkaai
649,Ernest Van Dijckkaai,2022-10-17,04:00:00,54,39,15,FMN 01 Ernest Van Dijckkaai
649,Ernest Van Dijckkaai,2022-10-17,05:00:00,108,70,38,FMN 01 Ernest Van Dijckkaai
649,Ernest Van Dijckkaai,2022-10-17,06:00:00,261,175,86,FMN 01 Ernest Van Dijckkaai
649,Ernest Van Dijckkaai,2022-10-17,07:00:00,496,312,184,FMN 01 Ernest Van Dijckkaai
649,Ernest Van Dijckkaai,2022-10-17,08:00:00,593,375,218,FMN 01 Ernest Van Dijckkaai
649,Ernest Van Dijckkaai,2022-10-17,09:00:00,159,95,64,FMN 01 Ernest Van Dijckkaai
649,Ernest Van Dijckkaai,2022-10-17,10:00:00,78,43,35,FMN 01 Ernest Van Dijckkaai
649,Ernest Van Dijckkaai,2022-10-17,11:00:00,106,51,55,FMN 01 Ernest Van Dijckkaai
649,Ernest Van Dijckkaai,2022-10-17,12:00:00,177,83,94,FMN 01 Ernest Van Dijckkaai
649,Ernest Van Dijckkaai,2022-10-17,13:00:00,192,110,82,FMN 01 Ernest Van Dijckkaai
649,Ernest Van Dijckkaai,2022-10-17,14:00:00,223,107,116,FMN 01 Ernest Van Dijckkaai
649,Ernest Van Dijckkaai,2022-10-17,15:00:00,281,124,157,FMN 01 Ernest Van Dijckkaai
649,Ernest Van Dijckkaai,2022-10-17,16:00:00,542,217,325,FMN 01 Ernest Van Dijckkaai
649,Ernest Van Dijckkaai,2022-10-17,17:00:00,616,257,359,FMN 01 Ernest Van Dijckkaai
649,Ernest Van Dijckkaai,2022-10-17,18:00:00,409,180,229,FMN 01 Ernest Van Dijckkaai
649,Ernest Van Dijckkaai,2022-10-17,19:00:00,199,88,111,FMN 01 Ernest Van Dijckkaai
649,Ernest Van Dijckkaai,2022-10-17,20:00:00,163,76,87,FMN 01 Ernest Van Dijckkaai
649,Ernest Van Dijckkaai,2022-10-17,21:00:00,135,56,79,FMN 01 Ernest Van Dijckkaai
649,Ernest Van Dijckkaai,2022-10-17,22:00:00,165,53,112,FMN 01 Ernest Van Dijckkaai
649,Ernest Van Dijckkaai,2022-10-17,23:00:00,43,24,19,FMN 01 Ernest Van Dijckkaai
649,Ernest Van Dijckkaai,2022-10-18,00:00:00,24,9,15,FMN 01 Ernest Van Dijckkaai
649,Ernest Van Dijckkaai,2022-10-18,01:00:00,13,2,11,FMN 01 Ernest Van Dijckkaai
649,Ernest Van Dijckkaai,2022-10-18,02:00:00,10,2,8,FMN 01 Ernest Van Dijckkaai
649,Ernest Van Dijckkaai,2022-10-18,03:00:00,10,3,7,FMN 01 Ernest Van Dijckkaai
649,Ernest Van Dijckkaai,2022-10-18,04:00:00,49,30,19,FMN 01 Ernest Van Dijckkaai
649,Ernest Van Dijckkaai,2022-10-18,05:00:00,139,98,41,FMN 01 Ernest Van Dijckkaai
649,Ernest Van Dijckkaai,2022-10-18,06:00:00,300,180,120,FMN 01 Ernest Van Dijckkaai
649,Ernest Van Dijckkaai,2022-10-18,07:00:00,533,319,214,FMN 01 Ernest Van Dijckkaai
649,Ernest Van Dijckkaai,2022-10-18,08:00:00,756,487,269,FMN 01 Ernest Van Dijckkaai
649,Ernest Van Dijckkaai,2022-10-18,09:00:00,353,225,128,FMN 01 Ernest Van Dijckkaai
649,Ernest Van Dijckkaai,2022-10-18,10:00:00,238,141,97,FMN 01 Ernest Van Dijckkaai
649,Ernest Van Dijckkaai,2022-10-18,11:00:00,252,135,117,FMN 01 Ernest Van Dijckkaai
649,Ernest Van Dijckkaai,2022-10-18,12:00:00,366,190,176,FMN 01 Ernest Van Dijckkaai
649,Ernest Van Dijckkaai,2022-10-18,13:00:00,404,238,166,FMN 01 Ernest Van Dijckkaai
649,Ernest Van Dijckkaai,2022-10-18,14:00:00,444,236,208,FMN 01 Ernest Van Dijckkaai
649,Ernest Van Dijckkaai,2022-10-18,15:00:00,594,297,297,FMN 01 Ernest Van Dijckkaai
649,Ernest Van Dijckkaai,2022-10-18,16:00:00,842,387,455,FMN 01 Ernest Van Dijckkaai
649,Ernest Van Dijckkaai,2022-10-18,17:00:00,833,360,473,FMN 01 Ernest Van Dijckkaai
649,Ernest Van Dijckkaai,2022-10-18,18:00:00,642,291,351,FMN 01 Ernest Van Dijckkaai
649,Ernest Van Dijckkaai,2022-10-18,19:00:00,292,157,135,FMN 01 Ernest Van Dijckkaai
649,Ernest Van Dijckkaai,2022-10-18,20:00:00,220,107,113,FMN 01 Ernest Van Dijckkaai
649,Ernest Van Dijckkaai,2022-10-18,21:00:00,161,58,103,FMN 01 Ernest Van Dijckkaai
649,Ernest Van Dijckkaai,2022-10-18,22:00:00,197,70,127,FMN 01 Ernest Van Dijckkaai
649,Ernest Van Dijckkaai,2022-10-18,23:00:00,84,24,60,FMN 01 Ernest Van Dijckkaai
649,Ernest Van Dijckkaai,2022-10-19,00:00:00,59,20,39,FMN 01 Ernest Van Dijckkaai
649,Ernest Van Dijckkaai,2022-10-19,01:00:00,26,11,15,FMN 01 Ernest Van Dijckkaai
649,Ernest Van Dijckkaai,2022-10-19,02:00:00,12,6,6,FMN 01 Ernest Van Dijckkaai
649,Ernest Van Dijckkaai,2022-10-19,03:00:00,19,11,8,FMN 01 Ernest Van Dijckkaai
649,Ernest Van Dijckkaai,2022-10-19,04:00:00,56,37,19,FMN 01 Ernest Van Dijckkaai
649,Ernest Van Dijckkaai,2022-10-19,05:00:00,122,83,39,FMN 01 Ernest Van Dijckkaai
649,Ernest Van Dijckkaai,2022-10-19,06:00:00,319,210,109,FMN 01 Ernest Van Dijckkaai
649,Ernest Van Dijckkaai,2022-10-19,07:00:00,550,347,203,FMN 01 Ernest Van Dijckkaai
649,Ernest Van Dijckkaai,2022-10-19,08:00:00,635,400,235,FMN 01 Ernest Van Dijckkaai
649,Ernest Van Dijckkaai,2022-10-19,09:00:00,314,196,118,FMN 01 Ernest Van Dijckkaai
649,Ernest Van Dijckkaai,2022-10-19,10:00:00,263,164,99,FMN 01 Ernest Van Dijckkaai
649,Ernest Van Dijckkaai,2022-10-19,11:00:00,264,134,130,FMN 01 Ernest Van Dijckkaai
649,Ernest Van Dijckkaai,2022-10-19,12:00:00,498,255,243,FMN 01 Ernest Van Dijckkaai
649,Ernest Van Dijckkaai,2022-10-19,13:00:00,403,236,167,FMN 01 Ernest Van Dijckkaai
649,Ernest Van Dijckkaai,2022-10-19,14:00:00,380,193,187,FMN 01 Ernest Van Dijckkaai
649,Ernest Van Dijckkaai,2022-10-19,15:00:00,425,193,232,FMN 01 Ernest Van Dijckkaai
649,Ernest Van Dijckkaai,2022-10-19,16:00:00,717,307,410,FMN 01 Ernest Van Dijckkaai
649,Ernest Van Dijckkaai,2022-10-19,17:00:00,711,309,402,FMN 01 Ernest Van Dijckkaai
649,Ernest Van Dijckkaai,2022-10-19,18:00:00,562,269,293,FMN 01 Ernest Van Dijckkaai
649,Ernest Van Dijckkaai,2022-10-19,19:00:00,263,123,140,FMN 01 Ernest Van Dijckkaai
649,Ernest Van Dijckkaai,2022-10-19,20:00:00,182,86,96,FMN 01 Ernest Van Dijckkaai
649,Ernest Van Dijckkaai,2022-10-19,21:00:00,147,57,90,FMN 01 Ernest Van Dijckkaai
649,Ernest Van Dijckkaai,2022-10-19,22:00:00,169,58,111,FMN 01 Ernest Van Dijckkaai
649,Ernest Van Dijckkaai,2022-10-19,23:00:00,74,31,43,FMN 01 Ernest Van Dijckkaai
649,Ernest Van Dijckkaai,2022-10-20,00:00:00,44,25,19,FMN 01 Ernest Van Dijckkaai
649,Ernest Van Dijckkaai,2022-10-20,01:00:00,21,8,13,FMN 01 Ernest Van Dijckkaai
649,Ernest Van Dijckkaai,2022-10-20,02:00:00,4,2,2,FMN 01 Ernest Van Dijckkaai
649,Ernest Van Dijckkaai,2022-10-20,03:00:00,15,8,7,FMN 01 Ernest Van Dijckkaai
649,Ernest Van Dijckkaai,2022-10-20,04:00:00,51,28,23,FMN 01 Ernest Van Dijckkaai
649,Ernest Van Dijckkaai,2022-10-20,05:00:00,119,81,38,FMN 01 Ernest Van Dijckkaai
649,Ernest Van Dijckkaai,2022-10-20,06:00:00,307,196,111,FMN 01 Ernest Van Dijckkaai
649,Ernest Van Dijckkaai,2022-10-20,07:00:00,463,278,185,FMN 01 Ernest Van Dijckkaai
649,Ernest Van Dijckkaai,2022-10-20,08:00:00,728,405,323,FMN 01 Ernest Van Dijckkaai
649,Ernest Van Dijckkaai,2022-10-20,09:00:00,362,214,148,FMN 01 Ernest Van Dijckkaai
649,Ernest Van Dijckkaai,2022-10-20,10:00:00,202,127,75,FMN 01 Ernest Van Dijckkaai
649,Ernest Van Dijckkaai,2022-10-20,11:00:00,133,70,63,FMN 01 Ernest Van Dijckkaai
649,Ernest Van Dijckkaai,2022-10-20,12:00:00,270,145,125,FMN 01 Ernest Van Dijckkaai
649,Ernest Van Dijckkaai,2022-10-20,13:00:00,241,130,111,FMN 01 Ernest Van Dijckkaai
649,Ernest Van Dijckkaai,2022-10-20,14:00:00,319,141,178,FMN 01 Ernest Van Dijckkaai
649,Ernest Van Dijckkaai,2022-10-20,15:00:00,432,214,218,FMN 01 Ernest Van Dijckkaai
649,Ernest Van Dijckkaai,2022-10-20,16:00:00,709,347,362,FMN 01 Ernest Van Dijckkaai
649,Ernest Van Dijckkaai,2022-10-20,17:00:00,803,411,392,FMN 01 Ernest Van Dijckkaai
649,Ernest Van Dijckkaai,2022-10-20,18:00:00,549,259,290,FMN 01 Ernest Van Dijckkaai
649,Ernest Van Dijckkaai,2022-10-20,19:00:00,313,176,137,FMN 01 Ernest Van Dijckkaai
649,Ernest Van Dijckkaai,2022-10-20,20:00:00,236,112,124,FMN 01 Ernest Van Dijckkaai
649,Ernest Van Dijckkaai,2022-10-20,21:00:00,170,71,99,FMN 01 Ernest Van Dijckkaai
649,Ernest Van Dijckkaai,2022-10-20,22:00:00,217,87,130,FMN 01 Ernest Van Dijckkaai
649,Ernest Van Dijckkaai,2022-10-20,23:00:00,138,83,55,FMN 01 Ernest Van Dijckkaai
649,Ernest Van Dijckkaai,2022-10-21,00:00:00,95,59,36,FMN 01 Ernest Van Dijckkaai
649,Ernest Van Dijckkaai,2022-10-21,01:00:00,45,20,25,FMN 01 Ernest Van Dijckkaai
649,Ernest Van Dijckkaai,2022-10-21,02:00:00,45,20,25,FMN 01 Ernest Van Dijckkaai
649,Ernest Van Dijckkaai,2022-10-21,03:00:00,38,5,33,FMN 01 Ernest Van Dijckkaai
649,Ernest Van Dijckkaai,2022-10-21,04:00:00,75,37,38,FMN 01 Ernest Van Dijckkaai
649,Ernest Van Dijckkaai,2022-10-21,05:00:00,119,72,47,FMN 01 Ernest Van Dijckkaai
649,Ernest Van Dijckkaai,2022-10-21,06:00:00,230,148,82,FMN 01 Ernest Van Dijckkaai
649,Ernest Van Dijckkaai,2022-10-21,07:00:00,408,258,150,FMN 01 Ernest Van Dijckkaai
649,Ernest Van Dijckkaai,2022-10-21,08:00:00,542,330,212,FMN 01 Ernest Van Dijckkaai
649,Ernest Van Dijckkaai,2022-10-21,09:00:00,309,191,118,FMN 01 Ernest Van Dijckkaai
649,Ernest Van Dijckkaai,2022-10-21,10:00:00,212,131,81,FMN 01 Ernest Van Dijckkaai
649,Ernest Van Dijckkaai,2022-10-21,11:00:00,230,119,111,FMN 01 Ernest Van Dijckkaai
649,Ernest Van Dijckkaai,2022-10-21,12:00:00,331,177,154,FMN 01 Ernest Van Dijckkaai
649,Ernest Van Dijckkaai,2022-10-21,13:00:00,351,180,171,FMN 01 Ernest Van Dijckkaai
649,Ernest Van Dijckkaai,2022-10-21,14:00:00,398,193,205,FMN 01 Ernest Van Dijckkaai
649,Ernest Van Dijckkaai,2022-10-21,15:00:00,544,272,272,FMN 01 Ernest Van Dijckkaai
649,Ernest Van Dijckkaai,2022-10-21,16:00:00,714,291,423,FMN 01 Ernest Van Dijckkaai
649,Ernest Van Dijckkaai,2022-10-21,17:00:00,680,331,349,FMN 01 Ernest Van Dijckkaai
649,Ernest Van Dijckkaai,2022-10-21,18:00:00,481,214,267,FMN 01 Ernest Van Dijckkaai
649,Ernest Van Dijckkaai,2022-10-21,19:00:00,323,147,176,FMN 01 Ernest Van Dijckkaai
649,Ernest Van Dijckkaai,2022-10-21,20:00:00,236,111,125,FMN 01 Ernest Van Dijckkaai
649,Ernest Van Dijckkaai,2022-10-21,21:00:00,211,87,124,FMN 01 Ernest Van Dijckkaai
649,Ernest Van Dijckkaai,2022-10-21,22:00:00,211,88,123,FMN 01 Ernest Van Dijckkaai
649,Ernest Van Dijckkaai,2022-10-21,23:00:00,159,63,96,FMN 01 Ernest Van Dijckkaai
649,Ernest Van Dijckkaai,2022-10-22,00:00:00,145,58,87,FMN 01 Ernest Van Dijckkaai
649,Ernest Van Dijckkaai,2022-10-22,01:00:00,110,51,59,FMN 01 Ernest Van Dijckkaai
649,Ernest Van Dijckkaai,2022-10-22,02:00:00,67,19,48,FMN 01 Ernest Van Dijckkaai
649,Ernest Van Dijckkaai,2022-10-22,03:00:00,34,8,26,FMN 01 Ernest Van Dijckkaai
649,Ernest Van Dijckkaai,2022-10-22,04:00:00,42,14,28,FMN 01 Ernest Van Dijckkaai
649,Ernest Van Dijckkaai,2022-10-22,05:00:00,52,35,17,FMN 01 Ernest Van Dijckkaai
649,Ernest Van Dijckkaai,2022-10-22,06:00:00,52,22,30,FMN 01 Ernest Van Dijckkaai
649,Ernest Van Dijckkaai,2022-10-22,07:00:00,34,12,22,FMN 01 Ernest Van Dijckkaai
649,Ernest Van Dijckkaai,2022-10-22,08:00:00,120,61,59,FMN 01 Ernest Van Dijckkaai
649,Ernest Van Dijckkaai,2022-10-22,09:00:00,162,85,77,FMN 01 Ernest Van Dijckkaai
649,Ernest Van Dijckkaai,2022-10-22,10:00:00,218,113,105,FMN 01 Ernest Van Dijckkaai
649,Ernest Van Dijckkaai,2022-10-22,11:00:00,281,182,99,FMN 01 Ernest Van Dijckkaai
649,Ernest Van Dijckkaai,2022-10-22,12:00:00,308,168,140,FMN 01 Ernest Van Dijckkaai
649,Ernest Van Dijckkaai,2022-10-22,13:00:00,422,200,222,FMN 01 Ernest Van Dijckkaai
649,Ernest Van Dijckkaai,2022-10-22,14:00:00,426,214,212,FMN 01 Ernest Van Dijckkaai
649,Ernest Van Dijckkaai,2022-10-22,15:00:00,423,223,200,FMN 01 Ernest Van Dijckkaai
649,Ernest Van Dijckkaai,2022-10-22,16:00:00,447,239,208,FMN 01 Ernest Van Dijckkaai
649,Ernest Van Dijckkaai,2022-10-22,17:00:00,420,214,206,FMN 01 Ernest Van Dijckkaai
649,Ernest Van Dijckkaai,2022-10-22,18:00:00,365,206,159,FMN 01 Ernest Van Dijckkaai
649,Ernest Van Dijckkaai,2022-10-22,19:00:00,258,144,114,FMN 01 Ernest Van Dijckkaai
649,Ernest Van Dijckkaai,2022-10-22,20:00:00,207,100,107,FMN 01 Ernest Van Dijckkaai
649,Ernest Van Dijckkaai,2022-10-22,21:00:00,170,89,81,FMN 01 Ernest Van Dijckkaai
649,Ernest Van Dijckkaai,2022-10-22,22:00:00,184,104,80,FMN 01 Ernest Van Dijckkaai
649,Ernest Van Dijckkaai,2022-10-22,23:00:00,175,53,122,FMN 01 Ernest Van Dijckkaai
649,Ernest Van Dijckkaai,2022-10-23,00:00:00,117,51,66,FMN 01 Ernest Van Dijckkaai
649,Ernest Van Dijckkaai,2022-10-23,01:00:00,110,35,75,FMN 01 Ernest Van Dijckkaai
649,Ernest Van Dijckkaai,2022-10-23,02:00:00,72,23,49,FMN 01 Ernest Van Dijckkaai
649,Ernest Van Dijckkaai,2022-10-23,03:00:00,47,9,38,FMN 01 Ernest Van Dijckkaai
649,Ernest Van Dijckkaai,2022-10-23,04:00:00,48,13,35,FMN 01 Ernest Van Dijckkaai
649,Ernest Van Dijckkaai,2022-10-23,05:00:00,36,16,20,FMN 01 Ernest Van Dijckkaai
649,Ernest Van Dijckkaai,2022-10-23,06:00:00,43,18,25,FMN 01 Ernest Van Dijckkaai
649,Ernest Van Dijckkaai,2022-10-23,07:00:00,37,13,24,FMN 01 Ernest Van Dijckkaai
649,Ernest Van Dijckkaai,2022-10-23,08:00:00,59,30,29,FMN 01 Ernest Van Dijckkaai
649,Ernest Van Dijckkaai,2022-10-23,09:00:00,153,99,54,FMN 01 Ernest Van Dijckkaai
649,Ernest Van Dijckkaai,2022-10-23,10:00:00,169,106,63,FMN 01 Ernest Van Dijckkaai
649,Ernest Van Dijckkaai,2022-10-23,11:00:00,204,108,96,FMN 01 Ernest Van Dijckkaai
649,Ernest Van Dijckkaai,2022-10-23,12:00:00,264,150,114,FMN 01 Ernest Van Dijckkaai
649,Ernest Van Dijckkaai,2022-10-23,13:00:00,304,171,133,FMN 01 Ernest Van Dijckkaai
649,Ernest Van Dijckkaai,2022-10-23,14:00:00,364,198,166,FMN 01 Ernest Van Dijckkaai
649,Ernest Van Dijckkaai,2022-10-23,15:00:00,374,183,191,FMN 01 Ernest Van Dijckkaai
649,Ernest Van Dijckkaai,2022-10-23,16:00:00,359,169,190,FMN 01 Ernest Van Dijckkaai
649,Ernest Van Dijckkaai,2022-10-23,17:00:00,308,148,160,FMN 01 Ernest Van Dijckkaai
649,Ernest Van Dijckkaai,2022-10-23,18:00:00,260,128,132,FMN 01 Ernest Van Dijckkaai
649,Ernest Van Dijckkaai,2022-10-23,19:00:00,184,95,89,FMN 01 Ernest Van Dijckkaai
649,Ernest Van Dijckkaai,2022-10-23,20:00:00,75,39,36,FMN 01 Ernest Van Dijckkaai
649,Ernest Van Dijckkaai,2022-10-23,21:00:00,89,39,50,FMN 01 Ernest Van Dijckkaai
649,Ernest Van Dijckkaai,2022-10-23,22:00:00,80,33,47,FMN 01 Ernest Van Dijckkaai
649,Ernest Van Dijckkaai,2022-10-23,23:00:00,55,24,31,FMN 01 Ernest Van Dijckkaai
649,Ernest Van Dijckkaai,2022-10-24,00:00:00,35,18,17,FMN 01 Ernest Van Dijckkaai
649,Ernest Van Dijckkaai,2022-10-24,01:00:00,7,5,2,FMN 01 Ernest Van Dijckkaai
649,Ernest Van Dijckkaai,2022-10-24,02:00:00,10,4,6,FMN 01 Ernest Van Dijckkaai
649,Ernest Van Dijckkaai,2022-10-24,03:00:00,12,8,4,FMN 01 Ernest Van Dijckkaai
649,Ernest Van Dijckkaai,2022-10-24,04:00:00,46,30,16,FMN 01 Ernest Van Dijckkaai
649,Ernest Van Dijckkaai,2022-10-24,05:00:00,111,83,28,FMN 01 Ernest Van Dijckkaai
649,Ernest Van Dijckkaai,2022-10-24,06:00:00,239,158,81,FMN 01 Ernest Van Dijckkaai
649,Ernest Van Dijckkaai,2022-10-24,07:00:00,457,282,175,FMN 01 Ernest Van Dijckkaai
649,Ernest Van Dijckkaai,2022-10-24,08:00:00,600,373,227,FMN 01 Ernest Van Dijckkaai
649,Ernest Van Dijckkaai,2022-10-24,09:00:00,257,162,95,FMN 01 Ernest Van Dijckkaai
649,Ernest Van Dijckkaai,2022-10-24,10:00:00,155,92,63,FMN 01 Ernest Van Dijckkaai
649,Ernest Van Dijckkaai,2022-10-24,11:00:00,143,73,70,FMN 01 Ernest Van Dijckkaai
649,Ernest Van Dijckkaai,2022-10-24,12:00:00,273,152,121,FMN 01 Ernest Van Dijckkaai
649,Ernest Van Dijckkaai,2022-10-24,13:00:00,219,114,105,FMN 01 Ernest Van Dijckkaai
649,Ernest Van Dijckkaai,2022-10-24,14:00:00,238,113,125,FMN 01 Ernest Van Dijckkaai
649,Ernest Van Dijckkaai,2022-10-24,15:00:00,357,183,174,FMN 01 Ernest Van Dijckkaai
649,Ernest Van Dijckkaai,2022-10-24,16:00:00,577,213,364,FMN 01 Ernest Van Dijckkaai
649,Ernest Van Dijckkaai,2022-10-24,17:00:00,658,292,366,FMN 01 Ernest Van Dijckkaai
649,Ernest Van Dijckkaai,2022-10-24,18:00:00,431,204,227,FMN 01 Ernest Van Dijckkaai
649,Ernest Van Dijckkaai,2022-10-24,19:00:00,167,71,96,FMN 01 Ernest Van Dijckkaai
649,Ernest Van Dijckkaai,2022-10-24,20:00:00,166,83,83,FMN 01 Ernest Van Dijckkaai
649,Ernest Van Dijckkaai,2022-10-24,21:00:00,129,55,74,FMN 01 Ernest Van Dijckkaai
649,Ernest Van Dijckkaai,2022-10-24,22:00:00,136,45,91,FMN 01 Ernest Van Dijckkaai
649,Ernest Van Dijckkaai,2022-10-24,23:00:00,50,24,26,FMN 01 Ernest Van Dijckkaai
649,Ernest Van Dijckkaai,2022-10-25,00:00:00,28,16,12,FMN 01 Ernest Van Dijckkaai
649,Ernest Van Dijckkaai,2022-10-25,01:00:00,14,3,11,FMN 01 Ernest Van Dijckkaai
649,Ernest Van Dijckkaai,2022-10-25,02:00:00,14,4,10,FMN 01 Ernest Van Dijckkaai
649,Ernest Van Dijckkaai,2022-10-25,03:00:00,18,9,9,FMN 01 Ernest Van Dijckkaai
649,Ernest Van Dijckkaai,2022-10-25,04:00:00,65,37,28,FMN 01 Ernest Van Dijckkaai
649,Ernest Van Dijckkaai,2022-10-25,05:00:00,154,106,48,FMN 01 Ernest Van Dijckkaai
649,Ernest Van Dijckkaai,2022-10-25,06:00:00,289,196,93,FMN 01 Ernest Van Dijckkaai
649,Ernest Van Dijckkaai,2022-10-25,07:00:00,557,346,211,FMN 01 Ernest Van Dijckkaai
649,Ernest Van Dijckkaai,2022-10-25,08:00:00,758,455,303,FMN 01 Ernest Van Dijckkaai
649,Ernest Van Dijckkaai,2022-10-25,09:00:00,344,204,140,FMN 01 Ernest Van Dijckkaai
649,Ernest Van Dijckkaai,2022-10-25,10:00:00,191,123,68,FMN 01 Ernest Van Dijckkaai
649,Ernest Van Dijckkaai,2022-10-25,11:00:00,233,127,106,FMN 01 Ernest Van Dijckkaai
649,Ernest Van Dijckkaai,2022-10-25,12:00:00,316,174,142,FMN 01 Ernest Van Dijckkaai
649,Ernest Van Dijckkaai,2022-10-25,13:00:00,323,187,136,FMN 01 Ernest Van Dijckkaai
649,Ernest Van Dijckkaai,2022-10-25,14:00:00,354,154,200,FMN 01 Ernest Van Dijckkaai
649,Ernest Van Dijckkaai,2022-10-25,15:00:00,476,221,255,FMN 01 Ernest Van Dijckkaai
649,Ernest Van Dijckkaai,2022-10-25,16:00:00,766,302,464,FMN 01 Ernest Van Dijckkaai
649,Ernest Van Dijckkaai,2022-10-25,17:00:00,793,343,450,FMN 01 Ernest Van Dijckkaai
649,Ernest Van Dijckkaai,2022-10-25,18:00:00,564,292,272,FMN 01 Ernest Van Dijckkaai
649,Ernest Van Dijckkaai,2022-10-25,19:00:00,283,143,140,FMN 01 Ernest Van Dijckkaai
649,Ernest Van Dijckkaai,2022-10-25,20:00:00,196,93,103,FMN 01 Ernest Van Dijckkaai
649,Ernest Van Dijckkaai,2022-10-25,21:00:00,174,72,102,FMN 01 Ernest Van Dijckkaai
649,Ernest Van Dijckkaai,2022-10-25,22:00:00,178,76,102,FMN 01 Ernest Van Dijckkaai
649,Ernest Van Dijckkaai,2022-10-25,23:00:00,81,35,46,FMN 01 Ernest Van Dijckkaai
649,Ernest Van Dijckkaai,2022-10-26,00:00:00,53,22,31,FMN 01 Ernest Van Dijckkaai
649,Ernest Van Dijckkaai,2022-10-26,01:00:00,35,13,22,FMN 01 Ernest Van Dijckkaai
649,Ernest Van Dijckkaai,2022-10-26,02:00:00,20,1,19,FMN 01 Ernest Van Dijckkaai
649,Ernest Van Dijckkaai,2022-10-26,03:00:00,30,3,27,FMN 01 Ernest Van Dijckkaai
649,Ernest Van Dijckkaai,2022-10-26,04:00:00,87,47,40,FMN 01 Ernest Van Dijckkaai
649,Ernest Van Dijckkaai,2022-10-26,05:00:00,148,97,51,FMN 01 Ernest Van Dijckkaai
649,Ernest Van Dijckkaai,2022-10-26,06:00:00,299,197,102,FMN 01 Ernest Van Dijckkaai
649,Ernest Van Dijckkaai,2022-10-26,07:00:00,537,351,186,FMN 01 Ernest Van Dijckkaai
649,Ernest Van Dijckkaai,2022-10-26,08:00:00,650,402,248,FMN 01 Ernest Van Dijckkaai
649,Ernest Van Dijckkaai,2022-10-26,09:00:00,320,207,113,FMN 01 Ernest Van Dijckkaai
649,Ernest Van Dijckkaai,2022-10-26,10:00:00,214,130,84,FMN 01 Ernest Van Dijckkaai
649,Ernest Van Dijckkaai,2022-10-26,11:00:00,238,120,118,FMN 01 Ernest Van Dijckkaai
649,Ernest Van Dijckkaai,2022-10-26,12:00:00,440,221,219,FMN 01 Ernest Van Dijckkaai
649,Ernest Van Dijckkaai,2022-10-26,13:00:00,369,201,168,FMN 01 Ernest Van Dijckkaai
649,Ernest Van Dijckkaai,2022-10-26,14:00:00,439,212,227,FMN 01 Ernest Van Dijckkaai
649,Ernest Van Dijckkaai,2022-10-26,15:00:00,518,251,267,FMN 01 Ernest Van Dijckkaai
649,Ernest Van Dijckkaai,2022-10-26,16:00:00,714,289,425,FMN 01 Ernest Van Dijckkaai
649,Ernest Van Dijckkaai,2022-10-26,17:00:00,737,297,440,FMN 01 Ernest Van Dijckkaai
649,Ernest Van Dijckkaai,2022-10-26,18:00:00,515,249,266,FMN 01 Ernest Van Dijckkaai
649,Ernest Van Dijckkaai,2022-10-26,19:00:00,300,151,149,FMN 01 Ernest Van Dijckkaai
649,Ernest Van Dijckkaai,2022-10-26,20:00:00,200,91,109,FMN 01 Ernest Van Dijckkaai
649,Ernest Van Dijckkaai,2022-10-26,21:00:00,192,95,97,FMN 01 Ernest Van Dijckkaai
649,Ernest Van Dijckkaai,2022-10-26,22:00:00,212,84,128,FMN 01 Ernest Van Dijckkaai
649,Ernest Van Dijckkaai,2022-10-26,23:00:00,97,42,55,FMN 01 Ernest Van Dijckkaai
649,Ernest Van Dijckkaai,2022-10-27,00:00:00,50,26,24,FMN 01 Ernest Van Dijckkaai
649,Ernest Van Dijckkaai,2022-10-27,01:00:00,27,10,17,FMN 01 Ernest Van Dijckkaai
649,Ernest Van Dijckkaai,2022-10-27,02:00:00,16,4,12,FMN 01 Ernest Van Dijckkaai
649,Ernest Van Dijckkaai,2022-10-27,03:00:00,17,7,10,FMN 01 Ernest Van Dijckkaai
649,Ernest Van Dijckkaai,2022-10-27,04:00:00,73,42,31,FMN 01 Ernest Van Dijckkaai
649,Ernest Van Dijckkaai,2022-10-27,05:00:00,148,92,56,FMN 01 Ernest Van Dijckkaai
649,Ernest Van Dijckkaai,2022-10-27,06:00:00,298,204,94,FMN 01 Ernest Van Dijckkaai
649,Ernest Van Dijckkaai,2022-10-27,07:00:00,512,306,206,FMN 01 Ernest Van Dijckkaai
649,Ernest Van Dijckkaai,2022-10-27,08:00:00,732,446,286,FMN 01 Ernest Van Dijckkaai
649,Ernest Van Dijckkaai,2022-10-27,09:00:00,405,281,124,FMN 01 Ernest Van Dijckkaai
649,Ernest Van Dijckkaai,2022-10-27,10:00:00,269,146,123,FMN 01 Ernest Van Dijckkaai
649,Ernest Van Dijckkaai,2022-10-27,11:00:00,268,130,138,FMN 01 Ernest Van Dijckkaai
649,Ernest Van Dijckkaai,2022-10-27,12:00:00,393,218,175,FMN 01 Ernest Van Dijckkaai
649,Ernest Van Dijckkaai,2022-10-27,13:00:00,389,204,185,FMN 01 Ernest Van Dijckkaai
649,Ernest Van Dijckkaai,2022-10-27,14:00:00,414,190,224,FMN 01 Ernest Van Dijckkaai
649,Ernest Van Dijckkaai,2022-10-27,15:00:00,539,245,294,FMN 01 Ernest Van Dijckkaai
649,Ernest Van Dijckkaai,2022-10-27,16:00:00,783,357,426,FMN 01 Ernest Van Dijckkaai
649,Ernest Van Dijckkaai,2022-10-27,17:00:00,817,351,466,FMN 01 Ernest Van Dijckkaai
649,Ernest Van Dijckkaai,2022-10-27,18:00:00,542,286,256,FMN 01 Ernest Van Dijckkaai
649,Ernest Van Dijckkaai,2022-10-27,19:00:00,307,162,145,FMN 01 Ernest Van Dijckkaai
649,Ernest Van Dijckkaai,2022-10-27,20:00:00,248,106,142,FMN 01 Ernest Van Dijckkaai
649,Ernest Van Dijckkaai,2022-10-27,21:00:00,212,92,120,FMN 01 Ernest Van Dijckkaai
649,Ernest Van Dijckkaai,2022-10-27,22:00:00,209,76,133,FMN 01 Ernest Van Dijckkaai
649,Ernest Van Dijckkaai,2022-10-27,23:00:00,107,41,66,FMN 01 Ernest Van Dijckkaai
649,Ernest Van Dijckkaai,2022-10-28,00:00:00,74,42,32,FMN 01 Ernest Van Dijckkaai
649,Ernest Van Dijckkaai,2022-10-28,01:00:00,42,29,13,FMN 01 Ernest Van Dijckkaai
649,Ernest Van Dijckkaai,2022-10-28,02:00:00,33,9,24,FMN 01 Ernest Van Dijckkaai
649,Ernest Van Dijckkaai,2022-10-28,03:00:00,39,8,31,FMN 01 Ernest Van Dijckkaai
649,Ernest Van Dijckkaai,2022-10-28,04:00:00,59,28,31,FMN 01 Ernest Van Dijckkaai
649,Ernest Van Dijckkaai,2022-10-28,05:00:00,153,93,60,FMN 01 Ernest Van Dijckkaai
649,Ernest Van Dijckkaai,2022-10-28,06:00:00,252,165,87,FMN 01 Ernest Van Dijckkaai
649,Ernest Van Dijckkaai,2022-10-28,07:00:00,469,282,187,FMN 01 Ernest Van Dijckkaai
649,Ernest Van Dijckkaai,2022-10-28,08:00:00,599,371,228,FMN 01 Ernest Van Dijckkaai
649,Ernest Van Dijckkaai,2022-10-28,09:00:00,309,202,107,FMN 01 Ernest Van Dijckkaai
649,Ernest Van Dijckkaai,2022-10-28,10:00:00,229,117,112,FMN 01 Ernest Van Dijckkaai
649,Ernest Van Dijckkaai,2022-10-28,11:00:00,283,148,135,FMN 01 Ernest Van Dijckkaai
649,Ernest Van Dijckkaai,2022-10-28,12:00:00,453,244,209,FMN 01 Ernest Van Dijckkaai
649,Ernest Van Dijckkaai,2022-10-28,13:00:00,404,222,182,FMN 01 Ernest Van Dijckkaai
649,Ernest Van Dijckkaai,2022-10-28,14:00:00,471,213,258,FMN 01 Ernest Van Dijckkaai
649,Ernest Van Dijckkaai,2022-10-28,15:00:00,557,266,291,FMN 01 Ernest Van Dijckkaai
649,Ernest Van Dijckkaai,2022-10-28,16:00:00,735,310,425,FMN 01 Ernest Van Dijckkaai
649,Ernest Van Dijckkaai,2022-10-28,17:00:00,633,295,338,FMN 01 Ernest Van Dijckkaai
649,Ernest Van Dijckkaai,2022-10-28,18:00:00,527,281,246,FMN 01 Ernest Van Dijckkaai
649,Ernest Van Dijckkaai,2022-10-28,19:00:00,383,211,172,FMN 01 Ernest Van Dijckkaai
649,Ernest Van Dijckkaai,2022-10-28,20:00:00,250,139,111,FMN 01 Ernest Van Dijckkaai
649,Ernest Van Dijckkaai,2022-10-28,21:00:00,223,119,104,FMN 01 Ernest Van Dijckkaai
649,Ernest Van Dijckkaai,2022-10-28,22:00:00,272,115,157,FMN 01 Ernest Van Dijckkaai
649,Ernest Van Dijckkaai,2022-10-28,23:00:00,213,79,134,FMN 01 Ernest Van Dijckkaai
649,Ernest Van Dijckkaai,2022-10-29,00:00:00,187,68,119,FMN 01 Ernest Van Dijckkaai
649,Ernest Van Dijckkaai,2022-10-29,01:00:00,98,44,54,FMN 01 Ernest Van Dijckkaai
649,Ernest Van Dijckkaai,2022-10-29,02:00:00,92,25,67,FMN 01 Ernest Van Dijckkaai
649,Ernest Van Dijckkaai,2022-10-29,03:00:00,74,21,53,FMN 01 Ernest Van Dijckkaai
649,Ernest Van Dijckkaai,2022-10-29,04:00:00,115,44,71,FMN 01 Ernest Van Dijckkaai
649,Ernest Van Dijckkaai,2022-10-29,05:00:00,98,32,66,FMN 01 Ernest Van Dijckkaai
649,Ernest Van Dijckkaai,2022-10-29,06:00:00,77,26,51,FMN 01 Ernest Van Dijckkaai
649,Ernest Van Dijckkaai,2022-10-29,07:00:00,52,29,23,FMN 01 Ernest Van Dijckkaai
649,Ernest Van Dijckkaai,2022-10-29,08:00:00,70,35,35,FMN 01 Ernest Van Dijckkaai
649,Ernest Van Dijckkaai,2022-10-29,09:00:00,124,74,50,FMN 01 Ernest Van Dijckkaai
649,Ernest Van Dijckkaai,2022-10-29,10:00:00,195,101,94,FMN 01 Ernest Van Dijckkaai
649,Ernest Van Dijckkaai,2022-10-29,11:00:00,261,154,107,FMN 01 Ernest Van Dijckkaai
649,Ernest Van Dijckkaai,2022-10-29,12:00:00,331,161,170,FMN 01 Ernest Van Dijckkaai
649,Ernest Van Dijckkaai,2022-10-29,13:00:00,486,281,205,FMN 01 Ernest Van Dijckkaai
649,Ernest Van Dijckkaai,2022-10-29,14:00:00,604,311,293,FMN 01 Ernest Van Dijckkaai
649,Ernest Van Dijckkaai,2022-10-29,15:00:00,591,296,295,FMN 01 Ernest Van Dijckkaai
649,Ernest Van Dijckkaai,2022-10-29,16:00:00,577,328,249,FMN 01 Ernest Van Dijckkaai
649,Ernest Van Dijckkaai,2022-10-29,17:00:00,515,252,263,FMN 01 Ernest Van Dijckkaai
649,Ernest Van Dijckkaai,2022-10-29,18:00:00,514,271,243,FMN 01 Ernest Van Dijckkaai
649,Ernest Van Dijckkaai,2022-10-29,19:00:00,271,136,135,FMN 01 Ernest Van Dijckkaai
649,Ernest Van Dijckkaai,2022-10-29,20:00:00,250,135,115,FMN 01 Ernest Van Dijckkaai
649,Ernest Van Dijckkaai,2022-10-29,21:00:00,148,72,76,FMN 01 Ernest Van Dijckkaai
649,Ernest Van Dijckkaai,2022-10-29,22:00:00,184,83,101,FMN 01 Ernest Van Dijckkaai
649,Ernest Van Dijckkaai,2022-10-29,23:00:00,211,95,116,FMN 01 Ernest Van Dijckkaai
649,Ernest Van Dijckkaai,2022-10-30,00:00:00,180,104,76,FMN 01 Ernest Van Dijckkaai
649,Ernest Van Dijckkaai,2022-10-30,01:00:00,88,27,61,FMN 01 Ernest Van Dijckkaai
649,Ernest Van Dijckkaai,2022-10-30,02:00:00,169,54,115,FMN 01 Ernest Van Dijckkaai
649,Ernest Van Dijckkaai,2022-10-30,03:00:00,45,6,39,FMN 01 Ernest Van Dijckkaai
649,Ernest Van Dijckkaai,2022-10-30,04:00:00,44,11,33,FMN 01 Ernest Van Dijckkaai
649,Ernest Van Dijckkaai,2022-10-30,05:00:00,46,18,28,FMN 01 Ernest Van Dijckkaai
649,Ernest Van Dijckkaai,2022-10-30,06:00:00,55,30,25,FMN 01 Ernest Van Dijckkaai
649,Ernest Van Dijckkaai,2022-10-30,07:00:00,34,19,15,FMN 01 Ernest Van Dijckkaai
649,Ernest Van Dijckkaai,2022-10-30,08:00:00,68,24,44,FMN 01 Ernest Van Dijckkaai
649,Ernest Van Dijckkaai,2022-10-30,09:00:00,170,105,65,FMN 01 Ernest Van Dijckkaai
649,Ernest Van Dijckkaai,2022-10-30,10:00:00,347,217,130,FMN 01 Ernest Van Dijckkaai
649,Ernest Van Dijckkaai,2022-10-30,11:00:00,411,209,202,FMN 01 Ernest Van Dijckkaai
649,Ernest Van Dijckkaai,2022-10-30,12:00:00,502,270,232,FMN 01 Ernest Van Dijckkaai
649,Ernest Van Dijckkaai,2022-10-30,13:00:00,485,258,227,FMN 01 Ernest Van Dijckkaai
649,Ernest Van Dijckkaai,2022-10-30,14:00:00,607,340,267,FMN 01 Ernest Van Dijckkaai
649,Ernest Van Dijckkaai,2022-10-30,15:00:00,647,330,317,FMN 01 Ernest Van Dijckkaai
649,Ernest Van Dijckkaai,2022-10-30,16:00:00,478,259,219,FMN 01 Ernest Van Dijckkaai
649,Ernest Van Dijckkaai,2022-10-30,17:00:00,350,178,172,FMN 01 Ernest Van Dijckkaai
649,Ernest Van Dijckkaai,2022-10-30,18:00:00,201,104,97,FMN 01 Ernest Van Dijckkaai
649,Ernest Van Dijckkaai,2022-10-30,19:00:00,162,93,69,FMN 01 Ernest Van Dijckkaai
649,Ernest Van Dijckkaai,2022-10-30,20:00:00,110,48,62,FMN 01 Ernest Van Dijckkaai
649,Ernest Van Dijckkaai,2022-10-30,21:00:00,79,29,50,FMN 01 Ernest Van Dijckkaai
649,Ernest Van Dijckkaai,2022-10-30,22:00:00,105,36,69,FMN 01 Ernest Van Dijckkaai
649,Ernest Van Dijckkaai,2022-10-30,23:00:00,67,20,47,FMN 01 Ernest Van Dijckkaai
649,Ernest Van Dijckkaai,2022-10-31,00:00:00,27,12,15,FMN 01 Ernest Van Dijckkaai
649,Ernest Van Dijckkaai,2022-10-31,01:00:00,17,3,14,FMN 01 Ernest Van Dijckkaai
649,Ernest Van Dijckkaai,2022-10-31,02:00:00,12,4,8,FMN 01 Ernest Van Dijckkaai
649,Ernest Van Dijckkaai,2022-10-31,03:00:00,11,3,8,FMN 01 Ernest Van Dijckkaai
649,Ernest Van Dijckkaai,2022-10-31,04:00:00,60,35,25,FMN 01 Ernest Van Dijckkaai
649,Ernest Van Dijckkaai,2022-10-31,05:00:00,85,60,25,FMN 01 Ernest Van Dijckkaai
649,Ernest Van Dijckkaai,2022-10-31,06:00:00,128,77,51,FMN 01 Ernest Van Dijckkaai
649,Ernest Van Dijckkaai,2022-10-31,07:00:00,178,111,67,FMN 01 Ernest Van Dijckkaai
649,Ernest Van Dijckkaai,2022-10-31,08:00:00,243,150,93,FMN 01 Ernest Van Dijckkaai
649,Ernest Van Dijckkaai,2022-10-31,09:00:00,146,83,63,FMN 01 Ernest Van Dijckkaai
649,Ernest Van Dijckkaai,2022-10-31,10:00:00,144,65,79,FMN 01 Ernest Van Dijckkaai
649,Ernest Van Dijckkaai,2022-10-31,11:00:00,157,82,75,FMN 01 Ernest Van Dijckkaai
649,Ernest Van Dijckkaai,2022-10-31,12:00:00,245,141,104,FMN 01 Ernest Van Dijckkaai
649,Ernest Van Dijckkaai,2022-10-31,13:00:00,248,157,91,FMN 01 Ernest Van Dijckkaai
649,Ernest Van Dijckkaai,2022-10-31,14:00:00,326,173,153,FMN 01 Ernest Van Dijckkaai
649,Ernest Van Dijckkaai,2022-10-31,15:00:00,370,188,182,FMN 01 Ernest Van Dijckkaai
649,Ernest Van Dijckkaai,2022-10-31,16:00:00,475,228,247,FMN 01 Ernest Van Dijckkaai
649,Ernest Van Dijckkaai,2022-10-31,17:00:00,408,171,237,FMN 01 Ernest Van Dijckkaai
649,Ernest Van Dijckkaai,2022-10-31,18:00:00,264,127,137,FMN 01 Ernest Van Dijckkaai
649,Ernest Van Dijckkaai,2022-10-31,19:00:00,219,115,104,FMN 01 Ernest Van Dijckkaai
649,Ernest Van Dijckkaai,2022-10-31,20:00:00,177,96,81,FMN 01 Ernest Van Dijckkaai
649,Ernest Van Dijckkaai,2022-10-31,21:00:00,134,85,49,FMN 01 Ernest Van Dijckkaai
649,Ernest Van Dijckkaai,2022-10-31,22:00:00,158,85,73,FMN 01 Ernest Van Dijckkaai
649,Ernest Van Dijckkaai,2022-10-31,23:00:00,152,97,55,FMN 01 Ernest Van Dijckkaai
649,Ernest Van Dijckkaai,2022-11-01,00:00:00,128,67,61,FMN 01 Ernest Van Dijckkaai
649,Ernest Van Dijckkaai,2022-11-01,01:00:00,77,34,43,FMN 01 Ernest Van Dijckkaai
649,Ernest Van Dijckkaai,2022-11-01,02:00:00,43,15,28,FMN 01 Ernest Van Dijckkaai
649,Ernest Van Dijckkaai,2022-11-01,03:00:00,56,17,39,FMN 01 Ernest Van Dijckkaai
649,Ernest Van Dijckkaai,2022-11-01,04:00:00,92,40,52,FMN 01 Ernest Van Dijckkaai
649,Ernest Van Dijckkaai,2022-11-01,05:00:00,72,33,39,FMN 01 Ernest Van Dijckkaai
649,Ernest Van Dijckkaai,2022-11-01,06:00:00,65,22,43,FMN 01 Ernest Van Dijckkaai
649,Ernest Van Dijckkaai,2022-11-01,07:00:00,45,20,25,FMN 01 Ernest Van Dijckkaai
649,Ernest Van Dijckkaai,2022-11-01,08:00:00,49,28,21,FMN 01 Ernest Van Dijckkaai
649,Ernest Van Dijckkaai,2022-11-01,09:00:00,89,50,39,FMN 01 Ernest Van Dijckkaai
649,Ernest Van Dijckkaai,2022-11-01,10:00:00,153,85,68,FMN 01 Ernest Van Dijckkaai
649,Ernest Van Dijckkaai,2022-11-01,11:00:00,179,96,83,FMN 01 Ernest Van Dijckkaai
649,Ernest Van Dijckkaai,2022-11-01,12:00:00,226,116,110,FMN 01 Ernest Van Dijckkaai
649,Ernest Van Dijckkaai,2022-11-01,13:00:00,266,158,108,FMN 01 Ernest Van Dijckkaai
649,Ernest Van Dijckkaai,2022-11-01,14:00:00,388,210,178,FMN 01 Ernest Van Dijckkaai
649,Ernest Van Dijckkaai,2022-11-01,15:00:00,344,175,169,FMN 01 Ernest Van Dijckkaai
649,Ernest Van Dijckkaai,2022-11-01,16:00:00,295,161,134,FMN 01 Ernest Van Dijckkaai
649,Ernest Van Dijckkaai,2022-11-01,17:00:00,202,86,116,FMN 01 Ernest Van Dijckkaai
649,Ernest Van Dijckkaai,2022-11-01,18:00:00,192,94,98,FMN 01 Ernest Van Dijckkaai
649,Ernest Van Dijckkaai,2022-11-01,19:00:00,128,81,47,FMN 01 Ernest Van Dijckkaai
649,Ernest Van Dijckkaai,2022-11-01,20:00:00,78,35,43,FMN 01 Ernest Van Dijckkaai
649,Ernest Van Dijckkaai,2022-11-01,21:00:00,69,34,35,FMN 01 Ernest Van Dijckkaai
649,Ernest Van Dijckkaai,2022-11-01,22:00:00,72,20,52,FMN 01 Ernest Van Dijckkaai
649,Ernest Van Dijckkaai,2022-11-01,23:00:00,37,17,20,FMN 01 Ernest Van Dijckkaai
649,Ernest Van Dijckkaai,2022-11-02,00:00:00,33,12,21,FMN 01 Ernest Van Dijckkaai
649,Ernest Van Dijckkaai,2022-11-02,01:00:00,16,4,12,FMN 01 Ernest Van Dijckkaai
649,Ernest Van Dijckkaai,2022-11-02,02:00:00,3,1,2,FMN 01 Ernest Van Dijckkaai
649,Ernest Van Dijckkaai,2022-11-02,03:00:00,10,2,8,FMN 01 Ernest Van Dijckkaai
649,Ernest Van Dijckkaai,2022-11-02,04:00:00,57,40,17,FMN 01 Ernest Van Dijckkaai
649,Ernest Van Dijckkaai,2022-11-02,05:00:00,105,69,36,FMN 01 Ernest Van Dijckkaai
649,Ernest Van Dijckkaai,2022-11-02,06:00:00,209,129,80,FMN 01 Ernest Van Dijckkaai
649,Ernest Van Dijckkaai,2022-11-02,07:00:00,338,229,109,FMN 01 Ernest Van Dijckkaai
649,Ernest Van Dijckkaai,2022-11-02,08:00:00,388,230,158,FMN 01 Ernest Van Dijckkaai
649,Ernest Van Dijckkaai,2022-11-02,09:00:00,219,135,84,FMN 01 Ernest Van Dijckkaai
649,Ernest Van Dijckkaai,2022-11-02,10:00:00,173,91,82,FMN 01 Ernest Van Dijckkaai
649,Ernest Van Dijckkaai,2022-11-02,11:00:00,207,112,95,FMN 01 Ernest Van Dijckkaai
649,Ernest Van Dijckkaai,2022-11-02,12:00:00,247,141,106,FMN 01 Ernest Van Dijckkaai
649,Ernest Van Dijckkaai,2022-11-02,13:00:00,253,148,105,FMN 01 Ernest Van Dijckkaai
649,Ernest Van Dijckkaai,2022-11-02,14:00:00,353,181,172,FMN 01 Ernest Van Dijckkaai
649,Ernest Van Dijckkaai,2022-11-02,15:00:00,361,206,155,FMN 01 Ernest Van Dijckkaai
649,Ernest Van Dijckkaai,2022-11-02,16:00:00,471,198,273,FMN 01 Ernest Van Dijckkaai
649,Ernest Van Dijckkaai,2022-11-02,17:00:00,542,227,315,FMN 01 Ernest Van Dijckkaai
649,Ernest Van Dijckkaai,2022-11-02,18:00:00,376,186,190,FMN 01 Ernest Van Dijckkaai
649,Ernest Van Dijckkaai,2022-11-02,19:00:00,220,102,118,FMN 01 Ernest Van Dijckkaai
649,Ernest Van Dijckkaai,2022-11-02,20:00:00,138,79,59,FMN 01 Ernest Van Dijckkaai
649,Ernest Van Dijckkaai,2022-11-02,21:00:00,113,53,60,FMN 01 Ernest Van Dijckkaai
649,Ernest Van Dijckkaai,2022-11-02,22:00:00,146,47,99,FMN 01 Ernest Van Dijckkaai
649,Ernest Van Dijckkaai,2022-11-02,23:00:00,58,18,40,FMN 01 Ernest Van Dijckkaai
649,Ernest Van Dijckkaai,2022-11-03,00:00:00,38,12,26,FMN 01 Ernest Van Dijckkaai
649,Ernest Van Dijckkaai,2022-11-03,01:00:00,7,2,5,FMN 01 Ernest Van Dijckkaai
649,Ernest Van Dijckkaai,2022-11-03,02:00:00,12,9,3,FMN 01 Ernest Van Dijckkaai
649,Ernest Van Dijckkaai,2022-11-03,03:00:00,6,3,3,FMN 01 Ernest Van Dijckkaai
649,Ernest Van Dijckkaai,2022-11-03,04:00:00,53,34,19,FMN 01 Ernest Van Dijckkaai
649,Ernest Van Dijckkaai,2022-11-03,05:00:00,115,77,38,FMN 01 Ernest Van Dijckkaai
649,Ernest Van Dijckkaai,2022-11-03,06:00:00,204,119,85,FMN 01 Ernest Van Dijckkaai
649,Ernest Van Dijckkaai,2022-11-03,07:00:00,309,191,118,FMN 01 Ernest Van Dijckkaai
649,Ernest Van Dijckkaai,2022-11-03,08:00:00,381,231,150,FMN 01 Ernest Van Dijckkaai
649,Ernest Van Dijckkaai,2022-11-03,09:00:00,233,142,91,FMN 01 Ernest Van Dijckkaai
649,Ernest Van Dijckkaai,2022-11-03,10:00:00,126,73,53,FMN 01 Ernest Van Dijckkaai
649,Ernest Van Dijckkaai,2022-11-03,11:00:00,157,84,73,FMN 01 Ernest Van Dijckkaai
649,Ernest Van Dijckkaai,2022-11-03,12:00:00,261,159,102,FMN 01 Ernest Van Dijckkaai
649,Ernest Van Dijckkaai,2022-11-03,13:00:00,238,134,104,FMN 01 Ernest Van Dijckkaai
649,Ernest Van Dijckkaai,2022-11-03,14:00:00,243,120,123,FMN 01 Ernest Van Dijckkaai
649,Ernest Van Dijckkaai,2022-11-03,15:00:00,273,148,125,FMN 01 Ernest Van Dijckkaai
649,Ernest Van Dijckkaai,2022-11-03,16:00:00,393,171,222,FMN 01 Ernest Van Dijckkaai
649,Ernest Van Dijckkaai,2022-11-03,17:00:00,412,165,247,FMN 01 Ernest Van Dijckkaai
649,Ernest Van Dijckkaai,2022-11-03,18:00:00,288,143,145,FMN 01 Ernest Van Dijckkaai
649,Ernest Van Dijckkaai,2022-11-03,19:00:00,147,71,76,FMN 01 Ernest Van Dijckkaai
649,Ernest Van Dijckkaai,2022-11-03,20:00:00,111,55,56,FMN 01 Ernest Van Dijckkaai
649,Ernest Van Dijckkaai,2022-11-03,21:00:00,85,36,49,FMN 01 Ernest Van Dijckkaai
649,Ernest Van Dijckkaai,2022-11-03,22:00:00,111,43,68,FMN 01 Ernest Van Dijckkaai
649,Ernest Van Dijckkaai,2022-11-03,23:00:00,71,25,46,FMN 01 Ernest Van Dijckkaai
649,Ernest Van Dijckkaai,2022-11-04,00:00:00,29,17,12,FMN 01 Ernest Van Dijckkaai
649,Ernest Van Dijckkaai,2022-11-04,01:00:00,21,9,12,FMN 01 Ernest Van Dijckkaai
649,Ernest Van Dijckkaai,2022-11-04,02:00:00,11,4,7,FMN 01 Ernest Van Dijckkaai
649,Ernest Van Dijckkaai,2022-11-04,03:00:00,17,5,12,FMN 01 Ernest Van Dijckkaai
649,Ernest Van Dijckkaai,2022-11-04,04:00:00,51,28,23,FMN 01 Ernest Van Dijckkaai
649,Ernest Van Dijckkaai,2022-11-04,05:00:00,103,67,36,FMN 01 Ernest Van Dijckkaai
649,Ernest Van Dijckkaai,2022-11-04,06:00:00,183,115,68,FMN 01 Ernest Van Dijckkaai
649,Ernest Van Dijckkaai,2022-11-04,07:00:00,210,135,75,FMN 01 Ernest Van Dijckkaai
649,Ernest Van Dijckkaai,2022-11-04,08:00:00,275,169,106,FMN 01 Ernest Van Dijckkaai
649,Ernest Van Dijckkaai,2022-11-04,09:00:00,202,127,75,FMN 01 Ernest Van Dijckkaai
649,Ernest Van Dijckkaai,2022-11-04,10:00:00,133,75,58,FMN 01 Ernest Van Dijckkaai
649,Ernest Van Dijckkaai,2022-11-04,11:00:00,143,71,72,FMN 01 Ernest Van Dijckkaai
649,Ernest Van Dijckkaai,2022-11-04,12:00:00,211,121,90,FMN 01 Ernest Van Dijckkaai
649,Ernest Van Dijckkaai,2022-11-04,13:00:00,216,127,89,FMN 01 Ernest Van Dijckkaai
649,Ernest Van Dijckkaai,2022-11-04,14:00:00,265,130,135,FMN 01 Ernest Van Dijckkaai
649,Ernest Van Dijckkaai,2022-11-04,15:00:00,290,132,158,FMN 01 Ernest Van Dijckkaai
649,Ernest Van Dijckkaai,2022-11-04,16:00:00,406,156,250,FMN 01 Ernest Van Dijckkaai
649,Ernest Van Dijckkaai,2022-11-04,17:00:00,402,165,237,FMN 01 Ernest Van Dijckkaai
649,Ernest Van Dijckkaai,2022-11-04,18:00:00,309,161,148,FMN 01 Ernest Van Dijckkaai
649,Ernest Van Dijckkaai,2022-11-04,19:00:00,214,124,90,FMN 01 Ernest Van Dijckkaai
649,Ernest Van Dijckkaai,2022-11-04,20:00:00,156,81,75,FMN 01 Ernest Van Dijckkaai
649,Ernest Van Dijckkaai,2022-11-04,21:00:00,144,66,78,FMN 01 Ernest Van Dijckkaai
649,Ernest Van Dijckkaai,2022-11-04,22:00:00,199,89,110,FMN 01 Ernest Van Dijckkaai
649,Ernest Van Dijckkaai,2022-11-04,23:00:00,107,47,60,FMN 01 Ernest Van Dijckkaai
649,Ernest Van Dijckkaai,2022-11-05,00:00:00,82,44,38,FMN 01 Ernest Van Dijckkaai
649,Ernest Van Dijckkaai,2022-11-05,01:00:00,61,30,31,FMN 01 Ernest Van Dijckkaai
649,Ernest Van Dijckkaai,2022-11-05,02:00:00,59,22,37,FMN 01 Ernest Van Dijckkaai
649,Ernest Van Dijckkaai,2022-11-05,03:00:00,38,4,34,FMN 01 Ernest Van Dijckkaai
649,Ernest Van Dijckkaai,2022-11-05,04:00:00,47,20,27,FMN 01 Ernest Van Dijckkaai
649,Ernest Van Dijckkaai,2022-11-05,05:00:00,53,30,23,FMN 01 Ernest Van Dijckkaai
649,Ernest Van Dijckkaai,2022-11-05,06:00:00,40,25,15,FMN 01 Ernest Van Dijckkaai
649,Ernest Van Dijckkaai,2022-11-05,07:00:00,33,17,16,FMN 01 Ernest Van Dijckkaai
649,Ernest Van Dijckkaai,2022-11-05,08:00:00,72,42,30,FMN 01 Ernest Van Dijckkaai
649,Ernest Van Dijckkaai,2022-11-05,09:00:00,140,82,58,FMN 01 Ernest Van Dijckkaai
649,Ernest Van Dijckkaai,2022-11-05,10:00:00,167,95,72,FMN 01 Ernest Van Dijckkaai
649,Ernest Van Dijckkaai,2022-11-05,11:00:00,206,110,96,FMN 01 Ernest Van Dijckkaai
649,Ernest Van Dijckkaai,2022-11-05,12:00:00,250,126,124,FMN 01 Ernest Van Dijckkaai
649,Ernest Van Dijckkaai,2022-11-05,13:00:00,315,167,148,FMN 01 Ernest Van Dijckkaai
649,Ernest Van Dijckkaai,2022-11-05,14:00:00,300,164,136,FMN 01 Ernest Van Dijckkaai
649,Ernest Van Dijckkaai,2022-11-05,15:00:00,342,178,164,FMN 01 Ernest Van Dijckkaai
649,Ernest Van Dijckkaai,2022-11-05,16:00:00,266,132,134,FMN 01 Ernest Van Dijckkaai
649,Ernest Van Dijckkaai,2022-11-05,17:00:00,249,134,115,FMN 01 Ernest Van Dijckkaai
649,Ernest Van Dijckkaai,2022-11-05,18:00:00,213,100,113,FMN 01 Ernest Van Dijckkaai
649,Ernest Van Dijckkaai,2022-11-05,19:00:00,166,73,93,FMN 01 Ernest Van Dijckkaai
649,Ernest Van Dijckkaai,2022-11-05,20:00:00,161,71,90,FMN 01 Ernest Van Dijckkaai
649,Ernest Van Dijckkaai,2022-11-05,21:00:00,90,37,53,FMN 01 Ernest Van Dijckkaai
649,Ernest Van Dijckkaai,2022-11-05,22:00:00,115,50,65,FMN 01 Ernest Van Dijckkaai
649,Ernest Van Dijckkaai,2022-11-05,23:00:00,98,42,56,FMN 01 Ernest Van Dijckkaai
649,Ernest Van Dijckkaai,2022-11-06,00:00:00,83,38,45,FMN 01 Ernest Van Dijckkaai
649,Ernest Van Dijckkaai,2022-11-06,01:00:00,59,19,40,FMN 01 Ernest Van Dijckkaai
649,Ernest Van Dijckkaai,2022-11-06,02:00:00,58,21,37,FMN 01 Ernest Van Dijckkaai
649,Ernest Van Dijckkaai,2022-11-06,03:00:00,48,18,30,FMN 01 Ernest Van Dijckkaai
649,Ernest Van Dijckkaai,2022-11-06,04:00:00,39,14,25,FMN 01 Ernest Van Dijckkaai
649,Ernest Van Dijckkaai,2022-11-06,05:00:00,32,21,11,FMN 01 Ernest Van Dijckkaai
649,Ernest Van Dijckkaai,2022-11-06,06:00:00,30,19,11,FMN 01 Ernest Van Dijckkaai
649,Ernest Van Dijckkaai,2022-11-06,07:00:00,45,26,19,FMN 01 Ernest Van Dijckkaai
649,Ernest Van Dijckkaai,2022-11-06,08:00:00,45,28,17,FMN 01 Ernest Van Dijckkaai
649,Ernest Van Dijckkaai,2022-11-06,09:00:00,97,53,44,FMN 01 Ernest Van Dijckkaai
649,Ernest Van Dijckkaai,2022-11-06,10:00:00,122,77,45,FMN 01 Ernest Van Dijckkaai
649,Ernest Van Dijckkaai,2022-11-06,11:00:00,153,82,71,FMN 01 Ernest Van Dijckkaai
649,Ernest Van Dijckkaai,2022-11-06,12:00:00,150,90,60,FMN 01 Ernest Van Dijckkaai
649,Ernest Van Dijckkaai,2022-11-06,13:00:00,103,58,45,FMN 01 Ernest Van Dijckkaai
649,Ernest Van Dijckkaai,2022-11-06,14:00:00,75,31,44,FMN 01 Ernest Van Dijckkaai
649,Ernest Van Dijckkaai,2022-11-06,15:00:00,70,26,44,FMN 01 Ernest Van Dijckkaai
649,Ernest Van Dijckkaai,2022-11-06,16:00:00,86,55,31,FMN 01 Ernest Van Dijckkaai
649,Ernest Van Dijckkaai,2022-11-06,17:00:00,94,49,45,FMN 01 Ernest Van Dijckkaai
649,Ernest Van Dijckkaai,2022-11-06,18:00:00,82,42,40,FMN 01 Ernest Van Dijckkaai
649,Ernest Van Dijckkaai,2022-11-06,19:00:00,60,30,30,FMN 01 Ernest Van Dijckkaai
649,Ernest Van Dijckkaai,2022-11-06,20:00:00,58,24,34,FMN 01 Ernest Van Dijckkaai
649,Ernest Van Dijckkaai,2022-11-06,21:00:00,59,25,34,FMN 01 Ernest Van Dijckkaai
649,Ernest Van Dijckkaai,2022-11-06,22:00:00,57,22,35,FMN 01 Ernest Van Dijckkaai
649,Ernest Van Dijckkaai,2022-11-06,23:00:00,15,3,12,FMN 01 Ernest Van Dijckkaai
649,Ernest Van Dijckkaai,2022-11-07,00:00:00,18,5,13,FMN 01 Ernest Van Dijckkaai
649,Ernest Van Dijckkaai,2022-11-07,01:00:00,9,5,4,FMN 01 Ernest Van Dijckkaai
649,Ernest Van Dijckkaai,2022-11-07,02:00:00,6,3,3,FMN 01 Ernest Van Dijckkaai
649,Ernest Van Dijckkaai,2022-11-07,03:00:00,6,3,3,FMN 01 Ernest Van Dijckkaai
649,Ernest Van Dijckkaai,2022-11-07,04:00:00,49,31,18,FMN 01 Ernest Van Dijckkaai
649,Ernest Van Dijckkaai,2022-11-07,05:00:00,115,75,40,FMN 01 Ernest Van Dijckkaai
649,Ernest Van Dijckkaai,2022-11-07,06:00:00,210,141,69,FMN 01 Ernest Van Dijckkaai
649,Ernest Van Dijckkaai,2022-11-07,07:00:00,405,261,144,FMN 01 Ernest Van Dijckkaai
649,Ernest Van Dijckkaai,2022-11-07,08:00:00,535,335,200,FMN 01 Ernest Van Dijckkaai
649,Ernest Van Dijckkaai,2022-11-07,09:00:00,240,159,81,FMN 01 Ernest Van Dijckkaai
649,Ernest Van Dijckkaai,2022-11-07,10:00:00,138,87,51,FMN 01 Ernest Van Dijckkaai
649,Ernest Van Dijckkaai,2022-11-07,11:00:00,146,72,74,FMN 01 Ernest Van Dijckkaai
649,Ernest Van Dijckkaai,2022-11-07,12:00:00,249,133,116,FMN 01 Ernest Van Dijckkaai
649,Ernest Van Dijckkaai,2022-11-07,13:00:00,212,120,92,FMN 01 Ernest Van Dijckkaai
649,Ernest Van Dijckkaai,2022-11-07,14:00:00,187,82,105,FMN 01 Ernest Van Dijckkaai
649,Ernest Van Dijckkaai,2022-11-07,15:00:00,286,152,134,FMN 01 Ernest Van Dijckkaai
649,Ernest Van Dijckkaai,2022-11-07,16:00:00,526,217,309,FMN 01 Ernest Van Dijckkaai
649,Ernest Van Dijckkaai,2022-11-07,17:00:00,590,260,330,FMN 01 Ernest Van Dijckkaai
649,Ernest Van Dijckkaai,2022-11-07,18:00:00,345,172,173,FMN 01 Ernest Van Dijckkaai
649,Ernest Van Dijckkaai,2022-11-07,19:00:00,196,87,109,FMN 01 Ernest Van Dijckkaai
649,Ernest Van Dijckkaai,2022-11-07,20:00:00,132,65,67,FMN 01 Ernest Van Dijckkaai
649,Ernest Van Dijckkaai,2022-11-07,21:00:00,134,68,66,FMN 01 Ernest Van Dijckkaai
649,Ernest Van Dijckkaai,2022-11-07,22:00:00,132,40,92,FMN 01 Ernest Van Dijckkaai
649,Ernest Van Dijckkaai,2022-11-07,23:00:00,46,16,30,FMN 01 Ernest Van Dijckkaai
649,Ernest Van Dijckkaai,2022-11-08,00:00:00,28,8,20,FMN 01 Ernest Van Dijckkaai
649,Ernest Van Dijckkaai,2022-11-08,01:00:00,7,2,5,FMN 01 Ernest Van Dijckkaai
649,Ernest Van Dijckkaai,2022-11-08,02:00:00,10,2,8,FMN 01 Ernest Van Dijckkaai
649,Ernest Van Dijckkaai,2022-11-08,03:00:00,9,5,4,FMN 01 Ernest Van Dijckkaai
649,Ernest Van Dijckkaai,2022-11-08,04:00:00,54,34,20,FMN 01 Ernest Van Dijckkaai
649,Ernest Van Dijckkaai,2022-11-08,05:00:00,137,92,45,FMN 01 Ernest Van Dijckkaai
649,Ernest Van Dijckkaai,2022-11-08,06:00:00,259,167,92,FMN 01 Ernest Van Dijckkaai
649,Ernest Van Dijckkaai,2022-11-08,07:00:00,530,324,206,FMN 01 Ernest Van Dijckkaai
649,Ernest Van Dijckkaai,2022-11-08,08:00:00,655,403,252,FMN 01 Ernest Van Dijckkaai
649,Ernest Van Dijckkaai,2022-11-08,09:00:00,290,194,96,FMN 01 Ernest Van Dijckkaai
649,Ernest Van Dijckkaai,2022-11-08,10:00:00,220,121,99,FMN 01 Ernest Van Dijckkaai
649,Ernest Van Dijckkaai,2022-11-08,11:00:00,161,83,78,FMN 01 Ernest Van Dijckkaai
649,Ernest Van Dijckkaai,2022-11-08,12:00:00,267,145,122,FMN 01 Ernest Van Dijckkaai
649,Ernest Van Dijckkaai,2022-11-08,13:00:00,279,178,101,FMN 01 Ernest Van Dijckkaai
649,Ernest Van Dijckkaai,2022-11-08,14:00:00,303,154,149,FMN 01 Ernest Van Dijckkaai
649,Ernest Van Dijckkaai,2022-11-08,15:00:00,391,196,195,FMN 01 Ernest Van Dijckkaai
649,Ernest Van Dijckkaai,2022-11-08,16:00:00,672,290,382,FMN 01 Ernest Van Dijckkaai
649,Ernest Van Dijckkaai,2022-11-08,17:00:00,711,307,404,FMN 01 Ernest Van Dijckkaai
649,Ernest Van Dijckkaai,2022-11-08,18:00:00,395,202,193,FMN 01 Ernest Van Dijckkaai
649,Ernest Van Dijckkaai,2022-11-08,19:00:00,261,129,132,FMN 01 Ernest Van Dijckkaai
649,Ernest Van Dijckkaai,2022-11-08,20:00:00,162,71,91,FMN 01 Ernest Van Dijckkaai
649,Ernest Van Dijckkaai,2022-11-08,21:00:00,119,52,67,FMN 01 Ernest Van Dijckkaai
649,Ernest Van Dijckkaai,2022-11-08,22:00:00,156,52,104,FMN 01 Ernest Van Dijckkaai
649,Ernest Van Dijckkaai,2022-11-08,23:00:00,72,20,52,FMN 01 Ernest Van Dijckkaai
649,Ernest Van Dijckkaai,2022-11-09,00:00:00,32,10,22,FMN 01 Ernest Van Dijckkaai
649,Ernest Van Dijckkaai,2022-11-09,01:00:00,12,7,5,FMN 01 Ernest Van Dijckkaai
649,Ernest Van Dijckkaai,2022-11-09,02:00:00,7,2,5,FMN 01 Ernest Van Dijckkaai
649,Ernest Van Dijckkaai,2022-11-09,03:00:00,13,1,12,FMN 01 Ernest Van Dijckkaai
649,Ernest Van Dijckkaai,2022-11-09,04:00:00,46,37,9,FMN 01 Ernest Van Dijckkaai
649,Ernest Van Dijckkaai,2022-11-09,05:00:00,101,64,37,FMN 01 Ernest Van Dijckkaai
649,Ernest Van Dijckkaai,2022-11-09,06:00:00,235,141,94,FMN 01 Ernest Van Dijckkaai
649,Ernest Van Dijckkaai,2022-11-09,07:00:00,476,310,166,FMN 01 Ernest Van Dijckkaai
649,Ernest Van Dijckkaai,2022-11-09,08:00:00,579,371,208,FMN 01 Ernest Van Dijckkaai
649,Ernest Van Dijckkaai,2022-11-09,09:00:00,280,180,100,FMN 01 Ernest Van Dijckkaai
649,Ernest Van Dijckkaai,2022-11-09,10:00:00,181,108,73,FMN 01 Ernest Van Dijckkaai
649,Ernest Van Dijckkaai,2022-11-09,11:00:00,200,101,99,FMN 01 Ernest Van Dijckkaai
649,Ernest Van Dijckkaai,2022-11-09,12:00:00,336,173,163,FMN 01 Ernest Van Dijckkaai
649,Ernest Van Dijckkaai,2022-11-09,13:00:00,311,170,141,FMN 01 Ernest Van Dijckkaai
649,Ernest Van Dijckkaai,2022-11-09,14:00:00,269,134,135,FMN 01 Ernest Van Dijckkaai
649,Ernest Van Dijckkaai,2022-11-09,15:00:00,317,151,166,FMN 01 Ernest Van Dijckkaai
649,Ernest Van Dijckkaai,2022-11-09,16:00:00,533,223,310,FMN 01 Ernest Van Dijckkaai
649,Ernest Van Dijckkaai,2022-11-09,17:00:00,646,285,361,FMN 01 Ernest Van Dijckkaai
649,Ernest Van Dijckkaai,2022-11-09,18:00:00,388,186,202,FMN 01 Ernest Van Dijckkaai
649,Ernest Van Dijckkaai,2022-11-09,19:00:00,252,142,110,FMN 01 Ernest Van Dijckkaai
649,Ernest Van Dijckkaai,2022-11-09,20:00:00,169,84,85,FMN 01 Ernest Van Dijckkaai
649,Ernest Van Dijckkaai,2022-11-09,21:00:00,139,74,65,FMN 01 Ernest Van Dijckkaai
649,Ernest Van Dijckkaai,2022-11-09,22:00:00,133,44,89,FMN 01 Ernest Van Dijckkaai
649,Ernest Van Dijckkaai,2022-11-09,23:00:00,73,28,45,FMN 01 Ernest Van Dijckkaai
649,Ernest Van Dijckkaai,2022-11-10,00:00:00,30,17,13,FMN 01 Ernest Van Dijckkaai
649,Ernest Van Dijckkaai,2022-11-10,01:00:00,18,7,11,FMN 01 Ernest Van Dijckkaai
649,Ernest Van Dijckkaai,2022-11-10,02:00:00,10,1,9,FMN 01 Ernest Van Dijckkaai
649,Ernest Van Dijckkaai,2022-11-10,03:00:00,13,5,8,FMN 01 Ernest Van Dijckkaai
649,Ernest Van Dijckkaai,2022-11-10,04:00:00,61,44,17,FMN 01 Ernest Van Dijckkaai
649,Ernest Van Dijckkaai,2022-11-10,05:00:00,117,83,34,FMN 01 Ernest Van Dijckkaai
649,Ernest Van Dijckkaai,2022-11-10,06:00:00,246,160,86,FMN 01 Ernest Van Dijckkaai
649,Ernest Van Dijckkaai,2022-11-10,07:00:00,441,277,164,FMN 01 Ernest Van Dijckkaai
649,Ernest Van Dijckkaai,2022-11-10,08:00:00,613,354,259,FMN 01 Ernest Van Dijckkaai
649,Ernest Van Dijckkaai,2022-11-10,09:00:00,292,184,108,FMN 01 Ernest Van Dijckkaai
649,Ernest Van Dijckkaai,2022-11-10,10:00:00,253,154,99,FMN 01 Ernest Van Dijckkaai
649,Ernest Van Dijckkaai,2022-11-10,11:00:00,255,136,119,FMN 01 Ernest Van Dijckkaai
649,Ernest Van Dijckkaai,2022-11-10,12:00:00,352,194,158,FMN 01 Ernest Van Dijckkaai
649,Ernest Van Dijckkaai,2022-11-10,13:00:00,332,198,134,FMN 01 Ernest Van Dijckkaai
649,Ernest Van Dijckkaai,2022-11-10,14:00:00,362,187,175,FMN 01 Ernest Van Dijckkaai
649,Ernest Van Dijckkaai,2022-11-10,15:00:00,385,202,183,FMN 01 Ernest Van Dijckkaai
649,Ernest Van Dijckkaai,2022-11-10,16:00:00,644,283,361,FMN 01 Ernest Van Dijckkaai
649,Ernest Van Dijckkaai,2022-11-10,17:00:00,646,299,347,FMN 01 Ernest Van Dijckkaai
649,Ernest Van Dijckkaai,2022-11-10,18:00:00,450,219,231,FMN 01 Ernest Van Dijckkaai
649,Ernest Van Dijckkaai,2022-11-10,19:00:00,249,140,109,FMN 01 Ernest Van Dijckkaai
649,Ernest Van Dijckkaai,2022-11-10,20:00:00,203,97,106,FMN 01 Ernest Van Dijckkaai
649,Ernest Van Dijckkaai,2022-11-10,21:00:00,156,71,85,FMN 01 Ernest Van Dijckkaai
649,Ernest Van Dijckkaai,2022-11-10,22:00:00,247,127,120,FMN 01 Ernest Van Dijckkaai
649,Ernest Van Dijckkaai,2022-11-10,23:00:00,193,99,94,FMN 01 Ernest Van Dijckkaai
649,Ernest Van Dijckkaai,2022-11-11,00:00:00,122,48,74,FMN 01 Ernest Van Dijckkaai
649,Ernest Van Dijckkaai,2022-11-11,01:00:00,97,44,53,FMN 01 Ernest Van Dijckkaai
649,Ernest Van Dijckkaai,2022-11-11,02:00:00,59,25,34,FMN 01 Ernest Van Dijckkaai
649,Ernest Van Dijckkaai,2022-11-11,03:00:00,62,21,41,FMN 01 Ernest Van Dijckkaai
649,Ernest Van Dijckkaai,2022-11-11,04:00:00,65,29,36,FMN 01 Ernest Van Dijckkaai
649,Ernest Van Dijckkaai,2022-11-11,05:00:00,56,32,24,FMN 01 Ernest Van Dijckkaai
649,Ernest Van Dijckkaai,2022-11-11,06:00:00,67,30,37,FMN 01 Ernest Van Dijckkaai
649,Ernest Van Dijckkaai,2022-11-11,07:00:00,44,17,27,FMN 01 Ernest Van Dijckkaai
649,Ernest Van Dijckkaai,2022-11-11,08:00:00,66,35,31,FMN 01 Ernest Van Dijckkaai
649,Ernest Van Dijckkaai,2022-11-11,09:00:00,146,63,83,FMN 01 Ernest Van Dijckkaai
649,Ernest Van Dijckkaai,2022-11-11,10:00:00,144,78,66,FMN 01 Ernest Van Dijckkaai
649,Ernest Van Dijckkaai,2022-11-11,11:00:00,190,97,93,FMN 01 Ernest Van Dijckkaai
649,Ernest Van Dijckkaai,2022-11-11,12:00:00,281,155,126,FMN 01 Ernest Van Dijckkaai
649,Ernest Van Dijckkaai,2022-11-11,13:00:00,313,173,140,FMN 01 Ernest Van Dijckkaai
649,Ernest Van Dijckkaai,2022-11-11,14:00:00,449,250,199,FMN 01 Ernest Van Dijckkaai
649,Ernest Van Dijckkaai,2022-11-11,15:00:00,359,207,152,FMN 01 Ernest Van Dijckkaai
649,Ernest Van Dijckkaai,2022-11-11,16:00:00,320,189,131,FMN 01 Ernest Van Dijckkaai
649,Ernest Van Dijckkaai,2022-11-11,17:00:00,265,122,143,FMN 01 Ernest Van Dijckkaai
649,Ernest Van Dijckkaai,2022-11-11,18:00:00,242,118,124,FMN 01 Ernest Van Dijckkaai
649,Ernest Van Dijckkaai,2022-11-11,19:00:00,147,81,66,FMN 01 Ernest Van Dijckkaai
649,Ernest Van Dijckkaai,2022-11-11,20:00:00,126,52,74,FMN 01 Ernest Van Dijckkaai
649,Ernest Van Dijckkaai,2022-11-11,21:00:00,147,60,87,FMN 01 Ernest Van Dijckkaai
649,Ernest Van Dijckkaai,2022-11-11,22:00:00,164,87,77,FMN 01 Ernest Van Dijckkaai
649,Ernest Van Dijckkaai,2022-11-11,23:00:00,110,61,49,FMN 01 Ernest Van Dijckkaai
649,Ernest Van Dijckkaai,2022-11-12,00:00:00,106,64,42,FMN 01 Ernest Van Dijckkaai
649,Ernest Van Dijckkaai,2022-11-12,01:00:00,57,23,34,FMN 01 Ernest Van Dijckkaai
649,Ernest Van Dijckkaai,2022-11-12,02:00:00,48,12,36,FMN 01 Ernest Van Dijckkaai
649,Ernest Van Dijckkaai,2022-11-12,03:00:00,41,17,24,FMN 01 Ernest Van Dijckkaai
649,Ernest Van Dijckkaai,2022-11-12,04:00:00,61,26,35,FMN 01 Ernest Van Dijckkaai
649,Ernest Van Dijckkaai,2022-11-12,05:00:00,48,27,21,FMN 01 Ernest Van Dijckkaai
649,Ernest Van Dijckkaai,2022-11-12,06:00:00,57,22,35,FMN 01 Ernest Van Dijckkaai
649,Ernest Van Dijckkaai,2022-11-12,07:00:00,33,14,19,FMN 01 Ernest Van Dijckkaai
649,Ernest Van Dijckkaai,2022-11-12,08:00:00,69,39,30,FMN 01 Ernest Van Dijckkaai
649,Ernest Van Dijckkaai,2022-11-12,09:00:00,131,75,56,FMN 01 Ernest Van Dijckkaai
649,Ernest Van Dijckkaai,2022-11-12,10:00:00,217,133,84,FMN 01 Ernest Van Dijckkaai
649,Ernest Van Dijckkaai,2022-11-12,11:00:00,222,120,102,FMN 01 Ernest Van Dijckkaai
649,Ernest Van Dijckkaai,2022-11-12,12:00:00,340,193,147,FMN 01 Ernest Van Dijckkaai
649,Ernest Van Dijckkaai,2022-11-12,13:00:00,519,373,146,FMN 01 Ernest Van Dijckkaai
649,Ernest Van Dijckkaai,2022-11-12,14:00:00,454,277,177,FMN 01 Ernest Van Dijckkaai
649,Ernest Van Dijckkaai,2022-11-12,15:00:00,635,265,370,FMN 01 Ernest Van Dijckkaai
649,Ernest Van Dijckkaai,2022-11-12,16:00:00,518,265,253,FMN 01 Ernest Van Dijckkaai
649,Ernest Van Dijckkaai,2022-11-12,17:00:00,384,179,205,FMN 01 Ernest Van Dijckkaai
649,Ernest Van Dijckkaai,2022-11-12,18:00:00,242,113,129,FMN 01 Ernest Van Dijckkaai
649,Ernest Van Dijckkaai,2022-11-12,19:00:00,184,100,84,FMN 01 Ernest Van Dijckkaai
649,Ernest Van Dijckkaai,2022-11-12,20:00:00,167,73,94,FMN 01 Ernest Van Dijckkaai
649,Ernest Van Dijckkaai,2022-11-12,21:00:00,158,78,80,FMN 01 Ernest Van Dijckkaai
649,Ernest Van Dijckkaai,2022-11-12,22:00:00,149,63,86,FMN 01 Ernest Van Dijckkaai
649,Ernest Van Dijckkaai,2022-11-12,23:00:00,120,39,81,FMN 01 Ernest Van Dijckkaai
649,Ernest Van Dijckkaai,2022-11-13,00:00:00,99,54,45,FMN 01 Ernest Van Dijckkaai
649,Ernest Van Dijckkaai,2022-11-13,01:00:00,55,20,35,FMN 01 Ernest Van Dijckkaai
649,Ernest Van Dijckkaai,2022-11-13,02:00:00,56,20,36,FMN 01 Ernest Van Dijckkaai
649,Ernest Van Dijckkaai,2022-11-13,03:00:00,37,11,26,FMN 01 Ernest Van Dijckkaai
649,Ernest Van Dijckkaai,2022-11-13,04:00:00,38,18,20,FMN 01 Ernest Van Dijckkaai
649,Ernest Van Dijckkaai,2022-11-13,05:00:00,33,14,19,FMN 01 Ernest Van Dijckkaai
649,Ernest Van Dijckkaai,2022-11-13,06:00:00,41,17,24,FMN 01 Ernest Van Dijckkaai
649,Ernest Van Dijckkaai,2022-11-13,07:00:00,35,14,21,FMN 01 Ernest Van Dijckkaai
649,Ernest Van Dijckkaai,2022-11-13,08:00:00,46,28,18,FMN 01 Ernest Van Dijckkaai
649,Ernest Van Dijckkaai,2022-11-13,09:00:00,144,89,55,FMN 01 Ernest Van Dijckkaai
649,Ernest Van Dijckkaai,2022-11-13,10:00:00,177,107,70,FMN 01 Ernest Van Dijckkaai
649,Ernest Van Dijckkaai,2022-11-13,11:00:00,285,150,135,FMN 01 Ernest Van Dijckkaai
649,Ernest Van Dijckkaai,2022-11-13,12:00:00,323,178,145,FMN 01 Ernest Van Dijckkaai
649,Ernest Van Dijckkaai,2022-11-13,13:00:00,453,247,206,FMN 01 Ernest Van Dijckkaai
649,Ernest Van Dijckkaai,2022-11-13,14:00:00,546,247,299,FMN 01 Ernest Van Dijckkaai
649,Ernest Van Dijckkaai,2022-11-13,15:00:00,508,255,253,FMN 01 Ernest Van Dijckkaai
649,Ernest Van Dijckkaai,2022-11-13,16:00:00,453,222,231,FMN 01 Ernest Van Dijckkaai
649,Ernest Van Dijckkaai,2022-11-13,17:00:00,266,131,135,FMN 01 Ernest Van Dijckkaai
649,Ernest Van Dijckkaai,2022-11-13,18:00:00,192,94,98,FMN 01 Ernest Van Dijckkaai
649,Ernest Van Dijckkaai,2022-11-13,19:00:00,116,56,60,FMN 01 Ernest Van Dijckkaai
649,Ernest Van Dijckkaai,2022-11-13,20:00:00,90,47,43,FMN 01 Ernest Van Dijckkaai
649,Ernest Van Dijckkaai,2022-11-13,21:00:00,81,42,39,FMN 01 Ernest Van Dijckkaai
649,Ernest Van Dijckkaai,2022-11-13,22:00:00,59,19,40,FMN 01 Ernest Van Dijckkaai
649,Ernest Van Dijckkaai,2022-11-13,23:00:00,34,14,20,FMN 01 Ernest Van Dijckkaai
649,Ernest Van Dijckkaai,2022-11-14,00:00:00,17,12,5,FMN 01 Ernest Van Dijckkaai
649,Ernest Van Dijckkaai,2022-11-14,01:00:00,6,3,3,FMN 01 Ernest Van Dijckkaai
649,Ernest Van Dijckkaai,2022-11-14,02:00:00,4,2,2,FMN 01 Ernest Van Dijckkaai
649,Ernest Van Dijckkaai,2022-11-14,03:00:00,6,1,5,FMN 01 Ernest Van Dijckkaai
649,Ernest Van Dijckkaai,2022-11-14,04:00:00,47,34,13,FMN 01 Ernest Van Dijckkaai
649,Ernest Van Dijckkaai,2022-11-14,05:00:00,127,86,41,FMN 01 Ernest Van Dijckkaai
649,Ernest Van Dijckkaai,2022-11-14,06:00:00,227,140,87,FMN 01 Ernest Van Dijckkaai
649,Ernest Van Dijckkaai,2022-11-14,07:00:00,449,280,169,FMN 01 Ernest Van Dijckkaai
649,Ernest Van Dijckkaai,2022-11-14,08:00:00,650,405,245,FMN 01 Ernest Van Dijckkaai
649,Ernest Van Dijckkaai,2022-11-14,09:00:00,253,168,85,FMN 01 Ernest Van Dijckkaai
649,Ernest Van Dijckkaai,2022-11-14,10:00:00,164,92,72,FMN 01 Ernest Van Dijckkaai
649,Ernest Van Dijckkaai,2022-11-14,11:00:00,184,95,89,FMN 01 Ernest Van Dijckkaai
649,Ernest Van Dijckkaai,2022-11-14,12:00:00,288,163,125,FMN 01 Ernest Van Dijckkaai
649,Ernest Van Dijckkaai,2022-11-14,13:00:00,252,145,107,FMN 01 Ernest Van Dijckkaai
649,Ernest Van Dijckkaai,2022-11-14,14:00:00,343,161,182,FMN 01 Ernest Van Dijckkaai
649,Ernest Van Dijckkaai,2022-11-14,15:00:00,390,194,196,FMN 01 Ernest Van Dijckkaai
649,Ernest Van Dijckkaai,2022-11-14,16:00:00,633,272,361,FMN 01 Ernest Van Dijckkaai
649,Ernest Van Dijckkaai,2022-11-14,17:00:00,609,239,370,FMN 01 Ernest Van Dijckkaai
649,Ernest Van Dijckkaai,2022-11-14,18:00:00,361,171,190,FMN 01 Ernest Van Dijckkaai
649,Ernest Van Dijckkaai,2022-11-14,19:00:00,181,85,96,FMN 01 Ernest Van Dijckkaai
649,Ernest Van Dijckkaai,2022-11-14,20:00:00,137,62,75,FMN 01 Ernest Van Dijckkaai
649,Ernest Van Dijckkaai,2022-11-14,21:00:00,123,44,79,FMN 01 Ernest Van Dijckkaai
649,Ernest Van Dijckkaai,2022-11-14,22:00:00,125,36,89,FMN 01 Ernest Van Dijckkaai
649,Ernest Van Dijckkaai,2022-11-14,23:00:00,40,15,25,FMN 01 Ernest Van Dijckkaai
649,Ernest Van Dijckkaai,2022-11-15,00:00:00,19,10,9,FMN 01 Ernest Van Dijckkaai
649,Ernest Van Dijckkaai,2022-11-15,01:00:00,16,3,13,FMN 01 Ernest Van Dijckkaai
649,Ernest Van Dijckkaai,2022-11-15,02:00:00,7,0,7,FMN 01 Ernest Van Dijckkaai
649,Ernest Van Dijckkaai,2022-11-15,03:00:00,9,3,6,FMN 01 Ernest Van Dijckkaai
649,Ernest Van Dijckkaai,2022-11-15,04:00:00,53,34,19,FMN 01 Ernest Van Dijckkaai
649,Ernest Van Dijckkaai,2022-11-15,05:00:00,117,85,32,FMN 01 Ernest Van Dijckkaai
649,Ernest Van Dijckkaai,2022-11-15,06:00:00,256,165,91,FMN 01 Ernest Van Dijckkaai
649,Ernest Van Dijckkaai,2022-11-15,07:00:00,462,280,182,FMN 01 Ernest Van Dijckkaai
649,Ernest Van Dijckkaai,2022-11-15,08:00:00,611,368,243,FMN 01 Ernest Van Dijckkaai
649,Ernest Van Dijckkaai,2022-11-15,09:00:00,272,163,109,FMN 01 Ernest Van Dijckkaai
649,Ernest Van Dijckkaai,2022-11-15,10:00:00,186,122,64,FMN 01 Ernest Van Dijckkaai
649,Ernest Van Dijckkaai,2022-11-15,11:00:00,183,97,86,FMN 01 Ernest Van Dijckkaai
649,Ernest Van Dijckkaai,2022-11-15,12:00:00,263,150,113,FMN 01 Ernest Van Dijckkaai
649,Ernest Van Dijckkaai,2022-11-15,13:00:00,292,174,118,FMN 01 Ernest Van Dijckkaai
649,Ernest Van Dijckkaai,2022-11-15,14:00:00,267,129,138,FMN 01 Ernest Van Dijckkaai
649,Ernest Van Dijckkaai,2022-11-15,15:00:00,335,149,186,FMN 01 Ernest Van Dijckkaai
649,Ernest Van Dijckkaai,2022-11-15,16:00:00,571,192,379,FMN 01 Ernest Van Dijckkaai
649,Ernest Van Dijckkaai,2022-11-15,17:00:00,570,238,332,FMN 01 Ernest Van Dijckkaai
649,Ernest Van Dijckkaai,2022-11-15,18:00:00,326,156,170,FMN 01 Ernest Van Dijckkaai
649,Ernest Van Dijckkaai,2022-11-15,19:00:00,161,77,84,FMN 01 Ernest Van Dijckkaai
649,Ernest Van Dijckkaai,2022-11-15,20:00:00,109,45,64,FMN 01 Ernest Van Dijckkaai
649,Ernest Van Dijckkaai,2022-11-15,21:00:00,100,45,55,FMN 01 Ernest Van Dijckkaai
649,Ernest Van Dijckkaai,2022-11-15,22:00:00,122,45,77,FMN 01 Ernest Van Dijckkaai
649,Ernest Van Dijckkaai,2022-11-15,23:00:00,57,18,39,FMN 01 Ernest Van Dijckkaai
649,Ernest Van Dijckkaai,2022-11-16,00:00:00,21,8,13,FMN 01 Ernest Van Dijckkaai
649,Ernest Van Dijckkaai,2022-11-16,01:00:00,8,5,3,FMN 01 Ernest Van Dijckkaai
649,Ernest Van Dijckkaai,2022-11-16,02:00:00,6,1,5,FMN 01 Ernest Van Dijckkaai
649,Ernest Van Dijckkaai,2022-11-16,03:00:00,10,3,7,FMN 01 Ernest Van Dijckkaai
649,Ernest Van Dijckkaai,2022-11-16,04:00:00,52,32,20,FMN 01 Ernest Van Dijckkaai
649,Ernest Van Dijckkaai,2022-11-16,05:00:00,117,75,42,FMN 01 Ernest Van Dijckkaai
649,Ernest Van Dijckkaai,2022-11-16,06:00:00,220,141,79,FMN 01 Ernest Van Dijckkaai
649,Ernest Van Dijckkaai,2022-11-16,07:00:00,450,298,152,FMN 01 Ernest Van Dijckkaai
649,Ernest Van Dijckkaai,2022-11-16,08:00:00,569,346,223,FMN 01 Ernest Van Dijckkaai
649,Ernest Van Dijckkaai,2022-11-16,09:00:00,254,169,85,FMN 01 Ernest Van Dijckkaai
649,Ernest Van Dijckkaai,2022-11-16,10:00:00,195,112,83,FMN 01 Ernest Van Dijckkaai
649,Ernest Van Dijckkaai,2022-11-16,11:00:00,189,111,78,FMN 01 Ernest Van Dijckkaai
649,Ernest Van Dijckkaai,2022-11-16,12:00:00,369,192,177,FMN 01 Ernest Van Dijckkaai
649,Ernest Van Dijckkaai,2022-11-16,13:00:00,259,161,98,FMN 01 Ernest Van Dijckkaai
649,Ernest Van Dijckkaai,2022-11-16,14:00:00,243,111,132,FMN 01 Ernest Van Dijckkaai
649,Ernest Van Dijckkaai,2022-11-16,15:00:00,303,144,159,FMN 01 Ernest Van Dijckkaai
649,Ernest Van Dijckkaai,2022-11-16,16:00:00,502,177,325,FMN 01 Ernest Van Dijckkaai
649,Ernest Van Dijckkaai,2022-11-16,17:00:00,571,247,324,FMN 01 Ernest Van Dijckkaai
649,Ernest Van Dijckkaai,2022-11-16,18:00:00,365,157,208,FMN 01 Ernest Van Dijckkaai
649,Ernest Van Dijckkaai,2022-11-16,19:00:00,205,103,102,FMN 01 Ernest Van Dijckkaai
649,Ernest Van Dijckkaai,2022-11-16,20:00:00,157,77,80,FMN 01 Ernest Van Dijckkaai
649,Ernest Van Dijckkaai,2022-11-16,21:00:00,89,44,45,FMN 01 Ernest Van Dijckkaai
649,Ernest Van Dijckkaai,2022-11-16,22:00:00,119,30,89,FMN 01 Ernest Van Dijckkaai
649,Ernest Van Dijckkaai,2022-11-16,23:00:00,62,28,34,FMN 01 Ernest Van Dijckkaai
649,Ernest Van Dijckkaai,2022-11-17,00:00:00,19,9,10,FMN 01 Ernest Van Dijckkaai
649,Ernest Van Dijckkaai,2022-11-17,01:00:00,15,6,9,FMN 01 Ernest Van Dijckkaai
649,Ernest Van Dijckkaai,2022-11-17,02:00:00,13,2,11,FMN 01 Ernest Van Dijckkaai
649,Ernest Van Dijckkaai,2022-11-17,03:00:00,16,2,14,FMN 01 Ernest Van Dijckkaai
649,Ernest Van Dijckkaai,2022-11-17,04:00:00,45,26,19,FMN 01 Ernest Van Dijckkaai
649,Ernest Van Dijckkaai,2022-11-17,05:00:00,84,58,26,FMN 01 Ernest Van Dijckkaai
649,Ernest Van Dijckkaai,2022-11-17,06:00:00,214,143,71,FMN 01 Ernest Van Dijckkaai
649,Ernest Van Dijckkaai,2022-11-17,07:00:00,353,224,129,FMN 01 Ernest Van Dijckkaai
649,Ernest Van Dijckkaai,2022-11-17,08:00:00,494,296,198,FMN 01 Ernest Van Dijckkaai
649,Ernest Van Dijckkaai,2022-11-17,09:00:00,219,132,87,FMN 01 Ernest Van Dijckkaai
649,Ernest Van Dijckkaai,2022-11-17,10:00:00,133,76,57,FMN 01 Ernest Van Dijckkaai
649,Ernest Van Dijckkaai,2022-11-17,11:00:00,105,53,52,FMN 01 Ernest Van Dijckkaai
649,Ernest Van Dijckkaai,2022-11-17,12:00:00,203,102,101,FMN 01 Ernest Van Dijckkaai
649,Ernest Van Dijckkaai,2022-11-17,13:00:00,145,85,60,FMN 01 Ernest Van Dijckkaai
649,Ernest Van Dijckkaai,2022-11-17,14:00:00,187,90,97,FMN 01 Ernest Van Dijckkaai
649,Ernest Van Dijckkaai,2022-11-17,15:00:00,294,132,162,FMN 01 Ernest Van Dijckkaai
649,Ernest Van Dijckkaai,2022-11-17,16:00:00,484,211,273,FMN 01 Ernest Van Dijckkaai
649,Ernest Van Dijckkaai,2022-11-17,17:00:00,555,258,297,FMN 01 Ernest Van Dijckkaai
649,Ernest Van Dijckkaai,2022-11-17,18:00:00,302,160,142,FMN 01 Ernest Van Dijckkaai
649,Ernest Van Dijckkaai,2022-11-17,19:00:00,209,116,93,FMN 01 Ernest Van Dijckkaai
649,Ernest Van Dijckkaai,2022-11-17,20:00:00,157,70,87,FMN 01 Ernest Van Dijckkaai
649,Ernest Van Dijckkaai,2022-11-17,21:00:00,127,55,72,FMN 01 Ernest Van Dijckkaai
649,Ernest Van Dijckkaai,2022-11-17,22:00:00,136,57,79,FMN 01 Ernest Van Dijckkaai
649,Ernest Van Dijckkaai,2022-11-17,23:00:00,67,26,41,FMN 01 Ernest Van Dijckkaai
649,Ernest Van Dijckkaai,2022-11-18,00:00:00,43,22,21,FMN 01 Ernest Van Dijckkaai
649,Ernest Van Dijckkaai,2022-11-18,01:00:00,37,11,26,FMN 01 Ernest Van Dijckkaai
649,Ernest Van Dijckkaai,2022-11-18,02:00:00,13,1,12,FMN 01 Ernest Van Dijckkaai
649,Ernest Van Dijckkaai,2022-11-18,03:00:00,14,4,10,FMN 01 Ernest Van Dijckkaai
649,Ernest Van Dijckkaai,2022-11-18,04:00:00,49,30,19,FMN 01 Ernest Van Dijckkaai
649,Ernest Van Dijckkaai,2022-11-18,05:00:00,103,61,42,FMN 01 Ernest Van Dijckkaai
649,Ernest Van Dijckkaai,2022-11-18,06:00:00,232,159,73,FMN 01 Ernest Van Dijckkaai
649,Ernest Van Dijckkaai,2022-11-18,07:00:00,386,257,129,FMN 01 Ernest Van Dijckkaai
649,Ernest Van Dijckkaai,2022-11-18,08:00:00,511,332,179,FMN 01 Ernest Van Dijckkaai
649,Ernest Van Dijckkaai,2022-11-18,09:00:00,228,146,82,FMN 01 Ernest Van Dijckkaai
649,Ernest Van Dijckkaai,2022-11-18,10:00:00,177,101,76,FMN 01 Ernest Van Dijckkaai
649,Ernest Van Dijckkaai,2022-11-18,11:00:00,165,82,83,FMN 01 Ernest Van Dijckkaai
649,Ernest Van Dijckkaai,2022-11-18,12:00:00,207,101,106,FMN 01 Ernest Van Dijckkaai
649,Ernest Van Dijckkaai,2022-11-18,13:00:00,202,118,84,FMN 01 Ernest Van Dijckkaai
649,Ernest Van Dijckkaai,2022-11-18,14:00:00,271,117,154,FMN 01 Ernest Van Dijckkaai
649,Ernest Van Dijckkaai,2022-11-18,15:00:00,281,123,158,FMN 01 Ernest Van Dijckkaai
649,Ernest Van Dijckkaai,2022-11-18,16:00:00,517,174,343,FMN 01 Ernest Van Dijckkaai
649,Ernest Van Dijckkaai,2022-11-18,17:00:00,412,193,219,FMN 01 Ernest Van Dijckkaai
649,Ernest Van Dijckkaai,2022-11-18,18:00:00,215,103,112,FMN 01 Ernest Van Dijckkaai
649,Ernest Van Dijckkaai,2022-11-18,19:00:00,132,68,64,FMN 01 Ernest Van Dijckkaai
649,Ernest Van Dijckkaai,2022-11-18,20:00:00,102,49,53,FMN 01 Ernest Van Dijckkaai
649,Ernest Van Dijckkaai,2022-11-18,21:00:00,82,38,44,FMN 01 Ernest Van Dijckkaai
649,Ernest Van Dijckkaai,2022-11-18,22:00:00,94,35,59,FMN 01 Ernest Van Dijckkaai
649,Ernest Van Dijckkaai,2022-11-18,23:00:00,96,31,65,FMN 01 Ernest Van Dijckkaai
649,Ernest Van Dijckkaai,2022-11-19,00:00:00,51,24,27,FMN 01 Ernest Van Dijckkaai
649,Ernest Van Dijckkaai,2022-11-19,01:00:00,55,22,33,FMN 01 Ernest Van Dijckkaai
649,Ernest Van Dijckkaai,2022-11-19,02:00:00,27,7,20,FMN 01 Ernest Van Dijckkaai
649,Ernest Van Dijckkaai,2022-11-19,03:00:00,22,9,13,FMN 01 Ernest Van Dijckkaai
649,Ernest Van Dijckkaai,2022-11-19,04:00:00,32,7,25,FMN 01 Ernest Van Dijckkaai
649,Ernest Van Dijckkaai,2022-11-19,05:00:00,28,17,11,FMN 01 Ernest Van Dijckkaai
649,Ernest Van Dijckkaai,2022-11-19,06:00:00,40,17,23,FMN 01 Ernest Van Dijckkaai
649,Ernest Van Dijckkaai,2022-11-19,07:00:00,28,9,19,FMN 01 Ernest Van Dijckkaai
649,Ernest Van Dijckkaai,2022-11-19,08:00:00,54,32,22,FMN 01 Ernest Van Dijckkaai
649,Ernest Van Dijckkaai,2022-11-19,09:00:00,71,37,34,FMN 01 Ernest Van Dijckkaai
649,Ernest Van Dijckkaai,2022-11-19,10:00:00,88,45,43,FMN 01 Ernest Van Dijckkaai
649,Ernest Van Dijckkaai,2022-11-19,11:00:00,113,61,52,FMN 01 Ernest Van Dijckkaai
649,Ernest Van Dijckkaai,2022-11-19,12:00:00,134,52,82,FMN 01 Ernest Van Dijckkaai
649,Ernest Van Dijckkaai,2022-11-19,13:00:00,170,110,60,FMN 01 Ernest Van Dijckkaai
649,Ernest Van Dijckkaai,2022-11-19,14:00:00,202,104,98,FMN 01 Ernest Van Dijckkaai
649,Ernest Van Dijckkaai,2022-11-19,15:00:00,171,79,92,FMN 01 Ernest Van Dijckkaai
649,Ernest Van Dijckkaai,2022-11-19,16:00:00,171,89,82,FMN 01 Ernest Van Dijckkaai
649,Ernest Van Dijckkaai,2022-11-19,17:00:00,175,82,93,FMN 01 Ernest Van Dijckkaai
649,Ernest Van Dijckkaai,2022-11-19,18:00:00,153,89,64,FMN 01 Ernest Van Dijckkaai
649,Ernest Van Dijckkaai,2022-11-19,19:00:00,115,57,58,FMN 01 Ernest Van Dijckkaai
649,Ernest Van Dijckkaai,2022-11-19,20:00:00,99,54,45,FMN 01 Ernest Van Dijckkaai
649,Ernest Van Dijckkaai,2022-11-19,21:00:00,72,41,31,FMN 01 Ernest Van Dijckkaai
649,Ernest Van Dijckkaai,2022-11-19,22:00:00,99,48,51,FMN 01 Ernest Van Dijckkaai
649,Ernest Van Dijckkaai,2022-11-19,23:00:00,124,70,54,FMN 01 Ernest Van Dijckkaai
649,Ernest Van Dijckkaai,2022-11-20,00:00:00,91,51,40,FMN 01 Ernest Van Dijckkaai
649,Ernest Van Dijckkaai,2022-11-20,01:00:00,65,20,45,FMN 01 Ernest Van Dijckkaai
649,Ernest Van Dijckkaai,2022-11-20,02:00:00,38,17,21,FMN 01 Ernest Van Dijckkaai
649,Ernest Van Dijckkaai,2022-11-20,03:00:00,31,3,28,FMN 01 Ernest Van Dijckkaai
649,Ernest Van Dijckkaai,2022-11-20,04:00:00,34,9,25,FMN 01 Ernest Van Dijckkaai
649,Ernest Van Dijckkaai,2022-11-20,05:00:00,39,8,31,FMN 01 Ernest Van Dijckkaai
649,Ernest Van Dijckkaai,2022-11-20,06:00:00,38,12,26,FMN 01 Ernest Van Dijckkaai
649,Ernest Van Dijckkaai,2022-11-20,07:00:00,36,18,18,FMN 01 Ernest Van Dijckkaai
649,Ernest Van Dijckkaai,2022-11-20,08:00:00,84,19,65,FMN 01 Ernest Van Dijckkaai
649,Ernest Van Dijckkaai,2022-11-20,09:00:00,150,40,110,FMN 01 Ernest Van Dijckkaai
649,Ernest Van Dijckkaai,2022-11-20,10:00:00,167,65,102,FMN 01 Ernest Van Dijckkaai
649,Ernest Van Dijckkaai,2022-11-20,11:00:00,210,138,72,FMN 01 Ernest Van Dijckkaai
649,Ernest Van Dijckkaai,2022-11-20,12:00:00,177,115,62,FMN 01 Ernest Van Dijckkaai
649,Ernest Van Dijckkaai,2022-11-20,13:00:00,196,132,64,FMN 01 Ernest Van Dijckkaai
649,Ernest Van Dijckkaai,2022-11-20,14:00:00,91,55,36,FMN 01 Ernest Van Dijckkaai
649,Ernest Van Dijckkaai,2022-11-20,15:00:00,110,53,57,FMN 01 Ernest Van Dijckkaai
649,Ernest Van Dijckkaai,2022-11-20,16:00:00,100,40,60,FMN 01 Ernest Van Dijckkaai
649,Ernest Van Dijckkaai,2022-11-20,17:00:00,100,52,48,FMN 01 Ernest Van Dijckkaai
649,Ernest Van Dijckkaai,2022-11-20,18:00:00,95,44,51,FMN 01 Ernest Van Dijckkaai
649,Ernest Van Dijckkaai,2022-11-20,19:00:00,75,32,43,FMN 01 Ernest Van Dijckkaai
649,Ernest Van Dijckkaai,2022-11-20,20:00:00,68,36,32,FMN 01 Ernest Van Dijckkaai
649,Ernest Van Dijckkaai,2022-11-20,21:00:00,52,29,23,FMN 01 Ernest Van Dijckkaai
649,Ernest Van Dijckkaai,2022-11-20,22:00:00,42,9,33,FMN 01 Ernest Van Dijckkaai
649,Ernest Van Dijckkaai,2022-11-20,23:00:00,36,20,16,FMN 01 Ernest Van Dijckkaai
649,Ernest Van Dijckkaai,2022-11-21,00:00:00,6,2,4,FMN 01 Ernest Van Dijckkaai
649,Ernest Van Dijckkaai,2022-11-21,01:00:00,6,2,4,FMN 01 Ernest Van Dijckkaai
649,Ernest Van Dijckkaai,2022-11-21,02:00:00,3,2,1,FMN 01 Ernest Van Dijckkaai
649,Ernest Van Dijckkaai,2022-11-21,03:00:00,6,3,3,FMN 01 Ernest Van Dijckkaai
649,Ernest Van Dijckkaai,2022-11-21,04:00:00,47,33,14,FMN 01 Ernest Van Dijckkaai
649,Ernest Van Dijckkaai,2022-11-21,05:00:00,102,66,36,FMN 01 Ernest Van Dijckkaai
649,Ernest Van Dijckkaai,2022-11-21,06:00:00,223,157,66,FMN 01 Ernest Van Dijckkaai
649,Ernest Van Dijckkaai,2022-11-21,07:00:00,410,264,146,FMN 01 Ernest Van Dijckkaai
649,Ernest Van Dijckkaai,2022-11-21,08:00:00,565,346,219,FMN 01 Ernest Van Dijckkaai
649,Ernest Van Dijckkaai,2022-11-21,09:00:00,219,158,61,FMN 01 Ernest Van Dijckkaai
649,Ernest Van Dijckkaai,2022-11-21,10:00:00,163,94,69,FMN 01 Ernest Van Dijckkaai
649,Ernest Van Dijckkaai,2022-11-21,11:00:00,152,85,67,FMN 01 Ernest Van Dijckkaai
649,Ernest Van Dijckkaai,2022-11-21,12:00:00,191,110,81,FMN 01 Ernest Van Dijckkaai
649,Ernest Van Dijckkaai,2022-11-21,13:00:00,190,111,79,FMN 01 Ernest Van Dijckkaai
649,Ernest Van Dijckkaai,2022-11-21,14:00:00,203,82,121,FMN 01 Ernest Van Dijckkaai
649,Ernest Van Dijckkaai,2022-11-21,15:00:00,291,118,173,FMN 01 Ernest Van Dijckkaai
649,Ernest Van Dijckkaai,2022-11-21,16:00:00,520,198,322,FMN 01 Ernest Van Dijckkaai
649,Ernest Van Dijckkaai,2022-11-21,17:00:00,528,227,301,FMN 01 Ernest Van Dijckkaai
649,Ernest Van Dijckkaai,2022-11-21,18:00:00,279,134,145,FMN 01 Ernest Van Dijckkaai
649,Ernest Van Dijckkaai,2022-11-21,19:00:00,128,55,73,FMN 01 Ernest Van Dijckkaai
649,Ernest Van Dijckkaai,2022-11-21,20:00:00,75,28,47,FMN 01 Ernest Van Dijckkaai
649,Ernest Van Dijckkaai,2022-11-21,21:00:00,73,36,37,FMN 01 Ernest Van Dijckkaai
649,Ernest Van Dijckkaai,2022-11-21,22:00:00,92,32,60,FMN 01 Ernest Van Dijckkaai
649,Ernest Van Dijckkaai,2022-11-21,23:00:00,41,15,26,FMN 01 Ernest Van Dijckkaai
649,Ernest Van Dijckkaai,2022-11-22,00:00:00,19,5,14,FMN 01 Ernest Van Dijckkaai
649,Ernest Van Dijckkaai,2022-11-22,01:00:00,13,9,4,FMN 01 Ernest Van Dijckkaai
649,Ernest Van Dijckkaai,2022-11-22,02:00:00,6,1,5,FMN 01 Ernest Van Dijckkaai
649,Ernest Van Dijckkaai,2022-11-22,03:00:00,10,2,8,FMN 01 Ernest Van Dijckkaai
649,Ernest Van Dijckkaai,2022-11-22,04:00:00,50,35,15,FMN 01 Ernest Van Dijckkaai
649,Ernest Van Dijckkaai,2022-11-22,05:00:00,98,70,28,FMN 01 Ernest Van Dijckkaai
649,Ernest Van Dijckkaai,2022-11-22,06:00:00,247,156,91,FMN 01 Ernest Van Dijckkaai
649,Ernest Van Dijckkaai,2022-11-22,07:00:00,368,235,133,FMN 01 Ernest Van Dijckkaai
649,Ernest Van Dijckkaai,2022-11-22,08:00:00,570,361,209,FMN 01 Ernest Van Dijckkaai
649,Ernest Van Dijckkaai,2022-11-22,09:00:00,249,159,90,FMN 01 Ernest Van Dijckkaai
649,Ernest Van Dijckkaai,2022-11-22,10:00:00,141,83,58,FMN 01 Ernest Van Dijckkaai
649,Ernest Van Dijckkaai,2022-11-22,11:00:00,126,77,49,FMN 01 Ernest Van Dijckkaai
649,Ernest Van Dijckkaai,2022-11-22,12:00:00,220,131,89,FMN 01 Ernest Van Dijckkaai
649,Ernest Van Dijckkaai,2022-11-22,13:00:00,174,91,83,FMN 01 Ernest Van Dijckkaai
649,Ernest Van Dijckkaai,2022-11-22,14:00:00,197,82,115,FMN 01 Ernest Van Dijckkaai
649,Ernest Van Dijckkaai,2022-11-22,15:00:00,268,121,147,FMN 01 Ernest Van Dijckkaai
649,Ernest Van Dijckkaai,2022-11-22,16:00:00,530,206,324,FMN 01 Ernest Van Dijckkaai
649,Ernest Van Dijckkaai,2022-11-22,17:00:00,568,228,340,FMN 01 Ernest Van Dijckkaai
649,Ernest Van Dijckkaai,2022-11-22,18:00:00,330,150,180,FMN 01 Ernest Van Dijckkaai
649,Ernest Van Dijckkaai,2022-11-22,19:00:00,184,95,89,FMN 01 Ernest Van Dijckkaai
649,Ernest Van Dijckkaai,2022-11-22,20:00:00,141,71,70,FMN 01 Ernest Van Dijckkaai
649,Ernest Van Dijckkaai,2022-11-22,21:00:00,88,42,46,FMN 01 Ernest Van Dijckkaai
649,Ernest Van Dijckkaai,2022-11-22,22:00:00,102,37,65,FMN 01 Ernest Van Dijckkaai
649,Ernest Van Dijckkaai,2022-11-22,23:00:00,52,18,34,FMN 01 Ernest Van Dijckkaai
649,Ernest Van Dijckkaai,2022-11-23,00:00:00,46,29,17,FMN 01 Ernest Van Dijckkaai
649,Ernest Van Dijckkaai,2022-11-23,01:00:00,9,2,7,FMN 01 Ernest Van Dijckkaai
649,Ernest Van Dijckkaai,2022-11-23,02:00:00,12,1,11,FMN 01 Ernest Van Dijckkaai
649,Ernest Van Dijckkaai,2022-11-23,03:00:00,8,2,6,FMN 01 Ernest Van Dijckkaai
649,Ernest Van Dijckkaai,2022-11-23,04:00:00,56,36,20,FMN 01 Ernest Van Dijckkaai
649,Ernest Van Dijckkaai,2022-11-23,05:00:00,116,76,40,FMN 01 Ernest Van Dijckkaai
649,Ernest Van Dijckkaai,2022-11-23,06:00:00,192,123,69,FMN 01 Ernest Van Dijckkaai
649,Ernest Van Dijckkaai,2022-11-23,07:00:00,364,234,130,FMN 01 Ernest Van Dijckkaai
649,Ernest Van Dijckkaai,2022-11-23,08:00:00,530,319,211,FMN 01 Ernest Van Dijckkaai
649,Ernest Van Dijckkaai,2022-11-23,09:00:00,238,156,82,FMN 01 Ernest Van Dijckkaai
649,Ernest Van Dijckkaai,2022-11-23,10:00:00,167,99,68,FMN 01 Ernest Van Dijckkaai
649,Ernest Van Dijckkaai,2022-11-23,11:00:00,169,83,86,FMN 01 Ernest Van Dijckkaai
649,Ernest Van Dijckkaai,2022-11-23,12:00:00,269,145,124,FMN 01 Ernest Van Dijckkaai
649,Ernest Van Dijckkaai,2022-11-23,13:00:00,193,101,92,FMN 01 Ernest Van Dijckkaai
649,Ernest Van Dijckkaai,2022-11-23,14:00:00,144,54,90,FMN 01 Ernest Van Dijckkaai
649,Ernest Van Dijckkaai,2022-11-23,15:00:00,172,86,86,FMN 01 Ernest Van Dijckkaai
649,Ernest Van Dijckkaai,2022-11-23,16:00:00,403,136,267,FMN 01 Ernest Van Dijckkaai
649,Ernest Van Dijckkaai,2022-11-23,17:00:00,483,213,270,FMN 01 Ernest Van Dijckkaai
649,Ernest Van Dijckkaai,2022-11-23,18:00:00,325,169,156,FMN 01 Ernest Van Dijckkaai
649,Ernest Van Dijckkaai,2022-11-23,19:00:00,209,119,90,FMN 01 Ernest Van Dijckkaai
649,Ernest Van Dijckkaai,2022-11-23,20:00:00,127,73,54,FMN 01 Ernest Van Dijckkaai
649,Ernest Van Dijckkaai,2022-11-23,21:00:00,83,42,41,FMN 01 Ernest Van Dijckkaai
649,Ernest Van Dijckkaai,2022-11-23,22:00:00,143,53,90,FMN 01 Ernest Van Dijckkaai
649,Ernest Van Dijckkaai,2022-11-23,23:00:00,94,25,69,FMN 01 Ernest Van Dijckkaai
649,Ernest Van Dijckkaai,2022-11-24,00:00:00,34,12,22,FMN 01 Ernest Van Dijckkaai
649,Ernest Van Dijckkaai,2022-11-24,01:00:00,28,7,21,FMN 01 Ernest Van Dijckkaai
649,Ernest Van Dijckkaai,2022-11-24,02:00:00,10,3,7,FMN 01 Ernest Van Dijckkaai
649,Ernest Van Dijckkaai,2022-11-24,03:00:00,10,6,4,FMN 01 Ernest Van Dijckkaai
649,Ernest Van Dijckkaai,2022-11-24,04:00:00,45,35,10,FMN 01 Ernest Van Dijckkaai
649,Ernest Van Dijckkaai,2022-11-24,05:00:00,112,76,36,FMN 01 Ernest Van Dijckkaai
649,Ernest Van Dijckkaai,2022-11-24,06:00:00,229,150,79,FMN 01 Ernest Van Dijckkaai
649,Ernest Van Dijckkaai,2022-11-24,07:00:00,414,248,166,FMN 01 Ernest Van Dijckkaai
649,Ernest Van Dijckkaai,2022-11-24,08:00:00,612,367,245,FMN 01 Ernest Van Dijckkaai
649,Ernest Van Dijckkaai,2022-11-24,09:00:00,297,185,112,FMN 01 Ernest Van Dijckkaai
649,Ernest Van Dijckkaai,2022-11-24,10:00:00,174,100,74,FMN 01 Ernest Van Dijckkaai
649,Ernest Van Dijckkaai,2022-11-24,11:00:00,190,99,91,FMN 01 Ernest Van Dijckkaai
649,Ernest Van Dijckkaai,2022-11-24,12:00:00,306,182,124,FMN 01 Ernest Van Dijckkaai
649,Ernest Van Dijckkaai,2022-11-24,13:00:00,252,143,109,FMN 01 Ernest Van Dijckkaai
649,Ernest Van Dijckkaai,2022-11-24,14:00:00,357,179,178,FMN 01 Ernest Van Dijckkaai
649,Ernest Van Dijckkaai,2022-11-24,15:00:00,323,146,177,FMN 01 Ernest Van Dijckkaai
649,Ernest Van Dijckkaai,2022-11-24,16:00:00,565,228,337,FMN 01 Ernest Van Dijckkaai
649,Ernest Van Dijckkaai,2022-11-24,17:00:00,656,278,378,FMN 01 Ernest Van Dijckkaai
649,Ernest Van Dijckkaai,2022-11-24,18:00:00,375,187,188,FMN 01 Ernest Van Dijckkaai
649,Ernest Van Dijckkaai,2022-11-24,19:00:00,184,91,93,FMN 01 Ernest Van Dijckkaai
649,Ernest Van Dijckkaai,2022-11-24,20:00:00,148,73,75,FMN 01 Ernest Van Dijckkaai
649,Ernest Van Dijckkaai,2022-11-24,21:00:00,124,56,68,FMN 01 Ernest Van Dijckkaai
649,Ernest Van Dijckkaai,2022-11-24,22:00:00,157,57,100,FMN 01 Ernest Van Dijckkaai
649,Ernest Van Dijckkaai,2022-11-24,23:00:00,53,18,35,FMN 01 Ernest Van Dijckkaai
649,Ernest Van Dijckkaai,2022-11-25,00:00:00,53,26,27,FMN 01 Ernest Van Dijckkaai
649,Ernest Van Dijckkaai,2022-11-25,01:00:00,21,8,13,FMN 01 Ernest Van Dijckkaai
649,Ernest Van Dijckkaai,2022-11-25,02:00:00,12,2,10,FMN 01 Ernest Van Dijckkaai
649,Ernest Van Dijckkaai,2022-11-25,03:00:00,21,6,15,FMN 01 Ernest Van Dijckkaai
649,Ernest Van Dijckkaai,2022-11-25,04:00:00,47,27,20,FMN 01 Ernest Van Dijckkaai
649,Ernest Van Dijckkaai,2022-11-25,05:00:00,116,70,46,FMN 01 Ernest Van Dijckkaai
649,Ernest Van Dijckkaai,2022-11-25,06:00:00,210,132,78,FMN 01 Ernest Van Dijckkaai
649,Ernest Van Dijckkaai,2022-11-25,07:00:00,334,220,114,FMN 01 Ernest Van Dijckkaai
649,Ernest Van Dijckkaai,2022-11-25,08:00:00,504,289,215,FMN 01 Ernest Van Dijckkaai
649,Ernest Van Dijckkaai,2022-11-25,09:00:00,246,159,87,FMN 01 Ernest Van Dijckkaai
649,Ernest Van Dijckkaai,2022-11-25,10:00:00,199,107,92,FMN 01 Ernest Van Dijckkaai
649,Ernest Van Dijckkaai,2022-11-25,11:00:00,161,84,77,FMN 01 Ernest Van Dijckkaai
649,Ernest Van Dijckkaai,2022-11-25,12:00:00,296,156,140,FMN 01 Ernest Van Dijckkaai
649,Ernest Van Dijckkaai,2022-11-25,13:00:00,295,167,128,FMN 01 Ernest Van Dijckkaai
649,Ernest Van Dijckkaai,2022-11-25,14:00:00,328,142,186,FMN 01 Ernest Van Dijckkaai
649,Ernest Van Dijckkaai,2022-11-25,15:00:00,378,173,205,FMN 01 Ernest Van Dijckkaai
649,Ernest Van Dijckkaai,2022-11-25,16:00:00,550,235,315,FMN 01 Ernest Van Dijckkaai
649,Ernest Van Dijckkaai,2022-11-25,17:00:00,487,211,276,FMN 01 Ernest Van Dijckkaai
649,Ernest Van Dijckkaai,2022-11-25,18:00:00,345,177,168,FMN 01 Ernest Van Dijckkaai
649,Ernest Van Dijckkaai,2022-11-25,19:00:00,203,119,84,FMN 01 Ernest Van Dijckkaai
649,Ernest Van Dijckkaai,2022-11-25,20:00:00,149,58,91,FMN 01 Ernest Van Dijckkaai
649,Ernest Van Dijckkaai,2022-11-25,21:00:00,136,81,55,FMN 01 Ernest Van Dijckkaai
649,Ernest Van Dijckkaai,2022-11-25,22:00:00,173,81,92,FMN 01 Ernest Van Dijckkaai
649,Ernest Van Dijckkaai,2022-11-25,23:00:00,114,43,71,FMN 01 Ernest Van Dijckkaai
649,Ernest Van Dijckkaai,2022-11-26,00:00:00,105,40,65,FMN 01 Ernest Van Dijckkaai
649,Ernest Van Dijckkaai,2022-11-26,01:00:00,50,25,25,FMN 01 Ernest Van Dijckkaai
649,Ernest Van Dijckkaai,2022-11-26,02:00:00,39,17,22,FMN 01 Ernest Van Dijckkaai
649,Ernest Van Dijckkaai,2022-11-26,03:00:00,23,3,20,FMN 01 Ernest Van Dijckkaai
649,Ernest Van Dijckkaai,2022-11-26,04:00:00,63,29,34,FMN 01 Ernest Van Dijckkaai
649,Ernest Van Dijckkaai,2022-11-26,05:00:00,53,26,27,FMN 01 Ernest Van Dijckkaai
649,Ernest Van Dijckkaai,2022-11-26,06:00:00,103,16,87,FMN 01 Ernest Van Dijckkaai
649,Ernest Van Dijckkaai,2022-11-26,07:00:00,32,15,17,FMN 01 Ernest Van Dijckkaai
649,Ernest Van Dijckkaai,2022-11-26,08:00:00,53,35,18,FMN 01 Ernest Van Dijckkaai
649,Ernest Van Dijckkaai,2022-11-26,09:00:00,116,69,47,FMN 01 Ernest Van Dijckkaai
649,Ernest Van Dijckkaai,2022-11-26,10:00:00,152,80,72,FMN 01 Ernest Van Dijckkaai
649,Ernest Van Dijckkaai,2022-11-26,11:00:00,158,72,86,FMN 01 Ernest Van Dijckkaai
649,Ernest Van Dijckkaai,2022-11-26,12:00:00,247,125,122,FMN 01 Ernest Van Dijckkaai
649,Ernest Van Dijckkaai,2022-11-26,13:00:00,244,142,102,FMN 01 Ernest Van Dijckkaai
649,Ernest Van Dijckkaai,2022-11-26,14:00:00,276,156,120,FMN 01 Ernest Van Dijckkaai
649,Ernest Van Dijckkaai,2022-11-26,15:00:00,281,133,148,FMN 01 Ernest Van Dijckkaai
649,Ernest Van Dijckkaai,2022-11-26,16:00:00,308,169,139,FMN 01 Ernest Van Dijckkaai
649,Ernest Van Dijckkaai,2022-11-26,17:00:00,258,135,123,FMN 01 Ernest Van Dijckkaai
649,Ernest Van Dijckkaai,2022-11-26,18:00:00,203,111,92,FMN 01 Ernest Van Dijckkaai
649,Ernest Van Dijckkaai,2022-11-26,19:00:00,168,86,82,FMN 01 Ernest Van Dijckkaai
649,Ernest Van Dijckkaai,2022-11-26,20:00:00,111,56,55,FMN 01 Ernest Van Dijckkaai
649,Ernest Van Dijckkaai,2022-11-26,21:00:00,96,37,59,FMN 01 Ernest Van Dijckkaai
649,Ernest Van Dijckkaai,2022-11-26,22:00:00,103,49,54,FMN 01 Ernest Van Dijckkaai
649,Ernest Van Dijckkaai,2022-11-26,23:00:00,117,65,52,FMN 01 Ernest Van Dijckkaai
649,Ernest Van Dijckkaai,2022-11-27,00:00:00,98,39,59,FMN 01 Ernest Van Dijckkaai
649,Ernest Van Dijckkaai,2022-11-27,01:00:00,60,37,23,FMN 01 Ernest Van Dijckkaai
649,Ernest Van Dijckkaai,2022-11-27,02:00:00,38,17,21,FMN 01 Ernest Van Dijckkaai
649,Ernest Van Dijckkaai,2022-11-27,03:00:00,31,10,21,FMN 01 Ernest Van Dijckkaai
649,Ernest Van Dijckkaai,2022-11-27,04:00:00,57,11,46,FMN 01 Ernest Van Dijckkaai
649,Ernest Van Dijckkaai,2022-11-27,05:00:00,34,6,28,FMN 01 Ernest Van Dijckkaai
649,Ernest Van Dijckkaai,2022-11-27,06:00:00,42,14,28,FMN 01 Ernest Van Dijckkaai
649,Ernest Van Dijckkaai,2022-11-27,07:00:00,23,9,14,FMN 01 Ernest Van Dijckkaai
649,Ernest Van Dijckkaai,2022-11-27,08:00:00,46,24,22,FMN 01 Ernest Van Dijckkaai
649,Ernest Van Dijckkaai,2022-11-27,09:00:00,61,40,21,FMN 01 Ernest Van Dijckkaai
649,Ernest Van Dijckkaai,2022-11-27,10:00:00,78,50,28,FMN 01 Ernest Van Dijckkaai
649,Ernest Van Dijckkaai,2022-11-27,11:00:00,84,49,35,FMN 01 Ernest Van Dijckkaai
649,Ernest Van Dijckkaai,2022-11-27,12:00:00,104,49,55,FMN 01 Ernest Van Dijckkaai
649,Ernest Van Dijckkaai,2022-11-27,13:00:00,168,92,76,FMN 01 Ernest Van Dijckkaai
649,Ernest Van Dijckkaai,2022-11-27,14:00:00,100,58,42,FMN 01 Ernest Van Dijckkaai
649,Ernest Van Dijckkaai,2022-11-27,15:00:00,100,49,51,FMN 01 Ernest Van Dijckkaai
649,Ernest Van Dijckkaai,2022-11-27,16:00:00,143,64,79,FMN 01 Ernest Van Dijckkaai
649,Ernest Van Dijckkaai,2022-11-27,17:00:00,104,59,45,FMN 01 Ernest Van Dijckkaai
649,Ernest Van Dijckkaai,2022-11-27,18:00:00,86,41,45,FMN 01 Ernest Van Dijckkaai
649,Ernest Van Dijckkaai,2022-11-27,19:00:00,58,30,28,FMN 01 Ernest Van Dijckkaai
649,Ernest Van Dijckkaai,2022-11-27,20:00:00,50,30,20,FMN 01 Ernest Van Dijckkaai
649,Ernest Van Dijckkaai,2022-11-27,21:00:00,45,20,25,FMN 01 Ernest Van Dijckkaai
649,Ernest Van Dijckkaai,2022-11-27,22:00:00,45,15,30,FMN 01 Ernest Van Dijckkaai
649,Ernest Van Dijckkaai,2022-11-27,23:00:00,19,8,11,FMN 01 Ernest Van Dijckkaai
649,Ernest Van Dijckkaai,2022-11-28,00:00:00,8,4,4,FMN 01 Ernest Van Dijckkaai
649,Ernest Van Dijckkaai,2022-11-28,01:00:00,7,3,4,FMN 01 Ernest Van Dijckkaai
649,Ernest Van Dijckkaai,2022-11-28,02:00:00,2,0,2,FMN 01 Ernest Van Dijckkaai
649,Ernest Van Dijckkaai,2022-11-28,03:00:00,6,3,3,FMN 01 Ernest Van Dijckkaai
649,Ernest Van Dijckkaai,2022-11-28,04:00:00,38,25,13,FMN 01 Ernest Van Dijckkaai
649,Ernest Van Dijckkaai,2022-11-28,05:00:00,88,56,32,FMN 01 Ernest Van Dijckkaai
649,Ernest Van Dijckkaai,2022-11-28,06:00:00,215,135,80,FMN 01 Ernest Van Dijckkaai
649,Ernest Van Dijckkaai,2022-11-28,07:00:00,379,238,141,FMN 01 Ernest Van Dijckkaai
649,Ernest Van Dijckkaai,2022-11-28,08:00:00,480,269,211,FMN 01 Ernest Van Dijckkaai
649,Ernest Van Dijckkaai,2022-11-28,09:00:00,181,121,60,FMN 01 Ernest Van Dijckkaai
649,Ernest Van Dijckkaai,2022-11-28,10:00:00,135,88,47,FMN 01 Ernest Van Dijckkaai
649,Ernest Van Dijckkaai,2022-11-28,11:00:00,130,76,54,FMN 01 Ernest Van Dijckkaai
649,Ernest Van Dijckkaai,2022-11-28,12:00:00,188,102,86,FMN 01 Ernest Van Dijckkaai
649,Ernest Van Dijckkaai,2022-11-28,13:00:00,170,91,79,FMN 01 Ernest Van Dijckkaai
649,Ernest Van Dijckkaai,2022-11-28,14:00:00,195,89,106,FMN 01 Ernest Van Dijckkaai
649,Ernest Van Dijckkaai,2022-11-28,15:00:00,309,142,167,FMN 01 Ernest Van Dijckkaai
649,Ernest Van Dijckkaai,2022-11-28,16:00:00,479,187,292,FMN 01 Ernest Van Dijckkaai
649,Ernest Van Dijckkaai,2022-11-28,17:00:00,508,205,303,FMN 01 Ernest Van Dijckkaai
649,Ernest Van Dijckkaai,2022-11-28,18:00:00,328,154,174,FMN 01 Ernest Van Dijckkaai
649,Ernest Van Dijckkaai,2022-11-28,19:00:00,175,80,95,FMN 01 Ernest Van Dijckkaai
649,Ernest Van Dijckkaai,2022-11-28,20:00:00,111,52,59,FMN 01 Ernest Van Dijckkaai
649,Ernest Van Dijckkaai,2022-11-28,21:00:00,110,56,54,FMN 01 Ernest Van Dijckkaai
649,Ernest Van Dijckkaai,2022-11-28,22:00:00,110,39,71,FMN 01 Ernest Van Dijckkaai
649,Ernest Van Dijckkaai,2022-11-28,23:00:00,48,17,31,FMN 01 Ernest Van Dijckkaai
649,Ernest Van Dijckkaai,2022-11-29,00:00:00,24,8,16,FMN 01 Ernest Van Dijckkaai
649,Ernest Van Dijckkaai,2022-11-29,01:00:00,5,0,5,FMN 01 Ernest Van Dijckkaai
649,Ernest Van Dijckkaai,2022-11-29,02:00:00,2,0,2,FMN 01 Ernest Van Dijckkaai
649,Ernest Van Dijckkaai,2022-11-29,03:00:00,9,1,8,FMN 01 Ernest Van Dijckkaai
649,Ernest Van Dijckkaai,2022-11-29,04:00:00,51,38,13,FMN 01 Ernest Van Dijckkaai
649,Ernest Van Dijckkaai,2022-11-29,05:00:00,118,81,37,FMN 01 Ernest Van Dijckkaai
649,Ernest Van Dijckkaai,2022-11-29,06:00:00,258,164,94,FMN 01 Ernest Van Dijckkaai
649,Ernest Van Dijckkaai,2022-11-29,07:00:00,444,270,174,FMN 01 Ernest Van Dijckkaai
649,Ernest Van Dijckkaai,2022-11-29,08:00:00,619,367,252,FMN 01 Ernest Van Dijckkaai
649,Ernest Van Dijckkaai,2022-11-29,09:00:00,243,150,93,FMN 01 Ernest Van Dijckkaai
649,Ernest Van Dijckkaai,2022-11-29,10:00:00,151,98,53,FMN 01 Ernest Van Dijckkaai
649,Ernest Van Dijckkaai,2022-11-29,11:00:00,145,74,71,FMN 01 Ernest Van Dijckkaai
649,Ernest Van Dijckkaai,2022-11-29,12:00:00,216,128,88,FMN 01 Ernest Van Dijckkaai
649,Ernest Van Dijckkaai,2022-11-29,13:00:00,222,146,76,FMN 01 Ernest Van Dijckkaai
649,Ernest Van Dijckkaai,2022-11-29,14:00:00,238,102,136,FMN 01 Ernest Van Dijckkaai
649,Ernest Van Dijckkaai,2022-11-29,15:00:00,342,153,189,FMN 01 Ernest Van Dijckkaai
649,Ernest Van Dijckkaai,2022-11-29,16:00:00,566,217,349,FMN 01 Ernest Van Dijckkaai
649,Ernest Van Dijckkaai,2022-11-29,17:00:00,654,264,390,FMN 01 Ernest Van Dijckkaai
649,Ernest Van Dijckkaai,2022-11-29,18:00:00,341,176,165,FMN 01 Ernest Van Dijckkaai
649,Ernest Van Dijckkaai,2022-11-29,19:00:00,223,112,111,FMN 01 Ernest Van Dijckkaai
649,Ernest Van Dijckkaai,2022-11-29,20:00:00,113,60,53,FMN 01 Ernest Van Dijckkaai
649,Ernest Van Dijckkaai,2022-11-29,21:00:00,122,53,69,FMN 01 Ernest Van Dijckkaai
649,Ernest Van Dijckkaai,2022-11-29,22:00:00,150,63,87,FMN 01 Ernest Van Dijckkaai
649,Ernest Van Dijckkaai,2022-11-29,23:00:00,59,22,37,FMN 01 Ernest Van Dijckkaai
649,Ernest Van Dijckkaai,2022-11-30,00:00:00,52,31,21,FMN 01 Ernest Van Dijckkaai
649,Ernest Van Dijckkaai,2022-11-30,01:00:00,16,4,12,FMN 01 Ernest Van Dijckkaai
649,Ernest Van Dijckkaai,2022-11-30,02:00:00,9,2,7,FMN 01 Ernest Van Dijckkaai
649,Ernest Van Dijckkaai,2022-11-30,03:00:00,18,2,16,FMN 01 Ernest Van Dijckkaai
649,Ernest Van Dijckkaai,2022-11-30,04:00:00,55,39,16,FMN 01 Ernest Van Dijckkaai
649,Ernest Van Dijckkaai,2022-11-30,05:00:00,115,69,46,FMN 01 Ernest Van Dijckkaai
649,Ernest Van Dijckkaai,2022-11-30,06:00:00,253,168,85,FMN 01 Ernest Van Dijckkaai
649,Ernest Van Dijckkaai,2022-11-30,07:00:00,423,276,147,FMN 01 Ernest Van Dijckkaai
649,Ernest Van Dijckkaai,2022-11-30,08:00:00,503,308,195,FMN 01 Ernest Van Dijckkaai
649,Ernest Van Dijckkaai,2022-11-30,09:00:00,214,134,80,FMN 01 Ernest Van Dijckkaai
649,Ernest Van Dijckkaai,2022-11-30,10:00:00,119,68,51,FMN 01 Ernest Van Dijckkaai
649,Ernest Van Dijckkaai,2022-11-30,11:00:00,160,79,81,FMN 01 Ernest Van Dijckkaai
649,Ernest Van Dijckkaai,2022-11-30,12:00:00,305,168,137,FMN 01 Ernest Van Dijckkaai
649,Ernest Van Dijckkaai,2022-11-30,13:00:00,231,121,110,FMN 01 Ernest Van Dijckkaai
649,Ernest Van Dijckkaai,2022-11-30,14:00:00,228,88,140,FMN 01 Ernest Van Dijckkaai
649,Ernest Van Dijckkaai,2022-11-30,15:00:00,275,118,157,FMN 01 Ernest Van Dijckkaai
649,Ernest Van Dijckkaai,2022-11-30,16:00:00,429,180,249,FMN 01 Ernest Van Dijckkaai
649,Ernest Van Dijckkaai,2022-11-30,17:00:00,554,212,342,FMN 01 Ernest Van Dijckkaai
649,Ernest Van Dijckkaai,2022-11-30,18:00:00,360,170,190,FMN 01 Ernest Van Dijckkaai
649,Ernest Van Dijckkaai,2022-11-30,19:00:00,207,98,109,FMN 01 Ernest Van Dijckkaai
649,Ernest Van Dijckkaai,2022-11-30,20:00:00,138,55,83,FMN 01 Ernest Van Dijckkaai
649,Ernest Van Dijckkaai,2022-11-30,21:00:00,100,51,49,FMN 01 Ernest Van Dijckkaai
649,Ernest Van Dijckkaai,2022-11-30,22:00:00,138,49,89,FMN 01 Ernest Van Dijckkaai
649,Ernest Van Dijckkaai,2022-11-30,23:00:00,74,28,46,FMN 01 Ernest Van Dijckkaai
649,Ernest Van Dijckkaai,2022-12-01,00:00:00,41,15,26,FMN 01 Ernest Van Dijckkaai
649,Ernest Van Dijckkaai,2022-12-01,01:00:00,21,8,13,FMN 01 Ernest Van Dijckkaai
649,Ernest Van Dijckkaai,2022-12-01,02:00:00,8,1,7,FMN 01 Ernest Van Dijckkaai
649,Ernest Van Dijckkaai,2022-12-01,03:00:00,16,10,6,FMN 01 Ernest Van Dijckkaai
649,Ernest Van Dijckkaai,2022-12-01,04:00:00,52,37,15,FMN 01 Ernest Van Dijckkaai
649,Ernest Van Dijckkaai,2022-12-01,05:00:00,103,72,31,FMN 01 Ernest Van Dijckkaai
649,Ernest Van Dijckkaai,2022-12-01,06:00:00,235,156,79,FMN 01 Ernest Van Dijckkaai
649,Ernest Van Dijckkaai,2022-12-01,07:00:00,424,260,164,FMN 01 Ernest Van Dijckkaai
649,Ernest Van Dijckkaai,2022-12-01,08:00:00,585,358,227,FMN 01 Ernest Van Dijckkaai
649,Ernest Van Dijckkaai,2022-12-01,09:00:00,267,165,102,FMN 01 Ernest Van Dijckkaai
649,Ernest Van Dijckkaai,2022-12-01,10:00:00,152,75,77,FMN 01 Ernest Van Dijckkaai
649,Ernest Van Dijckkaai,2022-12-01,11:00:00,142,73,69,FMN 01 Ernest Van Dijckkaai
649,Ernest Van Dijckkaai,2022-12-01,12:00:00,255,136,119,FMN 01 Ernest Van Dijckkaai
649,Ernest Van Dijckkaai,2022-12-01,13:00:00,224,128,96,FMN 01 Ernest Van Dijckkaai
649,Ernest Van Dijckkaai,2022-12-01,14:00:00,281,149,132,FMN 01 Ernest Van Dijckkaai
649,Ernest Van Dijckkaai,2022-12-01,15:00:00,456,212,244,FMN 01 Ernest Van Dijckkaai
649,Ernest Van Dijckkaai,2022-12-01,16:00:00,517,239,278,FMN 01 Ernest Van Dijckkaai
649,Ernest Van Dijckkaai,2022-12-01,17:00:00,488,240,248,FMN 01 Ernest Van Dijckkaai
649,Ernest Van Dijckkaai,2022-12-01,18:00:00,458,221,237,FMN 01 Ernest Van Dijckkaai
649,Ernest Van Dijckkaai,2022-12-01,19:00:00,230,109,121,FMN 01 Ernest Van Dijckkaai
649,Ernest Van Dijckkaai,2022-12-01,20:00:00,152,70,82,FMN 01 Ernest Van Dijckkaai
649,Ernest Van Dijckkaai,2022-12-01,21:00:00,113,57,56,FMN 01 Ernest Van Dijckkaai
649,Ernest Van Dijckkaai,2022-12-01,22:00:00,165,67,98,FMN 01 Ernest Van Dijckkaai
649,Ernest Van Dijckkaai,2022-12-01,23:00:00,81,30,51,FMN 01 Ernest Van Dijckkaai
649,Ernest Van Dijckkaai,2022-12-02,00:00:00,65,28,37,FMN 01 Ernest Van Dijckkaai
649,Ernest Van Dijckkaai,2022-12-02,01:00:00,35,7,28,FMN 01 Ernest Van Dijckkaai
649,Ernest Van Dijckkaai,2022-12-02,02:00:00,17,5,12,FMN 01 Ernest Van Dijckkaai
649,Ernest Van Dijckkaai,2022-12-02,03:00:00,23,4,19,FMN 01 Ernest Van Dijckkaai
649,Ernest Van Dijckkaai,2022-12-02,04:00:00,55,30,25,FMN 01 Ernest Van Dijckkaai
649,Ernest Van Dijckkaai,2022-12-02,05:00:00,98,66,32,FMN 01 Ernest Van Dijckkaai
649,Ernest Van Dijckkaai,2022-12-02,06:00:00,190,130,60,FMN 01 Ernest Van Dijckkaai
649,Ernest Van Dijckkaai,2022-12-02,07:00:00,325,213,112,FMN 01 Ernest Van Dijckkaai
649,Ernest Van Dijckkaai,2022-12-02,08:00:00,481,291,190,FMN 01 Ernest Van Dijckkaai
649,Ernest Van Dijckkaai,2022-12-02,09:00:00,221,144,77,FMN 01 Ernest Van Dijckkaai
649,Ernest Van Dijckkaai,2022-12-02,10:00:00,175,103,72,FMN 01 Ernest Van Dijckkaai
649,Ernest Van Dijckkaai,2022-12-02,11:00:00,166,93,73,FMN 01 Ernest Van Dijckkaai
649,Ernest Van Dijckkaai,2022-12-02,12:00:00,226,121,105,FMN 01 Ernest Van Dijckkaai
649,Ernest Van Dijckkaai,2022-12-02,13:00:00,213,107,106,FMN 01 Ernest Van Dijckkaai
649,Ernest Van Dijckkaai,2022-12-02,14:00:00,218,87,131,FMN 01 Ernest Van Dijckkaai
649,Ernest Van Dijckkaai,2022-12-02,15:00:00,291,128,163,FMN 01 Ernest Van Dijckkaai
649,Ernest Van Dijckkaai,2022-12-02,16:00:00,430,186,244,FMN 01 Ernest Van Dijckkaai
649,Ernest Van Dijckkaai,2022-12-02,17:00:00,385,166,219,FMN 01 Ernest Van Dijckkaai
649,Ernest Van Dijckkaai,2022-12-02,18:00:00,292,151,141,FMN 01 Ernest Van Dijckkaai
649,Ernest Van Dijckkaai,2022-12-02,19:00:00,164,86,78,FMN 01 Ernest Van Dijckkaai
649,Ernest Van Dijckkaai,2022-12-02,20:00:00,96,42,54,FMN 01 Ernest Van Dijckkaai
649,Ernest Van Dijckkaai,2022-12-02,21:00:00,73,32,41,FMN 01 Ernest Van Dijckkaai
649,Ernest Van Dijckkaai,2022-12-02,22:00:00,99,33,66,FMN 01 Ernest Van Dijckkaai
649,Ernest Van Dijckkaai,2022-12-02,23:00:00,81,36,45,FMN 01 Ernest Van Dijckkaai
649,Ernest Van Dijckkaai,2022-12-03,00:00:00,75,35,40,FMN 01 Ernest Van Dijckkaai
649,Ernest Van Dijckkaai,2022-12-03,01:00:00,36,11,25,FMN 01 Ernest Van Dijckkaai
649,Ernest Van Dijckkaai,2022-12-03,02:00:00,27,6,21,FMN 01 Ernest Van Dijckkaai
649,Ernest Van Dijckkaai,2022-12-03,03:00:00,26,4,22,FMN 01 Ernest Van Dijckkaai
649,Ernest Van Dijckkaai,2022-12-03,04:00:00,33,20,13,FMN 01 Ernest Van Dijckkaai
649,Ernest Van Dijckkaai,2022-12-03,05:00:00,36,16,20,FMN 01 Ernest Van Dijckkaai
649,Ernest Van Dijckkaai,2022-12-03,06:00:00,45,26,19,FMN 01 Ernest Van Dijckkaai
649,Ernest Van Dijckkaai,2022-12-03,07:00:00,35,16,19,FMN 01 Ernest Van Dijckkaai
649,Ernest Van Dijckkaai,2022-12-03,08:00:00,59,36,23,FMN 01 Ernest Van Dijckkaai
649,Ernest Van Dijckkaai,2022-12-03,09:00:00,112,67,45,FMN 01 Ernest Van Dijckkaai
649,Ernest Van Dijckkaai,2022-12-03,10:00:00,108,61,47,FMN 01 Ernest Van Dijckkaai
649,Ernest Van Dijckkaai,2022-12-03,11:00:00,129,72,57,FMN 01 Ernest Van Dijckkaai
649,Ernest Van Dijckkaai,2022-12-03,12:00:00,141,82,59,FMN 01 Ernest Van Dijckkaai
649,Ernest Van Dijckkaai,2022-12-03,13:00:00,156,86,70,FMN 01 Ernest Van Dijckkaai
649,Ernest Van Dijckkaai,2022-12-03,14:00:00,209,103,106,FMN 01 Ernest Van Dijckkaai
649,Ernest Van Dijckkaai,2022-12-03,15:00:00,151,73,78,FMN 01 Ernest Van Dijckkaai
649,Ernest Van Dijckkaai,2022-12-03,16:00:00,164,94,70,FMN 01 Ernest Van Dijckkaai
649,Ernest Van Dijckkaai,2022-12-03,17:00:00,157,79,78,FMN 01 Ernest Van Dijckkaai
649,Ernest Van Dijckkaai,2022-12-03,18:00:00,151,81,70,FMN 01 Ernest Van Dijckkaai
649,Ernest Van Dijckkaai,2022-12-03,19:00:00,119,69,50,FMN 01 Ernest Van Dijckkaai
649,Ernest Van Dijckkaai,2022-12-03,20:00:00,86,43,43,FMN 01 Ernest Van Dijckkaai
649,Ernest Van Dijckkaai,2022-12-03,21:00:00,69,31,38,FMN 01 Ernest Van Dijckkaai
649,Ernest Van Dijckkaai,2022-12-03,22:00:00,84,26,58,FMN 01 Ernest Van Dijckkaai
649,Ernest Van Dijckkaai,2022-12-03,23:00:00,66,27,39,FMN 01 Ernest Van Dijckkaai
649,Ernest Van Dijckkaai,2022-12-04,00:00:00,47,24,23,FMN 01 Ernest Van Dijckkaai
649,Ernest Van Dijckkaai,2022-12-04,01:00:00,41,18,23,FMN 01 Ernest Van Dijckkaai
649,Ernest Van Dijckkaai,2022-12-04,02:00:00,25,8,17,FMN 01 Ernest Van Dijckkaai
649,Ernest Van Dijckkaai,2022-12-04,03:00:00,23,11,12,FMN 01 Ernest Van Dijckkaai
649,Ernest Van Dijckkaai,2022-12-04,04:00:00,26,10,16,FMN 01 Ernest Van Dijckkaai
649,Ernest Van Dijckkaai,2022-12-04,05:00:00,32,12,20,FMN 01 Ernest Van Dijckkaai
649,Ernest Van Dijckkaai,2022-12-04,06:00:00,26,11,15,FMN 01 Ernest Van Dijckkaai
649,Ernest Van Dijckkaai,2022-12-04,07:00:00,26,13,13,FMN 01 Ernest Van Dijckkaai
649,Ernest Van Dijckkaai,2022-12-04,08:00:00,35,18,17,FMN 01 Ernest Van Dijckkaai
649,Ernest Van Dijckkaai,2022-12-04,09:00:00,93,52,41,FMN 01 Ernest Van Dijckkaai
649,Ernest Van Dijckkaai,2022-12-04,10:00:00,108,54,54,FMN 01 Ernest Van Dijckkaai
649,Ernest Van Dijckkaai,2022-12-04,11:00:00,164,80,84,FMN 01 Ernest Van Dijckkaai
649,Ernest Van Dijckkaai,2022-12-04,12:00:00,179,82,97,FMN 01 Ernest Van Dijckkaai
649,Ernest Van Dijckkaai,2022-12-04,13:00:00,190,90,100,FMN 01 Ernest Van Dijckkaai
649,Ernest Van Dijckkaai,2022-12-04,14:00:00,130,65,65,FMN 01 Ernest Van Dijckkaai
649,Ernest Van Dijckkaai,2022-12-04,15:00:00,163,98,65,FMN 01 Ernest Van Dijckkaai
649,Ernest Van Dijckkaai,2022-12-04,16:00:00,129,67,62,FMN 01 Ernest Van Dijckkaai
649,Ernest Van Dijckkaai,2022-12-04,17:00:00,124,63,61,FMN 01 Ernest Van Dijckkaai
649,Ernest Van Dijckkaai,2022-12-04,18:00:00,99,53,46,FMN 01 Ernest Van Dijckkaai
649,Ernest Van Dijckkaai,2022-12-04,19:00:00,87,40,47,FMN 01 Ernest Van Dijckkaai
649,Ernest Van Dijckkaai,2022-12-04,20:00:00,60,22,38,FMN 01 Ernest Van Dijckkaai
649,Ernest Van Dijckkaai,2022-12-04,21:00:00,48,28,20,FMN 01 Ernest Van Dijckkaai
649,Ernest Van Dijckkaai,2022-12-04,22:00:00,57,25,32,FMN 01 Ernest Van Dijckkaai
649,Ernest Van Dijckkaai,2022-12-04,23:00:00,20,9,11,FMN 01 Ernest Van Dijckkaai
649,Ernest Van Dijckkaai,2022-12-05,00:00:00,13,8,5,FMN 01 Ernest Van Dijckkaai
649,Ernest Van Dijckkaai,2022-12-05,01:00:00,5,2,3,FMN 01 Ernest Van Dijckkaai
649,Ernest Van Dijckkaai,2022-12-05,02:00:00,8,4,4,FMN 01 Ernest Van Dijckkaai
649,Ernest Van Dijckkaai,2022-12-05,03:00:00,6,3,3,FMN 01 Ernest Van Dijckkaai
649,Ernest Van Dijckkaai,2022-12-05,04:00:00,36,27,9,FMN 01 Ernest Van Dijckkaai
649,Ernest Van Dijckkaai,2022-12-05,05:00:00,74,49,25,FMN 01 Ernest Van Dijckkaai
649,Ernest Van Dijckkaai,2022-12-05,06:00:00,169,116,53,FMN 01 Ernest Van Dijckkaai
649,Ernest Van Dijckkaai,2022-12-05,07:00:00,343,241,102,FMN 01 Ernest Van Dijckkaai
649,Ernest Van Dijckkaai,2022-12-05,08:00:00,449,265,184,FMN 01 Ernest Van Dijckkaai
649,Ernest Van Dijckkaai,2022-12-05,09:00:00,177,123,54,FMN 01 Ernest Van Dijckkaai
649,Ernest Van Dijckkaai,2022-12-05,10:00:00,107,74,33,FMN 01 Ernest Van Dijckkaai
649,Ernest Van Dijckkaai,2022-12-05,11:00:00,93,50,43,FMN 01 Ernest Van Dijckkaai
649,Ernest Van Dijckkaai,2022-12-05,12:00:00,161,92,69,FMN 01 Ernest Van Dijckkaai
649,Ernest Van Dijckkaai,2022-12-05,13:00:00,142,81,61,FMN 01 Ernest Van Dijckkaai
649,Ernest Van Dijckkaai,2022-12-05,14:00:00,157,67,90,FMN 01 Ernest Van Dijckkaai
649,Ernest Van Dijckkaai,2022-12-05,15:00:00,215,100,115,FMN 01 Ernest Van Dijckkaai
649,Ernest Van Dijckkaai,2022-12-05,16:00:00,352,119,233,FMN 01 Ernest Van Dijckkaai
649,Ernest Van Dijckkaai,2022-12-05,17:00:00,448,177,271,FMN 01 Ernest Van Dijckkaai
649,Ernest Van Dijckkaai,2022-12-05,18:00:00,290,123,167,FMN 01 Ernest Van Dijckkaai
649,Ernest Van Dijckkaai,2022-12-05,19:00:00,145,69,76,FMN 01 Ernest Van Dijckkaai
649,Ernest Van Dijckkaai,2022-12-05,20:00:00,111,52,59,FMN 01 Ernest Van Dijckkaai
649,Ernest Van Dijckkaai,2022-12-05,21:00:00,87,42,45,FMN 01 Ernest Van Dijckkaai
649,Ernest Van Dijckkaai,2022-12-05,22:00:00,71,26,45,FMN 01 Ernest Van Dijckkaai
649,Ernest Van Dijckkaai,2022-12-05,23:00:00,31,14,17,FMN 01 Ernest Van Dijckkaai
649,Ernest Van Dijckkaai,2022-12-06,00:00:00,18,10,8,FMN 01 Ernest Van Dijckkaai
649,Ernest Van Dijckkaai,2022-12-06,01:00:00,9,1,8,FMN 01 Ernest Van Dijckkaai
649,Ernest Van Dijckkaai,2022-12-06,02:00:00,4,2,2,FMN 01 Ernest Van Dijckkaai
649,Ernest Van Dijckkaai,2022-12-06,03:00:00,7,2,5,FMN 01 Ernest Van Dijckkaai
649,Ernest Van Dijckkaai,2022-12-06,04:00:00,45,26,19,FMN 01 Ernest Van Dijckkaai
649,Ernest Van Dijckkaai,2022-12-06,05:00:00,97,64,33,FMN 01 Ernest Van Dijckkaai
649,Ernest Van Dijckkaai,2022-12-06,06:00:00,233,152,81,FMN 01 Ernest Van Dijckkaai
649,Ernest Van Dijckkaai,2022-12-06,07:00:00,388,264,124,FMN 01 Ernest Van Dijckkaai
649,Ernest Van Dijckkaai,2022-12-06,08:00:00,552,317,235,FMN 01 Ernest Van Dijckkaai
649,Ernest Van Dijckkaai,2022-12-06,09:00:00,259,175,84,FMN 01 Ernest Van Dijckkaai
649,Ernest Van Dijckkaai,2022-12-06,10:00:00,122,77,45,FMN 01 Ernest Van Dijckkaai
649,Ernest Van Dijckkaai,2022-12-06,11:00:00,153,78,75,FMN 01 Ernest Van Dijckkaai
649,Ernest Van Dijckkaai,2022-12-06,12:00:00,212,123,89,FMN 01 Ernest Van Dijckkaai
649,Ernest Van Dijckkaai,2022-12-06,13:00:00,212,116,96,FMN 01 Ernest Van Dijckkaai
649,Ernest Van Dijckkaai,2022-12-06,14:00:00,236,104,132,FMN 01 Ernest Van Dijckkaai
649,Ernest Van Dijckkaai,2022-12-06,15:00:00,321,150,171,FMN 01 Ernest Van Dijckkaai
649,Ernest Van Dijckkaai,2022-12-06,16:00:00,461,188,273,FMN 01 Ernest Van Dijckkaai
649,Ernest Van Dijckkaai,2022-12-06,17:00:00,558,237,321,FMN 01 Ernest Van Dijckkaai
649,Ernest Van Dijckkaai,2022-12-06,18:00:00,313,142,171,FMN 01 Ernest Van Dijckkaai
649,Ernest Van Dijckkaai,2022-12-06,19:00:00,159,72,87,FMN 01 Ernest Van Dijckkaai
649,Ernest Van Dijckkaai,2022-12-06,20:00:00,108,53,55,FMN 01 Ernest Van Dijckkaai
649,Ernest Van Dijckkaai,2022-12-06,21:00:00,73,42,31,FMN 01 Ernest Van Dijckkaai
649,Ernest Van Dijckkaai,2022-12-06,22:00:00,111,47,64,FMN 01 Ernest Van Dijckkaai
649,Ernest Van Dijckkaai,2022-12-06,23:00:00,44,16,28,FMN 01 Ernest Van Dijckkaai
649,Ernest Van Dijckkaai,2022-12-07,00:00:00,24,11,13,FMN 01 Ernest Van Dijckkaai
649,Ernest Van Dijckkaai,2022-12-07,01:00:00,8,3,5,FMN 01 Ernest Van Dijckkaai
649,Ernest Van Dijckkaai,2022-12-07,02:00:00,8,4,4,FMN 01 Ernest Van Dijckkaai
649,Ernest Van Dijckkaai,2022-12-07,03:00:00,10,1,9,FMN 01 Ernest Van Dijckkaai
649,Ernest Van Dijckkaai,2022-12-07,04:00:00,53,27,26,FMN 01 Ernest Van Dijckkaai
649,Ernest Van Dijckkaai,2022-12-07,05:00:00,81,48,33,FMN 01 Ernest Van Dijckkaai
649,Ernest Van Dijckkaai,2022-12-07,06:00:00,204,127,77,FMN 01 Ernest Van Dijckkaai
649,Ernest Van Dijckkaai,2022-12-07,07:00:00,353,232,121,FMN 01 Ernest Van Dijckkaai
649,Ernest Van Dijckkaai,2022-12-07,08:00:00,472,284,188,FMN 01 Ernest Van Dijckkaai
649,Ernest Van Dijckkaai,2022-12-07,09:00:00,218,135,83,FMN 01 Ernest Van Dijckkaai
649,Ernest Van Dijckkaai,2022-12-07,10:00:00,139,78,61,FMN 01 Ernest Van Dijckkaai
649,Ernest Van Dijckkaai,2022-12-07,11:00:00,129,76,53,FMN 01 Ernest Van Dijckkaai
649,Ernest Van Dijckkaai,2022-12-07,12:00:00,254,142,112,FMN 01 Ernest Van Dijckkaai
649,Ernest Van Dijckkaai,2022-12-07,13:00:00,195,108,87,FMN 01 Ernest Van Dijckkaai
649,Ernest Van Dijckkaai,2022-12-07,14:00:00,190,101,89,FMN 01 Ernest Van Dijckkaai
649,Ernest Van Dijckkaai,2022-12-07,15:00:00,205,95,110,FMN 01 Ernest Van Dijckkaai
649,Ernest Van Dijckkaai,2022-12-07,16:00:00,360,150,210,FMN 01 Ernest Van Dijckkaai
649,Ernest Van Dijckkaai,2022-12-07,17:00:00,445,183,262,FMN 01 Ernest Van Dijckkaai
649,Ernest Van Dijckkaai,2022-12-07,18:00:00,341,164,177,FMN 01 Ernest Van Dijckkaai
649,Ernest Van Dijckkaai,2022-12-07,19:00:00,160,74,86,FMN 01 Ernest Van Dijckkaai
649,Ernest Van Dijckkaai,2022-12-07,20:00:00,100,53,47,FMN 01 Ernest Van Dijckkaai
649,Ernest Van Dijckkaai,2022-12-07,21:00:00,90,45,45,FMN 01 Ernest Van Dijckkaai
649,Ernest Van Dijckkaai,2022-12-07,22:00:00,104,33,71,FMN 01 Ernest Van Dijckkaai
649,Ernest Van Dijckkaai,2022-12-07,23:00:00,56,26,30,FMN 01 Ernest Van Dijckkaai
649,Ernest Van Dijckkaai,2022-12-08,00:00:00,35,17,18,FMN 01 Ernest Van Dijckkaai
649,Ernest Van Dijckkaai,2022-12-08,01:00:00,12,3,9,FMN 01 Ernest Van Dijckkaai
649,Ernest Van Dijckkaai,2022-12-08,02:00:00,8,0,8,FMN 01 Ernest Van Dijckkaai
649,Ernest Van Dijckkaai,2022-12-08,03:00:00,7,0,7,FMN 01 Ernest Van Dijckkaai
649,Ernest Van Dijckkaai,2022-12-08,04:00:00,34,23,11,FMN 01 Ernest Van Dijckkaai
649,Ernest Van Dijckkaai,2022-12-08,05:00:00,74,51,23,FMN 01 Ernest Van Dijckkaai
649,Ernest Van Dijckkaai,2022-12-08,06:00:00,187,127,60,FMN 01 Ernest Van Dijckkaai
649,Ernest Van Dijckkaai,2022-12-08,07:00:00,347,209,138,FMN 01 Ernest Van Dijckkaai
649,Ernest Van Dijckkaai,2022-12-08,08:00:00,518,309,209,FMN 01 Ernest Van Dijckkaai
649,Ernest Van Dijckkaai,2022-12-08,09:00:00,243,166,77,FMN 01 Ernest Van Dijckkaai
649,Ernest Van Dijckkaai,2022-12-08,10:00:00,163,92,71,FMN 01 Ernest Van Dijckkaai
649,Ernest Van Dijckkaai,2022-12-08,11:00:00,133,83,50,FMN 01 Ernest Van Dijckkaai
649,Ernest Van Dijckkaai,2022-12-08,12:00:00,213,117,96,FMN 01 Ernest Van Dijckkaai
649,Ernest Van Dijckkaai,2022-12-08,13:00:00,185,102,83,FMN 01 Ernest Van Dijckkaai
649,Ernest Van Dijckkaai,2022-12-08,14:00:00,152,65,87,FMN 01 Ernest Van Dijckkaai
649,Ernest Van Dijckkaai,2022-12-08,15:00:00,233,114,119,FMN 01 Ernest Van Dijckkaai
649,Ernest Van Dijckkaai,2022-12-08,16:00:00,393,166,227,FMN 01 Ernest Van Dijckkaai
649,Ernest Van Dijckkaai,2022-12-08,17:00:00,528,240,288,FMN 01 Ernest Van Dijckkaai
649,Ernest Van Dijckkaai,2022-12-08,18:00:00,306,167,139,FMN 01 Ernest Van Dijckkaai
649,Ernest Van Dijckkaai,2022-12-08,19:00:00,184,101,83,FMN 01 Ernest Van Dijckkaai
649,Ernest Van Dijckkaai,2022-12-08,20:00:00,87,49,38,FMN 01 Ernest Van Dijckkaai
649,Ernest Van Dijckkaai,2022-12-08,21:00:00,103,39,64,FMN 01 Ernest Van Dijckkaai
649,Ernest Van Dijckkaai,2022-12-08,22:00:00,113,44,69,FMN 01 Ernest Van Dijckkaai
649,Ernest Van Dijckkaai,2022-12-08,23:00:00,85,41,44,FMN 01 Ernest Van Dijckkaai
649,Ernest Van Dijckkaai,2022-12-09,00:00:00,36,11,25,FMN 01 Ernest Van Dijckkaai
649,Ernest Van Dijckkaai,2022-12-09,01:00:00,18,4,14,FMN 01 Ernest Van Dijckkaai
649,Ernest Van Dijckkaai,2022-12-09,02:00:00,15,4,11,FMN 01 Ernest Van Dijckkaai
649,Ernest Van Dijckkaai,2022-12-09,03:00:00,17,3,14,FMN 01 Ernest Van Dijckkaai
649,Ernest Van Dijckkaai,2022-12-09,04:00:00,40,22,18,FMN 01 Ernest Van Dijckkaai
649,Ernest Van Dijckkaai,2022-12-09,05:00:00,67,37,30,FMN 01 Ernest Van Dijckkaai
649,Ernest Van Dijckkaai,2022-12-09,06:00:00,138,87,51,FMN 01 Ernest Van Dijckkaai
649,Ernest Van Dijckkaai,2022-12-09,07:00:00,277,177,100,FMN 01 Ernest Van Dijckkaai
649,Ernest Van Dijckkaai,2022-12-09,08:00:00,397,226,171,FMN 01 Ernest Van Dijckkaai
649,Ernest Van Dijckkaai,2022-12-09,09:00:00,171,106,65,FMN 01 Ernest Van Dijckkaai
649,Ernest Van Dijckkaai,2022-12-09,10:00:00,165,89,76,FMN 01 Ernest Van Dijckkaai
649,Ernest Van Dijckkaai,2022-12-09,11:00:00,185,110,75,FMN 01 Ernest Van Dijckkaai
649,Ernest Van Dijckkaai,2022-12-09,12:00:00,232,127,105,FMN 01 Ernest Van Dijckkaai
649,Ernest Van Dijckkaai,2022-12-09,13:00:00,238,137,101,FMN 01 Ernest Van Dijckkaai
649,Ernest Van Dijckkaai,2022-12-09,14:00:00,239,129,110,FMN 01 Ernest Van Dijckkaai
649,Ernest Van Dijckkaai,2022-12-09,15:00:00,302,152,150,FMN 01 Ernest Van Dijckkaai
649,Ernest Van Dijckkaai,2022-12-09,16:00:00,438,199,239,FMN 01 Ernest Van Dijckkaai
649,Ernest Van Dijckkaai,2022-12-09,17:00:00,403,191,212,FMN 01 Ernest Van Dijckkaai
649,Ernest Van Dijckkaai,2022-12-09,18:00:00,271,140,131,FMN 01 Ernest Van Dijckkaai
649,Ernest Van Dijckkaai,2022-12-09,19:00:00,229,140,89,FMN 01 Ernest Van Dijckkaai
649,Ernest Van Dijckkaai,2022-12-09,20:00:00,130,75,55,FMN 01 Ernest Van Dijckkaai
649,Ernest Van Dijckkaai,2022-12-09,21:00:00,111,58,53,FMN 01 Ernest Van Dijckkaai
649,Ernest Van Dijckkaai,2022-12-09,22:00:00,85,29,56,FMN 01 Ernest Van Dijckkaai
649,Ernest Van Dijckkaai,2022-12-09,23:00:00,101,27,74,FMN 01 Ernest Van Dijckkaai
649,Ernest Van Dijckkaai,2022-12-10,00:00:00,73,29,44,FMN 01 Ernest Van Dijckkaai
649,Ernest Van Dijckkaai,2022-12-10,01:00:00,59,20,39,FMN 01 Ernest Van Dijckkaai
649,Ernest Van Dijckkaai,2022-12-10,02:00:00,39,14,25,FMN 01 Ernest Van Dijckkaai
649,Ernest Van Dijckkaai,2022-12-10,03:00:00,29,4,25,FMN 01 Ernest Van Dijckkaai
649,Ernest Van Dijckkaai,2022-12-10,04:00:00,28,10,18,FMN 01 Ernest Van Dijckkaai
649,Ernest Van Dijckkaai,2022-12-10,05:00:00,27,14,13,FMN 01 Ernest Van Dijckkaai
649,Ernest Van Dijckkaai,2022-12-10,06:00:00,25,8,17,FMN 01 Ernest Van Dijckkaai
649,Ernest Van Dijckkaai,2022-12-10,07:00:00,18,5,13,FMN 01 Ernest Van Dijckkaai
649,Ernest Van Dijckkaai,2022-12-10,08:00:00,45,29,16,FMN 01 Ernest Van Dijckkaai
649,Ernest Van Dijckkaai,2022-12-10,09:00:00,69,30,39,FMN 01 Ernest Van Dijckkaai
649,Ernest Van Dijckkaai,2022-12-10,10:00:00,67,30,37,FMN 01 Ernest Van Dijckkaai
649,Ernest Van Dijckkaai,2022-12-10,11:00:00,79,55,24,FMN 01 Ernest Van Dijckkaai
649,Ernest Van Dijckkaai,2022-12-10,12:00:00,119,65,54,FMN 01 Ernest Van Dijckkaai
649,Ernest Van Dijckkaai,2022-12-10,13:00:00,156,84,72,FMN 01 Ernest Van Dijckkaai
649,Ernest Van Dijckkaai,2022-12-10,14:00:00,150,88,62,FMN 01 Ernest Van Dijckkaai
649,Ernest Van Dijckkaai,2022-12-10,15:00:00,171,103,68,FMN 01 Ernest Van Dijckkaai
649,Ernest Van Dijckkaai,2022-12-10,16:00:00,167,102,65,FMN 01 Ernest Van Dijckkaai
649,Ernest Van Dijckkaai,2022-12-10,17:00:00,153,79,74,FMN 01 Ernest Van Dijckkaai
649,Ernest Van Dijckkaai,2022-12-10,18:00:00,149,87,62,FMN 01 Ernest Van Dijckkaai
649,Ernest Van Dijckkaai,2022-12-10,19:00:00,118,62,56,FMN 01 Ernest Van Dijckkaai
649,Ernest Van Dijckkaai,2022-12-10,20:00:00,56,31,25,FMN 01 Ernest Van Dijckkaai
649,Ernest Van Dijckkaai,2022-12-10,21:00:00,41,25,16,FMN 01 Ernest Van Dijckkaai
649,Ernest Van Dijckkaai,2022-12-10,22:00:00,79,31,48,FMN 01 Ernest Van Dijckkaai
649,Ernest Van Dijckkaai,2022-12-10,23:00:00,74,23,51,FMN 01 Ernest Van Dijckkaai
649,Ernest Van Dijckkaai,2022-12-11,00:00:00,59,20,39,FMN 01 Ernest Van Dijckkaai
649,Ernest Van Dijckkaai,2022-12-11,01:00:00,37,14,23,FMN 01 Ernest Van Dijckkaai
649,Ernest Van Dijckkaai,2022-12-11,02:00:00,19,7,12,FMN 01 Ernest Van Dijckkaai
649,Ernest Van Dijckkaai,2022-12-11,03:00:00,11,6,5,FMN 01 Ernest Van Dijckkaai
649,Ernest Van Dijckkaai,2022-12-11,04:00:00,19,6,13,FMN 01 Ernest Van Dijckkaai
649,Ernest Van Dijckkaai,2022-12-11,05:00:00,25,12,13,FMN 01 Ernest Van Dijckkaai
649,Ernest Van Dijckkaai,2022-12-11,06:00:00,15,9,6,FMN 01 Ernest Van Dijckkaai
649,Ernest Van Dijckkaai,2022-12-11,07:00:00,11,8,3,FMN 01 Ernest Van Dijckkaai
649,Ernest Van Dijckkaai,2022-12-11,08:00:00,34,21,13,FMN 01 Ernest Van Dijckkaai
649,Ernest Van Dijckkaai,2022-12-11,09:00:00,53,35,18,FMN 01 Ernest Van Dijckkaai
649,Ernest Van Dijckkaai,2022-12-11,10:00:00,76,50,26,FMN 01 Ernest Van Dijckkaai
649,Ernest Van Dijckkaai,2022-12-11,11:00:00,119,67,52,FMN 01 Ernest Van Dijckkaai
649,Ernest Van Dijckkaai,2022-12-11,12:00:00,109,62,47,FMN 01 Ernest Van Dijckkaai
649,Ernest Van Dijckkaai,2022-12-11,13:00:00,135,81,54,FMN 01 Ernest Van Dijckkaai
649,Ernest Van Dijckkaai,2022-12-11,14:00:00,143,73,70,FMN 01 Ernest Van Dijckkaai
649,Ernest Van Dijckkaai,2022-12-11,15:00:00,148,75,73,FMN 01 Ernest Van Dijckkaai
649,Ernest Van Dijckkaai,2022-12-11,16:00:00,177,85,92,FMN 01 Ernest Van Dijckkaai
649,Ernest Van Dijckkaai,2022-12-11,17:00:00,146,70,76,FMN 01 Ernest Van Dijckkaai
649,Ernest Van Dijckkaai,2022-12-11,18:00:00,126,71,55,FMN 01 Ernest Van Dijckkaai
649,Ernest Van Dijckkaai,2022-12-11,19:00:00,79,45,34,FMN 01 Ernest Van Dijckkaai
649,Ernest Van Dijckkaai,2022-12-11,20:00:00,56,26,30,FMN 01 Ernest Van Dijckkaai
649,Ernest Van Dijckkaai,2022-12-11,21:00:00,64,33,31,FMN 01 Ernest Van Dijckkaai
649,Ernest Van Dijckkaai,2022-12-11,22:00:00,53,18,35,FMN 01 Ernest Van Dijckkaai
649,Ernest Van Dijckkaai,2022-12-11,23:00:00,29,10,19,FMN 01 Ernest Van Dijckkaai
649,Ernest Van Dijckkaai,2022-12-12,00:00:00,10,4,6,FMN 01 Ernest Van Dijckkaai
649,Ernest Van Dijckkaai,2022-12-12,01:00:00,7,1,6,FMN 01 Ernest Van Dijckkaai
649,Ernest Van Dijckkaai,2022-12-12,02:00:00,7,3,4,FMN 01 Ernest Van Dijckkaai
649,Ernest Van Dijckkaai,2022-12-12,03:00:00,3,2,1,FMN 01 Ernest Van Dijckkaai
649,Ernest Van Dijckkaai,2022-12-12,04:00:00,29,20,9,FMN 01 Ernest Van Dijckkaai
649,Ernest Van Dijckkaai,2022-12-12,05:00:00,55,37,18,FMN 01 Ernest Van Dijckkaai
649,Ernest Van Dijckkaai,2022-12-12,06:00:00,140,97,43,FMN 01 Ernest Van Dijckkaai
649,Ernest Van Dijckkaai,2022-12-12,07:00:00,269,192,77,FMN 01 Ernest Van Dijckkaai
649,Ernest Van Dijckkaai,2022-12-12,08:00:00,369,236,133,FMN 01 Ernest Van Dijckkaai
649,Ernest Van Dijckkaai,2022-12-12,09:00:00,161,110,51,FMN 01 Ernest Van Dijckkaai
649,Ernest Van Dijckkaai,2022-12-12,10:00:00,114,69,45,FMN 01 Ernest Van Dijckkaai
649,Ernest Van Dijckkaai,2022-12-12,11:00:00,96,59,37,FMN 01 Ernest Van Dijckkaai
649,Ernest Van Dijckkaai,2022-12-12,12:00:00,153,87,66,FMN 01 Ernest Van Dijckkaai
649,Ernest Van Dijckkaai,2022-12-12,13:00:00,161,84,77,FMN 01 Ernest Van Dijckkaai
649,Ernest Van Dijckkaai,2022-12-12,14:00:00,150,78,72,FMN 01 Ernest Van Dijckkaai
649,Ernest Van Dijckkaai,2022-12-12,15:00:00,231,121,110,FMN 01 Ernest Van Dijckkaai
649,Ernest Van Dijckkaai,2022-12-12,16:00:00,351,152,199,FMN 01 Ernest Van Dijckkaai
649,Ernest Van Dijckkaai,2022-12-12,17:00:00,380,163,217,FMN 01 Ernest Van Dijckkaai
649,Ernest Van Dijckkaai,2022-12-12,18:00:00,201,89,112,FMN 01 Ernest Van Dijckkaai
649,Ernest Van Dijckkaai,2022-12-12,19:00:00,103,50,53,FMN 01 Ernest Van Dijckkaai
649,Ernest Van Dijckkaai,2022-12-12,20:00:00,80,45,35,FMN 01 Ernest Van Dijckkaai
649,Ernest Van Dijckkaai,2022-12-12,21:00:00,63,26,37,FMN 01 Ernest Van Dijckkaai
649,Ernest Van Dijckkaai,2022-12-12,22:00:00,80,32,48,FMN 01 Ernest Van Dijckkaai
649,Ernest Van Dijckkaai,2022-12-12,23:00:00,25,7,18,FMN 01 Ernest Van Dijckkaai
649,Ernest Van Dijckkaai,2022-12-13,00:00:00,17,5,12,FMN 01 Ernest Van Dijckkaai
649,Ernest Van Dijckkaai,2022-12-13,01:00:00,3,1,2,FMN 01 Ernest Van Dijckkaai
649,Ernest Van Dijckkaai,2022-12-13,02:00:00,2,1,1,FMN 01 Ernest Van Dijckkaai
649,Ernest Van Dijckkaai,2022-12-13,03:00:00,7,4,3,FMN 01 Ernest Van Dijckkaai
649,Ernest Van Dijckkaai,2022-12-13,04:00:00,21,17,4,FMN 01 Ernest Van Dijckkaai
649,Ernest Van Dijckkaai,2022-12-13,05:00:00,46,29,17,FMN 01 Ernest Van Dijckkaai
649,Ernest Van Dijckkaai,2022-12-13,06:00:00,122,85,37,FMN 01 Ernest Van Dijckkaai
649,Ernest Van Dijckkaai,2022-12-13,07:00:00,229,159,70,FMN 01 Ernest Van Dijckkaai
649,Ernest Van Dijckkaai,2022-12-13,08:00:00,343,238,105,FMN 01 Ernest Van Dijckkaai
649,Ernest Van Dijckkaai,2022-12-13,09:00:00,152,102,50,FMN 01 Ernest Van Dijckkaai
649,Ernest Van Dijckkaai,2022-12-13,10:00:00,94,58,36,FMN 01 Ernest Van Dijckkaai
649,Ernest Van Dijckkaai,2022-12-13,11:00:00,97,57,40,FMN 01 Ernest Van Dijckkaai
649,Ernest Van Dijckkaai,2022-12-13,12:00:00,151,88,63,FMN 01 Ernest Van Dijckkaai
649,Ernest Van Dijckkaai,2022-12-13,13:00:00,142,87,55,FMN 01 Ernest Van Dijckkaai
649,Ernest Van Dijckkaai,2022-12-13,14:00:00,133,58,75,FMN 01 Ernest Van Dijckkaai
649,Ernest Van Dijckkaai,2022-12-13,15:00:00,195,110,85,FMN 01 Ernest Van Dijckkaai
649,Ernest Van Dijckkaai,2022-12-13,16:00:00,309,133,176,FMN 01 Ernest Van Dijckkaai
649,Ernest Van Dijckkaai,2022-12-13,17:00:00,355,163,192,FMN 01 Ernest Van Dijckkaai
649,Ernest Van Dijckkaai,2022-12-13,18:00:00,240,122,118,FMN 01 Ernest Van Dijckkaai
649,Ernest Van Dijckkaai,2022-12-13,19:00:00,116,64,52,FMN 01 Ernest Van Dijckkaai
649,Ernest Van Dijckkaai,2022-12-13,20:00:00,74,30,44,FMN 01 Ernest Van Dijckkaai
649,Ernest Van Dijckkaai,2022-12-13,21:00:00,48,17,31,FMN 01 Ernest Van Dijckkaai
649,Ernest Van Dijckkaai,2022-12-13,22:00:00,65,28,37,FMN 01 Ernest Van Dijckkaai
649,Ernest Van Dijckkaai,2022-12-13,23:00:00,50,19,31,FMN 01 Ernest Van Dijckkaai
649,Ernest Van Dijckkaai,2022-12-14,00:00:00,18,7,11,FMN 01 Ernest Van Dijckkaai
649,Ernest Van Dijckkaai,2022-12-14,01:00:00,2,0,2,FMN 01 Ernest Van Dijckkaai
649,Ernest Van Dijckkaai,2022-12-14,02:00:00,5,2,3,FMN 01 Ernest Van Dijckkaai
649,Ernest Van Dijckkaai,2022-12-14,03:00:00,7,1,6,FMN 01 Ernest Van Dijckkaai
649,Ernest Van Dijckkaai,2022-12-14,04:00:00,32,23,9,FMN 01 Ernest Van Dijckkaai
649,Ernest Van Dijckkaai,2022-12-14,05:00:00,51,35,16,FMN 01 Ernest Van Dijckkaai
649,Ernest Van Dijckkaai,2022-12-14,06:00:00,129,85,44,FMN 01 Ernest Van Dijckkaai
649,Ernest Van Dijckkaai,2022-12-14,07:00:00,212,163,49,FMN 01 Ernest Van Dijckkaai
649,Ernest Van Dijckkaai,2022-12-14,08:00:00,337,229,108,FMN 01 Ernest Van Dijckkaai
649,Ernest Van Dijckkaai,2022-12-14,09:00:00,155,112,43,FMN 01 Ernest Van Dijckkaai
649,Ernest Van Dijckkaai,2022-12-14,10:00:00,110,68,42,FMN 01 Ernest Van Dijckkaai
649,Ernest Van Dijckkaai,2022-12-14,11:00:00,105,62,43,FMN 01 Ernest Van Dijckkaai
649,Ernest Van Dijckkaai,2022-12-14,12:00:00,179,105,74,FMN 01 Ernest Van Dijckkaai
649,Ernest Van Dijckkaai,2022-12-14,13:00:00,143,92,51,FMN 01 Ernest Van Dijckkaai
649,Ernest Van Dijckkaai,2022-12-14,14:00:00,168,80,88,FMN 01 Ernest Van Dijckkaai
649,Ernest Van Dijckkaai,2022-12-14,15:00:00,159,87,72,FMN 01 Ernest Van Dijckkaai
649,Ernest Van Dijckkaai,2022-12-14,16:00:00,279,136,143,FMN 01 Ernest Van Dijckkaai
649,Ernest Van Dijckkaai,2022-12-14,17:00:00,319,145,174,FMN 01 Ernest Van Dijckkaai
649,Ernest Van Dijckkaai,2022-12-14,18:00:00,210,111,99,FMN 01 Ernest Van Dijckkaai
649,Ernest Van Dijckkaai,2022-12-14,19:00:00,123,79,44,FMN 01 Ernest Van Dijckkaai
649,Ernest Van Dijckkaai,2022-12-14,20:00:00,76,38,38,FMN 01 Ernest Van Dijckkaai
649,Ernest Van Dijckkaai,2022-12-14,21:00:00,63,32,31,FMN 01 Ernest Van Dijckkaai
649,Ernest Van Dijckkaai,2022-12-14,22:00:00,101,35,66,FMN 01 Ernest Van Dijckkaai
649,Ernest Van Dijckkaai,2022-12-14,23:00:00,38,12,26,FMN 01 Ernest Van Dijckkaai
649,Ernest Van Dijckkaai,2022-12-15,00:00:00,25,11,14,FMN 01 Ernest Van Dijckkaai
649,Ernest Van Dijckkaai,2022-12-15,01:00:00,7,4,3,FMN 01 Ernest Van Dijckkaai
649,Ernest Van Dijckkaai,2022-12-15,02:00:00,4,2,2,FMN 01 Ernest Van Dijckkaai
649,Ernest Van Dijckkaai,2022-12-15,03:00:00,7,2,5,FMN 01 Ernest Van Dijckkaai
649,Ernest Van Dijckkaai,2022-12-15,04:00:00,22,16,6,FMN 01 Ernest Van Dijckkaai
649,Ernest Van Dijckkaai,2022-12-15,05:00:00,49,37,12,FMN 01 Ernest Van Dijckkaai
649,Ernest Van Dijckkaai,2022-12-15,06:00:00,127,89,38,FMN 01 Ernest Van Dijckkaai
649,Ernest Van Dijckkaai,2022-12-15,07:00:00,215,154,61,FMN 01 Ernest Van Dijckkaai
649,Ernest Van Dijckkaai,2022-12-15,08:00:00,338,222,116,FMN 01 Ernest Van Dijckkaai
649,Ernest Van Dijckkaai,2022-12-15,09:00:00,167,111,56,FMN 01 Ernest Van Dijckkaai
649,Ernest Van Dijckkaai,2022-12-15,10:00:00,109,79,30,FMN 01 Ernest Van Dijckkaai
649,Ernest Van Dijckkaai,2022-12-15,11:00:00,101,72,29,FMN 01 Ernest Van Dijckkaai
649,Ernest Van Dijckkaai,2022-12-15,12:00:00,154,97,57,FMN 01 Ernest Van Dijckkaai
649,Ernest Van Dijckkaai,2022-12-15,13:00:00,154,89,65,FMN 01 Ernest Van Dijckkaai
649,Ernest Van Dijckkaai,2022-12-15,14:00:00,143,77,66,FMN 01 Ernest Van Dijckkaai
649,Ernest Van Dijckkaai,2022-12-15,15:00:00,225,133,92,FMN 01 Ernest Van Dijckkaai
649,Ernest Van Dijckkaai,2022-12-15,16:00:00,360,179,181,FMN 01 Ernest Van Dijckkaai
649,Ernest Van Dijckkaai,2022-12-15,17:00:00,360,210,150,FMN 01 Ernest Van Dijckkaai
649,Ernest Van Dijckkaai,2022-12-15,18:00:00,273,170,103,FMN 01 Ernest Van Dijckkaai
649,Ernest Van Dijckkaai,2022-12-15,19:00:00,154,85,69,FMN 01 Ernest Van Dijckkaai
649,Ernest Van Dijckkaai,2022-12-15,20:00:00,103,58,45,FMN 01 Ernest Van Dijckkaai
649,Ernest Van Dijckkaai,2022-12-15,21:00:00,71,26,45,FMN 01 Ernest Van Dijckkaai
649,Ernest Van Dijckkaai,2022-12-15,22:00:00,106,29,77,FMN 01 Ernest Van Dijckkaai
649,Ernest Van Dijckkaai,2022-12-15,23:00:00,57,27,30,FMN 01 Ernest Van Dijckkaai
649,Ernest Van Dijckkaai,2022-12-16,00:00:00,37,14,23,FMN 01 Ernest Van Dijckkaai
649,Ernest Van Dijckkaai,2022-12-16,01:00:00,17,6,11,FMN 01 Ernest Van Dijckkaai
649,Ernest Van Dijckkaai,2022-12-16,02:00:00,16,4,12,FMN 01 Ernest Van Dijckkaai
649,Ernest Van Dijckkaai,2022-12-16,03:00:00,9,2,7,FMN 01 Ernest Van Dijckkaai
649,Ernest Van Dijckkaai,2022-12-16,04:00:00,32,20,12,FMN 01 Ernest Van Dijckkaai
649,Ernest Van Dijckkaai,2022-12-16,05:00:00,55,35,20,FMN 01 Ernest Van Dijckkaai
649,Ernest Van Dijckkaai,2022-12-16,06:00:00,94,66,28,FMN 01 Ernest Van Dijckkaai
649,Ernest Van Dijckkaai,2022-12-16,07:00:00,216,167,49,FMN 01 Ernest Van Dijckkaai
649,Ernest Van Dijckkaai,2022-12-16,08:00:00,310,202,108,FMN 01 Ernest Van Dijckkaai
649,Ernest Van Dijckkaai,2022-12-16,09:00:00,169,117,52,FMN 01 Ernest Van Dijckkaai
649,Ernest Van Dijckkaai,2022-12-16,10:00:00,127,82,45,FMN 01 Ernest Van Dijckkaai
649,Ernest Van Dijckkaai,2022-12-16,11:00:00,100,64,36,FMN 01 Ernest Van Dijckkaai
649,Ernest Van Dijckkaai,2022-12-16,12:00:00,172,113,59,FMN 01 Ernest Van Dijckkaai
649,Ernest Van Dijckkaai,2022-12-16,13:00:00,195,132,63,FMN 01 Ernest Van Dijckkaai
649,Ernest Van Dijckkaai,2022-12-16,14:00:00,219,107,112,FMN 01 Ernest Van Dijckkaai
649,Ernest Van Dijckkaai,2022-12-16,15:00:00,241,137,104,FMN 01 Ernest Van Dijckkaai
649,Ernest Van Dijckkaai,2022-12-16,16:00:00,345,176,169,FMN 01 Ernest Van Dijckkaai
649,Ernest Van Dijckkaai,2022-12-16,17:00:00,337,195,142,FMN 01 Ernest Van Dijckkaai
649,Ernest Van Dijckkaai,2022-12-16,18:00:00,255,151,104,FMN 01 Ernest Van Dijckkaai
649,Ernest Van Dijckkaai,2022-12-16,19:00:00,159,89,70,FMN 01 Ernest Van Dijckkaai
649,Ernest Van Dijckkaai,2022-12-16,20:00:00,137,74,63,FMN 01 Ernest Van Dijckkaai
649,Ernest Van Dijckkaai,2022-12-16,21:00:00,75,40,35,FMN 01 Ernest Van Dijckkaai
649,Ernest Van Dijckkaai,2022-12-16,22:00:00,87,23,64,FMN 01 Ernest Van Dijckkaai
649,Ernest Van Dijckkaai,2022-12-16,23:00:00,87,24,63,FMN 01 Ernest Van Dijckkaai
649,Ernest Van Dijckkaai,2022-12-17,00:00:00,67,23,44,FMN 01 Ernest Van Dijckkaai
649,Ernest Van Dijckkaai,2022-12-17,01:00:00,64,16,48,FMN 01 Ernest Van Dijckkaai
649,Ernest Van Dijckkaai,2022-12-17,02:00:00,53,20,33,FMN 01 Ernest Van Dijckkaai
649,Ernest Van Dijckkaai,2022-12-17,03:00:00,27,2,25,FMN 01 Ernest Van Dijckkaai
649,Ernest Van Dijckkaai,2022-12-17,04:00:00,17,5,12,FMN 01 Ernest Van Dijckkaai
649,Ernest Van Dijckkaai,2022-12-17,05:00:00,27,14,13,FMN 01 Ernest Van Dijckkaai
649,Ernest Van Dijckkaai,2022-12-17,06:00:00,15,6,9,FMN 01 Ernest Van Dijckkaai
649,Ernest Van Dijckkaai,2022-12-17,07:00:00,18,7,11,FMN 01 Ernest Van Dijckkaai
649,Ernest Van Dijckkaai,2022-12-17,08:00:00,43,29,14,FMN 01 Ernest Van Dijckkaai
649,Ernest Van Dijckkaai,2022-12-17,09:00:00,48,38,10,FMN 01 Ernest Van Dijckkaai
649,Ernest Van Dijckkaai,2022-12-17,10:00:00,81,54,27,FMN 01 Ernest Van Dijckkaai
649,Ernest Van Dijckkaai,2022-12-17,11:00:00,90,51,39,FMN 01 Ernest Van Dijckkaai
649,Ernest Van Dijckkaai,2022-12-17,12:00:00,103,55,48,FMN 01 Ernest Van Dijckkaai
649,Ernest Van Dijckkaai,2022-12-17,13:00:00,144,93,51,FMN 01 Ernest Van Dijckkaai
649,Ernest Van Dijckkaai,2022-12-17,14:00:00,152,73,79,FMN 01 Ernest Van Dijckkaai
649,Ernest Van Dijckkaai,2022-12-17,15:00:00,151,91,60,FMN 01 Ernest Van Dijckkaai
649,Ernest Van Dijckkaai,2022-12-17,16:00:00,125,68,57,FMN 01 Ernest Van Dijckkaai
649,Ernest Van Dijckkaai,2022-12-17,17:00:00,135,81,54,FMN 01 Ernest Van Dijckkaai
649,Ernest Van Dijckkaai,2022-12-17,18:00:00,106,64,42,FMN 01 Ernest Van Dijckkaai
649,Ernest Van Dijckkaai,2022-12-17,19:00:00,97,60,37,FMN 01 Ernest Van Dijckkaai
649,Ernest Van Dijckkaai,2022-12-17,20:00:00,83,54,29,FMN 01 Ernest Van Dijckkaai
649,Ernest Van Dijckkaai,2022-12-17,21:00:00,54,33,21,FMN 01 Ernest Van Dijckkaai
649,Ernest Van Dijckkaai,2022-12-17,22:00:00,56,35,21,FMN 01 Ernest Van Dijckkaai
649,Ernest Van Dijckkaai,2022-12-17,23:00:00,66,20,46,FMN 01 Ernest Van Dijckkaai
649,Ernest Van Dijckkaai,2022-12-18,00:00:00,40,11,29,FMN 01 Ernest Van Dijckkaai
649,Ernest Van Dijckkaai,2022-12-18,01:00:00,30,17,13,FMN 01 Ernest Van Dijckkaai
649,Ernest Van Dijckkaai,2022-12-18,02:00:00,18,4,14,FMN 01 Ernest Van Dijckkaai
649,Ernest Van Dijckkaai,2022-12-18,03:00:00,10,1,9,FMN 01 Ernest Van Dijckkaai
649,Ernest Van Dijckkaai,2022-12-18,04:00:00,14,4,10,FMN 01 Ernest Van Dijckkaai
649,Ernest Van Dijckkaai,2022-12-18,05:00:00,10,5,5,FMN 01 Ernest Van Dijckkaai
649,Ernest Van Dijckkaai,2022-12-18,06:00:00,13,8,5,FMN 01 Ernest Van Dijckkaai
649,Ernest Van Dijckkaai,2022-12-18,07:00:00,5,3,2,FMN 01 Ernest Van Dijckkaai
649,Ernest Van Dijckkaai,2022-12-18,08:00:00,17,13,4,FMN 01 Ernest Van Dijckkaai
649,Ernest Van Dijckkaai,2022-12-18,09:00:00,33,23,10,FMN 01 Ernest Van Dijckkaai
649,Ernest Van Dijckkaai,2022-12-18,10:00:00,44,28,16,FMN 01 Ernest Van Dijckkaai
649,Ernest Van Dijckkaai,2022-12-18,11:00:00,52,28,24,FMN 01 Ernest Van Dijckkaai
649,Ernest Van Dijckkaai,2022-12-18,12:00:00,61,40,21,FMN 01 Ernest Van Dijckkaai
649,Ernest Van Dijckkaai,2022-12-18,13:00:00,78,41,37,FMN 01 Ernest Van Dijckkaai
649,Ernest Van Dijckkaai,2022-12-18,14:00:00,84,50,34,FMN 01 Ernest Van Dijckkaai
649,Ernest Van Dijckkaai,2022-12-18,15:00:00,105,68,37,FMN 01 Ernest Van Dijckkaai
649,Ernest Van Dijckkaai,2022-12-18,16:00:00,58,37,21,FMN 01 Ernest Van Dijckkaai
649,Ernest Van Dijckkaai,2022-12-18,17:00:00,84,40,44,FMN 01 Ernest Van Dijckkaai
649,Ernest Van Dijckkaai,2022-12-18,18:00:00,58,18,40,FMN 01 Ernest Van Dijckkaai
649,Ernest Van Dijckkaai,2022-12-18,19:00:00,60,34,26,FMN 01 Ernest Van Dijckkaai
649,Ernest Van Dijckkaai,2022-12-18,20:00:00,29,18,11,FMN 01 Ernest Van Dijckkaai
649,Ernest Van Dijckkaai,2022-12-18,21:00:00,27,13,14,FMN 01 Ernest Van Dijckkaai
649,Ernest Van Dijckkaai,2022-12-18,22:00:00,25,11,14,FMN 01 Ernest Van Dijckkaai
649,Ernest Van Dijckkaai,2022-12-18,23:00:00,18,8,10,FMN 01 Ernest Van Dijckkaai
649,Ernest Van Dijckkaai,2022-12-19,00:00:00,2,0,2,FMN 01 Ernest Van Dijckkaai
649,Ernest Van Dijckkaai,2022-12-19,01:00:00,1,0,1,FMN 01 Ernest Van Dijckkaai
649,Ernest Van Dijckkaai,2022-12-19,02:00:00,1,0,1,FMN 01 Ernest Van Dijckkaai
649,Ernest Van Dijckkaai,2022-12-19,03:00:00,1,1,0,FMN 01 Ernest Van Dijckkaai
649,Ernest Van Dijckkaai,2022-12-19,04:00:00,28,21,7,FMN 01 Ernest Van Dijckkaai
649,Ernest Van Dijckkaai,2022-12-19,05:00:00,40,28,12,FMN 01 Ernest Van Dijckkaai
649,Ernest Van Dijckkaai,2022-12-19,06:00:00,112,83,29,FMN 01 Ernest Van Dijckkaai
649,Ernest Van Dijckkaai,2022-12-19,07:00:00,241,165,76,FMN 01 Ernest Van Dijckkaai
649,Ernest Van Dijckkaai,2022-12-19,08:00:00,393,256,137,FMN 01 Ernest Van Dijckkaai
649,Ernest Van Dijckkaai,2022-12-19,09:00:00,167,104,63,FMN 01 Ernest Van Dijckkaai
649,Ernest Van Dijckkaai,2022-12-19,10:00:00,118,78,40,FMN 01 Ernest Van Dijckkaai
649,Ernest Van Dijckkaai,2022-12-19,11:00:00,98,49,49,FMN 01 Ernest Van Dijckkaai
649,Ernest Van Dijckkaai,2022-12-19,12:00:00,148,82,66,FMN 01 Ernest Van Dijckkaai
649,Ernest Van Dijckkaai,2022-12-19,13:00:00,132,79,53,FMN 01 Ernest Van Dijckkaai
649,Ernest Van Dijckkaai,2022-12-19,14:00:00,166,86,80,FMN 01 Ernest Van Dijckkaai
649,Ernest Van Dijckkaai,2022-12-19,15:00:00,197,93,104,FMN 01 Ernest Van Dijckkaai
649,Ernest Van Dijckkaai,2022-12-19,16:00:00,338,166,172,FMN 01 Ernest Van Dijckkaai
649,Ernest Van Dijckkaai,2022-12-19,17:00:00,406,199,207,FMN 01 Ernest Van Dijckkaai
649,Ernest Van Dijckkaai,2022-12-19,18:00:00,234,114,120,FMN 01 Ernest Van Dijckkaai
649,Ernest Van Dijckkaai,2022-12-19,19:00:00,171,87,84,FMN 01 Ernest Van Dijckkaai
649,Ernest Van Dijckkaai,2022-12-19,20:00:00,103,40,63,FMN 01 Ernest Van Dijckkaai
649,Ernest Van Dijckkaai,2022-12-19,21:00:00,95,31,64,FMN 01 Ernest Van Dijckkaai
649,Ernest Van Dijckkaai,2022-12-19,22:00:00,88,25,63,FMN 01 Ernest Van Dijckkaai
649,Ernest Van Dijckkaai,2022-12-19,23:00:00,53,18,35,FMN 01 Ernest Van Dijckkaai
649,Ernest Van Dijckkaai,2022-12-20,00:00:00,15,6,9,FMN 01 Ernest Van Dijckkaai
649,Ernest Van Dijckkaai,2022-12-20,01:00:00,7,4,3,FMN 01 Ernest Van Dijckkaai
649,Ernest Van Dijckkaai,2022-12-20,02:00:00,9,3,6,FMN 01 Ernest Van Dijckkaai
649,Ernest Van Dijckkaai,2022-12-20,03:00:00,7,3,4,FMN 01 Ernest Van Dijckkaai
649,Ernest Van Dijckkaai,2022-12-20,04:00:00,36,22,14,FMN 01 Ernest Van Dijckkaai
649,Ernest Van Dijckkaai,2022-12-20,05:00:00,73,43,30,FMN 01 Ernest Van Dijckkaai
649,Ernest Van Dijckkaai,2022-12-20,06:00:00,165,117,48,FMN 01 Ernest Van Dijckkaai
649,Ernest Van Dijckkaai,2022-12-20,07:00:00,290,193,97,FMN 01 Ernest Van Dijckkaai
649,Ernest Van Dijckkaai,2022-12-20,08:00:00,418,248,170,FMN 01 Ernest Van Dijckkaai
649,Ernest Van Dijckkaai,2022-12-20,09:00:00,158,114,44,FMN 01 Ernest Van Dijckkaai
649,Ernest Van Dijckkaai,2022-12-20,10:00:00,104,61,43,FMN 01 Ernest Van Dijckkaai
649,Ernest Van Dijckkaai,2022-12-20,11:00:00,89,45,44,FMN 01 Ernest Van Dijckkaai
649,Ernest Van Dijckkaai,2022-12-20,12:00:00,160,97,63,FMN 01 Ernest Van Dijckkaai
649,Ernest Van Dijckkaai,2022-12-20,13:00:00,111,71,40,FMN 01 Ernest Van Dijckkaai
649,Ernest Van Dijckkaai,2022-12-20,14:00:00,147,75,72,FMN 01 Ernest Van Dijckkaai
649,Ernest Van Dijckkaai,2022-12-20,15:00:00,171,87,84,FMN 01 Ernest Van Dijckkaai
649,Ernest Van Dijckkaai,2022-12-20,16:00:00,331,144,187,FMN 01 Ernest Van Dijckkaai
649,Ernest Van Dijckkaai,2022-12-20,17:00:00,403,171,232,FMN 01 Ernest Van Dijckkaai
649,Ernest Van Dijckkaai,2022-12-20,18:00:00,218,116,102,FMN 01 Ernest Van Dijckkaai
649,Ernest Van Dijckkaai,2022-12-20,19:00:00,122,61,61,FMN 01 Ernest Van Dijckkaai
649,Ernest Van Dijckkaai,2022-12-20,20:00:00,82,36,46,FMN 01 Ernest Van Dijckkaai
649,Ernest Van Dijckkaai,2022-12-20,21:00:00,76,35,41,FMN 01 Ernest Van Dijckkaai
649,Ernest Van Dijckkaai,2022-12-20,22:00:00,68,22,46,FMN 01 Ernest Van Dijckkaai
649,Ernest Van Dijckkaai,2022-12-20,23:00:00,46,15,31,FMN 01 Ernest Van Dijckkaai
649,Ernest Van Dijckkaai,2022-12-21,00:00:00,22,9,13,FMN 01 Ernest Van Dijckkaai
649,Ernest Van Dijckkaai,2022-12-21,01:00:00,6,0,6,FMN 01 Ernest Van Dijckkaai
649,Ernest Van Dijckkaai,2022-12-21,02:00:00,6,2,4,FMN 01 Ernest Van Dijckkaai
649,Ernest Van Dijckkaai,2022-12-21,03:00:00,11,4,7,FMN 01 Ernest Van Dijckkaai
649,Ernest Van Dijckkaai,2022-12-21,04:00:00,43,24,19,FMN 01 Ernest Van Dijckkaai
649,Ernest Van Dijckkaai,2022-12-21,05:00:00,59,34,25,FMN 01 Ernest Van Dijckkaai
649,Ernest Van Dijckkaai,2022-12-21,06:00:00,142,105,37,FMN 01 Ernest Van Dijckkaai
649,Ernest Van Dijckkaai,2022-12-21,07:00:00,286,188,98,FMN 01 Ernest Van Dijckkaai
649,Ernest Van Dijckkaai,2022-12-21,08:00:00,377,225,152,FMN 01 Ernest Van Dijckkaai
649,Ernest Van Dijckkaai,2022-12-21,09:00:00,214,142,72,FMN 01 Ernest Van Dijckkaai
649,Ernest Van Dijckkaai,2022-12-21,10:00:00,157,93,64,FMN 01 Ernest Van Dijckkaai
649,Ernest Van Dijckkaai,2022-12-21,11:00:00,162,86,76,FMN 01 Ernest Van Dijckkaai
649,Ernest Van Dijckkaai,2022-12-21,12:00:00,227,136,91,FMN 01 Ernest Van Dijckkaai
649,Ernest Van Dijckkaai,2022-12-21,13:00:00,243,139,104,FMN 01 Ernest Van Dijckkaai
649,Ernest Van Dijckkaai,2022-12-21,14:00:00,224,110,114,FMN 01 Ernest Van Dijckkaai
649,Ernest Van Dijckkaai,2022-12-21,15:00:00,259,114,145,FMN 01 Ernest Van Dijckkaai
649,Ernest Van Dijckkaai,2022-12-21,16:00:00,347,164,183,FMN 01 Ernest Van Dijckkaai
649,Ernest Van Dijckkaai,2022-12-21,17:00:00,394,166,228,FMN 01 Ernest Van Dijckkaai
649,Ernest Van Dijckkaai,2022-12-21,18:00:00,250,122,128,FMN 01 Ernest Van Dijckkaai
649,Ernest Van Dijckkaai,2022-12-21,19:00:00,141,73,68,FMN 01 Ernest Van Dijckkaai
649,Ernest Van Dijckkaai,2022-12-21,20:00:00,134,75,59,FMN 01 Ernest Van Dijckkaai
649,Ernest Van Dijckkaai,2022-12-21,21:00:00,104,42,62,FMN 01 Ernest Van Dijckkaai
649,Ernest Van Dijckkaai,2022-12-21,22:00:00,112,44,68,FMN 01 Ernest Van Dijckkaai
649,Ernest Van Dijckkaai,2022-12-21,23:00:00,73,24,49,FMN 01 Ernest Van Dijckkaai
649,Ernest Van Dijckkaai,2022-12-22,00:00:00,45,21,24,FMN 01 Ernest Van Dijckkaai
649,Ernest Van Dijckkaai,2022-12-22,01:00:00,15,2,13,FMN 01 Ernest Van Dijckkaai
649,Ernest Van Dijckkaai,2022-12-22,02:00:00,10,1,9,FMN 01 Ernest Van Dijckkaai
649,Ernest Van Dijckkaai,2022-12-22,03:00:00,5,2,3,FMN 01 Ernest Van Dijckkaai
649,Ernest Van Dijckkaai,2022-12-22,04:00:00,36,27,9,FMN 01 Ernest Van Dijckkaai
649,Ernest Van Dijckkaai,2022-12-22,05:00:00,58,39,19,FMN 01 Ernest Van Dijckkaai
649,Ernest Van Dijckkaai,2022-12-22,06:00:00,116,76,40,FMN 01 Ernest Van Dijckkaai
649,Ernest Van Dijckkaai,2022-12-22,07:00:00,237,152,85,FMN 01 Ernest Van Dijckkaai
649,Ernest Van Dijckkaai,2022-12-22,08:00:00,382,251,131,FMN 01 Ernest Van Dijckkaai
649,Ernest Van Dijckkaai,2022-12-22,09:00:00,204,132,72,FMN 01 Ernest Van Dijckkaai
649,Ernest Van Dijckkaai,2022-12-22,10:00:00,127,87,40,FMN 01 Ernest Van Dijckkaai
649,Ernest Van Dijckkaai,2022-12-22,11:00:00,147,84,63,FMN 01 Ernest Van Dijckkaai
649,Ernest Van Dijckkaai,2022-12-22,12:00:00,228,133,95,FMN 01 Ernest Van Dijckkaai
649,Ernest Van Dijckkaai,2022-12-22,13:00:00,196,111,85,FMN 01 Ernest Van Dijckkaai
649,Ernest Van Dijckkaai,2022-12-22,14:00:00,212,107,105,FMN 01 Ernest Van Dijckkaai
649,Ernest Van Dijckkaai,2022-12-22,15:00:00,204,99,105,FMN 01 Ernest Van Dijckkaai
649,Ernest Van Dijckkaai,2022-12-22,16:00:00,298,117,181,FMN 01 Ernest Van Dijckkaai
649,Ernest Van Dijckkaai,2022-12-22,17:00:00,354,180,174,FMN 01 Ernest Van Dijckkaai
649,Ernest Van Dijckkaai,2022-12-22,18:00:00,234,117,117,FMN 01 Ernest Van Dijckkaai
649,Ernest Van Dijckkaai,2022-12-22,19:00:00,153,76,77,FMN 01 Ernest Van Dijckkaai
649,Ernest Van Dijckkaai,2022-12-22,20:00:00,130,62,68,FMN 01 Ernest Van Dijckkaai
649,Ernest Van Dijckkaai,2022-12-22,21:00:00,111,62,49,FMN 01 Ernest Van Dijckkaai
649,Ernest Van Dijckkaai,2022-12-22,22:00:00,116,40,76,FMN 01 Ernest Van Dijckkaai
649,Ernest Van Dijckkaai,2022-12-22,23:00:00,77,32,45,FMN 01 Ernest Van Dijckkaai
649,Ernest Van Dijckkaai,2022-12-23,00:00:00,52,25,27,FMN 01 Ernest Van Dijckkaai
649,Ernest Van Dijckkaai,2022-12-23,01:00:00,35,10,25,FMN 01 Ernest Van Dijckkaai
649,Ernest Van Dijckkaai,2022-12-23,02:00:00,29,5,24,FMN 01 Ernest Van Dijckkaai
649,Ernest Van Dijckkaai,2022-12-23,03:00:00,22,4,18,FMN 01 Ernest Van Dijckkaai
649,Ernest Van Dijckkaai,2022-12-23,04:00:00,43,26,17,FMN 01 Ernest Van Dijckkaai
649,Ernest Van Dijckkaai,2022-12-23,05:00:00,55,27,28,FMN 01 Ernest Van Dijckkaai
649,Ernest Van Dijckkaai,2022-12-23,06:00:00,101,69,32,FMN 01 Ernest Van Dijckkaai
649,Ernest Van Dijckkaai,2022-12-23,07:00:00,188,128,60,FMN 01 Ernest Van Dijckkaai
649,Ernest Van Dijckkaai,2022-12-23,08:00:00,306,197,109,FMN 01 Ernest Van Dijckkaai
649,Ernest Van Dijckkaai,2022-12-23,09:00:00,193,116,77,FMN 01 Ernest Van Dijckkaai
649,Ernest Van Dijckkaai,2022-12-23,10:00:00,119,67,52,FMN 01 Ernest Van Dijckkaai
649,Ernest Van Dijckkaai,2022-12-23,11:00:00,104,57,47,FMN 01 Ernest Van Dijckkaai
649,Ernest Van Dijckkaai,2022-12-23,12:00:00,162,89,73,FMN 01 Ernest Van Dijckkaai
649,Ernest Van Dijckkaai,2022-12-23,13:00:00,114,55,59,FMN 01 Ernest Van Dijckkaai
649,Ernest Van Dijckkaai,2022-12-23,14:00:00,155,72,83,FMN 01 Ernest Van Dijckkaai
649,Ernest Van Dijckkaai,2022-12-23,15:00:00,190,89,101,FMN 01 Ernest Van Dijckkaai
649,Ernest Van Dijckkaai,2022-12-23,16:00:00,215,107,108,FMN 01 Ernest Van Dijckkaai
649,Ernest Van Dijckkaai,2022-12-23,17:00:00,204,105,99,FMN 01 Ernest Van Dijckkaai
649,Ernest Van Dijckkaai,2022-12-23,18:00:00,185,107,78,FMN 01 Ernest Van Dijckkaai
649,Ernest Van Dijckkaai,2022-12-23,19:00:00,151,88,63,FMN 01 Ernest Van Dijckkaai
649,Ernest Van Dijckkaai,2022-12-23,20:00:00,132,73,59,FMN 01 Ernest Van Dijckkaai
649,Ernest Van Dijckkaai,2022-12-23,21:00:00,98,44,54,FMN 01 Ernest Van Dijckkaai
649,Ernest Van Dijckkaai,2022-12-23,22:00:00,88,33,55,FMN 01 Ernest Van Dijckkaai
649,Ernest Van Dijckkaai,2022-12-23,23:00:00,95,47,48,FMN 01 Ernest Van Dijckkaai
649,Ernest Van Dijckkaai,2022-12-24,00:00:00,63,20,43,FMN 01 Ernest Van Dijckkaai
649,Ernest Van Dijckkaai,2022-12-24,01:00:00,33,10,23,FMN 01 Ernest Van Dijckkaai
649,Ernest Van Dijckkaai,2022-12-24,02:00:00,40,7,33,FMN 01 Ernest Van Dijckkaai
649,Ernest Van Dijckkaai,2022-12-24,03:00:00,31,8,23,FMN 01 Ernest Van Dijckkaai
649,Ernest Van Dijckkaai,2022-12-24,04:00:00,38,17,21,FMN 01 Ernest Van Dijckkaai
649,Ernest Van Dijckkaai,2022-12-24,05:00:00,27,12,15,FMN 01 Ernest Van Dijckkaai
649,Ernest Van Dijckkaai,2022-12-24,06:00:00,38,20,18,FMN 01 Ernest Van Dijckkaai
649,Ernest Van Dijckkaai,2022-12-24,07:00:00,20,11,9,FMN 01 Ernest Van Dijckkaai
649,Ernest Van Dijckkaai,2022-12-24,08:00:00,39,24,15,FMN 01 Ernest Van Dijckkaai
649,Ernest Van Dijckkaai,2022-12-24,09:00:00,73,40,33,FMN 01 Ernest Van Dijckkaai
649,Ernest Van Dijckkaai,2022-12-24,10:00:00,94,54,40,FMN 01 Ernest Van Dijckkaai
649,Ernest Van Dijckkaai,2022-12-24,11:00:00,123,60,63,FMN 01 Ernest Van Dijckkaai
649,Ernest Van Dijckkaai,2022-12-24,12:00:00,151,85,66,FMN 01 Ernest Van Dijckkaai
649,Ernest Van Dijckkaai,2022-12-24,13:00:00,151,86,65,FMN 01 Ernest Van Dijckkaai
649,Ernest Van Dijckkaai,2022-12-24,14:00:00,160,97,63,FMN 01 Ernest Van Dijckkaai
649,Ernest Van Dijckkaai,2022-12-24,15:00:00,172,97,75,FMN 01 Ernest Van Dijckkaai
649,Ernest Van Dijckkaai,2022-12-24,16:00:00,153,67,86,FMN 01 Ernest Van Dijckkaai
649,Ernest Van Dijckkaai,2022-12-24,17:00:00,79,37,42,FMN 01 Ernest Van Dijckkaai
649,Ernest Van Dijckkaai,2022-12-24,18:00:00,77,31,46,FMN 01 Ernest Van Dijckkaai
649,Ernest Van Dijckkaai,2022-12-24,19:00:00,48,20,28,FMN 01 Ernest Van Dijckkaai
649,Ernest Van Dijckkaai,2022-12-24,20:00:00,45,27,18,FMN 01 Ernest Van Dijckkaai
649,Ernest Van Dijckkaai,2022-12-24,21:00:00,38,20,18,FMN 01 Ernest Van Dijckkaai
649,Ernest Van Dijckkaai,2022-12-24,22:00:00,44,26,18,FMN 01 Ernest Van Dijckkaai
649,Ernest Van Dijckkaai,2022-12-24,23:00:00,42,21,21,FMN 01 Ernest Van Dijckkaai
649,Ernest Van Dijckkaai,2022-12-25,00:00:00,24,13,11,FMN 01 Ernest Van Dijckkaai
649,Ernest Van Dijckkaai,2022-12-25,01:00:00,27,13,14,FMN 01 Ernest Van Dijckkaai
649,Ernest Van Dijckkaai,2022-12-25,02:00:00,16,7,9,FMN 01 Ernest Van Dijckkaai
649,Ernest Van Dijckkaai,2022-12-25,03:00:00,8,0,8,FMN 01 Ernest Van Dijckkaai
649,Ernest Van Dijckkaai,2022-12-25,04:00:00,14,6,8,FMN 01 Ernest Van Dijckkaai
649,Ernest Van Dijckkaai,2022-12-25,05:00:00,12,6,6,FMN 01 Ernest Van Dijckkaai
649,Ernest Van Dijckkaai,2022-12-25,06:00:00,31,9,22,FMN 01 Ernest Van Dijckkaai
649,Ernest Van Dijckkaai,2022-12-25,07:00:00,14,8,6,FMN 01 Ernest Van Dijckkaai
649,Ernest Van Dijckkaai,2022-12-25,08:00:00,15,7,8,FMN 01 Ernest Van Dijckkaai
649,Ernest Van Dijckkaai,2022-12-25,09:00:00,22,11,11,FMN 01 Ernest Van Dijckkaai
649,Ernest Van Dijckkaai,2022-12-25,10:00:00,34,19,15,FMN 01 Ernest Van Dijckkaai
649,Ernest Van Dijckkaai,2022-12-25,11:00:00,30,15,15,FMN 01 Ernest Van Dijckkaai
649,Ernest Van Dijckkaai,2022-12-25,12:00:00,32,19,13,FMN 01 Ernest Van Dijckkaai
649,Ernest Van Dijckkaai,2022-12-25,13:00:00,39,22,17,FMN 01 Ernest Van Dijckkaai
649,Ernest Van Dijckkaai,2022-12-25,14:00:00,34,17,17,FMN 01 Ernest Van Dijckkaai
649,Ernest Van Dijckkaai,2022-12-25,15:00:00,35,15,20,FMN 01 Ernest Van Dijckkaai
649,Ernest Van Dijckkaai,2022-12-25,16:00:00,31,17,14,FMN 01 Ernest Van Dijckkaai
649,Ernest Van Dijckkaai,2022-12-25,17:00:00,39,22,17,FMN 01 Ernest Van Dijckkaai
649,Ernest Van Dijckkaai,2022-12-25,18:00:00,30,14,16,FMN 01 Ernest Van Dijckkaai
649,Ernest Van Dijckkaai,2022-12-25,19:00:00,29,16,13,FMN 01 Ernest Van Dijckkaai
649,Ernest Van Dijckkaai,2022-12-25,20:00:00,33,16,17,FMN 01 Ernest Van Dijckkaai
649,Ernest Van Dijckkaai,2022-12-25,21:00:00,24,8,16,FMN 01 Ernest Van Dijckkaai
649,Ernest Van Dijckkaai,2022-12-25,22:00:00,34,18,16,FMN 01 Ernest Van Dijckkaai
649,Ernest Van Dijckkaai,2022-12-25,23:00:00,23,3,20,FMN 01 Ernest Van Dijckkaai
649,Ernest Van Dijckkaai,2022-12-26,00:00:00,13,9,4,FMN 01 Ernest Van Dijckkaai
649,Ernest Van Dijckkaai,2022-12-26,01:00:00,9,1,8,FMN 01 Ernest Van Dijckkaai
649,Ernest Van Dijckkaai,2022-12-26,02:00:00,3,2,1,FMN 01 Ernest Van Dijckkaai
649,Ernest Van Dijckkaai,2022-12-26,03:00:00,8,3,5,FMN 01 Ernest Van Dijckkaai
649,Ernest Van Dijckkaai,2022-12-26,04:00:00,30,19,11,FMN 01 Ernest Van Dijckkaai
649,Ernest Van Dijckkaai,2022-12-26,05:00:00,25,14,11,FMN 01 Ernest Van Dijckkaai
649,Ernest Van Dijckkaai,2022-12-26,06:00:00,44,26,18,FMN 01 Ernest Van Dijckkaai
649,Ernest Van Dijckkaai,2022-12-26,07:00:00,65,39,26,FMN 01 Ernest Van Dijckkaai
649,Ernest Van Dijckkaai,2022-12-26,08:00:00,77,43,34,FMN 01 Ernest Van Dijckkaai
649,Ernest Van Dijckkaai,2022-12-26,09:00:00,58,29,29,FMN 01 Ernest Van Dijckkaai
649,Ernest Van Dijckkaai,2022-12-26,10:00:00,60,38,22,FMN 01 Ernest Van Dijckkaai
649,Ernest Van Dijckkaai,2022-12-26,11:00:00,52,31,21,FMN 01 Ernest Van Dijckkaai
649,Ernest Van Dijckkaai,2022-12-26,12:00:00,102,65,37,FMN 01 Ernest Van Dijckkaai
649,Ernest Van Dijckkaai,2022-12-26,13:00:00,122,68,54,FMN 01 Ernest Van Dijckkaai
649,Ernest Van Dijckkaai,2022-12-26,14:00:00,154,89,65,FMN 01 Ernest Van Dijckkaai
649,Ernest Van Dijckkaai,2022-12-26,15:00:00,198,100,98,FMN 01 Ernest Van Dijckkaai
649,Ernest Van Dijckkaai,2022-12-26,16:00:00,219,108,111,FMN 01 Ernest Van Dijckkaai
649,Ernest Van Dijckkaai,2022-12-26,17:00:00,176,75,101,FMN 01 Ernest Van Dijckkaai
649,Ernest Van Dijckkaai,2022-12-26,18:00:00,165,78,87,FMN 01 Ernest Van Dijckkaai
649,Ernest Van Dijckkaai,2022-12-26,19:00:00,107,53,54,FMN 01 Ernest Van Dijckkaai
649,Ernest Van Dijckkaai,2022-12-26,20:00:00,68,36,32,FMN 01 Ernest Van Dijckkaai
649,Ernest Van Dijckkaai,2022-12-26,21:00:00,64,29,35,FMN 01 Ernest Van Dijckkaai
649,Ernest Van Dijckkaai,2022-12-26,22:00:00,57,21,36,FMN 01 Ernest Van Dijckkaai
649,Ernest Van Dijckkaai,2022-12-26,23:00:00,32,10,22,FMN 01 Ernest Van Dijckkaai
649,Ernest Van Dijckkaai,2022-12-27,00:00:00,20,4,16,FMN 01 Ernest Van Dijckkaai
649,Ernest Van Dijckkaai,2022-12-27,01:00:00,5,1,4,FMN 01 Ernest Van Dijckkaai
649,Ernest Van Dijckkaai,2022-12-27,02:00:00,4,3,1,FMN 01 Ernest Van Dijckkaai
649,Ernest Van Dijckkaai,2022-12-27,03:00:00,3,1,2,FMN 01 Ernest Van Dijckkaai
649,Ernest Van Dijckkaai,2022-12-27,04:00:00,26,21,5,FMN 01 Ernest Van Dijckkaai
649,Ernest Van Dijckkaai,2022-12-27,05:00:00,37,21,16,FMN 01 Ernest Van Dijckkaai
649,Ernest Van Dijckkaai,2022-12-27,06:00:00,97,63,34,FMN 01 Ernest Van Dijckkaai
649,Ernest Van Dijckkaai,2022-12-27,07:00:00,121,78,43,FMN 01 Ernest Van Dijckkaai
649,Ernest Van Dijckkaai,2022-12-27,08:00:00,151,89,62,FMN 01 Ernest Van Dijckkaai
649,Ernest Van Dijckkaai,2022-12-27,09:00:00,124,83,41,FMN 01 Ernest Van Dijckkaai
649,Ernest Van Dijckkaai,2022-12-27,10:00:00,89,37,52,FMN 01 Ernest Van Dijckkaai
649,Ernest Van Dijckkaai,2022-12-27,11:00:00,122,75,47,FMN 01 Ernest Van Dijckkaai
649,Ernest Van Dijckkaai,2022-12-27,12:00:00,183,104,79,FMN 01 Ernest Van Dijckkaai
649,Ernest Van Dijckkaai,2022-12-27,13:00:00,186,110,76,FMN 01 Ernest Van Dijckkaai
649,Ernest Van Dijckkaai,2022-12-27,14:00:00,214,119,95,FMN 01 Ernest Van Dijckkaai
649,Ernest Van Dijckkaai,2022-12-27,15:00:00,273,159,114,FMN 01 Ernest Van Dijckkaai
649,Ernest Van Dijckkaai,2022-12-27,16:00:00,366,171,195,FMN 01 Ernest Van Dijckkaai
649,Ernest Van Dijckkaai,2022-12-27,17:00:00,318,129,189,FMN 01 Ernest Van Dijckkaai
649,Ernest Van Dijckkaai,2022-12-27,18:00:00,225,104,121,FMN 01 Ernest Van Dijckkaai
649,Ernest Van Dijckkaai,2022-12-27,19:00:00,130,63,67,FMN 01 Ernest Van Dijckkaai
649,Ernest Van Dijckkaai,2022-12-27,20:00:00,98,50,48,FMN 01 Ernest Van Dijckkaai
649,Ernest Van Dijckkaai,2022-12-27,21:00:00,81,38,43,FMN 01 Ernest Van Dijckkaai
649,Ernest Van Dijckkaai,2022-12-27,22:00:00,102,39,63,FMN 01 Ernest Van Dijckkaai
649,Ernest Van Dijckkaai,2022-12-27,23:00:00,50,10,40,FMN 01 Ernest Van Dijckkaai
649,Ernest Van Dijckkaai,2022-12-28,00:00:00,44,11,33,FMN 01 Ernest Van Dijckkaai
649,Ernest Van Dijckkaai,2022-12-28,01:00:00,22,4,18,FMN 01 Ernest Van Dijckkaai
649,Ernest Van Dijckkaai,2022-12-28,02:00:00,8,4,4,FMN 01 Ernest Van Dijckkaai
649,Ernest Van Dijckkaai,2022-12-28,03:00:00,9,1,8,FMN 01 Ernest Van Dijckkaai
649,Ernest Van Dijckkaai,2022-12-28,04:00:00,22,13,9,FMN 01 Ernest Van Dijckkaai
649,Ernest Van Dijckkaai,2022-12-28,05:00:00,39,24,15,FMN 01 Ernest Van Dijckkaai
649,Ernest Van Dijckkaai,2022-12-28,06:00:00,71,45,26,FMN 01 Ernest Van Dijckkaai
649,Ernest Van Dijckkaai,2022-12-28,07:00:00,118,75,43,FMN 01 Ernest Van Dijckkaai
649,Ernest Van Dijckkaai,2022-12-28,08:00:00,159,100,59,FMN 01 Ernest Van Dijckkaai
649,Ernest Van Dijckkaai,2022-12-28,09:00:00,96,59,37,FMN 01 Ernest Van Dijckkaai
649,Ernest Van Dijckkaai,2022-12-28,10:00:00,89,49,40,FMN 01 Ernest Van Dijckkaai
649,Ernest Van Dijckkaai,2022-12-28,11:00:00,91,57,34,FMN 01 Ernest Van Dijckkaai
649,Ernest Van Dijckkaai,2022-12-28,12:00:00,122,73,49,FMN 01 Ernest Van Dijckkaai
649,Ernest Van Dijckkaai,2022-12-28,13:00:00,136,71,65,FMN 01 Ernest Van Dijckkaai
649,Ernest Van Dijckkaai,2022-12-28,14:00:00,149,83,66,FMN 01 Ernest Van Dijckkaai
649,Ernest Van Dijckkaai,2022-12-28,15:00:00,167,89,78,FMN 01 Ernest Van Dijckkaai
649,Ernest Van Dijckkaai,2022-12-28,16:00:00,206,94,112,FMN 01 Ernest Van Dijckkaai
649,Ernest Van Dijckkaai,2022-12-28,17:00:00,205,95,110,FMN 01 Ernest Van Dijckkaai
649,Ernest Van Dijckkaai,2022-12-28,18:00:00,137,87,50,FMN 01 Ernest Van Dijckkaai
649,Ernest Van Dijckkaai,2022-12-28,19:00:00,91,48,43,FMN 01 Ernest Van Dijckkaai
649,Ernest Van Dijckkaai,2022-12-28,20:00:00,79,38,41,FMN 01 Ernest Van Dijckkaai
649,Ernest Van Dijckkaai,2022-12-28,21:00:00,60,30,30,FMN 01 Ernest Van Dijckkaai
649,Ernest Van Dijckkaai,2022-12-28,22:00:00,65,24,41,FMN 01 Ernest Van Dijckkaai
649,Ernest Van Dijckkaai,2022-12-28,23:00:00,63,9,54,FMN 01 Ernest Van Dijckkaai
649,Ernest Van Dijckkaai,2022-12-29,00:00:00,23,9,14,FMN 01 Ernest Van Dijckkaai
649,Ernest Van Dijckkaai,2022-12-29,01:00:00,22,9,13,FMN 01 Ernest Van Dijckkaai
649,Ernest Van Dijckkaai,2022-12-29,02:00:00,9,2,7,FMN 01 Ernest Van Dijckkaai
649,Ernest Van Dijckkaai,2022-12-29,03:00:00,8,3,5,FMN 01 Ernest Van Dijckkaai
649,Ernest Van Dijckkaai,2022-12-29,04:00:00,23,18,5,FMN 01 Ernest Van Dijckkaai
649,Ernest Van Dijckkaai,2022-12-29,05:00:00,33,22,11,FMN 01 Ernest Van Dijckkaai
649,Ernest Van Dijckkaai,2022-12-29,06:00:00,65,39,26,FMN 01 Ernest Van Dijckkaai
649,Ernest Van Dijckkaai,2022-12-29,07:00:00,124,79,45,FMN 01 Ernest Van Dijckkaai
649,Ernest Van Dijckkaai,2022-12-29,08:00:00,130,76,54,FMN 01 Ernest Van Dijckkaai
649,Ernest Van Dijckkaai,2022-12-29,09:00:00,85,57,28,FMN 01 Ernest Van Dijckkaai
649,Ernest Van Dijckkaai,2022-12-29,10:00:00,73,48,25,FMN 01 Ernest Van Dijckkaai
649,Ernest Van Dijckkaai,2022-12-29,11:00:00,97,58,39,FMN 01 Ernest Van Dijckkaai
649,Ernest Van Dijckkaai,2022-12-29,12:00:00,161,97,64,FMN 01 Ernest Van Dijckkaai
649,Ernest Van Dijckkaai,2022-12-29,13:00:00,152,83,69,FMN 01 Ernest Van Dijckkaai
649,Ernest Van Dijckkaai,2022-12-29,14:00:00,142,73,69,FMN 01 Ernest Van Dijckkaai
649,Ernest Van Dijckkaai,2022-12-29,15:00:00,164,83,81,FMN 01 Ernest Van Dijckkaai
649,Ernest Van Dijckkaai,2022-12-29,16:00:00,245,110,135,FMN 01 Ernest Van Dijckkaai
649,Ernest Van Dijckkaai,2022-12-29,17:00:00,248,136,112,FMN 01 Ernest Van Dijckkaai
649,Ernest Van Dijckkaai,2022-12-29,18:00:00,179,99,80,FMN 01 Ernest Van Dijckkaai
649,Ernest Van Dijckkaai,2022-12-29,19:00:00,142,68,74,FMN 01 Ernest Van Dijckkaai
649,Ernest Van Dijckkaai,2022-12-29,20:00:00,120,56,64,FMN 01 Ernest Van Dijckkaai
649,Ernest Van Dijckkaai,2022-12-29,21:00:00,90,38,52,FMN 01 Ernest Van Dijckkaai
649,Ernest Van Dijckkaai,2022-12-29,22:00:00,85,29,56,FMN 01 Ernest Van Dijckkaai
649,Ernest Van Dijckkaai,2022-12-29,23:00:00,69,35,34,FMN 01 Ernest Van Dijckkaai
649,Ernest Van Dijckkaai,2022-12-30,00:00:00,41,18,23,FMN 01 Ernest Van Dijckkaai
649,Ernest Van Dijckkaai,2022-12-30,01:00:00,29,13,16,FMN 01 Ernest Van Dijckkaai
649,Ernest Van Dijckkaai,2022-12-30,02:00:00,13,5,8,FMN 01 Ernest Van Dijckkaai
649,Ernest Van Dijckkaai,2022-12-30,03:00:00,17,2,15,FMN 01 Ernest Van Dijckkaai
649,Ernest Van Dijckkaai,2022-12-30,04:00:00,30,15,15,FMN 01 Ernest Van Dijckkaai
649,Ernest Van Dijckkaai,2022-12-30,05:00:00,46,20,26,FMN 01 Ernest Van Dijckkaai
649,Ernest Van Dijckkaai,2022-12-30,06:00:00,62,39,23,FMN 01 Ernest Van Dijckkaai
649,Ernest Van Dijckkaai,2022-12-30,07:00:00,98,59,39,FMN 01 Ernest Van Dijckkaai
649,Ernest Van Dijckkaai,2022-12-30,08:00:00,116,71,45,FMN 01 Ernest Van Dijckkaai
649,Ernest Van Dijckkaai,2022-12-30,09:00:00,95,59,36,FMN 01 Ernest Van Dijckkaai
649,Ernest Van Dijckkaai,2022-12-30,10:00:00,104,61,43,FMN 01 Ernest Van Dijckkaai
649,Ernest Van Dijckkaai,2022-12-30,11:00:00,142,73,69,FMN 01 Ernest Van Dijckkaai
649,Ernest Van Dijckkaai,2022-12-30,12:00:00,110,66,44,FMN 01 Ernest Van Dijckkaai
649,Ernest Van Dijckkaai,2022-12-30,13:00:00,102,50,52,FMN 01 Ernest Van Dijckkaai
649,Ernest Van Dijckkaai,2022-12-30,14:00:00,127,56,71,FMN 01 Ernest Van Dijckkaai
649,Ernest Van Dijckkaai,2022-12-30,15:00:00,132,59,73,FMN 01 Ernest Van Dijckkaai
649,Ernest Van Dijckkaai,2022-12-30,16:00:00,187,85,102,FMN 01 Ernest Van Dijckkaai
649,Ernest Van Dijckkaai,2022-12-30,17:00:00,158,81,77,FMN 01 Ernest Van Dijckkaai
649,Ernest Van Dijckkaai,2022-12-30,18:00:00,114,58,56,FMN 01 Ernest Van Dijckkaai
649,Ernest Van Dijckkaai,2022-12-30,19:00:00,112,61,51,FMN 01 Ernest Van Dijckkaai
649,Ernest Van Dijckkaai,2022-12-30,20:00:00,97,53,44,FMN 01 Ernest Van Dijckkaai
649,Ernest Van Dijckkaai,2022-12-30,21:00:00,76,32,44,FMN 01 Ernest Van Dijckkaai
649,Ernest Van Dijckkaai,2022-12-30,22:00:00,74,33,41,FMN 01 Ernest Van Dijckkaai
649,Ernest Van Dijckkaai,2022-12-30,23:00:00,55,14,41,FMN 01 Ernest Van Dijckkaai
649,Ernest Van Dijckkaai,2022-12-31,00:00:00,32,18,14,FMN 01 Ernest Van Dijckkaai
649,Ernest Van Dijckkaai,2022-12-31,01:00:00,12,3,9,FMN 01 Ernest Van Dijckkaai
649,Ernest Van Dijckkaai,2022-12-31,02:00:00,11,5,6,FMN 01 Ernest Van Dijckkaai
649,Ernest Van Dijckkaai,2022-12-31,03:00:00,17,7,10,FMN 01 Ernest Van Dijckkaai
649,Ernest Van Dijckkaai,2022-12-31,04:00:00,24,10,14,FMN 01 Ernest Van Dijckkaai
649,Ernest Van Dijckkaai,2022-12-31,05:00:00,10,8,2,FMN 01 Ernest Van Dijckkaai
649,Ernest Van Dijckkaai,2022-12-31,06:00:00,15,8,7,FMN 01 Ernest Van Dijckkaai
649,Ernest Van Dijckkaai,2022-12-31,07:00:00,24,14,10,FMN 01 Ernest Van Dijckkaai
649,Ernest Van Dijckkaai,2022-12-31,08:00:00,22,15,7,FMN 01 Ernest Van Dijckkaai
649,Ernest Van Dijckkaai,2022-12-31,09:00:00,34,18,16,FMN 01 Ernest Van Dijckkaai
649,Ernest Van Dijckkaai,2022-12-31,10:00:00,57,30,27,FMN 01 Ernest Van Dijckkaai
649,Ernest Van Dijckkaai,2022-12-31,11:00:00,88,41,47,FMN 01 Ernest Van Dijckkaai
649,Ernest Van Dijckkaai,2022-12-31,12:00:00,78,49,29,FMN 01 Ernest Van Dijckkaai
649,Ernest Van Dijckkaai,2022-12-31,13:00:00,87,56,31,FMN 01 Ernest Van Dijckkaai
649,Ernest Van Dijckkaai,2022-12-31,14:00:00,113,54,59,FMN 01 Ernest Van Dijckkaai
649,Ernest Van Dijckkaai,2022-12-31,15:00:00,134,78,56,FMN 01 Ernest Van Dijckkaai
649,Ernest Van Dijckkaai,2022-12-31,16:00:00,160,88,72,FMN 01 Ernest Van Dijckkaai
649,Ernest Van Dijckkaai,2022-12-31,17:00:00,132,64,68,FMN 01 Ernest Van Dijckkaai
649,Ernest Van Dijckkaai,2022-12-31,18:00:00,158,93,65,FMN 01 Ernest Van Dijckkaai
649,Ernest Van Dijckkaai,2022-12-31,19:00:00,100,49,51,FMN 01 Ernest Van Dijckkaai
649,Ernest Van Dijckkaai,2022-12-31,20:00:00,61,29,32,FMN 01 Ernest Van Dijckkaai
649,Ernest Van Dijckkaai,2022-12-31,21:00:00,98,56,42,FMN 01 Ernest Van Dijckkaai
649,Ernest Van Dijckkaai,2022-12-31,22:00:00,105,69,36,FMN 01 Ernest Van Dijckkaai
649,Ernest Van Dijckkaai,2022-12-31,23:00:00,119,42,77,FMN 01 Ernest Van Dijckkaai
649,Ernest Van Dijckkaai,2023-01-01,00:00:00,139,108,31,FMN 01 Ernest Van Dijckkaai
649,Ernest Van Dijckkaai,2023-01-01,01:00:00,111,67,44,FMN 01 Ernest Van Dijckkaai
649,Ernest Van Dijckkaai,2023-01-01,02:00:00,128,55,73,FMN 01 Ernest Van Dijckkaai
649,Ernest Van Dijckkaai,2023-01-01,03:00:00,103,38,65,FMN 01 Ernest Van Dijckkaai
649,Ernest Van Dijckkaai,2023-01-01,04:00:00,108,31,77,FMN 01 Ernest Van Dijckkaai
649,Ernest Van Dijckkaai,2023-01-01,05:00:00,76,22,54,FMN 01 Ernest Van Dijckkaai
649,Ernest Van Dijckkaai,2023-01-01,06:00:00,50,11,39,FMN 01 Ernest Van Dijckkaai
649,Ernest Van Dijckkaai,2023-01-01,07:00:00,33,11,22,FMN 01 Ernest Van Dijckkaai
649,Ernest Van Dijckkaai,2023-01-01,08:00:00,8,4,4,FMN 01 Ernest Van Dijckkaai
649,Ernest Van Dijckkaai,2023-01-01,09:00:00,16,8,8,FMN 01 Ernest Van Dijckkaai
649,Ernest Van Dijckkaai,2023-01-01,10:00:00,44,23,21,FMN 01 Ernest Van Dijckkaai
649,Ernest Van Dijckkaai,2023-01-01,11:00:00,51,25,26,FMN 01 Ernest Van Dijckkaai
649,Ernest Van Dijckkaai,2023-01-01,12:00:00,89,56,33,FMN 01 Ernest Van Dijckkaai
649,Ernest Van Dijckkaai,2023-01-01,13:00:00,106,67,39,FMN 01 Ernest Van Dijckkaai
649,Ernest Van Dijckkaai,2023-01-01,14:00:00,150,87,63,FMN 01 Ernest Van Dijckkaai
649,Ernest Van Dijckkaai,2023-01-01,15:00:00,100,47,53,FMN 01 Ernest Van Dijckkaai
649,Ernest Van Dijckkaai,2023-01-01,16:00:00,146,56,90,FMN 01 Ernest Van Dijckkaai
649,Ernest Van Dijckkaai,2023-01-01,17:00:00,65,36,29,FMN 01 Ernest Van Dijckkaai
649,Ernest Van Dijckkaai,2023-01-01,18:00:00,53,27,26,FMN 01 Ernest Van Dijckkaai
649,Ernest Van Dijckkaai,2023-01-01,19:00:00,49,15,34,FMN 01 Ernest Van Dijckkaai
649,Ernest Van Dijckkaai,2023-01-01,20:00:00,43,23,20,FMN 01 Ernest Van Dijckkaai
649,Ernest Van Dijckkaai,2023-01-01,21:00:00,45,23,22,FMN 01 Ernest Van Dijckkaai
649,Ernest Van Dijckkaai,2023-01-01,22:00:00,29,13,16,FMN 01 Ernest Van Dijckkaai
649,Ernest Van Dijckkaai,2023-01-01,23:00:00,21,6,15,FMN 01 Ernest Van Dijckkaai
649,Ernest Van Dijckkaai,2023-01-02,00:00:00,5,2,3,FMN 01 Ernest Van Dijckkaai
649,Ernest Van Dijckkaai,2023-01-02,01:00:00,10,5,5,FMN 01 Ernest Van Dijckkaai
649,Ernest Van Dijckkaai,2023-01-02,02:00:00,2,1,1,FMN 01 Ernest Van Dijckkaai
649,Ernest Van Dijckkaai,2023-01-02,03:00:00,6,3,3,FMN 01 Ernest Van Dijckkaai
649,Ernest Van Dijckkaai,2023-01-02,04:00:00,27,20,7,FMN 01 Ernest Van Dijckkaai
649,Ernest Van Dijckkaai,2023-01-02,05:00:00,28,19,9,FMN 01 Ernest Van Dijckkaai
649,Ernest Van Dijckkaai,2023-01-02,06:00:00,43,30,13,FMN 01 Ernest Van Dijckkaai
649,Ernest Van Dijckkaai,2023-01-02,07:00:00,104,64,40,FMN 01 Ernest Van Dijckkaai
649,Ernest Van Dijckkaai,2023-01-02,08:00:00,154,89,65,FMN 01 Ernest Van Dijckkaai
649,Ernest Van Dijckkaai,2023-01-02,09:00:00,75,43,32,FMN 01 Ernest Van Dijckkaai
649,Ernest Van Dijckkaai,2023-01-02,10:00:00,74,52,22,FMN 01 Ernest Van Dijckkaai
649,Ernest Van Dijckkaai,2023-01-02,11:00:00,108,59,49,FMN 01 Ernest Van Dijckkaai
649,Ernest Van Dijckkaai,2023-01-02,12:00:00,126,68,58,FMN 01 Ernest Van Dijckkaai
649,Ernest Van Dijckkaai,2023-01-02,13:00:00,180,118,62,FMN 01 Ernest Van Dijckkaai
649,Ernest Van Dijckkaai,2023-01-02,14:00:00,117,44,73,FMN 01 Ernest Van Dijckkaai
649,Ernest Van Dijckkaai,2023-01-02,15:00:00,134,68,66,FMN 01 Ernest Van Dijckkaai
649,Ernest Van Dijckkaai,2023-01-02,16:00:00,169,80,89,FMN 01 Ernest Van Dijckkaai
649,Ernest Van Dijckkaai,2023-01-02,17:00:00,244,108,136,FMN 01 Ernest Van Dijckkaai
649,Ernest Van Dijckkaai,2023-01-02,18:00:00,134,81,53,FMN 01 Ernest Van Dijckkaai
649,Ernest Van Dijckkaai,2023-01-02,19:00:00,131,62,69,FMN 01 Ernest Van Dijckkaai
649,Ernest Van Dijckkaai,2023-01-02,20:00:00,73,34,39,FMN 01 Ernest Van Dijckkaai
649,Ernest Van Dijckkaai,2023-01-02,21:00:00,60,27,33,FMN 01 Ernest Van Dijckkaai
649,Ernest Van Dijckkaai,2023-01-02,22:00:00,54,18,36,FMN 01 Ernest Van Dijckkaai
649,Ernest Van Dijckkaai,2023-01-02,23:00:00,32,10,22,FMN 01 Ernest Van Dijckkaai
649,Ernest Van Dijckkaai,2023-01-03,00:00:00,19,5,14,FMN 01 Ernest Van Dijckkaai
649,Ernest Van Dijckkaai,2023-01-03,01:00:00,13,2,11,FMN 01 Ernest Van Dijckkaai
649,Ernest Van Dijckkaai,2023-01-03,02:00:00,4,2,2,FMN 01 Ernest Van Dijckkaai
649,Ernest Van Dijckkaai,2023-01-03,03:00:00,7,3,4,FMN 01 Ernest Van Dijckkaai
649,Ernest Van Dijckkaai,2023-01-03,04:00:00,46,31,15,FMN 01 Ernest Van Dijckkaai
649,Ernest Van Dijckkaai,2023-01-03,05:00:00,64,44,20,FMN 01 Ernest Van Dijckkaai
649,Ernest Van Dijckkaai,2023-01-03,06:00:00,164,110,54,FMN 01 Ernest Van Dijckkaai
649,Ernest Van Dijckkaai,2023-01-03,07:00:00,215,139,76,FMN 01 Ernest Van Dijckkaai
649,Ernest Van Dijckkaai,2023-01-03,08:00:00,324,198,126,FMN 01 Ernest Van Dijckkaai
649,Ernest Van Dijckkaai,2023-01-03,09:00:00,143,88,55,FMN 01 Ernest Van Dijckkaai
649,Ernest Van Dijckkaai,2023-01-03,10:00:00,120,75,45,FMN 01 Ernest Van Dijckkaai
649,Ernest Van Dijckkaai,2023-01-03,11:00:00,126,65,61,FMN 01 Ernest Van Dijckkaai
649,Ernest Van Dijckkaai,2023-01-03,12:00:00,180,98,82,FMN 01 Ernest Van Dijckkaai
649,Ernest Van Dijckkaai,2023-01-03,13:00:00,184,109,75,FMN 01 Ernest Van Dijckkaai
649,Ernest Van Dijckkaai,2023-01-03,14:00:00,273,137,136,FMN 01 Ernest Van Dijckkaai
649,Ernest Van Dijckkaai,2023-01-03,15:00:00,285,124,161,FMN 01 Ernest Van Dijckkaai
649,Ernest Van Dijckkaai,2023-01-03,16:00:00,370,163,207,FMN 01 Ernest Van Dijckkaai
649,Ernest Van Dijckkaai,2023-01-03,17:00:00,440,201,239,FMN 01 Ernest Van Dijckkaai
649,Ernest Van Dijckkaai,2023-01-03,18:00:00,273,131,142,FMN 01 Ernest Van Dijckkaai
649,Ernest Van Dijckkaai,2023-01-03,19:00:00,161,92,69,FMN 01 Ernest Van Dijckkaai
649,Ernest Van Dijckkaai,2023-01-03,20:00:00,102,62,40,FMN 01 Ernest Van Dijckkaai
649,Ernest Van Dijckkaai,2023-01-03,21:00:00,104,48,56,FMN 01 Ernest Van Dijckkaai
649,Ernest Van Dijckkaai,2023-01-03,22:00:00,84,32,52,FMN 01 Ernest Van Dijckkaai
649,Ernest Van Dijckkaai,2023-01-03,23:00:00,46,13,33,FMN 01 Ernest Van Dijckkaai
649,Ernest Van Dijckkaai,2023-01-04,00:00:00,28,10,18,FMN 01 Ernest Van Dijckkaai
649,Ernest Van Dijckkaai,2023-01-04,01:00:00,8,3,5,FMN 01 Ernest Van Dijckkaai
649,Ernest Van Dijckkaai,2023-01-04,02:00:00,6,2,4,FMN 01 Ernest Van Dijckkaai
649,Ernest Van Dijckkaai,2023-01-04,03:00:00,4,2,2,FMN 01 Ernest Van Dijckkaai
649,Ernest Van Dijckkaai,2023-01-04,04:00:00,43,36,7,FMN 01 Ernest Van Dijckkaai
649,Ernest Van Dijckkaai,2023-01-04,05:00:00,66,45,21,FMN 01 Ernest Van Dijckkaai
649,Ernest Van Dijckkaai,2023-01-04,06:00:00,156,97,59,FMN 01 Ernest Van Dijckkaai
649,Ernest Van Dijckkaai,2023-01-04,07:00:00,210,149,61,FMN 01 Ernest Van Dijckkaai
649,Ernest Van Dijckkaai,2023-01-04,08:00:00,246,154,92,FMN 01 Ernest Van Dijckkaai
649,Ernest Van Dijckkaai,2023-01-04,09:00:00,121,65,56,FMN 01 Ernest Van Dijckkaai
649,Ernest Van Dijckkaai,2023-01-04,10:00:00,75,45,30,FMN 01 Ernest Van Dijckkaai
649,Ernest Van Dijckkaai,2023-01-04,11:00:00,82,40,42,FMN 01 Ernest Van Dijckkaai
649,Ernest Van Dijckkaai,2023-01-04,12:00:00,127,74,53,FMN 01 Ernest Van Dijckkaai
649,Ernest Van Dijckkaai,2023-01-04,13:00:00,119,67,52,FMN 01 Ernest Van Dijckkaai
649,Ernest Van Dijckkaai,2023-01-04,14:00:00,140,49,91,FMN 01 Ernest Van Dijckkaai
649,Ernest Van Dijckkaai,2023-01-04,15:00:00,175,88,87,FMN 01 Ernest Van Dijckkaai
649,Ernest Van Dijckkaai,2023-01-04,16:00:00,256,114,142,FMN 01 Ernest Van Dijckkaai
649,Ernest Van Dijckkaai,2023-01-04,17:00:00,330,137,193,FMN 01 Ernest Van Dijckkaai
649,Ernest Van Dijckkaai,2023-01-04,18:00:00,216,123,93,FMN 01 Ernest Van Dijckkaai
649,Ernest Van Dijckkaai,2023-01-04,19:00:00,127,60,67,FMN 01 Ernest Van Dijckkaai
649,Ernest Van Dijckkaai,2023-01-04,20:00:00,115,56,59,FMN 01 Ernest Van Dijckkaai
649,Ernest Van Dijckkaai,2023-01-04,21:00:00,73,29,44,FMN 01 Ernest Van Dijckkaai
649,Ernest Van Dijckkaai,2023-01-04,22:00:00,95,34,61,FMN 01 Ernest Van Dijckkaai
649,Ernest Van Dijckkaai,2023-01-04,23:00:00,47,20,27,FMN 01 Ernest Van Dijckkaai
649,Ernest Van Dijckkaai,2023-01-05,00:00:00,34,6,28,FMN 01 Ernest Van Dijckkaai
649,Ernest Van Dijckkaai,2023-01-05,01:00:00,2,0,2,FMN 01 Ernest Van Dijckkaai
649,Ernest Van Dijckkaai,2023-01-05,02:00:00,7,1,6,FMN 01 Ernest Van Dijckkaai
649,Ernest Van Dijckkaai,2023-01-05,03:00:00,3,2,1,FMN 01 Ernest Van Dijckkaai
649,Ernest Van Dijckkaai,2023-01-05,04:00:00,49,38,11,FMN 01 Ernest Van Dijckkaai
649,Ernest Van Dijckkaai,2023-01-05,05:00:00,67,39,28,FMN 01 Ernest Van Dijckkaai
649,Ernest Van Dijckkaai,2023-01-05,06:00:00,171,109,62,FMN 01 Ernest Van Dijckkaai
649,Ernest Van Dijckkaai,2023-01-05,07:00:00,238,153,85,FMN 01 Ernest Van Dijckkaai
649,Ernest Van Dijckkaai,2023-01-05,08:00:00,301,169,132,FMN 01 Ernest Van Dijckkaai
649,Ernest Van Dijckkaai,2023-01-05,09:00:00,180,116,64,FMN 01 Ernest Van Dijckkaai
649,Ernest Van Dijckkaai,2023-01-05,10:00:00,140,74,66,FMN 01 Ernest Van Dijckkaai
649,Ernest Van Dijckkaai,2023-01-05,11:00:00,167,100,67,FMN 01 Ernest Van Dijckkaai
649,Ernest Van Dijckkaai,2023-01-05,12:00:00,207,118,89,FMN 01 Ernest Van Dijckkaai
649,Ernest Van Dijckkaai,2023-01-05,13:00:00,205,120,85,FMN 01 Ernest Van Dijckkaai
649,Ernest Van Dijckkaai,2023-01-05,14:00:00,224,94,130,FMN 01 Ernest Van Dijckkaai
649,Ernest Van Dijckkaai,2023-01-05,15:00:00,231,106,125,FMN 01 Ernest Van Dijckkaai
649,Ernest Van Dijckkaai,2023-01-05,16:00:00,367,158,209,FMN 01 Ernest Van Dijckkaai
649,Ernest Van Dijckkaai,2023-01-05,17:00:00,415,180,235,FMN 01 Ernest Van Dijckkaai
649,Ernest Van Dijckkaai,2023-01-05,18:00:00,266,151,115,FMN 01 Ernest Van Dijckkaai
649,Ernest Van Dijckkaai,2023-01-05,19:00:00,169,98,71,FMN 01 Ernest Van Dijckkaai
649,Ernest Van Dijckkaai,2023-01-05,20:00:00,108,51,57,FMN 01 Ernest Van Dijckkaai
649,Ernest Van Dijckkaai,2023-01-05,21:00:00,113,52,61,FMN 01 Ernest Van Dijckkaai
649,Ernest Van Dijckkaai,2023-01-05,22:00:00,110,37,73,FMN 01 Ernest Van Dijckkaai
649,Ernest Van Dijckkaai,2023-01-05,23:00:00,57,14,43,FMN 01 Ernest Van Dijckkaai
649,Ernest Van Dijckkaai,2023-01-06,00:00:00,30,16,14,FMN 01 Ernest Van Dijckkaai
649,Ernest Van Dijckkaai,2023-01-06,01:00:00,13,3,10,FMN 01 Ernest Van Dijckkaai
649,Ernest Van Dijckkaai,2023-01-06,02:00:00,11,2,9,FMN 01 Ernest Van Dijckkaai
649,Ernest Van Dijckkaai,2023-01-06,03:00:00,16,1,15,FMN 01 Ernest Van Dijckkaai
649,Ernest Van Dijckkaai,2023-01-06,04:00:00,60,40,20,FMN 01 Ernest Van Dijckkaai
649,Ernest Van Dijckkaai,2023-01-06,05:00:00,64,42,22,FMN 01 Ernest Van Dijckkaai
649,Ernest Van Dijckkaai,2023-01-06,06:00:00,149,89,60,FMN 01 Ernest Van Dijckkaai
649,Ernest Van Dijckkaai,2023-01-06,07:00:00,184,118,66,FMN 01 Ernest Van Dijckkaai
649,Ernest Van Dijckkaai,2023-01-06,08:00:00,218,144,74,FMN 01 Ernest Van Dijckkaai
649,Ernest Van Dijckkaai,2023-01-06,09:00:00,154,104,50,FMN 01 Ernest Van Dijckkaai
649,Ernest Van Dijckkaai,2023-01-06,10:00:00,103,60,43,FMN 01 Ernest Van Dijckkaai
649,Ernest Van Dijckkaai,2023-01-06,11:00:00,169,91,78,FMN 01 Ernest Van Dijckkaai
649,Ernest Van Dijckkaai,2023-01-06,12:00:00,209,106,103,FMN 01 Ernest Van Dijckkaai
649,Ernest Van Dijckkaai,2023-01-06,13:00:00,204,127,77,FMN 01 Ernest Van Dijckkaai
649,Ernest Van Dijckkaai,2023-01-06,14:00:00,273,133,140,FMN 01 Ernest Van Dijckkaai
649,Ernest Van Dijckkaai,2023-01-06,15:00:00,268,134,134,FMN 01 Ernest Van Dijckkaai
649,Ernest Van Dijckkaai,2023-01-06,16:00:00,371,150,221,FMN 01 Ernest Van Dijckkaai
649,Ernest Van Dijckkaai,2023-01-06,17:00:00,334,160,174,FMN 01 Ernest Van Dijckkaai
649,Ernest Van Dijckkaai,2023-01-06,18:00:00,210,102,108,FMN 01 Ernest Van Dijckkaai
649,Ernest Van Dijckkaai,2023-01-06,19:00:00,174,104,70,FMN 01 Ernest Van Dijckkaai
649,Ernest Van Dijckkaai,2023-01-06,20:00:00,105,47,58,FMN 01 Ernest Van Dijckkaai
649,Ernest Van Dijckkaai,2023-01-06,21:00:00,102,53,49,FMN 01 Ernest Van Dijckkaai
649,Ernest Van Dijckkaai,2023-01-06,22:00:00,111,39,72,FMN 01 Ernest Van Dijckkaai
649,Ernest Van Dijckkaai,2023-01-06,23:00:00,87,35,52,FMN 01 Ernest Van Dijckkaai
649,Ernest Van Dijckkaai,2023-01-07,00:00:00,80,31,49,FMN 01 Ernest Van Dijckkaai
649,Ernest Van Dijckkaai,2023-01-07,01:00:00,78,31,47,FMN 01 Ernest Van Dijckkaai
649,Ernest Van Dijckkaai,2023-01-07,02:00:00,36,19,17,FMN 01 Ernest Van Dijckkaai
649,Ernest Van Dijckkaai,2023-01-07,03:00:00,50,25,25,FMN 01 Ernest Van Dijckkaai
649,Ernest Van Dijckkaai,2023-01-07,04:00:00,42,29,13,FMN 01 Ernest Van Dijckkaai
649,Ernest Van Dijckkaai,2023-01-07,05:00:00,31,20,11,FMN 01 Ernest Van Dijckkaai
649,Ernest Van Dijckkaai,2023-01-07,06:00:00,32,13,19,FMN 01 Ernest Van Dijckkaai
649,Ernest Van Dijckkaai,2023-01-07,07:00:00,24,14,10,FMN 01 Ernest Van Dijckkaai
649,Ernest Van Dijckkaai,2023-01-07,08:00:00,41,25,16,FMN 01 Ernest Van Dijckkaai
649,Ernest Van Dijckkaai,2023-01-07,09:00:00,75,39,36,FMN 01 Ernest Van Dijckkaai
649,Ernest Van Dijckkaai,2023-01-07,10:00:00,120,68,52,FMN 01 Ernest Van Dijckkaai
649,Ernest Van Dijckkaai,2023-01-07,11:00:00,160,89,71,FMN 01 Ernest Van Dijckkaai
649,Ernest Van Dijckkaai,2023-01-07,12:00:00,231,130,101,FMN 01 Ernest Van Dijckkaai
649,Ernest Van Dijckkaai,2023-01-07,13:00:00,262,153,109,FMN 01 Ernest Van Dijckkaai
649,Ernest Van Dijckkaai,2023-01-07,14:00:00,298,180,118,FMN 01 Ernest Van Dijckkaai
649,Ernest Van Dijckkaai,2023-01-07,15:00:00,257,160,97,FMN 01 Ernest Van Dijckkaai
649,Ernest Van Dijckkaai,2023-01-07,16:00:00,196,82,114,FMN 01 Ernest Van Dijckkaai
649,Ernest Van Dijckkaai,2023-01-07,17:00:00,128,72,56,FMN 01 Ernest Van Dijckkaai
649,Ernest Van Dijckkaai,2023-01-07,18:00:00,152,82,70,FMN 01 Ernest Van Dijckkaai
649,Ernest Van Dijckkaai,2023-01-07,19:00:00,120,62,58,FMN 01 Ernest Van Dijckkaai
649,Ernest Van Dijckkaai,2023-01-07,20:00:00,92,40,52,FMN 01 Ernest Van Dijckkaai
649,Ernest Van Dijckkaai,2023-01-07,21:00:00,67,39,28,FMN 01 Ernest Van Dijckkaai
649,Ernest Van Dijckkaai,2023-01-07,22:00:00,78,37,41,FMN 01 Ernest Van Dijckkaai
649,Ernest Van Dijckkaai,2023-01-07,23:00:00,83,35,48,FMN 01 Ernest Van Dijckkaai
649,Ernest Van Dijckkaai,2023-01-08,00:00:00,58,23,35,FMN 01 Ernest Van Dijckkaai
649,Ernest Van Dijckkaai,2023-01-08,01:00:00,45,12,33,FMN 01 Ernest Van Dijckkaai
649,Ernest Van Dijckkaai,2023-01-08,02:00:00,47,19,28,FMN 01 Ernest Van Dijckkaai
649,Ernest Van Dijckkaai,2023-01-08,03:00:00,31,12,19,FMN 01 Ernest Van Dijckkaai
649,Ernest Van Dijckkaai,2023-01-08,04:00:00,22,13,9,FMN 01 Ernest Van Dijckkaai
649,Ernest Van Dijckkaai,2023-01-08,05:00:00,12,6,6,FMN 01 Ernest Van Dijckkaai
649,Ernest Van Dijckkaai,2023-01-08,06:00:00,27,16,11,FMN 01 Ernest Van Dijckkaai
649,Ernest Van Dijckkaai,2023-01-08,07:00:00,29,18,11,FMN 01 Ernest Van Dijckkaai
649,Ernest Van Dijckkaai,2023-01-08,08:00:00,26,13,13,FMN 01 Ernest Van Dijckkaai
649,Ernest Van Dijckkaai,2023-01-08,09:00:00,79,42,37,FMN 01 Ernest Van Dijckkaai
649,Ernest Van Dijckkaai,2023-01-08,10:00:00,91,47,44,FMN 01 Ernest Van Dijckkaai
649,Ernest Van Dijckkaai,2023-01-08,11:00:00,172,102,70,FMN 01 Ernest Van Dijckkaai
649,Ernest Van Dijckkaai,2023-01-08,12:00:00,224,122,102,FMN 01 Ernest Van Dijckkaai
649,Ernest Van Dijckkaai,2023-01-08,13:00:00,251,150,101,FMN 01 Ernest Van Dijckkaai
649,Ernest Van Dijckkaai,2023-01-08,14:00:00,307,189,118,FMN 01 Ernest Van Dijckkaai
649,Ernest Van Dijckkaai,2023-01-08,15:00:00,279,146,133,FMN 01 Ernest Van Dijckkaai
649,Ernest Van Dijckkaai,2023-01-08,16:00:00,246,117,129,FMN 01 Ernest Van Dijckkaai
649,Ernest Van Dijckkaai,2023-01-08,17:00:00,165,63,102,FMN 01 Ernest Van Dijckkaai
649,Ernest Van Dijckkaai,2023-01-08,18:00:00,137,62,75,FMN 01 Ernest Van Dijckkaai
649,Ernest Van Dijckkaai,2023-01-08,19:00:00,90,51,39,FMN 01 Ernest Van Dijckkaai
649,Ernest Van Dijckkaai,2023-01-08,20:00:00,77,31,46,FMN 01 Ernest Van Dijckkaai
649,Ernest Van Dijckkaai,2023-01-08,21:00:00,61,24,37,FMN 01 Ernest Van Dijckkaai
649,Ernest Van Dijckkaai,2023-01-08,22:00:00,37,12,25,FMN 01 Ernest Van Dijckkaai
649,Ernest Van Dijckkaai,2023-01-08,23:00:00,24,8,16,FMN 01 Ernest Van Dijckkaai
649,Ernest Van Dijckkaai,2023-01-09,00:00:00,11,6,5,FMN 01 Ernest Van Dijckkaai
649,Ernest Van Dijckkaai,2023-01-09,01:00:00,7,5,2,FMN 01 Ernest Van Dijckkaai
649,Ernest Van Dijckkaai,2023-01-09,02:00:00,4,2,2,FMN 01 Ernest Van Dijckkaai
649,Ernest Van Dijckkaai,2023-01-09,03:00:00,4,3,1,FMN 01 Ernest Van Dijckkaai
649,Ernest Van Dijckkaai,2023-01-09,04:00:00,45,29,16,FMN 01 Ernest Van Dijckkaai
649,Ernest Van Dijckkaai,2023-01-09,05:00:00,90,58,32,FMN 01 Ernest Van Dijckkaai
649,Ernest Van Dijckkaai,2023-01-09,06:00:00,190,134,56,FMN 01 Ernest Van Dijckkaai
649,Ernest Van Dijckkaai,2023-01-09,07:00:00,340,226,114,FMN 01 Ernest Van Dijckkaai
649,Ernest Van Dijckkaai,2023-01-09,08:00:00,480,298,182,FMN 01 Ernest Van Dijckkaai
649,Ernest Van Dijckkaai,2023-01-09,09:00:00,171,110,61,FMN 01 Ernest Van Dijckkaai
649,Ernest Van Dijckkaai,2023-01-09,10:00:00,98,58,40,FMN 01 Ernest Van Dijckkaai
649,Ernest Van Dijckkaai,2023-01-09,11:00:00,124,67,57,FMN 01 Ernest Van Dijckkaai
649,Ernest Van Dijckkaai,2023-01-09,12:00:00,173,104,69,FMN 01 Ernest Van Dijckkaai
649,Ernest Van Dijckkaai,2023-01-09,13:00:00,183,118,65,FMN 01 Ernest Van Dijckkaai
649,Ernest Van Dijckkaai,2023-01-09,14:00:00,177,90,87,FMN 01 Ernest Van Dijckkaai
649,Ernest Van Dijckkaai,2023-01-09,15:00:00,231,113,118,FMN 01 Ernest Van Dijckkaai
649,Ernest Van Dijckkaai,2023-01-09,16:00:00,429,157,272,FMN 01 Ernest Van Dijckkaai
649,Ernest Van Dijckkaai,2023-01-09,17:00:00,486,178,308,FMN 01 Ernest Van Dijckkaai
649,Ernest Van Dijckkaai,2023-01-09,18:00:00,236,118,118,FMN 01 Ernest Van Dijckkaai
649,Ernest Van Dijckkaai,2023-01-09,19:00:00,131,69,62,FMN 01 Ernest Van Dijckkaai
649,Ernest Van Dijckkaai,2023-01-09,20:00:00,80,38,42,FMN 01 Ernest Van Dijckkaai
649,Ernest Van Dijckkaai,2023-01-09,21:00:00,79,35,44,FMN 01 Ernest Van Dijckkaai
649,Ernest Van Dijckkaai,2023-01-09,22:00:00,87,25,62,FMN 01 Ernest Van Dijckkaai
649,Ernest Van Dijckkaai,2023-01-09,23:00:00,31,11,20,FMN 01 Ernest Van Dijckkaai
649,Ernest Van Dijckkaai,2023-01-10,00:00:00,10,5,5,FMN 01 Ernest Van Dijckkaai
649,Ernest Van Dijckkaai,2023-01-10,01:00:00,11,2,9,FMN 01 Ernest Van Dijckkaai
649,Ernest Van Dijckkaai,2023-01-10,02:00:00,5,3,2,FMN 01 Ernest Van Dijckkaai
649,Ernest Van Dijckkaai,2023-01-10,03:00:00,6,4,2,FMN 01 Ernest Van Dijckkaai
649,Ernest Van Dijckkaai,2023-01-10,04:00:00,44,31,13,FMN 01 Ernest Van Dijckkaai
649,Ernest Van Dijckkaai,2023-01-10,05:00:00,81,54,27,FMN 01 Ernest Van Dijckkaai
649,Ernest Van Dijckkaai,2023-01-10,06:00:00,227,149,78,FMN 01 Ernest Van Dijckkaai
649,Ernest Van Dijckkaai,2023-01-10,07:00:00,382,236,146,FMN 01 Ernest Van Dijckkaai
649,Ernest Van Dijckkaai,2023-01-10,08:00:00,521,330,191,FMN 01 Ernest Van Dijckkaai
649,Ernest Van Dijckkaai,2023-01-10,09:00:00,219,137,82,FMN 01 Ernest Van Dijckkaai
649,Ernest Van Dijckkaai,2023-01-10,10:00:00,122,73,49,FMN 01 Ernest Van Dijckkaai
649,Ernest Van Dijckkaai,2023-01-10,11:00:00,204,110,94,FMN 01 Ernest Van Dijckkaai
649,Ernest Van Dijckkaai,2023-01-10,12:00:00,222,131,91,FMN 01 Ernest Van Dijckkaai
649,Ernest Van Dijckkaai,2023-01-10,13:00:00,143,82,61,FMN 01 Ernest Van Dijckkaai
649,Ernest Van Dijckkaai,2023-01-10,14:00:00,161,81,80,FMN 01 Ernest Van Dijckkaai
649,Ernest Van Dijckkaai,2023-01-10,15:00:00,178,86,92,FMN 01 Ernest Van Dijckkaai
649,Ernest Van Dijckkaai,2023-01-10,16:00:00,380,147,233,FMN 01 Ernest Van Dijckkaai
649,Ernest Van Dijckkaai,2023-01-10,17:00:00,473,204,269,FMN 01 Ernest Van Dijckkaai
649,Ernest Van Dijckkaai,2023-01-10,18:00:00,251,117,134,FMN 01 Ernest Van Dijckkaai
649,Ernest Van Dijckkaai,2023-01-10,19:00:00,125,64,61,FMN 01 Ernest Van Dijckkaai
649,Ernest Van Dijckkaai,2023-01-10,20:00:00,106,56,50,FMN 01 Ernest Van Dijckkaai
649,Ernest Van Dijckkaai,2023-01-10,21:00:00,83,41,42,FMN 01 Ernest Van Dijckkaai
649,Ernest Van Dijckkaai,2023-01-10,22:00:00,97,40,57,FMN 01 Ernest Van Dijckkaai
649,Ernest Van Dijckkaai,2023-01-10,23:00:00,39,11,28,FMN 01 Ernest Van Dijckkaai
649,Ernest Van Dijckkaai,2023-01-11,00:00:00,12,4,8,FMN 01 Ernest Van Dijckkaai
649,Ernest Van Dijckkaai,2023-01-11,01:00:00,8,7,1,FMN 01 Ernest Van Dijckkaai
649,Ernest Van Dijckkaai,2023-01-11,02:00:00,4,1,3,FMN 01 Ernest Van Dijckkaai
649,Ernest Van Dijckkaai,2023-01-11,03:00:00,6,2,4,FMN 01 Ernest Van Dijckkaai
649,Ernest Van Dijckkaai,2023-01-11,04:00:00,38,23,15,FMN 01 Ernest Van Dijckkaai
649,Ernest Van Dijckkaai,2023-01-11,05:00:00,81,58,23,FMN 01 Ernest Van Dijckkaai
649,Ernest Van Dijckkaai,2023-01-11,06:00:00,201,131,70,FMN 01 Ernest Van Dijckkaai
649,Ernest Van Dijckkaai,2023-01-11,07:00:00,336,217,119,FMN 01 Ernest Van Dijckkaai
649,Ernest Van Dijckkaai,2023-01-11,08:00:00,459,286,173,FMN 01 Ernest Van Dijckkaai
649,Ernest Van Dijckkaai,2023-01-11,09:00:00,199,120,79,FMN 01 Ernest Van Dijckkaai
649,Ernest Van Dijckkaai,2023-01-11,10:00:00,118,61,57,FMN 01 Ernest Van Dijckkaai
649,Ernest Van Dijckkaai,2023-01-11,11:00:00,157,87,70,FMN 01 Ernest Van Dijckkaai
649,Ernest Van Dijckkaai,2023-01-11,12:00:00,285,147,138,FMN 01 Ernest Van Dijckkaai
649,Ernest Van Dijckkaai,2023-01-11,13:00:00,200,115,85,FMN 01 Ernest Van Dijckkaai
649,Ernest Van Dijckkaai,2023-01-11,14:00:00,212,93,119,FMN 01 Ernest Van Dijckkaai
649,Ernest Van Dijckkaai,2023-01-11,15:00:00,238,113,125,FMN 01 Ernest Van Dijckkaai
649,Ernest Van Dijckkaai,2023-01-11,16:00:00,372,155,217,FMN 01 Ernest Van Dijckkaai
649,Ernest Van Dijckkaai,2023-01-11,17:00:00,440,185,255,FMN 01 Ernest Van Dijckkaai
649,Ernest Van Dijckkaai,2023-01-11,18:00:00,311,142,169,FMN 01 Ernest Van Dijckkaai
649,Ernest Van Dijckkaai,2023-01-11,19:00:00,136,61,75,FMN 01 Ernest Van Dijckkaai
649,Ernest Van Dijckkaai,2023-01-11,20:00:00,93,48,45,FMN 01 Ernest Van Dijckkaai
649,Ernest Van Dijckkaai,2023-01-11,21:00:00,59,34,25,FMN 01 Ernest Van Dijckkaai
649,Ernest Van Dijckkaai,2023-01-11,22:00:00,91,40,51,FMN 01 Ernest Van Dijckkaai
649,Ernest Van Dijckkaai,2023-01-11,23:00:00,50,19,31,FMN 01 Ernest Van Dijckkaai
649,Ernest Van Dijckkaai,2023-01-12,00:00:00,13,6,7,FMN 01 Ernest Van Dijckkaai
649,Ernest Van Dijckkaai,2023-01-12,01:00:00,9,1,8,FMN 01 Ernest Van Dijckkaai
649,Ernest Van Dijckkaai,2023-01-12,02:00:00,4,0,4,FMN 01 Ernest Van Dijckkaai
649,Ernest Van Dijckkaai,2023-01-12,03:00:00,3,1,2,FMN 01 Ernest Van Dijckkaai
649,Ernest Van Dijckkaai,2023-01-12,04:00:00,27,18,9,FMN 01 Ernest Van Dijckkaai
649,Ernest Van Dijckkaai,2023-01-12,05:00:00,61,41,20,FMN 01 Ernest Van Dijckkaai
649,Ernest Van Dijckkaai,2023-01-12,06:00:00,136,91,45,FMN 01 Ernest Van Dijckkaai
649,Ernest Van Dijckkaai,2023-01-12,07:00:00,224,150,74,FMN 01 Ernest Van Dijckkaai
649,Ernest Van Dijckkaai,2023-01-12,08:00:00,308,177,131,FMN 01 Ernest Van Dijckkaai
649,Ernest Van Dijckkaai,2023-01-12,09:00:00,135,80,55,FMN 01 Ernest Van Dijckkaai
649,Ernest Van Dijckkaai,2023-01-12,10:00:00,66,41,25,FMN 01 Ernest Van Dijckkaai
649,Ernest Van Dijckkaai,2023-01-12,11:00:00,72,50,22,FMN 01 Ernest Van Dijckkaai
649,Ernest Van Dijckkaai,2023-01-12,12:00:00,95,55,40,FMN 01 Ernest Van Dijckkaai
649,Ernest Van Dijckkaai,2023-01-12,13:00:00,91,52,39,FMN 01 Ernest Van Dijckkaai
649,Ernest Van Dijckkaai,2023-01-12,14:00:00,101,39,62,FMN 01 Ernest Van Dijckkaai
649,Ernest Van Dijckkaai,2023-01-12,15:00:00,131,65,66,FMN 01 Ernest Van Dijckkaai
649,Ernest Van Dijckkaai,2023-01-12,16:00:00,243,101,142,FMN 01 Ernest Van Dijckkaai
649,Ernest Van Dijckkaai,2023-01-12,17:00:00,271,106,165,FMN 01 Ernest Van Dijckkaai
649,Ernest Van Dijckkaai,2023-01-12,18:00:00,171,97,74,FMN 01 Ernest Van Dijckkaai
649,Ernest Van Dijckkaai,2023-01-12,19:00:00,88,50,38,FMN 01 Ernest Van Dijckkaai
649,Ernest Van Dijckkaai,2023-01-12,20:00:00,80,46,34,FMN 01 Ernest Van Dijckkaai
649,Ernest Van Dijckkaai,2023-01-12,21:00:00,52,26,26,FMN 01 Ernest Van Dijckkaai
649,Ernest Van Dijckkaai,2023-01-12,22:00:00,75,24,51,FMN 01 Ernest Van Dijckkaai
649,Ernest Van Dijckkaai,2023-01-12,23:00:00,35,9,26,FMN 01 Ernest Van Dijckkaai
649,Ernest Van Dijckkaai,2023-01-13,00:00:00,35,11,24,FMN 01 Ernest Van Dijckkaai
649,Ernest Van Dijckkaai,2023-01-13,01:00:00,16,7,9,FMN 01 Ernest Van Dijckkaai
649,Ernest Van Dijckkaai,2023-01-13,02:00:00,8,3,5,FMN 01 Ernest Van Dijckkaai
649,Ernest Van Dijckkaai,2023-01-13,03:00:00,8,2,6,FMN 01 Ernest Van Dijckkaai
649,Ernest Van Dijckkaai,2023-01-13,04:00:00,38,28,10,FMN 01 Ernest Van Dijckkaai
649,Ernest Van Dijckkaai,2023-01-13,05:00:00,70,44,26,FMN 01 Ernest Van Dijckkaai
649,Ernest Van Dijckkaai,2023-01-13,06:00:00,162,108,54,FMN 01 Ernest Van Dijckkaai
649,Ernest Van Dijckkaai,2023-01-13,07:00:00,288,183,105,FMN 01 Ernest Van Dijckkaai
649,Ernest Van Dijckkaai,2023-01-13,08:00:00,408,263,145,FMN 01 Ernest Van Dijckkaai
649,Ernest Van Dijckkaai,2023-01-13,09:00:00,202,137,65,FMN 01 Ernest Van Dijckkaai
649,Ernest Van Dijckkaai,2023-01-13,10:00:00,125,73,52,FMN 01 Ernest Van Dijckkaai
649,Ernest Van Dijckkaai,2023-01-13,11:00:00,128,72,56,FMN 01 Ernest Van Dijckkaai
649,Ernest Van Dijckkaai,2023-01-13,12:00:00,200,119,81,FMN 01 Ernest Van Dijckkaai
649,Ernest Van Dijckkaai,2023-01-13,13:00:00,173,101,72,FMN 01 Ernest Van Dijckkaai
649,Ernest Van Dijckkaai,2023-01-13,14:00:00,163,72,91,FMN 01 Ernest Van Dijckkaai
649,Ernest Van Dijckkaai,2023-01-13,15:00:00,253,109,144,FMN 01 Ernest Van Dijckkaai
649,Ernest Van Dijckkaai,2023-01-13,16:00:00,388,154,234,FMN 01 Ernest Van Dijckkaai
649,Ernest Van Dijckkaai,2023-01-13,17:00:00,370,194,176,FMN 01 Ernest Van Dijckkaai
649,Ernest Van Dijckkaai,2023-01-13,18:00:00,274,130,144,FMN 01 Ernest Van Dijckkaai
649,Ernest Van Dijckkaai,2023-01-13,19:00:00,150,75,75,FMN 01 Ernest Van Dijckkaai
649,Ernest Van Dijckkaai,2023-01-13,20:00:00,131,67,64,FMN 01 Ernest Van Dijckkaai
649,Ernest Van Dijckkaai,2023-01-13,21:00:00,95,43,52,FMN 01 Ernest Van Dijckkaai
649,Ernest Van Dijckkaai,2023-01-13,22:00:00,91,34,57,FMN 01 Ernest Van Dijckkaai
649,Ernest Van Dijckkaai,2023-01-13,23:00:00,73,27,46,FMN 01 Ernest Van Dijckkaai
649,Ernest Van Dijckkaai,2023-01-14,00:00:00,70,37,33,FMN 01 Ernest Van Dijckkaai
649,Ernest Van Dijckkaai,2023-01-14,01:00:00,61,31,30,FMN 01 Ernest Van Dijckkaai
649,Ernest Van Dijckkaai,2023-01-14,02:00:00,40,22,18,FMN 01 Ernest Van Dijckkaai
649,Ernest Van Dijckkaai,2023-01-14,03:00:00,48,29,19,FMN 01 Ernest Van Dijckkaai
649,Ernest Van Dijckkaai,2023-01-14,04:00:00,38,23,15,FMN 01 Ernest Van Dijckkaai
649,Ernest Van Dijckkaai,2023-01-14,05:00:00,30,15,15,FMN 01 Ernest Van Dijckkaai
649,Ernest Van Dijckkaai,2023-01-14,06:00:00,24,10,14,FMN 01 Ernest Van Dijckkaai
649,Ernest Van Dijckkaai,2023-01-14,07:00:00,18,11,7,FMN 01 Ernest Van Dijckkaai
649,Ernest Van Dijckkaai,2023-01-14,08:00:00,35,23,12,FMN 01 Ernest Van Dijckkaai
649,Ernest Van Dijckkaai,2023-01-14,09:00:00,46,23,23,FMN 01 Ernest Van Dijckkaai
649,Ernest Van Dijckkaai,2023-01-14,10:00:00,23,15,8,FMN 01 Ernest Van Dijckkaai
649,Ernest Van Dijckkaai,2023-01-14,11:00:00,42,22,20,FMN 01 Ernest Van Dijckkaai
649,Ernest Van Dijckkaai,2023-01-14,12:00:00,55,33,22,FMN 01 Ernest Van Dijckkaai
649,Ernest Van Dijckkaai,2023-01-14,13:00:00,66,42,24,FMN 01 Ernest Van Dijckkaai
649,Ernest Van Dijckkaai,2023-01-14,14:00:00,74,35,39,FMN 01 Ernest Van Dijckkaai
649,Ernest Van Dijckkaai,2023-01-14,15:00:00,77,45,32,FMN 01 Ernest Van Dijckkaai
649,Ernest Van Dijckkaai,2023-01-14,16:00:00,83,41,42,FMN 01 Ernest Van Dijckkaai
649,Ernest Van Dijckkaai,2023-01-14,17:00:00,73,42,31,FMN 01 Ernest Van Dijckkaai
649,Ernest Van Dijckkaai,2023-01-14,18:00:00,79,47,32,FMN 01 Ernest Van Dijckkaai
649,Ernest Van Dijckkaai,2023-01-14,19:00:00,77,42,35,FMN 01 Ernest Van Dijckkaai
649,Ernest Van Dijckkaai,2023-01-14,20:00:00,69,34,35,FMN 01 Ernest Van Dijckkaai
649,Ernest Van Dijckkaai,2023-01-14,21:00:00,50,22,28,FMN 01 Ernest Van Dijckkaai
649,Ernest Van Dijckkaai,2023-01-14,22:00:00,62,32,30,FMN 01 Ernest Van Dijckkaai
649,Ernest Van Dijckkaai,2023-01-14,23:00:00,58,22,36,FMN 01 Ernest Van Dijckkaai
649,Ernest Van Dijckkaai,2023-01-15,00:00:00,45,16,29,FMN 01 Ernest Van Dijckkaai
649,Ernest Van Dijckkaai,2023-01-15,01:00:00,34,14,20,FMN 01 Ernest Van Dijckkaai
649,Ernest Van Dijckkaai,2023-01-15,02:00:00,32,19,13,FMN 01 Ernest Van Dijckkaai
649,Ernest Van Dijckkaai,2023-01-15,03:00:00,15,8,7,FMN 01 Ernest Van Dijckkaai
649,Ernest Van Dijckkaai,2023-01-15,04:00:00,33,17,16,FMN 01 Ernest Van Dijckkaai
649,Ernest Van Dijckkaai,2023-01-15,05:00:00,16,9,7,FMN 01 Ernest Van Dijckkaai
649,Ernest Van Dijckkaai,2023-01-15,06:00:00,29,13,16,FMN 01 Ernest Van Dijckkaai
649,Ernest Van Dijckkaai,2023-01-15,07:00:00,18,11,7,FMN 01 Ernest Van Dijckkaai
649,Ernest Van Dijckkaai,2023-01-15,08:00:00,33,14,19,FMN 01 Ernest Van Dijckkaai
649,Ernest Van Dijckkaai,2023-01-15,09:00:00,96,53,43,FMN 01 Ernest Van Dijckkaai
649,Ernest Van Dijckkaai,2023-01-15,10:00:00,93,55,38,FMN 01 Ernest Van Dijckkaai
649,Ernest Van Dijckkaai,2023-01-15,11:00:00,150,85,65,FMN 01 Ernest Van Dijckkaai
649,Ernest Van Dijckkaai,2023-01-15,12:00:00,135,69,66,FMN 01 Ernest Van Dijckkaai
649,Ernest Van Dijckkaai,2023-01-15,13:00:00,145,97,48,FMN 01 Ernest Van Dijckkaai
649,Ernest Van Dijckkaai,2023-01-15,14:00:00,133,85,48,FMN 01 Ernest Van Dijckkaai
649,Ernest Van Dijckkaai,2023-01-15,15:00:00,109,58,51,FMN 01 Ernest Van Dijckkaai
649,Ernest Van Dijckkaai,2023-01-15,16:00:00,104,52,52,FMN 01 Ernest Van Dijckkaai
649,Ernest Van Dijckkaai,2023-01-15,17:00:00,86,48,38,FMN 01 Ernest Van Dijckkaai
649,Ernest Van Dijckkaai,2023-01-15,18:00:00,86,52,34,FMN 01 Ernest Van Dijckkaai
649,Ernest Van Dijckkaai,2023-01-15,19:00:00,56,36,20,FMN 01 Ernest Van Dijckkaai
649,Ernest Van Dijckkaai,2023-01-15,20:00:00,44,23,21,FMN 01 Ernest Van Dijckkaai
649,Ernest Van Dijckkaai,2023-01-15,21:00:00,35,16,19,FMN 01 Ernest Van Dijckkaai
649,Ernest Van Dijckkaai,2023-01-15,22:00:00,24,8,16,FMN 01 Ernest Van Dijckkaai
649,Ernest Van Dijckkaai,2023-01-15,23:00:00,20,6,14,FMN 01 Ernest Van Dijckkaai
649,Ernest Van Dijckkaai,2023-01-16,00:00:00,22,6,16,FMN 01 Ernest Van Dijckkaai
649,Ernest Van Dijckkaai,2023-01-16,01:00:00,2,1,1,FMN 01 Ernest Van Dijckkaai
649,Ernest Van Dijckkaai,2023-01-16,02:00:00,2,0,2,FMN 01 Ernest Van Dijckkaai
649,Ernest Van Dijckkaai,2023-01-16,03:00:00,4,1,3,FMN 01 Ernest Van Dijckkaai
649,Ernest Van Dijckkaai,2023-01-16,04:00:00,45,34,11,FMN 01 Ernest Van Dijckkaai
649,Ernest Van Dijckkaai,2023-01-16,05:00:00,54,34,20,FMN 01 Ernest Van Dijckkaai
649,Ernest Van Dijckkaai,2023-01-16,06:00:00,131,97,34,FMN 01 Ernest Van Dijckkaai
649,Ernest Van Dijckkaai,2023-01-16,07:00:00,250,170,80,FMN 01 Ernest Van Dijckkaai
649,Ernest Van Dijckkaai,2023-01-16,08:00:00,327,198,129,FMN 01 Ernest Van Dijckkaai
649,Ernest Van Dijckkaai,2023-01-16,09:00:00,152,94,58,FMN 01 Ernest Van Dijckkaai
649,Ernest Van Dijckkaai,2023-01-16,10:00:00,77,57,20,FMN 01 Ernest Van Dijckkaai
649,Ernest Van Dijckkaai,2023-01-16,11:00:00,76,41,35,FMN 01 Ernest Van Dijckkaai
649,Ernest Van Dijckkaai,2023-01-16,12:00:00,121,72,49,FMN 01 Ernest Van Dijckkaai
649,Ernest Van Dijckkaai,2023-01-16,13:00:00,100,51,49,FMN 01 Ernest Van Dijckkaai
649,Ernest Van Dijckkaai,2023-01-16,14:00:00,141,65,76,FMN 01 Ernest Van Dijckkaai
649,Ernest Van Dijckkaai,2023-01-16,15:00:00,173,83,90,FMN 01 Ernest Van Dijckkaai
649,Ernest Van Dijckkaai,2023-01-16,16:00:00,265,86,179,FMN 01 Ernest Van Dijckkaai
649,Ernest Van Dijckkaai,2023-01-16,17:00:00,300,132,168,FMN 01 Ernest Van Dijckkaai
649,Ernest Van Dijckkaai,2023-01-16,18:00:00,186,91,95,FMN 01 Ernest Van Dijckkaai
649,Ernest Van Dijckkaai,2023-01-16,19:00:00,81,40,41,FMN 01 Ernest Van Dijckkaai
649,Ernest Van Dijckkaai,2023-01-16,20:00:00,51,22,29,FMN 01 Ernest Van Dijckkaai
649,Ernest Van Dijckkaai,2023-01-16,21:00:00,53,21,32,FMN 01 Ernest Van Dijckkaai
649,Ernest Van Dijckkaai,2023-01-16,22:00:00,54,20,34,FMN 01 Ernest Van Dijckkaai
649,Ernest Van Dijckkaai,2023-01-16,23:00:00,19,10,9,FMN 01 Ernest Van Dijckkaai
649,Ernest Van Dijckkaai,2023-01-17,00:00:00,10,3,7,FMN 01 Ernest Van Dijckkaai
649,Ernest Van Dijckkaai,2023-01-17,01:00:00,2,1,1,FMN 01 Ernest Van Dijckkaai
649,Ernest Van Dijckkaai,2023-01-17,02:00:00,2,1,1,FMN 01 Ernest Van Dijckkaai
649,Ernest Van Dijckkaai,2023-01-17,03:00:00,4,0,4,FMN 01 Ernest Van Dijckkaai
649,Ernest Van Dijckkaai,2023-01-17,04:00:00,50,37,13,FMN 01 Ernest Van Dijckkaai
649,Ernest Van Dijckkaai,2023-01-17,05:00:00,72,50,22,FMN 01 Ernest Van Dijckkaai
649,Ernest Van Dijckkaai,2023-01-17,06:00:00,174,124,50,FMN 01 Ernest Van Dijckkaai
649,Ernest Van Dijckkaai,2023-01-17,07:00:00,275,185,90,FMN 01 Ernest Van Dijckkaai
649,Ernest Van Dijckkaai,2023-01-17,08:00:00,393,255,138,FMN 01 Ernest Van Dijckkaai
649,Ernest Van Dijckkaai,2023-01-17,09:00:00,197,123,74,FMN 01 Ernest Van Dijckkaai
649,Ernest Van Dijckkaai,2023-01-17,10:00:00,99,70,29,FMN 01 Ernest Van Dijckkaai
649,Ernest Van Dijckkaai,2023-01-17,11:00:00,108,58,50,FMN 01 Ernest Van Dijckkaai
649,Ernest Van Dijckkaai,2023-01-17,12:00:00,197,117,80,FMN 01 Ernest Van Dijckkaai
649,Ernest Van Dijckkaai,2023-01-17,13:00:00,170,94,76,FMN 01 Ernest Van Dijckkaai
649,Ernest Van Dijckkaai,2023-01-17,14:00:00,188,81,107,FMN 01 Ernest Van Dijckkaai
649,Ernest Van Dijckkaai,2023-01-17,15:00:00,254,128,126,FMN 01 Ernest Van Dijckkaai
649,Ernest Van Dijckkaai,2023-01-17,16:00:00,434,171,263,FMN 01 Ernest Van Dijckkaai
649,Ernest Van Dijckkaai,2023-01-17,17:00:00,420,181,239,FMN 01 Ernest Van Dijckkaai
649,Ernest Van Dijckkaai,2023-01-17,18:00:00,260,133,127,FMN 01 Ernest Van Dijckkaai
649,Ernest Van Dijckkaai,2023-01-17,19:00:00,133,72,61,FMN 01 Ernest Van Dijckkaai
649,Ernest Van Dijckkaai,2023-01-17,20:00:00,89,34,55,FMN 01 Ernest Van Dijckkaai
649,Ernest Van Dijckkaai,2023-01-17,21:00:00,67,34,33,FMN 01 Ernest Van Dijckkaai
649,Ernest Van Dijckkaai,2023-01-17,22:00:00,96,43,53,FMN 01 Ernest Van Dijckkaai
649,Ernest Van Dijckkaai,2023-01-17,23:00:00,43,27,16,FMN 01 Ernest Van Dijckkaai
649,Ernest Van Dijckkaai,2023-01-18,00:00:00,21,12,9,FMN 01 Ernest Van Dijckkaai
649,Ernest Van Dijckkaai,2023-01-18,01:00:00,8,5,3,FMN 01 Ernest Van Dijckkaai
649,Ernest Van Dijckkaai,2023-01-18,02:00:00,4,1,3,FMN 01 Ernest Van Dijckkaai
649,Ernest Van Dijckkaai,2023-01-18,03:00:00,4,1,3,FMN 01 Ernest Van Dijckkaai
649,Ernest Van Dijckkaai,2023-01-18,04:00:00,45,37,8,FMN 01 Ernest Van Dijckkaai
649,Ernest Van Dijckkaai,2023-01-18,05:00:00,59,41,18,FMN 01 Ernest Van Dijckkaai
649,Ernest Van Dijckkaai,2023-01-18,06:00:00,135,95,40,FMN 01 Ernest Van Dijckkaai
649,Ernest Van Dijckkaai,2023-01-18,07:00:00,277,212,65,FMN 01 Ernest Van Dijckkaai
649,Ernest Van Dijckkaai,2023-01-18,08:00:00,312,212,100,FMN 01 Ernest Van Dijckkaai
649,Ernest Van Dijckkaai,2023-01-18,09:00:00,133,80,53,FMN 01 Ernest Van Dijckkaai
649,Ernest Van Dijckkaai,2023-01-18,10:00:00,82,57,25,FMN 01 Ernest Van Dijckkaai
649,Ernest Van Dijckkaai,2023-01-18,11:00:00,98,63,35,FMN 01 Ernest Van Dijckkaai
649,Ernest Van Dijckkaai,2023-01-18,12:00:00,196,122,74,FMN 01 Ernest Van Dijckkaai
649,Ernest Van Dijckkaai,2023-01-18,13:00:00,192,117,75,FMN 01 Ernest Van Dijckkaai
649,Ernest Van Dijckkaai,2023-01-18,14:00:00,207,103,104,FMN 01 Ernest Van Dijckkaai
649,Ernest Van Dijckkaai,2023-01-18,15:00:00,183,97,86,FMN 01 Ernest Van Dijckkaai
649,Ernest Van Dijckkaai,2023-01-18,16:00:00,364,144,220,FMN 01 Ernest Van Dijckkaai
649,Ernest Van Dijckkaai,2023-01-18,17:00:00,408,162,246,FMN 01 Ernest Van Dijckkaai
649,Ernest Van Dijckkaai,2023-01-18,18:00:00,220,112,108,FMN 01 Ernest Van Dijckkaai
649,Ernest Van Dijckkaai,2023-01-18,19:00:00,140,64,76,FMN 01 Ernest Van Dijckkaai
649,Ernest Van Dijckkaai,2023-01-18,20:00:00,71,27,44,FMN 01 Ernest Van Dijckkaai
649,Ernest Van Dijckkaai,2023-01-18,21:00:00,57,25,32,FMN 01 Ernest Van Dijckkaai
649,Ernest Van Dijckkaai,2023-01-18,22:00:00,93,34,59,FMN 01 Ernest Van Dijckkaai
649,Ernest Van Dijckkaai,2023-01-18,23:00:00,62,32,30,FMN 01 Ernest Van Dijckkaai
649,Ernest Van Dijckkaai,2023-01-19,00:00:00,20,9,11,FMN 01 Ernest Van Dijckkaai
649,Ernest Van Dijckkaai,2023-01-19,01:00:00,10,5,5,FMN 01 Ernest Van Dijckkaai
649,Ernest Van Dijckkaai,2023-01-19,02:00:00,1,0,1,FMN 01 Ernest Van Dijckkaai
649,Ernest Van Dijckkaai,2023-01-19,03:00:00,7,2,5,FMN 01 Ernest Van Dijckkaai
649,Ernest Van Dijckkaai,2023-01-19,04:00:00,40,27,13,FMN 01 Ernest Van Dijckkaai
649,Ernest Van Dijckkaai,2023-01-19,05:00:00,64,50,14,FMN 01 Ernest Van Dijckkaai
649,Ernest Van Dijckkaai,2023-01-19,06:00:00,146,96,50,FMN 01 Ernest Van Dijckkaai
649,Ernest Van Dijckkaai,2023-01-19,07:00:00,247,170,77,FMN 01 Ernest Van Dijckkaai
649,Ernest Van Dijckkaai,2023-01-19,08:00:00,370,226,144,FMN 01 Ernest Van Dijckkaai
649,Ernest Van Dijckkaai,2023-01-19,09:00:00,169,107,62,FMN 01 Ernest Van Dijckkaai
649,Ernest Van Dijckkaai,2023-01-19,10:00:00,85,56,29,FMN 01 Ernest Van Dijckkaai
649,Ernest Van Dijckkaai,2023-01-19,11:00:00,89,59,30,FMN 01 Ernest Van Dijckkaai
649,Ernest Van Dijckkaai,2023-01-19,12:00:00,131,76,55,FMN 01 Ernest Van Dijckkaai
649,Ernest Van Dijckkaai,2023-01-19,13:00:00,147,93,54,FMN 01 Ernest Van Dijckkaai
649,Ernest Van Dijckkaai,2023-01-19,14:00:00,154,86,68,FMN 01 Ernest Van Dijckkaai
649,Ernest Van Dijckkaai,2023-01-19,15:00:00,199,101,98,FMN 01 Ernest Van Dijckkaai
649,Ernest Van Dijckkaai,2023-01-19,16:00:00,373,172,201,FMN 01 Ernest Van Dijckkaai
649,Ernest Van Dijckkaai,2023-01-19,17:00:00,394,165,229,FMN 01 Ernest Van Dijckkaai
649,Ernest Van Dijckkaai,2023-01-19,18:00:00,252,132,120,FMN 01 Ernest Van Dijckkaai
649,Ernest Van Dijckkaai,2023-01-19,19:00:00,130,68,62,FMN 01 Ernest Van Dijckkaai
649,Ernest Van Dijckkaai,2023-01-19,20:00:00,91,46,45,FMN 01 Ernest Van Dijckkaai
649,Ernest Van Dijckkaai,2023-01-19,21:00:00,64,22,42,FMN 01 Ernest Van Dijckkaai
649,Ernest Van Dijckkaai,2023-01-19,22:00:00,79,27,52,FMN 01 Ernest Van Dijckkaai
649,Ernest Van Dijckkaai,2023-01-19,23:00:00,45,19,26,FMN 01 Ernest Van Dijckkaai
649,Ernest Van Dijckkaai,2023-01-20,00:00:00,28,15,13,FMN 01 Ernest Van Dijckkaai
649,Ernest Van Dijckkaai,2023-01-20,01:00:00,12,5,7,FMN 01 Ernest Van Dijckkaai
649,Ernest Van Dijckkaai,2023-01-20,02:00:00,7,2,5,FMN 01 Ernest Van Dijckkaai
649,Ernest Van Dijckkaai,2023-01-20,03:00:00,4,1,3,FMN 01 Ernest Van Dijckkaai
649,Ernest Van Dijckkaai,2023-01-20,04:00:00,35,28,7,FMN 01 Ernest Van Dijckkaai
649,Ernest Van Dijckkaai,2023-01-20,05:00:00,63,43,20,FMN 01 Ernest Van Dijckkaai
649,Ernest Van Dijckkaai,2023-01-20,06:00:00,102,76,26,FMN 01 Ernest Van Dijckkaai
649,Ernest Van Dijckkaai,2023-01-20,07:00:00,171,120,51,FMN 01 Ernest Van Dijckkaai
649,Ernest Van Dijckkaai,2023-01-20,08:00:00,242,159,83,FMN 01 Ernest Van Dijckkaai
649,Ernest Van Dijckkaai,2023-01-20,09:00:00,110,70,40,FMN 01 Ernest Van Dijckkaai
649,Ernest Van Dijckkaai,2023-01-20,10:00:00,67,39,28,FMN 01 Ernest Van Dijckkaai
649,Ernest Van Dijckkaai,2023-01-20,11:00:00,67,39,28,FMN 01 Ernest Van Dijckkaai
649,Ernest Van Dijckkaai,2023-01-20,12:00:00,80,46,34,FMN 01 Ernest Van Dijckkaai
649,Ernest Van Dijckkaai,2023-01-20,13:00:00,78,37,41,FMN 01 Ernest Van Dijckkaai
649,Ernest Van Dijckkaai,2023-01-20,14:00:00,104,48,56,FMN 01 Ernest Van Dijckkaai
649,Ernest Van Dijckkaai,2023-01-20,15:00:00,140,69,71,FMN 01 Ernest Van Dijckkaai
649,Ernest Van Dijckkaai,2023-01-20,16:00:00,200,94,106,FMN 01 Ernest Van Dijckkaai
649,Ernest Van Dijckkaai,2023-01-20,17:00:00,228,100,128,FMN 01 Ernest Van Dijckkaai
649,Ernest Van Dijckkaai,2023-01-20,18:00:00,163,79,84,FMN 01 Ernest Van Dijckkaai
649,Ernest Van Dijckkaai,2023-01-20,19:00:00,99,60,39,FMN 01 Ernest Van Dijckkaai
649,Ernest Van Dijckkaai,2023-01-20,20:00:00,72,46,26,FMN 01 Ernest Van Dijckkaai
649,Ernest Van Dijckkaai,2023-01-20,21:00:00,54,22,32,FMN 01 Ernest Van Dijckkaai
649,Ernest Van Dijckkaai,2023-01-20,22:00:00,69,21,48,FMN 01 Ernest Van Dijckkaai
649,Ernest Van Dijckkaai,2023-01-20,23:00:00,55,21,34,FMN 01 Ernest Van Dijckkaai
649,Ernest Van Dijckkaai,2023-01-21,00:00:00,34,15,19,FMN 01 Ernest Van Dijckkaai
649,Ernest Van Dijckkaai,2023-01-21,01:00:00,28,12,16,FMN 01 Ernest Van Dijckkaai
649,Ernest Van Dijckkaai,2023-01-21,02:00:00,16,3,13,FMN 01 Ernest Van Dijckkaai
649,Ernest Van Dijckkaai,2023-01-21,03:00:00,17,5,12,FMN 01 Ernest Van Dijckkaai
649,Ernest Van Dijckkaai,2023-01-21,04:00:00,20,9,11,FMN 01 Ernest Van Dijckkaai
649,Ernest Van Dijckkaai,2023-01-21,05:00:00,16,8,8,FMN 01 Ernest Van Dijckkaai
649,Ernest Van Dijckkaai,2023-01-21,06:00:00,20,7,13,FMN 01 Ernest Van Dijckkaai
649,Ernest Van Dijckkaai,2023-01-21,07:00:00,14,10,4,FMN 01 Ernest Van Dijckkaai
649,Ernest Van Dijckkaai,2023-01-21,08:00:00,20,14,6,FMN 01 Ernest Van Dijckkaai
649,Ernest Van Dijckkaai,2023-01-21,09:00:00,35,19,16,FMN 01 Ernest Van Dijckkaai
649,Ernest Van Dijckkaai,2023-01-21,10:00:00,60,43,17,FMN 01 Ernest Van Dijckkaai
649,Ernest Van Dijckkaai,2023-01-21,11:00:00,104,57,47,FMN 01 Ernest Van Dijckkaai
649,Ernest Van Dijckkaai,2023-01-21,12:00:00,79,46,33,FMN 01 Ernest Van Dijckkaai
649,Ernest Van Dijckkaai,2023-01-21,13:00:00,126,78,48,FMN 01 Ernest Van Dijckkaai
649,Ernest Van Dijckkaai,2023-01-21,14:00:00,118,70,48,FMN 01 Ernest Van Dijckkaai
649,Ernest Van Dijckkaai,2023-01-21,15:00:00,146,81,65,FMN 01 Ernest Van Dijckkaai
649,Ernest Van Dijckkaai,2023-01-21,16:00:00,154,84,70,FMN 01 Ernest Van Dijckkaai
649,Ernest Van Dijckkaai,2023-01-21,17:00:00,137,70,67,FMN 01 Ernest Van Dijckkaai
649,Ernest Van Dijckkaai,2023-01-21,18:00:00,136,69,67,FMN 01 Ernest Van Dijckkaai
649,Ernest Van Dijckkaai,2023-01-21,19:00:00,86,48,38,FMN 01 Ernest Van Dijckkaai
649,Ernest Van Dijckkaai,2023-01-21,20:00:00,54,32,22,FMN 01 Ernest Van Dijckkaai
649,Ernest Van Dijckkaai,2023-01-21,21:00:00,54,25,29,FMN 01 Ernest Van Dijckkaai
649,Ernest Van Dijckkaai,2023-01-21,22:00:00,44,11,33,FMN 01 Ernest Van Dijckkaai
649,Ernest Van Dijckkaai,2023-01-21,23:00:00,42,17,25,FMN 01 Ernest Van Dijckkaai
649,Ernest Van Dijckkaai,2023-01-22,00:00:00,36,18,18,FMN 01 Ernest Van Dijckkaai
649,Ernest Van Dijckkaai,2023-01-22,01:00:00,19,7,12,FMN 01 Ernest Van Dijckkaai
649,Ernest Van Dijckkaai,2023-01-22,02:00:00,12,8,4,FMN 01 Ernest Van Dijckkaai
649,Ernest Van Dijckkaai,2023-01-22,03:00:00,19,6,13,FMN 01 Ernest Van Dijckkaai
649,Ernest Van Dijckkaai,2023-01-22,04:00:00,15,1,14,FMN 01 Ernest Van Dijckkaai
649,Ernest Van Dijckkaai,2023-01-22,05:00:00,14,8,6,FMN 01 Ernest Van Dijckkaai
649,Ernest Van Dijckkaai,2023-01-22,06:00:00,19,8,11,FMN 01 Ernest Van Dijckkaai
649,Ernest Van Dijckkaai,2023-01-22,07:00:00,14,5,9,FMN 01 Ernest Van Dijckkaai
649,Ernest Van Dijckkaai,2023-01-22,08:00:00,32,20,12,FMN 01 Ernest Van Dijckkaai
649,Ernest Van Dijckkaai,2023-01-22,09:00:00,36,22,14,FMN 01 Ernest Van Dijckkaai
649,Ernest Van Dijckkaai,2023-01-22,10:00:00,54,31,23,FMN 01 Ernest Van Dijckkaai
649,Ernest Van Dijckkaai,2023-01-22,11:00:00,85,45,40,FMN 01 Ernest Van Dijckkaai
649,Ernest Van Dijckkaai,2023-01-22,12:00:00,87,50,37,FMN 01 Ernest Van Dijckkaai
649,Ernest Van Dijckkaai,2023-01-22,13:00:00,99,62,37,FMN 01 Ernest Van Dijckkaai
649,Ernest Van Dijckkaai,2023-01-22,14:00:00,119,56,63,FMN 01 Ernest Van Dijckkaai
649,Ernest Van Dijckkaai,2023-01-22,15:00:00,96,44,52,FMN 01 Ernest Van Dijckkaai
649,Ernest Van Dijckkaai,2023-01-22,16:00:00,95,47,48,FMN 01 Ernest Van Dijckkaai
649,Ernest Van Dijckkaai,2023-01-22,17:00:00,70,31,39,FMN 01 Ernest Van Dijckkaai
649,Ernest Van Dijckkaai,2023-01-22,18:00:00,78,37,41,FMN 01 Ernest Van Dijckkaai
649,Ernest Van Dijckkaai,2023-01-22,19:00:00,53,35,18,FMN 01 Ernest Van Dijckkaai
649,Ernest Van Dijckkaai,2023-01-22,20:00:00,39,18,21,FMN 01 Ernest Van Dijckkaai
649,Ernest Van Dijckkaai,2023-01-22,21:00:00,39,20,19,FMN 01 Ernest Van Dijckkaai
649,Ernest Van Dijckkaai,2023-01-22,22:00:00,32,12,20,FMN 01 Ernest Van Dijckkaai
649,Ernest Van Dijckkaai,2023-01-22,23:00:00,29,13,16,FMN 01 Ernest Van Dijckkaai
649,Ernest Van Dijckkaai,2023-01-23,00:00:00,10,2,8,FMN 01 Ernest Van Dijckkaai
649,Ernest Van Dijckkaai,2023-01-23,01:00:00,8,4,4,FMN 01 Ernest Van Dijckkaai
649,Ernest Van Dijckkaai,2023-01-23,02:00:00,4,3,1,FMN 01 Ernest Van Dijckkaai
649,Ernest Van Dijckkaai,2023-01-23,03:00:00,6,4,2,FMN 01 Ernest Van Dijckkaai
649,Ernest Van Dijckkaai,2023-01-23,04:00:00,35,23,12,FMN 01 Ernest Van Dijckkaai
649,Ernest Van Dijckkaai,2023-01-23,05:00:00,73,56,17,FMN 01 Ernest Van Dijckkaai
649,Ernest Van Dijckkaai,2023-01-23,06:00:00,170,127,43,FMN 01 Ernest Van Dijckkaai
649,Ernest Van Dijckkaai,2023-01-23,07:00:00,328,222,106,FMN 01 Ernest Van Dijckkaai
649,Ernest Van Dijckkaai,2023-01-23,08:00:00,443,296,147,FMN 01 Ernest Van Dijckkaai
649,Ernest Van Dijckkaai,2023-01-23,09:00:00,165,114,51,FMN 01 Ernest Van Dijckkaai
649,Ernest Van Dijckkaai,2023-01-23,10:00:00,81,40,41,FMN 01 Ernest Van Dijckkaai
649,Ernest Van Dijckkaai,2023-01-23,11:00:00,94,53,41,FMN 01 Ernest Van Dijckkaai
649,Ernest Van Dijckkaai,2023-01-23,12:00:00,153,93,60,FMN 01 Ernest Van Dijckkaai
649,Ernest Van Dijckkaai,2023-01-23,13:00:00,148,87,61,FMN 01 Ernest Van Dijckkaai
649,Ernest Van Dijckkaai,2023-01-23,14:00:00,170,81,89,FMN 01 Ernest Van Dijckkaai
649,Ernest Van Dijckkaai,2023-01-23,15:00:00,204,97,107,FMN 01 Ernest Van Dijckkaai
649,Ernest Van Dijckkaai,2023-01-23,16:00:00,378,150,228,FMN 01 Ernest Van Dijckkaai
649,Ernest Van Dijckkaai,2023-01-23,17:00:00,440,187,253,FMN 01 Ernest Van Dijckkaai
649,Ernest Van Dijckkaai,2023-01-23,18:00:00,254,128,126,FMN 01 Ernest Van Dijckkaai
649,Ernest Van Dijckkaai,2023-01-23,19:00:00,92,41,51,FMN 01 Ernest Van Dijckkaai
649,Ernest Van Dijckkaai,2023-01-23,20:00:00,85,40,45,FMN 01 Ernest Van Dijckkaai
649,Ernest Van Dijckkaai,2023-01-23,21:00:00,65,31,34,FMN 01 Ernest Van Dijckkaai
649,Ernest Van Dijckkaai,2023-01-23,22:00:00,89,30,59,FMN 01 Ernest Van Dijckkaai
649,Ernest Van Dijckkaai,2023-01-23,23:00:00,34,15,19,FMN 01 Ernest Van Dijckkaai
649,Ernest Van Dijckkaai,2023-01-24,00:00:00,6,3,3,FMN 01 Ernest Van Dijckkaai
649,Ernest Van Dijckkaai,2023-01-24,01:00:00,5,2,3,FMN 01 Ernest Van Dijckkaai
649,Ernest Van Dijckkaai,2023-01-24,02:00:00,2,1,1,FMN 01 Ernest Van Dijckkaai
649,Ernest Van Dijckkaai,2023-01-24,03:00:00,7,2,5,FMN 01 Ernest Van Dijckkaai
649,Ernest Van Dijckkaai,2023-01-24,04:00:00,45,32,13,FMN 01 Ernest Van Dijckkaai
649,Ernest Van Dijckkaai,2023-01-24,05:00:00,98,71,27,FMN 01 Ernest Van Dijckkaai
649,Ernest Van Dijckkaai,2023-01-24,06:00:00,212,151,61,FMN 01 Ernest Van Dijckkaai
649,Ernest Van Dijckkaai,2023-01-24,07:00:00,364,253,111,FMN 01 Ernest Van Dijckkaai
649,Ernest Van Dijckkaai,2023-01-24,08:00:00,482,306,176,FMN 01 Ernest Van Dijckkaai
649,Ernest Van Dijckkaai,2023-01-24,09:00:00,220,146,74,FMN 01 Ernest Van Dijckkaai
649,Ernest Van Dijckkaai,2023-01-24,10:00:00,118,73,45,FMN 01 Ernest Van Dijckkaai
649,Ernest Van Dijckkaai,2023-01-24,11:00:00,99,64,35,FMN 01 Ernest Van Dijckkaai
649,Ernest Van Dijckkaai,2023-01-24,12:00:00,169,103,66,FMN 01 Ernest Van Dijckkaai
649,Ernest Van Dijckkaai,2023-01-24,13:00:00,150,84,66,FMN 01 Ernest Van Dijckkaai
649,Ernest Van Dijckkaai,2023-01-24,14:00:00,184,103,81,FMN 01 Ernest Van Dijckkaai
649,Ernest Van Dijckkaai,2023-01-24,15:00:00,239,124,115,FMN 01 Ernest Van Dijckkaai
649,Ernest Van Dijckkaai,2023-01-24,16:00:00,389,168,221,FMN 01 Ernest Van Dijckkaai
649,Ernest Van Dijckkaai,2023-01-24,17:00:00,468,191,277,FMN 01 Ernest Van Dijckkaai
649,Ernest Van Dijckkaai,2023-01-24,18:00:00,330,158,172,FMN 01 Ernest Van Dijckkaai
649,Ernest Van Dijckkaai,2023-01-24,19:00:00,130,62,68,FMN 01 Ernest Van Dijckkaai
649,Ernest Van Dijckkaai,2023-01-24,20:00:00,105,60,45,FMN 01 Ernest Van Dijckkaai
649,Ernest Van Dijckkaai,2023-01-24,21:00:00,66,26,40,FMN 01 Ernest Van Dijckkaai
649,Ernest Van Dijckkaai,2023-01-24,22:00:00,86,36,50,FMN 01 Ernest Van Dijckkaai
649,Ernest Van Dijckkaai,2023-01-24,23:00:00,44,18,26,FMN 01 Ernest Van Dijckkaai
649,Ernest Van Dijckkaai,2023-01-25,00:00:00,14,8,6,FMN 01 Ernest Van Dijckkaai
649,Ernest Van Dijckkaai,2023-01-25,01:00:00,9,6,3,FMN 01 Ernest Van Dijckkaai
649,Ernest Van Dijckkaai,2023-01-25,02:00:00,3,1,2,FMN 01 Ernest Van Dijckkaai
649,Ernest Van Dijckkaai,2023-01-25,03:00:00,10,1,9,FMN 01 Ernest Van Dijckkaai
649,Ernest Van Dijckkaai,2023-01-25,04:00:00,44,27,17,FMN 01 Ernest Van Dijckkaai
649,Ernest Van Dijckkaai,2023-01-25,05:00:00,89,66,23,FMN 01 Ernest Van Dijckkaai
649,Ernest Van Dijckkaai,2023-01-25,06:00:00,187,128,59,FMN 01 Ernest Van Dijckkaai
649,Ernest Van Dijckkaai,2023-01-25,07:00:00,336,232,104,FMN 01 Ernest Van Dijckkaai
649,Ernest Van Dijckkaai,2023-01-25,08:00:00,417,274,143,FMN 01 Ernest Van Dijckkaai
649,Ernest Van Dijckkaai,2023-01-25,09:00:00,167,100,67,FMN 01 Ernest Van Dijckkaai
649,Ernest Van Dijckkaai,2023-01-25,10:00:00,131,99,32,FMN 01 Ernest Van Dijckkaai
649,Ernest Van Dijckkaai,2023-01-25,11:00:00,123,63,60,FMN 01 Ernest Van Dijckkaai
649,Ernest Van Dijckkaai,2023-01-25,12:00:00,207,129,78,FMN 01 Ernest Van Dijckkaai
649,Ernest Van Dijckkaai,2023-01-25,13:00:00,169,97,72,FMN 01 Ernest Van Dijckkaai
649,Ernest Van Dijckkaai,2023-01-25,14:00:00,167,75,92,FMN 01 Ernest Van Dijckkaai
649,Ernest Van Dijckkaai,2023-01-25,15:00:00,179,91,88,FMN 01 Ernest Van Dijckkaai
649,Ernest Van Dijckkaai,2023-01-25,16:00:00,339,138,201,FMN 01 Ernest Van Dijckkaai
649,Ernest Van Dijckkaai,2023-01-25,17:00:00,444,184,260,FMN 01 Ernest Van Dijckkaai
649,Ernest Van Dijckkaai,2023-01-25,18:00:00,248,120,128,FMN 01 Ernest Van Dijckkaai
649,Ernest Van Dijckkaai,2023-01-25,19:00:00,122,68,54,FMN 01 Ernest Van Dijckkaai
649,Ernest Van Dijckkaai,2023-01-25,20:00:00,85,41,44,FMN 01 Ernest Van Dijckkaai
649,Ernest Van Dijckkaai,2023-01-25,21:00:00,61,25,36,FMN 01 Ernest Van Dijckkaai
649,Ernest Van Dijckkaai,2023-01-25,22:00:00,67,23,44,FMN 01 Ernest Van Dijckkaai
649,Ernest Van Dijckkaai,2023-01-25,23:00:00,39,19,20,FMN 01 Ernest Van Dijckkaai
649,Ernest Van Dijckkaai,2023-01-26,00:00:00,17,6,11,FMN 01 Ernest Van Dijckkaai
649,Ernest Van Dijckkaai,2023-01-26,01:00:00,8,2,6,FMN 01 Ernest Van Dijckkaai
649,Ernest Van Dijckkaai,2023-01-26,02:00:00,1,1,0,FMN 01 Ernest Van Dijckkaai
649,Ernest Van Dijckkaai,2023-01-26,03:00:00,13,8,5,FMN 01 Ernest Van Dijckkaai
649,Ernest Van Dijckkaai,2023-01-26,04:00:00,40,23,17,FMN 01 Ernest Van Dijckkaai
649,Ernest Van Dijckkaai,2023-01-26,05:00:00,65,43,22,FMN 01 Ernest Van Dijckkaai
649,Ernest Van Dijckkaai,2023-01-26,06:00:00,151,105,46,FMN 01 Ernest Van Dijckkaai
649,Ernest Van Dijckkaai,2023-01-26,07:00:00,267,182,85,FMN 01 Ernest Van Dijckkaai
649,Ernest Van Dijckkaai,2023-01-26,08:00:00,387,247,140,FMN 01 Ernest Van Dijckkaai
649,Ernest Van Dijckkaai,2023-01-26,09:00:00,165,106,59,FMN 01 Ernest Van Dijckkaai
649,Ernest Van Dijckkaai,2023-01-26,10:00:00,103,66,37,FMN 01 Ernest Van Dijckkaai
649,Ernest Van Dijckkaai,2023-01-26,11:00:00,128,78,50,FMN 01 Ernest Van Dijckkaai
649,Ernest Van Dijckkaai,2023-01-26,12:00:00,155,88,67,FMN 01 Ernest Van Dijckkaai
649,Ernest Van Dijckkaai,2023-01-26,13:00:00,183,117,66,FMN 01 Ernest Van Dijckkaai
649,Ernest Van Dijckkaai,2023-01-26,14:00:00,182,91,91,FMN 01 Ernest Van Dijckkaai
649,Ernest Van Dijckkaai,2023-01-26,15:00:00,232,121,111,FMN 01 Ernest Van Dijckkaai
649,Ernest Van Dijckkaai,2023-01-26,16:00:00,377,165,212,FMN 01 Ernest Van Dijckkaai
649,Ernest Van Dijckkaai,2023-01-26,17:00:00,436,200,236,FMN 01 Ernest Van Dijckkaai
649,Ernest Van Dijckkaai,2023-01-26,18:00:00,298,171,127,FMN 01 Ernest Van Dijckkaai
649,Ernest Van Dijckkaai,2023-01-26,19:00:00,118,66,52,FMN 01 Ernest Van Dijckkaai
649,Ernest Van Dijckkaai,2023-01-26,20:00:00,116,57,59,FMN 01 Ernest Van Dijckkaai
649,Ernest Van Dijckkaai,2023-01-26,21:00:00,101,41,60,FMN 01 Ernest Van Dijckkaai
649,Ernest Van Dijckkaai,2023-01-26,22:00:00,106,41,65,FMN 01 Ernest Van Dijckkaai
649,Ernest Van Dijckkaai,2023-01-26,23:00:00,48,32,16,FMN 01 Ernest Van Dijckkaai
649,Ernest Van Dijckkaai,2023-01-27,00:00:00,42,15,27,FMN 01 Ernest Van Dijckkaai
649,Ernest Van Dijckkaai,2023-01-27,01:00:00,20,8,12,FMN 01 Ernest Van Dijckkaai
649,Ernest Van Dijckkaai,2023-01-27,02:00:00,15,3,12,FMN 01 Ernest Van Dijckkaai
649,Ernest Van Dijckkaai,2023-01-27,03:00:00,21,5,16,FMN 01 Ernest Van Dijckkaai
649,Ernest Van Dijckkaai,2023-01-27,04:00:00,56,26,30,FMN 01 Ernest Van Dijckkaai
649,Ernest Van Dijckkaai,2023-01-27,05:00:00,96,55,41,FMN 01 Ernest Van Dijckkaai
649,Ernest Van Dijckkaai,2023-01-27,06:00:00,159,102,57,FMN 01 Ernest Van Dijckkaai
649,Ernest Van Dijckkaai,2023-01-27,07:00:00,286,186,100,FMN 01 Ernest Van Dijckkaai
649,Ernest Van Dijckkaai,2023-01-27,08:00:00,356,239,117,FMN 01 Ernest Van Dijckkaai
649,Ernest Van Dijckkaai,2023-01-27,09:00:00,198,127,71,FMN 01 Ernest Van Dijckkaai
649,Ernest Van Dijckkaai,2023-01-27,10:00:00,158,99,59,FMN 01 Ernest Van Dijckkaai
649,Ernest Van Dijckkaai,2023-01-27,11:00:00,139,81,58,FMN 01 Ernest Van Dijckkaai
649,Ernest Van Dijckkaai,2023-01-27,12:00:00,231,129,102,FMN 01 Ernest Van Dijckkaai
649,Ernest Van Dijckkaai,2023-01-27,13:00:00,152,85,67,FMN 01 Ernest Van Dijckkaai
649,Ernest Van Dijckkaai,2023-01-27,14:00:00,237,108,129,FMN 01 Ernest Van Dijckkaai
649,Ernest Van Dijckkaai,2023-01-27,15:00:00,260,124,136,FMN 01 Ernest Van Dijckkaai
649,Ernest Van Dijckkaai,2023-01-27,16:00:00,400,173,227,FMN 01 Ernest Van Dijckkaai
649,Ernest Van Dijckkaai,2023-01-27,17:00:00,356,200,156,FMN 01 Ernest Van Dijckkaai
649,Ernest Van Dijckkaai,2023-01-27,18:00:00,274,138,136,FMN 01 Ernest Van Dijckkaai
649,Ernest Van Dijckkaai,2023-01-27,19:00:00,168,97,71,FMN 01 Ernest Van Dijckkaai
649,Ernest Van Dijckkaai,2023-01-27,20:00:00,114,81,33,FMN 01 Ernest Van Dijckkaai
649,Ernest Van Dijckkaai,2023-01-27,21:00:00,85,42,43,FMN 01 Ernest Van Dijckkaai
649,Ernest Van Dijckkaai,2023-01-27,22:00:00,126,53,73,FMN 01 Ernest Van Dijckkaai
649,Ernest Van Dijckkaai,2023-01-27,23:00:00,93,31,62,FMN 01 Ernest Van Dijckkaai
649,Ernest Van Dijckkaai,2023-01-28,00:00:00,75,37,38,FMN 01 Ernest Van Dijckkaai
649,Ernest Van Dijckkaai,2023-01-28,01:00:00,62,23,39,FMN 01 Ernest Van Dijckkaai
649,Ernest Van Dijckkaai,2023-01-28,02:00:00,34,9,25,FMN 01 Ernest Van Dijckkaai
649,Ernest Van Dijckkaai,2023-01-28,03:00:00,46,11,35,FMN 01 Ernest Van Dijckkaai
649,Ernest Van Dijckkaai,2023-01-28,04:00:00,30,9,21,FMN 01 Ernest Van Dijckkaai
649,Ernest Van Dijckkaai,2023-01-28,05:00:00,37,13,24,FMN 01 Ernest Van Dijckkaai
649,Ernest Van Dijckkaai,2023-01-28,06:00:00,39,14,25,FMN 01 Ernest Van Dijckkaai
649,Ernest Van Dijckkaai,2023-01-28,07:00:00,29,10,19,FMN 01 Ernest Van Dijckkaai
649,Ernest Van Dijckkaai,2023-01-28,08:00:00,53,35,18,FMN 01 Ernest Van Dijckkaai
649,Ernest Van Dijckkaai,2023-01-28,09:00:00,91,49,42,FMN 01 Ernest Van Dijckkaai
649,Ernest Van Dijckkaai,2023-01-28,10:00:00,116,83,33,FMN 01 Ernest Van Dijckkaai
649,Ernest Van Dijckkaai,2023-01-28,11:00:00,122,64,58,FMN 01 Ernest Van Dijckkaai
649,Ernest Van Dijckkaai,2023-01-28,12:00:00,131,59,72,FMN 01 Ernest Van Dijckkaai
649,Ernest Van Dijckkaai,2023-01-28,13:00:00,177,105,72,FMN 01 Ernest Van Dijckkaai
649,Ernest Van Dijckkaai,2023-01-28,14:00:00,218,129,89,FMN 01 Ernest Van Dijckkaai
649,Ernest Van Dijckkaai,2023-01-28,15:00:00,237,112,125,FMN 01 Ernest Van Dijckkaai
649,Ernest Van Dijckkaai,2023-01-28,16:00:00,209,103,106,FMN 01 Ernest Van Dijckkaai
649,Ernest Van Dijckkaai,2023-01-28,17:00:00,213,107,106,FMN 01 Ernest Van Dijckkaai
649,Ernest Van Dijckkaai,2023-01-28,18:00:00,158,96,62,FMN 01 Ernest Van Dijckkaai
649,Ernest Van Dijckkaai,2023-01-28,19:00:00,121,61,60,FMN 01 Ernest Van Dijckkaai
649,Ernest Van Dijckkaai,2023-01-28,20:00:00,98,58,40,FMN 01 Ernest Van Dijckkaai
649,Ernest Van Dijckkaai,2023-01-28,21:00:00,64,39,25,FMN 01 Ernest Van Dijckkaai
649,Ernest Van Dijckkaai,2023-01-28,22:00:00,62,19,43,FMN 01 Ernest Van Dijckkaai
649,Ernest Van Dijckkaai,2023-01-28,23:00:00,65,29,36,FMN 01 Ernest Van Dijckkaai
649,Ernest Van Dijckkaai,2023-01-29,00:00:00,64,36,28,FMN 01 Ernest Van Dijckkaai
649,Ernest Van Dijckkaai,2023-01-29,01:00:00,35,14,21,FMN 01 Ernest Van Dijckkaai
649,Ernest Van Dijckkaai,2023-01-29,02:00:00,31,16,15,FMN 01 Ernest Van Dijckkaai
649,Ernest Van Dijckkaai,2023-01-29,03:00:00,25,5,20,FMN 01 Ernest Van Dijckkaai
649,Ernest Van Dijckkaai,2023-01-29,04:00:00,20,4,16,FMN 01 Ernest Van Dijckkaai
649,Ernest Van Dijckkaai,2023-01-29,05:00:00,21,9,12,FMN 01 Ernest Van Dijckkaai
649,Ernest Van Dijckkaai,2023-01-29,06:00:00,29,18,11,FMN 01 Ernest Van Dijckkaai
649,Ernest Van Dijckkaai,2023-01-29,07:00:00,15,8,7,FMN 01 Ernest Van Dijckkaai
649,Ernest Van Dijckkaai,2023-01-29,08:00:00,32,14,18,FMN 01 Ernest Van Dijckkaai
649,Ernest Van Dijckkaai,2023-01-29,09:00:00,57,31,26,FMN 01 Ernest Van Dijckkaai
649,Ernest Van Dijckkaai,2023-01-29,10:00:00,79,40,39,FMN 01 Ernest Van Dijckkaai
649,Ernest Van Dijckkaai,2023-01-29,11:00:00,94,57,37,FMN 01 Ernest Van Dijckkaai
649,Ernest Van Dijckkaai,2023-01-29,12:00:00,115,69,46,FMN 01 Ernest Van Dijckkaai
649,Ernest Van Dijckkaai,2023-01-29,13:00:00,160,106,54,FMN 01 Ernest Van Dijckkaai
649,Ernest Van Dijckkaai,2023-01-29,14:00:00,139,67,72,FMN 01 Ernest Van Dijckkaai
649,Ernest Van Dijckkaai,2023-01-29,15:00:00,138,78,60,FMN 01 Ernest Van Dijckkaai
649,Ernest Van Dijckkaai,2023-01-29,16:00:00,134,71,63,FMN 01 Ernest Van Dijckkaai
649,Ernest Van Dijckkaai,2023-01-29,17:00:00,116,60,56,FMN 01 Ernest Van Dijckkaai
649,Ernest Van Dijckkaai,2023-01-29,18:00:00,81,45,36,FMN 01 Ernest Van Dijckkaai
649,Ernest Van Dijckkaai,2023-01-29,19:00:00,49,29,20,FMN 01 Ernest Van Dijckkaai
649,Ernest Van Dijckkaai,2023-01-29,20:00:00,58,32,26,FMN 01 Ernest Van Dijckkaai
649,Ernest Van Dijckkaai,2023-01-29,21:00:00,43,18,25,FMN 01 Ernest Van Dijckkaai
649,Ernest Van Dijckkaai,2023-01-29,22:00:00,39,14,25,FMN 01 Ernest Van Dijckkaai
649,Ernest Van Dijckkaai,2023-01-29,23:00:00,25,8,17,FMN 01 Ernest Van Dijckkaai
649,Ernest Van Dijckkaai,2023-01-30,00:00:00,8,5,3,FMN 01 Ernest Van Dijckkaai
649,Ernest Van Dijckkaai,2023-01-30,01:00:00,4,2,2,FMN 01 Ernest Van Dijckkaai
649,Ernest Van Dijckkaai,2023-01-30,02:00:00,2,0,2,FMN 01 Ernest Van Dijckkaai
649,Ernest Van Dijckkaai,2023-01-30,03:00:00,9,2,7,FMN 01 Ernest Van Dijckkaai
649,Ernest Van Dijckkaai,2023-01-30,04:00:00,36,22,14,FMN 01 Ernest Van Dijckkaai
649,Ernest Van Dijckkaai,2023-01-30,05:00:00,89,65,24,FMN 01 Ernest Van Dijckkaai
649,Ernest Van Dijckkaai,2023-01-30,06:00:00,206,146,60,FMN 01 Ernest Van Dijckkaai
649,Ernest Van Dijckkaai,2023-01-30,07:00:00,339,231,108,FMN 01 Ernest Van Dijckkaai
649,Ernest Van Dijckkaai,2023-01-30,08:00:00,469,282,187,FMN 01 Ernest Van Dijckkaai
649,Ernest Van Dijckkaai,2023-01-30,09:00:00,170,105,65,FMN 01 Ernest Van Dijckkaai
649,Ernest Van Dijckkaai,2023-01-30,10:00:00,91,60,31,FMN 01 Ernest Van Dijckkaai
649,Ernest Van Dijckkaai,2023-01-30,11:00:00,135,75,60,FMN 01 Ernest Van Dijckkaai
649,Ernest Van Dijckkaai,2023-01-30,12:00:00,176,84,92,FMN 01 Ernest Van Dijckkaai
649,Ernest Van Dijckkaai,2023-01-30,13:00:00,137,86,51,FMN 01 Ernest Van Dijckkaai
649,Ernest Van Dijckkaai,2023-01-30,14:00:00,190,90,100,FMN 01 Ernest Van Dijckkaai
649,Ernest Van Dijckkaai,2023-01-30,15:00:00,231,105,126,FMN 01 Ernest Van Dijckkaai
649,Ernest Van Dijckkaai,2023-01-30,16:00:00,441,162,279,FMN 01 Ernest Van Dijckkaai
649,Ernest Van Dijckkaai,2023-01-30,17:00:00,505,254,251,FMN 01 Ernest Van Dijckkaai
649,Ernest Van Dijckkaai,2023-01-30,18:00:00,282,147,135,FMN 01 Ernest Van Dijckkaai
649,Ernest Van Dijckkaai,2023-01-30,19:00:00,154,71,83,FMN 01 Ernest Van Dijckkaai
649,Ernest Van Dijckkaai,2023-01-30,20:00:00,89,47,42,FMN 01 Ernest Van Dijckkaai
649,Ernest Van Dijckkaai,2023-01-30,21:00:00,82,39,43,FMN 01 Ernest Van Dijckkaai
649,Ernest Van Dijckkaai,2023-01-30,22:00:00,80,27,53,FMN 01 Ernest Van Dijckkaai
649,Ernest Van Dijckkaai,2023-01-30,23:00:00,33,10,23,FMN 01 Ernest Van Dijckkaai
649,Ernest Van Dijckkaai,2023-01-31,00:00:00,17,8,9,FMN 01 Ernest Van Dijckkaai
649,Ernest Van Dijckkaai,2023-01-31,01:00:00,2,1,1,FMN 01 Ernest Van Dijckkaai
649,Ernest Van Dijckkaai,2023-01-31,02:00:00,4,0,4,FMN 01 Ernest Van Dijckkaai
649,Ernest Van Dijckkaai,2023-01-31,03:00:00,3,1,2,FMN 01 Ernest Van Dijckkaai
649,Ernest Van Dijckkaai,2023-01-31,04:00:00,36,23,13,FMN 01 Ernest Van Dijckkaai
649,Ernest Van Dijckkaai,2023-01-31,05:00:00,93,60,33,FMN 01 Ernest Van Dijckkaai
649,Ernest Van Dijckkaai,2023-01-31,06:00:00,209,141,68,FMN 01 Ernest Van Dijckkaai
649,Ernest Van Dijckkaai,2023-01-31,07:00:00,371,242,129,FMN 01 Ernest Van Dijckkaai
649,Ernest Van Dijckkaai,2023-01-31,08:00:00,510,323,187,FMN 01 Ernest Van Dijckkaai
649,Ernest Van Dijckkaai,2023-01-31,09:00:00,196,126,70,FMN 01 Ernest Van Dijckkaai
649,Ernest Van Dijckkaai,2023-01-31,10:00:00,88,49,39,FMN 01 Ernest Van Dijckkaai
649,Ernest Van Dijckkaai,2023-01-31,11:00:00,101,67,34,FMN 01 Ernest Van Dijckkaai
649,Ernest Van Dijckkaai,2023-01-31,12:00:00,169,99,70,FMN 01 Ernest Van Dijckkaai
649,Ernest Van Dijckkaai,2023-01-31,13:00:00,132,72,60,FMN 01 Ernest Van Dijckkaai
649,Ernest Van Dijckkaai,2023-01-31,14:00:00,173,74,99,FMN 01 Ernest Van Dijckkaai
649,Ernest Van Dijckkaai,2023-01-31,15:00:00,223,87,136,FMN 01 Ernest Van Dijckkaai
649,Ernest Van Dijckkaai,2023-01-31,16:00:00,413,171,242,FMN 01 Ernest Van Dijckkaai
649,Ernest Van Dijckkaai,2023-01-31,17:00:00,496,229,267,FMN 01 Ernest Van Dijckkaai
649,Ernest Van Dijckkaai,2023-01-31,18:00:00,299,158,141,FMN 01 Ernest Van Dijckkaai
649,Ernest Van Dijckkaai,2023-01-31,19:00:00,142,90,52,FMN 01 Ernest Van Dijckkaai
649,Ernest Van Dijckkaai,2023-01-31,20:00:00,110,54,56,FMN 01 Ernest Van Dijckkaai
649,Ernest Van Dijckkaai,2023-01-31,21:00:00,79,34,45,FMN 01 Ernest Van Dijckkaai
649,Ernest Van Dijckkaai,2023-01-31,22:00:00,92,39,53,FMN 01 Ernest Van Dijckkaai
649,Ernest Van Dijckkaai,2023-01-31,23:00:00,30,12,18,FMN 01 Ernest Van Dijckkaai
649,Ernest Van Dijckkaai,2023-02-01,00:00:00,21,12,9,FMN 01 Ernest Van Dijckkaai
649,Ernest Van Dijckkaai,2023-02-01,01:00:00,8,2,6,FMN 01 Ernest Van Dijckkaai
649,Ernest Van Dijckkaai,2023-02-01,02:00:00,5,2,3,FMN 01 Ernest Van Dijckkaai
649,Ernest Van Dijckkaai,2023-02-01,03:00:00,6,1,5,FMN 01 Ernest Van Dijckkaai
649,Ernest Van Dijckkaai,2023-02-01,04:00:00,53,31,22,FMN 01 Ernest Van Dijckkaai
649,Ernest Van Dijckkaai,2023-02-01,05:00:00,84,56,28,FMN 01 Ernest Van Dijckkaai
649,Ernest Van Dijckkaai,2023-02-01,06:00:00,213,130,83,FMN 01 Ernest Van Dijckkaai
649,Ernest Van Dijckkaai,2023-02-01,07:00:00,327,227,100,FMN 01 Ernest Van Dijckkaai
649,Ernest Van Dijckkaai,2023-02-01,08:00:00,429,276,153,FMN 01 Ernest Van Dijckkaai
649,Ernest Van Dijckkaai,2023-02-01,09:00:00,197,124,73,FMN 01 Ernest Van Dijckkaai
649,Ernest Van Dijckkaai,2023-02-01,10:00:00,101,59,42,FMN 01 Ernest Van Dijckkaai
649,Ernest Van Dijckkaai,2023-02-01,11:00:00,131,76,55,FMN 01 Ernest Van Dijckkaai
649,Ernest Van Dijckkaai,2023-02-01,12:00:00,201,117,84,FMN 01 Ernest Van Dijckkaai
649,Ernest Van Dijckkaai,2023-02-01,13:00:00,164,87,77,FMN 01 Ernest Van Dijckkaai
649,Ernest Van Dijckkaai,2023-02-01,14:00:00,203,90,113,FMN 01 Ernest Van Dijckkaai
649,Ernest Van Dijckkaai,2023-02-01,15:00:00,214,114,100,FMN 01 Ernest Van Dijckkaai
649,Ernest Van Dijckkaai,2023-02-01,16:00:00,404,150,254,FMN 01 Ernest Van Dijckkaai
649,Ernest Van Dijckkaai,2023-02-01,17:00:00,437,194,243,FMN 01 Ernest Van Dijckkaai
649,Ernest Van Dijckkaai,2023-02-01,18:00:00,282,148,134,FMN 01 Ernest Van Dijckkaai
649,Ernest Van Dijckkaai,2023-02-01,19:00:00,164,84,80,FMN 01 Ernest Van Dijckkaai
649,Ernest Van Dijckkaai,2023-02-01,20:00:00,104,46,58,FMN 01 Ernest Van Dijckkaai
649,Ernest Van Dijckkaai,2023-02-01,21:00:00,87,43,44,FMN 01 Ernest Van Dijckkaai
649,Ernest Van Dijckkaai,2023-02-01,22:00:00,93,40,53,FMN 01 Ernest Van Dijckkaai
649,Ernest Van Dijckkaai,2023-02-01,23:00:00,60,29,31,FMN 01 Ernest Van Dijckkaai
649,Ernest Van Dijckkaai,2023-02-02,00:00:00,27,13,14,FMN 01 Ernest Van Dijckkaai
649,Ernest Van Dijckkaai,2023-02-02,01:00:00,13,6,7,FMN 01 Ernest Van Dijckkaai
649,Ernest Van Dijckkaai,2023-02-02,02:00:00,7,1,6,FMN 01 Ernest Van Dijckkaai
649,Ernest Van Dijckkaai,2023-02-02,03:00:00,17,4,13,FMN 01 Ernest Van Dijckkaai
649,Ernest Van Dijckkaai,2023-02-02,04:00:00,55,31,24,FMN 01 Ernest Van Dijckkaai
649,Ernest Van Dijckkaai,2023-02-02,05:00:00,85,56,29,FMN 01 Ernest Van Dijckkaai
649,Ernest Van Dijckkaai,2023-02-02,06:00:00,203,134,69,FMN 01 Ernest Van Dijckkaai
649,Ernest Van Dijckkaai,2023-02-02,07:00:00,374,244,130,FMN 01 Ernest Van Dijckkaai
649,Ernest Van Dijckkaai,2023-02-02,08:00:00,460,275,185,FMN 01 Ernest Van Dijckkaai
649,Ernest Van Dijckkaai,2023-02-02,09:00:00,207,135,72,FMN 01 Ernest Van Dijckkaai
649,Ernest Van Dijckkaai,2023-02-02,10:00:00,98,58,40,FMN 01 Ernest Van Dijckkaai
649,Ernest Van Dijckkaai,2023-02-02,11:00:00,151,101,50,FMN 01 Ernest Van Dijckkaai
649,Ernest Van Dijckkaai,2023-02-02,12:00:00,176,95,81,FMN 01 Ernest Van Dijckkaai
649,Ernest Van Dijckkaai,2023-02-02,13:00:00,180,96,84,FMN 01 Ernest Van Dijckkaai
649,Ernest Van Dijckkaai,2023-02-02,14:00:00,196,84,112,FMN 01 Ernest Van Dijckkaai
649,Ernest Van Dijckkaai,2023-02-02,15:00:00,232,117,115,FMN 01 Ernest Van Dijckkaai
649,Ernest Van Dijckkaai,2023-02-02,16:00:00,418,173,245,FMN 01 Ernest Van Dijckkaai
649,Ernest Van Dijckkaai,2023-02-02,17:00:00,504,213,291,FMN 01 Ernest Van Dijckkaai
649,Ernest Van Dijckkaai,2023-02-02,18:00:00,331,177,154,FMN 01 Ernest Van Dijckkaai
649,Ernest Van Dijckkaai,2023-02-02,19:00:00,182,101,81,FMN 01 Ernest Van Dijckkaai
649,Ernest Van Dijckkaai,2023-02-02,20:00:00,114,58,56,FMN 01 Ernest Van Dijckkaai
649,Ernest Van Dijckkaai,2023-02-02,21:00:00,81,35,46,FMN 01 Ernest Van Dijckkaai
649,Ernest Van Dijckkaai,2023-02-02,22:00:00,114,44,70,FMN 01 Ernest Van Dijckkaai
649,Ernest Van Dijckkaai,2023-02-02,23:00:00,64,32,32,FMN 01 Ernest Van Dijckkaai
649,Ernest Van Dijckkaai,2023-02-03,00:00:00,38,16,22,FMN 01 Ernest Van Dijckkaai
649,Ernest Van Dijckkaai,2023-02-03,01:00:00,32,16,16,FMN 01 Ernest Van Dijckkaai
649,Ernest Van Dijckkaai,2023-02-03,02:00:00,15,3,12,FMN 01 Ernest Van Dijckkaai
649,Ernest Van Dijckkaai,2023-02-03,03:00:00,12,4,8,FMN 01 Ernest Van Dijckkaai
649,Ernest Van Dijckkaai,2023-02-03,04:00:00,54,26,28,FMN 01 Ernest Van Dijckkaai
649,Ernest Van Dijckkaai,2023-02-03,05:00:00,99,57,42,FMN 01 Ernest Van Dijckkaai
649,Ernest Van Dijckkaai,2023-02-03,06:00:00,216,138,78,FMN 01 Ernest Van Dijckkaai
649,Ernest Van Dijckkaai,2023-02-03,07:00:00,309,199,110,FMN 01 Ernest Van Dijckkaai
649,Ernest Van Dijckkaai,2023-02-03,08:00:00,382,242,140,FMN 01 Ernest Van Dijckkaai
649,Ernest Van Dijckkaai,2023-02-03,09:00:00,199,125,74,FMN 01 Ernest Van Dijckkaai
649,Ernest Van Dijckkaai,2023-02-03,10:00:00,128,74,54,FMN 01 Ernest Van Dijckkaai
649,Ernest Van Dijckkaai,2023-02-03,11:00:00,131,81,50,FMN 01 Ernest Van Dijckkaai
649,Ernest Van Dijckkaai,2023-02-03,12:00:00,197,119,78,FMN 01 Ernest Van Dijckkaai
649,Ernest Van Dijckkaai,2023-02-03,13:00:00,211,115,96,FMN 01 Ernest Van Dijckkaai
649,Ernest Van Dijckkaai,2023-02-03,14:00:00,228,104,124,FMN 01 Ernest Van Dijckkaai
649,Ernest Van Dijckkaai,2023-02-03,15:00:00,263,115,148,FMN 01 Ernest Van Dijckkaai
649,Ernest Van Dijckkaai,2023-02-03,16:00:00,405,178,227,FMN 01 Ernest Van Dijckkaai
649,Ernest Van Dijckkaai,2023-02-03,17:00:00,372,187,185,FMN 01 Ernest Van Dijckkaai
649,Ernest Van Dijckkaai,2023-02-03,18:00:00,269,127,142,FMN 01 Ernest Van Dijckkaai
649,Ernest Van Dijckkaai,2023-02-03,19:00:00,184,106,78,FMN 01 Ernest Van Dijckkaai
649,Ernest Van Dijckkaai,2023-02-03,20:00:00,113,54,59,FMN 01 Ernest Van Dijckkaai
649,Ernest Van Dijckkaai,2023-02-03,21:00:00,104,56,48,FMN 01 Ernest Van Dijckkaai
649,Ernest Van Dijckkaai,2023-02-03,22:00:00,114,48,66,FMN 01 Ernest Van Dijckkaai
649,Ernest Van Dijckkaai,2023-02-03,23:00:00,112,55,57,FMN 01 Ernest Van Dijckkaai
649,Ernest Van Dijckkaai,2023-02-04,00:00:00,77,22,55,FMN 01 Ernest Van Dijckkaai
649,Ernest Van Dijckkaai,2023-02-04,01:00:00,46,20,26,FMN 01 Ernest Van Dijckkaai
649,Ernest Van Dijckkaai,2023-02-04,02:00:00,46,11,35,FMN 01 Ernest Van Dijckkaai
649,Ernest Van Dijckkaai,2023-02-04,03:00:00,50,20,30,FMN 01 Ernest Van Dijckkaai
649,Ernest Van Dijckkaai,2023-02-04,04:00:00,34,10,24,FMN 01 Ernest Van Dijckkaai
649,Ernest Van Dijckkaai,2023-02-04,05:00:00,40,16,24,FMN 01 Ernest Van Dijckkaai
649,Ernest Van Dijckkaai,2023-02-04,06:00:00,38,23,15,FMN 01 Ernest Van Dijckkaai
649,Ernest Van Dijckkaai,2023-02-04,07:00:00,38,18,20,FMN 01 Ernest Van Dijckkaai
649,Ernest Van Dijckkaai,2023-02-04,08:00:00,57,34,23,FMN 01 Ernest Van Dijckkaai
649,Ernest Van Dijckkaai,2023-02-04,09:00:00,84,51,33,FMN 01 Ernest Van Dijckkaai
649,Ernest Van Dijckkaai,2023-02-04,10:00:00,77,45,32,FMN 01 Ernest Van Dijckkaai
649,Ernest Van Dijckkaai,2023-02-04,11:00:00,86,53,33,FMN 01 Ernest Van Dijckkaai
649,Ernest Van Dijckkaai,2023-02-04,12:00:00,134,66,68,FMN 01 Ernest Van Dijckkaai
649,Ernest Van Dijckkaai,2023-02-04,13:00:00,115,61,54,FMN 01 Ernest Van Dijckkaai
649,Ernest Van Dijckkaai,2023-02-04,14:00:00,174,99,75,FMN 01 Ernest Van Dijckkaai
649,Ernest Van Dijckkaai,2023-02-04,15:00:00,144,68,76,FMN 01 Ernest Van Dijckkaai
649,Ernest Van Dijckkaai,2023-02-04,16:00:00,194,87,107,FMN 01 Ernest Van Dijckkaai
649,Ernest Van Dijckkaai,2023-02-04,17:00:00,187,97,90,FMN 01 Ernest Van Dijckkaai
649,Ernest Van Dijckkaai,2023-02-04,18:00:00,165,97,68,FMN 01 Ernest Van Dijckkaai
649,Ernest Van Dijckkaai,2023-02-04,19:00:00,115,58,57,FMN 01 Ernest Van Dijckkaai
649,Ernest Van Dijckkaai,2023-02-04,20:00:00,115,50,65,FMN 01 Ernest Van Dijckkaai
649,Ernest Van Dijckkaai,2023-02-04,21:00:00,72,36,36,FMN 01 Ernest Van Dijckkaai
649,Ernest Van Dijckkaai,2023-02-04,22:00:00,107,46,61,FMN 01 Ernest Van Dijckkaai
649,Ernest Van Dijckkaai,2023-02-04,23:00:00,80,41,39,FMN 01 Ernest Van Dijckkaai
649,Ernest Van Dijckkaai,2023-02-05,00:00:00,59,26,33,FMN 01 Ernest Van Dijckkaai
649,Ernest Van Dijckkaai,2023-02-05,01:00:00,60,24,36,FMN 01 Ernest Van Dijckkaai
649,Ernest Van Dijckkaai,2023-02-05,02:00:00,30,8,22,FMN 01 Ernest Van Dijckkaai
649,Ernest Van Dijckkaai,2023-02-05,03:00:00,44,10,34,FMN 01 Ernest Van Dijckkaai
649,Ernest Van Dijckkaai,2023-02-05,04:00:00,36,9,27,FMN 01 Ernest Van Dijckkaai
649,Ernest Van Dijckkaai,2023-02-05,05:00:00,37,9,28,FMN 01 Ernest Van Dijckkaai
649,Ernest Van Dijckkaai,2023-02-05,06:00:00,17,14,3,FMN 01 Ernest Van Dijckkaai
649,Ernest Van Dijckkaai,2023-02-05,07:00:00,25,12,13,FMN 01 Ernest Van Dijckkaai
649,Ernest Van Dijckkaai,2023-02-05,08:00:00,33,23,10,FMN 01 Ernest Van Dijckkaai
649,Ernest Van Dijckkaai,2023-02-05,09:00:00,91,60,31,FMN 01 Ernest Van Dijckkaai
649,Ernest Van Dijckkaai,2023-02-05,10:00:00,112,79,33,FMN 01 Ernest Van Dijckkaai
649,Ernest Van Dijckkaai,2023-02-05,11:00:00,136,67,69,FMN 01 Ernest Van Dijckkaai
649,Ernest Van Dijckkaai,2023-02-05,12:00:00,177,83,94,FMN 01 Ernest Van Dijckkaai
649,Ernest Van Dijckkaai,2023-02-05,13:00:00,185,83,102,FMN 01 Ernest Van Dijckkaai
649,Ernest Van Dijckkaai,2023-02-05,14:00:00,223,111,112,FMN 01 Ernest Van Dijckkaai
649,Ernest Van Dijckkaai,2023-02-05,15:00:00,209,98,111,FMN 01 Ernest Van Dijckkaai
649,Ernest Van Dijckkaai,2023-02-05,16:00:00,193,106,87,FMN 01 Ernest Van Dijckkaai
649,Ernest Van Dijckkaai,2023-02-05,17:00:00,153,64,89,FMN 01 Ernest Van Dijckkaai
649,Ernest Van Dijckkaai,2023-02-05,18:00:00,126,48,78,FMN 01 Ernest Van Dijckkaai
649,Ernest Van Dijckkaai,2023-02-05,19:00:00,96,46,50,FMN 01 Ernest Van Dijckkaai
649,Ernest Van Dijckkaai,2023-02-05,20:00:00,64,32,32,FMN 01 Ernest Van Dijckkaai
649,Ernest Van Dijckkaai,2023-02-05,21:00:00,55,35,20,FMN 01 Ernest Van Dijckkaai
649,Ernest Van Dijckkaai,2023-02-05,22:00:00,50,18,32,FMN 01 Ernest Van Dijckkaai
649,Ernest Van Dijckkaai,2023-02-05,23:00:00,30,8,22,FMN 01 Ernest Van Dijckkaai
649,Ernest Van Dijckkaai,2023-02-06,00:00:00,13,6,7,FMN 01 Ernest Van Dijckkaai
649,Ernest Van Dijckkaai,2023-02-06,01:00:00,4,2,2,FMN 01 Ernest Van Dijckkaai
649,Ernest Van Dijckkaai,2023-02-06,02:00:00,4,1,3,FMN 01 Ernest Van Dijckkaai
649,Ernest Van Dijckkaai,2023-02-06,03:00:00,7,3,4,FMN 01 Ernest Van Dijckkaai
649,Ernest Van Dijckkaai,2023-02-06,04:00:00,45,29,16,FMN 01 Ernest Van Dijckkaai
649,Ernest Van Dijckkaai,2023-02-06,05:00:00,70,51,19,FMN 01 Ernest Van Dijckkaai
649,Ernest Van Dijckkaai,2023-02-06,06:00:00,212,147,65,FMN 01 Ernest Van Dijckkaai
649,Ernest Van Dijckkaai,2023-02-06,07:00:00,336,226,110,FMN 01 Ernest Van Dijckkaai
649,Ernest Van Dijckkaai,2023-02-06,08:00:00,483,306,177,FMN 01 Ernest Van Dijckkaai
649,Ernest Van Dijckkaai,2023-02-06,09:00:00,207,132,75,FMN 01 Ernest Van Dijckkaai
649,Ernest Van Dijckkaai,2023-02-06,10:00:00,133,78,55,FMN 01 Ernest Van Dijckkaai
649,Ernest Van Dijckkaai,2023-02-06,11:00:00,132,75,57,FMN 01 Ernest Van Dijckkaai
649,Ernest Van Dijckkaai,2023-02-06,12:00:00,177,111,66,FMN 01 Ernest Van Dijckkaai
649,Ernest Van Dijckkaai,2023-02-06,13:00:00,204,130,74,FMN 01 Ernest Van Dijckkaai
649,Ernest Van Dijckkaai,2023-02-06,14:00:00,256,122,134,FMN 01 Ernest Van Dijckkaai
649,Ernest Van Dijckkaai,2023-02-06,15:00:00,296,120,176,FMN 01 Ernest Van Dijckkaai
649,Ernest Van Dijckkaai,2023-02-06,16:00:00,533,225,308,FMN 01 Ernest Van Dijckkaai
649,Ernest Van Dijckkaai,2023-02-06,17:00:00,526,239,287,FMN 01 Ernest Van Dijckkaai
649,Ernest Van Dijckkaai,2023-02-06,18:00:00,283,144,139,FMN 01 Ernest Van Dijckkaai
649,Ernest Van Dijckkaai,2023-02-06,19:00:00,129,59,70,FMN 01 Ernest Van Dijckkaai
649,Ernest Van Dijckkaai,2023-02-06,20:00:00,105,51,54,FMN 01 Ernest Van Dijckkaai
649,Ernest Van Dijckkaai,2023-02-06,21:00:00,80,40,40,FMN 01 Ernest Van Dijckkaai
649,Ernest Van Dijckkaai,2023-02-06,22:00:00,108,33,75,FMN 01 Ernest Van Dijckkaai
649,Ernest Van Dijckkaai,2023-02-06,23:00:00,33,14,19,FMN 01 Ernest Van Dijckkaai
649,Ernest Van Dijckkaai,2023-02-07,00:00:00,12,4,8,FMN 01 Ernest Van Dijckkaai
649,Ernest Van Dijckkaai,2023-02-07,01:00:00,2,1,1,FMN 01 Ernest Van Dijckkaai
649,Ernest Van Dijckkaai,2023-02-07,02:00:00,7,2,5,FMN 01 Ernest Van Dijckkaai
649,Ernest Van Dijckkaai,2023-02-07,03:00:00,9,3,6,FMN 01 Ernest Van Dijckkaai
649,Ernest Van Dijckkaai,2023-02-07,04:00:00,55,36,19,FMN 01 Ernest Van Dijckkaai
649,Ernest Van Dijckkaai,2023-02-07,05:00:00,91,61,30,FMN 01 Ernest Van Dijckkaai
649,Ernest Van Dijckkaai,2023-02-07,06:00:00,213,144,69,FMN 01 Ernest Van Dijckkaai
649,Ernest Van Dijckkaai,2023-02-07,07:00:00,384,248,136,FMN 01 Ernest Van Dijckkaai
649,Ernest Van Dijckkaai,2023-02-07,08:00:00,527,342,185,FMN 01 Ernest Van Dijckkaai
649,Ernest Van Dijckkaai,2023-02-07,09:00:00,204,126,78,FMN 01 Ernest Van Dijckkaai
649,Ernest Van Dijckkaai,2023-02-07,10:00:00,127,78,49,FMN 01 Ernest Van Dijckkaai
649,Ernest Van Dijckkaai,2023-02-07,11:00:00,145,88,57,FMN 01 Ernest Van Dijckkaai
649,Ernest Van Dijckkaai,2023-02-07,12:00:00,233,148,85,FMN 01 Ernest Van Dijckkaai
649,Ernest Van Dijckkaai,2023-02-07,13:00:00,223,138,85,FMN 01 Ernest Van Dijckkaai
649,Ernest Van Dijckkaai,2023-02-07,14:00:00,273,135,138,FMN 01 Ernest Van Dijckkaai
649,Ernest Van Dijckkaai,2023-02-07,15:00:00,303,154,149,FMN 01 Ernest Van Dijckkaai
649,Ernest Van Dijckkaai,2023-02-07,16:00:00,494,187,307,FMN 01 Ernest Van Dijckkaai
649,Ernest Van Dijckkaai,2023-02-07,17:00:00,614,247,367,FMN 01 Ernest Van Dijckkaai
649,Ernest Van Dijckkaai,2023-02-07,18:00:00,318,145,173,FMN 01 Ernest Van Dijckkaai
649,Ernest Van Dijckkaai,2023-02-07,19:00:00,149,90,59,FMN 01 Ernest Van Dijckkaai
649,Ernest Van Dijckkaai,2023-02-07,20:00:00,112,46,66,FMN 01 Ernest Van Dijckkaai
649,Ernest Van Dijckkaai,2023-02-07,21:00:00,98,44,54,FMN 01 Ernest Van Dijckkaai
649,Ernest Van Dijckkaai,2023-02-07,22:00:00,123,48,75,FMN 01 Ernest Van Dijckkaai
649,Ernest Van Dijckkaai,2023-02-07,23:00:00,45,17,28,FMN 01 Ernest Van Dijckkaai
649,Ernest Van Dijckkaai,2023-02-08,00:00:00,16,6,10,FMN 01 Ernest Van Dijckkaai
649,Ernest Van Dijckkaai,2023-02-08,01:00:00,10,4,6,FMN 01 Ernest Van Dijckkaai
649,Ernest Van Dijckkaai,2023-02-08,02:00:00,4,1,3,FMN 01 Ernest Van Dijckkaai
649,Ernest Van Dijckkaai,2023-02-08,03:00:00,8,2,6,FMN 01 Ernest Van Dijckkaai
649,Ernest Van Dijckkaai,2023-02-08,04:00:00,48,30,18,FMN 01 Ernest Van Dijckkaai
649,Ernest Van Dijckkaai,2023-02-08,05:00:00,80,49,31,FMN 01 Ernest Van Dijckkaai
649,Ernest Van Dijckkaai,2023-02-08,06:00:00,187,127,60,FMN 01 Ernest Van Dijckkaai
649,Ernest Van Dijckkaai,2023-02-08,07:00:00,317,214,103,FMN 01 Ernest Van Dijckkaai
649,Ernest Van Dijckkaai,2023-02-08,08:00:00,418,281,137,FMN 01 Ernest Van Dijckkaai
649,Ernest Van Dijckkaai,2023-02-08,09:00:00,170,109,61,FMN 01 Ernest Van Dijckkaai
649,Ernest Van Dijckkaai,2023-02-08,10:00:00,111,73,38,FMN 01 Ernest Van Dijckkaai
649,Ernest Van Dijckkaai,2023-02-08,11:00:00,123,65,58,FMN 01 Ernest Van Dijckkaai
649,Ernest Van Dijckkaai,2023-02-08,12:00:00,275,176,99,FMN 01 Ernest Van Dijckkaai
649,Ernest Van Dijckkaai,2023-02-08,13:00:00,263,148,115,FMN 01 Ernest Van Dijckkaai
649,Ernest Van Dijckkaai,2023-02-08,14:00:00,242,103,139,FMN 01 Ernest Van Dijckkaai
649,Ernest Van Dijckkaai,2023-02-08,15:00:00,294,148,146,FMN 01 Ernest Van Dijckkaai
649,Ernest Van Dijckkaai,2023-02-08,16:00:00,459,166,293,FMN 01 Ernest Van Dijckkaai
649,Ernest Van Dijckkaai,2023-02-08,17:00:00,547,241,306,FMN 01 Ernest Van Dijckkaai
649,Ernest Van Dijckkaai,2023-02-08,18:00:00,344,189,155,FMN 01 Ernest Van Dijckkaai
649,Ernest Van Dijckkaai,2023-02-08,19:00:00,142,75,67,FMN 01 Ernest Van Dijckkaai
649,Ernest Van Dijckkaai,2023-02-08,20:00:00,124,45,79,FMN 01 Ernest Van Dijckkaai
649,Ernest Van Dijckkaai,2023-02-08,21:00:00,85,30,55,FMN 01 Ernest Van Dijckkaai
649,Ernest Van Dijckkaai,2023-02-08,22:00:00,97,29,68,FMN 01 Ernest Van Dijckkaai
649,Ernest Van Dijckkaai,2023-02-08,23:00:00,48,20,28,FMN 01 Ernest Van Dijckkaai
649,Ernest Van Dijckkaai,2023-02-09,00:00:00,28,13,15,FMN 01 Ernest Van Dijckkaai
649,Ernest Van Dijckkaai,2023-02-09,01:00:00,16,5,11,FMN 01 Ernest Van Dijckkaai
649,Ernest Van Dijckkaai,2023-02-09,02:00:00,3,1,2,FMN 01 Ernest Van Dijckkaai
649,Ernest Van Dijckkaai,2023-02-09,03:00:00,8,2,6,FMN 01 Ernest Van Dijckkaai
649,Ernest Van Dijckkaai,2023-02-09,04:00:00,44,29,15,FMN 01 Ernest Van Dijckkaai
649,Ernest Van Dijckkaai,2023-02-09,05:00:00,82,57,25,FMN 01 Ernest Van Dijckkaai
649,Ernest Van Dijckkaai,2023-02-09,06:00:00,204,137,67,FMN 01 Ernest Van Dijckkaai
649,Ernest Van Dijckkaai,2023-02-09,07:00:00,348,232,116,FMN 01 Ernest Van Dijckkaai
649,Ernest Van Dijckkaai,2023-02-09,08:00:00,479,300,179,FMN 01 Ernest Van Dijckkaai
649,Ernest Van Dijckkaai,2023-02-09,09:00:00,201,128,73,FMN 01 Ernest Van Dijckkaai
649,Ernest Van Dijckkaai,2023-02-09,10:00:00,121,73,48,FMN 01 Ernest Van Dijckkaai
649,Ernest Van Dijckkaai,2023-02-09,11:00:00,110,56,54,FMN 01 Ernest Van Dijckkaai
649,Ernest Van Dijckkaai,2023-02-09,12:00:00,230,126,104,FMN 01 Ernest Van Dijckkaai
649,Ernest Van Dijckkaai,2023-02-09,13:00:00,228,147,81,FMN 01 Ernest Van Dijckkaai
649,Ernest Van Dijckkaai,2023-02-09,14:00:00,236,111,125,FMN 01 Ernest Van Dijckkaai
649,Ernest Van Dijckkaai,2023-02-09,15:00:00,281,140,141,FMN 01 Ernest Van Dijckkaai
649,Ernest Van Dijckkaai,2023-02-09,16:00:00,492,196,296,FMN 01 Ernest Van Dijckkaai
649,Ernest Van Dijckkaai,2023-02-09,17:00:00,527,228,299,FMN 01 Ernest Van Dijckkaai
649,Ernest Van Dijckkaai,2023-02-09,18:00:00,341,189,152,FMN 01 Ernest Van Dijckkaai
649,Ernest Van Dijckkaai,2023-02-09,19:00:00,161,82,79,FMN 01 Ernest Van Dijckkaai
649,Ernest Van Dijckkaai,2023-02-09,20:00:00,128,54,74,FMN 01 Ernest Van Dijckkaai
649,Ernest Van Dijckkaai,2023-02-09,21:00:00,107,38,69,FMN 01 Ernest Van Dijckkaai
649,Ernest Van Dijckkaai,2023-02-09,22:00:00,143,53,90,FMN 01 Ernest Van Dijckkaai
649,Ernest Van Dijckkaai,2023-02-09,23:00:00,68,28,40,FMN 01 Ernest Van Dijckkaai
649,Ernest Van Dijckkaai,2023-02-10,00:00:00,48,25,23,FMN 01 Ernest Van Dijckkaai
649,Ernest Van Dijckkaai,2023-02-10,01:00:00,14,9,5,FMN 01 Ernest Van Dijckkaai
649,Ernest Van Dijckkaai,2023-02-10,02:00:00,23,7,16,FMN 01 Ernest Van Dijckkaai
649,Ernest Van Dijckkaai,2023-02-10,03:00:00,16,6,10,FMN 01 Ernest Van Dijckkaai
649,Ernest Van Dijckkaai,2023-02-10,04:00:00,39,22,17,FMN 01 Ernest Van Dijckkaai
649,Ernest Van Dijckkaai,2023-02-10,05:00:00,82,56,26,FMN 01 Ernest Van Dijckkaai
649,Ernest Van Dijckkaai,2023-02-10,06:00:00,186,128,58,FMN 01 Ernest Van Dijckkaai
649,Ernest Van Dijckkaai,2023-02-10,07:00:00,308,205,103,FMN 01 Ernest Van Dijckkaai
649,Ernest Van Dijckkaai,2023-02-10,08:00:00,425,285,140,FMN 01 Ernest Van Dijckkaai
649,Ernest Van Dijckkaai,2023-02-10,09:00:00,181,113,68,FMN 01 Ernest Van Dijckkaai
649,Ernest Van Dijckkaai,2023-02-10,10:00:00,148,82,66,FMN 01 Ernest Van Dijckkaai
649,Ernest Van Dijckkaai,2023-02-10,11:00:00,144,75,69,FMN 01 Ernest Van Dijckkaai
649,Ernest Van Dijckkaai,2023-02-10,12:00:00,211,117,94,FMN 01 Ernest Van Dijckkaai
649,Ernest Van Dijckkaai,2023-02-10,13:00:00,168,89,79,FMN 01 Ernest Van Dijckkaai
649,Ernest Van Dijckkaai,2023-02-10,14:00:00,222,101,121,FMN 01 Ernest Van Dijckkaai
649,Ernest Van Dijckkaai,2023-02-10,15:00:00,285,150,135,FMN 01 Ernest Van Dijckkaai
649,Ernest Van Dijckkaai,2023-02-10,16:00:00,449,172,277,FMN 01 Ernest Van Dijckkaai
649,Ernest Van Dijckkaai,2023-02-10,17:00:00,399,192,207,FMN 01 Ernest Van Dijckkaai
649,Ernest Van Dijckkaai,2023-02-10,18:00:00,251,133,118,FMN 01 Ernest Van Dijckkaai
649,Ernest Van Dijckkaai,2023-02-10,19:00:00,180,88,92,FMN 01 Ernest Van Dijckkaai
649,Ernest Van Dijckkaai,2023-02-10,20:00:00,110,62,48,FMN 01 Ernest Van Dijckkaai
649,Ernest Van Dijckkaai,2023-02-10,21:00:00,93,51,42,FMN 01 Ernest Van Dijckkaai
649,Ernest Van Dijckkaai,2023-02-10,22:00:00,122,61,61,FMN 01 Ernest Van Dijckkaai
649,Ernest Van Dijckkaai,2023-02-10,23:00:00,94,35,59,FMN 01 Ernest Van Dijckkaai
649,Ernest Van Dijckkaai,2023-02-11,00:00:00,77,39,38,FMN 01 Ernest Van Dijckkaai
649,Ernest Van Dijckkaai,2023-02-11,01:00:00,59,20,39,FMN 01 Ernest Van Dijckkaai
649,Ernest Van Dijckkaai,2023-02-11,02:00:00,36,16,20,FMN 01 Ernest Van Dijckkaai
649,Ernest Van Dijckkaai,2023-02-11,03:00:00,40,7,33,FMN 01 Ernest Van Dijckkaai
649,Ernest Van Dijckkaai,2023-02-11,04:00:00,39,15,24,FMN 01 Ernest Van Dijckkaai
649,Ernest Van Dijckkaai,2023-02-11,05:00:00,27,14,13,FMN 01 Ernest Van Dijckkaai
649,Ernest Van Dijckkaai,2023-02-11,06:00:00,30,16,14,FMN 01 Ernest Van Dijckkaai
649,Ernest Van Dijckkaai,2023-02-11,07:00:00,30,9,21,FMN 01 Ernest Van Dijckkaai
649,Ernest Van Dijckkaai,2023-02-11,08:00:00,53,29,24,FMN 01 Ernest Van Dijckkaai
649,Ernest Van Dijckkaai,2023-02-11,09:00:00,108,66,42,FMN 01 Ernest Van Dijckkaai
649,Ernest Van Dijckkaai,2023-02-11,10:00:00,120,73,47,FMN 01 Ernest Van Dijckkaai
649,Ernest Van Dijckkaai,2023-02-11,11:00:00,150,76,74,FMN 01 Ernest Van Dijckkaai
649,Ernest Van Dijckkaai,2023-02-11,12:00:00,198,99,99,FMN 01 Ernest Van Dijckkaai
649,Ernest Van Dijckkaai,2023-02-11,13:00:00,180,87,93,FMN 01 Ernest Van Dijckkaai
649,Ernest Van Dijckkaai,2023-02-11,14:00:00,194,106,88,FMN 01 Ernest Van Dijckkaai
649,Ernest Van Dijckkaai,2023-02-11,15:00:00,213,103,110,FMN 01 Ernest Van Dijckkaai
649,Ernest Van Dijckkaai,2023-02-11,16:00:00,215,106,109,FMN 01 Ernest Van Dijckkaai
649,Ernest Van Dijckkaai,2023-02-11,17:00:00,212,120,92,FMN 01 Ernest Van Dijckkaai
649,Ernest Van Dijckkaai,2023-02-11,18:00:00,179,100,79,FMN 01 Ernest Van Dijckkaai
649,Ernest Van Dijckkaai,2023-02-11,19:00:00,138,69,69,FMN 01 Ernest Van Dijckkaai
649,Ernest Van Dijckkaai,2023-02-11,20:00:00,136,76,60,FMN 01 Ernest Van Dijckkaai
649,Ernest Van Dijckkaai,2023-02-11,21:00:00,95,56,39,FMN 01 Ernest Van Dijckkaai
649,Ernest Van Dijckkaai,2023-02-11,22:00:00,84,34,50,FMN 01 Ernest Van Dijckkaai
649,Ernest Van Dijckkaai,2023-02-11,23:00:00,105,44,61,FMN 01 Ernest Van Dijckkaai
649,Ernest Van Dijckkaai,2023-02-12,00:00:00,81,40,41,FMN 01 Ernest Van Dijckkaai
649,Ernest Van Dijckkaai,2023-02-12,01:00:00,79,45,34,FMN 01 Ernest Van Dijckkaai
649,Ernest Van Dijckkaai,2023-02-12,02:00:00,62,18,44,FMN 01 Ernest Van Dijckkaai
649,Ernest Van Dijckkaai,2023-02-12,03:00:00,30,6,24,FMN 01 Ernest Van Dijckkaai
649,Ernest Van Dijckkaai,2023-02-12,04:00:00,37,9,28,FMN 01 Ernest Van Dijckkaai
649,Ernest Van Dijckkaai,2023-02-12,05:00:00,37,8,29,FMN 01 Ernest Van Dijckkaai
649,Ernest Van Dijckkaai,2023-02-12,06:00:00,39,20,19,FMN 01 Ernest Van Dijckkaai
649,Ernest Van Dijckkaai,2023-02-12,07:00:00,19,9,10,FMN 01 Ernest Van Dijckkaai
649,Ernest Van Dijckkaai,2023-02-12,08:00:00,45,27,18,FMN 01 Ernest Van Dijckkaai
649,Ernest Van Dijckkaai,2023-02-12,09:00:00,148,102,46,FMN 01 Ernest Van Dijckkaai
649,Ernest Van Dijckkaai,2023-02-12,10:00:00,150,109,41,FMN 01 Ernest Van Dijckkaai
649,Ernest Van Dijckkaai,2023-02-12,11:00:00,193,122,71,FMN 01 Ernest Van Dijckkaai
649,Ernest Van Dijckkaai,2023-02-12,12:00:00,270,143,127,FMN 01 Ernest Van Dijckkaai
649,Ernest Van Dijckkaai,2023-02-12,13:00:00,261,156,105,FMN 01 Ernest Van Dijckkaai
649,Ernest Van Dijckkaai,2023-02-12,14:00:00,236,130,106,FMN 01 Ernest Van Dijckkaai
649,Ernest Van Dijckkaai,2023-02-12,15:00:00,263,115,148,FMN 01 Ernest Van Dijckkaai
649,Ernest Van Dijckkaai,2023-02-12,16:00:00,252,102,150,FMN 01 Ernest Van Dijckkaai
649,Ernest Van Dijckkaai,2023-02-12,17:00:00,204,92,112,FMN 01 Ernest Van Dijckkaai
649,Ernest Van Dijckkaai,2023-02-12,18:00:00,141,71,70,FMN 01 Ernest Van Dijckkaai
649,Ernest Van Dijckkaai,2023-02-12,19:00:00,89,39,50,FMN 01 Ernest Van Dijckkaai
649,Ernest Van Dijckkaai,2023-02-12,20:00:00,52,27,25,FMN 01 Ernest Van Dijckkaai
649,Ernest Van Dijckkaai,2023-02-12,21:00:00,83,41,42,FMN 01 Ernest Van Dijckkaai
649,Ernest Van Dijckkaai,2023-02-12,22:00:00,62,26,36,FMN 01 Ernest Van Dijckkaai
649,Ernest Van Dijckkaai,2023-02-12,23:00:00,39,15,24,FMN 01 Ernest Van Dijckkaai
649,Ernest Van Dijckkaai,2023-02-13,00:00:00,10,3,7,FMN 01 Ernest Van Dijckkaai
649,Ernest Van Dijckkaai,2023-02-13,01:00:00,3,1,2,FMN 01 Ernest Van Dijckkaai
649,Ernest Van Dijckkaai,2023-02-13,02:00:00,4,1,3,FMN 01 Ernest Van Dijckkaai
649,Ernest Van Dijckkaai,2023-02-13,03:00:00,7,3,4,FMN 01 Ernest Van Dijckkaai
649,Ernest Van Dijckkaai,2023-02-13,04:00:00,61,40,21,FMN 01 Ernest Van Dijckkaai
649,Ernest Van Dijckkaai,2023-02-13,05:00:00,101,70,31,FMN 01 Ernest Van Dijckkaai
649,Ernest Van Dijckkaai,2023-02-13,06:00:00,203,140,63,FMN 01 Ernest Van Dijckkaai
649,Ernest Van Dijckkaai,2023-02-13,07:00:00,414,277,137,FMN 01 Ernest Van Dijckkaai
649,Ernest Van Dijckkaai,2023-02-13,08:00:00,544,345,199,FMN 01 Ernest Van Dijckkaai
649,Ernest Van Dijckkaai,2023-02-13,09:00:00,209,123,86,FMN 01 Ernest Van Dijckkaai
649,Ernest Van Dijckkaai,2023-02-13,10:00:00,137,88,49,FMN 01 Ernest Van Dijckkaai
649,Ernest Van Dijckkaai,2023-02-13,11:00:00,132,73,59,FMN 01 Ernest Van Dijckkaai
649,Ernest Van Dijckkaai,2023-02-13,12:00:00,226,123,103,FMN 01 Ernest Van Dijckkaai
649,Ernest Van Dijckkaai,2023-02-13,13:00:00,247,142,105,FMN 01 Ernest Van Dijckkaai
649,Ernest Van Dijckkaai,2023-02-13,14:00:00,316,152,164,FMN 01 Ernest Van Dijckkaai
649,Ernest Van Dijckkaai,2023-02-13,15:00:00,372,163,209,FMN 01 Ernest Van Dijckkaai
649,Ernest Van Dijckkaai,2023-02-13,16:00:00,585,239,346,FMN 01 Ernest Van Dijckkaai
649,Ernest Van Dijckkaai,2023-02-13,17:00:00,648,283,365,FMN 01 Ernest Van Dijckkaai
649,Ernest Van Dijckkaai,2023-02-13,18:00:00,341,153,188,FMN 01 Ernest Van Dijckkaai
649,Ernest Van Dijckkaai,2023-02-13,19:00:00,178,75,103,FMN 01 Ernest Van Dijckkaai
649,Ernest Van Dijckkaai,2023-02-13,20:00:00,134,59,75,FMN 01 Ernest Van Dijckkaai
649,Ernest Van Dijckkaai,2023-02-13,21:00:00,99,41,58,FMN 01 Ernest Van Dijckkaai
649,Ernest Van Dijckkaai,2023-02-13,22:00:00,112,49,63,FMN 01 Ernest Van Dijckkaai
649,Ernest Van Dijckkaai,2023-02-13,23:00:00,38,22,16,FMN 01 Ernest Van Dijckkaai
649,Ernest Van Dijckkaai,2023-02-14,00:00:00,15,4,11,FMN 01 Ernest Van Dijckkaai
649,Ernest Van Dijckkaai,2023-02-14,01:00:00,5,2,3,FMN 01 Ernest Van Dijckkaai
649,Ernest Van Dijckkaai,2023-02-14,02:00:00,1,1,0,FMN 01 Ernest Van Dijckkaai
649,Ernest Van Dijckkaai,2023-02-14,03:00:00,9,2,7,FMN 01 Ernest Van Dijckkaai
649,Ernest Van Dijckkaai,2023-02-14,04:00:00,58,41,17,FMN 01 Ernest Van Dijckkaai
649,Ernest Van Dijckkaai,2023-02-14,05:00:00,121,83,38,FMN 01 Ernest Van Dijckkaai
649,Ernest Van Dijckkaai,2023-02-14,06:00:00,241,152,89,FMN 01 Ernest Van Dijckkaai
649,Ernest Van Dijckkaai,2023-02-14,07:00:00,457,308,149,FMN 01 Ernest Van Dijckkaai
649,Ernest Van Dijckkaai,2023-02-14,08:00:00,557,320,237,FMN 01 Ernest Van Dijckkaai
649,Ernest Van Dijckkaai,2023-02-14,09:00:00,311,189,122,FMN 01 Ernest Van Dijckkaai
649,Ernest Van Dijckkaai,2023-02-14,10:00:00,168,105,63,FMN 01 Ernest Van Dijckkaai
649,Ernest Van Dijckkaai,2023-02-14,11:00:00,168,91,77,FMN 01 Ernest Van Dijckkaai
649,Ernest Van Dijckkaai,2023-02-14,12:00:00,334,207,127,FMN 01 Ernest Van Dijckkaai
649,Ernest Van Dijckkaai,2023-02-14,13:00:00,326,203,123,FMN 01 Ernest Van Dijckkaai
649,Ernest Van Dijckkaai,2023-02-14,14:00:00,382,183,199,FMN 01 Ernest Van Dijckkaai
649,Ernest Van Dijckkaai,2023-02-14,15:00:00,501,257,244,FMN 01 Ernest Van Dijckkaai
649,Ernest Van Dijckkaai,2023-02-14,16:00:00,712,305,407,FMN 01 Ernest Van Dijckkaai
649,Ernest Van Dijckkaai,2023-02-14,17:00:00,751,322,429,FMN 01 Ernest Van Dijckkaai
649,Ernest Van Dijckkaai,2023-02-14,18:00:00,461,241,220,FMN 01 Ernest Van Dijckkaai
649,Ernest Van Dijckkaai,2023-02-14,19:00:00,213,109,104,FMN 01 Ernest Van Dijckkaai
649,Ernest Van Dijckkaai,2023-02-14,20:00:00,170,75,95,FMN 01 Ernest Van Dijckkaai
649,Ernest Van Dijckkaai,2023-02-14,21:00:00,132,54,78,FMN 01 Ernest Van Dijckkaai
649,Ernest Van Dijckkaai,2023-02-14,22:00:00,132,47,85,FMN 01 Ernest Van Dijckkaai
649,Ernest Van Dijckkaai,2023-02-14,23:00:00,76,29,47,FMN 01 Ernest Van Dijckkaai
649,Ernest Van Dijckkaai,2023-02-15,00:00:00,25,11,14,FMN 01 Ernest Van Dijckkaai
649,Ernest Van Dijckkaai,2023-02-15,01:00:00,14,6,8,FMN 01 Ernest Van Dijckkaai
649,Ernest Van Dijckkaai,2023-02-15,02:00:00,8,1,7,FMN 01 Ernest Van Dijckkaai
649,Ernest Van Dijckkaai,2023-02-15,03:00:00,13,3,10,FMN 01 Ernest Van Dijckkaai
649,Ernest Van Dijckkaai,2023-02-15,04:00:00,66,47,19,FMN 01 Ernest Van Dijckkaai
649,Ernest Van Dijckkaai,2023-02-15,05:00:00,102,74,28,FMN 01 Ernest Van Dijckkaai
649,Ernest Van Dijckkaai,2023-02-15,06:00:00,217,134,83,FMN 01 Ernest Van Dijckkaai
649,Ernest Van Dijckkaai,2023-02-15,07:00:00,404,278,126,FMN 01 Ernest Van Dijckkaai
649,Ernest Van Dijckkaai,2023-02-15,08:00:00,497,317,180,FMN 01 Ernest Van Dijckkaai
649,Ernest Van Dijckkaai,2023-02-15,09:00:00,215,143,72,FMN 01 Ernest Van Dijckkaai
649,Ernest Van Dijckkaai,2023-02-15,10:00:00,148,99,49,FMN 01 Ernest Van Dijckkaai
649,Ernest Van Dijckkaai,2023-02-15,11:00:00,183,91,92,FMN 01 Ernest Van Dijckkaai
649,Ernest Van Dijckkaai,2023-02-15,12:00:00,339,182,157,FMN 01 Ernest Van Dijckkaai
649,Ernest Van Dijckkaai,2023-02-15,13:00:00,336,193,143,FMN 01 Ernest Van Dijckkaai
649,Ernest Van Dijckkaai,2023-02-15,14:00:00,305,150,155,FMN 01 Ernest Van Dijckkaai
649,Ernest Van Dijckkaai,2023-02-15,15:00:00,340,162,178,FMN 01 Ernest Van Dijckkaai
649,Ernest Van Dijckkaai,2023-02-15,16:00:00,534,220,314,FMN 01 Ernest Van Dijckkaai
649,Ernest Van Dijckkaai,2023-02-15,17:00:00,618,264,354,FMN 01 Ernest Van Dijckkaai
649,Ernest Van Dijckkaai,2023-02-15,18:00:00,370,176,194,FMN 01 Ernest Van Dijckkaai
649,Ernest Van Dijckkaai,2023-02-15,19:00:00,217,129,88,FMN 01 Ernest Van Dijckkaai
649,Ernest Van Dijckkaai,2023-02-15,20:00:00,123,51,72,FMN 01 Ernest Van Dijckkaai
649,Ernest Van Dijckkaai,2023-02-15,21:00:00,123,45,78,FMN 01 Ernest Van Dijckkaai
649,Ernest Van Dijckkaai,2023-02-15,22:00:00,150,54,96,FMN 01 Ernest Van Dijckkaai
649,Ernest Van Dijckkaai,2023-02-15,23:00:00,58,20,38,FMN 01 Ernest Van Dijckkaai
649,Ernest Van Dijckkaai,2023-02-16,00:00:00,46,30,16,FMN 01 Ernest Van Dijckkaai
649,Ernest Van Dijckkaai,2023-02-16,01:00:00,16,8,8,FMN 01 Ernest Van Dijckkaai
649,Ernest Van Dijckkaai,2023-02-16,02:00:00,12,1,11,FMN 01 Ernest Van Dijckkaai
649,Ernest Van Dijckkaai,2023-02-16,03:00:00,23,5,18,FMN 01 Ernest Van Dijckkaai
649,Ernest Van Dijckkaai,2023-02-16,04:00:00,69,38,31,FMN 01 Ernest Van Dijckkaai
649,Ernest Van Dijckkaai,2023-02-16,05:00:00,105,67,38,FMN 01 Ernest Van Dijckkaai
649,Ernest Van Dijckkaai,2023-02-16,06:00:00,227,138,89,FMN 01 Ernest Van Dijckkaai
649,Ernest Van Dijckkaai,2023-02-16,07:00:00,384,258,126,FMN 01 Ernest Van Dijckkaai
649,Ernest Van Dijckkaai,2023-02-16,08:00:00,501,305,196,FMN 01 Ernest Van Dijckkaai
649,Ernest Van Dijckkaai,2023-02-16,09:00:00,225,139,86,FMN 01 Ernest Van Dijckkaai
649,Ernest Van Dijckkaai,2023-02-16,10:00:00,130,80,50,FMN 01 Ernest Van Dijckkaai
649,Ernest Van Dijckkaai,2023-02-16,11:00:00,109,62,47,FMN 01 Ernest Van Dijckkaai
649,Ernest Van Dijckkaai,2023-02-16,12:00:00,198,116,82,FMN 01 Ernest Van Dijckkaai
649,Ernest Van Dijckkaai,2023-02-16,13:00:00,210,117,93,FMN 01 Ernest Van Dijckkaai
649,Ernest Van Dijckkaai,2023-02-16,14:00:00,229,118,111,FMN 01 Ernest Van Dijckkaai
649,Ernest Van Dijckkaai,2023-02-16,15:00:00,297,147,150,FMN 01 Ernest Van Dijckkaai
649,Ernest Van Dijckkaai,2023-02-16,16:00:00,494,218,276,FMN 01 Ernest Van Dijckkaai
649,Ernest Van Dijckkaai,2023-02-16,17:00:00,538,238,300,FMN 01 Ernest Van Dijckkaai
649,Ernest Van Dijckkaai,2023-02-16,18:00:00,324,166,158,FMN 01 Ernest Van Dijckkaai
649,Ernest Van Dijckkaai,2023-02-16,19:00:00,156,86,70,FMN 01 Ernest Van Dijckkaai
649,Ernest Van Dijckkaai,2023-02-16,20:00:00,146,69,77,FMN 01 Ernest Van Dijckkaai
649,Ernest Van Dijckkaai,2023-02-16,21:00:00,112,51,61,FMN 01 Ernest Van Dijckkaai
649,Ernest Van Dijckkaai,2023-02-16,22:00:00,132,46,86,FMN 01 Ernest Van Dijckkaai
649,Ernest Van Dijckkaai,2023-02-16,23:00:00,92,47,45,FMN 01 Ernest Van Dijckkaai
649,Ernest Van Dijckkaai,2023-02-17,00:00:00,50,22,28,FMN 01 Ernest Van Dijckkaai
649,Ernest Van Dijckkaai,2023-02-17,01:00:00,16,12,4,FMN 01 Ernest Van Dijckkaai
649,Ernest Van Dijckkaai,2023-02-17,02:00:00,28,7,21,FMN 01 Ernest Van Dijckkaai
649,Ernest Van Dijckkaai,2023-02-17,03:00:00,26,12,14,FMN 01 Ernest Van Dijckkaai
649,Ernest Van Dijckkaai,2023-02-17,04:00:00,54,34,20,FMN 01 Ernest Van Dijckkaai
649,Ernest Van Dijckkaai,2023-02-17,05:00:00,108,66,42,FMN 01 Ernest Van Dijckkaai
649,Ernest Van Dijckkaai,2023-02-17,06:00:00,186,111,75,FMN 01 Ernest Van Dijckkaai
649,Ernest Van Dijckkaai,2023-02-17,07:00:00,343,235,108,FMN 01 Ernest Van Dijckkaai
649,Ernest Van Dijckkaai,2023-02-17,08:00:00,433,278,155,FMN 01 Ernest Van Dijckkaai
649,Ernest Van Dijckkaai,2023-02-17,09:00:00,197,123,74,FMN 01 Ernest Van Dijckkaai
649,Ernest Van Dijckkaai,2023-02-17,10:00:00,132,70,62,FMN 01 Ernest Van Dijckkaai
649,Ernest Van Dijckkaai,2023-02-17,11:00:00,160,79,81,FMN 01 Ernest Van Dijckkaai
649,Ernest Van Dijckkaai,2023-02-17,12:00:00,204,119,85,FMN 01 Ernest Van Dijckkaai
649,Ernest Van Dijckkaai,2023-02-17,13:00:00,193,125,68,FMN 01 Ernest Van Dijckkaai
649,Ernest Van Dijckkaai,2023-02-17,14:00:00,242,119,123,FMN 01 Ernest Van Dijckkaai
649,Ernest Van Dijckkaai,2023-02-17,15:00:00,343,160,183,FMN 01 Ernest Van Dijckkaai
649,Ernest Van Dijckkaai,2023-02-17,16:00:00,450,170,280,FMN 01 Ernest Van Dijckkaai
649,Ernest Van Dijckkaai,2023-02-17,17:00:00,442,215,227,FMN 01 Ernest Van Dijckkaai
649,Ernest Van Dijckkaai,2023-02-17,18:00:00,293,150,143,FMN 01 Ernest Van Dijckkaai
649,Ernest Van Dijckkaai,2023-02-17,19:00:00,216,121,95,FMN 01 Ernest Van Dijckkaai
649,Ernest Van Dijckkaai,2023-02-17,20:00:00,140,54,86,FMN 01 Ernest Van Dijckkaai
649,Ernest Van Dijckkaai,2023-02-17,21:00:00,131,77,54,FMN 01 Ernest Van Dijckkaai
649,Ernest Van Dijckkaai,2023-02-17,22:00:00,128,52,76,FMN 01 Ernest Van Dijckkaai
649,Ernest Van Dijckkaai,2023-02-17,23:00:00,109,33,76,FMN 01 Ernest Van Dijckkaai
649,Ernest Van Dijckkaai,2023-02-18,00:00:00,79,33,46,FMN 01 Ernest Van Dijckkaai
649,Ernest Van Dijckkaai,2023-02-18,01:00:00,49,10,39,FMN 01 Ernest Van Dijckkaai
649,Ernest Van Dijckkaai,2023-02-18,02:00:00,41,13,28,FMN 01 Ernest Van Dijckkaai
649,Ernest Van Dijckkaai,2023-02-18,03:00:00,39,14,25,FMN 01 Ernest Van Dijckkaai
649,Ernest Van Dijckkaai,2023-02-18,04:00:00,44,26,18,FMN 01 Ernest Van Dijckkaai
649,Ernest Van Dijckkaai,2023-02-18,05:00:00,29,14,15,FMN 01 Ernest Van Dijckkaai
649,Ernest Van Dijckkaai,2023-02-18,06:00:00,30,15,15,FMN 01 Ernest Van Dijckkaai
649,Ernest Van Dijckkaai,2023-02-18,07:00:00,18,8,10,FMN 01 Ernest Van Dijckkaai
649,Ernest Van Dijckkaai,2023-02-18,08:00:00,55,29,26,FMN 01 Ernest Van Dijckkaai
649,Ernest Van Dijckkaai,2023-02-18,09:00:00,95,53,42,FMN 01 Ernest Van Dijckkaai
649,Ernest Van Dijckkaai,2023-02-18,10:00:00,112,65,47,FMN 01 Ernest Van Dijckkaai
649,Ernest Van Dijckkaai,2023-02-18,11:00:00,140,88,52,FMN 01 Ernest Van Dijckkaai
649,Ernest Van Dijckkaai,2023-02-18,12:00:00,145,77,68,FMN 01 Ernest Van Dijckkaai
649,Ernest Van Dijckkaai,2023-02-18,13:00:00,169,99,70,FMN 01 Ernest Van Dijckkaai
649,Ernest Van Dijckkaai,2023-02-18,14:00:00,193,105,88,FMN 01 Ernest Van Dijckkaai
649,Ernest Van Dijckkaai,2023-02-18,15:00:00,184,94,90,FMN 01 Ernest Van Dijckkaai
649,Ernest Van Dijckkaai,2023-02-18,16:00:00,178,100,78,FMN 01 Ernest Van Dijckkaai
649,Ernest Van Dijckkaai,2023-02-18,17:00:00,179,105,74,FMN 01 Ernest Van Dijckkaai
649,Ernest Van Dijckkaai,2023-02-18,18:00:00,182,109,73,FMN 01 Ernest Van Dijckkaai
649,Ernest Van Dijckkaai,2023-02-18,19:00:00,189,97,92,FMN 01 Ernest Van Dijckkaai
649,Ernest Van Dijckkaai,2023-02-18,20:00:00,121,58,63,FMN 01 Ernest Van Dijckkaai
649,Ernest Van Dijckkaai,2023-02-18,21:00:00,95,60,35,FMN 01 Ernest Van Dijckkaai
649,Ernest Van Dijckkaai,2023-02-18,22:00:00,101,54,47,FMN 01 Ernest Van Dijckkaai
649,Ernest Van Dijckkaai,2023-02-18,23:00:00,94,41,53,FMN 01 Ernest Van Dijckkaai
649,Ernest Van Dijckkaai,2023-02-19,00:00:00,66,33,33,FMN 01 Ernest Van Dijckkaai
649,Ernest Van Dijckkaai,2023-02-19,01:00:00,60,24,36,FMN 01 Ernest Van Dijckkaai
649,Ernest Van Dijckkaai,2023-02-19,02:00:00,34,12,22,FMN 01 Ernest Van Dijckkaai
649,Ernest Van Dijckkaai,2023-02-19,03:00:00,40,20,20,FMN 01 Ernest Van Dijckkaai
649,Ernest Van Dijckkaai,2023-02-19,04:00:00,41,14,27,FMN 01 Ernest Van Dijckkaai
649,Ernest Van Dijckkaai,2023-02-19,05:00:00,43,18,25,FMN 01 Ernest Van Dijckkaai
649,Ernest Van Dijckkaai,2023-02-19,06:00:00,63,24,39,FMN 01 Ernest Van Dijckkaai
649,Ernest Van Dijckkaai,2023-02-19,07:00:00,36,11,25,FMN 01 Ernest Van Dijckkaai
649,Ernest Van Dijckkaai,2023-02-19,08:00:00,78,20,58,FMN 01 Ernest Van Dijckkaai
649,Ernest Van Dijckkaai,2023-02-19,09:00:00,114,57,57,FMN 01 Ernest Van Dijckkaai
649,Ernest Van Dijckkaai,2023-02-19,10:00:00,122,66,56,FMN 01 Ernest Van Dijckkaai
649,Ernest Van Dijckkaai,2023-02-19,11:00:00,190,90,100,FMN 01 Ernest Van Dijckkaai
649,Ernest Van Dijckkaai,2023-02-19,12:00:00,189,92,97,FMN 01 Ernest Van Dijckkaai
649,Ernest Van Dijckkaai,2023-02-19,13:00:00,200,104,96,FMN 01 Ernest Van Dijckkaai
649,Ernest Van Dijckkaai,2023-02-19,14:00:00,262,148,114,FMN 01 Ernest Van Dijckkaai
649,Ernest Van Dijckkaai,2023-02-19,15:00:00,182,110,72,FMN 01 Ernest Van Dijckkaai
649,Ernest Van Dijckkaai,2023-02-19,16:00:00,224,123,101,FMN 01 Ernest Van Dijckkaai
649,Ernest Van Dijckkaai,2023-02-19,17:00:00,160,62,98,FMN 01 Ernest Van Dijckkaai
649,Ernest Van Dijckkaai,2023-02-19,18:00:00,148,82,66,FMN 01 Ernest Van Dijckkaai
649,Ernest Van Dijckkaai,2023-02-19,19:00:00,119,55,64,FMN 01 Ernest Van Dijckkaai
649,Ernest Van Dijckkaai,2023-02-19,20:00:00,105,56,49,FMN 01 Ernest Van Dijckkaai
649,Ernest Van Dijckkaai,2023-02-19,21:00:00,88,40,48,FMN 01 Ernest Van Dijckkaai
649,Ernest Van Dijckkaai,2023-02-19,22:00:00,68,29,39,FMN 01 Ernest Van Dijckkaai
649,Ernest Van Dijckkaai,2023-02-19,23:00:00,36,12,24,FMN 01 Ernest Van Dijckkaai
649,Ernest Van Dijckkaai,2023-02-20,00:00:00,13,5,8,FMN 01 Ernest Van Dijckkaai
649,Ernest Van Dijckkaai,2023-02-20,01:00:00,6,1,5,FMN 01 Ernest Van Dijckkaai
649,Ernest Van Dijckkaai,2023-02-20,02:00:00,6,1,5,FMN 01 Ernest Van Dijckkaai
649,Ernest Van Dijckkaai,2023-02-20,03:00:00,1,0,1,FMN 01 Ernest Van Dijckkaai
649,Ernest Van Dijckkaai,2023-02-20,04:00:00,48,28,20,FMN 01 Ernest Van Dijckkaai
649,Ernest Van Dijckkaai,2023-02-20,05:00:00,77,47,30,FMN 01 Ernest Van Dijckkaai
649,Ernest Van Dijckkaai,2023-02-20,06:00:00,207,133,74,FMN 01 Ernest Van Dijckkaai
649,Ernest Van Dijckkaai,2023-02-20,07:00:00,326,216,110,FMN 01 Ernest Van Dijckkaai
649,Ernest Van Dijckkaai,2023-02-20,08:00:00,365,223,142,FMN 01 Ernest Van Dijckkaai
649,Ernest Van Dijckkaai,2023-02-20,09:00:00,200,114,86,FMN 01 Ernest Van Dijckkaai
649,Ernest Van Dijckkaai,2023-02-20,10:00:00,111,72,39,FMN 01 Ernest Van Dijckkaai
649,Ernest Van Dijckkaai,2023-02-20,11:00:00,131,80,51,FMN 01 Ernest Van Dijckkaai
649,Ernest Van Dijckkaai,2023-02-20,12:00:00,199,108,91,FMN 01 Ernest Van Dijckkaai
649,Ernest Van Dijckkaai,2023-02-20,13:00:00,202,121,81,FMN 01 Ernest Van Dijckkaai
649,Ernest Van Dijckkaai,2023-02-20,14:00:00,182,86,96,FMN 01 Ernest Van Dijckkaai
649,Ernest Van Dijckkaai,2023-02-20,15:00:00,231,124,107,FMN 01 Ernest Van Dijckkaai
649,Ernest Van Dijckkaai,2023-02-20,16:00:00,415,151,264,FMN 01 Ernest Van Dijckkaai
649,Ernest Van Dijckkaai,2023-02-20,17:00:00,479,181,298,FMN 01 Ernest Van Dijckkaai
649,Ernest Van Dijckkaai,2023-02-20,18:00:00,259,120,139,FMN 01 Ernest Van Dijckkaai
649,Ernest Van Dijckkaai,2023-02-20,19:00:00,138,62,76,FMN 01 Ernest Van Dijckkaai
649,Ernest Van Dijckkaai,2023-02-20,20:00:00,98,49,49,FMN 01 Ernest Van Dijckkaai
649,Ernest Van Dijckkaai,2023-02-20,21:00:00,103,60,43,FMN 01 Ernest Van Dijckkaai
649,Ernest Van Dijckkaai,2023-02-20,22:00:00,112,37,75,FMN 01 Ernest Van Dijckkaai
649,Ernest Van Dijckkaai,2023-02-20,23:00:00,43,15,28,FMN 01 Ernest Van Dijckkaai
649,Ernest Van Dijckkaai,2023-02-21,00:00:00,21,10,11,FMN 01 Ernest Van Dijckkaai
649,Ernest Van Dijckkaai,2023-02-21,01:00:00,4,3,1,FMN 01 Ernest Van Dijckkaai
649,Ernest Van Dijckkaai,2023-02-21,02:00:00,3,1,2,FMN 01 Ernest Van Dijckkaai
649,Ernest Van Dijckkaai,2023-02-21,03:00:00,2,1,1,FMN 01 Ernest Van Dijckkaai
649,Ernest Van Dijckkaai,2023-02-21,04:00:00,48,36,12,FMN 01 Ernest Van Dijckkaai
649,Ernest Van Dijckkaai,2023-02-21,05:00:00,89,58,31,FMN 01 Ernest Van Dijckkaai
649,Ernest Van Dijckkaai,2023-02-21,06:00:00,207,132,75,FMN 01 Ernest Van Dijckkaai
649,Ernest Van Dijckkaai,2023-02-21,07:00:00,356,241,115,FMN 01 Ernest Van Dijckkaai
649,Ernest Van Dijckkaai,2023-02-21,08:00:00,400,253,147,FMN 01 Ernest Van Dijckkaai
649,Ernest Van Dijckkaai,2023-02-21,09:00:00,210,118,92,FMN 01 Ernest Van Dijckkaai
649,Ernest Van Dijckkaai,2023-02-21,10:00:00,136,94,42,FMN 01 Ernest Van Dijckkaai
649,Ernest Van Dijckkaai,2023-02-21,11:00:00,154,91,63,FMN 01 Ernest Van Dijckkaai
649,Ernest Van Dijckkaai,2023-02-21,12:00:00,189,115,74,FMN 01 Ernest Van Dijckkaai
649,Ernest Van Dijckkaai,2023-02-21,13:00:00,185,98,87,FMN 01 Ernest Van Dijckkaai
649,Ernest Van Dijckkaai,2023-02-21,14:00:00,227,109,118,FMN 01 Ernest Van Dijckkaai
649,Ernest Van Dijckkaai,2023-02-21,15:00:00,276,145,131,FMN 01 Ernest Van Dijckkaai
649,Ernest Van Dijckkaai,2023-02-21,16:00:00,418,171,247,FMN 01 Ernest Van Dijckkaai
649,Ernest Van Dijckkaai,2023-02-21,17:00:00,508,213,295,FMN 01 Ernest Van Dijckkaai
649,Ernest Van Dijckkaai,2023-02-21,18:00:00,330,160,170,FMN 01 Ernest Van Dijckkaai
649,Ernest Van Dijckkaai,2023-02-21,19:00:00,192,97,95,FMN 01 Ernest Van Dijckkaai
649,Ernest Van Dijckkaai,2023-02-21,20:00:00,124,50,74,FMN 01 Ernest Van Dijckkaai
649,Ernest Van Dijckkaai,2023-02-21,21:00:00,101,55,46,FMN 01 Ernest Van Dijckkaai
649,Ernest Van Dijckkaai,2023-02-21,22:00:00,124,38,86,FMN 01 Ernest Van Dijckkaai
649,Ernest Van Dijckkaai,2023-02-21,23:00:00,48,20,28,FMN 01 Ernest Van Dijckkaai
649,Ernest Van Dijckkaai,2023-02-22,00:00:00,23,12,11,FMN 01 Ernest Van Dijckkaai
649,Ernest Van Dijckkaai,2023-02-22,01:00:00,19,8,11,FMN 01 Ernest Van Dijckkaai
649,Ernest Van Dijckkaai,2023-02-22,02:00:00,7,2,5,FMN 01 Ernest Van Dijckkaai
649,Ernest Van Dijckkaai,2023-02-22,03:00:00,4,0,4,FMN 01 Ernest Van Dijckkaai
649,Ernest Van Dijckkaai,2023-02-22,04:00:00,49,30,19,FMN 01 Ernest Van Dijckkaai
649,Ernest Van Dijckkaai,2023-02-22,05:00:00,92,62,30,FMN 01 Ernest Van Dijckkaai
649,Ernest Van Dijckkaai,2023-02-22,06:00:00,198,127,71,FMN 01 Ernest Van Dijckkaai
649,Ernest Van Dijckkaai,2023-02-22,07:00:00,291,186,105,FMN 01 Ernest Van Dijckkaai
649,Ernest Van Dijckkaai,2023-02-22,08:00:00,374,232,142,FMN 01 Ernest Van Dijckkaai
649,Ernest Van Dijckkaai,2023-02-22,09:00:00,167,102,65,FMN 01 Ernest Van Dijckkaai
649,Ernest Van Dijckkaai,2023-02-22,10:00:00,143,95,48,FMN 01 Ernest Van Dijckkaai
649,Ernest Van Dijckkaai,2023-02-22,11:00:00,138,82,56,FMN 01 Ernest Van Dijckkaai
649,Ernest Van Dijckkaai,2023-02-22,12:00:00,181,103,78,FMN 01 Ernest Van Dijckkaai
649,Ernest Van Dijckkaai,2023-02-22,13:00:00,181,89,92,FMN 01 Ernest Van Dijckkaai
649,Ernest Van Dijckkaai,2023-02-22,14:00:00,190,90,100,FMN 01 Ernest Van Dijckkaai
649,Ernest Van Dijckkaai,2023-02-22,15:00:00,246,122,124,FMN 01 Ernest Van Dijckkaai
649,Ernest Van Dijckkaai,2023-02-22,16:00:00,403,159,244,FMN 01 Ernest Van Dijckkaai
649,Ernest Van Dijckkaai,2023-02-22,17:00:00,468,206,262,FMN 01 Ernest Van Dijckkaai
649,Ernest Van Dijckkaai,2023-02-22,18:00:00,280,145,135,FMN 01 Ernest Van Dijckkaai
649,Ernest Van Dijckkaai,2023-02-22,19:00:00,154,74,80,FMN 01 Ernest Van Dijckkaai
649,Ernest Van Dijckkaai,2023-02-22,20:00:00,124,65,59,FMN 01 Ernest Van Dijckkaai
649,Ernest Van Dijckkaai,2023-02-22,21:00:00,90,50,40,FMN 01 Ernest Van Dijckkaai
649,Ernest Van Dijckkaai,2023-02-22,22:00:00,136,54,82,FMN 01 Ernest Van Dijckkaai
649,Ernest Van Dijckkaai,2023-02-22,23:00:00,42,13,29,FMN 01 Ernest Van Dijckkaai
649,Ernest Van Dijckkaai,2023-02-23,00:00:00,22,8,14,FMN 01 Ernest Van Dijckkaai
649,Ernest Van Dijckkaai,2023-02-23,01:00:00,12,5,7,FMN 01 Ernest Van Dijckkaai
649,Ernest Van Dijckkaai,2023-02-23,02:00:00,4,0,4,FMN 01 Ernest Van Dijckkaai
649,Ernest Van Dijckkaai,2023-02-23,03:00:00,10,6,4,FMN 01 Ernest Van Dijckkaai
649,Ernest Van Dijckkaai,2023-02-23,04:00:00,38,23,15,FMN 01 Ernest Van Dijckkaai
649,Ernest Van Dijckkaai,2023-02-23,05:00:00,106,71,35,FMN 01 Ernest Van Dijckkaai
649,Ernest Van Dijckkaai,2023-02-23,06:00:00,190,120,70,FMN 01 Ernest Van Dijckkaai
649,Ernest Van Dijckkaai,2023-02-23,07:00:00,311,195,116,FMN 01 Ernest Van Dijckkaai
649,Ernest Van Dijckkaai,2023-02-23,08:00:00,347,205,142,FMN 01 Ernest Van Dijckkaai
649,Ernest Van Dijckkaai,2023-02-23,09:00:00,193,114,79,FMN 01 Ernest Van Dijckkaai
649,Ernest Van Dijckkaai,2023-02-23,10:00:00,129,86,43,FMN 01 Ernest Van Dijckkaai
649,Ernest Van Dijckkaai,2023-02-23,11:00:00,123,73,50,FMN 01 Ernest Van Dijckkaai
649,Ernest Van Dijckkaai,2023-02-23,12:00:00,186,108,78,FMN 01 Ernest Van Dijckkaai
649,Ernest Van Dijckkaai,2023-02-23,13:00:00,213,101,112,FMN 01 Ernest Van Dijckkaai
649,Ernest Van Dijckkaai,2023-02-23,14:00:00,237,117,120,FMN 01 Ernest Van Dijckkaai
649,Ernest Van Dijckkaai,2023-02-23,15:00:00,287,137,150,FMN 01 Ernest Van Dijckkaai
649,Ernest Van Dijckkaai,2023-02-23,16:00:00,405,180,225,FMN 01 Ernest Van Dijckkaai
649,Ernest Van Dijckkaai,2023-02-23,17:00:00,540,258,282,FMN 01 Ernest Van Dijckkaai
649,Ernest Van Dijckkaai,2023-02-23,18:00:00,360,174,186,FMN 01 Ernest Van Dijckkaai
649,Ernest Van Dijckkaai,2023-02-23,19:00:00,152,69,83,FMN 01 Ernest Van Dijckkaai
649,Ernest Van Dijckkaai,2023-02-23,20:00:00,137,81,56,FMN 01 Ernest Van Dijckkaai
649,Ernest Van Dijckkaai,2023-02-23,21:00:00,117,57,60,FMN 01 Ernest Van Dijckkaai
649,Ernest Van Dijckkaai,2023-02-23,22:00:00,129,51,78,FMN 01 Ernest Van Dijckkaai
649,Ernest Van Dijckkaai,2023-02-23,23:00:00,77,22,55,FMN 01 Ernest Van Dijckkaai
649,Ernest Van Dijckkaai,2023-02-24,00:00:00,64,38,26,FMN 01 Ernest Van Dijckkaai
649,Ernest Van Dijckkaai,2023-02-24,01:00:00,31,12,19,FMN 01 Ernest Van Dijckkaai
649,Ernest Van Dijckkaai,2023-02-24,02:00:00,19,6,13,FMN 01 Ernest Van Dijckkaai
649,Ernest Van Dijckkaai,2023-02-24,03:00:00,18,6,12,FMN 01 Ernest Van Dijckkaai
649,Ernest Van Dijckkaai,2023-02-24,04:00:00,50,23,27,FMN 01 Ernest Van Dijckkaai
649,Ernest Van Dijckkaai,2023-02-24,05:00:00,103,55,48,FMN 01 Ernest Van Dijckkaai
649,Ernest Van Dijckkaai,2023-02-24,06:00:00,153,93,60,FMN 01 Ernest Van Dijckkaai
649,Ernest Van Dijckkaai,2023-02-24,07:00:00,230,143,87,FMN 01 Ernest Van Dijckkaai
649,Ernest Van Dijckkaai,2023-02-24,08:00:00,283,175,108,FMN 01 Ernest Van Dijckkaai
649,Ernest Van Dijckkaai,2023-02-24,09:00:00,193,114,79,FMN 01 Ernest Van Dijckkaai
649,Ernest Van Dijckkaai,2023-02-24,10:00:00,153,80,73,FMN 01 Ernest Van Dijckkaai
649,Ernest Van Dijckkaai,2023-02-24,11:00:00,154,85,69,FMN 01 Ernest Van Dijckkaai
649,Ernest Van Dijckkaai,2023-02-24,12:00:00,216,126,90,FMN 01 Ernest Van Dijckkaai
649,Ernest Van Dijckkaai,2023-02-24,13:00:00,193,99,94,FMN 01 Ernest Van Dijckkaai
649,Ernest Van Dijckkaai,2023-02-24,14:00:00,168,70,98,FMN 01 Ernest Van Dijckkaai
649,Ernest Van Dijckkaai,2023-02-24,15:00:00,240,112,128,FMN 01 Ernest Van Dijckkaai
649,Ernest Van Dijckkaai,2023-02-24,16:00:00,340,139,201,FMN 01 Ernest Van Dijckkaai
649,Ernest Van Dijckkaai,2023-02-24,17:00:00,340,147,193,FMN 01 Ernest Van Dijckkaai
649,Ernest Van Dijckkaai,2023-02-24,18:00:00,267,135,132,FMN 01 Ernest Van Dijckkaai
649,Ernest Van Dijckkaai,2023-02-24,19:00:00,178,94,84,FMN 01 Ernest Van Dijckkaai
649,Ernest Van Dijckkaai,2023-02-24,20:00:00,114,64,50,FMN 01 Ernest Van Dijckkaai
649,Ernest Van Dijckkaai,2023-02-24,21:00:00,109,42,67,FMN 01 Ernest Van Dijckkaai
649,Ernest Van Dijckkaai,2023-02-24,22:00:00,114,45,69,FMN 01 Ernest Van Dijckkaai
649,Ernest Van Dijckkaai,2023-02-24,23:00:00,97,39,58,FMN 01 Ernest Van Dijckkaai
649,Ernest Van Dijckkaai,2023-02-25,00:00:00,82,30,52,FMN 01 Ernest Van Dijckkaai
649,Ernest Van Dijckkaai,2023-02-25,01:00:00,39,18,21,FMN 01 Ernest Van Dijckkaai
649,Ernest Van Dijckkaai,2023-02-25,02:00:00,35,15,20,FMN 01 Ernest Van Dijckkaai
649,Ernest Van Dijckkaai,2023-02-25,03:00:00,31,15,16,FMN 01 Ernest Van Dijckkaai
649,Ernest Van Dijckkaai,2023-02-25,04:00:00,41,20,21,FMN 01 Ernest Van Dijckkaai
649,Ernest Van Dijckkaai,2023-02-25,05:00:00,32,11,21,FMN 01 Ernest Van Dijckkaai
649,Ernest Van Dijckkaai,2023-02-25,06:00:00,33,18,15,FMN 01 Ernest Van Dijckkaai
649,Ernest Van Dijckkaai,2023-02-25,07:00:00,26,10,16,FMN 01 Ernest Van Dijckkaai
649,Ernest Van Dijckkaai,2023-02-25,08:00:00,54,35,19,FMN 01 Ernest Van Dijckkaai
649,Ernest Van Dijckkaai,2023-02-25,09:00:00,95,54,41,FMN 01 Ernest Van Dijckkaai
649,Ernest Van Dijckkaai,2023-02-25,10:00:00,150,94,56,FMN 01 Ernest Van Dijckkaai
649,Ernest Van Dijckkaai,2023-02-25,11:00:00,151,95,56,FMN 01 Ernest Van Dijckkaai
649,Ernest Van Dijckkaai,2023-02-25,12:00:00,220,102,118,FMN 01 Ernest Van Dijckkaai
649,Ernest Van Dijckkaai,2023-02-25,13:00:00,186,102,84,FMN 01 Ernest Van Dijckkaai
649,Ernest Van Dijckkaai,2023-02-25,14:00:00,227,112,115,FMN 01 Ernest Van Dijckkaai
649,Ernest Van Dijckkaai,2023-02-25,15:00:00,234,125,109,FMN 01 Ernest Van Dijckkaai
649,Ernest Van Dijckkaai,2023-02-25,16:00:00,222,127,95,FMN 01 Ernest Van Dijckkaai
649,Ernest Van Dijckkaai,2023-02-25,17:00:00,239,128,111,FMN 01 Ernest Van Dijckkaai
649,Ernest Van Dijckkaai,2023-02-25,18:00:00,191,114,77,FMN 01 Ernest Van Dijckkaai
649,Ernest Van Dijckkaai,2023-02-25,19:00:00,137,75,62,FMN 01 Ernest Van Dijckkaai
649,Ernest Van Dijckkaai,2023-02-25,20:00:00,117,62,55,FMN 01 Ernest Van Dijckkaai
649,Ernest Van Dijckkaai,2023-02-25,21:00:00,83,42,41,FMN 01 Ernest Van Dijckkaai
649,Ernest Van Dijckkaai,2023-02-25,22:00:00,98,51,47,FMN 01 Ernest Van Dijckkaai
649,Ernest Van Dijckkaai,2023-02-25,23:00:00,102,58,44,FMN 01 Ernest Van Dijckkaai
649,Ernest Van Dijckkaai,2023-02-26,00:00:00,85,45,40,FMN 01 Ernest Van Dijckkaai
649,Ernest Van Dijckkaai,2023-02-26,01:00:00,63,33,30,FMN 01 Ernest Van Dijckkaai
649,Ernest Van Dijckkaai,2023-02-26,02:00:00,42,24,18,FMN 01 Ernest Van Dijckkaai
649,Ernest Van Dijckkaai,2023-02-26,03:00:00,54,12,42,FMN 01 Ernest Van Dijckkaai
649,Ernest Van Dijckkaai,2023-02-26,04:00:00,35,9,26,FMN 01 Ernest Van Dijckkaai
649,Ernest Van Dijckkaai,2023-02-26,05:00:00,40,14,26,FMN 01 Ernest Van Dijckkaai
649,Ernest Van Dijckkaai,2023-02-26,06:00:00,47,11,36,FMN 01 Ernest Van Dijckkaai
649,Ernest Van Dijckkaai,2023-02-26,07:00:00,22,6,16,FMN 01 Ernest Van Dijckkaai
649,Ernest Van Dijckkaai,2023-02-26,08:00:00,44,18,26,FMN 01 Ernest Van Dijckkaai
649,Ernest Van Dijckkaai,2023-02-26,09:00:00,104,56,48,FMN 01 Ernest Van Dijckkaai
649,Ernest Van Dijckkaai,2023-02-26,10:00:00,137,86,51,FMN 01 Ernest Van Dijckkaai
649,Ernest Van Dijckkaai,2023-02-26,11:00:00,143,72,71,FMN 01 Ernest Van Dijckkaai
649,Ernest Van Dijckkaai,2023-02-26,12:00:00,200,112,88,FMN 01 Ernest Van Dijckkaai
649,Ernest Van Dijckkaai,2023-02-26,13:00:00,223,109,114,FMN 01 Ernest Van Dijckkaai
649,Ernest Van Dijckkaai,2023-02-26,14:00:00,308,160,148,FMN 01 Ernest Van Dijckkaai
649,Ernest Van Dijckkaai,2023-02-26,15:00:00,229,119,110,FMN 01 Ernest Van Dijckkaai
649,Ernest Van Dijckkaai,2023-02-26,16:00:00,204,107,97,FMN 01 Ernest Van Dijckkaai
649,Ernest Van Dijckkaai,2023-02-26,17:00:00,217,95,122,FMN 01 Ernest Van Dijckkaai
649,Ernest Van Dijckkaai,2023-02-26,18:00:00,154,81,73,FMN 01 Ernest Van Dijckkaai
649,Ernest Van Dijckkaai,2023-02-26,19:00:00,94,39,55,FMN 01 Ernest Van Dijckkaai
649,Ernest Van Dijckkaai,2023-02-26,20:00:00,57,26,31,FMN 01 Ernest Van Dijckkaai
649,Ernest Van Dijckkaai,2023-02-26,21:00:00,58,24,34,FMN 01 Ernest Van Dijckkaai
649,Ernest Van Dijckkaai,2023-02-26,22:00:00,51,21,30,FMN 01 Ernest Van Dijckkaai
649,Ernest Van Dijckkaai,2023-02-26,23:00:00,32,19,13,FMN 01 Ernest Van Dijckkaai
649,Ernest Van Dijckkaai,2023-02-27,00:00:00,13,7,6,FMN 01 Ernest Van Dijckkaai
649,Ernest Van Dijckkaai,2023-02-27,01:00:00,4,1,3,FMN 01 Ernest Van Dijckkaai
649,Ernest Van Dijckkaai,2023-02-27,02:00:00,5,0,5,FMN 01 Ernest Van Dijckkaai
649,Ernest Van Dijckkaai,2023-02-27,03:00:00,6,3,3,FMN 01 Ernest Van Dijckkaai
649,Ernest Van Dijckkaai,2023-02-27,04:00:00,51,36,15,FMN 01 Ernest Van Dijckkaai
649,Ernest Van Dijckkaai,2023-02-27,05:00:00,86,60,26,FMN 01 Ernest Van Dijckkaai
649,Ernest Van Dijckkaai,2023-02-27,06:00:00,196,133,63,FMN 01 Ernest Van Dijckkaai
649,Ernest Van Dijckkaai,2023-02-27,07:00:00,368,236,132,FMN 01 Ernest Van Dijckkaai
649,Ernest Van Dijckkaai,2023-02-27,08:00:00,481,284,197,FMN 01 Ernest Van Dijckkaai
649,Ernest Van Dijckkaai,2023-02-27,09:00:00,176,121,55,FMN 01 Ernest Van Dijckkaai
649,Ernest Van Dijckkaai,2023-02-27,10:00:00,145,109,36,FMN 01 Ernest Van Dijckkaai
649,Ernest Van Dijckkaai,2023-02-27,11:00:00,119,59,60,FMN 01 Ernest Van Dijckkaai
649,Ernest Van Dijckkaai,2023-02-27,12:00:00,221,125,96,FMN 01 Ernest Van Dijckkaai
649,Ernest Van Dijckkaai,2023-02-27,13:00:00,236,124,112,FMN 01 Ernest Van Dijckkaai
649,Ernest Van Dijckkaai,2023-02-27,14:00:00,267,145,122,FMN 01 Ernest Van Dijckkaai
649,Ernest Van Dijckkaai,2023-02-27,15:00:00,330,145,185,FMN 01 Ernest Van Dijckkaai
649,Ernest Van Dijckkaai,2023-02-27,16:00:00,591,240,351,FMN 01 Ernest Van Dijckkaai
649,Ernest Van Dijckkaai,2023-02-27,17:00:00,538,210,328,FMN 01 Ernest Van Dijckkaai
649,Ernest Van Dijckkaai,2023-02-27,18:00:00,338,165,173,FMN 01 Ernest Van Dijckkaai
649,Ernest Van Dijckkaai,2023-02-27,19:00:00,156,83,73,FMN 01 Ernest Van Dijckkaai
649,Ernest Van Dijckkaai,2023-02-27,20:00:00,94,40,54,FMN 01 Ernest Van Dijckkaai
649,Ernest Van Dijckkaai,2023-02-27,21:00:00,99,46,53,FMN 01 Ernest Van Dijckkaai
649,Ernest Van Dijckkaai,2023-02-27,22:00:00,108,40,68,FMN 01 Ernest Van Dijckkaai
649,Ernest Van Dijckkaai,2023-02-27,23:00:00,33,17,16,FMN 01 Ernest Van Dijckkaai
649,Ernest Van Dijckkaai,2023-02-28,00:00:00,17,7,10,FMN 01 Ernest Van Dijckkaai
649,Ernest Van Dijckkaai,2023-02-28,01:00:00,9,4,5,FMN 01 Ernest Van Dijckkaai
649,Ernest Van Dijckkaai,2023-02-28,02:00:00,1,0,1,FMN 01 Ernest Van Dijckkaai
649,Ernest Van Dijckkaai,2023-02-28,03:00:00,5,0,5,FMN 01 Ernest Van Dijckkaai
649,Ernest Van Dijckkaai,2023-02-28,04:00:00,56,45,11,FMN 01 Ernest Van Dijckkaai
649,Ernest Van Dijckkaai,2023-02-28,05:00:00,104,72,32,FMN 01 Ernest Van Dijckkaai
649,Ernest Van Dijckkaai,2023-02-28,06:00:00,217,144,73,FMN 01 Ernest Van Dijckkaai
649,Ernest Van Dijckkaai,2023-02-28,07:00:00,403,250,153,FMN 01 Ernest Van Dijckkaai
649,Ernest Van Dijckkaai,2023-02-28,08:00:00,552,356,196,FMN 01 Ernest Van Dijckkaai
649,Ernest Van Dijckkaai,2023-02-28,09:00:00,246,155,91,FMN 01 Ernest Van Dijckkaai
649,Ernest Van Dijckkaai,2023-02-28,10:00:00,142,81,61,FMN 01 Ernest Van Dijckkaai
649,Ernest Van Dijckkaai,2023-02-28,11:00:00,138,86,52,FMN 01 Ernest Van Dijckkaai
649,Ernest Van Dijckkaai,2023-02-28,12:00:00,248,129,119,FMN 01 Ernest Van Dijckkaai
649,Ernest Van Dijckkaai,2023-02-28,13:00:00,215,120,95,FMN 01 Ernest Van Dijckkaai
649,Ernest Van Dijckkaai,2023-02-28,14:00:00,285,118,167,FMN 01 Ernest Van Dijckkaai
649,Ernest Van Dijckkaai,2023-02-28,15:00:00,342,160,182,FMN 01 Ernest Van Dijckkaai
649,Ernest Van Dijckkaai,2023-02-28,16:00:00,601,251,350,FMN 01 Ernest Van Dijckkaai
649,Ernest Van Dijckkaai,2023-02-28,17:00:00,635,272,363,FMN 01 Ernest Van Dijckkaai
649,Ernest Van Dijckkaai,2023-02-28,18:00:00,398,176,222,FMN 01 Ernest Van Dijckkaai
649,Ernest Van Dijckkaai,2023-02-28,19:00:00,193,103,90,FMN 01 Ernest Van Dijckkaai
649,Ernest Van Dijckkaai,2023-02-28,20:00:00,150,65,85,FMN 01 Ernest Van Dijckkaai
649,Ernest Van Dijckkaai,2023-02-28,21:00:00,102,43,59,FMN 01 Ernest Van Dijckkaai
649,Ernest Van Dijckkaai,2023-02-28,22:00:00,96,43,53,FMN 01 Ernest Van Dijckkaai
649,Ernest Van Dijckkaai,2023-02-28,23:00:00,53,23,30,FMN 01 Ernest Van Dijckkaai
649,Ernest Van Dijckkaai,2023-03-01,00:00:00,27,18,9,FMN 01 Ernest Van Dijckkaai
649,Ernest Van Dijckkaai,2023-03-01,01:00:00,29,23,6,FMN 01 Ernest Van Dijckkaai
649,Ernest Van Dijckkaai,2023-03-01,02:00:00,10,1,9,FMN 01 Ernest Van Dijckkaai
649,Ernest Van Dijckkaai,2023-03-01,03:00:00,8,2,6,FMN 01 Ernest Van Dijckkaai
649,Ernest Van Dijckkaai,2023-03-01,04:00:00,68,36,32,FMN 01 Ernest Van Dijckkaai
649,Ernest Van Dijckkaai,2023-03-01,05:00:00,99,69,30,FMN 01 Ernest Van Dijckkaai
649,Ernest Van Dijckkaai,2023-03-01,06:00:00,194,129,65,FMN 01 Ernest Van Dijckkaai
649,Ernest Van Dijckkaai,2023-03-01,07:00:00,360,240,120,FMN 01 Ernest Van Dijckkaai
649,Ernest Van Dijckkaai,2023-03-01,08:00:00,473,303,170,FMN 01 Ernest Van Dijckkaai
649,Ernest Van Dijckkaai,2023-03-01,09:00:00,222,143,79,FMN 01 Ernest Van Dijckkaai
649,Ernest Van Dijckkaai,2023-03-01,10:00:00,142,89,53,FMN 01 Ernest Van Dijckkaai
649,Ernest Van Dijckkaai,2023-03-01,11:00:00,176,93,83,FMN 01 Ernest Van Dijckkaai
649,Ernest Van Dijckkaai,2023-03-01,12:00:00,324,165,159,FMN 01 Ernest Van Dijckkaai
649,Ernest Van Dijckkaai,2023-03-01,13:00:00,294,159,135,FMN 01 Ernest Van Dijckkaai
649,Ernest Van Dijckkaai,2023-03-01,14:00:00,295,133,162,FMN 01 Ernest Van Dijckkaai
649,Ernest Van Dijckkaai,2023-03-01,15:00:00,360,165,195,FMN 01 Ernest Van Dijckkaai
649,Ernest Van Dijckkaai,2023-03-01,16:00:00,523,197,326,FMN 01 Ernest Van Dijckkaai
649,Ernest Van Dijckkaai,2023-03-01,17:00:00,595,276,319,FMN 01 Ernest Van Dijckkaai
649,Ernest Van Dijckkaai,2023-03-01,18:00:00,372,198,174,FMN 01 Ernest Van Dijckkaai
649,Ernest Van Dijckkaai,2023-03-01,19:00:00,203,99,104,FMN 01 Ernest Van Dijckkaai
649,Ernest Van Dijckkaai,2023-03-01,20:00:00,95,38,57,FMN 01 Ernest Van Dijckkaai
649,Ernest Van Dijckkaai,2023-03-01,21:00:00,118,48,70,FMN 01 Ernest Van Dijckkaai
649,Ernest Van Dijckkaai,2023-03-01,22:00:00,143,54,89,FMN 01 Ernest Van Dijckkaai
649,Ernest Van Dijckkaai,2023-03-01,23:00:00,52,16,36,FMN 01 Ernest Van Dijckkaai
649,Ernest Van Dijckkaai,2023-03-02,00:00:00,25,17,8,FMN 01 Ernest Van Dijckkaai
649,Ernest Van Dijckkaai,2023-03-02,01:00:00,15,6,9,FMN 01 Ernest Van Dijckkaai
649,Ernest Van Dijckkaai,2023-03-02,02:00:00,4,3,1,FMN 01 Ernest Van Dijckkaai
649,Ernest Van Dijckkaai,2023-03-02,03:00:00,6,1,5,FMN 01 Ernest Van Dijckkaai
649,Ernest Van Dijckkaai,2023-03-02,04:00:00,51,36,15,FMN 01 Ernest Van Dijckkaai
649,Ernest Van Dijckkaai,2023-03-02,05:00:00,94,65,29,FMN 01 Ernest Van Dijckkaai
649,Ernest Van Dijckkaai,2023-03-02,06:00:00,220,132,88,FMN 01 Ernest Van Dijckkaai
649,Ernest Van Dijckkaai,2023-03-02,07:00:00,362,231,131,FMN 01 Ernest Van Dijckkaai
649,Ernest Van Dijckkaai,2023-03-02,08:00:00,542,332,210,FMN 01 Ernest Van Dijckkaai
649,Ernest Van Dijckkaai,2023-03-02,09:00:00,207,123,84,FMN 01 Ernest Van Dijckkaai
649,Ernest Van Dijckkaai,2023-03-02,10:00:00,136,80,56,FMN 01 Ernest Van Dijckkaai
649,Ernest Van Dijckkaai,2023-03-02,11:00:00,164,94,70,FMN 01 Ernest Van Dijckkaai
649,Ernest Van Dijckkaai,2023-03-02,12:00:00,263,133,130,FMN 01 Ernest Van Dijckkaai
649,Ernest Van Dijckkaai,2023-03-02,13:00:00,261,149,112,FMN 01 Ernest Van Dijckkaai
649,Ernest Van Dijckkaai,2023-03-02,14:00:00,306,131,175,FMN 01 Ernest Van Dijckkaai
649,Ernest Van Dijckkaai,2023-03-02,15:00:00,408,186,222,FMN 01 Ernest Van Dijckkaai
649,Ernest Van Dijckkaai,2023-03-02,16:00:00,607,253,354,FMN 01 Ernest Van Dijckkaai
649,Ernest Van Dijckkaai,2023-03-02,17:00:00,616,282,334,FMN 01 Ernest Van Dijckkaai
649,Ernest Van Dijckkaai,2023-03-02,18:00:00,433,229,204,FMN 01 Ernest Van Dijckkaai
649,Ernest Van Dijckkaai,2023-03-02,19:00:00,217,116,101,FMN 01 Ernest Van Dijckkaai
649,Ernest Van Dijckkaai,2023-03-02,20:00:00,129,62,67,FMN 01 Ernest Van Dijckkaai
649,Ernest Van Dijckkaai,2023-03-02,21:00:00,126,57,69,FMN 01 Ernest Van Dijckkaai
649,Ernest Van Dijckkaai,2023-03-02,22:00:00,137,45,92,FMN 01 Ernest Van Dijckkaai
649,Ernest Van Dijckkaai,2023-03-02,23:00:00,71,27,44,FMN 01 Ernest Van Dijckkaai
649,Ernest Van Dijckkaai,2023-03-03,00:00:00,60,33,27,FMN 01 Ernest Van Dijckkaai
649,Ernest Van Dijckkaai,2023-03-03,01:00:00,21,8,13,FMN 01 Ernest Van Dijckkaai
649,Ernest Van Dijckkaai,2023-03-03,02:00:00,10,2,8,FMN 01 Ernest Van Dijckkaai
649,Ernest Van Dijckkaai,2023-03-03,03:00:00,18,3,15,FMN 01 Ernest Van Dijckkaai
649,Ernest Van Dijckkaai,2023-03-03,04:00:00,63,37,26,FMN 01 Ernest Van Dijckkaai
649,Ernest Van Dijckkaai,2023-03-03,05:00:00,91,51,40,FMN 01 Ernest Van Dijckkaai
649,Ernest Van Dijckkaai,2023-03-03,06:00:00,172,111,61,FMN 01 Ernest Van Dijckkaai
649,Ernest Van Dijckkaai,2023-03-03,07:00:00,322,206,116,FMN 01 Ernest Van Dijckkaai
649,Ernest Van Dijckkaai,2023-03-03,08:00:00,463,295,168,FMN 01 Ernest Van Dijckkaai
649,Ernest Van Dijckkaai,2023-03-03,09:00:00,212,138,74,FMN 01 Ernest Van Dijckkaai
649,Ernest Van Dijckkaai,2023-03-03,10:00:00,156,96,60,FMN 01 Ernest Van Dijckkaai
649,Ernest Van Dijckkaai,2023-03-03,11:00:00,155,87,68,FMN 01 Ernest Van Dijckkaai
649,Ernest Van Dijckkaai,2023-03-03,12:00:00,255,122,133,FMN 01 Ernest Van Dijckkaai
649,Ernest Van Dijckkaai,2023-03-03,13:00:00,243,126,117,FMN 01 Ernest Van Dijckkaai
649,Ernest Van Dijckkaai,2023-03-03,14:00:00,329,184,145,FMN 01 Ernest Van Dijckkaai
649,Ernest Van Dijckkaai,2023-03-03,15:00:00,393,180,213,FMN 01 Ernest Van Dijckkaai
649,Ernest Van Dijckkaai,2023-03-03,16:00:00,512,192,320,FMN 01 Ernest Van Dijckkaai
649,Ernest Van Dijckkaai,2023-03-03,17:00:00,440,182,258,FMN 01 Ernest Van Dijckkaai
649,Ernest Van Dijckkaai,2023-03-03,18:00:00,298,146,152,FMN 01 Ernest Van Dijckkaai
649,Ernest Van Dijckkaai,2023-03-03,19:00:00,226,130,96,FMN 01 Ernest Van Dijckkaai
649,Ernest Van Dijckkaai,2023-03-03,20:00:00,160,86,74,FMN 01 Ernest Van Dijckkaai
649,Ernest Van Dijckkaai,2023-03-03,21:00:00,131,52,79,FMN 01 Ernest Van Dijckkaai
649,Ernest Van Dijckkaai,2023-03-03,22:00:00,134,54,80,FMN 01 Ernest Van Dijckkaai
649,Ernest Van Dijckkaai,2023-03-03,23:00:00,100,43,57,FMN 01 Ernest Van Dijckkaai
649,Ernest Van Dijckkaai,2023-03-04,00:00:00,80,40,40,FMN 01 Ernest Van Dijckkaai
649,Ernest Van Dijckkaai,2023-03-04,01:00:00,88,46,42,FMN 01 Ernest Van Dijckkaai
649,Ernest Van Dijckkaai,2023-03-04,02:00:00,41,14,27,FMN 01 Ernest Van Dijckkaai
649,Ernest Van Dijckkaai,2023-03-04,03:00:00,37,8,29,FMN 01 Ernest Van Dijckkaai
649,Ernest Van Dijckkaai,2023-03-04,04:00:00,55,26,29,FMN 01 Ernest Van Dijckkaai
649,Ernest Van Dijckkaai,2023-03-04,05:00:00,42,16,26,FMN 01 Ernest Van Dijckkaai
649,Ernest Van Dijckkaai,2023-03-04,06:00:00,55,11,44,FMN 01 Ernest Van Dijckkaai
649,Ernest Van Dijckkaai,2023-03-04,07:00:00,30,8,22,FMN 01 Ernest Van Dijckkaai
649,Ernest Van Dijckkaai,2023-03-04,08:00:00,67,39,28,FMN 01 Ernest Van Dijckkaai
649,Ernest Van Dijckkaai,2023-03-04,09:00:00,110,70,40,FMN 01 Ernest Van Dijckkaai
649,Ernest Van Dijckkaai,2023-03-04,10:00:00,146,88,58,FMN 01 Ernest Van Dijckkaai
649,Ernest Van Dijckkaai,2023-03-04,11:00:00,184,106,78,FMN 01 Ernest Van Dijckkaai
649,Ernest Van Dijckkaai,2023-03-04,12:00:00,199,127,72,FMN 01 Ernest Van Dijckkaai
649,Ernest Van Dijckkaai,2023-03-04,13:00:00,205,105,100,FMN 01 Ernest Van Dijckkaai
649,Ernest Van Dijckkaai,2023-03-04,14:00:00,208,93,115,FMN 01 Ernest Van Dijckkaai
649,Ernest Van Dijckkaai,2023-03-04,15:00:00,190,109,81,FMN 01 Ernest Van Dijckkaai
649,Ernest Van Dijckkaai,2023-03-04,16:00:00,191,88,103,FMN 01 Ernest Van Dijckkaai
649,Ernest Van Dijckkaai,2023-03-04,17:00:00,213,117,96,FMN 01 Ernest Van Dijckkaai
649,Ernest Van Dijckkaai,2023-03-04,18:00:00,181,87,94,FMN 01 Ernest Van Dijckkaai
649,Ernest Van Dijckkaai,2023-03-04,19:00:00,121,78,43,FMN 01 Ernest Van Dijckkaai
649,Ernest Van Dijckkaai,2023-03-04,20:00:00,129,84,45,FMN 01 Ernest Van Dijckkaai
649,Ernest Van Dijckkaai,2023-03-04,21:00:00,78,44,34,FMN 01 Ernest Van Dijckkaai
649,Ernest Van Dijckkaai,2023-03-04,22:00:00,84,36,48,FMN 01 Ernest Van Dijckkaai
649,Ernest Van Dijckkaai,2023-03-04,23:00:00,108,52,56,FMN 01 Ernest Van Dijckkaai
649,Ernest Van Dijckkaai,2023-03-05,00:00:00,67,31,36,FMN 01 Ernest Van Dijckkaai
649,Ernest Van Dijckkaai,2023-03-05,01:00:00,39,12,27,FMN 01 Ernest Van Dijckkaai
649,Ernest Van Dijckkaai,2023-03-05,02:00:00,43,12,31,FMN 01 Ernest Van Dijckkaai
649,Ernest Van Dijckkaai,2023-03-05,03:00:00,36,10,26,FMN 01 Ernest Van Dijckkaai
649,Ernest Van Dijckkaai,2023-03-05,04:00:00,29,6,23,FMN 01 Ernest Van Dijckkaai
649,Ernest Van Dijckkaai,2023-03-05,05:00:00,31,10,21,FMN 01 Ernest Van Dijckkaai
649,Ernest Van Dijckkaai,2023-03-05,06:00:00,28,13,15,FMN 01 Ernest Van Dijckkaai
649,Ernest Van Dijckkaai,2023-03-05,07:00:00,19,8,11,FMN 01 Ernest Van Dijckkaai
649,Ernest Van Dijckkaai,2023-03-05,08:00:00,46,28,18,FMN 01 Ernest Van Dijckkaai
649,Ernest Van Dijckkaai,2023-03-05,09:00:00,64,35,29,FMN 01 Ernest Van Dijckkaai
649,Ernest Van Dijckkaai,2023-03-05,10:00:00,104,73,31,FMN 01 Ernest Van Dijckkaai
649,Ernest Van Dijckkaai,2023-03-05,11:00:00,123,76,47,FMN 01 Ernest Van Dijckkaai
649,Ernest Van Dijckkaai,2023-03-05,12:00:00,133,86,47,FMN 01 Ernest Van Dijckkaai
649,Ernest Van Dijckkaai,2023-03-05,13:00:00,139,79,60,FMN 01 Ernest Van Dijckkaai
649,Ernest Van Dijckkaai,2023-03-05,14:00:00,164,84,80,FMN 01 Ernest Van Dijckkaai
649,Ernest Van Dijckkaai,2023-03-05,15:00:00,151,79,72,FMN 01 Ernest Van Dijckkaai
649,Ernest Van Dijckkaai,2023-03-05,16:00:00,158,73,85,FMN 01 Ernest Van Dijckkaai
649,Ernest Van Dijckkaai,2023-03-05,17:00:00,118,50,68,FMN 01 Ernest Van Dijckkaai
649,Ernest Van Dijckkaai,2023-03-05,18:00:00,93,43,50,FMN 01 Ernest Van Dijckkaai
649,Ernest Van Dijckkaai,2023-03-05,19:00:00,89,39,50,FMN 01 Ernest Van Dijckkaai
649,Ernest Van Dijckkaai,2023-03-05,20:00:00,49,14,35,FMN 01 Ernest Van Dijckkaai
649,Ernest Van Dijckkaai,2023-03-05,21:00:00,43,25,18,FMN 01 Ernest Van Dijckkaai
649,Ernest Van Dijckkaai,2023-03-05,22:00:00,38,13,25,FMN 01 Ernest Van Dijckkaai
649,Ernest Van Dijckkaai,2023-03-05,23:00:00,25,7,18,FMN 01 Ernest Van Dijckkaai
649,Ernest Van Dijckkaai,2023-03-06,00:00:00,9,5,4,FMN 01 Ernest Van Dijckkaai
649,Ernest Van Dijckkaai,2023-03-06,01:00:00,6,3,3,FMN 01 Ernest Van Dijckkaai
649,Ernest Van Dijckkaai,2023-03-06,02:00:00,4,1,3,FMN 01 Ernest Van Dijckkaai
649,Ernest Van Dijckkaai,2023-03-06,03:00:00,7,3,4,FMN 01 Ernest Van Dijckkaai
649,Ernest Van Dijckkaai,2023-03-06,04:00:00,39,29,10,FMN 01 Ernest Van Dijckkaai
649,Ernest Van Dijckkaai,2023-03-06,05:00:00,67,40,27,FMN 01 Ernest Van Dijckkaai
649,Ernest Van Dijckkaai,2023-03-06,06:00:00,197,136,61,FMN 01 Ernest Van Dijckkaai
649,Ernest Van Dijckkaai,2023-03-06,07:00:00,334,209,125,FMN 01 Ernest Van Dijckkaai
649,Ernest Van Dijckkaai,2023-03-06,08:00:00,516,310,206,FMN 01 Ernest Van Dijckkaai
649,Ernest Van Dijckkaai,2023-03-06,09:00:00,198,120,78,FMN 01 Ernest Van Dijckkaai
649,Ernest Van Dijckkaai,2023-03-06,10:00:00,115,81,34,FMN 01 Ernest Van Dijckkaai
649,Ernest Van Dijckkaai,2023-03-06,11:00:00,108,54,54,FMN 01 Ernest Van Dijckkaai
649,Ernest Van Dijckkaai,2023-03-06,12:00:00,196,104,92,FMN 01 Ernest Van Dijckkaai
649,Ernest Van Dijckkaai,2023-03-06,13:00:00,187,107,80,FMN 01 Ernest Van Dijckkaai
649,Ernest Van Dijckkaai,2023-03-06,14:00:00,196,85,111,FMN 01 Ernest Van Dijckkaai
649,Ernest Van Dijckkaai,2023-03-06,15:00:00,278,141,137,FMN 01 Ernest Van Dijckkaai
649,Ernest Van Dijckkaai,2023-03-06,16:00:00,462,178,284,FMN 01 Ernest Van Dijckkaai
649,Ernest Van Dijckkaai,2023-03-06,17:00:00,503,208,295,FMN 01 Ernest Van Dijckkaai
649,Ernest Van Dijckkaai,2023-03-06,18:00:00,292,150,142,FMN 01 Ernest Van Dijckkaai
649,Ernest Van Dijckkaai,2023-03-06,19:00:00,131,66,65,FMN 01 Ernest Van Dijckkaai
649,Ernest Van Dijckkaai,2023-03-06,20:00:00,99,43,56,FMN 01 Ernest Van Dijckkaai
649,Ernest Van Dijckkaai,2023-03-06,21:00:00,74,36,38,FMN 01 Ernest Van Dijckkaai
649,Ernest Van Dijckkaai,2023-03-06,22:00:00,88,22,66,FMN 01 Ernest Van Dijckkaai
649,Ernest Van Dijckkaai,2023-03-06,23:00:00,40,11,29,FMN 01 Ernest Van Dijckkaai
649,Ernest Van Dijckkaai,2023-03-07,00:00:00,9,4,5,FMN 01 Ernest Van Dijckkaai
649,Ernest Van Dijckkaai,2023-03-07,01:00:00,3,1,2,FMN 01 Ernest Van Dijckkaai
649,Ernest Van Dijckkaai,2023-03-07,02:00:00,2,1,1,FMN 01 Ernest Van Dijckkaai
649,Ernest Van Dijckkaai,2023-03-07,03:00:00,2,1,1,FMN 01 Ernest Van Dijckkaai
649,Ernest Van Dijckkaai,2023-03-07,04:00:00,30,21,9,FMN 01 Ernest Van Dijckkaai
649,Ernest Van Dijckkaai,2023-03-07,05:00:00,69,48,21,FMN 01 Ernest Van Dijckkaai
649,Ernest Van Dijckkaai,2023-03-07,06:00:00,175,113,62,FMN 01 Ernest Van Dijckkaai
649,Ernest Van Dijckkaai,2023-03-07,07:00:00,316,203,113,FMN 01 Ernest Van Dijckkaai
649,Ernest Van Dijckkaai,2023-03-07,08:00:00,445,281,164,FMN 01 Ernest Van Dijckkaai
649,Ernest Van Dijckkaai,2023-03-07,09:00:00,185,123,62,FMN 01 Ernest Van Dijckkaai
649,Ernest Van Dijckkaai,2023-03-07,10:00:00,93,57,36,FMN 01 Ernest Van Dijckkaai
649,Ernest Van Dijckkaai,2023-03-07,11:00:00,97,61,36,FMN 01 Ernest Van Dijckkaai
649,Ernest Van Dijckkaai,2023-03-07,12:00:00,158,83,75,FMN 01 Ernest Van Dijckkaai
649,Ernest Van Dijckkaai,2023-03-07,13:00:00,142,89,53,FMN 01 Ernest Van Dijckkaai
649,Ernest Van Dijckkaai,2023-03-07,14:00:00,129,59,70,FMN 01 Ernest Van Dijckkaai
649,Ernest Van Dijckkaai,2023-03-07,15:00:00,186,92,94,FMN 01 Ernest Van Dijckkaai
649,Ernest Van Dijckkaai,2023-03-07,16:00:00,351,133,218,FMN 01 Ernest Van Dijckkaai
649,Ernest Van Dijckkaai,2023-03-07,17:00:00,430,183,247,FMN 01 Ernest Van Dijckkaai
649,Ernest Van Dijckkaai,2023-03-07,18:00:00,244,118,126,FMN 01 Ernest Van Dijckkaai
649,Ernest Van Dijckkaai,2023-03-07,19:00:00,126,59,67,FMN 01 Ernest Van Dijckkaai
649,Ernest Van Dijckkaai,2023-03-07,20:00:00,97,49,48,FMN 01 Ernest Van Dijckkaai
649,Ernest Van Dijckkaai,2023-03-07,21:00:00,76,39,37,FMN 01 Ernest Van Dijckkaai
649,Ernest Van Dijckkaai,2023-03-07,22:00:00,93,41,52,FMN 01 Ernest Van Dijckkaai
649,Ernest Van Dijckkaai,2023-03-07,23:00:00,27,10,17,FMN 01 Ernest Van Dijckkaai
649,Ernest Van Dijckkaai,2023-03-08,00:00:00,36,20,16,FMN 01 Ernest Van Dijckkaai
649,Ernest Van Dijckkaai,2023-03-08,01:00:00,15,4,11,FMN 01 Ernest Van Dijckkaai
649,Ernest Van Dijckkaai,2023-03-08,02:00:00,10,1,9,FMN 01 Ernest Van Dijckkaai
649,Ernest Van Dijckkaai,2023-03-08,03:00:00,17,5,12,FMN 01 Ernest Van Dijckkaai
649,Ernest Van Dijckkaai,2023-03-08,04:00:00,41,16,25,FMN 01 Ernest Van Dijckkaai
649,Ernest Van Dijckkaai,2023-03-08,05:00:00,69,45,24,FMN 01 Ernest Van Dijckkaai
649,Ernest Van Dijckkaai,2023-03-08,06:00:00,140,97,43,FMN 01 Ernest Van Dijckkaai
649,Ernest Van Dijckkaai,2023-03-08,07:00:00,212,139,73,FMN 01 Ernest Van Dijckkaai
649,Ernest Van Dijckkaai,2023-03-08,08:00:00,244,160,84,FMN 01 Ernest Van Dijckkaai
649,Ernest Van Dijckkaai,2023-03-08,09:00:00,116,64,52,FMN 01 Ernest Van Dijckkaai
649,Ernest Van Dijckkaai,2023-03-08,10:00:00,54,36,18,FMN 01 Ernest Van Dijckkaai
649,Ernest Van Dijckkaai,2023-03-08,11:00:00,73,40,33,FMN 01 Ernest Van Dijckkaai
649,Ernest Van Dijckkaai,2023-03-08,12:00:00,147,76,71,FMN 01 Ernest Van Dijckkaai
649,Ernest Van Dijckkaai,2023-03-08,13:00:00,133,77,56,FMN 01 Ernest Van Dijckkaai
649,Ernest Van Dijckkaai,2023-03-08,14:00:00,140,72,68,FMN 01 Ernest Van Dijckkaai
649,Ernest Van Dijckkaai,2023-03-08,15:00:00,167,75,92,FMN 01 Ernest Van Dijckkaai
649,Ernest Van Dijckkaai,2023-03-08,16:00:00,243,95,148,FMN 01 Ernest Van Dijckkaai
649,Ernest Van Dijckkaai,2023-03-08,17:00:00,287,114,173,FMN 01 Ernest Van Dijckkaai
649,Ernest Van Dijckkaai,2023-03-08,18:00:00,183,95,88,FMN 01 Ernest Van Dijckkaai
649,Ernest Van Dijckkaai,2023-03-08,19:00:00,102,53,49,FMN 01 Ernest Van Dijckkaai
649,Ernest Van Dijckkaai,2023-03-08,20:00:00,71,37,34,FMN 01 Ernest Van Dijckkaai
649,Ernest Van Dijckkaai,2023-03-08,21:00:00,68,29,39,FMN 01 Ernest Van Dijckkaai
649,Ernest Van Dijckkaai,2023-03-08,22:00:00,92,33,59,FMN 01 Ernest Van Dijckkaai
649,Ernest Van Dijckkaai,2023-03-08,23:00:00,37,12,25,FMN 01 Ernest Van Dijckkaai
649,Ernest Van Dijckkaai,2023-03-09,00:00:00,28,14,14,FMN 01 Ernest Van Dijckkaai
649,Ernest Van Dijckkaai,2023-03-09,01:00:00,12,4,8,FMN 01 Ernest Van Dijckkaai
649,Ernest Van Dijckkaai,2023-03-09,02:00:00,4,0,4,FMN 01 Ernest Van Dijckkaai
649,Ernest Van Dijckkaai,2023-03-09,03:00:00,7,2,5,FMN 01 Ernest Van Dijckkaai
649,Ernest Van Dijckkaai,2023-03-09,04:00:00,32,20,12,FMN 01 Ernest Van Dijckkaai
649,Ernest Van Dijckkaai,2023-03-09,05:00:00,86,52,34,FMN 01 Ernest Van Dijckkaai
649,Ernest Van Dijckkaai,2023-03-09,06:00:00,135,93,42,FMN 01 Ernest Van Dijckkaai
649,Ernest Van Dijckkaai,2023-03-09,07:00:00,265,171,94,FMN 01 Ernest Van Dijckkaai
649,Ernest Van Dijckkaai,2023-03-09,08:00:00,424,278,146,FMN 01 Ernest Van Dijckkaai
649,Ernest Van Dijckkaai,2023-03-09,09:00:00,199,117,82,FMN 01 Ernest Van Dijckkaai
649,Ernest Van Dijckkaai,2023-03-09,10:00:00,120,78,42,FMN 01 Ernest Van Dijckkaai
649,Ernest Van Dijckkaai,2023-03-09,11:00:00,79,45,34,FMN 01 Ernest Van Dijckkaai
649,Ernest Van Dijckkaai,2023-03-09,12:00:00,143,77,66,FMN 01 Ernest Van Dijckkaai
649,Ernest Van Dijckkaai,2023-03-09,13:00:00,158,102,56,FMN 01 Ernest Van Dijckkaai
649,Ernest Van Dijckkaai,2023-03-09,14:00:00,149,80,69,FMN 01 Ernest Van Dijckkaai
649,Ernest Van Dijckkaai,2023-03-09,15:00:00,226,108,118,FMN 01 Ernest Van Dijckkaai
649,Ernest Van Dijckkaai,2023-03-09,16:00:00,394,174,220,FMN 01 Ernest Van Dijckkaai
649,Ernest Van Dijckkaai,2023-03-09,17:00:00,411,188,223,FMN 01 Ernest Van Dijckkaai
649,Ernest Van Dijckkaai,2023-03-09,18:00:00,266,118,148,FMN 01 Ernest Van Dijckkaai
649,Ernest Van Dijckkaai,2023-03-09,19:00:00,110,58,52,FMN 01 Ernest Van Dijckkaai
649,Ernest Van Dijckkaai,2023-03-09,20:00:00,106,55,51,FMN 01 Ernest Van Dijckkaai
649,Ernest Van Dijckkaai,2023-03-09,21:00:00,87,38,49,FMN 01 Ernest Van Dijckkaai
649,Ernest Van Dijckkaai,2023-03-09,22:00:00,77,24,53,FMN 01 Ernest Van Dijckkaai
649,Ernest Van Dijckkaai,2023-03-09,23:00:00,41,16,25,FMN 01 Ernest Van Dijckkaai
649,Ernest Van Dijckkaai,2023-03-10,00:00:00,50,29,21,FMN 01 Ernest Van Dijckkaai
649,Ernest Van Dijckkaai,2023-03-10,01:00:00,27,7,20,FMN 01 Ernest Van Dijckkaai
649,Ernest Van Dijckkaai,2023-03-10,02:00:00,29,4,25,FMN 01 Ernest Van Dijckkaai
649,Ernest Van Dijckkaai,2023-03-10,03:00:00,23,3,20,FMN 01 Ernest Van Dijckkaai
649,Ernest Van Dijckkaai,2023-03-10,04:00:00,37,13,24,FMN 01 Ernest Van Dijckkaai
649,Ernest Van Dijckkaai,2023-03-10,05:00:00,81,51,30,FMN 01 Ernest Van Dijckkaai
649,Ernest Van Dijckkaai,2023-03-10,06:00:00,144,94,50,FMN 01 Ernest Van Dijckkaai
649,Ernest Van Dijckkaai,2023-03-10,07:00:00,293,190,103,FMN 01 Ernest Van Dijckkaai
649,Ernest Van Dijckkaai,2023-03-10,08:00:00,391,257,134,FMN 01 Ernest Van Dijckkaai
649,Ernest Van Dijckkaai,2023-03-10,09:00:00,153,95,58,FMN 01 Ernest Van Dijckkaai
649,Ernest Van Dijckkaai,2023-03-10,10:00:00,107,67,40,FMN 01 Ernest Van Dijckkaai
649,Ernest Van Dijckkaai,2023-03-10,11:00:00,117,68,49,FMN 01 Ernest Van Dijckkaai
649,Ernest Van Dijckkaai,2023-03-10,12:00:00,211,113,98,FMN 01 Ernest Van Dijckkaai
649,Ernest Van Dijckkaai,2023-03-10,13:00:00,152,90,62,FMN 01 Ernest Van Dijckkaai
649,Ernest Van Dijckkaai,2023-03-10,14:00:00,157,70,87,FMN 01 Ernest Van Dijckkaai
649,Ernest Van Dijckkaai,2023-03-10,15:00:00,206,96,110,FMN 01 Ernest Van Dijckkaai
649,Ernest Van Dijckkaai,2023-03-10,16:00:00,316,116,200,FMN 01 Ernest Van Dijckkaai
649,Ernest Van Dijckkaai,2023-03-10,17:00:00,306,137,169,FMN 01 Ernest Van Dijckkaai
649,Ernest Van Dijckkaai,2023-03-10,18:00:00,191,93,98,FMN 01 Ernest Van Dijckkaai
649,Ernest Van Dijckkaai,2023-03-10,19:00:00,146,72,74,FMN 01 Ernest Van Dijckkaai
649,Ernest Van Dijckkaai,2023-03-10,20:00:00,119,56,63,FMN 01 Ernest Van Dijckkaai
649,Ernest Van Dijckkaai,2023-03-10,21:00:00,87,49,38,FMN 01 Ernest Van Dijckkaai
649,Ernest Van Dijckkaai,2023-03-10,22:00:00,115,70,45,FMN 01 Ernest Van Dijckkaai
649,Ernest Van Dijckkaai,2023-03-10,23:00:00,131,63,68,FMN 01 Ernest Van Dijckkaai
649,Ernest Van Dijckkaai,2023-03-11,00:00:00,95,37,58,FMN 01 Ernest Van Dijckkaai
649,Ernest Van Dijckkaai,2023-03-11,01:00:00,63,21,42,FMN 01 Ernest Van Dijckkaai
649,Ernest Van Dijckkaai,2023-03-11,02:00:00,70,18,52,FMN 01 Ernest Van Dijckkaai
649,Ernest Van Dijckkaai,2023-03-11,03:00:00,63,11,52,FMN 01 Ernest Van Dijckkaai
649,Ernest Van Dijckkaai,2023-03-11,04:00:00,71,25,46,FMN 01 Ernest Van Dijckkaai
649,Ernest Van Dijckkaai,2023-03-11,05:00:00,57,16,41,FMN 01 Ernest Van Dijckkaai
649,Ernest Van Dijckkaai,2023-03-11,06:00:00,41,17,24,FMN 01 Ernest Van Dijckkaai
649,Ernest Van Dijckkaai,2023-03-11,07:00:00,22,7,15,FMN 01 Ernest Van Dijckkaai
649,Ernest Van Dijckkaai,2023-03-11,08:00:00,54,32,22,FMN 01 Ernest Van Dijckkaai
649,Ernest Van Dijckkaai,2023-03-11,09:00:00,116,67,49,FMN 01 Ernest Van Dijckkaai
649,Ernest Van Dijckkaai,2023-03-11,10:00:00,145,82,63,FMN 01 Ernest Van Dijckkaai
649,Ernest Van Dijckkaai,2023-03-11,11:00:00,186,113,73,FMN 01 Ernest Van Dijckkaai
649,Ernest Van Dijckkaai,2023-03-11,12:00:00,229,123,106,FMN 01 Ernest Van Dijckkaai
649,Ernest Van Dijckkaai,2023-03-11,13:00:00,255,129,126,FMN 01 Ernest Van Dijckkaai
649,Ernest Van Dijckkaai,2023-03-11,14:00:00,364,197,167,FMN 01 Ernest Van Dijckkaai
649,Ernest Van Dijckkaai,2023-03-11,15:00:00,374,204,170,FMN 01 Ernest Van Dijckkaai
649,Ernest Van Dijckkaai,2023-03-11,16:00:00,355,185,170,FMN 01 Ernest Van Dijckkaai
649,Ernest Van Dijckkaai,2023-03-11,17:00:00,317,153,164,FMN 01 Ernest Van Dijckkaai
649,Ernest Van Dijckkaai,2023-03-11,18:00:00,270,140,130,FMN 01 Ernest Van Dijckkaai
649,Ernest Van Dijckkaai,2023-03-11,19:00:00,169,86,83,FMN 01 Ernest Van Dijckkaai
649,Ernest Van Dijckkaai,2023-03-11,20:00:00,135,61,74,FMN 01 Ernest Van Dijckkaai
649,Ernest Van Dijckkaai,2023-03-11,21:00:00,101,56,45,FMN 01 Ernest Van Dijckkaai
649,Ernest Van Dijckkaai,2023-03-11,22:00:00,123,56,67,FMN 01 Ernest Van Dijckkaai
649,Ernest Van Dijckkaai,2023-03-11,23:00:00,163,102,61,FMN 01 Ernest Van Dijckkaai
649,Ernest Van Dijckkaai,2023-03-12,00:00:00,85,40,45,FMN 01 Ernest Van Dijckkaai
649,Ernest Van Dijckkaai,2023-03-12,01:00:00,67,22,45,FMN 01 Ernest Van Dijckkaai
649,Ernest Van Dijckkaai,2023-03-12,02:00:00,58,10,48,FMN 01 Ernest Van Dijckkaai
649,Ernest Van Dijckkaai,2023-03-12,03:00:00,50,12,38,FMN 01 Ernest Van Dijckkaai
649,Ernest Van Dijckkaai,2023-03-12,04:00:00,56,9,47,FMN 01 Ernest Van Dijckkaai
649,Ernest Van Dijckkaai,2023-03-12,05:00:00,38,9,29,FMN 01 Ernest Van Dijckkaai
649,Ernest Van Dijckkaai,2023-03-12,06:00:00,45,11,34,FMN 01 Ernest Van Dijckkaai
649,Ernest Van Dijckkaai,2023-03-12,07:00:00,12,8,4,FMN 01 Ernest Van Dijckkaai
649,Ernest Van Dijckkaai,2023-03-12,08:00:00,45,26,19,FMN 01 Ernest Van Dijckkaai
649,Ernest Van Dijckkaai,2023-03-12,09:00:00,78,41,37,FMN 01 Ernest Van Dijckkaai
649,Ernest Van Dijckkaai,2023-03-12,10:00:00,101,49,52,FMN 01 Ernest Van Dijckkaai
649,Ernest Van Dijckkaai,2023-03-12,11:00:00,117,77,40,FMN 01 Ernest Van Dijckkaai
649,Ernest Van Dijckkaai,2023-03-12,12:00:00,153,92,61,FMN 01 Ernest Van Dijckkaai
649,Ernest Van Dijckkaai,2023-03-12,13:00:00,185,100,85,FMN 01 Ernest Van Dijckkaai
649,Ernest Van Dijckkaai,2023-03-12,14:00:00,195,111,84,FMN 01 Ernest Van Dijckkaai
649,Ernest Van Dijckkaai,2023-03-12,15:00:00,194,124,70,FMN 01 Ernest Van Dijckkaai
649,Ernest Van Dijckkaai,2023-03-12,16:00:00,181,104,77,FMN 01 Ernest Van Dijckkaai
649,Ernest Van Dijckkaai,2023-03-12,17:00:00,178,71,107,FMN 01 Ernest Van Dijckkaai
649,Ernest Van Dijckkaai,2023-03-12,18:00:00,166,94,72,FMN 01 Ernest Van Dijckkaai
649,Ernest Van Dijckkaai,2023-03-12,19:00:00,114,54,60,FMN 01 Ernest Van Dijckkaai
649,Ernest Van Dijckkaai,2023-03-12,20:00:00,76,42,34,FMN 01 Ernest Van Dijckkaai
649,Ernest Van Dijckkaai,2023-03-12,21:00:00,62,31,31,FMN 01 Ernest Van Dijckkaai
649,Ernest Van Dijckkaai,2023-03-12,22:00:00,57,26,31,FMN 01 Ernest Van Dijckkaai
649,Ernest Van Dijckkaai,2023-03-12,23:00:00,44,13,31,FMN 01 Ernest Van Dijckkaai
649,Ernest Van Dijckkaai,2023-03-13,00:00:00,21,7,14,FMN 01 Ernest Van Dijckkaai
649,Ernest Van Dijckkaai,2023-03-13,01:00:00,15,3,12,FMN 01 Ernest Van Dijckkaai
649,Ernest Van Dijckkaai,2023-03-13,02:00:00,5,1,4,FMN 01 Ernest Van Dijckkaai
649,Ernest Van Dijckkaai,2023-03-13,03:00:00,8,3,5,FMN 01 Ernest Van Dijckkaai
649,Ernest Van Dijckkaai,2023-03-13,04:00:00,40,29,11,FMN 01 Ernest Van Dijckkaai
649,Ernest Van Dijckkaai,2023-03-13,05:00:00,86,54,32,FMN 01 Ernest Van Dijckkaai
649,Ernest Van Dijckkaai,2023-03-13,06:00:00,192,130,62,FMN 01 Ernest Van Dijckkaai
649,Ernest Van Dijckkaai,2023-03-13,07:00:00,363,233,130,FMN 01 Ernest Van Dijckkaai
649,Ernest Van Dijckkaai,2023-03-13,08:00:00,450,283,167,FMN 01 Ernest Van Dijckkaai
649,Ernest Van Dijckkaai,2023-03-13,09:00:00,183,112,71,FMN 01 Ernest Van Dijckkaai
649,Ernest Van Dijckkaai,2023-03-13,10:00:00,126,90,36,FMN 01 Ernest Van Dijckkaai
649,Ernest Van Dijckkaai,2023-03-13,11:00:00,100,56,44,FMN 01 Ernest Van Dijckkaai
649,Ernest Van Dijckkaai,2023-03-13,12:00:00,188,107,81,FMN 01 Ernest Van Dijckkaai
649,Ernest Van Dijckkaai,2023-03-13,13:00:00,157,97,60,FMN 01 Ernest Van Dijckkaai
649,Ernest Van Dijckkaai,2023-03-13,14:00:00,203,96,107,FMN 01 Ernest Van Dijckkaai
649,Ernest Van Dijckkaai,2023-03-13,15:00:00,261,143,118,FMN 01 Ernest Van Dijckkaai
649,Ernest Van Dijckkaai,2023-03-13,16:00:00,444,191,253,FMN 01 Ernest Van Dijckkaai
649,Ernest Van Dijckkaai,2023-03-13,17:00:00,529,225,304,FMN 01 Ernest Van Dijckkaai
649,Ernest Van Dijckkaai,2023-03-13,18:00:00,338,170,168,FMN 01 Ernest Van Dijckkaai
649,Ernest Van Dijckkaai,2023-03-13,19:00:00,182,82,100,FMN 01 Ernest Van Dijckkaai
649,Ernest Van Dijckkaai,2023-03-13,20:00:00,108,44,64,FMN 01 Ernest Van Dijckkaai
649,Ernest Van Dijckkaai,2023-03-13,21:00:00,129,58,71,FMN 01 Ernest Van Dijckkaai
649,Ernest Van Dijckkaai,2023-03-13,22:00:00,86,31,55,FMN 01 Ernest Van Dijckkaai
649,Ernest Van Dijckkaai,2023-03-13,23:00:00,40,16,24,FMN 01 Ernest Van Dijckkaai
649,Ernest Van Dijckkaai,2023-03-14,00:00:00,10,5,5,FMN 01 Ernest Van Dijckkaai
649,Ernest Van Dijckkaai,2023-03-14,01:00:00,3,1,2,FMN 01 Ernest Van Dijckkaai
649,Ernest Van Dijckkaai,2023-03-14,02:00:00,3,1,2,FMN 01 Ernest Van Dijckkaai
649,Ernest Van Dijckkaai,2023-03-14,03:00:00,11,4,7,FMN 01 Ernest Van Dijckkaai
649,Ernest Van Dijckkaai,2023-03-14,04:00:00,47,33,14,FMN 01 Ernest Van Dijckkaai
649,Ernest Van Dijckkaai,2023-03-14,05:00:00,101,60,41,FMN 01 Ernest Van Dijckkaai
649,Ernest Van Dijckkaai,2023-03-14,06:00:00,186,119,67,FMN 01 Ernest Van Dijckkaai
649,Ernest Van Dijckkaai,2023-03-14,07:00:00,286,177,109,FMN 01 Ernest Van Dijckkaai
649,Ernest Van Dijckkaai,2023-03-14,08:00:00,395,253,142,FMN 01 Ernest Van Dijckkaai
649,Ernest Van Dijckkaai,2023-03-14,09:00:00,214,132,82,FMN 01 Ernest Van Dijckkaai
649,Ernest Van Dijckkaai,2023-03-14,10:00:00,100,65,35,FMN 01 Ernest Van Dijckkaai
649,Ernest Van Dijckkaai,2023-03-14,11:00:00,102,64,38,FMN 01 Ernest Van Dijckkaai
649,Ernest Van Dijckkaai,2023-03-14,12:00:00,143,84,59,FMN 01 Ernest Van Dijckkaai
649,Ernest Van Dijckkaai,2023-03-14,13:00:00,120,63,57,FMN 01 Ernest Van Dijckkaai
649,Ernest Van Dijckkaai,2023-03-14,14:00:00,181,64,117,FMN 01 Ernest Van Dijckkaai
649,Ernest Van Dijckkaai,2023-03-14,15:00:00,250,116,134,FMN 01 Ernest Van Dijckkaai
649,Ernest Van Dijckkaai,2023-03-14,16:00:00,409,151,258,FMN 01 Ernest Van Dijckkaai
649,Ernest Van Dijckkaai,2023-03-14,17:00:00,447,180,267,FMN 01 Ernest Van Dijckkaai
649,Ernest Van Dijckkaai,2023-03-14,18:00:00,282,136,146,FMN 01 Ernest Van Dijckkaai
649,Ernest Van Dijckkaai,2023-03-14,19:00:00,139,69,70,FMN 01 Ernest Van Dijckkaai
649,Ernest Van Dijckkaai,2023-03-14,20:00:00,111,58,53,FMN 01 Ernest Van Dijckkaai
649,Ernest Van Dijckkaai,2023-03-14,21:00:00,84,37,47,FMN 01 Ernest Van Dijckkaai
649,Ernest Van Dijckkaai,2023-03-14,22:00:00,74,30,44,FMN 01 Ernest Van Dijckkaai
649,Ernest Van Dijckkaai,2023-03-14,23:00:00,39,18,21,FMN 01 Ernest Van Dijckkaai
649,Ernest Van Dijckkaai,2023-03-15,00:00:00,15,7,8,FMN 01 Ernest Van Dijckkaai
649,Ernest Van Dijckkaai,2023-03-15,01:00:00,6,2,4,FMN 01 Ernest Van Dijckkaai
649,Ernest Van Dijckkaai,2023-03-15,02:00:00,1,0,1,FMN 01 Ernest Van Dijckkaai
649,Ernest Van Dijckkaai,2023-03-15,03:00:00,9,2,7,FMN 01 Ernest Van Dijckkaai
649,Ernest Van Dijckkaai,2023-03-15,04:00:00,53,33,20,FMN 01 Ernest Van Dijckkaai
649,Ernest Van Dijckkaai,2023-03-15,05:00:00,96,58,38,FMN 01 Ernest Van Dijckkaai
649,Ernest Van Dijckkaai,2023-03-15,06:00:00,195,130,65,FMN 01 Ernest Van Dijckkaai
649,Ernest Van Dijckkaai,2023-03-15,07:00:00,340,219,121,FMN 01 Ernest Van Dijckkaai
649,Ernest Van Dijckkaai,2023-03-15,08:00:00,449,300,149,FMN 01 Ernest Van Dijckkaai
649,Ernest Van Dijckkaai,2023-03-15,09:00:00,203,112,91,FMN 01 Ernest Van Dijckkaai
649,Ernest Van Dijckkaai,2023-03-15,10:00:00,125,79,46,FMN 01 Ernest Van Dijckkaai
649,Ernest Van Dijckkaai,2023-03-15,11:00:00,150,84,66,FMN 01 Ernest Van Dijckkaai
649,Ernest Van Dijckkaai,2023-03-15,12:00:00,273,152,121,FMN 01 Ernest Van Dijckkaai
649,Ernest Van Dijckkaai,2023-03-15,13:00:00,273,145,128,FMN 01 Ernest Van Dijckkaai
649,Ernest Van Dijckkaai,2023-03-15,14:00:00,273,133,140,FMN 01 Ernest Van Dijckkaai
649,Ernest Van Dijckkaai,2023-03-15,15:00:00,270,134,136,FMN 01 Ernest Van Dijckkaai
649,Ernest Van Dijckkaai,2023-03-15,16:00:00,413,162,251,FMN 01 Ernest Van Dijckkaai
649,Ernest Van Dijckkaai,2023-03-15,17:00:00,560,248,312,FMN 01 Ernest Van Dijckkaai
649,Ernest Van Dijckkaai,2023-03-15,18:00:00,355,190,165,FMN 01 Ernest Van Dijckkaai
649,Ernest Van Dijckkaai,2023-03-15,19:00:00,192,87,105,FMN 01 Ernest Van Dijckkaai
649,Ernest Van Dijckkaai,2023-03-15,20:00:00,124,61,63,FMN 01 Ernest Van Dijckkaai
649,Ernest Van Dijckkaai,2023-03-15,21:00:00,118,63,55,FMN 01 Ernest Van Dijckkaai
649,Ernest Van Dijckkaai,2023-03-15,22:00:00,135,56,79,FMN 01 Ernest Van Dijckkaai
649,Ernest Van Dijckkaai,2023-03-15,23:00:00,67,15,52,FMN 01 Ernest Van Dijckkaai
649,Ernest Van Dijckkaai,2023-03-16,00:00:00,20,12,8,FMN 01 Ernest Van Dijckkaai
649,Ernest Van Dijckkaai,2023-03-16,01:00:00,14,7,7,FMN 01 Ernest Van Dijckkaai
649,Ernest Van Dijckkaai,2023-03-16,02:00:00,9,2,7,FMN 01 Ernest Van Dijckkaai
649,Ernest Van Dijckkaai,2023-03-16,03:00:00,10,4,6,FMN 01 Ernest Van Dijckkaai
649,Ernest Van Dijckkaai,2023-03-16,04:00:00,45,30,15,FMN 01 Ernest Van Dijckkaai
649,Ernest Van Dijckkaai,2023-03-16,05:00:00,99,62,37,FMN 01 Ernest Van Dijckkaai
649,Ernest Van Dijckkaai,2023-03-16,06:00:00,203,129,74,FMN 01 Ernest Van Dijckkaai
649,Ernest Van Dijckkaai,2023-03-16,07:00:00,386,251,135,FMN 01 Ernest Van Dijckkaai
649,Ernest Van Dijckkaai,2023-03-16,08:00:00,520,317,203,FMN 01 Ernest Van Dijckkaai
649,Ernest Van Dijckkaai,2023-03-16,09:00:00,248,142,106,FMN 01 Ernest Van Dijckkaai
649,Ernest Van Dijckkaai,2023-03-16,10:00:00,139,85,54,FMN 01 Ernest Van Dijckkaai
649,Ernest Van Dijckkaai,2023-03-16,11:00:00,164,89,75,FMN 01 Ernest Van Dijckkaai
649,Ernest Van Dijckkaai,2023-03-16,12:00:00,256,135,121,FMN 01 Ernest Van Dijckkaai
649,Ernest Van Dijckkaai,2023-03-16,13:00:00,264,150,114,FMN 01 Ernest Van Dijckkaai
649,Ernest Van Dijckkaai,2023-03-16,14:00:00,296,138,158,FMN 01 Ernest Van Dijckkaai
649,Ernest Van Dijckkaai,2023-03-16,15:00:00,351,186,165,FMN 01 Ernest Van Dijckkaai
649,Ernest Van Dijckkaai,2023-03-16,16:00:00,532,226,306,FMN 01 Ernest Van Dijckkaai
649,Ernest Van Dijckkaai,2023-03-16,17:00:00,634,271,363,FMN 01 Ernest Van Dijckkaai
649,Ernest Van Dijckkaai,2023-03-16,18:00:00,421,223,198,FMN 01 Ernest Van Dijckkaai
649,Ernest Van Dijckkaai,2023-03-16,19:00:00,223,126,97,FMN 01 Ernest Van Dijckkaai
649,Ernest Van Dijckkaai,2023-03-16,20:00:00,162,76,86,FMN 01 Ernest Van Dijckkaai
649,Ernest Van Dijckkaai,2023-03-16,21:00:00,146,65,81,FMN 01 Ernest Van Dijckkaai
649,Ernest Van Dijckkaai,2023-03-16,22:00:00,140,39,101,FMN 01 Ernest Van Dijckkaai
649,Ernest Van Dijckkaai,2023-03-16,23:00:00,69,22,47,FMN 01 Ernest Van Dijckkaai
649,Ernest Van Dijckkaai,2023-03-17,00:00:00,52,26,26,FMN 01 Ernest Van Dijckkaai
649,Ernest Van Dijckkaai,2023-03-17,01:00:00,26,13,13,FMN 01 Ernest Van Dijckkaai
649,Ernest Van Dijckkaai,2023-03-17,02:00:00,15,4,11,FMN 01 Ernest Van Dijckkaai
649,Ernest Van Dijckkaai,2023-03-17,03:00:00,24,5,19,FMN 01 Ernest Van Dijckkaai
649,Ernest Van Dijckkaai,2023-03-17,04:00:00,73,32,41,FMN 01 Ernest Van Dijckkaai
649,Ernest Van Dijckkaai,2023-03-17,05:00:00,106,63,43,FMN 01 Ernest Van Dijckkaai
649,Ernest Van Dijckkaai,2023-03-17,06:00:00,216,131,85,FMN 01 Ernest Van Dijckkaai
649,Ernest Van Dijckkaai,2023-03-17,07:00:00,354,219,135,FMN 01 Ernest Van Dijckkaai
649,Ernest Van Dijckkaai,2023-03-17,08:00:00,470,289,181,FMN 01 Ernest Van Dijckkaai
649,Ernest Van Dijckkaai,2023-03-17,09:00:00,231,130,101,FMN 01 Ernest Van Dijckkaai
649,Ernest Van Dijckkaai,2023-03-17,10:00:00,162,97,65,FMN 01 Ernest Van Dijckkaai
649,Ernest Van Dijckkaai,2023-03-17,11:00:00,189,103,86,FMN 01 Ernest Van Dijckkaai
649,Ernest Van Dijckkaai,2023-03-17,12:00:00,267,141,126,FMN 01 Ernest Van Dijckkaai
649,Ernest Van Dijckkaai,2023-03-17,13:00:00,316,170,146,FMN 01 Ernest Van Dijckkaai
649,Ernest Van Dijckkaai,2023-03-17,14:00:00,354,164,190,FMN 01 Ernest Van Dijckkaai
649,Ernest Van Dijckkaai,2023-03-17,15:00:00,451,237,214,FMN 01 Ernest Van Dijckkaai
649,Ernest Van Dijckkaai,2023-03-17,16:00:00,585,253,332,FMN 01 Ernest Van Dijckkaai
649,Ernest Van Dijckkaai,2023-03-17,17:00:00,540,231,309,FMN 01 Ernest Van Dijckkaai
649,Ernest Van Dijckkaai,2023-03-17,18:00:00,339,182,157,FMN 01 Ernest Van Dijckkaai
649,Ernest Van Dijckkaai,2023-03-17,19:00:00,244,134,110,FMN 01 Ernest Van Dijckkaai
649,Ernest Van Dijckkaai,2023-03-17,20:00:00,182,88,94,FMN 01 Ernest Van Dijckkaai
649,Ernest Van Dijckkaai,2023-03-17,21:00:00,159,84,75,FMN 01 Ernest Van Dijckkaai
649,Ernest Van Dijckkaai,2023-03-17,22:00:00,168,58,110,FMN 01 Ernest Van Dijckkaai
649,Ernest Van Dijckkaai,2023-03-17,23:00:00,149,59,90,FMN 01 Ernest Van Dijckkaai
649,Ernest Van Dijckkaai,2023-03-18,00:00:00,96,46,50,FMN 01 Ernest Van Dijckkaai
649,Ernest Van Dijckkaai,2023-03-18,01:00:00,73,25,48,FMN 01 Ernest Van Dijckkaai
649,Ernest Van Dijckkaai,2023-03-18,02:00:00,60,20,40,FMN 01 Ernest Van Dijckkaai
649,Ernest Van Dijckkaai,2023-03-18,03:00:00,55,25,30,FMN 01 Ernest Van Dijckkaai
649,Ernest Van Dijckkaai,2023-03-18,04:00:00,66,26,40,FMN 01 Ernest Van Dijckkaai
649,Ernest Van Dijckkaai,2023-03-18,05:00:00,33,16,17,FMN 01 Ernest Van Dijckkaai
649,Ernest Van Dijckkaai,2023-03-18,06:00:00,51,24,27,FMN 01 Ernest Van Dijckkaai
649,Ernest Van Dijckkaai,2023-03-18,07:00:00,41,17,24,FMN 01 Ernest Van Dijckkaai
649,Ernest Van Dijckkaai,2023-03-18,08:00:00,80,40,40,FMN 01 Ernest Van Dijckkaai
649,Ernest Van Dijckkaai,2023-03-18,09:00:00,135,67,68,FMN 01 Ernest Van Dijckkaai
649,Ernest Van Dijckkaai,2023-03-18,10:00:00,185,118,67,FMN 01 Ernest Van Dijckkaai
649,Ernest Van Dijckkaai,2023-03-18,11:00:00,207,109,98,FMN 01 Ernest Van Dijckkaai
649,Ernest Van Dijckkaai,2023-03-18,12:00:00,223,106,117,FMN 01 Ernest Van Dijckkaai
649,Ernest Van Dijckkaai,2023-03-18,13:00:00,309,151,158,FMN 01 Ernest Van Dijckkaai
649,Ernest Van Dijckkaai,2023-03-18,14:00:00,390,203,187,FMN 01 Ernest Van Dijckkaai
649,Ernest Van Dijckkaai,2023-03-18,15:00:00,327,176,151,FMN 01 Ernest Van Dijckkaai
649,Ernest Van Dijckkaai,2023-03-18,16:00:00,378,199,179,FMN 01 Ernest Van Dijckkaai
649,Ernest Van Dijckkaai,2023-03-18,17:00:00,290,139,151,FMN 01 Ernest Van Dijckkaai
649,Ernest Van Dijckkaai,2023-03-18,18:00:00,207,120,87,FMN 01 Ernest Van Dijckkaai
649,Ernest Van Dijckkaai,2023-03-18,19:00:00,145,71,74,FMN 01 Ernest Van Dijckkaai
649,Ernest Van Dijckkaai,2023-03-18,20:00:00,134,65,69,FMN 01 Ernest Van Dijckkaai
649,Ernest Van Dijckkaai,2023-03-18,21:00:00,123,65,58,FMN 01 Ernest Van Dijckkaai
649,Ernest Van Dijckkaai,2023-03-18,22:00:00,108,44,64,FMN 01 Ernest Van Dijckkaai
649,Ernest Van Dijckkaai,2023-03-18,23:00:00,100,43,57,FMN 01 Ernest Van Dijckkaai
649,Ernest Van Dijckkaai,2023-03-19,00:00:00,78,44,34,FMN 01 Ernest Van Dijckkaai
649,Ernest Van Dijckkaai,2023-03-19,01:00:00,54,37,17,FMN 01 Ernest Van Dijckkaai
649,Ernest Van Dijckkaai,2023-03-19,02:00:00,43,15,28,FMN 01 Ernest Van Dijckkaai
649,Ernest Van Dijckkaai,2023-03-19,03:00:00,38,10,28,FMN 01 Ernest Van Dijckkaai
649,Ernest Van Dijckkaai,2023-03-19,04:00:00,56,24,32,FMN 01 Ernest Van Dijckkaai
649,Ernest Van Dijckkaai,2023-03-19,05:00:00,29,12,17,FMN 01 Ernest Van Dijckkaai
649,Ernest Van Dijckkaai,2023-03-19,06:00:00,53,27,26,FMN 01 Ernest Van Dijckkaai
649,Ernest Van Dijckkaai,2023-03-19,07:00:00,34,19,15,FMN 01 Ernest Van Dijckkaai
649,Ernest Van Dijckkaai,2023-03-19,08:00:00,64,34,30,FMN 01 Ernest Van Dijckkaai
649,Ernest Van Dijckkaai,2023-03-19,09:00:00,113,70,43,FMN 01 Ernest Van Dijckkaai
649,Ernest Van Dijckkaai,2023-03-19,10:00:00,171,113,58,FMN 01 Ernest Van Dijckkaai
649,Ernest Van Dijckkaai,2023-03-19,11:00:00,206,106,100,FMN 01 Ernest Van Dijckkaai
649,Ernest Van Dijckkaai,2023-03-19,12:00:00,211,108,103,FMN 01 Ernest Van Dijckkaai
649,Ernest Van Dijckkaai,2023-03-19,13:00:00,221,125,96,FMN 01 Ernest Van Dijckkaai
649,Ernest Van Dijckkaai,2023-03-19,14:00:00,307,150,157,FMN 01 Ernest Van Dijckkaai
649,Ernest Van Dijckkaai,2023-03-19,15:00:00,278,156,122,FMN 01 Ernest Van Dijckkaai
649,Ernest Van Dijckkaai,2023-03-19,16:00:00,225,112,113,FMN 01 Ernest Van Dijckkaai
649,Ernest Van Dijckkaai,2023-03-19,17:00:00,199,91,108,FMN 01 Ernest Van Dijckkaai
649,Ernest Van Dijckkaai,2023-03-19,18:00:00,148,65,83,FMN 01 Ernest Van Dijckkaai
649,Ernest Van Dijckkaai,2023-03-19,19:00:00,114,65,49,FMN 01 Ernest Van Dijckkaai
649,Ernest Van Dijckkaai,2023-03-19,20:00:00,74,37,37,FMN 01 Ernest Van Dijckkaai
649,Ernest Van Dijckkaai,2023-03-19,21:00:00,71,30,41,FMN 01 Ernest Van Dijckkaai
649,Ernest Van Dijckkaai,2023-03-19,22:00:00,51,21,30,FMN 01 Ernest Van Dijckkaai
649,Ernest Van Dijckkaai,2023-03-19,23:00:00,35,9,26,FMN 01 Ernest Van Dijckkaai
649,Ernest Van Dijckkaai,2023-03-20,00:00:00,9,2,7,FMN 01 Ernest Van Dijckkaai
649,Ernest Van Dijckkaai,2023-03-20,01:00:00,7,3,4,FMN 01 Ernest Van Dijckkaai
649,Ernest Van Dijckkaai,2023-03-20,02:00:00,7,2,5,FMN 01 Ernest Van Dijckkaai
649,Ernest Van Dijckkaai,2023-03-20,03:00:00,8,2,6,FMN 01 Ernest Van Dijckkaai
649,Ernest Van Dijckkaai,2023-03-20,04:00:00,62,49,13,FMN 01 Ernest Van Dijckkaai
649,Ernest Van Dijckkaai,2023-03-20,05:00:00,98,69,29,FMN 01 Ernest Van Dijckkaai
649,Ernest Van Dijckkaai,2023-03-20,06:00:00,236,164,72,FMN 01 Ernest Van Dijckkaai
649,Ernest Van Dijckkaai,2023-03-20,07:00:00,400,246,154,FMN 01 Ernest Van Dijckkaai
649,Ernest Van Dijckkaai,2023-03-20,08:00:00,522,334,188,FMN 01 Ernest Van Dijckkaai
649,Ernest Van Dijckkaai,2023-03-20,09:00:00,210,130,80,FMN 01 Ernest Van Dijckkaai
649,Ernest Van Dijckkaai,2023-03-20,10:00:00,115,72,43,FMN 01 Ernest Van Dijckkaai
649,Ernest Van Dijckkaai,2023-03-20,11:00:00,149,79,70,FMN 01 Ernest Van Dijckkaai
649,Ernest Van Dijckkaai,2023-03-20,12:00:00,218,122,96,FMN 01 Ernest Van Dijckkaai
649,Ernest Van Dijckkaai,2023-03-20,13:00:00,182,98,84,FMN 01 Ernest Van Dijckkaai
649,Ernest Van Dijckkaai,2023-03-20,14:00:00,222,106,116,FMN 01 Ernest Van Dijckkaai
649,Ernest Van Dijckkaai,2023-03-20,15:00:00,223,101,122,FMN 01 Ernest Van Dijckkaai
649,Ernest Van Dijckkaai,2023-03-20,16:00:00,454,189,265,FMN 01 Ernest Van Dijckkaai
649,Ernest Van Dijckkaai,2023-03-20,17:00:00,568,211,357,FMN 01 Ernest Van Dijckkaai
649,Ernest Van Dijckkaai,2023-03-20,18:00:00,316,143,173,FMN 01 Ernest Van Dijckkaai
649,Ernest Van Dijckkaai,2023-03-20,19:00:00,165,81,84,FMN 01 Ernest Van Dijckkaai
649,Ernest Van Dijckkaai,2023-03-20,20:00:00,125,66,59,FMN 01 Ernest Van Dijckkaai
649,Ernest Van Dijckkaai,2023-03-20,21:00:00,89,40,49,FMN 01 Ernest Van Dijckkaai
649,Ernest Van Dijckkaai,2023-03-20,22:00:00,91,28,63,FMN 01 Ernest Van Dijckkaai
649,Ernest Van Dijckkaai,2023-03-20,23:00:00,45,22,23,FMN 01 Ernest Van Dijckkaai
649,Ernest Van Dijckkaai,2023-03-21,00:00:00,21,10,11,FMN 01 Ernest Van Dijckkaai
649,Ernest Van Dijckkaai,2023-03-21,01:00:00,6,2,4,FMN 01 Ernest Van Dijckkaai
649,Ernest Van Dijckkaai,2023-03-21,02:00:00,10,1,9,FMN 01 Ernest Van Dijckkaai
649,Ernest Van Dijckkaai,2023-03-21,03:00:00,9,2,7,FMN 01 Ernest Van Dijckkaai
649,Ernest Van Dijckkaai,2023-03-21,04:00:00,49,35,14,FMN 01 Ernest Van Dijckkaai
649,Ernest Van Dijckkaai,2023-03-21,05:00:00,91,63,28,FMN 01 Ernest Van Dijckkaai
649,Ernest Van Dijckkaai,2023-03-21,06:00:00,231,156,75,FMN 01 Ernest Van Dijckkaai
649,Ernest Van Dijckkaai,2023-03-21,07:00:00,341,215,126,FMN 01 Ernest Van Dijckkaai
649,Ernest Van Dijckkaai,2023-03-21,08:00:00,527,332,195,FMN 01 Ernest Van Dijckkaai
649,Ernest Van Dijckkaai,2023-03-21,09:00:00,264,160,104,FMN 01 Ernest Van Dijckkaai
649,Ernest Van Dijckkaai,2023-03-21,10:00:00,173,100,73,FMN 01 Ernest Van Dijckkaai
649,Ernest Van Dijckkaai,2023-03-21,11:00:00,134,68,66,FMN 01 Ernest Van Dijckkaai
649,Ernest Van Dijckkaai,2023-03-21,12:00:00,249,131,118,FMN 01 Ernest Van Dijckkaai
649,Ernest Van Dijckkaai,2023-03-21,13:00:00,211,117,94,FMN 01 Ernest Van Dijckkaai
649,Ernest Van Dijckkaai,2023-03-21,14:00:00,274,137,137,FMN 01 Ernest Van Dijckkaai
649,Ernest Van Dijckkaai,2023-03-21,15:00:00,290,134,156,FMN 01 Ernest Van Dijckkaai
649,Ernest Van Dijckkaai,2023-03-21,16:00:00,505,212,293,FMN 01 Ernest Van Dijckkaai
649,Ernest Van Dijckkaai,2023-03-21,17:00:00,556,241,315,FMN 01 Ernest Van Dijckkaai
649,Ernest Van Dijckkaai,2023-03-21,18:00:00,384,156,228,FMN 01 Ernest Van Dijckkaai
649,Ernest Van Dijckkaai,2023-03-21,19:00:00,161,75,86,FMN 01 Ernest Van Dijckkaai
649,Ernest Van Dijckkaai,2023-03-21,20:00:00,147,73,74,FMN 01 Ernest Van Dijckkaai
649,Ernest Van Dijckkaai,2023-03-21,21:00:00,136,66,70,FMN 01 Ernest Van Dijckkaai
649,Ernest Van Dijckkaai,2023-03-21,22:00:00,130,57,73,FMN 01 Ernest Van Dijckkaai
649,Ernest Van Dijckkaai,2023-03-21,23:00:00,64,27,37,FMN 01 Ernest Van Dijckkaai
649,Ernest Van Dijckkaai,2023-03-22,00:00:00,28,11,17,FMN 01 Ernest Van Dijckkaai
649,Ernest Van Dijckkaai,2023-03-22,01:00:00,17,6,11,FMN 01 Ernest Van Dijckkaai
649,Ernest Van Dijckkaai,2023-03-22,02:00:00,14,2,12,FMN 01 Ernest Van Dijckkaai
649,Ernest Van Dijckkaai,2023-03-22,03:00:00,11,3,8,FMN 01 Ernest Van Dijckkaai
649,Ernest Van Dijckkaai,2023-03-22,04:00:00,52,35,17,FMN 01 Ernest Van Dijckkaai
649,Ernest Van Dijckkaai,2023-03-22,05:00:00,83,57,26,FMN 01 Ernest Van Dijckkaai
649,Ernest Van Dijckkaai,2023-03-22,06:00:00,231,156,75,FMN 01 Ernest Van Dijckkaai
649,Ernest Van Dijckkaai,2023-03-22,07:00:00,361,233,128,FMN 01 Ernest Van Dijckkaai
649,Ernest Van Dijckkaai,2023-03-22,08:00:00,495,314,181,FMN 01 Ernest Van Dijckkaai
649,Ernest Van Dijckkaai,2023-03-22,09:00:00,199,124,75,FMN 01 Ernest Van Dijckkaai
649,Ernest Van Dijckkaai,2023-03-22,10:00:00,136,79,57,FMN 01 Ernest Van Dijckkaai
649,Ernest Van Dijckkaai,2023-03-22,11:00:00,96,49,47,FMN 01 Ernest Van Dijckkaai
649,Ernest Van Dijckkaai,2023-03-22,12:00:00,226,112,114,FMN 01 Ernest Van Dijckkaai
649,Ernest Van Dijckkaai,2023-03-22,13:00:00,213,117,96,FMN 01 Ernest Van Dijckkaai
649,Ernest Van Dijckkaai,2023-03-22,14:00:00,224,110,114,FMN 01 Ernest Van Dijckkaai
649,Ernest Van Dijckkaai,2023-03-22,15:00:00,211,101,110,FMN 01 Ernest Van Dijckkaai
649,Ernest Van Dijckkaai,2023-03-22,16:00:00,373,141,232,FMN 01 Ernest Van Dijckkaai
649,Ernest Van Dijckkaai,2023-03-22,17:00:00,459,196,263,FMN 01 Ernest Van Dijckkaai
649,Ernest Van Dijckkaai,2023-03-22,18:00:00,293,149,144,FMN 01 Ernest Van Dijckkaai
649,Ernest Van Dijckkaai,2023-03-22,19:00:00,128,57,71,FMN 01 Ernest Van Dijckkaai
649,Ernest Van Dijckkaai,2023-03-22,20:00:00,112,57,55,FMN 01 Ernest Van Dijckkaai
649,Ernest Van Dijckkaai,2023-03-22,21:00:00,90,46,44,FMN 01 Ernest Van Dijckkaai
649,Ernest Van Dijckkaai,2023-03-22,22:00:00,127,45,82,FMN 01 Ernest Van Dijckkaai
649,Ernest Van Dijckkaai,2023-03-22,23:00:00,43,15,28,FMN 01 Ernest Van Dijckkaai
649,Ernest Van Dijckkaai,2023-03-23,00:00:00,28,15,13,FMN 01 Ernest Van Dijckkaai
649,Ernest Van Dijckkaai,2023-03-23,01:00:00,14,5,9,FMN 01 Ernest Van Dijckkaai
649,Ernest Van Dijckkaai,2023-03-23,02:00:00,5,0,5,FMN 01 Ernest Van Dijckkaai
649,Ernest Van Dijckkaai,2023-03-23,03:00:00,9,3,6,FMN 01 Ernest Van Dijckkaai
649,Ernest Van Dijckkaai,2023-03-23,04:00:00,44,30,14,FMN 01 Ernest Van Dijckkaai
649,Ernest Van Dijckkaai,2023-03-23,05:00:00,92,56,36,FMN 01 Ernest Van Dijckkaai
649,Ernest Van Dijckkaai,2023-03-23,06:00:00,194,125,69,FMN 01 Ernest Van Dijckkaai
649,Ernest Van Dijckkaai,2023-03-23,07:00:00,301,189,112,FMN 01 Ernest Van Dijckkaai
649,Ernest Van Dijckkaai,2023-03-23,08:00:00,399,247,152,FMN 01 Ernest Van Dijckkaai
649,Ernest Van Dijckkaai,2023-03-23,09:00:00,201,118,83,FMN 01 Ernest Van Dijckkaai
649,Ernest Van Dijckkaai,2023-03-23,10:00:00,119,73,46,FMN 01 Ernest Van Dijckkaai
649,Ernest Van Dijckkaai,2023-03-23,11:00:00,129,64,65,FMN 01 Ernest Van Dijckkaai
649,Ernest Van Dijckkaai,2023-03-23,12:00:00,261,138,123,FMN 01 Ernest Van Dijckkaai
649,Ernest Van Dijckkaai,2023-03-23,13:00:00,161,94,67,FMN 01 Ernest Van Dijckkaai
649,Ernest Van Dijckkaai,2023-03-23,14:00:00,187,74,113,FMN 01 Ernest Van Dijckkaai
649,Ernest Van Dijckkaai,2023-03-23,15:00:00,244,129,115,FMN 01 Ernest Van Dijckkaai
649,Ernest Van Dijckkaai,2023-03-23,16:00:00,428,181,247,FMN 01 Ernest Van Dijckkaai
649,Ernest Van Dijckkaai,2023-03-23,17:00:00,433,190,243,FMN 01 Ernest Van Dijckkaai
649,Ernest Van Dijckkaai,2023-03-23,18:00:00,317,150,167,FMN 01 Ernest Van Dijckkaai
649,Ernest Van Dijckkaai,2023-03-23,19:00:00,177,99,78,FMN 01 Ernest Van Dijckkaai
649,Ernest Van Dijckkaai,2023-03-23,20:00:00,126,63,63,FMN 01 Ernest Van Dijckkaai
649,Ernest Van Dijckkaai,2023-03-23,21:00:00,101,47,54,FMN 01 Ernest Van Dijckkaai
649,Ernest Van Dijckkaai,2023-03-23,22:00:00,106,35,71,FMN 01 Ernest Van Dijckkaai
649,Ernest Van Dijckkaai,2023-03-23,23:00:00,62,20,42,FMN 01 Ernest Van Dijckkaai
649,Ernest Van Dijckkaai,2023-03-24,00:00:00,34,13,21,FMN 01 Ernest Van Dijckkaai
649,Ernest Van Dijckkaai,2023-03-24,01:00:00,21,6,15,FMN 01 Ernest Van Dijckkaai
649,Ernest Van Dijckkaai,2023-03-24,02:00:00,12,3,9,FMN 01 Ernest Van Dijckkaai
649,Ernest Van Dijckkaai,2023-03-24,03:00:00,6,1,5,FMN 01 Ernest Van Dijckkaai
649,Ernest Van Dijckkaai,2023-03-24,04:00:00,47,29,18,FMN 01 Ernest Van Dijckkaai
649,Ernest Van Dijckkaai,2023-03-24,05:00:00,106,68,38,FMN 01 Ernest Van Dijckkaai
649,Ernest Van Dijckkaai,2023-03-24,06:00:00,176,116,60,FMN 01 Ernest Van Dijckkaai
649,Ernest Van Dijckkaai,2023-03-24,07:00:00,301,183,118,FMN 01 Ernest Van Dijckkaai
649,Ernest Van Dijckkaai,2023-03-24,08:00:00,470,300,170,FMN 01 Ernest Van Dijckkaai
649,Ernest Van Dijckkaai,2023-03-24,09:00:00,257,168,89,FMN 01 Ernest Van Dijckkaai
649,Ernest Van Dijckkaai,2023-03-24,10:00:00,161,85,76,FMN 01 Ernest Van Dijckkaai
649,Ernest Van Dijckkaai,2023-03-24,11:00:00,123,61,62,FMN 01 Ernest Van Dijckkaai
649,Ernest Van Dijckkaai,2023-03-24,12:00:00,213,108,105,FMN 01 Ernest Van Dijckkaai
649,Ernest Van Dijckkaai,2023-03-24,13:00:00,185,95,90,FMN 01 Ernest Van Dijckkaai
649,Ernest Van Dijckkaai,2023-03-24,14:00:00,205,88,117,FMN 01 Ernest Van Dijckkaai
649,Ernest Van Dijckkaai,2023-03-24,15:00:00,271,121,150,FMN 01 Ernest Van Dijckkaai
649,Ernest Van Dijckkaai,2023-03-24,16:00:00,404,167,237,FMN 01 Ernest Van Dijckkaai
649,Ernest Van Dijckkaai,2023-03-24,17:00:00,392,184,208,FMN 01 Ernest Van Dijckkaai
649,Ernest Van Dijckkaai,2023-03-24,18:00:00,240,114,126,FMN 01 Ernest Van Dijckkaai
649,Ernest Van Dijckkaai,2023-03-24,19:00:00,188,97,91,FMN 01 Ernest Van Dijckkaai
649,Ernest Van Dijckkaai,2023-03-24,20:00:00,120,66,54,FMN 01 Ernest Van Dijckkaai
649,Ernest Van Dijckkaai,2023-03-24,21:00:00,87,57,30,FMN 01 Ernest Van Dijckkaai
649,Ernest Van Dijckkaai,2023-03-24,22:00:00,116,42,74,FMN 01 Ernest Van Dijckkaai
649,Ernest Van Dijckkaai,2023-03-24,23:00:00,89,29,60,FMN 01 Ernest Van Dijckkaai
649,Ernest Van Dijckkaai,2023-03-25,00:00:00,73,35,38,FMN 01 Ernest Van Dijckkaai
649,Ernest Van Dijckkaai,2023-03-25,01:00:00,46,15,31,FMN 01 Ernest Van Dijckkaai
649,Ernest Van Dijckkaai,2023-03-25,02:00:00,33,12,21,FMN 01 Ernest Van Dijckkaai
649,Ernest Van Dijckkaai,2023-03-25,03:00:00,23,3,20,FMN 01 Ernest Van Dijckkaai
649,Ernest Van Dijckkaai,2023-03-25,04:00:00,22,12,10,FMN 01 Ernest Van Dijckkaai
649,Ernest Van Dijckkaai,2023-03-25,05:00:00,32,14,18,FMN 01 Ernest Van Dijckkaai
649,Ernest Van Dijckkaai,2023-03-25,06:00:00,38,19,19,FMN 01 Ernest Van Dijckkaai
649,Ernest Van Dijckkaai,2023-03-25,07:00:00,24,13,11,FMN 01 Ernest Van Dijckkaai
649,Ernest Van Dijckkaai,2023-03-25,08:00:00,71,48,23,FMN 01 Ernest Van Dijckkaai
649,Ernest Van Dijckkaai,2023-03-25,09:00:00,105,61,44,FMN 01 Ernest Van Dijckkaai
649,Ernest Van Dijckkaai,2023-03-25,10:00:00,103,54,49,FMN 01 Ernest Van Dijckkaai
649,Ernest Van Dijckkaai,2023-03-25,11:00:00,124,76,48,FMN 01 Ernest Van Dijckkaai
649,Ernest Van Dijckkaai,2023-03-25,12:00:00,137,81,56,FMN 01 Ernest Van Dijckkaai
649,Ernest Van Dijckkaai,2023-03-25,13:00:00,140,65,75,FMN 01 Ernest Van Dijckkaai
649,Ernest Van Dijckkaai,2023-03-25,14:00:00,115,56,59,FMN 01 Ernest Van Dijckkaai
649,Ernest Van Dijckkaai,2023-03-25,15:00:00,152,77,75,FMN 01 Ernest Van Dijckkaai
649,Ernest Van Dijckkaai,2023-03-25,16:00:00,177,84,93,FMN 01 Ernest Van Dijckkaai
649,Ernest Van Dijckkaai,2023-03-25,17:00:00,137,83,54,FMN 01 Ernest Van Dijckkaai
649,Ernest Van Dijckkaai,2023-03-25,18:00:00,156,80,76,FMN 01 Ernest Van Dijckkaai
649,Ernest Van Dijckkaai,2023-03-25,19:00:00,116,64,52,FMN 01 Ernest Van Dijckkaai
649,Ernest Van Dijckkaai,2023-03-25,20:00:00,86,56,30,FMN 01 Ernest Van Dijckkaai
649,Ernest Van Dijckkaai,2023-03-25,21:00:00,84,46,38,FMN 01 Ernest Van Dijckkaai
649,Ernest Van Dijckkaai,2023-03-25,22:00:00,74,39,35,FMN 01 Ernest Van Dijckkaai
649,Ernest Van Dijckkaai,2023-03-25,23:00:00,78,37,41,FMN 01 Ernest Van Dijckkaai
649,Ernest Van Dijckkaai,2023-03-26,00:00:00,71,31,40,FMN 01 Ernest Van Dijckkaai
649,Ernest Van Dijckkaai,2023-03-26,01:00:00,44,17,27,FMN 01 Ernest Van Dijckkaai
649,Ernest Van Dijckkaai,2023-03-26,02:00:00,0,0,0,FMN 01 Ernest Van Dijckkaai
649,Ernest Van Dijckkaai,2023-03-26,03:00:00,38,8,30,FMN 01 Ernest Van Dijckkaai
649,Ernest Van Dijckkaai,2023-03-26,04:00:00,41,11,30,FMN 01 Ernest Van Dijckkaai
649,Ernest Van Dijckkaai,2023-03-26,05:00:00,34,20,14,FMN 01 Ernest Van Dijckkaai
649,Ernest Van Dijckkaai,2023-03-26,06:00:00,33,17,16,FMN 01 Ernest Van Dijckkaai
649,Ernest Van Dijckkaai,2023-03-26,07:00:00,17,7,10,FMN 01 Ernest Van Dijckkaai
649,Ernest Van Dijckkaai,2023-03-26,08:00:00,21,12,9,FMN 01 Ernest Van Dijckkaai
649,Ernest Van Dijckkaai,2023-03-26,09:00:00,42,21,21,FMN 01 Ernest Van Dijckkaai
649,Ernest Van Dijckkaai,2023-03-26,10:00:00,33,20,13,FMN 01 Ernest Van Dijckkaai
649,Ernest Van Dijckkaai,2023-03-26,11:00:00,35,19,16,FMN 01 Ernest Van Dijckkaai
649,Ernest Van Dijckkaai,2023-03-26,12:00:00,47,25,22,FMN 01 Ernest Van Dijckkaai
649,Ernest Van Dijckkaai,2023-03-26,13:00:00,75,41,34,FMN 01 Ernest Van Dijckkaai
649,Ernest Van Dijckkaai,2023-03-26,14:00:00,99,54,45,FMN 01 Ernest Van Dijckkaai
649,Ernest Van Dijckkaai,2023-03-26,15:00:00,100,54,46,FMN 01 Ernest Van Dijckkaai
649,Ernest Van Dijckkaai,2023-03-26,16:00:00,76,44,32,FMN 01 Ernest Van Dijckkaai
649,Ernest Van Dijckkaai,2023-03-26,17:00:00,89,37,52,FMN 01 Ernest Van Dijckkaai
649,Ernest Van Dijckkaai,2023-03-26,18:00:00,120,60,60,FMN 01 Ernest Van Dijckkaai
649,Ernest Van Dijckkaai,2023-03-26,19:00:00,86,46,40,FMN 01 Ernest Van Dijckkaai
649,Ernest Van Dijckkaai,2023-03-26,20:00:00,56,27,29,FMN 01 Ernest Van Dijckkaai
649,Ernest Van Dijckkaai,2023-03-26,21:00:00,58,27,31,FMN 01 Ernest Van Dijckkaai
649,Ernest Van Dijckkaai,2023-03-26,22:00:00,56,18,38,FMN 01 Ernest Van Dijckkaai
649,Ernest Van Dijckkaai,2023-03-26,23:00:00,40,25,15,FMN 01 Ernest Van Dijckkaai
649,Ernest Van Dijckkaai,2023-03-27,00:00:00,14,8,6,FMN 01 Ernest Van Dijckkaai
649,Ernest Van Dijckkaai,2023-03-27,01:00:00,9,3,6,FMN 01 Ernest Van Dijckkaai
649,Ernest Van Dijckkaai,2023-03-27,02:00:00,4,1,3,FMN 01 Ernest Van Dijckkaai
649,Ernest Van Dijckkaai,2023-03-27,03:00:00,7,4,3,FMN 01 Ernest Van Dijckkaai
649,Ernest Van Dijckkaai,2023-03-27,04:00:00,48,33,15,FMN 01 Ernest Van Dijckkaai
649,Ernest Van Dijckkaai,2023-03-27,05:00:00,92,58,34,FMN 01 Ernest Van Dijckkaai
649,Ernest Van Dijckkaai,2023-03-27,06:00:00,191,139,52,FMN 01 Ernest Van Dijckkaai
649,Ernest Van Dijckkaai,2023-03-27,07:00:00,356,219,137,FMN 01 Ernest Van Dijckkaai
649,Ernest Van Dijckkaai,2023-03-27,08:00:00,493,290,203,FMN 01 Ernest Van Dijckkaai
649,Ernest Van Dijckkaai,2023-03-27,09:00:00,224,133,91,FMN 01 Ernest Van Dijckkaai
649,Ernest Van Dijckkaai,2023-03-27,10:00:00,141,96,45,FMN 01 Ernest Van Dijckkaai
649,Ernest Van Dijckkaai,2023-03-27,11:00:00,122,78,44,FMN 01 Ernest Van Dijckkaai
649,Ernest Van Dijckkaai,2023-03-27,12:00:00,204,131,73,FMN 01 Ernest Van Dijckkaai
649,Ernest Van Dijckkaai,2023-03-27,13:00:00,187,107,80,FMN 01 Ernest Van Dijckkaai
649,Ernest Van Dijckkaai,2023-03-27,14:00:00,205,91,114,FMN 01 Ernest Van Dijckkaai
649,Ernest Van Dijckkaai,2023-03-27,15:00:00,297,144,153,FMN 01 Ernest Van Dijckkaai
649,Ernest Van Dijckkaai,2023-03-27,16:00:00,505,216,289,FMN 01 Ernest Van Dijckkaai
649,Ernest Van Dijckkaai,2023-03-27,17:00:00,528,237,291,FMN 01 Ernest Van Dijckkaai
649,Ernest Van Dijckkaai,2023-03-27,18:00:00,348,167,181,FMN 01 Ernest Van Dijckkaai
649,Ernest Van Dijckkaai,2023-03-27,19:00:00,177,89,88,FMN 01 Ernest Van Dijckkaai
649,Ernest Van Dijckkaai,2023-03-27,20:00:00,130,60,70,FMN 01 Ernest Van Dijckkaai
649,Ernest Van Dijckkaai,2023-03-27,21:00:00,117,62,55,FMN 01 Ernest Van Dijckkaai
649,Ernest Van Dijckkaai,2023-03-27,22:00:00,98,43,55,FMN 01 Ernest Van Dijckkaai
649,Ernest Van Dijckkaai,2023-03-27,23:00:00,46,14,32,FMN 01 Ernest Van Dijckkaai
649,Ernest Van Dijckkaai,2023-03-28,00:00:00,14,8,6,FMN 01 Ernest Van Dijckkaai
649,Ernest Van Dijckkaai,2023-03-28,01:00:00,10,4,6,FMN 01 Ernest Van Dijckkaai
649,Ernest Van Dijckkaai,2023-03-28,02:00:00,6,0,6,FMN 01 Ernest Van Dijckkaai
649,Ernest Van Dijckkaai,2023-03-28,03:00:00,7,3,4,FMN 01 Ernest Van Dijckkaai
649,Ernest Van Dijckkaai,2023-03-28,04:00:00,51,36,15,FMN 01 Ernest Van Dijckkaai
649,Ernest Van Dijckkaai,2023-03-28,05:00:00,112,78,34,FMN 01 Ernest Van Dijckkaai
649,Ernest Van Dijckkaai,2023-03-28,06:00:00,191,125,66,FMN 01 Ernest Van Dijckkaai
649,Ernest Van Dijckkaai,2023-03-28,07:00:00,364,229,135,FMN 01 Ernest Van Dijckkaai
649,Ernest Van Dijckkaai,2023-03-28,08:00:00,514,326,188,FMN 01 Ernest Van Dijckkaai
649,Ernest Van Dijckkaai,2023-03-28,09:00:00,265,158,107,FMN 01 Ernest Van Dijckkaai
649,Ernest Van Dijckkaai,2023-03-28,10:00:00,137,85,52,FMN 01 Ernest Van Dijckkaai
649,Ernest Van Dijckkaai,2023-03-28,11:00:00,158,87,71,FMN 01 Ernest Van Dijckkaai
649,Ernest Van Dijckkaai,2023-03-28,12:00:00,261,130,131,FMN 01 Ernest Van Dijckkaai
649,Ernest Van Dijckkaai,2023-03-28,13:00:00,226,141,85,FMN 01 Ernest Van Dijckkaai
649,Ernest Van Dijckkaai,2023-03-28,14:00:00,235,106,129,FMN 01 Ernest Van Dijckkaai
649,Ernest Van Dijckkaai,2023-03-28,15:00:00,304,155,149,FMN 01 Ernest Van Dijckkaai
649,Ernest Van Dijckkaai,2023-03-28,16:00:00,559,254,305,FMN 01 Ernest Van Dijckkaai
649,Ernest Van Dijckkaai,2023-03-28,17:00:00,595,258,337,FMN 01 Ernest Van Dijckkaai
649,Ernest Van Dijckkaai,2023-03-28,18:00:00,361,201,160,FMN 01 Ernest Van Dijckkaai
649,Ernest Van Dijckkaai,2023-03-28,19:00:00,188,95,93,FMN 01 Ernest Van Dijckkaai
649,Ernest Van Dijckkaai,2023-03-28,20:00:00,92,36,56,FMN 01 Ernest Van Dijckkaai
649,Ernest Van Dijckkaai,2023-03-28,21:00:00,129,55,74,FMN 01 Ernest Van Dijckkaai
649,Ernest Van Dijckkaai,2023-03-28,22:00:00,133,49,84,FMN 01 Ernest Van Dijckkaai
649,Ernest Van Dijckkaai,2023-03-28,23:00:00,57,28,29,FMN 01 Ernest Van Dijckkaai
649,Ernest Van Dijckkaai,2023-03-29,00:00:00,31,17,14,FMN 01 Ernest Van Dijckkaai
649,Ernest Van Dijckkaai,2023-03-29,01:00:00,12,3,9,FMN 01 Ernest Van Dijckkaai
649,Ernest Van Dijckkaai,2023-03-29,02:00:00,3,2,1,FMN 01 Ernest Van Dijckkaai
649,Ernest Van Dijckkaai,2023-03-29,03:00:00,11,2,9,FMN 01 Ernest Van Dijckkaai
649,Ernest Van Dijckkaai,2023-03-29,04:00:00,47,29,18,FMN 01 Ernest Van Dijckkaai
649,Ernest Van Dijckkaai,2023-03-29,05:00:00,109,72,37,FMN 01 Ernest Van Dijckkaai
649,Ernest Van Dijckkaai,2023-03-29,06:00:00,197,133,64,FMN 01 Ernest Van Dijckkaai
649,Ernest Van Dijckkaai,2023-03-29,07:00:00,378,254,124,FMN 01 Ernest Van Dijckkaai
649,Ernest Van Dijckkaai,2023-03-29,08:00:00,462,302,160,FMN 01 Ernest Van Dijckkaai
649,Ernest Van Dijckkaai,2023-03-29,09:00:00,224,124,100,FMN 01 Ernest Van Dijckkaai
649,Ernest Van Dijckkaai,2023-03-29,10:00:00,129,73,56,FMN 01 Ernest Van Dijckkaai
649,Ernest Van Dijckkaai,2023-03-29,11:00:00,206,126,80,FMN 01 Ernest Van Dijckkaai
649,Ernest Van Dijckkaai,2023-03-29,12:00:00,282,153,129,FMN 01 Ernest Van Dijckkaai
649,Ernest Van Dijckkaai,2023-03-29,13:00:00,266,142,124,FMN 01 Ernest Van Dijckkaai
649,Ernest Van Dijckkaai,2023-03-29,14:00:00,284,135,149,FMN 01 Ernest Van Dijckkaai
649,Ernest Van Dijckkaai,2023-03-29,15:00:00,297,147,150,FMN 01 Ernest Van Dijckkaai
649,Ernest Van Dijckkaai,2023-03-29,16:00:00,491,228,263,FMN 01 Ernest Van Dijckkaai
649,Ernest Van Dijckkaai,2023-03-29,17:00:00,563,248,315,FMN 01 Ernest Van Dijckkaai
649,Ernest Van Dijckkaai,2023-03-29,18:00:00,388,208,180,FMN 01 Ernest Van Dijckkaai
649,Ernest Van Dijckkaai,2023-03-29,19:00:00,217,111,106,FMN 01 Ernest Van Dijckkaai
649,Ernest Van Dijckkaai,2023-03-29,20:00:00,200,91,109,FMN 01 Ernest Van Dijckkaai
649,Ernest Van Dijckkaai,2023-03-29,21:00:00,129,60,69,FMN 01 Ernest Van Dijckkaai
649,Ernest Van Dijckkaai,2023-03-29,22:00:00,159,59,100,FMN 01 Ernest Van Dijckkaai
649,Ernest Van Dijckkaai,2023-03-29,23:00:00,72,29,43,FMN 01 Ernest Van Dijckkaai
649,Ernest Van Dijckkaai,2023-03-30,00:00:00,50,19,31,FMN 01 Ernest Van Dijckkaai
649,Ernest Van Dijckkaai,2023-03-30,01:00:00,19,8,11,FMN 01 Ernest Van Dijckkaai
649,Ernest Van Dijckkaai,2023-03-30,02:00:00,10,3,7,FMN 01 Ernest Van Dijckkaai
649,Ernest Van Dijckkaai,2023-03-30,03:00:00,8,2,6,FMN 01 Ernest Van Dijckkaai
649,Ernest Van Dijckkaai,2023-03-30,04:00:00,39,20,19,FMN 01 Ernest Van Dijckkaai
649,Ernest Van Dijckkaai,2023-03-30,05:00:00,91,64,27,FMN 01 Ernest Van Dijckkaai
649,Ernest Van Dijckkaai,2023-03-30,06:00:00,216,146,70,FMN 01 Ernest Van Dijckkaai
649,Ernest Van Dijckkaai,2023-03-30,07:00:00,323,212,111,FMN 01 Ernest Van Dijckkaai
649,Ernest Van Dijckkaai,2023-03-30,08:00:00,505,304,201,FMN 01 Ernest Van Dijckkaai
649,Ernest Van Dijckkaai,2023-03-30,09:00:00,251,153,98,FMN 01 Ernest Van Dijckkaai
649,Ernest Van Dijckkaai,2023-03-30,10:00:00,135,68,67,FMN 01 Ernest Van Dijckkaai
649,Ernest Van Dijckkaai,2023-03-30,11:00:00,151,80,71,FMN 01 Ernest Van Dijckkaai
649,Ernest Van Dijckkaai,2023-03-30,12:00:00,219,115,104,FMN 01 Ernest Van Dijckkaai
649,Ernest Van Dijckkaai,2023-03-30,13:00:00,191,122,69,FMN 01 Ernest Van Dijckkaai
649,Ernest Van Dijckkaai,2023-03-30,14:00:00,216,105,111,FMN 01 Ernest Van Dijckkaai
649,Ernest Van Dijckkaai,2023-03-30,15:00:00,273,144,129,FMN 01 Ernest Van Dijckkaai
649,Ernest Van Dijckkaai,2023-03-30,16:00:00,469,188,281,FMN 01 Ernest Van Dijckkaai
649,Ernest Van Dijckkaai,2023-03-30,17:00:00,492,222,270,FMN 01 Ernest Van Dijckkaai
649,Ernest Van Dijckkaai,2023-03-30,18:00:00,361,190,171,FMN 01 Ernest Van Dijckkaai
649,Ernest Van Dijckkaai,2023-03-30,19:00:00,203,99,104,FMN 01 Ernest Van Dijckkaai
649,Ernest Van Dijckkaai,2023-03-30,20:00:00,146,74,72,FMN 01 Ernest Van Dijckkaai
649,Ernest Van Dijckkaai,2023-03-30,21:00:00,135,75,60,FMN 01 Ernest Van Dijckkaai
649,Ernest Van Dijckkaai,2023-03-30,22:00:00,146,54,92,FMN 01 Ernest Van Dijckkaai
649,Ernest Van Dijckkaai,2023-03-30,23:00:00,92,32,60,FMN 01 Ernest Van Dijckkaai
649,Ernest Van Dijckkaai,2023-03-31,00:00:00,48,17,31,FMN 01 Ernest Van Dijckkaai
649,Ernest Van Dijckkaai,2023-03-31,01:00:00,31,22,9,FMN 01 Ernest Van Dijckkaai
649,Ernest Van Dijckkaai,2023-03-31,02:00:00,20,4,16,FMN 01 Ernest Van Dijckkaai
649,Ernest Van Dijckkaai,2023-03-31,03:00:00,20,5,15,FMN 01 Ernest Van Dijckkaai
649,Ernest Van Dijckkaai,2023-03-31,04:00:00,39,22,17,FMN 01 Ernest Van Dijckkaai
649,Ernest Van Dijckkaai,2023-03-31,05:00:00,68,36,32,FMN 01 Ernest Van Dijckkaai
649,Ernest Van Dijckkaai,2023-03-31,06:00:00,120,79,41,FMN 01 Ernest Van Dijckkaai
649,Ernest Van Dijckkaai,2023-03-31,07:00:00,182,113,69,FMN 01 Ernest Van Dijckkaai
649,Ernest Van Dijckkaai,2023-03-31,08:00:00,304,185,119,FMN 01 Ernest Van Dijckkaai
649,Ernest Van Dijckkaai,2023-03-31,09:00:00,162,102,60,FMN 01 Ernest Van Dijckkaai
649,Ernest Van Dijckkaai,2023-03-31,10:00:00,113,73,40,FMN 01 Ernest Van Dijckkaai
649,Ernest Van Dijckkaai,2023-03-31,11:00:00,141,64,77,FMN 01 Ernest Van Dijckkaai
649,Ernest Van Dijckkaai,2023-03-31,12:00:00,138,82,56,FMN 01 Ernest Van Dijckkaai
649,Ernest Van Dijckkaai,2023-03-31,13:00:00,140,68,72,FMN 01 Ernest Van Dijckkaai
649,Ernest Van Dijckkaai,2023-03-31,14:00:00,130,58,72,FMN 01 Ernest Van Dijckkaai
649,Ernest Van Dijckkaai,2023-03-31,15:00:00,209,101,108,FMN 01 Ernest Van Dijckkaai
649,Ernest Van Dijckkaai,2023-03-31,16:00:00,245,98,147,FMN 01 Ernest Van Dijckkaai
649,Ernest Van Dijckkaai,2023-03-31,17:00:00,227,112,115,FMN 01 Ernest Van Dijckkaai
649,Ernest Van Dijckkaai,2023-03-31,18:00:00,174,89,85,FMN 01 Ernest Van Dijckkaai
649,Ernest Van Dijckkaai,2023-03-31,19:00:00,155,80,75,FMN 01 Ernest Van Dijckkaai
649,Ernest Van Dijckkaai,2023-03-31,20:00:00,118,74,44,FMN 01 Ernest Van Dijckkaai
649,Ernest Van Dijckkaai,2023-03-31,21:00:00,85,32,53,FMN 01 Ernest Van Dijckkaai
649,Ernest Van Dijckkaai,2023-03-31,22:00:00,96,37,59,FMN 01 Ernest Van Dijckkaai
649,Ernest Van Dijckkaai,2023-03-31,23:00:00,59,23,36,FMN 01 Ernest Van Dijckkaai
649,Ernest Van Dijckkaai,2023-04-01,00:00:00,56,28,28,FMN 01 Ernest Van Dijckkaai
649,Ernest Van Dijckkaai,2023-04-01,01:00:00,36,17,19,FMN 01 Ernest Van Dijckkaai
649,Ernest Van Dijckkaai,2023-04-01,02:00:00,34,17,17,FMN 01 Ernest Van Dijckkaai
649,Ernest Van Dijckkaai,2023-04-01,03:00:00,30,14,16,FMN 01 Ernest Van Dijckkaai
649,Ernest Van Dijckkaai,2023-04-01,04:00:00,35,7,28,FMN 01 Ernest Van Dijckkaai
649,Ernest Van Dijckkaai,2023-04-01,05:00:00,31,12,19,FMN 01 Ernest Van Dijckkaai
649,Ernest Van Dijckkaai,2023-04-01,06:00:00,30,11,19,FMN 01 Ernest Van Dijckkaai
649,Ernest Van Dijckkaai,2023-04-01,07:00:00,24,9,15,FMN 01 Ernest Van Dijckkaai
649,Ernest Van Dijckkaai,2023-04-01,08:00:00,38,26,12,FMN 01 Ernest Van Dijckkaai
649,Ernest Van Dijckkaai,2023-04-01,09:00:00,62,34,28,FMN 01 Ernest Van Dijckkaai
649,Ernest Van Dijckkaai,2023-04-01,10:00:00,65,39,26,FMN 01 Ernest Van Dijckkaai
649,Ernest Van Dijckkaai,2023-04-01,11:00:00,74,53,21,FMN 01 Ernest Van Dijckkaai
649,Ernest Van Dijckkaai,2023-04-01,12:00:00,101,46,55,FMN 01 Ernest Van Dijckkaai
649,Ernest Van Dijckkaai,2023-04-01,13:00:00,97,60,37,FMN 01 Ernest Van Dijckkaai
649,Ernest Van Dijckkaai,2023-04-01,14:00:00,117,70,47,FMN 01 Ernest Van Dijckkaai
649,Ernest Van Dijckkaai,2023-04-01,15:00:00,84,43,41,FMN 01 Ernest Van Dijckkaai
649,Ernest Van Dijckkaai,2023-04-01,16:00:00,92,47,45,FMN 01 Ernest Van Dijckkaai
649,Ernest Van Dijckkaai,2023-04-01,17:00:00,94,55,39,FMN 01 Ernest Van Dijckkaai
649,Ernest Van Dijckkaai,2023-04-01,18:00:00,97,65,32,FMN 01 Ernest Van Dijckkaai
649,Ernest Van Dijckkaai,2023-04-01,19:00:00,92,62,30,FMN 01 Ernest Van Dijckkaai
649,Ernest Van Dijckkaai,2023-04-01,20:00:00,74,44,30,FMN 01 Ernest Van Dijckkaai
649,Ernest Van Dijckkaai,2023-04-01,21:00:00,41,13,28,FMN 01 Ernest Van Dijckkaai
649,Ernest Van Dijckkaai,2023-04-01,22:00:00,46,18,28,FMN 01 Ernest Van Dijckkaai
649,Ernest Van Dijckkaai,2023-04-01,23:00:00,59,25,34,FMN 01 Ernest Van Dijckkaai
649,Ernest Van Dijckkaai,2023-04-02,00:00:00,53,15,38,FMN 01 Ernest Van Dijckkaai
649,Ernest Van Dijckkaai,2023-04-02,01:00:00,46,22,24,FMN 01 Ernest Van Dijckkaai
649,Ernest Van Dijckkaai,2023-04-02,02:00:00,44,12,32,FMN 01 Ernest Van Dijckkaai
649,Ernest Van Dijckkaai,2023-04-02,03:00:00,35,5,30,FMN 01 Ernest Van Dijckkaai
649,Ernest Van Dijckkaai,2023-04-02,04:00:00,35,11,24,FMN 01 Ernest Van Dijckkaai
649,Ernest Van Dijckkaai,2023-04-02,05:00:00,36,18,18,FMN 01 Ernest Van Dijckkaai
649,Ernest Van Dijckkaai,2023-04-02,06:00:00,28,14,14,FMN 01 Ernest Van Dijckkaai
649,Ernest Van Dijckkaai,2023-04-02,07:00:00,29,11,18,FMN 01 Ernest Van Dijckkaai
649,Ernest Van Dijckkaai,2023-04-02,08:00:00,51,26,25,FMN 01 Ernest Van Dijckkaai
649,Ernest Van Dijckkaai,2023-04-02,09:00:00,114,80,34,FMN 01 Ernest Van Dijckkaai
649,Ernest Van Dijckkaai,2023-04-02,10:00:00,129,75,54,FMN 01 Ernest Van Dijckkaai
649,Ernest Van Dijckkaai,2023-04-02,11:00:00,180,103,77,FMN 01 Ernest Van Dijckkaai
649,Ernest Van Dijckkaai,2023-04-02,12:00:00,216,75,141,FMN 01 Ernest Van Dijckkaai
649,Ernest Van Dijckkaai,2023-04-02,13:00:00,191,98,93,FMN 01 Ernest Van Dijckkaai
649,Ernest Van Dijckkaai,2023-04-02,14:00:00,183,94,89,FMN 01 Ernest Van Dijckkaai
649,Ernest Van Dijckkaai,2023-04-02,15:00:00,152,62,90,FMN 01 Ernest Van Dijckkaai
649,Ernest Van Dijckkaai,2023-04-02,16:00:00,145,71,74,FMN 01 Ernest Van Dijckkaai
649,Ernest Van Dijckkaai,2023-04-02,17:00:00,168,86,82,FMN 01 Ernest Van Dijckkaai
649,Ernest Van Dijckkaai,2023-04-02,18:00:00,200,90,110,FMN 01 Ernest Van Dijckkaai
649,Ernest Van Dijckkaai,2023-04-02,19:00:00,157,76,81,FMN 01 Ernest Van Dijckkaai
649,Ernest Van Dijckkaai,2023-04-02,20:00:00,89,43,46,FMN 01 Ernest Van Dijckkaai
649,Ernest Van Dijckkaai,2023-04-02,21:00:00,61,29,32,FMN 01 Ernest Van Dijckkaai
649,Ernest Van Dijckkaai,2023-04-02,22:00:00,67,31,36,FMN 01 Ernest Van Dijckkaai
649,Ernest Van Dijckkaai,2023-04-02,23:00:00,32,11,21,FMN 01 Ernest Van Dijckkaai
649,Ernest Van Dijckkaai,2023-04-03,00:00:00,30,11,19,FMN 01 Ernest Van Dijckkaai
649,Ernest Van Dijckkaai,2023-04-03,01:00:00,14,5,9,FMN 01 Ernest Van Dijckkaai
649,Ernest Van Dijckkaai,2023-04-03,02:00:00,4,3,1,FMN 01 Ernest Van Dijckkaai
649,Ernest Van Dijckkaai,2023-04-03,03:00:00,4,1,3,FMN 01 Ernest Van Dijckkaai
649,Ernest Van Dijckkaai,2023-04-03,04:00:00,49,38,11,FMN 01 Ernest Van Dijckkaai
649,Ernest Van Dijckkaai,2023-04-03,05:00:00,99,65,34,FMN 01 Ernest Van Dijckkaai
649,Ernest Van Dijckkaai,2023-04-03,06:00:00,187,112,75,FMN 01 Ernest Van Dijckkaai
649,Ernest Van Dijckkaai,2023-04-03,07:00:00,286,195,91,FMN 01 Ernest Van Dijckkaai
649,Ernest Van Dijckkaai,2023-04-03,08:00:00,343,208,135,FMN 01 Ernest Van Dijckkaai
649,Ernest Van Dijckkaai,2023-04-03,09:00:00,202,123,79,FMN 01 Ernest Van Dijckkaai
649,Ernest Van Dijckkaai,2023-04-03,10:00:00,140,76,64,FMN 01 Ernest Van Dijckkaai
649,Ernest Van Dijckkaai,2023-04-03,11:00:00,168,102,66,FMN 01 Ernest Van Dijckkaai
649,Ernest Van Dijckkaai,2023-04-03,12:00:00,187,101,86,FMN 01 Ernest Van Dijckkaai
649,Ernest Van Dijckkaai,2023-04-03,13:00:00,224,132,92,FMN 01 Ernest Van Dijckkaai
649,Ernest Van Dijckkaai,2023-04-03,14:00:00,299,153,146,FMN 01 Ernest Van Dijckkaai
649,Ernest Van Dijckkaai,2023-04-03,15:00:00,336,163,173,FMN 01 Ernest Van Dijckkaai
649,Ernest Van Dijckkaai,2023-04-03,16:00:00,491,216,275,FMN 01 Ernest Van Dijckkaai
649,Ernest Van Dijckkaai,2023-04-03,17:00:00,595,241,354,FMN 01 Ernest Van Dijckkaai
649,Ernest Van Dijckkaai,2023-04-03,18:00:00,371,187,184,FMN 01 Ernest Van Dijckkaai
649,Ernest Van Dijckkaai,2023-04-03,19:00:00,232,110,122,FMN 01 Ernest Van Dijckkaai
649,Ernest Van Dijckkaai,2023-04-03,20:00:00,157,76,81,FMN 01 Ernest Van Dijckkaai
649,Ernest Van Dijckkaai,2023-04-03,21:00:00,115,65,50,FMN 01 Ernest Van Dijckkaai
649,Ernest Van Dijckkaai,2023-04-03,22:00:00,108,44,64,FMN 01 Ernest Van Dijckkaai
649,Ernest Van Dijckkaai,2023-04-03,23:00:00,43,12,31,FMN 01 Ernest Van Dijckkaai
649,Ernest Van Dijckkaai,2023-04-04,00:00:00,21,4,17,FMN 01 Ernest Van Dijckkaai
649,Ernest Van Dijckkaai,2023-04-04,01:00:00,14,5,9,FMN 01 Ernest Van Dijckkaai
649,Ernest Van Dijckkaai,2023-04-04,02:00:00,12,5,7,FMN 01 Ernest Van Dijckkaai
649,Ernest Van Dijckkaai,2023-04-04,03:00:00,5,3,2,FMN 01 Ernest Van Dijckkaai
649,Ernest Van Dijckkaai,2023-04-04,04:00:00,46,33,13,FMN 01 Ernest Van Dijckkaai
649,Ernest Van Dijckkaai,2023-04-04,05:00:00,99,62,37,FMN 01 Ernest Van Dijckkaai
649,Ernest Van Dijckkaai,2023-04-04,06:00:00,221,136,85,FMN 01 Ernest Van Dijckkaai
649,Ernest Van Dijckkaai,2023-04-04,07:00:00,319,196,123,FMN 01 Ernest Van Dijckkaai
649,Ernest Van Dijckkaai,2023-04-04,08:00:00,393,251,142,FMN 01 Ernest Van Dijckkaai
649,Ernest Van Dijckkaai,2023-04-04,09:00:00,219,125,94,FMN 01 Ernest Van Dijckkaai
649,Ernest Van Dijckkaai,2023-04-04,10:00:00,161,92,69,FMN 01 Ernest Van Dijckkaai
649,Ernest Van Dijckkaai,2023-04-04,11:00:00,159,91,68,FMN 01 Ernest Van Dijckkaai
649,Ernest Van Dijckkaai,2023-04-04,12:00:00,201,115,86,FMN 01 Ernest Van Dijckkaai
649,Ernest Van Dijckkaai,2023-04-04,13:00:00,261,167,94,FMN 01 Ernest Van Dijckkaai
649,Ernest Van Dijckkaai,2023-04-04,14:00:00,286,130,156,FMN 01 Ernest Van Dijckkaai
649,Ernest Van Dijckkaai,2023-04-04,15:00:00,314,157,157,FMN 01 Ernest Van Dijckkaai
649,Ernest Van Dijckkaai,2023-04-04,16:00:00,595,271,324,FMN 01 Ernest Van Dijckkaai
649,Ernest Van Dijckkaai,2023-04-04,17:00:00,605,263,342,FMN 01 Ernest Van Dijckkaai
649,Ernest Van Dijckkaai,2023-04-04,18:00:00,410,190,220,FMN 01 Ernest Van Dijckkaai
649,Ernest Van Dijckkaai,2023-04-04,19:00:00,234,107,127,FMN 01 Ernest Van Dijckkaai
649,Ernest Van Dijckkaai,2023-04-04,20:00:00,209,106,103,FMN 01 Ernest Van Dijckkaai
649,Ernest Van Dijckkaai,2023-04-04,21:00:00,116,55,61,FMN 01 Ernest Van Dijckkaai
649,Ernest Van Dijckkaai,2023-04-04,22:00:00,127,51,76,FMN 01 Ernest Van Dijckkaai
649,Ernest Van Dijckkaai,2023-04-04,23:00:00,47,23,24,FMN 01 Ernest Van Dijckkaai
649,Ernest Van Dijckkaai,2023-04-05,00:00:00,21,13,8,FMN 01 Ernest Van Dijckkaai
649,Ernest Van Dijckkaai,2023-04-05,01:00:00,17,5,12,FMN 01 Ernest Van Dijckkaai
649,Ernest Van Dijckkaai,2023-04-05,02:00:00,5,1,4,FMN 01 Ernest Van Dijckkaai
649,Ernest Van Dijckkaai,2023-04-05,03:00:00,11,2,9,FMN 01 Ernest Van Dijckkaai
649,Ernest Van Dijckkaai,2023-04-05,04:00:00,56,35,21,FMN 01 Ernest Van Dijckkaai
649,Ernest Van Dijckkaai,2023-04-05,05:00:00,98,58,40,FMN 01 Ernest Van Dijckkaai
649,Ernest Van Dijckkaai,2023-04-05,06:00:00,223,142,81,FMN 01 Ernest Van Dijckkaai
649,Ernest Van Dijckkaai,2023-04-05,07:00:00,290,194,96,FMN 01 Ernest Van Dijckkaai
649,Ernest Van Dijckkaai,2023-04-05,08:00:00,394,238,156,FMN 01 Ernest Van Dijckkaai
649,Ernest Van Dijckkaai,2023-04-05,09:00:00,232,135,97,FMN 01 Ernest Van Dijckkaai
649,Ernest Van Dijckkaai,2023-04-05,10:00:00,147,87,60,FMN 01 Ernest Van Dijckkaai
649,Ernest Van Dijckkaai,2023-04-05,11:00:00,183,114,69,FMN 01 Ernest Van Dijckkaai
649,Ernest Van Dijckkaai,2023-04-05,12:00:00,297,171,126,FMN 01 Ernest Van Dijckkaai
649,Ernest Van Dijckkaai,2023-04-05,13:00:00,311,172,139,FMN 01 Ernest Van Dijckkaai
649,Ernest Van Dijckkaai,2023-04-05,14:00:00,377,198,179,FMN 01 Ernest Van Dijckkaai
649,Ernest Van Dijckkaai,2023-04-05,15:00:00,405,207,198,FMN 01 Ernest Van Dijckkaai
649,Ernest Van Dijckkaai,2023-04-05,16:00:00,577,253,324,FMN 01 Ernest Van Dijckkaai
649,Ernest Van Dijckkaai,2023-04-05,17:00:00,599,264,335,FMN 01 Ernest Van Dijckkaai
649,Ernest Van Dijckkaai,2023-04-05,18:00:00,447,227,220,FMN 01 Ernest Van Dijckkaai
649,Ernest Van Dijckkaai,2023-04-05,19:00:00,319,129,190,FMN 01 Ernest Van Dijckkaai
649,Ernest Van Dijckkaai,2023-04-05,20:00:00,174,86,88,FMN 01 Ernest Van Dijckkaai
649,Ernest Van Dijckkaai,2023-04-05,21:00:00,126,61,65,FMN 01 Ernest Van Dijckkaai
649,Ernest Van Dijckkaai,2023-04-05,22:00:00,146,56,90,FMN 01 Ernest Van Dijckkaai
649,Ernest Van Dijckkaai,2023-04-05,23:00:00,76,28,48,FMN 01 Ernest Van Dijckkaai
649,Ernest Van Dijckkaai,2023-04-06,00:00:00,33,15,18,FMN 01 Ernest Van Dijckkaai
649,Ernest Van Dijckkaai,2023-04-06,01:00:00,12,4,8,FMN 01 Ernest Van Dijckkaai
649,Ernest Van Dijckkaai,2023-04-06,02:00:00,8,5,3,FMN 01 Ernest Van Dijckkaai
649,Ernest Van Dijckkaai,2023-04-06,03:00:00,11,3,8,FMN 01 Ernest Van Dijckkaai
649,Ernest Van Dijckkaai,2023-04-06,04:00:00,49,36,13,FMN 01 Ernest Van Dijckkaai
649,Ernest Van Dijckkaai,2023-04-06,05:00:00,82,50,32,FMN 01 Ernest Van Dijckkaai
649,Ernest Van Dijckkaai,2023-04-06,06:00:00,205,127,78,FMN 01 Ernest Van Dijckkaai
649,Ernest Van Dijckkaai,2023-04-06,07:00:00,261,166,95,FMN 01 Ernest Van Dijckkaai
649,Ernest Van Dijckkaai,2023-04-06,08:00:00,327,190,137,FMN 01 Ernest Van Dijckkaai
649,Ernest Van Dijckkaai,2023-04-06,09:00:00,184,113,71,FMN 01 Ernest Van Dijckkaai
649,Ernest Van Dijckkaai,2023-04-06,10:00:00,63,41,22,FMN 01 Ernest Van Dijckkaai
649,Ernest Van Dijckkaai,2023-04-06,11:00:00,70,30,40,FMN 01 Ernest Van Dijckkaai
649,Ernest Van Dijckkaai,2023-04-06,12:00:00,136,71,65,FMN 01 Ernest Van Dijckkaai
649,Ernest Van Dijckkaai,2023-04-06,13:00:00,119,66,53,FMN 01 Ernest Van Dijckkaai
649,Ernest Van Dijckkaai,2023-04-06,14:00:00,152,65,87,FMN 01 Ernest Van Dijckkaai
649,Ernest Van Dijckkaai,2023-04-06,15:00:00,182,79,103,FMN 01 Ernest Van Dijckkaai
649,Ernest Van Dijckkaai,2023-04-06,16:00:00,313,119,194,FMN 01 Ernest Van Dijckkaai
649,Ernest Van Dijckkaai,2023-04-06,17:00:00,353,138,215,FMN 01 Ernest Van Dijckkaai
649,Ernest Van Dijckkaai,2023-04-06,18:00:00,217,119,98,FMN 01 Ernest Van Dijckkaai
649,Ernest Van Dijckkaai,2023-04-06,19:00:00,124,61,63,FMN 01 Ernest Van Dijckkaai
649,Ernest Van Dijckkaai,2023-04-06,20:00:00,86,42,44,FMN 01 Ernest Van Dijckkaai
649,Ernest Van Dijckkaai,2023-04-06,21:00:00,60,31,29,FMN 01 Ernest Van Dijckkaai
649,Ernest Van Dijckkaai,2023-04-06,22:00:00,83,38,45,FMN 01 Ernest Van Dijckkaai
649,Ernest Van Dijckkaai,2023-04-06,23:00:00,54,23,31,FMN 01 Ernest Van Dijckkaai
649,Ernest Van Dijckkaai,2023-04-07,00:00:00,25,11,14,FMN 01 Ernest Van Dijckkaai
649,Ernest Van Dijckkaai,2023-04-07,01:00:00,19,9,10,FMN 01 Ernest Van Dijckkaai
649,Ernest Van Dijckkaai,2023-04-07,02:00:00,17,8,9,FMN 01 Ernest Van Dijckkaai
649,Ernest Van Dijckkaai,2023-04-07,03:00:00,22,7,15,FMN 01 Ernest Van Dijckkaai
649,Ernest Van Dijckkaai,2023-04-07,04:00:00,44,26,18,FMN 01 Ernest Van Dijckkaai
649,Ernest Van Dijckkaai,2023-04-07,05:00:00,87,42,45,FMN 01 Ernest Van Dijckkaai
649,Ernest Van Dijckkaai,2023-04-07,06:00:00,157,93,64,FMN 01 Ernest Van Dijckkaai
649,Ernest Van Dijckkaai,2023-04-07,07:00:00,190,102,88,FMN 01 Ernest Van Dijckkaai
649,Ernest Van Dijckkaai,2023-04-07,08:00:00,238,138,100,FMN 01 Ernest Van Dijckkaai
649,Ernest Van Dijckkaai,2023-04-07,09:00:00,194,118,76,FMN 01 Ernest Van Dijckkaai
649,Ernest Van Dijckkaai,2023-04-07,10:00:00,142,82,60,FMN 01 Ernest Van Dijckkaai
649,Ernest Van Dijckkaai,2023-04-07,11:00:00,131,66,65,FMN 01 Ernest Van Dijckkaai
649,Ernest Van Dijckkaai,2023-04-07,12:00:00,204,92,112,FMN 01 Ernest Van Dijckkaai
649,Ernest Van Dijckkaai,2023-04-07,13:00:00,196,93,103,FMN 01 Ernest Van Dijckkaai
649,Ernest Van Dijckkaai,2023-04-07,14:00:00,283,133,150,FMN 01 Ernest Van Dijckkaai
649,Ernest Van Dijckkaai,2023-04-07,15:00:00,261,135,126,FMN 01 Ernest Van Dijckkaai
649,Ernest Van Dijckkaai,2023-04-07,16:00:00,328,130,198,FMN 01 Ernest Van Dijckkaai
649,Ernest Van Dijckkaai,2023-04-07,17:00:00,353,161,192,FMN 01 Ernest Van Dijckkaai
649,Ernest Van Dijckkaai,2023-04-07,18:00:00,253,115,138,FMN 01 Ernest Van Dijckkaai
649,Ernest Van Dijckkaai,2023-04-07,19:00:00,186,90,96,FMN 01 Ernest Van Dijckkaai
649,Ernest Van Dijckkaai,2023-04-07,20:00:00,119,63,56,FMN 01 Ernest Van Dijckkaai
649,Ernest Van Dijckkaai,2023-04-07,21:00:00,101,53,48,FMN 01 Ernest Van Dijckkaai
649,Ernest Van Dijckkaai,2023-04-07,22:00:00,160,58,102,FMN 01 Ernest Van Dijckkaai
649,Ernest Van Dijckkaai,2023-04-07,23:00:00,136,42,94,FMN 01 Ernest Van Dijckkaai
649,Ernest Van Dijckkaai,2023-04-08,00:00:00,70,35,35,FMN 01 Ernest Van Dijckkaai
649,Ernest Van Dijckkaai,2023-04-08,01:00:00,50,28,22,FMN 01 Ernest Van Dijckkaai
649,Ernest Van Dijckkaai,2023-04-08,02:00:00,42,26,16,FMN 01 Ernest Van Dijckkaai
649,Ernest Van Dijckkaai,2023-04-08,03:00:00,40,19,21,FMN 01 Ernest Van Dijckkaai
649,Ernest Van Dijckkaai,2023-04-08,04:00:00,40,13,27,FMN 01 Ernest Van Dijckkaai
649,Ernest Van Dijckkaai,2023-04-08,05:00:00,47,21,26,FMN 01 Ernest Van Dijckkaai
649,Ernest Van Dijckkaai,2023-04-08,06:00:00,36,13,23,FMN 01 Ernest Van Dijckkaai
649,Ernest Van Dijckkaai,2023-04-08,07:00:00,46,17,29,FMN 01 Ernest Van Dijckkaai
649,Ernest Van Dijckkaai,2023-04-08,08:00:00,61,39,22,FMN 01 Ernest Van Dijckkaai
649,Ernest Van Dijckkaai,2023-04-08,09:00:00,138,80,58,FMN 01 Ernest Van Dijckkaai
649,Ernest Van Dijckkaai,2023-04-08,10:00:00,181,106,75,FMN 01 Ernest Van Dijckkaai
649,Ernest Van Dijckkaai,2023-04-08,11:00:00,187,98,89,FMN 01 Ernest Van Dijckkaai
649,Ernest Van Dijckkaai,2023-04-08,12:00:00,237,132,105,FMN 01 Ernest Van Dijckkaai
649,Ernest Van Dijckkaai,2023-04-08,13:00:00,301,161,140,FMN 01 Ernest Van Dijckkaai
649,Ernest Van Dijckkaai,2023-04-08,14:00:00,350,170,180,FMN 01 Ernest Van Dijckkaai
649,Ernest Van Dijckkaai,2023-04-08,15:00:00,417,185,232,FMN 01 Ernest Van Dijckkaai
649,Ernest Van Dijckkaai,2023-04-08,16:00:00,368,166,202,FMN 01 Ernest Van Dijckkaai
649,Ernest Van Dijckkaai,2023-04-08,17:00:00,320,157,163,FMN 01 Ernest Van Dijckkaai
649,Ernest Van Dijckkaai,2023-04-08,18:00:00,317,146,171,FMN 01 Ernest Van Dijckkaai
649,Ernest Van Dijckkaai,2023-04-08,19:00:00,217,108,109,FMN 01 Ernest Van Dijckkaai
649,Ernest Van Dijckkaai,2023-04-08,20:00:00,175,89,86,FMN 01 Ernest Van Dijckkaai
649,Ernest Van Dijckkaai,2023-04-08,21:00:00,90,50,40,FMN 01 Ernest Van Dijckkaai
649,Ernest Van Dijckkaai,2023-04-08,22:00:00,129,69,60,FMN 01 Ernest Van Dijckkaai
649,Ernest Van Dijckkaai,2023-04-08,23:00:00,124,80,44,FMN 01 Ernest Van Dijckkaai
649,Ernest Van Dijckkaai,2023-04-09,00:00:00,62,27,35,FMN 01 Ernest Van Dijckkaai
649,Ernest Van Dijckkaai,2023-04-09,01:00:00,61,26,35,FMN 01 Ernest Van Dijckkaai
649,Ernest Van Dijckkaai,2023-04-09,02:00:00,49,18,31,FMN 01 Ernest Van Dijckkaai
649,Ernest Van Dijckkaai,2023-04-09,03:00:00,32,11,21,FMN 01 Ernest Van Dijckkaai
649,Ernest Van Dijckkaai,2023-04-09,04:00:00,35,14,21,FMN 01 Ernest Van Dijckkaai
649,Ernest Van Dijckkaai,2023-04-09,05:00:00,21,11,10,FMN 01 Ernest Van Dijckkaai
649,Ernest Van Dijckkaai,2023-04-09,06:00:00,29,12,17,FMN 01 Ernest Van Dijckkaai
649,Ernest Van Dijckkaai,2023-04-09,07:00:00,43,6,37,FMN 01 Ernest Van Dijckkaai
649,Ernest Van Dijckkaai,2023-04-09,08:00:00,59,27,32,FMN 01 Ernest Van Dijckkaai
649,Ernest Van Dijckkaai,2023-04-09,09:00:00,153,96,57,FMN 01 Ernest Van Dijckkaai
649,Ernest Van Dijckkaai,2023-04-09,10:00:00,188,127,61,FMN 01 Ernest Van Dijckkaai
649,Ernest Van Dijckkaai,2023-04-09,11:00:00,355,175,180,FMN 01 Ernest Van Dijckkaai
649,Ernest Van Dijckkaai,2023-04-09,12:00:00,367,144,223,FMN 01 Ernest Van Dijckkaai
649,Ernest Van Dijckkaai,2023-04-09,13:00:00,413,223,190,FMN 01 Ernest Van Dijckkaai
649,Ernest Van Dijckkaai,2023-04-09,14:00:00,537,262,275,FMN 01 Ernest Van Dijckkaai
649,Ernest Van Dijckkaai,2023-04-09,15:00:00,508,247,261,FMN 01 Ernest Van Dijckkaai
649,Ernest Van Dijckkaai,2023-04-09,16:00:00,479,224,255,FMN 01 Ernest Van Dijckkaai
649,Ernest Van Dijckkaai,2023-04-09,17:00:00,420,211,209,FMN 01 Ernest Van Dijckkaai
649,Ernest Van Dijckkaai,2023-04-09,18:00:00,331,154,177,FMN 01 Ernest Van Dijckkaai
649,Ernest Van Dijckkaai,2023-04-09,19:00:00,256,111,145,FMN 01 Ernest Van Dijckkaai
649,Ernest Van Dijckkaai,2023-04-09,20:00:00,142,70,72,FMN 01 Ernest Van Dijckkaai
649,Ernest Van Dijckkaai,2023-04-09,21:00:00,109,53,56,FMN 01 Ernest Van Dijckkaai
649,Ernest Van Dijckkaai,2023-04-09,22:00:00,100,49,51,FMN 01 Ernest Van Dijckkaai
649,Ernest Van Dijckkaai,2023-04-09,23:00:00,93,50,43,FMN 01 Ernest Van Dijckkaai
649,Ernest Van Dijckkaai,2023-04-10,00:00:00,54,31,23,FMN 01 Ernest Van Dijckkaai
649,Ernest Van Dijckkaai,2023-04-10,01:00:00,30,9,21,FMN 01 Ernest Van Dijckkaai
649,Ernest Van Dijckkaai,2023-04-10,02:00:00,20,5,15,FMN 01 Ernest Van Dijckkaai
649,Ernest Van Dijckkaai,2023-04-10,03:00:00,9,5,4,FMN 01 Ernest Van Dijckkaai
649,Ernest Van Dijckkaai,2023-04-10,04:00:00,37,17,20,FMN 01 Ernest Van Dijckkaai
649,Ernest Van Dijckkaai,2023-04-10,05:00:00,27,19,8,FMN 01 Ernest Van Dijckkaai
649,Ernest Van Dijckkaai,2023-04-10,06:00:00,27,13,14,FMN 01 Ernest Van Dijckkaai
649,Ernest Van Dijckkaai,2023-04-10,07:00:00,26,10,16,FMN 01 Ernest Van Dijckkaai
649,Ernest Van Dijckkaai,2023-04-10,08:00:00,46,18,28,FMN 01 Ernest Van Dijckkaai
649,Ernest Van Dijckkaai,2023-04-10,09:00:00,110,56,54,FMN 01 Ernest Van Dijckkaai
649,Ernest Van Dijckkaai,2023-04-10,10:00:00,143,76,67,FMN 01 Ernest Van Dijckkaai
649,Ernest Van Dijckkaai,2023-04-10,11:00:00,179,103,76,FMN 01 Ernest Van Dijckkaai
649,Ernest Van Dijckkaai,2023-04-10,12:00:00,231,126,105,FMN 01 Ernest Van Dijckkaai
649,Ernest Van Dijckkaai,2023-04-10,13:00:00,247,120,127,FMN 01 Ernest Van Dijckkaai
649,Ernest Van Dijckkaai,2023-04-10,14:00:00,202,90,112,FMN 01 Ernest Van Dijckkaai
649,Ernest Van Dijckkaai,2023-04-10,15:00:00,139,85,54,FMN 01 Ernest Van Dijckkaai
649,Ernest Van Dijckkaai,2023-04-10,16:00:00,129,57,72,FMN 01 Ernest Van Dijckkaai
649,Ernest Van Dijckkaai,2023-04-10,17:00:00,94,38,56,FMN 01 Ernest Van Dijckkaai
649,Ernest Van Dijckkaai,2023-04-10,18:00:00,58,30,28,FMN 01 Ernest Van Dijckkaai
649,Ernest Van Dijckkaai,2023-04-10,19:00:00,51,23,28,FMN 01 Ernest Van Dijckkaai
649,Ernest Van Dijckkaai,2023-04-10,20:00:00,62,28,34,FMN 01 Ernest Van Dijckkaai
649,Ernest Van Dijckkaai,2023-04-10,21:00:00,46,22,24,FMN 01 Ernest Van Dijckkaai
649,Ernest Van Dijckkaai,2023-04-10,22:00:00,47,16,31,FMN 01 Ernest Van Dijckkaai
649,Ernest Van Dijckkaai,2023-04-10,23:00:00,21,11,10,FMN 01 Ernest Van Dijckkaai
649,Ernest Van Dijckkaai,2023-04-11,00:00:00,14,6,8,FMN 01 Ernest Van Dijckkaai
649,Ernest Van Dijckkaai,2023-04-11,01:00:00,12,5,7,FMN 01 Ernest Van Dijckkaai
649,Ernest Van Dijckkaai,2023-04-11,02:00:00,7,1,6,FMN 01 Ernest Van Dijckkaai
649,Ernest Van Dijckkaai,2023-04-11,03:00:00,7,1,6,FMN 01 Ernest Van Dijckkaai
649,Ernest Van Dijckkaai,2023-04-11,04:00:00,48,32,16,FMN 01 Ernest Van Dijckkaai
649,Ernest Van Dijckkaai,2023-04-11,05:00:00,114,71,43,FMN 01 Ernest Van Dijckkaai
649,Ernest Van Dijckkaai,2023-04-11,06:00:00,201,129,72,FMN 01 Ernest Van Dijckkaai
649,Ernest Van Dijckkaai,2023-04-11,07:00:00,287,178,109,FMN 01 Ernest Van Dijckkaai
649,Ernest Van Dijckkaai,2023-04-11,08:00:00,375,222,153,FMN 01 Ernest Van Dijckkaai
649,Ernest Van Dijckkaai,2023-04-11,09:00:00,184,115,69,FMN 01 Ernest Van Dijckkaai
649,Ernest Van Dijckkaai,2023-04-11,10:00:00,192,103,89,FMN 01 Ernest Van Dijckkaai
649,Ernest Van Dijckkaai,2023-04-11,11:00:00,174,94,80,FMN 01 Ernest Van Dijckkaai
649,Ernest Van Dijckkaai,2023-04-11,12:00:00,213,123,90,FMN 01 Ernest Van Dijckkaai
649,Ernest Van Dijckkaai,2023-04-11,13:00:00,242,131,111,FMN 01 Ernest Van Dijckkaai
649,Ernest Van Dijckkaai,2023-04-11,14:00:00,277,135,142,FMN 01 Ernest Van Dijckkaai
649,Ernest Van Dijckkaai,2023-04-11,15:00:00,319,164,155,FMN 01 Ernest Van Dijckkaai
649,Ernest Van Dijckkaai,2023-04-11,16:00:00,473,198,275,FMN 01 Ernest Van Dijckkaai
649,Ernest Van Dijckkaai,2023-04-11,17:00:00,537,223,314,FMN 01 Ernest Van Dijckkaai
649,Ernest Van Dijckkaai,2023-04-11,18:00:00,338,160,178,FMN 01 Ernest Van Dijckkaai
649,Ernest Van Dijckkaai,2023-04-11,19:00:00,187,103,84,FMN 01 Ernest Van Dijckkaai
649,Ernest Van Dijckkaai,2023-04-11,20:00:00,126,63,63,FMN 01 Ernest Van Dijckkaai
649,Ernest Van Dijckkaai,2023-04-11,21:00:00,92,41,51,FMN 01 Ernest Van Dijckkaai
649,Ernest Van Dijckkaai,2023-04-11,22:00:00,110,36,74,FMN 01 Ernest Van Dijckkaai
649,Ernest Van Dijckkaai,2023-04-11,23:00:00,42,14,28,FMN 01 Ernest Van Dijckkaai
649,Ernest Van Dijckkaai,2023-04-12,00:00:00,16,4,12,FMN 01 Ernest Van Dijckkaai
649,Ernest Van Dijckkaai,2023-04-12,01:00:00,9,5,4,FMN 01 Ernest Van Dijckkaai
649,Ernest Van Dijckkaai,2023-04-12,02:00:00,1,0,1,FMN 01 Ernest Van Dijckkaai
649,Ernest Van Dijckkaai,2023-04-12,03:00:00,11,3,8,FMN 01 Ernest Van Dijckkaai
649,Ernest Van Dijckkaai,2023-04-12,04:00:00,41,26,15,FMN 01 Ernest Van Dijckkaai
649,Ernest Van Dijckkaai,2023-04-12,05:00:00,74,50,24,FMN 01 Ernest Van Dijckkaai
649,Ernest Van Dijckkaai,2023-04-12,06:00:00,145,80,65,FMN 01 Ernest Van Dijckkaai
649,Ernest Van Dijckkaai,2023-04-12,07:00:00,181,118,63,FMN 01 Ernest Van Dijckkaai
649,Ernest Van Dijckkaai,2023-04-12,08:00:00,233,139,94,FMN 01 Ernest Van Dijckkaai
649,Ernest Van Dijckkaai,2023-04-12,09:00:00,144,73,71,FMN 01 Ernest Van Dijckkaai
649,Ernest Van Dijckkaai,2023-04-12,10:00:00,101,59,42,FMN 01 Ernest Van Dijckkaai
649,Ernest Van Dijckkaai,2023-04-12,11:00:00,116,66,50,FMN 01 Ernest Van Dijckkaai
649,Ernest Van Dijckkaai,2023-04-12,12:00:00,123,72,51,FMN 01 Ernest Van Dijckkaai
649,Ernest Van Dijckkaai,2023-04-12,13:00:00,115,62,53,FMN 01 Ernest Van Dijckkaai
649,Ernest Van Dijckkaai,2023-04-12,14:00:00,150,69,81,FMN 01 Ernest Van Dijckkaai
649,Ernest Van Dijckkaai,2023-04-12,15:00:00,162,84,78,FMN 01 Ernest Van Dijckkaai
649,Ernest Van Dijckkaai,2023-04-12,16:00:00,304,119,185,FMN 01 Ernest Van Dijckkaai
649,Ernest Van Dijckkaai,2023-04-12,17:00:00,345,141,204,FMN 01 Ernest Van Dijckkaai
649,Ernest Van Dijckkaai,2023-04-12,18:00:00,233,120,113,FMN 01 Ernest Van Dijckkaai
649,Ernest Van Dijckkaai,2023-04-12,19:00:00,183,98,85,FMN 01 Ernest Van Dijckkaai
649,Ernest Van Dijckkaai,2023-04-12,20:00:00,135,60,75,FMN 01 Ernest Van Dijckkaai
649,Ernest Van Dijckkaai,2023-04-12,21:00:00,84,43,41,FMN 01 Ernest Van Dijckkaai
649,Ernest Van Dijckkaai,2023-04-12,22:00:00,106,39,67,FMN 01 Ernest Van Dijckkaai
649,Ernest Van Dijckkaai,2023-04-12,23:00:00,41,17,24,FMN 01 Ernest Van Dijckkaai
649,Ernest Van Dijckkaai,2023-04-13,00:00:00,12,6,6,FMN 01 Ernest Van Dijckkaai
649,Ernest Van Dijckkaai,2023-04-13,01:00:00,14,7,7,FMN 01 Ernest Van Dijckkaai
649,Ernest Van Dijckkaai,2023-04-13,02:00:00,5,3,2,FMN 01 Ernest Van Dijckkaai
649,Ernest Van Dijckkaai,2023-04-13,03:00:00,8,4,4,FMN 01 Ernest Van Dijckkaai
649,Ernest Van Dijckkaai,2023-04-13,04:00:00,41,25,16,FMN 01 Ernest Van Dijckkaai
649,Ernest Van Dijckkaai,2023-04-13,05:00:00,96,67,29,FMN 01 Ernest Van Dijckkaai
649,Ernest Van Dijckkaai,2023-04-13,06:00:00,162,101,61,FMN 01 Ernest Van Dijckkaai
649,Ernest Van Dijckkaai,2023-04-13,07:00:00,238,152,86,FMN 01 Ernest Van Dijckkaai
649,Ernest Van Dijckkaai,2023-04-13,08:00:00,344,214,130,FMN 01 Ernest Van Dijckkaai
649,Ernest Van Dijckkaai,2023-04-13,09:00:00,219,142,77,FMN 01 Ernest Van Dijckkaai
649,Ernest Van Dijckkaai,2023-04-13,10:00:00,110,57,53,FMN 01 Ernest Van Dijckkaai
649,Ernest Van Dijckkaai,2023-04-13,11:00:00,167,82,85,FMN 01 Ernest Van Dijckkaai
649,Ernest Van Dijckkaai,2023-04-13,12:00:00,188,101,87,FMN 01 Ernest Van Dijckkaai
649,Ernest Van Dijckkaai,2023-04-13,13:00:00,200,112,88,FMN 01 Ernest Van Dijckkaai
649,Ernest Van Dijckkaai,2023-04-13,14:00:00,305,155,150,FMN 01 Ernest Van Dijckkaai
649,Ernest Van Dijckkaai,2023-04-13,15:00:00,279,134,145,FMN 01 Ernest Van Dijckkaai
649,Ernest Van Dijckkaai,2023-04-13,16:00:00,477,199,278,FMN 01 Ernest Van Dijckkaai
649,Ernest Van Dijckkaai,2023-04-13,17:00:00,511,236,275,FMN 01 Ernest Van Dijckkaai
649,Ernest Van Dijckkaai,2023-04-13,18:00:00,409,217,192,FMN 01 Ernest Van Dijckkaai
649,Ernest Van Dijckkaai,2023-04-13,19:00:00,293,155,138,FMN 01 Ernest Van Dijckkaai
649,Ernest Van Dijckkaai,2023-04-13,20:00:00,203,106,97,FMN 01 Ernest Van Dijckkaai
649,Ernest Van Dijckkaai,2023-04-13,21:00:00,127,57,70,FMN 01 Ernest Van Dijckkaai
649,Ernest Van Dijckkaai,2023-04-13,22:00:00,156,52,104,FMN 01 Ernest Van Dijckkaai
649,Ernest Van Dijckkaai,2023-04-13,23:00:00,97,46,51,FMN 01 Ernest Van Dijckkaai
649,Ernest Van Dijckkaai,2023-04-14,00:00:00,55,32,23,FMN 01 Ernest Van Dijckkaai
649,Ernest Van Dijckkaai,2023-04-14,01:00:00,38,21,17,FMN 01 Ernest Van Dijckkaai
649,Ernest Van Dijckkaai,2023-04-14,02:00:00,16,3,13,FMN 01 Ernest Van Dijckkaai
649,Ernest Van Dijckkaai,2023-04-14,03:00:00,21,5,16,FMN 01 Ernest Van Dijckkaai
649,Ernest Van Dijckkaai,2023-04-14,04:00:00,55,29,26,FMN 01 Ernest Van Dijckkaai
649,Ernest Van Dijckkaai,2023-04-14,05:00:00,112,64,48,FMN 01 Ernest Van Dijckkaai
649,Ernest Van Dijckkaai,2023-04-14,06:00:00,206,131,75,FMN 01 Ernest Van Dijckkaai
649,Ernest Van Dijckkaai,2023-04-14,07:00:00,275,162,113,FMN 01 Ernest Van Dijckkaai
649,Ernest Van Dijckkaai,2023-04-14,08:00:00,301,185,116,FMN 01 Ernest Van Dijckkaai
649,Ernest Van Dijckkaai,2023-04-14,09:00:00,232,140,92,FMN 01 Ernest Van Dijckkaai
649,Ernest Van Dijckkaai,2023-04-14,10:00:00,199,117,82,FMN 01 Ernest Van Dijckkaai
649,Ernest Van Dijckkaai,2023-04-14,11:00:00,225,133,92,FMN 01 Ernest Van Dijckkaai
649,Ernest Van Dijckkaai,2023-04-14,12:00:00,299,156,143,FMN 01 Ernest Van Dijckkaai
649,Ernest Van Dijckkaai,2023-04-14,13:00:00,282,145,137,FMN 01 Ernest Van Dijckkaai
649,Ernest Van Dijckkaai,2023-04-14,14:00:00,306,153,153,FMN 01 Ernest Van Dijckkaai
649,Ernest Van Dijckkaai,2023-04-14,15:00:00,378,182,196,FMN 01 Ernest Van Dijckkaai
649,Ernest Van Dijckkaai,2023-04-14,16:00:00,481,201,280,FMN 01 Ernest Van Dijckkaai
649,Ernest Van Dijckkaai,2023-04-14,17:00:00,433,202,231,FMN 01 Ernest Van Dijckkaai
649,Ernest Van Dijckkaai,2023-04-14,18:00:00,375,176,199,FMN 01 Ernest Van Dijckkaai
649,Ernest Van Dijckkaai,2023-04-14,19:00:00,298,155,143,FMN 01 Ernest Van Dijckkaai
649,Ernest Van Dijckkaai,2023-04-14,20:00:00,186,97,89,FMN 01 Ernest Van Dijckkaai
649,Ernest Van Dijckkaai,2023-04-14,21:00:00,160,80,80,FMN 01 Ernest Van Dijckkaai
649,Ernest Van Dijckkaai,2023-04-14,22:00:00,198,84,114,FMN 01 Ernest Van Dijckkaai
649,Ernest Van Dijckkaai,2023-04-14,23:00:00,185,71,114,FMN 01 Ernest Van Dijckkaai
649,Ernest Van Dijckkaai,2023-04-15,00:00:00,105,53,52,FMN 01 Ernest Van Dijckkaai
649,Ernest Van Dijckkaai,2023-04-15,01:00:00,61,21,40,FMN 01 Ernest Van Dijckkaai
649,Ernest Van Dijckkaai,2023-04-15,02:00:00,47,22,25,FMN 01 Ernest Van Dijckkaai
649,Ernest Van Dijckkaai,2023-04-15,03:00:00,48,15,33,FMN 01 Ernest Van Dijckkaai
649,Ernest Van Dijckkaai,2023-04-15,04:00:00,50,23,27,FMN 01 Ernest Van Dijckkaai
649,Ernest Van Dijckkaai,2023-04-15,05:00:00,38,17,21,FMN 01 Ernest Van Dijckkaai
649,Ernest Van Dijckkaai,2023-04-15,06:00:00,42,13,29,FMN 01 Ernest Van Dijckkaai
649,Ernest Van Dijckkaai,2023-04-15,07:00:00,32,15,17,FMN 01 Ernest Van Dijckkaai
649,Ernest Van Dijckkaai,2023-04-15,08:00:00,72,38,34,FMN 01 Ernest Van Dijckkaai
649,Ernest Van Dijckkaai,2023-04-15,09:00:00,148,98,50,FMN 01 Ernest Van Dijckkaai
649,Ernest Van Dijckkaai,2023-04-15,10:00:00,181,102,79,FMN 01 Ernest Van Dijckkaai
649,Ernest Van Dijckkaai,2023-04-15,11:00:00,253,148,105,FMN 01 Ernest Van Dijckkaai
649,Ernest Van Dijckkaai,2023-04-15,12:00:00,346,178,168,FMN 01 Ernest Van Dijckkaai
649,Ernest Van Dijckkaai,2023-04-15,13:00:00,367,209,158,FMN 01 Ernest Van Dijckkaai
649,Ernest Van Dijckkaai,2023-04-15,14:00:00,493,283,210,FMN 01 Ernest Van Dijckkaai
649,Ernest Van Dijckkaai,2023-04-15,15:00:00,525,289,236,FMN 01 Ernest Van Dijckkaai
649,Ernest Van Dijckkaai,2023-04-15,16:00:00,555,301,254,FMN 01 Ernest Van Dijckkaai
649,Ernest Van Dijckkaai,2023-04-15,17:00:00,434,236,198,FMN 01 Ernest Van Dijckkaai
649,Ernest Van Dijckkaai,2023-04-15,18:00:00,401,233,168,FMN 01 Ernest Van Dijckkaai
649,Ernest Van Dijckkaai,2023-04-15,19:00:00,242,108,134,FMN 01 Ernest Van Dijckkaai
649,Ernest Van Dijckkaai,2023-04-15,20:00:00,188,86,102,FMN 01 Ernest Van Dijckkaai
649,Ernest Van Dijckkaai,2023-04-15,21:00:00,159,88,71,FMN 01 Ernest Van Dijckkaai
649,Ernest Van Dijckkaai,2023-04-15,22:00:00,144,57,87,FMN 01 Ernest Van Dijckkaai
649,Ernest Van Dijckkaai,2023-04-15,23:00:00,129,49,80,FMN 01 Ernest Van Dijckkaai
649,Ernest Van Dijckkaai,2023-04-16,00:00:00,111,44,67,FMN 01 Ernest Van Dijckkaai
649,Ernest Van Dijckkaai,2023-04-16,01:00:00,55,21,34,FMN 01 Ernest Van Dijckkaai
649,Ernest Van Dijckkaai,2023-04-16,02:00:00,29,7,22,FMN 01 Ernest Van Dijckkaai
649,Ernest Van Dijckkaai,2023-04-16,03:00:00,47,14,33,FMN 01 Ernest Van Dijckkaai
649,Ernest Van Dijckkaai,2023-04-16,04:00:00,43,19,24,FMN 01 Ernest Van Dijckkaai
649,Ernest Van Dijckkaai,2023-04-16,05:00:00,29,12,17,FMN 01 Ernest Van Dijckkaai
649,Ernest Van Dijckkaai,2023-04-16,06:00:00,26,13,13,FMN 01 Ernest Van Dijckkaai
649,Ernest Van Dijckkaai,2023-04-16,07:00:00,15,6,9,FMN 01 Ernest Van Dijckkaai
649,Ernest Van Dijckkaai,2023-04-16,08:00:00,59,26,33,FMN 01 Ernest Van Dijckkaai
649,Ernest Van Dijckkaai,2023-04-16,09:00:00,71,40,31,FMN 01 Ernest Van Dijckkaai
649,Ernest Van Dijckkaai,2023-04-16,10:00:00,102,56,46,FMN 01 Ernest Van Dijckkaai
649,Ernest Van Dijckkaai,2023-04-16,11:00:00,159,102,57,FMN 01 Ernest Van Dijckkaai
649,Ernest Van Dijckkaai,2023-04-16,12:00:00,157,73,84,FMN 01 Ernest Van Dijckkaai
649,Ernest Van Dijckkaai,2023-04-16,13:00:00,149,90,59,FMN 01 Ernest Van Dijckkaai
649,Ernest Van Dijckkaai,2023-04-16,14:00:00,174,72,102,FMN 01 Ernest Van Dijckkaai
649,Ernest Van Dijckkaai,2023-04-16,15:00:00,210,103,107,FMN 01 Ernest Van Dijckkaai
649,Ernest Van Dijckkaai,2023-04-16,16:00:00,204,93,111,FMN 01 Ernest Van Dijckkaai
649,Ernest Van Dijckkaai,2023-04-16,17:00:00,168,86,82,FMN 01 Ernest Van Dijckkaai
649,Ernest Van Dijckkaai,2023-04-16,18:00:00,131,55,76,FMN 01 Ernest Van Dijckkaai
649,Ernest Van Dijckkaai,2023-04-16,19:00:00,134,67,67,FMN 01 Ernest Van Dijckkaai
649,Ernest Van Dijckkaai,2023-04-16,20:00:00,79,35,44,FMN 01 Ernest Van Dijckkaai
649,Ernest Van Dijckkaai,2023-04-16,21:00:00,61,31,30,FMN 01 Ernest Van Dijckkaai
649,Ernest Van Dijckkaai,2023-04-16,22:00:00,67,27,40,FMN 01 Ernest Van Dijckkaai
649,Ernest Van Dijckkaai,2023-04-16,23:00:00,41,21,20,FMN 01 Ernest Van Dijckkaai
649,Ernest Van Dijckkaai,2023-04-17,00:00:00,23,10,13,FMN 01 Ernest Van Dijckkaai
649,Ernest Van Dijckkaai,2023-04-17,01:00:00,7,2,5,FMN 01 Ernest Van Dijckkaai
649,Ernest Van Dijckkaai,2023-04-17,02:00:00,3,0,3,FMN 01 Ernest Van Dijckkaai
649,Ernest Van Dijckkaai,2023-04-17,03:00:00,7,2,5,FMN 01 Ernest Van Dijckkaai
649,Ernest Van Dijckkaai,2023-04-17,04:00:00,53,36,17,FMN 01 Ernest Van Dijckkaai
649,Ernest Van Dijckkaai,2023-04-17,05:00:00,102,66,36,FMN 01 Ernest Van Dijckkaai
649,Ernest Van Dijckkaai,2023-04-17,06:00:00,239,149,90,FMN 01 Ernest Van Dijckkaai
649,Ernest Van Dijckkaai,2023-04-17,07:00:00,447,277,170,FMN 01 Ernest Van Dijckkaai
649,Ernest Van Dijckkaai,2023-04-17,08:00:00,625,391,234,FMN 01 Ernest Van Dijckkaai
649,Ernest Van Dijckkaai,2023-04-17,09:00:00,223,148,75,FMN 01 Ernest Van Dijckkaai
649,Ernest Van Dijckkaai,2023-04-17,10:00:00,147,82,65,FMN 01 Ernest Van Dijckkaai
649,Ernest Van Dijckkaai,2023-04-17,11:00:00,143,72,71,FMN 01 Ernest Van Dijckkaai
649,Ernest Van Dijckkaai,2023-04-17,12:00:00,245,135,110,FMN 01 Ernest Van Dijckkaai
649,Ernest Van Dijckkaai,2023-04-17,13:00:00,248,130,118,FMN 01 Ernest Van Dijckkaai
649,Ernest Van Dijckkaai,2023-04-17,14:00:00,254,121,133,FMN 01 Ernest Van Dijckkaai
649,Ernest Van Dijckkaai,2023-04-17,15:00:00,358,172,186,FMN 01 Ernest Van Dijckkaai
649,Ernest Van Dijckkaai,2023-04-17,16:00:00,685,268,417,FMN 01 Ernest Van Dijckkaai
649,Ernest Van Dijckkaai,2023-04-17,17:00:00,640,265,375,FMN 01 Ernest Van Dijckkaai
649,Ernest Van Dijckkaai,2023-04-17,18:00:00,410,200,210,FMN 01 Ernest Van Dijckkaai
649,Ernest Van Dijckkaai,2023-04-17,19:00:00,237,113,124,FMN 01 Ernest Van Dijckkaai
649,Ernest Van Dijckkaai,2023-04-17,20:00:00,177,84,93,FMN 01 Ernest Van Dijckkaai
649,Ernest Van Dijckkaai,2023-04-17,21:00:00,121,62,59,FMN 01 Ernest Van Dijckkaai
649,Ernest Van Dijckkaai,2023-04-17,22:00:00,128,39,89,FMN 01 Ernest Van Dijckkaai
649,Ernest Van Dijckkaai,2023-04-17,23:00:00,42,17,25,FMN 01 Ernest Van Dijckkaai
649,Ernest Van Dijckkaai,2023-04-18,00:00:00,28,14,14,FMN 01 Ernest Van Dijckkaai
649,Ernest Van Dijckkaai,2023-04-18,01:00:00,16,7,9,FMN 01 Ernest Van Dijckkaai
649,Ernest Van Dijckkaai,2023-04-18,02:00:00,5,2,3,FMN 01 Ernest Van Dijckkaai
649,Ernest Van Dijckkaai,2023-04-18,03:00:00,13,5,8,FMN 01 Ernest Van Dijckkaai
649,Ernest Van Dijckkaai,2023-04-18,04:00:00,62,42,20,FMN 01 Ernest Van Dijckkaai
649,Ernest Van Dijckkaai,2023-04-18,05:00:00,113,72,41,FMN 01 Ernest Van Dijckkaai
649,Ernest Van Dijckkaai,2023-04-18,06:00:00,273,175,98,FMN 01 Ernest Van Dijckkaai
649,Ernest Van Dijckkaai,2023-04-18,07:00:00,523,313,210,FMN 01 Ernest Van Dijckkaai
649,Ernest Van Dijckkaai,2023-04-18,08:00:00,694,450,244,FMN 01 Ernest Van Dijckkaai
649,Ernest Van Dijckkaai,2023-04-18,09:00:00,285,164,121,FMN 01 Ernest Van Dijckkaai
649,Ernest Van Dijckkaai,2023-04-18,10:00:00,190,110,80,FMN 01 Ernest Van Dijckkaai
649,Ernest Van Dijckkaai,2023-04-18,11:00:00,206,113,93,FMN 01 Ernest Van Dijckkaai
649,Ernest Van Dijckkaai,2023-04-18,12:00:00,247,138,109,FMN 01 Ernest Van Dijckkaai
649,Ernest Van Dijckkaai,2023-04-18,13:00:00,302,148,154,FMN 01 Ernest Van Dijckkaai
649,Ernest Van Dijckkaai,2023-04-18,14:00:00,275,114,161,FMN 01 Ernest Van Dijckkaai
649,Ernest Van Dijckkaai,2023-04-18,15:00:00,413,184,229,FMN 01 Ernest Van Dijckkaai
649,Ernest Van Dijckkaai,2023-04-18,16:00:00,670,251,419,FMN 01 Ernest Van Dijckkaai
649,Ernest Van Dijckkaai,2023-04-18,17:00:00,769,335,434,FMN 01 Ernest Van Dijckkaai
649,Ernest Van Dijckkaai,2023-04-18,18:00:00,443,216,227,FMN 01 Ernest Van Dijckkaai
649,Ernest Van Dijckkaai,2023-04-18,19:00:00,293,141,152,FMN 01 Ernest Van Dijckkaai
649,Ernest Van Dijckkaai,2023-04-18,20:00:00,207,99,108,FMN 01 Ernest Van Dijckkaai
649,Ernest Van Dijckkaai,2023-04-18,21:00:00,137,59,78,FMN 01 Ernest Van Dijckkaai
649,Ernest Van Dijckkaai,2023-04-18,22:00:00,164,54,110,FMN 01 Ernest Van Dijckkaai
649,Ernest Van Dijckkaai,2023-04-18,23:00:00,74,34,40,FMN 01 Ernest Van Dijckkaai
649,Ernest Van Dijckkaai,2023-04-19,00:00:00,38,17,21,FMN 01 Ernest Van Dijckkaai
649,Ernest Van Dijckkaai,2023-04-19,01:00:00,15,3,12,FMN 01 Ernest Van Dijckkaai
649,Ernest Van Dijckkaai,2023-04-19,02:00:00,11,3,8,FMN 01 Ernest Van Dijckkaai
649,Ernest Van Dijckkaai,2023-04-19,03:00:00,8,4,4,FMN 01 Ernest Van Dijckkaai
649,Ernest Van Dijckkaai,2023-04-19,04:00:00,53,38,15,FMN 01 Ernest Van Dijckkaai
649,Ernest Van Dijckkaai,2023-04-19,05:00:00,121,81,40,FMN 01 Ernest Van Dijckkaai
649,Ernest Van Dijckkaai,2023-04-19,06:00:00,274,167,107,FMN 01 Ernest Van Dijckkaai
649,Ernest Van Dijckkaai,2023-04-19,07:00:00,443,291,152,FMN 01 Ernest Van Dijckkaai
649,Ernest Van Dijckkaai,2023-04-19,08:00:00,570,363,207,FMN 01 Ernest Van Dijckkaai
649,Ernest Van Dijckkaai,2023-04-19,09:00:00,267,146,121,FMN 01 Ernest Van Dijckkaai
649,Ernest Van Dijckkaai,2023-04-19,10:00:00,208,105,103,FMN 01 Ernest Van Dijckkaai
649,Ernest Van Dijckkaai,2023-04-19,11:00:00,220,107,113,FMN 01 Ernest Van Dijckkaai
649,Ernest Van Dijckkaai,2023-04-19,12:00:00,384,181,203,FMN 01 Ernest Van Dijckkaai
649,Ernest Van Dijckkaai,2023-04-19,13:00:00,324,177,147,FMN 01 Ernest Van Dijckkaai
649,Ernest Van Dijckkaai,2023-04-19,14:00:00,349,179,170,FMN 01 Ernest Van Dijckkaai
649,Ernest Van Dijckkaai,2023-04-19,15:00:00,403,202,201,FMN 01 Ernest Van Dijckkaai
649,Ernest Van Dijckkaai,2023-04-19,16:00:00,663,262,401,FMN 01 Ernest Van Dijckkaai
649,Ernest Van Dijckkaai,2023-04-19,17:00:00,710,303,407,FMN 01 Ernest Van Dijckkaai
649,Ernest Van Dijckkaai,2023-04-19,18:00:00,562,299,263,FMN 01 Ernest Van Dijckkaai
649,Ernest Van Dijckkaai,2023-04-19,19:00:00,300,147,153,FMN 01 Ernest Van Dijckkaai
649,Ernest Van Dijckkaai,2023-04-19,20:00:00,256,134,122,FMN 01 Ernest Van Dijckkaai
649,Ernest Van Dijckkaai,2023-04-19,21:00:00,161,61,100,FMN 01 Ernest Van Dijckkaai
649,Ernest Van Dijckkaai,2023-04-19,22:00:00,222,59,163,FMN 01 Ernest Van Dijckkaai
649,Ernest Van Dijckkaai,2023-04-19,23:00:00,102,43,59,FMN 01 Ernest Van Dijckkaai
649,Ernest Van Dijckkaai,2023-04-20,00:00:00,43,16,27,FMN 01 Ernest Van Dijckkaai
649,Ernest Van Dijckkaai,2023-04-20,01:00:00,10,4,6,FMN 01 Ernest Van Dijckkaai
649,Ernest Van Dijckkaai,2023-04-20,02:00:00,7,3,4,FMN 01 Ernest Van Dijckkaai
649,Ernest Van Dijckkaai,2023-04-20,03:00:00,15,6,9,FMN 01 Ernest Van Dijckkaai
649,Ernest Van Dijckkaai,2023-04-20,04:00:00,48,35,13,FMN 01 Ernest Van Dijckkaai
649,Ernest Van Dijckkaai,2023-04-20,05:00:00,96,64,32,FMN 01 Ernest Van Dijckkaai
649,Ernest Van Dijckkaai,2023-04-20,06:00:00,224,139,85,FMN 01 Ernest Van Dijckkaai
649,Ernest Van Dijckkaai,2023-04-20,07:00:00,395,236,159,FMN 01 Ernest Van Dijckkaai
649,Ernest Van Dijckkaai,2023-04-20,08:00:00,539,319,220,FMN 01 Ernest Van Dijckkaai
649,Ernest Van Dijckkaai,2023-04-20,09:00:00,240,142,98,FMN 01 Ernest Van Dijckkaai
649,Ernest Van Dijckkaai,2023-04-20,10:00:00,158,92,66,FMN 01 Ernest Van Dijckkaai
649,Ernest Van Dijckkaai,2023-04-20,11:00:00,140,61,79,FMN 01 Ernest Van Dijckkaai
649,Ernest Van Dijckkaai,2023-04-20,12:00:00,241,132,109,FMN 01 Ernest Van Dijckkaai
649,Ernest Van Dijckkaai,2023-04-20,13:00:00,227,127,100,FMN 01 Ernest Van Dijckkaai
649,Ernest Van Dijckkaai,2023-04-20,14:00:00,269,110,159,FMN 01 Ernest Van Dijckkaai
649,Ernest Van Dijckkaai,2023-04-20,15:00:00,329,156,173,FMN 01 Ernest Van Dijckkaai
649,Ernest Van Dijckkaai,2023-04-20,16:00:00,505,195,310,FMN 01 Ernest Van Dijckkaai
649,Ernest Van Dijckkaai,2023-04-20,17:00:00,552,241,311,FMN 01 Ernest Van Dijckkaai
649,Ernest Van Dijckkaai,2023-04-20,18:00:00,408,217,191,FMN 01 Ernest Van Dijckkaai
649,Ernest Van Dijckkaai,2023-04-20,19:00:00,211,108,103,FMN 01 Ernest Van Dijckkaai
649,Ernest Van Dijckkaai,2023-04-20,20:00:00,158,83,75,FMN 01 Ernest Van Dijckkaai
649,Ernest Van Dijckkaai,2023-04-20,21:00:00,134,66,68,FMN 01 Ernest Van Dijckkaai
649,Ernest Van Dijckkaai,2023-04-20,22:00:00,189,67,122,FMN 01 Ernest Van Dijckkaai
649,Ernest Van Dijckkaai,2023-04-20,23:00:00,96,40,56,FMN 01 Ernest Van Dijckkaai
649,Ernest Van Dijckkaai,2023-04-21,00:00:00,54,26,28,FMN 01 Ernest Van Dijckkaai
649,Ernest Van Dijckkaai,2023-04-21,01:00:00,46,20,26,FMN 01 Ernest Van Dijckkaai
649,Ernest Van Dijckkaai,2023-04-21,02:00:00,30,8,22,FMN 01 Ernest Van Dijckkaai
649,Ernest Van Dijckkaai,2023-04-21,03:00:00,25,3,22,FMN 01 Ernest Van Dijckkaai
649,Ernest Van Dijckkaai,2023-04-21,04:00:00,62,25,37,FMN 01 Ernest Van Dijckkaai
649,Ernest Van Dijckkaai,2023-04-21,05:00:00,94,59,35,FMN 01 Ernest Van Dijckkaai
649,Ernest Van Dijckkaai,2023-04-21,06:00:00,206,130,76,FMN 01 Ernest Van Dijckkaai
649,Ernest Van Dijckkaai,2023-04-21,07:00:00,339,203,136,FMN 01 Ernest Van Dijckkaai
649,Ernest Van Dijckkaai,2023-04-21,08:00:00,470,292,178,FMN 01 Ernest Van Dijckkaai
649,Ernest Van Dijckkaai,2023-04-21,09:00:00,282,178,104,FMN 01 Ernest Van Dijckkaai
649,Ernest Van Dijckkaai,2023-04-21,10:00:00,198,106,92,FMN 01 Ernest Van Dijckkaai
649,Ernest Van Dijckkaai,2023-04-21,11:00:00,219,114,105,FMN 01 Ernest Van Dijckkaai
649,Ernest Van Dijckkaai,2023-04-21,12:00:00,342,161,181,FMN 01 Ernest Van Dijckkaai
649,Ernest Van Dijckkaai,2023-04-21,13:00:00,362,204,158,FMN 01 Ernest Van Dijckkaai
649,Ernest Van Dijckkaai,2023-04-21,14:00:00,477,224,253,FMN 01 Ernest Van Dijckkaai
649,Ernest Van Dijckkaai,2023-04-21,15:00:00,450,193,257,FMN 01 Ernest Van Dijckkaai
649,Ernest Van Dijckkaai,2023-04-21,16:00:00,641,269,372,FMN 01 Ernest Van Dijckkaai
649,Ernest Van Dijckkaai,2023-04-21,17:00:00,571,237,334,FMN 01 Ernest Van Dijckkaai
649,Ernest Van Dijckkaai,2023-04-21,18:00:00,420,195,225,FMN 01 Ernest Van Dijckkaai
649,Ernest Van Dijckkaai,2023-04-21,19:00:00,315,149,166,FMN 01 Ernest Van Dijckkaai
649,Ernest Van Dijckkaai,2023-04-21,20:00:00,251,132,119,FMN 01 Ernest Van Dijckkaai
649,Ernest Van Dijckkaai,2023-04-21,21:00:00,142,63,79,FMN 01 Ernest Van Dijckkaai
649,Ernest Van Dijckkaai,2023-04-21,22:00:00,182,86,96,FMN 01 Ernest Van Dijckkaai
649,Ernest Van Dijckkaai,2023-04-21,23:00:00,134,44,90,FMN 01 Ernest Van Dijckkaai
649,Ernest Van Dijckkaai,2023-04-22,00:00:00,113,53,60,FMN 01 Ernest Van Dijckkaai
649,Ernest Van Dijckkaai,2023-04-22,01:00:00,70,37,33,FMN 01 Ernest Van Dijckkaai
649,Ernest Van Dijckkaai,2023-04-22,02:00:00,52,23,29,FMN 01 Ernest Van Dijckkaai
649,Ernest Van Dijckkaai,2023-04-22,03:00:00,33,12,21,FMN 01 Ernest Van Dijckkaai
649,Ernest Van Dijckkaai,2023-04-22,04:00:00,52,31,21,FMN 01 Ernest Van Dijckkaai
649,Ernest Van Dijckkaai,2023-04-22,05:00:00,37,16,21,FMN 01 Ernest Van Dijckkaai
649,Ernest Van Dijckkaai,2023-04-22,06:00:00,37,19,18,FMN 01 Ernest Van Dijckkaai
649,Ernest Van Dijckkaai,2023-04-22,07:00:00,45,19,26,FMN 01 Ernest Van Dijckkaai
649,Ernest Van Dijckkaai,2023-04-22,08:00:00,83,44,39,FMN 01 Ernest Van Dijckkaai
649,Ernest Van Dijckkaai,2023-04-22,09:00:00,188,95,93,FMN 01 Ernest Van Dijckkaai
649,Ernest Van Dijckkaai,2023-04-22,10:00:00,229,122,107,FMN 01 Ernest Van Dijckkaai
649,Ernest Van Dijckkaai,2023-04-22,11:00:00,288,150,138,FMN 01 Ernest Van Dijckkaai
649,Ernest Van Dijckkaai,2023-04-22,12:00:00,192,109,83,FMN 01 Ernest Van Dijckkaai
649,Ernest Van Dijckkaai,2023-04-22,13:00:00,162,89,73,FMN 01 Ernest Van Dijckkaai
649,Ernest Van Dijckkaai,2023-04-22,14:00:00,177,85,92,FMN 01 Ernest Van Dijckkaai
649,Ernest Van Dijckkaai,2023-04-22,15:00:00,230,113,117,FMN 01 Ernest Van Dijckkaai
649,Ernest Van Dijckkaai,2023-04-22,16:00:00,171,67,104,FMN 01 Ernest Van Dijckkaai
649,Ernest Van Dijckkaai,2023-04-22,17:00:00,183,84,99,FMN 01 Ernest Van Dijckkaai
649,Ernest Van Dijckkaai,2023-04-22,18:00:00,166,100,66,FMN 01 Ernest Van Dijckkaai
649,Ernest Van Dijckkaai,2023-04-22,19:00:00,176,91,85,FMN 01 Ernest Van Dijckkaai
649,Ernest Van Dijckkaai,2023-04-22,20:00:00,159,89,70,FMN 01 Ernest Van Dijckkaai
649,Ernest Van Dijckkaai,2023-04-22,21:00:00,113,58,55,FMN 01 Ernest Van Dijckkaai
649,Ernest Van Dijckkaai,2023-04-22,22:00:00,95,38,57,FMN 01 Ernest Van Dijckkaai
649,Ernest Van Dijckkaai,2023-04-22,23:00:00,106,53,53,FMN 01 Ernest Van Dijckkaai
649,Ernest Van Dijckkaai,2023-04-23,00:00:00,58,20,38,FMN 01 Ernest Van Dijckkaai
649,Ernest Van Dijckkaai,2023-04-23,01:00:00,49,20,29,FMN 01 Ernest Van Dijckkaai
649,Ernest Van Dijckkaai,2023-04-23,02:00:00,35,15,20,FMN 01 Ernest Van Dijckkaai
649,Ernest Van Dijckkaai,2023-04-23,03:00:00,31,10,21,FMN 01 Ernest Van Dijckkaai
649,Ernest Van Dijckkaai,2023-04-23,04:00:00,46,13,33,FMN 01 Ernest Van Dijckkaai
649,Ernest Van Dijckkaai,2023-04-23,05:00:00,23,10,13,FMN 01 Ernest Van Dijckkaai
649,Ernest Van Dijckkaai,2023-04-23,06:00:00,29,14,15,FMN 01 Ernest Van Dijckkaai
649,Ernest Van Dijckkaai,2023-04-23,07:00:00,27,10,17,FMN 01 Ernest Van Dijckkaai
649,Ernest Van Dijckkaai,2023-04-23,08:00:00,86,39,47,FMN 01 Ernest Van Dijckkaai
649,Ernest Van Dijckkaai,2023-04-23,09:00:00,257,167,90,FMN 01 Ernest Van Dijckkaai
649,Ernest Van Dijckkaai,2023-04-23,10:00:00,390,242,148,FMN 01 Ernest Van Dijckkaai
649,Ernest Van Dijckkaai,2023-04-23,11:00:00,555,287,268,FMN 01 Ernest Van Dijckkaai
649,Ernest Van Dijckkaai,2023-04-23,12:00:00,622,291,331,FMN 01 Ernest Van Dijckkaai
649,Ernest Van Dijckkaai,2023-04-23,13:00:00,597,228,369,FMN 01 Ernest Van Dijckkaai
649,Ernest Van Dijckkaai,2023-04-23,14:00:00,435,259,176,FMN 01 Ernest Van Dijckkaai
649,Ernest Van Dijckkaai,2023-04-23,15:00:00,460,275,185,FMN 01 Ernest Van Dijckkaai
649,Ernest Van Dijckkaai,2023-04-23,16:00:00,385,192,193,FMN 01 Ernest Van Dijckkaai
649,Ernest Van Dijckkaai,2023-04-23,17:00:00,449,250,199,FMN 01 Ernest Van Dijckkaai
649,Ernest Van Dijckkaai,2023-04-23,18:00:00,330,189,141,FMN 01 Ernest Van Dijckkaai
649,Ernest Van Dijckkaai,2023-04-23,19:00:00,137,75,62,FMN 01 Ernest Van Dijckkaai
649,Ernest Van Dijckkaai,2023-04-23,20:00:00,63,35,28,FMN 01 Ernest Van Dijckkaai
649,Ernest Van Dijckkaai,2023-04-23,21:00:00,78,37,41,FMN 01 Ernest Van Dijckkaai
649,Ernest Van Dijckkaai,2023-04-23,22:00:00,53,22,31,FMN 01 Ernest Van Dijckkaai
649,Ernest Van Dijckkaai,2023-04-23,23:00:00,34,17,17,FMN 01 Ernest Van Dijckkaai
649,Ernest Van Dijckkaai,2023-04-24,00:00:00,16,6,10,FMN 01 Ernest Van Dijckkaai
649,Ernest Van Dijckkaai,2023-04-24,01:00:00,7,2,5,FMN 01 Ernest Van Dijckkaai
649,Ernest Van Dijckkaai,2023-04-24,02:00:00,4,2,2,FMN 01 Ernest Van Dijckkaai
649,Ernest Van Dijckkaai,2023-04-24,03:00:00,11,4,7,FMN 01 Ernest Van Dijckkaai
649,Ernest Van Dijckkaai,2023-04-24,04:00:00,46,30,16,FMN 01 Ernest Van Dijckkaai
649,Ernest Van Dijckkaai,2023-04-24,05:00:00,76,51,25,FMN 01 Ernest Van Dijckkaai
649,Ernest Van Dijckkaai,2023-04-24,06:00:00,168,103,65,FMN 01 Ernest Van Dijckkaai
649,Ernest Van Dijckkaai,2023-04-24,07:00:00,260,156,104,FMN 01 Ernest Van Dijckkaai
649,Ernest Van Dijckkaai,2023-04-24,08:00:00,379,236,143,FMN 01 Ernest Van Dijckkaai
649,Ernest Van Dijckkaai,2023-04-24,09:00:00,204,128,76,FMN 01 Ernest Van Dijckkaai
649,Ernest Van Dijckkaai,2023-04-24,10:00:00,111,73,38,FMN 01 Ernest Van Dijckkaai
649,Ernest Van Dijckkaai,2023-04-24,11:00:00,118,58,60,FMN 01 Ernest Van Dijckkaai
649,Ernest Van Dijckkaai,2023-04-24,12:00:00,214,117,97,FMN 01 Ernest Van Dijckkaai
649,Ernest Van Dijckkaai,2023-04-24,13:00:00,180,104,76,FMN 01 Ernest Van Dijckkaai
649,Ernest Van Dijckkaai,2023-04-24,14:00:00,184,79,105,FMN 01 Ernest Van Dijckkaai
649,Ernest Van Dijckkaai,2023-04-24,15:00:00,275,130,145,FMN 01 Ernest Van Dijckkaai
649,Ernest Van Dijckkaai,2023-04-24,16:00:00,463,181,282,FMN 01 Ernest Van Dijckkaai
649,Ernest Van Dijckkaai,2023-04-24,17:00:00,521,240,281,FMN 01 Ernest Van Dijckkaai
649,Ernest Van Dijckkaai,2023-04-24,18:00:00,327,157,170,FMN 01 Ernest Van Dijckkaai
649,Ernest Van Dijckkaai,2023-04-24,19:00:00,203,84,119,FMN 01 Ernest Van Dijckkaai
649,Ernest Van Dijckkaai,2023-04-24,20:00:00,166,77,89,FMN 01 Ernest Van Dijckkaai
649,Ernest Van Dijckkaai,2023-04-24,21:00:00,134,61,73,FMN 01 Ernest Van Dijckkaai
649,Ernest Van Dijckkaai,2023-04-24,22:00:00,118,49,69,FMN 01 Ernest Van Dijckkaai
649,Ernest Van Dijckkaai,2023-04-24,23:00:00,47,17,30,FMN 01 Ernest Van Dijckkaai
649,Ernest Van Dijckkaai,2023-04-25,00:00:00,30,12,18,FMN 01 Ernest Van Dijckkaai
649,Ernest Van Dijckkaai,2023-04-25,01:00:00,16,5,11,FMN 01 Ernest Van Dijckkaai
649,Ernest Van Dijckkaai,2023-04-25,02:00:00,4,2,2,FMN 01 Ernest Van Dijckkaai
649,Ernest Van Dijckkaai,2023-04-25,03:00:00,10,3,7,FMN 01 Ernest Van Dijckkaai
649,Ernest Van Dijckkaai,2023-04-25,04:00:00,55,38,17,FMN 01 Ernest Van Dijckkaai
649,Ernest Van Dijckkaai,2023-04-25,05:00:00,129,82,47,FMN 01 Ernest Van Dijckkaai
649,Ernest Van Dijckkaai,2023-04-25,06:00:00,275,177,98,FMN 01 Ernest Van Dijckkaai
649,Ernest Van Dijckkaai,2023-04-25,07:00:00,497,304,193,FMN 01 Ernest Van Dijckkaai
649,Ernest Van Dijckkaai,2023-04-25,08:00:00,625,386,239,FMN 01 Ernest Van Dijckkaai
649,Ernest Van Dijckkaai,2023-04-25,09:00:00,332,201,131,FMN 01 Ernest Van Dijckkaai
649,Ernest Van Dijckkaai,2023-04-25,10:00:00,178,114,64,FMN 01 Ernest Van Dijckkaai
649,Ernest Van Dijckkaai,2023-04-25,11:00:00,168,90,78,FMN 01 Ernest Van Dijckkaai
649,Ernest Van Dijckkaai,2023-04-25,12:00:00,269,122,147,FMN 01 Ernest Van Dijckkaai
649,Ernest Van Dijckkaai,2023-04-25,13:00:00,273,156,117,FMN 01 Ernest Van Dijckkaai
649,Ernest Van Dijckkaai,2023-04-25,14:00:00,284,110,174,FMN 01 Ernest Van Dijckkaai
649,Ernest Van Dijckkaai,2023-04-25,15:00:00,410,198,212,FMN 01 Ernest Van Dijckkaai
649,Ernest Van Dijckkaai,2023-04-25,16:00:00,680,304,376,FMN 01 Ernest Van Dijckkaai
649,Ernest Van Dijckkaai,2023-04-25,17:00:00,716,327,389,FMN 01 Ernest Van Dijckkaai
649,Ernest Van Dijckkaai,2023-04-25,18:00:00,452,222,230,FMN 01 Ernest Van Dijckkaai
649,Ernest Van Dijckkaai,2023-04-25,19:00:00,280,146,134,FMN 01 Ernest Van Dijckkaai
649,Ernest Van Dijckkaai,2023-04-25,20:00:00,201,95,106,FMN 01 Ernest Van Dijckkaai
649,Ernest Van Dijckkaai,2023-04-25,21:00:00,154,80,74,FMN 01 Ernest Van Dijckkaai
649,Ernest Van Dijckkaai,2023-04-25,22:00:00,155,45,110,FMN 01 Ernest Van Dijckkaai
649,Ernest Van Dijckkaai,2023-04-25,23:00:00,68,22,46,FMN 01 Ernest Van Dijckkaai
649,Ernest Van Dijckkaai,2023-04-26,00:00:00,21,11,10,FMN 01 Ernest Van Dijckkaai
649,Ernest Van Dijckkaai,2023-04-26,01:00:00,7,3,4,FMN 01 Ernest Van Dijckkaai
649,Ernest Van Dijckkaai,2023-04-26,02:00:00,7,6,1,FMN 01 Ernest Van Dijckkaai
649,Ernest Van Dijckkaai,2023-04-26,03:00:00,14,5,9,FMN 01 Ernest Van Dijckkaai
649,Ernest Van Dijckkaai,2023-04-26,04:00:00,47,30,17,FMN 01 Ernest Van Dijckkaai
649,Ernest Van Dijckkaai,2023-04-26,05:00:00,122,82,40,FMN 01 Ernest Van Dijckkaai
649,Ernest Van Dijckkaai,2023-04-26,06:00:00,258,157,101,FMN 01 Ernest Van Dijckkaai
649,Ernest Van Dijckkaai,2023-04-26,07:00:00,407,255,152,FMN 01 Ernest Van Dijckkaai
649,Ernest Van Dijckkaai,2023-04-26,08:00:00,546,340,206,FMN 01 Ernest Van Dijckkaai
649,Ernest Van Dijckkaai,2023-04-26,09:00:00,242,130,112,FMN 01 Ernest Van Dijckkaai
649,Ernest Van Dijckkaai,2023-04-26,10:00:00,195,127,68,FMN 01 Ernest Van Dijckkaai
649,Ernest Van Dijckkaai,2023-04-26,11:00:00,208,99,109,FMN 01 Ernest Van Dijckkaai
649,Ernest Van Dijckkaai,2023-04-26,12:00:00,355,168,187,FMN 01 Ernest Van Dijckkaai
649,Ernest Van Dijckkaai,2023-04-26,13:00:00,295,172,123,FMN 01 Ernest Van Dijckkaai
649,Ernest Van Dijckkaai,2023-04-26,14:00:00,307,143,164,FMN 01 Ernest Van Dijckkaai
649,Ernest Van Dijckkaai,2023-04-26,15:00:00,346,156,190,FMN 01 Ernest Van Dijckkaai
649,Ernest Van Dijckkaai,2023-04-26,16:00:00,631,274,357,FMN 01 Ernest Van Dijckkaai
649,Ernest Van Dijckkaai,2023-04-26,17:00:00,676,295,381,FMN 01 Ernest Van Dijckkaai
649,Ernest Van Dijckkaai,2023-04-26,18:00:00,464,236,228,FMN 01 Ernest Van Dijckkaai
649,Ernest Van Dijckkaai,2023-04-26,19:00:00,295,133,162,FMN 01 Ernest Van Dijckkaai
649,Ernest Van Dijckkaai,2023-04-26,20:00:00,223,106,117,FMN 01 Ernest Van Dijckkaai
649,Ernest Van Dijckkaai,2023-04-26,21:00:00,167,79,88,FMN 01 Ernest Van Dijckkaai
649,Ernest Van Dijckkaai,2023-04-26,22:00:00,150,56,94,FMN 01 Ernest Van Dijckkaai
649,Ernest Van Dijckkaai,2023-04-26,23:00:00,88,33,55,FMN 01 Ernest Van Dijckkaai
649,Ernest Van Dijckkaai,2023-04-27,00:00:00,25,13,12,FMN 01 Ernest Van Dijckkaai
649,Ernest Van Dijckkaai,2023-04-27,01:00:00,20,10,10,FMN 01 Ernest Van Dijckkaai
649,Ernest Van Dijckkaai,2023-04-27,02:00:00,6,2,4,FMN 01 Ernest Van Dijckkaai
649,Ernest Van Dijckkaai,2023-04-27,03:00:00,5,2,3,FMN 01 Ernest Van Dijckkaai
649,Ernest Van Dijckkaai,2023-04-27,04:00:00,42,29,13,FMN 01 Ernest Van Dijckkaai
649,Ernest Van Dijckkaai,2023-04-27,05:00:00,116,68,48,FMN 01 Ernest Van Dijckkaai
649,Ernest Van Dijckkaai,2023-04-27,06:00:00,272,155,117,FMN 01 Ernest Van Dijckkaai
649,Ernest Van Dijckkaai,2023-04-27,07:00:00,496,302,194,FMN 01 Ernest Van Dijckkaai
649,Ernest Van Dijckkaai,2023-04-27,08:00:00,629,364,265,FMN 01 Ernest Van Dijckkaai
649,Ernest Van Dijckkaai,2023-04-27,09:00:00,331,190,141,FMN 01 Ernest Van Dijckkaai
649,Ernest Van Dijckkaai,2023-04-27,10:00:00,223,127,96,FMN 01 Ernest Van Dijckkaai
649,Ernest Van Dijckkaai,2023-04-27,11:00:00,271,136,135,FMN 01 Ernest Van Dijckkaai
649,Ernest Van Dijckkaai,2023-04-27,12:00:00,384,211,173,FMN 01 Ernest Van Dijckkaai
649,Ernest Van Dijckkaai,2023-04-27,13:00:00,349,203,146,FMN 01 Ernest Van Dijckkaai
649,Ernest Van Dijckkaai,2023-04-27,14:00:00,435,200,235,FMN 01 Ernest Van Dijckkaai
649,Ernest Van Dijckkaai,2023-04-27,15:00:00,548,223,325,FMN 01 Ernest Van Dijckkaai
649,Ernest Van Dijckkaai,2023-04-27,16:00:00,714,282,432,FMN 01 Ernest Van Dijckkaai
649,Ernest Van Dijckkaai,2023-04-27,17:00:00,749,330,419,FMN 01 Ernest Van Dijckkaai
649,Ernest Van Dijckkaai,2023-04-27,18:00:00,556,270,286,FMN 01 Ernest Van Dijckkaai
649,Ernest Van Dijckkaai,2023-04-27,19:00:00,315,149,166,FMN 01 Ernest Van Dijckkaai
649,Ernest Van Dijckkaai,2023-04-27,20:00:00,226,115,111,FMN 01 Ernest Van Dijckkaai
649,Ernest Van Dijckkaai,2023-04-27,21:00:00,173,92,81,FMN 01 Ernest Van Dijckkaai
649,Ernest Van Dijckkaai,2023-04-27,22:00:00,196,72,124,FMN 01 Ernest Van Dijckkaai
649,Ernest Van Dijckkaai,2023-04-27,23:00:00,100,40,60,FMN 01 Ernest Van Dijckkaai
649,Ernest Van Dijckkaai,2023-04-28,00:00:00,55,31,24,FMN 01 Ernest Van Dijckkaai
649,Ernest Van Dijckkaai,2023-04-28,01:00:00,28,22,6,FMN 01 Ernest Van Dijckkaai
649,Ernest Van Dijckkaai,2023-04-28,02:00:00,15,4,11,FMN 01 Ernest Van Dijckkaai
649,Ernest Van Dijckkaai,2023-04-28,03:00:00,33,5,28,FMN 01 Ernest Van Dijckkaai
649,Ernest Van Dijckkaai,2023-04-28,04:00:00,61,34,27,FMN 01 Ernest Van Dijckkaai
649,Ernest Van Dijckkaai,2023-04-28,05:00:00,135,77,58,FMN 01 Ernest Van Dijckkaai
649,Ernest Van Dijckkaai,2023-04-28,06:00:00,239,155,84,FMN 01 Ernest Van Dijckkaai
649,Ernest Van Dijckkaai,2023-04-28,07:00:00,348,219,129,FMN 01 Ernest Van Dijckkaai
649,Ernest Van Dijckkaai,2023-04-28,08:00:00,470,283,187,FMN 01 Ernest Van Dijckkaai
649,Ernest Van Dijckkaai,2023-04-28,09:00:00,230,132,98,FMN 01 Ernest Van Dijckkaai
649,Ernest Van Dijckkaai,2023-04-28,10:00:00,227,123,104,FMN 01 Ernest Van Dijckkaai
649,Ernest Van Dijckkaai,2023-04-28,11:00:00,206,109,97,FMN 01 Ernest Van Dijckkaai
649,Ernest Van Dijckkaai,2023-04-28,12:00:00,250,141,109,FMN 01 Ernest Van Dijckkaai
649,Ernest Van Dijckkaai,2023-04-28,13:00:00,256,132,124,FMN 01 Ernest Van Dijckkaai
649,Ernest Van Dijckkaai,2023-04-28,14:00:00,283,128,155,FMN 01 Ernest Van Dijckkaai
649,Ernest Van Dijckkaai,2023-04-28,15:00:00,400,184,216,FMN 01 Ernest Van Dijckkaai
649,Ernest Van Dijckkaai,2023-04-28,16:00:00,545,227,318,FMN 01 Ernest Van Dijckkaai
649,Ernest Van Dijckkaai,2023-04-28,17:00:00,495,226,269,FMN 01 Ernest Van Dijckkaai
649,Ernest Van Dijckkaai,2023-04-28,18:00:00,334,175,159,FMN 01 Ernest Van Dijckkaai
649,Ernest Van Dijckkaai,2023-04-28,19:00:00,287,147,140,FMN 01 Ernest Van Dijckkaai
649,Ernest Van Dijckkaai,2023-04-28,20:00:00,171,83,88,FMN 01 Ernest Van Dijckkaai
649,Ernest Van Dijckkaai,2023-04-28,21:00:00,158,72,86,FMN 01 Ernest Van Dijckkaai
649,Ernest Van Dijckkaai,2023-04-28,22:00:00,159,67,92,FMN 01 Ernest Van Dijckkaai
649,Ernest Van Dijckkaai,2023-04-28,23:00:00,140,55,85,FMN 01 Ernest Van Dijckkaai
649,Ernest Van Dijckkaai,2023-04-29,00:00:00,88,31,57,FMN 01 Ernest Van Dijckkaai
649,Ernest Van Dijckkaai,2023-04-29,01:00:00,55,27,28,FMN 01 Ernest Van Dijckkaai
649,Ernest Van Dijckkaai,2023-04-29,02:00:00,59,23,36,FMN 01 Ernest Van Dijckkaai
649,Ernest Van Dijckkaai,2023-04-29,03:00:00,28,7,21,FMN 01 Ernest Van Dijckkaai
649,Ernest Van Dijckkaai,2023-04-29,04:00:00,50,18,32,FMN 01 Ernest Van Dijckkaai
649,Ernest Van Dijckkaai,2023-04-29,05:00:00,46,21,25,FMN 01 Ernest Van Dijckkaai
649,Ernest Van Dijckkaai,2023-04-29,06:00:00,50,23,27,FMN 01 Ernest Van Dijckkaai
649,Ernest Van Dijckkaai,2023-04-29,07:00:00,54,26,28,FMN 01 Ernest Van Dijckkaai
649,Ernest Van Dijckkaai,2023-04-29,08:00:00,85,42,43,FMN 01 Ernest Van Dijckkaai
649,Ernest Van Dijckkaai,2023-04-29,09:00:00,153,86,67,FMN 01 Ernest Van Dijckkaai
649,Ernest Van Dijckkaai,2023-04-29,10:00:00,177,118,59,FMN 01 Ernest Van Dijckkaai
649,Ernest Van Dijckkaai,2023-04-29,11:00:00,274,155,119,FMN 01 Ernest Van Dijckkaai
649,Ernest Van Dijckkaai,2023-04-29,12:00:00,323,160,163,FMN 01 Ernest Van Dijckkaai
649,Ernest Van Dijckkaai,2023-04-29,13:00:00,375,212,163,FMN 01 Ernest Van Dijckkaai
649,Ernest Van Dijckkaai,2023-04-29,14:00:00,409,203,206,FMN 01 Ernest Van Dijckkaai
649,Ernest Van Dijckkaai,2023-04-29,15:00:00,417,202,215,FMN 01 Ernest Van Dijckkaai
649,Ernest Van Dijckkaai,2023-04-29,16:00:00,415,190,225,FMN 01 Ernest Van Dijckkaai
649,Ernest Van Dijckkaai,2023-04-29,17:00:00,445,252,193,FMN 01 Ernest Van Dijckkaai
649,Ernest Van Dijckkaai,2023-04-29,18:00:00,428,259,169,FMN 01 Ernest Van Dijckkaai
649,Ernest Van Dijckkaai,2023-04-29,19:00:00,333,191,142,FMN 01 Ernest Van Dijckkaai
649,Ernest Van Dijckkaai,2023-04-29,20:00:00,234,120,114,FMN 01 Ernest Van Dijckkaai
649,Ernest Van Dijckkaai,2023-04-29,21:00:00,189,100,89,FMN 01 Ernest Van Dijckkaai
649,Ernest Van Dijckkaai,2023-04-29,22:00:00,147,61,86,FMN 01 Ernest Van Dijckkaai
649,Ernest Van Dijckkaai,2023-04-29,23:00:00,168,65,103,FMN 01 Ernest Van Dijckkaai
649,Ernest Van Dijckkaai,2023-04-30,00:00:00,143,39,104,FMN 01 Ernest Van Dijckkaai
649,Ernest Van Dijckkaai,2023-04-30,01:00:00,81,30,51,FMN 01 Ernest Van Dijckkaai
649,Ernest Van Dijckkaai,2023-04-30,02:00:00,56,19,37,FMN 01 Ernest Van Dijckkaai
649,Ernest Van Dijckkaai,2023-04-30,03:00:00,58,16,42,FMN 01 Ernest Van Dijckkaai
649,Ernest Van Dijckkaai,2023-04-30,04:00:00,45,22,23,FMN 01 Ernest Van Dijckkaai
649,Ernest Van Dijckkaai,2023-04-30,05:00:00,32,18,14,FMN 01 Ernest Van Dijckkaai
649,Ernest Van Dijckkaai,2023-04-30,06:00:00,62,32,30,FMN 01 Ernest Van Dijckkaai
649,Ernest Van Dijckkaai,2023-04-30,07:00:00,39,21,18,FMN 01 Ernest Van Dijckkaai
649,Ernest Van Dijckkaai,2023-04-30,08:00:00,106,64,42,FMN 01 Ernest Van Dijckkaai
649,Ernest Van Dijckkaai,2023-04-30,09:00:00,205,107,98,FMN 01 Ernest Van Dijckkaai
649,Ernest Van Dijckkaai,2023-04-30,10:00:00,340,175,165,FMN 01 Ernest Van Dijckkaai
649,Ernest Van Dijckkaai,2023-04-30,11:00:00,363,212,151,FMN 01 Ernest Van Dijckkaai
649,Ernest Van Dijckkaai,2023-04-30,12:00:00,441,256,185,FMN 01 Ernest Van Dijckkaai
649,Ernest Van Dijckkaai,2023-04-30,13:00:00,570,273,297,FMN 01 Ernest Van Dijckkaai
649,Ernest Van Dijckkaai,2023-04-30,14:00:00,707,372,335,FMN 01 Ernest Van Dijckkaai
649,Ernest Van Dijckkaai,2023-04-30,15:00:00,652,331,321,FMN 01 Ernest Van Dijckkaai
649,Ernest Van Dijckkaai,2023-04-30,16:00:00,630,327,303,FMN 01 Ernest Van Dijckkaai
649,Ernest Van Dijckkaai,2023-04-30,17:00:00,569,295,274,FMN 01 Ernest Van Dijckkaai
649,Ernest Van Dijckkaai,2023-04-30,18:00:00,448,234,214,FMN 01 Ernest Van Dijckkaai
649,Ernest Van Dijckkaai,2023-04-30,19:00:00,342,164,178,FMN 01 Ernest Van Dijckkaai
649,Ernest Van Dijckkaai,2023-04-30,20:00:00,297,120,177,FMN 01 Ernest Van Dijckkaai
649,Ernest Van Dijckkaai,2023-04-30,21:00:00,207,88,119,FMN 01 Ernest Van Dijckkaai
649,Ernest Van Dijckkaai,2023-04-30,22:00:00,244,83,161,FMN 01 Ernest Van Dijckkaai
649,Ernest Van Dijckkaai,2023-04-30,23:00:00,146,38,108,FMN 01 Ernest Van Dijckkaai
649,Ernest Van Dijckkaai,2023-05-01,00:00:00,72,26,46,FMN 01 Ernest Van Dijckkaai
649,Ernest Van Dijckkaai,2023-05-01,01:00:00,61,17,44,FMN 01 Ernest Van Dijckkaai
649,Ernest Van Dijckkaai,2023-05-01,02:00:00,31,10,21,FMN 01 Ernest Van Dijckkaai
649,Ernest Van Dijckkaai,2023-05-01,03:00:00,28,10,18,FMN 01 Ernest Van Dijckkaai
649,Ernest Van Dijckkaai,2023-05-01,04:00:00,29,15,14,FMN 01 Ernest Van Dijckkaai
649,Ernest Van Dijckkaai,2023-05-01,05:00:00,29,20,9,FMN 01 Ernest Van Dijckkaai
649,Ernest Van Dijckkaai,2023-05-01,06:00:00,42,24,18,FMN 01 Ernest Van Dijckkaai
649,Ernest Van Dijckkaai,2023-05-01,07:00:00,40,17,23,FMN 01 Ernest Van Dijckkaai
649,Ernest Van Dijckkaai,2023-05-01,08:00:00,56,24,32,FMN 01 Ernest Van Dijckkaai
649,Ernest Van Dijckkaai,2023-05-01,09:00:00,148,74,74,FMN 01 Ernest Van Dijckkaai
649,Ernest Van Dijckkaai,2023-05-01,10:00:00,228,120,108,FMN 01 Ernest Van Dijckkaai
649,Ernest Van Dijckkaai,2023-05-01,11:00:00,267,138,129,FMN 01 Ernest Van Dijckkaai
649,Ernest Van Dijckkaai,2023-05-01,12:00:00,200,107,93,FMN 01 Ernest Van Dijckkaai
649,Ernest Van Dijckkaai,2023-05-01,13:00:00,327,184,143,FMN 01 Ernest Van Dijckkaai
649,Ernest Van Dijckkaai,2023-05-01,14:00:00,443,249,194,FMN 01 Ernest Van Dijckkaai
649,Ernest Van Dijckkaai,2023-05-01,15:00:00,389,191,198,FMN 01 Ernest Van Dijckkaai
649,Ernest Van Dijckkaai,2023-05-01,16:00:00,427,228,199,FMN 01 Ernest Van Dijckkaai
649,Ernest Van Dijckkaai,2023-05-01,17:00:00,403,194,209,FMN 01 Ernest Van Dijckkaai
649,Ernest Van Dijckkaai,2023-05-01,18:00:00,288,123,165,FMN 01 Ernest Van Dijckkaai
649,Ernest Van Dijckkaai,2023-05-01,19:00:00,242,120,122,FMN 01 Ernest Van Dijckkaai
649,Ernest Van Dijckkaai,2023-05-01,20:00:00,199,98,101,FMN 01 Ernest Van Dijckkaai
649,Ernest Van Dijckkaai,2023-05-01,21:00:00,116,66,50,FMN 01 Ernest Van Dijckkaai
649,Ernest Van Dijckkaai,2023-05-01,22:00:00,110,36,74,FMN 01 Ernest Van Dijckkaai
649,Ernest Van Dijckkaai,2023-05-01,23:00:00,64,32,32,FMN 01 Ernest Van Dijckkaai
649,Ernest Van Dijckkaai,2023-05-02,00:00:00,19,6,13,FMN 01 Ernest Van Dijckkaai
649,Ernest Van Dijckkaai,2023-05-02,01:00:00,9,3,6,FMN 01 Ernest Van Dijckkaai
649,Ernest Van Dijckkaai,2023-05-02,02:00:00,9,3,6,FMN 01 Ernest Van Dijckkaai
649,Ernest Van Dijckkaai,2023-05-02,03:00:00,10,3,7,FMN 01 Ernest Van Dijckkaai
649,Ernest Van Dijckkaai,2023-05-02,04:00:00,59,40,19,FMN 01 Ernest Van Dijckkaai
649,Ernest Van Dijckkaai,2023-05-02,05:00:00,117,76,41,FMN 01 Ernest Van Dijckkaai
649,Ernest Van Dijckkaai,2023-05-02,06:00:00,280,169,111,FMN 01 Ernest Van Dijckkaai
649,Ernest Van Dijckkaai,2023-05-02,07:00:00,506,301,205,FMN 01 Ernest Van Dijckkaai
649,Ernest Van Dijckkaai,2023-05-02,08:00:00,685,411,274,FMN 01 Ernest Van Dijckkaai
649,Ernest Van Dijckkaai,2023-05-02,09:00:00,398,254,144,FMN 01 Ernest Van Dijckkaai
649,Ernest Van Dijckkaai,2023-05-02,10:00:00,176,101,75,FMN 01 Ernest Van Dijckkaai
649,Ernest Van Dijckkaai,2023-05-02,11:00:00,211,110,101,FMN 01 Ernest Van Dijckkaai
649,Ernest Van Dijckkaai,2023-05-02,12:00:00,332,188,144,FMN 01 Ernest Van Dijckkaai
649,Ernest Van Dijckkaai,2023-05-02,13:00:00,400,205,195,FMN 01 Ernest Van Dijckkaai
649,Ernest Van Dijckkaai,2023-05-02,14:00:00,421,198,223,FMN 01 Ernest Van Dijckkaai
649,Ernest Van Dijckkaai,2023-05-02,15:00:00,476,219,257,FMN 01 Ernest Van Dijckkaai
649,Ernest Van Dijckkaai,2023-05-02,16:00:00,712,322,390,FMN 01 Ernest Van Dijckkaai
649,Ernest Van Dijckkaai,2023-05-02,17:00:00,769,338,431,FMN 01 Ernest Van Dijckkaai
649,Ernest Van Dijckkaai,2023-05-02,18:00:00,529,242,287,FMN 01 Ernest Van Dijckkaai
649,Ernest Van Dijckkaai,2023-05-02,19:00:00,325,156,169,FMN 01 Ernest Van Dijckkaai
649,Ernest Van Dijckkaai,2023-05-02,20:00:00,252,118,134,FMN 01 Ernest Van Dijckkaai
649,Ernest Van Dijckkaai,2023-05-02,21:00:00,175,89,86,FMN 01 Ernest Van Dijckkaai
649,Ernest Van Dijckkaai,2023-05-02,22:00:00,197,78,119,FMN 01 Ernest Van Dijckkaai
649,Ernest Van Dijckkaai,2023-05-02,23:00:00,55,19,36,FMN 01 Ernest Van Dijckkaai
649,Ernest Van Dijckkaai,2023-05-03,00:00:00,26,12,14,FMN 01 Ernest Van Dijckkaai
649,Ernest Van Dijckkaai,2023-05-03,01:00:00,8,4,4,FMN 01 Ernest Van Dijckkaai
649,Ernest Van Dijckkaai,2023-05-03,02:00:00,6,0,6,FMN 01 Ernest Van Dijckkaai
649,Ernest Van Dijckkaai,2023-05-03,03:00:00,14,3,11,FMN 01 Ernest Van Dijckkaai
649,Ernest Van Dijckkaai,2023-05-03,04:00:00,62,41,21,FMN 01 Ernest Van Dijckkaai
649,Ernest Van Dijckkaai,2023-05-03,05:00:00,115,79,36,FMN 01 Ernest Van Dijckkaai
649,Ernest Van Dijckkaai,2023-05-03,06:00:00,314,192,122,FMN 01 Ernest Van Dijckkaai
649,Ernest Van Dijckkaai,2023-05-03,07:00:00,492,304,188,FMN 01 Ernest Van Dijckkaai
649,Ernest Van Dijckkaai,2023-05-03,08:00:00,625,403,222,FMN 01 Ernest Van Dijckkaai
649,Ernest Van Dijckkaai,2023-05-03,09:00:00,271,142,129,FMN 01 Ernest Van Dijckkaai
649,Ernest Van Dijckkaai,2023-05-03,10:00:00,239,130,109,FMN 01 Ernest Van Dijckkaai
649,Ernest Van Dijckkaai,2023-05-03,11:00:00,254,146,108,FMN 01 Ernest Van Dijckkaai
649,Ernest Van Dijckkaai,2023-05-03,12:00:00,436,217,219,FMN 01 Ernest Van Dijckkaai
649,Ernest Van Dijckkaai,2023-05-03,13:00:00,443,236,207,FMN 01 Ernest Van Dijckkaai
649,Ernest Van Dijckkaai,2023-05-03,14:00:00,423,204,219,FMN 01 Ernest Van Dijckkaai
649,Ernest Van Dijckkaai,2023-05-03,15:00:00,321,155,166,FMN 01 Ernest Van Dijckkaai
649,Ernest Van Dijckkaai,2023-05-03,16:00:00,0,0,0,FMN 01 Ernest Van Dijckkaai
649,Ernest Van Dijckkaai,2023-05-03,17:00:00,0,0,0,FMN 01 Ernest Van Dijckkaai
649,Ernest Van Dijckkaai,2023-05-03,18:00:00,0,0,0,FMN 01 Ernest Van Dijckkaai
649,Ernest Van Dijckkaai,2023-05-03,19:00:00,0,0,0,FMN 01 Ernest Van Dijckkaai
649,Ernest Van Dijckkaai,2023-05-03,20:00:00,0,0,0,FMN 01 Ernest Van Dijckkaai
649,Ernest Van Dijckkaai,2023-05-03,21:00:00,0,0,0,FMN 01 Ernest Van Dijckkaai
649,Ernest Van Dijckkaai,2023-05-03,22:00:00,0,0,0,FMN 01 Ernest Van Dijckkaai
649,Ernest Van Dijckkaai,2023-05-03,23:00:00,0,0,0,FMN 01 Ernest Van Dijckkaai
649,Ernest Van Dijckkaai,2023-05-18,00:00:00,0,0,0,FMN 01 Ernest Van Dijckkaai
649,Ernest Van Dijckkaai,2023-05-18,01:00:00,18,8,10,FMN 01 Ernest Van Dijckkaai
649,Ernest Van Dijckkaai,2023-05-18,02:00:00,11,4,7,FMN 01 Ernest Van Dijckkaai
649,Ernest Van Dijckkaai,2023-05-18,03:00:00,10,0,10,FMN 01 Ernest Van Dijckkaai
649,Ernest Van Dijckkaai,2023-05-18,04:00:00,41,29,12,FMN 01 Ernest Van Dijckkaai
649,Ernest Van Dijckkaai,2023-05-18,05:00:00,86,55,31,FMN 01 Ernest Van Dijckkaai
649,Ernest Van Dijckkaai,2023-05-18,06:00:00,209,131,78,FMN 01 Ernest Van Dijckkaai
649,Ernest Van Dijckkaai,2023-05-18,07:00:00,331,220,111,FMN 01 Ernest Van Dijckkaai
649,Ernest Van Dijckkaai,2023-05-18,08:00:00,432,264,168,FMN 01 Ernest Van Dijckkaai
649,Ernest Van Dijckkaai,2023-05-18,09:00:00,215,134,81,FMN 01 Ernest Van Dijckkaai
649,Ernest Van Dijckkaai,2023-05-18,10:00:00,155,85,70,FMN 01 Ernest Van Dijckkaai
649,Ernest Van Dijckkaai,2023-05-18,11:00:00,175,97,78,FMN 01 Ernest Van Dijckkaai
649,Ernest Van Dijckkaai,2023-05-18,12:00:00,240,126,114,FMN 01 Ernest Van Dijckkaai
649,Ernest Van Dijckkaai,2023-05-18,13:00:00,257,128,129,FMN 01 Ernest Van Dijckkaai
649,Ernest Van Dijckkaai,2023-05-18,14:00:00,273,125,148,FMN 01 Ernest Van Dijckkaai
649,Ernest Van Dijckkaai,2023-05-18,15:00:00,357,171,186,FMN 01 Ernest Van Dijckkaai
649,Ernest Van Dijckkaai,2023-05-18,16:00:00,511,201,310,FMN 01 Ernest Van Dijckkaai
649,Ernest Van Dijckkaai,2023-05-18,17:00:00,553,218,335,FMN 01 Ernest Van Dijckkaai
649,Ernest Van Dijckkaai,2023-05-18,18:00:00,337,148,189,FMN 01 Ernest Van Dijckkaai
649,Ernest Van Dijckkaai,2023-05-18,19:00:00,209,98,111,FMN 01 Ernest Van Dijckkaai
649,Ernest Van Dijckkaai,2023-05-18,20:00:00,168,74,94,FMN 01 Ernest Van Dijckkaai
649,Ernest Van Dijckkaai,2023-05-18,21:00:00,148,68,80,FMN 01 Ernest Van Dijckkaai
649,Ernest Van Dijckkaai,2023-05-18,22:00:00,143,49,94,FMN 01 Ernest Van Dijckkaai
649,Ernest Van Dijckkaai,2023-05-18,23:00:00,88,36,52,FMN 01 Ernest Van Dijckkaai
649,Ernest Van Dijckkaai,2023-05-19,00:00:00,0,0,0,FMN 01 Ernest Van Dijckkaai
649,Ernest Van Dijckkaai,2023-05-19,01:00:00,19,7,12,FMN 01 Ernest Van Dijckkaai
649,Ernest Van Dijckkaai,2023-05-19,02:00:00,15,4,11,FMN 01 Ernest Van Dijckkaai
649,Ernest Van Dijckkaai,2023-05-19,03:00:00,13,5,8,FMN 01 Ernest Van Dijckkaai
649,Ernest Van Dijckkaai,2023-05-19,04:00:00,36,22,14,FMN 01 Ernest Van Dijckkaai
649,Ernest Van Dijckkaai,2023-05-19,05:00:00,67,43,24,FMN 01 Ernest Van Dijckkaai
649,Ernest Van Dijckkaai,2023-05-19,06:00:00,152,100,52,FMN 01 Ernest Van Dijckkaai
649,Ernest Van Dijckkaai,2023-05-19,07:00:00,270,168,102,FMN 01 Ernest Van Dijckkaai
649,Ernest Van Dijckkaai,2023-05-19,08:00:00,347,214,133,FMN 01 Ernest Van Dijckkaai
649,Ernest Van Dijckkaai,2023-05-19,09:00:00,189,107,82,FMN 01 Ernest Van Dijckkaai
649,Ernest Van Dijckkaai,2023-05-19,10:00:00,136,78,58,FMN 01 Ernest Van Dijckkaai
649,Ernest Van Dijckkaai,2023-05-19,11:00:00,159,83,76,FMN 01 Ernest Van Dijckkaai
649,Ernest Van Dijckkaai,2023-05-19,12:00:00,221,121,100,FMN 01 Ernest Van Dijckkaai
649,Ernest Van Dijckkaai,2023-05-19,13:00:00,233,120,113,FMN 01 Ernest Van Dijckkaai
649,Ernest Van Dijckkaai,2023-05-19,14:00:00,246,113,133,FMN 01 Ernest Van Dijckkaai
649,Ernest Van Dijckkaai,2023-05-19,15:00:00,330,149,181,FMN 01 Ernest Van Dijckkaai
649,Ernest Van Dijckkaai,2023-05-19,16:00:00,427,166,261,FMN 01 Ernest Van Dijckkaai
649,Ernest Van Dijckkaai,2023-05-19,17:00:00,401,168,233,FMN 01 Ernest Van Dijckkaai
649,Ernest Van Dijckkaai,2023-05-19,18:00:00,278,131,147,FMN 01 Ernest Van Dijckkaai
649,Ernest Van Dijckkaai,2023-05-19,19:00:00,211,109,102,FMN 01 Ernest Van Dijckkaai
649,Ernest Van Dijckkaai,2023-05-19,20:00:00,161,84,77,FMN 01 Ernest Van Dijckkaai
649,Ernest Van Dijckkaai,2023-05-19,21:00:00,147,74,73,FMN 01 Ernest Van Dijckkaai
649,Ernest Van Dijckkaai,2023-05-19,22:00:00,141,61,80,FMN 01 Ernest Van Dijckkaai
649,Ernest Van Dijckkaai,2023-05-19,23:00:00,107,42,65,FMN 01 Ernest Van Dijckkaai
649,Ernest Van Dijckkaai,2023-05-20,00:00:00,0,0,0,FMN 01 Ernest Van Dijckkaai
649,Ernest Van Dijckkaai,2023-05-20,01:00:00,74,31,43,FMN 01 Ernest Van Dijckkaai
649,Ernest Van Dijckkaai,2023-05-20,02:00:00,53,20,33,FMN 01 Ernest Van Dijckkaai
649,Ernest Van Dijckkaai,2023-05-20,03:00:00,37,10,27,FMN 01 Ernest Van Dijckkaai
649,Ernest Van Dijckkaai,2023-05-20,04:00:00,39,15,24,FMN 01 Ernest Van Dijckkaai
649,Ernest Van Dijckkaai,2023-05-20,05:00:00,40,15,25,FMN 01 Ernest Van Dijckkaai
649,Ernest Van Dijckkaai,2023-05-20,06:00:00,53,19,34,FMN 01 Ernest Van Dijckkaai
649,Ernest Van Dijckkaai,2023-05-20,07:00:00,38,21,17,FMN 01 Ernest Van Dijckkaai
649,Ernest Van Dijckkaai,2023-05-20,08:00:00,71,40,31,FMN 01 Ernest Van Dijckkaai
649,Ernest Van Dijckkaai,2023-05-20,09:00:00,123,70,53,FMN 01 Ernest Van Dijckkaai
649,Ernest Van Dijckkaai,2023-05-20,10:00:00,182,104,78,FMN 01 Ernest Van Dijckkaai
649,Ernest Van Dijckkaai,2023-05-20,11:00:00,220,127,93,FMN 01 Ernest Van Dijckkaai
649,Ernest Van Dijckkaai,2023-05-20,12:00:00,275,141,134,FMN 01 Ernest Van Dijckkaai
649,Ernest Van Dijckkaai,2023-05-20,13:00:00,344,187,157,FMN 01 Ernest Van Dijckkaai
649,Ernest Van Dijckkaai,2023-05-20,14:00:00,405,208,197,FMN 01 Ernest Van Dijckkaai
649,Ernest Van Dijckkaai,2023-05-20,15:00:00,425,207,218,FMN 01 Ernest Van Dijckkaai
649,Ernest Van Dijckkaai,2023-05-20,16:00:00,395,186,209,FMN 01 Ernest Van Dijckkaai
649,Ernest Van Dijckkaai,2023-05-20,17:00:00,365,177,188,FMN 01 Ernest Van Dijckkaai
649,Ernest Van Dijckkaai,2023-05-20,18:00:00,290,144,146,FMN 01 Ernest Van Dijckkaai
649,Ernest Van Dijckkaai,2023-05-20,19:00:00,244,113,131,FMN 01 Ernest Van Dijckkaai
649,Ernest Van Dijckkaai,2023-05-20,20:00:00,204,104,100,FMN 01 Ernest Van Dijckkaai
649,Ernest Van Dijckkaai,2023-05-20,21:00:00,168,89,79,FMN 01 Ernest Van Dijckkaai
649,Ernest Van Dijckkaai,2023-05-20,22:00:00,146,54,92,FMN 01 Ernest Van Dijckkaai
649,Ernest Van Dijckkaai,2023-05-20,23:00:00,121,55,66,FMN 01 Ernest Van Dijckkaai
649,Ernest Van Dijckkaai,2023-05-21,00:00:00,0,0,0,FMN 01 Ernest Van Dijckkaai
649,Ernest Van Dijckkaai,2023-05-21,01:00:00,85,30,55,FMN 01 Ernest Van Dijckkaai
649,Ernest Van Dijckkaai,2023-05-21,02:00:00,59,19,40,FMN 01 Ernest Van Dijckkaai
649,Ernest Van Dijckkaai,2023-05-21,03:00:00,52,14,38,FMN 01 Ernest Van Dijckkaai
649,Ernest Van Dijckkaai,2023-05-21,04:00:00,54,18,36,FMN 01 Ernest Van Dijckkaai
649,Ernest Van Dijckkaai,2023-05-21,05:00:00,34,14,20,FMN 01 Ernest Van Dijckkaai
649,Ernest Van Dijckkaai,2023-05-21,06:00:00,43,18,25,FMN 01 Ernest Van Dijckkaai
649,Ernest Van Dijckkaai,2023-05-21,07:00:00,47,13,34,FMN 01 Ernest Van Dijckkaai
649,Ernest Van Dijckkaai,2023-05-21,08:00:00,76,44,32,FMN 01 Ernest Van Dijckkaai
649,Ernest Van Dijckkaai,2023-05-21,09:00:00,176,99,77,FMN 01 Ernest Van Dijckkaai
649,Ernest Van Dijckkaai,2023-05-21,10:00:00,261,142,119,FMN 01 Ernest Van Dijckkaai
649,Ernest Van Dijckkaai,2023-05-21,11:00:00,356,181,175,FMN 01 Ernest Van Dijckkaai
649,Ernest Van Dijckkaai,2023-05-21,12:00:00,398,194,204,FMN 01 Ernest Van Dijckkaai
649,Ernest Van Dijckkaai,2023-05-21,13:00:00,458,234,224,FMN 01 Ernest Van Dijckkaai
649,Ernest Van Dijckkaai,2023-05-21,14:00:00,560,275,285,FMN 01 Ernest Van Dijckkaai
649,Ernest Van Dijckkaai,2023-05-21,15:00:00,555,278,277,FMN 01 Ernest Van Dijckkaai
649,Ernest Van Dijckkaai,2023-05-21,16:00:00,503,225,278,FMN 01 Ernest Van Dijckkaai
649,Ernest Van Dijckkaai,2023-05-21,17:00:00,435,190,245,FMN 01 Ernest Van Dijckkaai
649,Ernest Van Dijckkaai,2023-05-21,18:00:00,330,133,197,FMN 01 Ernest Van Dijckkaai
649,Ernest Van Dijckkaai,2023-05-21,19:00:00,214,91,123,FMN 01 Ernest Van Dijckkaai
649,Ernest Van Dijckkaai,2023-05-21,20:00:00,164,75,89,FMN 01 Ernest Van Dijckkaai
649,Ernest Van Dijckkaai,2023-05-21,21:00:00,133,57,76,FMN 01 Ernest Van Dijckkaai
649,Ernest Van Dijckkaai,2023-05-21,22:00:00,109,39,70,FMN 01 Ernest Van Dijckkaai
649,Ernest Van Dijckkaai,2023-05-21,23:00:00,59,30,29,FMN 01 Ernest Van Dijckkaai
649,Ernest Van Dijckkaai,2023-05-22,00:00:00,0,0,0,FMN 01 Ernest Van Dijckkaai
649,Ernest Van Dijckkaai,2023-05-22,01:00:00,23,7,16,FMN 01 Ernest Van Dijckkaai
649,Ernest Van Dijckkaai,2023-05-22,02:00:00,9,4,5,FMN 01 Ernest Van Dijckkaai
649,Ernest Van Dijckkaai,2023-05-22,03:00:00,9,3,6,FMN 01 Ernest Van Dijckkaai
649,Ernest Van Dijckkaai,2023-05-22,04:00:00,54,41,13,FMN 01 Ernest Van Dijckkaai
649,Ernest Van Dijckkaai,2023-05-22,05:00:00,103,64,39,FMN 01 Ernest Van Dijckkaai
649,Ernest Van Dijckkaai,2023-05-22,06:00:00,260,161,99,FMN 01 Ernest Van Dijckkaai
649,Ernest Van Dijckkaai,2023-05-22,07:00:00,432,286,146,FMN 01 Ernest Van Dijckkaai
649,Ernest Van Dijckkaai,2023-05-22,08:00:00,546,335,211,FMN 01 Ernest Van Dijckkaai
649,Ernest Van Dijckkaai,2023-05-22,09:00:00,245,153,92,FMN 01 Ernest Van Dijckkaai
649,Ernest Van Dijckkaai,2023-05-22,10:00:00,187,100,87,FMN 01 Ernest Van Dijckkaai
649,Ernest Van Dijckkaai,2023-05-22,11:00:00,194,110,84,FMN 01 Ernest Van Dijckkaai
649,Ernest Van Dijckkaai,2023-05-22,12:00:00,277,157,120,FMN 01 Ernest Van Dijckkaai
649,Ernest Van Dijckkaai,2023-05-22,13:00:00,293,161,132,FMN 01 Ernest Van Dijckkaai
649,Ernest Van Dijckkaai,2023-05-22,14:00:00,322,158,164,FMN 01 Ernest Van Dijckkaai
649,Ernest Van Dijckkaai,2023-05-22,15:00:00,394,178,216,FMN 01 Ernest Van Dijckkaai
649,Ernest Van Dijckkaai,2023-05-22,16:00:00,629,254,375,FMN 01 Ernest Van Dijckkaai
649,Ernest Van Dijckkaai,2023-05-22,17:00:00,656,257,399,FMN 01 Ernest Van Dijckkaai
649,Ernest Van Dijckkaai,2023-05-22,18:00:00,424,201,223,FMN 01 Ernest Van Dijckkaai
649,Ernest Van Dijckkaai,2023-05-22,19:00:00,236,109,127,FMN 01 Ernest Van Dijckkaai
649,Ernest Van Dijckkaai,2023-05-22,20:00:00,179,76,103,FMN 01 Ernest Van Dijckkaai
649,Ernest Van Dijckkaai,2023-05-22,21:00:00,156,69,87,FMN 01 Ernest Van Dijckkaai
649,Ernest Van Dijckkaai,2023-05-22,22:00:00,148,49,99,FMN 01 Ernest Van Dijckkaai
649,Ernest Van Dijckkaai,2023-05-22,23:00:00,68,32,36,FMN 01 Ernest Van Dijckkaai
649,Ernest Van Dijckkaai,2023-05-23,00:00:00,0,0,0,FMN 01 Ernest Van Dijckkaai
649,Ernest Van Dijckkaai,2023-05-23,01:00:00,19,9,10,FMN 01 Ernest Van Dijckkaai
649,Ernest Van Dijckkaai,2023-05-23,02:00:00,9,5,4,FMN 01 Ernest Van Dijckkaai
649,Ernest Van Dijckkaai,2023-05-23,03:00:00,11,6,5,FMN 01 Ernest Van Dijckkaai
649,Ernest Van Dijckkaai,2023-05-23,04:00:00,42,30,12,FMN 01 Ernest Van Dijckkaai
649,Ernest Van Dijckkaai,2023-05-23,05:00:00,115,78,37,FMN 01 Ernest Van Dijckkaai
649,Ernest Van Dijckkaai,2023-05-23,06:00:00,299,190,109,FMN 01 Ernest Van Dijckkaai
649,Ernest Van Dijckkaai,2023-05-23,07:00:00,491,321,170,FMN 01 Ernest Van Dijckkaai
649,Ernest Van Dijckkaai,2023-05-23,08:00:00,625,391,234,FMN 01 Ernest Van Dijckkaai
649,Ernest Van Dijckkaai,2023-05-23,09:00:00,283,180,103,FMN 01 Ernest Van Dijckkaai
649,Ernest Van Dijckkaai,2023-05-23,10:00:00,212,119,93,FMN 01 Ernest Van Dijckkaai
649,Ernest Van Dijckkaai,2023-05-23,11:00:00,220,113,107,FMN 01 Ernest Van Dijckkaai
649,Ernest Van Dijckkaai,2023-05-23,12:00:00,310,166,144,FMN 01 Ernest Van Dijckkaai
649,Ernest Van Dijckkaai,2023-05-23,13:00:00,301,160,141,FMN 01 Ernest Van Dijckkaai
649,Ernest Van Dijckkaai,2023-05-23,14:00:00,332,159,173,FMN 01 Ernest Van Dijckkaai
649,Ernest Van Dijckkaai,2023-05-23,15:00:00,424,194,230,FMN 01 Ernest Van Dijckkaai
649,Ernest Van Dijckkaai,2023-05-23,16:00:00,676,256,420,FMN 01 Ernest Van Dijckkaai
649,Ernest Van Dijckkaai,2023-05-23,17:00:00,730,293,437,FMN 01 Ernest Van Dijckkaai
649,Ernest Van Dijckkaai,2023-05-23,18:00:00,453,206,247,FMN 01 Ernest Van Dijckkaai
649,Ernest Van Dijckkaai,2023-05-23,19:00:00,270,133,137,FMN 01 Ernest Van Dijckkaai
649,Ernest Van Dijckkaai,2023-05-23,20:00:00,217,104,113,FMN 01 Ernest Van Dijckkaai
649,Ernest Van Dijckkaai,2023-05-23,21:00:00,157,68,89,FMN 01 Ernest Van Dijckkaai
649,Ernest Van Dijckkaai,2023-05-23,22:00:00,165,62,103,FMN 01 Ernest Van Dijckkaai
649,Ernest Van Dijckkaai,2023-05-23,23:00:00,83,30,53,FMN 01 Ernest Van Dijckkaai
649,Ernest Van Dijckkaai,2023-05-24,00:00:00,0,0,0,FMN 01 Ernest Van Dijckkaai
649,Ernest Van Dijckkaai,2023-05-24,01:00:00,19,4,15,FMN 01 Ernest Van Dijckkaai
649,Ernest Van Dijckkaai,2023-05-24,02:00:00,13,4,9,FMN 01 Ernest Van Dijckkaai
649,Ernest Van Dijckkaai,2023-05-24,03:00:00,11,5,6,FMN 01 Ernest Van Dijckkaai
649,Ernest Van Dijckkaai,2023-05-24,04:00:00,48,31,17,FMN 01 Ernest Van Dijckkaai
649,Ernest Van Dijckkaai,2023-05-24,05:00:00,117,85,32,FMN 01 Ernest Van Dijckkaai
649,Ernest Van Dijckkaai,2023-05-24,06:00:00,271,168,103,FMN 01 Ernest Van Dijckkaai
649,Ernest Van Dijckkaai,2023-05-24,07:00:00,445,293,152,FMN 01 Ernest Van Dijckkaai
649,Ernest Van Dijckkaai,2023-05-24,08:00:00,539,334,205,FMN 01 Ernest Van Dijckkaai
649,Ernest Van Dijckkaai,2023-05-24,09:00:00,275,162,113,FMN 01 Ernest Van Dijckkaai
649,Ernest Van Dijckkaai,2023-05-24,10:00:00,195,104,91,FMN 01 Ernest Van Dijckkaai
649,Ernest Van Dijckkaai,2023-05-24,11:00:00,233,127,106,FMN 01 Ernest Van Dijckkaai
649,Ernest Van Dijckkaai,2023-05-24,12:00:00,352,186,166,FMN 01 Ernest Van Dijckkaai
649,Ernest Van Dijckkaai,2023-05-24,13:00:00,324,173,151,FMN 01 Ernest Van Dijckkaai
649,Ernest Van Dijckkaai,2023-05-24,14:00:00,348,166,182,FMN 01 Ernest Van Dijckkaai
649,Ernest Van Dijckkaai,2023-05-24,15:00:00,423,196,227,FMN 01 Ernest Van Dijckkaai
649,Ernest Van Dijckkaai,2023-05-24,16:00:00,617,243,374,FMN 01 Ernest Van Dijckkaai
649,Ernest Van Dijckkaai,2023-05-24,17:00:00,698,287,411,FMN 01 Ernest Van Dijckkaai
649,Ernest Van Dijckkaai,2023-05-24,18:00:00,466,210,256,FMN 01 Ernest Van Dijckkaai
649,Ernest Van Dijckkaai,2023-05-24,19:00:00,271,134,137,FMN 01 Ernest Van Dijckkaai
649,Ernest Van Dijckkaai,2023-05-24,20:00:00,225,106,119,FMN 01 Ernest Van Dijckkaai
649,Ernest Van Dijckkaai,2023-05-24,21:00:00,173,74,99,FMN 01 Ernest Van Dijckkaai
649,Ernest Van Dijckkaai,2023-05-24,22:00:00,170,59,111,FMN 01 Ernest Van Dijckkaai
649,Ernest Van Dijckkaai,2023-05-24,23:00:00,87,35,52,FMN 01 Ernest Van Dijckkaai
649,Ernest Van Dijckkaai,2023-05-25,00:00:00,0,0,0,FMN 01 Ernest Van Dijckkaai
649,Ernest Van Dijckkaai,2023-05-25,01:00:00,21,4,17,FMN 01 Ernest Van Dijckkaai
649,Ernest Van Dijckkaai,2023-05-25,02:00:00,19,8,11,FMN 01 Ernest Van Dijckkaai
649,Ernest Van Dijckkaai,2023-05-25,03:00:00,12,6,6,FMN 01 Ernest Van Dijckkaai
649,Ernest Van Dijckkaai,2023-05-25,04:00:00,51,33,18,FMN 01 Ernest Van Dijckkaai
649,Ernest Van Dijckkaai,2023-05-25,05:00:00,96,63,33,FMN 01 Ernest Van Dijckkaai
649,Ernest Van Dijckkaai,2023-05-25,06:00:00,294,181,113,FMN 01 Ernest Van Dijckkaai
649,Ernest Van Dijckkaai,2023-05-25,07:00:00,461,300,161,FMN 01 Ernest Van Dijckkaai
649,Ernest Van Dijckkaai,2023-05-25,08:00:00,589,367,222,FMN 01 Ernest Van Dijckkaai
649,Ernest Van Dijckkaai,2023-05-25,09:00:00,301,188,113,FMN 01 Ernest Van Dijckkaai
649,Ernest Van Dijckkaai,2023-05-25,10:00:00,218,123,95,FMN 01 Ernest Van Dijckkaai
649,Ernest Van Dijckkaai,2023-05-25,11:00:00,213,122,91,FMN 01 Ernest Van Dijckkaai
649,Ernest Van Dijckkaai,2023-05-25,12:00:00,327,175,152,FMN 01 Ernest Van Dijckkaai
649,Ernest Van Dijckkaai,2023-05-25,13:00:00,333,180,153,FMN 01 Ernest Van Dijckkaai
649,Ernest Van Dijckkaai,2023-05-25,14:00:00,389,183,206,FMN 01 Ernest Van Dijckkaai
649,Ernest Van Dijckkaai,2023-05-25,15:00:00,453,216,237,FMN 01 Ernest Van Dijckkaai
649,Ernest Van Dijckkaai,2023-05-25,16:00:00,688,284,404,FMN 01 Ernest Van Dijckkaai
649,Ernest Van Dijckkaai,2023-05-25,17:00:00,729,295,434,FMN 01 Ernest Van Dijckkaai
649,Ernest Van Dijckkaai,2023-05-25,18:00:00,463,213,250,FMN 01 Ernest Van Dijckkaai
649,Ernest Van Dijckkaai,2023-05-25,19:00:00,300,150,150,FMN 01 Ernest Van Dijckkaai
649,Ernest Van Dijckkaai,2023-05-25,20:00:00,216,95,121,FMN 01 Ernest Van Dijckkaai
649,Ernest Van Dijckkaai,2023-05-25,21:00:00,183,83,100,FMN 01 Ernest Van Dijckkaai
649,Ernest Van Dijckkaai,2023-05-25,22:00:00,190,66,124,FMN 01 Ernest Van Dijckkaai
649,Ernest Van Dijckkaai,2023-05-25,23:00:00,116,51,65,FMN 01 Ernest Van Dijckkaai
649,Ernest Van Dijckkaai,2023-05-26,00:00:00,0,0,0,FMN 01 Ernest Van Dijckkaai
649,Ernest Van Dijckkaai,2023-05-26,01:00:00,35,12,23,FMN 01 Ernest Van Dijckkaai
649,Ernest Van Dijckkaai,2023-05-26,02:00:00,31,11,20,FMN 01 Ernest Van Dijckkaai
649,Ernest Van Dijckkaai,2023-05-26,03:00:00,22,5,17,FMN 01 Ernest Van Dijckkaai
649,Ernest Van Dijckkaai,2023-05-26,04:00:00,43,30,13,FMN 01 Ernest Van Dijckkaai
649,Ernest Van Dijckkaai,2023-05-26,05:00:00,89,57,32,FMN 01 Ernest Van Dijckkaai
649,Ernest Van Dijckkaai,2023-05-26,06:00:00,229,139,90,FMN 01 Ernest Van Dijckkaai
649,Ernest Van Dijckkaai,2023-05-26,07:00:00,366,238,128,FMN 01 Ernest Van Dijckkaai
649,Ernest Van Dijckkaai,2023-05-26,08:00:00,499,309,190,FMN 01 Ernest Van Dijckkaai
649,Ernest Van Dijckkaai,2023-05-26,09:00:00,269,171,98,FMN 01 Ernest Van Dijckkaai
649,Ernest Van Dijckkaai,2023-05-26,10:00:00,208,113,95,FMN 01 Ernest Van Dijckkaai
649,Ernest Van Dijckkaai,2023-05-26,11:00:00,218,115,103,FMN 01 Ernest Van Dijckkaai
649,Ernest Van Dijckkaai,2023-05-26,12:00:00,334,172,162,FMN 01 Ernest Van Dijckkaai
649,Ernest Van Dijckkaai,2023-05-26,13:00:00,324,170,154,FMN 01 Ernest Van Dijckkaai
649,Ernest Van Dijckkaai,2023-05-26,14:00:00,391,178,213,FMN 01 Ernest Van Dijckkaai
649,Ernest Van Dijckkaai,2023-05-26,15:00:00,471,215,256,FMN 01 Ernest Van Dijckkaai
649,Ernest Van Dijckkaai,2023-05-26,16:00:00,627,252,375,FMN 01 Ernest Van Dijckkaai
649,Ernest Van Dijckkaai,2023-05-26,17:00:00,552,240,312,FMN 01 Ernest Van Dijckkaai
649,Ernest Van Dijckkaai,2023-05-26,18:00:00,399,186,213,FMN 01 Ernest Van Dijckkaai
649,Ernest Van Dijckkaai,2023-05-26,19:00:00,304,143,161,FMN 01 Ernest Van Dijckkaai
649,Ernest Van Dijckkaai,2023-05-26,20:00:00,232,116,116,FMN 01 Ernest Van Dijckkaai
649,Ernest Van Dijckkaai,2023-05-26,21:00:00,189,90,99,FMN 01 Ernest Van Dijckkaai
649,Ernest Van Dijckkaai,2023-05-26,22:00:00,187,74,113,FMN 01 Ernest Van Dijckkaai
649,Ernest Van Dijckkaai,2023-05-26,23:00:00,157,71,86,FMN 01 Ernest Van Dijckkaai
649,Ernest Van Dijckkaai,2023-05-27,00:00:00,0,0,0,FMN 01 Ernest Van Dijckkaai
649,Ernest Van Dijckkaai,2023-05-27,01:00:00,91,28,63,FMN 01 Ernest Van Dijckkaai
649,Ernest Van Dijckkaai,2023-05-27,02:00:00,58,19,39,FMN 01 Ernest Van Dijckkaai
649,Ernest Van Dijckkaai,2023-05-27,03:00:00,37,16,21,FMN 01 Ernest Van Dijckkaai
649,Ernest Van Dijckkaai,2023-05-27,04:00:00,41,18,23,FMN 01 Ernest Van Dijckkaai
649,Ernest Van Dijckkaai,2023-05-27,05:00:00,57,34,23,FMN 01 Ernest Van Dijckkaai
649,Ernest Van Dijckkaai,2023-05-27,06:00:00,56,32,24,FMN 01 Ernest Van Dijckkaai
649,Ernest Van Dijckkaai,2023-05-27,07:00:00,42,19,23,FMN 01 Ernest Van Dijckkaai
649,Ernest Van Dijckkaai,2023-05-27,08:00:00,75,33,42,FMN 01 Ernest Van Dijckkaai
649,Ernest Van Dijckkaai,2023-05-27,09:00:00,159,95,64,FMN 01 Ernest Van Dijckkaai
649,Ernest Van Dijckkaai,2023-05-27,10:00:00,201,112,89,FMN 01 Ernest Van Dijckkaai
649,Ernest Van Dijckkaai,2023-05-27,11:00:00,262,136,126,FMN 01 Ernest Van Dijckkaai
649,Ernest Van Dijckkaai,2023-05-27,12:00:00,321,171,150,FMN 01 Ernest Van Dijckkaai
649,Ernest Van Dijckkaai,2023-05-27,13:00:00,362,193,169,FMN 01 Ernest Van Dijckkaai
649,Ernest Van Dijckkaai,2023-05-27,14:00:00,441,217,224,FMN 01 Ernest Van Dijckkaai
649,Ernest Van Dijckkaai,2023-05-27,15:00:00,464,240,224,FMN 01 Ernest Van Dijckkaai
649,Ernest Van Dijckkaai,2023-05-27,16:00:00,446,221,225,FMN 01 Ernest Van Dijckkaai
649,Ernest Van Dijckkaai,2023-05-27,17:00:00,405,203,202,FMN 01 Ernest Van Dijckkaai
649,Ernest Van Dijckkaai,2023-05-27,18:00:00,345,171,174,FMN 01 Ernest Van Dijckkaai
649,Ernest Van Dijckkaai,2023-05-27,19:00:00,288,146,142,FMN 01 Ernest Van Dijckkaai
649,Ernest Van Dijckkaai,2023-05-27,20:00:00,222,113,109,FMN 01 Ernest Van Dijckkaai
649,Ernest Van Dijckkaai,2023-05-27,21:00:00,187,85,102,FMN 01 Ernest Van Dijckkaai
649,Ernest Van Dijckkaai,2023-05-27,22:00:00,180,76,104,FMN 01 Ernest Van Dijckkaai
649,Ernest Van Dijckkaai,2023-05-27,23:00:00,146,58,88,FMN 01 Ernest Van Dijckkaai
649,Ernest Van Dijckkaai,2023-05-28,00:00:00,0,0,0,FMN 01 Ernest Van Dijckkaai
649,Ernest Van Dijckkaai,2023-05-28,01:00:00,107,43,64,FMN 01 Ernest Van Dijckkaai
649,Ernest Van Dijckkaai,2023-05-28,02:00:00,71,24,47,FMN 01 Ernest Van Dijckkaai
649,Ernest Van Dijckkaai,2023-05-28,03:00:00,57,17,40,FMN 01 Ernest Van Dijckkaai
649,Ernest Van Dijckkaai,2023-05-28,04:00:00,50,20,30,FMN 01 Ernest Van Dijckkaai
649,Ernest Van Dijckkaai,2023-05-28,05:00:00,43,23,20,FMN 01 Ernest Van Dijckkaai
649,Ernest Van Dijckkaai,2023-05-28,06:00:00,53,24,29,FMN 01 Ernest Van Dijckkaai
649,Ernest Van Dijckkaai,2023-05-28,07:00:00,56,17,39,FMN 01 Ernest Van Dijckkaai
649,Ernest Van Dijckkaai,2023-05-28,08:00:00,109,52,57,FMN 01 Ernest Van Dijckkaai
649,Ernest Van Dijckkaai,2023-05-28,09:00:00,218,123,95,FMN 01 Ernest Van Dijckkaai
649,Ernest Van Dijckkaai,2023-05-28,10:00:00,325,173,152,FMN 01 Ernest Van Dijckkaai
649,Ernest Van Dijckkaai,2023-05-28,11:00:00,410,213,197,FMN 01 Ernest Van Dijckkaai
649,Ernest Van Dijckkaai,2023-05-28,12:00:00,488,243,245,FMN 01 Ernest Van Dijckkaai
649,Ernest Van Dijckkaai,2023-05-28,13:00:00,548,273,275,FMN 01 Ernest Van Dijckkaai
649,Ernest Van Dijckkaai,2023-05-28,14:00:00,657,328,329,FMN 01 Ernest Van Dijckkaai
649,Ernest Van Dijckkaai,2023-05-28,15:00:00,666,324,342,FMN 01 Ernest Van Dijckkaai
649,Ernest Van Dijckkaai,2023-05-28,16:00:00,609,274,335,FMN 01 Ernest Van Dijckkaai
649,Ernest Van Dijckkaai,2023-05-28,17:00:00,511,225,286,FMN 01 Ernest Van Dijckkaai
649,Ernest Van Dijckkaai,2023-05-28,18:00:00,384,164,220,FMN 01 Ernest Van Dijckkaai
649,Ernest Van Dijckkaai,2023-05-28,19:00:00,260,121,139,FMN 01 Ernest Van Dijckkaai
649,Ernest Van Dijckkaai,2023-05-28,20:00:00,221,89,132,FMN 01 Ernest Van Dijckkaai
649,Ernest Van Dijckkaai,2023-05-28,21:00:00,175,76,99,FMN 01 Ernest Van Dijckkaai
649,Ernest Van Dijckkaai,2023-05-28,22:00:00,132,42,90,FMN 01 Ernest Van Dijckkaai
649,Ernest Van Dijckkaai,2023-05-28,23:00:00,67,26,41,FMN 01 Ernest Van Dijckkaai
649,Ernest Van Dijckkaai,2023-05-29,00:00:00,0,0,0,FMN 01 Ernest Van Dijckkaai
649,Ernest Van Dijckkaai,2023-05-29,01:00:00,20,8,12,FMN 01 Ernest Van Dijckkaai
649,Ernest Van Dijckkaai,2023-05-29,02:00:00,11,4,7,FMN 01 Ernest Van Dijckkaai
649,Ernest Van Dijckkaai,2023-05-29,03:00:00,14,8,6,FMN 01 Ernest Van Dijckkaai
649,Ernest Van Dijckkaai,2023-05-29,04:00:00,37,27,10,FMN 01 Ernest Van Dijckkaai
649,Ernest Van Dijckkaai,2023-05-29,05:00:00,94,59,35,FMN 01 Ernest Van Dijckkaai
649,Ernest Van Dijckkaai,2023-05-29,06:00:00,251,148,103,FMN 01 Ernest Van Dijckkaai
649,Ernest Van Dijckkaai,2023-05-29,07:00:00,399,257,142,FMN 01 Ernest Van Dijckkaai
649,Ernest Van Dijckkaai,2023-05-29,08:00:00,512,304,208,FMN 01 Ernest Van Dijckkaai
649,Ernest Van Dijckkaai,2023-05-29,09:00:00,230,133,97,FMN 01 Ernest Van Dijckkaai
649,Ernest Van Dijckkaai,2023-05-29,10:00:00,177,94,83,FMN 01 Ernest Van Dijckkaai
649,Ernest Van Dijckkaai,2023-05-29,11:00:00,186,107,79,FMN 01 Ernest Van Dijckkaai
649,Ernest Van Dijckkaai,2023-05-29,12:00:00,249,132,117,FMN 01 Ernest Van Dijckkaai
649,Ernest Van Dijckkaai,2023-05-29,13:00:00,269,146,123,FMN 01 Ernest Van Dijckkaai
649,Ernest Van Dijckkaai,2023-05-29,14:00:00,296,134,162,FMN 01 Ernest Van Dijckkaai
649,Ernest Van Dijckkaai,2023-05-29,15:00:00,369,163,206,FMN 01 Ernest Van Dijckkaai
649,Ernest Van Dijckkaai,2023-05-29,16:00:00,608,228,380,FMN 01 Ernest Van Dijckkaai
649,Ernest Van Dijckkaai,2023-05-29,17:00:00,634,253,381,FMN 01 Ernest Van Dijckkaai
649,Ernest Van Dijckkaai,2023-05-29,18:00:00,406,177,229,FMN 01 Ernest Van Dijckkaai
649,Ernest Van Dijckkaai,2023-05-29,19:00:00,239,108,131,FMN 01 Ernest Van Dijckkaai
649,Ernest Van Dijckkaai,2023-05-29,20:00:00,175,76,99,FMN 01 Ernest Van Dijckkaai
649,Ernest Van Dijckkaai,2023-05-29,21:00:00,141,61,80,FMN 01 Ernest Van Dijckkaai
649,Ernest Van Dijckkaai,2023-05-29,22:00:00,143,50,93,FMN 01 Ernest Van Dijckkaai
649,Ernest Van Dijckkaai,2023-05-29,23:00:00,66,23,43,FMN 01 Ernest Van Dijckkaai
649,Ernest Van Dijckkaai,2023-05-30,00:00:00,0,0,0,FMN 01 Ernest Van Dijckkaai
649,Ernest Van Dijckkaai,2023-05-30,01:00:00,21,5,16,FMN 01 Ernest Van Dijckkaai
649,Ernest Van Dijckkaai,2023-05-30,02:00:00,8,4,4,FMN 01 Ernest Van Dijckkaai
649,Ernest Van Dijckkaai,2023-05-30,03:00:00,10,5,5,FMN 01 Ernest Van Dijckkaai
649,Ernest Van Dijckkaai,2023-05-30,04:00:00,57,38,19,FMN 01 Ernest Van Dijckkaai
649,Ernest Van Dijckkaai,2023-05-30,05:00:00,112,75,37,FMN 01 Ernest Van Dijckkaai
649,Ernest Van Dijckkaai,2023-05-30,06:00:00,313,196,117,FMN 01 Ernest Van Dijckkaai
649,Ernest Van Dijckkaai,2023-05-30,07:00:00,534,347,187,FMN 01 Ernest Van Dijckkaai
649,Ernest Van Dijckkaai,2023-05-30,08:00:00,633,392,241,FMN 01 Ernest Van Dijckkaai
649,Ernest Van Dijckkaai,2023-05-30,09:00:00,293,181,112,FMN 01 Ernest Van Dijckkaai
649,Ernest Van Dijckkaai,2023-05-30,10:00:00,205,113,92,FMN 01 Ernest Van Dijckkaai
649,Ernest Van Dijckkaai,2023-05-30,11:00:00,217,113,104,FMN 01 Ernest Van Dijckkaai
649,Ernest Van Dijckkaai,2023-05-30,12:00:00,306,167,139,FMN 01 Ernest Van Dijckkaai
649,Ernest Van Dijckkaai,2023-05-30,13:00:00,310,167,143,FMN 01 Ernest Van Dijckkaai
649,Ernest Van Dijckkaai,2023-05-30,14:00:00,363,169,194,FMN 01 Ernest Van Dijckkaai
649,Ernest Van Dijckkaai,2023-05-30,15:00:00,455,211,244,FMN 01 Ernest Van Dijckkaai
649,Ernest Van Dijckkaai,2023-05-30,16:00:00,726,280,446,FMN 01 Ernest Van Dijckkaai
649,Ernest Van Dijckkaai,2023-05-30,17:00:00,757,303,454,FMN 01 Ernest Van Dijckkaai
649,Ernest Van Dijckkaai,2023-05-30,18:00:00,472,209,263,FMN 01 Ernest Van Dijckkaai
649,Ernest Van Dijckkaai,2023-05-30,19:00:00,272,130,142,FMN 01 Ernest Van Dijckkaai
649,Ernest Van Dijckkaai,2023-05-30,20:00:00,198,90,108,FMN 01 Ernest Van Dijckkaai
649,Ernest Van Dijckkaai,2023-05-30,21:00:00,165,83,82,FMN 01 Ernest Van Dijckkaai
649,Ernest Van Dijckkaai,2023-05-30,22:00:00,164,56,108,FMN 01 Ernest Van Dijckkaai
649,Ernest Van Dijckkaai,2023-05-30,23:00:00,83,26,57,FMN 01 Ernest Van Dijckkaai
649,Ernest Van Dijckkaai,2023-05-31,00:00:00,0,0,0,FMN 01 Ernest Van Dijckkaai
649,Ernest Van Dijckkaai,2023-05-31,01:00:00,25,9,16,FMN 01 Ernest Van Dijckkaai
649,Ernest Van Dijckkaai,2023-05-31,02:00:00,22,9,13,FMN 01 Ernest Van Dijckkaai
649,Ernest Van Dijckkaai,2023-05-31,03:00:00,12,2,10,FMN 01 Ernest Van Dijckkaai
649,Ernest Van Dijckkaai,2023-05-31,04:00:00,64,42,22,FMN 01 Ernest Van Dijckkaai
649,Ernest Van Dijckkaai,2023-05-31,05:00:00,114,79,35,FMN 01 Ernest Van Dijckkaai
649,Ernest Van Dijckkaai,2023-05-31,06:00:00,325,200,125,FMN 01 Ernest Van Dijckkaai
649,Ernest Van Dijckkaai,2023-05-31,07:00:00,537,353,184,FMN 01 Ernest Van Dijckkaai
649,Ernest Van Dijckkaai,2023-05-31,08:00:00,658,401,257,FMN 01 Ernest Van Dijckkaai
649,Ernest Van Dijckkaai,2023-05-31,09:00:00,332,195,137,FMN 01 Ernest Van Dijckkaai
649,Ernest Van Dijckkaai,2023-05-31,10:00:00,254,149,105,FMN 01 Ernest Van Dijckkaai
649,Ernest Van Dijckkaai,2023-05-31,11:00:00,278,144,134,FMN 01 Ernest Van Dijckkaai
649,Ernest Van Dijckkaai,2023-05-31,12:00:00,435,236,199,FMN 01 Ernest Van Dijckkaai
649,Ernest Van Dijckkaai,2023-05-31,13:00:00,406,219,187,FMN 01 Ernest Van Dijckkaai
649,Ernest Van Dijckkaai,2023-05-31,14:00:00,451,217,234,FMN 01 Ernest Van Dijckkaai
649,Ernest Van Dijckkaai,2023-05-31,15:00:00,514,243,271,FMN 01 Ernest Van Dijckkaai
649,Ernest Van Dijckkaai,2023-05-31,16:00:00,743,281,462,FMN 01 Ernest Van Dijckkaai
649,Ernest Van Dijckkaai,2023-05-31,17:00:00,814,329,485,FMN 01 Ernest Van Dijckkaai
649,Ernest Van Dijckkaai,2023-05-31,18:00:00,569,254,315,FMN 01 Ernest Van Dijckkaai
649,Ernest Van Dijckkaai,2023-05-31,19:00:00,344,155,189,FMN 01 Ernest Van Dijckkaai
649,Ernest Van Dijckkaai,2023-05-31,20:00:00,259,112,147,FMN 01 Ernest Van Dijckkaai
649,Ernest Van Dijckkaai,2023-05-31,21:00:00,204,95,109,FMN 01 Ernest Van Dijckkaai
649,Ernest Van Dijckkaai,2023-05-31,22:00:00,207,77,130,FMN 01 Ernest Van Dijckkaai
649,Ernest Van Dijckkaai,2023-05-31,23:00:00,109,43,66,FMN 01 Ernest Van Dijckkaai
649,Ernest Van Dijckkaai,2023-06-01,00:00:00,0,0,0,FMN 01 Ernest Van Dijckkaai
649,Ernest Van Dijckkaai,2023-06-01,01:00:00,0,0,0,FMN 01 Ernest Van Dijckkaai
649,Ernest Van Dijckkaai,2023-06-01,02:00:00,0,0,0,FMN 01 Ernest Van Dijckkaai
649,Ernest Van Dijckkaai,2023-06-01,03:00:00,0,0,0,FMN 01 Ernest Van Dijckkaai
649,Ernest Van Dijckkaai,2023-06-01,04:00:00,0,0,0,FMN 01 Ernest Van Dijckkaai
649,Ernest Van Dijckkaai,2023-06-01,05:00:00,0,0,0,FMN 01 Ernest Van Dijckkaai
649,Ernest Van Dijckkaai,2023-06-01,06:00:00,0,0,0,FMN 01 Ernest Van Dijckkaai
649,Ernest Van Dijckkaai,2023-06-01,07:00:00,0,0,0,FMN 01 Ernest Van Dijckkaai
649,Ernest Van Dijckkaai,2023-06-01,08:00:00,0,0,0,FMN 01 Ernest Van Dijckkaai
649,Ernest Van Dijckkaai,2023-06-01,09:00:00,0,0,0,FMN 01 Ernest Van Dijckkaai
649,Ernest Van Dijckkaai,2023-06-01,10:00:00,0,0,0,FMN 01 Ernest Van Dijckkaai
649,Ernest Van Dijckkaai,2023-06-01,11:00:00,0,0,0,FMN 01 Ernest Van Dijckkaai
649,Ernest Van Dijckkaai,2023-06-01,12:00:00,0,0,0,FMN 01 Ernest Van Dijckkaai
649,Ernest Van Dijckkaai,2023-06-01,13:00:00,0,0,0,FMN 01 Ernest Van Dijckkaai
649,Ernest Van Dijckkaai,2023-06-01,14:00:00,87,42,45,FMN 01 Ernest Van Dijckkaai
649,Ernest Van Dijckkaai,2023-06-01,15:00:00,526,237,289,FMN 01 Ernest Van Dijckkaai
649,Ernest Van Dijckkaai,2023-06-01,16:00:00,755,322,433,FMN 01 Ernest Van Dijckkaai
649,Ernest Van Dijckkaai,2023-06-01,17:00:00,849,359,490,FMN 01 Ernest Van Dijckkaai
649,Ernest Van Dijckkaai,2023-06-01,18:00:00,593,305,288,FMN 01 Ernest Van Dijckkaai
649,Ernest Van Dijckkaai,2023-06-01,19:00:00,396,199,197,FMN 01 Ernest Van Dijckkaai
649,Ernest Van Dijckkaai,2023-06-01,20:00:00,278,120,158,FMN 01 Ernest Van Dijckkaai
649,Ernest Van Dijckkaai,2023-06-01,21:00:00,236,74,162,FMN 01 Ernest Van Dijckkaai
649,Ernest Van Dijckkaai,2023-06-01,22:00:00,233,85,148,FMN 01 Ernest Van Dijckkaai
649,Ernest Van Dijckkaai,2023-06-01,23:00:00,104,39,65,FMN 01 Ernest Van Dijckkaai
649,Ernest Van Dijckkaai,2023-06-02,00:00:00,28,18,10,FMN 01 Ernest Van Dijckkaai
649,Ernest Van Dijckkaai,2023-06-02,01:00:00,21,17,4,FMN 01 Ernest Van Dijckkaai
649,Ernest Van Dijckkaai,2023-06-02,02:00:00,4,3,1,FMN 01 Ernest Van Dijckkaai
649,Ernest Van Dijckkaai,2023-06-02,03:00:00,16,3,13,FMN 01 Ernest Van Dijckkaai
649,Ernest Van Dijckkaai,2023-06-02,04:00:00,61,37,24,FMN 01 Ernest Van Dijckkaai
649,Ernest Van Dijckkaai,2023-06-02,05:00:00,129,82,47,FMN 01 Ernest Van Dijckkaai
649,Ernest Van Dijckkaai,2023-06-02,06:00:00,283,180,103,FMN 01 Ernest Van Dijckkaai
649,Ernest Van Dijckkaai,2023-06-02,07:00:00,403,254,149,FMN 01 Ernest Van Dijckkaai
649,Ernest Van Dijckkaai,2023-06-02,08:00:00,562,331,231,FMN 01 Ernest Van Dijckkaai
649,Ernest Van Dijckkaai,2023-06-02,09:00:00,405,304,101,FMN 01 Ernest Van Dijckkaai
649,Ernest Van Dijckkaai,2023-06-02,10:00:00,272,144,128,FMN 01 Ernest Van Dijckkaai
649,Ernest Van Dijckkaai,2023-06-02,11:00:00,248,98,150,FMN 01 Ernest Van Dijckkaai
649,Ernest Van Dijckkaai,2023-06-02,12:00:00,322,162,160,FMN 01 Ernest Van Dijckkaai
649,Ernest Van Dijckkaai,2023-06-02,13:00:00,333,184,149,FMN 01 Ernest Van Dijckkaai
649,Ernest Van Dijckkaai,2023-06-02,14:00:00,580,234,346,FMN 01 Ernest Van Dijckkaai
649,Ernest Van Dijckkaai,2023-06-02,15:00:00,580,267,313,FMN 01 Ernest Van Dijckkaai
649,Ernest Van Dijckkaai,2023-06-02,16:00:00,758,309,449,FMN 01 Ernest Van Dijckkaai
649,Ernest Van Dijckkaai,2023-06-02,17:00:00,747,325,422,FMN 01 Ernest Van Dijckkaai
649,Ernest Van Dijckkaai,2023-06-02,18:00:00,569,273,296,FMN 01 Ernest Van Dijckkaai
649,Ernest Van Dijckkaai,2023-06-02,19:00:00,402,207,195,FMN 01 Ernest Van Dijckkaai
649,Ernest Van Dijckkaai,2023-06-02,20:00:00,342,154,188,FMN 01 Ernest Van Dijckkaai
649,Ernest Van Dijckkaai,2023-06-02,21:00:00,306,123,183,FMN 01 Ernest Van Dijckkaai
649,Ernest Van Dijckkaai,2023-06-02,22:00:00,311,133,178,FMN 01 Ernest Van Dijckkaai
649,Ernest Van Dijckkaai,2023-06-02,23:00:00,238,96,142,FMN 01 Ernest Van Dijckkaai
649,Ernest Van Dijckkaai,2023-06-03,00:00:00,191,100,91,FMN 01 Ernest Van Dijckkaai
649,Ernest Van Dijckkaai,2023-06-03,01:00:00,96,45,51,FMN 01 Ernest Van Dijckkaai
649,Ernest Van Dijckkaai,2023-06-03,02:00:00,67,33,34,FMN 01 Ernest Van Dijckkaai
649,Ernest Van Dijckkaai,2023-06-03,03:00:00,46,15,31,FMN 01 Ernest Van Dijckkaai
649,Ernest Van Dijckkaai,2023-06-03,04:00:00,46,19,27,FMN 01 Ernest Van Dijckkaai
649,Ernest Van Dijckkaai,2023-06-03,05:00:00,30,19,11,FMN 01 Ernest Van Dijckkaai
649,Ernest Van Dijckkaai,2023-06-03,06:00:00,67,30,37,FMN 01 Ernest Van Dijckkaai
649,Ernest Van Dijckkaai,2023-06-03,07:00:00,45,20,25,FMN 01 Ernest Van Dijckkaai
649,Ernest Van Dijckkaai,2023-06-03,08:00:00,112,65,47,FMN 01 Ernest Van Dijckkaai
649,Ernest Van Dijckkaai,2023-06-03,09:00:00,220,133,87,FMN 01 Ernest Van Dijckkaai
649,Ernest Van Dijckkaai,2023-06-03,10:00:00,310,165,145,FMN 01 Ernest Van Dijckkaai
649,Ernest Van Dijckkaai,2023-06-03,11:00:00,409,198,211,FMN 01 Ernest Van Dijckkaai
649,Ernest Van Dijckkaai,2023-06-03,12:00:00,443,226,217,FMN 01 Ernest Van Dijckkaai
649,Ernest Van Dijckkaai,2023-06-03,13:00:00,486,288,198,FMN 01 Ernest Van Dijckkaai
649,Ernest Van Dijckkaai,2023-06-03,14:00:00,594,310,284,FMN 01 Ernest Van Dijckkaai
649,Ernest Van Dijckkaai,2023-06-03,15:00:00,590,342,248,FMN 01 Ernest Van Dijckkaai
649,Ernest Van Dijckkaai,2023-06-03,16:00:00,578,300,278,FMN 01 Ernest Van Dijckkaai
649,Ernest Van Dijckkaai,2023-06-03,17:00:00,625,325,300,FMN 01 Ernest Van Dijckkaai
649,Ernest Van Dijckkaai,2023-06-03,18:00:00,544,232,312,FMN 01 Ernest Van Dijckkaai
649,Ernest Van Dijckkaai,2023-06-03,19:00:00,401,217,184,FMN 01 Ernest Van Dijckkaai
649,Ernest Van Dijckkaai,2023-06-03,20:00:00,384,163,221,FMN 01 Ernest Van Dijckkaai
649,Ernest Van Dijckkaai,2023-06-03,21:00:00,271,125,146,FMN 01 Ernest Van Dijckkaai
649,Ernest Van Dijckkaai,2023-06-03,22:00:00,273,111,162,FMN 01 Ernest Van Dijckkaai
649,Ernest Van Dijckkaai,2023-06-03,23:00:00,221,82,139,FMN 01 Ernest Van Dijckkaai
649,Ernest Van Dijckkaai,2023-06-04,00:00:00,173,56,117,FMN 01 Ernest Van Dijckkaai
649,Ernest Van Dijckkaai,2023-06-04,01:00:00,105,24,81,FMN 01 Ernest Van Dijckkaai
649,Ernest Van Dijckkaai,2023-06-04,02:00:00,83,20,63,FMN 01 Ernest Van Dijckkaai
649,Ernest Van Dijckkaai,2023-06-04,03:00:00,68,15,53,FMN 01 Ernest Van Dijckkaai
649,Ernest Van Dijckkaai,2023-06-04,04:00:00,69,16,53,FMN 01 Ernest Van Dijckkaai
649,Ernest Van Dijckkaai,2023-06-04,05:00:00,28,13,15,FMN 01 Ernest Van Dijckkaai
649,Ernest Van Dijckkaai,2023-06-04,06:00:00,52,27,25,FMN 01 Ernest Van Dijckkaai
649,Ernest Van Dijckkaai,2023-06-04,07:00:00,44,23,21,FMN 01 Ernest Van Dijckkaai
649,Ernest Van Dijckkaai,2023-06-04,08:00:00,116,61,55,FMN 01 Ernest Van Dijckkaai
649,Ernest Van Dijckkaai,2023-06-04,09:00:00,225,136,89,FMN 01 Ernest Van Dijckkaai
649,Ernest Van Dijckkaai,2023-06-04,10:00:00,309,200,109,FMN 01 Ernest Van Dijckkaai
649,Ernest Van Dijckkaai,2023-06-04,11:00:00,436,197,239,FMN 01 Ernest Van Dijckkaai
649,Ernest Van Dijckkaai,2023-06-04,12:00:00,516,263,253,FMN 01 Ernest Van Dijckkaai
649,Ernest Van Dijckkaai,2023-06-04,13:00:00,579,335,244,FMN 01 Ernest Van Dijckkaai
649,Ernest Van Dijckkaai,2023-06-04,14:00:00,676,397,279,FMN 01 Ernest Van Dijckkaai
649,Ernest Van Dijckkaai,2023-06-04,15:00:00,769,420,349,FMN 01 Ernest Van Dijckkaai
649,Ernest Van Dijckkaai,2023-06-04,16:00:00,647,326,321,FMN 01 Ernest Van Dijckkaai
649,Ernest Van Dijckkaai,2023-06-04,17:00:00,661,343,318,FMN 01 Ernest Van Dijckkaai
649,Ernest Van Dijckkaai,2023-06-04,18:00:00,466,196,270,FMN 01 Ernest Van Dijckkaai
649,Ernest Van Dijckkaai,2023-06-04,19:00:00,368,157,211,FMN 01 Ernest Van Dijckkaai
649,Ernest Van Dijckkaai,2023-06-04,20:00:00,289,106,183,FMN 01 Ernest Van Dijckkaai
649,Ernest Van Dijckkaai,2023-06-04,21:00:00,232,112,120,FMN 01 Ernest Van Dijckkaai
649,Ernest Van Dijckkaai,2023-06-04,22:00:00,146,63,83,FMN 01 Ernest Van Dijckkaai
649,Ernest Van Dijckkaai,2023-06-04,23:00:00,78,25,53,FMN 01 Ernest Van Dijckkaai
649,Ernest Van Dijckkaai,2023-06-05,00:00:00,57,16,41,FMN 01 Ernest Van Dijckkaai
649,Ernest Van Dijckkaai,2023-06-05,01:00:00,27,3,24,FMN 01 Ernest Van Dijckkaai
649,Ernest Van Dijckkaai,2023-06-05,02:00:00,17,7,10,FMN 01 Ernest Van Dijckkaai
649,Ernest Van Dijckkaai,2023-06-05,03:00:00,12,6,6,FMN 01 Ernest Van Dijckkaai
649,Ernest Van Dijckkaai,2023-06-05,04:00:00,72,43,29,FMN 01 Ernest Van Dijckkaai
649,Ernest Van Dijckkaai,2023-06-05,05:00:00,122,83,39,FMN 01 Ernest Van Dijckkaai
649,Ernest Van Dijckkaai,2023-06-05,06:00:00,281,173,108,FMN 01 Ernest Van Dijckkaai
649,Ernest Van Dijckkaai,2023-06-05,07:00:00,507,318,189,FMN 01 Ernest Van Dijckkaai
649,Ernest Van Dijckkaai,2023-06-05,08:00:00,694,399,295,FMN 01 Ernest Van Dijckkaai
649,Ernest Van Dijckkaai,2023-06-05,09:00:00,274,152,122,FMN 01 Ernest Van Dijckkaai
649,Ernest Van Dijckkaai,2023-06-05,10:00:00,199,120,79,FMN 01 Ernest Van Dijckkaai
649,Ernest Van Dijckkaai,2023-06-05,11:00:00,251,120,131,FMN 01 Ernest Van Dijckkaai
649,Ernest Van Dijckkaai,2023-06-05,12:00:00,372,195,177,FMN 01 Ernest Van Dijckkaai
649,Ernest Van Dijckkaai,2023-06-05,13:00:00,412,227,185,FMN 01 Ernest Van Dijckkaai
649,Ernest Van Dijckkaai,2023-06-05,14:00:00,480,232,248,FMN 01 Ernest Van Dijckkaai
649,Ernest Van Dijckkaai,2023-06-05,15:00:00,565,283,282,FMN 01 Ernest Van Dijckkaai
649,Ernest Van Dijckkaai,2023-06-05,16:00:00,819,342,477,FMN 01 Ernest Van Dijckkaai
649,Ernest Van Dijckkaai,2023-06-05,17:00:00,985,506,479,FMN 01 Ernest Van Dijckkaai
649,Ernest Van Dijckkaai,2023-06-05,18:00:00,720,442,278,FMN 01 Ernest Van Dijckkaai
649,Ernest Van Dijckkaai,2023-06-05,19:00:00,431,182,249,FMN 01 Ernest Van Dijckkaai
649,Ernest Van Dijckkaai,2023-06-05,20:00:00,403,152,251,FMN 01 Ernest Van Dijckkaai
649,Ernest Van Dijckkaai,2023-06-05,21:00:00,312,121,191,FMN 01 Ernest Van Dijckkaai
649,Ernest Van Dijckkaai,2023-06-05,22:00:00,244,91,153,FMN 01 Ernest Van Dijckkaai
649,Ernest Van Dijckkaai,2023-06-05,23:00:00,85,28,57,FMN 01 Ernest Van Dijckkaai
649,Ernest Van Dijckkaai,2023-06-06,00:00:00,41,16,25,FMN 01 Ernest Van Dijckkaai
649,Ernest Van Dijckkaai,2023-06-06,01:00:00,19,11,8,FMN 01 Ernest Van Dijckkaai
649,Ernest Van Dijckkaai,2023-06-06,02:00:00,14,7,7,FMN 01 Ernest Van Dijckkaai
649,Ernest Van Dijckkaai,2023-06-06,03:00:00,11,4,7,FMN 01 Ernest Van Dijckkaai
649,Ernest Van Dijckkaai,2023-06-06,04:00:00,66,40,26,FMN 01 Ernest Van Dijckkaai
649,Ernest Van Dijckkaai,2023-06-06,05:00:00,154,99,55,FMN 01 Ernest Van Dijckkaai
649,Ernest Van Dijckkaai,2023-06-06,06:00:00,339,207,132,FMN 01 Ernest Van Dijckkaai
649,Ernest Van Dijckkaai,2023-06-06,07:00:00,565,335,230,FMN 01 Ernest Van Dijckkaai
649,Ernest Van Dijckkaai,2023-06-06,08:00:00,810,488,322,FMN 01 Ernest Van Dijckkaai
649,Ernest Van Dijckkaai,2023-06-06,09:00:00,363,213,150,FMN 01 Ernest Van Dijckkaai
649,Ernest Van Dijckkaai,2023-06-06,10:00:00,274,156,118,FMN 01 Ernest Van Dijckkaai
649,Ernest Van Dijckkaai,2023-06-06,11:00:00,311,172,139,FMN 01 Ernest Van Dijckkaai
649,Ernest Van Dijckkaai,2023-06-06,12:00:00,374,203,171,FMN 01 Ernest Van Dijckkaai
649,Ernest Van Dijckkaai,2023-06-06,13:00:00,410,219,191,FMN 01 Ernest Van Dijckkaai
649,Ernest Van Dijckkaai,2023-06-06,14:00:00,471,232,239,FMN 01 Ernest Van Dijckkaai
649,Ernest Van Dijckkaai,2023-06-06,15:00:00,532,262,270,FMN 01 Ernest Van Dijckkaai
649,Ernest Van Dijckkaai,2023-06-06,16:00:00,825,342,483,FMN 01 Ernest Van Dijckkaai
649,Ernest Van Dijckkaai,2023-06-06,17:00:00,940,402,538,FMN 01 Ernest Van Dijckkaai
649,Ernest Van Dijckkaai,2023-06-06,18:00:00,636,300,336,FMN 01 Ernest Van Dijckkaai
649,Ernest Van Dijckkaai,2023-06-06,19:00:00,392,220,172,FMN 01 Ernest Van Dijckkaai
649,Ernest Van Dijckkaai,2023-06-06,20:00:00,323,135,188,FMN 01 Ernest Van Dijckkaai
649,Ernest Van Dijckkaai,2023-06-06,21:00:00,254,101,153,FMN 01 Ernest Van Dijckkaai
649,Ernest Van Dijckkaai,2023-06-06,22:00:00,299,123,176,FMN 01 Ernest Van Dijckkaai
649,Ernest Van Dijckkaai,2023-06-06,23:00:00,111,40,71,FMN 01 Ernest Van Dijckkaai
649,Ernest Van Dijckkaai,2023-06-07,00:00:00,42,13,29,FMN 01 Ernest Van Dijckkaai
649,Ernest Van Dijckkaai,2023-06-07,01:00:00,17,7,10,FMN 01 Ernest Van Dijckkaai
649,Ernest Van Dijckkaai,2023-06-07,02:00:00,22,7,15,FMN 01 Ernest Van Dijckkaai
649,Ernest Van Dijckkaai,2023-06-07,03:00:00,7,3,4,FMN 01 Ernest Van Dijckkaai
649,Ernest Van Dijckkaai,2023-06-07,04:00:00,73,42,31,FMN 01 Ernest Van Dijckkaai
649,Ernest Van Dijckkaai,2023-06-07,05:00:00,141,91,50,FMN 01 Ernest Van Dijckkaai
649,Ernest Van Dijckkaai,2023-06-07,06:00:00,291,181,110,FMN 01 Ernest Van Dijckkaai
649,Ernest Van Dijckkaai,2023-06-07,07:00:00,474,294,180,FMN 01 Ernest Van Dijckkaai
649,Ernest Van Dijckkaai,2023-06-07,08:00:00,652,397,255,FMN 01 Ernest Van Dijckkaai
649,Ernest Van Dijckkaai,2023-06-07,09:00:00,307,184,123,FMN 01 Ernest Van Dijckkaai
649,Ernest Van Dijckkaai,2023-06-07,10:00:00,233,132,101,FMN 01 Ernest Van Dijckkaai
649,Ernest Van Dijckkaai,2023-06-07,11:00:00,250,126,124,FMN 01 Ernest Van Dijckkaai
649,Ernest Van Dijckkaai,2023-06-07,12:00:00,452,216,236,FMN 01 Ernest Van Dijckkaai
649,Ernest Van Dijckkaai,2023-06-07,13:00:00,379,206,173,FMN 01 Ernest Van Dijckkaai
649,Ernest Van Dijckkaai,2023-06-07,14:00:00,463,234,229,FMN 01 Ernest Van Dijckkaai
649,Ernest Van Dijckkaai,2023-06-07,15:00:00,525,263,262,FMN 01 Ernest Van Dijckkaai
649,Ernest Van Dijckkaai,2023-06-07,16:00:00,708,318,390,FMN 01 Ernest Van Dijckkaai
649,Ernest Van Dijckkaai,2023-06-07,17:00:00,779,308,471,FMN 01 Ernest Van Dijckkaai
649,Ernest Van Dijckkaai,2023-06-07,18:00:00,567,277,290,FMN 01 Ernest Van Dijckkaai
649,Ernest Van Dijckkaai,2023-06-07,19:00:00,406,198,208,FMN 01 Ernest Van Dijckkaai
649,Ernest Van Dijckkaai,2023-06-07,20:00:00,315,153,162,FMN 01 Ernest Van Dijckkaai
649,Ernest Van Dijckkaai,2023-06-07,21:00:00,253,96,157,FMN 01 Ernest Van Dijckkaai
649,Ernest Van Dijckkaai,2023-06-07,22:00:00,281,124,157,FMN 01 Ernest Van Dijckkaai
649,Ernest Van Dijckkaai,2023-06-07,23:00:00,123,50,73,FMN 01 Ernest Van Dijckkaai
649,Ernest Van Dijckkaai,2023-06-08,00:00:00,51,17,34,FMN 01 Ernest Van Dijckkaai
649,Ernest Van Dijckkaai,2023-06-08,01:00:00,22,9,13,FMN 01 Ernest Van Dijckkaai
649,Ernest Van Dijckkaai,2023-06-08,02:00:00,11,3,8,FMN 01 Ernest Van Dijckkaai
649,Ernest Van Dijckkaai,2023-06-08,03:00:00,17,8,9,FMN 01 Ernest Van Dijckkaai
649,Ernest Van Dijckkaai,2023-06-08,04:00:00,72,47,25,FMN 01 Ernest Van Dijckkaai
649,Ernest Van Dijckkaai,2023-06-08,05:00:00,139,94,45,FMN 01 Ernest Van Dijckkaai
649,Ernest Van Dijckkaai,2023-06-08,06:00:00,305,185,120,FMN 01 Ernest Van Dijckkaai
649,Ernest Van Dijckkaai,2023-06-08,07:00:00,539,324,215,FMN 01 Ernest Van Dijckkaai
649,Ernest Van Dijckkaai,2023-06-08,08:00:00,687,413,274,FMN 01 Ernest Van Dijckkaai
649,Ernest Van Dijckkaai,2023-06-08,09:00:00,355,210,145,FMN 01 Ernest Van Dijckkaai
649,Ernest Van Dijckkaai,2023-06-08,10:00:00,242,122,120,FMN 01 Ernest Van Dijckkaai
649,Ernest Van Dijckkaai,2023-06-08,11:00:00,299,131,168,FMN 01 Ernest Van Dijckkaai
649,Ernest Van Dijckkaai,2023-06-08,12:00:00,453,261,192,FMN 01 Ernest Van Dijckkaai
649,Ernest Van Dijckkaai,2023-06-08,13:00:00,408,232,176,FMN 01 Ernest Van Dijckkaai
649,Ernest Van Dijckkaai,2023-06-08,14:00:00,536,261,275,FMN 01 Ernest Van Dijckkaai
649,Ernest Van Dijckkaai,2023-06-08,15:00:00,578,253,325,FMN 01 Ernest Van Dijckkaai
649,Ernest Van Dijckkaai,2023-06-08,16:00:00,793,331,462,FMN 01 Ernest Van Dijckkaai
649,Ernest Van Dijckkaai,2023-06-08,17:00:00,890,380,510,FMN 01 Ernest Van Dijckkaai
649,Ernest Van Dijckkaai,2023-06-08,18:00:00,630,338,292,FMN 01 Ernest Van Dijckkaai
649,Ernest Van Dijckkaai,2023-06-08,19:00:00,461,219,242,FMN 01 Ernest Van Dijckkaai
649,Ernest Van Dijckkaai,2023-06-08,20:00:00,367,161,206,FMN 01 Ernest Van Dijckkaai
649,Ernest Van Dijckkaai,2023-06-08,21:00:00,292,118,174,FMN 01 Ernest Van Dijckkaai
649,Ernest Van Dijckkaai,2023-06-08,22:00:00,299,135,164,FMN 01 Ernest Van Dijckkaai
649,Ernest Van Dijckkaai,2023-06-08,23:00:00,164,56,108,FMN 01 Ernest Van Dijckkaai
649,Ernest Van Dijckkaai,2023-06-09,00:00:00,74,28,46,FMN 01 Ernest Van Dijckkaai
649,Ernest Van Dijckkaai,2023-06-09,01:00:00,25,11,14,FMN 01 Ernest Van Dijckkaai
649,Ernest Van Dijckkaai,2023-06-09,02:00:00,28,14,14,FMN 01 Ernest Van Dijckkaai
649,Ernest Van Dijckkaai,2023-06-09,03:00:00,15,3,12,FMN 01 Ernest Van Dijckkaai
649,Ernest Van Dijckkaai,2023-06-09,04:00:00,71,37,34,FMN 01 Ernest Van Dijckkaai
649,Ernest Van Dijckkaai,2023-06-09,05:00:00,139,89,50,FMN 01 Ernest Van Dijckkaai
649,Ernest Van Dijckkaai,2023-06-09,06:00:00,269,161,108,FMN 01 Ernest Van Dijckkaai
649,Ernest Van Dijckkaai,2023-06-09,07:00:00,472,282,190,FMN 01 Ernest Van Dijckkaai
649,Ernest Van Dijckkaai,2023-06-09,08:00:00,708,435,273,FMN 01 Ernest Van Dijckkaai
649,Ernest Van Dijckkaai,2023-06-09,09:00:00,351,194,157,FMN 01 Ernest Van Dijckkaai
649,Ernest Van Dijckkaai,2023-06-09,10:00:00,274,156,118,FMN 01 Ernest Van Dijckkaai
649,Ernest Van Dijckkaai,2023-06-09,11:00:00,348,189,159,FMN 01 Ernest Van Dijckkaai
649,Ernest Van Dijckkaai,2023-06-09,12:00:00,542,245,297,FMN 01 Ernest Van Dijckkaai
649,Ernest Van Dijckkaai,2023-06-09,13:00:00,444,249,195,FMN 01 Ernest Van Dijckkaai
649,Ernest Van Dijckkaai,2023-06-09,14:00:00,491,230,261,FMN 01 Ernest Van Dijckkaai
649,Ernest Van Dijckkaai,2023-06-09,15:00:00,644,315,329,FMN 01 Ernest Van Dijckkaai
649,Ernest Van Dijckkaai,2023-06-09,16:00:00,782,333,449,FMN 01 Ernest Van Dijckkaai
649,Ernest Van Dijckkaai,2023-06-09,17:00:00,714,328,386,FMN 01 Ernest Van Dijckkaai
649,Ernest Van Dijckkaai,2023-06-09,18:00:00,612,348,264,FMN 01 Ernest Van Dijckkaai
649,Ernest Van Dijckkaai,2023-06-09,19:00:00,571,347,224,FMN 01 Ernest Van Dijckkaai
649,Ernest Van Dijckkaai,2023-06-09,20:00:00,427,229,198,FMN 01 Ernest Van Dijckkaai
649,Ernest Van Dijckkaai,2023-06-09,21:00:00,375,200,175,FMN 01 Ernest Van Dijckkaai
649,Ernest Van Dijckkaai,2023-06-09,22:00:00,453,190,263,FMN 01 Ernest Van Dijckkaai
649,Ernest Van Dijckkaai,2023-06-09,23:00:00,341,110,231,FMN 01 Ernest Van Dijckkaai
649,Ernest Van Dijckkaai,2023-06-10,00:00:00,338,101,237,FMN 01 Ernest Van Dijckkaai
649,Ernest Van Dijckkaai,2023-06-10,01:00:00,164,35,129,FMN 01 Ernest Van Dijckkaai
649,Ernest Van Dijckkaai,2023-06-10,02:00:00,111,35,76,FMN 01 Ernest Van Dijckkaai
649,Ernest Van Dijckkaai,2023-06-10,03:00:00,48,22,26,FMN 01 Ernest Van Dijckkaai
649,Ernest Van Dijckkaai,2023-06-10,04:00:00,55,27,28,FMN 01 Ernest Van Dijckkaai
649,Ernest Van Dijckkaai,2023-06-10,05:00:00,47,23,24,FMN 01 Ernest Van Dijckkaai
649,Ernest Van Dijckkaai,2023-06-10,06:00:00,53,23,30,FMN 01 Ernest Van Dijckkaai
649,Ernest Van Dijckkaai,2023-06-10,07:00:00,65,29,36,FMN 01 Ernest Van Dijckkaai
649,Ernest Van Dijckkaai,2023-06-10,08:00:00,154,64,90,FMN 01 Ernest Van Dijckkaai
649,Ernest Van Dijckkaai,2023-06-10,09:00:00,301,176,125,FMN 01 Ernest Van Dijckkaai
649,Ernest Van Dijckkaai,2023-06-10,10:00:00,329,160,169,FMN 01 Ernest Van Dijckkaai
649,Ernest Van Dijckkaai,2023-06-10,11:00:00,372,217,155,FMN 01 Ernest Van Dijckkaai
649,Ernest Van Dijckkaai,2023-06-10,12:00:00,409,219,190,FMN 01 Ernest Van Dijckkaai
649,Ernest Van Dijckkaai,2023-06-10,13:00:00,491,265,226,FMN 01 Ernest Van Dijckkaai
649,Ernest Van Dijckkaai,2023-06-10,14:00:00,531,276,255,FMN 01 Ernest Van Dijckkaai
649,Ernest Van Dijckkaai,2023-06-10,15:00:00,557,283,274,FMN 01 Ernest Van Dijckkaai
649,Ernest Van Dijckkaai,2023-06-10,16:00:00,469,249,220,FMN 01 Ernest Van Dijckkaai
649,Ernest Van Dijckkaai,2023-06-10,17:00:00,489,268,221,FMN 01 Ernest Van Dijckkaai
649,Ernest Van Dijckkaai,2023-06-10,18:00:00,486,283,203,FMN 01 Ernest Van Dijckkaai
649,Ernest Van Dijckkaai,2023-06-10,19:00:00,512,246,266,FMN 01 Ernest Van Dijckkaai
649,Ernest Van Dijckkaai,2023-06-10,20:00:00,422,216,206,FMN 01 Ernest Van Dijckkaai
649,Ernest Van Dijckkaai,2023-06-10,21:00:00,328,156,172,FMN 01 Ernest Van Dijckkaai
649,Ernest Van Dijckkaai,2023-06-10,22:00:00,347,172,175,FMN 01 Ernest Van Dijckkaai
649,Ernest Van Dijckkaai,2023-06-10,23:00:00,333,115,218,FMN 01 Ernest Van Dijckkaai
649,Ernest Van Dijckkaai,2023-06-11,00:00:00,298,90,208,FMN 01 Ernest Van Dijckkaai
649,Ernest Van Dijckkaai,2023-06-11,01:00:00,184,78,106,FMN 01 Ernest Van Dijckkaai
649,Ernest Van Dijckkaai,2023-06-11,02:00:00,93,38,55,FMN 01 Ernest Van Dijckkaai
649,Ernest Van Dijckkaai,2023-06-11,03:00:00,85,32,53,FMN 01 Ernest Van Dijckkaai
649,Ernest Van Dijckkaai,2023-06-11,04:00:00,54,18,36,FMN 01 Ernest Van Dijckkaai
649,Ernest Van Dijckkaai,2023-06-11,05:00:00,47,24,23,FMN 01 Ernest Van Dijckkaai
649,Ernest Van Dijckkaai,2023-06-11,06:00:00,41,11,30,FMN 01 Ernest Van Dijckkaai
649,Ernest Van Dijckkaai,2023-06-11,07:00:00,51,23,28,FMN 01 Ernest Van Dijckkaai
649,Ernest Van Dijckkaai,2023-06-11,08:00:00,112,51,61,FMN 01 Ernest Van Dijckkaai
649,Ernest Van Dijckkaai,2023-06-11,09:00:00,223,132,91,FMN 01 Ernest Van Dijckkaai
649,Ernest Van Dijckkaai,2023-06-11,10:00:00,323,192,131,FMN 01 Ernest Van Dijckkaai
649,Ernest Van Dijckkaai,2023-06-11,11:00:00,344,194,150,FMN 01 Ernest Van Dijckkaai
649,Ernest Van Dijckkaai,2023-06-11,12:00:00,377,206,171,FMN 01 Ernest Van Dijckkaai
649,Ernest Van Dijckkaai,2023-06-11,13:00:00,469,255,214,FMN 01 Ernest Van Dijckkaai
649,Ernest Van Dijckkaai,2023-06-11,14:00:00,468,243,225,FMN 01 Ernest Van Dijckkaai
649,Ernest Van Dijckkaai,2023-06-11,15:00:00,440,222,218,FMN 01 Ernest Van Dijckkaai
649,Ernest Van Dijckkaai,2023-06-11,16:00:00,409,190,219,FMN 01 Ernest Van Dijckkaai
649,Ernest Van Dijckkaai,2023-06-11,17:00:00,402,185,217,FMN 01 Ernest Van Dijckkaai
649,Ernest Van Dijckkaai,2023-06-11,18:00:00,364,186,178,FMN 01 Ernest Van Dijckkaai
649,Ernest Van Dijckkaai,2023-06-11,19:00:00,279,113,166,FMN 01 Ernest Van Dijckkaai
649,Ernest Van Dijckkaai,2023-06-11,20:00:00,321,148,173,FMN 01 Ernest Van Dijckkaai
649,Ernest Van Dijckkaai,2023-06-11,21:00:00,270,128,142,FMN 01 Ernest Van Dijckkaai
649,Ernest Van Dijckkaai,2023-06-11,22:00:00,160,70,90,FMN 01 Ernest Van Dijckkaai
649,Ernest Van Dijckkaai,2023-06-11,23:00:00,115,49,66,FMN 01 Ernest Van Dijckkaai
649,Ernest Van Dijckkaai,2023-06-12,00:00:00,50,16,34,FMN 01 Ernest Van Dijckkaai
649,Ernest Van Dijckkaai,2023-06-12,01:00:00,32,12,20,FMN 01 Ernest Van Dijckkaai
649,Ernest Van Dijckkaai,2023-06-12,02:00:00,18,6,12,FMN 01 Ernest Van Dijckkaai
649,Ernest Van Dijckkaai,2023-06-12,03:00:00,11,4,7,FMN 01 Ernest Van Dijckkaai
649,Ernest Van Dijckkaai,2023-06-12,04:00:00,76,45,31,FMN 01 Ernest Van Dijckkaai
649,Ernest Van Dijckkaai,2023-06-12,05:00:00,163,105,58,FMN 01 Ernest Van Dijckkaai
649,Ernest Van Dijckkaai,2023-06-12,06:00:00,293,197,96,FMN 01 Ernest Van Dijckkaai
649,Ernest Van Dijckkaai,2023-06-12,07:00:00,536,355,181,FMN 01 Ernest Van Dijckkaai
649,Ernest Van Dijckkaai,2023-06-12,08:00:00,694,406,288,FMN 01 Ernest Van Dijckkaai
649,Ernest Van Dijckkaai,2023-06-12,09:00:00,321,191,130,FMN 01 Ernest Van Dijckkaai
649,Ernest Van Dijckkaai,2023-06-12,10:00:00,222,126,96,FMN 01 Ernest Van Dijckkaai
649,Ernest Van Dijckkaai,2023-06-12,11:00:00,248,122,126,FMN 01 Ernest Van Dijckkaai
649,Ernest Van Dijckkaai,2023-06-12,12:00:00,359,185,174,FMN 01 Ernest Van Dijckkaai
649,Ernest Van Dijckkaai,2023-06-12,13:00:00,311,144,167,FMN 01 Ernest Van Dijckkaai
649,Ernest Van Dijckkaai,2023-06-12,14:00:00,354,167,187,FMN 01 Ernest Van Dijckkaai
649,Ernest Van Dijckkaai,2023-06-12,15:00:00,429,198,231,FMN 01 Ernest Van Dijckkaai
649,Ernest Van Dijckkaai,2023-06-12,16:00:00,690,295,395,FMN 01 Ernest Van Dijckkaai
649,Ernest Van Dijckkaai,2023-06-12,17:00:00,784,301,483,FMN 01 Ernest Van Dijckkaai
649,Ernest Van Dijckkaai,2023-06-12,18:00:00,479,244,235,FMN 01 Ernest Van Dijckkaai
649,Ernest Van Dijckkaai,2023-06-12,19:00:00,319,140,179,FMN 01 Ernest Van Dijckkaai
649,Ernest Van Dijckkaai,2023-06-12,20:00:00,311,144,167,FMN 01 Ernest Van Dijckkaai
649,Ernest Van Dijckkaai,2023-06-12,21:00:00,329,137,192,FMN 01 Ernest Van Dijckkaai
649,Ernest Van Dijckkaai,2023-06-12,22:00:00,247,111,136,FMN 01 Ernest Van Dijckkaai
649,Ernest Van Dijckkaai,2023-06-12,23:00:00,130,60,70,FMN 01 Ernest Van Dijckkaai
649,Ernest Van Dijckkaai,2023-06-13,00:00:00,49,17,32,FMN 01 Ernest Van Dijckkaai
649,Ernest Van Dijckkaai,2023-06-13,01:00:00,32,14,18,FMN 01 Ernest Van Dijckkaai
649,Ernest Van Dijckkaai,2023-06-13,02:00:00,7,2,5,FMN 01 Ernest Van Dijckkaai
649,Ernest Van Dijckkaai,2023-06-13,03:00:00,12,3,9,FMN 01 Ernest Van Dijckkaai
649,Ernest Van Dijckkaai,2023-06-13,04:00:00,62,30,32,FMN 01 Ernest Van Dijckkaai
649,Ernest Van Dijckkaai,2023-06-13,05:00:00,158,106,52,FMN 01 Ernest Van Dijckkaai
649,Ernest Van Dijckkaai,2023-06-13,06:00:00,343,216,127,FMN 01 Ernest Van Dijckkaai
649,Ernest Van Dijckkaai,2023-06-13,07:00:00,581,371,210,FMN 01 Ernest Van Dijckkaai
649,Ernest Van Dijckkaai,2023-06-13,08:00:00,753,454,299,FMN 01 Ernest Van Dijckkaai
649,Ernest Van Dijckkaai,2023-06-13,09:00:00,340,196,144,FMN 01 Ernest Van Dijckkaai
649,Ernest Van Dijckkaai,2023-06-13,10:00:00,264,138,126,FMN 01 Ernest Van Dijckkaai
649,Ernest Van Dijckkaai,2023-06-13,11:00:00,270,150,120,FMN 01 Ernest Van Dijckkaai
649,Ernest Van Dijckkaai,2023-06-13,12:00:00,402,210,192,FMN 01 Ernest Van Dijckkaai
649,Ernest Van Dijckkaai,2023-06-13,13:00:00,442,272,170,FMN 01 Ernest Van Dijckkaai
649,Ernest Van Dijckkaai,2023-06-13,14:00:00,398,188,210,FMN 01 Ernest Van Dijckkaai
649,Ernest Van Dijckkaai,2023-06-13,15:00:00,462,209,253,FMN 01 Ernest Van Dijckkaai
649,Ernest Van Dijckkaai,2023-06-13,16:00:00,738,314,424,FMN 01 Ernest Van Dijckkaai
649,Ernest Van Dijckkaai,2023-06-13,17:00:00,846,360,486,FMN 01 Ernest Van Dijckkaai
649,Ernest Van Dijckkaai,2023-06-13,18:00:00,592,292,300,FMN 01 Ernest Van Dijckkaai
649,Ernest Van Dijckkaai,2023-06-13,19:00:00,389,208,181,FMN 01 Ernest Van Dijckkaai
649,Ernest Van Dijckkaai,2023-06-13,20:00:00,352,173,179,FMN 01 Ernest Van Dijckkaai
649,Ernest Van Dijckkaai,2023-06-13,21:00:00,346,167,179,FMN 01 Ernest Van Dijckkaai
649,Ernest Van Dijckkaai,2023-06-13,22:00:00,365,146,219,FMN 01 Ernest Van Dijckkaai
649,Ernest Van Dijckkaai,2023-06-13,23:00:00,148,60,88,FMN 01 Ernest Van Dijckkaai
649,Ernest Van Dijckkaai,2023-06-14,00:00:00,59,28,31,FMN 01 Ernest Van Dijckkaai
649,Ernest Van Dijckkaai,2023-06-14,01:00:00,27,7,20,FMN 01 Ernest Van Dijckkaai
649,Ernest Van Dijckkaai,2023-06-14,02:00:00,25,9,16,FMN 01 Ernest Van Dijckkaai
649,Ernest Van Dijckkaai,2023-06-14,03:00:00,19,11,8,FMN 01 Ernest Van Dijckkaai
649,Ernest Van Dijckkaai,2023-06-14,04:00:00,74,38,36,FMN 01 Ernest Van Dijckkaai
649,Ernest Van Dijckkaai,2023-06-14,05:00:00,156,100,56,FMN 01 Ernest Van Dijckkaai
649,Ernest Van Dijckkaai,2023-06-14,06:00:00,303,186,117,FMN 01 Ernest Van Dijckkaai
649,Ernest Van Dijckkaai,2023-06-14,07:00:00,480,297,183,FMN 01 Ernest Van Dijckkaai
649,Ernest Van Dijckkaai,2023-06-14,08:00:00,663,400,263,FMN 01 Ernest Van Dijckkaai
649,Ernest Van Dijckkaai,2023-06-14,09:00:00,357,221,136,FMN 01 Ernest Van Dijckkaai
649,Ernest Van Dijckkaai,2023-06-14,10:00:00,279,138,141,FMN 01 Ernest Van Dijckkaai
649,Ernest Van Dijckkaai,2023-06-14,11:00:00,273,125,148,FMN 01 Ernest Van Dijckkaai
649,Ernest Van Dijckkaai,2023-06-14,12:00:00,399,198,201,FMN 01 Ernest Van Dijckkaai
649,Ernest Van Dijckkaai,2023-06-14,13:00:00,396,214,182,FMN 01 Ernest Van Dijckkaai
649,Ernest Van Dijckkaai,2023-06-14,14:00:00,401,188,213,FMN 01 Ernest Van Dijckkaai
649,Ernest Van Dijckkaai,2023-06-14,15:00:00,429,211,218,FMN 01 Ernest Van Dijckkaai
649,Ernest Van Dijckkaai,2023-06-14,16:00:00,676,311,365,FMN 01 Ernest Van Dijckkaai
649,Ernest Van Dijckkaai,2023-06-14,17:00:00,805,363,442,FMN 01 Ernest Van Dijckkaai
649,Ernest Van Dijckkaai,2023-06-14,18:00:00,625,328,297,FMN 01 Ernest Van Dijckkaai
649,Ernest Van Dijckkaai,2023-06-14,19:00:00,429,216,213,FMN 01 Ernest Van Dijckkaai
649,Ernest Van Dijckkaai,2023-06-14,20:00:00,393,213,180,FMN 01 Ernest Van Dijckkaai
649,Ernest Van Dijckkaai,2023-06-14,21:00:00,373,164,209,FMN 01 Ernest Van Dijckkaai
649,Ernest Van Dijckkaai,2023-06-14,22:00:00,313,123,190,FMN 01 Ernest Van Dijckkaai
649,Ernest Van Dijckkaai,2023-06-14,23:00:00,148,45,103,FMN 01 Ernest Van Dijckkaai
649,Ernest Van Dijckkaai,2023-06-15,00:00:00,64,28,36,FMN 01 Ernest Van Dijckkaai
649,Ernest Van Dijckkaai,2023-06-15,01:00:00,38,15,23,FMN 01 Ernest Van Dijckkaai
649,Ernest Van Dijckkaai,2023-06-15,02:00:00,11,5,6,FMN 01 Ernest Van Dijckkaai
649,Ernest Van Dijckkaai,2023-06-15,03:00:00,15,6,9,FMN 01 Ernest Van Dijckkaai
649,Ernest Van Dijckkaai,2023-06-15,04:00:00,67,41,26,FMN 01 Ernest Van Dijckkaai
649,Ernest Van Dijckkaai,2023-06-15,05:00:00,157,109,48,FMN 01 Ernest Van Dijckkaai
649,Ernest Van Dijckkaai,2023-06-15,06:00:00,316,197,119,FMN 01 Ernest Van Dijckkaai
649,Ernest Van Dijckkaai,2023-06-15,07:00:00,521,334,187,FMN 01 Ernest Van Dijckkaai
649,Ernest Van Dijckkaai,2023-06-15,08:00:00,726,437,289,FMN 01 Ernest Van Dijckkaai
649,Ernest Van Dijckkaai,2023-06-15,09:00:00,379,231,148,FMN 01 Ernest Van Dijckkaai
649,Ernest Van Dijckkaai,2023-06-15,10:00:00,288,163,125,FMN 01 Ernest Van Dijckkaai
649,Ernest Van Dijckkaai,2023-06-15,11:00:00,313,175,138,FMN 01 Ernest Van Dijckkaai
649,Ernest Van Dijckkaai,2023-06-15,12:00:00,435,235,200,FMN 01 Ernest Van Dijckkaai
649,Ernest Van Dijckkaai,2023-06-15,13:00:00,376,199,177,FMN 01 Ernest Van Dijckkaai
649,Ernest Van Dijckkaai,2023-06-15,14:00:00,448,192,256,FMN 01 Ernest Van Dijckkaai
649,Ernest Van Dijckkaai,2023-06-15,15:00:00,554,245,309,FMN 01 Ernest Van Dijckkaai
649,Ernest Van Dijckkaai,2023-06-15,16:00:00,777,377,400,FMN 01 Ernest Van Dijckkaai
649,Ernest Van Dijckkaai,2023-06-15,17:00:00,867,371,496,FMN 01 Ernest Van Dijckkaai
649,Ernest Van Dijckkaai,2023-06-15,18:00:00,636,313,323,FMN 01 Ernest Van Dijckkaai
649,Ernest Van Dijckkaai,2023-06-15,19:00:00,438,228,210,FMN 01 Ernest Van Dijckkaai
649,Ernest Van Dijckkaai,2023-06-15,20:00:00,432,222,210,FMN 01 Ernest Van Dijckkaai
649,Ernest Van Dijckkaai,2023-06-15,21:00:00,364,154,210,FMN 01 Ernest Van Dijckkaai
649,Ernest Van Dijckkaai,2023-06-15,22:00:00,320,121,199,FMN 01 Ernest Van Dijckkaai
649,Ernest Van Dijckkaai,2023-06-15,23:00:00,191,66,125,FMN 01 Ernest Van Dijckkaai
649,Ernest Van Dijckkaai,2023-06-16,00:00:00,81,34,47,FMN 01 Ernest Van Dijckkaai
649,Ernest Van Dijckkaai,2023-06-16,01:00:00,60,28,32,FMN 01 Ernest Van Dijckkaai
649,Ernest Van Dijckkaai,2023-06-16,02:00:00,38,20,18,FMN 01 Ernest Van Dijckkaai
649,Ernest Van Dijckkaai,2023-06-16,03:00:00,39,6,33,FMN 01 Ernest Van Dijckkaai
649,Ernest Van Dijckkaai,2023-06-16,04:00:00,81,45,36,FMN 01 Ernest Van Dijckkaai
649,Ernest Van Dijckkaai,2023-06-16,05:00:00,150,98,52,FMN 01 Ernest Van Dijckkaai
649,Ernest Van Dijckkaai,2023-06-16,06:00:00,268,172,96,FMN 01 Ernest Van Dijckkaai
649,Ernest Van Dijckkaai,2023-06-16,07:00:00,435,248,187,FMN 01 Ernest Van Dijckkaai
649,Ernest Van Dijckkaai,2023-06-16,08:00:00,647,376,271,FMN 01 Ernest Van Dijckkaai
649,Ernest Van Dijckkaai,2023-06-16,09:00:00,447,300,147,FMN 01 Ernest Van Dijckkaai
649,Ernest Van Dijckkaai,2023-06-16,10:00:00,344,194,150,FMN 01 Ernest Van Dijckkaai
649,Ernest Van Dijckkaai,2023-06-16,11:00:00,433,210,223,FMN 01 Ernest Van Dijckkaai
649,Ernest Van Dijckkaai,2023-06-16,12:00:00,476,251,225,FMN 01 Ernest Van Dijckkaai
649,Ernest Van Dijckkaai,2023-06-16,13:00:00,491,252,239,FMN 01 Ernest Van Dijckkaai
649,Ernest Van Dijckkaai,2023-06-16,14:00:00,531,238,293,FMN 01 Ernest Van Dijckkaai
649,Ernest Van Dijckkaai,2023-06-16,15:00:00,607,274,333,FMN 01 Ernest Van Dijckkaai
649,Ernest Van Dijckkaai,2023-06-16,16:00:00,724,350,374,FMN 01 Ernest Van Dijckkaai
649,Ernest Van Dijckkaai,2023-06-16,17:00:00,669,317,352,FMN 01 Ernest Van Dijckkaai
649,Ernest Van Dijckkaai,2023-06-16,18:00:00,640,319,321,FMN 01 Ernest Van Dijckkaai
649,Ernest Van Dijckkaai,2023-06-16,19:00:00,562,286,276,FMN 01 Ernest Van Dijckkaai
649,Ernest Van Dijckkaai,2023-06-16,20:00:00,458,199,259,FMN 01 Ernest Van Dijckkaai
649,Ernest Van Dijckkaai,2023-06-16,21:00:00,410,181,229,FMN 01 Ernest Van Dijckkaai
649,Ernest Van Dijckkaai,2023-06-16,22:00:00,489,206,283,FMN 01 Ernest Van Dijckkaai
649,Ernest Van Dijckkaai,2023-06-16,23:00:00,339,136,203,FMN 01 Ernest Van Dijckkaai
649,Ernest Van Dijckkaai,2023-06-17,00:00:00,301,179,122,FMN 01 Ernest Van Dijckkaai
649,Ernest Van Dijckkaai,2023-06-17,01:00:00,158,80,78,FMN 01 Ernest Van Dijckkaai
649,Ernest Van Dijckkaai,2023-06-17,02:00:00,105,50,55,FMN 01 Ernest Van Dijckkaai
649,Ernest Van Dijckkaai,2023-06-17,03:00:00,64,19,45,FMN 01 Ernest Van Dijckkaai
649,Ernest Van Dijckkaai,2023-06-17,04:00:00,49,20,29,FMN 01 Ernest Van Dijckkaai
649,Ernest Van Dijckkaai,2023-06-17,05:00:00,45,27,18,FMN 01 Ernest Van Dijckkaai
649,Ernest Van Dijckkaai,2023-06-17,06:00:00,57,22,35,FMN 01 Ernest Van Dijckkaai
649,Ernest Van Dijckkaai,2023-06-17,07:00:00,65,24,41,FMN 01 Ernest Van Dijckkaai
649,Ernest Van Dijckkaai,2023-06-17,08:00:00,107,51,56,FMN 01 Ernest Van Dijckkaai
649,Ernest Van Dijckkaai,2023-06-17,09:00:00,214,134,80,FMN 01 Ernest Van Dijckkaai
649,Ernest Van Dijckkaai,2023-06-17,10:00:00,267,151,116,FMN 01 Ernest Van Dijckkaai
649,Ernest Van Dijckkaai,2023-06-17,11:00:00,350,192,158,FMN 01 Ernest Van Dijckkaai
649,Ernest Van Dijckkaai,2023-06-17,12:00:00,397,213,184,FMN 01 Ernest Van Dijckkaai
649,Ernest Van Dijckkaai,2023-06-17,13:00:00,461,250,211,FMN 01 Ernest Van Dijckkaai
649,Ernest Van Dijckkaai,2023-06-17,14:00:00,532,287,245,FMN 01 Ernest Van Dijckkaai
649,Ernest Van Dijckkaai,2023-06-17,15:00:00,578,301,277,FMN 01 Ernest Van Dijckkaai
649,Ernest Van Dijckkaai,2023-06-17,16:00:00,578,260,318,FMN 01 Ernest Van Dijckkaai
649,Ernest Van Dijckkaai,2023-06-17,17:00:00,539,283,256,FMN 01 Ernest Van Dijckkaai
649,Ernest Van Dijckkaai,2023-06-17,18:00:00,524,261,263,FMN 01 Ernest Van Dijckkaai
649,Ernest Van Dijckkaai,2023-06-17,19:00:00,416,221,195,FMN 01 Ernest Van Dijckkaai
649,Ernest Van Dijckkaai,2023-06-17,20:00:00,339,128,211,FMN 01 Ernest Van Dijckkaai
649,Ernest Van Dijckkaai,2023-06-17,21:00:00,308,149,159,FMN 01 Ernest Van Dijckkaai
649,Ernest Van Dijckkaai,2023-06-17,22:00:00,367,165,202,FMN 01 Ernest Van Dijckkaai
649,Ernest Van Dijckkaai,2023-06-17,23:00:00,320,95,225,FMN 01 Ernest Van Dijckkaai
649,Ernest Van Dijckkaai,2023-06-18,00:00:00,189,83,106,FMN 01 Ernest Van Dijckkaai
649,Ernest Van Dijckkaai,2023-06-18,01:00:00,171,67,104,FMN 01 Ernest Van Dijckkaai
649,Ernest Van Dijckkaai,2023-06-18,02:00:00,116,60,56,FMN 01 Ernest Van Dijckkaai
649,Ernest Van Dijckkaai,2023-06-18,03:00:00,80,35,45,FMN 01 Ernest Van Dijckkaai
649,Ernest Van Dijckkaai,2023-06-18,04:00:00,48,26,22,FMN 01 Ernest Van Dijckkaai
649,Ernest Van Dijckkaai,2023-06-18,05:00:00,45,19,26,FMN 01 Ernest Van Dijckkaai
649,Ernest Van Dijckkaai,2023-06-18,06:00:00,55,29,26,FMN 01 Ernest Van Dijckkaai
649,Ernest Van Dijckkaai,2023-06-18,07:00:00,45,22,23,FMN 01 Ernest Van Dijckkaai
649,Ernest Van Dijckkaai,2023-06-18,08:00:00,118,56,62,FMN 01 Ernest Van Dijckkaai
649,Ernest Van Dijckkaai,2023-06-18,09:00:00,184,97,87,FMN 01 Ernest Van Dijckkaai
649,Ernest Van Dijckkaai,2023-06-18,10:00:00,196,108,88,FMN 01 Ernest Van Dijckkaai
649,Ernest Van Dijckkaai,2023-06-18,11:00:00,197,89,108,FMN 01 Ernest Van Dijckkaai
649,Ernest Van Dijckkaai,2023-06-18,12:00:00,254,148,106,FMN 01 Ernest Van Dijckkaai
649,Ernest Van Dijckkaai,2023-06-18,13:00:00,280,161,119,FMN 01 Ernest Van Dijckkaai
649,Ernest Van Dijckkaai,2023-06-18,14:00:00,412,211,201,FMN 01 Ernest Van Dijckkaai
649,Ernest Van Dijckkaai,2023-06-18,15:00:00,414,212,202,FMN 01 Ernest Van Dijckkaai
649,Ernest Van Dijckkaai,2023-06-18,16:00:00,396,221,175,FMN 01 Ernest Van Dijckkaai
649,Ernest Van Dijckkaai,2023-06-18,17:00:00,353,171,182,FMN 01 Ernest Van Dijckkaai
649,Ernest Van Dijckkaai,2023-06-18,18:00:00,316,158,158,FMN 01 Ernest Van Dijckkaai
649,Ernest Van Dijckkaai,2023-06-18,19:00:00,245,120,125,FMN 01 Ernest Van Dijckkaai
649,Ernest Van Dijckkaai,2023-06-18,20:00:00,241,110,131,FMN 01 Ernest Van Dijckkaai
649,Ernest Van Dijckkaai,2023-06-18,21:00:00,195,90,105,FMN 01 Ernest Van Dijckkaai
649,Ernest Van Dijckkaai,2023-06-18,22:00:00,116,53,63,FMN 01 Ernest Van Dijckkaai
649,Ernest Van Dijckkaai,2023-06-18,23:00:00,80,27,53,FMN 01 Ernest Van Dijckkaai
649,Ernest Van Dijckkaai,2023-06-19,00:00:00,27,12,15,FMN 01 Ernest Van Dijckkaai
649,Ernest Van Dijckkaai,2023-06-19,01:00:00,18,3,15,FMN 01 Ernest Van Dijckkaai
649,Ernest Van Dijckkaai,2023-06-19,02:00:00,16,7,9,FMN 01 Ernest Van Dijckkaai
649,Ernest Van Dijckkaai,2023-06-19,03:00:00,10,6,4,FMN 01 Ernest Van Dijckkaai
649,Ernest Van Dijckkaai,2023-06-19,04:00:00,72,46,26,FMN 01 Ernest Van Dijckkaai
649,Ernest Van Dijckkaai,2023-06-19,05:00:00,115,83,32,FMN 01 Ernest Van Dijckkaai
649,Ernest Van Dijckkaai,2023-06-19,06:00:00,288,187,101,FMN 01 Ernest Van Dijckkaai
649,Ernest Van Dijckkaai,2023-06-19,07:00:00,469,296,173,FMN 01 Ernest Van Dijckkaai
649,Ernest Van Dijckkaai,2023-06-19,08:00:00,644,377,267,FMN 01 Ernest Van Dijckkaai
649,Ernest Van Dijckkaai,2023-06-19,09:00:00,285,171,114,FMN 01 Ernest Van Dijckkaai
649,Ernest Van Dijckkaai,2023-06-19,10:00:00,228,108,120,FMN 01 Ernest Van Dijckkaai
649,Ernest Van Dijckkaai,2023-06-19,11:00:00,254,130,124,FMN 01 Ernest Van Dijckkaai
649,Ernest Van Dijckkaai,2023-06-19,12:00:00,310,153,157,FMN 01 Ernest Van Dijckkaai
649,Ernest Van Dijckkaai,2023-06-19,13:00:00,283,149,134,FMN 01 Ernest Van Dijckkaai
649,Ernest Van Dijckkaai,2023-06-19,14:00:00,383,176,207,FMN 01 Ernest Van Dijckkaai
649,Ernest Van Dijckkaai,2023-06-19,15:00:00,455,203,252,FMN 01 Ernest Van Dijckkaai
649,Ernest Van Dijckkaai,2023-06-19,16:00:00,629,262,367,FMN 01 Ernest Van Dijckkaai
649,Ernest Van Dijckkaai,2023-06-19,17:00:00,786,292,494,FMN 01 Ernest Van Dijckkaai
649,Ernest Van Dijckkaai,2023-06-19,18:00:00,530,240,290,FMN 01 Ernest Van Dijckkaai
649,Ernest Van Dijckkaai,2023-06-19,19:00:00,357,184,173,FMN 01 Ernest Van Dijckkaai
649,Ernest Van Dijckkaai,2023-06-19,20:00:00,324,150,174,FMN 01 Ernest Van Dijckkaai
649,Ernest Van Dijckkaai,2023-06-19,21:00:00,242,119,123,FMN 01 Ernest Van Dijckkaai
649,Ernest Van Dijckkaai,2023-06-19,22:00:00,288,111,177,FMN 01 Ernest Van Dijckkaai
649,Ernest Van Dijckkaai,2023-06-19,23:00:00,106,46,60,FMN 01 Ernest Van Dijckkaai
649,Ernest Van Dijckkaai,2023-06-20,00:00:00,49,25,24,FMN 01 Ernest Van Dijckkaai
649,Ernest Van Dijckkaai,2023-06-20,01:00:00,21,5,16,FMN 01 Ernest Van Dijckkaai
649,Ernest Van Dijckkaai,2023-06-20,02:00:00,19,7,12,FMN 01 Ernest Van Dijckkaai
649,Ernest Van Dijckkaai,2023-06-20,03:00:00,15,7,8,FMN 01 Ernest Van Dijckkaai
649,Ernest Van Dijckkaai,2023-06-20,04:00:00,69,45,24,FMN 01 Ernest Van Dijckkaai
649,Ernest Van Dijckkaai,2023-06-20,05:00:00,135,89,46,FMN 01 Ernest Van Dijckkaai
649,Ernest Van Dijckkaai,2023-06-20,06:00:00,269,169,100,FMN 01 Ernest Van Dijckkaai
649,Ernest Van Dijckkaai,2023-06-20,07:00:00,482,298,184,FMN 01 Ernest Van Dijckkaai
649,Ernest Van Dijckkaai,2023-06-20,08:00:00,727,451,276,FMN 01 Ernest Van Dijckkaai
649,Ernest Van Dijckkaai,2023-06-20,09:00:00,404,245,159,FMN 01 Ernest Van Dijckkaai
649,Ernest Van Dijckkaai,2023-06-20,10:00:00,232,117,115,FMN 01 Ernest Van Dijckkaai
649,Ernest Van Dijckkaai,2023-06-20,11:00:00,253,137,116,FMN 01 Ernest Van Dijckkaai
649,Ernest Van Dijckkaai,2023-06-20,12:00:00,378,223,155,FMN 01 Ernest Van Dijckkaai
649,Ernest Van Dijckkaai,2023-06-20,13:00:00,398,179,219,FMN 01 Ernest Van Dijckkaai
649,Ernest Van Dijckkaai,2023-06-20,14:00:00,384,176,208,FMN 01 Ernest Van Dijckkaai
649,Ernest Van Dijckkaai,2023-06-20,15:00:00,431,199,232,FMN 01 Ernest Van Dijckkaai
649,Ernest Van Dijckkaai,2023-06-20,16:00:00,678,287,391,FMN 01 Ernest Van Dijckkaai
649,Ernest Van Dijckkaai,2023-06-20,17:00:00,557,230,327,FMN 01 Ernest Van Dijckkaai
649,Ernest Van Dijckkaai,2023-06-20,18:00:00,288,133,155,FMN 01 Ernest Van Dijckkaai
649,Ernest Van Dijckkaai,2023-06-20,19:00:00,127,53,74,FMN 01 Ernest Van Dijckkaai
649,Ernest Van Dijckkaai,2023-06-20,20:00:00,109,45,64,FMN 01 Ernest Van Dijckkaai
649,Ernest Van Dijckkaai,2023-06-20,21:00:00,82,36,46,FMN 01 Ernest Van Dijckkaai
649,Ernest Van Dijckkaai,2023-06-20,22:00:00,129,48,81,FMN 01 Ernest Van Dijckkaai
649,Ernest Van Dijckkaai,2023-06-20,23:00:00,55,14,41,FMN 01 Ernest Van Dijckkaai
649,Ernest Van Dijckkaai,2023-06-21,00:00:00,39,13,26,FMN 01 Ernest Van Dijckkaai
649,Ernest Van Dijckkaai,2023-06-21,01:00:00,17,6,11,FMN 01 Ernest Van Dijckkaai
649,Ernest Van Dijckkaai,2023-06-21,02:00:00,21,7,14,FMN 01 Ernest Van Dijckkaai
649,Ernest Van Dijckkaai,2023-06-21,03:00:00,9,5,4,FMN 01 Ernest Van Dijckkaai
649,Ernest Van Dijckkaai,2023-06-21,04:00:00,59,37,22,FMN 01 Ernest Van Dijckkaai
649,Ernest Van Dijckkaai,2023-06-21,05:00:00,140,89,51,FMN 01 Ernest Van Dijckkaai
649,Ernest Van Dijckkaai,2023-06-21,06:00:00,281,182,99,FMN 01 Ernest Van Dijckkaai
649,Ernest Van Dijckkaai,2023-06-21,07:00:00,471,312,159,FMN 01 Ernest Van Dijckkaai
649,Ernest Van Dijckkaai,2023-06-21,08:00:00,601,357,244,FMN 01 Ernest Van Dijckkaai
649,Ernest Van Dijckkaai,2023-06-21,09:00:00,329,188,141,FMN 01 Ernest Van Dijckkaai
649,Ernest Van Dijckkaai,2023-06-21,10:00:00,300,174,126,FMN 01 Ernest Van Dijckkaai
649,Ernest Van Dijckkaai,2023-06-21,11:00:00,323,147,176,FMN 01 Ernest Van Dijckkaai
649,Ernest Van Dijckkaai,2023-06-21,12:00:00,438,225,213,FMN 01 Ernest Van Dijckkaai
649,Ernest Van Dijckkaai,2023-06-21,13:00:00,393,214,179,FMN 01 Ernest Van Dijckkaai
649,Ernest Van Dijckkaai,2023-06-21,14:00:00,422,205,217,FMN 01 Ernest Van Dijckkaai
649,Ernest Van Dijckkaai,2023-06-21,15:00:00,450,206,244,FMN 01 Ernest Van Dijckkaai
649,Ernest Van Dijckkaai,2023-06-21,16:00:00,676,286,390,FMN 01 Ernest Van Dijckkaai
649,Ernest Van Dijckkaai,2023-06-21,17:00:00,799,362,437,FMN 01 Ernest Van Dijckkaai
649,Ernest Van Dijckkaai,2023-06-21,18:00:00,631,322,309,FMN 01 Ernest Van Dijckkaai
649,Ernest Van Dijckkaai,2023-06-21,19:00:00,426,216,210,FMN 01 Ernest Van Dijckkaai
649,Ernest Van Dijckkaai,2023-06-21,20:00:00,392,191,201,FMN 01 Ernest Van Dijckkaai
649,Ernest Van Dijckkaai,2023-06-21,21:00:00,329,129,200,FMN 01 Ernest Van Dijckkaai
649,Ernest Van Dijckkaai,2023-06-21,22:00:00,348,156,192,FMN 01 Ernest Van Dijckkaai
649,Ernest Van Dijckkaai,2023-06-21,23:00:00,193,64,129,FMN 01 Ernest Van Dijckkaai
649,Ernest Van Dijckkaai,2023-06-22,00:00:00,84,28,56,FMN 01 Ernest Van Dijckkaai
649,Ernest Van Dijckkaai,2023-06-22,01:00:00,38,13,25,FMN 01 Ernest Van Dijckkaai
649,Ernest Van Dijckkaai,2023-06-22,02:00:00,26,9,17,FMN 01 Ernest Van Dijckkaai
649,Ernest Van Dijckkaai,2023-06-22,03:00:00,18,4,14,FMN 01 Ernest Van Dijckkaai
649,Ernest Van Dijckkaai,2023-06-22,04:00:00,67,39,28,FMN 01 Ernest Van Dijckkaai
649,Ernest Van Dijckkaai,2023-06-22,05:00:00,126,81,45,FMN 01 Ernest Van Dijckkaai
649,Ernest Van Dijckkaai,2023-06-22,06:00:00,245,147,98,FMN 01 Ernest Van Dijckkaai
649,Ernest Van Dijckkaai,2023-06-22,07:00:00,382,231,151,FMN 01 Ernest Van Dijckkaai
649,Ernest Van Dijckkaai,2023-06-22,08:00:00,585,343,242,FMN 01 Ernest Van Dijckkaai
649,Ernest Van Dijckkaai,2023-06-22,09:00:00,318,192,126,FMN 01 Ernest Van Dijckkaai
649,Ernest Van Dijckkaai,2023-06-22,10:00:00,228,122,106,FMN 01 Ernest Van Dijckkaai
649,Ernest Van Dijckkaai,2023-06-22,11:00:00,199,95,104,FMN 01 Ernest Van Dijckkaai
649,Ernest Van Dijckkaai,2023-06-22,12:00:00,207,90,117,FMN 01 Ernest Van Dijckkaai
649,Ernest Van Dijckkaai,2023-06-22,13:00:00,151,80,71,FMN 01 Ernest Van Dijckkaai
649,Ernest Van Dijckkaai,2023-06-22,14:00:00,194,82,112,FMN 01 Ernest Van Dijckkaai
649,Ernest Van Dijckkaai,2023-06-22,15:00:00,216,102,114,FMN 01 Ernest Van Dijckkaai
649,Ernest Van Dijckkaai,2023-06-22,16:00:00,357,151,206,FMN 01 Ernest Van Dijckkaai
649,Ernest Van Dijckkaai,2023-06-22,17:00:00,373,159,214,FMN 01 Ernest Van Dijckkaai
649,Ernest Van Dijckkaai,2023-06-22,18:00:00,273,143,130,FMN 01 Ernest Van Dijckkaai
649,Ernest Van Dijckkaai,2023-06-22,19:00:00,187,94,93,FMN 01 Ernest Van Dijckkaai
649,Ernest Van Dijckkaai,2023-06-22,20:00:00,163,74,89,FMN 01 Ernest Van Dijckkaai
649,Ernest Van Dijckkaai,2023-06-22,21:00:00,198,79,119,FMN 01 Ernest Van Dijckkaai
649,Ernest Van Dijckkaai,2023-06-22,22:00:00,152,69,83,FMN 01 Ernest Van Dijckkaai
649,Ernest Van Dijckkaai,2023-06-22,23:00:00,110,48,62,FMN 01 Ernest Van Dijckkaai
649,Ernest Van Dijckkaai,2023-06-23,00:00:00,60,28,32,FMN 01 Ernest Van Dijckkaai
649,Ernest Van Dijckkaai,2023-06-23,01:00:00,63,33,30,FMN 01 Ernest Van Dijckkaai
649,Ernest Van Dijckkaai,2023-06-23,02:00:00,38,10,28,FMN 01 Ernest Van Dijckkaai
649,Ernest Van Dijckkaai,2023-06-23,03:00:00,36,7,29,FMN 01 Ernest Van Dijckkaai
649,Ernest Van Dijckkaai,2023-06-23,04:00:00,63,40,23,FMN 01 Ernest Van Dijckkaai
649,Ernest Van Dijckkaai,2023-06-23,05:00:00,152,85,67,FMN 01 Ernest Van Dijckkaai
649,Ernest Van Dijckkaai,2023-06-23,06:00:00,253,151,102,FMN 01 Ernest Van Dijckkaai
649,Ernest Van Dijckkaai,2023-06-23,07:00:00,344,197,147,FMN 01 Ernest Van Dijckkaai
649,Ernest Van Dijckkaai,2023-06-23,08:00:00,524,295,229,FMN 01 Ernest Van Dijckkaai
649,Ernest Van Dijckkaai,2023-06-23,09:00:00,397,254,143,FMN 01 Ernest Van Dijckkaai
649,Ernest Van Dijckkaai,2023-06-23,10:00:00,284,162,122,FMN 01 Ernest Van Dijckkaai
649,Ernest Van Dijckkaai,2023-06-23,11:00:00,405,230,175,FMN 01 Ernest Van Dijckkaai
649,Ernest Van Dijckkaai,2023-06-23,12:00:00,413,224,189,FMN 01 Ernest Van Dijckkaai
649,Ernest Van Dijckkaai,2023-06-23,13:00:00,448,228,220,FMN 01 Ernest Van Dijckkaai
649,Ernest Van Dijckkaai,2023-06-23,14:00:00,474,213,261,FMN 01 Ernest Van Dijckkaai
649,Ernest Van Dijckkaai,2023-06-23,15:00:00,609,261,348,FMN 01 Ernest Van Dijckkaai
649,Ernest Van Dijckkaai,2023-06-23,16:00:00,717,312,405,FMN 01 Ernest Van Dijckkaai
649,Ernest Van Dijckkaai,2023-06-23,17:00:00,729,351,378,FMN 01 Ernest Van Dijckkaai
649,Ernest Van Dijckkaai,2023-06-23,18:00:00,574,330,244,FMN 01 Ernest Van Dijckkaai
649,Ernest Van Dijckkaai,2023-06-23,19:00:00,477,251,226,FMN 01 Ernest Van Dijckkaai
649,Ernest Van Dijckkaai,2023-06-23,20:00:00,436,187,249,FMN 01 Ernest Van Dijckkaai
649,Ernest Van Dijckkaai,2023-06-23,21:00:00,398,171,227,FMN 01 Ernest Van Dijckkaai
649,Ernest Van Dijckkaai,2023-06-23,22:00:00,367,158,209,FMN 01 Ernest Van Dijckkaai
649,Ernest Van Dijckkaai,2023-06-23,23:00:00,310,142,168,FMN 01 Ernest Van Dijckkaai
649,Ernest Van Dijckkaai,2023-06-24,00:00:00,206,94,112,FMN 01 Ernest Van Dijckkaai
649,Ernest Van Dijckkaai,2023-06-24,01:00:00,137,59,78,FMN 01 Ernest Van Dijckkaai
649,Ernest Van Dijckkaai,2023-06-24,02:00:00,114,43,71,FMN 01 Ernest Van Dijckkaai
649,Ernest Van Dijckkaai,2023-06-24,03:00:00,72,30,42,FMN 01 Ernest Van Dijckkaai
649,Ernest Van Dijckkaai,2023-06-24,04:00:00,63,21,42,FMN 01 Ernest Van Dijckkaai
649,Ernest Van Dijckkaai,2023-06-24,05:00:00,46,17,29,FMN 01 Ernest Van Dijckkaai
649,Ernest Van Dijckkaai,2023-06-24,06:00:00,70,28,42,FMN 01 Ernest Van Dijckkaai
649,Ernest Van Dijckkaai,2023-06-24,07:00:00,57,27,30,FMN 01 Ernest Van Dijckkaai
649,Ernest Van Dijckkaai,2023-06-24,08:00:00,143,63,80,FMN 01 Ernest Van Dijckkaai
649,Ernest Van Dijckkaai,2023-06-24,09:00:00,261,148,113,FMN 01 Ernest Van Dijckkaai
649,Ernest Van Dijckkaai,2023-06-24,10:00:00,311,177,134,FMN 01 Ernest Van Dijckkaai
649,Ernest Van Dijckkaai,2023-06-24,11:00:00,370,191,179,FMN 01 Ernest Van Dijckkaai
649,Ernest Van Dijckkaai,2023-06-24,12:00:00,485,242,243,FMN 01 Ernest Van Dijckkaai
649,Ernest Van Dijckkaai,2023-06-24,13:00:00,666,308,358,FMN 01 Ernest Van Dijckkaai
649,Ernest Van Dijckkaai,2023-06-24,14:00:00,659,302,357,FMN 01 Ernest Van Dijckkaai
649,Ernest Van Dijckkaai,2023-06-24,15:00:00,666,333,333,FMN 01 Ernest Van Dijckkaai
649,Ernest Van Dijckkaai,2023-06-24,16:00:00,605,278,327,FMN 01 Ernest Van Dijckkaai
649,Ernest Van Dijckkaai,2023-06-24,17:00:00,543,260,283,FMN 01 Ernest Van Dijckkaai
649,Ernest Van Dijckkaai,2023-06-24,18:00:00,473,254,219,FMN 01 Ernest Van Dijckkaai
649,Ernest Van Dijckkaai,2023-06-24,19:00:00,519,254,265,FMN 01 Ernest Van Dijckkaai
649,Ernest Van Dijckkaai,2023-06-24,20:00:00,399,184,215,FMN 01 Ernest Van Dijckkaai
649,Ernest Van Dijckkaai,2023-06-24,21:00:00,403,182,221,FMN 01 Ernest Van Dijckkaai
649,Ernest Van Dijckkaai,2023-06-24,22:00:00,366,159,207,FMN 01 Ernest Van Dijckkaai
649,Ernest Van Dijckkaai,2023-06-24,23:00:00,374,177,197,FMN 01 Ernest Van Dijckkaai
649,Ernest Van Dijckkaai,2023-06-25,00:00:00,349,237,112,FMN 01 Ernest Van Dijckkaai
649,Ernest Van Dijckkaai,2023-06-25,01:00:00,294,207,87,FMN 01 Ernest Van Dijckkaai
649,Ernest Van Dijckkaai,2023-06-25,02:00:00,132,65,67,FMN 01 Ernest Van Dijckkaai
649,Ernest Van Dijckkaai,2023-06-25,03:00:00,96,29,67,FMN 01 Ernest Van Dijckkaai
649,Ernest Van Dijckkaai,2023-06-25,04:00:00,68,34,34,FMN 01 Ernest Van Dijckkaai
649,Ernest Van Dijckkaai,2023-06-25,05:00:00,56,17,39,FMN 01 Ernest Van Dijckkaai
649,Ernest Van Dijckkaai,2023-06-25,06:00:00,55,26,29,FMN 01 Ernest Van Dijckkaai
649,Ernest Van Dijckkaai,2023-06-25,07:00:00,72,26,46,FMN 01 Ernest Van Dijckkaai
649,Ernest Van Dijckkaai,2023-06-25,08:00:00,141,66,75,FMN 01 Ernest Van Dijckkaai
649,Ernest Van Dijckkaai,2023-06-25,09:00:00,285,165,120,FMN 01 Ernest Van Dijckkaai
649,Ernest Van Dijckkaai,2023-06-25,10:00:00,355,171,184,FMN 01 Ernest Van Dijckkaai
649,Ernest Van Dijckkaai,2023-06-25,11:00:00,369,191,178,FMN 01 Ernest Van Dijckkaai
649,Ernest Van Dijckkaai,2023-06-25,12:00:00,466,242,224,FMN 01 Ernest Van Dijckkaai
649,Ernest Van Dijckkaai,2023-06-25,13:00:00,580,296,284,FMN 01 Ernest Van Dijckkaai
649,Ernest Van Dijckkaai,2023-06-25,14:00:00,713,394,319,FMN 01 Ernest Van Dijckkaai
649,Ernest Van Dijckkaai,2023-06-25,15:00:00,560,238,322,FMN 01 Ernest Van Dijckkaai
649,Ernest Van Dijckkaai,2023-06-25,16:00:00,576,268,308,FMN 01 Ernest Van Dijckkaai
649,Ernest Van Dijckkaai,2023-06-25,17:00:00,485,216,269,FMN 01 Ernest Van Dijckkaai
649,Ernest Van Dijckkaai,2023-06-25,18:00:00,469,197,272,FMN 01 Ernest Van Dijckkaai
649,Ernest Van Dijckkaai,2023-06-25,19:00:00,359,171,188,FMN 01 Ernest Van Dijckkaai
649,Ernest Van Dijckkaai,2023-06-25,20:00:00,323,164,159,FMN 01 Ernest Van Dijckkaai
649,Ernest Van Dijckkaai,2023-06-25,21:00:00,315,163,152,FMN 01 Ernest Van Dijckkaai
649,Ernest Van Dijckkaai,2023-06-25,22:00:00,305,145,160,FMN 01 Ernest Van Dijckkaai
649,Ernest Van Dijckkaai,2023-06-25,23:00:00,206,110,96,FMN 01 Ernest Van Dijckkaai
649,Ernest Van Dijckkaai,2023-06-26,00:00:00,155,101,54,FMN 01 Ernest Van Dijckkaai
649,Ernest Van Dijckkaai,2023-06-26,01:00:00,162,139,23,FMN 01 Ernest Van Dijckkaai
649,Ernest Van Dijckkaai,2023-06-26,02:00:00,33,10,23,FMN 01 Ernest Van Dijckkaai
649,Ernest Van Dijckkaai,2023-06-26,03:00:00,25,9,16,FMN 01 Ernest Van Dijckkaai
649,Ernest Van Dijckkaai,2023-06-26,04:00:00,51,31,20,FMN 01 Ernest Van Dijckkaai
649,Ernest Van Dijckkaai,2023-06-26,05:00:00,131,78,53,FMN 01 Ernest Van Dijckkaai
649,Ernest Van Dijckkaai,2023-06-26,06:00:00,263,158,105,FMN 01 Ernest Van Dijckkaai
649,Ernest Van Dijckkaai,2023-06-26,07:00:00,468,301,167,FMN 01 Ernest Van Dijckkaai
649,Ernest Van Dijckkaai,2023-06-26,08:00:00,582,349,233,FMN 01 Ernest Van Dijckkaai
649,Ernest Van Dijckkaai,2023-06-26,09:00:00,284,176,108,FMN 01 Ernest Van Dijckkaai
649,Ernest Van Dijckkaai,2023-06-26,10:00:00,247,121,126,FMN 01 Ernest Van Dijckkaai
649,Ernest Van Dijckkaai,2023-06-26,11:00:00,289,177,112,FMN 01 Ernest Van Dijckkaai
649,Ernest Van Dijckkaai,2023-06-26,12:00:00,389,214,175,FMN 01 Ernest Van Dijckkaai
649,Ernest Van Dijckkaai,2023-06-26,13:00:00,320,178,142,FMN 01 Ernest Van Dijckkaai
649,Ernest Van Dijckkaai,2023-06-26,14:00:00,393,183,210,FMN 01 Ernest Van Dijckkaai
649,Ernest Van Dijckkaai,2023-06-26,15:00:00,443,200,243,FMN 01 Ernest Van Dijckkaai
649,Ernest Van Dijckkaai,2023-06-26,16:00:00,708,274,434,FMN 01 Ernest Van Dijckkaai
649,Ernest Van Dijckkaai,2023-06-26,17:00:00,734,292,442,FMN 01 Ernest Van Dijckkaai
649,Ernest Van Dijckkaai,2023-06-26,18:00:00,509,222,287,FMN 01 Ernest Van Dijckkaai
649,Ernest Van Dijckkaai,2023-06-26,19:00:00,315,165,150,FMN 01 Ernest Van Dijckkaai
649,Ernest Van Dijckkaai,2023-06-26,20:00:00,321,135,186,FMN 01 Ernest Van Dijckkaai
649,Ernest Van Dijckkaai,2023-06-26,21:00:00,245,118,127,FMN 01 Ernest Van Dijckkaai
649,Ernest Van Dijckkaai,2023-06-26,22:00:00,273,125,148,FMN 01 Ernest Van Dijckkaai
649,Ernest Van Dijckkaai,2023-06-26,23:00:00,122,46,76,FMN 01 Ernest Van Dijckkaai
649,Ernest Van Dijckkaai,2023-06-27,00:00:00,63,20,43,FMN 01 Ernest Van Dijckkaai
649,Ernest Van Dijckkaai,2023-06-27,01:00:00,41,25,16,FMN 01 Ernest Van Dijckkaai
649,Ernest Van Dijckkaai,2023-06-27,02:00:00,21,6,15,FMN 01 Ernest Van Dijckkaai
649,Ernest Van Dijckkaai,2023-06-27,03:00:00,40,5,35,FMN 01 Ernest Van Dijckkaai
649,Ernest Van Dijckkaai,2023-06-27,04:00:00,60,31,29,FMN 01 Ernest Van Dijckkaai
649,Ernest Van Dijckkaai,2023-06-27,05:00:00,149,88,61,FMN 01 Ernest Van Dijckkaai
649,Ernest Van Dijckkaai,2023-06-27,06:00:00,298,174,124,FMN 01 Ernest Van Dijckkaai
649,Ernest Van Dijckkaai,2023-06-27,07:00:00,540,326,214,FMN 01 Ernest Van Dijckkaai
649,Ernest Van Dijckkaai,2023-06-27,08:00:00,662,385,277,FMN 01 Ernest Van Dijckkaai
649,Ernest Van Dijckkaai,2023-06-27,09:00:00,429,287,142,FMN 01 Ernest Van Dijckkaai
649,Ernest Van Dijckkaai,2023-06-27,10:00:00,255,118,137,FMN 01 Ernest Van Dijckkaai
649,Ernest Van Dijckkaai,2023-06-27,11:00:00,286,150,136,FMN 01 Ernest Van Dijckkaai
649,Ernest Van Dijckkaai,2023-06-27,12:00:00,369,221,148,FMN 01 Ernest Van Dijckkaai
649,Ernest Van Dijckkaai,2023-06-27,13:00:00,376,205,171,FMN 01 Ernest Van Dijckkaai
649,Ernest Van Dijckkaai,2023-06-27,14:00:00,436,209,227,FMN 01 Ernest Van Dijckkaai
649,Ernest Van Dijckkaai,2023-06-27,15:00:00,527,266,261,FMN 01 Ernest Van Dijckkaai
649,Ernest Van Dijckkaai,2023-06-27,16:00:00,779,331,448,FMN 01 Ernest Van Dijckkaai
649,Ernest Van Dijckkaai,2023-06-27,17:00:00,852,397,455,FMN 01 Ernest Van Dijckkaai
649,Ernest Van Dijckkaai,2023-06-27,18:00:00,565,282,283,FMN 01 Ernest Van Dijckkaai
649,Ernest Van Dijckkaai,2023-06-27,19:00:00,358,173,185,FMN 01 Ernest Van Dijckkaai
649,Ernest Van Dijckkaai,2023-06-27,20:00:00,264,129,135,FMN 01 Ernest Van Dijckkaai
649,Ernest Van Dijckkaai,2023-06-27,21:00:00,245,115,130,FMN 01 Ernest Van Dijckkaai
649,Ernest Van Dijckkaai,2023-06-27,22:00:00,272,99,173,FMN 01 Ernest Van Dijckkaai
649,Ernest Van Dijckkaai,2023-06-27,23:00:00,194,72,122,FMN 01 Ernest Van Dijckkaai
649,Ernest Van Dijckkaai,2023-06-28,00:00:00,73,17,56,FMN 01 Ernest Van Dijckkaai
649,Ernest Van Dijckkaai,2023-06-28,01:00:00,34,9,25,FMN 01 Ernest Van Dijckkaai
649,Ernest Van Dijckkaai,2023-06-28,02:00:00,26,6,20,FMN 01 Ernest Van Dijckkaai
649,Ernest Van Dijckkaai,2023-06-28,03:00:00,13,5,8,FMN 01 Ernest Van Dijckkaai
649,Ernest Van Dijckkaai,2023-06-28,04:00:00,51,31,20,FMN 01 Ernest Van Dijckkaai
649,Ernest Van Dijckkaai,2023-06-28,05:00:00,131,78,53,FMN 01 Ernest Van Dijckkaai
649,Ernest Van Dijckkaai,2023-06-28,06:00:00,259,160,99,FMN 01 Ernest Van Dijckkaai
649,Ernest Van Dijckkaai,2023-06-28,07:00:00,405,246,159,FMN 01 Ernest Van Dijckkaai
649,Ernest Van Dijckkaai,2023-06-28,08:00:00,556,340,216,FMN 01 Ernest Van Dijckkaai
649,Ernest Van Dijckkaai,2023-06-28,09:00:00,292,157,135,FMN 01 Ernest Van Dijckkaai
649,Ernest Van Dijckkaai,2023-06-28,10:00:00,224,122,102,FMN 01 Ernest Van Dijckkaai
649,Ernest Van Dijckkaai,2023-06-28,11:00:00,269,130,139,FMN 01 Ernest Van Dijckkaai
649,Ernest Van Dijckkaai,2023-06-28,12:00:00,388,198,190,FMN 01 Ernest Van Dijckkaai
649,Ernest Van Dijckkaai,2023-06-28,13:00:00,364,194,170,FMN 01 Ernest Van Dijckkaai
649,Ernest Van Dijckkaai,2023-06-28,14:00:00,450,209,241,FMN 01 Ernest Van Dijckkaai
649,Ernest Van Dijckkaai,2023-06-28,15:00:00,457,250,207,FMN 01 Ernest Van Dijckkaai
649,Ernest Van Dijckkaai,2023-06-28,16:00:00,641,287,354,FMN 01 Ernest Van Dijckkaai
649,Ernest Van Dijckkaai,2023-06-28,17:00:00,690,289,401,FMN 01 Ernest Van Dijckkaai
649,Ernest Van Dijckkaai,2023-06-28,18:00:00,514,276,238,FMN 01 Ernest Van Dijckkaai
649,Ernest Van Dijckkaai,2023-06-28,19:00:00,358,202,156,FMN 01 Ernest Van Dijckkaai
649,Ernest Van Dijckkaai,2023-06-28,20:00:00,299,140,159,FMN 01 Ernest Van Dijckkaai
649,Ernest Van Dijckkaai,2023-06-28,21:00:00,260,111,149,FMN 01 Ernest Van Dijckkaai
649,Ernest Van Dijckkaai,2023-06-28,22:00:00,274,117,157,FMN 01 Ernest Van Dijckkaai
649,Ernest Van Dijckkaai,2023-06-28,23:00:00,211,63,148,FMN 01 Ernest Van Dijckkaai
649,Ernest Van Dijckkaai,2023-06-29,00:00:00,138,31,107,FMN 01 Ernest Van Dijckkaai
649,Ernest Van Dijckkaai,2023-06-29,01:00:00,61,16,45,FMN 01 Ernest Van Dijckkaai
649,Ernest Van Dijckkaai,2023-06-29,02:00:00,38,24,14,FMN 01 Ernest Van Dijckkaai
649,Ernest Van Dijckkaai,2023-06-29,03:00:00,34,20,14,FMN 01 Ernest Van Dijckkaai
649,Ernest Van Dijckkaai,2023-06-29,04:00:00,73,42,31,FMN 01 Ernest Van Dijckkaai
649,Ernest Van Dijckkaai,2023-06-29,05:00:00,148,86,62,FMN 01 Ernest Van Dijckkaai
649,Ernest Van Dijckkaai,2023-06-29,06:00:00,222,131,91,FMN 01 Ernest Van Dijckkaai
649,Ernest Van Dijckkaai,2023-06-29,07:00:00,400,244,156,FMN 01 Ernest Van Dijckkaai
649,Ernest Van Dijckkaai,2023-06-29,08:00:00,596,346,250,FMN 01 Ernest Van Dijckkaai
649,Ernest Van Dijckkaai,2023-06-29,09:00:00,418,253,165,FMN 01 Ernest Van Dijckkaai
649,Ernest Van Dijckkaai,2023-06-29,10:00:00,239,135,104,FMN 01 Ernest Van Dijckkaai
649,Ernest Van Dijckkaai,2023-06-29,11:00:00,235,127,108,FMN 01 Ernest Van Dijckkaai
649,Ernest Van Dijckkaai,2023-06-29,12:00:00,361,188,173,FMN 01 Ernest Van Dijckkaai
649,Ernest Van Dijckkaai,2023-06-29,13:00:00,358,195,163,FMN 01 Ernest Van Dijckkaai
649,Ernest Van Dijckkaai,2023-06-29,14:00:00,456,216,240,FMN 01 Ernest Van Dijckkaai
649,Ernest Van Dijckkaai,2023-06-29,15:00:00,405,204,201,FMN 01 Ernest Van Dijckkaai
649,Ernest Van Dijckkaai,2023-06-29,16:00:00,594,277,317,FMN 01 Ernest Van Dijckkaai
649,Ernest Van Dijckkaai,2023-06-29,17:00:00,578,240,338,FMN 01 Ernest Van Dijckkaai
649,Ernest Van Dijckkaai,2023-06-29,18:00:00,414,192,222,FMN 01 Ernest Van Dijckkaai
649,Ernest Van Dijckkaai,2023-06-29,19:00:00,322,139,183,FMN 01 Ernest Van Dijckkaai
649,Ernest Van Dijckkaai,2023-06-29,20:00:00,190,83,107,FMN 01 Ernest Van Dijckkaai
649,Ernest Van Dijckkaai,2023-06-29,21:00:00,182,89,93,FMN 01 Ernest Van Dijckkaai
649,Ernest Van Dijckkaai,2023-06-29,22:00:00,215,90,125,FMN 01 Ernest Van Dijckkaai
649,Ernest Van Dijckkaai,2023-06-29,23:00:00,138,71,67,FMN 01 Ernest Van Dijckkaai
649,Ernest Van Dijckkaai,2023-06-30,00:00:00,84,38,46,FMN 01 Ernest Van Dijckkaai
649,Ernest Van Dijckkaai,2023-06-30,01:00:00,45,17,28,FMN 01 Ernest Van Dijckkaai
649,Ernest Van Dijckkaai,2023-06-30,02:00:00,35,6,29,FMN 01 Ernest Van Dijckkaai
649,Ernest Van Dijckkaai,2023-06-30,03:00:00,45,3,42,FMN 01 Ernest Van Dijckkaai
649,Ernest Van Dijckkaai,2023-06-30,04:00:00,58,35,23,FMN 01 Ernest Van Dijckkaai
649,Ernest Van Dijckkaai,2023-06-30,05:00:00,117,67,50,FMN 01 Ernest Van Dijckkaai
649,Ernest Van Dijckkaai,2023-06-30,06:00:00,231,137,94,FMN 01 Ernest Van Dijckkaai
649,Ernest Van Dijckkaai,2023-06-30,07:00:00,333,199,134,FMN 01 Ernest Van Dijckkaai
649,Ernest Van Dijckkaai,2023-06-30,08:00:00,450,247,203,FMN 01 Ernest Van Dijckkaai
649,Ernest Van Dijckkaai,2023-06-30,09:00:00,345,210,135,FMN 01 Ernest Van Dijckkaai
649,Ernest Van Dijckkaai,2023-06-30,10:00:00,273,134,139,FMN 01 Ernest Van Dijckkaai
649,Ernest Van Dijckkaai,2023-06-30,11:00:00,304,170,134,FMN 01 Ernest Van Dijckkaai
649,Ernest Van Dijckkaai,2023-06-30,12:00:00,374,201,173,FMN 01 Ernest Van Dijckkaai
649,Ernest Van Dijckkaai,2023-06-30,13:00:00,350,183,167,FMN 01 Ernest Van Dijckkaai
649,Ernest Van Dijckkaai,2023-06-30,14:00:00,481,217,264,FMN 01 Ernest Van Dijckkaai
649,Ernest Van Dijckkaai,2023-06-30,15:00:00,519,247,272,FMN 01 Ernest Van Dijckkaai
649,Ernest Van Dijckkaai,2023-06-30,16:00:00,614,243,371,FMN 01 Ernest Van Dijckkaai
649,Ernest Van Dijckkaai,2023-06-30,17:00:00,565,292,273,FMN 01 Ernest Van Dijckkaai
649,Ernest Van Dijckkaai,2023-06-30,18:00:00,445,204,241,FMN 01 Ernest Van Dijckkaai
649,Ernest Van Dijckkaai,2023-06-30,19:00:00,341,165,176,FMN 01 Ernest Van Dijckkaai
649,Ernest Van Dijckkaai,2023-06-30,20:00:00,309,154,155,FMN 01 Ernest Van Dijckkaai
649,Ernest Van Dijckkaai,2023-06-30,21:00:00,286,150,136,FMN 01 Ernest Van Dijckkaai
649,Ernest Van Dijckkaai,2023-06-30,22:00:00,300,125,175,FMN 01 Ernest Van Dijckkaai
649,Ernest Van Dijckkaai,2023-06-30,23:00:00,209,93,116,FMN 01 Ernest Van Dijckkaai
649,Ernest Van Dijckkaai,2023-07-01,00:00:00,134,58,76,FMN 01 Ernest Van Dijckkaai
649,Ernest Van Dijckkaai,2023-07-01,01:00:00,104,49,55,FMN 01 Ernest Van Dijckkaai
649,Ernest Van Dijckkaai,2023-07-01,02:00:00,64,21,43,FMN 01 Ernest Van Dijckkaai
649,Ernest Van Dijckkaai,2023-07-01,03:00:00,54,14,40,FMN 01 Ernest Van Dijckkaai
649,Ernest Van Dijckkaai,2023-07-01,04:00:00,38,13,25,FMN 01 Ernest Van Dijckkaai
649,Ernest Van Dijckkaai,2023-07-01,05:00:00,32,17,15,FMN 01 Ernest Van Dijckkaai
649,Ernest Van Dijckkaai,2023-07-01,06:00:00,58,35,23,FMN 01 Ernest Van Dijckkaai
649,Ernest Van Dijckkaai,2023-07-01,07:00:00,38,19,19,FMN 01 Ernest Van Dijckkaai
649,Ernest Van Dijckkaai,2023-07-01,08:00:00,56,34,22,FMN 01 Ernest Van Dijckkaai
649,Ernest Van Dijckkaai,2023-07-01,09:00:00,118,52,66,FMN 01 Ernest Van Dijckkaai
649,Ernest Van Dijckkaai,2023-07-01,10:00:00,141,75,66,FMN 01 Ernest Van Dijckkaai
649,Ernest Van Dijckkaai,2023-07-01,11:00:00,118,69,49,FMN 01 Ernest Van Dijckkaai
649,Ernest Van Dijckkaai,2023-07-01,12:00:00,138,66,72,FMN 01 Ernest Van Dijckkaai
649,Ernest Van Dijckkaai,2023-07-01,13:00:00,175,81,94,FMN 01 Ernest Van Dijckkaai
649,Ernest Van Dijckkaai,2023-07-01,14:00:00,156,77,79,FMN 01 Ernest Van Dijckkaai
649,Ernest Van Dijckkaai,2023-07-01,15:00:00,191,93,98,FMN 01 Ernest Van Dijckkaai
649,Ernest Van Dijckkaai,2023-07-01,16:00:00,209,107,102,FMN 01 Ernest Van Dijckkaai
649,Ernest Van Dijckkaai,2023-07-01,17:00:00,166,90,76,FMN 01 Ernest Van Dijckkaai
649,Ernest Van Dijckkaai,2023-07-01,18:00:00,243,145,98,FMN 01 Ernest Van Dijckkaai
649,Ernest Van Dijckkaai,2023-07-01,19:00:00,155,81,74,FMN 01 Ernest Van Dijckkaai
649,Ernest Van Dijckkaai,2023-07-01,20:00:00,204,115,89,FMN 01 Ernest Van Dijckkaai
649,Ernest Van Dijckkaai,2023-07-01,21:00:00,155,74,81,FMN 01 Ernest Van Dijckkaai
649,Ernest Van Dijckkaai,2023-07-01,22:00:00,164,75,89,FMN 01 Ernest Van Dijckkaai
649,Ernest Van Dijckkaai,2023-07-01,23:00:00,136,65,71,FMN 01 Ernest Van Dijckkaai
649,Ernest Van Dijckkaai,2023-07-02,00:00:00,132,66,66,FMN 01 Ernest Van Dijckkaai
649,Ernest Van Dijckkaai,2023-07-02,01:00:00,58,19,39,FMN 01 Ernest Van Dijckkaai
649,Ernest Van Dijckkaai,2023-07-02,02:00:00,67,19,48,FMN 01 Ernest Van Dijckkaai
649,Ernest Van Dijckkaai,2023-07-02,03:00:00,39,13,26,FMN 01 Ernest Van Dijckkaai
649,Ernest Van Dijckkaai,2023-07-02,04:00:00,48,21,27,FMN 01 Ernest Van Dijckkaai
649,Ernest Van Dijckkaai,2023-07-02,05:00:00,26,16,10,FMN 01 Ernest Van Dijckkaai
649,Ernest Van Dijckkaai,2023-07-02,06:00:00,37,19,18,FMN 01 Ernest Van Dijckkaai
649,Ernest Van Dijckkaai,2023-07-02,07:00:00,44,16,28,FMN 01 Ernest Van Dijckkaai
649,Ernest Van Dijckkaai,2023-07-02,08:00:00,103,61,42,FMN 01 Ernest Van Dijckkaai
649,Ernest Van Dijckkaai,2023-07-02,09:00:00,184,130,54,FMN 01 Ernest Van Dijckkaai
649,Ernest Van Dijckkaai,2023-07-02,10:00:00,275,140,135,FMN 01 Ernest Van Dijckkaai
649,Ernest Van Dijckkaai,2023-07-02,11:00:00,358,208,150,FMN 01 Ernest Van Dijckkaai
649,Ernest Van Dijckkaai,2023-07-02,12:00:00,395,232,163,FMN 01 Ernest Van Dijckkaai
649,Ernest Van Dijckkaai,2023-07-02,13:00:00,444,250,194,FMN 01 Ernest Van Dijckkaai
649,Ernest Van Dijckkaai,2023-07-02,14:00:00,521,259,262,FMN 01 Ernest Van Dijckkaai
649,Ernest Van Dijckkaai,2023-07-02,15:00:00,504,280,224,FMN 01 Ernest Van Dijckkaai
649,Ernest Van Dijckkaai,2023-07-02,16:00:00,509,247,262,FMN 01 Ernest Van Dijckkaai
649,Ernest Van Dijckkaai,2023-07-02,17:00:00,403,168,235,FMN 01 Ernest Van Dijckkaai
649,Ernest Van Dijckkaai,2023-07-02,18:00:00,356,151,205,FMN 01 Ernest Van Dijckkaai
649,Ernest Van Dijckkaai,2023-07-02,19:00:00,340,161,179,FMN 01 Ernest Van Dijckkaai
649,Ernest Van Dijckkaai,2023-07-02,20:00:00,228,123,105,FMN 01 Ernest Van Dijckkaai
649,Ernest Van Dijckkaai,2023-07-02,21:00:00,185,89,96,FMN 01 Ernest Van Dijckkaai
649,Ernest Van Dijckkaai,2023-07-02,22:00:00,144,47,97,FMN 01 Ernest Van Dijckkaai
649,Ernest Van Dijckkaai,2023-07-02,23:00:00,98,30,68,FMN 01 Ernest Van Dijckkaai
649,Ernest Van Dijckkaai,2023-07-03,00:00:00,41,17,24,FMN 01 Ernest Van Dijckkaai
649,Ernest Van Dijckkaai,2023-07-03,01:00:00,21,6,15,FMN 01 Ernest Van Dijckkaai
649,Ernest Van Dijckkaai,2023-07-03,02:00:00,10,3,7,FMN 01 Ernest Van Dijckkaai
649,Ernest Van Dijckkaai,2023-07-03,03:00:00,10,5,5,FMN 01 Ernest Van Dijckkaai
649,Ernest Van Dijckkaai,2023-07-03,04:00:00,58,36,22,FMN 01 Ernest Van Dijckkaai
649,Ernest Van Dijckkaai,2023-07-03,05:00:00,120,70,50,FMN 01 Ernest Van Dijckkaai
649,Ernest Van Dijckkaai,2023-07-03,06:00:00,251,160,91,FMN 01 Ernest Van Dijckkaai
649,Ernest Van Dijckkaai,2023-07-03,07:00:00,382,230,152,FMN 01 Ernest Van Dijckkaai
649,Ernest Van Dijckkaai,2023-07-03,08:00:00,471,269,202,FMN 01 Ernest Van Dijckkaai
649,Ernest Van Dijckkaai,2023-07-03,09:00:00,252,150,102,FMN 01 Ernest Van Dijckkaai
649,Ernest Van Dijckkaai,2023-07-03,10:00:00,174,106,68,FMN 01 Ernest Van Dijckkaai
649,Ernest Van Dijckkaai,2023-07-03,11:00:00,238,148,90,FMN 01 Ernest Van Dijckkaai
649,Ernest Van Dijckkaai,2023-07-03,12:00:00,247,132,115,FMN 01 Ernest Van Dijckkaai
649,Ernest Van Dijckkaai,2023-07-03,13:00:00,276,147,129,FMN 01 Ernest Van Dijckkaai
649,Ernest Van Dijckkaai,2023-07-03,14:00:00,326,145,181,FMN 01 Ernest Van Dijckkaai
649,Ernest Van Dijckkaai,2023-07-03,15:00:00,338,162,176,FMN 01 Ernest Van Dijckkaai
649,Ernest Van Dijckkaai,2023-07-03,16:00:00,518,202,316,FMN 01 Ernest Van Dijckkaai
649,Ernest Van Dijckkaai,2023-07-03,17:00:00,671,280,391,FMN 01 Ernest Van Dijckkaai
649,Ernest Van Dijckkaai,2023-07-03,18:00:00,421,194,227,FMN 01 Ernest Van Dijckkaai
649,Ernest Van Dijckkaai,2023-07-03,19:00:00,229,114,115,FMN 01 Ernest Van Dijckkaai
649,Ernest Van Dijckkaai,2023-07-03,20:00:00,198,100,98,FMN 01 Ernest Van Dijckkaai
649,Ernest Van Dijckkaai,2023-07-03,21:00:00,180,88,92,FMN 01 Ernest Van Dijckkaai
649,Ernest Van Dijckkaai,2023-07-03,22:00:00,142,61,81,FMN 01 Ernest Van Dijckkaai
649,Ernest Van Dijckkaai,2023-07-03,23:00:00,77,27,50,FMN 01 Ernest Van Dijckkaai
649,Ernest Van Dijckkaai,2023-07-04,00:00:00,37,17,20,FMN 01 Ernest Van Dijckkaai
649,Ernest Van Dijckkaai,2023-07-04,01:00:00,21,9,12,FMN 01 Ernest Van Dijckkaai
649,Ernest Van Dijckkaai,2023-07-04,02:00:00,14,4,10,FMN 01 Ernest Van Dijckkaai
649,Ernest Van Dijckkaai,2023-07-04,03:00:00,13,4,9,FMN 01 Ernest Van Dijckkaai
649,Ernest Van Dijckkaai,2023-07-04,04:00:00,72,50,22,FMN 01 Ernest Van Dijckkaai
649,Ernest Van Dijckkaai,2023-07-04,05:00:00,130,75,55,FMN 01 Ernest Van Dijckkaai
649,Ernest Van Dijckkaai,2023-07-04,06:00:00,270,170,100,FMN 01 Ernest Van Dijckkaai
649,Ernest Van Dijckkaai,2023-07-04,07:00:00,411,254,157,FMN 01 Ernest Van Dijckkaai
649,Ernest Van Dijckkaai,2023-07-04,08:00:00,521,287,234,FMN 01 Ernest Van Dijckkaai
649,Ernest Van Dijckkaai,2023-07-04,09:00:00,300,191,109,FMN 01 Ernest Van Dijckkaai
649,Ernest Van Dijckkaai,2023-07-04,10:00:00,206,114,92,FMN 01 Ernest Van Dijckkaai
649,Ernest Van Dijckkaai,2023-07-04,11:00:00,209,116,93,FMN 01 Ernest Van Dijckkaai
649,Ernest Van Dijckkaai,2023-07-04,12:00:00,276,163,113,FMN 01 Ernest Van Dijckkaai
649,Ernest Van Dijckkaai,2023-07-04,13:00:00,296,145,151,FMN 01 Ernest Van Dijckkaai
649,Ernest Van Dijckkaai,2023-07-04,14:00:00,320,163,157,FMN 01 Ernest Van Dijckkaai
649,Ernest Van Dijckkaai,2023-07-04,15:00:00,395,183,212,FMN 01 Ernest Van Dijckkaai
649,Ernest Van Dijckkaai,2023-07-04,16:00:00,617,251,366,FMN 01 Ernest Van Dijckkaai
649,Ernest Van Dijckkaai,2023-07-04,17:00:00,717,322,395,FMN 01 Ernest Van Dijckkaai
649,Ernest Van Dijckkaai,2023-07-04,18:00:00,452,215,237,FMN 01 Ernest Van Dijckkaai
649,Ernest Van Dijckkaai,2023-07-04,19:00:00,206,95,111,FMN 01 Ernest Van Dijckkaai
649,Ernest Van Dijckkaai,2023-07-04,20:00:00,197,90,107,FMN 01 Ernest Van Dijckkaai
649,Ernest Van Dijckkaai,2023-07-04,21:00:00,154,71,83,FMN 01 Ernest Van Dijckkaai
649,Ernest Van Dijckkaai,2023-07-04,22:00:00,155,40,115,FMN 01 Ernest Van Dijckkaai
649,Ernest Van Dijckkaai,2023-07-04,23:00:00,89,41,48,FMN 01 Ernest Van Dijckkaai
649,Ernest Van Dijckkaai,2023-07-05,00:00:00,54,21,33,FMN 01 Ernest Van Dijckkaai
649,Ernest Van Dijckkaai,2023-07-05,01:00:00,14,4,10,FMN 01 Ernest Van Dijckkaai
649,Ernest Van Dijckkaai,2023-07-05,02:00:00,7,0,7,FMN 01 Ernest Van Dijckkaai
649,Ernest Van Dijckkaai,2023-07-05,03:00:00,22,9,13,FMN 01 Ernest Van Dijckkaai
649,Ernest Van Dijckkaai,2023-07-05,04:00:00,59,33,26,FMN 01 Ernest Van Dijckkaai
649,Ernest Van Dijckkaai,2023-07-05,05:00:00,99,62,37,FMN 01 Ernest Van Dijckkaai
649,Ernest Van Dijckkaai,2023-07-05,06:00:00,183,108,75,FMN 01 Ernest Van Dijckkaai
649,Ernest Van Dijckkaai,2023-07-05,07:00:00,267,173,94,FMN 01 Ernest Van Dijckkaai
649,Ernest Van Dijckkaai,2023-07-05,08:00:00,330,201,129,FMN 01 Ernest Van Dijckkaai
649,Ernest Van Dijckkaai,2023-07-05,09:00:00,200,119,81,FMN 01 Ernest Van Dijckkaai
649,Ernest Van Dijckkaai,2023-07-05,10:00:00,126,73,53,FMN 01 Ernest Van Dijckkaai
649,Ernest Van Dijckkaai,2023-07-05,11:00:00,175,86,89,FMN 01 Ernest Van Dijckkaai
649,Ernest Van Dijckkaai,2023-07-05,12:00:00,219,116,103,FMN 01 Ernest Van Dijckkaai
649,Ernest Van Dijckkaai,2023-07-05,13:00:00,208,119,89,FMN 01 Ernest Van Dijckkaai
649,Ernest Van Dijckkaai,2023-07-05,14:00:00,229,101,128,FMN 01 Ernest Van Dijckkaai
649,Ernest Van Dijckkaai,2023-07-05,15:00:00,279,131,148,FMN 01 Ernest Van Dijckkaai
649,Ernest Van Dijckkaai,2023-07-05,16:00:00,463,193,270,FMN 01 Ernest Van Dijckkaai
649,Ernest Van Dijckkaai,2023-07-05,17:00:00,533,197,336,FMN 01 Ernest Van Dijckkaai
649,Ernest Van Dijckkaai,2023-07-05,18:00:00,255,116,139,FMN 01 Ernest Van Dijckkaai
649,Ernest Van Dijckkaai,2023-07-05,19:00:00,170,89,81,FMN 01 Ernest Van Dijckkaai
649,Ernest Van Dijckkaai,2023-07-05,20:00:00,143,75,68,FMN 01 Ernest Van Dijckkaai
649,Ernest Van Dijckkaai,2023-07-05,21:00:00,159,73,86,FMN 01 Ernest Van Dijckkaai
649,Ernest Van Dijckkaai,2023-07-05,22:00:00,164,57,107,FMN 01 Ernest Van Dijckkaai
649,Ernest Van Dijckkaai,2023-07-05,23:00:00,81,35,46,FMN 01 Ernest Van Dijckkaai
649,Ernest Van Dijckkaai,2023-07-06,00:00:00,37,16,21,FMN 01 Ernest Van Dijckkaai
649,Ernest Van Dijckkaai,2023-07-06,01:00:00,20,4,16,FMN 01 Ernest Van Dijckkaai
649,Ernest Van Dijckkaai,2023-07-06,02:00:00,7,2,5,FMN 01 Ernest Van Dijckkaai
649,Ernest Van Dijckkaai,2023-07-06,03:00:00,11,4,7,FMN 01 Ernest Van Dijckkaai
649,Ernest Van Dijckkaai,2023-07-06,04:00:00,54,34,20,FMN 01 Ernest Van Dijckkaai
649,Ernest Van Dijckkaai,2023-07-06,05:00:00,130,76,54,FMN 01 Ernest Van Dijckkaai
649,Ernest Van Dijckkaai,2023-07-06,06:00:00,231,141,90,FMN 01 Ernest Van Dijckkaai
649,Ernest Van Dijckkaai,2023-07-06,07:00:00,395,248,147,FMN 01 Ernest Van Dijckkaai
649,Ernest Van Dijckkaai,2023-07-06,08:00:00,494,274,220,FMN 01 Ernest Van Dijckkaai
649,Ernest Van Dijckkaai,2023-07-06,09:00:00,254,158,96,FMN 01 Ernest Van Dijckkaai
649,Ernest Van Dijckkaai,2023-07-06,10:00:00,240,120,120,FMN 01 Ernest Van Dijckkaai
649,Ernest Van Dijckkaai,2023-07-06,11:00:00,233,129,104,FMN 01 Ernest Van Dijckkaai
649,Ernest Van Dijckkaai,2023-07-06,12:00:00,324,167,157,FMN 01 Ernest Van Dijckkaai
649,Ernest Van Dijckkaai,2023-07-06,13:00:00,286,149,137,FMN 01 Ernest Van Dijckkaai
649,Ernest Van Dijckkaai,2023-07-06,14:00:00,378,184,194,FMN 01 Ernest Van Dijckkaai
649,Ernest Van Dijckkaai,2023-07-06,15:00:00,400,196,204,FMN 01 Ernest Van Dijckkaai
649,Ernest Van Dijckkaai,2023-07-06,16:00:00,605,281,324,FMN 01 Ernest Van Dijckkaai
649,Ernest Van Dijckkaai,2023-07-06,17:00:00,731,313,418,FMN 01 Ernest Van Dijckkaai
649,Ernest Van Dijckkaai,2023-07-06,18:00:00,525,263,262,FMN 01 Ernest Van Dijckkaai
649,Ernest Van Dijckkaai,2023-07-06,19:00:00,364,183,181,FMN 01 Ernest Van Dijckkaai
649,Ernest Van Dijckkaai,2023-07-06,20:00:00,298,150,148,FMN 01 Ernest Van Dijckkaai
649,Ernest Van Dijckkaai,2023-07-06,21:00:00,251,113,138,FMN 01 Ernest Van Dijckkaai
649,Ernest Van Dijckkaai,2023-07-06,22:00:00,251,80,171,FMN 01 Ernest Van Dijckkaai
649,Ernest Van Dijckkaai,2023-07-06,23:00:00,178,74,104,FMN 01 Ernest Van Dijckkaai
649,Ernest Van Dijckkaai,2023-07-07,00:00:00,101,45,56,FMN 01 Ernest Van Dijckkaai
649,Ernest Van Dijckkaai,2023-07-07,01:00:00,42,21,21,FMN 01 Ernest Van Dijckkaai
649,Ernest Van Dijckkaai,2023-07-07,02:00:00,36,19,17,FMN 01 Ernest Van Dijckkaai
649,Ernest Van Dijckkaai,2023-07-07,03:00:00,24,9,15,FMN 01 Ernest Van Dijckkaai
649,Ernest Van Dijckkaai,2023-07-07,04:00:00,62,29,33,FMN 01 Ernest Van Dijckkaai
649,Ernest Van Dijckkaai,2023-07-07,05:00:00,141,80,61,FMN 01 Ernest Van Dijckkaai
649,Ernest Van Dijckkaai,2023-07-07,06:00:00,228,127,101,FMN 01 Ernest Van Dijckkaai
649,Ernest Van Dijckkaai,2023-07-07,07:00:00,351,227,124,FMN 01 Ernest Van Dijckkaai
649,Ernest Van Dijckkaai,2023-07-07,08:00:00,423,230,193,FMN 01 Ernest Van Dijckkaai
649,Ernest Van Dijckkaai,2023-07-07,09:00:00,280,159,121,FMN 01 Ernest Van Dijckkaai
649,Ernest Van Dijckkaai,2023-07-07,10:00:00,273,155,118,FMN 01 Ernest Van Dijckkaai
649,Ernest Van Dijckkaai,2023-07-07,11:00:00,310,159,151,FMN 01 Ernest Van Dijckkaai
649,Ernest Van Dijckkaai,2023-07-07,12:00:00,425,232,193,FMN 01 Ernest Van Dijckkaai
649,Ernest Van Dijckkaai,2023-07-07,13:00:00,391,218,173,FMN 01 Ernest Van Dijckkaai
649,Ernest Van Dijckkaai,2023-07-07,14:00:00,464,211,253,FMN 01 Ernest Van Dijckkaai
649,Ernest Van Dijckkaai,2023-07-07,15:00:00,597,305,292,FMN 01 Ernest Van Dijckkaai
649,Ernest Van Dijckkaai,2023-07-07,16:00:00,710,289,421,FMN 01 Ernest Van Dijckkaai
649,Ernest Van Dijckkaai,2023-07-07,17:00:00,675,310,365,FMN 01 Ernest Van Dijckkaai
649,Ernest Van Dijckkaai,2023-07-07,18:00:00,503,260,243,FMN 01 Ernest Van Dijckkaai
649,Ernest Van Dijckkaai,2023-07-07,19:00:00,416,211,205,FMN 01 Ernest Van Dijckkaai
649,Ernest Van Dijckkaai,2023-07-07,20:00:00,409,216,193,FMN 01 Ernest Van Dijckkaai
649,Ernest Van Dijckkaai,2023-07-07,21:00:00,341,157,184,FMN 01 Ernest Van Dijckkaai
649,Ernest Van Dijckkaai,2023-07-07,22:00:00,378,158,220,FMN 01 Ernest Van Dijckkaai
649,Ernest Van Dijckkaai,2023-07-07,23:00:00,281,121,160,FMN 01 Ernest Van Dijckkaai
649,Ernest Van Dijckkaai,2023-07-08,00:00:00,205,86,119,FMN 01 Ernest Van Dijckkaai
649,Ernest Van Dijckkaai,2023-07-08,01:00:00,123,68,55,FMN 01 Ernest Van Dijckkaai
649,Ernest Van Dijckkaai,2023-07-08,02:00:00,106,36,70,FMN 01 Ernest Van Dijckkaai
649,Ernest Van Dijckkaai,2023-07-08,03:00:00,73,24,49,FMN 01 Ernest Van Dijckkaai
649,Ernest Van Dijckkaai,2023-07-08,04:00:00,45,12,33,FMN 01 Ernest Van Dijckkaai
649,Ernest Van Dijckkaai,2023-07-08,05:00:00,49,25,24,FMN 01 Ernest Van Dijckkaai
649,Ernest Van Dijckkaai,2023-07-08,06:00:00,63,23,40,FMN 01 Ernest Van Dijckkaai
649,Ernest Van Dijckkaai,2023-07-08,07:00:00,60,24,36,FMN 01 Ernest Van Dijckkaai
649,Ernest Van Dijckkaai,2023-07-08,08:00:00,115,49,66,FMN 01 Ernest Van Dijckkaai
649,Ernest Van Dijckkaai,2023-07-08,09:00:00,209,124,85,FMN 01 Ernest Van Dijckkaai
649,Ernest Van Dijckkaai,2023-07-08,10:00:00,337,198,139,FMN 01 Ernest Van Dijckkaai
649,Ernest Van Dijckkaai,2023-07-08,11:00:00,325,193,132,FMN 01 Ernest Van Dijckkaai
649,Ernest Van Dijckkaai,2023-07-08,12:00:00,435,205,230,FMN 01 Ernest Van Dijckkaai
649,Ernest Van Dijckkaai,2023-07-08,13:00:00,419,228,191,FMN 01 Ernest Van Dijckkaai
649,Ernest Van Dijckkaai,2023-07-08,14:00:00,442,236,206,FMN 01 Ernest Van Dijckkaai
649,Ernest Van Dijckkaai,2023-07-08,15:00:00,475,236,239,FMN 01 Ernest Van Dijckkaai
649,Ernest Van Dijckkaai,2023-07-08,16:00:00,388,186,202,FMN 01 Ernest Van Dijckkaai
649,Ernest Van Dijckkaai,2023-07-08,17:00:00,382,194,188,FMN 01 Ernest Van Dijckkaai
649,Ernest Van Dijckkaai,2023-07-08,18:00:00,338,171,167,FMN 01 Ernest Van Dijckkaai
649,Ernest Van Dijckkaai,2023-07-08,19:00:00,388,199,189,FMN 01 Ernest Van Dijckkaai
649,Ernest Van Dijckkaai,2023-07-08,20:00:00,356,203,153,FMN 01 Ernest Van Dijckkaai
649,Ernest Van Dijckkaai,2023-07-08,21:00:00,352,169,183,FMN 01 Ernest Van Dijckkaai
649,Ernest Van Dijckkaai,2023-07-08,22:00:00,360,180,180,FMN 01 Ernest Van Dijckkaai
649,Ernest Van Dijckkaai,2023-07-08,23:00:00,265,92,173,FMN 01 Ernest Van Dijckkaai
649,Ernest Van Dijckkaai,2023-07-09,00:00:00,191,84,107,FMN 01 Ernest Van Dijckkaai
649,Ernest Van Dijckkaai,2023-07-09,01:00:00,162,60,102,FMN 01 Ernest Van Dijckkaai
649,Ernest Van Dijckkaai,2023-07-09,02:00:00,109,37,72,FMN 01 Ernest Van Dijckkaai
649,Ernest Van Dijckkaai,2023-07-09,03:00:00,91,36,55,FMN 01 Ernest Van Dijckkaai
649,Ernest Van Dijckkaai,2023-07-09,04:00:00,80,18,62,FMN 01 Ernest Van Dijckkaai
649,Ernest Van Dijckkaai,2023-07-09,05:00:00,53,19,34,FMN 01 Ernest Van Dijckkaai
649,Ernest Van Dijckkaai,2023-07-09,06:00:00,49,24,25,FMN 01 Ernest Van Dijckkaai
649,Ernest Van Dijckkaai,2023-07-09,07:00:00,54,31,23,FMN 01 Ernest Van Dijckkaai
649,Ernest Van Dijckkaai,2023-07-09,08:00:00,105,53,52,FMN 01 Ernest Van Dijckkaai
649,Ernest Van Dijckkaai,2023-07-09,09:00:00,215,143,72,FMN 01 Ernest Van Dijckkaai
649,Ernest Van Dijckkaai,2023-07-09,10:00:00,340,171,169,FMN 01 Ernest Van Dijckkaai
649,Ernest Van Dijckkaai,2023-07-09,11:00:00,401,212,189,FMN 01 Ernest Van Dijckkaai
649,Ernest Van Dijckkaai,2023-07-09,12:00:00,366,210,156,FMN 01 Ernest Van Dijckkaai
649,Ernest Van Dijckkaai,2023-07-09,13:00:00,392,199,193,FMN 01 Ernest Van Dijckkaai
649,Ernest Van Dijckkaai,2023-07-09,14:00:00,363,179,184,FMN 01 Ernest Van Dijckkaai
649,Ernest Van Dijckkaai,2023-07-09,15:00:00,99,41,58,FMN 01 Ernest Van Dijckkaai
649,Ernest Van Dijckkaai,2023-07-09,16:00:00,213,91,122,FMN 01 Ernest Van Dijckkaai
649,Ernest Van Dijckkaai,2023-07-09,17:00:00,195,83,112,FMN 01 Ernest Van Dijckkaai
649,Ernest Van Dijckkaai,2023-07-09,18:00:00,198,89,109,FMN 01 Ernest Van Dijckkaai
649,Ernest Van Dijckkaai,2023-07-09,19:00:00,211,95,116,FMN 01 Ernest Van Dijckkaai
649,Ernest Van Dijckkaai,2023-07-09,20:00:00,237,97,140,FMN 01 Ernest Van Dijckkaai
649,Ernest Van Dijckkaai,2023-07-09,21:00:00,201,95,106,FMN 01 Ernest Van Dijckkaai
649,Ernest Van Dijckkaai,2023-07-09,22:00:00,130,66,64,FMN 01 Ernest Van Dijckkaai
649,Ernest Van Dijckkaai,2023-07-09,23:00:00,78,35,43,FMN 01 Ernest Van Dijckkaai
649,Ernest Van Dijckkaai,2023-07-10,00:00:00,62,24,38,FMN 01 Ernest Van Dijckkaai
649,Ernest Van Dijckkaai,2023-07-10,01:00:00,31,13,18,FMN 01 Ernest Van Dijckkaai
649,Ernest Van Dijckkaai,2023-07-10,02:00:00,17,5,12,FMN 01 Ernest Van Dijckkaai
649,Ernest Van Dijckkaai,2023-07-10,03:00:00,16,1,15,FMN 01 Ernest Van Dijckkaai
649,Ernest Van Dijckkaai,2023-07-10,04:00:00,69,39,30,FMN 01 Ernest Van Dijckkaai
649,Ernest Van Dijckkaai,2023-07-10,05:00:00,112,67,45,FMN 01 Ernest Van Dijckkaai
649,Ernest Van Dijckkaai,2023-07-10,06:00:00,241,166,75,FMN 01 Ernest Van Dijckkaai
649,Ernest Van Dijckkaai,2023-07-10,07:00:00,361,237,124,FMN 01 Ernest Van Dijckkaai
649,Ernest Van Dijckkaai,2023-07-10,08:00:00,403,232,171,FMN 01 Ernest Van Dijckkaai
649,Ernest Van Dijckkaai,2023-07-10,09:00:00,240,129,111,FMN 01 Ernest Van Dijckkaai
649,Ernest Van Dijckkaai,2023-07-10,10:00:00,292,155,137,FMN 01 Ernest Van Dijckkaai
649,Ernest Van Dijckkaai,2023-07-10,11:00:00,422,244,178,FMN 01 Ernest Van Dijckkaai
649,Ernest Van Dijckkaai,2023-07-10,12:00:00,336,182,154,FMN 01 Ernest Van Dijckkaai
649,Ernest Van Dijckkaai,2023-07-10,13:00:00,357,193,164,FMN 01 Ernest Van Dijckkaai
649,Ernest Van Dijckkaai,2023-07-10,14:00:00,420,220,200,FMN 01 Ernest Van Dijckkaai
649,Ernest Van Dijckkaai,2023-07-10,15:00:00,474,207,267,FMN 01 Ernest Van Dijckkaai
649,Ernest Van Dijckkaai,2023-07-10,16:00:00,625,265,360,FMN 01 Ernest Van Dijckkaai
649,Ernest Van Dijckkaai,2023-07-10,17:00:00,704,322,382,FMN 01 Ernest Van Dijckkaai
649,Ernest Van Dijckkaai,2023-07-10,18:00:00,503,238,265,FMN 01 Ernest Van Dijckkaai
649,Ernest Van Dijckkaai,2023-07-10,19:00:00,348,167,181,FMN 01 Ernest Van Dijckkaai
649,Ernest Van Dijckkaai,2023-07-10,20:00:00,354,143,211,FMN 01 Ernest Van Dijckkaai
649,Ernest Van Dijckkaai,2023-07-10,21:00:00,295,132,163,FMN 01 Ernest Van Dijckkaai
649,Ernest Van Dijckkaai,2023-07-10,22:00:00,269,105,164,FMN 01 Ernest Van Dijckkaai
649,Ernest Van Dijckkaai,2023-07-10,23:00:00,124,57,67,FMN 01 Ernest Van Dijckkaai
649,Ernest Van Dijckkaai,2023-07-11,00:00:00,47,17,30,FMN 01 Ernest Van Dijckkaai
649,Ernest Van Dijckkaai,2023-07-11,01:00:00,29,8,21,FMN 01 Ernest Van Dijckkaai
649,Ernest Van Dijckkaai,2023-07-11,02:00:00,16,6,10,FMN 01 Ernest Van Dijckkaai
649,Ernest Van Dijckkaai,2023-07-11,03:00:00,19,3,16,FMN 01 Ernest Van Dijckkaai
649,Ernest Van Dijckkaai,2023-07-11,04:00:00,63,35,28,FMN 01 Ernest Van Dijckkaai
649,Ernest Van Dijckkaai,2023-07-11,05:00:00,149,91,58,FMN 01 Ernest Van Dijckkaai
649,Ernest Van Dijckkaai,2023-07-11,06:00:00,280,193,87,FMN 01 Ernest Van Dijckkaai
649,Ernest Van Dijckkaai,2023-07-11,07:00:00,359,235,124,FMN 01 Ernest Van Dijckkaai
649,Ernest Van Dijckkaai,2023-07-11,08:00:00,418,271,147,FMN 01 Ernest Van Dijckkaai
649,Ernest Van Dijckkaai,2023-07-11,09:00:00,261,148,113,FMN 01 Ernest Van Dijckkaai
649,Ernest Van Dijckkaai,2023-07-11,10:00:00,250,140,110,FMN 01 Ernest Van Dijckkaai
649,Ernest Van Dijckkaai,2023-07-11,11:00:00,323,188,135,FMN 01 Ernest Van Dijckkaai
649,Ernest Van Dijckkaai,2023-07-11,12:00:00,405,198,207,FMN 01 Ernest Van Dijckkaai
649,Ernest Van Dijckkaai,2023-07-11,13:00:00,413,241,172,FMN 01 Ernest Van Dijckkaai
649,Ernest Van Dijckkaai,2023-07-11,14:00:00,496,253,243,FMN 01 Ernest Van Dijckkaai
649,Ernest Van Dijckkaai,2023-07-11,15:00:00,479,202,277,FMN 01 Ernest Van Dijckkaai
649,Ernest Van Dijckkaai,2023-07-11,16:00:00,651,249,402,FMN 01 Ernest Van Dijckkaai
649,Ernest Van Dijckkaai,2023-07-11,17:00:00,776,364,412,FMN 01 Ernest Van Dijckkaai
649,Ernest Van Dijckkaai,2023-07-11,18:00:00,592,319,273,FMN 01 Ernest Van Dijckkaai
649,Ernest Van Dijckkaai,2023-07-11,19:00:00,474,273,201,FMN 01 Ernest Van Dijckkaai
649,Ernest Van Dijckkaai,2023-07-11,20:00:00,470,258,212,FMN 01 Ernest Van Dijckkaai
649,Ernest Van Dijckkaai,2023-07-11,21:00:00,386,171,215,FMN 01 Ernest Van Dijckkaai
649,Ernest Van Dijckkaai,2023-07-11,22:00:00,353,109,244,FMN 01 Ernest Van Dijckkaai
649,Ernest Van Dijckkaai,2023-07-11,23:00:00,215,38,177,FMN 01 Ernest Van Dijckkaai
649,Ernest Van Dijckkaai,2023-07-12,00:00:00,88,35,53,FMN 01 Ernest Van Dijckkaai
649,Ernest Van Dijckkaai,2023-07-12,01:00:00,52,16,36,FMN 01 Ernest Van Dijckkaai
649,Ernest Van Dijckkaai,2023-07-12,02:00:00,16,3,13,FMN 01 Ernest Van Dijckkaai
649,Ernest Van Dijckkaai,2023-07-12,03:00:00,11,2,9,FMN 01 Ernest Van Dijckkaai
649,Ernest Van Dijckkaai,2023-07-12,04:00:00,71,40,31,FMN 01 Ernest Van Dijckkaai
649,Ernest Van Dijckkaai,2023-07-12,05:00:00,131,71,60,FMN 01 Ernest Van Dijckkaai
649,Ernest Van Dijckkaai,2023-07-12,06:00:00,248,160,88,FMN 01 Ernest Van Dijckkaai
649,Ernest Van Dijckkaai,2023-07-12,07:00:00,340,224,116,FMN 01 Ernest Van Dijckkaai
649,Ernest Van Dijckkaai,2023-07-12,08:00:00,403,236,167,FMN 01 Ernest Van Dijckkaai
649,Ernest Van Dijckkaai,2023-07-12,09:00:00,254,147,107,FMN 01 Ernest Van Dijckkaai
649,Ernest Van Dijckkaai,2023-07-12,10:00:00,210,108,102,FMN 01 Ernest Van Dijckkaai
649,Ernest Van Dijckkaai,2023-07-12,11:00:00,258,155,103,FMN 01 Ernest Van Dijckkaai
649,Ernest Van Dijckkaai,2023-07-12,12:00:00,278,168,110,FMN 01 Ernest Van Dijckkaai
649,Ernest Van Dijckkaai,2023-07-12,13:00:00,290,165,125,FMN 01 Ernest Van Dijckkaai
649,Ernest Van Dijckkaai,2023-07-12,14:00:00,401,196,205,FMN 01 Ernest Van Dijckkaai
649,Ernest Van Dijckkaai,2023-07-12,15:00:00,405,172,233,FMN 01 Ernest Van Dijckkaai
649,Ernest Van Dijckkaai,2023-07-12,16:00:00,619,272,347,FMN 01 Ernest Van Dijckkaai
649,Ernest Van Dijckkaai,2023-07-12,17:00:00,603,273,330,FMN 01 Ernest Van Dijckkaai
649,Ernest Van Dijckkaai,2023-07-12,18:00:00,474,247,227,FMN 01 Ernest Van Dijckkaai
649,Ernest Van Dijckkaai,2023-07-12,19:00:00,338,165,173,FMN 01 Ernest Van Dijckkaai
649,Ernest Van Dijckkaai,2023-07-12,20:00:00,294,146,148,FMN 01 Ernest Van Dijckkaai
649,Ernest Van Dijckkaai,2023-07-12,21:00:00,282,141,141,FMN 01 Ernest Van Dijckkaai
649,Ernest Van Dijckkaai,2023-07-12,22:00:00,268,85,183,FMN 01 Ernest Van Dijckkaai
649,Ernest Van Dijckkaai,2023-07-12,23:00:00,111,44,67,FMN 01 Ernest Van Dijckkaai
649,Ernest Van Dijckkaai,2023-07-13,00:00:00,75,26,49,FMN 01 Ernest Van Dijckkaai
649,Ernest Van Dijckkaai,2023-07-13,01:00:00,28,5,23,FMN 01 Ernest Van Dijckkaai
649,Ernest Van Dijckkaai,2023-07-13,02:00:00,33,13,20,FMN 01 Ernest Van Dijckkaai
649,Ernest Van Dijckkaai,2023-07-13,03:00:00,12,2,10,FMN 01 Ernest Van Dijckkaai
649,Ernest Van Dijckkaai,2023-07-13,04:00:00,47,29,18,FMN 01 Ernest Van Dijckkaai
649,Ernest Van Dijckkaai,2023-07-13,05:00:00,137,83,54,FMN 01 Ernest Van Dijckkaai
649,Ernest Van Dijckkaai,2023-07-13,06:00:00,237,148,89,FMN 01 Ernest Van Dijckkaai
649,Ernest Van Dijckkaai,2023-07-13,07:00:00,328,209,119,FMN 01 Ernest Van Dijckkaai
649,Ernest Van Dijckkaai,2023-07-13,08:00:00,425,237,188,FMN 01 Ernest Van Dijckkaai
649,Ernest Van Dijckkaai,2023-07-13,09:00:00,241,154,87,FMN 01 Ernest Van Dijckkaai
649,Ernest Van Dijckkaai,2023-07-13,10:00:00,211,119,92,FMN 01 Ernest Van Dijckkaai
649,Ernest Van Dijckkaai,2023-07-13,11:00:00,213,120,93,FMN 01 Ernest Van Dijckkaai
649,Ernest Van Dijckkaai,2023-07-13,12:00:00,348,202,146,FMN 01 Ernest Van Dijckkaai
649,Ernest Van Dijckkaai,2023-07-13,13:00:00,241,116,125,FMN 01 Ernest Van Dijckkaai
649,Ernest Van Dijckkaai,2023-07-13,14:00:00,279,161,118,FMN 01 Ernest Van Dijckkaai
649,Ernest Van Dijckkaai,2023-07-13,15:00:00,334,155,179,FMN 01 Ernest Van Dijckkaai
649,Ernest Van Dijckkaai,2023-07-13,16:00:00,559,230,329,FMN 01 Ernest Van Dijckkaai
649,Ernest Van Dijckkaai,2023-07-13,17:00:00,660,290,370,FMN 01 Ernest Van Dijckkaai
649,Ernest Van Dijckkaai,2023-07-13,18:00:00,444,205,239,FMN 01 Ernest Van Dijckkaai
649,Ernest Van Dijckkaai,2023-07-13,19:00:00,389,195,194,FMN 01 Ernest Van Dijckkaai
649,Ernest Van Dijckkaai,2023-07-13,20:00:00,261,127,134,FMN 01 Ernest Van Dijckkaai
649,Ernest Van Dijckkaai,2023-07-13,21:00:00,229,116,113,FMN 01 Ernest Van Dijckkaai
649,Ernest Van Dijckkaai,2023-07-13,22:00:00,203,79,124,FMN 01 Ernest Van Dijckkaai
649,Ernest Van Dijckkaai,2023-07-13,23:00:00,153,55,98,FMN 01 Ernest Van Dijckkaai
649,Ernest Van Dijckkaai,2023-07-14,00:00:00,69,32,37,FMN 01 Ernest Van Dijckkaai
649,Ernest Van Dijckkaai,2023-07-14,01:00:00,54,32,22,FMN 01 Ernest Van Dijckkaai
649,Ernest Van Dijckkaai,2023-07-14,02:00:00,18,4,14,FMN 01 Ernest Van Dijckkaai
649,Ernest Van Dijckkaai,2023-07-14,03:00:00,18,5,13,FMN 01 Ernest Van Dijckkaai
649,Ernest Van Dijckkaai,2023-07-14,04:00:00,81,36,45,FMN 01 Ernest Van Dijckkaai
649,Ernest Van Dijckkaai,2023-07-14,05:00:00,142,73,69,FMN 01 Ernest Van Dijckkaai
649,Ernest Van Dijckkaai,2023-07-14,06:00:00,199,121,78,FMN 01 Ernest Van Dijckkaai
649,Ernest Van Dijckkaai,2023-07-14,07:00:00,320,200,120,FMN 01 Ernest Van Dijckkaai
649,Ernest Van Dijckkaai,2023-07-14,08:00:00,356,213,143,FMN 01 Ernest Van Dijckkaai
649,Ernest Van Dijckkaai,2023-07-14,09:00:00,300,176,124,FMN 01 Ernest Van Dijckkaai
649,Ernest Van Dijckkaai,2023-07-14,10:00:00,255,127,128,FMN 01 Ernest Van Dijckkaai
649,Ernest Van Dijckkaai,2023-07-14,11:00:00,285,152,133,FMN 01 Ernest Van Dijckkaai
649,Ernest Van Dijckkaai,2023-07-14,12:00:00,423,245,178,FMN 01 Ernest Van Dijckkaai
649,Ernest Van Dijckkaai,2023-07-14,13:00:00,398,200,198,FMN 01 Ernest Van Dijckkaai
649,Ernest Van Dijckkaai,2023-07-14,14:00:00,368,171,197,FMN 01 Ernest Van Dijckkaai
649,Ernest Van Dijckkaai,2023-07-14,15:00:00,503,243,260,FMN 01 Ernest Van Dijckkaai
649,Ernest Van Dijckkaai,2023-07-14,16:00:00,603,265,338,FMN 01 Ernest Van Dijckkaai
649,Ernest Van Dijckkaai,2023-07-14,17:00:00,523,255,268,FMN 01 Ernest Van Dijckkaai
649,Ernest Van Dijckkaai,2023-07-14,18:00:00,447,234,213,FMN 01 Ernest Van Dijckkaai
649,Ernest Van Dijckkaai,2023-07-14,19:00:00,372,193,179,FMN 01 Ernest Van Dijckkaai
649,Ernest Van Dijckkaai,2023-07-14,20:00:00,368,169,199,FMN 01 Ernest Van Dijckkaai
649,Ernest Van Dijckkaai,2023-07-14,21:00:00,297,133,164,FMN 01 Ernest Van Dijckkaai
649,Ernest Van Dijckkaai,2023-07-14,22:00:00,261,102,159,FMN 01 Ernest Van Dijckkaai
649,Ernest Van Dijckkaai,2023-07-14,23:00:00,218,84,134,FMN 01 Ernest Van Dijckkaai
649,Ernest Van Dijckkaai,2023-07-15,00:00:00,179,79,100,FMN 01 Ernest Van Dijckkaai
649,Ernest Van Dijckkaai,2023-07-15,01:00:00,122,60,62,FMN 01 Ernest Van Dijckkaai
649,Ernest Van Dijckkaai,2023-07-15,02:00:00,84,47,37,FMN 01 Ernest Van Dijckkaai
649,Ernest Van Dijckkaai,2023-07-15,03:00:00,73,24,49,FMN 01 Ernest Van Dijckkaai
649,Ernest Van Dijckkaai,2023-07-15,04:00:00,49,21,28,FMN 01 Ernest Van Dijckkaai
649,Ernest Van Dijckkaai,2023-07-15,05:00:00,44,22,22,FMN 01 Ernest Van Dijckkaai
649,Ernest Van Dijckkaai,2023-07-15,06:00:00,80,37,43,FMN 01 Ernest Van Dijckkaai
649,Ernest Van Dijckkaai,2023-07-15,07:00:00,43,18,25,FMN 01 Ernest Van Dijckkaai
649,Ernest Van Dijckkaai,2023-07-15,08:00:00,75,38,37,FMN 01 Ernest Van Dijckkaai
649,Ernest Van Dijckkaai,2023-07-15,09:00:00,233,111,122,FMN 01 Ernest Van Dijckkaai
649,Ernest Van Dijckkaai,2023-07-15,10:00:00,260,150,110,FMN 01 Ernest Van Dijckkaai
649,Ernest Van Dijckkaai,2023-07-15,11:00:00,336,204,132,FMN 01 Ernest Van Dijckkaai
649,Ernest Van Dijckkaai,2023-07-15,12:00:00,263,141,122,FMN 01 Ernest Van Dijckkaai
649,Ernest Van Dijckkaai,2023-07-15,13:00:00,313,161,152,FMN 01 Ernest Van Dijckkaai
649,Ernest Van Dijckkaai,2023-07-15,14:00:00,434,237,197,FMN 01 Ernest Van Dijckkaai
649,Ernest Van Dijckkaai,2023-07-15,15:00:00,413,205,208,FMN 01 Ernest Van Dijckkaai
649,Ernest Van Dijckkaai,2023-07-15,16:00:00,394,202,192,FMN 01 Ernest Van Dijckkaai
649,Ernest Van Dijckkaai,2023-07-15,17:00:00,377,216,161,FMN 01 Ernest Van Dijckkaai
649,Ernest Van Dijckkaai,2023-07-15,18:00:00,395,194,201,FMN 01 Ernest Van Dijckkaai
649,Ernest Van Dijckkaai,2023-07-15,19:00:00,276,135,141,FMN 01 Ernest Van Dijckkaai
649,Ernest Van Dijckkaai,2023-07-15,20:00:00,264,137,127,FMN 01 Ernest Van Dijckkaai
649,Ernest Van Dijckkaai,2023-07-15,21:00:00,254,121,133,FMN 01 Ernest Van Dijckkaai
649,Ernest Van Dijckkaai,2023-07-15,22:00:00,262,114,148,FMN 01 Ernest Van Dijckkaai
649,Ernest Van Dijckkaai,2023-07-15,23:00:00,175,68,107,FMN 01 Ernest Van Dijckkaai
649,Ernest Van Dijckkaai,2023-07-16,00:00:00,187,64,123,FMN 01 Ernest Van Dijckkaai
649,Ernest Van Dijckkaai,2023-07-16,01:00:00,69,33,36,FMN 01 Ernest Van Dijckkaai
649,Ernest Van Dijckkaai,2023-07-16,02:00:00,54,16,38,FMN 01 Ernest Van Dijckkaai
649,Ernest Van Dijckkaai,2023-07-16,03:00:00,45,16,29,FMN 01 Ernest Van Dijckkaai
649,Ernest Van Dijckkaai,2023-07-16,04:00:00,48,20,28,FMN 01 Ernest Van Dijckkaai
649,Ernest Van Dijckkaai,2023-07-16,05:00:00,46,18,28,FMN 01 Ernest Van Dijckkaai
649,Ernest Van Dijckkaai,2023-07-16,06:00:00,46,21,25,FMN 01 Ernest Van Dijckkaai
649,Ernest Van Dijckkaai,2023-07-16,07:00:00,29,10,19,FMN 01 Ernest Van Dijckkaai
649,Ernest Van Dijckkaai,2023-07-16,08:00:00,72,28,44,FMN 01 Ernest Van Dijckkaai
649,Ernest Van Dijckkaai,2023-07-16,09:00:00,148,81,67,FMN 01 Ernest Van Dijckkaai
649,Ernest Van Dijckkaai,2023-07-16,10:00:00,257,154,103,FMN 01 Ernest Van Dijckkaai
649,Ernest Van Dijckkaai,2023-07-16,11:00:00,321,176,145,FMN 01 Ernest Van Dijckkaai
649,Ernest Van Dijckkaai,2023-07-16,12:00:00,280,144,136,FMN 01 Ernest Van Dijckkaai
649,Ernest Van Dijckkaai,2023-07-16,13:00:00,320,159,161,FMN 01 Ernest Van Dijckkaai
649,Ernest Van Dijckkaai,2023-07-16,14:00:00,391,200,191,FMN 01 Ernest Van Dijckkaai
649,Ernest Van Dijckkaai,2023-07-16,15:00:00,383,198,185,FMN 01 Ernest Van Dijckkaai
649,Ernest Van Dijckkaai,2023-07-16,16:00:00,342,167,175,FMN 01 Ernest Van Dijckkaai
649,Ernest Van Dijckkaai,2023-07-16,17:00:00,351,181,170,FMN 01 Ernest Van Dijckkaai
649,Ernest Van Dijckkaai,2023-07-16,18:00:00,271,122,149,FMN 01 Ernest Van Dijckkaai
649,Ernest Van Dijckkaai,2023-07-16,19:00:00,215,103,112,FMN 01 Ernest Van Dijckkaai
649,Ernest Van Dijckkaai,2023-07-16,20:00:00,169,89,80,FMN 01 Ernest Van Dijckkaai
649,Ernest Van Dijckkaai,2023-07-16,21:00:00,156,71,85,FMN 01 Ernest Van Dijckkaai
649,Ernest Van Dijckkaai,2023-07-16,22:00:00,139,71,68,FMN 01 Ernest Van Dijckkaai
649,Ernest Van Dijckkaai,2023-07-16,23:00:00,66,25,41,FMN 01 Ernest Van Dijckkaai
649,Ernest Van Dijckkaai,2023-07-17,00:00:00,40,11,29,FMN 01 Ernest Van Dijckkaai
649,Ernest Van Dijckkaai,2023-07-17,01:00:00,18,8,10,FMN 01 Ernest Van Dijckkaai
649,Ernest Van Dijckkaai,2023-07-17,02:00:00,8,2,6,FMN 01 Ernest Van Dijckkaai
649,Ernest Van Dijckkaai,2023-07-17,03:00:00,18,8,10,FMN 01 Ernest Van Dijckkaai
649,Ernest Van Dijckkaai,2023-07-17,04:00:00,63,45,18,FMN 01 Ernest Van Dijckkaai
649,Ernest Van Dijckkaai,2023-07-17,05:00:00,122,76,46,FMN 01 Ernest Van Dijckkaai
649,Ernest Van Dijckkaai,2023-07-17,06:00:00,224,136,88,FMN 01 Ernest Van Dijckkaai
649,Ernest Van Dijckkaai,2023-07-17,07:00:00,314,201,113,FMN 01 Ernest Van Dijckkaai
649,Ernest Van Dijckkaai,2023-07-17,08:00:00,358,210,148,FMN 01 Ernest Van Dijckkaai
649,Ernest Van Dijckkaai,2023-07-17,09:00:00,216,118,98,FMN 01 Ernest Van Dijckkaai
649,Ernest Van Dijckkaai,2023-07-17,10:00:00,176,96,80,FMN 01 Ernest Van Dijckkaai
649,Ernest Van Dijckkaai,2023-07-17,11:00:00,291,135,156,FMN 01 Ernest Van Dijckkaai
649,Ernest Van Dijckkaai,2023-07-17,12:00:00,257,135,122,FMN 01 Ernest Van Dijckkaai
649,Ernest Van Dijckkaai,2023-07-17,13:00:00,280,167,113,FMN 01 Ernest Van Dijckkaai
649,Ernest Van Dijckkaai,2023-07-17,14:00:00,351,158,193,FMN 01 Ernest Van Dijckkaai
649,Ernest Van Dijckkaai,2023-07-17,15:00:00,285,116,169,FMN 01 Ernest Van Dijckkaai
649,Ernest Van Dijckkaai,2023-07-17,16:00:00,454,214,240,FMN 01 Ernest Van Dijckkaai
649,Ernest Van Dijckkaai,2023-07-17,17:00:00,586,257,329,FMN 01 Ernest Van Dijckkaai
649,Ernest Van Dijckkaai,2023-07-17,18:00:00,379,180,199,FMN 01 Ernest Van Dijckkaai
649,Ernest Van Dijckkaai,2023-07-17,19:00:00,285,129,156,FMN 01 Ernest Van Dijckkaai
649,Ernest Van Dijckkaai,2023-07-17,20:00:00,292,153,139,FMN 01 Ernest Van Dijckkaai
649,Ernest Van Dijckkaai,2023-07-17,21:00:00,231,107,124,FMN 01 Ernest Van Dijckkaai
649,Ernest Van Dijckkaai,2023-07-17,22:00:00,194,71,123,FMN 01 Ernest Van Dijckkaai
649,Ernest Van Dijckkaai,2023-07-17,23:00:00,83,33,50,FMN 01 Ernest Van Dijckkaai
649,Ernest Van Dijckkaai,2023-07-18,00:00:00,45,16,29,FMN 01 Ernest Van Dijckkaai
649,Ernest Van Dijckkaai,2023-07-18,01:00:00,28,9,19,FMN 01 Ernest Van Dijckkaai
649,Ernest Van Dijckkaai,2023-07-18,02:00:00,15,3,12,FMN 01 Ernest Van Dijckkaai
649,Ernest Van Dijckkaai,2023-07-18,03:00:00,10,5,5,FMN 01 Ernest Van Dijckkaai
649,Ernest Van Dijckkaai,2023-07-18,04:00:00,57,46,11,FMN 01 Ernest Van Dijckkaai
649,Ernest Van Dijckkaai,2023-07-18,05:00:00,140,87,53,FMN 01 Ernest Van Dijckkaai
649,Ernest Van Dijckkaai,2023-07-18,06:00:00,259,155,104,FMN 01 Ernest Van Dijckkaai
649,Ernest Van Dijckkaai,2023-07-18,07:00:00,384,239,145,FMN 01 Ernest Van Dijckkaai
649,Ernest Van Dijckkaai,2023-07-18,08:00:00,436,260,176,FMN 01 Ernest Van Dijckkaai
649,Ernest Van Dijckkaai,2023-07-18,09:00:00,274,160,114,FMN 01 Ernest Van Dijckkaai
649,Ernest Van Dijckkaai,2023-07-18,10:00:00,227,113,114,FMN 01 Ernest Van Dijckkaai
649,Ernest Van Dijckkaai,2023-07-18,11:00:00,345,176,169,FMN 01 Ernest Van Dijckkaai
649,Ernest Van Dijckkaai,2023-07-18,12:00:00,409,227,182,FMN 01 Ernest Van Dijckkaai
649,Ernest Van Dijckkaai,2023-07-18,13:00:00,447,244,203,FMN 01 Ernest Van Dijckkaai
649,Ernest Van Dijckkaai,2023-07-18,14:00:00,572,283,289,FMN 01 Ernest Van Dijckkaai
649,Ernest Van Dijckkaai,2023-07-18,15:00:00,551,294,257,FMN 01 Ernest Van Dijckkaai
649,Ernest Van Dijckkaai,2023-07-18,16:00:00,663,291,372,FMN 01 Ernest Van Dijckkaai
649,Ernest Van Dijckkaai,2023-07-18,17:00:00,861,402,459,FMN 01 Ernest Van Dijckkaai
649,Ernest Van Dijckkaai,2023-07-18,18:00:00,580,276,304,FMN 01 Ernest Van Dijckkaai
649,Ernest Van Dijckkaai,2023-07-18,19:00:00,421,222,199,FMN 01 Ernest Van Dijckkaai
649,Ernest Van Dijckkaai,2023-07-18,20:00:00,371,179,192,FMN 01 Ernest Van Dijckkaai
649,Ernest Van Dijckkaai,2023-07-18,21:00:00,306,140,166,FMN 01 Ernest Van Dijckkaai
649,Ernest Van Dijckkaai,2023-07-18,22:00:00,266,106,160,FMN 01 Ernest Van Dijckkaai
649,Ernest Van Dijckkaai,2023-07-18,23:00:00,143,61,82,FMN 01 Ernest Van Dijckkaai
649,Ernest Van Dijckkaai,2023-07-19,00:00:00,71,17,54,FMN 01 Ernest Van Dijckkaai
649,Ernest Van Dijckkaai,2023-07-19,01:00:00,47,7,40,FMN 01 Ernest Van Dijckkaai
649,Ernest Van Dijckkaai,2023-07-19,02:00:00,31,12,19,FMN 01 Ernest Van Dijckkaai
649,Ernest Van Dijckkaai,2023-07-19,03:00:00,13,5,8,FMN 01 Ernest Van Dijckkaai
649,Ernest Van Dijckkaai,2023-07-19,04:00:00,67,41,26,FMN 01 Ernest Van Dijckkaai
649,Ernest Van Dijckkaai,2023-07-19,05:00:00,119,75,44,FMN 01 Ernest Van Dijckkaai
649,Ernest Van Dijckkaai,2023-07-19,06:00:00,212,126,86,FMN 01 Ernest Van Dijckkaai
649,Ernest Van Dijckkaai,2023-07-19,07:00:00,318,193,125,FMN 01 Ernest Van Dijckkaai
649,Ernest Van Dijckkaai,2023-07-19,08:00:00,423,269,154,FMN 01 Ernest Van Dijckkaai
649,Ernest Van Dijckkaai,2023-07-19,09:00:00,239,140,99,FMN 01 Ernest Van Dijckkaai
649,Ernest Van Dijckkaai,2023-07-19,10:00:00,254,172,82,FMN 01 Ernest Van Dijckkaai
649,Ernest Van Dijckkaai,2023-07-19,11:00:00,272,133,139,FMN 01 Ernest Van Dijckkaai
649,Ernest Van Dijckkaai,2023-07-19,12:00:00,336,154,182,FMN 01 Ernest Van Dijckkaai
649,Ernest Van Dijckkaai,2023-07-19,13:00:00,289,158,131,FMN 01 Ernest Van Dijckkaai
649,Ernest Van Dijckkaai,2023-07-19,14:00:00,376,154,222,FMN 01 Ernest Van Dijckkaai
649,Ernest Van Dijckkaai,2023-07-19,15:00:00,379,176,203,FMN 01 Ernest Van Dijckkaai
649,Ernest Van Dijckkaai,2023-07-19,16:00:00,534,192,342,FMN 01 Ernest Van Dijckkaai
649,Ernest Van Dijckkaai,2023-07-19,17:00:00,569,238,331,FMN 01 Ernest Van Dijckkaai
649,Ernest Van Dijckkaai,2023-07-19,18:00:00,450,239,211,FMN 01 Ernest Van Dijckkaai
649,Ernest Van Dijckkaai,2023-07-19,19:00:00,265,140,125,FMN 01 Ernest Van Dijckkaai
649,Ernest Van Dijckkaai,2023-07-19,20:00:00,235,103,132,FMN 01 Ernest Van Dijckkaai
649,Ernest Van Dijckkaai,2023-07-19,21:00:00,224,113,111,FMN 01 Ernest Van Dijckkaai
649,Ernest Van Dijckkaai,2023-07-19,22:00:00,184,69,115,FMN 01 Ernest Van Dijckkaai
649,Ernest Van Dijckkaai,2023-07-19,23:00:00,117,36,81,FMN 01 Ernest Van Dijckkaai
649,Ernest Van Dijckkaai,2023-07-20,00:00:00,66,33,33,FMN 01 Ernest Van Dijckkaai
649,Ernest Van Dijckkaai,2023-07-20,01:00:00,23,11,12,FMN 01 Ernest Van Dijckkaai
649,Ernest Van Dijckkaai,2023-07-20,02:00:00,14,4,10,FMN 01 Ernest Van Dijckkaai
649,Ernest Van Dijckkaai,2023-07-20,03:00:00,8,4,4,FMN 01 Ernest Van Dijckkaai
649,Ernest Van Dijckkaai,2023-07-20,04:00:00,49,35,14,FMN 01 Ernest Van Dijckkaai
649,Ernest Van Dijckkaai,2023-07-20,05:00:00,124,78,46,FMN 01 Ernest Van Dijckkaai
649,Ernest Van Dijckkaai,2023-07-20,06:00:00,213,120,93,FMN 01 Ernest Van Dijckkaai
649,Ernest Van Dijckkaai,2023-07-20,07:00:00,278,177,101,FMN 01 Ernest Van Dijckkaai
649,Ernest Van Dijckkaai,2023-07-20,08:00:00,368,231,137,FMN 01 Ernest Van Dijckkaai
649,Ernest Van Dijckkaai,2023-07-20,09:00:00,272,162,110,FMN 01 Ernest Van Dijckkaai
649,Ernest Van Dijckkaai,2023-07-20,10:00:00,201,108,93,FMN 01 Ernest Van Dijckkaai
649,Ernest Van Dijckkaai,2023-07-20,11:00:00,264,158,106,FMN 01 Ernest Van Dijckkaai
649,Ernest Van Dijckkaai,2023-07-20,12:00:00,333,193,140,FMN 01 Ernest Van Dijckkaai
649,Ernest Van Dijckkaai,2023-07-20,13:00:00,330,170,160,FMN 01 Ernest Van Dijckkaai
649,Ernest Van Dijckkaai,2023-07-20,14:00:00,393,202,191,FMN 01 Ernest Van Dijckkaai
649,Ernest Van Dijckkaai,2023-07-20,15:00:00,479,269,210,FMN 01 Ernest Van Dijckkaai
649,Ernest Van Dijckkaai,2023-07-20,16:00:00,554,254,300,FMN 01 Ernest Van Dijckkaai
649,Ernest Van Dijckkaai,2023-07-20,17:00:00,579,236,343,FMN 01 Ernest Van Dijckkaai
649,Ernest Van Dijckkaai,2023-07-20,18:00:00,327,169,158,FMN 01 Ernest Van Dijckkaai
649,Ernest Van Dijckkaai,2023-07-20,19:00:00,340,178,162,FMN 01 Ernest Van Dijckkaai
649,Ernest Van Dijckkaai,2023-07-20,20:00:00,238,105,133,FMN 01 Ernest Van Dijckkaai
649,Ernest Van Dijckkaai,2023-07-20,21:00:00,253,121,132,FMN 01 Ernest Van Dijckkaai
649,Ernest Van Dijckkaai,2023-07-20,22:00:00,209,94,115,FMN 01 Ernest Van Dijckkaai
649,Ernest Van Dijckkaai,2023-07-20,23:00:00,171,68,103,FMN 01 Ernest Van Dijckkaai
649,Ernest Van Dijckkaai,2023-07-21,00:00:00,95,43,52,FMN 01 Ernest Van Dijckkaai
649,Ernest Van Dijckkaai,2023-07-21,01:00:00,97,48,49,FMN 01 Ernest Van Dijckkaai
649,Ernest Van Dijckkaai,2023-07-21,02:00:00,69,21,48,FMN 01 Ernest Van Dijckkaai
649,Ernest Van Dijckkaai,2023-07-21,03:00:00,33,8,25,FMN 01 Ernest Van Dijckkaai
649,Ernest Van Dijckkaai,2023-07-21,04:00:00,35,11,24,FMN 01 Ernest Van Dijckkaai
649,Ernest Van Dijckkaai,2023-07-21,05:00:00,46,15,31,FMN 01 Ernest Van Dijckkaai
649,Ernest Van Dijckkaai,2023-07-21,06:00:00,44,24,20,FMN 01 Ernest Van Dijckkaai
649,Ernest Van Dijckkaai,2023-07-21,07:00:00,56,23,33,FMN 01 Ernest Van Dijckkaai
649,Ernest Van Dijckkaai,2023-07-21,08:00:00,99,53,46,FMN 01 Ernest Van Dijckkaai
649,Ernest Van Dijckkaai,2023-07-21,09:00:00,201,110,91,FMN 01 Ernest Van Dijckkaai
649,Ernest Van Dijckkaai,2023-07-21,10:00:00,252,148,104,FMN 01 Ernest Van Dijckkaai
649,Ernest Van Dijckkaai,2023-07-21,11:00:00,304,140,164,FMN 01 Ernest Van Dijckkaai
649,Ernest Van Dijckkaai,2023-07-21,12:00:00,133,76,57,FMN 01 Ernest Van Dijckkaai
649,Ernest Van Dijckkaai,2023-07-21,13:00:00,221,112,109,FMN 01 Ernest Van Dijckkaai
649,Ernest Van Dijckkaai,2023-07-21,14:00:00,299,155,144,FMN 01 Ernest Van Dijckkaai
649,Ernest Van Dijckkaai,2023-07-21,15:00:00,328,176,152,FMN 01 Ernest Van Dijckkaai
649,Ernest Van Dijckkaai,2023-07-21,16:00:00,365,196,169,FMN 01 Ernest Van Dijckkaai
649,Ernest Van Dijckkaai,2023-07-21,17:00:00,352,167,185,FMN 01 Ernest Van Dijckkaai
649,Ernest Van Dijckkaai,2023-07-21,18:00:00,342,159,183,FMN 01 Ernest Van Dijckkaai
649,Ernest Van Dijckkaai,2023-07-21,19:00:00,332,115,217,FMN 01 Ernest Van Dijckkaai
649,Ernest Van Dijckkaai,2023-07-21,20:00:00,263,133,130,FMN 01 Ernest Van Dijckkaai
649,Ernest Van Dijckkaai,2023-07-21,21:00:00,197,93,104,FMN 01 Ernest Van Dijckkaai
649,Ernest Van Dijckkaai,2023-07-21,22:00:00,178,71,107,FMN 01 Ernest Van Dijckkaai
649,Ernest Van Dijckkaai,2023-07-21,23:00:00,144,63,81,FMN 01 Ernest Van Dijckkaai
649,Ernest Van Dijckkaai,2023-07-22,00:00:00,101,47,54,FMN 01 Ernest Van Dijckkaai
649,Ernest Van Dijckkaai,2023-07-22,01:00:00,61,30,31,FMN 01 Ernest Van Dijckkaai
649,Ernest Van Dijckkaai,2023-07-22,02:00:00,26,8,18,FMN 01 Ernest Van Dijckkaai
649,Ernest Van Dijckkaai,2023-07-22,03:00:00,35,3,32,FMN 01 Ernest Van Dijckkaai
649,Ernest Van Dijckkaai,2023-07-22,04:00:00,36,16,20,FMN 01 Ernest Van Dijckkaai
649,Ernest Van Dijckkaai,2023-07-22,05:00:00,44,16,28,FMN 01 Ernest Van Dijckkaai
649,Ernest Van Dijckkaai,2023-07-22,06:00:00,59,17,42,FMN 01 Ernest Van Dijckkaai
649,Ernest Van Dijckkaai,2023-07-22,07:00:00,38,16,22,FMN 01 Ernest Van Dijckkaai
649,Ernest Van Dijckkaai,2023-07-22,08:00:00,60,32,28,FMN 01 Ernest Van Dijckkaai
649,Ernest Van Dijckkaai,2023-07-22,09:00:00,167,91,76,FMN 01 Ernest Van Dijckkaai
649,Ernest Van Dijckkaai,2023-07-22,10:00:00,209,127,82,FMN 01 Ernest Van Dijckkaai
649,Ernest Van Dijckkaai,2023-07-22,11:00:00,273,143,130,FMN 01 Ernest Van Dijckkaai
649,Ernest Van Dijckkaai,2023-07-22,12:00:00,317,148,169,FMN 01 Ernest Van Dijckkaai
649,Ernest Van Dijckkaai,2023-07-22,13:00:00,374,206,168,FMN 01 Ernest Van Dijckkaai
649,Ernest Van Dijckkaai,2023-07-22,14:00:00,474,251,223,FMN 01 Ernest Van Dijckkaai
649,Ernest Van Dijckkaai,2023-07-22,15:00:00,428,206,222,FMN 01 Ernest Van Dijckkaai
649,Ernest Van Dijckkaai,2023-07-22,16:00:00,366,187,179,FMN 01 Ernest Van Dijckkaai
649,Ernest Van Dijckkaai,2023-07-22,17:00:00,352,171,181,FMN 01 Ernest Van Dijckkaai
649,Ernest Van Dijckkaai,2023-07-22,18:00:00,291,157,134,FMN 01 Ernest Van Dijckkaai
649,Ernest Van Dijckkaai,2023-07-22,19:00:00,215,114,101,FMN 01 Ernest Van Dijckkaai
649,Ernest Van Dijckkaai,2023-07-22,20:00:00,145,80,65,FMN 01 Ernest Van Dijckkaai
649,Ernest Van Dijckkaai,2023-07-22,21:00:00,114,63,51,FMN 01 Ernest Van Dijckkaai
649,Ernest Van Dijckkaai,2023-07-22,22:00:00,119,47,72,FMN 01 Ernest Van Dijckkaai
649,Ernest Van Dijckkaai,2023-07-22,23:00:00,89,42,47,FMN 01 Ernest Van Dijckkaai
649,Ernest Van Dijckkaai,2023-07-23,00:00:00,67,22,45,FMN 01 Ernest Van Dijckkaai
649,Ernest Van Dijckkaai,2023-07-23,01:00:00,57,19,38,FMN 01 Ernest Van Dijckkaai
649,Ernest Van Dijckkaai,2023-07-23,02:00:00,39,15,24,FMN 01 Ernest Van Dijckkaai
649,Ernest Van Dijckkaai,2023-07-23,03:00:00,39,11,28,FMN 01 Ernest Van Dijckkaai
649,Ernest Van Dijckkaai,2023-07-23,04:00:00,38,16,22,FMN 01 Ernest Van Dijckkaai
649,Ernest Van Dijckkaai,2023-07-23,05:00:00,21,14,7,FMN 01 Ernest Van Dijckkaai
649,Ernest Van Dijckkaai,2023-07-23,06:00:00,35,14,21,FMN 01 Ernest Van Dijckkaai
649,Ernest Van Dijckkaai,2023-07-23,07:00:00,18,6,12,FMN 01 Ernest Van Dijckkaai
649,Ernest Van Dijckkaai,2023-07-23,08:00:00,41,22,19,FMN 01 Ernest Van Dijckkaai
649,Ernest Van Dijckkaai,2023-07-23,09:00:00,52,24,28,FMN 01 Ernest Van Dijckkaai
649,Ernest Van Dijckkaai,2023-07-23,10:00:00,100,58,42,FMN 01 Ernest Van Dijckkaai
649,Ernest Van Dijckkaai,2023-07-23,11:00:00,130,63,67,FMN 01 Ernest Van Dijckkaai
649,Ernest Van Dijckkaai,2023-07-23,12:00:00,127,53,74,FMN 01 Ernest Van Dijckkaai
649,Ernest Van Dijckkaai,2023-07-23,13:00:00,212,132,80,FMN 01 Ernest Van Dijckkaai
649,Ernest Van Dijckkaai,2023-07-23,14:00:00,223,128,95,FMN 01 Ernest Van Dijckkaai
649,Ernest Van Dijckkaai,2023-07-23,15:00:00,206,105,101,FMN 01 Ernest Van Dijckkaai
649,Ernest Van Dijckkaai,2023-07-23,16:00:00,227,115,112,FMN 01 Ernest Van Dijckkaai
649,Ernest Van Dijckkaai,2023-07-23,17:00:00,168,76,92,FMN 01 Ernest Van Dijckkaai
649,Ernest Van Dijckkaai,2023-07-23,18:00:00,164,79,85,FMN 01 Ernest Van Dijckkaai
649,Ernest Van Dijckkaai,2023-07-23,19:00:00,77,29,48,FMN 01 Ernest Van Dijckkaai
649,Ernest Van Dijckkaai,2023-07-23,20:00:00,67,30,37,FMN 01 Ernest Van Dijckkaai
649,Ernest Van Dijckkaai,2023-07-23,21:00:00,61,26,35,FMN 01 Ernest Van Dijckkaai
649,Ernest Van Dijckkaai,2023-07-23,22:00:00,58,28,30,FMN 01 Ernest Van Dijckkaai
649,Ernest Van Dijckkaai,2023-07-23,23:00:00,47,23,24,FMN 01 Ernest Van Dijckkaai
649,Ernest Van Dijckkaai,2023-07-24,00:00:00,11,3,8,FMN 01 Ernest Van Dijckkaai
649,Ernest Van Dijckkaai,2023-07-24,01:00:00,13,6,7,FMN 01 Ernest Van Dijckkaai
649,Ernest Van Dijckkaai,2023-07-24,02:00:00,6,1,5,FMN 01 Ernest Van Dijckkaai
649,Ernest Van Dijckkaai,2023-07-24,03:00:00,10,3,7,FMN 01 Ernest Van Dijckkaai
649,Ernest Van Dijckkaai,2023-07-24,04:00:00,40,28,12,FMN 01 Ernest Van Dijckkaai
649,Ernest Van Dijckkaai,2023-07-24,05:00:00,70,47,23,FMN 01 Ernest Van Dijckkaai
649,Ernest Van Dijckkaai,2023-07-24,06:00:00,133,75,58,FMN 01 Ernest Van Dijckkaai
649,Ernest Van Dijckkaai,2023-07-24,07:00:00,225,151,74,FMN 01 Ernest Van Dijckkaai
649,Ernest Van Dijckkaai,2023-07-24,08:00:00,264,155,109,FMN 01 Ernest Van Dijckkaai
649,Ernest Van Dijckkaai,2023-07-24,09:00:00,127,83,44,FMN 01 Ernest Van Dijckkaai
649,Ernest Van Dijckkaai,2023-07-24,10:00:00,102,53,49,FMN 01 Ernest Van Dijckkaai
649,Ernest Van Dijckkaai,2023-07-24,11:00:00,150,92,58,FMN 01 Ernest Van Dijckkaai
649,Ernest Van Dijckkaai,2023-07-24,12:00:00,190,106,84,FMN 01 Ernest Van Dijckkaai
649,Ernest Van Dijckkaai,2023-07-24,13:00:00,203,108,95,FMN 01 Ernest Van Dijckkaai
649,Ernest Van Dijckkaai,2023-07-24,14:00:00,243,109,134,FMN 01 Ernest Van Dijckkaai
649,Ernest Van Dijckkaai,2023-07-24,15:00:00,190,74,116,FMN 01 Ernest Van Dijckkaai
649,Ernest Van Dijckkaai,2023-07-24,16:00:00,323,128,195,FMN 01 Ernest Van Dijckkaai
649,Ernest Van Dijckkaai,2023-07-24,17:00:00,377,159,218,FMN 01 Ernest Van Dijckkaai
649,Ernest Van Dijckkaai,2023-07-24,18:00:00,251,129,122,FMN 01 Ernest Van Dijckkaai
649,Ernest Van Dijckkaai,2023-07-24,19:00:00,174,90,84,FMN 01 Ernest Van Dijckkaai
649,Ernest Van Dijckkaai,2023-07-24,20:00:00,178,88,90,FMN 01 Ernest Van Dijckkaai
649,Ernest Van Dijckkaai,2023-07-24,21:00:00,134,48,86,FMN 01 Ernest Van Dijckkaai
649,Ernest Van Dijckkaai,2023-07-24,22:00:00,127,43,84,FMN 01 Ernest Van Dijckkaai
649,Ernest Van Dijckkaai,2023-07-24,23:00:00,71,27,44,FMN 01 Ernest Van Dijckkaai
649,Ernest Van Dijckkaai,2023-07-25,00:00:00,34,12,22,FMN 01 Ernest Van Dijckkaai
649,Ernest Van Dijckkaai,2023-07-25,01:00:00,21,11,10,FMN 01 Ernest Van Dijckkaai
649,Ernest Van Dijckkaai,2023-07-25,02:00:00,23,4,19,FMN 01 Ernest Van Dijckkaai
649,Ernest Van Dijckkaai,2023-07-25,03:00:00,9,4,5,FMN 01 Ernest Van Dijckkaai
649,Ernest Van Dijckkaai,2023-07-25,04:00:00,52,33,19,FMN 01 Ernest Van Dijckkaai
649,Ernest Van Dijckkaai,2023-07-25,05:00:00,100,67,33,FMN 01 Ernest Van Dijckkaai
649,Ernest Van Dijckkaai,2023-07-25,06:00:00,195,126,69,FMN 01 Ernest Van Dijckkaai
649,Ernest Van Dijckkaai,2023-07-25,07:00:00,287,177,110,FMN 01 Ernest Van Dijckkaai
649,Ernest Van Dijckkaai,2023-07-25,08:00:00,316,178,138,FMN 01 Ernest Van Dijckkaai
649,Ernest Van Dijckkaai,2023-07-25,09:00:00,227,119,108,FMN 01 Ernest Van Dijckkaai
649,Ernest Van Dijckkaai,2023-07-25,10:00:00,158,90,68,FMN 01 Ernest Van Dijckkaai
649,Ernest Van Dijckkaai,2023-07-25,11:00:00,217,129,88,FMN 01 Ernest Van Dijckkaai
649,Ernest Van Dijckkaai,2023-07-25,12:00:00,294,144,150,FMN 01 Ernest Van Dijckkaai
649,Ernest Van Dijckkaai,2023-07-25,13:00:00,335,182,153,FMN 01 Ernest Van Dijckkaai
649,Ernest Van Dijckkaai,2023-07-25,14:00:00,393,188,205,FMN 01 Ernest Van Dijckkaai
649,Ernest Van Dijckkaai,2023-07-25,15:00:00,338,163,175,FMN 01 Ernest Van Dijckkaai
649,Ernest Van Dijckkaai,2023-07-25,16:00:00,604,254,350,FMN 01 Ernest Van Dijckkaai
649,Ernest Van Dijckkaai,2023-07-25,17:00:00,583,244,339,FMN 01 Ernest Van Dijckkaai
649,Ernest Van Dijckkaai,2023-07-25,18:00:00,505,265,240,FMN 01 Ernest Van Dijckkaai
649,Ernest Van Dijckkaai,2023-07-25,19:00:00,354,173,181,FMN 01 Ernest Van Dijckkaai
649,Ernest Van Dijckkaai,2023-07-25,20:00:00,269,121,148,FMN 01 Ernest Van Dijckkaai
649,Ernest Van Dijckkaai,2023-07-25,21:00:00,216,98,118,FMN 01 Ernest Van Dijckkaai
649,Ernest Van Dijckkaai,2023-07-25,22:00:00,213,85,128,FMN 01 Ernest Van Dijckkaai
649,Ernest Van Dijckkaai,2023-07-25,23:00:00,145,63,82,FMN 01 Ernest Van Dijckkaai
649,Ernest Van Dijckkaai,2023-07-26,00:00:00,75,31,44,FMN 01 Ernest Van Dijckkaai
649,Ernest Van Dijckkaai,2023-07-26,01:00:00,33,14,19,FMN 01 Ernest Van Dijckkaai
649,Ernest Van Dijckkaai,2023-07-26,02:00:00,23,11,12,FMN 01 Ernest Van Dijckkaai
649,Ernest Van Dijckkaai,2023-07-26,03:00:00,18,2,16,FMN 01 Ernest Van Dijckkaai
649,Ernest Van Dijckkaai,2023-07-26,04:00:00,53,35,18,FMN 01 Ernest Van Dijckkaai
649,Ernest Van Dijckkaai,2023-07-26,05:00:00,95,63,32,FMN 01 Ernest Van Dijckkaai
649,Ernest Van Dijckkaai,2023-07-26,06:00:00,224,141,83,FMN 01 Ernest Van Dijckkaai
649,Ernest Van Dijckkaai,2023-07-26,07:00:00,322,202,120,FMN 01 Ernest Van Dijckkaai
649,Ernest Van Dijckkaai,2023-07-26,08:00:00,385,230,155,FMN 01 Ernest Van Dijckkaai
649,Ernest Van Dijckkaai,2023-07-26,09:00:00,254,143,111,FMN 01 Ernest Van Dijckkaai
649,Ernest Van Dijckkaai,2023-07-26,10:00:00,257,147,110,FMN 01 Ernest Van Dijckkaai
649,Ernest Van Dijckkaai,2023-07-26,11:00:00,254,138,116,FMN 01 Ernest Van Dijckkaai
649,Ernest Van Dijckkaai,2023-07-26,12:00:00,346,206,140,FMN 01 Ernest Van Dijckkaai
649,Ernest Van Dijckkaai,2023-07-26,13:00:00,328,176,152,FMN 01 Ernest Van Dijckkaai
649,Ernest Van Dijckkaai,2023-07-26,14:00:00,461,214,247,FMN 01 Ernest Van Dijckkaai
649,Ernest Van Dijckkaai,2023-07-26,15:00:00,475,226,249,FMN 01 Ernest Van Dijckkaai
649,Ernest Van Dijckkaai,2023-07-26,16:00:00,666,293,373,FMN 01 Ernest Van Dijckkaai
649,Ernest Van Dijckkaai,2023-07-26,17:00:00,696,303,393,FMN 01 Ernest Van Dijckkaai
649,Ernest Van Dijckkaai,2023-07-26,18:00:00,479,233,246,FMN 01 Ernest Van Dijckkaai
649,Ernest Van Dijckkaai,2023-07-26,19:00:00,320,157,163,FMN 01 Ernest Van Dijckkaai
649,Ernest Van Dijckkaai,2023-07-26,20:00:00,313,158,155,FMN 01 Ernest Van Dijckkaai
649,Ernest Van Dijckkaai,2023-07-26,21:00:00,258,123,135,FMN 01 Ernest Van Dijckkaai
649,Ernest Van Dijckkaai,2023-07-26,22:00:00,216,70,146,FMN 01 Ernest Van Dijckkaai
649,Ernest Van Dijckkaai,2023-07-26,23:00:00,128,44,84,FMN 01 Ernest Van Dijckkaai
649,Ernest Van Dijckkaai,2023-07-27,00:00:00,71,32,39,FMN 01 Ernest Van Dijckkaai
649,Ernest Van Dijckkaai,2023-07-27,01:00:00,20,5,15,FMN 01 Ernest Van Dijckkaai
649,Ernest Van Dijckkaai,2023-07-27,02:00:00,13,1,12,FMN 01 Ernest Van Dijckkaai
649,Ernest Van Dijckkaai,2023-07-27,03:00:00,12,4,8,FMN 01 Ernest Van Dijckkaai
649,Ernest Van Dijckkaai,2023-07-27,04:00:00,47,31,16,FMN 01 Ernest Van Dijckkaai
649,Ernest Van Dijckkaai,2023-07-27,05:00:00,79,48,31,FMN 01 Ernest Van Dijckkaai
649,Ernest Van Dijckkaai,2023-07-27,06:00:00,134,88,46,FMN 01 Ernest Van Dijckkaai
649,Ernest Van Dijckkaai,2023-07-27,07:00:00,185,110,75,FMN 01 Ernest Van Dijckkaai
649,Ernest Van Dijckkaai,2023-07-27,08:00:00,237,142,95,FMN 01 Ernest Van Dijckkaai
649,Ernest Van Dijckkaai,2023-07-27,09:00:00,132,78,54,FMN 01 Ernest Van Dijckkaai
649,Ernest Van Dijckkaai,2023-07-27,10:00:00,92,60,32,FMN 01 Ernest Van Dijckkaai
649,Ernest Van Dijckkaai,2023-07-27,11:00:00,98,55,43,FMN 01 Ernest Van Dijckkaai
649,Ernest Van Dijckkaai,2023-07-27,12:00:00,155,91,64,FMN 01 Ernest Van Dijckkaai
649,Ernest Van Dijckkaai,2023-07-27,13:00:00,142,75,67,FMN 01 Ernest Van Dijckkaai
649,Ernest Van Dijckkaai,2023-07-27,14:00:00,138,63,75,FMN 01 Ernest Van Dijckkaai
649,Ernest Van Dijckkaai,2023-07-27,15:00:00,210,108,102,FMN 01 Ernest Van Dijckkaai
649,Ernest Van Dijckkaai,2023-07-27,16:00:00,288,130,158,FMN 01 Ernest Van Dijckkaai
649,Ernest Van Dijckkaai,2023-07-27,17:00:00,314,115,199,FMN 01 Ernest Van Dijckkaai
649,Ernest Van Dijckkaai,2023-07-27,18:00:00,226,116,110,FMN 01 Ernest Van Dijckkaai
649,Ernest Van Dijckkaai,2023-07-27,19:00:00,158,65,93,FMN 01 Ernest Van Dijckkaai
649,Ernest Van Dijckkaai,2023-07-27,20:00:00,122,61,61,FMN 01 Ernest Van Dijckkaai
649,Ernest Van Dijckkaai,2023-07-27,21:00:00,108,48,60,FMN 01 Ernest Van Dijckkaai
649,Ernest Van Dijckkaai,2023-07-27,22:00:00,140,47,93,FMN 01 Ernest Van Dijckkaai
649,Ernest Van Dijckkaai,2023-07-27,23:00:00,73,36,37,FMN 01 Ernest Van Dijckkaai
649,Ernest Van Dijckkaai,2023-07-28,00:00:00,35,20,15,FMN 01 Ernest Van Dijckkaai
649,Ernest Van Dijckkaai,2023-07-28,01:00:00,18,10,8,FMN 01 Ernest Van Dijckkaai
649,Ernest Van Dijckkaai,2023-07-28,02:00:00,24,6,18,FMN 01 Ernest Van Dijckkaai
649,Ernest Van Dijckkaai,2023-07-28,03:00:00,23,6,17,FMN 01 Ernest Van Dijckkaai
649,Ernest Van Dijckkaai,2023-07-28,04:00:00,60,38,22,FMN 01 Ernest Van Dijckkaai
649,Ernest Van Dijckkaai,2023-07-28,05:00:00,93,50,43,FMN 01 Ernest Van Dijckkaai
649,Ernest Van Dijckkaai,2023-07-28,06:00:00,155,96,59,FMN 01 Ernest Van Dijckkaai
649,Ernest Van Dijckkaai,2023-07-28,07:00:00,230,159,71,FMN 01 Ernest Van Dijckkaai
649,Ernest Van Dijckkaai,2023-07-28,08:00:00,271,165,106,FMN 01 Ernest Van Dijckkaai
649,Ernest Van Dijckkaai,2023-07-28,09:00:00,155,89,66,FMN 01 Ernest Van Dijckkaai
649,Ernest Van Dijckkaai,2023-07-28,10:00:00,173,87,86,FMN 01 Ernest Van Dijckkaai
649,Ernest Van Dijckkaai,2023-07-28,11:00:00,216,109,107,FMN 01 Ernest Van Dijckkaai
649,Ernest Van Dijckkaai,2023-07-28,12:00:00,295,160,135,FMN 01 Ernest Van Dijckkaai
649,Ernest Van Dijckkaai,2023-07-28,13:00:00,310,175,135,FMN 01 Ernest Van Dijckkaai
649,Ernest Van Dijckkaai,2023-07-28,14:00:00,352,165,187,FMN 01 Ernest Van Dijckkaai
649,Ernest Van Dijckkaai,2023-07-28,15:00:00,406,175,231,FMN 01 Ernest Van Dijckkaai
649,Ernest Van Dijckkaai,2023-07-28,16:00:00,519,231,288,FMN 01 Ernest Van Dijckkaai
649,Ernest Van Dijckkaai,2023-07-28,17:00:00,489,251,238,FMN 01 Ernest Van Dijckkaai
649,Ernest Van Dijckkaai,2023-07-28,18:00:00,426,215,211,FMN 01 Ernest Van Dijckkaai
649,Ernest Van Dijckkaai,2023-07-28,19:00:00,424,205,219,FMN 01 Ernest Van Dijckkaai
649,Ernest Van Dijckkaai,2023-07-28,20:00:00,380,175,205,FMN 01 Ernest Van Dijckkaai
649,Ernest Van Dijckkaai,2023-07-28,21:00:00,329,136,193,FMN 01 Ernest Van Dijckkaai
649,Ernest Van Dijckkaai,2023-07-28,22:00:00,315,131,184,FMN 01 Ernest Van Dijckkaai
649,Ernest Van Dijckkaai,2023-07-28,23:00:00,254,120,134,FMN 01 Ernest Van Dijckkaai
649,Ernest Van Dijckkaai,2023-07-29,00:00:00,236,153,83,FMN 01 Ernest Van Dijckkaai
649,Ernest Van Dijckkaai,2023-07-29,01:00:00,102,60,42,FMN 01 Ernest Van Dijckkaai
649,Ernest Van Dijckkaai,2023-07-29,02:00:00,54,29,25,FMN 01 Ernest Van Dijckkaai
649,Ernest Van Dijckkaai,2023-07-29,03:00:00,58,24,34,FMN 01 Ernest Van Dijckkaai
649,Ernest Van Dijckkaai,2023-07-29,04:00:00,63,35,28,FMN 01 Ernest Van Dijckkaai
649,Ernest Van Dijckkaai,2023-07-29,05:00:00,51,27,24,FMN 01 Ernest Van Dijckkaai
649,Ernest Van Dijckkaai,2023-07-29,06:00:00,60,22,38,FMN 01 Ernest Van Dijckkaai
649,Ernest Van Dijckkaai,2023-07-29,07:00:00,32,13,19,FMN 01 Ernest Van Dijckkaai
649,Ernest Van Dijckkaai,2023-07-29,08:00:00,81,41,40,FMN 01 Ernest Van Dijckkaai
649,Ernest Van Dijckkaai,2023-07-29,09:00:00,139,62,77,FMN 01 Ernest Van Dijckkaai
649,Ernest Van Dijckkaai,2023-07-29,10:00:00,226,139,87,FMN 01 Ernest Van Dijckkaai
649,Ernest Van Dijckkaai,2023-07-29,11:00:00,258,134,124,FMN 01 Ernest Van Dijckkaai
649,Ernest Van Dijckkaai,2023-07-29,12:00:00,215,96,119,FMN 01 Ernest Van Dijckkaai
649,Ernest Van Dijckkaai,2023-07-29,13:00:00,111,64,47,FMN 01 Ernest Van Dijckkaai
649,Ernest Van Dijckkaai,2023-07-29,14:00:00,257,123,134,FMN 01 Ernest Van Dijckkaai
649,Ernest Van Dijckkaai,2023-07-29,15:00:00,362,177,185,FMN 01 Ernest Van Dijckkaai
649,Ernest Van Dijckkaai,2023-07-29,16:00:00,243,107,136,FMN 01 Ernest Van Dijckkaai
649,Ernest Van Dijckkaai,2023-07-29,17:00:00,321,160,161,FMN 01 Ernest Van Dijckkaai
649,Ernest Van Dijckkaai,2023-07-29,18:00:00,299,139,160,FMN 01 Ernest Van Dijckkaai
649,Ernest Van Dijckkaai,2023-07-29,19:00:00,290,143,147,FMN 01 Ernest Van Dijckkaai
649,Ernest Van Dijckkaai,2023-07-29,20:00:00,264,126,138,FMN 01 Ernest Van Dijckkaai
649,Ernest Van Dijckkaai,2023-07-29,21:00:00,244,128,116,FMN 01 Ernest Van Dijckkaai
649,Ernest Van Dijckkaai,2023-07-29,22:00:00,178,79,99,FMN 01 Ernest Van Dijckkaai
649,Ernest Van Dijckkaai,2023-07-29,23:00:00,144,74,70,FMN 01 Ernest Van Dijckkaai
649,Ernest Van Dijckkaai,2023-07-30,00:00:00,115,48,67,FMN 01 Ernest Van Dijckkaai
649,Ernest Van Dijckkaai,2023-07-30,01:00:00,93,43,50,FMN 01 Ernest Van Dijckkaai
649,Ernest Van Dijckkaai,2023-07-30,02:00:00,62,11,51,FMN 01 Ernest Van Dijckkaai
649,Ernest Van Dijckkaai,2023-07-30,03:00:00,39,10,29,FMN 01 Ernest Van Dijckkaai
649,Ernest Van Dijckkaai,2023-07-30,04:00:00,52,14,38,FMN 01 Ernest Van Dijckkaai
649,Ernest Van Dijckkaai,2023-07-30,05:00:00,25,12,13,FMN 01 Ernest Van Dijckkaai
649,Ernest Van Dijckkaai,2023-07-30,06:00:00,46,16,30,FMN 01 Ernest Van Dijckkaai
649,Ernest Van Dijckkaai,2023-07-30,07:00:00,24,8,16,FMN 01 Ernest Van Dijckkaai
649,Ernest Van Dijckkaai,2023-07-30,08:00:00,75,28,47,FMN 01 Ernest Van Dijckkaai
649,Ernest Van Dijckkaai,2023-07-30,09:00:00,127,61,66,FMN 01 Ernest Van Dijckkaai
649,Ernest Van Dijckkaai,2023-07-30,10:00:00,187,110,77,FMN 01 Ernest Van Dijckkaai
649,Ernest Van Dijckkaai,2023-07-30,11:00:00,262,153,109,FMN 01 Ernest Van Dijckkaai
649,Ernest Van Dijckkaai,2023-07-30,12:00:00,305,155,150,FMN 01 Ernest Van Dijckkaai
649,Ernest Van Dijckkaai,2023-07-30,13:00:00,329,190,139,FMN 01 Ernest Van Dijckkaai
649,Ernest Van Dijckkaai,2023-07-30,14:00:00,452,246,206,FMN 01 Ernest Van Dijckkaai
649,Ernest Van Dijckkaai,2023-07-30,15:00:00,366,183,183,FMN 01 Ernest Van Dijckkaai
649,Ernest Van Dijckkaai,2023-07-30,16:00:00,411,221,190,FMN 01 Ernest Van Dijckkaai
649,Ernest Van Dijckkaai,2023-07-30,17:00:00,287,146,141,FMN 01 Ernest Van Dijckkaai
649,Ernest Van Dijckkaai,2023-07-30,18:00:00,188,75,113,FMN 01 Ernest Van Dijckkaai
649,Ernest Van Dijckkaai,2023-07-30,19:00:00,69,22,47,FMN 01 Ernest Van Dijckkaai
649,Ernest Van Dijckkaai,2023-07-30,20:00:00,71,26,45,FMN 01 Ernest Van Dijckkaai
649,Ernest Van Dijckkaai,2023-07-30,21:00:00,49,19,30,FMN 01 Ernest Van Dijckkaai
649,Ernest Van Dijckkaai,2023-07-30,22:00:00,49,10,39,FMN 01 Ernest Van Dijckkaai
649,Ernest Van Dijckkaai,2023-07-30,23:00:00,40,19,21,FMN 01 Ernest Van Dijckkaai
649,Ernest Van Dijckkaai,2023-07-31,00:00:00,19,8,11,FMN 01 Ernest Van Dijckkaai
649,Ernest Van Dijckkaai,2023-07-31,01:00:00,17,6,11,FMN 01 Ernest Van Dijckkaai
649,Ernest Van Dijckkaai,2023-07-31,02:00:00,11,5,6,FMN 01 Ernest Van Dijckkaai
649,Ernest Van Dijckkaai,2023-07-31,03:00:00,8,2,6,FMN 01 Ernest Van Dijckkaai
649,Ernest Van Dijckkaai,2023-07-31,04:00:00,61,41,20,FMN 01 Ernest Van Dijckkaai
649,Ernest Van Dijckkaai,2023-07-31,05:00:00,91,52,39,FMN 01 Ernest Van Dijckkaai
649,Ernest Van Dijckkaai,2023-07-31,06:00:00,140,97,43,FMN 01 Ernest Van Dijckkaai
649,Ernest Van Dijckkaai,2023-07-31,07:00:00,213,131,82,FMN 01 Ernest Van Dijckkaai
649,Ernest Van Dijckkaai,2023-07-31,08:00:00,225,129,96,FMN 01 Ernest Van Dijckkaai
649,Ernest Van Dijckkaai,2023-07-31,09:00:00,145,96,49,FMN 01 Ernest Van Dijckkaai
649,Ernest Van Dijckkaai,2023-07-31,10:00:00,112,59,53,FMN 01 Ernest Van Dijckkaai
649,Ernest Van Dijckkaai,2023-07-31,11:00:00,168,82,86,FMN 01 Ernest Van Dijckkaai
649,Ernest Van Dijckkaai,2023-07-31,12:00:00,232,130,102,FMN 01 Ernest Van Dijckkaai
649,Ernest Van Dijckkaai,2023-07-31,13:00:00,184,83,101,FMN 01 Ernest Van Dijckkaai
649,Ernest Van Dijckkaai,2023-07-31,14:00:00,201,94,107,FMN 01 Ernest Van Dijckkaai
649,Ernest Van Dijckkaai,2023-07-31,15:00:00,189,99,90,FMN 01 Ernest Van Dijckkaai
649,Ernest Van Dijckkaai,2023-07-31,16:00:00,290,95,195,FMN 01 Ernest Van Dijckkaai
649,Ernest Van Dijckkaai,2023-07-31,17:00:00,334,132,202,FMN 01 Ernest Van Dijckkaai
649,Ernest Van Dijckkaai,2023-07-31,18:00:00,152,75,77,FMN 01 Ernest Van Dijckkaai
649,Ernest Van Dijckkaai,2023-07-31,19:00:00,64,29,35,FMN 01 Ernest Van Dijckkaai
649,Ernest Van Dijckkaai,2023-07-31,20:00:00,75,38,37,FMN 01 Ernest Van Dijckkaai
649,Ernest Van Dijckkaai,2023-07-31,21:00:00,58,29,29,FMN 01 Ernest Van Dijckkaai
649,Ernest Van Dijckkaai,2023-07-31,22:00:00,65,23,42,FMN 01 Ernest Van Dijckkaai
649,Ernest Van Dijckkaai,2023-07-31,23:00:00,39,16,23,FMN 01 Ernest Van Dijckkaai
649,Ernest Van Dijckkaai,2023-08-01,00:00:00,18,7,11,FMN 01 Ernest Van Dijckkaai
649,Ernest Van Dijckkaai,2023-08-01,01:00:00,6,3,3,FMN 01 Ernest Van Dijckkaai
649,Ernest Van Dijckkaai,2023-08-01,02:00:00,4,2,2,FMN 01 Ernest Van Dijckkaai
649,Ernest Van Dijckkaai,2023-08-01,03:00:00,5,0,5,FMN 01 Ernest Van Dijckkaai
649,Ernest Van Dijckkaai,2023-08-01,04:00:00,59,41,18,FMN 01 Ernest Van Dijckkaai
649,Ernest Van Dijckkaai,2023-08-01,05:00:00,109,66,43,FMN 01 Ernest Van Dijckkaai
649,Ernest Van Dijckkaai,2023-08-01,06:00:00,174,117,57,FMN 01 Ernest Van Dijckkaai
649,Ernest Van Dijckkaai,2023-08-01,07:00:00,301,200,101,FMN 01 Ernest Van Dijckkaai
649,Ernest Van Dijckkaai,2023-08-01,08:00:00,351,222,129,FMN 01 Ernest Van Dijckkaai
649,Ernest Van Dijckkaai,2023-08-01,09:00:00,211,129,82,FMN 01 Ernest Van Dijckkaai
649,Ernest Van Dijckkaai,2023-08-01,10:00:00,133,69,64,FMN 01 Ernest Van Dijckkaai
649,Ernest Van Dijckkaai,2023-08-01,11:00:00,212,87,125,FMN 01 Ernest Van Dijckkaai
649,Ernest Van Dijckkaai,2023-08-01,12:00:00,240,128,112,FMN 01 Ernest Van Dijckkaai
649,Ernest Van Dijckkaai,2023-08-01,13:00:00,264,126,138,FMN 01 Ernest Van Dijckkaai
649,Ernest Van Dijckkaai,2023-08-01,14:00:00,337,162,175,FMN 01 Ernest Van Dijckkaai
649,Ernest Van Dijckkaai,2023-08-01,15:00:00,355,191,164,FMN 01 Ernest Van Dijckkaai
649,Ernest Van Dijckkaai,2023-08-01,16:00:00,501,190,311,FMN 01 Ernest Van Dijckkaai
649,Ernest Van Dijckkaai,2023-08-01,17:00:00,522,207,315,FMN 01 Ernest Van Dijckkaai
649,Ernest Van Dijckkaai,2023-08-01,18:00:00,392,173,219,FMN 01 Ernest Van Dijckkaai
649,Ernest Van Dijckkaai,2023-08-01,19:00:00,257,143,114,FMN 01 Ernest Van Dijckkaai
649,Ernest Van Dijckkaai,2023-08-01,20:00:00,224,119,105,FMN 01 Ernest Van Dijckkaai
649,Ernest Van Dijckkaai,2023-08-01,21:00:00,180,84,96,FMN 01 Ernest Van Dijckkaai
649,Ernest Van Dijckkaai,2023-08-01,22:00:00,184,77,107,FMN 01 Ernest Van Dijckkaai
649,Ernest Van Dijckkaai,2023-08-01,23:00:00,126,58,68,FMN 01 Ernest Van Dijckkaai
649,Ernest Van Dijckkaai,2023-08-02,00:00:00,52,21,31,FMN 01 Ernest Van Dijckkaai
649,Ernest Van Dijckkaai,2023-08-02,01:00:00,23,5,18,FMN 01 Ernest Van Dijckkaai
649,Ernest Van Dijckkaai,2023-08-02,02:00:00,12,6,6,FMN 01 Ernest Van Dijckkaai
649,Ernest Van Dijckkaai,2023-08-02,03:00:00,21,5,16,FMN 01 Ernest Van Dijckkaai
649,Ernest Van Dijckkaai,2023-08-02,04:00:00,65,39,26,FMN 01 Ernest Van Dijckkaai
649,Ernest Van Dijckkaai,2023-08-02,05:00:00,95,54,41,FMN 01 Ernest Van Dijckkaai
649,Ernest Van Dijckkaai,2023-08-02,06:00:00,143,94,49,FMN 01 Ernest Van Dijckkaai
649,Ernest Van Dijckkaai,2023-08-02,07:00:00,186,124,62,FMN 01 Ernest Van Dijckkaai
649,Ernest Van Dijckkaai,2023-08-02,08:00:00,212,124,88,FMN 01 Ernest Van Dijckkaai
649,Ernest Van Dijckkaai,2023-08-02,09:00:00,137,86,51,FMN 01 Ernest Van Dijckkaai
649,Ernest Van Dijckkaai,2023-08-02,10:00:00,116,66,50,FMN 01 Ernest Van Dijckkaai
649,Ernest Van Dijckkaai,2023-08-02,11:00:00,160,80,80,FMN 01 Ernest Van Dijckkaai
649,Ernest Van Dijckkaai,2023-08-02,12:00:00,179,91,88,FMN 01 Ernest Van Dijckkaai
649,Ernest Van Dijckkaai,2023-08-02,13:00:00,197,104,93,FMN 01 Ernest Van Dijckkaai
649,Ernest Van Dijckkaai,2023-08-02,14:00:00,253,109,144,FMN 01 Ernest Van Dijckkaai
649,Ernest Van Dijckkaai,2023-08-02,15:00:00,266,143,123,FMN 01 Ernest Van Dijckkaai
649,Ernest Van Dijckkaai,2023-08-02,16:00:00,409,171,238,FMN 01 Ernest Van Dijckkaai
649,Ernest Van Dijckkaai,2023-08-02,17:00:00,378,151,227,FMN 01 Ernest Van Dijckkaai
649,Ernest Van Dijckkaai,2023-08-02,18:00:00,322,147,175,FMN 01 Ernest Van Dijckkaai
649,Ernest Van Dijckkaai,2023-08-02,19:00:00,160,77,83,FMN 01 Ernest Van Dijckkaai
649,Ernest Van Dijckkaai,2023-08-02,20:00:00,101,45,56,FMN 01 Ernest Van Dijckkaai
649,Ernest Van Dijckkaai,2023-08-02,21:00:00,90,49,41,FMN 01 Ernest Van Dijckkaai
649,Ernest Van Dijckkaai,2023-08-02,22:00:00,96,31,65,FMN 01 Ernest Van Dijckkaai
649,Ernest Van Dijckkaai,2023-08-02,23:00:00,43,19,24,FMN 01 Ernest Van Dijckkaai
649,Ernest Van Dijckkaai,2023-08-03,00:00:00,39,10,29,FMN 01 Ernest Van Dijckkaai
649,Ernest Van Dijckkaai,2023-08-03,01:00:00,15,4,11,FMN 01 Ernest Van Dijckkaai
649,Ernest Van Dijckkaai,2023-08-03,02:00:00,7,1,6,FMN 01 Ernest Van Dijckkaai
649,Ernest Van Dijckkaai,2023-08-03,03:00:00,8,1,7,FMN 01 Ernest Van Dijckkaai
649,Ernest Van Dijckkaai,2023-08-03,04:00:00,48,37,11,FMN 01 Ernest Van Dijckkaai
649,Ernest Van Dijckkaai,2023-08-03,05:00:00,85,49,36,FMN 01 Ernest Van Dijckkaai
649,Ernest Van Dijckkaai,2023-08-03,06:00:00,135,87,48,FMN 01 Ernest Van Dijckkaai
649,Ernest Van Dijckkaai,2023-08-03,07:00:00,218,139,79,FMN 01 Ernest Van Dijckkaai
649,Ernest Van Dijckkaai,2023-08-03,08:00:00,282,179,103,FMN 01 Ernest Van Dijckkaai
649,Ernest Van Dijckkaai,2023-08-03,09:00:00,172,91,81,FMN 01 Ernest Van Dijckkaai
649,Ernest Van Dijckkaai,2023-08-03,10:00:00,92,49,43,FMN 01 Ernest Van Dijckkaai
649,Ernest Van Dijckkaai,2023-08-03,11:00:00,104,56,48,FMN 01 Ernest Van Dijckkaai
649,Ernest Van Dijckkaai,2023-08-03,12:00:00,148,80,68,FMN 01 Ernest Van Dijckkaai
649,Ernest Van Dijckkaai,2023-08-03,13:00:00,138,78,60,FMN 01 Ernest Van Dijckkaai
649,Ernest Van Dijckkaai,2023-08-03,14:00:00,217,82,135,FMN 01 Ernest Van Dijckkaai
649,Ernest Van Dijckkaai,2023-08-03,15:00:00,223,110,113,FMN 01 Ernest Van Dijckkaai
649,Ernest Van Dijckkaai,2023-08-03,16:00:00,389,165,224,FMN 01 Ernest Van Dijckkaai
649,Ernest Van Dijckkaai,2023-08-03,17:00:00,405,175,230,FMN 01 Ernest Van Dijckkaai
649,Ernest Van Dijckkaai,2023-08-03,18:00:00,335,163,172,FMN 01 Ernest Van Dijckkaai
649,Ernest Van Dijckkaai,2023-08-03,19:00:00,216,109,107,FMN 01 Ernest Van Dijckkaai
649,Ernest Van Dijckkaai,2023-08-03,20:00:00,203,105,98,FMN 01 Ernest Van Dijckkaai
649,Ernest Van Dijckkaai,2023-08-03,21:00:00,177,81,96,FMN 01 Ernest Van Dijckkaai
649,Ernest Van Dijckkaai,2023-08-03,22:00:00,194,81,113,FMN 01 Ernest Van Dijckkaai
649,Ernest Van Dijckkaai,2023-08-03,23:00:00,105,45,60,FMN 01 Ernest Van Dijckkaai
649,Ernest Van Dijckkaai,2023-08-04,00:00:00,85,45,40,FMN 01 Ernest Van Dijckkaai
649,Ernest Van Dijckkaai,2023-08-04,01:00:00,46,20,26,FMN 01 Ernest Van Dijckkaai
649,Ernest Van Dijckkaai,2023-08-04,02:00:00,26,7,19,FMN 01 Ernest Van Dijckkaai
649,Ernest Van Dijckkaai,2023-08-04,03:00:00,32,6,26,FMN 01 Ernest Van Dijckkaai
649,Ernest Van Dijckkaai,2023-08-04,04:00:00,62,36,26,FMN 01 Ernest Van Dijckkaai
649,Ernest Van Dijckkaai,2023-08-04,05:00:00,109,64,45,FMN 01 Ernest Van Dijckkaai
649,Ernest Van Dijckkaai,2023-08-04,06:00:00,166,101,65,FMN 01 Ernest Van Dijckkaai
649,Ernest Van Dijckkaai,2023-08-04,07:00:00,227,150,77,FMN 01 Ernest Van Dijckkaai
649,Ernest Van Dijckkaai,2023-08-04,08:00:00,262,162,100,FMN 01 Ernest Van Dijckkaai
649,Ernest Van Dijckkaai,2023-08-04,09:00:00,153,95,58,FMN 01 Ernest Van Dijckkaai
649,Ernest Van Dijckkaai,2023-08-04,10:00:00,132,79,53,FMN 01 Ernest Van Dijckkaai
649,Ernest Van Dijckkaai,2023-08-04,11:00:00,190,92,98,FMN 01 Ernest Van Dijckkaai
649,Ernest Van Dijckkaai,2023-08-04,12:00:00,276,141,135,FMN 01 Ernest Van Dijckkaai
649,Ernest Van Dijckkaai,2023-08-04,13:00:00,252,112,140,FMN 01 Ernest Van Dijckkaai
649,Ernest Van Dijckkaai,2023-08-04,14:00:00,301,131,170,FMN 01 Ernest Van Dijckkaai
649,Ernest Van Dijckkaai,2023-08-04,15:00:00,359,158,201,FMN 01 Ernest Van Dijckkaai
649,Ernest Van Dijckkaai,2023-08-04,16:00:00,499,234,265,FMN 01 Ernest Van Dijckkaai
649,Ernest Van Dijckkaai,2023-08-04,17:00:00,519,232,287,FMN 01 Ernest Van Dijckkaai
649,Ernest Van Dijckkaai,2023-08-04,18:00:00,389,197,192,FMN 01 Ernest Van Dijckkaai
649,Ernest Van Dijckkaai,2023-08-04,19:00:00,326,154,172,FMN 01 Ernest Van Dijckkaai
649,Ernest Van Dijckkaai,2023-08-04,20:00:00,282,140,142,FMN 01 Ernest Van Dijckkaai
649,Ernest Van Dijckkaai,2023-08-04,21:00:00,308,179,129,FMN 01 Ernest Van Dijckkaai
649,Ernest Van Dijckkaai,2023-08-04,22:00:00,273,144,129,FMN 01 Ernest Van Dijckkaai
649,Ernest Van Dijckkaai,2023-08-04,23:00:00,250,118,132,FMN 01 Ernest Van Dijckkaai
649,Ernest Van Dijckkaai,2023-08-05,00:00:00,189,77,112,FMN 01 Ernest Van Dijckkaai
649,Ernest Van Dijckkaai,2023-08-05,01:00:00,123,58,65,FMN 01 Ernest Van Dijckkaai
649,Ernest Van Dijckkaai,2023-08-05,02:00:00,107,44,63,FMN 01 Ernest Van Dijckkaai
649,Ernest Van Dijckkaai,2023-08-05,03:00:00,62,22,40,FMN 01 Ernest Van Dijckkaai
649,Ernest Van Dijckkaai,2023-08-05,04:00:00,51,13,38,FMN 01 Ernest Van Dijckkaai
649,Ernest Van Dijckkaai,2023-08-05,05:00:00,42,16,26,FMN 01 Ernest Van Dijckkaai
649,Ernest Van Dijckkaai,2023-08-05,06:00:00,53,17,36,FMN 01 Ernest Van Dijckkaai
649,Ernest Van Dijckkaai,2023-08-05,07:00:00,55,13,42,FMN 01 Ernest Van Dijckkaai
649,Ernest Van Dijckkaai,2023-08-05,08:00:00,95,47,48,FMN 01 Ernest Van Dijckkaai
649,Ernest Van Dijckkaai,2023-08-05,09:00:00,126,68,58,FMN 01 Ernest Van Dijckkaai
649,Ernest Van Dijckkaai,2023-08-05,10:00:00,203,118,85,FMN 01 Ernest Van Dijckkaai
649,Ernest Van Dijckkaai,2023-08-05,11:00:00,278,155,123,FMN 01 Ernest Van Dijckkaai
649,Ernest Van Dijckkaai,2023-08-05,12:00:00,272,136,136,FMN 01 Ernest Van Dijckkaai
649,Ernest Van Dijckkaai,2023-08-05,13:00:00,173,83,90,FMN 01 Ernest Van Dijckkaai
649,Ernest Van Dijckkaai,2023-08-05,14:00:00,195,92,103,FMN 01 Ernest Van Dijckkaai
649,Ernest Van Dijckkaai,2023-08-05,15:00:00,180,96,84,FMN 01 Ernest Van Dijckkaai
649,Ernest Van Dijckkaai,2023-08-05,16:00:00,187,97,90,FMN 01 Ernest Van Dijckkaai
649,Ernest Van Dijckkaai,2023-08-05,17:00:00,279,148,131,FMN 01 Ernest Van Dijckkaai
649,Ernest Van Dijckkaai,2023-08-05,18:00:00,226,126,100,FMN 01 Ernest Van Dijckkaai
649,Ernest Van Dijckkaai,2023-08-05,19:00:00,290,158,132,FMN 01 Ernest Van Dijckkaai
649,Ernest Van Dijckkaai,2023-08-05,20:00:00,238,130,108,FMN 01 Ernest Van Dijckkaai
649,Ernest Van Dijckkaai,2023-08-05,21:00:00,294,167,127,FMN 01 Ernest Van Dijckkaai
649,Ernest Van Dijckkaai,2023-08-05,22:00:00,363,241,122,FMN 01 Ernest Van Dijckkaai
649,Ernest Van Dijckkaai,2023-08-05,23:00:00,357,213,144,FMN 01 Ernest Van Dijckkaai
649,Ernest Van Dijckkaai,2023-08-06,00:00:00,242,122,120,FMN 01 Ernest Van Dijckkaai
649,Ernest Van Dijckkaai,2023-08-06,01:00:00,137,68,69,FMN 01 Ernest Van Dijckkaai
649,Ernest Van Dijckkaai,2023-08-06,02:00:00,49,5,44,FMN 01 Ernest Van Dijckkaai
649,Ernest Van Dijckkaai,2023-08-06,03:00:00,58,17,41,FMN 01 Ernest Van Dijckkaai
649,Ernest Van Dijckkaai,2023-08-06,04:00:00,18,4,14,FMN 01 Ernest Van Dijckkaai
649,Ernest Van Dijckkaai,2023-08-06,05:00:00,10,4,6,FMN 01 Ernest Van Dijckkaai
649,Ernest Van Dijckkaai,2023-08-06,06:00:00,17,10,7,FMN 01 Ernest Van Dijckkaai
649,Ernest Van Dijckkaai,2023-08-06,07:00:00,12,3,9,FMN 01 Ernest Van Dijckkaai
649,Ernest Van Dijckkaai,2023-08-06,08:00:00,27,14,13,FMN 01 Ernest Van Dijckkaai
649,Ernest Van Dijckkaai,2023-08-06,09:00:00,79,60,19,FMN 01 Ernest Van Dijckkaai
649,Ernest Van Dijckkaai,2023-08-06,10:00:00,62,37,25,FMN 01 Ernest Van Dijckkaai
649,Ernest Van Dijckkaai,2023-08-06,11:00:00,60,36,24,FMN 01 Ernest Van Dijckkaai
649,Ernest Van Dijckkaai,2023-08-06,12:00:00,79,45,34,FMN 01 Ernest Van Dijckkaai
649,Ernest Van Dijckkaai,2023-08-06,13:00:00,124,74,50,FMN 01 Ernest Van Dijckkaai
649,Ernest Van Dijckkaai,2023-08-06,14:00:00,64,32,32,FMN 01 Ernest Van Dijckkaai
649,Ernest Van Dijckkaai,2023-08-06,15:00:00,68,39,29,FMN 01 Ernest Van Dijckkaai
649,Ernest Van Dijckkaai,2023-08-06,16:00:00,50,26,24,FMN 01 Ernest Van Dijckkaai
649,Ernest Van Dijckkaai,2023-08-06,17:00:00,66,31,35,FMN 01 Ernest Van Dijckkaai
649,Ernest Van Dijckkaai,2023-08-06,18:00:00,100,64,36,FMN 01 Ernest Van Dijckkaai
649,Ernest Van Dijckkaai,2023-08-06,19:00:00,92,40,52,FMN 01 Ernest Van Dijckkaai
649,Ernest Van Dijckkaai,2023-08-06,20:00:00,137,66,71,FMN 01 Ernest Van Dijckkaai
649,Ernest Van Dijckkaai,2023-08-06,21:00:00,81,40,41,FMN 01 Ernest Van Dijckkaai
649,Ernest Van Dijckkaai,2023-08-06,22:00:00,66,20,46,FMN 01 Ernest Van Dijckkaai
649,Ernest Van Dijckkaai,2023-08-06,23:00:00,43,14,29,FMN 01 Ernest Van Dijckkaai
649,Ernest Van Dijckkaai,2023-08-07,00:00:00,20,7,13,FMN 01 Ernest Van Dijckkaai
649,Ernest Van Dijckkaai,2023-08-07,01:00:00,16,5,11,FMN 01 Ernest Van Dijckkaai
649,Ernest Van Dijckkaai,2023-08-07,02:00:00,15,12,3,FMN 01 Ernest Van Dijckkaai
649,Ernest Van Dijckkaai,2023-08-07,03:00:00,10,3,7,FMN 01 Ernest Van Dijckkaai
649,Ernest Van Dijckkaai,2023-08-07,04:00:00,53,35,18,FMN 01 Ernest Van Dijckkaai
649,Ernest Van Dijckkaai,2023-08-07,05:00:00,102,66,36,FMN 01 Ernest Van Dijckkaai
649,Ernest Van Dijckkaai,2023-08-07,06:00:00,176,123,53,FMN 01 Ernest Van Dijckkaai
649,Ernest Van Dijckkaai,2023-08-07,07:00:00,308,196,112,FMN 01 Ernest Van Dijckkaai
649,Ernest Van Dijckkaai,2023-08-07,08:00:00,353,215,138,FMN 01 Ernest Van Dijckkaai
649,Ernest Van Dijckkaai,2023-08-07,09:00:00,232,130,102,FMN 01 Ernest Van Dijckkaai
649,Ernest Van Dijckkaai,2023-08-07,10:00:00,155,97,58,FMN 01 Ernest Van Dijckkaai
649,Ernest Van Dijckkaai,2023-08-07,11:00:00,198,113,85,FMN 01 Ernest Van Dijckkaai
649,Ernest Van Dijckkaai,2023-08-07,12:00:00,277,138,139,FMN 01 Ernest Van Dijckkaai
649,Ernest Van Dijckkaai,2023-08-07,13:00:00,259,146,113,FMN 01 Ernest Van Dijckkaai
649,Ernest Van Dijckkaai,2023-08-07,14:00:00,321,157,164,FMN 01 Ernest Van Dijckkaai
649,Ernest Van Dijckkaai,2023-08-07,15:00:00,393,175,218,FMN 01 Ernest Van Dijckkaai
649,Ernest Van Dijckkaai,2023-08-07,16:00:00,543,240,303,FMN 01 Ernest Van Dijckkaai
649,Ernest Van Dijckkaai,2023-08-07,17:00:00,587,255,332,FMN 01 Ernest Van Dijckkaai
649,Ernest Van Dijckkaai,2023-08-07,18:00:00,407,180,227,FMN 01 Ernest Van Dijckkaai
649,Ernest Van Dijckkaai,2023-08-07,19:00:00,228,98,130,FMN 01 Ernest Van Dijckkaai
649,Ernest Van Dijckkaai,2023-08-07,20:00:00,226,123,103,FMN 01 Ernest Van Dijckkaai
649,Ernest Van Dijckkaai,2023-08-07,21:00:00,191,86,105,FMN 01 Ernest Van Dijckkaai
649,Ernest Van Dijckkaai,2023-08-07,22:00:00,167,54,113,FMN 01 Ernest Van Dijckkaai
649,Ernest Van Dijckkaai,2023-08-07,23:00:00,97,41,56,FMN 01 Ernest Van Dijckkaai
649,Ernest Van Dijckkaai,2023-08-08,00:00:00,31,15,16,FMN 01 Ernest Van Dijckkaai
649,Ernest Van Dijckkaai,2023-08-08,01:00:00,26,6,20,FMN 01 Ernest Van Dijckkaai
649,Ernest Van Dijckkaai,2023-08-08,02:00:00,20,11,9,FMN 01 Ernest Van Dijckkaai
649,Ernest Van Dijckkaai,2023-08-08,03:00:00,7,2,5,FMN 01 Ernest Van Dijckkaai
649,Ernest Van Dijckkaai,2023-08-08,04:00:00,56,37,19,FMN 01 Ernest Van Dijckkaai
649,Ernest Van Dijckkaai,2023-08-08,05:00:00,120,74,46,FMN 01 Ernest Van Dijckkaai
649,Ernest Van Dijckkaai,2023-08-08,06:00:00,225,143,82,FMN 01 Ernest Van Dijckkaai
649,Ernest Van Dijckkaai,2023-08-08,07:00:00,366,226,140,FMN 01 Ernest Van Dijckkaai
649,Ernest Van Dijckkaai,2023-08-08,08:00:00,438,238,200,FMN 01 Ernest Van Dijckkaai
649,Ernest Van Dijckkaai,2023-08-08,09:00:00,224,127,97,FMN 01 Ernest Van Dijckkaai
649,Ernest Van Dijckkaai,2023-08-08,10:00:00,173,107,66,FMN 01 Ernest Van Dijckkaai
649,Ernest Van Dijckkaai,2023-08-08,11:00:00,183,95,88,FMN 01 Ernest Van Dijckkaai
649,Ernest Van Dijckkaai,2023-08-08,12:00:00,249,133,116,FMN 01 Ernest Van Dijckkaai
649,Ernest Van Dijckkaai,2023-08-08,13:00:00,261,150,111,FMN 01 Ernest Van Dijckkaai
649,Ernest Van Dijckkaai,2023-08-08,14:00:00,289,146,143,FMN 01 Ernest Van Dijckkaai
649,Ernest Van Dijckkaai,2023-08-08,15:00:00,435,200,235,FMN 01 Ernest Van Dijckkaai
649,Ernest Van Dijckkaai,2023-08-08,16:00:00,633,311,322,FMN 01 Ernest Van Dijckkaai
649,Ernest Van Dijckkaai,2023-08-08,17:00:00,643,261,382,FMN 01 Ernest Van Dijckkaai
649,Ernest Van Dijckkaai,2023-08-08,18:00:00,362,176,186,FMN 01 Ernest Van Dijckkaai
649,Ernest Van Dijckkaai,2023-08-08,19:00:00,197,88,109,FMN 01 Ernest Van Dijckkaai
649,Ernest Van Dijckkaai,2023-08-08,20:00:00,159,77,82,FMN 01 Ernest Van Dijckkaai
649,Ernest Van Dijckkaai,2023-08-08,21:00:00,93,53,40,FMN 01 Ernest Van Dijckkaai
649,Ernest Van Dijckkaai,2023-08-08,22:00:00,118,38,80,FMN 01 Ernest Van Dijckkaai
649,Ernest Van Dijckkaai,2023-08-08,23:00:00,65,25,40,FMN 01 Ernest Van Dijckkaai
649,Ernest Van Dijckkaai,2023-08-09,00:00:00,38,19,19,FMN 01 Ernest Van Dijckkaai
649,Ernest Van Dijckkaai,2023-08-09,01:00:00,30,8,22,FMN 01 Ernest Van Dijckkaai
649,Ernest Van Dijckkaai,2023-08-09,02:00:00,14,7,7,FMN 01 Ernest Van Dijckkaai
649,Ernest Van Dijckkaai,2023-08-09,03:00:00,15,3,12,FMN 01 Ernest Van Dijckkaai
649,Ernest Van Dijckkaai,2023-08-09,04:00:00,53,32,21,FMN 01 Ernest Van Dijckkaai
649,Ernest Van Dijckkaai,2023-08-09,05:00:00,106,64,42,FMN 01 Ernest Van Dijckkaai
649,Ernest Van Dijckkaai,2023-08-09,06:00:00,189,115,74,FMN 01 Ernest Van Dijckkaai
649,Ernest Van Dijckkaai,2023-08-09,07:00:00,342,221,121,FMN 01 Ernest Van Dijckkaai
649,Ernest Van Dijckkaai,2023-08-09,08:00:00,375,221,154,FMN 01 Ernest Van Dijckkaai
649,Ernest Van Dijckkaai,2023-08-09,09:00:00,272,168,104,FMN 01 Ernest Van Dijckkaai
649,Ernest Van Dijckkaai,2023-08-09,10:00:00,219,116,103,FMN 01 Ernest Van Dijckkaai
649,Ernest Van Dijckkaai,2023-08-09,11:00:00,320,183,137,FMN 01 Ernest Van Dijckkaai
649,Ernest Van Dijckkaai,2023-08-09,12:00:00,371,195,176,FMN 01 Ernest Van Dijckkaai
649,Ernest Van Dijckkaai,2023-08-09,13:00:00,378,207,171,FMN 01 Ernest Van Dijckkaai
649,Ernest Van Dijckkaai,2023-08-09,14:00:00,494,243,251,FMN 01 Ernest Van Dijckkaai
649,Ernest Van Dijckkaai,2023-08-09,15:00:00,554,276,278,FMN 01 Ernest Van Dijckkaai
649,Ernest Van Dijckkaai,2023-08-09,16:00:00,662,300,362,FMN 01 Ernest Van Dijckkaai
649,Ernest Van Dijckkaai,2023-08-09,17:00:00,743,319,424,FMN 01 Ernest Van Dijckkaai
649,Ernest Van Dijckkaai,2023-08-09,18:00:00,540,277,263,FMN 01 Ernest Van Dijckkaai
649,Ernest Van Dijckkaai,2023-08-09,19:00:00,410,191,219,FMN 01 Ernest Van Dijckkaai
649,Ernest Van Dijckkaai,2023-08-09,20:00:00,347,158,189,FMN 01 Ernest Van Dijckkaai
649,Ernest Van Dijckkaai,2023-08-09,21:00:00,276,135,141,FMN 01 Ernest Van Dijckkaai
649,Ernest Van Dijckkaai,2023-08-09,22:00:00,199,78,121,FMN 01 Ernest Van Dijckkaai
649,Ernest Van Dijckkaai,2023-08-09,23:00:00,101,43,58,FMN 01 Ernest Van Dijckkaai
649,Ernest Van Dijckkaai,2023-08-10,00:00:00,66,27,39,FMN 01 Ernest Van Dijckkaai
649,Ernest Van Dijckkaai,2023-08-10,01:00:00,24,9,15,FMN 01 Ernest Van Dijckkaai
649,Ernest Van Dijckkaai,2023-08-10,02:00:00,15,5,10,FMN 01 Ernest Van Dijckkaai
649,Ernest Van Dijckkaai,2023-08-10,03:00:00,14,5,9,FMN 01 Ernest Van Dijckkaai
649,Ernest Van Dijckkaai,2023-08-10,04:00:00,53,33,20,FMN 01 Ernest Van Dijckkaai
649,Ernest Van Dijckkaai,2023-08-10,05:00:00,139,78,61,FMN 01 Ernest Van Dijckkaai
649,Ernest Van Dijckkaai,2023-08-10,06:00:00,231,140,91,FMN 01 Ernest Van Dijckkaai
649,Ernest Van Dijckkaai,2023-08-10,07:00:00,338,203,135,FMN 01 Ernest Van Dijckkaai
649,Ernest Van Dijckkaai,2023-08-10,08:00:00,437,263,174,FMN 01 Ernest Van Dijckkaai
649,Ernest Van Dijckkaai,2023-08-10,09:00:00,303,190,113,FMN 01 Ernest Van Dijckkaai
649,Ernest Van Dijckkaai,2023-08-10,10:00:00,254,140,114,FMN 01 Ernest Van Dijckkaai
649,Ernest Van Dijckkaai,2023-08-10,11:00:00,413,218,195,FMN 01 Ernest Van Dijckkaai
649,Ernest Van Dijckkaai,2023-08-10,12:00:00,484,277,207,FMN 01 Ernest Van Dijckkaai
649,Ernest Van Dijckkaai,2023-08-10,13:00:00,474,291,183,FMN 01 Ernest Van Dijckkaai
649,Ernest Van Dijckkaai,2023-08-10,14:00:00,577,301,276,FMN 01 Ernest Van Dijckkaai
649,Ernest Van Dijckkaai,2023-08-10,15:00:00,670,329,341,FMN 01 Ernest Van Dijckkaai
649,Ernest Van Dijckkaai,2023-08-10,16:00:00,765,336,429,FMN 01 Ernest Van Dijckkaai
649,Ernest Van Dijckkaai,2023-08-10,17:00:00,819,375,444,FMN 01 Ernest Van Dijckkaai
649,Ernest Van Dijckkaai,2023-08-10,18:00:00,697,321,376,FMN 01 Ernest Van Dijckkaai
649,Ernest Van Dijckkaai,2023-08-10,19:00:00,526,245,281,FMN 01 Ernest Van Dijckkaai
649,Ernest Van Dijckkaai,2023-08-10,20:00:00,403,191,212,FMN 01 Ernest Van Dijckkaai
649,Ernest Van Dijckkaai,2023-08-10,21:00:00,367,164,203,FMN 01 Ernest Van Dijckkaai
649,Ernest Van Dijckkaai,2023-08-10,22:00:00,284,111,173,FMN 01 Ernest Van Dijckkaai
649,Ernest Van Dijckkaai,2023-08-10,23:00:00,185,75,110,FMN 01 Ernest Van Dijckkaai
649,Ernest Van Dijckkaai,2023-08-11,00:00:00,139,66,73,FMN 01 Ernest Van Dijckkaai
649,Ernest Van Dijckkaai,2023-08-11,01:00:00,69,28,41,FMN 01 Ernest Van Dijckkaai
649,Ernest Van Dijckkaai,2023-08-11,02:00:00,39,11,28,FMN 01 Ernest Van Dijckkaai
649,Ernest Van Dijckkaai,2023-08-11,03:00:00,24,7,17,FMN 01 Ernest Van Dijckkaai
649,Ernest Van Dijckkaai,2023-08-11,04:00:00,61,33,28,FMN 01 Ernest Van Dijckkaai
649,Ernest Van Dijckkaai,2023-08-11,05:00:00,142,79,63,FMN 01 Ernest Van Dijckkaai
649,Ernest Van Dijckkaai,2023-08-11,06:00:00,217,130,87,FMN 01 Ernest Van Dijckkaai
649,Ernest Van Dijckkaai,2023-08-11,07:00:00,276,168,108,FMN 01 Ernest Van Dijckkaai
649,Ernest Van Dijckkaai,2023-08-11,08:00:00,391,220,171,FMN 01 Ernest Van Dijckkaai
649,Ernest Van Dijckkaai,2023-08-11,09:00:00,273,161,112,FMN 01 Ernest Van Dijckkaai
649,Ernest Van Dijckkaai,2023-08-11,10:00:00,332,153,179,FMN 01 Ernest Van Dijckkaai
649,Ernest Van Dijckkaai,2023-08-11,11:00:00,379,215,164,FMN 01 Ernest Van Dijckkaai
649,Ernest Van Dijckkaai,2023-08-11,12:00:00,428,214,214,FMN 01 Ernest Van Dijckkaai
649,Ernest Van Dijckkaai,2023-08-11,13:00:00,408,230,178,FMN 01 Ernest Van Dijckkaai
649,Ernest Van Dijckkaai,2023-08-11,14:00:00,567,280,287,FMN 01 Ernest Van Dijckkaai
649,Ernest Van Dijckkaai,2023-08-11,15:00:00,618,298,320,FMN 01 Ernest Van Dijckkaai
649,Ernest Van Dijckkaai,2023-08-11,16:00:00,683,312,371,FMN 01 Ernest Van Dijckkaai
649,Ernest Van Dijckkaai,2023-08-11,17:00:00,634,308,326,FMN 01 Ernest Van Dijckkaai
649,Ernest Van Dijckkaai,2023-08-11,18:00:00,480,255,225,FMN 01 Ernest Van Dijckkaai
649,Ernest Van Dijckkaai,2023-08-11,19:00:00,374,189,185,FMN 01 Ernest Van Dijckkaai
649,Ernest Van Dijckkaai,2023-08-11,20:00:00,269,132,137,FMN 01 Ernest Van Dijckkaai
649,Ernest Van Dijckkaai,2023-08-11,21:00:00,270,131,139,FMN 01 Ernest Van Dijckkaai
649,Ernest Van Dijckkaai,2023-08-11,22:00:00,230,89,141,FMN 01 Ernest Van Dijckkaai
649,Ernest Van Dijckkaai,2023-08-11,23:00:00,166,57,109,FMN 01 Ernest Van Dijckkaai
649,Ernest Van Dijckkaai,2023-08-12,00:00:00,148,55,93,FMN 01 Ernest Van Dijckkaai
649,Ernest Van Dijckkaai,2023-08-12,01:00:00,57,18,39,FMN 01 Ernest Van Dijckkaai
649,Ernest Van Dijckkaai,2023-08-12,02:00:00,72,21,51,FMN 01 Ernest Van Dijckkaai
649,Ernest Van Dijckkaai,2023-08-12,03:00:00,39,15,24,FMN 01 Ernest Van Dijckkaai
649,Ernest Van Dijckkaai,2023-08-12,04:00:00,39,13,26,FMN 01 Ernest Van Dijckkaai
649,Ernest Van Dijckkaai,2023-08-12,05:00:00,31,11,20,FMN 01 Ernest Van Dijckkaai
649,Ernest Van Dijckkaai,2023-08-12,06:00:00,28,10,18,FMN 01 Ernest Van Dijckkaai
649,Ernest Van Dijckkaai,2023-08-12,07:00:00,41,14,27,FMN 01 Ernest Van Dijckkaai
649,Ernest Van Dijckkaai,2023-08-12,08:00:00,55,30,25,FMN 01 Ernest Van Dijckkaai
649,Ernest Van Dijckkaai,2023-08-12,09:00:00,112,65,47,FMN 01 Ernest Van Dijckkaai
649,Ernest Van Dijckkaai,2023-08-12,10:00:00,163,92,71,FMN 01 Ernest Van Dijckkaai
649,Ernest Van Dijckkaai,2023-08-12,11:00:00,216,109,107,FMN 01 Ernest Van Dijckkaai
649,Ernest Van Dijckkaai,2023-08-12,12:00:00,316,165,151,FMN 01 Ernest Van Dijckkaai
649,Ernest Van Dijckkaai,2023-08-12,13:00:00,470,277,193,FMN 01 Ernest Van Dijckkaai
649,Ernest Van Dijckkaai,2023-08-12,14:00:00,522,276,246,FMN 01 Ernest Van Dijckkaai
649,Ernest Van Dijckkaai,2023-08-12,15:00:00,452,243,209,FMN 01 Ernest Van Dijckkaai
649,Ernest Van Dijckkaai,2023-08-12,16:00:00,575,297,278,FMN 01 Ernest Van Dijckkaai
649,Ernest Van Dijckkaai,2023-08-12,17:00:00,645,340,305,FMN 01 Ernest Van Dijckkaai
649,Ernest Van Dijckkaai,2023-08-12,18:00:00,636,311,325,FMN 01 Ernest Van Dijckkaai
649,Ernest Van Dijckkaai,2023-08-12,19:00:00,542,278,264,FMN 01 Ernest Van Dijckkaai
649,Ernest Van Dijckkaai,2023-08-12,20:00:00,522,238,284,FMN 01 Ernest Van Dijckkaai
649,Ernest Van Dijckkaai,2023-08-12,21:00:00,477,226,251,FMN 01 Ernest Van Dijckkaai
649,Ernest Van Dijckkaai,2023-08-12,22:00:00,504,263,241,FMN 01 Ernest Van Dijckkaai
649,Ernest Van Dijckkaai,2023-08-12,23:00:00,397,214,183,FMN 01 Ernest Van Dijckkaai
649,Ernest Van Dijckkaai,2023-08-13,00:00:00,330,216,114,FMN 01 Ernest Van Dijckkaai
649,Ernest Van Dijckkaai,2023-08-13,01:00:00,148,69,79,FMN 01 Ernest Van Dijckkaai
649,Ernest Van Dijckkaai,2023-08-13,02:00:00,106,21,85,FMN 01 Ernest Van Dijckkaai
649,Ernest Van Dijckkaai,2023-08-13,03:00:00,90,11,79,FMN 01 Ernest Van Dijckkaai
649,Ernest Van Dijckkaai,2023-08-13,04:00:00,66,11,55,FMN 01 Ernest Van Dijckkaai
649,Ernest Van Dijckkaai,2023-08-13,05:00:00,52,19,33,FMN 01 Ernest Van Dijckkaai
649,Ernest Van Dijckkaai,2023-08-13,06:00:00,54,19,35,FMN 01 Ernest Van Dijckkaai
649,Ernest Van Dijckkaai,2023-08-13,07:00:00,41,19,22,FMN 01 Ernest Van Dijckkaai
649,Ernest Van Dijckkaai,2023-08-13,08:00:00,71,34,37,FMN 01 Ernest Van Dijckkaai
649,Ernest Van Dijckkaai,2023-08-13,09:00:00,199,98,101,FMN 01 Ernest Van Dijckkaai
649,Ernest Van Dijckkaai,2023-08-13,10:00:00,300,154,146,FMN 01 Ernest Van Dijckkaai
649,Ernest Van Dijckkaai,2023-08-13,11:00:00,387,210,177,FMN 01 Ernest Van Dijckkaai
649,Ernest Van Dijckkaai,2023-08-13,12:00:00,500,286,214,FMN 01 Ernest Van Dijckkaai
649,Ernest Van Dijckkaai,2023-08-13,13:00:00,559,297,262,FMN 01 Ernest Van Dijckkaai
649,Ernest Van Dijckkaai,2023-08-13,14:00:00,745,379,366,FMN 01 Ernest Van Dijckkaai
649,Ernest Van Dijckkaai,2023-08-13,15:00:00,717,357,360,FMN 01 Ernest Van Dijckkaai
649,Ernest Van Dijckkaai,2023-08-13,16:00:00,642,269,373,FMN 01 Ernest Van Dijckkaai
649,Ernest Van Dijckkaai,2023-08-13,17:00:00,619,266,353,FMN 01 Ernest Van Dijckkaai
649,Ernest Van Dijckkaai,2023-08-13,18:00:00,485,212,273,FMN 01 Ernest Van Dijckkaai
649,Ernest Van Dijckkaai,2023-08-13,19:00:00,502,281,221,FMN 01 Ernest Van Dijckkaai
649,Ernest Van Dijckkaai,2023-08-13,20:00:00,434,235,199,FMN 01 Ernest Van Dijckkaai
649,Ernest Van Dijckkaai,2023-08-13,21:00:00,367,190,177,FMN 01 Ernest Van Dijckkaai
649,Ernest Van Dijckkaai,2023-08-13,22:00:00,267,117,150,FMN 01 Ernest Van Dijckkaai
649,Ernest Van Dijckkaai,2023-08-13,23:00:00,179,112,67,FMN 01 Ernest Van Dijckkaai
649,Ernest Van Dijckkaai,2023-08-14,00:00:00,109,36,73,FMN 01 Ernest Van Dijckkaai
649,Ernest Van Dijckkaai,2023-08-14,01:00:00,52,14,38,FMN 01 Ernest Van Dijckkaai
649,Ernest Van Dijckkaai,2023-08-14,02:00:00,46,21,25,FMN 01 Ernest Van Dijckkaai
649,Ernest Van Dijckkaai,2023-08-14,03:00:00,26,12,14,FMN 01 Ernest Van Dijckkaai
649,Ernest Van Dijckkaai,2023-08-14,04:00:00,45,26,19,FMN 01 Ernest Van Dijckkaai
649,Ernest Van Dijckkaai,2023-08-14,05:00:00,86,56,30,FMN 01 Ernest Van Dijckkaai
649,Ernest Van Dijckkaai,2023-08-14,06:00:00,89,52,37,FMN 01 Ernest Van Dijckkaai
649,Ernest Van Dijckkaai,2023-08-14,07:00:00,175,104,71,FMN 01 Ernest Van Dijckkaai
649,Ernest Van Dijckkaai,2023-08-14,08:00:00,221,123,98,FMN 01 Ernest Van Dijckkaai
649,Ernest Van Dijckkaai,2023-08-14,09:00:00,197,103,94,FMN 01 Ernest Van Dijckkaai
649,Ernest Van Dijckkaai,2023-08-14,10:00:00,276,140,136,FMN 01 Ernest Van Dijckkaai
649,Ernest Van Dijckkaai,2023-08-14,11:00:00,295,171,124,FMN 01 Ernest Van Dijckkaai
649,Ernest Van Dijckkaai,2023-08-14,12:00:00,402,216,186,FMN 01 Ernest Van Dijckkaai
649,Ernest Van Dijckkaai,2023-08-14,13:00:00,480,244,236,FMN 01 Ernest Van Dijckkaai
649,Ernest Van Dijckkaai,2023-08-14,14:00:00,524,257,267,FMN 01 Ernest Van Dijckkaai
649,Ernest Van Dijckkaai,2023-08-14,15:00:00,563,252,311,FMN 01 Ernest Van Dijckkaai
649,Ernest Van Dijckkaai,2023-08-14,16:00:00,610,312,298,FMN 01 Ernest Van Dijckkaai
649,Ernest Van Dijckkaai,2023-08-14,17:00:00,595,276,319,FMN 01 Ernest Van Dijckkaai
649,Ernest Van Dijckkaai,2023-08-14,18:00:00,489,242,247,FMN 01 Ernest Van Dijckkaai
649,Ernest Van Dijckkaai,2023-08-14,19:00:00,446,241,205,FMN 01 Ernest Van Dijckkaai
649,Ernest Van Dijckkaai,2023-08-14,20:00:00,482,236,246,FMN 01 Ernest Van Dijckkaai
649,Ernest Van Dijckkaai,2023-08-14,21:00:00,362,174,188,FMN 01 Ernest Van Dijckkaai
649,Ernest Van Dijckkaai,2023-08-14,22:00:00,273,108,165,FMN 01 Ernest Van Dijckkaai
649,Ernest Van Dijckkaai,2023-08-14,23:00:00,167,82,85,FMN 01 Ernest Van Dijckkaai
649,Ernest Van Dijckkaai,2023-08-15,00:00:00,119,51,68,FMN 01 Ernest Van Dijckkaai
649,Ernest Van Dijckkaai,2023-08-15,01:00:00,45,9,36,FMN 01 Ernest Van Dijckkaai
649,Ernest Van Dijckkaai,2023-08-15,02:00:00,46,26,20,FMN 01 Ernest Van Dijckkaai
649,Ernest Van Dijckkaai,2023-08-15,03:00:00,25,4,21,FMN 01 Ernest Van Dijckkaai
649,Ernest Van Dijckkaai,2023-08-15,04:00:00,59,15,44,FMN 01 Ernest Van Dijckkaai
649,Ernest Van Dijckkaai,2023-08-15,05:00:00,41,23,18,FMN 01 Ernest Van Dijckkaai
649,Ernest Van Dijckkaai,2023-08-15,06:00:00,31,15,16,FMN 01 Ernest Van Dijckkaai
649,Ernest Van Dijckkaai,2023-08-15,07:00:00,5,4,1,FMN 01 Ernest Van Dijckkaai
649,Ernest Van Dijckkaai,2023-08-15,08:00:00,1,0,1,FMN 01 Ernest Van Dijckkaai
649,Ernest Van Dijckkaai,2023-08-15,09:00:00,10,3,7,FMN 01 Ernest Van Dijckkaai
649,Ernest Van Dijckkaai,2023-08-15,10:00:00,12,1,11,FMN 01 Ernest Van Dijckkaai
649,Ernest Van Dijckkaai,2023-08-15,11:00:00,48,22,26,FMN 01 Ernest Van Dijckkaai
649,Ernest Van Dijckkaai,2023-08-15,12:00:00,88,69,19,FMN 01 Ernest Van Dijckkaai
649,Ernest Van Dijckkaai,2023-08-15,13:00:00,75,56,19,FMN 01 Ernest Van Dijckkaai
649,Ernest Van Dijckkaai,2023-08-15,14:00:00,138,93,45,FMN 01 Ernest Van Dijckkaai
649,Ernest Van Dijckkaai,2023-08-15,15:00:00,43,16,27,FMN 01 Ernest Van Dijckkaai
649,Ernest Van Dijckkaai,2023-08-15,16:00:00,76,21,55,FMN 01 Ernest Van Dijckkaai
649,Ernest Van Dijckkaai,2023-08-15,17:00:00,55,14,41,FMN 01 Ernest Van Dijckkaai
649,Ernest Van Dijckkaai,2023-08-15,18:00:00,62,27,35,FMN 01 Ernest Van Dijckkaai
649,Ernest Van Dijckkaai,2023-08-15,19:00:00,88,57,31,FMN 01 Ernest Van Dijckkaai
649,Ernest Van Dijckkaai,2023-08-15,20:00:00,54,33,21,FMN 01 Ernest Van Dijckkaai
649,Ernest Van Dijckkaai,2023-08-15,21:00:00,55,30,25,FMN 01 Ernest Van Dijckkaai
649,Ernest Van Dijckkaai,2023-08-15,22:00:00,119,52,67,FMN 01 Ernest Van Dijckkaai
649,Ernest Van Dijckkaai,2023-08-15,23:00:00,99,38,61,FMN 01 Ernest Van Dijckkaai
649,Ernest Van Dijckkaai,2023-08-16,00:00:00,62,21,41,FMN 01 Ernest Van Dijckkaai
649,Ernest Van Dijckkaai,2023-08-16,01:00:00,32,13,19,FMN 01 Ernest Van Dijckkaai
649,Ernest Van Dijckkaai,2023-08-16,02:00:00,20,6,14,FMN 01 Ernest Van Dijckkaai
649,Ernest Van Dijckkaai,2023-08-16,03:00:00,19,5,14,FMN 01 Ernest Van Dijckkaai
649,Ernest Van Dijckkaai,2023-08-16,04:00:00,48,25,23,FMN 01 Ernest Van Dijckkaai
649,Ernest Van Dijckkaai,2023-08-16,05:00:00,114,66,48,FMN 01 Ernest Van Dijckkaai
649,Ernest Van Dijckkaai,2023-08-16,06:00:00,211,141,70,FMN 01 Ernest Van Dijckkaai
649,Ernest Van Dijckkaai,2023-08-16,07:00:00,373,216,157,FMN 01 Ernest Van Dijckkaai
649,Ernest Van Dijckkaai,2023-08-16,08:00:00,497,289,208,FMN 01 Ernest Van Dijckkaai
649,Ernest Van Dijckkaai,2023-08-16,09:00:00,283,170,113,FMN 01 Ernest Van Dijckkaai
649,Ernest Van Dijckkaai,2023-08-16,10:00:00,255,145,110,FMN 01 Ernest Van Dijckkaai
649,Ernest Van Dijckkaai,2023-08-16,11:00:00,291,156,135,FMN 01 Ernest Van Dijckkaai
649,Ernest Van Dijckkaai,2023-08-16,12:00:00,380,186,194,FMN 01 Ernest Van Dijckkaai
649,Ernest Van Dijckkaai,2023-08-16,13:00:00,379,179,200,FMN 01 Ernest Van Dijckkaai
649,Ernest Van Dijckkaai,2023-08-16,14:00:00,433,225,208,FMN 01 Ernest Van Dijckkaai
649,Ernest Van Dijckkaai,2023-08-16,15:00:00,489,237,252,FMN 01 Ernest Van Dijckkaai
649,Ernest Van Dijckkaai,2023-08-16,16:00:00,708,323,385,FMN 01 Ernest Van Dijckkaai
649,Ernest Van Dijckkaai,2023-08-16,17:00:00,810,309,501,FMN 01 Ernest Van Dijckkaai
649,Ernest Van Dijckkaai,2023-08-16,18:00:00,508,234,274,FMN 01 Ernest Van Dijckkaai
649,Ernest Van Dijckkaai,2023-08-16,19:00:00,346,150,196,FMN 01 Ernest Van Dijckkaai
649,Ernest Van Dijckkaai,2023-08-16,20:00:00,279,150,129,FMN 01 Ernest Van Dijckkaai
649,Ernest Van Dijckkaai,2023-08-16,21:00:00,307,159,148,FMN 01 Ernest Van Dijckkaai
649,Ernest Van Dijckkaai,2023-08-16,22:00:00,231,92,139,FMN 01 Ernest Van Dijckkaai
649,Ernest Van Dijckkaai,2023-08-16,23:00:00,118,49,69,FMN 01 Ernest Van Dijckkaai
649,Ernest Van Dijckkaai,2023-08-17,00:00:00,94,31,63,FMN 01 Ernest Van Dijckkaai
649,Ernest Van Dijckkaai,2023-08-17,01:00:00,30,14,16,FMN 01 Ernest Van Dijckkaai
649,Ernest Van Dijckkaai,2023-08-17,02:00:00,9,2,7,FMN 01 Ernest Van Dijckkaai
649,Ernest Van Dijckkaai,2023-08-17,03:00:00,19,7,12,FMN 01 Ernest Van Dijckkaai
649,Ernest Van Dijckkaai,2023-08-17,04:00:00,61,32,29,FMN 01 Ernest Van Dijckkaai
649,Ernest Van Dijckkaai,2023-08-17,05:00:00,120,73,47,FMN 01 Ernest Van Dijckkaai
649,Ernest Van Dijckkaai,2023-08-17,06:00:00,243,139,104,FMN 01 Ernest Van Dijckkaai
649,Ernest Van Dijckkaai,2023-08-17,07:00:00,391,229,162,FMN 01 Ernest Van Dijckkaai
649,Ernest Van Dijckkaai,2023-08-17,08:00:00,498,273,225,FMN 01 Ernest Van Dijckkaai
649,Ernest Van Dijckkaai,2023-08-17,09:00:00,291,173,118,FMN 01 Ernest Van Dijckkaai
649,Ernest Van Dijckkaai,2023-08-17,10:00:00,238,126,112,FMN 01 Ernest Van Dijckkaai
649,Ernest Van Dijckkaai,2023-08-17,11:00:00,272,112,160,FMN 01 Ernest Van Dijckkaai
649,Ernest Van Dijckkaai,2023-08-17,12:00:00,348,176,172,FMN 01 Ernest Van Dijckkaai
649,Ernest Van Dijckkaai,2023-08-17,13:00:00,378,211,167,FMN 01 Ernest Van Dijckkaai
649,Ernest Van Dijckkaai,2023-08-17,14:00:00,431,219,212,FMN 01 Ernest Van Dijckkaai
649,Ernest Van Dijckkaai,2023-08-17,15:00:00,494,210,284,FMN 01 Ernest Van Dijckkaai
649,Ernest Van Dijckkaai,2023-08-17,16:00:00,665,303,362,FMN 01 Ernest Van Dijckkaai
649,Ernest Van Dijckkaai,2023-08-17,17:00:00,715,288,427,FMN 01 Ernest Van Dijckkaai
649,Ernest Van Dijckkaai,2023-08-17,18:00:00,557,293,264,FMN 01 Ernest Van Dijckkaai
649,Ernest Van Dijckkaai,2023-08-17,19:00:00,347,168,179,FMN 01 Ernest Van Dijckkaai
649,Ernest Van Dijckkaai,2023-08-17,20:00:00,313,154,159,FMN 01 Ernest Van Dijckkaai
649,Ernest Van Dijckkaai,2023-08-17,21:00:00,238,109,129,FMN 01 Ernest Van Dijckkaai
649,Ernest Van Dijckkaai,2023-08-17,22:00:00,217,84,133,FMN 01 Ernest Van Dijckkaai
649,Ernest Van Dijckkaai,2023-08-17,23:00:00,140,43,97,FMN 01 Ernest Van Dijckkaai
649,Ernest Van Dijckkaai,2023-08-18,00:00:00,72,26,46,FMN 01 Ernest Van Dijckkaai
649,Ernest Van Dijckkaai,2023-08-18,01:00:00,37,14,23,FMN 01 Ernest Van Dijckkaai
649,Ernest Van Dijckkaai,2023-08-18,02:00:00,33,10,23,FMN 01 Ernest Van Dijckkaai
649,Ernest Van Dijckkaai,2023-08-18,03:00:00,16,3,13,FMN 01 Ernest Van Dijckkaai
649,Ernest Van Dijckkaai,2023-08-18,04:00:00,74,34,40,FMN 01 Ernest Van Dijckkaai
649,Ernest Van Dijckkaai,2023-08-18,05:00:00,119,79,40,FMN 01 Ernest Van Dijckkaai
649,Ernest Van Dijckkaai,2023-08-18,06:00:00,208,115,93,FMN 01 Ernest Van Dijckkaai
649,Ernest Van Dijckkaai,2023-08-18,07:00:00,318,194,124,FMN 01 Ernest Van Dijckkaai
649,Ernest Van Dijckkaai,2023-08-18,08:00:00,400,232,168,FMN 01 Ernest Van Dijckkaai
649,Ernest Van Dijckkaai,2023-08-18,09:00:00,267,136,131,FMN 01 Ernest Van Dijckkaai
649,Ernest Van Dijckkaai,2023-08-18,10:00:00,220,122,98,FMN 01 Ernest Van Dijckkaai
649,Ernest Van Dijckkaai,2023-08-18,11:00:00,258,122,136,FMN 01 Ernest Van Dijckkaai
649,Ernest Van Dijckkaai,2023-08-18,12:00:00,334,190,144,FMN 01 Ernest Van Dijckkaai
649,Ernest Van Dijckkaai,2023-08-18,13:00:00,418,211,207,FMN 01 Ernest Van Dijckkaai
649,Ernest Van Dijckkaai,2023-08-18,14:00:00,457,238,219,FMN 01 Ernest Van Dijckkaai
649,Ernest Van Dijckkaai,2023-08-18,15:00:00,617,302,315,FMN 01 Ernest Van Dijckkaai
649,Ernest Van Dijckkaai,2023-08-18,16:00:00,668,291,377,FMN 01 Ernest Van Dijckkaai
649,Ernest Van Dijckkaai,2023-08-18,17:00:00,738,347,391,FMN 01 Ernest Van Dijckkaai
649,Ernest Van Dijckkaai,2023-08-18,18:00:00,593,291,302,FMN 01 Ernest Van Dijckkaai
649,Ernest Van Dijckkaai,2023-08-18,19:00:00,609,350,259,FMN 01 Ernest Van Dijckkaai
649,Ernest Van Dijckkaai,2023-08-18,20:00:00,549,329,220,FMN 01 Ernest Van Dijckkaai
649,Ernest Van Dijckkaai,2023-08-18,21:00:00,622,414,208,FMN 01 Ernest Van Dijckkaai
649,Ernest Van Dijckkaai,2023-08-18,22:00:00,426,184,242,FMN 01 Ernest Van Dijckkaai
649,Ernest Van Dijckkaai,2023-08-18,23:00:00,326,121,205,FMN 01 Ernest Van Dijckkaai
649,Ernest Van Dijckkaai,2023-08-19,00:00:00,349,66,283,FMN 01 Ernest Van Dijckkaai
649,Ernest Van Dijckkaai,2023-08-19,01:00:00,130,36,94,FMN 01 Ernest Van Dijckkaai
649,Ernest Van Dijckkaai,2023-08-19,02:00:00,113,29,84,FMN 01 Ernest Van Dijckkaai
649,Ernest Van Dijckkaai,2023-08-19,03:00:00,61,16,45,FMN 01 Ernest Van Dijckkaai
649,Ernest Van Dijckkaai,2023-08-19,04:00:00,55,17,38,FMN 01 Ernest Van Dijckkaai
649,Ernest Van Dijckkaai,2023-08-19,05:00:00,52,25,27,FMN 01 Ernest Van Dijckkaai
649,Ernest Van Dijckkaai,2023-08-19,06:00:00,50,15,35,FMN 01 Ernest Van Dijckkaai
649,Ernest Van Dijckkaai,2023-08-19,07:00:00,44,21,23,FMN 01 Ernest Van Dijckkaai
649,Ernest Van Dijckkaai,2023-08-19,08:00:00,111,56,55,FMN 01 Ernest Van Dijckkaai
649,Ernest Van Dijckkaai,2023-08-19,09:00:00,205,122,83,FMN 01 Ernest Van Dijckkaai
649,Ernest Van Dijckkaai,2023-08-19,10:00:00,227,134,93,FMN 01 Ernest Van Dijckkaai
649,Ernest Van Dijckkaai,2023-08-19,11:00:00,312,168,144,FMN 01 Ernest Van Dijckkaai
649,Ernest Van Dijckkaai,2023-08-19,12:00:00,418,186,232,FMN 01 Ernest Van Dijckkaai
649,Ernest Van Dijckkaai,2023-08-19,13:00:00,358,172,186,FMN 01 Ernest Van Dijckkaai
649,Ernest Van Dijckkaai,2023-08-19,14:00:00,516,222,294,FMN 01 Ernest Van Dijckkaai
649,Ernest Van Dijckkaai,2023-08-19,15:00:00,606,298,308,FMN 01 Ernest Van Dijckkaai
649,Ernest Van Dijckkaai,2023-08-19,16:00:00,547,311,236,FMN 01 Ernest Van Dijckkaai
649,Ernest Van Dijckkaai,2023-08-19,17:00:00,512,274,238,FMN 01 Ernest Van Dijckkaai
649,Ernest Van Dijckkaai,2023-08-19,18:00:00,606,340,266,FMN 01 Ernest Van Dijckkaai
649,Ernest Van Dijckkaai,2023-08-19,19:00:00,485,286,199,FMN 01 Ernest Van Dijckkaai
649,Ernest Van Dijckkaai,2023-08-19,20:00:00,550,307,243,FMN 01 Ernest Van Dijckkaai
649,Ernest Van Dijckkaai,2023-08-19,21:00:00,488,285,203,FMN 01 Ernest Van Dijckkaai
649,Ernest Van Dijckkaai,2023-08-19,22:00:00,345,159,186,FMN 01 Ernest Van Dijckkaai
649,Ernest Van Dijckkaai,2023-08-19,23:00:00,264,86,178,FMN 01 Ernest Van Dijckkaai
649,Ernest Van Dijckkaai,2023-08-20,00:00:00,215,48,167,FMN 01 Ernest Van Dijckkaai
649,Ernest Van Dijckkaai,2023-08-20,01:00:00,123,26,97,FMN 01 Ernest Van Dijckkaai
649,Ernest Van Dijckkaai,2023-08-20,02:00:00,78,27,51,FMN 01 Ernest Van Dijckkaai
649,Ernest Van Dijckkaai,2023-08-20,03:00:00,40,10,30,FMN 01 Ernest Van Dijckkaai
649,Ernest Van Dijckkaai,2023-08-20,04:00:00,43,14,29,FMN 01 Ernest Van Dijckkaai
649,Ernest Van Dijckkaai,2023-08-20,05:00:00,52,21,31,FMN 01 Ernest Van Dijckkaai
649,Ernest Van Dijckkaai,2023-08-20,06:00:00,36,18,18,FMN 01 Ernest Van Dijckkaai
649,Ernest Van Dijckkaai,2023-08-20,07:00:00,44,19,25,FMN 01 Ernest Van Dijckkaai
649,Ernest Van Dijckkaai,2023-08-20,08:00:00,79,42,37,FMN 01 Ernest Van Dijckkaai
649,Ernest Van Dijckkaai,2023-08-20,09:00:00,197,101,96,FMN 01 Ernest Van Dijckkaai
649,Ernest Van Dijckkaai,2023-08-20,10:00:00,340,186,154,FMN 01 Ernest Van Dijckkaai
649,Ernest Van Dijckkaai,2023-08-20,11:00:00,375,205,170,FMN 01 Ernest Van Dijckkaai
649,Ernest Van Dijckkaai,2023-08-20,12:00:00,539,298,241,FMN 01 Ernest Van Dijckkaai
649,Ernest Van Dijckkaai,2023-08-20,13:00:00,613,365,248,FMN 01 Ernest Van Dijckkaai
649,Ernest Van Dijckkaai,2023-08-20,14:00:00,699,402,297,FMN 01 Ernest Van Dijckkaai
649,Ernest Van Dijckkaai,2023-08-20,15:00:00,835,529,306,FMN 01 Ernest Van Dijckkaai
649,Ernest Van Dijckkaai,2023-08-20,16:00:00,825,441,384,FMN 01 Ernest Van Dijckkaai
649,Ernest Van Dijckkaai,2023-08-20,17:00:00,696,321,375,FMN 01 Ernest Van Dijckkaai
649,Ernest Van Dijckkaai,2023-08-20,18:00:00,599,317,282,FMN 01 Ernest Van Dijckkaai
649,Ernest Van Dijckkaai,2023-08-20,19:00:00,454,239,215,FMN 01 Ernest Van Dijckkaai
649,Ernest Van Dijckkaai,2023-08-20,20:00:00,424,197,227,FMN 01 Ernest Van Dijckkaai
649,Ernest Van Dijckkaai,2023-08-20,21:00:00,334,151,183,FMN 01 Ernest Van Dijckkaai
649,Ernest Van Dijckkaai,2023-08-20,22:00:00,228,65,163,FMN 01 Ernest Van Dijckkaai
649,Ernest Van Dijckkaai,2023-08-20,23:00:00,104,40,64,FMN 01 Ernest Van Dijckkaai
649,Ernest Van Dijckkaai,2023-08-21,00:00:00,47,11,36,FMN 01 Ernest Van Dijckkaai
649,Ernest Van Dijckkaai,2023-08-21,01:00:00,30,6,24,FMN 01 Ernest Van Dijckkaai
649,Ernest Van Dijckkaai,2023-08-21,02:00:00,17,6,11,FMN 01 Ernest Van Dijckkaai
649,Ernest Van Dijckkaai,2023-08-21,03:00:00,12,4,8,FMN 01 Ernest Van Dijckkaai
649,Ernest Van Dijckkaai,2023-08-21,04:00:00,66,49,17,FMN 01 Ernest Van Dijckkaai
649,Ernest Van Dijckkaai,2023-08-21,05:00:00,116,69,47,FMN 01 Ernest Van Dijckkaai
649,Ernest Van Dijckkaai,2023-08-21,06:00:00,239,151,88,FMN 01 Ernest Van Dijckkaai
649,Ernest Van Dijckkaai,2023-08-21,07:00:00,419,267,152,FMN 01 Ernest Van Dijckkaai
649,Ernest Van Dijckkaai,2023-08-21,08:00:00,507,276,231,FMN 01 Ernest Van Dijckkaai
649,Ernest Van Dijckkaai,2023-08-21,09:00:00,333,189,144,FMN 01 Ernest Van Dijckkaai
649,Ernest Van Dijckkaai,2023-08-21,10:00:00,241,136,105,FMN 01 Ernest Van Dijckkaai
649,Ernest Van Dijckkaai,2023-08-21,11:00:00,294,147,147,FMN 01 Ernest Van Dijckkaai
649,Ernest Van Dijckkaai,2023-08-21,12:00:00,317,169,148,FMN 01 Ernest Van Dijckkaai
649,Ernest Van Dijckkaai,2023-08-21,13:00:00,393,186,207,FMN 01 Ernest Van Dijckkaai
649,Ernest Van Dijckkaai,2023-08-21,14:00:00,483,248,235,FMN 01 Ernest Van Dijckkaai
649,Ernest Van Dijckkaai,2023-08-21,15:00:00,504,247,257,FMN 01 Ernest Van Dijckkaai
649,Ernest Van Dijckkaai,2023-08-21,16:00:00,749,345,404,FMN 01 Ernest Van Dijckkaai
649,Ernest Van Dijckkaai,2023-08-21,17:00:00,784,318,466,FMN 01 Ernest Van Dijckkaai
649,Ernest Van Dijckkaai,2023-08-21,18:00:00,504,231,273,FMN 01 Ernest Van Dijckkaai
649,Ernest Van Dijckkaai,2023-08-21,19:00:00,424,220,204,FMN 01 Ernest Van Dijckkaai
649,Ernest Van Dijckkaai,2023-08-21,20:00:00,416,215,201,FMN 01 Ernest Van Dijckkaai
649,Ernest Van Dijckkaai,2023-08-21,21:00:00,352,157,195,FMN 01 Ernest Van Dijckkaai
649,Ernest Van Dijckkaai,2023-08-21,22:00:00,208,75,133,FMN 01 Ernest Van Dijckkaai
649,Ernest Van Dijckkaai,2023-08-21,23:00:00,101,42,59,FMN 01 Ernest Van Dijckkaai
649,Ernest Van Dijckkaai,2023-08-22,00:00:00,55,24,31,FMN 01 Ernest Van Dijckkaai
649,Ernest Van Dijckkaai,2023-08-22,01:00:00,28,10,18,FMN 01 Ernest Van Dijckkaai
649,Ernest Van Dijckkaai,2023-08-22,02:00:00,13,4,9,FMN 01 Ernest Van Dijckkaai
649,Ernest Van Dijckkaai,2023-08-22,03:00:00,20,9,11,FMN 01 Ernest Van Dijckkaai
649,Ernest Van Dijckkaai,2023-08-22,04:00:00,74,56,18,FMN 01 Ernest Van Dijckkaai
649,Ernest Van Dijckkaai,2023-08-22,05:00:00,132,84,48,FMN 01 Ernest Van Dijckkaai
649,Ernest Van Dijckkaai,2023-08-22,06:00:00,311,198,113,FMN 01 Ernest Van Dijckkaai
649,Ernest Van Dijckkaai,2023-08-22,07:00:00,475,301,174,FMN 01 Ernest Van Dijckkaai
649,Ernest Van Dijckkaai,2023-08-22,08:00:00,585,326,259,FMN 01 Ernest Van Dijckkaai
649,Ernest Van Dijckkaai,2023-08-22,09:00:00,358,221,137,FMN 01 Ernest Van Dijckkaai
649,Ernest Van Dijckkaai,2023-08-22,10:00:00,287,161,126,FMN 01 Ernest Van Dijckkaai
649,Ernest Van Dijckkaai,2023-08-22,11:00:00,281,146,135,FMN 01 Ernest Van Dijckkaai
649,Ernest Van Dijckkaai,2023-08-22,12:00:00,380,195,185,FMN 01 Ernest Van Dijckkaai
649,Ernest Van Dijckkaai,2023-08-22,13:00:00,399,205,194,FMN 01 Ernest Van Dijckkaai
649,Ernest Van Dijckkaai,2023-08-22,14:00:00,489,215,274,FMN 01 Ernest Van Dijckkaai
649,Ernest Van Dijckkaai,2023-08-22,15:00:00,579,293,286,FMN 01 Ernest Van Dijckkaai
649,Ernest Van Dijckkaai,2023-08-22,16:00:00,747,317,430,FMN 01 Ernest Van Dijckkaai
649,Ernest Van Dijckkaai,2023-08-22,17:00:00,936,374,562,FMN 01 Ernest Van Dijckkaai
649,Ernest Van Dijckkaai,2023-08-22,18:00:00,609,296,313,FMN 01 Ernest Van Dijckkaai
649,Ernest Van Dijckkaai,2023-08-22,19:00:00,467,247,220,FMN 01 Ernest Van Dijckkaai
649,Ernest Van Dijckkaai,2023-08-22,20:00:00,445,214,231,FMN 01 Ernest Van Dijckkaai
649,Ernest Van Dijckkaai,2023-08-22,21:00:00,304,131,173,FMN 01 Ernest Van Dijckkaai
649,Ernest Van Dijckkaai,2023-08-22,22:00:00,262,93,169,FMN 01 Ernest Van Dijckkaai
649,Ernest Van Dijckkaai,2023-08-22,23:00:00,164,45,119,FMN 01 Ernest Van Dijckkaai
649,Ernest Van Dijckkaai,2023-08-23,00:00:00,67,21,46,FMN 01 Ernest Van Dijckkaai
649,Ernest Van Dijckkaai,2023-08-23,01:00:00,39,15,24,FMN 01 Ernest Van Dijckkaai
649,Ernest Van Dijckkaai,2023-08-23,02:00:00,19,3,16,FMN 01 Ernest Van Dijckkaai
649,Ernest Van Dijckkaai,2023-08-23,03:00:00,15,4,11,FMN 01 Ernest Van Dijckkaai
649,Ernest Van Dijckkaai,2023-08-23,04:00:00,63,45,18,FMN 01 Ernest Van Dijckkaai
649,Ernest Van Dijckkaai,2023-08-23,05:00:00,119,76,43,FMN 01 Ernest Van Dijckkaai
649,Ernest Van Dijckkaai,2023-08-23,06:00:00,282,179,103,FMN 01 Ernest Van Dijckkaai
649,Ernest Van Dijckkaai,2023-08-23,07:00:00,422,259,163,FMN 01 Ernest Van Dijckkaai
649,Ernest Van Dijckkaai,2023-08-23,08:00:00,538,316,222,FMN 01 Ernest Van Dijckkaai
649,Ernest Van Dijckkaai,2023-08-23,09:00:00,363,228,135,FMN 01 Ernest Van Dijckkaai
649,Ernest Van Dijckkaai,2023-08-23,10:00:00,280,133,147,FMN 01 Ernest Van Dijckkaai
649,Ernest Van Dijckkaai,2023-08-23,11:00:00,289,136,153,FMN 01 Ernest Van Dijckkaai
649,Ernest Van Dijckkaai,2023-08-23,12:00:00,513,277,236,FMN 01 Ernest Van Dijckkaai
649,Ernest Van Dijckkaai,2023-08-23,13:00:00,451,240,211,FMN 01 Ernest Van Dijckkaai
649,Ernest Van Dijckkaai,2023-08-23,14:00:00,594,276,318,FMN 01 Ernest Van Dijckkaai
649,Ernest Van Dijckkaai,2023-08-23,15:00:00,561,258,303,FMN 01 Ernest Van Dijckkaai
649,Ernest Van Dijckkaai,2023-08-23,16:00:00,790,332,458,FMN 01 Ernest Van Dijckkaai
649,Ernest Van Dijckkaai,2023-08-23,17:00:00,968,442,526,FMN 01 Ernest Van Dijckkaai
649,Ernest Van Dijckkaai,2023-08-23,18:00:00,692,334,358,FMN 01 Ernest Van Dijckkaai
649,Ernest Van Dijckkaai,2023-08-23,19:00:00,518,233,285,FMN 01 Ernest Van Dijckkaai
649,Ernest Van Dijckkaai,2023-08-23,20:00:00,479,227,252,FMN 01 Ernest Van Dijckkaai
649,Ernest Van Dijckkaai,2023-08-23,21:00:00,383,185,198,FMN 01 Ernest Van Dijckkaai
649,Ernest Van Dijckkaai,2023-08-23,22:00:00,295,111,184,FMN 01 Ernest Van Dijckkaai
649,Ernest Van Dijckkaai,2023-08-23,23:00:00,148,47,101,FMN 01 Ernest Van Dijckkaai
649,Ernest Van Dijckkaai,2023-08-24,00:00:00,67,23,44,FMN 01 Ernest Van Dijckkaai
649,Ernest Van Dijckkaai,2023-08-24,01:00:00,48,19,29,FMN 01 Ernest Van Dijckkaai
649,Ernest Van Dijckkaai,2023-08-24,02:00:00,11,4,7,FMN 01 Ernest Van Dijckkaai
649,Ernest Van Dijckkaai,2023-08-24,03:00:00,23,10,13,FMN 01 Ernest Van Dijckkaai
649,Ernest Van Dijckkaai,2023-08-24,04:00:00,55,38,17,FMN 01 Ernest Van Dijckkaai
649,Ernest Van Dijckkaai,2023-08-24,05:00:00,119,69,50,FMN 01 Ernest Van Dijckkaai
649,Ernest Van Dijckkaai,2023-08-24,06:00:00,280,178,102,FMN 01 Ernest Van Dijckkaai
649,Ernest Van Dijckkaai,2023-08-24,07:00:00,396,247,149,FMN 01 Ernest Van Dijckkaai
649,Ernest Van Dijckkaai,2023-08-24,08:00:00,555,318,237,FMN 01 Ernest Van Dijckkaai
649,Ernest Van Dijckkaai,2023-08-24,09:00:00,351,190,161,FMN 01 Ernest Van Dijckkaai
649,Ernest Van Dijckkaai,2023-08-24,10:00:00,231,125,106,FMN 01 Ernest Van Dijckkaai
649,Ernest Van Dijckkaai,2023-08-24,11:00:00,261,130,131,FMN 01 Ernest Van Dijckkaai
649,Ernest Van Dijckkaai,2023-08-24,12:00:00,216,110,106,FMN 01 Ernest Van Dijckkaai
649,Ernest Van Dijckkaai,2023-08-24,13:00:00,268,164,104,FMN 01 Ernest Van Dijckkaai
649,Ernest Van Dijckkaai,2023-08-24,14:00:00,324,154,170,FMN 01 Ernest Van Dijckkaai
649,Ernest Van Dijckkaai,2023-08-24,15:00:00,366,156,210,FMN 01 Ernest Van Dijckkaai
649,Ernest Van Dijckkaai,2023-08-24,16:00:00,649,254,395,FMN 01 Ernest Van Dijckkaai
649,Ernest Van Dijckkaai,2023-08-24,17:00:00,695,268,427,FMN 01 Ernest Van Dijckkaai
649,Ernest Van Dijckkaai,2023-08-24,18:00:00,513,255,258,FMN 01 Ernest Van Dijckkaai
649,Ernest Van Dijckkaai,2023-08-24,19:00:00,419,216,203,FMN 01 Ernest Van Dijckkaai
649,Ernest Van Dijckkaai,2023-08-24,20:00:00,269,132,137,FMN 01 Ernest Van Dijckkaai
649,Ernest Van Dijckkaai,2023-08-24,21:00:00,261,130,131,FMN 01 Ernest Van Dijckkaai
649,Ernest Van Dijckkaai,2023-08-24,22:00:00,207,73,134,FMN 01 Ernest Van Dijckkaai
649,Ernest Van Dijckkaai,2023-08-24,23:00:00,92,45,47,FMN 01 Ernest Van Dijckkaai
649,Ernest Van Dijckkaai,2023-08-25,00:00:00,83,20,63,FMN 01 Ernest Van Dijckkaai
649,Ernest Van Dijckkaai,2023-08-25,01:00:00,43,20,23,FMN 01 Ernest Van Dijckkaai
649,Ernest Van Dijckkaai,2023-08-25,02:00:00,23,4,19,FMN 01 Ernest Van Dijckkaai
649,Ernest Van Dijckkaai,2023-08-25,03:00:00,24,5,19,FMN 01 Ernest Van Dijckkaai
649,Ernest Van Dijckkaai,2023-08-25,04:00:00,50,32,18,FMN 01 Ernest Van Dijckkaai
649,Ernest Van Dijckkaai,2023-08-25,05:00:00,116,71,45,FMN 01 Ernest Van Dijckkaai
649,Ernest Van Dijckkaai,2023-08-25,06:00:00,211,138,73,FMN 01 Ernest Van Dijckkaai
649,Ernest Van Dijckkaai,2023-08-25,07:00:00,292,177,115,FMN 01 Ernest Van Dijckkaai
649,Ernest Van Dijckkaai,2023-08-25,08:00:00,399,214,185,FMN 01 Ernest Van Dijckkaai
649,Ernest Van Dijckkaai,2023-08-25,09:00:00,253,152,101,FMN 01 Ernest Van Dijckkaai
649,Ernest Van Dijckkaai,2023-08-25,10:00:00,222,102,120,FMN 01 Ernest Van Dijckkaai
649,Ernest Van Dijckkaai,2023-08-25,11:00:00,267,149,118,FMN 01 Ernest Van Dijckkaai
649,Ernest Van Dijckkaai,2023-08-25,12:00:00,349,174,175,FMN 01 Ernest Van Dijckkaai
649,Ernest Van Dijckkaai,2023-08-25,13:00:00,375,204,171,FMN 01 Ernest Van Dijckkaai
649,Ernest Van Dijckkaai,2023-08-25,14:00:00,475,261,214,FMN 01 Ernest Van Dijckkaai
649,Ernest Van Dijckkaai,2023-08-25,15:00:00,515,264,251,FMN 01 Ernest Van Dijckkaai
649,Ernest Van Dijckkaai,2023-08-25,16:00:00,732,391,341,FMN 01 Ernest Van Dijckkaai
649,Ernest Van Dijckkaai,2023-08-25,17:00:00,692,257,435,FMN 01 Ernest Van Dijckkaai
649,Ernest Van Dijckkaai,2023-08-25,18:00:00,432,200,232,FMN 01 Ernest Van Dijckkaai
649,Ernest Van Dijckkaai,2023-08-25,19:00:00,278,140,138,FMN 01 Ernest Van Dijckkaai
649,Ernest Van Dijckkaai,2023-08-25,20:00:00,268,144,124,FMN 01 Ernest Van Dijckkaai
649,Ernest Van Dijckkaai,2023-08-25,21:00:00,241,144,97,FMN 01 Ernest Van Dijckkaai
649,Ernest Van Dijckkaai,2023-08-25,22:00:00,210,98,112,FMN 01 Ernest Van Dijckkaai
649,Ernest Van Dijckkaai,2023-08-25,23:00:00,172,63,109,FMN 01 Ernest Van Dijckkaai
649,Ernest Van Dijckkaai,2023-08-26,00:00:00,174,53,121,FMN 01 Ernest Van Dijckkaai
649,Ernest Van Dijckkaai,2023-08-26,01:00:00,83,30,53,FMN 01 Ernest Van Dijckkaai
649,Ernest Van Dijckkaai,2023-08-26,02:00:00,75,26,49,FMN 01 Ernest Van Dijckkaai
649,Ernest Van Dijckkaai,2023-08-26,03:00:00,44,12,32,FMN 01 Ernest Van Dijckkaai
649,Ernest Van Dijckkaai,2023-08-26,04:00:00,45,14,31,FMN 01 Ernest Van Dijckkaai
649,Ernest Van Dijckkaai,2023-08-26,05:00:00,30,13,17,FMN 01 Ernest Van Dijckkaai
649,Ernest Van Dijckkaai,2023-08-26,06:00:00,47,16,31,FMN 01 Ernest Van Dijckkaai
649,Ernest Van Dijckkaai,2023-08-26,07:00:00,56,24,32,FMN 01 Ernest Van Dijckkaai
649,Ernest Van Dijckkaai,2023-08-26,08:00:00,119,44,75,FMN 01 Ernest Van Dijckkaai
649,Ernest Van Dijckkaai,2023-08-26,09:00:00,231,133,98,FMN 01 Ernest Van Dijckkaai
649,Ernest Van Dijckkaai,2023-08-26,10:00:00,324,204,120,FMN 01 Ernest Van Dijckkaai
649,Ernest Van Dijckkaai,2023-08-26,11:00:00,464,318,146,FMN 01 Ernest Van Dijckkaai
649,Ernest Van Dijckkaai,2023-08-26,12:00:00,615,260,355,FMN 01 Ernest Van Dijckkaai
649,Ernest Van Dijckkaai,2023-08-26,13:00:00,645,324,321,FMN 01 Ernest Van Dijckkaai
649,Ernest Van Dijckkaai,2023-08-26,14:00:00,722,464,258,FMN 01 Ernest Van Dijckkaai
649,Ernest Van Dijckkaai,2023-08-26,15:00:00,717,480,237,FMN 01 Ernest Van Dijckkaai
649,Ernest Van Dijckkaai,2023-08-26,16:00:00,539,209,330,FMN 01 Ernest Van Dijckkaai
649,Ernest Van Dijckkaai,2023-08-26,17:00:00,717,265,452,FMN 01 Ernest Van Dijckkaai
649,Ernest Van Dijckkaai,2023-08-26,18:00:00,574,337,237,FMN 01 Ernest Van Dijckkaai
649,Ernest Van Dijckkaai,2023-08-26,19:00:00,378,199,179,FMN 01 Ernest Van Dijckkaai
649,Ernest Van Dijckkaai,2023-08-26,20:00:00,416,236,180,FMN 01 Ernest Van Dijckkaai
649,Ernest Van Dijckkaai,2023-08-26,21:00:00,305,170,135,FMN 01 Ernest Van Dijckkaai
649,Ernest Van Dijckkaai,2023-08-26,22:00:00,187,75,112,FMN 01 Ernest Van Dijckkaai
649,Ernest Van Dijckkaai,2023-08-26,23:00:00,138,56,82,FMN 01 Ernest Van Dijckkaai
649,Ernest Van Dijckkaai,2023-08-27,00:00:00,137,55,82,FMN 01 Ernest Van Dijckkaai
649,Ernest Van Dijckkaai,2023-08-27,01:00:00,71,27,44,FMN 01 Ernest Van Dijckkaai
649,Ernest Van Dijckkaai,2023-08-27,02:00:00,39,9,30,FMN 01 Ernest Van Dijckkaai
649,Ernest Van Dijckkaai,2023-08-27,03:00:00,49,14,35,FMN 01 Ernest Van Dijckkaai
649,Ernest Van Dijckkaai,2023-08-27,04:00:00,29,8,21,FMN 01 Ernest Van Dijckkaai
649,Ernest Van Dijckkaai,2023-08-27,05:00:00,19,5,14,FMN 01 Ernest Van Dijckkaai
649,Ernest Van Dijckkaai,2023-08-27,06:00:00,41,19,22,FMN 01 Ernest Van Dijckkaai
649,Ernest Van Dijckkaai,2023-08-27,07:00:00,28,10,18,FMN 01 Ernest Van Dijckkaai
649,Ernest Van Dijckkaai,2023-08-27,08:00:00,113,41,72,FMN 01 Ernest Van Dijckkaai
649,Ernest Van Dijckkaai,2023-08-27,09:00:00,269,106,163,FMN 01 Ernest Van Dijckkaai
649,Ernest Van Dijckkaai,2023-08-27,10:00:00,509,212,297,FMN 01 Ernest Van Dijckkaai
649,Ernest Van Dijckkaai,2023-08-27,11:00:00,733,394,339,FMN 01 Ernest Van Dijckkaai
649,Ernest Van Dijckkaai,2023-08-27,12:00:00,759,363,396,FMN 01 Ernest Van Dijckkaai
649,Ernest Van Dijckkaai,2023-08-27,13:00:00,668,363,305,FMN 01 Ernest Van Dijckkaai
649,Ernest Van Dijckkaai,2023-08-27,14:00:00,780,283,497,FMN 01 Ernest Van Dijckkaai
649,Ernest Van Dijckkaai,2023-08-27,15:00:00,808,221,587,FMN 01 Ernest Van Dijckkaai
649,Ernest Van Dijckkaai,2023-08-27,16:00:00,853,468,385,FMN 01 Ernest Van Dijckkaai
649,Ernest Van Dijckkaai,2023-08-27,17:00:00,798,575,223,FMN 01 Ernest Van Dijckkaai
649,Ernest Van Dijckkaai,2023-08-27,18:00:00,618,439,179,FMN 01 Ernest Van Dijckkaai
649,Ernest Van Dijckkaai,2023-08-27,19:00:00,369,210,159,FMN 01 Ernest Van Dijckkaai
649,Ernest Van Dijckkaai,2023-08-27,20:00:00,291,149,142,FMN 01 Ernest Van Dijckkaai
649,Ernest Van Dijckkaai,2023-08-27,21:00:00,205,97,108,FMN 01 Ernest Van Dijckkaai
649,Ernest Van Dijckkaai,2023-08-27,22:00:00,173,82,91,FMN 01 Ernest Van Dijckkaai
649,Ernest Van Dijckkaai,2023-08-27,23:00:00,81,46,35,FMN 01 Ernest Van Dijckkaai
649,Ernest Van Dijckkaai,2023-08-28,00:00:00,53,25,28,FMN 01 Ernest Van Dijckkaai
649,Ernest Van Dijckkaai,2023-08-28,01:00:00,10,1,9,FMN 01 Ernest Van Dijckkaai
649,Ernest Van Dijckkaai,2023-08-28,02:00:00,11,3,8,FMN 01 Ernest Van Dijckkaai
649,Ernest Van Dijckkaai,2023-08-28,03:00:00,10,4,6,FMN 01 Ernest Van Dijckkaai
649,Ernest Van Dijckkaai,2023-08-28,04:00:00,58,39,19,FMN 01 Ernest Van Dijckkaai
649,Ernest Van Dijckkaai,2023-08-28,05:00:00,133,88,45,FMN 01 Ernest Van Dijckkaai
649,Ernest Van Dijckkaai,2023-08-28,06:00:00,233,138,95,FMN 01 Ernest Van Dijckkaai
649,Ernest Van Dijckkaai,2023-08-28,07:00:00,368,228,140,FMN 01 Ernest Van Dijckkaai
649,Ernest Van Dijckkaai,2023-08-28,08:00:00,479,279,200,FMN 01 Ernest Van Dijckkaai
649,Ernest Van Dijckkaai,2023-08-28,09:00:00,238,147,91,FMN 01 Ernest Van Dijckkaai
649,Ernest Van Dijckkaai,2023-08-28,10:00:00,211,118,93,FMN 01 Ernest Van Dijckkaai
649,Ernest Van Dijckkaai,2023-08-28,11:00:00,235,134,101,FMN 01 Ernest Van Dijckkaai
649,Ernest Van Dijckkaai,2023-08-28,12:00:00,335,159,176,FMN 01 Ernest Van Dijckkaai
649,Ernest Van Dijckkaai,2023-08-28,13:00:00,277,145,132,FMN 01 Ernest Van Dijckkaai
649,Ernest Van Dijckkaai,2023-08-28,14:00:00,375,172,203,FMN 01 Ernest Van Dijckkaai
649,Ernest Van Dijckkaai,2023-08-28,15:00:00,330,168,162,FMN 01 Ernest Van Dijckkaai
649,Ernest Van Dijckkaai,2023-08-28,16:00:00,540,200,340,FMN 01 Ernest Van Dijckkaai
649,Ernest Van Dijckkaai,2023-08-28,17:00:00,617,239,378,FMN 01 Ernest Van Dijckkaai
649,Ernest Van Dijckkaai,2023-08-28,18:00:00,283,124,159,FMN 01 Ernest Van Dijckkaai
649,Ernest Van Dijckkaai,2023-08-28,19:00:00,191,89,102,FMN 01 Ernest Van Dijckkaai
649,Ernest Van Dijckkaai,2023-08-28,20:00:00,163,85,78,FMN 01 Ernest Van Dijckkaai
649,Ernest Van Dijckkaai,2023-08-28,21:00:00,131,59,72,FMN 01 Ernest Van Dijckkaai
649,Ernest Van Dijckkaai,2023-08-28,22:00:00,123,40,83,FMN 01 Ernest Van Dijckkaai
649,Ernest Van Dijckkaai,2023-08-28,23:00:00,72,33,39,FMN 01 Ernest Van Dijckkaai
649,Ernest Van Dijckkaai,2023-08-29,00:00:00,32,11,21,FMN 01 Ernest Van Dijckkaai
649,Ernest Van Dijckkaai,2023-08-29,01:00:00,17,7,10,FMN 01 Ernest Van Dijckkaai
649,Ernest Van Dijckkaai,2023-08-29,02:00:00,19,7,12,FMN 01 Ernest Van Dijckkaai
649,Ernest Van Dijckkaai,2023-08-29,03:00:00,5,3,2,FMN 01 Ernest Van Dijckkaai
649,Ernest Van Dijckkaai,2023-08-29,04:00:00,45,32,13,FMN 01 Ernest Van Dijckkaai
649,Ernest Van Dijckkaai,2023-08-29,05:00:00,141,88,53,FMN 01 Ernest Van Dijckkaai
649,Ernest Van Dijckkaai,2023-08-29,06:00:00,260,171,89,FMN 01 Ernest Van Dijckkaai
649,Ernest Van Dijckkaai,2023-08-29,07:00:00,403,247,156,FMN 01 Ernest Van Dijckkaai
649,Ernest Van Dijckkaai,2023-08-29,08:00:00,548,326,222,FMN 01 Ernest Van Dijckkaai
649,Ernest Van Dijckkaai,2023-08-29,09:00:00,293,176,117,FMN 01 Ernest Van Dijckkaai
649,Ernest Van Dijckkaai,2023-08-29,10:00:00,213,123,90,FMN 01 Ernest Van Dijckkaai
649,Ernest Van Dijckkaai,2023-08-29,11:00:00,195,104,91,FMN 01 Ernest Van Dijckkaai
649,Ernest Van Dijckkaai,2023-08-29,12:00:00,322,172,150,FMN 01 Ernest Van Dijckkaai
649,Ernest Van Dijckkaai,2023-08-29,13:00:00,328,189,139,FMN 01 Ernest Van Dijckkaai
649,Ernest Van Dijckkaai,2023-08-29,14:00:00,404,197,207,FMN 01 Ernest Van Dijckkaai
649,Ernest Van Dijckkaai,2023-08-29,15:00:00,475,208,267,FMN 01 Ernest Van Dijckkaai
649,Ernest Van Dijckkaai,2023-08-29,16:00:00,587,242,345,FMN 01 Ernest Van Dijckkaai
649,Ernest Van Dijckkaai,2023-08-29,17:00:00,733,309,424,FMN 01 Ernest Van Dijckkaai
649,Ernest Van Dijckkaai,2023-08-29,18:00:00,502,234,268,FMN 01 Ernest Van Dijckkaai
649,Ernest Van Dijckkaai,2023-08-29,19:00:00,335,157,178,FMN 01 Ernest Van Dijckkaai
649,Ernest Van Dijckkaai,2023-08-29,20:00:00,323,156,167,FMN 01 Ernest Van Dijckkaai
649,Ernest Van Dijckkaai,2023-08-29,21:00:00,232,112,120,FMN 01 Ernest Van Dijckkaai
649,Ernest Van Dijckkaai,2023-08-29,22:00:00,162,63,99,FMN 01 Ernest Van Dijckkaai
649,Ernest Van Dijckkaai,2023-08-29,23:00:00,102,42,60,FMN 01 Ernest Van Dijckkaai
649,Ernest Van Dijckkaai,2023-08-30,00:00:00,54,13,41,FMN 01 Ernest Van Dijckkaai
649,Ernest Van Dijckkaai,2023-08-30,01:00:00,27,4,23,FMN 01 Ernest Van Dijckkaai
649,Ernest Van Dijckkaai,2023-08-30,02:00:00,12,2,10,FMN 01 Ernest Van Dijckkaai
649,Ernest Van Dijckkaai,2023-08-30,03:00:00,19,7,12,FMN 01 Ernest Van Dijckkaai
649,Ernest Van Dijckkaai,2023-08-30,04:00:00,64,43,21,FMN 01 Ernest Van Dijckkaai
649,Ernest Van Dijckkaai,2023-08-30,05:00:00,131,78,53,FMN 01 Ernest Van Dijckkaai
649,Ernest Van Dijckkaai,2023-08-30,06:00:00,250,159,91,FMN 01 Ernest Van Dijckkaai
649,Ernest Van Dijckkaai,2023-08-30,07:00:00,284,172,112,FMN 01 Ernest Van Dijckkaai
649,Ernest Van Dijckkaai,2023-08-30,08:00:00,316,198,118,FMN 01 Ernest Van Dijckkaai
649,Ernest Van Dijckkaai,2023-08-30,09:00:00,206,120,86,FMN 01 Ernest Van Dijckkaai
649,Ernest Van Dijckkaai,2023-08-30,10:00:00,166,98,68,FMN 01 Ernest Van Dijckkaai
649,Ernest Van Dijckkaai,2023-08-30,11:00:00,160,71,89,FMN 01 Ernest Van Dijckkaai
649,Ernest Van Dijckkaai,2023-08-30,12:00:00,293,146,147,FMN 01 Ernest Van Dijckkaai
649,Ernest Van Dijckkaai,2023-08-30,13:00:00,254,129,125,FMN 01 Ernest Van Dijckkaai
649,Ernest Van Dijckkaai,2023-08-30,14:00:00,318,132,186,FMN 01 Ernest Van Dijckkaai
649,Ernest Van Dijckkaai,2023-08-30,15:00:00,370,177,193,FMN 01 Ernest Van Dijckkaai
649,Ernest Van Dijckkaai,2023-08-30,16:00:00,480,208,272,FMN 01 Ernest Van Dijckkaai
649,Ernest Van Dijckkaai,2023-08-30,17:00:00,636,239,397,FMN 01 Ernest Van Dijckkaai
649,Ernest Van Dijckkaai,2023-08-30,18:00:00,473,222,251,FMN 01 Ernest Van Dijckkaai
649,Ernest Van Dijckkaai,2023-08-30,19:00:00,324,156,168,FMN 01 Ernest Van Dijckkaai
649,Ernest Van Dijckkaai,2023-08-30,20:00:00,246,115,131,FMN 01 Ernest Van Dijckkaai
649,Ernest Van Dijckkaai,2023-08-30,21:00:00,188,90,98,FMN 01 Ernest Van Dijckkaai
649,Ernest Van Dijckkaai,2023-08-30,22:00:00,166,58,108,FMN 01 Ernest Van Dijckkaai
649,Ernest Van Dijckkaai,2023-08-30,23:00:00,89,40,49,FMN 01 Ernest Van Dijckkaai
649,Ernest Van Dijckkaai,2023-08-31,00:00:00,45,20,25,FMN 01 Ernest Van Dijckkaai
649,Ernest Van Dijckkaai,2023-08-31,01:00:00,35,19,16,FMN 01 Ernest Van Dijckkaai
649,Ernest Van Dijckkaai,2023-08-31,02:00:00,17,4,13,FMN 01 Ernest Van Dijckkaai
649,Ernest Van Dijckkaai,2023-08-31,03:00:00,9,3,6,FMN 01 Ernest Van Dijckkaai
649,Ernest Van Dijckkaai,2023-08-31,04:00:00,54,39,15,FMN 01 Ernest Van Dijckkaai
649,Ernest Van Dijckkaai,2023-08-31,05:00:00,141,90,51,FMN 01 Ernest Van Dijckkaai
649,Ernest Van Dijckkaai,2023-08-31,06:00:00,243,155,88,FMN 01 Ernest Van Dijckkaai
649,Ernest Van Dijckkaai,2023-08-31,07:00:00,358,226,132,FMN 01 Ernest Van Dijckkaai
649,Ernest Van Dijckkaai,2023-08-31,08:00:00,494,308,186,FMN 01 Ernest Van Dijckkaai
649,Ernest Van Dijckkaai,2023-08-31,09:00:00,319,191,128,FMN 01 Ernest Van Dijckkaai
649,Ernest Van Dijckkaai,2023-08-31,10:00:00,267,139,128,FMN 01 Ernest Van Dijckkaai
649,Ernest Van Dijckkaai,2023-08-31,11:00:00,278,159,119,FMN 01 Ernest Van Dijckkaai
649,Ernest Van Dijckkaai,2023-08-31,12:00:00,349,189,160,FMN 01 Ernest Van Dijckkaai
649,Ernest Van Dijckkaai,2023-08-31,13:00:00,337,187,150,FMN 01 Ernest Van Dijckkaai
649,Ernest Van Dijckkaai,2023-08-31,14:00:00,454,230,224,FMN 01 Ernest Van Dijckkaai
649,Ernest Van Dijckkaai,2023-08-31,15:00:00,418,191,227,FMN 01 Ernest Van Dijckkaai
649,Ernest Van Dijckkaai,2023-08-31,16:00:00,569,244,325,FMN 01 Ernest Van Dijckkaai
649,Ernest Van Dijckkaai,2023-08-31,17:00:00,662,288,374,FMN 01 Ernest Van Dijckkaai
649,Ernest Van Dijckkaai,2023-08-31,18:00:00,484,245,239,FMN 01 Ernest Van Dijckkaai
649,Ernest Van Dijckkaai,2023-08-31,19:00:00,318,130,188,FMN 01 Ernest Van Dijckkaai
649,Ernest Van Dijckkaai,2023-08-31,20:00:00,262,107,155,FMN 01 Ernest Van Dijckkaai
649,Ernest Van Dijckkaai,2023-08-31,21:00:00,223,101,122,FMN 01 Ernest Van Dijckkaai
649,Ernest Van Dijckkaai,2023-08-31,22:00:00,216,61,155,FMN 01 Ernest Van Dijckkaai
649,Ernest Van Dijckkaai,2023-08-31,23:00:00,107,65,42,FMN 01 Ernest Van Dijckkaai
649,Ernest Van Dijckkaai,2023-09-01,00:00:00,69,40,29,FMN 01 Ernest Van Dijckkaai
649,Ernest Van Dijckkaai,2023-09-01,01:00:00,33,12,21,FMN 01 Ernest Van Dijckkaai
649,Ernest Van Dijckkaai,2023-09-01,02:00:00,17,2,15,FMN 01 Ernest Van Dijckkaai
649,Ernest Van Dijckkaai,2023-09-01,03:00:00,25,2,23,FMN 01 Ernest Van Dijckkaai
649,Ernest Van Dijckkaai,2023-09-01,04:00:00,51,29,22,FMN 01 Ernest Van Dijckkaai
649,Ernest Van Dijckkaai,2023-09-01,05:00:00,107,59,48,FMN 01 Ernest Van Dijckkaai
649,Ernest Van Dijckkaai,2023-09-01,06:00:00,178,110,68,FMN 01 Ernest Van Dijckkaai
649,Ernest Van Dijckkaai,2023-09-01,07:00:00,274,175,99,FMN 01 Ernest Van Dijckkaai
649,Ernest Van Dijckkaai,2023-09-01,08:00:00,312,180,132,FMN 01 Ernest Van Dijckkaai
649,Ernest Van Dijckkaai,2023-09-01,09:00:00,187,142,45,FMN 01 Ernest Van Dijckkaai
649,Ernest Van Dijckkaai,2023-09-01,10:00:00,77,43,34,FMN 01 Ernest Van Dijckkaai
649,Ernest Van Dijckkaai,2023-09-01,11:00:00,123,51,72,FMN 01 Ernest Van Dijckkaai
649,Ernest Van Dijckkaai,2023-09-01,12:00:00,136,70,66,FMN 01 Ernest Van Dijckkaai
649,Ernest Van Dijckkaai,2023-09-01,13:00:00,181,91,90,FMN 01 Ernest Van Dijckkaai
649,Ernest Van Dijckkaai,2023-09-01,14:00:00,266,119,147,FMN 01 Ernest Van Dijckkaai
649,Ernest Van Dijckkaai,2023-09-01,15:00:00,418,181,237,FMN 01 Ernest Van Dijckkaai
649,Ernest Van Dijckkaai,2023-09-01,16:00:00,441,189,252,FMN 01 Ernest Van Dijckkaai
649,Ernest Van Dijckkaai,2023-09-01,17:00:00,457,173,284,FMN 01 Ernest Van Dijckkaai
649,Ernest Van Dijckkaai,2023-09-01,18:00:00,364,176,188,FMN 01 Ernest Van Dijckkaai
649,Ernest Van Dijckkaai,2023-09-01,19:00:00,325,177,148,FMN 01 Ernest Van Dijckkaai
649,Ernest Van Dijckkaai,2023-09-01,20:00:00,204,98,106,FMN 01 Ernest Van Dijckkaai
649,Ernest Van Dijckkaai,2023-09-01,21:00:00,187,81,106,FMN 01 Ernest Van Dijckkaai
649,Ernest Van Dijckkaai,2023-09-01,22:00:00,205,82,123,FMN 01 Ernest Van Dijckkaai
649,Ernest Van Dijckkaai,2023-09-01,23:00:00,177,77,100,FMN 01 Ernest Van Dijckkaai
649,Ernest Van Dijckkaai,2023-09-02,00:00:00,116,74,42,FMN 01 Ernest Van Dijckkaai
649,Ernest Van Dijckkaai,2023-09-02,01:00:00,117,52,65,FMN 01 Ernest Van Dijckkaai
649,Ernest Van Dijckkaai,2023-09-02,02:00:00,55,19,36,FMN 01 Ernest Van Dijckkaai
649,Ernest Van Dijckkaai,2023-09-02,03:00:00,48,19,29,FMN 01 Ernest Van Dijckkaai
649,Ernest Van Dijckkaai,2023-09-02,04:00:00,37,23,14,FMN 01 Ernest Van Dijckkaai
649,Ernest Van Dijckkaai,2023-09-02,05:00:00,44,25,19,FMN 01 Ernest Van Dijckkaai
649,Ernest Van Dijckkaai,2023-09-02,06:00:00,53,23,30,FMN 01 Ernest Van Dijckkaai
649,Ernest Van Dijckkaai,2023-09-02,07:00:00,65,29,36,FMN 01 Ernest Van Dijckkaai
649,Ernest Van Dijckkaai,2023-09-02,08:00:00,100,54,46,FMN 01 Ernest Van Dijckkaai
649,Ernest Van Dijckkaai,2023-09-02,09:00:00,183,103,80,FMN 01 Ernest Van Dijckkaai
649,Ernest Van Dijckkaai,2023-09-02,10:00:00,231,121,110,FMN 01 Ernest Van Dijckkaai
649,Ernest Van Dijckkaai,2023-09-02,11:00:00,329,142,187,FMN 01 Ernest Van Dijckkaai
649,Ernest Van Dijckkaai,2023-09-02,12:00:00,348,180,168,FMN 01 Ernest Van Dijckkaai
649,Ernest Van Dijckkaai,2023-09-02,13:00:00,416,231,185,FMN 01 Ernest Van Dijckkaai
649,Ernest Van Dijckkaai,2023-09-02,14:00:00,578,262,316,FMN 01 Ernest Van Dijckkaai
649,Ernest Van Dijckkaai,2023-09-02,15:00:00,595,284,311,FMN 01 Ernest Van Dijckkaai
649,Ernest Van Dijckkaai,2023-09-02,16:00:00,658,330,328,FMN 01 Ernest Van Dijckkaai
649,Ernest Van Dijckkaai,2023-09-02,17:00:00,569,290,279,FMN 01 Ernest Van Dijckkaai
649,Ernest Van Dijckkaai,2023-09-02,18:00:00,457,211,246,FMN 01 Ernest Van Dijckkaai
649,Ernest Van Dijckkaai,2023-09-02,19:00:00,415,212,203,FMN 01 Ernest Van Dijckkaai
649,Ernest Van Dijckkaai,2023-09-02,20:00:00,312,161,151,FMN 01 Ernest Van Dijckkaai
649,Ernest Van Dijckkaai,2023-09-02,21:00:00,288,154,134,FMN 01 Ernest Van Dijckkaai
649,Ernest Van Dijckkaai,2023-09-02,22:00:00,250,103,147,FMN 01 Ernest Van Dijckkaai
649,Ernest Van Dijckkaai,2023-09-02,23:00:00,206,103,103,FMN 01 Ernest Van Dijckkaai
649,Ernest Van Dijckkaai,2023-09-03,00:00:00,178,112,66,FMN 01 Ernest Van Dijckkaai
649,Ernest Van Dijckkaai,2023-09-03,01:00:00,119,60,59,FMN 01 Ernest Van Dijckkaai
649,Ernest Van Dijckkaai,2023-09-03,02:00:00,78,38,40,FMN 01 Ernest Van Dijckkaai
649,Ernest Van Dijckkaai,2023-09-03,03:00:00,40,14,26,FMN 01 Ernest Van Dijckkaai
649,Ernest Van Dijckkaai,2023-09-03,04:00:00,49,15,34,FMN 01 Ernest Van Dijckkaai
649,Ernest Van Dijckkaai,2023-09-03,05:00:00,20,12,8,FMN 01 Ernest Van Dijckkaai
649,Ernest Van Dijckkaai,2023-09-03,06:00:00,50,20,30,FMN 01 Ernest Van Dijckkaai
649,Ernest Van Dijckkaai,2023-09-03,07:00:00,33,16,17,FMN 01 Ernest Van Dijckkaai
649,Ernest Van Dijckkaai,2023-09-03,08:00:00,79,46,33,FMN 01 Ernest Van Dijckkaai
649,Ernest Van Dijckkaai,2023-09-03,09:00:00,212,122,90,FMN 01 Ernest Van Dijckkaai
649,Ernest Van Dijckkaai,2023-09-03,10:00:00,301,185,116,FMN 01 Ernest Van Dijckkaai
649,Ernest Van Dijckkaai,2023-09-03,11:00:00,423,212,211,FMN 01 Ernest Van Dijckkaai
649,Ernest Van Dijckkaai,2023-09-03,12:00:00,518,240,278,FMN 01 Ernest Van Dijckkaai
649,Ernest Van Dijckkaai,2023-09-03,13:00:00,553,291,262,FMN 01 Ernest Van Dijckkaai
649,Ernest Van Dijckkaai,2023-09-03,14:00:00,723,402,321,FMN 01 Ernest Van Dijckkaai
649,Ernest Van Dijckkaai,2023-09-03,15:00:00,768,359,409,FMN 01 Ernest Van Dijckkaai
649,Ernest Van Dijckkaai,2023-09-03,16:00:00,716,397,319,FMN 01 Ernest Van Dijckkaai
649,Ernest Van Dijckkaai,2023-09-03,17:00:00,679,296,383,FMN 01 Ernest Van Dijckkaai
649,Ernest Van Dijckkaai,2023-09-03,18:00:00,522,253,269,FMN 01 Ernest Van Dijckkaai
649,Ernest Van Dijckkaai,2023-09-03,19:00:00,422,171,251,FMN 01 Ernest Van Dijckkaai
649,Ernest Van Dijckkaai,2023-09-03,20:00:00,333,134,199,FMN 01 Ernest Van Dijckkaai
649,Ernest Van Dijckkaai,2023-09-03,21:00:00,228,97,131,FMN 01 Ernest Van Dijckkaai
649,Ernest Van Dijckkaai,2023-09-03,22:00:00,162,53,109,FMN 01 Ernest Van Dijckkaai
649,Ernest Van Dijckkaai,2023-09-03,23:00:00,82,39,43,FMN 01 Ernest Van Dijckkaai
649,Ernest Van Dijckkaai,2023-09-04,00:00:00,34,16,18,FMN 01 Ernest Van Dijckkaai
649,Ernest Van Dijckkaai,2023-09-04,01:00:00,15,8,7,FMN 01 Ernest Van Dijckkaai
649,Ernest Van Dijckkaai,2023-09-04,02:00:00,15,5,10,FMN 01 Ernest Van Dijckkaai
649,Ernest Van Dijckkaai,2023-09-04,03:00:00,12,6,6,FMN 01 Ernest Van Dijckkaai
649,Ernest Van Dijckkaai,2023-09-04,04:00:00,69,43,26,FMN 01 Ernest Van Dijckkaai
649,Ernest Van Dijckkaai,2023-09-04,05:00:00,116,73,43,FMN 01 Ernest Van Dijckkaai
649,Ernest Van Dijckkaai,2023-09-04,06:00:00,273,175,98,FMN 01 Ernest Van Dijckkaai
649,Ernest Van Dijckkaai,2023-09-04,07:00:00,517,319,198,FMN 01 Ernest Van Dijckkaai
649,Ernest Van Dijckkaai,2023-09-04,08:00:00,760,450,310,FMN 01 Ernest Van Dijckkaai
649,Ernest Van Dijckkaai,2023-09-04,09:00:00,324,186,138,FMN 01 Ernest Van Dijckkaai
649,Ernest Van Dijckkaai,2023-09-04,10:00:00,242,114,128,FMN 01 Ernest Van Dijckkaai
649,Ernest Van Dijckkaai,2023-09-04,11:00:00,249,116,133,FMN 01 Ernest Van Dijckkaai
649,Ernest Van Dijckkaai,2023-09-04,12:00:00,326,167,159,FMN 01 Ernest Van Dijckkaai
649,Ernest Van Dijckkaai,2023-09-04,13:00:00,381,222,159,FMN 01 Ernest Van Dijckkaai
649,Ernest Van Dijckkaai,2023-09-04,14:00:00,475,214,261,FMN 01 Ernest Van Dijckkaai
649,Ernest Van Dijckkaai,2023-09-04,15:00:00,490,232,258,FMN 01 Ernest Van Dijckkaai
649,Ernest Van Dijckkaai,2023-09-04,16:00:00,827,381,446,FMN 01 Ernest Van Dijckkaai
649,Ernest Van Dijckkaai,2023-09-04,17:00:00,891,331,560,FMN 01 Ernest Van Dijckkaai
649,Ernest Van Dijckkaai,2023-09-04,18:00:00,507,235,272,FMN 01 Ernest Van Dijckkaai
649,Ernest Van Dijckkaai,2023-09-04,19:00:00,353,169,184,FMN 01 Ernest Van Dijckkaai
649,Ernest Van Dijckkaai,2023-09-04,20:00:00,294,154,140,FMN 01 Ernest Van Dijckkaai
649,Ernest Van Dijckkaai,2023-09-04,21:00:00,232,102,130,FMN 01 Ernest Van Dijckkaai
649,Ernest Van Dijckkaai,2023-09-04,22:00:00,208,56,152,FMN 01 Ernest Van Dijckkaai
649,Ernest Van Dijckkaai,2023-09-04,23:00:00,76,31,45,FMN 01 Ernest Van Dijckkaai
649,Ernest Van Dijckkaai,2023-09-05,00:00:00,40,15,25,FMN 01 Ernest Van Dijckkaai
649,Ernest Van Dijckkaai,2023-09-05,01:00:00,14,7,7,FMN 01 Ernest Van Dijckkaai
649,Ernest Van Dijckkaai,2023-09-05,02:00:00,10,3,7,FMN 01 Ernest Van Dijckkaai
649,Ernest Van Dijckkaai,2023-09-05,03:00:00,15,2,13,FMN 01 Ernest Van Dijckkaai
649,Ernest Van Dijckkaai,2023-09-05,04:00:00,62,39,23,FMN 01 Ernest Van Dijckkaai
649,Ernest Van Dijckkaai,2023-09-05,05:00:00,126,74,52,FMN 01 Ernest Van Dijckkaai
649,Ernest Van Dijckkaai,2023-09-05,06:00:00,306,198,108,FMN 01 Ernest Van Dijckkaai
649,Ernest Van Dijckkaai,2023-09-05,07:00:00,573,355,218,FMN 01 Ernest Van Dijckkaai
649,Ernest Van Dijckkaai,2023-09-05,08:00:00,792,457,335,FMN 01 Ernest Van Dijckkaai
649,Ernest Van Dijckkaai,2023-09-05,09:00:00,381,213,168,FMN 01 Ernest Van Dijckkaai
649,Ernest Van Dijckkaai,2023-09-05,10:00:00,245,144,101,FMN 01 Ernest Van Dijckkaai
649,Ernest Van Dijckkaai,2023-09-05,11:00:00,296,163,133,FMN 01 Ernest Van Dijckkaai
649,Ernest Van Dijckkaai,2023-09-05,12:00:00,389,200,189,FMN 01 Ernest Van Dijckkaai
649,Ernest Van Dijckkaai,2023-09-05,13:00:00,408,214,194,FMN 01 Ernest Van Dijckkaai
649,Ernest Van Dijckkaai,2023-09-05,14:00:00,519,254,265,FMN 01 Ernest Van Dijckkaai
649,Ernest Van Dijckkaai,2023-09-05,15:00:00,596,283,313,FMN 01 Ernest Van Dijckkaai
649,Ernest Van Dijckkaai,2023-09-05,16:00:00,843,343,500,FMN 01 Ernest Van Dijckkaai
649,Ernest Van Dijckkaai,2023-09-05,17:00:00,907,382,525,FMN 01 Ernest Van Dijckkaai
649,Ernest Van Dijckkaai,2023-09-05,18:00:00,630,305,325,FMN 01 Ernest Van Dijckkaai
649,Ernest Van Dijckkaai,2023-09-05,19:00:00,446,217,229,FMN 01 Ernest Van Dijckkaai
649,Ernest Van Dijckkaai,2023-09-05,20:00:00,407,180,227,FMN 01 Ernest Van Dijckkaai
649,Ernest Van Dijckkaai,2023-09-05,21:00:00,324,149,175,FMN 01 Ernest Van Dijckkaai
649,Ernest Van Dijckkaai,2023-09-05,22:00:00,268,95,173,FMN 01 Ernest Van Dijckkaai
649,Ernest Van Dijckkaai,2023-09-05,23:00:00,88,33,55,FMN 01 Ernest Van Dijckkaai
649,Ernest Van Dijckkaai,2023-09-06,00:00:00,51,21,30,FMN 01 Ernest Van Dijckkaai
649,Ernest Van Dijckkaai,2023-09-06,01:00:00,29,13,16,FMN 01 Ernest Van Dijckkaai
649,Ernest Van Dijckkaai,2023-09-06,02:00:00,16,4,12,FMN 01 Ernest Van Dijckkaai
649,Ernest Van Dijckkaai,2023-09-06,03:00:00,11,4,7,FMN 01 Ernest Van Dijckkaai
649,Ernest Van Dijckkaai,2023-09-06,04:00:00,62,38,24,FMN 01 Ernest Van Dijckkaai
649,Ernest Van Dijckkaai,2023-09-06,05:00:00,144,82,62,FMN 01 Ernest Van Dijckkaai
649,Ernest Van Dijckkaai,2023-09-06,06:00:00,329,212,117,FMN 01 Ernest Van Dijckkaai
649,Ernest Van Dijckkaai,2023-09-06,07:00:00,518,334,184,FMN 01 Ernest Van Dijckkaai
649,Ernest Van Dijckkaai,2023-09-06,08:00:00,650,379,271,FMN 01 Ernest Van Dijckkaai
649,Ernest Van Dijckkaai,2023-09-06,09:00:00,339,189,150,FMN 01 Ernest Van Dijckkaai
649,Ernest Van Dijckkaai,2023-09-06,10:00:00,273,154,119,FMN 01 Ernest Van Dijckkaai
649,Ernest Van Dijckkaai,2023-09-06,11:00:00,312,169,143,FMN 01 Ernest Van Dijckkaai
649,Ernest Van Dijckkaai,2023-09-06,12:00:00,476,220,256,FMN 01 Ernest Van Dijckkaai
649,Ernest Van Dijckkaai,2023-09-06,13:00:00,452,222,230,FMN 01 Ernest Van Dijckkaai
649,Ernest Van Dijckkaai,2023-09-06,14:00:00,453,229,224,FMN 01 Ernest Van Dijckkaai
649,Ernest Van Dijckkaai,2023-09-06,15:00:00,523,280,243,FMN 01 Ernest Van Dijckkaai
649,Ernest Van Dijckkaai,2023-09-06,16:00:00,691,295,396,FMN 01 Ernest Van Dijckkaai
649,Ernest Van Dijckkaai,2023-09-06,17:00:00,816,325,491,FMN 01 Ernest Van Dijckkaai
649,Ernest Van Dijckkaai,2023-09-06,18:00:00,570,297,273,FMN 01 Ernest Van Dijckkaai
649,Ernest Van Dijckkaai,2023-09-06,19:00:00,437,228,209,FMN 01 Ernest Van Dijckkaai
649,Ernest Van Dijckkaai,2023-09-06,20:00:00,456,196,260,FMN 01 Ernest Van Dijckkaai
649,Ernest Van Dijckkaai,2023-09-06,21:00:00,316,133,183,FMN 01 Ernest Van Dijckkaai
649,Ernest Van Dijckkaai,2023-09-06,22:00:00,257,98,159,FMN 01 Ernest Van Dijckkaai
649,Ernest Van Dijckkaai,2023-09-06,23:00:00,154,44,110,FMN 01 Ernest Van Dijckkaai
649,Ernest Van Dijckkaai,2023-09-07,00:00:00,90,32,58,FMN 01 Ernest Van Dijckkaai
649,Ernest Van Dijckkaai,2023-09-07,01:00:00,46,22,24,FMN 01 Ernest Van Dijckkaai
649,Ernest Van Dijckkaai,2023-09-07,02:00:00,45,27,18,FMN 01 Ernest Van Dijckkaai
649,Ernest Van Dijckkaai,2023-09-07,03:00:00,28,14,14,FMN 01 Ernest Van Dijckkaai
649,Ernest Van Dijckkaai,2023-09-07,04:00:00,92,58,34,FMN 01 Ernest Van Dijckkaai
649,Ernest Van Dijckkaai,2023-09-07,05:00:00,155,112,43,FMN 01 Ernest Van Dijckkaai
649,Ernest Van Dijckkaai,2023-09-07,06:00:00,293,181,112,FMN 01 Ernest Van Dijckkaai
649,Ernest Van Dijckkaai,2023-09-07,07:00:00,564,352,212,FMN 01 Ernest Van Dijckkaai
649,Ernest Van Dijckkaai,2023-09-07,08:00:00,733,447,286,FMN 01 Ernest Van Dijckkaai
649,Ernest Van Dijckkaai,2023-09-07,09:00:00,353,189,164,FMN 01 Ernest Van Dijckkaai
649,Ernest Van Dijckkaai,2023-09-07,10:00:00,284,166,118,FMN 01 Ernest Van Dijckkaai
649,Ernest Van Dijckkaai,2023-09-07,11:00:00,302,150,152,FMN 01 Ernest Van Dijckkaai
649,Ernest Van Dijckkaai,2023-09-07,12:00:00,431,234,197,FMN 01 Ernest Van Dijckkaai
649,Ernest Van Dijckkaai,2023-09-07,13:00:00,407,226,181,FMN 01 Ernest Van Dijckkaai
649,Ernest Van Dijckkaai,2023-09-07,14:00:00,439,200,239,FMN 01 Ernest Van Dijckkaai
649,Ernest Van Dijckkaai,2023-09-07,15:00:00,559,257,302,FMN 01 Ernest Van Dijckkaai
649,Ernest Van Dijckkaai,2023-09-07,16:00:00,802,347,455,FMN 01 Ernest Van Dijckkaai
649,Ernest Van Dijckkaai,2023-09-07,17:00:00,836,365,471,FMN 01 Ernest Van Dijckkaai
649,Ernest Van Dijckkaai,2023-09-07,18:00:00,683,352,331,FMN 01 Ernest Van Dijckkaai
649,Ernest Van Dijckkaai,2023-09-07,19:00:00,425,215,210,FMN 01 Ernest Van Dijckkaai
649,Ernest Van Dijckkaai,2023-09-07,20:00:00,441,204,237,FMN 01 Ernest Van Dijckkaai
649,Ernest Van Dijckkaai,2023-09-07,21:00:00,386,149,237,FMN 01 Ernest Van Dijckkaai
649,Ernest Van Dijckkaai,2023-09-07,22:00:00,311,129,182,FMN 01 Ernest Van Dijckkaai
649,Ernest Van Dijckkaai,2023-09-07,23:00:00,177,72,105,FMN 01 Ernest Van Dijckkaai
649,Ernest Van Dijckkaai,2023-09-08,00:00:00,102,44,58,FMN 01 Ernest Van Dijckkaai
649,Ernest Van Dijckkaai,2023-09-08,01:00:00,46,17,29,FMN 01 Ernest Van Dijckkaai
649,Ernest Van Dijckkaai,2023-09-08,02:00:00,36,14,22,FMN 01 Ernest Van Dijckkaai
649,Ernest Van Dijckkaai,2023-09-08,03:00:00,24,3,21,FMN 01 Ernest Van Dijckkaai
649,Ernest Van Dijckkaai,2023-09-08,04:00:00,97,51,46,FMN 01 Ernest Van Dijckkaai
649,Ernest Van Dijckkaai,2023-09-08,05:00:00,172,88,84,FMN 01 Ernest Van Dijckkaai
649,Ernest Van Dijckkaai,2023-09-08,06:00:00,246,151,95,FMN 01 Ernest Van Dijckkaai
649,Ernest Van Dijckkaai,2023-09-08,07:00:00,453,286,167,FMN 01 Ernest Van Dijckkaai
649,Ernest Van Dijckkaai,2023-09-08,08:00:00,606,367,239,FMN 01 Ernest Van Dijckkaai
649,Ernest Van Dijckkaai,2023-09-08,09:00:00,320,197,123,FMN 01 Ernest Van Dijckkaai
649,Ernest Van Dijckkaai,2023-09-08,10:00:00,267,135,132,FMN 01 Ernest Van Dijckkaai
649,Ernest Van Dijckkaai,2023-09-08,11:00:00,280,146,134,FMN 01 Ernest Van Dijckkaai
649,Ernest Van Dijckkaai,2023-09-08,12:00:00,452,228,224,FMN 01 Ernest Van Dijckkaai
649,Ernest Van Dijckkaai,2023-09-08,13:00:00,373,191,182,FMN 01 Ernest Van Dijckkaai
649,Ernest Van Dijckkaai,2023-09-08,14:00:00,454,204,250,FMN 01 Ernest Van Dijckkaai
649,Ernest Van Dijckkaai,2023-09-08,15:00:00,608,261,347,FMN 01 Ernest Van Dijckkaai
649,Ernest Van Dijckkaai,2023-09-08,16:00:00,692,313,379,FMN 01 Ernest Van Dijckkaai
649,Ernest Van Dijckkaai,2023-09-08,17:00:00,732,364,368,FMN 01 Ernest Van Dijckkaai
649,Ernest Van Dijckkaai,2023-09-08,18:00:00,673,392,281,FMN 01 Ernest Van Dijckkaai
649,Ernest Van Dijckkaai,2023-09-08,19:00:00,562,330,232,FMN 01 Ernest Van Dijckkaai
649,Ernest Van Dijckkaai,2023-09-08,20:00:00,590,355,235,FMN 01 Ernest Van Dijckkaai
649,Ernest Van Dijckkaai,2023-09-08,21:00:00,528,284,244,FMN 01 Ernest Van Dijckkaai
649,Ernest Van Dijckkaai,2023-09-08,22:00:00,509,225,284,FMN 01 Ernest Van Dijckkaai
649,Ernest Van Dijckkaai,2023-09-08,23:00:00,383,133,250,FMN 01 Ernest Van Dijckkaai
649,Ernest Van Dijckkaai,2023-09-09,00:00:00,320,83,237,FMN 01 Ernest Van Dijckkaai
649,Ernest Van Dijckkaai,2023-09-09,01:00:00,191,62,129,FMN 01 Ernest Van Dijckkaai
649,Ernest Van Dijckkaai,2023-09-09,02:00:00,102,29,73,FMN 01 Ernest Van Dijckkaai
649,Ernest Van Dijckkaai,2023-09-09,03:00:00,73,17,56,FMN 01 Ernest Van Dijckkaai
649,Ernest Van Dijckkaai,2023-09-09,04:00:00,75,25,50,FMN 01 Ernest Van Dijckkaai
649,Ernest Van Dijckkaai,2023-09-09,05:00:00,40,30,10,FMN 01 Ernest Van Dijckkaai
649,Ernest Van Dijckkaai,2023-09-09,06:00:00,62,26,36,FMN 01 Ernest Van Dijckkaai
649,Ernest Van Dijckkaai,2023-09-09,07:00:00,59,27,32,FMN 01 Ernest Van Dijckkaai
649,Ernest Van Dijckkaai,2023-09-09,08:00:00,119,55,64,FMN 01 Ernest Van Dijckkaai
649,Ernest Van Dijckkaai,2023-09-09,09:00:00,244,138,106,FMN 01 Ernest Van Dijckkaai
649,Ernest Van Dijckkaai,2023-09-09,10:00:00,315,168,147,FMN 01 Ernest Van Dijckkaai
649,Ernest Van Dijckkaai,2023-09-09,11:00:00,440,238,202,FMN 01 Ernest Van Dijckkaai
649,Ernest Van Dijckkaai,2023-09-09,12:00:00,462,259,203,FMN 01 Ernest Van Dijckkaai
649,Ernest Van Dijckkaai,2023-09-09,13:00:00,480,250,230,FMN 01 Ernest Van Dijckkaai
649,Ernest Van Dijckkaai,2023-09-09,14:00:00,585,302,283,FMN 01 Ernest Van Dijckkaai
649,Ernest Van Dijckkaai,2023-09-09,15:00:00,585,300,285,FMN 01 Ernest Van Dijckkaai
649,Ernest Van Dijckkaai,2023-09-09,16:00:00,621,327,294,FMN 01 Ernest Van Dijckkaai
649,Ernest Van Dijckkaai,2023-09-09,17:00:00,576,284,292,FMN 01 Ernest Van Dijckkaai
649,Ernest Van Dijckkaai,2023-09-09,18:00:00,580,270,310,FMN 01 Ernest Van Dijckkaai
649,Ernest Van Dijckkaai,2023-09-09,19:00:00,524,269,255,FMN 01 Ernest Van Dijckkaai
649,Ernest Van Dijckkaai,2023-09-09,20:00:00,512,255,257,FMN 01 Ernest Van Dijckkaai
649,Ernest Van Dijckkaai,2023-09-09,21:00:00,327,142,185,FMN 01 Ernest Van Dijckkaai
649,Ernest Van Dijckkaai,2023-09-09,22:00:00,352,154,198,FMN 01 Ernest Van Dijckkaai
649,Ernest Van Dijckkaai,2023-09-09,23:00:00,279,139,140,FMN 01 Ernest Van Dijckkaai
649,Ernest Van Dijckkaai,2023-09-10,00:00:00,224,110,114,FMN 01 Ernest Van Dijckkaai
649,Ernest Van Dijckkaai,2023-09-10,01:00:00,133,71,62,FMN 01 Ernest Van Dijckkaai
649,Ernest Van Dijckkaai,2023-09-10,02:00:00,96,34,62,FMN 01 Ernest Van Dijckkaai
649,Ernest Van Dijckkaai,2023-09-10,03:00:00,51,22,29,FMN 01 Ernest Van Dijckkaai
649,Ernest Van Dijckkaai,2023-09-10,04:00:00,63,16,47,FMN 01 Ernest Van Dijckkaai
649,Ernest Van Dijckkaai,2023-09-10,05:00:00,32,18,14,FMN 01 Ernest Van Dijckkaai
649,Ernest Van Dijckkaai,2023-09-10,06:00:00,57,32,25,FMN 01 Ernest Van Dijckkaai
649,Ernest Van Dijckkaai,2023-09-10,07:00:00,56,25,31,FMN 01 Ernest Van Dijckkaai
649,Ernest Van Dijckkaai,2023-09-10,08:00:00,139,91,48,FMN 01 Ernest Van Dijckkaai
649,Ernest Van Dijckkaai,2023-09-10,09:00:00,273,160,113,FMN 01 Ernest Van Dijckkaai
649,Ernest Van Dijckkaai,2023-09-10,10:00:00,381,238,143,FMN 01 Ernest Van Dijckkaai
649,Ernest Van Dijckkaai,2023-09-10,11:00:00,488,293,195,FMN 01 Ernest Van Dijckkaai
649,Ernest Van Dijckkaai,2023-09-10,12:00:00,514,283,231,FMN 01 Ernest Van Dijckkaai
649,Ernest Van Dijckkaai,2023-09-10,13:00:00,533,270,263,FMN 01 Ernest Van Dijckkaai
649,Ernest Van Dijckkaai,2023-09-10,14:00:00,592,311,281,FMN 01 Ernest Van Dijckkaai
649,Ernest Van Dijckkaai,2023-09-10,15:00:00,535,288,247,FMN 01 Ernest Van Dijckkaai
649,Ernest Van Dijckkaai,2023-09-10,16:00:00,519,214,305,FMN 01 Ernest Van Dijckkaai
649,Ernest Van Dijckkaai,2023-09-10,17:00:00,507,208,299,FMN 01 Ernest Van Dijckkaai
649,Ernest Van Dijckkaai,2023-09-10,18:00:00,433,195,238,FMN 01 Ernest Van Dijckkaai
649,Ernest Van Dijckkaai,2023-09-10,19:00:00,302,129,173,FMN 01 Ernest Van Dijckkaai
649,Ernest Van Dijckkaai,2023-09-10,20:00:00,311,140,171,FMN 01 Ernest Van Dijckkaai
649,Ernest Van Dijckkaai,2023-09-10,21:00:00,248,122,126,FMN 01 Ernest Van Dijckkaai
649,Ernest Van Dijckkaai,2023-09-10,22:00:00,139,61,78,FMN 01 Ernest Van Dijckkaai
649,Ernest Van Dijckkaai,2023-09-10,23:00:00,86,34,52,FMN 01 Ernest Van Dijckkaai
649,Ernest Van Dijckkaai,2023-09-11,00:00:00,44,16,28,FMN 01 Ernest Van Dijckkaai
649,Ernest Van Dijckkaai,2023-09-11,01:00:00,27,12,15,FMN 01 Ernest Van Dijckkaai
649,Ernest Van Dijckkaai,2023-09-11,02:00:00,22,14,8,FMN 01 Ernest Van Dijckkaai
649,Ernest Van Dijckkaai,2023-09-11,03:00:00,15,9,6,FMN 01 Ernest Van Dijckkaai
649,Ernest Van Dijckkaai,2023-09-11,04:00:00,70,48,22,FMN 01 Ernest Van Dijckkaai
649,Ernest Van Dijckkaai,2023-09-11,05:00:00,151,105,46,FMN 01 Ernest Van Dijckkaai
649,Ernest Van Dijckkaai,2023-09-11,06:00:00,294,186,108,FMN 01 Ernest Van Dijckkaai
649,Ernest Van Dijckkaai,2023-09-11,07:00:00,535,338,197,FMN 01 Ernest Van Dijckkaai
649,Ernest Van Dijckkaai,2023-09-11,08:00:00,776,438,338,FMN 01 Ernest Van Dijckkaai
649,Ernest Van Dijckkaai,2023-09-11,09:00:00,316,188,128,FMN 01 Ernest Van Dijckkaai
649,Ernest Van Dijckkaai,2023-09-11,10:00:00,241,131,110,FMN 01 Ernest Van Dijckkaai
649,Ernest Van Dijckkaai,2023-09-11,11:00:00,243,150,93,FMN 01 Ernest Van Dijckkaai
649,Ernest Van Dijckkaai,2023-09-11,12:00:00,362,180,182,FMN 01 Ernest Van Dijckkaai
649,Ernest Van Dijckkaai,2023-09-11,13:00:00,317,163,154,FMN 01 Ernest Van Dijckkaai
649,Ernest Van Dijckkaai,2023-09-11,14:00:00,452,200,252,FMN 01 Ernest Van Dijckkaai
649,Ernest Van Dijckkaai,2023-09-11,15:00:00,501,240,261,FMN 01 Ernest Van Dijckkaai
649,Ernest Van Dijckkaai,2023-09-11,16:00:00,766,328,438,FMN 01 Ernest Van Dijckkaai
649,Ernest Van Dijckkaai,2023-09-11,17:00:00,756,281,475,FMN 01 Ernest Van Dijckkaai
649,Ernest Van Dijckkaai,2023-09-11,18:00:00,483,245,238,FMN 01 Ernest Van Dijckkaai
649,Ernest Van Dijckkaai,2023-09-11,19:00:00,288,142,146,FMN 01 Ernest Van Dijckkaai
649,Ernest Van Dijckkaai,2023-09-11,20:00:00,258,141,117,FMN 01 Ernest Van Dijckkaai
649,Ernest Van Dijckkaai,2023-09-11,21:00:00,194,74,120,FMN 01 Ernest Van Dijckkaai
649,Ernest Van Dijckkaai,2023-09-11,22:00:00,172,60,112,FMN 01 Ernest Van Dijckkaai
649,Ernest Van Dijckkaai,2023-09-11,23:00:00,71,32,39,FMN 01 Ernest Van Dijckkaai
649,Ernest Van Dijckkaai,2023-09-12,00:00:00,25,8,17,FMN 01 Ernest Van Dijckkaai
649,Ernest Van Dijckkaai,2023-09-12,01:00:00,10,7,3,FMN 01 Ernest Van Dijckkaai
649,Ernest Van Dijckkaai,2023-09-12,02:00:00,8,5,3,FMN 01 Ernest Van Dijckkaai
649,Ernest Van Dijckkaai,2023-09-12,03:00:00,7,3,4,FMN 01 Ernest Van Dijckkaai
649,Ernest Van Dijckkaai,2023-09-12,04:00:00,56,35,21,FMN 01 Ernest Van Dijckkaai
649,Ernest Van Dijckkaai,2023-09-12,05:00:00,169,111,58,FMN 01 Ernest Van Dijckkaai
649,Ernest Van Dijckkaai,2023-09-12,06:00:00,262,169,93,FMN 01 Ernest Van Dijckkaai
649,Ernest Van Dijckkaai,2023-09-12,07:00:00,504,313,191,FMN 01 Ernest Van Dijckkaai
649,Ernest Van Dijckkaai,2023-09-12,08:00:00,665,386,279,FMN 01 Ernest Van Dijckkaai
649,Ernest Van Dijckkaai,2023-09-12,09:00:00,300,192,108,FMN 01 Ernest Van Dijckkaai
649,Ernest Van Dijckkaai,2023-09-12,10:00:00,221,123,98,FMN 01 Ernest Van Dijckkaai
649,Ernest Van Dijckkaai,2023-09-12,11:00:00,225,107,118,FMN 01 Ernest Van Dijckkaai
649,Ernest Van Dijckkaai,2023-09-12,12:00:00,382,200,182,FMN 01 Ernest Van Dijckkaai
649,Ernest Van Dijckkaai,2023-09-12,13:00:00,297,146,151,FMN 01 Ernest Van Dijckkaai
649,Ernest Van Dijckkaai,2023-09-12,14:00:00,391,180,211,FMN 01 Ernest Van Dijckkaai
649,Ernest Van Dijckkaai,2023-09-12,15:00:00,469,237,232,FMN 01 Ernest Van Dijckkaai
649,Ernest Van Dijckkaai,2023-09-12,16:00:00,789,304,485,FMN 01 Ernest Van Dijckkaai
649,Ernest Van Dijckkaai,2023-09-12,17:00:00,707,289,418,FMN 01 Ernest Van Dijckkaai
649,Ernest Van Dijckkaai,2023-09-12,18:00:00,469,219,250,FMN 01 Ernest Van Dijckkaai
649,Ernest Van Dijckkaai,2023-09-12,19:00:00,277,146,131,FMN 01 Ernest Van Dijckkaai
649,Ernest Van Dijckkaai,2023-09-12,20:00:00,178,78,100,FMN 01 Ernest Van Dijckkaai
649,Ernest Van Dijckkaai,2023-09-12,21:00:00,147,50,97,FMN 01 Ernest Van Dijckkaai
649,Ernest Van Dijckkaai,2023-09-12,22:00:00,159,45,114,FMN 01 Ernest Van Dijckkaai
649,Ernest Van Dijckkaai,2023-09-12,23:00:00,74,32,42,FMN 01 Ernest Van Dijckkaai
649,Ernest Van Dijckkaai,2023-09-13,00:00:00,28,12,16,FMN 01 Ernest Van Dijckkaai
649,Ernest Van Dijckkaai,2023-09-13,01:00:00,14,5,9,FMN 01 Ernest Van Dijckkaai
649,Ernest Van Dijckkaai,2023-09-13,02:00:00,14,7,7,FMN 01 Ernest Van Dijckkaai
649,Ernest Van Dijckkaai,2023-09-13,03:00:00,18,5,13,FMN 01 Ernest Van Dijckkaai
649,Ernest Van Dijckkaai,2023-09-13,04:00:00,67,35,32,FMN 01 Ernest Van Dijckkaai
649,Ernest Van Dijckkaai,2023-09-13,05:00:00,135,90,45,FMN 01 Ernest Van Dijckkaai
649,Ernest Van Dijckkaai,2023-09-13,06:00:00,288,184,104,FMN 01 Ernest Van Dijckkaai
649,Ernest Van Dijckkaai,2023-09-13,07:00:00,463,293,170,FMN 01 Ernest Van Dijckkaai
649,Ernest Van Dijckkaai,2023-09-13,08:00:00,584,351,233,FMN 01 Ernest Van Dijckkaai
649,Ernest Van Dijckkaai,2023-09-13,09:00:00,299,164,135,FMN 01 Ernest Van Dijckkaai
649,Ernest Van Dijckkaai,2023-09-13,10:00:00,191,108,83,FMN 01 Ernest Van Dijckkaai
649,Ernest Van Dijckkaai,2023-09-13,11:00:00,196,103,93,FMN 01 Ernest Van Dijckkaai
649,Ernest Van Dijckkaai,2023-09-13,12:00:00,383,201,182,FMN 01 Ernest Van Dijckkaai
649,Ernest Van Dijckkaai,2023-09-13,13:00:00,363,200,163,FMN 01 Ernest Van Dijckkaai
649,Ernest Van Dijckkaai,2023-09-13,14:00:00,356,163,193,FMN 01 Ernest Van Dijckkaai
649,Ernest Van Dijckkaai,2023-09-13,15:00:00,427,201,226,FMN 01 Ernest Van Dijckkaai
649,Ernest Van Dijckkaai,2023-09-13,16:00:00,626,278,348,FMN 01 Ernest Van Dijckkaai
649,Ernest Van Dijckkaai,2023-09-13,17:00:00,741,298,443,FMN 01 Ernest Van Dijckkaai
649,Ernest Van Dijckkaai,2023-09-13,18:00:00,502,259,243,FMN 01 Ernest Van Dijckkaai
649,Ernest Van Dijckkaai,2023-09-13,19:00:00,353,164,189,FMN 01 Ernest Van Dijckkaai
649,Ernest Van Dijckkaai,2023-09-13,20:00:00,290,149,141,FMN 01 Ernest Van Dijckkaai
649,Ernest Van Dijckkaai,2023-09-13,21:00:00,224,94,130,FMN 01 Ernest Van Dijckkaai
649,Ernest Van Dijckkaai,2023-09-13,22:00:00,199,71,128,FMN 01 Ernest Van Dijckkaai
649,Ernest Van Dijckkaai,2023-09-13,23:00:00,104,42,62,FMN 01 Ernest Van Dijckkaai
649,Ernest Van Dijckkaai,2023-09-14,00:00:00,37,13,24,FMN 01 Ernest Van Dijckkaai
649,Ernest Van Dijckkaai,2023-09-14,01:00:00,20,6,14,FMN 01 Ernest Van Dijckkaai
649,Ernest Van Dijckkaai,2023-09-14,02:00:00,7,6,1,FMN 01 Ernest Van Dijckkaai
649,Ernest Van Dijckkaai,2023-09-14,03:00:00,11,2,9,FMN 01 Ernest Van Dijckkaai
649,Ernest Van Dijckkaai,2023-09-14,04:00:00,54,36,18,FMN 01 Ernest Van Dijckkaai
649,Ernest Van Dijckkaai,2023-09-14,05:00:00,144,91,53,FMN 01 Ernest Van Dijckkaai
649,Ernest Van Dijckkaai,2023-09-14,06:00:00,304,195,109,FMN 01 Ernest Van Dijckkaai
649,Ernest Van Dijckkaai,2023-09-14,07:00:00,490,304,186,FMN 01 Ernest Van Dijckkaai
649,Ernest Van Dijckkaai,2023-09-14,08:00:00,731,429,302,FMN 01 Ernest Van Dijckkaai
649,Ernest Van Dijckkaai,2023-09-14,09:00:00,344,214,130,FMN 01 Ernest Van Dijckkaai
649,Ernest Van Dijckkaai,2023-09-14,10:00:00,244,136,108,FMN 01 Ernest Van Dijckkaai
649,Ernest Van Dijckkaai,2023-09-14,11:00:00,260,126,134,FMN 01 Ernest Van Dijckkaai
649,Ernest Van Dijckkaai,2023-09-14,12:00:00,436,226,210,FMN 01 Ernest Van Dijckkaai
649,Ernest Van Dijckkaai,2023-09-14,13:00:00,349,183,166,FMN 01 Ernest Van Dijckkaai
649,Ernest Van Dijckkaai,2023-09-14,14:00:00,404,188,216,FMN 01 Ernest Van Dijckkaai
649,Ernest Van Dijckkaai,2023-09-14,15:00:00,523,265,258,FMN 01 Ernest Van Dijckkaai
649,Ernest Van Dijckkaai,2023-09-14,16:00:00,766,328,438,FMN 01 Ernest Van Dijckkaai
649,Ernest Van Dijckkaai,2023-09-14,17:00:00,839,379,460,FMN 01 Ernest Van Dijckkaai
649,Ernest Van Dijckkaai,2023-09-14,18:00:00,589,310,279,FMN 01 Ernest Van Dijckkaai
649,Ernest Van Dijckkaai,2023-09-14,19:00:00,445,223,222,FMN 01 Ernest Van Dijckkaai
649,Ernest Van Dijckkaai,2023-09-14,20:00:00,325,157,168,FMN 01 Ernest Van Dijckkaai
649,Ernest Van Dijckkaai,2023-09-14,21:00:00,236,97,139,FMN 01 Ernest Van Dijckkaai
649,Ernest Van Dijckkaai,2023-09-14,22:00:00,224,84,140,FMN 01 Ernest Van Dijckkaai
649,Ernest Van Dijckkaai,2023-09-14,23:00:00,140,39,101,FMN 01 Ernest Van Dijckkaai
649,Ernest Van Dijckkaai,2023-09-15,00:00:00,88,45,43,FMN 01 Ernest Van Dijckkaai
649,Ernest Van Dijckkaai,2023-09-15,01:00:00,54,31,23,FMN 01 Ernest Van Dijckkaai
649,Ernest Van Dijckkaai,2023-09-15,02:00:00,25,7,18,FMN 01 Ernest Van Dijckkaai
649,Ernest Van Dijckkaai,2023-09-15,03:00:00,24,9,15,FMN 01 Ernest Van Dijckkaai
649,Ernest Van Dijckkaai,2023-09-15,04:00:00,75,32,43,FMN 01 Ernest Van Dijckkaai
649,Ernest Van Dijckkaai,2023-09-15,05:00:00,134,78,56,FMN 01 Ernest Van Dijckkaai
649,Ernest Van Dijckkaai,2023-09-15,06:00:00,265,165,100,FMN 01 Ernest Van Dijckkaai
649,Ernest Van Dijckkaai,2023-09-15,07:00:00,431,275,156,FMN 01 Ernest Van Dijckkaai
649,Ernest Van Dijckkaai,2023-09-15,08:00:00,600,353,247,FMN 01 Ernest Van Dijckkaai
649,Ernest Van Dijckkaai,2023-09-15,09:00:00,347,213,134,FMN 01 Ernest Van Dijckkaai
649,Ernest Van Dijckkaai,2023-09-15,10:00:00,256,159,97,FMN 01 Ernest Van Dijckkaai
649,Ernest Van Dijckkaai,2023-09-15,11:00:00,331,166,165,FMN 01 Ernest Van Dijckkaai
649,Ernest Van Dijckkaai,2023-09-15,12:00:00,421,203,218,FMN 01 Ernest Van Dijckkaai
649,Ernest Van Dijckkaai,2023-09-15,13:00:00,506,261,245,FMN 01 Ernest Van Dijckkaai
649,Ernest Van Dijckkaai,2023-09-15,14:00:00,475,227,248,FMN 01 Ernest Van Dijckkaai
649,Ernest Van Dijckkaai,2023-09-15,15:00:00,653,328,325,FMN 01 Ernest Van Dijckkaai
649,Ernest Van Dijckkaai,2023-09-15,16:00:00,819,364,455,FMN 01 Ernest Van Dijckkaai
649,Ernest Van Dijckkaai,2023-09-15,17:00:00,729,329,400,FMN 01 Ernest Van Dijckkaai
649,Ernest Van Dijckkaai,2023-09-15,18:00:00,546,291,255,FMN 01 Ernest Van Dijckkaai
649,Ernest Van Dijckkaai,2023-09-15,19:00:00,430,227,203,FMN 01 Ernest Van Dijckkaai
649,Ernest Van Dijckkaai,2023-09-15,20:00:00,381,190,191,FMN 01 Ernest Van Dijckkaai
649,Ernest Van Dijckkaai,2023-09-15,21:00:00,258,130,128,FMN 01 Ernest Van Dijckkaai
649,Ernest Van Dijckkaai,2023-09-15,22:00:00,220,90,130,FMN 01 Ernest Van Dijckkaai
649,Ernest Van Dijckkaai,2023-09-15,23:00:00,198,73,125,FMN 01 Ernest Van Dijckkaai
649,Ernest Van Dijckkaai,2023-09-16,00:00:00,145,74,71,FMN 01 Ernest Van Dijckkaai
649,Ernest Van Dijckkaai,2023-09-16,01:00:00,126,56,70,FMN 01 Ernest Van Dijckkaai
649,Ernest Van Dijckkaai,2023-09-16,02:00:00,68,24,44,FMN 01 Ernest Van Dijckkaai
649,Ernest Van Dijckkaai,2023-09-16,03:00:00,48,18,30,FMN 01 Ernest Van Dijckkaai
649,Ernest Van Dijckkaai,2023-09-16,04:00:00,68,26,42,FMN 01 Ernest Van Dijckkaai
649,Ernest Van Dijckkaai,2023-09-16,05:00:00,73,32,41,FMN 01 Ernest Van Dijckkaai
649,Ernest Van Dijckkaai,2023-09-16,06:00:00,56,21,35,FMN 01 Ernest Van Dijckkaai
649,Ernest Van Dijckkaai,2023-09-16,07:00:00,55,23,32,FMN 01 Ernest Van Dijckkaai
649,Ernest Van Dijckkaai,2023-09-16,08:00:00,121,66,55,FMN 01 Ernest Van Dijckkaai
649,Ernest Van Dijckkaai,2023-09-16,09:00:00,243,139,104,FMN 01 Ernest Van Dijckkaai
649,Ernest Van Dijckkaai,2023-09-16,10:00:00,293,175,118,FMN 01 Ernest Van Dijckkaai
649,Ernest Van Dijckkaai,2023-09-16,11:00:00,356,206,150,FMN 01 Ernest Van Dijckkaai
649,Ernest Van Dijckkaai,2023-09-16,12:00:00,396,201,195,FMN 01 Ernest Van Dijckkaai
649,Ernest Van Dijckkaai,2023-09-16,13:00:00,480,234,246,FMN 01 Ernest Van Dijckkaai
649,Ernest Van Dijckkaai,2023-09-16,14:00:00,535,250,285,FMN 01 Ernest Van Dijckkaai
649,Ernest Van Dijckkaai,2023-09-16,15:00:00,637,284,353,FMN 01 Ernest Van Dijckkaai
649,Ernest Van Dijckkaai,2023-09-16,16:00:00,583,273,310,FMN 01 Ernest Van Dijckkaai
649,Ernest Van Dijckkaai,2023-09-16,17:00:00,582,283,299,FMN 01 Ernest Van Dijckkaai
649,Ernest Van Dijckkaai,2023-09-16,18:00:00,435,230,205,FMN 01 Ernest Van Dijckkaai
649,Ernest Van Dijckkaai,2023-09-16,19:00:00,326,173,153,FMN 01 Ernest Van Dijckkaai
649,Ernest Van Dijckkaai,2023-09-16,20:00:00,303,159,144,FMN 01 Ernest Van Dijckkaai
649,Ernest Van Dijckkaai,2023-09-16,21:00:00,178,76,102,FMN 01 Ernest Van Dijckkaai
649,Ernest Van Dijckkaai,2023-09-16,22:00:00,183,66,117,FMN 01 Ernest Van Dijckkaai
649,Ernest Van Dijckkaai,2023-09-16,23:00:00,154,59,95,FMN 01 Ernest Van Dijckkaai
649,Ernest Van Dijckkaai,2023-09-17,00:00:00,120,41,79,FMN 01 Ernest Van Dijckkaai
649,Ernest Van Dijckkaai,2023-09-17,01:00:00,82,41,41,FMN 01 Ernest Van Dijckkaai
649,Ernest Van Dijckkaai,2023-09-17,02:00:00,62,31,31,FMN 01 Ernest Van Dijckkaai
649,Ernest Van Dijckkaai,2023-09-17,03:00:00,65,32,33,FMN 01 Ernest Van Dijckkaai
649,Ernest Van Dijckkaai,2023-09-17,04:00:00,49,14,35,FMN 01 Ernest Van Dijckkaai
649,Ernest Van Dijckkaai,2023-09-17,05:00:00,42,23,19,FMN 01 Ernest Van Dijckkaai
649,Ernest Van Dijckkaai,2023-09-17,06:00:00,46,19,27,FMN 01 Ernest Van Dijckkaai
649,Ernest Van Dijckkaai,2023-09-17,07:00:00,43,22,21,FMN 01 Ernest Van Dijckkaai
649,Ernest Van Dijckkaai,2023-09-17,08:00:00,117,51,66,FMN 01 Ernest Van Dijckkaai
649,Ernest Van Dijckkaai,2023-09-17,09:00:00,285,154,131,FMN 01 Ernest Van Dijckkaai
649,Ernest Van Dijckkaai,2023-09-17,10:00:00,272,156,116,FMN 01 Ernest Van Dijckkaai
649,Ernest Van Dijckkaai,2023-09-17,11:00:00,395,220,175,FMN 01 Ernest Van Dijckkaai
649,Ernest Van Dijckkaai,2023-09-17,12:00:00,489,257,232,FMN 01 Ernest Van Dijckkaai
649,Ernest Van Dijckkaai,2023-09-17,13:00:00,584,304,280,FMN 01 Ernest Van Dijckkaai
649,Ernest Van Dijckkaai,2023-09-17,14:00:00,666,378,288,FMN 01 Ernest Van Dijckkaai
649,Ernest Van Dijckkaai,2023-09-17,15:00:00,731,372,359,FMN 01 Ernest Van Dijckkaai
649,Ernest Van Dijckkaai,2023-09-17,16:00:00,587,257,330,FMN 01 Ernest Van Dijckkaai
649,Ernest Van Dijckkaai,2023-09-17,17:00:00,601,279,322,FMN 01 Ernest Van Dijckkaai
649,Ernest Van Dijckkaai,2023-09-17,18:00:00,588,292,296,FMN 01 Ernest Van Dijckkaai
649,Ernest Van Dijckkaai,2023-09-17,19:00:00,330,175,155,FMN 01 Ernest Van Dijckkaai
649,Ernest Van Dijckkaai,2023-09-17,20:00:00,230,115,115,FMN 01 Ernest Van Dijckkaai
649,Ernest Van Dijckkaai,2023-09-17,21:00:00,148,66,82,FMN 01 Ernest Van Dijckkaai
649,Ernest Van Dijckkaai,2023-09-17,22:00:00,113,45,68,FMN 01 Ernest Van Dijckkaai
649,Ernest Van Dijckkaai,2023-09-17,23:00:00,78,41,37,FMN 01 Ernest Van Dijckkaai
649,Ernest Van Dijckkaai,2023-09-18,00:00:00,54,18,36,FMN 01 Ernest Van Dijckkaai
649,Ernest Van Dijckkaai,2023-09-18,01:00:00,21,5,16,FMN 01 Ernest Van Dijckkaai
649,Ernest Van Dijckkaai,2023-09-18,02:00:00,12,7,5,FMN 01 Ernest Van Dijckkaai
649,Ernest Van Dijckkaai,2023-09-18,03:00:00,8,4,4,FMN 01 Ernest Van Dijckkaai
649,Ernest Van Dijckkaai,2023-09-18,04:00:00,41,29,12,FMN 01 Ernest Van Dijckkaai
649,Ernest Van Dijckkaai,2023-09-18,05:00:00,96,65,31,FMN 01 Ernest Van Dijckkaai
649,Ernest Van Dijckkaai,2023-09-18,06:00:00,232,159,73,FMN 01 Ernest Van Dijckkaai
649,Ernest Van Dijckkaai,2023-09-18,07:00:00,464,294,170,FMN 01 Ernest Van Dijckkaai
649,Ernest Van Dijckkaai,2023-09-18,08:00:00,703,416,287,FMN 01 Ernest Van Dijckkaai
649,Ernest Van Dijckkaai,2023-09-18,09:00:00,283,182,101,FMN 01 Ernest Van Dijckkaai
649,Ernest Van Dijckkaai,2023-09-18,10:00:00,192,112,80,FMN 01 Ernest Van Dijckkaai
649,Ernest Van Dijckkaai,2023-09-18,11:00:00,162,95,67,FMN 01 Ernest Van Dijckkaai
649,Ernest Van Dijckkaai,2023-09-18,12:00:00,306,146,160,FMN 01 Ernest Van Dijckkaai
649,Ernest Van Dijckkaai,2023-09-18,13:00:00,262,141,121,FMN 01 Ernest Van Dijckkaai
649,Ernest Van Dijckkaai,2023-09-18,14:00:00,288,126,162,FMN 01 Ernest Van Dijckkaai
649,Ernest Van Dijckkaai,2023-09-18,15:00:00,385,190,195,FMN 01 Ernest Van Dijckkaai
649,Ernest Van Dijckkaai,2023-09-18,16:00:00,552,211,341,FMN 01 Ernest Van Dijckkaai
649,Ernest Van Dijckkaai,2023-09-18,17:00:00,697,286,411,FMN 01 Ernest Van Dijckkaai
649,Ernest Van Dijckkaai,2023-09-18,18:00:00,398,185,213,FMN 01 Ernest Van Dijckkaai
649,Ernest Van Dijckkaai,2023-09-18,19:00:00,224,119,105,FMN 01 Ernest Van Dijckkaai
649,Ernest Van Dijckkaai,2023-09-18,20:00:00,248,134,114,FMN 01 Ernest Van Dijckkaai
649,Ernest Van Dijckkaai,2023-09-18,21:00:00,135,47,88,FMN 01 Ernest Van Dijckkaai
649,Ernest Van Dijckkaai,2023-09-18,22:00:00,146,44,102,FMN 01 Ernest Van Dijckkaai
649,Ernest Van Dijckkaai,2023-09-18,23:00:00,53,21,32,FMN 01 Ernest Van Dijckkaai
649,Ernest Van Dijckkaai,2023-09-19,00:00:00,21,9,12,FMN 01 Ernest Van Dijckkaai
649,Ernest Van Dijckkaai,2023-09-19,01:00:00,14,5,9,FMN 01 Ernest Van Dijckkaai
649,Ernest Van Dijckkaai,2023-09-19,02:00:00,9,2,7,FMN 01 Ernest Van Dijckkaai
649,Ernest Van Dijckkaai,2023-09-19,03:00:00,6,2,4,FMN 01 Ernest Van Dijckkaai
649,Ernest Van Dijckkaai,2023-09-19,04:00:00,62,47,15,FMN 01 Ernest Van Dijckkaai
649,Ernest Van Dijckkaai,2023-09-19,05:00:00,135,83,52,FMN 01 Ernest Van Dijckkaai
649,Ernest Van Dijckkaai,2023-09-19,06:00:00,270,195,75,FMN 01 Ernest Van Dijckkaai
649,Ernest Van Dijckkaai,2023-09-19,07:00:00,535,330,205,FMN 01 Ernest Van Dijckkaai
649,Ernest Van Dijckkaai,2023-09-19,08:00:00,730,457,273,FMN 01 Ernest Van Dijckkaai
649,Ernest Van Dijckkaai,2023-09-19,09:00:00,349,203,146,FMN 01 Ernest Van Dijckkaai
649,Ernest Van Dijckkaai,2023-09-19,10:00:00,208,114,94,FMN 01 Ernest Van Dijckkaai
649,Ernest Van Dijckkaai,2023-09-19,11:00:00,226,126,100,FMN 01 Ernest Van Dijckkaai
649,Ernest Van Dijckkaai,2023-09-19,12:00:00,315,181,134,FMN 01 Ernest Van Dijckkaai
649,Ernest Van Dijckkaai,2023-09-19,13:00:00,266,156,110,FMN 01 Ernest Van Dijckkaai
649,Ernest Van Dijckkaai,2023-09-19,14:00:00,333,139,194,FMN 01 Ernest Van Dijckkaai
649,Ernest Van Dijckkaai,2023-09-19,15:00:00,433,199,234,FMN 01 Ernest Van Dijckkaai
649,Ernest Van Dijckkaai,2023-09-19,16:00:00,695,268,427,FMN 01 Ernest Van Dijckkaai
649,Ernest Van Dijckkaai,2023-09-19,17:00:00,755,299,456,FMN 01 Ernest Van Dijckkaai
649,Ernest Van Dijckkaai,2023-09-19,18:00:00,454,208,246,FMN 01 Ernest Van Dijckkaai
649,Ernest Van Dijckkaai,2023-09-19,19:00:00,216,112,104,FMN 01 Ernest Van Dijckkaai
649,Ernest Van Dijckkaai,2023-09-19,20:00:00,164,63,101,FMN 01 Ernest Van Dijckkaai
649,Ernest Van Dijckkaai,2023-09-19,21:00:00,158,56,102,FMN 01 Ernest Van Dijckkaai
649,Ernest Van Dijckkaai,2023-09-19,22:00:00,163,66,97,FMN 01 Ernest Van Dijckkaai
649,Ernest Van Dijckkaai,2023-09-19,23:00:00,102,53,49,FMN 01 Ernest Van Dijckkaai
649,Ernest Van Dijckkaai,2023-09-20,00:00:00,33,10,23,FMN 01 Ernest Van Dijckkaai
649,Ernest Van Dijckkaai,2023-09-20,01:00:00,18,9,9,FMN 01 Ernest Van Dijckkaai
649,Ernest Van Dijckkaai,2023-09-20,02:00:00,13,2,11,FMN 01 Ernest Van Dijckkaai
649,Ernest Van Dijckkaai,2023-09-20,03:00:00,10,3,7,FMN 01 Ernest Van Dijckkaai
649,Ernest Van Dijckkaai,2023-09-20,04:00:00,68,40,28,FMN 01 Ernest Van Dijckkaai
649,Ernest Van Dijckkaai,2023-09-20,05:00:00,127,80,47,FMN 01 Ernest Van Dijckkaai
649,Ernest Van Dijckkaai,2023-09-20,06:00:00,284,189,95,FMN 01 Ernest Van Dijckkaai
649,Ernest Van Dijckkaai,2023-09-20,07:00:00,460,307,153,FMN 01 Ernest Van Dijckkaai
649,Ernest Van Dijckkaai,2023-09-20,08:00:00,638,382,256,FMN 01 Ernest Van Dijckkaai
649,Ernest Van Dijckkaai,2023-09-20,09:00:00,318,196,122,FMN 01 Ernest Van Dijckkaai
649,Ernest Van Dijckkaai,2023-09-20,10:00:00,183,106,77,FMN 01 Ernest Van Dijckkaai
649,Ernest Van Dijckkaai,2023-09-20,11:00:00,264,127,137,FMN 01 Ernest Van Dijckkaai
649,Ernest Van Dijckkaai,2023-09-20,12:00:00,416,226,190,FMN 01 Ernest Van Dijckkaai
649,Ernest Van Dijckkaai,2023-09-20,13:00:00,317,161,156,FMN 01 Ernest Van Dijckkaai
649,Ernest Van Dijckkaai,2023-09-20,14:00:00,381,191,190,FMN 01 Ernest Van Dijckkaai
649,Ernest Van Dijckkaai,2023-09-20,15:00:00,404,200,204,FMN 01 Ernest Van Dijckkaai
649,Ernest Van Dijckkaai,2023-09-20,16:00:00,589,257,332,FMN 01 Ernest Van Dijckkaai
649,Ernest Van Dijckkaai,2023-09-20,17:00:00,626,242,384,FMN 01 Ernest Van Dijckkaai
649,Ernest Van Dijckkaai,2023-09-20,18:00:00,449,215,234,FMN 01 Ernest Van Dijckkaai
649,Ernest Van Dijckkaai,2023-09-20,19:00:00,304,157,147,FMN 01 Ernest Van Dijckkaai
649,Ernest Van Dijckkaai,2023-09-20,20:00:00,241,123,118,FMN 01 Ernest Van Dijckkaai
649,Ernest Van Dijckkaai,2023-09-20,21:00:00,190,78,112,FMN 01 Ernest Van Dijckkaai
649,Ernest Van Dijckkaai,2023-09-20,22:00:00,208,80,128,FMN 01 Ernest Van Dijckkaai
649,Ernest Van Dijckkaai,2023-09-20,23:00:00,99,32,67,FMN 01 Ernest Van Dijckkaai
649,Ernest Van Dijckkaai,2023-09-21,00:00:00,45,15,30,FMN 01 Ernest Van Dijckkaai
649,Ernest Van Dijckkaai,2023-09-21,01:00:00,22,8,14,FMN 01 Ernest Van Dijckkaai
649,Ernest Van Dijckkaai,2023-09-21,02:00:00,18,7,11,FMN 01 Ernest Van Dijckkaai
649,Ernest Van Dijckkaai,2023-09-21,03:00:00,9,2,7,FMN 01 Ernest Van Dijckkaai
649,Ernest Van Dijckkaai,2023-09-21,04:00:00,55,31,24,FMN 01 Ernest Van Dijckkaai
649,Ernest Van Dijckkaai,2023-09-21,05:00:00,95,54,41,FMN 01 Ernest Van Dijckkaai
649,Ernest Van Dijckkaai,2023-09-21,06:00:00,190,116,74,FMN 01 Ernest Van Dijckkaai
649,Ernest Van Dijckkaai,2023-09-21,07:00:00,356,235,121,FMN 01 Ernest Van Dijckkaai
649,Ernest Van Dijckkaai,2023-09-21,08:00:00,503,307,196,FMN 01 Ernest Van Dijckkaai
649,Ernest Van Dijckkaai,2023-09-21,09:00:00,270,147,123,FMN 01 Ernest Van Dijckkaai
649,Ernest Van Dijckkaai,2023-09-21,10:00:00,136,84,52,FMN 01 Ernest Van Dijckkaai
649,Ernest Van Dijckkaai,2023-09-21,11:00:00,103,58,45,FMN 01 Ernest Van Dijckkaai
649,Ernest Van Dijckkaai,2023-09-21,12:00:00,205,109,96,FMN 01 Ernest Van Dijckkaai
649,Ernest Van Dijckkaai,2023-09-21,13:00:00,195,106,89,FMN 01 Ernest Van Dijckkaai
649,Ernest Van Dijckkaai,2023-09-21,14:00:00,189,73,116,FMN 01 Ernest Van Dijckkaai
649,Ernest Van Dijckkaai,2023-09-21,15:00:00,316,156,160,FMN 01 Ernest Van Dijckkaai
649,Ernest Van Dijckkaai,2023-09-21,16:00:00,452,184,268,FMN 01 Ernest Van Dijckkaai
649,Ernest Van Dijckkaai,2023-09-21,17:00:00,486,217,269,FMN 01 Ernest Van Dijckkaai
649,Ernest Van Dijckkaai,2023-09-21,18:00:00,351,167,184,FMN 01 Ernest Van Dijckkaai
649,Ernest Van Dijckkaai,2023-09-21,19:00:00,213,113,100,FMN 01 Ernest Van Dijckkaai
649,Ernest Van Dijckkaai,2023-09-21,20:00:00,153,73,80,FMN 01 Ernest Van Dijckkaai
649,Ernest Van Dijckkaai,2023-09-21,21:00:00,172,70,102,FMN 01 Ernest Van Dijckkaai
649,Ernest Van Dijckkaai,2023-09-21,22:00:00,148,53,95,FMN 01 Ernest Van Dijckkaai
649,Ernest Van Dijckkaai,2023-09-21,23:00:00,79,34,45,FMN 01 Ernest Van Dijckkaai
649,Ernest Van Dijckkaai,2023-09-22,00:00:00,45,22,23,FMN 01 Ernest Van Dijckkaai
649,Ernest Van Dijckkaai,2023-09-22,01:00:00,33,18,15,FMN 01 Ernest Van Dijckkaai
649,Ernest Van Dijckkaai,2023-09-22,02:00:00,26,6,20,FMN 01 Ernest Van Dijckkaai
649,Ernest Van Dijckkaai,2023-09-22,03:00:00,36,6,30,FMN 01 Ernest Van Dijckkaai
649,Ernest Van Dijckkaai,2023-09-22,04:00:00,54,28,26,FMN 01 Ernest Van Dijckkaai
649,Ernest Van Dijckkaai,2023-09-22,05:00:00,110,72,38,FMN 01 Ernest Van Dijckkaai
649,Ernest Van Dijckkaai,2023-09-22,06:00:00,191,119,72,FMN 01 Ernest Van Dijckkaai
649,Ernest Van Dijckkaai,2023-09-22,07:00:00,380,254,126,FMN 01 Ernest Van Dijckkaai
649,Ernest Van Dijckkaai,2023-09-22,08:00:00,527,313,214,FMN 01 Ernest Van Dijckkaai
649,Ernest Van Dijckkaai,2023-09-22,09:00:00,256,153,103,FMN 01 Ernest Van Dijckkaai
649,Ernest Van Dijckkaai,2023-09-22,10:00:00,255,144,111,FMN 01 Ernest Van Dijckkaai
649,Ernest Van Dijckkaai,2023-09-22,11:00:00,266,140,126,FMN 01 Ernest Van Dijckkaai
649,Ernest Van Dijckkaai,2023-09-22,12:00:00,336,179,157,FMN 01 Ernest Van Dijckkaai
649,Ernest Van Dijckkaai,2023-09-22,13:00:00,312,178,134,FMN 01 Ernest Van Dijckkaai
649,Ernest Van Dijckkaai,2023-09-22,14:00:00,350,169,181,FMN 01 Ernest Van Dijckkaai
649,Ernest Van Dijckkaai,2023-09-22,15:00:00,445,214,231,FMN 01 Ernest Van Dijckkaai
649,Ernest Van Dijckkaai,2023-09-22,16:00:00,515,212,303,FMN 01 Ernest Van Dijckkaai
649,Ernest Van Dijckkaai,2023-09-22,17:00:00,420,183,237,FMN 01 Ernest Van Dijckkaai
649,Ernest Van Dijckkaai,2023-09-22,18:00:00,290,139,151,FMN 01 Ernest Van Dijckkaai
649,Ernest Van Dijckkaai,2023-09-22,19:00:00,199,94,105,FMN 01 Ernest Van Dijckkaai
649,Ernest Van Dijckkaai,2023-09-22,20:00:00,136,60,76,FMN 01 Ernest Van Dijckkaai
649,Ernest Van Dijckkaai,2023-09-22,21:00:00,107,42,65,FMN 01 Ernest Van Dijckkaai
649,Ernest Van Dijckkaai,2023-09-22,22:00:00,132,46,86,FMN 01 Ernest Van Dijckkaai
649,Ernest Van Dijckkaai,2023-09-22,23:00:00,96,43,53,FMN 01 Ernest Van Dijckkaai
649,Ernest Van Dijckkaai,2023-09-23,00:00:00,89,58,31,FMN 01 Ernest Van Dijckkaai
649,Ernest Van Dijckkaai,2023-09-23,01:00:00,62,22,40,FMN 01 Ernest Van Dijckkaai
649,Ernest Van Dijckkaai,2023-09-23,02:00:00,37,15,22,FMN 01 Ernest Van Dijckkaai
649,Ernest Van Dijckkaai,2023-09-23,03:00:00,31,11,20,FMN 01 Ernest Van Dijckkaai
649,Ernest Van Dijckkaai,2023-09-23,04:00:00,57,17,40,FMN 01 Ernest Van Dijckkaai
649,Ernest Van Dijckkaai,2023-09-23,05:00:00,40,23,17,FMN 01 Ernest Van Dijckkaai
649,Ernest Van Dijckkaai,2023-09-23,06:00:00,44,21,23,FMN 01 Ernest Van Dijckkaai
649,Ernest Van Dijckkaai,2023-09-23,07:00:00,43,20,23,FMN 01 Ernest Van Dijckkaai
649,Ernest Van Dijckkaai,2023-09-23,08:00:00,77,47,30,FMN 01 Ernest Van Dijckkaai
649,Ernest Van Dijckkaai,2023-09-23,09:00:00,184,106,78,FMN 01 Ernest Van Dijckkaai
649,Ernest Van Dijckkaai,2023-09-23,10:00:00,199,120,79,FMN 01 Ernest Van Dijckkaai
649,Ernest Van Dijckkaai,2023-09-23,11:00:00,264,132,132,FMN 01 Ernest Van Dijckkaai
649,Ernest Van Dijckkaai,2023-09-23,12:00:00,320,148,172,FMN 01 Ernest Van Dijckkaai
649,Ernest Van Dijckkaai,2023-09-23,13:00:00,285,172,113,FMN 01 Ernest Van Dijckkaai
649,Ernest Van Dijckkaai,2023-09-23,14:00:00,329,170,159,FMN 01 Ernest Van Dijckkaai
649,Ernest Van Dijckkaai,2023-09-23,15:00:00,351,172,179,FMN 01 Ernest Van Dijckkaai
649,Ernest Van Dijckkaai,2023-09-23,16:00:00,394,224,170,FMN 01 Ernest Van Dijckkaai
649,Ernest Van Dijckkaai,2023-09-23,17:00:00,385,204,181,FMN 01 Ernest Van Dijckkaai
649,Ernest Van Dijckkaai,2023-09-23,18:00:00,407,203,204,FMN 01 Ernest Van Dijckkaai
649,Ernest Van Dijckkaai,2023-09-23,19:00:00,276,184,92,FMN 01 Ernest Van Dijckkaai
649,Ernest Van Dijckkaai,2023-09-23,20:00:00,249,124,125,FMN 01 Ernest Van Dijckkaai
649,Ernest Van Dijckkaai,2023-09-23,21:00:00,181,82,99,FMN 01 Ernest Van Dijckkaai
649,Ernest Van Dijckkaai,2023-09-23,22:00:00,196,103,93,FMN 01 Ernest Van Dijckkaai
649,Ernest Van Dijckkaai,2023-09-23,23:00:00,184,72,112,FMN 01 Ernest Van Dijckkaai
649,Ernest Van Dijckkaai,2023-09-24,00:00:00,104,40,64,FMN 01 Ernest Van Dijckkaai
649,Ernest Van Dijckkaai,2023-09-24,01:00:00,83,30,53,FMN 01 Ernest Van Dijckkaai
649,Ernest Van Dijckkaai,2023-09-24,02:00:00,66,24,42,FMN 01 Ernest Van Dijckkaai
649,Ernest Van Dijckkaai,2023-09-24,03:00:00,43,14,29,FMN 01 Ernest Van Dijckkaai
649,Ernest Van Dijckkaai,2023-09-24,04:00:00,49,20,29,FMN 01 Ernest Van Dijckkaai
649,Ernest Van Dijckkaai,2023-09-24,05:00:00,44,22,22,FMN 01 Ernest Van Dijckkaai
649,Ernest Van Dijckkaai,2023-09-24,06:00:00,38,17,21,FMN 01 Ernest Van Dijckkaai
649,Ernest Van Dijckkaai,2023-09-24,07:00:00,29,13,16,FMN 01 Ernest Van Dijckkaai
649,Ernest Van Dijckkaai,2023-09-24,08:00:00,68,38,30,FMN 01 Ernest Van Dijckkaai
649,Ernest Van Dijckkaai,2023-09-24,09:00:00,155,83,72,FMN 01 Ernest Van Dijckkaai
649,Ernest Van Dijckkaai,2023-09-24,10:00:00,260,151,109,FMN 01 Ernest Van Dijckkaai
649,Ernest Van Dijckkaai,2023-09-24,11:00:00,371,209,162,FMN 01 Ernest Van Dijckkaai
649,Ernest Van Dijckkaai,2023-09-24,12:00:00,473,247,226,FMN 01 Ernest Van Dijckkaai
649,Ernest Van Dijckkaai,2023-09-24,13:00:00,534,273,261,FMN 01 Ernest Van Dijckkaai
649,Ernest Van Dijckkaai,2023-09-24,14:00:00,677,339,338,FMN 01 Ernest Van Dijckkaai
649,Ernest Van Dijckkaai,2023-09-24,15:00:00,719,360,359,FMN 01 Ernest Van Dijckkaai
649,Ernest Van Dijckkaai,2023-09-24,16:00:00,655,279,376,FMN 01 Ernest Van Dijckkaai
649,Ernest Van Dijckkaai,2023-09-24,17:00:00,588,302,286,FMN 01 Ernest Van Dijckkaai
649,Ernest Van Dijckkaai,2023-09-24,18:00:00,379,192,187,FMN 01 Ernest Van Dijckkaai
649,Ernest Van Dijckkaai,2023-09-24,19:00:00,313,127,186,FMN 01 Ernest Van Dijckkaai
649,Ernest Van Dijckkaai,2023-09-24,20:00:00,191,93,98,FMN 01 Ernest Van Dijckkaai
649,Ernest Van Dijckkaai,2023-09-24,21:00:00,123,61,62,FMN 01 Ernest Van Dijckkaai
649,Ernest Van Dijckkaai,2023-09-24,22:00:00,93,35,58,FMN 01 Ernest Van Dijckkaai
649,Ernest Van Dijckkaai,2023-09-24,23:00:00,54,28,26,FMN 01 Ernest Van Dijckkaai
649,Ernest Van Dijckkaai,2023-09-25,00:00:00,24,7,17,FMN 01 Ernest Van Dijckkaai
649,Ernest Van Dijckkaai,2023-09-25,01:00:00,23,2,21,FMN 01 Ernest Van Dijckkaai
649,Ernest Van Dijckkaai,2023-09-25,02:00:00,8,3,5,FMN 01 Ernest Van Dijckkaai
649,Ernest Van Dijckkaai,2023-09-25,03:00:00,3,0,3,FMN 01 Ernest Van Dijckkaai
649,Ernest Van Dijckkaai,2023-09-25,04:00:00,63,40,23,FMN 01 Ernest Van Dijckkaai
649,Ernest Van Dijckkaai,2023-09-25,05:00:00,138,91,47,FMN 01 Ernest Van Dijckkaai
649,Ernest Van Dijckkaai,2023-09-25,06:00:00,244,167,77,FMN 01 Ernest Van Dijckkaai
649,Ernest Van Dijckkaai,2023-09-25,07:00:00,519,346,173,FMN 01 Ernest Van Dijckkaai
649,Ernest Van Dijckkaai,2023-09-25,08:00:00,744,460,284,FMN 01 Ernest Van Dijckkaai
649,Ernest Van Dijckkaai,2023-09-25,09:00:00,416,290,126,FMN 01 Ernest Van Dijckkaai
649,Ernest Van Dijckkaai,2023-09-25,10:00:00,238,138,100,FMN 01 Ernest Van Dijckkaai
649,Ernest Van Dijckkaai,2023-09-25,11:00:00,235,109,126,FMN 01 Ernest Van Dijckkaai
649,Ernest Van Dijckkaai,2023-09-25,12:00:00,451,190,261,FMN 01 Ernest Van Dijckkaai
649,Ernest Van Dijckkaai,2023-09-25,13:00:00,399,230,169,FMN 01 Ernest Van Dijckkaai
649,Ernest Van Dijckkaai,2023-09-25,14:00:00,471,235,236,FMN 01 Ernest Van Dijckkaai
649,Ernest Van Dijckkaai,2023-09-25,15:00:00,500,246,254,FMN 01 Ernest Van Dijckkaai
649,Ernest Van Dijckkaai,2023-09-25,16:00:00,807,360,447,FMN 01 Ernest Van Dijckkaai
649,Ernest Van Dijckkaai,2023-09-25,17:00:00,790,316,474,FMN 01 Ernest Van Dijckkaai
649,Ernest Van Dijckkaai,2023-09-25,18:00:00,505,234,271,FMN 01 Ernest Van Dijckkaai
649,Ernest Van Dijckkaai,2023-09-25,19:00:00,294,127,167,FMN 01 Ernest Van Dijckkaai
649,Ernest Van Dijckkaai,2023-09-25,20:00:00,269,123,146,FMN 01 Ernest Van Dijckkaai
649,Ernest Van Dijckkaai,2023-09-25,21:00:00,199,74,125,FMN 01 Ernest Van Dijckkaai
649,Ernest Van Dijckkaai,2023-09-25,22:00:00,179,63,116,FMN 01 Ernest Van Dijckkaai
649,Ernest Van Dijckkaai,2023-09-25,23:00:00,70,38,32,FMN 01 Ernest Van Dijckkaai
649,Ernest Van Dijckkaai,2023-09-26,00:00:00,32,11,21,FMN 01 Ernest Van Dijckkaai
649,Ernest Van Dijckkaai,2023-09-26,01:00:00,21,9,12,FMN 01 Ernest Van Dijckkaai
649,Ernest Van Dijckkaai,2023-09-26,02:00:00,11,2,9,FMN 01 Ernest Van Dijckkaai
649,Ernest Van Dijckkaai,2023-09-26,03:00:00,11,2,9,FMN 01 Ernest Van Dijckkaai
649,Ernest Van Dijckkaai,2023-09-26,04:00:00,63,42,21,FMN 01 Ernest Van Dijckkaai
649,Ernest Van Dijckkaai,2023-09-26,05:00:00,160,109,51,FMN 01 Ernest Van Dijckkaai
649,Ernest Van Dijckkaai,2023-09-26,06:00:00,315,215,100,FMN 01 Ernest Van Dijckkaai
649,Ernest Van Dijckkaai,2023-09-26,07:00:00,563,357,206,FMN 01 Ernest Van Dijckkaai
649,Ernest Van Dijckkaai,2023-09-26,08:00:00,814,503,311,FMN 01 Ernest Van Dijckkaai
649,Ernest Van Dijckkaai,2023-09-26,09:00:00,352,221,131,FMN 01 Ernest Van Dijckkaai
649,Ernest Van Dijckkaai,2023-09-26,10:00:00,247,139,108,FMN 01 Ernest Van Dijckkaai
649,Ernest Van Dijckkaai,2023-09-26,11:00:00,265,155,110,FMN 01 Ernest Van Dijckkaai
649,Ernest Van Dijckkaai,2023-09-26,12:00:00,397,220,177,FMN 01 Ernest Van Dijckkaai
649,Ernest Van Dijckkaai,2023-09-26,13:00:00,424,228,196,FMN 01 Ernest Van Dijckkaai
649,Ernest Van Dijckkaai,2023-09-26,14:00:00,489,219,270,FMN 01 Ernest Van Dijckkaai
649,Ernest Van Dijckkaai,2023-09-26,15:00:00,638,288,350,FMN 01 Ernest Van Dijckkaai
649,Ernest Van Dijckkaai,2023-09-26,16:00:00,846,343,503,FMN 01 Ernest Van Dijckkaai
649,Ernest Van Dijckkaai,2023-09-26,17:00:00,899,367,532,FMN 01 Ernest Van Dijckkaai
649,Ernest Van Dijckkaai,2023-09-26,18:00:00,577,260,317,FMN 01 Ernest Van Dijckkaai
649,Ernest Van Dijckkaai,2023-09-26,19:00:00,349,160,189,FMN 01 Ernest Van Dijckkaai
649,Ernest Van Dijckkaai,2023-09-26,20:00:00,245,107,138,FMN 01 Ernest Van Dijckkaai
649,Ernest Van Dijckkaai,2023-09-26,21:00:00,210,76,134,FMN 01 Ernest Van Dijckkaai
649,Ernest Van Dijckkaai,2023-09-26,22:00:00,203,81,122,FMN 01 Ernest Van Dijckkaai
649,Ernest Van Dijckkaai,2023-09-26,23:00:00,78,34,44,FMN 01 Ernest Van Dijckkaai
649,Ernest Van Dijckkaai,2023-09-27,00:00:00,44,16,28,FMN 01 Ernest Van Dijckkaai
649,Ernest Van Dijckkaai,2023-09-27,01:00:00,25,12,13,FMN 01 Ernest Van Dijckkaai
649,Ernest Van Dijckkaai,2023-09-27,02:00:00,13,3,10,FMN 01 Ernest Van Dijckkaai
649,Ernest Van Dijckkaai,2023-09-27,03:00:00,17,4,13,FMN 01 Ernest Van Dijckkaai
649,Ernest Van Dijckkaai,2023-09-27,04:00:00,65,41,24,FMN 01 Ernest Van Dijckkaai
649,Ernest Van Dijckkaai,2023-09-27,05:00:00,152,95,57,FMN 01 Ernest Van Dijckkaai
649,Ernest Van Dijckkaai,2023-09-27,06:00:00,302,198,104,FMN 01 Ernest Van Dijckkaai
649,Ernest Van Dijckkaai,2023-09-27,07:00:00,500,319,181,FMN 01 Ernest Van Dijckkaai
649,Ernest Van Dijckkaai,2023-09-27,08:00:00,705,451,254,FMN 01 Ernest Van Dijckkaai
649,Ernest Van Dijckkaai,2023-09-27,09:00:00,340,231,109,FMN 01 Ernest Van Dijckkaai
649,Ernest Van Dijckkaai,2023-09-27,10:00:00,276,146,130,FMN 01 Ernest Van Dijckkaai
649,Ernest Van Dijckkaai,2023-09-27,11:00:00,253,131,122,FMN 01 Ernest Van Dijckkaai
649,Ernest Van Dijckkaai,2023-09-27,12:00:00,482,251,231,FMN 01 Ernest Van Dijckkaai
649,Ernest Van Dijckkaai,2023-09-27,13:00:00,444,225,219,FMN 01 Ernest Van Dijckkaai
649,Ernest Van Dijckkaai,2023-09-27,14:00:00,498,222,276,FMN 01 Ernest Van Dijckkaai
649,Ernest Van Dijckkaai,2023-09-27,15:00:00,534,245,289,FMN 01 Ernest Van Dijckkaai
649,Ernest Van Dijckkaai,2023-09-27,16:00:00,783,365,418,FMN 01 Ernest Van Dijckkaai
649,Ernest Van Dijckkaai,2023-09-27,17:00:00,802,333,469,FMN 01 Ernest Van Dijckkaai
649,Ernest Van Dijckkaai,2023-09-27,18:00:00,556,247,309,FMN 01 Ernest Van Dijckkaai
649,Ernest Van Dijckkaai,2023-09-27,19:00:00,324,189,135,FMN 01 Ernest Van Dijckkaai
649,Ernest Van Dijckkaai,2023-09-27,20:00:00,242,126,116,FMN 01 Ernest Van Dijckkaai
649,Ernest Van Dijckkaai,2023-09-27,21:00:00,204,87,117,FMN 01 Ernest Van Dijckkaai
649,Ernest Van Dijckkaai,2023-09-27,22:00:00,210,85,125,FMN 01 Ernest Van Dijckkaai
649,Ernest Van Dijckkaai,2023-09-27,23:00:00,145,44,101,FMN 01 Ernest Van Dijckkaai
