Meetpunt surrogate key,Meetpunt locatie,Datum,Tijd,Aantal fietsers,Aantal fietsers van,Aantal fietsers naar,Meetpunt code
666,R10 414,2022-11-09,00:00:00,7,2,5,FMN 19 Binnensingel Oostkant
666,R10 414,2022-11-09,01:00:00,5,4,1,FMN 19 Binnensingel Oostkant
666,R10 414,2022-11-09,02:00:00,2,2,0,FMN 19 Binnensingel Oostkant
666,R10 414,2022-11-09,03:00:00,3,3,0,FMN 19 Binnensingel Oostkant
666,R10 414,2022-11-09,04:00:00,20,7,13,FMN 19 Binnensingel Oostkant
666,R10 414,2022-11-09,05:00:00,30,11,19,FMN 19 Binnensingel Oostkant
666,R10 414,2022-11-09,06:00:00,60,31,29,FMN 19 Binnensingel Oostkant
666,R10 414,2022-11-09,07:00:00,131,71,60,FMN 19 Binnensingel Oostkant
666,R10 414,2022-11-09,08:00:00,178,83,95,FMN 19 Binnensingel Oostkant
666,R10 414,2022-11-09,09:00:00,71,44,27,FMN 19 Binnensingel Oostkant
666,R10 414,2022-11-09,10:00:00,106,65,41,FMN 19 Binnensingel Oostkant
666,R10 414,2022-11-09,11:00:00,127,81,46,FMN 19 Binnensingel Oostkant
666,R10 414,2022-11-09,12:00:00,242,167,75,FMN 19 Binnensingel Oostkant
666,R10 414,2022-11-09,13:00:00,265,202,63,FMN 19 Binnensingel Oostkant
666,R10 414,2022-11-09,14:00:00,164,123,41,FMN 19 Binnensingel Oostkant
666,R10 414,2022-11-09,15:00:00,265,207,58,FMN 19 Binnensingel Oostkant
666,R10 414,2022-11-09,16:00:00,379,304,75,FMN 19 Binnensingel Oostkant
666,R10 414,2022-11-09,17:00:00,432,315,117,FMN 19 Binnensingel Oostkant
666,R10 414,2022-11-09,18:00:00,340,238,102,FMN 19 Binnensingel Oostkant
666,R10 414,2022-11-09,19:00:00,201,145,56,FMN 19 Binnensingel Oostkant
666,R10 414,2022-11-09,20:00:00,128,100,28,FMN 19 Binnensingel Oostkant
666,R10 414,2022-11-09,21:00:00,145,118,27,FMN 19 Binnensingel Oostkant
666,R10 414,2022-11-09,22:00:00,121,94,27,FMN 19 Binnensingel Oostkant
666,R10 414,2022-11-09,23:00:00,51,40,11,FMN 19 Binnensingel Oostkant
666,R10 414,2022-11-10,00:00:00,15,10,5,FMN 19 Binnensingel Oostkant
666,R10 414,2022-11-10,01:00:00,9,8,1,FMN 19 Binnensingel Oostkant
666,R10 414,2022-11-10,02:00:00,2,1,1,FMN 19 Binnensingel Oostkant
666,R10 414,2022-11-10,03:00:00,6,4,2,FMN 19 Binnensingel Oostkant
666,R10 414,2022-11-10,04:00:00,17,10,7,FMN 19 Binnensingel Oostkant
666,R10 414,2022-11-10,05:00:00,32,20,12,FMN 19 Binnensingel Oostkant
666,R10 414,2022-11-10,06:00:00,63,39,24,FMN 19 Binnensingel Oostkant
666,R10 414,2022-11-10,07:00:00,156,100,56,FMN 19 Binnensingel Oostkant
666,R10 414,2022-11-10,08:00:00,234,148,86,FMN 19 Binnensingel Oostkant
666,R10 414,2022-11-10,09:00:00,96,58,38,FMN 19 Binnensingel Oostkant
666,R10 414,2022-11-10,10:00:00,80,54,26,FMN 19 Binnensingel Oostkant
666,R10 414,2022-11-10,11:00:00,87,67,20,FMN 19 Binnensingel Oostkant
666,R10 414,2022-11-10,12:00:00,137,105,32,FMN 19 Binnensingel Oostkant
666,R10 414,2022-11-10,13:00:00,141,111,30,FMN 19 Binnensingel Oostkant
666,R10 414,2022-11-10,14:00:00,105,87,18,FMN 19 Binnensingel Oostkant
666,R10 414,2022-11-10,15:00:00,197,167,30,FMN 19 Binnensingel Oostkant
666,R10 414,2022-11-10,16:00:00,288,222,66,FMN 19 Binnensingel Oostkant
666,R10 414,2022-11-10,17:00:00,267,209,58,FMN 19 Binnensingel Oostkant
666,R10 414,2022-11-10,18:00:00,244,175,69,FMN 19 Binnensingel Oostkant
666,R10 414,2022-11-10,19:00:00,140,105,35,FMN 19 Binnensingel Oostkant
666,R10 414,2022-11-10,20:00:00,98,74,24,FMN 19 Binnensingel Oostkant
666,R10 414,2022-11-10,21:00:00,101,76,25,FMN 19 Binnensingel Oostkant
666,R10 414,2022-11-10,22:00:00,72,54,18,FMN 19 Binnensingel Oostkant
666,R10 414,2022-11-10,23:00:00,52,34,18,FMN 19 Binnensingel Oostkant
666,R10 414,2022-11-11,00:00:00,36,25,11,FMN 19 Binnensingel Oostkant
666,R10 414,2022-11-11,01:00:00,31,18,13,FMN 19 Binnensingel Oostkant
666,R10 414,2022-11-11,02:00:00,28,19,9,FMN 19 Binnensingel Oostkant
666,R10 414,2022-11-11,03:00:00,22,17,5,FMN 19 Binnensingel Oostkant
666,R10 414,2022-11-11,04:00:00,39,28,11,FMN 19 Binnensingel Oostkant
666,R10 414,2022-11-11,05:00:00,22,13,9,FMN 19 Binnensingel Oostkant
666,R10 414,2022-11-11,06:00:00,20,9,11,FMN 19 Binnensingel Oostkant
666,R10 414,2022-11-11,07:00:00,27,19,8,FMN 19 Binnensingel Oostkant
666,R10 414,2022-11-11,08:00:00,32,20,12,FMN 19 Binnensingel Oostkant
666,R10 414,2022-11-11,09:00:00,39,34,5,FMN 19 Binnensingel Oostkant
666,R10 414,2022-11-11,10:00:00,45,35,10,FMN 19 Binnensingel Oostkant
666,R10 414,2022-11-11,11:00:00,60,51,9,FMN 19 Binnensingel Oostkant
666,R10 414,2022-11-11,12:00:00,61,46,15,FMN 19 Binnensingel Oostkant
666,R10 414,2022-11-11,13:00:00,71,51,20,FMN 19 Binnensingel Oostkant
666,R10 414,2022-11-11,14:00:00,96,75,21,FMN 19 Binnensingel Oostkant
666,R10 414,2022-11-11,15:00:00,99,73,26,FMN 19 Binnensingel Oostkant
666,R10 414,2022-11-11,16:00:00,85,69,16,FMN 19 Binnensingel Oostkant
666,R10 414,2022-11-11,17:00:00,84,57,27,FMN 19 Binnensingel Oostkant
666,R10 414,2022-11-11,18:00:00,100,82,18,FMN 19 Binnensingel Oostkant
666,R10 414,2022-11-11,19:00:00,78,61,17,FMN 19 Binnensingel Oostkant
666,R10 414,2022-11-11,20:00:00,48,33,15,FMN 19 Binnensingel Oostkant
666,R10 414,2022-11-11,21:00:00,51,45,6,FMN 19 Binnensingel Oostkant
666,R10 414,2022-11-11,22:00:00,46,36,10,FMN 19 Binnensingel Oostkant
666,R10 414,2022-11-11,23:00:00,45,33,12,FMN 19 Binnensingel Oostkant
666,R10 414,2022-11-12,00:00:00,25,19,6,FMN 19 Binnensingel Oostkant
666,R10 414,2022-11-12,01:00:00,10,9,1,FMN 19 Binnensingel Oostkant
666,R10 414,2022-11-12,02:00:00,9,7,2,FMN 19 Binnensingel Oostkant
666,R10 414,2022-11-12,03:00:00,12,9,3,FMN 19 Binnensingel Oostkant
666,R10 414,2022-11-12,04:00:00,17,10,7,FMN 19 Binnensingel Oostkant
666,R10 414,2022-11-12,05:00:00,12,7,5,FMN 19 Binnensingel Oostkant
666,R10 414,2022-11-12,06:00:00,19,8,11,FMN 19 Binnensingel Oostkant
666,R10 414,2022-11-12,07:00:00,23,11,12,FMN 19 Binnensingel Oostkant
666,R10 414,2022-11-12,08:00:00,32,23,9,FMN 19 Binnensingel Oostkant
666,R10 414,2022-11-12,09:00:00,46,33,13,FMN 19 Binnensingel Oostkant
666,R10 414,2022-11-12,10:00:00,67,57,10,FMN 19 Binnensingel Oostkant
666,R10 414,2022-11-12,11:00:00,59,43,16,FMN 19 Binnensingel Oostkant
666,R10 414,2022-11-12,12:00:00,94,74,20,FMN 19 Binnensingel Oostkant
666,R10 414,2022-11-12,13:00:00,95,66,29,FMN 19 Binnensingel Oostkant
666,R10 414,2022-11-12,14:00:00,107,72,35,FMN 19 Binnensingel Oostkant
666,R10 414,2022-11-12,15:00:00,97,57,40,FMN 19 Binnensingel Oostkant
666,R10 414,2022-11-12,16:00:00,97,77,20,FMN 19 Binnensingel Oostkant
666,R10 414,2022-11-12,17:00:00,123,91,32,FMN 19 Binnensingel Oostkant
666,R10 414,2022-11-12,18:00:00,92,72,20,FMN 19 Binnensingel Oostkant
666,R10 414,2022-11-12,19:00:00,73,52,21,FMN 19 Binnensingel Oostkant
666,R10 414,2022-11-12,20:00:00,61,46,15,FMN 19 Binnensingel Oostkant
666,R10 414,2022-11-12,21:00:00,48,35,13,FMN 19 Binnensingel Oostkant
666,R10 414,2022-11-12,22:00:00,49,40,9,FMN 19 Binnensingel Oostkant
666,R10 414,2022-11-12,23:00:00,41,23,18,FMN 19 Binnensingel Oostkant
666,R10 414,2022-11-13,00:00:00,39,33,6,FMN 19 Binnensingel Oostkant
666,R10 414,2022-11-13,01:00:00,14,12,2,FMN 19 Binnensingel Oostkant
666,R10 414,2022-11-13,02:00:00,10,8,2,FMN 19 Binnensingel Oostkant
666,R10 414,2022-11-13,03:00:00,18,11,7,FMN 19 Binnensingel Oostkant
666,R10 414,2022-11-13,04:00:00,8,5,3,FMN 19 Binnensingel Oostkant
666,R10 414,2022-11-13,05:00:00,10,4,6,FMN 19 Binnensingel Oostkant
666,R10 414,2022-11-13,06:00:00,1,0,1,FMN 19 Binnensingel Oostkant
666,R10 414,2022-11-13,07:00:00,12,9,3,FMN 19 Binnensingel Oostkant
666,R10 414,2022-11-13,08:00:00,21,13,8,FMN 19 Binnensingel Oostkant
666,R10 414,2022-11-13,09:00:00,30,23,7,FMN 19 Binnensingel Oostkant
666,R10 414,2022-11-13,10:00:00,61,46,15,FMN 19 Binnensingel Oostkant
666,R10 414,2022-11-13,11:00:00,58,46,12,FMN 19 Binnensingel Oostkant
666,R10 414,2022-11-13,12:00:00,62,49,13,FMN 19 Binnensingel Oostkant
666,R10 414,2022-11-13,13:00:00,93,70,23,FMN 19 Binnensingel Oostkant
666,R10 414,2022-11-13,14:00:00,95,65,30,FMN 19 Binnensingel Oostkant
666,R10 414,2022-11-13,15:00:00,102,55,47,FMN 19 Binnensingel Oostkant
666,R10 414,2022-11-13,16:00:00,99,74,25,FMN 19 Binnensingel Oostkant
666,R10 414,2022-11-13,17:00:00,104,78,26,FMN 19 Binnensingel Oostkant
666,R10 414,2022-11-13,18:00:00,48,35,13,FMN 19 Binnensingel Oostkant
666,R10 414,2022-11-13,19:00:00,60,46,14,FMN 19 Binnensingel Oostkant
666,R10 414,2022-11-13,20:00:00,46,35,11,FMN 19 Binnensingel Oostkant
666,R10 414,2022-11-13,21:00:00,30,25,5,FMN 19 Binnensingel Oostkant
666,R10 414,2022-11-13,22:00:00,28,19,9,FMN 19 Binnensingel Oostkant
666,R10 414,2022-11-13,23:00:00,19,14,5,FMN 19 Binnensingel Oostkant
666,R10 414,2022-11-14,00:00:00,5,3,2,FMN 19 Binnensingel Oostkant
666,R10 414,2022-11-14,01:00:00,3,3,0,FMN 19 Binnensingel Oostkant
666,R10 414,2022-11-14,02:00:00,8,6,2,FMN 19 Binnensingel Oostkant
666,R10 414,2022-11-14,03:00:00,3,1,2,FMN 19 Binnensingel Oostkant
666,R10 414,2022-11-14,04:00:00,12,6,6,FMN 19 Binnensingel Oostkant
666,R10 414,2022-11-14,05:00:00,20,9,11,FMN 19 Binnensingel Oostkant
666,R10 414,2022-11-14,06:00:00,44,27,17,FMN 19 Binnensingel Oostkant
666,R10 414,2022-11-14,07:00:00,110,71,39,FMN 19 Binnensingel Oostkant
666,R10 414,2022-11-14,08:00:00,116,68,48,FMN 19 Binnensingel Oostkant
666,R10 414,2022-11-14,09:00:00,53,31,22,FMN 19 Binnensingel Oostkant
666,R10 414,2022-11-14,10:00:00,61,34,27,FMN 19 Binnensingel Oostkant
666,R10 414,2022-11-14,11:00:00,81,64,17,FMN 19 Binnensingel Oostkant
666,R10 414,2022-11-14,12:00:00,125,96,29,FMN 19 Binnensingel Oostkant
666,R10 414,2022-11-14,13:00:00,121,83,38,FMN 19 Binnensingel Oostkant
666,R10 414,2022-11-14,14:00:00,98,78,20,FMN 19 Binnensingel Oostkant
666,R10 414,2022-11-14,15:00:00,166,135,31,FMN 19 Binnensingel Oostkant
666,R10 414,2022-11-14,16:00:00,290,247,43,FMN 19 Binnensingel Oostkant
666,R10 414,2022-11-14,17:00:00,230,175,55,FMN 19 Binnensingel Oostkant
666,R10 414,2022-11-14,18:00:00,154,112,42,FMN 19 Binnensingel Oostkant
666,R10 414,2022-11-14,19:00:00,85,60,25,FMN 19 Binnensingel Oostkant
666,R10 414,2022-11-14,20:00:00,74,54,20,FMN 19 Binnensingel Oostkant
666,R10 414,2022-11-14,21:00:00,57,51,6,FMN 19 Binnensingel Oostkant
666,R10 414,2022-11-14,22:00:00,62,51,11,FMN 19 Binnensingel Oostkant
666,R10 414,2022-11-14,23:00:00,24,18,6,FMN 19 Binnensingel Oostkant
666,R10 414,2022-11-15,00:00:00,7,5,2,FMN 19 Binnensingel Oostkant
666,R10 414,2022-11-15,01:00:00,3,3,0,FMN 19 Binnensingel Oostkant
666,R10 414,2022-11-15,02:00:00,3,2,1,FMN 19 Binnensingel Oostkant
666,R10 414,2022-11-15,03:00:00,4,2,2,FMN 19 Binnensingel Oostkant
666,R10 414,2022-11-15,04:00:00,19,7,12,FMN 19 Binnensingel Oostkant
666,R10 414,2022-11-15,05:00:00,25,11,14,FMN 19 Binnensingel Oostkant
666,R10 414,2022-11-15,06:00:00,58,35,23,FMN 19 Binnensingel Oostkant
666,R10 414,2022-11-15,07:00:00,183,125,58,FMN 19 Binnensingel Oostkant
666,R10 414,2022-11-15,08:00:00,233,151,82,FMN 19 Binnensingel Oostkant
666,R10 414,2022-11-15,09:00:00,93,61,32,FMN 19 Binnensingel Oostkant
666,R10 414,2022-11-15,10:00:00,60,40,20,FMN 19 Binnensingel Oostkant
666,R10 414,2022-11-15,11:00:00,78,59,19,FMN 19 Binnensingel Oostkant
666,R10 414,2022-11-15,12:00:00,112,78,34,FMN 19 Binnensingel Oostkant
666,R10 414,2022-11-15,13:00:00,118,86,32,FMN 19 Binnensingel Oostkant
666,R10 414,2022-11-15,14:00:00,96,73,23,FMN 19 Binnensingel Oostkant
666,R10 414,2022-11-15,15:00:00,175,159,16,FMN 19 Binnensingel Oostkant
666,R10 414,2022-11-15,16:00:00,234,187,47,FMN 19 Binnensingel Oostkant
666,R10 414,2022-11-15,17:00:00,247,191,56,FMN 19 Binnensingel Oostkant
666,R10 414,2022-11-15,18:00:00,219,172,47,FMN 19 Binnensingel Oostkant
666,R10 414,2022-11-15,19:00:00,74,57,17,FMN 19 Binnensingel Oostkant
666,R10 414,2022-11-15,20:00:00,72,53,19,FMN 19 Binnensingel Oostkant
666,R10 414,2022-11-15,21:00:00,77,61,16,FMN 19 Binnensingel Oostkant
666,R10 414,2022-11-15,22:00:00,50,36,14,FMN 19 Binnensingel Oostkant
666,R10 414,2022-11-15,23:00:00,23,18,5,FMN 19 Binnensingel Oostkant
666,R10 414,2022-11-16,00:00:00,7,3,4,FMN 19 Binnensingel Oostkant
666,R10 414,2022-11-16,01:00:00,6,5,1,FMN 19 Binnensingel Oostkant
666,R10 414,2022-11-16,02:00:00,3,3,0,FMN 19 Binnensingel Oostkant
666,R10 414,2022-11-16,03:00:00,4,4,0,FMN 19 Binnensingel Oostkant
666,R10 414,2022-11-16,04:00:00,21,10,11,FMN 19 Binnensingel Oostkant
666,R10 414,2022-11-16,05:00:00,30,15,15,FMN 19 Binnensingel Oostkant
666,R10 414,2022-11-16,06:00:00,67,43,24,FMN 19 Binnensingel Oostkant
666,R10 414,2022-11-16,07:00:00,148,99,49,FMN 19 Binnensingel Oostkant
666,R10 414,2022-11-16,08:00:00,194,116,78,FMN 19 Binnensingel Oostkant
666,R10 414,2022-11-16,09:00:00,77,57,20,FMN 19 Binnensingel Oostkant
666,R10 414,2022-11-16,10:00:00,73,55,18,FMN 19 Binnensingel Oostkant
666,R10 414,2022-11-16,11:00:00,77,57,20,FMN 19 Binnensingel Oostkant
666,R10 414,2022-11-16,12:00:00,189,148,41,FMN 19 Binnensingel Oostkant
666,R10 414,2022-11-16,13:00:00,134,101,33,FMN 19 Binnensingel Oostkant
666,R10 414,2022-11-16,14:00:00,97,78,19,FMN 19 Binnensingel Oostkant
666,R10 414,2022-11-16,15:00:00,152,124,28,FMN 19 Binnensingel Oostkant
666,R10 414,2022-11-16,16:00:00,213,168,45,FMN 19 Binnensingel Oostkant
666,R10 414,2022-11-16,17:00:00,238,176,62,FMN 19 Binnensingel Oostkant
666,R10 414,2022-11-16,18:00:00,188,134,54,FMN 19 Binnensingel Oostkant
666,R10 414,2022-11-16,19:00:00,107,77,30,FMN 19 Binnensingel Oostkant
666,R10 414,2022-11-16,20:00:00,85,70,15,FMN 19 Binnensingel Oostkant
666,R10 414,2022-11-16,21:00:00,75,61,14,FMN 19 Binnensingel Oostkant
666,R10 414,2022-11-16,22:00:00,75,56,19,FMN 19 Binnensingel Oostkant
666,R10 414,2022-11-16,23:00:00,20,17,3,FMN 19 Binnensingel Oostkant
666,R10 414,2022-11-17,00:00:00,10,7,3,FMN 19 Binnensingel Oostkant
666,R10 414,2022-11-17,01:00:00,5,5,0,FMN 19 Binnensingel Oostkant
666,R10 414,2022-11-17,02:00:00,7,5,2,FMN 19 Binnensingel Oostkant
666,R10 414,2022-11-17,03:00:00,6,3,3,FMN 19 Binnensingel Oostkant
666,R10 414,2022-11-17,04:00:00,18,8,10,FMN 19 Binnensingel Oostkant
666,R10 414,2022-11-17,05:00:00,26,13,13,FMN 19 Binnensingel Oostkant
666,R10 414,2022-11-17,06:00:00,55,35,20,FMN 19 Binnensingel Oostkant
666,R10 414,2022-11-17,07:00:00,147,95,52,FMN 19 Binnensingel Oostkant
666,R10 414,2022-11-17,08:00:00,199,144,55,FMN 19 Binnensingel Oostkant
666,R10 414,2022-11-17,09:00:00,70,50,20,FMN 19 Binnensingel Oostkant
666,R10 414,2022-11-17,10:00:00,64,38,26,FMN 19 Binnensingel Oostkant
666,R10 414,2022-11-17,11:00:00,52,36,16,FMN 19 Binnensingel Oostkant
666,R10 414,2022-11-17,12:00:00,98,83,15,FMN 19 Binnensingel Oostkant
666,R10 414,2022-11-17,13:00:00,83,61,22,FMN 19 Binnensingel Oostkant
666,R10 414,2022-11-17,14:00:00,59,41,18,FMN 19 Binnensingel Oostkant
666,R10 414,2022-11-17,15:00:00,140,116,24,FMN 19 Binnensingel Oostkant
666,R10 414,2022-11-17,16:00:00,219,174,45,FMN 19 Binnensingel Oostkant
666,R10 414,2022-11-17,17:00:00,244,185,59,FMN 19 Binnensingel Oostkant
666,R10 414,2022-11-17,18:00:00,170,124,46,FMN 19 Binnensingel Oostkant
666,R10 414,2022-11-17,19:00:00,76,52,24,FMN 19 Binnensingel Oostkant
666,R10 414,2022-11-17,20:00:00,66,51,15,FMN 19 Binnensingel Oostkant
666,R10 414,2022-11-17,21:00:00,80,64,16,FMN 19 Binnensingel Oostkant
666,R10 414,2022-11-17,22:00:00,73,64,9,FMN 19 Binnensingel Oostkant
666,R10 414,2022-11-17,23:00:00,35,28,7,FMN 19 Binnensingel Oostkant
666,R10 414,2022-11-18,00:00:00,17,10,7,FMN 19 Binnensingel Oostkant
666,R10 414,2022-11-18,01:00:00,9,6,3,FMN 19 Binnensingel Oostkant
666,R10 414,2022-11-18,02:00:00,7,6,1,FMN 19 Binnensingel Oostkant
666,R10 414,2022-11-18,03:00:00,12,7,5,FMN 19 Binnensingel Oostkant
666,R10 414,2022-11-18,04:00:00,18,8,10,FMN 19 Binnensingel Oostkant
666,R10 414,2022-11-18,05:00:00,16,11,5,FMN 19 Binnensingel Oostkant
666,R10 414,2022-11-18,06:00:00,47,33,14,FMN 19 Binnensingel Oostkant
666,R10 414,2022-11-18,07:00:00,123,79,44,FMN 19 Binnensingel Oostkant
666,R10 414,2022-11-18,08:00:00,139,88,51,FMN 19 Binnensingel Oostkant
666,R10 414,2022-11-18,09:00:00,72,49,23,FMN 19 Binnensingel Oostkant
666,R10 414,2022-11-18,10:00:00,67,45,22,FMN 19 Binnensingel Oostkant
666,R10 414,2022-11-18,11:00:00,70,51,19,FMN 19 Binnensingel Oostkant
666,R10 414,2022-11-18,12:00:00,96,71,25,FMN 19 Binnensingel Oostkant
666,R10 414,2022-11-18,13:00:00,99,63,36,FMN 19 Binnensingel Oostkant
666,R10 414,2022-11-18,14:00:00,94,72,22,FMN 19 Binnensingel Oostkant
666,R10 414,2022-11-18,15:00:00,152,131,21,FMN 19 Binnensingel Oostkant
666,R10 414,2022-11-18,16:00:00,284,249,35,FMN 19 Binnensingel Oostkant
666,R10 414,2022-11-18,17:00:00,187,139,48,FMN 19 Binnensingel Oostkant
666,R10 414,2022-11-18,18:00:00,124,98,26,FMN 19 Binnensingel Oostkant
666,R10 414,2022-11-18,19:00:00,81,59,22,FMN 19 Binnensingel Oostkant
666,R10 414,2022-11-18,20:00:00,63,50,13,FMN 19 Binnensingel Oostkant
666,R10 414,2022-11-18,21:00:00,50,44,6,FMN 19 Binnensingel Oostkant
666,R10 414,2022-11-18,22:00:00,48,36,12,FMN 19 Binnensingel Oostkant
666,R10 414,2022-11-18,23:00:00,38,27,11,FMN 19 Binnensingel Oostkant
666,R10 414,2022-11-19,00:00:00,24,23,1,FMN 19 Binnensingel Oostkant
666,R10 414,2022-11-19,01:00:00,19,17,2,FMN 19 Binnensingel Oostkant
666,R10 414,2022-11-19,02:00:00,14,12,2,FMN 19 Binnensingel Oostkant
666,R10 414,2022-11-19,03:00:00,14,8,6,FMN 19 Binnensingel Oostkant
666,R10 414,2022-11-19,04:00:00,8,6,2,FMN 19 Binnensingel Oostkant
666,R10 414,2022-11-19,05:00:00,14,10,4,FMN 19 Binnensingel Oostkant
666,R10 414,2022-11-19,06:00:00,9,5,4,FMN 19 Binnensingel Oostkant
666,R10 414,2022-11-19,07:00:00,19,14,5,FMN 19 Binnensingel Oostkant
666,R10 414,2022-11-19,08:00:00,22,18,4,FMN 19 Binnensingel Oostkant
666,R10 414,2022-11-19,09:00:00,33,21,12,FMN 19 Binnensingel Oostkant
666,R10 414,2022-11-19,10:00:00,38,31,7,FMN 19 Binnensingel Oostkant
666,R10 414,2022-11-19,11:00:00,44,36,8,FMN 19 Binnensingel Oostkant
666,R10 414,2022-11-19,12:00:00,50,29,21,FMN 19 Binnensingel Oostkant
666,R10 414,2022-11-19,13:00:00,41,32,9,FMN 19 Binnensingel Oostkant
666,R10 414,2022-11-19,14:00:00,41,32,9,FMN 19 Binnensingel Oostkant
666,R10 414,2022-11-19,15:00:00,53,44,9,FMN 19 Binnensingel Oostkant
666,R10 414,2022-11-19,16:00:00,52,38,14,FMN 19 Binnensingel Oostkant
666,R10 414,2022-11-19,17:00:00,48,41,7,FMN 19 Binnensingel Oostkant
666,R10 414,2022-11-19,18:00:00,59,52,7,FMN 19 Binnensingel Oostkant
666,R10 414,2022-11-19,19:00:00,58,44,14,FMN 19 Binnensingel Oostkant
666,R10 414,2022-11-19,20:00:00,29,24,5,FMN 19 Binnensingel Oostkant
666,R10 414,2022-11-19,21:00:00,35,25,10,FMN 19 Binnensingel Oostkant
666,R10 414,2022-11-19,22:00:00,57,43,14,FMN 19 Binnensingel Oostkant
666,R10 414,2022-11-19,23:00:00,18,18,0,FMN 19 Binnensingel Oostkant
666,R10 414,2022-11-20,00:00:00,27,21,6,FMN 19 Binnensingel Oostkant
666,R10 414,2022-11-20,01:00:00,16,8,8,FMN 19 Binnensingel Oostkant
666,R10 414,2022-11-20,02:00:00,12,11,1,FMN 19 Binnensingel Oostkant
666,R10 414,2022-11-20,03:00:00,11,11,0,FMN 19 Binnensingel Oostkant
666,R10 414,2022-11-20,04:00:00,9,4,5,FMN 19 Binnensingel Oostkant
666,R10 414,2022-11-20,05:00:00,8,6,2,FMN 19 Binnensingel Oostkant
666,R10 414,2022-11-20,06:00:00,5,3,2,FMN 19 Binnensingel Oostkant
666,R10 414,2022-11-20,07:00:00,8,5,3,FMN 19 Binnensingel Oostkant
666,R10 414,2022-11-20,08:00:00,9,7,2,FMN 19 Binnensingel Oostkant
666,R10 414,2022-11-20,09:00:00,31,21,10,FMN 19 Binnensingel Oostkant
666,R10 414,2022-11-20,10:00:00,19,14,5,FMN 19 Binnensingel Oostkant
666,R10 414,2022-11-20,11:00:00,52,40,12,FMN 19 Binnensingel Oostkant
666,R10 414,2022-11-20,12:00:00,46,36,10,FMN 19 Binnensingel Oostkant
666,R10 414,2022-11-20,13:00:00,58,41,17,FMN 19 Binnensingel Oostkant
666,R10 414,2022-11-20,14:00:00,43,34,9,FMN 19 Binnensingel Oostkant
666,R10 414,2022-11-20,15:00:00,44,34,10,FMN 19 Binnensingel Oostkant
666,R10 414,2022-11-20,16:00:00,42,32,10,FMN 19 Binnensingel Oostkant
666,R10 414,2022-11-20,17:00:00,44,30,14,FMN 19 Binnensingel Oostkant
666,R10 414,2022-11-20,18:00:00,37,21,16,FMN 19 Binnensingel Oostkant
666,R10 414,2022-11-20,19:00:00,33,26,7,FMN 19 Binnensingel Oostkant
666,R10 414,2022-11-20,20:00:00,31,21,10,FMN 19 Binnensingel Oostkant
666,R10 414,2022-11-20,21:00:00,18,11,7,FMN 19 Binnensingel Oostkant
666,R10 414,2022-11-20,22:00:00,32,20,12,FMN 19 Binnensingel Oostkant
666,R10 414,2022-11-20,23:00:00,13,10,3,FMN 19 Binnensingel Oostkant
666,R10 414,2022-11-21,00:00:00,7,6,1,FMN 19 Binnensingel Oostkant
666,R10 414,2022-11-21,01:00:00,7,5,2,FMN 19 Binnensingel Oostkant
666,R10 414,2022-11-21,02:00:00,3,3,0,FMN 19 Binnensingel Oostkant
666,R10 414,2022-11-21,03:00:00,3,1,2,FMN 19 Binnensingel Oostkant
666,R10 414,2022-11-21,04:00:00,13,7,6,FMN 19 Binnensingel Oostkant
666,R10 414,2022-11-21,05:00:00,24,15,9,FMN 19 Binnensingel Oostkant
666,R10 414,2022-11-21,06:00:00,50,36,14,FMN 19 Binnensingel Oostkant
666,R10 414,2022-11-21,07:00:00,150,102,48,FMN 19 Binnensingel Oostkant
666,R10 414,2022-11-21,08:00:00,154,93,61,FMN 19 Binnensingel Oostkant
666,R10 414,2022-11-21,09:00:00,59,39,20,FMN 19 Binnensingel Oostkant
666,R10 414,2022-11-21,10:00:00,67,52,15,FMN 19 Binnensingel Oostkant
666,R10 414,2022-11-21,11:00:00,64,52,12,FMN 19 Binnensingel Oostkant
666,R10 414,2022-11-21,12:00:00,105,80,25,FMN 19 Binnensingel Oostkant
666,R10 414,2022-11-21,13:00:00,109,76,33,FMN 19 Binnensingel Oostkant
666,R10 414,2022-11-21,14:00:00,83,66,17,FMN 19 Binnensingel Oostkant
666,R10 414,2022-11-21,15:00:00,155,127,28,FMN 19 Binnensingel Oostkant
666,R10 414,2022-11-21,16:00:00,231,180,51,FMN 19 Binnensingel Oostkant
666,R10 414,2022-11-21,17:00:00,196,159,37,FMN 19 Binnensingel Oostkant
666,R10 414,2022-11-21,18:00:00,167,137,30,FMN 19 Binnensingel Oostkant
666,R10 414,2022-11-21,19:00:00,76,52,24,FMN 19 Binnensingel Oostkant
666,R10 414,2022-11-21,20:00:00,45,40,5,FMN 19 Binnensingel Oostkant
666,R10 414,2022-11-21,21:00:00,48,43,5,FMN 19 Binnensingel Oostkant
666,R10 414,2022-11-21,22:00:00,69,52,17,FMN 19 Binnensingel Oostkant
666,R10 414,2022-11-21,23:00:00,20,15,5,FMN 19 Binnensingel Oostkant
666,R10 414,2022-11-22,00:00:00,2,1,1,FMN 19 Binnensingel Oostkant
666,R10 414,2022-11-22,01:00:00,2,2,0,FMN 19 Binnensingel Oostkant
666,R10 414,2022-11-22,02:00:00,5,1,4,FMN 19 Binnensingel Oostkant
666,R10 414,2022-11-22,03:00:00,3,1,2,FMN 19 Binnensingel Oostkant
666,R10 414,2022-11-22,04:00:00,16,8,8,FMN 19 Binnensingel Oostkant
666,R10 414,2022-11-22,05:00:00,20,11,9,FMN 19 Binnensingel Oostkant
666,R10 414,2022-11-22,06:00:00,52,33,19,FMN 19 Binnensingel Oostkant
666,R10 414,2022-11-22,07:00:00,159,108,51,FMN 19 Binnensingel Oostkant
666,R10 414,2022-11-22,08:00:00,174,116,58,FMN 19 Binnensingel Oostkant
666,R10 414,2022-11-22,09:00:00,66,41,25,FMN 19 Binnensingel Oostkant
666,R10 414,2022-11-22,10:00:00,52,34,18,FMN 19 Binnensingel Oostkant
666,R10 414,2022-11-22,11:00:00,53,40,13,FMN 19 Binnensingel Oostkant
666,R10 414,2022-11-22,12:00:00,93,68,25,FMN 19 Binnensingel Oostkant
666,R10 414,2022-11-22,13:00:00,102,72,30,FMN 19 Binnensingel Oostkant
666,R10 414,2022-11-22,14:00:00,62,43,19,FMN 19 Binnensingel Oostkant
666,R10 414,2022-11-22,15:00:00,136,113,23,FMN 19 Binnensingel Oostkant
666,R10 414,2022-11-22,16:00:00,235,184,51,FMN 19 Binnensingel Oostkant
666,R10 414,2022-11-22,17:00:00,202,152,50,FMN 19 Binnensingel Oostkant
666,R10 414,2022-11-22,18:00:00,177,138,39,FMN 19 Binnensingel Oostkant
666,R10 414,2022-11-22,19:00:00,77,57,20,FMN 19 Binnensingel Oostkant
666,R10 414,2022-11-22,20:00:00,63,49,14,FMN 19 Binnensingel Oostkant
666,R10 414,2022-11-22,21:00:00,62,51,11,FMN 19 Binnensingel Oostkant
666,R10 414,2022-11-22,22:00:00,59,48,11,FMN 19 Binnensingel Oostkant
666,R10 414,2022-11-22,23:00:00,36,30,6,FMN 19 Binnensingel Oostkant
666,R10 414,2022-11-24,00:00:00,9,6,3,FMN 19 Binnensingel Oostkant
666,R10 414,2022-11-24,01:00:00,6,5,1,FMN 19 Binnensingel Oostkant
666,R10 414,2022-11-24,02:00:00,5,4,1,FMN 19 Binnensingel Oostkant
666,R10 414,2022-11-24,03:00:00,6,4,2,FMN 19 Binnensingel Oostkant
666,R10 414,2022-11-24,04:00:00,15,8,7,FMN 19 Binnensingel Oostkant
666,R10 414,2022-11-24,05:00:00,22,12,10,FMN 19 Binnensingel Oostkant
666,R10 414,2022-11-24,06:00:00,42,26,16,FMN 19 Binnensingel Oostkant
666,R10 414,2022-11-24,07:00:00,120,79,41,FMN 19 Binnensingel Oostkant
666,R10 414,2022-11-24,08:00:00,162,108,54,FMN 19 Binnensingel Oostkant
666,R10 414,2022-11-24,09:00:00,63,42,21,FMN 19 Binnensingel Oostkant
666,R10 414,2022-11-24,10:00:00,59,40,19,FMN 19 Binnensingel Oostkant
666,R10 414,2022-11-24,11:00:00,57,44,13,FMN 19 Binnensingel Oostkant
666,R10 414,2022-11-24,12:00:00,95,75,20,FMN 19 Binnensingel Oostkant
666,R10 414,2022-11-24,13:00:00,84,62,22,FMN 19 Binnensingel Oostkant
666,R10 414,2022-11-24,14:00:00,72,58,14,FMN 19 Binnensingel Oostkant
666,R10 414,2022-11-24,15:00:00,127,104,23,FMN 19 Binnensingel Oostkant
666,R10 414,2022-11-24,16:00:00,189,150,39,FMN 19 Binnensingel Oostkant
666,R10 414,2022-11-24,17:00:00,196,154,42,FMN 19 Binnensingel Oostkant
666,R10 414,2022-11-24,18:00:00,153,114,39,FMN 19 Binnensingel Oostkant
666,R10 414,2022-11-24,19:00:00,83,61,22,FMN 19 Binnensingel Oostkant
666,R10 414,2022-11-24,20:00:00,66,49,17,FMN 19 Binnensingel Oostkant
666,R10 414,2022-11-24,21:00:00,68,54,14,FMN 19 Binnensingel Oostkant
666,R10 414,2022-11-24,22:00:00,55,43,12,FMN 19 Binnensingel Oostkant
666,R10 414,2022-11-24,23:00:00,35,27,8,FMN 19 Binnensingel Oostkant
666,R10 414,2022-11-25,00:00:00,25,17,8,FMN 19 Binnensingel Oostkant
666,R10 414,2022-11-25,01:00:00,16,11,5,FMN 19 Binnensingel Oostkant
666,R10 414,2022-11-25,02:00:00,11,9,2,FMN 19 Binnensingel Oostkant
666,R10 414,2022-11-25,03:00:00,13,9,4,FMN 19 Binnensingel Oostkant
666,R10 414,2022-11-25,04:00:00,20,12,8,FMN 19 Binnensingel Oostkant
666,R10 414,2022-11-25,05:00:00,19,13,6,FMN 19 Binnensingel Oostkant
666,R10 414,2022-11-25,06:00:00,39,27,12,FMN 19 Binnensingel Oostkant
666,R10 414,2022-11-25,07:00:00,75,52,23,FMN 19 Binnensingel Oostkant
666,R10 414,2022-11-25,08:00:00,97,69,28,FMN 19 Binnensingel Oostkant
666,R10 414,2022-11-25,09:00:00,56,41,15,FMN 19 Binnensingel Oostkant
666,R10 414,2022-11-25,10:00:00,53,41,12,FMN 19 Binnensingel Oostkant
666,R10 414,2022-11-25,11:00:00,57,43,14,FMN 19 Binnensingel Oostkant
666,R10 414,2022-11-25,12:00:00,72,55,17,FMN 19 Binnensingel Oostkant
666,R10 414,2022-11-25,13:00:00,77,54,23,FMN 19 Binnensingel Oostkant
666,R10 414,2022-11-25,14:00:00,80,64,16,FMN 19 Binnensingel Oostkant
666,R10 414,2022-11-25,15:00:00,107,88,19,FMN 19 Binnensingel Oostkant
666,R10 414,2022-11-25,16:00:00,148,128,20,FMN 19 Binnensingel Oostkant
666,R10 414,2022-11-25,17:00:00,133,101,32,FMN 19 Binnensingel Oostkant
666,R10 414,2022-11-25,18:00:00,93,74,19,FMN 19 Binnensingel Oostkant
666,R10 414,2022-11-25,19:00:00,73,56,17,FMN 19 Binnensingel Oostkant
666,R10 414,2022-11-25,20:00:00,36,27,9,FMN 19 Binnensingel Oostkant
666,R10 414,2022-11-25,21:00:00,33,28,5,FMN 19 Binnensingel Oostkant
666,R10 414,2022-11-25,22:00:00,27,22,5,FMN 19 Binnensingel Oostkant
666,R10 414,2022-11-25,23:00:00,27,20,7,FMN 19 Binnensingel Oostkant
666,R10 414,2022-11-26,00:00:00,15,14,1,FMN 19 Binnensingel Oostkant
666,R10 414,2022-11-26,01:00:00,9,8,1,FMN 19 Binnensingel Oostkant
666,R10 414,2022-11-26,02:00:00,8,7,1,FMN 19 Binnensingel Oostkant
666,R10 414,2022-11-26,03:00:00,7,5,2,FMN 19 Binnensingel Oostkant
666,R10 414,2022-11-26,04:00:00,8,6,2,FMN 19 Binnensingel Oostkant
666,R10 414,2022-11-26,05:00:00,6,5,1,FMN 19 Binnensingel Oostkant
666,R10 414,2022-11-26,06:00:00,9,5,4,FMN 19 Binnensingel Oostkant
666,R10 414,2022-11-26,07:00:00,11,8,3,FMN 19 Binnensingel Oostkant
666,R10 414,2022-11-26,08:00:00,16,13,3,FMN 19 Binnensingel Oostkant
666,R10 414,2022-11-26,09:00:00,23,18,5,FMN 19 Binnensingel Oostkant
666,R10 414,2022-11-26,10:00:00,32,29,3,FMN 19 Binnensingel Oostkant
666,R10 414,2022-11-26,11:00:00,31,26,5,FMN 19 Binnensingel Oostkant
666,R10 414,2022-11-26,12:00:00,44,35,9,FMN 19 Binnensingel Oostkant
666,R10 414,2022-11-26,13:00:00,40,32,8,FMN 19 Binnensingel Oostkant
666,R10 414,2022-11-26,14:00:00,43,34,9,FMN 19 Binnensingel Oostkant
666,R10 414,2022-11-26,15:00:00,44,34,10,FMN 19 Binnensingel Oostkant
666,R10 414,2022-11-26,16:00:00,45,38,7,FMN 19 Binnensingel Oostkant
666,R10 414,2022-11-26,17:00:00,51,43,8,FMN 19 Binnensingel Oostkant
666,R10 414,2022-11-26,18:00:00,46,41,5,FMN 19 Binnensingel Oostkant
666,R10 414,2022-11-26,19:00:00,40,32,8,FMN 19 Binnensingel Oostkant
666,R10 414,2022-11-26,20:00:00,27,23,4,FMN 19 Binnensingel Oostkant
666,R10 414,2022-11-26,21:00:00,25,20,5,FMN 19 Binnensingel Oostkant
666,R10 414,2022-11-26,22:00:00,31,27,4,FMN 19 Binnensingel Oostkant
666,R10 414,2022-11-26,23:00:00,18,14,4,FMN 19 Binnensingel Oostkant
666,R10 414,2022-11-27,00:00:00,23,19,4,FMN 19 Binnensingel Oostkant
666,R10 414,2022-11-27,01:00:00,11,7,4,FMN 19 Binnensingel Oostkant
666,R10 414,2022-11-27,02:00:00,7,6,1,FMN 19 Binnensingel Oostkant
666,R10 414,2022-11-27,03:00:00,10,8,2,FMN 19 Binnensingel Oostkant
666,R10 414,2022-11-27,04:00:00,6,3,3,FMN 19 Binnensingel Oostkant
666,R10 414,2022-11-27,05:00:00,7,4,3,FMN 19 Binnensingel Oostkant
666,R10 414,2022-11-27,06:00:00,2,1,1,FMN 19 Binnensingel Oostkant
666,R10 414,2022-11-27,07:00:00,7,5,2,FMN 19 Binnensingel Oostkant
666,R10 414,2022-11-27,08:00:00,11,7,4,FMN 19 Binnensingel Oostkant
666,R10 414,2022-11-27,09:00:00,21,15,6,FMN 19 Binnensingel Oostkant
666,R10 414,2022-11-27,10:00:00,28,21,7,FMN 19 Binnensingel Oostkant
666,R10 414,2022-11-27,11:00:00,39,30,9,FMN 19 Binnensingel Oostkant
666,R10 414,2022-11-27,12:00:00,37,29,8,FMN 19 Binnensingel Oostkant
666,R10 414,2022-11-27,13:00:00,53,39,14,FMN 19 Binnensingel Oostkant
666,R10 414,2022-11-27,14:00:00,49,35,14,FMN 19 Binnensingel Oostkant
666,R10 414,2022-11-27,15:00:00,51,31,20,FMN 19 Binnensingel Oostkant
666,R10 414,2022-11-27,16:00:00,50,37,13,FMN 19 Binnensingel Oostkant
666,R10 414,2022-11-27,17:00:00,51,37,14,FMN 19 Binnensingel Oostkant
666,R10 414,2022-11-27,18:00:00,30,20,10,FMN 19 Binnensingel Oostkant
666,R10 414,2022-11-27,19:00:00,33,25,8,FMN 19 Binnensingel Oostkant
666,R10 414,2022-11-27,20:00:00,26,19,7,FMN 19 Binnensingel Oostkant
666,R10 414,2022-11-27,21:00:00,18,13,5,FMN 19 Binnensingel Oostkant
666,R10 414,2022-11-27,22:00:00,21,14,7,FMN 19 Binnensingel Oostkant
666,R10 414,2022-11-27,23:00:00,11,8,3,FMN 19 Binnensingel Oostkant
666,R10 414,2022-11-28,00:00:00,5,4,1,FMN 19 Binnensingel Oostkant
666,R10 414,2022-11-28,01:00:00,5,4,1,FMN 19 Binnensingel Oostkant
666,R10 414,2022-11-28,02:00:00,6,5,1,FMN 19 Binnensingel Oostkant
666,R10 414,2022-11-28,03:00:00,3,1,2,FMN 19 Binnensingel Oostkant
666,R10 414,2022-11-28,04:00:00,12,6,6,FMN 19 Binnensingel Oostkant
666,R10 414,2022-11-28,05:00:00,22,12,10,FMN 19 Binnensingel Oostkant
666,R10 414,2022-11-28,06:00:00,47,32,15,FMN 19 Binnensingel Oostkant
666,R10 414,2022-11-28,07:00:00,129,86,43,FMN 19 Binnensingel Oostkant
666,R10 414,2022-11-28,08:00:00,132,79,53,FMN 19 Binnensingel Oostkant
666,R10 414,2022-11-28,09:00:00,56,35,21,FMN 19 Binnensingel Oostkant
666,R10 414,2022-11-28,10:00:00,63,43,20,FMN 19 Binnensingel Oostkant
666,R10 414,2022-11-28,11:00:00,72,58,14,FMN 19 Binnensingel Oostkant
666,R10 414,2022-11-28,12:00:00,114,87,27,FMN 19 Binnensingel Oostkant
666,R10 414,2022-11-28,13:00:00,113,79,34,FMN 19 Binnensingel Oostkant
666,R10 414,2022-11-28,14:00:00,90,72,18,FMN 19 Binnensingel Oostkant
666,R10 414,2022-11-28,15:00:00,159,130,29,FMN 19 Binnensingel Oostkant
666,R10 414,2022-11-28,16:00:00,258,212,46,FMN 19 Binnensingel Oostkant
666,R10 414,2022-11-28,17:00:00,211,166,45,FMN 19 Binnensingel Oostkant
666,R10 414,2022-11-28,18:00:00,158,123,35,FMN 19 Binnensingel Oostkant
666,R10 414,2022-11-28,19:00:00,80,56,24,FMN 19 Binnensingel Oostkant
666,R10 414,2022-11-28,20:00:00,60,47,13,FMN 19 Binnensingel Oostkant
666,R10 414,2022-11-28,21:00:00,51,46,5,FMN 19 Binnensingel Oostkant
666,R10 414,2022-11-28,22:00:00,66,52,14,FMN 19 Binnensingel Oostkant
666,R10 414,2022-11-28,23:00:00,21,16,5,FMN 19 Binnensingel Oostkant
666,R10 414,2022-11-29,00:00:00,6,4,2,FMN 19 Binnensingel Oostkant
666,R10 414,2022-11-29,01:00:00,4,4,0,FMN 19 Binnensingel Oostkant
666,R10 414,2022-11-29,02:00:00,5,2,3,FMN 19 Binnensingel Oostkant
666,R10 414,2022-11-29,03:00:00,5,2,3,FMN 19 Binnensingel Oostkant
666,R10 414,2022-11-29,04:00:00,23,10,13,FMN 19 Binnensingel Oostkant
666,R10 414,2022-11-29,05:00:00,31,15,16,FMN 19 Binnensingel Oostkant
666,R10 414,2022-11-29,06:00:00,76,48,28,FMN 19 Binnensingel Oostkant
666,R10 414,2022-11-29,07:00:00,234,161,73,FMN 19 Binnensingel Oostkant
666,R10 414,2022-11-29,08:00:00,278,185,93,FMN 19 Binnensingel Oostkant
666,R10 414,2022-11-29,09:00:00,109,71,38,FMN 19 Binnensingel Oostkant
666,R10 414,2022-11-29,10:00:00,76,51,25,FMN 19 Binnensingel Oostkant
666,R10 414,2022-11-29,11:00:00,90,68,22,FMN 19 Binnensingel Oostkant
666,R10 414,2022-11-29,12:00:00,141,102,39,FMN 19 Binnensingel Oostkant
666,R10 414,2022-11-29,13:00:00,151,109,42,FMN 19 Binnensingel Oostkant
666,R10 414,2022-11-29,14:00:00,108,80,28,FMN 19 Binnensingel Oostkant
666,R10 414,2022-11-29,15:00:00,215,189,26,FMN 19 Binnensingel Oostkant
666,R10 414,2022-11-29,16:00:00,322,257,65,FMN 19 Binnensingel Oostkant
666,R10 414,2022-11-29,17:00:00,309,238,71,FMN 19 Binnensingel Oostkant
666,R10 414,2022-11-29,18:00:00,271,214,57,FMN 19 Binnensingel Oostkant
666,R10 414,2022-11-29,19:00:00,104,79,25,FMN 19 Binnensingel Oostkant
666,R10 414,2022-11-29,20:00:00,93,71,22,FMN 19 Binnensingel Oostkant
666,R10 414,2022-11-29,21:00:00,96,78,18,FMN 19 Binnensingel Oostkant
666,R10 414,2022-11-29,22:00:00,75,58,17,FMN 19 Binnensingel Oostkant
666,R10 414,2022-11-29,23:00:00,40,33,7,FMN 19 Binnensingel Oostkant
666,R10 414,2022-11-30,00:00:00,13,4,9,FMN 19 Binnensingel Oostkant
666,R10 414,2022-11-30,01:00:00,7,5,2,FMN 19 Binnensingel Oostkant
666,R10 414,2022-11-30,02:00:00,4,4,0,FMN 19 Binnensingel Oostkant
666,R10 414,2022-11-30,03:00:00,5,5,0,FMN 19 Binnensingel Oostkant
666,R10 414,2022-11-30,04:00:00,36,12,24,FMN 19 Binnensingel Oostkant
666,R10 414,2022-11-30,05:00:00,51,17,34,FMN 19 Binnensingel Oostkant
666,R10 414,2022-11-30,06:00:00,104,51,53,FMN 19 Binnensingel Oostkant
666,R10 414,2022-11-30,07:00:00,225,117,108,FMN 19 Binnensingel Oostkant
666,R10 414,2022-11-30,08:00:00,310,138,172,FMN 19 Binnensingel Oostkant
666,R10 414,2022-11-30,09:00:00,121,72,49,FMN 19 Binnensingel Oostkant
666,R10 414,2022-11-30,10:00:00,181,106,75,FMN 19 Binnensingel Oostkant
666,R10 414,2022-11-30,11:00:00,217,133,84,FMN 19 Binnensingel Oostkant
666,R10 414,2022-11-30,12:00:00,409,274,135,FMN 19 Binnensingel Oostkant
666,R10 414,2022-11-30,13:00:00,449,334,115,FMN 19 Binnensingel Oostkant
666,R10 414,2022-11-30,14:00:00,277,202,75,FMN 19 Binnensingel Oostkant
666,R10 414,2022-11-30,15:00:00,444,340,104,FMN 19 Binnensingel Oostkant
666,R10 414,2022-11-30,16:00:00,637,500,137,FMN 19 Binnensingel Oostkant
666,R10 414,2022-11-30,17:00:00,730,518,212,FMN 19 Binnensingel Oostkant
666,R10 414,2022-11-30,18:00:00,576,391,185,FMN 19 Binnensingel Oostkant
666,R10 414,2022-11-30,19:00:00,341,239,102,FMN 19 Binnensingel Oostkant
666,R10 414,2022-11-30,20:00:00,215,164,51,FMN 19 Binnensingel Oostkant
666,R10 414,2022-11-30,21:00:00,242,194,48,FMN 19 Binnensingel Oostkant
666,R10 414,2022-11-30,22:00:00,204,155,49,FMN 19 Binnensingel Oostkant
666,R10 414,2022-11-30,23:00:00,85,65,20,FMN 19 Binnensingel Oostkant
666,R10 414,2022-12-01,00:00:00,8,5,3,FMN 19 Binnensingel Oostkant
666,R10 414,2022-12-01,01:00:00,4,4,0,FMN 19 Binnensingel Oostkant
666,R10 414,2022-12-01,02:00:00,4,3,1,FMN 19 Binnensingel Oostkant
666,R10 414,2022-12-01,03:00:00,5,3,2,FMN 19 Binnensingel Oostkant
666,R10 414,2022-12-01,04:00:00,13,7,6,FMN 19 Binnensingel Oostkant
666,R10 414,2022-12-01,05:00:00,17,10,7,FMN 19 Binnensingel Oostkant
666,R10 414,2022-12-01,06:00:00,35,22,13,FMN 19 Binnensingel Oostkant
666,R10 414,2022-12-01,07:00:00,99,65,34,FMN 19 Binnensingel Oostkant
666,R10 414,2022-12-01,08:00:00,133,90,43,FMN 19 Binnensingel Oostkant
666,R10 414,2022-12-01,09:00:00,52,34,18,FMN 19 Binnensingel Oostkant
666,R10 414,2022-12-01,10:00:00,49,33,16,FMN 19 Binnensingel Oostkant
666,R10 414,2022-12-01,11:00:00,47,37,10,FMN 19 Binnensingel Oostkant
666,R10 414,2022-12-01,12:00:00,78,62,16,FMN 19 Binnensingel Oostkant
666,R10 414,2022-12-01,13:00:00,70,52,18,FMN 19 Binnensingel Oostkant
666,R10 414,2022-12-01,14:00:00,58,47,11,FMN 19 Binnensingel Oostkant
666,R10 414,2022-12-01,15:00:00,105,86,19,FMN 19 Binnensingel Oostkant
666,R10 414,2022-12-01,16:00:00,156,124,32,FMN 19 Binnensingel Oostkant
666,R10 414,2022-12-01,17:00:00,162,128,34,FMN 19 Binnensingel Oostkant
666,R10 414,2022-12-01,18:00:00,125,94,31,FMN 19 Binnensingel Oostkant
666,R10 414,2022-12-01,19:00:00,69,51,18,FMN 19 Binnensingel Oostkant
666,R10 414,2022-12-01,20:00:00,55,40,15,FMN 19 Binnensingel Oostkant
666,R10 414,2022-12-01,21:00:00,55,45,10,FMN 19 Binnensingel Oostkant
666,R10 414,2022-12-01,22:00:00,46,36,10,FMN 19 Binnensingel Oostkant
666,R10 414,2022-12-01,23:00:00,29,22,7,FMN 19 Binnensingel Oostkant
666,R10 414,2022-12-02,00:00:00,24,16,8,FMN 19 Binnensingel Oostkant
666,R10 414,2022-12-02,01:00:00,17,12,5,FMN 19 Binnensingel Oostkant
666,R10 414,2022-12-02,02:00:00,11,9,2,FMN 19 Binnensingel Oostkant
666,R10 414,2022-12-02,03:00:00,11,8,3,FMN 19 Binnensingel Oostkant
666,R10 414,2022-12-02,04:00:00,20,12,8,FMN 19 Binnensingel Oostkant
666,R10 414,2022-12-02,05:00:00,19,12,7,FMN 19 Binnensingel Oostkant
666,R10 414,2022-12-02,06:00:00,39,28,11,FMN 19 Binnensingel Oostkant
666,R10 414,2022-12-02,07:00:00,75,51,24,FMN 19 Binnensingel Oostkant
666,R10 414,2022-12-02,08:00:00,94,67,27,FMN 19 Binnensingel Oostkant
666,R10 414,2022-12-02,09:00:00,56,41,15,FMN 19 Binnensingel Oostkant
666,R10 414,2022-12-02,10:00:00,53,41,12,FMN 19 Binnensingel Oostkant
666,R10 414,2022-12-02,11:00:00,55,42,13,FMN 19 Binnensingel Oostkant
666,R10 414,2022-12-02,12:00:00,71,54,17,FMN 19 Binnensingel Oostkant
666,R10 414,2022-12-02,13:00:00,75,52,23,FMN 19 Binnensingel Oostkant
666,R10 414,2022-12-02,14:00:00,80,64,16,FMN 19 Binnensingel Oostkant
666,R10 414,2022-12-02,15:00:00,106,87,19,FMN 19 Binnensingel Oostkant
666,R10 414,2022-12-02,16:00:00,145,125,20,FMN 19 Binnensingel Oostkant
666,R10 414,2022-12-02,17:00:00,131,99,32,FMN 19 Binnensingel Oostkant
666,R10 414,2022-12-02,18:00:00,92,73,19,FMN 19 Binnensingel Oostkant
666,R10 414,2022-12-02,19:00:00,72,56,16,FMN 19 Binnensingel Oostkant
666,R10 414,2022-12-02,20:00:00,36,26,10,FMN 19 Binnensingel Oostkant
666,R10 414,2022-12-02,21:00:00,32,28,4,FMN 19 Binnensingel Oostkant
666,R10 414,2022-12-02,22:00:00,26,21,5,FMN 19 Binnensingel Oostkant
666,R10 414,2022-12-02,23:00:00,27,20,7,FMN 19 Binnensingel Oostkant
666,R10 414,2022-12-04,00:00:00,29,24,5,FMN 19 Binnensingel Oostkant
666,R10 414,2022-12-04,01:00:00,14,9,5,FMN 19 Binnensingel Oostkant
666,R10 414,2022-12-04,02:00:00,9,8,1,FMN 19 Binnensingel Oostkant
666,R10 414,2022-12-04,03:00:00,13,10,3,FMN 19 Binnensingel Oostkant
666,R10 414,2022-12-04,04:00:00,8,4,4,FMN 19 Binnensingel Oostkant
666,R10 414,2022-12-04,05:00:00,7,4,3,FMN 19 Binnensingel Oostkant
666,R10 414,2022-12-04,06:00:00,4,2,2,FMN 19 Binnensingel Oostkant
666,R10 414,2022-12-04,07:00:00,8,6,2,FMN 19 Binnensingel Oostkant
666,R10 414,2022-12-04,08:00:00,14,9,5,FMN 19 Binnensingel Oostkant
666,R10 414,2022-12-04,09:00:00,26,19,7,FMN 19 Binnensingel Oostkant
666,R10 414,2022-12-04,10:00:00,36,27,9,FMN 19 Binnensingel Oostkant
666,R10 414,2022-12-04,11:00:00,49,38,11,FMN 19 Binnensingel Oostkant
666,R10 414,2022-12-04,12:00:00,47,37,10,FMN 19 Binnensingel Oostkant
666,R10 414,2022-12-04,13:00:00,67,49,18,FMN 19 Binnensingel Oostkant
666,R10 414,2022-12-04,14:00:00,61,44,17,FMN 19 Binnensingel Oostkant
666,R10 414,2022-12-04,15:00:00,65,39,26,FMN 19 Binnensingel Oostkant
666,R10 414,2022-12-04,16:00:00,62,47,15,FMN 19 Binnensingel Oostkant
666,R10 414,2022-12-04,17:00:00,66,48,18,FMN 19 Binnensingel Oostkant
666,R10 414,2022-12-04,18:00:00,38,25,13,FMN 19 Binnensingel Oostkant
666,R10 414,2022-12-04,19:00:00,40,31,9,FMN 19 Binnensingel Oostkant
666,R10 414,2022-12-04,20:00:00,35,25,10,FMN 19 Binnensingel Oostkant
666,R10 414,2022-12-04,21:00:00,21,16,5,FMN 19 Binnensingel Oostkant
666,R10 414,2022-12-04,22:00:00,26,17,9,FMN 19 Binnensingel Oostkant
666,R10 414,2022-12-04,23:00:00,15,11,4,FMN 19 Binnensingel Oostkant
666,R10 414,2022-12-05,00:00:00,5,4,1,FMN 19 Binnensingel Oostkant
666,R10 414,2022-12-05,01:00:00,5,4,1,FMN 19 Binnensingel Oostkant
666,R10 414,2022-12-05,02:00:00,6,5,1,FMN 19 Binnensingel Oostkant
666,R10 414,2022-12-05,03:00:00,3,1,2,FMN 19 Binnensingel Oostkant
666,R10 414,2022-12-05,04:00:00,11,6,5,FMN 19 Binnensingel Oostkant
666,R10 414,2022-12-05,05:00:00,20,11,9,FMN 19 Binnensingel Oostkant
666,R10 414,2022-12-05,06:00:00,45,31,14,FMN 19 Binnensingel Oostkant
666,R10 414,2022-12-05,07:00:00,122,84,38,FMN 19 Binnensingel Oostkant
666,R10 414,2022-12-05,08:00:00,126,77,49,FMN 19 Binnensingel Oostkant
666,R10 414,2022-12-05,09:00:00,52,34,18,FMN 19 Binnensingel Oostkant
666,R10 414,2022-12-05,10:00:00,61,42,19,FMN 19 Binnensingel Oostkant
666,R10 414,2022-12-05,11:00:00,69,56,13,FMN 19 Binnensingel Oostkant
666,R10 414,2022-12-05,12:00:00,109,85,24,FMN 19 Binnensingel Oostkant
666,R10 414,2022-12-05,13:00:00,108,77,31,FMN 19 Binnensingel Oostkant
666,R10 414,2022-12-05,14:00:00,86,69,17,FMN 19 Binnensingel Oostkant
666,R10 414,2022-12-05,15:00:00,153,127,26,FMN 19 Binnensingel Oostkant
666,R10 414,2022-12-05,16:00:00,247,206,41,FMN 19 Binnensingel Oostkant
666,R10 414,2022-12-05,17:00:00,203,162,41,FMN 19 Binnensingel Oostkant
666,R10 414,2022-12-05,18:00:00,152,120,32,FMN 19 Binnensingel Oostkant
666,R10 414,2022-12-05,19:00:00,76,54,22,FMN 19 Binnensingel Oostkant
666,R10 414,2022-12-05,20:00:00,57,46,11,FMN 19 Binnensingel Oostkant
666,R10 414,2022-12-05,21:00:00,50,45,5,FMN 19 Binnensingel Oostkant
666,R10 414,2022-12-05,22:00:00,62,50,12,FMN 19 Binnensingel Oostkant
666,R10 414,2022-12-05,23:00:00,21,16,5,FMN 19 Binnensingel Oostkant
666,R10 414,2022-12-06,00:00:00,4,3,1,FMN 19 Binnensingel Oostkant
666,R10 414,2022-12-06,01:00:00,2,2,0,FMN 19 Binnensingel Oostkant
666,R10 414,2022-12-06,02:00:00,5,2,3,FMN 19 Binnensingel Oostkant
666,R10 414,2022-12-06,03:00:00,3,1,2,FMN 19 Binnensingel Oostkant
666,R10 414,2022-12-06,04:00:00,16,7,9,FMN 19 Binnensingel Oostkant
666,R10 414,2022-12-06,05:00:00,22,11,11,FMN 19 Binnensingel Oostkant
666,R10 414,2022-12-06,06:00:00,53,32,21,FMN 19 Binnensingel Oostkant
666,R10 414,2022-12-06,07:00:00,164,112,52,FMN 19 Binnensingel Oostkant
666,R10 414,2022-12-06,08:00:00,194,127,67,FMN 19 Binnensingel Oostkant
666,R10 414,2022-12-06,09:00:00,77,49,28,FMN 19 Binnensingel Oostkant
666,R10 414,2022-12-06,10:00:00,53,35,18,FMN 19 Binnensingel Oostkant
666,R10 414,2022-12-06,11:00:00,63,48,15,FMN 19 Binnensingel Oostkant
666,R10 414,2022-12-06,12:00:00,99,70,29,FMN 19 Binnensingel Oostkant
666,R10 414,2022-12-06,13:00:00,105,75,30,FMN 19 Binnensingel Oostkant
666,R10 414,2022-12-06,14:00:00,76,56,20,FMN 19 Binnensingel Oostkant
666,R10 414,2022-12-06,15:00:00,149,130,19,FMN 19 Binnensingel Oostkant
666,R10 414,2022-12-06,16:00:00,224,177,47,FMN 19 Binnensingel Oostkant
666,R10 414,2022-12-06,17:00:00,215,164,51,FMN 19 Binnensingel Oostkant
666,R10 414,2022-12-06,18:00:00,189,148,41,FMN 19 Binnensingel Oostkant
666,R10 414,2022-12-06,19:00:00,73,55,18,FMN 19 Binnensingel Oostkant
666,R10 414,2022-12-06,20:00:00,64,48,16,FMN 19 Binnensingel Oostkant
666,R10 414,2022-12-06,21:00:00,67,54,13,FMN 19 Binnensingel Oostkant
666,R10 414,2022-12-06,22:00:00,52,40,12,FMN 19 Binnensingel Oostkant
666,R10 414,2022-12-06,23:00:00,28,23,5,FMN 19 Binnensingel Oostkant
666,R10 414,2022-12-07,00:00:00,0,0,0,FMN 19 Binnensingel Oostkant
666,R10 414,2022-12-07,01:00:00,2,0,2,FMN 19 Binnensingel Oostkant
666,R10 414,2022-12-07,02:00:00,0,0,0,FMN 19 Binnensingel Oostkant
666,R10 414,2022-12-07,03:00:00,4,0,4,FMN 19 Binnensingel Oostkant
666,R10 414,2022-12-07,04:00:00,4,0,4,FMN 19 Binnensingel Oostkant
666,R10 414,2022-12-07,05:00:00,13,0,13,FMN 19 Binnensingel Oostkant
666,R10 414,2022-12-07,06:00:00,17,0,17,FMN 19 Binnensingel Oostkant
666,R10 414,2022-12-07,07:00:00,42,0,42,FMN 19 Binnensingel Oostkant
666,R10 414,2022-12-07,08:00:00,47,0,47,FMN 19 Binnensingel Oostkant
666,R10 414,2022-12-07,09:00:00,18,0,18,FMN 19 Binnensingel Oostkant
666,R10 414,2022-12-07,10:00:00,25,0,25,FMN 19 Binnensingel Oostkant
666,R10 414,2022-12-07,11:00:00,9,0,9,FMN 19 Binnensingel Oostkant
666,R10 414,2022-12-07,12:00:00,59,19,40,FMN 19 Binnensingel Oostkant
666,R10 414,2022-12-07,13:00:00,123,99,24,FMN 19 Binnensingel Oostkant
666,R10 414,2022-12-07,14:00:00,65,42,23,FMN 19 Binnensingel Oostkant
666,R10 414,2022-12-07,15:00:00,112,91,21,FMN 19 Binnensingel Oostkant
666,R10 414,2022-12-07,16:00:00,174,129,45,FMN 19 Binnensingel Oostkant
666,R10 414,2022-12-07,17:00:00,198,150,48,FMN 19 Binnensingel Oostkant
666,R10 414,2022-12-07,18:00:00,151,111,40,FMN 19 Binnensingel Oostkant
666,R10 414,2022-12-07,19:00:00,92,67,25,FMN 19 Binnensingel Oostkant
666,R10 414,2022-12-07,20:00:00,55,39,16,FMN 19 Binnensingel Oostkant
666,R10 414,2022-12-07,21:00:00,50,42,8,FMN 19 Binnensingel Oostkant
666,R10 414,2022-12-07,22:00:00,46,38,8,FMN 19 Binnensingel Oostkant
666,R10 414,2022-12-07,23:00:00,24,18,6,FMN 19 Binnensingel Oostkant
666,R10 414,2022-12-08,00:00:00,4,3,1,FMN 19 Binnensingel Oostkant
666,R10 414,2022-12-08,01:00:00,6,4,2,FMN 19 Binnensingel Oostkant
666,R10 414,2022-12-08,02:00:00,5,4,1,FMN 19 Binnensingel Oostkant
666,R10 414,2022-12-08,03:00:00,9,6,3,FMN 19 Binnensingel Oostkant
666,R10 414,2022-12-08,04:00:00,18,10,8,FMN 19 Binnensingel Oostkant
666,R10 414,2022-12-08,05:00:00,17,10,7,FMN 19 Binnensingel Oostkant
666,R10 414,2022-12-08,06:00:00,37,25,12,FMN 19 Binnensingel Oostkant
666,R10 414,2022-12-08,07:00:00,128,93,35,FMN 19 Binnensingel Oostkant
666,R10 414,2022-12-08,08:00:00,143,95,48,FMN 19 Binnensingel Oostkant
666,R10 414,2022-12-08,09:00:00,56,37,19,FMN 19 Binnensingel Oostkant
666,R10 414,2022-12-08,10:00:00,51,35,16,FMN 19 Binnensingel Oostkant
666,R10 414,2022-12-08,11:00:00,57,46,11,FMN 19 Binnensingel Oostkant
666,R10 414,2022-12-08,12:00:00,108,85,23,FMN 19 Binnensingel Oostkant
666,R10 414,2022-12-08,13:00:00,72,54,18,FMN 19 Binnensingel Oostkant
666,R10 414,2022-12-08,14:00:00,54,46,8,FMN 19 Binnensingel Oostkant
666,R10 414,2022-12-08,15:00:00,121,103,18,FMN 19 Binnensingel Oostkant
666,R10 414,2022-12-08,16:00:00,179,144,35,FMN 19 Binnensingel Oostkant
666,R10 414,2022-12-08,17:00:00,204,169,35,FMN 19 Binnensingel Oostkant
666,R10 414,2022-12-08,18:00:00,123,97,26,FMN 19 Binnensingel Oostkant
666,R10 414,2022-12-08,19:00:00,70,57,13,FMN 19 Binnensingel Oostkant
666,R10 414,2022-12-08,20:00:00,55,35,20,FMN 19 Binnensingel Oostkant
666,R10 414,2022-12-08,21:00:00,54,50,4,FMN 19 Binnensingel Oostkant
666,R10 414,2022-12-08,22:00:00,53,41,12,FMN 19 Binnensingel Oostkant
666,R10 414,2022-12-08,23:00:00,37,30,7,FMN 19 Binnensingel Oostkant
666,R10 414,2022-12-09,00:00:00,18,10,8,FMN 19 Binnensingel Oostkant
666,R10 414,2022-12-09,01:00:00,8,6,2,FMN 19 Binnensingel Oostkant
666,R10 414,2022-12-09,02:00:00,6,6,0,FMN 19 Binnensingel Oostkant
666,R10 414,2022-12-09,03:00:00,5,2,3,FMN 19 Binnensingel Oostkant
666,R10 414,2022-12-09,04:00:00,11,7,4,FMN 19 Binnensingel Oostkant
666,R10 414,2022-12-09,05:00:00,17,13,4,FMN 19 Binnensingel Oostkant
666,R10 414,2022-12-09,06:00:00,51,37,14,FMN 19 Binnensingel Oostkant
666,R10 414,2022-12-09,07:00:00,76,60,16,FMN 19 Binnensingel Oostkant
666,R10 414,2022-12-09,08:00:00,113,89,24,FMN 19 Binnensingel Oostkant
666,R10 414,2022-12-09,09:00:00,60,47,13,FMN 19 Binnensingel Oostkant
666,R10 414,2022-12-09,10:00:00,50,42,8,FMN 19 Binnensingel Oostkant
666,R10 414,2022-12-09,11:00:00,41,30,11,FMN 19 Binnensingel Oostkant
666,R10 414,2022-12-09,12:00:00,80,63,17,FMN 19 Binnensingel Oostkant
666,R10 414,2022-12-09,13:00:00,86,66,20,FMN 19 Binnensingel Oostkant
666,R10 414,2022-12-09,14:00:00,73,59,14,FMN 19 Binnensingel Oostkant
666,R10 414,2022-12-09,15:00:00,99,91,8,FMN 19 Binnensingel Oostkant
666,R10 414,2022-12-09,16:00:00,117,105,12,FMN 19 Binnensingel Oostkant
666,R10 414,2022-12-09,17:00:00,122,104,18,FMN 19 Binnensingel Oostkant
666,R10 414,2022-12-09,18:00:00,68,57,11,FMN 19 Binnensingel Oostkant
666,R10 414,2022-12-09,19:00:00,66,54,12,FMN 19 Binnensingel Oostkant
666,R10 414,2022-12-09,20:00:00,34,24,10,FMN 19 Binnensingel Oostkant
666,R10 414,2022-12-09,21:00:00,30,25,5,FMN 19 Binnensingel Oostkant
666,R10 414,2022-12-09,22:00:00,18,17,1,FMN 19 Binnensingel Oostkant
666,R10 414,2022-12-09,23:00:00,24,20,4,FMN 19 Binnensingel Oostkant
666,R10 414,2022-12-10,00:00:00,0,0,0,FMN 19 Binnensingel Oostkant
666,R10 414,2022-12-10,01:00:00,18,11,7,FMN 19 Binnensingel Oostkant
666,R10 414,2022-12-10,02:00:00,13,11,2,FMN 19 Binnensingel Oostkant
666,R10 414,2022-12-10,03:00:00,12,8,4,FMN 19 Binnensingel Oostkant
666,R10 414,2022-12-10,04:00:00,14,8,6,FMN 19 Binnensingel Oostkant
666,R10 414,2022-12-10,05:00:00,10,5,5,FMN 19 Binnensingel Oostkant
666,R10 414,2022-12-10,06:00:00,21,13,8,FMN 19 Binnensingel Oostkant
666,R10 414,2022-12-10,07:00:00,21,14,7,FMN 19 Binnensingel Oostkant
666,R10 414,2022-12-10,08:00:00,36,25,11,FMN 19 Binnensingel Oostkant
666,R10 414,2022-12-10,09:00:00,39,29,10,FMN 19 Binnensingel Oostkant
666,R10 414,2022-12-10,10:00:00,50,39,11,FMN 19 Binnensingel Oostkant
666,R10 414,2022-12-10,11:00:00,60,42,18,FMN 19 Binnensingel Oostkant
666,R10 414,2022-12-10,12:00:00,68,48,20,FMN 19 Binnensingel Oostkant
666,R10 414,2022-12-10,13:00:00,60,48,12,FMN 19 Binnensingel Oostkant
666,R10 414,2022-12-10,14:00:00,82,62,20,FMN 19 Binnensingel Oostkant
666,R10 414,2022-12-10,15:00:00,80,64,16,FMN 19 Binnensingel Oostkant
666,R10 414,2022-12-10,16:00:00,62,47,15,FMN 19 Binnensingel Oostkant
666,R10 414,2022-12-10,17:00:00,71,57,14,FMN 19 Binnensingel Oostkant
666,R10 414,2022-12-10,18:00:00,66,51,15,FMN 19 Binnensingel Oostkant
666,R10 414,2022-12-10,19:00:00,75,53,22,FMN 19 Binnensingel Oostkant
666,R10 414,2022-12-10,20:00:00,53,46,7,FMN 19 Binnensingel Oostkant
666,R10 414,2022-12-10,21:00:00,37,26,11,FMN 19 Binnensingel Oostkant
666,R10 414,2022-12-10,22:00:00,37,31,6,FMN 19 Binnensingel Oostkant
666,R10 414,2022-12-10,23:00:00,32,21,11,FMN 19 Binnensingel Oostkant
666,R10 414,2022-12-11,00:00:00,26,21,5,FMN 19 Binnensingel Oostkant
666,R10 414,2022-12-11,01:00:00,12,8,4,FMN 19 Binnensingel Oostkant
666,R10 414,2022-12-11,02:00:00,9,8,1,FMN 19 Binnensingel Oostkant
666,R10 414,2022-12-11,03:00:00,11,8,3,FMN 19 Binnensingel Oostkant
666,R10 414,2022-12-11,04:00:00,7,4,3,FMN 19 Binnensingel Oostkant
666,R10 414,2022-12-11,05:00:00,7,4,3,FMN 19 Binnensingel Oostkant
666,R10 414,2022-12-11,06:00:00,2,1,1,FMN 19 Binnensingel Oostkant
666,R10 414,2022-12-11,07:00:00,8,5,3,FMN 19 Binnensingel Oostkant
666,R10 414,2022-12-11,08:00:00,12,8,4,FMN 19 Binnensingel Oostkant
666,R10 414,2022-12-11,09:00:00,23,17,6,FMN 19 Binnensingel Oostkant
666,R10 414,2022-12-11,10:00:00,32,24,8,FMN 19 Binnensingel Oostkant
666,R10 414,2022-12-11,11:00:00,44,34,10,FMN 19 Binnensingel Oostkant
666,R10 414,2022-12-11,12:00:00,42,33,9,FMN 19 Binnensingel Oostkant
666,R10 414,2022-12-11,13:00:00,60,44,16,FMN 19 Binnensingel Oostkant
666,R10 414,2022-12-11,14:00:00,54,39,15,FMN 19 Binnensingel Oostkant
666,R10 414,2022-12-11,15:00:00,58,35,23,FMN 19 Binnensingel Oostkant
666,R10 414,2022-12-11,16:00:00,55,41,14,FMN 19 Binnensingel Oostkant
666,R10 414,2022-12-11,17:00:00,59,43,16,FMN 19 Binnensingel Oostkant
666,R10 414,2022-12-11,18:00:00,33,22,11,FMN 19 Binnensingel Oostkant
666,R10 414,2022-12-11,19:00:00,36,28,8,FMN 19 Binnensingel Oostkant
666,R10 414,2022-12-11,20:00:00,31,22,9,FMN 19 Binnensingel Oostkant
666,R10 414,2022-12-11,21:00:00,18,14,4,FMN 19 Binnensingel Oostkant
666,R10 414,2022-12-11,22:00:00,25,16,9,FMN 19 Binnensingel Oostkant
666,R10 414,2022-12-11,23:00:00,12,9,3,FMN 19 Binnensingel Oostkant
666,R10 414,2022-12-12,00:00:00,5,4,1,FMN 19 Binnensingel Oostkant
666,R10 414,2022-12-12,01:00:00,5,4,1,FMN 19 Binnensingel Oostkant
666,R10 414,2022-12-12,02:00:00,6,5,1,FMN 19 Binnensingel Oostkant
666,R10 414,2022-12-12,03:00:00,3,1,2,FMN 19 Binnensingel Oostkant
666,R10 414,2022-12-12,04:00:00,12,6,6,FMN 19 Binnensingel Oostkant
666,R10 414,2022-12-12,05:00:00,22,12,10,FMN 19 Binnensingel Oostkant
666,R10 414,2022-12-12,06:00:00,46,31,15,FMN 19 Binnensingel Oostkant
666,R10 414,2022-12-12,07:00:00,128,86,42,FMN 19 Binnensingel Oostkant
666,R10 414,2022-12-12,08:00:00,132,80,52,FMN 19 Binnensingel Oostkant
666,R10 414,2022-12-12,09:00:00,54,34,20,FMN 19 Binnensingel Oostkant
666,R10 414,2022-12-12,10:00:00,64,43,21,FMN 19 Binnensingel Oostkant
666,R10 414,2022-12-12,11:00:00,71,57,14,FMN 19 Binnensingel Oostkant
666,R10 414,2022-12-12,12:00:00,113,87,26,FMN 19 Binnensingel Oostkant
666,R10 414,2022-12-12,13:00:00,113,79,34,FMN 19 Binnensingel Oostkant
666,R10 414,2022-12-12,14:00:00,89,71,18,FMN 19 Binnensingel Oostkant
666,R10 414,2022-12-12,15:00:00,158,130,28,FMN 19 Binnensingel Oostkant
666,R10 414,2022-12-12,16:00:00,256,211,45,FMN 19 Binnensingel Oostkant
666,R10 414,2022-12-12,17:00:00,210,165,45,FMN 19 Binnensingel Oostkant
666,R10 414,2022-12-12,18:00:00,157,123,34,FMN 19 Binnensingel Oostkant
666,R10 414,2022-12-12,19:00:00,80,56,24,FMN 19 Binnensingel Oostkant
666,R10 414,2022-12-12,20:00:00,58,46,12,FMN 19 Binnensingel Oostkant
666,R10 414,2022-12-12,21:00:00,52,47,5,FMN 19 Binnensingel Oostkant
666,R10 414,2022-12-12,22:00:00,65,51,14,FMN 19 Binnensingel Oostkant
666,R10 414,2022-12-12,23:00:00,21,16,5,FMN 19 Binnensingel Oostkant
666,R10 414,2022-12-13,00:00:00,4,3,1,FMN 19 Binnensingel Oostkant
666,R10 414,2022-12-13,01:00:00,2,2,0,FMN 19 Binnensingel Oostkant
666,R10 414,2022-12-13,02:00:00,3,1,2,FMN 19 Binnensingel Oostkant
666,R10 414,2022-12-13,03:00:00,3,1,2,FMN 19 Binnensingel Oostkant
666,R10 414,2022-12-13,04:00:00,16,7,9,FMN 19 Binnensingel Oostkant
666,R10 414,2022-12-13,05:00:00,19,9,10,FMN 19 Binnensingel Oostkant
666,R10 414,2022-12-13,06:00:00,47,29,18,FMN 19 Binnensingel Oostkant
666,R10 414,2022-12-13,07:00:00,147,99,48,FMN 19 Binnensingel Oostkant
666,R10 414,2022-12-13,08:00:00,175,114,61,FMN 19 Binnensingel Oostkant
666,R10 414,2022-12-13,09:00:00,67,43,24,FMN 19 Binnensingel Oostkant
666,R10 414,2022-12-13,10:00:00,49,32,17,FMN 19 Binnensingel Oostkant
666,R10 414,2022-12-13,11:00:00,56,42,14,FMN 19 Binnensingel Oostkant
666,R10 414,2022-12-13,12:00:00,88,62,26,FMN 19 Binnensingel Oostkant
666,R10 414,2022-12-13,13:00:00,94,67,27,FMN 19 Binnensingel Oostkant
666,R10 414,2022-12-13,14:00:00,68,50,18,FMN 19 Binnensingel Oostkant
666,R10 414,2022-12-13,15:00:00,132,115,17,FMN 19 Binnensingel Oostkant
666,R10 414,2022-12-13,16:00:00,201,158,43,FMN 19 Binnensingel Oostkant
666,R10 414,2022-12-13,17:00:00,192,146,46,FMN 19 Binnensingel Oostkant
666,R10 414,2022-12-13,18:00:00,169,132,37,FMN 19 Binnensingel Oostkant
666,R10 414,2022-12-13,19:00:00,65,49,16,FMN 19 Binnensingel Oostkant
666,R10 414,2022-12-13,20:00:00,58,43,15,FMN 19 Binnensingel Oostkant
666,R10 414,2022-12-13,21:00:00,59,48,11,FMN 19 Binnensingel Oostkant
666,R10 414,2022-12-13,22:00:00,47,36,11,FMN 19 Binnensingel Oostkant
666,R10 414,2022-12-13,23:00:00,25,20,5,FMN 19 Binnensingel Oostkant
666,R10 414,2022-12-15,00:00:00,11,7,4,FMN 19 Binnensingel Oostkant
666,R10 414,2022-12-15,01:00:00,7,6,1,FMN 19 Binnensingel Oostkant
666,R10 414,2022-12-15,02:00:00,6,5,1,FMN 19 Binnensingel Oostkant
666,R10 414,2022-12-15,03:00:00,7,5,2,FMN 19 Binnensingel Oostkant
666,R10 414,2022-12-15,04:00:00,19,9,10,FMN 19 Binnensingel Oostkant
666,R10 414,2022-12-15,05:00:00,26,15,11,FMN 19 Binnensingel Oostkant
666,R10 414,2022-12-15,06:00:00,52,32,20,FMN 19 Binnensingel Oostkant
666,R10 414,2022-12-15,07:00:00,148,97,51,FMN 19 Binnensingel Oostkant
666,R10 414,2022-12-15,08:00:00,197,131,66,FMN 19 Binnensingel Oostkant
666,R10 414,2022-12-15,09:00:00,78,51,27,FMN 19 Binnensingel Oostkant
666,R10 414,2022-12-15,10:00:00,72,49,23,FMN 19 Binnensingel Oostkant
666,R10 414,2022-12-15,11:00:00,69,53,16,FMN 19 Binnensingel Oostkant
666,R10 414,2022-12-15,12:00:00,116,91,25,FMN 19 Binnensingel Oostkant
666,R10 414,2022-12-15,13:00:00,104,77,27,FMN 19 Binnensingel Oostkant
666,R10 414,2022-12-15,14:00:00,87,70,17,FMN 19 Binnensingel Oostkant
666,R10 414,2022-12-15,15:00:00,155,127,28,FMN 19 Binnensingel Oostkant
666,R10 414,2022-12-15,16:00:00,231,182,49,FMN 19 Binnensingel Oostkant
666,R10 414,2022-12-15,17:00:00,240,188,52,FMN 19 Binnensingel Oostkant
666,R10 414,2022-12-15,18:00:00,187,139,48,FMN 19 Binnensingel Oostkant
666,R10 414,2022-12-15,19:00:00,101,74,27,FMN 19 Binnensingel Oostkant
666,R10 414,2022-12-15,20:00:00,81,60,21,FMN 19 Binnensingel Oostkant
666,R10 414,2022-12-15,21:00:00,82,65,17,FMN 19 Binnensingel Oostkant
666,R10 414,2022-12-15,22:00:00,68,53,15,FMN 19 Binnensingel Oostkant
666,R10 414,2022-12-15,23:00:00,43,33,10,FMN 19 Binnensingel Oostkant
666,R10 414,2022-12-16,00:00:00,25,17,8,FMN 19 Binnensingel Oostkant
666,R10 414,2022-12-16,01:00:00,16,11,5,FMN 19 Binnensingel Oostkant
666,R10 414,2022-12-16,02:00:00,11,9,2,FMN 19 Binnensingel Oostkant
666,R10 414,2022-12-16,03:00:00,13,9,4,FMN 19 Binnensingel Oostkant
666,R10 414,2022-12-16,04:00:00,18,11,7,FMN 19 Binnensingel Oostkant
666,R10 414,2022-12-16,05:00:00,20,13,7,FMN 19 Binnensingel Oostkant
666,R10 414,2022-12-16,06:00:00,40,28,12,FMN 19 Binnensingel Oostkant
666,R10 414,2022-12-16,07:00:00,75,52,23,FMN 19 Binnensingel Oostkant
666,R10 414,2022-12-16,08:00:00,96,68,28,FMN 19 Binnensingel Oostkant
666,R10 414,2022-12-16,09:00:00,55,41,14,FMN 19 Binnensingel Oostkant
666,R10 414,2022-12-16,10:00:00,54,41,13,FMN 19 Binnensingel Oostkant
666,R10 414,2022-12-16,11:00:00,55,42,13,FMN 19 Binnensingel Oostkant
666,R10 414,2022-12-16,12:00:00,72,55,17,FMN 19 Binnensingel Oostkant
666,R10 414,2022-12-16,13:00:00,76,53,23,FMN 19 Binnensingel Oostkant
666,R10 414,2022-12-16,14:00:00,81,64,17,FMN 19 Binnensingel Oostkant
666,R10 414,2022-12-16,15:00:00,106,88,18,FMN 19 Binnensingel Oostkant
666,R10 414,2022-12-16,16:00:00,148,127,21,FMN 19 Binnensingel Oostkant
666,R10 414,2022-12-16,17:00:00,131,100,31,FMN 19 Binnensingel Oostkant
666,R10 414,2022-12-16,18:00:00,93,74,19,FMN 19 Binnensingel Oostkant
666,R10 414,2022-12-16,19:00:00,73,56,17,FMN 19 Binnensingel Oostkant
666,R10 414,2022-12-16,20:00:00,35,26,9,FMN 19 Binnensingel Oostkant
666,R10 414,2022-12-16,21:00:00,33,28,5,FMN 19 Binnensingel Oostkant
666,R10 414,2022-12-16,22:00:00,27,22,5,FMN 19 Binnensingel Oostkant
666,R10 414,2022-12-16,23:00:00,27,20,7,FMN 19 Binnensingel Oostkant
666,R10 414,2022-12-17,00:00:00,14,13,1,FMN 19 Binnensingel Oostkant
666,R10 414,2022-12-17,01:00:00,9,8,1,FMN 19 Binnensingel Oostkant
666,R10 414,2022-12-17,02:00:00,6,6,0,FMN 19 Binnensingel Oostkant
666,R10 414,2022-12-17,03:00:00,7,5,2,FMN 19 Binnensingel Oostkant
666,R10 414,2022-12-17,04:00:00,7,5,2,FMN 19 Binnensingel Oostkant
666,R10 414,2022-12-17,05:00:00,7,6,1,FMN 19 Binnensingel Oostkant
666,R10 414,2022-12-17,06:00:00,7,4,3,FMN 19 Binnensingel Oostkant
666,R10 414,2022-12-17,07:00:00,10,7,3,FMN 19 Binnensingel Oostkant
666,R10 414,2022-12-17,08:00:00,15,13,2,FMN 19 Binnensingel Oostkant
666,R10 414,2022-12-17,09:00:00,21,17,4,FMN 19 Binnensingel Oostkant
666,R10 414,2022-12-17,10:00:00,30,27,3,FMN 19 Binnensingel Oostkant
666,R10 414,2022-12-17,11:00:00,29,25,4,FMN 19 Binnensingel Oostkant
666,R10 414,2022-12-17,12:00:00,39,32,7,FMN 19 Binnensingel Oostkant
666,R10 414,2022-12-17,13:00:00,38,31,7,FMN 19 Binnensingel Oostkant
666,R10 414,2022-12-17,14:00:00,40,32,8,FMN 19 Binnensingel Oostkant
666,R10 414,2022-12-17,15:00:00,39,31,8,FMN 19 Binnensingel Oostkant
666,R10 414,2022-12-17,16:00:00,42,36,6,FMN 19 Binnensingel Oostkant
666,R10 414,2022-12-17,17:00:00,48,41,7,FMN 19 Binnensingel Oostkant
666,R10 414,2022-12-17,18:00:00,43,39,4,FMN 19 Binnensingel Oostkant
666,R10 414,2022-12-17,19:00:00,36,30,6,FMN 19 Binnensingel Oostkant
666,R10 414,2022-12-17,20:00:00,26,22,4,FMN 19 Binnensingel Oostkant
666,R10 414,2022-12-17,21:00:00,22,18,4,FMN 19 Binnensingel Oostkant
666,R10 414,2022-12-17,22:00:00,30,26,4,FMN 19 Binnensingel Oostkant
666,R10 414,2022-12-17,23:00:00,16,13,3,FMN 19 Binnensingel Oostkant
666,R10 414,2022-12-18,00:00:00,23,19,4,FMN 19 Binnensingel Oostkant
666,R10 414,2022-12-18,01:00:00,11,7,4,FMN 19 Binnensingel Oostkant
666,R10 414,2022-12-18,02:00:00,8,7,1,FMN 19 Binnensingel Oostkant
666,R10 414,2022-12-18,03:00:00,11,8,3,FMN 19 Binnensingel Oostkant
666,R10 414,2022-12-18,04:00:00,5,3,2,FMN 19 Binnensingel Oostkant
666,R10 414,2022-12-18,05:00:00,6,3,3,FMN 19 Binnensingel Oostkant
666,R10 414,2022-12-18,06:00:00,3,2,1,FMN 19 Binnensingel Oostkant
666,R10 414,2022-12-18,07:00:00,7,4,3,FMN 19 Binnensingel Oostkant
666,R10 414,2022-12-18,08:00:00,11,8,3,FMN 19 Binnensingel Oostkant
666,R10 414,2022-12-18,09:00:00,21,15,6,FMN 19 Binnensingel Oostkant
666,R10 414,2022-12-18,10:00:00,29,21,8,FMN 19 Binnensingel Oostkant
666,R10 414,2022-12-18,11:00:00,39,31,8,FMN 19 Binnensingel Oostkant
666,R10 414,2022-12-18,12:00:00,38,30,8,FMN 19 Binnensingel Oostkant
666,R10 414,2022-12-18,13:00:00,54,39,15,FMN 19 Binnensingel Oostkant
666,R10 414,2022-12-18,14:00:00,49,35,14,FMN 19 Binnensingel Oostkant
666,R10 414,2022-12-18,15:00:00,53,32,21,FMN 19 Binnensingel Oostkant
666,R10 414,2022-12-18,16:00:00,49,37,12,FMN 19 Binnensingel Oostkant
666,R10 414,2022-12-18,17:00:00,54,39,15,FMN 19 Binnensingel Oostkant
666,R10 414,2022-12-18,18:00:00,30,20,10,FMN 19 Binnensingel Oostkant
666,R10 414,2022-12-18,19:00:00,33,25,8,FMN 19 Binnensingel Oostkant
666,R10 414,2022-12-18,20:00:00,27,20,7,FMN 19 Binnensingel Oostkant
666,R10 414,2022-12-18,21:00:00,18,13,5,FMN 19 Binnensingel Oostkant
666,R10 414,2022-12-18,22:00:00,20,13,7,FMN 19 Binnensingel Oostkant
666,R10 414,2022-12-18,23:00:00,12,9,3,FMN 19 Binnensingel Oostkant
666,R10 414,2022-12-19,00:00:00,5,4,1,FMN 19 Binnensingel Oostkant
666,R10 414,2022-12-19,01:00:00,5,4,1,FMN 19 Binnensingel Oostkant
666,R10 414,2022-12-19,02:00:00,6,5,1,FMN 19 Binnensingel Oostkant
666,R10 414,2022-12-19,03:00:00,3,1,2,FMN 19 Binnensingel Oostkant
666,R10 414,2022-12-19,04:00:00,11,6,5,FMN 19 Binnensingel Oostkant
666,R10 414,2022-12-19,05:00:00,22,12,10,FMN 19 Binnensingel Oostkant
666,R10 414,2022-12-19,06:00:00,44,30,14,FMN 19 Binnensingel Oostkant
666,R10 414,2022-12-19,07:00:00,124,85,39,FMN 19 Binnensingel Oostkant
666,R10 414,2022-12-19,08:00:00,128,78,50,FMN 19 Binnensingel Oostkant
666,R10 414,2022-12-19,09:00:00,53,34,19,FMN 19 Binnensingel Oostkant
666,R10 414,2022-12-19,10:00:00,62,42,20,FMN 19 Binnensingel Oostkant
666,R10 414,2022-12-19,11:00:00,70,57,13,FMN 19 Binnensingel Oostkant
666,R10 414,2022-12-19,12:00:00,110,86,24,FMN 19 Binnensingel Oostkant
666,R10 414,2022-12-19,13:00:00,110,77,33,FMN 19 Binnensingel Oostkant
666,R10 414,2022-12-19,14:00:00,87,70,17,FMN 19 Binnensingel Oostkant
666,R10 414,2022-12-19,15:00:00,155,128,27,FMN 19 Binnensingel Oostkant
666,R10 414,2022-12-19,16:00:00,251,208,43,FMN 19 Binnensingel Oostkant
666,R10 414,2022-12-19,17:00:00,205,163,42,FMN 19 Binnensingel Oostkant
666,R10 414,2022-12-19,18:00:00,153,121,32,FMN 19 Binnensingel Oostkant
666,R10 414,2022-12-19,19:00:00,78,55,23,FMN 19 Binnensingel Oostkant
666,R10 414,2022-12-19,20:00:00,57,46,11,FMN 19 Binnensingel Oostkant
666,R10 414,2022-12-19,21:00:00,51,46,5,FMN 19 Binnensingel Oostkant
666,R10 414,2022-12-19,22:00:00,63,50,13,FMN 19 Binnensingel Oostkant
666,R10 414,2022-12-19,23:00:00,21,16,5,FMN 19 Binnensingel Oostkant
666,R10 414,2022-12-20,00:00:00,4,3,1,FMN 19 Binnensingel Oostkant
666,R10 414,2022-12-20,01:00:00,2,2,0,FMN 19 Binnensingel Oostkant
666,R10 414,2022-12-20,02:00:00,5,2,3,FMN 19 Binnensingel Oostkant
666,R10 414,2022-12-20,03:00:00,3,1,2,FMN 19 Binnensingel Oostkant
666,R10 414,2022-12-20,04:00:00,18,8,10,FMN 19 Binnensingel Oostkant
666,R10 414,2022-12-20,05:00:00,21,10,11,FMN 19 Binnensingel Oostkant
666,R10 414,2022-12-20,06:00:00,53,33,20,FMN 19 Binnensingel Oostkant
666,R10 414,2022-12-20,07:00:00,168,114,54,FMN 19 Binnensingel Oostkant
666,R10 414,2022-12-20,08:00:00,197,129,68,FMN 19 Binnensingel Oostkant
666,R10 414,2022-12-20,09:00:00,78,50,28,FMN 19 Binnensingel Oostkant
666,R10 414,2022-12-20,10:00:00,54,36,18,FMN 19 Binnensingel Oostkant
666,R10 414,2022-12-20,11:00:00,64,48,16,FMN 19 Binnensingel Oostkant
666,R10 414,2022-12-20,12:00:00,100,71,29,FMN 19 Binnensingel Oostkant
666,R10 414,2022-12-20,13:00:00,107,77,30,FMN 19 Binnensingel Oostkant
666,R10 414,2022-12-20,14:00:00,76,56,20,FMN 19 Binnensingel Oostkant
666,R10 414,2022-12-20,15:00:00,153,133,20,FMN 19 Binnensingel Oostkant
666,R10 414,2022-12-20,16:00:00,227,180,47,FMN 19 Binnensingel Oostkant
666,R10 414,2022-12-20,17:00:00,219,167,52,FMN 19 Binnensingel Oostkant
666,R10 414,2022-12-20,18:00:00,192,150,42,FMN 19 Binnensingel Oostkant
666,R10 414,2022-12-20,19:00:00,74,56,18,FMN 19 Binnensingel Oostkant
666,R10 414,2022-12-20,20:00:00,65,49,16,FMN 19 Binnensingel Oostkant
666,R10 414,2022-12-20,21:00:00,68,55,13,FMN 19 Binnensingel Oostkant
666,R10 414,2022-12-20,22:00:00,54,41,13,FMN 19 Binnensingel Oostkant
666,R10 414,2022-12-20,23:00:00,28,23,5,FMN 19 Binnensingel Oostkant
666,R10 414,2022-12-21,00:00:00,0,0,0,FMN 19 Binnensingel Oostkant
666,R10 414,2022-12-21,01:00:00,0,0,0,FMN 19 Binnensingel Oostkant
666,R10 414,2022-12-21,02:00:00,0,0,0,FMN 19 Binnensingel Oostkant
666,R10 414,2022-12-21,03:00:00,0,0,0,FMN 19 Binnensingel Oostkant
666,R10 414,2022-12-21,04:00:00,0,0,0,FMN 19 Binnensingel Oostkant
666,R10 414,2022-12-21,05:00:00,0,0,0,FMN 19 Binnensingel Oostkant
666,R10 414,2022-12-21,06:00:00,0,0,0,FMN 19 Binnensingel Oostkant
666,R10 414,2022-12-21,07:00:00,0,0,0,FMN 19 Binnensingel Oostkant
666,R10 414,2022-12-21,08:00:00,0,0,0,FMN 19 Binnensingel Oostkant
666,R10 414,2022-12-21,09:00:00,6,4,2,FMN 19 Binnensingel Oostkant
666,R10 414,2022-12-21,10:00:00,51,35,16,FMN 19 Binnensingel Oostkant
666,R10 414,2022-12-21,11:00:00,73,55,18,FMN 19 Binnensingel Oostkant
666,R10 414,2022-12-21,12:00:00,85,65,20,FMN 19 Binnensingel Oostkant
666,R10 414,2022-12-21,13:00:00,101,82,19,FMN 19 Binnensingel Oostkant
666,R10 414,2022-12-21,14:00:00,66,51,15,FMN 19 Binnensingel Oostkant
666,R10 414,2022-12-21,15:00:00,91,72,19,FMN 19 Binnensingel Oostkant
666,R10 414,2022-12-21,16:00:00,143,126,17,FMN 19 Binnensingel Oostkant
666,R10 414,2022-12-21,17:00:00,146,112,34,FMN 19 Binnensingel Oostkant
666,R10 414,2022-12-21,18:00:00,115,85,30,FMN 19 Binnensingel Oostkant
666,R10 414,2022-12-21,19:00:00,74,58,16,FMN 19 Binnensingel Oostkant
666,R10 414,2022-12-21,20:00:00,38,30,8,FMN 19 Binnensingel Oostkant
666,R10 414,2022-12-21,21:00:00,69,61,8,FMN 19 Binnensingel Oostkant
666,R10 414,2022-12-21,22:00:00,40,37,3,FMN 19 Binnensingel Oostkant
666,R10 414,2022-12-21,23:00:00,26,20,6,FMN 19 Binnensingel Oostkant
666,R10 414,2022-12-22,00:00:00,11,6,5,FMN 19 Binnensingel Oostkant
666,R10 414,2022-12-22,01:00:00,5,5,0,FMN 19 Binnensingel Oostkant
666,R10 414,2022-12-22,02:00:00,6,6,0,FMN 19 Binnensingel Oostkant
666,R10 414,2022-12-22,03:00:00,6,5,1,FMN 19 Binnensingel Oostkant
666,R10 414,2022-12-22,04:00:00,15,7,8,FMN 19 Binnensingel Oostkant
666,R10 414,2022-12-22,05:00:00,18,10,8,FMN 19 Binnensingel Oostkant
666,R10 414,2022-12-22,06:00:00,32,18,14,FMN 19 Binnensingel Oostkant
666,R10 414,2022-12-22,07:00:00,98,61,37,FMN 19 Binnensingel Oostkant
666,R10 414,2022-12-22,08:00:00,133,88,45,FMN 19 Binnensingel Oostkant
666,R10 414,2022-12-22,09:00:00,58,40,18,FMN 19 Binnensingel Oostkant
666,R10 414,2022-12-22,10:00:00,63,49,14,FMN 19 Binnensingel Oostkant
666,R10 414,2022-12-22,11:00:00,52,45,7,FMN 19 Binnensingel Oostkant
666,R10 414,2022-12-22,12:00:00,77,57,20,FMN 19 Binnensingel Oostkant
666,R10 414,2022-12-22,13:00:00,76,51,25,FMN 19 Binnensingel Oostkant
666,R10 414,2022-12-22,14:00:00,95,78,17,FMN 19 Binnensingel Oostkant
666,R10 414,2022-12-22,15:00:00,101,74,27,FMN 19 Binnensingel Oostkant
666,R10 414,2022-12-22,16:00:00,146,121,25,FMN 19 Binnensingel Oostkant
666,R10 414,2022-12-22,17:00:00,150,117,33,FMN 19 Binnensingel Oostkant
666,R10 414,2022-12-22,18:00:00,133,107,26,FMN 19 Binnensingel Oostkant
666,R10 414,2022-12-22,19:00:00,79,55,24,FMN 19 Binnensingel Oostkant
666,R10 414,2022-12-22,20:00:00,71,54,17,FMN 19 Binnensingel Oostkant
666,R10 414,2022-12-22,21:00:00,61,48,13,FMN 19 Binnensingel Oostkant
666,R10 414,2022-12-22,22:00:00,47,33,14,FMN 19 Binnensingel Oostkant
666,R10 414,2022-12-22,23:00:00,30,26,4,FMN 19 Binnensingel Oostkant
666,R10 414,2022-12-23,00:00:00,28,22,6,FMN 19 Binnensingel Oostkant
666,R10 414,2022-12-23,01:00:00,17,16,1,FMN 19 Binnensingel Oostkant
666,R10 414,2022-12-23,02:00:00,7,6,1,FMN 19 Binnensingel Oostkant
666,R10 414,2022-12-23,03:00:00,10,10,0,FMN 19 Binnensingel Oostkant
666,R10 414,2022-12-23,04:00:00,11,4,7,FMN 19 Binnensingel Oostkant
666,R10 414,2022-12-23,05:00:00,23,15,8,FMN 19 Binnensingel Oostkant
666,R10 414,2022-12-23,06:00:00,41,33,8,FMN 19 Binnensingel Oostkant
666,R10 414,2022-12-23,07:00:00,79,52,27,FMN 19 Binnensingel Oostkant
666,R10 414,2022-12-23,08:00:00,105,79,26,FMN 19 Binnensingel Oostkant
666,R10 414,2022-12-23,09:00:00,54,37,17,FMN 19 Binnensingel Oostkant
666,R10 414,2022-12-23,10:00:00,55,45,10,FMN 19 Binnensingel Oostkant
666,R10 414,2022-12-23,11:00:00,56,41,15,FMN 19 Binnensingel Oostkant
666,R10 414,2022-12-23,12:00:00,53,41,12,FMN 19 Binnensingel Oostkant
666,R10 414,2022-12-23,13:00:00,53,36,17,FMN 19 Binnensingel Oostkant
666,R10 414,2022-12-23,14:00:00,64,55,9,FMN 19 Binnensingel Oostkant
666,R10 414,2022-12-23,15:00:00,81,61,20,FMN 19 Binnensingel Oostkant
666,R10 414,2022-12-23,16:00:00,112,92,20,FMN 19 Binnensingel Oostkant
666,R10 414,2022-12-23,17:00:00,142,107,35,FMN 19 Binnensingel Oostkant
666,R10 414,2022-12-23,18:00:00,84,62,22,FMN 19 Binnensingel Oostkant
666,R10 414,2022-12-23,19:00:00,70,54,16,FMN 19 Binnensingel Oostkant
666,R10 414,2022-12-23,20:00:00,0,0,0,FMN 19 Binnensingel Oostkant
666,R10 414,2022-12-23,21:00:00,0,0,0,FMN 19 Binnensingel Oostkant
666,R10 414,2022-12-23,22:00:00,0,0,0,FMN 19 Binnensingel Oostkant
666,R10 414,2022-12-23,23:00:00,0,0,0,FMN 19 Binnensingel Oostkant
666,R10 414,2022-12-24,00:00:00,13,12,1,FMN 19 Binnensingel Oostkant
666,R10 414,2022-12-24,01:00:00,8,8,0,FMN 19 Binnensingel Oostkant
666,R10 414,2022-12-24,02:00:00,6,5,1,FMN 19 Binnensingel Oostkant
666,R10 414,2022-12-24,03:00:00,6,5,1,FMN 19 Binnensingel Oostkant
666,R10 414,2022-12-24,04:00:00,5,4,1,FMN 19 Binnensingel Oostkant
666,R10 414,2022-12-24,05:00:00,6,5,1,FMN 19 Binnensingel Oostkant
666,R10 414,2022-12-24,06:00:00,6,4,2,FMN 19 Binnensingel Oostkant
666,R10 414,2022-12-24,07:00:00,10,7,3,FMN 19 Binnensingel Oostkant
666,R10 414,2022-12-24,08:00:00,13,12,1,FMN 19 Binnensingel Oostkant
666,R10 414,2022-12-24,09:00:00,20,16,4,FMN 19 Binnensingel Oostkant
666,R10 414,2022-12-24,10:00:00,27,25,2,FMN 19 Binnensingel Oostkant
666,R10 414,2022-12-24,11:00:00,25,22,3,FMN 19 Binnensingel Oostkant
666,R10 414,2022-12-24,12:00:00,35,30,5,FMN 19 Binnensingel Oostkant
666,R10 414,2022-12-24,13:00:00,33,28,5,FMN 19 Binnensingel Oostkant
666,R10 414,2022-12-24,14:00:00,36,30,6,FMN 19 Binnensingel Oostkant
666,R10 414,2022-12-24,15:00:00,35,29,6,FMN 19 Binnensingel Oostkant
666,R10 414,2022-12-24,16:00:00,38,33,5,FMN 19 Binnensingel Oostkant
666,R10 414,2022-12-24,17:00:00,43,38,5,FMN 19 Binnensingel Oostkant
666,R10 414,2022-12-24,18:00:00,39,36,3,FMN 19 Binnensingel Oostkant
666,R10 414,2022-12-24,19:00:00,32,27,5,FMN 19 Binnensingel Oostkant
666,R10 414,2022-12-24,20:00:00,23,20,3,FMN 19 Binnensingel Oostkant
666,R10 414,2022-12-24,21:00:00,20,17,3,FMN 19 Binnensingel Oostkant
666,R10 414,2022-12-24,22:00:00,27,24,3,FMN 19 Binnensingel Oostkant
666,R10 414,2022-12-24,23:00:00,14,12,2,FMN 19 Binnensingel Oostkant
666,R10 414,2022-12-25,00:00:00,25,20,5,FMN 19 Binnensingel Oostkant
666,R10 414,2022-12-25,01:00:00,11,8,3,FMN 19 Binnensingel Oostkant
666,R10 414,2022-12-25,02:00:00,9,7,2,FMN 19 Binnensingel Oostkant
666,R10 414,2022-12-25,03:00:00,11,9,2,FMN 19 Binnensingel Oostkant
666,R10 414,2022-12-25,04:00:00,6,3,3,FMN 19 Binnensingel Oostkant
666,R10 414,2022-12-25,05:00:00,7,4,3,FMN 19 Binnensingel Oostkant
666,R10 414,2022-12-25,06:00:00,3,1,2,FMN 19 Binnensingel Oostkant
666,R10 414,2022-12-25,07:00:00,7,5,2,FMN 19 Binnensingel Oostkant
666,R10 414,2022-12-25,08:00:00,12,8,4,FMN 19 Binnensingel Oostkant
666,R10 414,2022-12-25,09:00:00,22,16,6,FMN 19 Binnensingel Oostkant
666,R10 414,2022-12-25,10:00:00,31,23,8,FMN 19 Binnensingel Oostkant
666,R10 414,2022-12-25,11:00:00,42,33,9,FMN 19 Binnensingel Oostkant
666,R10 414,2022-12-25,12:00:00,41,32,9,FMN 19 Binnensingel Oostkant
666,R10 414,2022-12-25,13:00:00,57,42,15,FMN 19 Binnensingel Oostkant
666,R10 414,2022-12-25,14:00:00,52,37,15,FMN 19 Binnensingel Oostkant
666,R10 414,2022-12-25,15:00:00,56,34,22,FMN 19 Binnensingel Oostkant
666,R10 414,2022-12-25,16:00:00,54,40,14,FMN 19 Binnensingel Oostkant
666,R10 414,2022-12-25,17:00:00,56,41,15,FMN 19 Binnensingel Oostkant
666,R10 414,2022-12-25,18:00:00,32,21,11,FMN 19 Binnensingel Oostkant
666,R10 414,2022-12-25,19:00:00,35,27,8,FMN 19 Binnensingel Oostkant
666,R10 414,2022-12-25,20:00:00,30,22,8,FMN 19 Binnensingel Oostkant
666,R10 414,2022-12-25,21:00:00,18,13,5,FMN 19 Binnensingel Oostkant
666,R10 414,2022-12-25,22:00:00,23,15,8,FMN 19 Binnensingel Oostkant
666,R10 414,2022-12-25,23:00:00,12,9,3,FMN 19 Binnensingel Oostkant
666,R10 414,2022-12-26,00:00:00,5,4,1,FMN 19 Binnensingel Oostkant
666,R10 414,2022-12-26,01:00:00,5,4,1,FMN 19 Binnensingel Oostkant
666,R10 414,2022-12-26,02:00:00,6,5,1,FMN 19 Binnensingel Oostkant
666,R10 414,2022-12-26,03:00:00,3,1,2,FMN 19 Binnensingel Oostkant
666,R10 414,2022-12-26,04:00:00,12,6,6,FMN 19 Binnensingel Oostkant
666,R10 414,2022-12-26,05:00:00,21,12,9,FMN 19 Binnensingel Oostkant
666,R10 414,2022-12-26,06:00:00,46,31,15,FMN 19 Binnensingel Oostkant
666,R10 414,2022-12-26,07:00:00,126,85,41,FMN 19 Binnensingel Oostkant
666,R10 414,2022-12-26,08:00:00,130,79,51,FMN 19 Binnensingel Oostkant
666,R10 414,2022-12-26,09:00:00,55,35,20,FMN 19 Binnensingel Oostkant
666,R10 414,2022-12-26,10:00:00,62,42,20,FMN 19 Binnensingel Oostkant
666,R10 414,2022-12-26,11:00:00,71,57,14,FMN 19 Binnensingel Oostkant
666,R10 414,2022-12-26,12:00:00,111,86,25,FMN 19 Binnensingel Oostkant
666,R10 414,2022-12-26,13:00:00,113,79,34,FMN 19 Binnensingel Oostkant
666,R10 414,2022-12-26,14:00:00,87,70,17,FMN 19 Binnensingel Oostkant
666,R10 414,2022-12-26,15:00:00,157,129,28,FMN 19 Binnensingel Oostkant
666,R10 414,2022-12-26,16:00:00,254,210,44,FMN 19 Binnensingel Oostkant
666,R10 414,2022-12-26,17:00:00,208,164,44,FMN 19 Binnensingel Oostkant
666,R10 414,2022-12-26,18:00:00,157,123,34,FMN 19 Binnensingel Oostkant
666,R10 414,2022-12-26,19:00:00,78,55,23,FMN 19 Binnensingel Oostkant
666,R10 414,2022-12-26,20:00:00,57,46,11,FMN 19 Binnensingel Oostkant
666,R10 414,2022-12-26,21:00:00,52,46,6,FMN 19 Binnensingel Oostkant
666,R10 414,2022-12-26,22:00:00,64,51,13,FMN 19 Binnensingel Oostkant
666,R10 414,2022-12-26,23:00:00,21,16,5,FMN 19 Binnensingel Oostkant
666,R10 414,2022-12-27,00:00:00,4,3,1,FMN 19 Binnensingel Oostkant
666,R10 414,2022-12-27,01:00:00,2,2,0,FMN 19 Binnensingel Oostkant
666,R10 414,2022-12-27,02:00:00,5,2,3,FMN 19 Binnensingel Oostkant
666,R10 414,2022-12-27,03:00:00,3,1,2,FMN 19 Binnensingel Oostkant
666,R10 414,2022-12-27,04:00:00,17,7,10,FMN 19 Binnensingel Oostkant
666,R10 414,2022-12-27,05:00:00,22,11,11,FMN 19 Binnensingel Oostkant
666,R10 414,2022-12-27,06:00:00,53,33,20,FMN 19 Binnensingel Oostkant
666,R10 414,2022-12-27,07:00:00,166,113,53,FMN 19 Binnensingel Oostkant
666,R10 414,2022-12-27,08:00:00,197,129,68,FMN 19 Binnensingel Oostkant
666,R10 414,2022-12-27,09:00:00,77,49,28,FMN 19 Binnensingel Oostkant
666,R10 414,2022-12-27,10:00:00,54,36,18,FMN 19 Binnensingel Oostkant
666,R10 414,2022-12-27,11:00:00,64,48,16,FMN 19 Binnensingel Oostkant
666,R10 414,2022-12-27,12:00:00,98,70,28,FMN 19 Binnensingel Oostkant
666,R10 414,2022-12-27,13:00:00,107,77,30,FMN 19 Binnensingel Oostkant
666,R10 414,2022-12-27,14:00:00,77,56,21,FMN 19 Binnensingel Oostkant
666,R10 414,2022-12-27,15:00:00,150,131,19,FMN 19 Binnensingel Oostkant
666,R10 414,2022-12-27,16:00:00,227,180,47,FMN 19 Binnensingel Oostkant
666,R10 414,2022-12-27,17:00:00,218,166,52,FMN 19 Binnensingel Oostkant
666,R10 414,2022-12-27,18:00:00,191,150,41,FMN 19 Binnensingel Oostkant
666,R10 414,2022-12-27,19:00:00,73,55,18,FMN 19 Binnensingel Oostkant
666,R10 414,2022-12-27,20:00:00,65,49,16,FMN 19 Binnensingel Oostkant
666,R10 414,2022-12-27,21:00:00,68,54,14,FMN 19 Binnensingel Oostkant
666,R10 414,2022-12-27,22:00:00,53,41,12,FMN 19 Binnensingel Oostkant
666,R10 414,2022-12-27,23:00:00,28,23,5,FMN 19 Binnensingel Oostkant
666,R10 414,2022-12-29,00:00:00,6,4,2,FMN 19 Binnensingel Oostkant
666,R10 414,2022-12-29,01:00:00,5,4,1,FMN 19 Binnensingel Oostkant
666,R10 414,2022-12-29,02:00:00,2,2,0,FMN 19 Binnensingel Oostkant
666,R10 414,2022-12-29,03:00:00,5,3,2,FMN 19 Binnensingel Oostkant
666,R10 414,2022-12-29,04:00:00,10,5,5,FMN 19 Binnensingel Oostkant
666,R10 414,2022-12-29,05:00:00,15,9,6,FMN 19 Binnensingel Oostkant
666,R10 414,2022-12-29,06:00:00,28,18,10,FMN 19 Binnensingel Oostkant
666,R10 414,2022-12-29,07:00:00,83,55,28,FMN 19 Binnensingel Oostkant
666,R10 414,2022-12-29,08:00:00,110,74,36,FMN 19 Binnensingel Oostkant
666,R10 414,2022-12-29,09:00:00,43,29,14,FMN 19 Binnensingel Oostkant
666,R10 414,2022-12-29,10:00:00,41,28,13,FMN 19 Binnensingel Oostkant
666,R10 414,2022-12-29,11:00:00,38,30,8,FMN 19 Binnensingel Oostkant
666,R10 414,2022-12-29,12:00:00,66,52,14,FMN 19 Binnensingel Oostkant
666,R10 414,2022-12-29,13:00:00,57,43,14,FMN 19 Binnensingel Oostkant
666,R10 414,2022-12-29,14:00:00,49,40,9,FMN 19 Binnensingel Oostkant
666,R10 414,2022-12-29,15:00:00,87,72,15,FMN 19 Binnensingel Oostkant
666,R10 414,2022-12-29,16:00:00,131,104,27,FMN 19 Binnensingel Oostkant
666,R10 414,2022-12-29,17:00:00,134,106,28,FMN 19 Binnensingel Oostkant
666,R10 414,2022-12-29,18:00:00,104,79,25,FMN 19 Binnensingel Oostkant
666,R10 414,2022-12-29,19:00:00,57,42,15,FMN 19 Binnensingel Oostkant
666,R10 414,2022-12-29,20:00:00,46,34,12,FMN 19 Binnensingel Oostkant
666,R10 414,2022-12-29,21:00:00,45,37,8,FMN 19 Binnensingel Oostkant
666,R10 414,2022-12-29,22:00:00,39,30,9,FMN 19 Binnensingel Oostkant
666,R10 414,2022-12-29,23:00:00,24,19,5,FMN 19 Binnensingel Oostkant
666,R10 414,2022-12-30,00:00:00,23,15,8,FMN 19 Binnensingel Oostkant
666,R10 414,2022-12-30,01:00:00,15,11,4,FMN 19 Binnensingel Oostkant
666,R10 414,2022-12-30,02:00:00,11,8,3,FMN 19 Binnensingel Oostkant
666,R10 414,2022-12-30,03:00:00,12,9,3,FMN 19 Binnensingel Oostkant
666,R10 414,2022-12-30,04:00:00,17,10,7,FMN 19 Binnensingel Oostkant
666,R10 414,2022-12-30,05:00:00,19,12,7,FMN 19 Binnensingel Oostkant
666,R10 414,2022-12-30,06:00:00,37,26,11,FMN 19 Binnensingel Oostkant
666,R10 414,2022-12-30,07:00:00,70,48,22,FMN 19 Binnensingel Oostkant
666,R10 414,2022-12-30,08:00:00,91,64,27,FMN 19 Binnensingel Oostkant
666,R10 414,2022-12-30,09:00:00,52,38,14,FMN 19 Binnensingel Oostkant
666,R10 414,2022-12-30,10:00:00,50,38,12,FMN 19 Binnensingel Oostkant
666,R10 414,2022-12-30,11:00:00,53,40,13,FMN 19 Binnensingel Oostkant
666,R10 414,2022-12-30,12:00:00,67,51,16,FMN 19 Binnensingel Oostkant
666,R10 414,2022-12-30,13:00:00,71,49,22,FMN 19 Binnensingel Oostkant
666,R10 414,2022-12-30,14:00:00,76,60,16,FMN 19 Binnensingel Oostkant
666,R10 414,2022-12-30,15:00:00,100,82,18,FMN 19 Binnensingel Oostkant
666,R10 414,2022-12-30,16:00:00,137,118,19,FMN 19 Binnensingel Oostkant
666,R10 414,2022-12-30,17:00:00,125,94,31,FMN 19 Binnensingel Oostkant
666,R10 414,2022-12-30,18:00:00,86,68,18,FMN 19 Binnensingel Oostkant
666,R10 414,2022-12-30,19:00:00,68,52,16,FMN 19 Binnensingel Oostkant
666,R10 414,2022-12-30,20:00:00,34,25,9,FMN 19 Binnensingel Oostkant
666,R10 414,2022-12-30,21:00:00,30,26,4,FMN 19 Binnensingel Oostkant
666,R10 414,2022-12-30,22:00:00,27,21,6,FMN 19 Binnensingel Oostkant
666,R10 414,2022-12-30,23:00:00,24,18,6,FMN 19 Binnensingel Oostkant
666,R10 414,2022-12-31,00:00:00,9,9,0,FMN 19 Binnensingel Oostkant
666,R10 414,2022-12-31,01:00:00,6,6,0,FMN 19 Binnensingel Oostkant
666,R10 414,2022-12-31,02:00:00,4,4,0,FMN 19 Binnensingel Oostkant
666,R10 414,2022-12-31,03:00:00,5,4,1,FMN 19 Binnensingel Oostkant
666,R10 414,2022-12-31,04:00:00,4,4,0,FMN 19 Binnensingel Oostkant
666,R10 414,2022-12-31,05:00:00,4,4,0,FMN 19 Binnensingel Oostkant
666,R10 414,2022-12-31,06:00:00,3,3,0,FMN 19 Binnensingel Oostkant
666,R10 414,2022-12-31,07:00:00,6,5,1,FMN 19 Binnensingel Oostkant
666,R10 414,2022-12-31,08:00:00,9,9,0,FMN 19 Binnensingel Oostkant
666,R10 414,2022-12-31,09:00:00,12,12,0,FMN 19 Binnensingel Oostkant
666,R10 414,2022-12-31,10:00:00,21,20,1,FMN 19 Binnensingel Oostkant
666,R10 414,2022-12-31,11:00:00,18,18,0,FMN 19 Binnensingel Oostkant
666,R10 414,2022-12-31,12:00:00,24,23,1,FMN 19 Binnensingel Oostkant
666,R10 414,2022-12-31,13:00:00,23,22,1,FMN 19 Binnensingel Oostkant
666,R10 414,2022-12-31,14:00:00,24,23,1,FMN 19 Binnensingel Oostkant
666,R10 414,2022-12-31,15:00:00,24,23,1,FMN 19 Binnensingel Oostkant
666,R10 414,2022-12-31,16:00:00,26,25,1,FMN 19 Binnensingel Oostkant
666,R10 414,2022-12-31,17:00:00,31,30,1,FMN 19 Binnensingel Oostkant
666,R10 414,2022-12-31,18:00:00,28,28,0,FMN 19 Binnensingel Oostkant
666,R10 414,2022-12-31,19:00:00,22,21,1,FMN 19 Binnensingel Oostkant
666,R10 414,2022-12-31,20:00:00,17,16,1,FMN 19 Binnensingel Oostkant
666,R10 414,2022-12-31,21:00:00,13,13,0,FMN 19 Binnensingel Oostkant
666,R10 414,2022-12-31,22:00:00,20,19,1,FMN 19 Binnensingel Oostkant
666,R10 414,2022-12-31,23:00:00,9,9,0,FMN 19 Binnensingel Oostkant
666,R10 414,2023-01-01,00:00:00,22,16,6,FMN 19 Binnensingel Oostkant
666,R10 414,2023-01-01,01:00:00,11,8,3,FMN 19 Binnensingel Oostkant
666,R10 414,2023-01-01,02:00:00,8,6,2,FMN 19 Binnensingel Oostkant
666,R10 414,2023-01-01,03:00:00,9,7,2,FMN 19 Binnensingel Oostkant
666,R10 414,2023-01-01,04:00:00,9,6,3,FMN 19 Binnensingel Oostkant
666,R10 414,2023-01-01,05:00:00,8,5,3,FMN 19 Binnensingel Oostkant
666,R10 414,2023-01-01,06:00:00,6,4,2,FMN 19 Binnensingel Oostkant
666,R10 414,2023-01-01,07:00:00,9,6,3,FMN 19 Binnensingel Oostkant
666,R10 414,2023-01-01,08:00:00,13,9,4,FMN 19 Binnensingel Oostkant
666,R10 414,2023-01-01,09:00:00,26,18,8,FMN 19 Binnensingel Oostkant
666,R10 414,2023-01-01,10:00:00,32,25,7,FMN 19 Binnensingel Oostkant
666,R10 414,2023-01-01,11:00:00,41,32,9,FMN 19 Binnensingel Oostkant
666,R10 414,2023-01-01,12:00:00,44,35,9,FMN 19 Binnensingel Oostkant
666,R10 414,2023-01-01,13:00:00,58,43,15,FMN 19 Binnensingel Oostkant
666,R10 414,2023-01-01,14:00:00,48,35,13,FMN 19 Binnensingel Oostkant
666,R10 414,2023-01-01,15:00:00,52,34,18,FMN 19 Binnensingel Oostkant
666,R10 414,2023-01-01,16:00:00,50,38,12,FMN 19 Binnensingel Oostkant
666,R10 414,2023-01-01,17:00:00,46,35,11,FMN 19 Binnensingel Oostkant
666,R10 414,2023-01-01,18:00:00,41,30,11,FMN 19 Binnensingel Oostkant
666,R10 414,2023-01-01,19:00:00,33,24,9,FMN 19 Binnensingel Oostkant
666,R10 414,2023-01-01,20:00:00,27,18,9,FMN 19 Binnensingel Oostkant
666,R10 414,2023-01-01,21:00:00,21,15,6,FMN 19 Binnensingel Oostkant
666,R10 414,2023-01-01,22:00:00,21,15,6,FMN 19 Binnensingel Oostkant
666,R10 414,2023-01-01,23:00:00,12,9,3,FMN 19 Binnensingel Oostkant
666,R10 414,2023-01-02,00:00:00,5,4,1,FMN 19 Binnensingel Oostkant
666,R10 414,2023-01-02,01:00:00,4,3,1,FMN 19 Binnensingel Oostkant
666,R10 414,2023-01-02,02:00:00,3,3,0,FMN 19 Binnensingel Oostkant
666,R10 414,2023-01-02,03:00:00,6,3,3,FMN 19 Binnensingel Oostkant
666,R10 414,2023-01-02,04:00:00,15,8,7,FMN 19 Binnensingel Oostkant
666,R10 414,2023-01-02,05:00:00,25,12,13,FMN 19 Binnensingel Oostkant
666,R10 414,2023-01-02,06:00:00,48,32,16,FMN 19 Binnensingel Oostkant
666,R10 414,2023-01-02,07:00:00,131,88,43,FMN 19 Binnensingel Oostkant
666,R10 414,2023-01-02,08:00:00,149,97,52,FMN 19 Binnensingel Oostkant
666,R10 414,2023-01-02,09:00:00,59,37,22,FMN 19 Binnensingel Oostkant
666,R10 414,2023-01-02,10:00:00,59,41,18,FMN 19 Binnensingel Oostkant
666,R10 414,2023-01-02,11:00:00,64,51,13,FMN 19 Binnensingel Oostkant
666,R10 414,2023-01-02,12:00:00,99,76,23,FMN 19 Binnensingel Oostkant
666,R10 414,2023-01-02,13:00:00,90,64,26,FMN 19 Binnensingel Oostkant
666,R10 414,2023-01-02,14:00:00,83,65,18,FMN 19 Binnensingel Oostkant
666,R10 414,2023-01-02,15:00:00,146,123,23,FMN 19 Binnensingel Oostkant
666,R10 414,2023-01-02,16:00:00,226,187,39,FMN 19 Binnensingel Oostkant
666,R10 414,2023-01-02,17:00:00,199,158,41,FMN 19 Binnensingel Oostkant
666,R10 414,2023-01-02,18:00:00,133,99,34,FMN 19 Binnensingel Oostkant
666,R10 414,2023-01-02,19:00:00,70,49,21,FMN 19 Binnensingel Oostkant
666,R10 414,2023-01-02,20:00:00,53,42,11,FMN 19 Binnensingel Oostkant
666,R10 414,2023-01-02,21:00:00,50,44,6,FMN 19 Binnensingel Oostkant
666,R10 414,2023-01-02,22:00:00,57,45,12,FMN 19 Binnensingel Oostkant
666,R10 414,2023-01-02,23:00:00,19,14,5,FMN 19 Binnensingel Oostkant
666,R10 414,2023-01-03,00:00:00,4,3,1,FMN 19 Binnensingel Oostkant
666,R10 414,2023-01-03,01:00:00,2,2,0,FMN 19 Binnensingel Oostkant
666,R10 414,2023-01-03,02:00:00,4,2,2,FMN 19 Binnensingel Oostkant
666,R10 414,2023-01-03,03:00:00,4,2,2,FMN 19 Binnensingel Oostkant
666,R10 414,2023-01-03,04:00:00,15,8,7,FMN 19 Binnensingel Oostkant
666,R10 414,2023-01-03,05:00:00,21,9,12,FMN 19 Binnensingel Oostkant
666,R10 414,2023-01-03,06:00:00,50,33,17,FMN 19 Binnensingel Oostkant
666,R10 414,2023-01-03,07:00:00,139,96,43,FMN 19 Binnensingel Oostkant
666,R10 414,2023-01-03,08:00:00,178,123,55,FMN 19 Binnensingel Oostkant
666,R10 414,2023-01-03,09:00:00,69,47,22,FMN 19 Binnensingel Oostkant
666,R10 414,2023-01-03,10:00:00,47,32,15,FMN 19 Binnensingel Oostkant
666,R10 414,2023-01-03,11:00:00,59,44,15,FMN 19 Binnensingel Oostkant
666,R10 414,2023-01-03,12:00:00,87,61,26,FMN 19 Binnensingel Oostkant
666,R10 414,2023-01-03,13:00:00,90,65,25,FMN 19 Binnensingel Oostkant
666,R10 414,2023-01-03,14:00:00,68,52,16,FMN 19 Binnensingel Oostkant
666,R10 414,2023-01-03,15:00:00,128,110,18,FMN 19 Binnensingel Oostkant
666,R10 414,2023-01-03,16:00:00,204,163,41,FMN 19 Binnensingel Oostkant
666,R10 414,2023-01-03,17:00:00,193,145,48,FMN 19 Binnensingel Oostkant
666,R10 414,2023-01-03,18:00:00,156,122,34,FMN 19 Binnensingel Oostkant
666,R10 414,2023-01-03,19:00:00,65,47,18,FMN 19 Binnensingel Oostkant
666,R10 414,2023-01-03,20:00:00,52,38,14,FMN 19 Binnensingel Oostkant
666,R10 414,2023-01-03,21:00:00,61,49,12,FMN 19 Binnensingel Oostkant
666,R10 414,2023-01-03,22:00:00,52,40,12,FMN 19 Binnensingel Oostkant
666,R10 414,2023-01-03,23:00:00,22,18,4,FMN 19 Binnensingel Oostkant
666,R10 414,2023-01-04,00:00:00,4,2,2,FMN 19 Binnensingel Oostkant
666,R10 414,2023-01-04,01:00:00,3,2,1,FMN 19 Binnensingel Oostkant
666,R10 414,2023-01-04,02:00:00,0,0,0,FMN 19 Binnensingel Oostkant
666,R10 414,2023-01-04,03:00:00,3,2,1,FMN 19 Binnensingel Oostkant
666,R10 414,2023-01-04,04:00:00,8,4,4,FMN 19 Binnensingel Oostkant
666,R10 414,2023-01-04,05:00:00,12,6,6,FMN 19 Binnensingel Oostkant
666,R10 414,2023-01-04,06:00:00,26,16,10,FMN 19 Binnensingel Oostkant
666,R10 414,2023-01-04,07:00:00,59,38,21,FMN 19 Binnensingel Oostkant
666,R10 414,2023-01-04,08:00:00,80,50,30,FMN 19 Binnensingel Oostkant
666,R10 414,2023-01-04,09:00:00,34,24,10,FMN 19 Binnensingel Oostkant
666,R10 414,2023-01-04,10:00:00,38,25,13,FMN 19 Binnensingel Oostkant
666,R10 414,2023-01-04,11:00:00,45,33,12,FMN 19 Binnensingel Oostkant
666,R10 414,2023-01-04,12:00:00,87,65,22,FMN 19 Binnensingel Oostkant
666,R10 414,2023-01-04,13:00:00,92,70,22,FMN 19 Binnensingel Oostkant
666,R10 414,2023-01-04,14:00:00,60,48,12,FMN 19 Binnensingel Oostkant
666,R10 414,2023-01-04,15:00:00,91,73,18,FMN 19 Binnensingel Oostkant
666,R10 414,2023-01-04,16:00:00,139,113,26,FMN 19 Binnensingel Oostkant
666,R10 414,2023-01-04,17:00:00,148,113,35,FMN 19 Binnensingel Oostkant
666,R10 414,2023-01-04,18:00:00,111,83,28,FMN 19 Binnensingel Oostkant
666,R10 414,2023-01-04,19:00:00,66,50,16,FMN 19 Binnensingel Oostkant
666,R10 414,2023-01-04,20:00:00,43,35,8,FMN 19 Binnensingel Oostkant
666,R10 414,2023-01-04,21:00:00,50,42,8,FMN 19 Binnensingel Oostkant
666,R10 414,2023-01-04,22:00:00,46,37,9,FMN 19 Binnensingel Oostkant
666,R10 414,2023-01-04,23:00:00,16,13,3,FMN 19 Binnensingel Oostkant
666,R10 414,2023-01-05,00:00:00,7,5,2,FMN 19 Binnensingel Oostkant
666,R10 414,2023-01-05,01:00:00,6,5,1,FMN 19 Binnensingel Oostkant
666,R10 414,2023-01-05,02:00:00,4,3,1,FMN 19 Binnensingel Oostkant
666,R10 414,2023-01-05,03:00:00,6,4,2,FMN 19 Binnensingel Oostkant
666,R10 414,2023-01-05,04:00:00,16,9,7,FMN 19 Binnensingel Oostkant
666,R10 414,2023-01-05,05:00:00,20,11,9,FMN 19 Binnensingel Oostkant
666,R10 414,2023-01-05,06:00:00,42,27,15,FMN 19 Binnensingel Oostkant
666,R10 414,2023-01-05,07:00:00,116,78,38,FMN 19 Binnensingel Oostkant
666,R10 414,2023-01-05,08:00:00,153,104,49,FMN 19 Binnensingel Oostkant
666,R10 414,2023-01-05,09:00:00,59,40,19,FMN 19 Binnensingel Oostkant
666,R10 414,2023-01-05,10:00:00,56,39,17,FMN 19 Binnensingel Oostkant
666,R10 414,2023-01-05,11:00:00,57,44,13,FMN 19 Binnensingel Oostkant
666,R10 414,2023-01-05,12:00:00,91,70,21,FMN 19 Binnensingel Oostkant
666,R10 414,2023-01-05,13:00:00,75,58,17,FMN 19 Binnensingel Oostkant
666,R10 414,2023-01-05,14:00:00,69,55,14,FMN 19 Binnensingel Oostkant
666,R10 414,2023-01-05,15:00:00,122,101,21,FMN 19 Binnensingel Oostkant
666,R10 414,2023-01-05,16:00:00,180,145,35,FMN 19 Binnensingel Oostkant
666,R10 414,2023-01-05,17:00:00,188,149,39,FMN 19 Binnensingel Oostkant
666,R10 414,2023-01-05,18:00:00,144,109,35,FMN 19 Binnensingel Oostkant
666,R10 414,2023-01-05,19:00:00,77,57,20,FMN 19 Binnensingel Oostkant
666,R10 414,2023-01-05,20:00:00,59,44,15,FMN 19 Binnensingel Oostkant
666,R10 414,2023-01-05,21:00:00,62,50,12,FMN 19 Binnensingel Oostkant
666,R10 414,2023-01-05,22:00:00,54,43,11,FMN 19 Binnensingel Oostkant
666,R10 414,2023-01-05,23:00:00,33,25,8,FMN 19 Binnensingel Oostkant
666,R10 414,2023-01-06,00:00:00,23,16,7,FMN 19 Binnensingel Oostkant
666,R10 414,2023-01-06,01:00:00,14,10,4,FMN 19 Binnensingel Oostkant
666,R10 414,2023-01-06,02:00:00,10,8,2,FMN 19 Binnensingel Oostkant
666,R10 414,2023-01-06,03:00:00,11,8,3,FMN 19 Binnensingel Oostkant
666,R10 414,2023-01-06,04:00:00,18,10,8,FMN 19 Binnensingel Oostkant
666,R10 414,2023-01-06,05:00:00,20,13,7,FMN 19 Binnensingel Oostkant
666,R10 414,2023-01-06,06:00:00,41,28,13,FMN 19 Binnensingel Oostkant
666,R10 414,2023-01-06,07:00:00,81,55,26,FMN 19 Binnensingel Oostkant
666,R10 414,2023-01-06,08:00:00,109,75,34,FMN 19 Binnensingel Oostkant
666,R10 414,2023-01-06,09:00:00,59,41,18,FMN 19 Binnensingel Oostkant
666,R10 414,2023-01-06,10:00:00,55,42,13,FMN 19 Binnensingel Oostkant
666,R10 414,2023-01-06,11:00:00,58,44,14,FMN 19 Binnensingel Oostkant
666,R10 414,2023-01-06,12:00:00,77,58,19,FMN 19 Binnensingel Oostkant
666,R10 414,2023-01-06,13:00:00,74,51,23,FMN 19 Binnensingel Oostkant
666,R10 414,2023-01-06,14:00:00,83,65,18,FMN 19 Binnensingel Oostkant
666,R10 414,2023-01-06,15:00:00,113,94,19,FMN 19 Binnensingel Oostkant
666,R10 414,2023-01-06,16:00:00,156,133,23,FMN 19 Binnensingel Oostkant
666,R10 414,2023-01-06,17:00:00,143,110,33,FMN 19 Binnensingel Oostkant
666,R10 414,2023-01-06,18:00:00,101,80,21,FMN 19 Binnensingel Oostkant
666,R10 414,2023-01-06,19:00:00,78,59,19,FMN 19 Binnensingel Oostkant
666,R10 414,2023-01-06,20:00:00,40,28,12,FMN 19 Binnensingel Oostkant
666,R10 414,2023-01-06,21:00:00,36,31,5,FMN 19 Binnensingel Oostkant
666,R10 414,2023-01-06,22:00:00,32,25,7,FMN 19 Binnensingel Oostkant
666,R10 414,2023-01-06,23:00:00,27,20,7,FMN 19 Binnensingel Oostkant
666,R10 414,2023-01-07,00:00:00,17,16,1,FMN 19 Binnensingel Oostkant
666,R10 414,2023-01-07,01:00:00,4,0,4,FMN 19 Binnensingel Oostkant
666,R10 414,2023-01-07,02:00:00,5,4,1,FMN 19 Binnensingel Oostkant
666,R10 414,2023-01-07,03:00:00,14,6,8,FMN 19 Binnensingel Oostkant
666,R10 414,2023-01-07,04:00:00,11,7,4,FMN 19 Binnensingel Oostkant
666,R10 414,2023-01-07,05:00:00,10,5,5,FMN 19 Binnensingel Oostkant
666,R10 414,2023-01-07,06:00:00,12,5,7,FMN 19 Binnensingel Oostkant
666,R10 414,2023-01-07,07:00:00,9,6,3,FMN 19 Binnensingel Oostkant
666,R10 414,2023-01-07,08:00:00,26,20,6,FMN 19 Binnensingel Oostkant
666,R10 414,2023-01-07,09:00:00,31,26,5,FMN 19 Binnensingel Oostkant
666,R10 414,2023-01-07,10:00:00,38,30,8,FMN 19 Binnensingel Oostkant
666,R10 414,2023-01-07,11:00:00,41,33,8,FMN 19 Binnensingel Oostkant
666,R10 414,2023-01-07,12:00:00,47,38,9,FMN 19 Binnensingel Oostkant
666,R10 414,2023-01-07,13:00:00,56,40,16,FMN 19 Binnensingel Oostkant
666,R10 414,2023-01-07,14:00:00,54,42,12,FMN 19 Binnensingel Oostkant
666,R10 414,2023-01-07,15:00:00,54,41,13,FMN 19 Binnensingel Oostkant
666,R10 414,2023-01-07,16:00:00,58,39,19,FMN 19 Binnensingel Oostkant
666,R10 414,2023-01-07,17:00:00,42,33,9,FMN 19 Binnensingel Oostkant
666,R10 414,2023-01-07,18:00:00,54,46,8,FMN 19 Binnensingel Oostkant
666,R10 414,2023-01-07,19:00:00,54,45,9,FMN 19 Binnensingel Oostkant
666,R10 414,2023-01-07,20:00:00,55,44,11,FMN 19 Binnensingel Oostkant
666,R10 414,2023-01-07,21:00:00,24,17,7,FMN 19 Binnensingel Oostkant
666,R10 414,2023-01-07,22:00:00,21,14,7,FMN 19 Binnensingel Oostkant
666,R10 414,2023-01-07,23:00:00,29,12,17,FMN 19 Binnensingel Oostkant
666,R10 414,2023-01-08,00:00:00,17,9,8,FMN 19 Binnensingel Oostkant
666,R10 414,2023-01-08,01:00:00,16,12,4,FMN 19 Binnensingel Oostkant
666,R10 414,2023-01-08,02:00:00,4,3,1,FMN 19 Binnensingel Oostkant
666,R10 414,2023-01-08,03:00:00,4,1,3,FMN 19 Binnensingel Oostkant
666,R10 414,2023-01-08,04:00:00,11,8,3,FMN 19 Binnensingel Oostkant
666,R10 414,2023-01-08,05:00:00,5,2,3,FMN 19 Binnensingel Oostkant
666,R10 414,2023-01-08,06:00:00,6,3,3,FMN 19 Binnensingel Oostkant
666,R10 414,2023-01-08,07:00:00,8,6,2,FMN 19 Binnensingel Oostkant
666,R10 414,2023-01-08,08:00:00,14,10,4,FMN 19 Binnensingel Oostkant
666,R10 414,2023-01-08,09:00:00,29,18,11,FMN 19 Binnensingel Oostkant
666,R10 414,2023-01-08,10:00:00,34,30,4,FMN 19 Binnensingel Oostkant
666,R10 414,2023-01-08,11:00:00,42,33,9,FMN 19 Binnensingel Oostkant
666,R10 414,2023-01-08,12:00:00,45,36,9,FMN 19 Binnensingel Oostkant
666,R10 414,2023-01-08,13:00:00,76,58,18,FMN 19 Binnensingel Oostkant
666,R10 414,2023-01-08,14:00:00,48,34,14,FMN 19 Binnensingel Oostkant
666,R10 414,2023-01-08,15:00:00,51,32,19,FMN 19 Binnensingel Oostkant
666,R10 414,2023-01-08,16:00:00,61,50,11,FMN 19 Binnensingel Oostkant
666,R10 414,2023-01-08,17:00:00,39,31,8,FMN 19 Binnensingel Oostkant
666,R10 414,2023-01-08,18:00:00,59,48,11,FMN 19 Binnensingel Oostkant
666,R10 414,2023-01-08,19:00:00,32,21,11,FMN 19 Binnensingel Oostkant
666,R10 414,2023-01-08,20:00:00,22,15,7,FMN 19 Binnensingel Oostkant
666,R10 414,2023-01-08,21:00:00,25,18,7,FMN 19 Binnensingel Oostkant
666,R10 414,2023-01-08,22:00:00,17,13,4,FMN 19 Binnensingel Oostkant
666,R10 414,2023-01-08,23:00:00,17,12,5,FMN 19 Binnensingel Oostkant
666,R10 414,2023-01-09,00:00:00,6,5,1,FMN 19 Binnensingel Oostkant
666,R10 414,2023-01-09,01:00:00,2,2,0,FMN 19 Binnensingel Oostkant
666,R10 414,2023-01-09,02:00:00,1,1,0,FMN 19 Binnensingel Oostkant
666,R10 414,2023-01-09,03:00:00,5,2,3,FMN 19 Binnensingel Oostkant
666,R10 414,2023-01-09,04:00:00,13,8,5,FMN 19 Binnensingel Oostkant
666,R10 414,2023-01-09,05:00:00,27,12,15,FMN 19 Binnensingel Oostkant
666,R10 414,2023-01-09,06:00:00,48,30,18,FMN 19 Binnensingel Oostkant
666,R10 414,2023-01-09,07:00:00,127,87,40,FMN 19 Binnensingel Oostkant
666,R10 414,2023-01-09,08:00:00,173,122,51,FMN 19 Binnensingel Oostkant
666,R10 414,2023-01-09,09:00:00,61,36,25,FMN 19 Binnensingel Oostkant
666,R10 414,2023-01-09,10:00:00,53,36,17,FMN 19 Binnensingel Oostkant
666,R10 414,2023-01-09,11:00:00,56,44,12,FMN 19 Binnensingel Oostkant
666,R10 414,2023-01-09,12:00:00,88,69,19,FMN 19 Binnensingel Oostkant
666,R10 414,2023-01-09,13:00:00,66,50,16,FMN 19 Binnensingel Oostkant
666,R10 414,2023-01-09,14:00:00,73,56,17,FMN 19 Binnensingel Oostkant
666,R10 414,2023-01-09,15:00:00,128,114,14,FMN 19 Binnensingel Oostkant
666,R10 414,2023-01-09,16:00:00,186,155,31,FMN 19 Binnensingel Oostkant
666,R10 414,2023-01-09,17:00:00,188,157,31,FMN 19 Binnensingel Oostkant
666,R10 414,2023-01-09,18:00:00,103,70,33,FMN 19 Binnensingel Oostkant
666,R10 414,2023-01-09,19:00:00,57,43,14,FMN 19 Binnensingel Oostkant
666,R10 414,2023-01-09,20:00:00,42,33,9,FMN 19 Binnensingel Oostkant
666,R10 414,2023-01-09,21:00:00,47,39,8,FMN 19 Binnensingel Oostkant
666,R10 414,2023-01-09,22:00:00,39,30,9,FMN 19 Binnensingel Oostkant
666,R10 414,2023-01-09,23:00:00,21,15,6,FMN 19 Binnensingel Oostkant
666,R10 414,2023-01-10,00:00:00,5,5,0,FMN 19 Binnensingel Oostkant
666,R10 414,2023-01-10,01:00:00,3,2,1,FMN 19 Binnensingel Oostkant
666,R10 414,2023-01-10,02:00:00,2,2,0,FMN 19 Binnensingel Oostkant
666,R10 414,2023-01-10,03:00:00,6,3,3,FMN 19 Binnensingel Oostkant
666,R10 414,2023-01-10,04:00:00,11,8,3,FMN 19 Binnensingel Oostkant
666,R10 414,2023-01-10,05:00:00,26,9,17,FMN 19 Binnensingel Oostkant
666,R10 414,2023-01-10,06:00:00,50,35,15,FMN 19 Binnensingel Oostkant
666,R10 414,2023-01-10,07:00:00,111,76,35,FMN 19 Binnensingel Oostkant
666,R10 414,2023-01-10,08:00:00,190,141,49,FMN 19 Binnensingel Oostkant
666,R10 414,2023-01-10,09:00:00,75,57,18,FMN 19 Binnensingel Oostkant
666,R10 414,2023-01-10,10:00:00,46,32,14,FMN 19 Binnensingel Oostkant
666,R10 414,2023-01-10,11:00:00,45,35,10,FMN 19 Binnensingel Oostkant
666,R10 414,2023-01-10,12:00:00,89,59,30,FMN 19 Binnensingel Oostkant
666,R10 414,2023-01-10,13:00:00,65,51,14,FMN 19 Binnensingel Oostkant
666,R10 414,2023-01-10,14:00:00,48,38,10,FMN 19 Binnensingel Oostkant
666,R10 414,2023-01-10,15:00:00,103,88,15,FMN 19 Binnensingel Oostkant
666,R10 414,2023-01-10,16:00:00,201,163,38,FMN 19 Binnensingel Oostkant
666,R10 414,2023-01-10,17:00:00,188,134,54,FMN 19 Binnensingel Oostkant
666,R10 414,2023-01-10,18:00:00,131,98,33,FMN 19 Binnensingel Oostkant
666,R10 414,2023-01-10,19:00:00,57,41,16,FMN 19 Binnensingel Oostkant
666,R10 414,2023-01-10,20:00:00,44,33,11,FMN 19 Binnensingel Oostkant
666,R10 414,2023-01-10,21:00:00,57,47,10,FMN 19 Binnensingel Oostkant
666,R10 414,2023-01-10,22:00:00,52,36,16,FMN 19 Binnensingel Oostkant
666,R10 414,2023-01-10,23:00:00,13,9,4,FMN 19 Binnensingel Oostkant
666,R10 414,2023-01-11,00:00:00,8,5,3,FMN 19 Binnensingel Oostkant
666,R10 414,2023-01-11,01:00:00,5,4,1,FMN 19 Binnensingel Oostkant
666,R10 414,2023-01-11,02:00:00,0,0,0,FMN 19 Binnensingel Oostkant
666,R10 414,2023-01-11,03:00:00,6,4,2,FMN 19 Binnensingel Oostkant
666,R10 414,2023-01-11,04:00:00,14,10,4,FMN 19 Binnensingel Oostkant
666,R10 414,2023-01-11,05:00:00,27,13,14,FMN 19 Binnensingel Oostkant
666,R10 414,2023-01-11,06:00:00,48,30,18,FMN 19 Binnensingel Oostkant
666,R10 414,2023-01-11,07:00:00,122,87,35,FMN 19 Binnensingel Oostkant
666,R10 414,2023-01-11,08:00:00,172,120,52,FMN 19 Binnensingel Oostkant
666,R10 414,2023-01-11,09:00:00,69,49,20,FMN 19 Binnensingel Oostkant
666,R10 414,2023-01-11,10:00:00,55,34,21,FMN 19 Binnensingel Oostkant
666,R10 414,2023-01-11,11:00:00,70,54,16,FMN 19 Binnensingel Oostkant
666,R10 414,2023-01-11,12:00:00,125,95,30,FMN 19 Binnensingel Oostkant
666,R10 414,2023-01-11,13:00:00,94,70,24,FMN 19 Binnensingel Oostkant
666,R10 414,2023-01-11,14:00:00,82,63,19,FMN 19 Binnensingel Oostkant
666,R10 414,2023-01-11,15:00:00,113,90,23,FMN 19 Binnensingel Oostkant
666,R10 414,2023-01-11,16:00:00,180,140,40,FMN 19 Binnensingel Oostkant
666,R10 414,2023-01-11,17:00:00,186,134,52,FMN 19 Binnensingel Oostkant
666,R10 414,2023-01-11,18:00:00,115,83,32,FMN 19 Binnensingel Oostkant
666,R10 414,2023-01-11,19:00:00,86,66,20,FMN 19 Binnensingel Oostkant
666,R10 414,2023-01-11,20:00:00,43,36,7,FMN 19 Binnensingel Oostkant
666,R10 414,2023-01-11,21:00:00,60,46,14,FMN 19 Binnensingel Oostkant
666,R10 414,2023-01-11,22:00:00,54,39,15,FMN 19 Binnensingel Oostkant
666,R10 414,2023-01-11,23:00:00,19,15,4,FMN 19 Binnensingel Oostkant
666,R10 414,2023-01-12,00:00:00,3,3,0,FMN 19 Binnensingel Oostkant
666,R10 414,2023-01-12,01:00:00,2,2,0,FMN 19 Binnensingel Oostkant
666,R10 414,2023-01-12,02:00:00,2,1,1,FMN 19 Binnensingel Oostkant
666,R10 414,2023-01-12,03:00:00,4,2,2,FMN 19 Binnensingel Oostkant
666,R10 414,2023-01-12,04:00:00,19,13,6,FMN 19 Binnensingel Oostkant
666,R10 414,2023-01-12,05:00:00,13,5,8,FMN 19 Binnensingel Oostkant
666,R10 414,2023-01-12,06:00:00,36,24,12,FMN 19 Binnensingel Oostkant
666,R10 414,2023-01-12,07:00:00,98,66,32,FMN 19 Binnensingel Oostkant
666,R10 414,2023-01-12,08:00:00,113,74,39,FMN 19 Binnensingel Oostkant
666,R10 414,2023-01-12,09:00:00,41,28,13,FMN 19 Binnensingel Oostkant
666,R10 414,2023-01-12,10:00:00,40,28,12,FMN 19 Binnensingel Oostkant
666,R10 414,2023-01-12,11:00:00,48,39,9,FMN 19 Binnensingel Oostkant
666,R10 414,2023-01-12,12:00:00,55,37,18,FMN 19 Binnensingel Oostkant
666,R10 414,2023-01-12,13:00:00,33,30,3,FMN 19 Binnensingel Oostkant
666,R10 414,2023-01-12,14:00:00,51,42,9,FMN 19 Binnensingel Oostkant
666,R10 414,2023-01-12,15:00:00,84,73,11,FMN 19 Binnensingel Oostkant
666,R10 414,2023-01-12,16:00:00,126,104,22,FMN 19 Binnensingel Oostkant
666,R10 414,2023-01-12,17:00:00,141,110,31,FMN 19 Binnensingel Oostkant
666,R10 414,2023-01-12,18:00:00,89,70,19,FMN 19 Binnensingel Oostkant
666,R10 414,2023-01-12,19:00:00,52,35,17,FMN 19 Binnensingel Oostkant
666,R10 414,2023-01-12,20:00:00,23,17,6,FMN 19 Binnensingel Oostkant
666,R10 414,2023-01-12,21:00:00,34,29,5,FMN 19 Binnensingel Oostkant
666,R10 414,2023-01-12,22:00:00,41,32,9,FMN 19 Binnensingel Oostkant
666,R10 414,2023-01-12,23:00:00,22,15,7,FMN 19 Binnensingel Oostkant
666,R10 414,2023-01-13,00:00:00,13,11,2,FMN 19 Binnensingel Oostkant
666,R10 414,2023-01-13,01:00:00,7,7,0,FMN 19 Binnensingel Oostkant
666,R10 414,2023-01-13,02:00:00,2,2,0,FMN 19 Binnensingel Oostkant
666,R10 414,2023-01-13,03:00:00,5,3,2,FMN 19 Binnensingel Oostkant
666,R10 414,2023-01-13,04:00:00,12,6,6,FMN 19 Binnensingel Oostkant
666,R10 414,2023-01-13,05:00:00,17,9,8,FMN 19 Binnensingel Oostkant
666,R10 414,2023-01-13,06:00:00,49,30,19,FMN 19 Binnensingel Oostkant
666,R10 414,2023-01-13,07:00:00,100,67,33,FMN 19 Binnensingel Oostkant
666,R10 414,2023-01-13,08:00:00,150,99,51,FMN 19 Binnensingel Oostkant
666,R10 414,2023-01-13,09:00:00,69,38,31,FMN 19 Binnensingel Oostkant
666,R10 414,2023-01-13,10:00:00,59,43,16,FMN 19 Binnensingel Oostkant
666,R10 414,2023-01-13,11:00:00,61,49,12,FMN 19 Binnensingel Oostkant
666,R10 414,2023-01-13,12:00:00,89,65,24,FMN 19 Binnensingel Oostkant
666,R10 414,2023-01-13,13:00:00,64,43,21,FMN 19 Binnensingel Oostkant
666,R10 414,2023-01-13,14:00:00,84,62,22,FMN 19 Binnensingel Oostkant
666,R10 414,2023-01-13,15:00:00,138,117,21,FMN 19 Binnensingel Oostkant
666,R10 414,2023-01-13,16:00:00,180,150,30,FMN 19 Binnensingel Oostkant
666,R10 414,2023-01-13,17:00:00,174,143,31,FMN 19 Binnensingel Oostkant
666,R10 414,2023-01-13,18:00:00,129,103,26,FMN 19 Binnensingel Oostkant
666,R10 414,2023-01-13,19:00:00,94,67,27,FMN 19 Binnensingel Oostkant
666,R10 414,2023-01-13,20:00:00,52,30,22,FMN 19 Binnensingel Oostkant
666,R10 414,2023-01-13,21:00:00,51,43,8,FMN 19 Binnensingel Oostkant
666,R10 414,2023-01-13,22:00:00,44,34,10,FMN 19 Binnensingel Oostkant
666,R10 414,2023-01-13,23:00:00,29,22,7,FMN 19 Binnensingel Oostkant
666,R10 414,2023-01-14,00:00:00,30,27,3,FMN 19 Binnensingel Oostkant
666,R10 414,2023-01-14,01:00:00,25,21,4,FMN 19 Binnensingel Oostkant
666,R10 414,2023-01-14,02:00:00,18,15,3,FMN 19 Binnensingel Oostkant
666,R10 414,2023-01-14,03:00:00,7,6,1,FMN 19 Binnensingel Oostkant
666,R10 414,2023-01-14,04:00:00,18,10,8,FMN 19 Binnensingel Oostkant
666,R10 414,2023-01-14,05:00:00,14,3,11,FMN 19 Binnensingel Oostkant
666,R10 414,2023-01-14,06:00:00,23,16,7,FMN 19 Binnensingel Oostkant
666,R10 414,2023-01-14,07:00:00,18,13,5,FMN 19 Binnensingel Oostkant
666,R10 414,2023-01-14,08:00:00,18,16,2,FMN 19 Binnensingel Oostkant
666,R10 414,2023-01-14,09:00:00,23,12,11,FMN 19 Binnensingel Oostkant
666,R10 414,2023-01-14,10:00:00,19,13,6,FMN 19 Binnensingel Oostkant
666,R10 414,2023-01-14,11:00:00,20,17,3,FMN 19 Binnensingel Oostkant
666,R10 414,2023-01-14,12:00:00,27,21,6,FMN 19 Binnensingel Oostkant
666,R10 414,2023-01-14,13:00:00,39,29,10,FMN 19 Binnensingel Oostkant
666,R10 414,2023-01-14,14:00:00,39,33,6,FMN 19 Binnensingel Oostkant
666,R10 414,2023-01-14,15:00:00,35,25,10,FMN 19 Binnensingel Oostkant
666,R10 414,2023-01-14,16:00:00,25,20,5,FMN 19 Binnensingel Oostkant
666,R10 414,2023-01-14,17:00:00,36,24,12,FMN 19 Binnensingel Oostkant
666,R10 414,2023-01-14,18:00:00,38,29,9,FMN 19 Binnensingel Oostkant
666,R10 414,2023-01-14,19:00:00,40,30,10,FMN 19 Binnensingel Oostkant
666,R10 414,2023-01-14,20:00:00,31,24,7,FMN 19 Binnensingel Oostkant
666,R10 414,2023-01-14,21:00:00,28,20,8,FMN 19 Binnensingel Oostkant
666,R10 414,2023-01-14,22:00:00,18,13,5,FMN 19 Binnensingel Oostkant
666,R10 414,2023-01-14,23:00:00,20,14,6,FMN 19 Binnensingel Oostkant
666,R10 414,2023-01-15,00:00:00,17,11,6,FMN 19 Binnensingel Oostkant
666,R10 414,2023-01-15,01:00:00,8,5,3,FMN 19 Binnensingel Oostkant
666,R10 414,2023-01-15,02:00:00,10,7,3,FMN 19 Binnensingel Oostkant
666,R10 414,2023-01-15,03:00:00,11,8,3,FMN 19 Binnensingel Oostkant
666,R10 414,2023-01-15,04:00:00,15,13,2,FMN 19 Binnensingel Oostkant
666,R10 414,2023-01-15,05:00:00,12,9,3,FMN 19 Binnensingel Oostkant
666,R10 414,2023-01-15,06:00:00,16,12,4,FMN 19 Binnensingel Oostkant
666,R10 414,2023-01-15,07:00:00,13,8,5,FMN 19 Binnensingel Oostkant
666,R10 414,2023-01-15,08:00:00,17,12,5,FMN 19 Binnensingel Oostkant
666,R10 414,2023-01-15,09:00:00,31,22,9,FMN 19 Binnensingel Oostkant
666,R10 414,2023-01-15,10:00:00,35,25,10,FMN 19 Binnensingel Oostkant
666,R10 414,2023-01-15,11:00:00,41,32,9,FMN 19 Binnensingel Oostkant
666,R10 414,2023-01-15,12:00:00,45,38,7,FMN 19 Binnensingel Oostkant
666,R10 414,2023-01-15,13:00:00,43,32,11,FMN 19 Binnensingel Oostkant
666,R10 414,2023-01-15,14:00:00,39,29,10,FMN 19 Binnensingel Oostkant
666,R10 414,2023-01-15,15:00:00,44,35,9,FMN 19 Binnensingel Oostkant
666,R10 414,2023-01-15,16:00:00,31,23,8,FMN 19 Binnensingel Oostkant
666,R10 414,2023-01-15,17:00:00,28,23,5,FMN 19 Binnensingel Oostkant
666,R10 414,2023-01-15,18:00:00,46,34,12,FMN 19 Binnensingel Oostkant
666,R10 414,2023-01-15,19:00:00,22,16,6,FMN 19 Binnensingel Oostkant
666,R10 414,2023-01-15,20:00:00,29,14,15,FMN 19 Binnensingel Oostkant
666,R10 414,2023-01-15,21:00:00,25,17,8,FMN 19 Binnensingel Oostkant
666,R10 414,2023-01-15,22:00:00,21,16,5,FMN 19 Binnensingel Oostkant
666,R10 414,2023-01-15,23:00:00,7,6,1,FMN 19 Binnensingel Oostkant
666,R10 414,2023-01-16,00:00:00,1,1,0,FMN 19 Binnensingel Oostkant
666,R10 414,2023-01-16,01:00:00,3,3,0,FMN 19 Binnensingel Oostkant
666,R10 414,2023-01-16,02:00:00,2,1,1,FMN 19 Binnensingel Oostkant
666,R10 414,2023-01-16,03:00:00,11,8,3,FMN 19 Binnensingel Oostkant
666,R10 414,2023-01-16,04:00:00,18,9,9,FMN 19 Binnensingel Oostkant
666,R10 414,2023-01-16,05:00:00,22,8,14,FMN 19 Binnensingel Oostkant
666,R10 414,2023-01-16,06:00:00,39,29,10,FMN 19 Binnensingel Oostkant
666,R10 414,2023-01-16,07:00:00,103,72,31,FMN 19 Binnensingel Oostkant
666,R10 414,2023-01-16,08:00:00,123,87,36,FMN 19 Binnensingel Oostkant
666,R10 414,2023-01-16,09:00:00,46,33,13,FMN 19 Binnensingel Oostkant
666,R10 414,2023-01-16,10:00:00,42,34,8,FMN 19 Binnensingel Oostkant
666,R10 414,2023-01-16,11:00:00,39,32,7,FMN 19 Binnensingel Oostkant
666,R10 414,2023-01-16,12:00:00,58,43,15,FMN 19 Binnensingel Oostkant
666,R10 414,2023-01-16,13:00:00,43,34,9,FMN 19 Binnensingel Oostkant
666,R10 414,2023-01-16,14:00:00,57,45,12,FMN 19 Binnensingel Oostkant
666,R10 414,2023-01-16,15:00:00,104,90,14,FMN 19 Binnensingel Oostkant
666,R10 414,2023-01-16,16:00:00,149,128,21,FMN 19 Binnensingel Oostkant
666,R10 414,2023-01-16,17:00:00,137,108,29,FMN 19 Binnensingel Oostkant
666,R10 414,2023-01-16,18:00:00,77,55,22,FMN 19 Binnensingel Oostkant
666,R10 414,2023-01-16,19:00:00,45,32,13,FMN 19 Binnensingel Oostkant
666,R10 414,2023-01-16,20:00:00,38,31,7,FMN 19 Binnensingel Oostkant
666,R10 414,2023-01-16,21:00:00,38,33,5,FMN 19 Binnensingel Oostkant
666,R10 414,2023-01-16,22:00:00,44,37,7,FMN 19 Binnensingel Oostkant
666,R10 414,2023-01-16,23:00:00,8,6,2,FMN 19 Binnensingel Oostkant
666,R10 414,2023-01-17,00:00:00,2,2,0,FMN 19 Binnensingel Oostkant
666,R10 414,2023-01-17,01:00:00,3,2,1,FMN 19 Binnensingel Oostkant
666,R10 414,2023-01-17,02:00:00,4,3,1,FMN 19 Binnensingel Oostkant
666,R10 414,2023-01-17,03:00:00,5,2,3,FMN 19 Binnensingel Oostkant
666,R10 414,2023-01-17,04:00:00,14,7,7,FMN 19 Binnensingel Oostkant
666,R10 414,2023-01-17,05:00:00,15,8,7,FMN 19 Binnensingel Oostkant
666,R10 414,2023-01-17,06:00:00,47,33,14,FMN 19 Binnensingel Oostkant
666,R10 414,2023-01-17,07:00:00,113,83,30,FMN 19 Binnensingel Oostkant
666,R10 414,2023-01-17,08:00:00,132,94,38,FMN 19 Binnensingel Oostkant
666,R10 414,2023-01-17,09:00:00,48,33,15,FMN 19 Binnensingel Oostkant
666,R10 414,2023-01-17,10:00:00,37,28,9,FMN 19 Binnensingel Oostkant
666,R10 414,2023-01-17,11:00:00,62,43,19,FMN 19 Binnensingel Oostkant
666,R10 414,2023-01-17,12:00:00,65,47,18,FMN 19 Binnensingel Oostkant
666,R10 414,2023-01-17,13:00:00,81,56,25,FMN 19 Binnensingel Oostkant
666,R10 414,2023-01-17,14:00:00,75,59,16,FMN 19 Binnensingel Oostkant
666,R10 414,2023-01-17,15:00:00,108,90,18,FMN 19 Binnensingel Oostkant
666,R10 414,2023-01-17,16:00:00,166,132,34,FMN 19 Binnensingel Oostkant
666,R10 414,2023-01-17,17:00:00,150,116,34,FMN 19 Binnensingel Oostkant
666,R10 414,2023-01-17,18:00:00,117,93,24,FMN 19 Binnensingel Oostkant
666,R10 414,2023-01-17,19:00:00,56,36,20,FMN 19 Binnensingel Oostkant
666,R10 414,2023-01-17,20:00:00,37,24,13,FMN 19 Binnensingel Oostkant
666,R10 414,2023-01-17,21:00:00,50,40,10,FMN 19 Binnensingel Oostkant
666,R10 414,2023-01-17,22:00:00,53,42,11,FMN 19 Binnensingel Oostkant
666,R10 414,2023-01-17,23:00:00,18,18,0,FMN 19 Binnensingel Oostkant
666,R10 414,2023-01-18,00:00:00,8,4,4,FMN 19 Binnensingel Oostkant
666,R10 414,2023-01-18,01:00:00,2,2,0,FMN 19 Binnensingel Oostkant
666,R10 414,2023-01-18,02:00:00,1,1,0,FMN 19 Binnensingel Oostkant
666,R10 414,2023-01-18,03:00:00,5,2,3,FMN 19 Binnensingel Oostkant
666,R10 414,2023-01-18,04:00:00,13,6,7,FMN 19 Binnensingel Oostkant
666,R10 414,2023-01-18,05:00:00,12,8,4,FMN 19 Binnensingel Oostkant
666,R10 414,2023-01-18,06:00:00,31,22,9,FMN 19 Binnensingel Oostkant
666,R10 414,2023-01-18,07:00:00,61,42,19,FMN 19 Binnensingel Oostkant
666,R10 414,2023-01-18,08:00:00,85,63,22,FMN 19 Binnensingel Oostkant
666,R10 414,2023-01-18,09:00:00,41,31,10,FMN 19 Binnensingel Oostkant
666,R10 414,2023-01-18,10:00:00,38,28,10,FMN 19 Binnensingel Oostkant
666,R10 414,2023-01-18,11:00:00,43,36,7,FMN 19 Binnensingel Oostkant
666,R10 414,2023-01-18,12:00:00,85,62,23,FMN 19 Binnensingel Oostkant
666,R10 414,2023-01-18,13:00:00,99,66,33,FMN 19 Binnensingel Oostkant
666,R10 414,2023-01-18,14:00:00,66,55,11,FMN 19 Binnensingel Oostkant
666,R10 414,2023-01-18,15:00:00,83,61,22,FMN 19 Binnensingel Oostkant
666,R10 414,2023-01-18,16:00:00,140,114,26,FMN 19 Binnensingel Oostkant
666,R10 414,2023-01-18,17:00:00,144,111,33,FMN 19 Binnensingel Oostkant
666,R10 414,2023-01-18,18:00:00,107,81,26,FMN 19 Binnensingel Oostkant
666,R10 414,2023-01-18,19:00:00,51,36,15,FMN 19 Binnensingel Oostkant
666,R10 414,2023-01-18,20:00:00,45,35,10,FMN 19 Binnensingel Oostkant
666,R10 414,2023-01-18,21:00:00,44,40,4,FMN 19 Binnensingel Oostkant
666,R10 414,2023-01-18,22:00:00,60,52,8,FMN 19 Binnensingel Oostkant
666,R10 414,2023-01-18,23:00:00,12,9,3,FMN 19 Binnensingel Oostkant
666,R10 414,2023-01-19,00:00:00,6,5,1,FMN 19 Binnensingel Oostkant
666,R10 414,2023-01-19,01:00:00,4,4,0,FMN 19 Binnensingel Oostkant
666,R10 414,2023-01-19,02:00:00,3,3,0,FMN 19 Binnensingel Oostkant
666,R10 414,2023-01-19,03:00:00,7,3,4,FMN 19 Binnensingel Oostkant
666,R10 414,2023-01-19,04:00:00,14,8,6,FMN 19 Binnensingel Oostkant
666,R10 414,2023-01-19,05:00:00,17,10,7,FMN 19 Binnensingel Oostkant
666,R10 414,2023-01-19,06:00:00,37,24,13,FMN 19 Binnensingel Oostkant
666,R10 414,2023-01-19,07:00:00,94,71,23,FMN 19 Binnensingel Oostkant
666,R10 414,2023-01-19,08:00:00,121,93,28,FMN 19 Binnensingel Oostkant
666,R10 414,2023-01-19,09:00:00,50,36,14,FMN 19 Binnensingel Oostkant
666,R10 414,2023-01-19,10:00:00,47,35,12,FMN 19 Binnensingel Oostkant
666,R10 414,2023-01-19,11:00:00,57,39,18,FMN 19 Binnensingel Oostkant
666,R10 414,2023-01-19,12:00:00,80,63,17,FMN 19 Binnensingel Oostkant
666,R10 414,2023-01-19,13:00:00,64,52,12,FMN 19 Binnensingel Oostkant
666,R10 414,2023-01-19,14:00:00,65,50,15,FMN 19 Binnensingel Oostkant
666,R10 414,2023-01-19,15:00:00,110,91,19,FMN 19 Binnensingel Oostkant
666,R10 414,2023-01-19,16:00:00,155,129,26,FMN 19 Binnensingel Oostkant
666,R10 414,2023-01-19,17:00:00,163,135,28,FMN 19 Binnensingel Oostkant
666,R10 414,2023-01-19,18:00:00,124,97,27,FMN 19 Binnensingel Oostkant
666,R10 414,2023-01-19,19:00:00,68,52,16,FMN 19 Binnensingel Oostkant
666,R10 414,2023-01-19,20:00:00,50,39,11,FMN 19 Binnensingel Oostkant
666,R10 414,2023-01-19,21:00:00,54,45,9,FMN 19 Binnensingel Oostkant
666,R10 414,2023-01-19,22:00:00,46,38,8,FMN 19 Binnensingel Oostkant
666,R10 414,2023-01-19,23:00:00,29,23,6,FMN 19 Binnensingel Oostkant
666,R10 414,2023-01-20,00:00:00,23,16,7,FMN 19 Binnensingel Oostkant
666,R10 414,2023-01-20,01:00:00,14,10,4,FMN 19 Binnensingel Oostkant
666,R10 414,2023-01-20,02:00:00,10,8,2,FMN 19 Binnensingel Oostkant
666,R10 414,2023-01-20,03:00:00,11,8,3,FMN 19 Binnensingel Oostkant
666,R10 414,2023-01-20,04:00:00,18,10,8,FMN 19 Binnensingel Oostkant
666,R10 414,2023-01-20,05:00:00,20,13,7,FMN 19 Binnensingel Oostkant
666,R10 414,2023-01-20,06:00:00,41,28,13,FMN 19 Binnensingel Oostkant
666,R10 414,2023-01-20,07:00:00,81,55,26,FMN 19 Binnensingel Oostkant
666,R10 414,2023-01-20,08:00:00,108,75,33,FMN 19 Binnensingel Oostkant
666,R10 414,2023-01-20,09:00:00,59,41,18,FMN 19 Binnensingel Oostkant
666,R10 414,2023-01-20,10:00:00,56,42,14,FMN 19 Binnensingel Oostkant
666,R10 414,2023-01-20,11:00:00,57,44,13,FMN 19 Binnensingel Oostkant
666,R10 414,2023-01-20,12:00:00,77,58,19,FMN 19 Binnensingel Oostkant
666,R10 414,2023-01-20,13:00:00,74,51,23,FMN 19 Binnensingel Oostkant
666,R10 414,2023-01-20,14:00:00,83,65,18,FMN 19 Binnensingel Oostkant
666,R10 414,2023-01-20,15:00:00,113,94,19,FMN 19 Binnensingel Oostkant
666,R10 414,2023-01-20,16:00:00,156,133,23,FMN 19 Binnensingel Oostkant
666,R10 414,2023-01-20,17:00:00,142,110,32,FMN 19 Binnensingel Oostkant
666,R10 414,2023-01-20,18:00:00,101,80,21,FMN 19 Binnensingel Oostkant
666,R10 414,2023-01-20,19:00:00,78,59,19,FMN 19 Binnensingel Oostkant
666,R10 414,2023-01-20,20:00:00,40,28,12,FMN 19 Binnensingel Oostkant
666,R10 414,2023-01-20,21:00:00,36,31,5,FMN 19 Binnensingel Oostkant
666,R10 414,2023-01-20,22:00:00,32,25,7,FMN 19 Binnensingel Oostkant
666,R10 414,2023-01-20,23:00:00,27,20,7,FMN 19 Binnensingel Oostkant
666,R10 414,2023-01-21,00:00:00,25,22,3,FMN 19 Binnensingel Oostkant
666,R10 414,2023-01-21,01:00:00,15,12,3,FMN 19 Binnensingel Oostkant
666,R10 414,2023-01-21,02:00:00,11,9,2,FMN 19 Binnensingel Oostkant
666,R10 414,2023-01-21,03:00:00,12,8,4,FMN 19 Binnensingel Oostkant
666,R10 414,2023-01-21,04:00:00,14,8,6,FMN 19 Binnensingel Oostkant
666,R10 414,2023-01-21,05:00:00,12,6,6,FMN 19 Binnensingel Oostkant
666,R10 414,2023-01-21,06:00:00,16,9,7,FMN 19 Binnensingel Oostkant
666,R10 414,2023-01-21,07:00:00,18,11,7,FMN 19 Binnensingel Oostkant
666,R10 414,2023-01-21,08:00:00,25,20,5,FMN 19 Binnensingel Oostkant
666,R10 414,2023-01-21,09:00:00,34,23,11,FMN 19 Binnensingel Oostkant
666,R10 414,2023-01-21,10:00:00,41,34,7,FMN 19 Binnensingel Oostkant
666,R10 414,2023-01-21,11:00:00,42,33,9,FMN 19 Binnensingel Oostkant
666,R10 414,2023-01-21,12:00:00,56,41,15,FMN 19 Binnensingel Oostkant
666,R10 414,2023-01-21,13:00:00,58,42,16,FMN 19 Binnensingel Oostkant
666,R10 414,2023-01-21,14:00:00,62,46,16,FMN 19 Binnensingel Oostkant
666,R10 414,2023-01-21,15:00:00,60,42,18,FMN 19 Binnensingel Oostkant
666,R10 414,2023-01-21,16:00:00,60,45,15,FMN 19 Binnensingel Oostkant
666,R10 414,2023-01-21,17:00:00,63,48,15,FMN 19 Binnensingel Oostkant
666,R10 414,2023-01-21,18:00:00,62,51,11,FMN 19 Binnensingel Oostkant
666,R10 414,2023-01-21,19:00:00,57,43,14,FMN 19 Binnensingel Oostkant
666,R10 414,2023-01-21,20:00:00,45,35,10,FMN 19 Binnensingel Oostkant
666,R10 414,2023-01-21,21:00:00,35,25,10,FMN 19 Binnensingel Oostkant
666,R10 414,2023-01-21,22:00:00,37,28,9,FMN 19 Binnensingel Oostkant
666,R10 414,2023-01-21,23:00:00,27,17,10,FMN 19 Binnensingel Oostkant
666,R10 414,2023-01-22,00:00:00,24,18,6,FMN 19 Binnensingel Oostkant
666,R10 414,2023-01-22,01:00:00,13,9,4,FMN 19 Binnensingel Oostkant
666,R10 414,2023-01-22,02:00:00,9,7,2,FMN 19 Binnensingel Oostkant
666,R10 414,2023-01-22,03:00:00,11,8,3,FMN 19 Binnensingel Oostkant
666,R10 414,2023-01-22,04:00:00,10,7,3,FMN 19 Binnensingel Oostkant
666,R10 414,2023-01-22,05:00:00,9,5,4,FMN 19 Binnensingel Oostkant
666,R10 414,2023-01-22,06:00:00,6,4,2,FMN 19 Binnensingel Oostkant
666,R10 414,2023-01-22,07:00:00,10,7,3,FMN 19 Binnensingel Oostkant
666,R10 414,2023-01-22,08:00:00,15,10,5,FMN 19 Binnensingel Oostkant
666,R10 414,2023-01-22,09:00:00,30,21,9,FMN 19 Binnensingel Oostkant
666,R10 414,2023-01-22,10:00:00,36,28,8,FMN 19 Binnensingel Oostkant
666,R10 414,2023-01-22,11:00:00,46,36,10,FMN 19 Binnensingel Oostkant
666,R10 414,2023-01-22,12:00:00,49,39,10,FMN 19 Binnensingel Oostkant
666,R10 414,2023-01-22,13:00:00,66,49,17,FMN 19 Binnensingel Oostkant
666,R10 414,2023-01-22,14:00:00,54,39,15,FMN 19 Binnensingel Oostkant
666,R10 414,2023-01-22,15:00:00,59,38,21,FMN 19 Binnensingel Oostkant
666,R10 414,2023-01-22,16:00:00,57,44,13,FMN 19 Binnensingel Oostkant
666,R10 414,2023-01-22,17:00:00,52,39,13,FMN 19 Binnensingel Oostkant
666,R10 414,2023-01-22,18:00:00,46,34,12,FMN 19 Binnensingel Oostkant
666,R10 414,2023-01-22,19:00:00,35,26,9,FMN 19 Binnensingel Oostkant
666,R10 414,2023-01-22,20:00:00,32,21,11,FMN 19 Binnensingel Oostkant
666,R10 414,2023-01-22,21:00:00,23,17,6,FMN 19 Binnensingel Oostkant
666,R10 414,2023-01-22,22:00:00,25,17,8,FMN 19 Binnensingel Oostkant
666,R10 414,2023-01-22,23:00:00,13,10,3,FMN 19 Binnensingel Oostkant
666,R10 414,2023-01-23,00:00:00,5,4,1,FMN 19 Binnensingel Oostkant
666,R10 414,2023-01-23,01:00:00,3,3,0,FMN 19 Binnensingel Oostkant
666,R10 414,2023-01-23,02:00:00,3,2,1,FMN 19 Binnensingel Oostkant
666,R10 414,2023-01-23,03:00:00,5,3,2,FMN 19 Binnensingel Oostkant
666,R10 414,2023-01-23,04:00:00,13,7,6,FMN 19 Binnensingel Oostkant
666,R10 414,2023-01-23,05:00:00,23,11,12,FMN 19 Binnensingel Oostkant
666,R10 414,2023-01-23,06:00:00,41,28,13,FMN 19 Binnensingel Oostkant
666,R10 414,2023-01-23,07:00:00,116,79,37,FMN 19 Binnensingel Oostkant
666,R10 414,2023-01-23,08:00:00,132,87,45,FMN 19 Binnensingel Oostkant
666,R10 414,2023-01-23,09:00:00,52,33,19,FMN 19 Binnensingel Oostkant
666,R10 414,2023-01-23,10:00:00,52,37,15,FMN 19 Binnensingel Oostkant
666,R10 414,2023-01-23,11:00:00,56,45,11,FMN 19 Binnensingel Oostkant
666,R10 414,2023-01-23,12:00:00,89,68,21,FMN 19 Binnensingel Oostkant
666,R10 414,2023-01-23,13:00:00,79,57,22,FMN 19 Binnensingel Oostkant
666,R10 414,2023-01-23,14:00:00,73,58,15,FMN 19 Binnensingel Oostkant
666,R10 414,2023-01-23,15:00:00,130,110,20,FMN 19 Binnensingel Oostkant
666,R10 414,2023-01-23,16:00:00,202,168,34,FMN 19 Binnensingel Oostkant
666,R10 414,2023-01-23,17:00:00,176,141,35,FMN 19 Binnensingel Oostkant
666,R10 414,2023-01-23,18:00:00,118,88,30,FMN 19 Binnensingel Oostkant
666,R10 414,2023-01-23,19:00:00,62,45,17,FMN 19 Binnensingel Oostkant
666,R10 414,2023-01-23,20:00:00,47,37,10,FMN 19 Binnensingel Oostkant
666,R10 414,2023-01-23,21:00:00,44,39,5,FMN 19 Binnensingel Oostkant
666,R10 414,2023-01-23,22:00:00,51,40,11,FMN 19 Binnensingel Oostkant
666,R10 414,2023-01-23,23:00:00,17,13,4,FMN 19 Binnensingel Oostkant
666,R10 414,2023-01-24,00:00:00,6,5,1,FMN 19 Binnensingel Oostkant
666,R10 414,2023-01-24,01:00:00,4,3,1,FMN 19 Binnensingel Oostkant
666,R10 414,2023-01-24,02:00:00,5,3,2,FMN 19 Binnensingel Oostkant
666,R10 414,2023-01-24,03:00:00,7,3,4,FMN 19 Binnensingel Oostkant
666,R10 414,2023-01-24,04:00:00,21,10,11,FMN 19 Binnensingel Oostkant
666,R10 414,2023-01-24,05:00:00,31,14,17,FMN 19 Binnensingel Oostkant
666,R10 414,2023-01-24,06:00:00,74,48,26,FMN 19 Binnensingel Oostkant
666,R10 414,2023-01-24,07:00:00,204,140,64,FMN 19 Binnensingel Oostkant
666,R10 414,2023-01-24,08:00:00,261,178,83,FMN 19 Binnensingel Oostkant
666,R10 414,2023-01-24,09:00:00,102,69,33,FMN 19 Binnensingel Oostkant
666,R10 414,2023-01-24,10:00:00,69,47,22,FMN 19 Binnensingel Oostkant
666,R10 414,2023-01-24,11:00:00,85,63,22,FMN 19 Binnensingel Oostkant
666,R10 414,2023-01-24,12:00:00,130,90,40,FMN 19 Binnensingel Oostkant
666,R10 414,2023-01-24,13:00:00,131,94,37,FMN 19 Binnensingel Oostkant
666,R10 414,2023-01-24,14:00:00,101,76,25,FMN 19 Binnensingel Oostkant
666,R10 414,2023-01-24,15:00:00,186,160,26,FMN 19 Binnensingel Oostkant
666,R10 414,2023-01-24,16:00:00,299,237,62,FMN 19 Binnensingel Oostkant
666,R10 414,2023-01-24,17:00:00,281,210,71,FMN 19 Binnensingel Oostkant
666,R10 414,2023-01-24,18:00:00,232,179,53,FMN 19 Binnensingel Oostkant
666,R10 414,2023-01-24,19:00:00,93,67,26,FMN 19 Binnensingel Oostkant
666,R10 414,2023-01-24,20:00:00,78,57,21,FMN 19 Binnensingel Oostkant
666,R10 414,2023-01-24,21:00:00,88,71,17,FMN 19 Binnensingel Oostkant
666,R10 414,2023-01-24,22:00:00,77,57,20,FMN 19 Binnensingel Oostkant
666,R10 414,2023-01-24,23:00:00,32,27,5,FMN 19 Binnensingel Oostkant
666,R10 414,2023-01-25,00:00:00,7,3,4,FMN 19 Binnensingel Oostkant
666,R10 414,2023-01-25,01:00:00,4,3,1,FMN 19 Binnensingel Oostkant
666,R10 414,2023-01-25,02:00:00,1,1,0,FMN 19 Binnensingel Oostkant
666,R10 414,2023-01-25,03:00:00,5,3,2,FMN 19 Binnensingel Oostkant
666,R10 414,2023-01-25,04:00:00,15,7,8,FMN 19 Binnensingel Oostkant
666,R10 414,2023-01-25,05:00:00,22,10,12,FMN 19 Binnensingel Oostkant
666,R10 414,2023-01-25,06:00:00,44,25,19,FMN 19 Binnensingel Oostkant
666,R10 414,2023-01-25,07:00:00,99,62,37,FMN 19 Binnensingel Oostkant
666,R10 414,2023-01-25,08:00:00,136,80,56,FMN 19 Binnensingel Oostkant
666,R10 414,2023-01-25,09:00:00,57,38,19,FMN 19 Binnensingel Oostkant
666,R10 414,2023-01-25,10:00:00,65,41,24,FMN 19 Binnensingel Oostkant
666,R10 414,2023-01-25,11:00:00,78,55,23,FMN 19 Binnensingel Oostkant
666,R10 414,2023-01-25,12:00:00,145,104,41,FMN 19 Binnensingel Oostkant
666,R10 414,2023-01-25,13:00:00,154,113,41,FMN 19 Binnensingel Oostkant
666,R10 414,2023-01-25,14:00:00,101,78,23,FMN 19 Binnensingel Oostkant
666,R10 414,2023-01-25,15:00:00,152,118,34,FMN 19 Binnensingel Oostkant
666,R10 414,2023-01-25,16:00:00,229,182,47,FMN 19 Binnensingel Oostkant
666,R10 414,2023-01-25,17:00:00,250,184,66,FMN 19 Binnensingel Oostkant
666,R10 414,2023-01-25,18:00:00,185,133,52,FMN 19 Binnensingel Oostkant
666,R10 414,2023-01-25,19:00:00,112,82,30,FMN 19 Binnensingel Oostkant
666,R10 414,2023-01-25,20:00:00,72,57,15,FMN 19 Binnensingel Oostkant
666,R10 414,2023-01-25,21:00:00,82,67,15,FMN 19 Binnensingel Oostkant
666,R10 414,2023-01-25,22:00:00,76,60,16,FMN 19 Binnensingel Oostkant
666,R10 414,2023-01-25,23:00:00,27,21,6,FMN 19 Binnensingel Oostkant
666,R10 414,2023-01-26,00:00:00,6,4,2,FMN 19 Binnensingel Oostkant
666,R10 414,2023-01-26,01:00:00,4,4,0,FMN 19 Binnensingel Oostkant
666,R10 414,2023-01-26,02:00:00,3,2,1,FMN 19 Binnensingel Oostkant
666,R10 414,2023-01-26,03:00:00,4,3,1,FMN 19 Binnensingel Oostkant
666,R10 414,2023-01-26,04:00:00,12,7,5,FMN 19 Binnensingel Oostkant
666,R10 414,2023-01-26,05:00:00,15,8,7,FMN 19 Binnensingel Oostkant
666,R10 414,2023-01-26,06:00:00,31,20,11,FMN 19 Binnensingel Oostkant
666,R10 414,2023-01-26,07:00:00,86,60,26,FMN 19 Binnensingel Oostkant
666,R10 414,2023-01-26,08:00:00,114,79,35,FMN 19 Binnensingel Oostkant
666,R10 414,2023-01-26,09:00:00,44,30,14,FMN 19 Binnensingel Oostkant
666,R10 414,2023-01-26,10:00:00,42,30,12,FMN 19 Binnensingel Oostkant
666,R10 414,2023-01-26,11:00:00,42,33,9,FMN 19 Binnensingel Oostkant
666,R10 414,2023-01-26,12:00:00,67,53,14,FMN 19 Binnensingel Oostkant
666,R10 414,2023-01-26,13:00:00,57,44,13,FMN 19 Binnensingel Oostkant
666,R10 414,2023-01-26,14:00:00,52,42,10,FMN 19 Binnensingel Oostkant
666,R10 414,2023-01-26,15:00:00,92,77,15,FMN 19 Binnensingel Oostkant
666,R10 414,2023-01-26,16:00:00,135,110,25,FMN 19 Binnensingel Oostkant
666,R10 414,2023-01-26,17:00:00,140,113,27,FMN 19 Binnensingel Oostkant
666,R10 414,2023-01-26,18:00:00,108,83,25,FMN 19 Binnensingel Oostkant
666,R10 414,2023-01-26,19:00:00,58,43,15,FMN 19 Binnensingel Oostkant
666,R10 414,2023-01-26,20:00:00,43,33,10,FMN 19 Binnensingel Oostkant
666,R10 414,2023-01-26,21:00:00,47,39,8,FMN 19 Binnensingel Oostkant
666,R10 414,2023-01-26,22:00:00,40,32,8,FMN 19 Binnensingel Oostkant
666,R10 414,2023-01-26,23:00:00,25,19,6,FMN 19 Binnensingel Oostkant
666,R10 414,2023-01-27,00:00:00,23,16,7,FMN 19 Binnensingel Oostkant
666,R10 414,2023-01-27,01:00:00,14,10,4,FMN 19 Binnensingel Oostkant
666,R10 414,2023-01-27,02:00:00,10,8,2,FMN 19 Binnensingel Oostkant
666,R10 414,2023-01-27,03:00:00,11,8,3,FMN 19 Binnensingel Oostkant
666,R10 414,2023-01-27,04:00:00,18,10,8,FMN 19 Binnensingel Oostkant
666,R10 414,2023-01-27,05:00:00,19,12,7,FMN 19 Binnensingel Oostkant
666,R10 414,2023-01-27,06:00:00,43,29,14,FMN 19 Binnensingel Oostkant
666,R10 414,2023-01-27,07:00:00,82,55,27,FMN 19 Binnensingel Oostkant
666,R10 414,2023-01-27,08:00:00,109,75,34,FMN 19 Binnensingel Oostkant
666,R10 414,2023-01-27,09:00:00,59,41,18,FMN 19 Binnensingel Oostkant
666,R10 414,2023-01-27,10:00:00,56,42,14,FMN 19 Binnensingel Oostkant
666,R10 414,2023-01-27,11:00:00,58,44,14,FMN 19 Binnensingel Oostkant
666,R10 414,2023-01-27,12:00:00,76,57,19,FMN 19 Binnensingel Oostkant
666,R10 414,2023-01-27,13:00:00,75,51,24,FMN 19 Binnensingel Oostkant
666,R10 414,2023-01-27,14:00:00,83,65,18,FMN 19 Binnensingel Oostkant
666,R10 414,2023-01-27,15:00:00,114,94,20,FMN 19 Binnensingel Oostkant
666,R10 414,2023-01-27,16:00:00,156,133,23,FMN 19 Binnensingel Oostkant
666,R10 414,2023-01-27,17:00:00,143,110,33,FMN 19 Binnensingel Oostkant
666,R10 414,2023-01-27,18:00:00,102,80,22,FMN 19 Binnensingel Oostkant
666,R10 414,2023-01-27,19:00:00,78,59,19,FMN 19 Binnensingel Oostkant
666,R10 414,2023-01-27,20:00:00,40,27,13,FMN 19 Binnensingel Oostkant
666,R10 414,2023-01-27,21:00:00,36,31,5,FMN 19 Binnensingel Oostkant
666,R10 414,2023-01-27,22:00:00,32,25,7,FMN 19 Binnensingel Oostkant
666,R10 414,2023-01-27,23:00:00,27,20,7,FMN 19 Binnensingel Oostkant
666,R10 414,2023-01-28,00:00:00,27,24,3,FMN 19 Binnensingel Oostkant
666,R10 414,2023-01-28,01:00:00,17,14,3,FMN 19 Binnensingel Oostkant
666,R10 414,2023-01-28,02:00:00,14,11,3,FMN 19 Binnensingel Oostkant
666,R10 414,2023-01-28,03:00:00,13,8,5,FMN 19 Binnensingel Oostkant
666,R10 414,2023-01-28,04:00:00,16,10,6,FMN 19 Binnensingel Oostkant
666,R10 414,2023-01-28,05:00:00,14,7,7,FMN 19 Binnensingel Oostkant
666,R10 414,2023-01-28,06:00:00,18,9,9,FMN 19 Binnensingel Oostkant
666,R10 414,2023-01-28,07:00:00,20,13,7,FMN 19 Binnensingel Oostkant
666,R10 414,2023-01-28,08:00:00,28,22,6,FMN 19 Binnensingel Oostkant
666,R10 414,2023-01-28,09:00:00,39,27,12,FMN 19 Binnensingel Oostkant
666,R10 414,2023-01-28,10:00:00,46,37,9,FMN 19 Binnensingel Oostkant
666,R10 414,2023-01-28,11:00:00,48,37,11,FMN 19 Binnensingel Oostkant
666,R10 414,2023-01-28,12:00:00,63,47,16,FMN 19 Binnensingel Oostkant
666,R10 414,2023-01-28,13:00:00,66,47,19,FMN 19 Binnensingel Oostkant
666,R10 414,2023-01-28,14:00:00,70,52,18,FMN 19 Binnensingel Oostkant
666,R10 414,2023-01-28,15:00:00,69,48,21,FMN 19 Binnensingel Oostkant
666,R10 414,2023-01-28,16:00:00,67,50,17,FMN 19 Binnensingel Oostkant
666,R10 414,2023-01-28,17:00:00,71,54,17,FMN 19 Binnensingel Oostkant
666,R10 414,2023-01-28,18:00:00,70,57,13,FMN 19 Binnensingel Oostkant
666,R10 414,2023-01-28,19:00:00,65,49,16,FMN 19 Binnensingel Oostkant
666,R10 414,2023-01-28,20:00:00,50,39,11,FMN 19 Binnensingel Oostkant
666,R10 414,2023-01-28,21:00:00,39,28,11,FMN 19 Binnensingel Oostkant
666,R10 414,2023-01-28,22:00:00,42,32,10,FMN 19 Binnensingel Oostkant
666,R10 414,2023-01-28,23:00:00,31,19,12,FMN 19 Binnensingel Oostkant
666,R10 414,2023-01-29,00:00:00,18,13,5,FMN 19 Binnensingel Oostkant
666,R10 414,2023-01-29,01:00:00,10,7,3,FMN 19 Binnensingel Oostkant
666,R10 414,2023-01-29,02:00:00,6,5,1,FMN 19 Binnensingel Oostkant
666,R10 414,2023-01-29,03:00:00,8,6,2,FMN 19 Binnensingel Oostkant
666,R10 414,2023-01-29,04:00:00,9,6,3,FMN 19 Binnensingel Oostkant
666,R10 414,2023-01-29,05:00:00,5,3,2,FMN 19 Binnensingel Oostkant
666,R10 414,2023-01-29,06:00:00,6,4,2,FMN 19 Binnensingel Oostkant
666,R10 414,2023-01-29,07:00:00,7,5,2,FMN 19 Binnensingel Oostkant
666,R10 414,2023-01-29,08:00:00,11,7,4,FMN 19 Binnensingel Oostkant
666,R10 414,2023-01-29,09:00:00,22,16,6,FMN 19 Binnensingel Oostkant
666,R10 414,2023-01-29,10:00:00,28,21,7,FMN 19 Binnensingel Oostkant
666,R10 414,2023-01-29,11:00:00,34,27,7,FMN 19 Binnensingel Oostkant
666,R10 414,2023-01-29,12:00:00,36,29,7,FMN 19 Binnensingel Oostkant
666,R10 414,2023-01-29,13:00:00,49,37,12,FMN 19 Binnensingel Oostkant
666,R10 414,2023-01-29,14:00:00,41,29,12,FMN 19 Binnensingel Oostkant
666,R10 414,2023-01-29,15:00:00,44,29,15,FMN 19 Binnensingel Oostkant
666,R10 414,2023-01-29,16:00:00,42,32,10,FMN 19 Binnensingel Oostkant
666,R10 414,2023-01-29,17:00:00,39,30,9,FMN 19 Binnensingel Oostkant
666,R10 414,2023-01-29,18:00:00,35,25,10,FMN 19 Binnensingel Oostkant
666,R10 414,2023-01-29,19:00:00,27,20,7,FMN 19 Binnensingel Oostkant
666,R10 414,2023-01-29,20:00:00,22,15,7,FMN 19 Binnensingel Oostkant
666,R10 414,2023-01-29,21:00:00,18,13,5,FMN 19 Binnensingel Oostkant
666,R10 414,2023-01-29,22:00:00,17,12,5,FMN 19 Binnensingel Oostkant
666,R10 414,2023-01-29,23:00:00,11,8,3,FMN 19 Binnensingel Oostkant
666,R10 414,2023-01-30,00:00:00,5,4,1,FMN 19 Binnensingel Oostkant
666,R10 414,2023-01-30,01:00:00,3,3,0,FMN 19 Binnensingel Oostkant
666,R10 414,2023-01-30,02:00:00,3,2,1,FMN 19 Binnensingel Oostkant
666,R10 414,2023-01-30,03:00:00,6,3,3,FMN 19 Binnensingel Oostkant
666,R10 414,2023-01-30,04:00:00,14,8,6,FMN 19 Binnensingel Oostkant
666,R10 414,2023-01-30,05:00:00,22,10,12,FMN 19 Binnensingel Oostkant
666,R10 414,2023-01-30,06:00:00,44,30,14,FMN 19 Binnensingel Oostkant
666,R10 414,2023-01-30,07:00:00,119,81,38,FMN 19 Binnensingel Oostkant
666,R10 414,2023-01-30,08:00:00,137,90,47,FMN 19 Binnensingel Oostkant
666,R10 414,2023-01-30,09:00:00,54,34,20,FMN 19 Binnensingel Oostkant
666,R10 414,2023-01-30,10:00:00,54,38,16,FMN 19 Binnensingel Oostkant
666,R10 414,2023-01-30,11:00:00,59,47,12,FMN 19 Binnensingel Oostkant
666,R10 414,2023-01-30,12:00:00,91,70,21,FMN 19 Binnensingel Oostkant
666,R10 414,2023-01-30,13:00:00,82,59,23,FMN 19 Binnensingel Oostkant
666,R10 414,2023-01-30,14:00:00,76,60,16,FMN 19 Binnensingel Oostkant
666,R10 414,2023-01-30,15:00:00,134,113,21,FMN 19 Binnensingel Oostkant
666,R10 414,2023-01-30,16:00:00,208,173,35,FMN 19 Binnensingel Oostkant
666,R10 414,2023-01-30,17:00:00,183,146,37,FMN 19 Binnensingel Oostkant
666,R10 414,2023-01-30,18:00:00,122,91,31,FMN 19 Binnensingel Oostkant
666,R10 414,2023-01-30,19:00:00,64,46,18,FMN 19 Binnensingel Oostkant
666,R10 414,2023-01-30,20:00:00,48,38,10,FMN 19 Binnensingel Oostkant
666,R10 414,2023-01-30,21:00:00,46,40,6,FMN 19 Binnensingel Oostkant
666,R10 414,2023-01-30,22:00:00,52,42,10,FMN 19 Binnensingel Oostkant
666,R10 414,2023-01-30,23:00:00,18,13,5,FMN 19 Binnensingel Oostkant
666,R10 414,2023-01-31,00:00:00,4,3,1,FMN 19 Binnensingel Oostkant
666,R10 414,2023-01-31,01:00:00,2,2,0,FMN 19 Binnensingel Oostkant
666,R10 414,2023-01-31,02:00:00,4,2,2,FMN 19 Binnensingel Oostkant
666,R10 414,2023-01-31,03:00:00,4,2,2,FMN 19 Binnensingel Oostkant
666,R10 414,2023-01-31,04:00:00,14,7,7,FMN 19 Binnensingel Oostkant
666,R10 414,2023-01-31,05:00:00,20,9,11,FMN 19 Binnensingel Oostkant
666,R10 414,2023-01-31,06:00:00,50,33,17,FMN 19 Binnensingel Oostkant
666,R10 414,2023-01-31,07:00:00,134,93,41,FMN 19 Binnensingel Oostkant
666,R10 414,2023-01-31,08:00:00,173,119,54,FMN 19 Binnensingel Oostkant
666,R10 414,2023-01-31,09:00:00,67,46,21,FMN 19 Binnensingel Oostkant
666,R10 414,2023-01-31,10:00:00,45,31,14,FMN 19 Binnensingel Oostkant
666,R10 414,2023-01-31,11:00:00,57,42,15,FMN 19 Binnensingel Oostkant
666,R10 414,2023-01-31,12:00:00,85,60,25,FMN 19 Binnensingel Oostkant
666,R10 414,2023-01-31,13:00:00,87,63,24,FMN 19 Binnensingel Oostkant
666,R10 414,2023-01-31,14:00:00,67,51,16,FMN 19 Binnensingel Oostkant
666,R10 414,2023-01-31,15:00:00,124,107,17,FMN 19 Binnensingel Oostkant
666,R10 414,2023-01-31,16:00:00,198,158,40,FMN 19 Binnensingel Oostkant
666,R10 414,2023-01-31,17:00:00,186,140,46,FMN 19 Binnensingel Oostkant
666,R10 414,2023-01-31,18:00:00,152,119,33,FMN 19 Binnensingel Oostkant
666,R10 414,2023-01-31,19:00:00,64,46,18,FMN 19 Binnensingel Oostkant
666,R10 414,2023-01-31,20:00:00,50,37,13,FMN 19 Binnensingel Oostkant
666,R10 414,2023-01-31,21:00:00,59,48,11,FMN 19 Binnensingel Oostkant
666,R10 414,2023-01-31,22:00:00,50,38,12,FMN 19 Binnensingel Oostkant
666,R10 414,2023-01-31,23:00:00,22,18,4,FMN 19 Binnensingel Oostkant
666,R10 414,2023-02-01,00:00:00,4,2,2,FMN 19 Binnensingel Oostkant
666,R10 414,2023-02-01,01:00:00,1,1,0,FMN 19 Binnensingel Oostkant
666,R10 414,2023-02-01,02:00:00,1,1,0,FMN 19 Binnensingel Oostkant
666,R10 414,2023-02-01,03:00:00,2,1,1,FMN 19 Binnensingel Oostkant
666,R10 414,2023-02-01,04:00:00,7,4,3,FMN 19 Binnensingel Oostkant
666,R10 414,2023-02-01,05:00:00,9,4,5,FMN 19 Binnensingel Oostkant
666,R10 414,2023-02-01,06:00:00,20,13,7,FMN 19 Binnensingel Oostkant
666,R10 414,2023-02-01,07:00:00,46,31,15,FMN 19 Binnensingel Oostkant
666,R10 414,2023-02-01,08:00:00,63,41,22,FMN 19 Binnensingel Oostkant
666,R10 414,2023-02-01,09:00:00,27,19,8,FMN 19 Binnensingel Oostkant
666,R10 414,2023-02-01,10:00:00,29,20,9,FMN 19 Binnensingel Oostkant
666,R10 414,2023-02-01,11:00:00,37,28,9,FMN 19 Binnensingel Oostkant
666,R10 414,2023-02-01,12:00:00,69,52,17,FMN 19 Binnensingel Oostkant
666,R10 414,2023-02-01,13:00:00,72,57,15,FMN 19 Binnensingel Oostkant
666,R10 414,2023-02-01,14:00:00,49,39,10,FMN 19 Binnensingel Oostkant
666,R10 414,2023-02-01,15:00:00,72,59,13,FMN 19 Binnensingel Oostkant
666,R10 414,2023-02-01,16:00:00,111,92,19,FMN 19 Binnensingel Oostkant
666,R10 414,2023-02-01,17:00:00,118,92,26,FMN 19 Binnensingel Oostkant
666,R10 414,2023-02-01,18:00:00,88,67,21,FMN 19 Binnensingel Oostkant
666,R10 414,2023-02-01,19:00:00,52,41,11,FMN 19 Binnensingel Oostkant
666,R10 414,2023-02-01,20:00:00,34,28,6,FMN 19 Binnensingel Oostkant
666,R10 414,2023-02-01,21:00:00,40,34,6,FMN 19 Binnensingel Oostkant
666,R10 414,2023-02-01,22:00:00,37,30,7,FMN 19 Binnensingel Oostkant
666,R10 414,2023-02-01,23:00:00,13,11,2,FMN 19 Binnensingel Oostkant
666,R10 414,2023-02-02,00:00:00,0,0,0,FMN 19 Binnensingel Oostkant
666,R10 414,2023-02-02,01:00:00,5,5,0,FMN 19 Binnensingel Oostkant
666,R10 414,2023-02-02,02:00:00,7,5,2,FMN 19 Binnensingel Oostkant
666,R10 414,2023-02-02,03:00:00,2,2,0,FMN 19 Binnensingel Oostkant
666,R10 414,2023-02-02,04:00:00,26,12,14,FMN 19 Binnensingel Oostkant
666,R10 414,2023-02-02,05:00:00,26,12,14,FMN 19 Binnensingel Oostkant
666,R10 414,2023-02-02,06:00:00,47,34,13,FMN 19 Binnensingel Oostkant
666,R10 414,2023-02-02,07:00:00,133,96,37,FMN 19 Binnensingel Oostkant
666,R10 414,2023-02-02,08:00:00,183,123,60,FMN 19 Binnensingel Oostkant
666,R10 414,2023-02-02,09:00:00,72,44,28,FMN 19 Binnensingel Oostkant
666,R10 414,2023-02-02,10:00:00,50,33,17,FMN 19 Binnensingel Oostkant
666,R10 414,2023-02-02,11:00:00,71,51,20,FMN 19 Binnensingel Oostkant
666,R10 414,2023-02-02,12:00:00,99,68,31,FMN 19 Binnensingel Oostkant
666,R10 414,2023-02-02,13:00:00,80,62,18,FMN 19 Binnensingel Oostkant
666,R10 414,2023-02-02,14:00:00,72,59,13,FMN 19 Binnensingel Oostkant
666,R10 414,2023-02-02,15:00:00,133,108,25,FMN 19 Binnensingel Oostkant
666,R10 414,2023-02-02,16:00:00,187,155,32,FMN 19 Binnensingel Oostkant
666,R10 414,2023-02-02,17:00:00,218,174,44,FMN 19 Binnensingel Oostkant
666,R10 414,2023-02-02,18:00:00,171,126,45,FMN 19 Binnensingel Oostkant
666,R10 414,2023-02-02,19:00:00,91,71,20,FMN 19 Binnensingel Oostkant
666,R10 414,2023-02-02,20:00:00,77,54,23,FMN 19 Binnensingel Oostkant
666,R10 414,2023-02-02,21:00:00,55,46,9,FMN 19 Binnensingel Oostkant
666,R10 414,2023-02-02,22:00:00,52,41,11,FMN 19 Binnensingel Oostkant
666,R10 414,2023-02-02,23:00:00,37,30,7,FMN 19 Binnensingel Oostkant
666,R10 414,2023-02-03,00:00:00,15,9,6,FMN 19 Binnensingel Oostkant
666,R10 414,2023-02-03,01:00:00,5,5,0,FMN 19 Binnensingel Oostkant
666,R10 414,2023-02-03,02:00:00,2,2,0,FMN 19 Binnensingel Oostkant
666,R10 414,2023-02-03,03:00:00,9,6,3,FMN 19 Binnensingel Oostkant
666,R10 414,2023-02-03,04:00:00,12,6,6,FMN 19 Binnensingel Oostkant
666,R10 414,2023-02-03,05:00:00,33,21,12,FMN 19 Binnensingel Oostkant
666,R10 414,2023-02-03,06:00:00,42,25,17,FMN 19 Binnensingel Oostkant
666,R10 414,2023-02-03,07:00:00,107,78,29,FMN 19 Binnensingel Oostkant
666,R10 414,2023-02-03,08:00:00,168,115,53,FMN 19 Binnensingel Oostkant
666,R10 414,2023-02-03,09:00:00,78,57,21,FMN 19 Binnensingel Oostkant
666,R10 414,2023-02-03,10:00:00,48,30,18,FMN 19 Binnensingel Oostkant
666,R10 414,2023-02-03,11:00:00,73,56,17,FMN 19 Binnensingel Oostkant
666,R10 414,2023-02-03,12:00:00,91,64,27,FMN 19 Binnensingel Oostkant
666,R10 414,2023-02-03,13:00:00,70,50,20,FMN 19 Binnensingel Oostkant
666,R10 414,2023-02-03,14:00:00,99,80,19,FMN 19 Binnensingel Oostkant
666,R10 414,2023-02-03,15:00:00,141,121,20,FMN 19 Binnensingel Oostkant
666,R10 414,2023-02-03,16:00:00,197,166,31,FMN 19 Binnensingel Oostkant
666,R10 414,2023-02-03,17:00:00,148,108,40,FMN 19 Binnensingel Oostkant
666,R10 414,2023-02-03,18:00:00,140,109,31,FMN 19 Binnensingel Oostkant
666,R10 414,2023-02-03,19:00:00,102,76,26,FMN 19 Binnensingel Oostkant
666,R10 414,2023-02-03,20:00:00,62,49,13,FMN 19 Binnensingel Oostkant
666,R10 414,2023-02-03,21:00:00,51,48,3,FMN 19 Binnensingel Oostkant
666,R10 414,2023-02-03,22:00:00,80,56,24,FMN 19 Binnensingel Oostkant
666,R10 414,2023-02-03,23:00:00,51,36,15,FMN 19 Binnensingel Oostkant
666,R10 414,2023-02-04,00:00:00,33,22,11,FMN 19 Binnensingel Oostkant
666,R10 414,2023-02-04,01:00:00,31,26,5,FMN 19 Binnensingel Oostkant
666,R10 414,2023-02-04,02:00:00,17,17,0,FMN 19 Binnensingel Oostkant
666,R10 414,2023-02-04,03:00:00,12,9,3,FMN 19 Binnensingel Oostkant
666,R10 414,2023-02-04,04:00:00,19,14,5,FMN 19 Binnensingel Oostkant
666,R10 414,2023-02-04,05:00:00,12,8,4,FMN 19 Binnensingel Oostkant
666,R10 414,2023-02-04,06:00:00,17,8,9,FMN 19 Binnensingel Oostkant
666,R10 414,2023-02-04,07:00:00,21,19,2,FMN 19 Binnensingel Oostkant
666,R10 414,2023-02-04,08:00:00,31,17,14,FMN 19 Binnensingel Oostkant
666,R10 414,2023-02-04,09:00:00,39,26,13,FMN 19 Binnensingel Oostkant
666,R10 414,2023-02-04,10:00:00,51,39,12,FMN 19 Binnensingel Oostkant
666,R10 414,2023-02-04,11:00:00,44,29,15,FMN 19 Binnensingel Oostkant
666,R10 414,2023-02-04,12:00:00,52,38,14,FMN 19 Binnensingel Oostkant
666,R10 414,2023-02-04,13:00:00,67,52,15,FMN 19 Binnensingel Oostkant
666,R10 414,2023-02-04,14:00:00,71,49,22,FMN 19 Binnensingel Oostkant
666,R10 414,2023-02-04,15:00:00,63,56,7,FMN 19 Binnensingel Oostkant
666,R10 414,2023-02-04,16:00:00,61,53,8,FMN 19 Binnensingel Oostkant
666,R10 414,2023-02-04,17:00:00,84,63,21,FMN 19 Binnensingel Oostkant
666,R10 414,2023-02-04,18:00:00,62,42,20,FMN 19 Binnensingel Oostkant
666,R10 414,2023-02-04,19:00:00,65,49,16,FMN 19 Binnensingel Oostkant
666,R10 414,2023-02-04,20:00:00,34,23,11,FMN 19 Binnensingel Oostkant
666,R10 414,2023-02-04,21:00:00,36,24,12,FMN 19 Binnensingel Oostkant
666,R10 414,2023-02-04,22:00:00,33,30,3,FMN 19 Binnensingel Oostkant
666,R10 414,2023-02-04,23:00:00,28,20,8,FMN 19 Binnensingel Oostkant
666,R10 414,2023-02-05,00:00:00,40,27,13,FMN 19 Binnensingel Oostkant
666,R10 414,2023-02-05,01:00:00,23,17,6,FMN 19 Binnensingel Oostkant
666,R10 414,2023-02-05,02:00:00,17,14,3,FMN 19 Binnensingel Oostkant
666,R10 414,2023-02-05,03:00:00,5,2,3,FMN 19 Binnensingel Oostkant
666,R10 414,2023-02-05,04:00:00,7,3,4,FMN 19 Binnensingel Oostkant
666,R10 414,2023-02-05,05:00:00,9,6,3,FMN 19 Binnensingel Oostkant
666,R10 414,2023-02-05,06:00:00,9,3,6,FMN 19 Binnensingel Oostkant
666,R10 414,2023-02-05,07:00:00,17,16,1,FMN 19 Binnensingel Oostkant
666,R10 414,2023-02-05,08:00:00,17,11,6,FMN 19 Binnensingel Oostkant
666,R10 414,2023-02-05,09:00:00,36,25,11,FMN 19 Binnensingel Oostkant
666,R10 414,2023-02-05,10:00:00,36,28,8,FMN 19 Binnensingel Oostkant
666,R10 414,2023-02-05,11:00:00,35,29,6,FMN 19 Binnensingel Oostkant
666,R10 414,2023-02-05,12:00:00,51,43,8,FMN 19 Binnensingel Oostkant
666,R10 414,2023-02-05,13:00:00,62,42,20,FMN 19 Binnensingel Oostkant
666,R10 414,2023-02-05,14:00:00,55,44,11,FMN 19 Binnensingel Oostkant
666,R10 414,2023-02-05,15:00:00,61,39,22,FMN 19 Binnensingel Oostkant
666,R10 414,2023-02-05,16:00:00,60,41,19,FMN 19 Binnensingel Oostkant
666,R10 414,2023-02-05,17:00:00,75,56,19,FMN 19 Binnensingel Oostkant
666,R10 414,2023-02-05,18:00:00,62,44,18,FMN 19 Binnensingel Oostkant
666,R10 414,2023-02-05,19:00:00,39,31,8,FMN 19 Binnensingel Oostkant
666,R10 414,2023-02-05,20:00:00,34,24,10,FMN 19 Binnensingel Oostkant
666,R10 414,2023-02-05,21:00:00,27,19,8,FMN 19 Binnensingel Oostkant
666,R10 414,2023-02-05,22:00:00,25,18,7,FMN 19 Binnensingel Oostkant
666,R10 414,2023-02-05,23:00:00,11,8,3,FMN 19 Binnensingel Oostkant
666,R10 414,2023-02-06,00:00:00,4,4,0,FMN 19 Binnensingel Oostkant
666,R10 414,2023-02-06,01:00:00,4,3,1,FMN 19 Binnensingel Oostkant
666,R10 414,2023-02-06,02:00:00,0,0,0,FMN 19 Binnensingel Oostkant
666,R10 414,2023-02-06,03:00:00,5,2,3,FMN 19 Binnensingel Oostkant
666,R10 414,2023-02-06,04:00:00,16,10,6,FMN 19 Binnensingel Oostkant
666,R10 414,2023-02-06,05:00:00,24,10,14,FMN 19 Binnensingel Oostkant
666,R10 414,2023-02-06,06:00:00,44,28,16,FMN 19 Binnensingel Oostkant
666,R10 414,2023-02-06,07:00:00,132,95,37,FMN 19 Binnensingel Oostkant
666,R10 414,2023-02-06,08:00:00,194,151,43,FMN 19 Binnensingel Oostkant
666,R10 414,2023-02-06,09:00:00,63,46,17,FMN 19 Binnensingel Oostkant
666,R10 414,2023-02-06,10:00:00,41,31,10,FMN 19 Binnensingel Oostkant
666,R10 414,2023-02-06,11:00:00,52,42,10,FMN 19 Binnensingel Oostkant
666,R10 414,2023-02-06,12:00:00,73,53,20,FMN 19 Binnensingel Oostkant
666,R10 414,2023-02-06,13:00:00,56,35,21,FMN 19 Binnensingel Oostkant
666,R10 414,2023-02-06,14:00:00,63,51,12,FMN 19 Binnensingel Oostkant
666,R10 414,2023-02-06,15:00:00,173,118,55,FMN 19 Binnensingel Oostkant
666,R10 414,2023-02-06,16:00:00,192,154,38,FMN 19 Binnensingel Oostkant
666,R10 414,2023-02-06,17:00:00,199,141,58,FMN 19 Binnensingel Oostkant
666,R10 414,2023-02-06,18:00:00,142,91,51,FMN 19 Binnensingel Oostkant
666,R10 414,2023-02-06,19:00:00,72,61,11,FMN 19 Binnensingel Oostkant
666,R10 414,2023-02-06,20:00:00,58,48,10,FMN 19 Binnensingel Oostkant
666,R10 414,2023-02-06,21:00:00,68,57,11,FMN 19 Binnensingel Oostkant
666,R10 414,2023-02-06,22:00:00,51,40,11,FMN 19 Binnensingel Oostkant
666,R10 414,2023-02-06,23:00:00,14,13,1,FMN 19 Binnensingel Oostkant
666,R10 414,2023-02-07,00:00:00,5,5,0,FMN 19 Binnensingel Oostkant
666,R10 414,2023-02-07,01:00:00,6,5,1,FMN 19 Binnensingel Oostkant
666,R10 414,2023-02-07,02:00:00,1,0,1,FMN 19 Binnensingel Oostkant
666,R10 414,2023-02-07,03:00:00,5,3,2,FMN 19 Binnensingel Oostkant
666,R10 414,2023-02-07,04:00:00,14,8,6,FMN 19 Binnensingel Oostkant
666,R10 414,2023-02-07,05:00:00,21,8,13,FMN 19 Binnensingel Oostkant
666,R10 414,2023-02-07,06:00:00,55,39,16,FMN 19 Binnensingel Oostkant
666,R10 414,2023-02-07,07:00:00,141,104,37,FMN 19 Binnensingel Oostkant
666,R10 414,2023-02-07,08:00:00,181,136,45,FMN 19 Binnensingel Oostkant
666,R10 414,2023-02-07,09:00:00,75,46,29,FMN 19 Binnensingel Oostkant
666,R10 414,2023-02-07,10:00:00,45,33,12,FMN 19 Binnensingel Oostkant
666,R10 414,2023-02-07,11:00:00,47,34,13,FMN 19 Binnensingel Oostkant
666,R10 414,2023-02-07,12:00:00,76,55,21,FMN 19 Binnensingel Oostkant
666,R10 414,2023-02-07,13:00:00,81,61,20,FMN 19 Binnensingel Oostkant
666,R10 414,2023-02-07,14:00:00,69,53,16,FMN 19 Binnensingel Oostkant
666,R10 414,2023-02-07,15:00:00,121,102,19,FMN 19 Binnensingel Oostkant
666,R10 414,2023-02-07,16:00:00,211,165,46,FMN 19 Binnensingel Oostkant
666,R10 414,2023-02-07,17:00:00,217,157,60,FMN 19 Binnensingel Oostkant
666,R10 414,2023-02-07,18:00:00,164,108,56,FMN 19 Binnensingel Oostkant
666,R10 414,2023-02-07,19:00:00,81,67,14,FMN 19 Binnensingel Oostkant
666,R10 414,2023-02-07,20:00:00,58,41,17,FMN 19 Binnensingel Oostkant
666,R10 414,2023-02-07,21:00:00,58,43,15,FMN 19 Binnensingel Oostkant
666,R10 414,2023-02-07,22:00:00,60,44,16,FMN 19 Binnensingel Oostkant
666,R10 414,2023-02-07,23:00:00,23,14,9,FMN 19 Binnensingel Oostkant
666,R10 414,2023-02-08,00:00:00,7,5,2,FMN 19 Binnensingel Oostkant
666,R10 414,2023-02-08,01:00:00,7,5,2,FMN 19 Binnensingel Oostkant
666,R10 414,2023-02-08,02:00:00,2,1,1,FMN 19 Binnensingel Oostkant
666,R10 414,2023-02-08,03:00:00,5,2,3,FMN 19 Binnensingel Oostkant
666,R10 414,2023-02-08,04:00:00,11,7,4,FMN 19 Binnensingel Oostkant
666,R10 414,2023-02-08,05:00:00,21,9,12,FMN 19 Binnensingel Oostkant
666,R10 414,2023-02-08,06:00:00,43,28,15,FMN 19 Binnensingel Oostkant
666,R10 414,2023-02-08,07:00:00,119,81,38,FMN 19 Binnensingel Oostkant
666,R10 414,2023-02-08,08:00:00,137,88,49,FMN 19 Binnensingel Oostkant
666,R10 414,2023-02-08,09:00:00,74,56,18,FMN 19 Binnensingel Oostkant
666,R10 414,2023-02-08,10:00:00,44,31,13,FMN 19 Binnensingel Oostkant
666,R10 414,2023-02-08,11:00:00,39,29,10,FMN 19 Binnensingel Oostkant
666,R10 414,2023-02-08,12:00:00,132,92,40,FMN 19 Binnensingel Oostkant
666,R10 414,2023-02-08,13:00:00,91,69,22,FMN 19 Binnensingel Oostkant
666,R10 414,2023-02-08,14:00:00,74,54,20,FMN 19 Binnensingel Oostkant
666,R10 414,2023-02-08,15:00:00,107,83,24,FMN 19 Binnensingel Oostkant
666,R10 414,2023-02-08,16:00:00,148,118,30,FMN 19 Binnensingel Oostkant
666,R10 414,2023-02-08,17:00:00,204,163,41,FMN 19 Binnensingel Oostkant
666,R10 414,2023-02-08,18:00:00,130,85,45,FMN 19 Binnensingel Oostkant
666,R10 414,2023-02-08,19:00:00,82,58,24,FMN 19 Binnensingel Oostkant
666,R10 414,2023-02-08,20:00:00,67,49,18,FMN 19 Binnensingel Oostkant
666,R10 414,2023-02-08,21:00:00,60,49,11,FMN 19 Binnensingel Oostkant
666,R10 414,2023-02-08,22:00:00,67,53,14,FMN 19 Binnensingel Oostkant
666,R10 414,2023-02-08,23:00:00,19,13,6,FMN 19 Binnensingel Oostkant
666,R10 414,2023-02-09,00:00:00,8,8,0,FMN 19 Binnensingel Oostkant
666,R10 414,2023-02-09,01:00:00,3,2,1,FMN 19 Binnensingel Oostkant
666,R10 414,2023-02-09,02:00:00,2,1,1,FMN 19 Binnensingel Oostkant
666,R10 414,2023-02-09,03:00:00,4,2,2,FMN 19 Binnensingel Oostkant
666,R10 414,2023-02-09,04:00:00,10,7,3,FMN 19 Binnensingel Oostkant
666,R10 414,2023-02-09,05:00:00,23,7,16,FMN 19 Binnensingel Oostkant
666,R10 414,2023-02-09,06:00:00,50,33,17,FMN 19 Binnensingel Oostkant
666,R10 414,2023-02-09,07:00:00,120,84,36,FMN 19 Binnensingel Oostkant
666,R10 414,2023-02-09,08:00:00,172,123,49,FMN 19 Binnensingel Oostkant
666,R10 414,2023-02-09,09:00:00,70,47,23,FMN 19 Binnensingel Oostkant
666,R10 414,2023-02-09,10:00:00,50,32,18,FMN 19 Binnensingel Oostkant
666,R10 414,2023-02-09,11:00:00,42,30,12,FMN 19 Binnensingel Oostkant
666,R10 414,2023-02-09,12:00:00,67,50,17,FMN 19 Binnensingel Oostkant
666,R10 414,2023-02-09,13:00:00,68,54,14,FMN 19 Binnensingel Oostkant
666,R10 414,2023-02-09,14:00:00,76,63,13,FMN 19 Binnensingel Oostkant
666,R10 414,2023-02-09,15:00:00,129,106,23,FMN 19 Binnensingel Oostkant
666,R10 414,2023-02-09,16:00:00,191,150,41,FMN 19 Binnensingel Oostkant
666,R10 414,2023-02-09,17:00:00,213,158,55,FMN 19 Binnensingel Oostkant
666,R10 414,2023-02-09,18:00:00,158,107,51,FMN 19 Binnensingel Oostkant
666,R10 414,2023-02-09,19:00:00,83,56,27,FMN 19 Binnensingel Oostkant
666,R10 414,2023-02-09,20:00:00,79,54,25,FMN 19 Binnensingel Oostkant
666,R10 414,2023-02-09,21:00:00,46,36,10,FMN 19 Binnensingel Oostkant
666,R10 414,2023-02-09,22:00:00,68,50,18,FMN 19 Binnensingel Oostkant
666,R10 414,2023-02-09,23:00:00,24,17,7,FMN 19 Binnensingel Oostkant
666,R10 414,2023-02-10,00:00:00,7,7,0,FMN 19 Binnensingel Oostkant
666,R10 414,2023-02-10,01:00:00,3,2,1,FMN 19 Binnensingel Oostkant
666,R10 414,2023-02-10,02:00:00,1,1,0,FMN 19 Binnensingel Oostkant
666,R10 414,2023-02-10,03:00:00,3,1,2,FMN 19 Binnensingel Oostkant
666,R10 414,2023-02-10,04:00:00,17,9,8,FMN 19 Binnensingel Oostkant
666,R10 414,2023-02-10,05:00:00,22,9,13,FMN 19 Binnensingel Oostkant
666,R10 414,2023-02-10,06:00:00,44,31,13,FMN 19 Binnensingel Oostkant
666,R10 414,2023-02-10,07:00:00,113,80,33,FMN 19 Binnensingel Oostkant
666,R10 414,2023-02-10,08:00:00,134,101,33,FMN 19 Binnensingel Oostkant
666,R10 414,2023-02-10,09:00:00,63,39,24,FMN 19 Binnensingel Oostkant
666,R10 414,2023-02-10,10:00:00,42,24,18,FMN 19 Binnensingel Oostkant
666,R10 414,2023-02-10,11:00:00,54,45,9,FMN 19 Binnensingel Oostkant
666,R10 414,2023-02-10,12:00:00,84,60,24,FMN 19 Binnensingel Oostkant
666,R10 414,2023-02-10,13:00:00,79,60,19,FMN 19 Binnensingel Oostkant
666,R10 414,2023-02-10,14:00:00,89,66,23,FMN 19 Binnensingel Oostkant
666,R10 414,2023-02-10,15:00:00,127,98,29,FMN 19 Binnensingel Oostkant
666,R10 414,2023-02-10,16:00:00,193,152,41,FMN 19 Binnensingel Oostkant
666,R10 414,2023-02-10,17:00:00,151,117,34,FMN 19 Binnensingel Oostkant
666,R10 414,2023-02-10,18:00:00,140,98,42,FMN 19 Binnensingel Oostkant
666,R10 414,2023-02-10,19:00:00,87,60,27,FMN 19 Binnensingel Oostkant
666,R10 414,2023-02-10,20:00:00,70,48,22,FMN 19 Binnensingel Oostkant
666,R10 414,2023-02-10,21:00:00,56,43,13,FMN 19 Binnensingel Oostkant
666,R10 414,2023-02-10,22:00:00,65,55,10,FMN 19 Binnensingel Oostkant
666,R10 414,2023-02-10,23:00:00,48,37,11,FMN 19 Binnensingel Oostkant
666,R10 414,2023-02-11,00:00:00,37,24,13,FMN 19 Binnensingel Oostkant
666,R10 414,2023-02-11,01:00:00,14,8,6,FMN 19 Binnensingel Oostkant
666,R10 414,2023-02-11,02:00:00,10,8,2,FMN 19 Binnensingel Oostkant
666,R10 414,2023-02-11,03:00:00,4,3,1,FMN 19 Binnensingel Oostkant
666,R10 414,2023-02-11,04:00:00,9,8,1,FMN 19 Binnensingel Oostkant
666,R10 414,2023-02-11,05:00:00,12,5,7,FMN 19 Binnensingel Oostkant
666,R10 414,2023-02-11,06:00:00,15,10,5,FMN 19 Binnensingel Oostkant
666,R10 414,2023-02-11,07:00:00,15,9,6,FMN 19 Binnensingel Oostkant
666,R10 414,2023-02-11,08:00:00,28,16,12,FMN 19 Binnensingel Oostkant
666,R10 414,2023-02-11,09:00:00,36,27,9,FMN 19 Binnensingel Oostkant
666,R10 414,2023-02-11,10:00:00,54,42,12,FMN 19 Binnensingel Oostkant
666,R10 414,2023-02-11,11:00:00,62,47,15,FMN 19 Binnensingel Oostkant
666,R10 414,2023-02-11,12:00:00,42,28,14,FMN 19 Binnensingel Oostkant
666,R10 414,2023-02-11,13:00:00,49,33,16,FMN 19 Binnensingel Oostkant
666,R10 414,2023-02-11,14:00:00,75,55,20,FMN 19 Binnensingel Oostkant
666,R10 414,2023-02-11,15:00:00,54,44,10,FMN 19 Binnensingel Oostkant
666,R10 414,2023-02-11,16:00:00,63,52,11,FMN 19 Binnensingel Oostkant
666,R10 414,2023-02-11,17:00:00,54,42,12,FMN 19 Binnensingel Oostkant
666,R10 414,2023-02-11,18:00:00,69,52,17,FMN 19 Binnensingel Oostkant
666,R10 414,2023-02-11,19:00:00,51,39,12,FMN 19 Binnensingel Oostkant
666,R10 414,2023-02-11,20:00:00,51,37,14,FMN 19 Binnensingel Oostkant
666,R10 414,2023-02-11,21:00:00,55,45,10,FMN 19 Binnensingel Oostkant
666,R10 414,2023-02-11,22:00:00,40,31,9,FMN 19 Binnensingel Oostkant
666,R10 414,2023-02-11,23:00:00,30,24,6,FMN 19 Binnensingel Oostkant
666,R10 414,2023-02-12,00:00:00,29,23,6,FMN 19 Binnensingel Oostkant
666,R10 414,2023-02-12,01:00:00,34,26,8,FMN 19 Binnensingel Oostkant
666,R10 414,2023-02-12,02:00:00,18,15,3,FMN 19 Binnensingel Oostkant
666,R10 414,2023-02-12,03:00:00,8,6,2,FMN 19 Binnensingel Oostkant
666,R10 414,2023-02-12,04:00:00,7,3,4,FMN 19 Binnensingel Oostkant
666,R10 414,2023-02-12,05:00:00,9,7,2,FMN 19 Binnensingel Oostkant
666,R10 414,2023-02-12,06:00:00,8,4,4,FMN 19 Binnensingel Oostkant
666,R10 414,2023-02-12,07:00:00,8,5,3,FMN 19 Binnensingel Oostkant
666,R10 414,2023-02-12,08:00:00,18,13,5,FMN 19 Binnensingel Oostkant
666,R10 414,2023-02-12,09:00:00,39,32,7,FMN 19 Binnensingel Oostkant
666,R10 414,2023-02-12,10:00:00,44,33,11,FMN 19 Binnensingel Oostkant
666,R10 414,2023-02-12,11:00:00,45,33,12,FMN 19 Binnensingel Oostkant
666,R10 414,2023-02-12,12:00:00,57,48,9,FMN 19 Binnensingel Oostkant
666,R10 414,2023-02-12,13:00:00,43,29,14,FMN 19 Binnensingel Oostkant
666,R10 414,2023-02-12,14:00:00,55,41,14,FMN 19 Binnensingel Oostkant
666,R10 414,2023-02-12,15:00:00,47,40,7,FMN 19 Binnensingel Oostkant
666,R10 414,2023-02-12,16:00:00,43,27,16,FMN 19 Binnensingel Oostkant
666,R10 414,2023-02-12,17:00:00,54,39,15,FMN 19 Binnensingel Oostkant
666,R10 414,2023-02-12,18:00:00,43,33,10,FMN 19 Binnensingel Oostkant
666,R10 414,2023-02-12,19:00:00,38,29,9,FMN 19 Binnensingel Oostkant
666,R10 414,2023-02-12,20:00:00,41,24,17,FMN 19 Binnensingel Oostkant
666,R10 414,2023-02-12,21:00:00,44,37,7,FMN 19 Binnensingel Oostkant
666,R10 414,2023-02-12,22:00:00,28,21,7,FMN 19 Binnensingel Oostkant
666,R10 414,2023-02-12,23:00:00,14,9,5,FMN 19 Binnensingel Oostkant
666,R10 414,2023-02-13,00:00:00,8,8,0,FMN 19 Binnensingel Oostkant
666,R10 414,2023-02-13,01:00:00,5,2,3,FMN 19 Binnensingel Oostkant
666,R10 414,2023-02-13,02:00:00,2,1,1,FMN 19 Binnensingel Oostkant
666,R10 414,2023-02-13,03:00:00,7,2,5,FMN 19 Binnensingel Oostkant
666,R10 414,2023-02-13,04:00:00,13,8,5,FMN 19 Binnensingel Oostkant
666,R10 414,2023-02-13,05:00:00,28,17,11,FMN 19 Binnensingel Oostkant
666,R10 414,2023-02-13,06:00:00,55,40,15,FMN 19 Binnensingel Oostkant
666,R10 414,2023-02-13,07:00:00,134,90,44,FMN 19 Binnensingel Oostkant
666,R10 414,2023-02-13,08:00:00,205,127,78,FMN 19 Binnensingel Oostkant
666,R10 414,2023-02-13,09:00:00,71,42,29,FMN 19 Binnensingel Oostkant
666,R10 414,2023-02-13,10:00:00,57,37,20,FMN 19 Binnensingel Oostkant
666,R10 414,2023-02-13,11:00:00,62,52,10,FMN 19 Binnensingel Oostkant
666,R10 414,2023-02-13,12:00:00,86,65,21,FMN 19 Binnensingel Oostkant
666,R10 414,2023-02-13,13:00:00,85,67,18,FMN 19 Binnensingel Oostkant
666,R10 414,2023-02-13,14:00:00,113,94,19,FMN 19 Binnensingel Oostkant
666,R10 414,2023-02-13,15:00:00,161,137,24,FMN 19 Binnensingel Oostkant
666,R10 414,2023-02-13,16:00:00,281,223,58,FMN 19 Binnensingel Oostkant
666,R10 414,2023-02-13,17:00:00,251,188,63,FMN 19 Binnensingel Oostkant
666,R10 414,2023-02-13,18:00:00,193,145,48,FMN 19 Binnensingel Oostkant
666,R10 414,2023-02-13,19:00:00,86,65,21,FMN 19 Binnensingel Oostkant
666,R10 414,2023-02-13,20:00:00,67,47,20,FMN 19 Binnensingel Oostkant
666,R10 414,2023-02-13,21:00:00,64,57,7,FMN 19 Binnensingel Oostkant
666,R10 414,2023-02-13,22:00:00,56,46,10,FMN 19 Binnensingel Oostkant
666,R10 414,2023-02-13,23:00:00,18,14,4,FMN 19 Binnensingel Oostkant
666,R10 414,2023-02-14,00:00:00,12,10,2,FMN 19 Binnensingel Oostkant
666,R10 414,2023-02-14,01:00:00,5,4,1,FMN 19 Binnensingel Oostkant
666,R10 414,2023-02-14,02:00:00,3,2,1,FMN 19 Binnensingel Oostkant
666,R10 414,2023-02-14,03:00:00,4,0,4,FMN 19 Binnensingel Oostkant
666,R10 414,2023-02-14,04:00:00,17,11,6,FMN 19 Binnensingel Oostkant
666,R10 414,2023-02-14,05:00:00,32,15,17,FMN 19 Binnensingel Oostkant
666,R10 414,2023-02-14,06:00:00,64,44,20,FMN 19 Binnensingel Oostkant
666,R10 414,2023-02-14,07:00:00,159,116,43,FMN 19 Binnensingel Oostkant
666,R10 414,2023-02-14,08:00:00,236,149,87,FMN 19 Binnensingel Oostkant
666,R10 414,2023-02-14,09:00:00,90,71,19,FMN 19 Binnensingel Oostkant
666,R10 414,2023-02-14,10:00:00,88,57,31,FMN 19 Binnensingel Oostkant
666,R10 414,2023-02-14,11:00:00,69,61,8,FMN 19 Binnensingel Oostkant
666,R10 414,2023-02-14,12:00:00,109,74,35,FMN 19 Binnensingel Oostkant
666,R10 414,2023-02-14,13:00:00,112,78,34,FMN 19 Binnensingel Oostkant
666,R10 414,2023-02-14,14:00:00,92,77,15,FMN 19 Binnensingel Oostkant
666,R10 414,2023-02-14,15:00:00,172,142,30,FMN 19 Binnensingel Oostkant
666,R10 414,2023-02-14,16:00:00,254,203,51,FMN 19 Binnensingel Oostkant
666,R10 414,2023-02-14,17:00:00,309,231,78,FMN 19 Binnensingel Oostkant
666,R10 414,2023-02-14,18:00:00,229,163,66,FMN 19 Binnensingel Oostkant
666,R10 414,2023-02-14,19:00:00,97,73,24,FMN 19 Binnensingel Oostkant
666,R10 414,2023-02-14,20:00:00,79,63,16,FMN 19 Binnensingel Oostkant
666,R10 414,2023-02-14,21:00:00,70,58,12,FMN 19 Binnensingel Oostkant
666,R10 414,2023-02-14,22:00:00,49,37,12,FMN 19 Binnensingel Oostkant
666,R10 414,2023-02-14,23:00:00,41,28,13,FMN 19 Binnensingel Oostkant
666,R10 414,2023-02-15,00:00:00,19,13,6,FMN 19 Binnensingel Oostkant
666,R10 414,2023-02-15,01:00:00,6,3,3,FMN 19 Binnensingel Oostkant
666,R10 414,2023-02-15,02:00:00,3,1,2,FMN 19 Binnensingel Oostkant
666,R10 414,2023-02-15,03:00:00,5,1,4,FMN 19 Binnensingel Oostkant
666,R10 414,2023-02-15,04:00:00,17,9,8,FMN 19 Binnensingel Oostkant
666,R10 414,2023-02-15,05:00:00,29,17,12,FMN 19 Binnensingel Oostkant
666,R10 414,2023-02-15,06:00:00,58,41,17,FMN 19 Binnensingel Oostkant
666,R10 414,2023-02-15,07:00:00,133,92,41,FMN 19 Binnensingel Oostkant
666,R10 414,2023-02-15,08:00:00,176,115,61,FMN 19 Binnensingel Oostkant
666,R10 414,2023-02-15,09:00:00,67,43,24,FMN 19 Binnensingel Oostkant
666,R10 414,2023-02-15,10:00:00,73,49,24,FMN 19 Binnensingel Oostkant
666,R10 414,2023-02-15,11:00:00,69,54,15,FMN 19 Binnensingel Oostkant
666,R10 414,2023-02-15,12:00:00,140,110,30,FMN 19 Binnensingel Oostkant
666,R10 414,2023-02-15,13:00:00,145,102,43,FMN 19 Binnensingel Oostkant
666,R10 414,2023-02-15,14:00:00,116,93,23,FMN 19 Binnensingel Oostkant
666,R10 414,2023-02-15,15:00:00,145,124,21,FMN 19 Binnensingel Oostkant
666,R10 414,2023-02-15,16:00:00,240,191,49,FMN 19 Binnensingel Oostkant
666,R10 414,2023-02-15,17:00:00,266,198,68,FMN 19 Binnensingel Oostkant
666,R10 414,2023-02-15,18:00:00,159,116,43,FMN 19 Binnensingel Oostkant
666,R10 414,2023-02-15,19:00:00,112,80,32,FMN 19 Binnensingel Oostkant
666,R10 414,2023-02-15,20:00:00,80,61,19,FMN 19 Binnensingel Oostkant
666,R10 414,2023-02-15,21:00:00,67,56,11,FMN 19 Binnensingel Oostkant
666,R10 414,2023-02-15,22:00:00,71,59,12,FMN 19 Binnensingel Oostkant
666,R10 414,2023-02-15,23:00:00,38,27,11,FMN 19 Binnensingel Oostkant
666,R10 414,2023-02-16,00:00:00,12,10,2,FMN 19 Binnensingel Oostkant
666,R10 414,2023-02-16,01:00:00,5,5,0,FMN 19 Binnensingel Oostkant
666,R10 414,2023-02-16,02:00:00,2,1,1,FMN 19 Binnensingel Oostkant
666,R10 414,2023-02-16,03:00:00,3,1,2,FMN 19 Binnensingel Oostkant
666,R10 414,2023-02-16,04:00:00,18,11,7,FMN 19 Binnensingel Oostkant
666,R10 414,2023-02-16,05:00:00,27,15,12,FMN 19 Binnensingel Oostkant
666,R10 414,2023-02-16,06:00:00,66,51,15,FMN 19 Binnensingel Oostkant
666,R10 414,2023-02-16,07:00:00,148,101,47,FMN 19 Binnensingel Oostkant
666,R10 414,2023-02-16,08:00:00,194,124,70,FMN 19 Binnensingel Oostkant
666,R10 414,2023-02-16,09:00:00,75,57,18,FMN 19 Binnensingel Oostkant
666,R10 414,2023-02-16,10:00:00,50,35,15,FMN 19 Binnensingel Oostkant
666,R10 414,2023-02-16,11:00:00,53,42,11,FMN 19 Binnensingel Oostkant
666,R10 414,2023-02-16,12:00:00,84,65,19,FMN 19 Binnensingel Oostkant
666,R10 414,2023-02-16,13:00:00,83,56,27,FMN 19 Binnensingel Oostkant
666,R10 414,2023-02-16,14:00:00,91,73,18,FMN 19 Binnensingel Oostkant
666,R10 414,2023-02-16,15:00:00,158,135,23,FMN 19 Binnensingel Oostkant
666,R10 414,2023-02-16,16:00:00,216,168,48,FMN 19 Binnensingel Oostkant
666,R10 414,2023-02-16,17:00:00,223,164,59,FMN 19 Binnensingel Oostkant
666,R10 414,2023-02-16,18:00:00,148,113,35,FMN 19 Binnensingel Oostkant
666,R10 414,2023-02-16,19:00:00,92,75,17,FMN 19 Binnensingel Oostkant
666,R10 414,2023-02-16,20:00:00,64,42,22,FMN 19 Binnensingel Oostkant
666,R10 414,2023-02-16,21:00:00,65,50,15,FMN 19 Binnensingel Oostkant
666,R10 414,2023-02-16,22:00:00,69,52,17,FMN 19 Binnensingel Oostkant
666,R10 414,2023-02-16,23:00:00,34,28,6,FMN 19 Binnensingel Oostkant
666,R10 414,2023-02-17,00:00:00,13,11,2,FMN 19 Binnensingel Oostkant
666,R10 414,2023-02-17,01:00:00,2,2,0,FMN 19 Binnensingel Oostkant
666,R10 414,2023-02-17,02:00:00,2,2,0,FMN 19 Binnensingel Oostkant
666,R10 414,2023-02-17,03:00:00,6,3,3,FMN 19 Binnensingel Oostkant
666,R10 414,2023-02-17,04:00:00,22,16,6,FMN 19 Binnensingel Oostkant
666,R10 414,2023-02-17,05:00:00,24,14,10,FMN 19 Binnensingel Oostkant
666,R10 414,2023-02-17,06:00:00,47,33,14,FMN 19 Binnensingel Oostkant
666,R10 414,2023-02-17,07:00:00,135,91,44,FMN 19 Binnensingel Oostkant
666,R10 414,2023-02-17,08:00:00,174,119,55,FMN 19 Binnensingel Oostkant
666,R10 414,2023-02-17,09:00:00,69,56,13,FMN 19 Binnensingel Oostkant
666,R10 414,2023-02-17,10:00:00,73,50,23,FMN 19 Binnensingel Oostkant
666,R10 414,2023-02-17,11:00:00,50,41,9,FMN 19 Binnensingel Oostkant
666,R10 414,2023-02-17,12:00:00,82,70,12,FMN 19 Binnensingel Oostkant
666,R10 414,2023-02-17,13:00:00,119,95,24,FMN 19 Binnensingel Oostkant
666,R10 414,2023-02-17,14:00:00,108,80,28,FMN 19 Binnensingel Oostkant
666,R10 414,2023-02-17,15:00:00,157,138,19,FMN 19 Binnensingel Oostkant
666,R10 414,2023-02-17,16:00:00,230,194,36,FMN 19 Binnensingel Oostkant
666,R10 414,2023-02-17,17:00:00,198,155,43,FMN 19 Binnensingel Oostkant
666,R10 414,2023-02-17,18:00:00,131,97,34,FMN 19 Binnensingel Oostkant
666,R10 414,2023-02-17,19:00:00,87,67,20,FMN 19 Binnensingel Oostkant
666,R10 414,2023-02-17,20:00:00,53,35,18,FMN 19 Binnensingel Oostkant
666,R10 414,2023-02-17,21:00:00,52,46,6,FMN 19 Binnensingel Oostkant
666,R10 414,2023-02-17,22:00:00,47,38,9,FMN 19 Binnensingel Oostkant
666,R10 414,2023-02-17,23:00:00,40,32,8,FMN 19 Binnensingel Oostkant
666,R10 414,2023-02-18,00:00:00,24,15,9,FMN 19 Binnensingel Oostkant
666,R10 414,2023-02-18,01:00:00,21,13,8,FMN 19 Binnensingel Oostkant
666,R10 414,2023-02-18,02:00:00,7,3,4,FMN 19 Binnensingel Oostkant
666,R10 414,2023-02-18,03:00:00,13,9,4,FMN 19 Binnensingel Oostkant
666,R10 414,2023-02-18,04:00:00,13,7,6,FMN 19 Binnensingel Oostkant
666,R10 414,2023-02-18,05:00:00,13,9,4,FMN 19 Binnensingel Oostkant
666,R10 414,2023-02-18,06:00:00,14,9,5,FMN 19 Binnensingel Oostkant
666,R10 414,2023-02-18,07:00:00,17,10,7,FMN 19 Binnensingel Oostkant
666,R10 414,2023-02-18,08:00:00,14,7,7,FMN 19 Binnensingel Oostkant
666,R10 414,2023-02-18,09:00:00,49,35,14,FMN 19 Binnensingel Oostkant
666,R10 414,2023-02-18,10:00:00,54,45,9,FMN 19 Binnensingel Oostkant
666,R10 414,2023-02-18,11:00:00,56,46,10,FMN 19 Binnensingel Oostkant
666,R10 414,2023-02-18,12:00:00,55,44,11,FMN 19 Binnensingel Oostkant
666,R10 414,2023-02-18,13:00:00,63,47,16,FMN 19 Binnensingel Oostkant
666,R10 414,2023-02-18,14:00:00,57,46,11,FMN 19 Binnensingel Oostkant
666,R10 414,2023-02-18,15:00:00,70,56,14,FMN 19 Binnensingel Oostkant
666,R10 414,2023-02-18,16:00:00,62,45,17,FMN 19 Binnensingel Oostkant
666,R10 414,2023-02-18,17:00:00,70,56,14,FMN 19 Binnensingel Oostkant
666,R10 414,2023-02-18,18:00:00,73,62,11,FMN 19 Binnensingel Oostkant
666,R10 414,2023-02-18,19:00:00,86,66,20,FMN 19 Binnensingel Oostkant
666,R10 414,2023-02-18,20:00:00,46,35,11,FMN 19 Binnensingel Oostkant
666,R10 414,2023-02-18,21:00:00,28,19,9,FMN 19 Binnensingel Oostkant
666,R10 414,2023-02-18,22:00:00,39,30,9,FMN 19 Binnensingel Oostkant
666,R10 414,2023-02-18,23:00:00,38,33,5,FMN 19 Binnensingel Oostkant
666,R10 414,2023-02-19,00:00:00,31,23,8,FMN 19 Binnensingel Oostkant
666,R10 414,2023-02-19,01:00:00,27,18,9,FMN 19 Binnensingel Oostkant
666,R10 414,2023-02-19,02:00:00,9,4,5,FMN 19 Binnensingel Oostkant
666,R10 414,2023-02-19,03:00:00,6,5,1,FMN 19 Binnensingel Oostkant
666,R10 414,2023-02-19,04:00:00,8,3,5,FMN 19 Binnensingel Oostkant
666,R10 414,2023-02-19,05:00:00,8,1,7,FMN 19 Binnensingel Oostkant
666,R10 414,2023-02-19,06:00:00,8,6,2,FMN 19 Binnensingel Oostkant
666,R10 414,2023-02-19,07:00:00,9,7,2,FMN 19 Binnensingel Oostkant
666,R10 414,2023-02-19,08:00:00,18,13,5,FMN 19 Binnensingel Oostkant
666,R10 414,2023-02-19,09:00:00,43,30,13,FMN 19 Binnensingel Oostkant
666,R10 414,2023-02-19,10:00:00,49,31,18,FMN 19 Binnensingel Oostkant
666,R10 414,2023-02-19,11:00:00,50,39,11,FMN 19 Binnensingel Oostkant
666,R10 414,2023-02-19,12:00:00,59,46,13,FMN 19 Binnensingel Oostkant
666,R10 414,2023-02-19,13:00:00,62,50,12,FMN 19 Binnensingel Oostkant
666,R10 414,2023-02-19,14:00:00,82,53,29,FMN 19 Binnensingel Oostkant
666,R10 414,2023-02-19,15:00:00,52,36,16,FMN 19 Binnensingel Oostkant
666,R10 414,2023-02-19,16:00:00,65,49,16,FMN 19 Binnensingel Oostkant
666,R10 414,2023-02-19,17:00:00,49,42,7,FMN 19 Binnensingel Oostkant
666,R10 414,2023-02-19,18:00:00,54,44,10,FMN 19 Binnensingel Oostkant
666,R10 414,2023-02-19,19:00:00,49,37,12,FMN 19 Binnensingel Oostkant
666,R10 414,2023-02-19,20:00:00,35,20,15,FMN 19 Binnensingel Oostkant
666,R10 414,2023-02-19,21:00:00,28,20,8,FMN 19 Binnensingel Oostkant
666,R10 414,2023-02-19,22:00:00,27,16,11,FMN 19 Binnensingel Oostkant
666,R10 414,2023-02-19,23:00:00,13,10,3,FMN 19 Binnensingel Oostkant
666,R10 414,2023-02-20,00:00:00,4,4,0,FMN 19 Binnensingel Oostkant
666,R10 414,2023-02-20,01:00:00,5,3,2,FMN 19 Binnensingel Oostkant
666,R10 414,2023-02-20,02:00:00,0,0,0,FMN 19 Binnensingel Oostkant
666,R10 414,2023-02-20,03:00:00,5,2,3,FMN 19 Binnensingel Oostkant
666,R10 414,2023-02-20,04:00:00,11,7,4,FMN 19 Binnensingel Oostkant
666,R10 414,2023-02-20,05:00:00,27,9,18,FMN 19 Binnensingel Oostkant
666,R10 414,2023-02-20,06:00:00,49,33,16,FMN 19 Binnensingel Oostkant
666,R10 414,2023-02-20,07:00:00,119,83,36,FMN 19 Binnensingel Oostkant
666,R10 414,2023-02-20,08:00:00,163,109,54,FMN 19 Binnensingel Oostkant
666,R10 414,2023-02-20,09:00:00,80,61,19,FMN 19 Binnensingel Oostkant
666,R10 414,2023-02-20,10:00:00,50,34,16,FMN 19 Binnensingel Oostkant
666,R10 414,2023-02-20,11:00:00,41,31,10,FMN 19 Binnensingel Oostkant
666,R10 414,2023-02-20,12:00:00,65,50,15,FMN 19 Binnensingel Oostkant
666,R10 414,2023-02-20,13:00:00,79,63,16,FMN 19 Binnensingel Oostkant
666,R10 414,2023-02-20,14:00:00,66,53,13,FMN 19 Binnensingel Oostkant
666,R10 414,2023-02-20,15:00:00,118,98,20,FMN 19 Binnensingel Oostkant
666,R10 414,2023-02-20,16:00:00,189,153,36,FMN 19 Binnensingel Oostkant
666,R10 414,2023-02-20,17:00:00,211,165,46,FMN 19 Binnensingel Oostkant
666,R10 414,2023-02-20,18:00:00,159,108,51,FMN 19 Binnensingel Oostkant
666,R10 414,2023-02-20,19:00:00,63,43,20,FMN 19 Binnensingel Oostkant
666,R10 414,2023-02-20,20:00:00,65,47,18,FMN 19 Binnensingel Oostkant
666,R10 414,2023-02-20,21:00:00,29,23,6,FMN 19 Binnensingel Oostkant
666,R10 414,2023-02-20,22:00:00,40,31,9,FMN 19 Binnensingel Oostkant
666,R10 414,2023-02-20,23:00:00,33,29,4,FMN 19 Binnensingel Oostkant
666,R10 414,2023-02-21,00:00:00,12,11,1,FMN 19 Binnensingel Oostkant
666,R10 414,2023-02-21,01:00:00,4,4,0,FMN 19 Binnensingel Oostkant
666,R10 414,2023-02-21,02:00:00,2,1,1,FMN 19 Binnensingel Oostkant
666,R10 414,2023-02-21,03:00:00,6,4,2,FMN 19 Binnensingel Oostkant
666,R10 414,2023-02-21,04:00:00,11,7,4,FMN 19 Binnensingel Oostkant
666,R10 414,2023-02-21,05:00:00,21,7,14,FMN 19 Binnensingel Oostkant
666,R10 414,2023-02-21,06:00:00,59,39,20,FMN 19 Binnensingel Oostkant
666,R10 414,2023-02-21,07:00:00,116,86,30,FMN 19 Binnensingel Oostkant
666,R10 414,2023-02-21,08:00:00,152,107,45,FMN 19 Binnensingel Oostkant
666,R10 414,2023-02-21,09:00:00,61,46,15,FMN 19 Binnensingel Oostkant
666,R10 414,2023-02-21,10:00:00,49,34,15,FMN 19 Binnensingel Oostkant
666,R10 414,2023-02-21,11:00:00,65,50,15,FMN 19 Binnensingel Oostkant
666,R10 414,2023-02-21,12:00:00,63,46,17,FMN 19 Binnensingel Oostkant
666,R10 414,2023-02-21,13:00:00,83,63,20,FMN 19 Binnensingel Oostkant
666,R10 414,2023-02-21,14:00:00,70,62,8,FMN 19 Binnensingel Oostkant
666,R10 414,2023-02-21,15:00:00,110,95,15,FMN 19 Binnensingel Oostkant
666,R10 414,2023-02-21,16:00:00,182,142,40,FMN 19 Binnensingel Oostkant
666,R10 414,2023-02-21,17:00:00,201,160,41,FMN 19 Binnensingel Oostkant
666,R10 414,2023-02-21,18:00:00,176,134,42,FMN 19 Binnensingel Oostkant
666,R10 414,2023-02-21,19:00:00,90,66,24,FMN 19 Binnensingel Oostkant
666,R10 414,2023-02-21,20:00:00,52,44,8,FMN 19 Binnensingel Oostkant
666,R10 414,2023-02-21,21:00:00,47,34,13,FMN 19 Binnensingel Oostkant
666,R10 414,2023-02-21,22:00:00,51,39,12,FMN 19 Binnensingel Oostkant
666,R10 414,2023-02-21,23:00:00,34,24,10,FMN 19 Binnensingel Oostkant
666,R10 414,2023-02-22,00:00:00,14,9,5,FMN 19 Binnensingel Oostkant
666,R10 414,2023-02-22,01:00:00,6,3,3,FMN 19 Binnensingel Oostkant
666,R10 414,2023-02-22,02:00:00,5,3,2,FMN 19 Binnensingel Oostkant
666,R10 414,2023-02-22,03:00:00,4,0,4,FMN 19 Binnensingel Oostkant
666,R10 414,2023-02-22,04:00:00,15,9,6,FMN 19 Binnensingel Oostkant
666,R10 414,2023-02-22,05:00:00,24,11,13,FMN 19 Binnensingel Oostkant
666,R10 414,2023-02-22,06:00:00,59,41,18,FMN 19 Binnensingel Oostkant
666,R10 414,2023-02-22,07:00:00,115,75,40,FMN 19 Binnensingel Oostkant
666,R10 414,2023-02-22,08:00:00,128,81,47,FMN 19 Binnensingel Oostkant
666,R10 414,2023-02-22,09:00:00,54,38,16,FMN 19 Binnensingel Oostkant
666,R10 414,2023-02-22,10:00:00,50,34,16,FMN 19 Binnensingel Oostkant
666,R10 414,2023-02-22,11:00:00,39,32,7,FMN 19 Binnensingel Oostkant
666,R10 414,2023-02-22,12:00:00,80,63,17,FMN 19 Binnensingel Oostkant
666,R10 414,2023-02-22,13:00:00,76,55,21,FMN 19 Binnensingel Oostkant
666,R10 414,2023-02-22,14:00:00,57,47,10,FMN 19 Binnensingel Oostkant
666,R10 414,2023-02-22,15:00:00,92,76,16,FMN 19 Binnensingel Oostkant
666,R10 414,2023-02-22,16:00:00,165,135,30,FMN 19 Binnensingel Oostkant
666,R10 414,2023-02-22,17:00:00,201,148,53,FMN 19 Binnensingel Oostkant
666,R10 414,2023-02-22,18:00:00,150,108,42,FMN 19 Binnensingel Oostkant
666,R10 414,2023-02-22,19:00:00,85,59,26,FMN 19 Binnensingel Oostkant
666,R10 414,2023-02-22,20:00:00,65,49,16,FMN 19 Binnensingel Oostkant
666,R10 414,2023-02-22,21:00:00,39,29,10,FMN 19 Binnensingel Oostkant
666,R10 414,2023-02-22,22:00:00,37,28,9,FMN 19 Binnensingel Oostkant
666,R10 414,2023-02-22,23:00:00,28,17,11,FMN 19 Binnensingel Oostkant
666,R10 414,2023-02-23,00:00:00,7,3,4,FMN 19 Binnensingel Oostkant
666,R10 414,2023-02-23,01:00:00,6,5,1,FMN 19 Binnensingel Oostkant
666,R10 414,2023-02-23,02:00:00,3,2,1,FMN 19 Binnensingel Oostkant
666,R10 414,2023-02-23,03:00:00,4,2,2,FMN 19 Binnensingel Oostkant
666,R10 414,2023-02-23,04:00:00,13,9,4,FMN 19 Binnensingel Oostkant
666,R10 414,2023-02-23,05:00:00,21,8,13,FMN 19 Binnensingel Oostkant
666,R10 414,2023-02-23,06:00:00,59,41,18,FMN 19 Binnensingel Oostkant
666,R10 414,2023-02-23,07:00:00,106,78,28,FMN 19 Binnensingel Oostkant
666,R10 414,2023-02-23,08:00:00,152,103,49,FMN 19 Binnensingel Oostkant
666,R10 414,2023-02-23,09:00:00,78,67,11,FMN 19 Binnensingel Oostkant
666,R10 414,2023-02-23,10:00:00,59,42,17,FMN 19 Binnensingel Oostkant
666,R10 414,2023-02-23,11:00:00,53,42,11,FMN 19 Binnensingel Oostkant
666,R10 414,2023-02-23,12:00:00,82,52,30,FMN 19 Binnensingel Oostkant
666,R10 414,2023-02-23,13:00:00,83,64,19,FMN 19 Binnensingel Oostkant
666,R10 414,2023-02-23,14:00:00,61,52,9,FMN 19 Binnensingel Oostkant
666,R10 414,2023-02-23,15:00:00,107,82,25,FMN 19 Binnensingel Oostkant
666,R10 414,2023-02-23,16:00:00,171,143,28,FMN 19 Binnensingel Oostkant
666,R10 414,2023-02-23,17:00:00,214,170,44,FMN 19 Binnensingel Oostkant
666,R10 414,2023-02-23,18:00:00,178,127,51,FMN 19 Binnensingel Oostkant
666,R10 414,2023-02-23,19:00:00,89,64,25,FMN 19 Binnensingel Oostkant
666,R10 414,2023-02-23,20:00:00,57,37,20,FMN 19 Binnensingel Oostkant
666,R10 414,2023-02-23,21:00:00,55,44,11,FMN 19 Binnensingel Oostkant
666,R10 414,2023-02-23,22:00:00,53,39,14,FMN 19 Binnensingel Oostkant
666,R10 414,2023-02-23,23:00:00,45,38,7,FMN 19 Binnensingel Oostkant
666,R10 414,2023-02-24,00:00:00,10,9,1,FMN 19 Binnensingel Oostkant
666,R10 414,2023-02-24,01:00:00,9,7,2,FMN 19 Binnensingel Oostkant
666,R10 414,2023-02-24,02:00:00,3,1,2,FMN 19 Binnensingel Oostkant
666,R10 414,2023-02-24,03:00:00,1,0,1,FMN 19 Binnensingel Oostkant
666,R10 414,2023-02-24,04:00:00,21,7,14,FMN 19 Binnensingel Oostkant
666,R10 414,2023-02-24,05:00:00,20,11,9,FMN 19 Binnensingel Oostkant
666,R10 414,2023-02-24,06:00:00,49,39,10,FMN 19 Binnensingel Oostkant
666,R10 414,2023-02-24,07:00:00,81,54,27,FMN 19 Binnensingel Oostkant
666,R10 414,2023-02-24,08:00:00,118,69,49,FMN 19 Binnensingel Oostkant
666,R10 414,2023-02-24,09:00:00,51,33,18,FMN 19 Binnensingel Oostkant
666,R10 414,2023-02-24,10:00:00,60,35,25,FMN 19 Binnensingel Oostkant
666,R10 414,2023-02-24,11:00:00,44,36,8,FMN 19 Binnensingel Oostkant
666,R10 414,2023-02-24,12:00:00,99,75,24,FMN 19 Binnensingel Oostkant
666,R10 414,2023-02-24,13:00:00,88,72,16,FMN 19 Binnensingel Oostkant
666,R10 414,2023-02-24,14:00:00,78,62,16,FMN 19 Binnensingel Oostkant
666,R10 414,2023-02-24,15:00:00,94,80,14,FMN 19 Binnensingel Oostkant
666,R10 414,2023-02-24,16:00:00,160,124,36,FMN 19 Binnensingel Oostkant
666,R10 414,2023-02-24,17:00:00,151,124,27,FMN 19 Binnensingel Oostkant
666,R10 414,2023-02-24,18:00:00,133,105,28,FMN 19 Binnensingel Oostkant
666,R10 414,2023-02-24,19:00:00,96,69,27,FMN 19 Binnensingel Oostkant
666,R10 414,2023-02-24,20:00:00,69,49,20,FMN 19 Binnensingel Oostkant
666,R10 414,2023-02-24,21:00:00,41,37,4,FMN 19 Binnensingel Oostkant
666,R10 414,2023-02-24,22:00:00,49,41,8,FMN 19 Binnensingel Oostkant
666,R10 414,2023-02-24,23:00:00,34,23,11,FMN 19 Binnensingel Oostkant
666,R10 414,2023-02-25,00:00:00,24,19,5,FMN 19 Binnensingel Oostkant
666,R10 414,2023-02-25,01:00:00,16,11,5,FMN 19 Binnensingel Oostkant
666,R10 414,2023-02-25,02:00:00,15,10,5,FMN 19 Binnensingel Oostkant
666,R10 414,2023-02-25,03:00:00,15,8,7,FMN 19 Binnensingel Oostkant
666,R10 414,2023-02-25,04:00:00,24,14,10,FMN 19 Binnensingel Oostkant
666,R10 414,2023-02-25,05:00:00,11,4,7,FMN 19 Binnensingel Oostkant
666,R10 414,2023-02-25,06:00:00,14,7,7,FMN 19 Binnensingel Oostkant
666,R10 414,2023-02-25,07:00:00,21,13,8,FMN 19 Binnensingel Oostkant
666,R10 414,2023-02-25,08:00:00,28,16,12,FMN 19 Binnensingel Oostkant
666,R10 414,2023-02-25,09:00:00,41,30,11,FMN 19 Binnensingel Oostkant
666,R10 414,2023-02-25,10:00:00,56,42,14,FMN 19 Binnensingel Oostkant
666,R10 414,2023-02-25,11:00:00,46,35,11,FMN 19 Binnensingel Oostkant
666,R10 414,2023-02-25,12:00:00,66,49,17,FMN 19 Binnensingel Oostkant
666,R10 414,2023-02-25,13:00:00,71,59,12,FMN 19 Binnensingel Oostkant
666,R10 414,2023-02-25,14:00:00,68,50,18,FMN 19 Binnensingel Oostkant
666,R10 414,2023-02-25,15:00:00,64,49,15,FMN 19 Binnensingel Oostkant
666,R10 414,2023-02-25,16:00:00,59,54,5,FMN 19 Binnensingel Oostkant
666,R10 414,2023-02-25,17:00:00,66,55,11,FMN 19 Binnensingel Oostkant
666,R10 414,2023-02-25,18:00:00,50,44,6,FMN 19 Binnensingel Oostkant
666,R10 414,2023-02-25,19:00:00,56,42,14,FMN 19 Binnensingel Oostkant
666,R10 414,2023-02-25,20:00:00,38,27,11,FMN 19 Binnensingel Oostkant
666,R10 414,2023-02-25,21:00:00,28,20,8,FMN 19 Binnensingel Oostkant
666,R10 414,2023-02-25,22:00:00,42,26,16,FMN 19 Binnensingel Oostkant
666,R10 414,2023-02-25,23:00:00,22,16,6,FMN 19 Binnensingel Oostkant
666,R10 414,2023-02-26,00:00:00,29,25,4,FMN 19 Binnensingel Oostkant
666,R10 414,2023-02-26,01:00:00,14,9,5,FMN 19 Binnensingel Oostkant
666,R10 414,2023-02-26,02:00:00,13,11,2,FMN 19 Binnensingel Oostkant
666,R10 414,2023-02-26,03:00:00,8,4,4,FMN 19 Binnensingel Oostkant
666,R10 414,2023-02-26,04:00:00,3,2,1,FMN 19 Binnensingel Oostkant
666,R10 414,2023-02-26,05:00:00,12,9,3,FMN 19 Binnensingel Oostkant
666,R10 414,2023-02-26,06:00:00,10,7,3,FMN 19 Binnensingel Oostkant
666,R10 414,2023-02-26,07:00:00,9,4,5,FMN 19 Binnensingel Oostkant
666,R10 414,2023-02-26,08:00:00,17,11,6,FMN 19 Binnensingel Oostkant
666,R10 414,2023-02-26,09:00:00,37,26,11,FMN 19 Binnensingel Oostkant
666,R10 414,2023-02-26,10:00:00,41,28,13,FMN 19 Binnensingel Oostkant
666,R10 414,2023-02-26,11:00:00,33,20,13,FMN 19 Binnensingel Oostkant
666,R10 414,2023-02-26,12:00:00,45,35,10,FMN 19 Binnensingel Oostkant
666,R10 414,2023-02-26,13:00:00,42,31,11,FMN 19 Binnensingel Oostkant
666,R10 414,2023-02-26,14:00:00,51,28,23,FMN 19 Binnensingel Oostkant
666,R10 414,2023-02-26,15:00:00,56,41,15,FMN 19 Binnensingel Oostkant
666,R10 414,2023-02-26,16:00:00,64,50,14,FMN 19 Binnensingel Oostkant
666,R10 414,2023-02-26,17:00:00,60,47,13,FMN 19 Binnensingel Oostkant
666,R10 414,2023-02-26,18:00:00,47,33,14,FMN 19 Binnensingel Oostkant
666,R10 414,2023-02-26,19:00:00,47,27,20,FMN 19 Binnensingel Oostkant
666,R10 414,2023-02-26,20:00:00,33,25,8,FMN 19 Binnensingel Oostkant
666,R10 414,2023-02-26,21:00:00,31,20,11,FMN 19 Binnensingel Oostkant
666,R10 414,2023-02-26,22:00:00,18,13,5,FMN 19 Binnensingel Oostkant
666,R10 414,2023-02-26,23:00:00,11,9,2,FMN 19 Binnensingel Oostkant
666,R10 414,2023-02-27,00:00:00,3,3,0,FMN 19 Binnensingel Oostkant
666,R10 414,2023-02-27,01:00:00,3,3,0,FMN 19 Binnensingel Oostkant
666,R10 414,2023-02-27,02:00:00,2,1,1,FMN 19 Binnensingel Oostkant
666,R10 414,2023-02-27,03:00:00,6,4,2,FMN 19 Binnensingel Oostkant
666,R10 414,2023-02-27,04:00:00,18,7,11,FMN 19 Binnensingel Oostkant
666,R10 414,2023-02-27,05:00:00,21,13,8,FMN 19 Binnensingel Oostkant
666,R10 414,2023-02-27,06:00:00,53,35,18,FMN 19 Binnensingel Oostkant
666,R10 414,2023-02-27,07:00:00,139,96,43,FMN 19 Binnensingel Oostkant
666,R10 414,2023-02-27,08:00:00,198,128,70,FMN 19 Binnensingel Oostkant
666,R10 414,2023-02-27,09:00:00,90,48,42,FMN 19 Binnensingel Oostkant
666,R10 414,2023-02-27,10:00:00,57,37,20,FMN 19 Binnensingel Oostkant
666,R10 414,2023-02-27,11:00:00,54,40,14,FMN 19 Binnensingel Oostkant
666,R10 414,2023-02-27,12:00:00,90,61,29,FMN 19 Binnensingel Oostkant
666,R10 414,2023-02-27,13:00:00,90,69,21,FMN 19 Binnensingel Oostkant
666,R10 414,2023-02-27,14:00:00,82,65,17,FMN 19 Binnensingel Oostkant
666,R10 414,2023-02-27,15:00:00,140,126,14,FMN 19 Binnensingel Oostkant
666,R10 414,2023-02-27,16:00:00,237,199,38,FMN 19 Binnensingel Oostkant
666,R10 414,2023-02-27,17:00:00,245,189,56,FMN 19 Binnensingel Oostkant
666,R10 414,2023-02-27,18:00:00,208,154,54,FMN 19 Binnensingel Oostkant
666,R10 414,2023-02-27,19:00:00,83,64,19,FMN 19 Binnensingel Oostkant
666,R10 414,2023-02-27,20:00:00,62,50,12,FMN 19 Binnensingel Oostkant
666,R10 414,2023-02-27,21:00:00,57,45,12,FMN 19 Binnensingel Oostkant
666,R10 414,2023-02-27,22:00:00,47,37,10,FMN 19 Binnensingel Oostkant
666,R10 414,2023-02-27,23:00:00,12,10,2,FMN 19 Binnensingel Oostkant
666,R10 414,2023-02-28,00:00:00,7,6,1,FMN 19 Binnensingel Oostkant
666,R10 414,2023-02-28,01:00:00,2,1,1,FMN 19 Binnensingel Oostkant
666,R10 414,2023-02-28,02:00:00,2,2,0,FMN 19 Binnensingel Oostkant
666,R10 414,2023-02-28,03:00:00,3,0,3,FMN 19 Binnensingel Oostkant
666,R10 414,2023-02-28,04:00:00,16,7,9,FMN 19 Binnensingel Oostkant
666,R10 414,2023-02-28,05:00:00,21,10,11,FMN 19 Binnensingel Oostkant
666,R10 414,2023-02-28,06:00:00,55,38,17,FMN 19 Binnensingel Oostkant
666,R10 414,2023-02-28,07:00:00,165,114,51,FMN 19 Binnensingel Oostkant
666,R10 414,2023-02-28,08:00:00,226,157,69,FMN 19 Binnensingel Oostkant
666,R10 414,2023-02-28,09:00:00,85,48,37,FMN 19 Binnensingel Oostkant
666,R10 414,2023-02-28,10:00:00,71,48,23,FMN 19 Binnensingel Oostkant
666,R10 414,2023-02-28,11:00:00,53,35,18,FMN 19 Binnensingel Oostkant
666,R10 414,2023-02-28,12:00:00,98,64,34,FMN 19 Binnensingel Oostkant
666,R10 414,2023-02-28,13:00:00,92,73,19,FMN 19 Binnensingel Oostkant
666,R10 414,2023-02-28,14:00:00,100,78,22,FMN 19 Binnensingel Oostkant
666,R10 414,2023-02-28,15:00:00,133,117,16,FMN 19 Binnensingel Oostkant
666,R10 414,2023-02-28,16:00:00,257,212,45,FMN 19 Binnensingel Oostkant
666,R10 414,2023-02-28,17:00:00,232,178,54,FMN 19 Binnensingel Oostkant
666,R10 414,2023-02-28,18:00:00,274,216,58,FMN 19 Binnensingel Oostkant
666,R10 414,2023-02-28,19:00:00,97,82,15,FMN 19 Binnensingel Oostkant
666,R10 414,2023-02-28,20:00:00,65,47,18,FMN 19 Binnensingel Oostkant
666,R10 414,2023-02-28,21:00:00,70,53,17,FMN 19 Binnensingel Oostkant
666,R10 414,2023-02-28,22:00:00,56,47,9,FMN 19 Binnensingel Oostkant
666,R10 414,2023-02-28,23:00:00,23,18,5,FMN 19 Binnensingel Oostkant
666,R10 414,2023-03-01,00:00:00,9,8,1,FMN 19 Binnensingel Oostkant
666,R10 414,2023-03-01,01:00:00,8,6,2,FMN 19 Binnensingel Oostkant
666,R10 414,2023-03-01,02:00:00,2,1,1,FMN 19 Binnensingel Oostkant
666,R10 414,2023-03-01,03:00:00,7,3,4,FMN 19 Binnensingel Oostkant
666,R10 414,2023-03-01,04:00:00,12,8,4,FMN 19 Binnensingel Oostkant
666,R10 414,2023-03-01,05:00:00,27,11,16,FMN 19 Binnensingel Oostkant
666,R10 414,2023-03-01,06:00:00,45,33,12,FMN 19 Binnensingel Oostkant
666,R10 414,2023-03-01,07:00:00,116,79,37,FMN 19 Binnensingel Oostkant
666,R10 414,2023-03-01,08:00:00,163,102,61,FMN 19 Binnensingel Oostkant
666,R10 414,2023-03-01,09:00:00,72,54,18,FMN 19 Binnensingel Oostkant
666,R10 414,2023-03-01,10:00:00,55,39,16,FMN 19 Binnensingel Oostkant
666,R10 414,2023-03-01,11:00:00,73,61,12,FMN 19 Binnensingel Oostkant
666,R10 414,2023-03-01,12:00:00,146,117,29,FMN 19 Binnensingel Oostkant
666,R10 414,2023-03-01,13:00:00,118,92,26,FMN 19 Binnensingel Oostkant
666,R10 414,2023-03-01,14:00:00,81,63,18,FMN 19 Binnensingel Oostkant
666,R10 414,2023-03-01,15:00:00,116,95,21,FMN 19 Binnensingel Oostkant
666,R10 414,2023-03-01,16:00:00,210,172,38,FMN 19 Binnensingel Oostkant
666,R10 414,2023-03-01,17:00:00,230,179,51,FMN 19 Binnensingel Oostkant
666,R10 414,2023-03-01,18:00:00,147,103,44,FMN 19 Binnensingel Oostkant
666,R10 414,2023-03-01,19:00:00,101,71,30,FMN 19 Binnensingel Oostkant
666,R10 414,2023-03-01,20:00:00,63,47,16,FMN 19 Binnensingel Oostkant
666,R10 414,2023-03-01,21:00:00,64,53,11,FMN 19 Binnensingel Oostkant
666,R10 414,2023-03-01,22:00:00,65,55,10,FMN 19 Binnensingel Oostkant
666,R10 414,2023-03-01,23:00:00,19,17,2,FMN 19 Binnensingel Oostkant
666,R10 414,2023-03-02,00:00:00,18,11,7,FMN 19 Binnensingel Oostkant
666,R10 414,2023-03-02,01:00:00,5,5,0,FMN 19 Binnensingel Oostkant
666,R10 414,2023-03-02,02:00:00,2,2,0,FMN 19 Binnensingel Oostkant
666,R10 414,2023-03-02,03:00:00,6,3,3,FMN 19 Binnensingel Oostkant
666,R10 414,2023-03-02,04:00:00,11,6,5,FMN 19 Binnensingel Oostkant
666,R10 414,2023-03-02,05:00:00,25,13,12,FMN 19 Binnensingel Oostkant
666,R10 414,2023-03-02,06:00:00,50,35,15,FMN 19 Binnensingel Oostkant
666,R10 414,2023-03-02,07:00:00,138,106,32,FMN 19 Binnensingel Oostkant
666,R10 414,2023-03-02,08:00:00,210,139,71,FMN 19 Binnensingel Oostkant
666,R10 414,2023-03-02,09:00:00,68,48,20,FMN 19 Binnensingel Oostkant
666,R10 414,2023-03-02,10:00:00,52,32,20,FMN 19 Binnensingel Oostkant
666,R10 414,2023-03-02,11:00:00,76,51,25,FMN 19 Binnensingel Oostkant
666,R10 414,2023-03-02,12:00:00,102,79,23,FMN 19 Binnensingel Oostkant
666,R10 414,2023-03-02,13:00:00,96,64,32,FMN 19 Binnensingel Oostkant
666,R10 414,2023-03-02,14:00:00,83,65,18,FMN 19 Binnensingel Oostkant
666,R10 414,2023-03-02,15:00:00,161,133,28,FMN 19 Binnensingel Oostkant
666,R10 414,2023-03-02,16:00:00,237,180,57,FMN 19 Binnensingel Oostkant
666,R10 414,2023-03-02,17:00:00,261,212,49,FMN 19 Binnensingel Oostkant
666,R10 414,2023-03-02,18:00:00,187,142,45,FMN 19 Binnensingel Oostkant
666,R10 414,2023-03-02,19:00:00,132,105,27,FMN 19 Binnensingel Oostkant
666,R10 414,2023-03-02,20:00:00,71,52,19,FMN 19 Binnensingel Oostkant
666,R10 414,2023-03-02,21:00:00,100,83,17,FMN 19 Binnensingel Oostkant
666,R10 414,2023-03-02,22:00:00,62,47,15,FMN 19 Binnensingel Oostkant
666,R10 414,2023-03-02,23:00:00,23,18,5,FMN 19 Binnensingel Oostkant
666,R10 414,2023-03-03,00:00:00,25,10,15,FMN 19 Binnensingel Oostkant
666,R10 414,2023-03-03,01:00:00,10,4,6,FMN 19 Binnensingel Oostkant
666,R10 414,2023-03-03,02:00:00,2,2,0,FMN 19 Binnensingel Oostkant
666,R10 414,2023-03-03,03:00:00,6,3,3,FMN 19 Binnensingel Oostkant
666,R10 414,2023-03-03,04:00:00,12,7,5,FMN 19 Binnensingel Oostkant
666,R10 414,2023-03-03,05:00:00,29,17,12,FMN 19 Binnensingel Oostkant
666,R10 414,2023-03-03,06:00:00,49,40,9,FMN 19 Binnensingel Oostkant
666,R10 414,2023-03-03,07:00:00,120,79,41,FMN 19 Binnensingel Oostkant
666,R10 414,2023-03-03,08:00:00,183,117,66,FMN 19 Binnensingel Oostkant
666,R10 414,2023-03-03,09:00:00,81,53,28,FMN 19 Binnensingel Oostkant
666,R10 414,2023-03-03,10:00:00,56,39,17,FMN 19 Binnensingel Oostkant
666,R10 414,2023-03-03,11:00:00,54,38,16,FMN 19 Binnensingel Oostkant
666,R10 414,2023-03-03,12:00:00,95,72,23,FMN 19 Binnensingel Oostkant
666,R10 414,2023-03-03,13:00:00,113,85,28,FMN 19 Binnensingel Oostkant
666,R10 414,2023-03-03,14:00:00,75,59,16,FMN 19 Binnensingel Oostkant
666,R10 414,2023-03-03,15:00:00,160,141,19,FMN 19 Binnensingel Oostkant
666,R10 414,2023-03-03,16:00:00,221,174,47,FMN 19 Binnensingel Oostkant
666,R10 414,2023-03-03,17:00:00,254,208,46,FMN 19 Binnensingel Oostkant
666,R10 414,2023-03-03,18:00:00,192,143,49,FMN 19 Binnensingel Oostkant
666,R10 414,2023-03-03,19:00:00,91,72,19,FMN 19 Binnensingel Oostkant
666,R10 414,2023-03-03,20:00:00,79,54,25,FMN 19 Binnensingel Oostkant
666,R10 414,2023-03-03,21:00:00,41,33,8,FMN 19 Binnensingel Oostkant
666,R10 414,2023-03-03,22:00:00,59,48,11,FMN 19 Binnensingel Oostkant
666,R10 414,2023-03-03,23:00:00,42,32,10,FMN 19 Binnensingel Oostkant
666,R10 414,2023-03-04,00:00:00,25,23,2,FMN 19 Binnensingel Oostkant
666,R10 414,2023-03-04,01:00:00,19,14,5,FMN 19 Binnensingel Oostkant
666,R10 414,2023-03-04,02:00:00,16,7,9,FMN 19 Binnensingel Oostkant
666,R10 414,2023-03-04,03:00:00,16,12,4,FMN 19 Binnensingel Oostkant
666,R10 414,2023-03-04,04:00:00,12,9,3,FMN 19 Binnensingel Oostkant
666,R10 414,2023-03-04,05:00:00,9,5,4,FMN 19 Binnensingel Oostkant
666,R10 414,2023-03-04,06:00:00,19,9,10,FMN 19 Binnensingel Oostkant
666,R10 414,2023-03-04,07:00:00,28,19,9,FMN 19 Binnensingel Oostkant
666,R10 414,2023-03-04,08:00:00,28,16,12,FMN 19 Binnensingel Oostkant
666,R10 414,2023-03-04,09:00:00,59,44,15,FMN 19 Binnensingel Oostkant
666,R10 414,2023-03-04,10:00:00,46,34,12,FMN 19 Binnensingel Oostkant
666,R10 414,2023-03-04,11:00:00,65,49,16,FMN 19 Binnensingel Oostkant
666,R10 414,2023-03-04,12:00:00,64,51,13,FMN 19 Binnensingel Oostkant
666,R10 414,2023-03-04,13:00:00,57,44,13,FMN 19 Binnensingel Oostkant
666,R10 414,2023-03-04,14:00:00,55,44,11,FMN 19 Binnensingel Oostkant
666,R10 414,2023-03-04,15:00:00,70,54,16,FMN 19 Binnensingel Oostkant
666,R10 414,2023-03-04,16:00:00,59,42,17,FMN 19 Binnensingel Oostkant
666,R10 414,2023-03-04,17:00:00,60,50,10,FMN 19 Binnensingel Oostkant
666,R10 414,2023-03-04,18:00:00,68,48,20,FMN 19 Binnensingel Oostkant
666,R10 414,2023-03-04,19:00:00,64,47,17,FMN 19 Binnensingel Oostkant
666,R10 414,2023-03-04,20:00:00,54,48,6,FMN 19 Binnensingel Oostkant
666,R10 414,2023-03-04,21:00:00,37,24,13,FMN 19 Binnensingel Oostkant
666,R10 414,2023-03-04,22:00:00,39,37,2,FMN 19 Binnensingel Oostkant
666,R10 414,2023-03-04,23:00:00,48,30,18,FMN 19 Binnensingel Oostkant
666,R10 414,2023-03-05,00:00:00,27,17,10,FMN 19 Binnensingel Oostkant
666,R10 414,2023-03-05,01:00:00,20,14,6,FMN 19 Binnensingel Oostkant
666,R10 414,2023-03-05,02:00:00,7,5,2,FMN 19 Binnensingel Oostkant
666,R10 414,2023-03-05,03:00:00,4,1,3,FMN 19 Binnensingel Oostkant
666,R10 414,2023-03-05,04:00:00,6,5,1,FMN 19 Binnensingel Oostkant
666,R10 414,2023-03-05,05:00:00,6,2,4,FMN 19 Binnensingel Oostkant
666,R10 414,2023-03-05,06:00:00,7,4,3,FMN 19 Binnensingel Oostkant
666,R10 414,2023-03-05,07:00:00,13,9,4,FMN 19 Binnensingel Oostkant
666,R10 414,2023-03-05,08:00:00,17,9,8,FMN 19 Binnensingel Oostkant
666,R10 414,2023-03-05,09:00:00,26,17,9,FMN 19 Binnensingel Oostkant
666,R10 414,2023-03-05,10:00:00,31,22,9,FMN 19 Binnensingel Oostkant
666,R10 414,2023-03-05,11:00:00,37,23,14,FMN 19 Binnensingel Oostkant
666,R10 414,2023-03-05,12:00:00,47,41,6,FMN 19 Binnensingel Oostkant
666,R10 414,2023-03-05,13:00:00,45,37,8,FMN 19 Binnensingel Oostkant
666,R10 414,2023-03-05,14:00:00,42,34,8,FMN 19 Binnensingel Oostkant
666,R10 414,2023-03-05,15:00:00,67,59,8,FMN 19 Binnensingel Oostkant
666,R10 414,2023-03-05,16:00:00,44,28,16,FMN 19 Binnensingel Oostkant
666,R10 414,2023-03-05,17:00:00,37,23,14,FMN 19 Binnensingel Oostkant
666,R10 414,2023-03-05,18:00:00,59,38,21,FMN 19 Binnensingel Oostkant
666,R10 414,2023-03-05,19:00:00,37,24,13,FMN 19 Binnensingel Oostkant
666,R10 414,2023-03-05,20:00:00,38,32,6,FMN 19 Binnensingel Oostkant
666,R10 414,2023-03-05,21:00:00,34,25,9,FMN 19 Binnensingel Oostkant
666,R10 414,2023-03-05,22:00:00,18,13,5,FMN 19 Binnensingel Oostkant
666,R10 414,2023-03-05,23:00:00,14,8,6,FMN 19 Binnensingel Oostkant
666,R10 414,2023-03-06,00:00:00,0,0,0,FMN 19 Binnensingel Oostkant
666,R10 414,2023-03-06,01:00:00,4,4,0,FMN 19 Binnensingel Oostkant
666,R10 414,2023-03-06,02:00:00,1,1,0,FMN 19 Binnensingel Oostkant
666,R10 414,2023-03-06,03:00:00,6,4,2,FMN 19 Binnensingel Oostkant
666,R10 414,2023-03-06,04:00:00,8,6,2,FMN 19 Binnensingel Oostkant
666,R10 414,2023-03-06,05:00:00,28,10,18,FMN 19 Binnensingel Oostkant
666,R10 414,2023-03-06,06:00:00,51,39,12,FMN 19 Binnensingel Oostkant
666,R10 414,2023-03-06,07:00:00,143,101,42,FMN 19 Binnensingel Oostkant
666,R10 414,2023-03-06,08:00:00,209,134,75,FMN 19 Binnensingel Oostkant
666,R10 414,2023-03-06,09:00:00,77,50,27,FMN 19 Binnensingel Oostkant
666,R10 414,2023-03-06,10:00:00,53,33,20,FMN 19 Binnensingel Oostkant
666,R10 414,2023-03-06,11:00:00,49,41,8,FMN 19 Binnensingel Oostkant
666,R10 414,2023-03-06,12:00:00,80,58,22,FMN 19 Binnensingel Oostkant
666,R10 414,2023-03-06,13:00:00,91,63,28,FMN 19 Binnensingel Oostkant
666,R10 414,2023-03-06,14:00:00,87,63,24,FMN 19 Binnensingel Oostkant
666,R10 414,2023-03-06,15:00:00,141,115,26,FMN 19 Binnensingel Oostkant
666,R10 414,2023-03-06,16:00:00,228,178,50,FMN 19 Binnensingel Oostkant
666,R10 414,2023-03-06,17:00:00,255,203,52,FMN 19 Binnensingel Oostkant
666,R10 414,2023-03-06,18:00:00,177,129,48,FMN 19 Binnensingel Oostkant
666,R10 414,2023-03-06,19:00:00,66,48,18,FMN 19 Binnensingel Oostkant
666,R10 414,2023-03-06,20:00:00,43,30,13,FMN 19 Binnensingel Oostkant
666,R10 414,2023-03-06,21:00:00,54,51,3,FMN 19 Binnensingel Oostkant
666,R10 414,2023-03-06,22:00:00,49,36,13,FMN 19 Binnensingel Oostkant
666,R10 414,2023-03-06,23:00:00,14,11,3,FMN 19 Binnensingel Oostkant
666,R10 414,2023-03-07,00:00:00,2,2,0,FMN 19 Binnensingel Oostkant
666,R10 414,2023-03-07,01:00:00,9,7,2,FMN 19 Binnensingel Oostkant
666,R10 414,2023-03-07,02:00:00,3,2,1,FMN 19 Binnensingel Oostkant
666,R10 414,2023-03-07,03:00:00,6,3,3,FMN 19 Binnensingel Oostkant
666,R10 414,2023-03-07,04:00:00,7,6,1,FMN 19 Binnensingel Oostkant
666,R10 414,2023-03-07,05:00:00,20,7,13,FMN 19 Binnensingel Oostkant
666,R10 414,2023-03-07,06:00:00,57,41,16,FMN 19 Binnensingel Oostkant
666,R10 414,2023-03-07,07:00:00,138,98,40,FMN 19 Binnensingel Oostkant
666,R10 414,2023-03-07,08:00:00,163,105,58,FMN 19 Binnensingel Oostkant
666,R10 414,2023-03-07,09:00:00,70,56,14,FMN 19 Binnensingel Oostkant
666,R10 414,2023-03-07,10:00:00,40,26,14,FMN 19 Binnensingel Oostkant
666,R10 414,2023-03-07,11:00:00,53,39,14,FMN 19 Binnensingel Oostkant
666,R10 414,2023-03-07,12:00:00,73,52,21,FMN 19 Binnensingel Oostkant
666,R10 414,2023-03-07,13:00:00,63,51,12,FMN 19 Binnensingel Oostkant
666,R10 414,2023-03-07,14:00:00,50,39,11,FMN 19 Binnensingel Oostkant
666,R10 414,2023-03-07,15:00:00,82,65,17,FMN 19 Binnensingel Oostkant
666,R10 414,2023-03-07,16:00:00,187,160,27,FMN 19 Binnensingel Oostkant
666,R10 414,2023-03-07,17:00:00,199,145,54,FMN 19 Binnensingel Oostkant
666,R10 414,2023-03-07,18:00:00,153,112,41,FMN 19 Binnensingel Oostkant
666,R10 414,2023-03-07,19:00:00,63,46,17,FMN 19 Binnensingel Oostkant
666,R10 414,2023-03-07,20:00:00,49,34,15,FMN 19 Binnensingel Oostkant
666,R10 414,2023-03-07,21:00:00,76,63,13,FMN 19 Binnensingel Oostkant
666,R10 414,2023-03-07,22:00:00,58,48,10,FMN 19 Binnensingel Oostkant
666,R10 414,2023-03-07,23:00:00,18,15,3,FMN 19 Binnensingel Oostkant
666,R10 414,2023-03-08,00:00:00,2,1,1,FMN 19 Binnensingel Oostkant
666,R10 414,2023-03-08,01:00:00,5,4,1,FMN 19 Binnensingel Oostkant
666,R10 414,2023-03-08,02:00:00,0,0,0,FMN 19 Binnensingel Oostkant
666,R10 414,2023-03-08,03:00:00,5,4,1,FMN 19 Binnensingel Oostkant
666,R10 414,2023-03-08,04:00:00,10,6,4,FMN 19 Binnensingel Oostkant
666,R10 414,2023-03-08,05:00:00,14,6,8,FMN 19 Binnensingel Oostkant
666,R10 414,2023-03-08,06:00:00,42,31,11,FMN 19 Binnensingel Oostkant
666,R10 414,2023-03-08,07:00:00,89,62,27,FMN 19 Binnensingel Oostkant
666,R10 414,2023-03-08,08:00:00,99,73,26,FMN 19 Binnensingel Oostkant
666,R10 414,2023-03-08,09:00:00,49,31,18,FMN 19 Binnensingel Oostkant
666,R10 414,2023-03-08,10:00:00,37,27,10,FMN 19 Binnensingel Oostkant
666,R10 414,2023-03-08,11:00:00,39,29,10,FMN 19 Binnensingel Oostkant
666,R10 414,2023-03-08,12:00:00,88,67,21,FMN 19 Binnensingel Oostkant
666,R10 414,2023-03-08,13:00:00,73,60,13,FMN 19 Binnensingel Oostkant
666,R10 414,2023-03-08,14:00:00,69,51,18,FMN 19 Binnensingel Oostkant
666,R10 414,2023-03-08,15:00:00,62,49,13,FMN 19 Binnensingel Oostkant
666,R10 414,2023-03-08,16:00:00,150,123,27,FMN 19 Binnensingel Oostkant
666,R10 414,2023-03-08,17:00:00,151,117,34,FMN 19 Binnensingel Oostkant
666,R10 414,2023-03-08,18:00:00,108,73,35,FMN 19 Binnensingel Oostkant
666,R10 414,2023-03-08,19:00:00,52,41,11,FMN 19 Binnensingel Oostkant
666,R10 414,2023-03-08,20:00:00,37,29,8,FMN 19 Binnensingel Oostkant
666,R10 414,2023-03-08,21:00:00,54,50,4,FMN 19 Binnensingel Oostkant
666,R10 414,2023-03-08,22:00:00,36,30,6,FMN 19 Binnensingel Oostkant
666,R10 414,2023-03-08,23:00:00,22,19,3,FMN 19 Binnensingel Oostkant
666,R10 414,2023-03-09,00:00:00,6,5,1,FMN 19 Binnensingel Oostkant
666,R10 414,2023-03-09,01:00:00,10,4,6,FMN 19 Binnensingel Oostkant
666,R10 414,2023-03-09,02:00:00,3,2,1,FMN 19 Binnensingel Oostkant
666,R10 414,2023-03-09,03:00:00,3,1,2,FMN 19 Binnensingel Oostkant
666,R10 414,2023-03-09,04:00:00,13,9,4,FMN 19 Binnensingel Oostkant
666,R10 414,2023-03-09,05:00:00,17,5,12,FMN 19 Binnensingel Oostkant
666,R10 414,2023-03-09,06:00:00,59,43,16,FMN 19 Binnensingel Oostkant
666,R10 414,2023-03-09,07:00:00,131,90,41,FMN 19 Binnensingel Oostkant
666,R10 414,2023-03-09,08:00:00,150,99,51,FMN 19 Binnensingel Oostkant
666,R10 414,2023-03-09,09:00:00,58,44,14,FMN 19 Binnensingel Oostkant
666,R10 414,2023-03-09,10:00:00,55,39,16,FMN 19 Binnensingel Oostkant
666,R10 414,2023-03-09,11:00:00,37,28,9,FMN 19 Binnensingel Oostkant
666,R10 414,2023-03-09,12:00:00,75,58,17,FMN 19 Binnensingel Oostkant
666,R10 414,2023-03-09,13:00:00,64,46,18,FMN 19 Binnensingel Oostkant
666,R10 414,2023-03-09,14:00:00,60,48,12,FMN 19 Binnensingel Oostkant
666,R10 414,2023-03-09,15:00:00,113,96,17,FMN 19 Binnensingel Oostkant
666,R10 414,2023-03-09,16:00:00,181,152,29,FMN 19 Binnensingel Oostkant
666,R10 414,2023-03-09,17:00:00,206,163,43,FMN 19 Binnensingel Oostkant
666,R10 414,2023-03-09,18:00:00,146,116,30,FMN 19 Binnensingel Oostkant
666,R10 414,2023-03-09,19:00:00,75,54,21,FMN 19 Binnensingel Oostkant
666,R10 414,2023-03-09,20:00:00,71,46,25,FMN 19 Binnensingel Oostkant
666,R10 414,2023-03-09,21:00:00,48,32,16,FMN 19 Binnensingel Oostkant
666,R10 414,2023-03-09,22:00:00,47,37,10,FMN 19 Binnensingel Oostkant
666,R10 414,2023-03-09,23:00:00,29,23,6,FMN 19 Binnensingel Oostkant
666,R10 414,2023-03-10,00:00:00,10,9,1,FMN 19 Binnensingel Oostkant
666,R10 414,2023-03-10,01:00:00,5,4,1,FMN 19 Binnensingel Oostkant
666,R10 414,2023-03-10,02:00:00,3,3,0,FMN 19 Binnensingel Oostkant
666,R10 414,2023-03-10,03:00:00,4,2,2,FMN 19 Binnensingel Oostkant
666,R10 414,2023-03-10,04:00:00,8,5,3,FMN 19 Binnensingel Oostkant
666,R10 414,2023-03-10,05:00:00,18,7,11,FMN 19 Binnensingel Oostkant
666,R10 414,2023-03-10,06:00:00,40,25,15,FMN 19 Binnensingel Oostkant
666,R10 414,2023-03-10,07:00:00,100,63,37,FMN 19 Binnensingel Oostkant
666,R10 414,2023-03-10,08:00:00,163,107,56,FMN 19 Binnensingel Oostkant
666,R10 414,2023-03-10,09:00:00,61,44,17,FMN 19 Binnensingel Oostkant
666,R10 414,2023-03-10,10:00:00,52,33,19,FMN 19 Binnensingel Oostkant
666,R10 414,2023-03-10,11:00:00,54,36,18,FMN 19 Binnensingel Oostkant
666,R10 414,2023-03-10,12:00:00,84,62,22,FMN 19 Binnensingel Oostkant
666,R10 414,2023-03-10,13:00:00,57,45,12,FMN 19 Binnensingel Oostkant
666,R10 414,2023-03-10,14:00:00,62,50,12,FMN 19 Binnensingel Oostkant
666,R10 414,2023-03-10,15:00:00,110,94,16,FMN 19 Binnensingel Oostkant
666,R10 414,2023-03-10,16:00:00,150,125,25,FMN 19 Binnensingel Oostkant
666,R10 414,2023-03-10,17:00:00,139,114,25,FMN 19 Binnensingel Oostkant
666,R10 414,2023-03-10,18:00:00,95,78,17,FMN 19 Binnensingel Oostkant
666,R10 414,2023-03-10,19:00:00,81,63,18,FMN 19 Binnensingel Oostkant
666,R10 414,2023-03-10,20:00:00,68,56,12,FMN 19 Binnensingel Oostkant
666,R10 414,2023-03-10,21:00:00,53,40,13,FMN 19 Binnensingel Oostkant
666,R10 414,2023-03-10,22:00:00,55,48,7,FMN 19 Binnensingel Oostkant
666,R10 414,2023-03-10,23:00:00,53,33,20,FMN 19 Binnensingel Oostkant
666,R10 414,2023-03-11,00:00:00,25,20,5,FMN 19 Binnensingel Oostkant
666,R10 414,2023-03-11,01:00:00,17,15,2,FMN 19 Binnensingel Oostkant
666,R10 414,2023-03-11,02:00:00,15,12,3,FMN 19 Binnensingel Oostkant
666,R10 414,2023-03-11,03:00:00,7,5,2,FMN 19 Binnensingel Oostkant
666,R10 414,2023-03-11,04:00:00,12,10,2,FMN 19 Binnensingel Oostkant
666,R10 414,2023-03-11,05:00:00,13,6,7,FMN 19 Binnensingel Oostkant
666,R10 414,2023-03-11,06:00:00,9,3,6,FMN 19 Binnensingel Oostkant
666,R10 414,2023-03-11,07:00:00,25,18,7,FMN 19 Binnensingel Oostkant
666,R10 414,2023-03-11,08:00:00,23,10,13,FMN 19 Binnensingel Oostkant
666,R10 414,2023-03-11,09:00:00,48,35,13,FMN 19 Binnensingel Oostkant
666,R10 414,2023-03-11,10:00:00,69,51,18,FMN 19 Binnensingel Oostkant
666,R10 414,2023-03-11,11:00:00,60,44,16,FMN 19 Binnensingel Oostkant
666,R10 414,2023-03-11,12:00:00,61,52,9,FMN 19 Binnensingel Oostkant
666,R10 414,2023-03-11,13:00:00,66,51,15,FMN 19 Binnensingel Oostkant
666,R10 414,2023-03-11,14:00:00,75,63,12,FMN 19 Binnensingel Oostkant
666,R10 414,2023-03-11,15:00:00,76,62,14,FMN 19 Binnensingel Oostkant
666,R10 414,2023-03-11,16:00:00,70,54,16,FMN 19 Binnensingel Oostkant
666,R10 414,2023-03-11,17:00:00,75,59,16,FMN 19 Binnensingel Oostkant
666,R10 414,2023-03-11,18:00:00,68,51,17,FMN 19 Binnensingel Oostkant
666,R10 414,2023-03-11,19:00:00,77,53,24,FMN 19 Binnensingel Oostkant
666,R10 414,2023-03-11,20:00:00,42,32,10,FMN 19 Binnensingel Oostkant
666,R10 414,2023-03-11,21:00:00,41,34,7,FMN 19 Binnensingel Oostkant
666,R10 414,2023-03-11,22:00:00,32,27,5,FMN 19 Binnensingel Oostkant
666,R10 414,2023-03-11,23:00:00,39,30,9,FMN 19 Binnensingel Oostkant
666,R10 414,2023-03-12,00:00:00,26,23,3,FMN 19 Binnensingel Oostkant
666,R10 414,2023-03-12,01:00:00,11,7,4,FMN 19 Binnensingel Oostkant
666,R10 414,2023-03-12,02:00:00,11,8,3,FMN 19 Binnensingel Oostkant
666,R10 414,2023-03-12,03:00:00,7,6,1,FMN 19 Binnensingel Oostkant
666,R10 414,2023-03-12,04:00:00,8,5,3,FMN 19 Binnensingel Oostkant
666,R10 414,2023-03-12,05:00:00,13,9,4,FMN 19 Binnensingel Oostkant
666,R10 414,2023-03-12,06:00:00,15,4,11,FMN 19 Binnensingel Oostkant
666,R10 414,2023-03-12,07:00:00,11,7,4,FMN 19 Binnensingel Oostkant
666,R10 414,2023-03-12,08:00:00,20,10,10,FMN 19 Binnensingel Oostkant
666,R10 414,2023-03-12,09:00:00,24,16,8,FMN 19 Binnensingel Oostkant
666,R10 414,2023-03-12,10:00:00,46,33,13,FMN 19 Binnensingel Oostkant
666,R10 414,2023-03-12,11:00:00,30,23,7,FMN 19 Binnensingel Oostkant
666,R10 414,2023-03-12,12:00:00,49,42,7,FMN 19 Binnensingel Oostkant
666,R10 414,2023-03-12,13:00:00,41,28,13,FMN 19 Binnensingel Oostkant
666,R10 414,2023-03-12,14:00:00,66,50,16,FMN 19 Binnensingel Oostkant
666,R10 414,2023-03-12,15:00:00,48,36,12,FMN 19 Binnensingel Oostkant
666,R10 414,2023-03-12,16:00:00,64,50,14,FMN 19 Binnensingel Oostkant
666,R10 414,2023-03-12,17:00:00,74,56,18,FMN 19 Binnensingel Oostkant
666,R10 414,2023-03-12,18:00:00,49,30,19,FMN 19 Binnensingel Oostkant
666,R10 414,2023-03-12,19:00:00,40,31,9,FMN 19 Binnensingel Oostkant
666,R10 414,2023-03-12,20:00:00,37,22,15,FMN 19 Binnensingel Oostkant
666,R10 414,2023-03-12,21:00:00,39,31,8,FMN 19 Binnensingel Oostkant
666,R10 414,2023-03-12,22:00:00,23,13,10,FMN 19 Binnensingel Oostkant
666,R10 414,2023-03-12,23:00:00,11,8,3,FMN 19 Binnensingel Oostkant
666,R10 414,2023-03-13,00:00:00,6,5,1,FMN 19 Binnensingel Oostkant
666,R10 414,2023-03-13,01:00:00,7,7,0,FMN 19 Binnensingel Oostkant
666,R10 414,2023-03-13,02:00:00,4,2,2,FMN 19 Binnensingel Oostkant
666,R10 414,2023-03-13,03:00:00,7,3,4,FMN 19 Binnensingel Oostkant
666,R10 414,2023-03-13,04:00:00,10,6,4,FMN 19 Binnensingel Oostkant
666,R10 414,2023-03-13,05:00:00,25,13,12,FMN 19 Binnensingel Oostkant
666,R10 414,2023-03-13,06:00:00,53,29,24,FMN 19 Binnensingel Oostkant
666,R10 414,2023-03-13,07:00:00,161,106,55,FMN 19 Binnensingel Oostkant
666,R10 414,2023-03-13,08:00:00,206,122,84,FMN 19 Binnensingel Oostkant
666,R10 414,2023-03-13,09:00:00,65,40,25,FMN 19 Binnensingel Oostkant
666,R10 414,2023-03-13,10:00:00,63,46,17,FMN 19 Binnensingel Oostkant
666,R10 414,2023-03-13,11:00:00,51,34,17,FMN 19 Binnensingel Oostkant
666,R10 414,2023-03-13,12:00:00,78,59,19,FMN 19 Binnensingel Oostkant
666,R10 414,2023-03-13,13:00:00,72,46,26,FMN 19 Binnensingel Oostkant
666,R10 414,2023-03-13,14:00:00,81,67,14,FMN 19 Binnensingel Oostkant
666,R10 414,2023-03-13,15:00:00,129,111,18,FMN 19 Binnensingel Oostkant
666,R10 414,2023-03-13,16:00:00,213,172,41,FMN 19 Binnensingel Oostkant
666,R10 414,2023-03-13,17:00:00,222,164,58,FMN 19 Binnensingel Oostkant
666,R10 414,2023-03-13,18:00:00,176,121,55,FMN 19 Binnensingel Oostkant
666,R10 414,2023-03-13,19:00:00,95,69,26,FMN 19 Binnensingel Oostkant
666,R10 414,2023-03-13,20:00:00,73,47,26,FMN 19 Binnensingel Oostkant
666,R10 414,2023-03-13,21:00:00,77,69,8,FMN 19 Binnensingel Oostkant
666,R10 414,2023-03-13,22:00:00,59,44,15,FMN 19 Binnensingel Oostkant
666,R10 414,2023-03-13,23:00:00,15,14,1,FMN 19 Binnensingel Oostkant
666,R10 414,2023-03-14,00:00:00,9,8,1,FMN 19 Binnensingel Oostkant
666,R10 414,2023-03-14,01:00:00,5,4,1,FMN 19 Binnensingel Oostkant
666,R10 414,2023-03-14,02:00:00,3,1,2,FMN 19 Binnensingel Oostkant
666,R10 414,2023-03-14,03:00:00,7,3,4,FMN 19 Binnensingel Oostkant
666,R10 414,2023-03-14,04:00:00,13,8,5,FMN 19 Binnensingel Oostkant
666,R10 414,2023-03-14,05:00:00,22,10,12,FMN 19 Binnensingel Oostkant
666,R10 414,2023-03-14,06:00:00,60,40,20,FMN 19 Binnensingel Oostkant
666,R10 414,2023-03-14,07:00:00,141,94,47,FMN 19 Binnensingel Oostkant
666,R10 414,2023-03-14,08:00:00,164,111,53,FMN 19 Binnensingel Oostkant
666,R10 414,2023-03-14,09:00:00,64,40,24,FMN 19 Binnensingel Oostkant
666,R10 414,2023-03-14,10:00:00,46,33,13,FMN 19 Binnensingel Oostkant
666,R10 414,2023-03-14,11:00:00,68,53,15,FMN 19 Binnensingel Oostkant
666,R10 414,2023-03-14,12:00:00,56,37,19,FMN 19 Binnensingel Oostkant
666,R10 414,2023-03-14,13:00:00,83,59,24,FMN 19 Binnensingel Oostkant
666,R10 414,2023-03-14,14:00:00,67,51,16,FMN 19 Binnensingel Oostkant
666,R10 414,2023-03-14,15:00:00,128,108,20,FMN 19 Binnensingel Oostkant
666,R10 414,2023-03-14,16:00:00,206,172,34,FMN 19 Binnensingel Oostkant
666,R10 414,2023-03-14,17:00:00,199,152,47,FMN 19 Binnensingel Oostkant
666,R10 414,2023-03-14,18:00:00,187,139,48,FMN 19 Binnensingel Oostkant
666,R10 414,2023-03-14,19:00:00,92,70,22,FMN 19 Binnensingel Oostkant
666,R10 414,2023-03-14,20:00:00,69,47,22,FMN 19 Binnensingel Oostkant
666,R10 414,2023-03-14,21:00:00,64,52,12,FMN 19 Binnensingel Oostkant
666,R10 414,2023-03-14,22:00:00,59,47,12,FMN 19 Binnensingel Oostkant
666,R10 414,2023-03-14,23:00:00,22,13,9,FMN 19 Binnensingel Oostkant
666,R10 414,2023-03-15,00:00:00,11,8,3,FMN 19 Binnensingel Oostkant
666,R10 414,2023-03-15,01:00:00,5,3,2,FMN 19 Binnensingel Oostkant
666,R10 414,2023-03-15,02:00:00,2,2,0,FMN 19 Binnensingel Oostkant
666,R10 414,2023-03-15,03:00:00,8,4,4,FMN 19 Binnensingel Oostkant
666,R10 414,2023-03-15,04:00:00,11,4,7,FMN 19 Binnensingel Oostkant
666,R10 414,2023-03-15,05:00:00,18,9,9,FMN 19 Binnensingel Oostkant
666,R10 414,2023-03-15,06:00:00,53,38,15,FMN 19 Binnensingel Oostkant
666,R10 414,2023-03-15,07:00:00,134,92,42,FMN 19 Binnensingel Oostkant
666,R10 414,2023-03-15,08:00:00,169,123,46,FMN 19 Binnensingel Oostkant
666,R10 414,2023-03-15,09:00:00,77,48,29,FMN 19 Binnensingel Oostkant
666,R10 414,2023-03-15,10:00:00,61,35,26,FMN 19 Binnensingel Oostkant
666,R10 414,2023-03-15,11:00:00,63,51,12,FMN 19 Binnensingel Oostkant
666,R10 414,2023-03-15,12:00:00,135,102,33,FMN 19 Binnensingel Oostkant
666,R10 414,2023-03-15,13:00:00,113,83,30,FMN 19 Binnensingel Oostkant
666,R10 414,2023-03-15,14:00:00,94,67,27,FMN 19 Binnensingel Oostkant
666,R10 414,2023-03-15,15:00:00,132,112,20,FMN 19 Binnensingel Oostkant
666,R10 414,2023-03-15,16:00:00,193,154,39,FMN 19 Binnensingel Oostkant
666,R10 414,2023-03-15,17:00:00,202,153,49,FMN 19 Binnensingel Oostkant
666,R10 414,2023-03-15,18:00:00,168,116,52,FMN 19 Binnensingel Oostkant
666,R10 414,2023-03-15,19:00:00,85,71,14,FMN 19 Binnensingel Oostkant
666,R10 414,2023-03-15,20:00:00,78,64,14,FMN 19 Binnensingel Oostkant
666,R10 414,2023-03-15,21:00:00,71,63,8,FMN 19 Binnensingel Oostkant
666,R10 414,2023-03-15,22:00:00,58,48,10,FMN 19 Binnensingel Oostkant
666,R10 414,2023-03-15,23:00:00,17,12,5,FMN 19 Binnensingel Oostkant
666,R10 414,2023-03-16,00:00:00,10,6,4,FMN 19 Binnensingel Oostkant
666,R10 414,2023-03-16,01:00:00,5,4,1,FMN 19 Binnensingel Oostkant
666,R10 414,2023-03-16,02:00:00,4,4,0,FMN 19 Binnensingel Oostkant
666,R10 414,2023-03-16,03:00:00,13,8,5,FMN 19 Binnensingel Oostkant
666,R10 414,2023-03-16,04:00:00,17,6,11,FMN 19 Binnensingel Oostkant
666,R10 414,2023-03-16,05:00:00,33,15,18,FMN 19 Binnensingel Oostkant
666,R10 414,2023-03-16,06:00:00,64,45,19,FMN 19 Binnensingel Oostkant
666,R10 414,2023-03-16,07:00:00,162,107,55,FMN 19 Binnensingel Oostkant
666,R10 414,2023-03-16,08:00:00,203,136,67,FMN 19 Binnensingel Oostkant
666,R10 414,2023-03-16,09:00:00,84,58,26,FMN 19 Binnensingel Oostkant
666,R10 414,2023-03-16,10:00:00,53,35,18,FMN 19 Binnensingel Oostkant
666,R10 414,2023-03-16,11:00:00,66,45,21,FMN 19 Binnensingel Oostkant
666,R10 414,2023-03-16,12:00:00,93,72,21,FMN 19 Binnensingel Oostkant
666,R10 414,2023-03-16,13:00:00,98,68,30,FMN 19 Binnensingel Oostkant
666,R10 414,2023-03-16,14:00:00,70,58,12,FMN 19 Binnensingel Oostkant
666,R10 414,2023-03-16,15:00:00,166,134,32,FMN 19 Binnensingel Oostkant
666,R10 414,2023-03-16,16:00:00,217,171,46,FMN 19 Binnensingel Oostkant
666,R10 414,2023-03-16,17:00:00,247,197,50,FMN 19 Binnensingel Oostkant
666,R10 414,2023-03-16,18:00:00,206,145,61,FMN 19 Binnensingel Oostkant
666,R10 414,2023-03-16,19:00:00,97,71,26,FMN 19 Binnensingel Oostkant
666,R10 414,2023-03-16,20:00:00,72,44,28,FMN 19 Binnensingel Oostkant
666,R10 414,2023-03-16,21:00:00,68,57,11,FMN 19 Binnensingel Oostkant
666,R10 414,2023-03-16,22:00:00,69,57,12,FMN 19 Binnensingel Oostkant
666,R10 414,2023-03-16,23:00:00,38,31,7,FMN 19 Binnensingel Oostkant
666,R10 414,2023-03-17,00:00:00,20,13,7,FMN 19 Binnensingel Oostkant
666,R10 414,2023-03-17,01:00:00,4,3,1,FMN 19 Binnensingel Oostkant
666,R10 414,2023-03-17,02:00:00,3,1,2,FMN 19 Binnensingel Oostkant
666,R10 414,2023-03-17,03:00:00,7,4,3,FMN 19 Binnensingel Oostkant
666,R10 414,2023-03-17,04:00:00,11,6,5,FMN 19 Binnensingel Oostkant
666,R10 414,2023-03-17,05:00:00,33,12,21,FMN 19 Binnensingel Oostkant
666,R10 414,2023-03-17,06:00:00,54,39,15,FMN 19 Binnensingel Oostkant
666,R10 414,2023-03-17,07:00:00,118,76,42,FMN 19 Binnensingel Oostkant
666,R10 414,2023-03-17,08:00:00,177,120,57,FMN 19 Binnensingel Oostkant
666,R10 414,2023-03-17,09:00:00,75,46,29,FMN 19 Binnensingel Oostkant
666,R10 414,2023-03-17,10:00:00,71,51,20,FMN 19 Binnensingel Oostkant
666,R10 414,2023-03-17,11:00:00,59,43,16,FMN 19 Binnensingel Oostkant
666,R10 414,2023-03-17,12:00:00,96,75,21,FMN 19 Binnensingel Oostkant
666,R10 414,2023-03-17,13:00:00,97,71,26,FMN 19 Binnensingel Oostkant
666,R10 414,2023-03-17,14:00:00,92,76,16,FMN 19 Binnensingel Oostkant
666,R10 414,2023-03-17,15:00:00,205,150,55,FMN 19 Binnensingel Oostkant
666,R10 414,2023-03-17,16:00:00,243,194,49,FMN 19 Binnensingel Oostkant
666,R10 414,2023-03-17,17:00:00,248,198,50,FMN 19 Binnensingel Oostkant
666,R10 414,2023-03-17,18:00:00,169,141,28,FMN 19 Binnensingel Oostkant
666,R10 414,2023-03-17,19:00:00,112,82,30,FMN 19 Binnensingel Oostkant
666,R10 414,2023-03-17,20:00:00,92,69,23,FMN 19 Binnensingel Oostkant
666,R10 414,2023-03-17,21:00:00,75,63,12,FMN 19 Binnensingel Oostkant
666,R10 414,2023-03-17,22:00:00,57,46,11,FMN 19 Binnensingel Oostkant
666,R10 414,2023-03-17,23:00:00,65,43,22,FMN 19 Binnensingel Oostkant
666,R10 414,2023-03-18,00:00:00,21,14,7,FMN 19 Binnensingel Oostkant
666,R10 414,2023-03-18,01:00:00,25,22,3,FMN 19 Binnensingel Oostkant
666,R10 414,2023-03-18,02:00:00,15,12,3,FMN 19 Binnensingel Oostkant
666,R10 414,2023-03-18,03:00:00,16,10,6,FMN 19 Binnensingel Oostkant
666,R10 414,2023-03-18,04:00:00,7,3,4,FMN 19 Binnensingel Oostkant
666,R10 414,2023-03-18,05:00:00,13,7,6,FMN 19 Binnensingel Oostkant
666,R10 414,2023-03-18,06:00:00,16,8,8,FMN 19 Binnensingel Oostkant
666,R10 414,2023-03-18,07:00:00,20,14,6,FMN 19 Binnensingel Oostkant
666,R10 414,2023-03-18,08:00:00,42,30,12,FMN 19 Binnensingel Oostkant
666,R10 414,2023-03-18,09:00:00,37,27,10,FMN 19 Binnensingel Oostkant
666,R10 414,2023-03-18,10:00:00,52,40,12,FMN 19 Binnensingel Oostkant
666,R10 414,2023-03-18,11:00:00,63,51,12,FMN 19 Binnensingel Oostkant
666,R10 414,2023-03-18,12:00:00,79,58,21,FMN 19 Binnensingel Oostkant
666,R10 414,2023-03-18,13:00:00,70,47,23,FMN 19 Binnensingel Oostkant
666,R10 414,2023-03-18,14:00:00,73,60,13,FMN 19 Binnensingel Oostkant
666,R10 414,2023-03-18,15:00:00,55,41,14,FMN 19 Binnensingel Oostkant
666,R10 414,2023-03-18,16:00:00,80,60,20,FMN 19 Binnensingel Oostkant
666,R10 414,2023-03-18,17:00:00,75,63,12,FMN 19 Binnensingel Oostkant
666,R10 414,2023-03-18,18:00:00,95,76,19,FMN 19 Binnensingel Oostkant
666,R10 414,2023-03-18,19:00:00,67,40,27,FMN 19 Binnensingel Oostkant
666,R10 414,2023-03-18,20:00:00,65,49,16,FMN 19 Binnensingel Oostkant
666,R10 414,2023-03-18,21:00:00,35,32,3,FMN 19 Binnensingel Oostkant
666,R10 414,2023-03-18,22:00:00,33,28,5,FMN 19 Binnensingel Oostkant
666,R10 414,2023-03-18,23:00:00,37,34,3,FMN 19 Binnensingel Oostkant
666,R10 414,2023-03-19,00:00:00,23,20,3,FMN 19 Binnensingel Oostkant
666,R10 414,2023-03-19,01:00:00,13,10,3,FMN 19 Binnensingel Oostkant
666,R10 414,2023-03-19,02:00:00,9,7,2,FMN 19 Binnensingel Oostkant
666,R10 414,2023-03-19,03:00:00,11,6,5,FMN 19 Binnensingel Oostkant
666,R10 414,2023-03-19,04:00:00,3,0,3,FMN 19 Binnensingel Oostkant
666,R10 414,2023-03-19,05:00:00,8,4,4,FMN 19 Binnensingel Oostkant
666,R10 414,2023-03-19,06:00:00,11,8,3,FMN 19 Binnensingel Oostkant
666,R10 414,2023-03-19,07:00:00,13,11,2,FMN 19 Binnensingel Oostkant
666,R10 414,2023-03-19,08:00:00,19,14,5,FMN 19 Binnensingel Oostkant
666,R10 414,2023-03-19,09:00:00,37,28,9,FMN 19 Binnensingel Oostkant
666,R10 414,2023-03-19,10:00:00,56,42,14,FMN 19 Binnensingel Oostkant
666,R10 414,2023-03-19,11:00:00,59,45,14,FMN 19 Binnensingel Oostkant
666,R10 414,2023-03-19,12:00:00,74,63,11,FMN 19 Binnensingel Oostkant
666,R10 414,2023-03-19,13:00:00,56,40,16,FMN 19 Binnensingel Oostkant
666,R10 414,2023-03-19,14:00:00,45,32,13,FMN 19 Binnensingel Oostkant
666,R10 414,2023-03-19,15:00:00,57,38,19,FMN 19 Binnensingel Oostkant
666,R10 414,2023-03-19,16:00:00,53,38,15,FMN 19 Binnensingel Oostkant
666,R10 414,2023-03-19,17:00:00,55,37,18,FMN 19 Binnensingel Oostkant
666,R10 414,2023-03-19,18:00:00,86,73,13,FMN 19 Binnensingel Oostkant
666,R10 414,2023-03-19,19:00:00,59,46,13,FMN 19 Binnensingel Oostkant
666,R10 414,2023-03-19,20:00:00,37,26,11,FMN 19 Binnensingel Oostkant
666,R10 414,2023-03-19,21:00:00,30,23,7,FMN 19 Binnensingel Oostkant
666,R10 414,2023-03-19,22:00:00,29,21,8,FMN 19 Binnensingel Oostkant
666,R10 414,2023-03-19,23:00:00,28,16,12,FMN 19 Binnensingel Oostkant
666,R10 414,2023-03-20,00:00:00,9,4,5,FMN 19 Binnensingel Oostkant
666,R10 414,2023-03-20,01:00:00,2,2,0,FMN 19 Binnensingel Oostkant
666,R10 414,2023-03-20,02:00:00,2,2,0,FMN 19 Binnensingel Oostkant
666,R10 414,2023-03-20,03:00:00,10,5,5,FMN 19 Binnensingel Oostkant
666,R10 414,2023-03-20,04:00:00,15,9,6,FMN 19 Binnensingel Oostkant
666,R10 414,2023-03-20,05:00:00,30,11,19,FMN 19 Binnensingel Oostkant
666,R10 414,2023-03-20,06:00:00,58,44,14,FMN 19 Binnensingel Oostkant
666,R10 414,2023-03-20,07:00:00,156,109,47,FMN 19 Binnensingel Oostkant
666,R10 414,2023-03-20,08:00:00,198,130,68,FMN 19 Binnensingel Oostkant
666,R10 414,2023-03-20,09:00:00,82,58,24,FMN 19 Binnensingel Oostkant
666,R10 414,2023-03-20,10:00:00,50,38,12,FMN 19 Binnensingel Oostkant
666,R10 414,2023-03-20,11:00:00,59,49,10,FMN 19 Binnensingel Oostkant
666,R10 414,2023-03-20,12:00:00,100,74,26,FMN 19 Binnensingel Oostkant
666,R10 414,2023-03-20,13:00:00,70,56,14,FMN 19 Binnensingel Oostkant
666,R10 414,2023-03-20,14:00:00,62,50,12,FMN 19 Binnensingel Oostkant
666,R10 414,2023-03-20,15:00:00,140,122,18,FMN 19 Binnensingel Oostkant
666,R10 414,2023-03-20,16:00:00,202,163,39,FMN 19 Binnensingel Oostkant
666,R10 414,2023-03-20,17:00:00,231,179,52,FMN 19 Binnensingel Oostkant
666,R10 414,2023-03-20,18:00:00,189,147,42,FMN 19 Binnensingel Oostkant
666,R10 414,2023-03-20,19:00:00,81,60,21,FMN 19 Binnensingel Oostkant
666,R10 414,2023-03-20,20:00:00,67,53,14,FMN 19 Binnensingel Oostkant
666,R10 414,2023-03-20,21:00:00,70,62,8,FMN 19 Binnensingel Oostkant
666,R10 414,2023-03-20,22:00:00,64,54,10,FMN 19 Binnensingel Oostkant
666,R10 414,2023-03-20,23:00:00,17,13,4,FMN 19 Binnensingel Oostkant
666,R10 414,2023-03-21,00:00:00,3,2,1,FMN 19 Binnensingel Oostkant
666,R10 414,2023-03-21,01:00:00,8,5,3,FMN 19 Binnensingel Oostkant
666,R10 414,2023-03-21,02:00:00,4,4,0,FMN 19 Binnensingel Oostkant
666,R10 414,2023-03-21,03:00:00,6,3,3,FMN 19 Binnensingel Oostkant
666,R10 414,2023-03-21,04:00:00,15,8,7,FMN 19 Binnensingel Oostkant
666,R10 414,2023-03-21,05:00:00,21,7,14,FMN 19 Binnensingel Oostkant
666,R10 414,2023-03-21,06:00:00,57,43,14,FMN 19 Binnensingel Oostkant
666,R10 414,2023-03-21,07:00:00,151,108,43,FMN 19 Binnensingel Oostkant
666,R10 414,2023-03-21,08:00:00,207,146,61,FMN 19 Binnensingel Oostkant
666,R10 414,2023-03-21,09:00:00,72,41,31,FMN 19 Binnensingel Oostkant
666,R10 414,2023-03-21,10:00:00,67,38,29,FMN 19 Binnensingel Oostkant
666,R10 414,2023-03-21,11:00:00,61,51,10,FMN 19 Binnensingel Oostkant
666,R10 414,2023-03-21,12:00:00,97,62,35,FMN 19 Binnensingel Oostkant
666,R10 414,2023-03-21,13:00:00,86,62,24,FMN 19 Binnensingel Oostkant
666,R10 414,2023-03-21,14:00:00,94,76,18,FMN 19 Binnensingel Oostkant
666,R10 414,2023-03-21,15:00:00,151,131,20,FMN 19 Binnensingel Oostkant
666,R10 414,2023-03-21,16:00:00,264,209,55,FMN 19 Binnensingel Oostkant
666,R10 414,2023-03-21,17:00:00,244,189,55,FMN 19 Binnensingel Oostkant
666,R10 414,2023-03-21,18:00:00,181,128,53,FMN 19 Binnensingel Oostkant
666,R10 414,2023-03-21,19:00:00,92,65,27,FMN 19 Binnensingel Oostkant
666,R10 414,2023-03-21,20:00:00,71,52,19,FMN 19 Binnensingel Oostkant
666,R10 414,2023-03-21,21:00:00,70,57,13,FMN 19 Binnensingel Oostkant
666,R10 414,2023-03-21,22:00:00,67,50,17,FMN 19 Binnensingel Oostkant
666,R10 414,2023-03-21,23:00:00,22,15,7,FMN 19 Binnensingel Oostkant
666,R10 414,2023-03-22,00:00:00,7,7,0,FMN 19 Binnensingel Oostkant
666,R10 414,2023-03-22,01:00:00,5,5,0,FMN 19 Binnensingel Oostkant
666,R10 414,2023-03-22,02:00:00,4,3,1,FMN 19 Binnensingel Oostkant
666,R10 414,2023-03-22,03:00:00,6,2,4,FMN 19 Binnensingel Oostkant
666,R10 414,2023-03-22,04:00:00,17,9,8,FMN 19 Binnensingel Oostkant
666,R10 414,2023-03-22,05:00:00,21,9,12,FMN 19 Binnensingel Oostkant
666,R10 414,2023-03-22,06:00:00,57,46,11,FMN 19 Binnensingel Oostkant
666,R10 414,2023-03-22,07:00:00,135,99,36,FMN 19 Binnensingel Oostkant
666,R10 414,2023-03-22,08:00:00,190,132,58,FMN 19 Binnensingel Oostkant
666,R10 414,2023-03-22,09:00:00,71,47,24,FMN 19 Binnensingel Oostkant
666,R10 414,2023-03-22,10:00:00,68,46,22,FMN 19 Binnensingel Oostkant
666,R10 414,2023-03-22,11:00:00,53,43,10,FMN 19 Binnensingel Oostkant
666,R10 414,2023-03-22,12:00:00,152,122,30,FMN 19 Binnensingel Oostkant
666,R10 414,2023-03-22,13:00:00,83,63,20,FMN 19 Binnensingel Oostkant
666,R10 414,2023-03-22,14:00:00,82,68,14,FMN 19 Binnensingel Oostkant
666,R10 414,2023-03-22,15:00:00,103,87,16,FMN 19 Binnensingel Oostkant
666,R10 414,2023-03-22,16:00:00,185,145,40,FMN 19 Binnensingel Oostkant
666,R10 414,2023-03-22,17:00:00,209,164,45,FMN 19 Binnensingel Oostkant
666,R10 414,2023-03-22,18:00:00,160,122,38,FMN 19 Binnensingel Oostkant
666,R10 414,2023-03-22,19:00:00,81,63,18,FMN 19 Binnensingel Oostkant
666,R10 414,2023-03-22,20:00:00,54,47,7,FMN 19 Binnensingel Oostkant
666,R10 414,2023-03-22,21:00:00,61,50,11,FMN 19 Binnensingel Oostkant
666,R10 414,2023-03-22,22:00:00,60,47,13,FMN 19 Binnensingel Oostkant
666,R10 414,2023-03-22,23:00:00,26,21,5,FMN 19 Binnensingel Oostkant
666,R10 414,2023-03-23,00:00:00,4,3,1,FMN 19 Binnensingel Oostkant
666,R10 414,2023-03-23,01:00:00,5,3,2,FMN 19 Binnensingel Oostkant
666,R10 414,2023-03-23,02:00:00,2,2,0,FMN 19 Binnensingel Oostkant
666,R10 414,2023-03-23,03:00:00,7,5,2,FMN 19 Binnensingel Oostkant
666,R10 414,2023-03-23,04:00:00,16,8,8,FMN 19 Binnensingel Oostkant
666,R10 414,2023-03-23,05:00:00,22,12,10,FMN 19 Binnensingel Oostkant
666,R10 414,2023-03-23,06:00:00,66,50,16,FMN 19 Binnensingel Oostkant
666,R10 414,2023-03-23,07:00:00,127,91,36,FMN 19 Binnensingel Oostkant
666,R10 414,2023-03-23,08:00:00,135,91,44,FMN 19 Binnensingel Oostkant
666,R10 414,2023-03-23,09:00:00,85,59,26,FMN 19 Binnensingel Oostkant
666,R10 414,2023-03-23,10:00:00,54,31,23,FMN 19 Binnensingel Oostkant
666,R10 414,2023-03-23,11:00:00,51,40,11,FMN 19 Binnensingel Oostkant
666,R10 414,2023-03-23,12:00:00,90,66,24,FMN 19 Binnensingel Oostkant
666,R10 414,2023-03-23,13:00:00,101,67,34,FMN 19 Binnensingel Oostkant
666,R10 414,2023-03-23,14:00:00,49,36,13,FMN 19 Binnensingel Oostkant
666,R10 414,2023-03-23,15:00:00,134,113,21,FMN 19 Binnensingel Oostkant
666,R10 414,2023-03-23,16:00:00,199,156,43,FMN 19 Binnensingel Oostkant
666,R10 414,2023-03-23,17:00:00,200,166,34,FMN 19 Binnensingel Oostkant
666,R10 414,2023-03-23,18:00:00,165,114,51,FMN 19 Binnensingel Oostkant
666,R10 414,2023-03-23,19:00:00,89,70,19,FMN 19 Binnensingel Oostkant
666,R10 414,2023-03-23,20:00:00,60,41,19,FMN 19 Binnensingel Oostkant
666,R10 414,2023-03-23,21:00:00,62,52,10,FMN 19 Binnensingel Oostkant
666,R10 414,2023-03-23,22:00:00,56,50,6,FMN 19 Binnensingel Oostkant
666,R10 414,2023-03-23,23:00:00,33,26,7,FMN 19 Binnensingel Oostkant
666,R10 414,2023-03-24,00:00:00,11,9,2,FMN 19 Binnensingel Oostkant
666,R10 414,2023-03-24,01:00:00,11,5,6,FMN 19 Binnensingel Oostkant
666,R10 414,2023-03-24,02:00:00,4,3,1,FMN 19 Binnensingel Oostkant
666,R10 414,2023-03-24,03:00:00,6,5,1,FMN 19 Binnensingel Oostkant
666,R10 414,2023-03-24,04:00:00,13,8,5,FMN 19 Binnensingel Oostkant
666,R10 414,2023-03-24,05:00:00,21,6,15,FMN 19 Binnensingel Oostkant
666,R10 414,2023-03-24,06:00:00,48,31,17,FMN 19 Binnensingel Oostkant
666,R10 414,2023-03-24,07:00:00,126,89,37,FMN 19 Binnensingel Oostkant
666,R10 414,2023-03-24,08:00:00,159,112,47,FMN 19 Binnensingel Oostkant
666,R10 414,2023-03-24,09:00:00,81,52,29,FMN 19 Binnensingel Oostkant
666,R10 414,2023-03-24,10:00:00,54,34,20,FMN 19 Binnensingel Oostkant
666,R10 414,2023-03-24,11:00:00,61,50,11,FMN 19 Binnensingel Oostkant
666,R10 414,2023-03-24,12:00:00,117,90,27,FMN 19 Binnensingel Oostkant
666,R10 414,2023-03-24,13:00:00,98,79,19,FMN 19 Binnensingel Oostkant
666,R10 414,2023-03-24,14:00:00,75,62,13,FMN 19 Binnensingel Oostkant
666,R10 414,2023-03-24,15:00:00,134,109,25,FMN 19 Binnensingel Oostkant
666,R10 414,2023-03-24,16:00:00,211,177,34,FMN 19 Binnensingel Oostkant
666,R10 414,2023-03-24,17:00:00,250,195,55,FMN 19 Binnensingel Oostkant
666,R10 414,2023-03-24,18:00:00,148,111,37,FMN 19 Binnensingel Oostkant
666,R10 414,2023-03-24,19:00:00,99,75,24,FMN 19 Binnensingel Oostkant
666,R10 414,2023-03-24,20:00:00,64,52,12,FMN 19 Binnensingel Oostkant
666,R10 414,2023-03-24,21:00:00,66,59,7,FMN 19 Binnensingel Oostkant
666,R10 414,2023-03-24,22:00:00,46,39,7,FMN 19 Binnensingel Oostkant
666,R10 414,2023-03-24,23:00:00,45,37,8,FMN 19 Binnensingel Oostkant
666,R10 414,2023-03-25,00:00:00,35,25,10,FMN 19 Binnensingel Oostkant
666,R10 414,2023-03-25,01:00:00,16,14,2,FMN 19 Binnensingel Oostkant
666,R10 414,2023-03-25,02:00:00,14,9,5,FMN 19 Binnensingel Oostkant
666,R10 414,2023-03-25,03:00:00,15,11,4,FMN 19 Binnensingel Oostkant
666,R10 414,2023-03-25,04:00:00,9,7,2,FMN 19 Binnensingel Oostkant
666,R10 414,2023-03-25,05:00:00,13,6,7,FMN 19 Binnensingel Oostkant
666,R10 414,2023-03-25,06:00:00,18,10,8,FMN 19 Binnensingel Oostkant
666,R10 414,2023-03-25,07:00:00,27,20,7,FMN 19 Binnensingel Oostkant
666,R10 414,2023-03-25,08:00:00,24,18,6,FMN 19 Binnensingel Oostkant
666,R10 414,2023-03-25,09:00:00,40,29,11,FMN 19 Binnensingel Oostkant
666,R10 414,2023-03-25,10:00:00,37,32,5,FMN 19 Binnensingel Oostkant
666,R10 414,2023-03-25,11:00:00,48,38,10,FMN 19 Binnensingel Oostkant
666,R10 414,2023-03-25,12:00:00,54,42,12,FMN 19 Binnensingel Oostkant
666,R10 414,2023-03-25,13:00:00,44,39,5,FMN 19 Binnensingel Oostkant
666,R10 414,2023-03-25,14:00:00,48,37,11,FMN 19 Binnensingel Oostkant
666,R10 414,2023-03-25,15:00:00,34,24,10,FMN 19 Binnensingel Oostkant
666,R10 414,2023-03-25,16:00:00,46,35,11,FMN 19 Binnensingel Oostkant
666,R10 414,2023-03-25,17:00:00,54,45,9,FMN 19 Binnensingel Oostkant
666,R10 414,2023-03-25,18:00:00,66,45,21,FMN 19 Binnensingel Oostkant
666,R10 414,2023-03-25,19:00:00,41,30,11,FMN 19 Binnensingel Oostkant
666,R10 414,2023-03-25,20:00:00,61,50,11,FMN 19 Binnensingel Oostkant
666,R10 414,2023-03-25,21:00:00,35,30,5,FMN 19 Binnensingel Oostkant
666,R10 414,2023-03-25,22:00:00,50,35,15,FMN 19 Binnensingel Oostkant
666,R10 414,2023-03-25,23:00:00,23,20,3,FMN 19 Binnensingel Oostkant
666,R10 414,2023-03-26,00:00:00,21,20,1,FMN 19 Binnensingel Oostkant
666,R10 414,2023-03-26,01:00:00,25,18,7,FMN 19 Binnensingel Oostkant
666,R10 414,2023-03-26,02:00:00,0,0,0,FMN 19 Binnensingel Oostkant
666,R10 414,2023-03-26,03:00:00,10,7,3,FMN 19 Binnensingel Oostkant
666,R10 414,2023-03-26,04:00:00,16,6,10,FMN 19 Binnensingel Oostkant
666,R10 414,2023-03-26,05:00:00,13,7,6,FMN 19 Binnensingel Oostkant
666,R10 414,2023-03-26,06:00:00,5,2,3,FMN 19 Binnensingel Oostkant
666,R10 414,2023-03-26,07:00:00,8,5,3,FMN 19 Binnensingel Oostkant
666,R10 414,2023-03-26,08:00:00,12,7,5,FMN 19 Binnensingel Oostkant
666,R10 414,2023-03-26,09:00:00,28,18,10,FMN 19 Binnensingel Oostkant
666,R10 414,2023-03-26,10:00:00,28,20,8,FMN 19 Binnensingel Oostkant
666,R10 414,2023-03-26,11:00:00,30,25,5,FMN 19 Binnensingel Oostkant
666,R10 414,2023-03-26,12:00:00,22,18,4,FMN 19 Binnensingel Oostkant
666,R10 414,2023-03-26,13:00:00,32,28,4,FMN 19 Binnensingel Oostkant
666,R10 414,2023-03-26,14:00:00,37,24,13,FMN 19 Binnensingel Oostkant
666,R10 414,2023-03-26,15:00:00,49,35,14,FMN 19 Binnensingel Oostkant
666,R10 414,2023-03-26,16:00:00,38,33,5,FMN 19 Binnensingel Oostkant
666,R10 414,2023-03-26,17:00:00,50,28,22,FMN 19 Binnensingel Oostkant
666,R10 414,2023-03-26,18:00:00,29,17,12,FMN 19 Binnensingel Oostkant
666,R10 414,2023-03-26,19:00:00,40,34,6,FMN 19 Binnensingel Oostkant
666,R10 414,2023-03-26,20:00:00,32,27,5,FMN 19 Binnensingel Oostkant
666,R10 414,2023-03-26,21:00:00,28,21,7,FMN 19 Binnensingel Oostkant
666,R10 414,2023-03-26,22:00:00,26,23,3,FMN 19 Binnensingel Oostkant
666,R10 414,2023-03-26,23:00:00,18,12,6,FMN 19 Binnensingel Oostkant
666,R10 414,2023-03-27,00:00:00,6,6,0,FMN 19 Binnensingel Oostkant
666,R10 414,2023-03-27,01:00:00,8,8,0,FMN 19 Binnensingel Oostkant
666,R10 414,2023-03-27,02:00:00,2,1,1,FMN 19 Binnensingel Oostkant
666,R10 414,2023-03-27,03:00:00,5,2,3,FMN 19 Binnensingel Oostkant
666,R10 414,2023-03-27,04:00:00,16,7,9,FMN 19 Binnensingel Oostkant
666,R10 414,2023-03-27,05:00:00,26,15,11,FMN 19 Binnensingel Oostkant
666,R10 414,2023-03-27,06:00:00,49,36,13,FMN 19 Binnensingel Oostkant
666,R10 414,2023-03-27,07:00:00,138,101,37,FMN 19 Binnensingel Oostkant
666,R10 414,2023-03-27,08:00:00,190,127,63,FMN 19 Binnensingel Oostkant
666,R10 414,2023-03-27,09:00:00,80,61,19,FMN 19 Binnensingel Oostkant
666,R10 414,2023-03-27,10:00:00,55,32,23,FMN 19 Binnensingel Oostkant
666,R10 414,2023-03-27,11:00:00,41,33,8,FMN 19 Binnensingel Oostkant
666,R10 414,2023-03-27,12:00:00,65,55,10,FMN 19 Binnensingel Oostkant
666,R10 414,2023-03-27,13:00:00,89,75,14,FMN 19 Binnensingel Oostkant
666,R10 414,2023-03-27,14:00:00,62,50,12,FMN 19 Binnensingel Oostkant
666,R10 414,2023-03-27,15:00:00,124,108,16,FMN 19 Binnensingel Oostkant
666,R10 414,2023-03-27,16:00:00,236,193,43,FMN 19 Binnensingel Oostkant
666,R10 414,2023-03-27,17:00:00,219,167,52,FMN 19 Binnensingel Oostkant
666,R10 414,2023-03-27,18:00:00,192,139,53,FMN 19 Binnensingel Oostkant
666,R10 414,2023-03-27,19:00:00,85,59,26,FMN 19 Binnensingel Oostkant
666,R10 414,2023-03-27,20:00:00,46,34,12,FMN 19 Binnensingel Oostkant
666,R10 414,2023-03-27,21:00:00,56,48,8,FMN 19 Binnensingel Oostkant
666,R10 414,2023-03-27,22:00:00,41,37,4,FMN 19 Binnensingel Oostkant
666,R10 414,2023-03-27,23:00:00,16,12,4,FMN 19 Binnensingel Oostkant
666,R10 414,2023-03-28,00:00:00,7,6,1,FMN 19 Binnensingel Oostkant
666,R10 414,2023-03-28,01:00:00,9,6,3,FMN 19 Binnensingel Oostkant
666,R10 414,2023-03-28,02:00:00,2,1,1,FMN 19 Binnensingel Oostkant
666,R10 414,2023-03-28,03:00:00,7,4,3,FMN 19 Binnensingel Oostkant
666,R10 414,2023-03-28,04:00:00,15,6,9,FMN 19 Binnensingel Oostkant
666,R10 414,2023-03-28,05:00:00,21,9,12,FMN 19 Binnensingel Oostkant
666,R10 414,2023-03-28,06:00:00,54,40,14,FMN 19 Binnensingel Oostkant
666,R10 414,2023-03-28,07:00:00,142,97,45,FMN 19 Binnensingel Oostkant
666,R10 414,2023-03-28,08:00:00,218,158,60,FMN 19 Binnensingel Oostkant
666,R10 414,2023-03-28,09:00:00,84,58,26,FMN 19 Binnensingel Oostkant
666,R10 414,2023-03-28,10:00:00,57,31,26,FMN 19 Binnensingel Oostkant
666,R10 414,2023-03-28,11:00:00,65,45,20,FMN 19 Binnensingel Oostkant
666,R10 414,2023-03-28,12:00:00,84,59,25,FMN 19 Binnensingel Oostkant
666,R10 414,2023-03-28,13:00:00,80,61,19,FMN 19 Binnensingel Oostkant
666,R10 414,2023-03-28,14:00:00,107,92,15,FMN 19 Binnensingel Oostkant
666,R10 414,2023-03-28,15:00:00,144,118,26,FMN 19 Binnensingel Oostkant
666,R10 414,2023-03-28,16:00:00,215,177,38,FMN 19 Binnensingel Oostkant
666,R10 414,2023-03-28,17:00:00,246,180,66,FMN 19 Binnensingel Oostkant
666,R10 414,2023-03-28,18:00:00,193,142,51,FMN 19 Binnensingel Oostkant
666,R10 414,2023-03-28,19:00:00,103,73,30,FMN 19 Binnensingel Oostkant
666,R10 414,2023-03-28,20:00:00,63,49,14,FMN 19 Binnensingel Oostkant
666,R10 414,2023-03-28,21:00:00,64,54,10,FMN 19 Binnensingel Oostkant
666,R10 414,2023-03-28,22:00:00,61,49,12,FMN 19 Binnensingel Oostkant
666,R10 414,2023-03-28,23:00:00,28,21,7,FMN 19 Binnensingel Oostkant
666,R10 414,2023-03-29,00:00:00,11,9,2,FMN 19 Binnensingel Oostkant
666,R10 414,2023-03-29,01:00:00,4,3,1,FMN 19 Binnensingel Oostkant
666,R10 414,2023-03-29,02:00:00,5,3,2,FMN 19 Binnensingel Oostkant
666,R10 414,2023-03-29,03:00:00,5,3,2,FMN 19 Binnensingel Oostkant
666,R10 414,2023-03-29,04:00:00,25,12,13,FMN 19 Binnensingel Oostkant
666,R10 414,2023-03-29,05:00:00,22,10,12,FMN 19 Binnensingel Oostkant
666,R10 414,2023-03-29,06:00:00,63,44,19,FMN 19 Binnensingel Oostkant
666,R10 414,2023-03-29,07:00:00,133,99,34,FMN 19 Binnensingel Oostkant
666,R10 414,2023-03-29,08:00:00,174,118,56,FMN 19 Binnensingel Oostkant
666,R10 414,2023-03-29,09:00:00,54,36,18,FMN 19 Binnensingel Oostkant
666,R10 414,2023-03-29,10:00:00,46,34,12,FMN 19 Binnensingel Oostkant
666,R10 414,2023-03-29,11:00:00,50,44,6,FMN 19 Binnensingel Oostkant
666,R10 414,2023-03-29,12:00:00,124,100,24,FMN 19 Binnensingel Oostkant
666,R10 414,2023-03-29,13:00:00,107,73,34,FMN 19 Binnensingel Oostkant
666,R10 414,2023-03-29,14:00:00,87,60,27,FMN 19 Binnensingel Oostkant
666,R10 414,2023-03-29,15:00:00,118,96,22,FMN 19 Binnensingel Oostkant
666,R10 414,2023-03-29,16:00:00,230,183,47,FMN 19 Binnensingel Oostkant
666,R10 414,2023-03-29,17:00:00,212,157,55,FMN 19 Binnensingel Oostkant
666,R10 414,2023-03-29,18:00:00,179,139,40,FMN 19 Binnensingel Oostkant
666,R10 414,2023-03-29,19:00:00,114,85,29,FMN 19 Binnensingel Oostkant
666,R10 414,2023-03-29,20:00:00,88,72,16,FMN 19 Binnensingel Oostkant
666,R10 414,2023-03-29,21:00:00,63,54,9,FMN 19 Binnensingel Oostkant
666,R10 414,2023-03-29,22:00:00,74,58,16,FMN 19 Binnensingel Oostkant
666,R10 414,2023-03-29,23:00:00,30,28,2,FMN 19 Binnensingel Oostkant
666,R10 414,2023-03-30,00:00:00,14,11,3,FMN 19 Binnensingel Oostkant
666,R10 414,2023-03-30,01:00:00,5,4,1,FMN 19 Binnensingel Oostkant
666,R10 414,2023-03-30,02:00:00,8,6,2,FMN 19 Binnensingel Oostkant
666,R10 414,2023-03-30,03:00:00,9,5,4,FMN 19 Binnensingel Oostkant
666,R10 414,2023-03-30,04:00:00,25,10,15,FMN 19 Binnensingel Oostkant
666,R10 414,2023-03-30,05:00:00,24,10,14,FMN 19 Binnensingel Oostkant
666,R10 414,2023-03-30,06:00:00,57,43,14,FMN 19 Binnensingel Oostkant
666,R10 414,2023-03-30,07:00:00,121,92,29,FMN 19 Binnensingel Oostkant
666,R10 414,2023-03-30,08:00:00,218,140,78,FMN 19 Binnensingel Oostkant
666,R10 414,2023-03-30,09:00:00,76,54,22,FMN 19 Binnensingel Oostkant
666,R10 414,2023-03-30,10:00:00,61,40,21,FMN 19 Binnensingel Oostkant
666,R10 414,2023-03-30,11:00:00,65,54,11,FMN 19 Binnensingel Oostkant
666,R10 414,2023-03-30,12:00:00,90,64,26,FMN 19 Binnensingel Oostkant
666,R10 414,2023-03-30,13:00:00,98,78,20,FMN 19 Binnensingel Oostkant
666,R10 414,2023-03-30,14:00:00,93,72,21,FMN 19 Binnensingel Oostkant
666,R10 414,2023-03-30,15:00:00,135,115,20,FMN 19 Binnensingel Oostkant
666,R10 414,2023-03-30,16:00:00,197,157,40,FMN 19 Binnensingel Oostkant
666,R10 414,2023-03-30,17:00:00,210,167,43,FMN 19 Binnensingel Oostkant
666,R10 414,2023-03-30,18:00:00,161,112,49,FMN 19 Binnensingel Oostkant
666,R10 414,2023-03-30,19:00:00,132,105,27,FMN 19 Binnensingel Oostkant
666,R10 414,2023-03-30,20:00:00,107,62,45,FMN 19 Binnensingel Oostkant
666,R10 414,2023-03-30,21:00:00,61,49,12,FMN 19 Binnensingel Oostkant
666,R10 414,2023-03-30,22:00:00,59,45,14,FMN 19 Binnensingel Oostkant
666,R10 414,2023-03-30,23:00:00,60,51,9,FMN 19 Binnensingel Oostkant
666,R10 414,2023-03-31,00:00:00,18,16,2,FMN 19 Binnensingel Oostkant
666,R10 414,2023-03-31,01:00:00,9,9,0,FMN 19 Binnensingel Oostkant
666,R10 414,2023-03-31,02:00:00,4,4,0,FMN 19 Binnensingel Oostkant
666,R10 414,2023-03-31,03:00:00,15,8,7,FMN 19 Binnensingel Oostkant
666,R10 414,2023-03-31,04:00:00,15,7,8,FMN 19 Binnensingel Oostkant
666,R10 414,2023-03-31,05:00:00,17,8,9,FMN 19 Binnensingel Oostkant
666,R10 414,2023-03-31,06:00:00,37,28,9,FMN 19 Binnensingel Oostkant
666,R10 414,2023-03-31,07:00:00,73,45,28,FMN 19 Binnensingel Oostkant
666,R10 414,2023-03-31,08:00:00,114,84,30,FMN 19 Binnensingel Oostkant
666,R10 414,2023-03-31,09:00:00,41,32,9,FMN 19 Binnensingel Oostkant
666,R10 414,2023-03-31,10:00:00,53,34,19,FMN 19 Binnensingel Oostkant
666,R10 414,2023-03-31,11:00:00,55,41,14,FMN 19 Binnensingel Oostkant
666,R10 414,2023-03-31,12:00:00,56,41,15,FMN 19 Binnensingel Oostkant
666,R10 414,2023-03-31,13:00:00,83,62,21,FMN 19 Binnensingel Oostkant
666,R10 414,2023-03-31,14:00:00,66,58,8,FMN 19 Binnensingel Oostkant
666,R10 414,2023-03-31,15:00:00,116,103,13,FMN 19 Binnensingel Oostkant
666,R10 414,2023-03-31,16:00:00,130,110,20,FMN 19 Binnensingel Oostkant
666,R10 414,2023-03-31,17:00:00,155,125,30,FMN 19 Binnensingel Oostkant
666,R10 414,2023-03-31,18:00:00,114,85,29,FMN 19 Binnensingel Oostkant
666,R10 414,2023-03-31,19:00:00,56,46,10,FMN 19 Binnensingel Oostkant
666,R10 414,2023-03-31,20:00:00,60,57,3,FMN 19 Binnensingel Oostkant
666,R10 414,2023-03-31,21:00:00,32,24,8,FMN 19 Binnensingel Oostkant
666,R10 414,2023-03-31,22:00:00,63,56,7,FMN 19 Binnensingel Oostkant
666,R10 414,2023-03-31,23:00:00,36,27,9,FMN 19 Binnensingel Oostkant
666,R10 414,2023-04-01,00:00:00,23,13,10,FMN 19 Binnensingel Oostkant
666,R10 414,2023-04-01,01:00:00,24,10,14,FMN 19 Binnensingel Oostkant
666,R10 414,2023-04-01,02:00:00,14,7,7,FMN 19 Binnensingel Oostkant
666,R10 414,2023-04-01,03:00:00,18,9,9,FMN 19 Binnensingel Oostkant
666,R10 414,2023-04-01,04:00:00,19,9,10,FMN 19 Binnensingel Oostkant
666,R10 414,2023-04-01,05:00:00,8,6,2,FMN 19 Binnensingel Oostkant
666,R10 414,2023-04-01,06:00:00,21,11,10,FMN 19 Binnensingel Oostkant
666,R10 414,2023-04-01,07:00:00,15,10,5,FMN 19 Binnensingel Oostkant
666,R10 414,2023-04-01,08:00:00,17,13,4,FMN 19 Binnensingel Oostkant
666,R10 414,2023-04-01,09:00:00,24,15,9,FMN 19 Binnensingel Oostkant
666,R10 414,2023-04-01,10:00:00,25,22,3,FMN 19 Binnensingel Oostkant
666,R10 414,2023-04-01,11:00:00,28,22,6,FMN 19 Binnensingel Oostkant
666,R10 414,2023-04-01,12:00:00,36,28,8,FMN 19 Binnensingel Oostkant
666,R10 414,2023-04-01,13:00:00,43,34,9,FMN 19 Binnensingel Oostkant
666,R10 414,2023-04-01,14:00:00,39,28,11,FMN 19 Binnensingel Oostkant
666,R10 414,2023-04-01,15:00:00,23,18,5,FMN 19 Binnensingel Oostkant
666,R10 414,2023-04-01,16:00:00,27,21,6,FMN 19 Binnensingel Oostkant
666,R10 414,2023-04-01,17:00:00,31,27,4,FMN 19 Binnensingel Oostkant
666,R10 414,2023-04-01,18:00:00,50,44,6,FMN 19 Binnensingel Oostkant
666,R10 414,2023-04-01,19:00:00,31,16,15,FMN 19 Binnensingel Oostkant
666,R10 414,2023-04-01,20:00:00,37,26,11,FMN 19 Binnensingel Oostkant
666,R10 414,2023-04-01,21:00:00,37,31,6,FMN 19 Binnensingel Oostkant
666,R10 414,2023-04-01,22:00:00,26,15,11,FMN 19 Binnensingel Oostkant
666,R10 414,2023-04-01,23:00:00,20,18,2,FMN 19 Binnensingel Oostkant
666,R10 414,2023-04-02,00:00:00,13,13,0,FMN 19 Binnensingel Oostkant
666,R10 414,2023-04-02,01:00:00,16,10,6,FMN 19 Binnensingel Oostkant
666,R10 414,2023-04-02,02:00:00,7,7,0,FMN 19 Binnensingel Oostkant
666,R10 414,2023-04-02,03:00:00,8,4,4,FMN 19 Binnensingel Oostkant
666,R10 414,2023-04-02,04:00:00,4,2,2,FMN 19 Binnensingel Oostkant
666,R10 414,2023-04-02,05:00:00,13,11,2,FMN 19 Binnensingel Oostkant
666,R10 414,2023-04-02,06:00:00,10,7,3,FMN 19 Binnensingel Oostkant
666,R10 414,2023-04-02,07:00:00,13,10,3,FMN 19 Binnensingel Oostkant
666,R10 414,2023-04-02,08:00:00,19,16,3,FMN 19 Binnensingel Oostkant
666,R10 414,2023-04-02,09:00:00,27,19,8,FMN 19 Binnensingel Oostkant
666,R10 414,2023-04-02,10:00:00,31,24,7,FMN 19 Binnensingel Oostkant
666,R10 414,2023-04-02,11:00:00,44,28,16,FMN 19 Binnensingel Oostkant
666,R10 414,2023-04-02,12:00:00,71,55,16,FMN 19 Binnensingel Oostkant
666,R10 414,2023-04-02,13:00:00,40,29,11,FMN 19 Binnensingel Oostkant
666,R10 414,2023-04-02,14:00:00,45,31,14,FMN 19 Binnensingel Oostkant
666,R10 414,2023-04-02,15:00:00,52,31,21,FMN 19 Binnensingel Oostkant
666,R10 414,2023-04-02,16:00:00,53,39,14,FMN 19 Binnensingel Oostkant
666,R10 414,2023-04-02,17:00:00,59,46,13,FMN 19 Binnensingel Oostkant
666,R10 414,2023-04-02,18:00:00,61,47,14,FMN 19 Binnensingel Oostkant
666,R10 414,2023-04-02,19:00:00,44,28,16,FMN 19 Binnensingel Oostkant
666,R10 414,2023-04-02,20:00:00,39,26,13,FMN 19 Binnensingel Oostkant
666,R10 414,2023-04-02,21:00:00,45,33,12,FMN 19 Binnensingel Oostkant
666,R10 414,2023-04-02,22:00:00,35,27,8,FMN 19 Binnensingel Oostkant
666,R10 414,2023-04-02,23:00:00,17,16,1,FMN 19 Binnensingel Oostkant
666,R10 414,2023-04-03,00:00:00,13,8,5,FMN 19 Binnensingel Oostkant
666,R10 414,2023-04-03,01:00:00,10,10,0,FMN 19 Binnensingel Oostkant
666,R10 414,2023-04-03,02:00:00,5,5,0,FMN 19 Binnensingel Oostkant
666,R10 414,2023-04-03,03:00:00,4,1,3,FMN 19 Binnensingel Oostkant
666,R10 414,2023-04-03,04:00:00,11,9,2,FMN 19 Binnensingel Oostkant
666,R10 414,2023-04-03,05:00:00,27,11,16,FMN 19 Binnensingel Oostkant
666,R10 414,2023-04-03,06:00:00,50,31,19,FMN 19 Binnensingel Oostkant
666,R10 414,2023-04-03,07:00:00,108,75,33,FMN 19 Binnensingel Oostkant
666,R10 414,2023-04-03,08:00:00,139,101,38,FMN 19 Binnensingel Oostkant
666,R10 414,2023-04-03,09:00:00,69,48,21,FMN 19 Binnensingel Oostkant
666,R10 414,2023-04-03,10:00:00,35,30,5,FMN 19 Binnensingel Oostkant
666,R10 414,2023-04-03,11:00:00,40,28,12,FMN 19 Binnensingel Oostkant
666,R10 414,2023-04-03,12:00:00,71,49,22,FMN 19 Binnensingel Oostkant
666,R10 414,2023-04-03,13:00:00,58,44,14,FMN 19 Binnensingel Oostkant
666,R10 414,2023-04-03,14:00:00,62,49,13,FMN 19 Binnensingel Oostkant
666,R10 414,2023-04-03,15:00:00,96,80,16,FMN 19 Binnensingel Oostkant
666,R10 414,2023-04-03,16:00:00,164,124,40,FMN 19 Binnensingel Oostkant
666,R10 414,2023-04-03,17:00:00,203,157,46,FMN 19 Binnensingel Oostkant
666,R10 414,2023-04-03,18:00:00,125,87,38,FMN 19 Binnensingel Oostkant
666,R10 414,2023-04-03,19:00:00,86,64,22,FMN 19 Binnensingel Oostkant
666,R10 414,2023-04-03,20:00:00,55,38,17,FMN 19 Binnensingel Oostkant
666,R10 414,2023-04-03,21:00:00,55,47,8,FMN 19 Binnensingel Oostkant
666,R10 414,2023-04-03,22:00:00,45,35,10,FMN 19 Binnensingel Oostkant
666,R10 414,2023-04-03,23:00:00,12,10,2,FMN 19 Binnensingel Oostkant
666,R10 414,2023-04-04,00:00:00,16,10,6,FMN 19 Binnensingel Oostkant
666,R10 414,2023-04-04,01:00:00,9,6,3,FMN 19 Binnensingel Oostkant
666,R10 414,2023-04-04,02:00:00,5,4,1,FMN 19 Binnensingel Oostkant
666,R10 414,2023-04-04,03:00:00,4,3,1,FMN 19 Binnensingel Oostkant
666,R10 414,2023-04-04,04:00:00,13,8,5,FMN 19 Binnensingel Oostkant
666,R10 414,2023-04-04,05:00:00,22,9,13,FMN 19 Binnensingel Oostkant
666,R10 414,2023-04-04,06:00:00,56,39,17,FMN 19 Binnensingel Oostkant
666,R10 414,2023-04-04,07:00:00,117,78,39,FMN 19 Binnensingel Oostkant
666,R10 414,2023-04-04,08:00:00,147,113,34,FMN 19 Binnensingel Oostkant
666,R10 414,2023-04-04,09:00:00,73,49,24,FMN 19 Binnensingel Oostkant
666,R10 414,2023-04-04,10:00:00,49,40,9,FMN 19 Binnensingel Oostkant
666,R10 414,2023-04-04,11:00:00,47,39,8,FMN 19 Binnensingel Oostkant
666,R10 414,2023-04-04,12:00:00,71,47,24,FMN 19 Binnensingel Oostkant
666,R10 414,2023-04-04,13:00:00,68,50,18,FMN 19 Binnensingel Oostkant
666,R10 414,2023-04-04,14:00:00,80,60,20,FMN 19 Binnensingel Oostkant
666,R10 414,2023-04-04,15:00:00,109,86,23,FMN 19 Binnensingel Oostkant
666,R10 414,2023-04-04,16:00:00,162,123,39,FMN 19 Binnensingel Oostkant
666,R10 414,2023-04-04,17:00:00,254,195,59,FMN 19 Binnensingel Oostkant
666,R10 414,2023-04-04,18:00:00,126,88,38,FMN 19 Binnensingel Oostkant
666,R10 414,2023-04-04,19:00:00,87,71,16,FMN 19 Binnensingel Oostkant
666,R10 414,2023-04-04,20:00:00,49,38,11,FMN 19 Binnensingel Oostkant
666,R10 414,2023-04-04,21:00:00,34,25,9,FMN 19 Binnensingel Oostkant
666,R10 414,2023-04-04,22:00:00,54,40,14,FMN 19 Binnensingel Oostkant
666,R10 414,2023-04-04,23:00:00,32,25,7,FMN 19 Binnensingel Oostkant
666,R10 414,2023-04-05,00:00:00,14,8,6,FMN 19 Binnensingel Oostkant
666,R10 414,2023-04-05,01:00:00,6,6,0,FMN 19 Binnensingel Oostkant
666,R10 414,2023-04-05,02:00:00,6,6,0,FMN 19 Binnensingel Oostkant
666,R10 414,2023-04-05,03:00:00,6,4,2,FMN 19 Binnensingel Oostkant
666,R10 414,2023-04-05,04:00:00,16,9,7,FMN 19 Binnensingel Oostkant
666,R10 414,2023-04-05,05:00:00,26,13,13,FMN 19 Binnensingel Oostkant
666,R10 414,2023-04-05,06:00:00,51,34,17,FMN 19 Binnensingel Oostkant
666,R10 414,2023-04-05,07:00:00,107,73,34,FMN 19 Binnensingel Oostkant
666,R10 414,2023-04-05,08:00:00,141,110,31,FMN 19 Binnensingel Oostkant
666,R10 414,2023-04-05,09:00:00,65,49,16,FMN 19 Binnensingel Oostkant
666,R10 414,2023-04-05,10:00:00,43,31,12,FMN 19 Binnensingel Oostkant
666,R10 414,2023-04-05,11:00:00,59,46,13,FMN 19 Binnensingel Oostkant
666,R10 414,2023-04-05,12:00:00,66,47,19,FMN 19 Binnensingel Oostkant
666,R10 414,2023-04-05,13:00:00,57,47,10,FMN 19 Binnensingel Oostkant
666,R10 414,2023-04-05,14:00:00,65,52,13,FMN 19 Binnensingel Oostkant
666,R10 414,2023-04-05,15:00:00,91,72,19,FMN 19 Binnensingel Oostkant
666,R10 414,2023-04-05,16:00:00,195,147,48,FMN 19 Binnensingel Oostkant
666,R10 414,2023-04-05,17:00:00,195,160,35,FMN 19 Binnensingel Oostkant
666,R10 414,2023-04-05,18:00:00,171,117,54,FMN 19 Binnensingel Oostkant
666,R10 414,2023-04-05,19:00:00,95,66,29,FMN 19 Binnensingel Oostkant
666,R10 414,2023-04-05,20:00:00,83,61,22,FMN 19 Binnensingel Oostkant
666,R10 414,2023-04-05,21:00:00,57,53,4,FMN 19 Binnensingel Oostkant
666,R10 414,2023-04-05,22:00:00,45,30,15,FMN 19 Binnensingel Oostkant
666,R10 414,2023-04-05,23:00:00,22,13,9,FMN 19 Binnensingel Oostkant
666,R10 414,2023-04-06,00:00:00,9,7,2,FMN 19 Binnensingel Oostkant
666,R10 414,2023-04-06,01:00:00,16,13,3,FMN 19 Binnensingel Oostkant
666,R10 414,2023-04-06,02:00:00,8,7,1,FMN 19 Binnensingel Oostkant
666,R10 414,2023-04-06,03:00:00,3,2,1,FMN 19 Binnensingel Oostkant
666,R10 414,2023-04-06,04:00:00,12,7,5,FMN 19 Binnensingel Oostkant
666,R10 414,2023-04-06,05:00:00,25,12,13,FMN 19 Binnensingel Oostkant
666,R10 414,2023-04-06,06:00:00,51,37,14,FMN 19 Binnensingel Oostkant
666,R10 414,2023-04-06,07:00:00,104,77,27,FMN 19 Binnensingel Oostkant
666,R10 414,2023-04-06,08:00:00,125,86,39,FMN 19 Binnensingel Oostkant
666,R10 414,2023-04-06,09:00:00,49,30,19,FMN 19 Binnensingel Oostkant
666,R10 414,2023-04-06,10:00:00,21,13,8,FMN 19 Binnensingel Oostkant
666,R10 414,2023-04-06,11:00:00,28,23,5,FMN 19 Binnensingel Oostkant
666,R10 414,2023-04-06,12:00:00,52,33,19,FMN 19 Binnensingel Oostkant
666,R10 414,2023-04-06,13:00:00,32,28,4,FMN 19 Binnensingel Oostkant
666,R10 414,2023-04-06,14:00:00,39,35,4,FMN 19 Binnensingel Oostkant
666,R10 414,2023-04-06,15:00:00,60,46,14,FMN 19 Binnensingel Oostkant
666,R10 414,2023-04-06,16:00:00,141,117,24,FMN 19 Binnensingel Oostkant
666,R10 414,2023-04-06,17:00:00,174,133,41,FMN 19 Binnensingel Oostkant
666,R10 414,2023-04-06,18:00:00,100,71,29,FMN 19 Binnensingel Oostkant
666,R10 414,2023-04-06,19:00:00,45,30,15,FMN 19 Binnensingel Oostkant
666,R10 414,2023-04-06,20:00:00,41,29,12,FMN 19 Binnensingel Oostkant
666,R10 414,2023-04-06,21:00:00,32,27,5,FMN 19 Binnensingel Oostkant
666,R10 414,2023-04-06,22:00:00,45,37,8,FMN 19 Binnensingel Oostkant
666,R10 414,2023-04-06,23:00:00,20,13,7,FMN 19 Binnensingel Oostkant
666,R10 414,2023-04-07,00:00:00,13,6,7,FMN 19 Binnensingel Oostkant
666,R10 414,2023-04-07,01:00:00,3,3,0,FMN 19 Binnensingel Oostkant
666,R10 414,2023-04-07,02:00:00,4,2,2,FMN 19 Binnensingel Oostkant
666,R10 414,2023-04-07,03:00:00,9,6,3,FMN 19 Binnensingel Oostkant
666,R10 414,2023-04-07,04:00:00,13,10,3,FMN 19 Binnensingel Oostkant
666,R10 414,2023-04-07,05:00:00,25,13,12,FMN 19 Binnensingel Oostkant
666,R10 414,2023-04-07,06:00:00,34,26,8,FMN 19 Binnensingel Oostkant
666,R10 414,2023-04-07,07:00:00,79,57,22,FMN 19 Binnensingel Oostkant
666,R10 414,2023-04-07,08:00:00,90,60,30,FMN 19 Binnensingel Oostkant
666,R10 414,2023-04-07,09:00:00,57,45,12,FMN 19 Binnensingel Oostkant
666,R10 414,2023-04-07,10:00:00,38,30,8,FMN 19 Binnensingel Oostkant
666,R10 414,2023-04-07,11:00:00,48,36,12,FMN 19 Binnensingel Oostkant
666,R10 414,2023-04-07,12:00:00,54,36,18,FMN 19 Binnensingel Oostkant
666,R10 414,2023-04-07,13:00:00,70,54,16,FMN 19 Binnensingel Oostkant
666,R10 414,2023-04-07,14:00:00,76,57,19,FMN 19 Binnensingel Oostkant
666,R10 414,2023-04-07,15:00:00,95,74,21,FMN 19 Binnensingel Oostkant
666,R10 414,2023-04-07,16:00:00,127,100,27,FMN 19 Binnensingel Oostkant
666,R10 414,2023-04-07,17:00:00,135,98,37,FMN 19 Binnensingel Oostkant
666,R10 414,2023-04-07,18:00:00,114,87,27,FMN 19 Binnensingel Oostkant
666,R10 414,2023-04-07,19:00:00,91,74,17,FMN 19 Binnensingel Oostkant
666,R10 414,2023-04-07,20:00:00,74,59,15,FMN 19 Binnensingel Oostkant
666,R10 414,2023-04-07,21:00:00,57,52,5,FMN 19 Binnensingel Oostkant
666,R10 414,2023-04-07,22:00:00,41,35,6,FMN 19 Binnensingel Oostkant
666,R10 414,2023-04-07,23:00:00,35,24,11,FMN 19 Binnensingel Oostkant
666,R10 414,2023-04-08,00:00:00,25,10,15,FMN 19 Binnensingel Oostkant
666,R10 414,2023-04-08,01:00:00,15,11,4,FMN 19 Binnensingel Oostkant
666,R10 414,2023-04-08,02:00:00,20,14,6,FMN 19 Binnensingel Oostkant
666,R10 414,2023-04-08,03:00:00,7,6,1,FMN 19 Binnensingel Oostkant
666,R10 414,2023-04-08,04:00:00,19,9,10,FMN 19 Binnensingel Oostkant
666,R10 414,2023-04-08,05:00:00,16,8,8,FMN 19 Binnensingel Oostkant
666,R10 414,2023-04-08,06:00:00,14,8,6,FMN 19 Binnensingel Oostkant
666,R10 414,2023-04-08,07:00:00,24,18,6,FMN 19 Binnensingel Oostkant
666,R10 414,2023-04-08,08:00:00,26,18,8,FMN 19 Binnensingel Oostkant
666,R10 414,2023-04-08,09:00:00,37,28,9,FMN 19 Binnensingel Oostkant
666,R10 414,2023-04-08,10:00:00,31,28,3,FMN 19 Binnensingel Oostkant
666,R10 414,2023-04-08,11:00:00,32,29,3,FMN 19 Binnensingel Oostkant
666,R10 414,2023-04-08,12:00:00,49,36,13,FMN 19 Binnensingel Oostkant
666,R10 414,2023-04-08,13:00:00,58,39,19,FMN 19 Binnensingel Oostkant
666,R10 414,2023-04-08,14:00:00,56,43,13,FMN 19 Binnensingel Oostkant
666,R10 414,2023-04-08,15:00:00,63,54,9,FMN 19 Binnensingel Oostkant
666,R10 414,2023-04-08,16:00:00,83,56,27,FMN 19 Binnensingel Oostkant
666,R10 414,2023-04-08,17:00:00,80,60,20,FMN 19 Binnensingel Oostkant
666,R10 414,2023-04-08,18:00:00,86,67,19,FMN 19 Binnensingel Oostkant
666,R10 414,2023-04-08,19:00:00,62,47,15,FMN 19 Binnensingel Oostkant
666,R10 414,2023-04-08,20:00:00,51,39,12,FMN 19 Binnensingel Oostkant
666,R10 414,2023-04-08,21:00:00,38,34,4,FMN 19 Binnensingel Oostkant
666,R10 414,2023-04-08,22:00:00,36,26,10,FMN 19 Binnensingel Oostkant
666,R10 414,2023-04-08,23:00:00,24,18,6,FMN 19 Binnensingel Oostkant
666,R10 414,2023-04-09,00:00:00,22,14,8,FMN 19 Binnensingel Oostkant
666,R10 414,2023-04-09,01:00:00,15,7,8,FMN 19 Binnensingel Oostkant
666,R10 414,2023-04-09,02:00:00,6,4,2,FMN 19 Binnensingel Oostkant
666,R10 414,2023-04-09,03:00:00,9,5,4,FMN 19 Binnensingel Oostkant
666,R10 414,2023-04-09,04:00:00,8,7,1,FMN 19 Binnensingel Oostkant
666,R10 414,2023-04-09,05:00:00,13,7,6,FMN 19 Binnensingel Oostkant
666,R10 414,2023-04-09,06:00:00,9,6,3,FMN 19 Binnensingel Oostkant
666,R10 414,2023-04-09,07:00:00,10,8,2,FMN 19 Binnensingel Oostkant
666,R10 414,2023-04-09,08:00:00,23,18,5,FMN 19 Binnensingel Oostkant
666,R10 414,2023-04-09,09:00:00,28,16,12,FMN 19 Binnensingel Oostkant
666,R10 414,2023-04-09,10:00:00,31,22,9,FMN 19 Binnensingel Oostkant
666,R10 414,2023-04-09,11:00:00,47,33,14,FMN 19 Binnensingel Oostkant
666,R10 414,2023-04-09,12:00:00,65,47,18,FMN 19 Binnensingel Oostkant
666,R10 414,2023-04-09,13:00:00,58,45,13,FMN 19 Binnensingel Oostkant
666,R10 414,2023-04-09,14:00:00,75,51,24,FMN 19 Binnensingel Oostkant
666,R10 414,2023-04-09,15:00:00,76,55,21,FMN 19 Binnensingel Oostkant
666,R10 414,2023-04-09,16:00:00,79,44,35,FMN 19 Binnensingel Oostkant
666,R10 414,2023-04-09,17:00:00,97,61,36,FMN 19 Binnensingel Oostkant
666,R10 414,2023-04-09,18:00:00,84,51,33,FMN 19 Binnensingel Oostkant
666,R10 414,2023-04-09,19:00:00,47,41,6,FMN 19 Binnensingel Oostkant
666,R10 414,2023-04-09,20:00:00,44,27,17,FMN 19 Binnensingel Oostkant
666,R10 414,2023-04-09,21:00:00,32,22,10,FMN 19 Binnensingel Oostkant
666,R10 414,2023-04-09,22:00:00,47,40,7,FMN 19 Binnensingel Oostkant
666,R10 414,2023-04-09,23:00:00,16,15,1,FMN 19 Binnensingel Oostkant
666,R10 414,2023-04-10,00:00:00,13,6,7,FMN 19 Binnensingel Oostkant
666,R10 414,2023-04-10,01:00:00,13,12,1,FMN 19 Binnensingel Oostkant
666,R10 414,2023-04-10,02:00:00,7,6,1,FMN 19 Binnensingel Oostkant
666,R10 414,2023-04-10,03:00:00,2,0,2,FMN 19 Binnensingel Oostkant
666,R10 414,2023-04-10,04:00:00,1,1,0,FMN 19 Binnensingel Oostkant
666,R10 414,2023-04-10,05:00:00,7,4,3,FMN 19 Binnensingel Oostkant
666,R10 414,2023-04-10,06:00:00,9,6,3,FMN 19 Binnensingel Oostkant
666,R10 414,2023-04-10,07:00:00,10,7,3,FMN 19 Binnensingel Oostkant
666,R10 414,2023-04-10,08:00:00,21,12,9,FMN 19 Binnensingel Oostkant
666,R10 414,2023-04-10,09:00:00,24,17,7,FMN 19 Binnensingel Oostkant
666,R10 414,2023-04-10,10:00:00,43,33,10,FMN 19 Binnensingel Oostkant
666,R10 414,2023-04-10,11:00:00,37,30,7,FMN 19 Binnensingel Oostkant
666,R10 414,2023-04-10,12:00:00,32,25,7,FMN 19 Binnensingel Oostkant
666,R10 414,2023-04-10,13:00:00,40,29,11,FMN 19 Binnensingel Oostkant
666,R10 414,2023-04-10,14:00:00,40,27,13,FMN 19 Binnensingel Oostkant
666,R10 414,2023-04-10,15:00:00,34,26,8,FMN 19 Binnensingel Oostkant
666,R10 414,2023-04-10,16:00:00,42,33,9,FMN 19 Binnensingel Oostkant
666,R10 414,2023-04-10,17:00:00,46,35,11,FMN 19 Binnensingel Oostkant
666,R10 414,2023-04-10,18:00:00,36,29,7,FMN 19 Binnensingel Oostkant
666,R10 414,2023-04-10,19:00:00,27,22,5,FMN 19 Binnensingel Oostkant
666,R10 414,2023-04-10,20:00:00,34,29,5,FMN 19 Binnensingel Oostkant
666,R10 414,2023-04-10,21:00:00,17,14,3,FMN 19 Binnensingel Oostkant
666,R10 414,2023-04-10,22:00:00,24,23,1,FMN 19 Binnensingel Oostkant
666,R10 414,2023-04-10,23:00:00,13,9,4,FMN 19 Binnensingel Oostkant
666,R10 414,2023-04-11,00:00:00,10,9,1,FMN 19 Binnensingel Oostkant
666,R10 414,2023-04-11,01:00:00,10,7,3,FMN 19 Binnensingel Oostkant
666,R10 414,2023-04-11,02:00:00,4,4,0,FMN 19 Binnensingel Oostkant
666,R10 414,2023-04-11,03:00:00,5,3,2,FMN 19 Binnensingel Oostkant
666,R10 414,2023-04-11,04:00:00,18,7,11,FMN 19 Binnensingel Oostkant
666,R10 414,2023-04-11,05:00:00,16,8,8,FMN 19 Binnensingel Oostkant
666,R10 414,2023-04-11,06:00:00,55,38,17,FMN 19 Binnensingel Oostkant
666,R10 414,2023-04-11,07:00:00,107,80,27,FMN 19 Binnensingel Oostkant
666,R10 414,2023-04-11,08:00:00,125,95,30,FMN 19 Binnensingel Oostkant
666,R10 414,2023-04-11,09:00:00,73,51,22,FMN 19 Binnensingel Oostkant
666,R10 414,2023-04-11,10:00:00,51,37,14,FMN 19 Binnensingel Oostkant
666,R10 414,2023-04-11,11:00:00,55,46,9,FMN 19 Binnensingel Oostkant
666,R10 414,2023-04-11,12:00:00,71,56,15,FMN 19 Binnensingel Oostkant
666,R10 414,2023-04-11,13:00:00,73,50,23,FMN 19 Binnensingel Oostkant
666,R10 414,2023-04-11,14:00:00,64,49,15,FMN 19 Binnensingel Oostkant
666,R10 414,2023-04-11,15:00:00,91,68,23,FMN 19 Binnensingel Oostkant
666,R10 414,2023-04-11,16:00:00,166,131,35,FMN 19 Binnensingel Oostkant
666,R10 414,2023-04-11,17:00:00,176,133,43,FMN 19 Binnensingel Oostkant
666,R10 414,2023-04-11,18:00:00,129,91,38,FMN 19 Binnensingel Oostkant
666,R10 414,2023-04-11,19:00:00,83,65,18,FMN 19 Binnensingel Oostkant
666,R10 414,2023-04-11,20:00:00,65,51,14,FMN 19 Binnensingel Oostkant
666,R10 414,2023-04-11,21:00:00,44,29,15,FMN 19 Binnensingel Oostkant
666,R10 414,2023-04-11,22:00:00,43,30,13,FMN 19 Binnensingel Oostkant
666,R10 414,2023-04-11,23:00:00,13,8,5,FMN 19 Binnensingel Oostkant
666,R10 414,2023-04-12,00:00:00,15,12,3,FMN 19 Binnensingel Oostkant
666,R10 414,2023-04-12,01:00:00,7,6,1,FMN 19 Binnensingel Oostkant
666,R10 414,2023-04-12,02:00:00,6,4,2,FMN 19 Binnensingel Oostkant
666,R10 414,2023-04-12,03:00:00,5,3,2,FMN 19 Binnensingel Oostkant
666,R10 414,2023-04-12,04:00:00,14,5,9,FMN 19 Binnensingel Oostkant
666,R10 414,2023-04-12,05:00:00,21,10,11,FMN 19 Binnensingel Oostkant
666,R10 414,2023-04-12,06:00:00,55,38,17,FMN 19 Binnensingel Oostkant
666,R10 414,2023-04-12,07:00:00,95,67,28,FMN 19 Binnensingel Oostkant
666,R10 414,2023-04-12,08:00:00,71,48,23,FMN 19 Binnensingel Oostkant
666,R10 414,2023-04-12,09:00:00,44,33,11,FMN 19 Binnensingel Oostkant
666,R10 414,2023-04-12,10:00:00,37,29,8,FMN 19 Binnensingel Oostkant
666,R10 414,2023-04-12,11:00:00,44,33,11,FMN 19 Binnensingel Oostkant
666,R10 414,2023-04-12,12:00:00,41,32,9,FMN 19 Binnensingel Oostkant
666,R10 414,2023-04-12,13:00:00,54,40,14,FMN 19 Binnensingel Oostkant
666,R10 414,2023-04-12,14:00:00,64,51,13,FMN 19 Binnensingel Oostkant
666,R10 414,2023-04-12,15:00:00,72,57,15,FMN 19 Binnensingel Oostkant
666,R10 414,2023-04-12,16:00:00,111,89,22,FMN 19 Binnensingel Oostkant
666,R10 414,2023-04-12,17:00:00,136,112,24,FMN 19 Binnensingel Oostkant
666,R10 414,2023-04-12,18:00:00,107,75,32,FMN 19 Binnensingel Oostkant
666,R10 414,2023-04-12,19:00:00,74,49,25,FMN 19 Binnensingel Oostkant
666,R10 414,2023-04-12,20:00:00,65,54,11,FMN 19 Binnensingel Oostkant
666,R10 414,2023-04-12,21:00:00,49,40,9,FMN 19 Binnensingel Oostkant
666,R10 414,2023-04-12,22:00:00,50,39,11,FMN 19 Binnensingel Oostkant
666,R10 414,2023-04-12,23:00:00,16,9,7,FMN 19 Binnensingel Oostkant
666,R10 414,2023-04-13,00:00:00,9,6,3,FMN 19 Binnensingel Oostkant
666,R10 414,2023-04-13,01:00:00,4,3,1,FMN 19 Binnensingel Oostkant
666,R10 414,2023-04-13,02:00:00,5,3,2,FMN 19 Binnensingel Oostkant
666,R10 414,2023-04-13,03:00:00,7,3,4,FMN 19 Binnensingel Oostkant
666,R10 414,2023-04-13,04:00:00,16,7,9,FMN 19 Binnensingel Oostkant
666,R10 414,2023-04-13,05:00:00,25,14,11,FMN 19 Binnensingel Oostkant
666,R10 414,2023-04-13,06:00:00,52,35,17,FMN 19 Binnensingel Oostkant
666,R10 414,2023-04-13,07:00:00,116,82,34,FMN 19 Binnensingel Oostkant
666,R10 414,2023-04-13,08:00:00,122,90,32,FMN 19 Binnensingel Oostkant
666,R10 414,2023-04-13,09:00:00,43,28,15,FMN 19 Binnensingel Oostkant
666,R10 414,2023-04-13,10:00:00,43,38,5,FMN 19 Binnensingel Oostkant
666,R10 414,2023-04-13,11:00:00,38,28,10,FMN 19 Binnensingel Oostkant
666,R10 414,2023-04-13,12:00:00,60,47,13,FMN 19 Binnensingel Oostkant
666,R10 414,2023-04-13,13:00:00,62,51,11,FMN 19 Binnensingel Oostkant
666,R10 414,2023-04-13,14:00:00,55,46,9,FMN 19 Binnensingel Oostkant
666,R10 414,2023-04-13,15:00:00,81,60,21,FMN 19 Binnensingel Oostkant
666,R10 414,2023-04-13,16:00:00,135,104,31,FMN 19 Binnensingel Oostkant
666,R10 414,2023-04-13,17:00:00,209,156,53,FMN 19 Binnensingel Oostkant
666,R10 414,2023-04-13,18:00:00,126,84,42,FMN 19 Binnensingel Oostkant
666,R10 414,2023-04-13,19:00:00,70,51,19,FMN 19 Binnensingel Oostkant
666,R10 414,2023-04-13,20:00:00,75,46,29,FMN 19 Binnensingel Oostkant
666,R10 414,2023-04-13,21:00:00,49,41,8,FMN 19 Binnensingel Oostkant
666,R10 414,2023-04-13,22:00:00,51,38,13,FMN 19 Binnensingel Oostkant
666,R10 414,2023-04-13,23:00:00,40,35,5,FMN 19 Binnensingel Oostkant
666,R10 414,2023-04-14,00:00:00,23,15,8,FMN 19 Binnensingel Oostkant
666,R10 414,2023-04-14,01:00:00,9,8,1,FMN 19 Binnensingel Oostkant
666,R10 414,2023-04-14,02:00:00,3,3,0,FMN 19 Binnensingel Oostkant
666,R10 414,2023-04-14,03:00:00,8,6,2,FMN 19 Binnensingel Oostkant
666,R10 414,2023-04-14,04:00:00,19,8,11,FMN 19 Binnensingel Oostkant
666,R10 414,2023-04-14,05:00:00,32,17,15,FMN 19 Binnensingel Oostkant
666,R10 414,2023-04-14,06:00:00,49,31,18,FMN 19 Binnensingel Oostkant
666,R10 414,2023-04-14,07:00:00,104,67,37,FMN 19 Binnensingel Oostkant
666,R10 414,2023-04-14,08:00:00,97,72,25,FMN 19 Binnensingel Oostkant
666,R10 414,2023-04-14,09:00:00,57,43,14,FMN 19 Binnensingel Oostkant
666,R10 414,2023-04-14,10:00:00,45,30,15,FMN 19 Binnensingel Oostkant
666,R10 414,2023-04-14,11:00:00,61,43,18,FMN 19 Binnensingel Oostkant
666,R10 414,2023-04-14,12:00:00,76,56,20,FMN 19 Binnensingel Oostkant
666,R10 414,2023-04-14,13:00:00,93,73,20,FMN 19 Binnensingel Oostkant
666,R10 414,2023-04-14,14:00:00,96,75,21,FMN 19 Binnensingel Oostkant
666,R10 414,2023-04-14,15:00:00,108,86,22,FMN 19 Binnensingel Oostkant
666,R10 414,2023-04-14,16:00:00,158,110,48,FMN 19 Binnensingel Oostkant
666,R10 414,2023-04-14,17:00:00,144,118,26,FMN 19 Binnensingel Oostkant
666,R10 414,2023-04-14,18:00:00,136,98,38,FMN 19 Binnensingel Oostkant
666,R10 414,2023-04-14,19:00:00,99,61,38,FMN 19 Binnensingel Oostkant
666,R10 414,2023-04-14,20:00:00,67,52,15,FMN 19 Binnensingel Oostkant
666,R10 414,2023-04-14,21:00:00,47,39,8,FMN 19 Binnensingel Oostkant
666,R10 414,2023-04-14,22:00:00,70,52,18,FMN 19 Binnensingel Oostkant
666,R10 414,2023-04-14,23:00:00,41,34,7,FMN 19 Binnensingel Oostkant
666,R10 414,2023-04-15,00:00:00,22,15,7,FMN 19 Binnensingel Oostkant
666,R10 414,2023-04-15,01:00:00,20,15,5,FMN 19 Binnensingel Oostkant
666,R10 414,2023-04-15,02:00:00,9,5,4,FMN 19 Binnensingel Oostkant
666,R10 414,2023-04-15,03:00:00,14,8,6,FMN 19 Binnensingel Oostkant
666,R10 414,2023-04-15,04:00:00,10,5,5,FMN 19 Binnensingel Oostkant
666,R10 414,2023-04-15,05:00:00,14,8,6,FMN 19 Binnensingel Oostkant
666,R10 414,2023-04-15,06:00:00,17,10,7,FMN 19 Binnensingel Oostkant
666,R10 414,2023-04-15,07:00:00,26,19,7,FMN 19 Binnensingel Oostkant
666,R10 414,2023-04-15,08:00:00,37,27,10,FMN 19 Binnensingel Oostkant
666,R10 414,2023-04-15,09:00:00,42,36,6,FMN 19 Binnensingel Oostkant
666,R10 414,2023-04-15,10:00:00,55,39,16,FMN 19 Binnensingel Oostkant
666,R10 414,2023-04-15,11:00:00,32,25,7,FMN 19 Binnensingel Oostkant
666,R10 414,2023-04-15,12:00:00,66,53,13,FMN 19 Binnensingel Oostkant
666,R10 414,2023-04-15,13:00:00,77,61,16,FMN 19 Binnensingel Oostkant
666,R10 414,2023-04-15,14:00:00,85,65,20,FMN 19 Binnensingel Oostkant
666,R10 414,2023-04-15,15:00:00,79,53,26,FMN 19 Binnensingel Oostkant
666,R10 414,2023-04-15,16:00:00,81,65,16,FMN 19 Binnensingel Oostkant
666,R10 414,2023-04-15,17:00:00,76,58,18,FMN 19 Binnensingel Oostkant
666,R10 414,2023-04-15,18:00:00,91,77,14,FMN 19 Binnensingel Oostkant
666,R10 414,2023-04-15,19:00:00,68,53,15,FMN 19 Binnensingel Oostkant
666,R10 414,2023-04-15,20:00:00,59,42,17,FMN 19 Binnensingel Oostkant
666,R10 414,2023-04-15,21:00:00,34,23,11,FMN 19 Binnensingel Oostkant
666,R10 414,2023-04-15,22:00:00,50,39,11,FMN 19 Binnensingel Oostkant
666,R10 414,2023-04-15,23:00:00,29,21,8,FMN 19 Binnensingel Oostkant
666,R10 414,2023-04-16,00:00:00,22,17,5,FMN 19 Binnensingel Oostkant
666,R10 414,2023-04-16,01:00:00,15,9,6,FMN 19 Binnensingel Oostkant
666,R10 414,2023-04-16,02:00:00,6,5,1,FMN 19 Binnensingel Oostkant
666,R10 414,2023-04-16,03:00:00,9,7,2,FMN 19 Binnensingel Oostkant
666,R10 414,2023-04-16,04:00:00,9,4,5,FMN 19 Binnensingel Oostkant
666,R10 414,2023-04-16,05:00:00,7,4,3,FMN 19 Binnensingel Oostkant
666,R10 414,2023-04-16,06:00:00,5,4,1,FMN 19 Binnensingel Oostkant
666,R10 414,2023-04-16,07:00:00,16,13,3,FMN 19 Binnensingel Oostkant
666,R10 414,2023-04-16,08:00:00,18,14,4,FMN 19 Binnensingel Oostkant
666,R10 414,2023-04-16,09:00:00,24,18,6,FMN 19 Binnensingel Oostkant
666,R10 414,2023-04-16,10:00:00,37,30,7,FMN 19 Binnensingel Oostkant
666,R10 414,2023-04-16,11:00:00,28,20,8,FMN 19 Binnensingel Oostkant
666,R10 414,2023-04-16,12:00:00,36,25,11,FMN 19 Binnensingel Oostkant
666,R10 414,2023-04-16,13:00:00,42,35,7,FMN 19 Binnensingel Oostkant
666,R10 414,2023-04-16,14:00:00,43,32,11,FMN 19 Binnensingel Oostkant
666,R10 414,2023-04-16,15:00:00,42,32,10,FMN 19 Binnensingel Oostkant
666,R10 414,2023-04-16,16:00:00,41,27,14,FMN 19 Binnensingel Oostkant
666,R10 414,2023-04-16,17:00:00,69,53,16,FMN 19 Binnensingel Oostkant
666,R10 414,2023-04-16,18:00:00,55,43,12,FMN 19 Binnensingel Oostkant
666,R10 414,2023-04-16,19:00:00,51,40,11,FMN 19 Binnensingel Oostkant
666,R10 414,2023-04-16,20:00:00,43,28,15,FMN 19 Binnensingel Oostkant
666,R10 414,2023-04-16,21:00:00,32,20,12,FMN 19 Binnensingel Oostkant
666,R10 414,2023-04-16,22:00:00,28,16,12,FMN 19 Binnensingel Oostkant
666,R10 414,2023-04-16,23:00:00,9,4,5,FMN 19 Binnensingel Oostkant
666,R10 414,2023-04-17,00:00:00,5,5,0,FMN 19 Binnensingel Oostkant
666,R10 414,2023-04-17,01:00:00,4,2,2,FMN 19 Binnensingel Oostkant
666,R10 414,2023-04-17,02:00:00,4,4,0,FMN 19 Binnensingel Oostkant
666,R10 414,2023-04-17,03:00:00,7,4,3,FMN 19 Binnensingel Oostkant
666,R10 414,2023-04-17,04:00:00,14,8,6,FMN 19 Binnensingel Oostkant
666,R10 414,2023-04-17,05:00:00,27,14,13,FMN 19 Binnensingel Oostkant
666,R10 414,2023-04-17,06:00:00,62,44,18,FMN 19 Binnensingel Oostkant
666,R10 414,2023-04-17,07:00:00,166,114,52,FMN 19 Binnensingel Oostkant
666,R10 414,2023-04-17,08:00:00,221,168,53,FMN 19 Binnensingel Oostkant
666,R10 414,2023-04-17,09:00:00,75,53,22,FMN 19 Binnensingel Oostkant
666,R10 414,2023-04-17,10:00:00,56,39,17,FMN 19 Binnensingel Oostkant
666,R10 414,2023-04-17,11:00:00,54,41,13,FMN 19 Binnensingel Oostkant
666,R10 414,2023-04-17,12:00:00,80,60,20,FMN 19 Binnensingel Oostkant
666,R10 414,2023-04-17,13:00:00,96,71,25,FMN 19 Binnensingel Oostkant
666,R10 414,2023-04-17,14:00:00,66,53,13,FMN 19 Binnensingel Oostkant
666,R10 414,2023-04-17,15:00:00,136,114,22,FMN 19 Binnensingel Oostkant
666,R10 414,2023-04-17,16:00:00,245,201,44,FMN 19 Binnensingel Oostkant
666,R10 414,2023-04-17,17:00:00,262,206,56,FMN 19 Binnensingel Oostkant
666,R10 414,2023-04-17,18:00:00,248,177,71,FMN 19 Binnensingel Oostkant
666,R10 414,2023-04-17,19:00:00,101,75,26,FMN 19 Binnensingel Oostkant
666,R10 414,2023-04-17,20:00:00,67,53,14,FMN 19 Binnensingel Oostkant
666,R10 414,2023-04-17,21:00:00,78,69,9,FMN 19 Binnensingel Oostkant
666,R10 414,2023-04-17,22:00:00,64,52,12,FMN 19 Binnensingel Oostkant
666,R10 414,2023-04-17,23:00:00,22,18,4,FMN 19 Binnensingel Oostkant
666,R10 414,2023-04-18,00:00:00,7,6,1,FMN 19 Binnensingel Oostkant
666,R10 414,2023-04-18,01:00:00,6,4,2,FMN 19 Binnensingel Oostkant
666,R10 414,2023-04-18,02:00:00,4,2,2,FMN 19 Binnensingel Oostkant
666,R10 414,2023-04-18,03:00:00,5,2,3,FMN 19 Binnensingel Oostkant
666,R10 414,2023-04-18,04:00:00,15,7,8,FMN 19 Binnensingel Oostkant
666,R10 414,2023-04-18,05:00:00,28,16,12,FMN 19 Binnensingel Oostkant
666,R10 414,2023-04-18,06:00:00,66,46,20,FMN 19 Binnensingel Oostkant
666,R10 414,2023-04-18,07:00:00,175,120,55,FMN 19 Binnensingel Oostkant
666,R10 414,2023-04-18,08:00:00,274,199,75,FMN 19 Binnensingel Oostkant
666,R10 414,2023-04-18,09:00:00,82,56,26,FMN 19 Binnensingel Oostkant
666,R10 414,2023-04-18,10:00:00,56,43,13,FMN 19 Binnensingel Oostkant
666,R10 414,2023-04-18,11:00:00,69,47,22,FMN 19 Binnensingel Oostkant
666,R10 414,2023-04-18,12:00:00,96,66,30,FMN 19 Binnensingel Oostkant
666,R10 414,2023-04-18,13:00:00,119,94,25,FMN 19 Binnensingel Oostkant
666,R10 414,2023-04-18,14:00:00,85,65,20,FMN 19 Binnensingel Oostkant
666,R10 414,2023-04-18,15:00:00,165,141,24,FMN 19 Binnensingel Oostkant
666,R10 414,2023-04-18,16:00:00,272,212,60,FMN 19 Binnensingel Oostkant
666,R10 414,2023-04-18,17:00:00,287,223,64,FMN 19 Binnensingel Oostkant
666,R10 414,2023-04-18,18:00:00,210,145,65,FMN 19 Binnensingel Oostkant
666,R10 414,2023-04-18,19:00:00,125,101,24,FMN 19 Binnensingel Oostkant
666,R10 414,2023-04-18,20:00:00,86,65,21,FMN 19 Binnensingel Oostkant
666,R10 414,2023-04-18,21:00:00,83,68,15,FMN 19 Binnensingel Oostkant
666,R10 414,2023-04-18,22:00:00,71,46,25,FMN 19 Binnensingel Oostkant
666,R10 414,2023-04-18,23:00:00,28,22,6,FMN 19 Binnensingel Oostkant
666,R10 414,2023-04-19,00:00:00,14,11,3,FMN 19 Binnensingel Oostkant
666,R10 414,2023-04-19,01:00:00,5,2,3,FMN 19 Binnensingel Oostkant
666,R10 414,2023-04-19,02:00:00,6,4,2,FMN 19 Binnensingel Oostkant
666,R10 414,2023-04-19,03:00:00,5,4,1,FMN 19 Binnensingel Oostkant
666,R10 414,2023-04-19,04:00:00,14,9,5,FMN 19 Binnensingel Oostkant
666,R10 414,2023-04-19,05:00:00,26,15,11,FMN 19 Binnensingel Oostkant
666,R10 414,2023-04-19,06:00:00,61,42,19,FMN 19 Binnensingel Oostkant
666,R10 414,2023-04-19,07:00:00,143,100,43,FMN 19 Binnensingel Oostkant
666,R10 414,2023-04-19,08:00:00,201,139,62,FMN 19 Binnensingel Oostkant
666,R10 414,2023-04-19,09:00:00,100,77,23,FMN 19 Binnensingel Oostkant
666,R10 414,2023-04-19,10:00:00,75,54,21,FMN 19 Binnensingel Oostkant
666,R10 414,2023-04-19,11:00:00,92,70,22,FMN 19 Binnensingel Oostkant
666,R10 414,2023-04-19,12:00:00,170,131,39,FMN 19 Binnensingel Oostkant
666,R10 414,2023-04-19,13:00:00,143,119,24,FMN 19 Binnensingel Oostkant
666,R10 414,2023-04-19,14:00:00,122,92,30,FMN 19 Binnensingel Oostkant
666,R10 414,2023-04-19,15:00:00,150,119,31,FMN 19 Binnensingel Oostkant
666,R10 414,2023-04-19,16:00:00,247,190,57,FMN 19 Binnensingel Oostkant
666,R10 414,2023-04-19,17:00:00,272,187,85,FMN 19 Binnensingel Oostkant
666,R10 414,2023-04-19,18:00:00,216,153,63,FMN 19 Binnensingel Oostkant
666,R10 414,2023-04-19,19:00:00,131,90,41,FMN 19 Binnensingel Oostkant
666,R10 414,2023-04-19,20:00:00,100,71,29,FMN 19 Binnensingel Oostkant
666,R10 414,2023-04-19,21:00:00,82,67,15,FMN 19 Binnensingel Oostkant
666,R10 414,2023-04-19,22:00:00,62,50,12,FMN 19 Binnensingel Oostkant
666,R10 414,2023-04-19,23:00:00,37,24,13,FMN 19 Binnensingel Oostkant
666,R10 414,2023-04-20,00:00:00,15,9,6,FMN 19 Binnensingel Oostkant
666,R10 414,2023-04-20,01:00:00,6,6,0,FMN 19 Binnensingel Oostkant
666,R10 414,2023-04-20,02:00:00,5,4,1,FMN 19 Binnensingel Oostkant
666,R10 414,2023-04-20,03:00:00,9,6,3,FMN 19 Binnensingel Oostkant
666,R10 414,2023-04-20,04:00:00,20,11,9,FMN 19 Binnensingel Oostkant
666,R10 414,2023-04-20,05:00:00,26,11,15,FMN 19 Binnensingel Oostkant
666,R10 414,2023-04-20,06:00:00,54,37,17,FMN 19 Binnensingel Oostkant
666,R10 414,2023-04-20,07:00:00,159,111,48,FMN 19 Binnensingel Oostkant
666,R10 414,2023-04-20,08:00:00,189,137,52,FMN 19 Binnensingel Oostkant
666,R10 414,2023-04-20,09:00:00,82,52,30,FMN 19 Binnensingel Oostkant
666,R10 414,2023-04-20,10:00:00,50,40,10,FMN 19 Binnensingel Oostkant
666,R10 414,2023-04-20,11:00:00,49,35,14,FMN 19 Binnensingel Oostkant
666,R10 414,2023-04-20,12:00:00,81,62,19,FMN 19 Binnensingel Oostkant
666,R10 414,2023-04-20,13:00:00,94,67,27,FMN 19 Binnensingel Oostkant
666,R10 414,2023-04-20,14:00:00,74,58,16,FMN 19 Binnensingel Oostkant
666,R10 414,2023-04-20,15:00:00,161,131,30,FMN 19 Binnensingel Oostkant
666,R10 414,2023-04-20,16:00:00,208,165,43,FMN 19 Binnensingel Oostkant
666,R10 414,2023-04-20,17:00:00,214,172,42,FMN 19 Binnensingel Oostkant
666,R10 414,2023-04-20,18:00:00,183,131,52,FMN 19 Binnensingel Oostkant
666,R10 414,2023-04-20,19:00:00,116,78,38,FMN 19 Binnensingel Oostkant
666,R10 414,2023-04-20,20:00:00,85,56,29,FMN 19 Binnensingel Oostkant
666,R10 414,2023-04-20,21:00:00,54,40,14,FMN 19 Binnensingel Oostkant
666,R10 414,2023-04-20,22:00:00,62,55,7,FMN 19 Binnensingel Oostkant
666,R10 414,2023-04-20,23:00:00,34,24,10,FMN 19 Binnensingel Oostkant
666,R10 414,2023-04-21,00:00:00,17,12,5,FMN 19 Binnensingel Oostkant
666,R10 414,2023-04-21,01:00:00,8,5,3,FMN 19 Binnensingel Oostkant
666,R10 414,2023-04-21,02:00:00,7,3,4,FMN 19 Binnensingel Oostkant
666,R10 414,2023-04-21,03:00:00,9,6,3,FMN 19 Binnensingel Oostkant
666,R10 414,2023-04-21,04:00:00,19,16,3,FMN 19 Binnensingel Oostkant
666,R10 414,2023-04-21,05:00:00,27,9,18,FMN 19 Binnensingel Oostkant
666,R10 414,2023-04-21,06:00:00,59,43,16,FMN 19 Binnensingel Oostkant
666,R10 414,2023-04-21,07:00:00,126,88,38,FMN 19 Binnensingel Oostkant
666,R10 414,2023-04-21,08:00:00,143,103,40,FMN 19 Binnensingel Oostkant
666,R10 414,2023-04-21,09:00:00,103,75,28,FMN 19 Binnensingel Oostkant
666,R10 414,2023-04-21,10:00:00,74,51,23,FMN 19 Binnensingel Oostkant
666,R10 414,2023-04-21,11:00:00,76,61,15,FMN 19 Binnensingel Oostkant
666,R10 414,2023-04-21,12:00:00,110,80,30,FMN 19 Binnensingel Oostkant
666,R10 414,2023-04-21,13:00:00,128,103,25,FMN 19 Binnensingel Oostkant
666,R10 414,2023-04-21,14:00:00,107,82,25,FMN 19 Binnensingel Oostkant
666,R10 414,2023-04-21,15:00:00,162,134,28,FMN 19 Binnensingel Oostkant
666,R10 414,2023-04-21,16:00:00,225,174,51,FMN 19 Binnensingel Oostkant
666,R10 414,2023-04-21,17:00:00,210,173,37,FMN 19 Binnensingel Oostkant
666,R10 414,2023-04-21,18:00:00,166,118,48,FMN 19 Binnensingel Oostkant
666,R10 414,2023-04-21,19:00:00,93,67,26,FMN 19 Binnensingel Oostkant
666,R10 414,2023-04-21,20:00:00,65,47,18,FMN 19 Binnensingel Oostkant
666,R10 414,2023-04-21,21:00:00,68,59,9,FMN 19 Binnensingel Oostkant
666,R10 414,2023-04-21,22:00:00,73,51,22,FMN 19 Binnensingel Oostkant
666,R10 414,2023-04-21,23:00:00,62,51,11,FMN 19 Binnensingel Oostkant
666,R10 414,2023-04-22,00:00:00,36,24,12,FMN 19 Binnensingel Oostkant
666,R10 414,2023-04-22,01:00:00,40,27,13,FMN 19 Binnensingel Oostkant
666,R10 414,2023-04-22,02:00:00,16,14,2,FMN 19 Binnensingel Oostkant
666,R10 414,2023-04-22,03:00:00,15,10,5,FMN 19 Binnensingel Oostkant
666,R10 414,2023-04-22,04:00:00,24,17,7,FMN 19 Binnensingel Oostkant
666,R10 414,2023-04-22,05:00:00,17,11,6,FMN 19 Binnensingel Oostkant
666,R10 414,2023-04-22,06:00:00,18,15,3,FMN 19 Binnensingel Oostkant
666,R10 414,2023-04-22,07:00:00,23,18,5,FMN 19 Binnensingel Oostkant
666,R10 414,2023-04-22,08:00:00,22,13,9,FMN 19 Binnensingel Oostkant
666,R10 414,2023-04-22,09:00:00,43,31,12,FMN 19 Binnensingel Oostkant
666,R10 414,2023-04-22,10:00:00,52,42,10,FMN 19 Binnensingel Oostkant
666,R10 414,2023-04-22,11:00:00,68,52,16,FMN 19 Binnensingel Oostkant
666,R10 414,2023-04-22,12:00:00,67,50,17,FMN 19 Binnensingel Oostkant
666,R10 414,2023-04-22,13:00:00,59,45,14,FMN 19 Binnensingel Oostkant
666,R10 414,2023-04-22,14:00:00,54,43,11,FMN 19 Binnensingel Oostkant
666,R10 414,2023-04-22,15:00:00,38,33,5,FMN 19 Binnensingel Oostkant
666,R10 414,2023-04-22,16:00:00,37,32,5,FMN 19 Binnensingel Oostkant
666,R10 414,2023-04-22,17:00:00,45,37,8,FMN 19 Binnensingel Oostkant
666,R10 414,2023-04-22,18:00:00,51,41,10,FMN 19 Binnensingel Oostkant
666,R10 414,2023-04-22,19:00:00,56,32,24,FMN 19 Binnensingel Oostkant
666,R10 414,2023-04-22,20:00:00,50,42,8,FMN 19 Binnensingel Oostkant
666,R10 414,2023-04-22,21:00:00,45,38,7,FMN 19 Binnensingel Oostkant
666,R10 414,2023-04-22,22:00:00,51,36,15,FMN 19 Binnensingel Oostkant
666,R10 414,2023-04-22,23:00:00,35,29,6,FMN 19 Binnensingel Oostkant
666,R10 414,2023-04-23,00:00:00,29,20,9,FMN 19 Binnensingel Oostkant
666,R10 414,2023-04-23,01:00:00,20,13,7,FMN 19 Binnensingel Oostkant
666,R10 414,2023-04-23,02:00:00,11,10,1,FMN 19 Binnensingel Oostkant
666,R10 414,2023-04-23,03:00:00,11,9,2,FMN 19 Binnensingel Oostkant
666,R10 414,2023-04-23,04:00:00,9,2,7,FMN 19 Binnensingel Oostkant
666,R10 414,2023-04-23,05:00:00,10,4,6,FMN 19 Binnensingel Oostkant
666,R10 414,2023-04-23,06:00:00,7,5,2,FMN 19 Binnensingel Oostkant
666,R10 414,2023-04-23,07:00:00,10,6,4,FMN 19 Binnensingel Oostkant
666,R10 414,2023-04-23,08:00:00,23,16,7,FMN 19 Binnensingel Oostkant
666,R10 414,2023-04-23,09:00:00,47,34,13,FMN 19 Binnensingel Oostkant
666,R10 414,2023-04-23,10:00:00,53,43,10,FMN 19 Binnensingel Oostkant
666,R10 414,2023-04-23,11:00:00,55,40,15,FMN 19 Binnensingel Oostkant
666,R10 414,2023-04-23,12:00:00,67,53,14,FMN 19 Binnensingel Oostkant
666,R10 414,2023-04-23,13:00:00,84,50,34,FMN 19 Binnensingel Oostkant
666,R10 414,2023-04-23,14:00:00,57,37,20,FMN 19 Binnensingel Oostkant
666,R10 414,2023-04-23,15:00:00,58,44,14,FMN 19 Binnensingel Oostkant
666,R10 414,2023-04-23,16:00:00,62,50,12,FMN 19 Binnensingel Oostkant
666,R10 414,2023-04-23,17:00:00,52,39,13,FMN 19 Binnensingel Oostkant
666,R10 414,2023-04-23,18:00:00,46,37,9,FMN 19 Binnensingel Oostkant
666,R10 414,2023-04-23,19:00:00,38,27,11,FMN 19 Binnensingel Oostkant
666,R10 414,2023-04-23,20:00:00,25,18,7,FMN 19 Binnensingel Oostkant
666,R10 414,2023-04-23,21:00:00,32,26,6,FMN 19 Binnensingel Oostkant
666,R10 414,2023-04-23,22:00:00,27,14,13,FMN 19 Binnensingel Oostkant
666,R10 414,2023-04-23,23:00:00,14,11,3,FMN 19 Binnensingel Oostkant
666,R10 414,2023-04-24,00:00:00,5,5,0,FMN 19 Binnensingel Oostkant
666,R10 414,2023-04-24,01:00:00,4,4,0,FMN 19 Binnensingel Oostkant
666,R10 414,2023-04-24,02:00:00,4,3,1,FMN 19 Binnensingel Oostkant
666,R10 414,2023-04-24,03:00:00,7,4,3,FMN 19 Binnensingel Oostkant
666,R10 414,2023-04-24,04:00:00,18,9,9,FMN 19 Binnensingel Oostkant
666,R10 414,2023-04-24,05:00:00,22,14,8,FMN 19 Binnensingel Oostkant
666,R10 414,2023-04-24,06:00:00,49,31,18,FMN 19 Binnensingel Oostkant
666,R10 414,2023-04-24,07:00:00,105,74,31,FMN 19 Binnensingel Oostkant
666,R10 414,2023-04-24,08:00:00,161,119,42,FMN 19 Binnensingel Oostkant
666,R10 414,2023-04-24,09:00:00,71,52,19,FMN 19 Binnensingel Oostkant
666,R10 414,2023-04-24,10:00:00,32,23,9,FMN 19 Binnensingel Oostkant
666,R10 414,2023-04-24,11:00:00,48,39,9,FMN 19 Binnensingel Oostkant
666,R10 414,2023-04-24,12:00:00,86,61,25,FMN 19 Binnensingel Oostkant
666,R10 414,2023-04-24,13:00:00,76,52,24,FMN 19 Binnensingel Oostkant
666,R10 414,2023-04-24,14:00:00,87,71,16,FMN 19 Binnensingel Oostkant
666,R10 414,2023-04-24,15:00:00,118,95,23,FMN 19 Binnensingel Oostkant
666,R10 414,2023-04-24,16:00:00,197,152,45,FMN 19 Binnensingel Oostkant
666,R10 414,2023-04-24,17:00:00,198,155,43,FMN 19 Binnensingel Oostkant
666,R10 414,2023-04-24,18:00:00,180,137,43,FMN 19 Binnensingel Oostkant
666,R10 414,2023-04-24,19:00:00,80,58,22,FMN 19 Binnensingel Oostkant
666,R10 414,2023-04-24,20:00:00,67,51,16,FMN 19 Binnensingel Oostkant
666,R10 414,2023-04-24,21:00:00,67,58,9,FMN 19 Binnensingel Oostkant
666,R10 414,2023-04-24,22:00:00,75,66,9,FMN 19 Binnensingel Oostkant
666,R10 414,2023-04-24,23:00:00,26,19,7,FMN 19 Binnensingel Oostkant
666,R10 414,2023-04-25,00:00:00,8,7,1,FMN 19 Binnensingel Oostkant
666,R10 414,2023-04-25,01:00:00,4,2,2,FMN 19 Binnensingel Oostkant
666,R10 414,2023-04-25,02:00:00,7,4,3,FMN 19 Binnensingel Oostkant
666,R10 414,2023-04-25,03:00:00,6,5,1,FMN 19 Binnensingel Oostkant
666,R10 414,2023-04-25,04:00:00,21,12,9,FMN 19 Binnensingel Oostkant
666,R10 414,2023-04-25,05:00:00,24,14,10,FMN 19 Binnensingel Oostkant
666,R10 414,2023-04-25,06:00:00,72,51,21,FMN 19 Binnensingel Oostkant
666,R10 414,2023-04-25,07:00:00,175,124,51,FMN 19 Binnensingel Oostkant
666,R10 414,2023-04-25,08:00:00,245,169,76,FMN 19 Binnensingel Oostkant
666,R10 414,2023-04-25,09:00:00,83,58,25,FMN 19 Binnensingel Oostkant
666,R10 414,2023-04-25,10:00:00,59,36,23,FMN 19 Binnensingel Oostkant
666,R10 414,2023-04-25,11:00:00,58,46,12,FMN 19 Binnensingel Oostkant
666,R10 414,2023-04-25,12:00:00,94,65,29,FMN 19 Binnensingel Oostkant
666,R10 414,2023-04-25,13:00:00,112,76,36,FMN 19 Binnensingel Oostkant
666,R10 414,2023-04-25,14:00:00,83,61,22,FMN 19 Binnensingel Oostkant
666,R10 414,2023-04-25,15:00:00,159,132,27,FMN 19 Binnensingel Oostkant
666,R10 414,2023-04-25,16:00:00,253,196,57,FMN 19 Binnensingel Oostkant
666,R10 414,2023-04-25,17:00:00,279,208,71,FMN 19 Binnensingel Oostkant
666,R10 414,2023-04-25,18:00:00,217,157,60,FMN 19 Binnensingel Oostkant
666,R10 414,2023-04-25,19:00:00,151,109,42,FMN 19 Binnensingel Oostkant
666,R10 414,2023-04-25,20:00:00,82,55,27,FMN 19 Binnensingel Oostkant
666,R10 414,2023-04-25,21:00:00,81,70,11,FMN 19 Binnensingel Oostkant
666,R10 414,2023-04-25,22:00:00,79,62,17,FMN 19 Binnensingel Oostkant
666,R10 414,2023-04-25,23:00:00,42,23,19,FMN 19 Binnensingel Oostkant
666,R10 414,2023-04-26,00:00:00,20,14,6,FMN 19 Binnensingel Oostkant
666,R10 414,2023-04-26,01:00:00,3,3,0,FMN 19 Binnensingel Oostkant
666,R10 414,2023-04-26,02:00:00,3,3,0,FMN 19 Binnensingel Oostkant
666,R10 414,2023-04-26,03:00:00,10,6,4,FMN 19 Binnensingel Oostkant
666,R10 414,2023-04-26,04:00:00,17,10,7,FMN 19 Binnensingel Oostkant
666,R10 414,2023-04-26,05:00:00,29,14,15,FMN 19 Binnensingel Oostkant
666,R10 414,2023-04-26,06:00:00,59,41,18,FMN 19 Binnensingel Oostkant
666,R10 414,2023-04-26,07:00:00,161,112,49,FMN 19 Binnensingel Oostkant
666,R10 414,2023-04-26,08:00:00,201,133,68,FMN 19 Binnensingel Oostkant
666,R10 414,2023-04-26,09:00:00,69,47,22,FMN 19 Binnensingel Oostkant
666,R10 414,2023-04-26,10:00:00,60,43,17,FMN 19 Binnensingel Oostkant
666,R10 414,2023-04-26,11:00:00,61,47,14,FMN 19 Binnensingel Oostkant
666,R10 414,2023-04-26,12:00:00,157,112,45,FMN 19 Binnensingel Oostkant
666,R10 414,2023-04-26,13:00:00,122,83,39,FMN 19 Binnensingel Oostkant
666,R10 414,2023-04-26,14:00:00,84,68,16,FMN 19 Binnensingel Oostkant
666,R10 414,2023-04-26,15:00:00,134,108,26,FMN 19 Binnensingel Oostkant
666,R10 414,2023-04-26,16:00:00,197,160,37,FMN 19 Binnensingel Oostkant
666,R10 414,2023-04-26,17:00:00,225,174,51,FMN 19 Binnensingel Oostkant
666,R10 414,2023-04-26,18:00:00,206,145,61,FMN 19 Binnensingel Oostkant
666,R10 414,2023-04-26,19:00:00,100,70,30,FMN 19 Binnensingel Oostkant
666,R10 414,2023-04-26,20:00:00,78,62,16,FMN 19 Binnensingel Oostkant
666,R10 414,2023-04-26,21:00:00,77,57,20,FMN 19 Binnensingel Oostkant
666,R10 414,2023-04-26,22:00:00,65,48,17,FMN 19 Binnensingel Oostkant
666,R10 414,2023-04-26,23:00:00,27,18,9,FMN 19 Binnensingel Oostkant
666,R10 414,2023-04-27,00:00:00,7,4,3,FMN 19 Binnensingel Oostkant
666,R10 414,2023-04-27,01:00:00,2,2,0,FMN 19 Binnensingel Oostkant
666,R10 414,2023-04-27,02:00:00,5,5,0,FMN 19 Binnensingel Oostkant
666,R10 414,2023-04-27,03:00:00,6,4,2,FMN 19 Binnensingel Oostkant
666,R10 414,2023-04-27,04:00:00,20,11,9,FMN 19 Binnensingel Oostkant
666,R10 414,2023-04-27,05:00:00,24,13,11,FMN 19 Binnensingel Oostkant
666,R10 414,2023-04-27,06:00:00,54,33,21,FMN 19 Binnensingel Oostkant
666,R10 414,2023-04-27,07:00:00,178,124,54,FMN 19 Binnensingel Oostkant
666,R10 414,2023-04-27,08:00:00,244,172,72,FMN 19 Binnensingel Oostkant
666,R10 414,2023-04-27,09:00:00,91,67,24,FMN 19 Binnensingel Oostkant
666,R10 414,2023-04-27,10:00:00,54,30,24,FMN 19 Binnensingel Oostkant
666,R10 414,2023-04-27,11:00:00,71,52,19,FMN 19 Binnensingel Oostkant
666,R10 414,2023-04-27,12:00:00,123,81,42,FMN 19 Binnensingel Oostkant
666,R10 414,2023-04-27,13:00:00,104,84,20,FMN 19 Binnensingel Oostkant
666,R10 414,2023-04-27,14:00:00,117,96,21,FMN 19 Binnensingel Oostkant
666,R10 414,2023-04-27,15:00:00,165,136,29,FMN 19 Binnensingel Oostkant
666,R10 414,2023-04-27,16:00:00,280,233,47,FMN 19 Binnensingel Oostkant
666,R10 414,2023-04-27,17:00:00,299,206,93,FMN 19 Binnensingel Oostkant
666,R10 414,2023-04-27,18:00:00,210,156,54,FMN 19 Binnensingel Oostkant
666,R10 414,2023-04-27,19:00:00,105,79,26,FMN 19 Binnensingel Oostkant
666,R10 414,2023-04-27,20:00:00,88,67,21,FMN 19 Binnensingel Oostkant
666,R10 414,2023-04-27,21:00:00,67,63,4,FMN 19 Binnensingel Oostkant
666,R10 414,2023-04-27,22:00:00,76,55,21,FMN 19 Binnensingel Oostkant
666,R10 414,2023-04-27,23:00:00,39,27,12,FMN 19 Binnensingel Oostkant
666,R10 414,2023-04-28,00:00:00,18,10,8,FMN 19 Binnensingel Oostkant
666,R10 414,2023-04-28,01:00:00,6,4,2,FMN 19 Binnensingel Oostkant
666,R10 414,2023-04-28,02:00:00,3,3,0,FMN 19 Binnensingel Oostkant
666,R10 414,2023-04-28,03:00:00,11,7,4,FMN 19 Binnensingel Oostkant
666,R10 414,2023-04-28,04:00:00,21,10,11,FMN 19 Binnensingel Oostkant
666,R10 414,2023-04-28,05:00:00,25,13,12,FMN 19 Binnensingel Oostkant
666,R10 414,2023-04-28,06:00:00,56,40,16,FMN 19 Binnensingel Oostkant
666,R10 414,2023-04-28,07:00:00,125,84,41,FMN 19 Binnensingel Oostkant
666,R10 414,2023-04-28,08:00:00,169,118,51,FMN 19 Binnensingel Oostkant
666,R10 414,2023-04-28,09:00:00,82,53,29,FMN 19 Binnensingel Oostkant
666,R10 414,2023-04-28,10:00:00,79,62,17,FMN 19 Binnensingel Oostkant
666,R10 414,2023-04-28,11:00:00,68,55,13,FMN 19 Binnensingel Oostkant
666,R10 414,2023-04-28,12:00:00,104,80,24,FMN 19 Binnensingel Oostkant
666,R10 414,2023-04-28,13:00:00,103,79,24,FMN 19 Binnensingel Oostkant
666,R10 414,2023-04-28,14:00:00,82,61,21,FMN 19 Binnensingel Oostkant
666,R10 414,2023-04-28,15:00:00,147,126,21,FMN 19 Binnensingel Oostkant
666,R10 414,2023-04-28,16:00:00,202,169,33,FMN 19 Binnensingel Oostkant
666,R10 414,2023-04-28,17:00:00,191,157,34,FMN 19 Binnensingel Oostkant
666,R10 414,2023-04-28,18:00:00,144,90,54,FMN 19 Binnensingel Oostkant
666,R10 414,2023-04-28,19:00:00,122,96,26,FMN 19 Binnensingel Oostkant
666,R10 414,2023-04-28,20:00:00,91,62,29,FMN 19 Binnensingel Oostkant
666,R10 414,2023-04-28,21:00:00,65,50,15,FMN 19 Binnensingel Oostkant
666,R10 414,2023-04-28,22:00:00,57,51,6,FMN 19 Binnensingel Oostkant
666,R10 414,2023-04-28,23:00:00,59,27,32,FMN 19 Binnensingel Oostkant
666,R10 414,2023-04-29,00:00:00,33,27,6,FMN 19 Binnensingel Oostkant
666,R10 414,2023-04-29,01:00:00,27,16,11,FMN 19 Binnensingel Oostkant
666,R10 414,2023-04-29,02:00:00,20,14,6,FMN 19 Binnensingel Oostkant
666,R10 414,2023-04-29,03:00:00,22,18,4,FMN 19 Binnensingel Oostkant
666,R10 414,2023-04-29,04:00:00,15,11,4,FMN 19 Binnensingel Oostkant
666,R10 414,2023-04-29,05:00:00,23,14,9,FMN 19 Binnensingel Oostkant
666,R10 414,2023-04-29,06:00:00,23,13,10,FMN 19 Binnensingel Oostkant
666,R10 414,2023-04-29,07:00:00,25,19,6,FMN 19 Binnensingel Oostkant
666,R10 414,2023-04-29,08:00:00,30,23,7,FMN 19 Binnensingel Oostkant
666,R10 414,2023-04-29,09:00:00,56,42,14,FMN 19 Binnensingel Oostkant
666,R10 414,2023-04-29,10:00:00,65,59,6,FMN 19 Binnensingel Oostkant
666,R10 414,2023-04-29,11:00:00,64,48,16,FMN 19 Binnensingel Oostkant
666,R10 414,2023-04-29,12:00:00,95,83,12,FMN 19 Binnensingel Oostkant
666,R10 414,2023-04-29,13:00:00,69,44,25,FMN 19 Binnensingel Oostkant
666,R10 414,2023-04-29,14:00:00,86,66,20,FMN 19 Binnensingel Oostkant
666,R10 414,2023-04-29,15:00:00,83,65,18,FMN 19 Binnensingel Oostkant
666,R10 414,2023-04-29,16:00:00,67,49,18,FMN 19 Binnensingel Oostkant
666,R10 414,2023-04-29,17:00:00,84,61,23,FMN 19 Binnensingel Oostkant
666,R10 414,2023-04-29,18:00:00,84,71,13,FMN 19 Binnensingel Oostkant
666,R10 414,2023-04-29,19:00:00,85,64,21,FMN 19 Binnensingel Oostkant
666,R10 414,2023-04-29,20:00:00,53,41,12,FMN 19 Binnensingel Oostkant
666,R10 414,2023-04-29,21:00:00,58,45,13,FMN 19 Binnensingel Oostkant
666,R10 414,2023-04-29,22:00:00,48,35,13,FMN 19 Binnensingel Oostkant
666,R10 414,2023-04-29,23:00:00,50,30,20,FMN 19 Binnensingel Oostkant
666,R10 414,2023-04-30,00:00:00,31,19,12,FMN 19 Binnensingel Oostkant
666,R10 414,2023-04-30,01:00:00,19,14,5,FMN 19 Binnensingel Oostkant
666,R10 414,2023-04-30,02:00:00,9,7,2,FMN 19 Binnensingel Oostkant
666,R10 414,2023-04-30,03:00:00,8,5,3,FMN 19 Binnensingel Oostkant
666,R10 414,2023-04-30,04:00:00,7,3,4,FMN 19 Binnensingel Oostkant
666,R10 414,2023-04-30,05:00:00,15,9,6,FMN 19 Binnensingel Oostkant
666,R10 414,2023-04-30,06:00:00,15,12,3,FMN 19 Binnensingel Oostkant
666,R10 414,2023-04-30,07:00:00,12,9,3,FMN 19 Binnensingel Oostkant
666,R10 414,2023-04-30,08:00:00,17,14,3,FMN 19 Binnensingel Oostkant
666,R10 414,2023-04-30,09:00:00,65,52,13,FMN 19 Binnensingel Oostkant
666,R10 414,2023-04-30,10:00:00,64,51,13,FMN 19 Binnensingel Oostkant
666,R10 414,2023-04-30,11:00:00,78,57,21,FMN 19 Binnensingel Oostkant
666,R10 414,2023-04-30,12:00:00,66,50,16,FMN 19 Binnensingel Oostkant
666,R10 414,2023-04-30,13:00:00,87,61,26,FMN 19 Binnensingel Oostkant
666,R10 414,2023-04-30,14:00:00,86,60,26,FMN 19 Binnensingel Oostkant
666,R10 414,2023-04-30,15:00:00,87,66,21,FMN 19 Binnensingel Oostkant
666,R10 414,2023-04-30,16:00:00,61,39,22,FMN 19 Binnensingel Oostkant
666,R10 414,2023-04-30,17:00:00,87,62,25,FMN 19 Binnensingel Oostkant
666,R10 414,2023-04-30,18:00:00,66,40,26,FMN 19 Binnensingel Oostkant
666,R10 414,2023-04-30,19:00:00,69,42,27,FMN 19 Binnensingel Oostkant
666,R10 414,2023-04-30,20:00:00,59,42,17,FMN 19 Binnensingel Oostkant
666,R10 414,2023-04-30,21:00:00,58,38,20,FMN 19 Binnensingel Oostkant
666,R10 414,2023-04-30,22:00:00,46,35,11,FMN 19 Binnensingel Oostkant
666,R10 414,2023-04-30,23:00:00,34,25,9,FMN 19 Binnensingel Oostkant
666,R10 414,2023-05-01,00:00:00,23,19,4,FMN 19 Binnensingel Oostkant
666,R10 414,2023-05-01,01:00:00,16,13,3,FMN 19 Binnensingel Oostkant
666,R10 414,2023-05-01,02:00:00,13,11,2,FMN 19 Binnensingel Oostkant
666,R10 414,2023-05-01,03:00:00,5,3,2,FMN 19 Binnensingel Oostkant
666,R10 414,2023-05-01,04:00:00,6,2,4,FMN 19 Binnensingel Oostkant
666,R10 414,2023-05-01,05:00:00,7,5,2,FMN 19 Binnensingel Oostkant
666,R10 414,2023-05-01,06:00:00,11,6,5,FMN 19 Binnensingel Oostkant
666,R10 414,2023-05-01,07:00:00,20,16,4,FMN 19 Binnensingel Oostkant
666,R10 414,2023-05-01,08:00:00,13,12,1,FMN 19 Binnensingel Oostkant
666,R10 414,2023-05-01,09:00:00,49,36,13,FMN 19 Binnensingel Oostkant
666,R10 414,2023-05-01,10:00:00,46,37,9,FMN 19 Binnensingel Oostkant
666,R10 414,2023-05-01,11:00:00,59,52,7,FMN 19 Binnensingel Oostkant
666,R10 414,2023-05-01,12:00:00,41,28,13,FMN 19 Binnensingel Oostkant
666,R10 414,2023-05-01,13:00:00,55,34,21,FMN 19 Binnensingel Oostkant
666,R10 414,2023-05-01,14:00:00,102,84,18,FMN 19 Binnensingel Oostkant
666,R10 414,2023-05-01,15:00:00,88,69,19,FMN 19 Binnensingel Oostkant
666,R10 414,2023-05-01,16:00:00,81,55,26,FMN 19 Binnensingel Oostkant
666,R10 414,2023-05-01,17:00:00,75,56,19,FMN 19 Binnensingel Oostkant
666,R10 414,2023-05-01,18:00:00,86,65,21,FMN 19 Binnensingel Oostkant
666,R10 414,2023-05-01,19:00:00,72,55,17,FMN 19 Binnensingel Oostkant
666,R10 414,2023-05-01,20:00:00,52,33,19,FMN 19 Binnensingel Oostkant
666,R10 414,2023-05-01,21:00:00,53,34,19,FMN 19 Binnensingel Oostkant
666,R10 414,2023-05-01,22:00:00,58,41,17,FMN 19 Binnensingel Oostkant
666,R10 414,2023-05-01,23:00:00,23,18,5,FMN 19 Binnensingel Oostkant
666,R10 414,2023-05-02,00:00:00,3,3,0,FMN 19 Binnensingel Oostkant
666,R10 414,2023-05-02,01:00:00,7,4,3,FMN 19 Binnensingel Oostkant
666,R10 414,2023-05-02,02:00:00,1,1,0,FMN 19 Binnensingel Oostkant
666,R10 414,2023-05-02,03:00:00,8,4,4,FMN 19 Binnensingel Oostkant
666,R10 414,2023-05-02,04:00:00,21,11,10,FMN 19 Binnensingel Oostkant
666,R10 414,2023-05-02,05:00:00,28,14,14,FMN 19 Binnensingel Oostkant
666,R10 414,2023-05-02,06:00:00,54,37,17,FMN 19 Binnensingel Oostkant
666,R10 414,2023-05-02,07:00:00,178,127,51,FMN 19 Binnensingel Oostkant
666,R10 414,2023-05-02,08:00:00,234,159,75,FMN 19 Binnensingel Oostkant
666,R10 414,2023-05-02,09:00:00,96,55,41,FMN 19 Binnensingel Oostkant
666,R10 414,2023-05-02,10:00:00,75,54,21,FMN 19 Binnensingel Oostkant
666,R10 414,2023-05-02,11:00:00,72,54,18,FMN 19 Binnensingel Oostkant
666,R10 414,2023-05-02,12:00:00,130,103,27,FMN 19 Binnensingel Oostkant
666,R10 414,2023-05-02,13:00:00,135,90,45,FMN 19 Binnensingel Oostkant
666,R10 414,2023-05-02,14:00:00,99,82,17,FMN 19 Binnensingel Oostkant
666,R10 414,2023-05-02,15:00:00,191,172,19,FMN 19 Binnensingel Oostkant
666,R10 414,2023-05-02,16:00:00,270,213,57,FMN 19 Binnensingel Oostkant
666,R10 414,2023-05-02,17:00:00,292,226,66,FMN 19 Binnensingel Oostkant
666,R10 414,2023-05-02,18:00:00,244,192,52,FMN 19 Binnensingel Oostkant
666,R10 414,2023-05-02,19:00:00,97,70,27,FMN 19 Binnensingel Oostkant
666,R10 414,2023-05-02,20:00:00,108,83,25,FMN 19 Binnensingel Oostkant
666,R10 414,2023-05-02,21:00:00,73,59,14,FMN 19 Binnensingel Oostkant
666,R10 414,2023-05-02,22:00:00,91,67,24,FMN 19 Binnensingel Oostkant
666,R10 414,2023-05-02,23:00:00,25,22,3,FMN 19 Binnensingel Oostkant
666,R10 414,2023-05-03,00:00:00,13,7,6,FMN 19 Binnensingel Oostkant
666,R10 414,2023-05-03,01:00:00,6,4,2,FMN 19 Binnensingel Oostkant
666,R10 414,2023-05-03,02:00:00,3,3,0,FMN 19 Binnensingel Oostkant
666,R10 414,2023-05-03,03:00:00,6,4,2,FMN 19 Binnensingel Oostkant
666,R10 414,2023-05-03,04:00:00,16,11,5,FMN 19 Binnensingel Oostkant
666,R10 414,2023-05-03,05:00:00,33,11,22,FMN 19 Binnensingel Oostkant
666,R10 414,2023-05-03,06:00:00,54,39,15,FMN 19 Binnensingel Oostkant
666,R10 414,2023-05-03,07:00:00,145,102,43,FMN 19 Binnensingel Oostkant
666,R10 414,2023-05-03,08:00:00,214,149,65,FMN 19 Binnensingel Oostkant
666,R10 414,2023-05-03,09:00:00,92,72,20,FMN 19 Binnensingel Oostkant
666,R10 414,2023-05-03,10:00:00,81,53,28,FMN 19 Binnensingel Oostkant
666,R10 414,2023-05-03,11:00:00,89,71,18,FMN 19 Binnensingel Oostkant
666,R10 414,2023-05-03,12:00:00,162,119,43,FMN 19 Binnensingel Oostkant
666,R10 414,2023-05-03,13:00:00,140,110,30,FMN 19 Binnensingel Oostkant
666,R10 414,2023-05-03,14:00:00,102,83,19,FMN 19 Binnensingel Oostkant
666,R10 414,2023-05-03,15:00:00,162,132,30,FMN 19 Binnensingel Oostkant
666,R10 414,2023-05-03,16:00:00,228,159,69,FMN 19 Binnensingel Oostkant
666,R10 414,2023-05-03,17:00:00,266,191,75,FMN 19 Binnensingel Oostkant
666,R10 414,2023-05-03,18:00:00,235,185,50,FMN 19 Binnensingel Oostkant
666,R10 414,2023-05-03,19:00:00,111,75,36,FMN 19 Binnensingel Oostkant
666,R10 414,2023-05-03,20:00:00,111,81,30,FMN 19 Binnensingel Oostkant
666,R10 414,2023-05-03,21:00:00,89,61,28,FMN 19 Binnensingel Oostkant
666,R10 414,2023-05-03,22:00:00,88,69,19,FMN 19 Binnensingel Oostkant
666,R10 414,2023-05-03,23:00:00,38,27,11,FMN 19 Binnensingel Oostkant
666,R10 414,2023-05-04,00:00:00,16,10,6,FMN 19 Binnensingel Oostkant
666,R10 414,2023-05-04,01:00:00,10,8,2,FMN 19 Binnensingel Oostkant
666,R10 414,2023-05-04,02:00:00,3,3,0,FMN 19 Binnensingel Oostkant
666,R10 414,2023-05-04,03:00:00,3,2,1,FMN 19 Binnensingel Oostkant
666,R10 414,2023-05-04,04:00:00,21,13,8,FMN 19 Binnensingel Oostkant
666,R10 414,2023-05-04,05:00:00,39,15,24,FMN 19 Binnensingel Oostkant
666,R10 414,2023-05-04,06:00:00,62,49,13,FMN 19 Binnensingel Oostkant
666,R10 414,2023-05-04,07:00:00,187,116,71,FMN 19 Binnensingel Oostkant
666,R10 414,2023-05-04,08:00:00,250,165,85,FMN 19 Binnensingel Oostkant
666,R10 414,2023-05-04,09:00:00,115,81,34,FMN 19 Binnensingel Oostkant
666,R10 414,2023-05-04,10:00:00,67,46,21,FMN 19 Binnensingel Oostkant
666,R10 414,2023-05-04,11:00:00,80,54,26,FMN 19 Binnensingel Oostkant
666,R10 414,2023-05-04,12:00:00,149,106,43,FMN 19 Binnensingel Oostkant
666,R10 414,2023-05-04,13:00:00,118,88,30,FMN 19 Binnensingel Oostkant
666,R10 414,2023-05-04,14:00:00,105,80,25,FMN 19 Binnensingel Oostkant
666,R10 414,2023-05-04,15:00:00,183,141,42,FMN 19 Binnensingel Oostkant
666,R10 414,2023-05-04,16:00:00,285,227,58,FMN 19 Binnensingel Oostkant
666,R10 414,2023-05-04,17:00:00,327,241,86,FMN 19 Binnensingel Oostkant
666,R10 414,2023-05-04,18:00:00,250,185,65,FMN 19 Binnensingel Oostkant
666,R10 414,2023-05-04,19:00:00,146,99,47,FMN 19 Binnensingel Oostkant
666,R10 414,2023-05-04,20:00:00,91,59,32,FMN 19 Binnensingel Oostkant
666,R10 414,2023-05-04,21:00:00,81,59,22,FMN 19 Binnensingel Oostkant
666,R10 414,2023-05-04,22:00:00,97,83,14,FMN 19 Binnensingel Oostkant
666,R10 414,2023-05-04,23:00:00,48,35,13,FMN 19 Binnensingel Oostkant
666,R10 414,2023-05-05,00:00:00,29,22,7,FMN 19 Binnensingel Oostkant
666,R10 414,2023-05-05,01:00:00,8,4,4,FMN 19 Binnensingel Oostkant
666,R10 414,2023-05-05,02:00:00,6,5,1,FMN 19 Binnensingel Oostkant
666,R10 414,2023-05-05,03:00:00,8,5,3,FMN 19 Binnensingel Oostkant
666,R10 414,2023-05-05,04:00:00,16,8,8,FMN 19 Binnensingel Oostkant
666,R10 414,2023-05-05,05:00:00,21,11,10,FMN 19 Binnensingel Oostkant
666,R10 414,2023-05-05,06:00:00,57,37,20,FMN 19 Binnensingel Oostkant
666,R10 414,2023-05-05,07:00:00,149,100,49,FMN 19 Binnensingel Oostkant
666,R10 414,2023-05-05,08:00:00,193,128,65,FMN 19 Binnensingel Oostkant
666,R10 414,2023-05-05,09:00:00,91,69,22,FMN 19 Binnensingel Oostkant
666,R10 414,2023-05-05,10:00:00,77,60,17,FMN 19 Binnensingel Oostkant
666,R10 414,2023-05-05,11:00:00,79,53,26,FMN 19 Binnensingel Oostkant
666,R10 414,2023-05-05,12:00:00,107,73,34,FMN 19 Binnensingel Oostkant
666,R10 414,2023-05-05,13:00:00,90,66,24,FMN 19 Binnensingel Oostkant
666,R10 414,2023-05-05,14:00:00,92,71,21,FMN 19 Binnensingel Oostkant
666,R10 414,2023-05-05,15:00:00,156,133,23,FMN 19 Binnensingel Oostkant
666,R10 414,2023-05-05,16:00:00,182,139,43,FMN 19 Binnensingel Oostkant
666,R10 414,2023-05-05,17:00:00,215,165,50,FMN 19 Binnensingel Oostkant
666,R10 414,2023-05-05,18:00:00,161,114,47,FMN 19 Binnensingel Oostkant
666,R10 414,2023-05-05,19:00:00,101,69,32,FMN 19 Binnensingel Oostkant
666,R10 414,2023-05-05,20:00:00,80,57,23,FMN 19 Binnensingel Oostkant
666,R10 414,2023-05-05,21:00:00,78,66,12,FMN 19 Binnensingel Oostkant
666,R10 414,2023-05-05,22:00:00,75,62,13,FMN 19 Binnensingel Oostkant
666,R10 414,2023-05-05,23:00:00,58,49,9,FMN 19 Binnensingel Oostkant
666,R10 414,2023-05-06,00:00:00,48,38,10,FMN 19 Binnensingel Oostkant
666,R10 414,2023-05-06,01:00:00,25,19,6,FMN 19 Binnensingel Oostkant
666,R10 414,2023-05-06,02:00:00,16,11,5,FMN 19 Binnensingel Oostkant
666,R10 414,2023-05-06,03:00:00,10,7,3,FMN 19 Binnensingel Oostkant
666,R10 414,2023-05-06,04:00:00,16,7,9,FMN 19 Binnensingel Oostkant
666,R10 414,2023-05-06,05:00:00,27,13,14,FMN 19 Binnensingel Oostkant
666,R10 414,2023-05-06,06:00:00,15,4,11,FMN 19 Binnensingel Oostkant
666,R10 414,2023-05-06,07:00:00,19,9,10,FMN 19 Binnensingel Oostkant
666,R10 414,2023-05-06,08:00:00,27,18,9,FMN 19 Binnensingel Oostkant
666,R10 414,2023-05-06,09:00:00,77,61,16,FMN 19 Binnensingel Oostkant
666,R10 414,2023-05-06,10:00:00,68,57,11,FMN 19 Binnensingel Oostkant
666,R10 414,2023-05-06,11:00:00,88,64,24,FMN 19 Binnensingel Oostkant
666,R10 414,2023-05-06,12:00:00,92,69,23,FMN 19 Binnensingel Oostkant
666,R10 414,2023-05-06,13:00:00,75,56,19,FMN 19 Binnensingel Oostkant
666,R10 414,2023-05-06,14:00:00,81,60,21,FMN 19 Binnensingel Oostkant
666,R10 414,2023-05-06,15:00:00,96,72,24,FMN 19 Binnensingel Oostkant
666,R10 414,2023-05-06,16:00:00,87,67,20,FMN 19 Binnensingel Oostkant
666,R10 414,2023-05-06,17:00:00,82,65,17,FMN 19 Binnensingel Oostkant
666,R10 414,2023-05-06,18:00:00,83,67,16,FMN 19 Binnensingel Oostkant
666,R10 414,2023-05-06,19:00:00,84,66,18,FMN 19 Binnensingel Oostkant
666,R10 414,2023-05-06,20:00:00,66,49,17,FMN 19 Binnensingel Oostkant
666,R10 414,2023-05-06,21:00:00,46,38,8,FMN 19 Binnensingel Oostkant
666,R10 414,2023-05-06,22:00:00,52,40,12,FMN 19 Binnensingel Oostkant
666,R10 414,2023-05-06,23:00:00,54,51,3,FMN 19 Binnensingel Oostkant
666,R10 414,2023-05-07,00:00:00,46,36,10,FMN 19 Binnensingel Oostkant
666,R10 414,2023-05-07,01:00:00,28,24,4,FMN 19 Binnensingel Oostkant
666,R10 414,2023-05-07,02:00:00,22,18,4,FMN 19 Binnensingel Oostkant
666,R10 414,2023-05-07,03:00:00,17,11,6,FMN 19 Binnensingel Oostkant
666,R10 414,2023-05-07,04:00:00,5,1,4,FMN 19 Binnensingel Oostkant
666,R10 414,2023-05-07,05:00:00,7,3,4,FMN 19 Binnensingel Oostkant
666,R10 414,2023-05-07,06:00:00,9,4,5,FMN 19 Binnensingel Oostkant
666,R10 414,2023-05-07,07:00:00,14,11,3,FMN 19 Binnensingel Oostkant
666,R10 414,2023-05-07,08:00:00,30,18,12,FMN 19 Binnensingel Oostkant
666,R10 414,2023-05-07,09:00:00,44,33,11,FMN 19 Binnensingel Oostkant
666,R10 414,2023-05-07,10:00:00,77,45,32,FMN 19 Binnensingel Oostkant
666,R10 414,2023-05-07,11:00:00,57,40,17,FMN 19 Binnensingel Oostkant
666,R10 414,2023-05-07,12:00:00,54,34,20,FMN 19 Binnensingel Oostkant
666,R10 414,2023-05-07,13:00:00,40,29,11,FMN 19 Binnensingel Oostkant
666,R10 414,2023-05-07,14:00:00,49,32,17,FMN 19 Binnensingel Oostkant
666,R10 414,2023-05-07,15:00:00,59,43,16,FMN 19 Binnensingel Oostkant
666,R10 414,2023-05-07,16:00:00,74,55,19,FMN 19 Binnensingel Oostkant
666,R10 414,2023-05-07,17:00:00,66,49,17,FMN 19 Binnensingel Oostkant
666,R10 414,2023-05-07,18:00:00,53,43,10,FMN 19 Binnensingel Oostkant
666,R10 414,2023-05-07,19:00:00,46,33,13,FMN 19 Binnensingel Oostkant
666,R10 414,2023-05-07,20:00:00,29,18,11,FMN 19 Binnensingel Oostkant
666,R10 414,2023-05-07,21:00:00,42,22,20,FMN 19 Binnensingel Oostkant
666,R10 414,2023-05-07,22:00:00,33,24,9,FMN 19 Binnensingel Oostkant
666,R10 414,2023-05-07,23:00:00,16,8,8,FMN 19 Binnensingel Oostkant
666,R10 414,2023-05-08,00:00:00,9,6,3,FMN 19 Binnensingel Oostkant
666,R10 414,2023-05-08,01:00:00,5,4,1,FMN 19 Binnensingel Oostkant
666,R10 414,2023-05-08,02:00:00,5,3,2,FMN 19 Binnensingel Oostkant
666,R10 414,2023-05-08,03:00:00,7,3,4,FMN 19 Binnensingel Oostkant
666,R10 414,2023-05-08,04:00:00,19,12,7,FMN 19 Binnensingel Oostkant
666,R10 414,2023-05-08,05:00:00,31,18,13,FMN 19 Binnensingel Oostkant
666,R10 414,2023-05-08,06:00:00,60,41,19,FMN 19 Binnensingel Oostkant
666,R10 414,2023-05-08,07:00:00,163,107,56,FMN 19 Binnensingel Oostkant
666,R10 414,2023-05-08,08:00:00,198,143,55,FMN 19 Binnensingel Oostkant
666,R10 414,2023-05-08,09:00:00,82,50,32,FMN 19 Binnensingel Oostkant
666,R10 414,2023-05-08,10:00:00,63,44,19,FMN 19 Binnensingel Oostkant
666,R10 414,2023-05-08,11:00:00,69,56,13,FMN 19 Binnensingel Oostkant
666,R10 414,2023-05-08,12:00:00,102,76,26,FMN 19 Binnensingel Oostkant
666,R10 414,2023-05-08,13:00:00,86,57,29,FMN 19 Binnensingel Oostkant
666,R10 414,2023-05-08,14:00:00,84,63,21,FMN 19 Binnensingel Oostkant
666,R10 414,2023-05-08,15:00:00,165,133,32,FMN 19 Binnensingel Oostkant
666,R10 414,2023-05-08,16:00:00,248,193,55,FMN 19 Binnensingel Oostkant
666,R10 414,2023-05-08,17:00:00,251,195,56,FMN 19 Binnensingel Oostkant
666,R10 414,2023-05-08,18:00:00,198,140,58,FMN 19 Binnensingel Oostkant
666,R10 414,2023-05-08,19:00:00,83,61,22,FMN 19 Binnensingel Oostkant
666,R10 414,2023-05-08,20:00:00,74,52,22,FMN 19 Binnensingel Oostkant
666,R10 414,2023-05-08,21:00:00,69,52,17,FMN 19 Binnensingel Oostkant
666,R10 414,2023-05-08,22:00:00,68,59,9,FMN 19 Binnensingel Oostkant
666,R10 414,2023-05-08,23:00:00,26,19,7,FMN 19 Binnensingel Oostkant
666,R10 414,2023-05-09,00:00:00,12,10,2,FMN 19 Binnensingel Oostkant
666,R10 414,2023-05-09,01:00:00,3,2,1,FMN 19 Binnensingel Oostkant
666,R10 414,2023-05-09,02:00:00,5,4,1,FMN 19 Binnensingel Oostkant
666,R10 414,2023-05-09,03:00:00,8,5,3,FMN 19 Binnensingel Oostkant
666,R10 414,2023-05-09,04:00:00,18,12,6,FMN 19 Binnensingel Oostkant
666,R10 414,2023-05-09,05:00:00,29,15,14,FMN 19 Binnensingel Oostkant
666,R10 414,2023-05-09,06:00:00,57,44,13,FMN 19 Binnensingel Oostkant
666,R10 414,2023-05-09,07:00:00,167,115,52,FMN 19 Binnensingel Oostkant
666,R10 414,2023-05-09,08:00:00,172,121,51,FMN 19 Binnensingel Oostkant
666,R10 414,2023-05-09,09:00:00,79,52,27,FMN 19 Binnensingel Oostkant
666,R10 414,2023-05-09,10:00:00,51,34,17,FMN 19 Binnensingel Oostkant
666,R10 414,2023-05-09,11:00:00,42,30,12,FMN 19 Binnensingel Oostkant
666,R10 414,2023-05-09,12:00:00,71,55,16,FMN 19 Binnensingel Oostkant
666,R10 414,2023-05-09,13:00:00,62,47,15,FMN 19 Binnensingel Oostkant
666,R10 414,2023-05-09,14:00:00,70,58,12,FMN 19 Binnensingel Oostkant
666,R10 414,2023-05-09,15:00:00,104,90,14,FMN 19 Binnensingel Oostkant
666,R10 414,2023-05-09,16:00:00,193,155,38,FMN 19 Binnensingel Oostkant
666,R10 414,2023-05-09,17:00:00,191,134,57,FMN 19 Binnensingel Oostkant
666,R10 414,2023-05-09,18:00:00,144,101,43,FMN 19 Binnensingel Oostkant
666,R10 414,2023-05-09,19:00:00,76,48,28,FMN 19 Binnensingel Oostkant
666,R10 414,2023-05-09,20:00:00,48,37,11,FMN 19 Binnensingel Oostkant
666,R10 414,2023-05-09,21:00:00,77,62,15,FMN 19 Binnensingel Oostkant
666,R10 414,2023-05-09,22:00:00,41,32,9,FMN 19 Binnensingel Oostkant
666,R10 414,2023-05-09,23:00:00,24,14,10,FMN 19 Binnensingel Oostkant
666,R10 414,2023-05-10,00:00:00,11,10,1,FMN 19 Binnensingel Oostkant
666,R10 414,2023-05-10,01:00:00,5,3,2,FMN 19 Binnensingel Oostkant
666,R10 414,2023-05-10,02:00:00,5,5,0,FMN 19 Binnensingel Oostkant
666,R10 414,2023-05-10,03:00:00,8,6,2,FMN 19 Binnensingel Oostkant
666,R10 414,2023-05-10,04:00:00,21,11,10,FMN 19 Binnensingel Oostkant
666,R10 414,2023-05-10,05:00:00,24,10,14,FMN 19 Binnensingel Oostkant
666,R10 414,2023-05-10,06:00:00,53,45,8,FMN 19 Binnensingel Oostkant
666,R10 414,2023-05-10,07:00:00,119,81,38,FMN 19 Binnensingel Oostkant
666,R10 414,2023-05-10,08:00:00,193,127,66,FMN 19 Binnensingel Oostkant
666,R10 414,2023-05-10,09:00:00,84,56,28,FMN 19 Binnensingel Oostkant
666,R10 414,2023-05-10,10:00:00,77,42,35,FMN 19 Binnensingel Oostkant
666,R10 414,2023-05-10,11:00:00,60,50,10,FMN 19 Binnensingel Oostkant
666,R10 414,2023-05-10,12:00:00,166,117,49,FMN 19 Binnensingel Oostkant
666,R10 414,2023-05-10,13:00:00,115,86,29,FMN 19 Binnensingel Oostkant
666,R10 414,2023-05-10,14:00:00,66,53,13,FMN 19 Binnensingel Oostkant
666,R10 414,2023-05-10,15:00:00,119,92,27,FMN 19 Binnensingel Oostkant
666,R10 414,2023-05-10,16:00:00,187,147,40,FMN 19 Binnensingel Oostkant
666,R10 414,2023-05-10,17:00:00,191,141,50,FMN 19 Binnensingel Oostkant
666,R10 414,2023-05-10,18:00:00,128,98,30,FMN 19 Binnensingel Oostkant
666,R10 414,2023-05-10,19:00:00,94,57,37,FMN 19 Binnensingel Oostkant
666,R10 414,2023-05-10,20:00:00,60,48,12,FMN 19 Binnensingel Oostkant
666,R10 414,2023-05-10,21:00:00,65,58,7,FMN 19 Binnensingel Oostkant
666,R10 414,2023-05-10,22:00:00,61,51,10,FMN 19 Binnensingel Oostkant
666,R10 414,2023-05-10,23:00:00,26,17,9,FMN 19 Binnensingel Oostkant
666,R10 414,2023-05-11,00:00:00,6,5,1,FMN 19 Binnensingel Oostkant
666,R10 414,2023-05-11,01:00:00,5,3,2,FMN 19 Binnensingel Oostkant
666,R10 414,2023-05-11,02:00:00,4,4,0,FMN 19 Binnensingel Oostkant
666,R10 414,2023-05-11,03:00:00,11,6,5,FMN 19 Binnensingel Oostkant
666,R10 414,2023-05-11,04:00:00,14,12,2,FMN 19 Binnensingel Oostkant
666,R10 414,2023-05-11,05:00:00,40,20,20,FMN 19 Binnensingel Oostkant
666,R10 414,2023-05-11,06:00:00,64,44,20,FMN 19 Binnensingel Oostkant
666,R10 414,2023-05-11,07:00:00,175,120,55,FMN 19 Binnensingel Oostkant
666,R10 414,2023-05-11,08:00:00,220,147,73,FMN 19 Binnensingel Oostkant
666,R10 414,2023-05-11,09:00:00,106,79,27,FMN 19 Binnensingel Oostkant
666,R10 414,2023-05-11,10:00:00,72,38,34,FMN 19 Binnensingel Oostkant
666,R10 414,2023-05-11,11:00:00,62,44,18,FMN 19 Binnensingel Oostkant
666,R10 414,2023-05-11,12:00:00,125,99,26,FMN 19 Binnensingel Oostkant
666,R10 414,2023-05-11,13:00:00,88,67,21,FMN 19 Binnensingel Oostkant
666,R10 414,2023-05-11,14:00:00,94,74,20,FMN 19 Binnensingel Oostkant
666,R10 414,2023-05-11,15:00:00,167,129,38,FMN 19 Binnensingel Oostkant
666,R10 414,2023-05-11,16:00:00,222,174,48,FMN 19 Binnensingel Oostkant
666,R10 414,2023-05-11,17:00:00,228,171,57,FMN 19 Binnensingel Oostkant
666,R10 414,2023-05-11,18:00:00,194,132,62,FMN 19 Binnensingel Oostkant
666,R10 414,2023-05-11,19:00:00,99,69,30,FMN 19 Binnensingel Oostkant
666,R10 414,2023-05-11,20:00:00,89,69,20,FMN 19 Binnensingel Oostkant
666,R10 414,2023-05-11,21:00:00,72,58,14,FMN 19 Binnensingel Oostkant
666,R10 414,2023-05-11,22:00:00,93,75,18,FMN 19 Binnensingel Oostkant
666,R10 414,2023-05-11,23:00:00,32,22,10,FMN 19 Binnensingel Oostkant
666,R10 414,2023-05-12,00:00:00,23,21,2,FMN 19 Binnensingel Oostkant
666,R10 414,2023-05-12,01:00:00,9,9,0,FMN 19 Binnensingel Oostkant
666,R10 414,2023-05-12,02:00:00,5,4,1,FMN 19 Binnensingel Oostkant
666,R10 414,2023-05-12,03:00:00,7,4,3,FMN 19 Binnensingel Oostkant
666,R10 414,2023-05-12,04:00:00,17,11,6,FMN 19 Binnensingel Oostkant
666,R10 414,2023-05-12,05:00:00,24,11,13,FMN 19 Binnensingel Oostkant
666,R10 414,2023-05-12,06:00:00,51,37,14,FMN 19 Binnensingel Oostkant
666,R10 414,2023-05-12,07:00:00,101,69,32,FMN 19 Binnensingel Oostkant
666,R10 414,2023-05-12,08:00:00,139,87,52,FMN 19 Binnensingel Oostkant
666,R10 414,2023-05-12,09:00:00,59,44,15,FMN 19 Binnensingel Oostkant
666,R10 414,2023-05-12,10:00:00,60,34,26,FMN 19 Binnensingel Oostkant
666,R10 414,2023-05-12,11:00:00,52,40,12,FMN 19 Binnensingel Oostkant
666,R10 414,2023-05-12,12:00:00,72,50,22,FMN 19 Binnensingel Oostkant
666,R10 414,2023-05-12,13:00:00,106,86,20,FMN 19 Binnensingel Oostkant
666,R10 414,2023-05-12,14:00:00,92,70,22,FMN 19 Binnensingel Oostkant
666,R10 414,2023-05-12,15:00:00,130,103,27,FMN 19 Binnensingel Oostkant
666,R10 414,2023-05-12,16:00:00,236,184,52,FMN 19 Binnensingel Oostkant
666,R10 414,2023-05-12,17:00:00,189,147,42,FMN 19 Binnensingel Oostkant
666,R10 414,2023-05-12,18:00:00,142,109,33,FMN 19 Binnensingel Oostkant
666,R10 414,2023-05-12,19:00:00,110,81,29,FMN 19 Binnensingel Oostkant
666,R10 414,2023-05-12,20:00:00,79,62,17,FMN 19 Binnensingel Oostkant
666,R10 414,2023-05-12,21:00:00,62,52,10,FMN 19 Binnensingel Oostkant
666,R10 414,2023-05-12,22:00:00,75,67,8,FMN 19 Binnensingel Oostkant
666,R10 414,2023-05-12,23:00:00,58,40,18,FMN 19 Binnensingel Oostkant
666,R10 414,2023-05-13,00:00:00,31,21,10,FMN 19 Binnensingel Oostkant
666,R10 414,2023-05-13,01:00:00,39,24,15,FMN 19 Binnensingel Oostkant
666,R10 414,2023-05-13,02:00:00,18,9,9,FMN 19 Binnensingel Oostkant
666,R10 414,2023-05-13,03:00:00,9,5,4,FMN 19 Binnensingel Oostkant
666,R10 414,2023-05-13,04:00:00,19,11,8,FMN 19 Binnensingel Oostkant
666,R10 414,2023-05-13,05:00:00,12,8,4,FMN 19 Binnensingel Oostkant
666,R10 414,2023-05-13,06:00:00,25,15,10,FMN 19 Binnensingel Oostkant
666,R10 414,2023-05-13,07:00:00,22,15,7,FMN 19 Binnensingel Oostkant
666,R10 414,2023-05-13,08:00:00,48,40,8,FMN 19 Binnensingel Oostkant
666,R10 414,2023-05-13,09:00:00,62,42,20,FMN 19 Binnensingel Oostkant
666,R10 414,2023-05-13,10:00:00,73,51,22,FMN 19 Binnensingel Oostkant
666,R10 414,2023-05-13,11:00:00,68,51,17,FMN 19 Binnensingel Oostkant
666,R10 414,2023-05-13,12:00:00,115,92,23,FMN 19 Binnensingel Oostkant
666,R10 414,2023-05-13,13:00:00,138,113,25,FMN 19 Binnensingel Oostkant
666,R10 414,2023-05-13,14:00:00,110,79,31,FMN 19 Binnensingel Oostkant
666,R10 414,2023-05-13,15:00:00,97,71,26,FMN 19 Binnensingel Oostkant
666,R10 414,2023-05-13,16:00:00,67,52,15,FMN 19 Binnensingel Oostkant
666,R10 414,2023-05-13,17:00:00,108,80,28,FMN 19 Binnensingel Oostkant
666,R10 414,2023-05-13,18:00:00,112,90,22,FMN 19 Binnensingel Oostkant
666,R10 414,2023-05-13,19:00:00,104,84,20,FMN 19 Binnensingel Oostkant
666,R10 414,2023-05-13,20:00:00,85,65,20,FMN 19 Binnensingel Oostkant
666,R10 414,2023-05-13,21:00:00,54,42,12,FMN 19 Binnensingel Oostkant
666,R10 414,2023-05-13,22:00:00,59,44,15,FMN 19 Binnensingel Oostkant
666,R10 414,2023-05-13,23:00:00,59,49,10,FMN 19 Binnensingel Oostkant
666,R10 414,2023-05-14,00:00:00,50,25,25,FMN 19 Binnensingel Oostkant
666,R10 414,2023-05-14,01:00:00,42,31,11,FMN 19 Binnensingel Oostkant
666,R10 414,2023-05-14,02:00:00,18,11,7,FMN 19 Binnensingel Oostkant
666,R10 414,2023-05-14,03:00:00,23,19,4,FMN 19 Binnensingel Oostkant
666,R10 414,2023-05-14,04:00:00,10,7,3,FMN 19 Binnensingel Oostkant
666,R10 414,2023-05-14,05:00:00,9,7,2,FMN 19 Binnensingel Oostkant
666,R10 414,2023-05-14,06:00:00,13,9,4,FMN 19 Binnensingel Oostkant
666,R10 414,2023-05-14,07:00:00,12,7,5,FMN 19 Binnensingel Oostkant
666,R10 414,2023-05-14,08:00:00,32,21,11,FMN 19 Binnensingel Oostkant
666,R10 414,2023-05-14,09:00:00,69,55,14,FMN 19 Binnensingel Oostkant
666,R10 414,2023-05-14,10:00:00,69,57,12,FMN 19 Binnensingel Oostkant
666,R10 414,2023-05-14,11:00:00,53,44,9,FMN 19 Binnensingel Oostkant
666,R10 414,2023-05-14,12:00:00,108,90,18,FMN 19 Binnensingel Oostkant
666,R10 414,2023-05-14,13:00:00,104,73,31,FMN 19 Binnensingel Oostkant
666,R10 414,2023-05-14,14:00:00,91,61,30,FMN 19 Binnensingel Oostkant
666,R10 414,2023-05-14,15:00:00,117,81,36,FMN 19 Binnensingel Oostkant
666,R10 414,2023-05-14,16:00:00,115,86,29,FMN 19 Binnensingel Oostkant
666,R10 414,2023-05-14,17:00:00,103,69,34,FMN 19 Binnensingel Oostkant
666,R10 414,2023-05-14,18:00:00,98,68,30,FMN 19 Binnensingel Oostkant
666,R10 414,2023-05-14,19:00:00,77,58,19,FMN 19 Binnensingel Oostkant
666,R10 414,2023-05-14,20:00:00,58,45,13,FMN 19 Binnensingel Oostkant
666,R10 414,2023-05-14,21:00:00,50,41,9,FMN 19 Binnensingel Oostkant
666,R10 414,2023-05-14,22:00:00,35,24,11,FMN 19 Binnensingel Oostkant
666,R10 414,2023-05-14,23:00:00,33,11,22,FMN 19 Binnensingel Oostkant
666,R10 414,2023-05-15,00:00:00,7,2,5,FMN 19 Binnensingel Oostkant
666,R10 414,2023-05-15,01:00:00,6,3,3,FMN 19 Binnensingel Oostkant
666,R10 414,2023-05-15,02:00:00,1,1,0,FMN 19 Binnensingel Oostkant
666,R10 414,2023-05-15,03:00:00,10,6,4,FMN 19 Binnensingel Oostkant
666,R10 414,2023-05-15,04:00:00,12,9,3,FMN 19 Binnensingel Oostkant
666,R10 414,2023-05-15,05:00:00,39,19,20,FMN 19 Binnensingel Oostkant
666,R10 414,2023-05-15,06:00:00,70,50,20,FMN 19 Binnensingel Oostkant
666,R10 414,2023-05-15,07:00:00,175,120,55,FMN 19 Binnensingel Oostkant
666,R10 414,2023-05-15,08:00:00,211,140,71,FMN 19 Binnensingel Oostkant
666,R10 414,2023-05-15,09:00:00,94,49,45,FMN 19 Binnensingel Oostkant
666,R10 414,2023-05-15,10:00:00,50,28,22,FMN 19 Binnensingel Oostkant
666,R10 414,2023-05-15,11:00:00,62,50,12,FMN 19 Binnensingel Oostkant
666,R10 414,2023-05-15,12:00:00,109,80,29,FMN 19 Binnensingel Oostkant
666,R10 414,2023-05-15,13:00:00,99,65,34,FMN 19 Binnensingel Oostkant
666,R10 414,2023-05-15,14:00:00,73,54,19,FMN 19 Binnensingel Oostkant
666,R10 414,2023-05-15,15:00:00,124,99,25,FMN 19 Binnensingel Oostkant
666,R10 414,2023-05-15,16:00:00,211,168,43,FMN 19 Binnensingel Oostkant
666,R10 414,2023-05-15,17:00:00,215,170,45,FMN 19 Binnensingel Oostkant
666,R10 414,2023-05-15,18:00:00,186,144,42,FMN 19 Binnensingel Oostkant
666,R10 414,2023-05-15,19:00:00,81,59,22,FMN 19 Binnensingel Oostkant
666,R10 414,2023-05-15,20:00:00,59,43,16,FMN 19 Binnensingel Oostkant
666,R10 414,2023-05-15,21:00:00,73,59,14,FMN 19 Binnensingel Oostkant
666,R10 414,2023-05-15,22:00:00,61,47,14,FMN 19 Binnensingel Oostkant
666,R10 414,2023-05-15,23:00:00,26,17,9,FMN 19 Binnensingel Oostkant
666,R10 414,2023-05-16,00:00:00,7,7,0,FMN 19 Binnensingel Oostkant
666,R10 414,2023-05-16,01:00:00,1,0,1,FMN 19 Binnensingel Oostkant
666,R10 414,2023-05-16,02:00:00,3,2,1,FMN 19 Binnensingel Oostkant
666,R10 414,2023-05-16,03:00:00,14,7,7,FMN 19 Binnensingel Oostkant
666,R10 414,2023-05-16,04:00:00,13,8,5,FMN 19 Binnensingel Oostkant
666,R10 414,2023-05-16,05:00:00,34,15,19,FMN 19 Binnensingel Oostkant
666,R10 414,2023-05-16,06:00:00,65,40,25,FMN 19 Binnensingel Oostkant
666,R10 414,2023-05-16,07:00:00,174,126,48,FMN 19 Binnensingel Oostkant
666,R10 414,2023-05-16,08:00:00,242,164,78,FMN 19 Binnensingel Oostkant
666,R10 414,2023-05-16,09:00:00,94,60,34,FMN 19 Binnensingel Oostkant
666,R10 414,2023-05-16,10:00:00,64,46,18,FMN 19 Binnensingel Oostkant
666,R10 414,2023-05-16,11:00:00,88,66,22,FMN 19 Binnensingel Oostkant
666,R10 414,2023-05-16,12:00:00,101,71,30,FMN 19 Binnensingel Oostkant
666,R10 414,2023-05-16,13:00:00,113,84,29,FMN 19 Binnensingel Oostkant
666,R10 414,2023-05-16,14:00:00,123,96,27,FMN 19 Binnensingel Oostkant
666,R10 414,2023-05-16,15:00:00,154,119,35,FMN 19 Binnensingel Oostkant
666,R10 414,2023-05-16,16:00:00,241,186,55,FMN 19 Binnensingel Oostkant
666,R10 414,2023-05-16,17:00:00,270,204,66,FMN 19 Binnensingel Oostkant
666,R10 414,2023-05-16,18:00:00,219,153,66,FMN 19 Binnensingel Oostkant
666,R10 414,2023-05-16,19:00:00,132,103,29,FMN 19 Binnensingel Oostkant
666,R10 414,2023-05-16,20:00:00,85,66,19,FMN 19 Binnensingel Oostkant
666,R10 414,2023-05-16,21:00:00,82,65,17,FMN 19 Binnensingel Oostkant
666,R10 414,2023-05-16,22:00:00,78,60,18,FMN 19 Binnensingel Oostkant
666,R10 414,2023-05-16,23:00:00,22,14,8,FMN 19 Binnensingel Oostkant
666,R10 414,2023-05-17,00:00:00,19,16,3,FMN 19 Binnensingel Oostkant
666,R10 414,2023-05-17,01:00:00,3,2,1,FMN 19 Binnensingel Oostkant
666,R10 414,2023-05-17,02:00:00,4,3,1,FMN 19 Binnensingel Oostkant
666,R10 414,2023-05-17,03:00:00,4,2,2,FMN 19 Binnensingel Oostkant
666,R10 414,2023-05-17,04:00:00,25,14,11,FMN 19 Binnensingel Oostkant
666,R10 414,2023-05-17,05:00:00,31,14,17,FMN 19 Binnensingel Oostkant
666,R10 414,2023-05-17,06:00:00,63,40,23,FMN 19 Binnensingel Oostkant
666,R10 414,2023-05-17,07:00:00,165,110,55,FMN 19 Binnensingel Oostkant
666,R10 414,2023-05-17,08:00:00,204,139,65,FMN 19 Binnensingel Oostkant
666,R10 414,2023-05-17,09:00:00,94,61,33,FMN 19 Binnensingel Oostkant
666,R10 414,2023-05-17,10:00:00,77,54,23,FMN 19 Binnensingel Oostkant
666,R10 414,2023-05-17,11:00:00,78,59,19,FMN 19 Binnensingel Oostkant
666,R10 414,2023-05-17,12:00:00,166,124,42,FMN 19 Binnensingel Oostkant
666,R10 414,2023-05-17,13:00:00,140,112,28,FMN 19 Binnensingel Oostkant
666,R10 414,2023-05-17,14:00:00,118,91,27,FMN 19 Binnensingel Oostkant
666,R10 414,2023-05-17,15:00:00,135,111,24,FMN 19 Binnensingel Oostkant
666,R10 414,2023-05-17,16:00:00,219,156,63,FMN 19 Binnensingel Oostkant
666,R10 414,2023-05-17,17:00:00,246,195,51,FMN 19 Binnensingel Oostkant
666,R10 414,2023-05-17,18:00:00,187,141,46,FMN 19 Binnensingel Oostkant
666,R10 414,2023-05-17,19:00:00,143,101,42,FMN 19 Binnensingel Oostkant
666,R10 414,2023-05-17,20:00:00,106,79,27,FMN 19 Binnensingel Oostkant
666,R10 414,2023-05-17,21:00:00,78,61,17,FMN 19 Binnensingel Oostkant
666,R10 414,2023-05-17,22:00:00,88,73,15,FMN 19 Binnensingel Oostkant
666,R10 414,2023-05-17,23:00:00,57,42,15,FMN 19 Binnensingel Oostkant
666,R10 414,2023-05-18,00:00:00,27,19,8,FMN 19 Binnensingel Oostkant
666,R10 414,2023-05-18,01:00:00,23,17,6,FMN 19 Binnensingel Oostkant
666,R10 414,2023-05-18,02:00:00,18,12,6,FMN 19 Binnensingel Oostkant
666,R10 414,2023-05-18,03:00:00,11,5,6,FMN 19 Binnensingel Oostkant
666,R10 414,2023-05-18,04:00:00,6,2,4,FMN 19 Binnensingel Oostkant
666,R10 414,2023-05-18,05:00:00,17,8,9,FMN 19 Binnensingel Oostkant
666,R10 414,2023-05-18,06:00:00,14,7,7,FMN 19 Binnensingel Oostkant
666,R10 414,2023-05-18,07:00:00,30,23,7,FMN 19 Binnensingel Oostkant
666,R10 414,2023-05-18,08:00:00,27,19,8,FMN 19 Binnensingel Oostkant
666,R10 414,2023-05-18,09:00:00,43,30,13,FMN 19 Binnensingel Oostkant
666,R10 414,2023-05-18,10:00:00,62,45,17,FMN 19 Binnensingel Oostkant
666,R10 414,2023-05-18,11:00:00,56,42,14,FMN 19 Binnensingel Oostkant
666,R10 414,2023-05-18,12:00:00,70,54,16,FMN 19 Binnensingel Oostkant
666,R10 414,2023-05-18,13:00:00,70,55,15,FMN 19 Binnensingel Oostkant
666,R10 414,2023-05-18,14:00:00,80,58,22,FMN 19 Binnensingel Oostkant
666,R10 414,2023-05-18,15:00:00,82,70,12,FMN 19 Binnensingel Oostkant
666,R10 414,2023-05-18,16:00:00,71,58,13,FMN 19 Binnensingel Oostkant
666,R10 414,2023-05-18,17:00:00,96,67,29,FMN 19 Binnensingel Oostkant
666,R10 414,2023-05-18,18:00:00,87,67,20,FMN 19 Binnensingel Oostkant
666,R10 414,2023-05-18,19:00:00,87,69,18,FMN 19 Binnensingel Oostkant
666,R10 414,2023-05-18,20:00:00,54,42,12,FMN 19 Binnensingel Oostkant
666,R10 414,2023-05-18,21:00:00,54,38,16,FMN 19 Binnensingel Oostkant
666,R10 414,2023-05-18,22:00:00,58,47,11,FMN 19 Binnensingel Oostkant
666,R10 414,2023-05-18,23:00:00,28,21,7,FMN 19 Binnensingel Oostkant
666,R10 414,2023-05-19,00:00:00,25,21,4,FMN 19 Binnensingel Oostkant
666,R10 414,2023-05-19,01:00:00,27,21,6,FMN 19 Binnensingel Oostkant
666,R10 414,2023-05-19,02:00:00,2,1,1,FMN 19 Binnensingel Oostkant
666,R10 414,2023-05-19,03:00:00,7,3,4,FMN 19 Binnensingel Oostkant
666,R10 414,2023-05-19,04:00:00,22,14,8,FMN 19 Binnensingel Oostkant
666,R10 414,2023-05-19,05:00:00,28,10,18,FMN 19 Binnensingel Oostkant
666,R10 414,2023-05-19,06:00:00,33,23,10,FMN 19 Binnensingel Oostkant
666,R10 414,2023-05-19,07:00:00,57,31,26,FMN 19 Binnensingel Oostkant
666,R10 414,2023-05-19,08:00:00,67,48,19,FMN 19 Binnensingel Oostkant
666,R10 414,2023-05-19,09:00:00,69,52,17,FMN 19 Binnensingel Oostkant
666,R10 414,2023-05-19,10:00:00,71,51,20,FMN 19 Binnensingel Oostkant
666,R10 414,2023-05-19,11:00:00,70,50,20,FMN 19 Binnensingel Oostkant
666,R10 414,2023-05-19,12:00:00,101,73,28,FMN 19 Binnensingel Oostkant
666,R10 414,2023-05-19,13:00:00,87,62,25,FMN 19 Binnensingel Oostkant
666,R10 414,2023-05-19,14:00:00,99,74,25,FMN 19 Binnensingel Oostkant
666,R10 414,2023-05-19,15:00:00,124,92,32,FMN 19 Binnensingel Oostkant
666,R10 414,2023-05-19,16:00:00,129,101,28,FMN 19 Binnensingel Oostkant
666,R10 414,2023-05-19,17:00:00,129,89,40,FMN 19 Binnensingel Oostkant
666,R10 414,2023-05-19,18:00:00,129,96,33,FMN 19 Binnensingel Oostkant
666,R10 414,2023-05-19,19:00:00,86,59,27,FMN 19 Binnensingel Oostkant
666,R10 414,2023-05-19,20:00:00,81,55,26,FMN 19 Binnensingel Oostkant
666,R10 414,2023-05-19,21:00:00,78,58,20,FMN 19 Binnensingel Oostkant
666,R10 414,2023-05-19,22:00:00,74,55,19,FMN 19 Binnensingel Oostkant
666,R10 414,2023-05-19,23:00:00,85,67,18,FMN 19 Binnensingel Oostkant
666,R10 414,2023-05-20,00:00:00,35,29,6,FMN 19 Binnensingel Oostkant
666,R10 414,2023-05-20,01:00:00,19,14,5,FMN 19 Binnensingel Oostkant
666,R10 414,2023-05-20,02:00:00,16,11,5,FMN 19 Binnensingel Oostkant
666,R10 414,2023-05-20,03:00:00,16,6,10,FMN 19 Binnensingel Oostkant
666,R10 414,2023-05-20,04:00:00,14,6,8,FMN 19 Binnensingel Oostkant
666,R10 414,2023-05-20,05:00:00,24,13,11,FMN 19 Binnensingel Oostkant
666,R10 414,2023-05-20,06:00:00,27,18,9,FMN 19 Binnensingel Oostkant
666,R10 414,2023-05-20,07:00:00,21,16,5,FMN 19 Binnensingel Oostkant
666,R10 414,2023-05-20,08:00:00,23,11,12,FMN 19 Binnensingel Oostkant
666,R10 414,2023-05-20,09:00:00,48,30,18,FMN 19 Binnensingel Oostkant
666,R10 414,2023-05-20,10:00:00,67,51,16,FMN 19 Binnensingel Oostkant
666,R10 414,2023-05-20,11:00:00,69,47,22,FMN 19 Binnensingel Oostkant
666,R10 414,2023-05-20,12:00:00,80,65,15,FMN 19 Binnensingel Oostkant
666,R10 414,2023-05-20,13:00:00,95,72,23,FMN 19 Binnensingel Oostkant
666,R10 414,2023-05-20,14:00:00,117,83,34,FMN 19 Binnensingel Oostkant
666,R10 414,2023-05-20,15:00:00,98,78,20,FMN 19 Binnensingel Oostkant
666,R10 414,2023-05-20,16:00:00,89,70,19,FMN 19 Binnensingel Oostkant
666,R10 414,2023-05-20,17:00:00,114,85,29,FMN 19 Binnensingel Oostkant
666,R10 414,2023-05-20,18:00:00,112,78,34,FMN 19 Binnensingel Oostkant
666,R10 414,2023-05-20,19:00:00,96,77,19,FMN 19 Binnensingel Oostkant
666,R10 414,2023-05-20,20:00:00,73,58,15,FMN 19 Binnensingel Oostkant
666,R10 414,2023-05-20,21:00:00,44,35,9,FMN 19 Binnensingel Oostkant
666,R10 414,2023-05-20,22:00:00,53,37,16,FMN 19 Binnensingel Oostkant
666,R10 414,2023-05-20,23:00:00,81,51,30,FMN 19 Binnensingel Oostkant
666,R10 414,2023-05-21,00:00:00,49,36,13,FMN 19 Binnensingel Oostkant
666,R10 414,2023-05-21,01:00:00,19,12,7,FMN 19 Binnensingel Oostkant
666,R10 414,2023-05-21,02:00:00,8,5,3,FMN 19 Binnensingel Oostkant
666,R10 414,2023-05-21,03:00:00,17,11,6,FMN 19 Binnensingel Oostkant
666,R10 414,2023-05-21,04:00:00,10,5,5,FMN 19 Binnensingel Oostkant
666,R10 414,2023-05-21,05:00:00,7,4,3,FMN 19 Binnensingel Oostkant
666,R10 414,2023-05-21,06:00:00,9,6,3,FMN 19 Binnensingel Oostkant
666,R10 414,2023-05-21,07:00:00,19,12,7,FMN 19 Binnensingel Oostkant
666,R10 414,2023-05-21,08:00:00,35,25,10,FMN 19 Binnensingel Oostkant
666,R10 414,2023-05-21,09:00:00,59,45,14,FMN 19 Binnensingel Oostkant
666,R10 414,2023-05-21,10:00:00,80,62,18,FMN 19 Binnensingel Oostkant
666,R10 414,2023-05-21,11:00:00,53,44,9,FMN 19 Binnensingel Oostkant
666,R10 414,2023-05-21,12:00:00,109,86,23,FMN 19 Binnensingel Oostkant
666,R10 414,2023-05-21,13:00:00,106,74,32,FMN 19 Binnensingel Oostkant
666,R10 414,2023-05-21,14:00:00,101,67,34,FMN 19 Binnensingel Oostkant
666,R10 414,2023-05-21,15:00:00,120,99,21,FMN 19 Binnensingel Oostkant
666,R10 414,2023-05-21,16:00:00,75,46,29,FMN 19 Binnensingel Oostkant
666,R10 414,2023-05-21,17:00:00,102,70,32,FMN 19 Binnensingel Oostkant
666,R10 414,2023-05-21,18:00:00,91,62,29,FMN 19 Binnensingel Oostkant
666,R10 414,2023-05-21,19:00:00,86,51,35,FMN 19 Binnensingel Oostkant
666,R10 414,2023-05-21,20:00:00,66,47,19,FMN 19 Binnensingel Oostkant
666,R10 414,2023-05-21,21:00:00,59,45,14,FMN 19 Binnensingel Oostkant
666,R10 414,2023-05-21,22:00:00,41,27,14,FMN 19 Binnensingel Oostkant
666,R10 414,2023-05-21,23:00:00,23,18,5,FMN 19 Binnensingel Oostkant
666,R10 414,2023-05-22,00:00:00,14,12,2,FMN 19 Binnensingel Oostkant
666,R10 414,2023-05-22,01:00:00,7,5,2,FMN 19 Binnensingel Oostkant
666,R10 414,2023-05-22,02:00:00,7,6,1,FMN 19 Binnensingel Oostkant
666,R10 414,2023-05-22,03:00:00,5,3,2,FMN 19 Binnensingel Oostkant
666,R10 414,2023-05-22,04:00:00,19,10,9,FMN 19 Binnensingel Oostkant
666,R10 414,2023-05-22,05:00:00,50,31,19,FMN 19 Binnensingel Oostkant
666,R10 414,2023-05-22,06:00:00,81,50,31,FMN 19 Binnensingel Oostkant
666,R10 414,2023-05-22,07:00:00,187,121,66,FMN 19 Binnensingel Oostkant
666,R10 414,2023-05-22,08:00:00,249,170,79,FMN 19 Binnensingel Oostkant
666,R10 414,2023-05-22,09:00:00,103,73,30,FMN 19 Binnensingel Oostkant
666,R10 414,2023-05-22,10:00:00,85,60,25,FMN 19 Binnensingel Oostkant
666,R10 414,2023-05-22,11:00:00,78,58,20,FMN 19 Binnensingel Oostkant
666,R10 414,2023-05-22,12:00:00,142,101,41,FMN 19 Binnensingel Oostkant
666,R10 414,2023-05-22,13:00:00,95,65,30,FMN 19 Binnensingel Oostkant
666,R10 414,2023-05-22,14:00:00,121,91,30,FMN 19 Binnensingel Oostkant
666,R10 414,2023-05-22,15:00:00,167,137,30,FMN 19 Binnensingel Oostkant
666,R10 414,2023-05-22,16:00:00,313,247,66,FMN 19 Binnensingel Oostkant
666,R10 414,2023-05-22,17:00:00,269,204,65,FMN 19 Binnensingel Oostkant
666,R10 414,2023-05-22,18:00:00,214,148,66,FMN 19 Binnensingel Oostkant
666,R10 414,2023-05-22,19:00:00,124,92,32,FMN 19 Binnensingel Oostkant
666,R10 414,2023-05-22,20:00:00,126,95,31,FMN 19 Binnensingel Oostkant
666,R10 414,2023-05-22,21:00:00,98,81,17,FMN 19 Binnensingel Oostkant
666,R10 414,2023-05-22,22:00:00,69,56,13,FMN 19 Binnensingel Oostkant
666,R10 414,2023-05-22,23:00:00,26,20,6,FMN 19 Binnensingel Oostkant
666,R10 414,2023-05-23,00:00:00,9,7,2,FMN 19 Binnensingel Oostkant
666,R10 414,2023-05-23,01:00:00,7,4,3,FMN 19 Binnensingel Oostkant
666,R10 414,2023-05-23,02:00:00,3,3,0,FMN 19 Binnensingel Oostkant
666,R10 414,2023-05-23,03:00:00,7,3,4,FMN 19 Binnensingel Oostkant
666,R10 414,2023-05-23,04:00:00,23,16,7,FMN 19 Binnensingel Oostkant
666,R10 414,2023-05-23,05:00:00,37,15,22,FMN 19 Binnensingel Oostkant
666,R10 414,2023-05-23,06:00:00,77,53,24,FMN 19 Binnensingel Oostkant
666,R10 414,2023-05-23,07:00:00,204,135,69,FMN 19 Binnensingel Oostkant
666,R10 414,2023-05-23,08:00:00,239,176,63,FMN 19 Binnensingel Oostkant
666,R10 414,2023-05-23,09:00:00,92,52,40,FMN 19 Binnensingel Oostkant
666,R10 414,2023-05-23,10:00:00,62,45,17,FMN 19 Binnensingel Oostkant
666,R10 414,2023-05-23,11:00:00,83,62,21,FMN 19 Binnensingel Oostkant
666,R10 414,2023-05-23,12:00:00,108,71,37,FMN 19 Binnensingel Oostkant
666,R10 414,2023-05-23,13:00:00,109,74,35,FMN 19 Binnensingel Oostkant
666,R10 414,2023-05-23,14:00:00,128,99,29,FMN 19 Binnensingel Oostkant
666,R10 414,2023-05-23,15:00:00,165,135,30,FMN 19 Binnensingel Oostkant
666,R10 414,2023-05-23,16:00:00,257,193,64,FMN 19 Binnensingel Oostkant
666,R10 414,2023-05-23,17:00:00,284,218,66,FMN 19 Binnensingel Oostkant
666,R10 414,2023-05-23,18:00:00,221,162,59,FMN 19 Binnensingel Oostkant
666,R10 414,2023-05-23,19:00:00,133,93,40,FMN 19 Binnensingel Oostkant
666,R10 414,2023-05-23,20:00:00,98,78,20,FMN 19 Binnensingel Oostkant
666,R10 414,2023-05-23,21:00:00,96,82,14,FMN 19 Binnensingel Oostkant
666,R10 414,2023-05-23,22:00:00,91,70,21,FMN 19 Binnensingel Oostkant
666,R10 414,2023-05-23,23:00:00,34,27,7,FMN 19 Binnensingel Oostkant
666,R10 414,2023-05-24,00:00:00,12,9,3,FMN 19 Binnensingel Oostkant
666,R10 414,2023-05-24,01:00:00,4,4,0,FMN 19 Binnensingel Oostkant
666,R10 414,2023-05-24,02:00:00,5,4,1,FMN 19 Binnensingel Oostkant
666,R10 414,2023-05-24,03:00:00,8,4,4,FMN 19 Binnensingel Oostkant
666,R10 414,2023-05-24,04:00:00,18,10,8,FMN 19 Binnensingel Oostkant
666,R10 414,2023-05-24,05:00:00,44,22,22,FMN 19 Binnensingel Oostkant
666,R10 414,2023-05-24,06:00:00,71,42,29,FMN 19 Binnensingel Oostkant
666,R10 414,2023-05-24,07:00:00,161,108,53,FMN 19 Binnensingel Oostkant
666,R10 414,2023-05-24,08:00:00,216,153,63,FMN 19 Binnensingel Oostkant
666,R10 414,2023-05-24,09:00:00,98,61,37,FMN 19 Binnensingel Oostkant
666,R10 414,2023-05-24,10:00:00,72,48,24,FMN 19 Binnensingel Oostkant
666,R10 414,2023-05-24,11:00:00,72,52,20,FMN 19 Binnensingel Oostkant
666,R10 414,2023-05-24,12:00:00,162,114,48,FMN 19 Binnensingel Oostkant
666,R10 414,2023-05-24,13:00:00,134,100,34,FMN 19 Binnensingel Oostkant
666,R10 414,2023-05-24,14:00:00,102,86,16,FMN 19 Binnensingel Oostkant
666,R10 414,2023-05-24,15:00:00,148,114,34,FMN 19 Binnensingel Oostkant
666,R10 414,2023-05-24,16:00:00,216,169,47,FMN 19 Binnensingel Oostkant
666,R10 414,2023-05-24,17:00:00,254,193,61,FMN 19 Binnensingel Oostkant
666,R10 414,2023-05-24,18:00:00,185,137,48,FMN 19 Binnensingel Oostkant
666,R10 414,2023-05-24,19:00:00,137,97,40,FMN 19 Binnensingel Oostkant
666,R10 414,2023-05-24,20:00:00,87,62,25,FMN 19 Binnensingel Oostkant
666,R10 414,2023-05-24,21:00:00,73,49,24,FMN 19 Binnensingel Oostkant
666,R10 414,2023-05-24,22:00:00,58,48,10,FMN 19 Binnensingel Oostkant
666,R10 414,2023-05-24,23:00:00,46,34,12,FMN 19 Binnensingel Oostkant
666,R10 414,2023-05-25,00:00:00,11,7,4,FMN 19 Binnensingel Oostkant
666,R10 414,2023-05-25,01:00:00,12,9,3,FMN 19 Binnensingel Oostkant
666,R10 414,2023-05-25,02:00:00,1,1,0,FMN 19 Binnensingel Oostkant
666,R10 414,2023-05-25,03:00:00,8,4,4,FMN 19 Binnensingel Oostkant
666,R10 414,2023-05-25,04:00:00,17,12,5,FMN 19 Binnensingel Oostkant
666,R10 414,2023-05-25,05:00:00,37,20,17,FMN 19 Binnensingel Oostkant
666,R10 414,2023-05-25,06:00:00,75,48,27,FMN 19 Binnensingel Oostkant
666,R10 414,2023-05-25,07:00:00,208,130,78,FMN 19 Binnensingel Oostkant
666,R10 414,2023-05-25,08:00:00,249,167,82,FMN 19 Binnensingel Oostkant
666,R10 414,2023-05-25,09:00:00,95,69,26,FMN 19 Binnensingel Oostkant
666,R10 414,2023-05-25,10:00:00,64,42,22,FMN 19 Binnensingel Oostkant
666,R10 414,2023-05-25,11:00:00,96,71,25,FMN 19 Binnensingel Oostkant
666,R10 414,2023-05-25,12:00:00,121,88,33,FMN 19 Binnensingel Oostkant
666,R10 414,2023-05-25,13:00:00,109,78,31,FMN 19 Binnensingel Oostkant
666,R10 414,2023-05-25,14:00:00,109,84,25,FMN 19 Binnensingel Oostkant
666,R10 414,2023-05-25,15:00:00,152,122,30,FMN 19 Binnensingel Oostkant
666,R10 414,2023-05-25,16:00:00,267,191,76,FMN 19 Binnensingel Oostkant
666,R10 414,2023-05-25,17:00:00,304,235,69,FMN 19 Binnensingel Oostkant
666,R10 414,2023-05-25,18:00:00,229,172,57,FMN 19 Binnensingel Oostkant
666,R10 414,2023-05-25,19:00:00,129,97,32,FMN 19 Binnensingel Oostkant
666,R10 414,2023-05-25,20:00:00,93,75,18,FMN 19 Binnensingel Oostkant
666,R10 414,2023-05-25,21:00:00,97,77,20,FMN 19 Binnensingel Oostkant
666,R10 414,2023-05-25,22:00:00,90,76,14,FMN 19 Binnensingel Oostkant
666,R10 414,2023-05-25,23:00:00,47,32,15,FMN 19 Binnensingel Oostkant
666,R10 414,2023-05-26,00:00:00,20,14,6,FMN 19 Binnensingel Oostkant
666,R10 414,2023-05-26,01:00:00,13,12,1,FMN 19 Binnensingel Oostkant
666,R10 414,2023-05-26,02:00:00,3,1,2,FMN 19 Binnensingel Oostkant
666,R10 414,2023-05-26,03:00:00,5,3,2,FMN 19 Binnensingel Oostkant
666,R10 414,2023-05-26,04:00:00,19,11,8,FMN 19 Binnensingel Oostkant
666,R10 414,2023-05-26,05:00:00,29,15,14,FMN 19 Binnensingel Oostkant
666,R10 414,2023-05-26,06:00:00,68,43,25,FMN 19 Binnensingel Oostkant
666,R10 414,2023-05-26,07:00:00,178,106,72,FMN 19 Binnensingel Oostkant
666,R10 414,2023-05-26,08:00:00,188,136,52,FMN 19 Binnensingel Oostkant
666,R10 414,2023-05-26,09:00:00,87,59,28,FMN 19 Binnensingel Oostkant
666,R10 414,2023-05-26,10:00:00,71,50,21,FMN 19 Binnensingel Oostkant
666,R10 414,2023-05-26,11:00:00,70,51,19,FMN 19 Binnensingel Oostkant
666,R10 414,2023-05-26,12:00:00,126,88,38,FMN 19 Binnensingel Oostkant
666,R10 414,2023-05-26,13:00:00,120,93,27,FMN 19 Binnensingel Oostkant
666,R10 414,2023-05-26,14:00:00,115,88,27,FMN 19 Binnensingel Oostkant
666,R10 414,2023-05-26,15:00:00,168,135,33,FMN 19 Binnensingel Oostkant
666,R10 414,2023-05-26,16:00:00,249,186,63,FMN 19 Binnensingel Oostkant
666,R10 414,2023-05-26,17:00:00,229,175,54,FMN 19 Binnensingel Oostkant
666,R10 414,2023-05-26,18:00:00,166,125,41,FMN 19 Binnensingel Oostkant
666,R10 414,2023-05-26,19:00:00,116,85,31,FMN 19 Binnensingel Oostkant
666,R10 414,2023-05-26,20:00:00,96,73,23,FMN 19 Binnensingel Oostkant
666,R10 414,2023-05-26,21:00:00,78,54,24,FMN 19 Binnensingel Oostkant
666,R10 414,2023-05-26,22:00:00,74,59,15,FMN 19 Binnensingel Oostkant
666,R10 414,2023-05-26,23:00:00,56,48,8,FMN 19 Binnensingel Oostkant
666,R10 414,2023-05-27,00:00:00,46,33,13,FMN 19 Binnensingel Oostkant
666,R10 414,2023-05-27,01:00:00,23,17,6,FMN 19 Binnensingel Oostkant
666,R10 414,2023-05-27,02:00:00,16,13,3,FMN 19 Binnensingel Oostkant
666,R10 414,2023-05-27,03:00:00,16,12,4,FMN 19 Binnensingel Oostkant
666,R10 414,2023-05-27,04:00:00,11,5,6,FMN 19 Binnensingel Oostkant
666,R10 414,2023-05-27,05:00:00,15,11,4,FMN 19 Binnensingel Oostkant
666,R10 414,2023-05-27,06:00:00,20,10,10,FMN 19 Binnensingel Oostkant
666,R10 414,2023-05-27,07:00:00,31,24,7,FMN 19 Binnensingel Oostkant
666,R10 414,2023-05-27,08:00:00,49,33,16,FMN 19 Binnensingel Oostkant
666,R10 414,2023-05-27,09:00:00,75,54,21,FMN 19 Binnensingel Oostkant
666,R10 414,2023-05-27,10:00:00,86,73,13,FMN 19 Binnensingel Oostkant
666,R10 414,2023-05-27,11:00:00,92,74,18,FMN 19 Binnensingel Oostkant
666,R10 414,2023-05-27,12:00:00,70,56,14,FMN 19 Binnensingel Oostkant
666,R10 414,2023-05-27,13:00:00,109,85,24,FMN 19 Binnensingel Oostkant
666,R10 414,2023-05-27,14:00:00,114,85,29,FMN 19 Binnensingel Oostkant
666,R10 414,2023-05-27,15:00:00,111,82,29,FMN 19 Binnensingel Oostkant
666,R10 414,2023-05-27,16:00:00,103,74,29,FMN 19 Binnensingel Oostkant
666,R10 414,2023-05-27,17:00:00,153,98,55,FMN 19 Binnensingel Oostkant
666,R10 414,2023-05-27,18:00:00,147,106,41,FMN 19 Binnensingel Oostkant
666,R10 414,2023-05-27,19:00:00,117,83,34,FMN 19 Binnensingel Oostkant
666,R10 414,2023-05-27,20:00:00,70,54,16,FMN 19 Binnensingel Oostkant
666,R10 414,2023-05-27,21:00:00,73,49,24,FMN 19 Binnensingel Oostkant
666,R10 414,2023-05-27,22:00:00,87,58,29,FMN 19 Binnensingel Oostkant
666,R10 414,2023-05-27,23:00:00,59,42,17,FMN 19 Binnensingel Oostkant
666,R10 414,2023-05-28,00:00:00,51,44,7,FMN 19 Binnensingel Oostkant
666,R10 414,2023-05-28,01:00:00,43,34,9,FMN 19 Binnensingel Oostkant
666,R10 414,2023-05-28,02:00:00,28,18,10,FMN 19 Binnensingel Oostkant
666,R10 414,2023-05-28,03:00:00,10,5,5,FMN 19 Binnensingel Oostkant
666,R10 414,2023-05-28,04:00:00,9,8,1,FMN 19 Binnensingel Oostkant
666,R10 414,2023-05-28,05:00:00,18,12,6,FMN 19 Binnensingel Oostkant
666,R10 414,2023-05-28,06:00:00,11,7,4,FMN 19 Binnensingel Oostkant
666,R10 414,2023-05-28,07:00:00,23,19,4,FMN 19 Binnensingel Oostkant
666,R10 414,2023-05-28,08:00:00,22,13,9,FMN 19 Binnensingel Oostkant
666,R10 414,2023-05-28,09:00:00,47,34,13,FMN 19 Binnensingel Oostkant
666,R10 414,2023-05-28,10:00:00,84,68,16,FMN 19 Binnensingel Oostkant
666,R10 414,2023-05-28,11:00:00,91,75,16,FMN 19 Binnensingel Oostkant
666,R10 414,2023-05-28,12:00:00,65,45,20,FMN 19 Binnensingel Oostkant
666,R10 414,2023-05-28,13:00:00,107,84,23,FMN 19 Binnensingel Oostkant
666,R10 414,2023-05-28,14:00:00,135,102,33,FMN 19 Binnensingel Oostkant
666,R10 414,2023-05-28,15:00:00,119,89,30,FMN 19 Binnensingel Oostkant
666,R10 414,2023-05-28,16:00:00,127,70,57,FMN 19 Binnensingel Oostkant
666,R10 414,2023-05-28,17:00:00,117,73,44,FMN 19 Binnensingel Oostkant
666,R10 414,2023-05-28,18:00:00,114,77,37,FMN 19 Binnensingel Oostkant
666,R10 414,2023-05-28,19:00:00,87,63,24,FMN 19 Binnensingel Oostkant
666,R10 414,2023-05-28,20:00:00,68,56,12,FMN 19 Binnensingel Oostkant
666,R10 414,2023-05-28,21:00:00,85,60,25,FMN 19 Binnensingel Oostkant
666,R10 414,2023-05-28,22:00:00,67,38,29,FMN 19 Binnensingel Oostkant
666,R10 414,2023-05-28,23:00:00,51,34,17,FMN 19 Binnensingel Oostkant
666,R10 414,2023-05-29,00:00:00,61,51,10,FMN 19 Binnensingel Oostkant
666,R10 414,2023-05-29,01:00:00,16,10,6,FMN 19 Binnensingel Oostkant
666,R10 414,2023-05-29,02:00:00,10,5,5,FMN 19 Binnensingel Oostkant
666,R10 414,2023-05-29,03:00:00,3,2,1,FMN 19 Binnensingel Oostkant
666,R10 414,2023-05-29,04:00:00,7,4,3,FMN 19 Binnensingel Oostkant
666,R10 414,2023-05-29,05:00:00,17,12,5,FMN 19 Binnensingel Oostkant
666,R10 414,2023-05-29,06:00:00,13,5,8,FMN 19 Binnensingel Oostkant
666,R10 414,2023-05-29,07:00:00,17,14,3,FMN 19 Binnensingel Oostkant
666,R10 414,2023-05-29,08:00:00,27,21,6,FMN 19 Binnensingel Oostkant
666,R10 414,2023-05-29,09:00:00,47,39,8,FMN 19 Binnensingel Oostkant
666,R10 414,2023-05-29,10:00:00,33,25,8,FMN 19 Binnensingel Oostkant
666,R10 414,2023-05-29,11:00:00,61,40,21,FMN 19 Binnensingel Oostkant
666,R10 414,2023-05-29,12:00:00,85,76,9,FMN 19 Binnensingel Oostkant
666,R10 414,2023-05-29,13:00:00,92,71,21,FMN 19 Binnensingel Oostkant
666,R10 414,2023-05-29,14:00:00,112,89,23,FMN 19 Binnensingel Oostkant
666,R10 414,2023-05-29,15:00:00,110,90,20,FMN 19 Binnensingel Oostkant
666,R10 414,2023-05-29,16:00:00,118,87,31,FMN 19 Binnensingel Oostkant
666,R10 414,2023-05-29,17:00:00,82,56,26,FMN 19 Binnensingel Oostkant
666,R10 414,2023-05-29,18:00:00,107,78,29,FMN 19 Binnensingel Oostkant
666,R10 414,2023-05-29,19:00:00,73,54,19,FMN 19 Binnensingel Oostkant
666,R10 414,2023-05-29,20:00:00,74,48,26,FMN 19 Binnensingel Oostkant
666,R10 414,2023-05-29,21:00:00,70,46,24,FMN 19 Binnensingel Oostkant
666,R10 414,2023-05-29,22:00:00,46,32,14,FMN 19 Binnensingel Oostkant
666,R10 414,2023-05-29,23:00:00,28,20,8,FMN 19 Binnensingel Oostkant
666,R10 414,2023-05-30,00:00:00,11,9,2,FMN 19 Binnensingel Oostkant
666,R10 414,2023-05-30,01:00:00,6,5,1,FMN 19 Binnensingel Oostkant
666,R10 414,2023-05-30,02:00:00,1,1,0,FMN 19 Binnensingel Oostkant
666,R10 414,2023-05-30,03:00:00,8,6,2,FMN 19 Binnensingel Oostkant
666,R10 414,2023-05-30,04:00:00,13,7,6,FMN 19 Binnensingel Oostkant
666,R10 414,2023-05-30,05:00:00,32,15,17,FMN 19 Binnensingel Oostkant
666,R10 414,2023-05-30,06:00:00,77,46,31,FMN 19 Binnensingel Oostkant
666,R10 414,2023-05-30,07:00:00,203,133,70,FMN 19 Binnensingel Oostkant
666,R10 414,2023-05-30,08:00:00,235,179,56,FMN 19 Binnensingel Oostkant
666,R10 414,2023-05-30,09:00:00,114,79,35,FMN 19 Binnensingel Oostkant
666,R10 414,2023-05-30,10:00:00,66,50,16,FMN 19 Binnensingel Oostkant
666,R10 414,2023-05-30,11:00:00,84,65,19,FMN 19 Binnensingel Oostkant
666,R10 414,2023-05-30,12:00:00,97,66,31,FMN 19 Binnensingel Oostkant
666,R10 414,2023-05-30,13:00:00,91,63,28,FMN 19 Binnensingel Oostkant
666,R10 414,2023-05-30,14:00:00,80,66,14,FMN 19 Binnensingel Oostkant
666,R10 414,2023-05-30,15:00:00,185,145,40,FMN 19 Binnensingel Oostkant
666,R10 414,2023-05-30,16:00:00,289,210,79,FMN 19 Binnensingel Oostkant
666,R10 414,2023-05-30,17:00:00,287,208,79,FMN 19 Binnensingel Oostkant
666,R10 414,2023-05-30,18:00:00,215,142,73,FMN 19 Binnensingel Oostkant
666,R10 414,2023-05-30,19:00:00,132,91,41,FMN 19 Binnensingel Oostkant
666,R10 414,2023-05-30,20:00:00,117,87,30,FMN 19 Binnensingel Oostkant
666,R10 414,2023-05-30,21:00:00,122,102,20,FMN 19 Binnensingel Oostkant
666,R10 414,2023-05-30,22:00:00,78,56,22,FMN 19 Binnensingel Oostkant
666,R10 414,2023-05-30,23:00:00,29,22,7,FMN 19 Binnensingel Oostkant
666,R10 414,2023-05-31,00:00:00,14,12,2,FMN 19 Binnensingel Oostkant
666,R10 414,2023-05-31,01:00:00,3,2,1,FMN 19 Binnensingel Oostkant
666,R10 414,2023-05-31,02:00:00,3,1,2,FMN 19 Binnensingel Oostkant
666,R10 414,2023-05-31,03:00:00,5,3,2,FMN 19 Binnensingel Oostkant
666,R10 414,2023-05-31,04:00:00,15,8,7,FMN 19 Binnensingel Oostkant
666,R10 414,2023-05-31,05:00:00,36,17,19,FMN 19 Binnensingel Oostkant
666,R10 414,2023-05-31,06:00:00,83,57,26,FMN 19 Binnensingel Oostkant
666,R10 414,2023-05-31,07:00:00,178,120,58,FMN 19 Binnensingel Oostkant
666,R10 414,2023-05-31,08:00:00,202,141,61,FMN 19 Binnensingel Oostkant
666,R10 414,2023-05-31,09:00:00,86,62,24,FMN 19 Binnensingel Oostkant
666,R10 414,2023-05-31,10:00:00,71,53,18,FMN 19 Binnensingel Oostkant
666,R10 414,2023-05-31,11:00:00,98,73,25,FMN 19 Binnensingel Oostkant
666,R10 414,2023-05-31,12:00:00,178,129,49,FMN 19 Binnensingel Oostkant
666,R10 414,2023-05-31,13:00:00,118,87,31,FMN 19 Binnensingel Oostkant
666,R10 414,2023-05-31,14:00:00,99,72,27,FMN 19 Binnensingel Oostkant
666,R10 414,2023-05-31,15:00:00,182,133,49,FMN 19 Binnensingel Oostkant
666,R10 414,2023-05-31,16:00:00,280,195,85,FMN 19 Binnensingel Oostkant
666,R10 414,2023-05-31,17:00:00,292,202,90,FMN 19 Binnensingel Oostkant
666,R10 414,2023-05-31,18:00:00,233,154,79,FMN 19 Binnensingel Oostkant
666,R10 414,2023-05-31,19:00:00,150,93,57,FMN 19 Binnensingel Oostkant
666,R10 414,2023-05-31,20:00:00,109,82,27,FMN 19 Binnensingel Oostkant
666,R10 414,2023-05-31,21:00:00,98,70,28,FMN 19 Binnensingel Oostkant
666,R10 414,2023-05-31,22:00:00,92,70,22,FMN 19 Binnensingel Oostkant
666,R10 414,2023-05-31,23:00:00,42,34,8,FMN 19 Binnensingel Oostkant
666,R10 414,2023-06-01,00:00:00,12,10,2,FMN 19 Binnensingel Oostkant
666,R10 414,2023-06-01,01:00:00,9,7,2,FMN 19 Binnensingel Oostkant
666,R10 414,2023-06-01,02:00:00,3,3,0,FMN 19 Binnensingel Oostkant
666,R10 414,2023-06-01,03:00:00,7,5,2,FMN 19 Binnensingel Oostkant
666,R10 414,2023-06-01,04:00:00,18,10,8,FMN 19 Binnensingel Oostkant
666,R10 414,2023-06-01,05:00:00,39,19,20,FMN 19 Binnensingel Oostkant
666,R10 414,2023-06-01,06:00:00,95,64,31,FMN 19 Binnensingel Oostkant
666,R10 414,2023-06-01,07:00:00,214,149,65,FMN 19 Binnensingel Oostkant
666,R10 414,2023-06-01,08:00:00,235,177,58,FMN 19 Binnensingel Oostkant
666,R10 414,2023-06-01,09:00:00,83,54,29,FMN 19 Binnensingel Oostkant
666,R10 414,2023-06-01,10:00:00,61,44,17,FMN 19 Binnensingel Oostkant
666,R10 414,2023-06-01,11:00:00,84,65,19,FMN 19 Binnensingel Oostkant
666,R10 414,2023-06-01,12:00:00,138,86,52,FMN 19 Binnensingel Oostkant
666,R10 414,2023-06-01,13:00:00,113,76,37,FMN 19 Binnensingel Oostkant
666,R10 414,2023-06-01,14:00:00,126,89,37,FMN 19 Binnensingel Oostkant
666,R10 414,2023-06-01,15:00:00,156,114,42,FMN 19 Binnensingel Oostkant
666,R10 414,2023-06-01,16:00:00,273,204,69,FMN 19 Binnensingel Oostkant
666,R10 414,2023-06-01,17:00:00,296,205,91,FMN 19 Binnensingel Oostkant
666,R10 414,2023-06-01,18:00:00,203,136,67,FMN 19 Binnensingel Oostkant
666,R10 414,2023-06-01,19:00:00,141,98,43,FMN 19 Binnensingel Oostkant
666,R10 414,2023-06-01,20:00:00,103,68,35,FMN 19 Binnensingel Oostkant
666,R10 414,2023-06-01,21:00:00,90,66,24,FMN 19 Binnensingel Oostkant
666,R10 414,2023-06-01,22:00:00,98,78,20,FMN 19 Binnensingel Oostkant
666,R10 414,2023-06-01,23:00:00,39,29,10,FMN 19 Binnensingel Oostkant
666,R10 414,2023-06-02,00:00:00,20,16,4,FMN 19 Binnensingel Oostkant
666,R10 414,2023-06-02,01:00:00,5,3,2,FMN 19 Binnensingel Oostkant
666,R10 414,2023-06-02,02:00:00,4,3,1,FMN 19 Binnensingel Oostkant
666,R10 414,2023-06-02,03:00:00,7,4,3,FMN 19 Binnensingel Oostkant
666,R10 414,2023-06-02,04:00:00,22,11,11,FMN 19 Binnensingel Oostkant
666,R10 414,2023-06-02,05:00:00,34,17,17,FMN 19 Binnensingel Oostkant
666,R10 414,2023-06-02,06:00:00,72,46,26,FMN 19 Binnensingel Oostkant
666,R10 414,2023-06-02,07:00:00,160,103,57,FMN 19 Binnensingel Oostkant
666,R10 414,2023-06-02,08:00:00,179,136,43,FMN 19 Binnensingel Oostkant
666,R10 414,2023-06-02,09:00:00,93,64,29,FMN 19 Binnensingel Oostkant
666,R10 414,2023-06-02,10:00:00,60,40,20,FMN 19 Binnensingel Oostkant
666,R10 414,2023-06-02,11:00:00,82,62,20,FMN 19 Binnensingel Oostkant
666,R10 414,2023-06-02,12:00:00,129,81,48,FMN 19 Binnensingel Oostkant
666,R10 414,2023-06-02,13:00:00,86,66,20,FMN 19 Binnensingel Oostkant
666,R10 414,2023-06-02,14:00:00,98,84,14,FMN 19 Binnensingel Oostkant
666,R10 414,2023-06-02,15:00:00,197,146,51,FMN 19 Binnensingel Oostkant
666,R10 414,2023-06-02,16:00:00,271,202,69,FMN 19 Binnensingel Oostkant
666,R10 414,2023-06-02,17:00:00,206,152,54,FMN 19 Binnensingel Oostkant
666,R10 414,2023-06-02,18:00:00,203,141,62,FMN 19 Binnensingel Oostkant
666,R10 414,2023-06-02,19:00:00,157,120,37,FMN 19 Binnensingel Oostkant
666,R10 414,2023-06-02,20:00:00,75,52,23,FMN 19 Binnensingel Oostkant
666,R10 414,2023-06-02,21:00:00,79,55,24,FMN 19 Binnensingel Oostkant
666,R10 414,2023-06-02,22:00:00,75,60,15,FMN 19 Binnensingel Oostkant
666,R10 414,2023-06-02,23:00:00,70,53,17,FMN 19 Binnensingel Oostkant
666,R10 414,2023-06-03,00:00:00,55,42,13,FMN 19 Binnensingel Oostkant
666,R10 414,2023-06-03,01:00:00,30,24,6,FMN 19 Binnensingel Oostkant
666,R10 414,2023-06-03,02:00:00,18,14,4,FMN 19 Binnensingel Oostkant
666,R10 414,2023-06-03,03:00:00,4,4,0,FMN 19 Binnensingel Oostkant
666,R10 414,2023-06-03,04:00:00,23,17,6,FMN 19 Binnensingel Oostkant
666,R10 414,2023-06-03,05:00:00,19,16,3,FMN 19 Binnensingel Oostkant
666,R10 414,2023-06-03,06:00:00,24,12,12,FMN 19 Binnensingel Oostkant
666,R10 414,2023-06-03,07:00:00,29,29,0,FMN 19 Binnensingel Oostkant
666,R10 414,2023-06-03,08:00:00,37,30,7,FMN 19 Binnensingel Oostkant
666,R10 414,2023-06-03,09:00:00,75,50,25,FMN 19 Binnensingel Oostkant
666,R10 414,2023-06-03,10:00:00,88,65,23,FMN 19 Binnensingel Oostkant
666,R10 414,2023-06-03,11:00:00,93,75,18,FMN 19 Binnensingel Oostkant
666,R10 414,2023-06-03,12:00:00,108,82,26,FMN 19 Binnensingel Oostkant
666,R10 414,2023-06-03,13:00:00,106,84,22,FMN 19 Binnensingel Oostkant
666,R10 414,2023-06-03,14:00:00,111,84,27,FMN 19 Binnensingel Oostkant
666,R10 414,2023-06-03,15:00:00,112,80,32,FMN 19 Binnensingel Oostkant
666,R10 414,2023-06-03,16:00:00,124,85,39,FMN 19 Binnensingel Oostkant
666,R10 414,2023-06-03,17:00:00,122,91,31,FMN 19 Binnensingel Oostkant
666,R10 414,2023-06-03,18:00:00,128,98,30,FMN 19 Binnensingel Oostkant
666,R10 414,2023-06-03,19:00:00,118,80,38,FMN 19 Binnensingel Oostkant
666,R10 414,2023-06-03,20:00:00,66,52,14,FMN 19 Binnensingel Oostkant
666,R10 414,2023-06-03,21:00:00,60,46,14,FMN 19 Binnensingel Oostkant
666,R10 414,2023-06-03,22:00:00,68,56,12,FMN 19 Binnensingel Oostkant
666,R10 414,2023-06-03,23:00:00,61,48,13,FMN 19 Binnensingel Oostkant
666,R10 414,2023-06-04,00:00:00,43,36,7,FMN 19 Binnensingel Oostkant
666,R10 414,2023-06-04,01:00:00,42,36,6,FMN 19 Binnensingel Oostkant
666,R10 414,2023-06-04,02:00:00,22,18,4,FMN 19 Binnensingel Oostkant
666,R10 414,2023-06-04,03:00:00,17,17,0,FMN 19 Binnensingel Oostkant
666,R10 414,2023-06-04,04:00:00,14,12,2,FMN 19 Binnensingel Oostkant
666,R10 414,2023-06-04,05:00:00,17,14,3,FMN 19 Binnensingel Oostkant
666,R10 414,2023-06-04,06:00:00,13,10,3,FMN 19 Binnensingel Oostkant
666,R10 414,2023-06-04,07:00:00,23,19,4,FMN 19 Binnensingel Oostkant
666,R10 414,2023-06-04,08:00:00,34,27,7,FMN 19 Binnensingel Oostkant
666,R10 414,2023-06-04,09:00:00,81,56,25,FMN 19 Binnensingel Oostkant
666,R10 414,2023-06-04,10:00:00,90,73,17,FMN 19 Binnensingel Oostkant
666,R10 414,2023-06-04,11:00:00,98,74,24,FMN 19 Binnensingel Oostkant
666,R10 414,2023-06-04,12:00:00,111,91,20,FMN 19 Binnensingel Oostkant
666,R10 414,2023-06-04,13:00:00,127,94,33,FMN 19 Binnensingel Oostkant
666,R10 414,2023-06-04,14:00:00,114,84,30,FMN 19 Binnensingel Oostkant
666,R10 414,2023-06-04,15:00:00,128,94,34,FMN 19 Binnensingel Oostkant
666,R10 414,2023-06-04,16:00:00,128,91,37,FMN 19 Binnensingel Oostkant
666,R10 414,2023-06-04,17:00:00,125,94,31,FMN 19 Binnensingel Oostkant
666,R10 414,2023-06-04,18:00:00,120,81,39,FMN 19 Binnensingel Oostkant
666,R10 414,2023-06-04,19:00:00,78,60,18,FMN 19 Binnensingel Oostkant
666,R10 414,2023-06-04,20:00:00,73,56,17,FMN 19 Binnensingel Oostkant
666,R10 414,2023-06-04,21:00:00,74,50,24,FMN 19 Binnensingel Oostkant
666,R10 414,2023-06-04,22:00:00,53,38,15,FMN 19 Binnensingel Oostkant
666,R10 414,2023-06-04,23:00:00,39,29,10,FMN 19 Binnensingel Oostkant
666,R10 414,2023-06-05,00:00:00,32,7,25,FMN 19 Binnensingel Oostkant
666,R10 414,2023-06-05,01:00:00,22,5,17,FMN 19 Binnensingel Oostkant
666,R10 414,2023-06-05,02:00:00,10,5,5,FMN 19 Binnensingel Oostkant
666,R10 414,2023-06-05,03:00:00,12,9,3,FMN 19 Binnensingel Oostkant
666,R10 414,2023-06-05,04:00:00,18,11,7,FMN 19 Binnensingel Oostkant
666,R10 414,2023-06-05,05:00:00,32,17,15,FMN 19 Binnensingel Oostkant
666,R10 414,2023-06-05,06:00:00,58,43,15,FMN 19 Binnensingel Oostkant
666,R10 414,2023-06-05,07:00:00,179,111,68,FMN 19 Binnensingel Oostkant
666,R10 414,2023-06-05,08:00:00,208,138,70,FMN 19 Binnensingel Oostkant
666,R10 414,2023-06-05,09:00:00,97,66,31,FMN 19 Binnensingel Oostkant
666,R10 414,2023-06-05,10:00:00,65,50,15,FMN 19 Binnensingel Oostkant
666,R10 414,2023-06-05,11:00:00,70,58,12,FMN 19 Binnensingel Oostkant
666,R10 414,2023-06-05,12:00:00,111,87,24,FMN 19 Binnensingel Oostkant
666,R10 414,2023-06-05,13:00:00,106,77,29,FMN 19 Binnensingel Oostkant
666,R10 414,2023-06-05,14:00:00,100,76,24,FMN 19 Binnensingel Oostkant
666,R10 414,2023-06-05,15:00:00,205,164,41,FMN 19 Binnensingel Oostkant
666,R10 414,2023-06-05,16:00:00,276,218,58,FMN 19 Binnensingel Oostkant
666,R10 414,2023-06-05,17:00:00,275,209,66,FMN 19 Binnensingel Oostkant
666,R10 414,2023-06-05,18:00:00,205,148,57,FMN 19 Binnensingel Oostkant
666,R10 414,2023-06-05,19:00:00,109,85,24,FMN 19 Binnensingel Oostkant
666,R10 414,2023-06-05,20:00:00,100,67,33,FMN 19 Binnensingel Oostkant
666,R10 414,2023-06-05,21:00:00,74,65,9,FMN 19 Binnensingel Oostkant
666,R10 414,2023-06-05,22:00:00,65,54,11,FMN 19 Binnensingel Oostkant
666,R10 414,2023-06-05,23:00:00,40,24,16,FMN 19 Binnensingel Oostkant
666,R10 414,2023-06-06,00:00:00,3,3,0,FMN 19 Binnensingel Oostkant
666,R10 414,2023-06-06,01:00:00,3,2,1,FMN 19 Binnensingel Oostkant
666,R10 414,2023-06-06,02:00:00,1,1,0,FMN 19 Binnensingel Oostkant
666,R10 414,2023-06-06,03:00:00,3,2,1,FMN 19 Binnensingel Oostkant
666,R10 414,2023-06-06,04:00:00,13,7,6,FMN 19 Binnensingel Oostkant
666,R10 414,2023-06-06,05:00:00,19,5,14,FMN 19 Binnensingel Oostkant
666,R10 414,2023-06-06,06:00:00,66,43,23,FMN 19 Binnensingel Oostkant
666,R10 414,2023-06-06,07:00:00,168,115,53,FMN 19 Binnensingel Oostkant
666,R10 414,2023-06-06,08:00:00,195,150,45,FMN 19 Binnensingel Oostkant
666,R10 414,2023-06-06,09:00:00,82,55,27,FMN 19 Binnensingel Oostkant
666,R10 414,2023-06-06,10:00:00,61,40,21,FMN 19 Binnensingel Oostkant
666,R10 414,2023-06-06,11:00:00,73,57,16,FMN 19 Binnensingel Oostkant
666,R10 414,2023-06-06,12:00:00,96,72,24,FMN 19 Binnensingel Oostkant
666,R10 414,2023-06-06,13:00:00,93,70,23,FMN 19 Binnensingel Oostkant
666,R10 414,2023-06-06,14:00:00,89,72,17,FMN 19 Binnensingel Oostkant
666,R10 414,2023-06-06,15:00:00,164,124,40,FMN 19 Binnensingel Oostkant
666,R10 414,2023-06-06,16:00:00,251,193,58,FMN 19 Binnensingel Oostkant
666,R10 414,2023-06-06,17:00:00,250,188,62,FMN 19 Binnensingel Oostkant
666,R10 414,2023-06-06,18:00:00,211,157,54,FMN 19 Binnensingel Oostkant
666,R10 414,2023-06-06,19:00:00,96,64,32,FMN 19 Binnensingel Oostkant
666,R10 414,2023-06-06,20:00:00,68,48,20,FMN 19 Binnensingel Oostkant
666,R10 414,2023-06-06,21:00:00,74,61,13,FMN 19 Binnensingel Oostkant
666,R10 414,2023-06-06,22:00:00,68,52,16,FMN 19 Binnensingel Oostkant
666,R10 414,2023-06-06,23:00:00,33,19,14,FMN 19 Binnensingel Oostkant
666,R10 414,2023-06-07,00:00:00,15,9,6,FMN 19 Binnensingel Oostkant
666,R10 414,2023-06-07,01:00:00,8,4,4,FMN 19 Binnensingel Oostkant
666,R10 414,2023-06-07,02:00:00,5,3,2,FMN 19 Binnensingel Oostkant
666,R10 414,2023-06-07,03:00:00,7,5,2,FMN 19 Binnensingel Oostkant
666,R10 414,2023-06-07,04:00:00,11,8,3,FMN 19 Binnensingel Oostkant
666,R10 414,2023-06-07,05:00:00,11,5,6,FMN 19 Binnensingel Oostkant
666,R10 414,2023-06-07,06:00:00,44,33,11,FMN 19 Binnensingel Oostkant
666,R10 414,2023-06-07,07:00:00,118,79,39,FMN 19 Binnensingel Oostkant
666,R10 414,2023-06-07,08:00:00,148,109,39,FMN 19 Binnensingel Oostkant
666,R10 414,2023-06-07,09:00:00,68,47,21,FMN 19 Binnensingel Oostkant
666,R10 414,2023-06-07,10:00:00,48,37,11,FMN 19 Binnensingel Oostkant
666,R10 414,2023-06-07,11:00:00,66,48,18,FMN 19 Binnensingel Oostkant
666,R10 414,2023-06-07,12:00:00,132,101,31,FMN 19 Binnensingel Oostkant
666,R10 414,2023-06-07,13:00:00,112,96,16,FMN 19 Binnensingel Oostkant
666,R10 414,2023-06-07,14:00:00,100,66,34,FMN 19 Binnensingel Oostkant
666,R10 414,2023-06-07,15:00:00,117,90,27,FMN 19 Binnensingel Oostkant
666,R10 414,2023-06-07,16:00:00,187,152,35,FMN 19 Binnensingel Oostkant
666,R10 414,2023-06-07,17:00:00,214,160,54,FMN 19 Binnensingel Oostkant
666,R10 414,2023-06-07,18:00:00,157,121,36,FMN 19 Binnensingel Oostkant
666,R10 414,2023-06-07,19:00:00,111,73,38,FMN 19 Binnensingel Oostkant
666,R10 414,2023-06-07,20:00:00,83,58,25,FMN 19 Binnensingel Oostkant
666,R10 414,2023-06-07,21:00:00,67,49,18,FMN 19 Binnensingel Oostkant
666,R10 414,2023-06-07,22:00:00,69,58,11,FMN 19 Binnensingel Oostkant
666,R10 414,2023-06-07,23:00:00,36,24,12,FMN 19 Binnensingel Oostkant
666,R10 414,2023-06-08,00:00:00,10,7,3,FMN 19 Binnensingel Oostkant
666,R10 414,2023-06-08,01:00:00,3,3,0,FMN 19 Binnensingel Oostkant
666,R10 414,2023-06-08,02:00:00,4,2,2,FMN 19 Binnensingel Oostkant
666,R10 414,2023-06-08,03:00:00,7,4,3,FMN 19 Binnensingel Oostkant
666,R10 414,2023-06-08,04:00:00,19,14,5,FMN 19 Binnensingel Oostkant
666,R10 414,2023-06-08,05:00:00,25,14,11,FMN 19 Binnensingel Oostkant
666,R10 414,2023-06-08,06:00:00,58,43,15,FMN 19 Binnensingel Oostkant
666,R10 414,2023-06-08,07:00:00,137,101,36,FMN 19 Binnensingel Oostkant
666,R10 414,2023-06-08,08:00:00,183,132,51,FMN 19 Binnensingel Oostkant
666,R10 414,2023-06-08,09:00:00,81,56,25,FMN 19 Binnensingel Oostkant
666,R10 414,2023-06-08,10:00:00,53,41,12,FMN 19 Binnensingel Oostkant
666,R10 414,2023-06-08,11:00:00,66,46,20,FMN 19 Binnensingel Oostkant
666,R10 414,2023-06-08,12:00:00,111,72,39,FMN 19 Binnensingel Oostkant
666,R10 414,2023-06-08,13:00:00,90,62,28,FMN 19 Binnensingel Oostkant
666,R10 414,2023-06-08,14:00:00,87,68,19,FMN 19 Binnensingel Oostkant
666,R10 414,2023-06-08,15:00:00,142,119,23,FMN 19 Binnensingel Oostkant
666,R10 414,2023-06-08,16:00:00,211,161,50,FMN 19 Binnensingel Oostkant
666,R10 414,2023-06-08,17:00:00,239,186,53,FMN 19 Binnensingel Oostkant
666,R10 414,2023-06-08,18:00:00,171,131,40,FMN 19 Binnensingel Oostkant
666,R10 414,2023-06-08,19:00:00,110,67,43,FMN 19 Binnensingel Oostkant
666,R10 414,2023-06-08,20:00:00,83,55,28,FMN 19 Binnensingel Oostkant
666,R10 414,2023-06-08,21:00:00,73,60,13,FMN 19 Binnensingel Oostkant
666,R10 414,2023-06-08,22:00:00,73,59,14,FMN 19 Binnensingel Oostkant
666,R10 414,2023-06-08,23:00:00,41,28,13,FMN 19 Binnensingel Oostkant
666,R10 414,2023-06-09,00:00:00,21,18,3,FMN 19 Binnensingel Oostkant
666,R10 414,2023-06-09,01:00:00,12,10,2,FMN 19 Binnensingel Oostkant
666,R10 414,2023-06-09,02:00:00,2,2,0,FMN 19 Binnensingel Oostkant
666,R10 414,2023-06-09,03:00:00,8,7,1,FMN 19 Binnensingel Oostkant
666,R10 414,2023-06-09,04:00:00,23,14,9,FMN 19 Binnensingel Oostkant
666,R10 414,2023-06-09,05:00:00,21,12,9,FMN 19 Binnensingel Oostkant
666,R10 414,2023-06-09,06:00:00,53,41,12,FMN 19 Binnensingel Oostkant
666,R10 414,2023-06-09,07:00:00,105,80,25,FMN 19 Binnensingel Oostkant
666,R10 414,2023-06-09,08:00:00,142,109,33,FMN 19 Binnensingel Oostkant
666,R10 414,2023-06-09,09:00:00,72,56,16,FMN 19 Binnensingel Oostkant
666,R10 414,2023-06-09,10:00:00,66,51,15,FMN 19 Binnensingel Oostkant
666,R10 414,2023-06-09,11:00:00,71,53,18,FMN 19 Binnensingel Oostkant
666,R10 414,2023-06-09,12:00:00,126,79,47,FMN 19 Binnensingel Oostkant
666,R10 414,2023-06-09,13:00:00,98,67,31,FMN 19 Binnensingel Oostkant
666,R10 414,2023-06-09,14:00:00,108,79,29,FMN 19 Binnensingel Oostkant
666,R10 414,2023-06-09,15:00:00,153,120,33,FMN 19 Binnensingel Oostkant
666,R10 414,2023-06-09,16:00:00,215,170,45,FMN 19 Binnensingel Oostkant
666,R10 414,2023-06-09,17:00:00,205,156,49,FMN 19 Binnensingel Oostkant
666,R10 414,2023-06-09,18:00:00,149,111,38,FMN 19 Binnensingel Oostkant
666,R10 414,2023-06-09,19:00:00,121,84,37,FMN 19 Binnensingel Oostkant
666,R10 414,2023-06-09,20:00:00,95,58,37,FMN 19 Binnensingel Oostkant
666,R10 414,2023-06-09,21:00:00,72,47,25,FMN 19 Binnensingel Oostkant
666,R10 414,2023-06-09,22:00:00,61,45,16,FMN 19 Binnensingel Oostkant
666,R10 414,2023-06-09,23:00:00,48,42,6,FMN 19 Binnensingel Oostkant
666,R10 414,2023-06-10,00:00:00,51,33,18,FMN 19 Binnensingel Oostkant
666,R10 414,2023-06-10,01:00:00,23,19,4,FMN 19 Binnensingel Oostkant
666,R10 414,2023-06-10,02:00:00,20,17,3,FMN 19 Binnensingel Oostkant
666,R10 414,2023-06-10,03:00:00,18,18,0,FMN 19 Binnensingel Oostkant
666,R10 414,2023-06-10,04:00:00,23,18,5,FMN 19 Binnensingel Oostkant
666,R10 414,2023-06-10,05:00:00,24,18,6,FMN 19 Binnensingel Oostkant
666,R10 414,2023-06-10,06:00:00,24,20,4,FMN 19 Binnensingel Oostkant
666,R10 414,2023-06-10,07:00:00,26,20,6,FMN 19 Binnensingel Oostkant
666,R10 414,2023-06-10,08:00:00,42,35,7,FMN 19 Binnensingel Oostkant
666,R10 414,2023-06-10,09:00:00,77,53,24,FMN 19 Binnensingel Oostkant
666,R10 414,2023-06-10,10:00:00,103,70,33,FMN 19 Binnensingel Oostkant
666,R10 414,2023-06-10,11:00:00,94,69,25,FMN 19 Binnensingel Oostkant
666,R10 414,2023-06-10,12:00:00,107,83,24,FMN 19 Binnensingel Oostkant
666,R10 414,2023-06-10,13:00:00,94,79,15,FMN 19 Binnensingel Oostkant
666,R10 414,2023-06-10,14:00:00,99,73,26,FMN 19 Binnensingel Oostkant
666,R10 414,2023-06-10,15:00:00,96,79,17,FMN 19 Binnensingel Oostkant
666,R10 414,2023-06-10,16:00:00,104,82,22,FMN 19 Binnensingel Oostkant
666,R10 414,2023-06-10,17:00:00,116,86,30,FMN 19 Binnensingel Oostkant
666,R10 414,2023-06-10,18:00:00,123,82,41,FMN 19 Binnensingel Oostkant
666,R10 414,2023-06-10,19:00:00,108,82,26,FMN 19 Binnensingel Oostkant
666,R10 414,2023-06-10,20:00:00,92,63,29,FMN 19 Binnensingel Oostkant
666,R10 414,2023-06-10,21:00:00,54,41,13,FMN 19 Binnensingel Oostkant
666,R10 414,2023-06-10,22:00:00,63,53,10,FMN 19 Binnensingel Oostkant
666,R10 414,2023-06-10,23:00:00,62,47,15,FMN 19 Binnensingel Oostkant
666,R10 414,2023-06-11,00:00:00,51,42,9,FMN 19 Binnensingel Oostkant
666,R10 414,2023-06-11,01:00:00,35,23,12,FMN 19 Binnensingel Oostkant
666,R10 414,2023-06-11,02:00:00,22,17,5,FMN 19 Binnensingel Oostkant
666,R10 414,2023-06-11,03:00:00,18,18,0,FMN 19 Binnensingel Oostkant
666,R10 414,2023-06-11,04:00:00,12,9,3,FMN 19 Binnensingel Oostkant
666,R10 414,2023-06-11,05:00:00,11,8,3,FMN 19 Binnensingel Oostkant
666,R10 414,2023-06-11,06:00:00,18,9,9,FMN 19 Binnensingel Oostkant
666,R10 414,2023-06-11,07:00:00,21,19,2,FMN 19 Binnensingel Oostkant
666,R10 414,2023-06-11,08:00:00,37,29,8,FMN 19 Binnensingel Oostkant
666,R10 414,2023-06-11,09:00:00,69,53,16,FMN 19 Binnensingel Oostkant
666,R10 414,2023-06-11,10:00:00,100,74,26,FMN 19 Binnensingel Oostkant
666,R10 414,2023-06-11,11:00:00,82,66,16,FMN 19 Binnensingel Oostkant
666,R10 414,2023-06-11,12:00:00,115,89,26,FMN 19 Binnensingel Oostkant
666,R10 414,2023-06-11,13:00:00,125,96,29,FMN 19 Binnensingel Oostkant
666,R10 414,2023-06-11,14:00:00,116,92,24,FMN 19 Binnensingel Oostkant
666,R10 414,2023-06-11,15:00:00,138,105,33,FMN 19 Binnensingel Oostkant
666,R10 414,2023-06-11,16:00:00,129,91,38,FMN 19 Binnensingel Oostkant
666,R10 414,2023-06-11,17:00:00,123,96,27,FMN 19 Binnensingel Oostkant
666,R10 414,2023-06-11,18:00:00,113,85,28,FMN 19 Binnensingel Oostkant
666,R10 414,2023-06-11,19:00:00,91,65,26,FMN 19 Binnensingel Oostkant
666,R10 414,2023-06-11,20:00:00,72,52,20,FMN 19 Binnensingel Oostkant
666,R10 414,2023-06-11,21:00:00,72,48,24,FMN 19 Binnensingel Oostkant
666,R10 414,2023-06-11,22:00:00,63,42,21,FMN 19 Binnensingel Oostkant
666,R10 414,2023-06-11,23:00:00,34,28,6,FMN 19 Binnensingel Oostkant
666,R10 414,2023-06-12,00:00:00,12,9,3,FMN 19 Binnensingel Oostkant
666,R10 414,2023-06-12,01:00:00,8,6,2,FMN 19 Binnensingel Oostkant
666,R10 414,2023-06-12,02:00:00,11,8,3,FMN 19 Binnensingel Oostkant
666,R10 414,2023-06-12,03:00:00,4,3,1,FMN 19 Binnensingel Oostkant
666,R10 414,2023-06-12,04:00:00,19,12,7,FMN 19 Binnensingel Oostkant
666,R10 414,2023-06-12,05:00:00,26,15,11,FMN 19 Binnensingel Oostkant
666,R10 414,2023-06-12,06:00:00,54,37,17,FMN 19 Binnensingel Oostkant
666,R10 414,2023-06-12,07:00:00,147,113,34,FMN 19 Binnensingel Oostkant
666,R10 414,2023-06-12,08:00:00,179,134,45,FMN 19 Binnensingel Oostkant
666,R10 414,2023-06-12,09:00:00,86,55,31,FMN 19 Binnensingel Oostkant
666,R10 414,2023-06-12,10:00:00,78,51,27,FMN 19 Binnensingel Oostkant
666,R10 414,2023-06-12,11:00:00,79,55,24,FMN 19 Binnensingel Oostkant
666,R10 414,2023-06-12,12:00:00,106,80,26,FMN 19 Binnensingel Oostkant
666,R10 414,2023-06-12,13:00:00,98,66,32,FMN 19 Binnensingel Oostkant
666,R10 414,2023-06-12,14:00:00,118,85,33,FMN 19 Binnensingel Oostkant
666,R10 414,2023-06-12,15:00:00,177,129,48,FMN 19 Binnensingel Oostkant
666,R10 414,2023-06-12,16:00:00,254,198,56,FMN 19 Binnensingel Oostkant
666,R10 414,2023-06-12,17:00:00,258,196,62,FMN 19 Binnensingel Oostkant
666,R10 414,2023-06-12,18:00:00,180,136,44,FMN 19 Binnensingel Oostkant
666,R10 414,2023-06-12,19:00:00,122,75,47,FMN 19 Binnensingel Oostkant
666,R10 414,2023-06-12,20:00:00,70,52,18,FMN 19 Binnensingel Oostkant
666,R10 414,2023-06-12,21:00:00,79,61,18,FMN 19 Binnensingel Oostkant
666,R10 414,2023-06-12,22:00:00,83,65,18,FMN 19 Binnensingel Oostkant
666,R10 414,2023-06-12,23:00:00,21,19,2,FMN 19 Binnensingel Oostkant
666,R10 414,2023-06-13,00:00:00,9,4,5,FMN 19 Binnensingel Oostkant
666,R10 414,2023-06-13,01:00:00,3,2,1,FMN 19 Binnensingel Oostkant
666,R10 414,2023-06-13,02:00:00,6,5,1,FMN 19 Binnensingel Oostkant
666,R10 414,2023-06-13,03:00:00,5,4,1,FMN 19 Binnensingel Oostkant
666,R10 414,2023-06-13,04:00:00,12,6,6,FMN 19 Binnensingel Oostkant
666,R10 414,2023-06-13,05:00:00,17,10,7,FMN 19 Binnensingel Oostkant
666,R10 414,2023-06-13,06:00:00,64,50,14,FMN 19 Binnensingel Oostkant
666,R10 414,2023-06-13,07:00:00,141,107,34,FMN 19 Binnensingel Oostkant
666,R10 414,2023-06-13,08:00:00,191,151,40,FMN 19 Binnensingel Oostkant
666,R10 414,2023-06-13,09:00:00,71,54,17,FMN 19 Binnensingel Oostkant
666,R10 414,2023-06-13,10:00:00,62,47,15,FMN 19 Binnensingel Oostkant
666,R10 414,2023-06-13,11:00:00,77,49,28,FMN 19 Binnensingel Oostkant
666,R10 414,2023-06-13,12:00:00,102,65,37,FMN 19 Binnensingel Oostkant
666,R10 414,2023-06-13,13:00:00,90,65,25,FMN 19 Binnensingel Oostkant
666,R10 414,2023-06-13,14:00:00,91,59,32,FMN 19 Binnensingel Oostkant
666,R10 414,2023-06-13,15:00:00,160,124,36,FMN 19 Binnensingel Oostkant
666,R10 414,2023-06-13,16:00:00,242,186,56,FMN 19 Binnensingel Oostkant
666,R10 414,2023-06-13,17:00:00,273,201,72,FMN 19 Binnensingel Oostkant
666,R10 414,2023-06-13,18:00:00,214,160,54,FMN 19 Binnensingel Oostkant
666,R10 414,2023-06-13,19:00:00,101,81,20,FMN 19 Binnensingel Oostkant
666,R10 414,2023-06-13,20:00:00,87,54,33,FMN 19 Binnensingel Oostkant
666,R10 414,2023-06-13,21:00:00,92,65,27,FMN 19 Binnensingel Oostkant
666,R10 414,2023-06-13,22:00:00,83,59,24,FMN 19 Binnensingel Oostkant
666,R10 414,2023-06-13,23:00:00,51,35,16,FMN 19 Binnensingel Oostkant
666,R10 414,2023-06-14,00:00:00,15,10,5,FMN 19 Binnensingel Oostkant
666,R10 414,2023-06-14,01:00:00,9,6,3,FMN 19 Binnensingel Oostkant
666,R10 414,2023-06-14,02:00:00,3,1,2,FMN 19 Binnensingel Oostkant
666,R10 414,2023-06-14,03:00:00,4,1,3,FMN 19 Binnensingel Oostkant
666,R10 414,2023-06-14,04:00:00,14,9,5,FMN 19 Binnensingel Oostkant
666,R10 414,2023-06-14,05:00:00,18,11,7,FMN 19 Binnensingel Oostkant
666,R10 414,2023-06-14,06:00:00,59,35,24,FMN 19 Binnensingel Oostkant
666,R10 414,2023-06-14,07:00:00,101,82,19,FMN 19 Binnensingel Oostkant
666,R10 414,2023-06-14,08:00:00,136,112,24,FMN 19 Binnensingel Oostkant
666,R10 414,2023-06-14,09:00:00,68,49,19,FMN 19 Binnensingel Oostkant
666,R10 414,2023-06-14,10:00:00,63,44,19,FMN 19 Binnensingel Oostkant
666,R10 414,2023-06-14,11:00:00,78,42,36,FMN 19 Binnensingel Oostkant
666,R10 414,2023-06-14,12:00:00,147,113,34,FMN 19 Binnensingel Oostkant
666,R10 414,2023-06-14,13:00:00,122,93,29,FMN 19 Binnensingel Oostkant
666,R10 414,2023-06-14,14:00:00,98,59,39,FMN 19 Binnensingel Oostkant
666,R10 414,2023-06-14,15:00:00,140,104,36,FMN 19 Binnensingel Oostkant
666,R10 414,2023-06-14,16:00:00,198,165,33,FMN 19 Binnensingel Oostkant
666,R10 414,2023-06-14,17:00:00,226,182,44,FMN 19 Binnensingel Oostkant
666,R10 414,2023-06-14,18:00:00,168,126,42,FMN 19 Binnensingel Oostkant
666,R10 414,2023-06-14,19:00:00,116,78,38,FMN 19 Binnensingel Oostkant
666,R10 414,2023-06-14,20:00:00,93,63,30,FMN 19 Binnensingel Oostkant
666,R10 414,2023-06-14,21:00:00,78,55,23,FMN 19 Binnensingel Oostkant
666,R10 414,2023-06-14,22:00:00,64,53,11,FMN 19 Binnensingel Oostkant
666,R10 414,2023-06-14,23:00:00,32,20,12,FMN 19 Binnensingel Oostkant
666,R10 414,2023-06-15,00:00:00,11,7,4,FMN 19 Binnensingel Oostkant
666,R10 414,2023-06-15,01:00:00,13,8,5,FMN 19 Binnensingel Oostkant
666,R10 414,2023-06-15,02:00:00,6,5,1,FMN 19 Binnensingel Oostkant
666,R10 414,2023-06-15,03:00:00,4,3,1,FMN 19 Binnensingel Oostkant
666,R10 414,2023-06-15,04:00:00,16,11,5,FMN 19 Binnensingel Oostkant
666,R10 414,2023-06-15,05:00:00,24,13,11,FMN 19 Binnensingel Oostkant
666,R10 414,2023-06-15,06:00:00,52,33,19,FMN 19 Binnensingel Oostkant
666,R10 414,2023-06-15,07:00:00,126,100,26,FMN 19 Binnensingel Oostkant
666,R10 414,2023-06-15,08:00:00,163,118,45,FMN 19 Binnensingel Oostkant
666,R10 414,2023-06-15,09:00:00,81,59,22,FMN 19 Binnensingel Oostkant
666,R10 414,2023-06-15,10:00:00,65,39,26,FMN 19 Binnensingel Oostkant
666,R10 414,2023-06-15,11:00:00,70,44,26,FMN 19 Binnensingel Oostkant
666,R10 414,2023-06-15,12:00:00,110,72,38,FMN 19 Binnensingel Oostkant
666,R10 414,2023-06-15,13:00:00,87,61,26,FMN 19 Binnensingel Oostkant
666,R10 414,2023-06-15,14:00:00,85,70,15,FMN 19 Binnensingel Oostkant
666,R10 414,2023-06-15,15:00:00,150,122,28,FMN 19 Binnensingel Oostkant
666,R10 414,2023-06-15,16:00:00,210,167,43,FMN 19 Binnensingel Oostkant
666,R10 414,2023-06-15,17:00:00,231,183,48,FMN 19 Binnensingel Oostkant
666,R10 414,2023-06-15,18:00:00,162,129,33,FMN 19 Binnensingel Oostkant
666,R10 414,2023-06-15,19:00:00,106,69,37,FMN 19 Binnensingel Oostkant
666,R10 414,2023-06-15,20:00:00,74,50,24,FMN 19 Binnensingel Oostkant
666,R10 414,2023-06-15,21:00:00,70,54,16,FMN 19 Binnensingel Oostkant
666,R10 414,2023-06-15,22:00:00,61,47,14,FMN 19 Binnensingel Oostkant
666,R10 414,2023-06-15,23:00:00,49,33,16,FMN 19 Binnensingel Oostkant
666,R10 414,2023-06-16,00:00:00,26,14,12,FMN 19 Binnensingel Oostkant
666,R10 414,2023-06-16,01:00:00,12,8,4,FMN 19 Binnensingel Oostkant
666,R10 414,2023-06-16,02:00:00,7,4,3,FMN 19 Binnensingel Oostkant
666,R10 414,2023-06-16,03:00:00,4,4,0,FMN 19 Binnensingel Oostkant
666,R10 414,2023-06-16,04:00:00,22,13,9,FMN 19 Binnensingel Oostkant
666,R10 414,2023-06-16,05:00:00,18,16,2,FMN 19 Binnensingel Oostkant
666,R10 414,2023-06-16,06:00:00,48,37,11,FMN 19 Binnensingel Oostkant
666,R10 414,2023-06-16,07:00:00,102,78,24,FMN 19 Binnensingel Oostkant
666,R10 414,2023-06-16,08:00:00,131,113,18,FMN 19 Binnensingel Oostkant
666,R10 414,2023-06-16,09:00:00,77,55,22,FMN 19 Binnensingel Oostkant
666,R10 414,2023-06-16,10:00:00,67,48,19,FMN 19 Binnensingel Oostkant
666,R10 414,2023-06-16,11:00:00,82,53,29,FMN 19 Binnensingel Oostkant
666,R10 414,2023-06-16,12:00:00,103,72,31,FMN 19 Binnensingel Oostkant
666,R10 414,2023-06-16,13:00:00,103,78,25,FMN 19 Binnensingel Oostkant
666,R10 414,2023-06-16,14:00:00,108,76,32,FMN 19 Binnensingel Oostkant
666,R10 414,2023-06-16,15:00:00,160,126,34,FMN 19 Binnensingel Oostkant
666,R10 414,2023-06-16,16:00:00,206,181,25,FMN 19 Binnensingel Oostkant
666,R10 414,2023-06-16,17:00:00,217,168,49,FMN 19 Binnensingel Oostkant
666,R10 414,2023-06-16,18:00:00,166,111,55,FMN 19 Binnensingel Oostkant
666,R10 414,2023-06-16,19:00:00,120,77,43,FMN 19 Binnensingel Oostkant
666,R10 414,2023-06-16,20:00:00,100,66,34,FMN 19 Binnensingel Oostkant
666,R10 414,2023-06-16,21:00:00,88,54,34,FMN 19 Binnensingel Oostkant
666,R10 414,2023-06-16,22:00:00,66,51,15,FMN 19 Binnensingel Oostkant
666,R10 414,2023-06-16,23:00:00,59,38,21,FMN 19 Binnensingel Oostkant
666,R10 414,2023-06-17,00:00:00,45,37,8,FMN 19 Binnensingel Oostkant
666,R10 414,2023-06-17,01:00:00,20,16,4,FMN 19 Binnensingel Oostkant
666,R10 414,2023-06-17,02:00:00,21,16,5,FMN 19 Binnensingel Oostkant
666,R10 414,2023-06-17,03:00:00,13,10,3,FMN 19 Binnensingel Oostkant
666,R10 414,2023-06-17,04:00:00,23,17,6,FMN 19 Binnensingel Oostkant
666,R10 414,2023-06-17,05:00:00,14,10,4,FMN 19 Binnensingel Oostkant
666,R10 414,2023-06-17,06:00:00,21,18,3,FMN 19 Binnensingel Oostkant
666,R10 414,2023-06-17,07:00:00,27,25,2,FMN 19 Binnensingel Oostkant
666,R10 414,2023-06-17,08:00:00,37,28,9,FMN 19 Binnensingel Oostkant
666,R10 414,2023-06-17,09:00:00,58,44,14,FMN 19 Binnensingel Oostkant
666,R10 414,2023-06-17,10:00:00,76,63,13,FMN 19 Binnensingel Oostkant
666,R10 414,2023-06-17,11:00:00,67,58,9,FMN 19 Binnensingel Oostkant
666,R10 414,2023-06-17,12:00:00,88,69,19,FMN 19 Binnensingel Oostkant
666,R10 414,2023-06-17,13:00:00,106,71,35,FMN 19 Binnensingel Oostkant
666,R10 414,2023-06-17,14:00:00,103,81,22,FMN 19 Binnensingel Oostkant
666,R10 414,2023-06-17,15:00:00,98,70,28,FMN 19 Binnensingel Oostkant
666,R10 414,2023-06-17,16:00:00,81,59,22,FMN 19 Binnensingel Oostkant
666,R10 414,2023-06-17,17:00:00,110,76,34,FMN 19 Binnensingel Oostkant
666,R10 414,2023-06-17,18:00:00,100,79,21,FMN 19 Binnensingel Oostkant
666,R10 414,2023-06-17,19:00:00,98,74,24,FMN 19 Binnensingel Oostkant
666,R10 414,2023-06-17,20:00:00,84,61,23,FMN 19 Binnensingel Oostkant
666,R10 414,2023-06-17,21:00:00,48,37,11,FMN 19 Binnensingel Oostkant
666,R10 414,2023-06-17,22:00:00,52,46,6,FMN 19 Binnensingel Oostkant
666,R10 414,2023-06-17,23:00:00,55,42,13,FMN 19 Binnensingel Oostkant
666,R10 414,2023-06-18,00:00:00,46,31,15,FMN 19 Binnensingel Oostkant
666,R10 414,2023-06-18,01:00:00,28,23,5,FMN 19 Binnensingel Oostkant
666,R10 414,2023-06-18,02:00:00,17,11,6,FMN 19 Binnensingel Oostkant
666,R10 414,2023-06-18,03:00:00,13,9,4,FMN 19 Binnensingel Oostkant
666,R10 414,2023-06-18,04:00:00,10,8,2,FMN 19 Binnensingel Oostkant
666,R10 414,2023-06-18,05:00:00,10,7,3,FMN 19 Binnensingel Oostkant
666,R10 414,2023-06-18,06:00:00,10,7,3,FMN 19 Binnensingel Oostkant
666,R10 414,2023-06-18,07:00:00,18,18,0,FMN 19 Binnensingel Oostkant
666,R10 414,2023-06-18,08:00:00,28,21,7,FMN 19 Binnensingel Oostkant
666,R10 414,2023-06-18,09:00:00,50,37,13,FMN 19 Binnensingel Oostkant
666,R10 414,2023-06-18,10:00:00,67,56,11,FMN 19 Binnensingel Oostkant
666,R10 414,2023-06-18,11:00:00,64,54,10,FMN 19 Binnensingel Oostkant
666,R10 414,2023-06-18,12:00:00,75,66,9,FMN 19 Binnensingel Oostkant
666,R10 414,2023-06-18,13:00:00,78,66,12,FMN 19 Binnensingel Oostkant
666,R10 414,2023-06-18,14:00:00,84,64,20,FMN 19 Binnensingel Oostkant
666,R10 414,2023-06-18,15:00:00,82,67,15,FMN 19 Binnensingel Oostkant
666,R10 414,2023-06-18,16:00:00,79,61,18,FMN 19 Binnensingel Oostkant
666,R10 414,2023-06-18,17:00:00,97,64,33,FMN 19 Binnensingel Oostkant
666,R10 414,2023-06-18,18:00:00,86,64,22,FMN 19 Binnensingel Oostkant
666,R10 414,2023-06-18,19:00:00,77,63,14,FMN 19 Binnensingel Oostkant
666,R10 414,2023-06-18,20:00:00,46,35,11,FMN 19 Binnensingel Oostkant
666,R10 414,2023-06-18,21:00:00,58,45,13,FMN 19 Binnensingel Oostkant
666,R10 414,2023-06-18,22:00:00,44,41,3,FMN 19 Binnensingel Oostkant
666,R10 414,2023-06-18,23:00:00,29,22,7,FMN 19 Binnensingel Oostkant
666,R10 414,2023-06-19,00:00:00,6,5,1,FMN 19 Binnensingel Oostkant
666,R10 414,2023-06-19,01:00:00,5,3,2,FMN 19 Binnensingel Oostkant
666,R10 414,2023-06-19,02:00:00,6,5,1,FMN 19 Binnensingel Oostkant
666,R10 414,2023-06-19,03:00:00,4,2,2,FMN 19 Binnensingel Oostkant
666,R10 414,2023-06-19,04:00:00,9,5,4,FMN 19 Binnensingel Oostkant
666,R10 414,2023-06-19,05:00:00,24,17,7,FMN 19 Binnensingel Oostkant
666,R10 414,2023-06-19,06:00:00,48,34,14,FMN 19 Binnensingel Oostkant
666,R10 414,2023-06-19,07:00:00,101,75,26,FMN 19 Binnensingel Oostkant
666,R10 414,2023-06-19,08:00:00,146,108,38,FMN 19 Binnensingel Oostkant
666,R10 414,2023-06-19,09:00:00,60,47,13,FMN 19 Binnensingel Oostkant
666,R10 414,2023-06-19,10:00:00,37,30,7,FMN 19 Binnensingel Oostkant
666,R10 414,2023-06-19,11:00:00,50,39,11,FMN 19 Binnensingel Oostkant
666,R10 414,2023-06-19,12:00:00,76,60,16,FMN 19 Binnensingel Oostkant
666,R10 414,2023-06-19,13:00:00,65,50,15,FMN 19 Binnensingel Oostkant
666,R10 414,2023-06-19,14:00:00,81,55,26,FMN 19 Binnensingel Oostkant
666,R10 414,2023-06-19,15:00:00,137,113,24,FMN 19 Binnensingel Oostkant
666,R10 414,2023-06-19,16:00:00,204,164,40,FMN 19 Binnensingel Oostkant
666,R10 414,2023-06-19,17:00:00,196,155,41,FMN 19 Binnensingel Oostkant
666,R10 414,2023-06-19,18:00:00,178,115,63,FMN 19 Binnensingel Oostkant
666,R10 414,2023-06-19,19:00:00,84,57,27,FMN 19 Binnensingel Oostkant
666,R10 414,2023-06-19,20:00:00,71,52,19,FMN 19 Binnensingel Oostkant
666,R10 414,2023-06-19,21:00:00,74,56,18,FMN 19 Binnensingel Oostkant
666,R10 414,2023-06-19,22:00:00,61,49,12,FMN 19 Binnensingel Oostkant
666,R10 414,2023-06-19,23:00:00,38,23,15,FMN 19 Binnensingel Oostkant
666,R10 414,2023-06-20,00:00:00,6,5,1,FMN 19 Binnensingel Oostkant
666,R10 414,2023-06-20,01:00:00,4,1,3,FMN 19 Binnensingel Oostkant
666,R10 414,2023-06-20,02:00:00,1,1,0,FMN 19 Binnensingel Oostkant
666,R10 414,2023-06-20,03:00:00,3,1,2,FMN 19 Binnensingel Oostkant
666,R10 414,2023-06-20,04:00:00,11,8,3,FMN 19 Binnensingel Oostkant
666,R10 414,2023-06-20,05:00:00,18,10,8,FMN 19 Binnensingel Oostkant
666,R10 414,2023-06-20,06:00:00,39,27,12,FMN 19 Binnensingel Oostkant
666,R10 414,2023-06-20,07:00:00,113,88,25,FMN 19 Binnensingel Oostkant
666,R10 414,2023-06-20,08:00:00,148,109,39,FMN 19 Binnensingel Oostkant
666,R10 414,2023-06-20,09:00:00,60,36,24,FMN 19 Binnensingel Oostkant
666,R10 414,2023-06-20,10:00:00,53,33,20,FMN 19 Binnensingel Oostkant
666,R10 414,2023-06-20,11:00:00,48,36,12,FMN 19 Binnensingel Oostkant
666,R10 414,2023-06-20,12:00:00,79,54,25,FMN 19 Binnensingel Oostkant
666,R10 414,2023-06-20,13:00:00,90,59,31,FMN 19 Binnensingel Oostkant
666,R10 414,2023-06-20,14:00:00,82,50,32,FMN 19 Binnensingel Oostkant
666,R10 414,2023-06-20,15:00:00,120,91,29,FMN 19 Binnensingel Oostkant
666,R10 414,2023-06-20,16:00:00,164,138,26,FMN 19 Binnensingel Oostkant
666,R10 414,2023-06-20,17:00:00,169,132,37,FMN 19 Binnensingel Oostkant
666,R10 414,2023-06-20,18:00:00,130,106,24,FMN 19 Binnensingel Oostkant
666,R10 414,2023-06-20,19:00:00,71,63,8,FMN 19 Binnensingel Oostkant
666,R10 414,2023-06-20,20:00:00,44,38,6,FMN 19 Binnensingel Oostkant
666,R10 414,2023-06-20,21:00:00,57,54,3,FMN 19 Binnensingel Oostkant
666,R10 414,2023-06-20,22:00:00,50,45,5,FMN 19 Binnensingel Oostkant
666,R10 414,2023-06-20,23:00:00,19,12,7,FMN 19 Binnensingel Oostkant
666,R10 414,2023-06-21,00:00:00,8,6,2,FMN 19 Binnensingel Oostkant
666,R10 414,2023-06-21,01:00:00,10,7,3,FMN 19 Binnensingel Oostkant
666,R10 414,2023-06-21,02:00:00,2,2,0,FMN 19 Binnensingel Oostkant
666,R10 414,2023-06-21,03:00:00,6,4,2,FMN 19 Binnensingel Oostkant
666,R10 414,2023-06-21,04:00:00,22,16,6,FMN 19 Binnensingel Oostkant
666,R10 414,2023-06-21,05:00:00,14,6,8,FMN 19 Binnensingel Oostkant
666,R10 414,2023-06-21,06:00:00,47,33,14,FMN 19 Binnensingel Oostkant
666,R10 414,2023-06-21,07:00:00,94,73,21,FMN 19 Binnensingel Oostkant
666,R10 414,2023-06-21,08:00:00,118,91,27,FMN 19 Binnensingel Oostkant
666,R10 414,2023-06-21,09:00:00,62,41,21,FMN 19 Binnensingel Oostkant
666,R10 414,2023-06-21,10:00:00,47,37,10,FMN 19 Binnensingel Oostkant
666,R10 414,2023-06-21,11:00:00,46,35,11,FMN 19 Binnensingel Oostkant
666,R10 414,2023-06-21,12:00:00,91,79,12,FMN 19 Binnensingel Oostkant
666,R10 414,2023-06-21,13:00:00,92,74,18,FMN 19 Binnensingel Oostkant
666,R10 414,2023-06-21,14:00:00,79,55,24,FMN 19 Binnensingel Oostkant
666,R10 414,2023-06-21,15:00:00,101,80,21,FMN 19 Binnensingel Oostkant
666,R10 414,2023-06-21,16:00:00,157,133,24,FMN 19 Binnensingel Oostkant
666,R10 414,2023-06-21,17:00:00,169,134,35,FMN 19 Binnensingel Oostkant
666,R10 414,2023-06-21,18:00:00,139,97,42,FMN 19 Binnensingel Oostkant
666,R10 414,2023-06-21,19:00:00,80,57,23,FMN 19 Binnensingel Oostkant
666,R10 414,2023-06-21,20:00:00,79,54,25,FMN 19 Binnensingel Oostkant
666,R10 414,2023-06-21,21:00:00,71,46,25,FMN 19 Binnensingel Oostkant
666,R10 414,2023-06-21,22:00:00,55,43,12,FMN 19 Binnensingel Oostkant
666,R10 414,2023-06-21,23:00:00,33,23,10,FMN 19 Binnensingel Oostkant
666,R10 414,2023-06-22,00:00:00,12,5,7,FMN 19 Binnensingel Oostkant
666,R10 414,2023-06-22,01:00:00,15,7,8,FMN 19 Binnensingel Oostkant
666,R10 414,2023-06-22,02:00:00,4,2,2,FMN 19 Binnensingel Oostkant
666,R10 414,2023-06-22,03:00:00,8,5,3,FMN 19 Binnensingel Oostkant
666,R10 414,2023-06-22,04:00:00,9,5,4,FMN 19 Binnensingel Oostkant
666,R10 414,2023-06-22,05:00:00,21,13,8,FMN 19 Binnensingel Oostkant
666,R10 414,2023-06-22,06:00:00,32,24,8,FMN 19 Binnensingel Oostkant
666,R10 414,2023-06-22,07:00:00,98,78,20,FMN 19 Binnensingel Oostkant
666,R10 414,2023-06-22,08:00:00,122,84,38,FMN 19 Binnensingel Oostkant
666,R10 414,2023-06-22,09:00:00,59,36,23,FMN 19 Binnensingel Oostkant
666,R10 414,2023-06-22,10:00:00,39,28,11,FMN 19 Binnensingel Oostkant
666,R10 414,2023-06-22,11:00:00,40,26,14,FMN 19 Binnensingel Oostkant
666,R10 414,2023-06-22,12:00:00,52,43,9,FMN 19 Binnensingel Oostkant
666,R10 414,2023-06-22,13:00:00,52,42,10,FMN 19 Binnensingel Oostkant
666,R10 414,2023-06-22,14:00:00,47,36,11,FMN 19 Binnensingel Oostkant
666,R10 414,2023-06-22,15:00:00,78,70,8,FMN 19 Binnensingel Oostkant
666,R10 414,2023-06-22,16:00:00,133,119,14,FMN 19 Binnensingel Oostkant
666,R10 414,2023-06-22,17:00:00,124,109,15,FMN 19 Binnensingel Oostkant
666,R10 414,2023-06-22,18:00:00,99,84,15,FMN 19 Binnensingel Oostkant
666,R10 414,2023-06-22,19:00:00,52,44,8,FMN 19 Binnensingel Oostkant
666,R10 414,2023-06-22,20:00:00,50,34,16,FMN 19 Binnensingel Oostkant
666,R10 414,2023-06-22,21:00:00,36,29,7,FMN 19 Binnensingel Oostkant
666,R10 414,2023-06-22,22:00:00,57,44,13,FMN 19 Binnensingel Oostkant
666,R10 414,2023-06-22,23:00:00,15,12,3,FMN 19 Binnensingel Oostkant
666,R10 414,2023-06-23,00:00:00,13,8,5,FMN 19 Binnensingel Oostkant
666,R10 414,2023-06-23,01:00:00,13,9,4,FMN 19 Binnensingel Oostkant
666,R10 414,2023-06-23,02:00:00,3,3,0,FMN 19 Binnensingel Oostkant
666,R10 414,2023-06-23,03:00:00,7,5,2,FMN 19 Binnensingel Oostkant
666,R10 414,2023-06-23,04:00:00,16,11,5,FMN 19 Binnensingel Oostkant
666,R10 414,2023-06-23,05:00:00,16,8,8,FMN 19 Binnensingel Oostkant
666,R10 414,2023-06-23,06:00:00,36,29,7,FMN 19 Binnensingel Oostkant
666,R10 414,2023-06-23,07:00:00,84,69,15,FMN 19 Binnensingel Oostkant
666,R10 414,2023-06-23,08:00:00,114,87,27,FMN 19 Binnensingel Oostkant
666,R10 414,2023-06-23,09:00:00,69,51,18,FMN 19 Binnensingel Oostkant
666,R10 414,2023-06-23,10:00:00,49,38,11,FMN 19 Binnensingel Oostkant
666,R10 414,2023-06-23,11:00:00,59,40,19,FMN 19 Binnensingel Oostkant
666,R10 414,2023-06-23,12:00:00,87,60,27,FMN 19 Binnensingel Oostkant
666,R10 414,2023-06-23,13:00:00,90,72,18,FMN 19 Binnensingel Oostkant
666,R10 414,2023-06-23,14:00:00,91,60,31,FMN 19 Binnensingel Oostkant
666,R10 414,2023-06-23,15:00:00,137,104,33,FMN 19 Binnensingel Oostkant
666,R10 414,2023-06-23,16:00:00,180,137,43,FMN 19 Binnensingel Oostkant
666,R10 414,2023-06-23,17:00:00,164,136,28,FMN 19 Binnensingel Oostkant
666,R10 414,2023-06-23,18:00:00,131,103,28,FMN 19 Binnensingel Oostkant
666,R10 414,2023-06-23,19:00:00,92,69,23,FMN 19 Binnensingel Oostkant
666,R10 414,2023-06-23,20:00:00,71,42,29,FMN 19 Binnensingel Oostkant
666,R10 414,2023-06-23,21:00:00,46,37,9,FMN 19 Binnensingel Oostkant
666,R10 414,2023-06-23,22:00:00,55,44,11,FMN 19 Binnensingel Oostkant
666,R10 414,2023-06-23,23:00:00,29,24,5,FMN 19 Binnensingel Oostkant
666,R10 414,2023-06-24,00:00:00,16,10,6,FMN 19 Binnensingel Oostkant
666,R10 414,2023-06-24,01:00:00,12,5,7,FMN 19 Binnensingel Oostkant
666,R10 414,2023-06-24,02:00:00,19,13,6,FMN 19 Binnensingel Oostkant
666,R10 414,2023-06-24,03:00:00,13,6,7,FMN 19 Binnensingel Oostkant
666,R10 414,2023-06-24,04:00:00,11,4,7,FMN 19 Binnensingel Oostkant
666,R10 414,2023-06-24,05:00:00,10,2,8,FMN 19 Binnensingel Oostkant
666,R10 414,2023-06-24,06:00:00,15,6,9,FMN 19 Binnensingel Oostkant
666,R10 414,2023-06-24,07:00:00,17,8,9,FMN 19 Binnensingel Oostkant
666,R10 414,2023-06-24,08:00:00,20,12,8,FMN 19 Binnensingel Oostkant
666,R10 414,2023-06-24,09:00:00,28,15,13,FMN 19 Binnensingel Oostkant
666,R10 414,2023-06-24,10:00:00,47,31,16,FMN 19 Binnensingel Oostkant
666,R10 414,2023-06-24,11:00:00,52,28,24,FMN 19 Binnensingel Oostkant
666,R10 414,2023-06-24,12:00:00,61,29,32,FMN 19 Binnensingel Oostkant
666,R10 414,2023-06-24,13:00:00,54,33,21,FMN 19 Binnensingel Oostkant
666,R10 414,2023-06-24,14:00:00,70,38,32,FMN 19 Binnensingel Oostkant
666,R10 414,2023-06-24,15:00:00,62,36,26,FMN 19 Binnensingel Oostkant
666,R10 414,2023-06-24,16:00:00,50,29,21,FMN 19 Binnensingel Oostkant
666,R10 414,2023-06-24,17:00:00,55,33,22,FMN 19 Binnensingel Oostkant
666,R10 414,2023-06-24,18:00:00,69,38,31,FMN 19 Binnensingel Oostkant
666,R10 414,2023-06-24,19:00:00,64,33,31,FMN 19 Binnensingel Oostkant
666,R10 414,2023-06-24,20:00:00,50,30,20,FMN 19 Binnensingel Oostkant
666,R10 414,2023-06-24,21:00:00,34,28,6,FMN 19 Binnensingel Oostkant
666,R10 414,2023-06-24,22:00:00,37,27,10,FMN 19 Binnensingel Oostkant
666,R10 414,2023-06-24,23:00:00,29,16,13,FMN 19 Binnensingel Oostkant
666,R10 414,2023-06-25,00:00:00,0,0,0,FMN 19 Binnensingel Oostkant
666,R10 414,2023-06-25,01:00:00,15,10,5,FMN 19 Binnensingel Oostkant
666,R10 414,2023-06-25,02:00:00,10,8,2,FMN 19 Binnensingel Oostkant
666,R10 414,2023-06-25,03:00:00,9,4,5,FMN 19 Binnensingel Oostkant
666,R10 414,2023-06-25,04:00:00,3,0,3,FMN 19 Binnensingel Oostkant
666,R10 414,2023-06-25,05:00:00,6,5,1,FMN 19 Binnensingel Oostkant
666,R10 414,2023-06-25,06:00:00,4,1,3,FMN 19 Binnensingel Oostkant
666,R10 414,2023-06-25,07:00:00,7,5,2,FMN 19 Binnensingel Oostkant
666,R10 414,2023-06-25,08:00:00,25,15,10,FMN 19 Binnensingel Oostkant
666,R10 414,2023-06-25,09:00:00,32,19,13,FMN 19 Binnensingel Oostkant
666,R10 414,2023-06-25,10:00:00,42,28,14,FMN 19 Binnensingel Oostkant
666,R10 414,2023-06-25,11:00:00,38,26,12,FMN 19 Binnensingel Oostkant
666,R10 414,2023-06-25,12:00:00,52,33,19,FMN 19 Binnensingel Oostkant
666,R10 414,2023-06-25,13:00:00,54,32,22,FMN 19 Binnensingel Oostkant
666,R10 414,2023-06-25,14:00:00,54,30,24,FMN 19 Binnensingel Oostkant
666,R10 414,2023-06-25,15:00:00,58,31,27,FMN 19 Binnensingel Oostkant
666,R10 414,2023-06-25,16:00:00,69,32,37,FMN 19 Binnensingel Oostkant
666,R10 414,2023-06-25,17:00:00,54,34,20,FMN 19 Binnensingel Oostkant
666,R10 414,2023-06-25,18:00:00,49,21,28,FMN 19 Binnensingel Oostkant
666,R10 414,2023-06-25,19:00:00,36,17,19,FMN 19 Binnensingel Oostkant
666,R10 414,2023-06-25,20:00:00,32,14,18,FMN 19 Binnensingel Oostkant
666,R10 414,2023-06-25,21:00:00,35,18,17,FMN 19 Binnensingel Oostkant
666,R10 414,2023-06-25,22:00:00,26,14,12,FMN 19 Binnensingel Oostkant
666,R10 414,2023-06-25,23:00:00,9,6,3,FMN 19 Binnensingel Oostkant
666,R10 414,2023-06-26,00:00:00,0,0,0,FMN 19 Binnensingel Oostkant
666,R10 414,2023-06-26,01:00:00,2,1,1,FMN 19 Binnensingel Oostkant
666,R10 414,2023-06-26,02:00:00,1,1,0,FMN 19 Binnensingel Oostkant
666,R10 414,2023-06-26,03:00:00,3,0,3,FMN 19 Binnensingel Oostkant
666,R10 414,2023-06-26,04:00:00,6,3,3,FMN 19 Binnensingel Oostkant
666,R10 414,2023-06-26,05:00:00,17,3,14,FMN 19 Binnensingel Oostkant
666,R10 414,2023-06-26,06:00:00,27,9,18,FMN 19 Binnensingel Oostkant
666,R10 414,2023-06-26,07:00:00,69,30,39,FMN 19 Binnensingel Oostkant
666,R10 414,2023-06-26,08:00:00,89,35,54,FMN 19 Binnensingel Oostkant
666,R10 414,2023-06-26,09:00:00,41,15,26,FMN 19 Binnensingel Oostkant
666,R10 414,2023-06-26,10:00:00,29,12,17,FMN 19 Binnensingel Oostkant
666,R10 414,2023-06-26,11:00:00,24,5,19,FMN 19 Binnensingel Oostkant
666,R10 414,2023-06-26,12:00:00,35,15,20,FMN 19 Binnensingel Oostkant
666,R10 414,2023-06-26,13:00:00,45,18,27,FMN 19 Binnensingel Oostkant
666,R10 414,2023-06-26,14:00:00,43,22,21,FMN 19 Binnensingel Oostkant
666,R10 414,2023-06-26,15:00:00,68,42,26,FMN 19 Binnensingel Oostkant
666,R10 414,2023-06-26,16:00:00,94,47,47,FMN 19 Binnensingel Oostkant
666,R10 414,2023-06-26,17:00:00,99,47,52,FMN 19 Binnensingel Oostkant
666,R10 414,2023-06-26,18:00:00,89,39,50,FMN 19 Binnensingel Oostkant
666,R10 414,2023-06-26,19:00:00,41,19,22,FMN 19 Binnensingel Oostkant
666,R10 414,2023-06-26,20:00:00,36,16,20,FMN 19 Binnensingel Oostkant
666,R10 414,2023-06-26,21:00:00,22,11,11,FMN 19 Binnensingel Oostkant
666,R10 414,2023-06-26,22:00:00,38,20,18,FMN 19 Binnensingel Oostkant
666,R10 414,2023-06-26,23:00:00,12,6,6,FMN 19 Binnensingel Oostkant
666,R10 414,2023-06-27,00:00:00,0,0,0,FMN 19 Binnensingel Oostkant
666,R10 414,2023-06-27,01:00:00,2,2,0,FMN 19 Binnensingel Oostkant
666,R10 414,2023-06-27,02:00:00,2,1,1,FMN 19 Binnensingel Oostkant
666,R10 414,2023-06-27,03:00:00,7,2,5,FMN 19 Binnensingel Oostkant
666,R10 414,2023-06-27,04:00:00,10,1,9,FMN 19 Binnensingel Oostkant
666,R10 414,2023-06-27,05:00:00,15,2,13,FMN 19 Binnensingel Oostkant
666,R10 414,2023-06-27,06:00:00,36,15,21,FMN 19 Binnensingel Oostkant
666,R10 414,2023-06-27,07:00:00,85,36,49,FMN 19 Binnensingel Oostkant
666,R10 414,2023-06-27,08:00:00,103,32,71,FMN 19 Binnensingel Oostkant
666,R10 414,2023-06-27,09:00:00,46,17,29,FMN 19 Binnensingel Oostkant
666,R10 414,2023-06-27,10:00:00,27,10,17,FMN 19 Binnensingel Oostkant
666,R10 414,2023-06-27,11:00:00,26,18,8,FMN 19 Binnensingel Oostkant
666,R10 414,2023-06-27,12:00:00,42,8,34,FMN 19 Binnensingel Oostkant
666,R10 414,2023-06-27,13:00:00,56,21,35,FMN 19 Binnensingel Oostkant
666,R10 414,2023-06-27,14:00:00,33,21,12,FMN 19 Binnensingel Oostkant
666,R10 414,2023-06-27,15:00:00,53,32,21,FMN 19 Binnensingel Oostkant
666,R10 414,2023-06-27,16:00:00,110,49,61,FMN 19 Binnensingel Oostkant
666,R10 414,2023-06-27,17:00:00,112,49,63,FMN 19 Binnensingel Oostkant
666,R10 414,2023-06-27,18:00:00,93,29,64,FMN 19 Binnensingel Oostkant
666,R10 414,2023-06-27,19:00:00,47,21,26,FMN 19 Binnensingel Oostkant
666,R10 414,2023-06-27,20:00:00,35,19,16,FMN 19 Binnensingel Oostkant
666,R10 414,2023-06-27,21:00:00,31,17,14,FMN 19 Binnensingel Oostkant
666,R10 414,2023-06-27,22:00:00,30,13,17,FMN 19 Binnensingel Oostkant
666,R10 414,2023-06-27,23:00:00,14,4,10,FMN 19 Binnensingel Oostkant
666,R10 414,2023-06-28,00:00:00,0,0,0,FMN 19 Binnensingel Oostkant
666,R10 414,2023-06-28,01:00:00,2,1,1,FMN 19 Binnensingel Oostkant
666,R10 414,2023-06-28,02:00:00,1,1,0,FMN 19 Binnensingel Oostkant
666,R10 414,2023-06-28,03:00:00,3,1,2,FMN 19 Binnensingel Oostkant
666,R10 414,2023-06-28,04:00:00,8,3,5,FMN 19 Binnensingel Oostkant
666,R10 414,2023-06-28,05:00:00,23,3,20,FMN 19 Binnensingel Oostkant
666,R10 414,2023-06-28,06:00:00,29,12,17,FMN 19 Binnensingel Oostkant
666,R10 414,2023-06-28,07:00:00,61,23,38,FMN 19 Binnensingel Oostkant
666,R10 414,2023-06-28,08:00:00,81,32,49,FMN 19 Binnensingel Oostkant
666,R10 414,2023-06-28,09:00:00,33,14,19,FMN 19 Binnensingel Oostkant
666,R10 414,2023-06-28,10:00:00,36,13,23,FMN 19 Binnensingel Oostkant
666,R10 414,2023-06-28,11:00:00,23,9,14,FMN 19 Binnensingel Oostkant
666,R10 414,2023-06-28,12:00:00,68,32,36,FMN 19 Binnensingel Oostkant
666,R10 414,2023-06-28,13:00:00,53,27,26,FMN 19 Binnensingel Oostkant
666,R10 414,2023-06-28,14:00:00,30,18,12,FMN 19 Binnensingel Oostkant
666,R10 414,2023-06-28,15:00:00,43,25,18,FMN 19 Binnensingel Oostkant
666,R10 414,2023-06-28,16:00:00,92,48,44,FMN 19 Binnensingel Oostkant
666,R10 414,2023-06-28,17:00:00,95,42,53,FMN 19 Binnensingel Oostkant
666,R10 414,2023-06-28,18:00:00,77,37,40,FMN 19 Binnensingel Oostkant
666,R10 414,2023-06-28,19:00:00,53,22,31,FMN 19 Binnensingel Oostkant
666,R10 414,2023-06-28,20:00:00,28,15,13,FMN 19 Binnensingel Oostkant
666,R10 414,2023-06-28,21:00:00,38,21,17,FMN 19 Binnensingel Oostkant
666,R10 414,2023-06-28,22:00:00,29,13,16,FMN 19 Binnensingel Oostkant
666,R10 414,2023-06-28,23:00:00,17,5,12,FMN 19 Binnensingel Oostkant
666,R10 414,2023-06-29,00:00:00,0,0,0,FMN 19 Binnensingel Oostkant
666,R10 414,2023-06-29,01:00:00,5,5,0,FMN 19 Binnensingel Oostkant
666,R10 414,2023-06-29,02:00:00,1,0,1,FMN 19 Binnensingel Oostkant
666,R10 414,2023-06-29,03:00:00,4,2,2,FMN 19 Binnensingel Oostkant
666,R10 414,2023-06-29,04:00:00,12,2,10,FMN 19 Binnensingel Oostkant
666,R10 414,2023-06-29,05:00:00,14,2,12,FMN 19 Binnensingel Oostkant
666,R10 414,2023-06-29,06:00:00,35,12,23,FMN 19 Binnensingel Oostkant
666,R10 414,2023-06-29,07:00:00,74,30,44,FMN 19 Binnensingel Oostkant
666,R10 414,2023-06-29,08:00:00,102,36,66,FMN 19 Binnensingel Oostkant
666,R10 414,2023-06-29,09:00:00,46,21,25,FMN 19 Binnensingel Oostkant
666,R10 414,2023-06-29,10:00:00,35,10,25,FMN 19 Binnensingel Oostkant
666,R10 414,2023-06-29,11:00:00,27,5,22,FMN 19 Binnensingel Oostkant
666,R10 414,2023-06-29,12:00:00,42,15,27,FMN 19 Binnensingel Oostkant
666,R10 414,2023-06-29,13:00:00,43,20,23,FMN 19 Binnensingel Oostkant
666,R10 414,2023-06-29,14:00:00,28,15,13,FMN 19 Binnensingel Oostkant
666,R10 414,2023-06-29,15:00:00,58,34,24,FMN 19 Binnensingel Oostkant
666,R10 414,2023-06-29,16:00:00,93,46,47,FMN 19 Binnensingel Oostkant
666,R10 414,2023-06-29,17:00:00,93,45,48,FMN 19 Binnensingel Oostkant
666,R10 414,2023-06-29,18:00:00,87,43,44,FMN 19 Binnensingel Oostkant
666,R10 414,2023-06-29,19:00:00,49,18,31,FMN 19 Binnensingel Oostkant
666,R10 414,2023-06-29,20:00:00,39,18,21,FMN 19 Binnensingel Oostkant
666,R10 414,2023-06-29,21:00:00,28,16,12,FMN 19 Binnensingel Oostkant
666,R10 414,2023-06-29,22:00:00,35,16,19,FMN 19 Binnensingel Oostkant
666,R10 414,2023-06-29,23:00:00,14,7,7,FMN 19 Binnensingel Oostkant
666,R10 414,2023-06-30,00:00:00,0,0,0,FMN 19 Binnensingel Oostkant
666,R10 414,2023-06-30,01:00:00,7,4,3,FMN 19 Binnensingel Oostkant
666,R10 414,2023-06-30,02:00:00,2,1,1,FMN 19 Binnensingel Oostkant
666,R10 414,2023-06-30,03:00:00,3,2,1,FMN 19 Binnensingel Oostkant
666,R10 414,2023-06-30,04:00:00,15,3,12,FMN 19 Binnensingel Oostkant
666,R10 414,2023-06-30,05:00:00,19,2,17,FMN 19 Binnensingel Oostkant
666,R10 414,2023-06-30,06:00:00,21,10,11,FMN 19 Binnensingel Oostkant
666,R10 414,2023-06-30,07:00:00,57,22,35,FMN 19 Binnensingel Oostkant
666,R10 414,2023-06-30,08:00:00,77,26,51,FMN 19 Binnensingel Oostkant
666,R10 414,2023-06-30,09:00:00,37,13,24,FMN 19 Binnensingel Oostkant
666,R10 414,2023-06-30,10:00:00,37,11,26,FMN 19 Binnensingel Oostkant
666,R10 414,2023-06-30,11:00:00,37,14,23,FMN 19 Binnensingel Oostkant
666,R10 414,2023-06-30,12:00:00,55,24,31,FMN 19 Binnensingel Oostkant
666,R10 414,2023-06-30,13:00:00,57,30,27,FMN 19 Binnensingel Oostkant
666,R10 414,2023-06-30,14:00:00,35,20,15,FMN 19 Binnensingel Oostkant
666,R10 414,2023-06-30,15:00:00,66,34,32,FMN 19 Binnensingel Oostkant
666,R10 414,2023-06-30,16:00:00,90,52,38,FMN 19 Binnensingel Oostkant
666,R10 414,2023-06-30,17:00:00,73,35,38,FMN 19 Binnensingel Oostkant
666,R10 414,2023-06-30,18:00:00,67,32,35,FMN 19 Binnensingel Oostkant
666,R10 414,2023-06-30,19:00:00,44,25,19,FMN 19 Binnensingel Oostkant
666,R10 414,2023-06-30,20:00:00,24,10,14,FMN 19 Binnensingel Oostkant
666,R10 414,2023-06-30,21:00:00,28,15,13,FMN 19 Binnensingel Oostkant
666,R10 414,2023-06-30,22:00:00,34,20,14,FMN 19 Binnensingel Oostkant
666,R10 414,2023-06-30,23:00:00,22,12,10,FMN 19 Binnensingel Oostkant
666,R10 414,2023-07-01,00:00:00,0,0,0,FMN 19 Binnensingel Oostkant
666,R10 414,2023-07-01,01:00:00,12,8,4,FMN 19 Binnensingel Oostkant
666,R10 414,2023-07-01,02:00:00,12,8,4,FMN 19 Binnensingel Oostkant
666,R10 414,2023-07-01,03:00:00,8,8,0,FMN 19 Binnensingel Oostkant
666,R10 414,2023-07-01,04:00:00,13,5,8,FMN 19 Binnensingel Oostkant
666,R10 414,2023-07-01,05:00:00,13,8,5,FMN 19 Binnensingel Oostkant
666,R10 414,2023-07-01,06:00:00,7,2,5,FMN 19 Binnensingel Oostkant
666,R10 414,2023-07-01,07:00:00,11,3,8,FMN 19 Binnensingel Oostkant
666,R10 414,2023-07-01,08:00:00,24,14,10,FMN 19 Binnensingel Oostkant
666,R10 414,2023-07-01,09:00:00,30,19,11,FMN 19 Binnensingel Oostkant
666,R10 414,2023-07-01,10:00:00,36,28,8,FMN 19 Binnensingel Oostkant
666,R10 414,2023-07-01,11:00:00,34,23,11,FMN 19 Binnensingel Oostkant
666,R10 414,2023-07-01,12:00:00,42,27,15,FMN 19 Binnensingel Oostkant
666,R10 414,2023-07-01,13:00:00,46,27,19,FMN 19 Binnensingel Oostkant
666,R10 414,2023-07-01,14:00:00,45,26,19,FMN 19 Binnensingel Oostkant
666,R10 414,2023-07-01,15:00:00,44,26,18,FMN 19 Binnensingel Oostkant
666,R10 414,2023-07-01,16:00:00,35,23,12,FMN 19 Binnensingel Oostkant
666,R10 414,2023-07-01,17:00:00,46,31,15,FMN 19 Binnensingel Oostkant
666,R10 414,2023-07-01,18:00:00,45,23,22,FMN 19 Binnensingel Oostkant
666,R10 414,2023-07-01,19:00:00,43,27,16,FMN 19 Binnensingel Oostkant
666,R10 414,2023-07-01,20:00:00,33,26,7,FMN 19 Binnensingel Oostkant
666,R10 414,2023-07-01,21:00:00,19,15,4,FMN 19 Binnensingel Oostkant
666,R10 414,2023-07-01,22:00:00,24,14,10,FMN 19 Binnensingel Oostkant
666,R10 414,2023-07-01,23:00:00,26,14,12,FMN 19 Binnensingel Oostkant
666,R10 414,2023-07-02,00:00:00,0,0,0,FMN 19 Binnensingel Oostkant
666,R10 414,2023-07-02,01:00:00,21,17,4,FMN 19 Binnensingel Oostkant
666,R10 414,2023-07-02,02:00:00,11,6,5,FMN 19 Binnensingel Oostkant
666,R10 414,2023-07-02,03:00:00,10,5,5,FMN 19 Binnensingel Oostkant
666,R10 414,2023-07-02,04:00:00,8,6,2,FMN 19 Binnensingel Oostkant
666,R10 414,2023-07-02,05:00:00,12,5,7,FMN 19 Binnensingel Oostkant
666,R10 414,2023-07-02,06:00:00,16,10,6,FMN 19 Binnensingel Oostkant
666,R10 414,2023-07-02,07:00:00,13,9,4,FMN 19 Binnensingel Oostkant
666,R10 414,2023-07-02,08:00:00,24,10,14,FMN 19 Binnensingel Oostkant
666,R10 414,2023-07-02,09:00:00,30,17,13,FMN 19 Binnensingel Oostkant
666,R10 414,2023-07-02,10:00:00,54,39,15,FMN 19 Binnensingel Oostkant
666,R10 414,2023-07-02,11:00:00,48,32,16,FMN 19 Binnensingel Oostkant
666,R10 414,2023-07-02,12:00:00,74,59,15,FMN 19 Binnensingel Oostkant
666,R10 414,2023-07-02,13:00:00,73,49,24,FMN 19 Binnensingel Oostkant
666,R10 414,2023-07-02,14:00:00,78,49,29,FMN 19 Binnensingel Oostkant
666,R10 414,2023-07-02,15:00:00,65,46,19,FMN 19 Binnensingel Oostkant
666,R10 414,2023-07-02,16:00:00,84,52,32,FMN 19 Binnensingel Oostkant
666,R10 414,2023-07-02,17:00:00,84,52,32,FMN 19 Binnensingel Oostkant
666,R10 414,2023-07-02,18:00:00,80,56,24,FMN 19 Binnensingel Oostkant
666,R10 414,2023-07-02,19:00:00,52,32,20,FMN 19 Binnensingel Oostkant
666,R10 414,2023-07-02,20:00:00,53,36,17,FMN 19 Binnensingel Oostkant
666,R10 414,2023-07-02,21:00:00,32,17,15,FMN 19 Binnensingel Oostkant
666,R10 414,2023-07-02,22:00:00,43,26,17,FMN 19 Binnensingel Oostkant
666,R10 414,2023-07-02,23:00:00,18,12,6,FMN 19 Binnensingel Oostkant
666,R10 414,2023-07-03,00:00:00,8,5,3,FMN 19 Binnensingel Oostkant
666,R10 414,2023-07-03,01:00:00,2,1,1,FMN 19 Binnensingel Oostkant
666,R10 414,2023-07-03,02:00:00,3,2,1,FMN 19 Binnensingel Oostkant
666,R10 414,2023-07-03,03:00:00,5,0,5,FMN 19 Binnensingel Oostkant
666,R10 414,2023-07-03,04:00:00,5,3,2,FMN 19 Binnensingel Oostkant
666,R10 414,2023-07-03,05:00:00,25,9,16,FMN 19 Binnensingel Oostkant
666,R10 414,2023-07-03,06:00:00,44,25,19,FMN 19 Binnensingel Oostkant
666,R10 414,2023-07-03,07:00:00,83,42,41,FMN 19 Binnensingel Oostkant
666,R10 414,2023-07-03,08:00:00,120,61,59,FMN 19 Binnensingel Oostkant
666,R10 414,2023-07-03,09:00:00,50,26,24,FMN 19 Binnensingel Oostkant
666,R10 414,2023-07-03,10:00:00,44,25,19,FMN 19 Binnensingel Oostkant
666,R10 414,2023-07-03,11:00:00,43,27,16,FMN 19 Binnensingel Oostkant
666,R10 414,2023-07-03,12:00:00,59,38,21,FMN 19 Binnensingel Oostkant
666,R10 414,2023-07-03,13:00:00,51,32,19,FMN 19 Binnensingel Oostkant
666,R10 414,2023-07-03,14:00:00,54,38,16,FMN 19 Binnensingel Oostkant
666,R10 414,2023-07-03,15:00:00,97,67,30,FMN 19 Binnensingel Oostkant
666,R10 414,2023-07-03,16:00:00,145,93,52,FMN 19 Binnensingel Oostkant
666,R10 414,2023-07-03,17:00:00,145,97,48,FMN 19 Binnensingel Oostkant
666,R10 414,2023-07-03,18:00:00,122,69,53,FMN 19 Binnensingel Oostkant
666,R10 414,2023-07-03,19:00:00,50,30,20,FMN 19 Binnensingel Oostkant
666,R10 414,2023-07-03,20:00:00,47,29,18,FMN 19 Binnensingel Oostkant
666,R10 414,2023-07-03,21:00:00,28,22,6,FMN 19 Binnensingel Oostkant
666,R10 414,2023-07-03,22:00:00,38,25,13,FMN 19 Binnensingel Oostkant
666,R10 414,2023-07-03,23:00:00,16,7,9,FMN 19 Binnensingel Oostkant
666,R10 414,2023-07-04,00:00:00,0,0,0,FMN 19 Binnensingel Oostkant
666,R10 414,2023-07-04,01:00:00,2,2,0,FMN 19 Binnensingel Oostkant
666,R10 414,2023-07-04,02:00:00,3,0,3,FMN 19 Binnensingel Oostkant
666,R10 414,2023-07-04,03:00:00,1,0,1,FMN 19 Binnensingel Oostkant
666,R10 414,2023-07-04,04:00:00,8,4,4,FMN 19 Binnensingel Oostkant
666,R10 414,2023-07-04,05:00:00,25,8,17,FMN 19 Binnensingel Oostkant
666,R10 414,2023-07-04,06:00:00,37,15,22,FMN 19 Binnensingel Oostkant
666,R10 414,2023-07-04,07:00:00,108,58,50,FMN 19 Binnensingel Oostkant
666,R10 414,2023-07-04,08:00:00,140,75,65,FMN 19 Binnensingel Oostkant
666,R10 414,2023-07-04,09:00:00,47,24,23,FMN 19 Binnensingel Oostkant
666,R10 414,2023-07-04,10:00:00,29,14,15,FMN 19 Binnensingel Oostkant
666,R10 414,2023-07-04,11:00:00,35,24,11,FMN 19 Binnensingel Oostkant
666,R10 414,2023-07-04,12:00:00,65,35,30,FMN 19 Binnensingel Oostkant
666,R10 414,2023-07-04,13:00:00,66,35,31,FMN 19 Binnensingel Oostkant
666,R10 414,2023-07-04,14:00:00,42,28,14,FMN 19 Binnensingel Oostkant
666,R10 414,2023-07-04,15:00:00,89,57,32,FMN 19 Binnensingel Oostkant
666,R10 414,2023-07-04,16:00:00,141,87,54,FMN 19 Binnensingel Oostkant
666,R10 414,2023-07-04,17:00:00,146,80,66,FMN 19 Binnensingel Oostkant
666,R10 414,2023-07-04,18:00:00,122,70,52,FMN 19 Binnensingel Oostkant
666,R10 414,2023-07-04,19:00:00,54,30,24,FMN 19 Binnensingel Oostkant
666,R10 414,2023-07-04,20:00:00,46,27,19,FMN 19 Binnensingel Oostkant
666,R10 414,2023-07-04,21:00:00,46,34,12,FMN 19 Binnensingel Oostkant
666,R10 414,2023-07-04,22:00:00,36,18,18,FMN 19 Binnensingel Oostkant
666,R10 414,2023-07-04,23:00:00,15,7,8,FMN 19 Binnensingel Oostkant
666,R10 414,2023-07-05,00:00:00,0,0,0,FMN 19 Binnensingel Oostkant
666,R10 414,2023-07-05,01:00:00,7,3,4,FMN 19 Binnensingel Oostkant
666,R10 414,2023-07-05,02:00:00,2,1,1,FMN 19 Binnensingel Oostkant
666,R10 414,2023-07-05,03:00:00,6,4,2,FMN 19 Binnensingel Oostkant
666,R10 414,2023-07-05,04:00:00,13,3,10,FMN 19 Binnensingel Oostkant
666,R10 414,2023-07-05,05:00:00,17,4,13,FMN 19 Binnensingel Oostkant
666,R10 414,2023-07-05,06:00:00,34,16,18,FMN 19 Binnensingel Oostkant
666,R10 414,2023-07-05,07:00:00,70,36,34,FMN 19 Binnensingel Oostkant
666,R10 414,2023-07-05,08:00:00,102,47,55,FMN 19 Binnensingel Oostkant
666,R10 414,2023-07-05,09:00:00,38,18,20,FMN 19 Binnensingel Oostkant
666,R10 414,2023-07-05,10:00:00,41,20,21,FMN 19 Binnensingel Oostkant
666,R10 414,2023-07-05,11:00:00,29,13,16,FMN 19 Binnensingel Oostkant
666,R10 414,2023-07-05,12:00:00,81,46,35,FMN 19 Binnensingel Oostkant
666,R10 414,2023-07-05,13:00:00,63,38,25,FMN 19 Binnensingel Oostkant
666,R10 414,2023-07-05,14:00:00,47,23,24,FMN 19 Binnensingel Oostkant
666,R10 414,2023-07-05,15:00:00,71,46,25,FMN 19 Binnensingel Oostkant
666,R10 414,2023-07-05,16:00:00,114,68,46,FMN 19 Binnensingel Oostkant
666,R10 414,2023-07-05,17:00:00,120,74,46,FMN 19 Binnensingel Oostkant
666,R10 414,2023-07-05,18:00:00,89,41,48,FMN 19 Binnensingel Oostkant
666,R10 414,2023-07-05,19:00:00,63,39,24,FMN 19 Binnensingel Oostkant
666,R10 414,2023-07-05,20:00:00,38,24,14,FMN 19 Binnensingel Oostkant
666,R10 414,2023-07-05,21:00:00,46,32,14,FMN 19 Binnensingel Oostkant
666,R10 414,2023-07-05,22:00:00,36,24,12,FMN 19 Binnensingel Oostkant
666,R10 414,2023-07-05,23:00:00,13,6,7,FMN 19 Binnensingel Oostkant
666,R10 414,2023-07-06,00:00:00,5,3,2,FMN 19 Binnensingel Oostkant
666,R10 414,2023-07-06,01:00:00,8,5,3,FMN 19 Binnensingel Oostkant
666,R10 414,2023-07-06,02:00:00,3,1,2,FMN 19 Binnensingel Oostkant
666,R10 414,2023-07-06,03:00:00,5,1,4,FMN 19 Binnensingel Oostkant
666,R10 414,2023-07-06,04:00:00,13,6,7,FMN 19 Binnensingel Oostkant
666,R10 414,2023-07-06,05:00:00,15,6,9,FMN 19 Binnensingel Oostkant
666,R10 414,2023-07-06,06:00:00,38,16,22,FMN 19 Binnensingel Oostkant
666,R10 414,2023-07-06,07:00:00,96,43,53,FMN 19 Binnensingel Oostkant
666,R10 414,2023-07-06,08:00:00,127,58,69,FMN 19 Binnensingel Oostkant
666,R10 414,2023-07-06,09:00:00,57,25,32,FMN 19 Binnensingel Oostkant
666,R10 414,2023-07-06,10:00:00,40,14,26,FMN 19 Binnensingel Oostkant
666,R10 414,2023-07-06,11:00:00,47,22,25,FMN 19 Binnensingel Oostkant
666,R10 414,2023-07-06,12:00:00,70,38,32,FMN 19 Binnensingel Oostkant
666,R10 414,2023-07-06,13:00:00,56,29,27,FMN 19 Binnensingel Oostkant
666,R10 414,2023-07-06,14:00:00,60,35,25,FMN 19 Binnensingel Oostkant
666,R10 414,2023-07-06,15:00:00,84,52,32,FMN 19 Binnensingel Oostkant
666,R10 414,2023-07-06,16:00:00,135,81,54,FMN 19 Binnensingel Oostkant
666,R10 414,2023-07-06,17:00:00,163,91,72,FMN 19 Binnensingel Oostkant
666,R10 414,2023-07-06,18:00:00,108,54,54,FMN 19 Binnensingel Oostkant
666,R10 414,2023-07-06,19:00:00,75,36,39,FMN 19 Binnensingel Oostkant
666,R10 414,2023-07-06,20:00:00,55,26,29,FMN 19 Binnensingel Oostkant
666,R10 414,2023-07-06,21:00:00,40,22,18,FMN 19 Binnensingel Oostkant
666,R10 414,2023-07-06,22:00:00,43,27,16,FMN 19 Binnensingel Oostkant
666,R10 414,2023-07-06,23:00:00,20,13,7,FMN 19 Binnensingel Oostkant
666,R10 414,2023-07-07,00:00:00,15,10,5,FMN 19 Binnensingel Oostkant
666,R10 414,2023-07-07,01:00:00,7,3,4,FMN 19 Binnensingel Oostkant
666,R10 414,2023-07-07,02:00:00,5,3,2,FMN 19 Binnensingel Oostkant
666,R10 414,2023-07-07,03:00:00,4,3,1,FMN 19 Binnensingel Oostkant
666,R10 414,2023-07-07,04:00:00,19,8,11,FMN 19 Binnensingel Oostkant
666,R10 414,2023-07-07,05:00:00,28,10,18,FMN 19 Binnensingel Oostkant
666,R10 414,2023-07-07,06:00:00,41,27,14,FMN 19 Binnensingel Oostkant
666,R10 414,2023-07-07,07:00:00,69,34,35,FMN 19 Binnensingel Oostkant
666,R10 414,2023-07-07,08:00:00,104,56,48,FMN 19 Binnensingel Oostkant
666,R10 414,2023-07-07,09:00:00,41,24,17,FMN 19 Binnensingel Oostkant
666,R10 414,2023-07-07,10:00:00,37,17,20,FMN 19 Binnensingel Oostkant
666,R10 414,2023-07-07,11:00:00,45,21,24,FMN 19 Binnensingel Oostkant
666,R10 414,2023-07-07,12:00:00,60,31,29,FMN 19 Binnensingel Oostkant
666,R10 414,2023-07-07,13:00:00,61,39,22,FMN 19 Binnensingel Oostkant
666,R10 414,2023-07-07,14:00:00,55,38,17,FMN 19 Binnensingel Oostkant
666,R10 414,2023-07-07,15:00:00,83,59,24,FMN 19 Binnensingel Oostkant
666,R10 414,2023-07-07,16:00:00,108,70,38,FMN 19 Binnensingel Oostkant
666,R10 414,2023-07-07,17:00:00,113,66,47,FMN 19 Binnensingel Oostkant
666,R10 414,2023-07-07,18:00:00,86,46,40,FMN 19 Binnensingel Oostkant
666,R10 414,2023-07-07,19:00:00,66,37,29,FMN 19 Binnensingel Oostkant
666,R10 414,2023-07-07,20:00:00,41,20,21,FMN 19 Binnensingel Oostkant
666,R10 414,2023-07-07,21:00:00,33,21,12,FMN 19 Binnensingel Oostkant
666,R10 414,2023-07-07,22:00:00,29,15,14,FMN 19 Binnensingel Oostkant
666,R10 414,2023-07-07,23:00:00,36,22,14,FMN 19 Binnensingel Oostkant
666,R10 414,2023-07-08,00:00:00,30,18,12,FMN 19 Binnensingel Oostkant
666,R10 414,2023-07-08,01:00:00,15,8,7,FMN 19 Binnensingel Oostkant
666,R10 414,2023-07-08,02:00:00,12,7,5,FMN 19 Binnensingel Oostkant
666,R10 414,2023-07-08,03:00:00,9,5,4,FMN 19 Binnensingel Oostkant
666,R10 414,2023-07-08,04:00:00,15,4,11,FMN 19 Binnensingel Oostkant
666,R10 414,2023-07-08,05:00:00,11,4,7,FMN 19 Binnensingel Oostkant
666,R10 414,2023-07-08,06:00:00,18,10,8,FMN 19 Binnensingel Oostkant
666,R10 414,2023-07-08,07:00:00,18,12,6,FMN 19 Binnensingel Oostkant
666,R10 414,2023-07-08,08:00:00,36,21,15,FMN 19 Binnensingel Oostkant
666,R10 414,2023-07-08,09:00:00,33,20,13,FMN 19 Binnensingel Oostkant
666,R10 414,2023-07-08,10:00:00,47,31,16,FMN 19 Binnensingel Oostkant
666,R10 414,2023-07-08,11:00:00,51,38,13,FMN 19 Binnensingel Oostkant
666,R10 414,2023-07-08,12:00:00,49,35,14,FMN 19 Binnensingel Oostkant
666,R10 414,2023-07-08,13:00:00,63,43,20,FMN 19 Binnensingel Oostkant
666,R10 414,2023-07-08,14:00:00,64,45,19,FMN 19 Binnensingel Oostkant
666,R10 414,2023-07-08,15:00:00,65,44,21,FMN 19 Binnensingel Oostkant
666,R10 414,2023-07-08,16:00:00,52,33,19,FMN 19 Binnensingel Oostkant
666,R10 414,2023-07-08,17:00:00,62,43,19,FMN 19 Binnensingel Oostkant
666,R10 414,2023-07-08,18:00:00,74,48,26,FMN 19 Binnensingel Oostkant
666,R10 414,2023-07-08,19:00:00,58,30,28,FMN 19 Binnensingel Oostkant
666,R10 414,2023-07-08,20:00:00,44,30,14,FMN 19 Binnensingel Oostkant
666,R10 414,2023-07-08,21:00:00,43,32,11,FMN 19 Binnensingel Oostkant
666,R10 414,2023-07-08,22:00:00,41,31,10,FMN 19 Binnensingel Oostkant
666,R10 414,2023-07-08,23:00:00,27,16,11,FMN 19 Binnensingel Oostkant
666,R10 414,2023-07-09,00:00:00,39,28,11,FMN 19 Binnensingel Oostkant
666,R10 414,2023-07-09,01:00:00,22,9,13,FMN 19 Binnensingel Oostkant
666,R10 414,2023-07-09,02:00:00,11,8,3,FMN 19 Binnensingel Oostkant
666,R10 414,2023-07-09,03:00:00,9,6,3,FMN 19 Binnensingel Oostkant
666,R10 414,2023-07-09,04:00:00,8,3,5,FMN 19 Binnensingel Oostkant
666,R10 414,2023-07-09,05:00:00,12,5,7,FMN 19 Binnensingel Oostkant
666,R10 414,2023-07-09,06:00:00,8,5,3,FMN 19 Binnensingel Oostkant
666,R10 414,2023-07-09,07:00:00,16,10,6,FMN 19 Binnensingel Oostkant
666,R10 414,2023-07-09,08:00:00,23,14,9,FMN 19 Binnensingel Oostkant
666,R10 414,2023-07-09,09:00:00,35,19,16,FMN 19 Binnensingel Oostkant
666,R10 414,2023-07-09,10:00:00,53,38,15,FMN 19 Binnensingel Oostkant
666,R10 414,2023-07-09,11:00:00,33,22,11,FMN 19 Binnensingel Oostkant
666,R10 414,2023-07-09,12:00:00,62,46,16,FMN 19 Binnensingel Oostkant
666,R10 414,2023-07-09,13:00:00,45,33,12,FMN 19 Binnensingel Oostkant
666,R10 414,2023-07-09,14:00:00,76,47,29,FMN 19 Binnensingel Oostkant
666,R10 414,2023-07-09,15:00:00,65,45,20,FMN 19 Binnensingel Oostkant
666,R10 414,2023-07-09,16:00:00,56,34,22,FMN 19 Binnensingel Oostkant
666,R10 414,2023-07-09,17:00:00,70,45,25,FMN 19 Binnensingel Oostkant
666,R10 414,2023-07-09,18:00:00,53,38,15,FMN 19 Binnensingel Oostkant
666,R10 414,2023-07-09,19:00:00,47,32,15,FMN 19 Binnensingel Oostkant
666,R10 414,2023-07-09,20:00:00,40,22,18,FMN 19 Binnensingel Oostkant
666,R10 414,2023-07-09,21:00:00,42,27,15,FMN 19 Binnensingel Oostkant
666,R10 414,2023-07-09,22:00:00,31,21,10,FMN 19 Binnensingel Oostkant
666,R10 414,2023-07-09,23:00:00,8,4,4,FMN 19 Binnensingel Oostkant
666,R10 414,2023-07-10,00:00:00,0,0,0,FMN 19 Binnensingel Oostkant
666,R10 414,2023-07-10,01:00:00,9,6,3,FMN 19 Binnensingel Oostkant
666,R10 414,2023-07-10,02:00:00,3,1,2,FMN 19 Binnensingel Oostkant
666,R10 414,2023-07-10,03:00:00,5,2,3,FMN 19 Binnensingel Oostkant
666,R10 414,2023-07-10,04:00:00,14,5,9,FMN 19 Binnensingel Oostkant
666,R10 414,2023-07-10,05:00:00,24,7,17,FMN 19 Binnensingel Oostkant
666,R10 414,2023-07-10,06:00:00,37,18,19,FMN 19 Binnensingel Oostkant
666,R10 414,2023-07-10,07:00:00,81,43,38,FMN 19 Binnensingel Oostkant
666,R10 414,2023-07-10,08:00:00,114,59,55,FMN 19 Binnensingel Oostkant
666,R10 414,2023-07-10,09:00:00,54,23,31,FMN 19 Binnensingel Oostkant
666,R10 414,2023-07-10,10:00:00,33,18,15,FMN 19 Binnensingel Oostkant
666,R10 414,2023-07-10,11:00:00,34,18,16,FMN 19 Binnensingel Oostkant
666,R10 414,2023-07-10,12:00:00,63,37,26,FMN 19 Binnensingel Oostkant
666,R10 414,2023-07-10,13:00:00,55,32,23,FMN 19 Binnensingel Oostkant
666,R10 414,2023-07-10,14:00:00,51,32,19,FMN 19 Binnensingel Oostkant
666,R10 414,2023-07-10,15:00:00,86,60,26,FMN 19 Binnensingel Oostkant
666,R10 414,2023-07-10,16:00:00,140,89,51,FMN 19 Binnensingel Oostkant
666,R10 414,2023-07-10,17:00:00,133,77,56,FMN 19 Binnensingel Oostkant
666,R10 414,2023-07-10,18:00:00,113,65,48,FMN 19 Binnensingel Oostkant
666,R10 414,2023-07-10,19:00:00,46,32,14,FMN 19 Binnensingel Oostkant
666,R10 414,2023-07-10,20:00:00,48,28,20,FMN 19 Binnensingel Oostkant
666,R10 414,2023-07-10,21:00:00,40,29,11,FMN 19 Binnensingel Oostkant
666,R10 414,2023-07-10,22:00:00,36,24,12,FMN 19 Binnensingel Oostkant
666,R10 414,2023-07-10,23:00:00,12,5,7,FMN 19 Binnensingel Oostkant
666,R10 414,2023-07-11,00:00:00,0,0,0,FMN 19 Binnensingel Oostkant
666,R10 414,2023-07-11,01:00:00,3,1,2,FMN 19 Binnensingel Oostkant
666,R10 414,2023-07-11,02:00:00,2,0,2,FMN 19 Binnensingel Oostkant
666,R10 414,2023-07-11,03:00:00,1,0,1,FMN 19 Binnensingel Oostkant
666,R10 414,2023-07-11,04:00:00,12,4,8,FMN 19 Binnensingel Oostkant
666,R10 414,2023-07-11,05:00:00,11,2,9,FMN 19 Binnensingel Oostkant
666,R10 414,2023-07-11,06:00:00,30,14,16,FMN 19 Binnensingel Oostkant
666,R10 414,2023-07-11,07:00:00,107,56,51,FMN 19 Binnensingel Oostkant
666,R10 414,2023-07-11,08:00:00,141,68,73,FMN 19 Binnensingel Oostkant
666,R10 414,2023-07-11,09:00:00,63,32,31,FMN 19 Binnensingel Oostkant
666,R10 414,2023-07-11,10:00:00,32,14,18,FMN 19 Binnensingel Oostkant
666,R10 414,2023-07-11,11:00:00,30,19,11,FMN 19 Binnensingel Oostkant
666,R10 414,2023-07-11,12:00:00,54,24,30,FMN 19 Binnensingel Oostkant
666,R10 414,2023-07-11,13:00:00,54,26,28,FMN 19 Binnensingel Oostkant
666,R10 414,2023-07-11,14:00:00,54,31,23,FMN 19 Binnensingel Oostkant
666,R10 414,2023-07-11,15:00:00,72,52,20,FMN 19 Binnensingel Oostkant
666,R10 414,2023-07-11,16:00:00,139,84,55,FMN 19 Binnensingel Oostkant
666,R10 414,2023-07-11,17:00:00,145,78,67,FMN 19 Binnensingel Oostkant
666,R10 414,2023-07-11,18:00:00,121,66,55,FMN 19 Binnensingel Oostkant
666,R10 414,2023-07-11,19:00:00,55,30,25,FMN 19 Binnensingel Oostkant
666,R10 414,2023-07-11,20:00:00,45,27,18,FMN 19 Binnensingel Oostkant
666,R10 414,2023-07-11,21:00:00,43,28,15,FMN 19 Binnensingel Oostkant
666,R10 414,2023-07-11,22:00:00,41,24,17,FMN 19 Binnensingel Oostkant
666,R10 414,2023-07-11,23:00:00,18,7,11,FMN 19 Binnensingel Oostkant
666,R10 414,2023-07-12,00:00:00,5,1,4,FMN 19 Binnensingel Oostkant
666,R10 414,2023-07-12,01:00:00,1,0,1,FMN 19 Binnensingel Oostkant
666,R10 414,2023-07-12,02:00:00,0,0,0,FMN 19 Binnensingel Oostkant
666,R10 414,2023-07-12,03:00:00,4,1,3,FMN 19 Binnensingel Oostkant
666,R10 414,2023-07-12,04:00:00,11,4,7,FMN 19 Binnensingel Oostkant
666,R10 414,2023-07-12,05:00:00,15,3,12,FMN 19 Binnensingel Oostkant
666,R10 414,2023-07-12,06:00:00,40,16,24,FMN 19 Binnensingel Oostkant
666,R10 414,2023-07-12,07:00:00,83,45,38,FMN 19 Binnensingel Oostkant
666,R10 414,2023-07-12,08:00:00,103,53,50,FMN 19 Binnensingel Oostkant
666,R10 414,2023-07-12,09:00:00,50,26,24,FMN 19 Binnensingel Oostkant
666,R10 414,2023-07-12,10:00:00,38,22,16,FMN 19 Binnensingel Oostkant
666,R10 414,2023-07-12,11:00:00,51,27,24,FMN 19 Binnensingel Oostkant
666,R10 414,2023-07-12,12:00:00,63,39,24,FMN 19 Binnensingel Oostkant
666,R10 414,2023-07-12,13:00:00,70,43,27,FMN 19 Binnensingel Oostkant
666,R10 414,2023-07-12,14:00:00,69,41,28,FMN 19 Binnensingel Oostkant
666,R10 414,2023-07-12,15:00:00,76,50,26,FMN 19 Binnensingel Oostkant
666,R10 414,2023-07-12,16:00:00,123,76,47,FMN 19 Binnensingel Oostkant
666,R10 414,2023-07-12,17:00:00,146,86,60,FMN 19 Binnensingel Oostkant
666,R10 414,2023-07-12,18:00:00,105,60,45,FMN 19 Binnensingel Oostkant
666,R10 414,2023-07-12,19:00:00,61,33,28,FMN 19 Binnensingel Oostkant
666,R10 414,2023-07-12,20:00:00,60,33,27,FMN 19 Binnensingel Oostkant
666,R10 414,2023-07-12,21:00:00,40,19,21,FMN 19 Binnensingel Oostkant
666,R10 414,2023-07-12,22:00:00,37,27,10,FMN 19 Binnensingel Oostkant
666,R10 414,2023-07-12,23:00:00,24,17,7,FMN 19 Binnensingel Oostkant
666,R10 414,2023-07-13,00:00:00,5,3,2,FMN 19 Binnensingel Oostkant
666,R10 414,2023-07-13,01:00:00,4,2,2,FMN 19 Binnensingel Oostkant
666,R10 414,2023-07-13,02:00:00,4,2,2,FMN 19 Binnensingel Oostkant
666,R10 414,2023-07-13,03:00:00,5,1,4,FMN 19 Binnensingel Oostkant
666,R10 414,2023-07-13,04:00:00,10,3,7,FMN 19 Binnensingel Oostkant
666,R10 414,2023-07-13,05:00:00,20,6,14,FMN 19 Binnensingel Oostkant
666,R10 414,2023-07-13,06:00:00,42,15,27,FMN 19 Binnensingel Oostkant
666,R10 414,2023-07-13,07:00:00,95,45,50,FMN 19 Binnensingel Oostkant
666,R10 414,2023-07-13,08:00:00,120,58,62,FMN 19 Binnensingel Oostkant
666,R10 414,2023-07-13,09:00:00,50,24,26,FMN 19 Binnensingel Oostkant
666,R10 414,2023-07-13,10:00:00,42,23,19,FMN 19 Binnensingel Oostkant
666,R10 414,2023-07-13,11:00:00,33,21,12,FMN 19 Binnensingel Oostkant
666,R10 414,2023-07-13,12:00:00,60,35,25,FMN 19 Binnensingel Oostkant
666,R10 414,2023-07-13,13:00:00,57,29,28,FMN 19 Binnensingel Oostkant
666,R10 414,2023-07-13,14:00:00,50,33,17,FMN 19 Binnensingel Oostkant
666,R10 414,2023-07-13,15:00:00,70,49,21,FMN 19 Binnensingel Oostkant
666,R10 414,2023-07-13,16:00:00,125,75,50,FMN 19 Binnensingel Oostkant
666,R10 414,2023-07-13,17:00:00,124,76,48,FMN 19 Binnensingel Oostkant
666,R10 414,2023-07-13,18:00:00,112,58,54,FMN 19 Binnensingel Oostkant
666,R10 414,2023-07-13,19:00:00,70,40,30,FMN 19 Binnensingel Oostkant
666,R10 414,2023-07-13,20:00:00,48,21,27,FMN 19 Binnensingel Oostkant
666,R10 414,2023-07-13,21:00:00,41,27,14,FMN 19 Binnensingel Oostkant
666,R10 414,2023-07-13,22:00:00,46,32,14,FMN 19 Binnensingel Oostkant
666,R10 414,2023-07-13,23:00:00,30,18,12,FMN 19 Binnensingel Oostkant
666,R10 414,2023-07-14,00:00:00,13,6,7,FMN 19 Binnensingel Oostkant
666,R10 414,2023-07-14,01:00:00,9,4,5,FMN 19 Binnensingel Oostkant
666,R10 414,2023-07-14,02:00:00,2,2,0,FMN 19 Binnensingel Oostkant
666,R10 414,2023-07-14,03:00:00,0,0,0,FMN 19 Binnensingel Oostkant
666,R10 414,2023-07-14,04:00:00,15,8,7,FMN 19 Binnensingel Oostkant
666,R10 414,2023-07-14,05:00:00,21,8,13,FMN 19 Binnensingel Oostkant
666,R10 414,2023-07-14,06:00:00,35,18,17,FMN 19 Binnensingel Oostkant
666,R10 414,2023-07-14,07:00:00,73,37,36,FMN 19 Binnensingel Oostkant
666,R10 414,2023-07-14,08:00:00,101,59,42,FMN 19 Binnensingel Oostkant
666,R10 414,2023-07-14,09:00:00,52,23,29,FMN 19 Binnensingel Oostkant
666,R10 414,2023-07-14,10:00:00,40,23,17,FMN 19 Binnensingel Oostkant
666,R10 414,2023-07-14,11:00:00,44,28,16,FMN 19 Binnensingel Oostkant
666,R10 414,2023-07-14,12:00:00,58,39,19,FMN 19 Binnensingel Oostkant
666,R10 414,2023-07-14,13:00:00,54,27,27,FMN 19 Binnensingel Oostkant
666,R10 414,2023-07-14,14:00:00,63,41,22,FMN 19 Binnensingel Oostkant
666,R10 414,2023-07-14,15:00:00,88,59,29,FMN 19 Binnensingel Oostkant
666,R10 414,2023-07-14,16:00:00,125,84,41,FMN 19 Binnensingel Oostkant
666,R10 414,2023-07-14,17:00:00,122,73,49,FMN 19 Binnensingel Oostkant
666,R10 414,2023-07-14,18:00:00,96,54,42,FMN 19 Binnensingel Oostkant
666,R10 414,2023-07-14,19:00:00,59,37,22,FMN 19 Binnensingel Oostkant
666,R10 414,2023-07-14,20:00:00,50,32,18,FMN 19 Binnensingel Oostkant
666,R10 414,2023-07-14,21:00:00,37,26,11,FMN 19 Binnensingel Oostkant
666,R10 414,2023-07-14,22:00:00,38,29,9,FMN 19 Binnensingel Oostkant
666,R10 414,2023-07-14,23:00:00,35,18,17,FMN 19 Binnensingel Oostkant
666,R10 414,2023-07-15,00:00:00,31,17,14,FMN 19 Binnensingel Oostkant
666,R10 414,2023-07-15,01:00:00,18,10,8,FMN 19 Binnensingel Oostkant
666,R10 414,2023-07-15,02:00:00,13,9,4,FMN 19 Binnensingel Oostkant
666,R10 414,2023-07-15,03:00:00,11,7,4,FMN 19 Binnensingel Oostkant
666,R10 414,2023-07-15,04:00:00,17,13,4,FMN 19 Binnensingel Oostkant
666,R10 414,2023-07-15,05:00:00,9,2,7,FMN 19 Binnensingel Oostkant
666,R10 414,2023-07-15,06:00:00,19,10,9,FMN 19 Binnensingel Oostkant
666,R10 414,2023-07-15,07:00:00,14,10,4,FMN 19 Binnensingel Oostkant
666,R10 414,2023-07-15,08:00:00,24,15,9,FMN 19 Binnensingel Oostkant
666,R10 414,2023-07-15,09:00:00,41,31,10,FMN 19 Binnensingel Oostkant
666,R10 414,2023-07-15,10:00:00,43,34,9,FMN 19 Binnensingel Oostkant
666,R10 414,2023-07-15,11:00:00,51,36,15,FMN 19 Binnensingel Oostkant
666,R10 414,2023-07-15,12:00:00,60,40,20,FMN 19 Binnensingel Oostkant
666,R10 414,2023-07-15,13:00:00,55,42,13,FMN 19 Binnensingel Oostkant
666,R10 414,2023-07-15,14:00:00,72,50,22,FMN 19 Binnensingel Oostkant
666,R10 414,2023-07-15,15:00:00,64,40,24,FMN 19 Binnensingel Oostkant
666,R10 414,2023-07-15,16:00:00,62,43,19,FMN 19 Binnensingel Oostkant
666,R10 414,2023-07-15,17:00:00,69,53,16,FMN 19 Binnensingel Oostkant
666,R10 414,2023-07-15,18:00:00,71,46,25,FMN 19 Binnensingel Oostkant
666,R10 414,2023-07-15,19:00:00,54,35,19,FMN 19 Binnensingel Oostkant
666,R10 414,2023-07-15,20:00:00,38,25,13,FMN 19 Binnensingel Oostkant
666,R10 414,2023-07-15,21:00:00,32,20,12,FMN 19 Binnensingel Oostkant
666,R10 414,2023-07-15,22:00:00,37,22,15,FMN 19 Binnensingel Oostkant
666,R10 414,2023-07-15,23:00:00,27,19,8,FMN 19 Binnensingel Oostkant
666,R10 414,2023-07-16,00:00:00,31,25,6,FMN 19 Binnensingel Oostkant
666,R10 414,2023-07-16,01:00:00,23,12,11,FMN 19 Binnensingel Oostkant
666,R10 414,2023-07-16,02:00:00,10,8,2,FMN 19 Binnensingel Oostkant
666,R10 414,2023-07-16,03:00:00,11,8,3,FMN 19 Binnensingel Oostkant
666,R10 414,2023-07-16,04:00:00,10,5,5,FMN 19 Binnensingel Oostkant
666,R10 414,2023-07-16,05:00:00,14,5,9,FMN 19 Binnensingel Oostkant
666,R10 414,2023-07-16,06:00:00,13,9,4,FMN 19 Binnensingel Oostkant
666,R10 414,2023-07-16,07:00:00,9,6,3,FMN 19 Binnensingel Oostkant
666,R10 414,2023-07-16,08:00:00,22,18,4,FMN 19 Binnensingel Oostkant
666,R10 414,2023-07-16,09:00:00,44,27,17,FMN 19 Binnensingel Oostkant
666,R10 414,2023-07-16,10:00:00,46,30,16,FMN 19 Binnensingel Oostkant
666,R10 414,2023-07-16,11:00:00,38,26,12,FMN 19 Binnensingel Oostkant
666,R10 414,2023-07-16,12:00:00,53,39,14,FMN 19 Binnensingel Oostkant
666,R10 414,2023-07-16,13:00:00,63,43,20,FMN 19 Binnensingel Oostkant
666,R10 414,2023-07-16,14:00:00,57,38,19,FMN 19 Binnensingel Oostkant
666,R10 414,2023-07-16,15:00:00,70,45,25,FMN 19 Binnensingel Oostkant
666,R10 414,2023-07-16,16:00:00,57,39,18,FMN 19 Binnensingel Oostkant
666,R10 414,2023-07-16,17:00:00,77,49,28,FMN 19 Binnensingel Oostkant
666,R10 414,2023-07-16,18:00:00,68,48,20,FMN 19 Binnensingel Oostkant
666,R10 414,2023-07-16,19:00:00,50,34,16,FMN 19 Binnensingel Oostkant
666,R10 414,2023-07-16,20:00:00,37,23,14,FMN 19 Binnensingel Oostkant
666,R10 414,2023-07-16,21:00:00,40,23,17,FMN 19 Binnensingel Oostkant
666,R10 414,2023-07-16,22:00:00,29,21,8,FMN 19 Binnensingel Oostkant
666,R10 414,2023-07-16,23:00:00,22,17,5,FMN 19 Binnensingel Oostkant
666,R10 414,2023-07-17,00:00:00,0,0,0,FMN 19 Binnensingel Oostkant
666,R10 414,2023-07-17,01:00:00,0,0,0,FMN 19 Binnensingel Oostkant
666,R10 414,2023-07-17,02:00:00,1,0,1,FMN 19 Binnensingel Oostkant
666,R10 414,2023-07-17,03:00:00,0,0,0,FMN 19 Binnensingel Oostkant
666,R10 414,2023-07-17,04:00:00,3,1,2,FMN 19 Binnensingel Oostkant
666,R10 414,2023-07-17,05:00:00,4,0,4,FMN 19 Binnensingel Oostkant
666,R10 414,2023-07-17,06:00:00,2,1,1,FMN 19 Binnensingel Oostkant
666,R10 414,2023-07-17,07:00:00,7,1,6,FMN 19 Binnensingel Oostkant
666,R10 414,2023-07-17,08:00:00,10,3,7,FMN 19 Binnensingel Oostkant
666,R10 414,2023-07-17,09:00:00,7,1,6,FMN 19 Binnensingel Oostkant
666,R10 414,2023-07-17,10:00:00,14,5,9,FMN 19 Binnensingel Oostkant
666,R10 414,2023-07-17,11:00:00,8,1,7,FMN 19 Binnensingel Oostkant
666,R10 414,2023-07-17,12:00:00,6,3,3,FMN 19 Binnensingel Oostkant
666,R10 414,2023-07-17,13:00:00,6,2,4,FMN 19 Binnensingel Oostkant
666,R10 414,2023-07-17,14:00:00,7,3,4,FMN 19 Binnensingel Oostkant
666,R10 414,2023-07-17,15:00:00,8,5,3,FMN 19 Binnensingel Oostkant
666,R10 414,2023-07-17,16:00:00,11,4,7,FMN 19 Binnensingel Oostkant
666,R10 414,2023-07-17,17:00:00,13,4,9,FMN 19 Binnensingel Oostkant
666,R10 414,2023-07-17,18:00:00,14,0,14,FMN 19 Binnensingel Oostkant
666,R10 414,2023-07-17,19:00:00,6,2,4,FMN 19 Binnensingel Oostkant
666,R10 414,2023-07-17,20:00:00,4,1,3,FMN 19 Binnensingel Oostkant
666,R10 414,2023-07-17,21:00:00,9,3,6,FMN 19 Binnensingel Oostkant
666,R10 414,2023-07-17,22:00:00,9,3,6,FMN 19 Binnensingel Oostkant
666,R10 414,2023-07-17,23:00:00,1,1,0,FMN 19 Binnensingel Oostkant
666,R10 414,2023-07-18,00:00:00,6,1,5,FMN 19 Binnensingel Oostkant
666,R10 414,2023-07-18,01:00:00,0,0,0,FMN 19 Binnensingel Oostkant
666,R10 414,2023-07-18,02:00:00,0,0,0,FMN 19 Binnensingel Oostkant
666,R10 414,2023-07-18,03:00:00,0,0,0,FMN 19 Binnensingel Oostkant
666,R10 414,2023-07-18,04:00:00,0,0,0,FMN 19 Binnensingel Oostkant
666,R10 414,2023-07-18,05:00:00,3,0,3,FMN 19 Binnensingel Oostkant
666,R10 414,2023-07-18,06:00:00,3,1,2,FMN 19 Binnensingel Oostkant
666,R10 414,2023-07-18,07:00:00,9,1,8,FMN 19 Binnensingel Oostkant
666,R10 414,2023-07-18,08:00:00,15,4,11,FMN 19 Binnensingel Oostkant
666,R10 414,2023-07-18,09:00:00,4,1,3,FMN 19 Binnensingel Oostkant
666,R10 414,2023-07-18,10:00:00,5,1,4,FMN 19 Binnensingel Oostkant
666,R10 414,2023-07-18,11:00:00,10,4,6,FMN 19 Binnensingel Oostkant
666,R10 414,2023-07-18,12:00:00,8,3,5,FMN 19 Binnensingel Oostkant
666,R10 414,2023-07-18,13:00:00,17,6,11,FMN 19 Binnensingel Oostkant
666,R10 414,2023-07-18,14:00:00,4,2,2,FMN 19 Binnensingel Oostkant
666,R10 414,2023-07-18,15:00:00,4,1,3,FMN 19 Binnensingel Oostkant
666,R10 414,2023-07-18,16:00:00,15,3,12,FMN 19 Binnensingel Oostkant
666,R10 414,2023-07-18,17:00:00,11,1,10,FMN 19 Binnensingel Oostkant
666,R10 414,2023-07-18,18:00:00,14,3,11,FMN 19 Binnensingel Oostkant
666,R10 414,2023-07-18,19:00:00,13,2,11,FMN 19 Binnensingel Oostkant
666,R10 414,2023-07-18,20:00:00,7,2,5,FMN 19 Binnensingel Oostkant
666,R10 414,2023-07-18,21:00:00,5,1,4,FMN 19 Binnensingel Oostkant
666,R10 414,2023-07-18,22:00:00,14,5,9,FMN 19 Binnensingel Oostkant
666,R10 414,2023-07-18,23:00:00,0,0,0,FMN 19 Binnensingel Oostkant
666,R10 414,2023-07-19,00:00:00,3,1,2,FMN 19 Binnensingel Oostkant
666,R10 414,2023-07-19,01:00:00,2,0,2,FMN 19 Binnensingel Oostkant
666,R10 414,2023-07-19,02:00:00,0,0,0,FMN 19 Binnensingel Oostkant
666,R10 414,2023-07-19,03:00:00,0,0,0,FMN 19 Binnensingel Oostkant
666,R10 414,2023-07-19,04:00:00,3,1,2,FMN 19 Binnensingel Oostkant
666,R10 414,2023-07-19,05:00:00,1,0,1,FMN 19 Binnensingel Oostkant
666,R10 414,2023-07-19,06:00:00,5,3,2,FMN 19 Binnensingel Oostkant
666,R10 414,2023-07-19,07:00:00,6,1,5,FMN 19 Binnensingel Oostkant
666,R10 414,2023-07-19,08:00:00,11,1,10,FMN 19 Binnensingel Oostkant
666,R10 414,2023-07-19,09:00:00,7,2,5,FMN 19 Binnensingel Oostkant
666,R10 414,2023-07-19,10:00:00,13,2,11,FMN 19 Binnensingel Oostkant
666,R10 414,2023-07-19,11:00:00,8,0,8,FMN 19 Binnensingel Oostkant
666,R10 414,2023-07-19,12:00:00,14,6,8,FMN 19 Binnensingel Oostkant
666,R10 414,2023-07-19,13:00:00,6,2,4,FMN 19 Binnensingel Oostkant
666,R10 414,2023-07-19,14:00:00,6,2,4,FMN 19 Binnensingel Oostkant
666,R10 414,2023-07-19,15:00:00,9,3,6,FMN 19 Binnensingel Oostkant
666,R10 414,2023-07-19,16:00:00,12,3,9,FMN 19 Binnensingel Oostkant
666,R10 414,2023-07-19,17:00:00,9,1,8,FMN 19 Binnensingel Oostkant
666,R10 414,2023-07-19,18:00:00,9,0,9,FMN 19 Binnensingel Oostkant
666,R10 414,2023-07-19,19:00:00,9,2,7,FMN 19 Binnensingel Oostkant
666,R10 414,2023-07-19,20:00:00,6,4,2,FMN 19 Binnensingel Oostkant
666,R10 414,2023-07-19,21:00:00,9,4,5,FMN 19 Binnensingel Oostkant
666,R10 414,2023-07-19,22:00:00,9,4,5,FMN 19 Binnensingel Oostkant
666,R10 414,2023-07-19,23:00:00,7,0,7,FMN 19 Binnensingel Oostkant
666,R10 414,2023-07-20,00:00:00,4,1,3,FMN 19 Binnensingel Oostkant
666,R10 414,2023-07-20,01:00:00,1,0,1,FMN 19 Binnensingel Oostkant
666,R10 414,2023-07-20,02:00:00,1,0,1,FMN 19 Binnensingel Oostkant
666,R10 414,2023-07-20,03:00:00,1,0,1,FMN 19 Binnensingel Oostkant
666,R10 414,2023-07-20,04:00:00,1,0,1,FMN 19 Binnensingel Oostkant
666,R10 414,2023-07-20,05:00:00,3,1,2,FMN 19 Binnensingel Oostkant
666,R10 414,2023-07-20,06:00:00,3,2,1,FMN 19 Binnensingel Oostkant
666,R10 414,2023-07-20,07:00:00,11,3,8,FMN 19 Binnensingel Oostkant
666,R10 414,2023-07-20,08:00:00,8,1,7,FMN 19 Binnensingel Oostkant
666,R10 414,2023-07-20,09:00:00,9,0,9,FMN 19 Binnensingel Oostkant
666,R10 414,2023-07-20,10:00:00,4,1,3,FMN 19 Binnensingel Oostkant
666,R10 414,2023-07-20,11:00:00,3,2,1,FMN 19 Binnensingel Oostkant
666,R10 414,2023-07-20,12:00:00,12,1,11,FMN 19 Binnensingel Oostkant
666,R10 414,2023-07-20,13:00:00,9,2,7,FMN 19 Binnensingel Oostkant
666,R10 414,2023-07-20,14:00:00,6,2,4,FMN 19 Binnensingel Oostkant
666,R10 414,2023-07-20,15:00:00,8,5,3,FMN 19 Binnensingel Oostkant
666,R10 414,2023-07-20,16:00:00,14,3,11,FMN 19 Binnensingel Oostkant
666,R10 414,2023-07-20,17:00:00,17,3,14,FMN 19 Binnensingel Oostkant
666,R10 414,2023-07-20,18:00:00,5,1,4,FMN 19 Binnensingel Oostkant
666,R10 414,2023-07-20,19:00:00,2,0,2,FMN 19 Binnensingel Oostkant
666,R10 414,2023-07-20,20:00:00,8,2,6,FMN 19 Binnensingel Oostkant
666,R10 414,2023-07-20,21:00:00,6,0,6,FMN 19 Binnensingel Oostkant
666,R10 414,2023-07-20,22:00:00,6,4,2,FMN 19 Binnensingel Oostkant
666,R10 414,2023-07-20,23:00:00,4,2,2,FMN 19 Binnensingel Oostkant
666,R10 414,2023-07-21,00:00:00,2,0,2,FMN 19 Binnensingel Oostkant
666,R10 414,2023-07-21,01:00:00,1,1,0,FMN 19 Binnensingel Oostkant
666,R10 414,2023-07-21,02:00:00,3,1,2,FMN 19 Binnensingel Oostkant
666,R10 414,2023-07-21,03:00:00,0,0,0,FMN 19 Binnensingel Oostkant
666,R10 414,2023-07-21,04:00:00,3,0,3,FMN 19 Binnensingel Oostkant
666,R10 414,2023-07-21,05:00:00,1,1,0,FMN 19 Binnensingel Oostkant
666,R10 414,2023-07-21,06:00:00,2,0,2,FMN 19 Binnensingel Oostkant
666,R10 414,2023-07-21,07:00:00,0,0,0,FMN 19 Binnensingel Oostkant
666,R10 414,2023-07-21,08:00:00,4,1,3,FMN 19 Binnensingel Oostkant
666,R10 414,2023-07-21,09:00:00,2,0,2,FMN 19 Binnensingel Oostkant
666,R10 414,2023-07-21,10:00:00,10,5,5,FMN 19 Binnensingel Oostkant
666,R10 414,2023-07-21,11:00:00,6,2,4,FMN 19 Binnensingel Oostkant
666,R10 414,2023-07-21,12:00:00,5,0,5,FMN 19 Binnensingel Oostkant
666,R10 414,2023-07-21,13:00:00,2,1,1,FMN 19 Binnensingel Oostkant
666,R10 414,2023-07-21,14:00:00,6,2,4,FMN 19 Binnensingel Oostkant
666,R10 414,2023-07-21,15:00:00,7,4,3,FMN 19 Binnensingel Oostkant
666,R10 414,2023-07-21,16:00:00,3,1,2,FMN 19 Binnensingel Oostkant
666,R10 414,2023-07-21,17:00:00,11,2,9,FMN 19 Binnensingel Oostkant
666,R10 414,2023-07-21,18:00:00,5,0,5,FMN 19 Binnensingel Oostkant
666,R10 414,2023-07-21,19:00:00,6,0,6,FMN 19 Binnensingel Oostkant
666,R10 414,2023-07-21,20:00:00,11,5,6,FMN 19 Binnensingel Oostkant
666,R10 414,2023-07-21,21:00:00,11,2,9,FMN 19 Binnensingel Oostkant
666,R10 414,2023-07-21,22:00:00,6,2,4,FMN 19 Binnensingel Oostkant
666,R10 414,2023-07-21,23:00:00,5,2,3,FMN 19 Binnensingel Oostkant
666,R10 414,2023-07-22,00:00:00,0,0,0,FMN 19 Binnensingel Oostkant
666,R10 414,2023-07-22,01:00:00,3,0,3,FMN 19 Binnensingel Oostkant
666,R10 414,2023-07-22,02:00:00,0,0,0,FMN 19 Binnensingel Oostkant
666,R10 414,2023-07-22,03:00:00,0,0,0,FMN 19 Binnensingel Oostkant
666,R10 414,2023-07-22,04:00:00,2,0,2,FMN 19 Binnensingel Oostkant
666,R10 414,2023-07-22,05:00:00,2,1,1,FMN 19 Binnensingel Oostkant
666,R10 414,2023-07-22,06:00:00,4,1,3,FMN 19 Binnensingel Oostkant
666,R10 414,2023-07-22,07:00:00,2,1,1,FMN 19 Binnensingel Oostkant
666,R10 414,2023-07-22,08:00:00,2,1,1,FMN 19 Binnensingel Oostkant
666,R10 414,2023-07-22,09:00:00,1,0,1,FMN 19 Binnensingel Oostkant
666,R10 414,2023-07-22,10:00:00,6,2,4,FMN 19 Binnensingel Oostkant
666,R10 414,2023-07-22,11:00:00,13,3,10,FMN 19 Binnensingel Oostkant
666,R10 414,2023-07-22,12:00:00,6,3,3,FMN 19 Binnensingel Oostkant
666,R10 414,2023-07-22,13:00:00,6,3,3,FMN 19 Binnensingel Oostkant
666,R10 414,2023-07-22,14:00:00,9,4,5,FMN 19 Binnensingel Oostkant
666,R10 414,2023-07-22,15:00:00,11,3,8,FMN 19 Binnensingel Oostkant
666,R10 414,2023-07-22,16:00:00,6,2,4,FMN 19 Binnensingel Oostkant
666,R10 414,2023-07-22,17:00:00,7,3,4,FMN 19 Binnensingel Oostkant
666,R10 414,2023-07-22,18:00:00,8,0,8,FMN 19 Binnensingel Oostkant
666,R10 414,2023-07-22,19:00:00,4,0,4,FMN 19 Binnensingel Oostkant
666,R10 414,2023-07-22,20:00:00,6,1,5,FMN 19 Binnensingel Oostkant
666,R10 414,2023-07-22,21:00:00,5,1,4,FMN 19 Binnensingel Oostkant
666,R10 414,2023-07-22,22:00:00,3,3,0,FMN 19 Binnensingel Oostkant
666,R10 414,2023-07-22,23:00:00,1,0,1,FMN 19 Binnensingel Oostkant
666,R10 414,2023-07-23,00:00:00,2,1,1,FMN 19 Binnensingel Oostkant
666,R10 414,2023-07-23,01:00:00,3,0,3,FMN 19 Binnensingel Oostkant
666,R10 414,2023-07-23,02:00:00,8,2,6,FMN 19 Binnensingel Oostkant
666,R10 414,2023-07-23,03:00:00,5,1,4,FMN 19 Binnensingel Oostkant
666,R10 414,2023-07-23,04:00:00,4,2,2,FMN 19 Binnensingel Oostkant
666,R10 414,2023-07-23,05:00:00,2,1,1,FMN 19 Binnensingel Oostkant
666,R10 414,2023-07-23,06:00:00,2,0,2,FMN 19 Binnensingel Oostkant
666,R10 414,2023-07-23,07:00:00,5,1,4,FMN 19 Binnensingel Oostkant
666,R10 414,2023-07-23,08:00:00,0,0,0,FMN 19 Binnensingel Oostkant
666,R10 414,2023-07-23,09:00:00,2,0,2,FMN 19 Binnensingel Oostkant
666,R10 414,2023-07-23,10:00:00,5,2,3,FMN 19 Binnensingel Oostkant
666,R10 414,2023-07-23,11:00:00,1,0,1,FMN 19 Binnensingel Oostkant
666,R10 414,2023-07-23,12:00:00,4,1,3,FMN 19 Binnensingel Oostkant
666,R10 414,2023-07-23,13:00:00,5,2,3,FMN 19 Binnensingel Oostkant
666,R10 414,2023-07-23,14:00:00,14,5,9,FMN 19 Binnensingel Oostkant
666,R10 414,2023-07-23,15:00:00,4,0,4,FMN 19 Binnensingel Oostkant
666,R10 414,2023-07-23,16:00:00,9,3,6,FMN 19 Binnensingel Oostkant
666,R10 414,2023-07-23,17:00:00,2,0,2,FMN 19 Binnensingel Oostkant
666,R10 414,2023-07-23,18:00:00,4,0,4,FMN 19 Binnensingel Oostkant
666,R10 414,2023-07-23,19:00:00,2,1,1,FMN 19 Binnensingel Oostkant
666,R10 414,2023-07-23,20:00:00,2,0,2,FMN 19 Binnensingel Oostkant
666,R10 414,2023-07-23,21:00:00,5,0,5,FMN 19 Binnensingel Oostkant
666,R10 414,2023-07-23,22:00:00,0,0,0,FMN 19 Binnensingel Oostkant
666,R10 414,2023-07-23,23:00:00,1,0,1,FMN 19 Binnensingel Oostkant
666,R10 414,2023-07-24,00:00:00,0,0,0,FMN 19 Binnensingel Oostkant
666,R10 414,2023-07-24,01:00:00,0,0,0,FMN 19 Binnensingel Oostkant
666,R10 414,2023-07-24,02:00:00,0,0,0,FMN 19 Binnensingel Oostkant
666,R10 414,2023-07-24,03:00:00,0,0,0,FMN 19 Binnensingel Oostkant
666,R10 414,2023-07-24,04:00:00,0,0,0,FMN 19 Binnensingel Oostkant
666,R10 414,2023-07-24,05:00:00,2,0,2,FMN 19 Binnensingel Oostkant
666,R10 414,2023-07-24,06:00:00,3,2,1,FMN 19 Binnensingel Oostkant
666,R10 414,2023-07-24,07:00:00,3,1,2,FMN 19 Binnensingel Oostkant
666,R10 414,2023-07-24,08:00:00,8,1,7,FMN 19 Binnensingel Oostkant
666,R10 414,2023-07-24,09:00:00,5,1,4,FMN 19 Binnensingel Oostkant
666,R10 414,2023-07-24,10:00:00,9,1,8,FMN 19 Binnensingel Oostkant
666,R10 414,2023-07-24,11:00:00,5,3,2,FMN 19 Binnensingel Oostkant
666,R10 414,2023-07-24,12:00:00,8,0,8,FMN 19 Binnensingel Oostkant
666,R10 414,2023-07-24,13:00:00,8,1,7,FMN 19 Binnensingel Oostkant
666,R10 414,2023-07-24,14:00:00,6,1,5,FMN 19 Binnensingel Oostkant
666,R10 414,2023-07-24,15:00:00,4,1,3,FMN 19 Binnensingel Oostkant
666,R10 414,2023-07-24,16:00:00,10,1,9,FMN 19 Binnensingel Oostkant
666,R10 414,2023-07-24,17:00:00,7,3,4,FMN 19 Binnensingel Oostkant
666,R10 414,2023-07-24,18:00:00,8,3,5,FMN 19 Binnensingel Oostkant
666,R10 414,2023-07-24,19:00:00,10,1,9,FMN 19 Binnensingel Oostkant
666,R10 414,2023-07-24,20:00:00,9,3,6,FMN 19 Binnensingel Oostkant
666,R10 414,2023-07-24,21:00:00,5,1,4,FMN 19 Binnensingel Oostkant
666,R10 414,2023-07-24,22:00:00,6,1,5,FMN 19 Binnensingel Oostkant
666,R10 414,2023-07-24,23:00:00,4,1,3,FMN 19 Binnensingel Oostkant
666,R10 414,2023-07-25,00:00:00,0,0,0,FMN 19 Binnensingel Oostkant
666,R10 414,2023-07-25,01:00:00,0,0,0,FMN 19 Binnensingel Oostkant
666,R10 414,2023-07-25,02:00:00,1,0,1,FMN 19 Binnensingel Oostkant
666,R10 414,2023-07-25,03:00:00,0,0,0,FMN 19 Binnensingel Oostkant
666,R10 414,2023-07-25,04:00:00,0,0,0,FMN 19 Binnensingel Oostkant
666,R10 414,2023-07-25,05:00:00,1,1,0,FMN 19 Binnensingel Oostkant
666,R10 414,2023-07-25,06:00:00,4,3,1,FMN 19 Binnensingel Oostkant
666,R10 414,2023-07-25,07:00:00,1,0,1,FMN 19 Binnensingel Oostkant
666,R10 414,2023-07-25,08:00:00,5,2,3,FMN 19 Binnensingel Oostkant
666,R10 414,2023-07-25,09:00:00,4,2,2,FMN 19 Binnensingel Oostkant
666,R10 414,2023-07-25,10:00:00,3,1,2,FMN 19 Binnensingel Oostkant
666,R10 414,2023-07-25,11:00:00,2,1,1,FMN 19 Binnensingel Oostkant
666,R10 414,2023-07-25,12:00:00,6,1,5,FMN 19 Binnensingel Oostkant
666,R10 414,2023-07-25,13:00:00,6,2,4,FMN 19 Binnensingel Oostkant
666,R10 414,2023-07-25,14:00:00,4,1,3,FMN 19 Binnensingel Oostkant
666,R10 414,2023-07-25,15:00:00,7,4,3,FMN 19 Binnensingel Oostkant
666,R10 414,2023-07-25,16:00:00,9,1,8,FMN 19 Binnensingel Oostkant
666,R10 414,2023-07-25,17:00:00,9,3,6,FMN 19 Binnensingel Oostkant
666,R10 414,2023-07-25,18:00:00,7,1,6,FMN 19 Binnensingel Oostkant
666,R10 414,2023-07-25,19:00:00,10,1,9,FMN 19 Binnensingel Oostkant
666,R10 414,2023-07-25,20:00:00,11,2,9,FMN 19 Binnensingel Oostkant
666,R10 414,2023-07-25,21:00:00,9,6,3,FMN 19 Binnensingel Oostkant
666,R10 414,2023-07-25,22:00:00,1,0,1,FMN 19 Binnensingel Oostkant
666,R10 414,2023-07-25,23:00:00,6,1,5,FMN 19 Binnensingel Oostkant
666,R10 414,2023-07-26,00:00:00,1,1,0,FMN 19 Binnensingel Oostkant
666,R10 414,2023-07-26,01:00:00,1,1,0,FMN 19 Binnensingel Oostkant
666,R10 414,2023-07-26,02:00:00,2,1,1,FMN 19 Binnensingel Oostkant
666,R10 414,2023-07-26,03:00:00,0,0,0,FMN 19 Binnensingel Oostkant
666,R10 414,2023-07-26,04:00:00,1,1,0,FMN 19 Binnensingel Oostkant
666,R10 414,2023-07-26,05:00:00,1,0,1,FMN 19 Binnensingel Oostkant
666,R10 414,2023-07-26,06:00:00,3,2,1,FMN 19 Binnensingel Oostkant
666,R10 414,2023-07-26,07:00:00,11,2,9,FMN 19 Binnensingel Oostkant
666,R10 414,2023-07-26,08:00:00,8,2,6,FMN 19 Binnensingel Oostkant
666,R10 414,2023-07-26,09:00:00,5,2,3,FMN 19 Binnensingel Oostkant
666,R10 414,2023-07-26,10:00:00,4,1,3,FMN 19 Binnensingel Oostkant
666,R10 414,2023-07-26,11:00:00,8,2,6,FMN 19 Binnensingel Oostkant
666,R10 414,2023-07-26,12:00:00,2,0,2,FMN 19 Binnensingel Oostkant
666,R10 414,2023-07-26,13:00:00,17,3,14,FMN 19 Binnensingel Oostkant
666,R10 414,2023-07-26,14:00:00,7,2,5,FMN 19 Binnensingel Oostkant
666,R10 414,2023-07-26,15:00:00,8,2,6,FMN 19 Binnensingel Oostkant
666,R10 414,2023-07-26,16:00:00,18,5,13,FMN 19 Binnensingel Oostkant
666,R10 414,2023-07-26,17:00:00,19,6,13,FMN 19 Binnensingel Oostkant
666,R10 414,2023-07-26,18:00:00,7,2,5,FMN 19 Binnensingel Oostkant
666,R10 414,2023-07-26,19:00:00,3,0,3,FMN 19 Binnensingel Oostkant
666,R10 414,2023-07-26,20:00:00,9,2,7,FMN 19 Binnensingel Oostkant
666,R10 414,2023-07-26,21:00:00,9,3,6,FMN 19 Binnensingel Oostkant
666,R10 414,2023-07-26,22:00:00,6,2,4,FMN 19 Binnensingel Oostkant
666,R10 414,2023-07-26,23:00:00,13,5,8,FMN 19 Binnensingel Oostkant
666,R10 414,2023-07-27,00:00:00,1,1,0,FMN 19 Binnensingel Oostkant
666,R10 414,2023-07-27,01:00:00,2,0,2,FMN 19 Binnensingel Oostkant
666,R10 414,2023-07-27,02:00:00,0,0,0,FMN 19 Binnensingel Oostkant
666,R10 414,2023-07-27,03:00:00,1,0,1,FMN 19 Binnensingel Oostkant
666,R10 414,2023-07-27,04:00:00,1,0,1,FMN 19 Binnensingel Oostkant
666,R10 414,2023-07-27,05:00:00,3,2,1,FMN 19 Binnensingel Oostkant
666,R10 414,2023-07-27,06:00:00,5,3,2,FMN 19 Binnensingel Oostkant
666,R10 414,2023-07-27,07:00:00,6,2,4,FMN 19 Binnensingel Oostkant
666,R10 414,2023-07-27,08:00:00,2,0,2,FMN 19 Binnensingel Oostkant
666,R10 414,2023-07-27,09:00:00,1,0,1,FMN 19 Binnensingel Oostkant
666,R10 414,2023-07-27,10:00:00,5,1,4,FMN 19 Binnensingel Oostkant
666,R10 414,2023-07-27,11:00:00,2,0,2,FMN 19 Binnensingel Oostkant
666,R10 414,2023-07-27,12:00:00,5,1,4,FMN 19 Binnensingel Oostkant
666,R10 414,2023-07-27,13:00:00,4,0,4,FMN 19 Binnensingel Oostkant
666,R10 414,2023-07-27,14:00:00,5,1,4,FMN 19 Binnensingel Oostkant
666,R10 414,2023-07-27,15:00:00,9,3,6,FMN 19 Binnensingel Oostkant
666,R10 414,2023-07-27,16:00:00,12,4,8,FMN 19 Binnensingel Oostkant
666,R10 414,2023-07-27,17:00:00,4,0,4,FMN 19 Binnensingel Oostkant
666,R10 414,2023-07-27,18:00:00,8,1,7,FMN 19 Binnensingel Oostkant
666,R10 414,2023-07-27,19:00:00,6,0,6,FMN 19 Binnensingel Oostkant
666,R10 414,2023-07-27,20:00:00,2,1,1,FMN 19 Binnensingel Oostkant
666,R10 414,2023-07-27,21:00:00,1,0,1,FMN 19 Binnensingel Oostkant
666,R10 414,2023-07-27,22:00:00,0,0,0,FMN 19 Binnensingel Oostkant
666,R10 414,2023-07-27,23:00:00,3,0,3,FMN 19 Binnensingel Oostkant
666,R10 414,2023-07-28,00:00:00,0,0,0,FMN 19 Binnensingel Oostkant
666,R10 414,2023-07-28,01:00:00,3,0,3,FMN 19 Binnensingel Oostkant
666,R10 414,2023-07-28,02:00:00,0,0,0,FMN 19 Binnensingel Oostkant
666,R10 414,2023-07-28,03:00:00,1,0,1,FMN 19 Binnensingel Oostkant
666,R10 414,2023-07-28,04:00:00,1,0,1,FMN 19 Binnensingel Oostkant
666,R10 414,2023-07-28,05:00:00,1,1,0,FMN 19 Binnensingel Oostkant
666,R10 414,2023-07-28,06:00:00,8,4,4,FMN 19 Binnensingel Oostkant
666,R10 414,2023-07-28,07:00:00,2,0,2,FMN 19 Binnensingel Oostkant
666,R10 414,2023-07-28,08:00:00,6,4,2,FMN 19 Binnensingel Oostkant
666,R10 414,2023-07-28,09:00:00,8,4,4,FMN 19 Binnensingel Oostkant
666,R10 414,2023-07-28,10:00:00,3,2,1,FMN 19 Binnensingel Oostkant
666,R10 414,2023-07-28,11:00:00,7,1,6,FMN 19 Binnensingel Oostkant
666,R10 414,2023-07-28,12:00:00,7,2,5,FMN 19 Binnensingel Oostkant
666,R10 414,2023-07-28,13:00:00,13,4,9,FMN 19 Binnensingel Oostkant
666,R10 414,2023-07-28,14:00:00,12,5,7,FMN 19 Binnensingel Oostkant
666,R10 414,2023-07-28,15:00:00,18,7,11,FMN 19 Binnensingel Oostkant
666,R10 414,2023-07-28,16:00:00,8,3,5,FMN 19 Binnensingel Oostkant
666,R10 414,2023-07-28,17:00:00,13,3,10,FMN 19 Binnensingel Oostkant
666,R10 414,2023-07-28,18:00:00,11,3,8,FMN 19 Binnensingel Oostkant
666,R10 414,2023-07-28,19:00:00,17,3,14,FMN 19 Binnensingel Oostkant
666,R10 414,2023-07-28,20:00:00,5,2,3,FMN 19 Binnensingel Oostkant
666,R10 414,2023-07-28,21:00:00,5,1,4,FMN 19 Binnensingel Oostkant
666,R10 414,2023-07-28,22:00:00,8,3,5,FMN 19 Binnensingel Oostkant
666,R10 414,2023-07-28,23:00:00,9,5,4,FMN 19 Binnensingel Oostkant
666,R10 414,2023-07-29,00:00:00,3,1,2,FMN 19 Binnensingel Oostkant
666,R10 414,2023-07-29,01:00:00,2,1,1,FMN 19 Binnensingel Oostkant
666,R10 414,2023-07-29,02:00:00,2,1,1,FMN 19 Binnensingel Oostkant
666,R10 414,2023-07-29,03:00:00,2,0,2,FMN 19 Binnensingel Oostkant
666,R10 414,2023-07-29,04:00:00,1,0,1,FMN 19 Binnensingel Oostkant
666,R10 414,2023-07-29,05:00:00,2,0,2,FMN 19 Binnensingel Oostkant
666,R10 414,2023-07-29,06:00:00,3,0,3,FMN 19 Binnensingel Oostkant
666,R10 414,2023-07-29,07:00:00,4,2,2,FMN 19 Binnensingel Oostkant
666,R10 414,2023-07-29,08:00:00,1,1,0,FMN 19 Binnensingel Oostkant
666,R10 414,2023-07-29,09:00:00,5,3,2,FMN 19 Binnensingel Oostkant
666,R10 414,2023-07-29,10:00:00,11,4,7,FMN 19 Binnensingel Oostkant
666,R10 414,2023-07-29,11:00:00,5,3,2,FMN 19 Binnensingel Oostkant
666,R10 414,2023-07-29,12:00:00,3,0,3,FMN 19 Binnensingel Oostkant
666,R10 414,2023-07-29,13:00:00,2,1,1,FMN 19 Binnensingel Oostkant
666,R10 414,2023-07-29,14:00:00,8,3,5,FMN 19 Binnensingel Oostkant
666,R10 414,2023-07-29,15:00:00,9,0,9,FMN 19 Binnensingel Oostkant
666,R10 414,2023-07-29,16:00:00,7,3,4,FMN 19 Binnensingel Oostkant
666,R10 414,2023-07-29,17:00:00,9,1,8,FMN 19 Binnensingel Oostkant
666,R10 414,2023-07-29,18:00:00,7,3,4,FMN 19 Binnensingel Oostkant
666,R10 414,2023-07-29,19:00:00,11,2,9,FMN 19 Binnensingel Oostkant
666,R10 414,2023-07-29,20:00:00,7,1,6,FMN 19 Binnensingel Oostkant
666,R10 414,2023-07-29,21:00:00,5,1,4,FMN 19 Binnensingel Oostkant
666,R10 414,2023-07-29,22:00:00,4,2,2,FMN 19 Binnensingel Oostkant
666,R10 414,2023-07-29,23:00:00,8,6,2,FMN 19 Binnensingel Oostkant
666,R10 414,2023-07-30,00:00:00,0,0,0,FMN 19 Binnensingel Oostkant
666,R10 414,2023-07-30,01:00:00,2,0,2,FMN 19 Binnensingel Oostkant
666,R10 414,2023-07-30,02:00:00,2,0,2,FMN 19 Binnensingel Oostkant
666,R10 414,2023-07-30,03:00:00,1,0,1,FMN 19 Binnensingel Oostkant
666,R10 414,2023-07-30,04:00:00,0,0,0,FMN 19 Binnensingel Oostkant
666,R10 414,2023-07-30,05:00:00,0,0,0,FMN 19 Binnensingel Oostkant
666,R10 414,2023-07-30,06:00:00,0,0,0,FMN 19 Binnensingel Oostkant
666,R10 414,2023-07-30,07:00:00,1,0,1,FMN 19 Binnensingel Oostkant
666,R10 414,2023-07-30,08:00:00,6,2,4,FMN 19 Binnensingel Oostkant
666,R10 414,2023-07-30,09:00:00,7,2,5,FMN 19 Binnensingel Oostkant
666,R10 414,2023-07-30,10:00:00,6,1,5,FMN 19 Binnensingel Oostkant
666,R10 414,2023-07-30,11:00:00,3,1,2,FMN 19 Binnensingel Oostkant
666,R10 414,2023-07-30,12:00:00,9,2,7,FMN 19 Binnensingel Oostkant
666,R10 414,2023-07-30,13:00:00,5,1,4,FMN 19 Binnensingel Oostkant
666,R10 414,2023-07-30,14:00:00,6,2,4,FMN 19 Binnensingel Oostkant
666,R10 414,2023-07-30,15:00:00,6,2,4,FMN 19 Binnensingel Oostkant
666,R10 414,2023-07-30,16:00:00,15,4,11,FMN 19 Binnensingel Oostkant
666,R10 414,2023-07-30,17:00:00,10,2,8,FMN 19 Binnensingel Oostkant
666,R10 414,2023-07-30,18:00:00,5,0,5,FMN 19 Binnensingel Oostkant
666,R10 414,2023-07-30,19:00:00,5,1,4,FMN 19 Binnensingel Oostkant
666,R10 414,2023-07-30,20:00:00,1,0,1,FMN 19 Binnensingel Oostkant
666,R10 414,2023-07-30,21:00:00,1,0,1,FMN 19 Binnensingel Oostkant
666,R10 414,2023-07-30,22:00:00,1,0,1,FMN 19 Binnensingel Oostkant
666,R10 414,2023-07-30,23:00:00,3,1,2,FMN 19 Binnensingel Oostkant
666,R10 414,2023-07-31,00:00:00,2,1,1,FMN 19 Binnensingel Oostkant
666,R10 414,2023-07-31,01:00:00,1,1,0,FMN 19 Binnensingel Oostkant
666,R10 414,2023-07-31,02:00:00,0,0,0,FMN 19 Binnensingel Oostkant
666,R10 414,2023-07-31,03:00:00,1,1,0,FMN 19 Binnensingel Oostkant
666,R10 414,2023-07-31,04:00:00,0,0,0,FMN 19 Binnensingel Oostkant
666,R10 414,2023-07-31,05:00:00,3,1,2,FMN 19 Binnensingel Oostkant
666,R10 414,2023-07-31,06:00:00,6,3,3,FMN 19 Binnensingel Oostkant
666,R10 414,2023-07-31,07:00:00,10,2,8,FMN 19 Binnensingel Oostkant
666,R10 414,2023-07-31,08:00:00,5,4,1,FMN 19 Binnensingel Oostkant
666,R10 414,2023-07-31,09:00:00,3,1,2,FMN 19 Binnensingel Oostkant
666,R10 414,2023-07-31,10:00:00,1,0,1,FMN 19 Binnensingel Oostkant
666,R10 414,2023-07-31,11:00:00,5,1,4,FMN 19 Binnensingel Oostkant
666,R10 414,2023-07-31,12:00:00,12,5,7,FMN 19 Binnensingel Oostkant
666,R10 414,2023-07-31,13:00:00,7,0,7,FMN 19 Binnensingel Oostkant
666,R10 414,2023-07-31,14:00:00,8,5,3,FMN 19 Binnensingel Oostkant
666,R10 414,2023-07-31,15:00:00,8,4,4,FMN 19 Binnensingel Oostkant
666,R10 414,2023-07-31,16:00:00,13,3,10,FMN 19 Binnensingel Oostkant
666,R10 414,2023-07-31,17:00:00,8,2,6,FMN 19 Binnensingel Oostkant
666,R10 414,2023-07-31,18:00:00,2,0,2,FMN 19 Binnensingel Oostkant
666,R10 414,2023-07-31,19:00:00,1,0,1,FMN 19 Binnensingel Oostkant
666,R10 414,2023-07-31,20:00:00,2,1,1,FMN 19 Binnensingel Oostkant
666,R10 414,2023-07-31,21:00:00,0,0,0,FMN 19 Binnensingel Oostkant
666,R10 414,2023-07-31,22:00:00,2,0,2,FMN 19 Binnensingel Oostkant
666,R10 414,2023-07-31,23:00:00,1,0,1,FMN 19 Binnensingel Oostkant
666,R10 414,2023-08-01,00:00:00,3,2,1,FMN 19 Binnensingel Oostkant
666,R10 414,2023-08-01,01:00:00,2,1,1,FMN 19 Binnensingel Oostkant
666,R10 414,2023-08-01,02:00:00,1,1,0,FMN 19 Binnensingel Oostkant
666,R10 414,2023-08-01,03:00:00,1,1,0,FMN 19 Binnensingel Oostkant
666,R10 414,2023-08-01,04:00:00,0,0,0,FMN 19 Binnensingel Oostkant
666,R10 414,2023-08-01,05:00:00,2,1,1,FMN 19 Binnensingel Oostkant
666,R10 414,2023-08-01,06:00:00,10,3,7,FMN 19 Binnensingel Oostkant
666,R10 414,2023-08-01,07:00:00,8,2,6,FMN 19 Binnensingel Oostkant
666,R10 414,2023-08-01,08:00:00,10,2,8,FMN 19 Binnensingel Oostkant
666,R10 414,2023-08-01,09:00:00,6,0,6,FMN 19 Binnensingel Oostkant
666,R10 414,2023-08-01,10:00:00,2,0,2,FMN 19 Binnensingel Oostkant
666,R10 414,2023-08-01,11:00:00,6,1,5,FMN 19 Binnensingel Oostkant
666,R10 414,2023-08-01,12:00:00,13,2,11,FMN 19 Binnensingel Oostkant
666,R10 414,2023-08-01,13:00:00,12,1,11,FMN 19 Binnensingel Oostkant
666,R10 414,2023-08-01,14:00:00,6,3,3,FMN 19 Binnensingel Oostkant
666,R10 414,2023-08-01,15:00:00,11,4,7,FMN 19 Binnensingel Oostkant
666,R10 414,2023-08-01,16:00:00,15,4,11,FMN 19 Binnensingel Oostkant
666,R10 414,2023-08-01,17:00:00,14,6,8,FMN 19 Binnensingel Oostkant
666,R10 414,2023-08-01,18:00:00,15,2,13,FMN 19 Binnensingel Oostkant
666,R10 414,2023-08-01,19:00:00,11,0,11,FMN 19 Binnensingel Oostkant
666,R10 414,2023-08-01,20:00:00,7,1,6,FMN 19 Binnensingel Oostkant
666,R10 414,2023-08-01,21:00:00,3,1,2,FMN 19 Binnensingel Oostkant
666,R10 414,2023-08-01,22:00:00,7,4,3,FMN 19 Binnensingel Oostkant
666,R10 414,2023-08-01,23:00:00,2,1,1,FMN 19 Binnensingel Oostkant
666,R10 414,2023-08-02,00:00:00,3,0,3,FMN 19 Binnensingel Oostkant
666,R10 414,2023-08-02,01:00:00,1,1,0,FMN 19 Binnensingel Oostkant
666,R10 414,2023-08-02,02:00:00,2,1,1,FMN 19 Binnensingel Oostkant
666,R10 414,2023-08-02,03:00:00,0,0,0,FMN 19 Binnensingel Oostkant
666,R10 414,2023-08-02,04:00:00,0,0,0,FMN 19 Binnensingel Oostkant
666,R10 414,2023-08-02,05:00:00,6,2,4,FMN 19 Binnensingel Oostkant
666,R10 414,2023-08-02,06:00:00,4,3,1,FMN 19 Binnensingel Oostkant
666,R10 414,2023-08-02,07:00:00,3,0,3,FMN 19 Binnensingel Oostkant
666,R10 414,2023-08-02,08:00:00,9,3,6,FMN 19 Binnensingel Oostkant
666,R10 414,2023-08-02,09:00:00,2,0,2,FMN 19 Binnensingel Oostkant
666,R10 414,2023-08-02,10:00:00,3,0,3,FMN 19 Binnensingel Oostkant
666,R10 414,2023-08-02,11:00:00,5,1,4,FMN 19 Binnensingel Oostkant
666,R10 414,2023-08-02,12:00:00,4,2,2,FMN 19 Binnensingel Oostkant
666,R10 414,2023-08-02,13:00:00,7,1,6,FMN 19 Binnensingel Oostkant
666,R10 414,2023-08-02,14:00:00,7,2,5,FMN 19 Binnensingel Oostkant
666,R10 414,2023-08-02,15:00:00,9,5,4,FMN 19 Binnensingel Oostkant
666,R10 414,2023-08-02,16:00:00,11,1,10,FMN 19 Binnensingel Oostkant
666,R10 414,2023-08-02,17:00:00,11,5,6,FMN 19 Binnensingel Oostkant
666,R10 414,2023-08-02,18:00:00,11,4,7,FMN 19 Binnensingel Oostkant
666,R10 414,2023-08-02,19:00:00,7,2,5,FMN 19 Binnensingel Oostkant
666,R10 414,2023-08-02,20:00:00,3,3,0,FMN 19 Binnensingel Oostkant
666,R10 414,2023-08-02,21:00:00,2,0,2,FMN 19 Binnensingel Oostkant
666,R10 414,2023-08-02,22:00:00,2,0,2,FMN 19 Binnensingel Oostkant
666,R10 414,2023-08-02,23:00:00,1,0,1,FMN 19 Binnensingel Oostkant
666,R10 414,2023-08-03,00:00:00,3,2,1,FMN 19 Binnensingel Oostkant
666,R10 414,2023-08-03,01:00:00,1,0,1,FMN 19 Binnensingel Oostkant
666,R10 414,2023-08-03,02:00:00,0,0,0,FMN 19 Binnensingel Oostkant
666,R10 414,2023-08-03,03:00:00,1,1,0,FMN 19 Binnensingel Oostkant
666,R10 414,2023-08-03,04:00:00,3,1,2,FMN 19 Binnensingel Oostkant
666,R10 414,2023-08-03,05:00:00,3,1,2,FMN 19 Binnensingel Oostkant
666,R10 414,2023-08-03,06:00:00,6,3,3,FMN 19 Binnensingel Oostkant
666,R10 414,2023-08-03,07:00:00,6,4,2,FMN 19 Binnensingel Oostkant
666,R10 414,2023-08-03,08:00:00,5,1,4,FMN 19 Binnensingel Oostkant
666,R10 414,2023-08-03,09:00:00,6,2,4,FMN 19 Binnensingel Oostkant
666,R10 414,2023-08-03,10:00:00,4,0,4,FMN 19 Binnensingel Oostkant
666,R10 414,2023-08-03,11:00:00,3,1,2,FMN 19 Binnensingel Oostkant
666,R10 414,2023-08-03,12:00:00,5,0,5,FMN 19 Binnensingel Oostkant
666,R10 414,2023-08-03,13:00:00,2,1,1,FMN 19 Binnensingel Oostkant
666,R10 414,2023-08-03,14:00:00,7,4,3,FMN 19 Binnensingel Oostkant
666,R10 414,2023-08-03,15:00:00,2,0,2,FMN 19 Binnensingel Oostkant
666,R10 414,2023-08-03,16:00:00,8,2,6,FMN 19 Binnensingel Oostkant
666,R10 414,2023-08-03,17:00:00,18,6,12,FMN 19 Binnensingel Oostkant
666,R10 414,2023-08-03,18:00:00,9,3,6,FMN 19 Binnensingel Oostkant
666,R10 414,2023-08-03,19:00:00,12,8,4,FMN 19 Binnensingel Oostkant
666,R10 414,2023-08-03,20:00:00,9,2,7,FMN 19 Binnensingel Oostkant
666,R10 414,2023-08-03,21:00:00,2,1,1,FMN 19 Binnensingel Oostkant
666,R10 414,2023-08-03,22:00:00,3,1,2,FMN 19 Binnensingel Oostkant
666,R10 414,2023-08-03,23:00:00,4,2,2,FMN 19 Binnensingel Oostkant
666,R10 414,2023-08-04,00:00:00,0,0,0,FMN 19 Binnensingel Oostkant
666,R10 414,2023-08-04,01:00:00,0,0,0,FMN 19 Binnensingel Oostkant
666,R10 414,2023-08-04,02:00:00,0,0,0,FMN 19 Binnensingel Oostkant
666,R10 414,2023-08-04,03:00:00,1,1,0,FMN 19 Binnensingel Oostkant
666,R10 414,2023-08-04,04:00:00,0,0,0,FMN 19 Binnensingel Oostkant
666,R10 414,2023-08-04,05:00:00,2,1,1,FMN 19 Binnensingel Oostkant
666,R10 414,2023-08-04,06:00:00,5,3,2,FMN 19 Binnensingel Oostkant
666,R10 414,2023-08-04,07:00:00,4,0,4,FMN 19 Binnensingel Oostkant
666,R10 414,2023-08-04,08:00:00,5,1,4,FMN 19 Binnensingel Oostkant
666,R10 414,2023-08-04,09:00:00,6,1,5,FMN 19 Binnensingel Oostkant
666,R10 414,2023-08-04,10:00:00,6,0,6,FMN 19 Binnensingel Oostkant
666,R10 414,2023-08-04,11:00:00,6,3,3,FMN 19 Binnensingel Oostkant
666,R10 414,2023-08-04,12:00:00,6,0,6,FMN 19 Binnensingel Oostkant
666,R10 414,2023-08-04,13:00:00,15,7,8,FMN 19 Binnensingel Oostkant
666,R10 414,2023-08-04,14:00:00,9,4,5,FMN 19 Binnensingel Oostkant
666,R10 414,2023-08-04,15:00:00,14,5,9,FMN 19 Binnensingel Oostkant
666,R10 414,2023-08-04,16:00:00,12,5,7,FMN 19 Binnensingel Oostkant
666,R10 414,2023-08-04,17:00:00,18,7,11,FMN 19 Binnensingel Oostkant
666,R10 414,2023-08-04,18:00:00,16,1,15,FMN 19 Binnensingel Oostkant
666,R10 414,2023-08-04,19:00:00,7,2,5,FMN 19 Binnensingel Oostkant
666,R10 414,2023-08-04,20:00:00,7,3,4,FMN 19 Binnensingel Oostkant
666,R10 414,2023-08-04,21:00:00,6,2,4,FMN 19 Binnensingel Oostkant
666,R10 414,2023-08-04,22:00:00,3,0,3,FMN 19 Binnensingel Oostkant
666,R10 414,2023-08-04,23:00:00,3,2,1,FMN 19 Binnensingel Oostkant
666,R10 414,2023-08-05,00:00:00,7,0,7,FMN 19 Binnensingel Oostkant
666,R10 414,2023-08-05,01:00:00,6,2,4,FMN 19 Binnensingel Oostkant
666,R10 414,2023-08-05,02:00:00,4,1,3,FMN 19 Binnensingel Oostkant
666,R10 414,2023-08-05,03:00:00,3,1,2,FMN 19 Binnensingel Oostkant
666,R10 414,2023-08-05,04:00:00,5,0,5,FMN 19 Binnensingel Oostkant
666,R10 414,2023-08-05,05:00:00,1,0,1,FMN 19 Binnensingel Oostkant
666,R10 414,2023-08-05,06:00:00,2,2,0,FMN 19 Binnensingel Oostkant
666,R10 414,2023-08-05,07:00:00,4,1,3,FMN 19 Binnensingel Oostkant
666,R10 414,2023-08-05,08:00:00,2,0,2,FMN 19 Binnensingel Oostkant
666,R10 414,2023-08-05,09:00:00,3,1,2,FMN 19 Binnensingel Oostkant
666,R10 414,2023-08-05,10:00:00,8,1,7,FMN 19 Binnensingel Oostkant
666,R10 414,2023-08-05,11:00:00,9,3,6,FMN 19 Binnensingel Oostkant
666,R10 414,2023-08-05,12:00:00,5,1,4,FMN 19 Binnensingel Oostkant
666,R10 414,2023-08-05,13:00:00,7,2,5,FMN 19 Binnensingel Oostkant
666,R10 414,2023-08-05,14:00:00,4,2,2,FMN 19 Binnensingel Oostkant
666,R10 414,2023-08-05,15:00:00,7,1,6,FMN 19 Binnensingel Oostkant
666,R10 414,2023-08-05,16:00:00,7,3,4,FMN 19 Binnensingel Oostkant
666,R10 414,2023-08-05,17:00:00,7,3,4,FMN 19 Binnensingel Oostkant
666,R10 414,2023-08-05,18:00:00,2,0,2,FMN 19 Binnensingel Oostkant
666,R10 414,2023-08-05,19:00:00,5,1,4,FMN 19 Binnensingel Oostkant
666,R10 414,2023-08-05,20:00:00,4,0,4,FMN 19 Binnensingel Oostkant
666,R10 414,2023-08-05,21:00:00,4,0,4,FMN 19 Binnensingel Oostkant
666,R10 414,2023-08-05,22:00:00,4,1,3,FMN 19 Binnensingel Oostkant
666,R10 414,2023-08-05,23:00:00,2,1,1,FMN 19 Binnensingel Oostkant
666,R10 414,2023-08-06,00:00:00,0,0,0,FMN 19 Binnensingel Oostkant
666,R10 414,2023-08-06,01:00:00,2,0,2,FMN 19 Binnensingel Oostkant
666,R10 414,2023-08-06,02:00:00,0,0,0,FMN 19 Binnensingel Oostkant
666,R10 414,2023-08-06,03:00:00,0,0,0,FMN 19 Binnensingel Oostkant
666,R10 414,2023-08-06,04:00:00,2,0,2,FMN 19 Binnensingel Oostkant
666,R10 414,2023-08-06,05:00:00,2,0,2,FMN 19 Binnensingel Oostkant
666,R10 414,2023-08-06,06:00:00,0,0,0,FMN 19 Binnensingel Oostkant
666,R10 414,2023-08-06,07:00:00,2,1,1,FMN 19 Binnensingel Oostkant
666,R10 414,2023-08-06,08:00:00,1,0,1,FMN 19 Binnensingel Oostkant
666,R10 414,2023-08-06,09:00:00,2,0,2,FMN 19 Binnensingel Oostkant
666,R10 414,2023-08-06,10:00:00,1,0,1,FMN 19 Binnensingel Oostkant
666,R10 414,2023-08-06,11:00:00,0,0,0,FMN 19 Binnensingel Oostkant
666,R10 414,2023-08-06,12:00:00,4,0,4,FMN 19 Binnensingel Oostkant
666,R10 414,2023-08-06,13:00:00,0,0,0,FMN 19 Binnensingel Oostkant
666,R10 414,2023-08-06,14:00:00,2,0,2,FMN 19 Binnensingel Oostkant
666,R10 414,2023-08-06,15:00:00,2,1,1,FMN 19 Binnensingel Oostkant
666,R10 414,2023-08-06,16:00:00,0,0,0,FMN 19 Binnensingel Oostkant
666,R10 414,2023-08-06,17:00:00,3,0,3,FMN 19 Binnensingel Oostkant
666,R10 414,2023-08-06,18:00:00,0,0,0,FMN 19 Binnensingel Oostkant
666,R10 414,2023-08-06,19:00:00,5,1,4,FMN 19 Binnensingel Oostkant
666,R10 414,2023-08-06,20:00:00,6,1,5,FMN 19 Binnensingel Oostkant
666,R10 414,2023-08-06,21:00:00,7,2,5,FMN 19 Binnensingel Oostkant
666,R10 414,2023-08-06,22:00:00,1,0,1,FMN 19 Binnensingel Oostkant
666,R10 414,2023-08-06,23:00:00,3,0,3,FMN 19 Binnensingel Oostkant
666,R10 414,2023-08-07,00:00:00,1,1,0,FMN 19 Binnensingel Oostkant
666,R10 414,2023-08-07,01:00:00,0,0,0,FMN 19 Binnensingel Oostkant
666,R10 414,2023-08-07,02:00:00,1,0,1,FMN 19 Binnensingel Oostkant
666,R10 414,2023-08-07,03:00:00,1,1,0,FMN 19 Binnensingel Oostkant
666,R10 414,2023-08-07,04:00:00,2,1,1,FMN 19 Binnensingel Oostkant
666,R10 414,2023-08-07,05:00:00,3,1,2,FMN 19 Binnensingel Oostkant
666,R10 414,2023-08-07,06:00:00,7,2,5,FMN 19 Binnensingel Oostkant
666,R10 414,2023-08-07,07:00:00,2,2,0,FMN 19 Binnensingel Oostkant
666,R10 414,2023-08-07,08:00:00,8,2,6,FMN 19 Binnensingel Oostkant
666,R10 414,2023-08-07,09:00:00,4,1,3,FMN 19 Binnensingel Oostkant
666,R10 414,2023-08-07,10:00:00,1,0,1,FMN 19 Binnensingel Oostkant
666,R10 414,2023-08-07,11:00:00,4,1,3,FMN 19 Binnensingel Oostkant
666,R10 414,2023-08-07,12:00:00,5,3,2,FMN 19 Binnensingel Oostkant
666,R10 414,2023-08-07,13:00:00,7,2,5,FMN 19 Binnensingel Oostkant
666,R10 414,2023-08-07,14:00:00,12,3,9,FMN 19 Binnensingel Oostkant
666,R10 414,2023-08-07,15:00:00,7,0,7,FMN 19 Binnensingel Oostkant
666,R10 414,2023-08-07,16:00:00,11,5,6,FMN 19 Binnensingel Oostkant
666,R10 414,2023-08-07,17:00:00,12,4,8,FMN 19 Binnensingel Oostkant
666,R10 414,2023-08-07,18:00:00,9,0,9,FMN 19 Binnensingel Oostkant
666,R10 414,2023-08-07,19:00:00,12,4,8,FMN 19 Binnensingel Oostkant
666,R10 414,2023-08-07,20:00:00,9,4,5,FMN 19 Binnensingel Oostkant
666,R10 414,2023-08-07,21:00:00,13,4,9,FMN 19 Binnensingel Oostkant
666,R10 414,2023-08-07,22:00:00,1,1,0,FMN 19 Binnensingel Oostkant
666,R10 414,2023-08-07,23:00:00,4,2,2,FMN 19 Binnensingel Oostkant
666,R10 414,2023-08-08,00:00:00,2,1,1,FMN 19 Binnensingel Oostkant
666,R10 414,2023-08-08,01:00:00,0,0,0,FMN 19 Binnensingel Oostkant
666,R10 414,2023-08-08,02:00:00,1,0,1,FMN 19 Binnensingel Oostkant
666,R10 414,2023-08-08,03:00:00,1,1,0,FMN 19 Binnensingel Oostkant
666,R10 414,2023-08-08,04:00:00,1,0,1,FMN 19 Binnensingel Oostkant
666,R10 414,2023-08-08,05:00:00,5,2,3,FMN 19 Binnensingel Oostkant
666,R10 414,2023-08-08,06:00:00,10,3,7,FMN 19 Binnensingel Oostkant
666,R10 414,2023-08-08,07:00:00,4,3,1,FMN 19 Binnensingel Oostkant
666,R10 414,2023-08-08,08:00:00,4,1,3,FMN 19 Binnensingel Oostkant
666,R10 414,2023-08-08,09:00:00,8,1,7,FMN 19 Binnensingel Oostkant
666,R10 414,2023-08-08,10:00:00,1,0,1,FMN 19 Binnensingel Oostkant
666,R10 414,2023-08-08,11:00:00,10,6,4,FMN 19 Binnensingel Oostkant
666,R10 414,2023-08-08,12:00:00,5,1,4,FMN 19 Binnensingel Oostkant
666,R10 414,2023-08-08,13:00:00,3,0,3,FMN 19 Binnensingel Oostkant
666,R10 414,2023-08-08,14:00:00,7,2,5,FMN 19 Binnensingel Oostkant
666,R10 414,2023-08-08,15:00:00,3,1,2,FMN 19 Binnensingel Oostkant
666,R10 414,2023-08-08,16:00:00,11,3,8,FMN 19 Binnensingel Oostkant
666,R10 414,2023-08-08,17:00:00,7,2,5,FMN 19 Binnensingel Oostkant
666,R10 414,2023-08-08,18:00:00,13,2,11,FMN 19 Binnensingel Oostkant
666,R10 414,2023-08-08,19:00:00,8,1,7,FMN 19 Binnensingel Oostkant
666,R10 414,2023-08-08,20:00:00,3,2,1,FMN 19 Binnensingel Oostkant
666,R10 414,2023-08-08,21:00:00,1,0,1,FMN 19 Binnensingel Oostkant
666,R10 414,2023-08-08,22:00:00,4,2,2,FMN 19 Binnensingel Oostkant
666,R10 414,2023-08-08,23:00:00,3,0,3,FMN 19 Binnensingel Oostkant
666,R10 414,2023-08-09,00:00:00,1,1,0,FMN 19 Binnensingel Oostkant
666,R10 414,2023-08-09,01:00:00,1,0,1,FMN 19 Binnensingel Oostkant
666,R10 414,2023-08-09,02:00:00,1,0,1,FMN 19 Binnensingel Oostkant
666,R10 414,2023-08-09,03:00:00,0,0,0,FMN 19 Binnensingel Oostkant
666,R10 414,2023-08-09,04:00:00,1,0,1,FMN 19 Binnensingel Oostkant
666,R10 414,2023-08-09,05:00:00,3,2,1,FMN 19 Binnensingel Oostkant
666,R10 414,2023-08-09,06:00:00,7,4,3,FMN 19 Binnensingel Oostkant
666,R10 414,2023-08-09,07:00:00,2,1,1,FMN 19 Binnensingel Oostkant
666,R10 414,2023-08-09,08:00:00,6,5,1,FMN 19 Binnensingel Oostkant
666,R10 414,2023-08-09,09:00:00,3,1,2,FMN 19 Binnensingel Oostkant
666,R10 414,2023-08-09,10:00:00,8,1,7,FMN 19 Binnensingel Oostkant
666,R10 414,2023-08-09,11:00:00,13,3,10,FMN 19 Binnensingel Oostkant
666,R10 414,2023-08-09,12:00:00,11,1,10,FMN 19 Binnensingel Oostkant
666,R10 414,2023-08-09,13:00:00,11,2,9,FMN 19 Binnensingel Oostkant
666,R10 414,2023-08-09,14:00:00,19,7,12,FMN 19 Binnensingel Oostkant
666,R10 414,2023-08-09,15:00:00,3,1,2,FMN 19 Binnensingel Oostkant
666,R10 414,2023-08-09,16:00:00,18,5,13,FMN 19 Binnensingel Oostkant
666,R10 414,2023-08-09,17:00:00,12,6,6,FMN 19 Binnensingel Oostkant
666,R10 414,2023-08-09,18:00:00,9,3,6,FMN 19 Binnensingel Oostkant
666,R10 414,2023-08-09,19:00:00,8,5,3,FMN 19 Binnensingel Oostkant
666,R10 414,2023-08-09,20:00:00,10,4,6,FMN 19 Binnensingel Oostkant
666,R10 414,2023-08-09,21:00:00,7,2,5,FMN 19 Binnensingel Oostkant
666,R10 414,2023-08-09,22:00:00,10,5,5,FMN 19 Binnensingel Oostkant
666,R10 414,2023-08-09,23:00:00,5,0,5,FMN 19 Binnensingel Oostkant
666,R10 414,2023-08-10,00:00:00,4,1,3,FMN 19 Binnensingel Oostkant
666,R10 414,2023-08-10,01:00:00,0,0,0,FMN 19 Binnensingel Oostkant
666,R10 414,2023-08-10,02:00:00,0,0,0,FMN 19 Binnensingel Oostkant
666,R10 414,2023-08-10,03:00:00,1,1,0,FMN 19 Binnensingel Oostkant
666,R10 414,2023-08-10,04:00:00,0,0,0,FMN 19 Binnensingel Oostkant
666,R10 414,2023-08-10,05:00:00,3,2,1,FMN 19 Binnensingel Oostkant
666,R10 414,2023-08-10,06:00:00,9,2,7,FMN 19 Binnensingel Oostkant
666,R10 414,2023-08-10,07:00:00,4,1,3,FMN 19 Binnensingel Oostkant
666,R10 414,2023-08-10,08:00:00,12,4,8,FMN 19 Binnensingel Oostkant
666,R10 414,2023-08-10,09:00:00,5,2,3,FMN 19 Binnensingel Oostkant
666,R10 414,2023-08-10,10:00:00,5,2,3,FMN 19 Binnensingel Oostkant
666,R10 414,2023-08-10,11:00:00,14,2,12,FMN 19 Binnensingel Oostkant
666,R10 414,2023-08-10,12:00:00,16,5,11,FMN 19 Binnensingel Oostkant
666,R10 414,2023-08-10,13:00:00,11,4,7,FMN 19 Binnensingel Oostkant
666,R10 414,2023-08-10,14:00:00,10,4,6,FMN 19 Binnensingel Oostkant
666,R10 414,2023-08-10,15:00:00,8,2,6,FMN 19 Binnensingel Oostkant
666,R10 414,2023-08-10,16:00:00,19,4,15,FMN 19 Binnensingel Oostkant
666,R10 414,2023-08-10,17:00:00,18,3,15,FMN 19 Binnensingel Oostkant
666,R10 414,2023-08-10,18:00:00,12,2,10,FMN 19 Binnensingel Oostkant
666,R10 414,2023-08-10,19:00:00,21,6,15,FMN 19 Binnensingel Oostkant
666,R10 414,2023-08-10,20:00:00,12,4,8,FMN 19 Binnensingel Oostkant
666,R10 414,2023-08-10,21:00:00,6,0,6,FMN 19 Binnensingel Oostkant
666,R10 414,2023-08-10,22:00:00,13,7,6,FMN 19 Binnensingel Oostkant
666,R10 414,2023-08-10,23:00:00,1,0,1,FMN 19 Binnensingel Oostkant
666,R10 414,2023-08-11,00:00:00,3,2,1,FMN 19 Binnensingel Oostkant
666,R10 414,2023-08-11,01:00:00,4,0,4,FMN 19 Binnensingel Oostkant
666,R10 414,2023-08-11,02:00:00,2,0,2,FMN 19 Binnensingel Oostkant
666,R10 414,2023-08-11,03:00:00,1,1,0,FMN 19 Binnensingel Oostkant
666,R10 414,2023-08-11,04:00:00,2,2,0,FMN 19 Binnensingel Oostkant
666,R10 414,2023-08-11,05:00:00,4,4,0,FMN 19 Binnensingel Oostkant
666,R10 414,2023-08-11,06:00:00,5,2,3,FMN 19 Binnensingel Oostkant
666,R10 414,2023-08-11,07:00:00,8,3,5,FMN 19 Binnensingel Oostkant
666,R10 414,2023-08-11,08:00:00,5,2,3,FMN 19 Binnensingel Oostkant
666,R10 414,2023-08-11,09:00:00,8,3,5,FMN 19 Binnensingel Oostkant
666,R10 414,2023-08-11,10:00:00,3,0,3,FMN 19 Binnensingel Oostkant
666,R10 414,2023-08-11,11:00:00,15,2,13,FMN 19 Binnensingel Oostkant
666,R10 414,2023-08-11,12:00:00,10,3,7,FMN 19 Binnensingel Oostkant
666,R10 414,2023-08-11,13:00:00,12,2,10,FMN 19 Binnensingel Oostkant
666,R10 414,2023-08-11,14:00:00,5,3,2,FMN 19 Binnensingel Oostkant
666,R10 414,2023-08-11,15:00:00,16,6,10,FMN 19 Binnensingel Oostkant
666,R10 414,2023-08-11,16:00:00,14,6,8,FMN 19 Binnensingel Oostkant
666,R10 414,2023-08-11,17:00:00,25,5,20,FMN 19 Binnensingel Oostkant
666,R10 414,2023-08-11,18:00:00,13,1,12,FMN 19 Binnensingel Oostkant
666,R10 414,2023-08-11,19:00:00,12,3,9,FMN 19 Binnensingel Oostkant
666,R10 414,2023-08-11,20:00:00,7,0,7,FMN 19 Binnensingel Oostkant
666,R10 414,2023-08-11,21:00:00,15,8,7,FMN 19 Binnensingel Oostkant
666,R10 414,2023-08-11,22:00:00,6,5,1,FMN 19 Binnensingel Oostkant
666,R10 414,2023-08-11,23:00:00,5,2,3,FMN 19 Binnensingel Oostkant
666,R10 414,2023-08-12,00:00:00,2,1,1,FMN 19 Binnensingel Oostkant
666,R10 414,2023-08-12,01:00:00,5,3,2,FMN 19 Binnensingel Oostkant
666,R10 414,2023-08-12,02:00:00,1,0,1,FMN 19 Binnensingel Oostkant
666,R10 414,2023-08-12,03:00:00,2,2,0,FMN 19 Binnensingel Oostkant
666,R10 414,2023-08-12,04:00:00,2,0,2,FMN 19 Binnensingel Oostkant
666,R10 414,2023-08-12,05:00:00,0,0,0,FMN 19 Binnensingel Oostkant
666,R10 414,2023-08-12,06:00:00,3,3,0,FMN 19 Binnensingel Oostkant
666,R10 414,2023-08-12,07:00:00,3,1,2,FMN 19 Binnensingel Oostkant
666,R10 414,2023-08-12,08:00:00,0,0,0,FMN 19 Binnensingel Oostkant
666,R10 414,2023-08-12,09:00:00,5,1,4,FMN 19 Binnensingel Oostkant
666,R10 414,2023-08-12,10:00:00,1,0,1,FMN 19 Binnensingel Oostkant
666,R10 414,2023-08-12,11:00:00,8,2,6,FMN 19 Binnensingel Oostkant
666,R10 414,2023-08-12,12:00:00,11,5,6,FMN 19 Binnensingel Oostkant
666,R10 414,2023-08-12,13:00:00,24,11,13,FMN 19 Binnensingel Oostkant
666,R10 414,2023-08-12,14:00:00,14,5,9,FMN 19 Binnensingel Oostkant
666,R10 414,2023-08-12,15:00:00,9,2,7,FMN 19 Binnensingel Oostkant
666,R10 414,2023-08-12,16:00:00,17,7,10,FMN 19 Binnensingel Oostkant
666,R10 414,2023-08-12,17:00:00,6,2,4,FMN 19 Binnensingel Oostkant
666,R10 414,2023-08-12,18:00:00,14,3,11,FMN 19 Binnensingel Oostkant
666,R10 414,2023-08-12,19:00:00,7,1,6,FMN 19 Binnensingel Oostkant
666,R10 414,2023-08-12,20:00:00,10,1,9,FMN 19 Binnensingel Oostkant
666,R10 414,2023-08-12,21:00:00,10,2,8,FMN 19 Binnensingel Oostkant
666,R10 414,2023-08-12,22:00:00,2,0,2,FMN 19 Binnensingel Oostkant
666,R10 414,2023-08-12,23:00:00,3,1,2,FMN 19 Binnensingel Oostkant
666,R10 414,2023-08-13,00:00:00,3,1,2,FMN 19 Binnensingel Oostkant
666,R10 414,2023-08-13,01:00:00,2,1,1,FMN 19 Binnensingel Oostkant
666,R10 414,2023-08-13,02:00:00,5,3,2,FMN 19 Binnensingel Oostkant
666,R10 414,2023-08-13,03:00:00,3,2,1,FMN 19 Binnensingel Oostkant
666,R10 414,2023-08-13,04:00:00,2,0,2,FMN 19 Binnensingel Oostkant
666,R10 414,2023-08-13,05:00:00,3,0,3,FMN 19 Binnensingel Oostkant
666,R10 414,2023-08-13,06:00:00,7,4,3,FMN 19 Binnensingel Oostkant
666,R10 414,2023-08-13,07:00:00,1,1,0,FMN 19 Binnensingel Oostkant
666,R10 414,2023-08-13,08:00:00,0,0,0,FMN 19 Binnensingel Oostkant
666,R10 414,2023-08-13,09:00:00,8,1,7,FMN 19 Binnensingel Oostkant
666,R10 414,2023-08-13,10:00:00,4,1,3,FMN 19 Binnensingel Oostkant
666,R10 414,2023-08-13,11:00:00,5,3,2,FMN 19 Binnensingel Oostkant
666,R10 414,2023-08-13,12:00:00,9,2,7,FMN 19 Binnensingel Oostkant
666,R10 414,2023-08-13,13:00:00,7,3,4,FMN 19 Binnensingel Oostkant
666,R10 414,2023-08-13,14:00:00,7,2,5,FMN 19 Binnensingel Oostkant
666,R10 414,2023-08-13,15:00:00,11,1,10,FMN 19 Binnensingel Oostkant
666,R10 414,2023-08-13,16:00:00,15,6,9,FMN 19 Binnensingel Oostkant
666,R10 414,2023-08-13,17:00:00,14,5,9,FMN 19 Binnensingel Oostkant
666,R10 414,2023-08-13,18:00:00,12,8,4,FMN 19 Binnensingel Oostkant
666,R10 414,2023-08-13,19:00:00,6,1,5,FMN 19 Binnensingel Oostkant
666,R10 414,2023-08-13,20:00:00,5,2,3,FMN 19 Binnensingel Oostkant
666,R10 414,2023-08-13,21:00:00,13,4,9,FMN 19 Binnensingel Oostkant
666,R10 414,2023-08-13,22:00:00,5,1,4,FMN 19 Binnensingel Oostkant
666,R10 414,2023-08-13,23:00:00,2,0,2,FMN 19 Binnensingel Oostkant
666,R10 414,2023-08-14,00:00:00,11,4,7,FMN 19 Binnensingel Oostkant
666,R10 414,2023-08-14,01:00:00,1,1,0,FMN 19 Binnensingel Oostkant
666,R10 414,2023-08-14,02:00:00,2,1,1,FMN 19 Binnensingel Oostkant
666,R10 414,2023-08-14,03:00:00,2,1,1,FMN 19 Binnensingel Oostkant
666,R10 414,2023-08-14,04:00:00,0,0,0,FMN 19 Binnensingel Oostkant
666,R10 414,2023-08-14,05:00:00,5,2,3,FMN 19 Binnensingel Oostkant
666,R10 414,2023-08-14,06:00:00,8,6,2,FMN 19 Binnensingel Oostkant
666,R10 414,2023-08-14,07:00:00,7,2,5,FMN 19 Binnensingel Oostkant
666,R10 414,2023-08-14,08:00:00,3,0,3,FMN 19 Binnensingel Oostkant
666,R10 414,2023-08-14,09:00:00,8,2,6,FMN 19 Binnensingel Oostkant
666,R10 414,2023-08-14,10:00:00,4,1,3,FMN 19 Binnensingel Oostkant
666,R10 414,2023-08-14,11:00:00,6,0,6,FMN 19 Binnensingel Oostkant
666,R10 414,2023-08-14,12:00:00,7,1,6,FMN 19 Binnensingel Oostkant
666,R10 414,2023-08-14,13:00:00,10,3,7,FMN 19 Binnensingel Oostkant
666,R10 414,2023-08-14,14:00:00,17,3,14,FMN 19 Binnensingel Oostkant
666,R10 414,2023-08-14,15:00:00,6,3,3,FMN 19 Binnensingel Oostkant
666,R10 414,2023-08-14,16:00:00,13,4,9,FMN 19 Binnensingel Oostkant
666,R10 414,2023-08-14,17:00:00,14,6,8,FMN 19 Binnensingel Oostkant
666,R10 414,2023-08-14,18:00:00,17,6,11,FMN 19 Binnensingel Oostkant
666,R10 414,2023-08-14,19:00:00,13,4,9,FMN 19 Binnensingel Oostkant
666,R10 414,2023-08-14,20:00:00,19,8,11,FMN 19 Binnensingel Oostkant
666,R10 414,2023-08-14,21:00:00,11,2,9,FMN 19 Binnensingel Oostkant
666,R10 414,2023-08-14,22:00:00,10,1,9,FMN 19 Binnensingel Oostkant
666,R10 414,2023-08-14,23:00:00,4,0,4,FMN 19 Binnensingel Oostkant
666,R10 414,2023-08-15,00:00:00,0,0,0,FMN 19 Binnensingel Oostkant
666,R10 414,2023-08-15,01:00:00,3,2,1,FMN 19 Binnensingel Oostkant
666,R10 414,2023-08-15,02:00:00,2,1,1,FMN 19 Binnensingel Oostkant
666,R10 414,2023-08-15,03:00:00,0,0,0,FMN 19 Binnensingel Oostkant
666,R10 414,2023-08-15,04:00:00,0,0,0,FMN 19 Binnensingel Oostkant
666,R10 414,2023-08-15,05:00:00,1,0,1,FMN 19 Binnensingel Oostkant
666,R10 414,2023-08-15,06:00:00,1,0,1,FMN 19 Binnensingel Oostkant
666,R10 414,2023-08-15,07:00:00,1,0,1,FMN 19 Binnensingel Oostkant
666,R10 414,2023-08-15,08:00:00,7,3,4,FMN 19 Binnensingel Oostkant
666,R10 414,2023-08-15,09:00:00,5,2,3,FMN 19 Binnensingel Oostkant
666,R10 414,2023-08-15,10:00:00,5,3,2,FMN 19 Binnensingel Oostkant
666,R10 414,2023-08-15,11:00:00,4,1,3,FMN 19 Binnensingel Oostkant
666,R10 414,2023-08-15,12:00:00,7,4,3,FMN 19 Binnensingel Oostkant
666,R10 414,2023-08-15,13:00:00,5,0,5,FMN 19 Binnensingel Oostkant
666,R10 414,2023-08-15,14:00:00,14,2,12,FMN 19 Binnensingel Oostkant
666,R10 414,2023-08-15,15:00:00,14,4,10,FMN 19 Binnensingel Oostkant
666,R10 414,2023-08-15,16:00:00,11,4,7,FMN 19 Binnensingel Oostkant
666,R10 414,2023-08-15,17:00:00,14,3,11,FMN 19 Binnensingel Oostkant
666,R10 414,2023-08-15,18:00:00,8,2,6,FMN 19 Binnensingel Oostkant
666,R10 414,2023-08-15,19:00:00,14,6,8,FMN 19 Binnensingel Oostkant
666,R10 414,2023-08-15,20:00:00,10,3,7,FMN 19 Binnensingel Oostkant
666,R10 414,2023-08-15,21:00:00,16,9,7,FMN 19 Binnensingel Oostkant
666,R10 414,2023-08-15,22:00:00,4,2,2,FMN 19 Binnensingel Oostkant
666,R10 414,2023-08-15,23:00:00,3,1,2,FMN 19 Binnensingel Oostkant
666,R10 414,2023-08-16,00:00:00,3,2,1,FMN 19 Binnensingel Oostkant
666,R10 414,2023-08-16,01:00:00,2,1,1,FMN 19 Binnensingel Oostkant
666,R10 414,2023-08-16,02:00:00,1,0,1,FMN 19 Binnensingel Oostkant
666,R10 414,2023-08-16,03:00:00,2,1,1,FMN 19 Binnensingel Oostkant
666,R10 414,2023-08-16,04:00:00,1,0,1,FMN 19 Binnensingel Oostkant
666,R10 414,2023-08-16,05:00:00,6,2,4,FMN 19 Binnensingel Oostkant
666,R10 414,2023-08-16,06:00:00,6,2,4,FMN 19 Binnensingel Oostkant
666,R10 414,2023-08-16,07:00:00,5,1,4,FMN 19 Binnensingel Oostkant
666,R10 414,2023-08-16,08:00:00,14,4,10,FMN 19 Binnensingel Oostkant
666,R10 414,2023-08-16,09:00:00,11,1,10,FMN 19 Binnensingel Oostkant
666,R10 414,2023-08-16,10:00:00,8,2,6,FMN 19 Binnensingel Oostkant
666,R10 414,2023-08-16,11:00:00,10,2,8,FMN 19 Binnensingel Oostkant
666,R10 414,2023-08-16,12:00:00,11,2,9,FMN 19 Binnensingel Oostkant
666,R10 414,2023-08-16,13:00:00,10,4,6,FMN 19 Binnensingel Oostkant
666,R10 414,2023-08-16,14:00:00,17,8,9,FMN 19 Binnensingel Oostkant
666,R10 414,2023-08-16,15:00:00,9,2,7,FMN 19 Binnensingel Oostkant
666,R10 414,2023-08-16,16:00:00,17,3,14,FMN 19 Binnensingel Oostkant
666,R10 414,2023-08-16,17:00:00,20,11,9,FMN 19 Binnensingel Oostkant
666,R10 414,2023-08-16,18:00:00,18,5,13,FMN 19 Binnensingel Oostkant
666,R10 414,2023-08-16,19:00:00,19,7,12,FMN 19 Binnensingel Oostkant
666,R10 414,2023-08-16,20:00:00,13,2,11,FMN 19 Binnensingel Oostkant
666,R10 414,2023-08-16,21:00:00,11,7,4,FMN 19 Binnensingel Oostkant
666,R10 414,2023-08-16,22:00:00,8,3,5,FMN 19 Binnensingel Oostkant
666,R10 414,2023-08-16,23:00:00,5,2,3,FMN 19 Binnensingel Oostkant
666,R10 414,2023-08-17,00:00:00,2,2,0,FMN 19 Binnensingel Oostkant
666,R10 414,2023-08-17,01:00:00,1,0,1,FMN 19 Binnensingel Oostkant
666,R10 414,2023-08-17,02:00:00,0,0,0,FMN 19 Binnensingel Oostkant
666,R10 414,2023-08-17,03:00:00,3,2,1,FMN 19 Binnensingel Oostkant
666,R10 414,2023-08-17,04:00:00,1,0,1,FMN 19 Binnensingel Oostkant
666,R10 414,2023-08-17,05:00:00,6,2,4,FMN 19 Binnensingel Oostkant
666,R10 414,2023-08-17,06:00:00,6,5,1,FMN 19 Binnensingel Oostkant
666,R10 414,2023-08-17,07:00:00,6,1,5,FMN 19 Binnensingel Oostkant
666,R10 414,2023-08-17,08:00:00,13,5,8,FMN 19 Binnensingel Oostkant
666,R10 414,2023-08-17,09:00:00,12,3,9,FMN 19 Binnensingel Oostkant
666,R10 414,2023-08-17,10:00:00,3,1,2,FMN 19 Binnensingel Oostkant
666,R10 414,2023-08-17,11:00:00,6,1,5,FMN 19 Binnensingel Oostkant
666,R10 414,2023-08-17,12:00:00,15,3,12,FMN 19 Binnensingel Oostkant
666,R10 414,2023-08-17,13:00:00,11,2,9,FMN 19 Binnensingel Oostkant
666,R10 414,2023-08-17,14:00:00,11,4,7,FMN 19 Binnensingel Oostkant
666,R10 414,2023-08-17,15:00:00,9,1,8,FMN 19 Binnensingel Oostkant
666,R10 414,2023-08-17,16:00:00,26,7,19,FMN 19 Binnensingel Oostkant
666,R10 414,2023-08-17,17:00:00,18,8,10,FMN 19 Binnensingel Oostkant
666,R10 414,2023-08-17,18:00:00,16,7,9,FMN 19 Binnensingel Oostkant
666,R10 414,2023-08-17,19:00:00,18,8,10,FMN 19 Binnensingel Oostkant
666,R10 414,2023-08-17,20:00:00,12,2,10,FMN 19 Binnensingel Oostkant
666,R10 414,2023-08-17,21:00:00,14,7,7,FMN 19 Binnensingel Oostkant
666,R10 414,2023-08-17,22:00:00,5,1,4,FMN 19 Binnensingel Oostkant
666,R10 414,2023-08-17,23:00:00,3,1,2,FMN 19 Binnensingel Oostkant
666,R10 414,2023-08-18,00:00:00,2,1,1,FMN 19 Binnensingel Oostkant
666,R10 414,2023-08-18,01:00:00,1,0,1,FMN 19 Binnensingel Oostkant
666,R10 414,2023-08-18,02:00:00,0,0,0,FMN 19 Binnensingel Oostkant
666,R10 414,2023-08-18,03:00:00,1,1,0,FMN 19 Binnensingel Oostkant
666,R10 414,2023-08-18,04:00:00,1,0,1,FMN 19 Binnensingel Oostkant
666,R10 414,2023-08-18,05:00:00,4,1,3,FMN 19 Binnensingel Oostkant
666,R10 414,2023-08-18,06:00:00,6,4,2,FMN 19 Binnensingel Oostkant
666,R10 414,2023-08-18,07:00:00,8,3,5,FMN 19 Binnensingel Oostkant
666,R10 414,2023-08-18,08:00:00,15,3,12,FMN 19 Binnensingel Oostkant
666,R10 414,2023-08-18,09:00:00,4,1,3,FMN 19 Binnensingel Oostkant
666,R10 414,2023-08-18,10:00:00,6,0,6,FMN 19 Binnensingel Oostkant
666,R10 414,2023-08-18,11:00:00,7,2,5,FMN 19 Binnensingel Oostkant
666,R10 414,2023-08-18,12:00:00,6,1,5,FMN 19 Binnensingel Oostkant
666,R10 414,2023-08-18,13:00:00,15,2,13,FMN 19 Binnensingel Oostkant
666,R10 414,2023-08-18,14:00:00,12,8,4,FMN 19 Binnensingel Oostkant
666,R10 414,2023-08-18,15:00:00,8,3,5,FMN 19 Binnensingel Oostkant
666,R10 414,2023-08-18,16:00:00,13,3,10,FMN 19 Binnensingel Oostkant
666,R10 414,2023-08-18,17:00:00,9,2,7,FMN 19 Binnensingel Oostkant
666,R10 414,2023-08-18,18:00:00,16,5,11,FMN 19 Binnensingel Oostkant
666,R10 414,2023-08-18,19:00:00,12,3,9,FMN 19 Binnensingel Oostkant
666,R10 414,2023-08-18,20:00:00,7,2,5,FMN 19 Binnensingel Oostkant
666,R10 414,2023-08-18,21:00:00,9,4,5,FMN 19 Binnensingel Oostkant
666,R10 414,2023-08-18,22:00:00,7,2,5,FMN 19 Binnensingel Oostkant
666,R10 414,2023-08-18,23:00:00,10,5,5,FMN 19 Binnensingel Oostkant
666,R10 414,2023-08-19,00:00:00,4,3,1,FMN 19 Binnensingel Oostkant
666,R10 414,2023-08-19,01:00:00,7,2,5,FMN 19 Binnensingel Oostkant
666,R10 414,2023-08-19,02:00:00,9,1,8,FMN 19 Binnensingel Oostkant
666,R10 414,2023-08-19,03:00:00,2,1,1,FMN 19 Binnensingel Oostkant
666,R10 414,2023-08-19,04:00:00,0,0,0,FMN 19 Binnensingel Oostkant
666,R10 414,2023-08-19,05:00:00,2,0,2,FMN 19 Binnensingel Oostkant
666,R10 414,2023-08-19,06:00:00,4,3,1,FMN 19 Binnensingel Oostkant
666,R10 414,2023-08-19,07:00:00,4,1,3,FMN 19 Binnensingel Oostkant
666,R10 414,2023-08-19,08:00:00,6,4,2,FMN 19 Binnensingel Oostkant
666,R10 414,2023-08-19,09:00:00,7,1,6,FMN 19 Binnensingel Oostkant
666,R10 414,2023-08-19,10:00:00,11,3,8,FMN 19 Binnensingel Oostkant
666,R10 414,2023-08-19,11:00:00,9,5,4,FMN 19 Binnensingel Oostkant
666,R10 414,2023-08-19,12:00:00,3,1,2,FMN 19 Binnensingel Oostkant
666,R10 414,2023-08-19,13:00:00,9,3,6,FMN 19 Binnensingel Oostkant
666,R10 414,2023-08-19,14:00:00,15,6,9,FMN 19 Binnensingel Oostkant
666,R10 414,2023-08-19,15:00:00,11,5,6,FMN 19 Binnensingel Oostkant
666,R10 414,2023-08-19,16:00:00,12,4,8,FMN 19 Binnensingel Oostkant
666,R10 414,2023-08-19,17:00:00,19,9,10,FMN 19 Binnensingel Oostkant
666,R10 414,2023-08-19,18:00:00,19,3,16,FMN 19 Binnensingel Oostkant
666,R10 414,2023-08-19,19:00:00,9,4,5,FMN 19 Binnensingel Oostkant
666,R10 414,2023-08-19,20:00:00,13,8,5,FMN 19 Binnensingel Oostkant
666,R10 414,2023-08-19,21:00:00,7,1,6,FMN 19 Binnensingel Oostkant
666,R10 414,2023-08-19,22:00:00,4,1,3,FMN 19 Binnensingel Oostkant
666,R10 414,2023-08-19,23:00:00,7,6,1,FMN 19 Binnensingel Oostkant
666,R10 414,2023-08-20,00:00:00,4,0,4,FMN 19 Binnensingel Oostkant
666,R10 414,2023-08-20,01:00:00,4,1,3,FMN 19 Binnensingel Oostkant
666,R10 414,2023-08-20,02:00:00,4,2,2,FMN 19 Binnensingel Oostkant
666,R10 414,2023-08-20,03:00:00,6,2,4,FMN 19 Binnensingel Oostkant
666,R10 414,2023-08-20,04:00:00,3,1,2,FMN 19 Binnensingel Oostkant
666,R10 414,2023-08-20,05:00:00,2,1,1,FMN 19 Binnensingel Oostkant
666,R10 414,2023-08-20,06:00:00,3,0,3,FMN 19 Binnensingel Oostkant
666,R10 414,2023-08-20,07:00:00,3,3,0,FMN 19 Binnensingel Oostkant
666,R10 414,2023-08-20,08:00:00,8,1,7,FMN 19 Binnensingel Oostkant
666,R10 414,2023-08-20,09:00:00,7,1,6,FMN 19 Binnensingel Oostkant
666,R10 414,2023-08-20,10:00:00,13,1,12,FMN 19 Binnensingel Oostkant
666,R10 414,2023-08-20,11:00:00,8,3,5,FMN 19 Binnensingel Oostkant
666,R10 414,2023-08-20,12:00:00,9,4,5,FMN 19 Binnensingel Oostkant
666,R10 414,2023-08-20,13:00:00,12,5,7,FMN 19 Binnensingel Oostkant
666,R10 414,2023-08-20,14:00:00,11,3,8,FMN 19 Binnensingel Oostkant
666,R10 414,2023-08-20,15:00:00,14,6,8,FMN 19 Binnensingel Oostkant
666,R10 414,2023-08-20,16:00:00,24,6,18,FMN 19 Binnensingel Oostkant
666,R10 414,2023-08-20,17:00:00,19,8,11,FMN 19 Binnensingel Oostkant
666,R10 414,2023-08-20,18:00:00,17,9,8,FMN 19 Binnensingel Oostkant
666,R10 414,2023-08-20,19:00:00,9,3,6,FMN 19 Binnensingel Oostkant
666,R10 414,2023-08-20,20:00:00,10,4,6,FMN 19 Binnensingel Oostkant
666,R10 414,2023-08-20,21:00:00,5,0,5,FMN 19 Binnensingel Oostkant
666,R10 414,2023-08-20,22:00:00,4,0,4,FMN 19 Binnensingel Oostkant
666,R10 414,2023-08-20,23:00:00,6,1,5,FMN 19 Binnensingel Oostkant
666,R10 414,2023-08-21,00:00:00,2,1,1,FMN 19 Binnensingel Oostkant
666,R10 414,2023-08-21,01:00:00,2,0,2,FMN 19 Binnensingel Oostkant
666,R10 414,2023-08-21,02:00:00,1,0,1,FMN 19 Binnensingel Oostkant
666,R10 414,2023-08-21,03:00:00,3,1,2,FMN 19 Binnensingel Oostkant
666,R10 414,2023-08-21,04:00:00,1,1,0,FMN 19 Binnensingel Oostkant
666,R10 414,2023-08-21,05:00:00,4,1,3,FMN 19 Binnensingel Oostkant
666,R10 414,2023-08-21,06:00:00,11,2,9,FMN 19 Binnensingel Oostkant
666,R10 414,2023-08-21,07:00:00,15,5,10,FMN 19 Binnensingel Oostkant
666,R10 414,2023-08-21,08:00:00,8,2,6,FMN 19 Binnensingel Oostkant
666,R10 414,2023-08-21,09:00:00,15,4,11,FMN 19 Binnensingel Oostkant
666,R10 414,2023-08-21,10:00:00,10,3,7,FMN 19 Binnensingel Oostkant
666,R10 414,2023-08-21,11:00:00,5,0,5,FMN 19 Binnensingel Oostkant
666,R10 414,2023-08-21,12:00:00,6,1,5,FMN 19 Binnensingel Oostkant
666,R10 414,2023-08-21,13:00:00,18,5,13,FMN 19 Binnensingel Oostkant
666,R10 414,2023-08-21,14:00:00,4,3,1,FMN 19 Binnensingel Oostkant
666,R10 414,2023-08-21,15:00:00,20,4,16,FMN 19 Binnensingel Oostkant
666,R10 414,2023-08-21,16:00:00,17,3,14,FMN 19 Binnensingel Oostkant
666,R10 414,2023-08-21,17:00:00,21,7,14,FMN 19 Binnensingel Oostkant
666,R10 414,2023-08-21,18:00:00,17,5,12,FMN 19 Binnensingel Oostkant
666,R10 414,2023-08-21,19:00:00,8,2,6,FMN 19 Binnensingel Oostkant
666,R10 414,2023-08-21,20:00:00,22,9,13,FMN 19 Binnensingel Oostkant
666,R10 414,2023-08-21,21:00:00,11,5,6,FMN 19 Binnensingel Oostkant
666,R10 414,2023-08-21,22:00:00,9,3,6,FMN 19 Binnensingel Oostkant
666,R10 414,2023-08-21,23:00:00,4,1,3,FMN 19 Binnensingel Oostkant
666,R10 414,2023-08-22,00:00:00,3,2,1,FMN 19 Binnensingel Oostkant
666,R10 414,2023-08-22,01:00:00,1,1,0,FMN 19 Binnensingel Oostkant
666,R10 414,2023-08-22,02:00:00,2,0,2,FMN 19 Binnensingel Oostkant
666,R10 414,2023-08-22,03:00:00,1,1,0,FMN 19 Binnensingel Oostkant
666,R10 414,2023-08-22,04:00:00,2,0,2,FMN 19 Binnensingel Oostkant
666,R10 414,2023-08-22,05:00:00,8,4,4,FMN 19 Binnensingel Oostkant
666,R10 414,2023-08-22,06:00:00,7,3,4,FMN 19 Binnensingel Oostkant
666,R10 414,2023-08-22,07:00:00,6,1,5,FMN 19 Binnensingel Oostkant
666,R10 414,2023-08-22,08:00:00,16,4,12,FMN 19 Binnensingel Oostkant
666,R10 414,2023-08-22,09:00:00,11,2,9,FMN 19 Binnensingel Oostkant
666,R10 414,2023-08-22,10:00:00,12,4,8,FMN 19 Binnensingel Oostkant
666,R10 414,2023-08-22,11:00:00,15,2,13,FMN 19 Binnensingel Oostkant
666,R10 414,2023-08-22,12:00:00,7,3,4,FMN 19 Binnensingel Oostkant
666,R10 414,2023-08-22,13:00:00,8,2,6,FMN 19 Binnensingel Oostkant
666,R10 414,2023-08-22,14:00:00,9,6,3,FMN 19 Binnensingel Oostkant
666,R10 414,2023-08-22,15:00:00,14,4,10,FMN 19 Binnensingel Oostkant
666,R10 414,2023-08-22,16:00:00,30,7,23,FMN 19 Binnensingel Oostkant
666,R10 414,2023-08-22,17:00:00,15,5,10,FMN 19 Binnensingel Oostkant
666,R10 414,2023-08-22,18:00:00,17,7,10,FMN 19 Binnensingel Oostkant
666,R10 414,2023-08-22,19:00:00,11,6,5,FMN 19 Binnensingel Oostkant
666,R10 414,2023-08-22,20:00:00,9,2,7,FMN 19 Binnensingel Oostkant
666,R10 414,2023-08-22,21:00:00,4,3,1,FMN 19 Binnensingel Oostkant
666,R10 414,2023-08-22,22:00:00,14,4,10,FMN 19 Binnensingel Oostkant
666,R10 414,2023-08-22,23:00:00,11,1,10,FMN 19 Binnensingel Oostkant
666,R10 414,2023-08-23,00:00:00,11,3,8,FMN 19 Binnensingel Oostkant
666,R10 414,2023-08-23,01:00:00,1,0,1,FMN 19 Binnensingel Oostkant
666,R10 414,2023-08-23,02:00:00,2,0,2,FMN 19 Binnensingel Oostkant
666,R10 414,2023-08-23,03:00:00,1,1,0,FMN 19 Binnensingel Oostkant
666,R10 414,2023-08-23,04:00:00,1,0,1,FMN 19 Binnensingel Oostkant
666,R10 414,2023-08-23,05:00:00,8,5,3,FMN 19 Binnensingel Oostkant
666,R10 414,2023-08-23,06:00:00,10,7,3,FMN 19 Binnensingel Oostkant
666,R10 414,2023-08-23,07:00:00,11,2,9,FMN 19 Binnensingel Oostkant
666,R10 414,2023-08-23,08:00:00,13,4,9,FMN 19 Binnensingel Oostkant
666,R10 414,2023-08-23,09:00:00,10,1,9,FMN 19 Binnensingel Oostkant
666,R10 414,2023-08-23,10:00:00,5,1,4,FMN 19 Binnensingel Oostkant
666,R10 414,2023-08-23,11:00:00,14,3,11,FMN 19 Binnensingel Oostkant
666,R10 414,2023-08-23,12:00:00,12,3,9,FMN 19 Binnensingel Oostkant
666,R10 414,2023-08-23,13:00:00,16,7,9,FMN 19 Binnensingel Oostkant
666,R10 414,2023-08-23,14:00:00,8,2,6,FMN 19 Binnensingel Oostkant
666,R10 414,2023-08-23,15:00:00,13,1,12,FMN 19 Binnensingel Oostkant
666,R10 414,2023-08-23,16:00:00,11,4,7,FMN 19 Binnensingel Oostkant
666,R10 414,2023-08-23,17:00:00,13,4,9,FMN 19 Binnensingel Oostkant
666,R10 414,2023-08-23,18:00:00,11,5,6,FMN 19 Binnensingel Oostkant
666,R10 414,2023-08-23,19:00:00,11,3,8,FMN 19 Binnensingel Oostkant
666,R10 414,2023-08-23,20:00:00,6,2,4,FMN 19 Binnensingel Oostkant
666,R10 414,2023-08-23,21:00:00,9,2,7,FMN 19 Binnensingel Oostkant
666,R10 414,2023-08-23,22:00:00,5,0,5,FMN 19 Binnensingel Oostkant
666,R10 414,2023-08-23,23:00:00,6,1,5,FMN 19 Binnensingel Oostkant
666,R10 414,2023-08-24,00:00:00,5,2,3,FMN 19 Binnensingel Oostkant
666,R10 414,2023-08-24,01:00:00,0,0,0,FMN 19 Binnensingel Oostkant
666,R10 414,2023-08-24,02:00:00,0,0,0,FMN 19 Binnensingel Oostkant
666,R10 414,2023-08-24,03:00:00,0,0,0,FMN 19 Binnensingel Oostkant
666,R10 414,2023-08-24,04:00:00,2,0,2,FMN 19 Binnensingel Oostkant
666,R10 414,2023-08-24,05:00:00,4,2,2,FMN 19 Binnensingel Oostkant
666,R10 414,2023-08-24,06:00:00,14,9,5,FMN 19 Binnensingel Oostkant
666,R10 414,2023-08-24,07:00:00,9,5,4,FMN 19 Binnensingel Oostkant
666,R10 414,2023-08-24,08:00:00,13,2,11,FMN 19 Binnensingel Oostkant
666,R10 414,2023-08-24,09:00:00,12,3,9,FMN 19 Binnensingel Oostkant
666,R10 414,2023-08-24,10:00:00,2,1,1,FMN 19 Binnensingel Oostkant
666,R10 414,2023-08-24,11:00:00,10,4,6,FMN 19 Binnensingel Oostkant
666,R10 414,2023-08-24,12:00:00,9,0,9,FMN 19 Binnensingel Oostkant
666,R10 414,2023-08-24,13:00:00,5,1,4,FMN 19 Binnensingel Oostkant
666,R10 414,2023-08-24,14:00:00,9,5,4,FMN 19 Binnensingel Oostkant
666,R10 414,2023-08-24,15:00:00,9,3,6,FMN 19 Binnensingel Oostkant
666,R10 414,2023-08-24,16:00:00,16,3,13,FMN 19 Binnensingel Oostkant
666,R10 414,2023-08-24,17:00:00,19,6,13,FMN 19 Binnensingel Oostkant
666,R10 414,2023-08-24,18:00:00,17,6,11,FMN 19 Binnensingel Oostkant
666,R10 414,2023-08-24,19:00:00,7,2,5,FMN 19 Binnensingel Oostkant
666,R10 414,2023-08-24,20:00:00,17,1,16,FMN 19 Binnensingel Oostkant
666,R10 414,2023-08-24,21:00:00,5,1,4,FMN 19 Binnensingel Oostkant
666,R10 414,2023-08-24,22:00:00,10,2,8,FMN 19 Binnensingel Oostkant
666,R10 414,2023-08-24,23:00:00,1,0,1,FMN 19 Binnensingel Oostkant
666,R10 414,2023-08-25,00:00:00,5,2,3,FMN 19 Binnensingel Oostkant
666,R10 414,2023-08-25,01:00:00,0,0,0,FMN 19 Binnensingel Oostkant
666,R10 414,2023-08-25,02:00:00,5,0,5,FMN 19 Binnensingel Oostkant
666,R10 414,2023-08-25,03:00:00,0,0,0,FMN 19 Binnensingel Oostkant
666,R10 414,2023-08-25,04:00:00,0,0,0,FMN 19 Binnensingel Oostkant
666,R10 414,2023-08-25,05:00:00,5,3,2,FMN 19 Binnensingel Oostkant
666,R10 414,2023-08-25,06:00:00,7,4,3,FMN 19 Binnensingel Oostkant
666,R10 414,2023-08-25,07:00:00,5,2,3,FMN 19 Binnensingel Oostkant
666,R10 414,2023-08-25,08:00:00,13,1,12,FMN 19 Binnensingel Oostkant
666,R10 414,2023-08-25,09:00:00,5,2,3,FMN 19 Binnensingel Oostkant
666,R10 414,2023-08-25,10:00:00,7,2,5,FMN 19 Binnensingel Oostkant
666,R10 414,2023-08-25,11:00:00,3,1,2,FMN 19 Binnensingel Oostkant
666,R10 414,2023-08-25,12:00:00,10,2,8,FMN 19 Binnensingel Oostkant
666,R10 414,2023-08-25,13:00:00,9,4,5,FMN 19 Binnensingel Oostkant
666,R10 414,2023-08-25,14:00:00,7,5,2,FMN 19 Binnensingel Oostkant
666,R10 414,2023-08-25,15:00:00,12,3,9,FMN 19 Binnensingel Oostkant
666,R10 414,2023-08-25,16:00:00,14,4,10,FMN 19 Binnensingel Oostkant
666,R10 414,2023-08-25,17:00:00,21,8,13,FMN 19 Binnensingel Oostkant
666,R10 414,2023-08-25,18:00:00,17,3,14,FMN 19 Binnensingel Oostkant
666,R10 414,2023-08-25,19:00:00,13,4,9,FMN 19 Binnensingel Oostkant
666,R10 414,2023-08-25,20:00:00,5,1,4,FMN 19 Binnensingel Oostkant
666,R10 414,2023-08-25,21:00:00,10,0,10,FMN 19 Binnensingel Oostkant
666,R10 414,2023-08-25,22:00:00,5,1,4,FMN 19 Binnensingel Oostkant
666,R10 414,2023-08-25,23:00:00,2,1,1,FMN 19 Binnensingel Oostkant
666,R10 414,2023-08-26,00:00:00,2,2,0,FMN 19 Binnensingel Oostkant
666,R10 414,2023-08-26,01:00:00,5,2,3,FMN 19 Binnensingel Oostkant
666,R10 414,2023-08-26,02:00:00,8,4,4,FMN 19 Binnensingel Oostkant
666,R10 414,2023-08-26,03:00:00,0,0,0,FMN 19 Binnensingel Oostkant
666,R10 414,2023-08-26,04:00:00,4,0,4,FMN 19 Binnensingel Oostkant
666,R10 414,2023-08-26,05:00:00,0,0,0,FMN 19 Binnensingel Oostkant
666,R10 414,2023-08-26,06:00:00,2,1,1,FMN 19 Binnensingel Oostkant
666,R10 414,2023-08-26,07:00:00,1,1,0,FMN 19 Binnensingel Oostkant
666,R10 414,2023-08-26,08:00:00,4,0,4,FMN 19 Binnensingel Oostkant
666,R10 414,2023-08-26,09:00:00,3,1,2,FMN 19 Binnensingel Oostkant
666,R10 414,2023-08-26,10:00:00,5,2,3,FMN 19 Binnensingel Oostkant
666,R10 414,2023-08-26,11:00:00,8,2,6,FMN 19 Binnensingel Oostkant
666,R10 414,2023-08-26,12:00:00,7,2,5,FMN 19 Binnensingel Oostkant
666,R10 414,2023-08-26,13:00:00,6,0,6,FMN 19 Binnensingel Oostkant
666,R10 414,2023-08-26,14:00:00,13,3,10,FMN 19 Binnensingel Oostkant
666,R10 414,2023-08-26,15:00:00,15,5,10,FMN 19 Binnensingel Oostkant
666,R10 414,2023-08-26,16:00:00,6,2,4,FMN 19 Binnensingel Oostkant
666,R10 414,2023-08-26,17:00:00,15,9,6,FMN 19 Binnensingel Oostkant
666,R10 414,2023-08-26,18:00:00,4,0,4,FMN 19 Binnensingel Oostkant
666,R10 414,2023-08-26,19:00:00,11,1,10,FMN 19 Binnensingel Oostkant
666,R10 414,2023-08-26,20:00:00,11,2,9,FMN 19 Binnensingel Oostkant
666,R10 414,2023-08-26,21:00:00,6,0,6,FMN 19 Binnensingel Oostkant
666,R10 414,2023-08-26,22:00:00,8,3,5,FMN 19 Binnensingel Oostkant
666,R10 414,2023-08-26,23:00:00,7,1,6,FMN 19 Binnensingel Oostkant
666,R10 414,2023-08-27,00:00:00,10,1,9,FMN 19 Binnensingel Oostkant
666,R10 414,2023-08-27,01:00:00,5,3,2,FMN 19 Binnensingel Oostkant
666,R10 414,2023-08-27,02:00:00,5,3,2,FMN 19 Binnensingel Oostkant
666,R10 414,2023-08-27,03:00:00,3,2,1,FMN 19 Binnensingel Oostkant
666,R10 414,2023-08-27,04:00:00,3,0,3,FMN 19 Binnensingel Oostkant
666,R10 414,2023-08-27,05:00:00,3,1,2,FMN 19 Binnensingel Oostkant
666,R10 414,2023-08-27,06:00:00,0,0,0,FMN 19 Binnensingel Oostkant
666,R10 414,2023-08-27,07:00:00,1,1,0,FMN 19 Binnensingel Oostkant
666,R10 414,2023-08-27,08:00:00,3,0,3,FMN 19 Binnensingel Oostkant
666,R10 414,2023-08-27,09:00:00,16,1,15,FMN 19 Binnensingel Oostkant
666,R10 414,2023-08-27,10:00:00,5,0,5,FMN 19 Binnensingel Oostkant
666,R10 414,2023-08-27,11:00:00,12,4,8,FMN 19 Binnensingel Oostkant
666,R10 414,2023-08-27,12:00:00,12,4,8,FMN 19 Binnensingel Oostkant
666,R10 414,2023-08-27,13:00:00,7,5,2,FMN 19 Binnensingel Oostkant
666,R10 414,2023-08-27,14:00:00,12,0,12,FMN 19 Binnensingel Oostkant
666,R10 414,2023-08-27,15:00:00,8,3,5,FMN 19 Binnensingel Oostkant
666,R10 414,2023-08-27,16:00:00,5,2,3,FMN 19 Binnensingel Oostkant
666,R10 414,2023-08-27,17:00:00,10,4,6,FMN 19 Binnensingel Oostkant
666,R10 414,2023-08-27,18:00:00,12,5,7,FMN 19 Binnensingel Oostkant
666,R10 414,2023-08-27,19:00:00,15,3,12,FMN 19 Binnensingel Oostkant
666,R10 414,2023-08-27,20:00:00,9,5,4,FMN 19 Binnensingel Oostkant
666,R10 414,2023-08-27,21:00:00,4,0,4,FMN 19 Binnensingel Oostkant
666,R10 414,2023-08-27,22:00:00,2,2,0,FMN 19 Binnensingel Oostkant
666,R10 414,2023-08-27,23:00:00,1,0,1,FMN 19 Binnensingel Oostkant
666,R10 414,2023-08-28,00:00:00,7,4,3,FMN 19 Binnensingel Oostkant
666,R10 414,2023-08-28,01:00:00,0,0,0,FMN 19 Binnensingel Oostkant
666,R10 414,2023-08-28,02:00:00,2,1,1,FMN 19 Binnensingel Oostkant
666,R10 414,2023-08-28,03:00:00,1,0,1,FMN 19 Binnensingel Oostkant
666,R10 414,2023-08-28,04:00:00,0,0,0,FMN 19 Binnensingel Oostkant
666,R10 414,2023-08-28,05:00:00,9,2,7,FMN 19 Binnensingel Oostkant
666,R10 414,2023-08-28,06:00:00,8,3,5,FMN 19 Binnensingel Oostkant
666,R10 414,2023-08-28,07:00:00,10,3,7,FMN 19 Binnensingel Oostkant
666,R10 414,2023-08-28,08:00:00,21,4,17,FMN 19 Binnensingel Oostkant
666,R10 414,2023-08-28,09:00:00,8,5,3,FMN 19 Binnensingel Oostkant
666,R10 414,2023-08-28,10:00:00,4,2,2,FMN 19 Binnensingel Oostkant
666,R10 414,2023-08-28,11:00:00,8,1,7,FMN 19 Binnensingel Oostkant
666,R10 414,2023-08-28,12:00:00,10,0,10,FMN 19 Binnensingel Oostkant
666,R10 414,2023-08-28,13:00:00,11,3,8,FMN 19 Binnensingel Oostkant
666,R10 414,2023-08-28,14:00:00,10,5,5,FMN 19 Binnensingel Oostkant
666,R10 414,2023-08-28,15:00:00,16,5,11,FMN 19 Binnensingel Oostkant
666,R10 414,2023-08-28,16:00:00,12,5,7,FMN 19 Binnensingel Oostkant
666,R10 414,2023-08-28,17:00:00,16,4,12,FMN 19 Binnensingel Oostkant
666,R10 414,2023-08-28,18:00:00,22,5,17,FMN 19 Binnensingel Oostkant
666,R10 414,2023-08-28,19:00:00,7,3,4,FMN 19 Binnensingel Oostkant
666,R10 414,2023-08-28,20:00:00,5,2,3,FMN 19 Binnensingel Oostkant
666,R10 414,2023-08-28,21:00:00,3,1,2,FMN 19 Binnensingel Oostkant
666,R10 414,2023-08-28,22:00:00,3,1,2,FMN 19 Binnensingel Oostkant
666,R10 414,2023-08-28,23:00:00,2,0,2,FMN 19 Binnensingel Oostkant
666,R10 414,2023-08-29,00:00:00,1,1,0,FMN 19 Binnensingel Oostkant
666,R10 414,2023-08-29,01:00:00,0,0,0,FMN 19 Binnensingel Oostkant
666,R10 414,2023-08-29,02:00:00,2,0,2,FMN 19 Binnensingel Oostkant
666,R10 414,2023-08-29,03:00:00,0,0,0,FMN 19 Binnensingel Oostkant
666,R10 414,2023-08-29,04:00:00,1,0,1,FMN 19 Binnensingel Oostkant
666,R10 414,2023-08-29,05:00:00,5,1,4,FMN 19 Binnensingel Oostkant
666,R10 414,2023-08-29,06:00:00,9,4,5,FMN 19 Binnensingel Oostkant
666,R10 414,2023-08-29,07:00:00,6,1,5,FMN 19 Binnensingel Oostkant
666,R10 414,2023-08-29,08:00:00,18,3,15,FMN 19 Binnensingel Oostkant
666,R10 414,2023-08-29,09:00:00,6,2,4,FMN 19 Binnensingel Oostkant
666,R10 414,2023-08-29,10:00:00,5,2,3,FMN 19 Binnensingel Oostkant
666,R10 414,2023-08-29,11:00:00,8,2,6,FMN 19 Binnensingel Oostkant
666,R10 414,2023-08-29,12:00:00,12,4,8,FMN 19 Binnensingel Oostkant
666,R10 414,2023-08-29,13:00:00,18,3,15,FMN 19 Binnensingel Oostkant
666,R10 414,2023-08-29,14:00:00,9,1,8,FMN 19 Binnensingel Oostkant
666,R10 414,2023-08-29,15:00:00,18,6,12,FMN 19 Binnensingel Oostkant
666,R10 414,2023-08-29,16:00:00,10,3,7,FMN 19 Binnensingel Oostkant
666,R10 414,2023-08-29,17:00:00,25,7,18,FMN 19 Binnensingel Oostkant
666,R10 414,2023-08-29,18:00:00,17,6,11,FMN 19 Binnensingel Oostkant
666,R10 414,2023-08-29,19:00:00,5,0,5,FMN 19 Binnensingel Oostkant
666,R10 414,2023-08-29,20:00:00,17,6,11,FMN 19 Binnensingel Oostkant
666,R10 414,2023-08-29,21:00:00,5,2,3,FMN 19 Binnensingel Oostkant
666,R10 414,2023-08-29,22:00:00,6,2,4,FMN 19 Binnensingel Oostkant
666,R10 414,2023-08-29,23:00:00,3,1,2,FMN 19 Binnensingel Oostkant
666,R10 414,2023-08-30,00:00:00,2,1,1,FMN 19 Binnensingel Oostkant
666,R10 414,2023-08-30,01:00:00,3,3,0,FMN 19 Binnensingel Oostkant
666,R10 414,2023-08-30,02:00:00,2,1,1,FMN 19 Binnensingel Oostkant
666,R10 414,2023-08-30,03:00:00,1,0,1,FMN 19 Binnensingel Oostkant
666,R10 414,2023-08-30,04:00:00,1,0,1,FMN 19 Binnensingel Oostkant
666,R10 414,2023-08-30,05:00:00,5,1,4,FMN 19 Binnensingel Oostkant
666,R10 414,2023-08-30,06:00:00,2,1,1,FMN 19 Binnensingel Oostkant
666,R10 414,2023-08-30,07:00:00,4,1,3,FMN 19 Binnensingel Oostkant
666,R10 414,2023-08-30,08:00:00,9,0,9,FMN 19 Binnensingel Oostkant
666,R10 414,2023-08-30,09:00:00,5,0,5,FMN 19 Binnensingel Oostkant
666,R10 414,2023-08-30,10:00:00,5,1,4,FMN 19 Binnensingel Oostkant
666,R10 414,2023-08-30,11:00:00,5,1,4,FMN 19 Binnensingel Oostkant
666,R10 414,2023-08-30,12:00:00,8,1,7,FMN 19 Binnensingel Oostkant
666,R10 414,2023-08-30,13:00:00,10,2,8,FMN 19 Binnensingel Oostkant
666,R10 414,2023-08-30,14:00:00,15,6,9,FMN 19 Binnensingel Oostkant
666,R10 414,2023-08-30,15:00:00,6,2,4,FMN 19 Binnensingel Oostkant
666,R10 414,2023-08-30,16:00:00,15,2,13,FMN 19 Binnensingel Oostkant
666,R10 414,2023-08-30,17:00:00,12,2,10,FMN 19 Binnensingel Oostkant
666,R10 414,2023-08-30,18:00:00,19,5,14,FMN 19 Binnensingel Oostkant
666,R10 414,2023-08-30,19:00:00,12,3,9,FMN 19 Binnensingel Oostkant
666,R10 414,2023-08-30,20:00:00,8,2,6,FMN 19 Binnensingel Oostkant
666,R10 414,2023-08-30,21:00:00,6,3,3,FMN 19 Binnensingel Oostkant
666,R10 414,2023-08-30,22:00:00,5,2,3,FMN 19 Binnensingel Oostkant
666,R10 414,2023-08-30,23:00:00,4,1,3,FMN 19 Binnensingel Oostkant
666,R10 414,2023-08-31,00:00:00,3,2,1,FMN 19 Binnensingel Oostkant
666,R10 414,2023-08-31,01:00:00,2,0,2,FMN 19 Binnensingel Oostkant
666,R10 414,2023-08-31,02:00:00,2,0,2,FMN 19 Binnensingel Oostkant
666,R10 414,2023-08-31,03:00:00,0,0,0,FMN 19 Binnensingel Oostkant
666,R10 414,2023-08-31,04:00:00,0,0,0,FMN 19 Binnensingel Oostkant
666,R10 414,2023-08-31,05:00:00,3,1,2,FMN 19 Binnensingel Oostkant
666,R10 414,2023-08-31,06:00:00,6,0,6,FMN 19 Binnensingel Oostkant
666,R10 414,2023-08-31,07:00:00,8,3,5,FMN 19 Binnensingel Oostkant
666,R10 414,2023-08-31,08:00:00,12,3,9,FMN 19 Binnensingel Oostkant
666,R10 414,2023-08-31,09:00:00,7,2,5,FMN 19 Binnensingel Oostkant
666,R10 414,2023-08-31,10:00:00,8,4,4,FMN 19 Binnensingel Oostkant
666,R10 414,2023-08-31,11:00:00,8,1,7,FMN 19 Binnensingel Oostkant
666,R10 414,2023-08-31,12:00:00,9,0,9,FMN 19 Binnensingel Oostkant
666,R10 414,2023-08-31,13:00:00,17,1,16,FMN 19 Binnensingel Oostkant
666,R10 414,2023-08-31,14:00:00,14,7,7,FMN 19 Binnensingel Oostkant
666,R10 414,2023-08-31,15:00:00,20,2,18,FMN 19 Binnensingel Oostkant
666,R10 414,2023-08-31,16:00:00,14,2,12,FMN 19 Binnensingel Oostkant
666,R10 414,2023-08-31,17:00:00,17,6,11,FMN 19 Binnensingel Oostkant
666,R10 414,2023-08-31,18:00:00,15,6,9,FMN 19 Binnensingel Oostkant
666,R10 414,2023-08-31,19:00:00,16,4,12,FMN 19 Binnensingel Oostkant
666,R10 414,2023-08-31,20:00:00,21,8,13,FMN 19 Binnensingel Oostkant
666,R10 414,2023-08-31,21:00:00,10,1,9,FMN 19 Binnensingel Oostkant
666,R10 414,2023-08-31,22:00:00,6,1,5,FMN 19 Binnensingel Oostkant
666,R10 414,2023-08-31,23:00:00,3,0,3,FMN 19 Binnensingel Oostkant
666,R10 414,2023-09-01,00:00:00,1,0,1,FMN 19 Binnensingel Oostkant
666,R10 414,2023-09-01,01:00:00,0,0,0,FMN 19 Binnensingel Oostkant
666,R10 414,2023-09-01,02:00:00,1,1,0,FMN 19 Binnensingel Oostkant
666,R10 414,2023-09-01,03:00:00,0,0,0,FMN 19 Binnensingel Oostkant
666,R10 414,2023-09-01,04:00:00,1,0,1,FMN 19 Binnensingel Oostkant
666,R10 414,2023-09-01,05:00:00,7,1,6,FMN 19 Binnensingel Oostkant
666,R10 414,2023-09-01,06:00:00,11,5,6,FMN 19 Binnensingel Oostkant
666,R10 414,2023-09-01,07:00:00,9,2,7,FMN 19 Binnensingel Oostkant
666,R10 414,2023-09-01,08:00:00,16,5,11,FMN 19 Binnensingel Oostkant
666,R10 414,2023-09-01,09:00:00,17,5,12,FMN 19 Binnensingel Oostkant
666,R10 414,2023-09-01,10:00:00,2,2,0,FMN 19 Binnensingel Oostkant
666,R10 414,2023-09-01,11:00:00,5,3,2,FMN 19 Binnensingel Oostkant
666,R10 414,2023-09-01,12:00:00,11,7,4,FMN 19 Binnensingel Oostkant
666,R10 414,2023-09-01,13:00:00,15,11,4,FMN 19 Binnensingel Oostkant
666,R10 414,2023-09-01,14:00:00,20,10,10,FMN 19 Binnensingel Oostkant
666,R10 414,2023-09-01,15:00:00,18,13,5,FMN 19 Binnensingel Oostkant
666,R10 414,2023-09-01,16:00:00,17,7,10,FMN 19 Binnensingel Oostkant
666,R10 414,2023-09-01,17:00:00,19,12,7,FMN 19 Binnensingel Oostkant
666,R10 414,2023-09-01,18:00:00,22,14,8,FMN 19 Binnensingel Oostkant
666,R10 414,2023-09-01,19:00:00,19,12,7,FMN 19 Binnensingel Oostkant
666,R10 414,2023-09-01,20:00:00,23,10,13,FMN 19 Binnensingel Oostkant
666,R10 414,2023-09-01,21:00:00,9,6,3,FMN 19 Binnensingel Oostkant
666,R10 414,2023-09-01,22:00:00,7,3,4,FMN 19 Binnensingel Oostkant
666,R10 414,2023-09-01,23:00:00,10,5,5,FMN 19 Binnensingel Oostkant
666,R10 414,2023-09-02,00:00:00,6,4,2,FMN 19 Binnensingel Oostkant
666,R10 414,2023-09-02,01:00:00,5,2,3,FMN 19 Binnensingel Oostkant
666,R10 414,2023-09-02,02:00:00,3,0,3,FMN 19 Binnensingel Oostkant
666,R10 414,2023-09-02,03:00:00,2,2,0,FMN 19 Binnensingel Oostkant
666,R10 414,2023-09-02,04:00:00,4,3,1,FMN 19 Binnensingel Oostkant
666,R10 414,2023-09-02,05:00:00,2,0,2,FMN 19 Binnensingel Oostkant
666,R10 414,2023-09-02,06:00:00,9,7,2,FMN 19 Binnensingel Oostkant
666,R10 414,2023-09-02,07:00:00,7,3,4,FMN 19 Binnensingel Oostkant
666,R10 414,2023-09-02,08:00:00,6,4,2,FMN 19 Binnensingel Oostkant
666,R10 414,2023-09-02,09:00:00,12,8,4,FMN 19 Binnensingel Oostkant
666,R10 414,2023-09-02,10:00:00,9,3,6,FMN 19 Binnensingel Oostkant
666,R10 414,2023-09-02,11:00:00,9,5,4,FMN 19 Binnensingel Oostkant
666,R10 414,2023-09-02,12:00:00,21,7,14,FMN 19 Binnensingel Oostkant
666,R10 414,2023-09-02,13:00:00,13,4,9,FMN 19 Binnensingel Oostkant
666,R10 414,2023-09-02,14:00:00,20,10,10,FMN 19 Binnensingel Oostkant
666,R10 414,2023-09-02,15:00:00,20,6,14,FMN 19 Binnensingel Oostkant
666,R10 414,2023-09-02,16:00:00,15,4,11,FMN 19 Binnensingel Oostkant
666,R10 414,2023-09-02,17:00:00,19,8,11,FMN 19 Binnensingel Oostkant
666,R10 414,2023-09-02,18:00:00,22,14,8,FMN 19 Binnensingel Oostkant
666,R10 414,2023-09-02,19:00:00,24,11,13,FMN 19 Binnensingel Oostkant
666,R10 414,2023-09-02,20:00:00,21,13,8,FMN 19 Binnensingel Oostkant
666,R10 414,2023-09-02,21:00:00,14,9,5,FMN 19 Binnensingel Oostkant
666,R10 414,2023-09-02,22:00:00,16,4,12,FMN 19 Binnensingel Oostkant
666,R10 414,2023-09-02,23:00:00,11,7,4,FMN 19 Binnensingel Oostkant
666,R10 414,2023-09-03,00:00:00,17,15,2,FMN 19 Binnensingel Oostkant
666,R10 414,2023-09-03,01:00:00,9,4,5,FMN 19 Binnensingel Oostkant
666,R10 414,2023-09-03,02:00:00,4,3,1,FMN 19 Binnensingel Oostkant
666,R10 414,2023-09-03,03:00:00,1,1,0,FMN 19 Binnensingel Oostkant
666,R10 414,2023-09-03,04:00:00,3,0,3,FMN 19 Binnensingel Oostkant
666,R10 414,2023-09-03,05:00:00,0,0,0,FMN 19 Binnensingel Oostkant
666,R10 414,2023-09-03,06:00:00,2,1,1,FMN 19 Binnensingel Oostkant
666,R10 414,2023-09-03,07:00:00,2,2,0,FMN 19 Binnensingel Oostkant
666,R10 414,2023-09-03,08:00:00,5,2,3,FMN 19 Binnensingel Oostkant
666,R10 414,2023-09-03,09:00:00,13,8,5,FMN 19 Binnensingel Oostkant
666,R10 414,2023-09-03,10:00:00,16,9,7,FMN 19 Binnensingel Oostkant
666,R10 414,2023-09-03,11:00:00,20,13,7,FMN 19 Binnensingel Oostkant
666,R10 414,2023-09-03,12:00:00,27,17,10,FMN 19 Binnensingel Oostkant
666,R10 414,2023-09-03,13:00:00,25,19,6,FMN 19 Binnensingel Oostkant
666,R10 414,2023-09-03,14:00:00,19,5,14,FMN 19 Binnensingel Oostkant
666,R10 414,2023-09-03,15:00:00,17,6,11,FMN 19 Binnensingel Oostkant
666,R10 414,2023-09-03,16:00:00,33,17,16,FMN 19 Binnensingel Oostkant
666,R10 414,2023-09-03,17:00:00,13,8,5,FMN 19 Binnensingel Oostkant
666,R10 414,2023-09-03,18:00:00,27,16,11,FMN 19 Binnensingel Oostkant
666,R10 414,2023-09-03,19:00:00,13,4,9,FMN 19 Binnensingel Oostkant
666,R10 414,2023-09-03,20:00:00,12,5,7,FMN 19 Binnensingel Oostkant
666,R10 414,2023-09-03,21:00:00,4,1,3,FMN 19 Binnensingel Oostkant
666,R10 414,2023-09-03,22:00:00,5,4,1,FMN 19 Binnensingel Oostkant
666,R10 414,2023-09-03,23:00:00,5,4,1,FMN 19 Binnensingel Oostkant
666,R10 414,2023-09-04,00:00:00,6,6,0,FMN 19 Binnensingel Oostkant
666,R10 414,2023-09-04,01:00:00,4,3,1,FMN 19 Binnensingel Oostkant
666,R10 414,2023-09-04,02:00:00,1,1,0,FMN 19 Binnensingel Oostkant
666,R10 414,2023-09-04,03:00:00,3,2,1,FMN 19 Binnensingel Oostkant
666,R10 414,2023-09-04,04:00:00,2,1,1,FMN 19 Binnensingel Oostkant
666,R10 414,2023-09-04,05:00:00,15,8,7,FMN 19 Binnensingel Oostkant
666,R10 414,2023-09-04,06:00:00,20,14,6,FMN 19 Binnensingel Oostkant
666,R10 414,2023-09-04,07:00:00,83,69,14,FMN 19 Binnensingel Oostkant
666,R10 414,2023-09-04,08:00:00,98,70,28,FMN 19 Binnensingel Oostkant
666,R10 414,2023-09-04,09:00:00,37,32,5,FMN 19 Binnensingel Oostkant
666,R10 414,2023-09-04,10:00:00,51,42,9,FMN 19 Binnensingel Oostkant
666,R10 414,2023-09-04,11:00:00,39,27,12,FMN 19 Binnensingel Oostkant
666,R10 414,2023-09-04,12:00:00,63,47,16,FMN 19 Binnensingel Oostkant
666,R10 414,2023-09-04,13:00:00,63,50,13,FMN 19 Binnensingel Oostkant
666,R10 414,2023-09-04,14:00:00,60,49,11,FMN 19 Binnensingel Oostkant
666,R10 414,2023-09-04,15:00:00,84,58,26,FMN 19 Binnensingel Oostkant
666,R10 414,2023-09-04,16:00:00,121,95,26,FMN 19 Binnensingel Oostkant
666,R10 414,2023-09-04,17:00:00,115,85,30,FMN 19 Binnensingel Oostkant
666,R10 414,2023-09-04,18:00:00,107,68,39,FMN 19 Binnensingel Oostkant
666,R10 414,2023-09-04,19:00:00,66,48,18,FMN 19 Binnensingel Oostkant
666,R10 414,2023-09-04,20:00:00,40,28,12,FMN 19 Binnensingel Oostkant
666,R10 414,2023-09-04,21:00:00,48,37,11,FMN 19 Binnensingel Oostkant
666,R10 414,2023-09-04,22:00:00,32,28,4,FMN 19 Binnensingel Oostkant
666,R10 414,2023-09-04,23:00:00,17,13,4,FMN 19 Binnensingel Oostkant
666,R10 414,2023-09-05,00:00:00,6,4,2,FMN 19 Binnensingel Oostkant
666,R10 414,2023-09-05,01:00:00,2,2,0,FMN 19 Binnensingel Oostkant
666,R10 414,2023-09-05,02:00:00,0,0,0,FMN 19 Binnensingel Oostkant
666,R10 414,2023-09-05,03:00:00,3,3,0,FMN 19 Binnensingel Oostkant
666,R10 414,2023-09-05,04:00:00,6,1,5,FMN 19 Binnensingel Oostkant
666,R10 414,2023-09-05,05:00:00,20,10,10,FMN 19 Binnensingel Oostkant
666,R10 414,2023-09-05,06:00:00,38,23,15,FMN 19 Binnensingel Oostkant
666,R10 414,2023-09-05,07:00:00,102,81,21,FMN 19 Binnensingel Oostkant
666,R10 414,2023-09-05,08:00:00,117,86,31,FMN 19 Binnensingel Oostkant
666,R10 414,2023-09-05,09:00:00,50,37,13,FMN 19 Binnensingel Oostkant
666,R10 414,2023-09-05,10:00:00,52,43,9,FMN 19 Binnensingel Oostkant
666,R10 414,2023-09-05,11:00:00,51,36,15,FMN 19 Binnensingel Oostkant
666,R10 414,2023-09-05,12:00:00,78,55,23,FMN 19 Binnensingel Oostkant
666,R10 414,2023-09-05,13:00:00,65,47,18,FMN 19 Binnensingel Oostkant
666,R10 414,2023-09-05,14:00:00,65,54,11,FMN 19 Binnensingel Oostkant
666,R10 414,2023-09-05,15:00:00,128,104,24,FMN 19 Binnensingel Oostkant
666,R10 414,2023-09-05,16:00:00,147,119,28,FMN 19 Binnensingel Oostkant
666,R10 414,2023-09-05,17:00:00,172,120,52,FMN 19 Binnensingel Oostkant
666,R10 414,2023-09-05,18:00:00,123,91,32,FMN 19 Binnensingel Oostkant
666,R10 414,2023-09-05,19:00:00,100,76,24,FMN 19 Binnensingel Oostkant
666,R10 414,2023-09-05,20:00:00,93,73,20,FMN 19 Binnensingel Oostkant
666,R10 414,2023-09-05,21:00:00,59,47,12,FMN 19 Binnensingel Oostkant
666,R10 414,2023-09-05,22:00:00,79,66,13,FMN 19 Binnensingel Oostkant
666,R10 414,2023-09-05,23:00:00,40,33,7,FMN 19 Binnensingel Oostkant
666,R10 414,2023-09-06,00:00:00,5,4,1,FMN 19 Binnensingel Oostkant
666,R10 414,2023-09-06,01:00:00,3,2,1,FMN 19 Binnensingel Oostkant
666,R10 414,2023-09-06,02:00:00,5,4,1,FMN 19 Binnensingel Oostkant
666,R10 414,2023-09-06,03:00:00,4,3,1,FMN 19 Binnensingel Oostkant
666,R10 414,2023-09-06,04:00:00,7,3,4,FMN 19 Binnensingel Oostkant
666,R10 414,2023-09-06,05:00:00,25,13,12,FMN 19 Binnensingel Oostkant
666,R10 414,2023-09-06,06:00:00,32,17,15,FMN 19 Binnensingel Oostkant
666,R10 414,2023-09-06,07:00:00,116,86,30,FMN 19 Binnensingel Oostkant
666,R10 414,2023-09-06,08:00:00,134,104,30,FMN 19 Binnensingel Oostkant
666,R10 414,2023-09-06,09:00:00,85,47,38,FMN 19 Binnensingel Oostkant
666,R10 414,2023-09-06,10:00:00,41,30,11,FMN 19 Binnensingel Oostkant
666,R10 414,2023-09-06,11:00:00,75,54,21,FMN 19 Binnensingel Oostkant
666,R10 414,2023-09-06,12:00:00,103,82,21,FMN 19 Binnensingel Oostkant
666,R10 414,2023-09-06,13:00:00,74,55,19,FMN 19 Binnensingel Oostkant
666,R10 414,2023-09-06,14:00:00,66,43,23,FMN 19 Binnensingel Oostkant
666,R10 414,2023-09-06,15:00:00,63,50,13,FMN 19 Binnensingel Oostkant
666,R10 414,2023-09-06,16:00:00,116,83,33,FMN 19 Binnensingel Oostkant
666,R10 414,2023-09-06,17:00:00,165,124,41,FMN 19 Binnensingel Oostkant
666,R10 414,2023-09-06,18:00:00,139,102,37,FMN 19 Binnensingel Oostkant
666,R10 414,2023-09-06,19:00:00,72,52,20,FMN 19 Binnensingel Oostkant
666,R10 414,2023-09-06,20:00:00,68,54,14,FMN 19 Binnensingel Oostkant
666,R10 414,2023-09-06,21:00:00,62,45,17,FMN 19 Binnensingel Oostkant
666,R10 414,2023-09-06,22:00:00,65,52,13,FMN 19 Binnensingel Oostkant
666,R10 414,2023-09-06,23:00:00,17,16,1,FMN 19 Binnensingel Oostkant
666,R10 414,2023-09-07,00:00:00,10,8,2,FMN 19 Binnensingel Oostkant
666,R10 414,2023-09-07,01:00:00,5,5,0,FMN 19 Binnensingel Oostkant
666,R10 414,2023-09-07,02:00:00,4,3,1,FMN 19 Binnensingel Oostkant
666,R10 414,2023-09-07,03:00:00,3,3,0,FMN 19 Binnensingel Oostkant
666,R10 414,2023-09-07,04:00:00,6,4,2,FMN 19 Binnensingel Oostkant
666,R10 414,2023-09-07,05:00:00,26,14,12,FMN 19 Binnensingel Oostkant
666,R10 414,2023-09-07,06:00:00,47,25,22,FMN 19 Binnensingel Oostkant
666,R10 414,2023-09-07,07:00:00,125,91,34,FMN 19 Binnensingel Oostkant
666,R10 414,2023-09-07,08:00:00,137,97,40,FMN 19 Binnensingel Oostkant
666,R10 414,2023-09-07,09:00:00,48,34,14,FMN 19 Binnensingel Oostkant
666,R10 414,2023-09-07,10:00:00,58,42,16,FMN 19 Binnensingel Oostkant
666,R10 414,2023-09-07,11:00:00,38,32,6,FMN 19 Binnensingel Oostkant
666,R10 414,2023-09-07,12:00:00,93,68,25,FMN 19 Binnensingel Oostkant
666,R10 414,2023-09-07,13:00:00,73,51,22,FMN 19 Binnensingel Oostkant
666,R10 414,2023-09-07,14:00:00,60,44,16,FMN 19 Binnensingel Oostkant
666,R10 414,2023-09-07,15:00:00,113,91,22,FMN 19 Binnensingel Oostkant
666,R10 414,2023-09-07,16:00:00,180,121,59,FMN 19 Binnensingel Oostkant
666,R10 414,2023-09-07,17:00:00,161,119,42,FMN 19 Binnensingel Oostkant
666,R10 414,2023-09-07,18:00:00,126,76,50,FMN 19 Binnensingel Oostkant
666,R10 414,2023-09-07,19:00:00,100,74,26,FMN 19 Binnensingel Oostkant
666,R10 414,2023-09-07,20:00:00,63,49,14,FMN 19 Binnensingel Oostkant
666,R10 414,2023-09-07,21:00:00,67,54,13,FMN 19 Binnensingel Oostkant
666,R10 414,2023-09-07,22:00:00,70,54,16,FMN 19 Binnensingel Oostkant
666,R10 414,2023-09-07,23:00:00,31,23,8,FMN 19 Binnensingel Oostkant
666,R10 414,2023-09-08,00:00:00,17,12,5,FMN 19 Binnensingel Oostkant
666,R10 414,2023-09-08,01:00:00,6,5,1,FMN 19 Binnensingel Oostkant
666,R10 414,2023-09-08,02:00:00,5,4,1,FMN 19 Binnensingel Oostkant
666,R10 414,2023-09-08,03:00:00,8,5,3,FMN 19 Binnensingel Oostkant
666,R10 414,2023-09-08,04:00:00,6,4,2,FMN 19 Binnensingel Oostkant
666,R10 414,2023-09-08,05:00:00,23,12,11,FMN 19 Binnensingel Oostkant
666,R10 414,2023-09-08,06:00:00,38,18,20,FMN 19 Binnensingel Oostkant
666,R10 414,2023-09-08,07:00:00,104,77,27,FMN 19 Binnensingel Oostkant
666,R10 414,2023-09-08,08:00:00,123,86,37,FMN 19 Binnensingel Oostkant
666,R10 414,2023-09-08,09:00:00,55,38,17,FMN 19 Binnensingel Oostkant
666,R10 414,2023-09-08,10:00:00,43,32,11,FMN 19 Binnensingel Oostkant
666,R10 414,2023-09-08,11:00:00,48,39,9,FMN 19 Binnensingel Oostkant
666,R10 414,2023-09-08,12:00:00,79,59,20,FMN 19 Binnensingel Oostkant
666,R10 414,2023-09-08,13:00:00,84,58,26,FMN 19 Binnensingel Oostkant
666,R10 414,2023-09-08,14:00:00,73,56,17,FMN 19 Binnensingel Oostkant
666,R10 414,2023-09-08,15:00:00,109,83,26,FMN 19 Binnensingel Oostkant
666,R10 414,2023-09-08,16:00:00,124,91,33,FMN 19 Binnensingel Oostkant
666,R10 414,2023-09-08,17:00:00,133,91,42,FMN 19 Binnensingel Oostkant
666,R10 414,2023-09-08,18:00:00,138,94,44,FMN 19 Binnensingel Oostkant
666,R10 414,2023-09-08,19:00:00,101,80,21,FMN 19 Binnensingel Oostkant
666,R10 414,2023-09-08,20:00:00,92,71,21,FMN 19 Binnensingel Oostkant
666,R10 414,2023-09-08,21:00:00,81,61,20,FMN 19 Binnensingel Oostkant
666,R10 414,2023-09-08,22:00:00,81,52,29,FMN 19 Binnensingel Oostkant
666,R10 414,2023-09-08,23:00:00,64,41,23,FMN 19 Binnensingel Oostkant
666,R10 414,2023-09-09,00:00:00,26,18,8,FMN 19 Binnensingel Oostkant
666,R10 414,2023-09-09,01:00:00,19,12,7,FMN 19 Binnensingel Oostkant
666,R10 414,2023-09-09,02:00:00,38,32,6,FMN 19 Binnensingel Oostkant
666,R10 414,2023-09-09,03:00:00,13,13,0,FMN 19 Binnensingel Oostkant
666,R10 414,2023-09-09,04:00:00,10,8,2,FMN 19 Binnensingel Oostkant
666,R10 414,2023-09-09,05:00:00,6,4,2,FMN 19 Binnensingel Oostkant
666,R10 414,2023-09-09,06:00:00,18,13,5,FMN 19 Binnensingel Oostkant
666,R10 414,2023-09-09,07:00:00,24,19,5,FMN 19 Binnensingel Oostkant
666,R10 414,2023-09-09,08:00:00,27,18,9,FMN 19 Binnensingel Oostkant
666,R10 414,2023-09-09,09:00:00,48,34,14,FMN 19 Binnensingel Oostkant
666,R10 414,2023-09-09,10:00:00,59,42,17,FMN 19 Binnensingel Oostkant
666,R10 414,2023-09-09,11:00:00,44,29,15,FMN 19 Binnensingel Oostkant
666,R10 414,2023-09-09,12:00:00,67,43,24,FMN 19 Binnensingel Oostkant
666,R10 414,2023-09-09,13:00:00,65,48,17,FMN 19 Binnensingel Oostkant
666,R10 414,2023-09-09,14:00:00,53,35,18,FMN 19 Binnensingel Oostkant
666,R10 414,2023-09-09,15:00:00,52,35,17,FMN 19 Binnensingel Oostkant
666,R10 414,2023-09-09,16:00:00,51,39,12,FMN 19 Binnensingel Oostkant
666,R10 414,2023-09-09,17:00:00,51,47,4,FMN 19 Binnensingel Oostkant
666,R10 414,2023-09-09,18:00:00,67,55,12,FMN 19 Binnensingel Oostkant
666,R10 414,2023-09-09,19:00:00,63,46,17,FMN 19 Binnensingel Oostkant
666,R10 414,2023-09-09,20:00:00,69,61,8,FMN 19 Binnensingel Oostkant
666,R10 414,2023-09-09,21:00:00,49,33,16,FMN 19 Binnensingel Oostkant
666,R10 414,2023-09-09,22:00:00,40,30,10,FMN 19 Binnensingel Oostkant
666,R10 414,2023-09-09,23:00:00,46,33,13,FMN 19 Binnensingel Oostkant
666,R10 414,2023-09-10,00:00:00,22,15,7,FMN 19 Binnensingel Oostkant
666,R10 414,2023-09-10,01:00:00,15,12,3,FMN 19 Binnensingel Oostkant
666,R10 414,2023-09-10,02:00:00,20,14,6,FMN 19 Binnensingel Oostkant
666,R10 414,2023-09-10,03:00:00,9,7,2,FMN 19 Binnensingel Oostkant
666,R10 414,2023-09-10,04:00:00,9,6,3,FMN 19 Binnensingel Oostkant
666,R10 414,2023-09-10,05:00:00,9,6,3,FMN 19 Binnensingel Oostkant
666,R10 414,2023-09-10,06:00:00,15,11,4,FMN 19 Binnensingel Oostkant
666,R10 414,2023-09-10,07:00:00,12,10,2,FMN 19 Binnensingel Oostkant
666,R10 414,2023-09-10,08:00:00,35,24,11,FMN 19 Binnensingel Oostkant
666,R10 414,2023-09-10,09:00:00,46,34,12,FMN 19 Binnensingel Oostkant
666,R10 414,2023-09-10,10:00:00,34,22,12,FMN 19 Binnensingel Oostkant
666,R10 414,2023-09-10,11:00:00,51,35,16,FMN 19 Binnensingel Oostkant
666,R10 414,2023-09-10,12:00:00,54,40,14,FMN 19 Binnensingel Oostkant
666,R10 414,2023-09-10,13:00:00,75,50,25,FMN 19 Binnensingel Oostkant
666,R10 414,2023-09-10,14:00:00,87,65,22,FMN 19 Binnensingel Oostkant
666,R10 414,2023-09-10,15:00:00,94,66,28,FMN 19 Binnensingel Oostkant
666,R10 414,2023-09-10,16:00:00,56,41,15,FMN 19 Binnensingel Oostkant
666,R10 414,2023-09-10,17:00:00,52,30,22,FMN 19 Binnensingel Oostkant
666,R10 414,2023-09-10,18:00:00,67,49,18,FMN 19 Binnensingel Oostkant
666,R10 414,2023-09-10,19:00:00,55,43,12,FMN 19 Binnensingel Oostkant
666,R10 414,2023-09-10,20:00:00,52,30,22,FMN 19 Binnensingel Oostkant
666,R10 414,2023-09-10,21:00:00,22,13,9,FMN 19 Binnensingel Oostkant
666,R10 414,2023-09-10,22:00:00,34,23,11,FMN 19 Binnensingel Oostkant
666,R10 414,2023-09-10,23:00:00,16,10,6,FMN 19 Binnensingel Oostkant
666,R10 414,2023-09-11,00:00:00,8,6,2,FMN 19 Binnensingel Oostkant
666,R10 414,2023-09-11,01:00:00,7,5,2,FMN 19 Binnensingel Oostkant
666,R10 414,2023-09-11,02:00:00,1,1,0,FMN 19 Binnensingel Oostkant
666,R10 414,2023-09-11,03:00:00,2,1,1,FMN 19 Binnensingel Oostkant
666,R10 414,2023-09-11,04:00:00,11,7,4,FMN 19 Binnensingel Oostkant
666,R10 414,2023-09-11,05:00:00,17,9,8,FMN 19 Binnensingel Oostkant
666,R10 414,2023-09-11,06:00:00,55,35,20,FMN 19 Binnensingel Oostkant
666,R10 414,2023-09-11,07:00:00,112,80,32,FMN 19 Binnensingel Oostkant
666,R10 414,2023-09-11,08:00:00,132,87,45,FMN 19 Binnensingel Oostkant
666,R10 414,2023-09-11,09:00:00,59,42,17,FMN 19 Binnensingel Oostkant
666,R10 414,2023-09-11,10:00:00,52,38,14,FMN 19 Binnensingel Oostkant
666,R10 414,2023-09-11,11:00:00,59,49,10,FMN 19 Binnensingel Oostkant
666,R10 414,2023-09-11,12:00:00,101,69,32,FMN 19 Binnensingel Oostkant
666,R10 414,2023-09-11,13:00:00,51,34,17,FMN 19 Binnensingel Oostkant
666,R10 414,2023-09-11,14:00:00,64,49,15,FMN 19 Binnensingel Oostkant
666,R10 414,2023-09-11,15:00:00,128,102,26,FMN 19 Binnensingel Oostkant
666,R10 414,2023-09-11,16:00:00,192,143,49,FMN 19 Binnensingel Oostkant
666,R10 414,2023-09-11,17:00:00,150,106,44,FMN 19 Binnensingel Oostkant
666,R10 414,2023-09-11,18:00:00,90,60,30,FMN 19 Binnensingel Oostkant
666,R10 414,2023-09-11,19:00:00,76,54,22,FMN 19 Binnensingel Oostkant
666,R10 414,2023-09-11,20:00:00,64,49,15,FMN 19 Binnensingel Oostkant
666,R10 414,2023-09-11,21:00:00,57,46,11,FMN 19 Binnensingel Oostkant
666,R10 414,2023-09-11,22:00:00,64,45,19,FMN 19 Binnensingel Oostkant
666,R10 414,2023-09-11,23:00:00,22,18,4,FMN 19 Binnensingel Oostkant
666,R10 414,2023-09-12,00:00:00,7,5,2,FMN 19 Binnensingel Oostkant
666,R10 414,2023-09-12,01:00:00,2,1,1,FMN 19 Binnensingel Oostkant
666,R10 414,2023-09-12,02:00:00,3,1,2,FMN 19 Binnensingel Oostkant
666,R10 414,2023-09-12,03:00:00,6,4,2,FMN 19 Binnensingel Oostkant
666,R10 414,2023-09-12,04:00:00,11,4,7,FMN 19 Binnensingel Oostkant
666,R10 414,2023-09-12,05:00:00,18,13,5,FMN 19 Binnensingel Oostkant
666,R10 414,2023-09-12,06:00:00,46,24,22,FMN 19 Binnensingel Oostkant
666,R10 414,2023-09-12,07:00:00,123,89,34,FMN 19 Binnensingel Oostkant
666,R10 414,2023-09-12,08:00:00,177,123,54,FMN 19 Binnensingel Oostkant
666,R10 414,2023-09-12,09:00:00,76,57,19,FMN 19 Binnensingel Oostkant
666,R10 414,2023-09-12,10:00:00,70,40,30,FMN 19 Binnensingel Oostkant
666,R10 414,2023-09-12,11:00:00,63,45,18,FMN 19 Binnensingel Oostkant
666,R10 414,2023-09-12,12:00:00,80,58,22,FMN 19 Binnensingel Oostkant
666,R10 414,2023-09-12,13:00:00,79,53,26,FMN 19 Binnensingel Oostkant
666,R10 414,2023-09-12,14:00:00,67,49,18,FMN 19 Binnensingel Oostkant
666,R10 414,2023-09-12,15:00:00,119,92,27,FMN 19 Binnensingel Oostkant
666,R10 414,2023-09-12,16:00:00,222,167,55,FMN 19 Binnensingel Oostkant
666,R10 414,2023-09-12,17:00:00,178,123,55,FMN 19 Binnensingel Oostkant
666,R10 414,2023-09-12,18:00:00,117,73,44,FMN 19 Binnensingel Oostkant
666,R10 414,2023-09-12,19:00:00,80,54,26,FMN 19 Binnensingel Oostkant
666,R10 414,2023-09-12,20:00:00,60,38,22,FMN 19 Binnensingel Oostkant
666,R10 414,2023-09-12,21:00:00,55,44,11,FMN 19 Binnensingel Oostkant
666,R10 414,2023-09-12,22:00:00,54,43,11,FMN 19 Binnensingel Oostkant
666,R10 414,2023-09-12,23:00:00,14,9,5,FMN 19 Binnensingel Oostkant
666,R10 414,2023-09-13,00:00:00,8,7,1,FMN 19 Binnensingel Oostkant
666,R10 414,2023-09-13,01:00:00,2,2,0,FMN 19 Binnensingel Oostkant
666,R10 414,2023-09-13,02:00:00,2,2,0,FMN 19 Binnensingel Oostkant
666,R10 414,2023-09-13,03:00:00,3,2,1,FMN 19 Binnensingel Oostkant
666,R10 414,2023-09-13,04:00:00,9,5,4,FMN 19 Binnensingel Oostkant
666,R10 414,2023-09-13,05:00:00,23,14,9,FMN 19 Binnensingel Oostkant
666,R10 414,2023-09-13,06:00:00,44,23,21,FMN 19 Binnensingel Oostkant
666,R10 414,2023-09-13,07:00:00,94,60,34,FMN 19 Binnensingel Oostkant
666,R10 414,2023-09-13,08:00:00,140,90,50,FMN 19 Binnensingel Oostkant
666,R10 414,2023-09-13,09:00:00,57,42,15,FMN 19 Binnensingel Oostkant
666,R10 414,2023-09-13,10:00:00,47,32,15,FMN 19 Binnensingel Oostkant
666,R10 414,2023-09-13,11:00:00,57,42,15,FMN 19 Binnensingel Oostkant
666,R10 414,2023-09-13,12:00:00,104,72,32,FMN 19 Binnensingel Oostkant
666,R10 414,2023-09-13,13:00:00,81,64,17,FMN 19 Binnensingel Oostkant
666,R10 414,2023-09-13,14:00:00,73,57,16,FMN 19 Binnensingel Oostkant
666,R10 414,2023-09-13,15:00:00,108,81,27,FMN 19 Binnensingel Oostkant
666,R10 414,2023-09-13,16:00:00,155,117,38,FMN 19 Binnensingel Oostkant
666,R10 414,2023-09-13,17:00:00,163,116,47,FMN 19 Binnensingel Oostkant
666,R10 414,2023-09-13,18:00:00,120,83,37,FMN 19 Binnensingel Oostkant
666,R10 414,2023-09-13,19:00:00,91,62,29,FMN 19 Binnensingel Oostkant
666,R10 414,2023-09-13,20:00:00,75,54,21,FMN 19 Binnensingel Oostkant
666,R10 414,2023-09-13,21:00:00,67,47,20,FMN 19 Binnensingel Oostkant
666,R10 414,2023-09-13,22:00:00,55,44,11,FMN 19 Binnensingel Oostkant
666,R10 414,2023-09-13,23:00:00,39,27,12,FMN 19 Binnensingel Oostkant
666,R10 414,2023-09-14,00:00:00,6,4,2,FMN 19 Binnensingel Oostkant
666,R10 414,2023-09-14,01:00:00,8,3,5,FMN 19 Binnensingel Oostkant
666,R10 414,2023-09-14,02:00:00,2,1,1,FMN 19 Binnensingel Oostkant
666,R10 414,2023-09-14,03:00:00,5,4,1,FMN 19 Binnensingel Oostkant
666,R10 414,2023-09-14,04:00:00,10,8,2,FMN 19 Binnensingel Oostkant
666,R10 414,2023-09-14,05:00:00,24,11,13,FMN 19 Binnensingel Oostkant
666,R10 414,2023-09-14,06:00:00,55,35,20,FMN 19 Binnensingel Oostkant
666,R10 414,2023-09-14,07:00:00,130,100,30,FMN 19 Binnensingel Oostkant
666,R10 414,2023-09-14,08:00:00,146,115,31,FMN 19 Binnensingel Oostkant
666,R10 414,2023-09-14,09:00:00,53,36,17,FMN 19 Binnensingel Oostkant
666,R10 414,2023-09-14,10:00:00,40,30,10,FMN 19 Binnensingel Oostkant
666,R10 414,2023-09-14,11:00:00,74,59,15,FMN 19 Binnensingel Oostkant
666,R10 414,2023-09-14,12:00:00,102,70,32,FMN 19 Binnensingel Oostkant
666,R10 414,2023-09-14,13:00:00,84,60,24,FMN 19 Binnensingel Oostkant
666,R10 414,2023-09-14,14:00:00,79,59,20,FMN 19 Binnensingel Oostkant
666,R10 414,2023-09-14,15:00:00,125,94,31,FMN 19 Binnensingel Oostkant
666,R10 414,2023-09-14,16:00:00,208,168,40,FMN 19 Binnensingel Oostkant
666,R10 414,2023-09-14,17:00:00,182,123,59,FMN 19 Binnensingel Oostkant
666,R10 414,2023-09-14,18:00:00,120,85,35,FMN 19 Binnensingel Oostkant
666,R10 414,2023-09-14,19:00:00,87,60,27,FMN 19 Binnensingel Oostkant
666,R10 414,2023-09-14,20:00:00,86,59,27,FMN 19 Binnensingel Oostkant
666,R10 414,2023-09-14,21:00:00,61,43,18,FMN 19 Binnensingel Oostkant
666,R10 414,2023-09-14,22:00:00,70,54,16,FMN 19 Binnensingel Oostkant
666,R10 414,2023-09-14,23:00:00,44,34,10,FMN 19 Binnensingel Oostkant
666,R10 414,2023-09-15,00:00:00,8,6,2,FMN 19 Binnensingel Oostkant
666,R10 414,2023-09-15,01:00:00,6,3,3,FMN 19 Binnensingel Oostkant
666,R10 414,2023-09-15,02:00:00,0,0,0,FMN 19 Binnensingel Oostkant
666,R10 414,2023-09-15,03:00:00,5,3,2,FMN 19 Binnensingel Oostkant
666,R10 414,2023-09-15,04:00:00,6,4,2,FMN 19 Binnensingel Oostkant
666,R10 414,2023-09-15,05:00:00,23,12,11,FMN 19 Binnensingel Oostkant
666,R10 414,2023-09-15,06:00:00,47,25,22,FMN 19 Binnensingel Oostkant
666,R10 414,2023-09-15,07:00:00,93,67,26,FMN 19 Binnensingel Oostkant
666,R10 414,2023-09-15,08:00:00,144,105,39,FMN 19 Binnensingel Oostkant
666,R10 414,2023-09-15,09:00:00,68,54,14,FMN 19 Binnensingel Oostkant
666,R10 414,2023-09-15,10:00:00,40,30,10,FMN 19 Binnensingel Oostkant
666,R10 414,2023-09-15,11:00:00,58,47,11,FMN 19 Binnensingel Oostkant
666,R10 414,2023-09-15,12:00:00,98,70,28,FMN 19 Binnensingel Oostkant
666,R10 414,2023-09-15,13:00:00,103,71,32,FMN 19 Binnensingel Oostkant
666,R10 414,2023-09-15,14:00:00,105,86,19,FMN 19 Binnensingel Oostkant
666,R10 414,2023-09-15,15:00:00,134,104,30,FMN 19 Binnensingel Oostkant
666,R10 414,2023-09-15,16:00:00,179,142,37,FMN 19 Binnensingel Oostkant
666,R10 414,2023-09-15,17:00:00,141,108,33,FMN 19 Binnensingel Oostkant
666,R10 414,2023-09-15,18:00:00,114,89,25,FMN 19 Binnensingel Oostkant
666,R10 414,2023-09-15,19:00:00,101,73,28,FMN 19 Binnensingel Oostkant
666,R10 414,2023-09-15,20:00:00,86,70,16,FMN 19 Binnensingel Oostkant
666,R10 414,2023-09-15,21:00:00,47,38,9,FMN 19 Binnensingel Oostkant
666,R10 414,2023-09-15,22:00:00,73,62,11,FMN 19 Binnensingel Oostkant
666,R10 414,2023-09-15,23:00:00,46,40,6,FMN 19 Binnensingel Oostkant
666,R10 414,2023-09-16,00:00:00,40,32,8,FMN 19 Binnensingel Oostkant
666,R10 414,2023-09-16,01:00:00,17,14,3,FMN 19 Binnensingel Oostkant
666,R10 414,2023-09-16,02:00:00,8,6,2,FMN 19 Binnensingel Oostkant
666,R10 414,2023-09-16,03:00:00,10,6,4,FMN 19 Binnensingel Oostkant
666,R10 414,2023-09-16,04:00:00,6,3,3,FMN 19 Binnensingel Oostkant
666,R10 414,2023-09-16,05:00:00,15,9,6,FMN 19 Binnensingel Oostkant
666,R10 414,2023-09-16,06:00:00,15,10,5,FMN 19 Binnensingel Oostkant
666,R10 414,2023-09-16,07:00:00,27,17,10,FMN 19 Binnensingel Oostkant
666,R10 414,2023-09-16,08:00:00,37,31,6,FMN 19 Binnensingel Oostkant
666,R10 414,2023-09-16,09:00:00,41,30,11,FMN 19 Binnensingel Oostkant
666,R10 414,2023-09-16,10:00:00,57,36,21,FMN 19 Binnensingel Oostkant
666,R10 414,2023-09-16,11:00:00,52,42,10,FMN 19 Binnensingel Oostkant
666,R10 414,2023-09-16,12:00:00,81,63,18,FMN 19 Binnensingel Oostkant
666,R10 414,2023-09-16,13:00:00,63,44,19,FMN 19 Binnensingel Oostkant
666,R10 414,2023-09-16,14:00:00,57,47,10,FMN 19 Binnensingel Oostkant
666,R10 414,2023-09-16,15:00:00,93,68,25,FMN 19 Binnensingel Oostkant
666,R10 414,2023-09-16,16:00:00,75,54,21,FMN 19 Binnensingel Oostkant
666,R10 414,2023-09-16,17:00:00,91,48,43,FMN 19 Binnensingel Oostkant
666,R10 414,2023-09-16,18:00:00,96,69,27,FMN 19 Binnensingel Oostkant
666,R10 414,2023-09-16,19:00:00,74,46,28,FMN 19 Binnensingel Oostkant
666,R10 414,2023-09-16,20:00:00,70,61,9,FMN 19 Binnensingel Oostkant
666,R10 414,2023-09-16,21:00:00,36,31,5,FMN 19 Binnensingel Oostkant
666,R10 414,2023-09-16,22:00:00,76,60,16,FMN 19 Binnensingel Oostkant
666,R10 414,2023-09-16,23:00:00,50,39,11,FMN 19 Binnensingel Oostkant
666,R10 414,2023-09-17,00:00:00,26,19,7,FMN 19 Binnensingel Oostkant
666,R10 414,2023-09-17,01:00:00,26,16,10,FMN 19 Binnensingel Oostkant
666,R10 414,2023-09-17,02:00:00,22,19,3,FMN 19 Binnensingel Oostkant
666,R10 414,2023-09-17,03:00:00,7,3,4,FMN 19 Binnensingel Oostkant
666,R10 414,2023-09-17,04:00:00,8,6,2,FMN 19 Binnensingel Oostkant
666,R10 414,2023-09-17,05:00:00,13,7,6,FMN 19 Binnensingel Oostkant
666,R10 414,2023-09-17,06:00:00,10,10,0,FMN 19 Binnensingel Oostkant
666,R10 414,2023-09-17,07:00:00,17,13,4,FMN 19 Binnensingel Oostkant
666,R10 414,2023-09-17,08:00:00,23,15,8,FMN 19 Binnensingel Oostkant
666,R10 414,2023-09-17,09:00:00,45,36,9,FMN 19 Binnensingel Oostkant
666,R10 414,2023-09-17,10:00:00,65,54,11,FMN 19 Binnensingel Oostkant
666,R10 414,2023-09-17,11:00:00,54,34,20,FMN 19 Binnensingel Oostkant
666,R10 414,2023-09-17,12:00:00,62,52,10,FMN 19 Binnensingel Oostkant
666,R10 414,2023-09-17,13:00:00,60,46,14,FMN 19 Binnensingel Oostkant
666,R10 414,2023-09-17,14:00:00,62,45,17,FMN 19 Binnensingel Oostkant
666,R10 414,2023-09-17,15:00:00,64,47,17,FMN 19 Binnensingel Oostkant
666,R10 414,2023-09-17,16:00:00,84,61,23,FMN 19 Binnensingel Oostkant
666,R10 414,2023-09-17,17:00:00,88,68,20,FMN 19 Binnensingel Oostkant
666,R10 414,2023-09-17,18:00:00,71,58,13,FMN 19 Binnensingel Oostkant
666,R10 414,2023-09-17,19:00:00,42,35,7,FMN 19 Binnensingel Oostkant
666,R10 414,2023-09-17,20:00:00,41,27,14,FMN 19 Binnensingel Oostkant
666,R10 414,2023-09-17,21:00:00,39,25,14,FMN 19 Binnensingel Oostkant
666,R10 414,2023-09-17,22:00:00,28,23,5,FMN 19 Binnensingel Oostkant
666,R10 414,2023-09-17,23:00:00,24,19,5,FMN 19 Binnensingel Oostkant
666,R10 414,2023-09-18,00:00:00,5,5,0,FMN 19 Binnensingel Oostkant
666,R10 414,2023-09-18,01:00:00,3,2,1,FMN 19 Binnensingel Oostkant
666,R10 414,2023-09-18,02:00:00,3,1,2,FMN 19 Binnensingel Oostkant
666,R10 414,2023-09-18,03:00:00,2,1,1,FMN 19 Binnensingel Oostkant
666,R10 414,2023-09-18,04:00:00,9,5,4,FMN 19 Binnensingel Oostkant
666,R10 414,2023-09-18,05:00:00,23,9,14,FMN 19 Binnensingel Oostkant
666,R10 414,2023-09-18,06:00:00,41,24,17,FMN 19 Binnensingel Oostkant
666,R10 414,2023-09-18,07:00:00,134,98,36,FMN 19 Binnensingel Oostkant
666,R10 414,2023-09-18,08:00:00,178,120,58,FMN 19 Binnensingel Oostkant
666,R10 414,2023-09-18,09:00:00,66,50,16,FMN 19 Binnensingel Oostkant
666,R10 414,2023-09-18,10:00:00,57,41,16,FMN 19 Binnensingel Oostkant
666,R10 414,2023-09-18,11:00:00,54,42,12,FMN 19 Binnensingel Oostkant
666,R10 414,2023-09-18,12:00:00,75,53,22,FMN 19 Binnensingel Oostkant
666,R10 414,2023-09-18,13:00:00,72,44,28,FMN 19 Binnensingel Oostkant
666,R10 414,2023-09-18,14:00:00,74,59,15,FMN 19 Binnensingel Oostkant
666,R10 414,2023-09-18,15:00:00,127,104,23,FMN 19 Binnensingel Oostkant
666,R10 414,2023-09-18,16:00:00,178,148,30,FMN 19 Binnensingel Oostkant
666,R10 414,2023-09-18,17:00:00,193,152,41,FMN 19 Binnensingel Oostkant
666,R10 414,2023-09-18,18:00:00,125,86,39,FMN 19 Binnensingel Oostkant
666,R10 414,2023-09-18,19:00:00,75,53,22,FMN 19 Binnensingel Oostkant
666,R10 414,2023-09-18,20:00:00,58,51,7,FMN 19 Binnensingel Oostkant
666,R10 414,2023-09-18,21:00:00,63,47,16,FMN 19 Binnensingel Oostkant
666,R10 414,2023-09-18,22:00:00,53,38,15,FMN 19 Binnensingel Oostkant
666,R10 414,2023-09-18,23:00:00,15,8,7,FMN 19 Binnensingel Oostkant
666,R10 414,2023-09-19,00:00:00,9,7,2,FMN 19 Binnensingel Oostkant
666,R10 414,2023-09-19,01:00:00,1,1,0,FMN 19 Binnensingel Oostkant
666,R10 414,2023-09-19,02:00:00,4,2,2,FMN 19 Binnensingel Oostkant
666,R10 414,2023-09-19,03:00:00,3,3,0,FMN 19 Binnensingel Oostkant
666,R10 414,2023-09-19,04:00:00,8,4,4,FMN 19 Binnensingel Oostkant
666,R10 414,2023-09-19,05:00:00,23,11,12,FMN 19 Binnensingel Oostkant
666,R10 414,2023-09-19,06:00:00,49,30,19,FMN 19 Binnensingel Oostkant
666,R10 414,2023-09-19,07:00:00,127,91,36,FMN 19 Binnensingel Oostkant
666,R10 414,2023-09-19,08:00:00,185,137,48,FMN 19 Binnensingel Oostkant
666,R10 414,2023-09-19,09:00:00,52,32,20,FMN 19 Binnensingel Oostkant
666,R10 414,2023-09-19,10:00:00,39,28,11,FMN 19 Binnensingel Oostkant
666,R10 414,2023-09-19,11:00:00,52,39,13,FMN 19 Binnensingel Oostkant
666,R10 414,2023-09-19,12:00:00,101,76,25,FMN 19 Binnensingel Oostkant
666,R10 414,2023-09-19,13:00:00,72,49,23,FMN 19 Binnensingel Oostkant
666,R10 414,2023-09-19,14:00:00,84,70,14,FMN 19 Binnensingel Oostkant
666,R10 414,2023-09-19,15:00:00,127,114,13,FMN 19 Binnensingel Oostkant
666,R10 414,2023-09-19,16:00:00,233,189,44,FMN 19 Binnensingel Oostkant
666,R10 414,2023-09-19,17:00:00,167,123,44,FMN 19 Binnensingel Oostkant
666,R10 414,2023-09-19,18:00:00,120,78,42,FMN 19 Binnensingel Oostkant
666,R10 414,2023-09-19,19:00:00,62,45,17,FMN 19 Binnensingel Oostkant
666,R10 414,2023-09-19,20:00:00,79,59,20,FMN 19 Binnensingel Oostkant
666,R10 414,2023-09-19,21:00:00,42,28,14,FMN 19 Binnensingel Oostkant
666,R10 414,2023-09-19,22:00:00,63,44,19,FMN 19 Binnensingel Oostkant
666,R10 414,2023-09-19,23:00:00,40,25,15,FMN 19 Binnensingel Oostkant
666,R10 414,2023-09-20,00:00:00,6,6,0,FMN 19 Binnensingel Oostkant
666,R10 414,2023-09-20,01:00:00,1,0,1,FMN 19 Binnensingel Oostkant
666,R10 414,2023-09-20,02:00:00,3,3,0,FMN 19 Binnensingel Oostkant
666,R10 414,2023-09-20,03:00:00,2,1,1,FMN 19 Binnensingel Oostkant
666,R10 414,2023-09-20,04:00:00,12,7,5,FMN 19 Binnensingel Oostkant
666,R10 414,2023-09-20,05:00:00,22,8,14,FMN 19 Binnensingel Oostkant
666,R10 414,2023-09-20,06:00:00,49,29,20,FMN 19 Binnensingel Oostkant
666,R10 414,2023-09-20,07:00:00,116,84,32,FMN 19 Binnensingel Oostkant
666,R10 414,2023-09-20,08:00:00,150,103,47,FMN 19 Binnensingel Oostkant
666,R10 414,2023-09-20,09:00:00,61,39,22,FMN 19 Binnensingel Oostkant
666,R10 414,2023-09-20,10:00:00,49,32,17,FMN 19 Binnensingel Oostkant
666,R10 414,2023-09-20,11:00:00,57,44,13,FMN 19 Binnensingel Oostkant
666,R10 414,2023-09-20,12:00:00,140,108,32,FMN 19 Binnensingel Oostkant
666,R10 414,2023-09-20,13:00:00,103,72,31,FMN 19 Binnensingel Oostkant
666,R10 414,2023-09-20,14:00:00,80,59,21,FMN 19 Binnensingel Oostkant
666,R10 414,2023-09-20,15:00:00,120,91,29,FMN 19 Binnensingel Oostkant
666,R10 414,2023-09-20,16:00:00,168,135,33,FMN 19 Binnensingel Oostkant
666,R10 414,2023-09-20,17:00:00,187,134,53,FMN 19 Binnensingel Oostkant
666,R10 414,2023-09-20,18:00:00,141,102,39,FMN 19 Binnensingel Oostkant
666,R10 414,2023-09-20,19:00:00,78,58,20,FMN 19 Binnensingel Oostkant
666,R10 414,2023-09-20,20:00:00,82,59,23,FMN 19 Binnensingel Oostkant
666,R10 414,2023-09-20,21:00:00,58,46,12,FMN 19 Binnensingel Oostkant
666,R10 414,2023-09-20,22:00:00,49,42,7,FMN 19 Binnensingel Oostkant
666,R10 414,2023-09-20,23:00:00,25,18,7,FMN 19 Binnensingel Oostkant
666,R10 414,2023-09-21,00:00:00,16,9,7,FMN 19 Binnensingel Oostkant
666,R10 414,2023-09-21,01:00:00,2,2,0,FMN 19 Binnensingel Oostkant
666,R10 414,2023-09-21,02:00:00,2,0,2,FMN 19 Binnensingel Oostkant
666,R10 414,2023-09-21,03:00:00,3,3,0,FMN 19 Binnensingel Oostkant
666,R10 414,2023-09-21,04:00:00,10,5,5,FMN 19 Binnensingel Oostkant
666,R10 414,2023-09-21,05:00:00,16,9,7,FMN 19 Binnensingel Oostkant
666,R10 414,2023-09-21,06:00:00,44,24,20,FMN 19 Binnensingel Oostkant
666,R10 414,2023-09-21,07:00:00,95,69,26,FMN 19 Binnensingel Oostkant
666,R10 414,2023-09-21,08:00:00,134,95,39,FMN 19 Binnensingel Oostkant
666,R10 414,2023-09-21,09:00:00,39,27,12,FMN 19 Binnensingel Oostkant
666,R10 414,2023-09-21,10:00:00,34,26,8,FMN 19 Binnensingel Oostkant
666,R10 414,2023-09-21,11:00:00,21,13,8,FMN 19 Binnensingel Oostkant
666,R10 414,2023-09-21,12:00:00,44,30,14,FMN 19 Binnensingel Oostkant
666,R10 414,2023-09-21,13:00:00,60,39,21,FMN 19 Binnensingel Oostkant
666,R10 414,2023-09-21,14:00:00,55,44,11,FMN 19 Binnensingel Oostkant
666,R10 414,2023-09-21,15:00:00,86,73,13,FMN 19 Binnensingel Oostkant
666,R10 414,2023-09-21,16:00:00,121,91,30,FMN 19 Binnensingel Oostkant
666,R10 414,2023-09-21,17:00:00,127,98,29,FMN 19 Binnensingel Oostkant
666,R10 414,2023-09-21,18:00:00,102,77,25,FMN 19 Binnensingel Oostkant
666,R10 414,2023-09-21,19:00:00,56,41,15,FMN 19 Binnensingel Oostkant
666,R10 414,2023-09-21,20:00:00,51,37,14,FMN 19 Binnensingel Oostkant
666,R10 414,2023-09-21,21:00:00,49,36,13,FMN 19 Binnensingel Oostkant
666,R10 414,2023-09-21,22:00:00,60,40,20,FMN 19 Binnensingel Oostkant
666,R10 414,2023-09-21,23:00:00,31,22,9,FMN 19 Binnensingel Oostkant
