Meetpunt surrogate key,Meetpunt locatie,Datum,Tijd,Aantal fietsers,Aantal fietsers van,Aantal fietsers naar,Meetpunt code
66,Bergstraat 71,2018-07-12,00:00:00,2,2,0,FMN GV 11 Ramsel
66,Bergstraat 71,2018-07-12,01:00:00,2,2,0,FMN GV 11 Ramsel
66,Bergstraat 71,2018-07-12,02:00:00,0,0,0,FMN GV 11 Ramsel
66,Bergstraat 71,2018-07-12,03:00:00,0,0,0,FMN GV 11 Ramsel
66,Bergstraat 71,2018-07-12,04:00:00,2,2,0,FMN GV 11 Ramsel
66,Bergstraat 71,2018-07-12,05:00:00,10,6,4,FMN GV 11 Ramsel
66,Bergstraat 71,2018-07-12,06:00:00,28,8,20,FMN GV 11 Ramsel
66,Bergstraat 71,2018-07-12,07:00:00,62,30,32,FMN GV 11 Ramsel
66,Bergstraat 71,2018-07-12,08:00:00,46,18,28,FMN GV 11 Ramsel
66,Bergstraat 71,2018-07-12,09:00:00,66,20,46,FMN GV 11 Ramsel
66,Bergstraat 71,2018-07-12,10:00:00,92,30,62,FMN GV 11 Ramsel
66,Bergstraat 71,2018-07-12,11:00:00,86,42,44,FMN GV 11 Ramsel
66,Bergstraat 71,2018-07-12,12:00:00,138,68,70,FMN GV 11 Ramsel
66,Bergstraat 71,2018-07-12,13:00:00,192,80,112,FMN GV 11 Ramsel
66,Bergstraat 71,2018-07-12,14:00:00,196,108,88,FMN GV 11 Ramsel
66,Bergstraat 71,2018-07-12,15:00:00,190,106,84,FMN GV 11 Ramsel
66,Bergstraat 71,2018-07-12,16:00:00,174,112,62,FMN GV 11 Ramsel
66,Bergstraat 71,2018-07-12,17:00:00,128,84,44,FMN GV 11 Ramsel
66,Bergstraat 71,2018-07-12,18:00:00,128,62,66,FMN GV 11 Ramsel
66,Bergstraat 71,2018-07-12,19:00:00,112,48,64,FMN GV 11 Ramsel
66,Bergstraat 71,2018-07-12,20:00:00,86,34,52,FMN GV 11 Ramsel
66,Bergstraat 71,2018-07-12,21:00:00,52,30,22,FMN GV 11 Ramsel
66,Bergstraat 71,2018-07-12,22:00:00,30,22,8,FMN GV 11 Ramsel
66,Bergstraat 71,2018-07-12,23:00:00,6,6,0,FMN GV 11 Ramsel
66,Bergstraat 71,2018-07-13,00:00:00,6,4,2,FMN GV 11 Ramsel
66,Bergstraat 71,2018-07-13,01:00:00,0,0,0,FMN GV 11 Ramsel
66,Bergstraat 71,2018-07-13,02:00:00,0,0,0,FMN GV 11 Ramsel
66,Bergstraat 71,2018-07-13,03:00:00,0,0,0,FMN GV 11 Ramsel
66,Bergstraat 71,2018-07-13,04:00:00,2,2,0,FMN GV 11 Ramsel
66,Bergstraat 71,2018-07-13,05:00:00,16,6,10,FMN GV 11 Ramsel
66,Bergstraat 71,2018-07-13,06:00:00,30,10,20,FMN GV 11 Ramsel
66,Bergstraat 71,2018-07-13,07:00:00,48,16,32,FMN GV 11 Ramsel
66,Bergstraat 71,2018-07-13,08:00:00,30,20,10,FMN GV 11 Ramsel
66,Bergstraat 71,2018-07-13,09:00:00,52,20,32,FMN GV 11 Ramsel
66,Bergstraat 71,2018-07-13,10:00:00,74,28,46,FMN GV 11 Ramsel
66,Bergstraat 71,2018-07-13,11:00:00,106,62,44,FMN GV 11 Ramsel
66,Bergstraat 71,2018-07-13,12:00:00,136,72,64,FMN GV 11 Ramsel
66,Bergstraat 71,2018-07-13,13:00:00,128,50,78,FMN GV 11 Ramsel
66,Bergstraat 71,2018-07-13,14:00:00,160,82,78,FMN GV 11 Ramsel
66,Bergstraat 71,2018-07-13,15:00:00,202,132,70,FMN GV 11 Ramsel
66,Bergstraat 71,2018-07-13,16:00:00,156,84,72,FMN GV 11 Ramsel
66,Bergstraat 71,2018-07-13,17:00:00,170,98,72,FMN GV 11 Ramsel
66,Bergstraat 71,2018-07-13,18:00:00,126,56,70,FMN GV 11 Ramsel
66,Bergstraat 71,2018-07-13,19:00:00,84,48,36,FMN GV 11 Ramsel
66,Bergstraat 71,2018-07-13,20:00:00,82,44,38,FMN GV 11 Ramsel
66,Bergstraat 71,2018-07-13,21:00:00,52,26,26,FMN GV 11 Ramsel
66,Bergstraat 71,2018-07-13,22:00:00,22,8,14,FMN GV 11 Ramsel
66,Bergstraat 71,2018-07-13,23:00:00,10,10,0,FMN GV 11 Ramsel
66,Bergstraat 71,2018-07-14,00:00:00,8,6,2,FMN GV 11 Ramsel
66,Bergstraat 71,2018-07-14,01:00:00,6,4,2,FMN GV 11 Ramsel
66,Bergstraat 71,2018-07-14,02:00:00,14,14,0,FMN GV 11 Ramsel
66,Bergstraat 71,2018-07-14,03:00:00,0,0,0,FMN GV 11 Ramsel
66,Bergstraat 71,2018-07-14,04:00:00,2,0,2,FMN GV 11 Ramsel
66,Bergstraat 71,2018-07-14,05:00:00,0,0,0,FMN GV 11 Ramsel
66,Bergstraat 71,2018-07-14,06:00:00,0,0,0,FMN GV 11 Ramsel
66,Bergstraat 71,2018-07-14,07:00:00,20,6,14,FMN GV 11 Ramsel
66,Bergstraat 71,2018-07-14,08:00:00,48,18,30,FMN GV 11 Ramsel
66,Bergstraat 71,2018-07-14,09:00:00,110,46,64,FMN GV 11 Ramsel
66,Bergstraat 71,2018-07-14,10:00:00,166,72,94,FMN GV 11 Ramsel
66,Bergstraat 71,2018-07-14,11:00:00,190,80,110,FMN GV 11 Ramsel
66,Bergstraat 71,2018-07-14,12:00:00,184,68,116,FMN GV 11 Ramsel
66,Bergstraat 71,2018-07-14,13:00:00,178,100,78,FMN GV 11 Ramsel
66,Bergstraat 71,2018-07-14,14:00:00,180,90,90,FMN GV 11 Ramsel
66,Bergstraat 71,2018-07-14,15:00:00,154,68,86,FMN GV 11 Ramsel
66,Bergstraat 71,2018-07-14,16:00:00,142,80,62,FMN GV 11 Ramsel
66,Bergstraat 71,2018-07-14,17:00:00,42,30,12,FMN GV 11 Ramsel
66,Bergstraat 71,2018-07-14,18:00:00,42,12,30,FMN GV 11 Ramsel
66,Bergstraat 71,2018-07-14,19:00:00,106,54,52,FMN GV 11 Ramsel
66,Bergstraat 71,2018-07-14,20:00:00,72,32,40,FMN GV 11 Ramsel
66,Bergstraat 71,2018-07-14,21:00:00,52,26,26,FMN GV 11 Ramsel
66,Bergstraat 71,2018-07-14,22:00:00,18,10,8,FMN GV 11 Ramsel
66,Bergstraat 71,2018-07-14,23:00:00,12,12,0,FMN GV 11 Ramsel
66,Bergstraat 71,2018-07-15,00:00:00,4,4,0,FMN GV 11 Ramsel
66,Bergstraat 71,2018-07-15,01:00:00,6,4,2,FMN GV 11 Ramsel
66,Bergstraat 71,2018-07-15,02:00:00,4,4,0,FMN GV 11 Ramsel
66,Bergstraat 71,2018-07-15,03:00:00,4,4,0,FMN GV 11 Ramsel
66,Bergstraat 71,2018-07-15,04:00:00,6,2,4,FMN GV 11 Ramsel
66,Bergstraat 71,2018-07-15,05:00:00,0,0,0,FMN GV 11 Ramsel
66,Bergstraat 71,2018-07-15,06:00:00,12,2,10,FMN GV 11 Ramsel
66,Bergstraat 71,2018-07-15,07:00:00,50,10,40,FMN GV 11 Ramsel
66,Bergstraat 71,2018-07-15,08:00:00,122,30,92,FMN GV 11 Ramsel
66,Bergstraat 71,2018-07-15,09:00:00,240,100,140,FMN GV 11 Ramsel
66,Bergstraat 71,2018-07-15,10:00:00,284,160,124,FMN GV 11 Ramsel
66,Bergstraat 71,2018-07-15,11:00:00,274,142,132,FMN GV 11 Ramsel
66,Bergstraat 71,2018-07-15,12:00:00,240,126,114,FMN GV 11 Ramsel
66,Bergstraat 71,2018-07-15,13:00:00,214,84,130,FMN GV 11 Ramsel
66,Bergstraat 71,2018-07-15,14:00:00,174,102,72,FMN GV 11 Ramsel
66,Bergstraat 71,2018-07-15,15:00:00,176,116,60,FMN GV 11 Ramsel
66,Bergstraat 71,2018-07-15,16:00:00,234,158,76,FMN GV 11 Ramsel
66,Bergstraat 71,2018-07-15,17:00:00,144,80,64,FMN GV 11 Ramsel
66,Bergstraat 71,2018-07-15,18:00:00,84,54,30,FMN GV 11 Ramsel
66,Bergstraat 71,2018-07-15,19:00:00,104,42,62,FMN GV 11 Ramsel
66,Bergstraat 71,2018-07-15,20:00:00,92,44,48,FMN GV 11 Ramsel
66,Bergstraat 71,2018-07-15,21:00:00,72,46,26,FMN GV 11 Ramsel
66,Bergstraat 71,2018-07-15,22:00:00,18,8,10,FMN GV 11 Ramsel
66,Bergstraat 71,2018-07-15,23:00:00,6,2,4,FMN GV 11 Ramsel
66,Bergstraat 71,2018-07-16,00:00:00,0,0,0,FMN GV 11 Ramsel
66,Bergstraat 71,2018-07-16,01:00:00,0,0,0,FMN GV 11 Ramsel
66,Bergstraat 71,2018-07-16,02:00:00,0,0,0,FMN GV 11 Ramsel
66,Bergstraat 71,2018-07-16,03:00:00,2,0,2,FMN GV 11 Ramsel
66,Bergstraat 71,2018-07-16,04:00:00,0,0,0,FMN GV 11 Ramsel
66,Bergstraat 71,2018-07-16,05:00:00,10,0,10,FMN GV 11 Ramsel
66,Bergstraat 71,2018-07-16,06:00:00,34,12,22,FMN GV 11 Ramsel
66,Bergstraat 71,2018-07-16,07:00:00,46,16,30,FMN GV 11 Ramsel
66,Bergstraat 71,2018-07-16,08:00:00,34,10,24,FMN GV 11 Ramsel
66,Bergstraat 71,2018-07-16,09:00:00,100,42,58,FMN GV 11 Ramsel
66,Bergstraat 71,2018-07-16,10:00:00,136,68,68,FMN GV 11 Ramsel
66,Bergstraat 71,2018-07-16,11:00:00,100,50,50,FMN GV 11 Ramsel
66,Bergstraat 71,2018-07-16,12:00:00,84,42,42,FMN GV 11 Ramsel
66,Bergstraat 71,2018-07-16,13:00:00,206,100,106,FMN GV 11 Ramsel
66,Bergstraat 71,2018-07-16,14:00:00,178,52,126,FMN GV 11 Ramsel
66,Bergstraat 71,2018-07-16,15:00:00,134,62,72,FMN GV 11 Ramsel
66,Bergstraat 71,2018-07-16,16:00:00,168,84,84,FMN GV 11 Ramsel
66,Bergstraat 71,2018-07-16,17:00:00,126,66,60,FMN GV 11 Ramsel
66,Bergstraat 71,2018-07-16,18:00:00,120,66,54,FMN GV 11 Ramsel
66,Bergstraat 71,2018-07-16,19:00:00,92,44,48,FMN GV 11 Ramsel
66,Bergstraat 71,2018-07-16,20:00:00,40,24,16,FMN GV 11 Ramsel
66,Bergstraat 71,2018-07-16,21:00:00,8,6,2,FMN GV 11 Ramsel
66,Bergstraat 71,2018-07-16,22:00:00,20,16,4,FMN GV 11 Ramsel
66,Bergstraat 71,2018-07-16,23:00:00,8,8,0,FMN GV 11 Ramsel
66,Bergstraat 71,2018-07-17,00:00:00,2,2,0,FMN GV 11 Ramsel
66,Bergstraat 71,2018-07-17,01:00:00,2,2,0,FMN GV 11 Ramsel
66,Bergstraat 71,2018-07-17,02:00:00,0,0,0,FMN GV 11 Ramsel
66,Bergstraat 71,2018-07-17,03:00:00,2,2,0,FMN GV 11 Ramsel
66,Bergstraat 71,2018-07-17,04:00:00,0,0,0,FMN GV 11 Ramsel
66,Bergstraat 71,2018-07-17,05:00:00,6,4,2,FMN GV 11 Ramsel
66,Bergstraat 71,2018-07-17,06:00:00,36,12,24,FMN GV 11 Ramsel
66,Bergstraat 71,2018-07-17,07:00:00,52,14,38,FMN GV 11 Ramsel
66,Bergstraat 71,2018-07-17,08:00:00,44,16,28,FMN GV 11 Ramsel
66,Bergstraat 71,2018-07-17,09:00:00,116,42,74,FMN GV 11 Ramsel
66,Bergstraat 71,2018-07-17,10:00:00,160,48,112,FMN GV 11 Ramsel
66,Bergstraat 71,2018-07-17,11:00:00,94,34,60,FMN GV 11 Ramsel
66,Bergstraat 71,2018-07-17,12:00:00,82,34,48,FMN GV 11 Ramsel
66,Bergstraat 71,2018-07-17,13:00:00,178,82,96,FMN GV 11 Ramsel
66,Bergstraat 71,2018-07-17,14:00:00,174,110,64,FMN GV 11 Ramsel
66,Bergstraat 71,2018-07-17,15:00:00,166,84,82,FMN GV 11 Ramsel
66,Bergstraat 71,2018-07-17,16:00:00,120,68,52,FMN GV 11 Ramsel
66,Bergstraat 71,2018-07-17,17:00:00,140,66,74,FMN GV 11 Ramsel
66,Bergstraat 71,2018-07-17,18:00:00,78,60,18,FMN GV 11 Ramsel
66,Bergstraat 71,2018-07-17,19:00:00,78,24,54,FMN GV 11 Ramsel
66,Bergstraat 71,2018-07-17,20:00:00,124,68,56,FMN GV 11 Ramsel
66,Bergstraat 71,2018-07-17,21:00:00,50,24,26,FMN GV 11 Ramsel
66,Bergstraat 71,2018-07-17,22:00:00,24,14,10,FMN GV 11 Ramsel
66,Bergstraat 71,2018-07-17,23:00:00,6,6,0,FMN GV 11 Ramsel
66,Bergstraat 71,2018-07-18,00:00:00,10,6,4,FMN GV 11 Ramsel
66,Bergstraat 71,2018-07-18,01:00:00,0,0,0,FMN GV 11 Ramsel
66,Bergstraat 71,2018-07-18,02:00:00,0,0,0,FMN GV 11 Ramsel
66,Bergstraat 71,2018-07-18,03:00:00,4,4,0,FMN GV 11 Ramsel
66,Bergstraat 71,2018-07-18,04:00:00,0,0,0,FMN GV 11 Ramsel
66,Bergstraat 71,2018-07-18,05:00:00,0,0,0,FMN GV 11 Ramsel
66,Bergstraat 71,2018-07-18,06:00:00,40,6,34,FMN GV 11 Ramsel
66,Bergstraat 71,2018-07-18,07:00:00,40,16,24,FMN GV 11 Ramsel
66,Bergstraat 71,2018-07-18,08:00:00,66,32,34,FMN GV 11 Ramsel
66,Bergstraat 71,2018-07-18,09:00:00,126,44,82,FMN GV 11 Ramsel
66,Bergstraat 71,2018-07-18,10:00:00,178,72,106,FMN GV 11 Ramsel
66,Bergstraat 71,2018-07-18,11:00:00,208,62,146,FMN GV 11 Ramsel
66,Bergstraat 71,2018-07-18,12:00:00,130,86,44,FMN GV 11 Ramsel
66,Bergstraat 71,2018-07-18,13:00:00,162,78,84,FMN GV 11 Ramsel
66,Bergstraat 71,2018-07-18,14:00:00,206,86,120,FMN GV 11 Ramsel
66,Bergstraat 71,2018-07-18,15:00:00,194,146,48,FMN GV 11 Ramsel
66,Bergstraat 71,2018-07-18,16:00:00,156,84,72,FMN GV 11 Ramsel
66,Bergstraat 71,2018-07-18,17:00:00,130,72,58,FMN GV 11 Ramsel
66,Bergstraat 71,2018-07-18,18:00:00,140,62,78,FMN GV 11 Ramsel
66,Bergstraat 71,2018-07-18,19:00:00,148,58,90,FMN GV 11 Ramsel
66,Bergstraat 71,2018-07-18,20:00:00,104,50,54,FMN GV 11 Ramsel
66,Bergstraat 71,2018-07-18,21:00:00,52,32,20,FMN GV 11 Ramsel
66,Bergstraat 71,2018-07-18,22:00:00,34,20,14,FMN GV 11 Ramsel
66,Bergstraat 71,2018-07-18,23:00:00,16,12,4,FMN GV 11 Ramsel
66,Bergstraat 71,2018-07-19,00:00:00,2,0,2,FMN GV 11 Ramsel
66,Bergstraat 71,2018-07-19,01:00:00,4,2,2,FMN GV 11 Ramsel
66,Bergstraat 71,2018-07-19,02:00:00,2,2,0,FMN GV 11 Ramsel
66,Bergstraat 71,2018-07-19,03:00:00,0,0,0,FMN GV 11 Ramsel
66,Bergstraat 71,2018-07-19,04:00:00,2,0,2,FMN GV 11 Ramsel
66,Bergstraat 71,2018-07-19,05:00:00,4,0,4,FMN GV 11 Ramsel
66,Bergstraat 71,2018-07-19,06:00:00,30,12,18,FMN GV 11 Ramsel
66,Bergstraat 71,2018-07-19,07:00:00,54,18,36,FMN GV 11 Ramsel
66,Bergstraat 71,2018-07-19,08:00:00,76,26,50,FMN GV 11 Ramsel
66,Bergstraat 71,2018-07-19,09:00:00,102,36,66,FMN GV 11 Ramsel
66,Bergstraat 71,2018-07-19,10:00:00,128,70,58,FMN GV 11 Ramsel
66,Bergstraat 71,2018-07-19,11:00:00,174,76,98,FMN GV 11 Ramsel
66,Bergstraat 71,2018-07-19,12:00:00,124,76,48,FMN GV 11 Ramsel
66,Bergstraat 71,2018-07-19,13:00:00,118,50,68,FMN GV 11 Ramsel
66,Bergstraat 71,2018-07-19,14:00:00,164,116,48,FMN GV 11 Ramsel
66,Bergstraat 71,2018-07-19,15:00:00,180,112,68,FMN GV 11 Ramsel
66,Bergstraat 71,2018-07-19,16:00:00,152,78,74,FMN GV 11 Ramsel
66,Bergstraat 71,2018-07-19,17:00:00,110,76,34,FMN GV 11 Ramsel
66,Bergstraat 71,2018-07-19,18:00:00,112,60,52,FMN GV 11 Ramsel
66,Bergstraat 71,2018-07-19,19:00:00,128,74,54,FMN GV 11 Ramsel
66,Bergstraat 71,2018-07-19,20:00:00,126,70,56,FMN GV 11 Ramsel
66,Bergstraat 71,2018-07-19,21:00:00,72,44,28,FMN GV 11 Ramsel
66,Bergstraat 71,2018-07-19,22:00:00,18,16,2,FMN GV 11 Ramsel
66,Bergstraat 71,2018-07-19,23:00:00,8,8,0,FMN GV 11 Ramsel
66,Bergstraat 71,2018-07-20,00:00:00,4,0,4,FMN GV 11 Ramsel
66,Bergstraat 71,2018-07-20,01:00:00,4,4,0,FMN GV 11 Ramsel
66,Bergstraat 71,2018-07-20,02:00:00,2,0,2,FMN GV 11 Ramsel
66,Bergstraat 71,2018-07-20,03:00:00,0,0,0,FMN GV 11 Ramsel
66,Bergstraat 71,2018-07-20,04:00:00,0,0,0,FMN GV 11 Ramsel
66,Bergstraat 71,2018-07-20,05:00:00,8,4,4,FMN GV 11 Ramsel
66,Bergstraat 71,2018-07-20,06:00:00,22,8,14,FMN GV 11 Ramsel
66,Bergstraat 71,2018-07-20,07:00:00,36,12,24,FMN GV 11 Ramsel
66,Bergstraat 71,2018-07-20,08:00:00,44,22,22,FMN GV 11 Ramsel
66,Bergstraat 71,2018-07-20,09:00:00,80,36,44,FMN GV 11 Ramsel
66,Bergstraat 71,2018-07-20,10:00:00,144,54,90,FMN GV 11 Ramsel
66,Bergstraat 71,2018-07-20,11:00:00,122,54,68,FMN GV 11 Ramsel
66,Bergstraat 71,2018-07-20,12:00:00,138,82,56,FMN GV 11 Ramsel
66,Bergstraat 71,2018-07-20,13:00:00,154,96,58,FMN GV 11 Ramsel
66,Bergstraat 71,2018-07-20,14:00:00,154,70,84,FMN GV 11 Ramsel
66,Bergstraat 71,2018-07-20,15:00:00,154,64,90,FMN GV 11 Ramsel
66,Bergstraat 71,2018-07-20,16:00:00,122,72,50,FMN GV 11 Ramsel
66,Bergstraat 71,2018-07-20,17:00:00,96,62,34,FMN GV 11 Ramsel
66,Bergstraat 71,2018-07-20,18:00:00,38,16,22,FMN GV 11 Ramsel
66,Bergstraat 71,2018-07-20,19:00:00,38,18,20,FMN GV 11 Ramsel
66,Bergstraat 71,2018-07-20,20:00:00,30,18,12,FMN GV 11 Ramsel
66,Bergstraat 71,2018-07-20,21:00:00,16,12,4,FMN GV 11 Ramsel
66,Bergstraat 71,2018-07-20,22:00:00,14,10,4,FMN GV 11 Ramsel
66,Bergstraat 71,2018-07-20,23:00:00,6,6,0,FMN GV 11 Ramsel
66,Bergstraat 71,2018-07-21,00:00:00,0,0,0,FMN GV 11 Ramsel
66,Bergstraat 71,2018-07-21,01:00:00,0,0,0,FMN GV 11 Ramsel
66,Bergstraat 71,2018-07-21,02:00:00,0,0,0,FMN GV 11 Ramsel
66,Bergstraat 71,2018-07-21,03:00:00,4,2,2,FMN GV 11 Ramsel
66,Bergstraat 71,2018-07-21,04:00:00,2,2,0,FMN GV 11 Ramsel
66,Bergstraat 71,2018-07-21,05:00:00,4,4,0,FMN GV 11 Ramsel
66,Bergstraat 71,2018-07-21,06:00:00,10,8,2,FMN GV 11 Ramsel
66,Bergstraat 71,2018-07-21,07:00:00,24,10,14,FMN GV 11 Ramsel
66,Bergstraat 71,2018-07-21,08:00:00,46,10,36,FMN GV 11 Ramsel
66,Bergstraat 71,2018-07-21,09:00:00,154,84,70,FMN GV 11 Ramsel
66,Bergstraat 71,2018-07-21,10:00:00,264,164,100,FMN GV 11 Ramsel
66,Bergstraat 71,2018-07-21,11:00:00,204,94,110,FMN GV 11 Ramsel
66,Bergstraat 71,2018-07-21,12:00:00,298,184,114,FMN GV 11 Ramsel
66,Bergstraat 71,2018-07-21,13:00:00,354,220,134,FMN GV 11 Ramsel
66,Bergstraat 71,2018-07-21,14:00:00,366,246,120,FMN GV 11 Ramsel
66,Bergstraat 71,2018-07-21,15:00:00,228,108,120,FMN GV 11 Ramsel
66,Bergstraat 71,2018-07-21,16:00:00,152,94,58,FMN GV 11 Ramsel
66,Bergstraat 71,2018-07-21,17:00:00,108,52,56,FMN GV 11 Ramsel
66,Bergstraat 71,2018-07-21,18:00:00,130,64,66,FMN GV 11 Ramsel
66,Bergstraat 71,2018-07-21,19:00:00,44,22,22,FMN GV 11 Ramsel
66,Bergstraat 71,2018-07-21,20:00:00,54,28,26,FMN GV 11 Ramsel
66,Bergstraat 71,2018-07-21,21:00:00,38,22,16,FMN GV 11 Ramsel
66,Bergstraat 71,2018-07-21,22:00:00,22,14,8,FMN GV 11 Ramsel
66,Bergstraat 71,2018-07-21,23:00:00,6,2,4,FMN GV 11 Ramsel
66,Bergstraat 71,2018-07-22,00:00:00,6,2,4,FMN GV 11 Ramsel
66,Bergstraat 71,2018-07-22,01:00:00,4,4,0,FMN GV 11 Ramsel
66,Bergstraat 71,2018-07-22,02:00:00,2,2,0,FMN GV 11 Ramsel
66,Bergstraat 71,2018-07-22,03:00:00,2,2,0,FMN GV 11 Ramsel
66,Bergstraat 71,2018-07-22,04:00:00,2,0,2,FMN GV 11 Ramsel
66,Bergstraat 71,2018-07-22,05:00:00,0,0,0,FMN GV 11 Ramsel
66,Bergstraat 71,2018-07-22,06:00:00,0,0,0,FMN GV 11 Ramsel
66,Bergstraat 71,2018-07-22,07:00:00,18,10,8,FMN GV 11 Ramsel
66,Bergstraat 71,2018-07-22,08:00:00,122,50,72,FMN GV 11 Ramsel
66,Bergstraat 71,2018-07-22,09:00:00,202,80,122,FMN GV 11 Ramsel
66,Bergstraat 71,2018-07-22,10:00:00,276,158,118,FMN GV 11 Ramsel
66,Bergstraat 71,2018-07-22,11:00:00,298,132,166,FMN GV 11 Ramsel
66,Bergstraat 71,2018-07-22,12:00:00,214,126,88,FMN GV 11 Ramsel
66,Bergstraat 71,2018-07-22,13:00:00,218,96,122,FMN GV 11 Ramsel
66,Bergstraat 71,2018-07-22,14:00:00,280,132,148,FMN GV 11 Ramsel
66,Bergstraat 71,2018-07-22,15:00:00,232,134,98,FMN GV 11 Ramsel
66,Bergstraat 71,2018-07-22,16:00:00,228,134,94,FMN GV 11 Ramsel
66,Bergstraat 71,2018-07-22,17:00:00,192,100,92,FMN GV 11 Ramsel
66,Bergstraat 71,2018-07-22,18:00:00,108,54,54,FMN GV 11 Ramsel
66,Bergstraat 71,2018-07-22,19:00:00,88,40,48,FMN GV 11 Ramsel
66,Bergstraat 71,2018-07-22,20:00:00,88,46,42,FMN GV 11 Ramsel
66,Bergstraat 71,2018-07-22,21:00:00,26,8,18,FMN GV 11 Ramsel
66,Bergstraat 71,2018-07-22,22:00:00,8,4,4,FMN GV 11 Ramsel
66,Bergstraat 71,2018-07-22,23:00:00,8,4,4,FMN GV 11 Ramsel
66,Bergstraat 71,2018-07-23,00:00:00,0,0,0,FMN GV 11 Ramsel
66,Bergstraat 71,2018-07-23,01:00:00,2,2,0,FMN GV 11 Ramsel
66,Bergstraat 71,2018-07-23,02:00:00,2,2,0,FMN GV 11 Ramsel
66,Bergstraat 71,2018-07-23,03:00:00,0,0,0,FMN GV 11 Ramsel
66,Bergstraat 71,2018-07-23,04:00:00,2,2,0,FMN GV 11 Ramsel
66,Bergstraat 71,2018-07-23,05:00:00,10,6,4,FMN GV 11 Ramsel
66,Bergstraat 71,2018-07-23,06:00:00,24,8,16,FMN GV 11 Ramsel
66,Bergstraat 71,2018-07-23,07:00:00,48,18,30,FMN GV 11 Ramsel
66,Bergstraat 71,2018-07-23,08:00:00,60,16,44,FMN GV 11 Ramsel
66,Bergstraat 71,2018-07-23,09:00:00,116,52,64,FMN GV 11 Ramsel
66,Bergstraat 71,2018-07-23,10:00:00,144,84,60,FMN GV 11 Ramsel
66,Bergstraat 71,2018-07-23,11:00:00,122,68,54,FMN GV 11 Ramsel
66,Bergstraat 71,2018-07-23,12:00:00,110,54,56,FMN GV 11 Ramsel
66,Bergstraat 71,2018-07-23,13:00:00,160,66,94,FMN GV 11 Ramsel
66,Bergstraat 71,2018-07-23,14:00:00,132,78,54,FMN GV 11 Ramsel
66,Bergstraat 71,2018-07-23,15:00:00,188,80,108,FMN GV 11 Ramsel
66,Bergstraat 71,2018-07-23,16:00:00,116,56,60,FMN GV 11 Ramsel
66,Bergstraat 71,2018-07-23,17:00:00,126,82,44,FMN GV 11 Ramsel
66,Bergstraat 71,2018-07-23,18:00:00,128,74,54,FMN GV 11 Ramsel
66,Bergstraat 71,2018-07-23,19:00:00,124,44,80,FMN GV 11 Ramsel
66,Bergstraat 71,2018-07-23,20:00:00,130,56,74,FMN GV 11 Ramsel
66,Bergstraat 71,2018-07-23,21:00:00,50,34,16,FMN GV 11 Ramsel
66,Bergstraat 71,2018-07-23,22:00:00,22,16,6,FMN GV 11 Ramsel
66,Bergstraat 71,2018-07-23,23:00:00,8,4,4,FMN GV 11 Ramsel
66,Bergstraat 71,2018-07-24,00:00:00,4,4,0,FMN GV 11 Ramsel
66,Bergstraat 71,2018-07-24,01:00:00,0,0,0,FMN GV 11 Ramsel
66,Bergstraat 71,2018-07-24,02:00:00,2,2,0,FMN GV 11 Ramsel
66,Bergstraat 71,2018-07-24,03:00:00,0,0,0,FMN GV 11 Ramsel
66,Bergstraat 71,2018-07-24,04:00:00,0,0,0,FMN GV 11 Ramsel
66,Bergstraat 71,2018-07-24,05:00:00,10,6,4,FMN GV 11 Ramsel
66,Bergstraat 71,2018-07-24,06:00:00,38,18,20,FMN GV 11 Ramsel
66,Bergstraat 71,2018-07-24,07:00:00,56,18,38,FMN GV 11 Ramsel
66,Bergstraat 71,2018-07-24,08:00:00,84,40,44,FMN GV 11 Ramsel
66,Bergstraat 71,2018-07-24,09:00:00,160,60,100,FMN GV 11 Ramsel
66,Bergstraat 71,2018-07-24,10:00:00,154,84,70,FMN GV 11 Ramsel
66,Bergstraat 71,2018-07-24,11:00:00,138,54,84,FMN GV 11 Ramsel
66,Bergstraat 71,2018-07-24,12:00:00,100,60,40,FMN GV 11 Ramsel
66,Bergstraat 71,2018-07-24,13:00:00,144,110,34,FMN GV 11 Ramsel
66,Bergstraat 71,2018-07-24,14:00:00,146,80,66,FMN GV 11 Ramsel
66,Bergstraat 71,2018-07-24,15:00:00,108,56,52,FMN GV 11 Ramsel
66,Bergstraat 71,2018-07-24,16:00:00,128,48,80,FMN GV 11 Ramsel
66,Bergstraat 71,2018-07-24,17:00:00,124,58,66,FMN GV 11 Ramsel
66,Bergstraat 71,2018-07-24,18:00:00,160,72,88,FMN GV 11 Ramsel
66,Bergstraat 71,2018-07-24,19:00:00,120,70,50,FMN GV 11 Ramsel
66,Bergstraat 71,2018-07-24,20:00:00,86,40,46,FMN GV 11 Ramsel
66,Bergstraat 71,2018-07-24,21:00:00,78,32,46,FMN GV 11 Ramsel
66,Bergstraat 71,2018-07-24,22:00:00,10,8,2,FMN GV 11 Ramsel
66,Bergstraat 71,2018-07-24,23:00:00,2,2,0,FMN GV 11 Ramsel
66,Bergstraat 71,2018-07-25,00:00:00,0,0,0,FMN GV 11 Ramsel
66,Bergstraat 71,2018-07-25,01:00:00,2,2,0,FMN GV 11 Ramsel
66,Bergstraat 71,2018-07-25,02:00:00,2,2,0,FMN GV 11 Ramsel
66,Bergstraat 71,2018-07-25,03:00:00,0,0,0,FMN GV 11 Ramsel
66,Bergstraat 71,2018-07-25,04:00:00,0,0,0,FMN GV 11 Ramsel
66,Bergstraat 71,2018-07-25,05:00:00,8,4,4,FMN GV 11 Ramsel
66,Bergstraat 71,2018-07-25,06:00:00,42,12,30,FMN GV 11 Ramsel
66,Bergstraat 71,2018-07-25,07:00:00,46,12,34,FMN GV 11 Ramsel
66,Bergstraat 71,2018-07-25,08:00:00,70,22,48,FMN GV 11 Ramsel
66,Bergstraat 71,2018-07-25,09:00:00,126,44,82,FMN GV 11 Ramsel
66,Bergstraat 71,2018-07-25,10:00:00,134,64,70,FMN GV 11 Ramsel
66,Bergstraat 71,2018-07-25,11:00:00,114,66,48,FMN GV 11 Ramsel
66,Bergstraat 71,2018-07-25,12:00:00,90,66,24,FMN GV 11 Ramsel
66,Bergstraat 71,2018-07-25,13:00:00,116,72,44,FMN GV 11 Ramsel
66,Bergstraat 71,2018-07-25,14:00:00,100,36,64,FMN GV 11 Ramsel
66,Bergstraat 71,2018-07-25,15:00:00,112,42,70,FMN GV 11 Ramsel
66,Bergstraat 71,2018-07-25,16:00:00,76,20,56,FMN GV 11 Ramsel
66,Bergstraat 71,2018-07-25,17:00:00,78,48,30,FMN GV 11 Ramsel
66,Bergstraat 71,2018-07-25,18:00:00,78,50,28,FMN GV 11 Ramsel
66,Bergstraat 71,2018-07-25,19:00:00,66,26,40,FMN GV 11 Ramsel
66,Bergstraat 71,2018-07-25,20:00:00,50,30,20,FMN GV 11 Ramsel
66,Bergstraat 71,2018-07-25,21:00:00,36,28,8,FMN GV 11 Ramsel
66,Bergstraat 71,2018-07-25,22:00:00,18,16,2,FMN GV 11 Ramsel
66,Bergstraat 71,2018-07-25,23:00:00,4,4,0,FMN GV 11 Ramsel
66,Bergstraat 71,2018-07-26,00:00:00,0,0,0,FMN GV 11 Ramsel
66,Bergstraat 71,2018-07-26,01:00:00,2,2,0,FMN GV 11 Ramsel
66,Bergstraat 71,2018-07-26,02:00:00,2,2,0,FMN GV 11 Ramsel
66,Bergstraat 71,2018-07-26,03:00:00,0,0,0,FMN GV 11 Ramsel
66,Bergstraat 71,2018-07-26,04:00:00,2,2,0,FMN GV 11 Ramsel
66,Bergstraat 71,2018-07-26,05:00:00,10,4,6,FMN GV 11 Ramsel
66,Bergstraat 71,2018-07-26,06:00:00,20,2,18,FMN GV 11 Ramsel
66,Bergstraat 71,2018-07-26,07:00:00,68,24,44,FMN GV 11 Ramsel
66,Bergstraat 71,2018-07-26,08:00:00,100,24,76,FMN GV 11 Ramsel
66,Bergstraat 71,2018-07-26,09:00:00,152,76,76,FMN GV 11 Ramsel
66,Bergstraat 71,2018-07-26,10:00:00,124,54,70,FMN GV 11 Ramsel
66,Bergstraat 71,2018-07-26,11:00:00,120,76,44,FMN GV 11 Ramsel
66,Bergstraat 71,2018-07-26,12:00:00,50,26,24,FMN GV 11 Ramsel
66,Bergstraat 71,2018-07-26,13:00:00,92,50,42,FMN GV 11 Ramsel
66,Bergstraat 71,2018-07-26,14:00:00,52,20,32,FMN GV 11 Ramsel
66,Bergstraat 71,2018-07-26,15:00:00,86,52,34,FMN GV 11 Ramsel
66,Bergstraat 71,2018-07-26,16:00:00,42,22,20,FMN GV 11 Ramsel
66,Bergstraat 71,2018-07-26,17:00:00,76,40,36,FMN GV 11 Ramsel
66,Bergstraat 71,2018-07-26,18:00:00,54,24,30,FMN GV 11 Ramsel
66,Bergstraat 71,2018-07-26,19:00:00,70,30,40,FMN GV 11 Ramsel
66,Bergstraat 71,2018-07-26,20:00:00,36,24,12,FMN GV 11 Ramsel
66,Bergstraat 71,2018-07-26,21:00:00,58,46,12,FMN GV 11 Ramsel
66,Bergstraat 71,2018-07-26,22:00:00,24,14,10,FMN GV 11 Ramsel
66,Bergstraat 71,2018-07-26,23:00:00,2,2,0,FMN GV 11 Ramsel
66,Bergstraat 71,2018-07-27,00:00:00,0,0,0,FMN GV 11 Ramsel
66,Bergstraat 71,2018-07-27,01:00:00,4,0,4,FMN GV 11 Ramsel
66,Bergstraat 71,2018-07-27,02:00:00,2,0,2,FMN GV 11 Ramsel
66,Bergstraat 71,2018-07-27,03:00:00,0,0,0,FMN GV 11 Ramsel
66,Bergstraat 71,2018-07-27,04:00:00,2,2,0,FMN GV 11 Ramsel
66,Bergstraat 71,2018-07-27,05:00:00,6,4,2,FMN GV 11 Ramsel
66,Bergstraat 71,2018-07-27,06:00:00,18,8,10,FMN GV 11 Ramsel
66,Bergstraat 71,2018-07-27,07:00:00,44,12,32,FMN GV 11 Ramsel
66,Bergstraat 71,2018-07-27,08:00:00,66,20,46,FMN GV 11 Ramsel
66,Bergstraat 71,2018-07-27,09:00:00,128,72,56,FMN GV 11 Ramsel
66,Bergstraat 71,2018-07-27,10:00:00,132,76,56,FMN GV 11 Ramsel
66,Bergstraat 71,2018-07-27,11:00:00,168,106,62,FMN GV 11 Ramsel
66,Bergstraat 71,2018-07-27,12:00:00,40,26,14,FMN GV 11 Ramsel
66,Bergstraat 71,2018-07-27,13:00:00,92,64,28,FMN GV 11 Ramsel
66,Bergstraat 71,2018-07-27,14:00:00,42,22,20,FMN GV 11 Ramsel
66,Bergstraat 71,2018-07-27,15:00:00,54,32,22,FMN GV 11 Ramsel
66,Bergstraat 71,2018-07-27,16:00:00,40,18,22,FMN GV 11 Ramsel
66,Bergstraat 71,2018-07-27,17:00:00,36,22,14,FMN GV 11 Ramsel
66,Bergstraat 71,2018-07-27,18:00:00,52,22,30,FMN GV 11 Ramsel
66,Bergstraat 71,2018-07-27,19:00:00,88,40,48,FMN GV 11 Ramsel
66,Bergstraat 71,2018-07-27,20:00:00,56,30,26,FMN GV 11 Ramsel
66,Bergstraat 71,2018-07-27,21:00:00,44,18,26,FMN GV 11 Ramsel
66,Bergstraat 71,2018-07-27,22:00:00,36,30,6,FMN GV 11 Ramsel
66,Bergstraat 71,2018-07-27,23:00:00,8,6,2,FMN GV 11 Ramsel
66,Bergstraat 71,2018-07-28,00:00:00,12,10,2,FMN GV 11 Ramsel
66,Bergstraat 71,2018-07-28,01:00:00,4,4,0,FMN GV 11 Ramsel
66,Bergstraat 71,2018-07-28,02:00:00,6,6,0,FMN GV 11 Ramsel
66,Bergstraat 71,2018-07-28,03:00:00,2,2,0,FMN GV 11 Ramsel
66,Bergstraat 71,2018-07-28,04:00:00,0,0,0,FMN GV 11 Ramsel
66,Bergstraat 71,2018-07-28,05:00:00,0,0,0,FMN GV 11 Ramsel
66,Bergstraat 71,2018-07-28,06:00:00,2,2,0,FMN GV 11 Ramsel
66,Bergstraat 71,2018-07-28,07:00:00,6,2,4,FMN GV 11 Ramsel
66,Bergstraat 71,2018-07-28,08:00:00,44,10,34,FMN GV 11 Ramsel
66,Bergstraat 71,2018-07-28,09:00:00,30,8,22,FMN GV 11 Ramsel
66,Bergstraat 71,2018-07-28,10:00:00,48,38,10,FMN GV 11 Ramsel
66,Bergstraat 71,2018-07-28,11:00:00,170,32,138,FMN GV 11 Ramsel
66,Bergstraat 71,2018-07-28,12:00:00,94,36,58,FMN GV 11 Ramsel
66,Bergstraat 71,2018-07-28,13:00:00,100,28,72,FMN GV 11 Ramsel
66,Bergstraat 71,2018-07-28,14:00:00,154,72,82,FMN GV 11 Ramsel
66,Bergstraat 71,2018-07-28,15:00:00,142,86,56,FMN GV 11 Ramsel
66,Bergstraat 71,2018-07-28,16:00:00,138,70,68,FMN GV 11 Ramsel
66,Bergstraat 71,2018-07-28,17:00:00,76,42,34,FMN GV 11 Ramsel
66,Bergstraat 71,2018-07-28,18:00:00,64,36,28,FMN GV 11 Ramsel
66,Bergstraat 71,2018-07-28,19:00:00,48,36,12,FMN GV 11 Ramsel
66,Bergstraat 71,2018-07-28,20:00:00,50,14,36,FMN GV 11 Ramsel
66,Bergstraat 71,2018-07-28,21:00:00,16,6,10,FMN GV 11 Ramsel
66,Bergstraat 71,2018-07-28,22:00:00,14,6,8,FMN GV 11 Ramsel
66,Bergstraat 71,2018-07-28,23:00:00,14,4,10,FMN GV 11 Ramsel
66,Bergstraat 71,2018-07-29,00:00:00,4,2,2,FMN GV 11 Ramsel
66,Bergstraat 71,2018-07-29,01:00:00,2,2,0,FMN GV 11 Ramsel
66,Bergstraat 71,2018-07-29,02:00:00,2,0,2,FMN GV 11 Ramsel
66,Bergstraat 71,2018-07-29,03:00:00,4,2,2,FMN GV 11 Ramsel
66,Bergstraat 71,2018-07-29,04:00:00,0,0,0,FMN GV 11 Ramsel
66,Bergstraat 71,2018-07-29,05:00:00,2,2,0,FMN GV 11 Ramsel
66,Bergstraat 71,2018-07-29,06:00:00,2,2,0,FMN GV 11 Ramsel
66,Bergstraat 71,2018-07-29,07:00:00,26,14,12,FMN GV 11 Ramsel
66,Bergstraat 71,2018-07-29,08:00:00,106,30,76,FMN GV 11 Ramsel
66,Bergstraat 71,2018-07-29,09:00:00,166,54,112,FMN GV 11 Ramsel
66,Bergstraat 71,2018-07-29,10:00:00,220,122,98,FMN GV 11 Ramsel
66,Bergstraat 71,2018-07-29,11:00:00,172,86,86,FMN GV 11 Ramsel
66,Bergstraat 71,2018-07-29,12:00:00,170,78,92,FMN GV 11 Ramsel
66,Bergstraat 71,2018-07-29,13:00:00,190,98,92,FMN GV 11 Ramsel
66,Bergstraat 71,2018-07-29,14:00:00,196,92,104,FMN GV 11 Ramsel
66,Bergstraat 71,2018-07-29,15:00:00,212,120,92,FMN GV 11 Ramsel
66,Bergstraat 71,2018-07-29,16:00:00,150,74,76,FMN GV 11 Ramsel
66,Bergstraat 71,2018-07-29,17:00:00,158,76,82,FMN GV 11 Ramsel
66,Bergstraat 71,2018-07-29,18:00:00,90,38,52,FMN GV 11 Ramsel
66,Bergstraat 71,2018-07-29,19:00:00,48,20,28,FMN GV 11 Ramsel
66,Bergstraat 71,2018-07-29,20:00:00,56,24,32,FMN GV 11 Ramsel
66,Bergstraat 71,2018-07-29,21:00:00,20,14,6,FMN GV 11 Ramsel
66,Bergstraat 71,2018-07-29,22:00:00,16,14,2,FMN GV 11 Ramsel
66,Bergstraat 71,2018-07-29,23:00:00,8,4,4,FMN GV 11 Ramsel
66,Bergstraat 71,2018-07-30,00:00:00,4,4,0,FMN GV 11 Ramsel
66,Bergstraat 71,2018-07-30,01:00:00,2,2,0,FMN GV 11 Ramsel
66,Bergstraat 71,2018-07-30,02:00:00,2,2,0,FMN GV 11 Ramsel
66,Bergstraat 71,2018-07-30,03:00:00,0,0,0,FMN GV 11 Ramsel
66,Bergstraat 71,2018-07-30,04:00:00,4,4,0,FMN GV 11 Ramsel
66,Bergstraat 71,2018-07-30,05:00:00,12,6,6,FMN GV 11 Ramsel
66,Bergstraat 71,2018-07-30,06:00:00,28,4,24,FMN GV 11 Ramsel
66,Bergstraat 71,2018-07-30,07:00:00,46,18,28,FMN GV 11 Ramsel
66,Bergstraat 71,2018-07-30,08:00:00,60,20,40,FMN GV 11 Ramsel
66,Bergstraat 71,2018-07-30,09:00:00,88,38,50,FMN GV 11 Ramsel
66,Bergstraat 71,2018-07-30,10:00:00,102,60,42,FMN GV 11 Ramsel
66,Bergstraat 71,2018-07-30,11:00:00,110,40,70,FMN GV 11 Ramsel
66,Bergstraat 71,2018-07-30,12:00:00,84,44,40,FMN GV 11 Ramsel
66,Bergstraat 71,2018-07-30,13:00:00,202,114,88,FMN GV 11 Ramsel
66,Bergstraat 71,2018-07-30,14:00:00,166,86,80,FMN GV 11 Ramsel
66,Bergstraat 71,2018-07-30,15:00:00,176,82,94,FMN GV 11 Ramsel
66,Bergstraat 71,2018-07-30,16:00:00,150,98,52,FMN GV 11 Ramsel
66,Bergstraat 71,2018-07-30,17:00:00,120,76,44,FMN GV 11 Ramsel
66,Bergstraat 71,2018-07-30,18:00:00,98,50,48,FMN GV 11 Ramsel
66,Bergstraat 71,2018-07-30,19:00:00,104,40,64,FMN GV 11 Ramsel
66,Bergstraat 71,2018-07-30,20:00:00,102,44,58,FMN GV 11 Ramsel
66,Bergstraat 71,2018-07-30,21:00:00,64,36,28,FMN GV 11 Ramsel
66,Bergstraat 71,2018-07-30,22:00:00,28,16,12,FMN GV 11 Ramsel
66,Bergstraat 71,2018-07-30,23:00:00,14,12,2,FMN GV 11 Ramsel
66,Bergstraat 71,2018-07-31,00:00:00,6,6,0,FMN GV 11 Ramsel
66,Bergstraat 71,2018-07-31,01:00:00,2,2,0,FMN GV 11 Ramsel
66,Bergstraat 71,2018-07-31,02:00:00,0,0,0,FMN GV 11 Ramsel
66,Bergstraat 71,2018-07-31,03:00:00,0,0,0,FMN GV 11 Ramsel
66,Bergstraat 71,2018-07-31,04:00:00,4,2,2,FMN GV 11 Ramsel
66,Bergstraat 71,2018-07-31,05:00:00,14,8,6,FMN GV 11 Ramsel
66,Bergstraat 71,2018-07-31,06:00:00,58,18,40,FMN GV 11 Ramsel
66,Bergstraat 71,2018-07-31,07:00:00,60,14,46,FMN GV 11 Ramsel
66,Bergstraat 71,2018-07-31,08:00:00,46,14,32,FMN GV 11 Ramsel
66,Bergstraat 71,2018-07-31,09:00:00,96,30,66,FMN GV 11 Ramsel
66,Bergstraat 71,2018-07-31,10:00:00,124,56,68,FMN GV 11 Ramsel
66,Bergstraat 71,2018-07-31,11:00:00,152,88,64,FMN GV 11 Ramsel
66,Bergstraat 71,2018-07-31,12:00:00,128,50,78,FMN GV 11 Ramsel
66,Bergstraat 71,2018-07-31,13:00:00,214,78,136,FMN GV 11 Ramsel
66,Bergstraat 71,2018-07-31,14:00:00,200,98,102,FMN GV 11 Ramsel
66,Bergstraat 71,2018-07-31,15:00:00,182,80,102,FMN GV 11 Ramsel
66,Bergstraat 71,2018-07-31,16:00:00,214,122,92,FMN GV 11 Ramsel
66,Bergstraat 71,2018-07-31,17:00:00,206,108,98,FMN GV 11 Ramsel
66,Bergstraat 71,2018-07-31,18:00:00,198,100,98,FMN GV 11 Ramsel
66,Bergstraat 71,2018-07-31,19:00:00,138,58,80,FMN GV 11 Ramsel
66,Bergstraat 71,2018-07-31,20:00:00,130,82,48,FMN GV 11 Ramsel
66,Bergstraat 71,2018-07-31,21:00:00,58,42,16,FMN GV 11 Ramsel
66,Bergstraat 71,2018-07-31,22:00:00,30,18,12,FMN GV 11 Ramsel
66,Bergstraat 71,2018-07-31,23:00:00,6,6,0,FMN GV 11 Ramsel
66,Bergstraat 71,2018-08-01,00:00:00,0,0,0,FMN GV 11 Ramsel
66,Bergstraat 71,2018-08-01,01:00:00,0,0,0,FMN GV 11 Ramsel
66,Bergstraat 71,2018-08-01,02:00:00,0,0,0,FMN GV 11 Ramsel
66,Bergstraat 71,2018-08-01,03:00:00,0,0,0,FMN GV 11 Ramsel
66,Bergstraat 71,2018-08-01,04:00:00,2,2,0,FMN GV 11 Ramsel
66,Bergstraat 71,2018-08-01,05:00:00,4,2,2,FMN GV 11 Ramsel
66,Bergstraat 71,2018-08-01,06:00:00,42,12,30,FMN GV 11 Ramsel
66,Bergstraat 71,2018-08-01,07:00:00,64,26,38,FMN GV 11 Ramsel
66,Bergstraat 71,2018-08-01,08:00:00,86,28,58,FMN GV 11 Ramsel
66,Bergstraat 71,2018-08-01,09:00:00,72,30,42,FMN GV 11 Ramsel
66,Bergstraat 71,2018-08-01,10:00:00,164,64,100,FMN GV 11 Ramsel
66,Bergstraat 71,2018-08-01,11:00:00,92,48,44,FMN GV 11 Ramsel
66,Bergstraat 71,2018-08-01,12:00:00,136,70,66,FMN GV 11 Ramsel
66,Bergstraat 71,2018-08-01,13:00:00,254,86,168,FMN GV 11 Ramsel
66,Bergstraat 71,2018-08-01,14:00:00,118,64,54,FMN GV 11 Ramsel
66,Bergstraat 71,2018-08-01,15:00:00,104,56,48,FMN GV 11 Ramsel
66,Bergstraat 71,2018-08-01,16:00:00,204,104,100,FMN GV 11 Ramsel
66,Bergstraat 71,2018-08-01,17:00:00,150,82,68,FMN GV 11 Ramsel
66,Bergstraat 71,2018-08-01,18:00:00,138,62,76,FMN GV 11 Ramsel
66,Bergstraat 71,2018-08-01,19:00:00,164,78,86,FMN GV 11 Ramsel
66,Bergstraat 71,2018-08-01,20:00:00,124,76,48,FMN GV 11 Ramsel
66,Bergstraat 71,2018-08-01,21:00:00,48,30,18,FMN GV 11 Ramsel
66,Bergstraat 71,2018-08-01,22:00:00,28,20,8,FMN GV 11 Ramsel
66,Bergstraat 71,2018-08-01,23:00:00,4,4,0,FMN GV 11 Ramsel
66,Bergstraat 71,2018-08-02,00:00:00,0,0,0,FMN GV 11 Ramsel
66,Bergstraat 71,2018-08-02,01:00:00,2,2,0,FMN GV 11 Ramsel
66,Bergstraat 71,2018-08-02,02:00:00,0,0,0,FMN GV 11 Ramsel
66,Bergstraat 71,2018-08-02,03:00:00,0,0,0,FMN GV 11 Ramsel
66,Bergstraat 71,2018-08-02,04:00:00,6,6,0,FMN GV 11 Ramsel
66,Bergstraat 71,2018-08-02,05:00:00,10,4,6,FMN GV 11 Ramsel
66,Bergstraat 71,2018-08-02,06:00:00,34,6,28,FMN GV 11 Ramsel
66,Bergstraat 71,2018-08-02,07:00:00,72,18,54,FMN GV 11 Ramsel
66,Bergstraat 71,2018-08-02,08:00:00,60,22,38,FMN GV 11 Ramsel
66,Bergstraat 71,2018-08-02,09:00:00,188,70,118,FMN GV 11 Ramsel
66,Bergstraat 71,2018-08-02,10:00:00,180,98,82,FMN GV 11 Ramsel
66,Bergstraat 71,2018-08-02,11:00:00,114,56,58,FMN GV 11 Ramsel
66,Bergstraat 71,2018-08-02,12:00:00,102,56,46,FMN GV 11 Ramsel
66,Bergstraat 71,2018-08-02,13:00:00,118,70,48,FMN GV 11 Ramsel
66,Bergstraat 71,2018-08-02,14:00:00,118,64,54,FMN GV 11 Ramsel
66,Bergstraat 71,2018-08-02,15:00:00,124,58,66,FMN GV 11 Ramsel
66,Bergstraat 71,2018-08-02,16:00:00,128,44,84,FMN GV 11 Ramsel
66,Bergstraat 71,2018-08-02,17:00:00,122,78,44,FMN GV 11 Ramsel
66,Bergstraat 71,2018-08-02,18:00:00,122,46,76,FMN GV 11 Ramsel
66,Bergstraat 71,2018-08-02,19:00:00,80,46,34,FMN GV 11 Ramsel
66,Bergstraat 71,2018-08-02,20:00:00,100,56,44,FMN GV 11 Ramsel
66,Bergstraat 71,2018-08-02,21:00:00,60,30,30,FMN GV 11 Ramsel
66,Bergstraat 71,2018-08-02,22:00:00,44,20,24,FMN GV 11 Ramsel
66,Bergstraat 71,2018-08-02,23:00:00,14,10,4,FMN GV 11 Ramsel
66,Bergstraat 71,2018-08-03,00:00:00,6,6,0,FMN GV 11 Ramsel
66,Bergstraat 71,2018-08-03,01:00:00,2,2,0,FMN GV 11 Ramsel
66,Bergstraat 71,2018-08-03,02:00:00,0,0,0,FMN GV 11 Ramsel
66,Bergstraat 71,2018-08-03,03:00:00,4,2,2,FMN GV 11 Ramsel
66,Bergstraat 71,2018-08-03,04:00:00,4,4,0,FMN GV 11 Ramsel
66,Bergstraat 71,2018-08-03,05:00:00,6,4,2,FMN GV 11 Ramsel
66,Bergstraat 71,2018-08-03,06:00:00,34,8,26,FMN GV 11 Ramsel
66,Bergstraat 71,2018-08-03,07:00:00,44,8,36,FMN GV 11 Ramsel
66,Bergstraat 71,2018-08-03,08:00:00,66,34,32,FMN GV 11 Ramsel
66,Bergstraat 71,2018-08-03,09:00:00,118,50,68,FMN GV 11 Ramsel
66,Bergstraat 71,2018-08-03,10:00:00,122,42,80,FMN GV 11 Ramsel
66,Bergstraat 71,2018-08-03,11:00:00,120,66,54,FMN GV 11 Ramsel
66,Bergstraat 71,2018-08-03,12:00:00,80,40,40,FMN GV 11 Ramsel
66,Bergstraat 71,2018-08-03,13:00:00,88,38,50,FMN GV 11 Ramsel
66,Bergstraat 71,2018-08-03,14:00:00,88,46,42,FMN GV 11 Ramsel
66,Bergstraat 71,2018-08-03,15:00:00,108,56,52,FMN GV 11 Ramsel
66,Bergstraat 71,2018-08-03,16:00:00,82,52,30,FMN GV 11 Ramsel
66,Bergstraat 71,2018-08-03,17:00:00,148,64,84,FMN GV 11 Ramsel
66,Bergstraat 71,2018-08-03,18:00:00,104,58,46,FMN GV 11 Ramsel
66,Bergstraat 71,2018-08-03,19:00:00,84,26,58,FMN GV 11 Ramsel
66,Bergstraat 71,2018-08-03,20:00:00,88,56,32,FMN GV 11 Ramsel
66,Bergstraat 71,2018-08-03,21:00:00,38,24,14,FMN GV 11 Ramsel
66,Bergstraat 71,2018-08-03,22:00:00,16,14,2,FMN GV 11 Ramsel
66,Bergstraat 71,2018-08-03,23:00:00,12,8,4,FMN GV 11 Ramsel
66,Bergstraat 71,2018-08-04,00:00:00,8,4,4,FMN GV 11 Ramsel
66,Bergstraat 71,2018-08-04,01:00:00,8,6,2,FMN GV 11 Ramsel
66,Bergstraat 71,2018-08-04,02:00:00,4,4,0,FMN GV 11 Ramsel
66,Bergstraat 71,2018-08-04,03:00:00,2,2,0,FMN GV 11 Ramsel
66,Bergstraat 71,2018-08-04,04:00:00,4,4,0,FMN GV 11 Ramsel
66,Bergstraat 71,2018-08-04,05:00:00,2,2,0,FMN GV 11 Ramsel
66,Bergstraat 71,2018-08-04,06:00:00,10,4,6,FMN GV 11 Ramsel
66,Bergstraat 71,2018-08-04,07:00:00,32,8,24,FMN GV 11 Ramsel
66,Bergstraat 71,2018-08-04,08:00:00,78,22,56,FMN GV 11 Ramsel
66,Bergstraat 71,2018-08-04,09:00:00,114,60,54,FMN GV 11 Ramsel
66,Bergstraat 71,2018-08-04,10:00:00,146,68,78,FMN GV 11 Ramsel
66,Bergstraat 71,2018-08-04,11:00:00,212,108,104,FMN GV 11 Ramsel
66,Bergstraat 71,2018-08-04,12:00:00,120,68,52,FMN GV 11 Ramsel
66,Bergstraat 71,2018-08-04,13:00:00,78,36,42,FMN GV 11 Ramsel
66,Bergstraat 71,2018-08-04,14:00:00,146,52,94,FMN GV 11 Ramsel
66,Bergstraat 71,2018-08-04,15:00:00,128,62,66,FMN GV 11 Ramsel
66,Bergstraat 71,2018-08-04,16:00:00,134,74,60,FMN GV 11 Ramsel
66,Bergstraat 71,2018-08-04,17:00:00,94,44,50,FMN GV 11 Ramsel
66,Bergstraat 71,2018-08-04,18:00:00,88,42,46,FMN GV 11 Ramsel
66,Bergstraat 71,2018-08-04,19:00:00,60,36,24,FMN GV 11 Ramsel
66,Bergstraat 71,2018-08-04,20:00:00,70,34,36,FMN GV 11 Ramsel
66,Bergstraat 71,2018-08-04,21:00:00,80,44,36,FMN GV 11 Ramsel
66,Bergstraat 71,2018-08-04,22:00:00,44,32,12,FMN GV 11 Ramsel
66,Bergstraat 71,2018-08-04,23:00:00,6,6,0,FMN GV 11 Ramsel
66,Bergstraat 71,2018-08-05,00:00:00,4,2,2,FMN GV 11 Ramsel
66,Bergstraat 71,2018-08-05,01:00:00,8,8,0,FMN GV 11 Ramsel
66,Bergstraat 71,2018-08-05,02:00:00,4,2,2,FMN GV 11 Ramsel
66,Bergstraat 71,2018-08-05,03:00:00,2,2,0,FMN GV 11 Ramsel
66,Bergstraat 71,2018-08-05,04:00:00,4,4,0,FMN GV 11 Ramsel
66,Bergstraat 71,2018-08-05,05:00:00,0,0,0,FMN GV 11 Ramsel
66,Bergstraat 71,2018-08-05,06:00:00,18,10,8,FMN GV 11 Ramsel
66,Bergstraat 71,2018-08-05,07:00:00,50,28,22,FMN GV 11 Ramsel
66,Bergstraat 71,2018-08-05,08:00:00,122,58,64,FMN GV 11 Ramsel
66,Bergstraat 71,2018-08-05,09:00:00,204,104,100,FMN GV 11 Ramsel
66,Bergstraat 71,2018-08-05,10:00:00,244,122,122,FMN GV 11 Ramsel
66,Bergstraat 71,2018-08-05,11:00:00,232,138,94,FMN GV 11 Ramsel
66,Bergstraat 71,2018-08-05,12:00:00,154,72,82,FMN GV 11 Ramsel
66,Bergstraat 71,2018-08-05,13:00:00,208,108,100,FMN GV 11 Ramsel
66,Bergstraat 71,2018-08-05,14:00:00,198,86,112,FMN GV 11 Ramsel
66,Bergstraat 71,2018-08-05,15:00:00,180,86,94,FMN GV 11 Ramsel
66,Bergstraat 71,2018-08-05,16:00:00,162,74,88,FMN GV 11 Ramsel
66,Bergstraat 71,2018-08-05,17:00:00,154,70,84,FMN GV 11 Ramsel
66,Bergstraat 71,2018-08-05,18:00:00,126,44,82,FMN GV 11 Ramsel
66,Bergstraat 71,2018-08-05,19:00:00,82,40,42,FMN GV 11 Ramsel
66,Bergstraat 71,2018-08-05,20:00:00,100,56,44,FMN GV 11 Ramsel
66,Bergstraat 71,2018-08-05,21:00:00,74,28,46,FMN GV 11 Ramsel
66,Bergstraat 71,2018-08-05,22:00:00,16,16,0,FMN GV 11 Ramsel
66,Bergstraat 71,2018-08-05,23:00:00,6,6,0,FMN GV 11 Ramsel
66,Bergstraat 71,2018-08-06,00:00:00,2,2,0,FMN GV 11 Ramsel
66,Bergstraat 71,2018-08-06,01:00:00,2,2,0,FMN GV 11 Ramsel
66,Bergstraat 71,2018-08-06,02:00:00,0,0,0,FMN GV 11 Ramsel
66,Bergstraat 71,2018-08-06,03:00:00,0,0,0,FMN GV 11 Ramsel
66,Bergstraat 71,2018-08-06,04:00:00,4,4,0,FMN GV 11 Ramsel
66,Bergstraat 71,2018-08-06,05:00:00,10,6,4,FMN GV 11 Ramsel
66,Bergstraat 71,2018-08-06,06:00:00,24,10,14,FMN GV 11 Ramsel
66,Bergstraat 71,2018-08-06,07:00:00,64,10,54,FMN GV 11 Ramsel
66,Bergstraat 71,2018-08-06,08:00:00,80,36,44,FMN GV 11 Ramsel
66,Bergstraat 71,2018-08-06,09:00:00,116,48,68,FMN GV 11 Ramsel
66,Bergstraat 71,2018-08-06,10:00:00,118,52,66,FMN GV 11 Ramsel
66,Bergstraat 71,2018-08-06,11:00:00,100,60,40,FMN GV 11 Ramsel
66,Bergstraat 71,2018-08-06,12:00:00,84,36,48,FMN GV 11 Ramsel
66,Bergstraat 71,2018-08-06,13:00:00,148,84,64,FMN GV 11 Ramsel
66,Bergstraat 71,2018-08-06,14:00:00,84,32,52,FMN GV 11 Ramsel
66,Bergstraat 71,2018-08-06,15:00:00,120,50,70,FMN GV 11 Ramsel
66,Bergstraat 71,2018-08-06,16:00:00,86,38,48,FMN GV 11 Ramsel
66,Bergstraat 71,2018-08-06,17:00:00,98,66,32,FMN GV 11 Ramsel
66,Bergstraat 71,2018-08-06,18:00:00,94,44,50,FMN GV 11 Ramsel
66,Bergstraat 71,2018-08-06,19:00:00,68,36,32,FMN GV 11 Ramsel
66,Bergstraat 71,2018-08-06,20:00:00,94,44,50,FMN GV 11 Ramsel
66,Bergstraat 71,2018-08-06,21:00:00,74,42,32,FMN GV 11 Ramsel
66,Bergstraat 71,2018-08-06,22:00:00,34,20,14,FMN GV 11 Ramsel
66,Bergstraat 71,2018-08-06,23:00:00,6,4,2,FMN GV 11 Ramsel
66,Bergstraat 71,2018-08-07,00:00:00,4,2,2,FMN GV 11 Ramsel
66,Bergstraat 71,2018-08-07,01:00:00,0,0,0,FMN GV 11 Ramsel
66,Bergstraat 71,2018-08-07,02:00:00,0,0,0,FMN GV 11 Ramsel
66,Bergstraat 71,2018-08-07,03:00:00,0,0,0,FMN GV 11 Ramsel
66,Bergstraat 71,2018-08-07,04:00:00,6,6,0,FMN GV 11 Ramsel
66,Bergstraat 71,2018-08-07,05:00:00,20,8,12,FMN GV 11 Ramsel
66,Bergstraat 71,2018-08-07,06:00:00,38,12,26,FMN GV 11 Ramsel
66,Bergstraat 71,2018-08-07,07:00:00,58,12,46,FMN GV 11 Ramsel
66,Bergstraat 71,2018-08-07,08:00:00,94,38,56,FMN GV 11 Ramsel
66,Bergstraat 71,2018-08-07,09:00:00,128,52,76,FMN GV 11 Ramsel
66,Bergstraat 71,2018-08-07,10:00:00,166,96,70,FMN GV 11 Ramsel
66,Bergstraat 71,2018-08-07,11:00:00,104,58,46,FMN GV 11 Ramsel
66,Bergstraat 71,2018-08-07,12:00:00,90,56,34,FMN GV 11 Ramsel
66,Bergstraat 71,2018-08-07,13:00:00,70,36,34,FMN GV 11 Ramsel
66,Bergstraat 71,2018-08-07,14:00:00,90,54,36,FMN GV 11 Ramsel
66,Bergstraat 71,2018-08-07,15:00:00,52,34,18,FMN GV 11 Ramsel
66,Bergstraat 71,2018-08-07,16:00:00,116,60,56,FMN GV 11 Ramsel
66,Bergstraat 71,2018-08-07,17:00:00,92,54,38,FMN GV 11 Ramsel
66,Bergstraat 71,2018-08-07,18:00:00,62,34,28,FMN GV 11 Ramsel
66,Bergstraat 71,2018-08-07,19:00:00,108,62,46,FMN GV 11 Ramsel
66,Bergstraat 71,2018-08-07,20:00:00,40,26,14,FMN GV 11 Ramsel
66,Bergstraat 71,2018-08-07,21:00:00,32,20,12,FMN GV 11 Ramsel
66,Bergstraat 71,2018-08-07,22:00:00,20,12,8,FMN GV 11 Ramsel
66,Bergstraat 71,2018-08-07,23:00:00,6,6,0,FMN GV 11 Ramsel
66,Bergstraat 71,2018-08-08,00:00:00,2,0,2,FMN GV 11 Ramsel
66,Bergstraat 71,2018-08-08,01:00:00,4,2,2,FMN GV 11 Ramsel
66,Bergstraat 71,2018-08-08,02:00:00,0,0,0,FMN GV 11 Ramsel
66,Bergstraat 71,2018-08-08,03:00:00,0,0,0,FMN GV 11 Ramsel
66,Bergstraat 71,2018-08-08,04:00:00,2,2,0,FMN GV 11 Ramsel
66,Bergstraat 71,2018-08-08,05:00:00,10,2,8,FMN GV 11 Ramsel
66,Bergstraat 71,2018-08-08,06:00:00,28,8,20,FMN GV 11 Ramsel
66,Bergstraat 71,2018-08-08,07:00:00,34,12,22,FMN GV 11 Ramsel
66,Bergstraat 71,2018-08-08,08:00:00,38,6,32,FMN GV 11 Ramsel
66,Bergstraat 71,2018-08-08,09:00:00,50,36,14,FMN GV 11 Ramsel
66,Bergstraat 71,2018-08-08,10:00:00,74,24,50,FMN GV 11 Ramsel
66,Bergstraat 71,2018-08-08,11:00:00,36,10,26,FMN GV 11 Ramsel
66,Bergstraat 71,2018-08-08,12:00:00,78,40,38,FMN GV 11 Ramsel
66,Bergstraat 71,2018-08-08,13:00:00,116,72,44,FMN GV 11 Ramsel
66,Bergstraat 71,2018-08-08,14:00:00,98,60,38,FMN GV 11 Ramsel
66,Bergstraat 71,2018-08-08,15:00:00,108,62,46,FMN GV 11 Ramsel
66,Bergstraat 71,2018-08-08,16:00:00,128,58,70,FMN GV 11 Ramsel
66,Bergstraat 71,2018-08-08,17:00:00,132,64,68,FMN GV 11 Ramsel
66,Bergstraat 71,2018-08-08,18:00:00,114,56,58,FMN GV 11 Ramsel
66,Bergstraat 71,2018-08-08,19:00:00,64,26,38,FMN GV 11 Ramsel
66,Bergstraat 71,2018-08-08,20:00:00,78,58,20,FMN GV 11 Ramsel
66,Bergstraat 71,2018-08-08,21:00:00,28,18,10,FMN GV 11 Ramsel
66,Bergstraat 71,2018-08-08,22:00:00,12,12,0,FMN GV 11 Ramsel
66,Bergstraat 71,2018-08-08,23:00:00,10,10,0,FMN GV 11 Ramsel
66,Bergstraat 71,2018-08-09,00:00:00,0,0,0,FMN GV 11 Ramsel
66,Bergstraat 71,2018-08-09,01:00:00,0,0,0,FMN GV 11 Ramsel
66,Bergstraat 71,2018-08-09,02:00:00,2,0,2,FMN GV 11 Ramsel
66,Bergstraat 71,2018-08-09,03:00:00,0,0,0,FMN GV 11 Ramsel
66,Bergstraat 71,2018-08-09,04:00:00,2,2,0,FMN GV 11 Ramsel
66,Bergstraat 71,2018-08-09,05:00:00,6,4,2,FMN GV 11 Ramsel
66,Bergstraat 71,2018-08-09,06:00:00,22,8,14,FMN GV 11 Ramsel
66,Bergstraat 71,2018-08-09,07:00:00,24,6,18,FMN GV 11 Ramsel
66,Bergstraat 71,2018-08-09,08:00:00,56,22,34,FMN GV 11 Ramsel
66,Bergstraat 71,2018-08-09,09:00:00,50,22,28,FMN GV 11 Ramsel
66,Bergstraat 71,2018-08-09,10:00:00,34,20,14,FMN GV 11 Ramsel
66,Bergstraat 71,2018-08-09,11:00:00,24,10,14,FMN GV 11 Ramsel
66,Bergstraat 71,2018-08-09,12:00:00,28,10,18,FMN GV 11 Ramsel
66,Bergstraat 71,2018-08-09,13:00:00,24,14,10,FMN GV 11 Ramsel
66,Bergstraat 71,2018-08-09,14:00:00,6,4,2,FMN GV 11 Ramsel
66,Bergstraat 71,2018-08-09,15:00:00,22,6,16,FMN GV 11 Ramsel
66,Bergstraat 71,2018-08-09,16:00:00,82,52,30,FMN GV 11 Ramsel
66,Bergstraat 71,2018-08-09,17:00:00,62,32,30,FMN GV 11 Ramsel
66,Bergstraat 71,2018-08-09,18:00:00,54,36,18,FMN GV 11 Ramsel
66,Bergstraat 71,2018-08-09,19:00:00,46,34,12,FMN GV 11 Ramsel
66,Bergstraat 71,2018-08-09,20:00:00,28,14,14,FMN GV 11 Ramsel
66,Bergstraat 71,2018-08-09,21:00:00,18,12,6,FMN GV 11 Ramsel
66,Bergstraat 71,2018-08-09,22:00:00,10,8,2,FMN GV 11 Ramsel
66,Bergstraat 71,2018-08-09,23:00:00,4,0,4,FMN GV 11 Ramsel
66,Bergstraat 71,2018-08-10,00:00:00,4,2,2,FMN GV 11 Ramsel
66,Bergstraat 71,2018-08-10,01:00:00,0,0,0,FMN GV 11 Ramsel
66,Bergstraat 71,2018-08-10,02:00:00,0,0,0,FMN GV 11 Ramsel
66,Bergstraat 71,2018-08-10,03:00:00,0,0,0,FMN GV 11 Ramsel
66,Bergstraat 71,2018-08-10,04:00:00,2,2,0,FMN GV 11 Ramsel
66,Bergstraat 71,2018-08-10,05:00:00,8,6,2,FMN GV 11 Ramsel
66,Bergstraat 71,2018-08-10,06:00:00,30,4,26,FMN GV 11 Ramsel
66,Bergstraat 71,2018-08-10,07:00:00,26,8,18,FMN GV 11 Ramsel
66,Bergstraat 71,2018-08-10,08:00:00,40,10,30,FMN GV 11 Ramsel
66,Bergstraat 71,2018-08-10,09:00:00,46,8,38,FMN GV 11 Ramsel
66,Bergstraat 71,2018-08-10,10:00:00,78,40,38,FMN GV 11 Ramsel
66,Bergstraat 71,2018-08-10,11:00:00,68,34,34,FMN GV 11 Ramsel
66,Bergstraat 71,2018-08-10,12:00:00,106,46,60,FMN GV 11 Ramsel
66,Bergstraat 71,2018-08-10,13:00:00,114,48,66,FMN GV 11 Ramsel
66,Bergstraat 71,2018-08-10,14:00:00,108,52,56,FMN GV 11 Ramsel
66,Bergstraat 71,2018-08-10,15:00:00,134,72,62,FMN GV 11 Ramsel
66,Bergstraat 71,2018-08-10,16:00:00,98,50,48,FMN GV 11 Ramsel
66,Bergstraat 71,2018-08-10,17:00:00,128,80,48,FMN GV 11 Ramsel
66,Bergstraat 71,2018-08-10,18:00:00,60,40,20,FMN GV 11 Ramsel
66,Bergstraat 71,2018-08-10,19:00:00,46,20,26,FMN GV 11 Ramsel
66,Bergstraat 71,2018-08-10,20:00:00,34,12,22,FMN GV 11 Ramsel
66,Bergstraat 71,2018-08-10,21:00:00,16,10,6,FMN GV 11 Ramsel
66,Bergstraat 71,2018-08-10,22:00:00,10,6,4,FMN GV 11 Ramsel
66,Bergstraat 71,2018-08-10,23:00:00,8,2,6,FMN GV 11 Ramsel
66,Bergstraat 71,2018-08-11,00:00:00,8,8,0,FMN GV 11 Ramsel
66,Bergstraat 71,2018-08-11,01:00:00,4,4,0,FMN GV 11 Ramsel
66,Bergstraat 71,2018-08-11,02:00:00,2,2,0,FMN GV 11 Ramsel
66,Bergstraat 71,2018-08-11,03:00:00,4,2,2,FMN GV 11 Ramsel
66,Bergstraat 71,2018-08-11,04:00:00,0,0,0,FMN GV 11 Ramsel
66,Bergstraat 71,2018-08-11,05:00:00,0,0,0,FMN GV 11 Ramsel
66,Bergstraat 71,2018-08-11,06:00:00,0,0,0,FMN GV 11 Ramsel
66,Bergstraat 71,2018-08-11,07:00:00,8,4,4,FMN GV 11 Ramsel
66,Bergstraat 71,2018-08-11,08:00:00,28,10,18,FMN GV 11 Ramsel
66,Bergstraat 71,2018-08-11,09:00:00,78,22,56,FMN GV 11 Ramsel
66,Bergstraat 71,2018-08-11,10:00:00,112,48,64,FMN GV 11 Ramsel
66,Bergstraat 71,2018-08-11,11:00:00,174,124,50,FMN GV 11 Ramsel
66,Bergstraat 71,2018-08-11,12:00:00,180,100,80,FMN GV 11 Ramsel
66,Bergstraat 71,2018-08-11,13:00:00,134,72,62,FMN GV 11 Ramsel
66,Bergstraat 71,2018-08-11,14:00:00,186,110,76,FMN GV 11 Ramsel
66,Bergstraat 71,2018-08-11,15:00:00,176,88,88,FMN GV 11 Ramsel
66,Bergstraat 71,2018-08-11,16:00:00,158,70,88,FMN GV 11 Ramsel
66,Bergstraat 71,2018-08-11,17:00:00,84,52,32,FMN GV 11 Ramsel
66,Bergstraat 71,2018-08-11,18:00:00,88,56,32,FMN GV 11 Ramsel
66,Bergstraat 71,2018-08-11,19:00:00,64,28,36,FMN GV 11 Ramsel
66,Bergstraat 71,2018-08-11,20:00:00,52,24,28,FMN GV 11 Ramsel
66,Bergstraat 71,2018-08-11,21:00:00,16,10,6,FMN GV 11 Ramsel
66,Bergstraat 71,2018-08-11,22:00:00,14,4,10,FMN GV 11 Ramsel
66,Bergstraat 71,2018-08-11,23:00:00,2,2,0,FMN GV 11 Ramsel
66,Bergstraat 71,2018-08-12,00:00:00,6,6,0,FMN GV 11 Ramsel
66,Bergstraat 71,2018-08-12,01:00:00,4,2,2,FMN GV 11 Ramsel
66,Bergstraat 71,2018-08-12,02:00:00,8,8,0,FMN GV 11 Ramsel
66,Bergstraat 71,2018-08-12,03:00:00,6,6,0,FMN GV 11 Ramsel
66,Bergstraat 71,2018-08-12,04:00:00,2,2,0,FMN GV 11 Ramsel
66,Bergstraat 71,2018-08-12,05:00:00,4,0,4,FMN GV 11 Ramsel
66,Bergstraat 71,2018-08-12,06:00:00,12,8,4,FMN GV 11 Ramsel
66,Bergstraat 71,2018-08-12,07:00:00,26,12,14,FMN GV 11 Ramsel
66,Bergstraat 71,2018-08-12,08:00:00,70,28,42,FMN GV 11 Ramsel
66,Bergstraat 71,2018-08-12,09:00:00,164,64,100,FMN GV 11 Ramsel
66,Bergstraat 71,2018-08-12,10:00:00,222,122,100,FMN GV 11 Ramsel
66,Bergstraat 71,2018-08-12,11:00:00,192,94,98,FMN GV 11 Ramsel
66,Bergstraat 71,2018-08-12,12:00:00,238,118,120,FMN GV 11 Ramsel
66,Bergstraat 71,2018-08-12,13:00:00,318,176,142,FMN GV 11 Ramsel
66,Bergstraat 71,2018-08-12,14:00:00,304,136,168,FMN GV 11 Ramsel
66,Bergstraat 71,2018-08-12,15:00:00,346,178,168,FMN GV 11 Ramsel
66,Bergstraat 71,2018-08-12,16:00:00,226,128,98,FMN GV 11 Ramsel
66,Bergstraat 71,2018-08-12,17:00:00,148,84,64,FMN GV 11 Ramsel
66,Bergstraat 71,2018-08-12,18:00:00,102,58,44,FMN GV 11 Ramsel
66,Bergstraat 71,2018-08-12,19:00:00,60,36,24,FMN GV 11 Ramsel
66,Bergstraat 71,2018-08-12,20:00:00,54,34,20,FMN GV 11 Ramsel
66,Bergstraat 71,2018-08-12,21:00:00,26,12,14,FMN GV 11 Ramsel
66,Bergstraat 71,2018-08-12,22:00:00,22,10,12,FMN GV 11 Ramsel
66,Bergstraat 71,2018-08-12,23:00:00,8,2,6,FMN GV 11 Ramsel
66,Bergstraat 71,2018-08-13,00:00:00,6,4,2,FMN GV 11 Ramsel
66,Bergstraat 71,2018-08-13,01:00:00,2,0,2,FMN GV 11 Ramsel
66,Bergstraat 71,2018-08-13,02:00:00,0,0,0,FMN GV 11 Ramsel
66,Bergstraat 71,2018-08-13,03:00:00,0,0,0,FMN GV 11 Ramsel
66,Bergstraat 71,2018-08-13,04:00:00,2,2,0,FMN GV 11 Ramsel
66,Bergstraat 71,2018-08-13,05:00:00,4,2,2,FMN GV 11 Ramsel
66,Bergstraat 71,2018-08-13,06:00:00,18,6,12,FMN GV 11 Ramsel
66,Bergstraat 71,2018-08-13,07:00:00,26,4,22,FMN GV 11 Ramsel
66,Bergstraat 71,2018-08-13,08:00:00,16,6,10,FMN GV 11 Ramsel
66,Bergstraat 71,2018-08-13,09:00:00,16,6,10,FMN GV 11 Ramsel
66,Bergstraat 71,2018-08-13,10:00:00,24,8,16,FMN GV 11 Ramsel
66,Bergstraat 71,2018-08-13,11:00:00,8,4,4,FMN GV 11 Ramsel
66,Bergstraat 71,2018-08-13,12:00:00,34,12,22,FMN GV 11 Ramsel
66,Bergstraat 71,2018-08-13,13:00:00,28,16,12,FMN GV 11 Ramsel
66,Bergstraat 71,2018-08-13,14:00:00,42,14,28,FMN GV 11 Ramsel
66,Bergstraat 71,2018-08-13,15:00:00,14,8,6,FMN GV 11 Ramsel
66,Bergstraat 71,2018-08-13,16:00:00,34,12,22,FMN GV 11 Ramsel
66,Bergstraat 71,2018-08-13,17:00:00,34,16,18,FMN GV 11 Ramsel
66,Bergstraat 71,2018-08-13,18:00:00,42,24,18,FMN GV 11 Ramsel
66,Bergstraat 71,2018-08-13,19:00:00,48,24,24,FMN GV 11 Ramsel
66,Bergstraat 71,2018-08-13,20:00:00,40,14,26,FMN GV 11 Ramsel
66,Bergstraat 71,2018-08-13,21:00:00,24,16,8,FMN GV 11 Ramsel
66,Bergstraat 71,2018-08-13,22:00:00,6,4,2,FMN GV 11 Ramsel
66,Bergstraat 71,2018-08-13,23:00:00,4,2,2,FMN GV 11 Ramsel
66,Bergstraat 71,2018-08-14,00:00:00,0,0,0,FMN GV 11 Ramsel
66,Bergstraat 71,2018-08-14,01:00:00,2,2,0,FMN GV 11 Ramsel
66,Bergstraat 71,2018-08-14,02:00:00,0,0,0,FMN GV 11 Ramsel
66,Bergstraat 71,2018-08-14,03:00:00,0,0,0,FMN GV 11 Ramsel
66,Bergstraat 71,2018-08-14,04:00:00,2,2,0,FMN GV 11 Ramsel
66,Bergstraat 71,2018-08-14,05:00:00,10,6,4,FMN GV 11 Ramsel
66,Bergstraat 71,2018-08-14,06:00:00,20,4,16,FMN GV 11 Ramsel
66,Bergstraat 71,2018-08-14,07:00:00,36,10,26,FMN GV 11 Ramsel
66,Bergstraat 71,2018-08-14,08:00:00,26,12,14,FMN GV 11 Ramsel
66,Bergstraat 71,2018-08-14,09:00:00,42,16,26,FMN GV 11 Ramsel
66,Bergstraat 71,2018-08-14,10:00:00,86,32,54,FMN GV 11 Ramsel
66,Bergstraat 71,2018-08-14,11:00:00,50,26,24,FMN GV 11 Ramsel
66,Bergstraat 71,2018-08-14,12:00:00,82,54,28,FMN GV 11 Ramsel
66,Bergstraat 71,2018-08-14,13:00:00,154,70,84,FMN GV 11 Ramsel
66,Bergstraat 71,2018-08-14,14:00:00,126,62,64,FMN GV 11 Ramsel
66,Bergstraat 71,2018-08-14,15:00:00,154,124,30,FMN GV 11 Ramsel
66,Bergstraat 71,2018-08-14,16:00:00,136,62,74,FMN GV 11 Ramsel
66,Bergstraat 71,2018-08-14,17:00:00,110,46,64,FMN GV 11 Ramsel
66,Bergstraat 71,2018-08-14,18:00:00,114,58,56,FMN GV 11 Ramsel
66,Bergstraat 71,2018-08-14,19:00:00,60,38,22,FMN GV 11 Ramsel
66,Bergstraat 71,2018-08-14,20:00:00,36,28,8,FMN GV 11 Ramsel
66,Bergstraat 71,2018-08-14,21:00:00,28,24,4,FMN GV 11 Ramsel
66,Bergstraat 71,2018-08-14,22:00:00,22,12,10,FMN GV 11 Ramsel
66,Bergstraat 71,2018-08-14,23:00:00,4,2,2,FMN GV 11 Ramsel
66,Bergstraat 71,2018-08-15,00:00:00,2,2,0,FMN GV 11 Ramsel
66,Bergstraat 71,2018-08-15,01:00:00,8,8,0,FMN GV 11 Ramsel
66,Bergstraat 71,2018-08-15,02:00:00,4,4,0,FMN GV 11 Ramsel
66,Bergstraat 71,2018-08-15,03:00:00,10,6,4,FMN GV 11 Ramsel
66,Bergstraat 71,2018-08-15,04:00:00,0,0,0,FMN GV 11 Ramsel
66,Bergstraat 71,2018-08-15,05:00:00,0,0,0,FMN GV 11 Ramsel
66,Bergstraat 71,2018-08-15,06:00:00,10,6,4,FMN GV 11 Ramsel
66,Bergstraat 71,2018-08-15,07:00:00,28,6,22,FMN GV 11 Ramsel
66,Bergstraat 71,2018-08-15,08:00:00,78,34,44,FMN GV 11 Ramsel
66,Bergstraat 71,2018-08-15,09:00:00,96,36,60,FMN GV 11 Ramsel
66,Bergstraat 71,2018-08-15,10:00:00,132,72,60,FMN GV 11 Ramsel
66,Bergstraat 71,2018-08-15,11:00:00,174,84,90,FMN GV 11 Ramsel
66,Bergstraat 71,2018-08-15,12:00:00,148,78,70,FMN GV 11 Ramsel
66,Bergstraat 71,2018-08-15,13:00:00,198,80,118,FMN GV 11 Ramsel
66,Bergstraat 71,2018-08-15,14:00:00,208,74,134,FMN GV 11 Ramsel
66,Bergstraat 71,2018-08-15,15:00:00,196,118,78,FMN GV 11 Ramsel
66,Bergstraat 71,2018-08-15,16:00:00,156,90,66,FMN GV 11 Ramsel
66,Bergstraat 71,2018-08-15,17:00:00,140,90,50,FMN GV 11 Ramsel
66,Bergstraat 71,2018-08-15,18:00:00,120,66,54,FMN GV 11 Ramsel
66,Bergstraat 71,2018-08-15,19:00:00,90,28,62,FMN GV 11 Ramsel
66,Bergstraat 71,2018-08-15,20:00:00,72,16,56,FMN GV 11 Ramsel
66,Bergstraat 71,2018-08-15,21:00:00,52,16,36,FMN GV 11 Ramsel
66,Bergstraat 71,2018-08-15,22:00:00,54,30,24,FMN GV 11 Ramsel
66,Bergstraat 71,2018-08-15,23:00:00,56,54,2,FMN GV 11 Ramsel
66,Bergstraat 71,2018-08-16,00:00:00,38,38,0,FMN GV 11 Ramsel
66,Bergstraat 71,2018-08-16,01:00:00,18,18,0,FMN GV 11 Ramsel
66,Bergstraat 71,2018-08-16,02:00:00,6,6,0,FMN GV 11 Ramsel
66,Bergstraat 71,2018-08-16,03:00:00,2,2,0,FMN GV 11 Ramsel
66,Bergstraat 71,2018-08-16,04:00:00,4,2,2,FMN GV 11 Ramsel
66,Bergstraat 71,2018-08-16,05:00:00,2,0,2,FMN GV 11 Ramsel
66,Bergstraat 71,2018-08-16,06:00:00,26,6,20,FMN GV 11 Ramsel
66,Bergstraat 71,2018-08-16,07:00:00,40,14,26,FMN GV 11 Ramsel
66,Bergstraat 71,2018-08-16,08:00:00,32,12,20,FMN GV 11 Ramsel
66,Bergstraat 71,2018-08-16,09:00:00,62,16,46,FMN GV 11 Ramsel
66,Bergstraat 71,2018-08-16,10:00:00,170,54,116,FMN GV 11 Ramsel
66,Bergstraat 71,2018-08-16,11:00:00,124,58,66,FMN GV 11 Ramsel
66,Bergstraat 71,2018-08-16,12:00:00,118,56,62,FMN GV 11 Ramsel
66,Bergstraat 71,2018-08-16,13:00:00,180,88,92,FMN GV 11 Ramsel
66,Bergstraat 71,2018-08-16,14:00:00,226,118,108,FMN GV 11 Ramsel
66,Bergstraat 71,2018-08-16,15:00:00,250,172,78,FMN GV 11 Ramsel
66,Bergstraat 71,2018-08-16,16:00:00,200,118,82,FMN GV 11 Ramsel
66,Bergstraat 71,2018-08-16,17:00:00,144,70,74,FMN GV 11 Ramsel
66,Bergstraat 71,2018-08-16,18:00:00,80,32,48,FMN GV 11 Ramsel
66,Bergstraat 71,2018-08-16,19:00:00,80,42,38,FMN GV 11 Ramsel
66,Bergstraat 71,2018-08-16,20:00:00,74,54,20,FMN GV 11 Ramsel
66,Bergstraat 71,2018-08-16,21:00:00,32,24,8,FMN GV 11 Ramsel
66,Bergstraat 71,2018-08-16,22:00:00,8,6,2,FMN GV 11 Ramsel
66,Bergstraat 71,2018-08-16,23:00:00,0,0,0,FMN GV 11 Ramsel
66,Bergstraat 71,2018-08-17,00:00:00,2,2,0,FMN GV 11 Ramsel
66,Bergstraat 71,2018-08-17,01:00:00,4,0,4,FMN GV 11 Ramsel
66,Bergstraat 71,2018-08-17,02:00:00,0,0,0,FMN GV 11 Ramsel
66,Bergstraat 71,2018-08-17,03:00:00,0,0,0,FMN GV 11 Ramsel
66,Bergstraat 71,2018-08-17,04:00:00,2,2,0,FMN GV 11 Ramsel
66,Bergstraat 71,2018-08-17,05:00:00,0,0,0,FMN GV 11 Ramsel
66,Bergstraat 71,2018-08-17,06:00:00,8,2,6,FMN GV 11 Ramsel
66,Bergstraat 71,2018-08-17,07:00:00,22,6,16,FMN GV 11 Ramsel
66,Bergstraat 71,2018-08-17,08:00:00,34,10,24,FMN GV 11 Ramsel
66,Bergstraat 71,2018-08-17,09:00:00,52,18,34,FMN GV 11 Ramsel
66,Bergstraat 71,2018-08-17,10:00:00,58,22,36,FMN GV 11 Ramsel
66,Bergstraat 71,2018-08-17,11:00:00,72,36,36,FMN GV 11 Ramsel
66,Bergstraat 71,2018-08-17,12:00:00,76,38,38,FMN GV 11 Ramsel
66,Bergstraat 71,2018-08-17,13:00:00,118,60,58,FMN GV 11 Ramsel
66,Bergstraat 71,2018-08-17,14:00:00,118,42,76,FMN GV 11 Ramsel
66,Bergstraat 71,2018-08-17,15:00:00,122,82,40,FMN GV 11 Ramsel
66,Bergstraat 71,2018-08-17,16:00:00,150,80,70,FMN GV 11 Ramsel
66,Bergstraat 71,2018-08-17,17:00:00,88,50,38,FMN GV 11 Ramsel
66,Bergstraat 71,2018-08-17,18:00:00,76,44,32,FMN GV 11 Ramsel
66,Bergstraat 71,2018-08-17,19:00:00,44,20,24,FMN GV 11 Ramsel
66,Bergstraat 71,2018-08-17,20:00:00,54,22,32,FMN GV 11 Ramsel
66,Bergstraat 71,2018-08-17,21:00:00,12,10,2,FMN GV 11 Ramsel
66,Bergstraat 71,2018-08-17,22:00:00,4,2,2,FMN GV 11 Ramsel
66,Bergstraat 71,2018-08-17,23:00:00,8,6,2,FMN GV 11 Ramsel
66,Bergstraat 71,2018-08-18,00:00:00,12,2,10,FMN GV 11 Ramsel
66,Bergstraat 71,2018-08-18,01:00:00,4,2,2,FMN GV 11 Ramsel
66,Bergstraat 71,2018-08-18,02:00:00,0,0,0,FMN GV 11 Ramsel
66,Bergstraat 71,2018-08-18,03:00:00,0,0,0,FMN GV 11 Ramsel
66,Bergstraat 71,2018-08-18,04:00:00,0,0,0,FMN GV 11 Ramsel
66,Bergstraat 71,2018-08-18,05:00:00,0,0,0,FMN GV 11 Ramsel
66,Bergstraat 71,2018-08-18,06:00:00,2,2,0,FMN GV 11 Ramsel
66,Bergstraat 71,2018-08-18,07:00:00,4,0,4,FMN GV 11 Ramsel
66,Bergstraat 71,2018-08-18,08:00:00,24,2,22,FMN GV 11 Ramsel
66,Bergstraat 71,2018-08-18,09:00:00,66,30,36,FMN GV 11 Ramsel
66,Bergstraat 71,2018-08-18,10:00:00,132,60,72,FMN GV 11 Ramsel
66,Bergstraat 71,2018-08-18,11:00:00,98,46,52,FMN GV 11 Ramsel
66,Bergstraat 71,2018-08-18,12:00:00,86,40,46,FMN GV 11 Ramsel
66,Bergstraat 71,2018-08-18,13:00:00,196,102,94,FMN GV 11 Ramsel
66,Bergstraat 71,2018-08-18,14:00:00,180,94,86,FMN GV 11 Ramsel
66,Bergstraat 71,2018-08-18,15:00:00,134,60,74,FMN GV 11 Ramsel
66,Bergstraat 71,2018-08-18,16:00:00,130,80,50,FMN GV 11 Ramsel
66,Bergstraat 71,2018-08-18,17:00:00,62,24,38,FMN GV 11 Ramsel
66,Bergstraat 71,2018-08-18,18:00:00,58,30,28,FMN GV 11 Ramsel
66,Bergstraat 71,2018-08-18,19:00:00,48,14,34,FMN GV 11 Ramsel
66,Bergstraat 71,2018-08-18,20:00:00,26,14,12,FMN GV 11 Ramsel
66,Bergstraat 71,2018-08-18,21:00:00,18,8,10,FMN GV 11 Ramsel
66,Bergstraat 71,2018-08-18,22:00:00,26,16,10,FMN GV 11 Ramsel
66,Bergstraat 71,2018-08-18,23:00:00,6,4,2,FMN GV 11 Ramsel
66,Bergstraat 71,2018-08-19,00:00:00,14,12,2,FMN GV 11 Ramsel
66,Bergstraat 71,2018-08-19,01:00:00,2,2,0,FMN GV 11 Ramsel
66,Bergstraat 71,2018-08-19,02:00:00,6,2,4,FMN GV 11 Ramsel
66,Bergstraat 71,2018-08-19,03:00:00,2,2,0,FMN GV 11 Ramsel
66,Bergstraat 71,2018-08-19,04:00:00,0,0,0,FMN GV 11 Ramsel
66,Bergstraat 71,2018-08-19,05:00:00,0,0,0,FMN GV 11 Ramsel
66,Bergstraat 71,2018-08-19,06:00:00,6,4,2,FMN GV 11 Ramsel
66,Bergstraat 71,2018-08-19,07:00:00,58,22,36,FMN GV 11 Ramsel
66,Bergstraat 71,2018-08-19,08:00:00,106,24,82,FMN GV 11 Ramsel
66,Bergstraat 71,2018-08-19,09:00:00,140,44,96,FMN GV 11 Ramsel
66,Bergstraat 71,2018-08-19,10:00:00,276,122,154,FMN GV 11 Ramsel
66,Bergstraat 71,2018-08-19,11:00:00,238,126,112,FMN GV 11 Ramsel
66,Bergstraat 71,2018-08-19,12:00:00,154,96,58,FMN GV 11 Ramsel
66,Bergstraat 71,2018-08-19,13:00:00,174,80,94,FMN GV 11 Ramsel
66,Bergstraat 71,2018-08-19,14:00:00,288,126,162,FMN GV 11 Ramsel
66,Bergstraat 71,2018-08-19,15:00:00,228,104,124,FMN GV 11 Ramsel
66,Bergstraat 71,2018-08-19,16:00:00,236,120,116,FMN GV 11 Ramsel
66,Bergstraat 71,2018-08-19,17:00:00,198,106,92,FMN GV 11 Ramsel
66,Bergstraat 71,2018-08-19,18:00:00,102,38,64,FMN GV 11 Ramsel
66,Bergstraat 71,2018-08-19,19:00:00,88,42,46,FMN GV 11 Ramsel
66,Bergstraat 71,2018-08-19,20:00:00,38,26,12,FMN GV 11 Ramsel
66,Bergstraat 71,2018-08-19,21:00:00,28,14,14,FMN GV 11 Ramsel
66,Bergstraat 71,2018-08-19,22:00:00,10,8,2,FMN GV 11 Ramsel
66,Bergstraat 71,2018-08-19,23:00:00,6,6,0,FMN GV 11 Ramsel
66,Bergstraat 71,2018-08-20,00:00:00,0,0,0,FMN GV 11 Ramsel
66,Bergstraat 71,2018-08-20,01:00:00,2,2,0,FMN GV 11 Ramsel
66,Bergstraat 71,2018-08-20,02:00:00,0,0,0,FMN GV 11 Ramsel
66,Bergstraat 71,2018-08-20,03:00:00,0,0,0,FMN GV 11 Ramsel
66,Bergstraat 71,2018-08-20,04:00:00,2,2,0,FMN GV 11 Ramsel
66,Bergstraat 71,2018-08-20,05:00:00,8,2,6,FMN GV 11 Ramsel
66,Bergstraat 71,2018-08-20,06:00:00,40,14,26,FMN GV 11 Ramsel
66,Bergstraat 71,2018-08-20,07:00:00,44,10,34,FMN GV 11 Ramsel
66,Bergstraat 71,2018-08-20,08:00:00,32,10,22,FMN GV 11 Ramsel
66,Bergstraat 71,2018-08-20,09:00:00,60,22,38,FMN GV 11 Ramsel
66,Bergstraat 71,2018-08-20,10:00:00,76,36,40,FMN GV 11 Ramsel
66,Bergstraat 71,2018-08-20,11:00:00,42,20,22,FMN GV 11 Ramsel
66,Bergstraat 71,2018-08-20,12:00:00,54,36,18,FMN GV 11 Ramsel
66,Bergstraat 71,2018-08-20,13:00:00,106,50,56,FMN GV 11 Ramsel
66,Bergstraat 71,2018-08-20,14:00:00,132,74,58,FMN GV 11 Ramsel
66,Bergstraat 71,2018-08-20,15:00:00,108,70,38,FMN GV 11 Ramsel
66,Bergstraat 71,2018-08-20,16:00:00,108,60,48,FMN GV 11 Ramsel
66,Bergstraat 71,2018-08-20,17:00:00,98,56,42,FMN GV 11 Ramsel
66,Bergstraat 71,2018-08-20,18:00:00,78,40,38,FMN GV 11 Ramsel
66,Bergstraat 71,2018-08-20,19:00:00,50,32,18,FMN GV 11 Ramsel
66,Bergstraat 71,2018-08-20,20:00:00,32,22,10,FMN GV 11 Ramsel
66,Bergstraat 71,2018-08-20,21:00:00,14,10,4,FMN GV 11 Ramsel
66,Bergstraat 71,2018-08-20,22:00:00,18,12,6,FMN GV 11 Ramsel
66,Bergstraat 71,2018-08-20,23:00:00,6,4,2,FMN GV 11 Ramsel
66,Bergstraat 71,2018-08-21,00:00:00,8,8,0,FMN GV 11 Ramsel
66,Bergstraat 71,2018-08-21,01:00:00,0,0,0,FMN GV 11 Ramsel
66,Bergstraat 71,2018-08-21,02:00:00,2,2,0,FMN GV 11 Ramsel
66,Bergstraat 71,2018-08-21,03:00:00,0,0,0,FMN GV 11 Ramsel
66,Bergstraat 71,2018-08-21,04:00:00,2,2,0,FMN GV 11 Ramsel
66,Bergstraat 71,2018-08-21,05:00:00,6,6,0,FMN GV 11 Ramsel
66,Bergstraat 71,2018-08-21,06:00:00,42,14,28,FMN GV 11 Ramsel
66,Bergstraat 71,2018-08-21,07:00:00,50,22,28,FMN GV 11 Ramsel
66,Bergstraat 71,2018-08-21,08:00:00,40,18,22,FMN GV 11 Ramsel
66,Bergstraat 71,2018-08-21,09:00:00,80,46,34,FMN GV 11 Ramsel
66,Bergstraat 71,2018-08-21,10:00:00,102,40,62,FMN GV 11 Ramsel
66,Bergstraat 71,2018-08-21,11:00:00,108,42,66,FMN GV 11 Ramsel
66,Bergstraat 71,2018-08-21,12:00:00,134,68,66,FMN GV 11 Ramsel
66,Bergstraat 71,2018-08-21,13:00:00,208,94,114,FMN GV 11 Ramsel
66,Bergstraat 71,2018-08-21,14:00:00,182,88,94,FMN GV 11 Ramsel
66,Bergstraat 71,2018-08-21,15:00:00,128,68,60,FMN GV 11 Ramsel
66,Bergstraat 71,2018-08-21,16:00:00,170,94,76,FMN GV 11 Ramsel
66,Bergstraat 71,2018-08-21,17:00:00,130,76,54,FMN GV 11 Ramsel
66,Bergstraat 71,2018-08-21,18:00:00,102,46,56,FMN GV 11 Ramsel
66,Bergstraat 71,2018-08-21,19:00:00,110,70,40,FMN GV 11 Ramsel
66,Bergstraat 71,2018-08-21,20:00:00,60,36,24,FMN GV 11 Ramsel
66,Bergstraat 71,2018-08-21,21:00:00,40,32,8,FMN GV 11 Ramsel
66,Bergstraat 71,2018-08-21,22:00:00,16,12,4,FMN GV 11 Ramsel
66,Bergstraat 71,2018-08-21,23:00:00,0,0,0,FMN GV 11 Ramsel
66,Bergstraat 71,2018-08-22,00:00:00,0,0,0,FMN GV 11 Ramsel
66,Bergstraat 71,2018-08-22,01:00:00,2,2,0,FMN GV 11 Ramsel
66,Bergstraat 71,2018-08-22,02:00:00,0,0,0,FMN GV 11 Ramsel
66,Bergstraat 71,2018-08-22,03:00:00,0,0,0,FMN GV 11 Ramsel
66,Bergstraat 71,2018-08-22,04:00:00,2,2,0,FMN GV 11 Ramsel
66,Bergstraat 71,2018-08-22,05:00:00,2,2,0,FMN GV 11 Ramsel
66,Bergstraat 71,2018-08-22,06:00:00,34,14,20,FMN GV 11 Ramsel
66,Bergstraat 71,2018-08-22,07:00:00,62,20,42,FMN GV 11 Ramsel
66,Bergstraat 71,2018-08-22,08:00:00,52,28,24,FMN GV 11 Ramsel
66,Bergstraat 71,2018-08-22,09:00:00,82,34,48,FMN GV 11 Ramsel
66,Bergstraat 71,2018-08-22,10:00:00,152,62,90,FMN GV 11 Ramsel
66,Bergstraat 71,2018-08-22,11:00:00,128,54,74,FMN GV 11 Ramsel
66,Bergstraat 71,2018-08-22,12:00:00,98,50,48,FMN GV 11 Ramsel
66,Bergstraat 71,2018-08-22,13:00:00,160,76,84,FMN GV 11 Ramsel
66,Bergstraat 71,2018-08-22,14:00:00,200,102,98,FMN GV 11 Ramsel
66,Bergstraat 71,2018-08-22,15:00:00,200,116,84,FMN GV 11 Ramsel
66,Bergstraat 71,2018-08-22,16:00:00,154,94,60,FMN GV 11 Ramsel
66,Bergstraat 71,2018-08-22,17:00:00,146,80,66,FMN GV 11 Ramsel
66,Bergstraat 71,2018-08-22,18:00:00,124,66,58,FMN GV 11 Ramsel
66,Bergstraat 71,2018-08-22,19:00:00,102,46,56,FMN GV 11 Ramsel
66,Bergstraat 71,2018-08-22,20:00:00,80,38,42,FMN GV 11 Ramsel
66,Bergstraat 71,2018-08-22,21:00:00,26,18,8,FMN GV 11 Ramsel
66,Bergstraat 71,2018-08-22,22:00:00,18,8,10,FMN GV 11 Ramsel
66,Bergstraat 71,2018-08-22,23:00:00,6,4,2,FMN GV 11 Ramsel
66,Bergstraat 71,2018-08-23,00:00:00,2,0,2,FMN GV 11 Ramsel
66,Bergstraat 71,2018-08-23,01:00:00,4,4,0,FMN GV 11 Ramsel
66,Bergstraat 71,2018-08-23,02:00:00,0,0,0,FMN GV 11 Ramsel
66,Bergstraat 71,2018-08-23,03:00:00,0,0,0,FMN GV 11 Ramsel
66,Bergstraat 71,2018-08-23,04:00:00,4,0,4,FMN GV 11 Ramsel
66,Bergstraat 71,2018-08-23,05:00:00,6,6,0,FMN GV 11 Ramsel
66,Bergstraat 71,2018-08-23,06:00:00,34,14,20,FMN GV 11 Ramsel
66,Bergstraat 71,2018-08-23,07:00:00,70,32,38,FMN GV 11 Ramsel
66,Bergstraat 71,2018-08-23,08:00:00,44,10,34,FMN GV 11 Ramsel
66,Bergstraat 71,2018-08-23,09:00:00,50,20,30,FMN GV 11 Ramsel
66,Bergstraat 71,2018-08-23,10:00:00,82,34,48,FMN GV 11 Ramsel
66,Bergstraat 71,2018-08-23,11:00:00,86,40,46,FMN GV 11 Ramsel
66,Bergstraat 71,2018-08-23,12:00:00,78,28,50,FMN GV 11 Ramsel
66,Bergstraat 71,2018-08-23,13:00:00,120,70,50,FMN GV 11 Ramsel
66,Bergstraat 71,2018-08-23,14:00:00,128,60,68,FMN GV 11 Ramsel
66,Bergstraat 71,2018-08-23,15:00:00,92,56,36,FMN GV 11 Ramsel
66,Bergstraat 71,2018-08-23,16:00:00,154,74,80,FMN GV 11 Ramsel
66,Bergstraat 71,2018-08-23,17:00:00,122,68,54,FMN GV 11 Ramsel
66,Bergstraat 71,2018-08-23,18:00:00,108,52,56,FMN GV 11 Ramsel
66,Bergstraat 71,2018-08-23,19:00:00,60,24,36,FMN GV 11 Ramsel
66,Bergstraat 71,2018-08-23,20:00:00,16,10,6,FMN GV 11 Ramsel
66,Bergstraat 71,2018-08-23,21:00:00,26,12,14,FMN GV 11 Ramsel
66,Bergstraat 71,2018-08-23,22:00:00,8,6,2,FMN GV 11 Ramsel
66,Bergstraat 71,2018-08-23,23:00:00,4,4,0,FMN GV 11 Ramsel
66,Bergstraat 71,2018-08-24,00:00:00,2,0,2,FMN GV 11 Ramsel
66,Bergstraat 71,2018-08-24,01:00:00,2,2,0,FMN GV 11 Ramsel
66,Bergstraat 71,2018-08-24,02:00:00,0,0,0,FMN GV 11 Ramsel
66,Bergstraat 71,2018-08-24,03:00:00,0,0,0,FMN GV 11 Ramsel
66,Bergstraat 71,2018-08-24,04:00:00,2,2,0,FMN GV 11 Ramsel
66,Bergstraat 71,2018-08-24,05:00:00,8,4,4,FMN GV 11 Ramsel
66,Bergstraat 71,2018-08-24,06:00:00,28,8,20,FMN GV 11 Ramsel
66,Bergstraat 71,2018-08-24,07:00:00,26,14,12,FMN GV 11 Ramsel
66,Bergstraat 71,2018-08-24,08:00:00,30,10,20,FMN GV 11 Ramsel
66,Bergstraat 71,2018-08-24,09:00:00,64,20,44,FMN GV 11 Ramsel
66,Bergstraat 71,2018-08-24,10:00:00,62,30,32,FMN GV 11 Ramsel
66,Bergstraat 71,2018-08-24,11:00:00,120,72,48,FMN GV 11 Ramsel
66,Bergstraat 71,2018-08-24,12:00:00,64,22,42,FMN GV 11 Ramsel
66,Bergstraat 71,2018-08-24,13:00:00,116,46,70,FMN GV 11 Ramsel
66,Bergstraat 71,2018-08-24,14:00:00,84,50,34,FMN GV 11 Ramsel
66,Bergstraat 71,2018-08-24,15:00:00,72,34,38,FMN GV 11 Ramsel
66,Bergstraat 71,2018-08-24,16:00:00,112,70,42,FMN GV 11 Ramsel
66,Bergstraat 71,2018-08-24,17:00:00,84,50,34,FMN GV 11 Ramsel
66,Bergstraat 71,2018-08-24,18:00:00,58,24,34,FMN GV 11 Ramsel
66,Bergstraat 71,2018-08-24,19:00:00,62,26,36,FMN GV 11 Ramsel
66,Bergstraat 71,2018-08-24,20:00:00,36,10,26,FMN GV 11 Ramsel
66,Bergstraat 71,2018-08-24,21:00:00,20,2,18,FMN GV 11 Ramsel
66,Bergstraat 71,2018-08-24,22:00:00,14,4,10,FMN GV 11 Ramsel
66,Bergstraat 71,2018-08-24,23:00:00,26,20,6,FMN GV 11 Ramsel
66,Bergstraat 71,2018-08-25,00:00:00,12,8,4,FMN GV 11 Ramsel
66,Bergstraat 71,2018-08-25,01:00:00,24,22,2,FMN GV 11 Ramsel
66,Bergstraat 71,2018-08-25,02:00:00,6,4,2,FMN GV 11 Ramsel
66,Bergstraat 71,2018-08-25,03:00:00,4,4,0,FMN GV 11 Ramsel
66,Bergstraat 71,2018-08-25,04:00:00,2,2,0,FMN GV 11 Ramsel
66,Bergstraat 71,2018-08-25,05:00:00,0,0,0,FMN GV 11 Ramsel
66,Bergstraat 71,2018-08-25,06:00:00,4,2,2,FMN GV 11 Ramsel
66,Bergstraat 71,2018-08-25,07:00:00,16,8,8,FMN GV 11 Ramsel
66,Bergstraat 71,2018-08-25,08:00:00,30,6,24,FMN GV 11 Ramsel
66,Bergstraat 71,2018-08-25,09:00:00,22,12,10,FMN GV 11 Ramsel
66,Bergstraat 71,2018-08-25,10:00:00,44,14,30,FMN GV 11 Ramsel
66,Bergstraat 71,2018-08-25,11:00:00,44,30,14,FMN GV 11 Ramsel
66,Bergstraat 71,2018-08-25,12:00:00,42,20,22,FMN GV 11 Ramsel
66,Bergstraat 71,2018-08-25,13:00:00,90,28,62,FMN GV 11 Ramsel
66,Bergstraat 71,2018-08-25,14:00:00,78,56,22,FMN GV 11 Ramsel
66,Bergstraat 71,2018-08-25,15:00:00,88,30,58,FMN GV 11 Ramsel
66,Bergstraat 71,2018-08-25,16:00:00,62,36,26,FMN GV 11 Ramsel
66,Bergstraat 71,2018-08-25,17:00:00,24,20,4,FMN GV 11 Ramsel
66,Bergstraat 71,2018-08-25,18:00:00,42,20,22,FMN GV 11 Ramsel
66,Bergstraat 71,2018-08-25,19:00:00,24,16,8,FMN GV 11 Ramsel
66,Bergstraat 71,2018-08-25,20:00:00,6,4,2,FMN GV 11 Ramsel
66,Bergstraat 71,2018-08-25,21:00:00,8,4,4,FMN GV 11 Ramsel
66,Bergstraat 71,2018-08-25,22:00:00,14,6,8,FMN GV 11 Ramsel
66,Bergstraat 71,2018-08-25,23:00:00,0,0,0,FMN GV 11 Ramsel
66,Bergstraat 71,2018-08-26,00:00:00,0,0,0,FMN GV 11 Ramsel
66,Bergstraat 71,2018-08-26,01:00:00,0,0,0,FMN GV 11 Ramsel
66,Bergstraat 71,2018-08-26,02:00:00,2,0,2,FMN GV 11 Ramsel
66,Bergstraat 71,2018-08-26,03:00:00,0,0,0,FMN GV 11 Ramsel
66,Bergstraat 71,2018-08-26,04:00:00,0,0,0,FMN GV 11 Ramsel
66,Bergstraat 71,2018-08-26,05:00:00,0,0,0,FMN GV 11 Ramsel
66,Bergstraat 71,2018-08-26,06:00:00,2,2,0,FMN GV 11 Ramsel
66,Bergstraat 71,2018-08-26,07:00:00,26,12,14,FMN GV 11 Ramsel
66,Bergstraat 71,2018-08-26,08:00:00,60,16,44,FMN GV 11 Ramsel
66,Bergstraat 71,2018-08-26,09:00:00,80,30,50,FMN GV 11 Ramsel
66,Bergstraat 71,2018-08-26,10:00:00,156,86,70,FMN GV 11 Ramsel
66,Bergstraat 71,2018-08-26,11:00:00,146,88,58,FMN GV 11 Ramsel
66,Bergstraat 71,2018-08-26,12:00:00,108,60,48,FMN GV 11 Ramsel
66,Bergstraat 71,2018-08-26,13:00:00,158,74,84,FMN GV 11 Ramsel
66,Bergstraat 71,2018-08-26,14:00:00,222,100,122,FMN GV 11 Ramsel
66,Bergstraat 71,2018-08-26,15:00:00,162,92,70,FMN GV 11 Ramsel
66,Bergstraat 71,2018-08-26,16:00:00,110,70,40,FMN GV 11 Ramsel
66,Bergstraat 71,2018-08-26,17:00:00,64,34,30,FMN GV 11 Ramsel
66,Bergstraat 71,2018-08-26,18:00:00,18,14,4,FMN GV 11 Ramsel
66,Bergstraat 71,2018-08-26,19:00:00,14,4,10,FMN GV 11 Ramsel
66,Bergstraat 71,2018-08-26,20:00:00,8,0,8,FMN GV 11 Ramsel
66,Bergstraat 71,2018-08-26,21:00:00,0,0,0,FMN GV 11 Ramsel
66,Bergstraat 71,2018-08-26,22:00:00,2,0,2,FMN GV 11 Ramsel
66,Bergstraat 71,2018-08-26,23:00:00,0,0,0,FMN GV 11 Ramsel
66,Bergstraat 71,2018-08-27,00:00:00,2,2,0,FMN GV 11 Ramsel
66,Bergstraat 71,2018-08-27,01:00:00,0,0,0,FMN GV 11 Ramsel
66,Bergstraat 71,2018-08-27,02:00:00,0,0,0,FMN GV 11 Ramsel
66,Bergstraat 71,2018-08-27,03:00:00,0,0,0,FMN GV 11 Ramsel
66,Bergstraat 71,2018-08-27,04:00:00,2,2,0,FMN GV 11 Ramsel
66,Bergstraat 71,2018-08-27,05:00:00,2,0,2,FMN GV 11 Ramsel
66,Bergstraat 71,2018-08-27,06:00:00,20,6,14,FMN GV 11 Ramsel
66,Bergstraat 71,2018-08-27,07:00:00,38,14,24,FMN GV 11 Ramsel
66,Bergstraat 71,2018-08-27,08:00:00,18,6,12,FMN GV 11 Ramsel
66,Bergstraat 71,2018-08-27,09:00:00,34,10,24,FMN GV 11 Ramsel
66,Bergstraat 71,2018-08-27,10:00:00,24,10,14,FMN GV 11 Ramsel
66,Bergstraat 71,2018-08-27,11:00:00,26,16,10,FMN GV 11 Ramsel
66,Bergstraat 71,2018-08-27,12:00:00,50,30,20,FMN GV 11 Ramsel
66,Bergstraat 71,2018-08-27,13:00:00,54,30,24,FMN GV 11 Ramsel
66,Bergstraat 71,2018-08-27,14:00:00,86,36,50,FMN GV 11 Ramsel
66,Bergstraat 71,2018-08-27,15:00:00,76,38,38,FMN GV 11 Ramsel
66,Bergstraat 71,2018-08-27,16:00:00,84,44,40,FMN GV 11 Ramsel
66,Bergstraat 71,2018-08-27,17:00:00,78,54,24,FMN GV 11 Ramsel
66,Bergstraat 71,2018-08-27,18:00:00,40,24,16,FMN GV 11 Ramsel
66,Bergstraat 71,2018-08-27,19:00:00,26,8,18,FMN GV 11 Ramsel
66,Bergstraat 71,2018-08-27,20:00:00,18,14,4,FMN GV 11 Ramsel
66,Bergstraat 71,2018-08-27,21:00:00,18,10,8,FMN GV 11 Ramsel
66,Bergstraat 71,2018-08-27,22:00:00,14,10,4,FMN GV 11 Ramsel
66,Bergstraat 71,2018-08-27,23:00:00,6,4,2,FMN GV 11 Ramsel
66,Bergstraat 71,2018-08-28,00:00:00,2,2,0,FMN GV 11 Ramsel
66,Bergstraat 71,2018-08-28,01:00:00,4,4,0,FMN GV 11 Ramsel
66,Bergstraat 71,2018-08-28,02:00:00,0,0,0,FMN GV 11 Ramsel
66,Bergstraat 71,2018-08-28,03:00:00,0,0,0,FMN GV 11 Ramsel
66,Bergstraat 71,2018-08-28,04:00:00,6,0,6,FMN GV 11 Ramsel
66,Bergstraat 71,2018-08-28,05:00:00,0,0,0,FMN GV 11 Ramsel
66,Bergstraat 71,2018-08-28,06:00:00,36,4,32,FMN GV 11 Ramsel
66,Bergstraat 71,2018-08-28,07:00:00,58,20,38,FMN GV 11 Ramsel
66,Bergstraat 71,2018-08-28,08:00:00,48,14,34,FMN GV 11 Ramsel
66,Bergstraat 71,2018-08-28,09:00:00,74,26,48,FMN GV 11 Ramsel
66,Bergstraat 71,2018-08-28,10:00:00,100,38,62,FMN GV 11 Ramsel
66,Bergstraat 71,2018-08-28,11:00:00,80,36,44,FMN GV 11 Ramsel
66,Bergstraat 71,2018-08-28,12:00:00,116,50,66,FMN GV 11 Ramsel
66,Bergstraat 71,2018-08-28,13:00:00,244,94,150,FMN GV 11 Ramsel
66,Bergstraat 71,2018-08-28,14:00:00,290,134,156,FMN GV 11 Ramsel
66,Bergstraat 71,2018-08-28,15:00:00,208,96,112,FMN GV 11 Ramsel
66,Bergstraat 71,2018-08-28,16:00:00,150,98,52,FMN GV 11 Ramsel
66,Bergstraat 71,2018-08-28,17:00:00,192,112,80,FMN GV 11 Ramsel
66,Bergstraat 71,2018-08-28,18:00:00,120,58,62,FMN GV 11 Ramsel
66,Bergstraat 71,2018-08-28,19:00:00,104,62,42,FMN GV 11 Ramsel
66,Bergstraat 71,2018-08-28,20:00:00,88,64,24,FMN GV 11 Ramsel
66,Bergstraat 71,2018-08-28,21:00:00,12,6,6,FMN GV 11 Ramsel
66,Bergstraat 71,2018-08-28,22:00:00,24,8,16,FMN GV 11 Ramsel
66,Bergstraat 71,2018-08-28,23:00:00,6,6,0,FMN GV 11 Ramsel
66,Bergstraat 71,2018-08-29,00:00:00,2,2,0,FMN GV 11 Ramsel
66,Bergstraat 71,2018-08-29,01:00:00,0,0,0,FMN GV 11 Ramsel
66,Bergstraat 71,2018-08-29,02:00:00,4,4,0,FMN GV 11 Ramsel
66,Bergstraat 71,2018-08-29,03:00:00,2,2,0,FMN GV 11 Ramsel
66,Bergstraat 71,2018-08-29,04:00:00,2,2,0,FMN GV 11 Ramsel
66,Bergstraat 71,2018-08-29,05:00:00,2,0,2,FMN GV 11 Ramsel
66,Bergstraat 71,2018-08-29,06:00:00,22,6,16,FMN GV 11 Ramsel
66,Bergstraat 71,2018-08-29,07:00:00,46,22,24,FMN GV 11 Ramsel
66,Bergstraat 71,2018-08-29,08:00:00,46,14,32,FMN GV 11 Ramsel
66,Bergstraat 71,2018-08-29,09:00:00,38,16,22,FMN GV 11 Ramsel
66,Bergstraat 71,2018-08-29,10:00:00,46,26,20,FMN GV 11 Ramsel
66,Bergstraat 71,2018-08-29,11:00:00,40,20,20,FMN GV 11 Ramsel
66,Bergstraat 71,2018-08-29,12:00:00,26,10,16,FMN GV 11 Ramsel
66,Bergstraat 71,2018-08-29,13:00:00,26,16,10,FMN GV 11 Ramsel
66,Bergstraat 71,2018-08-29,14:00:00,40,22,18,FMN GV 11 Ramsel
66,Bergstraat 71,2018-08-29,15:00:00,68,44,24,FMN GV 11 Ramsel
66,Bergstraat 71,2018-08-29,16:00:00,32,10,22,FMN GV 11 Ramsel
66,Bergstraat 71,2018-08-29,17:00:00,52,36,16,FMN GV 11 Ramsel
66,Bergstraat 71,2018-08-29,18:00:00,36,22,14,FMN GV 11 Ramsel
66,Bergstraat 71,2018-08-29,19:00:00,20,8,12,FMN GV 11 Ramsel
66,Bergstraat 71,2018-08-29,20:00:00,12,4,8,FMN GV 11 Ramsel
66,Bergstraat 71,2018-08-29,21:00:00,14,14,0,FMN GV 11 Ramsel
66,Bergstraat 71,2018-08-29,22:00:00,4,0,4,FMN GV 11 Ramsel
66,Bergstraat 71,2018-08-29,23:00:00,0,0,0,FMN GV 11 Ramsel
66,Bergstraat 71,2018-08-30,00:00:00,2,2,0,FMN GV 11 Ramsel
66,Bergstraat 71,2018-08-30,01:00:00,0,0,0,FMN GV 11 Ramsel
66,Bergstraat 71,2018-08-30,02:00:00,0,0,0,FMN GV 11 Ramsel
66,Bergstraat 71,2018-08-30,03:00:00,0,0,0,FMN GV 11 Ramsel
66,Bergstraat 71,2018-08-30,04:00:00,0,0,0,FMN GV 11 Ramsel
66,Bergstraat 71,2018-08-30,05:00:00,0,0,0,FMN GV 11 Ramsel
66,Bergstraat 71,2018-08-30,06:00:00,28,8,20,FMN GV 11 Ramsel
66,Bergstraat 71,2018-08-30,07:00:00,38,16,22,FMN GV 11 Ramsel
66,Bergstraat 71,2018-08-30,08:00:00,42,10,32,FMN GV 11 Ramsel
66,Bergstraat 71,2018-08-30,09:00:00,100,26,74,FMN GV 11 Ramsel
66,Bergstraat 71,2018-08-30,10:00:00,70,28,42,FMN GV 11 Ramsel
66,Bergstraat 71,2018-08-30,11:00:00,104,70,34,FMN GV 11 Ramsel
66,Bergstraat 71,2018-08-30,12:00:00,96,58,38,FMN GV 11 Ramsel
66,Bergstraat 71,2018-08-30,13:00:00,134,78,56,FMN GV 11 Ramsel
66,Bergstraat 71,2018-08-30,14:00:00,152,84,68,FMN GV 11 Ramsel
66,Bergstraat 71,2018-08-30,15:00:00,114,66,48,FMN GV 11 Ramsel
66,Bergstraat 71,2018-08-30,16:00:00,122,64,58,FMN GV 11 Ramsel
66,Bergstraat 71,2018-08-30,17:00:00,78,52,26,FMN GV 11 Ramsel
66,Bergstraat 71,2018-08-30,18:00:00,60,38,22,FMN GV 11 Ramsel
66,Bergstraat 71,2018-08-30,19:00:00,44,16,28,FMN GV 11 Ramsel
66,Bergstraat 71,2018-08-30,20:00:00,28,14,14,FMN GV 11 Ramsel
66,Bergstraat 71,2018-08-30,21:00:00,20,16,4,FMN GV 11 Ramsel
66,Bergstraat 71,2018-08-30,22:00:00,22,14,8,FMN GV 11 Ramsel
66,Bergstraat 71,2018-08-30,23:00:00,6,2,4,FMN GV 11 Ramsel
66,Bergstraat 71,2018-08-31,00:00:00,0,0,0,FMN GV 11 Ramsel
66,Bergstraat 71,2018-08-31,01:00:00,2,2,0,FMN GV 11 Ramsel
66,Bergstraat 71,2018-08-31,02:00:00,2,2,0,FMN GV 11 Ramsel
66,Bergstraat 71,2018-08-31,03:00:00,0,0,0,FMN GV 11 Ramsel
66,Bergstraat 71,2018-08-31,04:00:00,4,2,2,FMN GV 11 Ramsel
66,Bergstraat 71,2018-08-31,05:00:00,0,0,0,FMN GV 11 Ramsel
66,Bergstraat 71,2018-08-31,06:00:00,22,10,12,FMN GV 11 Ramsel
66,Bergstraat 71,2018-08-31,07:00:00,46,14,32,FMN GV 11 Ramsel
66,Bergstraat 71,2018-08-31,08:00:00,48,8,40,FMN GV 11 Ramsel
66,Bergstraat 71,2018-08-31,09:00:00,22,12,10,FMN GV 11 Ramsel
66,Bergstraat 71,2018-08-31,10:00:00,38,10,28,FMN GV 11 Ramsel
66,Bergstraat 71,2018-08-31,11:00:00,30,14,16,FMN GV 11 Ramsel
66,Bergstraat 71,2018-08-31,12:00:00,76,36,40,FMN GV 11 Ramsel
66,Bergstraat 71,2018-08-31,13:00:00,100,44,56,FMN GV 11 Ramsel
66,Bergstraat 71,2018-08-31,14:00:00,126,62,64,FMN GV 11 Ramsel
66,Bergstraat 71,2018-08-31,15:00:00,146,82,64,FMN GV 11 Ramsel
66,Bergstraat 71,2018-08-31,16:00:00,140,82,58,FMN GV 11 Ramsel
66,Bergstraat 71,2018-08-31,17:00:00,124,74,50,FMN GV 11 Ramsel
66,Bergstraat 71,2018-08-31,18:00:00,90,44,46,FMN GV 11 Ramsel
66,Bergstraat 71,2018-08-31,19:00:00,48,26,22,FMN GV 11 Ramsel
66,Bergstraat 71,2018-08-31,20:00:00,28,20,8,FMN GV 11 Ramsel
66,Bergstraat 71,2018-08-31,21:00:00,12,8,4,FMN GV 11 Ramsel
66,Bergstraat 71,2018-08-31,22:00:00,6,6,0,FMN GV 11 Ramsel
66,Bergstraat 71,2018-08-31,23:00:00,16,14,2,FMN GV 11 Ramsel
66,Bergstraat 71,2018-09-01,00:00:00,2,2,0,FMN GV 11 Ramsel
66,Bergstraat 71,2018-09-01,01:00:00,4,2,2,FMN GV 11 Ramsel
66,Bergstraat 71,2018-09-01,02:00:00,4,0,4,FMN GV 11 Ramsel
66,Bergstraat 71,2018-09-01,03:00:00,0,0,0,FMN GV 11 Ramsel
66,Bergstraat 71,2018-09-01,04:00:00,0,0,0,FMN GV 11 Ramsel
66,Bergstraat 71,2018-09-01,05:00:00,0,0,0,FMN GV 11 Ramsel
66,Bergstraat 71,2018-09-01,06:00:00,4,2,2,FMN GV 11 Ramsel
66,Bergstraat 71,2018-09-01,07:00:00,8,2,6,FMN GV 11 Ramsel
66,Bergstraat 71,2018-09-01,08:00:00,40,8,32,FMN GV 11 Ramsel
66,Bergstraat 71,2018-09-01,09:00:00,66,30,36,FMN GV 11 Ramsel
66,Bergstraat 71,2018-09-01,10:00:00,84,34,50,FMN GV 11 Ramsel
66,Bergstraat 71,2018-09-01,11:00:00,124,70,54,FMN GV 11 Ramsel
66,Bergstraat 71,2018-09-01,12:00:00,78,32,46,FMN GV 11 Ramsel
66,Bergstraat 71,2018-09-01,13:00:00,148,82,66,FMN GV 11 Ramsel
66,Bergstraat 71,2018-09-01,14:00:00,186,86,100,FMN GV 11 Ramsel
66,Bergstraat 71,2018-09-01,15:00:00,176,86,90,FMN GV 11 Ramsel
66,Bergstraat 71,2018-09-01,16:00:00,112,72,40,FMN GV 11 Ramsel
66,Bergstraat 71,2018-09-01,17:00:00,82,40,42,FMN GV 11 Ramsel
66,Bergstraat 71,2018-09-01,18:00:00,90,42,48,FMN GV 11 Ramsel
66,Bergstraat 71,2018-09-01,19:00:00,42,24,18,FMN GV 11 Ramsel
66,Bergstraat 71,2018-09-01,20:00:00,30,12,18,FMN GV 11 Ramsel
66,Bergstraat 71,2018-09-01,21:00:00,4,2,2,FMN GV 11 Ramsel
66,Bergstraat 71,2018-09-01,22:00:00,6,6,0,FMN GV 11 Ramsel
66,Bergstraat 71,2018-09-01,23:00:00,0,0,0,FMN GV 11 Ramsel
66,Bergstraat 71,2018-09-02,00:00:00,10,2,8,FMN GV 11 Ramsel
66,Bergstraat 71,2018-09-02,01:00:00,2,0,2,FMN GV 11 Ramsel
66,Bergstraat 71,2018-09-02,02:00:00,0,0,0,FMN GV 11 Ramsel
66,Bergstraat 71,2018-09-02,03:00:00,0,0,0,FMN GV 11 Ramsel
66,Bergstraat 71,2018-09-02,04:00:00,0,0,0,FMN GV 11 Ramsel
66,Bergstraat 71,2018-09-02,05:00:00,0,0,0,FMN GV 11 Ramsel
66,Bergstraat 71,2018-09-02,06:00:00,8,4,4,FMN GV 11 Ramsel
66,Bergstraat 71,2018-09-02,07:00:00,28,18,10,FMN GV 11 Ramsel
66,Bergstraat 71,2018-09-02,08:00:00,62,28,34,FMN GV 11 Ramsel
66,Bergstraat 71,2018-09-02,09:00:00,210,60,150,FMN GV 11 Ramsel
66,Bergstraat 71,2018-09-02,10:00:00,270,98,172,FMN GV 11 Ramsel
66,Bergstraat 71,2018-09-02,11:00:00,236,84,152,FMN GV 11 Ramsel
66,Bergstraat 71,2018-09-02,12:00:00,240,112,128,FMN GV 11 Ramsel
66,Bergstraat 71,2018-09-02,13:00:00,348,106,242,FMN GV 11 Ramsel
66,Bergstraat 71,2018-09-02,14:00:00,366,136,230,FMN GV 11 Ramsel
66,Bergstraat 71,2018-09-02,15:00:00,256,110,146,FMN GV 11 Ramsel
66,Bergstraat 71,2018-09-02,16:00:00,184,98,86,FMN GV 11 Ramsel
66,Bergstraat 71,2018-09-02,17:00:00,136,76,60,FMN GV 11 Ramsel
66,Bergstraat 71,2018-09-02,18:00:00,100,36,64,FMN GV 11 Ramsel
66,Bergstraat 71,2018-09-02,19:00:00,54,26,28,FMN GV 11 Ramsel
66,Bergstraat 71,2018-09-02,20:00:00,44,28,16,FMN GV 11 Ramsel
66,Bergstraat 71,2018-09-02,21:00:00,6,2,4,FMN GV 11 Ramsel
66,Bergstraat 71,2018-09-02,22:00:00,2,0,2,FMN GV 11 Ramsel
66,Bergstraat 71,2018-09-02,23:00:00,14,10,4,FMN GV 11 Ramsel
66,Bergstraat 71,2018-09-03,00:00:00,0,0,0,FMN GV 11 Ramsel
66,Bergstraat 71,2018-09-03,01:00:00,0,0,0,FMN GV 11 Ramsel
66,Bergstraat 71,2018-09-03,02:00:00,0,0,0,FMN GV 11 Ramsel
66,Bergstraat 71,2018-09-03,03:00:00,0,0,0,FMN GV 11 Ramsel
66,Bergstraat 71,2018-09-03,04:00:00,2,2,0,FMN GV 11 Ramsel
66,Bergstraat 71,2018-09-03,05:00:00,8,4,4,FMN GV 11 Ramsel
66,Bergstraat 71,2018-09-03,06:00:00,26,6,20,FMN GV 11 Ramsel
66,Bergstraat 71,2018-09-03,07:00:00,160,20,140,FMN GV 11 Ramsel
66,Bergstraat 71,2018-09-03,08:00:00,216,38,178,FMN GV 11 Ramsel
66,Bergstraat 71,2018-09-03,09:00:00,136,44,92,FMN GV 11 Ramsel
66,Bergstraat 71,2018-09-03,10:00:00,94,36,58,FMN GV 11 Ramsel
66,Bergstraat 71,2018-09-03,11:00:00,56,20,36,FMN GV 11 Ramsel
66,Bergstraat 71,2018-09-03,12:00:00,304,238,66,FMN GV 11 Ramsel
66,Bergstraat 71,2018-09-03,13:00:00,158,72,86,FMN GV 11 Ramsel
66,Bergstraat 71,2018-09-03,14:00:00,140,62,78,FMN GV 11 Ramsel
66,Bergstraat 71,2018-09-03,15:00:00,122,80,42,FMN GV 11 Ramsel
66,Bergstraat 71,2018-09-03,16:00:00,90,66,24,FMN GV 11 Ramsel
66,Bergstraat 71,2018-09-03,17:00:00,114,60,54,FMN GV 11 Ramsel
66,Bergstraat 71,2018-09-03,18:00:00,74,56,18,FMN GV 11 Ramsel
66,Bergstraat 71,2018-09-03,19:00:00,30,10,20,FMN GV 11 Ramsel
66,Bergstraat 71,2018-09-03,20:00:00,18,10,8,FMN GV 11 Ramsel
66,Bergstraat 71,2018-09-03,21:00:00,10,4,6,FMN GV 11 Ramsel
66,Bergstraat 71,2018-09-03,22:00:00,8,8,0,FMN GV 11 Ramsel
66,Bergstraat 71,2018-09-03,23:00:00,2,0,2,FMN GV 11 Ramsel
66,Bergstraat 71,2018-09-04,00:00:00,2,2,0,FMN GV 11 Ramsel
66,Bergstraat 71,2018-09-04,01:00:00,0,0,0,FMN GV 11 Ramsel
66,Bergstraat 71,2018-09-04,02:00:00,0,0,0,FMN GV 11 Ramsel
66,Bergstraat 71,2018-09-04,03:00:00,2,2,0,FMN GV 11 Ramsel
66,Bergstraat 71,2018-09-04,04:00:00,4,4,0,FMN GV 11 Ramsel
66,Bergstraat 71,2018-09-04,05:00:00,18,8,10,FMN GV 11 Ramsel
66,Bergstraat 71,2018-09-04,06:00:00,36,10,26,FMN GV 11 Ramsel
66,Bergstraat 71,2018-09-04,07:00:00,276,44,232,FMN GV 11 Ramsel
66,Bergstraat 71,2018-09-04,08:00:00,126,34,92,FMN GV 11 Ramsel
66,Bergstraat 71,2018-09-04,09:00:00,48,12,36,FMN GV 11 Ramsel
66,Bergstraat 71,2018-09-04,10:00:00,48,30,18,FMN GV 11 Ramsel
66,Bergstraat 71,2018-09-04,11:00:00,70,48,22,FMN GV 11 Ramsel
66,Bergstraat 71,2018-09-04,12:00:00,76,50,26,FMN GV 11 Ramsel
66,Bergstraat 71,2018-09-04,13:00:00,130,54,76,FMN GV 11 Ramsel
66,Bergstraat 71,2018-09-04,14:00:00,164,72,92,FMN GV 11 Ramsel
66,Bergstraat 71,2018-09-04,15:00:00,248,178,70,FMN GV 11 Ramsel
66,Bergstraat 71,2018-09-04,16:00:00,204,174,30,FMN GV 11 Ramsel
66,Bergstraat 71,2018-09-04,17:00:00,118,74,44,FMN GV 11 Ramsel
66,Bergstraat 71,2018-09-04,18:00:00,98,36,62,FMN GV 11 Ramsel
66,Bergstraat 71,2018-09-04,19:00:00,100,48,52,FMN GV 11 Ramsel
66,Bergstraat 71,2018-09-04,20:00:00,44,28,16,FMN GV 11 Ramsel
66,Bergstraat 71,2018-09-04,21:00:00,46,36,10,FMN GV 11 Ramsel
66,Bergstraat 71,2018-09-04,22:00:00,4,4,0,FMN GV 11 Ramsel
66,Bergstraat 71,2018-09-04,23:00:00,0,0,0,FMN GV 11 Ramsel
66,Bergstraat 71,2018-09-05,00:00:00,0,0,0,FMN GV 11 Ramsel
66,Bergstraat 71,2018-09-05,01:00:00,0,0,0,FMN GV 11 Ramsel
66,Bergstraat 71,2018-09-05,02:00:00,0,0,0,FMN GV 11 Ramsel
66,Bergstraat 71,2018-09-05,03:00:00,0,0,0,FMN GV 11 Ramsel
66,Bergstraat 71,2018-09-05,04:00:00,4,2,2,FMN GV 11 Ramsel
66,Bergstraat 71,2018-09-05,05:00:00,6,2,4,FMN GV 11 Ramsel
66,Bergstraat 71,2018-09-05,06:00:00,44,10,34,FMN GV 11 Ramsel
66,Bergstraat 71,2018-09-05,07:00:00,240,30,210,FMN GV 11 Ramsel
66,Bergstraat 71,2018-09-05,08:00:00,134,18,116,FMN GV 11 Ramsel
66,Bergstraat 71,2018-09-05,09:00:00,66,26,40,FMN GV 11 Ramsel
66,Bergstraat 71,2018-09-05,10:00:00,56,34,22,FMN GV 11 Ramsel
66,Bergstraat 71,2018-09-05,11:00:00,78,40,38,FMN GV 11 Ramsel
66,Bergstraat 71,2018-09-05,12:00:00,288,222,66,FMN GV 11 Ramsel
66,Bergstraat 71,2018-09-05,13:00:00,120,70,50,FMN GV 11 Ramsel
66,Bergstraat 71,2018-09-05,14:00:00,174,76,98,FMN GV 11 Ramsel
66,Bergstraat 71,2018-09-05,15:00:00,122,76,46,FMN GV 11 Ramsel
66,Bergstraat 71,2018-09-05,16:00:00,140,84,56,FMN GV 11 Ramsel
66,Bergstraat 71,2018-09-05,17:00:00,162,116,46,FMN GV 11 Ramsel
66,Bergstraat 71,2018-09-05,18:00:00,104,54,50,FMN GV 11 Ramsel
66,Bergstraat 71,2018-09-05,19:00:00,76,48,28,FMN GV 11 Ramsel
66,Bergstraat 71,2018-09-05,20:00:00,38,18,20,FMN GV 11 Ramsel
66,Bergstraat 71,2018-09-05,21:00:00,8,6,2,FMN GV 11 Ramsel
66,Bergstraat 71,2018-09-05,22:00:00,6,4,2,FMN GV 11 Ramsel
66,Bergstraat 71,2018-09-05,23:00:00,8,6,2,FMN GV 11 Ramsel
66,Bergstraat 71,2018-09-06,00:00:00,0,0,0,FMN GV 11 Ramsel
66,Bergstraat 71,2018-09-06,01:00:00,2,2,0,FMN GV 11 Ramsel
66,Bergstraat 71,2018-09-06,02:00:00,0,0,0,FMN GV 11 Ramsel
66,Bergstraat 71,2018-09-06,03:00:00,0,0,0,FMN GV 11 Ramsel
66,Bergstraat 71,2018-09-06,04:00:00,6,4,2,FMN GV 11 Ramsel
66,Bergstraat 71,2018-09-06,05:00:00,6,4,2,FMN GV 11 Ramsel
66,Bergstraat 71,2018-09-06,06:00:00,42,8,34,FMN GV 11 Ramsel
66,Bergstraat 71,2018-09-06,07:00:00,228,34,194,FMN GV 11 Ramsel
66,Bergstraat 71,2018-09-06,08:00:00,152,20,132,FMN GV 11 Ramsel
66,Bergstraat 71,2018-09-06,09:00:00,44,16,28,FMN GV 11 Ramsel
66,Bergstraat 71,2018-09-06,10:00:00,52,30,22,FMN GV 11 Ramsel
66,Bergstraat 71,2018-09-06,11:00:00,180,154,26,FMN GV 11 Ramsel
66,Bergstraat 71,2018-09-06,12:00:00,128,92,36,FMN GV 11 Ramsel
66,Bergstraat 71,2018-09-06,13:00:00,62,28,34,FMN GV 11 Ramsel
66,Bergstraat 71,2018-09-06,14:00:00,104,54,50,FMN GV 11 Ramsel
66,Bergstraat 71,2018-09-06,15:00:00,224,172,52,FMN GV 11 Ramsel
66,Bergstraat 71,2018-09-06,16:00:00,176,128,48,FMN GV 11 Ramsel
66,Bergstraat 71,2018-09-06,17:00:00,100,62,38,FMN GV 11 Ramsel
66,Bergstraat 71,2018-09-06,18:00:00,106,50,56,FMN GV 11 Ramsel
66,Bergstraat 71,2018-09-06,19:00:00,82,56,26,FMN GV 11 Ramsel
66,Bergstraat 71,2018-09-06,20:00:00,46,38,8,FMN GV 11 Ramsel
66,Bergstraat 71,2018-09-06,21:00:00,30,26,4,FMN GV 11 Ramsel
66,Bergstraat 71,2018-09-06,22:00:00,12,12,0,FMN GV 11 Ramsel
66,Bergstraat 71,2018-09-06,23:00:00,2,0,2,FMN GV 11 Ramsel
66,Bergstraat 71,2018-09-07,00:00:00,2,2,0,FMN GV 11 Ramsel
66,Bergstraat 71,2018-09-07,01:00:00,0,0,0,FMN GV 11 Ramsel
66,Bergstraat 71,2018-09-07,02:00:00,0,0,0,FMN GV 11 Ramsel
66,Bergstraat 71,2018-09-07,03:00:00,0,0,0,FMN GV 11 Ramsel
66,Bergstraat 71,2018-09-07,04:00:00,6,4,2,FMN GV 11 Ramsel
66,Bergstraat 71,2018-09-07,05:00:00,4,2,2,FMN GV 11 Ramsel
66,Bergstraat 71,2018-09-07,06:00:00,24,12,12,FMN GV 11 Ramsel
66,Bergstraat 71,2018-09-07,07:00:00,102,16,86,FMN GV 11 Ramsel
66,Bergstraat 71,2018-09-07,08:00:00,92,8,84,FMN GV 11 Ramsel
66,Bergstraat 71,2018-09-07,09:00:00,68,16,52,FMN GV 11 Ramsel
66,Bergstraat 71,2018-09-07,10:00:00,82,26,56,FMN GV 11 Ramsel
66,Bergstraat 71,2018-09-07,11:00:00,38,14,24,FMN GV 11 Ramsel
66,Bergstraat 71,2018-09-07,12:00:00,74,36,38,FMN GV 11 Ramsel
66,Bergstraat 71,2018-09-07,13:00:00,262,64,198,FMN GV 11 Ramsel
66,Bergstraat 71,2018-09-07,14:00:00,128,72,56,FMN GV 11 Ramsel
66,Bergstraat 71,2018-09-07,15:00:00,234,170,64,FMN GV 11 Ramsel
66,Bergstraat 71,2018-09-07,16:00:00,110,74,36,FMN GV 11 Ramsel
66,Bergstraat 71,2018-09-07,17:00:00,66,36,30,FMN GV 11 Ramsel
66,Bergstraat 71,2018-09-07,18:00:00,76,46,30,FMN GV 11 Ramsel
66,Bergstraat 71,2018-09-07,19:00:00,42,26,16,FMN GV 11 Ramsel
66,Bergstraat 71,2018-09-07,20:00:00,38,28,10,FMN GV 11 Ramsel
66,Bergstraat 71,2018-09-07,21:00:00,10,6,4,FMN GV 11 Ramsel
66,Bergstraat 71,2018-09-07,22:00:00,24,18,6,FMN GV 11 Ramsel
66,Bergstraat 71,2018-09-07,23:00:00,2,0,2,FMN GV 11 Ramsel
66,Bergstraat 71,2018-09-08,00:00:00,6,4,2,FMN GV 11 Ramsel
66,Bergstraat 71,2018-09-08,01:00:00,8,8,0,FMN GV 11 Ramsel
66,Bergstraat 71,2018-09-08,02:00:00,6,2,4,FMN GV 11 Ramsel
66,Bergstraat 71,2018-09-08,03:00:00,4,4,0,FMN GV 11 Ramsel
66,Bergstraat 71,2018-09-08,04:00:00,4,0,4,FMN GV 11 Ramsel
66,Bergstraat 71,2018-09-08,05:00:00,0,0,0,FMN GV 11 Ramsel
66,Bergstraat 71,2018-09-08,06:00:00,6,2,4,FMN GV 11 Ramsel
66,Bergstraat 71,2018-09-08,07:00:00,22,4,18,FMN GV 11 Ramsel
66,Bergstraat 71,2018-09-08,08:00:00,22,8,14,FMN GV 11 Ramsel
66,Bergstraat 71,2018-09-08,09:00:00,68,28,40,FMN GV 11 Ramsel
66,Bergstraat 71,2018-09-08,10:00:00,156,114,42,FMN GV 11 Ramsel
66,Bergstraat 71,2018-09-08,11:00:00,172,120,52,FMN GV 11 Ramsel
66,Bergstraat 71,2018-09-08,12:00:00,142,94,48,FMN GV 11 Ramsel
66,Bergstraat 71,2018-09-08,13:00:00,180,108,72,FMN GV 11 Ramsel
66,Bergstraat 71,2018-09-08,14:00:00,216,120,96,FMN GV 11 Ramsel
66,Bergstraat 71,2018-09-08,15:00:00,168,82,86,FMN GV 11 Ramsel
66,Bergstraat 71,2018-09-08,16:00:00,138,88,50,FMN GV 11 Ramsel
66,Bergstraat 71,2018-09-08,17:00:00,62,18,44,FMN GV 11 Ramsel
66,Bergstraat 71,2018-09-08,18:00:00,62,34,28,FMN GV 11 Ramsel
66,Bergstraat 71,2018-09-08,19:00:00,32,12,20,FMN GV 11 Ramsel
66,Bergstraat 71,2018-09-08,20:00:00,20,16,4,FMN GV 11 Ramsel
66,Bergstraat 71,2018-09-08,21:00:00,16,8,8,FMN GV 11 Ramsel
66,Bergstraat 71,2018-09-08,22:00:00,12,6,6,FMN GV 11 Ramsel
66,Bergstraat 71,2018-09-08,23:00:00,2,2,0,FMN GV 11 Ramsel
66,Bergstraat 71,2018-09-09,00:00:00,4,4,0,FMN GV 11 Ramsel
66,Bergstraat 71,2018-09-09,01:00:00,14,12,2,FMN GV 11 Ramsel
66,Bergstraat 71,2018-09-09,02:00:00,24,24,0,FMN GV 11 Ramsel
66,Bergstraat 71,2018-09-09,03:00:00,4,0,4,FMN GV 11 Ramsel
66,Bergstraat 71,2018-09-09,04:00:00,4,4,0,FMN GV 11 Ramsel
66,Bergstraat 71,2018-09-09,05:00:00,0,0,0,FMN GV 11 Ramsel
66,Bergstraat 71,2018-09-09,06:00:00,4,2,2,FMN GV 11 Ramsel
66,Bergstraat 71,2018-09-09,07:00:00,14,6,8,FMN GV 11 Ramsel
66,Bergstraat 71,2018-09-09,08:00:00,80,42,38,FMN GV 11 Ramsel
66,Bergstraat 71,2018-09-09,09:00:00,136,50,86,FMN GV 11 Ramsel
66,Bergstraat 71,2018-09-09,10:00:00,178,104,74,FMN GV 11 Ramsel
66,Bergstraat 71,2018-09-09,11:00:00,112,56,56,FMN GV 11 Ramsel
66,Bergstraat 71,2018-09-09,12:00:00,124,66,58,FMN GV 11 Ramsel
66,Bergstraat 71,2018-09-09,13:00:00,178,96,82,FMN GV 11 Ramsel
66,Bergstraat 71,2018-09-09,14:00:00,222,132,90,FMN GV 11 Ramsel
66,Bergstraat 71,2018-09-09,15:00:00,192,110,82,FMN GV 11 Ramsel
66,Bergstraat 71,2018-09-09,16:00:00,142,58,84,FMN GV 11 Ramsel
66,Bergstraat 71,2018-09-09,17:00:00,110,70,40,FMN GV 11 Ramsel
66,Bergstraat 71,2018-09-09,18:00:00,68,30,38,FMN GV 11 Ramsel
66,Bergstraat 71,2018-09-09,19:00:00,46,28,18,FMN GV 11 Ramsel
66,Bergstraat 71,2018-09-09,20:00:00,20,18,2,FMN GV 11 Ramsel
66,Bergstraat 71,2018-09-09,21:00:00,8,6,2,FMN GV 11 Ramsel
66,Bergstraat 71,2018-09-09,22:00:00,0,0,0,FMN GV 11 Ramsel
66,Bergstraat 71,2018-09-09,23:00:00,0,0,0,FMN GV 11 Ramsel
66,Bergstraat 71,2018-09-10,00:00:00,2,2,0,FMN GV 11 Ramsel
66,Bergstraat 71,2018-09-10,01:00:00,0,0,0,FMN GV 11 Ramsel
66,Bergstraat 71,2018-09-10,02:00:00,0,0,0,FMN GV 11 Ramsel
66,Bergstraat 71,2018-09-10,03:00:00,0,0,0,FMN GV 11 Ramsel
66,Bergstraat 71,2018-09-10,04:00:00,2,0,2,FMN GV 11 Ramsel
66,Bergstraat 71,2018-09-10,05:00:00,10,4,6,FMN GV 11 Ramsel
66,Bergstraat 71,2018-09-10,06:00:00,46,16,30,FMN GV 11 Ramsel
66,Bergstraat 71,2018-09-10,07:00:00,256,56,200,FMN GV 11 Ramsel
66,Bergstraat 71,2018-09-10,08:00:00,166,42,124,FMN GV 11 Ramsel
66,Bergstraat 71,2018-09-10,09:00:00,64,26,38,FMN GV 11 Ramsel
66,Bergstraat 71,2018-09-10,10:00:00,94,54,40,FMN GV 11 Ramsel
66,Bergstraat 71,2018-09-10,11:00:00,68,28,40,FMN GV 11 Ramsel
66,Bergstraat 71,2018-09-10,12:00:00,86,38,48,FMN GV 11 Ramsel
66,Bergstraat 71,2018-09-10,13:00:00,184,90,94,FMN GV 11 Ramsel
66,Bergstraat 71,2018-09-10,14:00:00,108,36,72,FMN GV 11 Ramsel
66,Bergstraat 71,2018-09-10,15:00:00,274,210,64,FMN GV 11 Ramsel
66,Bergstraat 71,2018-09-10,16:00:00,188,136,52,FMN GV 11 Ramsel
66,Bergstraat 71,2018-09-10,17:00:00,136,82,54,FMN GV 11 Ramsel
66,Bergstraat 71,2018-09-10,18:00:00,54,30,24,FMN GV 11 Ramsel
66,Bergstraat 71,2018-09-10,19:00:00,36,18,18,FMN GV 11 Ramsel
66,Bergstraat 71,2018-09-10,20:00:00,36,18,18,FMN GV 11 Ramsel
66,Bergstraat 71,2018-09-10,21:00:00,10,4,6,FMN GV 11 Ramsel
66,Bergstraat 71,2018-09-10,22:00:00,12,8,4,FMN GV 11 Ramsel
66,Bergstraat 71,2018-09-10,23:00:00,4,2,2,FMN GV 11 Ramsel
66,Bergstraat 71,2018-09-11,00:00:00,4,4,0,FMN GV 11 Ramsel
66,Bergstraat 71,2018-09-11,01:00:00,0,0,0,FMN GV 11 Ramsel
66,Bergstraat 71,2018-09-11,02:00:00,0,0,0,FMN GV 11 Ramsel
66,Bergstraat 71,2018-09-11,03:00:00,0,0,0,FMN GV 11 Ramsel
66,Bergstraat 71,2018-09-11,04:00:00,6,2,4,FMN GV 11 Ramsel
66,Bergstraat 71,2018-09-11,05:00:00,8,2,6,FMN GV 11 Ramsel
66,Bergstraat 71,2018-09-11,06:00:00,62,20,42,FMN GV 11 Ramsel
66,Bergstraat 71,2018-09-11,07:00:00,246,58,188,FMN GV 11 Ramsel
66,Bergstraat 71,2018-09-11,08:00:00,154,24,130,FMN GV 11 Ramsel
66,Bergstraat 71,2018-09-11,09:00:00,48,22,26,FMN GV 11 Ramsel
66,Bergstraat 71,2018-09-11,10:00:00,84,22,62,FMN GV 11 Ramsel
66,Bergstraat 71,2018-09-11,11:00:00,130,44,86,FMN GV 11 Ramsel
66,Bergstraat 71,2018-09-11,12:00:00,122,66,56,FMN GV 11 Ramsel
66,Bergstraat 71,2018-09-11,13:00:00,168,74,94,FMN GV 11 Ramsel
66,Bergstraat 71,2018-09-11,14:00:00,178,92,86,FMN GV 11 Ramsel
66,Bergstraat 71,2018-09-11,15:00:00,312,222,90,FMN GV 11 Ramsel
66,Bergstraat 71,2018-09-11,16:00:00,226,162,64,FMN GV 11 Ramsel
66,Bergstraat 71,2018-09-11,17:00:00,202,116,86,FMN GV 11 Ramsel
66,Bergstraat 71,2018-09-11,18:00:00,134,74,60,FMN GV 11 Ramsel
66,Bergstraat 71,2018-09-11,19:00:00,86,40,46,FMN GV 11 Ramsel
66,Bergstraat 71,2018-09-11,20:00:00,64,52,12,FMN GV 11 Ramsel
66,Bergstraat 71,2018-09-11,21:00:00,16,14,2,FMN GV 11 Ramsel
66,Bergstraat 71,2018-09-11,22:00:00,12,8,4,FMN GV 11 Ramsel
66,Bergstraat 71,2018-09-11,23:00:00,0,0,0,FMN GV 11 Ramsel
66,Bergstraat 71,2018-09-12,00:00:00,0,0,0,FMN GV 11 Ramsel
66,Bergstraat 71,2018-09-12,01:00:00,0,0,0,FMN GV 11 Ramsel
66,Bergstraat 71,2018-09-12,02:00:00,0,0,0,FMN GV 11 Ramsel
66,Bergstraat 71,2018-09-12,03:00:00,0,0,0,FMN GV 11 Ramsel
66,Bergstraat 71,2018-09-12,04:00:00,0,0,0,FMN GV 11 Ramsel
66,Bergstraat 71,2018-09-12,05:00:00,6,2,4,FMN GV 11 Ramsel
66,Bergstraat 71,2018-09-12,06:00:00,42,14,28,FMN GV 11 Ramsel
66,Bergstraat 71,2018-09-12,07:00:00,240,42,198,FMN GV 11 Ramsel
66,Bergstraat 71,2018-09-12,08:00:00,156,32,124,FMN GV 11 Ramsel
66,Bergstraat 71,2018-09-12,09:00:00,72,22,50,FMN GV 11 Ramsel
66,Bergstraat 71,2018-09-12,10:00:00,128,46,82,FMN GV 11 Ramsel
66,Bergstraat 71,2018-09-12,11:00:00,82,44,38,FMN GV 11 Ramsel
66,Bergstraat 71,2018-09-12,12:00:00,262,212,50,FMN GV 11 Ramsel
66,Bergstraat 71,2018-09-12,13:00:00,60,44,16,FMN GV 11 Ramsel
66,Bergstraat 71,2018-09-12,14:00:00,56,30,26,FMN GV 11 Ramsel
66,Bergstraat 71,2018-09-12,15:00:00,44,24,20,FMN GV 11 Ramsel
66,Bergstraat 71,2018-09-12,16:00:00,100,60,40,FMN GV 11 Ramsel
66,Bergstraat 71,2018-09-12,17:00:00,108,58,50,FMN GV 11 Ramsel
66,Bergstraat 71,2018-09-12,18:00:00,52,28,24,FMN GV 11 Ramsel
66,Bergstraat 71,2018-09-12,19:00:00,46,28,18,FMN GV 11 Ramsel
66,Bergstraat 71,2018-09-12,20:00:00,30,20,10,FMN GV 11 Ramsel
66,Bergstraat 71,2018-09-12,21:00:00,16,6,10,FMN GV 11 Ramsel
66,Bergstraat 71,2018-09-12,22:00:00,10,10,0,FMN GV 11 Ramsel
66,Bergstraat 71,2018-09-12,23:00:00,4,2,2,FMN GV 11 Ramsel
66,Bergstraat 71,2018-09-13,00:00:00,0,0,0,FMN GV 11 Ramsel
66,Bergstraat 71,2018-09-13,01:00:00,0,0,0,FMN GV 11 Ramsel
66,Bergstraat 71,2018-09-13,02:00:00,0,0,0,FMN GV 11 Ramsel
66,Bergstraat 71,2018-09-13,03:00:00,0,0,0,FMN GV 11 Ramsel
66,Bergstraat 71,2018-09-13,04:00:00,6,2,4,FMN GV 11 Ramsel
66,Bergstraat 71,2018-09-13,05:00:00,4,2,2,FMN GV 11 Ramsel
66,Bergstraat 71,2018-09-13,06:00:00,44,12,32,FMN GV 11 Ramsel
66,Bergstraat 71,2018-09-13,07:00:00,186,22,164,FMN GV 11 Ramsel
66,Bergstraat 71,2018-09-13,08:00:00,138,10,128,FMN GV 11 Ramsel
66,Bergstraat 71,2018-09-13,09:00:00,66,12,54,FMN GV 11 Ramsel
66,Bergstraat 71,2018-09-13,10:00:00,48,24,24,FMN GV 11 Ramsel
66,Bergstraat 71,2018-09-13,11:00:00,44,14,30,FMN GV 11 Ramsel
66,Bergstraat 71,2018-09-13,12:00:00,56,32,24,FMN GV 11 Ramsel
66,Bergstraat 71,2018-09-13,13:00:00,96,52,44,FMN GV 11 Ramsel
66,Bergstraat 71,2018-09-13,14:00:00,112,52,60,FMN GV 11 Ramsel
66,Bergstraat 71,2018-09-13,15:00:00,246,180,66,FMN GV 11 Ramsel
66,Bergstraat 71,2018-09-13,16:00:00,178,128,50,FMN GV 11 Ramsel
66,Bergstraat 71,2018-09-13,17:00:00,136,68,68,FMN GV 11 Ramsel
66,Bergstraat 71,2018-09-13,18:00:00,104,60,44,FMN GV 11 Ramsel
66,Bergstraat 71,2018-09-13,19:00:00,64,38,26,FMN GV 11 Ramsel
66,Bergstraat 71,2018-09-13,20:00:00,24,16,8,FMN GV 11 Ramsel
66,Bergstraat 71,2018-09-13,21:00:00,26,16,10,FMN GV 11 Ramsel
66,Bergstraat 71,2018-09-13,22:00:00,12,8,4,FMN GV 11 Ramsel
66,Bergstraat 71,2018-09-13,23:00:00,0,0,0,FMN GV 11 Ramsel
66,Bergstraat 71,2018-09-14,00:00:00,0,0,0,FMN GV 11 Ramsel
66,Bergstraat 71,2018-09-14,01:00:00,0,0,0,FMN GV 11 Ramsel
66,Bergstraat 71,2018-09-14,02:00:00,0,0,0,FMN GV 11 Ramsel
66,Bergstraat 71,2018-09-14,03:00:00,0,0,0,FMN GV 11 Ramsel
66,Bergstraat 71,2018-09-14,04:00:00,4,2,2,FMN GV 11 Ramsel
66,Bergstraat 71,2018-09-14,05:00:00,8,2,6,FMN GV 11 Ramsel
66,Bergstraat 71,2018-09-14,06:00:00,30,6,24,FMN GV 11 Ramsel
66,Bergstraat 71,2018-09-14,07:00:00,206,28,178,FMN GV 11 Ramsel
66,Bergstraat 71,2018-09-14,08:00:00,154,26,128,FMN GV 11 Ramsel
66,Bergstraat 71,2018-09-14,09:00:00,68,14,54,FMN GV 11 Ramsel
66,Bergstraat 71,2018-09-14,10:00:00,68,30,38,FMN GV 11 Ramsel
66,Bergstraat 71,2018-09-14,11:00:00,54,30,24,FMN GV 11 Ramsel
66,Bergstraat 71,2018-09-14,12:00:00,102,42,60,FMN GV 11 Ramsel
66,Bergstraat 71,2018-09-14,13:00:00,126,54,72,FMN GV 11 Ramsel
66,Bergstraat 71,2018-09-14,14:00:00,158,76,82,FMN GV 11 Ramsel
66,Bergstraat 71,2018-09-14,15:00:00,284,222,62,FMN GV 11 Ramsel
66,Bergstraat 71,2018-09-14,16:00:00,126,86,40,FMN GV 11 Ramsel
66,Bergstraat 71,2018-09-14,17:00:00,84,62,22,FMN GV 11 Ramsel
66,Bergstraat 71,2018-09-14,18:00:00,58,36,22,FMN GV 11 Ramsel
66,Bergstraat 71,2018-09-14,19:00:00,48,26,22,FMN GV 11 Ramsel
66,Bergstraat 71,2018-09-14,20:00:00,30,8,22,FMN GV 11 Ramsel
66,Bergstraat 71,2018-09-14,21:00:00,10,4,6,FMN GV 11 Ramsel
66,Bergstraat 71,2018-09-14,22:00:00,32,2,30,FMN GV 11 Ramsel
66,Bergstraat 71,2018-09-14,23:00:00,28,14,14,FMN GV 11 Ramsel
66,Bergstraat 71,2018-09-15,00:00:00,6,4,2,FMN GV 11 Ramsel
66,Bergstraat 71,2018-09-15,01:00:00,2,0,2,FMN GV 11 Ramsel
66,Bergstraat 71,2018-09-15,02:00:00,14,14,0,FMN GV 11 Ramsel
66,Bergstraat 71,2018-09-15,03:00:00,16,16,0,FMN GV 11 Ramsel
66,Bergstraat 71,2018-09-15,04:00:00,10,8,2,FMN GV 11 Ramsel
66,Bergstraat 71,2018-09-15,05:00:00,8,6,2,FMN GV 11 Ramsel
66,Bergstraat 71,2018-09-15,06:00:00,6,2,4,FMN GV 11 Ramsel
66,Bergstraat 71,2018-09-15,07:00:00,12,4,8,FMN GV 11 Ramsel
66,Bergstraat 71,2018-09-15,08:00:00,26,14,12,FMN GV 11 Ramsel
66,Bergstraat 71,2018-09-15,09:00:00,58,30,28,FMN GV 11 Ramsel
66,Bergstraat 71,2018-09-15,10:00:00,106,52,54,FMN GV 11 Ramsel
66,Bergstraat 71,2018-09-15,11:00:00,134,74,60,FMN GV 11 Ramsel
66,Bergstraat 71,2018-09-15,12:00:00,76,36,40,FMN GV 11 Ramsel
66,Bergstraat 71,2018-09-15,13:00:00,158,68,90,FMN GV 11 Ramsel
66,Bergstraat 71,2018-09-15,14:00:00,98,54,44,FMN GV 11 Ramsel
66,Bergstraat 71,2018-09-15,15:00:00,120,60,60,FMN GV 11 Ramsel
66,Bergstraat 71,2018-09-15,16:00:00,110,76,34,FMN GV 11 Ramsel
66,Bergstraat 71,2018-09-15,17:00:00,56,40,16,FMN GV 11 Ramsel
66,Bergstraat 71,2018-09-15,18:00:00,52,28,24,FMN GV 11 Ramsel
66,Bergstraat 71,2018-09-15,19:00:00,18,4,14,FMN GV 11 Ramsel
66,Bergstraat 71,2018-09-15,20:00:00,14,8,6,FMN GV 11 Ramsel
66,Bergstraat 71,2018-09-15,21:00:00,6,2,4,FMN GV 11 Ramsel
66,Bergstraat 71,2018-09-15,22:00:00,16,8,8,FMN GV 11 Ramsel
66,Bergstraat 71,2018-09-15,23:00:00,8,4,4,FMN GV 11 Ramsel
66,Bergstraat 71,2018-09-16,00:00:00,4,0,4,FMN GV 11 Ramsel
66,Bergstraat 71,2018-09-16,01:00:00,8,2,6,FMN GV 11 Ramsel
66,Bergstraat 71,2018-09-16,02:00:00,4,4,0,FMN GV 11 Ramsel
66,Bergstraat 71,2018-09-16,03:00:00,4,4,0,FMN GV 11 Ramsel
66,Bergstraat 71,2018-09-16,04:00:00,0,0,0,FMN GV 11 Ramsel
66,Bergstraat 71,2018-09-16,05:00:00,4,0,4,FMN GV 11 Ramsel
66,Bergstraat 71,2018-09-16,06:00:00,0,0,0,FMN GV 11 Ramsel
66,Bergstraat 71,2018-09-16,07:00:00,12,4,8,FMN GV 11 Ramsel
66,Bergstraat 71,2018-09-16,08:00:00,52,14,38,FMN GV 11 Ramsel
66,Bergstraat 71,2018-09-16,09:00:00,100,40,60,FMN GV 11 Ramsel
66,Bergstraat 71,2018-09-16,10:00:00,98,44,54,FMN GV 11 Ramsel
66,Bergstraat 71,2018-09-16,11:00:00,158,74,84,FMN GV 11 Ramsel
66,Bergstraat 71,2018-09-16,12:00:00,138,70,68,FMN GV 11 Ramsel
66,Bergstraat 71,2018-09-16,13:00:00,242,104,138,FMN GV 11 Ramsel
66,Bergstraat 71,2018-09-16,14:00:00,276,148,128,FMN GV 11 Ramsel
66,Bergstraat 71,2018-09-16,15:00:00,192,110,82,FMN GV 11 Ramsel
66,Bergstraat 71,2018-09-16,16:00:00,180,122,58,FMN GV 11 Ramsel
66,Bergstraat 71,2018-09-16,17:00:00,154,84,70,FMN GV 11 Ramsel
66,Bergstraat 71,2018-09-16,18:00:00,86,46,40,FMN GV 11 Ramsel
66,Bergstraat 71,2018-09-16,19:00:00,34,14,20,FMN GV 11 Ramsel
66,Bergstraat 71,2018-09-16,20:00:00,28,12,16,FMN GV 11 Ramsel
66,Bergstraat 71,2018-09-16,21:00:00,4,2,2,FMN GV 11 Ramsel
66,Bergstraat 71,2018-09-16,22:00:00,4,2,2,FMN GV 11 Ramsel
66,Bergstraat 71,2018-09-16,23:00:00,0,0,0,FMN GV 11 Ramsel
66,Bergstraat 71,2018-09-17,00:00:00,4,2,2,FMN GV 11 Ramsel
66,Bergstraat 71,2018-09-17,01:00:00,4,2,2,FMN GV 11 Ramsel
66,Bergstraat 71,2018-09-17,02:00:00,0,0,0,FMN GV 11 Ramsel
66,Bergstraat 71,2018-09-17,03:00:00,0,0,0,FMN GV 11 Ramsel
66,Bergstraat 71,2018-09-17,04:00:00,4,2,2,FMN GV 11 Ramsel
66,Bergstraat 71,2018-09-17,05:00:00,10,6,4,FMN GV 11 Ramsel
66,Bergstraat 71,2018-09-17,06:00:00,40,12,28,FMN GV 11 Ramsel
66,Bergstraat 71,2018-09-17,07:00:00,254,44,210,FMN GV 11 Ramsel
66,Bergstraat 71,2018-09-17,08:00:00,302,160,142,FMN GV 11 Ramsel
66,Bergstraat 71,2018-09-17,09:00:00,132,110,22,FMN GV 11 Ramsel
66,Bergstraat 71,2018-09-17,10:00:00,56,32,24,FMN GV 11 Ramsel
66,Bergstraat 71,2018-09-17,11:00:00,72,24,48,FMN GV 11 Ramsel
66,Bergstraat 71,2018-09-17,12:00:00,110,36,74,FMN GV 11 Ramsel
66,Bergstraat 71,2018-09-17,13:00:00,164,86,78,FMN GV 11 Ramsel
66,Bergstraat 71,2018-09-17,14:00:00,202,126,76,FMN GV 11 Ramsel
66,Bergstraat 71,2018-09-17,15:00:00,282,196,86,FMN GV 11 Ramsel
66,Bergstraat 71,2018-09-17,16:00:00,426,194,232,FMN GV 11 Ramsel
66,Bergstraat 71,2018-09-17,17:00:00,140,88,52,FMN GV 11 Ramsel
66,Bergstraat 71,2018-09-17,18:00:00,86,48,38,FMN GV 11 Ramsel
66,Bergstraat 71,2018-09-17,19:00:00,70,34,36,FMN GV 11 Ramsel
66,Bergstraat 71,2018-09-17,20:00:00,32,28,4,FMN GV 11 Ramsel
66,Bergstraat 71,2018-09-17,21:00:00,10,4,6,FMN GV 11 Ramsel
66,Bergstraat 71,2018-09-17,22:00:00,8,4,4,FMN GV 11 Ramsel
66,Bergstraat 71,2018-09-17,23:00:00,2,0,2,FMN GV 11 Ramsel
66,Bergstraat 71,2018-09-18,00:00:00,0,0,0,FMN GV 11 Ramsel
66,Bergstraat 71,2018-09-18,01:00:00,0,0,0,FMN GV 11 Ramsel
66,Bergstraat 71,2018-09-18,02:00:00,0,0,0,FMN GV 11 Ramsel
66,Bergstraat 71,2018-09-18,03:00:00,0,0,0,FMN GV 11 Ramsel
66,Bergstraat 71,2018-09-18,04:00:00,0,0,0,FMN GV 11 Ramsel
66,Bergstraat 71,2018-09-18,05:00:00,10,6,4,FMN GV 11 Ramsel
66,Bergstraat 71,2018-09-18,06:00:00,50,20,30,FMN GV 11 Ramsel
66,Bergstraat 71,2018-09-18,07:00:00,262,42,220,FMN GV 11 Ramsel
66,Bergstraat 71,2018-09-18,08:00:00,222,40,182,FMN GV 11 Ramsel
66,Bergstraat 71,2018-09-18,09:00:00,92,36,56,FMN GV 11 Ramsel
66,Bergstraat 71,2018-09-18,10:00:00,138,46,92,FMN GV 11 Ramsel
66,Bergstraat 71,2018-09-18,11:00:00,98,42,56,FMN GV 11 Ramsel
66,Bergstraat 71,2018-09-18,12:00:00,136,70,66,FMN GV 11 Ramsel
66,Bergstraat 71,2018-09-18,13:00:00,154,72,82,FMN GV 11 Ramsel
66,Bergstraat 71,2018-09-18,14:00:00,184,90,94,FMN GV 11 Ramsel
66,Bergstraat 71,2018-09-18,15:00:00,322,246,76,FMN GV 11 Ramsel
66,Bergstraat 71,2018-09-18,16:00:00,304,230,74,FMN GV 11 Ramsel
66,Bergstraat 71,2018-09-18,17:00:00,188,84,104,FMN GV 11 Ramsel
66,Bergstraat 71,2018-09-18,18:00:00,150,82,68,FMN GV 11 Ramsel
66,Bergstraat 71,2018-09-18,19:00:00,106,48,58,FMN GV 11 Ramsel
66,Bergstraat 71,2018-09-18,20:00:00,56,38,18,FMN GV 11 Ramsel
66,Bergstraat 71,2018-09-18,21:00:00,32,28,4,FMN GV 11 Ramsel
66,Bergstraat 71,2018-09-18,22:00:00,14,14,0,FMN GV 11 Ramsel
66,Bergstraat 71,2018-09-18,23:00:00,0,0,0,FMN GV 11 Ramsel
66,Bergstraat 71,2018-09-19,00:00:00,0,0,0,FMN GV 11 Ramsel
66,Bergstraat 71,2018-09-19,01:00:00,0,0,0,FMN GV 11 Ramsel
66,Bergstraat 71,2018-09-19,02:00:00,0,0,0,FMN GV 11 Ramsel
66,Bergstraat 71,2018-09-19,03:00:00,0,0,0,FMN GV 11 Ramsel
66,Bergstraat 71,2018-09-19,04:00:00,2,2,0,FMN GV 11 Ramsel
66,Bergstraat 71,2018-09-19,05:00:00,10,4,6,FMN GV 11 Ramsel
66,Bergstraat 71,2018-09-19,06:00:00,34,14,20,FMN GV 11 Ramsel
66,Bergstraat 71,2018-09-19,07:00:00,286,48,238,FMN GV 11 Ramsel
66,Bergstraat 71,2018-09-19,08:00:00,178,38,140,FMN GV 11 Ramsel
66,Bergstraat 71,2018-09-19,09:00:00,68,30,38,FMN GV 11 Ramsel
66,Bergstraat 71,2018-09-19,10:00:00,82,28,54,FMN GV 11 Ramsel
66,Bergstraat 71,2018-09-19,11:00:00,110,44,66,FMN GV 11 Ramsel
66,Bergstraat 71,2018-09-19,12:00:00,324,260,64,FMN GV 11 Ramsel
66,Bergstraat 71,2018-09-19,13:00:00,196,112,84,FMN GV 11 Ramsel
66,Bergstraat 71,2018-09-19,14:00:00,192,108,84,FMN GV 11 Ramsel
66,Bergstraat 71,2018-09-19,15:00:00,140,84,56,FMN GV 11 Ramsel
66,Bergstraat 71,2018-09-19,16:00:00,158,110,48,FMN GV 11 Ramsel
66,Bergstraat 71,2018-09-19,17:00:00,186,84,102,FMN GV 11 Ramsel
66,Bergstraat 71,2018-09-19,18:00:00,100,46,54,FMN GV 11 Ramsel
66,Bergstraat 71,2018-09-19,19:00:00,62,40,22,FMN GV 11 Ramsel
66,Bergstraat 71,2018-09-19,20:00:00,32,26,6,FMN GV 11 Ramsel
66,Bergstraat 71,2018-09-19,21:00:00,6,4,2,FMN GV 11 Ramsel
66,Bergstraat 71,2018-09-19,22:00:00,14,12,2,FMN GV 11 Ramsel
66,Bergstraat 71,2018-09-19,23:00:00,2,0,2,FMN GV 11 Ramsel
66,Bergstraat 71,2018-09-20,00:00:00,4,4,0,FMN GV 11 Ramsel
66,Bergstraat 71,2018-09-20,01:00:00,0,0,0,FMN GV 11 Ramsel
66,Bergstraat 71,2018-09-20,02:00:00,0,0,0,FMN GV 11 Ramsel
66,Bergstraat 71,2018-09-20,03:00:00,0,0,0,FMN GV 11 Ramsel
66,Bergstraat 71,2018-09-20,04:00:00,4,2,2,FMN GV 11 Ramsel
66,Bergstraat 71,2018-09-20,05:00:00,8,4,4,FMN GV 11 Ramsel
66,Bergstraat 71,2018-09-20,06:00:00,46,12,34,FMN GV 11 Ramsel
66,Bergstraat 71,2018-09-20,07:00:00,250,50,200,FMN GV 11 Ramsel
66,Bergstraat 71,2018-09-20,08:00:00,174,24,150,FMN GV 11 Ramsel
66,Bergstraat 71,2018-09-20,09:00:00,72,26,46,FMN GV 11 Ramsel
66,Bergstraat 71,2018-09-20,10:00:00,112,32,80,FMN GV 11 Ramsel
66,Bergstraat 71,2018-09-20,11:00:00,98,48,50,FMN GV 11 Ramsel
66,Bergstraat 71,2018-09-20,12:00:00,124,76,48,FMN GV 11 Ramsel
66,Bergstraat 71,2018-09-20,13:00:00,136,58,78,FMN GV 11 Ramsel
66,Bergstraat 71,2018-09-20,14:00:00,152,86,66,FMN GV 11 Ramsel
66,Bergstraat 71,2018-09-20,15:00:00,264,188,76,FMN GV 11 Ramsel
66,Bergstraat 71,2018-09-20,16:00:00,252,156,96,FMN GV 11 Ramsel
66,Bergstraat 71,2018-09-20,17:00:00,122,72,50,FMN GV 11 Ramsel
66,Bergstraat 71,2018-09-20,18:00:00,82,36,46,FMN GV 11 Ramsel
66,Bergstraat 71,2018-09-20,19:00:00,70,42,28,FMN GV 11 Ramsel
66,Bergstraat 71,2018-09-20,20:00:00,24,18,6,FMN GV 11 Ramsel
66,Bergstraat 71,2018-09-20,21:00:00,18,8,10,FMN GV 11 Ramsel
66,Bergstraat 71,2018-09-20,22:00:00,14,10,4,FMN GV 11 Ramsel
66,Bergstraat 71,2018-09-20,23:00:00,2,2,0,FMN GV 11 Ramsel
66,Bergstraat 71,2018-09-21,00:00:00,0,0,0,FMN GV 11 Ramsel
66,Bergstraat 71,2018-09-21,01:00:00,0,0,0,FMN GV 11 Ramsel
66,Bergstraat 71,2018-09-21,02:00:00,0,0,0,FMN GV 11 Ramsel
66,Bergstraat 71,2018-09-21,03:00:00,0,0,0,FMN GV 11 Ramsel
66,Bergstraat 71,2018-09-21,04:00:00,2,2,0,FMN GV 11 Ramsel
66,Bergstraat 71,2018-09-21,05:00:00,4,2,2,FMN GV 11 Ramsel
66,Bergstraat 71,2018-09-21,06:00:00,26,8,18,FMN GV 11 Ramsel
66,Bergstraat 71,2018-09-21,07:00:00,124,14,110,FMN GV 11 Ramsel
66,Bergstraat 71,2018-09-21,08:00:00,96,16,80,FMN GV 11 Ramsel
66,Bergstraat 71,2018-09-21,09:00:00,14,8,6,FMN GV 11 Ramsel
66,Bergstraat 71,2018-09-21,10:00:00,20,4,16,FMN GV 11 Ramsel
66,Bergstraat 71,2018-09-21,11:00:00,22,16,6,FMN GV 11 Ramsel
66,Bergstraat 71,2018-09-21,12:00:00,38,10,28,FMN GV 11 Ramsel
66,Bergstraat 71,2018-09-21,13:00:00,62,30,32,FMN GV 11 Ramsel
66,Bergstraat 71,2018-09-21,14:00:00,56,30,26,FMN GV 11 Ramsel
66,Bergstraat 71,2018-09-21,15:00:00,138,102,36,FMN GV 11 Ramsel
66,Bergstraat 71,2018-09-21,16:00:00,96,82,14,FMN GV 11 Ramsel
66,Bergstraat 71,2018-09-21,17:00:00,72,48,24,FMN GV 11 Ramsel
66,Bergstraat 71,2018-09-21,18:00:00,46,24,22,FMN GV 11 Ramsel
66,Bergstraat 71,2018-09-21,19:00:00,24,12,12,FMN GV 11 Ramsel
66,Bergstraat 71,2018-09-21,20:00:00,30,16,14,FMN GV 11 Ramsel
66,Bergstraat 71,2018-09-21,21:00:00,18,12,6,FMN GV 11 Ramsel
66,Bergstraat 71,2018-09-21,22:00:00,10,4,6,FMN GV 11 Ramsel
66,Bergstraat 71,2018-09-21,23:00:00,2,2,0,FMN GV 11 Ramsel
66,Bergstraat 71,2018-09-22,00:00:00,0,0,0,FMN GV 11 Ramsel
66,Bergstraat 71,2018-09-22,01:00:00,2,2,0,FMN GV 11 Ramsel
66,Bergstraat 71,2018-09-22,02:00:00,12,10,2,FMN GV 11 Ramsel
66,Bergstraat 71,2018-09-22,03:00:00,0,0,0,FMN GV 11 Ramsel
66,Bergstraat 71,2018-09-22,04:00:00,4,4,0,FMN GV 11 Ramsel
66,Bergstraat 71,2018-09-22,05:00:00,4,0,4,FMN GV 11 Ramsel
66,Bergstraat 71,2018-09-22,06:00:00,4,2,2,FMN GV 11 Ramsel
66,Bergstraat 71,2018-09-22,07:00:00,10,6,4,FMN GV 11 Ramsel
66,Bergstraat 71,2018-09-22,08:00:00,20,10,10,FMN GV 11 Ramsel
66,Bergstraat 71,2018-09-22,09:00:00,58,22,36,FMN GV 11 Ramsel
66,Bergstraat 71,2018-09-22,10:00:00,70,38,32,FMN GV 11 Ramsel
66,Bergstraat 71,2018-09-22,11:00:00,44,20,24,FMN GV 11 Ramsel
66,Bergstraat 71,2018-09-22,12:00:00,68,36,32,FMN GV 11 Ramsel
66,Bergstraat 71,2018-09-22,13:00:00,52,26,26,FMN GV 11 Ramsel
66,Bergstraat 71,2018-09-22,14:00:00,78,32,46,FMN GV 11 Ramsel
66,Bergstraat 71,2018-09-22,15:00:00,58,28,30,FMN GV 11 Ramsel
66,Bergstraat 71,2018-09-22,16:00:00,18,10,8,FMN GV 11 Ramsel
66,Bergstraat 71,2018-09-22,17:00:00,20,10,10,FMN GV 11 Ramsel
66,Bergstraat 71,2018-09-22,18:00:00,22,10,12,FMN GV 11 Ramsel
66,Bergstraat 71,2018-09-22,19:00:00,4,0,4,FMN GV 11 Ramsel
66,Bergstraat 71,2018-09-22,20:00:00,4,2,2,FMN GV 11 Ramsel
66,Bergstraat 71,2018-09-22,21:00:00,2,0,2,FMN GV 11 Ramsel
66,Bergstraat 71,2018-09-22,22:00:00,4,2,2,FMN GV 11 Ramsel
66,Bergstraat 71,2018-09-22,23:00:00,2,2,0,FMN GV 11 Ramsel
66,Bergstraat 71,2018-09-23,00:00:00,4,2,2,FMN GV 11 Ramsel
66,Bergstraat 71,2018-09-23,01:00:00,0,0,0,FMN GV 11 Ramsel
66,Bergstraat 71,2018-09-23,02:00:00,2,2,0,FMN GV 11 Ramsel
66,Bergstraat 71,2018-09-23,03:00:00,2,2,0,FMN GV 11 Ramsel
66,Bergstraat 71,2018-09-23,04:00:00,0,0,0,FMN GV 11 Ramsel
66,Bergstraat 71,2018-09-23,05:00:00,0,0,0,FMN GV 11 Ramsel
66,Bergstraat 71,2018-09-23,06:00:00,2,2,0,FMN GV 11 Ramsel
66,Bergstraat 71,2018-09-23,07:00:00,4,2,2,FMN GV 11 Ramsel
66,Bergstraat 71,2018-09-23,08:00:00,24,10,14,FMN GV 11 Ramsel
66,Bergstraat 71,2018-09-23,09:00:00,16,6,10,FMN GV 11 Ramsel
66,Bergstraat 71,2018-09-23,10:00:00,20,12,8,FMN GV 11 Ramsel
66,Bergstraat 71,2018-09-23,11:00:00,22,14,8,FMN GV 11 Ramsel
66,Bergstraat 71,2018-09-23,12:00:00,8,8,0,FMN GV 11 Ramsel
66,Bergstraat 71,2018-09-23,13:00:00,16,14,2,FMN GV 11 Ramsel
66,Bergstraat 71,2018-09-23,14:00:00,6,4,2,FMN GV 11 Ramsel
66,Bergstraat 71,2018-09-23,15:00:00,6,4,2,FMN GV 11 Ramsel
66,Bergstraat 71,2018-09-23,16:00:00,2,2,0,FMN GV 11 Ramsel
66,Bergstraat 71,2018-09-23,17:00:00,6,2,4,FMN GV 11 Ramsel
66,Bergstraat 71,2018-09-23,18:00:00,2,0,2,FMN GV 11 Ramsel
66,Bergstraat 71,2018-09-23,19:00:00,2,0,2,FMN GV 11 Ramsel
66,Bergstraat 71,2018-09-23,20:00:00,0,0,0,FMN GV 11 Ramsel
66,Bergstraat 71,2018-09-23,21:00:00,4,0,4,FMN GV 11 Ramsel
66,Bergstraat 71,2018-09-23,22:00:00,2,2,0,FMN GV 11 Ramsel
66,Bergstraat 71,2018-09-23,23:00:00,2,2,0,FMN GV 11 Ramsel
66,Bergstraat 71,2018-09-24,00:00:00,0,0,0,FMN GV 11 Ramsel
66,Bergstraat 71,2018-09-24,01:00:00,0,0,0,FMN GV 11 Ramsel
66,Bergstraat 71,2018-09-24,02:00:00,0,0,0,FMN GV 11 Ramsel
66,Bergstraat 71,2018-09-24,03:00:00,0,0,0,FMN GV 11 Ramsel
66,Bergstraat 71,2018-09-24,04:00:00,6,0,6,FMN GV 11 Ramsel
66,Bergstraat 71,2018-09-24,05:00:00,6,4,2,FMN GV 11 Ramsel
66,Bergstraat 71,2018-09-24,06:00:00,38,12,26,FMN GV 11 Ramsel
66,Bergstraat 71,2018-09-24,07:00:00,160,20,140,FMN GV 11 Ramsel
66,Bergstraat 71,2018-09-24,08:00:00,130,14,116,FMN GV 11 Ramsel
66,Bergstraat 71,2018-09-24,09:00:00,34,12,22,FMN GV 11 Ramsel
66,Bergstraat 71,2018-09-24,10:00:00,32,20,12,FMN GV 11 Ramsel
66,Bergstraat 71,2018-09-24,11:00:00,20,6,14,FMN GV 11 Ramsel
66,Bergstraat 71,2018-09-24,12:00:00,40,18,22,FMN GV 11 Ramsel
66,Bergstraat 71,2018-09-24,13:00:00,56,14,42,FMN GV 11 Ramsel
66,Bergstraat 71,2018-09-24,14:00:00,56,38,18,FMN GV 11 Ramsel
66,Bergstraat 71,2018-09-24,15:00:00,182,144,38,FMN GV 11 Ramsel
66,Bergstraat 71,2018-09-24,16:00:00,136,114,22,FMN GV 11 Ramsel
66,Bergstraat 71,2018-09-24,17:00:00,76,48,28,FMN GV 11 Ramsel
66,Bergstraat 71,2018-09-24,18:00:00,48,24,24,FMN GV 11 Ramsel
66,Bergstraat 71,2018-09-24,19:00:00,64,32,32,FMN GV 11 Ramsel
66,Bergstraat 71,2018-09-24,20:00:00,26,18,8,FMN GV 11 Ramsel
66,Bergstraat 71,2018-09-24,21:00:00,20,12,8,FMN GV 11 Ramsel
66,Bergstraat 71,2018-09-24,22:00:00,12,2,10,FMN GV 11 Ramsel
66,Bergstraat 71,2018-09-24,23:00:00,6,6,0,FMN GV 11 Ramsel
66,Bergstraat 71,2018-09-25,00:00:00,0,0,0,FMN GV 11 Ramsel
66,Bergstraat 71,2018-09-25,01:00:00,0,0,0,FMN GV 11 Ramsel
66,Bergstraat 71,2018-09-25,02:00:00,0,0,0,FMN GV 11 Ramsel
66,Bergstraat 71,2018-09-25,03:00:00,0,0,0,FMN GV 11 Ramsel
66,Bergstraat 71,2018-09-25,04:00:00,4,2,2,FMN GV 11 Ramsel
66,Bergstraat 71,2018-09-25,05:00:00,4,2,2,FMN GV 11 Ramsel
66,Bergstraat 71,2018-09-25,06:00:00,42,20,22,FMN GV 11 Ramsel
66,Bergstraat 71,2018-09-25,07:00:00,188,28,160,FMN GV 11 Ramsel
66,Bergstraat 71,2018-09-25,08:00:00,178,32,146,FMN GV 11 Ramsel
66,Bergstraat 71,2018-09-25,09:00:00,28,12,16,FMN GV 11 Ramsel
66,Bergstraat 71,2018-09-25,10:00:00,36,22,14,FMN GV 11 Ramsel
66,Bergstraat 71,2018-09-25,11:00:00,38,6,32,FMN GV 11 Ramsel
66,Bergstraat 71,2018-09-25,12:00:00,94,46,48,FMN GV 11 Ramsel
66,Bergstraat 71,2018-09-25,13:00:00,164,78,86,FMN GV 11 Ramsel
66,Bergstraat 71,2018-09-25,14:00:00,128,68,60,FMN GV 11 Ramsel
66,Bergstraat 71,2018-09-25,15:00:00,282,214,68,FMN GV 11 Ramsel
66,Bergstraat 71,2018-09-25,16:00:00,232,162,70,FMN GV 11 Ramsel
66,Bergstraat 71,2018-09-25,17:00:00,104,58,46,FMN GV 11 Ramsel
66,Bergstraat 71,2018-09-25,18:00:00,110,58,52,FMN GV 11 Ramsel
66,Bergstraat 71,2018-09-25,19:00:00,66,28,38,FMN GV 11 Ramsel
66,Bergstraat 71,2018-09-25,20:00:00,34,30,4,FMN GV 11 Ramsel
66,Bergstraat 71,2018-09-25,21:00:00,16,6,10,FMN GV 11 Ramsel
66,Bergstraat 71,2018-09-25,22:00:00,4,4,0,FMN GV 11 Ramsel
66,Bergstraat 71,2018-09-25,23:00:00,2,2,0,FMN GV 11 Ramsel
66,Bergstraat 71,2018-09-26,00:00:00,0,0,0,FMN GV 11 Ramsel
66,Bergstraat 71,2018-09-26,01:00:00,0,0,0,FMN GV 11 Ramsel
66,Bergstraat 71,2018-09-26,02:00:00,0,0,0,FMN GV 11 Ramsel
66,Bergstraat 71,2018-09-26,03:00:00,0,0,0,FMN GV 11 Ramsel
66,Bergstraat 71,2018-09-26,04:00:00,4,2,2,FMN GV 11 Ramsel
66,Bergstraat 71,2018-09-26,05:00:00,4,4,0,FMN GV 11 Ramsel
66,Bergstraat 71,2018-09-26,06:00:00,40,14,26,FMN GV 11 Ramsel
66,Bergstraat 71,2018-09-26,07:00:00,204,30,174,FMN GV 11 Ramsel
66,Bergstraat 71,2018-09-26,08:00:00,184,20,164,FMN GV 11 Ramsel
66,Bergstraat 71,2018-09-26,09:00:00,46,14,32,FMN GV 11 Ramsel
66,Bergstraat 71,2018-09-26,10:00:00,62,30,32,FMN GV 11 Ramsel
66,Bergstraat 71,2018-09-26,11:00:00,90,42,48,FMN GV 11 Ramsel
66,Bergstraat 71,2018-09-26,12:00:00,292,228,64,FMN GV 11 Ramsel
66,Bergstraat 71,2018-09-26,13:00:00,198,70,128,FMN GV 11 Ramsel
66,Bergstraat 71,2018-09-26,14:00:00,200,90,110,FMN GV 11 Ramsel
66,Bergstraat 71,2018-09-26,15:00:00,186,130,56,FMN GV 11 Ramsel
66,Bergstraat 71,2018-09-26,16:00:00,148,74,74,FMN GV 11 Ramsel
66,Bergstraat 71,2018-09-26,17:00:00,146,76,70,FMN GV 11 Ramsel
66,Bergstraat 71,2018-09-26,18:00:00,100,62,38,FMN GV 11 Ramsel
66,Bergstraat 71,2018-09-26,19:00:00,54,34,20,FMN GV 11 Ramsel
66,Bergstraat 71,2018-09-26,20:00:00,28,16,12,FMN GV 11 Ramsel
66,Bergstraat 71,2018-09-26,21:00:00,20,18,2,FMN GV 11 Ramsel
66,Bergstraat 71,2018-09-26,22:00:00,10,10,0,FMN GV 11 Ramsel
66,Bergstraat 71,2018-09-26,23:00:00,4,4,0,FMN GV 11 Ramsel
66,Bergstraat 71,2018-09-27,00:00:00,4,4,0,FMN GV 11 Ramsel
66,Bergstraat 71,2018-09-27,01:00:00,2,2,0,FMN GV 11 Ramsel
66,Bergstraat 71,2018-09-27,02:00:00,0,0,0,FMN GV 11 Ramsel
66,Bergstraat 71,2018-09-27,03:00:00,0,0,0,FMN GV 11 Ramsel
66,Bergstraat 71,2018-09-27,04:00:00,4,2,2,FMN GV 11 Ramsel
66,Bergstraat 71,2018-09-27,05:00:00,8,6,2,FMN GV 11 Ramsel
66,Bergstraat 71,2018-09-27,06:00:00,44,6,38,FMN GV 11 Ramsel
66,Bergstraat 71,2018-09-27,07:00:00,208,36,172,FMN GV 11 Ramsel
66,Bergstraat 71,2018-09-27,08:00:00,168,22,146,FMN GV 11 Ramsel
66,Bergstraat 71,2018-09-27,09:00:00,64,20,44,FMN GV 11 Ramsel
66,Bergstraat 71,2018-09-27,10:00:00,106,52,54,FMN GV 11 Ramsel
66,Bergstraat 71,2018-09-27,11:00:00,96,52,44,FMN GV 11 Ramsel
66,Bergstraat 71,2018-09-27,12:00:00,126,58,68,FMN GV 11 Ramsel
66,Bergstraat 71,2018-09-27,13:00:00,264,142,122,FMN GV 11 Ramsel
66,Bergstraat 71,2018-09-27,14:00:00,206,118,88,FMN GV 11 Ramsel
66,Bergstraat 71,2018-09-27,15:00:00,290,212,78,FMN GV 11 Ramsel
66,Bergstraat 71,2018-09-27,16:00:00,282,194,88,FMN GV 11 Ramsel
66,Bergstraat 71,2018-09-27,17:00:00,150,72,78,FMN GV 11 Ramsel
66,Bergstraat 71,2018-09-27,18:00:00,118,40,78,FMN GV 11 Ramsel
66,Bergstraat 71,2018-09-27,19:00:00,72,48,24,FMN GV 11 Ramsel
66,Bergstraat 71,2018-09-27,20:00:00,26,12,14,FMN GV 11 Ramsel
66,Bergstraat 71,2018-09-27,21:00:00,16,12,4,FMN GV 11 Ramsel
66,Bergstraat 71,2018-09-27,22:00:00,14,10,4,FMN GV 11 Ramsel
66,Bergstraat 71,2018-09-27,23:00:00,10,10,0,FMN GV 11 Ramsel
66,Bergstraat 71,2018-09-28,00:00:00,0,0,0,FMN GV 11 Ramsel
66,Bergstraat 71,2018-09-28,01:00:00,0,0,0,FMN GV 11 Ramsel
66,Bergstraat 71,2018-09-28,02:00:00,2,2,0,FMN GV 11 Ramsel
66,Bergstraat 71,2018-09-28,03:00:00,0,0,0,FMN GV 11 Ramsel
66,Bergstraat 71,2018-09-28,04:00:00,2,2,0,FMN GV 11 Ramsel
66,Bergstraat 71,2018-09-28,05:00:00,4,2,2,FMN GV 11 Ramsel
66,Bergstraat 71,2018-09-28,06:00:00,36,10,26,FMN GV 11 Ramsel
66,Bergstraat 71,2018-09-28,07:00:00,166,22,144,FMN GV 11 Ramsel
66,Bergstraat 71,2018-09-28,08:00:00,170,36,134,FMN GV 11 Ramsel
66,Bergstraat 71,2018-09-28,09:00:00,34,14,20,FMN GV 11 Ramsel
66,Bergstraat 71,2018-09-28,10:00:00,54,18,36,FMN GV 11 Ramsel
66,Bergstraat 71,2018-09-28,11:00:00,44,22,22,FMN GV 11 Ramsel
66,Bergstraat 71,2018-09-28,12:00:00,52,32,20,FMN GV 11 Ramsel
66,Bergstraat 71,2018-09-28,13:00:00,44,32,12,FMN GV 11 Ramsel
66,Bergstraat 71,2018-09-28,14:00:00,74,34,40,FMN GV 11 Ramsel
66,Bergstraat 71,2018-09-28,15:00:00,216,174,42,FMN GV 11 Ramsel
66,Bergstraat 71,2018-09-28,16:00:00,128,94,34,FMN GV 11 Ramsel
66,Bergstraat 71,2018-09-28,17:00:00,84,46,38,FMN GV 11 Ramsel
66,Bergstraat 71,2018-09-28,18:00:00,56,28,28,FMN GV 11 Ramsel
66,Bergstraat 71,2018-09-28,19:00:00,42,14,28,FMN GV 11 Ramsel
66,Bergstraat 71,2018-09-28,20:00:00,16,10,6,FMN GV 11 Ramsel
66,Bergstraat 71,2018-09-28,21:00:00,18,6,12,FMN GV 11 Ramsel
66,Bergstraat 71,2018-09-28,22:00:00,10,6,4,FMN GV 11 Ramsel
66,Bergstraat 71,2018-09-28,23:00:00,4,2,2,FMN GV 11 Ramsel
66,Bergstraat 71,2018-09-29,00:00:00,6,6,0,FMN GV 11 Ramsel
66,Bergstraat 71,2018-09-29,01:00:00,12,12,0,FMN GV 11 Ramsel
66,Bergstraat 71,2018-09-29,02:00:00,8,8,0,FMN GV 11 Ramsel
66,Bergstraat 71,2018-09-29,03:00:00,4,4,0,FMN GV 11 Ramsel
66,Bergstraat 71,2018-09-29,04:00:00,2,0,2,FMN GV 11 Ramsel
66,Bergstraat 71,2018-09-29,05:00:00,4,2,2,FMN GV 11 Ramsel
66,Bergstraat 71,2018-09-29,06:00:00,4,2,2,FMN GV 11 Ramsel
66,Bergstraat 71,2018-09-29,07:00:00,4,2,2,FMN GV 11 Ramsel
66,Bergstraat 71,2018-09-29,08:00:00,8,2,6,FMN GV 11 Ramsel
66,Bergstraat 71,2018-09-29,09:00:00,54,14,40,FMN GV 11 Ramsel
66,Bergstraat 71,2018-09-29,10:00:00,64,36,28,FMN GV 11 Ramsel
66,Bergstraat 71,2018-09-29,11:00:00,98,56,42,FMN GV 11 Ramsel
66,Bergstraat 71,2018-09-29,12:00:00,72,22,50,FMN GV 11 Ramsel
66,Bergstraat 71,2018-09-29,13:00:00,122,44,78,FMN GV 11 Ramsel
66,Bergstraat 71,2018-09-29,14:00:00,202,102,100,FMN GV 11 Ramsel
66,Bergstraat 71,2018-09-29,15:00:00,114,72,42,FMN GV 11 Ramsel
66,Bergstraat 71,2018-09-29,16:00:00,110,56,54,FMN GV 11 Ramsel
66,Bergstraat 71,2018-09-29,17:00:00,52,26,26,FMN GV 11 Ramsel
66,Bergstraat 71,2018-09-29,18:00:00,54,32,22,FMN GV 11 Ramsel
66,Bergstraat 71,2018-09-29,19:00:00,42,28,14,FMN GV 11 Ramsel
66,Bergstraat 71,2018-09-29,20:00:00,16,10,6,FMN GV 11 Ramsel
66,Bergstraat 71,2018-09-29,21:00:00,6,2,4,FMN GV 11 Ramsel
66,Bergstraat 71,2018-09-29,22:00:00,10,6,4,FMN GV 11 Ramsel
66,Bergstraat 71,2018-09-29,23:00:00,2,0,2,FMN GV 11 Ramsel
66,Bergstraat 71,2018-09-30,00:00:00,4,0,4,FMN GV 11 Ramsel
66,Bergstraat 71,2018-09-30,01:00:00,2,2,0,FMN GV 11 Ramsel
66,Bergstraat 71,2018-09-30,02:00:00,2,2,0,FMN GV 11 Ramsel
66,Bergstraat 71,2018-09-30,03:00:00,4,0,4,FMN GV 11 Ramsel
66,Bergstraat 71,2018-09-30,04:00:00,2,0,2,FMN GV 11 Ramsel
66,Bergstraat 71,2018-09-30,05:00:00,0,0,0,FMN GV 11 Ramsel
66,Bergstraat 71,2018-09-30,06:00:00,4,2,2,FMN GV 11 Ramsel
66,Bergstraat 71,2018-09-30,07:00:00,22,14,8,FMN GV 11 Ramsel
66,Bergstraat 71,2018-09-30,08:00:00,84,10,74,FMN GV 11 Ramsel
66,Bergstraat 71,2018-09-30,09:00:00,72,20,52,FMN GV 11 Ramsel
66,Bergstraat 71,2018-09-30,10:00:00,118,80,38,FMN GV 11 Ramsel
66,Bergstraat 71,2018-09-30,11:00:00,106,50,56,FMN GV 11 Ramsel
66,Bergstraat 71,2018-09-30,12:00:00,112,58,54,FMN GV 11 Ramsel
66,Bergstraat 71,2018-09-30,13:00:00,168,72,96,FMN GV 11 Ramsel
66,Bergstraat 71,2018-09-30,14:00:00,208,66,142,FMN GV 11 Ramsel
66,Bergstraat 71,2018-09-30,15:00:00,134,76,58,FMN GV 11 Ramsel
66,Bergstraat 71,2018-09-30,16:00:00,126,68,58,FMN GV 11 Ramsel
66,Bergstraat 71,2018-09-30,17:00:00,52,16,36,FMN GV 11 Ramsel
66,Bergstraat 71,2018-09-30,18:00:00,44,34,10,FMN GV 11 Ramsel
66,Bergstraat 71,2018-09-30,19:00:00,22,18,4,FMN GV 11 Ramsel
66,Bergstraat 71,2018-09-30,20:00:00,6,4,2,FMN GV 11 Ramsel
66,Bergstraat 71,2018-09-30,21:00:00,0,0,0,FMN GV 11 Ramsel
66,Bergstraat 71,2018-09-30,22:00:00,2,2,0,FMN GV 11 Ramsel
66,Bergstraat 71,2018-09-30,23:00:00,0,0,0,FMN GV 11 Ramsel
66,Bergstraat 71,2018-10-01,00:00:00,0,0,0,FMN GV 11 Ramsel
66,Bergstraat 71,2018-10-01,01:00:00,0,0,0,FMN GV 11 Ramsel
66,Bergstraat 71,2018-10-01,02:00:00,0,0,0,FMN GV 11 Ramsel
66,Bergstraat 71,2018-10-01,03:00:00,0,0,0,FMN GV 11 Ramsel
66,Bergstraat 71,2018-10-01,04:00:00,2,2,0,FMN GV 11 Ramsel
66,Bergstraat 71,2018-10-01,05:00:00,2,2,0,FMN GV 11 Ramsel
66,Bergstraat 71,2018-10-01,06:00:00,32,14,18,FMN GV 11 Ramsel
66,Bergstraat 71,2018-10-01,07:00:00,154,20,134,FMN GV 11 Ramsel
66,Bergstraat 71,2018-10-01,08:00:00,136,18,118,FMN GV 11 Ramsel
66,Bergstraat 71,2018-10-01,09:00:00,116,86,30,FMN GV 11 Ramsel
66,Bergstraat 71,2018-10-01,10:00:00,28,14,14,FMN GV 11 Ramsel
66,Bergstraat 71,2018-10-01,11:00:00,24,12,12,FMN GV 11 Ramsel
66,Bergstraat 71,2018-10-01,12:00:00,22,12,10,FMN GV 11 Ramsel
66,Bergstraat 71,2018-10-01,13:00:00,52,30,22,FMN GV 11 Ramsel
66,Bergstraat 71,2018-10-01,14:00:00,42,18,24,FMN GV 11 Ramsel
66,Bergstraat 71,2018-10-01,15:00:00,148,126,22,FMN GV 11 Ramsel
66,Bergstraat 71,2018-10-01,16:00:00,104,86,18,FMN GV 11 Ramsel
66,Bergstraat 71,2018-10-01,17:00:00,54,34,20,FMN GV 11 Ramsel
66,Bergstraat 71,2018-10-01,18:00:00,40,32,8,FMN GV 11 Ramsel
66,Bergstraat 71,2018-10-01,19:00:00,12,6,6,FMN GV 11 Ramsel
66,Bergstraat 71,2018-10-01,20:00:00,22,12,10,FMN GV 11 Ramsel
66,Bergstraat 71,2018-10-01,21:00:00,2,0,2,FMN GV 11 Ramsel
66,Bergstraat 71,2018-10-01,22:00:00,8,8,0,FMN GV 11 Ramsel
66,Bergstraat 71,2018-10-01,23:00:00,2,2,0,FMN GV 11 Ramsel
66,Bergstraat 71,2018-10-02,00:00:00,0,0,0,FMN GV 11 Ramsel
66,Bergstraat 71,2018-10-02,01:00:00,0,0,0,FMN GV 11 Ramsel
66,Bergstraat 71,2018-10-02,02:00:00,0,0,0,FMN GV 11 Ramsel
66,Bergstraat 71,2018-10-02,03:00:00,0,0,0,FMN GV 11 Ramsel
66,Bergstraat 71,2018-10-02,04:00:00,2,2,0,FMN GV 11 Ramsel
66,Bergstraat 71,2018-10-02,05:00:00,12,2,10,FMN GV 11 Ramsel
66,Bergstraat 71,2018-10-02,06:00:00,28,12,16,FMN GV 11 Ramsel
66,Bergstraat 71,2018-10-02,07:00:00,186,18,168,FMN GV 11 Ramsel
66,Bergstraat 71,2018-10-02,08:00:00,156,26,130,FMN GV 11 Ramsel
66,Bergstraat 71,2018-10-02,09:00:00,38,10,28,FMN GV 11 Ramsel
66,Bergstraat 71,2018-10-02,10:00:00,14,8,6,FMN GV 11 Ramsel
66,Bergstraat 71,2018-10-02,11:00:00,20,8,12,FMN GV 11 Ramsel
66,Bergstraat 71,2018-10-02,12:00:00,12,10,2,FMN GV 11 Ramsel
66,Bergstraat 71,2018-10-02,13:00:00,48,30,18,FMN GV 11 Ramsel
66,Bergstraat 71,2018-10-02,14:00:00,40,24,16,FMN GV 11 Ramsel
66,Bergstraat 71,2018-10-02,15:00:00,210,190,20,FMN GV 11 Ramsel
66,Bergstraat 71,2018-10-02,16:00:00,108,72,36,FMN GV 11 Ramsel
66,Bergstraat 71,2018-10-02,17:00:00,82,40,42,FMN GV 11 Ramsel
66,Bergstraat 71,2018-10-02,18:00:00,52,38,14,FMN GV 11 Ramsel
66,Bergstraat 71,2018-10-02,19:00:00,52,24,28,FMN GV 11 Ramsel
66,Bergstraat 71,2018-10-02,20:00:00,24,22,2,FMN GV 11 Ramsel
66,Bergstraat 71,2018-10-02,21:00:00,10,6,4,FMN GV 11 Ramsel
66,Bergstraat 71,2018-10-02,22:00:00,6,4,2,FMN GV 11 Ramsel
66,Bergstraat 71,2018-10-02,23:00:00,6,6,0,FMN GV 11 Ramsel
66,Bergstraat 71,2018-10-03,00:00:00,2,2,0,FMN GV 11 Ramsel
66,Bergstraat 71,2018-10-03,01:00:00,0,0,0,FMN GV 11 Ramsel
66,Bergstraat 71,2018-10-03,02:00:00,0,0,0,FMN GV 11 Ramsel
66,Bergstraat 71,2018-10-03,03:00:00,0,0,0,FMN GV 11 Ramsel
66,Bergstraat 71,2018-10-03,04:00:00,4,2,2,FMN GV 11 Ramsel
66,Bergstraat 71,2018-10-03,05:00:00,8,2,6,FMN GV 11 Ramsel
66,Bergstraat 71,2018-10-03,06:00:00,34,10,24,FMN GV 11 Ramsel
66,Bergstraat 71,2018-10-03,07:00:00,110,28,82,FMN GV 11 Ramsel
66,Bergstraat 71,2018-10-03,08:00:00,66,8,58,FMN GV 11 Ramsel
66,Bergstraat 71,2018-10-03,09:00:00,20,14,6,FMN GV 11 Ramsel
66,Bergstraat 71,2018-10-03,10:00:00,54,24,30,FMN GV 11 Ramsel
66,Bergstraat 71,2018-10-03,11:00:00,56,34,22,FMN GV 11 Ramsel
66,Bergstraat 71,2018-10-03,12:00:00,132,86,46,FMN GV 11 Ramsel
66,Bergstraat 71,2018-10-03,13:00:00,84,36,48,FMN GV 11 Ramsel
66,Bergstraat 71,2018-10-03,14:00:00,138,68,70,FMN GV 11 Ramsel
66,Bergstraat 71,2018-10-03,15:00:00,94,48,46,FMN GV 11 Ramsel
66,Bergstraat 71,2018-10-03,16:00:00,104,64,40,FMN GV 11 Ramsel
66,Bergstraat 71,2018-10-03,17:00:00,120,58,62,FMN GV 11 Ramsel
66,Bergstraat 71,2018-10-03,18:00:00,82,48,34,FMN GV 11 Ramsel
66,Bergstraat 71,2018-10-03,19:00:00,34,22,12,FMN GV 11 Ramsel
66,Bergstraat 71,2018-10-03,20:00:00,14,12,2,FMN GV 11 Ramsel
66,Bergstraat 71,2018-10-03,21:00:00,2,2,0,FMN GV 11 Ramsel
66,Bergstraat 71,2018-10-03,22:00:00,14,10,4,FMN GV 11 Ramsel
66,Bergstraat 71,2018-10-03,23:00:00,2,2,0,FMN GV 11 Ramsel
66,Bergstraat 71,2018-10-04,00:00:00,2,2,0,FMN GV 11 Ramsel
66,Bergstraat 71,2018-10-04,01:00:00,0,0,0,FMN GV 11 Ramsel
66,Bergstraat 71,2018-10-04,02:00:00,0,0,0,FMN GV 11 Ramsel
66,Bergstraat 71,2018-10-04,03:00:00,0,0,0,FMN GV 11 Ramsel
66,Bergstraat 71,2018-10-04,04:00:00,4,2,2,FMN GV 11 Ramsel
66,Bergstraat 71,2018-10-04,05:00:00,12,6,6,FMN GV 11 Ramsel
66,Bergstraat 71,2018-10-04,06:00:00,36,10,26,FMN GV 11 Ramsel
66,Bergstraat 71,2018-10-04,07:00:00,208,26,182,FMN GV 11 Ramsel
66,Bergstraat 71,2018-10-04,08:00:00,176,38,138,FMN GV 11 Ramsel
66,Bergstraat 71,2018-10-04,09:00:00,34,8,26,FMN GV 11 Ramsel
66,Bergstraat 71,2018-10-04,10:00:00,60,18,42,FMN GV 11 Ramsel
66,Bergstraat 71,2018-10-04,11:00:00,42,22,20,FMN GV 11 Ramsel
66,Bergstraat 71,2018-10-04,12:00:00,98,40,58,FMN GV 11 Ramsel
66,Bergstraat 71,2018-10-04,13:00:00,158,52,106,FMN GV 11 Ramsel
66,Bergstraat 71,2018-10-04,14:00:00,186,96,90,FMN GV 11 Ramsel
66,Bergstraat 71,2018-10-04,15:00:00,320,250,70,FMN GV 11 Ramsel
66,Bergstraat 71,2018-10-04,16:00:00,264,184,80,FMN GV 11 Ramsel
66,Bergstraat 71,2018-10-04,17:00:00,130,74,56,FMN GV 11 Ramsel
66,Bergstraat 71,2018-10-04,18:00:00,104,68,36,FMN GV 11 Ramsel
66,Bergstraat 71,2018-10-04,19:00:00,44,20,24,FMN GV 11 Ramsel
66,Bergstraat 71,2018-10-04,20:00:00,18,16,2,FMN GV 11 Ramsel
66,Bergstraat 71,2018-10-04,21:00:00,14,8,6,FMN GV 11 Ramsel
66,Bergstraat 71,2018-10-04,22:00:00,10,6,4,FMN GV 11 Ramsel
66,Bergstraat 71,2018-10-04,23:00:00,2,2,0,FMN GV 11 Ramsel
66,Bergstraat 71,2018-10-05,00:00:00,0,0,0,FMN GV 11 Ramsel
66,Bergstraat 71,2018-10-05,01:00:00,0,0,0,FMN GV 11 Ramsel
66,Bergstraat 71,2018-10-05,02:00:00,0,0,0,FMN GV 11 Ramsel
66,Bergstraat 71,2018-10-05,03:00:00,0,0,0,FMN GV 11 Ramsel
66,Bergstraat 71,2018-10-05,04:00:00,2,2,0,FMN GV 11 Ramsel
66,Bergstraat 71,2018-10-05,05:00:00,6,2,4,FMN GV 11 Ramsel
66,Bergstraat 71,2018-10-05,06:00:00,26,8,18,FMN GV 11 Ramsel
66,Bergstraat 71,2018-10-05,07:00:00,176,32,144,FMN GV 11 Ramsel
66,Bergstraat 71,2018-10-05,08:00:00,152,22,130,FMN GV 11 Ramsel
66,Bergstraat 71,2018-10-05,09:00:00,54,28,26,FMN GV 11 Ramsel
66,Bergstraat 71,2018-10-05,10:00:00,78,32,46,FMN GV 11 Ramsel
66,Bergstraat 71,2018-10-05,11:00:00,80,38,42,FMN GV 11 Ramsel
66,Bergstraat 71,2018-10-05,12:00:00,104,40,64,FMN GV 11 Ramsel
66,Bergstraat 71,2018-10-05,13:00:00,162,80,82,FMN GV 11 Ramsel
66,Bergstraat 71,2018-10-05,14:00:00,284,100,184,FMN GV 11 Ramsel
66,Bergstraat 71,2018-10-05,15:00:00,302,200,102,FMN GV 11 Ramsel
66,Bergstraat 71,2018-10-05,16:00:00,202,140,62,FMN GV 11 Ramsel
66,Bergstraat 71,2018-10-05,17:00:00,118,78,40,FMN GV 11 Ramsel
66,Bergstraat 71,2018-10-05,18:00:00,84,54,30,FMN GV 11 Ramsel
66,Bergstraat 71,2018-10-05,19:00:00,22,12,10,FMN GV 11 Ramsel
66,Bergstraat 71,2018-10-05,20:00:00,26,10,16,FMN GV 11 Ramsel
66,Bergstraat 71,2018-10-05,21:00:00,6,0,6,FMN GV 11 Ramsel
66,Bergstraat 71,2018-10-05,22:00:00,20,10,10,FMN GV 11 Ramsel
66,Bergstraat 71,2018-10-05,23:00:00,0,0,0,FMN GV 11 Ramsel
66,Bergstraat 71,2018-10-06,00:00:00,10,4,6,FMN GV 11 Ramsel
66,Bergstraat 71,2018-10-06,01:00:00,6,4,2,FMN GV 11 Ramsel
66,Bergstraat 71,2018-10-06,02:00:00,8,8,0,FMN GV 11 Ramsel
66,Bergstraat 71,2018-10-06,03:00:00,6,4,2,FMN GV 11 Ramsel
66,Bergstraat 71,2018-10-06,04:00:00,2,2,0,FMN GV 11 Ramsel
66,Bergstraat 71,2018-10-06,05:00:00,8,2,6,FMN GV 11 Ramsel
66,Bergstraat 71,2018-10-06,06:00:00,2,2,0,FMN GV 11 Ramsel
66,Bergstraat 71,2018-10-06,07:00:00,6,4,2,FMN GV 11 Ramsel
66,Bergstraat 71,2018-10-06,08:00:00,26,8,18,FMN GV 11 Ramsel
66,Bergstraat 71,2018-10-06,09:00:00,72,22,50,FMN GV 11 Ramsel
66,Bergstraat 71,2018-10-06,10:00:00,86,38,48,FMN GV 11 Ramsel
66,Bergstraat 71,2018-10-06,11:00:00,118,56,62,FMN GV 11 Ramsel
66,Bergstraat 71,2018-10-06,12:00:00,150,66,84,FMN GV 11 Ramsel
66,Bergstraat 71,2018-10-06,13:00:00,284,138,146,FMN GV 11 Ramsel
66,Bergstraat 71,2018-10-06,14:00:00,264,142,122,FMN GV 11 Ramsel
66,Bergstraat 71,2018-10-06,15:00:00,204,100,104,FMN GV 11 Ramsel
66,Bergstraat 71,2018-10-06,16:00:00,182,104,78,FMN GV 11 Ramsel
66,Bergstraat 71,2018-10-06,17:00:00,100,48,52,FMN GV 11 Ramsel
66,Bergstraat 71,2018-10-06,18:00:00,70,44,26,FMN GV 11 Ramsel
66,Bergstraat 71,2018-10-06,19:00:00,34,16,18,FMN GV 11 Ramsel
66,Bergstraat 71,2018-10-06,20:00:00,8,2,6,FMN GV 11 Ramsel
66,Bergstraat 71,2018-10-06,21:00:00,6,2,4,FMN GV 11 Ramsel
66,Bergstraat 71,2018-10-06,22:00:00,8,4,4,FMN GV 11 Ramsel
66,Bergstraat 71,2018-10-06,23:00:00,6,6,0,FMN GV 11 Ramsel
66,Bergstraat 71,2018-10-07,00:00:00,4,2,2,FMN GV 11 Ramsel
66,Bergstraat 71,2018-10-07,01:00:00,0,0,0,FMN GV 11 Ramsel
66,Bergstraat 71,2018-10-07,02:00:00,2,2,0,FMN GV 11 Ramsel
66,Bergstraat 71,2018-10-07,03:00:00,0,0,0,FMN GV 11 Ramsel
66,Bergstraat 71,2018-10-07,04:00:00,0,0,0,FMN GV 11 Ramsel
66,Bergstraat 71,2018-10-07,05:00:00,0,0,0,FMN GV 11 Ramsel
66,Bergstraat 71,2018-10-07,06:00:00,6,4,2,FMN GV 11 Ramsel
66,Bergstraat 71,2018-10-07,07:00:00,6,2,4,FMN GV 11 Ramsel
66,Bergstraat 71,2018-10-07,08:00:00,46,24,22,FMN GV 11 Ramsel
66,Bergstraat 71,2018-10-07,09:00:00,30,12,18,FMN GV 11 Ramsel
66,Bergstraat 71,2018-10-07,10:00:00,52,28,24,FMN GV 11 Ramsel
66,Bergstraat 71,2018-10-07,11:00:00,62,36,26,FMN GV 11 Ramsel
66,Bergstraat 71,2018-10-07,12:00:00,44,14,30,FMN GV 11 Ramsel
66,Bergstraat 71,2018-10-07,13:00:00,104,40,64,FMN GV 11 Ramsel
66,Bergstraat 71,2018-10-07,14:00:00,126,58,68,FMN GV 11 Ramsel
66,Bergstraat 71,2018-10-07,15:00:00,112,48,64,FMN GV 11 Ramsel
66,Bergstraat 71,2018-10-07,16:00:00,108,50,58,FMN GV 11 Ramsel
66,Bergstraat 71,2018-10-07,17:00:00,72,28,44,FMN GV 11 Ramsel
66,Bergstraat 71,2018-10-07,18:00:00,22,12,10,FMN GV 11 Ramsel
66,Bergstraat 71,2018-10-07,19:00:00,22,12,10,FMN GV 11 Ramsel
66,Bergstraat 71,2018-10-07,20:00:00,12,6,6,FMN GV 11 Ramsel
66,Bergstraat 71,2018-10-07,21:00:00,10,6,4,FMN GV 11 Ramsel
66,Bergstraat 71,2018-10-07,22:00:00,2,2,0,FMN GV 11 Ramsel
66,Bergstraat 71,2018-10-07,23:00:00,2,2,0,FMN GV 11 Ramsel
66,Bergstraat 71,2018-10-08,00:00:00,0,0,0,FMN GV 11 Ramsel
66,Bergstraat 71,2018-10-08,01:00:00,2,2,0,FMN GV 11 Ramsel
66,Bergstraat 71,2018-10-08,02:00:00,0,0,0,FMN GV 11 Ramsel
66,Bergstraat 71,2018-10-08,03:00:00,0,0,0,FMN GV 11 Ramsel
66,Bergstraat 71,2018-10-08,04:00:00,2,2,0,FMN GV 11 Ramsel
66,Bergstraat 71,2018-10-08,05:00:00,4,4,0,FMN GV 11 Ramsel
66,Bergstraat 71,2018-10-08,06:00:00,36,12,24,FMN GV 11 Ramsel
66,Bergstraat 71,2018-10-08,07:00:00,190,40,150,FMN GV 11 Ramsel
66,Bergstraat 71,2018-10-08,08:00:00,182,22,160,FMN GV 11 Ramsel
66,Bergstraat 71,2018-10-08,09:00:00,40,6,34,FMN GV 11 Ramsel
66,Bergstraat 71,2018-10-08,10:00:00,40,20,20,FMN GV 11 Ramsel
66,Bergstraat 71,2018-10-08,11:00:00,34,14,20,FMN GV 11 Ramsel
66,Bergstraat 71,2018-10-08,12:00:00,110,58,52,FMN GV 11 Ramsel
66,Bergstraat 71,2018-10-08,13:00:00,152,54,98,FMN GV 11 Ramsel
66,Bergstraat 71,2018-10-08,14:00:00,130,76,54,FMN GV 11 Ramsel
66,Bergstraat 71,2018-10-08,15:00:00,262,214,48,FMN GV 11 Ramsel
66,Bergstraat 71,2018-10-08,16:00:00,212,170,42,FMN GV 11 Ramsel
66,Bergstraat 71,2018-10-08,17:00:00,98,62,36,FMN GV 11 Ramsel
66,Bergstraat 71,2018-10-08,18:00:00,90,52,38,FMN GV 11 Ramsel
66,Bergstraat 71,2018-10-08,19:00:00,34,14,20,FMN GV 11 Ramsel
66,Bergstraat 71,2018-10-08,20:00:00,22,10,12,FMN GV 11 Ramsel
66,Bergstraat 71,2018-10-08,21:00:00,18,16,2,FMN GV 11 Ramsel
66,Bergstraat 71,2018-10-08,22:00:00,6,4,2,FMN GV 11 Ramsel
66,Bergstraat 71,2018-10-08,23:00:00,2,2,0,FMN GV 11 Ramsel
66,Bergstraat 71,2018-10-09,00:00:00,2,2,0,FMN GV 11 Ramsel
66,Bergstraat 71,2018-10-09,01:00:00,0,0,0,FMN GV 11 Ramsel
66,Bergstraat 71,2018-10-09,02:00:00,0,0,0,FMN GV 11 Ramsel
66,Bergstraat 71,2018-10-09,03:00:00,0,0,0,FMN GV 11 Ramsel
66,Bergstraat 71,2018-10-09,04:00:00,4,2,2,FMN GV 11 Ramsel
66,Bergstraat 71,2018-10-09,05:00:00,6,2,4,FMN GV 11 Ramsel
66,Bergstraat 71,2018-10-09,06:00:00,38,12,26,FMN GV 11 Ramsel
66,Bergstraat 71,2018-10-09,07:00:00,198,44,154,FMN GV 11 Ramsel
66,Bergstraat 71,2018-10-09,08:00:00,170,20,150,FMN GV 11 Ramsel
66,Bergstraat 71,2018-10-09,09:00:00,62,26,36,FMN GV 11 Ramsel
66,Bergstraat 71,2018-10-09,10:00:00,20,14,6,FMN GV 11 Ramsel
66,Bergstraat 71,2018-10-09,11:00:00,90,32,58,FMN GV 11 Ramsel
66,Bergstraat 71,2018-10-09,12:00:00,98,46,52,FMN GV 11 Ramsel
66,Bergstraat 71,2018-10-09,13:00:00,198,88,110,FMN GV 11 Ramsel
66,Bergstraat 71,2018-10-09,14:00:00,152,78,74,FMN GV 11 Ramsel
66,Bergstraat 71,2018-10-09,15:00:00,266,206,60,FMN GV 11 Ramsel
66,Bergstraat 71,2018-10-09,16:00:00,226,158,68,FMN GV 11 Ramsel
66,Bergstraat 71,2018-10-09,17:00:00,142,92,50,FMN GV 11 Ramsel
66,Bergstraat 71,2018-10-09,18:00:00,96,58,38,FMN GV 11 Ramsel
66,Bergstraat 71,2018-10-09,19:00:00,52,20,32,FMN GV 11 Ramsel
66,Bergstraat 71,2018-10-09,20:00:00,36,26,10,FMN GV 11 Ramsel
66,Bergstraat 71,2018-10-09,21:00:00,8,8,0,FMN GV 11 Ramsel
66,Bergstraat 71,2018-10-09,22:00:00,12,12,0,FMN GV 11 Ramsel
66,Bergstraat 71,2018-10-09,23:00:00,0,0,0,FMN GV 11 Ramsel
66,Bergstraat 71,2018-10-10,00:00:00,2,2,0,FMN GV 11 Ramsel
66,Bergstraat 71,2018-10-10,01:00:00,0,0,0,FMN GV 11 Ramsel
66,Bergstraat 71,2018-10-10,02:00:00,0,0,0,FMN GV 11 Ramsel
66,Bergstraat 71,2018-10-10,03:00:00,2,0,2,FMN GV 11 Ramsel
66,Bergstraat 71,2018-10-10,04:00:00,2,2,0,FMN GV 11 Ramsel
66,Bergstraat 71,2018-10-10,05:00:00,6,6,0,FMN GV 11 Ramsel
66,Bergstraat 71,2018-10-10,06:00:00,46,12,34,FMN GV 11 Ramsel
66,Bergstraat 71,2018-10-10,07:00:00,190,36,154,FMN GV 11 Ramsel
66,Bergstraat 71,2018-10-10,08:00:00,152,36,116,FMN GV 11 Ramsel
66,Bergstraat 71,2018-10-10,09:00:00,44,16,28,FMN GV 11 Ramsel
66,Bergstraat 71,2018-10-10,10:00:00,82,44,38,FMN GV 11 Ramsel
66,Bergstraat 71,2018-10-10,11:00:00,80,52,28,FMN GV 11 Ramsel
66,Bergstraat 71,2018-10-10,12:00:00,270,194,76,FMN GV 11 Ramsel
66,Bergstraat 71,2018-10-10,13:00:00,178,84,94,FMN GV 11 Ramsel
66,Bergstraat 71,2018-10-10,14:00:00,242,110,132,FMN GV 11 Ramsel
66,Bergstraat 71,2018-10-10,15:00:00,158,74,84,FMN GV 11 Ramsel
66,Bergstraat 71,2018-10-10,16:00:00,188,130,58,FMN GV 11 Ramsel
66,Bergstraat 71,2018-10-10,17:00:00,150,94,56,FMN GV 11 Ramsel
66,Bergstraat 71,2018-10-10,18:00:00,88,48,40,FMN GV 11 Ramsel
66,Bergstraat 71,2018-10-10,19:00:00,66,50,16,FMN GV 11 Ramsel
66,Bergstraat 71,2018-10-10,20:00:00,22,18,4,FMN GV 11 Ramsel
66,Bergstraat 71,2018-10-10,21:00:00,8,4,4,FMN GV 11 Ramsel
66,Bergstraat 71,2018-10-10,22:00:00,16,10,6,FMN GV 11 Ramsel
66,Bergstraat 71,2018-10-10,23:00:00,0,0,0,FMN GV 11 Ramsel
66,Bergstraat 71,2018-10-11,00:00:00,0,0,0,FMN GV 11 Ramsel
66,Bergstraat 71,2018-10-11,01:00:00,0,0,0,FMN GV 11 Ramsel
66,Bergstraat 71,2018-10-11,02:00:00,0,0,0,FMN GV 11 Ramsel
66,Bergstraat 71,2018-10-11,03:00:00,0,0,0,FMN GV 11 Ramsel
66,Bergstraat 71,2018-10-11,04:00:00,4,2,2,FMN GV 11 Ramsel
66,Bergstraat 71,2018-10-11,05:00:00,10,4,6,FMN GV 11 Ramsel
66,Bergstraat 71,2018-10-11,06:00:00,36,2,34,FMN GV 11 Ramsel
66,Bergstraat 71,2018-10-11,07:00:00,210,40,170,FMN GV 11 Ramsel
66,Bergstraat 71,2018-10-11,08:00:00,180,24,156,FMN GV 11 Ramsel
66,Bergstraat 71,2018-10-11,09:00:00,44,14,30,FMN GV 11 Ramsel
66,Bergstraat 71,2018-10-11,10:00:00,30,10,20,FMN GV 11 Ramsel
66,Bergstraat 71,2018-10-11,11:00:00,36,30,6,FMN GV 11 Ramsel
66,Bergstraat 71,2018-10-11,12:00:00,76,40,36,FMN GV 11 Ramsel
66,Bergstraat 71,2018-10-11,13:00:00,86,46,40,FMN GV 11 Ramsel
66,Bergstraat 71,2018-10-11,14:00:00,176,86,90,FMN GV 11 Ramsel
66,Bergstraat 71,2018-10-11,15:00:00,292,222,70,FMN GV 11 Ramsel
66,Bergstraat 71,2018-10-11,16:00:00,232,168,64,FMN GV 11 Ramsel
66,Bergstraat 71,2018-10-11,17:00:00,174,98,76,FMN GV 11 Ramsel
66,Bergstraat 71,2018-10-11,18:00:00,76,34,42,FMN GV 11 Ramsel
66,Bergstraat 71,2018-10-11,19:00:00,62,38,24,FMN GV 11 Ramsel
66,Bergstraat 71,2018-10-11,20:00:00,44,36,8,FMN GV 11 Ramsel
66,Bergstraat 71,2018-10-11,21:00:00,10,10,0,FMN GV 11 Ramsel
66,Bergstraat 71,2018-10-11,22:00:00,8,8,0,FMN GV 11 Ramsel
66,Bergstraat 71,2018-10-11,23:00:00,0,0,0,FMN GV 11 Ramsel
66,Bergstraat 71,2018-10-12,00:00:00,6,2,4,FMN GV 11 Ramsel
66,Bergstraat 71,2018-10-12,01:00:00,0,0,0,FMN GV 11 Ramsel
66,Bergstraat 71,2018-10-12,02:00:00,0,0,0,FMN GV 11 Ramsel
66,Bergstraat 71,2018-10-12,03:00:00,4,4,0,FMN GV 11 Ramsel
66,Bergstraat 71,2018-10-12,04:00:00,2,2,0,FMN GV 11 Ramsel
66,Bergstraat 71,2018-10-12,05:00:00,8,2,6,FMN GV 11 Ramsel
66,Bergstraat 71,2018-10-12,06:00:00,46,8,38,FMN GV 11 Ramsel
66,Bergstraat 71,2018-10-12,07:00:00,182,22,160,FMN GV 11 Ramsel
66,Bergstraat 71,2018-10-12,08:00:00,162,26,136,FMN GV 11 Ramsel
66,Bergstraat 71,2018-10-12,09:00:00,54,18,36,FMN GV 11 Ramsel
66,Bergstraat 71,2018-10-12,10:00:00,64,26,38,FMN GV 11 Ramsel
66,Bergstraat 71,2018-10-12,11:00:00,56,26,30,FMN GV 11 Ramsel
66,Bergstraat 71,2018-10-12,12:00:00,90,30,60,FMN GV 11 Ramsel
66,Bergstraat 71,2018-10-12,13:00:00,134,66,68,FMN GV 11 Ramsel
66,Bergstraat 71,2018-10-12,14:00:00,182,94,88,FMN GV 11 Ramsel
66,Bergstraat 71,2018-10-12,15:00:00,326,232,94,FMN GV 11 Ramsel
66,Bergstraat 71,2018-10-12,16:00:00,164,118,46,FMN GV 11 Ramsel
66,Bergstraat 71,2018-10-12,17:00:00,122,70,52,FMN GV 11 Ramsel
66,Bergstraat 71,2018-10-12,18:00:00,72,48,24,FMN GV 11 Ramsel
66,Bergstraat 71,2018-10-12,19:00:00,48,24,24,FMN GV 11 Ramsel
66,Bergstraat 71,2018-10-12,20:00:00,22,4,18,FMN GV 11 Ramsel
66,Bergstraat 71,2018-10-12,21:00:00,20,8,12,FMN GV 11 Ramsel
66,Bergstraat 71,2018-10-12,22:00:00,20,8,12,FMN GV 11 Ramsel
66,Bergstraat 71,2018-10-12,23:00:00,4,0,4,FMN GV 11 Ramsel
66,Bergstraat 71,2018-10-13,00:00:00,6,4,2,FMN GV 11 Ramsel
66,Bergstraat 71,2018-10-13,01:00:00,8,8,0,FMN GV 11 Ramsel
66,Bergstraat 71,2018-10-13,02:00:00,8,8,0,FMN GV 11 Ramsel
66,Bergstraat 71,2018-10-13,03:00:00,12,12,0,FMN GV 11 Ramsel
66,Bergstraat 71,2018-10-13,04:00:00,0,0,0,FMN GV 11 Ramsel
66,Bergstraat 71,2018-10-13,05:00:00,2,0,2,FMN GV 11 Ramsel
66,Bergstraat 71,2018-10-13,06:00:00,4,2,2,FMN GV 11 Ramsel
66,Bergstraat 71,2018-10-13,07:00:00,6,2,4,FMN GV 11 Ramsel
66,Bergstraat 71,2018-10-13,08:00:00,36,12,24,FMN GV 11 Ramsel
66,Bergstraat 71,2018-10-13,09:00:00,108,24,84,FMN GV 11 Ramsel
66,Bergstraat 71,2018-10-13,10:00:00,136,58,78,FMN GV 11 Ramsel
66,Bergstraat 71,2018-10-13,11:00:00,140,70,70,FMN GV 11 Ramsel
66,Bergstraat 71,2018-10-13,12:00:00,134,54,80,FMN GV 11 Ramsel
66,Bergstraat 71,2018-10-13,13:00:00,318,128,190,FMN GV 11 Ramsel
66,Bergstraat 71,2018-10-13,14:00:00,332,170,162,FMN GV 11 Ramsel
66,Bergstraat 71,2018-10-13,15:00:00,290,158,132,FMN GV 11 Ramsel
66,Bergstraat 71,2018-10-13,16:00:00,254,158,96,FMN GV 11 Ramsel
66,Bergstraat 71,2018-10-13,17:00:00,162,98,64,FMN GV 11 Ramsel
66,Bergstraat 71,2018-10-13,18:00:00,60,42,18,FMN GV 11 Ramsel
66,Bergstraat 71,2018-10-13,19:00:00,74,44,30,FMN GV 11 Ramsel
66,Bergstraat 71,2018-10-13,20:00:00,14,8,6,FMN GV 11 Ramsel
66,Bergstraat 71,2018-10-13,21:00:00,6,2,4,FMN GV 11 Ramsel
66,Bergstraat 71,2018-10-13,22:00:00,14,6,8,FMN GV 11 Ramsel
66,Bergstraat 71,2018-10-13,23:00:00,14,12,2,FMN GV 11 Ramsel
66,Bergstraat 71,2018-10-14,00:00:00,12,12,0,FMN GV 11 Ramsel
66,Bergstraat 71,2018-10-14,01:00:00,26,20,6,FMN GV 11 Ramsel
66,Bergstraat 71,2018-10-14,02:00:00,4,0,4,FMN GV 11 Ramsel
66,Bergstraat 71,2018-10-14,03:00:00,4,4,0,FMN GV 11 Ramsel
66,Bergstraat 71,2018-10-14,04:00:00,18,6,12,FMN GV 11 Ramsel
66,Bergstraat 71,2018-10-14,05:00:00,6,6,0,FMN GV 11 Ramsel
66,Bergstraat 71,2018-10-14,06:00:00,4,2,2,FMN GV 11 Ramsel
66,Bergstraat 71,2018-10-14,07:00:00,8,6,2,FMN GV 11 Ramsel
66,Bergstraat 71,2018-10-14,08:00:00,72,22,50,FMN GV 11 Ramsel
66,Bergstraat 71,2018-10-14,09:00:00,108,54,54,FMN GV 11 Ramsel
66,Bergstraat 71,2018-10-14,10:00:00,210,98,112,FMN GV 11 Ramsel
66,Bergstraat 71,2018-10-14,11:00:00,202,140,62,FMN GV 11 Ramsel
66,Bergstraat 71,2018-10-14,12:00:00,194,116,78,FMN GV 11 Ramsel
66,Bergstraat 71,2018-10-14,13:00:00,226,102,124,FMN GV 11 Ramsel
66,Bergstraat 71,2018-10-14,14:00:00,212,96,116,FMN GV 11 Ramsel
66,Bergstraat 71,2018-10-14,15:00:00,202,102,100,FMN GV 11 Ramsel
66,Bergstraat 71,2018-10-14,16:00:00,124,64,60,FMN GV 11 Ramsel
66,Bergstraat 71,2018-10-14,17:00:00,92,46,46,FMN GV 11 Ramsel
66,Bergstraat 71,2018-10-14,18:00:00,60,32,28,FMN GV 11 Ramsel
66,Bergstraat 71,2018-10-14,19:00:00,20,12,8,FMN GV 11 Ramsel
66,Bergstraat 71,2018-10-14,20:00:00,4,4,0,FMN GV 11 Ramsel
66,Bergstraat 71,2018-10-14,21:00:00,2,0,2,FMN GV 11 Ramsel
66,Bergstraat 71,2018-10-14,22:00:00,2,0,2,FMN GV 11 Ramsel
66,Bergstraat 71,2018-10-14,23:00:00,0,0,0,FMN GV 11 Ramsel
66,Bergstraat 71,2018-10-15,00:00:00,0,0,0,FMN GV 11 Ramsel
66,Bergstraat 71,2018-10-15,01:00:00,0,0,0,FMN GV 11 Ramsel
66,Bergstraat 71,2018-10-15,02:00:00,0,0,0,FMN GV 11 Ramsel
66,Bergstraat 71,2018-10-15,03:00:00,4,2,2,FMN GV 11 Ramsel
66,Bergstraat 71,2018-10-15,04:00:00,4,2,2,FMN GV 11 Ramsel
66,Bergstraat 71,2018-10-15,05:00:00,10,4,6,FMN GV 11 Ramsel
66,Bergstraat 71,2018-10-15,06:00:00,34,2,32,FMN GV 11 Ramsel
66,Bergstraat 71,2018-10-15,07:00:00,200,30,170,FMN GV 11 Ramsel
66,Bergstraat 71,2018-10-15,08:00:00,180,28,152,FMN GV 11 Ramsel
66,Bergstraat 71,2018-10-15,09:00:00,60,24,36,FMN GV 11 Ramsel
66,Bergstraat 71,2018-10-15,10:00:00,38,12,26,FMN GV 11 Ramsel
66,Bergstraat 71,2018-10-15,11:00:00,42,18,24,FMN GV 11 Ramsel
66,Bergstraat 71,2018-10-15,12:00:00,62,46,16,FMN GV 11 Ramsel
66,Bergstraat 71,2018-10-15,13:00:00,124,62,62,FMN GV 11 Ramsel
66,Bergstraat 71,2018-10-15,14:00:00,208,104,104,FMN GV 11 Ramsel
66,Bergstraat 71,2018-10-15,15:00:00,308,232,76,FMN GV 11 Ramsel
66,Bergstraat 71,2018-10-15,16:00:00,194,130,64,FMN GV 11 Ramsel
66,Bergstraat 71,2018-10-15,17:00:00,104,58,46,FMN GV 11 Ramsel
66,Bergstraat 71,2018-10-15,18:00:00,88,62,26,FMN GV 11 Ramsel
66,Bergstraat 71,2018-10-15,19:00:00,44,20,24,FMN GV 11 Ramsel
66,Bergstraat 71,2018-10-15,20:00:00,14,10,4,FMN GV 11 Ramsel
66,Bergstraat 71,2018-10-15,21:00:00,20,18,2,FMN GV 11 Ramsel
66,Bergstraat 71,2018-10-15,22:00:00,12,8,4,FMN GV 11 Ramsel
66,Bergstraat 71,2018-10-15,23:00:00,0,0,0,FMN GV 11 Ramsel
66,Bergstraat 71,2018-10-16,00:00:00,0,0,0,FMN GV 11 Ramsel
66,Bergstraat 71,2018-10-16,01:00:00,0,0,0,FMN GV 11 Ramsel
66,Bergstraat 71,2018-10-16,02:00:00,0,0,0,FMN GV 11 Ramsel
66,Bergstraat 71,2018-10-16,03:00:00,0,0,0,FMN GV 11 Ramsel
66,Bergstraat 71,2018-10-16,04:00:00,4,2,2,FMN GV 11 Ramsel
66,Bergstraat 71,2018-10-16,05:00:00,14,8,6,FMN GV 11 Ramsel
66,Bergstraat 71,2018-10-16,06:00:00,42,10,32,FMN GV 11 Ramsel
66,Bergstraat 71,2018-10-16,07:00:00,208,42,166,FMN GV 11 Ramsel
66,Bergstraat 71,2018-10-16,08:00:00,170,34,136,FMN GV 11 Ramsel
66,Bergstraat 71,2018-10-16,09:00:00,62,32,30,FMN GV 11 Ramsel
66,Bergstraat 71,2018-10-16,10:00:00,54,18,36,FMN GV 11 Ramsel
66,Bergstraat 71,2018-10-16,11:00:00,66,22,44,FMN GV 11 Ramsel
66,Bergstraat 71,2018-10-16,12:00:00,116,54,62,FMN GV 11 Ramsel
66,Bergstraat 71,2018-10-16,13:00:00,200,92,108,FMN GV 11 Ramsel
66,Bergstraat 71,2018-10-16,14:00:00,228,84,144,FMN GV 11 Ramsel
66,Bergstraat 71,2018-10-16,15:00:00,412,286,126,FMN GV 11 Ramsel
66,Bergstraat 71,2018-10-16,16:00:00,246,176,70,FMN GV 11 Ramsel
66,Bergstraat 71,2018-10-16,17:00:00,152,94,58,FMN GV 11 Ramsel
66,Bergstraat 71,2018-10-16,18:00:00,120,58,62,FMN GV 11 Ramsel
66,Bergstraat 71,2018-10-16,19:00:00,92,44,48,FMN GV 11 Ramsel
66,Bergstraat 71,2018-10-16,20:00:00,30,26,4,FMN GV 11 Ramsel
66,Bergstraat 71,2018-10-16,21:00:00,12,6,6,FMN GV 11 Ramsel
66,Bergstraat 71,2018-10-16,22:00:00,8,2,6,FMN GV 11 Ramsel
66,Bergstraat 71,2018-10-16,23:00:00,2,0,2,FMN GV 11 Ramsel
66,Bergstraat 71,2018-10-17,00:00:00,0,0,0,FMN GV 11 Ramsel
66,Bergstraat 71,2018-10-17,01:00:00,0,0,0,FMN GV 11 Ramsel
66,Bergstraat 71,2018-10-17,02:00:00,0,0,0,FMN GV 11 Ramsel
66,Bergstraat 71,2018-10-17,03:00:00,0,0,0,FMN GV 11 Ramsel
66,Bergstraat 71,2018-10-17,04:00:00,4,2,2,FMN GV 11 Ramsel
66,Bergstraat 71,2018-10-17,05:00:00,6,2,4,FMN GV 11 Ramsel
66,Bergstraat 71,2018-10-17,06:00:00,36,12,24,FMN GV 11 Ramsel
66,Bergstraat 71,2018-10-17,07:00:00,190,26,164,FMN GV 11 Ramsel
66,Bergstraat 71,2018-10-17,08:00:00,172,30,142,FMN GV 11 Ramsel
66,Bergstraat 71,2018-10-17,09:00:00,40,10,30,FMN GV 11 Ramsel
66,Bergstraat 71,2018-10-17,10:00:00,76,46,30,FMN GV 11 Ramsel
66,Bergstraat 71,2018-10-17,11:00:00,66,30,36,FMN GV 11 Ramsel
66,Bergstraat 71,2018-10-17,12:00:00,288,228,60,FMN GV 11 Ramsel
66,Bergstraat 71,2018-10-17,13:00:00,168,108,60,FMN GV 11 Ramsel
66,Bergstraat 71,2018-10-17,14:00:00,214,92,122,FMN GV 11 Ramsel
66,Bergstraat 71,2018-10-17,15:00:00,156,70,86,FMN GV 11 Ramsel
66,Bergstraat 71,2018-10-17,16:00:00,166,82,84,FMN GV 11 Ramsel
66,Bergstraat 71,2018-10-17,17:00:00,142,78,64,FMN GV 11 Ramsel
66,Bergstraat 71,2018-10-17,18:00:00,106,56,50,FMN GV 11 Ramsel
66,Bergstraat 71,2018-10-17,19:00:00,52,40,12,FMN GV 11 Ramsel
66,Bergstraat 71,2018-10-17,20:00:00,24,18,6,FMN GV 11 Ramsel
66,Bergstraat 71,2018-10-17,21:00:00,6,2,4,FMN GV 11 Ramsel
66,Bergstraat 71,2018-10-17,22:00:00,14,12,2,FMN GV 11 Ramsel
66,Bergstraat 71,2018-10-17,23:00:00,0,0,0,FMN GV 11 Ramsel
66,Bergstraat 71,2018-10-18,00:00:00,6,6,0,FMN GV 11 Ramsel
66,Bergstraat 71,2018-10-18,01:00:00,2,2,0,FMN GV 11 Ramsel
66,Bergstraat 71,2018-10-18,02:00:00,0,0,0,FMN GV 11 Ramsel
66,Bergstraat 71,2018-10-18,03:00:00,0,0,0,FMN GV 11 Ramsel
66,Bergstraat 71,2018-10-18,04:00:00,2,0,2,FMN GV 11 Ramsel
66,Bergstraat 71,2018-10-18,05:00:00,8,0,8,FMN GV 11 Ramsel
66,Bergstraat 71,2018-10-18,06:00:00,34,12,22,FMN GV 11 Ramsel
66,Bergstraat 71,2018-10-18,07:00:00,198,22,176,FMN GV 11 Ramsel
66,Bergstraat 71,2018-10-18,08:00:00,182,30,152,FMN GV 11 Ramsel
66,Bergstraat 71,2018-10-18,09:00:00,36,12,24,FMN GV 11 Ramsel
66,Bergstraat 71,2018-10-18,10:00:00,48,16,32,FMN GV 11 Ramsel
66,Bergstraat 71,2018-10-18,11:00:00,24,20,4,FMN GV 11 Ramsel
66,Bergstraat 71,2018-10-18,12:00:00,66,32,34,FMN GV 11 Ramsel
66,Bergstraat 71,2018-10-18,13:00:00,122,48,74,FMN GV 11 Ramsel
66,Bergstraat 71,2018-10-18,14:00:00,114,80,34,FMN GV 11 Ramsel
66,Bergstraat 71,2018-10-18,15:00:00,262,184,78,FMN GV 11 Ramsel
66,Bergstraat 71,2018-10-18,16:00:00,158,122,36,FMN GV 11 Ramsel
66,Bergstraat 71,2018-10-18,17:00:00,76,52,24,FMN GV 11 Ramsel
66,Bergstraat 71,2018-10-18,18:00:00,58,32,26,FMN GV 11 Ramsel
66,Bergstraat 71,2018-10-18,19:00:00,60,36,24,FMN GV 11 Ramsel
66,Bergstraat 71,2018-10-18,20:00:00,30,24,6,FMN GV 11 Ramsel
66,Bergstraat 71,2018-10-18,21:00:00,12,12,0,FMN GV 11 Ramsel
66,Bergstraat 71,2018-10-18,22:00:00,10,4,6,FMN GV 11 Ramsel
66,Bergstraat 71,2018-10-18,23:00:00,6,6,0,FMN GV 11 Ramsel
66,Bergstraat 71,2018-10-19,00:00:00,2,0,2,FMN GV 11 Ramsel
66,Bergstraat 71,2018-10-19,01:00:00,0,0,0,FMN GV 11 Ramsel
66,Bergstraat 71,2018-10-19,02:00:00,0,0,0,FMN GV 11 Ramsel
66,Bergstraat 71,2018-10-19,03:00:00,4,2,2,FMN GV 11 Ramsel
66,Bergstraat 71,2018-10-19,04:00:00,4,2,2,FMN GV 11 Ramsel
66,Bergstraat 71,2018-10-19,05:00:00,8,4,4,FMN GV 11 Ramsel
66,Bergstraat 71,2018-10-19,06:00:00,88,14,74,FMN GV 11 Ramsel
66,Bergstraat 71,2018-10-19,07:00:00,234,36,198,FMN GV 11 Ramsel
66,Bergstraat 71,2018-10-19,08:00:00,130,28,102,FMN GV 11 Ramsel
66,Bergstraat 71,2018-10-19,09:00:00,50,24,26,FMN GV 11 Ramsel
66,Bergstraat 71,2018-10-19,10:00:00,62,26,36,FMN GV 11 Ramsel
66,Bergstraat 71,2018-10-19,11:00:00,40,16,24,FMN GV 11 Ramsel
66,Bergstraat 71,2018-10-19,12:00:00,88,46,42,FMN GV 11 Ramsel
66,Bergstraat 71,2018-10-19,13:00:00,90,62,28,FMN GV 11 Ramsel
66,Bergstraat 71,2018-10-19,14:00:00,182,92,90,FMN GV 11 Ramsel
66,Bergstraat 71,2018-10-19,15:00:00,260,214,46,FMN GV 11 Ramsel
66,Bergstraat 71,2018-10-19,16:00:00,166,108,58,FMN GV 11 Ramsel
66,Bergstraat 71,2018-10-19,17:00:00,76,52,24,FMN GV 11 Ramsel
66,Bergstraat 71,2018-10-19,18:00:00,56,32,24,FMN GV 11 Ramsel
66,Bergstraat 71,2018-10-19,19:00:00,30,6,24,FMN GV 11 Ramsel
66,Bergstraat 71,2018-10-19,20:00:00,22,14,8,FMN GV 11 Ramsel
66,Bergstraat 71,2018-10-19,21:00:00,26,10,16,FMN GV 11 Ramsel
66,Bergstraat 71,2018-10-19,22:00:00,22,8,14,FMN GV 11 Ramsel
66,Bergstraat 71,2018-10-19,23:00:00,6,2,4,FMN GV 11 Ramsel
66,Bergstraat 71,2018-10-20,00:00:00,2,0,2,FMN GV 11 Ramsel
66,Bergstraat 71,2018-10-20,01:00:00,8,4,4,FMN GV 11 Ramsel
66,Bergstraat 71,2018-10-20,02:00:00,10,4,6,FMN GV 11 Ramsel
66,Bergstraat 71,2018-10-20,03:00:00,26,22,4,FMN GV 11 Ramsel
66,Bergstraat 71,2018-10-20,04:00:00,16,14,2,FMN GV 11 Ramsel
66,Bergstraat 71,2018-10-20,05:00:00,2,0,2,FMN GV 11 Ramsel
66,Bergstraat 71,2018-10-20,06:00:00,0,0,0,FMN GV 11 Ramsel
66,Bergstraat 71,2018-10-20,07:00:00,8,2,6,FMN GV 11 Ramsel
66,Bergstraat 71,2018-10-20,08:00:00,20,14,6,FMN GV 11 Ramsel
66,Bergstraat 71,2018-10-20,09:00:00,34,14,20,FMN GV 11 Ramsel
66,Bergstraat 71,2018-10-20,10:00:00,62,32,30,FMN GV 11 Ramsel
66,Bergstraat 71,2018-10-20,11:00:00,72,36,36,FMN GV 11 Ramsel
66,Bergstraat 71,2018-10-20,12:00:00,106,54,52,FMN GV 11 Ramsel
66,Bergstraat 71,2018-10-20,13:00:00,106,52,54,FMN GV 11 Ramsel
66,Bergstraat 71,2018-10-20,14:00:00,156,68,88,FMN GV 11 Ramsel
66,Bergstraat 71,2018-10-20,15:00:00,126,80,46,FMN GV 11 Ramsel
66,Bergstraat 71,2018-10-20,16:00:00,108,54,54,FMN GV 11 Ramsel
66,Bergstraat 71,2018-10-20,17:00:00,86,38,48,FMN GV 11 Ramsel
66,Bergstraat 71,2018-10-20,18:00:00,30,8,22,FMN GV 11 Ramsel
66,Bergstraat 71,2018-10-20,19:00:00,22,12,10,FMN GV 11 Ramsel
66,Bergstraat 71,2018-10-20,20:00:00,10,4,6,FMN GV 11 Ramsel
66,Bergstraat 71,2018-10-20,21:00:00,6,6,0,FMN GV 11 Ramsel
66,Bergstraat 71,2018-10-20,22:00:00,2,0,2,FMN GV 11 Ramsel
66,Bergstraat 71,2018-10-20,23:00:00,2,2,0,FMN GV 11 Ramsel
66,Bergstraat 71,2018-10-21,00:00:00,4,4,0,FMN GV 11 Ramsel
66,Bergstraat 71,2018-10-21,01:00:00,2,2,0,FMN GV 11 Ramsel
66,Bergstraat 71,2018-10-21,02:00:00,2,2,0,FMN GV 11 Ramsel
66,Bergstraat 71,2018-10-21,03:00:00,0,0,0,FMN GV 11 Ramsel
66,Bergstraat 71,2018-10-21,04:00:00,2,0,2,FMN GV 11 Ramsel
66,Bergstraat 71,2018-10-21,05:00:00,2,0,2,FMN GV 11 Ramsel
66,Bergstraat 71,2018-10-21,06:00:00,0,0,0,FMN GV 11 Ramsel
66,Bergstraat 71,2018-10-21,07:00:00,4,2,2,FMN GV 11 Ramsel
66,Bergstraat 71,2018-10-21,08:00:00,60,28,32,FMN GV 11 Ramsel
66,Bergstraat 71,2018-10-21,09:00:00,108,22,86,FMN GV 11 Ramsel
66,Bergstraat 71,2018-10-21,10:00:00,96,38,58,FMN GV 11 Ramsel
66,Bergstraat 71,2018-10-21,11:00:00,120,70,50,FMN GV 11 Ramsel
66,Bergstraat 71,2018-10-21,12:00:00,142,62,80,FMN GV 11 Ramsel
66,Bergstraat 71,2018-10-21,13:00:00,144,76,68,FMN GV 11 Ramsel
66,Bergstraat 71,2018-10-21,14:00:00,220,126,94,FMN GV 11 Ramsel
66,Bergstraat 71,2018-10-21,15:00:00,166,116,50,FMN GV 11 Ramsel
66,Bergstraat 71,2018-10-21,16:00:00,122,58,64,FMN GV 11 Ramsel
66,Bergstraat 71,2018-10-21,17:00:00,80,38,42,FMN GV 11 Ramsel
66,Bergstraat 71,2018-10-21,18:00:00,32,22,10,FMN GV 11 Ramsel
66,Bergstraat 71,2018-10-21,19:00:00,14,6,8,FMN GV 11 Ramsel
66,Bergstraat 71,2018-10-21,20:00:00,8,6,2,FMN GV 11 Ramsel
66,Bergstraat 71,2018-10-21,21:00:00,4,2,2,FMN GV 11 Ramsel
66,Bergstraat 71,2018-10-21,22:00:00,4,4,0,FMN GV 11 Ramsel
66,Bergstraat 71,2018-10-21,23:00:00,0,0,0,FMN GV 11 Ramsel
66,Bergstraat 71,2018-10-22,00:00:00,2,2,0,FMN GV 11 Ramsel
66,Bergstraat 71,2018-10-22,01:00:00,0,0,0,FMN GV 11 Ramsel
66,Bergstraat 71,2018-10-22,02:00:00,0,0,0,FMN GV 11 Ramsel
66,Bergstraat 71,2018-10-22,03:00:00,0,0,0,FMN GV 11 Ramsel
66,Bergstraat 71,2018-10-22,04:00:00,0,0,0,FMN GV 11 Ramsel
66,Bergstraat 71,2018-10-22,05:00:00,4,2,2,FMN GV 11 Ramsel
66,Bergstraat 71,2018-10-22,06:00:00,44,14,30,FMN GV 11 Ramsel
66,Bergstraat 71,2018-10-22,07:00:00,162,22,140,FMN GV 11 Ramsel
66,Bergstraat 71,2018-10-22,08:00:00,136,20,116,FMN GV 11 Ramsel
66,Bergstraat 71,2018-10-22,09:00:00,30,12,18,FMN GV 11 Ramsel
66,Bergstraat 71,2018-10-22,10:00:00,38,22,16,FMN GV 11 Ramsel
66,Bergstraat 71,2018-10-22,11:00:00,12,4,8,FMN GV 11 Ramsel
66,Bergstraat 71,2018-10-22,12:00:00,64,28,36,FMN GV 11 Ramsel
66,Bergstraat 71,2018-10-22,13:00:00,56,34,22,FMN GV 11 Ramsel
66,Bergstraat 71,2018-10-22,14:00:00,90,34,56,FMN GV 11 Ramsel
66,Bergstraat 71,2018-10-22,15:00:00,250,186,64,FMN GV 11 Ramsel
66,Bergstraat 71,2018-10-22,16:00:00,124,94,30,FMN GV 11 Ramsel
66,Bergstraat 71,2018-10-22,17:00:00,62,40,22,FMN GV 11 Ramsel
66,Bergstraat 71,2018-10-22,18:00:00,58,34,24,FMN GV 11 Ramsel
66,Bergstraat 71,2018-10-22,19:00:00,18,6,12,FMN GV 11 Ramsel
66,Bergstraat 71,2018-10-22,20:00:00,10,8,2,FMN GV 11 Ramsel
66,Bergstraat 71,2018-10-22,21:00:00,10,10,0,FMN GV 11 Ramsel
66,Bergstraat 71,2018-10-22,22:00:00,2,2,0,FMN GV 11 Ramsel
66,Bergstraat 71,2018-10-22,23:00:00,0,0,0,FMN GV 11 Ramsel
66,Bergstraat 71,2018-10-23,00:00:00,0,0,0,FMN GV 11 Ramsel
66,Bergstraat 71,2018-10-23,01:00:00,0,0,0,FMN GV 11 Ramsel
66,Bergstraat 71,2018-10-23,02:00:00,0,0,0,FMN GV 11 Ramsel
66,Bergstraat 71,2018-10-23,03:00:00,0,0,0,FMN GV 11 Ramsel
66,Bergstraat 71,2018-10-23,04:00:00,4,2,2,FMN GV 11 Ramsel
66,Bergstraat 71,2018-10-23,05:00:00,10,2,8,FMN GV 11 Ramsel
66,Bergstraat 71,2018-10-23,06:00:00,46,18,28,FMN GV 11 Ramsel
66,Bergstraat 71,2018-10-23,07:00:00,178,44,134,FMN GV 11 Ramsel
66,Bergstraat 71,2018-10-23,08:00:00,144,24,120,FMN GV 11 Ramsel
66,Bergstraat 71,2018-10-23,09:00:00,40,10,30,FMN GV 11 Ramsel
66,Bergstraat 71,2018-10-23,10:00:00,54,26,28,FMN GV 11 Ramsel
66,Bergstraat 71,2018-10-23,11:00:00,24,10,14,FMN GV 11 Ramsel
66,Bergstraat 71,2018-10-23,12:00:00,76,44,32,FMN GV 11 Ramsel
66,Bergstraat 71,2018-10-23,13:00:00,148,58,90,FMN GV 11 Ramsel
66,Bergstraat 71,2018-10-23,14:00:00,86,38,48,FMN GV 11 Ramsel
66,Bergstraat 71,2018-10-23,15:00:00,288,242,46,FMN GV 11 Ramsel
66,Bergstraat 71,2018-10-23,16:00:00,190,144,46,FMN GV 11 Ramsel
66,Bergstraat 71,2018-10-23,17:00:00,92,52,40,FMN GV 11 Ramsel
66,Bergstraat 71,2018-10-23,18:00:00,76,42,34,FMN GV 11 Ramsel
66,Bergstraat 71,2018-10-23,19:00:00,62,26,36,FMN GV 11 Ramsel
66,Bergstraat 71,2018-10-23,20:00:00,40,36,4,FMN GV 11 Ramsel
66,Bergstraat 71,2018-10-23,21:00:00,14,8,6,FMN GV 11 Ramsel
66,Bergstraat 71,2018-10-23,22:00:00,0,0,0,FMN GV 11 Ramsel
66,Bergstraat 71,2018-10-23,23:00:00,12,6,6,FMN GV 11 Ramsel
66,Bergstraat 71,2018-10-24,00:00:00,2,0,2,FMN GV 11 Ramsel
66,Bergstraat 71,2018-10-24,01:00:00,2,2,0,FMN GV 11 Ramsel
66,Bergstraat 71,2018-10-24,02:00:00,0,0,0,FMN GV 11 Ramsel
66,Bergstraat 71,2018-10-24,03:00:00,0,0,0,FMN GV 11 Ramsel
66,Bergstraat 71,2018-10-24,04:00:00,8,4,4,FMN GV 11 Ramsel
66,Bergstraat 71,2018-10-24,05:00:00,6,4,2,FMN GV 11 Ramsel
66,Bergstraat 71,2018-10-24,06:00:00,40,10,30,FMN GV 11 Ramsel
66,Bergstraat 71,2018-10-24,07:00:00,200,44,156,FMN GV 11 Ramsel
66,Bergstraat 71,2018-10-24,08:00:00,168,22,146,FMN GV 11 Ramsel
66,Bergstraat 71,2018-10-24,09:00:00,38,10,28,FMN GV 11 Ramsel
66,Bergstraat 71,2018-10-24,10:00:00,30,22,8,FMN GV 11 Ramsel
66,Bergstraat 71,2018-10-24,11:00:00,68,42,26,FMN GV 11 Ramsel
66,Bergstraat 71,2018-10-24,12:00:00,240,204,36,FMN GV 11 Ramsel
66,Bergstraat 71,2018-10-24,13:00:00,96,52,44,FMN GV 11 Ramsel
66,Bergstraat 71,2018-10-24,14:00:00,106,52,54,FMN GV 11 Ramsel
66,Bergstraat 71,2018-10-24,15:00:00,74,44,30,FMN GV 11 Ramsel
66,Bergstraat 71,2018-10-24,16:00:00,96,52,44,FMN GV 11 Ramsel
66,Bergstraat 71,2018-10-24,17:00:00,80,52,28,FMN GV 11 Ramsel
66,Bergstraat 71,2018-10-24,18:00:00,78,44,34,FMN GV 11 Ramsel
66,Bergstraat 71,2018-10-24,19:00:00,40,24,16,FMN GV 11 Ramsel
66,Bergstraat 71,2018-10-24,20:00:00,22,16,6,FMN GV 11 Ramsel
66,Bergstraat 71,2018-10-24,21:00:00,30,24,6,FMN GV 11 Ramsel
66,Bergstraat 71,2018-10-24,22:00:00,14,10,4,FMN GV 11 Ramsel
66,Bergstraat 71,2018-10-24,23:00:00,0,0,0,FMN GV 11 Ramsel
66,Bergstraat 71,2018-10-25,00:00:00,2,2,0,FMN GV 11 Ramsel
66,Bergstraat 71,2018-10-25,01:00:00,0,0,0,FMN GV 11 Ramsel
66,Bergstraat 71,2018-10-25,02:00:00,0,0,0,FMN GV 11 Ramsel
66,Bergstraat 71,2018-10-25,03:00:00,0,0,0,FMN GV 11 Ramsel
66,Bergstraat 71,2018-10-25,04:00:00,2,2,0,FMN GV 11 Ramsel
66,Bergstraat 71,2018-10-25,05:00:00,8,4,4,FMN GV 11 Ramsel
66,Bergstraat 71,2018-10-25,06:00:00,26,6,20,FMN GV 11 Ramsel
66,Bergstraat 71,2018-10-25,07:00:00,184,30,154,FMN GV 11 Ramsel
66,Bergstraat 71,2018-10-25,08:00:00,172,30,142,FMN GV 11 Ramsel
66,Bergstraat 71,2018-10-25,09:00:00,48,16,32,FMN GV 11 Ramsel
66,Bergstraat 71,2018-10-25,10:00:00,40,20,20,FMN GV 11 Ramsel
66,Bergstraat 71,2018-10-25,11:00:00,56,30,26,FMN GV 11 Ramsel
66,Bergstraat 71,2018-10-25,12:00:00,66,36,30,FMN GV 11 Ramsel
66,Bergstraat 71,2018-10-25,13:00:00,88,52,36,FMN GV 11 Ramsel
66,Bergstraat 71,2018-10-25,14:00:00,94,58,36,FMN GV 11 Ramsel
66,Bergstraat 71,2018-10-25,15:00:00,290,208,82,FMN GV 11 Ramsel
66,Bergstraat 71,2018-10-25,16:00:00,146,94,52,FMN GV 11 Ramsel
66,Bergstraat 71,2018-10-25,17:00:00,94,60,34,FMN GV 11 Ramsel
66,Bergstraat 71,2018-10-25,18:00:00,52,36,16,FMN GV 11 Ramsel
66,Bergstraat 71,2018-10-25,19:00:00,46,30,16,FMN GV 11 Ramsel
66,Bergstraat 71,2018-10-25,20:00:00,34,22,12,FMN GV 11 Ramsel
66,Bergstraat 71,2018-10-25,21:00:00,16,10,6,FMN GV 11 Ramsel
66,Bergstraat 71,2018-10-25,22:00:00,8,6,2,FMN GV 11 Ramsel
66,Bergstraat 71,2018-10-25,23:00:00,0,0,0,FMN GV 11 Ramsel
66,Bergstraat 71,2018-10-26,00:00:00,2,2,0,FMN GV 11 Ramsel
66,Bergstraat 71,2018-10-26,01:00:00,0,0,0,FMN GV 11 Ramsel
66,Bergstraat 71,2018-10-26,02:00:00,0,0,0,FMN GV 11 Ramsel
66,Bergstraat 71,2018-10-26,03:00:00,2,0,2,FMN GV 11 Ramsel
66,Bergstraat 71,2018-10-26,04:00:00,4,2,2,FMN GV 11 Ramsel
66,Bergstraat 71,2018-10-26,05:00:00,2,0,2,FMN GV 11 Ramsel
66,Bergstraat 71,2018-10-26,06:00:00,22,2,20,FMN GV 11 Ramsel
66,Bergstraat 71,2018-10-26,07:00:00,166,22,144,FMN GV 11 Ramsel
66,Bergstraat 71,2018-10-26,08:00:00,126,26,100,FMN GV 11 Ramsel
66,Bergstraat 71,2018-10-26,09:00:00,28,10,18,FMN GV 11 Ramsel
66,Bergstraat 71,2018-10-26,10:00:00,32,20,12,FMN GV 11 Ramsel
66,Bergstraat 71,2018-10-26,11:00:00,32,20,12,FMN GV 11 Ramsel
66,Bergstraat 71,2018-10-26,12:00:00,44,24,20,FMN GV 11 Ramsel
66,Bergstraat 71,2018-10-26,13:00:00,52,32,20,FMN GV 11 Ramsel
66,Bergstraat 71,2018-10-26,14:00:00,68,30,38,FMN GV 11 Ramsel
66,Bergstraat 71,2018-10-26,15:00:00,172,138,34,FMN GV 11 Ramsel
66,Bergstraat 71,2018-10-26,16:00:00,128,98,30,FMN GV 11 Ramsel
66,Bergstraat 71,2018-10-26,17:00:00,54,40,14,FMN GV 11 Ramsel
66,Bergstraat 71,2018-10-26,18:00:00,26,18,8,FMN GV 11 Ramsel
66,Bergstraat 71,2018-10-26,19:00:00,12,10,2,FMN GV 11 Ramsel
66,Bergstraat 71,2018-10-26,20:00:00,10,6,4,FMN GV 11 Ramsel
66,Bergstraat 71,2018-10-26,21:00:00,6,0,6,FMN GV 11 Ramsel
66,Bergstraat 71,2018-10-26,22:00:00,0,0,0,FMN GV 11 Ramsel
66,Bergstraat 71,2018-10-26,23:00:00,2,2,0,FMN GV 11 Ramsel
66,Bergstraat 71,2018-10-27,00:00:00,0,0,0,FMN GV 11 Ramsel
66,Bergstraat 71,2018-10-27,01:00:00,0,0,0,FMN GV 11 Ramsel
66,Bergstraat 71,2018-10-27,02:00:00,4,2,2,FMN GV 11 Ramsel
66,Bergstraat 71,2018-10-27,03:00:00,0,0,0,FMN GV 11 Ramsel
66,Bergstraat 71,2018-10-27,04:00:00,0,0,0,FMN GV 11 Ramsel
66,Bergstraat 71,2018-10-27,05:00:00,4,0,4,FMN GV 11 Ramsel
66,Bergstraat 71,2018-10-27,06:00:00,4,2,2,FMN GV 11 Ramsel
66,Bergstraat 71,2018-10-27,07:00:00,0,0,0,FMN GV 11 Ramsel
66,Bergstraat 71,2018-10-27,08:00:00,14,8,6,FMN GV 11 Ramsel
66,Bergstraat 71,2018-10-27,09:00:00,28,10,18,FMN GV 11 Ramsel
66,Bergstraat 71,2018-10-27,10:00:00,22,4,18,FMN GV 11 Ramsel
66,Bergstraat 71,2018-10-27,11:00:00,44,24,20,FMN GV 11 Ramsel
66,Bergstraat 71,2018-10-27,12:00:00,60,22,38,FMN GV 11 Ramsel
66,Bergstraat 71,2018-10-27,13:00:00,78,38,40,FMN GV 11 Ramsel
66,Bergstraat 71,2018-10-27,14:00:00,140,80,60,FMN GV 11 Ramsel
66,Bergstraat 71,2018-10-27,15:00:00,106,62,44,FMN GV 11 Ramsel
66,Bergstraat 71,2018-10-27,16:00:00,58,34,24,FMN GV 11 Ramsel
66,Bergstraat 71,2018-10-27,17:00:00,50,24,26,FMN GV 11 Ramsel
66,Bergstraat 71,2018-10-27,18:00:00,12,6,6,FMN GV 11 Ramsel
66,Bergstraat 71,2018-10-27,19:00:00,12,4,8,FMN GV 11 Ramsel
66,Bergstraat 71,2018-10-27,20:00:00,8,2,6,FMN GV 11 Ramsel
66,Bergstraat 71,2018-10-27,21:00:00,0,0,0,FMN GV 11 Ramsel
66,Bergstraat 71,2018-10-27,22:00:00,4,4,0,FMN GV 11 Ramsel
66,Bergstraat 71,2018-10-27,23:00:00,4,4,0,FMN GV 11 Ramsel
66,Bergstraat 71,2018-10-28,00:00:00,0,0,0,FMN GV 11 Ramsel
66,Bergstraat 71,2018-10-28,01:00:00,4,2,2,FMN GV 11 Ramsel
66,Bergstraat 71,2018-10-28,02:00:00,2,2,0,FMN GV 11 Ramsel
66,Bergstraat 71,2018-10-28,03:00:00,4,2,2,FMN GV 11 Ramsel
66,Bergstraat 71,2018-10-28,04:00:00,2,0,2,FMN GV 11 Ramsel
66,Bergstraat 71,2018-10-28,05:00:00,0,0,0,FMN GV 11 Ramsel
66,Bergstraat 71,2018-10-28,06:00:00,4,0,4,FMN GV 11 Ramsel
66,Bergstraat 71,2018-10-28,07:00:00,6,2,4,FMN GV 11 Ramsel
66,Bergstraat 71,2018-10-28,08:00:00,56,32,24,FMN GV 11 Ramsel
66,Bergstraat 71,2018-10-28,09:00:00,86,32,54,FMN GV 11 Ramsel
66,Bergstraat 71,2018-10-28,10:00:00,80,24,56,FMN GV 11 Ramsel
66,Bergstraat 71,2018-10-28,11:00:00,70,40,30,FMN GV 11 Ramsel
66,Bergstraat 71,2018-10-28,12:00:00,54,18,36,FMN GV 11 Ramsel
66,Bergstraat 71,2018-10-28,13:00:00,70,34,36,FMN GV 11 Ramsel
66,Bergstraat 71,2018-10-28,14:00:00,34,18,16,FMN GV 11 Ramsel
66,Bergstraat 71,2018-10-28,15:00:00,30,22,8,FMN GV 11 Ramsel
66,Bergstraat 71,2018-10-28,16:00:00,40,24,16,FMN GV 11 Ramsel
66,Bergstraat 71,2018-10-28,17:00:00,22,8,14,FMN GV 11 Ramsel
66,Bergstraat 71,2018-10-28,18:00:00,8,4,4,FMN GV 11 Ramsel
66,Bergstraat 71,2018-10-28,19:00:00,6,0,6,FMN GV 11 Ramsel
66,Bergstraat 71,2018-10-28,20:00:00,2,2,0,FMN GV 11 Ramsel
66,Bergstraat 71,2018-10-28,21:00:00,2,0,2,FMN GV 11 Ramsel
66,Bergstraat 71,2018-10-28,22:00:00,0,0,0,FMN GV 11 Ramsel
66,Bergstraat 71,2018-10-28,23:00:00,4,4,0,FMN GV 11 Ramsel
66,Bergstraat 71,2018-10-29,00:00:00,0,0,0,FMN GV 11 Ramsel
66,Bergstraat 71,2018-10-29,01:00:00,0,0,0,FMN GV 11 Ramsel
66,Bergstraat 71,2018-10-29,02:00:00,0,0,0,FMN GV 11 Ramsel
66,Bergstraat 71,2018-10-29,03:00:00,0,0,0,FMN GV 11 Ramsel
66,Bergstraat 71,2018-10-29,04:00:00,2,2,0,FMN GV 11 Ramsel
66,Bergstraat 71,2018-10-29,05:00:00,8,6,2,FMN GV 11 Ramsel
66,Bergstraat 71,2018-10-29,06:00:00,16,2,14,FMN GV 11 Ramsel
66,Bergstraat 71,2018-10-29,07:00:00,30,6,24,FMN GV 11 Ramsel
66,Bergstraat 71,2018-10-29,08:00:00,36,18,18,FMN GV 11 Ramsel
66,Bergstraat 71,2018-10-29,09:00:00,36,10,26,FMN GV 11 Ramsel
66,Bergstraat 71,2018-10-29,10:00:00,42,24,18,FMN GV 11 Ramsel
66,Bergstraat 71,2018-10-29,11:00:00,36,28,8,FMN GV 11 Ramsel
66,Bergstraat 71,2018-10-29,12:00:00,38,20,18,FMN GV 11 Ramsel
66,Bergstraat 71,2018-10-29,13:00:00,46,12,34,FMN GV 11 Ramsel
66,Bergstraat 71,2018-10-29,14:00:00,16,2,14,FMN GV 11 Ramsel
66,Bergstraat 71,2018-10-29,15:00:00,40,24,16,FMN GV 11 Ramsel
66,Bergstraat 71,2018-10-29,16:00:00,54,42,12,FMN GV 11 Ramsel
66,Bergstraat 71,2018-10-29,17:00:00,40,26,14,FMN GV 11 Ramsel
66,Bergstraat 71,2018-10-29,18:00:00,18,12,6,FMN GV 11 Ramsel
66,Bergstraat 71,2018-10-29,19:00:00,32,12,20,FMN GV 11 Ramsel
66,Bergstraat 71,2018-10-29,20:00:00,8,4,4,FMN GV 11 Ramsel
66,Bergstraat 71,2018-10-29,21:00:00,8,8,0,FMN GV 11 Ramsel
66,Bergstraat 71,2018-10-29,22:00:00,4,2,2,FMN GV 11 Ramsel
66,Bergstraat 71,2018-10-29,23:00:00,4,4,0,FMN GV 11 Ramsel
66,Bergstraat 71,2018-10-30,00:00:00,0,0,0,FMN GV 11 Ramsel
66,Bergstraat 71,2018-10-30,01:00:00,0,0,0,FMN GV 11 Ramsel
66,Bergstraat 71,2018-10-30,02:00:00,2,0,2,FMN GV 11 Ramsel
66,Bergstraat 71,2018-10-30,03:00:00,0,0,0,FMN GV 11 Ramsel
66,Bergstraat 71,2018-10-30,04:00:00,2,2,0,FMN GV 11 Ramsel
66,Bergstraat 71,2018-10-30,05:00:00,4,0,4,FMN GV 11 Ramsel
66,Bergstraat 71,2018-10-30,06:00:00,16,2,14,FMN GV 11 Ramsel
66,Bergstraat 71,2018-10-30,07:00:00,18,8,10,FMN GV 11 Ramsel
66,Bergstraat 71,2018-10-30,08:00:00,12,2,10,FMN GV 11 Ramsel
66,Bergstraat 71,2018-10-30,09:00:00,12,6,6,FMN GV 11 Ramsel
66,Bergstraat 71,2018-10-30,10:00:00,8,0,8,FMN GV 11 Ramsel
66,Bergstraat 71,2018-10-30,11:00:00,28,20,8,FMN GV 11 Ramsel
66,Bergstraat 71,2018-10-30,12:00:00,28,12,16,FMN GV 11 Ramsel
66,Bergstraat 71,2018-10-30,13:00:00,24,8,16,FMN GV 11 Ramsel
66,Bergstraat 71,2018-10-30,14:00:00,4,0,4,FMN GV 11 Ramsel
66,Bergstraat 71,2018-10-30,15:00:00,14,8,6,FMN GV 11 Ramsel
66,Bergstraat 71,2018-10-30,16:00:00,14,8,6,FMN GV 11 Ramsel
66,Bergstraat 71,2018-10-30,17:00:00,30,16,14,FMN GV 11 Ramsel
66,Bergstraat 71,2018-10-30,18:00:00,12,4,8,FMN GV 11 Ramsel
66,Bergstraat 71,2018-10-30,19:00:00,12,6,6,FMN GV 11 Ramsel
66,Bergstraat 71,2018-10-30,20:00:00,4,4,0,FMN GV 11 Ramsel
66,Bergstraat 71,2018-10-30,21:00:00,4,2,2,FMN GV 11 Ramsel
66,Bergstraat 71,2018-10-30,22:00:00,2,2,0,FMN GV 11 Ramsel
66,Bergstraat 71,2018-10-30,23:00:00,2,2,0,FMN GV 11 Ramsel
66,Bergstraat 71,2018-10-31,00:00:00,0,0,0,FMN GV 11 Ramsel
66,Bergstraat 71,2018-10-31,01:00:00,0,0,0,FMN GV 11 Ramsel
66,Bergstraat 71,2018-10-31,02:00:00,0,0,0,FMN GV 11 Ramsel
66,Bergstraat 71,2018-10-31,03:00:00,0,0,0,FMN GV 11 Ramsel
66,Bergstraat 71,2018-10-31,04:00:00,2,2,0,FMN GV 11 Ramsel
66,Bergstraat 71,2018-10-31,05:00:00,6,0,6,FMN GV 11 Ramsel
66,Bergstraat 71,2018-10-31,06:00:00,16,6,10,FMN GV 11 Ramsel
66,Bergstraat 71,2018-10-31,07:00:00,28,14,14,FMN GV 11 Ramsel
66,Bergstraat 71,2018-10-31,08:00:00,20,8,12,FMN GV 11 Ramsel
66,Bergstraat 71,2018-10-31,09:00:00,34,22,12,FMN GV 11 Ramsel
66,Bergstraat 71,2018-10-31,10:00:00,24,6,18,FMN GV 11 Ramsel
66,Bergstraat 71,2018-10-31,11:00:00,40,24,16,FMN GV 11 Ramsel
66,Bergstraat 71,2018-10-31,12:00:00,68,34,34,FMN GV 11 Ramsel
66,Bergstraat 71,2018-10-31,13:00:00,68,36,32,FMN GV 11 Ramsel
66,Bergstraat 71,2018-10-31,14:00:00,102,50,52,FMN GV 11 Ramsel
66,Bergstraat 71,2018-10-31,15:00:00,58,28,30,FMN GV 11 Ramsel
66,Bergstraat 71,2018-10-31,16:00:00,66,26,40,FMN GV 11 Ramsel
66,Bergstraat 71,2018-10-31,17:00:00,66,40,26,FMN GV 11 Ramsel
66,Bergstraat 71,2018-10-31,18:00:00,20,10,10,FMN GV 11 Ramsel
66,Bergstraat 71,2018-10-31,19:00:00,14,8,6,FMN GV 11 Ramsel
66,Bergstraat 71,2018-10-31,20:00:00,14,10,4,FMN GV 11 Ramsel
66,Bergstraat 71,2018-10-31,21:00:00,4,2,2,FMN GV 11 Ramsel
66,Bergstraat 71,2018-10-31,22:00:00,4,4,0,FMN GV 11 Ramsel
66,Bergstraat 71,2018-10-31,23:00:00,6,4,2,FMN GV 11 Ramsel
66,Bergstraat 71,2018-11-01,00:00:00,2,2,0,FMN GV 11 Ramsel
66,Bergstraat 71,2018-11-01,01:00:00,0,0,0,FMN GV 11 Ramsel
66,Bergstraat 71,2018-11-01,02:00:00,2,2,0,FMN GV 11 Ramsel
66,Bergstraat 71,2018-11-01,03:00:00,0,0,0,FMN GV 11 Ramsel
66,Bergstraat 71,2018-11-01,04:00:00,0,0,0,FMN GV 11 Ramsel
66,Bergstraat 71,2018-11-01,05:00:00,2,2,0,FMN GV 11 Ramsel
66,Bergstraat 71,2018-11-01,06:00:00,0,0,0,FMN GV 11 Ramsel
66,Bergstraat 71,2018-11-01,07:00:00,4,2,2,FMN GV 11 Ramsel
66,Bergstraat 71,2018-11-01,08:00:00,32,10,22,FMN GV 11 Ramsel
66,Bergstraat 71,2018-11-01,09:00:00,50,8,42,FMN GV 11 Ramsel
66,Bergstraat 71,2018-11-01,10:00:00,72,46,26,FMN GV 11 Ramsel
66,Bergstraat 71,2018-11-01,11:00:00,106,66,40,FMN GV 11 Ramsel
66,Bergstraat 71,2018-11-01,12:00:00,58,30,28,FMN GV 11 Ramsel
66,Bergstraat 71,2018-11-01,13:00:00,26,16,10,FMN GV 11 Ramsel
66,Bergstraat 71,2018-11-01,14:00:00,22,10,12,FMN GV 11 Ramsel
66,Bergstraat 71,2018-11-01,15:00:00,16,8,8,FMN GV 11 Ramsel
66,Bergstraat 71,2018-11-01,16:00:00,20,12,8,FMN GV 11 Ramsel
66,Bergstraat 71,2018-11-01,17:00:00,12,4,8,FMN GV 11 Ramsel
66,Bergstraat 71,2018-11-01,18:00:00,0,0,0,FMN GV 11 Ramsel
66,Bergstraat 71,2018-11-01,19:00:00,2,2,0,FMN GV 11 Ramsel
66,Bergstraat 71,2018-11-01,20:00:00,6,2,4,FMN GV 11 Ramsel
66,Bergstraat 71,2018-11-01,21:00:00,0,0,0,FMN GV 11 Ramsel
66,Bergstraat 71,2018-11-01,22:00:00,2,2,0,FMN GV 11 Ramsel
66,Bergstraat 71,2018-11-01,23:00:00,0,0,0,FMN GV 11 Ramsel
66,Bergstraat 71,2018-11-02,00:00:00,0,0,0,FMN GV 11 Ramsel
66,Bergstraat 71,2018-11-02,01:00:00,0,0,0,FMN GV 11 Ramsel
66,Bergstraat 71,2018-11-02,02:00:00,2,2,0,FMN GV 11 Ramsel
66,Bergstraat 71,2018-11-02,03:00:00,0,0,0,FMN GV 11 Ramsel
66,Bergstraat 71,2018-11-02,04:00:00,0,0,0,FMN GV 11 Ramsel
66,Bergstraat 71,2018-11-02,05:00:00,4,2,2,FMN GV 11 Ramsel
66,Bergstraat 71,2018-11-02,06:00:00,8,4,4,FMN GV 11 Ramsel
66,Bergstraat 71,2018-11-02,07:00:00,16,6,10,FMN GV 11 Ramsel
66,Bergstraat 71,2018-11-02,08:00:00,18,4,14,FMN GV 11 Ramsel
66,Bergstraat 71,2018-11-02,09:00:00,34,12,22,FMN GV 11 Ramsel
66,Bergstraat 71,2018-11-02,10:00:00,78,38,40,FMN GV 11 Ramsel
66,Bergstraat 71,2018-11-02,11:00:00,44,22,22,FMN GV 11 Ramsel
66,Bergstraat 71,2018-11-02,12:00:00,94,22,72,FMN GV 11 Ramsel
66,Bergstraat 71,2018-11-02,13:00:00,142,70,72,FMN GV 11 Ramsel
66,Bergstraat 71,2018-11-02,14:00:00,126,64,62,FMN GV 11 Ramsel
66,Bergstraat 71,2018-11-02,15:00:00,122,78,44,FMN GV 11 Ramsel
66,Bergstraat 71,2018-11-02,16:00:00,74,52,22,FMN GV 11 Ramsel
66,Bergstraat 71,2018-11-02,17:00:00,60,44,16,FMN GV 11 Ramsel
66,Bergstraat 71,2018-11-02,18:00:00,12,8,4,FMN GV 11 Ramsel
66,Bergstraat 71,2018-11-02,19:00:00,6,4,2,FMN GV 11 Ramsel
66,Bergstraat 71,2018-11-02,20:00:00,10,6,4,FMN GV 11 Ramsel
66,Bergstraat 71,2018-11-02,21:00:00,10,0,10,FMN GV 11 Ramsel
66,Bergstraat 71,2018-11-02,22:00:00,14,12,2,FMN GV 11 Ramsel
66,Bergstraat 71,2018-11-02,23:00:00,0,0,0,FMN GV 11 Ramsel
66,Bergstraat 71,2018-11-03,00:00:00,4,0,4,FMN GV 11 Ramsel
66,Bergstraat 71,2018-11-03,01:00:00,0,0,0,FMN GV 11 Ramsel
66,Bergstraat 71,2018-11-03,02:00:00,6,4,2,FMN GV 11 Ramsel
66,Bergstraat 71,2018-11-03,03:00:00,0,0,0,FMN GV 11 Ramsel
66,Bergstraat 71,2018-11-03,04:00:00,0,0,0,FMN GV 11 Ramsel
66,Bergstraat 71,2018-11-03,05:00:00,2,0,2,FMN GV 11 Ramsel
66,Bergstraat 71,2018-11-03,06:00:00,0,0,0,FMN GV 11 Ramsel
66,Bergstraat 71,2018-11-03,07:00:00,2,0,2,FMN GV 11 Ramsel
66,Bergstraat 71,2018-11-03,08:00:00,24,8,16,FMN GV 11 Ramsel
66,Bergstraat 71,2018-11-03,09:00:00,28,6,22,FMN GV 11 Ramsel
66,Bergstraat 71,2018-11-03,10:00:00,44,26,18,FMN GV 11 Ramsel
66,Bergstraat 71,2018-11-03,11:00:00,82,40,42,FMN GV 11 Ramsel
66,Bergstraat 71,2018-11-03,12:00:00,84,36,48,FMN GV 11 Ramsel
66,Bergstraat 71,2018-11-03,13:00:00,110,52,58,FMN GV 11 Ramsel
66,Bergstraat 71,2018-11-03,14:00:00,172,100,72,FMN GV 11 Ramsel
66,Bergstraat 71,2018-11-03,15:00:00,114,64,50,FMN GV 11 Ramsel
66,Bergstraat 71,2018-11-03,16:00:00,78,42,36,FMN GV 11 Ramsel
66,Bergstraat 71,2018-11-03,17:00:00,70,50,20,FMN GV 11 Ramsel
66,Bergstraat 71,2018-11-03,18:00:00,10,8,2,FMN GV 11 Ramsel
66,Bergstraat 71,2018-11-03,19:00:00,8,4,4,FMN GV 11 Ramsel
66,Bergstraat 71,2018-11-03,20:00:00,8,4,4,FMN GV 11 Ramsel
66,Bergstraat 71,2018-11-03,21:00:00,0,0,0,FMN GV 11 Ramsel
66,Bergstraat 71,2018-11-03,22:00:00,2,0,2,FMN GV 11 Ramsel
66,Bergstraat 71,2018-11-03,23:00:00,2,2,0,FMN GV 11 Ramsel
66,Bergstraat 71,2018-11-04,00:00:00,2,2,0,FMN GV 11 Ramsel
66,Bergstraat 71,2018-11-04,01:00:00,0,0,0,FMN GV 11 Ramsel
66,Bergstraat 71,2018-11-04,02:00:00,0,0,0,FMN GV 11 Ramsel
66,Bergstraat 71,2018-11-04,03:00:00,6,4,2,FMN GV 11 Ramsel
66,Bergstraat 71,2018-11-04,04:00:00,4,4,0,FMN GV 11 Ramsel
66,Bergstraat 71,2018-11-04,05:00:00,4,4,0,FMN GV 11 Ramsel
66,Bergstraat 71,2018-11-04,06:00:00,2,0,2,FMN GV 11 Ramsel
66,Bergstraat 71,2018-11-04,07:00:00,22,4,18,FMN GV 11 Ramsel
66,Bergstraat 71,2018-11-04,08:00:00,78,22,56,FMN GV 11 Ramsel
66,Bergstraat 71,2018-11-04,09:00:00,58,26,32,FMN GV 11 Ramsel
66,Bergstraat 71,2018-11-04,10:00:00,72,40,32,FMN GV 11 Ramsel
66,Bergstraat 71,2018-11-04,11:00:00,122,70,52,FMN GV 11 Ramsel
66,Bergstraat 71,2018-11-04,12:00:00,142,88,54,FMN GV 11 Ramsel
66,Bergstraat 71,2018-11-04,13:00:00,154,78,76,FMN GV 11 Ramsel
66,Bergstraat 71,2018-11-04,14:00:00,134,52,82,FMN GV 11 Ramsel
66,Bergstraat 71,2018-11-04,15:00:00,96,52,44,FMN GV 11 Ramsel
66,Bergstraat 71,2018-11-04,16:00:00,64,46,18,FMN GV 11 Ramsel
66,Bergstraat 71,2018-11-04,17:00:00,38,32,6,FMN GV 11 Ramsel
66,Bergstraat 71,2018-11-04,18:00:00,10,8,2,FMN GV 11 Ramsel
66,Bergstraat 71,2018-11-04,19:00:00,10,4,6,FMN GV 11 Ramsel
66,Bergstraat 71,2018-11-04,20:00:00,6,4,2,FMN GV 11 Ramsel
66,Bergstraat 71,2018-11-04,21:00:00,0,0,0,FMN GV 11 Ramsel
66,Bergstraat 71,2018-11-04,22:00:00,2,2,0,FMN GV 11 Ramsel
66,Bergstraat 71,2018-11-04,23:00:00,4,4,0,FMN GV 11 Ramsel
66,Bergstraat 71,2018-11-05,00:00:00,0,0,0,FMN GV 11 Ramsel
66,Bergstraat 71,2018-11-05,01:00:00,0,0,0,FMN GV 11 Ramsel
66,Bergstraat 71,2018-11-05,02:00:00,0,0,0,FMN GV 11 Ramsel
66,Bergstraat 71,2018-11-05,03:00:00,0,0,0,FMN GV 11 Ramsel
66,Bergstraat 71,2018-11-05,04:00:00,2,2,0,FMN GV 11 Ramsel
66,Bergstraat 71,2018-11-05,05:00:00,4,4,0,FMN GV 11 Ramsel
66,Bergstraat 71,2018-11-05,06:00:00,30,4,26,FMN GV 11 Ramsel
66,Bergstraat 71,2018-11-05,07:00:00,190,32,158,FMN GV 11 Ramsel
66,Bergstraat 71,2018-11-05,08:00:00,128,24,104,FMN GV 11 Ramsel
66,Bergstraat 71,2018-11-05,09:00:00,46,14,32,FMN GV 11 Ramsel
66,Bergstraat 71,2018-11-05,10:00:00,50,26,24,FMN GV 11 Ramsel
66,Bergstraat 71,2018-11-05,11:00:00,40,22,18,FMN GV 11 Ramsel
66,Bergstraat 71,2018-11-05,12:00:00,82,38,44,FMN GV 11 Ramsel
66,Bergstraat 71,2018-11-05,13:00:00,160,96,64,FMN GV 11 Ramsel
66,Bergstraat 71,2018-11-05,14:00:00,104,62,42,FMN GV 11 Ramsel
66,Bergstraat 71,2018-11-05,15:00:00,284,206,78,FMN GV 11 Ramsel
66,Bergstraat 71,2018-11-05,16:00:00,144,110,34,FMN GV 11 Ramsel
66,Bergstraat 71,2018-11-05,17:00:00,52,36,16,FMN GV 11 Ramsel
66,Bergstraat 71,2018-11-05,18:00:00,40,24,16,FMN GV 11 Ramsel
66,Bergstraat 71,2018-11-05,19:00:00,26,12,14,FMN GV 11 Ramsel
66,Bergstraat 71,2018-11-05,20:00:00,16,12,4,FMN GV 11 Ramsel
66,Bergstraat 71,2018-11-05,21:00:00,8,6,2,FMN GV 11 Ramsel
66,Bergstraat 71,2018-11-05,22:00:00,0,0,0,FMN GV 11 Ramsel
66,Bergstraat 71,2018-11-05,23:00:00,2,2,0,FMN GV 11 Ramsel
66,Bergstraat 71,2018-11-06,00:00:00,0,0,0,FMN GV 11 Ramsel
66,Bergstraat 71,2018-11-06,01:00:00,0,0,0,FMN GV 11 Ramsel
66,Bergstraat 71,2018-11-06,02:00:00,0,0,0,FMN GV 11 Ramsel
66,Bergstraat 71,2018-11-06,03:00:00,0,0,0,FMN GV 11 Ramsel
66,Bergstraat 71,2018-11-06,04:00:00,4,0,4,FMN GV 11 Ramsel
66,Bergstraat 71,2018-11-06,05:00:00,12,8,4,FMN GV 11 Ramsel
66,Bergstraat 71,2018-11-06,06:00:00,38,8,30,FMN GV 11 Ramsel
66,Bergstraat 71,2018-11-06,07:00:00,180,40,140,FMN GV 11 Ramsel
66,Bergstraat 71,2018-11-06,08:00:00,166,42,124,FMN GV 11 Ramsel
66,Bergstraat 71,2018-11-06,09:00:00,46,14,32,FMN GV 11 Ramsel
66,Bergstraat 71,2018-11-06,10:00:00,100,42,58,FMN GV 11 Ramsel
66,Bergstraat 71,2018-11-06,11:00:00,108,44,64,FMN GV 11 Ramsel
66,Bergstraat 71,2018-11-06,12:00:00,154,66,88,FMN GV 11 Ramsel
66,Bergstraat 71,2018-11-06,13:00:00,260,90,170,FMN GV 11 Ramsel
66,Bergstraat 71,2018-11-06,14:00:00,186,92,94,FMN GV 11 Ramsel
66,Bergstraat 71,2018-11-06,15:00:00,382,298,84,FMN GV 11 Ramsel
66,Bergstraat 71,2018-11-06,16:00:00,252,174,78,FMN GV 11 Ramsel
66,Bergstraat 71,2018-11-06,17:00:00,102,56,46,FMN GV 11 Ramsel
66,Bergstraat 71,2018-11-06,18:00:00,40,24,16,FMN GV 11 Ramsel
66,Bergstraat 71,2018-11-06,19:00:00,16,4,12,FMN GV 11 Ramsel
66,Bergstraat 71,2018-11-06,20:00:00,26,14,12,FMN GV 11 Ramsel
66,Bergstraat 71,2018-11-06,21:00:00,20,16,4,FMN GV 11 Ramsel
66,Bergstraat 71,2018-11-06,22:00:00,16,14,2,FMN GV 11 Ramsel
66,Bergstraat 71,2018-11-06,23:00:00,2,2,0,FMN GV 11 Ramsel
66,Bergstraat 71,2018-11-07,00:00:00,0,0,0,FMN GV 11 Ramsel
66,Bergstraat 71,2018-11-07,01:00:00,0,0,0,FMN GV 11 Ramsel
66,Bergstraat 71,2018-11-07,02:00:00,0,0,0,FMN GV 11 Ramsel
66,Bergstraat 71,2018-11-07,03:00:00,0,0,0,FMN GV 11 Ramsel
66,Bergstraat 71,2018-11-07,04:00:00,6,2,4,FMN GV 11 Ramsel
66,Bergstraat 71,2018-11-07,05:00:00,2,0,2,FMN GV 11 Ramsel
66,Bergstraat 71,2018-11-07,06:00:00,32,14,18,FMN GV 11 Ramsel
66,Bergstraat 71,2018-11-07,07:00:00,176,24,152,FMN GV 11 Ramsel
66,Bergstraat 71,2018-11-07,08:00:00,190,30,160,FMN GV 11 Ramsel
66,Bergstraat 71,2018-11-07,09:00:00,34,18,16,FMN GV 11 Ramsel
66,Bergstraat 71,2018-11-07,10:00:00,72,40,32,FMN GV 11 Ramsel
66,Bergstraat 71,2018-11-07,11:00:00,60,34,26,FMN GV 11 Ramsel
66,Bergstraat 71,2018-11-07,12:00:00,284,224,60,FMN GV 11 Ramsel
66,Bergstraat 71,2018-11-07,13:00:00,48,30,18,FMN GV 11 Ramsel
66,Bergstraat 71,2018-11-07,14:00:00,50,42,8,FMN GV 11 Ramsel
66,Bergstraat 71,2018-11-07,15:00:00,36,20,16,FMN GV 11 Ramsel
66,Bergstraat 71,2018-11-07,16:00:00,52,36,16,FMN GV 11 Ramsel
66,Bergstraat 71,2018-11-07,17:00:00,54,34,20,FMN GV 11 Ramsel
66,Bergstraat 71,2018-11-07,18:00:00,28,18,10,FMN GV 11 Ramsel
66,Bergstraat 71,2018-11-07,19:00:00,26,20,6,FMN GV 11 Ramsel
66,Bergstraat 71,2018-11-07,20:00:00,10,8,2,FMN GV 11 Ramsel
66,Bergstraat 71,2018-11-07,21:00:00,14,12,2,FMN GV 11 Ramsel
66,Bergstraat 71,2018-11-07,22:00:00,4,4,0,FMN GV 11 Ramsel
66,Bergstraat 71,2018-11-07,23:00:00,2,2,0,FMN GV 11 Ramsel
66,Bergstraat 71,2018-11-08,00:00:00,0,0,0,FMN GV 11 Ramsel
66,Bergstraat 71,2018-11-08,01:00:00,0,0,0,FMN GV 11 Ramsel
66,Bergstraat 71,2018-11-08,02:00:00,0,0,0,FMN GV 11 Ramsel
66,Bergstraat 71,2018-11-08,03:00:00,0,0,0,FMN GV 11 Ramsel
66,Bergstraat 71,2018-11-08,04:00:00,2,2,0,FMN GV 11 Ramsel
66,Bergstraat 71,2018-11-08,05:00:00,10,2,8,FMN GV 11 Ramsel
66,Bergstraat 71,2018-11-08,06:00:00,34,8,26,FMN GV 11 Ramsel
66,Bergstraat 71,2018-11-08,07:00:00,188,26,162,FMN GV 11 Ramsel
66,Bergstraat 71,2018-11-08,08:00:00,152,22,130,FMN GV 11 Ramsel
66,Bergstraat 71,2018-11-08,09:00:00,34,14,20,FMN GV 11 Ramsel
66,Bergstraat 71,2018-11-08,10:00:00,62,28,34,FMN GV 11 Ramsel
66,Bergstraat 71,2018-11-08,11:00:00,38,18,20,FMN GV 11 Ramsel
66,Bergstraat 71,2018-11-08,12:00:00,80,34,46,FMN GV 11 Ramsel
66,Bergstraat 71,2018-11-08,13:00:00,154,62,92,FMN GV 11 Ramsel
66,Bergstraat 71,2018-11-08,14:00:00,124,60,64,FMN GV 11 Ramsel
66,Bergstraat 71,2018-11-08,15:00:00,290,216,74,FMN GV 11 Ramsel
66,Bergstraat 71,2018-11-08,16:00:00,148,110,38,FMN GV 11 Ramsel
66,Bergstraat 71,2018-11-08,17:00:00,70,38,32,FMN GV 11 Ramsel
66,Bergstraat 71,2018-11-08,18:00:00,48,32,16,FMN GV 11 Ramsel
66,Bergstraat 71,2018-11-08,19:00:00,20,14,6,FMN GV 11 Ramsel
66,Bergstraat 71,2018-11-08,20:00:00,28,28,0,FMN GV 11 Ramsel
66,Bergstraat 71,2018-11-08,21:00:00,10,8,2,FMN GV 11 Ramsel
66,Bergstraat 71,2018-11-08,22:00:00,4,4,0,FMN GV 11 Ramsel
66,Bergstraat 71,2018-11-08,23:00:00,4,4,0,FMN GV 11 Ramsel
66,Bergstraat 71,2018-11-09,00:00:00,0,0,0,FMN GV 11 Ramsel
66,Bergstraat 71,2018-11-09,01:00:00,0,0,0,FMN GV 11 Ramsel
66,Bergstraat 71,2018-11-09,02:00:00,0,0,0,FMN GV 11 Ramsel
66,Bergstraat 71,2018-11-09,03:00:00,0,0,0,FMN GV 11 Ramsel
66,Bergstraat 71,2018-11-09,04:00:00,2,2,0,FMN GV 11 Ramsel
66,Bergstraat 71,2018-11-09,05:00:00,4,0,4,FMN GV 11 Ramsel
66,Bergstraat 71,2018-11-09,06:00:00,32,8,24,FMN GV 11 Ramsel
66,Bergstraat 71,2018-11-09,07:00:00,158,20,138,FMN GV 11 Ramsel
66,Bergstraat 71,2018-11-09,08:00:00,140,24,116,FMN GV 11 Ramsel
66,Bergstraat 71,2018-11-09,09:00:00,42,18,24,FMN GV 11 Ramsel
66,Bergstraat 71,2018-11-09,10:00:00,52,26,26,FMN GV 11 Ramsel
66,Bergstraat 71,2018-11-09,11:00:00,52,24,28,FMN GV 11 Ramsel
66,Bergstraat 71,2018-11-09,12:00:00,76,38,38,FMN GV 11 Ramsel
66,Bergstraat 71,2018-11-09,13:00:00,92,30,62,FMN GV 11 Ramsel
66,Bergstraat 71,2018-11-09,14:00:00,108,58,50,FMN GV 11 Ramsel
66,Bergstraat 71,2018-11-09,15:00:00,250,196,54,FMN GV 11 Ramsel
66,Bergstraat 71,2018-11-09,16:00:00,180,140,40,FMN GV 11 Ramsel
66,Bergstraat 71,2018-11-09,17:00:00,72,50,22,FMN GV 11 Ramsel
66,Bergstraat 71,2018-11-09,18:00:00,50,26,24,FMN GV 11 Ramsel
66,Bergstraat 71,2018-11-09,19:00:00,6,0,6,FMN GV 11 Ramsel
66,Bergstraat 71,2018-11-09,20:00:00,10,6,4,FMN GV 11 Ramsel
66,Bergstraat 71,2018-11-09,21:00:00,14,8,6,FMN GV 11 Ramsel
66,Bergstraat 71,2018-11-09,22:00:00,12,10,2,FMN GV 11 Ramsel
66,Bergstraat 71,2018-11-09,23:00:00,4,2,2,FMN GV 11 Ramsel
66,Bergstraat 71,2018-11-10,00:00:00,2,2,0,FMN GV 11 Ramsel
66,Bergstraat 71,2018-11-10,01:00:00,4,4,0,FMN GV 11 Ramsel
66,Bergstraat 71,2018-11-10,02:00:00,4,4,0,FMN GV 11 Ramsel
66,Bergstraat 71,2018-11-10,03:00:00,0,0,0,FMN GV 11 Ramsel
66,Bergstraat 71,2018-11-10,04:00:00,2,0,2,FMN GV 11 Ramsel
66,Bergstraat 71,2018-11-10,05:00:00,4,2,2,FMN GV 11 Ramsel
66,Bergstraat 71,2018-11-10,06:00:00,6,4,2,FMN GV 11 Ramsel
66,Bergstraat 71,2018-11-10,07:00:00,4,2,2,FMN GV 11 Ramsel
66,Bergstraat 71,2018-11-10,08:00:00,14,4,10,FMN GV 11 Ramsel
66,Bergstraat 71,2018-11-10,09:00:00,22,16,6,FMN GV 11 Ramsel
66,Bergstraat 71,2018-11-10,10:00:00,40,20,20,FMN GV 11 Ramsel
66,Bergstraat 71,2018-11-10,11:00:00,30,12,18,FMN GV 11 Ramsel
66,Bergstraat 71,2018-11-10,12:00:00,30,22,8,FMN GV 11 Ramsel
66,Bergstraat 71,2018-11-10,13:00:00,24,12,12,FMN GV 11 Ramsel
66,Bergstraat 71,2018-11-10,14:00:00,6,2,4,FMN GV 11 Ramsel
66,Bergstraat 71,2018-11-10,15:00:00,8,8,0,FMN GV 11 Ramsel
66,Bergstraat 71,2018-11-10,16:00:00,20,16,4,FMN GV 11 Ramsel
66,Bergstraat 71,2018-11-10,17:00:00,14,2,12,FMN GV 11 Ramsel
66,Bergstraat 71,2018-11-10,18:00:00,12,6,6,FMN GV 11 Ramsel
66,Bergstraat 71,2018-11-10,19:00:00,4,4,0,FMN GV 11 Ramsel
66,Bergstraat 71,2018-11-10,20:00:00,4,4,0,FMN GV 11 Ramsel
66,Bergstraat 71,2018-11-10,21:00:00,2,2,0,FMN GV 11 Ramsel
66,Bergstraat 71,2018-11-10,22:00:00,6,4,2,FMN GV 11 Ramsel
66,Bergstraat 71,2018-11-10,23:00:00,0,0,0,FMN GV 11 Ramsel
66,Bergstraat 71,2018-11-11,00:00:00,0,0,0,FMN GV 11 Ramsel
66,Bergstraat 71,2018-11-11,01:00:00,0,0,0,FMN GV 11 Ramsel
66,Bergstraat 71,2018-11-11,02:00:00,0,0,0,FMN GV 11 Ramsel
66,Bergstraat 71,2018-11-11,03:00:00,2,2,0,FMN GV 11 Ramsel
66,Bergstraat 71,2018-11-11,04:00:00,0,0,0,FMN GV 11 Ramsel
66,Bergstraat 71,2018-11-11,05:00:00,2,2,0,FMN GV 11 Ramsel
66,Bergstraat 71,2018-11-11,06:00:00,0,0,0,FMN GV 11 Ramsel
66,Bergstraat 71,2018-11-11,07:00:00,4,2,2,FMN GV 11 Ramsel
66,Bergstraat 71,2018-11-11,08:00:00,12,2,10,FMN GV 11 Ramsel
66,Bergstraat 71,2018-11-11,09:00:00,56,20,36,FMN GV 11 Ramsel
66,Bergstraat 71,2018-11-11,10:00:00,54,38,16,FMN GV 11 Ramsel
66,Bergstraat 71,2018-11-11,11:00:00,36,20,16,FMN GV 11 Ramsel
66,Bergstraat 71,2018-11-11,12:00:00,38,32,6,FMN GV 11 Ramsel
66,Bergstraat 71,2018-11-11,13:00:00,18,8,10,FMN GV 11 Ramsel
66,Bergstraat 71,2018-11-11,14:00:00,8,4,4,FMN GV 11 Ramsel
66,Bergstraat 71,2018-11-11,15:00:00,26,18,8,FMN GV 11 Ramsel
66,Bergstraat 71,2018-11-11,16:00:00,8,6,2,FMN GV 11 Ramsel
66,Bergstraat 71,2018-11-11,17:00:00,2,2,0,FMN GV 11 Ramsel
66,Bergstraat 71,2018-11-11,18:00:00,2,0,2,FMN GV 11 Ramsel
66,Bergstraat 71,2018-11-11,19:00:00,0,0,0,FMN GV 11 Ramsel
66,Bergstraat 71,2018-11-11,20:00:00,2,0,2,FMN GV 11 Ramsel
66,Bergstraat 71,2018-11-11,21:00:00,4,2,2,FMN GV 11 Ramsel
66,Bergstraat 71,2018-11-11,22:00:00,0,0,0,FMN GV 11 Ramsel
66,Bergstraat 71,2018-11-11,23:00:00,2,2,0,FMN GV 11 Ramsel
66,Bergstraat 71,2018-11-12,00:00:00,0,0,0,FMN GV 11 Ramsel
66,Bergstraat 71,2018-11-12,01:00:00,0,0,0,FMN GV 11 Ramsel
66,Bergstraat 71,2018-11-12,02:00:00,0,0,0,FMN GV 11 Ramsel
66,Bergstraat 71,2018-11-12,03:00:00,0,0,0,FMN GV 11 Ramsel
66,Bergstraat 71,2018-11-12,04:00:00,0,0,0,FMN GV 11 Ramsel
66,Bergstraat 71,2018-11-12,05:00:00,2,2,0,FMN GV 11 Ramsel
66,Bergstraat 71,2018-11-12,06:00:00,24,4,20,FMN GV 11 Ramsel
66,Bergstraat 71,2018-11-12,07:00:00,68,4,64,FMN GV 11 Ramsel
66,Bergstraat 71,2018-11-12,08:00:00,72,6,66,FMN GV 11 Ramsel
66,Bergstraat 71,2018-11-12,09:00:00,14,2,12,FMN GV 11 Ramsel
66,Bergstraat 71,2018-11-12,10:00:00,8,8,0,FMN GV 11 Ramsel
66,Bergstraat 71,2018-11-12,11:00:00,8,2,6,FMN GV 11 Ramsel
66,Bergstraat 71,2018-11-12,12:00:00,6,0,6,FMN GV 11 Ramsel
66,Bergstraat 71,2018-11-12,13:00:00,10,8,2,FMN GV 11 Ramsel
66,Bergstraat 71,2018-11-12,14:00:00,26,12,14,FMN GV 11 Ramsel
66,Bergstraat 71,2018-11-12,15:00:00,112,92,20,FMN GV 11 Ramsel
66,Bergstraat 71,2018-11-12,16:00:00,58,42,16,FMN GV 11 Ramsel
66,Bergstraat 71,2018-11-12,17:00:00,42,28,14,FMN GV 11 Ramsel
66,Bergstraat 71,2018-11-12,18:00:00,14,10,4,FMN GV 11 Ramsel
66,Bergstraat 71,2018-11-12,19:00:00,10,4,6,FMN GV 11 Ramsel
66,Bergstraat 71,2018-11-12,20:00:00,4,2,2,FMN GV 11 Ramsel
66,Bergstraat 71,2018-11-12,21:00:00,4,2,2,FMN GV 11 Ramsel
66,Bergstraat 71,2018-11-12,22:00:00,0,0,0,FMN GV 11 Ramsel
66,Bergstraat 71,2018-11-12,23:00:00,2,2,0,FMN GV 11 Ramsel
66,Bergstraat 71,2018-11-13,00:00:00,0,0,0,FMN GV 11 Ramsel
66,Bergstraat 71,2018-11-13,01:00:00,0,0,0,FMN GV 11 Ramsel
66,Bergstraat 71,2018-11-13,02:00:00,0,0,0,FMN GV 11 Ramsel
66,Bergstraat 71,2018-11-13,03:00:00,0,0,0,FMN GV 11 Ramsel
66,Bergstraat 71,2018-11-13,04:00:00,2,2,0,FMN GV 11 Ramsel
66,Bergstraat 71,2018-11-13,05:00:00,4,4,0,FMN GV 11 Ramsel
66,Bergstraat 71,2018-11-13,06:00:00,48,12,36,FMN GV 11 Ramsel
66,Bergstraat 71,2018-11-13,07:00:00,144,32,112,FMN GV 11 Ramsel
66,Bergstraat 71,2018-11-13,08:00:00,170,32,138,FMN GV 11 Ramsel
66,Bergstraat 71,2018-11-13,09:00:00,44,20,24,FMN GV 11 Ramsel
66,Bergstraat 71,2018-11-13,10:00:00,46,22,24,FMN GV 11 Ramsel
66,Bergstraat 71,2018-11-13,11:00:00,52,20,32,FMN GV 11 Ramsel
66,Bergstraat 71,2018-11-13,12:00:00,64,32,32,FMN GV 11 Ramsel
66,Bergstraat 71,2018-11-13,13:00:00,116,40,76,FMN GV 11 Ramsel
66,Bergstraat 71,2018-11-13,14:00:00,138,62,76,FMN GV 11 Ramsel
66,Bergstraat 71,2018-11-13,15:00:00,276,228,48,FMN GV 11 Ramsel
66,Bergstraat 71,2018-11-13,16:00:00,148,116,32,FMN GV 11 Ramsel
66,Bergstraat 71,2018-11-13,17:00:00,72,46,26,FMN GV 11 Ramsel
66,Bergstraat 71,2018-11-13,18:00:00,60,36,24,FMN GV 11 Ramsel
66,Bergstraat 71,2018-11-13,19:00:00,32,14,18,FMN GV 11 Ramsel
66,Bergstraat 71,2018-11-13,20:00:00,24,20,4,FMN GV 11 Ramsel
66,Bergstraat 71,2018-11-13,21:00:00,14,12,2,FMN GV 11 Ramsel
66,Bergstraat 71,2018-11-13,22:00:00,6,6,0,FMN GV 11 Ramsel
66,Bergstraat 71,2018-11-13,23:00:00,6,6,0,FMN GV 11 Ramsel
66,Bergstraat 71,2018-11-14,00:00:00,0,0,0,FMN GV 11 Ramsel
66,Bergstraat 71,2018-11-14,01:00:00,0,0,0,FMN GV 11 Ramsel
66,Bergstraat 71,2018-11-14,02:00:00,0,0,0,FMN GV 11 Ramsel
66,Bergstraat 71,2018-11-14,03:00:00,0,0,0,FMN GV 11 Ramsel
66,Bergstraat 71,2018-11-14,04:00:00,6,2,4,FMN GV 11 Ramsel
66,Bergstraat 71,2018-11-14,05:00:00,4,0,4,FMN GV 11 Ramsel
66,Bergstraat 71,2018-11-14,06:00:00,38,14,24,FMN GV 11 Ramsel
66,Bergstraat 71,2018-11-14,07:00:00,158,50,108,FMN GV 11 Ramsel
66,Bergstraat 71,2018-11-14,08:00:00,166,20,146,FMN GV 11 Ramsel
66,Bergstraat 71,2018-11-14,09:00:00,44,18,26,FMN GV 11 Ramsel
66,Bergstraat 71,2018-11-14,10:00:00,78,48,30,FMN GV 11 Ramsel
66,Bergstraat 71,2018-11-14,11:00:00,92,50,42,FMN GV 11 Ramsel
66,Bergstraat 71,2018-11-14,12:00:00,278,224,54,FMN GV 11 Ramsel
66,Bergstraat 71,2018-11-14,13:00:00,208,86,122,FMN GV 11 Ramsel
66,Bergstraat 71,2018-11-14,14:00:00,140,64,76,FMN GV 11 Ramsel
66,Bergstraat 71,2018-11-14,15:00:00,142,78,64,FMN GV 11 Ramsel
66,Bergstraat 71,2018-11-14,16:00:00,130,72,58,FMN GV 11 Ramsel
66,Bergstraat 71,2018-11-14,17:00:00,100,74,26,FMN GV 11 Ramsel
66,Bergstraat 71,2018-11-14,18:00:00,34,18,16,FMN GV 11 Ramsel
66,Bergstraat 71,2018-11-14,19:00:00,32,20,12,FMN GV 11 Ramsel
66,Bergstraat 71,2018-11-14,20:00:00,18,10,8,FMN GV 11 Ramsel
66,Bergstraat 71,2018-11-14,21:00:00,10,6,4,FMN GV 11 Ramsel
66,Bergstraat 71,2018-11-14,22:00:00,6,6,0,FMN GV 11 Ramsel
66,Bergstraat 71,2018-11-14,23:00:00,2,2,0,FMN GV 11 Ramsel
66,Bergstraat 71,2018-11-15,00:00:00,0,0,0,FMN GV 11 Ramsel
66,Bergstraat 71,2018-11-15,01:00:00,2,0,2,FMN GV 11 Ramsel
66,Bergstraat 71,2018-11-15,02:00:00,0,0,0,FMN GV 11 Ramsel
66,Bergstraat 71,2018-11-15,03:00:00,2,0,2,FMN GV 11 Ramsel
66,Bergstraat 71,2018-11-15,04:00:00,2,2,0,FMN GV 11 Ramsel
66,Bergstraat 71,2018-11-15,05:00:00,2,0,2,FMN GV 11 Ramsel
66,Bergstraat 71,2018-11-15,06:00:00,28,6,22,FMN GV 11 Ramsel
66,Bergstraat 71,2018-11-15,07:00:00,124,30,94,FMN GV 11 Ramsel
66,Bergstraat 71,2018-11-15,08:00:00,172,42,130,FMN GV 11 Ramsel
66,Bergstraat 71,2018-11-15,09:00:00,48,16,32,FMN GV 11 Ramsel
66,Bergstraat 71,2018-11-15,10:00:00,60,28,32,FMN GV 11 Ramsel
66,Bergstraat 71,2018-11-15,11:00:00,72,38,34,FMN GV 11 Ramsel
66,Bergstraat 71,2018-11-15,12:00:00,112,54,58,FMN GV 11 Ramsel
66,Bergstraat 71,2018-11-15,13:00:00,156,76,80,FMN GV 11 Ramsel
66,Bergstraat 71,2018-11-15,14:00:00,224,146,78,FMN GV 11 Ramsel
66,Bergstraat 71,2018-11-15,15:00:00,330,222,108,FMN GV 11 Ramsel
66,Bergstraat 71,2018-11-15,16:00:00,196,142,54,FMN GV 11 Ramsel
66,Bergstraat 71,2018-11-15,17:00:00,72,44,28,FMN GV 11 Ramsel
66,Bergstraat 71,2018-11-15,18:00:00,62,28,34,FMN GV 11 Ramsel
66,Bergstraat 71,2018-11-15,19:00:00,26,16,10,FMN GV 11 Ramsel
66,Bergstraat 71,2018-11-15,20:00:00,32,26,6,FMN GV 11 Ramsel
66,Bergstraat 71,2018-11-15,21:00:00,8,6,2,FMN GV 11 Ramsel
66,Bergstraat 71,2018-11-15,22:00:00,6,6,0,FMN GV 11 Ramsel
66,Bergstraat 71,2018-11-15,23:00:00,2,2,0,FMN GV 11 Ramsel
66,Bergstraat 71,2018-11-16,00:00:00,2,2,0,FMN GV 11 Ramsel
66,Bergstraat 71,2018-11-16,01:00:00,0,0,0,FMN GV 11 Ramsel
66,Bergstraat 71,2018-11-16,02:00:00,0,0,0,FMN GV 11 Ramsel
66,Bergstraat 71,2018-11-16,03:00:00,0,0,0,FMN GV 11 Ramsel
66,Bergstraat 71,2018-11-16,04:00:00,2,2,0,FMN GV 11 Ramsel
66,Bergstraat 71,2018-11-16,05:00:00,0,0,0,FMN GV 11 Ramsel
66,Bergstraat 71,2018-11-16,06:00:00,30,8,22,FMN GV 11 Ramsel
66,Bergstraat 71,2018-11-16,07:00:00,124,16,108,FMN GV 11 Ramsel
66,Bergstraat 71,2018-11-16,08:00:00,168,22,146,FMN GV 11 Ramsel
66,Bergstraat 71,2018-11-16,09:00:00,18,4,14,FMN GV 11 Ramsel
66,Bergstraat 71,2018-11-16,10:00:00,34,18,16,FMN GV 11 Ramsel
66,Bergstraat 71,2018-11-16,11:00:00,28,16,12,FMN GV 11 Ramsel
66,Bergstraat 71,2018-11-16,12:00:00,42,26,16,FMN GV 11 Ramsel
66,Bergstraat 71,2018-11-16,13:00:00,46,16,30,FMN GV 11 Ramsel
66,Bergstraat 71,2018-11-16,14:00:00,76,38,38,FMN GV 11 Ramsel
66,Bergstraat 71,2018-11-16,15:00:00,196,152,44,FMN GV 11 Ramsel
66,Bergstraat 71,2018-11-16,16:00:00,108,88,20,FMN GV 11 Ramsel
66,Bergstraat 71,2018-11-16,17:00:00,56,44,12,FMN GV 11 Ramsel
66,Bergstraat 71,2018-11-16,18:00:00,24,22,2,FMN GV 11 Ramsel
66,Bergstraat 71,2018-11-16,19:00:00,16,6,10,FMN GV 11 Ramsel
66,Bergstraat 71,2018-11-16,20:00:00,6,2,4,FMN GV 11 Ramsel
66,Bergstraat 71,2018-11-16,21:00:00,2,2,0,FMN GV 11 Ramsel
66,Bergstraat 71,2018-11-16,22:00:00,6,6,0,FMN GV 11 Ramsel
66,Bergstraat 71,2018-11-16,23:00:00,0,0,0,FMN GV 11 Ramsel
66,Bergstraat 71,2018-11-17,00:00:00,2,2,0,FMN GV 11 Ramsel
66,Bergstraat 71,2018-11-17,01:00:00,0,0,0,FMN GV 11 Ramsel
66,Bergstraat 71,2018-11-17,02:00:00,2,2,0,FMN GV 11 Ramsel
66,Bergstraat 71,2018-11-17,03:00:00,0,0,0,FMN GV 11 Ramsel
66,Bergstraat 71,2018-11-17,04:00:00,2,2,0,FMN GV 11 Ramsel
66,Bergstraat 71,2018-11-17,05:00:00,2,0,2,FMN GV 11 Ramsel
66,Bergstraat 71,2018-11-17,06:00:00,0,0,0,FMN GV 11 Ramsel
66,Bergstraat 71,2018-11-17,07:00:00,2,2,0,FMN GV 11 Ramsel
66,Bergstraat 71,2018-11-17,08:00:00,12,0,12,FMN GV 11 Ramsel
66,Bergstraat 71,2018-11-17,09:00:00,24,8,16,FMN GV 11 Ramsel
66,Bergstraat 71,2018-11-17,10:00:00,52,30,22,FMN GV 11 Ramsel
66,Bergstraat 71,2018-11-17,11:00:00,76,34,42,FMN GV 11 Ramsel
66,Bergstraat 71,2018-11-17,12:00:00,60,34,26,FMN GV 11 Ramsel
66,Bergstraat 71,2018-11-17,13:00:00,82,28,54,FMN GV 11 Ramsel
66,Bergstraat 71,2018-11-17,14:00:00,120,66,54,FMN GV 11 Ramsel
66,Bergstraat 71,2018-11-17,15:00:00,82,46,36,FMN GV 11 Ramsel
66,Bergstraat 71,2018-11-17,16:00:00,70,44,26,FMN GV 11 Ramsel
66,Bergstraat 71,2018-11-17,17:00:00,26,8,18,FMN GV 11 Ramsel
66,Bergstraat 71,2018-11-17,18:00:00,10,8,2,FMN GV 11 Ramsel
66,Bergstraat 71,2018-11-17,19:00:00,10,2,8,FMN GV 11 Ramsel
66,Bergstraat 71,2018-11-17,20:00:00,14,4,10,FMN GV 11 Ramsel
66,Bergstraat 71,2018-11-17,21:00:00,6,2,4,FMN GV 11 Ramsel
66,Bergstraat 71,2018-11-17,22:00:00,6,2,4,FMN GV 11 Ramsel
66,Bergstraat 71,2018-11-17,23:00:00,6,6,0,FMN GV 11 Ramsel
66,Bergstraat 71,2018-11-18,00:00:00,4,4,0,FMN GV 11 Ramsel
66,Bergstraat 71,2018-11-18,01:00:00,2,2,0,FMN GV 11 Ramsel
66,Bergstraat 71,2018-11-18,02:00:00,0,0,0,FMN GV 11 Ramsel
66,Bergstraat 71,2018-11-18,03:00:00,2,0,2,FMN GV 11 Ramsel
66,Bergstraat 71,2018-11-18,04:00:00,4,4,0,FMN GV 11 Ramsel
66,Bergstraat 71,2018-11-18,05:00:00,0,0,0,FMN GV 11 Ramsel
66,Bergstraat 71,2018-11-18,06:00:00,0,0,0,FMN GV 11 Ramsel
66,Bergstraat 71,2018-11-18,07:00:00,6,2,4,FMN GV 11 Ramsel
66,Bergstraat 71,2018-11-18,08:00:00,16,10,6,FMN GV 11 Ramsel
66,Bergstraat 71,2018-11-18,09:00:00,40,12,28,FMN GV 11 Ramsel
66,Bergstraat 71,2018-11-18,10:00:00,62,36,26,FMN GV 11 Ramsel
66,Bergstraat 71,2018-11-18,11:00:00,78,56,22,FMN GV 11 Ramsel
66,Bergstraat 71,2018-11-18,12:00:00,74,48,26,FMN GV 11 Ramsel
66,Bergstraat 71,2018-11-18,13:00:00,34,12,22,FMN GV 11 Ramsel
66,Bergstraat 71,2018-11-18,14:00:00,100,42,58,FMN GV 11 Ramsel
66,Bergstraat 71,2018-11-18,15:00:00,60,32,28,FMN GV 11 Ramsel
66,Bergstraat 71,2018-11-18,16:00:00,36,26,10,FMN GV 11 Ramsel
66,Bergstraat 71,2018-11-18,17:00:00,18,8,10,FMN GV 11 Ramsel
66,Bergstraat 71,2018-11-18,18:00:00,10,6,4,FMN GV 11 Ramsel
66,Bergstraat 71,2018-11-18,19:00:00,4,2,2,FMN GV 11 Ramsel
66,Bergstraat 71,2018-11-18,20:00:00,12,4,8,FMN GV 11 Ramsel
66,Bergstraat 71,2018-11-18,21:00:00,2,2,0,FMN GV 11 Ramsel
66,Bergstraat 71,2018-11-18,22:00:00,2,2,0,FMN GV 11 Ramsel
66,Bergstraat 71,2018-11-18,23:00:00,2,2,0,FMN GV 11 Ramsel
66,Bergstraat 71,2018-11-19,00:00:00,0,0,0,FMN GV 11 Ramsel
66,Bergstraat 71,2018-11-19,01:00:00,0,0,0,FMN GV 11 Ramsel
66,Bergstraat 71,2018-11-19,02:00:00,0,0,0,FMN GV 11 Ramsel
66,Bergstraat 71,2018-11-19,03:00:00,0,0,0,FMN GV 11 Ramsel
66,Bergstraat 71,2018-11-19,04:00:00,0,0,0,FMN GV 11 Ramsel
66,Bergstraat 71,2018-11-19,05:00:00,2,0,2,FMN GV 11 Ramsel
66,Bergstraat 71,2018-11-19,06:00:00,40,8,32,FMN GV 11 Ramsel
66,Bergstraat 71,2018-11-19,07:00:00,134,20,114,FMN GV 11 Ramsel
66,Bergstraat 71,2018-11-19,08:00:00,130,20,110,FMN GV 11 Ramsel
66,Bergstraat 71,2018-11-19,09:00:00,36,6,30,FMN GV 11 Ramsel
66,Bergstraat 71,2018-11-19,10:00:00,46,24,22,FMN GV 11 Ramsel
66,Bergstraat 71,2018-11-19,11:00:00,18,8,10,FMN GV 11 Ramsel
66,Bergstraat 71,2018-11-19,12:00:00,48,38,10,FMN GV 11 Ramsel
66,Bergstraat 71,2018-11-19,13:00:00,36,6,30,FMN GV 11 Ramsel
66,Bergstraat 71,2018-11-19,14:00:00,32,20,12,FMN GV 11 Ramsel
66,Bergstraat 71,2018-11-19,15:00:00,164,144,20,FMN GV 11 Ramsel
66,Bergstraat 71,2018-11-19,16:00:00,100,90,10,FMN GV 11 Ramsel
66,Bergstraat 71,2018-11-19,17:00:00,46,36,10,FMN GV 11 Ramsel
66,Bergstraat 71,2018-11-19,18:00:00,34,24,10,FMN GV 11 Ramsel
66,Bergstraat 71,2018-11-19,19:00:00,24,14,10,FMN GV 11 Ramsel
66,Bergstraat 71,2018-11-19,20:00:00,4,2,2,FMN GV 11 Ramsel
66,Bergstraat 71,2018-11-19,21:00:00,4,0,4,FMN GV 11 Ramsel
66,Bergstraat 71,2018-11-19,22:00:00,6,4,2,FMN GV 11 Ramsel
66,Bergstraat 71,2018-11-19,23:00:00,0,0,0,FMN GV 11 Ramsel
66,Bergstraat 71,2018-11-20,00:00:00,0,0,0,FMN GV 11 Ramsel
66,Bergstraat 71,2018-11-20,01:00:00,0,0,0,FMN GV 11 Ramsel
66,Bergstraat 71,2018-11-20,02:00:00,0,0,0,FMN GV 11 Ramsel
66,Bergstraat 71,2018-11-20,03:00:00,0,0,0,FMN GV 11 Ramsel
66,Bergstraat 71,2018-11-20,04:00:00,4,2,2,FMN GV 11 Ramsel
66,Bergstraat 71,2018-11-20,05:00:00,0,0,0,FMN GV 11 Ramsel
66,Bergstraat 71,2018-11-20,06:00:00,34,10,24,FMN GV 11 Ramsel
66,Bergstraat 71,2018-11-20,07:00:00,112,22,90,FMN GV 11 Ramsel
66,Bergstraat 71,2018-11-20,08:00:00,164,22,142,FMN GV 11 Ramsel
66,Bergstraat 71,2018-11-20,09:00:00,30,12,18,FMN GV 11 Ramsel
66,Bergstraat 71,2018-11-20,10:00:00,8,6,2,FMN GV 11 Ramsel
66,Bergstraat 71,2018-11-20,11:00:00,12,8,4,FMN GV 11 Ramsel
66,Bergstraat 71,2018-11-20,12:00:00,42,28,14,FMN GV 11 Ramsel
66,Bergstraat 71,2018-11-20,13:00:00,52,18,34,FMN GV 11 Ramsel
66,Bergstraat 71,2018-11-20,14:00:00,28,14,14,FMN GV 11 Ramsel
66,Bergstraat 71,2018-11-20,15:00:00,158,140,18,FMN GV 11 Ramsel
66,Bergstraat 71,2018-11-20,16:00:00,120,104,16,FMN GV 11 Ramsel
66,Bergstraat 71,2018-11-20,17:00:00,60,36,24,FMN GV 11 Ramsel
66,Bergstraat 71,2018-11-20,18:00:00,26,14,12,FMN GV 11 Ramsel
66,Bergstraat 71,2018-11-20,19:00:00,32,16,16,FMN GV 11 Ramsel
66,Bergstraat 71,2018-11-20,20:00:00,18,10,8,FMN GV 11 Ramsel
66,Bergstraat 71,2018-11-20,21:00:00,12,6,6,FMN GV 11 Ramsel
66,Bergstraat 71,2018-11-20,22:00:00,14,6,8,FMN GV 11 Ramsel
66,Bergstraat 71,2018-11-20,23:00:00,2,2,0,FMN GV 11 Ramsel
66,Bergstraat 71,2018-11-21,00:00:00,2,2,0,FMN GV 11 Ramsel
66,Bergstraat 71,2018-11-21,01:00:00,0,0,0,FMN GV 11 Ramsel
66,Bergstraat 71,2018-11-21,02:00:00,0,0,0,FMN GV 11 Ramsel
66,Bergstraat 71,2018-11-21,03:00:00,2,0,2,FMN GV 11 Ramsel
66,Bergstraat 71,2018-11-21,04:00:00,2,2,0,FMN GV 11 Ramsel
66,Bergstraat 71,2018-11-21,05:00:00,4,2,2,FMN GV 11 Ramsel
66,Bergstraat 71,2018-11-21,06:00:00,22,6,16,FMN GV 11 Ramsel
66,Bergstraat 71,2018-11-21,07:00:00,104,16,88,FMN GV 11 Ramsel
66,Bergstraat 71,2018-11-21,08:00:00,170,34,136,FMN GV 11 Ramsel
66,Bergstraat 71,2018-11-21,09:00:00,16,8,8,FMN GV 11 Ramsel
66,Bergstraat 71,2018-11-21,10:00:00,32,14,18,FMN GV 11 Ramsel
66,Bergstraat 71,2018-11-21,11:00:00,42,16,26,FMN GV 11 Ramsel
66,Bergstraat 71,2018-11-21,12:00:00,192,156,36,FMN GV 11 Ramsel
66,Bergstraat 71,2018-11-21,13:00:00,62,40,22,FMN GV 11 Ramsel
66,Bergstraat 71,2018-11-21,14:00:00,68,34,34,FMN GV 11 Ramsel
66,Bergstraat 71,2018-11-21,15:00:00,52,36,16,FMN GV 11 Ramsel
66,Bergstraat 71,2018-11-21,16:00:00,62,26,36,FMN GV 11 Ramsel
66,Bergstraat 71,2018-11-21,17:00:00,56,36,20,FMN GV 11 Ramsel
66,Bergstraat 71,2018-11-21,18:00:00,36,22,14,FMN GV 11 Ramsel
66,Bergstraat 71,2018-11-21,19:00:00,30,12,18,FMN GV 11 Ramsel
66,Bergstraat 71,2018-11-21,20:00:00,10,8,2,FMN GV 11 Ramsel
66,Bergstraat 71,2018-11-21,21:00:00,8,4,4,FMN GV 11 Ramsel
66,Bergstraat 71,2018-11-21,22:00:00,2,2,0,FMN GV 11 Ramsel
66,Bergstraat 71,2018-11-21,23:00:00,2,2,0,FMN GV 11 Ramsel
66,Bergstraat 71,2018-11-22,00:00:00,0,0,0,FMN GV 11 Ramsel
66,Bergstraat 71,2018-11-22,01:00:00,0,0,0,FMN GV 11 Ramsel
66,Bergstraat 71,2018-11-22,02:00:00,0,0,0,FMN GV 11 Ramsel
66,Bergstraat 71,2018-11-22,03:00:00,0,0,0,FMN GV 11 Ramsel
66,Bergstraat 71,2018-11-22,04:00:00,2,2,0,FMN GV 11 Ramsel
66,Bergstraat 71,2018-11-22,05:00:00,6,4,2,FMN GV 11 Ramsel
66,Bergstraat 71,2018-11-22,06:00:00,28,12,16,FMN GV 11 Ramsel
66,Bergstraat 71,2018-11-22,07:00:00,136,14,122,FMN GV 11 Ramsel
66,Bergstraat 71,2018-11-22,08:00:00,150,20,130,FMN GV 11 Ramsel
66,Bergstraat 71,2018-11-22,09:00:00,20,10,10,FMN GV 11 Ramsel
66,Bergstraat 71,2018-11-22,10:00:00,42,18,24,FMN GV 11 Ramsel
66,Bergstraat 71,2018-11-22,11:00:00,32,14,18,FMN GV 11 Ramsel
66,Bergstraat 71,2018-11-22,12:00:00,62,38,24,FMN GV 11 Ramsel
66,Bergstraat 71,2018-11-22,13:00:00,108,60,48,FMN GV 11 Ramsel
66,Bergstraat 71,2018-11-22,14:00:00,72,34,38,FMN GV 11 Ramsel
66,Bergstraat 71,2018-11-22,15:00:00,190,152,38,FMN GV 11 Ramsel
66,Bergstraat 71,2018-11-22,16:00:00,150,106,44,FMN GV 11 Ramsel
66,Bergstraat 71,2018-11-22,17:00:00,46,32,14,FMN GV 11 Ramsel
66,Bergstraat 71,2018-11-22,18:00:00,42,24,18,FMN GV 11 Ramsel
66,Bergstraat 71,2018-11-22,19:00:00,30,22,8,FMN GV 11 Ramsel
66,Bergstraat 71,2018-11-22,20:00:00,10,8,2,FMN GV 11 Ramsel
66,Bergstraat 71,2018-11-22,21:00:00,22,20,2,FMN GV 11 Ramsel
66,Bergstraat 71,2018-11-22,22:00:00,0,0,0,FMN GV 11 Ramsel
66,Bergstraat 71,2018-11-22,23:00:00,4,4,0,FMN GV 11 Ramsel
66,Bergstraat 71,2018-11-23,00:00:00,0,0,0,FMN GV 11 Ramsel
66,Bergstraat 71,2018-11-23,01:00:00,0,0,0,FMN GV 11 Ramsel
66,Bergstraat 71,2018-11-23,02:00:00,0,0,0,FMN GV 11 Ramsel
66,Bergstraat 71,2018-11-23,03:00:00,0,0,0,FMN GV 11 Ramsel
66,Bergstraat 71,2018-11-23,04:00:00,2,0,2,FMN GV 11 Ramsel
66,Bergstraat 71,2018-11-23,05:00:00,2,2,0,FMN GV 11 Ramsel
66,Bergstraat 71,2018-11-23,06:00:00,16,4,12,FMN GV 11 Ramsel
66,Bergstraat 71,2018-11-23,07:00:00,124,22,102,FMN GV 11 Ramsel
66,Bergstraat 71,2018-11-23,08:00:00,130,24,106,FMN GV 11 Ramsel
66,Bergstraat 71,2018-11-23,09:00:00,36,16,20,FMN GV 11 Ramsel
66,Bergstraat 71,2018-11-23,10:00:00,44,26,18,FMN GV 11 Ramsel
66,Bergstraat 71,2018-11-23,11:00:00,34,22,12,FMN GV 11 Ramsel
66,Bergstraat 71,2018-11-23,12:00:00,74,26,48,FMN GV 11 Ramsel
66,Bergstraat 71,2018-11-23,13:00:00,70,30,40,FMN GV 11 Ramsel
66,Bergstraat 71,2018-11-23,14:00:00,142,70,72,FMN GV 11 Ramsel
66,Bergstraat 71,2018-11-23,15:00:00,192,152,40,FMN GV 11 Ramsel
66,Bergstraat 71,2018-11-23,16:00:00,98,76,22,FMN GV 11 Ramsel
66,Bergstraat 71,2018-11-23,17:00:00,58,48,10,FMN GV 11 Ramsel
66,Bergstraat 71,2018-11-23,18:00:00,34,18,16,FMN GV 11 Ramsel
66,Bergstraat 71,2018-11-23,19:00:00,18,12,6,FMN GV 11 Ramsel
66,Bergstraat 71,2018-11-23,20:00:00,10,4,6,FMN GV 11 Ramsel
66,Bergstraat 71,2018-11-23,21:00:00,10,10,0,FMN GV 11 Ramsel
66,Bergstraat 71,2018-11-23,22:00:00,6,2,4,FMN GV 11 Ramsel
66,Bergstraat 71,2018-11-23,23:00:00,4,2,2,FMN GV 11 Ramsel
66,Bergstraat 71,2018-11-24,00:00:00,0,0,0,FMN GV 11 Ramsel
66,Bergstraat 71,2018-11-24,01:00:00,4,2,2,FMN GV 11 Ramsel
66,Bergstraat 71,2018-11-24,02:00:00,4,4,0,FMN GV 11 Ramsel
66,Bergstraat 71,2018-11-24,03:00:00,2,2,0,FMN GV 11 Ramsel
66,Bergstraat 71,2018-11-24,04:00:00,0,0,0,FMN GV 11 Ramsel
66,Bergstraat 71,2018-11-24,05:00:00,0,0,0,FMN GV 11 Ramsel
66,Bergstraat 71,2018-11-24,06:00:00,6,4,2,FMN GV 11 Ramsel
66,Bergstraat 71,2018-11-24,07:00:00,4,2,2,FMN GV 11 Ramsel
66,Bergstraat 71,2018-11-24,08:00:00,12,2,10,FMN GV 11 Ramsel
66,Bergstraat 71,2018-11-24,09:00:00,10,6,4,FMN GV 11 Ramsel
66,Bergstraat 71,2018-11-24,10:00:00,20,8,12,FMN GV 11 Ramsel
66,Bergstraat 71,2018-11-24,11:00:00,4,0,4,FMN GV 11 Ramsel
66,Bergstraat 71,2018-11-24,12:00:00,10,4,6,FMN GV 11 Ramsel
66,Bergstraat 71,2018-11-24,13:00:00,22,8,14,FMN GV 11 Ramsel
66,Bergstraat 71,2018-11-24,14:00:00,16,2,14,FMN GV 11 Ramsel
66,Bergstraat 71,2018-11-24,15:00:00,24,10,14,FMN GV 11 Ramsel
66,Bergstraat 71,2018-11-24,16:00:00,4,4,0,FMN GV 11 Ramsel
66,Bergstraat 71,2018-11-24,17:00:00,8,4,4,FMN GV 11 Ramsel
66,Bergstraat 71,2018-11-24,18:00:00,2,0,2,FMN GV 11 Ramsel
66,Bergstraat 71,2018-11-24,19:00:00,4,0,4,FMN GV 11 Ramsel
66,Bergstraat 71,2018-11-24,20:00:00,2,0,2,FMN GV 11 Ramsel
66,Bergstraat 71,2018-11-24,21:00:00,2,2,0,FMN GV 11 Ramsel
66,Bergstraat 71,2018-11-24,22:00:00,6,4,2,FMN GV 11 Ramsel
66,Bergstraat 71,2018-11-24,23:00:00,4,2,2,FMN GV 11 Ramsel
66,Bergstraat 71,2018-11-25,00:00:00,2,0,2,FMN GV 11 Ramsel
66,Bergstraat 71,2018-11-25,01:00:00,0,0,0,FMN GV 11 Ramsel
66,Bergstraat 71,2018-11-25,02:00:00,0,0,0,FMN GV 11 Ramsel
66,Bergstraat 71,2018-11-25,03:00:00,0,0,0,FMN GV 11 Ramsel
66,Bergstraat 71,2018-11-25,04:00:00,0,0,0,FMN GV 11 Ramsel
66,Bergstraat 71,2018-11-25,05:00:00,0,0,0,FMN GV 11 Ramsel
66,Bergstraat 71,2018-11-25,06:00:00,0,0,0,FMN GV 11 Ramsel
66,Bergstraat 71,2018-11-25,07:00:00,4,0,4,FMN GV 11 Ramsel
66,Bergstraat 71,2018-11-25,08:00:00,38,16,22,FMN GV 11 Ramsel
66,Bergstraat 71,2018-11-25,09:00:00,92,26,66,FMN GV 11 Ramsel
66,Bergstraat 71,2018-11-25,10:00:00,76,46,30,FMN GV 11 Ramsel
66,Bergstraat 71,2018-11-25,11:00:00,78,46,32,FMN GV 11 Ramsel
66,Bergstraat 71,2018-11-25,12:00:00,64,38,26,FMN GV 11 Ramsel
66,Bergstraat 71,2018-11-25,13:00:00,36,16,20,FMN GV 11 Ramsel
66,Bergstraat 71,2018-11-25,14:00:00,70,26,44,FMN GV 11 Ramsel
66,Bergstraat 71,2018-11-25,15:00:00,18,12,6,FMN GV 11 Ramsel
66,Bergstraat 71,2018-11-25,16:00:00,22,12,10,FMN GV 11 Ramsel
66,Bergstraat 71,2018-11-25,17:00:00,16,4,12,FMN GV 11 Ramsel
66,Bergstraat 71,2018-11-25,18:00:00,8,0,8,FMN GV 11 Ramsel
66,Bergstraat 71,2018-11-25,19:00:00,10,2,8,FMN GV 11 Ramsel
66,Bergstraat 71,2018-11-25,20:00:00,2,2,0,FMN GV 11 Ramsel
66,Bergstraat 71,2018-11-25,21:00:00,6,2,4,FMN GV 11 Ramsel
66,Bergstraat 71,2018-11-25,22:00:00,0,0,0,FMN GV 11 Ramsel
66,Bergstraat 71,2018-11-25,23:00:00,2,2,0,FMN GV 11 Ramsel
66,Bergstraat 71,2018-11-26,00:00:00,0,0,0,FMN GV 11 Ramsel
66,Bergstraat 71,2018-11-26,01:00:00,0,0,0,FMN GV 11 Ramsel
66,Bergstraat 71,2018-11-26,02:00:00,2,2,0,FMN GV 11 Ramsel
66,Bergstraat 71,2018-11-26,03:00:00,0,0,0,FMN GV 11 Ramsel
66,Bergstraat 71,2018-11-26,04:00:00,0,0,0,FMN GV 11 Ramsel
66,Bergstraat 71,2018-11-26,05:00:00,2,2,0,FMN GV 11 Ramsel
66,Bergstraat 71,2018-11-26,06:00:00,26,8,18,FMN GV 11 Ramsel
66,Bergstraat 71,2018-11-26,07:00:00,98,16,82,FMN GV 11 Ramsel
66,Bergstraat 71,2018-11-26,08:00:00,120,12,108,FMN GV 11 Ramsel
66,Bergstraat 71,2018-11-26,09:00:00,12,2,10,FMN GV 11 Ramsel
66,Bergstraat 71,2018-11-26,10:00:00,12,6,6,FMN GV 11 Ramsel
66,Bergstraat 71,2018-11-26,11:00:00,14,6,8,FMN GV 11 Ramsel
66,Bergstraat 71,2018-11-26,12:00:00,26,18,8,FMN GV 11 Ramsel
66,Bergstraat 71,2018-11-26,13:00:00,18,6,12,FMN GV 11 Ramsel
66,Bergstraat 71,2018-11-26,14:00:00,20,10,10,FMN GV 11 Ramsel
66,Bergstraat 71,2018-11-26,15:00:00,146,128,18,FMN GV 11 Ramsel
66,Bergstraat 71,2018-11-26,16:00:00,72,62,10,FMN GV 11 Ramsel
66,Bergstraat 71,2018-11-26,17:00:00,50,40,10,FMN GV 11 Ramsel
66,Bergstraat 71,2018-11-26,18:00:00,24,18,6,FMN GV 11 Ramsel
66,Bergstraat 71,2018-11-26,19:00:00,12,4,8,FMN GV 11 Ramsel
66,Bergstraat 71,2018-11-26,20:00:00,20,10,10,FMN GV 11 Ramsel
66,Bergstraat 71,2018-11-26,21:00:00,0,0,0,FMN GV 11 Ramsel
66,Bergstraat 71,2018-11-26,22:00:00,4,2,2,FMN GV 11 Ramsel
66,Bergstraat 71,2018-11-26,23:00:00,2,2,0,FMN GV 11 Ramsel
66,Bergstraat 71,2018-11-27,00:00:00,0,0,0,FMN GV 11 Ramsel
66,Bergstraat 71,2018-11-27,01:00:00,0,0,0,FMN GV 11 Ramsel
66,Bergstraat 71,2018-11-27,02:00:00,0,0,0,FMN GV 11 Ramsel
66,Bergstraat 71,2018-11-27,03:00:00,2,0,2,FMN GV 11 Ramsel
66,Bergstraat 71,2018-11-27,04:00:00,2,2,0,FMN GV 11 Ramsel
66,Bergstraat 71,2018-11-27,05:00:00,2,0,2,FMN GV 11 Ramsel
66,Bergstraat 71,2018-11-27,06:00:00,30,12,18,FMN GV 11 Ramsel
66,Bergstraat 71,2018-11-27,07:00:00,130,22,108,FMN GV 11 Ramsel
66,Bergstraat 71,2018-11-27,08:00:00,152,30,122,FMN GV 11 Ramsel
66,Bergstraat 71,2018-11-27,09:00:00,54,18,36,FMN GV 11 Ramsel
66,Bergstraat 71,2018-11-27,10:00:00,30,26,4,FMN GV 11 Ramsel
66,Bergstraat 71,2018-11-27,11:00:00,28,12,16,FMN GV 11 Ramsel
66,Bergstraat 71,2018-11-27,12:00:00,60,28,32,FMN GV 11 Ramsel
66,Bergstraat 71,2018-11-27,13:00:00,92,54,38,FMN GV 11 Ramsel
66,Bergstraat 71,2018-11-27,14:00:00,54,36,18,FMN GV 11 Ramsel
66,Bergstraat 71,2018-11-27,15:00:00,170,136,34,FMN GV 11 Ramsel
66,Bergstraat 71,2018-11-27,16:00:00,160,116,44,FMN GV 11 Ramsel
66,Bergstraat 71,2018-11-27,17:00:00,70,46,24,FMN GV 11 Ramsel
66,Bergstraat 71,2018-11-27,18:00:00,44,22,22,FMN GV 11 Ramsel
66,Bergstraat 71,2018-11-27,19:00:00,32,10,22,FMN GV 11 Ramsel
66,Bergstraat 71,2018-11-27,20:00:00,36,24,12,FMN GV 11 Ramsel
66,Bergstraat 71,2018-11-27,21:00:00,8,4,4,FMN GV 11 Ramsel
66,Bergstraat 71,2018-11-27,22:00:00,8,8,0,FMN GV 11 Ramsel
66,Bergstraat 71,2018-11-27,23:00:00,4,2,2,FMN GV 11 Ramsel
66,Bergstraat 71,2018-11-28,00:00:00,0,0,0,FMN GV 11 Ramsel
66,Bergstraat 71,2018-11-28,01:00:00,0,0,0,FMN GV 11 Ramsel
66,Bergstraat 71,2018-11-28,02:00:00,0,0,0,FMN GV 11 Ramsel
66,Bergstraat 71,2018-11-28,03:00:00,0,0,0,FMN GV 11 Ramsel
66,Bergstraat 71,2018-11-28,04:00:00,2,2,0,FMN GV 11 Ramsel
66,Bergstraat 71,2018-11-28,05:00:00,0,0,0,FMN GV 11 Ramsel
66,Bergstraat 71,2018-11-28,06:00:00,18,4,14,FMN GV 11 Ramsel
66,Bergstraat 71,2018-11-28,07:00:00,112,22,90,FMN GV 11 Ramsel
66,Bergstraat 71,2018-11-28,08:00:00,128,20,108,FMN GV 11 Ramsel
66,Bergstraat 71,2018-11-28,09:00:00,14,4,10,FMN GV 11 Ramsel
66,Bergstraat 71,2018-11-28,10:00:00,14,10,4,FMN GV 11 Ramsel
66,Bergstraat 71,2018-11-28,11:00:00,22,8,14,FMN GV 11 Ramsel
66,Bergstraat 71,2018-11-28,12:00:00,190,166,24,FMN GV 11 Ramsel
66,Bergstraat 71,2018-11-28,13:00:00,36,24,12,FMN GV 11 Ramsel
66,Bergstraat 71,2018-11-28,14:00:00,24,10,14,FMN GV 11 Ramsel
66,Bergstraat 71,2018-11-28,15:00:00,36,22,14,FMN GV 11 Ramsel
66,Bergstraat 71,2018-11-28,16:00:00,28,14,14,FMN GV 11 Ramsel
66,Bergstraat 71,2018-11-28,17:00:00,36,22,14,FMN GV 11 Ramsel
66,Bergstraat 71,2018-11-28,18:00:00,28,14,14,FMN GV 11 Ramsel
66,Bergstraat 71,2018-11-28,19:00:00,10,8,2,FMN GV 11 Ramsel
66,Bergstraat 71,2018-11-28,20:00:00,22,14,8,FMN GV 11 Ramsel
66,Bergstraat 71,2018-11-28,21:00:00,6,6,0,FMN GV 11 Ramsel
66,Bergstraat 71,2018-11-28,22:00:00,6,6,0,FMN GV 11 Ramsel
66,Bergstraat 71,2018-11-28,23:00:00,0,0,0,FMN GV 11 Ramsel
66,Bergstraat 71,2018-11-29,00:00:00,2,2,0,FMN GV 11 Ramsel
66,Bergstraat 71,2018-11-29,01:00:00,2,2,0,FMN GV 11 Ramsel
66,Bergstraat 71,2018-11-29,02:00:00,0,0,0,FMN GV 11 Ramsel
66,Bergstraat 71,2018-11-29,03:00:00,0,0,0,FMN GV 11 Ramsel
66,Bergstraat 71,2018-11-29,04:00:00,2,2,0,FMN GV 11 Ramsel
66,Bergstraat 71,2018-11-29,05:00:00,2,0,2,FMN GV 11 Ramsel
66,Bergstraat 71,2018-11-29,06:00:00,26,4,22,FMN GV 11 Ramsel
66,Bergstraat 71,2018-11-29,07:00:00,106,12,94,FMN GV 11 Ramsel
66,Bergstraat 71,2018-11-29,08:00:00,146,16,130,FMN GV 11 Ramsel
66,Bergstraat 71,2018-11-29,09:00:00,14,14,0,FMN GV 11 Ramsel
66,Bergstraat 71,2018-11-29,10:00:00,24,12,12,FMN GV 11 Ramsel
66,Bergstraat 71,2018-11-29,11:00:00,14,4,10,FMN GV 11 Ramsel
66,Bergstraat 71,2018-11-29,12:00:00,42,30,12,FMN GV 11 Ramsel
66,Bergstraat 71,2018-11-29,13:00:00,12,6,6,FMN GV 11 Ramsel
66,Bergstraat 71,2018-11-29,14:00:00,76,42,34,FMN GV 11 Ramsel
66,Bergstraat 71,2018-11-29,15:00:00,196,150,46,FMN GV 11 Ramsel
66,Bergstraat 71,2018-11-29,16:00:00,114,82,32,FMN GV 11 Ramsel
66,Bergstraat 71,2018-11-29,17:00:00,46,24,22,FMN GV 11 Ramsel
66,Bergstraat 71,2018-11-29,18:00:00,42,28,14,FMN GV 11 Ramsel
66,Bergstraat 71,2018-11-29,19:00:00,38,20,18,FMN GV 11 Ramsel
66,Bergstraat 71,2018-11-29,20:00:00,14,6,8,FMN GV 11 Ramsel
66,Bergstraat 71,2018-11-29,21:00:00,26,22,4,FMN GV 11 Ramsel
66,Bergstraat 71,2018-11-29,22:00:00,8,8,0,FMN GV 11 Ramsel
66,Bergstraat 71,2018-11-29,23:00:00,2,2,0,FMN GV 11 Ramsel
66,Bergstraat 71,2018-11-30,00:00:00,2,2,0,FMN GV 11 Ramsel
66,Bergstraat 71,2018-11-30,01:00:00,0,0,0,FMN GV 11 Ramsel
66,Bergstraat 71,2018-11-30,02:00:00,0,0,0,FMN GV 11 Ramsel
66,Bergstraat 71,2018-11-30,03:00:00,0,0,0,FMN GV 11 Ramsel
66,Bergstraat 71,2018-11-30,04:00:00,4,2,2,FMN GV 11 Ramsel
66,Bergstraat 71,2018-11-30,05:00:00,2,0,2,FMN GV 11 Ramsel
66,Bergstraat 71,2018-11-30,06:00:00,28,10,18,FMN GV 11 Ramsel
66,Bergstraat 71,2018-11-30,07:00:00,130,20,110,FMN GV 11 Ramsel
66,Bergstraat 71,2018-11-30,08:00:00,134,30,104,FMN GV 11 Ramsel
66,Bergstraat 71,2018-11-30,09:00:00,36,14,22,FMN GV 11 Ramsel
66,Bergstraat 71,2018-11-30,10:00:00,48,30,18,FMN GV 11 Ramsel
66,Bergstraat 71,2018-11-30,11:00:00,36,26,10,FMN GV 11 Ramsel
66,Bergstraat 71,2018-11-30,12:00:00,84,42,42,FMN GV 11 Ramsel
66,Bergstraat 71,2018-11-30,13:00:00,100,44,56,FMN GV 11 Ramsel
66,Bergstraat 71,2018-11-30,14:00:00,116,56,60,FMN GV 11 Ramsel
66,Bergstraat 71,2018-11-30,15:00:00,234,176,58,FMN GV 11 Ramsel
66,Bergstraat 71,2018-11-30,16:00:00,104,84,20,FMN GV 11 Ramsel
66,Bergstraat 71,2018-11-30,17:00:00,54,40,14,FMN GV 11 Ramsel
66,Bergstraat 71,2018-11-30,18:00:00,36,24,12,FMN GV 11 Ramsel
66,Bergstraat 71,2018-11-30,19:00:00,26,6,20,FMN GV 11 Ramsel
66,Bergstraat 71,2018-11-30,20:00:00,8,4,4,FMN GV 11 Ramsel
66,Bergstraat 71,2018-11-30,21:00:00,12,2,10,FMN GV 11 Ramsel
66,Bergstraat 71,2018-11-30,22:00:00,4,2,2,FMN GV 11 Ramsel
66,Bergstraat 71,2018-11-30,23:00:00,14,12,2,FMN GV 11 Ramsel
66,Bergstraat 71,2018-12-01,00:00:00,2,2,0,FMN GV 11 Ramsel
66,Bergstraat 71,2018-12-01,01:00:00,2,2,0,FMN GV 11 Ramsel
66,Bergstraat 71,2018-12-01,02:00:00,2,2,0,FMN GV 11 Ramsel
66,Bergstraat 71,2018-12-01,03:00:00,4,4,0,FMN GV 11 Ramsel
66,Bergstraat 71,2018-12-01,04:00:00,0,0,0,FMN GV 11 Ramsel
66,Bergstraat 71,2018-12-01,05:00:00,0,0,0,FMN GV 11 Ramsel
66,Bergstraat 71,2018-12-01,06:00:00,0,0,0,FMN GV 11 Ramsel
66,Bergstraat 71,2018-12-01,07:00:00,8,0,8,FMN GV 11 Ramsel
66,Bergstraat 71,2018-12-01,08:00:00,26,10,16,FMN GV 11 Ramsel
66,Bergstraat 71,2018-12-01,09:00:00,48,20,28,FMN GV 11 Ramsel
66,Bergstraat 71,2018-12-01,10:00:00,54,30,24,FMN GV 11 Ramsel
66,Bergstraat 71,2018-12-01,11:00:00,68,38,30,FMN GV 11 Ramsel
66,Bergstraat 71,2018-12-01,12:00:00,40,26,14,FMN GV 11 Ramsel
66,Bergstraat 71,2018-12-01,13:00:00,20,12,8,FMN GV 11 Ramsel
66,Bergstraat 71,2018-12-01,14:00:00,30,14,16,FMN GV 11 Ramsel
66,Bergstraat 71,2018-12-01,15:00:00,14,4,10,FMN GV 11 Ramsel
66,Bergstraat 71,2018-12-01,16:00:00,12,10,2,FMN GV 11 Ramsel
66,Bergstraat 71,2018-12-01,17:00:00,2,0,2,FMN GV 11 Ramsel
66,Bergstraat 71,2018-12-01,18:00:00,6,4,2,FMN GV 11 Ramsel
66,Bergstraat 71,2018-12-01,19:00:00,10,4,6,FMN GV 11 Ramsel
66,Bergstraat 71,2018-12-01,20:00:00,4,0,4,FMN GV 11 Ramsel
66,Bergstraat 71,2018-12-01,21:00:00,6,2,4,FMN GV 11 Ramsel
66,Bergstraat 71,2018-12-01,22:00:00,4,2,2,FMN GV 11 Ramsel
66,Bergstraat 71,2018-12-01,23:00:00,6,4,2,FMN GV 11 Ramsel
66,Bergstraat 71,2018-12-02,00:00:00,0,0,0,FMN GV 11 Ramsel
66,Bergstraat 71,2018-12-02,01:00:00,2,0,2,FMN GV 11 Ramsel
66,Bergstraat 71,2018-12-02,02:00:00,8,8,0,FMN GV 11 Ramsel
66,Bergstraat 71,2018-12-02,03:00:00,0,0,0,FMN GV 11 Ramsel
66,Bergstraat 71,2018-12-02,04:00:00,0,0,0,FMN GV 11 Ramsel
66,Bergstraat 71,2018-12-02,05:00:00,2,0,2,FMN GV 11 Ramsel
66,Bergstraat 71,2018-12-02,06:00:00,0,0,0,FMN GV 11 Ramsel
66,Bergstraat 71,2018-12-02,07:00:00,0,0,0,FMN GV 11 Ramsel
66,Bergstraat 71,2018-12-02,08:00:00,10,2,8,FMN GV 11 Ramsel
66,Bergstraat 71,2018-12-02,09:00:00,14,2,12,FMN GV 11 Ramsel
66,Bergstraat 71,2018-12-02,10:00:00,22,6,16,FMN GV 11 Ramsel
66,Bergstraat 71,2018-12-02,11:00:00,14,8,6,FMN GV 11 Ramsel
66,Bergstraat 71,2018-12-02,12:00:00,14,6,8,FMN GV 11 Ramsel
66,Bergstraat 71,2018-12-02,13:00:00,48,24,24,FMN GV 11 Ramsel
66,Bergstraat 71,2018-12-02,14:00:00,30,20,10,FMN GV 11 Ramsel
66,Bergstraat 71,2018-12-02,15:00:00,20,14,6,FMN GV 11 Ramsel
66,Bergstraat 71,2018-12-02,16:00:00,26,10,16,FMN GV 11 Ramsel
66,Bergstraat 71,2018-12-02,17:00:00,18,8,10,FMN GV 11 Ramsel
66,Bergstraat 71,2018-12-02,18:00:00,6,0,6,FMN GV 11 Ramsel
66,Bergstraat 71,2018-12-02,19:00:00,2,2,0,FMN GV 11 Ramsel
66,Bergstraat 71,2018-12-02,20:00:00,10,8,2,FMN GV 11 Ramsel
66,Bergstraat 71,2018-12-02,21:00:00,0,0,0,FMN GV 11 Ramsel
66,Bergstraat 71,2018-12-02,22:00:00,2,2,0,FMN GV 11 Ramsel
66,Bergstraat 71,2018-12-02,23:00:00,4,4,0,FMN GV 11 Ramsel
66,Bergstraat 71,2018-12-03,00:00:00,0,0,0,FMN GV 11 Ramsel
66,Bergstraat 71,2018-12-03,01:00:00,0,0,0,FMN GV 11 Ramsel
66,Bergstraat 71,2018-12-03,02:00:00,0,0,0,FMN GV 11 Ramsel
66,Bergstraat 71,2018-12-03,03:00:00,0,0,0,FMN GV 11 Ramsel
66,Bergstraat 71,2018-12-03,04:00:00,0,0,0,FMN GV 11 Ramsel
66,Bergstraat 71,2018-12-03,05:00:00,4,2,2,FMN GV 11 Ramsel
66,Bergstraat 71,2018-12-03,06:00:00,24,8,16,FMN GV 11 Ramsel
66,Bergstraat 71,2018-12-03,07:00:00,88,8,80,FMN GV 11 Ramsel
66,Bergstraat 71,2018-12-03,08:00:00,122,8,114,FMN GV 11 Ramsel
66,Bergstraat 71,2018-12-03,09:00:00,30,10,20,FMN GV 11 Ramsel
66,Bergstraat 71,2018-12-03,10:00:00,26,14,12,FMN GV 11 Ramsel
66,Bergstraat 71,2018-12-03,11:00:00,22,14,8,FMN GV 11 Ramsel
66,Bergstraat 71,2018-12-03,12:00:00,22,20,2,FMN GV 11 Ramsel
66,Bergstraat 71,2018-12-03,13:00:00,36,24,12,FMN GV 11 Ramsel
66,Bergstraat 71,2018-12-03,14:00:00,14,10,4,FMN GV 11 Ramsel
66,Bergstraat 71,2018-12-03,15:00:00,130,110,20,FMN GV 11 Ramsel
66,Bergstraat 71,2018-12-03,16:00:00,62,50,12,FMN GV 11 Ramsel
66,Bergstraat 71,2018-12-03,17:00:00,30,16,14,FMN GV 11 Ramsel
66,Bergstraat 71,2018-12-03,18:00:00,26,18,8,FMN GV 11 Ramsel
66,Bergstraat 71,2018-12-03,19:00:00,6,0,6,FMN GV 11 Ramsel
66,Bergstraat 71,2018-12-03,20:00:00,4,4,0,FMN GV 11 Ramsel
66,Bergstraat 71,2018-12-03,21:00:00,2,2,0,FMN GV 11 Ramsel
66,Bergstraat 71,2018-12-03,22:00:00,4,2,2,FMN GV 11 Ramsel
66,Bergstraat 71,2018-12-03,23:00:00,4,2,2,FMN GV 11 Ramsel
66,Bergstraat 71,2018-12-04,00:00:00,0,0,0,FMN GV 11 Ramsel
66,Bergstraat 71,2018-12-04,01:00:00,0,0,0,FMN GV 11 Ramsel
66,Bergstraat 71,2018-12-04,02:00:00,0,0,0,FMN GV 11 Ramsel
66,Bergstraat 71,2018-12-04,03:00:00,0,0,0,FMN GV 11 Ramsel
66,Bergstraat 71,2018-12-04,04:00:00,2,0,2,FMN GV 11 Ramsel
66,Bergstraat 71,2018-12-04,05:00:00,8,6,2,FMN GV 11 Ramsel
66,Bergstraat 71,2018-12-04,06:00:00,36,12,24,FMN GV 11 Ramsel
66,Bergstraat 71,2018-12-04,07:00:00,116,30,86,FMN GV 11 Ramsel
66,Bergstraat 71,2018-12-04,08:00:00,166,28,138,FMN GV 11 Ramsel
66,Bergstraat 71,2018-12-04,09:00:00,36,10,26,FMN GV 11 Ramsel
66,Bergstraat 71,2018-12-04,10:00:00,56,28,28,FMN GV 11 Ramsel
66,Bergstraat 71,2018-12-04,11:00:00,54,26,28,FMN GV 11 Ramsel
66,Bergstraat 71,2018-12-04,12:00:00,144,70,74,FMN GV 11 Ramsel
66,Bergstraat 71,2018-12-04,13:00:00,186,88,98,FMN GV 11 Ramsel
66,Bergstraat 71,2018-12-04,14:00:00,114,54,60,FMN GV 11 Ramsel
66,Bergstraat 71,2018-12-04,15:00:00,300,238,62,FMN GV 11 Ramsel
66,Bergstraat 71,2018-12-04,16:00:00,106,70,36,FMN GV 11 Ramsel
66,Bergstraat 71,2018-12-04,17:00:00,56,32,24,FMN GV 11 Ramsel
66,Bergstraat 71,2018-12-04,18:00:00,50,26,24,FMN GV 11 Ramsel
66,Bergstraat 71,2018-12-04,19:00:00,30,12,18,FMN GV 11 Ramsel
66,Bergstraat 71,2018-12-04,20:00:00,26,18,8,FMN GV 11 Ramsel
66,Bergstraat 71,2018-12-04,21:00:00,4,2,2,FMN GV 11 Ramsel
66,Bergstraat 71,2018-12-04,22:00:00,6,6,0,FMN GV 11 Ramsel
66,Bergstraat 71,2018-12-04,23:00:00,0,0,0,FMN GV 11 Ramsel
66,Bergstraat 71,2018-12-05,00:00:00,0,0,0,FMN GV 11 Ramsel
66,Bergstraat 71,2018-12-05,01:00:00,0,0,0,FMN GV 11 Ramsel
66,Bergstraat 71,2018-12-05,02:00:00,0,0,0,FMN GV 11 Ramsel
66,Bergstraat 71,2018-12-05,03:00:00,0,0,0,FMN GV 11 Ramsel
66,Bergstraat 71,2018-12-05,04:00:00,2,2,0,FMN GV 11 Ramsel
66,Bergstraat 71,2018-12-05,05:00:00,2,0,2,FMN GV 11 Ramsel
66,Bergstraat 71,2018-12-05,06:00:00,32,6,26,FMN GV 11 Ramsel
66,Bergstraat 71,2018-12-05,07:00:00,110,24,86,FMN GV 11 Ramsel
66,Bergstraat 71,2018-12-05,08:00:00,168,28,140,FMN GV 11 Ramsel
66,Bergstraat 71,2018-12-05,09:00:00,42,22,20,FMN GV 11 Ramsel
66,Bergstraat 71,2018-12-05,10:00:00,70,48,22,FMN GV 11 Ramsel
66,Bergstraat 71,2018-12-05,11:00:00,38,24,14,FMN GV 11 Ramsel
66,Bergstraat 71,2018-12-05,12:00:00,174,138,36,FMN GV 11 Ramsel
66,Bergstraat 71,2018-12-05,13:00:00,46,24,22,FMN GV 11 Ramsel
66,Bergstraat 71,2018-12-05,14:00:00,28,10,18,FMN GV 11 Ramsel
66,Bergstraat 71,2018-12-05,15:00:00,32,12,20,FMN GV 11 Ramsel
66,Bergstraat 71,2018-12-05,16:00:00,60,32,28,FMN GV 11 Ramsel
66,Bergstraat 71,2018-12-05,17:00:00,38,30,8,FMN GV 11 Ramsel
66,Bergstraat 71,2018-12-05,18:00:00,34,22,12,FMN GV 11 Ramsel
66,Bergstraat 71,2018-12-05,19:00:00,14,10,4,FMN GV 11 Ramsel
66,Bergstraat 71,2018-12-05,20:00:00,8,4,4,FMN GV 11 Ramsel
66,Bergstraat 71,2018-12-05,21:00:00,14,8,6,FMN GV 11 Ramsel
66,Bergstraat 71,2018-12-05,22:00:00,2,2,0,FMN GV 11 Ramsel
66,Bergstraat 71,2018-12-05,23:00:00,2,2,0,FMN GV 11 Ramsel
66,Bergstraat 71,2018-12-06,00:00:00,0,0,0,FMN GV 11 Ramsel
66,Bergstraat 71,2018-12-06,01:00:00,0,0,0,FMN GV 11 Ramsel
66,Bergstraat 71,2018-12-06,02:00:00,0,0,0,FMN GV 11 Ramsel
66,Bergstraat 71,2018-12-06,03:00:00,0,0,0,FMN GV 11 Ramsel
66,Bergstraat 71,2018-12-06,04:00:00,2,2,0,FMN GV 11 Ramsel
66,Bergstraat 71,2018-12-06,05:00:00,2,0,2,FMN GV 11 Ramsel
66,Bergstraat 71,2018-12-06,06:00:00,24,6,18,FMN GV 11 Ramsel
66,Bergstraat 71,2018-12-06,07:00:00,138,24,114,FMN GV 11 Ramsel
66,Bergstraat 71,2018-12-06,08:00:00,142,32,110,FMN GV 11 Ramsel
66,Bergstraat 71,2018-12-06,09:00:00,26,16,10,FMN GV 11 Ramsel
66,Bergstraat 71,2018-12-06,10:00:00,82,54,28,FMN GV 11 Ramsel
66,Bergstraat 71,2018-12-06,11:00:00,44,32,12,FMN GV 11 Ramsel
66,Bergstraat 71,2018-12-06,12:00:00,130,100,30,FMN GV 11 Ramsel
66,Bergstraat 71,2018-12-06,13:00:00,32,10,22,FMN GV 11 Ramsel
66,Bergstraat 71,2018-12-06,14:00:00,58,38,20,FMN GV 11 Ramsel
66,Bergstraat 71,2018-12-06,15:00:00,64,46,18,FMN GV 11 Ramsel
66,Bergstraat 71,2018-12-06,16:00:00,80,58,22,FMN GV 11 Ramsel
66,Bergstraat 71,2018-12-06,17:00:00,40,30,10,FMN GV 11 Ramsel
66,Bergstraat 71,2018-12-06,18:00:00,28,14,14,FMN GV 11 Ramsel
66,Bergstraat 71,2018-12-06,19:00:00,24,12,12,FMN GV 11 Ramsel
66,Bergstraat 71,2018-12-06,20:00:00,26,22,4,FMN GV 11 Ramsel
66,Bergstraat 71,2018-12-06,21:00:00,12,6,6,FMN GV 11 Ramsel
66,Bergstraat 71,2018-12-06,22:00:00,2,2,0,FMN GV 11 Ramsel
66,Bergstraat 71,2018-12-06,23:00:00,2,2,0,FMN GV 11 Ramsel
66,Bergstraat 71,2018-12-07,00:00:00,0,0,0,FMN GV 11 Ramsel
66,Bergstraat 71,2018-12-07,01:00:00,2,0,2,FMN GV 11 Ramsel
66,Bergstraat 71,2018-12-07,02:00:00,0,0,0,FMN GV 11 Ramsel
66,Bergstraat 71,2018-12-07,03:00:00,0,0,0,FMN GV 11 Ramsel
66,Bergstraat 71,2018-12-07,04:00:00,2,2,0,FMN GV 11 Ramsel
66,Bergstraat 71,2018-12-07,05:00:00,4,2,2,FMN GV 11 Ramsel
66,Bergstraat 71,2018-12-07,06:00:00,12,4,8,FMN GV 11 Ramsel
66,Bergstraat 71,2018-12-07,07:00:00,124,20,104,FMN GV 11 Ramsel
66,Bergstraat 71,2018-12-07,08:00:00,98,24,74,FMN GV 11 Ramsel
66,Bergstraat 71,2018-12-07,09:00:00,28,12,16,FMN GV 11 Ramsel
66,Bergstraat 71,2018-12-07,10:00:00,74,70,4,FMN GV 11 Ramsel
66,Bergstraat 71,2018-12-07,11:00:00,42,32,10,FMN GV 11 Ramsel
66,Bergstraat 71,2018-12-07,12:00:00,68,56,12,FMN GV 11 Ramsel
66,Bergstraat 71,2018-12-07,13:00:00,32,18,14,FMN GV 11 Ramsel
66,Bergstraat 71,2018-12-07,14:00:00,12,10,2,FMN GV 11 Ramsel
66,Bergstraat 71,2018-12-07,15:00:00,40,30,10,FMN GV 11 Ramsel
66,Bergstraat 71,2018-12-07,16:00:00,34,28,6,FMN GV 11 Ramsel
66,Bergstraat 71,2018-12-07,17:00:00,22,16,6,FMN GV 11 Ramsel
66,Bergstraat 71,2018-12-07,18:00:00,4,0,4,FMN GV 11 Ramsel
66,Bergstraat 71,2018-12-07,19:00:00,12,6,6,FMN GV 11 Ramsel
66,Bergstraat 71,2018-12-07,20:00:00,8,4,4,FMN GV 11 Ramsel
66,Bergstraat 71,2018-12-07,21:00:00,10,10,0,FMN GV 11 Ramsel
66,Bergstraat 71,2018-12-07,22:00:00,2,0,2,FMN GV 11 Ramsel
66,Bergstraat 71,2018-12-07,23:00:00,0,0,0,FMN GV 11 Ramsel
66,Bergstraat 71,2018-12-08,00:00:00,0,0,0,FMN GV 11 Ramsel
66,Bergstraat 71,2018-12-08,01:00:00,0,0,0,FMN GV 11 Ramsel
66,Bergstraat 71,2018-12-08,02:00:00,0,0,0,FMN GV 11 Ramsel
66,Bergstraat 71,2018-12-08,03:00:00,2,2,0,FMN GV 11 Ramsel
66,Bergstraat 71,2018-12-08,04:00:00,0,0,0,FMN GV 11 Ramsel
66,Bergstraat 71,2018-12-08,05:00:00,4,4,0,FMN GV 11 Ramsel
66,Bergstraat 71,2018-12-08,06:00:00,0,0,0,FMN GV 11 Ramsel
66,Bergstraat 71,2018-12-08,07:00:00,2,0,2,FMN GV 11 Ramsel
66,Bergstraat 71,2018-12-08,08:00:00,14,4,10,FMN GV 11 Ramsel
66,Bergstraat 71,2018-12-08,09:00:00,32,12,20,FMN GV 11 Ramsel
66,Bergstraat 71,2018-12-08,10:00:00,40,24,16,FMN GV 11 Ramsel
66,Bergstraat 71,2018-12-08,11:00:00,42,32,10,FMN GV 11 Ramsel
66,Bergstraat 71,2018-12-08,12:00:00,48,22,26,FMN GV 11 Ramsel
66,Bergstraat 71,2018-12-08,13:00:00,52,10,42,FMN GV 11 Ramsel
66,Bergstraat 71,2018-12-08,14:00:00,54,34,20,FMN GV 11 Ramsel
66,Bergstraat 71,2018-12-08,15:00:00,22,16,6,FMN GV 11 Ramsel
66,Bergstraat 71,2018-12-08,16:00:00,32,22,10,FMN GV 11 Ramsel
66,Bergstraat 71,2018-12-08,17:00:00,12,8,4,FMN GV 11 Ramsel
66,Bergstraat 71,2018-12-08,18:00:00,2,2,0,FMN GV 11 Ramsel
66,Bergstraat 71,2018-12-08,19:00:00,14,6,8,FMN GV 11 Ramsel
66,Bergstraat 71,2018-12-08,20:00:00,14,8,6,FMN GV 11 Ramsel
66,Bergstraat 71,2018-12-08,21:00:00,0,0,0,FMN GV 11 Ramsel
66,Bergstraat 71,2018-12-08,22:00:00,0,0,0,FMN GV 11 Ramsel
66,Bergstraat 71,2018-12-08,23:00:00,0,0,0,FMN GV 11 Ramsel
66,Bergstraat 71,2018-12-09,00:00:00,0,0,0,FMN GV 11 Ramsel
66,Bergstraat 71,2018-12-09,01:00:00,4,4,0,FMN GV 11 Ramsel
66,Bergstraat 71,2018-12-09,02:00:00,2,0,2,FMN GV 11 Ramsel
66,Bergstraat 71,2018-12-09,03:00:00,4,4,0,FMN GV 11 Ramsel
66,Bergstraat 71,2018-12-09,04:00:00,0,0,0,FMN GV 11 Ramsel
66,Bergstraat 71,2018-12-09,05:00:00,0,0,0,FMN GV 11 Ramsel
66,Bergstraat 71,2018-12-09,06:00:00,2,0,2,FMN GV 11 Ramsel
66,Bergstraat 71,2018-12-09,07:00:00,0,0,0,FMN GV 11 Ramsel
66,Bergstraat 71,2018-12-09,08:00:00,12,6,6,FMN GV 11 Ramsel
66,Bergstraat 71,2018-12-09,09:00:00,2,2,0,FMN GV 11 Ramsel
66,Bergstraat 71,2018-12-09,10:00:00,6,4,2,FMN GV 11 Ramsel
66,Bergstraat 71,2018-12-09,11:00:00,6,6,0,FMN GV 11 Ramsel
66,Bergstraat 71,2018-12-09,12:00:00,2,2,0,FMN GV 11 Ramsel
66,Bergstraat 71,2018-12-09,13:00:00,8,4,4,FMN GV 11 Ramsel
66,Bergstraat 71,2018-12-09,14:00:00,20,8,12,FMN GV 11 Ramsel
66,Bergstraat 71,2018-12-09,15:00:00,12,6,6,FMN GV 11 Ramsel
66,Bergstraat 71,2018-12-09,16:00:00,4,2,2,FMN GV 11 Ramsel
66,Bergstraat 71,2018-12-09,17:00:00,6,4,2,FMN GV 11 Ramsel
66,Bergstraat 71,2018-12-09,18:00:00,2,0,2,FMN GV 11 Ramsel
66,Bergstraat 71,2018-12-09,19:00:00,0,0,0,FMN GV 11 Ramsel
66,Bergstraat 71,2018-12-09,20:00:00,4,2,2,FMN GV 11 Ramsel
66,Bergstraat 71,2018-12-09,21:00:00,2,0,2,FMN GV 11 Ramsel
66,Bergstraat 71,2018-12-09,22:00:00,0,0,0,FMN GV 11 Ramsel
66,Bergstraat 71,2018-12-09,23:00:00,2,2,0,FMN GV 11 Ramsel
66,Bergstraat 71,2018-12-10,00:00:00,0,0,0,FMN GV 11 Ramsel
66,Bergstraat 71,2018-12-10,01:00:00,0,0,0,FMN GV 11 Ramsel
66,Bergstraat 71,2018-12-10,02:00:00,0,0,0,FMN GV 11 Ramsel
66,Bergstraat 71,2018-12-10,03:00:00,0,0,0,FMN GV 11 Ramsel
66,Bergstraat 71,2018-12-10,04:00:00,0,0,0,FMN GV 11 Ramsel
66,Bergstraat 71,2018-12-10,05:00:00,2,2,0,FMN GV 11 Ramsel
66,Bergstraat 71,2018-12-10,06:00:00,24,8,16,FMN GV 11 Ramsel
66,Bergstraat 71,2018-12-10,07:00:00,118,16,102,FMN GV 11 Ramsel
66,Bergstraat 71,2018-12-10,08:00:00,136,24,112,FMN GV 11 Ramsel
66,Bergstraat 71,2018-12-10,09:00:00,22,10,12,FMN GV 11 Ramsel
66,Bergstraat 71,2018-12-10,10:00:00,76,58,18,FMN GV 11 Ramsel
66,Bergstraat 71,2018-12-10,11:00:00,74,62,12,FMN GV 11 Ramsel
66,Bergstraat 71,2018-12-10,12:00:00,142,112,30,FMN GV 11 Ramsel
66,Bergstraat 71,2018-12-10,13:00:00,104,44,60,FMN GV 11 Ramsel
66,Bergstraat 71,2018-12-10,14:00:00,64,28,36,FMN GV 11 Ramsel
66,Bergstraat 71,2018-12-10,15:00:00,54,40,14,FMN GV 11 Ramsel
66,Bergstraat 71,2018-12-10,16:00:00,46,34,12,FMN GV 11 Ramsel
66,Bergstraat 71,2018-12-10,17:00:00,36,28,8,FMN GV 11 Ramsel
66,Bergstraat 71,2018-12-10,18:00:00,26,18,8,FMN GV 11 Ramsel
66,Bergstraat 71,2018-12-10,19:00:00,10,8,2,FMN GV 11 Ramsel
66,Bergstraat 71,2018-12-10,20:00:00,16,8,8,FMN GV 11 Ramsel
66,Bergstraat 71,2018-12-10,21:00:00,4,2,2,FMN GV 11 Ramsel
66,Bergstraat 71,2018-12-10,22:00:00,4,4,0,FMN GV 11 Ramsel
66,Bergstraat 71,2018-12-10,23:00:00,2,2,0,FMN GV 11 Ramsel
66,Bergstraat 71,2018-12-11,00:00:00,0,0,0,FMN GV 11 Ramsel
66,Bergstraat 71,2018-12-11,01:00:00,0,0,0,FMN GV 11 Ramsel
66,Bergstraat 71,2018-12-11,02:00:00,0,0,0,FMN GV 11 Ramsel
66,Bergstraat 71,2018-12-11,03:00:00,0,0,0,FMN GV 11 Ramsel
66,Bergstraat 71,2018-12-11,04:00:00,2,2,0,FMN GV 11 Ramsel
66,Bergstraat 71,2018-12-11,05:00:00,10,6,4,FMN GV 11 Ramsel
66,Bergstraat 71,2018-12-11,06:00:00,36,12,24,FMN GV 11 Ramsel
66,Bergstraat 71,2018-12-11,07:00:00,144,24,120,FMN GV 11 Ramsel
66,Bergstraat 71,2018-12-11,08:00:00,134,36,98,FMN GV 11 Ramsel
66,Bergstraat 71,2018-12-11,09:00:00,32,18,14,FMN GV 11 Ramsel
66,Bergstraat 71,2018-12-11,10:00:00,126,96,30,FMN GV 11 Ramsel
66,Bergstraat 71,2018-12-11,11:00:00,72,50,22,FMN GV 11 Ramsel
66,Bergstraat 71,2018-12-11,12:00:00,80,50,30,FMN GV 11 Ramsel
66,Bergstraat 71,2018-12-11,13:00:00,158,58,100,FMN GV 11 Ramsel
66,Bergstraat 71,2018-12-11,14:00:00,78,48,30,FMN GV 11 Ramsel
66,Bergstraat 71,2018-12-11,15:00:00,72,48,24,FMN GV 11 Ramsel
66,Bergstraat 71,2018-12-11,16:00:00,84,46,38,FMN GV 11 Ramsel
66,Bergstraat 71,2018-12-11,17:00:00,48,26,22,FMN GV 11 Ramsel
66,Bergstraat 71,2018-12-11,18:00:00,34,24,10,FMN GV 11 Ramsel
66,Bergstraat 71,2018-12-11,19:00:00,30,10,20,FMN GV 11 Ramsel
66,Bergstraat 71,2018-12-11,20:00:00,32,22,10,FMN GV 11 Ramsel
66,Bergstraat 71,2018-12-11,21:00:00,2,2,0,FMN GV 11 Ramsel
66,Bergstraat 71,2018-12-11,22:00:00,8,4,4,FMN GV 11 Ramsel
66,Bergstraat 71,2018-12-11,23:00:00,2,2,0,FMN GV 11 Ramsel
66,Bergstraat 71,2018-12-12,00:00:00,0,0,0,FMN GV 11 Ramsel
66,Bergstraat 71,2018-12-12,01:00:00,0,0,0,FMN GV 11 Ramsel
66,Bergstraat 71,2018-12-12,02:00:00,0,0,0,FMN GV 11 Ramsel
66,Bergstraat 71,2018-12-12,03:00:00,0,0,0,FMN GV 11 Ramsel
66,Bergstraat 71,2018-12-12,04:00:00,2,2,0,FMN GV 11 Ramsel
66,Bergstraat 71,2018-12-12,05:00:00,10,6,4,FMN GV 11 Ramsel
66,Bergstraat 71,2018-12-12,06:00:00,20,2,18,FMN GV 11 Ramsel
66,Bergstraat 71,2018-12-12,07:00:00,72,22,50,FMN GV 11 Ramsel
66,Bergstraat 71,2018-12-12,08:00:00,112,26,86,FMN GV 11 Ramsel
66,Bergstraat 71,2018-12-12,09:00:00,20,6,14,FMN GV 11 Ramsel
66,Bergstraat 71,2018-12-12,10:00:00,92,72,20,FMN GV 11 Ramsel
66,Bergstraat 71,2018-12-12,11:00:00,78,52,26,FMN GV 11 Ramsel
66,Bergstraat 71,2018-12-12,12:00:00,82,70,12,FMN GV 11 Ramsel
66,Bergstraat 71,2018-12-12,13:00:00,42,22,20,FMN GV 11 Ramsel
66,Bergstraat 71,2018-12-12,14:00:00,40,16,24,FMN GV 11 Ramsel
66,Bergstraat 71,2018-12-12,15:00:00,30,22,8,FMN GV 11 Ramsel
66,Bergstraat 71,2018-12-12,16:00:00,52,28,24,FMN GV 11 Ramsel
66,Bergstraat 71,2018-12-12,17:00:00,48,30,18,FMN GV 11 Ramsel
66,Bergstraat 71,2018-12-12,18:00:00,22,14,8,FMN GV 11 Ramsel
66,Bergstraat 71,2018-12-12,19:00:00,18,12,6,FMN GV 11 Ramsel
66,Bergstraat 71,2018-12-12,20:00:00,10,6,4,FMN GV 11 Ramsel
66,Bergstraat 71,2018-12-12,21:00:00,2,0,2,FMN GV 11 Ramsel
66,Bergstraat 71,2018-12-12,22:00:00,6,6,0,FMN GV 11 Ramsel
66,Bergstraat 71,2018-12-12,23:00:00,2,2,0,FMN GV 11 Ramsel
66,Bergstraat 71,2018-12-13,00:00:00,0,0,0,FMN GV 11 Ramsel
66,Bergstraat 71,2018-12-13,01:00:00,2,2,0,FMN GV 11 Ramsel
66,Bergstraat 71,2018-12-13,02:00:00,0,0,0,FMN GV 11 Ramsel
66,Bergstraat 71,2018-12-13,03:00:00,0,0,0,FMN GV 11 Ramsel
66,Bergstraat 71,2018-12-13,04:00:00,2,2,0,FMN GV 11 Ramsel
66,Bergstraat 71,2018-12-13,05:00:00,6,0,6,FMN GV 11 Ramsel
66,Bergstraat 71,2018-12-13,06:00:00,24,4,20,FMN GV 11 Ramsel
66,Bergstraat 71,2018-12-13,07:00:00,80,28,52,FMN GV 11 Ramsel
66,Bergstraat 71,2018-12-13,08:00:00,68,20,48,FMN GV 11 Ramsel
66,Bergstraat 71,2018-12-13,09:00:00,18,14,4,FMN GV 11 Ramsel
66,Bergstraat 71,2018-12-13,10:00:00,70,56,14,FMN GV 11 Ramsel
66,Bergstraat 71,2018-12-13,11:00:00,48,34,14,FMN GV 11 Ramsel
66,Bergstraat 71,2018-12-13,12:00:00,86,62,24,FMN GV 11 Ramsel
66,Bergstraat 71,2018-12-13,13:00:00,32,14,18,FMN GV 11 Ramsel
66,Bergstraat 71,2018-12-13,14:00:00,46,24,22,FMN GV 11 Ramsel
66,Bergstraat 71,2018-12-13,15:00:00,60,40,20,FMN GV 11 Ramsel
66,Bergstraat 71,2018-12-13,16:00:00,50,38,12,FMN GV 11 Ramsel
66,Bergstraat 71,2018-12-13,17:00:00,40,30,10,FMN GV 11 Ramsel
66,Bergstraat 71,2018-12-13,18:00:00,16,10,6,FMN GV 11 Ramsel
66,Bergstraat 71,2018-12-13,19:00:00,16,10,6,FMN GV 11 Ramsel
66,Bergstraat 71,2018-12-13,20:00:00,6,4,2,FMN GV 11 Ramsel
66,Bergstraat 71,2018-12-13,21:00:00,6,0,6,FMN GV 11 Ramsel
66,Bergstraat 71,2018-12-13,22:00:00,0,0,0,FMN GV 11 Ramsel
66,Bergstraat 71,2018-12-13,23:00:00,2,2,0,FMN GV 11 Ramsel
66,Bergstraat 71,2018-12-14,00:00:00,0,0,0,FMN GV 11 Ramsel
66,Bergstraat 71,2018-12-14,01:00:00,0,0,0,FMN GV 11 Ramsel
66,Bergstraat 71,2018-12-14,02:00:00,0,0,0,FMN GV 11 Ramsel
66,Bergstraat 71,2018-12-14,03:00:00,0,0,0,FMN GV 11 Ramsel
66,Bergstraat 71,2018-12-14,04:00:00,2,0,2,FMN GV 11 Ramsel
66,Bergstraat 71,2018-12-14,05:00:00,2,0,2,FMN GV 11 Ramsel
66,Bergstraat 71,2018-12-14,06:00:00,14,2,12,FMN GV 11 Ramsel
66,Bergstraat 71,2018-12-14,07:00:00,96,22,74,FMN GV 11 Ramsel
66,Bergstraat 71,2018-12-14,08:00:00,80,18,62,FMN GV 11 Ramsel
66,Bergstraat 71,2018-12-14,09:00:00,6,2,4,FMN GV 11 Ramsel
66,Bergstraat 71,2018-12-14,10:00:00,54,42,12,FMN GV 11 Ramsel
66,Bergstraat 71,2018-12-14,11:00:00,78,64,14,FMN GV 11 Ramsel
66,Bergstraat 71,2018-12-14,12:00:00,54,40,14,FMN GV 11 Ramsel
66,Bergstraat 71,2018-12-14,13:00:00,40,26,14,FMN GV 11 Ramsel
66,Bergstraat 71,2018-12-14,14:00:00,54,22,32,FMN GV 11 Ramsel
66,Bergstraat 71,2018-12-14,15:00:00,40,26,14,FMN GV 11 Ramsel
66,Bergstraat 71,2018-12-14,16:00:00,30,18,12,FMN GV 11 Ramsel
66,Bergstraat 71,2018-12-14,17:00:00,32,22,10,FMN GV 11 Ramsel
66,Bergstraat 71,2018-12-14,18:00:00,18,14,4,FMN GV 11 Ramsel
66,Bergstraat 71,2018-12-14,19:00:00,18,6,12,FMN GV 11 Ramsel
66,Bergstraat 71,2018-12-14,20:00:00,8,4,4,FMN GV 11 Ramsel
66,Bergstraat 71,2018-12-14,21:00:00,8,2,6,FMN GV 11 Ramsel
66,Bergstraat 71,2018-12-14,22:00:00,4,2,2,FMN GV 11 Ramsel
66,Bergstraat 71,2018-12-14,23:00:00,0,0,0,FMN GV 11 Ramsel
66,Bergstraat 71,2018-12-15,00:00:00,4,2,2,FMN GV 11 Ramsel
66,Bergstraat 71,2018-12-15,01:00:00,2,2,0,FMN GV 11 Ramsel
66,Bergstraat 71,2018-12-15,02:00:00,2,0,2,FMN GV 11 Ramsel
66,Bergstraat 71,2018-12-15,03:00:00,4,4,0,FMN GV 11 Ramsel
66,Bergstraat 71,2018-12-15,04:00:00,0,0,0,FMN GV 11 Ramsel
66,Bergstraat 71,2018-12-15,05:00:00,2,2,0,FMN GV 11 Ramsel
66,Bergstraat 71,2018-12-15,06:00:00,0,0,0,FMN GV 11 Ramsel
66,Bergstraat 71,2018-12-15,07:00:00,2,0,2,FMN GV 11 Ramsel
66,Bergstraat 71,2018-12-15,08:00:00,4,0,4,FMN GV 11 Ramsel
66,Bergstraat 71,2018-12-15,09:00:00,24,8,16,FMN GV 11 Ramsel
66,Bergstraat 71,2018-12-15,10:00:00,14,12,2,FMN GV 11 Ramsel
66,Bergstraat 71,2018-12-15,11:00:00,44,24,20,FMN GV 11 Ramsel
66,Bergstraat 71,2018-12-15,12:00:00,52,26,26,FMN GV 11 Ramsel
66,Bergstraat 71,2018-12-15,13:00:00,42,14,28,FMN GV 11 Ramsel
66,Bergstraat 71,2018-12-15,14:00:00,30,12,18,FMN GV 11 Ramsel
66,Bergstraat 71,2018-12-15,15:00:00,54,48,6,FMN GV 11 Ramsel
66,Bergstraat 71,2018-12-15,16:00:00,22,20,2,FMN GV 11 Ramsel
66,Bergstraat 71,2018-12-15,17:00:00,16,10,6,FMN GV 11 Ramsel
66,Bergstraat 71,2018-12-15,18:00:00,24,2,22,FMN GV 11 Ramsel
66,Bergstraat 71,2018-12-15,19:00:00,4,2,2,FMN GV 11 Ramsel
66,Bergstraat 71,2018-12-15,20:00:00,8,2,6,FMN GV 11 Ramsel
66,Bergstraat 71,2018-12-15,21:00:00,12,8,4,FMN GV 11 Ramsel
66,Bergstraat 71,2018-12-15,22:00:00,8,6,2,FMN GV 11 Ramsel
66,Bergstraat 71,2018-12-15,23:00:00,0,0,0,FMN GV 11 Ramsel
66,Bergstraat 71,2018-12-16,00:00:00,2,2,0,FMN GV 11 Ramsel
66,Bergstraat 71,2018-12-16,01:00:00,0,0,0,FMN GV 11 Ramsel
66,Bergstraat 71,2018-12-16,02:00:00,0,0,0,FMN GV 11 Ramsel
66,Bergstraat 71,2018-12-16,03:00:00,0,0,0,FMN GV 11 Ramsel
66,Bergstraat 71,2018-12-16,04:00:00,0,0,0,FMN GV 11 Ramsel
66,Bergstraat 71,2018-12-16,05:00:00,0,0,0,FMN GV 11 Ramsel
66,Bergstraat 71,2018-12-16,06:00:00,0,0,0,FMN GV 11 Ramsel
66,Bergstraat 71,2018-12-16,07:00:00,0,0,0,FMN GV 11 Ramsel
66,Bergstraat 71,2018-12-16,08:00:00,12,8,4,FMN GV 11 Ramsel
66,Bergstraat 71,2018-12-16,09:00:00,0,0,0,FMN GV 11 Ramsel
66,Bergstraat 71,2018-12-16,10:00:00,8,4,4,FMN GV 11 Ramsel
66,Bergstraat 71,2018-12-16,11:00:00,14,10,4,FMN GV 11 Ramsel
66,Bergstraat 71,2018-12-16,12:00:00,4,4,0,FMN GV 11 Ramsel
66,Bergstraat 71,2018-12-16,13:00:00,22,4,18,FMN GV 11 Ramsel
66,Bergstraat 71,2018-12-16,14:00:00,12,10,2,FMN GV 11 Ramsel
66,Bergstraat 71,2018-12-16,15:00:00,12,10,2,FMN GV 11 Ramsel
66,Bergstraat 71,2018-12-16,16:00:00,0,0,0,FMN GV 11 Ramsel
66,Bergstraat 71,2018-12-16,17:00:00,8,2,6,FMN GV 11 Ramsel
66,Bergstraat 71,2018-12-16,18:00:00,2,2,0,FMN GV 11 Ramsel
66,Bergstraat 71,2018-12-16,19:00:00,8,2,6,FMN GV 11 Ramsel
66,Bergstraat 71,2018-12-16,20:00:00,2,2,0,FMN GV 11 Ramsel
66,Bergstraat 71,2018-12-16,21:00:00,0,0,0,FMN GV 11 Ramsel
66,Bergstraat 71,2018-12-16,22:00:00,0,0,0,FMN GV 11 Ramsel
66,Bergstraat 71,2018-12-16,23:00:00,0,0,0,FMN GV 11 Ramsel
66,Bergstraat 71,2018-12-17,00:00:00,0,0,0,FMN GV 11 Ramsel
66,Bergstraat 71,2018-12-17,01:00:00,0,0,0,FMN GV 11 Ramsel
66,Bergstraat 71,2018-12-17,02:00:00,0,0,0,FMN GV 11 Ramsel
66,Bergstraat 71,2018-12-17,03:00:00,0,0,0,FMN GV 11 Ramsel
66,Bergstraat 71,2018-12-17,04:00:00,2,2,0,FMN GV 11 Ramsel
66,Bergstraat 71,2018-12-17,05:00:00,2,2,0,FMN GV 11 Ramsel
66,Bergstraat 71,2018-12-17,06:00:00,20,4,16,FMN GV 11 Ramsel
66,Bergstraat 71,2018-12-17,07:00:00,114,8,106,FMN GV 11 Ramsel
66,Bergstraat 71,2018-12-17,08:00:00,106,26,80,FMN GV 11 Ramsel
66,Bergstraat 71,2018-12-17,09:00:00,24,12,12,FMN GV 11 Ramsel
66,Bergstraat 71,2018-12-17,10:00:00,54,38,16,FMN GV 11 Ramsel
66,Bergstraat 71,2018-12-17,11:00:00,42,28,14,FMN GV 11 Ramsel
66,Bergstraat 71,2018-12-17,12:00:00,120,78,42,FMN GV 11 Ramsel
66,Bergstraat 71,2018-12-17,13:00:00,60,32,28,FMN GV 11 Ramsel
66,Bergstraat 71,2018-12-17,14:00:00,92,34,58,FMN GV 11 Ramsel
66,Bergstraat 71,2018-12-17,15:00:00,86,48,38,FMN GV 11 Ramsel
66,Bergstraat 71,2018-12-17,16:00:00,64,56,8,FMN GV 11 Ramsel
66,Bergstraat 71,2018-12-17,17:00:00,22,14,8,FMN GV 11 Ramsel
66,Bergstraat 71,2018-12-17,18:00:00,24,16,8,FMN GV 11 Ramsel
66,Bergstraat 71,2018-12-17,19:00:00,6,0,6,FMN GV 11 Ramsel
66,Bergstraat 71,2018-12-17,20:00:00,10,10,0,FMN GV 11 Ramsel
66,Bergstraat 71,2018-12-17,21:00:00,4,2,2,FMN GV 11 Ramsel
66,Bergstraat 71,2018-12-17,22:00:00,4,2,2,FMN GV 11 Ramsel
66,Bergstraat 71,2018-12-17,23:00:00,0,0,0,FMN GV 11 Ramsel
66,Bergstraat 71,2018-12-18,00:00:00,0,0,0,FMN GV 11 Ramsel
66,Bergstraat 71,2018-12-18,01:00:00,0,0,0,FMN GV 11 Ramsel
66,Bergstraat 71,2018-12-18,02:00:00,0,0,0,FMN GV 11 Ramsel
66,Bergstraat 71,2018-12-18,03:00:00,0,0,0,FMN GV 11 Ramsel
66,Bergstraat 71,2018-12-18,04:00:00,6,4,2,FMN GV 11 Ramsel
66,Bergstraat 71,2018-12-18,05:00:00,2,2,0,FMN GV 11 Ramsel
66,Bergstraat 71,2018-12-18,06:00:00,26,2,24,FMN GV 11 Ramsel
66,Bergstraat 71,2018-12-18,07:00:00,108,16,92,FMN GV 11 Ramsel
66,Bergstraat 71,2018-12-18,08:00:00,74,16,58,FMN GV 11 Ramsel
66,Bergstraat 71,2018-12-18,09:00:00,32,14,18,FMN GV 11 Ramsel
66,Bergstraat 71,2018-12-18,10:00:00,84,66,18,FMN GV 11 Ramsel
66,Bergstraat 71,2018-12-18,11:00:00,50,28,22,FMN GV 11 Ramsel
66,Bergstraat 71,2018-12-18,12:00:00,68,42,26,FMN GV 11 Ramsel
66,Bergstraat 71,2018-12-18,13:00:00,136,52,84,FMN GV 11 Ramsel
66,Bergstraat 71,2018-12-18,14:00:00,96,46,50,FMN GV 11 Ramsel
66,Bergstraat 71,2018-12-18,15:00:00,128,104,24,FMN GV 11 Ramsel
66,Bergstraat 71,2018-12-18,16:00:00,82,48,34,FMN GV 11 Ramsel
66,Bergstraat 71,2018-12-18,17:00:00,70,36,34,FMN GV 11 Ramsel
66,Bergstraat 71,2018-12-18,18:00:00,54,36,18,FMN GV 11 Ramsel
66,Bergstraat 71,2018-12-18,19:00:00,26,12,14,FMN GV 11 Ramsel
66,Bergstraat 71,2018-12-18,20:00:00,14,10,4,FMN GV 11 Ramsel
66,Bergstraat 71,2018-12-18,21:00:00,4,2,2,FMN GV 11 Ramsel
66,Bergstraat 71,2018-12-18,22:00:00,12,10,2,FMN GV 11 Ramsel
66,Bergstraat 71,2018-12-18,23:00:00,2,2,0,FMN GV 11 Ramsel
66,Bergstraat 71,2018-12-19,00:00:00,0,0,0,FMN GV 11 Ramsel
66,Bergstraat 71,2018-12-19,01:00:00,0,0,0,FMN GV 11 Ramsel
66,Bergstraat 71,2018-12-19,02:00:00,0,0,0,FMN GV 11 Ramsel
66,Bergstraat 71,2018-12-19,03:00:00,0,0,0,FMN GV 11 Ramsel
66,Bergstraat 71,2018-12-19,04:00:00,2,2,0,FMN GV 11 Ramsel
66,Bergstraat 71,2018-12-19,05:00:00,2,2,0,FMN GV 11 Ramsel
66,Bergstraat 71,2018-12-19,06:00:00,10,2,8,FMN GV 11 Ramsel
66,Bergstraat 71,2018-12-19,07:00:00,44,10,34,FMN GV 11 Ramsel
66,Bergstraat 71,2018-12-19,08:00:00,42,10,32,FMN GV 11 Ramsel
66,Bergstraat 71,2018-12-19,09:00:00,34,18,16,FMN GV 11 Ramsel
66,Bergstraat 71,2018-12-19,10:00:00,48,36,12,FMN GV 11 Ramsel
66,Bergstraat 71,2018-12-19,11:00:00,54,14,40,FMN GV 11 Ramsel
66,Bergstraat 71,2018-12-19,12:00:00,56,40,16,FMN GV 11 Ramsel
66,Bergstraat 71,2018-12-19,13:00:00,36,10,26,FMN GV 11 Ramsel
66,Bergstraat 71,2018-12-19,14:00:00,64,28,36,FMN GV 11 Ramsel
66,Bergstraat 71,2018-12-19,15:00:00,52,24,28,FMN GV 11 Ramsel
66,Bergstraat 71,2018-12-19,16:00:00,52,32,20,FMN GV 11 Ramsel
66,Bergstraat 71,2018-12-19,17:00:00,48,34,14,FMN GV 11 Ramsel
66,Bergstraat 71,2018-12-19,18:00:00,26,16,10,FMN GV 11 Ramsel
66,Bergstraat 71,2018-12-19,19:00:00,28,20,8,FMN GV 11 Ramsel
66,Bergstraat 71,2018-12-19,20:00:00,12,10,2,FMN GV 11 Ramsel
66,Bergstraat 71,2018-12-19,21:00:00,4,0,4,FMN GV 11 Ramsel
66,Bergstraat 71,2018-12-19,22:00:00,6,0,6,FMN GV 11 Ramsel
66,Bergstraat 71,2018-12-19,23:00:00,2,2,0,FMN GV 11 Ramsel
66,Bergstraat 71,2018-12-20,00:00:00,0,0,0,FMN GV 11 Ramsel
66,Bergstraat 71,2018-12-20,01:00:00,4,2,2,FMN GV 11 Ramsel
66,Bergstraat 71,2018-12-20,02:00:00,0,0,0,FMN GV 11 Ramsel
66,Bergstraat 71,2018-12-20,03:00:00,0,0,0,FMN GV 11 Ramsel
66,Bergstraat 71,2018-12-20,04:00:00,4,4,0,FMN GV 11 Ramsel
66,Bergstraat 71,2018-12-20,05:00:00,2,0,2,FMN GV 11 Ramsel
66,Bergstraat 71,2018-12-20,06:00:00,16,4,12,FMN GV 11 Ramsel
66,Bergstraat 71,2018-12-20,07:00:00,28,6,22,FMN GV 11 Ramsel
66,Bergstraat 71,2018-12-20,08:00:00,46,12,34,FMN GV 11 Ramsel
66,Bergstraat 71,2018-12-20,09:00:00,20,8,12,FMN GV 11 Ramsel
66,Bergstraat 71,2018-12-20,10:00:00,56,26,30,FMN GV 11 Ramsel
66,Bergstraat 71,2018-12-20,11:00:00,22,6,16,FMN GV 11 Ramsel
66,Bergstraat 71,2018-12-20,12:00:00,40,30,10,FMN GV 11 Ramsel
66,Bergstraat 71,2018-12-20,13:00:00,52,22,30,FMN GV 11 Ramsel
66,Bergstraat 71,2018-12-20,14:00:00,40,22,18,FMN GV 11 Ramsel
66,Bergstraat 71,2018-12-20,15:00:00,38,18,20,FMN GV 11 Ramsel
66,Bergstraat 71,2018-12-20,16:00:00,18,16,2,FMN GV 11 Ramsel
66,Bergstraat 71,2018-12-20,17:00:00,40,30,10,FMN GV 11 Ramsel
66,Bergstraat 71,2018-12-20,18:00:00,24,10,14,FMN GV 11 Ramsel
66,Bergstraat 71,2018-12-20,19:00:00,8,4,4,FMN GV 11 Ramsel
66,Bergstraat 71,2018-12-20,20:00:00,10,8,2,FMN GV 11 Ramsel
66,Bergstraat 71,2018-12-20,21:00:00,2,2,0,FMN GV 11 Ramsel
66,Bergstraat 71,2018-12-20,22:00:00,16,12,4,FMN GV 11 Ramsel
66,Bergstraat 71,2018-12-20,23:00:00,6,6,0,FMN GV 11 Ramsel
66,Bergstraat 71,2018-12-21,00:00:00,0,0,0,FMN GV 11 Ramsel
66,Bergstraat 71,2018-12-21,01:00:00,0,0,0,FMN GV 11 Ramsel
66,Bergstraat 71,2018-12-21,02:00:00,0,0,0,FMN GV 11 Ramsel
66,Bergstraat 71,2018-12-21,03:00:00,2,2,0,FMN GV 11 Ramsel
66,Bergstraat 71,2018-12-21,04:00:00,0,0,0,FMN GV 11 Ramsel
66,Bergstraat 71,2018-12-21,05:00:00,2,2,0,FMN GV 11 Ramsel
66,Bergstraat 71,2018-12-21,06:00:00,12,2,10,FMN GV 11 Ramsel
66,Bergstraat 71,2018-12-21,07:00:00,18,0,18,FMN GV 11 Ramsel
66,Bergstraat 71,2018-12-21,08:00:00,34,6,28,FMN GV 11 Ramsel
66,Bergstraat 71,2018-12-21,09:00:00,20,14,6,FMN GV 11 Ramsel
66,Bergstraat 71,2018-12-21,10:00:00,22,10,12,FMN GV 11 Ramsel
66,Bergstraat 71,2018-12-21,11:00:00,24,18,6,FMN GV 11 Ramsel
66,Bergstraat 71,2018-12-21,12:00:00,8,2,6,FMN GV 11 Ramsel
66,Bergstraat 71,2018-12-21,13:00:00,10,8,2,FMN GV 11 Ramsel
66,Bergstraat 71,2018-12-21,14:00:00,16,4,12,FMN GV 11 Ramsel
66,Bergstraat 71,2018-12-21,15:00:00,28,20,8,FMN GV 11 Ramsel
66,Bergstraat 71,2018-12-21,16:00:00,30,16,14,FMN GV 11 Ramsel
66,Bergstraat 71,2018-12-21,17:00:00,20,14,6,FMN GV 11 Ramsel
66,Bergstraat 71,2018-12-21,18:00:00,10,4,6,FMN GV 11 Ramsel
66,Bergstraat 71,2018-12-21,19:00:00,10,2,8,FMN GV 11 Ramsel
66,Bergstraat 71,2018-12-21,20:00:00,6,4,2,FMN GV 11 Ramsel
66,Bergstraat 71,2018-12-21,21:00:00,18,4,14,FMN GV 11 Ramsel
66,Bergstraat 71,2018-12-21,22:00:00,4,2,2,FMN GV 11 Ramsel
66,Bergstraat 71,2018-12-21,23:00:00,2,0,2,FMN GV 11 Ramsel
66,Bergstraat 71,2018-12-22,00:00:00,0,0,0,FMN GV 11 Ramsel
66,Bergstraat 71,2018-12-22,01:00:00,4,2,2,FMN GV 11 Ramsel
66,Bergstraat 71,2018-12-22,02:00:00,12,12,0,FMN GV 11 Ramsel
66,Bergstraat 71,2018-12-22,03:00:00,2,2,0,FMN GV 11 Ramsel
66,Bergstraat 71,2018-12-22,04:00:00,10,6,4,FMN GV 11 Ramsel
66,Bergstraat 71,2018-12-22,05:00:00,2,2,0,FMN GV 11 Ramsel
66,Bergstraat 71,2018-12-22,06:00:00,2,0,2,FMN GV 11 Ramsel
66,Bergstraat 71,2018-12-22,07:00:00,2,2,0,FMN GV 11 Ramsel
66,Bergstraat 71,2018-12-22,08:00:00,6,0,6,FMN GV 11 Ramsel
66,Bergstraat 71,2018-12-22,09:00:00,30,12,18,FMN GV 11 Ramsel
66,Bergstraat 71,2018-12-22,10:00:00,36,12,24,FMN GV 11 Ramsel
66,Bergstraat 71,2018-12-22,11:00:00,32,12,20,FMN GV 11 Ramsel
66,Bergstraat 71,2018-12-22,12:00:00,62,34,28,FMN GV 11 Ramsel
66,Bergstraat 71,2018-12-22,13:00:00,70,34,36,FMN GV 11 Ramsel
66,Bergstraat 71,2018-12-22,14:00:00,88,32,56,FMN GV 11 Ramsel
66,Bergstraat 71,2018-12-22,15:00:00,74,48,26,FMN GV 11 Ramsel
66,Bergstraat 71,2018-12-22,16:00:00,50,30,20,FMN GV 11 Ramsel
66,Bergstraat 71,2018-12-22,17:00:00,18,12,6,FMN GV 11 Ramsel
66,Bergstraat 71,2018-12-22,18:00:00,16,10,6,FMN GV 11 Ramsel
66,Bergstraat 71,2018-12-22,19:00:00,6,4,2,FMN GV 11 Ramsel
66,Bergstraat 71,2018-12-22,20:00:00,2,2,0,FMN GV 11 Ramsel
66,Bergstraat 71,2018-12-22,21:00:00,0,0,0,FMN GV 11 Ramsel
66,Bergstraat 71,2018-12-22,22:00:00,6,4,2,FMN GV 11 Ramsel
66,Bergstraat 71,2018-12-22,23:00:00,6,4,2,FMN GV 11 Ramsel
66,Bergstraat 71,2018-12-23,00:00:00,0,0,0,FMN GV 11 Ramsel
66,Bergstraat 71,2018-12-23,01:00:00,16,8,8,FMN GV 11 Ramsel
66,Bergstraat 71,2018-12-23,02:00:00,6,6,0,FMN GV 11 Ramsel
66,Bergstraat 71,2018-12-23,03:00:00,2,2,0,FMN GV 11 Ramsel
66,Bergstraat 71,2018-12-23,04:00:00,0,0,0,FMN GV 11 Ramsel
66,Bergstraat 71,2018-12-23,05:00:00,2,0,2,FMN GV 11 Ramsel
66,Bergstraat 71,2018-12-23,06:00:00,6,0,6,FMN GV 11 Ramsel
66,Bergstraat 71,2018-12-23,07:00:00,4,0,4,FMN GV 11 Ramsel
66,Bergstraat 71,2018-12-23,08:00:00,40,14,26,FMN GV 11 Ramsel
66,Bergstraat 71,2018-12-23,09:00:00,48,24,24,FMN GV 11 Ramsel
66,Bergstraat 71,2018-12-23,10:00:00,52,38,14,FMN GV 11 Ramsel
66,Bergstraat 71,2018-12-23,11:00:00,30,24,6,FMN GV 11 Ramsel
66,Bergstraat 71,2018-12-23,12:00:00,20,10,10,FMN GV 11 Ramsel
66,Bergstraat 71,2018-12-23,13:00:00,8,4,4,FMN GV 11 Ramsel
66,Bergstraat 71,2018-12-23,14:00:00,4,2,2,FMN GV 11 Ramsel
66,Bergstraat 71,2018-12-23,15:00:00,4,4,0,FMN GV 11 Ramsel
66,Bergstraat 71,2018-12-23,16:00:00,4,0,4,FMN GV 11 Ramsel
66,Bergstraat 71,2018-12-23,17:00:00,2,2,0,FMN GV 11 Ramsel
66,Bergstraat 71,2018-12-23,18:00:00,4,0,4,FMN GV 11 Ramsel
66,Bergstraat 71,2018-12-23,19:00:00,4,0,4,FMN GV 11 Ramsel
66,Bergstraat 71,2018-12-23,20:00:00,2,2,0,FMN GV 11 Ramsel
66,Bergstraat 71,2018-12-23,21:00:00,2,2,0,FMN GV 11 Ramsel
66,Bergstraat 71,2018-12-23,22:00:00,0,0,0,FMN GV 11 Ramsel
66,Bergstraat 71,2018-12-23,23:00:00,2,2,0,FMN GV 11 Ramsel
66,Bergstraat 71,2018-12-24,00:00:00,0,0,0,FMN GV 11 Ramsel
66,Bergstraat 71,2018-12-24,01:00:00,0,0,0,FMN GV 11 Ramsel
66,Bergstraat 71,2018-12-24,02:00:00,0,0,0,FMN GV 11 Ramsel
66,Bergstraat 71,2018-12-24,03:00:00,4,2,2,FMN GV 11 Ramsel
66,Bergstraat 71,2018-12-24,04:00:00,0,0,0,FMN GV 11 Ramsel
66,Bergstraat 71,2018-12-24,05:00:00,0,0,0,FMN GV 11 Ramsel
66,Bergstraat 71,2018-12-24,06:00:00,6,0,6,FMN GV 11 Ramsel
66,Bergstraat 71,2018-12-24,07:00:00,6,2,4,FMN GV 11 Ramsel
66,Bergstraat 71,2018-12-24,08:00:00,16,4,12,FMN GV 11 Ramsel
66,Bergstraat 71,2018-12-24,09:00:00,20,16,4,FMN GV 11 Ramsel
66,Bergstraat 71,2018-12-24,10:00:00,62,34,28,FMN GV 11 Ramsel
66,Bergstraat 71,2018-12-24,11:00:00,48,24,24,FMN GV 11 Ramsel
66,Bergstraat 71,2018-12-24,12:00:00,84,46,38,FMN GV 11 Ramsel
66,Bergstraat 71,2018-12-24,13:00:00,104,48,56,FMN GV 11 Ramsel
66,Bergstraat 71,2018-12-24,14:00:00,108,50,58,FMN GV 11 Ramsel
66,Bergstraat 71,2018-12-24,15:00:00,98,50,48,FMN GV 11 Ramsel
66,Bergstraat 71,2018-12-24,16:00:00,64,52,12,FMN GV 11 Ramsel
66,Bergstraat 71,2018-12-24,17:00:00,24,16,8,FMN GV 11 Ramsel
66,Bergstraat 71,2018-12-24,18:00:00,12,4,8,FMN GV 11 Ramsel
66,Bergstraat 71,2018-12-24,19:00:00,4,2,2,FMN GV 11 Ramsel
66,Bergstraat 71,2018-12-24,20:00:00,8,6,2,FMN GV 11 Ramsel
66,Bergstraat 71,2018-12-24,21:00:00,0,0,0,FMN GV 11 Ramsel
66,Bergstraat 71,2018-12-24,22:00:00,4,2,2,FMN GV 11 Ramsel
66,Bergstraat 71,2018-12-24,23:00:00,2,0,2,FMN GV 11 Ramsel
66,Bergstraat 71,2018-12-25,00:00:00,2,2,0,FMN GV 11 Ramsel
66,Bergstraat 71,2018-12-25,01:00:00,0,0,0,FMN GV 11 Ramsel
66,Bergstraat 71,2018-12-25,02:00:00,4,2,2,FMN GV 11 Ramsel
66,Bergstraat 71,2018-12-25,03:00:00,0,0,0,FMN GV 11 Ramsel
66,Bergstraat 71,2018-12-25,04:00:00,4,4,0,FMN GV 11 Ramsel
66,Bergstraat 71,2018-12-25,05:00:00,0,0,0,FMN GV 11 Ramsel
66,Bergstraat 71,2018-12-25,06:00:00,0,0,0,FMN GV 11 Ramsel
66,Bergstraat 71,2018-12-25,07:00:00,2,0,2,FMN GV 11 Ramsel
66,Bergstraat 71,2018-12-25,08:00:00,8,6,2,FMN GV 11 Ramsel
66,Bergstraat 71,2018-12-25,09:00:00,18,6,12,FMN GV 11 Ramsel
66,Bergstraat 71,2018-12-25,10:00:00,54,38,16,FMN GV 11 Ramsel
66,Bergstraat 71,2018-12-25,11:00:00,64,38,26,FMN GV 11 Ramsel
66,Bergstraat 71,2018-12-25,12:00:00,62,30,32,FMN GV 11 Ramsel
66,Bergstraat 71,2018-12-25,13:00:00,44,20,24,FMN GV 11 Ramsel
66,Bergstraat 71,2018-12-25,14:00:00,38,26,12,FMN GV 11 Ramsel
66,Bergstraat 71,2018-12-25,15:00:00,52,28,24,FMN GV 11 Ramsel
66,Bergstraat 71,2018-12-25,16:00:00,12,6,6,FMN GV 11 Ramsel
66,Bergstraat 71,2018-12-25,17:00:00,6,4,2,FMN GV 11 Ramsel
66,Bergstraat 71,2018-12-25,18:00:00,2,2,0,FMN GV 11 Ramsel
66,Bergstraat 71,2018-12-25,19:00:00,2,0,2,FMN GV 11 Ramsel
66,Bergstraat 71,2018-12-25,20:00:00,2,2,0,FMN GV 11 Ramsel
66,Bergstraat 71,2018-12-25,21:00:00,2,2,0,FMN GV 11 Ramsel
66,Bergstraat 71,2018-12-25,22:00:00,0,0,0,FMN GV 11 Ramsel
66,Bergstraat 71,2018-12-25,23:00:00,0,0,0,FMN GV 11 Ramsel
66,Bergstraat 71,2018-12-26,00:00:00,0,0,0,FMN GV 11 Ramsel
66,Bergstraat 71,2018-12-26,01:00:00,0,0,0,FMN GV 11 Ramsel
66,Bergstraat 71,2018-12-26,02:00:00,0,0,0,FMN GV 11 Ramsel
66,Bergstraat 71,2018-12-26,03:00:00,0,0,0,FMN GV 11 Ramsel
66,Bergstraat 71,2018-12-26,04:00:00,0,0,0,FMN GV 11 Ramsel
66,Bergstraat 71,2018-12-26,05:00:00,2,0,2,FMN GV 11 Ramsel
66,Bergstraat 71,2018-12-26,06:00:00,2,2,0,FMN GV 11 Ramsel
66,Bergstraat 71,2018-12-26,07:00:00,4,0,4,FMN GV 11 Ramsel
66,Bergstraat 71,2018-12-26,08:00:00,16,10,6,FMN GV 11 Ramsel
66,Bergstraat 71,2018-12-26,09:00:00,8,2,6,FMN GV 11 Ramsel
66,Bergstraat 71,2018-12-26,10:00:00,28,10,18,FMN GV 11 Ramsel
66,Bergstraat 71,2018-12-26,11:00:00,44,34,10,FMN GV 11 Ramsel
66,Bergstraat 71,2018-12-26,12:00:00,42,24,18,FMN GV 11 Ramsel
66,Bergstraat 71,2018-12-26,13:00:00,96,32,64,FMN GV 11 Ramsel
66,Bergstraat 71,2018-12-26,14:00:00,88,48,40,FMN GV 11 Ramsel
66,Bergstraat 71,2018-12-26,15:00:00,56,38,18,FMN GV 11 Ramsel
66,Bergstraat 71,2018-12-26,16:00:00,42,26,16,FMN GV 11 Ramsel
66,Bergstraat 71,2018-12-26,17:00:00,34,20,14,FMN GV 11 Ramsel
66,Bergstraat 71,2018-12-26,18:00:00,22,12,10,FMN GV 11 Ramsel
66,Bergstraat 71,2018-12-26,19:00:00,12,4,8,FMN GV 11 Ramsel
66,Bergstraat 71,2018-12-26,20:00:00,10,8,2,FMN GV 11 Ramsel
66,Bergstraat 71,2018-12-26,21:00:00,4,2,2,FMN GV 11 Ramsel
66,Bergstraat 71,2018-12-26,22:00:00,0,0,0,FMN GV 11 Ramsel
66,Bergstraat 71,2018-12-26,23:00:00,2,2,0,FMN GV 11 Ramsel
66,Bergstraat 71,2018-12-27,00:00:00,2,0,2,FMN GV 11 Ramsel
66,Bergstraat 71,2018-12-27,01:00:00,0,0,0,FMN GV 11 Ramsel
66,Bergstraat 71,2018-12-27,02:00:00,0,0,0,FMN GV 11 Ramsel
66,Bergstraat 71,2018-12-27,03:00:00,0,0,0,FMN GV 11 Ramsel
66,Bergstraat 71,2018-12-27,04:00:00,0,0,0,FMN GV 11 Ramsel
66,Bergstraat 71,2018-12-27,05:00:00,2,0,2,FMN GV 11 Ramsel
66,Bergstraat 71,2018-12-27,06:00:00,6,2,4,FMN GV 11 Ramsel
66,Bergstraat 71,2018-12-27,07:00:00,0,0,0,FMN GV 11 Ramsel
66,Bergstraat 71,2018-12-27,08:00:00,16,4,12,FMN GV 11 Ramsel
66,Bergstraat 71,2018-12-27,09:00:00,16,8,8,FMN GV 11 Ramsel
66,Bergstraat 71,2018-12-27,10:00:00,34,18,16,FMN GV 11 Ramsel
66,Bergstraat 71,2018-12-27,11:00:00,32,14,18,FMN GV 11 Ramsel
66,Bergstraat 71,2018-12-27,12:00:00,28,14,14,FMN GV 11 Ramsel
66,Bergstraat 71,2018-12-27,13:00:00,106,42,64,FMN GV 11 Ramsel
66,Bergstraat 71,2018-12-27,14:00:00,82,26,56,FMN GV 11 Ramsel
66,Bergstraat 71,2018-12-27,15:00:00,58,34,24,FMN GV 11 Ramsel
66,Bergstraat 71,2018-12-27,16:00:00,50,34,16,FMN GV 11 Ramsel
66,Bergstraat 71,2018-12-27,17:00:00,18,18,0,FMN GV 11 Ramsel
66,Bergstraat 71,2018-12-27,18:00:00,18,6,12,FMN GV 11 Ramsel
66,Bergstraat 71,2018-12-27,19:00:00,6,4,2,FMN GV 11 Ramsel
66,Bergstraat 71,2018-12-27,20:00:00,18,16,2,FMN GV 11 Ramsel
66,Bergstraat 71,2018-12-27,21:00:00,2,0,2,FMN GV 11 Ramsel
66,Bergstraat 71,2018-12-27,22:00:00,6,6,0,FMN GV 11 Ramsel
66,Bergstraat 71,2018-12-27,23:00:00,2,2,0,FMN GV 11 Ramsel
66,Bergstraat 71,2018-12-28,00:00:00,4,4,0,FMN GV 11 Ramsel
66,Bergstraat 71,2018-12-28,01:00:00,0,0,0,FMN GV 11 Ramsel
66,Bergstraat 71,2018-12-28,02:00:00,2,2,0,FMN GV 11 Ramsel
66,Bergstraat 71,2018-12-28,03:00:00,2,0,2,FMN GV 11 Ramsel
66,Bergstraat 71,2018-12-28,04:00:00,0,0,0,FMN GV 11 Ramsel
66,Bergstraat 71,2018-12-28,05:00:00,0,0,0,FMN GV 11 Ramsel
66,Bergstraat 71,2018-12-28,06:00:00,2,0,2,FMN GV 11 Ramsel
66,Bergstraat 71,2018-12-28,07:00:00,4,0,4,FMN GV 11 Ramsel
66,Bergstraat 71,2018-12-28,08:00:00,4,2,2,FMN GV 11 Ramsel
66,Bergstraat 71,2018-12-28,09:00:00,6,4,2,FMN GV 11 Ramsel
66,Bergstraat 71,2018-12-28,10:00:00,12,2,10,FMN GV 11 Ramsel
66,Bergstraat 71,2018-12-28,11:00:00,18,12,6,FMN GV 11 Ramsel
66,Bergstraat 71,2018-12-28,12:00:00,50,36,14,FMN GV 11 Ramsel
66,Bergstraat 71,2018-12-28,13:00:00,28,10,18,FMN GV 11 Ramsel
66,Bergstraat 71,2018-12-28,14:00:00,50,22,28,FMN GV 11 Ramsel
66,Bergstraat 71,2018-12-28,15:00:00,32,18,14,FMN GV 11 Ramsel
66,Bergstraat 71,2018-12-28,16:00:00,32,16,16,FMN GV 11 Ramsel
66,Bergstraat 71,2018-12-28,17:00:00,6,4,2,FMN GV 11 Ramsel
66,Bergstraat 71,2018-12-28,18:00:00,8,4,4,FMN GV 11 Ramsel
66,Bergstraat 71,2018-12-28,19:00:00,6,4,2,FMN GV 11 Ramsel
66,Bergstraat 71,2018-12-28,20:00:00,4,0,4,FMN GV 11 Ramsel
66,Bergstraat 71,2018-12-28,21:00:00,2,2,0,FMN GV 11 Ramsel
66,Bergstraat 71,2018-12-28,22:00:00,2,2,0,FMN GV 11 Ramsel
66,Bergstraat 71,2018-12-28,23:00:00,2,2,0,FMN GV 11 Ramsel
66,Bergstraat 71,2018-12-29,00:00:00,0,0,0,FMN GV 11 Ramsel
66,Bergstraat 71,2018-12-29,01:00:00,2,2,0,FMN GV 11 Ramsel
66,Bergstraat 71,2018-12-29,02:00:00,2,0,2,FMN GV 11 Ramsel
66,Bergstraat 71,2018-12-29,03:00:00,2,0,2,FMN GV 11 Ramsel
66,Bergstraat 71,2018-12-29,04:00:00,6,4,2,FMN GV 11 Ramsel
66,Bergstraat 71,2018-12-29,05:00:00,2,0,2,FMN GV 11 Ramsel
66,Bergstraat 71,2018-12-29,06:00:00,0,0,0,FMN GV 11 Ramsel
66,Bergstraat 71,2018-12-29,07:00:00,0,0,0,FMN GV 11 Ramsel
66,Bergstraat 71,2018-12-29,08:00:00,12,4,8,FMN GV 11 Ramsel
66,Bergstraat 71,2018-12-29,09:00:00,36,10,26,FMN GV 11 Ramsel
66,Bergstraat 71,2018-12-29,10:00:00,40,14,26,FMN GV 11 Ramsel
66,Bergstraat 71,2018-12-29,11:00:00,60,32,28,FMN GV 11 Ramsel
66,Bergstraat 71,2018-12-29,12:00:00,62,34,28,FMN GV 11 Ramsel
66,Bergstraat 71,2018-12-29,13:00:00,56,32,24,FMN GV 11 Ramsel
66,Bergstraat 71,2018-12-29,14:00:00,58,24,34,FMN GV 11 Ramsel
66,Bergstraat 71,2018-12-29,15:00:00,30,18,12,FMN GV 11 Ramsel
66,Bergstraat 71,2018-12-29,16:00:00,16,8,8,FMN GV 11 Ramsel
66,Bergstraat 71,2018-12-29,17:00:00,6,4,2,FMN GV 11 Ramsel
66,Bergstraat 71,2018-12-29,18:00:00,12,8,4,FMN GV 11 Ramsel
66,Bergstraat 71,2018-12-29,19:00:00,4,2,2,FMN GV 11 Ramsel
66,Bergstraat 71,2018-12-29,20:00:00,6,2,4,FMN GV 11 Ramsel
66,Bergstraat 71,2018-12-29,21:00:00,0,0,0,FMN GV 11 Ramsel
66,Bergstraat 71,2018-12-29,22:00:00,2,0,2,FMN GV 11 Ramsel
66,Bergstraat 71,2018-12-29,23:00:00,4,4,0,FMN GV 11 Ramsel
66,Bergstraat 71,2018-12-30,00:00:00,0,0,0,FMN GV 11 Ramsel
66,Bergstraat 71,2018-12-30,01:00:00,2,2,0,FMN GV 11 Ramsel
66,Bergstraat 71,2018-12-30,02:00:00,4,2,2,FMN GV 11 Ramsel
66,Bergstraat 71,2018-12-30,03:00:00,0,0,0,FMN GV 11 Ramsel
66,Bergstraat 71,2018-12-30,04:00:00,0,0,0,FMN GV 11 Ramsel
66,Bergstraat 71,2018-12-30,05:00:00,0,0,0,FMN GV 11 Ramsel
66,Bergstraat 71,2018-12-30,06:00:00,2,0,2,FMN GV 11 Ramsel
66,Bergstraat 71,2018-12-30,07:00:00,0,0,0,FMN GV 11 Ramsel
66,Bergstraat 71,2018-12-30,08:00:00,22,8,14,FMN GV 11 Ramsel
66,Bergstraat 71,2018-12-30,09:00:00,68,32,36,FMN GV 11 Ramsel
66,Bergstraat 71,2018-12-30,10:00:00,46,22,24,FMN GV 11 Ramsel
66,Bergstraat 71,2018-12-30,11:00:00,74,38,36,FMN GV 11 Ramsel
66,Bergstraat 71,2018-12-30,12:00:00,58,32,26,FMN GV 11 Ramsel
66,Bergstraat 71,2018-12-30,13:00:00,52,30,22,FMN GV 11 Ramsel
66,Bergstraat 71,2018-12-30,14:00:00,88,48,40,FMN GV 11 Ramsel
66,Bergstraat 71,2018-12-30,15:00:00,46,24,22,FMN GV 11 Ramsel
66,Bergstraat 71,2018-12-30,16:00:00,38,20,18,FMN GV 11 Ramsel
66,Bergstraat 71,2018-12-30,17:00:00,12,8,4,FMN GV 11 Ramsel
66,Bergstraat 71,2018-12-30,18:00:00,2,2,0,FMN GV 11 Ramsel
66,Bergstraat 71,2018-12-30,19:00:00,0,0,0,FMN GV 11 Ramsel
66,Bergstraat 71,2018-12-30,20:00:00,0,0,0,FMN GV 11 Ramsel
66,Bergstraat 71,2018-12-30,21:00:00,0,0,0,FMN GV 11 Ramsel
66,Bergstraat 71,2018-12-30,22:00:00,0,0,0,FMN GV 11 Ramsel
66,Bergstraat 71,2018-12-30,23:00:00,4,2,2,FMN GV 11 Ramsel
66,Bergstraat 71,2018-12-31,00:00:00,4,0,4,FMN GV 11 Ramsel
66,Bergstraat 71,2018-12-31,01:00:00,0,0,0,FMN GV 11 Ramsel
66,Bergstraat 71,2018-12-31,02:00:00,4,4,0,FMN GV 11 Ramsel
66,Bergstraat 71,2018-12-31,03:00:00,0,0,0,FMN GV 11 Ramsel
66,Bergstraat 71,2018-12-31,04:00:00,0,0,0,FMN GV 11 Ramsel
66,Bergstraat 71,2018-12-31,05:00:00,0,0,0,FMN GV 11 Ramsel
66,Bergstraat 71,2018-12-31,06:00:00,10,4,6,FMN GV 11 Ramsel
66,Bergstraat 71,2018-12-31,07:00:00,8,2,6,FMN GV 11 Ramsel
66,Bergstraat 71,2018-12-31,08:00:00,10,6,4,FMN GV 11 Ramsel
66,Bergstraat 71,2018-12-31,09:00:00,40,30,10,FMN GV 11 Ramsel
66,Bergstraat 71,2018-12-31,10:00:00,44,14,30,FMN GV 11 Ramsel
66,Bergstraat 71,2018-12-31,11:00:00,42,16,26,FMN GV 11 Ramsel
66,Bergstraat 71,2018-12-31,12:00:00,26,16,10,FMN GV 11 Ramsel
66,Bergstraat 71,2018-12-31,13:00:00,58,18,40,FMN GV 11 Ramsel
66,Bergstraat 71,2018-12-31,14:00:00,70,36,34,FMN GV 11 Ramsel
66,Bergstraat 71,2018-12-31,15:00:00,66,44,22,FMN GV 11 Ramsel
66,Bergstraat 71,2018-12-31,16:00:00,34,22,12,FMN GV 11 Ramsel
66,Bergstraat 71,2018-12-31,17:00:00,16,6,10,FMN GV 11 Ramsel
66,Bergstraat 71,2018-12-31,18:00:00,20,8,12,FMN GV 11 Ramsel
66,Bergstraat 71,2018-12-31,19:00:00,16,8,8,FMN GV 11 Ramsel
66,Bergstraat 71,2018-12-31,20:00:00,4,2,2,FMN GV 11 Ramsel
66,Bergstraat 71,2018-12-31,21:00:00,0,0,0,FMN GV 11 Ramsel
66,Bergstraat 71,2018-12-31,22:00:00,8,8,0,FMN GV 11 Ramsel
66,Bergstraat 71,2018-12-31,23:00:00,2,0,2,FMN GV 11 Ramsel
66,Bergstraat 71,2019-01-01,00:00:00,10,6,4,FMN GV 11 Ramsel
66,Bergstraat 71,2019-01-01,01:00:00,12,2,10,FMN GV 11 Ramsel
66,Bergstraat 71,2019-01-01,02:00:00,24,18,6,FMN GV 11 Ramsel
66,Bergstraat 71,2019-01-01,03:00:00,8,2,6,FMN GV 11 Ramsel
66,Bergstraat 71,2019-01-01,04:00:00,14,10,4,FMN GV 11 Ramsel
66,Bergstraat 71,2019-01-01,05:00:00,0,0,0,FMN GV 11 Ramsel
66,Bergstraat 71,2019-01-01,06:00:00,6,2,4,FMN GV 11 Ramsel
66,Bergstraat 71,2019-01-01,07:00:00,2,2,0,FMN GV 11 Ramsel
66,Bergstraat 71,2019-01-01,08:00:00,6,2,4,FMN GV 11 Ramsel
66,Bergstraat 71,2019-01-01,09:00:00,16,0,16,FMN GV 11 Ramsel
66,Bergstraat 71,2019-01-01,10:00:00,40,16,24,FMN GV 11 Ramsel
66,Bergstraat 71,2019-01-01,11:00:00,46,38,8,FMN GV 11 Ramsel
66,Bergstraat 71,2019-01-01,12:00:00,26,10,16,FMN GV 11 Ramsel
66,Bergstraat 71,2019-01-01,13:00:00,8,4,4,FMN GV 11 Ramsel
66,Bergstraat 71,2019-01-01,14:00:00,8,4,4,FMN GV 11 Ramsel
66,Bergstraat 71,2019-01-01,15:00:00,10,6,4,FMN GV 11 Ramsel
66,Bergstraat 71,2019-01-01,16:00:00,2,2,0,FMN GV 11 Ramsel
66,Bergstraat 71,2019-01-01,17:00:00,10,6,4,FMN GV 11 Ramsel
66,Bergstraat 71,2019-01-01,18:00:00,4,4,0,FMN GV 11 Ramsel
66,Bergstraat 71,2019-01-01,19:00:00,0,0,0,FMN GV 11 Ramsel
66,Bergstraat 71,2019-01-01,20:00:00,0,0,0,FMN GV 11 Ramsel
66,Bergstraat 71,2019-01-01,21:00:00,8,2,6,FMN GV 11 Ramsel
66,Bergstraat 71,2019-01-01,22:00:00,2,0,2,FMN GV 11 Ramsel
66,Bergstraat 71,2019-01-01,23:00:00,0,0,0,FMN GV 11 Ramsel
66,Bergstraat 71,2019-01-02,00:00:00,0,0,0,FMN GV 11 Ramsel
66,Bergstraat 71,2019-01-02,01:00:00,0,0,0,FMN GV 11 Ramsel
66,Bergstraat 71,2019-01-02,02:00:00,0,0,0,FMN GV 11 Ramsel
66,Bergstraat 71,2019-01-02,03:00:00,0,0,0,FMN GV 11 Ramsel
66,Bergstraat 71,2019-01-02,04:00:00,2,2,0,FMN GV 11 Ramsel
66,Bergstraat 71,2019-01-02,05:00:00,0,0,0,FMN GV 11 Ramsel
66,Bergstraat 71,2019-01-02,06:00:00,14,6,8,FMN GV 11 Ramsel
66,Bergstraat 71,2019-01-02,07:00:00,22,4,18,FMN GV 11 Ramsel
66,Bergstraat 71,2019-01-02,08:00:00,24,10,14,FMN GV 11 Ramsel
66,Bergstraat 71,2019-01-02,09:00:00,14,4,10,FMN GV 11 Ramsel
66,Bergstraat 71,2019-01-02,10:00:00,30,6,24,FMN GV 11 Ramsel
66,Bergstraat 71,2019-01-02,11:00:00,28,8,20,FMN GV 11 Ramsel
66,Bergstraat 71,2019-01-02,12:00:00,40,22,18,FMN GV 11 Ramsel
66,Bergstraat 71,2019-01-02,13:00:00,72,44,28,FMN GV 11 Ramsel
66,Bergstraat 71,2019-01-02,14:00:00,90,34,56,FMN GV 11 Ramsel
66,Bergstraat 71,2019-01-02,15:00:00,66,38,28,FMN GV 11 Ramsel
66,Bergstraat 71,2019-01-02,16:00:00,50,36,14,FMN GV 11 Ramsel
66,Bergstraat 71,2019-01-02,17:00:00,42,22,20,FMN GV 11 Ramsel
66,Bergstraat 71,2019-01-02,18:00:00,26,14,12,FMN GV 11 Ramsel
66,Bergstraat 71,2019-01-02,19:00:00,20,4,16,FMN GV 11 Ramsel
66,Bergstraat 71,2019-01-02,20:00:00,28,20,8,FMN GV 11 Ramsel
66,Bergstraat 71,2019-01-02,21:00:00,14,14,0,FMN GV 11 Ramsel
66,Bergstraat 71,2019-01-02,22:00:00,6,6,0,FMN GV 11 Ramsel
66,Bergstraat 71,2019-01-02,23:00:00,2,2,0,FMN GV 11 Ramsel
66,Bergstraat 71,2019-01-03,00:00:00,6,4,2,FMN GV 11 Ramsel
66,Bergstraat 71,2019-01-03,01:00:00,0,0,0,FMN GV 11 Ramsel
66,Bergstraat 71,2019-01-03,02:00:00,0,0,0,FMN GV 11 Ramsel
66,Bergstraat 71,2019-01-03,03:00:00,0,0,0,FMN GV 11 Ramsel
66,Bergstraat 71,2019-01-03,04:00:00,2,0,2,FMN GV 11 Ramsel
66,Bergstraat 71,2019-01-03,05:00:00,0,0,0,FMN GV 11 Ramsel
66,Bergstraat 71,2019-01-03,06:00:00,22,4,18,FMN GV 11 Ramsel
66,Bergstraat 71,2019-01-03,07:00:00,28,6,22,FMN GV 11 Ramsel
66,Bergstraat 71,2019-01-03,08:00:00,28,6,22,FMN GV 11 Ramsel
66,Bergstraat 71,2019-01-03,09:00:00,22,8,14,FMN GV 11 Ramsel
66,Bergstraat 71,2019-01-03,10:00:00,40,16,24,FMN GV 11 Ramsel
66,Bergstraat 71,2019-01-03,11:00:00,26,8,18,FMN GV 11 Ramsel
66,Bergstraat 71,2019-01-03,12:00:00,36,20,16,FMN GV 11 Ramsel
66,Bergstraat 71,2019-01-03,13:00:00,52,28,24,FMN GV 11 Ramsel
66,Bergstraat 71,2019-01-03,14:00:00,76,32,44,FMN GV 11 Ramsel
66,Bergstraat 71,2019-01-03,15:00:00,86,52,34,FMN GV 11 Ramsel
66,Bergstraat 71,2019-01-03,16:00:00,56,38,18,FMN GV 11 Ramsel
66,Bergstraat 71,2019-01-03,17:00:00,32,20,12,FMN GV 11 Ramsel
66,Bergstraat 71,2019-01-03,18:00:00,32,14,18,FMN GV 11 Ramsel
66,Bergstraat 71,2019-01-03,19:00:00,10,6,4,FMN GV 11 Ramsel
66,Bergstraat 71,2019-01-03,20:00:00,32,28,4,FMN GV 11 Ramsel
66,Bergstraat 71,2019-01-03,21:00:00,6,6,0,FMN GV 11 Ramsel
66,Bergstraat 71,2019-01-03,22:00:00,6,2,4,FMN GV 11 Ramsel
66,Bergstraat 71,2019-01-03,23:00:00,2,2,0,FMN GV 11 Ramsel
66,Bergstraat 71,2019-01-04,00:00:00,2,2,0,FMN GV 11 Ramsel
66,Bergstraat 71,2019-01-04,01:00:00,0,0,0,FMN GV 11 Ramsel
66,Bergstraat 71,2019-01-04,02:00:00,0,0,0,FMN GV 11 Ramsel
66,Bergstraat 71,2019-01-04,03:00:00,0,0,0,FMN GV 11 Ramsel
66,Bergstraat 71,2019-01-04,04:00:00,2,0,2,FMN GV 11 Ramsel
66,Bergstraat 71,2019-01-04,05:00:00,0,0,0,FMN GV 11 Ramsel
66,Bergstraat 71,2019-01-04,06:00:00,20,4,16,FMN GV 11 Ramsel
66,Bergstraat 71,2019-01-04,07:00:00,22,8,14,FMN GV 11 Ramsel
66,Bergstraat 71,2019-01-04,08:00:00,10,4,6,FMN GV 11 Ramsel
66,Bergstraat 71,2019-01-04,09:00:00,18,6,12,FMN GV 11 Ramsel
66,Bergstraat 71,2019-01-04,10:00:00,26,16,10,FMN GV 11 Ramsel
66,Bergstraat 71,2019-01-04,11:00:00,46,28,18,FMN GV 11 Ramsel
66,Bergstraat 71,2019-01-04,12:00:00,34,22,12,FMN GV 11 Ramsel
66,Bergstraat 71,2019-01-04,13:00:00,36,18,18,FMN GV 11 Ramsel
66,Bergstraat 71,2019-01-04,14:00:00,32,14,18,FMN GV 11 Ramsel
66,Bergstraat 71,2019-01-04,15:00:00,46,12,34,FMN GV 11 Ramsel
66,Bergstraat 71,2019-01-04,16:00:00,44,26,18,FMN GV 11 Ramsel
66,Bergstraat 71,2019-01-04,17:00:00,18,14,4,FMN GV 11 Ramsel
66,Bergstraat 71,2019-01-04,18:00:00,10,4,6,FMN GV 11 Ramsel
66,Bergstraat 71,2019-01-04,19:00:00,14,8,6,FMN GV 11 Ramsel
66,Bergstraat 71,2019-01-04,20:00:00,6,4,2,FMN GV 11 Ramsel
66,Bergstraat 71,2019-01-04,21:00:00,4,2,2,FMN GV 11 Ramsel
66,Bergstraat 71,2019-01-04,22:00:00,4,0,4,FMN GV 11 Ramsel
66,Bergstraat 71,2019-01-04,23:00:00,2,2,0,FMN GV 11 Ramsel
66,Bergstraat 71,2019-01-05,00:00:00,6,4,2,FMN GV 11 Ramsel
66,Bergstraat 71,2019-01-05,01:00:00,0,0,0,FMN GV 11 Ramsel
66,Bergstraat 71,2019-01-05,02:00:00,2,2,0,FMN GV 11 Ramsel
66,Bergstraat 71,2019-01-05,03:00:00,2,2,0,FMN GV 11 Ramsel
66,Bergstraat 71,2019-01-05,04:00:00,0,0,0,FMN GV 11 Ramsel
66,Bergstraat 71,2019-01-05,05:00:00,0,0,0,FMN GV 11 Ramsel
66,Bergstraat 71,2019-01-05,06:00:00,2,0,2,FMN GV 11 Ramsel
66,Bergstraat 71,2019-01-05,07:00:00,6,2,4,FMN GV 11 Ramsel
66,Bergstraat 71,2019-01-05,08:00:00,12,6,6,FMN GV 11 Ramsel
66,Bergstraat 71,2019-01-05,09:00:00,20,10,10,FMN GV 11 Ramsel
66,Bergstraat 71,2019-01-05,10:00:00,44,28,16,FMN GV 11 Ramsel
66,Bergstraat 71,2019-01-05,11:00:00,30,4,26,FMN GV 11 Ramsel
66,Bergstraat 71,2019-01-05,12:00:00,42,24,18,FMN GV 11 Ramsel
66,Bergstraat 71,2019-01-05,13:00:00,72,36,36,FMN GV 11 Ramsel
66,Bergstraat 71,2019-01-05,14:00:00,50,18,32,FMN GV 11 Ramsel
66,Bergstraat 71,2019-01-05,15:00:00,62,40,22,FMN GV 11 Ramsel
66,Bergstraat 71,2019-01-05,16:00:00,24,14,10,FMN GV 11 Ramsel
66,Bergstraat 71,2019-01-05,17:00:00,12,6,6,FMN GV 11 Ramsel
66,Bergstraat 71,2019-01-05,18:00:00,6,4,2,FMN GV 11 Ramsel
66,Bergstraat 71,2019-01-05,19:00:00,2,0,2,FMN GV 11 Ramsel
66,Bergstraat 71,2019-01-05,20:00:00,4,0,4,FMN GV 11 Ramsel
66,Bergstraat 71,2019-01-05,21:00:00,4,2,2,FMN GV 11 Ramsel
66,Bergstraat 71,2019-01-05,22:00:00,6,2,4,FMN GV 11 Ramsel
66,Bergstraat 71,2019-01-05,23:00:00,2,2,0,FMN GV 11 Ramsel
66,Bergstraat 71,2019-01-06,00:00:00,10,8,2,FMN GV 11 Ramsel
66,Bergstraat 71,2019-01-06,01:00:00,0,0,0,FMN GV 11 Ramsel
66,Bergstraat 71,2019-01-06,02:00:00,4,2,2,FMN GV 11 Ramsel
66,Bergstraat 71,2019-01-06,03:00:00,0,0,0,FMN GV 11 Ramsel
66,Bergstraat 71,2019-01-06,04:00:00,2,2,0,FMN GV 11 Ramsel
66,Bergstraat 71,2019-01-06,05:00:00,0,0,0,FMN GV 11 Ramsel
66,Bergstraat 71,2019-01-06,06:00:00,0,0,0,FMN GV 11 Ramsel
66,Bergstraat 71,2019-01-06,07:00:00,2,2,0,FMN GV 11 Ramsel
66,Bergstraat 71,2019-01-06,08:00:00,20,10,10,FMN GV 11 Ramsel
66,Bergstraat 71,2019-01-06,09:00:00,100,26,74,FMN GV 11 Ramsel
66,Bergstraat 71,2019-01-06,10:00:00,80,36,44,FMN GV 11 Ramsel
66,Bergstraat 71,2019-01-06,11:00:00,98,68,30,FMN GV 11 Ramsel
66,Bergstraat 71,2019-01-06,12:00:00,44,28,16,FMN GV 11 Ramsel
66,Bergstraat 71,2019-01-06,13:00:00,38,14,24,FMN GV 11 Ramsel
66,Bergstraat 71,2019-01-06,14:00:00,48,28,20,FMN GV 11 Ramsel
66,Bergstraat 71,2019-01-06,15:00:00,52,26,26,FMN GV 11 Ramsel
66,Bergstraat 71,2019-01-06,16:00:00,14,8,6,FMN GV 11 Ramsel
66,Bergstraat 71,2019-01-06,17:00:00,12,6,6,FMN GV 11 Ramsel
66,Bergstraat 71,2019-01-06,18:00:00,4,2,2,FMN GV 11 Ramsel
66,Bergstraat 71,2019-01-06,19:00:00,8,2,6,FMN GV 11 Ramsel
66,Bergstraat 71,2019-01-06,20:00:00,4,2,2,FMN GV 11 Ramsel
66,Bergstraat 71,2019-01-06,21:00:00,0,0,0,FMN GV 11 Ramsel
66,Bergstraat 71,2019-01-06,22:00:00,2,0,2,FMN GV 11 Ramsel
66,Bergstraat 71,2019-01-06,23:00:00,0,0,0,FMN GV 11 Ramsel
66,Bergstraat 71,2019-01-07,00:00:00,2,2,0,FMN GV 11 Ramsel
66,Bergstraat 71,2019-01-07,01:00:00,0,0,0,FMN GV 11 Ramsel
66,Bergstraat 71,2019-01-07,02:00:00,0,0,0,FMN GV 11 Ramsel
66,Bergstraat 71,2019-01-07,03:00:00,0,0,0,FMN GV 11 Ramsel
66,Bergstraat 71,2019-01-07,04:00:00,2,2,0,FMN GV 11 Ramsel
66,Bergstraat 71,2019-01-07,05:00:00,8,8,0,FMN GV 11 Ramsel
66,Bergstraat 71,2019-01-07,06:00:00,38,14,24,FMN GV 11 Ramsel
66,Bergstraat 71,2019-01-07,07:00:00,122,16,106,FMN GV 11 Ramsel
66,Bergstraat 71,2019-01-07,08:00:00,132,26,106,FMN GV 11 Ramsel
66,Bergstraat 71,2019-01-07,09:00:00,24,12,12,FMN GV 11 Ramsel
66,Bergstraat 71,2019-01-07,10:00:00,24,8,16,FMN GV 11 Ramsel
66,Bergstraat 71,2019-01-07,11:00:00,24,10,14,FMN GV 11 Ramsel
66,Bergstraat 71,2019-01-07,12:00:00,34,22,12,FMN GV 11 Ramsel
66,Bergstraat 71,2019-01-07,13:00:00,44,32,12,FMN GV 11 Ramsel
66,Bergstraat 71,2019-01-07,14:00:00,36,18,18,FMN GV 11 Ramsel
66,Bergstraat 71,2019-01-07,15:00:00,166,138,28,FMN GV 11 Ramsel
66,Bergstraat 71,2019-01-07,16:00:00,74,56,18,FMN GV 11 Ramsel
66,Bergstraat 71,2019-01-07,17:00:00,50,32,18,FMN GV 11 Ramsel
66,Bergstraat 71,2019-01-07,18:00:00,24,12,12,FMN GV 11 Ramsel
66,Bergstraat 71,2019-01-07,19:00:00,14,4,10,FMN GV 11 Ramsel
66,Bergstraat 71,2019-01-07,20:00:00,16,10,6,FMN GV 11 Ramsel
66,Bergstraat 71,2019-01-07,21:00:00,0,0,0,FMN GV 11 Ramsel
66,Bergstraat 71,2019-01-07,22:00:00,4,4,0,FMN GV 11 Ramsel
66,Bergstraat 71,2019-01-07,23:00:00,0,0,0,FMN GV 11 Ramsel
66,Bergstraat 71,2019-01-08,00:00:00,0,0,0,FMN GV 11 Ramsel
66,Bergstraat 71,2019-01-08,01:00:00,0,0,0,FMN GV 11 Ramsel
66,Bergstraat 71,2019-01-08,02:00:00,0,0,0,FMN GV 11 Ramsel
66,Bergstraat 71,2019-01-08,03:00:00,0,0,0,FMN GV 11 Ramsel
66,Bergstraat 71,2019-01-08,04:00:00,2,2,0,FMN GV 11 Ramsel
66,Bergstraat 71,2019-01-08,05:00:00,10,6,4,FMN GV 11 Ramsel
66,Bergstraat 71,2019-01-08,06:00:00,34,14,20,FMN GV 11 Ramsel
66,Bergstraat 71,2019-01-08,07:00:00,102,32,70,FMN GV 11 Ramsel
66,Bergstraat 71,2019-01-08,08:00:00,106,12,94,FMN GV 11 Ramsel
66,Bergstraat 71,2019-01-08,09:00:00,18,4,14,FMN GV 11 Ramsel
66,Bergstraat 71,2019-01-08,10:00:00,8,2,6,FMN GV 11 Ramsel
66,Bergstraat 71,2019-01-08,11:00:00,14,10,4,FMN GV 11 Ramsel
66,Bergstraat 71,2019-01-08,12:00:00,16,2,14,FMN GV 11 Ramsel
66,Bergstraat 71,2019-01-08,13:00:00,30,10,20,FMN GV 11 Ramsel
66,Bergstraat 71,2019-01-08,14:00:00,16,10,6,FMN GV 11 Ramsel
66,Bergstraat 71,2019-01-08,15:00:00,102,84,18,FMN GV 11 Ramsel
66,Bergstraat 71,2019-01-08,16:00:00,72,56,16,FMN GV 11 Ramsel
66,Bergstraat 71,2019-01-08,17:00:00,38,28,10,FMN GV 11 Ramsel
66,Bergstraat 71,2019-01-08,18:00:00,30,24,6,FMN GV 11 Ramsel
66,Bergstraat 71,2019-01-08,19:00:00,16,4,12,FMN GV 11 Ramsel
66,Bergstraat 71,2019-01-08,20:00:00,12,10,2,FMN GV 11 Ramsel
66,Bergstraat 71,2019-01-08,21:00:00,2,2,0,FMN GV 11 Ramsel
66,Bergstraat 71,2019-01-08,22:00:00,6,2,4,FMN GV 11 Ramsel
66,Bergstraat 71,2019-01-08,23:00:00,2,2,0,FMN GV 11 Ramsel
66,Bergstraat 71,2019-01-09,00:00:00,0,0,0,FMN GV 11 Ramsel
66,Bergstraat 71,2019-01-09,01:00:00,0,0,0,FMN GV 11 Ramsel
66,Bergstraat 71,2019-01-09,02:00:00,0,0,0,FMN GV 11 Ramsel
66,Bergstraat 71,2019-01-09,03:00:00,4,2,2,FMN GV 11 Ramsel
66,Bergstraat 71,2019-01-09,04:00:00,2,2,0,FMN GV 11 Ramsel
66,Bergstraat 71,2019-01-09,05:00:00,4,2,2,FMN GV 11 Ramsel
66,Bergstraat 71,2019-01-09,06:00:00,38,14,24,FMN GV 11 Ramsel
66,Bergstraat 71,2019-01-09,07:00:00,106,16,90,FMN GV 11 Ramsel
66,Bergstraat 71,2019-01-09,08:00:00,128,18,110,FMN GV 11 Ramsel
66,Bergstraat 71,2019-01-09,09:00:00,26,8,18,FMN GV 11 Ramsel
66,Bergstraat 71,2019-01-09,10:00:00,36,24,12,FMN GV 11 Ramsel
66,Bergstraat 71,2019-01-09,11:00:00,26,8,18,FMN GV 11 Ramsel
66,Bergstraat 71,2019-01-09,12:00:00,172,122,50,FMN GV 11 Ramsel
66,Bergstraat 71,2019-01-09,13:00:00,64,40,24,FMN GV 11 Ramsel
66,Bergstraat 71,2019-01-09,14:00:00,88,38,50,FMN GV 11 Ramsel
66,Bergstraat 71,2019-01-09,15:00:00,76,32,44,FMN GV 11 Ramsel
66,Bergstraat 71,2019-01-09,16:00:00,64,42,22,FMN GV 11 Ramsel
66,Bergstraat 71,2019-01-09,17:00:00,50,34,16,FMN GV 11 Ramsel
66,Bergstraat 71,2019-01-09,18:00:00,30,14,16,FMN GV 11 Ramsel
66,Bergstraat 71,2019-01-09,19:00:00,20,18,2,FMN GV 11 Ramsel
66,Bergstraat 71,2019-01-09,20:00:00,14,8,6,FMN GV 11 Ramsel
66,Bergstraat 71,2019-01-09,21:00:00,4,0,4,FMN GV 11 Ramsel
66,Bergstraat 71,2019-01-09,22:00:00,0,0,0,FMN GV 11 Ramsel
66,Bergstraat 71,2019-01-09,23:00:00,4,4,0,FMN GV 11 Ramsel
66,Bergstraat 71,2019-01-10,00:00:00,0,0,0,FMN GV 11 Ramsel
66,Bergstraat 71,2019-01-10,01:00:00,0,0,0,FMN GV 11 Ramsel
66,Bergstraat 71,2019-01-10,02:00:00,0,0,0,FMN GV 11 Ramsel
66,Bergstraat 71,2019-01-10,03:00:00,0,0,0,FMN GV 11 Ramsel
66,Bergstraat 71,2019-01-10,04:00:00,2,2,0,FMN GV 11 Ramsel
66,Bergstraat 71,2019-01-10,05:00:00,6,4,2,FMN GV 11 Ramsel
66,Bergstraat 71,2019-01-10,06:00:00,20,6,14,FMN GV 11 Ramsel
66,Bergstraat 71,2019-01-10,07:00:00,52,20,32,FMN GV 11 Ramsel
66,Bergstraat 71,2019-01-10,08:00:00,102,32,70,FMN GV 11 Ramsel
66,Bergstraat 71,2019-01-10,09:00:00,10,2,8,FMN GV 11 Ramsel
66,Bergstraat 71,2019-01-10,10:00:00,28,22,6,FMN GV 11 Ramsel
66,Bergstraat 71,2019-01-10,11:00:00,14,4,10,FMN GV 11 Ramsel
66,Bergstraat 71,2019-01-10,12:00:00,34,20,14,FMN GV 11 Ramsel
66,Bergstraat 71,2019-01-10,13:00:00,64,24,40,FMN GV 11 Ramsel
66,Bergstraat 71,2019-01-10,14:00:00,56,26,30,FMN GV 11 Ramsel
66,Bergstraat 71,2019-01-10,15:00:00,148,100,48,FMN GV 11 Ramsel
66,Bergstraat 71,2019-01-10,16:00:00,106,74,32,FMN GV 11 Ramsel
66,Bergstraat 71,2019-01-10,17:00:00,40,30,10,FMN GV 11 Ramsel
66,Bergstraat 71,2019-01-10,18:00:00,38,22,16,FMN GV 11 Ramsel
66,Bergstraat 71,2019-01-10,19:00:00,14,8,6,FMN GV 11 Ramsel
66,Bergstraat 71,2019-01-10,20:00:00,26,22,4,FMN GV 11 Ramsel
66,Bergstraat 71,2019-01-10,21:00:00,10,8,2,FMN GV 11 Ramsel
66,Bergstraat 71,2019-01-10,22:00:00,6,6,0,FMN GV 11 Ramsel
66,Bergstraat 71,2019-01-10,23:00:00,2,2,0,FMN GV 11 Ramsel
66,Bergstraat 71,2019-01-11,00:00:00,0,0,0,FMN GV 11 Ramsel
66,Bergstraat 71,2019-01-11,01:00:00,0,0,0,FMN GV 11 Ramsel
66,Bergstraat 71,2019-01-11,02:00:00,0,0,0,FMN GV 11 Ramsel
66,Bergstraat 71,2019-01-11,03:00:00,0,0,0,FMN GV 11 Ramsel
66,Bergstraat 71,2019-01-11,04:00:00,6,2,4,FMN GV 11 Ramsel
66,Bergstraat 71,2019-01-11,05:00:00,2,2,0,FMN GV 11 Ramsel
66,Bergstraat 71,2019-01-11,06:00:00,32,10,22,FMN GV 11 Ramsel
66,Bergstraat 71,2019-01-11,07:00:00,82,18,64,FMN GV 11 Ramsel
66,Bergstraat 71,2019-01-11,08:00:00,82,8,74,FMN GV 11 Ramsel
66,Bergstraat 71,2019-01-11,09:00:00,6,0,6,FMN GV 11 Ramsel
66,Bergstraat 71,2019-01-11,10:00:00,10,4,6,FMN GV 11 Ramsel
66,Bergstraat 71,2019-01-11,11:00:00,14,6,8,FMN GV 11 Ramsel
66,Bergstraat 71,2019-01-11,12:00:00,24,16,8,FMN GV 11 Ramsel
66,Bergstraat 71,2019-01-11,13:00:00,30,16,14,FMN GV 11 Ramsel
66,Bergstraat 71,2019-01-11,14:00:00,58,22,36,FMN GV 11 Ramsel
66,Bergstraat 71,2019-01-11,15:00:00,106,78,28,FMN GV 11 Ramsel
66,Bergstraat 71,2019-01-11,16:00:00,78,48,30,FMN GV 11 Ramsel
66,Bergstraat 71,2019-01-11,17:00:00,40,26,14,FMN GV 11 Ramsel
66,Bergstraat 71,2019-01-11,18:00:00,24,12,12,FMN GV 11 Ramsel
66,Bergstraat 71,2019-01-11,19:00:00,8,0,8,FMN GV 11 Ramsel
66,Bergstraat 71,2019-01-11,20:00:00,12,2,10,FMN GV 11 Ramsel
66,Bergstraat 71,2019-01-11,21:00:00,4,2,2,FMN GV 11 Ramsel
66,Bergstraat 71,2019-01-11,22:00:00,8,2,6,FMN GV 11 Ramsel
66,Bergstraat 71,2019-01-11,23:00:00,4,2,2,FMN GV 11 Ramsel
66,Bergstraat 71,2019-01-12,00:00:00,2,2,0,FMN GV 11 Ramsel
66,Bergstraat 71,2019-01-12,01:00:00,6,6,0,FMN GV 11 Ramsel
66,Bergstraat 71,2019-01-12,02:00:00,2,2,0,FMN GV 11 Ramsel
66,Bergstraat 71,2019-01-12,03:00:00,0,0,0,FMN GV 11 Ramsel
66,Bergstraat 71,2019-01-12,04:00:00,2,0,2,FMN GV 11 Ramsel
66,Bergstraat 71,2019-01-12,05:00:00,4,2,2,FMN GV 11 Ramsel
66,Bergstraat 71,2019-01-12,06:00:00,0,0,0,FMN GV 11 Ramsel
66,Bergstraat 71,2019-01-12,07:00:00,4,2,2,FMN GV 11 Ramsel
66,Bergstraat 71,2019-01-12,08:00:00,16,6,10,FMN GV 11 Ramsel
66,Bergstraat 71,2019-01-12,09:00:00,42,16,26,FMN GV 11 Ramsel
66,Bergstraat 71,2019-01-12,10:00:00,52,24,28,FMN GV 11 Ramsel
66,Bergstraat 71,2019-01-12,11:00:00,56,36,20,FMN GV 11 Ramsel
66,Bergstraat 71,2019-01-12,12:00:00,38,22,16,FMN GV 11 Ramsel
66,Bergstraat 71,2019-01-12,13:00:00,18,12,6,FMN GV 11 Ramsel
66,Bergstraat 71,2019-01-12,14:00:00,10,6,4,FMN GV 11 Ramsel
66,Bergstraat 71,2019-01-12,15:00:00,4,0,4,FMN GV 11 Ramsel
66,Bergstraat 71,2019-01-12,16:00:00,10,8,2,FMN GV 11 Ramsel
66,Bergstraat 71,2019-01-12,17:00:00,12,2,10,FMN GV 11 Ramsel
66,Bergstraat 71,2019-01-12,18:00:00,8,4,4,FMN GV 11 Ramsel
66,Bergstraat 71,2019-01-12,19:00:00,4,0,4,FMN GV 11 Ramsel
66,Bergstraat 71,2019-01-12,20:00:00,6,2,4,FMN GV 11 Ramsel
66,Bergstraat 71,2019-01-12,21:00:00,4,2,2,FMN GV 11 Ramsel
66,Bergstraat 71,2019-01-12,22:00:00,4,2,2,FMN GV 11 Ramsel
66,Bergstraat 71,2019-01-12,23:00:00,4,2,2,FMN GV 11 Ramsel
66,Bergstraat 71,2019-01-13,00:00:00,4,2,2,FMN GV 11 Ramsel
66,Bergstraat 71,2019-01-13,01:00:00,2,0,2,FMN GV 11 Ramsel
66,Bergstraat 71,2019-01-13,02:00:00,2,2,0,FMN GV 11 Ramsel
66,Bergstraat 71,2019-01-13,03:00:00,4,4,0,FMN GV 11 Ramsel
66,Bergstraat 71,2019-01-13,04:00:00,0,0,0,FMN GV 11 Ramsel
66,Bergstraat 71,2019-01-13,05:00:00,0,0,0,FMN GV 11 Ramsel
66,Bergstraat 71,2019-01-13,06:00:00,2,2,0,FMN GV 11 Ramsel
66,Bergstraat 71,2019-01-13,07:00:00,0,0,0,FMN GV 11 Ramsel
66,Bergstraat 71,2019-01-13,08:00:00,6,4,2,FMN GV 11 Ramsel
66,Bergstraat 71,2019-01-13,09:00:00,22,8,14,FMN GV 11 Ramsel
66,Bergstraat 71,2019-01-13,10:00:00,40,16,24,FMN GV 11 Ramsel
66,Bergstraat 71,2019-01-13,11:00:00,52,38,14,FMN GV 11 Ramsel
66,Bergstraat 71,2019-01-13,12:00:00,24,18,6,FMN GV 11 Ramsel
66,Bergstraat 71,2019-01-13,13:00:00,2,2,0,FMN GV 11 Ramsel
66,Bergstraat 71,2019-01-13,14:00:00,2,2,0,FMN GV 11 Ramsel
66,Bergstraat 71,2019-01-13,15:00:00,8,4,4,FMN GV 11 Ramsel
66,Bergstraat 71,2019-01-13,16:00:00,4,0,4,FMN GV 11 Ramsel
66,Bergstraat 71,2019-01-13,17:00:00,0,0,0,FMN GV 11 Ramsel
66,Bergstraat 71,2019-01-13,18:00:00,2,0,2,FMN GV 11 Ramsel
66,Bergstraat 71,2019-01-13,19:00:00,6,0,6,FMN GV 11 Ramsel
66,Bergstraat 71,2019-01-13,20:00:00,6,4,2,FMN GV 11 Ramsel
66,Bergstraat 71,2019-01-13,21:00:00,2,2,0,FMN GV 11 Ramsel
66,Bergstraat 71,2019-01-13,22:00:00,0,0,0,FMN GV 11 Ramsel
66,Bergstraat 71,2019-01-13,23:00:00,0,0,0,FMN GV 11 Ramsel
66,Bergstraat 71,2019-01-14,00:00:00,2,2,0,FMN GV 11 Ramsel
66,Bergstraat 71,2019-01-14,01:00:00,0,0,0,FMN GV 11 Ramsel
66,Bergstraat 71,2019-01-14,02:00:00,0,0,0,FMN GV 11 Ramsel
66,Bergstraat 71,2019-01-14,03:00:00,4,2,2,FMN GV 11 Ramsel
66,Bergstraat 71,2019-01-14,04:00:00,2,2,0,FMN GV 11 Ramsel
66,Bergstraat 71,2019-01-14,05:00:00,2,2,0,FMN GV 11 Ramsel
66,Bergstraat 71,2019-01-14,06:00:00,18,2,16,FMN GV 11 Ramsel
66,Bergstraat 71,2019-01-14,07:00:00,62,6,56,FMN GV 11 Ramsel
66,Bergstraat 71,2019-01-14,08:00:00,88,8,80,FMN GV 11 Ramsel
66,Bergstraat 71,2019-01-14,09:00:00,30,8,22,FMN GV 11 Ramsel
66,Bergstraat 71,2019-01-14,10:00:00,18,8,10,FMN GV 11 Ramsel
66,Bergstraat 71,2019-01-14,11:00:00,20,12,8,FMN GV 11 Ramsel
66,Bergstraat 71,2019-01-14,12:00:00,30,22,8,FMN GV 11 Ramsel
66,Bergstraat 71,2019-01-14,13:00:00,54,26,28,FMN GV 11 Ramsel
66,Bergstraat 71,2019-01-14,14:00:00,42,24,18,FMN GV 11 Ramsel
66,Bergstraat 71,2019-01-14,15:00:00,104,62,42,FMN GV 11 Ramsel
66,Bergstraat 71,2019-01-14,16:00:00,110,94,16,FMN GV 11 Ramsel
66,Bergstraat 71,2019-01-14,17:00:00,38,28,10,FMN GV 11 Ramsel
66,Bergstraat 71,2019-01-14,18:00:00,12,8,4,FMN GV 11 Ramsel
66,Bergstraat 71,2019-01-14,19:00:00,6,0,6,FMN GV 11 Ramsel
66,Bergstraat 71,2019-01-14,20:00:00,10,8,2,FMN GV 11 Ramsel
66,Bergstraat 71,2019-01-14,21:00:00,2,0,2,FMN GV 11 Ramsel
66,Bergstraat 71,2019-01-14,22:00:00,6,2,4,FMN GV 11 Ramsel
66,Bergstraat 71,2019-01-14,23:00:00,2,0,2,FMN GV 11 Ramsel
66,Bergstraat 71,2019-01-15,00:00:00,2,2,0,FMN GV 11 Ramsel
66,Bergstraat 71,2019-01-15,01:00:00,0,0,0,FMN GV 11 Ramsel
66,Bergstraat 71,2019-01-15,02:00:00,0,0,0,FMN GV 11 Ramsel
66,Bergstraat 71,2019-01-15,03:00:00,0,0,0,FMN GV 11 Ramsel
66,Bergstraat 71,2019-01-15,04:00:00,2,0,2,FMN GV 11 Ramsel
66,Bergstraat 71,2019-01-15,05:00:00,2,2,0,FMN GV 11 Ramsel
66,Bergstraat 71,2019-01-15,06:00:00,34,16,18,FMN GV 11 Ramsel
66,Bergstraat 71,2019-01-15,07:00:00,120,26,94,FMN GV 11 Ramsel
66,Bergstraat 71,2019-01-15,08:00:00,134,14,120,FMN GV 11 Ramsel
66,Bergstraat 71,2019-01-15,09:00:00,46,20,26,FMN GV 11 Ramsel
66,Bergstraat 71,2019-01-15,10:00:00,48,24,24,FMN GV 11 Ramsel
66,Bergstraat 71,2019-01-15,11:00:00,48,20,28,FMN GV 11 Ramsel
66,Bergstraat 71,2019-01-15,12:00:00,76,40,36,FMN GV 11 Ramsel
66,Bergstraat 71,2019-01-15,13:00:00,126,78,48,FMN GV 11 Ramsel
66,Bergstraat 71,2019-01-15,14:00:00,88,48,40,FMN GV 11 Ramsel
66,Bergstraat 71,2019-01-15,15:00:00,194,148,46,FMN GV 11 Ramsel
66,Bergstraat 71,2019-01-15,16:00:00,108,72,36,FMN GV 11 Ramsel
66,Bergstraat 71,2019-01-15,17:00:00,64,42,22,FMN GV 11 Ramsel
66,Bergstraat 71,2019-01-15,18:00:00,32,10,22,FMN GV 11 Ramsel
66,Bergstraat 71,2019-01-15,19:00:00,28,8,20,FMN GV 11 Ramsel
66,Bergstraat 71,2019-01-15,20:00:00,32,28,4,FMN GV 11 Ramsel
66,Bergstraat 71,2019-01-15,21:00:00,8,2,6,FMN GV 11 Ramsel
66,Bergstraat 71,2019-01-15,22:00:00,2,0,2,FMN GV 11 Ramsel
66,Bergstraat 71,2019-01-15,23:00:00,2,2,0,FMN GV 11 Ramsel
66,Bergstraat 71,2019-01-16,00:00:00,0,0,0,FMN GV 11 Ramsel
66,Bergstraat 71,2019-01-16,01:00:00,0,0,0,FMN GV 11 Ramsel
66,Bergstraat 71,2019-01-16,02:00:00,0,0,0,FMN GV 11 Ramsel
66,Bergstraat 71,2019-01-16,03:00:00,0,0,0,FMN GV 11 Ramsel
66,Bergstraat 71,2019-01-16,04:00:00,2,2,0,FMN GV 11 Ramsel
66,Bergstraat 71,2019-01-16,05:00:00,6,4,2,FMN GV 11 Ramsel
66,Bergstraat 71,2019-01-16,06:00:00,32,16,16,FMN GV 11 Ramsel
66,Bergstraat 71,2019-01-16,07:00:00,120,20,100,FMN GV 11 Ramsel
66,Bergstraat 71,2019-01-16,08:00:00,120,28,92,FMN GV 11 Ramsel
66,Bergstraat 71,2019-01-16,09:00:00,16,4,12,FMN GV 11 Ramsel
66,Bergstraat 71,2019-01-16,10:00:00,34,14,20,FMN GV 11 Ramsel
66,Bergstraat 71,2019-01-16,11:00:00,36,18,18,FMN GV 11 Ramsel
66,Bergstraat 71,2019-01-16,12:00:00,202,152,50,FMN GV 11 Ramsel
66,Bergstraat 71,2019-01-16,13:00:00,70,38,32,FMN GV 11 Ramsel
66,Bergstraat 71,2019-01-16,14:00:00,86,44,42,FMN GV 11 Ramsel
66,Bergstraat 71,2019-01-16,15:00:00,72,50,22,FMN GV 11 Ramsel
66,Bergstraat 71,2019-01-16,16:00:00,66,42,24,FMN GV 11 Ramsel
66,Bergstraat 71,2019-01-16,17:00:00,54,34,20,FMN GV 11 Ramsel
66,Bergstraat 71,2019-01-16,18:00:00,24,16,8,FMN GV 11 Ramsel
66,Bergstraat 71,2019-01-16,19:00:00,28,24,4,FMN GV 11 Ramsel
66,Bergstraat 71,2019-01-16,20:00:00,14,8,6,FMN GV 11 Ramsel
66,Bergstraat 71,2019-01-16,21:00:00,0,0,0,FMN GV 11 Ramsel
66,Bergstraat 71,2019-01-16,22:00:00,8,0,8,FMN GV 11 Ramsel
66,Bergstraat 71,2019-01-16,23:00:00,2,2,0,FMN GV 11 Ramsel
66,Bergstraat 71,2019-01-17,00:00:00,0,0,0,FMN GV 11 Ramsel
66,Bergstraat 71,2019-01-17,01:00:00,0,0,0,FMN GV 11 Ramsel
66,Bergstraat 71,2019-01-17,02:00:00,0,0,0,FMN GV 11 Ramsel
66,Bergstraat 71,2019-01-17,03:00:00,0,0,0,FMN GV 11 Ramsel
66,Bergstraat 71,2019-01-17,04:00:00,2,0,2,FMN GV 11 Ramsel
66,Bergstraat 71,2019-01-17,05:00:00,2,2,0,FMN GV 11 Ramsel
66,Bergstraat 71,2019-01-17,06:00:00,28,6,22,FMN GV 11 Ramsel
66,Bergstraat 71,2019-01-17,07:00:00,64,10,54,FMN GV 11 Ramsel
66,Bergstraat 71,2019-01-17,08:00:00,96,18,78,FMN GV 11 Ramsel
66,Bergstraat 71,2019-01-17,09:00:00,4,0,4,FMN GV 11 Ramsel
66,Bergstraat 71,2019-01-17,10:00:00,6,4,2,FMN GV 11 Ramsel
66,Bergstraat 71,2019-01-17,11:00:00,0,0,0,FMN GV 11 Ramsel
66,Bergstraat 71,2019-01-17,12:00:00,8,6,2,FMN GV 11 Ramsel
66,Bergstraat 71,2019-01-17,13:00:00,14,10,4,FMN GV 11 Ramsel
66,Bergstraat 71,2019-01-17,14:00:00,2,0,2,FMN GV 11 Ramsel
66,Bergstraat 71,2019-01-17,15:00:00,88,76,12,FMN GV 11 Ramsel
66,Bergstraat 71,2019-01-17,16:00:00,56,46,10,FMN GV 11 Ramsel
66,Bergstraat 71,2019-01-17,17:00:00,28,24,4,FMN GV 11 Ramsel
66,Bergstraat 71,2019-01-17,18:00:00,28,18,10,FMN GV 11 Ramsel
66,Bergstraat 71,2019-01-17,19:00:00,12,4,8,FMN GV 11 Ramsel
66,Bergstraat 71,2019-01-17,20:00:00,8,6,2,FMN GV 11 Ramsel
66,Bergstraat 71,2019-01-17,21:00:00,14,12,2,FMN GV 11 Ramsel
66,Bergstraat 71,2019-01-17,22:00:00,8,4,4,FMN GV 11 Ramsel
66,Bergstraat 71,2019-01-17,23:00:00,4,4,0,FMN GV 11 Ramsel
66,Bergstraat 71,2019-01-18,00:00:00,0,0,0,FMN GV 11 Ramsel
66,Bergstraat 71,2019-01-18,01:00:00,0,0,0,FMN GV 11 Ramsel
66,Bergstraat 71,2019-01-18,02:00:00,0,0,0,FMN GV 11 Ramsel
66,Bergstraat 71,2019-01-18,03:00:00,0,0,0,FMN GV 11 Ramsel
66,Bergstraat 71,2019-01-18,04:00:00,2,2,0,FMN GV 11 Ramsel
66,Bergstraat 71,2019-01-18,05:00:00,0,0,0,FMN GV 11 Ramsel
66,Bergstraat 71,2019-01-18,06:00:00,6,2,4,FMN GV 11 Ramsel
66,Bergstraat 71,2019-01-18,07:00:00,32,14,18,FMN GV 11 Ramsel
66,Bergstraat 71,2019-01-18,08:00:00,32,16,16,FMN GV 11 Ramsel
66,Bergstraat 71,2019-01-18,09:00:00,6,2,4,FMN GV 11 Ramsel
66,Bergstraat 71,2019-01-18,10:00:00,12,6,6,FMN GV 11 Ramsel
66,Bergstraat 71,2019-01-18,11:00:00,22,10,12,FMN GV 11 Ramsel
66,Bergstraat 71,2019-01-18,12:00:00,24,8,16,FMN GV 11 Ramsel
66,Bergstraat 71,2019-01-18,13:00:00,20,6,14,FMN GV 11 Ramsel
66,Bergstraat 71,2019-01-18,14:00:00,40,24,16,FMN GV 11 Ramsel
66,Bergstraat 71,2019-01-18,15:00:00,92,74,18,FMN GV 11 Ramsel
66,Bergstraat 71,2019-01-18,16:00:00,72,62,10,FMN GV 11 Ramsel
66,Bergstraat 71,2019-01-18,17:00:00,32,24,8,FMN GV 11 Ramsel
66,Bergstraat 71,2019-01-18,18:00:00,16,12,4,FMN GV 11 Ramsel
66,Bergstraat 71,2019-01-18,19:00:00,8,4,4,FMN GV 11 Ramsel
66,Bergstraat 71,2019-01-18,20:00:00,12,4,8,FMN GV 11 Ramsel
66,Bergstraat 71,2019-01-18,21:00:00,2,2,0,FMN GV 11 Ramsel
66,Bergstraat 71,2019-01-18,22:00:00,4,2,2,FMN GV 11 Ramsel
66,Bergstraat 71,2019-01-18,23:00:00,2,0,2,FMN GV 11 Ramsel
66,Bergstraat 71,2019-01-19,00:00:00,2,2,0,FMN GV 11 Ramsel
66,Bergstraat 71,2019-01-19,01:00:00,8,8,0,FMN GV 11 Ramsel
66,Bergstraat 71,2019-01-19,02:00:00,2,0,2,FMN GV 11 Ramsel
66,Bergstraat 71,2019-01-19,03:00:00,0,0,0,FMN GV 11 Ramsel
66,Bergstraat 71,2019-01-19,04:00:00,0,0,0,FMN GV 11 Ramsel
66,Bergstraat 71,2019-01-19,05:00:00,0,0,0,FMN GV 11 Ramsel
66,Bergstraat 71,2019-01-19,06:00:00,2,0,2,FMN GV 11 Ramsel
66,Bergstraat 71,2019-01-19,07:00:00,2,0,2,FMN GV 11 Ramsel
66,Bergstraat 71,2019-01-19,08:00:00,4,2,2,FMN GV 11 Ramsel
66,Bergstraat 71,2019-01-19,09:00:00,16,6,10,FMN GV 11 Ramsel
66,Bergstraat 71,2019-01-19,10:00:00,26,10,16,FMN GV 11 Ramsel
66,Bergstraat 71,2019-01-19,11:00:00,38,18,20,FMN GV 11 Ramsel
66,Bergstraat 71,2019-01-19,12:00:00,26,6,20,FMN GV 11 Ramsel
66,Bergstraat 71,2019-01-19,13:00:00,84,24,60,FMN GV 11 Ramsel
66,Bergstraat 71,2019-01-19,14:00:00,70,28,42,FMN GV 11 Ramsel
66,Bergstraat 71,2019-01-19,15:00:00,72,56,16,FMN GV 11 Ramsel
66,Bergstraat 71,2019-01-19,16:00:00,36,32,4,FMN GV 11 Ramsel
66,Bergstraat 71,2019-01-19,17:00:00,14,10,4,FMN GV 11 Ramsel
66,Bergstraat 71,2019-01-19,18:00:00,6,6,0,FMN GV 11 Ramsel
66,Bergstraat 71,2019-01-19,19:00:00,8,4,4,FMN GV 11 Ramsel
66,Bergstraat 71,2019-01-19,20:00:00,2,0,2,FMN GV 11 Ramsel
66,Bergstraat 71,2019-01-19,21:00:00,0,0,0,FMN GV 11 Ramsel
66,Bergstraat 71,2019-01-19,22:00:00,10,4,6,FMN GV 11 Ramsel
66,Bergstraat 71,2019-01-19,23:00:00,10,8,2,FMN GV 11 Ramsel
66,Bergstraat 71,2019-01-20,00:00:00,0,0,0,FMN GV 11 Ramsel
66,Bergstraat 71,2019-01-20,01:00:00,2,0,2,FMN GV 11 Ramsel
66,Bergstraat 71,2019-01-20,02:00:00,0,0,0,FMN GV 11 Ramsel
66,Bergstraat 71,2019-01-20,03:00:00,6,6,0,FMN GV 11 Ramsel
66,Bergstraat 71,2019-01-20,04:00:00,0,0,0,FMN GV 11 Ramsel
66,Bergstraat 71,2019-01-20,05:00:00,2,2,0,FMN GV 11 Ramsel
66,Bergstraat 71,2019-01-20,06:00:00,0,0,0,FMN GV 11 Ramsel
66,Bergstraat 71,2019-01-20,07:00:00,0,0,0,FMN GV 11 Ramsel
66,Bergstraat 71,2019-01-20,08:00:00,14,4,10,FMN GV 11 Ramsel
66,Bergstraat 71,2019-01-20,09:00:00,34,6,28,FMN GV 11 Ramsel
66,Bergstraat 71,2019-01-20,10:00:00,28,10,18,FMN GV 11 Ramsel
66,Bergstraat 71,2019-01-20,11:00:00,44,32,12,FMN GV 11 Ramsel
66,Bergstraat 71,2019-01-20,12:00:00,38,22,16,FMN GV 11 Ramsel
66,Bergstraat 71,2019-01-20,13:00:00,50,28,22,FMN GV 11 Ramsel
66,Bergstraat 71,2019-01-20,14:00:00,62,16,46,FMN GV 11 Ramsel
66,Bergstraat 71,2019-01-20,15:00:00,40,32,8,FMN GV 11 Ramsel
66,Bergstraat 71,2019-01-20,16:00:00,16,12,4,FMN GV 11 Ramsel
66,Bergstraat 71,2019-01-20,17:00:00,16,8,8,FMN GV 11 Ramsel
66,Bergstraat 71,2019-01-20,18:00:00,4,4,0,FMN GV 11 Ramsel
66,Bergstraat 71,2019-01-20,19:00:00,8,4,4,FMN GV 11 Ramsel
66,Bergstraat 71,2019-01-20,20:00:00,6,6,0,FMN GV 11 Ramsel
66,Bergstraat 71,2019-01-20,21:00:00,0,0,0,FMN GV 11 Ramsel
66,Bergstraat 71,2019-01-20,22:00:00,0,0,0,FMN GV 11 Ramsel
66,Bergstraat 71,2019-01-20,23:00:00,0,0,0,FMN GV 11 Ramsel
66,Bergstraat 71,2019-01-21,00:00:00,0,0,0,FMN GV 11 Ramsel
66,Bergstraat 71,2019-01-21,01:00:00,0,0,0,FMN GV 11 Ramsel
66,Bergstraat 71,2019-01-21,02:00:00,10,8,2,FMN GV 11 Ramsel
66,Bergstraat 71,2019-01-21,03:00:00,0,0,0,FMN GV 11 Ramsel
66,Bergstraat 71,2019-01-21,04:00:00,2,2,0,FMN GV 11 Ramsel
66,Bergstraat 71,2019-01-21,05:00:00,2,2,0,FMN GV 11 Ramsel
66,Bergstraat 71,2019-01-21,06:00:00,26,16,10,FMN GV 11 Ramsel
66,Bergstraat 71,2019-01-21,07:00:00,16,2,14,FMN GV 11 Ramsel
66,Bergstraat 71,2019-01-21,08:00:00,48,14,34,FMN GV 11 Ramsel
66,Bergstraat 71,2019-01-21,09:00:00,10,4,6,FMN GV 11 Ramsel
66,Bergstraat 71,2019-01-21,10:00:00,20,16,4,FMN GV 11 Ramsel
66,Bergstraat 71,2019-01-21,11:00:00,28,14,14,FMN GV 11 Ramsel
66,Bergstraat 71,2019-01-21,12:00:00,46,20,26,FMN GV 11 Ramsel
66,Bergstraat 71,2019-01-21,13:00:00,42,6,36,FMN GV 11 Ramsel
66,Bergstraat 71,2019-01-21,14:00:00,54,30,24,FMN GV 11 Ramsel
66,Bergstraat 71,2019-01-21,15:00:00,90,64,26,FMN GV 11 Ramsel
66,Bergstraat 71,2019-01-21,16:00:00,54,32,22,FMN GV 11 Ramsel
66,Bergstraat 71,2019-01-21,17:00:00,36,22,14,FMN GV 11 Ramsel
66,Bergstraat 71,2019-01-21,18:00:00,18,16,2,FMN GV 11 Ramsel
66,Bergstraat 71,2019-01-21,19:00:00,2,0,2,FMN GV 11 Ramsel
66,Bergstraat 71,2019-01-21,20:00:00,4,2,2,FMN GV 11 Ramsel
66,Bergstraat 71,2019-01-21,21:00:00,2,0,2,FMN GV 11 Ramsel
66,Bergstraat 71,2019-01-21,22:00:00,4,4,0,FMN GV 11 Ramsel
66,Bergstraat 71,2019-01-21,23:00:00,2,2,0,FMN GV 11 Ramsel
66,Bergstraat 71,2019-01-22,00:00:00,0,0,0,FMN GV 11 Ramsel
66,Bergstraat 71,2019-01-22,01:00:00,0,0,0,FMN GV 11 Ramsel
66,Bergstraat 71,2019-01-22,02:00:00,0,0,0,FMN GV 11 Ramsel
66,Bergstraat 71,2019-01-22,03:00:00,0,0,0,FMN GV 11 Ramsel
66,Bergstraat 71,2019-01-22,04:00:00,2,2,0,FMN GV 11 Ramsel
66,Bergstraat 71,2019-01-22,05:00:00,2,2,0,FMN GV 11 Ramsel
66,Bergstraat 71,2019-01-22,06:00:00,14,6,8,FMN GV 11 Ramsel
66,Bergstraat 71,2019-01-22,07:00:00,60,16,44,FMN GV 11 Ramsel
66,Bergstraat 71,2019-01-22,08:00:00,82,30,52,FMN GV 11 Ramsel
66,Bergstraat 71,2019-01-22,09:00:00,16,4,12,FMN GV 11 Ramsel
66,Bergstraat 71,2019-01-22,10:00:00,2,0,2,FMN GV 11 Ramsel
66,Bergstraat 71,2019-01-22,11:00:00,2,0,2,FMN GV 11 Ramsel
66,Bergstraat 71,2019-01-22,12:00:00,8,4,4,FMN GV 11 Ramsel
66,Bergstraat 71,2019-01-22,13:00:00,10,4,6,FMN GV 11 Ramsel
66,Bergstraat 71,2019-01-22,14:00:00,4,2,2,FMN GV 11 Ramsel
66,Bergstraat 71,2019-01-22,15:00:00,58,52,6,FMN GV 11 Ramsel
66,Bergstraat 71,2019-01-22,16:00:00,32,28,4,FMN GV 11 Ramsel
66,Bergstraat 71,2019-01-22,17:00:00,14,10,4,FMN GV 11 Ramsel
66,Bergstraat 71,2019-01-22,18:00:00,16,10,6,FMN GV 11 Ramsel
66,Bergstraat 71,2019-01-22,19:00:00,4,4,0,FMN GV 11 Ramsel
66,Bergstraat 71,2019-01-22,20:00:00,4,4,0,FMN GV 11 Ramsel
66,Bergstraat 71,2019-01-22,21:00:00,2,2,0,FMN GV 11 Ramsel
66,Bergstraat 71,2019-01-22,22:00:00,2,2,0,FMN GV 11 Ramsel
66,Bergstraat 71,2019-01-22,23:00:00,0,0,0,FMN GV 11 Ramsel
66,Bergstraat 71,2019-01-23,00:00:00,0,0,0,FMN GV 11 Ramsel
66,Bergstraat 71,2019-01-23,01:00:00,0,0,0,FMN GV 11 Ramsel
66,Bergstraat 71,2019-01-23,02:00:00,0,0,0,FMN GV 11 Ramsel
66,Bergstraat 71,2019-01-23,03:00:00,2,2,0,FMN GV 11 Ramsel
66,Bergstraat 71,2019-01-23,04:00:00,0,0,0,FMN GV 11 Ramsel
66,Bergstraat 71,2019-01-23,05:00:00,6,4,2,FMN GV 11 Ramsel
66,Bergstraat 71,2019-01-23,06:00:00,10,4,6,FMN GV 11 Ramsel
66,Bergstraat 71,2019-01-23,07:00:00,28,4,24,FMN GV 11 Ramsel
66,Bergstraat 71,2019-01-23,08:00:00,60,22,38,FMN GV 11 Ramsel
66,Bergstraat 71,2019-01-23,09:00:00,10,6,4,FMN GV 11 Ramsel
66,Bergstraat 71,2019-01-23,10:00:00,6,6,0,FMN GV 11 Ramsel
66,Bergstraat 71,2019-01-23,11:00:00,4,4,0,FMN GV 11 Ramsel
66,Bergstraat 71,2019-01-23,12:00:00,92,70,22,FMN GV 11 Ramsel
66,Bergstraat 71,2019-01-23,13:00:00,14,10,4,FMN GV 11 Ramsel
66,Bergstraat 71,2019-01-23,14:00:00,12,4,8,FMN GV 11 Ramsel
66,Bergstraat 71,2019-01-23,15:00:00,20,12,8,FMN GV 11 Ramsel
66,Bergstraat 71,2019-01-23,16:00:00,18,4,14,FMN GV 11 Ramsel
66,Bergstraat 71,2019-01-23,17:00:00,28,16,12,FMN GV 11 Ramsel
66,Bergstraat 71,2019-01-23,18:00:00,16,10,6,FMN GV 11 Ramsel
66,Bergstraat 71,2019-01-23,19:00:00,4,4,0,FMN GV 11 Ramsel
66,Bergstraat 71,2019-01-23,20:00:00,4,0,4,FMN GV 11 Ramsel
66,Bergstraat 71,2019-01-23,21:00:00,2,2,0,FMN GV 11 Ramsel
66,Bergstraat 71,2019-01-23,22:00:00,4,2,2,FMN GV 11 Ramsel
66,Bergstraat 71,2019-01-23,23:00:00,0,0,0,FMN GV 11 Ramsel
66,Bergstraat 71,2019-01-24,00:00:00,0,0,0,FMN GV 11 Ramsel
66,Bergstraat 71,2019-01-24,01:00:00,0,0,0,FMN GV 11 Ramsel
66,Bergstraat 71,2019-01-24,02:00:00,2,0,2,FMN GV 11 Ramsel
66,Bergstraat 71,2019-01-24,03:00:00,2,2,0,FMN GV 11 Ramsel
66,Bergstraat 71,2019-01-24,04:00:00,0,0,0,FMN GV 11 Ramsel
66,Bergstraat 71,2019-01-24,05:00:00,8,4,4,FMN GV 11 Ramsel
66,Bergstraat 71,2019-01-24,06:00:00,18,8,10,FMN GV 11 Ramsel
66,Bergstraat 71,2019-01-24,07:00:00,62,20,42,FMN GV 11 Ramsel
66,Bergstraat 71,2019-01-24,08:00:00,78,10,68,FMN GV 11 Ramsel
66,Bergstraat 71,2019-01-24,09:00:00,6,2,4,FMN GV 11 Ramsel
66,Bergstraat 71,2019-01-24,10:00:00,8,6,2,FMN GV 11 Ramsel
66,Bergstraat 71,2019-01-24,11:00:00,12,12,0,FMN GV 11 Ramsel
66,Bergstraat 71,2019-01-24,12:00:00,22,12,10,FMN GV 11 Ramsel
66,Bergstraat 71,2019-01-24,13:00:00,32,16,16,FMN GV 11 Ramsel
66,Bergstraat 71,2019-01-24,14:00:00,22,14,8,FMN GV 11 Ramsel
66,Bergstraat 71,2019-01-24,15:00:00,76,58,18,FMN GV 11 Ramsel
66,Bergstraat 71,2019-01-24,16:00:00,52,46,6,FMN GV 11 Ramsel
66,Bergstraat 71,2019-01-24,17:00:00,32,20,12,FMN GV 11 Ramsel
66,Bergstraat 71,2019-01-24,18:00:00,30,16,14,FMN GV 11 Ramsel
66,Bergstraat 71,2019-01-24,19:00:00,8,2,6,FMN GV 11 Ramsel
66,Bergstraat 71,2019-01-24,20:00:00,10,6,4,FMN GV 11 Ramsel
66,Bergstraat 71,2019-01-24,21:00:00,2,2,0,FMN GV 11 Ramsel
66,Bergstraat 71,2019-01-24,22:00:00,4,2,2,FMN GV 11 Ramsel
66,Bergstraat 71,2019-01-24,23:00:00,2,2,0,FMN GV 11 Ramsel
66,Bergstraat 71,2019-01-25,00:00:00,0,0,0,FMN GV 11 Ramsel
66,Bergstraat 71,2019-01-25,01:00:00,0,0,0,FMN GV 11 Ramsel
66,Bergstraat 71,2019-01-25,02:00:00,0,0,0,FMN GV 11 Ramsel
66,Bergstraat 71,2019-01-25,03:00:00,2,2,0,FMN GV 11 Ramsel
66,Bergstraat 71,2019-01-25,04:00:00,2,2,0,FMN GV 11 Ramsel
66,Bergstraat 71,2019-01-25,05:00:00,8,2,6,FMN GV 11 Ramsel
66,Bergstraat 71,2019-01-25,06:00:00,14,8,6,FMN GV 11 Ramsel
66,Bergstraat 71,2019-01-25,07:00:00,44,6,38,FMN GV 11 Ramsel
66,Bergstraat 71,2019-01-25,08:00:00,74,12,62,FMN GV 11 Ramsel
66,Bergstraat 71,2019-01-25,09:00:00,16,10,6,FMN GV 11 Ramsel
66,Bergstraat 71,2019-01-25,10:00:00,18,6,12,FMN GV 11 Ramsel
66,Bergstraat 71,2019-01-25,11:00:00,10,8,2,FMN GV 11 Ramsel
66,Bergstraat 71,2019-01-25,12:00:00,10,2,8,FMN GV 11 Ramsel
66,Bergstraat 71,2019-01-25,13:00:00,30,24,6,FMN GV 11 Ramsel
66,Bergstraat 71,2019-01-25,14:00:00,40,18,22,FMN GV 11 Ramsel
66,Bergstraat 71,2019-01-25,15:00:00,62,54,8,FMN GV 11 Ramsel
66,Bergstraat 71,2019-01-25,16:00:00,30,20,10,FMN GV 11 Ramsel
66,Bergstraat 71,2019-01-25,17:00:00,36,24,12,FMN GV 11 Ramsel
66,Bergstraat 71,2019-01-25,18:00:00,22,18,4,FMN GV 11 Ramsel
66,Bergstraat 71,2019-01-25,19:00:00,0,0,0,FMN GV 11 Ramsel
66,Bergstraat 71,2019-01-25,20:00:00,4,0,4,FMN GV 11 Ramsel
66,Bergstraat 71,2019-01-25,21:00:00,8,4,4,FMN GV 11 Ramsel
66,Bergstraat 71,2019-01-25,22:00:00,6,4,2,FMN GV 11 Ramsel
66,Bergstraat 71,2019-01-25,23:00:00,0,0,0,FMN GV 11 Ramsel
66,Bergstraat 71,2019-01-26,00:00:00,0,0,0,FMN GV 11 Ramsel
66,Bergstraat 71,2019-01-26,01:00:00,4,2,2,FMN GV 11 Ramsel
66,Bergstraat 71,2019-01-26,02:00:00,4,2,2,FMN GV 11 Ramsel
66,Bergstraat 71,2019-01-26,03:00:00,0,0,0,FMN GV 11 Ramsel
66,Bergstraat 71,2019-01-26,04:00:00,0,0,0,FMN GV 11 Ramsel
66,Bergstraat 71,2019-01-26,05:00:00,4,0,4,FMN GV 11 Ramsel
66,Bergstraat 71,2019-01-26,06:00:00,2,0,2,FMN GV 11 Ramsel
66,Bergstraat 71,2019-01-26,07:00:00,4,2,2,FMN GV 11 Ramsel
66,Bergstraat 71,2019-01-26,08:00:00,6,2,4,FMN GV 11 Ramsel
66,Bergstraat 71,2019-01-26,09:00:00,38,10,28,FMN GV 11 Ramsel
66,Bergstraat 71,2019-01-26,10:00:00,52,26,26,FMN GV 11 Ramsel
66,Bergstraat 71,2019-01-26,11:00:00,42,16,26,FMN GV 11 Ramsel
66,Bergstraat 71,2019-01-26,12:00:00,48,30,18,FMN GV 11 Ramsel
66,Bergstraat 71,2019-01-26,13:00:00,56,34,22,FMN GV 11 Ramsel
66,Bergstraat 71,2019-01-26,14:00:00,52,22,30,FMN GV 11 Ramsel
66,Bergstraat 71,2019-01-26,15:00:00,42,28,14,FMN GV 11 Ramsel
66,Bergstraat 71,2019-01-26,16:00:00,30,20,10,FMN GV 11 Ramsel
66,Bergstraat 71,2019-01-26,17:00:00,12,8,4,FMN GV 11 Ramsel
66,Bergstraat 71,2019-01-26,18:00:00,2,0,2,FMN GV 11 Ramsel
66,Bergstraat 71,2019-01-26,19:00:00,6,4,2,FMN GV 11 Ramsel
66,Bergstraat 71,2019-01-26,20:00:00,2,0,2,FMN GV 11 Ramsel
66,Bergstraat 71,2019-01-26,21:00:00,4,2,2,FMN GV 11 Ramsel
66,Bergstraat 71,2019-01-26,22:00:00,2,0,2,FMN GV 11 Ramsel
66,Bergstraat 71,2019-01-26,23:00:00,2,0,2,FMN GV 11 Ramsel
66,Bergstraat 71,2019-01-27,00:00:00,4,0,4,FMN GV 11 Ramsel
66,Bergstraat 71,2019-01-27,01:00:00,4,4,0,FMN GV 11 Ramsel
66,Bergstraat 71,2019-01-27,02:00:00,4,4,0,FMN GV 11 Ramsel
66,Bergstraat 71,2019-01-27,03:00:00,0,0,0,FMN GV 11 Ramsel
66,Bergstraat 71,2019-01-27,04:00:00,0,0,0,FMN GV 11 Ramsel
66,Bergstraat 71,2019-01-27,05:00:00,0,0,0,FMN GV 11 Ramsel
66,Bergstraat 71,2019-01-27,06:00:00,2,0,2,FMN GV 11 Ramsel
66,Bergstraat 71,2019-01-27,07:00:00,0,0,0,FMN GV 11 Ramsel
66,Bergstraat 71,2019-01-27,08:00:00,4,0,4,FMN GV 11 Ramsel
66,Bergstraat 71,2019-01-27,09:00:00,0,0,0,FMN GV 11 Ramsel
66,Bergstraat 71,2019-01-27,10:00:00,18,12,6,FMN GV 11 Ramsel
66,Bergstraat 71,2019-01-27,11:00:00,6,4,2,FMN GV 11 Ramsel
66,Bergstraat 71,2019-01-27,12:00:00,14,6,8,FMN GV 11 Ramsel
66,Bergstraat 71,2019-01-27,13:00:00,12,6,6,FMN GV 11 Ramsel
66,Bergstraat 71,2019-01-27,14:00:00,4,4,0,FMN GV 11 Ramsel
66,Bergstraat 71,2019-01-27,15:00:00,2,0,2,FMN GV 11 Ramsel
66,Bergstraat 71,2019-01-27,16:00:00,8,2,6,FMN GV 11 Ramsel
66,Bergstraat 71,2019-01-27,17:00:00,4,4,0,FMN GV 11 Ramsel
66,Bergstraat 71,2019-01-27,18:00:00,6,2,4,FMN GV 11 Ramsel
66,Bergstraat 71,2019-01-27,19:00:00,4,2,2,FMN GV 11 Ramsel
66,Bergstraat 71,2019-01-27,20:00:00,4,4,0,FMN GV 11 Ramsel
66,Bergstraat 71,2019-01-27,21:00:00,0,0,0,FMN GV 11 Ramsel
66,Bergstraat 71,2019-01-27,22:00:00,0,0,0,FMN GV 11 Ramsel
66,Bergstraat 71,2019-01-27,23:00:00,0,0,0,FMN GV 11 Ramsel
66,Bergstraat 71,2019-01-28,00:00:00,0,0,0,FMN GV 11 Ramsel
66,Bergstraat 71,2019-01-28,01:00:00,0,0,0,FMN GV 11 Ramsel
66,Bergstraat 71,2019-01-28,02:00:00,0,0,0,FMN GV 11 Ramsel
66,Bergstraat 71,2019-01-28,03:00:00,0,0,0,FMN GV 11 Ramsel
66,Bergstraat 71,2019-01-28,04:00:00,2,2,0,FMN GV 11 Ramsel
66,Bergstraat 71,2019-01-28,05:00:00,0,0,0,FMN GV 11 Ramsel
66,Bergstraat 71,2019-01-28,06:00:00,20,6,14,FMN GV 11 Ramsel
66,Bergstraat 71,2019-01-28,07:00:00,38,8,30,FMN GV 11 Ramsel
66,Bergstraat 71,2019-01-28,08:00:00,50,8,42,FMN GV 11 Ramsel
66,Bergstraat 71,2019-01-28,09:00:00,18,8,10,FMN GV 11 Ramsel
66,Bergstraat 71,2019-01-28,10:00:00,8,2,6,FMN GV 11 Ramsel
66,Bergstraat 71,2019-01-28,11:00:00,12,6,6,FMN GV 11 Ramsel
66,Bergstraat 71,2019-01-28,12:00:00,16,12,4,FMN GV 11 Ramsel
66,Bergstraat 71,2019-01-28,13:00:00,28,14,14,FMN GV 11 Ramsel
66,Bergstraat 71,2019-01-28,14:00:00,14,8,6,FMN GV 11 Ramsel
66,Bergstraat 71,2019-01-28,15:00:00,62,52,10,FMN GV 11 Ramsel
66,Bergstraat 71,2019-01-28,16:00:00,24,24,0,FMN GV 11 Ramsel
66,Bergstraat 71,2019-01-28,17:00:00,28,16,12,FMN GV 11 Ramsel
66,Bergstraat 71,2019-01-28,18:00:00,18,10,8,FMN GV 11 Ramsel
66,Bergstraat 71,2019-01-28,19:00:00,10,6,4,FMN GV 11 Ramsel
66,Bergstraat 71,2019-01-28,20:00:00,8,6,2,FMN GV 11 Ramsel
66,Bergstraat 71,2019-01-28,21:00:00,4,0,4,FMN GV 11 Ramsel
66,Bergstraat 71,2019-01-28,22:00:00,6,0,6,FMN GV 11 Ramsel
66,Bergstraat 71,2019-01-28,23:00:00,0,0,0,FMN GV 11 Ramsel
66,Bergstraat 71,2019-01-29,00:00:00,4,2,2,FMN GV 11 Ramsel
66,Bergstraat 71,2019-01-29,01:00:00,0,0,0,FMN GV 11 Ramsel
66,Bergstraat 71,2019-01-29,02:00:00,0,0,0,FMN GV 11 Ramsel
66,Bergstraat 71,2019-01-29,03:00:00,2,2,0,FMN GV 11 Ramsel
66,Bergstraat 71,2019-01-29,04:00:00,2,2,0,FMN GV 11 Ramsel
66,Bergstraat 71,2019-01-29,05:00:00,2,2,0,FMN GV 11 Ramsel
66,Bergstraat 71,2019-01-29,06:00:00,18,6,12,FMN GV 11 Ramsel
66,Bergstraat 71,2019-01-29,07:00:00,26,14,12,FMN GV 11 Ramsel
66,Bergstraat 71,2019-01-29,08:00:00,40,20,20,FMN GV 11 Ramsel
66,Bergstraat 71,2019-01-29,09:00:00,12,8,4,FMN GV 11 Ramsel
66,Bergstraat 71,2019-01-29,10:00:00,18,14,4,FMN GV 11 Ramsel
66,Bergstraat 71,2019-01-29,11:00:00,28,14,14,FMN GV 11 Ramsel
66,Bergstraat 71,2019-01-29,12:00:00,54,30,24,FMN GV 11 Ramsel
66,Bergstraat 71,2019-01-29,13:00:00,108,46,62,FMN GV 11 Ramsel
66,Bergstraat 71,2019-01-29,14:00:00,62,24,38,FMN GV 11 Ramsel
66,Bergstraat 71,2019-01-29,15:00:00,170,122,48,FMN GV 11 Ramsel
66,Bergstraat 71,2019-01-29,16:00:00,68,58,10,FMN GV 11 Ramsel
66,Bergstraat 71,2019-01-29,17:00:00,54,28,26,FMN GV 11 Ramsel
66,Bergstraat 71,2019-01-29,18:00:00,38,36,2,FMN GV 11 Ramsel
66,Bergstraat 71,2019-01-29,19:00:00,20,4,16,FMN GV 11 Ramsel
66,Bergstraat 71,2019-01-29,20:00:00,32,24,8,FMN GV 11 Ramsel
66,Bergstraat 71,2019-01-29,21:00:00,8,8,0,FMN GV 11 Ramsel
66,Bergstraat 71,2019-01-29,22:00:00,8,4,4,FMN GV 11 Ramsel
66,Bergstraat 71,2019-01-29,23:00:00,0,0,0,FMN GV 11 Ramsel
66,Bergstraat 71,2019-01-30,00:00:00,2,0,2,FMN GV 11 Ramsel
66,Bergstraat 71,2019-01-30,01:00:00,0,0,0,FMN GV 11 Ramsel
66,Bergstraat 71,2019-01-30,02:00:00,0,0,0,FMN GV 11 Ramsel
66,Bergstraat 71,2019-01-30,03:00:00,0,0,0,FMN GV 11 Ramsel
66,Bergstraat 71,2019-01-30,04:00:00,2,2,0,FMN GV 11 Ramsel
66,Bergstraat 71,2019-01-30,05:00:00,2,0,2,FMN GV 11 Ramsel
66,Bergstraat 71,2019-01-30,06:00:00,16,6,10,FMN GV 11 Ramsel
66,Bergstraat 71,2019-01-30,07:00:00,58,10,48,FMN GV 11 Ramsel
66,Bergstraat 71,2019-01-30,08:00:00,70,14,56,FMN GV 11 Ramsel
66,Bergstraat 71,2019-01-30,09:00:00,16,6,10,FMN GV 11 Ramsel
66,Bergstraat 71,2019-01-30,10:00:00,4,2,2,FMN GV 11 Ramsel
66,Bergstraat 71,2019-01-30,11:00:00,12,6,6,FMN GV 11 Ramsel
66,Bergstraat 71,2019-01-30,12:00:00,92,72,20,FMN GV 11 Ramsel
66,Bergstraat 71,2019-01-30,13:00:00,10,8,2,FMN GV 11 Ramsel
66,Bergstraat 71,2019-01-30,14:00:00,4,2,2,FMN GV 11 Ramsel
66,Bergstraat 71,2019-01-30,15:00:00,12,8,4,FMN GV 11 Ramsel
66,Bergstraat 71,2019-01-30,16:00:00,22,16,6,FMN GV 11 Ramsel
66,Bergstraat 71,2019-01-30,17:00:00,26,20,6,FMN GV 11 Ramsel
66,Bergstraat 71,2019-01-30,18:00:00,12,8,4,FMN GV 11 Ramsel
66,Bergstraat 71,2019-01-30,19:00:00,8,6,2,FMN GV 11 Ramsel
66,Bergstraat 71,2019-01-30,20:00:00,4,2,2,FMN GV 11 Ramsel
66,Bergstraat 71,2019-01-30,21:00:00,4,4,0,FMN GV 11 Ramsel
66,Bergstraat 71,2019-01-30,22:00:00,2,2,0,FMN GV 11 Ramsel
66,Bergstraat 71,2019-01-30,23:00:00,2,2,0,FMN GV 11 Ramsel
66,Bergstraat 71,2019-01-31,00:00:00,4,2,2,FMN GV 11 Ramsel
66,Bergstraat 71,2019-01-31,01:00:00,0,0,0,FMN GV 11 Ramsel
66,Bergstraat 71,2019-01-31,02:00:00,0,0,0,FMN GV 11 Ramsel
66,Bergstraat 71,2019-01-31,03:00:00,0,0,0,FMN GV 11 Ramsel
66,Bergstraat 71,2019-01-31,04:00:00,0,0,0,FMN GV 11 Ramsel
66,Bergstraat 71,2019-01-31,05:00:00,4,2,2,FMN GV 11 Ramsel
66,Bergstraat 71,2019-01-31,06:00:00,12,4,8,FMN GV 11 Ramsel
66,Bergstraat 71,2019-01-31,07:00:00,40,8,32,FMN GV 11 Ramsel
66,Bergstraat 71,2019-01-31,08:00:00,48,16,32,FMN GV 11 Ramsel
66,Bergstraat 71,2019-01-31,09:00:00,14,6,8,FMN GV 11 Ramsel
66,Bergstraat 71,2019-01-31,10:00:00,10,6,4,FMN GV 11 Ramsel
66,Bergstraat 71,2019-01-31,11:00:00,8,4,4,FMN GV 11 Ramsel
66,Bergstraat 71,2019-01-31,12:00:00,24,16,8,FMN GV 11 Ramsel
66,Bergstraat 71,2019-01-31,13:00:00,62,24,38,FMN GV 11 Ramsel
66,Bergstraat 71,2019-01-31,14:00:00,38,28,10,FMN GV 11 Ramsel
66,Bergstraat 71,2019-01-31,15:00:00,104,82,22,FMN GV 11 Ramsel
66,Bergstraat 71,2019-01-31,16:00:00,56,42,14,FMN GV 11 Ramsel
66,Bergstraat 71,2019-01-31,17:00:00,30,22,8,FMN GV 11 Ramsel
66,Bergstraat 71,2019-01-31,18:00:00,26,16,10,FMN GV 11 Ramsel
66,Bergstraat 71,2019-01-31,19:00:00,10,6,4,FMN GV 11 Ramsel
66,Bergstraat 71,2019-01-31,20:00:00,4,2,2,FMN GV 11 Ramsel
66,Bergstraat 71,2019-01-31,21:00:00,8,6,2,FMN GV 11 Ramsel
66,Bergstraat 71,2019-01-31,22:00:00,0,0,0,FMN GV 11 Ramsel
66,Bergstraat 71,2019-01-31,23:00:00,6,6,0,FMN GV 11 Ramsel
66,Bergstraat 71,2019-02-01,00:00:00,2,2,0,FMN GV 11 Ramsel
66,Bergstraat 71,2019-02-01,01:00:00,0,0,0,FMN GV 11 Ramsel
66,Bergstraat 71,2019-02-01,02:00:00,0,0,0,FMN GV 11 Ramsel
66,Bergstraat 71,2019-02-01,03:00:00,0,0,0,FMN GV 11 Ramsel
66,Bergstraat 71,2019-02-01,04:00:00,2,2,0,FMN GV 11 Ramsel
66,Bergstraat 71,2019-02-01,05:00:00,10,4,6,FMN GV 11 Ramsel
66,Bergstraat 71,2019-02-01,06:00:00,16,6,10,FMN GV 11 Ramsel
66,Bergstraat 71,2019-02-01,07:00:00,40,18,22,FMN GV 11 Ramsel
66,Bergstraat 71,2019-02-01,08:00:00,36,12,24,FMN GV 11 Ramsel
66,Bergstraat 71,2019-02-01,09:00:00,2,0,2,FMN GV 11 Ramsel
66,Bergstraat 71,2019-02-01,10:00:00,10,2,8,FMN GV 11 Ramsel
66,Bergstraat 71,2019-02-01,11:00:00,0,0,0,FMN GV 11 Ramsel
66,Bergstraat 71,2019-02-01,12:00:00,14,10,4,FMN GV 11 Ramsel
66,Bergstraat 71,2019-02-01,13:00:00,36,24,12,FMN GV 11 Ramsel
66,Bergstraat 71,2019-02-01,14:00:00,28,14,14,FMN GV 11 Ramsel
66,Bergstraat 71,2019-02-01,15:00:00,72,60,12,FMN GV 11 Ramsel
66,Bergstraat 71,2019-02-01,16:00:00,50,30,20,FMN GV 11 Ramsel
66,Bergstraat 71,2019-02-01,17:00:00,22,14,8,FMN GV 11 Ramsel
66,Bergstraat 71,2019-02-01,18:00:00,8,6,2,FMN GV 11 Ramsel
66,Bergstraat 71,2019-02-01,19:00:00,14,6,8,FMN GV 11 Ramsel
66,Bergstraat 71,2019-02-01,20:00:00,2,2,0,FMN GV 11 Ramsel
66,Bergstraat 71,2019-02-01,21:00:00,14,2,12,FMN GV 11 Ramsel
66,Bergstraat 71,2019-02-01,22:00:00,28,6,22,FMN GV 11 Ramsel
66,Bergstraat 71,2019-02-01,23:00:00,6,4,2,FMN GV 11 Ramsel
66,Bergstraat 71,2019-02-02,00:00:00,4,4,0,FMN GV 11 Ramsel
66,Bergstraat 71,2019-02-02,01:00:00,0,0,0,FMN GV 11 Ramsel
66,Bergstraat 71,2019-02-02,02:00:00,8,8,0,FMN GV 11 Ramsel
66,Bergstraat 71,2019-02-02,03:00:00,12,12,0,FMN GV 11 Ramsel
66,Bergstraat 71,2019-02-02,04:00:00,8,6,2,FMN GV 11 Ramsel
66,Bergstraat 71,2019-02-02,05:00:00,0,0,0,FMN GV 11 Ramsel
66,Bergstraat 71,2019-02-02,06:00:00,0,0,0,FMN GV 11 Ramsel
66,Bergstraat 71,2019-02-02,07:00:00,2,0,2,FMN GV 11 Ramsel
66,Bergstraat 71,2019-02-02,08:00:00,10,6,4,FMN GV 11 Ramsel
66,Bergstraat 71,2019-02-02,09:00:00,6,4,2,FMN GV 11 Ramsel
66,Bergstraat 71,2019-02-02,10:00:00,10,6,4,FMN GV 11 Ramsel
66,Bergstraat 71,2019-02-02,11:00:00,8,6,2,FMN GV 11 Ramsel
66,Bergstraat 71,2019-02-02,12:00:00,4,2,2,FMN GV 11 Ramsel
66,Bergstraat 71,2019-02-02,13:00:00,8,6,2,FMN GV 11 Ramsel
66,Bergstraat 71,2019-02-02,14:00:00,2,0,2,FMN GV 11 Ramsel
66,Bergstraat 71,2019-02-02,15:00:00,2,2,0,FMN GV 11 Ramsel
66,Bergstraat 71,2019-02-02,16:00:00,6,4,2,FMN GV 11 Ramsel
66,Bergstraat 71,2019-02-02,17:00:00,8,4,4,FMN GV 11 Ramsel
66,Bergstraat 71,2019-02-02,18:00:00,4,2,2,FMN GV 11 Ramsel
66,Bergstraat 71,2019-02-02,19:00:00,4,2,2,FMN GV 11 Ramsel
66,Bergstraat 71,2019-02-02,20:00:00,2,2,0,FMN GV 11 Ramsel
66,Bergstraat 71,2019-02-02,21:00:00,2,0,2,FMN GV 11 Ramsel
66,Bergstraat 71,2019-02-02,22:00:00,4,0,4,FMN GV 11 Ramsel
66,Bergstraat 71,2019-02-02,23:00:00,4,4,0,FMN GV 11 Ramsel
66,Bergstraat 71,2019-02-03,00:00:00,0,0,0,FMN GV 11 Ramsel
66,Bergstraat 71,2019-02-03,01:00:00,0,0,0,FMN GV 11 Ramsel
66,Bergstraat 71,2019-02-03,02:00:00,0,0,0,FMN GV 11 Ramsel
66,Bergstraat 71,2019-02-03,03:00:00,2,2,0,FMN GV 11 Ramsel
66,Bergstraat 71,2019-02-03,04:00:00,0,0,0,FMN GV 11 Ramsel
66,Bergstraat 71,2019-02-03,05:00:00,0,0,0,FMN GV 11 Ramsel
66,Bergstraat 71,2019-02-03,06:00:00,0,0,0,FMN GV 11 Ramsel
66,Bergstraat 71,2019-02-03,07:00:00,0,0,0,FMN GV 11 Ramsel
66,Bergstraat 71,2019-02-03,08:00:00,8,4,4,FMN GV 11 Ramsel
66,Bergstraat 71,2019-02-03,09:00:00,22,18,4,FMN GV 11 Ramsel
66,Bergstraat 71,2019-02-03,10:00:00,62,22,40,FMN GV 11 Ramsel
66,Bergstraat 71,2019-02-03,11:00:00,62,34,28,FMN GV 11 Ramsel
66,Bergstraat 71,2019-02-03,12:00:00,52,36,16,FMN GV 11 Ramsel
66,Bergstraat 71,2019-02-03,13:00:00,56,18,38,FMN GV 11 Ramsel
66,Bergstraat 71,2019-02-03,14:00:00,36,18,18,FMN GV 11 Ramsel
66,Bergstraat 71,2019-02-03,15:00:00,38,28,10,FMN GV 11 Ramsel
66,Bergstraat 71,2019-02-03,16:00:00,30,12,18,FMN GV 11 Ramsel
66,Bergstraat 71,2019-02-03,17:00:00,20,10,10,FMN GV 11 Ramsel
66,Bergstraat 71,2019-02-03,18:00:00,4,4,0,FMN GV 11 Ramsel
66,Bergstraat 71,2019-02-03,19:00:00,2,2,0,FMN GV 11 Ramsel
66,Bergstraat 71,2019-02-03,20:00:00,6,4,2,FMN GV 11 Ramsel
66,Bergstraat 71,2019-02-03,21:00:00,2,2,0,FMN GV 11 Ramsel
66,Bergstraat 71,2019-02-03,22:00:00,2,2,0,FMN GV 11 Ramsel
66,Bergstraat 71,2019-02-03,23:00:00,0,0,0,FMN GV 11 Ramsel
66,Bergstraat 71,2019-02-04,00:00:00,2,2,0,FMN GV 11 Ramsel
66,Bergstraat 71,2019-02-04,01:00:00,0,0,0,FMN GV 11 Ramsel
66,Bergstraat 71,2019-02-04,02:00:00,0,0,0,FMN GV 11 Ramsel
66,Bergstraat 71,2019-02-04,03:00:00,0,0,0,FMN GV 11 Ramsel
66,Bergstraat 71,2019-02-04,04:00:00,2,2,0,FMN GV 11 Ramsel
66,Bergstraat 71,2019-02-04,05:00:00,6,6,0,FMN GV 11 Ramsel
66,Bergstraat 71,2019-02-04,06:00:00,18,10,8,FMN GV 11 Ramsel
66,Bergstraat 71,2019-02-04,07:00:00,42,8,34,FMN GV 11 Ramsel
66,Bergstraat 71,2019-02-04,08:00:00,54,14,40,FMN GV 11 Ramsel
66,Bergstraat 71,2019-02-04,09:00:00,30,10,20,FMN GV 11 Ramsel
66,Bergstraat 71,2019-02-04,10:00:00,26,12,14,FMN GV 11 Ramsel
66,Bergstraat 71,2019-02-04,11:00:00,16,10,6,FMN GV 11 Ramsel
66,Bergstraat 71,2019-02-04,12:00:00,18,14,4,FMN GV 11 Ramsel
66,Bergstraat 71,2019-02-04,13:00:00,40,24,16,FMN GV 11 Ramsel
66,Bergstraat 71,2019-02-04,14:00:00,22,6,16,FMN GV 11 Ramsel
66,Bergstraat 71,2019-02-04,15:00:00,124,92,32,FMN GV 11 Ramsel
66,Bergstraat 71,2019-02-04,16:00:00,78,62,16,FMN GV 11 Ramsel
66,Bergstraat 71,2019-02-04,17:00:00,24,18,6,FMN GV 11 Ramsel
66,Bergstraat 71,2019-02-04,18:00:00,18,12,6,FMN GV 11 Ramsel
66,Bergstraat 71,2019-02-04,19:00:00,14,8,6,FMN GV 11 Ramsel
66,Bergstraat 71,2019-02-04,20:00:00,10,6,4,FMN GV 11 Ramsel
66,Bergstraat 71,2019-02-04,21:00:00,0,0,0,FMN GV 11 Ramsel
66,Bergstraat 71,2019-02-04,22:00:00,12,12,0,FMN GV 11 Ramsel
66,Bergstraat 71,2019-02-04,23:00:00,2,2,0,FMN GV 11 Ramsel
66,Bergstraat 71,2019-02-05,00:00:00,0,0,0,FMN GV 11 Ramsel
66,Bergstraat 71,2019-02-05,01:00:00,0,0,0,FMN GV 11 Ramsel
66,Bergstraat 71,2019-02-05,02:00:00,0,0,0,FMN GV 11 Ramsel
66,Bergstraat 71,2019-02-05,03:00:00,0,0,0,FMN GV 11 Ramsel
66,Bergstraat 71,2019-02-05,04:00:00,4,2,2,FMN GV 11 Ramsel
66,Bergstraat 71,2019-02-05,05:00:00,8,6,2,FMN GV 11 Ramsel
66,Bergstraat 71,2019-02-05,06:00:00,32,12,20,FMN GV 11 Ramsel
66,Bergstraat 71,2019-02-05,07:00:00,74,16,58,FMN GV 11 Ramsel
66,Bergstraat 71,2019-02-05,08:00:00,106,22,84,FMN GV 11 Ramsel
66,Bergstraat 71,2019-02-05,09:00:00,42,20,22,FMN GV 11 Ramsel
66,Bergstraat 71,2019-02-05,10:00:00,42,12,30,FMN GV 11 Ramsel
66,Bergstraat 71,2019-02-05,11:00:00,24,8,16,FMN GV 11 Ramsel
66,Bergstraat 71,2019-02-05,12:00:00,62,38,24,FMN GV 11 Ramsel
66,Bergstraat 71,2019-02-05,13:00:00,94,40,54,FMN GV 11 Ramsel
66,Bergstraat 71,2019-02-05,14:00:00,70,28,42,FMN GV 11 Ramsel
66,Bergstraat 71,2019-02-05,15:00:00,140,106,34,FMN GV 11 Ramsel
66,Bergstraat 71,2019-02-05,16:00:00,98,84,14,FMN GV 11 Ramsel
66,Bergstraat 71,2019-02-05,17:00:00,68,38,30,FMN GV 11 Ramsel
66,Bergstraat 71,2019-02-05,18:00:00,30,18,12,FMN GV 11 Ramsel
66,Bergstraat 71,2019-02-05,19:00:00,42,16,26,FMN GV 11 Ramsel
66,Bergstraat 71,2019-02-05,20:00:00,28,18,10,FMN GV 11 Ramsel
66,Bergstraat 71,2019-02-05,21:00:00,14,14,0,FMN GV 11 Ramsel
66,Bergstraat 71,2019-02-05,22:00:00,8,8,0,FMN GV 11 Ramsel
66,Bergstraat 71,2019-02-05,23:00:00,6,2,4,FMN GV 11 Ramsel
66,Bergstraat 71,2019-02-06,00:00:00,0,0,0,FMN GV 11 Ramsel
66,Bergstraat 71,2019-02-06,01:00:00,0,0,0,FMN GV 11 Ramsel
66,Bergstraat 71,2019-02-06,02:00:00,0,0,0,FMN GV 11 Ramsel
66,Bergstraat 71,2019-02-06,03:00:00,0,0,0,FMN GV 11 Ramsel
66,Bergstraat 71,2019-02-06,04:00:00,2,0,2,FMN GV 11 Ramsel
66,Bergstraat 71,2019-02-06,05:00:00,10,2,8,FMN GV 11 Ramsel
66,Bergstraat 71,2019-02-06,06:00:00,26,14,12,FMN GV 11 Ramsel
66,Bergstraat 71,2019-02-06,07:00:00,76,12,64,FMN GV 11 Ramsel
66,Bergstraat 71,2019-02-06,08:00:00,112,18,94,FMN GV 11 Ramsel
66,Bergstraat 71,2019-02-06,09:00:00,32,8,24,FMN GV 11 Ramsel
66,Bergstraat 71,2019-02-06,10:00:00,30,18,12,FMN GV 11 Ramsel
66,Bergstraat 71,2019-02-06,11:00:00,24,10,14,FMN GV 11 Ramsel
66,Bergstraat 71,2019-02-06,12:00:00,146,112,34,FMN GV 11 Ramsel
66,Bergstraat 71,2019-02-06,13:00:00,62,24,38,FMN GV 11 Ramsel
66,Bergstraat 71,2019-02-06,14:00:00,46,24,22,FMN GV 11 Ramsel
66,Bergstraat 71,2019-02-06,15:00:00,44,24,20,FMN GV 11 Ramsel
66,Bergstraat 71,2019-02-06,16:00:00,38,28,10,FMN GV 11 Ramsel
66,Bergstraat 71,2019-02-06,17:00:00,44,34,10,FMN GV 11 Ramsel
66,Bergstraat 71,2019-02-06,18:00:00,16,10,6,FMN GV 11 Ramsel
66,Bergstraat 71,2019-02-06,19:00:00,10,8,2,FMN GV 11 Ramsel
66,Bergstraat 71,2019-02-06,20:00:00,6,6,0,FMN GV 11 Ramsel
66,Bergstraat 71,2019-02-06,21:00:00,8,6,2,FMN GV 11 Ramsel
66,Bergstraat 71,2019-02-06,22:00:00,8,8,0,FMN GV 11 Ramsel
66,Bergstraat 71,2019-02-06,23:00:00,0,0,0,FMN GV 11 Ramsel
66,Bergstraat 71,2019-02-07,00:00:00,0,0,0,FMN GV 11 Ramsel
66,Bergstraat 71,2019-02-07,01:00:00,0,0,0,FMN GV 11 Ramsel
66,Bergstraat 71,2019-02-07,02:00:00,0,0,0,FMN GV 11 Ramsel
66,Bergstraat 71,2019-02-07,03:00:00,0,0,0,FMN GV 11 Ramsel
66,Bergstraat 71,2019-02-07,04:00:00,2,0,2,FMN GV 11 Ramsel
66,Bergstraat 71,2019-02-07,05:00:00,6,4,2,FMN GV 11 Ramsel
66,Bergstraat 71,2019-02-07,06:00:00,12,4,8,FMN GV 11 Ramsel
66,Bergstraat 71,2019-02-07,07:00:00,42,10,32,FMN GV 11 Ramsel
66,Bergstraat 71,2019-02-07,08:00:00,64,14,50,FMN GV 11 Ramsel
66,Bergstraat 71,2019-02-07,09:00:00,14,6,8,FMN GV 11 Ramsel
66,Bergstraat 71,2019-02-07,10:00:00,28,18,10,FMN GV 11 Ramsel
66,Bergstraat 71,2019-02-07,11:00:00,32,22,10,FMN GV 11 Ramsel
66,Bergstraat 71,2019-02-07,12:00:00,36,20,16,FMN GV 11 Ramsel
66,Bergstraat 71,2019-02-07,13:00:00,70,42,28,FMN GV 11 Ramsel
66,Bergstraat 71,2019-02-07,14:00:00,58,34,24,FMN GV 11 Ramsel
66,Bergstraat 71,2019-02-07,15:00:00,104,78,26,FMN GV 11 Ramsel
66,Bergstraat 71,2019-02-07,16:00:00,54,42,12,FMN GV 11 Ramsel
66,Bergstraat 71,2019-02-07,17:00:00,34,24,10,FMN GV 11 Ramsel
66,Bergstraat 71,2019-02-07,18:00:00,16,6,10,FMN GV 11 Ramsel
66,Bergstraat 71,2019-02-07,19:00:00,28,20,8,FMN GV 11 Ramsel
66,Bergstraat 71,2019-02-07,20:00:00,30,26,4,FMN GV 11 Ramsel
66,Bergstraat 71,2019-02-07,21:00:00,12,12,0,FMN GV 11 Ramsel
66,Bergstraat 71,2019-02-07,22:00:00,6,6,0,FMN GV 11 Ramsel
66,Bergstraat 71,2019-02-07,23:00:00,4,4,0,FMN GV 11 Ramsel
66,Bergstraat 71,2019-02-08,00:00:00,4,2,2,FMN GV 11 Ramsel
66,Bergstraat 71,2019-02-08,01:00:00,2,2,0,FMN GV 11 Ramsel
66,Bergstraat 71,2019-02-08,02:00:00,0,0,0,FMN GV 11 Ramsel
66,Bergstraat 71,2019-02-08,03:00:00,0,0,0,FMN GV 11 Ramsel
66,Bergstraat 71,2019-02-08,04:00:00,2,2,0,FMN GV 11 Ramsel
66,Bergstraat 71,2019-02-08,05:00:00,4,0,4,FMN GV 11 Ramsel
66,Bergstraat 71,2019-02-08,06:00:00,28,8,20,FMN GV 11 Ramsel
66,Bergstraat 71,2019-02-08,07:00:00,82,16,66,FMN GV 11 Ramsel
66,Bergstraat 71,2019-02-08,08:00:00,84,18,66,FMN GV 11 Ramsel
66,Bergstraat 71,2019-02-08,09:00:00,10,2,8,FMN GV 11 Ramsel
66,Bergstraat 71,2019-02-08,10:00:00,12,6,6,FMN GV 11 Ramsel
66,Bergstraat 71,2019-02-08,11:00:00,24,12,12,FMN GV 11 Ramsel
66,Bergstraat 71,2019-02-08,12:00:00,20,10,10,FMN GV 11 Ramsel
66,Bergstraat 71,2019-02-08,13:00:00,26,10,16,FMN GV 11 Ramsel
66,Bergstraat 71,2019-02-08,14:00:00,40,24,16,FMN GV 11 Ramsel
66,Bergstraat 71,2019-02-08,15:00:00,88,70,18,FMN GV 11 Ramsel
66,Bergstraat 71,2019-02-08,16:00:00,64,48,16,FMN GV 11 Ramsel
66,Bergstraat 71,2019-02-08,17:00:00,30,24,6,FMN GV 11 Ramsel
66,Bergstraat 71,2019-02-08,18:00:00,24,14,10,FMN GV 11 Ramsel
66,Bergstraat 71,2019-02-08,19:00:00,4,4,0,FMN GV 11 Ramsel
66,Bergstraat 71,2019-02-08,20:00:00,8,6,2,FMN GV 11 Ramsel
66,Bergstraat 71,2019-02-08,21:00:00,2,2,0,FMN GV 11 Ramsel
66,Bergstraat 71,2019-02-08,22:00:00,2,0,2,FMN GV 11 Ramsel
66,Bergstraat 71,2019-02-08,23:00:00,2,2,0,FMN GV 11 Ramsel
66,Bergstraat 71,2019-02-09,00:00:00,2,2,0,FMN GV 11 Ramsel
66,Bergstraat 71,2019-02-09,01:00:00,0,0,0,FMN GV 11 Ramsel
66,Bergstraat 71,2019-02-09,02:00:00,2,2,0,FMN GV 11 Ramsel
66,Bergstraat 71,2019-02-09,03:00:00,0,0,0,FMN GV 11 Ramsel
66,Bergstraat 71,2019-02-09,04:00:00,0,0,0,FMN GV 11 Ramsel
66,Bergstraat 71,2019-02-09,05:00:00,2,2,0,FMN GV 11 Ramsel
66,Bergstraat 71,2019-02-09,06:00:00,0,0,0,FMN GV 11 Ramsel
66,Bergstraat 71,2019-02-09,07:00:00,2,0,2,FMN GV 11 Ramsel
66,Bergstraat 71,2019-02-09,08:00:00,14,4,10,FMN GV 11 Ramsel
66,Bergstraat 71,2019-02-09,09:00:00,22,4,18,FMN GV 11 Ramsel
66,Bergstraat 71,2019-02-09,10:00:00,44,14,30,FMN GV 11 Ramsel
66,Bergstraat 71,2019-02-09,11:00:00,30,20,10,FMN GV 11 Ramsel
66,Bergstraat 71,2019-02-09,12:00:00,20,16,4,FMN GV 11 Ramsel
66,Bergstraat 71,2019-02-09,13:00:00,52,26,26,FMN GV 11 Ramsel
66,Bergstraat 71,2019-02-09,14:00:00,62,32,30,FMN GV 11 Ramsel
66,Bergstraat 71,2019-02-09,15:00:00,30,18,12,FMN GV 11 Ramsel
66,Bergstraat 71,2019-02-09,16:00:00,30,8,22,FMN GV 11 Ramsel
66,Bergstraat 71,2019-02-09,17:00:00,14,12,2,FMN GV 11 Ramsel
66,Bergstraat 71,2019-02-09,18:00:00,8,6,2,FMN GV 11 Ramsel
66,Bergstraat 71,2019-02-09,19:00:00,0,0,0,FMN GV 11 Ramsel
66,Bergstraat 71,2019-02-09,20:00:00,14,6,8,FMN GV 11 Ramsel
66,Bergstraat 71,2019-02-09,21:00:00,0,0,0,FMN GV 11 Ramsel
66,Bergstraat 71,2019-02-09,22:00:00,2,0,2,FMN GV 11 Ramsel
66,Bergstraat 71,2019-02-09,23:00:00,2,2,0,FMN GV 11 Ramsel
66,Bergstraat 71,2019-02-10,00:00:00,2,2,0,FMN GV 11 Ramsel
66,Bergstraat 71,2019-02-10,01:00:00,0,0,0,FMN GV 11 Ramsel
66,Bergstraat 71,2019-02-10,02:00:00,2,2,0,FMN GV 11 Ramsel
66,Bergstraat 71,2019-02-10,03:00:00,2,2,0,FMN GV 11 Ramsel
66,Bergstraat 71,2019-02-10,04:00:00,0,0,0,FMN GV 11 Ramsel
66,Bergstraat 71,2019-02-10,05:00:00,0,0,0,FMN GV 11 Ramsel
66,Bergstraat 71,2019-02-10,06:00:00,0,0,0,FMN GV 11 Ramsel
66,Bergstraat 71,2019-02-10,07:00:00,0,0,0,FMN GV 11 Ramsel
66,Bergstraat 71,2019-02-10,08:00:00,6,2,4,FMN GV 11 Ramsel
66,Bergstraat 71,2019-02-10,09:00:00,12,4,8,FMN GV 11 Ramsel
66,Bergstraat 71,2019-02-10,10:00:00,2,2,0,FMN GV 11 Ramsel
66,Bergstraat 71,2019-02-10,11:00:00,10,4,6,FMN GV 11 Ramsel
66,Bergstraat 71,2019-02-10,12:00:00,4,4,0,FMN GV 11 Ramsel
66,Bergstraat 71,2019-02-10,13:00:00,6,4,2,FMN GV 11 Ramsel
66,Bergstraat 71,2019-02-10,14:00:00,4,4,0,FMN GV 11 Ramsel
66,Bergstraat 71,2019-02-10,15:00:00,8,6,2,FMN GV 11 Ramsel
66,Bergstraat 71,2019-02-10,16:00:00,2,0,2,FMN GV 11 Ramsel
66,Bergstraat 71,2019-02-10,17:00:00,4,2,2,FMN GV 11 Ramsel
66,Bergstraat 71,2019-02-10,18:00:00,6,0,6,FMN GV 11 Ramsel
66,Bergstraat 71,2019-02-10,19:00:00,6,2,4,FMN GV 11 Ramsel
66,Bergstraat 71,2019-02-10,20:00:00,0,0,0,FMN GV 11 Ramsel
66,Bergstraat 71,2019-02-10,21:00:00,0,0,0,FMN GV 11 Ramsel
66,Bergstraat 71,2019-02-10,22:00:00,0,0,0,FMN GV 11 Ramsel
66,Bergstraat 71,2019-02-10,23:00:00,0,0,0,FMN GV 11 Ramsel
66,Bergstraat 71,2019-02-11,00:00:00,0,0,0,FMN GV 11 Ramsel
66,Bergstraat 71,2019-02-11,01:00:00,0,0,0,FMN GV 11 Ramsel
66,Bergstraat 71,2019-02-11,02:00:00,2,2,0,FMN GV 11 Ramsel
66,Bergstraat 71,2019-02-11,03:00:00,0,0,0,FMN GV 11 Ramsel
66,Bergstraat 71,2019-02-11,04:00:00,4,2,2,FMN GV 11 Ramsel
66,Bergstraat 71,2019-02-11,05:00:00,8,4,4,FMN GV 11 Ramsel
66,Bergstraat 71,2019-02-11,06:00:00,20,10,10,FMN GV 11 Ramsel
66,Bergstraat 71,2019-02-11,07:00:00,106,18,88,FMN GV 11 Ramsel
66,Bergstraat 71,2019-02-11,08:00:00,122,24,98,FMN GV 11 Ramsel
66,Bergstraat 71,2019-02-11,09:00:00,38,14,24,FMN GV 11 Ramsel
66,Bergstraat 71,2019-02-11,10:00:00,38,26,12,FMN GV 11 Ramsel
66,Bergstraat 71,2019-02-11,11:00:00,28,18,10,FMN GV 11 Ramsel
66,Bergstraat 71,2019-02-11,12:00:00,30,16,14,FMN GV 11 Ramsel
66,Bergstraat 71,2019-02-11,13:00:00,90,34,56,FMN GV 11 Ramsel
66,Bergstraat 71,2019-02-11,14:00:00,38,24,14,FMN GV 11 Ramsel
66,Bergstraat 71,2019-02-11,15:00:00,146,122,24,FMN GV 11 Ramsel
66,Bergstraat 71,2019-02-11,16:00:00,100,78,22,FMN GV 11 Ramsel
66,Bergstraat 71,2019-02-11,17:00:00,42,32,10,FMN GV 11 Ramsel
66,Bergstraat 71,2019-02-11,18:00:00,28,18,10,FMN GV 11 Ramsel
66,Bergstraat 71,2019-02-11,19:00:00,20,8,12,FMN GV 11 Ramsel
66,Bergstraat 71,2019-02-11,20:00:00,10,8,2,FMN GV 11 Ramsel
66,Bergstraat 71,2019-02-11,21:00:00,2,2,0,FMN GV 11 Ramsel
66,Bergstraat 71,2019-02-11,22:00:00,4,0,4,FMN GV 11 Ramsel
66,Bergstraat 71,2019-02-11,23:00:00,2,2,0,FMN GV 11 Ramsel
66,Bergstraat 71,2019-02-12,00:00:00,2,0,2,FMN GV 11 Ramsel
66,Bergstraat 71,2019-02-12,01:00:00,0,0,0,FMN GV 11 Ramsel
66,Bergstraat 71,2019-02-12,02:00:00,0,0,0,FMN GV 11 Ramsel
66,Bergstraat 71,2019-02-12,03:00:00,0,0,0,FMN GV 11 Ramsel
66,Bergstraat 71,2019-02-12,04:00:00,4,0,4,FMN GV 11 Ramsel
66,Bergstraat 71,2019-02-12,05:00:00,4,2,2,FMN GV 11 Ramsel
66,Bergstraat 71,2019-02-12,06:00:00,30,14,16,FMN GV 11 Ramsel
66,Bergstraat 71,2019-02-12,07:00:00,80,26,54,FMN GV 11 Ramsel
66,Bergstraat 71,2019-02-12,08:00:00,74,20,54,FMN GV 11 Ramsel
66,Bergstraat 71,2019-02-12,09:00:00,22,10,12,FMN GV 11 Ramsel
66,Bergstraat 71,2019-02-12,10:00:00,36,14,22,FMN GV 11 Ramsel
66,Bergstraat 71,2019-02-12,11:00:00,18,8,10,FMN GV 11 Ramsel
66,Bergstraat 71,2019-02-12,12:00:00,74,28,46,FMN GV 11 Ramsel
66,Bergstraat 71,2019-02-12,13:00:00,138,62,76,FMN GV 11 Ramsel
66,Bergstraat 71,2019-02-12,14:00:00,74,50,24,FMN GV 11 Ramsel
66,Bergstraat 71,2019-02-12,15:00:00,160,128,32,FMN GV 11 Ramsel
66,Bergstraat 71,2019-02-12,16:00:00,116,80,36,FMN GV 11 Ramsel
66,Bergstraat 71,2019-02-12,17:00:00,88,58,30,FMN GV 11 Ramsel
66,Bergstraat 71,2019-02-12,18:00:00,34,22,12,FMN GV 11 Ramsel
66,Bergstraat 71,2019-02-12,19:00:00,32,12,20,FMN GV 11 Ramsel
66,Bergstraat 71,2019-02-12,20:00:00,30,24,6,FMN GV 11 Ramsel
66,Bergstraat 71,2019-02-12,21:00:00,8,6,2,FMN GV 11 Ramsel
66,Bergstraat 71,2019-02-12,22:00:00,8,4,4,FMN GV 11 Ramsel
66,Bergstraat 71,2019-02-12,23:00:00,0,0,0,FMN GV 11 Ramsel
66,Bergstraat 71,2019-02-13,00:00:00,4,4,0,FMN GV 11 Ramsel
66,Bergstraat 71,2019-02-13,01:00:00,0,0,0,FMN GV 11 Ramsel
66,Bergstraat 71,2019-02-13,02:00:00,0,0,0,FMN GV 11 Ramsel
66,Bergstraat 71,2019-02-13,03:00:00,0,0,0,FMN GV 11 Ramsel
66,Bergstraat 71,2019-02-13,04:00:00,2,2,0,FMN GV 11 Ramsel
66,Bergstraat 71,2019-02-13,05:00:00,10,8,2,FMN GV 11 Ramsel
66,Bergstraat 71,2019-02-13,06:00:00,16,12,4,FMN GV 11 Ramsel
66,Bergstraat 71,2019-02-13,07:00:00,112,16,96,FMN GV 11 Ramsel
66,Bergstraat 71,2019-02-13,08:00:00,88,22,66,FMN GV 11 Ramsel
66,Bergstraat 71,2019-02-13,09:00:00,32,10,22,FMN GV 11 Ramsel
66,Bergstraat 71,2019-02-13,10:00:00,32,24,8,FMN GV 11 Ramsel
66,Bergstraat 71,2019-02-13,11:00:00,30,20,10,FMN GV 11 Ramsel
66,Bergstraat 71,2019-02-13,12:00:00,174,120,54,FMN GV 11 Ramsel
66,Bergstraat 71,2019-02-13,13:00:00,110,56,54,FMN GV 11 Ramsel
66,Bergstraat 71,2019-02-13,14:00:00,154,88,66,FMN GV 11 Ramsel
66,Bergstraat 71,2019-02-13,15:00:00,104,56,48,FMN GV 11 Ramsel
66,Bergstraat 71,2019-02-13,16:00:00,112,70,42,FMN GV 11 Ramsel
66,Bergstraat 71,2019-02-13,17:00:00,62,34,28,FMN GV 11 Ramsel
66,Bergstraat 71,2019-02-13,18:00:00,46,30,16,FMN GV 11 Ramsel
66,Bergstraat 71,2019-02-13,19:00:00,10,6,4,FMN GV 11 Ramsel
66,Bergstraat 71,2019-02-13,20:00:00,16,10,6,FMN GV 11 Ramsel
66,Bergstraat 71,2019-02-13,21:00:00,12,8,4,FMN GV 11 Ramsel
66,Bergstraat 71,2019-02-13,22:00:00,2,0,2,FMN GV 11 Ramsel
66,Bergstraat 71,2019-02-13,23:00:00,4,4,0,FMN GV 11 Ramsel
66,Bergstraat 71,2019-02-14,00:00:00,0,0,0,FMN GV 11 Ramsel
66,Bergstraat 71,2019-02-14,01:00:00,0,0,0,FMN GV 11 Ramsel
66,Bergstraat 71,2019-02-14,02:00:00,0,0,0,FMN GV 11 Ramsel
66,Bergstraat 71,2019-02-14,03:00:00,0,0,0,FMN GV 11 Ramsel
66,Bergstraat 71,2019-02-14,04:00:00,2,2,0,FMN GV 11 Ramsel
66,Bergstraat 71,2019-02-14,05:00:00,2,2,0,FMN GV 11 Ramsel
66,Bergstraat 71,2019-02-14,06:00:00,14,4,10,FMN GV 11 Ramsel
66,Bergstraat 71,2019-02-14,07:00:00,104,28,76,FMN GV 11 Ramsel
66,Bergstraat 71,2019-02-14,08:00:00,152,36,116,FMN GV 11 Ramsel
66,Bergstraat 71,2019-02-14,09:00:00,30,14,16,FMN GV 11 Ramsel
66,Bergstraat 71,2019-02-14,10:00:00,42,18,24,FMN GV 11 Ramsel
66,Bergstraat 71,2019-02-14,11:00:00,52,22,30,FMN GV 11 Ramsel
66,Bergstraat 71,2019-02-14,12:00:00,62,42,20,FMN GV 11 Ramsel
66,Bergstraat 71,2019-02-14,13:00:00,190,86,104,FMN GV 11 Ramsel
66,Bergstraat 71,2019-02-14,14:00:00,180,110,70,FMN GV 11 Ramsel
66,Bergstraat 71,2019-02-14,15:00:00,216,162,54,FMN GV 11 Ramsel
66,Bergstraat 71,2019-02-14,16:00:00,138,90,48,FMN GV 11 Ramsel
66,Bergstraat 71,2019-02-14,17:00:00,98,64,34,FMN GV 11 Ramsel
66,Bergstraat 71,2019-02-14,18:00:00,34,18,16,FMN GV 11 Ramsel
66,Bergstraat 71,2019-02-14,19:00:00,22,14,8,FMN GV 11 Ramsel
66,Bergstraat 71,2019-02-14,20:00:00,20,14,6,FMN GV 11 Ramsel
66,Bergstraat 71,2019-02-14,21:00:00,6,4,2,FMN GV 11 Ramsel
66,Bergstraat 71,2019-02-14,22:00:00,10,8,2,FMN GV 11 Ramsel
66,Bergstraat 71,2019-02-14,23:00:00,2,2,0,FMN GV 11 Ramsel
66,Bergstraat 71,2019-02-15,00:00:00,0,0,0,FMN GV 11 Ramsel
66,Bergstraat 71,2019-02-15,01:00:00,0,0,0,FMN GV 11 Ramsel
66,Bergstraat 71,2019-02-15,02:00:00,2,2,0,FMN GV 11 Ramsel
66,Bergstraat 71,2019-02-15,03:00:00,0,0,0,FMN GV 11 Ramsel
66,Bergstraat 71,2019-02-15,04:00:00,2,2,0,FMN GV 11 Ramsel
66,Bergstraat 71,2019-02-15,05:00:00,4,2,2,FMN GV 11 Ramsel
66,Bergstraat 71,2019-02-15,06:00:00,28,10,18,FMN GV 11 Ramsel
66,Bergstraat 71,2019-02-15,07:00:00,102,18,84,FMN GV 11 Ramsel
66,Bergstraat 71,2019-02-15,08:00:00,130,30,100,FMN GV 11 Ramsel
66,Bergstraat 71,2019-02-15,09:00:00,30,12,18,FMN GV 11 Ramsel
66,Bergstraat 71,2019-02-15,10:00:00,50,20,30,FMN GV 11 Ramsel
66,Bergstraat 71,2019-02-15,11:00:00,36,18,18,FMN GV 11 Ramsel
66,Bergstraat 71,2019-02-15,12:00:00,124,32,92,FMN GV 11 Ramsel
66,Bergstraat 71,2019-02-15,13:00:00,150,86,64,FMN GV 11 Ramsel
66,Bergstraat 71,2019-02-15,14:00:00,154,94,60,FMN GV 11 Ramsel
66,Bergstraat 71,2019-02-15,15:00:00,274,190,84,FMN GV 11 Ramsel
66,Bergstraat 71,2019-02-15,16:00:00,150,88,62,FMN GV 11 Ramsel
66,Bergstraat 71,2019-02-15,17:00:00,118,92,26,FMN GV 11 Ramsel
66,Bergstraat 71,2019-02-15,18:00:00,32,18,14,FMN GV 11 Ramsel
66,Bergstraat 71,2019-02-15,19:00:00,12,6,6,FMN GV 11 Ramsel
66,Bergstraat 71,2019-02-15,20:00:00,24,8,16,FMN GV 11 Ramsel
66,Bergstraat 71,2019-02-15,21:00:00,10,8,2,FMN GV 11 Ramsel
66,Bergstraat 71,2019-02-15,22:00:00,4,2,2,FMN GV 11 Ramsel
66,Bergstraat 71,2019-02-15,23:00:00,4,2,2,FMN GV 11 Ramsel
66,Bergstraat 71,2019-02-16,00:00:00,2,2,0,FMN GV 11 Ramsel
66,Bergstraat 71,2019-02-16,01:00:00,4,4,0,FMN GV 11 Ramsel
66,Bergstraat 71,2019-02-16,02:00:00,8,6,2,FMN GV 11 Ramsel
66,Bergstraat 71,2019-02-16,03:00:00,0,0,0,FMN GV 11 Ramsel
66,Bergstraat 71,2019-02-16,04:00:00,0,0,0,FMN GV 11 Ramsel
66,Bergstraat 71,2019-02-16,05:00:00,0,0,0,FMN GV 11 Ramsel
66,Bergstraat 71,2019-02-16,06:00:00,2,0,2,FMN GV 11 Ramsel
66,Bergstraat 71,2019-02-16,07:00:00,6,4,2,FMN GV 11 Ramsel
66,Bergstraat 71,2019-02-16,08:00:00,12,4,8,FMN GV 11 Ramsel
66,Bergstraat 71,2019-02-16,09:00:00,30,18,12,FMN GV 11 Ramsel
66,Bergstraat 71,2019-02-16,10:00:00,90,42,48,FMN GV 11 Ramsel
66,Bergstraat 71,2019-02-16,11:00:00,120,48,72,FMN GV 11 Ramsel
66,Bergstraat 71,2019-02-16,12:00:00,104,46,58,FMN GV 11 Ramsel
66,Bergstraat 71,2019-02-16,13:00:00,230,84,146,FMN GV 11 Ramsel
66,Bergstraat 71,2019-02-16,14:00:00,226,114,112,FMN GV 11 Ramsel
66,Bergstraat 71,2019-02-16,15:00:00,190,108,82,FMN GV 11 Ramsel
66,Bergstraat 71,2019-02-16,16:00:00,182,110,72,FMN GV 11 Ramsel
66,Bergstraat 71,2019-02-16,17:00:00,56,28,28,FMN GV 11 Ramsel
66,Bergstraat 71,2019-02-16,18:00:00,32,20,12,FMN GV 11 Ramsel
66,Bergstraat 71,2019-02-16,19:00:00,14,8,6,FMN GV 11 Ramsel
66,Bergstraat 71,2019-02-16,20:00:00,6,4,2,FMN GV 11 Ramsel
66,Bergstraat 71,2019-02-16,21:00:00,4,2,2,FMN GV 11 Ramsel
66,Bergstraat 71,2019-02-16,22:00:00,8,4,4,FMN GV 11 Ramsel
66,Bergstraat 71,2019-02-16,23:00:00,4,2,2,FMN GV 11 Ramsel
66,Bergstraat 71,2019-02-17,00:00:00,4,4,0,FMN GV 11 Ramsel
66,Bergstraat 71,2019-02-17,01:00:00,0,0,0,FMN GV 11 Ramsel
66,Bergstraat 71,2019-02-17,02:00:00,8,4,4,FMN GV 11 Ramsel
66,Bergstraat 71,2019-02-17,03:00:00,2,2,0,FMN GV 11 Ramsel
66,Bergstraat 71,2019-02-17,04:00:00,0,0,0,FMN GV 11 Ramsel
66,Bergstraat 71,2019-02-17,05:00:00,0,0,0,FMN GV 11 Ramsel
66,Bergstraat 71,2019-02-17,06:00:00,0,0,0,FMN GV 11 Ramsel
66,Bergstraat 71,2019-02-17,07:00:00,2,0,2,FMN GV 11 Ramsel
66,Bergstraat 71,2019-02-17,08:00:00,84,24,60,FMN GV 11 Ramsel
66,Bergstraat 71,2019-02-17,09:00:00,136,40,96,FMN GV 11 Ramsel
66,Bergstraat 71,2019-02-17,10:00:00,122,60,62,FMN GV 11 Ramsel
66,Bergstraat 71,2019-02-17,11:00:00,172,94,78,FMN GV 11 Ramsel
66,Bergstraat 71,2019-02-17,12:00:00,170,78,92,FMN GV 11 Ramsel
66,Bergstraat 71,2019-02-17,13:00:00,222,96,126,FMN GV 11 Ramsel
66,Bergstraat 71,2019-02-17,14:00:00,258,140,118,FMN GV 11 Ramsel
66,Bergstraat 71,2019-02-17,15:00:00,216,128,88,FMN GV 11 Ramsel
66,Bergstraat 71,2019-02-17,16:00:00,144,78,66,FMN GV 11 Ramsel
66,Bergstraat 71,2019-02-17,17:00:00,64,40,24,FMN GV 11 Ramsel
66,Bergstraat 71,2019-02-17,18:00:00,18,14,4,FMN GV 11 Ramsel
66,Bergstraat 71,2019-02-17,19:00:00,18,12,6,FMN GV 11 Ramsel
66,Bergstraat 71,2019-02-17,20:00:00,12,6,6,FMN GV 11 Ramsel
66,Bergstraat 71,2019-02-17,21:00:00,0,0,0,FMN GV 11 Ramsel
66,Bergstraat 71,2019-02-17,22:00:00,2,2,0,FMN GV 11 Ramsel
66,Bergstraat 71,2019-02-17,23:00:00,0,0,0,FMN GV 11 Ramsel
66,Bergstraat 71,2019-02-18,00:00:00,2,2,0,FMN GV 11 Ramsel
66,Bergstraat 71,2019-02-18,01:00:00,0,0,0,FMN GV 11 Ramsel
66,Bergstraat 71,2019-02-18,02:00:00,0,0,0,FMN GV 11 Ramsel
66,Bergstraat 71,2019-02-18,03:00:00,0,0,0,FMN GV 11 Ramsel
66,Bergstraat 71,2019-02-18,04:00:00,2,2,0,FMN GV 11 Ramsel
66,Bergstraat 71,2019-02-18,05:00:00,10,8,2,FMN GV 11 Ramsel
66,Bergstraat 71,2019-02-18,06:00:00,36,6,30,FMN GV 11 Ramsel
66,Bergstraat 71,2019-02-18,07:00:00,144,24,120,FMN GV 11 Ramsel
66,Bergstraat 71,2019-02-18,08:00:00,166,18,148,FMN GV 11 Ramsel
66,Bergstraat 71,2019-02-18,09:00:00,34,16,18,FMN GV 11 Ramsel
66,Bergstraat 71,2019-02-18,10:00:00,42,20,22,FMN GV 11 Ramsel
66,Bergstraat 71,2019-02-18,11:00:00,48,12,36,FMN GV 11 Ramsel
66,Bergstraat 71,2019-02-18,12:00:00,98,40,58,FMN GV 11 Ramsel
66,Bergstraat 71,2019-02-18,13:00:00,144,68,76,FMN GV 11 Ramsel
66,Bergstraat 71,2019-02-18,14:00:00,150,78,72,FMN GV 11 Ramsel
66,Bergstraat 71,2019-02-18,15:00:00,310,220,90,FMN GV 11 Ramsel
66,Bergstraat 71,2019-02-18,16:00:00,150,108,42,FMN GV 11 Ramsel
66,Bergstraat 71,2019-02-18,17:00:00,100,64,36,FMN GV 11 Ramsel
66,Bergstraat 71,2019-02-18,18:00:00,38,20,18,FMN GV 11 Ramsel
66,Bergstraat 71,2019-02-18,19:00:00,24,12,12,FMN GV 11 Ramsel
66,Bergstraat 71,2019-02-18,20:00:00,14,8,6,FMN GV 11 Ramsel
66,Bergstraat 71,2019-02-18,21:00:00,8,6,2,FMN GV 11 Ramsel
66,Bergstraat 71,2019-02-18,22:00:00,8,8,0,FMN GV 11 Ramsel
66,Bergstraat 71,2019-02-18,23:00:00,2,2,0,FMN GV 11 Ramsel
66,Bergstraat 71,2019-02-19,00:00:00,0,0,0,FMN GV 11 Ramsel
66,Bergstraat 71,2019-02-19,01:00:00,0,0,0,FMN GV 11 Ramsel
66,Bergstraat 71,2019-02-19,02:00:00,0,0,0,FMN GV 11 Ramsel
66,Bergstraat 71,2019-02-19,03:00:00,2,2,0,FMN GV 11 Ramsel
66,Bergstraat 71,2019-02-19,04:00:00,2,0,2,FMN GV 11 Ramsel
66,Bergstraat 71,2019-02-19,05:00:00,16,6,10,FMN GV 11 Ramsel
66,Bergstraat 71,2019-02-19,06:00:00,42,10,32,FMN GV 11 Ramsel
66,Bergstraat 71,2019-02-19,07:00:00,162,30,132,FMN GV 11 Ramsel
66,Bergstraat 71,2019-02-19,08:00:00,180,36,144,FMN GV 11 Ramsel
66,Bergstraat 71,2019-02-19,09:00:00,64,20,44,FMN GV 11 Ramsel
66,Bergstraat 71,2019-02-19,10:00:00,76,32,44,FMN GV 11 Ramsel
66,Bergstraat 71,2019-02-19,11:00:00,40,18,22,FMN GV 11 Ramsel
66,Bergstraat 71,2019-02-19,12:00:00,76,42,34,FMN GV 11 Ramsel
66,Bergstraat 71,2019-02-19,13:00:00,116,66,50,FMN GV 11 Ramsel
66,Bergstraat 71,2019-02-19,14:00:00,96,50,46,FMN GV 11 Ramsel
66,Bergstraat 71,2019-02-19,15:00:00,226,194,32,FMN GV 11 Ramsel
66,Bergstraat 71,2019-02-19,16:00:00,136,90,46,FMN GV 11 Ramsel
66,Bergstraat 71,2019-02-19,17:00:00,88,60,28,FMN GV 11 Ramsel
66,Bergstraat 71,2019-02-19,18:00:00,62,36,26,FMN GV 11 Ramsel
66,Bergstraat 71,2019-02-19,19:00:00,38,14,24,FMN GV 11 Ramsel
66,Bergstraat 71,2019-02-19,20:00:00,32,26,6,FMN GV 11 Ramsel
66,Bergstraat 71,2019-02-19,21:00:00,8,6,2,FMN GV 11 Ramsel
66,Bergstraat 71,2019-02-19,22:00:00,14,14,0,FMN GV 11 Ramsel
66,Bergstraat 71,2019-02-19,23:00:00,4,4,0,FMN GV 11 Ramsel
66,Bergstraat 71,2019-02-20,00:00:00,0,0,0,FMN GV 11 Ramsel
66,Bergstraat 71,2019-02-20,01:00:00,0,0,0,FMN GV 11 Ramsel
66,Bergstraat 71,2019-02-20,02:00:00,0,0,0,FMN GV 11 Ramsel
66,Bergstraat 71,2019-02-20,03:00:00,2,2,0,FMN GV 11 Ramsel
66,Bergstraat 71,2019-02-20,04:00:00,2,2,0,FMN GV 11 Ramsel
66,Bergstraat 71,2019-02-20,05:00:00,6,4,2,FMN GV 11 Ramsel
66,Bergstraat 71,2019-02-20,06:00:00,36,8,28,FMN GV 11 Ramsel
66,Bergstraat 71,2019-02-20,07:00:00,156,28,128,FMN GV 11 Ramsel
66,Bergstraat 71,2019-02-20,08:00:00,148,22,126,FMN GV 11 Ramsel
66,Bergstraat 71,2019-02-20,09:00:00,32,12,20,FMN GV 11 Ramsel
66,Bergstraat 71,2019-02-20,10:00:00,46,26,20,FMN GV 11 Ramsel
66,Bergstraat 71,2019-02-20,11:00:00,72,44,28,FMN GV 11 Ramsel
66,Bergstraat 71,2019-02-20,12:00:00,256,196,60,FMN GV 11 Ramsel
66,Bergstraat 71,2019-02-20,13:00:00,162,82,80,FMN GV 11 Ramsel
66,Bergstraat 71,2019-02-20,14:00:00,156,84,72,FMN GV 11 Ramsel
66,Bergstraat 71,2019-02-20,15:00:00,164,90,74,FMN GV 11 Ramsel
66,Bergstraat 71,2019-02-20,16:00:00,132,86,46,FMN GV 11 Ramsel
66,Bergstraat 71,2019-02-20,17:00:00,146,100,46,FMN GV 11 Ramsel
66,Bergstraat 71,2019-02-20,18:00:00,46,28,18,FMN GV 11 Ramsel
66,Bergstraat 71,2019-02-20,19:00:00,46,36,10,FMN GV 11 Ramsel
66,Bergstraat 71,2019-02-20,20:00:00,16,8,8,FMN GV 11 Ramsel
66,Bergstraat 71,2019-02-20,21:00:00,0,0,0,FMN GV 11 Ramsel
66,Bergstraat 71,2019-02-20,22:00:00,8,4,4,FMN GV 11 Ramsel
66,Bergstraat 71,2019-02-20,23:00:00,2,2,0,FMN GV 11 Ramsel
66,Bergstraat 71,2019-02-21,00:00:00,0,0,0,FMN GV 11 Ramsel
66,Bergstraat 71,2019-02-21,01:00:00,0,0,0,FMN GV 11 Ramsel
66,Bergstraat 71,2019-02-21,02:00:00,0,0,0,FMN GV 11 Ramsel
66,Bergstraat 71,2019-02-21,03:00:00,2,2,0,FMN GV 11 Ramsel
66,Bergstraat 71,2019-02-21,04:00:00,2,0,2,FMN GV 11 Ramsel
66,Bergstraat 71,2019-02-21,05:00:00,16,6,10,FMN GV 11 Ramsel
66,Bergstraat 71,2019-02-21,06:00:00,48,10,38,FMN GV 11 Ramsel
66,Bergstraat 71,2019-02-21,07:00:00,150,26,124,FMN GV 11 Ramsel
66,Bergstraat 71,2019-02-21,08:00:00,154,24,130,FMN GV 11 Ramsel
66,Bergstraat 71,2019-02-21,09:00:00,32,20,12,FMN GV 11 Ramsel
66,Bergstraat 71,2019-02-21,10:00:00,42,18,24,FMN GV 11 Ramsel
66,Bergstraat 71,2019-02-21,11:00:00,44,22,22,FMN GV 11 Ramsel
66,Bergstraat 71,2019-02-21,12:00:00,82,34,48,FMN GV 11 Ramsel
66,Bergstraat 71,2019-02-21,13:00:00,132,54,78,FMN GV 11 Ramsel
66,Bergstraat 71,2019-02-21,14:00:00,132,84,48,FMN GV 11 Ramsel
66,Bergstraat 71,2019-02-21,15:00:00,238,178,60,FMN GV 11 Ramsel
66,Bergstraat 71,2019-02-21,16:00:00,156,110,46,FMN GV 11 Ramsel
66,Bergstraat 71,2019-02-21,17:00:00,98,50,48,FMN GV 11 Ramsel
66,Bergstraat 71,2019-02-21,18:00:00,60,32,28,FMN GV 11 Ramsel
66,Bergstraat 71,2019-02-21,19:00:00,44,18,26,FMN GV 11 Ramsel
66,Bergstraat 71,2019-02-21,20:00:00,28,20,8,FMN GV 11 Ramsel
66,Bergstraat 71,2019-02-21,21:00:00,14,12,2,FMN GV 11 Ramsel
66,Bergstraat 71,2019-02-21,22:00:00,10,10,0,FMN GV 11 Ramsel
66,Bergstraat 71,2019-02-21,23:00:00,0,0,0,FMN GV 11 Ramsel
66,Bergstraat 71,2019-02-22,00:00:00,2,2,0,FMN GV 11 Ramsel
66,Bergstraat 71,2019-02-22,01:00:00,0,0,0,FMN GV 11 Ramsel
66,Bergstraat 71,2019-02-22,02:00:00,0,0,0,FMN GV 11 Ramsel
66,Bergstraat 71,2019-02-22,03:00:00,2,2,0,FMN GV 11 Ramsel
66,Bergstraat 71,2019-02-22,04:00:00,2,2,0,FMN GV 11 Ramsel
66,Bergstraat 71,2019-02-22,05:00:00,16,10,6,FMN GV 11 Ramsel
66,Bergstraat 71,2019-02-22,06:00:00,28,6,22,FMN GV 11 Ramsel
66,Bergstraat 71,2019-02-22,07:00:00,146,18,128,FMN GV 11 Ramsel
66,Bergstraat 71,2019-02-22,08:00:00,142,22,120,FMN GV 11 Ramsel
66,Bergstraat 71,2019-02-22,09:00:00,30,18,12,FMN GV 11 Ramsel
66,Bergstraat 71,2019-02-22,10:00:00,54,32,22,FMN GV 11 Ramsel
66,Bergstraat 71,2019-02-22,11:00:00,76,34,42,FMN GV 11 Ramsel
66,Bergstraat 71,2019-02-22,12:00:00,60,30,30,FMN GV 11 Ramsel
66,Bergstraat 71,2019-02-22,13:00:00,112,58,54,FMN GV 11 Ramsel
66,Bergstraat 71,2019-02-22,14:00:00,144,72,72,FMN GV 11 Ramsel
66,Bergstraat 71,2019-02-22,15:00:00,224,190,34,FMN GV 11 Ramsel
66,Bergstraat 71,2019-02-22,16:00:00,148,108,40,FMN GV 11 Ramsel
66,Bergstraat 71,2019-02-22,17:00:00,88,62,26,FMN GV 11 Ramsel
66,Bergstraat 71,2019-02-22,18:00:00,40,32,8,FMN GV 11 Ramsel
66,Bergstraat 71,2019-02-22,19:00:00,28,16,12,FMN GV 11 Ramsel
66,Bergstraat 71,2019-02-22,20:00:00,18,6,12,FMN GV 11 Ramsel
66,Bergstraat 71,2019-02-22,21:00:00,34,12,22,FMN GV 11 Ramsel
66,Bergstraat 71,2019-02-22,22:00:00,14,0,14,FMN GV 11 Ramsel
66,Bergstraat 71,2019-02-22,23:00:00,0,0,0,FMN GV 11 Ramsel
66,Bergstraat 71,2019-02-23,00:00:00,4,4,0,FMN GV 11 Ramsel
66,Bergstraat 71,2019-02-23,01:00:00,6,4,2,FMN GV 11 Ramsel
66,Bergstraat 71,2019-02-23,02:00:00,12,10,2,FMN GV 11 Ramsel
66,Bergstraat 71,2019-02-23,03:00:00,20,18,2,FMN GV 11 Ramsel
66,Bergstraat 71,2019-02-23,04:00:00,18,18,0,FMN GV 11 Ramsel
66,Bergstraat 71,2019-02-23,05:00:00,4,0,4,FMN GV 11 Ramsel
66,Bergstraat 71,2019-02-23,06:00:00,4,2,2,FMN GV 11 Ramsel
66,Bergstraat 71,2019-02-23,07:00:00,26,10,16,FMN GV 11 Ramsel
66,Bergstraat 71,2019-02-23,08:00:00,30,18,12,FMN GV 11 Ramsel
66,Bergstraat 71,2019-02-23,09:00:00,50,14,36,FMN GV 11 Ramsel
66,Bergstraat 71,2019-02-23,10:00:00,84,32,52,FMN GV 11 Ramsel
66,Bergstraat 71,2019-02-23,11:00:00,100,48,52,FMN GV 11 Ramsel
66,Bergstraat 71,2019-02-23,12:00:00,142,78,64,FMN GV 11 Ramsel
66,Bergstraat 71,2019-02-23,13:00:00,250,106,144,FMN GV 11 Ramsel
66,Bergstraat 71,2019-02-23,14:00:00,282,166,116,FMN GV 11 Ramsel
66,Bergstraat 71,2019-02-23,15:00:00,260,156,104,FMN GV 11 Ramsel
66,Bergstraat 71,2019-02-23,16:00:00,154,96,58,FMN GV 11 Ramsel
66,Bergstraat 71,2019-02-23,17:00:00,112,66,46,FMN GV 11 Ramsel
66,Bergstraat 71,2019-02-23,18:00:00,26,18,8,FMN GV 11 Ramsel
66,Bergstraat 71,2019-02-23,19:00:00,20,10,10,FMN GV 11 Ramsel
66,Bergstraat 71,2019-02-23,20:00:00,10,4,6,FMN GV 11 Ramsel
66,Bergstraat 71,2019-02-23,21:00:00,6,2,4,FMN GV 11 Ramsel
66,Bergstraat 71,2019-02-23,22:00:00,4,2,2,FMN GV 11 Ramsel
66,Bergstraat 71,2019-02-23,23:00:00,10,8,2,FMN GV 11 Ramsel
66,Bergstraat 71,2019-02-24,00:00:00,6,4,2,FMN GV 11 Ramsel
66,Bergstraat 71,2019-02-24,01:00:00,0,0,0,FMN GV 11 Ramsel
66,Bergstraat 71,2019-02-24,02:00:00,6,6,0,FMN GV 11 Ramsel
66,Bergstraat 71,2019-02-24,03:00:00,2,2,0,FMN GV 11 Ramsel
66,Bergstraat 71,2019-02-24,04:00:00,2,2,0,FMN GV 11 Ramsel
66,Bergstraat 71,2019-02-24,05:00:00,2,0,2,FMN GV 11 Ramsel
66,Bergstraat 71,2019-02-24,06:00:00,4,0,4,FMN GV 11 Ramsel
66,Bergstraat 71,2019-02-24,07:00:00,20,8,12,FMN GV 11 Ramsel
66,Bergstraat 71,2019-02-24,08:00:00,46,20,26,FMN GV 11 Ramsel
66,Bergstraat 71,2019-02-24,09:00:00,134,50,84,FMN GV 11 Ramsel
66,Bergstraat 71,2019-02-24,10:00:00,180,90,90,FMN GV 11 Ramsel
66,Bergstraat 71,2019-02-24,11:00:00,176,112,64,FMN GV 11 Ramsel
66,Bergstraat 71,2019-02-24,12:00:00,140,66,74,FMN GV 11 Ramsel
66,Bergstraat 71,2019-02-24,13:00:00,256,132,124,FMN GV 11 Ramsel
66,Bergstraat 71,2019-02-24,14:00:00,304,160,144,FMN GV 11 Ramsel
66,Bergstraat 71,2019-02-24,15:00:00,258,130,128,FMN GV 11 Ramsel
66,Bergstraat 71,2019-02-24,16:00:00,260,134,126,FMN GV 11 Ramsel
66,Bergstraat 71,2019-02-24,17:00:00,98,46,52,FMN GV 11 Ramsel
66,Bergstraat 71,2019-02-24,18:00:00,42,24,18,FMN GV 11 Ramsel
66,Bergstraat 71,2019-02-24,19:00:00,20,16,4,FMN GV 11 Ramsel
66,Bergstraat 71,2019-02-24,20:00:00,8,4,4,FMN GV 11 Ramsel
66,Bergstraat 71,2019-02-24,21:00:00,6,6,0,FMN GV 11 Ramsel
66,Bergstraat 71,2019-02-24,22:00:00,8,6,2,FMN GV 11 Ramsel
66,Bergstraat 71,2019-02-24,23:00:00,0,0,0,FMN GV 11 Ramsel
66,Bergstraat 71,2019-02-25,00:00:00,0,0,0,FMN GV 11 Ramsel
66,Bergstraat 71,2019-02-25,01:00:00,0,0,0,FMN GV 11 Ramsel
66,Bergstraat 71,2019-02-25,02:00:00,0,0,0,FMN GV 11 Ramsel
66,Bergstraat 71,2019-02-25,03:00:00,0,0,0,FMN GV 11 Ramsel
66,Bergstraat 71,2019-02-25,04:00:00,2,2,0,FMN GV 11 Ramsel
66,Bergstraat 71,2019-02-25,05:00:00,6,2,4,FMN GV 11 Ramsel
66,Bergstraat 71,2019-02-25,06:00:00,48,18,30,FMN GV 11 Ramsel
66,Bergstraat 71,2019-02-25,07:00:00,138,20,118,FMN GV 11 Ramsel
66,Bergstraat 71,2019-02-25,08:00:00,140,14,126,FMN GV 11 Ramsel
66,Bergstraat 71,2019-02-25,09:00:00,48,14,34,FMN GV 11 Ramsel
66,Bergstraat 71,2019-02-25,10:00:00,70,44,26,FMN GV 11 Ramsel
66,Bergstraat 71,2019-02-25,11:00:00,48,20,28,FMN GV 11 Ramsel
66,Bergstraat 71,2019-02-25,12:00:00,72,32,40,FMN GV 11 Ramsel
66,Bergstraat 71,2019-02-25,13:00:00,156,72,84,FMN GV 11 Ramsel
66,Bergstraat 71,2019-02-25,14:00:00,170,104,66,FMN GV 11 Ramsel
66,Bergstraat 71,2019-02-25,15:00:00,268,186,82,FMN GV 11 Ramsel
66,Bergstraat 71,2019-02-25,16:00:00,160,116,44,FMN GV 11 Ramsel
66,Bergstraat 71,2019-02-25,17:00:00,96,60,36,FMN GV 11 Ramsel
66,Bergstraat 71,2019-02-25,18:00:00,48,32,16,FMN GV 11 Ramsel
66,Bergstraat 71,2019-02-25,19:00:00,30,20,10,FMN GV 11 Ramsel
66,Bergstraat 71,2019-02-25,20:00:00,16,10,6,FMN GV 11 Ramsel
66,Bergstraat 71,2019-02-25,21:00:00,12,8,4,FMN GV 11 Ramsel
66,Bergstraat 71,2019-02-25,22:00:00,6,0,6,FMN GV 11 Ramsel
66,Bergstraat 71,2019-02-25,23:00:00,2,2,0,FMN GV 11 Ramsel
66,Bergstraat 71,2019-02-26,00:00:00,2,0,2,FMN GV 11 Ramsel
66,Bergstraat 71,2019-02-26,01:00:00,0,0,0,FMN GV 11 Ramsel
66,Bergstraat 71,2019-02-26,02:00:00,0,0,0,FMN GV 11 Ramsel
66,Bergstraat 71,2019-02-26,03:00:00,0,0,0,FMN GV 11 Ramsel
66,Bergstraat 71,2019-02-26,04:00:00,2,0,2,FMN GV 11 Ramsel
66,Bergstraat 71,2019-02-26,05:00:00,10,4,6,FMN GV 11 Ramsel
66,Bergstraat 71,2019-02-26,06:00:00,42,10,32,FMN GV 11 Ramsel
66,Bergstraat 71,2019-02-26,07:00:00,144,26,118,FMN GV 11 Ramsel
66,Bergstraat 71,2019-02-26,08:00:00,154,24,130,FMN GV 11 Ramsel
66,Bergstraat 71,2019-02-26,09:00:00,46,18,28,FMN GV 11 Ramsel
66,Bergstraat 71,2019-02-26,10:00:00,48,26,22,FMN GV 11 Ramsel
66,Bergstraat 71,2019-02-26,11:00:00,76,32,44,FMN GV 11 Ramsel
66,Bergstraat 71,2019-02-26,12:00:00,108,66,42,FMN GV 11 Ramsel
66,Bergstraat 71,2019-02-26,13:00:00,204,94,110,FMN GV 11 Ramsel
66,Bergstraat 71,2019-02-26,14:00:00,236,114,122,FMN GV 11 Ramsel
66,Bergstraat 71,2019-02-26,15:00:00,330,258,72,FMN GV 11 Ramsel
66,Bergstraat 71,2019-02-26,16:00:00,194,144,50,FMN GV 11 Ramsel
66,Bergstraat 71,2019-02-26,17:00:00,166,80,86,FMN GV 11 Ramsel
66,Bergstraat 71,2019-02-26,18:00:00,70,48,22,FMN GV 11 Ramsel
66,Bergstraat 71,2019-02-26,19:00:00,46,28,18,FMN GV 11 Ramsel
66,Bergstraat 71,2019-02-26,20:00:00,32,24,8,FMN GV 11 Ramsel
66,Bergstraat 71,2019-02-26,21:00:00,4,4,0,FMN GV 11 Ramsel
66,Bergstraat 71,2019-02-26,22:00:00,6,4,2,FMN GV 11 Ramsel
66,Bergstraat 71,2019-02-26,23:00:00,2,0,2,FMN GV 11 Ramsel
66,Bergstraat 71,2019-02-27,00:00:00,2,2,0,FMN GV 11 Ramsel
66,Bergstraat 71,2019-02-27,01:00:00,0,0,0,FMN GV 11 Ramsel
66,Bergstraat 71,2019-02-27,02:00:00,2,0,2,FMN GV 11 Ramsel
66,Bergstraat 71,2019-02-27,03:00:00,0,0,0,FMN GV 11 Ramsel
66,Bergstraat 71,2019-02-27,04:00:00,2,0,2,FMN GV 11 Ramsel
66,Bergstraat 71,2019-02-27,05:00:00,14,4,10,FMN GV 11 Ramsel
66,Bergstraat 71,2019-02-27,06:00:00,42,16,26,FMN GV 11 Ramsel
66,Bergstraat 71,2019-02-27,07:00:00,144,20,124,FMN GV 11 Ramsel
66,Bergstraat 71,2019-02-27,08:00:00,148,20,128,FMN GV 11 Ramsel
66,Bergstraat 71,2019-02-27,09:00:00,36,10,26,FMN GV 11 Ramsel
66,Bergstraat 71,2019-02-27,10:00:00,74,30,44,FMN GV 11 Ramsel
66,Bergstraat 71,2019-02-27,11:00:00,84,32,52,FMN GV 11 Ramsel
66,Bergstraat 71,2019-02-27,12:00:00,280,192,88,FMN GV 11 Ramsel
66,Bergstraat 71,2019-02-27,13:00:00,232,88,144,FMN GV 11 Ramsel
66,Bergstraat 71,2019-02-27,14:00:00,300,162,138,FMN GV 11 Ramsel
66,Bergstraat 71,2019-02-27,15:00:00,272,166,106,FMN GV 11 Ramsel
66,Bergstraat 71,2019-02-27,16:00:00,256,160,96,FMN GV 11 Ramsel
66,Bergstraat 71,2019-02-27,17:00:00,146,76,70,FMN GV 11 Ramsel
66,Bergstraat 71,2019-02-27,18:00:00,58,40,18,FMN GV 11 Ramsel
66,Bergstraat 71,2019-02-27,19:00:00,38,28,10,FMN GV 11 Ramsel
66,Bergstraat 71,2019-02-27,20:00:00,20,12,8,FMN GV 11 Ramsel
66,Bergstraat 71,2019-02-27,21:00:00,26,22,4,FMN GV 11 Ramsel
66,Bergstraat 71,2019-02-27,22:00:00,4,4,0,FMN GV 11 Ramsel
66,Bergstraat 71,2019-02-27,23:00:00,2,0,2,FMN GV 11 Ramsel
66,Bergstraat 71,2019-02-28,00:00:00,4,2,2,FMN GV 11 Ramsel
66,Bergstraat 71,2019-02-28,01:00:00,0,0,0,FMN GV 11 Ramsel
66,Bergstraat 71,2019-02-28,02:00:00,0,0,0,FMN GV 11 Ramsel
66,Bergstraat 71,2019-02-28,03:00:00,2,2,0,FMN GV 11 Ramsel
66,Bergstraat 71,2019-02-28,04:00:00,4,2,2,FMN GV 11 Ramsel
66,Bergstraat 71,2019-02-28,05:00:00,6,2,4,FMN GV 11 Ramsel
66,Bergstraat 71,2019-02-28,06:00:00,34,14,20,FMN GV 11 Ramsel
66,Bergstraat 71,2019-02-28,07:00:00,126,24,102,FMN GV 11 Ramsel
66,Bergstraat 71,2019-02-28,08:00:00,160,24,136,FMN GV 11 Ramsel
66,Bergstraat 71,2019-02-28,09:00:00,44,22,22,FMN GV 11 Ramsel
66,Bergstraat 71,2019-02-28,10:00:00,74,32,42,FMN GV 11 Ramsel
66,Bergstraat 71,2019-02-28,11:00:00,40,20,20,FMN GV 11 Ramsel
66,Bergstraat 71,2019-02-28,12:00:00,52,28,24,FMN GV 11 Ramsel
66,Bergstraat 71,2019-02-28,13:00:00,66,38,28,FMN GV 11 Ramsel
66,Bergstraat 71,2019-02-28,14:00:00,76,54,22,FMN GV 11 Ramsel
66,Bergstraat 71,2019-02-28,15:00:00,186,124,62,FMN GV 11 Ramsel
66,Bergstraat 71,2019-02-28,16:00:00,84,66,18,FMN GV 11 Ramsel
66,Bergstraat 71,2019-02-28,17:00:00,86,52,34,FMN GV 11 Ramsel
66,Bergstraat 71,2019-02-28,18:00:00,36,24,12,FMN GV 11 Ramsel
66,Bergstraat 71,2019-02-28,19:00:00,28,14,14,FMN GV 11 Ramsel
66,Bergstraat 71,2019-02-28,20:00:00,16,12,4,FMN GV 11 Ramsel
66,Bergstraat 71,2019-02-28,21:00:00,8,8,0,FMN GV 11 Ramsel
66,Bergstraat 71,2019-02-28,22:00:00,14,4,10,FMN GV 11 Ramsel
66,Bergstraat 71,2019-02-28,23:00:00,0,0,0,FMN GV 11 Ramsel
66,Bergstraat 71,2019-03-01,00:00:00,0,0,0,FMN GV 11 Ramsel
66,Bergstraat 71,2019-03-01,01:00:00,0,0,0,FMN GV 11 Ramsel
66,Bergstraat 71,2019-03-01,02:00:00,0,0,0,FMN GV 11 Ramsel
66,Bergstraat 71,2019-03-01,03:00:00,0,0,0,FMN GV 11 Ramsel
66,Bergstraat 71,2019-03-01,04:00:00,2,2,0,FMN GV 11 Ramsel
66,Bergstraat 71,2019-03-01,05:00:00,6,0,6,FMN GV 11 Ramsel
66,Bergstraat 71,2019-03-01,06:00:00,18,6,12,FMN GV 11 Ramsel
66,Bergstraat 71,2019-03-01,07:00:00,128,34,94,FMN GV 11 Ramsel
66,Bergstraat 71,2019-03-01,08:00:00,106,14,92,FMN GV 11 Ramsel
66,Bergstraat 71,2019-03-01,09:00:00,26,8,18,FMN GV 11 Ramsel
66,Bergstraat 71,2019-03-01,10:00:00,22,16,6,FMN GV 11 Ramsel
66,Bergstraat 71,2019-03-01,11:00:00,14,12,2,FMN GV 11 Ramsel
66,Bergstraat 71,2019-03-01,12:00:00,20,10,10,FMN GV 11 Ramsel
66,Bergstraat 71,2019-03-01,13:00:00,34,8,26,FMN GV 11 Ramsel
66,Bergstraat 71,2019-03-01,14:00:00,44,30,14,FMN GV 11 Ramsel
66,Bergstraat 71,2019-03-01,15:00:00,122,98,24,FMN GV 11 Ramsel
66,Bergstraat 71,2019-03-01,16:00:00,92,82,10,FMN GV 11 Ramsel
66,Bergstraat 71,2019-03-01,17:00:00,88,56,32,FMN GV 11 Ramsel
66,Bergstraat 71,2019-03-01,18:00:00,34,22,12,FMN GV 11 Ramsel
66,Bergstraat 71,2019-03-01,19:00:00,8,6,2,FMN GV 11 Ramsel
66,Bergstraat 71,2019-03-01,20:00:00,14,8,6,FMN GV 11 Ramsel
66,Bergstraat 71,2019-03-01,21:00:00,4,2,2,FMN GV 11 Ramsel
66,Bergstraat 71,2019-03-01,22:00:00,4,0,4,FMN GV 11 Ramsel
66,Bergstraat 71,2019-03-01,23:00:00,10,2,8,FMN GV 11 Ramsel
66,Bergstraat 71,2019-03-02,00:00:00,0,0,0,FMN GV 11 Ramsel
66,Bergstraat 71,2019-03-02,01:00:00,4,2,2,FMN GV 11 Ramsel
66,Bergstraat 71,2019-03-02,02:00:00,10,8,2,FMN GV 11 Ramsel
66,Bergstraat 71,2019-03-02,03:00:00,4,4,0,FMN GV 11 Ramsel
66,Bergstraat 71,2019-03-02,04:00:00,0,0,0,FMN GV 11 Ramsel
66,Bergstraat 71,2019-03-02,05:00:00,6,4,2,FMN GV 11 Ramsel
66,Bergstraat 71,2019-03-02,06:00:00,2,0,2,FMN GV 11 Ramsel
66,Bergstraat 71,2019-03-02,07:00:00,12,2,10,FMN GV 11 Ramsel
66,Bergstraat 71,2019-03-02,08:00:00,26,10,16,FMN GV 11 Ramsel
66,Bergstraat 71,2019-03-02,09:00:00,64,28,36,FMN GV 11 Ramsel
66,Bergstraat 71,2019-03-02,10:00:00,84,48,36,FMN GV 11 Ramsel
66,Bergstraat 71,2019-03-02,11:00:00,128,62,66,FMN GV 11 Ramsel
66,Bergstraat 71,2019-03-02,12:00:00,74,40,34,FMN GV 11 Ramsel
66,Bergstraat 71,2019-03-02,13:00:00,86,48,38,FMN GV 11 Ramsel
66,Bergstraat 71,2019-03-02,14:00:00,82,56,26,FMN GV 11 Ramsel
66,Bergstraat 71,2019-03-02,15:00:00,66,48,18,FMN GV 11 Ramsel
66,Bergstraat 71,2019-03-02,16:00:00,44,32,12,FMN GV 11 Ramsel
66,Bergstraat 71,2019-03-02,17:00:00,44,26,18,FMN GV 11 Ramsel
66,Bergstraat 71,2019-03-02,18:00:00,16,12,4,FMN GV 11 Ramsel
66,Bergstraat 71,2019-03-02,19:00:00,12,4,8,FMN GV 11 Ramsel
66,Bergstraat 71,2019-03-02,20:00:00,6,2,4,FMN GV 11 Ramsel
66,Bergstraat 71,2019-03-02,21:00:00,6,6,0,FMN GV 11 Ramsel
66,Bergstraat 71,2019-03-02,22:00:00,4,0,4,FMN GV 11 Ramsel
66,Bergstraat 71,2019-03-02,23:00:00,2,2,0,FMN GV 11 Ramsel
66,Bergstraat 71,2019-03-03,00:00:00,0,0,0,FMN GV 11 Ramsel
66,Bergstraat 71,2019-03-03,01:00:00,2,2,0,FMN GV 11 Ramsel
66,Bergstraat 71,2019-03-03,02:00:00,4,2,2,FMN GV 11 Ramsel
66,Bergstraat 71,2019-03-03,03:00:00,2,0,2,FMN GV 11 Ramsel
66,Bergstraat 71,2019-03-03,04:00:00,2,0,2,FMN GV 11 Ramsel
66,Bergstraat 71,2019-03-03,05:00:00,0,0,0,FMN GV 11 Ramsel
66,Bergstraat 71,2019-03-03,06:00:00,0,0,0,FMN GV 11 Ramsel
66,Bergstraat 71,2019-03-03,07:00:00,4,2,2,FMN GV 11 Ramsel
66,Bergstraat 71,2019-03-03,08:00:00,20,4,16,FMN GV 11 Ramsel
66,Bergstraat 71,2019-03-03,09:00:00,24,4,20,FMN GV 11 Ramsel
66,Bergstraat 71,2019-03-03,10:00:00,28,12,16,FMN GV 11 Ramsel
66,Bergstraat 71,2019-03-03,11:00:00,18,18,0,FMN GV 11 Ramsel
66,Bergstraat 71,2019-03-03,12:00:00,10,6,4,FMN GV 11 Ramsel
66,Bergstraat 71,2019-03-03,13:00:00,8,2,6,FMN GV 11 Ramsel
66,Bergstraat 71,2019-03-03,14:00:00,12,10,2,FMN GV 11 Ramsel
66,Bergstraat 71,2019-03-03,15:00:00,10,6,4,FMN GV 11 Ramsel
66,Bergstraat 71,2019-03-03,16:00:00,14,6,8,FMN GV 11 Ramsel
66,Bergstraat 71,2019-03-03,17:00:00,28,12,16,FMN GV 11 Ramsel
66,Bergstraat 71,2019-03-03,18:00:00,10,10,0,FMN GV 11 Ramsel
66,Bergstraat 71,2019-03-03,19:00:00,8,2,6,FMN GV 11 Ramsel
66,Bergstraat 71,2019-03-03,20:00:00,10,8,2,FMN GV 11 Ramsel
66,Bergstraat 71,2019-03-03,21:00:00,0,0,0,FMN GV 11 Ramsel
66,Bergstraat 71,2019-03-03,22:00:00,0,0,0,FMN GV 11 Ramsel
66,Bergstraat 71,2019-03-03,23:00:00,0,0,0,FMN GV 11 Ramsel
66,Bergstraat 71,2019-03-04,00:00:00,0,0,0,FMN GV 11 Ramsel
66,Bergstraat 71,2019-03-04,01:00:00,0,0,0,FMN GV 11 Ramsel
66,Bergstraat 71,2019-03-04,02:00:00,0,0,0,FMN GV 11 Ramsel
66,Bergstraat 71,2019-03-04,03:00:00,0,0,0,FMN GV 11 Ramsel
66,Bergstraat 71,2019-03-04,04:00:00,2,2,0,FMN GV 11 Ramsel
66,Bergstraat 71,2019-03-04,05:00:00,4,2,2,FMN GV 11 Ramsel
66,Bergstraat 71,2019-03-04,06:00:00,30,8,22,FMN GV 11 Ramsel
66,Bergstraat 71,2019-03-04,07:00:00,24,4,20,FMN GV 11 Ramsel
66,Bergstraat 71,2019-03-04,08:00:00,16,2,14,FMN GV 11 Ramsel
66,Bergstraat 71,2019-03-04,09:00:00,12,6,6,FMN GV 11 Ramsel
66,Bergstraat 71,2019-03-04,10:00:00,10,4,6,FMN GV 11 Ramsel
66,Bergstraat 71,2019-03-04,11:00:00,20,10,10,FMN GV 11 Ramsel
66,Bergstraat 71,2019-03-04,12:00:00,12,2,10,FMN GV 11 Ramsel
66,Bergstraat 71,2019-03-04,13:00:00,50,14,36,FMN GV 11 Ramsel
66,Bergstraat 71,2019-03-04,14:00:00,64,30,34,FMN GV 11 Ramsel
66,Bergstraat 71,2019-03-04,15:00:00,66,46,20,FMN GV 11 Ramsel
66,Bergstraat 71,2019-03-04,16:00:00,42,34,8,FMN GV 11 Ramsel
66,Bergstraat 71,2019-03-04,17:00:00,48,38,10,FMN GV 11 Ramsel
66,Bergstraat 71,2019-03-04,18:00:00,32,28,4,FMN GV 11 Ramsel
66,Bergstraat 71,2019-03-04,19:00:00,12,6,6,FMN GV 11 Ramsel
66,Bergstraat 71,2019-03-04,20:00:00,16,12,4,FMN GV 11 Ramsel
66,Bergstraat 71,2019-03-04,21:00:00,2,0,2,FMN GV 11 Ramsel
66,Bergstraat 71,2019-03-04,22:00:00,2,2,0,FMN GV 11 Ramsel
66,Bergstraat 71,2019-03-04,23:00:00,2,2,0,FMN GV 11 Ramsel
66,Bergstraat 71,2019-03-05,00:00:00,0,0,0,FMN GV 11 Ramsel
66,Bergstraat 71,2019-03-05,01:00:00,0,0,0,FMN GV 11 Ramsel
66,Bergstraat 71,2019-03-05,02:00:00,0,0,0,FMN GV 11 Ramsel
66,Bergstraat 71,2019-03-05,03:00:00,0,0,0,FMN GV 11 Ramsel
66,Bergstraat 71,2019-03-05,04:00:00,2,2,0,FMN GV 11 Ramsel
66,Bergstraat 71,2019-03-05,05:00:00,2,0,2,FMN GV 11 Ramsel
66,Bergstraat 71,2019-03-05,06:00:00,28,6,22,FMN GV 11 Ramsel
66,Bergstraat 71,2019-03-05,07:00:00,36,10,26,FMN GV 11 Ramsel
66,Bergstraat 71,2019-03-05,08:00:00,28,6,22,FMN GV 11 Ramsel
66,Bergstraat 71,2019-03-05,09:00:00,26,10,16,FMN GV 11 Ramsel
66,Bergstraat 71,2019-03-05,10:00:00,30,10,20,FMN GV 11 Ramsel
66,Bergstraat 71,2019-03-05,11:00:00,40,30,10,FMN GV 11 Ramsel
66,Bergstraat 71,2019-03-05,12:00:00,50,20,30,FMN GV 11 Ramsel
66,Bergstraat 71,2019-03-05,13:00:00,146,46,100,FMN GV 11 Ramsel
66,Bergstraat 71,2019-03-05,14:00:00,100,58,42,FMN GV 11 Ramsel
66,Bergstraat 71,2019-03-05,15:00:00,78,52,26,FMN GV 11 Ramsel
66,Bergstraat 71,2019-03-05,16:00:00,98,76,22,FMN GV 11 Ramsel
66,Bergstraat 71,2019-03-05,17:00:00,72,42,30,FMN GV 11 Ramsel
66,Bergstraat 71,2019-03-05,18:00:00,36,24,12,FMN GV 11 Ramsel
66,Bergstraat 71,2019-03-05,19:00:00,26,12,14,FMN GV 11 Ramsel
66,Bergstraat 71,2019-03-05,20:00:00,38,28,10,FMN GV 11 Ramsel
66,Bergstraat 71,2019-03-05,21:00:00,10,4,6,FMN GV 11 Ramsel
66,Bergstraat 71,2019-03-05,22:00:00,8,6,2,FMN GV 11 Ramsel
66,Bergstraat 71,2019-03-05,23:00:00,2,2,0,FMN GV 11 Ramsel
66,Bergstraat 71,2019-03-06,00:00:00,2,2,0,FMN GV 11 Ramsel
66,Bergstraat 71,2019-03-06,01:00:00,0,0,0,FMN GV 11 Ramsel
66,Bergstraat 71,2019-03-06,02:00:00,6,0,6,FMN GV 11 Ramsel
66,Bergstraat 71,2019-03-06,03:00:00,0,0,0,FMN GV 11 Ramsel
66,Bergstraat 71,2019-03-06,04:00:00,2,2,0,FMN GV 11 Ramsel
66,Bergstraat 71,2019-03-06,05:00:00,6,4,2,FMN GV 11 Ramsel
66,Bergstraat 71,2019-03-06,06:00:00,30,10,20,FMN GV 11 Ramsel
66,Bergstraat 71,2019-03-06,07:00:00,32,10,22,FMN GV 11 Ramsel
66,Bergstraat 71,2019-03-06,08:00:00,36,10,26,FMN GV 11 Ramsel
66,Bergstraat 71,2019-03-06,09:00:00,14,6,8,FMN GV 11 Ramsel
66,Bergstraat 71,2019-03-06,10:00:00,40,24,16,FMN GV 11 Ramsel
66,Bergstraat 71,2019-03-06,11:00:00,36,26,10,FMN GV 11 Ramsel
66,Bergstraat 71,2019-03-06,12:00:00,32,18,14,FMN GV 11 Ramsel
66,Bergstraat 71,2019-03-06,13:00:00,56,30,26,FMN GV 11 Ramsel
66,Bergstraat 71,2019-03-06,14:00:00,46,28,18,FMN GV 11 Ramsel
66,Bergstraat 71,2019-03-06,15:00:00,54,32,22,FMN GV 11 Ramsel
66,Bergstraat 71,2019-03-06,16:00:00,50,30,20,FMN GV 11 Ramsel
66,Bergstraat 71,2019-03-06,17:00:00,50,36,14,FMN GV 11 Ramsel
66,Bergstraat 71,2019-03-06,18:00:00,24,16,8,FMN GV 11 Ramsel
66,Bergstraat 71,2019-03-06,19:00:00,24,14,10,FMN GV 11 Ramsel
66,Bergstraat 71,2019-03-06,20:00:00,14,8,6,FMN GV 11 Ramsel
66,Bergstraat 71,2019-03-06,21:00:00,8,4,4,FMN GV 11 Ramsel
66,Bergstraat 71,2019-03-06,22:00:00,2,2,0,FMN GV 11 Ramsel
66,Bergstraat 71,2019-03-06,23:00:00,4,2,2,FMN GV 11 Ramsel
66,Bergstraat 71,2019-03-07,00:00:00,0,0,0,FMN GV 11 Ramsel
66,Bergstraat 71,2019-03-07,01:00:00,2,2,0,FMN GV 11 Ramsel
66,Bergstraat 71,2019-03-07,02:00:00,4,4,0,FMN GV 11 Ramsel
66,Bergstraat 71,2019-03-07,03:00:00,0,0,0,FMN GV 11 Ramsel
66,Bergstraat 71,2019-03-07,04:00:00,2,2,0,FMN GV 11 Ramsel
66,Bergstraat 71,2019-03-07,05:00:00,6,2,4,FMN GV 11 Ramsel
66,Bergstraat 71,2019-03-07,06:00:00,18,10,8,FMN GV 11 Ramsel
66,Bergstraat 71,2019-03-07,07:00:00,16,4,12,FMN GV 11 Ramsel
66,Bergstraat 71,2019-03-07,08:00:00,18,2,16,FMN GV 11 Ramsel
66,Bergstraat 71,2019-03-07,09:00:00,26,8,18,FMN GV 11 Ramsel
66,Bergstraat 71,2019-03-07,10:00:00,22,10,12,FMN GV 11 Ramsel
66,Bergstraat 71,2019-03-07,11:00:00,26,14,12,FMN GV 11 Ramsel
66,Bergstraat 71,2019-03-07,12:00:00,8,6,2,FMN GV 11 Ramsel
66,Bergstraat 71,2019-03-07,13:00:00,22,8,14,FMN GV 11 Ramsel
66,Bergstraat 71,2019-03-07,14:00:00,32,26,6,FMN GV 11 Ramsel
66,Bergstraat 71,2019-03-07,15:00:00,36,20,16,FMN GV 11 Ramsel
66,Bergstraat 71,2019-03-07,16:00:00,22,18,4,FMN GV 11 Ramsel
66,Bergstraat 71,2019-03-07,17:00:00,28,18,10,FMN GV 11 Ramsel
66,Bergstraat 71,2019-03-07,18:00:00,16,8,8,FMN GV 11 Ramsel
66,Bergstraat 71,2019-03-07,19:00:00,10,6,4,FMN GV 11 Ramsel
66,Bergstraat 71,2019-03-07,20:00:00,14,10,4,FMN GV 11 Ramsel
66,Bergstraat 71,2019-03-07,21:00:00,4,4,0,FMN GV 11 Ramsel
66,Bergstraat 71,2019-03-07,22:00:00,2,2,0,FMN GV 11 Ramsel
66,Bergstraat 71,2019-03-07,23:00:00,6,6,0,FMN GV 11 Ramsel
66,Bergstraat 71,2019-03-08,00:00:00,0,0,0,FMN GV 11 Ramsel
66,Bergstraat 71,2019-03-08,01:00:00,0,0,0,FMN GV 11 Ramsel
66,Bergstraat 71,2019-03-08,02:00:00,2,2,0,FMN GV 11 Ramsel
66,Bergstraat 71,2019-03-08,03:00:00,0,0,0,FMN GV 11 Ramsel
66,Bergstraat 71,2019-03-08,04:00:00,2,0,2,FMN GV 11 Ramsel
66,Bergstraat 71,2019-03-08,05:00:00,6,2,4,FMN GV 11 Ramsel
66,Bergstraat 71,2019-03-08,06:00:00,28,4,24,FMN GV 11 Ramsel
66,Bergstraat 71,2019-03-08,07:00:00,36,16,20,FMN GV 11 Ramsel
66,Bergstraat 71,2019-03-08,08:00:00,18,4,14,FMN GV 11 Ramsel
66,Bergstraat 71,2019-03-08,09:00:00,52,20,32,FMN GV 11 Ramsel
66,Bergstraat 71,2019-03-08,10:00:00,48,28,20,FMN GV 11 Ramsel
66,Bergstraat 71,2019-03-08,11:00:00,62,30,32,FMN GV 11 Ramsel
66,Bergstraat 71,2019-03-08,12:00:00,88,44,44,FMN GV 11 Ramsel
66,Bergstraat 71,2019-03-08,13:00:00,136,58,78,FMN GV 11 Ramsel
66,Bergstraat 71,2019-03-08,14:00:00,130,74,56,FMN GV 11 Ramsel
66,Bergstraat 71,2019-03-08,15:00:00,120,74,46,FMN GV 11 Ramsel
66,Bergstraat 71,2019-03-08,16:00:00,126,74,52,FMN GV 11 Ramsel
66,Bergstraat 71,2019-03-08,17:00:00,76,52,24,FMN GV 11 Ramsel
66,Bergstraat 71,2019-03-08,18:00:00,42,22,20,FMN GV 11 Ramsel
66,Bergstraat 71,2019-03-08,19:00:00,6,6,0,FMN GV 11 Ramsel
66,Bergstraat 71,2019-03-08,20:00:00,8,2,6,FMN GV 11 Ramsel
66,Bergstraat 71,2019-03-08,21:00:00,10,6,4,FMN GV 11 Ramsel
66,Bergstraat 71,2019-03-08,22:00:00,6,6,0,FMN GV 11 Ramsel
66,Bergstraat 71,2019-03-08,23:00:00,2,2,0,FMN GV 11 Ramsel
66,Bergstraat 71,2019-03-09,00:00:00,4,4,0,FMN GV 11 Ramsel
66,Bergstraat 71,2019-03-09,01:00:00,0,0,0,FMN GV 11 Ramsel
66,Bergstraat 71,2019-03-09,02:00:00,8,6,2,FMN GV 11 Ramsel
66,Bergstraat 71,2019-03-09,03:00:00,0,0,0,FMN GV 11 Ramsel
66,Bergstraat 71,2019-03-09,04:00:00,4,4,0,FMN GV 11 Ramsel
66,Bergstraat 71,2019-03-09,05:00:00,2,0,2,FMN GV 11 Ramsel
66,Bergstraat 71,2019-03-09,06:00:00,0,0,0,FMN GV 11 Ramsel
66,Bergstraat 71,2019-03-09,07:00:00,44,16,28,FMN GV 11 Ramsel
66,Bergstraat 71,2019-03-09,08:00:00,16,2,14,FMN GV 11 Ramsel
66,Bergstraat 71,2019-03-09,09:00:00,38,14,24,FMN GV 11 Ramsel
66,Bergstraat 71,2019-03-09,10:00:00,56,30,26,FMN GV 11 Ramsel
66,Bergstraat 71,2019-03-09,11:00:00,76,38,38,FMN GV 11 Ramsel
66,Bergstraat 71,2019-03-09,12:00:00,62,46,16,FMN GV 11 Ramsel
66,Bergstraat 71,2019-03-09,13:00:00,90,40,50,FMN GV 11 Ramsel
66,Bergstraat 71,2019-03-09,14:00:00,60,38,22,FMN GV 11 Ramsel
66,Bergstraat 71,2019-03-09,15:00:00,54,38,16,FMN GV 11 Ramsel
66,Bergstraat 71,2019-03-09,16:00:00,46,34,12,FMN GV 11 Ramsel
66,Bergstraat 71,2019-03-09,17:00:00,24,14,10,FMN GV 11 Ramsel
66,Bergstraat 71,2019-03-09,18:00:00,28,18,10,FMN GV 11 Ramsel
66,Bergstraat 71,2019-03-09,19:00:00,6,4,2,FMN GV 11 Ramsel
66,Bergstraat 71,2019-03-09,20:00:00,26,16,10,FMN GV 11 Ramsel
66,Bergstraat 71,2019-03-09,21:00:00,14,12,2,FMN GV 11 Ramsel
66,Bergstraat 71,2019-03-09,22:00:00,10,6,4,FMN GV 11 Ramsel
66,Bergstraat 71,2019-03-09,23:00:00,12,10,2,FMN GV 11 Ramsel
66,Bergstraat 71,2019-03-10,00:00:00,6,6,0,FMN GV 11 Ramsel
66,Bergstraat 71,2019-03-10,01:00:00,8,6,2,FMN GV 11 Ramsel
66,Bergstraat 71,2019-03-10,02:00:00,6,4,2,FMN GV 11 Ramsel
66,Bergstraat 71,2019-03-10,03:00:00,6,2,4,FMN GV 11 Ramsel
66,Bergstraat 71,2019-03-10,04:00:00,6,0,6,FMN GV 11 Ramsel
66,Bergstraat 71,2019-03-10,05:00:00,12,0,12,FMN GV 11 Ramsel
66,Bergstraat 71,2019-03-10,06:00:00,8,0,8,FMN GV 11 Ramsel
66,Bergstraat 71,2019-03-10,07:00:00,2,0,2,FMN GV 11 Ramsel
66,Bergstraat 71,2019-03-10,08:00:00,18,12,6,FMN GV 11 Ramsel
66,Bergstraat 71,2019-03-10,09:00:00,48,8,40,FMN GV 11 Ramsel
66,Bergstraat 71,2019-03-10,10:00:00,62,34,28,FMN GV 11 Ramsel
66,Bergstraat 71,2019-03-10,11:00:00,34,20,14,FMN GV 11 Ramsel
66,Bergstraat 71,2019-03-10,12:00:00,22,18,4,FMN GV 11 Ramsel
66,Bergstraat 71,2019-03-10,13:00:00,6,2,4,FMN GV 11 Ramsel
66,Bergstraat 71,2019-03-10,14:00:00,6,6,0,FMN GV 11 Ramsel
66,Bergstraat 71,2019-03-10,15:00:00,6,2,4,FMN GV 11 Ramsel
66,Bergstraat 71,2019-03-10,16:00:00,2,0,2,FMN GV 11 Ramsel
66,Bergstraat 71,2019-03-10,17:00:00,8,2,6,FMN GV 11 Ramsel
66,Bergstraat 71,2019-03-10,18:00:00,2,2,0,FMN GV 11 Ramsel
66,Bergstraat 71,2019-03-10,19:00:00,8,4,4,FMN GV 11 Ramsel
66,Bergstraat 71,2019-03-10,20:00:00,4,2,2,FMN GV 11 Ramsel
66,Bergstraat 71,2019-03-10,21:00:00,4,2,2,FMN GV 11 Ramsel
66,Bergstraat 71,2019-03-10,22:00:00,2,0,2,FMN GV 11 Ramsel
66,Bergstraat 71,2019-03-10,23:00:00,0,0,0,FMN GV 11 Ramsel
66,Bergstraat 71,2019-03-11,00:00:00,0,0,0,FMN GV 11 Ramsel
66,Bergstraat 71,2019-03-11,01:00:00,0,0,0,FMN GV 11 Ramsel
66,Bergstraat 71,2019-03-11,02:00:00,0,0,0,FMN GV 11 Ramsel
66,Bergstraat 71,2019-03-11,03:00:00,0,0,0,FMN GV 11 Ramsel
66,Bergstraat 71,2019-03-11,04:00:00,2,2,0,FMN GV 11 Ramsel
66,Bergstraat 71,2019-03-11,05:00:00,2,0,2,FMN GV 11 Ramsel
66,Bergstraat 71,2019-03-11,06:00:00,10,2,8,FMN GV 11 Ramsel
66,Bergstraat 71,2019-03-11,07:00:00,66,18,48,FMN GV 11 Ramsel
66,Bergstraat 71,2019-03-11,08:00:00,102,14,88,FMN GV 11 Ramsel
66,Bergstraat 71,2019-03-11,09:00:00,30,2,28,FMN GV 11 Ramsel
66,Bergstraat 71,2019-03-11,10:00:00,28,26,2,FMN GV 11 Ramsel
66,Bergstraat 71,2019-03-11,11:00:00,6,0,6,FMN GV 11 Ramsel
66,Bergstraat 71,2019-03-11,12:00:00,16,8,8,FMN GV 11 Ramsel
66,Bergstraat 71,2019-03-11,13:00:00,30,16,14,FMN GV 11 Ramsel
66,Bergstraat 71,2019-03-11,14:00:00,16,10,6,FMN GV 11 Ramsel
66,Bergstraat 71,2019-03-11,15:00:00,112,84,28,FMN GV 11 Ramsel
66,Bergstraat 71,2019-03-11,16:00:00,52,40,12,FMN GV 11 Ramsel
66,Bergstraat 71,2019-03-11,17:00:00,26,14,12,FMN GV 11 Ramsel
66,Bergstraat 71,2019-03-11,18:00:00,30,22,8,FMN GV 11 Ramsel
66,Bergstraat 71,2019-03-11,19:00:00,8,4,4,FMN GV 11 Ramsel
66,Bergstraat 71,2019-03-11,20:00:00,14,10,4,FMN GV 11 Ramsel
66,Bergstraat 71,2019-03-11,21:00:00,12,8,4,FMN GV 11 Ramsel
66,Bergstraat 71,2019-03-11,22:00:00,6,4,2,FMN GV 11 Ramsel
66,Bergstraat 71,2019-03-11,23:00:00,0,0,0,FMN GV 11 Ramsel
66,Bergstraat 71,2019-03-12,00:00:00,0,0,0,FMN GV 11 Ramsel
66,Bergstraat 71,2019-03-12,01:00:00,2,0,2,FMN GV 11 Ramsel
66,Bergstraat 71,2019-03-12,02:00:00,0,0,0,FMN GV 11 Ramsel
66,Bergstraat 71,2019-03-12,03:00:00,0,0,0,FMN GV 11 Ramsel
66,Bergstraat 71,2019-03-12,04:00:00,2,2,0,FMN GV 11 Ramsel
66,Bergstraat 71,2019-03-12,05:00:00,18,10,8,FMN GV 11 Ramsel
66,Bergstraat 71,2019-03-12,06:00:00,22,6,16,FMN GV 11 Ramsel
66,Bergstraat 71,2019-03-12,07:00:00,102,14,88,FMN GV 11 Ramsel
66,Bergstraat 71,2019-03-12,08:00:00,130,20,110,FMN GV 11 Ramsel
66,Bergstraat 71,2019-03-12,09:00:00,30,10,20,FMN GV 11 Ramsel
66,Bergstraat 71,2019-03-12,10:00:00,26,14,12,FMN GV 11 Ramsel
66,Bergstraat 71,2019-03-12,11:00:00,58,30,28,FMN GV 11 Ramsel
66,Bergstraat 71,2019-03-12,12:00:00,52,30,22,FMN GV 11 Ramsel
66,Bergstraat 71,2019-03-12,13:00:00,34,12,22,FMN GV 11 Ramsel
66,Bergstraat 71,2019-03-12,14:00:00,56,32,24,FMN GV 11 Ramsel
66,Bergstraat 71,2019-03-12,15:00:00,164,142,22,FMN GV 11 Ramsel
66,Bergstraat 71,2019-03-12,16:00:00,88,64,24,FMN GV 11 Ramsel
66,Bergstraat 71,2019-03-12,17:00:00,50,28,22,FMN GV 11 Ramsel
66,Bergstraat 71,2019-03-12,18:00:00,32,22,10,FMN GV 11 Ramsel
66,Bergstraat 71,2019-03-12,19:00:00,12,2,10,FMN GV 11 Ramsel
66,Bergstraat 71,2019-03-12,20:00:00,10,8,2,FMN GV 11 Ramsel
66,Bergstraat 71,2019-03-12,21:00:00,4,2,2,FMN GV 11 Ramsel
66,Bergstraat 71,2019-03-12,22:00:00,6,4,2,FMN GV 11 Ramsel
66,Bergstraat 71,2019-03-12,23:00:00,2,2,0,FMN GV 11 Ramsel
66,Bergstraat 71,2019-03-13,00:00:00,0,0,0,FMN GV 11 Ramsel
66,Bergstraat 71,2019-03-13,01:00:00,0,0,0,FMN GV 11 Ramsel
66,Bergstraat 71,2019-03-13,02:00:00,0,0,0,FMN GV 11 Ramsel
66,Bergstraat 71,2019-03-13,03:00:00,0,0,0,FMN GV 11 Ramsel
66,Bergstraat 71,2019-03-13,04:00:00,2,2,0,FMN GV 11 Ramsel
66,Bergstraat 71,2019-03-13,05:00:00,4,4,0,FMN GV 11 Ramsel
66,Bergstraat 71,2019-03-13,06:00:00,26,10,16,FMN GV 11 Ramsel
66,Bergstraat 71,2019-03-13,07:00:00,72,10,62,FMN GV 11 Ramsel
66,Bergstraat 71,2019-03-13,08:00:00,84,12,72,FMN GV 11 Ramsel
66,Bergstraat 71,2019-03-13,09:00:00,24,10,14,FMN GV 11 Ramsel
66,Bergstraat 71,2019-03-13,10:00:00,4,2,2,FMN GV 11 Ramsel
66,Bergstraat 71,2019-03-13,11:00:00,20,8,12,FMN GV 11 Ramsel
66,Bergstraat 71,2019-03-13,12:00:00,102,94,8,FMN GV 11 Ramsel
66,Bergstraat 71,2019-03-13,13:00:00,24,22,2,FMN GV 11 Ramsel
66,Bergstraat 71,2019-03-13,14:00:00,8,6,2,FMN GV 11 Ramsel
66,Bergstraat 71,2019-03-13,15:00:00,2,2,0,FMN GV 11 Ramsel
66,Bergstraat 71,2019-03-13,16:00:00,20,10,10,FMN GV 11 Ramsel
66,Bergstraat 71,2019-03-13,17:00:00,24,20,4,FMN GV 11 Ramsel
66,Bergstraat 71,2019-03-13,18:00:00,12,10,2,FMN GV 11 Ramsel
66,Bergstraat 71,2019-03-13,19:00:00,6,4,2,FMN GV 11 Ramsel
66,Bergstraat 71,2019-03-13,20:00:00,14,8,6,FMN GV 11 Ramsel
66,Bergstraat 71,2019-03-13,21:00:00,2,2,0,FMN GV 11 Ramsel
66,Bergstraat 71,2019-03-13,22:00:00,6,2,4,FMN GV 11 Ramsel
66,Bergstraat 71,2019-03-13,23:00:00,2,2,0,FMN GV 11 Ramsel
66,Bergstraat 71,2019-03-14,00:00:00,0,0,0,FMN GV 11 Ramsel
66,Bergstraat 71,2019-03-14,01:00:00,0,0,0,FMN GV 11 Ramsel
66,Bergstraat 71,2019-03-14,02:00:00,0,0,0,FMN GV 11 Ramsel
66,Bergstraat 71,2019-03-14,03:00:00,0,0,0,FMN GV 11 Ramsel
66,Bergstraat 71,2019-03-14,04:00:00,2,2,0,FMN GV 11 Ramsel
66,Bergstraat 71,2019-03-14,05:00:00,6,4,2,FMN GV 11 Ramsel
66,Bergstraat 71,2019-03-14,06:00:00,22,8,14,FMN GV 11 Ramsel
66,Bergstraat 71,2019-03-14,07:00:00,62,12,50,FMN GV 11 Ramsel
66,Bergstraat 71,2019-03-14,08:00:00,76,16,60,FMN GV 11 Ramsel
66,Bergstraat 71,2019-03-14,09:00:00,4,0,4,FMN GV 11 Ramsel
66,Bergstraat 71,2019-03-14,10:00:00,4,0,4,FMN GV 11 Ramsel
66,Bergstraat 71,2019-03-14,11:00:00,0,0,0,FMN GV 11 Ramsel
66,Bergstraat 71,2019-03-14,12:00:00,2,2,0,FMN GV 11 Ramsel
66,Bergstraat 71,2019-03-14,13:00:00,8,6,2,FMN GV 11 Ramsel
66,Bergstraat 71,2019-03-14,14:00:00,20,6,14,FMN GV 11 Ramsel
66,Bergstraat 71,2019-03-14,15:00:00,66,56,10,FMN GV 11 Ramsel
66,Bergstraat 71,2019-03-14,16:00:00,68,50,18,FMN GV 11 Ramsel
66,Bergstraat 71,2019-03-14,17:00:00,44,28,16,FMN GV 11 Ramsel
66,Bergstraat 71,2019-03-14,18:00:00,26,20,6,FMN GV 11 Ramsel
66,Bergstraat 71,2019-03-14,19:00:00,12,6,6,FMN GV 11 Ramsel
66,Bergstraat 71,2019-03-14,20:00:00,28,26,2,FMN GV 11 Ramsel
66,Bergstraat 71,2019-03-14,21:00:00,12,8,4,FMN GV 11 Ramsel
66,Bergstraat 71,2019-03-14,22:00:00,4,2,2,FMN GV 11 Ramsel
66,Bergstraat 71,2019-03-14,23:00:00,0,0,0,FMN GV 11 Ramsel
66,Bergstraat 71,2019-03-15,00:00:00,2,2,0,FMN GV 11 Ramsel
66,Bergstraat 71,2019-03-15,01:00:00,0,0,0,FMN GV 11 Ramsel
66,Bergstraat 71,2019-03-15,02:00:00,0,0,0,FMN GV 11 Ramsel
66,Bergstraat 71,2019-03-15,03:00:00,0,0,0,FMN GV 11 Ramsel
66,Bergstraat 71,2019-03-15,04:00:00,2,2,0,FMN GV 11 Ramsel
66,Bergstraat 71,2019-03-15,05:00:00,2,0,2,FMN GV 11 Ramsel
66,Bergstraat 71,2019-03-15,06:00:00,10,2,8,FMN GV 11 Ramsel
66,Bergstraat 71,2019-03-15,07:00:00,52,0,52,FMN GV 11 Ramsel
66,Bergstraat 71,2019-03-15,08:00:00,62,8,54,FMN GV 11 Ramsel
66,Bergstraat 71,2019-03-15,09:00:00,6,4,2,FMN GV 11 Ramsel
66,Bergstraat 71,2019-03-15,10:00:00,2,2,0,FMN GV 11 Ramsel
66,Bergstraat 71,2019-03-15,11:00:00,12,2,10,FMN GV 11 Ramsel
66,Bergstraat 71,2019-03-15,12:00:00,20,12,8,FMN GV 11 Ramsel
66,Bergstraat 71,2019-03-15,13:00:00,16,12,4,FMN GV 11 Ramsel
66,Bergstraat 71,2019-03-15,14:00:00,36,20,16,FMN GV 11 Ramsel
66,Bergstraat 71,2019-03-15,15:00:00,88,68,20,FMN GV 11 Ramsel
66,Bergstraat 71,2019-03-15,16:00:00,42,38,4,FMN GV 11 Ramsel
66,Bergstraat 71,2019-03-15,17:00:00,30,18,12,FMN GV 11 Ramsel
66,Bergstraat 71,2019-03-15,18:00:00,8,6,2,FMN GV 11 Ramsel
66,Bergstraat 71,2019-03-15,19:00:00,6,4,2,FMN GV 11 Ramsel
66,Bergstraat 71,2019-03-15,20:00:00,16,4,12,FMN GV 11 Ramsel
66,Bergstraat 71,2019-03-15,21:00:00,0,0,0,FMN GV 11 Ramsel
66,Bergstraat 71,2019-03-15,22:00:00,6,0,6,FMN GV 11 Ramsel
66,Bergstraat 71,2019-03-15,23:00:00,6,4,2,FMN GV 11 Ramsel
66,Bergstraat 71,2019-03-16,00:00:00,0,0,0,FMN GV 11 Ramsel
66,Bergstraat 71,2019-03-16,01:00:00,0,0,0,FMN GV 11 Ramsel
66,Bergstraat 71,2019-03-16,02:00:00,6,4,2,FMN GV 11 Ramsel
66,Bergstraat 71,2019-03-16,03:00:00,8,6,2,FMN GV 11 Ramsel
66,Bergstraat 71,2019-03-16,04:00:00,0,0,0,FMN GV 11 Ramsel
66,Bergstraat 71,2019-03-16,05:00:00,0,0,0,FMN GV 11 Ramsel
66,Bergstraat 71,2019-03-16,06:00:00,4,0,4,FMN GV 11 Ramsel
66,Bergstraat 71,2019-03-16,07:00:00,2,0,2,FMN GV 11 Ramsel
66,Bergstraat 71,2019-03-16,08:00:00,10,2,8,FMN GV 11 Ramsel
66,Bergstraat 71,2019-03-16,09:00:00,30,10,20,FMN GV 11 Ramsel
66,Bergstraat 71,2019-03-16,10:00:00,62,26,36,FMN GV 11 Ramsel
66,Bergstraat 71,2019-03-16,11:00:00,62,26,36,FMN GV 11 Ramsel
66,Bergstraat 71,2019-03-16,12:00:00,70,28,42,FMN GV 11 Ramsel
66,Bergstraat 71,2019-03-16,13:00:00,72,34,38,FMN GV 11 Ramsel
66,Bergstraat 71,2019-03-16,14:00:00,72,46,26,FMN GV 11 Ramsel
66,Bergstraat 71,2019-03-16,15:00:00,96,68,28,FMN GV 11 Ramsel
66,Bergstraat 71,2019-03-16,16:00:00,78,64,14,FMN GV 11 Ramsel
66,Bergstraat 71,2019-03-16,17:00:00,28,14,14,FMN GV 11 Ramsel
66,Bergstraat 71,2019-03-16,18:00:00,12,6,6,FMN GV 11 Ramsel
66,Bergstraat 71,2019-03-16,19:00:00,14,2,12,FMN GV 11 Ramsel
66,Bergstraat 71,2019-03-16,20:00:00,6,4,2,FMN GV 11 Ramsel
66,Bergstraat 71,2019-03-16,21:00:00,10,2,8,FMN GV 11 Ramsel
66,Bergstraat 71,2019-03-16,22:00:00,10,4,6,FMN GV 11 Ramsel
66,Bergstraat 71,2019-03-16,23:00:00,10,4,6,FMN GV 11 Ramsel
66,Bergstraat 71,2019-03-17,00:00:00,4,4,0,FMN GV 11 Ramsel
66,Bergstraat 71,2019-03-17,01:00:00,2,0,2,FMN GV 11 Ramsel
66,Bergstraat 71,2019-03-17,02:00:00,0,0,0,FMN GV 11 Ramsel
66,Bergstraat 71,2019-03-17,03:00:00,4,2,2,FMN GV 11 Ramsel
66,Bergstraat 71,2019-03-17,04:00:00,2,2,0,FMN GV 11 Ramsel
66,Bergstraat 71,2019-03-17,05:00:00,0,0,0,FMN GV 11 Ramsel
66,Bergstraat 71,2019-03-17,06:00:00,0,0,0,FMN GV 11 Ramsel
66,Bergstraat 71,2019-03-17,07:00:00,4,2,2,FMN GV 11 Ramsel
66,Bergstraat 71,2019-03-17,08:00:00,34,16,18,FMN GV 11 Ramsel
66,Bergstraat 71,2019-03-17,09:00:00,72,28,44,FMN GV 11 Ramsel
66,Bergstraat 71,2019-03-17,10:00:00,108,50,58,FMN GV 11 Ramsel
66,Bergstraat 71,2019-03-17,11:00:00,76,56,20,FMN GV 11 Ramsel
66,Bergstraat 71,2019-03-17,12:00:00,54,34,20,FMN GV 11 Ramsel
66,Bergstraat 71,2019-03-17,13:00:00,50,26,24,FMN GV 11 Ramsel
66,Bergstraat 71,2019-03-17,14:00:00,8,6,2,FMN GV 11 Ramsel
66,Bergstraat 71,2019-03-17,15:00:00,14,8,6,FMN GV 11 Ramsel
66,Bergstraat 71,2019-03-17,16:00:00,30,26,4,FMN GV 11 Ramsel
66,Bergstraat 71,2019-03-17,17:00:00,0,0,0,FMN GV 11 Ramsel
66,Bergstraat 71,2019-03-17,18:00:00,8,0,8,FMN GV 11 Ramsel
66,Bergstraat 71,2019-03-17,19:00:00,6,4,2,FMN GV 11 Ramsel
66,Bergstraat 71,2019-03-17,20:00:00,10,6,4,FMN GV 11 Ramsel
66,Bergstraat 71,2019-03-17,21:00:00,2,0,2,FMN GV 11 Ramsel
66,Bergstraat 71,2019-03-17,22:00:00,4,4,0,FMN GV 11 Ramsel
66,Bergstraat 71,2019-03-17,23:00:00,2,2,0,FMN GV 11 Ramsel
66,Bergstraat 71,2019-03-18,00:00:00,0,0,0,FMN GV 11 Ramsel
66,Bergstraat 71,2019-03-18,01:00:00,0,0,0,FMN GV 11 Ramsel
66,Bergstraat 71,2019-03-18,02:00:00,0,0,0,FMN GV 11 Ramsel
66,Bergstraat 71,2019-03-18,03:00:00,0,0,0,FMN GV 11 Ramsel
66,Bergstraat 71,2019-03-18,04:00:00,2,2,0,FMN GV 11 Ramsel
66,Bergstraat 71,2019-03-18,05:00:00,4,4,0,FMN GV 11 Ramsel
66,Bergstraat 71,2019-03-18,06:00:00,44,12,32,FMN GV 11 Ramsel
66,Bergstraat 71,2019-03-18,07:00:00,132,28,104,FMN GV 11 Ramsel
66,Bergstraat 71,2019-03-18,08:00:00,150,30,120,FMN GV 11 Ramsel
66,Bergstraat 71,2019-03-18,09:00:00,52,16,36,FMN GV 11 Ramsel
66,Bergstraat 71,2019-03-18,10:00:00,54,28,26,FMN GV 11 Ramsel
66,Bergstraat 71,2019-03-18,11:00:00,42,18,24,FMN GV 11 Ramsel
66,Bergstraat 71,2019-03-18,12:00:00,38,20,18,FMN GV 11 Ramsel
66,Bergstraat 71,2019-03-18,13:00:00,50,24,26,FMN GV 11 Ramsel
66,Bergstraat 71,2019-03-18,14:00:00,92,28,64,FMN GV 11 Ramsel
66,Bergstraat 71,2019-03-18,15:00:00,182,142,40,FMN GV 11 Ramsel
66,Bergstraat 71,2019-03-18,16:00:00,112,92,20,FMN GV 11 Ramsel
66,Bergstraat 71,2019-03-18,17:00:00,76,56,20,FMN GV 11 Ramsel
66,Bergstraat 71,2019-03-18,18:00:00,66,40,26,FMN GV 11 Ramsel
66,Bergstraat 71,2019-03-18,19:00:00,24,10,14,FMN GV 11 Ramsel
66,Bergstraat 71,2019-03-18,20:00:00,14,10,4,FMN GV 11 Ramsel
66,Bergstraat 71,2019-03-18,21:00:00,8,6,2,FMN GV 11 Ramsel
66,Bergstraat 71,2019-03-18,22:00:00,4,4,0,FMN GV 11 Ramsel
66,Bergstraat 71,2019-03-18,23:00:00,6,6,0,FMN GV 11 Ramsel
66,Bergstraat 71,2019-03-19,00:00:00,0,0,0,FMN GV 11 Ramsel
66,Bergstraat 71,2019-03-19,01:00:00,0,0,0,FMN GV 11 Ramsel
66,Bergstraat 71,2019-03-19,02:00:00,0,0,0,FMN GV 11 Ramsel
66,Bergstraat 71,2019-03-19,03:00:00,0,0,0,FMN GV 11 Ramsel
66,Bergstraat 71,2019-03-19,04:00:00,8,4,4,FMN GV 11 Ramsel
66,Bergstraat 71,2019-03-19,05:00:00,8,4,4,FMN GV 11 Ramsel
66,Bergstraat 71,2019-03-19,06:00:00,40,8,32,FMN GV 11 Ramsel
66,Bergstraat 71,2019-03-19,07:00:00,158,28,130,FMN GV 11 Ramsel
66,Bergstraat 71,2019-03-19,08:00:00,172,26,146,FMN GV 11 Ramsel
66,Bergstraat 71,2019-03-19,09:00:00,64,28,36,FMN GV 11 Ramsel
66,Bergstraat 71,2019-03-19,10:00:00,62,28,34,FMN GV 11 Ramsel
66,Bergstraat 71,2019-03-19,11:00:00,54,22,32,FMN GV 11 Ramsel
66,Bergstraat 71,2019-03-19,12:00:00,92,48,44,FMN GV 11 Ramsel
66,Bergstraat 71,2019-03-19,13:00:00,162,82,80,FMN GV 11 Ramsel
66,Bergstraat 71,2019-03-19,14:00:00,174,100,74,FMN GV 11 Ramsel
66,Bergstraat 71,2019-03-19,15:00:00,234,172,62,FMN GV 11 Ramsel
66,Bergstraat 71,2019-03-19,16:00:00,224,164,60,FMN GV 11 Ramsel
66,Bergstraat 71,2019-03-19,17:00:00,142,84,58,FMN GV 11 Ramsel
66,Bergstraat 71,2019-03-19,18:00:00,76,54,22,FMN GV 11 Ramsel
66,Bergstraat 71,2019-03-19,19:00:00,54,22,32,FMN GV 11 Ramsel
66,Bergstraat 71,2019-03-19,20:00:00,32,20,12,FMN GV 11 Ramsel
66,Bergstraat 71,2019-03-19,21:00:00,18,14,4,FMN GV 11 Ramsel
66,Bergstraat 71,2019-03-19,22:00:00,10,6,4,FMN GV 11 Ramsel
66,Bergstraat 71,2019-03-19,23:00:00,8,4,4,FMN GV 11 Ramsel
66,Bergstraat 71,2019-03-20,00:00:00,0,0,0,FMN GV 11 Ramsel
66,Bergstraat 71,2019-03-20,01:00:00,0,0,0,FMN GV 11 Ramsel
66,Bergstraat 71,2019-03-20,02:00:00,0,0,0,FMN GV 11 Ramsel
66,Bergstraat 71,2019-03-20,03:00:00,0,0,0,FMN GV 11 Ramsel
66,Bergstraat 71,2019-03-20,04:00:00,4,4,0,FMN GV 11 Ramsel
66,Bergstraat 71,2019-03-20,05:00:00,10,2,8,FMN GV 11 Ramsel
66,Bergstraat 71,2019-03-20,06:00:00,44,16,28,FMN GV 11 Ramsel
66,Bergstraat 71,2019-03-20,07:00:00,100,14,86,FMN GV 11 Ramsel
66,Bergstraat 71,2019-03-20,08:00:00,90,20,70,FMN GV 11 Ramsel
66,Bergstraat 71,2019-03-20,09:00:00,68,24,44,FMN GV 11 Ramsel
66,Bergstraat 71,2019-03-20,10:00:00,82,40,42,FMN GV 11 Ramsel
66,Bergstraat 71,2019-03-20,11:00:00,80,32,48,FMN GV 11 Ramsel
66,Bergstraat 71,2019-03-20,12:00:00,126,86,40,FMN GV 11 Ramsel
66,Bergstraat 71,2019-03-20,13:00:00,164,68,96,FMN GV 11 Ramsel
66,Bergstraat 71,2019-03-20,14:00:00,154,74,80,FMN GV 11 Ramsel
66,Bergstraat 71,2019-03-20,15:00:00,110,76,34,FMN GV 11 Ramsel
66,Bergstraat 71,2019-03-20,16:00:00,108,68,40,FMN GV 11 Ramsel
66,Bergstraat 71,2019-03-20,17:00:00,100,58,42,FMN GV 11 Ramsel
66,Bergstraat 71,2019-03-20,18:00:00,70,40,30,FMN GV 11 Ramsel
66,Bergstraat 71,2019-03-20,19:00:00,46,36,10,FMN GV 11 Ramsel
66,Bergstraat 71,2019-03-20,20:00:00,20,14,6,FMN GV 11 Ramsel
66,Bergstraat 71,2019-03-20,21:00:00,6,2,4,FMN GV 11 Ramsel
66,Bergstraat 71,2019-03-20,22:00:00,8,6,2,FMN GV 11 Ramsel
66,Bergstraat 71,2019-03-20,23:00:00,4,4,0,FMN GV 11 Ramsel
66,Bergstraat 71,2019-03-21,00:00:00,4,2,2,FMN GV 11 Ramsel
66,Bergstraat 71,2019-03-21,01:00:00,0,0,0,FMN GV 11 Ramsel
66,Bergstraat 71,2019-03-21,02:00:00,0,0,0,FMN GV 11 Ramsel
66,Bergstraat 71,2019-03-21,03:00:00,0,0,0,FMN GV 11 Ramsel
66,Bergstraat 71,2019-03-21,04:00:00,4,4,0,FMN GV 11 Ramsel
66,Bergstraat 71,2019-03-21,05:00:00,6,4,2,FMN GV 11 Ramsel
66,Bergstraat 71,2019-03-21,06:00:00,46,16,30,FMN GV 11 Ramsel
66,Bergstraat 71,2019-03-21,07:00:00,168,18,150,FMN GV 11 Ramsel
66,Bergstraat 71,2019-03-21,08:00:00,188,34,154,FMN GV 11 Ramsel
66,Bergstraat 71,2019-03-21,09:00:00,54,14,40,FMN GV 11 Ramsel
66,Bergstraat 71,2019-03-21,10:00:00,72,22,50,FMN GV 11 Ramsel
66,Bergstraat 71,2019-03-21,11:00:00,58,24,34,FMN GV 11 Ramsel
66,Bergstraat 71,2019-03-21,12:00:00,106,40,66,FMN GV 11 Ramsel
66,Bergstraat 71,2019-03-21,13:00:00,180,104,76,FMN GV 11 Ramsel
66,Bergstraat 71,2019-03-21,14:00:00,166,98,68,FMN GV 11 Ramsel
66,Bergstraat 71,2019-03-21,15:00:00,300,256,44,FMN GV 11 Ramsel
66,Bergstraat 71,2019-03-21,16:00:00,208,138,70,FMN GV 11 Ramsel
66,Bergstraat 71,2019-03-21,17:00:00,162,90,72,FMN GV 11 Ramsel
66,Bergstraat 71,2019-03-21,18:00:00,90,70,20,FMN GV 11 Ramsel
66,Bergstraat 71,2019-03-21,19:00:00,54,30,24,FMN GV 11 Ramsel
66,Bergstraat 71,2019-03-21,20:00:00,18,6,12,FMN GV 11 Ramsel
66,Bergstraat 71,2019-03-21,21:00:00,14,10,4,FMN GV 11 Ramsel
66,Bergstraat 71,2019-03-21,22:00:00,8,6,2,FMN GV 11 Ramsel
66,Bergstraat 71,2019-03-21,23:00:00,6,6,0,FMN GV 11 Ramsel
66,Bergstraat 71,2019-03-22,00:00:00,2,2,0,FMN GV 11 Ramsel
66,Bergstraat 71,2019-03-22,01:00:00,0,0,0,FMN GV 11 Ramsel
66,Bergstraat 71,2019-03-22,02:00:00,0,0,0,FMN GV 11 Ramsel
66,Bergstraat 71,2019-03-22,03:00:00,2,2,0,FMN GV 11 Ramsel
66,Bergstraat 71,2019-03-22,04:00:00,2,2,0,FMN GV 11 Ramsel
66,Bergstraat 71,2019-03-22,05:00:00,10,2,8,FMN GV 11 Ramsel
66,Bergstraat 71,2019-03-22,06:00:00,52,10,42,FMN GV 11 Ramsel
66,Bergstraat 71,2019-03-22,07:00:00,174,28,146,FMN GV 11 Ramsel
66,Bergstraat 71,2019-03-22,08:00:00,214,26,188,FMN GV 11 Ramsel
66,Bergstraat 71,2019-03-22,09:00:00,24,12,12,FMN GV 11 Ramsel
66,Bergstraat 71,2019-03-22,10:00:00,54,20,34,FMN GV 11 Ramsel
66,Bergstraat 71,2019-03-22,11:00:00,78,28,50,FMN GV 11 Ramsel
66,Bergstraat 71,2019-03-22,12:00:00,124,68,56,FMN GV 11 Ramsel
66,Bergstraat 71,2019-03-22,13:00:00,236,120,116,FMN GV 11 Ramsel
66,Bergstraat 71,2019-03-22,14:00:00,214,90,124,FMN GV 11 Ramsel
66,Bergstraat 71,2019-03-22,15:00:00,372,272,100,FMN GV 11 Ramsel
66,Bergstraat 71,2019-03-22,16:00:00,256,170,86,FMN GV 11 Ramsel
66,Bergstraat 71,2019-03-22,17:00:00,142,96,46,FMN GV 11 Ramsel
66,Bergstraat 71,2019-03-22,18:00:00,98,62,36,FMN GV 11 Ramsel
66,Bergstraat 71,2019-03-22,19:00:00,34,18,16,FMN GV 11 Ramsel
66,Bergstraat 71,2019-03-22,20:00:00,22,12,10,FMN GV 11 Ramsel
66,Bergstraat 71,2019-03-22,21:00:00,12,4,8,FMN GV 11 Ramsel
66,Bergstraat 71,2019-03-22,22:00:00,14,6,8,FMN GV 11 Ramsel
66,Bergstraat 71,2019-03-22,23:00:00,6,2,4,FMN GV 11 Ramsel
66,Bergstraat 71,2019-03-23,00:00:00,6,4,2,FMN GV 11 Ramsel
66,Bergstraat 71,2019-03-23,01:00:00,2,0,2,FMN GV 11 Ramsel
66,Bergstraat 71,2019-03-23,02:00:00,6,6,0,FMN GV 11 Ramsel
66,Bergstraat 71,2019-03-23,03:00:00,8,8,0,FMN GV 11 Ramsel
66,Bergstraat 71,2019-03-23,04:00:00,4,4,0,FMN GV 11 Ramsel
66,Bergstraat 71,2019-03-23,05:00:00,4,0,4,FMN GV 11 Ramsel
66,Bergstraat 71,2019-03-23,06:00:00,2,0,2,FMN GV 11 Ramsel
66,Bergstraat 71,2019-03-23,07:00:00,12,4,8,FMN GV 11 Ramsel
66,Bergstraat 71,2019-03-23,08:00:00,36,12,24,FMN GV 11 Ramsel
66,Bergstraat 71,2019-03-23,09:00:00,56,16,40,FMN GV 11 Ramsel
66,Bergstraat 71,2019-03-23,10:00:00,114,38,76,FMN GV 11 Ramsel
66,Bergstraat 71,2019-03-23,11:00:00,102,50,52,FMN GV 11 Ramsel
66,Bergstraat 71,2019-03-23,12:00:00,58,32,26,FMN GV 11 Ramsel
66,Bergstraat 71,2019-03-23,13:00:00,88,40,48,FMN GV 11 Ramsel
66,Bergstraat 71,2019-03-23,14:00:00,124,52,72,FMN GV 11 Ramsel
66,Bergstraat 71,2019-03-23,15:00:00,112,74,38,FMN GV 11 Ramsel
66,Bergstraat 71,2019-03-23,16:00:00,42,20,22,FMN GV 11 Ramsel
66,Bergstraat 71,2019-03-23,17:00:00,54,40,14,FMN GV 11 Ramsel
66,Bergstraat 71,2019-03-23,18:00:00,16,12,4,FMN GV 11 Ramsel
66,Bergstraat 71,2019-03-23,19:00:00,18,4,14,FMN GV 11 Ramsel
66,Bergstraat 71,2019-03-23,20:00:00,16,4,12,FMN GV 11 Ramsel
66,Bergstraat 71,2019-03-23,21:00:00,8,4,4,FMN GV 11 Ramsel
66,Bergstraat 71,2019-03-23,22:00:00,14,10,4,FMN GV 11 Ramsel
66,Bergstraat 71,2019-03-23,23:00:00,4,4,0,FMN GV 11 Ramsel
66,Bergstraat 71,2019-03-24,00:00:00,6,4,2,FMN GV 11 Ramsel
66,Bergstraat 71,2019-03-24,01:00:00,6,2,4,FMN GV 11 Ramsel
66,Bergstraat 71,2019-03-24,02:00:00,4,2,2,FMN GV 11 Ramsel
66,Bergstraat 71,2019-03-24,03:00:00,2,0,2,FMN GV 11 Ramsel
66,Bergstraat 71,2019-03-24,04:00:00,0,0,0,FMN GV 11 Ramsel
66,Bergstraat 71,2019-03-24,05:00:00,0,0,0,FMN GV 11 Ramsel
66,Bergstraat 71,2019-03-24,06:00:00,2,0,2,FMN GV 11 Ramsel
66,Bergstraat 71,2019-03-24,07:00:00,36,10,26,FMN GV 11 Ramsel
66,Bergstraat 71,2019-03-24,08:00:00,94,20,74,FMN GV 11 Ramsel
66,Bergstraat 71,2019-03-24,09:00:00,130,48,82,FMN GV 11 Ramsel
66,Bergstraat 71,2019-03-24,10:00:00,206,112,94,FMN GV 11 Ramsel
66,Bergstraat 71,2019-03-24,11:00:00,214,164,50,FMN GV 11 Ramsel
66,Bergstraat 71,2019-03-24,12:00:00,202,92,110,FMN GV 11 Ramsel
66,Bergstraat 71,2019-03-24,13:00:00,182,88,94,FMN GV 11 Ramsel
66,Bergstraat 71,2019-03-24,14:00:00,292,132,160,FMN GV 11 Ramsel
66,Bergstraat 71,2019-03-24,15:00:00,194,94,100,FMN GV 11 Ramsel
66,Bergstraat 71,2019-03-24,16:00:00,164,106,58,FMN GV 11 Ramsel
66,Bergstraat 71,2019-03-24,17:00:00,82,46,36,FMN GV 11 Ramsel
66,Bergstraat 71,2019-03-24,18:00:00,46,26,20,FMN GV 11 Ramsel
66,Bergstraat 71,2019-03-24,19:00:00,14,12,2,FMN GV 11 Ramsel
66,Bergstraat 71,2019-03-24,20:00:00,4,2,2,FMN GV 11 Ramsel
66,Bergstraat 71,2019-03-24,21:00:00,10,10,0,FMN GV 11 Ramsel
66,Bergstraat 71,2019-03-24,22:00:00,2,2,0,FMN GV 11 Ramsel
66,Bergstraat 71,2019-03-24,23:00:00,6,4,2,FMN GV 11 Ramsel
66,Bergstraat 71,2019-03-25,00:00:00,6,6,0,FMN GV 11 Ramsel
66,Bergstraat 71,2019-03-25,01:00:00,0,0,0,FMN GV 11 Ramsel
66,Bergstraat 71,2019-03-25,02:00:00,0,0,0,FMN GV 11 Ramsel
66,Bergstraat 71,2019-03-25,03:00:00,0,0,0,FMN GV 11 Ramsel
66,Bergstraat 71,2019-03-25,04:00:00,2,2,0,FMN GV 11 Ramsel
66,Bergstraat 71,2019-03-25,05:00:00,6,0,6,FMN GV 11 Ramsel
66,Bergstraat 71,2019-03-25,06:00:00,42,8,34,FMN GV 11 Ramsel
66,Bergstraat 71,2019-03-25,07:00:00,130,18,112,FMN GV 11 Ramsel
66,Bergstraat 71,2019-03-25,08:00:00,174,32,142,FMN GV 11 Ramsel
66,Bergstraat 71,2019-03-25,09:00:00,48,16,32,FMN GV 11 Ramsel
66,Bergstraat 71,2019-03-25,10:00:00,30,24,6,FMN GV 11 Ramsel
66,Bergstraat 71,2019-03-25,11:00:00,16,4,12,FMN GV 11 Ramsel
66,Bergstraat 71,2019-03-25,12:00:00,30,24,6,FMN GV 11 Ramsel
66,Bergstraat 71,2019-03-25,13:00:00,40,28,12,FMN GV 11 Ramsel
66,Bergstraat 71,2019-03-25,14:00:00,36,24,12,FMN GV 11 Ramsel
66,Bergstraat 71,2019-03-25,15:00:00,160,148,12,FMN GV 11 Ramsel
66,Bergstraat 71,2019-03-25,16:00:00,118,94,24,FMN GV 11 Ramsel
66,Bergstraat 71,2019-03-25,17:00:00,62,44,18,FMN GV 11 Ramsel
66,Bergstraat 71,2019-03-25,18:00:00,44,28,16,FMN GV 11 Ramsel
66,Bergstraat 71,2019-03-25,19:00:00,10,6,4,FMN GV 11 Ramsel
66,Bergstraat 71,2019-03-25,20:00:00,20,10,10,FMN GV 11 Ramsel
66,Bergstraat 71,2019-03-25,21:00:00,10,2,8,FMN GV 11 Ramsel
66,Bergstraat 71,2019-03-25,22:00:00,6,4,2,FMN GV 11 Ramsel
66,Bergstraat 71,2019-03-25,23:00:00,0,0,0,FMN GV 11 Ramsel
66,Bergstraat 71,2019-03-26,00:00:00,2,2,0,FMN GV 11 Ramsel
66,Bergstraat 71,2019-03-26,01:00:00,0,0,0,FMN GV 11 Ramsel
66,Bergstraat 71,2019-03-26,02:00:00,0,0,0,FMN GV 11 Ramsel
66,Bergstraat 71,2019-03-26,03:00:00,0,0,0,FMN GV 11 Ramsel
66,Bergstraat 71,2019-03-26,04:00:00,4,0,4,FMN GV 11 Ramsel
66,Bergstraat 71,2019-03-26,05:00:00,10,2,8,FMN GV 11 Ramsel
66,Bergstraat 71,2019-03-26,06:00:00,64,12,52,FMN GV 11 Ramsel
66,Bergstraat 71,2019-03-26,07:00:00,156,18,138,FMN GV 11 Ramsel
66,Bergstraat 71,2019-03-26,08:00:00,162,36,126,FMN GV 11 Ramsel
66,Bergstraat 71,2019-03-26,09:00:00,44,20,24,FMN GV 11 Ramsel
66,Bergstraat 71,2019-03-26,10:00:00,52,24,28,FMN GV 11 Ramsel
66,Bergstraat 71,2019-03-26,11:00:00,34,14,20,FMN GV 11 Ramsel
66,Bergstraat 71,2019-03-26,12:00:00,102,84,18,FMN GV 11 Ramsel
66,Bergstraat 71,2019-03-26,13:00:00,136,72,64,FMN GV 11 Ramsel
66,Bergstraat 71,2019-03-26,14:00:00,84,48,36,FMN GV 11 Ramsel
66,Bergstraat 71,2019-03-26,15:00:00,186,146,40,FMN GV 11 Ramsel
66,Bergstraat 71,2019-03-26,16:00:00,166,134,32,FMN GV 11 Ramsel
66,Bergstraat 71,2019-03-26,17:00:00,110,58,52,FMN GV 11 Ramsel
66,Bergstraat 71,2019-03-26,18:00:00,76,56,20,FMN GV 11 Ramsel
66,Bergstraat 71,2019-03-26,19:00:00,80,28,52,FMN GV 11 Ramsel
66,Bergstraat 71,2019-03-26,20:00:00,26,22,4,FMN GV 11 Ramsel
66,Bergstraat 71,2019-03-26,21:00:00,18,10,8,FMN GV 11 Ramsel
66,Bergstraat 71,2019-03-26,22:00:00,20,14,6,FMN GV 11 Ramsel
66,Bergstraat 71,2019-03-26,23:00:00,2,2,0,FMN GV 11 Ramsel
66,Bergstraat 71,2019-03-27,00:00:00,0,0,0,FMN GV 11 Ramsel
66,Bergstraat 71,2019-03-27,01:00:00,0,0,0,FMN GV 11 Ramsel
66,Bergstraat 71,2019-03-27,02:00:00,0,0,0,FMN GV 11 Ramsel
66,Bergstraat 71,2019-03-27,03:00:00,4,0,4,FMN GV 11 Ramsel
66,Bergstraat 71,2019-03-27,04:00:00,2,2,0,FMN GV 11 Ramsel
66,Bergstraat 71,2019-03-27,05:00:00,6,2,4,FMN GV 11 Ramsel
66,Bergstraat 71,2019-03-27,06:00:00,22,6,16,FMN GV 11 Ramsel
66,Bergstraat 71,2019-03-27,07:00:00,146,20,126,FMN GV 11 Ramsel
66,Bergstraat 71,2019-03-27,08:00:00,180,30,150,FMN GV 11 Ramsel
66,Bergstraat 71,2019-03-27,09:00:00,50,26,24,FMN GV 11 Ramsel
66,Bergstraat 71,2019-03-27,10:00:00,90,48,42,FMN GV 11 Ramsel
66,Bergstraat 71,2019-03-27,11:00:00,56,26,30,FMN GV 11 Ramsel
66,Bergstraat 71,2019-03-27,12:00:00,262,216,46,FMN GV 11 Ramsel
66,Bergstraat 71,2019-03-27,13:00:00,96,52,44,FMN GV 11 Ramsel
66,Bergstraat 71,2019-03-27,14:00:00,106,50,56,FMN GV 11 Ramsel
66,Bergstraat 71,2019-03-27,15:00:00,106,66,40,FMN GV 11 Ramsel
66,Bergstraat 71,2019-03-27,16:00:00,100,66,34,FMN GV 11 Ramsel
66,Bergstraat 71,2019-03-27,17:00:00,94,64,30,FMN GV 11 Ramsel
66,Bergstraat 71,2019-03-27,18:00:00,58,36,22,FMN GV 11 Ramsel
66,Bergstraat 71,2019-03-27,19:00:00,32,16,16,FMN GV 11 Ramsel
66,Bergstraat 71,2019-03-27,20:00:00,18,12,6,FMN GV 11 Ramsel
66,Bergstraat 71,2019-03-27,21:00:00,24,18,6,FMN GV 11 Ramsel
66,Bergstraat 71,2019-03-27,22:00:00,4,4,0,FMN GV 11 Ramsel
66,Bergstraat 71,2019-03-27,23:00:00,2,2,0,FMN GV 11 Ramsel
66,Bergstraat 71,2019-03-28,00:00:00,4,0,4,FMN GV 11 Ramsel
66,Bergstraat 71,2019-03-28,01:00:00,2,2,0,FMN GV 11 Ramsel
66,Bergstraat 71,2019-03-28,02:00:00,0,0,0,FMN GV 11 Ramsel
66,Bergstraat 71,2019-03-28,03:00:00,0,0,0,FMN GV 11 Ramsel
66,Bergstraat 71,2019-03-28,04:00:00,2,2,0,FMN GV 11 Ramsel
66,Bergstraat 71,2019-03-28,05:00:00,8,4,4,FMN GV 11 Ramsel
66,Bergstraat 71,2019-03-28,06:00:00,48,10,38,FMN GV 11 Ramsel
66,Bergstraat 71,2019-03-28,07:00:00,218,46,172,FMN GV 11 Ramsel
66,Bergstraat 71,2019-03-28,08:00:00,148,38,110,FMN GV 11 Ramsel
66,Bergstraat 71,2019-03-28,09:00:00,54,20,34,FMN GV 11 Ramsel
66,Bergstraat 71,2019-03-28,10:00:00,110,76,34,FMN GV 11 Ramsel
66,Bergstraat 71,2019-03-28,11:00:00,84,50,34,FMN GV 11 Ramsel
66,Bergstraat 71,2019-03-28,12:00:00,128,86,42,FMN GV 11 Ramsel
66,Bergstraat 71,2019-03-28,13:00:00,146,66,80,FMN GV 11 Ramsel
66,Bergstraat 71,2019-03-28,14:00:00,186,84,102,FMN GV 11 Ramsel
66,Bergstraat 71,2019-03-28,15:00:00,184,148,36,FMN GV 11 Ramsel
66,Bergstraat 71,2019-03-28,16:00:00,146,108,38,FMN GV 11 Ramsel
66,Bergstraat 71,2019-03-28,17:00:00,122,76,46,FMN GV 11 Ramsel
66,Bergstraat 71,2019-03-28,18:00:00,64,38,26,FMN GV 11 Ramsel
66,Bergstraat 71,2019-03-28,19:00:00,36,20,16,FMN GV 11 Ramsel
66,Bergstraat 71,2019-03-28,20:00:00,6,4,2,FMN GV 11 Ramsel
66,Bergstraat 71,2019-03-28,21:00:00,10,6,4,FMN GV 11 Ramsel
66,Bergstraat 71,2019-03-28,22:00:00,16,6,10,FMN GV 11 Ramsel
66,Bergstraat 71,2019-03-28,23:00:00,6,2,4,FMN GV 11 Ramsel
66,Bergstraat 71,2019-03-29,00:00:00,2,0,2,FMN GV 11 Ramsel
66,Bergstraat 71,2019-03-29,01:00:00,0,0,0,FMN GV 11 Ramsel
66,Bergstraat 71,2019-03-29,02:00:00,0,0,0,FMN GV 11 Ramsel
66,Bergstraat 71,2019-03-29,03:00:00,4,4,0,FMN GV 11 Ramsel
66,Bergstraat 71,2019-03-29,04:00:00,2,2,0,FMN GV 11 Ramsel
66,Bergstraat 71,2019-03-29,05:00:00,4,0,4,FMN GV 11 Ramsel
66,Bergstraat 71,2019-03-29,06:00:00,36,12,24,FMN GV 11 Ramsel
66,Bergstraat 71,2019-03-29,07:00:00,180,24,156,FMN GV 11 Ramsel
66,Bergstraat 71,2019-03-29,08:00:00,194,34,160,FMN GV 11 Ramsel
66,Bergstraat 71,2019-03-29,09:00:00,50,20,30,FMN GV 11 Ramsel
66,Bergstraat 71,2019-03-29,10:00:00,118,58,60,FMN GV 11 Ramsel
66,Bergstraat 71,2019-03-29,11:00:00,118,84,34,FMN GV 11 Ramsel
66,Bergstraat 71,2019-03-29,12:00:00,196,104,92,FMN GV 11 Ramsel
66,Bergstraat 71,2019-03-29,13:00:00,194,90,104,FMN GV 11 Ramsel
66,Bergstraat 71,2019-03-29,14:00:00,220,130,90,FMN GV 11 Ramsel
66,Bergstraat 71,2019-03-29,15:00:00,270,196,74,FMN GV 11 Ramsel
66,Bergstraat 71,2019-03-29,16:00:00,190,134,56,FMN GV 11 Ramsel
66,Bergstraat 71,2019-03-29,17:00:00,142,96,46,FMN GV 11 Ramsel
66,Bergstraat 71,2019-03-29,18:00:00,72,36,36,FMN GV 11 Ramsel
66,Bergstraat 71,2019-03-29,19:00:00,38,26,12,FMN GV 11 Ramsel
66,Bergstraat 71,2019-03-29,20:00:00,22,10,12,FMN GV 11 Ramsel
66,Bergstraat 71,2019-03-29,21:00:00,28,18,10,FMN GV 11 Ramsel
66,Bergstraat 71,2019-03-29,22:00:00,16,10,6,FMN GV 11 Ramsel
66,Bergstraat 71,2019-03-29,23:00:00,2,2,0,FMN GV 11 Ramsel
66,Bergstraat 71,2019-03-30,00:00:00,14,14,0,FMN GV 11 Ramsel
66,Bergstraat 71,2019-03-30,01:00:00,4,0,4,FMN GV 11 Ramsel
66,Bergstraat 71,2019-03-30,02:00:00,2,2,0,FMN GV 11 Ramsel
66,Bergstraat 71,2019-03-30,03:00:00,2,0,2,FMN GV 11 Ramsel
66,Bergstraat 71,2019-03-30,04:00:00,0,0,0,FMN GV 11 Ramsel
66,Bergstraat 71,2019-03-30,05:00:00,4,0,4,FMN GV 11 Ramsel
66,Bergstraat 71,2019-03-30,06:00:00,4,0,4,FMN GV 11 Ramsel
66,Bergstraat 71,2019-03-30,07:00:00,44,34,10,FMN GV 11 Ramsel
66,Bergstraat 71,2019-03-30,08:00:00,48,16,32,FMN GV 11 Ramsel
66,Bergstraat 71,2019-03-30,09:00:00,118,58,60,FMN GV 11 Ramsel
66,Bergstraat 71,2019-03-30,10:00:00,120,46,74,FMN GV 11 Ramsel
66,Bergstraat 71,2019-03-30,11:00:00,146,80,66,FMN GV 11 Ramsel
66,Bergstraat 71,2019-03-30,12:00:00,172,64,108,FMN GV 11 Ramsel
66,Bergstraat 71,2019-03-30,13:00:00,278,128,150,FMN GV 11 Ramsel
66,Bergstraat 71,2019-03-30,14:00:00,364,176,188,FMN GV 11 Ramsel
66,Bergstraat 71,2019-03-30,15:00:00,254,158,96,FMN GV 11 Ramsel
66,Bergstraat 71,2019-03-30,16:00:00,264,172,92,FMN GV 11 Ramsel
66,Bergstraat 71,2019-03-30,17:00:00,148,82,66,FMN GV 11 Ramsel
66,Bergstraat 71,2019-03-30,18:00:00,62,40,22,FMN GV 11 Ramsel
66,Bergstraat 71,2019-03-30,19:00:00,18,10,8,FMN GV 11 Ramsel
66,Bergstraat 71,2019-03-30,20:00:00,18,6,12,FMN GV 11 Ramsel
66,Bergstraat 71,2019-03-30,21:00:00,16,4,12,FMN GV 11 Ramsel
66,Bergstraat 71,2019-03-30,22:00:00,26,22,4,FMN GV 11 Ramsel
66,Bergstraat 71,2019-03-30,23:00:00,34,20,14,FMN GV 11 Ramsel
66,Bergstraat 71,2019-03-31,00:00:00,22,20,2,FMN GV 11 Ramsel
66,Bergstraat 71,2019-03-31,01:00:00,8,2,6,FMN GV 11 Ramsel
66,Bergstraat 71,2019-03-31,02:00:00,0,0,0,FMN GV 11 Ramsel
66,Bergstraat 71,2019-03-31,03:00:00,30,4,26,FMN GV 11 Ramsel
66,Bergstraat 71,2019-03-31,04:00:00,8,8,0,FMN GV 11 Ramsel
66,Bergstraat 71,2019-03-31,05:00:00,22,8,14,FMN GV 11 Ramsel
66,Bergstraat 71,2019-03-31,06:00:00,4,0,4,FMN GV 11 Ramsel
66,Bergstraat 71,2019-03-31,07:00:00,14,8,6,FMN GV 11 Ramsel
66,Bergstraat 71,2019-03-31,08:00:00,58,12,46,FMN GV 11 Ramsel
66,Bergstraat 71,2019-03-31,09:00:00,92,40,52,FMN GV 11 Ramsel
66,Bergstraat 71,2019-03-31,10:00:00,98,68,30,FMN GV 11 Ramsel
66,Bergstraat 71,2019-03-31,11:00:00,84,30,54,FMN GV 11 Ramsel
66,Bergstraat 71,2019-03-31,12:00:00,58,32,26,FMN GV 11 Ramsel
66,Bergstraat 71,2019-03-31,13:00:00,108,64,44,FMN GV 11 Ramsel
66,Bergstraat 71,2019-03-31,14:00:00,148,88,60,FMN GV 11 Ramsel
66,Bergstraat 71,2019-03-31,15:00:00,86,44,42,FMN GV 11 Ramsel
66,Bergstraat 71,2019-03-31,16:00:00,68,40,28,FMN GV 11 Ramsel
66,Bergstraat 71,2019-03-31,17:00:00,82,46,36,FMN GV 11 Ramsel
66,Bergstraat 71,2019-03-31,18:00:00,54,30,24,FMN GV 11 Ramsel
66,Bergstraat 71,2019-03-31,19:00:00,38,16,22,FMN GV 11 Ramsel
66,Bergstraat 71,2019-03-31,20:00:00,10,6,4,FMN GV 11 Ramsel
66,Bergstraat 71,2019-03-31,21:00:00,2,2,0,FMN GV 11 Ramsel
66,Bergstraat 71,2019-03-31,22:00:00,4,2,2,FMN GV 11 Ramsel
66,Bergstraat 71,2019-03-31,23:00:00,2,2,0,FMN GV 11 Ramsel
66,Bergstraat 71,2019-04-01,00:00:00,2,2,0,FMN GV 11 Ramsel
66,Bergstraat 71,2019-04-01,01:00:00,0,0,0,FMN GV 11 Ramsel
66,Bergstraat 71,2019-04-01,02:00:00,0,0,0,FMN GV 11 Ramsel
66,Bergstraat 71,2019-04-01,03:00:00,0,0,0,FMN GV 11 Ramsel
66,Bergstraat 71,2019-04-01,04:00:00,2,2,0,FMN GV 11 Ramsel
66,Bergstraat 71,2019-04-01,05:00:00,8,4,4,FMN GV 11 Ramsel
66,Bergstraat 71,2019-04-01,06:00:00,64,14,50,FMN GV 11 Ramsel
66,Bergstraat 71,2019-04-01,07:00:00,150,18,132,FMN GV 11 Ramsel
66,Bergstraat 71,2019-04-01,08:00:00,170,12,158,FMN GV 11 Ramsel
66,Bergstraat 71,2019-04-01,09:00:00,34,12,22,FMN GV 11 Ramsel
66,Bergstraat 71,2019-04-01,10:00:00,78,40,38,FMN GV 11 Ramsel
66,Bergstraat 71,2019-04-01,11:00:00,62,26,36,FMN GV 11 Ramsel
66,Bergstraat 71,2019-04-01,12:00:00,136,104,32,FMN GV 11 Ramsel
66,Bergstraat 71,2019-04-01,13:00:00,160,48,112,FMN GV 11 Ramsel
66,Bergstraat 71,2019-04-01,14:00:00,190,86,104,FMN GV 11 Ramsel
66,Bergstraat 71,2019-04-01,15:00:00,218,152,66,FMN GV 11 Ramsel
66,Bergstraat 71,2019-04-01,16:00:00,216,154,62,FMN GV 11 Ramsel
66,Bergstraat 71,2019-04-01,17:00:00,128,86,42,FMN GV 11 Ramsel
66,Bergstraat 71,2019-04-01,18:00:00,98,54,44,FMN GV 11 Ramsel
66,Bergstraat 71,2019-04-01,19:00:00,54,34,20,FMN GV 11 Ramsel
66,Bergstraat 71,2019-04-01,20:00:00,22,14,8,FMN GV 11 Ramsel
66,Bergstraat 71,2019-04-01,21:00:00,10,2,8,FMN GV 11 Ramsel
66,Bergstraat 71,2019-04-01,22:00:00,6,4,2,FMN GV 11 Ramsel
66,Bergstraat 71,2019-04-01,23:00:00,4,4,0,FMN GV 11 Ramsel
66,Bergstraat 71,2019-04-02,00:00:00,0,0,0,FMN GV 11 Ramsel
66,Bergstraat 71,2019-04-02,01:00:00,2,2,0,FMN GV 11 Ramsel
66,Bergstraat 71,2019-04-02,02:00:00,0,0,0,FMN GV 11 Ramsel
66,Bergstraat 71,2019-04-02,03:00:00,0,0,0,FMN GV 11 Ramsel
66,Bergstraat 71,2019-04-02,04:00:00,4,2,2,FMN GV 11 Ramsel
66,Bergstraat 71,2019-04-02,05:00:00,8,0,8,FMN GV 11 Ramsel
66,Bergstraat 71,2019-04-02,06:00:00,38,12,26,FMN GV 11 Ramsel
66,Bergstraat 71,2019-04-02,07:00:00,140,20,120,FMN GV 11 Ramsel
66,Bergstraat 71,2019-04-02,08:00:00,140,22,118,FMN GV 11 Ramsel
66,Bergstraat 71,2019-04-02,09:00:00,116,82,34,FMN GV 11 Ramsel
66,Bergstraat 71,2019-04-02,10:00:00,92,68,24,FMN GV 11 Ramsel
66,Bergstraat 71,2019-04-02,11:00:00,52,28,24,FMN GV 11 Ramsel
66,Bergstraat 71,2019-04-02,12:00:00,84,72,12,FMN GV 11 Ramsel
66,Bergstraat 71,2019-04-02,13:00:00,40,16,24,FMN GV 11 Ramsel
66,Bergstraat 71,2019-04-02,14:00:00,44,16,28,FMN GV 11 Ramsel
66,Bergstraat 71,2019-04-02,15:00:00,132,104,28,FMN GV 11 Ramsel
66,Bergstraat 71,2019-04-02,16:00:00,114,94,20,FMN GV 11 Ramsel
66,Bergstraat 71,2019-04-02,17:00:00,76,56,20,FMN GV 11 Ramsel
66,Bergstraat 71,2019-04-02,18:00:00,14,10,4,FMN GV 11 Ramsel
66,Bergstraat 71,2019-04-02,19:00:00,30,8,22,FMN GV 11 Ramsel
66,Bergstraat 71,2019-04-02,20:00:00,20,14,6,FMN GV 11 Ramsel
66,Bergstraat 71,2019-04-02,21:00:00,10,8,2,FMN GV 11 Ramsel
66,Bergstraat 71,2019-04-02,22:00:00,2,2,0,FMN GV 11 Ramsel
66,Bergstraat 71,2019-04-02,23:00:00,4,4,0,FMN GV 11 Ramsel
66,Bergstraat 71,2019-04-03,00:00:00,2,0,2,FMN GV 11 Ramsel
66,Bergstraat 71,2019-04-03,01:00:00,0,0,0,FMN GV 11 Ramsel
66,Bergstraat 71,2019-04-03,02:00:00,0,0,0,FMN GV 11 Ramsel
66,Bergstraat 71,2019-04-03,03:00:00,0,0,0,FMN GV 11 Ramsel
66,Bergstraat 71,2019-04-03,04:00:00,2,2,0,FMN GV 11 Ramsel
66,Bergstraat 71,2019-04-03,05:00:00,10,4,6,FMN GV 11 Ramsel
66,Bergstraat 71,2019-04-03,06:00:00,26,10,16,FMN GV 11 Ramsel
66,Bergstraat 71,2019-04-03,07:00:00,96,26,70,FMN GV 11 Ramsel
66,Bergstraat 71,2019-04-03,08:00:00,114,24,90,FMN GV 11 Ramsel
66,Bergstraat 71,2019-04-03,09:00:00,48,22,26,FMN GV 11 Ramsel
66,Bergstraat 71,2019-04-03,10:00:00,64,40,24,FMN GV 11 Ramsel
66,Bergstraat 71,2019-04-03,11:00:00,38,24,14,FMN GV 11 Ramsel
66,Bergstraat 71,2019-04-03,12:00:00,132,100,32,FMN GV 11 Ramsel
66,Bergstraat 71,2019-04-03,13:00:00,40,34,6,FMN GV 11 Ramsel
66,Bergstraat 71,2019-04-03,14:00:00,88,42,46,FMN GV 11 Ramsel
66,Bergstraat 71,2019-04-03,15:00:00,40,32,8,FMN GV 11 Ramsel
66,Bergstraat 71,2019-04-03,16:00:00,62,38,24,FMN GV 11 Ramsel
66,Bergstraat 71,2019-04-03,17:00:00,68,42,26,FMN GV 11 Ramsel
66,Bergstraat 71,2019-04-03,18:00:00,38,18,20,FMN GV 11 Ramsel
66,Bergstraat 71,2019-04-03,19:00:00,24,22,2,FMN GV 11 Ramsel
66,Bergstraat 71,2019-04-03,20:00:00,30,22,8,FMN GV 11 Ramsel
66,Bergstraat 71,2019-04-03,21:00:00,8,4,4,FMN GV 11 Ramsel
66,Bergstraat 71,2019-04-03,22:00:00,2,2,0,FMN GV 11 Ramsel
66,Bergstraat 71,2019-04-03,23:00:00,10,6,4,FMN GV 11 Ramsel
66,Bergstraat 71,2019-04-04,00:00:00,0,0,0,FMN GV 11 Ramsel
66,Bergstraat 71,2019-04-04,01:00:00,4,2,2,FMN GV 11 Ramsel
66,Bergstraat 71,2019-04-04,02:00:00,0,0,0,FMN GV 11 Ramsel
66,Bergstraat 71,2019-04-04,03:00:00,4,2,2,FMN GV 11 Ramsel
66,Bergstraat 71,2019-04-04,04:00:00,2,2,0,FMN GV 11 Ramsel
66,Bergstraat 71,2019-04-04,05:00:00,12,6,6,FMN GV 11 Ramsel
66,Bergstraat 71,2019-04-04,06:00:00,46,12,34,FMN GV 11 Ramsel
66,Bergstraat 71,2019-04-04,07:00:00,52,10,42,FMN GV 11 Ramsel
66,Bergstraat 71,2019-04-04,08:00:00,52,16,36,FMN GV 11 Ramsel
66,Bergstraat 71,2019-04-04,09:00:00,34,12,22,FMN GV 11 Ramsel
66,Bergstraat 71,2019-04-04,10:00:00,48,22,26,FMN GV 11 Ramsel
66,Bergstraat 71,2019-04-04,11:00:00,64,24,40,FMN GV 11 Ramsel
66,Bergstraat 71,2019-04-04,12:00:00,60,36,24,FMN GV 11 Ramsel
66,Bergstraat 71,2019-04-04,13:00:00,102,44,58,FMN GV 11 Ramsel
66,Bergstraat 71,2019-04-04,14:00:00,100,42,58,FMN GV 11 Ramsel
66,Bergstraat 71,2019-04-04,15:00:00,110,74,36,FMN GV 11 Ramsel
66,Bergstraat 71,2019-04-04,16:00:00,112,90,22,FMN GV 11 Ramsel
66,Bergstraat 71,2019-04-04,17:00:00,64,42,22,FMN GV 11 Ramsel
66,Bergstraat 71,2019-04-04,18:00:00,76,48,28,FMN GV 11 Ramsel
66,Bergstraat 71,2019-04-04,19:00:00,58,36,22,FMN GV 11 Ramsel
66,Bergstraat 71,2019-04-04,20:00:00,18,14,4,FMN GV 11 Ramsel
66,Bergstraat 71,2019-04-04,21:00:00,8,4,4,FMN GV 11 Ramsel
66,Bergstraat 71,2019-04-04,22:00:00,12,8,4,FMN GV 11 Ramsel
66,Bergstraat 71,2019-04-04,23:00:00,6,6,0,FMN GV 11 Ramsel
66,Bergstraat 71,2019-04-05,00:00:00,2,0,2,FMN GV 11 Ramsel
66,Bergstraat 71,2019-04-05,01:00:00,0,0,0,FMN GV 11 Ramsel
66,Bergstraat 71,2019-04-05,02:00:00,0,0,0,FMN GV 11 Ramsel
66,Bergstraat 71,2019-04-05,03:00:00,0,0,0,FMN GV 11 Ramsel
66,Bergstraat 71,2019-04-05,04:00:00,2,0,2,FMN GV 11 Ramsel
66,Bergstraat 71,2019-04-05,05:00:00,8,2,6,FMN GV 11 Ramsel
66,Bergstraat 71,2019-04-05,06:00:00,32,8,24,FMN GV 11 Ramsel
66,Bergstraat 71,2019-04-05,07:00:00,60,12,48,FMN GV 11 Ramsel
66,Bergstraat 71,2019-04-05,08:00:00,120,36,84,FMN GV 11 Ramsel
66,Bergstraat 71,2019-04-05,09:00:00,94,52,42,FMN GV 11 Ramsel
66,Bergstraat 71,2019-04-05,10:00:00,68,32,36,FMN GV 11 Ramsel
66,Bergstraat 71,2019-04-05,11:00:00,96,48,48,FMN GV 11 Ramsel
66,Bergstraat 71,2019-04-05,12:00:00,90,38,52,FMN GV 11 Ramsel
66,Bergstraat 71,2019-04-05,13:00:00,146,72,74,FMN GV 11 Ramsel
66,Bergstraat 71,2019-04-05,14:00:00,180,78,102,FMN GV 11 Ramsel
66,Bergstraat 71,2019-04-05,15:00:00,148,108,40,FMN GV 11 Ramsel
66,Bergstraat 71,2019-04-05,16:00:00,132,60,72,FMN GV 11 Ramsel
66,Bergstraat 71,2019-04-05,17:00:00,130,92,38,FMN GV 11 Ramsel
66,Bergstraat 71,2019-04-05,18:00:00,64,40,24,FMN GV 11 Ramsel
66,Bergstraat 71,2019-04-05,19:00:00,38,24,14,FMN GV 11 Ramsel
66,Bergstraat 71,2019-04-05,20:00:00,16,8,8,FMN GV 11 Ramsel
66,Bergstraat 71,2019-04-05,21:00:00,6,2,4,FMN GV 11 Ramsel
66,Bergstraat 71,2019-04-05,22:00:00,14,6,8,FMN GV 11 Ramsel
66,Bergstraat 71,2019-04-05,23:00:00,12,2,10,FMN GV 11 Ramsel
66,Bergstraat 71,2019-04-06,00:00:00,4,2,2,FMN GV 11 Ramsel
66,Bergstraat 71,2019-04-06,01:00:00,0,0,0,FMN GV 11 Ramsel
66,Bergstraat 71,2019-04-06,02:00:00,6,4,2,FMN GV 11 Ramsel
66,Bergstraat 71,2019-04-06,03:00:00,4,4,0,FMN GV 11 Ramsel
66,Bergstraat 71,2019-04-06,04:00:00,0,0,0,FMN GV 11 Ramsel
66,Bergstraat 71,2019-04-06,05:00:00,8,4,4,FMN GV 11 Ramsel
66,Bergstraat 71,2019-04-06,06:00:00,2,0,2,FMN GV 11 Ramsel
66,Bergstraat 71,2019-04-06,07:00:00,14,8,6,FMN GV 11 Ramsel
66,Bergstraat 71,2019-04-06,08:00:00,50,14,36,FMN GV 11 Ramsel
66,Bergstraat 71,2019-04-06,09:00:00,62,28,34,FMN GV 11 Ramsel
66,Bergstraat 71,2019-04-06,10:00:00,92,58,34,FMN GV 11 Ramsel
66,Bergstraat 71,2019-04-06,11:00:00,112,48,64,FMN GV 11 Ramsel
66,Bergstraat 71,2019-04-06,12:00:00,128,58,70,FMN GV 11 Ramsel
66,Bergstraat 71,2019-04-06,13:00:00,220,92,128,FMN GV 11 Ramsel
66,Bergstraat 71,2019-04-06,14:00:00,206,94,112,FMN GV 11 Ramsel
66,Bergstraat 71,2019-04-06,15:00:00,168,110,58,FMN GV 11 Ramsel
66,Bergstraat 71,2019-04-06,16:00:00,142,72,70,FMN GV 11 Ramsel
66,Bergstraat 71,2019-04-06,17:00:00,80,54,26,FMN GV 11 Ramsel
66,Bergstraat 71,2019-04-06,18:00:00,40,20,20,FMN GV 11 Ramsel
66,Bergstraat 71,2019-04-06,19:00:00,18,10,8,FMN GV 11 Ramsel
66,Bergstraat 71,2019-04-06,20:00:00,10,2,8,FMN GV 11 Ramsel
66,Bergstraat 71,2019-04-06,21:00:00,6,4,2,FMN GV 11 Ramsel
66,Bergstraat 71,2019-04-06,22:00:00,22,10,12,FMN GV 11 Ramsel
66,Bergstraat 71,2019-04-06,23:00:00,20,2,18,FMN GV 11 Ramsel
66,Bergstraat 71,2019-04-07,00:00:00,2,2,0,FMN GV 11 Ramsel
66,Bergstraat 71,2019-04-07,01:00:00,0,0,0,FMN GV 11 Ramsel
66,Bergstraat 71,2019-04-07,02:00:00,10,8,2,FMN GV 11 Ramsel
66,Bergstraat 71,2019-04-07,03:00:00,16,16,0,FMN GV 11 Ramsel
66,Bergstraat 71,2019-04-07,04:00:00,0,0,0,FMN GV 11 Ramsel
66,Bergstraat 71,2019-04-07,05:00:00,0,0,0,FMN GV 11 Ramsel
66,Bergstraat 71,2019-04-07,06:00:00,0,0,0,FMN GV 11 Ramsel
66,Bergstraat 71,2019-04-07,07:00:00,30,12,18,FMN GV 11 Ramsel
66,Bergstraat 71,2019-04-07,08:00:00,74,28,46,FMN GV 11 Ramsel
66,Bergstraat 71,2019-04-07,09:00:00,164,62,102,FMN GV 11 Ramsel
66,Bergstraat 71,2019-04-07,10:00:00,210,92,118,FMN GV 11 Ramsel
66,Bergstraat 71,2019-04-07,11:00:00,212,150,62,FMN GV 11 Ramsel
66,Bergstraat 71,2019-04-07,12:00:00,154,104,50,FMN GV 11 Ramsel
66,Bergstraat 71,2019-04-07,13:00:00,242,116,126,FMN GV 11 Ramsel
66,Bergstraat 71,2019-04-07,14:00:00,244,118,126,FMN GV 11 Ramsel
66,Bergstraat 71,2019-04-07,15:00:00,212,114,98,FMN GV 11 Ramsel
66,Bergstraat 71,2019-04-07,16:00:00,140,66,74,FMN GV 11 Ramsel
66,Bergstraat 71,2019-04-07,17:00:00,82,42,40,FMN GV 11 Ramsel
66,Bergstraat 71,2019-04-07,18:00:00,86,48,38,FMN GV 11 Ramsel
66,Bergstraat 71,2019-04-07,19:00:00,50,30,20,FMN GV 11 Ramsel
66,Bergstraat 71,2019-04-07,20:00:00,38,28,10,FMN GV 11 Ramsel
66,Bergstraat 71,2019-04-07,21:00:00,8,4,4,FMN GV 11 Ramsel
66,Bergstraat 71,2019-04-07,22:00:00,4,2,2,FMN GV 11 Ramsel
66,Bergstraat 71,2019-04-07,23:00:00,6,6,0,FMN GV 11 Ramsel
66,Bergstraat 71,2019-04-08,00:00:00,2,0,2,FMN GV 11 Ramsel
66,Bergstraat 71,2019-04-08,01:00:00,0,0,0,FMN GV 11 Ramsel
66,Bergstraat 71,2019-04-08,02:00:00,4,4,0,FMN GV 11 Ramsel
66,Bergstraat 71,2019-04-08,03:00:00,0,0,0,FMN GV 11 Ramsel
66,Bergstraat 71,2019-04-08,04:00:00,2,2,0,FMN GV 11 Ramsel
66,Bergstraat 71,2019-04-08,05:00:00,10,4,6,FMN GV 11 Ramsel
66,Bergstraat 71,2019-04-08,06:00:00,48,8,40,FMN GV 11 Ramsel
66,Bergstraat 71,2019-04-08,07:00:00,38,8,30,FMN GV 11 Ramsel
66,Bergstraat 71,2019-04-08,08:00:00,32,8,24,FMN GV 11 Ramsel
66,Bergstraat 71,2019-04-08,09:00:00,30,10,20,FMN GV 11 Ramsel
66,Bergstraat 71,2019-04-08,10:00:00,74,36,38,FMN GV 11 Ramsel
66,Bergstraat 71,2019-04-08,11:00:00,26,12,14,FMN GV 11 Ramsel
66,Bergstraat 71,2019-04-08,12:00:00,62,34,28,FMN GV 11 Ramsel
66,Bergstraat 71,2019-04-08,13:00:00,136,78,58,FMN GV 11 Ramsel
66,Bergstraat 71,2019-04-08,14:00:00,106,38,68,FMN GV 11 Ramsel
66,Bergstraat 71,2019-04-08,15:00:00,110,68,42,FMN GV 11 Ramsel
66,Bergstraat 71,2019-04-08,16:00:00,128,110,18,FMN GV 11 Ramsel
66,Bergstraat 71,2019-04-08,17:00:00,82,52,30,FMN GV 11 Ramsel
66,Bergstraat 71,2019-04-08,18:00:00,84,48,36,FMN GV 11 Ramsel
66,Bergstraat 71,2019-04-08,19:00:00,50,38,12,FMN GV 11 Ramsel
66,Bergstraat 71,2019-04-08,20:00:00,18,8,10,FMN GV 11 Ramsel
66,Bergstraat 71,2019-04-08,21:00:00,4,2,2,FMN GV 11 Ramsel
66,Bergstraat 71,2019-04-08,22:00:00,8,6,2,FMN GV 11 Ramsel
66,Bergstraat 71,2019-04-08,23:00:00,6,4,2,FMN GV 11 Ramsel
66,Bergstraat 71,2019-04-09,00:00:00,2,0,2,FMN GV 11 Ramsel
66,Bergstraat 71,2019-04-09,01:00:00,0,0,0,FMN GV 11 Ramsel
66,Bergstraat 71,2019-04-09,02:00:00,0,0,0,FMN GV 11 Ramsel
66,Bergstraat 71,2019-04-09,03:00:00,0,0,0,FMN GV 11 Ramsel
66,Bergstraat 71,2019-04-09,04:00:00,2,2,0,FMN GV 11 Ramsel
66,Bergstraat 71,2019-04-09,05:00:00,4,0,4,FMN GV 11 Ramsel
66,Bergstraat 71,2019-04-09,06:00:00,40,8,32,FMN GV 11 Ramsel
66,Bergstraat 71,2019-04-09,07:00:00,26,4,22,FMN GV 11 Ramsel
66,Bergstraat 71,2019-04-09,08:00:00,24,10,14,FMN GV 11 Ramsel
66,Bergstraat 71,2019-04-09,09:00:00,24,12,12,FMN GV 11 Ramsel
66,Bergstraat 71,2019-04-09,10:00:00,24,6,18,FMN GV 11 Ramsel
66,Bergstraat 71,2019-04-09,11:00:00,22,6,16,FMN GV 11 Ramsel
66,Bergstraat 71,2019-04-09,12:00:00,58,30,28,FMN GV 11 Ramsel
66,Bergstraat 71,2019-04-09,13:00:00,72,44,28,FMN GV 11 Ramsel
66,Bergstraat 71,2019-04-09,14:00:00,92,44,48,FMN GV 11 Ramsel
66,Bergstraat 71,2019-04-09,15:00:00,90,46,44,FMN GV 11 Ramsel
66,Bergstraat 71,2019-04-09,16:00:00,80,68,12,FMN GV 11 Ramsel
66,Bergstraat 71,2019-04-09,17:00:00,80,58,22,FMN GV 11 Ramsel
66,Bergstraat 71,2019-04-09,18:00:00,40,22,18,FMN GV 11 Ramsel
66,Bergstraat 71,2019-04-09,19:00:00,40,18,22,FMN GV 11 Ramsel
66,Bergstraat 71,2019-04-09,20:00:00,32,22,10,FMN GV 11 Ramsel
66,Bergstraat 71,2019-04-09,21:00:00,14,2,12,FMN GV 11 Ramsel
66,Bergstraat 71,2019-04-09,22:00:00,14,12,2,FMN GV 11 Ramsel
66,Bergstraat 71,2019-04-09,23:00:00,2,0,2,FMN GV 11 Ramsel
66,Bergstraat 71,2019-04-10,00:00:00,8,8,0,FMN GV 11 Ramsel
66,Bergstraat 71,2019-04-10,01:00:00,2,2,0,FMN GV 11 Ramsel
66,Bergstraat 71,2019-04-10,02:00:00,0,0,0,FMN GV 11 Ramsel
66,Bergstraat 71,2019-04-10,03:00:00,0,0,0,FMN GV 11 Ramsel
66,Bergstraat 71,2019-04-10,04:00:00,2,2,0,FMN GV 11 Ramsel
66,Bergstraat 71,2019-04-10,05:00:00,8,2,6,FMN GV 11 Ramsel
66,Bergstraat 71,2019-04-10,06:00:00,46,8,38,FMN GV 11 Ramsel
66,Bergstraat 71,2019-04-10,07:00:00,40,8,32,FMN GV 11 Ramsel
66,Bergstraat 71,2019-04-10,08:00:00,48,14,34,FMN GV 11 Ramsel
66,Bergstraat 71,2019-04-10,09:00:00,34,10,24,FMN GV 11 Ramsel
66,Bergstraat 71,2019-04-10,10:00:00,82,24,58,FMN GV 11 Ramsel
66,Bergstraat 71,2019-04-10,11:00:00,76,40,36,FMN GV 11 Ramsel
66,Bergstraat 71,2019-04-10,12:00:00,46,24,22,FMN GV 11 Ramsel
66,Bergstraat 71,2019-04-10,13:00:00,140,80,60,FMN GV 11 Ramsel
66,Bergstraat 71,2019-04-10,14:00:00,116,60,56,FMN GV 11 Ramsel
66,Bergstraat 71,2019-04-10,15:00:00,92,50,42,FMN GV 11 Ramsel
66,Bergstraat 71,2019-04-10,16:00:00,122,82,40,FMN GV 11 Ramsel
66,Bergstraat 71,2019-04-10,17:00:00,86,50,36,FMN GV 11 Ramsel
66,Bergstraat 71,2019-04-10,18:00:00,96,52,44,FMN GV 11 Ramsel
66,Bergstraat 71,2019-04-10,19:00:00,64,28,36,FMN GV 11 Ramsel
66,Bergstraat 71,2019-04-10,20:00:00,34,28,6,FMN GV 11 Ramsel
66,Bergstraat 71,2019-04-10,21:00:00,32,20,12,FMN GV 11 Ramsel
66,Bergstraat 71,2019-04-10,22:00:00,8,4,4,FMN GV 11 Ramsel
66,Bergstraat 71,2019-04-10,23:00:00,4,2,2,FMN GV 11 Ramsel
66,Bergstraat 71,2019-04-11,00:00:00,0,0,0,FMN GV 11 Ramsel
66,Bergstraat 71,2019-04-11,01:00:00,2,2,0,FMN GV 11 Ramsel
66,Bergstraat 71,2019-04-11,02:00:00,0,0,0,FMN GV 11 Ramsel
66,Bergstraat 71,2019-04-11,03:00:00,0,0,0,FMN GV 11 Ramsel
66,Bergstraat 71,2019-04-11,04:00:00,2,2,0,FMN GV 11 Ramsel
66,Bergstraat 71,2019-04-11,05:00:00,6,2,4,FMN GV 11 Ramsel
66,Bergstraat 71,2019-04-11,06:00:00,44,12,32,FMN GV 11 Ramsel
66,Bergstraat 71,2019-04-11,07:00:00,46,16,30,FMN GV 11 Ramsel
66,Bergstraat 71,2019-04-11,08:00:00,38,12,26,FMN GV 11 Ramsel
66,Bergstraat 71,2019-04-11,09:00:00,38,12,26,FMN GV 11 Ramsel
66,Bergstraat 71,2019-04-11,10:00:00,50,26,24,FMN GV 11 Ramsel
66,Bergstraat 71,2019-04-11,11:00:00,44,30,14,FMN GV 11 Ramsel
66,Bergstraat 71,2019-04-11,12:00:00,86,34,52,FMN GV 11 Ramsel
66,Bergstraat 71,2019-04-11,13:00:00,114,64,50,FMN GV 11 Ramsel
66,Bergstraat 71,2019-04-11,14:00:00,146,76,70,FMN GV 11 Ramsel
66,Bergstraat 71,2019-04-11,15:00:00,148,68,80,FMN GV 11 Ramsel
66,Bergstraat 71,2019-04-11,16:00:00,132,80,52,FMN GV 11 Ramsel
66,Bergstraat 71,2019-04-11,17:00:00,118,66,52,FMN GV 11 Ramsel
66,Bergstraat 71,2019-04-11,18:00:00,64,40,24,FMN GV 11 Ramsel
66,Bergstraat 71,2019-04-11,19:00:00,52,28,24,FMN GV 11 Ramsel
66,Bergstraat 71,2019-04-11,20:00:00,34,26,8,FMN GV 11 Ramsel
66,Bergstraat 71,2019-04-11,21:00:00,10,4,6,FMN GV 11 Ramsel
66,Bergstraat 71,2019-04-11,22:00:00,12,8,4,FMN GV 11 Ramsel
66,Bergstraat 71,2019-04-11,23:00:00,2,2,0,FMN GV 11 Ramsel
66,Bergstraat 71,2019-04-12,00:00:00,2,0,2,FMN GV 11 Ramsel
66,Bergstraat 71,2019-04-12,01:00:00,0,0,0,FMN GV 11 Ramsel
66,Bergstraat 71,2019-04-12,02:00:00,0,0,0,FMN GV 11 Ramsel
66,Bergstraat 71,2019-04-12,03:00:00,4,4,0,FMN GV 11 Ramsel
66,Bergstraat 71,2019-04-12,04:00:00,0,0,0,FMN GV 11 Ramsel
66,Bergstraat 71,2019-04-12,05:00:00,6,0,6,FMN GV 11 Ramsel
66,Bergstraat 71,2019-04-12,06:00:00,32,8,24,FMN GV 11 Ramsel
66,Bergstraat 71,2019-04-12,07:00:00,46,14,32,FMN GV 11 Ramsel
66,Bergstraat 71,2019-04-12,08:00:00,48,18,30,FMN GV 11 Ramsel
66,Bergstraat 71,2019-04-12,09:00:00,32,18,14,FMN GV 11 Ramsel
66,Bergstraat 71,2019-04-12,10:00:00,64,42,22,FMN GV 11 Ramsel
66,Bergstraat 71,2019-04-12,11:00:00,62,34,28,FMN GV 11 Ramsel
66,Bergstraat 71,2019-04-12,12:00:00,78,46,32,FMN GV 11 Ramsel
66,Bergstraat 71,2019-04-12,13:00:00,74,42,32,FMN GV 11 Ramsel
66,Bergstraat 71,2019-04-12,14:00:00,64,24,40,FMN GV 11 Ramsel
66,Bergstraat 71,2019-04-12,15:00:00,54,28,26,FMN GV 11 Ramsel
66,Bergstraat 71,2019-04-12,16:00:00,68,44,24,FMN GV 11 Ramsel
66,Bergstraat 71,2019-04-12,17:00:00,52,36,16,FMN GV 11 Ramsel
66,Bergstraat 71,2019-04-12,18:00:00,48,26,22,FMN GV 11 Ramsel
66,Bergstraat 71,2019-04-12,19:00:00,36,18,18,FMN GV 11 Ramsel
66,Bergstraat 71,2019-04-12,20:00:00,14,8,6,FMN GV 11 Ramsel
66,Bergstraat 71,2019-04-12,21:00:00,10,6,4,FMN GV 11 Ramsel
66,Bergstraat 71,2019-04-12,22:00:00,18,12,6,FMN GV 11 Ramsel
66,Bergstraat 71,2019-04-12,23:00:00,2,2,0,FMN GV 11 Ramsel
66,Bergstraat 71,2019-04-13,00:00:00,4,4,0,FMN GV 11 Ramsel
66,Bergstraat 71,2019-04-13,01:00:00,0,0,0,FMN GV 11 Ramsel
66,Bergstraat 71,2019-04-13,02:00:00,10,6,4,FMN GV 11 Ramsel
66,Bergstraat 71,2019-04-13,03:00:00,4,4,0,FMN GV 11 Ramsel
66,Bergstraat 71,2019-04-13,04:00:00,0,0,0,FMN GV 11 Ramsel
66,Bergstraat 71,2019-04-13,05:00:00,0,0,0,FMN GV 11 Ramsel
66,Bergstraat 71,2019-04-13,06:00:00,2,0,2,FMN GV 11 Ramsel
66,Bergstraat 71,2019-04-13,07:00:00,6,4,2,FMN GV 11 Ramsel
66,Bergstraat 71,2019-04-13,08:00:00,28,6,22,FMN GV 11 Ramsel
66,Bergstraat 71,2019-04-13,09:00:00,40,16,24,FMN GV 11 Ramsel
66,Bergstraat 71,2019-04-13,10:00:00,88,44,44,FMN GV 11 Ramsel
66,Bergstraat 71,2019-04-13,11:00:00,62,36,26,FMN GV 11 Ramsel
66,Bergstraat 71,2019-04-13,12:00:00,92,38,54,FMN GV 11 Ramsel
66,Bergstraat 71,2019-04-13,13:00:00,88,28,60,FMN GV 11 Ramsel
66,Bergstraat 71,2019-04-13,14:00:00,142,72,70,FMN GV 11 Ramsel
66,Bergstraat 71,2019-04-13,15:00:00,66,44,22,FMN GV 11 Ramsel
66,Bergstraat 71,2019-04-13,16:00:00,96,70,26,FMN GV 11 Ramsel
66,Bergstraat 71,2019-04-13,17:00:00,42,30,12,FMN GV 11 Ramsel
66,Bergstraat 71,2019-04-13,18:00:00,34,24,10,FMN GV 11 Ramsel
66,Bergstraat 71,2019-04-13,19:00:00,20,12,8,FMN GV 11 Ramsel
66,Bergstraat 71,2019-04-13,20:00:00,6,0,6,FMN GV 11 Ramsel
66,Bergstraat 71,2019-04-13,21:00:00,2,2,0,FMN GV 11 Ramsel
66,Bergstraat 71,2019-04-13,22:00:00,12,10,2,FMN GV 11 Ramsel
66,Bergstraat 71,2019-04-13,23:00:00,8,4,4,FMN GV 11 Ramsel
66,Bergstraat 71,2019-04-14,00:00:00,4,4,0,FMN GV 11 Ramsel
66,Bergstraat 71,2019-04-14,01:00:00,0,0,0,FMN GV 11 Ramsel
66,Bergstraat 71,2019-04-14,02:00:00,0,0,0,FMN GV 11 Ramsel
66,Bergstraat 71,2019-04-14,03:00:00,2,2,0,FMN GV 11 Ramsel
66,Bergstraat 71,2019-04-14,04:00:00,0,0,0,FMN GV 11 Ramsel
66,Bergstraat 71,2019-04-14,05:00:00,0,0,0,FMN GV 11 Ramsel
66,Bergstraat 71,2019-04-14,06:00:00,0,0,0,FMN GV 11 Ramsel
66,Bergstraat 71,2019-04-14,07:00:00,42,8,34,FMN GV 11 Ramsel
66,Bergstraat 71,2019-04-14,08:00:00,48,8,40,FMN GV 11 Ramsel
66,Bergstraat 71,2019-04-14,09:00:00,112,36,76,FMN GV 11 Ramsel
66,Bergstraat 71,2019-04-14,10:00:00,114,54,60,FMN GV 11 Ramsel
66,Bergstraat 71,2019-04-14,11:00:00,118,80,38,FMN GV 11 Ramsel
66,Bergstraat 71,2019-04-14,12:00:00,98,50,48,FMN GV 11 Ramsel
66,Bergstraat 71,2019-04-14,13:00:00,100,58,42,FMN GV 11 Ramsel
66,Bergstraat 71,2019-04-14,14:00:00,122,60,62,FMN GV 11 Ramsel
66,Bergstraat 71,2019-04-14,15:00:00,100,50,50,FMN GV 11 Ramsel
66,Bergstraat 71,2019-04-14,16:00:00,58,34,24,FMN GV 11 Ramsel
66,Bergstraat 71,2019-04-14,17:00:00,40,22,18,FMN GV 11 Ramsel
66,Bergstraat 71,2019-04-14,18:00:00,26,6,20,FMN GV 11 Ramsel
66,Bergstraat 71,2019-04-14,19:00:00,38,16,22,FMN GV 11 Ramsel
66,Bergstraat 71,2019-04-14,20:00:00,24,12,12,FMN GV 11 Ramsel
66,Bergstraat 71,2019-04-14,21:00:00,4,4,0,FMN GV 11 Ramsel
66,Bergstraat 71,2019-04-14,22:00:00,2,0,2,FMN GV 11 Ramsel
66,Bergstraat 71,2019-04-14,23:00:00,4,4,0,FMN GV 11 Ramsel
66,Bergstraat 71,2019-04-15,00:00:00,4,4,0,FMN GV 11 Ramsel
66,Bergstraat 71,2019-04-15,01:00:00,0,0,0,FMN GV 11 Ramsel
66,Bergstraat 71,2019-04-15,02:00:00,2,2,0,FMN GV 11 Ramsel
66,Bergstraat 71,2019-04-15,03:00:00,0,0,0,FMN GV 11 Ramsel
66,Bergstraat 71,2019-04-15,04:00:00,2,2,0,FMN GV 11 Ramsel
66,Bergstraat 71,2019-04-15,05:00:00,6,6,0,FMN GV 11 Ramsel
66,Bergstraat 71,2019-04-15,06:00:00,30,8,22,FMN GV 11 Ramsel
66,Bergstraat 71,2019-04-15,07:00:00,42,16,26,FMN GV 11 Ramsel
66,Bergstraat 71,2019-04-15,08:00:00,32,12,20,FMN GV 11 Ramsel
66,Bergstraat 71,2019-04-15,09:00:00,44,18,26,FMN GV 11 Ramsel
66,Bergstraat 71,2019-04-15,10:00:00,98,74,24,FMN GV 11 Ramsel
66,Bergstraat 71,2019-04-15,11:00:00,66,30,36,FMN GV 11 Ramsel
66,Bergstraat 71,2019-04-15,12:00:00,84,30,54,FMN GV 11 Ramsel
66,Bergstraat 71,2019-04-15,13:00:00,144,54,90,FMN GV 11 Ramsel
66,Bergstraat 71,2019-04-15,14:00:00,182,94,88,FMN GV 11 Ramsel
66,Bergstraat 71,2019-04-15,15:00:00,178,98,80,FMN GV 11 Ramsel
66,Bergstraat 71,2019-04-15,16:00:00,120,70,50,FMN GV 11 Ramsel
66,Bergstraat 71,2019-04-15,17:00:00,116,80,36,FMN GV 11 Ramsel
66,Bergstraat 71,2019-04-15,18:00:00,84,40,44,FMN GV 11 Ramsel
66,Bergstraat 71,2019-04-15,19:00:00,48,24,24,FMN GV 11 Ramsel
66,Bergstraat 71,2019-04-15,20:00:00,36,28,8,FMN GV 11 Ramsel
66,Bergstraat 71,2019-04-15,21:00:00,16,6,10,FMN GV 11 Ramsel
66,Bergstraat 71,2019-04-15,22:00:00,4,4,0,FMN GV 11 Ramsel
66,Bergstraat 71,2019-04-15,23:00:00,4,4,0,FMN GV 11 Ramsel
66,Bergstraat 71,2019-04-16,00:00:00,6,4,2,FMN GV 11 Ramsel
66,Bergstraat 71,2019-04-16,01:00:00,0,0,0,FMN GV 11 Ramsel
66,Bergstraat 71,2019-04-16,02:00:00,0,0,0,FMN GV 11 Ramsel
66,Bergstraat 71,2019-04-16,03:00:00,0,0,0,FMN GV 11 Ramsel
66,Bergstraat 71,2019-04-16,04:00:00,2,2,0,FMN GV 11 Ramsel
66,Bergstraat 71,2019-04-16,05:00:00,6,2,4,FMN GV 11 Ramsel
66,Bergstraat 71,2019-04-16,06:00:00,44,10,34,FMN GV 11 Ramsel
66,Bergstraat 71,2019-04-16,07:00:00,50,22,28,FMN GV 11 Ramsel
66,Bergstraat 71,2019-04-16,08:00:00,48,16,32,FMN GV 11 Ramsel
66,Bergstraat 71,2019-04-16,09:00:00,84,44,40,FMN GV 11 Ramsel
66,Bergstraat 71,2019-04-16,10:00:00,76,42,34,FMN GV 11 Ramsel
66,Bergstraat 71,2019-04-16,11:00:00,78,36,42,FMN GV 11 Ramsel
66,Bergstraat 71,2019-04-16,12:00:00,110,56,54,FMN GV 11 Ramsel
66,Bergstraat 71,2019-04-16,13:00:00,212,98,114,FMN GV 11 Ramsel
66,Bergstraat 71,2019-04-16,14:00:00,170,66,104,FMN GV 11 Ramsel
66,Bergstraat 71,2019-04-16,15:00:00,156,94,62,FMN GV 11 Ramsel
66,Bergstraat 71,2019-04-16,16:00:00,150,98,52,FMN GV 11 Ramsel
66,Bergstraat 71,2019-04-16,17:00:00,142,84,58,FMN GV 11 Ramsel
66,Bergstraat 71,2019-04-16,18:00:00,88,48,40,FMN GV 11 Ramsel
66,Bergstraat 71,2019-04-16,19:00:00,64,36,28,FMN GV 11 Ramsel
66,Bergstraat 71,2019-04-16,20:00:00,38,30,8,FMN GV 11 Ramsel
66,Bergstraat 71,2019-04-16,21:00:00,38,34,4,FMN GV 11 Ramsel
66,Bergstraat 71,2019-04-16,22:00:00,14,10,4,FMN GV 11 Ramsel
66,Bergstraat 71,2019-04-16,23:00:00,6,6,0,FMN GV 11 Ramsel
66,Bergstraat 71,2019-04-17,00:00:00,2,0,2,FMN GV 11 Ramsel
66,Bergstraat 71,2019-04-17,01:00:00,4,2,2,FMN GV 11 Ramsel
66,Bergstraat 71,2019-04-17,02:00:00,0,0,0,FMN GV 11 Ramsel
66,Bergstraat 71,2019-04-17,03:00:00,0,0,0,FMN GV 11 Ramsel
66,Bergstraat 71,2019-04-17,04:00:00,2,2,0,FMN GV 11 Ramsel
66,Bergstraat 71,2019-04-17,05:00:00,10,4,6,FMN GV 11 Ramsel
66,Bergstraat 71,2019-04-17,06:00:00,34,10,24,FMN GV 11 Ramsel
66,Bergstraat 71,2019-04-17,07:00:00,64,14,50,FMN GV 11 Ramsel
66,Bergstraat 71,2019-04-17,08:00:00,44,18,26,FMN GV 11 Ramsel
66,Bergstraat 71,2019-04-17,09:00:00,48,20,28,FMN GV 11 Ramsel
66,Bergstraat 71,2019-04-17,10:00:00,68,32,36,FMN GV 11 Ramsel
66,Bergstraat 71,2019-04-17,11:00:00,68,22,46,FMN GV 11 Ramsel
66,Bergstraat 71,2019-04-17,12:00:00,92,48,44,FMN GV 11 Ramsel
66,Bergstraat 71,2019-04-17,13:00:00,100,36,64,FMN GV 11 Ramsel
66,Bergstraat 71,2019-04-17,14:00:00,98,54,44,FMN GV 11 Ramsel
66,Bergstraat 71,2019-04-17,15:00:00,174,84,90,FMN GV 11 Ramsel
66,Bergstraat 71,2019-04-17,16:00:00,126,70,56,FMN GV 11 Ramsel
66,Bergstraat 71,2019-04-17,17:00:00,126,84,42,FMN GV 11 Ramsel
66,Bergstraat 71,2019-04-17,18:00:00,84,42,42,FMN GV 11 Ramsel
66,Bergstraat 71,2019-04-17,19:00:00,68,40,28,FMN GV 11 Ramsel
66,Bergstraat 71,2019-04-17,20:00:00,56,32,24,FMN GV 11 Ramsel
66,Bergstraat 71,2019-04-17,21:00:00,16,10,6,FMN GV 11 Ramsel
66,Bergstraat 71,2019-04-17,22:00:00,8,6,2,FMN GV 11 Ramsel
66,Bergstraat 71,2019-04-17,23:00:00,4,2,2,FMN GV 11 Ramsel
66,Bergstraat 71,2019-04-18,00:00:00,6,4,2,FMN GV 11 Ramsel
66,Bergstraat 71,2019-04-18,01:00:00,2,0,2,FMN GV 11 Ramsel
66,Bergstraat 71,2019-04-18,02:00:00,4,4,0,FMN GV 11 Ramsel
66,Bergstraat 71,2019-04-18,03:00:00,0,0,0,FMN GV 11 Ramsel
66,Bergstraat 71,2019-04-18,04:00:00,2,2,0,FMN GV 11 Ramsel
66,Bergstraat 71,2019-04-18,05:00:00,8,2,6,FMN GV 11 Ramsel
66,Bergstraat 71,2019-04-18,06:00:00,46,18,28,FMN GV 11 Ramsel
66,Bergstraat 71,2019-04-18,07:00:00,58,20,38,FMN GV 11 Ramsel
66,Bergstraat 71,2019-04-18,08:00:00,32,4,28,FMN GV 11 Ramsel
66,Bergstraat 71,2019-04-18,09:00:00,80,30,50,FMN GV 11 Ramsel
66,Bergstraat 71,2019-04-18,10:00:00,114,42,72,FMN GV 11 Ramsel
66,Bergstraat 71,2019-04-18,11:00:00,62,14,48,FMN GV 11 Ramsel
66,Bergstraat 71,2019-04-18,12:00:00,136,72,64,FMN GV 11 Ramsel
66,Bergstraat 71,2019-04-18,13:00:00,236,82,154,FMN GV 11 Ramsel
66,Bergstraat 71,2019-04-18,14:00:00,248,132,116,FMN GV 11 Ramsel
66,Bergstraat 71,2019-04-18,15:00:00,220,154,66,FMN GV 11 Ramsel
66,Bergstraat 71,2019-04-18,16:00:00,156,100,56,FMN GV 11 Ramsel
66,Bergstraat 71,2019-04-18,17:00:00,172,98,74,FMN GV 11 Ramsel
66,Bergstraat 71,2019-04-18,18:00:00,136,78,58,FMN GV 11 Ramsel
66,Bergstraat 71,2019-04-18,19:00:00,88,34,54,FMN GV 11 Ramsel
66,Bergstraat 71,2019-04-18,20:00:00,64,44,20,FMN GV 11 Ramsel
66,Bergstraat 71,2019-04-18,21:00:00,26,16,10,FMN GV 11 Ramsel
66,Bergstraat 71,2019-04-18,22:00:00,18,12,6,FMN GV 11 Ramsel
66,Bergstraat 71,2019-04-18,23:00:00,14,10,4,FMN GV 11 Ramsel
66,Bergstraat 71,2019-04-19,00:00:00,4,0,4,FMN GV 11 Ramsel
66,Bergstraat 71,2019-04-19,01:00:00,4,0,4,FMN GV 11 Ramsel
66,Bergstraat 71,2019-04-19,02:00:00,0,0,0,FMN GV 11 Ramsel
66,Bergstraat 71,2019-04-19,03:00:00,0,0,0,FMN GV 11 Ramsel
66,Bergstraat 71,2019-04-19,04:00:00,0,0,0,FMN GV 11 Ramsel
66,Bergstraat 71,2019-04-19,05:00:00,10,6,4,FMN GV 11 Ramsel
66,Bergstraat 71,2019-04-19,06:00:00,48,18,30,FMN GV 11 Ramsel
66,Bergstraat 71,2019-04-19,07:00:00,52,14,38,FMN GV 11 Ramsel
66,Bergstraat 71,2019-04-19,08:00:00,78,30,48,FMN GV 11 Ramsel
66,Bergstraat 71,2019-04-19,09:00:00,92,34,58,FMN GV 11 Ramsel
66,Bergstraat 71,2019-04-19,10:00:00,92,38,54,FMN GV 11 Ramsel
66,Bergstraat 71,2019-04-19,11:00:00,140,74,66,FMN GV 11 Ramsel
66,Bergstraat 71,2019-04-19,12:00:00,116,48,68,FMN GV 11 Ramsel
66,Bergstraat 71,2019-04-19,13:00:00,226,128,98,FMN GV 11 Ramsel
66,Bergstraat 71,2019-04-19,14:00:00,246,144,102,FMN GV 11 Ramsel
66,Bergstraat 71,2019-04-19,15:00:00,222,120,102,FMN GV 11 Ramsel
66,Bergstraat 71,2019-04-19,16:00:00,298,178,120,FMN GV 11 Ramsel
66,Bergstraat 71,2019-04-19,17:00:00,226,78,148,FMN GV 11 Ramsel
66,Bergstraat 71,2019-04-19,18:00:00,116,54,62,FMN GV 11 Ramsel
66,Bergstraat 71,2019-04-19,19:00:00,84,52,32,FMN GV 11 Ramsel
66,Bergstraat 71,2019-04-19,20:00:00,70,32,38,FMN GV 11 Ramsel
66,Bergstraat 71,2019-04-19,21:00:00,22,4,18,FMN GV 11 Ramsel
66,Bergstraat 71,2019-04-19,22:00:00,28,2,26,FMN GV 11 Ramsel
66,Bergstraat 71,2019-04-19,23:00:00,14,4,10,FMN GV 11 Ramsel
66,Bergstraat 71,2019-04-20,00:00:00,8,6,2,FMN GV 11 Ramsel
66,Bergstraat 71,2019-04-20,01:00:00,10,10,0,FMN GV 11 Ramsel
66,Bergstraat 71,2019-04-20,02:00:00,14,12,2,FMN GV 11 Ramsel
66,Bergstraat 71,2019-04-20,03:00:00,10,10,0,FMN GV 11 Ramsel
66,Bergstraat 71,2019-04-20,04:00:00,12,6,6,FMN GV 11 Ramsel
66,Bergstraat 71,2019-04-20,05:00:00,10,6,4,FMN GV 11 Ramsel
66,Bergstraat 71,2019-04-20,06:00:00,2,2,0,FMN GV 11 Ramsel
66,Bergstraat 71,2019-04-20,07:00:00,28,4,24,FMN GV 11 Ramsel
66,Bergstraat 71,2019-04-20,08:00:00,30,6,24,FMN GV 11 Ramsel
66,Bergstraat 71,2019-04-20,09:00:00,86,36,50,FMN GV 11 Ramsel
66,Bergstraat 71,2019-04-20,10:00:00,146,42,104,FMN GV 11 Ramsel
66,Bergstraat 71,2019-04-20,11:00:00,144,56,88,FMN GV 11 Ramsel
66,Bergstraat 71,2019-04-20,12:00:00,170,76,94,FMN GV 11 Ramsel
66,Bergstraat 71,2019-04-20,13:00:00,258,108,150,FMN GV 11 Ramsel
66,Bergstraat 71,2019-04-20,14:00:00,322,136,186,FMN GV 11 Ramsel
66,Bergstraat 71,2019-04-20,15:00:00,292,174,118,FMN GV 11 Ramsel
66,Bergstraat 71,2019-04-20,16:00:00,252,150,102,FMN GV 11 Ramsel
66,Bergstraat 71,2019-04-20,17:00:00,262,130,132,FMN GV 11 Ramsel
66,Bergstraat 71,2019-04-20,18:00:00,104,68,36,FMN GV 11 Ramsel
66,Bergstraat 71,2019-04-20,19:00:00,124,60,64,FMN GV 11 Ramsel
66,Bergstraat 71,2019-04-20,20:00:00,44,24,20,FMN GV 11 Ramsel
66,Bergstraat 71,2019-04-20,21:00:00,30,14,16,FMN GV 11 Ramsel
66,Bergstraat 71,2019-04-20,22:00:00,10,4,6,FMN GV 11 Ramsel
66,Bergstraat 71,2019-04-20,23:00:00,14,4,10,FMN GV 11 Ramsel
66,Bergstraat 71,2019-04-21,00:00:00,8,4,4,FMN GV 11 Ramsel
66,Bergstraat 71,2019-04-21,01:00:00,8,2,6,FMN GV 11 Ramsel
66,Bergstraat 71,2019-04-21,02:00:00,4,4,0,FMN GV 11 Ramsel
66,Bergstraat 71,2019-04-21,03:00:00,0,0,0,FMN GV 11 Ramsel
66,Bergstraat 71,2019-04-21,04:00:00,2,2,0,FMN GV 11 Ramsel
66,Bergstraat 71,2019-04-21,05:00:00,4,4,0,FMN GV 11 Ramsel
66,Bergstraat 71,2019-04-21,06:00:00,6,0,6,FMN GV 11 Ramsel
66,Bergstraat 71,2019-04-21,07:00:00,28,16,12,FMN GV 11 Ramsel
66,Bergstraat 71,2019-04-21,08:00:00,50,6,44,FMN GV 11 Ramsel
66,Bergstraat 71,2019-04-21,09:00:00,102,28,74,FMN GV 11 Ramsel
66,Bergstraat 71,2019-04-21,10:00:00,170,100,70,FMN GV 11 Ramsel
66,Bergstraat 71,2019-04-21,11:00:00,250,130,120,FMN GV 11 Ramsel
66,Bergstraat 71,2019-04-21,12:00:00,164,86,78,FMN GV 11 Ramsel
66,Bergstraat 71,2019-04-21,13:00:00,216,98,118,FMN GV 11 Ramsel
66,Bergstraat 71,2019-04-21,14:00:00,254,130,124,FMN GV 11 Ramsel
66,Bergstraat 71,2019-04-21,15:00:00,260,156,104,FMN GV 11 Ramsel
66,Bergstraat 71,2019-04-21,16:00:00,238,132,106,FMN GV 11 Ramsel
66,Bergstraat 71,2019-04-21,17:00:00,156,86,70,FMN GV 11 Ramsel
66,Bergstraat 71,2019-04-21,18:00:00,102,50,52,FMN GV 11 Ramsel
66,Bergstraat 71,2019-04-21,19:00:00,72,40,32,FMN GV 11 Ramsel
66,Bergstraat 71,2019-04-21,20:00:00,42,14,28,FMN GV 11 Ramsel
66,Bergstraat 71,2019-04-21,21:00:00,40,24,16,FMN GV 11 Ramsel
66,Bergstraat 71,2019-04-21,22:00:00,16,2,14,FMN GV 11 Ramsel
66,Bergstraat 71,2019-04-21,23:00:00,6,2,4,FMN GV 11 Ramsel
66,Bergstraat 71,2019-04-22,00:00:00,4,2,2,FMN GV 11 Ramsel
66,Bergstraat 71,2019-04-22,01:00:00,0,0,0,FMN GV 11 Ramsel
66,Bergstraat 71,2019-04-22,02:00:00,2,0,2,FMN GV 11 Ramsel
66,Bergstraat 71,2019-04-22,03:00:00,2,0,2,FMN GV 11 Ramsel
66,Bergstraat 71,2019-04-22,04:00:00,2,2,0,FMN GV 11 Ramsel
66,Bergstraat 71,2019-04-22,05:00:00,0,0,0,FMN GV 11 Ramsel
66,Bergstraat 71,2019-04-22,06:00:00,0,0,0,FMN GV 11 Ramsel
66,Bergstraat 71,2019-04-22,07:00:00,18,8,10,FMN GV 11 Ramsel
66,Bergstraat 71,2019-04-22,08:00:00,52,26,26,FMN GV 11 Ramsel
66,Bergstraat 71,2019-04-22,09:00:00,128,54,74,FMN GV 11 Ramsel
66,Bergstraat 71,2019-04-22,10:00:00,202,100,102,FMN GV 11 Ramsel
66,Bergstraat 71,2019-04-22,11:00:00,218,140,78,FMN GV 11 Ramsel
66,Bergstraat 71,2019-04-22,12:00:00,226,102,124,FMN GV 11 Ramsel
66,Bergstraat 71,2019-04-22,13:00:00,360,178,182,FMN GV 11 Ramsel
66,Bergstraat 71,2019-04-22,14:00:00,366,194,172,FMN GV 11 Ramsel
66,Bergstraat 71,2019-04-22,15:00:00,276,140,136,FMN GV 11 Ramsel
66,Bergstraat 71,2019-04-22,16:00:00,322,170,152,FMN GV 11 Ramsel
66,Bergstraat 71,2019-04-22,17:00:00,240,122,118,FMN GV 11 Ramsel
66,Bergstraat 71,2019-04-22,18:00:00,102,52,50,FMN GV 11 Ramsel
66,Bergstraat 71,2019-04-22,19:00:00,42,26,16,FMN GV 11 Ramsel
66,Bergstraat 71,2019-04-22,20:00:00,48,22,26,FMN GV 11 Ramsel
66,Bergstraat 71,2019-04-22,21:00:00,10,6,4,FMN GV 11 Ramsel
66,Bergstraat 71,2019-04-22,22:00:00,14,12,2,FMN GV 11 Ramsel
66,Bergstraat 71,2019-04-22,23:00:00,2,2,0,FMN GV 11 Ramsel
66,Bergstraat 71,2019-04-23,00:00:00,2,2,0,FMN GV 11 Ramsel
66,Bergstraat 71,2019-04-23,01:00:00,0,0,0,FMN GV 11 Ramsel
66,Bergstraat 71,2019-04-23,02:00:00,0,0,0,FMN GV 11 Ramsel
66,Bergstraat 71,2019-04-23,03:00:00,0,0,0,FMN GV 11 Ramsel
66,Bergstraat 71,2019-04-23,04:00:00,4,2,2,FMN GV 11 Ramsel
66,Bergstraat 71,2019-04-23,05:00:00,18,8,10,FMN GV 11 Ramsel
66,Bergstraat 71,2019-04-23,06:00:00,62,12,50,FMN GV 11 Ramsel
66,Bergstraat 71,2019-04-23,07:00:00,256,42,214,FMN GV 11 Ramsel
66,Bergstraat 71,2019-04-23,08:00:00,192,50,142,FMN GV 11 Ramsel
66,Bergstraat 71,2019-04-23,09:00:00,70,24,46,FMN GV 11 Ramsel
66,Bergstraat 71,2019-04-23,10:00:00,72,26,46,FMN GV 11 Ramsel
66,Bergstraat 71,2019-04-23,11:00:00,88,34,54,FMN GV 11 Ramsel
66,Bergstraat 71,2019-04-23,12:00:00,118,66,52,FMN GV 11 Ramsel
66,Bergstraat 71,2019-04-23,13:00:00,144,60,84,FMN GV 11 Ramsel
66,Bergstraat 71,2019-04-23,14:00:00,150,82,68,FMN GV 11 Ramsel
66,Bergstraat 71,2019-04-23,15:00:00,290,238,52,FMN GV 11 Ramsel
66,Bergstraat 71,2019-04-23,16:00:00,226,162,64,FMN GV 11 Ramsel
66,Bergstraat 71,2019-04-23,17:00:00,196,120,76,FMN GV 11 Ramsel
66,Bergstraat 71,2019-04-23,18:00:00,120,76,44,FMN GV 11 Ramsel
66,Bergstraat 71,2019-04-23,19:00:00,90,48,42,FMN GV 11 Ramsel
66,Bergstraat 71,2019-04-23,20:00:00,44,22,22,FMN GV 11 Ramsel
66,Bergstraat 71,2019-04-23,21:00:00,32,28,4,FMN GV 11 Ramsel
66,Bergstraat 71,2019-04-23,22:00:00,12,6,6,FMN GV 11 Ramsel
66,Bergstraat 71,2019-04-23,23:00:00,4,4,0,FMN GV 11 Ramsel
66,Bergstraat 71,2019-04-24,00:00:00,0,0,0,FMN GV 11 Ramsel
66,Bergstraat 71,2019-04-24,01:00:00,0,0,0,FMN GV 11 Ramsel
66,Bergstraat 71,2019-04-24,02:00:00,0,0,0,FMN GV 11 Ramsel
66,Bergstraat 71,2019-04-24,03:00:00,0,0,0,FMN GV 11 Ramsel
66,Bergstraat 71,2019-04-24,04:00:00,2,2,0,FMN GV 11 Ramsel
66,Bergstraat 71,2019-04-24,05:00:00,6,0,6,FMN GV 11 Ramsel
66,Bergstraat 71,2019-04-24,06:00:00,42,10,32,FMN GV 11 Ramsel
66,Bergstraat 71,2019-04-24,07:00:00,200,30,170,FMN GV 11 Ramsel
66,Bergstraat 71,2019-04-24,08:00:00,198,28,170,FMN GV 11 Ramsel
66,Bergstraat 71,2019-04-24,09:00:00,68,16,52,FMN GV 11 Ramsel
66,Bergstraat 71,2019-04-24,10:00:00,82,44,38,FMN GV 11 Ramsel
66,Bergstraat 71,2019-04-24,11:00:00,58,34,24,FMN GV 11 Ramsel
66,Bergstraat 71,2019-04-24,12:00:00,326,254,72,FMN GV 11 Ramsel
66,Bergstraat 71,2019-04-24,13:00:00,146,90,56,FMN GV 11 Ramsel
66,Bergstraat 71,2019-04-24,14:00:00,146,82,64,FMN GV 11 Ramsel
66,Bergstraat 71,2019-04-24,15:00:00,94,64,30,FMN GV 11 Ramsel
66,Bergstraat 71,2019-04-24,16:00:00,98,68,30,FMN GV 11 Ramsel
66,Bergstraat 71,2019-04-24,17:00:00,114,80,34,FMN GV 11 Ramsel
66,Bergstraat 71,2019-04-24,18:00:00,58,38,20,FMN GV 11 Ramsel
66,Bergstraat 71,2019-04-24,19:00:00,6,4,2,FMN GV 11 Ramsel
66,Bergstraat 71,2019-04-24,20:00:00,12,8,4,FMN GV 11 Ramsel
66,Bergstraat 71,2019-04-24,21:00:00,2,0,2,FMN GV 11 Ramsel
66,Bergstraat 71,2019-04-24,22:00:00,14,6,8,FMN GV 11 Ramsel
66,Bergstraat 71,2019-04-24,23:00:00,0,0,0,FMN GV 11 Ramsel
66,Bergstraat 71,2019-04-25,00:00:00,2,2,0,FMN GV 11 Ramsel
66,Bergstraat 71,2019-04-25,01:00:00,0,0,0,FMN GV 11 Ramsel
66,Bergstraat 71,2019-04-25,02:00:00,2,2,0,FMN GV 11 Ramsel
66,Bergstraat 71,2019-04-25,03:00:00,0,0,0,FMN GV 11 Ramsel
66,Bergstraat 71,2019-04-25,04:00:00,4,0,4,FMN GV 11 Ramsel
66,Bergstraat 71,2019-04-25,05:00:00,4,0,4,FMN GV 11 Ramsel
66,Bergstraat 71,2019-04-25,06:00:00,44,10,34,FMN GV 11 Ramsel
66,Bergstraat 71,2019-04-25,07:00:00,162,24,138,FMN GV 11 Ramsel
66,Bergstraat 71,2019-04-25,08:00:00,152,24,128,FMN GV 11 Ramsel
66,Bergstraat 71,2019-04-25,09:00:00,44,14,30,FMN GV 11 Ramsel
66,Bergstraat 71,2019-04-25,10:00:00,26,10,16,FMN GV 11 Ramsel
66,Bergstraat 71,2019-04-25,11:00:00,42,14,28,FMN GV 11 Ramsel
66,Bergstraat 71,2019-04-25,12:00:00,36,22,14,FMN GV 11 Ramsel
66,Bergstraat 71,2019-04-25,13:00:00,64,42,22,FMN GV 11 Ramsel
66,Bergstraat 71,2019-04-25,14:00:00,28,28,0,FMN GV 11 Ramsel
66,Bergstraat 71,2019-04-25,15:00:00,198,174,24,FMN GV 11 Ramsel
66,Bergstraat 71,2019-04-25,16:00:00,88,74,14,FMN GV 11 Ramsel
66,Bergstraat 71,2019-04-25,17:00:00,68,52,16,FMN GV 11 Ramsel
66,Bergstraat 71,2019-04-25,18:00:00,56,30,26,FMN GV 11 Ramsel
66,Bergstraat 71,2019-04-25,19:00:00,48,22,26,FMN GV 11 Ramsel
66,Bergstraat 71,2019-04-25,20:00:00,14,10,4,FMN GV 11 Ramsel
66,Bergstraat 71,2019-04-25,21:00:00,8,2,6,FMN GV 11 Ramsel
66,Bergstraat 71,2019-04-25,22:00:00,10,8,2,FMN GV 11 Ramsel
66,Bergstraat 71,2019-04-25,23:00:00,0,0,0,FMN GV 11 Ramsel
66,Bergstraat 71,2019-04-26,00:00:00,2,2,0,FMN GV 11 Ramsel
66,Bergstraat 71,2019-04-26,01:00:00,2,2,0,FMN GV 11 Ramsel
66,Bergstraat 71,2019-04-26,02:00:00,2,2,0,FMN GV 11 Ramsel
66,Bergstraat 71,2019-04-26,03:00:00,0,0,0,FMN GV 11 Ramsel
66,Bergstraat 71,2019-04-26,04:00:00,2,2,0,FMN GV 11 Ramsel
66,Bergstraat 71,2019-04-26,05:00:00,4,0,4,FMN GV 11 Ramsel
66,Bergstraat 71,2019-04-26,06:00:00,28,8,20,FMN GV 11 Ramsel
66,Bergstraat 71,2019-04-26,07:00:00,166,28,138,FMN GV 11 Ramsel
66,Bergstraat 71,2019-04-26,08:00:00,174,36,138,FMN GV 11 Ramsel
66,Bergstraat 71,2019-04-26,09:00:00,50,22,28,FMN GV 11 Ramsel
66,Bergstraat 71,2019-04-26,10:00:00,56,28,28,FMN GV 11 Ramsel
66,Bergstraat 71,2019-04-26,11:00:00,64,30,34,FMN GV 11 Ramsel
66,Bergstraat 71,2019-04-26,12:00:00,102,48,54,FMN GV 11 Ramsel
66,Bergstraat 71,2019-04-26,13:00:00,108,44,64,FMN GV 11 Ramsel
66,Bergstraat 71,2019-04-26,14:00:00,188,118,70,FMN GV 11 Ramsel
66,Bergstraat 71,2019-04-26,15:00:00,204,148,56,FMN GV 11 Ramsel
66,Bergstraat 71,2019-04-26,16:00:00,174,126,48,FMN GV 11 Ramsel
66,Bergstraat 71,2019-04-26,17:00:00,108,78,30,FMN GV 11 Ramsel
66,Bergstraat 71,2019-04-26,18:00:00,100,52,48,FMN GV 11 Ramsel
66,Bergstraat 71,2019-04-26,19:00:00,44,32,12,FMN GV 11 Ramsel
66,Bergstraat 71,2019-04-26,20:00:00,54,24,30,FMN GV 11 Ramsel
66,Bergstraat 71,2019-04-26,21:00:00,16,6,10,FMN GV 11 Ramsel
66,Bergstraat 71,2019-04-26,22:00:00,4,2,2,FMN GV 11 Ramsel
66,Bergstraat 71,2019-04-26,23:00:00,12,12,0,FMN GV 11 Ramsel
66,Bergstraat 71,2019-04-27,00:00:00,6,2,4,FMN GV 11 Ramsel
66,Bergstraat 71,2019-04-27,01:00:00,4,2,2,FMN GV 11 Ramsel
66,Bergstraat 71,2019-04-27,02:00:00,4,4,0,FMN GV 11 Ramsel
66,Bergstraat 71,2019-04-27,03:00:00,2,2,0,FMN GV 11 Ramsel
66,Bergstraat 71,2019-04-27,04:00:00,0,0,0,FMN GV 11 Ramsel
66,Bergstraat 71,2019-04-27,05:00:00,2,0,2,FMN GV 11 Ramsel
66,Bergstraat 71,2019-04-27,06:00:00,0,0,0,FMN GV 11 Ramsel
66,Bergstraat 71,2019-04-27,07:00:00,12,2,10,FMN GV 11 Ramsel
66,Bergstraat 71,2019-04-27,08:00:00,20,6,14,FMN GV 11 Ramsel
66,Bergstraat 71,2019-04-27,09:00:00,54,50,4,FMN GV 11 Ramsel
66,Bergstraat 71,2019-04-27,10:00:00,20,12,8,FMN GV 11 Ramsel
66,Bergstraat 71,2019-04-27,11:00:00,26,10,16,FMN GV 11 Ramsel
66,Bergstraat 71,2019-04-27,12:00:00,22,14,8,FMN GV 11 Ramsel
66,Bergstraat 71,2019-04-27,13:00:00,40,16,24,FMN GV 11 Ramsel
66,Bergstraat 71,2019-04-27,14:00:00,30,16,14,FMN GV 11 Ramsel
66,Bergstraat 71,2019-04-27,15:00:00,30,12,18,FMN GV 11 Ramsel
66,Bergstraat 71,2019-04-27,16:00:00,50,34,16,FMN GV 11 Ramsel
66,Bergstraat 71,2019-04-27,17:00:00,22,10,12,FMN GV 11 Ramsel
66,Bergstraat 71,2019-04-27,18:00:00,10,8,2,FMN GV 11 Ramsel
66,Bergstraat 71,2019-04-27,19:00:00,12,6,6,FMN GV 11 Ramsel
66,Bergstraat 71,2019-04-27,20:00:00,10,2,8,FMN GV 11 Ramsel
66,Bergstraat 71,2019-04-27,21:00:00,4,2,2,FMN GV 11 Ramsel
66,Bergstraat 71,2019-04-27,22:00:00,4,4,0,FMN GV 11 Ramsel
66,Bergstraat 71,2019-04-27,23:00:00,2,2,0,FMN GV 11 Ramsel
66,Bergstraat 71,2019-04-28,00:00:00,10,8,2,FMN GV 11 Ramsel
66,Bergstraat 71,2019-04-28,01:00:00,2,0,2,FMN GV 11 Ramsel
66,Bergstraat 71,2019-04-28,02:00:00,2,2,0,FMN GV 11 Ramsel
66,Bergstraat 71,2019-04-28,03:00:00,0,0,0,FMN GV 11 Ramsel
66,Bergstraat 71,2019-04-28,04:00:00,0,0,0,FMN GV 11 Ramsel
66,Bergstraat 71,2019-04-28,05:00:00,4,2,2,FMN GV 11 Ramsel
66,Bergstraat 71,2019-04-28,06:00:00,2,0,2,FMN GV 11 Ramsel
66,Bergstraat 71,2019-04-28,07:00:00,2,0,2,FMN GV 11 Ramsel
66,Bergstraat 71,2019-04-28,08:00:00,22,2,20,FMN GV 11 Ramsel
66,Bergstraat 71,2019-04-28,09:00:00,84,58,26,FMN GV 11 Ramsel
66,Bergstraat 71,2019-04-28,10:00:00,44,16,28,FMN GV 11 Ramsel
66,Bergstraat 71,2019-04-28,11:00:00,44,26,18,FMN GV 11 Ramsel
66,Bergstraat 71,2019-04-28,12:00:00,62,34,28,FMN GV 11 Ramsel
66,Bergstraat 71,2019-04-28,13:00:00,22,8,14,FMN GV 11 Ramsel
66,Bergstraat 71,2019-04-28,14:00:00,28,18,10,FMN GV 11 Ramsel
66,Bergstraat 71,2019-04-28,15:00:00,42,28,14,FMN GV 11 Ramsel
66,Bergstraat 71,2019-04-28,16:00:00,36,22,14,FMN GV 11 Ramsel
66,Bergstraat 71,2019-04-28,17:00:00,32,18,14,FMN GV 11 Ramsel
66,Bergstraat 71,2019-04-28,18:00:00,24,10,14,FMN GV 11 Ramsel
66,Bergstraat 71,2019-04-28,19:00:00,16,12,4,FMN GV 11 Ramsel
66,Bergstraat 71,2019-04-28,20:00:00,10,4,6,FMN GV 11 Ramsel
66,Bergstraat 71,2019-04-28,21:00:00,4,4,0,FMN GV 11 Ramsel
66,Bergstraat 71,2019-04-28,22:00:00,2,2,0,FMN GV 11 Ramsel
66,Bergstraat 71,2019-04-28,23:00:00,0,0,0,FMN GV 11 Ramsel
66,Bergstraat 71,2019-04-29,00:00:00,0,0,0,FMN GV 11 Ramsel
66,Bergstraat 71,2019-04-29,01:00:00,0,0,0,FMN GV 11 Ramsel
66,Bergstraat 71,2019-04-29,02:00:00,2,2,0,FMN GV 11 Ramsel
66,Bergstraat 71,2019-04-29,03:00:00,0,0,0,FMN GV 11 Ramsel
66,Bergstraat 71,2019-04-29,04:00:00,2,2,0,FMN GV 11 Ramsel
66,Bergstraat 71,2019-04-29,05:00:00,8,2,6,FMN GV 11 Ramsel
66,Bergstraat 71,2019-04-29,06:00:00,64,18,46,FMN GV 11 Ramsel
66,Bergstraat 71,2019-04-29,07:00:00,186,18,168,FMN GV 11 Ramsel
66,Bergstraat 71,2019-04-29,08:00:00,162,20,142,FMN GV 11 Ramsel
66,Bergstraat 71,2019-04-29,09:00:00,60,26,34,FMN GV 11 Ramsel
66,Bergstraat 71,2019-04-29,10:00:00,56,22,34,FMN GV 11 Ramsel
66,Bergstraat 71,2019-04-29,11:00:00,38,24,14,FMN GV 11 Ramsel
66,Bergstraat 71,2019-04-29,12:00:00,94,50,44,FMN GV 11 Ramsel
66,Bergstraat 71,2019-04-29,13:00:00,186,66,120,FMN GV 11 Ramsel
66,Bergstraat 71,2019-04-29,14:00:00,204,114,90,FMN GV 11 Ramsel
66,Bergstraat 71,2019-04-29,15:00:00,276,208,68,FMN GV 11 Ramsel
66,Bergstraat 71,2019-04-29,16:00:00,200,160,40,FMN GV 11 Ramsel
66,Bergstraat 71,2019-04-29,17:00:00,152,96,56,FMN GV 11 Ramsel
66,Bergstraat 71,2019-04-29,18:00:00,86,46,40,FMN GV 11 Ramsel
66,Bergstraat 71,2019-04-29,19:00:00,54,36,18,FMN GV 11 Ramsel
66,Bergstraat 71,2019-04-29,20:00:00,38,22,16,FMN GV 11 Ramsel
66,Bergstraat 71,2019-04-29,21:00:00,24,16,8,FMN GV 11 Ramsel
66,Bergstraat 71,2019-04-29,22:00:00,8,8,0,FMN GV 11 Ramsel
66,Bergstraat 71,2019-04-29,23:00:00,2,2,0,FMN GV 11 Ramsel
66,Bergstraat 71,2019-04-30,00:00:00,0,0,0,FMN GV 11 Ramsel
66,Bergstraat 71,2019-04-30,01:00:00,0,0,0,FMN GV 11 Ramsel
66,Bergstraat 71,2019-04-30,02:00:00,0,0,0,FMN GV 11 Ramsel
66,Bergstraat 71,2019-04-30,03:00:00,0,0,0,FMN GV 11 Ramsel
66,Bergstraat 71,2019-04-30,04:00:00,2,2,0,FMN GV 11 Ramsel
66,Bergstraat 71,2019-04-30,05:00:00,14,6,8,FMN GV 11 Ramsel
66,Bergstraat 71,2019-04-30,06:00:00,72,16,56,FMN GV 11 Ramsel
66,Bergstraat 71,2019-04-30,07:00:00,216,42,174,FMN GV 11 Ramsel
66,Bergstraat 71,2019-04-30,08:00:00,196,34,162,FMN GV 11 Ramsel
66,Bergstraat 71,2019-04-30,09:00:00,32,20,12,FMN GV 11 Ramsel
66,Bergstraat 71,2019-04-30,10:00:00,32,18,14,FMN GV 11 Ramsel
66,Bergstraat 71,2019-04-30,11:00:00,62,24,38,FMN GV 11 Ramsel
66,Bergstraat 71,2019-04-30,12:00:00,112,66,46,FMN GV 11 Ramsel
66,Bergstraat 71,2019-04-30,13:00:00,202,102,100,FMN GV 11 Ramsel
66,Bergstraat 71,2019-04-30,14:00:00,174,94,80,FMN GV 11 Ramsel
66,Bergstraat 71,2019-04-30,15:00:00,298,216,82,FMN GV 11 Ramsel
66,Bergstraat 71,2019-04-30,16:00:00,196,140,56,FMN GV 11 Ramsel
66,Bergstraat 71,2019-04-30,17:00:00,138,78,60,FMN GV 11 Ramsel
66,Bergstraat 71,2019-04-30,18:00:00,128,72,56,FMN GV 11 Ramsel
66,Bergstraat 71,2019-04-30,19:00:00,66,32,34,FMN GV 11 Ramsel
66,Bergstraat 71,2019-04-30,20:00:00,82,54,28,FMN GV 11 Ramsel
66,Bergstraat 71,2019-04-30,21:00:00,44,36,8,FMN GV 11 Ramsel
66,Bergstraat 71,2019-04-30,22:00:00,28,18,10,FMN GV 11 Ramsel
66,Bergstraat 71,2019-04-30,23:00:00,12,6,6,FMN GV 11 Ramsel
66,Bergstraat 71,2019-05-01,00:00:00,0,0,0,FMN GV 11 Ramsel
66,Bergstraat 71,2019-05-01,01:00:00,14,6,8,FMN GV 11 Ramsel
66,Bergstraat 71,2019-05-01,02:00:00,6,4,2,FMN GV 11 Ramsel
66,Bergstraat 71,2019-05-01,03:00:00,4,4,0,FMN GV 11 Ramsel
66,Bergstraat 71,2019-05-01,04:00:00,2,2,0,FMN GV 11 Ramsel
66,Bergstraat 71,2019-05-01,05:00:00,2,2,0,FMN GV 11 Ramsel
66,Bergstraat 71,2019-05-01,06:00:00,2,2,0,FMN GV 11 Ramsel
66,Bergstraat 71,2019-05-01,07:00:00,20,8,12,FMN GV 11 Ramsel
66,Bergstraat 71,2019-05-01,08:00:00,28,12,16,FMN GV 11 Ramsel
66,Bergstraat 71,2019-05-01,09:00:00,176,86,90,FMN GV 11 Ramsel
66,Bergstraat 71,2019-05-01,10:00:00,296,108,188,FMN GV 11 Ramsel
66,Bergstraat 71,2019-05-01,11:00:00,198,110,88,FMN GV 11 Ramsel
66,Bergstraat 71,2019-05-01,12:00:00,182,100,82,FMN GV 11 Ramsel
66,Bergstraat 71,2019-05-01,13:00:00,260,124,136,FMN GV 11 Ramsel
66,Bergstraat 71,2019-05-01,14:00:00,350,184,166,FMN GV 11 Ramsel
66,Bergstraat 71,2019-05-01,15:00:00,324,178,146,FMN GV 11 Ramsel
66,Bergstraat 71,2019-05-01,16:00:00,302,174,128,FMN GV 11 Ramsel
66,Bergstraat 71,2019-05-01,17:00:00,164,82,82,FMN GV 11 Ramsel
66,Bergstraat 71,2019-05-01,18:00:00,130,86,44,FMN GV 11 Ramsel
66,Bergstraat 71,2019-05-01,19:00:00,42,22,20,FMN GV 11 Ramsel
66,Bergstraat 71,2019-05-01,20:00:00,86,46,40,FMN GV 11 Ramsel
66,Bergstraat 71,2019-05-01,21:00:00,12,10,2,FMN GV 11 Ramsel
66,Bergstraat 71,2019-05-01,22:00:00,4,4,0,FMN GV 11 Ramsel
66,Bergstraat 71,2019-05-01,23:00:00,10,4,6,FMN GV 11 Ramsel
66,Bergstraat 71,2019-05-02,00:00:00,0,0,0,FMN GV 11 Ramsel
66,Bergstraat 71,2019-05-02,01:00:00,0,0,0,FMN GV 11 Ramsel
66,Bergstraat 71,2019-05-02,02:00:00,2,2,0,FMN GV 11 Ramsel
66,Bergstraat 71,2019-05-02,03:00:00,0,0,0,FMN GV 11 Ramsel
66,Bergstraat 71,2019-05-02,04:00:00,4,2,2,FMN GV 11 Ramsel
66,Bergstraat 71,2019-05-02,05:00:00,12,4,8,FMN GV 11 Ramsel
66,Bergstraat 71,2019-05-02,06:00:00,34,10,24,FMN GV 11 Ramsel
66,Bergstraat 71,2019-05-02,07:00:00,176,32,144,FMN GV 11 Ramsel
66,Bergstraat 71,2019-05-02,08:00:00,190,60,130,FMN GV 11 Ramsel
66,Bergstraat 71,2019-05-02,09:00:00,78,36,42,FMN GV 11 Ramsel
66,Bergstraat 71,2019-05-02,10:00:00,62,22,40,FMN GV 11 Ramsel
66,Bergstraat 71,2019-05-02,11:00:00,64,36,28,FMN GV 11 Ramsel
66,Bergstraat 71,2019-05-02,12:00:00,44,30,14,FMN GV 11 Ramsel
66,Bergstraat 71,2019-05-02,13:00:00,58,18,40,FMN GV 11 Ramsel
66,Bergstraat 71,2019-05-02,14:00:00,40,26,14,FMN GV 11 Ramsel
66,Bergstraat 71,2019-05-02,15:00:00,138,114,24,FMN GV 11 Ramsel
66,Bergstraat 71,2019-05-02,16:00:00,100,74,26,FMN GV 11 Ramsel
66,Bergstraat 71,2019-05-02,17:00:00,68,42,26,FMN GV 11 Ramsel
66,Bergstraat 71,2019-05-02,18:00:00,44,40,4,FMN GV 11 Ramsel
66,Bergstraat 71,2019-05-02,19:00:00,28,16,12,FMN GV 11 Ramsel
66,Bergstraat 71,2019-05-02,20:00:00,20,8,12,FMN GV 11 Ramsel
66,Bergstraat 71,2019-05-02,21:00:00,8,6,2,FMN GV 11 Ramsel
66,Bergstraat 71,2019-05-02,22:00:00,6,6,0,FMN GV 11 Ramsel
66,Bergstraat 71,2019-05-02,23:00:00,2,2,0,FMN GV 11 Ramsel
66,Bergstraat 71,2019-05-03,00:00:00,2,0,2,FMN GV 11 Ramsel
66,Bergstraat 71,2019-05-03,01:00:00,0,0,0,FMN GV 11 Ramsel
66,Bergstraat 71,2019-05-03,02:00:00,0,0,0,FMN GV 11 Ramsel
66,Bergstraat 71,2019-05-03,03:00:00,0,0,0,FMN GV 11 Ramsel
66,Bergstraat 71,2019-05-03,04:00:00,2,2,0,FMN GV 11 Ramsel
66,Bergstraat 71,2019-05-03,05:00:00,8,2,6,FMN GV 11 Ramsel
66,Bergstraat 71,2019-05-03,06:00:00,36,14,22,FMN GV 11 Ramsel
66,Bergstraat 71,2019-05-03,07:00:00,170,22,148,FMN GV 11 Ramsel
66,Bergstraat 71,2019-05-03,08:00:00,182,60,122,FMN GV 11 Ramsel
66,Bergstraat 71,2019-05-03,09:00:00,38,10,28,FMN GV 11 Ramsel
66,Bergstraat 71,2019-05-03,10:00:00,36,14,22,FMN GV 11 Ramsel
66,Bergstraat 71,2019-05-03,11:00:00,46,22,24,FMN GV 11 Ramsel
66,Bergstraat 71,2019-05-03,12:00:00,66,18,48,FMN GV 11 Ramsel
66,Bergstraat 71,2019-05-03,13:00:00,94,50,44,FMN GV 11 Ramsel
66,Bergstraat 71,2019-05-03,14:00:00,94,44,50,FMN GV 11 Ramsel
66,Bergstraat 71,2019-05-03,15:00:00,214,174,40,FMN GV 11 Ramsel
66,Bergstraat 71,2019-05-03,16:00:00,134,98,36,FMN GV 11 Ramsel
66,Bergstraat 71,2019-05-03,17:00:00,80,62,18,FMN GV 11 Ramsel
66,Bergstraat 71,2019-05-03,18:00:00,76,56,20,FMN GV 11 Ramsel
66,Bergstraat 71,2019-05-03,19:00:00,60,16,44,FMN GV 11 Ramsel
66,Bergstraat 71,2019-05-03,20:00:00,22,8,14,FMN GV 11 Ramsel
66,Bergstraat 71,2019-05-03,21:00:00,18,4,14,FMN GV 11 Ramsel
66,Bergstraat 71,2019-05-03,22:00:00,2,2,0,FMN GV 11 Ramsel
66,Bergstraat 71,2019-05-03,23:00:00,4,0,4,FMN GV 11 Ramsel
66,Bergstraat 71,2019-05-04,00:00:00,8,6,2,FMN GV 11 Ramsel
66,Bergstraat 71,2019-05-04,01:00:00,6,2,4,FMN GV 11 Ramsel
66,Bergstraat 71,2019-05-04,02:00:00,16,14,2,FMN GV 11 Ramsel
66,Bergstraat 71,2019-05-04,03:00:00,0,0,0,FMN GV 11 Ramsel
66,Bergstraat 71,2019-05-04,04:00:00,16,14,2,FMN GV 11 Ramsel
66,Bergstraat 71,2019-05-04,05:00:00,6,2,4,FMN GV 11 Ramsel
66,Bergstraat 71,2019-05-04,06:00:00,0,0,0,FMN GV 11 Ramsel
66,Bergstraat 71,2019-05-04,07:00:00,16,4,12,FMN GV 11 Ramsel
66,Bergstraat 71,2019-05-04,08:00:00,10,8,2,FMN GV 11 Ramsel
66,Bergstraat 71,2019-05-04,09:00:00,36,16,20,FMN GV 11 Ramsel
66,Bergstraat 71,2019-05-04,10:00:00,48,16,32,FMN GV 11 Ramsel
66,Bergstraat 71,2019-05-04,11:00:00,38,18,20,FMN GV 11 Ramsel
66,Bergstraat 71,2019-05-04,12:00:00,16,10,6,FMN GV 11 Ramsel
66,Bergstraat 71,2019-05-04,13:00:00,20,10,10,FMN GV 11 Ramsel
66,Bergstraat 71,2019-05-04,14:00:00,32,20,12,FMN GV 11 Ramsel
66,Bergstraat 71,2019-05-04,15:00:00,18,6,12,FMN GV 11 Ramsel
66,Bergstraat 71,2019-05-04,16:00:00,30,24,6,FMN GV 11 Ramsel
66,Bergstraat 71,2019-05-04,17:00:00,16,6,10,FMN GV 11 Ramsel
66,Bergstraat 71,2019-05-04,18:00:00,6,2,4,FMN GV 11 Ramsel
66,Bergstraat 71,2019-05-04,19:00:00,4,4,0,FMN GV 11 Ramsel
66,Bergstraat 71,2019-05-04,20:00:00,10,8,2,FMN GV 11 Ramsel
66,Bergstraat 71,2019-05-04,21:00:00,6,6,0,FMN GV 11 Ramsel
66,Bergstraat 71,2019-05-04,22:00:00,4,2,2,FMN GV 11 Ramsel
66,Bergstraat 71,2019-05-04,23:00:00,4,2,2,FMN GV 11 Ramsel
66,Bergstraat 71,2019-05-05,00:00:00,2,2,0,FMN GV 11 Ramsel
66,Bergstraat 71,2019-05-05,01:00:00,2,0,2,FMN GV 11 Ramsel
66,Bergstraat 71,2019-05-05,02:00:00,2,0,2,FMN GV 11 Ramsel
66,Bergstraat 71,2019-05-05,03:00:00,6,2,4,FMN GV 11 Ramsel
66,Bergstraat 71,2019-05-05,04:00:00,0,0,0,FMN GV 11 Ramsel
66,Bergstraat 71,2019-05-05,05:00:00,6,6,0,FMN GV 11 Ramsel
66,Bergstraat 71,2019-05-05,06:00:00,0,0,0,FMN GV 11 Ramsel
66,Bergstraat 71,2019-05-05,07:00:00,28,12,16,FMN GV 11 Ramsel
66,Bergstraat 71,2019-05-05,08:00:00,60,26,34,FMN GV 11 Ramsel
66,Bergstraat 71,2019-05-05,09:00:00,88,42,46,FMN GV 11 Ramsel
66,Bergstraat 71,2019-05-05,10:00:00,92,56,36,FMN GV 11 Ramsel
66,Bergstraat 71,2019-05-05,11:00:00,140,92,48,FMN GV 11 Ramsel
66,Bergstraat 71,2019-05-05,12:00:00,68,22,46,FMN GV 11 Ramsel
66,Bergstraat 71,2019-05-05,13:00:00,38,16,22,FMN GV 11 Ramsel
66,Bergstraat 71,2019-05-05,14:00:00,72,32,40,FMN GV 11 Ramsel
66,Bergstraat 71,2019-05-05,15:00:00,64,44,20,FMN GV 11 Ramsel
66,Bergstraat 71,2019-05-05,16:00:00,14,10,4,FMN GV 11 Ramsel
66,Bergstraat 71,2019-05-05,17:00:00,36,14,22,FMN GV 11 Ramsel
66,Bergstraat 71,2019-05-05,18:00:00,12,2,10,FMN GV 11 Ramsel
66,Bergstraat 71,2019-05-05,19:00:00,20,12,8,FMN GV 11 Ramsel
66,Bergstraat 71,2019-05-05,20:00:00,20,14,6,FMN GV 11 Ramsel
66,Bergstraat 71,2019-05-05,21:00:00,2,2,0,FMN GV 11 Ramsel
66,Bergstraat 71,2019-05-05,22:00:00,2,2,0,FMN GV 11 Ramsel
66,Bergstraat 71,2019-05-05,23:00:00,2,2,0,FMN GV 11 Ramsel
66,Bergstraat 71,2019-05-06,00:00:00,0,0,0,FMN GV 11 Ramsel
66,Bergstraat 71,2019-05-06,01:00:00,6,2,4,FMN GV 11 Ramsel
66,Bergstraat 71,2019-05-06,02:00:00,2,2,0,FMN GV 11 Ramsel
66,Bergstraat 71,2019-05-06,03:00:00,0,0,0,FMN GV 11 Ramsel
66,Bergstraat 71,2019-05-06,04:00:00,2,2,0,FMN GV 11 Ramsel
66,Bergstraat 71,2019-05-06,05:00:00,4,2,2,FMN GV 11 Ramsel
66,Bergstraat 71,2019-05-06,06:00:00,42,12,30,FMN GV 11 Ramsel
66,Bergstraat 71,2019-05-06,07:00:00,154,12,142,FMN GV 11 Ramsel
66,Bergstraat 71,2019-05-06,08:00:00,174,22,152,FMN GV 11 Ramsel
66,Bergstraat 71,2019-05-06,09:00:00,32,10,22,FMN GV 11 Ramsel
66,Bergstraat 71,2019-05-06,10:00:00,26,16,10,FMN GV 11 Ramsel
66,Bergstraat 71,2019-05-06,11:00:00,18,8,10,FMN GV 11 Ramsel
66,Bergstraat 71,2019-05-06,12:00:00,34,26,8,FMN GV 11 Ramsel
66,Bergstraat 71,2019-05-06,13:00:00,94,62,32,FMN GV 11 Ramsel
66,Bergstraat 71,2019-05-06,14:00:00,44,24,20,FMN GV 11 Ramsel
66,Bergstraat 71,2019-05-06,15:00:00,170,158,12,FMN GV 11 Ramsel
66,Bergstraat 71,2019-05-06,16:00:00,126,116,10,FMN GV 11 Ramsel
66,Bergstraat 71,2019-05-06,17:00:00,62,48,14,FMN GV 11 Ramsel
66,Bergstraat 71,2019-05-06,18:00:00,48,28,20,FMN GV 11 Ramsel
66,Bergstraat 71,2019-05-06,19:00:00,36,18,18,FMN GV 11 Ramsel
66,Bergstraat 71,2019-05-06,20:00:00,20,16,4,FMN GV 11 Ramsel
66,Bergstraat 71,2019-05-06,21:00:00,26,20,6,FMN GV 11 Ramsel
66,Bergstraat 71,2019-05-06,22:00:00,10,6,4,FMN GV 11 Ramsel
66,Bergstraat 71,2019-05-06,23:00:00,2,2,0,FMN GV 11 Ramsel
66,Bergstraat 71,2019-05-07,00:00:00,2,2,0,FMN GV 11 Ramsel
66,Bergstraat 71,2019-05-07,01:00:00,0,0,0,FMN GV 11 Ramsel
66,Bergstraat 71,2019-05-07,02:00:00,0,0,0,FMN GV 11 Ramsel
66,Bergstraat 71,2019-05-07,03:00:00,0,0,0,FMN GV 11 Ramsel
66,Bergstraat 71,2019-05-07,04:00:00,2,2,0,FMN GV 11 Ramsel
66,Bergstraat 71,2019-05-07,05:00:00,6,4,2,FMN GV 11 Ramsel
66,Bergstraat 71,2019-05-07,06:00:00,68,14,54,FMN GV 11 Ramsel
66,Bergstraat 71,2019-05-07,07:00:00,172,20,152,FMN GV 11 Ramsel
66,Bergstraat 71,2019-05-07,08:00:00,164,20,144,FMN GV 11 Ramsel
66,Bergstraat 71,2019-05-07,09:00:00,68,24,44,FMN GV 11 Ramsel
66,Bergstraat 71,2019-05-07,10:00:00,74,34,40,FMN GV 11 Ramsel
66,Bergstraat 71,2019-05-07,11:00:00,136,92,44,FMN GV 11 Ramsel
66,Bergstraat 71,2019-05-07,12:00:00,114,64,50,FMN GV 11 Ramsel
66,Bergstraat 71,2019-05-07,13:00:00,154,76,78,FMN GV 11 Ramsel
66,Bergstraat 71,2019-05-07,14:00:00,180,112,68,FMN GV 11 Ramsel
66,Bergstraat 71,2019-05-07,15:00:00,308,222,86,FMN GV 11 Ramsel
66,Bergstraat 71,2019-05-07,16:00:00,206,158,48,FMN GV 11 Ramsel
66,Bergstraat 71,2019-05-07,17:00:00,148,98,50,FMN GV 11 Ramsel
66,Bergstraat 71,2019-05-07,18:00:00,86,40,46,FMN GV 11 Ramsel
66,Bergstraat 71,2019-05-07,19:00:00,62,24,38,FMN GV 11 Ramsel
66,Bergstraat 71,2019-05-07,20:00:00,66,52,14,FMN GV 11 Ramsel
66,Bergstraat 71,2019-05-07,21:00:00,44,34,10,FMN GV 11 Ramsel
66,Bergstraat 71,2019-05-07,22:00:00,6,4,2,FMN GV 11 Ramsel
66,Bergstraat 71,2019-05-07,23:00:00,0,0,0,FMN GV 11 Ramsel
66,Bergstraat 71,2019-05-08,00:00:00,0,0,0,FMN GV 11 Ramsel
66,Bergstraat 71,2019-05-08,01:00:00,0,0,0,FMN GV 11 Ramsel
66,Bergstraat 71,2019-05-08,02:00:00,0,0,0,FMN GV 11 Ramsel
66,Bergstraat 71,2019-05-08,03:00:00,0,0,0,FMN GV 11 Ramsel
66,Bergstraat 71,2019-05-08,04:00:00,2,2,0,FMN GV 11 Ramsel
66,Bergstraat 71,2019-05-08,05:00:00,8,2,6,FMN GV 11 Ramsel
66,Bergstraat 71,2019-05-08,06:00:00,36,12,24,FMN GV 11 Ramsel
66,Bergstraat 71,2019-05-08,07:00:00,140,14,126,FMN GV 11 Ramsel
66,Bergstraat 71,2019-05-08,08:00:00,126,20,106,FMN GV 11 Ramsel
66,Bergstraat 71,2019-05-08,09:00:00,30,22,8,FMN GV 11 Ramsel
66,Bergstraat 71,2019-05-08,10:00:00,26,20,6,FMN GV 11 Ramsel
66,Bergstraat 71,2019-05-08,11:00:00,24,20,4,FMN GV 11 Ramsel
66,Bergstraat 71,2019-05-08,12:00:00,16,14,2,FMN GV 11 Ramsel
66,Bergstraat 71,2019-05-08,13:00:00,20,16,4,FMN GV 11 Ramsel
66,Bergstraat 71,2019-05-08,14:00:00,18,6,12,FMN GV 11 Ramsel
66,Bergstraat 71,2019-05-08,15:00:00,48,24,24,FMN GV 11 Ramsel
66,Bergstraat 71,2019-05-08,16:00:00,38,30,8,FMN GV 11 Ramsel
66,Bergstraat 71,2019-05-08,17:00:00,54,28,26,FMN GV 11 Ramsel
66,Bergstraat 71,2019-05-08,18:00:00,40,30,10,FMN GV 11 Ramsel
66,Bergstraat 71,2019-05-08,19:00:00,34,18,16,FMN GV 11 Ramsel
66,Bergstraat 71,2019-05-08,20:00:00,14,10,4,FMN GV 11 Ramsel
66,Bergstraat 71,2019-05-08,21:00:00,2,2,0,FMN GV 11 Ramsel
66,Bergstraat 71,2019-05-08,22:00:00,8,8,0,FMN GV 11 Ramsel
66,Bergstraat 71,2019-05-08,23:00:00,2,2,0,FMN GV 11 Ramsel
66,Bergstraat 71,2019-05-09,00:00:00,0,0,0,FMN GV 11 Ramsel
66,Bergstraat 71,2019-05-09,01:00:00,0,0,0,FMN GV 11 Ramsel
66,Bergstraat 71,2019-05-09,02:00:00,0,0,0,FMN GV 11 Ramsel
66,Bergstraat 71,2019-05-09,03:00:00,0,0,0,FMN GV 11 Ramsel
66,Bergstraat 71,2019-05-09,04:00:00,4,2,2,FMN GV 11 Ramsel
66,Bergstraat 71,2019-05-09,05:00:00,6,2,4,FMN GV 11 Ramsel
66,Bergstraat 71,2019-05-09,06:00:00,34,8,26,FMN GV 11 Ramsel
66,Bergstraat 71,2019-05-09,07:00:00,102,16,86,FMN GV 11 Ramsel
66,Bergstraat 71,2019-05-09,08:00:00,98,20,78,FMN GV 11 Ramsel
66,Bergstraat 71,2019-05-09,09:00:00,56,24,32,FMN GV 11 Ramsel
66,Bergstraat 71,2019-05-09,10:00:00,44,20,24,FMN GV 11 Ramsel
66,Bergstraat 71,2019-05-09,11:00:00,34,12,22,FMN GV 11 Ramsel
66,Bergstraat 71,2019-05-09,12:00:00,48,22,26,FMN GV 11 Ramsel
66,Bergstraat 71,2019-05-09,13:00:00,40,16,24,FMN GV 11 Ramsel
66,Bergstraat 71,2019-05-09,14:00:00,104,44,60,FMN GV 11 Ramsel
66,Bergstraat 71,2019-05-09,15:00:00,168,138,30,FMN GV 11 Ramsel
66,Bergstraat 71,2019-05-09,16:00:00,158,128,30,FMN GV 11 Ramsel
66,Bergstraat 71,2019-05-09,17:00:00,78,48,30,FMN GV 11 Ramsel
66,Bergstraat 71,2019-05-09,18:00:00,36,24,12,FMN GV 11 Ramsel
66,Bergstraat 71,2019-05-09,19:00:00,20,4,16,FMN GV 11 Ramsel
66,Bergstraat 71,2019-05-09,20:00:00,32,24,8,FMN GV 11 Ramsel
66,Bergstraat 71,2019-05-09,21:00:00,20,14,6,FMN GV 11 Ramsel
66,Bergstraat 71,2019-05-09,22:00:00,8,4,4,FMN GV 11 Ramsel
66,Bergstraat 71,2019-05-09,23:00:00,2,2,0,FMN GV 11 Ramsel
66,Bergstraat 71,2019-05-10,00:00:00,2,2,0,FMN GV 11 Ramsel
66,Bergstraat 71,2019-05-10,01:00:00,0,0,0,FMN GV 11 Ramsel
66,Bergstraat 71,2019-05-10,02:00:00,2,0,2,FMN GV 11 Ramsel
66,Bergstraat 71,2019-05-10,03:00:00,0,0,0,FMN GV 11 Ramsel
66,Bergstraat 71,2019-05-10,04:00:00,2,2,0,FMN GV 11 Ramsel
66,Bergstraat 71,2019-05-10,05:00:00,6,2,4,FMN GV 11 Ramsel
66,Bergstraat 71,2019-05-10,06:00:00,10,0,10,FMN GV 11 Ramsel
66,Bergstraat 71,2019-05-10,07:00:00,114,16,98,FMN GV 11 Ramsel
66,Bergstraat 71,2019-05-10,08:00:00,72,14,58,FMN GV 11 Ramsel
66,Bergstraat 71,2019-05-10,09:00:00,16,6,10,FMN GV 11 Ramsel
66,Bergstraat 71,2019-05-10,10:00:00,28,14,14,FMN GV 11 Ramsel
66,Bergstraat 71,2019-05-10,11:00:00,10,8,2,FMN GV 11 Ramsel
66,Bergstraat 71,2019-05-10,12:00:00,36,14,22,FMN GV 11 Ramsel
66,Bergstraat 71,2019-05-10,13:00:00,80,28,52,FMN GV 11 Ramsel
66,Bergstraat 71,2019-05-10,14:00:00,98,54,44,FMN GV 11 Ramsel
66,Bergstraat 71,2019-05-10,15:00:00,110,88,22,FMN GV 11 Ramsel
66,Bergstraat 71,2019-05-10,16:00:00,98,86,12,FMN GV 11 Ramsel
66,Bergstraat 71,2019-05-10,17:00:00,54,28,26,FMN GV 11 Ramsel
66,Bergstraat 71,2019-05-10,18:00:00,58,38,20,FMN GV 11 Ramsel
66,Bergstraat 71,2019-05-10,19:00:00,30,18,12,FMN GV 11 Ramsel
66,Bergstraat 71,2019-05-10,20:00:00,26,14,12,FMN GV 11 Ramsel
66,Bergstraat 71,2019-05-10,21:00:00,14,8,6,FMN GV 11 Ramsel
66,Bergstraat 71,2019-05-10,22:00:00,6,4,2,FMN GV 11 Ramsel
66,Bergstraat 71,2019-05-10,23:00:00,8,6,2,FMN GV 11 Ramsel
66,Bergstraat 71,2019-05-11,00:00:00,0,0,0,FMN GV 11 Ramsel
66,Bergstraat 71,2019-05-11,01:00:00,6,4,2,FMN GV 11 Ramsel
66,Bergstraat 71,2019-05-11,02:00:00,6,4,2,FMN GV 11 Ramsel
66,Bergstraat 71,2019-05-11,03:00:00,0,0,0,FMN GV 11 Ramsel
66,Bergstraat 71,2019-05-11,04:00:00,0,0,0,FMN GV 11 Ramsel
66,Bergstraat 71,2019-05-11,05:00:00,2,2,0,FMN GV 11 Ramsel
66,Bergstraat 71,2019-05-11,06:00:00,2,0,2,FMN GV 11 Ramsel
66,Bergstraat 71,2019-05-11,07:00:00,16,6,10,FMN GV 11 Ramsel
66,Bergstraat 71,2019-05-11,08:00:00,12,4,8,FMN GV 11 Ramsel
66,Bergstraat 71,2019-05-11,09:00:00,40,8,32,FMN GV 11 Ramsel
66,Bergstraat 71,2019-05-11,10:00:00,38,16,22,FMN GV 11 Ramsel
66,Bergstraat 71,2019-05-11,11:00:00,52,24,28,FMN GV 11 Ramsel
66,Bergstraat 71,2019-05-11,12:00:00,80,42,38,FMN GV 11 Ramsel
66,Bergstraat 71,2019-05-11,13:00:00,88,52,36,FMN GV 11 Ramsel
66,Bergstraat 71,2019-05-11,14:00:00,152,76,76,FMN GV 11 Ramsel
66,Bergstraat 71,2019-05-11,15:00:00,214,104,110,FMN GV 11 Ramsel
66,Bergstraat 71,2019-05-11,16:00:00,92,54,38,FMN GV 11 Ramsel
66,Bergstraat 71,2019-05-11,17:00:00,70,32,38,FMN GV 11 Ramsel
66,Bergstraat 71,2019-05-11,18:00:00,44,28,16,FMN GV 11 Ramsel
66,Bergstraat 71,2019-05-11,19:00:00,34,22,12,FMN GV 11 Ramsel
66,Bergstraat 71,2019-05-11,20:00:00,26,14,12,FMN GV 11 Ramsel
66,Bergstraat 71,2019-05-11,21:00:00,14,4,10,FMN GV 11 Ramsel
66,Bergstraat 71,2019-05-11,22:00:00,16,8,8,FMN GV 11 Ramsel
66,Bergstraat 71,2019-05-11,23:00:00,0,0,0,FMN GV 11 Ramsel
66,Bergstraat 71,2019-05-12,00:00:00,0,0,0,FMN GV 11 Ramsel
66,Bergstraat 71,2019-05-12,01:00:00,2,0,2,FMN GV 11 Ramsel
66,Bergstraat 71,2019-05-12,02:00:00,2,2,0,FMN GV 11 Ramsel
66,Bergstraat 71,2019-05-12,03:00:00,4,4,0,FMN GV 11 Ramsel
66,Bergstraat 71,2019-05-12,04:00:00,0,0,0,FMN GV 11 Ramsel
66,Bergstraat 71,2019-05-12,05:00:00,0,0,0,FMN GV 11 Ramsel
66,Bergstraat 71,2019-05-12,06:00:00,2,0,2,FMN GV 11 Ramsel
66,Bergstraat 71,2019-05-12,07:00:00,54,12,42,FMN GV 11 Ramsel
66,Bergstraat 71,2019-05-12,08:00:00,116,18,98,FMN GV 11 Ramsel
66,Bergstraat 71,2019-05-12,09:00:00,172,92,80,FMN GV 11 Ramsel
66,Bergstraat 71,2019-05-12,10:00:00,148,84,64,FMN GV 11 Ramsel
66,Bergstraat 71,2019-05-12,11:00:00,154,102,52,FMN GV 11 Ramsel
66,Bergstraat 71,2019-05-12,12:00:00,134,86,48,FMN GV 11 Ramsel
66,Bergstraat 71,2019-05-12,13:00:00,166,108,58,FMN GV 11 Ramsel
66,Bergstraat 71,2019-05-12,14:00:00,222,100,122,FMN GV 11 Ramsel
66,Bergstraat 71,2019-05-12,15:00:00,142,80,62,FMN GV 11 Ramsel
66,Bergstraat 71,2019-05-12,16:00:00,150,72,78,FMN GV 11 Ramsel
66,Bergstraat 71,2019-05-12,17:00:00,66,48,18,FMN GV 11 Ramsel
66,Bergstraat 71,2019-05-12,18:00:00,58,14,44,FMN GV 11 Ramsel
66,Bergstraat 71,2019-05-12,19:00:00,38,14,24,FMN GV 11 Ramsel
66,Bergstraat 71,2019-05-12,20:00:00,12,10,2,FMN GV 11 Ramsel
66,Bergstraat 71,2019-05-12,21:00:00,8,2,6,FMN GV 11 Ramsel
66,Bergstraat 71,2019-05-12,22:00:00,0,0,0,FMN GV 11 Ramsel
66,Bergstraat 71,2019-05-12,23:00:00,0,0,0,FMN GV 11 Ramsel
66,Bergstraat 71,2019-05-13,00:00:00,2,2,0,FMN GV 11 Ramsel
66,Bergstraat 71,2019-05-13,01:00:00,4,2,2,FMN GV 11 Ramsel
66,Bergstraat 71,2019-05-13,02:00:00,0,0,0,FMN GV 11 Ramsel
66,Bergstraat 71,2019-05-13,03:00:00,0,0,0,FMN GV 11 Ramsel
66,Bergstraat 71,2019-05-13,04:00:00,4,2,2,FMN GV 11 Ramsel
66,Bergstraat 71,2019-05-13,05:00:00,8,2,6,FMN GV 11 Ramsel
66,Bergstraat 71,2019-05-13,06:00:00,52,16,36,FMN GV 11 Ramsel
66,Bergstraat 71,2019-05-13,07:00:00,166,8,158,FMN GV 11 Ramsel
66,Bergstraat 71,2019-05-13,08:00:00,186,30,156,FMN GV 11 Ramsel
66,Bergstraat 71,2019-05-13,09:00:00,44,16,28,FMN GV 11 Ramsel
66,Bergstraat 71,2019-05-13,10:00:00,54,38,16,FMN GV 11 Ramsel
66,Bergstraat 71,2019-05-13,11:00:00,52,28,24,FMN GV 11 Ramsel
66,Bergstraat 71,2019-05-13,12:00:00,86,42,44,FMN GV 11 Ramsel
66,Bergstraat 71,2019-05-13,13:00:00,162,78,84,FMN GV 11 Ramsel
66,Bergstraat 71,2019-05-13,14:00:00,144,74,70,FMN GV 11 Ramsel
66,Bergstraat 71,2019-05-13,15:00:00,272,208,64,FMN GV 11 Ramsel
66,Bergstraat 71,2019-05-13,16:00:00,232,178,54,FMN GV 11 Ramsel
66,Bergstraat 71,2019-05-13,17:00:00,108,82,26,FMN GV 11 Ramsel
66,Bergstraat 71,2019-05-13,18:00:00,70,36,34,FMN GV 11 Ramsel
66,Bergstraat 71,2019-05-13,19:00:00,46,20,26,FMN GV 11 Ramsel
66,Bergstraat 71,2019-05-13,20:00:00,20,8,12,FMN GV 11 Ramsel
66,Bergstraat 71,2019-05-13,21:00:00,16,12,4,FMN GV 11 Ramsel
66,Bergstraat 71,2019-05-13,22:00:00,8,6,2,FMN GV 11 Ramsel
66,Bergstraat 71,2019-05-13,23:00:00,2,2,0,FMN GV 11 Ramsel
66,Bergstraat 71,2019-05-14,00:00:00,2,2,0,FMN GV 11 Ramsel
66,Bergstraat 71,2019-05-14,01:00:00,0,0,0,FMN GV 11 Ramsel
66,Bergstraat 71,2019-05-14,02:00:00,2,0,2,FMN GV 11 Ramsel
66,Bergstraat 71,2019-05-14,03:00:00,0,0,0,FMN GV 11 Ramsel
66,Bergstraat 71,2019-05-14,04:00:00,2,2,0,FMN GV 11 Ramsel
66,Bergstraat 71,2019-05-14,05:00:00,12,4,8,FMN GV 11 Ramsel
66,Bergstraat 71,2019-05-14,06:00:00,68,18,50,FMN GV 11 Ramsel
66,Bergstraat 71,2019-05-14,07:00:00,228,34,194,FMN GV 11 Ramsel
66,Bergstraat 71,2019-05-14,08:00:00,274,34,240,FMN GV 11 Ramsel
66,Bergstraat 71,2019-05-14,09:00:00,58,20,38,FMN GV 11 Ramsel
66,Bergstraat 71,2019-05-14,10:00:00,46,14,32,FMN GV 11 Ramsel
66,Bergstraat 71,2019-05-14,11:00:00,240,204,36,FMN GV 11 Ramsel
66,Bergstraat 71,2019-05-14,12:00:00,122,54,68,FMN GV 11 Ramsel
66,Bergstraat 71,2019-05-14,13:00:00,196,84,112,FMN GV 11 Ramsel
66,Bergstraat 71,2019-05-14,14:00:00,330,142,188,FMN GV 11 Ramsel
66,Bergstraat 71,2019-05-14,15:00:00,324,228,96,FMN GV 11 Ramsel
66,Bergstraat 71,2019-05-14,16:00:00,246,190,56,FMN GV 11 Ramsel
66,Bergstraat 71,2019-05-14,17:00:00,178,122,56,FMN GV 11 Ramsel
66,Bergstraat 71,2019-05-14,18:00:00,134,46,88,FMN GV 11 Ramsel
66,Bergstraat 71,2019-05-14,19:00:00,84,56,28,FMN GV 11 Ramsel
66,Bergstraat 71,2019-05-14,20:00:00,82,54,28,FMN GV 11 Ramsel
66,Bergstraat 71,2019-05-14,21:00:00,22,14,8,FMN GV 11 Ramsel
66,Bergstraat 71,2019-05-14,22:00:00,22,18,4,FMN GV 11 Ramsel
66,Bergstraat 71,2019-05-14,23:00:00,2,2,0,FMN GV 11 Ramsel
66,Bergstraat 71,2019-05-15,00:00:00,0,0,0,FMN GV 11 Ramsel
66,Bergstraat 71,2019-05-15,01:00:00,0,0,0,FMN GV 11 Ramsel
66,Bergstraat 71,2019-05-15,02:00:00,2,2,0,FMN GV 11 Ramsel
66,Bergstraat 71,2019-05-15,03:00:00,0,0,0,FMN GV 11 Ramsel
66,Bergstraat 71,2019-05-15,04:00:00,2,2,0,FMN GV 11 Ramsel
66,Bergstraat 71,2019-05-15,05:00:00,14,8,6,FMN GV 11 Ramsel
66,Bergstraat 71,2019-05-15,06:00:00,48,18,30,FMN GV 11 Ramsel
66,Bergstraat 71,2019-05-15,07:00:00,202,32,170,FMN GV 11 Ramsel
66,Bergstraat 71,2019-05-15,08:00:00,238,36,202,FMN GV 11 Ramsel
66,Bergstraat 71,2019-05-15,09:00:00,44,22,22,FMN GV 11 Ramsel
66,Bergstraat 71,2019-05-15,10:00:00,112,36,76,FMN GV 11 Ramsel
66,Bergstraat 71,2019-05-15,11:00:00,118,66,52,FMN GV 11 Ramsel
66,Bergstraat 71,2019-05-15,12:00:00,340,272,68,FMN GV 11 Ramsel
66,Bergstraat 71,2019-05-15,13:00:00,210,110,100,FMN GV 11 Ramsel
66,Bergstraat 71,2019-05-15,14:00:00,204,108,96,FMN GV 11 Ramsel
66,Bergstraat 71,2019-05-15,15:00:00,242,88,154,FMN GV 11 Ramsel
66,Bergstraat 71,2019-05-15,16:00:00,176,112,64,FMN GV 11 Ramsel
66,Bergstraat 71,2019-05-15,17:00:00,176,102,74,FMN GV 11 Ramsel
66,Bergstraat 71,2019-05-15,18:00:00,142,70,72,FMN GV 11 Ramsel
66,Bergstraat 71,2019-05-15,19:00:00,118,44,74,FMN GV 11 Ramsel
66,Bergstraat 71,2019-05-15,20:00:00,62,44,18,FMN GV 11 Ramsel
66,Bergstraat 71,2019-05-15,21:00:00,26,26,0,FMN GV 11 Ramsel
66,Bergstraat 71,2019-05-15,22:00:00,12,10,2,FMN GV 11 Ramsel
66,Bergstraat 71,2019-05-15,23:00:00,4,0,4,FMN GV 11 Ramsel
66,Bergstraat 71,2019-05-16,00:00:00,2,2,0,FMN GV 11 Ramsel
66,Bergstraat 71,2019-05-16,01:00:00,0,0,0,FMN GV 11 Ramsel
66,Bergstraat 71,2019-05-16,02:00:00,0,0,0,FMN GV 11 Ramsel
66,Bergstraat 71,2019-05-16,03:00:00,0,0,0,FMN GV 11 Ramsel
66,Bergstraat 71,2019-05-16,04:00:00,2,2,0,FMN GV 11 Ramsel
66,Bergstraat 71,2019-05-16,05:00:00,14,4,10,FMN GV 11 Ramsel
66,Bergstraat 71,2019-05-16,06:00:00,48,18,30,FMN GV 11 Ramsel
66,Bergstraat 71,2019-05-16,07:00:00,174,20,154,FMN GV 11 Ramsel
66,Bergstraat 71,2019-05-16,08:00:00,206,32,174,FMN GV 11 Ramsel
66,Bergstraat 71,2019-05-16,09:00:00,84,14,70,FMN GV 11 Ramsel
66,Bergstraat 71,2019-05-16,10:00:00,66,32,34,FMN GV 11 Ramsel
66,Bergstraat 71,2019-05-16,11:00:00,98,62,36,FMN GV 11 Ramsel
66,Bergstraat 71,2019-05-16,12:00:00,86,46,40,FMN GV 11 Ramsel
66,Bergstraat 71,2019-05-16,13:00:00,166,100,66,FMN GV 11 Ramsel
66,Bergstraat 71,2019-05-16,14:00:00,148,54,94,FMN GV 11 Ramsel
66,Bergstraat 71,2019-05-16,15:00:00,336,254,82,FMN GV 11 Ramsel
66,Bergstraat 71,2019-05-16,16:00:00,250,152,98,FMN GV 11 Ramsel
66,Bergstraat 71,2019-05-16,17:00:00,146,98,48,FMN GV 11 Ramsel
66,Bergstraat 71,2019-05-16,18:00:00,92,46,46,FMN GV 11 Ramsel
66,Bergstraat 71,2019-05-16,19:00:00,60,34,26,FMN GV 11 Ramsel
66,Bergstraat 71,2019-05-16,20:00:00,62,24,38,FMN GV 11 Ramsel
66,Bergstraat 71,2019-05-16,21:00:00,18,16,2,FMN GV 11 Ramsel
66,Bergstraat 71,2019-05-16,22:00:00,10,8,2,FMN GV 11 Ramsel
66,Bergstraat 71,2019-05-16,23:00:00,4,2,2,FMN GV 11 Ramsel
66,Bergstraat 71,2019-05-17,00:00:00,6,6,0,FMN GV 11 Ramsel
66,Bergstraat 71,2019-05-17,01:00:00,2,2,0,FMN GV 11 Ramsel
66,Bergstraat 71,2019-05-17,02:00:00,0,0,0,FMN GV 11 Ramsel
66,Bergstraat 71,2019-05-17,03:00:00,0,0,0,FMN GV 11 Ramsel
66,Bergstraat 71,2019-05-17,04:00:00,2,2,0,FMN GV 11 Ramsel
66,Bergstraat 71,2019-05-17,05:00:00,10,8,2,FMN GV 11 Ramsel
66,Bergstraat 71,2019-05-17,06:00:00,36,10,26,FMN GV 11 Ramsel
66,Bergstraat 71,2019-05-17,07:00:00,140,22,118,FMN GV 11 Ramsel
66,Bergstraat 71,2019-05-17,08:00:00,188,36,152,FMN GV 11 Ramsel
66,Bergstraat 71,2019-05-17,09:00:00,52,16,36,FMN GV 11 Ramsel
66,Bergstraat 71,2019-05-17,10:00:00,44,28,16,FMN GV 11 Ramsel
66,Bergstraat 71,2019-05-17,11:00:00,52,14,38,FMN GV 11 Ramsel
66,Bergstraat 71,2019-05-17,12:00:00,64,28,36,FMN GV 11 Ramsel
66,Bergstraat 71,2019-05-17,13:00:00,54,18,36,FMN GV 11 Ramsel
66,Bergstraat 71,2019-05-17,14:00:00,104,56,48,FMN GV 11 Ramsel
66,Bergstraat 71,2019-05-17,15:00:00,210,182,28,FMN GV 11 Ramsel
66,Bergstraat 71,2019-05-17,16:00:00,110,76,34,FMN GV 11 Ramsel
66,Bergstraat 71,2019-05-17,17:00:00,106,72,34,FMN GV 11 Ramsel
66,Bergstraat 71,2019-05-17,18:00:00,58,28,30,FMN GV 11 Ramsel
66,Bergstraat 71,2019-05-17,19:00:00,54,14,40,FMN GV 11 Ramsel
66,Bergstraat 71,2019-05-17,20:00:00,40,18,22,FMN GV 11 Ramsel
66,Bergstraat 71,2019-05-17,21:00:00,40,30,10,FMN GV 11 Ramsel
66,Bergstraat 71,2019-05-17,22:00:00,10,8,2,FMN GV 11 Ramsel
66,Bergstraat 71,2019-05-17,23:00:00,6,2,4,FMN GV 11 Ramsel
66,Bergstraat 71,2019-05-18,00:00:00,4,0,4,FMN GV 11 Ramsel
66,Bergstraat 71,2019-05-18,01:00:00,0,0,0,FMN GV 11 Ramsel
66,Bergstraat 71,2019-05-18,02:00:00,4,4,0,FMN GV 11 Ramsel
66,Bergstraat 71,2019-05-18,03:00:00,0,0,0,FMN GV 11 Ramsel
66,Bergstraat 71,2019-05-18,04:00:00,0,0,0,FMN GV 11 Ramsel
66,Bergstraat 71,2019-05-18,05:00:00,6,0,6,FMN GV 11 Ramsel
66,Bergstraat 71,2019-05-18,06:00:00,10,6,4,FMN GV 11 Ramsel
66,Bergstraat 71,2019-05-18,07:00:00,16,10,6,FMN GV 11 Ramsel
66,Bergstraat 71,2019-05-18,08:00:00,38,10,28,FMN GV 11 Ramsel
66,Bergstraat 71,2019-05-18,09:00:00,96,28,68,FMN GV 11 Ramsel
66,Bergstraat 71,2019-05-18,10:00:00,108,34,74,FMN GV 11 Ramsel
66,Bergstraat 71,2019-05-18,11:00:00,112,58,54,FMN GV 11 Ramsel
66,Bergstraat 71,2019-05-18,12:00:00,130,70,60,FMN GV 11 Ramsel
66,Bergstraat 71,2019-05-18,13:00:00,182,68,114,FMN GV 11 Ramsel
66,Bergstraat 71,2019-05-18,14:00:00,242,112,130,FMN GV 11 Ramsel
66,Bergstraat 71,2019-05-18,15:00:00,198,114,84,FMN GV 11 Ramsel
66,Bergstraat 71,2019-05-18,16:00:00,188,88,100,FMN GV 11 Ramsel
66,Bergstraat 71,2019-05-18,17:00:00,108,60,48,FMN GV 11 Ramsel
66,Bergstraat 71,2019-05-18,18:00:00,62,44,18,FMN GV 11 Ramsel
66,Bergstraat 71,2019-05-18,19:00:00,34,20,14,FMN GV 11 Ramsel
66,Bergstraat 71,2019-05-18,20:00:00,26,8,18,FMN GV 11 Ramsel
66,Bergstraat 71,2019-05-18,21:00:00,14,10,4,FMN GV 11 Ramsel
66,Bergstraat 71,2019-05-18,22:00:00,26,16,10,FMN GV 11 Ramsel
66,Bergstraat 71,2019-05-18,23:00:00,12,10,2,FMN GV 11 Ramsel
66,Bergstraat 71,2019-05-19,00:00:00,2,2,0,FMN GV 11 Ramsel
66,Bergstraat 71,2019-05-19,01:00:00,0,0,0,FMN GV 11 Ramsel
66,Bergstraat 71,2019-05-19,02:00:00,2,2,0,FMN GV 11 Ramsel
66,Bergstraat 71,2019-05-19,03:00:00,8,8,0,FMN GV 11 Ramsel
66,Bergstraat 71,2019-05-19,04:00:00,0,0,0,FMN GV 11 Ramsel
66,Bergstraat 71,2019-05-19,05:00:00,0,0,0,FMN GV 11 Ramsel
66,Bergstraat 71,2019-05-19,06:00:00,2,2,0,FMN GV 11 Ramsel
66,Bergstraat 71,2019-05-19,07:00:00,38,14,24,FMN GV 11 Ramsel
66,Bergstraat 71,2019-05-19,08:00:00,106,22,84,FMN GV 11 Ramsel
66,Bergstraat 71,2019-05-19,09:00:00,82,42,40,FMN GV 11 Ramsel
66,Bergstraat 71,2019-05-19,10:00:00,88,44,44,FMN GV 11 Ramsel
66,Bergstraat 71,2019-05-19,11:00:00,102,66,36,FMN GV 11 Ramsel
66,Bergstraat 71,2019-05-19,12:00:00,80,50,30,FMN GV 11 Ramsel
66,Bergstraat 71,2019-05-19,13:00:00,120,52,68,FMN GV 11 Ramsel
66,Bergstraat 71,2019-05-19,14:00:00,168,60,108,FMN GV 11 Ramsel
66,Bergstraat 71,2019-05-19,15:00:00,162,96,66,FMN GV 11 Ramsel
66,Bergstraat 71,2019-05-19,16:00:00,142,80,62,FMN GV 11 Ramsel
66,Bergstraat 71,2019-05-19,17:00:00,36,24,12,FMN GV 11 Ramsel
66,Bergstraat 71,2019-05-19,18:00:00,6,2,4,FMN GV 11 Ramsel
66,Bergstraat 71,2019-05-19,19:00:00,18,12,6,FMN GV 11 Ramsel
66,Bergstraat 71,2019-05-19,20:00:00,10,4,6,FMN GV 11 Ramsel
66,Bergstraat 71,2019-05-19,21:00:00,8,8,0,FMN GV 11 Ramsel
66,Bergstraat 71,2019-05-19,22:00:00,6,4,2,FMN GV 11 Ramsel
66,Bergstraat 71,2019-05-19,23:00:00,0,0,0,FMN GV 11 Ramsel
66,Bergstraat 71,2019-05-20,00:00:00,0,0,0,FMN GV 11 Ramsel
66,Bergstraat 71,2019-05-20,01:00:00,0,0,0,FMN GV 11 Ramsel
66,Bergstraat 71,2019-05-20,02:00:00,0,0,0,FMN GV 11 Ramsel
66,Bergstraat 71,2019-05-20,03:00:00,0,0,0,FMN GV 11 Ramsel
66,Bergstraat 71,2019-05-20,04:00:00,4,4,0,FMN GV 11 Ramsel
66,Bergstraat 71,2019-05-20,05:00:00,8,2,6,FMN GV 11 Ramsel
66,Bergstraat 71,2019-05-20,06:00:00,48,16,32,FMN GV 11 Ramsel
66,Bergstraat 71,2019-05-20,07:00:00,156,10,146,FMN GV 11 Ramsel
66,Bergstraat 71,2019-05-20,08:00:00,178,12,166,FMN GV 11 Ramsel
66,Bergstraat 71,2019-05-20,09:00:00,60,16,44,FMN GV 11 Ramsel
66,Bergstraat 71,2019-05-20,10:00:00,46,20,26,FMN GV 11 Ramsel
66,Bergstraat 71,2019-05-20,11:00:00,66,36,30,FMN GV 11 Ramsel
66,Bergstraat 71,2019-05-20,12:00:00,64,30,34,FMN GV 11 Ramsel
66,Bergstraat 71,2019-05-20,13:00:00,90,30,60,FMN GV 11 Ramsel
66,Bergstraat 71,2019-05-20,14:00:00,100,54,46,FMN GV 11 Ramsel
66,Bergstraat 71,2019-05-20,15:00:00,282,240,42,FMN GV 11 Ramsel
66,Bergstraat 71,2019-05-20,16:00:00,130,110,20,FMN GV 11 Ramsel
66,Bergstraat 71,2019-05-20,17:00:00,82,64,18,FMN GV 11 Ramsel
66,Bergstraat 71,2019-05-20,18:00:00,66,42,24,FMN GV 11 Ramsel
66,Bergstraat 71,2019-05-20,19:00:00,34,14,20,FMN GV 11 Ramsel
66,Bergstraat 71,2019-05-20,20:00:00,20,8,12,FMN GV 11 Ramsel
66,Bergstraat 71,2019-05-20,21:00:00,8,4,4,FMN GV 11 Ramsel
66,Bergstraat 71,2019-05-20,22:00:00,12,10,2,FMN GV 11 Ramsel
66,Bergstraat 71,2019-05-20,23:00:00,6,6,0,FMN GV 11 Ramsel
66,Bergstraat 71,2019-05-21,00:00:00,0,0,0,FMN GV 11 Ramsel
66,Bergstraat 71,2019-05-21,01:00:00,0,0,0,FMN GV 11 Ramsel
66,Bergstraat 71,2019-05-21,02:00:00,2,0,2,FMN GV 11 Ramsel
66,Bergstraat 71,2019-05-21,03:00:00,4,2,2,FMN GV 11 Ramsel
66,Bergstraat 71,2019-05-21,04:00:00,2,2,0,FMN GV 11 Ramsel
66,Bergstraat 71,2019-05-21,05:00:00,8,2,6,FMN GV 11 Ramsel
66,Bergstraat 71,2019-05-21,06:00:00,52,12,40,FMN GV 11 Ramsel
66,Bergstraat 71,2019-05-21,07:00:00,178,26,152,FMN GV 11 Ramsel
66,Bergstraat 71,2019-05-21,08:00:00,196,14,182,FMN GV 11 Ramsel
66,Bergstraat 71,2019-05-21,09:00:00,46,20,26,FMN GV 11 Ramsel
66,Bergstraat 71,2019-05-21,10:00:00,28,14,14,FMN GV 11 Ramsel
66,Bergstraat 71,2019-05-21,11:00:00,38,16,22,FMN GV 11 Ramsel
66,Bergstraat 71,2019-05-21,12:00:00,88,56,32,FMN GV 11 Ramsel
66,Bergstraat 71,2019-05-21,13:00:00,140,60,80,FMN GV 11 Ramsel
66,Bergstraat 71,2019-05-21,14:00:00,108,64,44,FMN GV 11 Ramsel
66,Bergstraat 71,2019-05-21,15:00:00,262,202,60,FMN GV 11 Ramsel
66,Bergstraat 71,2019-05-21,16:00:00,192,120,72,FMN GV 11 Ramsel
66,Bergstraat 71,2019-05-21,17:00:00,136,76,60,FMN GV 11 Ramsel
66,Bergstraat 71,2019-05-21,18:00:00,102,58,44,FMN GV 11 Ramsel
66,Bergstraat 71,2019-05-21,19:00:00,68,36,32,FMN GV 11 Ramsel
66,Bergstraat 71,2019-05-21,20:00:00,40,28,12,FMN GV 11 Ramsel
66,Bergstraat 71,2019-05-21,21:00:00,50,44,6,FMN GV 11 Ramsel
66,Bergstraat 71,2019-05-21,22:00:00,22,10,12,FMN GV 11 Ramsel
66,Bergstraat 71,2019-05-21,23:00:00,2,2,0,FMN GV 11 Ramsel
66,Bergstraat 71,2019-05-22,00:00:00,2,2,0,FMN GV 11 Ramsel
66,Bergstraat 71,2019-05-22,01:00:00,0,0,0,FMN GV 11 Ramsel
66,Bergstraat 71,2019-05-22,02:00:00,0,0,0,FMN GV 11 Ramsel
66,Bergstraat 71,2019-05-22,03:00:00,0,0,0,FMN GV 11 Ramsel
66,Bergstraat 71,2019-05-22,04:00:00,2,2,0,FMN GV 11 Ramsel
66,Bergstraat 71,2019-05-22,05:00:00,6,4,2,FMN GV 11 Ramsel
66,Bergstraat 71,2019-05-22,06:00:00,60,14,46,FMN GV 11 Ramsel
66,Bergstraat 71,2019-05-22,07:00:00,182,30,152,FMN GV 11 Ramsel
66,Bergstraat 71,2019-05-22,08:00:00,196,24,172,FMN GV 11 Ramsel
66,Bergstraat 71,2019-05-22,09:00:00,80,28,52,FMN GV 11 Ramsel
66,Bergstraat 71,2019-05-22,10:00:00,80,50,30,FMN GV 11 Ramsel
66,Bergstraat 71,2019-05-22,11:00:00,88,40,48,FMN GV 11 Ramsel
66,Bergstraat 71,2019-05-22,12:00:00,284,222,62,FMN GV 11 Ramsel
66,Bergstraat 71,2019-05-22,13:00:00,148,76,72,FMN GV 11 Ramsel
66,Bergstraat 71,2019-05-22,14:00:00,286,118,168,FMN GV 11 Ramsel
66,Bergstraat 71,2019-05-22,15:00:00,194,98,96,FMN GV 11 Ramsel
66,Bergstraat 71,2019-05-22,16:00:00,254,152,102,FMN GV 11 Ramsel
66,Bergstraat 71,2019-05-22,17:00:00,168,98,70,FMN GV 11 Ramsel
66,Bergstraat 71,2019-05-22,18:00:00,142,66,76,FMN GV 11 Ramsel
66,Bergstraat 71,2019-05-22,19:00:00,106,78,28,FMN GV 11 Ramsel
66,Bergstraat 71,2019-05-22,20:00:00,76,56,20,FMN GV 11 Ramsel
66,Bergstraat 71,2019-05-22,21:00:00,24,10,14,FMN GV 11 Ramsel
66,Bergstraat 71,2019-05-22,22:00:00,16,12,4,FMN GV 11 Ramsel
66,Bergstraat 71,2019-05-22,23:00:00,4,4,0,FMN GV 11 Ramsel
66,Bergstraat 71,2019-05-23,00:00:00,0,0,0,FMN GV 11 Ramsel
66,Bergstraat 71,2019-05-23,01:00:00,0,0,0,FMN GV 11 Ramsel
66,Bergstraat 71,2019-05-23,02:00:00,0,0,0,FMN GV 11 Ramsel
66,Bergstraat 71,2019-05-23,03:00:00,0,0,0,FMN GV 11 Ramsel
66,Bergstraat 71,2019-05-23,04:00:00,2,2,0,FMN GV 11 Ramsel
66,Bergstraat 71,2019-05-23,05:00:00,6,2,4,FMN GV 11 Ramsel
66,Bergstraat 71,2019-05-23,06:00:00,54,12,42,FMN GV 11 Ramsel
66,Bergstraat 71,2019-05-23,07:00:00,200,32,168,FMN GV 11 Ramsel
66,Bergstraat 71,2019-05-23,08:00:00,192,32,160,FMN GV 11 Ramsel
66,Bergstraat 71,2019-05-23,09:00:00,106,56,50,FMN GV 11 Ramsel
66,Bergstraat 71,2019-05-23,10:00:00,80,34,46,FMN GV 11 Ramsel
66,Bergstraat 71,2019-05-23,11:00:00,98,40,58,FMN GV 11 Ramsel
66,Bergstraat 71,2019-05-23,12:00:00,112,68,44,FMN GV 11 Ramsel
66,Bergstraat 71,2019-05-23,13:00:00,182,92,90,FMN GV 11 Ramsel
66,Bergstraat 71,2019-05-23,14:00:00,184,94,90,FMN GV 11 Ramsel
66,Bergstraat 71,2019-05-23,15:00:00,364,242,122,FMN GV 11 Ramsel
66,Bergstraat 71,2019-05-23,16:00:00,262,196,66,FMN GV 11 Ramsel
66,Bergstraat 71,2019-05-23,17:00:00,136,80,56,FMN GV 11 Ramsel
66,Bergstraat 71,2019-05-23,18:00:00,158,72,86,FMN GV 11 Ramsel
66,Bergstraat 71,2019-05-23,19:00:00,124,52,72,FMN GV 11 Ramsel
66,Bergstraat 71,2019-05-23,20:00:00,76,56,20,FMN GV 11 Ramsel
66,Bergstraat 71,2019-05-23,21:00:00,28,22,6,FMN GV 11 Ramsel
66,Bergstraat 71,2019-05-23,22:00:00,22,14,8,FMN GV 11 Ramsel
66,Bergstraat 71,2019-05-23,23:00:00,4,2,2,FMN GV 11 Ramsel
66,Bergstraat 71,2019-05-24,00:00:00,0,0,0,FMN GV 11 Ramsel
66,Bergstraat 71,2019-05-24,01:00:00,0,0,0,FMN GV 11 Ramsel
66,Bergstraat 71,2019-05-24,02:00:00,0,0,0,FMN GV 11 Ramsel
66,Bergstraat 71,2019-05-24,03:00:00,0,0,0,FMN GV 11 Ramsel
66,Bergstraat 71,2019-05-24,04:00:00,4,2,2,FMN GV 11 Ramsel
66,Bergstraat 71,2019-05-24,05:00:00,6,2,4,FMN GV 11 Ramsel
66,Bergstraat 71,2019-05-24,06:00:00,56,18,38,FMN GV 11 Ramsel
66,Bergstraat 71,2019-05-24,07:00:00,168,30,138,FMN GV 11 Ramsel
66,Bergstraat 71,2019-05-24,08:00:00,204,28,176,FMN GV 11 Ramsel
66,Bergstraat 71,2019-05-24,09:00:00,88,28,60,FMN GV 11 Ramsel
66,Bergstraat 71,2019-05-24,10:00:00,50,22,28,FMN GV 11 Ramsel
66,Bergstraat 71,2019-05-24,11:00:00,56,32,24,FMN GV 11 Ramsel
66,Bergstraat 71,2019-05-24,12:00:00,112,62,50,FMN GV 11 Ramsel
66,Bergstraat 71,2019-05-24,13:00:00,168,102,66,FMN GV 11 Ramsel
66,Bergstraat 71,2019-05-24,14:00:00,184,104,80,FMN GV 11 Ramsel
66,Bergstraat 71,2019-05-24,15:00:00,320,246,74,FMN GV 11 Ramsel
66,Bergstraat 71,2019-05-24,16:00:00,214,146,68,FMN GV 11 Ramsel
66,Bergstraat 71,2019-05-24,17:00:00,204,122,82,FMN GV 11 Ramsel
66,Bergstraat 71,2019-05-24,18:00:00,80,44,36,FMN GV 11 Ramsel
66,Bergstraat 71,2019-05-24,19:00:00,106,46,60,FMN GV 11 Ramsel
66,Bergstraat 71,2019-05-24,20:00:00,48,28,20,FMN GV 11 Ramsel
66,Bergstraat 71,2019-05-24,21:00:00,28,18,10,FMN GV 11 Ramsel
66,Bergstraat 71,2019-05-24,22:00:00,14,6,8,FMN GV 11 Ramsel
66,Bergstraat 71,2019-05-24,23:00:00,4,0,4,FMN GV 11 Ramsel
66,Bergstraat 71,2019-05-25,00:00:00,2,0,2,FMN GV 11 Ramsel
66,Bergstraat 71,2019-05-25,01:00:00,8,8,0,FMN GV 11 Ramsel
66,Bergstraat 71,2019-05-25,02:00:00,0,0,0,FMN GV 11 Ramsel
66,Bergstraat 71,2019-05-25,03:00:00,4,4,0,FMN GV 11 Ramsel
66,Bergstraat 71,2019-05-25,04:00:00,0,0,0,FMN GV 11 Ramsel
66,Bergstraat 71,2019-05-25,05:00:00,0,0,0,FMN GV 11 Ramsel
66,Bergstraat 71,2019-05-25,06:00:00,6,4,2,FMN GV 11 Ramsel
66,Bergstraat 71,2019-05-25,07:00:00,40,8,32,FMN GV 11 Ramsel
66,Bergstraat 71,2019-05-25,08:00:00,56,14,42,FMN GV 11 Ramsel
66,Bergstraat 71,2019-05-25,09:00:00,104,26,78,FMN GV 11 Ramsel
66,Bergstraat 71,2019-05-25,10:00:00,102,46,56,FMN GV 11 Ramsel
66,Bergstraat 71,2019-05-25,11:00:00,58,24,34,FMN GV 11 Ramsel
66,Bergstraat 71,2019-05-25,12:00:00,82,48,34,FMN GV 11 Ramsel
66,Bergstraat 71,2019-05-25,13:00:00,130,56,74,FMN GV 11 Ramsel
66,Bergstraat 71,2019-05-25,14:00:00,214,98,116,FMN GV 11 Ramsel
66,Bergstraat 71,2019-05-25,15:00:00,148,76,72,FMN GV 11 Ramsel
66,Bergstraat 71,2019-05-25,16:00:00,130,84,46,FMN GV 11 Ramsel
66,Bergstraat 71,2019-05-25,17:00:00,138,56,82,FMN GV 11 Ramsel
66,Bergstraat 71,2019-05-25,18:00:00,56,44,12,FMN GV 11 Ramsel
66,Bergstraat 71,2019-05-25,19:00:00,52,34,18,FMN GV 11 Ramsel
66,Bergstraat 71,2019-05-25,20:00:00,40,26,14,FMN GV 11 Ramsel
66,Bergstraat 71,2019-05-25,21:00:00,36,12,24,FMN GV 11 Ramsel
66,Bergstraat 71,2019-05-25,22:00:00,12,2,10,FMN GV 11 Ramsel
66,Bergstraat 71,2019-05-25,23:00:00,8,4,4,FMN GV 11 Ramsel
66,Bergstraat 71,2019-05-26,00:00:00,4,2,2,FMN GV 11 Ramsel
66,Bergstraat 71,2019-05-26,01:00:00,0,0,0,FMN GV 11 Ramsel
66,Bergstraat 71,2019-05-26,02:00:00,2,2,0,FMN GV 11 Ramsel
66,Bergstraat 71,2019-05-26,03:00:00,6,6,0,FMN GV 11 Ramsel
66,Bergstraat 71,2019-05-26,04:00:00,4,4,0,FMN GV 11 Ramsel
66,Bergstraat 71,2019-05-26,05:00:00,0,0,0,FMN GV 11 Ramsel
66,Bergstraat 71,2019-05-26,06:00:00,6,0,6,FMN GV 11 Ramsel
66,Bergstraat 71,2019-05-26,07:00:00,30,12,18,FMN GV 11 Ramsel
66,Bergstraat 71,2019-05-26,08:00:00,98,20,78,FMN GV 11 Ramsel
66,Bergstraat 71,2019-05-26,09:00:00,182,90,92,FMN GV 11 Ramsel
66,Bergstraat 71,2019-05-26,10:00:00,188,112,76,FMN GV 11 Ramsel
66,Bergstraat 71,2019-05-26,11:00:00,248,122,126,FMN GV 11 Ramsel
66,Bergstraat 71,2019-05-26,12:00:00,244,136,108,FMN GV 11 Ramsel
66,Bergstraat 71,2019-05-26,13:00:00,382,206,176,FMN GV 11 Ramsel
66,Bergstraat 71,2019-05-26,14:00:00,282,174,108,FMN GV 11 Ramsel
66,Bergstraat 71,2019-05-26,15:00:00,244,138,106,FMN GV 11 Ramsel
66,Bergstraat 71,2019-05-26,16:00:00,174,84,90,FMN GV 11 Ramsel
66,Bergstraat 71,2019-05-26,17:00:00,142,64,78,FMN GV 11 Ramsel
66,Bergstraat 71,2019-05-26,18:00:00,98,56,42,FMN GV 11 Ramsel
66,Bergstraat 71,2019-05-26,19:00:00,36,12,24,FMN GV 11 Ramsel
66,Bergstraat 71,2019-05-26,20:00:00,30,16,14,FMN GV 11 Ramsel
66,Bergstraat 71,2019-05-26,21:00:00,16,6,10,FMN GV 11 Ramsel
66,Bergstraat 71,2019-05-26,22:00:00,16,6,10,FMN GV 11 Ramsel
66,Bergstraat 71,2019-05-26,23:00:00,0,0,0,FMN GV 11 Ramsel
66,Bergstraat 71,2019-05-27,00:00:00,2,2,0,FMN GV 11 Ramsel
66,Bergstraat 71,2019-05-27,01:00:00,2,2,0,FMN GV 11 Ramsel
66,Bergstraat 71,2019-05-27,02:00:00,0,0,0,FMN GV 11 Ramsel
66,Bergstraat 71,2019-05-27,03:00:00,0,0,0,FMN GV 11 Ramsel
66,Bergstraat 71,2019-05-27,04:00:00,2,2,0,FMN GV 11 Ramsel
66,Bergstraat 71,2019-05-27,05:00:00,16,12,4,FMN GV 11 Ramsel
66,Bergstraat 71,2019-05-27,06:00:00,66,20,46,FMN GV 11 Ramsel
66,Bergstraat 71,2019-05-27,07:00:00,148,14,134,FMN GV 11 Ramsel
66,Bergstraat 71,2019-05-27,08:00:00,194,30,164,FMN GV 11 Ramsel
66,Bergstraat 71,2019-05-27,09:00:00,94,64,30,FMN GV 11 Ramsel
66,Bergstraat 71,2019-05-27,10:00:00,76,36,40,FMN GV 11 Ramsel
66,Bergstraat 71,2019-05-27,11:00:00,66,28,38,FMN GV 11 Ramsel
66,Bergstraat 71,2019-05-27,12:00:00,72,36,36,FMN GV 11 Ramsel
66,Bergstraat 71,2019-05-27,13:00:00,160,90,70,FMN GV 11 Ramsel
66,Bergstraat 71,2019-05-27,14:00:00,186,62,124,FMN GV 11 Ramsel
66,Bergstraat 71,2019-05-27,15:00:00,316,248,68,FMN GV 11 Ramsel
66,Bergstraat 71,2019-05-27,16:00:00,188,136,52,FMN GV 11 Ramsel
66,Bergstraat 71,2019-05-27,17:00:00,138,76,62,FMN GV 11 Ramsel
66,Bergstraat 71,2019-05-27,18:00:00,86,48,38,FMN GV 11 Ramsel
66,Bergstraat 71,2019-05-27,19:00:00,48,24,24,FMN GV 11 Ramsel
66,Bergstraat 71,2019-05-27,20:00:00,68,46,22,FMN GV 11 Ramsel
66,Bergstraat 71,2019-05-27,21:00:00,16,6,10,FMN GV 11 Ramsel
66,Bergstraat 71,2019-05-27,22:00:00,14,8,6,FMN GV 11 Ramsel
66,Bergstraat 71,2019-05-27,23:00:00,2,2,0,FMN GV 11 Ramsel
66,Bergstraat 71,2019-05-28,00:00:00,0,0,0,FMN GV 11 Ramsel
66,Bergstraat 71,2019-05-28,01:00:00,0,0,0,FMN GV 11 Ramsel
66,Bergstraat 71,2019-05-28,02:00:00,0,0,0,FMN GV 11 Ramsel
66,Bergstraat 71,2019-05-28,03:00:00,0,0,0,FMN GV 11 Ramsel
66,Bergstraat 71,2019-05-28,04:00:00,2,2,0,FMN GV 11 Ramsel
66,Bergstraat 71,2019-05-28,05:00:00,12,10,2,FMN GV 11 Ramsel
66,Bergstraat 71,2019-05-28,06:00:00,34,6,28,FMN GV 11 Ramsel
66,Bergstraat 71,2019-05-28,07:00:00,142,20,122,FMN GV 11 Ramsel
66,Bergstraat 71,2019-05-28,08:00:00,154,28,126,FMN GV 11 Ramsel
66,Bergstraat 71,2019-05-28,09:00:00,24,6,18,FMN GV 11 Ramsel
66,Bergstraat 71,2019-05-28,10:00:00,10,2,8,FMN GV 11 Ramsel
66,Bergstraat 71,2019-05-28,11:00:00,2,0,2,FMN GV 11 Ramsel
66,Bergstraat 71,2019-05-28,12:00:00,24,16,8,FMN GV 11 Ramsel
66,Bergstraat 71,2019-05-28,13:00:00,56,28,28,FMN GV 11 Ramsel
66,Bergstraat 71,2019-05-28,14:00:00,26,10,16,FMN GV 11 Ramsel
66,Bergstraat 71,2019-05-28,15:00:00,176,160,16,FMN GV 11 Ramsel
66,Bergstraat 71,2019-05-28,16:00:00,82,60,22,FMN GV 11 Ramsel
66,Bergstraat 71,2019-05-28,17:00:00,80,52,28,FMN GV 11 Ramsel
66,Bergstraat 71,2019-05-28,18:00:00,44,22,22,FMN GV 11 Ramsel
66,Bergstraat 71,2019-05-28,19:00:00,40,18,22,FMN GV 11 Ramsel
66,Bergstraat 71,2019-05-28,20:00:00,38,26,12,FMN GV 11 Ramsel
66,Bergstraat 71,2019-05-28,21:00:00,14,6,8,FMN GV 11 Ramsel
66,Bergstraat 71,2019-05-28,22:00:00,12,12,0,FMN GV 11 Ramsel
66,Bergstraat 71,2019-05-28,23:00:00,10,6,4,FMN GV 11 Ramsel
66,Bergstraat 71,2019-05-29,00:00:00,0,0,0,FMN GV 11 Ramsel
66,Bergstraat 71,2019-05-29,01:00:00,4,4,0,FMN GV 11 Ramsel
66,Bergstraat 71,2019-05-29,02:00:00,2,0,2,FMN GV 11 Ramsel
66,Bergstraat 71,2019-05-29,03:00:00,0,0,0,FMN GV 11 Ramsel
66,Bergstraat 71,2019-05-29,04:00:00,2,2,0,FMN GV 11 Ramsel
66,Bergstraat 71,2019-05-29,05:00:00,10,10,0,FMN GV 11 Ramsel
66,Bergstraat 71,2019-05-29,06:00:00,42,12,30,FMN GV 11 Ramsel
66,Bergstraat 71,2019-05-29,07:00:00,94,28,66,FMN GV 11 Ramsel
66,Bergstraat 71,2019-05-29,08:00:00,108,22,86,FMN GV 11 Ramsel
66,Bergstraat 71,2019-05-29,09:00:00,68,16,52,FMN GV 11 Ramsel
66,Bergstraat 71,2019-05-29,10:00:00,92,36,56,FMN GV 11 Ramsel
66,Bergstraat 71,2019-05-29,11:00:00,74,30,44,FMN GV 11 Ramsel
66,Bergstraat 71,2019-05-29,12:00:00,132,96,36,FMN GV 11 Ramsel
66,Bergstraat 71,2019-05-29,13:00:00,204,98,106,FMN GV 11 Ramsel
66,Bergstraat 71,2019-05-29,14:00:00,292,114,178,FMN GV 11 Ramsel
66,Bergstraat 71,2019-05-29,15:00:00,164,78,86,FMN GV 11 Ramsel
66,Bergstraat 71,2019-05-29,16:00:00,170,116,54,FMN GV 11 Ramsel
66,Bergstraat 71,2019-05-29,17:00:00,126,70,56,FMN GV 11 Ramsel
66,Bergstraat 71,2019-05-29,18:00:00,98,48,50,FMN GV 11 Ramsel
66,Bergstraat 71,2019-05-29,19:00:00,66,42,24,FMN GV 11 Ramsel
66,Bergstraat 71,2019-05-29,20:00:00,64,40,24,FMN GV 11 Ramsel
66,Bergstraat 71,2019-05-29,21:00:00,108,34,74,FMN GV 11 Ramsel
66,Bergstraat 71,2019-05-29,22:00:00,218,126,92,FMN GV 11 Ramsel
66,Bergstraat 71,2019-05-29,23:00:00,74,58,16,FMN GV 11 Ramsel
66,Bergstraat 71,2019-05-30,00:00:00,36,16,20,FMN GV 11 Ramsel
66,Bergstraat 71,2019-05-30,01:00:00,2,0,2,FMN GV 11 Ramsel
66,Bergstraat 71,2019-05-30,02:00:00,6,0,6,FMN GV 11 Ramsel
66,Bergstraat 71,2019-05-30,03:00:00,4,0,4,FMN GV 11 Ramsel
66,Bergstraat 71,2019-05-30,04:00:00,8,0,8,FMN GV 11 Ramsel
66,Bergstraat 71,2019-05-30,05:00:00,2,0,2,FMN GV 11 Ramsel
66,Bergstraat 71,2019-05-30,06:00:00,6,0,6,FMN GV 11 Ramsel
66,Bergstraat 71,2019-05-30,07:00:00,22,6,16,FMN GV 11 Ramsel
66,Bergstraat 71,2019-05-30,08:00:00,20,6,14,FMN GV 11 Ramsel
66,Bergstraat 71,2019-05-30,09:00:00,80,16,64,FMN GV 11 Ramsel
66,Bergstraat 71,2019-05-30,10:00:00,86,38,48,FMN GV 11 Ramsel
66,Bergstraat 71,2019-05-30,11:00:00,114,58,56,FMN GV 11 Ramsel
66,Bergstraat 71,2019-05-30,12:00:00,108,52,56,FMN GV 11 Ramsel
66,Bergstraat 71,2019-05-30,13:00:00,160,90,70,FMN GV 11 Ramsel
66,Bergstraat 71,2019-05-30,14:00:00,302,188,114,FMN GV 11 Ramsel
66,Bergstraat 71,2019-05-30,15:00:00,208,124,84,FMN GV 11 Ramsel
66,Bergstraat 71,2019-05-30,16:00:00,190,114,76,FMN GV 11 Ramsel
66,Bergstraat 71,2019-05-30,17:00:00,184,80,104,FMN GV 11 Ramsel
66,Bergstraat 71,2019-05-30,18:00:00,140,42,98,FMN GV 11 Ramsel
66,Bergstraat 71,2019-05-30,19:00:00,58,24,34,FMN GV 11 Ramsel
66,Bergstraat 71,2019-05-30,20:00:00,82,38,44,FMN GV 11 Ramsel
66,Bergstraat 71,2019-05-30,21:00:00,40,20,20,FMN GV 11 Ramsel
66,Bergstraat 71,2019-05-30,22:00:00,18,10,8,FMN GV 11 Ramsel
66,Bergstraat 71,2019-05-30,23:00:00,18,6,12,FMN GV 11 Ramsel
66,Bergstraat 71,2019-05-31,00:00:00,8,6,2,FMN GV 11 Ramsel
66,Bergstraat 71,2019-05-31,01:00:00,0,0,0,FMN GV 11 Ramsel
66,Bergstraat 71,2019-05-31,02:00:00,4,0,4,FMN GV 11 Ramsel
66,Bergstraat 71,2019-05-31,03:00:00,0,0,0,FMN GV 11 Ramsel
66,Bergstraat 71,2019-05-31,04:00:00,4,0,4,FMN GV 11 Ramsel
66,Bergstraat 71,2019-05-31,05:00:00,6,2,4,FMN GV 11 Ramsel
66,Bergstraat 71,2019-05-31,06:00:00,14,4,10,FMN GV 11 Ramsel
66,Bergstraat 71,2019-05-31,07:00:00,26,12,14,FMN GV 11 Ramsel
66,Bergstraat 71,2019-05-31,08:00:00,54,6,48,FMN GV 11 Ramsel
66,Bergstraat 71,2019-05-31,09:00:00,106,32,74,FMN GV 11 Ramsel
66,Bergstraat 71,2019-05-31,10:00:00,102,42,60,FMN GV 11 Ramsel
66,Bergstraat 71,2019-05-31,11:00:00,158,72,86,FMN GV 11 Ramsel
66,Bergstraat 71,2019-05-31,12:00:00,100,40,60,FMN GV 11 Ramsel
66,Bergstraat 71,2019-05-31,13:00:00,150,80,70,FMN GV 11 Ramsel
66,Bergstraat 71,2019-05-31,14:00:00,226,110,116,FMN GV 11 Ramsel
66,Bergstraat 71,2019-05-31,15:00:00,190,122,68,FMN GV 11 Ramsel
66,Bergstraat 71,2019-05-31,16:00:00,180,92,88,FMN GV 11 Ramsel
66,Bergstraat 71,2019-05-31,17:00:00,88,52,36,FMN GV 11 Ramsel
66,Bergstraat 71,2019-05-31,18:00:00,56,34,22,FMN GV 11 Ramsel
66,Bergstraat 71,2019-05-31,19:00:00,54,14,40,FMN GV 11 Ramsel
66,Bergstraat 71,2019-05-31,20:00:00,60,28,32,FMN GV 11 Ramsel
66,Bergstraat 71,2019-05-31,21:00:00,26,14,12,FMN GV 11 Ramsel
66,Bergstraat 71,2019-05-31,22:00:00,26,22,4,FMN GV 11 Ramsel
66,Bergstraat 71,2019-05-31,23:00:00,2,2,0,FMN GV 11 Ramsel
66,Bergstraat 71,2019-06-01,00:00:00,6,0,6,FMN GV 11 Ramsel
66,Bergstraat 71,2019-06-01,01:00:00,4,0,4,FMN GV 11 Ramsel
66,Bergstraat 71,2019-06-01,02:00:00,8,6,2,FMN GV 11 Ramsel
66,Bergstraat 71,2019-06-01,03:00:00,6,2,4,FMN GV 11 Ramsel
66,Bergstraat 71,2019-06-01,04:00:00,0,0,0,FMN GV 11 Ramsel
66,Bergstraat 71,2019-06-01,05:00:00,4,0,4,FMN GV 11 Ramsel
66,Bergstraat 71,2019-06-01,06:00:00,0,0,0,FMN GV 11 Ramsel
66,Bergstraat 71,2019-06-01,07:00:00,16,4,12,FMN GV 11 Ramsel
66,Bergstraat 71,2019-06-01,08:00:00,70,26,44,FMN GV 11 Ramsel
66,Bergstraat 71,2019-06-01,09:00:00,92,52,40,FMN GV 11 Ramsel
66,Bergstraat 71,2019-06-01,10:00:00,126,50,76,FMN GV 11 Ramsel
66,Bergstraat 71,2019-06-01,11:00:00,136,48,88,FMN GV 11 Ramsel
66,Bergstraat 71,2019-06-01,12:00:00,142,78,64,FMN GV 11 Ramsel
66,Bergstraat 71,2019-06-01,13:00:00,206,90,116,FMN GV 11 Ramsel
66,Bergstraat 71,2019-06-01,14:00:00,318,192,126,FMN GV 11 Ramsel
66,Bergstraat 71,2019-06-01,15:00:00,266,150,116,FMN GV 11 Ramsel
66,Bergstraat 71,2019-06-01,16:00:00,198,104,94,FMN GV 11 Ramsel
66,Bergstraat 71,2019-06-01,17:00:00,194,126,68,FMN GV 11 Ramsel
66,Bergstraat 71,2019-06-01,18:00:00,116,68,48,FMN GV 11 Ramsel
66,Bergstraat 71,2019-06-01,19:00:00,110,38,72,FMN GV 11 Ramsel
66,Bergstraat 71,2019-06-01,20:00:00,68,30,38,FMN GV 11 Ramsel
66,Bergstraat 71,2019-06-01,21:00:00,64,36,28,FMN GV 11 Ramsel
66,Bergstraat 71,2019-06-01,22:00:00,38,30,8,FMN GV 11 Ramsel
66,Bergstraat 71,2019-06-01,23:00:00,24,16,8,FMN GV 11 Ramsel
66,Bergstraat 71,2019-06-02,00:00:00,20,20,0,FMN GV 11 Ramsel
66,Bergstraat 71,2019-06-02,01:00:00,0,0,0,FMN GV 11 Ramsel
66,Bergstraat 71,2019-06-02,02:00:00,12,8,4,FMN GV 11 Ramsel
66,Bergstraat 71,2019-06-02,03:00:00,18,0,18,FMN GV 11 Ramsel
66,Bergstraat 71,2019-06-02,04:00:00,12,4,8,FMN GV 11 Ramsel
66,Bergstraat 71,2019-06-02,05:00:00,6,2,4,FMN GV 11 Ramsel
66,Bergstraat 71,2019-06-02,06:00:00,6,0,6,FMN GV 11 Ramsel
66,Bergstraat 71,2019-06-02,07:00:00,34,16,18,FMN GV 11 Ramsel
66,Bergstraat 71,2019-06-02,08:00:00,110,34,76,FMN GV 11 Ramsel
66,Bergstraat 71,2019-06-02,09:00:00,232,80,152,FMN GV 11 Ramsel
66,Bergstraat 71,2019-06-02,10:00:00,274,124,150,FMN GV 11 Ramsel
66,Bergstraat 71,2019-06-02,11:00:00,308,162,146,FMN GV 11 Ramsel
66,Bergstraat 71,2019-06-02,12:00:00,182,112,70,FMN GV 11 Ramsel
66,Bergstraat 71,2019-06-02,13:00:00,272,170,102,FMN GV 11 Ramsel
66,Bergstraat 71,2019-06-02,14:00:00,364,186,178,FMN GV 11 Ramsel
66,Bergstraat 71,2019-06-02,15:00:00,294,138,156,FMN GV 11 Ramsel
66,Bergstraat 71,2019-06-02,16:00:00,242,168,74,FMN GV 11 Ramsel
66,Bergstraat 71,2019-06-02,17:00:00,170,98,72,FMN GV 11 Ramsel
66,Bergstraat 71,2019-06-02,18:00:00,94,50,44,FMN GV 11 Ramsel
66,Bergstraat 71,2019-06-02,19:00:00,96,54,42,FMN GV 11 Ramsel
66,Bergstraat 71,2019-06-02,20:00:00,62,36,26,FMN GV 11 Ramsel
66,Bergstraat 71,2019-06-02,21:00:00,22,10,12,FMN GV 11 Ramsel
66,Bergstraat 71,2019-06-02,22:00:00,2,0,2,FMN GV 11 Ramsel
66,Bergstraat 71,2019-06-02,23:00:00,6,4,2,FMN GV 11 Ramsel
66,Bergstraat 71,2019-06-03,00:00:00,0,0,0,FMN GV 11 Ramsel
66,Bergstraat 71,2019-06-03,01:00:00,2,2,0,FMN GV 11 Ramsel
66,Bergstraat 71,2019-06-03,02:00:00,0,0,0,FMN GV 11 Ramsel
66,Bergstraat 71,2019-06-03,03:00:00,0,0,0,FMN GV 11 Ramsel
66,Bergstraat 71,2019-06-03,04:00:00,2,2,0,FMN GV 11 Ramsel
66,Bergstraat 71,2019-06-03,05:00:00,12,6,6,FMN GV 11 Ramsel
66,Bergstraat 71,2019-06-03,06:00:00,72,24,48,FMN GV 11 Ramsel
66,Bergstraat 71,2019-06-03,07:00:00,154,22,132,FMN GV 11 Ramsel
66,Bergstraat 71,2019-06-03,08:00:00,214,26,188,FMN GV 11 Ramsel
66,Bergstraat 71,2019-06-03,09:00:00,80,32,48,FMN GV 11 Ramsel
66,Bergstraat 71,2019-06-03,10:00:00,64,44,20,FMN GV 11 Ramsel
66,Bergstraat 71,2019-06-03,11:00:00,48,14,34,FMN GV 11 Ramsel
66,Bergstraat 71,2019-06-03,12:00:00,114,34,80,FMN GV 11 Ramsel
66,Bergstraat 71,2019-06-03,13:00:00,76,48,28,FMN GV 11 Ramsel
66,Bergstraat 71,2019-06-03,14:00:00,38,24,14,FMN GV 11 Ramsel
66,Bergstraat 71,2019-06-03,15:00:00,216,180,36,FMN GV 11 Ramsel
66,Bergstraat 71,2019-06-03,16:00:00,170,120,50,FMN GV 11 Ramsel
66,Bergstraat 71,2019-06-03,17:00:00,100,76,24,FMN GV 11 Ramsel
66,Bergstraat 71,2019-06-03,18:00:00,72,44,28,FMN GV 11 Ramsel
66,Bergstraat 71,2019-06-03,19:00:00,34,16,18,FMN GV 11 Ramsel
66,Bergstraat 71,2019-06-03,20:00:00,50,18,32,FMN GV 11 Ramsel
66,Bergstraat 71,2019-06-03,21:00:00,16,12,4,FMN GV 11 Ramsel
66,Bergstraat 71,2019-06-03,22:00:00,4,0,4,FMN GV 11 Ramsel
66,Bergstraat 71,2019-06-03,23:00:00,4,4,0,FMN GV 11 Ramsel
66,Bergstraat 71,2019-06-04,00:00:00,2,2,0,FMN GV 11 Ramsel
66,Bergstraat 71,2019-06-04,01:00:00,0,0,0,FMN GV 11 Ramsel
66,Bergstraat 71,2019-06-04,02:00:00,0,0,0,FMN GV 11 Ramsel
66,Bergstraat 71,2019-06-04,03:00:00,0,0,0,FMN GV 11 Ramsel
66,Bergstraat 71,2019-06-04,04:00:00,2,2,0,FMN GV 11 Ramsel
66,Bergstraat 71,2019-06-04,05:00:00,12,4,8,FMN GV 11 Ramsel
66,Bergstraat 71,2019-06-04,06:00:00,74,20,54,FMN GV 11 Ramsel
66,Bergstraat 71,2019-06-04,07:00:00,160,28,132,FMN GV 11 Ramsel
66,Bergstraat 71,2019-06-04,08:00:00,224,34,190,FMN GV 11 Ramsel
66,Bergstraat 71,2019-06-04,09:00:00,94,24,70,FMN GV 11 Ramsel
66,Bergstraat 71,2019-06-04,10:00:00,78,36,42,FMN GV 11 Ramsel
66,Bergstraat 71,2019-06-04,11:00:00,56,26,30,FMN GV 11 Ramsel
66,Bergstraat 71,2019-06-04,12:00:00,68,42,26,FMN GV 11 Ramsel
66,Bergstraat 71,2019-06-04,13:00:00,126,62,64,FMN GV 11 Ramsel
66,Bergstraat 71,2019-06-04,14:00:00,102,68,34,FMN GV 11 Ramsel
66,Bergstraat 71,2019-06-04,15:00:00,248,214,34,FMN GV 11 Ramsel
66,Bergstraat 71,2019-06-04,16:00:00,178,126,52,FMN GV 11 Ramsel
66,Bergstraat 71,2019-06-04,17:00:00,102,66,36,FMN GV 11 Ramsel
66,Bergstraat 71,2019-06-04,18:00:00,72,52,20,FMN GV 11 Ramsel
66,Bergstraat 71,2019-06-04,19:00:00,58,26,32,FMN GV 11 Ramsel
66,Bergstraat 71,2019-06-04,20:00:00,60,42,18,FMN GV 11 Ramsel
66,Bergstraat 71,2019-06-04,21:00:00,10,8,2,FMN GV 11 Ramsel
66,Bergstraat 71,2019-06-04,22:00:00,8,4,4,FMN GV 11 Ramsel
66,Bergstraat 71,2019-06-04,23:00:00,4,4,0,FMN GV 11 Ramsel
66,Bergstraat 71,2019-06-05,00:00:00,2,0,2,FMN GV 11 Ramsel
66,Bergstraat 71,2019-06-05,01:00:00,0,0,0,FMN GV 11 Ramsel
66,Bergstraat 71,2019-06-05,02:00:00,0,0,0,FMN GV 11 Ramsel
66,Bergstraat 71,2019-06-05,03:00:00,0,0,0,FMN GV 11 Ramsel
66,Bergstraat 71,2019-06-05,04:00:00,2,2,0,FMN GV 11 Ramsel
66,Bergstraat 71,2019-06-05,05:00:00,14,8,6,FMN GV 11 Ramsel
66,Bergstraat 71,2019-06-05,06:00:00,28,6,22,FMN GV 11 Ramsel
66,Bergstraat 71,2019-06-05,07:00:00,106,4,102,FMN GV 11 Ramsel
66,Bergstraat 71,2019-06-05,08:00:00,142,10,132,FMN GV 11 Ramsel
66,Bergstraat 71,2019-06-05,09:00:00,54,42,12,FMN GV 11 Ramsel
66,Bergstraat 71,2019-06-05,10:00:00,28,24,4,FMN GV 11 Ramsel
66,Bergstraat 71,2019-06-05,11:00:00,26,16,10,FMN GV 11 Ramsel
66,Bergstraat 71,2019-06-05,12:00:00,156,140,16,FMN GV 11 Ramsel
66,Bergstraat 71,2019-06-05,13:00:00,34,14,20,FMN GV 11 Ramsel
66,Bergstraat 71,2019-06-05,14:00:00,56,22,34,FMN GV 11 Ramsel
66,Bergstraat 71,2019-06-05,15:00:00,96,36,60,FMN GV 11 Ramsel
66,Bergstraat 71,2019-06-05,16:00:00,80,50,30,FMN GV 11 Ramsel
66,Bergstraat 71,2019-06-05,17:00:00,86,62,24,FMN GV 11 Ramsel
66,Bergstraat 71,2019-06-05,18:00:00,52,26,26,FMN GV 11 Ramsel
66,Bergstraat 71,2019-06-05,19:00:00,62,50,12,FMN GV 11 Ramsel
66,Bergstraat 71,2019-06-05,20:00:00,42,18,24,FMN GV 11 Ramsel
66,Bergstraat 71,2019-06-05,21:00:00,14,10,4,FMN GV 11 Ramsel
66,Bergstraat 71,2019-06-05,22:00:00,10,8,2,FMN GV 11 Ramsel
66,Bergstraat 71,2019-06-05,23:00:00,4,2,2,FMN GV 11 Ramsel
66,Bergstraat 71,2019-06-06,00:00:00,2,2,0,FMN GV 11 Ramsel
66,Bergstraat 71,2019-06-06,01:00:00,0,0,0,FMN GV 11 Ramsel
66,Bergstraat 71,2019-06-06,02:00:00,0,0,0,FMN GV 11 Ramsel
66,Bergstraat 71,2019-06-06,03:00:00,0,0,0,FMN GV 11 Ramsel
66,Bergstraat 71,2019-06-06,04:00:00,2,2,0,FMN GV 11 Ramsel
66,Bergstraat 71,2019-06-06,05:00:00,10,8,2,FMN GV 11 Ramsel
66,Bergstraat 71,2019-06-06,06:00:00,58,20,38,FMN GV 11 Ramsel
66,Bergstraat 71,2019-06-06,07:00:00,180,16,164,FMN GV 11 Ramsel
66,Bergstraat 71,2019-06-06,08:00:00,192,18,174,FMN GV 11 Ramsel
66,Bergstraat 71,2019-06-06,09:00:00,132,66,66,FMN GV 11 Ramsel
66,Bergstraat 71,2019-06-06,10:00:00,60,46,14,FMN GV 11 Ramsel
66,Bergstraat 71,2019-06-06,11:00:00,62,40,22,FMN GV 11 Ramsel
66,Bergstraat 71,2019-06-06,12:00:00,100,70,30,FMN GV 11 Ramsel
66,Bergstraat 71,2019-06-06,13:00:00,94,54,40,FMN GV 11 Ramsel
66,Bergstraat 71,2019-06-06,14:00:00,98,50,48,FMN GV 11 Ramsel
66,Bergstraat 71,2019-06-06,15:00:00,226,160,66,FMN GV 11 Ramsel
66,Bergstraat 71,2019-06-06,16:00:00,194,142,52,FMN GV 11 Ramsel
66,Bergstraat 71,2019-06-06,17:00:00,124,88,36,FMN GV 11 Ramsel
66,Bergstraat 71,2019-06-06,18:00:00,84,52,32,FMN GV 11 Ramsel
66,Bergstraat 71,2019-06-06,19:00:00,54,20,34,FMN GV 11 Ramsel
66,Bergstraat 71,2019-06-06,20:00:00,24,16,8,FMN GV 11 Ramsel
66,Bergstraat 71,2019-06-06,21:00:00,20,14,6,FMN GV 11 Ramsel
66,Bergstraat 71,2019-06-06,22:00:00,22,18,4,FMN GV 11 Ramsel
66,Bergstraat 71,2019-06-06,23:00:00,4,2,2,FMN GV 11 Ramsel
66,Bergstraat 71,2019-06-07,00:00:00,0,0,0,FMN GV 11 Ramsel
66,Bergstraat 71,2019-06-07,01:00:00,0,0,0,FMN GV 11 Ramsel
66,Bergstraat 71,2019-06-07,02:00:00,0,0,0,FMN GV 11 Ramsel
66,Bergstraat 71,2019-06-07,03:00:00,0,0,0,FMN GV 11 Ramsel
66,Bergstraat 71,2019-06-07,04:00:00,2,2,0,FMN GV 11 Ramsel
66,Bergstraat 71,2019-06-07,05:00:00,12,8,4,FMN GV 11 Ramsel
66,Bergstraat 71,2019-06-07,06:00:00,38,8,30,FMN GV 11 Ramsel
66,Bergstraat 71,2019-06-07,07:00:00,166,16,150,FMN GV 11 Ramsel
66,Bergstraat 71,2019-06-07,08:00:00,180,26,154,FMN GV 11 Ramsel
66,Bergstraat 71,2019-06-07,09:00:00,72,54,18,FMN GV 11 Ramsel
66,Bergstraat 71,2019-06-07,10:00:00,80,50,30,FMN GV 11 Ramsel
66,Bergstraat 71,2019-06-07,11:00:00,74,46,28,FMN GV 11 Ramsel
66,Bergstraat 71,2019-06-07,12:00:00,104,70,34,FMN GV 11 Ramsel
66,Bergstraat 71,2019-06-07,13:00:00,116,56,60,FMN GV 11 Ramsel
66,Bergstraat 71,2019-06-07,14:00:00,100,56,44,FMN GV 11 Ramsel
66,Bergstraat 71,2019-06-07,15:00:00,252,210,42,FMN GV 11 Ramsel
66,Bergstraat 71,2019-06-07,16:00:00,106,88,18,FMN GV 11 Ramsel
66,Bergstraat 71,2019-06-07,17:00:00,70,58,12,FMN GV 11 Ramsel
66,Bergstraat 71,2019-06-07,18:00:00,26,14,12,FMN GV 11 Ramsel
66,Bergstraat 71,2019-06-07,19:00:00,24,10,14,FMN GV 11 Ramsel
66,Bergstraat 71,2019-06-07,20:00:00,36,22,14,FMN GV 11 Ramsel
66,Bergstraat 71,2019-06-07,21:00:00,16,8,8,FMN GV 11 Ramsel
66,Bergstraat 71,2019-06-07,22:00:00,10,4,6,FMN GV 11 Ramsel
66,Bergstraat 71,2019-06-07,23:00:00,6,4,2,FMN GV 11 Ramsel
66,Bergstraat 71,2019-06-08,00:00:00,6,4,2,FMN GV 11 Ramsel
66,Bergstraat 71,2019-06-08,01:00:00,2,2,0,FMN GV 11 Ramsel
66,Bergstraat 71,2019-06-08,02:00:00,6,6,0,FMN GV 11 Ramsel
66,Bergstraat 71,2019-06-08,03:00:00,2,2,0,FMN GV 11 Ramsel
66,Bergstraat 71,2019-06-08,04:00:00,0,0,0,FMN GV 11 Ramsel
66,Bergstraat 71,2019-06-08,05:00:00,4,2,2,FMN GV 11 Ramsel
66,Bergstraat 71,2019-06-08,06:00:00,4,0,4,FMN GV 11 Ramsel
66,Bergstraat 71,2019-06-08,07:00:00,42,24,18,FMN GV 11 Ramsel
66,Bergstraat 71,2019-06-08,08:00:00,10,2,8,FMN GV 11 Ramsel
66,Bergstraat 71,2019-06-08,09:00:00,20,10,10,FMN GV 11 Ramsel
66,Bergstraat 71,2019-06-08,10:00:00,30,16,14,FMN GV 11 Ramsel
66,Bergstraat 71,2019-06-08,11:00:00,22,12,10,FMN GV 11 Ramsel
66,Bergstraat 71,2019-06-08,12:00:00,42,16,26,FMN GV 11 Ramsel
66,Bergstraat 71,2019-06-08,13:00:00,62,10,52,FMN GV 11 Ramsel
66,Bergstraat 71,2019-06-08,14:00:00,52,32,20,FMN GV 11 Ramsel
66,Bergstraat 71,2019-06-08,15:00:00,22,10,12,FMN GV 11 Ramsel
66,Bergstraat 71,2019-06-08,16:00:00,24,20,4,FMN GV 11 Ramsel
66,Bergstraat 71,2019-06-08,17:00:00,30,20,10,FMN GV 11 Ramsel
66,Bergstraat 71,2019-06-08,18:00:00,30,20,10,FMN GV 11 Ramsel
66,Bergstraat 71,2019-06-08,19:00:00,22,8,14,FMN GV 11 Ramsel
66,Bergstraat 71,2019-06-08,20:00:00,20,4,16,FMN GV 11 Ramsel
66,Bergstraat 71,2019-06-08,21:00:00,20,8,12,FMN GV 11 Ramsel
66,Bergstraat 71,2019-06-08,22:00:00,6,4,2,FMN GV 11 Ramsel
66,Bergstraat 71,2019-06-08,23:00:00,12,2,10,FMN GV 11 Ramsel
66,Bergstraat 71,2019-06-09,00:00:00,18,16,2,FMN GV 11 Ramsel
66,Bergstraat 71,2019-06-09,01:00:00,0,0,0,FMN GV 11 Ramsel
66,Bergstraat 71,2019-06-09,02:00:00,4,4,0,FMN GV 11 Ramsel
66,Bergstraat 71,2019-06-09,03:00:00,4,0,4,FMN GV 11 Ramsel
66,Bergstraat 71,2019-06-09,04:00:00,0,0,0,FMN GV 11 Ramsel
66,Bergstraat 71,2019-06-09,05:00:00,0,0,0,FMN GV 11 Ramsel
66,Bergstraat 71,2019-06-09,06:00:00,6,2,4,FMN GV 11 Ramsel
66,Bergstraat 71,2019-06-09,07:00:00,18,2,16,FMN GV 11 Ramsel
66,Bergstraat 71,2019-06-09,08:00:00,64,16,48,FMN GV 11 Ramsel
66,Bergstraat 71,2019-06-09,09:00:00,126,22,104,FMN GV 11 Ramsel
66,Bergstraat 71,2019-06-09,10:00:00,212,126,86,FMN GV 11 Ramsel
66,Bergstraat 71,2019-06-09,11:00:00,246,124,122,FMN GV 11 Ramsel
66,Bergstraat 71,2019-06-09,12:00:00,174,84,90,FMN GV 11 Ramsel
66,Bergstraat 71,2019-06-09,13:00:00,260,140,120,FMN GV 11 Ramsel
66,Bergstraat 71,2019-06-09,14:00:00,266,122,144,FMN GV 11 Ramsel
66,Bergstraat 71,2019-06-09,15:00:00,206,126,80,FMN GV 11 Ramsel
66,Bergstraat 71,2019-06-09,16:00:00,138,94,44,FMN GV 11 Ramsel
66,Bergstraat 71,2019-06-09,17:00:00,100,46,54,FMN GV 11 Ramsel
66,Bergstraat 71,2019-06-09,18:00:00,58,24,34,FMN GV 11 Ramsel
66,Bergstraat 71,2019-06-09,19:00:00,28,24,4,FMN GV 11 Ramsel
66,Bergstraat 71,2019-06-09,20:00:00,14,6,8,FMN GV 11 Ramsel
66,Bergstraat 71,2019-06-09,21:00:00,34,30,4,FMN GV 11 Ramsel
66,Bergstraat 71,2019-06-09,22:00:00,14,4,10,FMN GV 11 Ramsel
66,Bergstraat 71,2019-06-09,23:00:00,10,6,4,FMN GV 11 Ramsel
66,Bergstraat 71,2019-06-10,00:00:00,2,2,0,FMN GV 11 Ramsel
66,Bergstraat 71,2019-06-10,01:00:00,12,8,4,FMN GV 11 Ramsel
66,Bergstraat 71,2019-06-10,02:00:00,0,0,0,FMN GV 11 Ramsel
66,Bergstraat 71,2019-06-10,03:00:00,0,0,0,FMN GV 11 Ramsel
66,Bergstraat 71,2019-06-10,04:00:00,0,0,0,FMN GV 11 Ramsel
66,Bergstraat 71,2019-06-10,05:00:00,2,2,0,FMN GV 11 Ramsel
66,Bergstraat 71,2019-06-10,06:00:00,8,4,4,FMN GV 11 Ramsel
66,Bergstraat 71,2019-06-10,07:00:00,14,6,8,FMN GV 11 Ramsel
66,Bergstraat 71,2019-06-10,08:00:00,46,8,38,FMN GV 11 Ramsel
66,Bergstraat 71,2019-06-10,09:00:00,88,30,58,FMN GV 11 Ramsel
66,Bergstraat 71,2019-06-10,10:00:00,142,84,58,FMN GV 11 Ramsel
66,Bergstraat 71,2019-06-10,11:00:00,150,78,72,FMN GV 11 Ramsel
66,Bergstraat 71,2019-06-10,12:00:00,142,86,56,FMN GV 11 Ramsel
66,Bergstraat 71,2019-06-10,13:00:00,174,70,104,FMN GV 11 Ramsel
66,Bergstraat 71,2019-06-10,14:00:00,150,60,90,FMN GV 11 Ramsel
66,Bergstraat 71,2019-06-10,15:00:00,90,32,58,FMN GV 11 Ramsel
66,Bergstraat 71,2019-06-10,16:00:00,154,88,66,FMN GV 11 Ramsel
66,Bergstraat 71,2019-06-10,17:00:00,72,50,22,FMN GV 11 Ramsel
66,Bergstraat 71,2019-06-10,18:00:00,40,20,20,FMN GV 11 Ramsel
66,Bergstraat 71,2019-06-10,19:00:00,12,8,4,FMN GV 11 Ramsel
66,Bergstraat 71,2019-06-10,20:00:00,26,12,14,FMN GV 11 Ramsel
66,Bergstraat 71,2019-06-10,21:00:00,8,4,4,FMN GV 11 Ramsel
66,Bergstraat 71,2019-06-10,22:00:00,4,4,0,FMN GV 11 Ramsel
66,Bergstraat 71,2019-06-10,23:00:00,6,4,2,FMN GV 11 Ramsel
66,Bergstraat 71,2019-06-11,00:00:00,0,0,0,FMN GV 11 Ramsel
66,Bergstraat 71,2019-06-11,01:00:00,0,0,0,FMN GV 11 Ramsel
66,Bergstraat 71,2019-06-11,02:00:00,2,0,2,FMN GV 11 Ramsel
66,Bergstraat 71,2019-06-11,03:00:00,0,0,0,FMN GV 11 Ramsel
66,Bergstraat 71,2019-06-11,04:00:00,2,2,0,FMN GV 11 Ramsel
66,Bergstraat 71,2019-06-11,05:00:00,14,6,8,FMN GV 11 Ramsel
66,Bergstraat 71,2019-06-11,06:00:00,58,14,44,FMN GV 11 Ramsel
66,Bergstraat 71,2019-06-11,07:00:00,164,22,142,FMN GV 11 Ramsel
66,Bergstraat 71,2019-06-11,08:00:00,226,22,204,FMN GV 11 Ramsel
66,Bergstraat 71,2019-06-11,09:00:00,138,92,46,FMN GV 11 Ramsel
66,Bergstraat 71,2019-06-11,10:00:00,98,54,44,FMN GV 11 Ramsel
66,Bergstraat 71,2019-06-11,11:00:00,134,66,68,FMN GV 11 Ramsel
66,Bergstraat 71,2019-06-11,12:00:00,164,128,36,FMN GV 11 Ramsel
66,Bergstraat 71,2019-06-11,13:00:00,148,64,84,FMN GV 11 Ramsel
66,Bergstraat 71,2019-06-11,14:00:00,110,50,60,FMN GV 11 Ramsel
66,Bergstraat 71,2019-06-11,15:00:00,140,114,26,FMN GV 11 Ramsel
66,Bergstraat 71,2019-06-11,16:00:00,110,72,38,FMN GV 11 Ramsel
66,Bergstraat 71,2019-06-11,17:00:00,108,60,48,FMN GV 11 Ramsel
66,Bergstraat 71,2019-06-11,18:00:00,68,30,38,FMN GV 11 Ramsel
66,Bergstraat 71,2019-06-11,19:00:00,82,46,36,FMN GV 11 Ramsel
66,Bergstraat 71,2019-06-11,20:00:00,50,40,10,FMN GV 11 Ramsel
66,Bergstraat 71,2019-06-11,21:00:00,16,12,4,FMN GV 11 Ramsel
66,Bergstraat 71,2019-06-11,22:00:00,10,8,2,FMN GV 11 Ramsel
66,Bergstraat 71,2019-06-11,23:00:00,4,4,0,FMN GV 11 Ramsel
66,Bergstraat 71,2019-06-12,00:00:00,0,0,0,FMN GV 11 Ramsel
66,Bergstraat 71,2019-06-12,01:00:00,0,0,0,FMN GV 11 Ramsel
66,Bergstraat 71,2019-06-12,02:00:00,0,0,0,FMN GV 11 Ramsel
66,Bergstraat 71,2019-06-12,03:00:00,0,0,0,FMN GV 11 Ramsel
66,Bergstraat 71,2019-06-12,04:00:00,2,2,0,FMN GV 11 Ramsel
66,Bergstraat 71,2019-06-12,05:00:00,16,6,10,FMN GV 11 Ramsel
66,Bergstraat 71,2019-06-12,06:00:00,38,12,26,FMN GV 11 Ramsel
66,Bergstraat 71,2019-06-12,07:00:00,92,6,86,FMN GV 11 Ramsel
66,Bergstraat 71,2019-06-12,08:00:00,58,6,52,FMN GV 11 Ramsel
66,Bergstraat 71,2019-06-12,09:00:00,18,6,12,FMN GV 11 Ramsel
66,Bergstraat 71,2019-06-12,10:00:00,40,24,16,FMN GV 11 Ramsel
66,Bergstraat 71,2019-06-12,11:00:00,32,30,2,FMN GV 11 Ramsel
66,Bergstraat 71,2019-06-12,12:00:00,96,76,20,FMN GV 11 Ramsel
66,Bergstraat 71,2019-06-12,13:00:00,16,4,12,FMN GV 11 Ramsel
66,Bergstraat 71,2019-06-12,14:00:00,40,18,22,FMN GV 11 Ramsel
66,Bergstraat 71,2019-06-12,15:00:00,32,14,18,FMN GV 11 Ramsel
66,Bergstraat 71,2019-06-12,16:00:00,58,32,26,FMN GV 11 Ramsel
66,Bergstraat 71,2019-06-12,17:00:00,60,46,14,FMN GV 11 Ramsel
66,Bergstraat 71,2019-06-12,18:00:00,58,30,28,FMN GV 11 Ramsel
66,Bergstraat 71,2019-06-12,19:00:00,32,16,16,FMN GV 11 Ramsel
66,Bergstraat 71,2019-06-12,20:00:00,30,14,16,FMN GV 11 Ramsel
66,Bergstraat 71,2019-06-12,21:00:00,34,30,4,FMN GV 11 Ramsel
66,Bergstraat 71,2019-06-12,22:00:00,14,10,4,FMN GV 11 Ramsel
66,Bergstraat 71,2019-06-12,23:00:00,2,2,0,FMN GV 11 Ramsel
66,Bergstraat 71,2019-06-13,00:00:00,0,0,0,FMN GV 11 Ramsel
66,Bergstraat 71,2019-06-13,01:00:00,2,0,2,FMN GV 11 Ramsel
66,Bergstraat 71,2019-06-13,02:00:00,0,0,0,FMN GV 11 Ramsel
66,Bergstraat 71,2019-06-13,03:00:00,0,0,0,FMN GV 11 Ramsel
66,Bergstraat 71,2019-06-13,04:00:00,2,2,0,FMN GV 11 Ramsel
66,Bergstraat 71,2019-06-13,05:00:00,12,6,6,FMN GV 11 Ramsel
66,Bergstraat 71,2019-06-13,06:00:00,60,18,42,FMN GV 11 Ramsel
66,Bergstraat 71,2019-06-13,07:00:00,196,14,182,FMN GV 11 Ramsel
66,Bergstraat 71,2019-06-13,08:00:00,192,20,172,FMN GV 11 Ramsel
66,Bergstraat 71,2019-06-13,09:00:00,78,14,64,FMN GV 11 Ramsel
66,Bergstraat 71,2019-06-13,10:00:00,144,110,34,FMN GV 11 Ramsel
66,Bergstraat 71,2019-06-13,11:00:00,76,60,16,FMN GV 11 Ramsel
66,Bergstraat 71,2019-06-13,12:00:00,134,110,24,FMN GV 11 Ramsel
66,Bergstraat 71,2019-06-13,13:00:00,68,26,42,FMN GV 11 Ramsel
66,Bergstraat 71,2019-06-13,14:00:00,60,34,26,FMN GV 11 Ramsel
66,Bergstraat 71,2019-06-13,15:00:00,90,70,20,FMN GV 11 Ramsel
66,Bergstraat 71,2019-06-13,16:00:00,102,76,26,FMN GV 11 Ramsel
66,Bergstraat 71,2019-06-13,17:00:00,78,50,28,FMN GV 11 Ramsel
66,Bergstraat 71,2019-06-13,18:00:00,54,34,20,FMN GV 11 Ramsel
66,Bergstraat 71,2019-06-13,19:00:00,40,18,22,FMN GV 11 Ramsel
66,Bergstraat 71,2019-06-13,20:00:00,28,10,18,FMN GV 11 Ramsel
66,Bergstraat 71,2019-06-13,21:00:00,18,12,6,FMN GV 11 Ramsel
66,Bergstraat 71,2019-06-13,22:00:00,8,6,2,FMN GV 11 Ramsel
66,Bergstraat 71,2019-06-13,23:00:00,6,6,0,FMN GV 11 Ramsel
66,Bergstraat 71,2019-06-14,00:00:00,0,0,0,FMN GV 11 Ramsel
66,Bergstraat 71,2019-06-14,01:00:00,2,2,0,FMN GV 11 Ramsel
66,Bergstraat 71,2019-06-14,02:00:00,0,0,0,FMN GV 11 Ramsel
66,Bergstraat 71,2019-06-14,03:00:00,0,0,0,FMN GV 11 Ramsel
66,Bergstraat 71,2019-06-14,04:00:00,4,4,0,FMN GV 11 Ramsel
66,Bergstraat 71,2019-06-14,05:00:00,22,10,12,FMN GV 11 Ramsel
66,Bergstraat 71,2019-06-14,06:00:00,50,16,34,FMN GV 11 Ramsel
66,Bergstraat 71,2019-06-14,07:00:00,152,30,122,FMN GV 11 Ramsel
66,Bergstraat 71,2019-06-14,08:00:00,142,16,126,FMN GV 11 Ramsel
66,Bergstraat 71,2019-06-14,09:00:00,20,6,14,FMN GV 11 Ramsel
66,Bergstraat 71,2019-06-14,10:00:00,128,102,26,FMN GV 11 Ramsel
66,Bergstraat 71,2019-06-14,11:00:00,100,70,30,FMN GV 11 Ramsel
66,Bergstraat 71,2019-06-14,12:00:00,134,80,54,FMN GV 11 Ramsel
66,Bergstraat 71,2019-06-14,13:00:00,126,64,62,FMN GV 11 Ramsel
66,Bergstraat 71,2019-06-14,14:00:00,176,80,96,FMN GV 11 Ramsel
66,Bergstraat 71,2019-06-14,15:00:00,214,144,70,FMN GV 11 Ramsel
66,Bergstraat 71,2019-06-14,16:00:00,142,82,60,FMN GV 11 Ramsel
66,Bergstraat 71,2019-06-14,17:00:00,128,70,58,FMN GV 11 Ramsel
66,Bergstraat 71,2019-06-14,18:00:00,76,40,36,FMN GV 11 Ramsel
66,Bergstraat 71,2019-06-14,19:00:00,92,64,28,FMN GV 11 Ramsel
66,Bergstraat 71,2019-06-14,20:00:00,48,22,26,FMN GV 11 Ramsel
66,Bergstraat 71,2019-06-14,21:00:00,56,34,22,FMN GV 11 Ramsel
66,Bergstraat 71,2019-06-14,22:00:00,14,12,2,FMN GV 11 Ramsel
66,Bergstraat 71,2019-06-14,23:00:00,8,8,0,FMN GV 11 Ramsel
66,Bergstraat 71,2019-06-15,00:00:00,6,6,0,FMN GV 11 Ramsel
66,Bergstraat 71,2019-06-15,01:00:00,4,4,0,FMN GV 11 Ramsel
66,Bergstraat 71,2019-06-15,02:00:00,12,12,0,FMN GV 11 Ramsel
66,Bergstraat 71,2019-06-15,03:00:00,0,0,0,FMN GV 11 Ramsel
66,Bergstraat 71,2019-06-15,04:00:00,0,0,0,FMN GV 11 Ramsel
66,Bergstraat 71,2019-06-15,05:00:00,2,0,2,FMN GV 11 Ramsel
66,Bergstraat 71,2019-06-15,06:00:00,0,0,0,FMN GV 11 Ramsel
66,Bergstraat 71,2019-06-15,07:00:00,12,6,6,FMN GV 11 Ramsel
66,Bergstraat 71,2019-06-15,08:00:00,40,2,38,FMN GV 11 Ramsel
66,Bergstraat 71,2019-06-15,09:00:00,16,10,6,FMN GV 11 Ramsel
66,Bergstraat 71,2019-06-15,10:00:00,32,10,22,FMN GV 11 Ramsel
66,Bergstraat 71,2019-06-15,11:00:00,74,48,26,FMN GV 11 Ramsel
66,Bergstraat 71,2019-06-15,12:00:00,50,30,20,FMN GV 11 Ramsel
66,Bergstraat 71,2019-06-15,13:00:00,100,40,60,FMN GV 11 Ramsel
66,Bergstraat 71,2019-06-15,14:00:00,90,44,46,FMN GV 11 Ramsel
66,Bergstraat 71,2019-06-15,15:00:00,158,82,76,FMN GV 11 Ramsel
66,Bergstraat 71,2019-06-15,16:00:00,104,48,56,FMN GV 11 Ramsel
66,Bergstraat 71,2019-06-15,17:00:00,62,46,16,FMN GV 11 Ramsel
66,Bergstraat 71,2019-06-15,18:00:00,70,40,30,FMN GV 11 Ramsel
66,Bergstraat 71,2019-06-15,19:00:00,42,22,20,FMN GV 11 Ramsel
66,Bergstraat 71,2019-06-15,20:00:00,28,6,22,FMN GV 11 Ramsel
66,Bergstraat 71,2019-06-15,21:00:00,22,8,14,FMN GV 11 Ramsel
66,Bergstraat 71,2019-06-15,22:00:00,12,10,2,FMN GV 11 Ramsel
66,Bergstraat 71,2019-06-15,23:00:00,6,4,2,FMN GV 11 Ramsel
66,Bergstraat 71,2019-06-16,00:00:00,4,4,0,FMN GV 11 Ramsel
66,Bergstraat 71,2019-06-16,01:00:00,4,4,0,FMN GV 11 Ramsel
66,Bergstraat 71,2019-06-16,02:00:00,6,6,0,FMN GV 11 Ramsel
66,Bergstraat 71,2019-06-16,03:00:00,2,2,0,FMN GV 11 Ramsel
66,Bergstraat 71,2019-06-16,04:00:00,4,0,4,FMN GV 11 Ramsel
66,Bergstraat 71,2019-06-16,05:00:00,2,2,0,FMN GV 11 Ramsel
66,Bergstraat 71,2019-06-16,06:00:00,16,6,10,FMN GV 11 Ramsel
66,Bergstraat 71,2019-06-16,07:00:00,28,8,20,FMN GV 11 Ramsel
66,Bergstraat 71,2019-06-16,08:00:00,108,26,82,FMN GV 11 Ramsel
66,Bergstraat 71,2019-06-16,09:00:00,166,74,92,FMN GV 11 Ramsel
66,Bergstraat 71,2019-06-16,10:00:00,186,98,88,FMN GV 11 Ramsel
66,Bergstraat 71,2019-06-16,11:00:00,184,78,106,FMN GV 11 Ramsel
66,Bergstraat 71,2019-06-16,12:00:00,114,62,52,FMN GV 11 Ramsel
66,Bergstraat 71,2019-06-16,13:00:00,168,70,98,FMN GV 11 Ramsel
66,Bergstraat 71,2019-06-16,14:00:00,276,144,132,FMN GV 11 Ramsel
66,Bergstraat 71,2019-06-16,15:00:00,246,126,120,FMN GV 11 Ramsel
66,Bergstraat 71,2019-06-16,16:00:00,190,90,100,FMN GV 11 Ramsel
66,Bergstraat 71,2019-06-16,17:00:00,108,50,58,FMN GV 11 Ramsel
66,Bergstraat 71,2019-06-16,18:00:00,78,34,44,FMN GV 11 Ramsel
66,Bergstraat 71,2019-06-16,19:00:00,50,30,20,FMN GV 11 Ramsel
66,Bergstraat 71,2019-06-16,20:00:00,20,4,16,FMN GV 11 Ramsel
66,Bergstraat 71,2019-06-16,21:00:00,18,10,8,FMN GV 11 Ramsel
66,Bergstraat 71,2019-06-16,22:00:00,8,6,2,FMN GV 11 Ramsel
66,Bergstraat 71,2019-06-16,23:00:00,4,4,0,FMN GV 11 Ramsel
66,Bergstraat 71,2019-06-17,00:00:00,4,2,2,FMN GV 11 Ramsel
66,Bergstraat 71,2019-06-17,01:00:00,0,0,0,FMN GV 11 Ramsel
66,Bergstraat 71,2019-06-17,02:00:00,0,0,0,FMN GV 11 Ramsel
66,Bergstraat 71,2019-06-17,03:00:00,0,0,0,FMN GV 11 Ramsel
66,Bergstraat 71,2019-06-17,04:00:00,2,2,0,FMN GV 11 Ramsel
66,Bergstraat 71,2019-06-17,05:00:00,10,4,6,FMN GV 11 Ramsel
66,Bergstraat 71,2019-06-17,06:00:00,86,20,66,FMN GV 11 Ramsel
66,Bergstraat 71,2019-06-17,07:00:00,242,32,210,FMN GV 11 Ramsel
66,Bergstraat 71,2019-06-17,08:00:00,184,22,162,FMN GV 11 Ramsel
66,Bergstraat 71,2019-06-17,09:00:00,108,48,60,FMN GV 11 Ramsel
66,Bergstraat 71,2019-06-17,10:00:00,130,66,64,FMN GV 11 Ramsel
66,Bergstraat 71,2019-06-17,11:00:00,158,100,58,FMN GV 11 Ramsel
66,Bergstraat 71,2019-06-17,12:00:00,256,174,82,FMN GV 11 Ramsel
66,Bergstraat 71,2019-06-17,13:00:00,192,92,100,FMN GV 11 Ramsel
66,Bergstraat 71,2019-06-17,14:00:00,198,100,98,FMN GV 11 Ramsel
66,Bergstraat 71,2019-06-17,15:00:00,188,126,62,FMN GV 11 Ramsel
66,Bergstraat 71,2019-06-17,16:00:00,178,112,66,FMN GV 11 Ramsel
66,Bergstraat 71,2019-06-17,17:00:00,166,100,66,FMN GV 11 Ramsel
66,Bergstraat 71,2019-06-17,18:00:00,140,88,52,FMN GV 11 Ramsel
66,Bergstraat 71,2019-06-17,19:00:00,114,76,38,FMN GV 11 Ramsel
66,Bergstraat 71,2019-06-17,20:00:00,60,32,28,FMN GV 11 Ramsel
66,Bergstraat 71,2019-06-17,21:00:00,34,28,6,FMN GV 11 Ramsel
66,Bergstraat 71,2019-06-17,22:00:00,20,12,8,FMN GV 11 Ramsel
66,Bergstraat 71,2019-06-17,23:00:00,0,0,0,FMN GV 11 Ramsel
66,Bergstraat 71,2019-06-18,00:00:00,2,2,0,FMN GV 11 Ramsel
66,Bergstraat 71,2019-06-18,01:00:00,0,0,0,FMN GV 11 Ramsel
66,Bergstraat 71,2019-06-18,02:00:00,0,0,0,FMN GV 11 Ramsel
66,Bergstraat 71,2019-06-18,03:00:00,0,0,0,FMN GV 11 Ramsel
66,Bergstraat 71,2019-06-18,04:00:00,2,2,0,FMN GV 11 Ramsel
66,Bergstraat 71,2019-06-18,05:00:00,10,4,6,FMN GV 11 Ramsel
66,Bergstraat 71,2019-06-18,06:00:00,88,20,68,FMN GV 11 Ramsel
66,Bergstraat 71,2019-06-18,07:00:00,242,28,214,FMN GV 11 Ramsel
66,Bergstraat 71,2019-06-18,08:00:00,218,32,186,FMN GV 11 Ramsel
66,Bergstraat 71,2019-06-18,09:00:00,64,26,38,FMN GV 11 Ramsel
66,Bergstraat 71,2019-06-18,10:00:00,232,126,106,FMN GV 11 Ramsel
66,Bergstraat 71,2019-06-18,11:00:00,208,108,100,FMN GV 11 Ramsel
66,Bergstraat 71,2019-06-18,12:00:00,224,150,74,FMN GV 11 Ramsel
66,Bergstraat 71,2019-06-18,13:00:00,194,74,120,FMN GV 11 Ramsel
66,Bergstraat 71,2019-06-18,14:00:00,230,150,80,FMN GV 11 Ramsel
66,Bergstraat 71,2019-06-18,15:00:00,290,128,162,FMN GV 11 Ramsel
66,Bergstraat 71,2019-06-18,16:00:00,270,174,96,FMN GV 11 Ramsel
66,Bergstraat 71,2019-06-18,17:00:00,198,110,88,FMN GV 11 Ramsel
66,Bergstraat 71,2019-06-18,18:00:00,136,62,74,FMN GV 11 Ramsel
66,Bergstraat 71,2019-06-18,19:00:00,144,66,78,FMN GV 11 Ramsel
66,Bergstraat 71,2019-06-18,20:00:00,100,60,40,FMN GV 11 Ramsel
66,Bergstraat 71,2019-06-18,21:00:00,74,34,40,FMN GV 11 Ramsel
66,Bergstraat 71,2019-06-18,22:00:00,18,10,8,FMN GV 11 Ramsel
66,Bergstraat 71,2019-06-18,23:00:00,4,4,0,FMN GV 11 Ramsel
66,Bergstraat 71,2019-06-19,00:00:00,0,0,0,FMN GV 11 Ramsel
66,Bergstraat 71,2019-06-19,01:00:00,0,0,0,FMN GV 11 Ramsel
66,Bergstraat 71,2019-06-19,02:00:00,0,0,0,FMN GV 11 Ramsel
66,Bergstraat 71,2019-06-19,03:00:00,2,0,2,FMN GV 11 Ramsel
66,Bergstraat 71,2019-06-19,04:00:00,4,2,2,FMN GV 11 Ramsel
66,Bergstraat 71,2019-06-19,05:00:00,8,4,4,FMN GV 11 Ramsel
66,Bergstraat 71,2019-06-19,06:00:00,46,14,32,FMN GV 11 Ramsel
66,Bergstraat 71,2019-06-19,07:00:00,220,20,200,FMN GV 11 Ramsel
66,Bergstraat 71,2019-06-19,08:00:00,196,34,162,FMN GV 11 Ramsel
66,Bergstraat 71,2019-06-19,09:00:00,82,24,58,FMN GV 11 Ramsel
66,Bergstraat 71,2019-06-19,10:00:00,212,174,38,FMN GV 11 Ramsel
66,Bergstraat 71,2019-06-19,11:00:00,118,94,24,FMN GV 11 Ramsel
66,Bergstraat 71,2019-06-19,12:00:00,154,124,30,FMN GV 11 Ramsel
66,Bergstraat 71,2019-06-19,13:00:00,76,38,38,FMN GV 11 Ramsel
66,Bergstraat 71,2019-06-19,14:00:00,118,58,60,FMN GV 11 Ramsel
66,Bergstraat 71,2019-06-19,15:00:00,94,52,42,FMN GV 11 Ramsel
66,Bergstraat 71,2019-06-19,16:00:00,116,70,46,FMN GV 11 Ramsel
66,Bergstraat 71,2019-06-19,17:00:00,52,38,14,FMN GV 11 Ramsel
66,Bergstraat 71,2019-06-19,18:00:00,24,22,2,FMN GV 11 Ramsel
66,Bergstraat 71,2019-06-19,19:00:00,26,14,12,FMN GV 11 Ramsel
66,Bergstraat 71,2019-06-19,20:00:00,14,12,2,FMN GV 11 Ramsel
66,Bergstraat 71,2019-06-19,21:00:00,10,8,2,FMN GV 11 Ramsel
66,Bergstraat 71,2019-06-19,22:00:00,8,8,0,FMN GV 11 Ramsel
66,Bergstraat 71,2019-06-19,23:00:00,6,6,0,FMN GV 11 Ramsel
66,Bergstraat 71,2019-06-20,00:00:00,0,0,0,FMN GV 11 Ramsel
66,Bergstraat 71,2019-06-20,01:00:00,0,0,0,FMN GV 11 Ramsel
66,Bergstraat 71,2019-06-20,02:00:00,0,0,0,FMN GV 11 Ramsel
66,Bergstraat 71,2019-06-20,03:00:00,2,0,2,FMN GV 11 Ramsel
66,Bergstraat 71,2019-06-20,04:00:00,2,2,0,FMN GV 11 Ramsel
66,Bergstraat 71,2019-06-20,05:00:00,8,2,6,FMN GV 11 Ramsel
66,Bergstraat 71,2019-06-20,06:00:00,62,20,42,FMN GV 11 Ramsel
66,Bergstraat 71,2019-06-20,07:00:00,202,28,174,FMN GV 11 Ramsel
66,Bergstraat 71,2019-06-20,08:00:00,168,28,140,FMN GV 11 Ramsel
66,Bergstraat 71,2019-06-20,09:00:00,62,10,52,FMN GV 11 Ramsel
66,Bergstraat 71,2019-06-20,10:00:00,232,186,46,FMN GV 11 Ramsel
66,Bergstraat 71,2019-06-20,11:00:00,76,54,22,FMN GV 11 Ramsel
66,Bergstraat 71,2019-06-20,12:00:00,82,62,20,FMN GV 11 Ramsel
66,Bergstraat 71,2019-06-20,13:00:00,94,54,40,FMN GV 11 Ramsel
66,Bergstraat 71,2019-06-20,14:00:00,124,68,56,FMN GV 11 Ramsel
66,Bergstraat 71,2019-06-20,15:00:00,182,96,86,FMN GV 11 Ramsel
66,Bergstraat 71,2019-06-20,16:00:00,122,88,34,FMN GV 11 Ramsel
66,Bergstraat 71,2019-06-20,17:00:00,86,64,22,FMN GV 11 Ramsel
66,Bergstraat 71,2019-06-20,18:00:00,108,50,58,FMN GV 11 Ramsel
66,Bergstraat 71,2019-06-20,19:00:00,72,46,26,FMN GV 11 Ramsel
66,Bergstraat 71,2019-06-20,20:00:00,56,16,40,FMN GV 11 Ramsel
66,Bergstraat 71,2019-06-20,21:00:00,24,12,12,FMN GV 11 Ramsel
66,Bergstraat 71,2019-06-20,22:00:00,10,10,0,FMN GV 11 Ramsel
66,Bergstraat 71,2019-06-20,23:00:00,4,4,0,FMN GV 11 Ramsel
66,Bergstraat 71,2019-06-21,00:00:00,2,0,2,FMN GV 11 Ramsel
66,Bergstraat 71,2019-06-21,01:00:00,0,0,0,FMN GV 11 Ramsel
66,Bergstraat 71,2019-06-21,02:00:00,2,2,0,FMN GV 11 Ramsel
66,Bergstraat 71,2019-06-21,03:00:00,0,0,0,FMN GV 11 Ramsel
66,Bergstraat 71,2019-06-21,04:00:00,6,2,4,FMN GV 11 Ramsel
66,Bergstraat 71,2019-06-21,05:00:00,6,2,4,FMN GV 11 Ramsel
66,Bergstraat 71,2019-06-21,06:00:00,62,12,50,FMN GV 11 Ramsel
66,Bergstraat 71,2019-06-21,07:00:00,208,22,186,FMN GV 11 Ramsel
66,Bergstraat 71,2019-06-21,08:00:00,214,28,186,FMN GV 11 Ramsel
66,Bergstraat 71,2019-06-21,09:00:00,72,22,50,FMN GV 11 Ramsel
66,Bergstraat 71,2019-06-21,10:00:00,188,124,64,FMN GV 11 Ramsel
66,Bergstraat 71,2019-06-21,11:00:00,140,46,94,FMN GV 11 Ramsel
66,Bergstraat 71,2019-06-21,12:00:00,192,106,86,FMN GV 11 Ramsel
66,Bergstraat 71,2019-06-21,13:00:00,168,90,78,FMN GV 11 Ramsel
66,Bergstraat 71,2019-06-21,14:00:00,176,110,66,FMN GV 11 Ramsel
66,Bergstraat 71,2019-06-21,15:00:00,172,82,90,FMN GV 11 Ramsel
66,Bergstraat 71,2019-06-21,16:00:00,168,130,38,FMN GV 11 Ramsel
66,Bergstraat 71,2019-06-21,17:00:00,126,82,44,FMN GV 11 Ramsel
66,Bergstraat 71,2019-06-21,18:00:00,118,56,62,FMN GV 11 Ramsel
66,Bergstraat 71,2019-06-21,19:00:00,102,34,68,FMN GV 11 Ramsel
66,Bergstraat 71,2019-06-21,20:00:00,70,14,56,FMN GV 11 Ramsel
66,Bergstraat 71,2019-06-21,21:00:00,52,26,26,FMN GV 11 Ramsel
66,Bergstraat 71,2019-06-21,22:00:00,26,10,16,FMN GV 11 Ramsel
66,Bergstraat 71,2019-06-21,23:00:00,12,12,0,FMN GV 11 Ramsel
66,Bergstraat 71,2019-06-22,00:00:00,22,14,8,FMN GV 11 Ramsel
66,Bergstraat 71,2019-06-22,01:00:00,6,6,0,FMN GV 11 Ramsel
66,Bergstraat 71,2019-06-22,02:00:00,0,0,0,FMN GV 11 Ramsel
66,Bergstraat 71,2019-06-22,03:00:00,6,2,4,FMN GV 11 Ramsel
66,Bergstraat 71,2019-06-22,04:00:00,8,6,2,FMN GV 11 Ramsel
66,Bergstraat 71,2019-06-22,05:00:00,4,0,4,FMN GV 11 Ramsel
66,Bergstraat 71,2019-06-22,06:00:00,8,6,2,FMN GV 11 Ramsel
66,Bergstraat 71,2019-06-22,07:00:00,12,4,8,FMN GV 11 Ramsel
66,Bergstraat 71,2019-06-22,08:00:00,44,14,30,FMN GV 11 Ramsel
66,Bergstraat 71,2019-06-22,09:00:00,68,36,32,FMN GV 11 Ramsel
66,Bergstraat 71,2019-06-22,10:00:00,170,82,88,FMN GV 11 Ramsel
66,Bergstraat 71,2019-06-22,11:00:00,146,82,64,FMN GV 11 Ramsel
66,Bergstraat 71,2019-06-22,12:00:00,148,64,84,FMN GV 11 Ramsel
66,Bergstraat 71,2019-06-22,13:00:00,214,86,128,FMN GV 11 Ramsel
66,Bergstraat 71,2019-06-22,14:00:00,230,128,102,FMN GV 11 Ramsel
66,Bergstraat 71,2019-06-22,15:00:00,272,92,180,FMN GV 11 Ramsel
66,Bergstraat 71,2019-06-22,16:00:00,214,84,130,FMN GV 11 Ramsel
66,Bergstraat 71,2019-06-22,17:00:00,172,114,58,FMN GV 11 Ramsel
66,Bergstraat 71,2019-06-22,18:00:00,112,46,66,FMN GV 11 Ramsel
66,Bergstraat 71,2019-06-22,19:00:00,56,30,26,FMN GV 11 Ramsel
66,Bergstraat 71,2019-06-22,20:00:00,64,28,36,FMN GV 11 Ramsel
66,Bergstraat 71,2019-06-22,21:00:00,42,20,22,FMN GV 11 Ramsel
66,Bergstraat 71,2019-06-22,22:00:00,34,28,6,FMN GV 11 Ramsel
66,Bergstraat 71,2019-06-22,23:00:00,24,20,4,FMN GV 11 Ramsel
66,Bergstraat 71,2019-06-23,00:00:00,4,4,0,FMN GV 11 Ramsel
66,Bergstraat 71,2019-06-23,01:00:00,8,8,0,FMN GV 11 Ramsel
66,Bergstraat 71,2019-06-23,02:00:00,14,6,8,FMN GV 11 Ramsel
66,Bergstraat 71,2019-06-23,03:00:00,10,0,10,FMN GV 11 Ramsel
66,Bergstraat 71,2019-06-23,04:00:00,2,0,2,FMN GV 11 Ramsel
66,Bergstraat 71,2019-06-23,05:00:00,2,0,2,FMN GV 11 Ramsel
66,Bergstraat 71,2019-06-23,06:00:00,12,4,8,FMN GV 11 Ramsel
66,Bergstraat 71,2019-06-23,07:00:00,40,30,10,FMN GV 11 Ramsel
66,Bergstraat 71,2019-06-23,08:00:00,78,24,54,FMN GV 11 Ramsel
66,Bergstraat 71,2019-06-23,09:00:00,154,78,76,FMN GV 11 Ramsel
66,Bergstraat 71,2019-06-23,10:00:00,240,106,134,FMN GV 11 Ramsel
66,Bergstraat 71,2019-06-23,11:00:00,288,174,114,FMN GV 11 Ramsel
66,Bergstraat 71,2019-06-23,12:00:00,200,94,106,FMN GV 11 Ramsel
66,Bergstraat 71,2019-06-23,13:00:00,210,92,118,FMN GV 11 Ramsel
66,Bergstraat 71,2019-06-23,14:00:00,286,114,172,FMN GV 11 Ramsel
66,Bergstraat 71,2019-06-23,15:00:00,290,180,110,FMN GV 11 Ramsel
66,Bergstraat 71,2019-06-23,16:00:00,256,122,134,FMN GV 11 Ramsel
66,Bergstraat 71,2019-06-23,17:00:00,144,86,58,FMN GV 11 Ramsel
66,Bergstraat 71,2019-06-23,18:00:00,168,92,76,FMN GV 11 Ramsel
66,Bergstraat 71,2019-06-23,19:00:00,112,58,54,FMN GV 11 Ramsel
66,Bergstraat 71,2019-06-23,20:00:00,70,36,34,FMN GV 11 Ramsel
66,Bergstraat 71,2019-06-23,21:00:00,54,32,22,FMN GV 11 Ramsel
66,Bergstraat 71,2019-06-23,22:00:00,10,6,4,FMN GV 11 Ramsel
66,Bergstraat 71,2019-06-23,23:00:00,6,2,4,FMN GV 11 Ramsel
66,Bergstraat 71,2019-06-24,00:00:00,6,4,2,FMN GV 11 Ramsel
66,Bergstraat 71,2019-06-24,01:00:00,0,0,0,FMN GV 11 Ramsel
66,Bergstraat 71,2019-06-24,02:00:00,0,0,0,FMN GV 11 Ramsel
66,Bergstraat 71,2019-06-24,03:00:00,6,4,2,FMN GV 11 Ramsel
66,Bergstraat 71,2019-06-24,04:00:00,6,2,4,FMN GV 11 Ramsel
66,Bergstraat 71,2019-06-24,05:00:00,22,12,10,FMN GV 11 Ramsel
66,Bergstraat 71,2019-06-24,06:00:00,72,18,54,FMN GV 11 Ramsel
66,Bergstraat 71,2019-06-24,07:00:00,80,16,64,FMN GV 11 Ramsel
66,Bergstraat 71,2019-06-24,08:00:00,98,28,70,FMN GV 11 Ramsel
66,Bergstraat 71,2019-06-24,09:00:00,104,58,46,FMN GV 11 Ramsel
66,Bergstraat 71,2019-06-24,10:00:00,204,116,88,FMN GV 11 Ramsel
66,Bergstraat 71,2019-06-24,11:00:00,86,26,60,FMN GV 11 Ramsel
66,Bergstraat 71,2019-06-24,12:00:00,78,34,44,FMN GV 11 Ramsel
66,Bergstraat 71,2019-06-24,13:00:00,138,62,76,FMN GV 11 Ramsel
66,Bergstraat 71,2019-06-24,14:00:00,202,80,122,FMN GV 11 Ramsel
66,Bergstraat 71,2019-06-24,15:00:00,146,84,62,FMN GV 11 Ramsel
66,Bergstraat 71,2019-06-24,16:00:00,142,94,48,FMN GV 11 Ramsel
66,Bergstraat 71,2019-06-24,17:00:00,142,92,50,FMN GV 11 Ramsel
66,Bergstraat 71,2019-06-24,18:00:00,122,56,66,FMN GV 11 Ramsel
66,Bergstraat 71,2019-06-24,19:00:00,90,64,26,FMN GV 11 Ramsel
66,Bergstraat 71,2019-06-24,20:00:00,76,42,34,FMN GV 11 Ramsel
66,Bergstraat 71,2019-06-24,21:00:00,64,48,16,FMN GV 11 Ramsel
66,Bergstraat 71,2019-06-24,22:00:00,30,24,6,FMN GV 11 Ramsel
66,Bergstraat 71,2019-06-24,23:00:00,16,4,12,FMN GV 11 Ramsel
66,Bergstraat 71,2019-06-25,00:00:00,10,6,4,FMN GV 11 Ramsel
66,Bergstraat 71,2019-06-25,01:00:00,8,2,6,FMN GV 11 Ramsel
66,Bergstraat 71,2019-06-25,02:00:00,4,2,2,FMN GV 11 Ramsel
66,Bergstraat 71,2019-06-25,03:00:00,16,0,16,FMN GV 11 Ramsel
66,Bergstraat 71,2019-06-25,04:00:00,4,4,0,FMN GV 11 Ramsel
66,Bergstraat 71,2019-06-25,05:00:00,38,18,20,FMN GV 11 Ramsel
66,Bergstraat 71,2019-06-25,06:00:00,82,24,58,FMN GV 11 Ramsel
66,Bergstraat 71,2019-06-25,07:00:00,102,26,76,FMN GV 11 Ramsel
66,Bergstraat 71,2019-06-25,08:00:00,138,36,102,FMN GV 11 Ramsel
66,Bergstraat 71,2019-06-25,09:00:00,162,64,98,FMN GV 11 Ramsel
66,Bergstraat 71,2019-06-25,10:00:00,132,66,66,FMN GV 11 Ramsel
66,Bergstraat 71,2019-06-25,11:00:00,114,62,52,FMN GV 11 Ramsel
66,Bergstraat 71,2019-06-25,12:00:00,116,50,66,FMN GV 11 Ramsel
66,Bergstraat 71,2019-06-25,13:00:00,114,56,58,FMN GV 11 Ramsel
66,Bergstraat 71,2019-06-25,14:00:00,144,80,64,FMN GV 11 Ramsel
66,Bergstraat 71,2019-06-25,15:00:00,110,64,46,FMN GV 11 Ramsel
66,Bergstraat 71,2019-06-25,16:00:00,126,76,50,FMN GV 11 Ramsel
66,Bergstraat 71,2019-06-25,17:00:00,116,66,50,FMN GV 11 Ramsel
66,Bergstraat 71,2019-06-25,18:00:00,146,72,74,FMN GV 11 Ramsel
66,Bergstraat 71,2019-06-25,19:00:00,114,58,56,FMN GV 11 Ramsel
66,Bergstraat 71,2019-06-25,20:00:00,106,64,42,FMN GV 11 Ramsel
66,Bergstraat 71,2019-06-25,21:00:00,74,42,32,FMN GV 11 Ramsel
66,Bergstraat 71,2019-06-25,22:00:00,24,16,8,FMN GV 11 Ramsel
66,Bergstraat 71,2019-06-25,23:00:00,12,8,4,FMN GV 11 Ramsel
66,Bergstraat 71,2019-06-26,00:00:00,8,2,6,FMN GV 11 Ramsel
66,Bergstraat 71,2019-06-26,01:00:00,0,0,0,FMN GV 11 Ramsel
66,Bergstraat 71,2019-06-26,02:00:00,0,0,0,FMN GV 11 Ramsel
66,Bergstraat 71,2019-06-26,03:00:00,0,0,0,FMN GV 11 Ramsel
66,Bergstraat 71,2019-06-26,04:00:00,8,8,0,FMN GV 11 Ramsel
66,Bergstraat 71,2019-06-26,05:00:00,30,12,18,FMN GV 11 Ramsel
66,Bergstraat 71,2019-06-26,06:00:00,70,18,52,FMN GV 11 Ramsel
66,Bergstraat 71,2019-06-26,07:00:00,120,30,90,FMN GV 11 Ramsel
66,Bergstraat 71,2019-06-26,08:00:00,156,32,124,FMN GV 11 Ramsel
66,Bergstraat 71,2019-06-26,09:00:00,168,78,90,FMN GV 11 Ramsel
66,Bergstraat 71,2019-06-26,10:00:00,172,86,86,FMN GV 11 Ramsel
66,Bergstraat 71,2019-06-26,11:00:00,136,80,56,FMN GV 11 Ramsel
66,Bergstraat 71,2019-06-26,12:00:00,126,74,52,FMN GV 11 Ramsel
66,Bergstraat 71,2019-06-26,13:00:00,142,70,72,FMN GV 11 Ramsel
66,Bergstraat 71,2019-06-26,14:00:00,210,128,82,FMN GV 11 Ramsel
66,Bergstraat 71,2019-06-26,15:00:00,142,80,62,FMN GV 11 Ramsel
66,Bergstraat 71,2019-06-26,16:00:00,168,98,70,FMN GV 11 Ramsel
66,Bergstraat 71,2019-06-26,17:00:00,148,88,60,FMN GV 11 Ramsel
66,Bergstraat 71,2019-06-26,18:00:00,116,70,46,FMN GV 11 Ramsel
66,Bergstraat 71,2019-06-26,19:00:00,104,54,50,FMN GV 11 Ramsel
66,Bergstraat 71,2019-06-26,20:00:00,100,50,50,FMN GV 11 Ramsel
66,Bergstraat 71,2019-06-26,21:00:00,84,46,38,FMN GV 11 Ramsel
66,Bergstraat 71,2019-06-26,22:00:00,38,24,14,FMN GV 11 Ramsel
66,Bergstraat 71,2019-06-26,23:00:00,8,2,6,FMN GV 11 Ramsel
66,Bergstraat 71,2019-06-27,00:00:00,2,0,2,FMN GV 11 Ramsel
66,Bergstraat 71,2019-06-27,01:00:00,6,6,0,FMN GV 11 Ramsel
66,Bergstraat 71,2019-06-27,02:00:00,0,0,0,FMN GV 11 Ramsel
66,Bergstraat 71,2019-06-27,03:00:00,0,0,0,FMN GV 11 Ramsel
66,Bergstraat 71,2019-06-27,04:00:00,4,4,0,FMN GV 11 Ramsel
66,Bergstraat 71,2019-06-27,05:00:00,34,12,22,FMN GV 11 Ramsel
66,Bergstraat 71,2019-06-27,06:00:00,76,12,64,FMN GV 11 Ramsel
66,Bergstraat 71,2019-06-27,07:00:00,120,18,102,FMN GV 11 Ramsel
66,Bergstraat 71,2019-06-27,08:00:00,140,44,96,FMN GV 11 Ramsel
66,Bergstraat 71,2019-06-27,09:00:00,114,50,64,FMN GV 11 Ramsel
66,Bergstraat 71,2019-06-27,10:00:00,136,80,56,FMN GV 11 Ramsel
66,Bergstraat 71,2019-06-27,11:00:00,112,64,48,FMN GV 11 Ramsel
66,Bergstraat 71,2019-06-27,12:00:00,136,72,64,FMN GV 11 Ramsel
66,Bergstraat 71,2019-06-27,13:00:00,190,70,120,FMN GV 11 Ramsel
66,Bergstraat 71,2019-06-27,14:00:00,168,80,88,FMN GV 11 Ramsel
66,Bergstraat 71,2019-06-27,15:00:00,286,118,168,FMN GV 11 Ramsel
66,Bergstraat 71,2019-06-27,16:00:00,216,112,104,FMN GV 11 Ramsel
66,Bergstraat 71,2019-06-27,17:00:00,174,112,62,FMN GV 11 Ramsel
66,Bergstraat 71,2019-06-27,18:00:00,138,80,58,FMN GV 11 Ramsel
66,Bergstraat 71,2019-06-27,19:00:00,112,60,52,FMN GV 11 Ramsel
66,Bergstraat 71,2019-06-27,20:00:00,106,46,60,FMN GV 11 Ramsel
66,Bergstraat 71,2019-06-27,21:00:00,50,30,20,FMN GV 11 Ramsel
66,Bergstraat 71,2019-06-27,22:00:00,42,36,6,FMN GV 11 Ramsel
66,Bergstraat 71,2019-06-27,23:00:00,6,6,0,FMN GV 11 Ramsel
66,Bergstraat 71,2019-06-28,00:00:00,2,0,2,FMN GV 11 Ramsel
66,Bergstraat 71,2019-06-28,01:00:00,12,12,0,FMN GV 11 Ramsel
66,Bergstraat 71,2019-06-28,02:00:00,6,6,0,FMN GV 11 Ramsel
66,Bergstraat 71,2019-06-28,03:00:00,0,0,0,FMN GV 11 Ramsel
66,Bergstraat 71,2019-06-28,04:00:00,8,6,2,FMN GV 11 Ramsel
66,Bergstraat 71,2019-06-28,05:00:00,28,12,16,FMN GV 11 Ramsel
66,Bergstraat 71,2019-06-28,06:00:00,58,18,40,FMN GV 11 Ramsel
66,Bergstraat 71,2019-06-28,07:00:00,52,12,40,FMN GV 11 Ramsel
66,Bergstraat 71,2019-06-28,08:00:00,128,20,108,FMN GV 11 Ramsel
66,Bergstraat 71,2019-06-28,09:00:00,162,56,106,FMN GV 11 Ramsel
66,Bergstraat 71,2019-06-28,10:00:00,108,66,42,FMN GV 11 Ramsel
66,Bergstraat 71,2019-06-28,11:00:00,120,80,40,FMN GV 11 Ramsel
66,Bergstraat 71,2019-06-28,12:00:00,176,106,70,FMN GV 11 Ramsel
66,Bergstraat 71,2019-06-28,13:00:00,146,78,68,FMN GV 11 Ramsel
66,Bergstraat 71,2019-06-28,14:00:00,194,76,118,FMN GV 11 Ramsel
66,Bergstraat 71,2019-06-28,15:00:00,208,106,102,FMN GV 11 Ramsel
66,Bergstraat 71,2019-06-28,16:00:00,212,126,86,FMN GV 11 Ramsel
66,Bergstraat 71,2019-06-28,17:00:00,144,98,46,FMN GV 11 Ramsel
66,Bergstraat 71,2019-06-28,18:00:00,80,38,42,FMN GV 11 Ramsel
66,Bergstraat 71,2019-06-28,19:00:00,114,66,48,FMN GV 11 Ramsel
66,Bergstraat 71,2019-06-28,20:00:00,94,40,54,FMN GV 11 Ramsel
66,Bergstraat 71,2019-06-28,21:00:00,66,24,42,FMN GV 11 Ramsel
66,Bergstraat 71,2019-06-28,22:00:00,32,20,12,FMN GV 11 Ramsel
66,Bergstraat 71,2019-06-28,23:00:00,48,18,30,FMN GV 11 Ramsel
66,Bergstraat 71,2019-06-29,00:00:00,4,4,0,FMN GV 11 Ramsel
66,Bergstraat 71,2019-06-29,01:00:00,14,12,2,FMN GV 11 Ramsel
66,Bergstraat 71,2019-06-29,02:00:00,22,22,0,FMN GV 11 Ramsel
66,Bergstraat 71,2019-06-29,03:00:00,40,40,0,FMN GV 11 Ramsel
66,Bergstraat 71,2019-06-29,04:00:00,16,14,2,FMN GV 11 Ramsel
66,Bergstraat 71,2019-06-29,05:00:00,16,10,6,FMN GV 11 Ramsel
66,Bergstraat 71,2019-06-29,06:00:00,16,2,14,FMN GV 11 Ramsel
66,Bergstraat 71,2019-06-29,07:00:00,32,8,24,FMN GV 11 Ramsel
66,Bergstraat 71,2019-06-29,08:00:00,66,30,36,FMN GV 11 Ramsel
66,Bergstraat 71,2019-06-29,09:00:00,114,40,74,FMN GV 11 Ramsel
66,Bergstraat 71,2019-06-29,10:00:00,192,84,108,FMN GV 11 Ramsel
66,Bergstraat 71,2019-06-29,11:00:00,160,82,78,FMN GV 11 Ramsel
66,Bergstraat 71,2019-06-29,12:00:00,108,62,46,FMN GV 11 Ramsel
66,Bergstraat 71,2019-06-29,13:00:00,128,56,72,FMN GV 11 Ramsel
66,Bergstraat 71,2019-06-29,14:00:00,160,68,92,FMN GV 11 Ramsel
66,Bergstraat 71,2019-06-29,15:00:00,100,64,36,FMN GV 11 Ramsel
66,Bergstraat 71,2019-06-29,16:00:00,86,44,42,FMN GV 11 Ramsel
66,Bergstraat 71,2019-06-29,17:00:00,66,48,18,FMN GV 11 Ramsel
66,Bergstraat 71,2019-06-29,18:00:00,86,42,44,FMN GV 11 Ramsel
66,Bergstraat 71,2019-06-29,19:00:00,72,18,54,FMN GV 11 Ramsel
66,Bergstraat 71,2019-06-29,20:00:00,70,16,54,FMN GV 11 Ramsel
66,Bergstraat 71,2019-06-29,21:00:00,72,28,44,FMN GV 11 Ramsel
66,Bergstraat 71,2019-06-29,22:00:00,44,30,14,FMN GV 11 Ramsel
66,Bergstraat 71,2019-06-29,23:00:00,24,12,12,FMN GV 11 Ramsel
66,Bergstraat 71,2019-06-30,00:00:00,12,12,0,FMN GV 11 Ramsel
66,Bergstraat 71,2019-06-30,01:00:00,22,18,4,FMN GV 11 Ramsel
66,Bergstraat 71,2019-06-30,02:00:00,22,22,0,FMN GV 11 Ramsel
66,Bergstraat 71,2019-06-30,03:00:00,4,4,0,FMN GV 11 Ramsel
66,Bergstraat 71,2019-06-30,04:00:00,4,4,0,FMN GV 11 Ramsel
66,Bergstraat 71,2019-06-30,05:00:00,10,4,6,FMN GV 11 Ramsel
66,Bergstraat 71,2019-06-30,06:00:00,22,4,18,FMN GV 11 Ramsel
66,Bergstraat 71,2019-06-30,07:00:00,46,10,36,FMN GV 11 Ramsel
66,Bergstraat 71,2019-06-30,08:00:00,146,58,88,FMN GV 11 Ramsel
66,Bergstraat 71,2019-06-30,09:00:00,144,62,82,FMN GV 11 Ramsel
66,Bergstraat 71,2019-06-30,10:00:00,250,144,106,FMN GV 11 Ramsel
66,Bergstraat 71,2019-06-30,11:00:00,274,154,120,FMN GV 11 Ramsel
66,Bergstraat 71,2019-06-30,12:00:00,172,76,96,FMN GV 11 Ramsel
66,Bergstraat 71,2019-06-30,13:00:00,238,116,122,FMN GV 11 Ramsel
66,Bergstraat 71,2019-06-30,14:00:00,240,108,132,FMN GV 11 Ramsel
66,Bergstraat 71,2019-06-30,15:00:00,264,162,102,FMN GV 11 Ramsel
66,Bergstraat 71,2019-06-30,16:00:00,172,82,90,FMN GV 11 Ramsel
66,Bergstraat 71,2019-06-30,17:00:00,98,48,50,FMN GV 11 Ramsel
66,Bergstraat 71,2019-06-30,18:00:00,112,62,50,FMN GV 11 Ramsel
66,Bergstraat 71,2019-06-30,19:00:00,100,24,76,FMN GV 11 Ramsel
66,Bergstraat 71,2019-06-30,20:00:00,72,32,40,FMN GV 11 Ramsel
66,Bergstraat 71,2019-06-30,21:00:00,56,26,30,FMN GV 11 Ramsel
66,Bergstraat 71,2019-06-30,22:00:00,20,16,4,FMN GV 11 Ramsel
66,Bergstraat 71,2019-06-30,23:00:00,8,2,6,FMN GV 11 Ramsel
66,Bergstraat 71,2019-07-01,00:00:00,2,0,2,FMN GV 11 Ramsel
66,Bergstraat 71,2019-07-01,01:00:00,6,4,2,FMN GV 11 Ramsel
66,Bergstraat 71,2019-07-01,02:00:00,14,12,2,FMN GV 11 Ramsel
66,Bergstraat 71,2019-07-01,03:00:00,0,0,0,FMN GV 11 Ramsel
66,Bergstraat 71,2019-07-01,04:00:00,4,4,0,FMN GV 11 Ramsel
66,Bergstraat 71,2019-07-01,05:00:00,24,8,16,FMN GV 11 Ramsel
66,Bergstraat 71,2019-07-01,06:00:00,76,34,42,FMN GV 11 Ramsel
66,Bergstraat 71,2019-07-01,07:00:00,68,22,46,FMN GV 11 Ramsel
66,Bergstraat 71,2019-07-01,08:00:00,54,14,40,FMN GV 11 Ramsel
66,Bergstraat 71,2019-07-01,09:00:00,66,40,26,FMN GV 11 Ramsel
66,Bergstraat 71,2019-07-01,10:00:00,106,52,54,FMN GV 11 Ramsel
66,Bergstraat 71,2019-07-01,11:00:00,162,58,104,FMN GV 11 Ramsel
66,Bergstraat 71,2019-07-01,12:00:00,144,68,76,FMN GV 11 Ramsel
66,Bergstraat 71,2019-07-01,13:00:00,288,142,146,FMN GV 11 Ramsel
66,Bergstraat 71,2019-07-01,14:00:00,146,68,78,FMN GV 11 Ramsel
66,Bergstraat 71,2019-07-01,15:00:00,150,86,64,FMN GV 11 Ramsel
66,Bergstraat 71,2019-07-01,16:00:00,200,90,110,FMN GV 11 Ramsel
66,Bergstraat 71,2019-07-01,17:00:00,148,100,48,FMN GV 11 Ramsel
66,Bergstraat 71,2019-07-01,18:00:00,112,70,42,FMN GV 11 Ramsel
66,Bergstraat 71,2019-07-01,19:00:00,120,68,52,FMN GV 11 Ramsel
66,Bergstraat 71,2019-07-01,20:00:00,58,30,28,FMN GV 11 Ramsel
66,Bergstraat 71,2019-07-01,21:00:00,42,20,22,FMN GV 11 Ramsel
66,Bergstraat 71,2019-07-01,22:00:00,24,18,6,FMN GV 11 Ramsel
66,Bergstraat 71,2019-07-01,23:00:00,14,10,4,FMN GV 11 Ramsel
66,Bergstraat 71,2019-07-02,00:00:00,8,8,0,FMN GV 11 Ramsel
66,Bergstraat 71,2019-07-02,01:00:00,2,2,0,FMN GV 11 Ramsel
66,Bergstraat 71,2019-07-02,02:00:00,0,0,0,FMN GV 11 Ramsel
66,Bergstraat 71,2019-07-02,03:00:00,0,0,0,FMN GV 11 Ramsel
66,Bergstraat 71,2019-07-02,04:00:00,2,2,0,FMN GV 11 Ramsel
66,Bergstraat 71,2019-07-02,05:00:00,6,2,4,FMN GV 11 Ramsel
66,Bergstraat 71,2019-07-02,06:00:00,68,22,46,FMN GV 11 Ramsel
66,Bergstraat 71,2019-07-02,07:00:00,58,18,40,FMN GV 11 Ramsel
66,Bergstraat 71,2019-07-02,08:00:00,60,16,44,FMN GV 11 Ramsel
66,Bergstraat 71,2019-07-02,09:00:00,78,12,66,FMN GV 11 Ramsel
66,Bergstraat 71,2019-07-02,10:00:00,86,40,46,FMN GV 11 Ramsel
66,Bergstraat 71,2019-07-02,11:00:00,78,46,32,FMN GV 11 Ramsel
66,Bergstraat 71,2019-07-02,12:00:00,104,46,58,FMN GV 11 Ramsel
66,Bergstraat 71,2019-07-02,13:00:00,260,168,92,FMN GV 11 Ramsel
66,Bergstraat 71,2019-07-02,14:00:00,274,128,146,FMN GV 11 Ramsel
66,Bergstraat 71,2019-07-02,15:00:00,228,136,92,FMN GV 11 Ramsel
66,Bergstraat 71,2019-07-02,16:00:00,178,100,78,FMN GV 11 Ramsel
66,Bergstraat 71,2019-07-02,17:00:00,152,98,54,FMN GV 11 Ramsel
66,Bergstraat 71,2019-07-02,18:00:00,148,70,78,FMN GV 11 Ramsel
66,Bergstraat 71,2019-07-02,19:00:00,84,38,46,FMN GV 11 Ramsel
66,Bergstraat 71,2019-07-02,20:00:00,92,50,42,FMN GV 11 Ramsel
66,Bergstraat 71,2019-07-02,21:00:00,128,94,34,FMN GV 11 Ramsel
66,Bergstraat 71,2019-07-02,22:00:00,24,12,12,FMN GV 11 Ramsel
66,Bergstraat 71,2019-07-02,23:00:00,14,6,8,FMN GV 11 Ramsel
66,Bergstraat 71,2019-07-03,00:00:00,4,4,0,FMN GV 11 Ramsel
66,Bergstraat 71,2019-07-03,01:00:00,2,0,2,FMN GV 11 Ramsel
66,Bergstraat 71,2019-07-03,02:00:00,0,0,0,FMN GV 11 Ramsel
66,Bergstraat 71,2019-07-03,03:00:00,0,0,0,FMN GV 11 Ramsel
66,Bergstraat 71,2019-07-03,04:00:00,0,0,0,FMN GV 11 Ramsel
66,Bergstraat 71,2019-07-03,05:00:00,8,4,4,FMN GV 11 Ramsel
66,Bergstraat 71,2019-07-03,06:00:00,72,30,42,FMN GV 11 Ramsel
66,Bergstraat 71,2019-07-03,07:00:00,80,20,60,FMN GV 11 Ramsel
66,Bergstraat 71,2019-07-03,08:00:00,72,26,46,FMN GV 11 Ramsel
66,Bergstraat 71,2019-07-03,09:00:00,88,40,48,FMN GV 11 Ramsel
66,Bergstraat 71,2019-07-03,10:00:00,70,36,34,FMN GV 11 Ramsel
66,Bergstraat 71,2019-07-03,11:00:00,78,38,40,FMN GV 11 Ramsel
66,Bergstraat 71,2019-07-03,12:00:00,86,52,34,FMN GV 11 Ramsel
66,Bergstraat 71,2019-07-03,13:00:00,164,96,68,FMN GV 11 Ramsel
66,Bergstraat 71,2019-07-03,14:00:00,218,78,140,FMN GV 11 Ramsel
66,Bergstraat 71,2019-07-03,15:00:00,210,84,126,FMN GV 11 Ramsel
66,Bergstraat 71,2019-07-03,16:00:00,200,114,86,FMN GV 11 Ramsel
66,Bergstraat 71,2019-07-03,17:00:00,164,102,62,FMN GV 11 Ramsel
66,Bergstraat 71,2019-07-03,18:00:00,108,64,44,FMN GV 11 Ramsel
66,Bergstraat 71,2019-07-03,19:00:00,192,120,72,FMN GV 11 Ramsel
66,Bergstraat 71,2019-07-03,20:00:00,110,60,50,FMN GV 11 Ramsel
66,Bergstraat 71,2019-07-03,21:00:00,40,10,30,FMN GV 11 Ramsel
66,Bergstraat 71,2019-07-03,22:00:00,24,16,8,FMN GV 11 Ramsel
66,Bergstraat 71,2019-07-03,23:00:00,10,2,8,FMN GV 11 Ramsel
66,Bergstraat 71,2019-07-04,00:00:00,0,0,0,FMN GV 11 Ramsel
66,Bergstraat 71,2019-07-04,01:00:00,0,0,0,FMN GV 11 Ramsel
66,Bergstraat 71,2019-07-04,02:00:00,4,4,0,FMN GV 11 Ramsel
66,Bergstraat 71,2019-07-04,03:00:00,0,0,0,FMN GV 11 Ramsel
66,Bergstraat 71,2019-07-04,04:00:00,2,2,0,FMN GV 11 Ramsel
66,Bergstraat 71,2019-07-04,05:00:00,16,6,10,FMN GV 11 Ramsel
66,Bergstraat 71,2019-07-04,06:00:00,90,26,64,FMN GV 11 Ramsel
66,Bergstraat 71,2019-07-04,07:00:00,82,30,52,FMN GV 11 Ramsel
66,Bergstraat 71,2019-07-04,08:00:00,74,22,52,FMN GV 11 Ramsel
66,Bergstraat 71,2019-07-04,09:00:00,82,18,64,FMN GV 11 Ramsel
66,Bergstraat 71,2019-07-04,10:00:00,110,56,54,FMN GV 11 Ramsel
66,Bergstraat 71,2019-07-04,11:00:00,132,74,58,FMN GV 11 Ramsel
66,Bergstraat 71,2019-07-04,12:00:00,130,78,52,FMN GV 11 Ramsel
66,Bergstraat 71,2019-07-04,13:00:00,170,80,90,FMN GV 11 Ramsel
66,Bergstraat 71,2019-07-04,14:00:00,268,114,154,FMN GV 11 Ramsel
66,Bergstraat 71,2019-07-04,15:00:00,196,96,100,FMN GV 11 Ramsel
66,Bergstraat 71,2019-07-04,16:00:00,180,94,86,FMN GV 11 Ramsel
66,Bergstraat 71,2019-07-04,17:00:00,170,86,84,FMN GV 11 Ramsel
66,Bergstraat 71,2019-07-04,18:00:00,168,96,72,FMN GV 11 Ramsel
66,Bergstraat 71,2019-07-04,19:00:00,156,82,74,FMN GV 11 Ramsel
66,Bergstraat 71,2019-07-04,20:00:00,114,70,44,FMN GV 11 Ramsel
66,Bergstraat 71,2019-07-04,21:00:00,84,52,32,FMN GV 11 Ramsel
66,Bergstraat 71,2019-07-04,22:00:00,42,22,20,FMN GV 11 Ramsel
66,Bergstraat 71,2019-07-04,23:00:00,16,12,4,FMN GV 11 Ramsel
66,Bergstraat 71,2019-07-05,00:00:00,2,2,0,FMN GV 11 Ramsel
66,Bergstraat 71,2019-07-05,01:00:00,2,0,2,FMN GV 11 Ramsel
66,Bergstraat 71,2019-07-05,02:00:00,0,0,0,FMN GV 11 Ramsel
66,Bergstraat 71,2019-07-05,03:00:00,0,0,0,FMN GV 11 Ramsel
66,Bergstraat 71,2019-07-05,04:00:00,4,2,2,FMN GV 11 Ramsel
66,Bergstraat 71,2019-07-05,05:00:00,14,4,10,FMN GV 11 Ramsel
66,Bergstraat 71,2019-07-05,06:00:00,46,14,32,FMN GV 11 Ramsel
66,Bergstraat 71,2019-07-05,07:00:00,68,26,42,FMN GV 11 Ramsel
66,Bergstraat 71,2019-07-05,08:00:00,46,8,38,FMN GV 11 Ramsel
66,Bergstraat 71,2019-07-05,09:00:00,90,50,40,FMN GV 11 Ramsel
66,Bergstraat 71,2019-07-05,10:00:00,122,34,88,FMN GV 11 Ramsel
66,Bergstraat 71,2019-07-05,11:00:00,76,28,48,FMN GV 11 Ramsel
66,Bergstraat 71,2019-07-05,12:00:00,156,70,86,FMN GV 11 Ramsel
66,Bergstraat 71,2019-07-05,13:00:00,148,64,84,FMN GV 11 Ramsel
66,Bergstraat 71,2019-07-05,14:00:00,200,106,94,FMN GV 11 Ramsel
66,Bergstraat 71,2019-07-05,15:00:00,246,134,112,FMN GV 11 Ramsel
66,Bergstraat 71,2019-07-05,16:00:00,160,84,76,FMN GV 11 Ramsel
66,Bergstraat 71,2019-07-05,17:00:00,152,108,44,FMN GV 11 Ramsel
66,Bergstraat 71,2019-07-05,18:00:00,130,64,66,FMN GV 11 Ramsel
66,Bergstraat 71,2019-07-05,19:00:00,54,38,16,FMN GV 11 Ramsel
66,Bergstraat 71,2019-07-05,20:00:00,64,38,26,FMN GV 11 Ramsel
66,Bergstraat 71,2019-07-05,21:00:00,38,10,28,FMN GV 11 Ramsel
66,Bergstraat 71,2019-07-05,22:00:00,46,20,26,FMN GV 11 Ramsel
66,Bergstraat 71,2019-07-05,23:00:00,8,4,4,FMN GV 11 Ramsel
66,Bergstraat 71,2019-07-06,00:00:00,8,8,0,FMN GV 11 Ramsel
66,Bergstraat 71,2019-07-06,01:00:00,4,4,0,FMN GV 11 Ramsel
66,Bergstraat 71,2019-07-06,02:00:00,2,2,0,FMN GV 11 Ramsel
66,Bergstraat 71,2019-07-06,03:00:00,2,0,2,FMN GV 11 Ramsel
66,Bergstraat 71,2019-07-06,04:00:00,12,10,2,FMN GV 11 Ramsel
66,Bergstraat 71,2019-07-06,05:00:00,6,4,2,FMN GV 11 Ramsel
66,Bergstraat 71,2019-07-06,06:00:00,12,2,10,FMN GV 11 Ramsel
66,Bergstraat 71,2019-07-06,07:00:00,32,16,16,FMN GV 11 Ramsel
66,Bergstraat 71,2019-07-06,08:00:00,52,14,38,FMN GV 11 Ramsel
66,Bergstraat 71,2019-07-06,09:00:00,112,42,70,FMN GV 11 Ramsel
66,Bergstraat 71,2019-07-06,10:00:00,178,32,146,FMN GV 11 Ramsel
66,Bergstraat 71,2019-07-06,11:00:00,122,50,72,FMN GV 11 Ramsel
66,Bergstraat 71,2019-07-06,12:00:00,156,84,72,FMN GV 11 Ramsel
66,Bergstraat 71,2019-07-06,13:00:00,164,32,132,FMN GV 11 Ramsel
66,Bergstraat 71,2019-07-06,14:00:00,218,124,94,FMN GV 11 Ramsel
66,Bergstraat 71,2019-07-06,15:00:00,194,104,90,FMN GV 11 Ramsel
66,Bergstraat 71,2019-07-06,16:00:00,180,114,66,FMN GV 11 Ramsel
66,Bergstraat 71,2019-07-06,17:00:00,186,120,66,FMN GV 11 Ramsel
66,Bergstraat 71,2019-07-06,18:00:00,132,112,20,FMN GV 11 Ramsel
66,Bergstraat 71,2019-07-06,19:00:00,82,64,18,FMN GV 11 Ramsel
66,Bergstraat 71,2019-07-06,20:00:00,86,26,60,FMN GV 11 Ramsel
66,Bergstraat 71,2019-07-06,21:00:00,42,24,18,FMN GV 11 Ramsel
66,Bergstraat 71,2019-07-06,22:00:00,22,16,6,FMN GV 11 Ramsel
66,Bergstraat 71,2019-07-06,23:00:00,12,12,0,FMN GV 11 Ramsel
66,Bergstraat 71,2019-07-07,00:00:00,8,2,6,FMN GV 11 Ramsel
66,Bergstraat 71,2019-07-07,01:00:00,10,10,0,FMN GV 11 Ramsel
66,Bergstraat 71,2019-07-07,02:00:00,10,10,0,FMN GV 11 Ramsel
66,Bergstraat 71,2019-07-07,03:00:00,0,0,0,FMN GV 11 Ramsel
66,Bergstraat 71,2019-07-07,04:00:00,0,0,0,FMN GV 11 Ramsel
66,Bergstraat 71,2019-07-07,05:00:00,8,6,2,FMN GV 11 Ramsel
66,Bergstraat 71,2019-07-07,06:00:00,10,0,10,FMN GV 11 Ramsel
66,Bergstraat 71,2019-07-07,07:00:00,26,8,18,FMN GV 11 Ramsel
66,Bergstraat 71,2019-07-07,08:00:00,46,14,32,FMN GV 11 Ramsel
66,Bergstraat 71,2019-07-07,09:00:00,144,78,66,FMN GV 11 Ramsel
66,Bergstraat 71,2019-07-07,10:00:00,172,114,58,FMN GV 11 Ramsel
66,Bergstraat 71,2019-07-07,11:00:00,232,142,90,FMN GV 11 Ramsel
66,Bergstraat 71,2019-07-07,12:00:00,164,76,88,FMN GV 11 Ramsel
66,Bergstraat 71,2019-07-07,13:00:00,240,130,110,FMN GV 11 Ramsel
66,Bergstraat 71,2019-07-07,14:00:00,300,152,148,FMN GV 11 Ramsel
66,Bergstraat 71,2019-07-07,15:00:00,274,156,118,FMN GV 11 Ramsel
66,Bergstraat 71,2019-07-07,16:00:00,196,114,82,FMN GV 11 Ramsel
66,Bergstraat 71,2019-07-07,17:00:00,148,86,62,FMN GV 11 Ramsel
66,Bergstraat 71,2019-07-07,18:00:00,128,72,56,FMN GV 11 Ramsel
66,Bergstraat 71,2019-07-07,19:00:00,72,38,34,FMN GV 11 Ramsel
66,Bergstraat 71,2019-07-07,20:00:00,38,26,12,FMN GV 11 Ramsel
66,Bergstraat 71,2019-07-07,21:00:00,54,26,28,FMN GV 11 Ramsel
66,Bergstraat 71,2019-07-07,22:00:00,16,10,6,FMN GV 11 Ramsel
66,Bergstraat 71,2019-07-07,23:00:00,4,4,0,FMN GV 11 Ramsel
66,Bergstraat 71,2019-07-08,00:00:00,6,6,0,FMN GV 11 Ramsel
66,Bergstraat 71,2019-07-08,01:00:00,6,6,0,FMN GV 11 Ramsel
66,Bergstraat 71,2019-07-08,02:00:00,2,0,2,FMN GV 11 Ramsel
66,Bergstraat 71,2019-07-08,03:00:00,4,4,0,FMN GV 11 Ramsel
66,Bergstraat 71,2019-07-08,04:00:00,4,4,0,FMN GV 11 Ramsel
66,Bergstraat 71,2019-07-08,05:00:00,12,2,10,FMN GV 11 Ramsel
66,Bergstraat 71,2019-07-08,06:00:00,44,26,18,FMN GV 11 Ramsel
66,Bergstraat 71,2019-07-08,07:00:00,62,14,48,FMN GV 11 Ramsel
66,Bergstraat 71,2019-07-08,08:00:00,46,8,38,FMN GV 11 Ramsel
66,Bergstraat 71,2019-07-08,09:00:00,58,18,40,FMN GV 11 Ramsel
66,Bergstraat 71,2019-07-08,10:00:00,118,84,34,FMN GV 11 Ramsel
66,Bergstraat 71,2019-07-08,11:00:00,54,22,32,FMN GV 11 Ramsel
66,Bergstraat 71,2019-07-08,12:00:00,80,46,34,FMN GV 11 Ramsel
66,Bergstraat 71,2019-07-08,13:00:00,146,68,78,FMN GV 11 Ramsel
66,Bergstraat 71,2019-07-08,14:00:00,88,44,44,FMN GV 11 Ramsel
66,Bergstraat 71,2019-07-08,15:00:00,104,66,38,FMN GV 11 Ramsel
66,Bergstraat 71,2019-07-08,16:00:00,104,72,32,FMN GV 11 Ramsel
66,Bergstraat 71,2019-07-08,17:00:00,188,84,104,FMN GV 11 Ramsel
66,Bergstraat 71,2019-07-08,18:00:00,102,70,32,FMN GV 11 Ramsel
66,Bergstraat 71,2019-07-08,19:00:00,56,22,34,FMN GV 11 Ramsel
66,Bergstraat 71,2019-07-08,20:00:00,72,46,26,FMN GV 11 Ramsel
66,Bergstraat 71,2019-07-08,21:00:00,12,4,8,FMN GV 11 Ramsel
66,Bergstraat 71,2019-07-08,22:00:00,4,4,0,FMN GV 11 Ramsel
66,Bergstraat 71,2019-07-08,23:00:00,4,2,2,FMN GV 11 Ramsel
66,Bergstraat 71,2019-07-09,00:00:00,4,4,0,FMN GV 11 Ramsel
66,Bergstraat 71,2019-07-09,01:00:00,0,0,0,FMN GV 11 Ramsel
66,Bergstraat 71,2019-07-09,02:00:00,4,2,2,FMN GV 11 Ramsel
66,Bergstraat 71,2019-07-09,03:00:00,0,0,0,FMN GV 11 Ramsel
66,Bergstraat 71,2019-07-09,04:00:00,4,4,0,FMN GV 11 Ramsel
66,Bergstraat 71,2019-07-09,05:00:00,8,2,6,FMN GV 11 Ramsel
66,Bergstraat 71,2019-07-09,06:00:00,36,10,26,FMN GV 11 Ramsel
66,Bergstraat 71,2019-07-09,07:00:00,62,18,44,FMN GV 11 Ramsel
66,Bergstraat 71,2019-07-09,08:00:00,50,32,18,FMN GV 11 Ramsel
66,Bergstraat 71,2019-07-09,09:00:00,60,18,42,FMN GV 11 Ramsel
66,Bergstraat 71,2019-07-09,10:00:00,76,32,44,FMN GV 11 Ramsel
66,Bergstraat 71,2019-07-09,11:00:00,102,62,40,FMN GV 11 Ramsel
66,Bergstraat 71,2019-07-09,12:00:00,134,58,76,FMN GV 11 Ramsel
66,Bergstraat 71,2019-07-09,13:00:00,222,112,110,FMN GV 11 Ramsel
66,Bergstraat 71,2019-07-09,14:00:00,160,80,80,FMN GV 11 Ramsel
66,Bergstraat 71,2019-07-09,15:00:00,194,112,82,FMN GV 11 Ramsel
66,Bergstraat 71,2019-07-09,16:00:00,198,134,64,FMN GV 11 Ramsel
66,Bergstraat 71,2019-07-09,17:00:00,178,100,78,FMN GV 11 Ramsel
66,Bergstraat 71,2019-07-09,18:00:00,138,70,68,FMN GV 11 Ramsel
66,Bergstraat 71,2019-07-09,19:00:00,66,42,24,FMN GV 11 Ramsel
66,Bergstraat 71,2019-07-09,20:00:00,74,44,30,FMN GV 11 Ramsel
66,Bergstraat 71,2019-07-09,21:00:00,36,24,12,FMN GV 11 Ramsel
66,Bergstraat 71,2019-07-09,22:00:00,24,14,10,FMN GV 11 Ramsel
66,Bergstraat 71,2019-07-09,23:00:00,6,2,4,FMN GV 11 Ramsel
66,Bergstraat 71,2019-07-10,00:00:00,0,0,0,FMN GV 11 Ramsel
66,Bergstraat 71,2019-07-10,01:00:00,4,4,0,FMN GV 11 Ramsel
66,Bergstraat 71,2019-07-10,02:00:00,2,2,0,FMN GV 11 Ramsel
66,Bergstraat 71,2019-07-10,03:00:00,8,6,2,FMN GV 11 Ramsel
66,Bergstraat 71,2019-07-10,04:00:00,8,8,0,FMN GV 11 Ramsel
66,Bergstraat 71,2019-07-10,05:00:00,12,2,10,FMN GV 11 Ramsel
66,Bergstraat 71,2019-07-10,06:00:00,50,18,32,FMN GV 11 Ramsel
66,Bergstraat 71,2019-07-10,07:00:00,56,22,34,FMN GV 11 Ramsel
66,Bergstraat 71,2019-07-10,08:00:00,46,16,30,FMN GV 11 Ramsel
66,Bergstraat 71,2019-07-10,09:00:00,60,24,36,FMN GV 11 Ramsel
66,Bergstraat 71,2019-07-10,10:00:00,76,30,46,FMN GV 11 Ramsel
66,Bergstraat 71,2019-07-10,11:00:00,126,66,60,FMN GV 11 Ramsel
66,Bergstraat 71,2019-07-10,12:00:00,110,36,74,FMN GV 11 Ramsel
66,Bergstraat 71,2019-07-10,13:00:00,162,78,84,FMN GV 11 Ramsel
66,Bergstraat 71,2019-07-10,14:00:00,134,70,64,FMN GV 11 Ramsel
66,Bergstraat 71,2019-07-10,15:00:00,142,76,66,FMN GV 11 Ramsel
66,Bergstraat 71,2019-07-10,16:00:00,116,80,36,FMN GV 11 Ramsel
66,Bergstraat 71,2019-07-10,17:00:00,132,56,76,FMN GV 11 Ramsel
66,Bergstraat 71,2019-07-10,18:00:00,126,62,64,FMN GV 11 Ramsel
66,Bergstraat 71,2019-07-10,19:00:00,86,54,32,FMN GV 11 Ramsel
66,Bergstraat 71,2019-07-10,20:00:00,40,28,12,FMN GV 11 Ramsel
66,Bergstraat 71,2019-07-10,21:00:00,36,22,14,FMN GV 11 Ramsel
66,Bergstraat 71,2019-07-10,22:00:00,12,10,2,FMN GV 11 Ramsel
66,Bergstraat 71,2019-07-10,23:00:00,6,6,0,FMN GV 11 Ramsel
66,Bergstraat 71,2019-07-11,00:00:00,6,4,2,FMN GV 11 Ramsel
66,Bergstraat 71,2019-07-11,01:00:00,4,4,0,FMN GV 11 Ramsel
66,Bergstraat 71,2019-07-11,02:00:00,0,0,0,FMN GV 11 Ramsel
66,Bergstraat 71,2019-07-11,03:00:00,0,0,0,FMN GV 11 Ramsel
66,Bergstraat 71,2019-07-11,04:00:00,4,4,0,FMN GV 11 Ramsel
66,Bergstraat 71,2019-07-11,05:00:00,8,4,4,FMN GV 11 Ramsel
66,Bergstraat 71,2019-07-11,06:00:00,36,14,22,FMN GV 11 Ramsel
66,Bergstraat 71,2019-07-11,07:00:00,54,24,30,FMN GV 11 Ramsel
66,Bergstraat 71,2019-07-11,08:00:00,70,26,44,FMN GV 11 Ramsel
66,Bergstraat 71,2019-07-11,09:00:00,126,48,78,FMN GV 11 Ramsel
66,Bergstraat 71,2019-07-11,10:00:00,192,38,154,FMN GV 11 Ramsel
66,Bergstraat 71,2019-07-11,11:00:00,208,104,104,FMN GV 11 Ramsel
66,Bergstraat 71,2019-07-11,12:00:00,248,114,134,FMN GV 11 Ramsel
66,Bergstraat 71,2019-07-11,13:00:00,150,76,74,FMN GV 11 Ramsel
66,Bergstraat 71,2019-07-11,14:00:00,186,126,60,FMN GV 11 Ramsel
66,Bergstraat 71,2019-07-11,15:00:00,120,68,52,FMN GV 11 Ramsel
66,Bergstraat 71,2019-07-11,16:00:00,136,70,66,FMN GV 11 Ramsel
66,Bergstraat 71,2019-07-11,17:00:00,104,56,48,FMN GV 11 Ramsel
66,Bergstraat 71,2019-07-11,18:00:00,122,58,64,FMN GV 11 Ramsel
66,Bergstraat 71,2019-07-11,19:00:00,116,58,58,FMN GV 11 Ramsel
66,Bergstraat 71,2019-07-11,20:00:00,68,54,14,FMN GV 11 Ramsel
66,Bergstraat 71,2019-07-11,21:00:00,28,18,10,FMN GV 11 Ramsel
66,Bergstraat 71,2019-07-11,22:00:00,4,4,0,FMN GV 11 Ramsel
66,Bergstraat 71,2019-07-11,23:00:00,4,4,0,FMN GV 11 Ramsel
66,Bergstraat 71,2019-07-12,00:00:00,2,2,0,FMN GV 11 Ramsel
66,Bergstraat 71,2019-07-12,01:00:00,0,0,0,FMN GV 11 Ramsel
66,Bergstraat 71,2019-07-12,02:00:00,6,4,2,FMN GV 11 Ramsel
66,Bergstraat 71,2019-07-12,03:00:00,2,0,2,FMN GV 11 Ramsel
66,Bergstraat 71,2019-07-12,04:00:00,0,0,0,FMN GV 11 Ramsel
66,Bergstraat 71,2019-07-12,05:00:00,12,6,6,FMN GV 11 Ramsel
66,Bergstraat 71,2019-07-12,06:00:00,26,6,20,FMN GV 11 Ramsel
66,Bergstraat 71,2019-07-12,07:00:00,34,10,24,FMN GV 11 Ramsel
66,Bergstraat 71,2019-07-12,08:00:00,58,12,46,FMN GV 11 Ramsel
66,Bergstraat 71,2019-07-12,09:00:00,50,16,34,FMN GV 11 Ramsel
66,Bergstraat 71,2019-07-12,10:00:00,48,26,22,FMN GV 11 Ramsel
66,Bergstraat 71,2019-07-12,11:00:00,56,34,22,FMN GV 11 Ramsel
66,Bergstraat 71,2019-07-12,12:00:00,70,40,30,FMN GV 11 Ramsel
66,Bergstraat 71,2019-07-12,13:00:00,36,26,10,FMN GV 11 Ramsel
66,Bergstraat 71,2019-07-12,14:00:00,36,16,20,FMN GV 11 Ramsel
66,Bergstraat 71,2019-07-12,15:00:00,28,14,14,FMN GV 11 Ramsel
66,Bergstraat 71,2019-07-12,16:00:00,86,48,38,FMN GV 11 Ramsel
66,Bergstraat 71,2019-07-12,17:00:00,82,54,28,FMN GV 11 Ramsel
66,Bergstraat 71,2019-07-12,18:00:00,84,46,38,FMN GV 11 Ramsel
66,Bergstraat 71,2019-07-12,19:00:00,34,10,24,FMN GV 11 Ramsel
66,Bergstraat 71,2019-07-12,20:00:00,34,12,22,FMN GV 11 Ramsel
66,Bergstraat 71,2019-07-12,21:00:00,22,12,10,FMN GV 11 Ramsel
66,Bergstraat 71,2019-07-12,22:00:00,26,22,4,FMN GV 11 Ramsel
66,Bergstraat 71,2019-07-12,23:00:00,4,2,2,FMN GV 11 Ramsel
66,Bergstraat 71,2019-07-13,00:00:00,6,4,2,FMN GV 11 Ramsel
66,Bergstraat 71,2019-07-13,01:00:00,0,0,0,FMN GV 11 Ramsel
66,Bergstraat 71,2019-07-13,02:00:00,4,2,2,FMN GV 11 Ramsel
66,Bergstraat 71,2019-07-13,03:00:00,6,6,0,FMN GV 11 Ramsel
66,Bergstraat 71,2019-07-13,04:00:00,0,0,0,FMN GV 11 Ramsel
66,Bergstraat 71,2019-07-13,05:00:00,6,2,4,FMN GV 11 Ramsel
66,Bergstraat 71,2019-07-13,06:00:00,10,2,8,FMN GV 11 Ramsel
66,Bergstraat 71,2019-07-13,07:00:00,38,12,26,FMN GV 11 Ramsel
66,Bergstraat 71,2019-07-13,08:00:00,24,8,16,FMN GV 11 Ramsel
66,Bergstraat 71,2019-07-13,09:00:00,36,22,14,FMN GV 11 Ramsel
66,Bergstraat 71,2019-07-13,10:00:00,62,28,34,FMN GV 11 Ramsel
66,Bergstraat 71,2019-07-13,11:00:00,66,26,40,FMN GV 11 Ramsel
66,Bergstraat 71,2019-07-13,12:00:00,88,46,42,FMN GV 11 Ramsel
66,Bergstraat 71,2019-07-13,13:00:00,74,36,38,FMN GV 11 Ramsel
66,Bergstraat 71,2019-07-13,14:00:00,94,42,52,FMN GV 11 Ramsel
66,Bergstraat 71,2019-07-13,15:00:00,74,44,30,FMN GV 11 Ramsel
66,Bergstraat 71,2019-07-13,16:00:00,106,62,44,FMN GV 11 Ramsel
66,Bergstraat 71,2019-07-13,17:00:00,70,34,36,FMN GV 11 Ramsel
66,Bergstraat 71,2019-07-13,18:00:00,86,32,54,FMN GV 11 Ramsel
66,Bergstraat 71,2019-07-13,19:00:00,38,20,18,FMN GV 11 Ramsel
66,Bergstraat 71,2019-07-13,20:00:00,38,12,26,FMN GV 11 Ramsel
66,Bergstraat 71,2019-07-13,21:00:00,18,12,6,FMN GV 11 Ramsel
66,Bergstraat 71,2019-07-13,22:00:00,18,18,0,FMN GV 11 Ramsel
66,Bergstraat 71,2019-07-13,23:00:00,10,2,8,FMN GV 11 Ramsel
66,Bergstraat 71,2019-07-14,00:00:00,4,4,0,FMN GV 11 Ramsel
66,Bergstraat 71,2019-07-14,01:00:00,2,0,2,FMN GV 11 Ramsel
66,Bergstraat 71,2019-07-14,02:00:00,6,4,2,FMN GV 11 Ramsel
66,Bergstraat 71,2019-07-14,03:00:00,10,8,2,FMN GV 11 Ramsel
66,Bergstraat 71,2019-07-14,04:00:00,4,2,2,FMN GV 11 Ramsel
66,Bergstraat 71,2019-07-14,05:00:00,2,0,2,FMN GV 11 Ramsel
66,Bergstraat 71,2019-07-14,06:00:00,20,4,16,FMN GV 11 Ramsel
66,Bergstraat 71,2019-07-14,07:00:00,44,12,32,FMN GV 11 Ramsel
66,Bergstraat 71,2019-07-14,08:00:00,82,28,54,FMN GV 11 Ramsel
66,Bergstraat 71,2019-07-14,09:00:00,174,82,92,FMN GV 11 Ramsel
66,Bergstraat 71,2019-07-14,10:00:00,186,110,76,FMN GV 11 Ramsel
66,Bergstraat 71,2019-07-14,11:00:00,276,140,136,FMN GV 11 Ramsel
66,Bergstraat 71,2019-07-14,12:00:00,164,82,82,FMN GV 11 Ramsel
66,Bergstraat 71,2019-07-14,13:00:00,162,126,36,FMN GV 11 Ramsel
66,Bergstraat 71,2019-07-14,14:00:00,198,114,84,FMN GV 11 Ramsel
66,Bergstraat 71,2019-07-14,15:00:00,194,100,94,FMN GV 11 Ramsel
66,Bergstraat 71,2019-07-14,16:00:00,120,48,72,FMN GV 11 Ramsel
66,Bergstraat 71,2019-07-14,17:00:00,90,36,54,FMN GV 11 Ramsel
66,Bergstraat 71,2019-07-14,18:00:00,88,36,52,FMN GV 11 Ramsel
66,Bergstraat 71,2019-07-14,19:00:00,28,16,12,FMN GV 11 Ramsel
66,Bergstraat 71,2019-07-14,20:00:00,36,20,16,FMN GV 11 Ramsel
66,Bergstraat 71,2019-07-14,21:00:00,26,22,4,FMN GV 11 Ramsel
66,Bergstraat 71,2019-07-14,22:00:00,10,8,2,FMN GV 11 Ramsel
66,Bergstraat 71,2019-07-14,23:00:00,12,10,2,FMN GV 11 Ramsel
66,Bergstraat 71,2019-07-15,00:00:00,20,20,0,FMN GV 11 Ramsel
66,Bergstraat 71,2019-07-15,01:00:00,2,2,0,FMN GV 11 Ramsel
66,Bergstraat 71,2019-07-15,02:00:00,4,4,0,FMN GV 11 Ramsel
66,Bergstraat 71,2019-07-15,03:00:00,2,0,2,FMN GV 11 Ramsel
66,Bergstraat 71,2019-07-15,04:00:00,0,0,0,FMN GV 11 Ramsel
66,Bergstraat 71,2019-07-15,05:00:00,6,4,2,FMN GV 11 Ramsel
66,Bergstraat 71,2019-07-15,06:00:00,42,20,22,FMN GV 11 Ramsel
66,Bergstraat 71,2019-07-15,07:00:00,54,16,38,FMN GV 11 Ramsel
66,Bergstraat 71,2019-07-15,08:00:00,32,10,22,FMN GV 11 Ramsel
66,Bergstraat 71,2019-07-15,09:00:00,56,18,38,FMN GV 11 Ramsel
66,Bergstraat 71,2019-07-15,10:00:00,102,38,64,FMN GV 11 Ramsel
66,Bergstraat 71,2019-07-15,11:00:00,52,34,18,FMN GV 11 Ramsel
66,Bergstraat 71,2019-07-15,12:00:00,84,46,38,FMN GV 11 Ramsel
66,Bergstraat 71,2019-07-15,13:00:00,120,66,54,FMN GV 11 Ramsel
66,Bergstraat 71,2019-07-15,14:00:00,120,72,48,FMN GV 11 Ramsel
66,Bergstraat 71,2019-07-15,15:00:00,110,56,54,FMN GV 11 Ramsel
66,Bergstraat 71,2019-07-15,16:00:00,90,48,42,FMN GV 11 Ramsel
66,Bergstraat 71,2019-07-15,17:00:00,134,86,48,FMN GV 11 Ramsel
66,Bergstraat 71,2019-07-15,18:00:00,76,44,32,FMN GV 11 Ramsel
66,Bergstraat 71,2019-07-15,19:00:00,30,18,12,FMN GV 11 Ramsel
66,Bergstraat 71,2019-07-15,20:00:00,82,26,56,FMN GV 11 Ramsel
66,Bergstraat 71,2019-07-15,21:00:00,26,14,12,FMN GV 11 Ramsel
66,Bergstraat 71,2019-07-15,22:00:00,10,6,4,FMN GV 11 Ramsel
66,Bergstraat 71,2019-07-15,23:00:00,8,6,2,FMN GV 11 Ramsel
66,Bergstraat 71,2019-07-16,00:00:00,2,2,0,FMN GV 11 Ramsel
66,Bergstraat 71,2019-07-16,01:00:00,0,0,0,FMN GV 11 Ramsel
66,Bergstraat 71,2019-07-16,02:00:00,2,2,0,FMN GV 11 Ramsel
66,Bergstraat 71,2019-07-16,03:00:00,0,0,0,FMN GV 11 Ramsel
66,Bergstraat 71,2019-07-16,04:00:00,0,0,0,FMN GV 11 Ramsel
66,Bergstraat 71,2019-07-16,05:00:00,4,0,4,FMN GV 11 Ramsel
66,Bergstraat 71,2019-07-16,06:00:00,40,12,28,FMN GV 11 Ramsel
66,Bergstraat 71,2019-07-16,07:00:00,60,16,44,FMN GV 11 Ramsel
66,Bergstraat 71,2019-07-16,08:00:00,60,18,42,FMN GV 11 Ramsel
66,Bergstraat 71,2019-07-16,09:00:00,84,34,50,FMN GV 11 Ramsel
66,Bergstraat 71,2019-07-16,10:00:00,94,48,46,FMN GV 11 Ramsel
66,Bergstraat 71,2019-07-16,11:00:00,118,60,58,FMN GV 11 Ramsel
66,Bergstraat 71,2019-07-16,12:00:00,126,64,62,FMN GV 11 Ramsel
66,Bergstraat 71,2019-07-16,13:00:00,200,88,112,FMN GV 11 Ramsel
66,Bergstraat 71,2019-07-16,14:00:00,248,140,108,FMN GV 11 Ramsel
66,Bergstraat 71,2019-07-16,15:00:00,296,190,106,FMN GV 11 Ramsel
66,Bergstraat 71,2019-07-16,16:00:00,224,138,86,FMN GV 11 Ramsel
66,Bergstraat 71,2019-07-16,17:00:00,222,110,112,FMN GV 11 Ramsel
66,Bergstraat 71,2019-07-16,18:00:00,158,92,66,FMN GV 11 Ramsel
66,Bergstraat 71,2019-07-16,19:00:00,86,40,46,FMN GV 11 Ramsel
66,Bergstraat 71,2019-07-16,20:00:00,90,46,44,FMN GV 11 Ramsel
66,Bergstraat 71,2019-07-16,21:00:00,78,28,50,FMN GV 11 Ramsel
66,Bergstraat 71,2019-07-16,22:00:00,22,10,12,FMN GV 11 Ramsel
66,Bergstraat 71,2019-07-16,23:00:00,10,10,0,FMN GV 11 Ramsel
66,Bergstraat 71,2019-07-17,00:00:00,0,0,0,FMN GV 11 Ramsel
66,Bergstraat 71,2019-07-17,01:00:00,0,0,0,FMN GV 11 Ramsel
66,Bergstraat 71,2019-07-17,02:00:00,4,4,0,FMN GV 11 Ramsel
66,Bergstraat 71,2019-07-17,03:00:00,2,2,0,FMN GV 11 Ramsel
66,Bergstraat 71,2019-07-17,04:00:00,0,0,0,FMN GV 11 Ramsel
66,Bergstraat 71,2019-07-17,05:00:00,10,4,6,FMN GV 11 Ramsel
66,Bergstraat 71,2019-07-17,06:00:00,40,14,26,FMN GV 11 Ramsel
66,Bergstraat 71,2019-07-17,07:00:00,62,14,48,FMN GV 11 Ramsel
66,Bergstraat 71,2019-07-17,08:00:00,86,28,58,FMN GV 11 Ramsel
66,Bergstraat 71,2019-07-17,09:00:00,76,34,42,FMN GV 11 Ramsel
66,Bergstraat 71,2019-07-17,10:00:00,174,64,110,FMN GV 11 Ramsel
66,Bergstraat 71,2019-07-17,11:00:00,110,46,64,FMN GV 11 Ramsel
66,Bergstraat 71,2019-07-17,12:00:00,152,84,68,FMN GV 11 Ramsel
66,Bergstraat 71,2019-07-17,13:00:00,260,114,146,FMN GV 11 Ramsel
66,Bergstraat 71,2019-07-17,14:00:00,282,110,172,FMN GV 11 Ramsel
66,Bergstraat 71,2019-07-17,15:00:00,264,126,138,FMN GV 11 Ramsel
66,Bergstraat 71,2019-07-17,16:00:00,214,130,84,FMN GV 11 Ramsel
66,Bergstraat 71,2019-07-17,17:00:00,166,92,74,FMN GV 11 Ramsel
66,Bergstraat 71,2019-07-17,18:00:00,162,86,76,FMN GV 11 Ramsel
66,Bergstraat 71,2019-07-17,19:00:00,132,56,76,FMN GV 11 Ramsel
66,Bergstraat 71,2019-07-17,20:00:00,74,42,32,FMN GV 11 Ramsel
66,Bergstraat 71,2019-07-17,21:00:00,90,74,16,FMN GV 11 Ramsel
66,Bergstraat 71,2019-07-17,22:00:00,14,6,8,FMN GV 11 Ramsel
66,Bergstraat 71,2019-07-17,23:00:00,6,4,2,FMN GV 11 Ramsel
66,Bergstraat 71,2019-07-18,00:00:00,6,6,0,FMN GV 11 Ramsel
66,Bergstraat 71,2019-07-18,01:00:00,2,2,0,FMN GV 11 Ramsel
66,Bergstraat 71,2019-07-18,02:00:00,0,0,0,FMN GV 11 Ramsel
66,Bergstraat 71,2019-07-18,03:00:00,2,0,2,FMN GV 11 Ramsel
66,Bergstraat 71,2019-07-18,04:00:00,0,0,0,FMN GV 11 Ramsel
66,Bergstraat 71,2019-07-18,05:00:00,8,4,4,FMN GV 11 Ramsel
66,Bergstraat 71,2019-07-18,06:00:00,42,14,28,FMN GV 11 Ramsel
66,Bergstraat 71,2019-07-18,07:00:00,44,14,30,FMN GV 11 Ramsel
66,Bergstraat 71,2019-07-18,08:00:00,68,28,40,FMN GV 11 Ramsel
66,Bergstraat 71,2019-07-18,09:00:00,78,20,58,FMN GV 11 Ramsel
66,Bergstraat 71,2019-07-18,10:00:00,104,40,64,FMN GV 11 Ramsel
66,Bergstraat 71,2019-07-18,11:00:00,122,64,58,FMN GV 11 Ramsel
66,Bergstraat 71,2019-07-18,12:00:00,86,52,34,FMN GV 11 Ramsel
66,Bergstraat 71,2019-07-18,13:00:00,180,82,98,FMN GV 11 Ramsel
66,Bergstraat 71,2019-07-18,14:00:00,198,94,104,FMN GV 11 Ramsel
66,Bergstraat 71,2019-07-18,15:00:00,182,120,62,FMN GV 11 Ramsel
66,Bergstraat 71,2019-07-18,16:00:00,150,78,72,FMN GV 11 Ramsel
66,Bergstraat 71,2019-07-18,17:00:00,128,94,34,FMN GV 11 Ramsel
66,Bergstraat 71,2019-07-18,18:00:00,114,52,62,FMN GV 11 Ramsel
66,Bergstraat 71,2019-07-18,19:00:00,76,42,34,FMN GV 11 Ramsel
66,Bergstraat 71,2019-07-18,20:00:00,60,30,30,FMN GV 11 Ramsel
66,Bergstraat 71,2019-07-18,21:00:00,18,6,12,FMN GV 11 Ramsel
66,Bergstraat 71,2019-07-18,22:00:00,26,16,10,FMN GV 11 Ramsel
66,Bergstraat 71,2019-07-18,23:00:00,0,0,0,FMN GV 11 Ramsel
66,Bergstraat 71,2019-07-19,00:00:00,0,0,0,FMN GV 11 Ramsel
66,Bergstraat 71,2019-07-19,01:00:00,0,0,0,FMN GV 11 Ramsel
66,Bergstraat 71,2019-07-19,02:00:00,4,4,0,FMN GV 11 Ramsel
66,Bergstraat 71,2019-07-19,03:00:00,0,0,0,FMN GV 11 Ramsel
66,Bergstraat 71,2019-07-19,04:00:00,0,0,0,FMN GV 11 Ramsel
66,Bergstraat 71,2019-07-19,05:00:00,12,2,10,FMN GV 11 Ramsel
66,Bergstraat 71,2019-07-19,06:00:00,40,16,24,FMN GV 11 Ramsel
66,Bergstraat 71,2019-07-19,07:00:00,54,16,38,FMN GV 11 Ramsel
66,Bergstraat 71,2019-07-19,08:00:00,32,22,10,FMN GV 11 Ramsel
66,Bergstraat 71,2019-07-19,09:00:00,86,26,60,FMN GV 11 Ramsel
66,Bergstraat 71,2019-07-19,10:00:00,164,74,90,FMN GV 11 Ramsel
66,Bergstraat 71,2019-07-19,11:00:00,166,86,80,FMN GV 11 Ramsel
66,Bergstraat 71,2019-07-19,12:00:00,168,84,84,FMN GV 11 Ramsel
66,Bergstraat 71,2019-07-19,13:00:00,262,142,120,FMN GV 11 Ramsel
66,Bergstraat 71,2019-07-19,14:00:00,274,110,164,FMN GV 11 Ramsel
66,Bergstraat 71,2019-07-19,15:00:00,222,136,86,FMN GV 11 Ramsel
66,Bergstraat 71,2019-07-19,16:00:00,202,112,90,FMN GV 11 Ramsel
66,Bergstraat 71,2019-07-19,17:00:00,108,74,34,FMN GV 11 Ramsel
66,Bergstraat 71,2019-07-19,18:00:00,124,32,92,FMN GV 11 Ramsel
66,Bergstraat 71,2019-07-19,19:00:00,68,28,40,FMN GV 11 Ramsel
66,Bergstraat 71,2019-07-19,20:00:00,60,42,18,FMN GV 11 Ramsel
66,Bergstraat 71,2019-07-19,21:00:00,38,24,14,FMN GV 11 Ramsel
66,Bergstraat 71,2019-07-19,22:00:00,22,14,8,FMN GV 11 Ramsel
66,Bergstraat 71,2019-07-19,23:00:00,8,6,2,FMN GV 11 Ramsel
66,Bergstraat 71,2019-07-20,00:00:00,12,8,4,FMN GV 11 Ramsel
66,Bergstraat 71,2019-07-20,01:00:00,0,0,0,FMN GV 11 Ramsel
66,Bergstraat 71,2019-07-20,02:00:00,2,0,2,FMN GV 11 Ramsel
66,Bergstraat 71,2019-07-20,03:00:00,10,8,2,FMN GV 11 Ramsel
66,Bergstraat 71,2019-07-20,04:00:00,0,0,0,FMN GV 11 Ramsel
66,Bergstraat 71,2019-07-20,05:00:00,4,2,2,FMN GV 11 Ramsel
66,Bergstraat 71,2019-07-20,06:00:00,10,4,6,FMN GV 11 Ramsel
66,Bergstraat 71,2019-07-20,07:00:00,18,6,12,FMN GV 11 Ramsel
66,Bergstraat 71,2019-07-20,08:00:00,62,18,44,FMN GV 11 Ramsel
66,Bergstraat 71,2019-07-20,09:00:00,124,84,40,FMN GV 11 Ramsel
66,Bergstraat 71,2019-07-20,10:00:00,94,36,58,FMN GV 11 Ramsel
66,Bergstraat 71,2019-07-20,11:00:00,72,40,32,FMN GV 11 Ramsel
66,Bergstraat 71,2019-07-20,12:00:00,80,44,36,FMN GV 11 Ramsel
66,Bergstraat 71,2019-07-20,13:00:00,112,44,68,FMN GV 11 Ramsel
66,Bergstraat 71,2019-07-20,14:00:00,158,68,90,FMN GV 11 Ramsel
66,Bergstraat 71,2019-07-20,15:00:00,58,30,28,FMN GV 11 Ramsel
66,Bergstraat 71,2019-07-20,16:00:00,104,80,24,FMN GV 11 Ramsel
66,Bergstraat 71,2019-07-20,17:00:00,56,32,24,FMN GV 11 Ramsel
66,Bergstraat 71,2019-07-20,18:00:00,50,20,30,FMN GV 11 Ramsel
66,Bergstraat 71,2019-07-20,19:00:00,60,40,20,FMN GV 11 Ramsel
66,Bergstraat 71,2019-07-20,20:00:00,16,4,12,FMN GV 11 Ramsel
66,Bergstraat 71,2019-07-20,21:00:00,34,12,22,FMN GV 11 Ramsel
66,Bergstraat 71,2019-07-20,22:00:00,14,8,6,FMN GV 11 Ramsel
66,Bergstraat 71,2019-07-20,23:00:00,8,6,2,FMN GV 11 Ramsel
66,Bergstraat 71,2019-07-21,00:00:00,6,4,2,FMN GV 11 Ramsel
66,Bergstraat 71,2019-07-21,01:00:00,6,4,2,FMN GV 11 Ramsel
66,Bergstraat 71,2019-07-21,02:00:00,2,2,0,FMN GV 11 Ramsel
66,Bergstraat 71,2019-07-21,03:00:00,4,4,0,FMN GV 11 Ramsel
66,Bergstraat 71,2019-07-21,04:00:00,12,12,0,FMN GV 11 Ramsel
66,Bergstraat 71,2019-07-21,05:00:00,8,2,6,FMN GV 11 Ramsel
66,Bergstraat 71,2019-07-21,06:00:00,18,0,18,FMN GV 11 Ramsel
66,Bergstraat 71,2019-07-21,07:00:00,42,6,36,FMN GV 11 Ramsel
66,Bergstraat 71,2019-07-21,08:00:00,104,44,60,FMN GV 11 Ramsel
66,Bergstraat 71,2019-07-21,09:00:00,110,50,60,FMN GV 11 Ramsel
66,Bergstraat 71,2019-07-21,10:00:00,266,136,130,FMN GV 11 Ramsel
66,Bergstraat 71,2019-07-21,11:00:00,422,136,286,FMN GV 11 Ramsel
66,Bergstraat 71,2019-07-21,12:00:00,178,88,90,FMN GV 11 Ramsel
66,Bergstraat 71,2019-07-21,13:00:00,378,136,242,FMN GV 11 Ramsel
66,Bergstraat 71,2019-07-21,14:00:00,348,204,144,FMN GV 11 Ramsel
66,Bergstraat 71,2019-07-21,15:00:00,270,142,128,FMN GV 11 Ramsel
66,Bergstraat 71,2019-07-21,16:00:00,250,126,124,FMN GV 11 Ramsel
66,Bergstraat 71,2019-07-21,17:00:00,166,78,88,FMN GV 11 Ramsel
66,Bergstraat 71,2019-07-21,18:00:00,192,108,84,FMN GV 11 Ramsel
66,Bergstraat 71,2019-07-21,19:00:00,80,46,34,FMN GV 11 Ramsel
66,Bergstraat 71,2019-07-21,20:00:00,80,36,44,FMN GV 11 Ramsel
66,Bergstraat 71,2019-07-21,21:00:00,48,36,12,FMN GV 11 Ramsel
66,Bergstraat 71,2019-07-21,22:00:00,24,22,2,FMN GV 11 Ramsel
66,Bergstraat 71,2019-07-21,23:00:00,8,6,2,FMN GV 11 Ramsel
66,Bergstraat 71,2019-07-22,00:00:00,14,12,2,FMN GV 11 Ramsel
66,Bergstraat 71,2019-07-22,01:00:00,0,0,0,FMN GV 11 Ramsel
66,Bergstraat 71,2019-07-22,02:00:00,0,0,0,FMN GV 11 Ramsel
66,Bergstraat 71,2019-07-22,03:00:00,0,0,0,FMN GV 11 Ramsel
66,Bergstraat 71,2019-07-22,04:00:00,2,2,0,FMN GV 11 Ramsel
66,Bergstraat 71,2019-07-22,05:00:00,12,6,6,FMN GV 11 Ramsel
66,Bergstraat 71,2019-07-22,06:00:00,44,4,40,FMN GV 11 Ramsel
66,Bergstraat 71,2019-07-22,07:00:00,64,16,48,FMN GV 11 Ramsel
66,Bergstraat 71,2019-07-22,08:00:00,58,18,40,FMN GV 11 Ramsel
66,Bergstraat 71,2019-07-22,09:00:00,84,42,42,FMN GV 11 Ramsel
66,Bergstraat 71,2019-07-22,10:00:00,122,46,76,FMN GV 11 Ramsel
66,Bergstraat 71,2019-07-22,11:00:00,146,62,84,FMN GV 11 Ramsel
66,Bergstraat 71,2019-07-22,12:00:00,166,84,82,FMN GV 11 Ramsel
66,Bergstraat 71,2019-07-22,13:00:00,274,124,150,FMN GV 11 Ramsel
66,Bergstraat 71,2019-07-22,14:00:00,218,146,72,FMN GV 11 Ramsel
66,Bergstraat 71,2019-07-22,15:00:00,222,110,112,FMN GV 11 Ramsel
66,Bergstraat 71,2019-07-22,16:00:00,252,164,88,FMN GV 11 Ramsel
66,Bergstraat 71,2019-07-22,17:00:00,184,126,58,FMN GV 11 Ramsel
66,Bergstraat 71,2019-07-22,18:00:00,152,80,72,FMN GV 11 Ramsel
66,Bergstraat 71,2019-07-22,19:00:00,152,98,54,FMN GV 11 Ramsel
66,Bergstraat 71,2019-07-22,20:00:00,132,84,48,FMN GV 11 Ramsel
66,Bergstraat 71,2019-07-22,21:00:00,96,48,48,FMN GV 11 Ramsel
66,Bergstraat 71,2019-07-22,22:00:00,28,16,12,FMN GV 11 Ramsel
66,Bergstraat 71,2019-07-22,23:00:00,0,0,0,FMN GV 11 Ramsel
66,Bergstraat 71,2019-07-23,00:00:00,4,2,2,FMN GV 11 Ramsel
66,Bergstraat 71,2019-07-23,01:00:00,0,0,0,FMN GV 11 Ramsel
66,Bergstraat 71,2019-07-23,02:00:00,4,4,0,FMN GV 11 Ramsel
66,Bergstraat 71,2019-07-23,03:00:00,0,0,0,FMN GV 11 Ramsel
66,Bergstraat 71,2019-07-23,04:00:00,2,2,0,FMN GV 11 Ramsel
66,Bergstraat 71,2019-07-23,05:00:00,12,2,10,FMN GV 11 Ramsel
66,Bergstraat 71,2019-07-23,06:00:00,58,18,40,FMN GV 11 Ramsel
66,Bergstraat 71,2019-07-23,07:00:00,90,30,60,FMN GV 11 Ramsel
66,Bergstraat 71,2019-07-23,08:00:00,108,42,66,FMN GV 11 Ramsel
66,Bergstraat 71,2019-07-23,09:00:00,160,60,100,FMN GV 11 Ramsel
66,Bergstraat 71,2019-07-23,10:00:00,196,92,104,FMN GV 11 Ramsel
66,Bergstraat 71,2019-07-23,11:00:00,162,76,86,FMN GV 11 Ramsel
66,Bergstraat 71,2019-07-23,12:00:00,110,56,54,FMN GV 11 Ramsel
66,Bergstraat 71,2019-07-23,13:00:00,138,88,50,FMN GV 11 Ramsel
66,Bergstraat 71,2019-07-23,14:00:00,126,66,60,FMN GV 11 Ramsel
66,Bergstraat 71,2019-07-23,15:00:00,114,60,54,FMN GV 11 Ramsel
66,Bergstraat 71,2019-07-23,16:00:00,108,54,54,FMN GV 11 Ramsel
66,Bergstraat 71,2019-07-23,17:00:00,86,60,26,FMN GV 11 Ramsel
66,Bergstraat 71,2019-07-23,18:00:00,114,68,46,FMN GV 11 Ramsel
66,Bergstraat 71,2019-07-23,19:00:00,98,48,50,FMN GV 11 Ramsel
66,Bergstraat 71,2019-07-23,20:00:00,80,42,38,FMN GV 11 Ramsel
66,Bergstraat 71,2019-07-23,21:00:00,90,52,38,FMN GV 11 Ramsel
66,Bergstraat 71,2019-07-23,22:00:00,48,18,30,FMN GV 11 Ramsel
66,Bergstraat 71,2019-07-23,23:00:00,10,10,0,FMN GV 11 Ramsel
66,Bergstraat 71,2019-07-24,00:00:00,4,0,4,FMN GV 11 Ramsel
66,Bergstraat 71,2019-07-24,01:00:00,10,6,4,FMN GV 11 Ramsel
66,Bergstraat 71,2019-07-24,02:00:00,4,4,0,FMN GV 11 Ramsel
66,Bergstraat 71,2019-07-24,03:00:00,8,0,8,FMN GV 11 Ramsel
66,Bergstraat 71,2019-07-24,04:00:00,4,4,0,FMN GV 11 Ramsel
66,Bergstraat 71,2019-07-24,05:00:00,10,2,8,FMN GV 11 Ramsel
66,Bergstraat 71,2019-07-24,06:00:00,74,16,58,FMN GV 11 Ramsel
66,Bergstraat 71,2019-07-24,07:00:00,60,10,50,FMN GV 11 Ramsel
66,Bergstraat 71,2019-07-24,08:00:00,134,42,92,FMN GV 11 Ramsel
66,Bergstraat 71,2019-07-24,09:00:00,148,62,86,FMN GV 11 Ramsel
66,Bergstraat 71,2019-07-24,10:00:00,142,60,82,FMN GV 11 Ramsel
66,Bergstraat 71,2019-07-24,11:00:00,112,80,32,FMN GV 11 Ramsel
66,Bergstraat 71,2019-07-24,12:00:00,92,60,32,FMN GV 11 Ramsel
66,Bergstraat 71,2019-07-24,13:00:00,68,28,40,FMN GV 11 Ramsel
66,Bergstraat 71,2019-07-24,14:00:00,56,32,24,FMN GV 11 Ramsel
66,Bergstraat 71,2019-07-24,15:00:00,56,32,24,FMN GV 11 Ramsel
66,Bergstraat 71,2019-07-24,16:00:00,70,48,22,FMN GV 11 Ramsel
66,Bergstraat 71,2019-07-24,17:00:00,98,60,38,FMN GV 11 Ramsel
66,Bergstraat 71,2019-07-24,18:00:00,60,40,20,FMN GV 11 Ramsel
66,Bergstraat 71,2019-07-24,19:00:00,100,44,56,FMN GV 11 Ramsel
66,Bergstraat 71,2019-07-24,20:00:00,94,58,36,FMN GV 11 Ramsel
66,Bergstraat 71,2019-07-24,21:00:00,76,46,30,FMN GV 11 Ramsel
66,Bergstraat 71,2019-07-24,22:00:00,44,14,30,FMN GV 11 Ramsel
66,Bergstraat 71,2019-07-24,23:00:00,16,8,8,FMN GV 11 Ramsel
66,Bergstraat 71,2019-07-25,00:00:00,4,2,2,FMN GV 11 Ramsel
66,Bergstraat 71,2019-07-25,01:00:00,4,2,2,FMN GV 11 Ramsel
66,Bergstraat 71,2019-07-25,02:00:00,2,0,2,FMN GV 11 Ramsel
66,Bergstraat 71,2019-07-25,03:00:00,2,0,2,FMN GV 11 Ramsel
66,Bergstraat 71,2019-07-25,04:00:00,2,2,0,FMN GV 11 Ramsel
66,Bergstraat 71,2019-07-25,05:00:00,10,2,8,FMN GV 11 Ramsel
66,Bergstraat 71,2019-07-25,06:00:00,44,14,30,FMN GV 11 Ramsel
66,Bergstraat 71,2019-07-25,07:00:00,76,24,52,FMN GV 11 Ramsel
66,Bergstraat 71,2019-07-25,08:00:00,134,52,82,FMN GV 11 Ramsel
66,Bergstraat 71,2019-07-25,09:00:00,154,66,88,FMN GV 11 Ramsel
66,Bergstraat 71,2019-07-25,10:00:00,100,56,44,FMN GV 11 Ramsel
66,Bergstraat 71,2019-07-25,11:00:00,74,56,18,FMN GV 11 Ramsel
66,Bergstraat 71,2019-07-25,12:00:00,30,20,10,FMN GV 11 Ramsel
66,Bergstraat 71,2019-07-25,13:00:00,32,16,16,FMN GV 11 Ramsel
66,Bergstraat 71,2019-07-25,14:00:00,36,22,14,FMN GV 11 Ramsel
66,Bergstraat 71,2019-07-25,15:00:00,40,26,14,FMN GV 11 Ramsel
66,Bergstraat 71,2019-07-25,16:00:00,28,16,12,FMN GV 11 Ramsel
66,Bergstraat 71,2019-07-25,17:00:00,72,56,16,FMN GV 11 Ramsel
66,Bergstraat 71,2019-07-25,18:00:00,22,12,10,FMN GV 11 Ramsel
66,Bergstraat 71,2019-07-25,19:00:00,38,20,18,FMN GV 11 Ramsel
66,Bergstraat 71,2019-07-25,20:00:00,42,26,16,FMN GV 11 Ramsel
66,Bergstraat 71,2019-07-25,21:00:00,20,10,10,FMN GV 11 Ramsel
66,Bergstraat 71,2019-07-25,22:00:00,22,16,6,FMN GV 11 Ramsel
66,Bergstraat 71,2019-07-25,23:00:00,6,6,0,FMN GV 11 Ramsel
66,Bergstraat 71,2019-07-26,00:00:00,4,2,2,FMN GV 11 Ramsel
66,Bergstraat 71,2019-07-26,01:00:00,0,0,0,FMN GV 11 Ramsel
66,Bergstraat 71,2019-07-26,02:00:00,0,0,0,FMN GV 11 Ramsel
66,Bergstraat 71,2019-07-26,03:00:00,4,4,0,FMN GV 11 Ramsel
66,Bergstraat 71,2019-07-26,04:00:00,4,0,4,FMN GV 11 Ramsel
66,Bergstraat 71,2019-07-26,05:00:00,12,2,10,FMN GV 11 Ramsel
66,Bergstraat 71,2019-07-26,06:00:00,58,10,48,FMN GV 11 Ramsel
66,Bergstraat 71,2019-07-26,07:00:00,68,26,42,FMN GV 11 Ramsel
66,Bergstraat 71,2019-07-26,08:00:00,108,52,56,FMN GV 11 Ramsel
66,Bergstraat 71,2019-07-26,09:00:00,94,46,48,FMN GV 11 Ramsel
66,Bergstraat 71,2019-07-26,10:00:00,118,70,48,FMN GV 11 Ramsel
66,Bergstraat 71,2019-07-26,11:00:00,140,66,74,FMN GV 11 Ramsel
66,Bergstraat 71,2019-07-26,12:00:00,56,38,18,FMN GV 11 Ramsel
66,Bergstraat 71,2019-07-26,13:00:00,76,50,26,FMN GV 11 Ramsel
66,Bergstraat 71,2019-07-26,14:00:00,92,44,48,FMN GV 11 Ramsel
66,Bergstraat 71,2019-07-26,15:00:00,78,42,36,FMN GV 11 Ramsel
66,Bergstraat 71,2019-07-26,16:00:00,76,44,32,FMN GV 11 Ramsel
66,Bergstraat 71,2019-07-26,17:00:00,72,42,30,FMN GV 11 Ramsel
66,Bergstraat 71,2019-07-26,18:00:00,62,38,24,FMN GV 11 Ramsel
66,Bergstraat 71,2019-07-26,19:00:00,14,4,10,FMN GV 11 Ramsel
66,Bergstraat 71,2019-07-26,20:00:00,28,14,14,FMN GV 11 Ramsel
66,Bergstraat 71,2019-07-26,21:00:00,34,24,10,FMN GV 11 Ramsel
66,Bergstraat 71,2019-07-26,22:00:00,14,4,10,FMN GV 11 Ramsel
66,Bergstraat 71,2019-07-26,23:00:00,8,6,2,FMN GV 11 Ramsel
66,Bergstraat 71,2019-07-27,00:00:00,10,2,8,FMN GV 11 Ramsel
66,Bergstraat 71,2019-07-27,01:00:00,8,4,4,FMN GV 11 Ramsel
66,Bergstraat 71,2019-07-27,02:00:00,6,2,4,FMN GV 11 Ramsel
66,Bergstraat 71,2019-07-27,03:00:00,10,6,4,FMN GV 11 Ramsel
66,Bergstraat 71,2019-07-27,04:00:00,0,0,0,FMN GV 11 Ramsel
66,Bergstraat 71,2019-07-27,05:00:00,6,4,2,FMN GV 11 Ramsel
66,Bergstraat 71,2019-07-27,06:00:00,2,2,0,FMN GV 11 Ramsel
66,Bergstraat 71,2019-07-27,07:00:00,18,4,14,FMN GV 11 Ramsel
66,Bergstraat 71,2019-07-27,08:00:00,28,10,18,FMN GV 11 Ramsel
66,Bergstraat 71,2019-07-27,09:00:00,66,32,34,FMN GV 11 Ramsel
66,Bergstraat 71,2019-07-27,10:00:00,60,36,24,FMN GV 11 Ramsel
66,Bergstraat 71,2019-07-27,11:00:00,46,24,22,FMN GV 11 Ramsel
66,Bergstraat 71,2019-07-27,12:00:00,20,14,6,FMN GV 11 Ramsel
66,Bergstraat 71,2019-07-27,13:00:00,20,6,14,FMN GV 11 Ramsel
66,Bergstraat 71,2019-07-27,14:00:00,28,14,14,FMN GV 11 Ramsel
66,Bergstraat 71,2019-07-27,15:00:00,30,26,4,FMN GV 11 Ramsel
66,Bergstraat 71,2019-07-27,16:00:00,24,12,12,FMN GV 11 Ramsel
66,Bergstraat 71,2019-07-27,17:00:00,12,4,8,FMN GV 11 Ramsel
66,Bergstraat 71,2019-07-27,18:00:00,10,0,10,FMN GV 11 Ramsel
66,Bergstraat 71,2019-07-27,19:00:00,14,8,6,FMN GV 11 Ramsel
66,Bergstraat 71,2019-07-27,20:00:00,14,2,12,FMN GV 11 Ramsel
66,Bergstraat 71,2019-07-27,21:00:00,0,0,0,FMN GV 11 Ramsel
66,Bergstraat 71,2019-07-27,22:00:00,10,8,2,FMN GV 11 Ramsel
66,Bergstraat 71,2019-07-27,23:00:00,0,0,0,FMN GV 11 Ramsel
66,Bergstraat 71,2019-07-28,00:00:00,0,0,0,FMN GV 11 Ramsel
66,Bergstraat 71,2019-07-28,01:00:00,2,0,2,FMN GV 11 Ramsel
66,Bergstraat 71,2019-07-28,02:00:00,4,4,0,FMN GV 11 Ramsel
66,Bergstraat 71,2019-07-28,03:00:00,0,0,0,FMN GV 11 Ramsel
66,Bergstraat 71,2019-07-28,04:00:00,2,2,0,FMN GV 11 Ramsel
66,Bergstraat 71,2019-07-28,05:00:00,0,0,0,FMN GV 11 Ramsel
66,Bergstraat 71,2019-07-28,06:00:00,2,2,0,FMN GV 11 Ramsel
66,Bergstraat 71,2019-07-28,07:00:00,2,0,2,FMN GV 11 Ramsel
66,Bergstraat 71,2019-07-28,08:00:00,22,12,10,FMN GV 11 Ramsel
66,Bergstraat 71,2019-07-28,09:00:00,72,40,32,FMN GV 11 Ramsel
66,Bergstraat 71,2019-07-28,10:00:00,44,30,14,FMN GV 11 Ramsel
66,Bergstraat 71,2019-07-28,11:00:00,46,34,12,FMN GV 11 Ramsel
66,Bergstraat 71,2019-07-28,12:00:00,22,8,14,FMN GV 11 Ramsel
66,Bergstraat 71,2019-07-28,13:00:00,36,22,14,FMN GV 11 Ramsel
66,Bergstraat 71,2019-07-28,14:00:00,36,12,24,FMN GV 11 Ramsel
66,Bergstraat 71,2019-07-28,15:00:00,38,16,22,FMN GV 11 Ramsel
66,Bergstraat 71,2019-07-28,16:00:00,40,18,22,FMN GV 11 Ramsel
66,Bergstraat 71,2019-07-28,17:00:00,50,14,36,FMN GV 11 Ramsel
66,Bergstraat 71,2019-07-28,18:00:00,26,18,8,FMN GV 11 Ramsel
66,Bergstraat 71,2019-07-28,19:00:00,12,4,8,FMN GV 11 Ramsel
66,Bergstraat 71,2019-07-28,20:00:00,24,20,4,FMN GV 11 Ramsel
66,Bergstraat 71,2019-07-28,21:00:00,4,2,2,FMN GV 11 Ramsel
66,Bergstraat 71,2019-07-28,22:00:00,2,2,0,FMN GV 11 Ramsel
66,Bergstraat 71,2019-07-28,23:00:00,2,2,0,FMN GV 11 Ramsel
66,Bergstraat 71,2019-07-29,00:00:00,0,0,0,FMN GV 11 Ramsel
66,Bergstraat 71,2019-07-29,01:00:00,0,0,0,FMN GV 11 Ramsel
66,Bergstraat 71,2019-07-29,02:00:00,2,0,2,FMN GV 11 Ramsel
66,Bergstraat 71,2019-07-29,03:00:00,0,0,0,FMN GV 11 Ramsel
66,Bergstraat 71,2019-07-29,04:00:00,4,0,4,FMN GV 11 Ramsel
66,Bergstraat 71,2019-07-29,05:00:00,6,2,4,FMN GV 11 Ramsel
66,Bergstraat 71,2019-07-29,06:00:00,36,8,28,FMN GV 11 Ramsel
66,Bergstraat 71,2019-07-29,07:00:00,56,16,40,FMN GV 11 Ramsel
66,Bergstraat 71,2019-07-29,08:00:00,56,26,30,FMN GV 11 Ramsel
66,Bergstraat 71,2019-07-29,09:00:00,92,34,58,FMN GV 11 Ramsel
66,Bergstraat 71,2019-07-29,10:00:00,130,66,64,FMN GV 11 Ramsel
66,Bergstraat 71,2019-07-29,11:00:00,124,44,80,FMN GV 11 Ramsel
66,Bergstraat 71,2019-07-29,12:00:00,82,42,40,FMN GV 11 Ramsel
66,Bergstraat 71,2019-07-29,13:00:00,310,164,146,FMN GV 11 Ramsel
66,Bergstraat 71,2019-07-29,14:00:00,290,140,150,FMN GV 11 Ramsel
66,Bergstraat 71,2019-07-29,15:00:00,302,132,170,FMN GV 11 Ramsel
66,Bergstraat 71,2019-07-29,16:00:00,254,154,100,FMN GV 11 Ramsel
66,Bergstraat 71,2019-07-29,17:00:00,156,92,64,FMN GV 11 Ramsel
66,Bergstraat 71,2019-07-29,18:00:00,142,68,74,FMN GV 11 Ramsel
66,Bergstraat 71,2019-07-29,19:00:00,144,54,90,FMN GV 11 Ramsel
66,Bergstraat 71,2019-07-29,20:00:00,110,64,46,FMN GV 11 Ramsel
66,Bergstraat 71,2019-07-29,21:00:00,62,40,22,FMN GV 11 Ramsel
66,Bergstraat 71,2019-07-29,22:00:00,20,12,8,FMN GV 11 Ramsel
66,Bergstraat 71,2019-07-29,23:00:00,0,0,0,FMN GV 11 Ramsel
66,Bergstraat 71,2019-07-30,00:00:00,4,4,0,FMN GV 11 Ramsel
66,Bergstraat 71,2019-07-30,01:00:00,0,0,0,FMN GV 11 Ramsel
66,Bergstraat 71,2019-07-30,02:00:00,0,0,0,FMN GV 11 Ramsel
66,Bergstraat 71,2019-07-30,03:00:00,0,0,0,FMN GV 11 Ramsel
66,Bergstraat 71,2019-07-30,04:00:00,0,0,0,FMN GV 11 Ramsel
66,Bergstraat 71,2019-07-30,05:00:00,8,0,8,FMN GV 11 Ramsel
66,Bergstraat 71,2019-07-30,06:00:00,52,14,38,FMN GV 11 Ramsel
66,Bergstraat 71,2019-07-30,07:00:00,68,18,50,FMN GV 11 Ramsel
66,Bergstraat 71,2019-07-30,08:00:00,66,20,46,FMN GV 11 Ramsel
66,Bergstraat 71,2019-07-30,09:00:00,130,60,70,FMN GV 11 Ramsel
66,Bergstraat 71,2019-07-30,10:00:00,154,66,88,FMN GV 11 Ramsel
66,Bergstraat 71,2019-07-30,11:00:00,124,64,60,FMN GV 11 Ramsel
66,Bergstraat 71,2019-07-30,12:00:00,212,144,68,FMN GV 11 Ramsel
66,Bergstraat 71,2019-07-30,13:00:00,230,136,94,FMN GV 11 Ramsel
66,Bergstraat 71,2019-07-30,14:00:00,254,120,134,FMN GV 11 Ramsel
66,Bergstraat 71,2019-07-30,15:00:00,204,114,90,FMN GV 11 Ramsel
66,Bergstraat 71,2019-07-30,16:00:00,192,132,60,FMN GV 11 Ramsel
66,Bergstraat 71,2019-07-30,17:00:00,228,132,96,FMN GV 11 Ramsel
66,Bergstraat 71,2019-07-30,18:00:00,176,70,106,FMN GV 11 Ramsel
66,Bergstraat 71,2019-07-30,19:00:00,96,40,56,FMN GV 11 Ramsel
66,Bergstraat 71,2019-07-30,20:00:00,94,66,28,FMN GV 11 Ramsel
66,Bergstraat 71,2019-07-30,21:00:00,44,20,24,FMN GV 11 Ramsel
66,Bergstraat 71,2019-07-30,22:00:00,6,4,2,FMN GV 11 Ramsel
66,Bergstraat 71,2019-07-30,23:00:00,4,4,0,FMN GV 11 Ramsel
66,Bergstraat 71,2019-07-31,00:00:00,2,0,2,FMN GV 11 Ramsel
66,Bergstraat 71,2019-07-31,01:00:00,8,6,2,FMN GV 11 Ramsel
66,Bergstraat 71,2019-07-31,02:00:00,0,0,0,FMN GV 11 Ramsel
66,Bergstraat 71,2019-07-31,03:00:00,0,0,0,FMN GV 11 Ramsel
66,Bergstraat 71,2019-07-31,04:00:00,0,0,0,FMN GV 11 Ramsel
66,Bergstraat 71,2019-07-31,05:00:00,12,8,4,FMN GV 11 Ramsel
66,Bergstraat 71,2019-07-31,06:00:00,32,8,24,FMN GV 11 Ramsel
66,Bergstraat 71,2019-07-31,07:00:00,50,10,40,FMN GV 11 Ramsel
66,Bergstraat 71,2019-07-31,08:00:00,40,14,26,FMN GV 11 Ramsel
66,Bergstraat 71,2019-07-31,09:00:00,86,34,52,FMN GV 11 Ramsel
66,Bergstraat 71,2019-07-31,10:00:00,98,26,72,FMN GV 11 Ramsel
66,Bergstraat 71,2019-07-31,11:00:00,148,100,48,FMN GV 11 Ramsel
66,Bergstraat 71,2019-07-31,12:00:00,46,28,18,FMN GV 11 Ramsel
66,Bergstraat 71,2019-07-31,13:00:00,152,82,70,FMN GV 11 Ramsel
66,Bergstraat 71,2019-07-31,14:00:00,110,52,58,FMN GV 11 Ramsel
66,Bergstraat 71,2019-07-31,15:00:00,126,76,50,FMN GV 11 Ramsel
66,Bergstraat 71,2019-07-31,16:00:00,130,72,58,FMN GV 11 Ramsel
66,Bergstraat 71,2019-07-31,17:00:00,98,62,36,FMN GV 11 Ramsel
66,Bergstraat 71,2019-07-31,18:00:00,86,40,46,FMN GV 11 Ramsel
66,Bergstraat 71,2019-07-31,19:00:00,144,72,72,FMN GV 11 Ramsel
66,Bergstraat 71,2019-07-31,20:00:00,94,60,34,FMN GV 11 Ramsel
66,Bergstraat 71,2019-07-31,21:00:00,30,14,16,FMN GV 11 Ramsel
66,Bergstraat 71,2019-07-31,22:00:00,14,8,6,FMN GV 11 Ramsel
66,Bergstraat 71,2019-07-31,23:00:00,6,6,0,FMN GV 11 Ramsel
66,Bergstraat 71,2019-08-01,00:00:00,8,6,2,FMN GV 11 Ramsel
66,Bergstraat 71,2019-08-01,01:00:00,0,0,0,FMN GV 11 Ramsel
66,Bergstraat 71,2019-08-01,02:00:00,0,0,0,FMN GV 11 Ramsel
66,Bergstraat 71,2019-08-01,03:00:00,2,0,2,FMN GV 11 Ramsel
66,Bergstraat 71,2019-08-01,04:00:00,0,0,0,FMN GV 11 Ramsel
66,Bergstraat 71,2019-08-01,05:00:00,8,2,6,FMN GV 11 Ramsel
66,Bergstraat 71,2019-08-01,06:00:00,38,12,26,FMN GV 11 Ramsel
66,Bergstraat 71,2019-08-01,07:00:00,46,12,34,FMN GV 11 Ramsel
66,Bergstraat 71,2019-08-01,08:00:00,70,16,54,FMN GV 11 Ramsel
66,Bergstraat 71,2019-08-01,09:00:00,84,28,56,FMN GV 11 Ramsel
66,Bergstraat 71,2019-08-01,10:00:00,96,32,64,FMN GV 11 Ramsel
66,Bergstraat 71,2019-08-01,11:00:00,114,76,38,FMN GV 11 Ramsel
66,Bergstraat 71,2019-08-01,12:00:00,180,76,104,FMN GV 11 Ramsel
66,Bergstraat 71,2019-08-01,13:00:00,238,100,138,FMN GV 11 Ramsel
66,Bergstraat 71,2019-08-01,14:00:00,192,116,76,FMN GV 11 Ramsel
66,Bergstraat 71,2019-08-01,15:00:00,246,128,118,FMN GV 11 Ramsel
66,Bergstraat 71,2019-08-01,16:00:00,190,110,80,FMN GV 11 Ramsel
66,Bergstraat 71,2019-08-01,17:00:00,156,106,50,FMN GV 11 Ramsel
66,Bergstraat 71,2019-08-01,18:00:00,84,32,52,FMN GV 11 Ramsel
66,Bergstraat 71,2019-08-01,19:00:00,104,56,48,FMN GV 11 Ramsel
66,Bergstraat 71,2019-08-01,20:00:00,88,40,48,FMN GV 11 Ramsel
66,Bergstraat 71,2019-08-01,21:00:00,38,24,14,FMN GV 11 Ramsel
66,Bergstraat 71,2019-08-01,22:00:00,22,8,14,FMN GV 11 Ramsel
66,Bergstraat 71,2019-08-01,23:00:00,10,6,4,FMN GV 11 Ramsel
66,Bergstraat 71,2019-08-02,00:00:00,2,2,0,FMN GV 11 Ramsel
66,Bergstraat 71,2019-08-02,01:00:00,0,0,0,FMN GV 11 Ramsel
66,Bergstraat 71,2019-08-02,02:00:00,0,0,0,FMN GV 11 Ramsel
66,Bergstraat 71,2019-08-02,03:00:00,6,2,4,FMN GV 11 Ramsel
66,Bergstraat 71,2019-08-02,04:00:00,2,0,2,FMN GV 11 Ramsel
66,Bergstraat 71,2019-08-02,05:00:00,8,2,6,FMN GV 11 Ramsel
66,Bergstraat 71,2019-08-02,06:00:00,30,8,22,FMN GV 11 Ramsel
66,Bergstraat 71,2019-08-02,07:00:00,44,12,32,FMN GV 11 Ramsel
66,Bergstraat 71,2019-08-02,08:00:00,56,20,36,FMN GV 11 Ramsel
66,Bergstraat 71,2019-08-02,09:00:00,84,26,58,FMN GV 11 Ramsel
66,Bergstraat 71,2019-08-02,10:00:00,84,42,42,FMN GV 11 Ramsel
66,Bergstraat 71,2019-08-02,11:00:00,98,52,46,FMN GV 11 Ramsel
66,Bergstraat 71,2019-08-02,12:00:00,50,28,22,FMN GV 11 Ramsel
66,Bergstraat 71,2019-08-02,13:00:00,78,30,48,FMN GV 11 Ramsel
66,Bergstraat 71,2019-08-02,14:00:00,90,42,48,FMN GV 11 Ramsel
66,Bergstraat 71,2019-08-02,15:00:00,74,42,32,FMN GV 11 Ramsel
66,Bergstraat 71,2019-08-02,16:00:00,72,40,32,FMN GV 11 Ramsel
66,Bergstraat 71,2019-08-02,17:00:00,114,70,44,FMN GV 11 Ramsel
66,Bergstraat 71,2019-08-02,18:00:00,46,28,18,FMN GV 11 Ramsel
66,Bergstraat 71,2019-08-02,19:00:00,56,32,24,FMN GV 11 Ramsel
66,Bergstraat 71,2019-08-02,20:00:00,38,12,26,FMN GV 11 Ramsel
66,Bergstraat 71,2019-08-02,21:00:00,22,14,8,FMN GV 11 Ramsel
66,Bergstraat 71,2019-08-02,22:00:00,10,8,2,FMN GV 11 Ramsel
66,Bergstraat 71,2019-08-02,23:00:00,10,8,2,FMN GV 11 Ramsel
66,Bergstraat 71,2019-08-03,00:00:00,6,4,2,FMN GV 11 Ramsel
66,Bergstraat 71,2019-08-03,01:00:00,0,0,0,FMN GV 11 Ramsel
66,Bergstraat 71,2019-08-03,02:00:00,2,2,0,FMN GV 11 Ramsel
66,Bergstraat 71,2019-08-03,03:00:00,2,2,0,FMN GV 11 Ramsel
66,Bergstraat 71,2019-08-03,04:00:00,8,4,4,FMN GV 11 Ramsel
66,Bergstraat 71,2019-08-03,05:00:00,2,2,0,FMN GV 11 Ramsel
66,Bergstraat 71,2019-08-03,06:00:00,6,2,4,FMN GV 11 Ramsel
66,Bergstraat 71,2019-08-03,07:00:00,14,6,8,FMN GV 11 Ramsel
66,Bergstraat 71,2019-08-03,08:00:00,52,20,32,FMN GV 11 Ramsel
66,Bergstraat 71,2019-08-03,09:00:00,64,26,38,FMN GV 11 Ramsel
66,Bergstraat 71,2019-08-03,10:00:00,98,34,64,FMN GV 11 Ramsel
66,Bergstraat 71,2019-08-03,11:00:00,126,64,62,FMN GV 11 Ramsel
66,Bergstraat 71,2019-08-03,12:00:00,106,54,52,FMN GV 11 Ramsel
66,Bergstraat 71,2019-08-03,13:00:00,166,88,78,FMN GV 11 Ramsel
66,Bergstraat 71,2019-08-03,14:00:00,216,106,110,FMN GV 11 Ramsel
66,Bergstraat 71,2019-08-03,15:00:00,164,88,76,FMN GV 11 Ramsel
66,Bergstraat 71,2019-08-03,16:00:00,194,108,86,FMN GV 11 Ramsel
66,Bergstraat 71,2019-08-03,17:00:00,78,54,24,FMN GV 11 Ramsel
66,Bergstraat 71,2019-08-03,18:00:00,86,44,42,FMN GV 11 Ramsel
66,Bergstraat 71,2019-08-03,19:00:00,56,32,24,FMN GV 11 Ramsel
66,Bergstraat 71,2019-08-03,20:00:00,78,38,40,FMN GV 11 Ramsel
66,Bergstraat 71,2019-08-03,21:00:00,30,20,10,FMN GV 11 Ramsel
66,Bergstraat 71,2019-08-03,22:00:00,12,10,2,FMN GV 11 Ramsel
66,Bergstraat 71,2019-08-03,23:00:00,10,8,2,FMN GV 11 Ramsel
66,Bergstraat 71,2019-08-04,00:00:00,4,2,2,FMN GV 11 Ramsel
66,Bergstraat 71,2019-08-04,01:00:00,2,2,0,FMN GV 11 Ramsel
66,Bergstraat 71,2019-08-04,02:00:00,8,4,4,FMN GV 11 Ramsel
66,Bergstraat 71,2019-08-04,03:00:00,0,0,0,FMN GV 11 Ramsel
66,Bergstraat 71,2019-08-04,04:00:00,0,0,0,FMN GV 11 Ramsel
66,Bergstraat 71,2019-08-04,05:00:00,2,0,2,FMN GV 11 Ramsel
66,Bergstraat 71,2019-08-04,06:00:00,14,8,6,FMN GV 11 Ramsel
66,Bergstraat 71,2019-08-04,07:00:00,38,8,30,FMN GV 11 Ramsel
66,Bergstraat 71,2019-08-04,08:00:00,82,28,54,FMN GV 11 Ramsel
66,Bergstraat 71,2019-08-04,09:00:00,136,54,82,FMN GV 11 Ramsel
66,Bergstraat 71,2019-08-04,10:00:00,216,96,120,FMN GV 11 Ramsel
66,Bergstraat 71,2019-08-04,11:00:00,260,122,138,FMN GV 11 Ramsel
66,Bergstraat 71,2019-08-04,12:00:00,222,108,114,FMN GV 11 Ramsel
66,Bergstraat 71,2019-08-04,13:00:00,280,142,138,FMN GV 11 Ramsel
66,Bergstraat 71,2019-08-04,14:00:00,460,228,232,FMN GV 11 Ramsel
66,Bergstraat 71,2019-08-04,15:00:00,366,190,176,FMN GV 11 Ramsel
66,Bergstraat 71,2019-08-04,16:00:00,274,142,132,FMN GV 11 Ramsel
66,Bergstraat 71,2019-08-04,17:00:00,234,118,116,FMN GV 11 Ramsel
66,Bergstraat 71,2019-08-04,18:00:00,114,60,54,FMN GV 11 Ramsel
66,Bergstraat 71,2019-08-04,19:00:00,88,38,50,FMN GV 11 Ramsel
66,Bergstraat 71,2019-08-04,20:00:00,42,34,8,FMN GV 11 Ramsel
66,Bergstraat 71,2019-08-04,21:00:00,64,44,20,FMN GV 11 Ramsel
66,Bergstraat 71,2019-08-04,22:00:00,18,10,8,FMN GV 11 Ramsel
66,Bergstraat 71,2019-08-04,23:00:00,4,2,2,FMN GV 11 Ramsel
66,Bergstraat 71,2019-08-05,00:00:00,0,0,0,FMN GV 11 Ramsel
66,Bergstraat 71,2019-08-05,01:00:00,2,2,0,FMN GV 11 Ramsel
66,Bergstraat 71,2019-08-05,02:00:00,2,2,0,FMN GV 11 Ramsel
66,Bergstraat 71,2019-08-05,03:00:00,2,0,2,FMN GV 11 Ramsel
66,Bergstraat 71,2019-08-05,04:00:00,2,2,0,FMN GV 11 Ramsel
66,Bergstraat 71,2019-08-05,05:00:00,10,6,4,FMN GV 11 Ramsel
66,Bergstraat 71,2019-08-05,06:00:00,42,16,26,FMN GV 11 Ramsel
66,Bergstraat 71,2019-08-05,07:00:00,56,12,44,FMN GV 11 Ramsel
66,Bergstraat 71,2019-08-05,08:00:00,58,22,36,FMN GV 11 Ramsel
66,Bergstraat 71,2019-08-05,09:00:00,70,38,32,FMN GV 11 Ramsel
66,Bergstraat 71,2019-08-05,10:00:00,82,40,42,FMN GV 11 Ramsel
66,Bergstraat 71,2019-08-05,11:00:00,108,52,56,FMN GV 11 Ramsel
66,Bergstraat 71,2019-08-05,12:00:00,106,48,58,FMN GV 11 Ramsel
66,Bergstraat 71,2019-08-05,13:00:00,192,100,92,FMN GV 11 Ramsel
66,Bergstraat 71,2019-08-05,14:00:00,216,80,136,FMN GV 11 Ramsel
66,Bergstraat 71,2019-08-05,15:00:00,204,108,96,FMN GV 11 Ramsel
66,Bergstraat 71,2019-08-05,16:00:00,160,88,72,FMN GV 11 Ramsel
66,Bergstraat 71,2019-08-05,17:00:00,154,88,66,FMN GV 11 Ramsel
66,Bergstraat 71,2019-08-05,18:00:00,74,52,22,FMN GV 11 Ramsel
66,Bergstraat 71,2019-08-05,19:00:00,84,38,46,FMN GV 11 Ramsel
66,Bergstraat 71,2019-08-05,20:00:00,40,12,28,FMN GV 11 Ramsel
66,Bergstraat 71,2019-08-05,21:00:00,24,14,10,FMN GV 11 Ramsel
66,Bergstraat 71,2019-08-05,22:00:00,10,4,6,FMN GV 11 Ramsel
66,Bergstraat 71,2019-08-05,23:00:00,2,2,0,FMN GV 11 Ramsel
66,Bergstraat 71,2019-08-06,00:00:00,0,0,0,FMN GV 11 Ramsel
66,Bergstraat 71,2019-08-06,01:00:00,0,0,0,FMN GV 11 Ramsel
66,Bergstraat 71,2019-08-06,02:00:00,0,0,0,FMN GV 11 Ramsel
66,Bergstraat 71,2019-08-06,03:00:00,2,0,2,FMN GV 11 Ramsel
66,Bergstraat 71,2019-08-06,04:00:00,2,2,0,FMN GV 11 Ramsel
66,Bergstraat 71,2019-08-06,05:00:00,12,4,8,FMN GV 11 Ramsel
66,Bergstraat 71,2019-08-06,06:00:00,50,14,36,FMN GV 11 Ramsel
66,Bergstraat 71,2019-08-06,07:00:00,68,14,54,FMN GV 11 Ramsel
66,Bergstraat 71,2019-08-06,08:00:00,62,22,40,FMN GV 11 Ramsel
66,Bergstraat 71,2019-08-06,09:00:00,56,24,32,FMN GV 11 Ramsel
66,Bergstraat 71,2019-08-06,10:00:00,130,44,86,FMN GV 11 Ramsel
66,Bergstraat 71,2019-08-06,11:00:00,134,64,70,FMN GV 11 Ramsel
66,Bergstraat 71,2019-08-06,12:00:00,166,68,98,FMN GV 11 Ramsel
66,Bergstraat 71,2019-08-06,13:00:00,234,92,142,FMN GV 11 Ramsel
66,Bergstraat 71,2019-08-06,14:00:00,268,148,120,FMN GV 11 Ramsel
66,Bergstraat 71,2019-08-06,15:00:00,184,94,90,FMN GV 11 Ramsel
66,Bergstraat 71,2019-08-06,16:00:00,232,162,70,FMN GV 11 Ramsel
66,Bergstraat 71,2019-08-06,17:00:00,128,84,44,FMN GV 11 Ramsel
66,Bergstraat 71,2019-08-06,18:00:00,130,58,72,FMN GV 11 Ramsel
66,Bergstraat 71,2019-08-06,19:00:00,102,56,46,FMN GV 11 Ramsel
66,Bergstraat 71,2019-08-06,20:00:00,58,42,16,FMN GV 11 Ramsel
66,Bergstraat 71,2019-08-06,21:00:00,28,22,6,FMN GV 11 Ramsel
66,Bergstraat 71,2019-08-06,22:00:00,14,14,0,FMN GV 11 Ramsel
66,Bergstraat 71,2019-08-06,23:00:00,12,6,6,FMN GV 11 Ramsel
66,Bergstraat 71,2019-08-07,00:00:00,4,2,2,FMN GV 11 Ramsel
66,Bergstraat 71,2019-08-07,01:00:00,2,2,0,FMN GV 11 Ramsel
66,Bergstraat 71,2019-08-07,02:00:00,0,0,0,FMN GV 11 Ramsel
66,Bergstraat 71,2019-08-07,03:00:00,0,0,0,FMN GV 11 Ramsel
66,Bergstraat 71,2019-08-07,04:00:00,4,4,0,FMN GV 11 Ramsel
66,Bergstraat 71,2019-08-07,05:00:00,18,10,8,FMN GV 11 Ramsel
66,Bergstraat 71,2019-08-07,06:00:00,42,10,32,FMN GV 11 Ramsel
66,Bergstraat 71,2019-08-07,07:00:00,42,10,32,FMN GV 11 Ramsel
66,Bergstraat 71,2019-08-07,08:00:00,52,8,44,FMN GV 11 Ramsel
66,Bergstraat 71,2019-08-07,09:00:00,56,26,30,FMN GV 11 Ramsel
66,Bergstraat 71,2019-08-07,10:00:00,90,52,38,FMN GV 11 Ramsel
66,Bergstraat 71,2019-08-07,11:00:00,96,46,50,FMN GV 11 Ramsel
66,Bergstraat 71,2019-08-07,12:00:00,100,64,36,FMN GV 11 Ramsel
66,Bergstraat 71,2019-08-07,13:00:00,160,92,68,FMN GV 11 Ramsel
66,Bergstraat 71,2019-08-07,14:00:00,152,50,102,FMN GV 11 Ramsel
66,Bergstraat 71,2019-08-07,15:00:00,164,70,94,FMN GV 11 Ramsel
66,Bergstraat 71,2019-08-07,16:00:00,158,96,62,FMN GV 11 Ramsel
66,Bergstraat 71,2019-08-07,17:00:00,106,60,46,FMN GV 11 Ramsel
66,Bergstraat 71,2019-08-07,18:00:00,140,72,68,FMN GV 11 Ramsel
66,Bergstraat 71,2019-08-07,19:00:00,124,36,88,FMN GV 11 Ramsel
66,Bergstraat 71,2019-08-07,20:00:00,58,34,24,FMN GV 11 Ramsel
66,Bergstraat 71,2019-08-07,21:00:00,54,40,14,FMN GV 11 Ramsel
66,Bergstraat 71,2019-08-07,22:00:00,18,18,0,FMN GV 11 Ramsel
66,Bergstraat 71,2019-08-07,23:00:00,4,4,0,FMN GV 11 Ramsel
66,Bergstraat 71,2019-08-08,00:00:00,12,8,4,FMN GV 11 Ramsel
66,Bergstraat 71,2019-08-08,01:00:00,6,4,2,FMN GV 11 Ramsel
66,Bergstraat 71,2019-08-08,02:00:00,8,4,4,FMN GV 11 Ramsel
66,Bergstraat 71,2019-08-08,03:00:00,2,2,0,FMN GV 11 Ramsel
66,Bergstraat 71,2019-08-08,04:00:00,4,4,0,FMN GV 11 Ramsel
66,Bergstraat 71,2019-08-08,05:00:00,20,12,8,FMN GV 11 Ramsel
66,Bergstraat 71,2019-08-08,06:00:00,38,10,28,FMN GV 11 Ramsel
66,Bergstraat 71,2019-08-08,07:00:00,56,10,46,FMN GV 11 Ramsel
66,Bergstraat 71,2019-08-08,08:00:00,88,20,68,FMN GV 11 Ramsel
66,Bergstraat 71,2019-08-08,09:00:00,110,34,76,FMN GV 11 Ramsel
66,Bergstraat 71,2019-08-08,10:00:00,162,60,102,FMN GV 11 Ramsel
66,Bergstraat 71,2019-08-08,11:00:00,112,54,58,FMN GV 11 Ramsel
66,Bergstraat 71,2019-08-08,12:00:00,160,70,90,FMN GV 11 Ramsel
66,Bergstraat 71,2019-08-08,13:00:00,234,94,140,FMN GV 11 Ramsel
66,Bergstraat 71,2019-08-08,14:00:00,270,118,152,FMN GV 11 Ramsel
66,Bergstraat 71,2019-08-08,15:00:00,222,124,98,FMN GV 11 Ramsel
66,Bergstraat 71,2019-08-08,16:00:00,288,172,116,FMN GV 11 Ramsel
66,Bergstraat 71,2019-08-08,17:00:00,222,124,98,FMN GV 11 Ramsel
66,Bergstraat 71,2019-08-08,18:00:00,160,98,62,FMN GV 11 Ramsel
66,Bergstraat 71,2019-08-08,19:00:00,88,54,34,FMN GV 11 Ramsel
66,Bergstraat 71,2019-08-08,20:00:00,124,84,40,FMN GV 11 Ramsel
66,Bergstraat 71,2019-08-08,21:00:00,54,32,22,FMN GV 11 Ramsel
66,Bergstraat 71,2019-08-08,22:00:00,12,6,6,FMN GV 11 Ramsel
66,Bergstraat 71,2019-08-08,23:00:00,8,8,0,FMN GV 11 Ramsel
66,Bergstraat 71,2019-08-09,00:00:00,10,4,6,FMN GV 11 Ramsel
66,Bergstraat 71,2019-08-09,01:00:00,0,0,0,FMN GV 11 Ramsel
66,Bergstraat 71,2019-08-09,02:00:00,0,0,0,FMN GV 11 Ramsel
66,Bergstraat 71,2019-08-09,03:00:00,2,0,2,FMN GV 11 Ramsel
66,Bergstraat 71,2019-08-09,04:00:00,2,2,0,FMN GV 11 Ramsel
66,Bergstraat 71,2019-08-09,05:00:00,14,6,8,FMN GV 11 Ramsel
66,Bergstraat 71,2019-08-09,06:00:00,18,4,14,FMN GV 11 Ramsel
66,Bergstraat 71,2019-08-09,07:00:00,34,2,32,FMN GV 11 Ramsel
66,Bergstraat 71,2019-08-09,08:00:00,34,6,28,FMN GV 11 Ramsel
66,Bergstraat 71,2019-08-09,09:00:00,34,14,20,FMN GV 11 Ramsel
66,Bergstraat 71,2019-08-09,10:00:00,38,22,16,FMN GV 11 Ramsel
66,Bergstraat 71,2019-08-09,11:00:00,28,10,18,FMN GV 11 Ramsel
66,Bergstraat 71,2019-08-09,12:00:00,46,24,22,FMN GV 11 Ramsel
66,Bergstraat 71,2019-08-09,13:00:00,36,12,24,FMN GV 11 Ramsel
66,Bergstraat 71,2019-08-09,14:00:00,64,30,34,FMN GV 11 Ramsel
66,Bergstraat 71,2019-08-09,15:00:00,82,44,38,FMN GV 11 Ramsel
66,Bergstraat 71,2019-08-09,16:00:00,80,58,22,FMN GV 11 Ramsel
66,Bergstraat 71,2019-08-09,17:00:00,80,62,18,FMN GV 11 Ramsel
66,Bergstraat 71,2019-08-09,18:00:00,28,22,6,FMN GV 11 Ramsel
66,Bergstraat 71,2019-08-09,19:00:00,54,28,26,FMN GV 11 Ramsel
66,Bergstraat 71,2019-08-09,20:00:00,32,16,16,FMN GV 11 Ramsel
66,Bergstraat 71,2019-08-09,21:00:00,42,10,32,FMN GV 11 Ramsel
66,Bergstraat 71,2019-08-09,22:00:00,22,14,8,FMN GV 11 Ramsel
66,Bergstraat 71,2019-08-09,23:00:00,20,10,10,FMN GV 11 Ramsel
66,Bergstraat 71,2019-08-10,00:00:00,14,12,2,FMN GV 11 Ramsel
66,Bergstraat 71,2019-08-10,01:00:00,16,12,4,FMN GV 11 Ramsel
66,Bergstraat 71,2019-08-10,02:00:00,2,0,2,FMN GV 11 Ramsel
66,Bergstraat 71,2019-08-10,03:00:00,2,2,0,FMN GV 11 Ramsel
66,Bergstraat 71,2019-08-10,04:00:00,0,0,0,FMN GV 11 Ramsel
66,Bergstraat 71,2019-08-10,05:00:00,4,2,2,FMN GV 11 Ramsel
66,Bergstraat 71,2019-08-10,06:00:00,4,0,4,FMN GV 11 Ramsel
66,Bergstraat 71,2019-08-10,07:00:00,20,10,10,FMN GV 11 Ramsel
66,Bergstraat 71,2019-08-10,08:00:00,34,10,24,FMN GV 11 Ramsel
66,Bergstraat 71,2019-08-10,09:00:00,84,26,58,FMN GV 11 Ramsel
66,Bergstraat 71,2019-08-10,10:00:00,54,18,36,FMN GV 11 Ramsel
66,Bergstraat 71,2019-08-10,11:00:00,80,42,38,FMN GV 11 Ramsel
66,Bergstraat 71,2019-08-10,12:00:00,70,36,34,FMN GV 11 Ramsel
66,Bergstraat 71,2019-08-10,13:00:00,104,30,74,FMN GV 11 Ramsel
66,Bergstraat 71,2019-08-10,14:00:00,74,30,44,FMN GV 11 Ramsel
66,Bergstraat 71,2019-08-10,15:00:00,110,70,40,FMN GV 11 Ramsel
66,Bergstraat 71,2019-08-10,16:00:00,166,48,118,FMN GV 11 Ramsel
66,Bergstraat 71,2019-08-10,17:00:00,72,36,36,FMN GV 11 Ramsel
66,Bergstraat 71,2019-08-10,18:00:00,64,36,28,FMN GV 11 Ramsel
66,Bergstraat 71,2019-08-10,19:00:00,46,16,30,FMN GV 11 Ramsel
66,Bergstraat 71,2019-08-10,20:00:00,56,28,28,FMN GV 11 Ramsel
66,Bergstraat 71,2019-08-10,21:00:00,42,16,26,FMN GV 11 Ramsel
66,Bergstraat 71,2019-08-10,22:00:00,28,10,18,FMN GV 11 Ramsel
66,Bergstraat 71,2019-08-10,23:00:00,22,20,2,FMN GV 11 Ramsel
66,Bergstraat 71,2019-08-11,00:00:00,16,12,4,FMN GV 11 Ramsel
66,Bergstraat 71,2019-08-11,01:00:00,14,12,2,FMN GV 11 Ramsel
66,Bergstraat 71,2019-08-11,02:00:00,0,0,0,FMN GV 11 Ramsel
66,Bergstraat 71,2019-08-11,03:00:00,0,0,0,FMN GV 11 Ramsel
66,Bergstraat 71,2019-08-11,04:00:00,2,2,0,FMN GV 11 Ramsel
66,Bergstraat 71,2019-08-11,05:00:00,6,2,4,FMN GV 11 Ramsel
66,Bergstraat 71,2019-08-11,06:00:00,8,0,8,FMN GV 11 Ramsel
66,Bergstraat 71,2019-08-11,07:00:00,18,12,6,FMN GV 11 Ramsel
66,Bergstraat 71,2019-08-11,08:00:00,90,16,74,FMN GV 11 Ramsel
66,Bergstraat 71,2019-08-11,09:00:00,150,42,108,FMN GV 11 Ramsel
66,Bergstraat 71,2019-08-11,10:00:00,312,180,132,FMN GV 11 Ramsel
66,Bergstraat 71,2019-08-11,11:00:00,244,124,120,FMN GV 11 Ramsel
66,Bergstraat 71,2019-08-11,12:00:00,244,158,86,FMN GV 11 Ramsel
66,Bergstraat 71,2019-08-11,13:00:00,236,118,118,FMN GV 11 Ramsel
66,Bergstraat 71,2019-08-11,14:00:00,210,122,88,FMN GV 11 Ramsel
66,Bergstraat 71,2019-08-11,15:00:00,260,128,132,FMN GV 11 Ramsel
66,Bergstraat 71,2019-08-11,16:00:00,222,112,110,FMN GV 11 Ramsel
66,Bergstraat 71,2019-08-11,17:00:00,168,78,90,FMN GV 11 Ramsel
66,Bergstraat 71,2019-08-11,18:00:00,82,60,22,FMN GV 11 Ramsel
66,Bergstraat 71,2019-08-11,19:00:00,82,32,50,FMN GV 11 Ramsel
66,Bergstraat 71,2019-08-11,20:00:00,74,32,42,FMN GV 11 Ramsel
66,Bergstraat 71,2019-08-11,21:00:00,16,12,4,FMN GV 11 Ramsel
66,Bergstraat 71,2019-08-11,22:00:00,4,2,2,FMN GV 11 Ramsel
66,Bergstraat 71,2019-08-11,23:00:00,4,2,2,FMN GV 11 Ramsel
66,Bergstraat 71,2019-08-12,00:00:00,2,2,0,FMN GV 11 Ramsel
66,Bergstraat 71,2019-08-12,01:00:00,2,2,0,FMN GV 11 Ramsel
66,Bergstraat 71,2019-08-12,02:00:00,0,0,0,FMN GV 11 Ramsel
66,Bergstraat 71,2019-08-12,03:00:00,4,2,2,FMN GV 11 Ramsel
66,Bergstraat 71,2019-08-12,04:00:00,4,2,2,FMN GV 11 Ramsel
66,Bergstraat 71,2019-08-12,05:00:00,12,8,4,FMN GV 11 Ramsel
66,Bergstraat 71,2019-08-12,06:00:00,30,10,20,FMN GV 11 Ramsel
66,Bergstraat 71,2019-08-12,07:00:00,46,10,36,FMN GV 11 Ramsel
66,Bergstraat 71,2019-08-12,08:00:00,52,20,32,FMN GV 11 Ramsel
66,Bergstraat 71,2019-08-12,09:00:00,62,22,40,FMN GV 11 Ramsel
66,Bergstraat 71,2019-08-12,10:00:00,88,48,40,FMN GV 11 Ramsel
66,Bergstraat 71,2019-08-12,11:00:00,82,32,50,FMN GV 11 Ramsel
66,Bergstraat 71,2019-08-12,12:00:00,112,64,48,FMN GV 11 Ramsel
66,Bergstraat 71,2019-08-12,13:00:00,112,52,60,FMN GV 11 Ramsel
66,Bergstraat 71,2019-08-12,14:00:00,124,68,56,FMN GV 11 Ramsel
66,Bergstraat 71,2019-08-12,15:00:00,70,48,22,FMN GV 11 Ramsel
66,Bergstraat 71,2019-08-12,16:00:00,56,40,16,FMN GV 11 Ramsel
66,Bergstraat 71,2019-08-12,17:00:00,54,42,12,FMN GV 11 Ramsel
66,Bergstraat 71,2019-08-12,18:00:00,28,16,12,FMN GV 11 Ramsel
66,Bergstraat 71,2019-08-12,19:00:00,62,22,40,FMN GV 11 Ramsel
66,Bergstraat 71,2019-08-12,20:00:00,44,26,18,FMN GV 11 Ramsel
66,Bergstraat 71,2019-08-12,21:00:00,24,14,10,FMN GV 11 Ramsel
66,Bergstraat 71,2019-08-12,22:00:00,8,6,2,FMN GV 11 Ramsel
66,Bergstraat 71,2019-08-12,23:00:00,8,6,2,FMN GV 11 Ramsel
66,Bergstraat 71,2019-08-13,00:00:00,0,0,0,FMN GV 11 Ramsel
66,Bergstraat 71,2019-08-13,01:00:00,2,0,2,FMN GV 11 Ramsel
66,Bergstraat 71,2019-08-13,02:00:00,0,0,0,FMN GV 11 Ramsel
66,Bergstraat 71,2019-08-13,03:00:00,0,0,0,FMN GV 11 Ramsel
66,Bergstraat 71,2019-08-13,04:00:00,4,2,2,FMN GV 11 Ramsel
66,Bergstraat 71,2019-08-13,05:00:00,6,2,4,FMN GV 11 Ramsel
66,Bergstraat 71,2019-08-13,06:00:00,36,14,22,FMN GV 11 Ramsel
66,Bergstraat 71,2019-08-13,07:00:00,36,8,28,FMN GV 11 Ramsel
66,Bergstraat 71,2019-08-13,08:00:00,48,12,36,FMN GV 11 Ramsel
66,Bergstraat 71,2019-08-13,09:00:00,102,38,64,FMN GV 11 Ramsel
66,Bergstraat 71,2019-08-13,10:00:00,118,54,64,FMN GV 11 Ramsel
66,Bergstraat 71,2019-08-13,11:00:00,94,52,42,FMN GV 11 Ramsel
66,Bergstraat 71,2019-08-13,12:00:00,146,66,80,FMN GV 11 Ramsel
66,Bergstraat 71,2019-08-13,13:00:00,106,34,72,FMN GV 11 Ramsel
66,Bergstraat 71,2019-08-13,14:00:00,94,66,28,FMN GV 11 Ramsel
66,Bergstraat 71,2019-08-13,15:00:00,72,60,12,FMN GV 11 Ramsel
66,Bergstraat 71,2019-08-13,16:00:00,68,50,18,FMN GV 11 Ramsel
66,Bergstraat 71,2019-08-13,17:00:00,112,58,54,FMN GV 11 Ramsel
66,Bergstraat 71,2019-08-13,18:00:00,44,22,22,FMN GV 11 Ramsel
66,Bergstraat 71,2019-08-13,19:00:00,40,10,30,FMN GV 11 Ramsel
66,Bergstraat 71,2019-08-13,20:00:00,30,22,8,FMN GV 11 Ramsel
66,Bergstraat 71,2019-08-13,21:00:00,14,10,4,FMN GV 11 Ramsel
66,Bergstraat 71,2019-08-13,22:00:00,4,2,2,FMN GV 11 Ramsel
66,Bergstraat 71,2019-08-13,23:00:00,12,6,6,FMN GV 11 Ramsel
66,Bergstraat 71,2019-08-14,00:00:00,0,0,0,FMN GV 11 Ramsel
66,Bergstraat 71,2019-08-14,01:00:00,2,2,0,FMN GV 11 Ramsel
66,Bergstraat 71,2019-08-14,02:00:00,2,2,0,FMN GV 11 Ramsel
66,Bergstraat 71,2019-08-14,03:00:00,0,0,0,FMN GV 11 Ramsel
66,Bergstraat 71,2019-08-14,04:00:00,4,2,2,FMN GV 11 Ramsel
66,Bergstraat 71,2019-08-14,05:00:00,8,4,4,FMN GV 11 Ramsel
66,Bergstraat 71,2019-08-14,06:00:00,32,10,22,FMN GV 11 Ramsel
66,Bergstraat 71,2019-08-14,07:00:00,42,8,34,FMN GV 11 Ramsel
66,Bergstraat 71,2019-08-14,08:00:00,68,20,48,FMN GV 11 Ramsel
66,Bergstraat 71,2019-08-14,09:00:00,80,42,38,FMN GV 11 Ramsel
66,Bergstraat 71,2019-08-14,10:00:00,116,34,82,FMN GV 11 Ramsel
66,Bergstraat 71,2019-08-14,11:00:00,100,52,48,FMN GV 11 Ramsel
66,Bergstraat 71,2019-08-14,12:00:00,116,66,50,FMN GV 11 Ramsel
66,Bergstraat 71,2019-08-14,13:00:00,136,62,74,FMN GV 11 Ramsel
66,Bergstraat 71,2019-08-14,14:00:00,126,56,70,FMN GV 11 Ramsel
66,Bergstraat 71,2019-08-14,15:00:00,148,98,50,FMN GV 11 Ramsel
66,Bergstraat 71,2019-08-14,16:00:00,106,58,48,FMN GV 11 Ramsel
66,Bergstraat 71,2019-08-14,17:00:00,60,42,18,FMN GV 11 Ramsel
66,Bergstraat 71,2019-08-14,18:00:00,66,30,36,FMN GV 11 Ramsel
66,Bergstraat 71,2019-08-14,19:00:00,32,16,16,FMN GV 11 Ramsel
66,Bergstraat 71,2019-08-14,20:00:00,32,14,18,FMN GV 11 Ramsel
66,Bergstraat 71,2019-08-14,21:00:00,22,14,8,FMN GV 11 Ramsel
66,Bergstraat 71,2019-08-14,22:00:00,10,8,2,FMN GV 11 Ramsel
66,Bergstraat 71,2019-08-14,23:00:00,4,2,2,FMN GV 11 Ramsel
66,Bergstraat 71,2019-08-15,00:00:00,2,2,0,FMN GV 11 Ramsel
66,Bergstraat 71,2019-08-15,01:00:00,8,0,8,FMN GV 11 Ramsel
66,Bergstraat 71,2019-08-15,02:00:00,2,2,0,FMN GV 11 Ramsel
66,Bergstraat 71,2019-08-15,03:00:00,2,0,2,FMN GV 11 Ramsel
66,Bergstraat 71,2019-08-15,04:00:00,0,0,0,FMN GV 11 Ramsel
66,Bergstraat 71,2019-08-15,05:00:00,4,4,0,FMN GV 11 Ramsel
66,Bergstraat 71,2019-08-15,06:00:00,4,0,4,FMN GV 11 Ramsel
66,Bergstraat 71,2019-08-15,07:00:00,6,2,4,FMN GV 11 Ramsel
66,Bergstraat 71,2019-08-15,08:00:00,16,6,10,FMN GV 11 Ramsel
66,Bergstraat 71,2019-08-15,09:00:00,72,30,42,FMN GV 11 Ramsel
66,Bergstraat 71,2019-08-15,10:00:00,102,46,56,FMN GV 11 Ramsel
66,Bergstraat 71,2019-08-15,11:00:00,38,22,16,FMN GV 11 Ramsel
66,Bergstraat 71,2019-08-15,12:00:00,70,34,36,FMN GV 11 Ramsel
66,Bergstraat 71,2019-08-15,13:00:00,68,32,36,FMN GV 11 Ramsel
66,Bergstraat 71,2019-08-15,14:00:00,162,88,74,FMN GV 11 Ramsel
66,Bergstraat 71,2019-08-15,15:00:00,124,78,46,FMN GV 11 Ramsel
66,Bergstraat 71,2019-08-15,16:00:00,84,54,30,FMN GV 11 Ramsel
66,Bergstraat 71,2019-08-15,17:00:00,38,16,22,FMN GV 11 Ramsel
66,Bergstraat 71,2019-08-15,18:00:00,54,28,26,FMN GV 11 Ramsel
66,Bergstraat 71,2019-08-15,19:00:00,66,22,44,FMN GV 11 Ramsel
66,Bergstraat 71,2019-08-15,20:00:00,50,18,32,FMN GV 11 Ramsel
66,Bergstraat 71,2019-08-15,21:00:00,32,14,18,FMN GV 11 Ramsel
66,Bergstraat 71,2019-08-15,22:00:00,32,24,8,FMN GV 11 Ramsel
66,Bergstraat 71,2019-08-15,23:00:00,36,28,8,FMN GV 11 Ramsel
66,Bergstraat 71,2019-08-16,00:00:00,24,20,4,FMN GV 11 Ramsel
66,Bergstraat 71,2019-08-16,01:00:00,8,6,2,FMN GV 11 Ramsel
66,Bergstraat 71,2019-08-16,02:00:00,12,12,0,FMN GV 11 Ramsel
66,Bergstraat 71,2019-08-16,03:00:00,0,0,0,FMN GV 11 Ramsel
66,Bergstraat 71,2019-08-16,04:00:00,2,2,0,FMN GV 11 Ramsel
66,Bergstraat 71,2019-08-16,05:00:00,8,6,2,FMN GV 11 Ramsel
66,Bergstraat 71,2019-08-16,06:00:00,22,10,12,FMN GV 11 Ramsel
66,Bergstraat 71,2019-08-16,07:00:00,38,16,22,FMN GV 11 Ramsel
66,Bergstraat 71,2019-08-16,08:00:00,54,22,32,FMN GV 11 Ramsel
66,Bergstraat 71,2019-08-16,09:00:00,72,34,38,FMN GV 11 Ramsel
66,Bergstraat 71,2019-08-16,10:00:00,126,48,78,FMN GV 11 Ramsel
66,Bergstraat 71,2019-08-16,11:00:00,192,56,136,FMN GV 11 Ramsel
66,Bergstraat 71,2019-08-16,12:00:00,146,64,82,FMN GV 11 Ramsel
66,Bergstraat 71,2019-08-16,13:00:00,236,86,150,FMN GV 11 Ramsel
66,Bergstraat 71,2019-08-16,14:00:00,244,146,98,FMN GV 11 Ramsel
66,Bergstraat 71,2019-08-16,15:00:00,298,150,148,FMN GV 11 Ramsel
66,Bergstraat 71,2019-08-16,16:00:00,150,86,64,FMN GV 11 Ramsel
66,Bergstraat 71,2019-08-16,17:00:00,196,108,88,FMN GV 11 Ramsel
66,Bergstraat 71,2019-08-16,18:00:00,106,46,60,FMN GV 11 Ramsel
66,Bergstraat 71,2019-08-16,19:00:00,82,30,52,FMN GV 11 Ramsel
66,Bergstraat 71,2019-08-16,20:00:00,76,42,34,FMN GV 11 Ramsel
66,Bergstraat 71,2019-08-16,21:00:00,22,12,10,FMN GV 11 Ramsel
66,Bergstraat 71,2019-08-16,22:00:00,18,16,2,FMN GV 11 Ramsel
66,Bergstraat 71,2019-08-16,23:00:00,24,18,6,FMN GV 11 Ramsel
66,Bergstraat 71,2019-08-17,00:00:00,12,8,4,FMN GV 11 Ramsel
66,Bergstraat 71,2019-08-17,01:00:00,4,0,4,FMN GV 11 Ramsel
66,Bergstraat 71,2019-08-17,02:00:00,2,2,0,FMN GV 11 Ramsel
66,Bergstraat 71,2019-08-17,03:00:00,0,0,0,FMN GV 11 Ramsel
66,Bergstraat 71,2019-08-17,04:00:00,0,0,0,FMN GV 11 Ramsel
66,Bergstraat 71,2019-08-17,05:00:00,2,2,0,FMN GV 11 Ramsel
66,Bergstraat 71,2019-08-17,06:00:00,4,2,2,FMN GV 11 Ramsel
66,Bergstraat 71,2019-08-17,07:00:00,16,2,14,FMN GV 11 Ramsel
66,Bergstraat 71,2019-08-17,08:00:00,24,10,14,FMN GV 11 Ramsel
66,Bergstraat 71,2019-08-17,09:00:00,56,20,36,FMN GV 11 Ramsel
66,Bergstraat 71,2019-08-17,10:00:00,34,22,12,FMN GV 11 Ramsel
66,Bergstraat 71,2019-08-17,11:00:00,56,26,30,FMN GV 11 Ramsel
66,Bergstraat 71,2019-08-17,12:00:00,46,18,28,FMN GV 11 Ramsel
66,Bergstraat 71,2019-08-17,13:00:00,32,18,14,FMN GV 11 Ramsel
66,Bergstraat 71,2019-08-17,14:00:00,76,34,42,FMN GV 11 Ramsel
66,Bergstraat 71,2019-08-17,15:00:00,52,30,22,FMN GV 11 Ramsel
66,Bergstraat 71,2019-08-17,16:00:00,32,22,10,FMN GV 11 Ramsel
66,Bergstraat 71,2019-08-17,17:00:00,50,40,10,FMN GV 11 Ramsel
66,Bergstraat 71,2019-08-17,18:00:00,24,12,12,FMN GV 11 Ramsel
66,Bergstraat 71,2019-08-17,19:00:00,8,4,4,FMN GV 11 Ramsel
66,Bergstraat 71,2019-08-17,20:00:00,6,0,6,FMN GV 11 Ramsel
66,Bergstraat 71,2019-08-17,21:00:00,4,2,2,FMN GV 11 Ramsel
66,Bergstraat 71,2019-08-17,22:00:00,10,4,6,FMN GV 11 Ramsel
66,Bergstraat 71,2019-08-17,23:00:00,2,0,2,FMN GV 11 Ramsel
66,Bergstraat 71,2019-08-18,00:00:00,6,0,6,FMN GV 11 Ramsel
66,Bergstraat 71,2019-08-18,01:00:00,2,0,2,FMN GV 11 Ramsel
66,Bergstraat 71,2019-08-18,02:00:00,2,2,0,FMN GV 11 Ramsel
66,Bergstraat 71,2019-08-18,03:00:00,2,2,0,FMN GV 11 Ramsel
66,Bergstraat 71,2019-08-18,04:00:00,0,0,0,FMN GV 11 Ramsel
66,Bergstraat 71,2019-08-18,05:00:00,0,0,0,FMN GV 11 Ramsel
66,Bergstraat 71,2019-08-18,06:00:00,0,0,0,FMN GV 11 Ramsel
66,Bergstraat 71,2019-08-18,07:00:00,4,0,4,FMN GV 11 Ramsel
66,Bergstraat 71,2019-08-18,08:00:00,6,0,6,FMN GV 11 Ramsel
66,Bergstraat 71,2019-08-18,09:00:00,28,4,24,FMN GV 11 Ramsel
66,Bergstraat 71,2019-08-18,10:00:00,14,10,4,FMN GV 11 Ramsel
66,Bergstraat 71,2019-08-18,11:00:00,28,22,6,FMN GV 11 Ramsel
66,Bergstraat 71,2019-08-18,12:00:00,32,8,24,FMN GV 11 Ramsel
66,Bergstraat 71,2019-08-18,13:00:00,116,40,76,FMN GV 11 Ramsel
66,Bergstraat 71,2019-08-18,14:00:00,70,22,48,FMN GV 11 Ramsel
66,Bergstraat 71,2019-08-18,15:00:00,48,20,28,FMN GV 11 Ramsel
66,Bergstraat 71,2019-08-18,16:00:00,88,52,36,FMN GV 11 Ramsel
66,Bergstraat 71,2019-08-18,17:00:00,72,40,32,FMN GV 11 Ramsel
66,Bergstraat 71,2019-08-18,18:00:00,64,34,30,FMN GV 11 Ramsel
66,Bergstraat 71,2019-08-18,19:00:00,70,28,42,FMN GV 11 Ramsel
66,Bergstraat 71,2019-08-18,20:00:00,52,20,32,FMN GV 11 Ramsel
66,Bergstraat 71,2019-08-18,21:00:00,40,20,20,FMN GV 11 Ramsel
66,Bergstraat 71,2019-08-18,22:00:00,18,14,4,FMN GV 11 Ramsel
66,Bergstraat 71,2019-08-18,23:00:00,10,10,0,FMN GV 11 Ramsel
66,Bergstraat 71,2019-08-19,00:00:00,4,4,0,FMN GV 11 Ramsel
66,Bergstraat 71,2019-08-19,01:00:00,0,0,0,FMN GV 11 Ramsel
66,Bergstraat 71,2019-08-19,02:00:00,0,0,0,FMN GV 11 Ramsel
66,Bergstraat 71,2019-08-19,03:00:00,2,0,2,FMN GV 11 Ramsel
66,Bergstraat 71,2019-08-19,04:00:00,4,4,0,FMN GV 11 Ramsel
66,Bergstraat 71,2019-08-19,05:00:00,22,10,12,FMN GV 11 Ramsel
66,Bergstraat 71,2019-08-19,06:00:00,42,22,20,FMN GV 11 Ramsel
66,Bergstraat 71,2019-08-19,07:00:00,62,18,44,FMN GV 11 Ramsel
66,Bergstraat 71,2019-08-19,08:00:00,48,12,36,FMN GV 11 Ramsel
66,Bergstraat 71,2019-08-19,09:00:00,46,22,24,FMN GV 11 Ramsel
66,Bergstraat 71,2019-08-19,10:00:00,128,52,76,FMN GV 11 Ramsel
66,Bergstraat 71,2019-08-19,11:00:00,130,64,66,FMN GV 11 Ramsel
66,Bergstraat 71,2019-08-19,12:00:00,100,44,56,FMN GV 11 Ramsel
66,Bergstraat 71,2019-08-19,13:00:00,154,86,68,FMN GV 11 Ramsel
66,Bergstraat 71,2019-08-19,14:00:00,170,62,108,FMN GV 11 Ramsel
66,Bergstraat 71,2019-08-19,15:00:00,180,78,102,FMN GV 11 Ramsel
66,Bergstraat 71,2019-08-19,16:00:00,186,86,100,FMN GV 11 Ramsel
66,Bergstraat 71,2019-08-19,17:00:00,116,68,48,FMN GV 11 Ramsel
66,Bergstraat 71,2019-08-19,18:00:00,96,42,54,FMN GV 11 Ramsel
66,Bergstraat 71,2019-08-19,19:00:00,72,32,40,FMN GV 11 Ramsel
66,Bergstraat 71,2019-08-19,20:00:00,50,24,26,FMN GV 11 Ramsel
66,Bergstraat 71,2019-08-19,21:00:00,22,12,10,FMN GV 11 Ramsel
66,Bergstraat 71,2019-08-19,22:00:00,16,14,2,FMN GV 11 Ramsel
66,Bergstraat 71,2019-08-19,23:00:00,0,0,0,FMN GV 11 Ramsel
66,Bergstraat 71,2019-08-20,00:00:00,6,4,2,FMN GV 11 Ramsel
66,Bergstraat 71,2019-08-20,01:00:00,2,2,0,FMN GV 11 Ramsel
66,Bergstraat 71,2019-08-20,02:00:00,4,4,0,FMN GV 11 Ramsel
66,Bergstraat 71,2019-08-20,03:00:00,0,0,0,FMN GV 11 Ramsel
66,Bergstraat 71,2019-08-20,04:00:00,2,2,0,FMN GV 11 Ramsel
66,Bergstraat 71,2019-08-20,05:00:00,20,10,10,FMN GV 11 Ramsel
66,Bergstraat 71,2019-08-20,06:00:00,48,16,32,FMN GV 11 Ramsel
66,Bergstraat 71,2019-08-20,07:00:00,70,22,48,FMN GV 11 Ramsel
66,Bergstraat 71,2019-08-20,08:00:00,44,10,34,FMN GV 11 Ramsel
66,Bergstraat 71,2019-08-20,09:00:00,76,30,46,FMN GV 11 Ramsel
66,Bergstraat 71,2019-08-20,10:00:00,112,60,52,FMN GV 11 Ramsel
66,Bergstraat 71,2019-08-20,11:00:00,110,38,72,FMN GV 11 Ramsel
66,Bergstraat 71,2019-08-20,12:00:00,110,60,50,FMN GV 11 Ramsel
66,Bergstraat 71,2019-08-20,13:00:00,248,112,136,FMN GV 11 Ramsel
66,Bergstraat 71,2019-08-20,14:00:00,210,146,64,FMN GV 11 Ramsel
66,Bergstraat 71,2019-08-20,15:00:00,208,134,74,FMN GV 11 Ramsel
66,Bergstraat 71,2019-08-20,16:00:00,298,108,190,FMN GV 11 Ramsel
66,Bergstraat 71,2019-08-20,17:00:00,148,80,68,FMN GV 11 Ramsel
66,Bergstraat 71,2019-08-20,18:00:00,184,80,104,FMN GV 11 Ramsel
66,Bergstraat 71,2019-08-20,19:00:00,80,42,38,FMN GV 11 Ramsel
66,Bergstraat 71,2019-08-20,20:00:00,116,56,60,FMN GV 11 Ramsel
66,Bergstraat 71,2019-08-20,21:00:00,50,46,4,FMN GV 11 Ramsel
66,Bergstraat 71,2019-08-20,22:00:00,16,8,8,FMN GV 11 Ramsel
66,Bergstraat 71,2019-08-20,23:00:00,8,8,0,FMN GV 11 Ramsel
66,Bergstraat 71,2019-08-21,00:00:00,2,2,0,FMN GV 11 Ramsel
66,Bergstraat 71,2019-08-21,01:00:00,0,0,0,FMN GV 11 Ramsel
66,Bergstraat 71,2019-08-21,02:00:00,4,4,0,FMN GV 11 Ramsel
66,Bergstraat 71,2019-08-21,03:00:00,2,0,2,FMN GV 11 Ramsel
66,Bergstraat 71,2019-08-21,04:00:00,2,2,0,FMN GV 11 Ramsel
66,Bergstraat 71,2019-08-21,05:00:00,16,6,10,FMN GV 11 Ramsel
66,Bergstraat 71,2019-08-21,06:00:00,50,18,32,FMN GV 11 Ramsel
66,Bergstraat 71,2019-08-21,07:00:00,72,24,48,FMN GV 11 Ramsel
66,Bergstraat 71,2019-08-21,08:00:00,80,34,46,FMN GV 11 Ramsel
66,Bergstraat 71,2019-08-21,09:00:00,58,28,30,FMN GV 11 Ramsel
66,Bergstraat 71,2019-08-21,10:00:00,112,28,84,FMN GV 11 Ramsel
66,Bergstraat 71,2019-08-21,11:00:00,102,36,66,FMN GV 11 Ramsel
66,Bergstraat 71,2019-08-21,12:00:00,118,52,66,FMN GV 11 Ramsel
66,Bergstraat 71,2019-08-21,13:00:00,192,102,90,FMN GV 11 Ramsel
66,Bergstraat 71,2019-08-21,14:00:00,268,120,148,FMN GV 11 Ramsel
66,Bergstraat 71,2019-08-21,15:00:00,286,136,150,FMN GV 11 Ramsel
66,Bergstraat 71,2019-08-21,16:00:00,240,148,92,FMN GV 11 Ramsel
66,Bergstraat 71,2019-08-21,17:00:00,196,124,72,FMN GV 11 Ramsel
66,Bergstraat 71,2019-08-21,18:00:00,186,104,82,FMN GV 11 Ramsel
66,Bergstraat 71,2019-08-21,19:00:00,150,60,90,FMN GV 11 Ramsel
66,Bergstraat 71,2019-08-21,20:00:00,66,34,32,FMN GV 11 Ramsel
66,Bergstraat 71,2019-08-21,21:00:00,34,22,12,FMN GV 11 Ramsel
66,Bergstraat 71,2019-08-21,22:00:00,18,18,0,FMN GV 11 Ramsel
66,Bergstraat 71,2019-08-21,23:00:00,16,12,4,FMN GV 11 Ramsel
66,Bergstraat 71,2019-08-22,00:00:00,0,0,0,FMN GV 11 Ramsel
66,Bergstraat 71,2019-08-22,01:00:00,0,0,0,FMN GV 11 Ramsel
66,Bergstraat 71,2019-08-22,02:00:00,2,0,2,FMN GV 11 Ramsel
66,Bergstraat 71,2019-08-22,03:00:00,0,0,0,FMN GV 11 Ramsel
66,Bergstraat 71,2019-08-22,04:00:00,2,2,0,FMN GV 11 Ramsel
66,Bergstraat 71,2019-08-22,05:00:00,14,2,12,FMN GV 11 Ramsel
66,Bergstraat 71,2019-08-22,06:00:00,40,10,30,FMN GV 11 Ramsel
66,Bergstraat 71,2019-08-22,07:00:00,70,30,40,FMN GV 11 Ramsel
66,Bergstraat 71,2019-08-22,08:00:00,74,20,54,FMN GV 11 Ramsel
66,Bergstraat 71,2019-08-22,09:00:00,94,18,76,FMN GV 11 Ramsel
66,Bergstraat 71,2019-08-22,10:00:00,144,48,96,FMN GV 11 Ramsel
66,Bergstraat 71,2019-08-22,11:00:00,154,62,92,FMN GV 11 Ramsel
66,Bergstraat 71,2019-08-22,12:00:00,140,66,74,FMN GV 11 Ramsel
66,Bergstraat 71,2019-08-22,13:00:00,250,96,154,FMN GV 11 Ramsel
66,Bergstraat 71,2019-08-22,14:00:00,352,190,162,FMN GV 11 Ramsel
66,Bergstraat 71,2019-08-22,15:00:00,274,156,118,FMN GV 11 Ramsel
66,Bergstraat 71,2019-08-22,16:00:00,262,138,124,FMN GV 11 Ramsel
66,Bergstraat 71,2019-08-22,17:00:00,290,174,116,FMN GV 11 Ramsel
66,Bergstraat 71,2019-08-22,18:00:00,124,70,54,FMN GV 11 Ramsel
66,Bergstraat 71,2019-08-22,19:00:00,134,80,54,FMN GV 11 Ramsel
66,Bergstraat 71,2019-08-22,20:00:00,100,58,42,FMN GV 11 Ramsel
66,Bergstraat 71,2019-08-22,21:00:00,86,12,74,FMN GV 11 Ramsel
66,Bergstraat 71,2019-08-22,22:00:00,68,62,6,FMN GV 11 Ramsel
66,Bergstraat 71,2019-08-22,23:00:00,66,56,10,FMN GV 11 Ramsel
66,Bergstraat 71,2019-08-23,00:00:00,18,16,2,FMN GV 11 Ramsel
66,Bergstraat 71,2019-08-23,01:00:00,18,18,0,FMN GV 11 Ramsel
66,Bergstraat 71,2019-08-23,02:00:00,6,6,0,FMN GV 11 Ramsel
66,Bergstraat 71,2019-08-23,03:00:00,2,2,0,FMN GV 11 Ramsel
66,Bergstraat 71,2019-08-23,04:00:00,6,4,2,FMN GV 11 Ramsel
66,Bergstraat 71,2019-08-23,05:00:00,8,4,4,FMN GV 11 Ramsel
66,Bergstraat 71,2019-08-23,06:00:00,36,12,24,FMN GV 11 Ramsel
66,Bergstraat 71,2019-08-23,07:00:00,64,20,44,FMN GV 11 Ramsel
66,Bergstraat 71,2019-08-23,08:00:00,64,26,38,FMN GV 11 Ramsel
66,Bergstraat 71,2019-08-23,09:00:00,60,30,30,FMN GV 11 Ramsel
66,Bergstraat 71,2019-08-23,10:00:00,98,48,50,FMN GV 11 Ramsel
66,Bergstraat 71,2019-08-23,11:00:00,102,46,56,FMN GV 11 Ramsel
66,Bergstraat 71,2019-08-23,12:00:00,118,66,52,FMN GV 11 Ramsel
66,Bergstraat 71,2019-08-23,13:00:00,186,88,98,FMN GV 11 Ramsel
66,Bergstraat 71,2019-08-23,14:00:00,224,114,110,FMN GV 11 Ramsel
66,Bergstraat 71,2019-08-23,15:00:00,250,148,102,FMN GV 11 Ramsel
66,Bergstraat 71,2019-08-23,16:00:00,208,106,102,FMN GV 11 Ramsel
66,Bergstraat 71,2019-08-23,17:00:00,176,122,54,FMN GV 11 Ramsel
66,Bergstraat 71,2019-08-23,18:00:00,128,96,32,FMN GV 11 Ramsel
66,Bergstraat 71,2019-08-23,19:00:00,102,46,56,FMN GV 11 Ramsel
66,Bergstraat 71,2019-08-23,20:00:00,56,18,38,FMN GV 11 Ramsel
66,Bergstraat 71,2019-08-23,21:00:00,52,26,26,FMN GV 11 Ramsel
66,Bergstraat 71,2019-08-23,22:00:00,20,18,2,FMN GV 11 Ramsel
66,Bergstraat 71,2019-08-23,23:00:00,4,2,2,FMN GV 11 Ramsel
66,Bergstraat 71,2019-08-24,00:00:00,6,4,2,FMN GV 11 Ramsel
66,Bergstraat 71,2019-08-24,01:00:00,6,6,0,FMN GV 11 Ramsel
66,Bergstraat 71,2019-08-24,02:00:00,2,2,0,FMN GV 11 Ramsel
66,Bergstraat 71,2019-08-24,03:00:00,0,0,0,FMN GV 11 Ramsel
66,Bergstraat 71,2019-08-24,04:00:00,0,0,0,FMN GV 11 Ramsel
66,Bergstraat 71,2019-08-24,05:00:00,8,8,0,FMN GV 11 Ramsel
66,Bergstraat 71,2019-08-24,06:00:00,12,2,10,FMN GV 11 Ramsel
66,Bergstraat 71,2019-08-24,07:00:00,14,4,10,FMN GV 11 Ramsel
66,Bergstraat 71,2019-08-24,08:00:00,52,22,30,FMN GV 11 Ramsel
66,Bergstraat 71,2019-08-24,09:00:00,94,40,54,FMN GV 11 Ramsel
66,Bergstraat 71,2019-08-24,10:00:00,172,76,96,FMN GV 11 Ramsel
66,Bergstraat 71,2019-08-24,11:00:00,184,80,104,FMN GV 11 Ramsel
66,Bergstraat 71,2019-08-24,12:00:00,164,74,90,FMN GV 11 Ramsel
66,Bergstraat 71,2019-08-24,13:00:00,230,110,120,FMN GV 11 Ramsel
66,Bergstraat 71,2019-08-24,14:00:00,264,134,130,FMN GV 11 Ramsel
66,Bergstraat 71,2019-08-24,15:00:00,222,126,96,FMN GV 11 Ramsel
66,Bergstraat 71,2019-08-24,16:00:00,182,100,82,FMN GV 11 Ramsel
66,Bergstraat 71,2019-08-24,17:00:00,160,72,88,FMN GV 11 Ramsel
66,Bergstraat 71,2019-08-24,18:00:00,96,52,44,FMN GV 11 Ramsel
66,Bergstraat 71,2019-08-24,19:00:00,100,48,52,FMN GV 11 Ramsel
66,Bergstraat 71,2019-08-24,20:00:00,74,40,34,FMN GV 11 Ramsel
66,Bergstraat 71,2019-08-24,21:00:00,28,12,16,FMN GV 11 Ramsel
66,Bergstraat 71,2019-08-24,22:00:00,12,6,6,FMN GV 11 Ramsel
66,Bergstraat 71,2019-08-24,23:00:00,26,14,12,FMN GV 11 Ramsel
66,Bergstraat 71,2019-08-25,00:00:00,0,0,0,FMN GV 11 Ramsel
66,Bergstraat 71,2019-08-25,01:00:00,4,0,4,FMN GV 11 Ramsel
66,Bergstraat 71,2019-08-25,02:00:00,8,6,2,FMN GV 11 Ramsel
66,Bergstraat 71,2019-08-25,03:00:00,4,2,2,FMN GV 11 Ramsel
66,Bergstraat 71,2019-08-25,04:00:00,0,0,0,FMN GV 11 Ramsel
66,Bergstraat 71,2019-08-25,05:00:00,0,0,0,FMN GV 11 Ramsel
66,Bergstraat 71,2019-08-25,06:00:00,8,0,8,FMN GV 11 Ramsel
66,Bergstraat 71,2019-08-25,07:00:00,56,16,40,FMN GV 11 Ramsel
66,Bergstraat 71,2019-08-25,08:00:00,102,20,82,FMN GV 11 Ramsel
66,Bergstraat 71,2019-08-25,09:00:00,202,56,146,FMN GV 11 Ramsel
66,Bergstraat 71,2019-08-25,10:00:00,256,138,118,FMN GV 11 Ramsel
66,Bergstraat 71,2019-08-25,11:00:00,270,168,102,FMN GV 11 Ramsel
66,Bergstraat 71,2019-08-25,12:00:00,182,102,80,FMN GV 11 Ramsel
66,Bergstraat 71,2019-08-25,13:00:00,192,110,82,FMN GV 11 Ramsel
66,Bergstraat 71,2019-08-25,14:00:00,214,112,102,FMN GV 11 Ramsel
66,Bergstraat 71,2019-08-25,15:00:00,262,148,114,FMN GV 11 Ramsel
66,Bergstraat 71,2019-08-25,16:00:00,220,132,88,FMN GV 11 Ramsel
66,Bergstraat 71,2019-08-25,17:00:00,164,68,96,FMN GV 11 Ramsel
66,Bergstraat 71,2019-08-25,18:00:00,148,72,76,FMN GV 11 Ramsel
66,Bergstraat 71,2019-08-25,19:00:00,138,62,76,FMN GV 11 Ramsel
66,Bergstraat 71,2019-08-25,20:00:00,96,58,38,FMN GV 11 Ramsel
66,Bergstraat 71,2019-08-25,21:00:00,52,40,12,FMN GV 11 Ramsel
66,Bergstraat 71,2019-08-25,22:00:00,16,10,6,FMN GV 11 Ramsel
66,Bergstraat 71,2019-08-25,23:00:00,8,6,2,FMN GV 11 Ramsel
66,Bergstraat 71,2019-08-26,00:00:00,0,0,0,FMN GV 11 Ramsel
66,Bergstraat 71,2019-08-26,01:00:00,4,4,0,FMN GV 11 Ramsel
66,Bergstraat 71,2019-08-26,02:00:00,4,0,4,FMN GV 11 Ramsel
66,Bergstraat 71,2019-08-26,03:00:00,2,0,2,FMN GV 11 Ramsel
66,Bergstraat 71,2019-08-26,04:00:00,4,4,0,FMN GV 11 Ramsel
66,Bergstraat 71,2019-08-26,05:00:00,12,4,8,FMN GV 11 Ramsel
66,Bergstraat 71,2019-08-26,06:00:00,48,14,34,FMN GV 11 Ramsel
66,Bergstraat 71,2019-08-26,07:00:00,58,24,34,FMN GV 11 Ramsel
66,Bergstraat 71,2019-08-26,08:00:00,72,30,42,FMN GV 11 Ramsel
66,Bergstraat 71,2019-08-26,09:00:00,94,48,46,FMN GV 11 Ramsel
66,Bergstraat 71,2019-08-26,10:00:00,104,30,74,FMN GV 11 Ramsel
66,Bergstraat 71,2019-08-26,11:00:00,108,50,58,FMN GV 11 Ramsel
66,Bergstraat 71,2019-08-26,12:00:00,148,72,76,FMN GV 11 Ramsel
66,Bergstraat 71,2019-08-26,13:00:00,166,88,78,FMN GV 11 Ramsel
66,Bergstraat 71,2019-08-26,14:00:00,176,64,112,FMN GV 11 Ramsel
66,Bergstraat 71,2019-08-26,15:00:00,180,100,80,FMN GV 11 Ramsel
66,Bergstraat 71,2019-08-26,16:00:00,160,104,56,FMN GV 11 Ramsel
66,Bergstraat 71,2019-08-26,17:00:00,126,52,74,FMN GV 11 Ramsel
66,Bergstraat 71,2019-08-26,18:00:00,134,60,74,FMN GV 11 Ramsel
66,Bergstraat 71,2019-08-26,19:00:00,114,46,68,FMN GV 11 Ramsel
66,Bergstraat 71,2019-08-26,20:00:00,82,52,30,FMN GV 11 Ramsel
66,Bergstraat 71,2019-08-26,21:00:00,62,54,8,FMN GV 11 Ramsel
66,Bergstraat 71,2019-08-26,22:00:00,22,16,6,FMN GV 11 Ramsel
66,Bergstraat 71,2019-08-26,23:00:00,2,0,2,FMN GV 11 Ramsel
66,Bergstraat 71,2019-08-27,00:00:00,6,4,2,FMN GV 11 Ramsel
66,Bergstraat 71,2019-08-27,01:00:00,0,0,0,FMN GV 11 Ramsel
66,Bergstraat 71,2019-08-27,02:00:00,2,2,0,FMN GV 11 Ramsel
66,Bergstraat 71,2019-08-27,03:00:00,0,0,0,FMN GV 11 Ramsel
66,Bergstraat 71,2019-08-27,04:00:00,2,2,0,FMN GV 11 Ramsel
66,Bergstraat 71,2019-08-27,05:00:00,20,4,16,FMN GV 11 Ramsel
66,Bergstraat 71,2019-08-27,06:00:00,54,22,32,FMN GV 11 Ramsel
66,Bergstraat 71,2019-08-27,07:00:00,86,30,56,FMN GV 11 Ramsel
66,Bergstraat 71,2019-08-27,08:00:00,104,38,66,FMN GV 11 Ramsel
66,Bergstraat 71,2019-08-27,09:00:00,150,42,108,FMN GV 11 Ramsel
66,Bergstraat 71,2019-08-27,10:00:00,162,82,80,FMN GV 11 Ramsel
66,Bergstraat 71,2019-08-27,11:00:00,146,52,94,FMN GV 11 Ramsel
66,Bergstraat 71,2019-08-27,12:00:00,158,100,58,FMN GV 11 Ramsel
66,Bergstraat 71,2019-08-27,13:00:00,252,124,128,FMN GV 11 Ramsel
66,Bergstraat 71,2019-08-27,14:00:00,110,50,60,FMN GV 11 Ramsel
66,Bergstraat 71,2019-08-27,15:00:00,168,74,94,FMN GV 11 Ramsel
66,Bergstraat 71,2019-08-27,16:00:00,184,100,84,FMN GV 11 Ramsel
66,Bergstraat 71,2019-08-27,17:00:00,154,72,82,FMN GV 11 Ramsel
66,Bergstraat 71,2019-08-27,18:00:00,154,84,70,FMN GV 11 Ramsel
66,Bergstraat 71,2019-08-27,19:00:00,154,70,84,FMN GV 11 Ramsel
66,Bergstraat 71,2019-08-27,20:00:00,124,66,58,FMN GV 11 Ramsel
66,Bergstraat 71,2019-08-27,21:00:00,56,38,18,FMN GV 11 Ramsel
66,Bergstraat 71,2019-08-27,22:00:00,20,10,10,FMN GV 11 Ramsel
66,Bergstraat 71,2019-08-27,23:00:00,14,6,8,FMN GV 11 Ramsel
66,Bergstraat 71,2019-08-28,00:00:00,0,0,0,FMN GV 11 Ramsel
66,Bergstraat 71,2019-08-28,01:00:00,0,0,0,FMN GV 11 Ramsel
66,Bergstraat 71,2019-08-28,02:00:00,2,0,2,FMN GV 11 Ramsel
66,Bergstraat 71,2019-08-28,03:00:00,0,0,0,FMN GV 11 Ramsel
66,Bergstraat 71,2019-08-28,04:00:00,6,4,2,FMN GV 11 Ramsel
66,Bergstraat 71,2019-08-28,05:00:00,18,6,12,FMN GV 11 Ramsel
66,Bergstraat 71,2019-08-28,06:00:00,42,18,24,FMN GV 11 Ramsel
66,Bergstraat 71,2019-08-28,07:00:00,66,22,44,FMN GV 11 Ramsel
66,Bergstraat 71,2019-08-28,08:00:00,102,28,74,FMN GV 11 Ramsel
66,Bergstraat 71,2019-08-28,09:00:00,108,60,48,FMN GV 11 Ramsel
66,Bergstraat 71,2019-08-28,10:00:00,86,28,58,FMN GV 11 Ramsel
66,Bergstraat 71,2019-08-28,11:00:00,100,66,34,FMN GV 11 Ramsel
66,Bergstraat 71,2019-08-28,12:00:00,100,56,44,FMN GV 11 Ramsel
66,Bergstraat 71,2019-08-28,13:00:00,136,68,68,FMN GV 11 Ramsel
66,Bergstraat 71,2019-08-28,14:00:00,148,86,62,FMN GV 11 Ramsel
66,Bergstraat 71,2019-08-28,15:00:00,156,94,62,FMN GV 11 Ramsel
66,Bergstraat 71,2019-08-28,16:00:00,162,78,84,FMN GV 11 Ramsel
66,Bergstraat 71,2019-08-28,17:00:00,160,74,86,FMN GV 11 Ramsel
66,Bergstraat 71,2019-08-28,18:00:00,98,60,38,FMN GV 11 Ramsel
66,Bergstraat 71,2019-08-28,19:00:00,78,40,38,FMN GV 11 Ramsel
66,Bergstraat 71,2019-08-28,20:00:00,36,20,16,FMN GV 11 Ramsel
66,Bergstraat 71,2019-08-28,21:00:00,32,26,6,FMN GV 11 Ramsel
66,Bergstraat 71,2019-08-28,22:00:00,6,6,0,FMN GV 11 Ramsel
66,Bergstraat 71,2019-08-28,23:00:00,10,2,8,FMN GV 11 Ramsel
66,Bergstraat 71,2019-08-29,00:00:00,4,4,0,FMN GV 11 Ramsel
66,Bergstraat 71,2019-08-29,01:00:00,2,2,0,FMN GV 11 Ramsel
66,Bergstraat 71,2019-08-29,02:00:00,0,0,0,FMN GV 11 Ramsel
66,Bergstraat 71,2019-08-29,03:00:00,0,0,0,FMN GV 11 Ramsel
66,Bergstraat 71,2019-08-29,04:00:00,2,2,0,FMN GV 11 Ramsel
66,Bergstraat 71,2019-08-29,05:00:00,6,4,2,FMN GV 11 Ramsel
66,Bergstraat 71,2019-08-29,06:00:00,32,12,20,FMN GV 11 Ramsel
66,Bergstraat 71,2019-08-29,07:00:00,40,14,26,FMN GV 11 Ramsel
66,Bergstraat 71,2019-08-29,08:00:00,66,24,42,FMN GV 11 Ramsel
66,Bergstraat 71,2019-08-29,09:00:00,56,16,40,FMN GV 11 Ramsel
66,Bergstraat 71,2019-08-29,10:00:00,54,26,28,FMN GV 11 Ramsel
66,Bergstraat 71,2019-08-29,11:00:00,94,52,42,FMN GV 11 Ramsel
66,Bergstraat 71,2019-08-29,12:00:00,70,46,24,FMN GV 11 Ramsel
66,Bergstraat 71,2019-08-29,13:00:00,110,46,64,FMN GV 11 Ramsel
66,Bergstraat 71,2019-08-29,14:00:00,164,70,94,FMN GV 11 Ramsel
66,Bergstraat 71,2019-08-29,15:00:00,136,74,62,FMN GV 11 Ramsel
66,Bergstraat 71,2019-08-29,16:00:00,160,98,62,FMN GV 11 Ramsel
66,Bergstraat 71,2019-08-29,17:00:00,146,78,68,FMN GV 11 Ramsel
66,Bergstraat 71,2019-08-29,18:00:00,126,64,62,FMN GV 11 Ramsel
66,Bergstraat 71,2019-08-29,19:00:00,100,44,56,FMN GV 11 Ramsel
66,Bergstraat 71,2019-08-29,20:00:00,44,32,12,FMN GV 11 Ramsel
66,Bergstraat 71,2019-08-29,21:00:00,20,16,4,FMN GV 11 Ramsel
66,Bergstraat 71,2019-08-29,22:00:00,12,12,0,FMN GV 11 Ramsel
66,Bergstraat 71,2019-08-29,23:00:00,2,2,0,FMN GV 11 Ramsel
66,Bergstraat 71,2019-08-30,00:00:00,10,6,4,FMN GV 11 Ramsel
66,Bergstraat 71,2019-08-30,01:00:00,0,0,0,FMN GV 11 Ramsel
66,Bergstraat 71,2019-08-30,02:00:00,0,0,0,FMN GV 11 Ramsel
66,Bergstraat 71,2019-08-30,03:00:00,0,0,0,FMN GV 11 Ramsel
66,Bergstraat 71,2019-08-30,04:00:00,4,4,0,FMN GV 11 Ramsel
66,Bergstraat 71,2019-08-30,05:00:00,10,4,6,FMN GV 11 Ramsel
66,Bergstraat 71,2019-08-30,06:00:00,44,20,24,FMN GV 11 Ramsel
66,Bergstraat 71,2019-08-30,07:00:00,74,18,56,FMN GV 11 Ramsel
66,Bergstraat 71,2019-08-30,08:00:00,68,18,50,FMN GV 11 Ramsel
66,Bergstraat 71,2019-08-30,09:00:00,88,36,52,FMN GV 11 Ramsel
66,Bergstraat 71,2019-08-30,10:00:00,114,36,78,FMN GV 11 Ramsel
66,Bergstraat 71,2019-08-30,11:00:00,96,48,48,FMN GV 11 Ramsel
66,Bergstraat 71,2019-08-30,12:00:00,154,56,98,FMN GV 11 Ramsel
66,Bergstraat 71,2019-08-30,13:00:00,204,90,114,FMN GV 11 Ramsel
66,Bergstraat 71,2019-08-30,14:00:00,182,68,114,FMN GV 11 Ramsel
66,Bergstraat 71,2019-08-30,15:00:00,240,184,56,FMN GV 11 Ramsel
66,Bergstraat 71,2019-08-30,16:00:00,170,100,70,FMN GV 11 Ramsel
66,Bergstraat 71,2019-08-30,17:00:00,196,122,74,FMN GV 11 Ramsel
66,Bergstraat 71,2019-08-30,18:00:00,158,84,74,FMN GV 11 Ramsel
66,Bergstraat 71,2019-08-30,19:00:00,74,48,26,FMN GV 11 Ramsel
66,Bergstraat 71,2019-08-30,20:00:00,76,42,34,FMN GV 11 Ramsel
66,Bergstraat 71,2019-08-30,21:00:00,22,18,4,FMN GV 11 Ramsel
66,Bergstraat 71,2019-08-30,22:00:00,18,10,8,FMN GV 11 Ramsel
66,Bergstraat 71,2019-08-30,23:00:00,4,2,2,FMN GV 11 Ramsel
66,Bergstraat 71,2019-08-31,00:00:00,14,8,6,FMN GV 11 Ramsel
66,Bergstraat 71,2019-08-31,01:00:00,6,2,4,FMN GV 11 Ramsel
66,Bergstraat 71,2019-08-31,02:00:00,2,2,0,FMN GV 11 Ramsel
66,Bergstraat 71,2019-08-31,03:00:00,0,0,0,FMN GV 11 Ramsel
66,Bergstraat 71,2019-08-31,04:00:00,0,0,0,FMN GV 11 Ramsel
66,Bergstraat 71,2019-08-31,05:00:00,6,4,2,FMN GV 11 Ramsel
66,Bergstraat 71,2019-08-31,06:00:00,6,2,4,FMN GV 11 Ramsel
66,Bergstraat 71,2019-08-31,07:00:00,16,2,14,FMN GV 11 Ramsel
66,Bergstraat 71,2019-08-31,08:00:00,50,14,36,FMN GV 11 Ramsel
66,Bergstraat 71,2019-08-31,09:00:00,132,66,66,FMN GV 11 Ramsel
66,Bergstraat 71,2019-08-31,10:00:00,152,60,92,FMN GV 11 Ramsel
66,Bergstraat 71,2019-08-31,11:00:00,152,72,80,FMN GV 11 Ramsel
66,Bergstraat 71,2019-08-31,12:00:00,176,90,86,FMN GV 11 Ramsel
66,Bergstraat 71,2019-08-31,13:00:00,210,92,118,FMN GV 11 Ramsel
66,Bergstraat 71,2019-08-31,14:00:00,296,148,148,FMN GV 11 Ramsel
66,Bergstraat 71,2019-08-31,15:00:00,236,128,108,FMN GV 11 Ramsel
66,Bergstraat 71,2019-08-31,16:00:00,216,128,88,FMN GV 11 Ramsel
66,Bergstraat 71,2019-08-31,17:00:00,136,74,62,FMN GV 11 Ramsel
66,Bergstraat 71,2019-08-31,18:00:00,122,60,62,FMN GV 11 Ramsel
66,Bergstraat 71,2019-08-31,19:00:00,78,24,54,FMN GV 11 Ramsel
66,Bergstraat 71,2019-08-31,20:00:00,32,16,16,FMN GV 11 Ramsel
66,Bergstraat 71,2019-08-31,21:00:00,20,6,14,FMN GV 11 Ramsel
66,Bergstraat 71,2019-08-31,22:00:00,20,14,6,FMN GV 11 Ramsel
66,Bergstraat 71,2019-08-31,23:00:00,20,14,6,FMN GV 11 Ramsel
66,Bergstraat 71,2019-09-01,00:00:00,4,0,4,FMN GV 11 Ramsel
66,Bergstraat 71,2019-09-01,01:00:00,12,4,8,FMN GV 11 Ramsel
66,Bergstraat 71,2019-09-01,02:00:00,4,4,0,FMN GV 11 Ramsel
66,Bergstraat 71,2019-09-01,03:00:00,2,2,0,FMN GV 11 Ramsel
66,Bergstraat 71,2019-09-01,04:00:00,0,0,0,FMN GV 11 Ramsel
66,Bergstraat 71,2019-09-01,05:00:00,2,0,2,FMN GV 11 Ramsel
66,Bergstraat 71,2019-09-01,06:00:00,10,2,8,FMN GV 11 Ramsel
66,Bergstraat 71,2019-09-01,07:00:00,38,14,24,FMN GV 11 Ramsel
66,Bergstraat 71,2019-09-01,08:00:00,244,34,210,FMN GV 11 Ramsel
66,Bergstraat 71,2019-09-01,09:00:00,160,24,136,FMN GV 11 Ramsel
66,Bergstraat 71,2019-09-01,10:00:00,354,114,240,FMN GV 11 Ramsel
66,Bergstraat 71,2019-09-01,11:00:00,284,122,162,FMN GV 11 Ramsel
66,Bergstraat 71,2019-09-01,12:00:00,272,106,166,FMN GV 11 Ramsel
66,Bergstraat 71,2019-09-01,13:00:00,486,112,374,FMN GV 11 Ramsel
66,Bergstraat 71,2019-09-01,14:00:00,366,100,266,FMN GV 11 Ramsel
66,Bergstraat 71,2019-09-01,15:00:00,252,122,130,FMN GV 11 Ramsel
66,Bergstraat 71,2019-09-01,16:00:00,138,68,70,FMN GV 11 Ramsel
66,Bergstraat 71,2019-09-01,17:00:00,128,68,60,FMN GV 11 Ramsel
66,Bergstraat 71,2019-09-01,18:00:00,96,30,66,FMN GV 11 Ramsel
66,Bergstraat 71,2019-09-01,19:00:00,50,14,36,FMN GV 11 Ramsel
66,Bergstraat 71,2019-09-01,20:00:00,44,38,6,FMN GV 11 Ramsel
66,Bergstraat 71,2019-09-01,21:00:00,18,12,6,FMN GV 11 Ramsel
66,Bergstraat 71,2019-09-01,22:00:00,2,2,0,FMN GV 11 Ramsel
66,Bergstraat 71,2019-09-01,23:00:00,2,2,0,FMN GV 11 Ramsel
66,Bergstraat 71,2019-09-02,00:00:00,0,0,0,FMN GV 11 Ramsel
66,Bergstraat 71,2019-09-02,01:00:00,0,0,0,FMN GV 11 Ramsel
66,Bergstraat 71,2019-09-02,02:00:00,0,0,0,FMN GV 11 Ramsel
66,Bergstraat 71,2019-09-02,03:00:00,0,0,0,FMN GV 11 Ramsel
66,Bergstraat 71,2019-09-02,04:00:00,2,2,0,FMN GV 11 Ramsel
66,Bergstraat 71,2019-09-02,05:00:00,6,4,2,FMN GV 11 Ramsel
66,Bergstraat 71,2019-09-02,06:00:00,64,16,48,FMN GV 11 Ramsel
66,Bergstraat 71,2019-09-02,07:00:00,186,26,160,FMN GV 11 Ramsel
66,Bergstraat 71,2019-09-02,08:00:00,302,40,262,FMN GV 11 Ramsel
66,Bergstraat 71,2019-09-02,09:00:00,114,20,94,FMN GV 11 Ramsel
66,Bergstraat 71,2019-09-02,10:00:00,74,20,54,FMN GV 11 Ramsel
66,Bergstraat 71,2019-09-02,11:00:00,72,30,42,FMN GV 11 Ramsel
66,Bergstraat 71,2019-09-02,12:00:00,306,246,60,FMN GV 11 Ramsel
66,Bergstraat 71,2019-09-02,13:00:00,222,116,106,FMN GV 11 Ramsel
66,Bergstraat 71,2019-09-02,14:00:00,228,120,108,FMN GV 11 Ramsel
66,Bergstraat 71,2019-09-02,15:00:00,240,168,72,FMN GV 11 Ramsel
66,Bergstraat 71,2019-09-02,16:00:00,236,148,88,FMN GV 11 Ramsel
66,Bergstraat 71,2019-09-02,17:00:00,118,76,42,FMN GV 11 Ramsel
66,Bergstraat 71,2019-09-02,18:00:00,108,68,40,FMN GV 11 Ramsel
66,Bergstraat 71,2019-09-02,19:00:00,74,28,46,FMN GV 11 Ramsel
66,Bergstraat 71,2019-09-02,20:00:00,44,30,14,FMN GV 11 Ramsel
66,Bergstraat 71,2019-09-02,21:00:00,14,4,10,FMN GV 11 Ramsel
66,Bergstraat 71,2019-09-02,22:00:00,10,10,0,FMN GV 11 Ramsel
66,Bergstraat 71,2019-09-02,23:00:00,4,0,4,FMN GV 11 Ramsel
66,Bergstraat 71,2019-09-03,00:00:00,0,0,0,FMN GV 11 Ramsel
66,Bergstraat 71,2019-09-03,01:00:00,4,2,2,FMN GV 11 Ramsel
66,Bergstraat 71,2019-09-03,02:00:00,4,4,0,FMN GV 11 Ramsel
66,Bergstraat 71,2019-09-03,03:00:00,0,0,0,FMN GV 11 Ramsel
66,Bergstraat 71,2019-09-03,04:00:00,2,2,0,FMN GV 11 Ramsel
66,Bergstraat 71,2019-09-03,05:00:00,12,6,6,FMN GV 11 Ramsel
66,Bergstraat 71,2019-09-03,06:00:00,84,20,64,FMN GV 11 Ramsel
66,Bergstraat 71,2019-09-03,07:00:00,346,36,310,FMN GV 11 Ramsel
66,Bergstraat 71,2019-09-03,08:00:00,218,20,198,FMN GV 11 Ramsel
66,Bergstraat 71,2019-09-03,09:00:00,76,30,46,FMN GV 11 Ramsel
66,Bergstraat 71,2019-09-03,10:00:00,56,16,40,FMN GV 11 Ramsel
66,Bergstraat 71,2019-09-03,11:00:00,82,40,42,FMN GV 11 Ramsel
66,Bergstraat 71,2019-09-03,12:00:00,124,58,66,FMN GV 11 Ramsel
66,Bergstraat 71,2019-09-03,13:00:00,140,74,66,FMN GV 11 Ramsel
66,Bergstraat 71,2019-09-03,14:00:00,98,56,42,FMN GV 11 Ramsel
66,Bergstraat 71,2019-09-03,15:00:00,358,276,82,FMN GV 11 Ramsel
66,Bergstraat 71,2019-09-03,16:00:00,250,180,70,FMN GV 11 Ramsel
66,Bergstraat 71,2019-09-03,17:00:00,170,92,78,FMN GV 11 Ramsel
66,Bergstraat 71,2019-09-03,18:00:00,78,40,38,FMN GV 11 Ramsel
66,Bergstraat 71,2019-09-03,19:00:00,58,36,22,FMN GV 11 Ramsel
66,Bergstraat 71,2019-09-03,20:00:00,46,38,8,FMN GV 11 Ramsel
66,Bergstraat 71,2019-09-03,21:00:00,14,12,2,FMN GV 11 Ramsel
66,Bergstraat 71,2019-09-03,22:00:00,14,12,2,FMN GV 11 Ramsel
66,Bergstraat 71,2019-09-03,23:00:00,2,2,0,FMN GV 11 Ramsel
66,Bergstraat 71,2019-09-04,00:00:00,2,2,0,FMN GV 11 Ramsel
66,Bergstraat 71,2019-09-04,01:00:00,0,0,0,FMN GV 11 Ramsel
66,Bergstraat 71,2019-09-04,02:00:00,0,0,0,FMN GV 11 Ramsel
66,Bergstraat 71,2019-09-04,03:00:00,0,0,0,FMN GV 11 Ramsel
66,Bergstraat 71,2019-09-04,04:00:00,4,2,2,FMN GV 11 Ramsel
66,Bergstraat 71,2019-09-04,05:00:00,10,6,4,FMN GV 11 Ramsel
66,Bergstraat 71,2019-09-04,06:00:00,52,14,38,FMN GV 11 Ramsel
66,Bergstraat 71,2019-09-04,07:00:00,302,24,278,FMN GV 11 Ramsel
66,Bergstraat 71,2019-09-04,08:00:00,172,22,150,FMN GV 11 Ramsel
66,Bergstraat 71,2019-09-04,09:00:00,56,28,28,FMN GV 11 Ramsel
66,Bergstraat 71,2019-09-04,10:00:00,104,52,52,FMN GV 11 Ramsel
66,Bergstraat 71,2019-09-04,11:00:00,98,62,36,FMN GV 11 Ramsel
66,Bergstraat 71,2019-09-04,12:00:00,304,252,52,FMN GV 11 Ramsel
66,Bergstraat 71,2019-09-04,13:00:00,124,74,50,FMN GV 11 Ramsel
66,Bergstraat 71,2019-09-04,14:00:00,142,92,50,FMN GV 11 Ramsel
66,Bergstraat 71,2019-09-04,15:00:00,106,64,42,FMN GV 11 Ramsel
66,Bergstraat 71,2019-09-04,16:00:00,86,74,12,FMN GV 11 Ramsel
66,Bergstraat 71,2019-09-04,17:00:00,50,32,18,FMN GV 11 Ramsel
66,Bergstraat 71,2019-09-04,18:00:00,64,36,28,FMN GV 11 Ramsel
66,Bergstraat 71,2019-09-04,19:00:00,44,30,14,FMN GV 11 Ramsel
66,Bergstraat 71,2019-09-04,20:00:00,20,12,8,FMN GV 11 Ramsel
66,Bergstraat 71,2019-09-04,21:00:00,24,22,2,FMN GV 11 Ramsel
66,Bergstraat 71,2019-09-04,22:00:00,14,8,6,FMN GV 11 Ramsel
66,Bergstraat 71,2019-09-04,23:00:00,2,2,0,FMN GV 11 Ramsel
66,Bergstraat 71,2019-09-05,00:00:00,0,0,0,FMN GV 11 Ramsel
66,Bergstraat 71,2019-09-05,01:00:00,2,0,2,FMN GV 11 Ramsel
66,Bergstraat 71,2019-09-05,02:00:00,0,0,0,FMN GV 11 Ramsel
66,Bergstraat 71,2019-09-05,03:00:00,0,0,0,FMN GV 11 Ramsel
66,Bergstraat 71,2019-09-05,04:00:00,4,2,2,FMN GV 11 Ramsel
66,Bergstraat 71,2019-09-05,05:00:00,10,6,4,FMN GV 11 Ramsel
66,Bergstraat 71,2019-09-05,06:00:00,46,12,34,FMN GV 11 Ramsel
66,Bergstraat 71,2019-09-05,07:00:00,242,18,224,FMN GV 11 Ramsel
66,Bergstraat 71,2019-09-05,08:00:00,156,12,144,FMN GV 11 Ramsel
66,Bergstraat 71,2019-09-05,09:00:00,76,44,32,FMN GV 11 Ramsel
66,Bergstraat 71,2019-09-05,10:00:00,18,10,8,FMN GV 11 Ramsel
66,Bergstraat 71,2019-09-05,11:00:00,236,220,16,FMN GV 11 Ramsel
66,Bergstraat 71,2019-09-05,12:00:00,116,102,14,FMN GV 11 Ramsel
66,Bergstraat 71,2019-09-05,13:00:00,66,36,30,FMN GV 11 Ramsel
66,Bergstraat 71,2019-09-05,14:00:00,84,34,50,FMN GV 11 Ramsel
66,Bergstraat 71,2019-09-05,15:00:00,240,210,30,FMN GV 11 Ramsel
66,Bergstraat 71,2019-09-05,16:00:00,188,164,24,FMN GV 11 Ramsel
66,Bergstraat 71,2019-09-05,17:00:00,100,62,38,FMN GV 11 Ramsel
66,Bergstraat 71,2019-09-05,18:00:00,80,34,46,FMN GV 11 Ramsel
66,Bergstraat 71,2019-09-05,19:00:00,38,22,16,FMN GV 11 Ramsel
66,Bergstraat 71,2019-09-05,20:00:00,64,46,18,FMN GV 11 Ramsel
66,Bergstraat 71,2019-09-05,21:00:00,18,16,2,FMN GV 11 Ramsel
66,Bergstraat 71,2019-09-05,22:00:00,12,12,0,FMN GV 11 Ramsel
66,Bergstraat 71,2019-09-05,23:00:00,10,6,4,FMN GV 11 Ramsel
66,Bergstraat 71,2019-09-06,00:00:00,2,2,0,FMN GV 11 Ramsel
66,Bergstraat 71,2019-09-06,01:00:00,0,0,0,FMN GV 11 Ramsel
66,Bergstraat 71,2019-09-06,02:00:00,0,0,0,FMN GV 11 Ramsel
66,Bergstraat 71,2019-09-06,03:00:00,0,0,0,FMN GV 11 Ramsel
66,Bergstraat 71,2019-09-06,04:00:00,2,2,0,FMN GV 11 Ramsel
66,Bergstraat 71,2019-09-06,05:00:00,6,4,2,FMN GV 11 Ramsel
66,Bergstraat 71,2019-09-06,06:00:00,42,14,28,FMN GV 11 Ramsel
66,Bergstraat 71,2019-09-06,07:00:00,258,28,230,FMN GV 11 Ramsel
66,Bergstraat 71,2019-09-06,08:00:00,186,26,160,FMN GV 11 Ramsel
66,Bergstraat 71,2019-09-06,09:00:00,114,58,56,FMN GV 11 Ramsel
66,Bergstraat 71,2019-09-06,10:00:00,66,36,30,FMN GV 11 Ramsel
66,Bergstraat 71,2019-09-06,11:00:00,86,38,48,FMN GV 11 Ramsel
66,Bergstraat 71,2019-09-06,12:00:00,106,36,70,FMN GV 11 Ramsel
66,Bergstraat 71,2019-09-06,13:00:00,504,86,418,FMN GV 11 Ramsel
66,Bergstraat 71,2019-09-06,14:00:00,226,106,120,FMN GV 11 Ramsel
66,Bergstraat 71,2019-09-06,15:00:00,370,294,76,FMN GV 11 Ramsel
66,Bergstraat 71,2019-09-06,16:00:00,214,154,60,FMN GV 11 Ramsel
66,Bergstraat 71,2019-09-06,17:00:00,134,100,34,FMN GV 11 Ramsel
66,Bergstraat 71,2019-09-06,18:00:00,118,40,78,FMN GV 11 Ramsel
66,Bergstraat 71,2019-09-06,19:00:00,62,32,30,FMN GV 11 Ramsel
66,Bergstraat 71,2019-09-06,20:00:00,16,10,6,FMN GV 11 Ramsel
66,Bergstraat 71,2019-09-06,21:00:00,20,14,6,FMN GV 11 Ramsel
66,Bergstraat 71,2019-09-06,22:00:00,6,2,4,FMN GV 11 Ramsel
66,Bergstraat 71,2019-09-06,23:00:00,4,4,0,FMN GV 11 Ramsel
66,Bergstraat 71,2019-09-07,00:00:00,10,10,0,FMN GV 11 Ramsel
66,Bergstraat 71,2019-09-07,01:00:00,6,6,0,FMN GV 11 Ramsel
66,Bergstraat 71,2019-09-07,02:00:00,2,2,0,FMN GV 11 Ramsel
66,Bergstraat 71,2019-09-07,03:00:00,2,0,2,FMN GV 11 Ramsel
66,Bergstraat 71,2019-09-07,04:00:00,2,2,0,FMN GV 11 Ramsel
66,Bergstraat 71,2019-09-07,05:00:00,4,0,4,FMN GV 11 Ramsel
66,Bergstraat 71,2019-09-07,06:00:00,6,2,4,FMN GV 11 Ramsel
66,Bergstraat 71,2019-09-07,07:00:00,26,6,20,FMN GV 11 Ramsel
66,Bergstraat 71,2019-09-07,08:00:00,26,12,14,FMN GV 11 Ramsel
66,Bergstraat 71,2019-09-07,09:00:00,64,30,34,FMN GV 11 Ramsel
66,Bergstraat 71,2019-09-07,10:00:00,84,36,48,FMN GV 11 Ramsel
66,Bergstraat 71,2019-09-07,11:00:00,100,62,38,FMN GV 11 Ramsel
66,Bergstraat 71,2019-09-07,12:00:00,84,18,66,FMN GV 11 Ramsel
66,Bergstraat 71,2019-09-07,13:00:00,82,54,28,FMN GV 11 Ramsel
66,Bergstraat 71,2019-09-07,14:00:00,58,34,24,FMN GV 11 Ramsel
66,Bergstraat 71,2019-09-07,15:00:00,30,18,12,FMN GV 11 Ramsel
66,Bergstraat 71,2019-09-07,16:00:00,62,26,36,FMN GV 11 Ramsel
66,Bergstraat 71,2019-09-07,17:00:00,34,22,12,FMN GV 11 Ramsel
66,Bergstraat 71,2019-09-07,18:00:00,64,32,32,FMN GV 11 Ramsel
66,Bergstraat 71,2019-09-07,19:00:00,36,10,26,FMN GV 11 Ramsel
66,Bergstraat 71,2019-09-07,20:00:00,24,8,16,FMN GV 11 Ramsel
66,Bergstraat 71,2019-09-07,21:00:00,16,8,8,FMN GV 11 Ramsel
66,Bergstraat 71,2019-09-07,22:00:00,2,2,0,FMN GV 11 Ramsel
66,Bergstraat 71,2019-09-07,23:00:00,8,8,0,FMN GV 11 Ramsel
66,Bergstraat 71,2019-09-08,00:00:00,2,2,0,FMN GV 11 Ramsel
66,Bergstraat 71,2019-09-08,01:00:00,8,2,6,FMN GV 11 Ramsel
66,Bergstraat 71,2019-09-08,02:00:00,4,4,0,FMN GV 11 Ramsel
66,Bergstraat 71,2019-09-08,03:00:00,4,4,0,FMN GV 11 Ramsel
66,Bergstraat 71,2019-09-08,04:00:00,0,0,0,FMN GV 11 Ramsel
66,Bergstraat 71,2019-09-08,05:00:00,0,0,0,FMN GV 11 Ramsel
66,Bergstraat 71,2019-09-08,06:00:00,2,0,2,FMN GV 11 Ramsel
66,Bergstraat 71,2019-09-08,07:00:00,18,12,6,FMN GV 11 Ramsel
66,Bergstraat 71,2019-09-08,08:00:00,46,18,28,FMN GV 11 Ramsel
66,Bergstraat 71,2019-09-08,09:00:00,122,40,82,FMN GV 11 Ramsel
66,Bergstraat 71,2019-09-08,10:00:00,168,68,100,FMN GV 11 Ramsel
66,Bergstraat 71,2019-09-08,11:00:00,192,106,86,FMN GV 11 Ramsel
66,Bergstraat 71,2019-09-08,12:00:00,90,44,46,FMN GV 11 Ramsel
66,Bergstraat 71,2019-09-08,13:00:00,162,102,60,FMN GV 11 Ramsel
66,Bergstraat 71,2019-09-08,14:00:00,202,92,110,FMN GV 11 Ramsel
66,Bergstraat 71,2019-09-08,15:00:00,182,104,78,FMN GV 11 Ramsel
66,Bergstraat 71,2019-09-08,16:00:00,132,74,58,FMN GV 11 Ramsel
66,Bergstraat 71,2019-09-08,17:00:00,76,30,46,FMN GV 11 Ramsel
66,Bergstraat 71,2019-09-08,18:00:00,74,38,36,FMN GV 11 Ramsel
66,Bergstraat 71,2019-09-08,19:00:00,60,36,24,FMN GV 11 Ramsel
66,Bergstraat 71,2019-09-08,20:00:00,16,6,10,FMN GV 11 Ramsel
66,Bergstraat 71,2019-09-08,21:00:00,8,4,4,FMN GV 11 Ramsel
66,Bergstraat 71,2019-09-08,22:00:00,4,4,0,FMN GV 11 Ramsel
66,Bergstraat 71,2019-09-08,23:00:00,6,4,2,FMN GV 11 Ramsel
66,Bergstraat 71,2019-09-09,00:00:00,0,0,0,FMN GV 11 Ramsel
66,Bergstraat 71,2019-09-09,01:00:00,0,0,0,FMN GV 11 Ramsel
66,Bergstraat 71,2019-09-09,02:00:00,0,0,0,FMN GV 11 Ramsel
66,Bergstraat 71,2019-09-09,03:00:00,0,0,0,FMN GV 11 Ramsel
66,Bergstraat 71,2019-09-09,04:00:00,2,2,0,FMN GV 11 Ramsel
66,Bergstraat 71,2019-09-09,05:00:00,10,4,6,FMN GV 11 Ramsel
66,Bergstraat 71,2019-09-09,06:00:00,50,16,34,FMN GV 11 Ramsel
66,Bergstraat 71,2019-09-09,07:00:00,256,22,234,FMN GV 11 Ramsel
66,Bergstraat 71,2019-09-09,08:00:00,222,38,184,FMN GV 11 Ramsel
66,Bergstraat 71,2019-09-09,09:00:00,82,36,46,FMN GV 11 Ramsel
66,Bergstraat 71,2019-09-09,10:00:00,68,42,26,FMN GV 11 Ramsel
66,Bergstraat 71,2019-09-09,11:00:00,70,32,38,FMN GV 11 Ramsel
66,Bergstraat 71,2019-09-09,12:00:00,98,48,50,FMN GV 11 Ramsel
66,Bergstraat 71,2019-09-09,13:00:00,220,106,114,FMN GV 11 Ramsel
66,Bergstraat 71,2019-09-09,14:00:00,138,84,54,FMN GV 11 Ramsel
66,Bergstraat 71,2019-09-09,15:00:00,332,244,88,FMN GV 11 Ramsel
66,Bergstraat 71,2019-09-09,16:00:00,266,200,66,FMN GV 11 Ramsel
66,Bergstraat 71,2019-09-09,17:00:00,136,90,46,FMN GV 11 Ramsel
66,Bergstraat 71,2019-09-09,18:00:00,110,76,34,FMN GV 11 Ramsel
66,Bergstraat 71,2019-09-09,19:00:00,44,26,18,FMN GV 11 Ramsel
66,Bergstraat 71,2019-09-09,20:00:00,28,12,16,FMN GV 11 Ramsel
66,Bergstraat 71,2019-09-09,21:00:00,14,4,10,FMN GV 11 Ramsel
66,Bergstraat 71,2019-09-09,22:00:00,10,8,2,FMN GV 11 Ramsel
66,Bergstraat 71,2019-09-09,23:00:00,2,2,0,FMN GV 11 Ramsel
66,Bergstraat 71,2019-09-10,00:00:00,4,4,0,FMN GV 11 Ramsel
66,Bergstraat 71,2019-09-10,01:00:00,0,0,0,FMN GV 11 Ramsel
66,Bergstraat 71,2019-09-10,02:00:00,0,0,0,FMN GV 11 Ramsel
66,Bergstraat 71,2019-09-10,03:00:00,0,0,0,FMN GV 11 Ramsel
66,Bergstraat 71,2019-09-10,04:00:00,4,2,2,FMN GV 11 Ramsel
66,Bergstraat 71,2019-09-10,05:00:00,12,4,8,FMN GV 11 Ramsel
66,Bergstraat 71,2019-09-10,06:00:00,60,14,46,FMN GV 11 Ramsel
66,Bergstraat 71,2019-09-10,07:00:00,258,26,232,FMN GV 11 Ramsel
66,Bergstraat 71,2019-09-10,08:00:00,188,18,170,FMN GV 11 Ramsel
66,Bergstraat 71,2019-09-10,09:00:00,52,26,26,FMN GV 11 Ramsel
66,Bergstraat 71,2019-09-10,10:00:00,110,36,74,FMN GV 11 Ramsel
66,Bergstraat 71,2019-09-10,11:00:00,86,48,38,FMN GV 11 Ramsel
66,Bergstraat 71,2019-09-10,12:00:00,140,42,98,FMN GV 11 Ramsel
66,Bergstraat 71,2019-09-10,13:00:00,250,108,142,FMN GV 11 Ramsel
66,Bergstraat 71,2019-09-10,14:00:00,220,118,102,FMN GV 11 Ramsel
66,Bergstraat 71,2019-09-10,15:00:00,436,352,84,FMN GV 11 Ramsel
66,Bergstraat 71,2019-09-10,16:00:00,340,266,74,FMN GV 11 Ramsel
66,Bergstraat 71,2019-09-10,17:00:00,200,102,98,FMN GV 11 Ramsel
66,Bergstraat 71,2019-09-10,18:00:00,130,70,60,FMN GV 11 Ramsel
66,Bergstraat 71,2019-09-10,19:00:00,144,58,86,FMN GV 11 Ramsel
66,Bergstraat 71,2019-09-10,20:00:00,16,8,8,FMN GV 11 Ramsel
66,Bergstraat 71,2019-09-10,21:00:00,54,48,6,FMN GV 11 Ramsel
66,Bergstraat 71,2019-09-10,22:00:00,20,12,8,FMN GV 11 Ramsel
66,Bergstraat 71,2019-09-10,23:00:00,4,4,0,FMN GV 11 Ramsel
66,Bergstraat 71,2019-09-11,00:00:00,0,0,0,FMN GV 11 Ramsel
66,Bergstraat 71,2019-09-11,01:00:00,0,0,0,FMN GV 11 Ramsel
66,Bergstraat 71,2019-09-11,02:00:00,0,0,0,FMN GV 11 Ramsel
66,Bergstraat 71,2019-09-11,03:00:00,2,0,2,FMN GV 11 Ramsel
66,Bergstraat 71,2019-09-11,04:00:00,4,2,2,FMN GV 11 Ramsel
66,Bergstraat 71,2019-09-11,05:00:00,12,4,8,FMN GV 11 Ramsel
66,Bergstraat 71,2019-09-11,06:00:00,54,16,38,FMN GV 11 Ramsel
66,Bergstraat 71,2019-09-11,07:00:00,250,18,232,FMN GV 11 Ramsel
66,Bergstraat 71,2019-09-11,08:00:00,168,16,152,FMN GV 11 Ramsel
66,Bergstraat 71,2019-09-11,09:00:00,32,8,24,FMN GV 11 Ramsel
66,Bergstraat 71,2019-09-11,10:00:00,52,30,22,FMN GV 11 Ramsel
66,Bergstraat 71,2019-09-11,11:00:00,42,12,30,FMN GV 11 Ramsel
66,Bergstraat 71,2019-09-11,12:00:00,250,234,16,FMN GV 11 Ramsel
66,Bergstraat 71,2019-09-11,13:00:00,44,40,4,FMN GV 11 Ramsel
66,Bergstraat 71,2019-09-11,14:00:00,48,24,24,FMN GV 11 Ramsel
66,Bergstraat 71,2019-09-11,15:00:00,52,26,26,FMN GV 11 Ramsel
66,Bergstraat 71,2019-09-11,16:00:00,80,62,18,FMN GV 11 Ramsel
66,Bergstraat 71,2019-09-11,17:00:00,70,46,24,FMN GV 11 Ramsel
66,Bergstraat 71,2019-09-11,18:00:00,36,18,18,FMN GV 11 Ramsel
66,Bergstraat 71,2019-09-11,19:00:00,30,24,6,FMN GV 11 Ramsel
66,Bergstraat 71,2019-09-11,20:00:00,20,10,10,FMN GV 11 Ramsel
66,Bergstraat 71,2019-09-11,21:00:00,2,2,0,FMN GV 11 Ramsel
66,Bergstraat 71,2019-09-11,22:00:00,4,4,0,FMN GV 11 Ramsel
66,Bergstraat 71,2019-09-11,23:00:00,6,2,4,FMN GV 11 Ramsel
66,Bergstraat 71,2019-09-12,00:00:00,2,2,0,FMN GV 11 Ramsel
66,Bergstraat 71,2019-09-12,01:00:00,0,0,0,FMN GV 11 Ramsel
66,Bergstraat 71,2019-09-12,02:00:00,0,0,0,FMN GV 11 Ramsel
66,Bergstraat 71,2019-09-12,03:00:00,0,0,0,FMN GV 11 Ramsel
66,Bergstraat 71,2019-09-12,04:00:00,4,4,0,FMN GV 11 Ramsel
66,Bergstraat 71,2019-09-12,05:00:00,18,4,14,FMN GV 11 Ramsel
66,Bergstraat 71,2019-09-12,06:00:00,56,10,46,FMN GV 11 Ramsel
66,Bergstraat 71,2019-09-12,07:00:00,208,22,186,FMN GV 11 Ramsel
66,Bergstraat 71,2019-09-12,08:00:00,136,24,112,FMN GV 11 Ramsel
66,Bergstraat 71,2019-09-12,09:00:00,86,18,68,FMN GV 11 Ramsel
66,Bergstraat 71,2019-09-12,10:00:00,94,28,66,FMN GV 11 Ramsel
66,Bergstraat 71,2019-09-12,11:00:00,72,46,26,FMN GV 11 Ramsel
66,Bergstraat 71,2019-09-12,12:00:00,94,38,56,FMN GV 11 Ramsel
66,Bergstraat 71,2019-09-12,13:00:00,154,80,74,FMN GV 11 Ramsel
66,Bergstraat 71,2019-09-12,14:00:00,212,130,82,FMN GV 11 Ramsel
66,Bergstraat 71,2019-09-12,15:00:00,320,218,102,FMN GV 11 Ramsel
66,Bergstraat 71,2019-09-12,16:00:00,234,144,90,FMN GV 11 Ramsel
66,Bergstraat 71,2019-09-12,17:00:00,184,110,74,FMN GV 11 Ramsel
66,Bergstraat 71,2019-09-12,18:00:00,98,48,50,FMN GV 11 Ramsel
66,Bergstraat 71,2019-09-12,19:00:00,94,58,36,FMN GV 11 Ramsel
66,Bergstraat 71,2019-09-12,20:00:00,46,32,14,FMN GV 11 Ramsel
66,Bergstraat 71,2019-09-12,21:00:00,18,10,8,FMN GV 11 Ramsel
66,Bergstraat 71,2019-09-12,22:00:00,22,18,4,FMN GV 11 Ramsel
66,Bergstraat 71,2019-09-12,23:00:00,6,6,0,FMN GV 11 Ramsel
66,Bergstraat 71,2019-09-13,00:00:00,0,0,0,FMN GV 11 Ramsel
66,Bergstraat 71,2019-09-13,01:00:00,0,0,0,FMN GV 11 Ramsel
66,Bergstraat 71,2019-09-13,02:00:00,0,0,0,FMN GV 11 Ramsel
66,Bergstraat 71,2019-09-13,03:00:00,0,0,0,FMN GV 11 Ramsel
66,Bergstraat 71,2019-09-13,04:00:00,6,4,2,FMN GV 11 Ramsel
66,Bergstraat 71,2019-09-13,05:00:00,12,4,8,FMN GV 11 Ramsel
66,Bergstraat 71,2019-09-13,06:00:00,48,14,34,FMN GV 11 Ramsel
66,Bergstraat 71,2019-09-13,07:00:00,250,20,230,FMN GV 11 Ramsel
66,Bergstraat 71,2019-09-13,08:00:00,196,28,168,FMN GV 11 Ramsel
66,Bergstraat 71,2019-09-13,09:00:00,32,18,14,FMN GV 11 Ramsel
66,Bergstraat 71,2019-09-13,10:00:00,66,30,36,FMN GV 11 Ramsel
66,Bergstraat 71,2019-09-13,11:00:00,56,20,36,FMN GV 11 Ramsel
66,Bergstraat 71,2019-09-13,12:00:00,40,16,24,FMN GV 11 Ramsel
66,Bergstraat 71,2019-09-13,13:00:00,76,34,42,FMN GV 11 Ramsel
66,Bergstraat 71,2019-09-13,14:00:00,118,64,54,FMN GV 11 Ramsel
66,Bergstraat 71,2019-09-13,15:00:00,294,220,74,FMN GV 11 Ramsel
66,Bergstraat 71,2019-09-13,16:00:00,186,150,36,FMN GV 11 Ramsel
66,Bergstraat 71,2019-09-13,17:00:00,156,88,68,FMN GV 11 Ramsel
66,Bergstraat 71,2019-09-13,18:00:00,108,56,52,FMN GV 11 Ramsel
66,Bergstraat 71,2019-09-13,19:00:00,86,44,42,FMN GV 11 Ramsel
66,Bergstraat 71,2019-09-13,20:00:00,40,10,30,FMN GV 11 Ramsel
66,Bergstraat 71,2019-09-13,21:00:00,30,20,10,FMN GV 11 Ramsel
66,Bergstraat 71,2019-09-13,22:00:00,16,8,8,FMN GV 11 Ramsel
66,Bergstraat 71,2019-09-13,23:00:00,2,2,0,FMN GV 11 Ramsel
66,Bergstraat 71,2019-09-14,00:00:00,2,2,0,FMN GV 11 Ramsel
66,Bergstraat 71,2019-09-14,01:00:00,2,2,0,FMN GV 11 Ramsel
66,Bergstraat 71,2019-09-14,02:00:00,20,20,0,FMN GV 11 Ramsel
66,Bergstraat 71,2019-09-14,03:00:00,10,6,4,FMN GV 11 Ramsel
66,Bergstraat 71,2019-09-14,04:00:00,16,16,0,FMN GV 11 Ramsel
66,Bergstraat 71,2019-09-14,05:00:00,4,2,2,FMN GV 11 Ramsel
66,Bergstraat 71,2019-09-14,06:00:00,4,2,2,FMN GV 11 Ramsel
66,Bergstraat 71,2019-09-14,07:00:00,20,8,12,FMN GV 11 Ramsel
66,Bergstraat 71,2019-09-14,08:00:00,40,22,18,FMN GV 11 Ramsel
66,Bergstraat 71,2019-09-14,09:00:00,90,28,62,FMN GV 11 Ramsel
66,Bergstraat 71,2019-09-14,10:00:00,122,40,82,FMN GV 11 Ramsel
66,Bergstraat 71,2019-09-14,11:00:00,186,106,80,FMN GV 11 Ramsel
66,Bergstraat 71,2019-09-14,12:00:00,172,68,104,FMN GV 11 Ramsel
66,Bergstraat 71,2019-09-14,13:00:00,326,144,182,FMN GV 11 Ramsel
66,Bergstraat 71,2019-09-14,14:00:00,288,142,146,FMN GV 11 Ramsel
66,Bergstraat 71,2019-09-14,15:00:00,246,120,126,FMN GV 11 Ramsel
66,Bergstraat 71,2019-09-14,16:00:00,210,130,80,FMN GV 11 Ramsel
66,Bergstraat 71,2019-09-14,17:00:00,192,120,72,FMN GV 11 Ramsel
66,Bergstraat 71,2019-09-14,18:00:00,76,44,32,FMN GV 11 Ramsel
66,Bergstraat 71,2019-09-14,19:00:00,86,46,40,FMN GV 11 Ramsel
66,Bergstraat 71,2019-09-14,20:00:00,58,14,44,FMN GV 11 Ramsel
66,Bergstraat 71,2019-09-14,21:00:00,14,10,4,FMN GV 11 Ramsel
66,Bergstraat 71,2019-09-14,22:00:00,20,12,8,FMN GV 11 Ramsel
66,Bergstraat 71,2019-09-14,23:00:00,10,6,4,FMN GV 11 Ramsel
66,Bergstraat 71,2019-09-15,00:00:00,0,0,0,FMN GV 11 Ramsel
66,Bergstraat 71,2019-09-15,01:00:00,0,0,0,FMN GV 11 Ramsel
66,Bergstraat 71,2019-09-15,02:00:00,10,6,4,FMN GV 11 Ramsel
66,Bergstraat 71,2019-09-15,03:00:00,6,6,0,FMN GV 11 Ramsel
66,Bergstraat 71,2019-09-15,04:00:00,4,4,0,FMN GV 11 Ramsel
66,Bergstraat 71,2019-09-15,05:00:00,6,4,2,FMN GV 11 Ramsel
66,Bergstraat 71,2019-09-15,06:00:00,8,4,4,FMN GV 11 Ramsel
66,Bergstraat 71,2019-09-15,07:00:00,26,14,12,FMN GV 11 Ramsel
66,Bergstraat 71,2019-09-15,08:00:00,62,14,48,FMN GV 11 Ramsel
66,Bergstraat 71,2019-09-15,09:00:00,146,56,90,FMN GV 11 Ramsel
66,Bergstraat 71,2019-09-15,10:00:00,212,102,110,FMN GV 11 Ramsel
66,Bergstraat 71,2019-09-15,11:00:00,284,140,144,FMN GV 11 Ramsel
66,Bergstraat 71,2019-09-15,12:00:00,136,88,48,FMN GV 11 Ramsel
66,Bergstraat 71,2019-09-15,13:00:00,296,134,162,FMN GV 11 Ramsel
66,Bergstraat 71,2019-09-15,14:00:00,392,150,242,FMN GV 11 Ramsel
66,Bergstraat 71,2019-09-15,15:00:00,424,244,180,FMN GV 11 Ramsel
66,Bergstraat 71,2019-09-15,16:00:00,306,170,136,FMN GV 11 Ramsel
66,Bergstraat 71,2019-09-15,17:00:00,236,102,134,FMN GV 11 Ramsel
66,Bergstraat 71,2019-09-15,18:00:00,158,106,52,FMN GV 11 Ramsel
66,Bergstraat 71,2019-09-15,19:00:00,76,56,20,FMN GV 11 Ramsel
66,Bergstraat 71,2019-09-15,20:00:00,22,2,20,FMN GV 11 Ramsel
66,Bergstraat 71,2019-09-15,21:00:00,12,6,6,FMN GV 11 Ramsel
66,Bergstraat 71,2019-09-15,22:00:00,4,2,2,FMN GV 11 Ramsel
66,Bergstraat 71,2019-09-15,23:00:00,12,10,2,FMN GV 11 Ramsel
66,Bergstraat 71,2019-09-16,00:00:00,4,2,2,FMN GV 11 Ramsel
66,Bergstraat 71,2019-09-16,01:00:00,0,0,0,FMN GV 11 Ramsel
66,Bergstraat 71,2019-09-16,02:00:00,0,0,0,FMN GV 11 Ramsel
66,Bergstraat 71,2019-09-16,03:00:00,2,2,0,FMN GV 11 Ramsel
66,Bergstraat 71,2019-09-16,04:00:00,8,4,4,FMN GV 11 Ramsel
66,Bergstraat 71,2019-09-16,05:00:00,10,6,4,FMN GV 11 Ramsel
66,Bergstraat 71,2019-09-16,06:00:00,74,24,50,FMN GV 11 Ramsel
66,Bergstraat 71,2019-09-16,07:00:00,246,22,224,FMN GV 11 Ramsel
66,Bergstraat 71,2019-09-16,08:00:00,156,22,134,FMN GV 11 Ramsel
66,Bergstraat 71,2019-09-16,09:00:00,62,28,34,FMN GV 11 Ramsel
66,Bergstraat 71,2019-09-16,10:00:00,46,14,32,FMN GV 11 Ramsel
66,Bergstraat 71,2019-09-16,11:00:00,52,24,28,FMN GV 11 Ramsel
66,Bergstraat 71,2019-09-16,12:00:00,56,26,30,FMN GV 11 Ramsel
66,Bergstraat 71,2019-09-16,13:00:00,86,32,54,FMN GV 11 Ramsel
66,Bergstraat 71,2019-09-16,14:00:00,108,60,48,FMN GV 11 Ramsel
66,Bergstraat 71,2019-09-16,15:00:00,280,236,44,FMN GV 11 Ramsel
66,Bergstraat 71,2019-09-16,16:00:00,188,142,46,FMN GV 11 Ramsel
66,Bergstraat 71,2019-09-16,17:00:00,92,68,24,FMN GV 11 Ramsel
66,Bergstraat 71,2019-09-16,18:00:00,84,58,26,FMN GV 11 Ramsel
66,Bergstraat 71,2019-09-16,19:00:00,52,22,30,FMN GV 11 Ramsel
66,Bergstraat 71,2019-09-16,20:00:00,22,10,12,FMN GV 11 Ramsel
66,Bergstraat 71,2019-09-16,21:00:00,2,2,0,FMN GV 11 Ramsel
66,Bergstraat 71,2019-09-16,22:00:00,12,10,2,FMN GV 11 Ramsel
66,Bergstraat 71,2019-09-16,23:00:00,2,2,0,FMN GV 11 Ramsel
66,Bergstraat 71,2019-09-17,00:00:00,0,0,0,FMN GV 11 Ramsel
66,Bergstraat 71,2019-09-17,01:00:00,0,0,0,FMN GV 11 Ramsel
66,Bergstraat 71,2019-09-17,02:00:00,0,0,0,FMN GV 11 Ramsel
66,Bergstraat 71,2019-09-17,03:00:00,0,0,0,FMN GV 11 Ramsel
66,Bergstraat 71,2019-09-17,04:00:00,4,4,0,FMN GV 11 Ramsel
66,Bergstraat 71,2019-09-17,05:00:00,18,8,10,FMN GV 11 Ramsel
66,Bergstraat 71,2019-09-17,06:00:00,52,12,40,FMN GV 11 Ramsel
66,Bergstraat 71,2019-09-17,07:00:00,256,24,232,FMN GV 11 Ramsel
66,Bergstraat 71,2019-09-17,08:00:00,174,20,154,FMN GV 11 Ramsel
66,Bergstraat 71,2019-09-17,09:00:00,60,36,24,FMN GV 11 Ramsel
66,Bergstraat 71,2019-09-17,10:00:00,64,24,40,FMN GV 11 Ramsel
66,Bergstraat 71,2019-09-17,11:00:00,88,36,52,FMN GV 11 Ramsel
66,Bergstraat 71,2019-09-17,12:00:00,80,40,40,FMN GV 11 Ramsel
66,Bergstraat 71,2019-09-17,13:00:00,220,114,106,FMN GV 11 Ramsel
66,Bergstraat 71,2019-09-17,14:00:00,218,106,112,FMN GV 11 Ramsel
66,Bergstraat 71,2019-09-17,15:00:00,334,250,84,FMN GV 11 Ramsel
66,Bergstraat 71,2019-09-17,16:00:00,272,196,76,FMN GV 11 Ramsel
66,Bergstraat 71,2019-09-17,17:00:00,136,76,60,FMN GV 11 Ramsel
66,Bergstraat 71,2019-09-17,18:00:00,86,54,32,FMN GV 11 Ramsel
66,Bergstraat 71,2019-09-17,19:00:00,44,14,30,FMN GV 11 Ramsel
66,Bergstraat 71,2019-09-17,20:00:00,26,20,6,FMN GV 11 Ramsel
66,Bergstraat 71,2019-09-17,21:00:00,30,28,2,FMN GV 11 Ramsel
66,Bergstraat 71,2019-09-17,22:00:00,8,2,6,FMN GV 11 Ramsel
66,Bergstraat 71,2019-09-17,23:00:00,0,0,0,FMN GV 11 Ramsel
66,Bergstraat 71,2019-09-18,00:00:00,0,0,0,FMN GV 11 Ramsel
66,Bergstraat 71,2019-09-18,01:00:00,2,2,0,FMN GV 11 Ramsel
66,Bergstraat 71,2019-09-18,02:00:00,0,0,0,FMN GV 11 Ramsel
66,Bergstraat 71,2019-09-18,03:00:00,0,0,0,FMN GV 11 Ramsel
66,Bergstraat 71,2019-09-18,04:00:00,2,2,0,FMN GV 11 Ramsel
66,Bergstraat 71,2019-09-18,05:00:00,20,12,8,FMN GV 11 Ramsel
66,Bergstraat 71,2019-09-18,06:00:00,62,20,42,FMN GV 11 Ramsel
66,Bergstraat 71,2019-09-18,07:00:00,244,20,224,FMN GV 11 Ramsel
66,Bergstraat 71,2019-09-18,08:00:00,200,28,172,FMN GV 11 Ramsel
66,Bergstraat 71,2019-09-18,09:00:00,68,26,42,FMN GV 11 Ramsel
66,Bergstraat 71,2019-09-18,10:00:00,66,26,40,FMN GV 11 Ramsel
66,Bergstraat 71,2019-09-18,11:00:00,70,26,44,FMN GV 11 Ramsel
66,Bergstraat 71,2019-09-18,12:00:00,324,278,46,FMN GV 11 Ramsel
66,Bergstraat 71,2019-09-18,13:00:00,178,128,50,FMN GV 11 Ramsel
66,Bergstraat 71,2019-09-18,14:00:00,178,100,78,FMN GV 11 Ramsel
66,Bergstraat 71,2019-09-18,15:00:00,172,96,76,FMN GV 11 Ramsel
66,Bergstraat 71,2019-09-18,16:00:00,170,112,58,FMN GV 11 Ramsel
66,Bergstraat 71,2019-09-18,17:00:00,130,90,40,FMN GV 11 Ramsel
66,Bergstraat 71,2019-09-18,18:00:00,68,40,28,FMN GV 11 Ramsel
66,Bergstraat 71,2019-09-18,19:00:00,62,48,14,FMN GV 11 Ramsel
66,Bergstraat 71,2019-09-18,20:00:00,32,14,18,FMN GV 11 Ramsel
66,Bergstraat 71,2019-09-18,21:00:00,28,24,4,FMN GV 11 Ramsel
66,Bergstraat 71,2019-09-18,22:00:00,14,10,4,FMN GV 11 Ramsel
66,Bergstraat 71,2019-09-18,23:00:00,6,6,0,FMN GV 11 Ramsel
66,Bergstraat 71,2019-09-19,00:00:00,4,2,2,FMN GV 11 Ramsel
66,Bergstraat 71,2019-09-19,01:00:00,2,2,0,FMN GV 11 Ramsel
66,Bergstraat 71,2019-09-19,02:00:00,0,0,0,FMN GV 11 Ramsel
66,Bergstraat 71,2019-09-19,03:00:00,0,0,0,FMN GV 11 Ramsel
66,Bergstraat 71,2019-09-19,04:00:00,2,2,0,FMN GV 11 Ramsel
66,Bergstraat 71,2019-09-19,05:00:00,16,4,12,FMN GV 11 Ramsel
66,Bergstraat 71,2019-09-19,06:00:00,52,12,40,FMN GV 11 Ramsel
66,Bergstraat 71,2019-09-19,07:00:00,224,28,196,FMN GV 11 Ramsel
66,Bergstraat 71,2019-09-19,08:00:00,206,28,178,FMN GV 11 Ramsel
66,Bergstraat 71,2019-09-19,09:00:00,56,24,32,FMN GV 11 Ramsel
66,Bergstraat 71,2019-09-19,10:00:00,60,14,46,FMN GV 11 Ramsel
66,Bergstraat 71,2019-09-19,11:00:00,86,36,50,FMN GV 11 Ramsel
66,Bergstraat 71,2019-09-19,12:00:00,90,76,14,FMN GV 11 Ramsel
66,Bergstraat 71,2019-09-19,13:00:00,150,100,50,FMN GV 11 Ramsel
66,Bergstraat 71,2019-09-19,14:00:00,132,48,84,FMN GV 11 Ramsel
66,Bergstraat 71,2019-09-19,15:00:00,296,188,108,FMN GV 11 Ramsel
66,Bergstraat 71,2019-09-19,16:00:00,252,170,82,FMN GV 11 Ramsel
66,Bergstraat 71,2019-09-19,17:00:00,154,84,70,FMN GV 11 Ramsel
66,Bergstraat 71,2019-09-19,18:00:00,84,54,30,FMN GV 11 Ramsel
66,Bergstraat 71,2019-09-19,19:00:00,60,32,28,FMN GV 11 Ramsel
66,Bergstraat 71,2019-09-19,20:00:00,58,32,26,FMN GV 11 Ramsel
66,Bergstraat 71,2019-09-19,21:00:00,12,10,2,FMN GV 11 Ramsel
66,Bergstraat 71,2019-09-19,22:00:00,16,12,4,FMN GV 11 Ramsel
66,Bergstraat 71,2019-09-19,23:00:00,6,6,0,FMN GV 11 Ramsel
66,Bergstraat 71,2019-09-20,00:00:00,0,0,0,FMN GV 11 Ramsel
66,Bergstraat 71,2019-09-20,01:00:00,0,0,0,FMN GV 11 Ramsel
66,Bergstraat 71,2019-09-20,02:00:00,0,0,0,FMN GV 11 Ramsel
66,Bergstraat 71,2019-09-20,03:00:00,0,0,0,FMN GV 11 Ramsel
66,Bergstraat 71,2019-09-20,04:00:00,2,2,0,FMN GV 11 Ramsel
66,Bergstraat 71,2019-09-20,05:00:00,8,2,6,FMN GV 11 Ramsel
66,Bergstraat 71,2019-09-20,06:00:00,48,8,40,FMN GV 11 Ramsel
66,Bergstraat 71,2019-09-20,07:00:00,224,14,210,FMN GV 11 Ramsel
66,Bergstraat 71,2019-09-20,08:00:00,222,44,178,FMN GV 11 Ramsel
66,Bergstraat 71,2019-09-20,09:00:00,26,10,16,FMN GV 11 Ramsel
66,Bergstraat 71,2019-09-20,10:00:00,64,44,20,FMN GV 11 Ramsel
66,Bergstraat 71,2019-09-20,11:00:00,66,28,38,FMN GV 11 Ramsel
66,Bergstraat 71,2019-09-20,12:00:00,128,56,72,FMN GV 11 Ramsel
66,Bergstraat 71,2019-09-20,13:00:00,126,56,70,FMN GV 11 Ramsel
66,Bergstraat 71,2019-09-20,14:00:00,244,132,112,FMN GV 11 Ramsel
66,Bergstraat 71,2019-09-20,15:00:00,332,258,74,FMN GV 11 Ramsel
66,Bergstraat 71,2019-09-20,16:00:00,194,148,46,FMN GV 11 Ramsel
66,Bergstraat 71,2019-09-20,17:00:00,124,86,38,FMN GV 11 Ramsel
66,Bergstraat 71,2019-09-20,18:00:00,110,56,54,FMN GV 11 Ramsel
66,Bergstraat 71,2019-09-20,19:00:00,52,24,28,FMN GV 11 Ramsel
66,Bergstraat 71,2019-09-20,20:00:00,22,18,4,FMN GV 11 Ramsel
66,Bergstraat 71,2019-09-20,21:00:00,12,4,8,FMN GV 11 Ramsel
66,Bergstraat 71,2019-09-20,22:00:00,6,4,2,FMN GV 11 Ramsel
66,Bergstraat 71,2019-09-20,23:00:00,12,8,4,FMN GV 11 Ramsel
66,Bergstraat 71,2019-09-21,00:00:00,0,0,0,FMN GV 11 Ramsel
66,Bergstraat 71,2019-09-21,01:00:00,2,2,0,FMN GV 11 Ramsel
66,Bergstraat 71,2019-09-21,02:00:00,2,2,0,FMN GV 11 Ramsel
66,Bergstraat 71,2019-09-21,03:00:00,0,0,0,FMN GV 11 Ramsel
66,Bergstraat 71,2019-09-21,04:00:00,4,2,2,FMN GV 11 Ramsel
66,Bergstraat 71,2019-09-21,05:00:00,6,2,4,FMN GV 11 Ramsel
66,Bergstraat 71,2019-09-21,06:00:00,4,0,4,FMN GV 11 Ramsel
66,Bergstraat 71,2019-09-21,07:00:00,16,6,10,FMN GV 11 Ramsel
66,Bergstraat 71,2019-09-21,08:00:00,26,6,20,FMN GV 11 Ramsel
66,Bergstraat 71,2019-09-21,09:00:00,46,18,28,FMN GV 11 Ramsel
66,Bergstraat 71,2019-09-21,10:00:00,142,58,84,FMN GV 11 Ramsel
66,Bergstraat 71,2019-09-21,11:00:00,126,58,68,FMN GV 11 Ramsel
66,Bergstraat 71,2019-09-21,12:00:00,146,70,76,FMN GV 11 Ramsel
66,Bergstraat 71,2019-09-21,13:00:00,276,86,190,FMN GV 11 Ramsel
66,Bergstraat 71,2019-09-21,14:00:00,298,126,172,FMN GV 11 Ramsel
66,Bergstraat 71,2019-09-21,15:00:00,292,158,134,FMN GV 11 Ramsel
66,Bergstraat 71,2019-09-21,16:00:00,234,164,70,FMN GV 11 Ramsel
66,Bergstraat 71,2019-09-21,17:00:00,132,88,44,FMN GV 11 Ramsel
66,Bergstraat 71,2019-09-21,18:00:00,132,72,60,FMN GV 11 Ramsel
66,Bergstraat 71,2019-09-21,19:00:00,58,36,22,FMN GV 11 Ramsel
66,Bergstraat 71,2019-09-21,20:00:00,40,22,18,FMN GV 11 Ramsel
66,Bergstraat 71,2019-09-21,21:00:00,12,8,4,FMN GV 11 Ramsel
66,Bergstraat 71,2019-09-21,22:00:00,8,4,4,FMN GV 11 Ramsel
66,Bergstraat 71,2019-09-21,23:00:00,4,2,2,FMN GV 11 Ramsel
66,Bergstraat 71,2019-09-22,00:00:00,8,0,8,FMN GV 11 Ramsel
66,Bergstraat 71,2019-09-22,01:00:00,10,0,10,FMN GV 11 Ramsel
66,Bergstraat 71,2019-09-22,02:00:00,2,2,0,FMN GV 11 Ramsel
66,Bergstraat 71,2019-09-22,03:00:00,4,4,0,FMN GV 11 Ramsel
66,Bergstraat 71,2019-09-22,04:00:00,0,0,0,FMN GV 11 Ramsel
66,Bergstraat 71,2019-09-22,05:00:00,0,0,0,FMN GV 11 Ramsel
66,Bergstraat 71,2019-09-22,06:00:00,0,0,0,FMN GV 11 Ramsel
66,Bergstraat 71,2019-09-22,07:00:00,18,8,10,FMN GV 11 Ramsel
66,Bergstraat 71,2019-09-22,08:00:00,56,16,40,FMN GV 11 Ramsel
66,Bergstraat 71,2019-09-22,09:00:00,128,40,88,FMN GV 11 Ramsel
66,Bergstraat 71,2019-09-22,10:00:00,182,70,112,FMN GV 11 Ramsel
66,Bergstraat 71,2019-09-22,11:00:00,244,130,114,FMN GV 11 Ramsel
66,Bergstraat 71,2019-09-22,12:00:00,208,100,108,FMN GV 11 Ramsel
66,Bergstraat 71,2019-09-22,13:00:00,290,124,166,FMN GV 11 Ramsel
66,Bergstraat 71,2019-09-22,14:00:00,306,142,164,FMN GV 11 Ramsel
66,Bergstraat 71,2019-09-22,15:00:00,216,110,106,FMN GV 11 Ramsel
66,Bergstraat 71,2019-09-22,16:00:00,174,94,80,FMN GV 11 Ramsel
66,Bergstraat 71,2019-09-22,17:00:00,140,80,60,FMN GV 11 Ramsel
66,Bergstraat 71,2019-09-22,18:00:00,72,34,38,FMN GV 11 Ramsel
66,Bergstraat 71,2019-09-22,19:00:00,22,14,8,FMN GV 11 Ramsel
66,Bergstraat 71,2019-09-22,20:00:00,10,8,2,FMN GV 11 Ramsel
66,Bergstraat 71,2019-09-22,21:00:00,8,4,4,FMN GV 11 Ramsel
66,Bergstraat 71,2019-09-22,22:00:00,2,2,0,FMN GV 11 Ramsel
66,Bergstraat 71,2019-09-22,23:00:00,4,2,2,FMN GV 11 Ramsel
66,Bergstraat 71,2019-09-23,00:00:00,0,0,0,FMN GV 11 Ramsel
66,Bergstraat 71,2019-09-23,01:00:00,0,0,0,FMN GV 11 Ramsel
66,Bergstraat 71,2019-09-23,02:00:00,0,0,0,FMN GV 11 Ramsel
66,Bergstraat 71,2019-09-23,03:00:00,2,0,2,FMN GV 11 Ramsel
66,Bergstraat 71,2019-09-23,04:00:00,2,2,0,FMN GV 11 Ramsel
66,Bergstraat 71,2019-09-23,05:00:00,6,2,4,FMN GV 11 Ramsel
66,Bergstraat 71,2019-09-23,06:00:00,52,14,38,FMN GV 11 Ramsel
66,Bergstraat 71,2019-09-23,07:00:00,230,20,210,FMN GV 11 Ramsel
66,Bergstraat 71,2019-09-23,08:00:00,162,12,150,FMN GV 11 Ramsel
66,Bergstraat 71,2019-09-23,09:00:00,44,24,20,FMN GV 11 Ramsel
66,Bergstraat 71,2019-09-23,10:00:00,70,36,34,FMN GV 11 Ramsel
66,Bergstraat 71,2019-09-23,11:00:00,78,50,28,FMN GV 11 Ramsel
66,Bergstraat 71,2019-09-23,12:00:00,74,38,36,FMN GV 11 Ramsel
66,Bergstraat 71,2019-09-23,13:00:00,126,48,78,FMN GV 11 Ramsel
66,Bergstraat 71,2019-09-23,14:00:00,136,74,62,FMN GV 11 Ramsel
66,Bergstraat 71,2019-09-23,15:00:00,236,188,48,FMN GV 11 Ramsel
66,Bergstraat 71,2019-09-23,16:00:00,196,136,60,FMN GV 11 Ramsel
66,Bergstraat 71,2019-09-23,17:00:00,160,120,40,FMN GV 11 Ramsel
66,Bergstraat 71,2019-09-23,18:00:00,90,62,28,FMN GV 11 Ramsel
66,Bergstraat 71,2019-09-23,19:00:00,54,30,24,FMN GV 11 Ramsel
66,Bergstraat 71,2019-09-23,20:00:00,34,18,16,FMN GV 11 Ramsel
66,Bergstraat 71,2019-09-23,21:00:00,6,2,4,FMN GV 11 Ramsel
66,Bergstraat 71,2019-09-23,22:00:00,16,8,8,FMN GV 11 Ramsel
66,Bergstraat 71,2019-09-23,23:00:00,6,6,0,FMN GV 11 Ramsel
66,Bergstraat 71,2019-09-24,00:00:00,0,0,0,FMN GV 11 Ramsel
66,Bergstraat 71,2019-09-24,01:00:00,0,0,0,FMN GV 11 Ramsel
66,Bergstraat 71,2019-09-24,02:00:00,0,0,0,FMN GV 11 Ramsel
66,Bergstraat 71,2019-09-24,03:00:00,0,0,0,FMN GV 11 Ramsel
66,Bergstraat 71,2019-09-24,04:00:00,2,2,0,FMN GV 11 Ramsel
66,Bergstraat 71,2019-09-24,05:00:00,10,4,6,FMN GV 11 Ramsel
66,Bergstraat 71,2019-09-24,06:00:00,50,8,42,FMN GV 11 Ramsel
66,Bergstraat 71,2019-09-24,07:00:00,186,12,174,FMN GV 11 Ramsel
66,Bergstraat 71,2019-09-24,08:00:00,154,16,138,FMN GV 11 Ramsel
66,Bergstraat 71,2019-09-24,09:00:00,46,16,30,FMN GV 11 Ramsel
66,Bergstraat 71,2019-09-24,10:00:00,60,20,40,FMN GV 11 Ramsel
66,Bergstraat 71,2019-09-24,11:00:00,52,30,22,FMN GV 11 Ramsel
66,Bergstraat 71,2019-09-24,12:00:00,62,40,22,FMN GV 11 Ramsel
66,Bergstraat 71,2019-09-24,13:00:00,76,26,50,FMN GV 11 Ramsel
66,Bergstraat 71,2019-09-24,14:00:00,36,24,12,FMN GV 11 Ramsel
66,Bergstraat 71,2019-09-24,15:00:00,204,188,16,FMN GV 11 Ramsel
66,Bergstraat 71,2019-09-24,16:00:00,114,98,16,FMN GV 11 Ramsel
66,Bergstraat 71,2019-09-24,17:00:00,60,44,16,FMN GV 11 Ramsel
66,Bergstraat 71,2019-09-24,18:00:00,50,42,8,FMN GV 11 Ramsel
66,Bergstraat 71,2019-09-24,19:00:00,22,14,8,FMN GV 11 Ramsel
66,Bergstraat 71,2019-09-24,20:00:00,4,2,2,FMN GV 11 Ramsel
66,Bergstraat 71,2019-09-24,21:00:00,10,8,2,FMN GV 11 Ramsel
66,Bergstraat 71,2019-09-24,22:00:00,8,0,8,FMN GV 11 Ramsel
66,Bergstraat 71,2019-09-24,23:00:00,2,0,2,FMN GV 11 Ramsel
66,Bergstraat 71,2019-09-25,00:00:00,0,0,0,FMN GV 11 Ramsel
66,Bergstraat 71,2019-09-25,01:00:00,0,0,0,FMN GV 11 Ramsel
66,Bergstraat 71,2019-09-25,02:00:00,0,0,0,FMN GV 11 Ramsel
66,Bergstraat 71,2019-09-25,03:00:00,0,0,0,FMN GV 11 Ramsel
66,Bergstraat 71,2019-09-25,04:00:00,2,2,0,FMN GV 11 Ramsel
66,Bergstraat 71,2019-09-25,05:00:00,6,4,2,FMN GV 11 Ramsel
66,Bergstraat 71,2019-09-25,06:00:00,38,12,26,FMN GV 11 Ramsel
66,Bergstraat 71,2019-09-25,07:00:00,156,16,140,FMN GV 11 Ramsel
66,Bergstraat 71,2019-09-25,08:00:00,112,6,106,FMN GV 11 Ramsel
66,Bergstraat 71,2019-09-25,09:00:00,24,16,8,FMN GV 11 Ramsel
66,Bergstraat 71,2019-09-25,10:00:00,46,18,28,FMN GV 11 Ramsel
66,Bergstraat 71,2019-09-25,11:00:00,46,18,28,FMN GV 11 Ramsel
66,Bergstraat 71,2019-09-25,12:00:00,178,156,22,FMN GV 11 Ramsel
66,Bergstraat 71,2019-09-25,13:00:00,70,60,10,FMN GV 11 Ramsel
66,Bergstraat 71,2019-09-25,14:00:00,56,28,28,FMN GV 11 Ramsel
66,Bergstraat 71,2019-09-25,15:00:00,52,24,28,FMN GV 11 Ramsel
66,Bergstraat 71,2019-09-25,16:00:00,48,28,20,FMN GV 11 Ramsel
66,Bergstraat 71,2019-09-25,17:00:00,76,38,38,FMN GV 11 Ramsel
66,Bergstraat 71,2019-09-25,18:00:00,32,14,18,FMN GV 11 Ramsel
66,Bergstraat 71,2019-09-25,19:00:00,20,14,6,FMN GV 11 Ramsel
66,Bergstraat 71,2019-09-25,20:00:00,12,8,4,FMN GV 11 Ramsel
66,Bergstraat 71,2019-09-25,21:00:00,18,18,0,FMN GV 11 Ramsel
66,Bergstraat 71,2019-09-25,22:00:00,12,10,2,FMN GV 11 Ramsel
66,Bergstraat 71,2019-09-25,23:00:00,6,4,2,FMN GV 11 Ramsel
66,Bergstraat 71,2019-09-26,00:00:00,2,2,0,FMN GV 11 Ramsel
66,Bergstraat 71,2019-09-26,01:00:00,0,0,0,FMN GV 11 Ramsel
66,Bergstraat 71,2019-09-26,02:00:00,0,0,0,FMN GV 11 Ramsel
66,Bergstraat 71,2019-09-26,03:00:00,0,0,0,FMN GV 11 Ramsel
66,Bergstraat 71,2019-09-26,04:00:00,4,4,0,FMN GV 11 Ramsel
66,Bergstraat 71,2019-09-26,05:00:00,6,2,4,FMN GV 11 Ramsel
66,Bergstraat 71,2019-09-26,06:00:00,42,2,40,FMN GV 11 Ramsel
66,Bergstraat 71,2019-09-26,07:00:00,156,10,146,FMN GV 11 Ramsel
66,Bergstraat 71,2019-09-26,08:00:00,116,16,100,FMN GV 11 Ramsel
66,Bergstraat 71,2019-09-26,09:00:00,24,6,18,FMN GV 11 Ramsel
66,Bergstraat 71,2019-09-26,10:00:00,8,4,4,FMN GV 11 Ramsel
66,Bergstraat 71,2019-09-26,11:00:00,10,6,4,FMN GV 11 Ramsel
66,Bergstraat 71,2019-09-26,12:00:00,8,6,2,FMN GV 11 Ramsel
66,Bergstraat 71,2019-09-26,13:00:00,34,18,16,FMN GV 11 Ramsel
66,Bergstraat 71,2019-09-26,14:00:00,40,20,20,FMN GV 11 Ramsel
66,Bergstraat 71,2019-09-26,15:00:00,192,156,36,FMN GV 11 Ramsel
66,Bergstraat 71,2019-09-26,16:00:00,88,80,8,FMN GV 11 Ramsel
66,Bergstraat 71,2019-09-26,17:00:00,74,40,34,FMN GV 11 Ramsel
66,Bergstraat 71,2019-09-26,18:00:00,40,26,14,FMN GV 11 Ramsel
66,Bergstraat 71,2019-09-26,19:00:00,24,10,14,FMN GV 11 Ramsel
66,Bergstraat 71,2019-09-26,20:00:00,10,8,2,FMN GV 11 Ramsel
66,Bergstraat 71,2019-09-26,21:00:00,20,16,4,FMN GV 11 Ramsel
66,Bergstraat 71,2019-09-26,22:00:00,10,2,8,FMN GV 11 Ramsel
66,Bergstraat 71,2019-09-26,23:00:00,2,2,0,FMN GV 11 Ramsel
66,Bergstraat 71,2019-09-27,00:00:00,2,2,0,FMN GV 11 Ramsel
66,Bergstraat 71,2019-09-27,01:00:00,0,0,0,FMN GV 11 Ramsel
66,Bergstraat 71,2019-09-27,02:00:00,0,0,0,FMN GV 11 Ramsel
66,Bergstraat 71,2019-09-27,03:00:00,0,0,0,FMN GV 11 Ramsel
66,Bergstraat 71,2019-09-27,04:00:00,2,2,0,FMN GV 11 Ramsel
66,Bergstraat 71,2019-09-27,05:00:00,8,6,2,FMN GV 11 Ramsel
66,Bergstraat 71,2019-09-27,06:00:00,28,6,22,FMN GV 11 Ramsel
66,Bergstraat 71,2019-09-27,07:00:00,172,20,152,FMN GV 11 Ramsel
66,Bergstraat 71,2019-09-27,08:00:00,156,28,128,FMN GV 11 Ramsel
66,Bergstraat 71,2019-09-27,09:00:00,56,24,32,FMN GV 11 Ramsel
66,Bergstraat 71,2019-09-27,10:00:00,64,26,38,FMN GV 11 Ramsel
66,Bergstraat 71,2019-09-27,11:00:00,58,32,26,FMN GV 11 Ramsel
66,Bergstraat 71,2019-09-27,12:00:00,106,60,46,FMN GV 11 Ramsel
66,Bergstraat 71,2019-09-27,13:00:00,80,34,46,FMN GV 11 Ramsel
66,Bergstraat 71,2019-09-27,14:00:00,80,44,36,FMN GV 11 Ramsel
66,Bergstraat 71,2019-09-27,15:00:00,256,194,62,FMN GV 11 Ramsel
66,Bergstraat 71,2019-09-27,16:00:00,144,122,22,FMN GV 11 Ramsel
66,Bergstraat 71,2019-09-27,17:00:00,86,66,20,FMN GV 11 Ramsel
66,Bergstraat 71,2019-09-27,18:00:00,66,36,30,FMN GV 11 Ramsel
66,Bergstraat 71,2019-09-27,19:00:00,32,18,14,FMN GV 11 Ramsel
66,Bergstraat 71,2019-09-27,20:00:00,30,8,22,FMN GV 11 Ramsel
66,Bergstraat 71,2019-09-27,21:00:00,22,6,16,FMN GV 11 Ramsel
66,Bergstraat 71,2019-09-27,22:00:00,8,6,2,FMN GV 11 Ramsel
66,Bergstraat 71,2019-09-27,23:00:00,2,0,2,FMN GV 11 Ramsel
66,Bergstraat 71,2019-09-28,00:00:00,2,0,2,FMN GV 11 Ramsel
66,Bergstraat 71,2019-09-28,01:00:00,10,6,4,FMN GV 11 Ramsel
66,Bergstraat 71,2019-09-28,02:00:00,4,4,0,FMN GV 11 Ramsel
66,Bergstraat 71,2019-09-28,03:00:00,2,2,0,FMN GV 11 Ramsel
66,Bergstraat 71,2019-09-28,04:00:00,0,0,0,FMN GV 11 Ramsel
66,Bergstraat 71,2019-09-28,05:00:00,2,2,0,FMN GV 11 Ramsel
66,Bergstraat 71,2019-09-28,06:00:00,0,0,0,FMN GV 11 Ramsel
66,Bergstraat 71,2019-09-28,07:00:00,6,2,4,FMN GV 11 Ramsel
66,Bergstraat 71,2019-09-28,08:00:00,18,6,12,FMN GV 11 Ramsel
66,Bergstraat 71,2019-09-28,09:00:00,40,16,24,FMN GV 11 Ramsel
66,Bergstraat 71,2019-09-28,10:00:00,72,38,34,FMN GV 11 Ramsel
66,Bergstraat 71,2019-09-28,11:00:00,42,20,22,FMN GV 11 Ramsel
66,Bergstraat 71,2019-09-28,12:00:00,56,32,24,FMN GV 11 Ramsel
66,Bergstraat 71,2019-09-28,13:00:00,52,26,26,FMN GV 11 Ramsel
66,Bergstraat 71,2019-09-28,14:00:00,36,14,22,FMN GV 11 Ramsel
66,Bergstraat 71,2019-09-28,15:00:00,84,50,34,FMN GV 11 Ramsel
66,Bergstraat 71,2019-09-28,16:00:00,54,16,38,FMN GV 11 Ramsel
66,Bergstraat 71,2019-09-28,17:00:00,54,26,28,FMN GV 11 Ramsel
66,Bergstraat 71,2019-09-28,18:00:00,34,22,12,FMN GV 11 Ramsel
66,Bergstraat 71,2019-09-28,19:00:00,14,8,6,FMN GV 11 Ramsel
66,Bergstraat 71,2019-09-28,20:00:00,12,2,10,FMN GV 11 Ramsel
66,Bergstraat 71,2019-09-28,21:00:00,4,0,4,FMN GV 11 Ramsel
66,Bergstraat 71,2019-09-28,22:00:00,4,2,2,FMN GV 11 Ramsel
66,Bergstraat 71,2019-09-28,23:00:00,14,2,12,FMN GV 11 Ramsel
66,Bergstraat 71,2019-09-29,00:00:00,2,2,0,FMN GV 11 Ramsel
66,Bergstraat 71,2019-09-29,01:00:00,4,4,0,FMN GV 11 Ramsel
66,Bergstraat 71,2019-09-29,02:00:00,0,0,0,FMN GV 11 Ramsel
66,Bergstraat 71,2019-09-29,03:00:00,6,6,0,FMN GV 11 Ramsel
66,Bergstraat 71,2019-09-29,04:00:00,2,2,0,FMN GV 11 Ramsel
66,Bergstraat 71,2019-09-29,05:00:00,2,0,2,FMN GV 11 Ramsel
66,Bergstraat 71,2019-09-29,06:00:00,0,0,0,FMN GV 11 Ramsel
66,Bergstraat 71,2019-09-29,07:00:00,6,0,6,FMN GV 11 Ramsel
66,Bergstraat 71,2019-09-29,08:00:00,88,8,80,FMN GV 11 Ramsel
66,Bergstraat 71,2019-09-29,09:00:00,12,4,8,FMN GV 11 Ramsel
66,Bergstraat 71,2019-09-29,10:00:00,42,22,20,FMN GV 11 Ramsel
66,Bergstraat 71,2019-09-29,11:00:00,20,12,8,FMN GV 11 Ramsel
66,Bergstraat 71,2019-09-29,12:00:00,14,10,4,FMN GV 11 Ramsel
66,Bergstraat 71,2019-09-29,13:00:00,20,16,4,FMN GV 11 Ramsel
66,Bergstraat 71,2019-09-29,14:00:00,14,8,6,FMN GV 11 Ramsel
66,Bergstraat 71,2019-09-29,15:00:00,12,12,0,FMN GV 11 Ramsel
66,Bergstraat 71,2019-09-29,16:00:00,12,8,4,FMN GV 11 Ramsel
66,Bergstraat 71,2019-09-29,17:00:00,18,12,6,FMN GV 11 Ramsel
66,Bergstraat 71,2019-09-29,18:00:00,6,6,0,FMN GV 11 Ramsel
66,Bergstraat 71,2019-09-29,19:00:00,10,6,4,FMN GV 11 Ramsel
66,Bergstraat 71,2019-09-29,20:00:00,10,2,8,FMN GV 11 Ramsel
66,Bergstraat 71,2019-09-29,21:00:00,2,2,0,FMN GV 11 Ramsel
66,Bergstraat 71,2019-09-29,22:00:00,4,2,2,FMN GV 11 Ramsel
66,Bergstraat 71,2019-09-29,23:00:00,0,0,0,FMN GV 11 Ramsel
66,Bergstraat 71,2019-09-30,00:00:00,0,0,0,FMN GV 11 Ramsel
66,Bergstraat 71,2019-09-30,01:00:00,0,0,0,FMN GV 11 Ramsel
66,Bergstraat 71,2019-09-30,02:00:00,0,0,0,FMN GV 11 Ramsel
66,Bergstraat 71,2019-09-30,03:00:00,0,0,0,FMN GV 11 Ramsel
66,Bergstraat 71,2019-09-30,04:00:00,2,2,0,FMN GV 11 Ramsel
66,Bergstraat 71,2019-09-30,05:00:00,8,4,4,FMN GV 11 Ramsel
66,Bergstraat 71,2019-09-30,06:00:00,42,6,36,FMN GV 11 Ramsel
66,Bergstraat 71,2019-09-30,07:00:00,184,26,158,FMN GV 11 Ramsel
66,Bergstraat 71,2019-09-30,08:00:00,174,22,152,FMN GV 11 Ramsel
66,Bergstraat 71,2019-09-30,09:00:00,66,38,28,FMN GV 11 Ramsel
66,Bergstraat 71,2019-09-30,10:00:00,40,12,28,FMN GV 11 Ramsel
66,Bergstraat 71,2019-09-30,11:00:00,70,36,34,FMN GV 11 Ramsel
66,Bergstraat 71,2019-09-30,12:00:00,68,32,36,FMN GV 11 Ramsel
66,Bergstraat 71,2019-09-30,13:00:00,136,70,66,FMN GV 11 Ramsel
66,Bergstraat 71,2019-09-30,14:00:00,168,62,106,FMN GV 11 Ramsel
66,Bergstraat 71,2019-09-30,15:00:00,244,206,38,FMN GV 11 Ramsel
66,Bergstraat 71,2019-09-30,16:00:00,258,200,58,FMN GV 11 Ramsel
66,Bergstraat 71,2019-09-30,17:00:00,84,52,32,FMN GV 11 Ramsel
66,Bergstraat 71,2019-09-30,18:00:00,66,40,26,FMN GV 11 Ramsel
66,Bergstraat 71,2019-09-30,19:00:00,42,30,12,FMN GV 11 Ramsel
66,Bergstraat 71,2019-09-30,20:00:00,16,10,6,FMN GV 11 Ramsel
66,Bergstraat 71,2019-09-30,21:00:00,10,6,4,FMN GV 11 Ramsel
66,Bergstraat 71,2019-09-30,22:00:00,8,6,2,FMN GV 11 Ramsel
66,Bergstraat 71,2019-09-30,23:00:00,4,4,0,FMN GV 11 Ramsel
66,Bergstraat 71,2019-10-01,00:00:00,0,0,0,FMN GV 11 Ramsel
66,Bergstraat 71,2019-10-01,01:00:00,0,0,0,FMN GV 11 Ramsel
66,Bergstraat 71,2019-10-01,02:00:00,0,0,0,FMN GV 11 Ramsel
66,Bergstraat 71,2019-10-01,03:00:00,0,0,0,FMN GV 11 Ramsel
66,Bergstraat 71,2019-10-01,04:00:00,2,2,0,FMN GV 11 Ramsel
66,Bergstraat 71,2019-10-01,05:00:00,10,6,4,FMN GV 11 Ramsel
66,Bergstraat 71,2019-10-01,06:00:00,40,10,30,FMN GV 11 Ramsel
66,Bergstraat 71,2019-10-01,07:00:00,136,12,124,FMN GV 11 Ramsel
66,Bergstraat 71,2019-10-01,08:00:00,82,0,82,FMN GV 11 Ramsel
66,Bergstraat 71,2019-10-01,09:00:00,4,0,4,FMN GV 11 Ramsel
66,Bergstraat 71,2019-10-01,10:00:00,0,0,0,FMN GV 11 Ramsel
66,Bergstraat 71,2019-10-01,11:00:00,8,6,2,FMN GV 11 Ramsel
66,Bergstraat 71,2019-10-01,12:00:00,2,0,2,FMN GV 11 Ramsel
66,Bergstraat 71,2019-10-01,13:00:00,12,4,8,FMN GV 11 Ramsel
66,Bergstraat 71,2019-10-01,14:00:00,42,16,26,FMN GV 11 Ramsel
66,Bergstraat 71,2019-10-01,15:00:00,154,136,18,FMN GV 11 Ramsel
66,Bergstraat 71,2019-10-01,16:00:00,86,64,22,FMN GV 11 Ramsel
66,Bergstraat 71,2019-10-01,17:00:00,68,44,24,FMN GV 11 Ramsel
66,Bergstraat 71,2019-10-01,18:00:00,26,20,6,FMN GV 11 Ramsel
66,Bergstraat 71,2019-10-01,19:00:00,62,28,34,FMN GV 11 Ramsel
66,Bergstraat 71,2019-10-01,20:00:00,26,18,8,FMN GV 11 Ramsel
66,Bergstraat 71,2019-10-01,21:00:00,16,14,2,FMN GV 11 Ramsel
66,Bergstraat 71,2019-10-01,22:00:00,8,6,2,FMN GV 11 Ramsel
66,Bergstraat 71,2019-10-01,23:00:00,0,0,0,FMN GV 11 Ramsel
66,Bergstraat 71,2019-10-02,00:00:00,2,2,0,FMN GV 11 Ramsel
66,Bergstraat 71,2019-10-02,01:00:00,2,2,0,FMN GV 11 Ramsel
66,Bergstraat 71,2019-10-02,02:00:00,0,0,0,FMN GV 11 Ramsel
66,Bergstraat 71,2019-10-02,03:00:00,0,0,0,FMN GV 11 Ramsel
66,Bergstraat 71,2019-10-02,04:00:00,4,2,2,FMN GV 11 Ramsel
66,Bergstraat 71,2019-10-02,05:00:00,14,8,6,FMN GV 11 Ramsel
66,Bergstraat 71,2019-10-02,06:00:00,40,10,30,FMN GV 11 Ramsel
66,Bergstraat 71,2019-10-02,07:00:00,108,18,90,FMN GV 11 Ramsel
66,Bergstraat 71,2019-10-02,08:00:00,66,16,50,FMN GV 11 Ramsel
66,Bergstraat 71,2019-10-02,09:00:00,60,30,30,FMN GV 11 Ramsel
66,Bergstraat 71,2019-10-02,10:00:00,48,16,32,FMN GV 11 Ramsel
66,Bergstraat 71,2019-10-02,11:00:00,42,18,24,FMN GV 11 Ramsel
66,Bergstraat 71,2019-10-02,12:00:00,134,94,40,FMN GV 11 Ramsel
66,Bergstraat 71,2019-10-02,13:00:00,126,54,72,FMN GV 11 Ramsel
66,Bergstraat 71,2019-10-02,14:00:00,78,48,30,FMN GV 11 Ramsel
66,Bergstraat 71,2019-10-02,15:00:00,72,44,28,FMN GV 11 Ramsel
66,Bergstraat 71,2019-10-02,16:00:00,76,54,22,FMN GV 11 Ramsel
66,Bergstraat 71,2019-10-02,17:00:00,72,40,32,FMN GV 11 Ramsel
66,Bergstraat 71,2019-10-02,18:00:00,46,30,16,FMN GV 11 Ramsel
66,Bergstraat 71,2019-10-02,19:00:00,24,16,8,FMN GV 11 Ramsel
66,Bergstraat 71,2019-10-02,20:00:00,12,4,8,FMN GV 11 Ramsel
66,Bergstraat 71,2019-10-02,21:00:00,12,12,0,FMN GV 11 Ramsel
66,Bergstraat 71,2019-10-02,22:00:00,8,6,2,FMN GV 11 Ramsel
66,Bergstraat 71,2019-10-02,23:00:00,2,2,0,FMN GV 11 Ramsel
66,Bergstraat 71,2019-10-03,00:00:00,2,2,0,FMN GV 11 Ramsel
66,Bergstraat 71,2019-10-03,01:00:00,0,0,0,FMN GV 11 Ramsel
66,Bergstraat 71,2019-10-03,02:00:00,0,0,0,FMN GV 11 Ramsel
66,Bergstraat 71,2019-10-03,03:00:00,0,0,0,FMN GV 11 Ramsel
66,Bergstraat 71,2019-10-03,04:00:00,2,2,0,FMN GV 11 Ramsel
66,Bergstraat 71,2019-10-03,05:00:00,16,8,8,FMN GV 11 Ramsel
66,Bergstraat 71,2019-10-03,06:00:00,32,8,24,FMN GV 11 Ramsel
66,Bergstraat 71,2019-10-03,07:00:00,188,16,172,FMN GV 11 Ramsel
66,Bergstraat 71,2019-10-03,08:00:00,164,20,144,FMN GV 11 Ramsel
66,Bergstraat 71,2019-10-03,09:00:00,368,324,44,FMN GV 11 Ramsel
66,Bergstraat 71,2019-10-03,10:00:00,32,18,14,FMN GV 11 Ramsel
66,Bergstraat 71,2019-10-03,11:00:00,30,14,16,FMN GV 11 Ramsel
66,Bergstraat 71,2019-10-03,12:00:00,34,22,12,FMN GV 11 Ramsel
66,Bergstraat 71,2019-10-03,13:00:00,62,30,32,FMN GV 11 Ramsel
66,Bergstraat 71,2019-10-03,14:00:00,80,22,58,FMN GV 11 Ramsel
66,Bergstraat 71,2019-10-03,15:00:00,318,132,186,FMN GV 11 Ramsel
66,Bergstraat 71,2019-10-03,16:00:00,268,194,74,FMN GV 11 Ramsel
66,Bergstraat 71,2019-10-03,17:00:00,94,58,36,FMN GV 11 Ramsel
66,Bergstraat 71,2019-10-03,18:00:00,66,36,30,FMN GV 11 Ramsel
66,Bergstraat 71,2019-10-03,19:00:00,60,42,18,FMN GV 11 Ramsel
66,Bergstraat 71,2019-10-03,20:00:00,10,4,6,FMN GV 11 Ramsel
66,Bergstraat 71,2019-10-03,21:00:00,12,10,2,FMN GV 11 Ramsel
66,Bergstraat 71,2019-10-03,22:00:00,12,10,2,FMN GV 11 Ramsel
66,Bergstraat 71,2019-10-03,23:00:00,2,2,0,FMN GV 11 Ramsel
66,Bergstraat 71,2019-10-04,00:00:00,0,0,0,FMN GV 11 Ramsel
66,Bergstraat 71,2019-10-04,01:00:00,0,0,0,FMN GV 11 Ramsel
66,Bergstraat 71,2019-10-04,02:00:00,0,0,0,FMN GV 11 Ramsel
66,Bergstraat 71,2019-10-04,03:00:00,0,0,0,FMN GV 11 Ramsel
66,Bergstraat 71,2019-10-04,04:00:00,4,2,2,FMN GV 11 Ramsel
66,Bergstraat 71,2019-10-04,05:00:00,8,6,2,FMN GV 11 Ramsel
66,Bergstraat 71,2019-10-04,06:00:00,20,6,14,FMN GV 11 Ramsel
66,Bergstraat 71,2019-10-04,07:00:00,88,4,84,FMN GV 11 Ramsel
66,Bergstraat 71,2019-10-04,08:00:00,102,6,96,FMN GV 11 Ramsel
66,Bergstraat 71,2019-10-04,09:00:00,8,0,8,FMN GV 11 Ramsel
66,Bergstraat 71,2019-10-04,10:00:00,14,12,2,FMN GV 11 Ramsel
66,Bergstraat 71,2019-10-04,11:00:00,20,8,12,FMN GV 11 Ramsel
66,Bergstraat 71,2019-10-04,12:00:00,30,10,20,FMN GV 11 Ramsel
66,Bergstraat 71,2019-10-04,13:00:00,24,10,14,FMN GV 11 Ramsel
66,Bergstraat 71,2019-10-04,14:00:00,40,32,8,FMN GV 11 Ramsel
66,Bergstraat 71,2019-10-04,15:00:00,108,88,20,FMN GV 11 Ramsel
66,Bergstraat 71,2019-10-04,16:00:00,68,50,18,FMN GV 11 Ramsel
66,Bergstraat 71,2019-10-04,17:00:00,46,32,14,FMN GV 11 Ramsel
66,Bergstraat 71,2019-10-04,18:00:00,36,20,16,FMN GV 11 Ramsel
66,Bergstraat 71,2019-10-04,19:00:00,12,8,4,FMN GV 11 Ramsel
66,Bergstraat 71,2019-10-04,20:00:00,8,4,4,FMN GV 11 Ramsel
66,Bergstraat 71,2019-10-04,21:00:00,6,4,2,FMN GV 11 Ramsel
66,Bergstraat 71,2019-10-04,22:00:00,4,2,2,FMN GV 11 Ramsel
66,Bergstraat 71,2019-10-04,23:00:00,0,0,0,FMN GV 11 Ramsel
66,Bergstraat 71,2019-10-05,00:00:00,2,2,0,FMN GV 11 Ramsel
66,Bergstraat 71,2019-10-05,01:00:00,2,2,0,FMN GV 11 Ramsel
66,Bergstraat 71,2019-10-05,02:00:00,2,2,0,FMN GV 11 Ramsel
66,Bergstraat 71,2019-10-05,03:00:00,2,0,2,FMN GV 11 Ramsel
66,Bergstraat 71,2019-10-05,04:00:00,0,0,0,FMN GV 11 Ramsel
66,Bergstraat 71,2019-10-05,05:00:00,4,2,2,FMN GV 11 Ramsel
66,Bergstraat 71,2019-10-05,06:00:00,6,4,2,FMN GV 11 Ramsel
66,Bergstraat 71,2019-10-05,07:00:00,8,2,6,FMN GV 11 Ramsel
66,Bergstraat 71,2019-10-05,08:00:00,26,10,16,FMN GV 11 Ramsel
66,Bergstraat 71,2019-10-05,09:00:00,40,14,26,FMN GV 11 Ramsel
66,Bergstraat 71,2019-10-05,10:00:00,66,26,40,FMN GV 11 Ramsel
66,Bergstraat 71,2019-10-05,11:00:00,92,48,44,FMN GV 11 Ramsel
66,Bergstraat 71,2019-10-05,12:00:00,66,34,32,FMN GV 11 Ramsel
66,Bergstraat 71,2019-10-05,13:00:00,116,50,66,FMN GV 11 Ramsel
66,Bergstraat 71,2019-10-05,14:00:00,134,46,88,FMN GV 11 Ramsel
66,Bergstraat 71,2019-10-05,15:00:00,116,56,60,FMN GV 11 Ramsel
66,Bergstraat 71,2019-10-05,16:00:00,122,66,56,FMN GV 11 Ramsel
66,Bergstraat 71,2019-10-05,17:00:00,54,28,26,FMN GV 11 Ramsel
66,Bergstraat 71,2019-10-05,18:00:00,56,32,24,FMN GV 11 Ramsel
66,Bergstraat 71,2019-10-05,19:00:00,20,12,8,FMN GV 11 Ramsel
66,Bergstraat 71,2019-10-05,20:00:00,10,6,4,FMN GV 11 Ramsel
66,Bergstraat 71,2019-10-05,21:00:00,14,12,2,FMN GV 11 Ramsel
66,Bergstraat 71,2019-10-05,22:00:00,16,14,2,FMN GV 11 Ramsel
66,Bergstraat 71,2019-10-05,23:00:00,4,4,0,FMN GV 11 Ramsel
66,Bergstraat 71,2019-10-06,00:00:00,8,6,2,FMN GV 11 Ramsel
66,Bergstraat 71,2019-10-06,01:00:00,0,0,0,FMN GV 11 Ramsel
66,Bergstraat 71,2019-10-06,02:00:00,2,2,0,FMN GV 11 Ramsel
66,Bergstraat 71,2019-10-06,03:00:00,2,2,0,FMN GV 11 Ramsel
66,Bergstraat 71,2019-10-06,04:00:00,2,2,0,FMN GV 11 Ramsel
66,Bergstraat 71,2019-10-06,05:00:00,2,0,2,FMN GV 11 Ramsel
66,Bergstraat 71,2019-10-06,06:00:00,4,2,2,FMN GV 11 Ramsel
66,Bergstraat 71,2019-10-06,07:00:00,6,2,4,FMN GV 11 Ramsel
66,Bergstraat 71,2019-10-06,08:00:00,16,4,12,FMN GV 11 Ramsel
66,Bergstraat 71,2019-10-06,09:00:00,22,2,20,FMN GV 11 Ramsel
66,Bergstraat 71,2019-10-06,10:00:00,24,16,8,FMN GV 11 Ramsel
66,Bergstraat 71,2019-10-06,11:00:00,26,16,10,FMN GV 11 Ramsel
66,Bergstraat 71,2019-10-06,12:00:00,14,10,4,FMN GV 11 Ramsel
66,Bergstraat 71,2019-10-06,13:00:00,14,8,6,FMN GV 11 Ramsel
66,Bergstraat 71,2019-10-06,14:00:00,10,8,2,FMN GV 11 Ramsel
66,Bergstraat 71,2019-10-06,15:00:00,6,0,6,FMN GV 11 Ramsel
66,Bergstraat 71,2019-10-06,16:00:00,24,18,6,FMN GV 11 Ramsel
66,Bergstraat 71,2019-10-06,17:00:00,8,2,6,FMN GV 11 Ramsel
66,Bergstraat 71,2019-10-06,18:00:00,10,4,6,FMN GV 11 Ramsel
66,Bergstraat 71,2019-10-06,19:00:00,4,2,2,FMN GV 11 Ramsel
66,Bergstraat 71,2019-10-06,20:00:00,4,2,2,FMN GV 11 Ramsel
66,Bergstraat 71,2019-10-06,21:00:00,0,0,0,FMN GV 11 Ramsel
66,Bergstraat 71,2019-10-06,22:00:00,6,4,2,FMN GV 11 Ramsel
66,Bergstraat 71,2019-10-06,23:00:00,4,4,0,FMN GV 11 Ramsel
66,Bergstraat 71,2019-10-07,00:00:00,0,0,0,FMN GV 11 Ramsel
66,Bergstraat 71,2019-10-07,01:00:00,0,0,0,FMN GV 11 Ramsel
66,Bergstraat 71,2019-10-07,02:00:00,0,0,0,FMN GV 11 Ramsel
66,Bergstraat 71,2019-10-07,03:00:00,0,0,0,FMN GV 11 Ramsel
66,Bergstraat 71,2019-10-07,04:00:00,2,2,0,FMN GV 11 Ramsel
66,Bergstraat 71,2019-10-07,05:00:00,14,6,8,FMN GV 11 Ramsel
66,Bergstraat 71,2019-10-07,06:00:00,42,10,32,FMN GV 11 Ramsel
66,Bergstraat 71,2019-10-07,07:00:00,150,8,142,FMN GV 11 Ramsel
66,Bergstraat 71,2019-10-07,08:00:00,128,6,122,FMN GV 11 Ramsel
66,Bergstraat 71,2019-10-07,09:00:00,68,28,40,FMN GV 11 Ramsel
66,Bergstraat 71,2019-10-07,10:00:00,62,30,32,FMN GV 11 Ramsel
66,Bergstraat 71,2019-10-07,11:00:00,56,30,26,FMN GV 11 Ramsel
66,Bergstraat 71,2019-10-07,12:00:00,106,58,48,FMN GV 11 Ramsel
66,Bergstraat 71,2019-10-07,13:00:00,126,74,52,FMN GV 11 Ramsel
66,Bergstraat 71,2019-10-07,14:00:00,120,72,48,FMN GV 11 Ramsel
66,Bergstraat 71,2019-10-07,15:00:00,220,196,24,FMN GV 11 Ramsel
66,Bergstraat 71,2019-10-07,16:00:00,168,124,44,FMN GV 11 Ramsel
66,Bergstraat 71,2019-10-07,17:00:00,98,58,40,FMN GV 11 Ramsel
66,Bergstraat 71,2019-10-07,18:00:00,80,54,26,FMN GV 11 Ramsel
66,Bergstraat 71,2019-10-07,19:00:00,52,36,16,FMN GV 11 Ramsel
66,Bergstraat 71,2019-10-07,20:00:00,10,6,4,FMN GV 11 Ramsel
66,Bergstraat 71,2019-10-07,21:00:00,18,10,8,FMN GV 11 Ramsel
66,Bergstraat 71,2019-10-07,22:00:00,10,2,8,FMN GV 11 Ramsel
66,Bergstraat 71,2019-10-07,23:00:00,4,4,0,FMN GV 11 Ramsel
66,Bergstraat 71,2019-10-08,00:00:00,2,2,0,FMN GV 11 Ramsel
66,Bergstraat 71,2019-10-08,01:00:00,0,0,0,FMN GV 11 Ramsel
66,Bergstraat 71,2019-10-08,02:00:00,0,0,0,FMN GV 11 Ramsel
66,Bergstraat 71,2019-10-08,03:00:00,0,0,0,FMN GV 11 Ramsel
66,Bergstraat 71,2019-10-08,04:00:00,2,2,0,FMN GV 11 Ramsel
66,Bergstraat 71,2019-10-08,05:00:00,8,2,6,FMN GV 11 Ramsel
66,Bergstraat 71,2019-10-08,06:00:00,34,2,32,FMN GV 11 Ramsel
66,Bergstraat 71,2019-10-08,07:00:00,124,14,110,FMN GV 11 Ramsel
66,Bergstraat 71,2019-10-08,08:00:00,90,2,88,FMN GV 11 Ramsel
66,Bergstraat 71,2019-10-08,09:00:00,18,4,14,FMN GV 11 Ramsel
66,Bergstraat 71,2019-10-08,10:00:00,8,2,6,FMN GV 11 Ramsel
66,Bergstraat 71,2019-10-08,11:00:00,10,4,6,FMN GV 11 Ramsel
66,Bergstraat 71,2019-10-08,12:00:00,36,14,22,FMN GV 11 Ramsel
66,Bergstraat 71,2019-10-08,13:00:00,86,34,52,FMN GV 11 Ramsel
66,Bergstraat 71,2019-10-08,14:00:00,50,32,18,FMN GV 11 Ramsel
66,Bergstraat 71,2019-10-08,15:00:00,150,124,26,FMN GV 11 Ramsel
66,Bergstraat 71,2019-10-08,16:00:00,120,100,20,FMN GV 11 Ramsel
66,Bergstraat 71,2019-10-08,17:00:00,90,60,30,FMN GV 11 Ramsel
66,Bergstraat 71,2019-10-08,18:00:00,54,34,20,FMN GV 11 Ramsel
66,Bergstraat 71,2019-10-08,19:00:00,44,24,20,FMN GV 11 Ramsel
66,Bergstraat 71,2019-10-08,20:00:00,22,18,4,FMN GV 11 Ramsel
66,Bergstraat 71,2019-10-08,21:00:00,12,10,2,FMN GV 11 Ramsel
66,Bergstraat 71,2019-10-08,22:00:00,10,8,2,FMN GV 11 Ramsel
66,Bergstraat 71,2019-10-08,23:00:00,4,2,2,FMN GV 11 Ramsel
66,Bergstraat 71,2019-10-09,00:00:00,0,0,0,FMN GV 11 Ramsel
66,Bergstraat 71,2019-10-09,01:00:00,0,0,0,FMN GV 11 Ramsel
66,Bergstraat 71,2019-10-09,02:00:00,0,0,0,FMN GV 11 Ramsel
66,Bergstraat 71,2019-10-09,03:00:00,0,0,0,FMN GV 11 Ramsel
66,Bergstraat 71,2019-10-09,04:00:00,2,2,0,FMN GV 11 Ramsel
66,Bergstraat 71,2019-10-09,05:00:00,6,2,4,FMN GV 11 Ramsel
66,Bergstraat 71,2019-10-09,06:00:00,50,8,42,FMN GV 11 Ramsel
66,Bergstraat 71,2019-10-09,07:00:00,170,6,164,FMN GV 11 Ramsel
66,Bergstraat 71,2019-10-09,08:00:00,110,8,102,FMN GV 11 Ramsel
66,Bergstraat 71,2019-10-09,09:00:00,40,18,22,FMN GV 11 Ramsel
66,Bergstraat 71,2019-10-09,10:00:00,34,14,20,FMN GV 11 Ramsel
66,Bergstraat 71,2019-10-09,11:00:00,26,16,10,FMN GV 11 Ramsel
66,Bergstraat 71,2019-10-09,12:00:00,148,142,6,FMN GV 11 Ramsel
66,Bergstraat 71,2019-10-09,13:00:00,38,32,6,FMN GV 11 Ramsel
66,Bergstraat 71,2019-10-09,14:00:00,36,16,20,FMN GV 11 Ramsel
66,Bergstraat 71,2019-10-09,15:00:00,44,22,22,FMN GV 11 Ramsel
66,Bergstraat 71,2019-10-09,16:00:00,86,64,22,FMN GV 11 Ramsel
66,Bergstraat 71,2019-10-09,17:00:00,70,48,22,FMN GV 11 Ramsel
66,Bergstraat 71,2019-10-09,18:00:00,64,38,26,FMN GV 11 Ramsel
66,Bergstraat 71,2019-10-09,19:00:00,32,24,8,FMN GV 11 Ramsel
66,Bergstraat 71,2019-10-09,20:00:00,18,10,8,FMN GV 11 Ramsel
66,Bergstraat 71,2019-10-09,21:00:00,10,6,4,FMN GV 11 Ramsel
66,Bergstraat 71,2019-10-09,22:00:00,2,0,2,FMN GV 11 Ramsel
66,Bergstraat 71,2019-10-09,23:00:00,0,0,0,FMN GV 11 Ramsel
66,Bergstraat 71,2019-10-10,00:00:00,2,2,0,FMN GV 11 Ramsel
66,Bergstraat 71,2019-10-10,01:00:00,4,4,0,FMN GV 11 Ramsel
66,Bergstraat 71,2019-10-10,02:00:00,0,0,0,FMN GV 11 Ramsel
66,Bergstraat 71,2019-10-10,03:00:00,0,0,0,FMN GV 11 Ramsel
66,Bergstraat 71,2019-10-10,04:00:00,2,2,0,FMN GV 11 Ramsel
66,Bergstraat 71,2019-10-10,05:00:00,12,4,8,FMN GV 11 Ramsel
66,Bergstraat 71,2019-10-10,06:00:00,50,8,42,FMN GV 11 Ramsel
66,Bergstraat 71,2019-10-10,07:00:00,192,12,180,FMN GV 11 Ramsel
66,Bergstraat 71,2019-10-10,08:00:00,146,14,132,FMN GV 11 Ramsel
66,Bergstraat 71,2019-10-10,09:00:00,56,24,32,FMN GV 11 Ramsel
66,Bergstraat 71,2019-10-10,10:00:00,52,18,34,FMN GV 11 Ramsel
66,Bergstraat 71,2019-10-10,11:00:00,38,26,12,FMN GV 11 Ramsel
66,Bergstraat 71,2019-10-10,12:00:00,50,30,20,FMN GV 11 Ramsel
66,Bergstraat 71,2019-10-10,13:00:00,100,56,44,FMN GV 11 Ramsel
66,Bergstraat 71,2019-10-10,14:00:00,130,78,52,FMN GV 11 Ramsel
66,Bergstraat 71,2019-10-10,15:00:00,214,174,40,FMN GV 11 Ramsel
66,Bergstraat 71,2019-10-10,16:00:00,164,140,24,FMN GV 11 Ramsel
66,Bergstraat 71,2019-10-10,17:00:00,88,70,18,FMN GV 11 Ramsel
66,Bergstraat 71,2019-10-10,18:00:00,74,44,30,FMN GV 11 Ramsel
66,Bergstraat 71,2019-10-10,19:00:00,44,24,20,FMN GV 11 Ramsel
66,Bergstraat 71,2019-10-10,20:00:00,22,16,6,FMN GV 11 Ramsel
66,Bergstraat 71,2019-10-10,21:00:00,14,12,2,FMN GV 11 Ramsel
66,Bergstraat 71,2019-10-10,22:00:00,20,12,8,FMN GV 11 Ramsel
66,Bergstraat 71,2019-10-10,23:00:00,2,2,0,FMN GV 11 Ramsel
66,Bergstraat 71,2019-10-11,00:00:00,2,2,0,FMN GV 11 Ramsel
66,Bergstraat 71,2019-10-11,01:00:00,0,0,0,FMN GV 11 Ramsel
66,Bergstraat 71,2019-10-11,02:00:00,0,0,0,FMN GV 11 Ramsel
66,Bergstraat 71,2019-10-11,03:00:00,0,0,0,FMN GV 11 Ramsel
66,Bergstraat 71,2019-10-11,04:00:00,4,4,0,FMN GV 11 Ramsel
66,Bergstraat 71,2019-10-11,05:00:00,6,2,4,FMN GV 11 Ramsel
66,Bergstraat 71,2019-10-11,06:00:00,26,4,22,FMN GV 11 Ramsel
66,Bergstraat 71,2019-10-11,07:00:00,184,12,172,FMN GV 11 Ramsel
66,Bergstraat 71,2019-10-11,08:00:00,158,12,146,FMN GV 11 Ramsel
66,Bergstraat 71,2019-10-11,09:00:00,42,14,28,FMN GV 11 Ramsel
66,Bergstraat 71,2019-10-11,10:00:00,36,26,10,FMN GV 11 Ramsel
66,Bergstraat 71,2019-10-11,11:00:00,22,12,10,FMN GV 11 Ramsel
66,Bergstraat 71,2019-10-11,12:00:00,38,10,28,FMN GV 11 Ramsel
66,Bergstraat 71,2019-10-11,13:00:00,44,24,20,FMN GV 11 Ramsel
66,Bergstraat 71,2019-10-11,14:00:00,82,56,26,FMN GV 11 Ramsel
66,Bergstraat 71,2019-10-11,15:00:00,270,222,48,FMN GV 11 Ramsel
66,Bergstraat 71,2019-10-11,16:00:00,94,80,14,FMN GV 11 Ramsel
66,Bergstraat 71,2019-10-11,17:00:00,72,46,26,FMN GV 11 Ramsel
66,Bergstraat 71,2019-10-11,18:00:00,50,36,14,FMN GV 11 Ramsel
66,Bergstraat 71,2019-10-11,19:00:00,40,22,18,FMN GV 11 Ramsel
66,Bergstraat 71,2019-10-11,20:00:00,16,6,10,FMN GV 11 Ramsel
66,Bergstraat 71,2019-10-11,21:00:00,36,26,10,FMN GV 11 Ramsel
66,Bergstraat 71,2019-10-11,22:00:00,14,8,6,FMN GV 11 Ramsel
66,Bergstraat 71,2019-10-11,23:00:00,6,2,4,FMN GV 11 Ramsel
66,Bergstraat 71,2019-10-12,00:00:00,6,4,2,FMN GV 11 Ramsel
66,Bergstraat 71,2019-10-12,01:00:00,0,0,0,FMN GV 11 Ramsel
66,Bergstraat 71,2019-10-12,02:00:00,14,14,0,FMN GV 11 Ramsel
66,Bergstraat 71,2019-10-12,03:00:00,6,4,2,FMN GV 11 Ramsel
66,Bergstraat 71,2019-10-12,04:00:00,2,2,0,FMN GV 11 Ramsel
66,Bergstraat 71,2019-10-12,05:00:00,2,2,0,FMN GV 11 Ramsel
66,Bergstraat 71,2019-10-12,06:00:00,2,2,0,FMN GV 11 Ramsel
66,Bergstraat 71,2019-10-12,07:00:00,12,4,8,FMN GV 11 Ramsel
66,Bergstraat 71,2019-10-12,08:00:00,22,10,12,FMN GV 11 Ramsel
66,Bergstraat 71,2019-10-12,09:00:00,58,22,36,FMN GV 11 Ramsel
66,Bergstraat 71,2019-10-12,10:00:00,92,40,52,FMN GV 11 Ramsel
66,Bergstraat 71,2019-10-12,11:00:00,132,62,70,FMN GV 11 Ramsel
66,Bergstraat 71,2019-10-12,12:00:00,102,46,56,FMN GV 11 Ramsel
66,Bergstraat 71,2019-10-12,13:00:00,138,66,72,FMN GV 11 Ramsel
66,Bergstraat 71,2019-10-12,14:00:00,236,104,132,FMN GV 11 Ramsel
66,Bergstraat 71,2019-10-12,15:00:00,142,98,44,FMN GV 11 Ramsel
66,Bergstraat 71,2019-10-12,16:00:00,88,50,38,FMN GV 11 Ramsel
66,Bergstraat 71,2019-10-12,17:00:00,80,44,36,FMN GV 11 Ramsel
66,Bergstraat 71,2019-10-12,18:00:00,50,24,26,FMN GV 11 Ramsel
66,Bergstraat 71,2019-10-12,19:00:00,58,30,28,FMN GV 11 Ramsel
66,Bergstraat 71,2019-10-12,20:00:00,10,2,8,FMN GV 11 Ramsel
66,Bergstraat 71,2019-10-12,21:00:00,8,6,2,FMN GV 11 Ramsel
66,Bergstraat 71,2019-10-12,22:00:00,10,6,4,FMN GV 11 Ramsel
66,Bergstraat 71,2019-10-12,23:00:00,4,4,0,FMN GV 11 Ramsel
66,Bergstraat 71,2019-10-13,00:00:00,6,2,4,FMN GV 11 Ramsel
66,Bergstraat 71,2019-10-13,01:00:00,44,40,4,FMN GV 11 Ramsel
66,Bergstraat 71,2019-10-13,02:00:00,8,4,4,FMN GV 11 Ramsel
66,Bergstraat 71,2019-10-13,03:00:00,2,0,2,FMN GV 11 Ramsel
66,Bergstraat 71,2019-10-13,04:00:00,4,0,4,FMN GV 11 Ramsel
66,Bergstraat 71,2019-10-13,05:00:00,16,4,12,FMN GV 11 Ramsel
66,Bergstraat 71,2019-10-13,06:00:00,2,0,2,FMN GV 11 Ramsel
66,Bergstraat 71,2019-10-13,07:00:00,18,2,16,FMN GV 11 Ramsel
66,Bergstraat 71,2019-10-13,08:00:00,56,18,38,FMN GV 11 Ramsel
66,Bergstraat 71,2019-10-13,09:00:00,64,16,48,FMN GV 11 Ramsel
66,Bergstraat 71,2019-10-13,10:00:00,126,78,48,FMN GV 11 Ramsel
66,Bergstraat 71,2019-10-13,11:00:00,194,106,88,FMN GV 11 Ramsel
66,Bergstraat 71,2019-10-13,12:00:00,122,68,54,FMN GV 11 Ramsel
66,Bergstraat 71,2019-10-13,13:00:00,192,102,90,FMN GV 11 Ramsel
66,Bergstraat 71,2019-10-13,14:00:00,262,124,138,FMN GV 11 Ramsel
66,Bergstraat 71,2019-10-13,15:00:00,162,108,54,FMN GV 11 Ramsel
66,Bergstraat 71,2019-10-13,16:00:00,148,86,62,FMN GV 11 Ramsel
66,Bergstraat 71,2019-10-13,17:00:00,78,46,32,FMN GV 11 Ramsel
66,Bergstraat 71,2019-10-13,18:00:00,54,28,26,FMN GV 11 Ramsel
66,Bergstraat 71,2019-10-13,19:00:00,18,14,4,FMN GV 11 Ramsel
66,Bergstraat 71,2019-10-13,20:00:00,4,2,2,FMN GV 11 Ramsel
66,Bergstraat 71,2019-10-13,21:00:00,4,2,2,FMN GV 11 Ramsel
66,Bergstraat 71,2019-10-13,22:00:00,10,6,4,FMN GV 11 Ramsel
66,Bergstraat 71,2019-10-13,23:00:00,2,2,0,FMN GV 11 Ramsel
66,Bergstraat 71,2019-10-14,00:00:00,0,0,0,FMN GV 11 Ramsel
66,Bergstraat 71,2019-10-14,01:00:00,0,0,0,FMN GV 11 Ramsel
66,Bergstraat 71,2019-10-14,02:00:00,2,0,2,FMN GV 11 Ramsel
66,Bergstraat 71,2019-10-14,03:00:00,0,0,0,FMN GV 11 Ramsel
66,Bergstraat 71,2019-10-14,04:00:00,2,2,0,FMN GV 11 Ramsel
66,Bergstraat 71,2019-10-14,05:00:00,14,6,8,FMN GV 11 Ramsel
66,Bergstraat 71,2019-10-14,06:00:00,50,10,40,FMN GV 11 Ramsel
66,Bergstraat 71,2019-10-14,07:00:00,198,22,176,FMN GV 11 Ramsel
66,Bergstraat 71,2019-10-14,08:00:00,182,14,168,FMN GV 11 Ramsel
66,Bergstraat 71,2019-10-14,09:00:00,52,28,24,FMN GV 11 Ramsel
66,Bergstraat 71,2019-10-14,10:00:00,42,26,16,FMN GV 11 Ramsel
66,Bergstraat 71,2019-10-14,11:00:00,32,14,18,FMN GV 11 Ramsel
66,Bergstraat 71,2019-10-14,12:00:00,70,42,28,FMN GV 11 Ramsel
66,Bergstraat 71,2019-10-14,13:00:00,142,52,90,FMN GV 11 Ramsel
66,Bergstraat 71,2019-10-14,14:00:00,152,80,72,FMN GV 11 Ramsel
66,Bergstraat 71,2019-10-14,15:00:00,370,258,112,FMN GV 11 Ramsel
66,Bergstraat 71,2019-10-14,16:00:00,266,182,84,FMN GV 11 Ramsel
66,Bergstraat 71,2019-10-14,17:00:00,86,60,26,FMN GV 11 Ramsel
66,Bergstraat 71,2019-10-14,18:00:00,74,42,32,FMN GV 11 Ramsel
66,Bergstraat 71,2019-10-14,19:00:00,32,22,10,FMN GV 11 Ramsel
66,Bergstraat 71,2019-10-14,20:00:00,18,12,6,FMN GV 11 Ramsel
66,Bergstraat 71,2019-10-14,21:00:00,16,12,4,FMN GV 11 Ramsel
66,Bergstraat 71,2019-10-14,22:00:00,10,8,2,FMN GV 11 Ramsel
66,Bergstraat 71,2019-10-14,23:00:00,4,4,0,FMN GV 11 Ramsel
66,Bergstraat 71,2019-10-15,00:00:00,2,0,2,FMN GV 11 Ramsel
66,Bergstraat 71,2019-10-15,01:00:00,0,0,0,FMN GV 11 Ramsel
66,Bergstraat 71,2019-10-15,02:00:00,0,0,0,FMN GV 11 Ramsel
66,Bergstraat 71,2019-10-15,03:00:00,0,0,0,FMN GV 11 Ramsel
66,Bergstraat 71,2019-10-15,04:00:00,4,4,0,FMN GV 11 Ramsel
66,Bergstraat 71,2019-10-15,05:00:00,12,6,6,FMN GV 11 Ramsel
66,Bergstraat 71,2019-10-15,06:00:00,30,2,28,FMN GV 11 Ramsel
66,Bergstraat 71,2019-10-15,07:00:00,108,10,98,FMN GV 11 Ramsel
66,Bergstraat 71,2019-10-15,08:00:00,120,4,116,FMN GV 11 Ramsel
66,Bergstraat 71,2019-10-15,09:00:00,18,10,8,FMN GV 11 Ramsel
66,Bergstraat 71,2019-10-15,10:00:00,14,6,8,FMN GV 11 Ramsel
66,Bergstraat 71,2019-10-15,11:00:00,10,8,2,FMN GV 11 Ramsel
66,Bergstraat 71,2019-10-15,12:00:00,54,16,38,FMN GV 11 Ramsel
66,Bergstraat 71,2019-10-15,13:00:00,122,60,62,FMN GV 11 Ramsel
66,Bergstraat 71,2019-10-15,14:00:00,70,36,34,FMN GV 11 Ramsel
66,Bergstraat 71,2019-10-15,15:00:00,158,134,24,FMN GV 11 Ramsel
66,Bergstraat 71,2019-10-15,16:00:00,90,68,22,FMN GV 11 Ramsel
66,Bergstraat 71,2019-10-15,17:00:00,84,46,38,FMN GV 11 Ramsel
66,Bergstraat 71,2019-10-15,18:00:00,48,28,20,FMN GV 11 Ramsel
66,Bergstraat 71,2019-10-15,19:00:00,58,30,28,FMN GV 11 Ramsel
66,Bergstraat 71,2019-10-15,20:00:00,32,32,0,FMN GV 11 Ramsel
66,Bergstraat 71,2019-10-15,21:00:00,12,8,4,FMN GV 11 Ramsel
66,Bergstraat 71,2019-10-15,22:00:00,8,4,4,FMN GV 11 Ramsel
66,Bergstraat 71,2019-10-15,23:00:00,2,2,0,FMN GV 11 Ramsel
66,Bergstraat 71,2019-10-16,00:00:00,0,0,0,FMN GV 11 Ramsel
66,Bergstraat 71,2019-10-16,01:00:00,2,0,2,FMN GV 11 Ramsel
66,Bergstraat 71,2019-10-16,02:00:00,0,0,0,FMN GV 11 Ramsel
66,Bergstraat 71,2019-10-16,03:00:00,0,0,0,FMN GV 11 Ramsel
66,Bergstraat 71,2019-10-16,04:00:00,4,2,2,FMN GV 11 Ramsel
66,Bergstraat 71,2019-10-16,05:00:00,14,6,8,FMN GV 11 Ramsel
66,Bergstraat 71,2019-10-16,06:00:00,30,4,26,FMN GV 11 Ramsel
66,Bergstraat 71,2019-10-16,07:00:00,140,6,134,FMN GV 11 Ramsel
66,Bergstraat 71,2019-10-16,08:00:00,152,12,140,FMN GV 11 Ramsel
66,Bergstraat 71,2019-10-16,09:00:00,44,8,36,FMN GV 11 Ramsel
66,Bergstraat 71,2019-10-16,10:00:00,42,18,24,FMN GV 11 Ramsel
66,Bergstraat 71,2019-10-16,11:00:00,34,26,8,FMN GV 11 Ramsel
66,Bergstraat 71,2019-10-16,12:00:00,208,188,20,FMN GV 11 Ramsel
66,Bergstraat 71,2019-10-16,13:00:00,44,38,6,FMN GV 11 Ramsel
66,Bergstraat 71,2019-10-16,14:00:00,36,14,22,FMN GV 11 Ramsel
66,Bergstraat 71,2019-10-16,15:00:00,32,10,22,FMN GV 11 Ramsel
66,Bergstraat 71,2019-10-16,16:00:00,68,54,14,FMN GV 11 Ramsel
66,Bergstraat 71,2019-10-16,17:00:00,42,34,8,FMN GV 11 Ramsel
66,Bergstraat 71,2019-10-16,18:00:00,40,24,16,FMN GV 11 Ramsel
66,Bergstraat 71,2019-10-16,19:00:00,14,12,2,FMN GV 11 Ramsel
66,Bergstraat 71,2019-10-16,20:00:00,4,4,0,FMN GV 11 Ramsel
66,Bergstraat 71,2019-10-16,21:00:00,4,4,0,FMN GV 11 Ramsel
66,Bergstraat 71,2019-10-16,22:00:00,6,4,2,FMN GV 11 Ramsel
66,Bergstraat 71,2019-10-16,23:00:00,0,0,0,FMN GV 11 Ramsel
66,Bergstraat 71,2019-10-17,00:00:00,2,2,0,FMN GV 11 Ramsel
66,Bergstraat 71,2019-10-17,01:00:00,0,0,0,FMN GV 11 Ramsel
66,Bergstraat 71,2019-10-17,02:00:00,0,0,0,FMN GV 11 Ramsel
66,Bergstraat 71,2019-10-17,03:00:00,0,0,0,FMN GV 11 Ramsel
66,Bergstraat 71,2019-10-17,04:00:00,4,4,0,FMN GV 11 Ramsel
66,Bergstraat 71,2019-10-17,05:00:00,12,6,6,FMN GV 11 Ramsel
66,Bergstraat 71,2019-10-17,06:00:00,40,4,36,FMN GV 11 Ramsel
66,Bergstraat 71,2019-10-17,07:00:00,168,12,156,FMN GV 11 Ramsel
66,Bergstraat 71,2019-10-17,08:00:00,138,10,128,FMN GV 11 Ramsel
66,Bergstraat 71,2019-10-17,09:00:00,40,14,26,FMN GV 11 Ramsel
66,Bergstraat 71,2019-10-17,10:00:00,62,18,44,FMN GV 11 Ramsel
66,Bergstraat 71,2019-10-17,11:00:00,70,34,36,FMN GV 11 Ramsel
66,Bergstraat 71,2019-10-17,12:00:00,74,46,28,FMN GV 11 Ramsel
66,Bergstraat 71,2019-10-17,13:00:00,92,46,46,FMN GV 11 Ramsel
66,Bergstraat 71,2019-10-17,14:00:00,132,74,58,FMN GV 11 Ramsel
66,Bergstraat 71,2019-10-17,15:00:00,226,180,46,FMN GV 11 Ramsel
66,Bergstraat 71,2019-10-17,16:00:00,180,158,22,FMN GV 11 Ramsel
66,Bergstraat 71,2019-10-17,17:00:00,86,54,32,FMN GV 11 Ramsel
66,Bergstraat 71,2019-10-17,18:00:00,76,46,30,FMN GV 11 Ramsel
66,Bergstraat 71,2019-10-17,19:00:00,44,26,18,FMN GV 11 Ramsel
66,Bergstraat 71,2019-10-17,20:00:00,16,14,2,FMN GV 11 Ramsel
66,Bergstraat 71,2019-10-17,21:00:00,10,10,0,FMN GV 11 Ramsel
66,Bergstraat 71,2019-10-17,22:00:00,16,6,10,FMN GV 11 Ramsel
66,Bergstraat 71,2019-10-17,23:00:00,2,2,0,FMN GV 11 Ramsel
66,Bergstraat 71,2019-10-18,00:00:00,0,0,0,FMN GV 11 Ramsel
66,Bergstraat 71,2019-10-18,01:00:00,2,2,0,FMN GV 11 Ramsel
66,Bergstraat 71,2019-10-18,02:00:00,0,0,0,FMN GV 11 Ramsel
66,Bergstraat 71,2019-10-18,03:00:00,0,0,0,FMN GV 11 Ramsel
66,Bergstraat 71,2019-10-18,04:00:00,2,2,0,FMN GV 11 Ramsel
66,Bergstraat 71,2019-10-18,05:00:00,12,8,4,FMN GV 11 Ramsel
66,Bergstraat 71,2019-10-18,06:00:00,30,2,28,FMN GV 11 Ramsel
66,Bergstraat 71,2019-10-18,07:00:00,236,14,222,FMN GV 11 Ramsel
66,Bergstraat 71,2019-10-18,08:00:00,114,22,92,FMN GV 11 Ramsel
66,Bergstraat 71,2019-10-18,09:00:00,24,8,16,FMN GV 11 Ramsel
66,Bergstraat 71,2019-10-18,10:00:00,28,22,6,FMN GV 11 Ramsel
66,Bergstraat 71,2019-10-18,11:00:00,28,20,8,FMN GV 11 Ramsel
66,Bergstraat 71,2019-10-18,12:00:00,42,22,20,FMN GV 11 Ramsel
66,Bergstraat 71,2019-10-18,13:00:00,30,14,16,FMN GV 11 Ramsel
66,Bergstraat 71,2019-10-18,14:00:00,58,32,26,FMN GV 11 Ramsel
66,Bergstraat 71,2019-10-18,15:00:00,184,144,40,FMN GV 11 Ramsel
66,Bergstraat 71,2019-10-18,16:00:00,120,92,28,FMN GV 11 Ramsel
66,Bergstraat 71,2019-10-18,17:00:00,82,68,14,FMN GV 11 Ramsel
66,Bergstraat 71,2019-10-18,18:00:00,64,32,32,FMN GV 11 Ramsel
66,Bergstraat 71,2019-10-18,19:00:00,26,10,16,FMN GV 11 Ramsel
66,Bergstraat 71,2019-10-18,20:00:00,16,12,4,FMN GV 11 Ramsel
66,Bergstraat 71,2019-10-18,21:00:00,16,2,14,FMN GV 11 Ramsel
66,Bergstraat 71,2019-10-18,22:00:00,10,4,6,FMN GV 11 Ramsel
66,Bergstraat 71,2019-10-18,23:00:00,0,0,0,FMN GV 11 Ramsel
66,Bergstraat 71,2019-10-19,00:00:00,4,4,0,FMN GV 11 Ramsel
66,Bergstraat 71,2019-10-19,01:00:00,10,4,6,FMN GV 11 Ramsel
66,Bergstraat 71,2019-10-19,02:00:00,4,4,0,FMN GV 11 Ramsel
66,Bergstraat 71,2019-10-19,03:00:00,6,6,0,FMN GV 11 Ramsel
66,Bergstraat 71,2019-10-19,04:00:00,8,8,0,FMN GV 11 Ramsel
66,Bergstraat 71,2019-10-19,05:00:00,6,4,2,FMN GV 11 Ramsel
66,Bergstraat 71,2019-10-19,06:00:00,4,2,2,FMN GV 11 Ramsel
66,Bergstraat 71,2019-10-19,07:00:00,10,4,6,FMN GV 11 Ramsel
66,Bergstraat 71,2019-10-19,08:00:00,22,8,14,FMN GV 11 Ramsel
66,Bergstraat 71,2019-10-19,09:00:00,24,10,14,FMN GV 11 Ramsel
66,Bergstraat 71,2019-10-19,10:00:00,42,24,18,FMN GV 11 Ramsel
66,Bergstraat 71,2019-10-19,11:00:00,22,6,16,FMN GV 11 Ramsel
66,Bergstraat 71,2019-10-19,12:00:00,54,24,30,FMN GV 11 Ramsel
66,Bergstraat 71,2019-10-19,13:00:00,64,28,36,FMN GV 11 Ramsel
66,Bergstraat 71,2019-10-19,14:00:00,68,34,34,FMN GV 11 Ramsel
66,Bergstraat 71,2019-10-19,15:00:00,96,42,54,FMN GV 11 Ramsel
66,Bergstraat 71,2019-10-19,16:00:00,86,44,42,FMN GV 11 Ramsel
66,Bergstraat 71,2019-10-19,17:00:00,76,48,28,FMN GV 11 Ramsel
66,Bergstraat 71,2019-10-19,18:00:00,34,20,14,FMN GV 11 Ramsel
66,Bergstraat 71,2019-10-19,19:00:00,16,6,10,FMN GV 11 Ramsel
66,Bergstraat 71,2019-10-19,20:00:00,12,6,6,FMN GV 11 Ramsel
66,Bergstraat 71,2019-10-19,21:00:00,8,2,6,FMN GV 11 Ramsel
66,Bergstraat 71,2019-10-19,22:00:00,4,2,2,FMN GV 11 Ramsel
66,Bergstraat 71,2019-10-19,23:00:00,2,2,0,FMN GV 11 Ramsel
66,Bergstraat 71,2019-10-20,00:00:00,4,2,2,FMN GV 11 Ramsel
66,Bergstraat 71,2019-10-20,01:00:00,4,4,0,FMN GV 11 Ramsel
66,Bergstraat 71,2019-10-20,02:00:00,2,2,0,FMN GV 11 Ramsel
66,Bergstraat 71,2019-10-20,03:00:00,2,2,0,FMN GV 11 Ramsel
66,Bergstraat 71,2019-10-20,04:00:00,2,2,0,FMN GV 11 Ramsel
66,Bergstraat 71,2019-10-20,05:00:00,2,2,0,FMN GV 11 Ramsel
66,Bergstraat 71,2019-10-20,06:00:00,4,4,0,FMN GV 11 Ramsel
66,Bergstraat 71,2019-10-20,07:00:00,48,4,44,FMN GV 11 Ramsel
66,Bergstraat 71,2019-10-20,08:00:00,106,28,78,FMN GV 11 Ramsel
66,Bergstraat 71,2019-10-20,09:00:00,106,18,88,FMN GV 11 Ramsel
66,Bergstraat 71,2019-10-20,10:00:00,78,50,28,FMN GV 11 Ramsel
66,Bergstraat 71,2019-10-20,11:00:00,90,84,6,FMN GV 11 Ramsel
66,Bergstraat 71,2019-10-20,12:00:00,68,28,40,FMN GV 11 Ramsel
66,Bergstraat 71,2019-10-20,13:00:00,22,14,8,FMN GV 11 Ramsel
66,Bergstraat 71,2019-10-20,14:00:00,26,16,10,FMN GV 11 Ramsel
66,Bergstraat 71,2019-10-20,15:00:00,12,2,10,FMN GV 11 Ramsel
66,Bergstraat 71,2019-10-20,16:00:00,16,10,6,FMN GV 11 Ramsel
66,Bergstraat 71,2019-10-20,17:00:00,22,10,12,FMN GV 11 Ramsel
66,Bergstraat 71,2019-10-20,18:00:00,10,0,10,FMN GV 11 Ramsel
66,Bergstraat 71,2019-10-20,19:00:00,2,0,2,FMN GV 11 Ramsel
66,Bergstraat 71,2019-10-20,20:00:00,2,0,2,FMN GV 11 Ramsel
66,Bergstraat 71,2019-10-20,21:00:00,0,0,0,FMN GV 11 Ramsel
66,Bergstraat 71,2019-10-20,22:00:00,0,0,0,FMN GV 11 Ramsel
66,Bergstraat 71,2019-10-20,23:00:00,0,0,0,FMN GV 11 Ramsel
66,Bergstraat 71,2019-10-21,00:00:00,0,0,0,FMN GV 11 Ramsel
66,Bergstraat 71,2019-10-21,01:00:00,0,0,0,FMN GV 11 Ramsel
66,Bergstraat 71,2019-10-21,02:00:00,0,0,0,FMN GV 11 Ramsel
66,Bergstraat 71,2019-10-21,03:00:00,0,0,0,FMN GV 11 Ramsel
66,Bergstraat 71,2019-10-21,04:00:00,2,2,0,FMN GV 11 Ramsel
66,Bergstraat 71,2019-10-21,05:00:00,6,2,4,FMN GV 11 Ramsel
66,Bergstraat 71,2019-10-21,06:00:00,32,14,18,FMN GV 11 Ramsel
66,Bergstraat 71,2019-10-21,07:00:00,156,6,150,FMN GV 11 Ramsel
66,Bergstraat 71,2019-10-21,08:00:00,130,8,122,FMN GV 11 Ramsel
66,Bergstraat 71,2019-10-21,09:00:00,34,22,12,FMN GV 11 Ramsel
66,Bergstraat 71,2019-10-21,10:00:00,40,20,20,FMN GV 11 Ramsel
66,Bergstraat 71,2019-10-21,11:00:00,36,26,10,FMN GV 11 Ramsel
66,Bergstraat 71,2019-10-21,12:00:00,96,60,36,FMN GV 11 Ramsel
66,Bergstraat 71,2019-10-21,13:00:00,70,24,46,FMN GV 11 Ramsel
66,Bergstraat 71,2019-10-21,14:00:00,96,58,38,FMN GV 11 Ramsel
66,Bergstraat 71,2019-10-21,15:00:00,198,168,30,FMN GV 11 Ramsel
66,Bergstraat 71,2019-10-21,16:00:00,98,72,26,FMN GV 11 Ramsel
66,Bergstraat 71,2019-10-21,17:00:00,78,54,24,FMN GV 11 Ramsel
66,Bergstraat 71,2019-10-21,18:00:00,54,32,22,FMN GV 11 Ramsel
66,Bergstraat 71,2019-10-21,19:00:00,24,10,14,FMN GV 11 Ramsel
66,Bergstraat 71,2019-10-21,20:00:00,10,6,4,FMN GV 11 Ramsel
66,Bergstraat 71,2019-10-21,21:00:00,10,6,4,FMN GV 11 Ramsel
66,Bergstraat 71,2019-10-21,22:00:00,14,4,10,FMN GV 11 Ramsel
66,Bergstraat 71,2019-10-21,23:00:00,4,4,0,FMN GV 11 Ramsel
66,Bergstraat 71,2019-10-22,00:00:00,2,2,0,FMN GV 11 Ramsel
66,Bergstraat 71,2019-10-22,01:00:00,0,0,0,FMN GV 11 Ramsel
66,Bergstraat 71,2019-10-22,02:00:00,0,0,0,FMN GV 11 Ramsel
66,Bergstraat 71,2019-10-22,03:00:00,0,0,0,FMN GV 11 Ramsel
66,Bergstraat 71,2019-10-22,04:00:00,6,4,2,FMN GV 11 Ramsel
66,Bergstraat 71,2019-10-22,05:00:00,16,6,10,FMN GV 11 Ramsel
66,Bergstraat 71,2019-10-22,06:00:00,50,4,46,FMN GV 11 Ramsel
66,Bergstraat 71,2019-10-22,07:00:00,160,16,144,FMN GV 11 Ramsel
66,Bergstraat 71,2019-10-22,08:00:00,156,16,140,FMN GV 11 Ramsel
66,Bergstraat 71,2019-10-22,09:00:00,48,16,32,FMN GV 11 Ramsel
66,Bergstraat 71,2019-10-22,10:00:00,50,20,30,FMN GV 11 Ramsel
66,Bergstraat 71,2019-10-22,11:00:00,100,36,64,FMN GV 11 Ramsel
66,Bergstraat 71,2019-10-22,12:00:00,74,46,28,FMN GV 11 Ramsel
66,Bergstraat 71,2019-10-22,13:00:00,114,66,48,FMN GV 11 Ramsel
66,Bergstraat 71,2019-10-22,14:00:00,118,64,54,FMN GV 11 Ramsel
66,Bergstraat 71,2019-10-22,15:00:00,262,174,88,FMN GV 11 Ramsel
66,Bergstraat 71,2019-10-22,16:00:00,202,138,64,FMN GV 11 Ramsel
66,Bergstraat 71,2019-10-22,17:00:00,128,86,42,FMN GV 11 Ramsel
66,Bergstraat 71,2019-10-22,18:00:00,74,52,22,FMN GV 11 Ramsel
66,Bergstraat 71,2019-10-22,19:00:00,54,26,28,FMN GV 11 Ramsel
66,Bergstraat 71,2019-10-22,20:00:00,20,20,0,FMN GV 11 Ramsel
66,Bergstraat 71,2019-10-22,21:00:00,6,6,0,FMN GV 11 Ramsel
66,Bergstraat 71,2019-10-22,22:00:00,12,4,8,FMN GV 11 Ramsel
66,Bergstraat 71,2019-10-22,23:00:00,0,0,0,FMN GV 11 Ramsel
66,Bergstraat 71,2019-10-23,00:00:00,2,0,2,FMN GV 11 Ramsel
66,Bergstraat 71,2019-10-23,01:00:00,2,2,0,FMN GV 11 Ramsel
66,Bergstraat 71,2019-10-23,02:00:00,0,0,0,FMN GV 11 Ramsel
66,Bergstraat 71,2019-10-23,03:00:00,0,0,0,FMN GV 11 Ramsel
66,Bergstraat 71,2019-10-23,04:00:00,2,2,0,FMN GV 11 Ramsel
66,Bergstraat 71,2019-10-23,05:00:00,16,6,10,FMN GV 11 Ramsel
66,Bergstraat 71,2019-10-23,06:00:00,52,6,46,FMN GV 11 Ramsel
66,Bergstraat 71,2019-10-23,07:00:00,230,28,202,FMN GV 11 Ramsel
66,Bergstraat 71,2019-10-23,08:00:00,154,18,136,FMN GV 11 Ramsel
66,Bergstraat 71,2019-10-23,09:00:00,72,44,28,FMN GV 11 Ramsel
66,Bergstraat 71,2019-10-23,10:00:00,70,24,46,FMN GV 11 Ramsel
66,Bergstraat 71,2019-10-23,11:00:00,78,48,30,FMN GV 11 Ramsel
66,Bergstraat 71,2019-10-23,12:00:00,316,250,66,FMN GV 11 Ramsel
66,Bergstraat 71,2019-10-23,13:00:00,156,96,60,FMN GV 11 Ramsel
66,Bergstraat 71,2019-10-23,14:00:00,152,66,86,FMN GV 11 Ramsel
66,Bergstraat 71,2019-10-23,15:00:00,222,106,116,FMN GV 11 Ramsel
66,Bergstraat 71,2019-10-23,16:00:00,174,106,68,FMN GV 11 Ramsel
66,Bergstraat 71,2019-10-23,17:00:00,154,90,64,FMN GV 11 Ramsel
66,Bergstraat 71,2019-10-23,18:00:00,82,46,36,FMN GV 11 Ramsel
66,Bergstraat 71,2019-10-23,19:00:00,58,44,14,FMN GV 11 Ramsel
66,Bergstraat 71,2019-10-23,20:00:00,22,12,10,FMN GV 11 Ramsel
66,Bergstraat 71,2019-10-23,21:00:00,6,4,2,FMN GV 11 Ramsel
66,Bergstraat 71,2019-10-23,22:00:00,18,10,8,FMN GV 11 Ramsel
66,Bergstraat 71,2019-10-23,23:00:00,0,0,0,FMN GV 11 Ramsel
66,Bergstraat 71,2019-10-24,00:00:00,2,2,0,FMN GV 11 Ramsel
66,Bergstraat 71,2019-10-24,01:00:00,0,0,0,FMN GV 11 Ramsel
66,Bergstraat 71,2019-10-24,02:00:00,0,0,0,FMN GV 11 Ramsel
66,Bergstraat 71,2019-10-24,03:00:00,0,0,0,FMN GV 11 Ramsel
66,Bergstraat 71,2019-10-24,04:00:00,2,2,0,FMN GV 11 Ramsel
66,Bergstraat 71,2019-10-24,05:00:00,20,10,10,FMN GV 11 Ramsel
66,Bergstraat 71,2019-10-24,06:00:00,44,10,34,FMN GV 11 Ramsel
66,Bergstraat 71,2019-10-24,07:00:00,198,18,180,FMN GV 11 Ramsel
66,Bergstraat 71,2019-10-24,08:00:00,166,32,134,FMN GV 11 Ramsel
66,Bergstraat 71,2019-10-24,09:00:00,56,18,38,FMN GV 11 Ramsel
66,Bergstraat 71,2019-10-24,10:00:00,70,28,42,FMN GV 11 Ramsel
66,Bergstraat 71,2019-10-24,11:00:00,68,42,26,FMN GV 11 Ramsel
66,Bergstraat 71,2019-10-24,12:00:00,116,62,54,FMN GV 11 Ramsel
66,Bergstraat 71,2019-10-24,13:00:00,160,56,104,FMN GV 11 Ramsel
66,Bergstraat 71,2019-10-24,14:00:00,186,94,92,FMN GV 11 Ramsel
66,Bergstraat 71,2019-10-24,15:00:00,274,250,24,FMN GV 11 Ramsel
66,Bergstraat 71,2019-10-24,16:00:00,242,174,68,FMN GV 11 Ramsel
66,Bergstraat 71,2019-10-24,17:00:00,158,100,58,FMN GV 11 Ramsel
66,Bergstraat 71,2019-10-24,18:00:00,54,40,14,FMN GV 11 Ramsel
66,Bergstraat 71,2019-10-24,19:00:00,54,28,26,FMN GV 11 Ramsel
66,Bergstraat 71,2019-10-24,20:00:00,26,16,10,FMN GV 11 Ramsel
66,Bergstraat 71,2019-10-24,21:00:00,26,22,4,FMN GV 11 Ramsel
66,Bergstraat 71,2019-10-24,22:00:00,12,6,6,FMN GV 11 Ramsel
66,Bergstraat 71,2019-10-24,23:00:00,6,4,2,FMN GV 11 Ramsel
66,Bergstraat 71,2019-10-25,00:00:00,2,0,2,FMN GV 11 Ramsel
66,Bergstraat 71,2019-10-25,01:00:00,2,2,0,FMN GV 11 Ramsel
66,Bergstraat 71,2019-10-25,02:00:00,2,2,0,FMN GV 11 Ramsel
66,Bergstraat 71,2019-10-25,03:00:00,2,2,0,FMN GV 11 Ramsel
66,Bergstraat 71,2019-10-25,04:00:00,4,4,0,FMN GV 11 Ramsel
66,Bergstraat 71,2019-10-25,05:00:00,8,4,4,FMN GV 11 Ramsel
66,Bergstraat 71,2019-10-25,06:00:00,36,6,30,FMN GV 11 Ramsel
66,Bergstraat 71,2019-10-25,07:00:00,200,20,180,FMN GV 11 Ramsel
66,Bergstraat 71,2019-10-25,08:00:00,168,22,146,FMN GV 11 Ramsel
66,Bergstraat 71,2019-10-25,09:00:00,42,20,22,FMN GV 11 Ramsel
66,Bergstraat 71,2019-10-25,10:00:00,64,38,26,FMN GV 11 Ramsel
66,Bergstraat 71,2019-10-25,11:00:00,68,38,30,FMN GV 11 Ramsel
66,Bergstraat 71,2019-10-25,12:00:00,94,50,44,FMN GV 11 Ramsel
66,Bergstraat 71,2019-10-25,13:00:00,112,56,56,FMN GV 11 Ramsel
66,Bergstraat 71,2019-10-25,14:00:00,176,82,94,FMN GV 11 Ramsel
66,Bergstraat 71,2019-10-25,15:00:00,238,198,40,FMN GV 11 Ramsel
66,Bergstraat 71,2019-10-25,16:00:00,162,104,58,FMN GV 11 Ramsel
66,Bergstraat 71,2019-10-25,17:00:00,112,82,30,FMN GV 11 Ramsel
66,Bergstraat 71,2019-10-25,18:00:00,78,52,26,FMN GV 11 Ramsel
66,Bergstraat 71,2019-10-25,19:00:00,36,28,8,FMN GV 11 Ramsel
66,Bergstraat 71,2019-10-25,20:00:00,24,8,16,FMN GV 11 Ramsel
66,Bergstraat 71,2019-10-25,21:00:00,22,12,10,FMN GV 11 Ramsel
66,Bergstraat 71,2019-10-25,22:00:00,38,8,30,FMN GV 11 Ramsel
66,Bergstraat 71,2019-10-25,23:00:00,10,8,2,FMN GV 11 Ramsel
66,Bergstraat 71,2019-10-26,00:00:00,6,2,4,FMN GV 11 Ramsel
66,Bergstraat 71,2019-10-26,01:00:00,16,4,12,FMN GV 11 Ramsel
66,Bergstraat 71,2019-10-26,02:00:00,0,0,0,FMN GV 11 Ramsel
66,Bergstraat 71,2019-10-26,03:00:00,2,2,0,FMN GV 11 Ramsel
66,Bergstraat 71,2019-10-26,04:00:00,0,0,0,FMN GV 11 Ramsel
66,Bergstraat 71,2019-10-26,05:00:00,6,4,2,FMN GV 11 Ramsel
66,Bergstraat 71,2019-10-26,06:00:00,0,0,0,FMN GV 11 Ramsel
66,Bergstraat 71,2019-10-26,07:00:00,14,6,8,FMN GV 11 Ramsel
66,Bergstraat 71,2019-10-26,08:00:00,14,4,10,FMN GV 11 Ramsel
66,Bergstraat 71,2019-10-26,09:00:00,54,14,40,FMN GV 11 Ramsel
66,Bergstraat 71,2019-10-26,10:00:00,76,36,40,FMN GV 11 Ramsel
66,Bergstraat 71,2019-10-26,11:00:00,102,52,50,FMN GV 11 Ramsel
66,Bergstraat 71,2019-10-26,12:00:00,100,36,64,FMN GV 11 Ramsel
66,Bergstraat 71,2019-10-26,13:00:00,288,118,170,FMN GV 11 Ramsel
66,Bergstraat 71,2019-10-26,14:00:00,208,88,120,FMN GV 11 Ramsel
66,Bergstraat 71,2019-10-26,15:00:00,200,124,76,FMN GV 11 Ramsel
66,Bergstraat 71,2019-10-26,16:00:00,166,104,62,FMN GV 11 Ramsel
66,Bergstraat 71,2019-10-26,17:00:00,138,64,74,FMN GV 11 Ramsel
66,Bergstraat 71,2019-10-26,18:00:00,34,26,8,FMN GV 11 Ramsel
66,Bergstraat 71,2019-10-26,19:00:00,14,8,6,FMN GV 11 Ramsel
66,Bergstraat 71,2019-10-26,20:00:00,12,4,8,FMN GV 11 Ramsel
66,Bergstraat 71,2019-10-26,21:00:00,10,8,2,FMN GV 11 Ramsel
66,Bergstraat 71,2019-10-26,22:00:00,8,4,4,FMN GV 11 Ramsel
66,Bergstraat 71,2019-10-26,23:00:00,8,6,2,FMN GV 11 Ramsel
66,Bergstraat 71,2019-10-27,00:00:00,14,6,8,FMN GV 11 Ramsel
66,Bergstraat 71,2019-10-27,01:00:00,4,4,0,FMN GV 11 Ramsel
66,Bergstraat 71,2019-10-27,02:00:00,4,2,2,FMN GV 11 Ramsel
66,Bergstraat 71,2019-10-27,03:00:00,0,0,0,FMN GV 11 Ramsel
66,Bergstraat 71,2019-10-27,04:00:00,0,0,0,FMN GV 11 Ramsel
66,Bergstraat 71,2019-10-27,05:00:00,2,2,0,FMN GV 11 Ramsel
66,Bergstraat 71,2019-10-27,06:00:00,2,0,2,FMN GV 11 Ramsel
66,Bergstraat 71,2019-10-27,07:00:00,12,2,10,FMN GV 11 Ramsel
66,Bergstraat 71,2019-10-27,08:00:00,30,12,18,FMN GV 11 Ramsel
66,Bergstraat 71,2019-10-27,09:00:00,88,36,52,FMN GV 11 Ramsel
66,Bergstraat 71,2019-10-27,10:00:00,64,38,26,FMN GV 11 Ramsel
66,Bergstraat 71,2019-10-27,11:00:00,94,56,38,FMN GV 11 Ramsel
66,Bergstraat 71,2019-10-27,12:00:00,30,18,12,FMN GV 11 Ramsel
66,Bergstraat 71,2019-10-27,13:00:00,98,52,46,FMN GV 11 Ramsel
66,Bergstraat 71,2019-10-27,14:00:00,114,64,50,FMN GV 11 Ramsel
66,Bergstraat 71,2019-10-27,15:00:00,68,30,38,FMN GV 11 Ramsel
66,Bergstraat 71,2019-10-27,16:00:00,66,40,26,FMN GV 11 Ramsel
66,Bergstraat 71,2019-10-27,17:00:00,28,18,10,FMN GV 11 Ramsel
66,Bergstraat 71,2019-10-27,18:00:00,18,14,4,FMN GV 11 Ramsel
66,Bergstraat 71,2019-10-27,19:00:00,22,12,10,FMN GV 11 Ramsel
66,Bergstraat 71,2019-10-27,20:00:00,2,0,2,FMN GV 11 Ramsel
66,Bergstraat 71,2019-10-27,21:00:00,0,0,0,FMN GV 11 Ramsel
66,Bergstraat 71,2019-10-27,22:00:00,8,8,0,FMN GV 11 Ramsel
66,Bergstraat 71,2019-10-27,23:00:00,6,4,2,FMN GV 11 Ramsel
66,Bergstraat 71,2019-10-28,00:00:00,2,0,2,FMN GV 11 Ramsel
66,Bergstraat 71,2019-10-28,01:00:00,2,2,0,FMN GV 11 Ramsel
66,Bergstraat 71,2019-10-28,02:00:00,2,0,2,FMN GV 11 Ramsel
66,Bergstraat 71,2019-10-28,03:00:00,0,0,0,FMN GV 11 Ramsel
66,Bergstraat 71,2019-10-28,04:00:00,0,0,0,FMN GV 11 Ramsel
66,Bergstraat 71,2019-10-28,05:00:00,20,12,8,FMN GV 11 Ramsel
66,Bergstraat 71,2019-10-28,06:00:00,28,6,22,FMN GV 11 Ramsel
66,Bergstraat 71,2019-10-28,07:00:00,50,12,38,FMN GV 11 Ramsel
66,Bergstraat 71,2019-10-28,08:00:00,34,2,32,FMN GV 11 Ramsel
66,Bergstraat 71,2019-10-28,09:00:00,64,38,26,FMN GV 11 Ramsel
66,Bergstraat 71,2019-10-28,10:00:00,66,36,30,FMN GV 11 Ramsel
66,Bergstraat 71,2019-10-28,11:00:00,64,20,44,FMN GV 11 Ramsel
66,Bergstraat 71,2019-10-28,12:00:00,84,34,50,FMN GV 11 Ramsel
66,Bergstraat 71,2019-10-28,13:00:00,114,56,58,FMN GV 11 Ramsel
66,Bergstraat 71,2019-10-28,14:00:00,128,70,58,FMN GV 11 Ramsel
66,Bergstraat 71,2019-10-28,15:00:00,96,66,30,FMN GV 11 Ramsel
66,Bergstraat 71,2019-10-28,16:00:00,162,114,48,FMN GV 11 Ramsel
66,Bergstraat 71,2019-10-28,17:00:00,92,68,24,FMN GV 11 Ramsel
66,Bergstraat 71,2019-10-28,18:00:00,30,20,10,FMN GV 11 Ramsel
66,Bergstraat 71,2019-10-28,19:00:00,40,22,18,FMN GV 11 Ramsel
66,Bergstraat 71,2019-10-28,20:00:00,16,16,0,FMN GV 11 Ramsel
66,Bergstraat 71,2019-10-28,21:00:00,10,4,6,FMN GV 11 Ramsel
66,Bergstraat 71,2019-10-28,22:00:00,6,6,0,FMN GV 11 Ramsel
66,Bergstraat 71,2019-10-28,23:00:00,2,2,0,FMN GV 11 Ramsel
66,Bergstraat 71,2019-10-29,00:00:00,2,0,2,FMN GV 11 Ramsel
66,Bergstraat 71,2019-10-29,01:00:00,0,0,0,FMN GV 11 Ramsel
66,Bergstraat 71,2019-10-29,02:00:00,0,0,0,FMN GV 11 Ramsel
66,Bergstraat 71,2019-10-29,03:00:00,0,0,0,FMN GV 11 Ramsel
66,Bergstraat 71,2019-10-29,04:00:00,8,8,0,FMN GV 11 Ramsel
66,Bergstraat 71,2019-10-29,05:00:00,18,10,8,FMN GV 11 Ramsel
66,Bergstraat 71,2019-10-29,06:00:00,36,8,28,FMN GV 11 Ramsel
66,Bergstraat 71,2019-10-29,07:00:00,60,10,50,FMN GV 11 Ramsel
66,Bergstraat 71,2019-10-29,08:00:00,46,8,38,FMN GV 11 Ramsel
66,Bergstraat 71,2019-10-29,09:00:00,30,14,16,FMN GV 11 Ramsel
66,Bergstraat 71,2019-10-29,10:00:00,60,20,40,FMN GV 11 Ramsel
66,Bergstraat 71,2019-10-29,11:00:00,80,32,48,FMN GV 11 Ramsel
66,Bergstraat 71,2019-10-29,12:00:00,68,28,40,FMN GV 11 Ramsel
66,Bergstraat 71,2019-10-29,13:00:00,214,86,128,FMN GV 11 Ramsel
66,Bergstraat 71,2019-10-29,14:00:00,172,98,74,FMN GV 11 Ramsel
66,Bergstraat 71,2019-10-29,15:00:00,102,76,26,FMN GV 11 Ramsel
66,Bergstraat 71,2019-10-29,16:00:00,132,92,40,FMN GV 11 Ramsel
66,Bergstraat 71,2019-10-29,17:00:00,104,58,46,FMN GV 11 Ramsel
66,Bergstraat 71,2019-10-29,18:00:00,34,20,14,FMN GV 11 Ramsel
66,Bergstraat 71,2019-10-29,19:00:00,30,10,20,FMN GV 11 Ramsel
66,Bergstraat 71,2019-10-29,20:00:00,28,26,2,FMN GV 11 Ramsel
66,Bergstraat 71,2019-10-29,21:00:00,18,16,2,FMN GV 11 Ramsel
66,Bergstraat 71,2019-10-29,22:00:00,18,10,8,FMN GV 11 Ramsel
66,Bergstraat 71,2019-10-29,23:00:00,4,2,2,FMN GV 11 Ramsel
66,Bergstraat 71,2019-10-30,00:00:00,2,0,2,FMN GV 11 Ramsel
66,Bergstraat 71,2019-10-30,01:00:00,0,0,0,FMN GV 11 Ramsel
66,Bergstraat 71,2019-10-30,02:00:00,0,0,0,FMN GV 11 Ramsel
66,Bergstraat 71,2019-10-30,03:00:00,0,0,0,FMN GV 11 Ramsel
66,Bergstraat 71,2019-10-30,04:00:00,0,0,0,FMN GV 11 Ramsel
66,Bergstraat 71,2019-10-30,05:00:00,16,6,10,FMN GV 11 Ramsel
66,Bergstraat 71,2019-10-30,06:00:00,32,6,26,FMN GV 11 Ramsel
66,Bergstraat 71,2019-10-30,07:00:00,48,12,36,FMN GV 11 Ramsel
66,Bergstraat 71,2019-10-30,08:00:00,38,10,28,FMN GV 11 Ramsel
66,Bergstraat 71,2019-10-30,09:00:00,36,16,20,FMN GV 11 Ramsel
66,Bergstraat 71,2019-10-30,10:00:00,46,24,22,FMN GV 11 Ramsel
66,Bergstraat 71,2019-10-30,11:00:00,62,34,28,FMN GV 11 Ramsel
66,Bergstraat 71,2019-10-30,12:00:00,72,34,38,FMN GV 11 Ramsel
66,Bergstraat 71,2019-10-30,13:00:00,74,30,44,FMN GV 11 Ramsel
66,Bergstraat 71,2019-10-30,14:00:00,86,28,58,FMN GV 11 Ramsel
66,Bergstraat 71,2019-10-30,15:00:00,58,36,22,FMN GV 11 Ramsel
66,Bergstraat 71,2019-10-30,16:00:00,100,60,40,FMN GV 11 Ramsel
66,Bergstraat 71,2019-10-30,17:00:00,66,32,34,FMN GV 11 Ramsel
66,Bergstraat 71,2019-10-30,18:00:00,48,36,12,FMN GV 11 Ramsel
66,Bergstraat 71,2019-10-30,19:00:00,30,10,20,FMN GV 11 Ramsel
66,Bergstraat 71,2019-10-30,20:00:00,16,10,6,FMN GV 11 Ramsel
66,Bergstraat 71,2019-10-30,21:00:00,10,0,10,FMN GV 11 Ramsel
66,Bergstraat 71,2019-10-30,22:00:00,16,14,2,FMN GV 11 Ramsel
66,Bergstraat 71,2019-10-30,23:00:00,8,8,0,FMN GV 11 Ramsel
66,Bergstraat 71,2019-10-31,00:00:00,0,0,0,FMN GV 11 Ramsel
66,Bergstraat 71,2019-10-31,01:00:00,0,0,0,FMN GV 11 Ramsel
66,Bergstraat 71,2019-10-31,02:00:00,2,2,0,FMN GV 11 Ramsel
66,Bergstraat 71,2019-10-31,03:00:00,2,2,0,FMN GV 11 Ramsel
66,Bergstraat 71,2019-10-31,04:00:00,2,2,0,FMN GV 11 Ramsel
66,Bergstraat 71,2019-10-31,05:00:00,20,10,10,FMN GV 11 Ramsel
66,Bergstraat 71,2019-10-31,06:00:00,32,8,24,FMN GV 11 Ramsel
66,Bergstraat 71,2019-10-31,07:00:00,58,6,52,FMN GV 11 Ramsel
66,Bergstraat 71,2019-10-31,08:00:00,30,10,20,FMN GV 11 Ramsel
66,Bergstraat 71,2019-10-31,09:00:00,30,12,18,FMN GV 11 Ramsel
66,Bergstraat 71,2019-10-31,10:00:00,64,36,28,FMN GV 11 Ramsel
66,Bergstraat 71,2019-10-31,11:00:00,42,32,10,FMN GV 11 Ramsel
66,Bergstraat 71,2019-10-31,12:00:00,52,28,24,FMN GV 11 Ramsel
66,Bergstraat 71,2019-10-31,13:00:00,116,58,58,FMN GV 11 Ramsel
66,Bergstraat 71,2019-10-31,14:00:00,124,58,66,FMN GV 11 Ramsel
66,Bergstraat 71,2019-10-31,15:00:00,92,64,28,FMN GV 11 Ramsel
66,Bergstraat 71,2019-10-31,16:00:00,138,86,52,FMN GV 11 Ramsel
66,Bergstraat 71,2019-10-31,17:00:00,70,50,20,FMN GV 11 Ramsel
66,Bergstraat 71,2019-10-31,18:00:00,40,22,18,FMN GV 11 Ramsel
66,Bergstraat 71,2019-10-31,19:00:00,30,16,14,FMN GV 11 Ramsel
66,Bergstraat 71,2019-10-31,20:00:00,24,14,10,FMN GV 11 Ramsel
66,Bergstraat 71,2019-10-31,21:00:00,12,10,2,FMN GV 11 Ramsel
66,Bergstraat 71,2019-10-31,22:00:00,16,14,2,FMN GV 11 Ramsel
66,Bergstraat 71,2019-10-31,23:00:00,0,0,0,FMN GV 11 Ramsel
66,Bergstraat 71,2019-11-01,00:00:00,6,6,0,FMN GV 11 Ramsel
66,Bergstraat 71,2019-11-01,01:00:00,0,0,0,FMN GV 11 Ramsel
66,Bergstraat 71,2019-11-01,02:00:00,0,0,0,FMN GV 11 Ramsel
66,Bergstraat 71,2019-11-01,03:00:00,0,0,0,FMN GV 11 Ramsel
66,Bergstraat 71,2019-11-01,04:00:00,0,0,0,FMN GV 11 Ramsel
66,Bergstraat 71,2019-11-01,05:00:00,2,2,0,FMN GV 11 Ramsel
66,Bergstraat 71,2019-11-01,06:00:00,0,0,0,FMN GV 11 Ramsel
66,Bergstraat 71,2019-11-01,07:00:00,4,2,2,FMN GV 11 Ramsel
66,Bergstraat 71,2019-11-01,08:00:00,24,10,14,FMN GV 11 Ramsel
66,Bergstraat 71,2019-11-01,09:00:00,28,8,20,FMN GV 11 Ramsel
66,Bergstraat 71,2019-11-01,10:00:00,32,24,8,FMN GV 11 Ramsel
66,Bergstraat 71,2019-11-01,11:00:00,8,4,4,FMN GV 11 Ramsel
66,Bergstraat 71,2019-11-01,12:00:00,8,4,4,FMN GV 11 Ramsel
66,Bergstraat 71,2019-11-01,13:00:00,16,6,10,FMN GV 11 Ramsel
66,Bergstraat 71,2019-11-01,14:00:00,32,16,16,FMN GV 11 Ramsel
66,Bergstraat 71,2019-11-01,15:00:00,16,12,4,FMN GV 11 Ramsel
66,Bergstraat 71,2019-11-01,16:00:00,16,8,8,FMN GV 11 Ramsel
66,Bergstraat 71,2019-11-01,17:00:00,4,4,0,FMN GV 11 Ramsel
66,Bergstraat 71,2019-11-01,18:00:00,14,8,6,FMN GV 11 Ramsel
66,Bergstraat 71,2019-11-01,19:00:00,6,2,4,FMN GV 11 Ramsel
66,Bergstraat 71,2019-11-01,20:00:00,10,6,4,FMN GV 11 Ramsel
66,Bergstraat 71,2019-11-01,21:00:00,10,4,6,FMN GV 11 Ramsel
66,Bergstraat 71,2019-11-01,22:00:00,6,0,6,FMN GV 11 Ramsel
66,Bergstraat 71,2019-11-01,23:00:00,4,4,0,FMN GV 11 Ramsel
66,Bergstraat 71,2019-11-02,00:00:00,4,0,4,FMN GV 11 Ramsel
66,Bergstraat 71,2019-11-02,01:00:00,2,2,0,FMN GV 11 Ramsel
66,Bergstraat 71,2019-11-02,02:00:00,2,2,0,FMN GV 11 Ramsel
66,Bergstraat 71,2019-11-02,03:00:00,0,0,0,FMN GV 11 Ramsel
66,Bergstraat 71,2019-11-02,04:00:00,0,0,0,FMN GV 11 Ramsel
66,Bergstraat 71,2019-11-02,05:00:00,8,6,2,FMN GV 11 Ramsel
66,Bergstraat 71,2019-11-02,06:00:00,0,0,0,FMN GV 11 Ramsel
66,Bergstraat 71,2019-11-02,07:00:00,10,2,8,FMN GV 11 Ramsel
66,Bergstraat 71,2019-11-02,08:00:00,28,12,16,FMN GV 11 Ramsel
66,Bergstraat 71,2019-11-02,09:00:00,32,4,28,FMN GV 11 Ramsel
66,Bergstraat 71,2019-11-02,10:00:00,26,18,8,FMN GV 11 Ramsel
66,Bergstraat 71,2019-11-02,11:00:00,28,20,8,FMN GV 11 Ramsel
66,Bergstraat 71,2019-11-02,12:00:00,40,12,28,FMN GV 11 Ramsel
66,Bergstraat 71,2019-11-02,13:00:00,98,40,58,FMN GV 11 Ramsel
66,Bergstraat 71,2019-11-02,14:00:00,120,74,46,FMN GV 11 Ramsel
66,Bergstraat 71,2019-11-02,15:00:00,92,48,44,FMN GV 11 Ramsel
66,Bergstraat 71,2019-11-02,16:00:00,76,54,22,FMN GV 11 Ramsel
66,Bergstraat 71,2019-11-02,17:00:00,26,10,16,FMN GV 11 Ramsel
66,Bergstraat 71,2019-11-02,18:00:00,16,8,8,FMN GV 11 Ramsel
66,Bergstraat 71,2019-11-02,19:00:00,12,2,10,FMN GV 11 Ramsel
66,Bergstraat 71,2019-11-02,20:00:00,8,2,6,FMN GV 11 Ramsel
66,Bergstraat 71,2019-11-02,21:00:00,8,0,8,FMN GV 11 Ramsel
66,Bergstraat 71,2019-11-02,22:00:00,4,2,2,FMN GV 11 Ramsel
66,Bergstraat 71,2019-11-02,23:00:00,6,2,4,FMN GV 11 Ramsel
66,Bergstraat 71,2019-11-03,00:00:00,4,4,0,FMN GV 11 Ramsel
66,Bergstraat 71,2019-11-03,01:00:00,4,2,2,FMN GV 11 Ramsel
66,Bergstraat 71,2019-11-03,02:00:00,2,2,0,FMN GV 11 Ramsel
66,Bergstraat 71,2019-11-03,03:00:00,2,2,0,FMN GV 11 Ramsel
66,Bergstraat 71,2019-11-03,04:00:00,10,10,0,FMN GV 11 Ramsel
66,Bergstraat 71,2019-11-03,05:00:00,4,4,0,FMN GV 11 Ramsel
66,Bergstraat 71,2019-11-03,06:00:00,4,2,2,FMN GV 11 Ramsel
66,Bergstraat 71,2019-11-03,07:00:00,8,2,6,FMN GV 11 Ramsel
66,Bergstraat 71,2019-11-03,08:00:00,30,16,14,FMN GV 11 Ramsel
66,Bergstraat 71,2019-11-03,09:00:00,52,14,38,FMN GV 11 Ramsel
66,Bergstraat 71,2019-11-03,10:00:00,76,54,22,FMN GV 11 Ramsel
66,Bergstraat 71,2019-11-03,11:00:00,60,44,16,FMN GV 11 Ramsel
66,Bergstraat 71,2019-11-03,12:00:00,20,16,4,FMN GV 11 Ramsel
66,Bergstraat 71,2019-11-03,13:00:00,8,8,0,FMN GV 11 Ramsel
66,Bergstraat 71,2019-11-03,14:00:00,4,2,2,FMN GV 11 Ramsel
66,Bergstraat 71,2019-11-03,15:00:00,22,8,14,FMN GV 11 Ramsel
66,Bergstraat 71,2019-11-03,16:00:00,12,0,12,FMN GV 11 Ramsel
66,Bergstraat 71,2019-11-03,17:00:00,18,12,6,FMN GV 11 Ramsel
66,Bergstraat 71,2019-11-03,18:00:00,10,8,2,FMN GV 11 Ramsel
66,Bergstraat 71,2019-11-03,19:00:00,6,2,4,FMN GV 11 Ramsel
66,Bergstraat 71,2019-11-03,20:00:00,4,4,0,FMN GV 11 Ramsel
66,Bergstraat 71,2019-11-03,21:00:00,0,0,0,FMN GV 11 Ramsel
66,Bergstraat 71,2019-11-03,22:00:00,0,0,0,FMN GV 11 Ramsel
66,Bergstraat 71,2019-11-03,23:00:00,4,2,2,FMN GV 11 Ramsel
66,Bergstraat 71,2019-11-04,00:00:00,0,0,0,FMN GV 11 Ramsel
66,Bergstraat 71,2019-11-04,01:00:00,2,2,0,FMN GV 11 Ramsel
66,Bergstraat 71,2019-11-04,02:00:00,0,0,0,FMN GV 11 Ramsel
66,Bergstraat 71,2019-11-04,03:00:00,0,0,0,FMN GV 11 Ramsel
66,Bergstraat 71,2019-11-04,04:00:00,2,2,0,FMN GV 11 Ramsel
66,Bergstraat 71,2019-11-04,05:00:00,14,10,4,FMN GV 11 Ramsel
66,Bergstraat 71,2019-11-04,06:00:00,32,4,28,FMN GV 11 Ramsel
66,Bergstraat 71,2019-11-04,07:00:00,154,20,134,FMN GV 11 Ramsel
66,Bergstraat 71,2019-11-04,08:00:00,126,2,124,FMN GV 11 Ramsel
66,Bergstraat 71,2019-11-04,09:00:00,38,20,18,FMN GV 11 Ramsel
66,Bergstraat 71,2019-11-04,10:00:00,38,26,12,FMN GV 11 Ramsel
66,Bergstraat 71,2019-11-04,11:00:00,32,12,20,FMN GV 11 Ramsel
66,Bergstraat 71,2019-11-04,12:00:00,42,20,22,FMN GV 11 Ramsel
66,Bergstraat 71,2019-11-04,13:00:00,88,34,54,FMN GV 11 Ramsel
66,Bergstraat 71,2019-11-04,14:00:00,92,60,32,FMN GV 11 Ramsel
66,Bergstraat 71,2019-11-04,15:00:00,214,178,36,FMN GV 11 Ramsel
66,Bergstraat 71,2019-11-04,16:00:00,156,110,46,FMN GV 11 Ramsel
66,Bergstraat 71,2019-11-04,17:00:00,90,58,32,FMN GV 11 Ramsel
66,Bergstraat 71,2019-11-04,18:00:00,32,22,10,FMN GV 11 Ramsel
66,Bergstraat 71,2019-11-04,19:00:00,4,2,2,FMN GV 11 Ramsel
66,Bergstraat 71,2019-11-04,20:00:00,10,10,0,FMN GV 11 Ramsel
66,Bergstraat 71,2019-11-04,21:00:00,10,4,6,FMN GV 11 Ramsel
66,Bergstraat 71,2019-11-04,22:00:00,10,6,4,FMN GV 11 Ramsel
66,Bergstraat 71,2019-11-04,23:00:00,2,2,0,FMN GV 11 Ramsel
66,Bergstraat 71,2019-11-05,00:00:00,2,2,0,FMN GV 11 Ramsel
66,Bergstraat 71,2019-11-05,01:00:00,0,0,0,FMN GV 11 Ramsel
66,Bergstraat 71,2019-11-05,02:00:00,0,0,0,FMN GV 11 Ramsel
66,Bergstraat 71,2019-11-05,03:00:00,0,0,0,FMN GV 11 Ramsel
66,Bergstraat 71,2019-11-05,04:00:00,2,2,0,FMN GV 11 Ramsel
66,Bergstraat 71,2019-11-05,05:00:00,18,8,10,FMN GV 11 Ramsel
66,Bergstraat 71,2019-11-05,06:00:00,30,6,24,FMN GV 11 Ramsel
66,Bergstraat 71,2019-11-05,07:00:00,184,22,162,FMN GV 11 Ramsel
66,Bergstraat 71,2019-11-05,08:00:00,130,8,122,FMN GV 11 Ramsel
66,Bergstraat 71,2019-11-05,09:00:00,42,12,30,FMN GV 11 Ramsel
66,Bergstraat 71,2019-11-05,10:00:00,30,12,18,FMN GV 11 Ramsel
66,Bergstraat 71,2019-11-05,11:00:00,66,32,34,FMN GV 11 Ramsel
66,Bergstraat 71,2019-11-05,12:00:00,62,28,34,FMN GV 11 Ramsel
66,Bergstraat 71,2019-11-05,13:00:00,152,70,82,FMN GV 11 Ramsel
66,Bergstraat 71,2019-11-05,14:00:00,134,76,58,FMN GV 11 Ramsel
66,Bergstraat 71,2019-11-05,15:00:00,262,204,58,FMN GV 11 Ramsel
66,Bergstraat 71,2019-11-05,16:00:00,178,146,32,FMN GV 11 Ramsel
66,Bergstraat 71,2019-11-05,17:00:00,104,56,48,FMN GV 11 Ramsel
66,Bergstraat 71,2019-11-05,18:00:00,52,32,20,FMN GV 11 Ramsel
66,Bergstraat 71,2019-11-05,19:00:00,36,12,24,FMN GV 11 Ramsel
66,Bergstraat 71,2019-11-05,20:00:00,36,28,8,FMN GV 11 Ramsel
66,Bergstraat 71,2019-11-05,21:00:00,6,6,0,FMN GV 11 Ramsel
66,Bergstraat 71,2019-11-05,22:00:00,16,8,8,FMN GV 11 Ramsel
66,Bergstraat 71,2019-11-05,23:00:00,0,0,0,FMN GV 11 Ramsel
66,Bergstraat 71,2019-11-06,00:00:00,2,2,0,FMN GV 11 Ramsel
66,Bergstraat 71,2019-11-06,01:00:00,2,0,2,FMN GV 11 Ramsel
66,Bergstraat 71,2019-11-06,02:00:00,0,0,0,FMN GV 11 Ramsel
66,Bergstraat 71,2019-11-06,03:00:00,2,2,0,FMN GV 11 Ramsel
66,Bergstraat 71,2019-11-06,04:00:00,4,2,2,FMN GV 11 Ramsel
66,Bergstraat 71,2019-11-06,05:00:00,10,6,4,FMN GV 11 Ramsel
66,Bergstraat 71,2019-11-06,06:00:00,36,6,30,FMN GV 11 Ramsel
66,Bergstraat 71,2019-11-06,07:00:00,150,14,136,FMN GV 11 Ramsel
66,Bergstraat 71,2019-11-06,08:00:00,128,22,106,FMN GV 11 Ramsel
66,Bergstraat 71,2019-11-06,09:00:00,58,16,42,FMN GV 11 Ramsel
66,Bergstraat 71,2019-11-06,10:00:00,26,14,12,FMN GV 11 Ramsel
66,Bergstraat 71,2019-11-06,11:00:00,48,16,32,FMN GV 11 Ramsel
66,Bergstraat 71,2019-11-06,12:00:00,196,166,30,FMN GV 11 Ramsel
66,Bergstraat 71,2019-11-06,13:00:00,82,44,38,FMN GV 11 Ramsel
66,Bergstraat 71,2019-11-06,14:00:00,88,44,44,FMN GV 11 Ramsel
66,Bergstraat 71,2019-11-06,15:00:00,82,46,36,FMN GV 11 Ramsel
66,Bergstraat 71,2019-11-06,16:00:00,82,58,24,FMN GV 11 Ramsel
66,Bergstraat 71,2019-11-06,17:00:00,70,46,24,FMN GV 11 Ramsel
66,Bergstraat 71,2019-11-06,18:00:00,46,28,18,FMN GV 11 Ramsel
66,Bergstraat 71,2019-11-06,19:00:00,24,16,8,FMN GV 11 Ramsel
66,Bergstraat 71,2019-11-06,20:00:00,10,6,4,FMN GV 11 Ramsel
66,Bergstraat 71,2019-11-06,21:00:00,4,4,0,FMN GV 11 Ramsel
66,Bergstraat 71,2019-11-06,22:00:00,8,6,2,FMN GV 11 Ramsel
66,Bergstraat 71,2019-11-06,23:00:00,0,0,0,FMN GV 11 Ramsel
66,Bergstraat 71,2019-11-07,00:00:00,2,0,2,FMN GV 11 Ramsel
66,Bergstraat 71,2019-11-07,01:00:00,0,0,0,FMN GV 11 Ramsel
66,Bergstraat 71,2019-11-07,02:00:00,0,0,0,FMN GV 11 Ramsel
66,Bergstraat 71,2019-11-07,03:00:00,0,0,0,FMN GV 11 Ramsel
66,Bergstraat 71,2019-11-07,04:00:00,2,2,0,FMN GV 11 Ramsel
66,Bergstraat 71,2019-11-07,05:00:00,14,8,6,FMN GV 11 Ramsel
66,Bergstraat 71,2019-11-07,06:00:00,50,4,46,FMN GV 11 Ramsel
66,Bergstraat 71,2019-11-07,07:00:00,140,16,124,FMN GV 11 Ramsel
66,Bergstraat 71,2019-11-07,08:00:00,132,18,114,FMN GV 11 Ramsel
66,Bergstraat 71,2019-11-07,09:00:00,32,10,22,FMN GV 11 Ramsel
66,Bergstraat 71,2019-11-07,10:00:00,8,4,4,FMN GV 11 Ramsel
66,Bergstraat 71,2019-11-07,11:00:00,0,0,0,FMN GV 11 Ramsel
66,Bergstraat 71,2019-11-07,12:00:00,12,10,2,FMN GV 11 Ramsel
66,Bergstraat 71,2019-11-07,13:00:00,16,8,8,FMN GV 11 Ramsel
66,Bergstraat 71,2019-11-07,14:00:00,54,14,40,FMN GV 11 Ramsel
66,Bergstraat 71,2019-11-07,15:00:00,144,126,18,FMN GV 11 Ramsel
66,Bergstraat 71,2019-11-07,16:00:00,108,88,20,FMN GV 11 Ramsel
66,Bergstraat 71,2019-11-07,17:00:00,92,76,16,FMN GV 11 Ramsel
66,Bergstraat 71,2019-11-07,18:00:00,30,20,10,FMN GV 11 Ramsel
66,Bergstraat 71,2019-11-07,19:00:00,28,16,12,FMN GV 11 Ramsel
66,Bergstraat 71,2019-11-07,20:00:00,10,10,0,FMN GV 11 Ramsel
66,Bergstraat 71,2019-11-07,21:00:00,2,2,0,FMN GV 11 Ramsel
66,Bergstraat 71,2019-11-07,22:00:00,8,4,4,FMN GV 11 Ramsel
66,Bergstraat 71,2019-11-07,23:00:00,2,2,0,FMN GV 11 Ramsel
66,Bergstraat 71,2019-11-08,00:00:00,4,4,0,FMN GV 11 Ramsel
66,Bergstraat 71,2019-11-08,01:00:00,2,0,2,FMN GV 11 Ramsel
66,Bergstraat 71,2019-11-08,02:00:00,0,0,0,FMN GV 11 Ramsel
66,Bergstraat 71,2019-11-08,03:00:00,0,0,0,FMN GV 11 Ramsel
66,Bergstraat 71,2019-11-08,04:00:00,2,2,0,FMN GV 11 Ramsel
66,Bergstraat 71,2019-11-08,05:00:00,10,6,4,FMN GV 11 Ramsel
66,Bergstraat 71,2019-11-08,06:00:00,26,6,20,FMN GV 11 Ramsel
66,Bergstraat 71,2019-11-08,07:00:00,144,16,128,FMN GV 11 Ramsel
66,Bergstraat 71,2019-11-08,08:00:00,122,20,102,FMN GV 11 Ramsel
66,Bergstraat 71,2019-11-08,09:00:00,46,24,22,FMN GV 11 Ramsel
66,Bergstraat 71,2019-11-08,10:00:00,54,24,30,FMN GV 11 Ramsel
66,Bergstraat 71,2019-11-08,11:00:00,52,22,30,FMN GV 11 Ramsel
66,Bergstraat 71,2019-11-08,12:00:00,80,36,44,FMN GV 11 Ramsel
66,Bergstraat 71,2019-11-08,13:00:00,74,32,42,FMN GV 11 Ramsel
66,Bergstraat 71,2019-11-08,14:00:00,130,66,64,FMN GV 11 Ramsel
66,Bergstraat 71,2019-11-08,15:00:00,196,166,30,FMN GV 11 Ramsel
66,Bergstraat 71,2019-11-08,16:00:00,148,120,28,FMN GV 11 Ramsel
66,Bergstraat 71,2019-11-08,17:00:00,66,34,32,FMN GV 11 Ramsel
66,Bergstraat 71,2019-11-08,18:00:00,38,28,10,FMN GV 11 Ramsel
66,Bergstraat 71,2019-11-08,19:00:00,36,16,20,FMN GV 11 Ramsel
66,Bergstraat 71,2019-11-08,20:00:00,12,10,2,FMN GV 11 Ramsel
66,Bergstraat 71,2019-11-08,21:00:00,10,8,2,FMN GV 11 Ramsel
66,Bergstraat 71,2019-11-08,22:00:00,20,10,10,FMN GV 11 Ramsel
66,Bergstraat 71,2019-11-08,23:00:00,2,0,2,FMN GV 11 Ramsel
66,Bergstraat 71,2019-11-09,00:00:00,14,6,8,FMN GV 11 Ramsel
66,Bergstraat 71,2019-11-09,01:00:00,2,0,2,FMN GV 11 Ramsel
66,Bergstraat 71,2019-11-09,02:00:00,4,4,0,FMN GV 11 Ramsel
66,Bergstraat 71,2019-11-09,03:00:00,0,0,0,FMN GV 11 Ramsel
66,Bergstraat 71,2019-11-09,04:00:00,2,2,0,FMN GV 11 Ramsel
66,Bergstraat 71,2019-11-09,05:00:00,6,2,4,FMN GV 11 Ramsel
66,Bergstraat 71,2019-11-09,06:00:00,4,2,2,FMN GV 11 Ramsel
66,Bergstraat 71,2019-11-09,07:00:00,4,2,2,FMN GV 11 Ramsel
66,Bergstraat 71,2019-11-09,08:00:00,12,4,8,FMN GV 11 Ramsel
66,Bergstraat 71,2019-11-09,09:00:00,36,16,20,FMN GV 11 Ramsel
66,Bergstraat 71,2019-11-09,10:00:00,36,14,22,FMN GV 11 Ramsel
66,Bergstraat 71,2019-11-09,11:00:00,40,22,18,FMN GV 11 Ramsel
66,Bergstraat 71,2019-11-09,12:00:00,92,36,56,FMN GV 11 Ramsel
66,Bergstraat 71,2019-11-09,13:00:00,102,48,54,FMN GV 11 Ramsel
66,Bergstraat 71,2019-11-09,14:00:00,90,44,46,FMN GV 11 Ramsel
66,Bergstraat 71,2019-11-09,15:00:00,96,58,38,FMN GV 11 Ramsel
66,Bergstraat 71,2019-11-09,16:00:00,86,68,18,FMN GV 11 Ramsel
66,Bergstraat 71,2019-11-09,17:00:00,48,26,22,FMN GV 11 Ramsel
66,Bergstraat 71,2019-11-09,18:00:00,14,6,8,FMN GV 11 Ramsel
66,Bergstraat 71,2019-11-09,19:00:00,18,4,14,FMN GV 11 Ramsel
66,Bergstraat 71,2019-11-09,20:00:00,8,4,4,FMN GV 11 Ramsel
66,Bergstraat 71,2019-11-09,21:00:00,6,6,0,FMN GV 11 Ramsel
66,Bergstraat 71,2019-11-09,22:00:00,10,6,4,FMN GV 11 Ramsel
66,Bergstraat 71,2019-11-09,23:00:00,14,12,2,FMN GV 11 Ramsel
66,Bergstraat 71,2019-11-10,00:00:00,2,0,2,FMN GV 11 Ramsel
66,Bergstraat 71,2019-11-10,01:00:00,0,0,0,FMN GV 11 Ramsel
66,Bergstraat 71,2019-11-10,02:00:00,2,2,0,FMN GV 11 Ramsel
66,Bergstraat 71,2019-11-10,03:00:00,0,0,0,FMN GV 11 Ramsel
66,Bergstraat 71,2019-11-10,04:00:00,0,0,0,FMN GV 11 Ramsel
66,Bergstraat 71,2019-11-10,05:00:00,4,4,0,FMN GV 11 Ramsel
66,Bergstraat 71,2019-11-10,06:00:00,0,0,0,FMN GV 11 Ramsel
66,Bergstraat 71,2019-11-10,07:00:00,0,0,0,FMN GV 11 Ramsel
66,Bergstraat 71,2019-11-10,08:00:00,30,16,14,FMN GV 11 Ramsel
66,Bergstraat 71,2019-11-10,09:00:00,48,16,32,FMN GV 11 Ramsel
66,Bergstraat 71,2019-11-10,10:00:00,68,24,44,FMN GV 11 Ramsel
66,Bergstraat 71,2019-11-10,11:00:00,82,52,30,FMN GV 11 Ramsel
66,Bergstraat 71,2019-11-10,12:00:00,68,48,20,FMN GV 11 Ramsel
66,Bergstraat 71,2019-11-10,13:00:00,140,68,72,FMN GV 11 Ramsel
66,Bergstraat 71,2019-11-10,14:00:00,114,44,70,FMN GV 11 Ramsel
66,Bergstraat 71,2019-11-10,15:00:00,106,58,48,FMN GV 11 Ramsel
66,Bergstraat 71,2019-11-10,16:00:00,50,24,26,FMN GV 11 Ramsel
66,Bergstraat 71,2019-11-10,17:00:00,12,8,4,FMN GV 11 Ramsel
66,Bergstraat 71,2019-11-10,18:00:00,8,2,6,FMN GV 11 Ramsel
66,Bergstraat 71,2019-11-10,19:00:00,12,8,4,FMN GV 11 Ramsel
66,Bergstraat 71,2019-11-10,20:00:00,12,8,4,FMN GV 11 Ramsel
66,Bergstraat 71,2019-11-10,21:00:00,6,6,0,FMN GV 11 Ramsel
66,Bergstraat 71,2019-11-10,22:00:00,0,0,0,FMN GV 11 Ramsel
66,Bergstraat 71,2019-11-10,23:00:00,4,2,2,FMN GV 11 Ramsel
66,Bergstraat 71,2019-11-11,00:00:00,0,0,0,FMN GV 11 Ramsel
66,Bergstraat 71,2019-11-11,01:00:00,2,2,0,FMN GV 11 Ramsel
66,Bergstraat 71,2019-11-11,02:00:00,2,0,2,FMN GV 11 Ramsel
66,Bergstraat 71,2019-11-11,03:00:00,0,0,0,FMN GV 11 Ramsel
66,Bergstraat 71,2019-11-11,04:00:00,0,0,0,FMN GV 11 Ramsel
66,Bergstraat 71,2019-11-11,05:00:00,2,2,0,FMN GV 11 Ramsel
66,Bergstraat 71,2019-11-11,06:00:00,4,0,4,FMN GV 11 Ramsel
66,Bergstraat 71,2019-11-11,07:00:00,2,0,2,FMN GV 11 Ramsel
66,Bergstraat 71,2019-11-11,08:00:00,16,8,8,FMN GV 11 Ramsel
66,Bergstraat 71,2019-11-11,09:00:00,44,26,18,FMN GV 11 Ramsel
66,Bergstraat 71,2019-11-11,10:00:00,92,52,40,FMN GV 11 Ramsel
66,Bergstraat 71,2019-11-11,11:00:00,54,26,28,FMN GV 11 Ramsel
66,Bergstraat 71,2019-11-11,12:00:00,36,20,16,FMN GV 11 Ramsel
66,Bergstraat 71,2019-11-11,13:00:00,28,20,8,FMN GV 11 Ramsel
66,Bergstraat 71,2019-11-11,14:00:00,12,2,10,FMN GV 11 Ramsel
66,Bergstraat 71,2019-11-11,15:00:00,12,8,4,FMN GV 11 Ramsel
66,Bergstraat 71,2019-11-11,16:00:00,8,4,4,FMN GV 11 Ramsel
66,Bergstraat 71,2019-11-11,17:00:00,8,4,4,FMN GV 11 Ramsel
66,Bergstraat 71,2019-11-11,18:00:00,6,4,2,FMN GV 11 Ramsel
66,Bergstraat 71,2019-11-11,19:00:00,2,0,2,FMN GV 11 Ramsel
66,Bergstraat 71,2019-11-11,20:00:00,4,2,2,FMN GV 11 Ramsel
66,Bergstraat 71,2019-11-11,21:00:00,10,6,4,FMN GV 11 Ramsel
66,Bergstraat 71,2019-11-11,22:00:00,4,4,0,FMN GV 11 Ramsel
66,Bergstraat 71,2019-11-11,23:00:00,2,0,2,FMN GV 11 Ramsel
66,Bergstraat 71,2019-11-12,00:00:00,4,2,2,FMN GV 11 Ramsel
66,Bergstraat 71,2019-11-12,01:00:00,0,0,0,FMN GV 11 Ramsel
66,Bergstraat 71,2019-11-12,02:00:00,0,0,0,FMN GV 11 Ramsel
66,Bergstraat 71,2019-11-12,03:00:00,0,0,0,FMN GV 11 Ramsel
66,Bergstraat 71,2019-11-12,04:00:00,2,2,0,FMN GV 11 Ramsel
66,Bergstraat 71,2019-11-12,05:00:00,18,10,8,FMN GV 11 Ramsel
66,Bergstraat 71,2019-11-12,06:00:00,32,4,28,FMN GV 11 Ramsel
66,Bergstraat 71,2019-11-12,07:00:00,124,20,104,FMN GV 11 Ramsel
66,Bergstraat 71,2019-11-12,08:00:00,138,14,124,FMN GV 11 Ramsel
66,Bergstraat 71,2019-11-12,09:00:00,46,12,34,FMN GV 11 Ramsel
66,Bergstraat 71,2019-11-12,10:00:00,26,10,16,FMN GV 11 Ramsel
66,Bergstraat 71,2019-11-12,11:00:00,28,18,10,FMN GV 11 Ramsel
66,Bergstraat 71,2019-11-12,12:00:00,50,18,32,FMN GV 11 Ramsel
66,Bergstraat 71,2019-11-12,13:00:00,80,48,32,FMN GV 11 Ramsel
66,Bergstraat 71,2019-11-12,14:00:00,80,38,42,FMN GV 11 Ramsel
66,Bergstraat 71,2019-11-12,15:00:00,162,148,14,FMN GV 11 Ramsel
66,Bergstraat 71,2019-11-12,16:00:00,142,110,32,FMN GV 11 Ramsel
66,Bergstraat 71,2019-11-12,17:00:00,84,50,34,FMN GV 11 Ramsel
66,Bergstraat 71,2019-11-12,18:00:00,42,28,14,FMN GV 11 Ramsel
66,Bergstraat 71,2019-11-12,19:00:00,28,10,18,FMN GV 11 Ramsel
66,Bergstraat 71,2019-11-12,20:00:00,12,12,0,FMN GV 11 Ramsel
66,Bergstraat 71,2019-11-12,21:00:00,12,8,4,FMN GV 11 Ramsel
66,Bergstraat 71,2019-11-12,22:00:00,6,2,4,FMN GV 11 Ramsel
66,Bergstraat 71,2019-11-12,23:00:00,2,0,2,FMN GV 11 Ramsel
66,Bergstraat 71,2019-11-13,00:00:00,0,0,0,FMN GV 11 Ramsel
66,Bergstraat 71,2019-11-13,01:00:00,0,0,0,FMN GV 11 Ramsel
66,Bergstraat 71,2019-11-13,02:00:00,0,0,0,FMN GV 11 Ramsel
66,Bergstraat 71,2019-11-13,03:00:00,0,0,0,FMN GV 11 Ramsel
66,Bergstraat 71,2019-11-13,04:00:00,4,4,0,FMN GV 11 Ramsel
66,Bergstraat 71,2019-11-13,05:00:00,18,10,8,FMN GV 11 Ramsel
66,Bergstraat 71,2019-11-13,06:00:00,28,6,22,FMN GV 11 Ramsel
66,Bergstraat 71,2019-11-13,07:00:00,128,14,114,FMN GV 11 Ramsel
66,Bergstraat 71,2019-11-13,08:00:00,122,20,102,FMN GV 11 Ramsel
66,Bergstraat 71,2019-11-13,09:00:00,20,10,10,FMN GV 11 Ramsel
66,Bergstraat 71,2019-11-13,10:00:00,38,12,26,FMN GV 11 Ramsel
66,Bergstraat 71,2019-11-13,11:00:00,36,16,20,FMN GV 11 Ramsel
66,Bergstraat 71,2019-11-13,12:00:00,178,140,38,FMN GV 11 Ramsel
66,Bergstraat 71,2019-11-13,13:00:00,34,24,10,FMN GV 11 Ramsel
66,Bergstraat 71,2019-11-13,14:00:00,66,34,32,FMN GV 11 Ramsel
66,Bergstraat 71,2019-11-13,15:00:00,74,54,20,FMN GV 11 Ramsel
66,Bergstraat 71,2019-11-13,16:00:00,68,34,34,FMN GV 11 Ramsel
66,Bergstraat 71,2019-11-13,17:00:00,90,60,30,FMN GV 11 Ramsel
66,Bergstraat 71,2019-11-13,18:00:00,38,26,12,FMN GV 11 Ramsel
66,Bergstraat 71,2019-11-13,19:00:00,12,6,6,FMN GV 11 Ramsel
66,Bergstraat 71,2019-11-13,20:00:00,6,4,2,FMN GV 11 Ramsel
66,Bergstraat 71,2019-11-13,21:00:00,0,0,0,FMN GV 11 Ramsel
66,Bergstraat 71,2019-11-13,22:00:00,8,6,2,FMN GV 11 Ramsel
66,Bergstraat 71,2019-11-13,23:00:00,4,4,0,FMN GV 11 Ramsel
66,Bergstraat 71,2019-11-14,00:00:00,0,0,0,FMN GV 11 Ramsel
66,Bergstraat 71,2019-11-14,01:00:00,0,0,0,FMN GV 11 Ramsel
66,Bergstraat 71,2019-11-14,02:00:00,0,0,0,FMN GV 11 Ramsel
66,Bergstraat 71,2019-11-14,03:00:00,2,0,2,FMN GV 11 Ramsel
66,Bergstraat 71,2019-11-14,04:00:00,4,4,0,FMN GV 11 Ramsel
66,Bergstraat 71,2019-11-14,05:00:00,14,10,4,FMN GV 11 Ramsel
66,Bergstraat 71,2019-11-14,06:00:00,48,8,40,FMN GV 11 Ramsel
66,Bergstraat 71,2019-11-14,07:00:00,122,12,110,FMN GV 11 Ramsel
66,Bergstraat 71,2019-11-14,08:00:00,110,6,104,FMN GV 11 Ramsel
66,Bergstraat 71,2019-11-14,09:00:00,28,8,20,FMN GV 11 Ramsel
66,Bergstraat 71,2019-11-14,10:00:00,22,18,4,FMN GV 11 Ramsel
66,Bergstraat 71,2019-11-14,11:00:00,12,8,4,FMN GV 11 Ramsel
66,Bergstraat 71,2019-11-14,12:00:00,40,22,18,FMN GV 11 Ramsel
66,Bergstraat 71,2019-11-14,13:00:00,88,46,42,FMN GV 11 Ramsel
66,Bergstraat 71,2019-11-14,14:00:00,96,54,42,FMN GV 11 Ramsel
66,Bergstraat 71,2019-11-14,15:00:00,112,98,14,FMN GV 11 Ramsel
66,Bergstraat 71,2019-11-14,16:00:00,120,102,18,FMN GV 11 Ramsel
66,Bergstraat 71,2019-11-14,17:00:00,60,48,12,FMN GV 11 Ramsel
66,Bergstraat 71,2019-11-14,18:00:00,36,22,14,FMN GV 11 Ramsel
66,Bergstraat 71,2019-11-14,19:00:00,14,10,4,FMN GV 11 Ramsel
66,Bergstraat 71,2019-11-14,20:00:00,4,2,2,FMN GV 11 Ramsel
66,Bergstraat 71,2019-11-14,21:00:00,4,4,0,FMN GV 11 Ramsel
66,Bergstraat 71,2019-11-14,22:00:00,10,8,2,FMN GV 11 Ramsel
66,Bergstraat 71,2019-11-14,23:00:00,2,2,0,FMN GV 11 Ramsel
66,Bergstraat 71,2019-11-15,00:00:00,0,0,0,FMN GV 11 Ramsel
66,Bergstraat 71,2019-11-15,01:00:00,0,0,0,FMN GV 11 Ramsel
66,Bergstraat 71,2019-11-15,02:00:00,0,0,0,FMN GV 11 Ramsel
66,Bergstraat 71,2019-11-15,03:00:00,0,0,0,FMN GV 11 Ramsel
66,Bergstraat 71,2019-11-15,04:00:00,4,2,2,FMN GV 11 Ramsel
66,Bergstraat 71,2019-11-15,05:00:00,12,8,4,FMN GV 11 Ramsel
66,Bergstraat 71,2019-11-15,06:00:00,20,2,18,FMN GV 11 Ramsel
66,Bergstraat 71,2019-11-15,07:00:00,112,14,98,FMN GV 11 Ramsel
66,Bergstraat 71,2019-11-15,08:00:00,106,16,90,FMN GV 11 Ramsel
66,Bergstraat 71,2019-11-15,09:00:00,32,6,26,FMN GV 11 Ramsel
66,Bergstraat 71,2019-11-15,10:00:00,22,12,10,FMN GV 11 Ramsel
66,Bergstraat 71,2019-11-15,11:00:00,20,10,10,FMN GV 11 Ramsel
66,Bergstraat 71,2019-11-15,12:00:00,42,20,22,FMN GV 11 Ramsel
66,Bergstraat 71,2019-11-15,13:00:00,54,36,18,FMN GV 11 Ramsel
66,Bergstraat 71,2019-11-15,14:00:00,84,50,34,FMN GV 11 Ramsel
66,Bergstraat 71,2019-11-15,15:00:00,156,114,42,FMN GV 11 Ramsel
66,Bergstraat 71,2019-11-15,16:00:00,66,56,10,FMN GV 11 Ramsel
66,Bergstraat 71,2019-11-15,17:00:00,74,52,22,FMN GV 11 Ramsel
66,Bergstraat 71,2019-11-15,18:00:00,16,6,10,FMN GV 11 Ramsel
66,Bergstraat 71,2019-11-15,19:00:00,18,12,6,FMN GV 11 Ramsel
66,Bergstraat 71,2019-11-15,20:00:00,12,10,2,FMN GV 11 Ramsel
66,Bergstraat 71,2019-11-15,21:00:00,6,4,2,FMN GV 11 Ramsel
66,Bergstraat 71,2019-11-15,22:00:00,0,0,0,FMN GV 11 Ramsel
66,Bergstraat 71,2019-11-15,23:00:00,2,0,2,FMN GV 11 Ramsel
66,Bergstraat 71,2019-11-16,00:00:00,2,2,0,FMN GV 11 Ramsel
66,Bergstraat 71,2019-11-16,01:00:00,0,0,0,FMN GV 11 Ramsel
66,Bergstraat 71,2019-11-16,02:00:00,2,2,0,FMN GV 11 Ramsel
66,Bergstraat 71,2019-11-16,03:00:00,0,0,0,FMN GV 11 Ramsel
66,Bergstraat 71,2019-11-16,04:00:00,2,2,0,FMN GV 11 Ramsel
66,Bergstraat 71,2019-11-16,05:00:00,6,2,4,FMN GV 11 Ramsel
66,Bergstraat 71,2019-11-16,06:00:00,0,0,0,FMN GV 11 Ramsel
66,Bergstraat 71,2019-11-16,07:00:00,10,2,8,FMN GV 11 Ramsel
66,Bergstraat 71,2019-11-16,08:00:00,8,2,6,FMN GV 11 Ramsel
66,Bergstraat 71,2019-11-16,09:00:00,44,18,26,FMN GV 11 Ramsel
66,Bergstraat 71,2019-11-16,10:00:00,32,14,18,FMN GV 11 Ramsel
66,Bergstraat 71,2019-11-16,11:00:00,66,40,26,FMN GV 11 Ramsel
66,Bergstraat 71,2019-11-16,12:00:00,76,24,52,FMN GV 11 Ramsel
66,Bergstraat 71,2019-11-16,13:00:00,102,42,60,FMN GV 11 Ramsel
66,Bergstraat 71,2019-11-16,14:00:00,80,24,56,FMN GV 11 Ramsel
66,Bergstraat 71,2019-11-16,15:00:00,76,38,38,FMN GV 11 Ramsel
66,Bergstraat 71,2019-11-16,16:00:00,68,50,18,FMN GV 11 Ramsel
66,Bergstraat 71,2019-11-16,17:00:00,44,36,8,FMN GV 11 Ramsel
66,Bergstraat 71,2019-11-16,18:00:00,12,10,2,FMN GV 11 Ramsel
66,Bergstraat 71,2019-11-16,19:00:00,4,0,4,FMN GV 11 Ramsel
66,Bergstraat 71,2019-11-16,20:00:00,8,0,8,FMN GV 11 Ramsel
66,Bergstraat 71,2019-11-16,21:00:00,8,8,0,FMN GV 11 Ramsel
66,Bergstraat 71,2019-11-16,22:00:00,4,2,2,FMN GV 11 Ramsel
66,Bergstraat 71,2019-11-16,23:00:00,2,2,0,FMN GV 11 Ramsel
66,Bergstraat 71,2019-11-17,00:00:00,0,0,0,FMN GV 11 Ramsel
66,Bergstraat 71,2019-11-17,01:00:00,2,2,0,FMN GV 11 Ramsel
66,Bergstraat 71,2019-11-17,02:00:00,2,2,0,FMN GV 11 Ramsel
66,Bergstraat 71,2019-11-17,03:00:00,4,4,0,FMN GV 11 Ramsel
66,Bergstraat 71,2019-11-17,04:00:00,2,0,2,FMN GV 11 Ramsel
66,Bergstraat 71,2019-11-17,05:00:00,4,2,2,FMN GV 11 Ramsel
66,Bergstraat 71,2019-11-17,06:00:00,0,0,0,FMN GV 11 Ramsel
66,Bergstraat 71,2019-11-17,07:00:00,8,0,8,FMN GV 11 Ramsel
66,Bergstraat 71,2019-11-17,08:00:00,40,10,30,FMN GV 11 Ramsel
66,Bergstraat 71,2019-11-17,09:00:00,42,18,24,FMN GV 11 Ramsel
66,Bergstraat 71,2019-11-17,10:00:00,54,26,28,FMN GV 11 Ramsel
66,Bergstraat 71,2019-11-17,11:00:00,94,40,54,FMN GV 11 Ramsel
66,Bergstraat 71,2019-11-17,12:00:00,104,76,28,FMN GV 11 Ramsel
66,Bergstraat 71,2019-11-17,13:00:00,102,42,60,FMN GV 11 Ramsel
66,Bergstraat 71,2019-11-17,14:00:00,88,46,42,FMN GV 11 Ramsel
66,Bergstraat 71,2019-11-17,15:00:00,60,28,32,FMN GV 11 Ramsel
66,Bergstraat 71,2019-11-17,16:00:00,26,18,8,FMN GV 11 Ramsel
66,Bergstraat 71,2019-11-17,17:00:00,28,6,22,FMN GV 11 Ramsel
66,Bergstraat 71,2019-11-17,18:00:00,6,4,2,FMN GV 11 Ramsel
66,Bergstraat 71,2019-11-17,19:00:00,0,0,0,FMN GV 11 Ramsel
66,Bergstraat 71,2019-11-17,20:00:00,8,4,4,FMN GV 11 Ramsel
66,Bergstraat 71,2019-11-17,21:00:00,2,0,2,FMN GV 11 Ramsel
66,Bergstraat 71,2019-11-17,22:00:00,0,0,0,FMN GV 11 Ramsel
66,Bergstraat 71,2019-11-17,23:00:00,0,0,0,FMN GV 11 Ramsel
66,Bergstraat 71,2019-11-18,00:00:00,0,0,0,FMN GV 11 Ramsel
66,Bergstraat 71,2019-11-18,01:00:00,0,0,0,FMN GV 11 Ramsel
66,Bergstraat 71,2019-11-18,02:00:00,0,0,0,FMN GV 11 Ramsel
66,Bergstraat 71,2019-11-18,03:00:00,0,0,0,FMN GV 11 Ramsel
66,Bergstraat 71,2019-11-18,04:00:00,2,2,0,FMN GV 11 Ramsel
66,Bergstraat 71,2019-11-18,05:00:00,14,10,4,FMN GV 11 Ramsel
66,Bergstraat 71,2019-11-18,06:00:00,16,2,14,FMN GV 11 Ramsel
66,Bergstraat 71,2019-11-18,07:00:00,102,4,98,FMN GV 11 Ramsel
66,Bergstraat 71,2019-11-18,08:00:00,94,6,88,FMN GV 11 Ramsel
66,Bergstraat 71,2019-11-18,09:00:00,30,10,20,FMN GV 11 Ramsel
66,Bergstraat 71,2019-11-18,10:00:00,18,8,10,FMN GV 11 Ramsel
66,Bergstraat 71,2019-11-18,11:00:00,22,12,10,FMN GV 11 Ramsel
66,Bergstraat 71,2019-11-18,12:00:00,8,2,6,FMN GV 11 Ramsel
66,Bergstraat 71,2019-11-18,13:00:00,28,18,10,FMN GV 11 Ramsel
66,Bergstraat 71,2019-11-18,14:00:00,22,14,8,FMN GV 11 Ramsel
66,Bergstraat 71,2019-11-18,15:00:00,100,88,12,FMN GV 11 Ramsel
66,Bergstraat 71,2019-11-18,16:00:00,54,42,12,FMN GV 11 Ramsel
66,Bergstraat 71,2019-11-18,17:00:00,48,40,8,FMN GV 11 Ramsel
66,Bergstraat 71,2019-11-18,18:00:00,22,18,4,FMN GV 11 Ramsel
66,Bergstraat 71,2019-11-18,19:00:00,4,4,0,FMN GV 11 Ramsel
66,Bergstraat 71,2019-11-18,20:00:00,12,10,2,FMN GV 11 Ramsel
66,Bergstraat 71,2019-11-18,21:00:00,2,2,0,FMN GV 11 Ramsel
66,Bergstraat 71,2019-11-18,22:00:00,10,2,8,FMN GV 11 Ramsel
66,Bergstraat 71,2019-11-18,23:00:00,2,2,0,FMN GV 11 Ramsel
66,Bergstraat 71,2019-11-19,00:00:00,0,0,0,FMN GV 11 Ramsel
66,Bergstraat 71,2019-11-19,01:00:00,0,0,0,FMN GV 11 Ramsel
66,Bergstraat 71,2019-11-19,02:00:00,0,0,0,FMN GV 11 Ramsel
66,Bergstraat 71,2019-11-19,03:00:00,0,0,0,FMN GV 11 Ramsel
66,Bergstraat 71,2019-11-19,04:00:00,4,4,0,FMN GV 11 Ramsel
66,Bergstraat 71,2019-11-19,05:00:00,14,8,6,FMN GV 11 Ramsel
66,Bergstraat 71,2019-11-19,06:00:00,28,6,22,FMN GV 11 Ramsel
66,Bergstraat 71,2019-11-19,07:00:00,118,22,96,FMN GV 11 Ramsel
66,Bergstraat 71,2019-11-19,08:00:00,136,16,120,FMN GV 11 Ramsel
66,Bergstraat 71,2019-11-19,09:00:00,24,12,12,FMN GV 11 Ramsel
66,Bergstraat 71,2019-11-19,10:00:00,30,12,18,FMN GV 11 Ramsel
66,Bergstraat 71,2019-11-19,11:00:00,40,14,26,FMN GV 11 Ramsel
66,Bergstraat 71,2019-11-19,12:00:00,52,24,28,FMN GV 11 Ramsel
66,Bergstraat 71,2019-11-19,13:00:00,116,48,68,FMN GV 11 Ramsel
66,Bergstraat 71,2019-11-19,14:00:00,116,62,54,FMN GV 11 Ramsel
66,Bergstraat 71,2019-11-19,15:00:00,216,176,40,FMN GV 11 Ramsel
66,Bergstraat 71,2019-11-19,16:00:00,146,94,52,FMN GV 11 Ramsel
66,Bergstraat 71,2019-11-19,17:00:00,124,90,34,FMN GV 11 Ramsel
66,Bergstraat 71,2019-11-19,18:00:00,58,32,26,FMN GV 11 Ramsel
66,Bergstraat 71,2019-11-19,19:00:00,48,20,28,FMN GV 11 Ramsel
66,Bergstraat 71,2019-11-19,20:00:00,22,18,4,FMN GV 11 Ramsel
66,Bergstraat 71,2019-11-19,21:00:00,12,6,6,FMN GV 11 Ramsel
66,Bergstraat 71,2019-11-19,22:00:00,14,4,10,FMN GV 11 Ramsel
66,Bergstraat 71,2019-11-19,23:00:00,8,8,0,FMN GV 11 Ramsel
66,Bergstraat 71,2019-11-20,00:00:00,0,0,0,FMN GV 11 Ramsel
66,Bergstraat 71,2019-11-20,01:00:00,0,0,0,FMN GV 11 Ramsel
66,Bergstraat 71,2019-11-20,02:00:00,2,0,2,FMN GV 11 Ramsel
66,Bergstraat 71,2019-11-20,03:00:00,0,0,0,FMN GV 11 Ramsel
66,Bergstraat 71,2019-11-20,04:00:00,0,0,0,FMN GV 11 Ramsel
66,Bergstraat 71,2019-11-20,05:00:00,6,6,0,FMN GV 11 Ramsel
66,Bergstraat 71,2019-11-20,06:00:00,22,4,18,FMN GV 11 Ramsel
66,Bergstraat 71,2019-11-20,07:00:00,96,14,82,FMN GV 11 Ramsel
66,Bergstraat 71,2019-11-20,08:00:00,88,6,82,FMN GV 11 Ramsel
66,Bergstraat 71,2019-11-20,09:00:00,22,4,18,FMN GV 11 Ramsel
66,Bergstraat 71,2019-11-20,10:00:00,26,12,14,FMN GV 11 Ramsel
66,Bergstraat 71,2019-11-20,11:00:00,20,12,8,FMN GV 11 Ramsel
66,Bergstraat 71,2019-11-20,12:00:00,176,142,34,FMN GV 11 Ramsel
66,Bergstraat 71,2019-11-20,13:00:00,86,48,38,FMN GV 11 Ramsel
66,Bergstraat 71,2019-11-20,14:00:00,118,68,50,FMN GV 11 Ramsel
66,Bergstraat 71,2019-11-20,15:00:00,80,56,24,FMN GV 11 Ramsel
66,Bergstraat 71,2019-11-20,16:00:00,64,42,22,FMN GV 11 Ramsel
66,Bergstraat 71,2019-11-20,17:00:00,58,42,16,FMN GV 11 Ramsel
66,Bergstraat 71,2019-11-20,18:00:00,48,30,18,FMN GV 11 Ramsel
66,Bergstraat 71,2019-11-20,19:00:00,16,8,8,FMN GV 11 Ramsel
66,Bergstraat 71,2019-11-20,20:00:00,24,12,12,FMN GV 11 Ramsel
66,Bergstraat 71,2019-11-20,21:00:00,6,4,2,FMN GV 11 Ramsel
66,Bergstraat 71,2019-11-20,22:00:00,12,6,6,FMN GV 11 Ramsel
66,Bergstraat 71,2019-11-20,23:00:00,4,4,0,FMN GV 11 Ramsel
66,Bergstraat 71,2019-11-21,00:00:00,2,2,0,FMN GV 11 Ramsel
66,Bergstraat 71,2019-11-21,01:00:00,0,0,0,FMN GV 11 Ramsel
66,Bergstraat 71,2019-11-21,02:00:00,0,0,0,FMN GV 11 Ramsel
66,Bergstraat 71,2019-11-21,03:00:00,0,0,0,FMN GV 11 Ramsel
66,Bergstraat 71,2019-11-21,04:00:00,2,2,0,FMN GV 11 Ramsel
66,Bergstraat 71,2019-11-21,05:00:00,12,6,6,FMN GV 11 Ramsel
66,Bergstraat 71,2019-11-21,06:00:00,32,4,28,FMN GV 11 Ramsel
66,Bergstraat 71,2019-11-21,07:00:00,100,18,82,FMN GV 11 Ramsel
66,Bergstraat 71,2019-11-21,08:00:00,96,14,82,FMN GV 11 Ramsel
66,Bergstraat 71,2019-11-21,09:00:00,24,4,20,FMN GV 11 Ramsel
66,Bergstraat 71,2019-11-21,10:00:00,18,4,14,FMN GV 11 Ramsel
66,Bergstraat 71,2019-11-21,11:00:00,26,16,10,FMN GV 11 Ramsel
66,Bergstraat 71,2019-11-21,12:00:00,34,16,18,FMN GV 11 Ramsel
66,Bergstraat 71,2019-11-21,13:00:00,66,42,24,FMN GV 11 Ramsel
66,Bergstraat 71,2019-11-21,14:00:00,78,42,36,FMN GV 11 Ramsel
66,Bergstraat 71,2019-11-21,15:00:00,150,120,30,FMN GV 11 Ramsel
66,Bergstraat 71,2019-11-21,16:00:00,104,80,24,FMN GV 11 Ramsel
66,Bergstraat 71,2019-11-21,17:00:00,64,52,12,FMN GV 11 Ramsel
66,Bergstraat 71,2019-11-21,18:00:00,36,22,14,FMN GV 11 Ramsel
66,Bergstraat 71,2019-11-21,19:00:00,24,18,6,FMN GV 11 Ramsel
66,Bergstraat 71,2019-11-21,20:00:00,12,12,0,FMN GV 11 Ramsel
66,Bergstraat 71,2019-11-21,21:00:00,6,4,2,FMN GV 11 Ramsel
66,Bergstraat 71,2019-11-21,22:00:00,8,2,6,FMN GV 11 Ramsel
66,Bergstraat 71,2019-11-21,23:00:00,4,4,0,FMN GV 11 Ramsel
66,Bergstraat 71,2019-11-22,00:00:00,2,2,0,FMN GV 11 Ramsel
66,Bergstraat 71,2019-11-22,01:00:00,0,0,0,FMN GV 11 Ramsel
66,Bergstraat 71,2019-11-22,02:00:00,2,2,0,FMN GV 11 Ramsel
66,Bergstraat 71,2019-11-22,03:00:00,0,0,0,FMN GV 11 Ramsel
66,Bergstraat 71,2019-11-22,04:00:00,2,2,0,FMN GV 11 Ramsel
66,Bergstraat 71,2019-11-22,05:00:00,12,8,4,FMN GV 11 Ramsel
66,Bergstraat 71,2019-11-22,06:00:00,30,8,22,FMN GV 11 Ramsel
66,Bergstraat 71,2019-11-22,07:00:00,134,18,116,FMN GV 11 Ramsel
66,Bergstraat 71,2019-11-22,08:00:00,116,20,96,FMN GV 11 Ramsel
66,Bergstraat 71,2019-11-22,09:00:00,44,10,34,FMN GV 11 Ramsel
66,Bergstraat 71,2019-11-22,10:00:00,26,20,6,FMN GV 11 Ramsel
66,Bergstraat 71,2019-11-22,11:00:00,44,24,20,FMN GV 11 Ramsel
66,Bergstraat 71,2019-11-22,12:00:00,80,24,56,FMN GV 11 Ramsel
66,Bergstraat 71,2019-11-22,13:00:00,94,32,62,FMN GV 11 Ramsel
66,Bergstraat 71,2019-11-22,14:00:00,118,66,52,FMN GV 11 Ramsel
66,Bergstraat 71,2019-11-22,15:00:00,198,150,48,FMN GV 11 Ramsel
66,Bergstraat 71,2019-11-22,16:00:00,178,132,46,FMN GV 11 Ramsel
66,Bergstraat 71,2019-11-22,17:00:00,84,64,20,FMN GV 11 Ramsel
66,Bergstraat 71,2019-11-22,18:00:00,34,16,18,FMN GV 11 Ramsel
66,Bergstraat 71,2019-11-22,19:00:00,18,10,8,FMN GV 11 Ramsel
66,Bergstraat 71,2019-11-22,20:00:00,20,14,6,FMN GV 11 Ramsel
66,Bergstraat 71,2019-11-22,21:00:00,10,8,2,FMN GV 11 Ramsel
66,Bergstraat 71,2019-11-22,22:00:00,20,6,14,FMN GV 11 Ramsel
66,Bergstraat 71,2019-11-22,23:00:00,4,0,4,FMN GV 11 Ramsel
66,Bergstraat 71,2019-11-23,00:00:00,8,4,4,FMN GV 11 Ramsel
66,Bergstraat 71,2019-11-23,01:00:00,18,4,14,FMN GV 11 Ramsel
66,Bergstraat 71,2019-11-23,02:00:00,2,2,0,FMN GV 11 Ramsel
66,Bergstraat 71,2019-11-23,03:00:00,0,0,0,FMN GV 11 Ramsel
66,Bergstraat 71,2019-11-23,04:00:00,2,0,2,FMN GV 11 Ramsel
66,Bergstraat 71,2019-11-23,05:00:00,2,0,2,FMN GV 11 Ramsel
66,Bergstraat 71,2019-11-23,06:00:00,4,2,2,FMN GV 11 Ramsel
66,Bergstraat 71,2019-11-23,07:00:00,4,0,4,FMN GV 11 Ramsel
66,Bergstraat 71,2019-11-23,08:00:00,12,2,10,FMN GV 11 Ramsel
66,Bergstraat 71,2019-11-23,09:00:00,22,6,16,FMN GV 11 Ramsel
66,Bergstraat 71,2019-11-23,10:00:00,38,26,12,FMN GV 11 Ramsel
66,Bergstraat 71,2019-11-23,11:00:00,60,24,36,FMN GV 11 Ramsel
66,Bergstraat 71,2019-11-23,12:00:00,42,18,24,FMN GV 11 Ramsel
66,Bergstraat 71,2019-11-23,13:00:00,108,36,72,FMN GV 11 Ramsel
66,Bergstraat 71,2019-11-23,14:00:00,68,44,24,FMN GV 11 Ramsel
66,Bergstraat 71,2019-11-23,15:00:00,72,38,34,FMN GV 11 Ramsel
66,Bergstraat 71,2019-11-23,16:00:00,42,32,10,FMN GV 11 Ramsel
66,Bergstraat 71,2019-11-23,17:00:00,26,22,4,FMN GV 11 Ramsel
66,Bergstraat 71,2019-11-23,18:00:00,14,4,10,FMN GV 11 Ramsel
66,Bergstraat 71,2019-11-23,19:00:00,10,6,4,FMN GV 11 Ramsel
66,Bergstraat 71,2019-11-23,20:00:00,8,4,4,FMN GV 11 Ramsel
66,Bergstraat 71,2019-11-23,21:00:00,4,0,4,FMN GV 11 Ramsel
66,Bergstraat 71,2019-11-23,22:00:00,6,6,0,FMN GV 11 Ramsel
66,Bergstraat 71,2019-11-23,23:00:00,6,6,0,FMN GV 11 Ramsel
66,Bergstraat 71,2019-11-24,00:00:00,4,2,2,FMN GV 11 Ramsel
66,Bergstraat 71,2019-11-24,01:00:00,2,0,2,FMN GV 11 Ramsel
66,Bergstraat 71,2019-11-24,02:00:00,6,2,4,FMN GV 11 Ramsel
66,Bergstraat 71,2019-11-24,03:00:00,6,0,6,FMN GV 11 Ramsel
66,Bergstraat 71,2019-11-24,04:00:00,0,0,0,FMN GV 11 Ramsel
66,Bergstraat 71,2019-11-24,05:00:00,0,0,0,FMN GV 11 Ramsel
66,Bergstraat 71,2019-11-24,06:00:00,4,2,2,FMN GV 11 Ramsel
66,Bergstraat 71,2019-11-24,07:00:00,6,0,6,FMN GV 11 Ramsel
66,Bergstraat 71,2019-11-24,08:00:00,54,12,42,FMN GV 11 Ramsel
66,Bergstraat 71,2019-11-24,09:00:00,56,28,28,FMN GV 11 Ramsel
66,Bergstraat 71,2019-11-24,10:00:00,76,44,32,FMN GV 11 Ramsel
66,Bergstraat 71,2019-11-24,11:00:00,154,82,72,FMN GV 11 Ramsel
66,Bergstraat 71,2019-11-24,12:00:00,72,28,44,FMN GV 11 Ramsel
66,Bergstraat 71,2019-11-24,13:00:00,104,70,34,FMN GV 11 Ramsel
66,Bergstraat 71,2019-11-24,14:00:00,78,50,28,FMN GV 11 Ramsel
66,Bergstraat 71,2019-11-24,15:00:00,88,46,42,FMN GV 11 Ramsel
66,Bergstraat 71,2019-11-24,16:00:00,34,26,8,FMN GV 11 Ramsel
66,Bergstraat 71,2019-11-24,17:00:00,16,2,14,FMN GV 11 Ramsel
66,Bergstraat 71,2019-11-24,18:00:00,12,6,6,FMN GV 11 Ramsel
66,Bergstraat 71,2019-11-24,19:00:00,4,0,4,FMN GV 11 Ramsel
66,Bergstraat 71,2019-11-24,20:00:00,6,4,2,FMN GV 11 Ramsel
66,Bergstraat 71,2019-11-24,21:00:00,4,2,2,FMN GV 11 Ramsel
66,Bergstraat 71,2019-11-24,22:00:00,4,2,2,FMN GV 11 Ramsel
66,Bergstraat 71,2019-11-24,23:00:00,0,0,0,FMN GV 11 Ramsel
66,Bergstraat 71,2019-11-25,00:00:00,2,0,2,FMN GV 11 Ramsel
66,Bergstraat 71,2019-11-25,01:00:00,0,0,0,FMN GV 11 Ramsel
66,Bergstraat 71,2019-11-25,02:00:00,0,0,0,FMN GV 11 Ramsel
66,Bergstraat 71,2019-11-25,03:00:00,0,0,0,FMN GV 11 Ramsel
66,Bergstraat 71,2019-11-25,04:00:00,4,2,2,FMN GV 11 Ramsel
66,Bergstraat 71,2019-11-25,05:00:00,16,14,2,FMN GV 11 Ramsel
66,Bergstraat 71,2019-11-25,06:00:00,26,2,24,FMN GV 11 Ramsel
66,Bergstraat 71,2019-11-25,07:00:00,154,18,136,FMN GV 11 Ramsel
66,Bergstraat 71,2019-11-25,08:00:00,130,22,108,FMN GV 11 Ramsel
66,Bergstraat 71,2019-11-25,09:00:00,48,14,34,FMN GV 11 Ramsel
66,Bergstraat 71,2019-11-25,10:00:00,52,30,22,FMN GV 11 Ramsel
66,Bergstraat 71,2019-11-25,11:00:00,32,22,10,FMN GV 11 Ramsel
66,Bergstraat 71,2019-11-25,12:00:00,44,18,26,FMN GV 11 Ramsel
66,Bergstraat 71,2019-11-25,13:00:00,108,52,56,FMN GV 11 Ramsel
66,Bergstraat 71,2019-11-25,14:00:00,120,60,60,FMN GV 11 Ramsel
66,Bergstraat 71,2019-11-25,15:00:00,252,178,74,FMN GV 11 Ramsel
66,Bergstraat 71,2019-11-25,16:00:00,168,136,32,FMN GV 11 Ramsel
66,Bergstraat 71,2019-11-25,17:00:00,96,72,24,FMN GV 11 Ramsel
66,Bergstraat 71,2019-11-25,18:00:00,24,16,8,FMN GV 11 Ramsel
66,Bergstraat 71,2019-11-25,19:00:00,18,10,8,FMN GV 11 Ramsel
66,Bergstraat 71,2019-11-25,20:00:00,14,10,4,FMN GV 11 Ramsel
66,Bergstraat 71,2019-11-25,21:00:00,6,2,4,FMN GV 11 Ramsel
66,Bergstraat 71,2019-11-25,22:00:00,12,10,2,FMN GV 11 Ramsel
66,Bergstraat 71,2019-11-25,23:00:00,0,0,0,FMN GV 11 Ramsel
66,Bergstraat 71,2019-11-26,00:00:00,0,0,0,FMN GV 11 Ramsel
66,Bergstraat 71,2019-11-26,01:00:00,0,0,0,FMN GV 11 Ramsel
66,Bergstraat 71,2019-11-26,02:00:00,0,0,0,FMN GV 11 Ramsel
66,Bergstraat 71,2019-11-26,03:00:00,0,0,0,FMN GV 11 Ramsel
66,Bergstraat 71,2019-11-26,04:00:00,4,4,0,FMN GV 11 Ramsel
66,Bergstraat 71,2019-11-26,05:00:00,16,10,6,FMN GV 11 Ramsel
66,Bergstraat 71,2019-11-26,06:00:00,44,10,34,FMN GV 11 Ramsel
66,Bergstraat 71,2019-11-26,07:00:00,138,22,116,FMN GV 11 Ramsel
66,Bergstraat 71,2019-11-26,08:00:00,126,26,100,FMN GV 11 Ramsel
66,Bergstraat 71,2019-11-26,09:00:00,50,16,34,FMN GV 11 Ramsel
66,Bergstraat 71,2019-11-26,10:00:00,40,20,20,FMN GV 11 Ramsel
66,Bergstraat 71,2019-11-26,11:00:00,52,24,28,FMN GV 11 Ramsel
66,Bergstraat 71,2019-11-26,12:00:00,48,28,20,FMN GV 11 Ramsel
66,Bergstraat 71,2019-11-26,13:00:00,44,18,26,FMN GV 11 Ramsel
66,Bergstraat 71,2019-11-26,14:00:00,48,32,16,FMN GV 11 Ramsel
66,Bergstraat 71,2019-11-26,15:00:00,120,98,22,FMN GV 11 Ramsel
66,Bergstraat 71,2019-11-26,16:00:00,138,108,30,FMN GV 11 Ramsel
66,Bergstraat 71,2019-11-26,17:00:00,72,48,24,FMN GV 11 Ramsel
66,Bergstraat 71,2019-11-26,18:00:00,26,18,8,FMN GV 11 Ramsel
66,Bergstraat 71,2019-11-26,19:00:00,24,12,12,FMN GV 11 Ramsel
66,Bergstraat 71,2019-11-26,20:00:00,16,14,2,FMN GV 11 Ramsel
66,Bergstraat 71,2019-11-26,21:00:00,4,2,2,FMN GV 11 Ramsel
66,Bergstraat 71,2019-11-26,22:00:00,8,4,4,FMN GV 11 Ramsel
66,Bergstraat 71,2019-11-26,23:00:00,4,4,0,FMN GV 11 Ramsel
66,Bergstraat 71,2019-11-27,00:00:00,0,0,0,FMN GV 11 Ramsel
66,Bergstraat 71,2019-11-27,01:00:00,0,0,0,FMN GV 11 Ramsel
66,Bergstraat 71,2019-11-27,02:00:00,0,0,0,FMN GV 11 Ramsel
66,Bergstraat 71,2019-11-27,03:00:00,0,0,0,FMN GV 11 Ramsel
66,Bergstraat 71,2019-11-27,04:00:00,2,2,0,FMN GV 11 Ramsel
66,Bergstraat 71,2019-11-27,05:00:00,10,8,2,FMN GV 11 Ramsel
66,Bergstraat 71,2019-11-27,06:00:00,26,4,22,FMN GV 11 Ramsel
66,Bergstraat 71,2019-11-27,07:00:00,100,14,86,FMN GV 11 Ramsel
66,Bergstraat 71,2019-11-27,08:00:00,120,12,108,FMN GV 11 Ramsel
66,Bergstraat 71,2019-11-27,09:00:00,24,8,16,FMN GV 11 Ramsel
66,Bergstraat 71,2019-11-27,10:00:00,34,20,14,FMN GV 11 Ramsel
66,Bergstraat 71,2019-11-27,11:00:00,22,16,6,FMN GV 11 Ramsel
66,Bergstraat 71,2019-11-27,12:00:00,144,124,20,FMN GV 11 Ramsel
66,Bergstraat 71,2019-11-27,13:00:00,32,24,8,FMN GV 11 Ramsel
66,Bergstraat 71,2019-11-27,14:00:00,20,8,12,FMN GV 11 Ramsel
66,Bergstraat 71,2019-11-27,15:00:00,28,12,16,FMN GV 11 Ramsel
66,Bergstraat 71,2019-11-27,16:00:00,36,28,8,FMN GV 11 Ramsel
66,Bergstraat 71,2019-11-27,17:00:00,46,32,14,FMN GV 11 Ramsel
66,Bergstraat 71,2019-11-27,18:00:00,22,8,14,FMN GV 11 Ramsel
66,Bergstraat 71,2019-11-27,19:00:00,10,10,0,FMN GV 11 Ramsel
66,Bergstraat 71,2019-11-27,20:00:00,6,4,2,FMN GV 11 Ramsel
66,Bergstraat 71,2019-11-27,21:00:00,0,0,0,FMN GV 11 Ramsel
66,Bergstraat 71,2019-11-27,22:00:00,6,2,4,FMN GV 11 Ramsel
66,Bergstraat 71,2019-11-27,23:00:00,2,2,0,FMN GV 11 Ramsel
66,Bergstraat 71,2019-11-28,00:00:00,0,0,0,FMN GV 11 Ramsel
66,Bergstraat 71,2019-11-28,01:00:00,0,0,0,FMN GV 11 Ramsel
66,Bergstraat 71,2019-11-28,02:00:00,0,0,0,FMN GV 11 Ramsel
66,Bergstraat 71,2019-11-28,03:00:00,0,0,0,FMN GV 11 Ramsel
66,Bergstraat 71,2019-11-28,04:00:00,4,2,2,FMN GV 11 Ramsel
66,Bergstraat 71,2019-11-28,05:00:00,12,10,2,FMN GV 11 Ramsel
66,Bergstraat 71,2019-11-28,06:00:00,16,2,14,FMN GV 11 Ramsel
66,Bergstraat 71,2019-11-28,07:00:00,90,8,82,FMN GV 11 Ramsel
66,Bergstraat 71,2019-11-28,08:00:00,86,6,80,FMN GV 11 Ramsel
66,Bergstraat 71,2019-11-28,09:00:00,18,4,14,FMN GV 11 Ramsel
66,Bergstraat 71,2019-11-28,10:00:00,16,6,10,FMN GV 11 Ramsel
66,Bergstraat 71,2019-11-28,11:00:00,16,12,4,FMN GV 11 Ramsel
66,Bergstraat 71,2019-11-28,12:00:00,12,8,4,FMN GV 11 Ramsel
66,Bergstraat 71,2019-11-28,13:00:00,16,8,8,FMN GV 11 Ramsel
66,Bergstraat 71,2019-11-28,14:00:00,18,6,12,FMN GV 11 Ramsel
66,Bergstraat 71,2019-11-28,15:00:00,76,56,20,FMN GV 11 Ramsel
66,Bergstraat 71,2019-11-28,16:00:00,62,48,14,FMN GV 11 Ramsel
66,Bergstraat 71,2019-11-28,17:00:00,40,28,12,FMN GV 11 Ramsel
66,Bergstraat 71,2019-11-28,18:00:00,24,18,6,FMN GV 11 Ramsel
66,Bergstraat 71,2019-11-28,19:00:00,4,2,2,FMN GV 11 Ramsel
66,Bergstraat 71,2019-11-28,20:00:00,8,4,4,FMN GV 11 Ramsel
66,Bergstraat 71,2019-11-28,21:00:00,4,4,0,FMN GV 11 Ramsel
66,Bergstraat 71,2019-11-28,22:00:00,2,2,0,FMN GV 11 Ramsel
66,Bergstraat 71,2019-11-28,23:00:00,0,0,0,FMN GV 11 Ramsel
66,Bergstraat 71,2019-11-29,00:00:00,0,0,0,FMN GV 11 Ramsel
66,Bergstraat 71,2019-11-29,01:00:00,0,0,0,FMN GV 11 Ramsel
66,Bergstraat 71,2019-11-29,02:00:00,0,0,0,FMN GV 11 Ramsel
66,Bergstraat 71,2019-11-29,03:00:00,0,0,0,FMN GV 11 Ramsel
66,Bergstraat 71,2019-11-29,04:00:00,2,2,0,FMN GV 11 Ramsel
66,Bergstraat 71,2019-11-29,05:00:00,6,6,0,FMN GV 11 Ramsel
66,Bergstraat 71,2019-11-29,06:00:00,28,10,18,FMN GV 11 Ramsel
66,Bergstraat 71,2019-11-29,07:00:00,146,20,126,FMN GV 11 Ramsel
66,Bergstraat 71,2019-11-29,08:00:00,126,20,106,FMN GV 11 Ramsel
66,Bergstraat 71,2019-11-29,09:00:00,22,6,16,FMN GV 11 Ramsel
66,Bergstraat 71,2019-11-29,10:00:00,28,6,22,FMN GV 11 Ramsel
66,Bergstraat 71,2019-11-29,11:00:00,34,16,18,FMN GV 11 Ramsel
66,Bergstraat 71,2019-11-29,12:00:00,66,28,38,FMN GV 11 Ramsel
66,Bergstraat 71,2019-11-29,13:00:00,88,50,38,FMN GV 11 Ramsel
66,Bergstraat 71,2019-11-29,14:00:00,82,38,44,FMN GV 11 Ramsel
66,Bergstraat 71,2019-11-29,15:00:00,168,134,34,FMN GV 11 Ramsel
66,Bergstraat 71,2019-11-29,16:00:00,100,78,22,FMN GV 11 Ramsel
66,Bergstraat 71,2019-11-29,17:00:00,70,60,10,FMN GV 11 Ramsel
66,Bergstraat 71,2019-11-29,18:00:00,36,20,16,FMN GV 11 Ramsel
66,Bergstraat 71,2019-11-29,19:00:00,28,14,14,FMN GV 11 Ramsel
66,Bergstraat 71,2019-11-29,20:00:00,16,14,2,FMN GV 11 Ramsel
66,Bergstraat 71,2019-11-29,21:00:00,8,6,2,FMN GV 11 Ramsel
66,Bergstraat 71,2019-11-29,22:00:00,8,6,2,FMN GV 11 Ramsel
66,Bergstraat 71,2019-11-29,23:00:00,2,0,2,FMN GV 11 Ramsel
66,Bergstraat 71,2019-11-30,00:00:00,14,2,12,FMN GV 11 Ramsel
66,Bergstraat 71,2019-11-30,01:00:00,10,6,4,FMN GV 11 Ramsel
66,Bergstraat 71,2019-11-30,02:00:00,2,2,0,FMN GV 11 Ramsel
66,Bergstraat 71,2019-11-30,03:00:00,0,0,0,FMN GV 11 Ramsel
66,Bergstraat 71,2019-11-30,04:00:00,0,0,0,FMN GV 11 Ramsel
66,Bergstraat 71,2019-11-30,05:00:00,4,0,4,FMN GV 11 Ramsel
66,Bergstraat 71,2019-11-30,06:00:00,4,0,4,FMN GV 11 Ramsel
66,Bergstraat 71,2019-11-30,07:00:00,8,4,4,FMN GV 11 Ramsel
66,Bergstraat 71,2019-11-30,08:00:00,8,0,8,FMN GV 11 Ramsel
66,Bergstraat 71,2019-11-30,09:00:00,20,6,14,FMN GV 11 Ramsel
66,Bergstraat 71,2019-11-30,10:00:00,40,18,22,FMN GV 11 Ramsel
66,Bergstraat 71,2019-11-30,11:00:00,30,16,14,FMN GV 11 Ramsel
66,Bergstraat 71,2019-11-30,12:00:00,64,28,36,FMN GV 11 Ramsel
66,Bergstraat 71,2019-11-30,13:00:00,100,38,62,FMN GV 11 Ramsel
66,Bergstraat 71,2019-11-30,14:00:00,80,34,46,FMN GV 11 Ramsel
66,Bergstraat 71,2019-11-30,15:00:00,122,82,40,FMN GV 11 Ramsel
66,Bergstraat 71,2019-11-30,16:00:00,60,44,16,FMN GV 11 Ramsel
66,Bergstraat 71,2019-11-30,17:00:00,18,12,6,FMN GV 11 Ramsel
66,Bergstraat 71,2019-11-30,18:00:00,12,0,12,FMN GV 11 Ramsel
66,Bergstraat 71,2019-11-30,19:00:00,8,4,4,FMN GV 11 Ramsel
66,Bergstraat 71,2019-11-30,20:00:00,0,0,0,FMN GV 11 Ramsel
66,Bergstraat 71,2019-11-30,21:00:00,2,2,0,FMN GV 11 Ramsel
66,Bergstraat 71,2019-11-30,22:00:00,6,4,2,FMN GV 11 Ramsel
66,Bergstraat 71,2019-11-30,23:00:00,2,2,0,FMN GV 11 Ramsel
66,Bergstraat 71,2019-12-01,00:00:00,0,0,0,FMN GV 11 Ramsel
66,Bergstraat 71,2019-12-01,01:00:00,0,0,0,FMN GV 11 Ramsel
66,Bergstraat 71,2019-12-01,02:00:00,10,8,2,FMN GV 11 Ramsel
66,Bergstraat 71,2019-12-01,03:00:00,0,0,0,FMN GV 11 Ramsel
66,Bergstraat 71,2019-12-01,04:00:00,0,0,0,FMN GV 11 Ramsel
66,Bergstraat 71,2019-12-01,05:00:00,0,0,0,FMN GV 11 Ramsel
66,Bergstraat 71,2019-12-01,06:00:00,8,2,6,FMN GV 11 Ramsel
66,Bergstraat 71,2019-12-01,07:00:00,4,2,2,FMN GV 11 Ramsel
66,Bergstraat 71,2019-12-01,08:00:00,16,8,8,FMN GV 11 Ramsel
66,Bergstraat 71,2019-12-01,09:00:00,64,30,34,FMN GV 11 Ramsel
66,Bergstraat 71,2019-12-01,10:00:00,42,18,24,FMN GV 11 Ramsel
66,Bergstraat 71,2019-12-01,11:00:00,22,10,12,FMN GV 11 Ramsel
66,Bergstraat 71,2019-12-01,12:00:00,34,20,14,FMN GV 11 Ramsel
66,Bergstraat 71,2019-12-01,13:00:00,34,28,6,FMN GV 11 Ramsel
66,Bergstraat 71,2019-12-01,14:00:00,56,24,32,FMN GV 11 Ramsel
66,Bergstraat 71,2019-12-01,15:00:00,24,10,14,FMN GV 11 Ramsel
66,Bergstraat 71,2019-12-01,16:00:00,24,16,8,FMN GV 11 Ramsel
66,Bergstraat 71,2019-12-01,17:00:00,14,8,6,FMN GV 11 Ramsel
66,Bergstraat 71,2019-12-01,18:00:00,8,6,2,FMN GV 11 Ramsel
66,Bergstraat 71,2019-12-01,19:00:00,10,2,8,FMN GV 11 Ramsel
66,Bergstraat 71,2019-12-01,20:00:00,2,2,0,FMN GV 11 Ramsel
66,Bergstraat 71,2019-12-01,21:00:00,4,4,0,FMN GV 11 Ramsel
66,Bergstraat 71,2019-12-01,22:00:00,0,0,0,FMN GV 11 Ramsel
66,Bergstraat 71,2019-12-01,23:00:00,0,0,0,FMN GV 11 Ramsel
66,Bergstraat 71,2019-12-02,00:00:00,2,0,2,FMN GV 11 Ramsel
66,Bergstraat 71,2019-12-02,01:00:00,0,0,0,FMN GV 11 Ramsel
66,Bergstraat 71,2019-12-02,02:00:00,0,0,0,FMN GV 11 Ramsel
66,Bergstraat 71,2019-12-02,03:00:00,2,0,2,FMN GV 11 Ramsel
66,Bergstraat 71,2019-12-02,04:00:00,0,0,0,FMN GV 11 Ramsel
66,Bergstraat 71,2019-12-02,05:00:00,8,4,4,FMN GV 11 Ramsel
66,Bergstraat 71,2019-12-02,06:00:00,34,6,28,FMN GV 11 Ramsel
66,Bergstraat 71,2019-12-02,07:00:00,118,16,102,FMN GV 11 Ramsel
66,Bergstraat 71,2019-12-02,08:00:00,102,12,90,FMN GV 11 Ramsel
66,Bergstraat 71,2019-12-02,09:00:00,42,12,30,FMN GV 11 Ramsel
66,Bergstraat 71,2019-12-02,10:00:00,30,12,18,FMN GV 11 Ramsel
66,Bergstraat 71,2019-12-02,11:00:00,20,4,16,FMN GV 11 Ramsel
66,Bergstraat 71,2019-12-02,12:00:00,38,22,16,FMN GV 11 Ramsel
66,Bergstraat 71,2019-12-02,13:00:00,64,30,34,FMN GV 11 Ramsel
66,Bergstraat 71,2019-12-02,14:00:00,70,34,36,FMN GV 11 Ramsel
66,Bergstraat 71,2019-12-02,15:00:00,162,110,52,FMN GV 11 Ramsel
66,Bergstraat 71,2019-12-02,16:00:00,138,114,24,FMN GV 11 Ramsel
66,Bergstraat 71,2019-12-02,17:00:00,84,66,18,FMN GV 11 Ramsel
66,Bergstraat 71,2019-12-02,18:00:00,36,26,10,FMN GV 11 Ramsel
66,Bergstraat 71,2019-12-02,19:00:00,16,10,6,FMN GV 11 Ramsel
66,Bergstraat 71,2019-12-02,20:00:00,8,6,2,FMN GV 11 Ramsel
66,Bergstraat 71,2019-12-02,21:00:00,6,2,4,FMN GV 11 Ramsel
66,Bergstraat 71,2019-12-02,22:00:00,20,8,12,FMN GV 11 Ramsel
66,Bergstraat 71,2019-12-02,23:00:00,8,6,2,FMN GV 11 Ramsel
66,Bergstraat 71,2019-12-03,00:00:00,0,0,0,FMN GV 11 Ramsel
66,Bergstraat 71,2019-12-03,01:00:00,2,2,0,FMN GV 11 Ramsel
66,Bergstraat 71,2019-12-03,02:00:00,0,0,0,FMN GV 11 Ramsel
66,Bergstraat 71,2019-12-03,03:00:00,0,0,0,FMN GV 11 Ramsel
66,Bergstraat 71,2019-12-03,04:00:00,0,0,0,FMN GV 11 Ramsel
66,Bergstraat 71,2019-12-03,05:00:00,8,4,4,FMN GV 11 Ramsel
66,Bergstraat 71,2019-12-03,06:00:00,22,2,20,FMN GV 11 Ramsel
66,Bergstraat 71,2019-12-03,07:00:00,120,12,108,FMN GV 11 Ramsel
66,Bergstraat 71,2019-12-03,08:00:00,108,16,92,FMN GV 11 Ramsel
66,Bergstraat 71,2019-12-03,09:00:00,20,4,16,FMN GV 11 Ramsel
66,Bergstraat 71,2019-12-03,10:00:00,30,20,10,FMN GV 11 Ramsel
66,Bergstraat 71,2019-12-03,11:00:00,20,12,8,FMN GV 11 Ramsel
66,Bergstraat 71,2019-12-03,12:00:00,86,28,58,FMN GV 11 Ramsel
66,Bergstraat 71,2019-12-03,13:00:00,136,46,90,FMN GV 11 Ramsel
66,Bergstraat 71,2019-12-03,14:00:00,114,62,52,FMN GV 11 Ramsel
66,Bergstraat 71,2019-12-03,15:00:00,170,142,28,FMN GV 11 Ramsel
66,Bergstraat 71,2019-12-03,16:00:00,128,100,28,FMN GV 11 Ramsel
66,Bergstraat 71,2019-12-03,17:00:00,74,48,26,FMN GV 11 Ramsel
66,Bergstraat 71,2019-12-03,18:00:00,44,34,10,FMN GV 11 Ramsel
66,Bergstraat 71,2019-12-03,19:00:00,42,18,24,FMN GV 11 Ramsel
66,Bergstraat 71,2019-12-03,20:00:00,34,28,6,FMN GV 11 Ramsel
66,Bergstraat 71,2019-12-03,21:00:00,4,4,0,FMN GV 11 Ramsel
66,Bergstraat 71,2019-12-03,22:00:00,10,2,8,FMN GV 11 Ramsel
66,Bergstraat 71,2019-12-03,23:00:00,4,0,4,FMN GV 11 Ramsel
66,Bergstraat 71,2019-12-04,00:00:00,0,0,0,FMN GV 11 Ramsel
66,Bergstraat 71,2019-12-04,01:00:00,0,0,0,FMN GV 11 Ramsel
66,Bergstraat 71,2019-12-04,02:00:00,0,0,0,FMN GV 11 Ramsel
66,Bergstraat 71,2019-12-04,03:00:00,0,0,0,FMN GV 11 Ramsel
66,Bergstraat 71,2019-12-04,04:00:00,2,0,2,FMN GV 11 Ramsel
66,Bergstraat 71,2019-12-04,05:00:00,6,4,2,FMN GV 11 Ramsel
66,Bergstraat 71,2019-12-04,06:00:00,20,2,18,FMN GV 11 Ramsel
66,Bergstraat 71,2019-12-04,07:00:00,96,12,84,FMN GV 11 Ramsel
66,Bergstraat 71,2019-12-04,08:00:00,88,6,82,FMN GV 11 Ramsel
66,Bergstraat 71,2019-12-04,09:00:00,8,2,6,FMN GV 11 Ramsel
66,Bergstraat 71,2019-12-04,10:00:00,14,8,6,FMN GV 11 Ramsel
66,Bergstraat 71,2019-12-04,11:00:00,42,22,20,FMN GV 11 Ramsel
66,Bergstraat 71,2019-12-04,12:00:00,156,142,14,FMN GV 11 Ramsel
66,Bergstraat 71,2019-12-04,13:00:00,78,42,36,FMN GV 11 Ramsel
66,Bergstraat 71,2019-12-04,14:00:00,94,50,44,FMN GV 11 Ramsel
66,Bergstraat 71,2019-12-04,15:00:00,78,46,32,FMN GV 11 Ramsel
66,Bergstraat 71,2019-12-04,16:00:00,52,34,18,FMN GV 11 Ramsel
66,Bergstraat 71,2019-12-04,17:00:00,68,44,24,FMN GV 11 Ramsel
66,Bergstraat 71,2019-12-04,18:00:00,28,20,8,FMN GV 11 Ramsel
66,Bergstraat 71,2019-12-04,19:00:00,18,14,4,FMN GV 11 Ramsel
66,Bergstraat 71,2019-12-04,20:00:00,12,6,6,FMN GV 11 Ramsel
66,Bergstraat 71,2019-12-04,21:00:00,12,10,2,FMN GV 11 Ramsel
66,Bergstraat 71,2019-12-04,22:00:00,4,0,4,FMN GV 11 Ramsel
66,Bergstraat 71,2019-12-04,23:00:00,2,2,0,FMN GV 11 Ramsel
66,Bergstraat 71,2019-12-05,00:00:00,0,0,0,FMN GV 11 Ramsel
66,Bergstraat 71,2019-12-05,01:00:00,0,0,0,FMN GV 11 Ramsel
66,Bergstraat 71,2019-12-05,02:00:00,0,0,0,FMN GV 11 Ramsel
66,Bergstraat 71,2019-12-05,03:00:00,0,0,0,FMN GV 11 Ramsel
66,Bergstraat 71,2019-12-05,04:00:00,2,2,0,FMN GV 11 Ramsel
66,Bergstraat 71,2019-12-05,05:00:00,4,2,2,FMN GV 11 Ramsel
66,Bergstraat 71,2019-12-05,06:00:00,26,4,22,FMN GV 11 Ramsel
66,Bergstraat 71,2019-12-05,07:00:00,98,30,68,FMN GV 11 Ramsel
66,Bergstraat 71,2019-12-05,08:00:00,90,14,76,FMN GV 11 Ramsel
66,Bergstraat 71,2019-12-05,09:00:00,18,8,10,FMN GV 11 Ramsel
66,Bergstraat 71,2019-12-05,10:00:00,40,20,20,FMN GV 11 Ramsel
66,Bergstraat 71,2019-12-05,11:00:00,46,32,14,FMN GV 11 Ramsel
66,Bergstraat 71,2019-12-05,12:00:00,70,56,14,FMN GV 11 Ramsel
66,Bergstraat 71,2019-12-05,13:00:00,40,20,20,FMN GV 11 Ramsel
66,Bergstraat 71,2019-12-05,14:00:00,70,36,34,FMN GV 11 Ramsel
66,Bergstraat 71,2019-12-05,15:00:00,88,70,18,FMN GV 11 Ramsel
66,Bergstraat 71,2019-12-05,16:00:00,74,52,22,FMN GV 11 Ramsel
66,Bergstraat 71,2019-12-05,17:00:00,50,36,14,FMN GV 11 Ramsel
66,Bergstraat 71,2019-12-05,18:00:00,20,12,8,FMN GV 11 Ramsel
66,Bergstraat 71,2019-12-05,19:00:00,18,12,6,FMN GV 11 Ramsel
66,Bergstraat 71,2019-12-05,20:00:00,6,6,0,FMN GV 11 Ramsel
66,Bergstraat 71,2019-12-05,21:00:00,6,2,4,FMN GV 11 Ramsel
66,Bergstraat 71,2019-12-05,22:00:00,8,6,2,FMN GV 11 Ramsel
66,Bergstraat 71,2019-12-05,23:00:00,4,4,0,FMN GV 11 Ramsel
66,Bergstraat 71,2019-12-06,00:00:00,2,2,0,FMN GV 11 Ramsel
66,Bergstraat 71,2019-12-06,01:00:00,0,0,0,FMN GV 11 Ramsel
66,Bergstraat 71,2019-12-06,02:00:00,0,0,0,FMN GV 11 Ramsel
66,Bergstraat 71,2019-12-06,03:00:00,0,0,0,FMN GV 11 Ramsel
66,Bergstraat 71,2019-12-06,04:00:00,2,2,0,FMN GV 11 Ramsel
66,Bergstraat 71,2019-12-06,05:00:00,4,4,0,FMN GV 11 Ramsel
66,Bergstraat 71,2019-12-06,06:00:00,14,0,14,FMN GV 11 Ramsel
66,Bergstraat 71,2019-12-06,07:00:00,78,10,68,FMN GV 11 Ramsel
66,Bergstraat 71,2019-12-06,08:00:00,50,2,48,FMN GV 11 Ramsel
66,Bergstraat 71,2019-12-06,09:00:00,20,8,12,FMN GV 11 Ramsel
66,Bergstraat 71,2019-12-06,10:00:00,32,30,2,FMN GV 11 Ramsel
66,Bergstraat 71,2019-12-06,11:00:00,6,4,2,FMN GV 11 Ramsel
66,Bergstraat 71,2019-12-06,12:00:00,36,28,8,FMN GV 11 Ramsel
66,Bergstraat 71,2019-12-06,13:00:00,6,6,0,FMN GV 11 Ramsel
66,Bergstraat 71,2019-12-06,14:00:00,30,24,6,FMN GV 11 Ramsel
66,Bergstraat 71,2019-12-06,15:00:00,44,38,6,FMN GV 11 Ramsel
66,Bergstraat 71,2019-12-06,16:00:00,36,28,8,FMN GV 11 Ramsel
66,Bergstraat 71,2019-12-06,17:00:00,18,14,4,FMN GV 11 Ramsel
66,Bergstraat 71,2019-12-06,18:00:00,10,4,6,FMN GV 11 Ramsel
66,Bergstraat 71,2019-12-06,19:00:00,0,0,0,FMN GV 11 Ramsel
66,Bergstraat 71,2019-12-06,20:00:00,4,4,0,FMN GV 11 Ramsel
66,Bergstraat 71,2019-12-06,21:00:00,4,0,4,FMN GV 11 Ramsel
66,Bergstraat 71,2019-12-06,22:00:00,8,6,2,FMN GV 11 Ramsel
66,Bergstraat 71,2019-12-06,23:00:00,4,2,2,FMN GV 11 Ramsel
66,Bergstraat 71,2019-12-07,00:00:00,0,0,0,FMN GV 11 Ramsel
66,Bergstraat 71,2019-12-07,01:00:00,0,0,0,FMN GV 11 Ramsel
66,Bergstraat 71,2019-12-07,02:00:00,2,2,0,FMN GV 11 Ramsel
66,Bergstraat 71,2019-12-07,03:00:00,0,0,0,FMN GV 11 Ramsel
66,Bergstraat 71,2019-12-07,04:00:00,0,0,0,FMN GV 11 Ramsel
66,Bergstraat 71,2019-12-07,05:00:00,2,0,2,FMN GV 11 Ramsel
66,Bergstraat 71,2019-12-07,06:00:00,2,2,0,FMN GV 11 Ramsel
66,Bergstraat 71,2019-12-07,07:00:00,2,0,2,FMN GV 11 Ramsel
66,Bergstraat 71,2019-12-07,08:00:00,28,6,22,FMN GV 11 Ramsel
66,Bergstraat 71,2019-12-07,09:00:00,38,16,22,FMN GV 11 Ramsel
66,Bergstraat 71,2019-12-07,10:00:00,58,22,36,FMN GV 11 Ramsel
66,Bergstraat 71,2019-12-07,11:00:00,60,36,24,FMN GV 11 Ramsel
66,Bergstraat 71,2019-12-07,12:00:00,62,24,38,FMN GV 11 Ramsel
66,Bergstraat 71,2019-12-07,13:00:00,106,50,56,FMN GV 11 Ramsel
66,Bergstraat 71,2019-12-07,14:00:00,106,52,54,FMN GV 11 Ramsel
66,Bergstraat 71,2019-12-07,15:00:00,92,54,38,FMN GV 11 Ramsel
66,Bergstraat 71,2019-12-07,16:00:00,90,64,26,FMN GV 11 Ramsel
66,Bergstraat 71,2019-12-07,17:00:00,30,16,14,FMN GV 11 Ramsel
66,Bergstraat 71,2019-12-07,18:00:00,8,6,2,FMN GV 11 Ramsel
66,Bergstraat 71,2019-12-07,19:00:00,8,2,6,FMN GV 11 Ramsel
66,Bergstraat 71,2019-12-07,20:00:00,10,4,6,FMN GV 11 Ramsel
66,Bergstraat 71,2019-12-07,21:00:00,12,6,6,FMN GV 11 Ramsel
66,Bergstraat 71,2019-12-07,22:00:00,6,4,2,FMN GV 11 Ramsel
66,Bergstraat 71,2019-12-07,23:00:00,6,6,0,FMN GV 11 Ramsel
66,Bergstraat 71,2019-12-08,00:00:00,2,2,0,FMN GV 11 Ramsel
66,Bergstraat 71,2019-12-08,01:00:00,4,2,2,FMN GV 11 Ramsel
66,Bergstraat 71,2019-12-08,02:00:00,4,4,0,FMN GV 11 Ramsel
66,Bergstraat 71,2019-12-08,03:00:00,0,0,0,FMN GV 11 Ramsel
66,Bergstraat 71,2019-12-08,04:00:00,6,6,0,FMN GV 11 Ramsel
66,Bergstraat 71,2019-12-08,05:00:00,2,0,2,FMN GV 11 Ramsel
66,Bergstraat 71,2019-12-08,06:00:00,2,0,2,FMN GV 11 Ramsel
66,Bergstraat 71,2019-12-08,07:00:00,2,0,2,FMN GV 11 Ramsel
66,Bergstraat 71,2019-12-08,08:00:00,2,0,2,FMN GV 11 Ramsel
66,Bergstraat 71,2019-12-08,09:00:00,14,2,12,FMN GV 11 Ramsel
66,Bergstraat 71,2019-12-08,10:00:00,14,14,0,FMN GV 11 Ramsel
66,Bergstraat 71,2019-12-08,11:00:00,16,8,8,FMN GV 11 Ramsel
66,Bergstraat 71,2019-12-08,12:00:00,14,10,4,FMN GV 11 Ramsel
66,Bergstraat 71,2019-12-08,13:00:00,30,16,14,FMN GV 11 Ramsel
66,Bergstraat 71,2019-12-08,14:00:00,38,12,26,FMN GV 11 Ramsel
66,Bergstraat 71,2019-12-08,15:00:00,36,26,10,FMN GV 11 Ramsel
66,Bergstraat 71,2019-12-08,16:00:00,22,10,12,FMN GV 11 Ramsel
66,Bergstraat 71,2019-12-08,17:00:00,14,10,4,FMN GV 11 Ramsel
66,Bergstraat 71,2019-12-08,18:00:00,0,0,0,FMN GV 11 Ramsel
66,Bergstraat 71,2019-12-08,19:00:00,4,2,2,FMN GV 11 Ramsel
66,Bergstraat 71,2019-12-08,20:00:00,2,2,0,FMN GV 11 Ramsel
66,Bergstraat 71,2019-12-08,21:00:00,0,0,0,FMN GV 11 Ramsel
66,Bergstraat 71,2019-12-08,22:00:00,2,0,2,FMN GV 11 Ramsel
66,Bergstraat 71,2019-12-08,23:00:00,0,0,0,FMN GV 11 Ramsel
66,Bergstraat 71,2019-12-09,00:00:00,0,0,0,FMN GV 11 Ramsel
66,Bergstraat 71,2019-12-09,01:00:00,0,0,0,FMN GV 11 Ramsel
66,Bergstraat 71,2019-12-09,02:00:00,0,0,0,FMN GV 11 Ramsel
66,Bergstraat 71,2019-12-09,03:00:00,0,0,0,FMN GV 11 Ramsel
66,Bergstraat 71,2019-12-09,04:00:00,2,2,0,FMN GV 11 Ramsel
66,Bergstraat 71,2019-12-09,05:00:00,8,4,4,FMN GV 11 Ramsel
66,Bergstraat 71,2019-12-09,06:00:00,18,2,16,FMN GV 11 Ramsel
66,Bergstraat 71,2019-12-09,07:00:00,66,8,58,FMN GV 11 Ramsel
66,Bergstraat 71,2019-12-09,08:00:00,46,2,44,FMN GV 11 Ramsel
66,Bergstraat 71,2019-12-09,09:00:00,8,4,4,FMN GV 11 Ramsel
66,Bergstraat 71,2019-12-09,10:00:00,30,20,10,FMN GV 11 Ramsel
66,Bergstraat 71,2019-12-09,11:00:00,22,14,8,FMN GV 11 Ramsel
66,Bergstraat 71,2019-12-09,12:00:00,50,42,8,FMN GV 11 Ramsel
66,Bergstraat 71,2019-12-09,13:00:00,20,12,8,FMN GV 11 Ramsel
66,Bergstraat 71,2019-12-09,14:00:00,12,4,8,FMN GV 11 Ramsel
66,Bergstraat 71,2019-12-09,15:00:00,22,18,4,FMN GV 11 Ramsel
66,Bergstraat 71,2019-12-09,16:00:00,30,28,2,FMN GV 11 Ramsel
66,Bergstraat 71,2019-12-09,17:00:00,26,16,10,FMN GV 11 Ramsel
66,Bergstraat 71,2019-12-09,18:00:00,26,16,10,FMN GV 11 Ramsel
66,Bergstraat 71,2019-12-09,19:00:00,2,0,2,FMN GV 11 Ramsel
66,Bergstraat 71,2019-12-09,20:00:00,10,6,4,FMN GV 11 Ramsel
66,Bergstraat 71,2019-12-09,21:00:00,4,2,2,FMN GV 11 Ramsel
66,Bergstraat 71,2019-12-09,22:00:00,2,2,0,FMN GV 11 Ramsel
66,Bergstraat 71,2019-12-09,23:00:00,8,6,2,FMN GV 11 Ramsel
66,Bergstraat 71,2019-12-10,00:00:00,2,0,2,FMN GV 11 Ramsel
66,Bergstraat 71,2019-12-10,01:00:00,0,0,0,FMN GV 11 Ramsel
66,Bergstraat 71,2019-12-10,02:00:00,0,0,0,FMN GV 11 Ramsel
66,Bergstraat 71,2019-12-10,03:00:00,2,0,2,FMN GV 11 Ramsel
66,Bergstraat 71,2019-12-10,04:00:00,2,2,0,FMN GV 11 Ramsel
66,Bergstraat 71,2019-12-10,05:00:00,10,6,4,FMN GV 11 Ramsel
66,Bergstraat 71,2019-12-10,06:00:00,34,4,30,FMN GV 11 Ramsel
66,Bergstraat 71,2019-12-10,07:00:00,100,8,92,FMN GV 11 Ramsel
66,Bergstraat 71,2019-12-10,08:00:00,58,10,48,FMN GV 11 Ramsel
66,Bergstraat 71,2019-12-10,09:00:00,30,12,18,FMN GV 11 Ramsel
66,Bergstraat 71,2019-12-10,10:00:00,98,80,18,FMN GV 11 Ramsel
66,Bergstraat 71,2019-12-10,11:00:00,52,34,18,FMN GV 11 Ramsel
66,Bergstraat 71,2019-12-10,12:00:00,68,44,24,FMN GV 11 Ramsel
66,Bergstraat 71,2019-12-10,13:00:00,140,60,80,FMN GV 11 Ramsel
66,Bergstraat 71,2019-12-10,14:00:00,98,46,52,FMN GV 11 Ramsel
66,Bergstraat 71,2019-12-10,15:00:00,106,76,30,FMN GV 11 Ramsel
66,Bergstraat 71,2019-12-10,16:00:00,72,48,24,FMN GV 11 Ramsel
66,Bergstraat 71,2019-12-10,17:00:00,66,42,24,FMN GV 11 Ramsel
66,Bergstraat 71,2019-12-10,18:00:00,30,22,8,FMN GV 11 Ramsel
66,Bergstraat 71,2019-12-10,19:00:00,14,4,10,FMN GV 11 Ramsel
66,Bergstraat 71,2019-12-10,20:00:00,30,26,4,FMN GV 11 Ramsel
66,Bergstraat 71,2019-12-10,21:00:00,4,0,4,FMN GV 11 Ramsel
66,Bergstraat 71,2019-12-10,22:00:00,4,2,2,FMN GV 11 Ramsel
66,Bergstraat 71,2019-12-10,23:00:00,6,6,0,FMN GV 11 Ramsel
66,Bergstraat 71,2019-12-11,00:00:00,0,0,0,FMN GV 11 Ramsel
66,Bergstraat 71,2019-12-11,01:00:00,0,0,0,FMN GV 11 Ramsel
66,Bergstraat 71,2019-12-11,02:00:00,0,0,0,FMN GV 11 Ramsel
66,Bergstraat 71,2019-12-11,03:00:00,2,0,2,FMN GV 11 Ramsel
66,Bergstraat 71,2019-12-11,04:00:00,2,2,0,FMN GV 11 Ramsel
66,Bergstraat 71,2019-12-11,05:00:00,10,8,2,FMN GV 11 Ramsel
66,Bergstraat 71,2019-12-11,06:00:00,18,6,12,FMN GV 11 Ramsel
66,Bergstraat 71,2019-12-11,07:00:00,64,10,54,FMN GV 11 Ramsel
66,Bergstraat 71,2019-12-11,08:00:00,78,10,68,FMN GV 11 Ramsel
66,Bergstraat 71,2019-12-11,09:00:00,22,6,16,FMN GV 11 Ramsel
66,Bergstraat 71,2019-12-11,10:00:00,60,58,2,FMN GV 11 Ramsel
66,Bergstraat 71,2019-12-11,11:00:00,40,24,16,FMN GV 11 Ramsel
66,Bergstraat 71,2019-12-11,12:00:00,66,44,22,FMN GV 11 Ramsel
66,Bergstraat 71,2019-12-11,13:00:00,54,26,28,FMN GV 11 Ramsel
66,Bergstraat 71,2019-12-11,14:00:00,58,36,22,FMN GV 11 Ramsel
66,Bergstraat 71,2019-12-11,15:00:00,36,20,16,FMN GV 11 Ramsel
66,Bergstraat 71,2019-12-11,16:00:00,42,24,18,FMN GV 11 Ramsel
66,Bergstraat 71,2019-12-11,17:00:00,42,30,12,FMN GV 11 Ramsel
66,Bergstraat 71,2019-12-11,18:00:00,18,12,6,FMN GV 11 Ramsel
66,Bergstraat 71,2019-12-11,19:00:00,20,12,8,FMN GV 11 Ramsel
66,Bergstraat 71,2019-12-11,20:00:00,18,10,8,FMN GV 11 Ramsel
66,Bergstraat 71,2019-12-11,21:00:00,2,2,0,FMN GV 11 Ramsel
66,Bergstraat 71,2019-12-11,22:00:00,8,6,2,FMN GV 11 Ramsel
66,Bergstraat 71,2019-12-11,23:00:00,0,0,0,FMN GV 11 Ramsel
66,Bergstraat 71,2019-12-12,00:00:00,0,0,0,FMN GV 11 Ramsel
66,Bergstraat 71,2019-12-12,01:00:00,2,0,2,FMN GV 11 Ramsel
66,Bergstraat 71,2019-12-12,02:00:00,0,0,0,FMN GV 11 Ramsel
66,Bergstraat 71,2019-12-12,03:00:00,0,0,0,FMN GV 11 Ramsel
66,Bergstraat 71,2019-12-12,04:00:00,4,4,0,FMN GV 11 Ramsel
66,Bergstraat 71,2019-12-12,05:00:00,10,6,4,FMN GV 11 Ramsel
66,Bergstraat 71,2019-12-12,06:00:00,30,4,26,FMN GV 11 Ramsel
66,Bergstraat 71,2019-12-12,07:00:00,106,10,96,FMN GV 11 Ramsel
66,Bergstraat 71,2019-12-12,08:00:00,106,18,88,FMN GV 11 Ramsel
66,Bergstraat 71,2019-12-12,09:00:00,38,18,20,FMN GV 11 Ramsel
66,Bergstraat 71,2019-12-12,10:00:00,90,74,16,FMN GV 11 Ramsel
66,Bergstraat 71,2019-12-12,11:00:00,46,38,8,FMN GV 11 Ramsel
66,Bergstraat 71,2019-12-12,12:00:00,74,44,30,FMN GV 11 Ramsel
66,Bergstraat 71,2019-12-12,13:00:00,118,48,70,FMN GV 11 Ramsel
66,Bergstraat 71,2019-12-12,14:00:00,78,40,38,FMN GV 11 Ramsel
66,Bergstraat 71,2019-12-12,15:00:00,88,42,46,FMN GV 11 Ramsel
66,Bergstraat 71,2019-12-12,16:00:00,90,60,30,FMN GV 11 Ramsel
66,Bergstraat 71,2019-12-12,17:00:00,54,48,6,FMN GV 11 Ramsel
66,Bergstraat 71,2019-12-12,18:00:00,16,12,4,FMN GV 11 Ramsel
66,Bergstraat 71,2019-12-12,19:00:00,8,2,6,FMN GV 11 Ramsel
66,Bergstraat 71,2019-12-12,20:00:00,6,2,4,FMN GV 11 Ramsel
66,Bergstraat 71,2019-12-12,21:00:00,6,4,2,FMN GV 11 Ramsel
66,Bergstraat 71,2019-12-12,22:00:00,4,2,2,FMN GV 11 Ramsel
66,Bergstraat 71,2019-12-12,23:00:00,4,2,2,FMN GV 11 Ramsel
66,Bergstraat 71,2019-12-13,00:00:00,2,2,0,FMN GV 11 Ramsel
66,Bergstraat 71,2019-12-13,01:00:00,0,0,0,FMN GV 11 Ramsel
66,Bergstraat 71,2019-12-13,02:00:00,0,0,0,FMN GV 11 Ramsel
66,Bergstraat 71,2019-12-13,03:00:00,2,0,2,FMN GV 11 Ramsel
66,Bergstraat 71,2019-12-13,04:00:00,2,2,0,FMN GV 11 Ramsel
66,Bergstraat 71,2019-12-13,05:00:00,12,10,2,FMN GV 11 Ramsel
66,Bergstraat 71,2019-12-13,06:00:00,14,4,10,FMN GV 11 Ramsel
66,Bergstraat 71,2019-12-13,07:00:00,80,14,66,FMN GV 11 Ramsel
66,Bergstraat 71,2019-12-13,08:00:00,58,4,54,FMN GV 11 Ramsel
66,Bergstraat 71,2019-12-13,09:00:00,12,2,10,FMN GV 11 Ramsel
66,Bergstraat 71,2019-12-13,10:00:00,46,40,6,FMN GV 11 Ramsel
66,Bergstraat 71,2019-12-13,11:00:00,38,32,6,FMN GV 11 Ramsel
66,Bergstraat 71,2019-12-13,12:00:00,58,44,14,FMN GV 11 Ramsel
66,Bergstraat 71,2019-12-13,13:00:00,14,4,10,FMN GV 11 Ramsel
66,Bergstraat 71,2019-12-13,14:00:00,10,6,4,FMN GV 11 Ramsel
66,Bergstraat 71,2019-12-13,15:00:00,16,6,10,FMN GV 11 Ramsel
66,Bergstraat 71,2019-12-13,16:00:00,30,24,6,FMN GV 11 Ramsel
66,Bergstraat 71,2019-12-13,17:00:00,18,12,6,FMN GV 11 Ramsel
66,Bergstraat 71,2019-12-13,18:00:00,6,4,2,FMN GV 11 Ramsel
66,Bergstraat 71,2019-12-13,19:00:00,14,10,4,FMN GV 11 Ramsel
66,Bergstraat 71,2019-12-13,20:00:00,6,2,4,FMN GV 11 Ramsel
66,Bergstraat 71,2019-12-13,21:00:00,10,10,0,FMN GV 11 Ramsel
66,Bergstraat 71,2019-12-13,22:00:00,6,2,4,FMN GV 11 Ramsel
66,Bergstraat 71,2019-12-13,23:00:00,6,6,0,FMN GV 11 Ramsel
66,Bergstraat 71,2019-12-14,00:00:00,0,0,0,FMN GV 11 Ramsel
66,Bergstraat 71,2019-12-14,01:00:00,4,0,4,FMN GV 11 Ramsel
66,Bergstraat 71,2019-12-14,02:00:00,2,2,0,FMN GV 11 Ramsel
66,Bergstraat 71,2019-12-14,03:00:00,2,2,0,FMN GV 11 Ramsel
66,Bergstraat 71,2019-12-14,04:00:00,0,0,0,FMN GV 11 Ramsel
66,Bergstraat 71,2019-12-14,05:00:00,2,0,2,FMN GV 11 Ramsel
66,Bergstraat 71,2019-12-14,06:00:00,6,0,6,FMN GV 11 Ramsel
66,Bergstraat 71,2019-12-14,07:00:00,4,2,2,FMN GV 11 Ramsel
66,Bergstraat 71,2019-12-14,08:00:00,12,2,10,FMN GV 11 Ramsel
66,Bergstraat 71,2019-12-14,09:00:00,24,10,14,FMN GV 11 Ramsel
66,Bergstraat 71,2019-12-14,10:00:00,24,6,18,FMN GV 11 Ramsel
66,Bergstraat 71,2019-12-14,11:00:00,36,24,12,FMN GV 11 Ramsel
66,Bergstraat 71,2019-12-14,12:00:00,42,22,20,FMN GV 11 Ramsel
66,Bergstraat 71,2019-12-14,13:00:00,26,10,16,FMN GV 11 Ramsel
66,Bergstraat 71,2019-12-14,14:00:00,26,14,12,FMN GV 11 Ramsel
66,Bergstraat 71,2019-12-14,15:00:00,16,10,6,FMN GV 11 Ramsel
66,Bergstraat 71,2019-12-14,16:00:00,12,8,4,FMN GV 11 Ramsel
66,Bergstraat 71,2019-12-14,17:00:00,18,10,8,FMN GV 11 Ramsel
66,Bergstraat 71,2019-12-14,18:00:00,24,20,4,FMN GV 11 Ramsel
66,Bergstraat 71,2019-12-14,19:00:00,24,10,14,FMN GV 11 Ramsel
66,Bergstraat 71,2019-12-14,20:00:00,14,6,8,FMN GV 11 Ramsel
66,Bergstraat 71,2019-12-14,21:00:00,8,6,2,FMN GV 11 Ramsel
66,Bergstraat 71,2019-12-14,22:00:00,10,2,8,FMN GV 11 Ramsel
66,Bergstraat 71,2019-12-14,23:00:00,6,2,4,FMN GV 11 Ramsel
66,Bergstraat 71,2019-12-15,00:00:00,2,2,0,FMN GV 11 Ramsel
66,Bergstraat 71,2019-12-15,01:00:00,2,0,2,FMN GV 11 Ramsel
66,Bergstraat 71,2019-12-15,02:00:00,4,4,0,FMN GV 11 Ramsel
66,Bergstraat 71,2019-12-15,03:00:00,0,0,0,FMN GV 11 Ramsel
66,Bergstraat 71,2019-12-15,04:00:00,0,0,0,FMN GV 11 Ramsel
66,Bergstraat 71,2019-12-15,05:00:00,0,0,0,FMN GV 11 Ramsel
66,Bergstraat 71,2019-12-15,06:00:00,0,0,0,FMN GV 11 Ramsel
66,Bergstraat 71,2019-12-15,07:00:00,4,2,2,FMN GV 11 Ramsel
66,Bergstraat 71,2019-12-15,08:00:00,20,6,14,FMN GV 11 Ramsel
66,Bergstraat 71,2019-12-15,09:00:00,40,14,26,FMN GV 11 Ramsel
66,Bergstraat 71,2019-12-15,10:00:00,78,32,46,FMN GV 11 Ramsel
66,Bergstraat 71,2019-12-15,11:00:00,114,60,54,FMN GV 11 Ramsel
66,Bergstraat 71,2019-12-15,12:00:00,48,26,22,FMN GV 11 Ramsel
66,Bergstraat 71,2019-12-15,13:00:00,64,34,30,FMN GV 11 Ramsel
66,Bergstraat 71,2019-12-15,14:00:00,58,22,36,FMN GV 11 Ramsel
66,Bergstraat 71,2019-12-15,15:00:00,50,38,12,FMN GV 11 Ramsel
66,Bergstraat 71,2019-12-15,16:00:00,18,12,6,FMN GV 11 Ramsel
66,Bergstraat 71,2019-12-15,17:00:00,28,12,16,FMN GV 11 Ramsel
66,Bergstraat 71,2019-12-15,18:00:00,16,12,4,FMN GV 11 Ramsel
66,Bergstraat 71,2019-12-15,19:00:00,4,2,2,FMN GV 11 Ramsel
66,Bergstraat 71,2019-12-15,20:00:00,8,6,2,FMN GV 11 Ramsel
66,Bergstraat 71,2019-12-15,21:00:00,8,8,0,FMN GV 11 Ramsel
66,Bergstraat 71,2019-12-15,22:00:00,0,0,0,FMN GV 11 Ramsel
66,Bergstraat 71,2019-12-15,23:00:00,0,0,0,FMN GV 11 Ramsel
66,Bergstraat 71,2019-12-16,00:00:00,4,2,2,FMN GV 11 Ramsel
66,Bergstraat 71,2019-12-16,01:00:00,0,0,0,FMN GV 11 Ramsel
66,Bergstraat 71,2019-12-16,02:00:00,0,0,0,FMN GV 11 Ramsel
66,Bergstraat 71,2019-12-16,03:00:00,0,0,0,FMN GV 11 Ramsel
66,Bergstraat 71,2019-12-16,04:00:00,2,2,0,FMN GV 11 Ramsel
66,Bergstraat 71,2019-12-16,05:00:00,10,6,4,FMN GV 11 Ramsel
66,Bergstraat 71,2019-12-16,06:00:00,26,6,20,FMN GV 11 Ramsel
66,Bergstraat 71,2019-12-16,07:00:00,110,18,92,FMN GV 11 Ramsel
66,Bergstraat 71,2019-12-16,08:00:00,100,10,90,FMN GV 11 Ramsel
66,Bergstraat 71,2019-12-16,09:00:00,32,10,22,FMN GV 11 Ramsel
66,Bergstraat 71,2019-12-16,10:00:00,48,44,4,FMN GV 11 Ramsel
66,Bergstraat 71,2019-12-16,11:00:00,38,28,10,FMN GV 11 Ramsel
66,Bergstraat 71,2019-12-16,12:00:00,68,54,14,FMN GV 11 Ramsel
66,Bergstraat 71,2019-12-16,13:00:00,46,20,26,FMN GV 11 Ramsel
66,Bergstraat 71,2019-12-16,14:00:00,42,28,14,FMN GV 11 Ramsel
66,Bergstraat 71,2019-12-16,15:00:00,44,36,8,FMN GV 11 Ramsel
66,Bergstraat 71,2019-12-16,16:00:00,34,26,8,FMN GV 11 Ramsel
66,Bergstraat 71,2019-12-16,17:00:00,40,32,8,FMN GV 11 Ramsel
66,Bergstraat 71,2019-12-16,18:00:00,22,18,4,FMN GV 11 Ramsel
66,Bergstraat 71,2019-12-16,19:00:00,14,8,6,FMN GV 11 Ramsel
66,Bergstraat 71,2019-12-16,20:00:00,8,4,4,FMN GV 11 Ramsel
66,Bergstraat 71,2019-12-16,21:00:00,4,2,2,FMN GV 11 Ramsel
66,Bergstraat 71,2019-12-16,22:00:00,12,4,8,FMN GV 11 Ramsel
66,Bergstraat 71,2019-12-16,23:00:00,8,8,0,FMN GV 11 Ramsel
66,Bergstraat 71,2019-12-17,00:00:00,0,0,0,FMN GV 11 Ramsel
66,Bergstraat 71,2019-12-17,01:00:00,0,0,0,FMN GV 11 Ramsel
66,Bergstraat 71,2019-12-17,02:00:00,2,0,2,FMN GV 11 Ramsel
66,Bergstraat 71,2019-12-17,03:00:00,0,0,0,FMN GV 11 Ramsel
66,Bergstraat 71,2019-12-17,04:00:00,2,2,0,FMN GV 11 Ramsel
66,Bergstraat 71,2019-12-17,05:00:00,10,4,6,FMN GV 11 Ramsel
66,Bergstraat 71,2019-12-17,06:00:00,34,6,28,FMN GV 11 Ramsel
66,Bergstraat 71,2019-12-17,07:00:00,120,22,98,FMN GV 11 Ramsel
66,Bergstraat 71,2019-12-17,08:00:00,106,22,84,FMN GV 11 Ramsel
66,Bergstraat 71,2019-12-17,09:00:00,66,14,52,FMN GV 11 Ramsel
66,Bergstraat 71,2019-12-17,10:00:00,128,82,46,FMN GV 11 Ramsel
66,Bergstraat 71,2019-12-17,11:00:00,82,28,54,FMN GV 11 Ramsel
66,Bergstraat 71,2019-12-17,12:00:00,116,58,58,FMN GV 11 Ramsel
66,Bergstraat 71,2019-12-17,13:00:00,212,100,112,FMN GV 11 Ramsel
66,Bergstraat 71,2019-12-17,14:00:00,208,102,106,FMN GV 11 Ramsel
66,Bergstraat 71,2019-12-17,15:00:00,156,108,48,FMN GV 11 Ramsel
66,Bergstraat 71,2019-12-17,16:00:00,144,96,48,FMN GV 11 Ramsel
66,Bergstraat 71,2019-12-17,17:00:00,76,50,26,FMN GV 11 Ramsel
66,Bergstraat 71,2019-12-17,18:00:00,58,42,16,FMN GV 11 Ramsel
66,Bergstraat 71,2019-12-17,19:00:00,32,16,16,FMN GV 11 Ramsel
66,Bergstraat 71,2019-12-17,20:00:00,28,22,6,FMN GV 11 Ramsel
66,Bergstraat 71,2019-12-17,21:00:00,6,6,0,FMN GV 11 Ramsel
66,Bergstraat 71,2019-12-17,22:00:00,24,12,12,FMN GV 11 Ramsel
66,Bergstraat 71,2019-12-17,23:00:00,2,2,0,FMN GV 11 Ramsel
66,Bergstraat 71,2019-12-18,00:00:00,10,4,6,FMN GV 11 Ramsel
66,Bergstraat 71,2019-12-18,01:00:00,0,0,0,FMN GV 11 Ramsel
66,Bergstraat 71,2019-12-18,02:00:00,0,0,0,FMN GV 11 Ramsel
66,Bergstraat 71,2019-12-18,03:00:00,2,0,2,FMN GV 11 Ramsel
66,Bergstraat 71,2019-12-18,04:00:00,2,2,0,FMN GV 11 Ramsel
66,Bergstraat 71,2019-12-18,05:00:00,10,2,8,FMN GV 11 Ramsel
66,Bergstraat 71,2019-12-18,06:00:00,34,10,24,FMN GV 11 Ramsel
66,Bergstraat 71,2019-12-18,07:00:00,72,10,62,FMN GV 11 Ramsel
66,Bergstraat 71,2019-12-18,08:00:00,56,12,44,FMN GV 11 Ramsel
66,Bergstraat 71,2019-12-18,09:00:00,44,8,36,FMN GV 11 Ramsel
66,Bergstraat 71,2019-12-18,10:00:00,36,20,16,FMN GV 11 Ramsel
66,Bergstraat 71,2019-12-18,11:00:00,74,22,52,FMN GV 11 Ramsel
66,Bergstraat 71,2019-12-18,12:00:00,102,64,38,FMN GV 11 Ramsel
66,Bergstraat 71,2019-12-18,13:00:00,122,56,66,FMN GV 11 Ramsel
66,Bergstraat 71,2019-12-18,14:00:00,132,54,78,FMN GV 11 Ramsel
66,Bergstraat 71,2019-12-18,15:00:00,112,70,42,FMN GV 11 Ramsel
66,Bergstraat 71,2019-12-18,16:00:00,90,66,24,FMN GV 11 Ramsel
66,Bergstraat 71,2019-12-18,17:00:00,88,72,16,FMN GV 11 Ramsel
66,Bergstraat 71,2019-12-18,18:00:00,28,10,18,FMN GV 11 Ramsel
66,Bergstraat 71,2019-12-18,19:00:00,18,10,8,FMN GV 11 Ramsel
66,Bergstraat 71,2019-12-18,20:00:00,26,18,8,FMN GV 11 Ramsel
66,Bergstraat 71,2019-12-18,21:00:00,22,8,14,FMN GV 11 Ramsel
66,Bergstraat 71,2019-12-18,22:00:00,10,6,4,FMN GV 11 Ramsel
66,Bergstraat 71,2019-12-18,23:00:00,12,10,2,FMN GV 11 Ramsel
66,Bergstraat 71,2019-12-19,00:00:00,0,0,0,FMN GV 11 Ramsel
66,Bergstraat 71,2019-12-19,01:00:00,0,0,0,FMN GV 11 Ramsel
66,Bergstraat 71,2019-12-19,02:00:00,14,12,2,FMN GV 11 Ramsel
66,Bergstraat 71,2019-12-19,03:00:00,0,0,0,FMN GV 11 Ramsel
66,Bergstraat 71,2019-12-19,04:00:00,10,4,6,FMN GV 11 Ramsel
66,Bergstraat 71,2019-12-19,05:00:00,14,8,6,FMN GV 11 Ramsel
66,Bergstraat 71,2019-12-19,06:00:00,26,6,20,FMN GV 11 Ramsel
66,Bergstraat 71,2019-12-19,07:00:00,56,10,46,FMN GV 11 Ramsel
66,Bergstraat 71,2019-12-19,08:00:00,32,6,26,FMN GV 11 Ramsel
66,Bergstraat 71,2019-12-19,09:00:00,38,10,28,FMN GV 11 Ramsel
66,Bergstraat 71,2019-12-19,10:00:00,42,8,34,FMN GV 11 Ramsel
66,Bergstraat 71,2019-12-19,11:00:00,52,22,30,FMN GV 11 Ramsel
66,Bergstraat 71,2019-12-19,12:00:00,68,24,44,FMN GV 11 Ramsel
66,Bergstraat 71,2019-12-19,13:00:00,158,68,90,FMN GV 11 Ramsel
66,Bergstraat 71,2019-12-19,14:00:00,188,100,88,FMN GV 11 Ramsel
66,Bergstraat 71,2019-12-19,15:00:00,112,78,34,FMN GV 11 Ramsel
66,Bergstraat 71,2019-12-19,16:00:00,86,64,22,FMN GV 11 Ramsel
66,Bergstraat 71,2019-12-19,17:00:00,64,46,18,FMN GV 11 Ramsel
66,Bergstraat 71,2019-12-19,18:00:00,32,22,10,FMN GV 11 Ramsel
66,Bergstraat 71,2019-12-19,19:00:00,14,8,6,FMN GV 11 Ramsel
66,Bergstraat 71,2019-12-19,20:00:00,20,14,6,FMN GV 11 Ramsel
66,Bergstraat 71,2019-12-19,21:00:00,14,6,8,FMN GV 11 Ramsel
66,Bergstraat 71,2019-12-19,22:00:00,8,6,2,FMN GV 11 Ramsel
66,Bergstraat 71,2019-12-19,23:00:00,10,6,4,FMN GV 11 Ramsel
66,Bergstraat 71,2019-12-20,00:00:00,0,0,0,FMN GV 11 Ramsel
66,Bergstraat 71,2019-12-20,01:00:00,0,0,0,FMN GV 11 Ramsel
66,Bergstraat 71,2019-12-20,02:00:00,0,0,0,FMN GV 11 Ramsel
66,Bergstraat 71,2019-12-20,03:00:00,0,0,0,FMN GV 11 Ramsel
66,Bergstraat 71,2019-12-20,04:00:00,0,0,0,FMN GV 11 Ramsel
66,Bergstraat 71,2019-12-20,05:00:00,6,2,4,FMN GV 11 Ramsel
66,Bergstraat 71,2019-12-20,06:00:00,8,2,6,FMN GV 11 Ramsel
66,Bergstraat 71,2019-12-20,07:00:00,64,12,52,FMN GV 11 Ramsel
66,Bergstraat 71,2019-12-20,08:00:00,78,4,74,FMN GV 11 Ramsel
66,Bergstraat 71,2019-12-20,09:00:00,92,50,42,FMN GV 11 Ramsel
66,Bergstraat 71,2019-12-20,10:00:00,24,20,4,FMN GV 11 Ramsel
66,Bergstraat 71,2019-12-20,11:00:00,42,28,14,FMN GV 11 Ramsel
66,Bergstraat 71,2019-12-20,12:00:00,44,36,8,FMN GV 11 Ramsel
66,Bergstraat 71,2019-12-20,13:00:00,20,8,12,FMN GV 11 Ramsel
66,Bergstraat 71,2019-12-20,14:00:00,30,12,18,FMN GV 11 Ramsel
66,Bergstraat 71,2019-12-20,15:00:00,38,28,10,FMN GV 11 Ramsel
66,Bergstraat 71,2019-12-20,16:00:00,38,26,12,FMN GV 11 Ramsel
66,Bergstraat 71,2019-12-20,17:00:00,36,24,12,FMN GV 11 Ramsel
66,Bergstraat 71,2019-12-20,18:00:00,28,14,14,FMN GV 11 Ramsel
66,Bergstraat 71,2019-12-20,19:00:00,20,4,16,FMN GV 11 Ramsel
66,Bergstraat 71,2019-12-20,20:00:00,14,8,6,FMN GV 11 Ramsel
66,Bergstraat 71,2019-12-20,21:00:00,22,10,12,FMN GV 11 Ramsel
66,Bergstraat 71,2019-12-20,22:00:00,6,2,4,FMN GV 11 Ramsel
66,Bergstraat 71,2019-12-20,23:00:00,10,6,4,FMN GV 11 Ramsel
66,Bergstraat 71,2019-12-21,00:00:00,14,12,2,FMN GV 11 Ramsel
66,Bergstraat 71,2019-12-21,01:00:00,6,4,2,FMN GV 11 Ramsel
66,Bergstraat 71,2019-12-21,02:00:00,8,6,2,FMN GV 11 Ramsel
66,Bergstraat 71,2019-12-21,03:00:00,4,4,0,FMN GV 11 Ramsel
66,Bergstraat 71,2019-12-21,04:00:00,0,0,0,FMN GV 11 Ramsel
66,Bergstraat 71,2019-12-21,05:00:00,8,6,2,FMN GV 11 Ramsel
66,Bergstraat 71,2019-12-21,06:00:00,2,2,0,FMN GV 11 Ramsel
66,Bergstraat 71,2019-12-21,07:00:00,6,2,4,FMN GV 11 Ramsel
66,Bergstraat 71,2019-12-21,08:00:00,18,4,14,FMN GV 11 Ramsel
66,Bergstraat 71,2019-12-21,09:00:00,34,8,26,FMN GV 11 Ramsel
66,Bergstraat 71,2019-12-21,10:00:00,48,26,22,FMN GV 11 Ramsel
66,Bergstraat 71,2019-12-21,11:00:00,74,22,52,FMN GV 11 Ramsel
66,Bergstraat 71,2019-12-21,12:00:00,64,40,24,FMN GV 11 Ramsel
66,Bergstraat 71,2019-12-21,13:00:00,102,58,44,FMN GV 11 Ramsel
66,Bergstraat 71,2019-12-21,14:00:00,72,24,48,FMN GV 11 Ramsel
66,Bergstraat 71,2019-12-21,15:00:00,44,18,26,FMN GV 11 Ramsel
66,Bergstraat 71,2019-12-21,16:00:00,66,56,10,FMN GV 11 Ramsel
66,Bergstraat 71,2019-12-21,17:00:00,14,10,4,FMN GV 11 Ramsel
66,Bergstraat 71,2019-12-21,18:00:00,8,4,4,FMN GV 11 Ramsel
66,Bergstraat 71,2019-12-21,19:00:00,12,4,8,FMN GV 11 Ramsel
66,Bergstraat 71,2019-12-21,20:00:00,8,4,4,FMN GV 11 Ramsel
66,Bergstraat 71,2019-12-21,21:00:00,16,14,2,FMN GV 11 Ramsel
66,Bergstraat 71,2019-12-21,22:00:00,8,4,4,FMN GV 11 Ramsel
66,Bergstraat 71,2019-12-21,23:00:00,2,2,0,FMN GV 11 Ramsel
66,Bergstraat 71,2019-12-22,00:00:00,4,4,0,FMN GV 11 Ramsel
66,Bergstraat 71,2019-12-22,01:00:00,2,0,2,FMN GV 11 Ramsel
66,Bergstraat 71,2019-12-22,02:00:00,4,2,2,FMN GV 11 Ramsel
66,Bergstraat 71,2019-12-22,03:00:00,2,2,0,FMN GV 11 Ramsel
66,Bergstraat 71,2019-12-22,04:00:00,2,2,0,FMN GV 11 Ramsel
66,Bergstraat 71,2019-12-22,05:00:00,2,2,0,FMN GV 11 Ramsel
66,Bergstraat 71,2019-12-22,06:00:00,4,0,4,FMN GV 11 Ramsel
66,Bergstraat 71,2019-12-22,07:00:00,2,0,2,FMN GV 11 Ramsel
66,Bergstraat 71,2019-12-22,08:00:00,10,2,8,FMN GV 11 Ramsel
66,Bergstraat 71,2019-12-22,09:00:00,16,10,6,FMN GV 11 Ramsel
66,Bergstraat 71,2019-12-22,10:00:00,20,8,12,FMN GV 11 Ramsel
66,Bergstraat 71,2019-12-22,11:00:00,40,30,10,FMN GV 11 Ramsel
66,Bergstraat 71,2019-12-22,12:00:00,28,12,16,FMN GV 11 Ramsel
66,Bergstraat 71,2019-12-22,13:00:00,24,4,20,FMN GV 11 Ramsel
66,Bergstraat 71,2019-12-22,14:00:00,20,16,4,FMN GV 11 Ramsel
66,Bergstraat 71,2019-12-22,15:00:00,6,4,2,FMN GV 11 Ramsel
66,Bergstraat 71,2019-12-22,16:00:00,4,2,2,FMN GV 11 Ramsel
66,Bergstraat 71,2019-12-22,17:00:00,0,0,0,FMN GV 11 Ramsel
66,Bergstraat 71,2019-12-22,18:00:00,6,4,2,FMN GV 11 Ramsel
66,Bergstraat 71,2019-12-22,19:00:00,6,0,6,FMN GV 11 Ramsel
66,Bergstraat 71,2019-12-22,20:00:00,4,4,0,FMN GV 11 Ramsel
66,Bergstraat 71,2019-12-22,21:00:00,2,2,0,FMN GV 11 Ramsel
66,Bergstraat 71,2019-12-22,22:00:00,4,4,0,FMN GV 11 Ramsel
66,Bergstraat 71,2019-12-22,23:00:00,0,0,0,FMN GV 11 Ramsel
66,Bergstraat 71,2019-12-23,00:00:00,2,2,0,FMN GV 11 Ramsel
66,Bergstraat 71,2019-12-23,01:00:00,2,0,2,FMN GV 11 Ramsel
66,Bergstraat 71,2019-12-23,02:00:00,0,0,0,FMN GV 11 Ramsel
66,Bergstraat 71,2019-12-23,03:00:00,0,0,0,FMN GV 11 Ramsel
66,Bergstraat 71,2019-12-23,04:00:00,0,0,0,FMN GV 11 Ramsel
66,Bergstraat 71,2019-12-23,05:00:00,4,4,0,FMN GV 11 Ramsel
66,Bergstraat 71,2019-12-23,06:00:00,20,4,16,FMN GV 11 Ramsel
66,Bergstraat 71,2019-12-23,07:00:00,22,6,16,FMN GV 11 Ramsel
66,Bergstraat 71,2019-12-23,08:00:00,30,6,24,FMN GV 11 Ramsel
66,Bergstraat 71,2019-12-23,09:00:00,40,16,24,FMN GV 11 Ramsel
66,Bergstraat 71,2019-12-23,10:00:00,52,36,16,FMN GV 11 Ramsel
66,Bergstraat 71,2019-12-23,11:00:00,36,14,22,FMN GV 11 Ramsel
66,Bergstraat 71,2019-12-23,12:00:00,30,26,4,FMN GV 11 Ramsel
66,Bergstraat 71,2019-12-23,13:00:00,22,12,10,FMN GV 11 Ramsel
66,Bergstraat 71,2019-12-23,14:00:00,34,10,24,FMN GV 11 Ramsel
66,Bergstraat 71,2019-12-23,15:00:00,60,30,30,FMN GV 11 Ramsel
66,Bergstraat 71,2019-12-23,16:00:00,54,22,32,FMN GV 11 Ramsel
66,Bergstraat 71,2019-12-23,17:00:00,40,32,8,FMN GV 11 Ramsel
66,Bergstraat 71,2019-12-23,18:00:00,32,20,12,FMN GV 11 Ramsel
66,Bergstraat 71,2019-12-23,19:00:00,10,4,6,FMN GV 11 Ramsel
66,Bergstraat 71,2019-12-23,20:00:00,10,4,6,FMN GV 11 Ramsel
66,Bergstraat 71,2019-12-23,21:00:00,12,10,2,FMN GV 11 Ramsel
66,Bergstraat 71,2019-12-23,22:00:00,6,2,4,FMN GV 11 Ramsel
66,Bergstraat 71,2019-12-23,23:00:00,2,2,0,FMN GV 11 Ramsel
66,Bergstraat 71,2019-12-24,00:00:00,2,2,0,FMN GV 11 Ramsel
66,Bergstraat 71,2019-12-24,01:00:00,0,0,0,FMN GV 11 Ramsel
66,Bergstraat 71,2019-12-24,02:00:00,0,0,0,FMN GV 11 Ramsel
66,Bergstraat 71,2019-12-24,03:00:00,0,0,0,FMN GV 11 Ramsel
66,Bergstraat 71,2019-12-24,04:00:00,0,0,0,FMN GV 11 Ramsel
66,Bergstraat 71,2019-12-24,05:00:00,2,0,2,FMN GV 11 Ramsel
66,Bergstraat 71,2019-12-24,06:00:00,16,6,10,FMN GV 11 Ramsel
66,Bergstraat 71,2019-12-24,07:00:00,24,6,18,FMN GV 11 Ramsel
66,Bergstraat 71,2019-12-24,08:00:00,12,4,8,FMN GV 11 Ramsel
66,Bergstraat 71,2019-12-24,09:00:00,30,12,18,FMN GV 11 Ramsel
66,Bergstraat 71,2019-12-24,10:00:00,28,14,14,FMN GV 11 Ramsel
66,Bergstraat 71,2019-12-24,11:00:00,50,16,34,FMN GV 11 Ramsel
66,Bergstraat 71,2019-12-24,12:00:00,66,42,24,FMN GV 11 Ramsel
66,Bergstraat 71,2019-12-24,13:00:00,88,34,54,FMN GV 11 Ramsel
66,Bergstraat 71,2019-12-24,14:00:00,72,28,44,FMN GV 11 Ramsel
66,Bergstraat 71,2019-12-24,15:00:00,46,36,10,FMN GV 11 Ramsel
66,Bergstraat 71,2019-12-24,16:00:00,44,28,16,FMN GV 11 Ramsel
66,Bergstraat 71,2019-12-24,17:00:00,22,14,8,FMN GV 11 Ramsel
66,Bergstraat 71,2019-12-24,18:00:00,14,8,6,FMN GV 11 Ramsel
66,Bergstraat 71,2019-12-24,19:00:00,6,2,4,FMN GV 11 Ramsel
66,Bergstraat 71,2019-12-24,20:00:00,2,0,2,FMN GV 11 Ramsel
66,Bergstraat 71,2019-12-24,21:00:00,2,0,2,FMN GV 11 Ramsel
66,Bergstraat 71,2019-12-24,22:00:00,4,4,0,FMN GV 11 Ramsel
66,Bergstraat 71,2019-12-24,23:00:00,2,0,2,FMN GV 11 Ramsel
66,Bergstraat 71,2019-12-25,00:00:00,0,0,0,FMN GV 11 Ramsel
66,Bergstraat 71,2019-12-25,01:00:00,4,2,2,FMN GV 11 Ramsel
66,Bergstraat 71,2019-12-25,02:00:00,0,0,0,FMN GV 11 Ramsel
66,Bergstraat 71,2019-12-25,03:00:00,0,0,0,FMN GV 11 Ramsel
66,Bergstraat 71,2019-12-25,04:00:00,0,0,0,FMN GV 11 Ramsel
66,Bergstraat 71,2019-12-25,05:00:00,2,2,0,FMN GV 11 Ramsel
66,Bergstraat 71,2019-12-25,06:00:00,0,0,0,FMN GV 11 Ramsel
66,Bergstraat 71,2019-12-25,07:00:00,4,2,2,FMN GV 11 Ramsel
66,Bergstraat 71,2019-12-25,08:00:00,18,2,16,FMN GV 11 Ramsel
66,Bergstraat 71,2019-12-25,09:00:00,22,10,12,FMN GV 11 Ramsel
66,Bergstraat 71,2019-12-25,10:00:00,42,18,24,FMN GV 11 Ramsel
66,Bergstraat 71,2019-12-25,11:00:00,38,26,12,FMN GV 11 Ramsel
66,Bergstraat 71,2019-12-25,12:00:00,34,14,20,FMN GV 11 Ramsel
66,Bergstraat 71,2019-12-25,13:00:00,52,22,30,FMN GV 11 Ramsel
66,Bergstraat 71,2019-12-25,14:00:00,34,18,16,FMN GV 11 Ramsel
66,Bergstraat 71,2019-12-25,15:00:00,46,24,22,FMN GV 11 Ramsel
66,Bergstraat 71,2019-12-25,16:00:00,26,14,12,FMN GV 11 Ramsel
66,Bergstraat 71,2019-12-25,17:00:00,14,8,6,FMN GV 11 Ramsel
66,Bergstraat 71,2019-12-25,18:00:00,16,8,8,FMN GV 11 Ramsel
66,Bergstraat 71,2019-12-25,19:00:00,4,2,2,FMN GV 11 Ramsel
66,Bergstraat 71,2019-12-25,20:00:00,4,2,2,FMN GV 11 Ramsel
66,Bergstraat 71,2019-12-25,21:00:00,10,4,6,FMN GV 11 Ramsel
66,Bergstraat 71,2019-12-25,22:00:00,2,2,0,FMN GV 11 Ramsel
66,Bergstraat 71,2019-12-25,23:00:00,0,0,0,FMN GV 11 Ramsel
66,Bergstraat 71,2019-12-26,00:00:00,0,0,0,FMN GV 11 Ramsel
66,Bergstraat 71,2019-12-26,01:00:00,0,0,0,FMN GV 11 Ramsel
66,Bergstraat 71,2019-12-26,02:00:00,2,2,0,FMN GV 11 Ramsel
66,Bergstraat 71,2019-12-26,03:00:00,0,0,0,FMN GV 11 Ramsel
66,Bergstraat 71,2019-12-26,04:00:00,0,0,0,FMN GV 11 Ramsel
66,Bergstraat 71,2019-12-26,05:00:00,6,4,2,FMN GV 11 Ramsel
66,Bergstraat 71,2019-12-26,06:00:00,0,0,0,FMN GV 11 Ramsel
66,Bergstraat 71,2019-12-26,07:00:00,10,4,6,FMN GV 11 Ramsel
66,Bergstraat 71,2019-12-26,08:00:00,28,6,22,FMN GV 11 Ramsel
66,Bergstraat 71,2019-12-26,09:00:00,36,12,24,FMN GV 11 Ramsel
66,Bergstraat 71,2019-12-26,10:00:00,54,10,44,FMN GV 11 Ramsel
66,Bergstraat 71,2019-12-26,11:00:00,68,32,36,FMN GV 11 Ramsel
66,Bergstraat 71,2019-12-26,12:00:00,88,40,48,FMN GV 11 Ramsel
66,Bergstraat 71,2019-12-26,13:00:00,102,42,60,FMN GV 11 Ramsel
66,Bergstraat 71,2019-12-26,14:00:00,96,52,44,FMN GV 11 Ramsel
66,Bergstraat 71,2019-12-26,15:00:00,28,22,6,FMN GV 11 Ramsel
66,Bergstraat 71,2019-12-26,16:00:00,30,22,8,FMN GV 11 Ramsel
66,Bergstraat 71,2019-12-26,17:00:00,24,20,4,FMN GV 11 Ramsel
66,Bergstraat 71,2019-12-26,18:00:00,16,12,4,FMN GV 11 Ramsel
66,Bergstraat 71,2019-12-26,19:00:00,16,10,6,FMN GV 11 Ramsel
66,Bergstraat 71,2019-12-26,20:00:00,20,6,14,FMN GV 11 Ramsel
66,Bergstraat 71,2019-12-26,21:00:00,14,12,2,FMN GV 11 Ramsel
66,Bergstraat 71,2019-12-26,22:00:00,0,0,0,FMN GV 11 Ramsel
66,Bergstraat 71,2019-12-26,23:00:00,2,2,0,FMN GV 11 Ramsel
66,Bergstraat 71,2019-12-27,00:00:00,4,2,2,FMN GV 11 Ramsel
66,Bergstraat 71,2019-12-27,01:00:00,4,0,4,FMN GV 11 Ramsel
66,Bergstraat 71,2019-12-27,02:00:00,0,0,0,FMN GV 11 Ramsel
66,Bergstraat 71,2019-12-27,03:00:00,2,2,0,FMN GV 11 Ramsel
66,Bergstraat 71,2019-12-27,04:00:00,0,0,0,FMN GV 11 Ramsel
66,Bergstraat 71,2019-12-27,05:00:00,4,2,2,FMN GV 11 Ramsel
66,Bergstraat 71,2019-12-27,06:00:00,8,4,4,FMN GV 11 Ramsel
66,Bergstraat 71,2019-12-27,07:00:00,10,4,6,FMN GV 11 Ramsel
66,Bergstraat 71,2019-12-27,08:00:00,12,4,8,FMN GV 11 Ramsel
66,Bergstraat 71,2019-12-27,09:00:00,36,16,20,FMN GV 11 Ramsel
66,Bergstraat 71,2019-12-27,10:00:00,16,6,10,FMN GV 11 Ramsel
66,Bergstraat 71,2019-12-27,11:00:00,26,6,20,FMN GV 11 Ramsel
66,Bergstraat 71,2019-12-27,12:00:00,30,14,16,FMN GV 11 Ramsel
66,Bergstraat 71,2019-12-27,13:00:00,56,28,28,FMN GV 11 Ramsel
66,Bergstraat 71,2019-12-27,14:00:00,62,28,34,FMN GV 11 Ramsel
66,Bergstraat 71,2019-12-27,15:00:00,46,34,12,FMN GV 11 Ramsel
66,Bergstraat 71,2019-12-27,16:00:00,24,18,6,FMN GV 11 Ramsel
66,Bergstraat 71,2019-12-27,17:00:00,32,26,6,FMN GV 11 Ramsel
66,Bergstraat 71,2019-12-27,18:00:00,20,10,10,FMN GV 11 Ramsel
66,Bergstraat 71,2019-12-27,19:00:00,12,10,2,FMN GV 11 Ramsel
66,Bergstraat 71,2019-12-27,20:00:00,14,4,10,FMN GV 11 Ramsel
66,Bergstraat 71,2019-12-27,21:00:00,12,8,4,FMN GV 11 Ramsel
66,Bergstraat 71,2019-12-27,22:00:00,6,2,4,FMN GV 11 Ramsel
66,Bergstraat 71,2019-12-27,23:00:00,2,2,0,FMN GV 11 Ramsel
66,Bergstraat 71,2019-12-28,00:00:00,8,6,2,FMN GV 11 Ramsel
66,Bergstraat 71,2019-12-28,01:00:00,2,0,2,FMN GV 11 Ramsel
66,Bergstraat 71,2019-12-28,02:00:00,12,10,2,FMN GV 11 Ramsel
66,Bergstraat 71,2019-12-28,03:00:00,0,0,0,FMN GV 11 Ramsel
66,Bergstraat 71,2019-12-28,04:00:00,2,0,2,FMN GV 11 Ramsel
66,Bergstraat 71,2019-12-28,05:00:00,6,2,4,FMN GV 11 Ramsel
66,Bergstraat 71,2019-12-28,06:00:00,0,0,0,FMN GV 11 Ramsel
66,Bergstraat 71,2019-12-28,07:00:00,4,2,2,FMN GV 11 Ramsel
66,Bergstraat 71,2019-12-28,08:00:00,16,6,10,FMN GV 11 Ramsel
66,Bergstraat 71,2019-12-28,09:00:00,22,4,18,FMN GV 11 Ramsel
66,Bergstraat 71,2019-12-28,10:00:00,40,14,26,FMN GV 11 Ramsel
66,Bergstraat 71,2019-12-28,11:00:00,38,16,22,FMN GV 11 Ramsel
66,Bergstraat 71,2019-12-28,12:00:00,116,40,76,FMN GV 11 Ramsel
66,Bergstraat 71,2019-12-28,13:00:00,116,36,80,FMN GV 11 Ramsel
66,Bergstraat 71,2019-12-28,14:00:00,136,56,80,FMN GV 11 Ramsel
66,Bergstraat 71,2019-12-28,15:00:00,96,76,20,FMN GV 11 Ramsel
66,Bergstraat 71,2019-12-28,16:00:00,68,62,6,FMN GV 11 Ramsel
66,Bergstraat 71,2019-12-28,17:00:00,24,16,8,FMN GV 11 Ramsel
66,Bergstraat 71,2019-12-28,18:00:00,8,8,0,FMN GV 11 Ramsel
66,Bergstraat 71,2019-12-28,19:00:00,6,2,4,FMN GV 11 Ramsel
66,Bergstraat 71,2019-12-28,20:00:00,6,0,6,FMN GV 11 Ramsel
66,Bergstraat 71,2019-12-28,21:00:00,0,0,0,FMN GV 11 Ramsel
66,Bergstraat 71,2019-12-28,22:00:00,2,0,2,FMN GV 11 Ramsel
66,Bergstraat 71,2019-12-28,23:00:00,2,0,2,FMN GV 11 Ramsel
66,Bergstraat 71,2019-12-29,00:00:00,0,0,0,FMN GV 11 Ramsel
66,Bergstraat 71,2019-12-29,01:00:00,4,0,4,FMN GV 11 Ramsel
66,Bergstraat 71,2019-12-29,02:00:00,0,0,0,FMN GV 11 Ramsel
66,Bergstraat 71,2019-12-29,03:00:00,4,4,0,FMN GV 11 Ramsel
66,Bergstraat 71,2019-12-29,04:00:00,0,0,0,FMN GV 11 Ramsel
66,Bergstraat 71,2019-12-29,05:00:00,4,2,2,FMN GV 11 Ramsel
66,Bergstraat 71,2019-12-29,06:00:00,0,0,0,FMN GV 11 Ramsel
66,Bergstraat 71,2019-12-29,07:00:00,4,2,2,FMN GV 11 Ramsel
66,Bergstraat 71,2019-12-29,08:00:00,24,6,18,FMN GV 11 Ramsel
66,Bergstraat 71,2019-12-29,09:00:00,38,14,24,FMN GV 11 Ramsel
66,Bergstraat 71,2019-12-29,10:00:00,84,40,44,FMN GV 11 Ramsel
66,Bergstraat 71,2019-12-29,11:00:00,74,40,34,FMN GV 11 Ramsel
66,Bergstraat 71,2019-12-29,12:00:00,64,30,34,FMN GV 11 Ramsel
66,Bergstraat 71,2019-12-29,13:00:00,98,56,42,FMN GV 11 Ramsel
66,Bergstraat 71,2019-12-29,14:00:00,104,40,64,FMN GV 11 Ramsel
66,Bergstraat 71,2019-12-29,15:00:00,100,68,32,FMN GV 11 Ramsel
66,Bergstraat 71,2019-12-29,16:00:00,32,18,14,FMN GV 11 Ramsel
66,Bergstraat 71,2019-12-29,17:00:00,16,6,10,FMN GV 11 Ramsel
66,Bergstraat 71,2019-12-29,18:00:00,6,4,2,FMN GV 11 Ramsel
66,Bergstraat 71,2019-12-29,19:00:00,4,2,2,FMN GV 11 Ramsel
66,Bergstraat 71,2019-12-29,20:00:00,6,6,0,FMN GV 11 Ramsel
66,Bergstraat 71,2019-12-29,21:00:00,4,4,0,FMN GV 11 Ramsel
66,Bergstraat 71,2019-12-29,22:00:00,0,0,0,FMN GV 11 Ramsel
66,Bergstraat 71,2019-12-29,23:00:00,0,0,0,FMN GV 11 Ramsel
66,Bergstraat 71,2019-12-30,00:00:00,8,8,0,FMN GV 11 Ramsel
66,Bergstraat 71,2019-12-30,01:00:00,4,0,4,FMN GV 11 Ramsel
66,Bergstraat 71,2019-12-30,02:00:00,0,0,0,FMN GV 11 Ramsel
66,Bergstraat 71,2019-12-30,03:00:00,0,0,0,FMN GV 11 Ramsel
66,Bergstraat 71,2019-12-30,04:00:00,0,0,0,FMN GV 11 Ramsel
66,Bergstraat 71,2019-12-30,05:00:00,8,4,4,FMN GV 11 Ramsel
66,Bergstraat 71,2019-12-30,06:00:00,8,2,6,FMN GV 11 Ramsel
66,Bergstraat 71,2019-12-30,07:00:00,12,4,8,FMN GV 11 Ramsel
66,Bergstraat 71,2019-12-30,08:00:00,14,2,12,FMN GV 11 Ramsel
66,Bergstraat 71,2019-12-30,09:00:00,36,14,22,FMN GV 11 Ramsel
66,Bergstraat 71,2019-12-30,10:00:00,46,34,12,FMN GV 11 Ramsel
66,Bergstraat 71,2019-12-30,11:00:00,76,36,40,FMN GV 11 Ramsel
66,Bergstraat 71,2019-12-30,12:00:00,80,42,38,FMN GV 11 Ramsel
66,Bergstraat 71,2019-12-30,13:00:00,140,40,100,FMN GV 11 Ramsel
66,Bergstraat 71,2019-12-30,14:00:00,128,62,66,FMN GV 11 Ramsel
66,Bergstraat 71,2019-12-30,15:00:00,84,56,28,FMN GV 11 Ramsel
66,Bergstraat 71,2019-12-30,16:00:00,86,50,36,FMN GV 11 Ramsel
66,Bergstraat 71,2019-12-30,17:00:00,42,32,10,FMN GV 11 Ramsel
66,Bergstraat 71,2019-12-30,18:00:00,20,10,10,FMN GV 11 Ramsel
66,Bergstraat 71,2019-12-30,19:00:00,12,4,8,FMN GV 11 Ramsel
66,Bergstraat 71,2019-12-30,20:00:00,20,16,4,FMN GV 11 Ramsel
66,Bergstraat 71,2019-12-30,21:00:00,2,2,0,FMN GV 11 Ramsel
66,Bergstraat 71,2019-12-30,22:00:00,8,6,2,FMN GV 11 Ramsel
66,Bergstraat 71,2019-12-30,23:00:00,6,4,2,FMN GV 11 Ramsel
66,Bergstraat 71,2019-12-31,00:00:00,0,0,0,FMN GV 11 Ramsel
66,Bergstraat 71,2019-12-31,01:00:00,2,2,0,FMN GV 11 Ramsel
66,Bergstraat 71,2019-12-31,02:00:00,0,0,0,FMN GV 11 Ramsel
66,Bergstraat 71,2019-12-31,03:00:00,0,0,0,FMN GV 11 Ramsel
66,Bergstraat 71,2019-12-31,04:00:00,2,0,2,FMN GV 11 Ramsel
66,Bergstraat 71,2019-12-31,05:00:00,6,2,4,FMN GV 11 Ramsel
66,Bergstraat 71,2019-12-31,06:00:00,4,2,2,FMN GV 11 Ramsel
66,Bergstraat 71,2019-12-31,07:00:00,12,4,8,FMN GV 11 Ramsel
66,Bergstraat 71,2019-12-31,08:00:00,10,4,6,FMN GV 11 Ramsel
66,Bergstraat 71,2019-12-31,09:00:00,18,8,10,FMN GV 11 Ramsel
66,Bergstraat 71,2019-12-31,10:00:00,36,16,20,FMN GV 11 Ramsel
66,Bergstraat 71,2019-12-31,11:00:00,36,16,20,FMN GV 11 Ramsel
66,Bergstraat 71,2019-12-31,12:00:00,40,18,22,FMN GV 11 Ramsel
66,Bergstraat 71,2019-12-31,13:00:00,38,22,16,FMN GV 11 Ramsel
66,Bergstraat 71,2019-12-31,14:00:00,50,28,22,FMN GV 11 Ramsel
66,Bergstraat 71,2019-12-31,15:00:00,68,36,32,FMN GV 11 Ramsel
66,Bergstraat 71,2019-12-31,16:00:00,34,16,18,FMN GV 11 Ramsel
66,Bergstraat 71,2019-12-31,17:00:00,24,10,14,FMN GV 11 Ramsel
66,Bergstraat 71,2019-12-31,18:00:00,34,22,12,FMN GV 11 Ramsel
66,Bergstraat 71,2019-12-31,19:00:00,10,4,6,FMN GV 11 Ramsel
66,Bergstraat 71,2019-12-31,20:00:00,4,4,0,FMN GV 11 Ramsel
66,Bergstraat 71,2019-12-31,21:00:00,6,2,4,FMN GV 11 Ramsel
66,Bergstraat 71,2019-12-31,22:00:00,6,6,0,FMN GV 11 Ramsel
66,Bergstraat 71,2019-12-31,23:00:00,0,0,0,FMN GV 11 Ramsel
66,Bergstraat 71,2020-01-01,00:00:00,4,0,4,FMN GV 11 Ramsel
66,Bergstraat 71,2020-01-01,01:00:00,8,6,2,FMN GV 11 Ramsel
66,Bergstraat 71,2020-01-01,02:00:00,14,6,8,FMN GV 11 Ramsel
66,Bergstraat 71,2020-01-01,03:00:00,6,6,0,FMN GV 11 Ramsel
66,Bergstraat 71,2020-01-01,04:00:00,30,14,16,FMN GV 11 Ramsel
66,Bergstraat 71,2020-01-01,05:00:00,2,2,0,FMN GV 11 Ramsel
66,Bergstraat 71,2020-01-01,06:00:00,4,0,4,FMN GV 11 Ramsel
66,Bergstraat 71,2020-01-01,07:00:00,2,0,2,FMN GV 11 Ramsel
66,Bergstraat 71,2020-01-01,08:00:00,2,0,2,FMN GV 11 Ramsel
66,Bergstraat 71,2020-01-01,09:00:00,18,2,16,FMN GV 11 Ramsel
66,Bergstraat 71,2020-01-01,10:00:00,34,12,22,FMN GV 11 Ramsel
66,Bergstraat 71,2020-01-01,11:00:00,40,18,22,FMN GV 11 Ramsel
66,Bergstraat 71,2020-01-01,12:00:00,24,12,12,FMN GV 11 Ramsel
66,Bergstraat 71,2020-01-01,13:00:00,28,24,4,FMN GV 11 Ramsel
66,Bergstraat 71,2020-01-01,14:00:00,34,26,8,FMN GV 11 Ramsel
66,Bergstraat 71,2020-01-01,15:00:00,32,20,12,FMN GV 11 Ramsel
66,Bergstraat 71,2020-01-01,16:00:00,16,14,2,FMN GV 11 Ramsel
66,Bergstraat 71,2020-01-01,17:00:00,6,2,4,FMN GV 11 Ramsel
66,Bergstraat 71,2020-01-01,18:00:00,8,0,8,FMN GV 11 Ramsel
66,Bergstraat 71,2020-01-01,19:00:00,4,2,2,FMN GV 11 Ramsel
66,Bergstraat 71,2020-01-01,20:00:00,0,0,0,FMN GV 11 Ramsel
66,Bergstraat 71,2020-01-01,21:00:00,0,0,0,FMN GV 11 Ramsel
66,Bergstraat 71,2020-01-01,22:00:00,0,0,0,FMN GV 11 Ramsel
66,Bergstraat 71,2020-01-01,23:00:00,0,0,0,FMN GV 11 Ramsel
66,Bergstraat 71,2020-01-02,00:00:00,0,0,0,FMN GV 11 Ramsel
66,Bergstraat 71,2020-01-02,01:00:00,0,0,0,FMN GV 11 Ramsel
66,Bergstraat 71,2020-01-02,02:00:00,0,0,0,FMN GV 11 Ramsel
66,Bergstraat 71,2020-01-02,03:00:00,0,0,0,FMN GV 11 Ramsel
66,Bergstraat 71,2020-01-02,04:00:00,0,0,0,FMN GV 11 Ramsel
66,Bergstraat 71,2020-01-02,05:00:00,10,6,4,FMN GV 11 Ramsel
66,Bergstraat 71,2020-01-02,06:00:00,16,0,16,FMN GV 11 Ramsel
66,Bergstraat 71,2020-01-02,07:00:00,28,4,24,FMN GV 11 Ramsel
66,Bergstraat 71,2020-01-02,08:00:00,16,2,14,FMN GV 11 Ramsel
66,Bergstraat 71,2020-01-02,09:00:00,40,12,28,FMN GV 11 Ramsel
66,Bergstraat 71,2020-01-02,10:00:00,22,10,12,FMN GV 11 Ramsel
66,Bergstraat 71,2020-01-02,11:00:00,24,10,14,FMN GV 11 Ramsel
66,Bergstraat 71,2020-01-02,12:00:00,52,32,20,FMN GV 11 Ramsel
66,Bergstraat 71,2020-01-02,13:00:00,84,20,64,FMN GV 11 Ramsel
66,Bergstraat 71,2020-01-02,14:00:00,72,28,44,FMN GV 11 Ramsel
66,Bergstraat 71,2020-01-02,15:00:00,84,62,22,FMN GV 11 Ramsel
66,Bergstraat 71,2020-01-02,16:00:00,50,32,18,FMN GV 11 Ramsel
66,Bergstraat 71,2020-01-02,17:00:00,28,22,6,FMN GV 11 Ramsel
66,Bergstraat 71,2020-01-02,18:00:00,16,10,6,FMN GV 11 Ramsel
66,Bergstraat 71,2020-01-02,19:00:00,16,4,12,FMN GV 11 Ramsel
66,Bergstraat 71,2020-01-02,20:00:00,22,12,10,FMN GV 11 Ramsel
66,Bergstraat 71,2020-01-02,21:00:00,6,6,0,FMN GV 11 Ramsel
66,Bergstraat 71,2020-01-02,22:00:00,10,6,4,FMN GV 11 Ramsel
66,Bergstraat 71,2020-01-02,23:00:00,0,0,0,FMN GV 11 Ramsel
66,Bergstraat 71,2020-01-03,00:00:00,0,0,0,FMN GV 11 Ramsel
66,Bergstraat 71,2020-01-03,01:00:00,2,0,2,FMN GV 11 Ramsel
66,Bergstraat 71,2020-01-03,02:00:00,2,2,0,FMN GV 11 Ramsel
66,Bergstraat 71,2020-01-03,03:00:00,0,0,0,FMN GV 11 Ramsel
66,Bergstraat 71,2020-01-03,04:00:00,0,0,0,FMN GV 11 Ramsel
66,Bergstraat 71,2020-01-03,05:00:00,10,8,2,FMN GV 11 Ramsel
66,Bergstraat 71,2020-01-03,06:00:00,22,4,18,FMN GV 11 Ramsel
66,Bergstraat 71,2020-01-03,07:00:00,30,8,22,FMN GV 11 Ramsel
66,Bergstraat 71,2020-01-03,08:00:00,24,8,16,FMN GV 11 Ramsel
66,Bergstraat 71,2020-01-03,09:00:00,14,2,12,FMN GV 11 Ramsel
66,Bergstraat 71,2020-01-03,10:00:00,14,8,6,FMN GV 11 Ramsel
66,Bergstraat 71,2020-01-03,11:00:00,18,8,10,FMN GV 11 Ramsel
66,Bergstraat 71,2020-01-03,12:00:00,32,12,20,FMN GV 11 Ramsel
66,Bergstraat 71,2020-01-03,13:00:00,10,8,2,FMN GV 11 Ramsel
66,Bergstraat 71,2020-01-03,14:00:00,12,8,4,FMN GV 11 Ramsel
66,Bergstraat 71,2020-01-03,15:00:00,16,14,2,FMN GV 11 Ramsel
66,Bergstraat 71,2020-01-03,16:00:00,26,18,8,FMN GV 11 Ramsel
66,Bergstraat 71,2020-01-03,17:00:00,20,18,2,FMN GV 11 Ramsel
66,Bergstraat 71,2020-01-03,18:00:00,12,10,2,FMN GV 11 Ramsel
66,Bergstraat 71,2020-01-03,19:00:00,10,8,2,FMN GV 11 Ramsel
66,Bergstraat 71,2020-01-03,20:00:00,8,2,6,FMN GV 11 Ramsel
66,Bergstraat 71,2020-01-03,21:00:00,2,2,0,FMN GV 11 Ramsel
66,Bergstraat 71,2020-01-03,22:00:00,10,6,4,FMN GV 11 Ramsel
66,Bergstraat 71,2020-01-03,23:00:00,0,0,0,FMN GV 11 Ramsel
66,Bergstraat 71,2020-01-04,00:00:00,2,0,2,FMN GV 11 Ramsel
66,Bergstraat 71,2020-01-04,01:00:00,0,0,0,FMN GV 11 Ramsel
66,Bergstraat 71,2020-01-04,02:00:00,2,2,0,FMN GV 11 Ramsel
66,Bergstraat 71,2020-01-04,03:00:00,0,0,0,FMN GV 11 Ramsel
66,Bergstraat 71,2020-01-04,04:00:00,0,0,0,FMN GV 11 Ramsel
66,Bergstraat 71,2020-01-04,05:00:00,4,2,2,FMN GV 11 Ramsel
66,Bergstraat 71,2020-01-04,06:00:00,2,2,0,FMN GV 11 Ramsel
66,Bergstraat 71,2020-01-04,07:00:00,2,2,0,FMN GV 11 Ramsel
66,Bergstraat 71,2020-01-04,08:00:00,12,4,8,FMN GV 11 Ramsel
66,Bergstraat 71,2020-01-04,09:00:00,58,16,42,FMN GV 11 Ramsel
66,Bergstraat 71,2020-01-04,10:00:00,60,30,30,FMN GV 11 Ramsel
66,Bergstraat 71,2020-01-04,11:00:00,100,36,64,FMN GV 11 Ramsel
66,Bergstraat 71,2020-01-04,12:00:00,78,44,34,FMN GV 11 Ramsel
66,Bergstraat 71,2020-01-04,13:00:00,82,34,48,FMN GV 11 Ramsel
66,Bergstraat 71,2020-01-04,14:00:00,114,64,50,FMN GV 11 Ramsel
66,Bergstraat 71,2020-01-04,15:00:00,116,92,24,FMN GV 11 Ramsel
66,Bergstraat 71,2020-01-04,16:00:00,28,20,8,FMN GV 11 Ramsel
66,Bergstraat 71,2020-01-04,17:00:00,14,6,8,FMN GV 11 Ramsel
66,Bergstraat 71,2020-01-04,18:00:00,12,10,2,FMN GV 11 Ramsel
66,Bergstraat 71,2020-01-04,19:00:00,6,0,6,FMN GV 11 Ramsel
66,Bergstraat 71,2020-01-04,20:00:00,6,0,6,FMN GV 11 Ramsel
66,Bergstraat 71,2020-01-04,21:00:00,2,2,0,FMN GV 11 Ramsel
66,Bergstraat 71,2020-01-04,22:00:00,10,4,6,FMN GV 11 Ramsel
66,Bergstraat 71,2020-01-04,23:00:00,4,2,2,FMN GV 11 Ramsel
66,Bergstraat 71,2020-01-05,00:00:00,4,4,0,FMN GV 11 Ramsel
66,Bergstraat 71,2020-01-05,01:00:00,4,4,0,FMN GV 11 Ramsel
66,Bergstraat 71,2020-01-05,02:00:00,2,0,2,FMN GV 11 Ramsel
66,Bergstraat 71,2020-01-05,03:00:00,4,2,2,FMN GV 11 Ramsel
66,Bergstraat 71,2020-01-05,04:00:00,0,0,0,FMN GV 11 Ramsel
66,Bergstraat 71,2020-01-05,05:00:00,2,2,0,FMN GV 11 Ramsel
66,Bergstraat 71,2020-01-05,06:00:00,0,0,0,FMN GV 11 Ramsel
66,Bergstraat 71,2020-01-05,07:00:00,6,0,6,FMN GV 11 Ramsel
66,Bergstraat 71,2020-01-05,08:00:00,38,8,30,FMN GV 11 Ramsel
66,Bergstraat 71,2020-01-05,09:00:00,52,18,34,FMN GV 11 Ramsel
66,Bergstraat 71,2020-01-05,10:00:00,90,48,42,FMN GV 11 Ramsel
66,Bergstraat 71,2020-01-05,11:00:00,90,58,32,FMN GV 11 Ramsel
66,Bergstraat 71,2020-01-05,12:00:00,90,52,38,FMN GV 11 Ramsel
66,Bergstraat 71,2020-01-05,13:00:00,76,36,40,FMN GV 11 Ramsel
66,Bergstraat 71,2020-01-05,14:00:00,94,50,44,FMN GV 11 Ramsel
66,Bergstraat 71,2020-01-05,15:00:00,46,30,16,FMN GV 11 Ramsel
66,Bergstraat 71,2020-01-05,16:00:00,26,12,14,FMN GV 11 Ramsel
66,Bergstraat 71,2020-01-05,17:00:00,12,8,4,FMN GV 11 Ramsel
66,Bergstraat 71,2020-01-05,18:00:00,4,4,0,FMN GV 11 Ramsel
66,Bergstraat 71,2020-01-05,19:00:00,12,8,4,FMN GV 11 Ramsel
66,Bergstraat 71,2020-01-05,20:00:00,6,4,2,FMN GV 11 Ramsel
66,Bergstraat 71,2020-01-05,21:00:00,6,4,2,FMN GV 11 Ramsel
66,Bergstraat 71,2020-01-05,22:00:00,6,4,2,FMN GV 11 Ramsel
66,Bergstraat 71,2020-01-05,23:00:00,2,2,0,FMN GV 11 Ramsel
66,Bergstraat 71,2020-01-06,00:00:00,0,0,0,FMN GV 11 Ramsel
66,Bergstraat 71,2020-01-06,01:00:00,2,0,2,FMN GV 11 Ramsel
66,Bergstraat 71,2020-01-06,02:00:00,2,2,0,FMN GV 11 Ramsel
66,Bergstraat 71,2020-01-06,03:00:00,2,0,2,FMN GV 11 Ramsel
66,Bergstraat 71,2020-01-06,04:00:00,2,2,0,FMN GV 11 Ramsel
66,Bergstraat 71,2020-01-06,05:00:00,12,10,2,FMN GV 11 Ramsel
66,Bergstraat 71,2020-01-06,06:00:00,32,8,24,FMN GV 11 Ramsel
66,Bergstraat 71,2020-01-06,07:00:00,170,16,154,FMN GV 11 Ramsel
66,Bergstraat 71,2020-01-06,08:00:00,110,16,94,FMN GV 11 Ramsel
66,Bergstraat 71,2020-01-06,09:00:00,46,22,24,FMN GV 11 Ramsel
66,Bergstraat 71,2020-01-06,10:00:00,50,30,20,FMN GV 11 Ramsel
66,Bergstraat 71,2020-01-06,11:00:00,34,22,12,FMN GV 11 Ramsel
66,Bergstraat 71,2020-01-06,12:00:00,60,18,42,FMN GV 11 Ramsel
66,Bergstraat 71,2020-01-06,13:00:00,108,52,56,FMN GV 11 Ramsel
66,Bergstraat 71,2020-01-06,14:00:00,116,48,68,FMN GV 11 Ramsel
66,Bergstraat 71,2020-01-06,15:00:00,200,152,48,FMN GV 11 Ramsel
66,Bergstraat 71,2020-01-06,16:00:00,142,112,30,FMN GV 11 Ramsel
66,Bergstraat 71,2020-01-06,17:00:00,76,48,28,FMN GV 11 Ramsel
66,Bergstraat 71,2020-01-06,18:00:00,34,28,6,FMN GV 11 Ramsel
66,Bergstraat 71,2020-01-06,19:00:00,20,18,2,FMN GV 11 Ramsel
66,Bergstraat 71,2020-01-06,20:00:00,8,6,2,FMN GV 11 Ramsel
66,Bergstraat 71,2020-01-06,21:00:00,8,6,2,FMN GV 11 Ramsel
66,Bergstraat 71,2020-01-06,22:00:00,12,12,0,FMN GV 11 Ramsel
66,Bergstraat 71,2020-01-06,23:00:00,4,2,2,FMN GV 11 Ramsel
66,Bergstraat 71,2020-01-07,00:00:00,0,0,0,FMN GV 11 Ramsel
66,Bergstraat 71,2020-01-07,01:00:00,0,0,0,FMN GV 11 Ramsel
66,Bergstraat 71,2020-01-07,02:00:00,0,0,0,FMN GV 11 Ramsel
66,Bergstraat 71,2020-01-07,03:00:00,2,0,2,FMN GV 11 Ramsel
66,Bergstraat 71,2020-01-07,04:00:00,2,2,0,FMN GV 11 Ramsel
66,Bergstraat 71,2020-01-07,05:00:00,18,14,4,FMN GV 11 Ramsel
66,Bergstraat 71,2020-01-07,06:00:00,36,2,34,FMN GV 11 Ramsel
66,Bergstraat 71,2020-01-07,07:00:00,162,28,134,FMN GV 11 Ramsel
66,Bergstraat 71,2020-01-07,08:00:00,142,18,124,FMN GV 11 Ramsel
66,Bergstraat 71,2020-01-07,09:00:00,30,14,16,FMN GV 11 Ramsel
66,Bergstraat 71,2020-01-07,10:00:00,26,14,12,FMN GV 11 Ramsel
66,Bergstraat 71,2020-01-07,11:00:00,46,18,28,FMN GV 11 Ramsel
66,Bergstraat 71,2020-01-07,12:00:00,74,20,54,FMN GV 11 Ramsel
66,Bergstraat 71,2020-01-07,13:00:00,122,66,56,FMN GV 11 Ramsel
66,Bergstraat 71,2020-01-07,14:00:00,98,60,38,FMN GV 11 Ramsel
66,Bergstraat 71,2020-01-07,15:00:00,210,176,34,FMN GV 11 Ramsel
66,Bergstraat 71,2020-01-07,16:00:00,174,118,56,FMN GV 11 Ramsel
66,Bergstraat 71,2020-01-07,17:00:00,86,52,34,FMN GV 11 Ramsel
66,Bergstraat 71,2020-01-07,18:00:00,52,28,24,FMN GV 11 Ramsel
66,Bergstraat 71,2020-01-07,19:00:00,42,10,32,FMN GV 11 Ramsel
66,Bergstraat 71,2020-01-07,20:00:00,28,24,4,FMN GV 11 Ramsel
66,Bergstraat 71,2020-01-07,21:00:00,12,10,2,FMN GV 11 Ramsel
66,Bergstraat 71,2020-01-07,22:00:00,12,6,6,FMN GV 11 Ramsel
66,Bergstraat 71,2020-01-07,23:00:00,0,0,0,FMN GV 11 Ramsel
66,Bergstraat 71,2020-01-08,00:00:00,4,4,0,FMN GV 11 Ramsel
66,Bergstraat 71,2020-01-08,01:00:00,0,0,0,FMN GV 11 Ramsel
66,Bergstraat 71,2020-01-08,02:00:00,2,0,2,FMN GV 11 Ramsel
66,Bergstraat 71,2020-01-08,03:00:00,0,0,0,FMN GV 11 Ramsel
66,Bergstraat 71,2020-01-08,04:00:00,2,2,0,FMN GV 11 Ramsel
66,Bergstraat 71,2020-01-08,05:00:00,16,14,2,FMN GV 11 Ramsel
66,Bergstraat 71,2020-01-08,06:00:00,30,6,24,FMN GV 11 Ramsel
66,Bergstraat 71,2020-01-08,07:00:00,118,12,106,FMN GV 11 Ramsel
66,Bergstraat 71,2020-01-08,08:00:00,140,20,120,FMN GV 11 Ramsel
66,Bergstraat 71,2020-01-08,09:00:00,26,12,14,FMN GV 11 Ramsel
66,Bergstraat 71,2020-01-08,10:00:00,24,14,10,FMN GV 11 Ramsel
66,Bergstraat 71,2020-01-08,11:00:00,18,12,6,FMN GV 11 Ramsel
66,Bergstraat 71,2020-01-08,12:00:00,144,124,20,FMN GV 11 Ramsel
66,Bergstraat 71,2020-01-08,13:00:00,46,22,24,FMN GV 11 Ramsel
66,Bergstraat 71,2020-01-08,14:00:00,46,18,28,FMN GV 11 Ramsel
66,Bergstraat 71,2020-01-08,15:00:00,44,26,18,FMN GV 11 Ramsel
66,Bergstraat 71,2020-01-08,16:00:00,50,38,12,FMN GV 11 Ramsel
66,Bergstraat 71,2020-01-08,17:00:00,44,34,10,FMN GV 11 Ramsel
66,Bergstraat 71,2020-01-08,18:00:00,34,16,18,FMN GV 11 Ramsel
66,Bergstraat 71,2020-01-08,19:00:00,10,8,2,FMN GV 11 Ramsel
66,Bergstraat 71,2020-01-08,20:00:00,12,8,4,FMN GV 11 Ramsel
66,Bergstraat 71,2020-01-08,21:00:00,10,8,2,FMN GV 11 Ramsel
66,Bergstraat 71,2020-01-08,22:00:00,6,6,0,FMN GV 11 Ramsel
66,Bergstraat 71,2020-01-08,23:00:00,2,2,0,FMN GV 11 Ramsel
66,Bergstraat 71,2020-01-09,00:00:00,2,0,2,FMN GV 11 Ramsel
66,Bergstraat 71,2020-01-09,01:00:00,0,0,0,FMN GV 11 Ramsel
66,Bergstraat 71,2020-01-09,02:00:00,0,0,0,FMN GV 11 Ramsel
66,Bergstraat 71,2020-01-09,03:00:00,0,0,0,FMN GV 11 Ramsel
66,Bergstraat 71,2020-01-09,04:00:00,2,2,0,FMN GV 11 Ramsel
66,Bergstraat 71,2020-01-09,05:00:00,12,10,2,FMN GV 11 Ramsel
66,Bergstraat 71,2020-01-09,06:00:00,32,4,28,FMN GV 11 Ramsel
66,Bergstraat 71,2020-01-09,07:00:00,106,12,94,FMN GV 11 Ramsel
66,Bergstraat 71,2020-01-09,08:00:00,114,10,104,FMN GV 11 Ramsel
66,Bergstraat 71,2020-01-09,09:00:00,24,4,20,FMN GV 11 Ramsel
66,Bergstraat 71,2020-01-09,10:00:00,20,16,4,FMN GV 11 Ramsel
66,Bergstraat 71,2020-01-09,11:00:00,12,8,4,FMN GV 11 Ramsel
66,Bergstraat 71,2020-01-09,12:00:00,22,8,14,FMN GV 11 Ramsel
66,Bergstraat 71,2020-01-09,13:00:00,22,8,14,FMN GV 11 Ramsel
66,Bergstraat 71,2020-01-09,14:00:00,46,20,26,FMN GV 11 Ramsel
66,Bergstraat 71,2020-01-09,15:00:00,152,128,24,FMN GV 11 Ramsel
66,Bergstraat 71,2020-01-09,16:00:00,86,76,10,FMN GV 11 Ramsel
66,Bergstraat 71,2020-01-09,17:00:00,48,30,18,FMN GV 11 Ramsel
66,Bergstraat 71,2020-01-09,18:00:00,34,20,14,FMN GV 11 Ramsel
66,Bergstraat 71,2020-01-09,19:00:00,10,10,0,FMN GV 11 Ramsel
66,Bergstraat 71,2020-01-09,20:00:00,6,2,4,FMN GV 11 Ramsel
66,Bergstraat 71,2020-01-09,21:00:00,2,2,0,FMN GV 11 Ramsel
66,Bergstraat 71,2020-01-09,22:00:00,2,2,0,FMN GV 11 Ramsel
66,Bergstraat 71,2020-01-09,23:00:00,0,0,0,FMN GV 11 Ramsel
66,Bergstraat 71,2020-01-10,00:00:00,2,2,0,FMN GV 11 Ramsel
66,Bergstraat 71,2020-01-10,01:00:00,0,0,0,FMN GV 11 Ramsel
66,Bergstraat 71,2020-01-10,02:00:00,0,0,0,FMN GV 11 Ramsel
66,Bergstraat 71,2020-01-10,03:00:00,0,0,0,FMN GV 11 Ramsel
66,Bergstraat 71,2020-01-10,04:00:00,2,2,0,FMN GV 11 Ramsel
66,Bergstraat 71,2020-01-10,05:00:00,8,6,2,FMN GV 11 Ramsel
66,Bergstraat 71,2020-01-10,06:00:00,26,6,20,FMN GV 11 Ramsel
66,Bergstraat 71,2020-01-10,07:00:00,70,2,68,FMN GV 11 Ramsel
66,Bergstraat 71,2020-01-10,08:00:00,114,18,96,FMN GV 11 Ramsel
66,Bergstraat 71,2020-01-10,09:00:00,20,4,16,FMN GV 11 Ramsel
66,Bergstraat 71,2020-01-10,10:00:00,26,10,16,FMN GV 11 Ramsel
66,Bergstraat 71,2020-01-10,11:00:00,18,8,10,FMN GV 11 Ramsel
66,Bergstraat 71,2020-01-10,12:00:00,72,36,36,FMN GV 11 Ramsel
66,Bergstraat 71,2020-01-10,13:00:00,42,22,20,FMN GV 11 Ramsel
66,Bergstraat 71,2020-01-10,14:00:00,76,46,30,FMN GV 11 Ramsel
66,Bergstraat 71,2020-01-10,15:00:00,90,66,24,FMN GV 11 Ramsel
66,Bergstraat 71,2020-01-10,16:00:00,78,66,12,FMN GV 11 Ramsel
66,Bergstraat 71,2020-01-10,17:00:00,42,32,10,FMN GV 11 Ramsel
66,Bergstraat 71,2020-01-10,18:00:00,24,12,12,FMN GV 11 Ramsel
66,Bergstraat 71,2020-01-10,19:00:00,26,16,10,FMN GV 11 Ramsel
66,Bergstraat 71,2020-01-10,20:00:00,24,14,10,FMN GV 11 Ramsel
66,Bergstraat 71,2020-01-10,21:00:00,10,8,2,FMN GV 11 Ramsel
66,Bergstraat 71,2020-01-10,22:00:00,6,4,2,FMN GV 11 Ramsel
66,Bergstraat 71,2020-01-10,23:00:00,4,4,0,FMN GV 11 Ramsel
66,Bergstraat 71,2020-01-11,00:00:00,4,2,2,FMN GV 11 Ramsel
66,Bergstraat 71,2020-01-11,01:00:00,10,8,2,FMN GV 11 Ramsel
66,Bergstraat 71,2020-01-11,02:00:00,4,4,0,FMN GV 11 Ramsel
66,Bergstraat 71,2020-01-11,03:00:00,2,2,0,FMN GV 11 Ramsel
66,Bergstraat 71,2020-01-11,04:00:00,2,0,2,FMN GV 11 Ramsel
66,Bergstraat 71,2020-01-11,05:00:00,2,0,2,FMN GV 11 Ramsel
66,Bergstraat 71,2020-01-11,06:00:00,0,0,0,FMN GV 11 Ramsel
66,Bergstraat 71,2020-01-11,07:00:00,10,4,6,FMN GV 11 Ramsel
66,Bergstraat 71,2020-01-11,08:00:00,10,2,8,FMN GV 11 Ramsel
66,Bergstraat 71,2020-01-11,09:00:00,74,16,58,FMN GV 11 Ramsel
66,Bergstraat 71,2020-01-11,10:00:00,72,34,38,FMN GV 11 Ramsel
66,Bergstraat 71,2020-01-11,11:00:00,96,58,38,FMN GV 11 Ramsel
66,Bergstraat 71,2020-01-11,12:00:00,90,36,54,FMN GV 11 Ramsel
66,Bergstraat 71,2020-01-11,13:00:00,166,72,94,FMN GV 11 Ramsel
66,Bergstraat 71,2020-01-11,14:00:00,88,40,48,FMN GV 11 Ramsel
66,Bergstraat 71,2020-01-11,15:00:00,94,56,38,FMN GV 11 Ramsel
66,Bergstraat 71,2020-01-11,16:00:00,54,34,20,FMN GV 11 Ramsel
66,Bergstraat 71,2020-01-11,17:00:00,36,18,18,FMN GV 11 Ramsel
66,Bergstraat 71,2020-01-11,18:00:00,18,10,8,FMN GV 11 Ramsel
66,Bergstraat 71,2020-01-11,19:00:00,22,14,8,FMN GV 11 Ramsel
66,Bergstraat 71,2020-01-11,20:00:00,0,0,0,FMN GV 11 Ramsel
66,Bergstraat 71,2020-01-11,21:00:00,8,8,0,FMN GV 11 Ramsel
66,Bergstraat 71,2020-01-11,22:00:00,10,8,2,FMN GV 11 Ramsel
66,Bergstraat 71,2020-01-11,23:00:00,4,4,0,FMN GV 11 Ramsel
66,Bergstraat 71,2020-01-12,00:00:00,2,0,2,FMN GV 11 Ramsel
66,Bergstraat 71,2020-01-12,01:00:00,2,0,2,FMN GV 11 Ramsel
66,Bergstraat 71,2020-01-12,02:00:00,6,6,0,FMN GV 11 Ramsel
66,Bergstraat 71,2020-01-12,03:00:00,4,0,4,FMN GV 11 Ramsel
66,Bergstraat 71,2020-01-12,04:00:00,0,0,0,FMN GV 11 Ramsel
66,Bergstraat 71,2020-01-12,05:00:00,2,2,0,FMN GV 11 Ramsel
66,Bergstraat 71,2020-01-12,06:00:00,2,0,2,FMN GV 11 Ramsel
66,Bergstraat 71,2020-01-12,07:00:00,4,2,2,FMN GV 11 Ramsel
66,Bergstraat 71,2020-01-12,08:00:00,42,6,36,FMN GV 11 Ramsel
66,Bergstraat 71,2020-01-12,09:00:00,90,38,52,FMN GV 11 Ramsel
66,Bergstraat 71,2020-01-12,10:00:00,122,66,56,FMN GV 11 Ramsel
66,Bergstraat 71,2020-01-12,11:00:00,116,76,40,FMN GV 11 Ramsel
66,Bergstraat 71,2020-01-12,12:00:00,42,18,24,FMN GV 11 Ramsel
66,Bergstraat 71,2020-01-12,13:00:00,14,10,4,FMN GV 11 Ramsel
66,Bergstraat 71,2020-01-12,14:00:00,18,10,8,FMN GV 11 Ramsel
66,Bergstraat 71,2020-01-12,15:00:00,28,14,14,FMN GV 11 Ramsel
66,Bergstraat 71,2020-01-12,16:00:00,22,14,8,FMN GV 11 Ramsel
66,Bergstraat 71,2020-01-12,17:00:00,36,10,26,FMN GV 11 Ramsel
66,Bergstraat 71,2020-01-12,18:00:00,6,2,4,FMN GV 11 Ramsel
66,Bergstraat 71,2020-01-12,19:00:00,12,4,8,FMN GV 11 Ramsel
66,Bergstraat 71,2020-01-12,20:00:00,6,4,2,FMN GV 11 Ramsel
66,Bergstraat 71,2020-01-12,21:00:00,2,0,2,FMN GV 11 Ramsel
66,Bergstraat 71,2020-01-12,22:00:00,0,0,0,FMN GV 11 Ramsel
66,Bergstraat 71,2020-01-12,23:00:00,0,0,0,FMN GV 11 Ramsel
66,Bergstraat 71,2020-01-13,00:00:00,2,0,2,FMN GV 11 Ramsel
66,Bergstraat 71,2020-01-13,01:00:00,2,0,2,FMN GV 11 Ramsel
66,Bergstraat 71,2020-01-13,02:00:00,0,0,0,FMN GV 11 Ramsel
66,Bergstraat 71,2020-01-13,03:00:00,0,0,0,FMN GV 11 Ramsel
66,Bergstraat 71,2020-01-13,04:00:00,2,2,0,FMN GV 11 Ramsel
66,Bergstraat 71,2020-01-13,05:00:00,6,6,0,FMN GV 11 Ramsel
66,Bergstraat 71,2020-01-13,06:00:00,46,10,36,FMN GV 11 Ramsel
66,Bergstraat 71,2020-01-13,07:00:00,138,18,120,FMN GV 11 Ramsel
66,Bergstraat 71,2020-01-13,08:00:00,110,8,102,FMN GV 11 Ramsel
66,Bergstraat 71,2020-01-13,09:00:00,34,12,22,FMN GV 11 Ramsel
66,Bergstraat 71,2020-01-13,10:00:00,32,14,18,FMN GV 11 Ramsel
66,Bergstraat 71,2020-01-13,11:00:00,52,28,24,FMN GV 11 Ramsel
66,Bergstraat 71,2020-01-13,12:00:00,50,26,24,FMN GV 11 Ramsel
66,Bergstraat 71,2020-01-13,13:00:00,114,56,58,FMN GV 11 Ramsel
66,Bergstraat 71,2020-01-13,14:00:00,102,62,40,FMN GV 11 Ramsel
66,Bergstraat 71,2020-01-13,15:00:00,200,158,42,FMN GV 11 Ramsel
66,Bergstraat 71,2020-01-13,16:00:00,120,88,32,FMN GV 11 Ramsel
66,Bergstraat 71,2020-01-13,17:00:00,58,32,26,FMN GV 11 Ramsel
66,Bergstraat 71,2020-01-13,18:00:00,38,26,12,FMN GV 11 Ramsel
66,Bergstraat 71,2020-01-13,19:00:00,26,14,12,FMN GV 11 Ramsel
66,Bergstraat 71,2020-01-13,20:00:00,16,16,0,FMN GV 11 Ramsel
66,Bergstraat 71,2020-01-13,21:00:00,8,6,2,FMN GV 11 Ramsel
66,Bergstraat 71,2020-01-13,22:00:00,6,0,6,FMN GV 11 Ramsel
66,Bergstraat 71,2020-01-13,23:00:00,6,4,2,FMN GV 11 Ramsel
66,Bergstraat 71,2020-01-14,00:00:00,0,0,0,FMN GV 11 Ramsel
66,Bergstraat 71,2020-01-14,01:00:00,4,0,4,FMN GV 11 Ramsel
66,Bergstraat 71,2020-01-14,02:00:00,0,0,0,FMN GV 11 Ramsel
66,Bergstraat 71,2020-01-14,03:00:00,0,0,0,FMN GV 11 Ramsel
66,Bergstraat 71,2020-01-14,04:00:00,2,2,0,FMN GV 11 Ramsel
66,Bergstraat 71,2020-01-14,05:00:00,10,6,4,FMN GV 11 Ramsel
66,Bergstraat 71,2020-01-14,06:00:00,24,2,22,FMN GV 11 Ramsel
66,Bergstraat 71,2020-01-14,07:00:00,96,12,84,FMN GV 11 Ramsel
66,Bergstraat 71,2020-01-14,08:00:00,106,8,98,FMN GV 11 Ramsel
66,Bergstraat 71,2020-01-14,09:00:00,14,4,10,FMN GV 11 Ramsel
66,Bergstraat 71,2020-01-14,10:00:00,28,4,24,FMN GV 11 Ramsel
66,Bergstraat 71,2020-01-14,11:00:00,28,16,12,FMN GV 11 Ramsel
66,Bergstraat 71,2020-01-14,12:00:00,36,16,20,FMN GV 11 Ramsel
66,Bergstraat 71,2020-01-14,13:00:00,28,12,16,FMN GV 11 Ramsel
66,Bergstraat 71,2020-01-14,14:00:00,38,22,16,FMN GV 11 Ramsel
66,Bergstraat 71,2020-01-14,15:00:00,164,134,30,FMN GV 11 Ramsel
66,Bergstraat 71,2020-01-14,16:00:00,90,72,18,FMN GV 11 Ramsel
66,Bergstraat 71,2020-01-14,17:00:00,60,38,22,FMN GV 11 Ramsel
66,Bergstraat 71,2020-01-14,18:00:00,32,22,10,FMN GV 11 Ramsel
66,Bergstraat 71,2020-01-14,19:00:00,20,6,14,FMN GV 11 Ramsel
66,Bergstraat 71,2020-01-14,20:00:00,18,14,4,FMN GV 11 Ramsel
66,Bergstraat 71,2020-01-14,21:00:00,8,2,6,FMN GV 11 Ramsel
66,Bergstraat 71,2020-01-14,22:00:00,6,2,4,FMN GV 11 Ramsel
66,Bergstraat 71,2020-01-14,23:00:00,0,0,0,FMN GV 11 Ramsel
66,Bergstraat 71,2020-01-15,00:00:00,4,2,2,FMN GV 11 Ramsel
66,Bergstraat 71,2020-01-15,01:00:00,0,0,0,FMN GV 11 Ramsel
66,Bergstraat 71,2020-01-15,02:00:00,0,0,0,FMN GV 11 Ramsel
66,Bergstraat 71,2020-01-15,03:00:00,0,0,0,FMN GV 11 Ramsel
66,Bergstraat 71,2020-01-15,04:00:00,4,2,2,FMN GV 11 Ramsel
66,Bergstraat 71,2020-01-15,05:00:00,6,4,2,FMN GV 11 Ramsel
66,Bergstraat 71,2020-01-15,06:00:00,24,6,18,FMN GV 11 Ramsel
66,Bergstraat 71,2020-01-15,07:00:00,118,16,102,FMN GV 11 Ramsel
66,Bergstraat 71,2020-01-15,08:00:00,112,18,94,FMN GV 11 Ramsel
66,Bergstraat 71,2020-01-15,09:00:00,18,4,14,FMN GV 11 Ramsel
66,Bergstraat 71,2020-01-15,10:00:00,28,14,14,FMN GV 11 Ramsel
66,Bergstraat 71,2020-01-15,11:00:00,38,16,22,FMN GV 11 Ramsel
66,Bergstraat 71,2020-01-15,12:00:00,152,130,22,FMN GV 11 Ramsel
66,Bergstraat 71,2020-01-15,13:00:00,46,26,20,FMN GV 11 Ramsel
66,Bergstraat 71,2020-01-15,14:00:00,40,12,28,FMN GV 11 Ramsel
66,Bergstraat 71,2020-01-15,15:00:00,46,30,16,FMN GV 11 Ramsel
66,Bergstraat 71,2020-01-15,16:00:00,34,20,14,FMN GV 11 Ramsel
66,Bergstraat 71,2020-01-15,17:00:00,58,40,18,FMN GV 11 Ramsel
66,Bergstraat 71,2020-01-15,18:00:00,20,12,8,FMN GV 11 Ramsel
66,Bergstraat 71,2020-01-15,19:00:00,22,14,8,FMN GV 11 Ramsel
66,Bergstraat 71,2020-01-15,20:00:00,16,10,6,FMN GV 11 Ramsel
66,Bergstraat 71,2020-01-15,21:00:00,6,4,2,FMN GV 11 Ramsel
66,Bergstraat 71,2020-01-15,22:00:00,12,6,6,FMN GV 11 Ramsel
66,Bergstraat 71,2020-01-15,23:00:00,0,0,0,FMN GV 11 Ramsel
66,Bergstraat 71,2020-01-16,00:00:00,0,0,0,FMN GV 11 Ramsel
66,Bergstraat 71,2020-01-16,01:00:00,0,0,0,FMN GV 11 Ramsel
66,Bergstraat 71,2020-01-16,02:00:00,0,0,0,FMN GV 11 Ramsel
66,Bergstraat 71,2020-01-16,03:00:00,0,0,0,FMN GV 11 Ramsel
66,Bergstraat 71,2020-01-16,04:00:00,2,2,0,FMN GV 11 Ramsel
66,Bergstraat 71,2020-01-16,05:00:00,10,8,2,FMN GV 11 Ramsel
66,Bergstraat 71,2020-01-16,06:00:00,40,8,32,FMN GV 11 Ramsel
66,Bergstraat 71,2020-01-16,07:00:00,124,24,100,FMN GV 11 Ramsel
66,Bergstraat 71,2020-01-16,08:00:00,98,10,88,FMN GV 11 Ramsel
66,Bergstraat 71,2020-01-16,09:00:00,38,10,28,FMN GV 11 Ramsel
66,Bergstraat 71,2020-01-16,10:00:00,46,16,30,FMN GV 11 Ramsel
66,Bergstraat 71,2020-01-16,11:00:00,42,26,16,FMN GV 11 Ramsel
66,Bergstraat 71,2020-01-16,12:00:00,82,48,34,FMN GV 11 Ramsel
66,Bergstraat 71,2020-01-16,13:00:00,120,52,68,FMN GV 11 Ramsel
66,Bergstraat 71,2020-01-16,14:00:00,132,72,60,FMN GV 11 Ramsel
66,Bergstraat 71,2020-01-16,15:00:00,222,168,54,FMN GV 11 Ramsel
66,Bergstraat 71,2020-01-16,16:00:00,128,112,16,FMN GV 11 Ramsel
66,Bergstraat 71,2020-01-16,17:00:00,68,42,26,FMN GV 11 Ramsel
66,Bergstraat 71,2020-01-16,18:00:00,64,46,18,FMN GV 11 Ramsel
66,Bergstraat 71,2020-01-16,19:00:00,26,18,8,FMN GV 11 Ramsel
66,Bergstraat 71,2020-01-16,20:00:00,20,16,4,FMN GV 11 Ramsel
66,Bergstraat 71,2020-01-16,21:00:00,10,8,2,FMN GV 11 Ramsel
66,Bergstraat 71,2020-01-16,22:00:00,14,6,8,FMN GV 11 Ramsel
66,Bergstraat 71,2020-01-16,23:00:00,2,2,0,FMN GV 11 Ramsel
66,Bergstraat 71,2020-01-17,00:00:00,0,0,0,FMN GV 11 Ramsel
66,Bergstraat 71,2020-01-17,01:00:00,0,0,0,FMN GV 11 Ramsel
66,Bergstraat 71,2020-01-17,02:00:00,0,0,0,FMN GV 11 Ramsel
66,Bergstraat 71,2020-01-17,03:00:00,0,0,0,FMN GV 11 Ramsel
66,Bergstraat 71,2020-01-17,04:00:00,2,2,0,FMN GV 11 Ramsel
66,Bergstraat 71,2020-01-17,05:00:00,6,6,0,FMN GV 11 Ramsel
66,Bergstraat 71,2020-01-17,06:00:00,20,6,14,FMN GV 11 Ramsel
66,Bergstraat 71,2020-01-17,07:00:00,130,10,120,FMN GV 11 Ramsel
66,Bergstraat 71,2020-01-17,08:00:00,100,12,88,FMN GV 11 Ramsel
66,Bergstraat 71,2020-01-17,09:00:00,30,8,22,FMN GV 11 Ramsel
66,Bergstraat 71,2020-01-17,10:00:00,20,8,12,FMN GV 11 Ramsel
66,Bergstraat 71,2020-01-17,11:00:00,24,16,8,FMN GV 11 Ramsel
66,Bergstraat 71,2020-01-17,12:00:00,26,16,10,FMN GV 11 Ramsel
66,Bergstraat 71,2020-01-17,13:00:00,30,18,12,FMN GV 11 Ramsel
66,Bergstraat 71,2020-01-17,14:00:00,50,26,24,FMN GV 11 Ramsel
66,Bergstraat 71,2020-01-17,15:00:00,128,112,16,FMN GV 11 Ramsel
66,Bergstraat 71,2020-01-17,16:00:00,76,66,10,FMN GV 11 Ramsel
66,Bergstraat 71,2020-01-17,17:00:00,52,34,18,FMN GV 11 Ramsel
66,Bergstraat 71,2020-01-17,18:00:00,28,16,12,FMN GV 11 Ramsel
66,Bergstraat 71,2020-01-17,19:00:00,26,16,10,FMN GV 11 Ramsel
66,Bergstraat 71,2020-01-17,20:00:00,12,4,8,FMN GV 11 Ramsel
66,Bergstraat 71,2020-01-17,21:00:00,4,0,4,FMN GV 11 Ramsel
66,Bergstraat 71,2020-01-17,22:00:00,6,2,4,FMN GV 11 Ramsel
66,Bergstraat 71,2020-01-17,23:00:00,6,6,0,FMN GV 11 Ramsel
66,Bergstraat 71,2020-01-18,00:00:00,8,2,6,FMN GV 11 Ramsel
66,Bergstraat 71,2020-01-18,01:00:00,0,0,0,FMN GV 11 Ramsel
66,Bergstraat 71,2020-01-18,02:00:00,6,4,2,FMN GV 11 Ramsel
66,Bergstraat 71,2020-01-18,03:00:00,2,2,0,FMN GV 11 Ramsel
66,Bergstraat 71,2020-01-18,04:00:00,0,0,0,FMN GV 11 Ramsel
66,Bergstraat 71,2020-01-18,05:00:00,2,2,0,FMN GV 11 Ramsel
66,Bergstraat 71,2020-01-18,06:00:00,4,0,4,FMN GV 11 Ramsel
66,Bergstraat 71,2020-01-18,07:00:00,8,4,4,FMN GV 11 Ramsel
66,Bergstraat 71,2020-01-18,08:00:00,16,4,12,FMN GV 11 Ramsel
66,Bergstraat 71,2020-01-18,09:00:00,44,16,28,FMN GV 11 Ramsel
66,Bergstraat 71,2020-01-18,10:00:00,66,24,42,FMN GV 11 Ramsel
66,Bergstraat 71,2020-01-18,11:00:00,96,66,30,FMN GV 11 Ramsel
66,Bergstraat 71,2020-01-18,12:00:00,88,56,32,FMN GV 11 Ramsel
66,Bergstraat 71,2020-01-18,13:00:00,120,52,68,FMN GV 11 Ramsel
66,Bergstraat 71,2020-01-18,14:00:00,102,56,46,FMN GV 11 Ramsel
66,Bergstraat 71,2020-01-18,15:00:00,122,54,68,FMN GV 11 Ramsel
66,Bergstraat 71,2020-01-18,16:00:00,68,38,30,FMN GV 11 Ramsel
66,Bergstraat 71,2020-01-18,17:00:00,32,24,8,FMN GV 11 Ramsel
66,Bergstraat 71,2020-01-18,18:00:00,20,8,12,FMN GV 11 Ramsel
66,Bergstraat 71,2020-01-18,19:00:00,16,4,12,FMN GV 11 Ramsel
66,Bergstraat 71,2020-01-18,20:00:00,12,4,8,FMN GV 11 Ramsel
66,Bergstraat 71,2020-01-18,21:00:00,2,0,2,FMN GV 11 Ramsel
66,Bergstraat 71,2020-01-18,22:00:00,12,10,2,FMN GV 11 Ramsel
66,Bergstraat 71,2020-01-18,23:00:00,0,0,0,FMN GV 11 Ramsel
66,Bergstraat 71,2020-01-19,00:00:00,2,0,2,FMN GV 11 Ramsel
66,Bergstraat 71,2020-01-19,01:00:00,4,2,2,FMN GV 11 Ramsel
66,Bergstraat 71,2020-01-19,02:00:00,0,0,0,FMN GV 11 Ramsel
66,Bergstraat 71,2020-01-19,03:00:00,4,2,2,FMN GV 11 Ramsel
66,Bergstraat 71,2020-01-19,04:00:00,0,0,0,FMN GV 11 Ramsel
66,Bergstraat 71,2020-01-19,05:00:00,0,0,0,FMN GV 11 Ramsel
66,Bergstraat 71,2020-01-19,06:00:00,2,2,0,FMN GV 11 Ramsel
66,Bergstraat 71,2020-01-19,07:00:00,2,0,2,FMN GV 11 Ramsel
66,Bergstraat 71,2020-01-19,08:00:00,8,2,6,FMN GV 11 Ramsel
66,Bergstraat 71,2020-01-19,09:00:00,30,12,18,FMN GV 11 Ramsel
66,Bergstraat 71,2020-01-19,10:00:00,56,30,26,FMN GV 11 Ramsel
66,Bergstraat 71,2020-01-19,11:00:00,120,50,70,FMN GV 11 Ramsel
66,Bergstraat 71,2020-01-19,12:00:00,60,26,34,FMN GV 11 Ramsel
66,Bergstraat 71,2020-01-19,13:00:00,100,52,48,FMN GV 11 Ramsel
66,Bergstraat 71,2020-01-19,14:00:00,72,18,54,FMN GV 11 Ramsel
66,Bergstraat 71,2020-01-19,15:00:00,80,44,36,FMN GV 11 Ramsel
66,Bergstraat 71,2020-01-19,16:00:00,34,20,14,FMN GV 11 Ramsel
66,Bergstraat 71,2020-01-19,17:00:00,18,10,8,FMN GV 11 Ramsel
66,Bergstraat 71,2020-01-19,18:00:00,18,6,12,FMN GV 11 Ramsel
66,Bergstraat 71,2020-01-19,19:00:00,4,0,4,FMN GV 11 Ramsel
66,Bergstraat 71,2020-01-19,20:00:00,8,8,0,FMN GV 11 Ramsel
66,Bergstraat 71,2020-01-19,21:00:00,6,6,0,FMN GV 11 Ramsel
66,Bergstraat 71,2020-01-19,22:00:00,4,2,2,FMN GV 11 Ramsel
66,Bergstraat 71,2020-01-19,23:00:00,0,0,0,FMN GV 11 Ramsel
66,Bergstraat 71,2020-01-20,00:00:00,2,2,0,FMN GV 11 Ramsel
66,Bergstraat 71,2020-01-20,01:00:00,0,0,0,FMN GV 11 Ramsel
66,Bergstraat 71,2020-01-20,02:00:00,0,0,0,FMN GV 11 Ramsel
66,Bergstraat 71,2020-01-20,03:00:00,0,0,0,FMN GV 11 Ramsel
66,Bergstraat 71,2020-01-20,04:00:00,0,0,0,FMN GV 11 Ramsel
66,Bergstraat 71,2020-01-20,05:00:00,6,4,2,FMN GV 11 Ramsel
66,Bergstraat 71,2020-01-20,06:00:00,22,4,18,FMN GV 11 Ramsel
66,Bergstraat 71,2020-01-20,07:00:00,60,8,52,FMN GV 11 Ramsel
66,Bergstraat 71,2020-01-20,08:00:00,44,4,40,FMN GV 11 Ramsel
66,Bergstraat 71,2020-01-20,09:00:00,20,10,10,FMN GV 11 Ramsel
66,Bergstraat 71,2020-01-20,10:00:00,20,12,8,FMN GV 11 Ramsel
66,Bergstraat 71,2020-01-20,11:00:00,18,2,16,FMN GV 11 Ramsel
66,Bergstraat 71,2020-01-20,12:00:00,30,20,10,FMN GV 11 Ramsel
66,Bergstraat 71,2020-01-20,13:00:00,54,30,24,FMN GV 11 Ramsel
66,Bergstraat 71,2020-01-20,14:00:00,64,38,26,FMN GV 11 Ramsel
66,Bergstraat 71,2020-01-20,15:00:00,70,48,22,FMN GV 11 Ramsel
66,Bergstraat 71,2020-01-20,16:00:00,88,76,12,FMN GV 11 Ramsel
66,Bergstraat 71,2020-01-20,17:00:00,56,46,10,FMN GV 11 Ramsel
66,Bergstraat 71,2020-01-20,18:00:00,38,28,10,FMN GV 11 Ramsel
66,Bergstraat 71,2020-01-20,19:00:00,20,14,6,FMN GV 11 Ramsel
66,Bergstraat 71,2020-01-20,20:00:00,6,2,4,FMN GV 11 Ramsel
66,Bergstraat 71,2020-01-20,21:00:00,2,0,2,FMN GV 11 Ramsel
66,Bergstraat 71,2020-01-20,22:00:00,6,4,2,FMN GV 11 Ramsel
66,Bergstraat 71,2020-01-20,23:00:00,0,0,0,FMN GV 11 Ramsel
66,Bergstraat 71,2020-01-21,00:00:00,4,2,2,FMN GV 11 Ramsel
66,Bergstraat 71,2020-01-21,01:00:00,0,0,0,FMN GV 11 Ramsel
66,Bergstraat 71,2020-01-21,02:00:00,2,2,0,FMN GV 11 Ramsel
66,Bergstraat 71,2020-01-21,03:00:00,2,0,2,FMN GV 11 Ramsel
66,Bergstraat 71,2020-01-21,04:00:00,4,2,2,FMN GV 11 Ramsel
66,Bergstraat 71,2020-01-21,05:00:00,10,6,4,FMN GV 11 Ramsel
66,Bergstraat 71,2020-01-21,06:00:00,34,10,24,FMN GV 11 Ramsel
66,Bergstraat 71,2020-01-21,07:00:00,108,12,96,FMN GV 11 Ramsel
66,Bergstraat 71,2020-01-21,08:00:00,108,10,98,FMN GV 11 Ramsel
66,Bergstraat 71,2020-01-21,09:00:00,14,2,12,FMN GV 11 Ramsel
66,Bergstraat 71,2020-01-21,10:00:00,18,8,10,FMN GV 11 Ramsel
66,Bergstraat 71,2020-01-21,11:00:00,26,16,10,FMN GV 11 Ramsel
66,Bergstraat 71,2020-01-21,12:00:00,30,12,18,FMN GV 11 Ramsel
66,Bergstraat 71,2020-01-21,13:00:00,58,28,30,FMN GV 11 Ramsel
66,Bergstraat 71,2020-01-21,14:00:00,48,36,12,FMN GV 11 Ramsel
66,Bergstraat 71,2020-01-21,15:00:00,110,92,18,FMN GV 11 Ramsel
66,Bergstraat 71,2020-01-21,16:00:00,116,100,16,FMN GV 11 Ramsel
66,Bergstraat 71,2020-01-21,17:00:00,72,42,30,FMN GV 11 Ramsel
66,Bergstraat 71,2020-01-21,18:00:00,36,22,14,FMN GV 11 Ramsel
66,Bergstraat 71,2020-01-21,19:00:00,14,0,14,FMN GV 11 Ramsel
66,Bergstraat 71,2020-01-21,20:00:00,12,12,0,FMN GV 11 Ramsel
66,Bergstraat 71,2020-01-21,21:00:00,10,10,0,FMN GV 11 Ramsel
66,Bergstraat 71,2020-01-21,22:00:00,6,4,2,FMN GV 11 Ramsel
66,Bergstraat 71,2020-01-21,23:00:00,2,2,0,FMN GV 11 Ramsel
66,Bergstraat 71,2020-01-22,00:00:00,0,0,0,FMN GV 11 Ramsel
66,Bergstraat 71,2020-01-22,01:00:00,0,0,0,FMN GV 11 Ramsel
66,Bergstraat 71,2020-01-22,02:00:00,0,0,0,FMN GV 11 Ramsel
66,Bergstraat 71,2020-01-22,03:00:00,0,0,0,FMN GV 11 Ramsel
66,Bergstraat 71,2020-01-22,04:00:00,2,2,0,FMN GV 11 Ramsel
66,Bergstraat 71,2020-01-22,05:00:00,10,6,4,FMN GV 11 Ramsel
66,Bergstraat 71,2020-01-22,06:00:00,28,4,24,FMN GV 11 Ramsel
66,Bergstraat 71,2020-01-22,07:00:00,90,8,82,FMN GV 11 Ramsel
66,Bergstraat 71,2020-01-22,08:00:00,104,8,96,FMN GV 11 Ramsel
66,Bergstraat 71,2020-01-22,09:00:00,24,8,16,FMN GV 11 Ramsel
66,Bergstraat 71,2020-01-22,10:00:00,18,6,12,FMN GV 11 Ramsel
66,Bergstraat 71,2020-01-22,11:00:00,22,6,16,FMN GV 11 Ramsel
66,Bergstraat 71,2020-01-22,12:00:00,144,118,26,FMN GV 11 Ramsel
66,Bergstraat 71,2020-01-22,13:00:00,78,34,44,FMN GV 11 Ramsel
66,Bergstraat 71,2020-01-22,14:00:00,44,16,28,FMN GV 11 Ramsel
66,Bergstraat 71,2020-01-22,15:00:00,72,38,34,FMN GV 11 Ramsel
66,Bergstraat 71,2020-01-22,16:00:00,36,22,14,FMN GV 11 Ramsel
66,Bergstraat 71,2020-01-22,17:00:00,54,40,14,FMN GV 11 Ramsel
66,Bergstraat 71,2020-01-22,18:00:00,30,24,6,FMN GV 11 Ramsel
66,Bergstraat 71,2020-01-22,19:00:00,18,16,2,FMN GV 11 Ramsel
66,Bergstraat 71,2020-01-22,20:00:00,2,2,0,FMN GV 11 Ramsel
66,Bergstraat 71,2020-01-22,21:00:00,6,4,2,FMN GV 11 Ramsel
66,Bergstraat 71,2020-01-22,22:00:00,8,4,4,FMN GV 11 Ramsel
66,Bergstraat 71,2020-01-22,23:00:00,2,2,0,FMN GV 11 Ramsel
66,Bergstraat 71,2020-01-23,00:00:00,0,0,0,FMN GV 11 Ramsel
66,Bergstraat 71,2020-01-23,01:00:00,0,0,0,FMN GV 11 Ramsel
66,Bergstraat 71,2020-01-23,02:00:00,0,0,0,FMN GV 11 Ramsel
66,Bergstraat 71,2020-01-23,03:00:00,0,0,0,FMN GV 11 Ramsel
66,Bergstraat 71,2020-01-23,04:00:00,6,4,2,FMN GV 11 Ramsel
66,Bergstraat 71,2020-01-23,05:00:00,14,8,6,FMN GV 11 Ramsel
66,Bergstraat 71,2020-01-23,06:00:00,26,4,22,FMN GV 11 Ramsel
66,Bergstraat 71,2020-01-23,07:00:00,96,14,82,FMN GV 11 Ramsel
66,Bergstraat 71,2020-01-23,08:00:00,88,2,86,FMN GV 11 Ramsel
66,Bergstraat 71,2020-01-23,09:00:00,24,2,22,FMN GV 11 Ramsel
66,Bergstraat 71,2020-01-23,10:00:00,38,14,24,FMN GV 11 Ramsel
66,Bergstraat 71,2020-01-23,11:00:00,32,20,12,FMN GV 11 Ramsel
66,Bergstraat 71,2020-01-23,12:00:00,30,16,14,FMN GV 11 Ramsel
66,Bergstraat 71,2020-01-23,13:00:00,50,30,20,FMN GV 11 Ramsel
66,Bergstraat 71,2020-01-23,14:00:00,74,26,48,FMN GV 11 Ramsel
66,Bergstraat 71,2020-01-23,15:00:00,140,114,26,FMN GV 11 Ramsel
66,Bergstraat 71,2020-01-23,16:00:00,112,100,12,FMN GV 11 Ramsel
66,Bergstraat 71,2020-01-23,17:00:00,56,34,22,FMN GV 11 Ramsel
66,Bergstraat 71,2020-01-23,18:00:00,26,22,4,FMN GV 11 Ramsel
66,Bergstraat 71,2020-01-23,19:00:00,8,2,6,FMN GV 11 Ramsel
66,Bergstraat 71,2020-01-23,20:00:00,14,8,6,FMN GV 11 Ramsel
66,Bergstraat 71,2020-01-23,21:00:00,6,6,0,FMN GV 11 Ramsel
66,Bergstraat 71,2020-01-23,22:00:00,4,4,0,FMN GV 11 Ramsel
66,Bergstraat 71,2020-01-23,23:00:00,0,0,0,FMN GV 11 Ramsel
66,Bergstraat 71,2020-01-24,00:00:00,2,0,2,FMN GV 11 Ramsel
66,Bergstraat 71,2020-01-24,01:00:00,0,0,0,FMN GV 11 Ramsel
66,Bergstraat 71,2020-01-24,02:00:00,0,0,0,FMN GV 11 Ramsel
66,Bergstraat 71,2020-01-24,03:00:00,0,0,0,FMN GV 11 Ramsel
66,Bergstraat 71,2020-01-24,04:00:00,2,2,0,FMN GV 11 Ramsel
66,Bergstraat 71,2020-01-24,05:00:00,12,8,4,FMN GV 11 Ramsel
66,Bergstraat 71,2020-01-24,06:00:00,14,0,14,FMN GV 11 Ramsel
66,Bergstraat 71,2020-01-24,07:00:00,100,6,94,FMN GV 11 Ramsel
66,Bergstraat 71,2020-01-24,08:00:00,120,20,100,FMN GV 11 Ramsel
66,Bergstraat 71,2020-01-24,09:00:00,14,2,12,FMN GV 11 Ramsel
66,Bergstraat 71,2020-01-24,10:00:00,32,22,10,FMN GV 11 Ramsel
66,Bergstraat 71,2020-01-24,11:00:00,24,8,16,FMN GV 11 Ramsel
66,Bergstraat 71,2020-01-24,12:00:00,44,12,32,FMN GV 11 Ramsel
66,Bergstraat 71,2020-01-24,13:00:00,32,24,8,FMN GV 11 Ramsel
66,Bergstraat 71,2020-01-24,14:00:00,38,24,14,FMN GV 11 Ramsel
66,Bergstraat 71,2020-01-24,15:00:00,100,70,30,FMN GV 11 Ramsel
66,Bergstraat 71,2020-01-24,16:00:00,78,62,16,FMN GV 11 Ramsel
66,Bergstraat 71,2020-01-24,17:00:00,40,36,4,FMN GV 11 Ramsel
66,Bergstraat 71,2020-01-24,18:00:00,22,10,12,FMN GV 11 Ramsel
66,Bergstraat 71,2020-01-24,19:00:00,20,18,2,FMN GV 11 Ramsel
66,Bergstraat 71,2020-01-24,20:00:00,14,8,6,FMN GV 11 Ramsel
66,Bergstraat 71,2020-01-24,21:00:00,8,8,0,FMN GV 11 Ramsel
66,Bergstraat 71,2020-01-24,22:00:00,8,6,2,FMN GV 11 Ramsel
66,Bergstraat 71,2020-01-24,23:00:00,4,2,2,FMN GV 11 Ramsel
66,Bergstraat 71,2020-01-25,00:00:00,4,0,4,FMN GV 11 Ramsel
66,Bergstraat 71,2020-01-25,01:00:00,8,4,4,FMN GV 11 Ramsel
66,Bergstraat 71,2020-01-25,02:00:00,2,2,0,FMN GV 11 Ramsel
66,Bergstraat 71,2020-01-25,03:00:00,2,2,0,FMN GV 11 Ramsel
66,Bergstraat 71,2020-01-25,04:00:00,0,0,0,FMN GV 11 Ramsel
66,Bergstraat 71,2020-01-25,05:00:00,0,0,0,FMN GV 11 Ramsel
66,Bergstraat 71,2020-01-25,06:00:00,4,2,2,FMN GV 11 Ramsel
66,Bergstraat 71,2020-01-25,07:00:00,6,2,4,FMN GV 11 Ramsel
66,Bergstraat 71,2020-01-25,08:00:00,20,10,10,FMN GV 11 Ramsel
66,Bergstraat 71,2020-01-25,09:00:00,20,6,14,FMN GV 11 Ramsel
66,Bergstraat 71,2020-01-25,10:00:00,48,26,22,FMN GV 11 Ramsel
66,Bergstraat 71,2020-01-25,11:00:00,68,42,26,FMN GV 11 Ramsel
66,Bergstraat 71,2020-01-25,12:00:00,72,16,56,FMN GV 11 Ramsel
66,Bergstraat 71,2020-01-25,13:00:00,54,30,24,FMN GV 11 Ramsel
66,Bergstraat 71,2020-01-25,14:00:00,84,40,44,FMN GV 11 Ramsel
66,Bergstraat 71,2020-01-25,15:00:00,50,34,16,FMN GV 11 Ramsel
66,Bergstraat 71,2020-01-25,16:00:00,40,20,20,FMN GV 11 Ramsel
66,Bergstraat 71,2020-01-25,17:00:00,26,10,16,FMN GV 11 Ramsel
66,Bergstraat 71,2020-01-25,18:00:00,12,8,4,FMN GV 11 Ramsel
66,Bergstraat 71,2020-01-25,19:00:00,10,6,4,FMN GV 11 Ramsel
66,Bergstraat 71,2020-01-25,20:00:00,6,2,4,FMN GV 11 Ramsel
66,Bergstraat 71,2020-01-25,21:00:00,4,2,2,FMN GV 11 Ramsel
66,Bergstraat 71,2020-01-25,22:00:00,4,0,4,FMN GV 11 Ramsel
66,Bergstraat 71,2020-01-25,23:00:00,0,0,0,FMN GV 11 Ramsel
66,Bergstraat 71,2020-01-26,00:00:00,4,2,2,FMN GV 11 Ramsel
66,Bergstraat 71,2020-01-26,01:00:00,2,2,0,FMN GV 11 Ramsel
66,Bergstraat 71,2020-01-26,02:00:00,8,4,4,FMN GV 11 Ramsel
66,Bergstraat 71,2020-01-26,03:00:00,2,0,2,FMN GV 11 Ramsel
66,Bergstraat 71,2020-01-26,04:00:00,0,0,0,FMN GV 11 Ramsel
66,Bergstraat 71,2020-01-26,05:00:00,2,2,0,FMN GV 11 Ramsel
66,Bergstraat 71,2020-01-26,06:00:00,6,2,4,FMN GV 11 Ramsel
66,Bergstraat 71,2020-01-26,07:00:00,2,0,2,FMN GV 11 Ramsel
66,Bergstraat 71,2020-01-26,08:00:00,40,10,30,FMN GV 11 Ramsel
66,Bergstraat 71,2020-01-26,09:00:00,68,20,48,FMN GV 11 Ramsel
66,Bergstraat 71,2020-01-26,10:00:00,92,28,64,FMN GV 11 Ramsel
66,Bergstraat 71,2020-01-26,11:00:00,124,62,62,FMN GV 11 Ramsel
66,Bergstraat 71,2020-01-26,12:00:00,52,26,26,FMN GV 11 Ramsel
66,Bergstraat 71,2020-01-26,13:00:00,102,42,60,FMN GV 11 Ramsel
66,Bergstraat 71,2020-01-26,14:00:00,112,52,60,FMN GV 11 Ramsel
66,Bergstraat 71,2020-01-26,15:00:00,70,52,18,FMN GV 11 Ramsel
66,Bergstraat 71,2020-01-26,16:00:00,78,66,12,FMN GV 11 Ramsel
66,Bergstraat 71,2020-01-26,17:00:00,28,10,18,FMN GV 11 Ramsel
66,Bergstraat 71,2020-01-26,18:00:00,14,8,6,FMN GV 11 Ramsel
66,Bergstraat 71,2020-01-26,19:00:00,4,2,2,FMN GV 11 Ramsel
66,Bergstraat 71,2020-01-26,20:00:00,4,0,4,FMN GV 11 Ramsel
66,Bergstraat 71,2020-01-26,21:00:00,6,2,4,FMN GV 11 Ramsel
66,Bergstraat 71,2020-01-26,22:00:00,2,2,0,FMN GV 11 Ramsel
66,Bergstraat 71,2020-01-26,23:00:00,2,2,0,FMN GV 11 Ramsel
66,Bergstraat 71,2020-01-27,00:00:00,0,0,0,FMN GV 11 Ramsel
66,Bergstraat 71,2020-01-27,01:00:00,2,2,0,FMN GV 11 Ramsel
66,Bergstraat 71,2020-01-27,02:00:00,0,0,0,FMN GV 11 Ramsel
66,Bergstraat 71,2020-01-27,03:00:00,0,0,0,FMN GV 11 Ramsel
66,Bergstraat 71,2020-01-27,04:00:00,4,2,2,FMN GV 11 Ramsel
66,Bergstraat 71,2020-01-27,05:00:00,10,10,0,FMN GV 11 Ramsel
66,Bergstraat 71,2020-01-27,06:00:00,36,6,30,FMN GV 11 Ramsel
66,Bergstraat 71,2020-01-27,07:00:00,80,12,68,FMN GV 11 Ramsel
66,Bergstraat 71,2020-01-27,08:00:00,96,6,90,FMN GV 11 Ramsel
66,Bergstraat 71,2020-01-27,09:00:00,18,4,14,FMN GV 11 Ramsel
66,Bergstraat 71,2020-01-27,10:00:00,20,8,12,FMN GV 11 Ramsel
66,Bergstraat 71,2020-01-27,11:00:00,20,8,12,FMN GV 11 Ramsel
66,Bergstraat 71,2020-01-27,12:00:00,30,18,12,FMN GV 11 Ramsel
66,Bergstraat 71,2020-01-27,13:00:00,50,20,30,FMN GV 11 Ramsel
66,Bergstraat 71,2020-01-27,14:00:00,44,26,18,FMN GV 11 Ramsel
66,Bergstraat 71,2020-01-27,15:00:00,92,80,12,FMN GV 11 Ramsel
66,Bergstraat 71,2020-01-27,16:00:00,110,84,26,FMN GV 11 Ramsel
66,Bergstraat 71,2020-01-27,17:00:00,50,32,18,FMN GV 11 Ramsel
66,Bergstraat 71,2020-01-27,18:00:00,20,14,6,FMN GV 11 Ramsel
66,Bergstraat 71,2020-01-27,19:00:00,12,10,2,FMN GV 11 Ramsel
66,Bergstraat 71,2020-01-27,20:00:00,6,6,0,FMN GV 11 Ramsel
66,Bergstraat 71,2020-01-27,21:00:00,4,4,0,FMN GV 11 Ramsel
66,Bergstraat 71,2020-01-27,22:00:00,8,4,4,FMN GV 11 Ramsel
66,Bergstraat 71,2020-01-27,23:00:00,4,2,2,FMN GV 11 Ramsel
66,Bergstraat 71,2020-01-28,00:00:00,0,0,0,FMN GV 11 Ramsel
66,Bergstraat 71,2020-01-28,01:00:00,0,0,0,FMN GV 11 Ramsel
66,Bergstraat 71,2020-01-28,02:00:00,0,0,0,FMN GV 11 Ramsel
66,Bergstraat 71,2020-01-28,03:00:00,0,0,0,FMN GV 11 Ramsel
66,Bergstraat 71,2020-01-28,04:00:00,2,2,0,FMN GV 11 Ramsel
66,Bergstraat 71,2020-01-28,05:00:00,16,12,4,FMN GV 11 Ramsel
66,Bergstraat 71,2020-01-28,06:00:00,12,4,8,FMN GV 11 Ramsel
66,Bergstraat 71,2020-01-28,07:00:00,68,8,60,FMN GV 11 Ramsel
66,Bergstraat 71,2020-01-28,08:00:00,74,4,70,FMN GV 11 Ramsel
66,Bergstraat 71,2020-01-28,09:00:00,18,6,12,FMN GV 11 Ramsel
66,Bergstraat 71,2020-01-28,10:00:00,10,6,4,FMN GV 11 Ramsel
66,Bergstraat 71,2020-01-28,11:00:00,20,8,12,FMN GV 11 Ramsel
66,Bergstraat 71,2020-01-28,12:00:00,14,8,6,FMN GV 11 Ramsel
66,Bergstraat 71,2020-01-28,13:00:00,54,26,28,FMN GV 11 Ramsel
66,Bergstraat 71,2020-01-28,14:00:00,40,20,20,FMN GV 11 Ramsel
66,Bergstraat 71,2020-01-28,15:00:00,96,72,24,FMN GV 11 Ramsel
66,Bergstraat 71,2020-01-28,16:00:00,50,38,12,FMN GV 11 Ramsel
66,Bergstraat 71,2020-01-28,17:00:00,68,30,38,FMN GV 11 Ramsel
66,Bergstraat 71,2020-01-28,18:00:00,44,28,16,FMN GV 11 Ramsel
66,Bergstraat 71,2020-01-28,19:00:00,28,10,18,FMN GV 11 Ramsel
66,Bergstraat 71,2020-01-28,20:00:00,20,18,2,FMN GV 11 Ramsel
66,Bergstraat 71,2020-01-28,21:00:00,2,2,0,FMN GV 11 Ramsel
66,Bergstraat 71,2020-01-28,22:00:00,2,0,2,FMN GV 11 Ramsel
66,Bergstraat 71,2020-01-28,23:00:00,2,2,0,FMN GV 11 Ramsel
66,Bergstraat 71,2020-01-29,00:00:00,0,0,0,FMN GV 11 Ramsel
66,Bergstraat 71,2020-01-29,01:00:00,0,0,0,FMN GV 11 Ramsel
66,Bergstraat 71,2020-01-29,02:00:00,0,0,0,FMN GV 11 Ramsel
66,Bergstraat 71,2020-01-29,03:00:00,0,0,0,FMN GV 11 Ramsel
66,Bergstraat 71,2020-01-29,04:00:00,2,2,0,FMN GV 11 Ramsel
66,Bergstraat 71,2020-01-29,05:00:00,12,6,6,FMN GV 11 Ramsel
66,Bergstraat 71,2020-01-29,06:00:00,36,4,32,FMN GV 11 Ramsel
66,Bergstraat 71,2020-01-29,07:00:00,102,20,82,FMN GV 11 Ramsel
66,Bergstraat 71,2020-01-29,08:00:00,124,20,104,FMN GV 11 Ramsel
66,Bergstraat 71,2020-01-29,09:00:00,30,4,26,FMN GV 11 Ramsel
66,Bergstraat 71,2020-01-29,10:00:00,36,20,16,FMN GV 11 Ramsel
66,Bergstraat 71,2020-01-29,11:00:00,52,30,22,FMN GV 11 Ramsel
66,Bergstraat 71,2020-01-29,12:00:00,200,152,48,FMN GV 11 Ramsel
66,Bergstraat 71,2020-01-29,13:00:00,88,64,24,FMN GV 11 Ramsel
66,Bergstraat 71,2020-01-29,14:00:00,106,54,52,FMN GV 11 Ramsel
66,Bergstraat 71,2020-01-29,15:00:00,78,42,36,FMN GV 11 Ramsel
66,Bergstraat 71,2020-01-29,16:00:00,92,80,12,FMN GV 11 Ramsel
66,Bergstraat 71,2020-01-29,17:00:00,80,64,16,FMN GV 11 Ramsel
66,Bergstraat 71,2020-01-29,18:00:00,30,16,14,FMN GV 11 Ramsel
66,Bergstraat 71,2020-01-29,19:00:00,24,14,10,FMN GV 11 Ramsel
66,Bergstraat 71,2020-01-29,20:00:00,10,8,2,FMN GV 11 Ramsel
66,Bergstraat 71,2020-01-29,21:00:00,4,2,2,FMN GV 11 Ramsel
66,Bergstraat 71,2020-01-29,22:00:00,8,2,6,FMN GV 11 Ramsel
66,Bergstraat 71,2020-01-29,23:00:00,4,4,0,FMN GV 11 Ramsel
66,Bergstraat 71,2020-01-30,00:00:00,2,0,2,FMN GV 11 Ramsel
66,Bergstraat 71,2020-01-30,01:00:00,0,0,0,FMN GV 11 Ramsel
66,Bergstraat 71,2020-01-30,02:00:00,2,0,2,FMN GV 11 Ramsel
66,Bergstraat 71,2020-01-30,03:00:00,0,0,0,FMN GV 11 Ramsel
66,Bergstraat 71,2020-01-30,04:00:00,2,2,0,FMN GV 11 Ramsel
66,Bergstraat 71,2020-01-30,05:00:00,10,6,4,FMN GV 11 Ramsel
66,Bergstraat 71,2020-01-30,06:00:00,30,10,20,FMN GV 11 Ramsel
66,Bergstraat 71,2020-01-30,07:00:00,126,12,114,FMN GV 11 Ramsel
66,Bergstraat 71,2020-01-30,08:00:00,100,6,94,FMN GV 11 Ramsel
66,Bergstraat 71,2020-01-30,09:00:00,32,6,26,FMN GV 11 Ramsel
66,Bergstraat 71,2020-01-30,10:00:00,50,12,38,FMN GV 11 Ramsel
66,Bergstraat 71,2020-01-30,11:00:00,54,24,30,FMN GV 11 Ramsel
66,Bergstraat 71,2020-01-30,12:00:00,40,22,18,FMN GV 11 Ramsel
66,Bergstraat 71,2020-01-30,13:00:00,80,26,54,FMN GV 11 Ramsel
66,Bergstraat 71,2020-01-30,14:00:00,68,38,30,FMN GV 11 Ramsel
66,Bergstraat 71,2020-01-30,15:00:00,152,126,26,FMN GV 11 Ramsel
66,Bergstraat 71,2020-01-30,16:00:00,84,72,12,FMN GV 11 Ramsel
66,Bergstraat 71,2020-01-30,17:00:00,44,30,14,FMN GV 11 Ramsel
66,Bergstraat 71,2020-01-30,18:00:00,40,24,16,FMN GV 11 Ramsel
66,Bergstraat 71,2020-01-30,19:00:00,16,8,8,FMN GV 11 Ramsel
66,Bergstraat 71,2020-01-30,20:00:00,12,10,2,FMN GV 11 Ramsel
66,Bergstraat 71,2020-01-30,21:00:00,0,0,0,FMN GV 11 Ramsel
66,Bergstraat 71,2020-01-30,22:00:00,6,4,2,FMN GV 11 Ramsel
66,Bergstraat 71,2020-01-30,23:00:00,4,4,0,FMN GV 11 Ramsel
66,Bergstraat 71,2020-01-31,00:00:00,6,2,4,FMN GV 11 Ramsel
66,Bergstraat 71,2020-01-31,01:00:00,0,0,0,FMN GV 11 Ramsel
66,Bergstraat 71,2020-01-31,02:00:00,2,2,0,FMN GV 11 Ramsel
66,Bergstraat 71,2020-01-31,03:00:00,4,4,0,FMN GV 11 Ramsel
66,Bergstraat 71,2020-01-31,04:00:00,4,4,0,FMN GV 11 Ramsel
66,Bergstraat 71,2020-01-31,05:00:00,8,6,2,FMN GV 11 Ramsel
66,Bergstraat 71,2020-01-31,06:00:00,22,4,18,FMN GV 11 Ramsel
66,Bergstraat 71,2020-01-31,07:00:00,98,12,86,FMN GV 11 Ramsel
66,Bergstraat 71,2020-01-31,08:00:00,86,16,70,FMN GV 11 Ramsel
66,Bergstraat 71,2020-01-31,09:00:00,46,12,34,FMN GV 11 Ramsel
66,Bergstraat 71,2020-01-31,10:00:00,46,24,22,FMN GV 11 Ramsel
66,Bergstraat 71,2020-01-31,11:00:00,32,20,12,FMN GV 11 Ramsel
66,Bergstraat 71,2020-01-31,12:00:00,42,14,28,FMN GV 11 Ramsel
66,Bergstraat 71,2020-01-31,13:00:00,72,30,42,FMN GV 11 Ramsel
66,Bergstraat 71,2020-01-31,14:00:00,96,56,40,FMN GV 11 Ramsel
66,Bergstraat 71,2020-01-31,15:00:00,170,130,40,FMN GV 11 Ramsel
66,Bergstraat 71,2020-01-31,16:00:00,78,66,12,FMN GV 11 Ramsel
66,Bergstraat 71,2020-01-31,17:00:00,50,34,16,FMN GV 11 Ramsel
66,Bergstraat 71,2020-01-31,18:00:00,30,12,18,FMN GV 11 Ramsel
66,Bergstraat 71,2020-01-31,19:00:00,24,18,6,FMN GV 11 Ramsel
66,Bergstraat 71,2020-01-31,20:00:00,18,10,8,FMN GV 11 Ramsel
66,Bergstraat 71,2020-01-31,21:00:00,10,6,4,FMN GV 11 Ramsel
66,Bergstraat 71,2020-01-31,22:00:00,10,6,4,FMN GV 11 Ramsel
66,Bergstraat 71,2020-01-31,23:00:00,4,2,2,FMN GV 11 Ramsel
66,Bergstraat 71,2020-02-01,00:00:00,4,4,0,FMN GV 11 Ramsel
66,Bergstraat 71,2020-02-01,01:00:00,2,2,0,FMN GV 11 Ramsel
66,Bergstraat 71,2020-02-01,02:00:00,2,2,0,FMN GV 11 Ramsel
66,Bergstraat 71,2020-02-01,03:00:00,0,0,0,FMN GV 11 Ramsel
66,Bergstraat 71,2020-02-01,04:00:00,6,2,4,FMN GV 11 Ramsel
66,Bergstraat 71,2020-02-01,05:00:00,6,4,2,FMN GV 11 Ramsel
66,Bergstraat 71,2020-02-01,06:00:00,0,0,0,FMN GV 11 Ramsel
66,Bergstraat 71,2020-02-01,07:00:00,4,4,0,FMN GV 11 Ramsel
66,Bergstraat 71,2020-02-01,08:00:00,8,2,6,FMN GV 11 Ramsel
66,Bergstraat 71,2020-02-01,09:00:00,14,0,14,FMN GV 11 Ramsel
66,Bergstraat 71,2020-02-01,10:00:00,22,14,8,FMN GV 11 Ramsel
66,Bergstraat 71,2020-02-01,11:00:00,24,6,18,FMN GV 11 Ramsel
66,Bergstraat 71,2020-02-01,12:00:00,34,18,16,FMN GV 11 Ramsel
66,Bergstraat 71,2020-02-01,13:00:00,46,24,22,FMN GV 11 Ramsel
66,Bergstraat 71,2020-02-01,14:00:00,72,48,24,FMN GV 11 Ramsel
66,Bergstraat 71,2020-02-01,15:00:00,54,32,22,FMN GV 11 Ramsel
66,Bergstraat 71,2020-02-01,16:00:00,74,46,28,FMN GV 11 Ramsel
66,Bergstraat 71,2020-02-01,17:00:00,26,12,14,FMN GV 11 Ramsel
66,Bergstraat 71,2020-02-01,18:00:00,14,8,6,FMN GV 11 Ramsel
66,Bergstraat 71,2020-02-01,19:00:00,10,6,4,FMN GV 11 Ramsel
66,Bergstraat 71,2020-02-01,20:00:00,8,4,4,FMN GV 11 Ramsel
66,Bergstraat 71,2020-02-01,21:00:00,12,6,6,FMN GV 11 Ramsel
66,Bergstraat 71,2020-02-01,22:00:00,14,6,8,FMN GV 11 Ramsel
66,Bergstraat 71,2020-02-01,23:00:00,2,2,0,FMN GV 11 Ramsel
66,Bergstraat 71,2020-02-02,00:00:00,4,2,2,FMN GV 11 Ramsel
66,Bergstraat 71,2020-02-02,01:00:00,0,0,0,FMN GV 11 Ramsel
66,Bergstraat 71,2020-02-02,02:00:00,0,0,0,FMN GV 11 Ramsel
66,Bergstraat 71,2020-02-02,03:00:00,6,6,0,FMN GV 11 Ramsel
66,Bergstraat 71,2020-02-02,04:00:00,0,0,0,FMN GV 11 Ramsel
66,Bergstraat 71,2020-02-02,05:00:00,4,4,0,FMN GV 11 Ramsel
66,Bergstraat 71,2020-02-02,06:00:00,2,2,0,FMN GV 11 Ramsel
66,Bergstraat 71,2020-02-02,07:00:00,4,0,4,FMN GV 11 Ramsel
66,Bergstraat 71,2020-02-02,08:00:00,14,4,10,FMN GV 11 Ramsel
66,Bergstraat 71,2020-02-02,09:00:00,8,4,4,FMN GV 11 Ramsel
66,Bergstraat 71,2020-02-02,10:00:00,18,12,6,FMN GV 11 Ramsel
66,Bergstraat 71,2020-02-02,11:00:00,10,8,2,FMN GV 11 Ramsel
66,Bergstraat 71,2020-02-02,12:00:00,12,10,2,FMN GV 11 Ramsel
66,Bergstraat 71,2020-02-02,13:00:00,28,14,14,FMN GV 11 Ramsel
66,Bergstraat 71,2020-02-02,14:00:00,32,18,14,FMN GV 11 Ramsel
66,Bergstraat 71,2020-02-02,15:00:00,30,18,12,FMN GV 11 Ramsel
66,Bergstraat 71,2020-02-02,16:00:00,14,8,6,FMN GV 11 Ramsel
66,Bergstraat 71,2020-02-02,17:00:00,20,12,8,FMN GV 11 Ramsel
66,Bergstraat 71,2020-02-02,18:00:00,8,2,6,FMN GV 11 Ramsel
66,Bergstraat 71,2020-02-02,19:00:00,6,0,6,FMN GV 11 Ramsel
66,Bergstraat 71,2020-02-02,20:00:00,2,2,0,FMN GV 11 Ramsel
66,Bergstraat 71,2020-02-02,21:00:00,4,0,4,FMN GV 11 Ramsel
66,Bergstraat 71,2020-02-02,22:00:00,2,0,2,FMN GV 11 Ramsel
66,Bergstraat 71,2020-02-02,23:00:00,0,0,0,FMN GV 11 Ramsel
66,Bergstraat 71,2020-02-03,00:00:00,2,2,0,FMN GV 11 Ramsel
66,Bergstraat 71,2020-02-03,01:00:00,0,0,0,FMN GV 11 Ramsel
66,Bergstraat 71,2020-02-03,02:00:00,0,0,0,FMN GV 11 Ramsel
66,Bergstraat 71,2020-02-03,03:00:00,0,0,0,FMN GV 11 Ramsel
66,Bergstraat 71,2020-02-03,04:00:00,2,2,0,FMN GV 11 Ramsel
66,Bergstraat 71,2020-02-03,05:00:00,10,10,0,FMN GV 11 Ramsel
66,Bergstraat 71,2020-02-03,06:00:00,26,6,20,FMN GV 11 Ramsel
66,Bergstraat 71,2020-02-03,07:00:00,98,12,86,FMN GV 11 Ramsel
66,Bergstraat 71,2020-02-03,08:00:00,98,6,92,FMN GV 11 Ramsel
66,Bergstraat 71,2020-02-03,09:00:00,34,12,22,FMN GV 11 Ramsel
66,Bergstraat 71,2020-02-03,10:00:00,64,30,34,FMN GV 11 Ramsel
66,Bergstraat 71,2020-02-03,11:00:00,54,26,28,FMN GV 11 Ramsel
66,Bergstraat 71,2020-02-03,12:00:00,56,28,28,FMN GV 11 Ramsel
66,Bergstraat 71,2020-02-03,13:00:00,86,40,46,FMN GV 11 Ramsel
66,Bergstraat 71,2020-02-03,14:00:00,90,52,38,FMN GV 11 Ramsel
66,Bergstraat 71,2020-02-03,15:00:00,124,98,26,FMN GV 11 Ramsel
66,Bergstraat 71,2020-02-03,16:00:00,72,60,12,FMN GV 11 Ramsel
66,Bergstraat 71,2020-02-03,17:00:00,52,34,18,FMN GV 11 Ramsel
66,Bergstraat 71,2020-02-03,18:00:00,34,20,14,FMN GV 11 Ramsel
66,Bergstraat 71,2020-02-03,19:00:00,22,12,10,FMN GV 11 Ramsel
66,Bergstraat 71,2020-02-03,20:00:00,6,4,2,FMN GV 11 Ramsel
66,Bergstraat 71,2020-02-03,21:00:00,10,8,2,FMN GV 11 Ramsel
66,Bergstraat 71,2020-02-03,22:00:00,4,2,2,FMN GV 11 Ramsel
66,Bergstraat 71,2020-02-03,23:00:00,0,0,0,FMN GV 11 Ramsel
66,Bergstraat 71,2020-02-04,00:00:00,2,0,2,FMN GV 11 Ramsel
66,Bergstraat 71,2020-02-04,01:00:00,0,0,0,FMN GV 11 Ramsel
66,Bergstraat 71,2020-02-04,02:00:00,0,0,0,FMN GV 11 Ramsel
66,Bergstraat 71,2020-02-04,03:00:00,0,0,0,FMN GV 11 Ramsel
66,Bergstraat 71,2020-02-04,04:00:00,2,2,0,FMN GV 11 Ramsel
66,Bergstraat 71,2020-02-04,05:00:00,14,12,2,FMN GV 11 Ramsel
66,Bergstraat 71,2020-02-04,06:00:00,28,2,26,FMN GV 11 Ramsel
66,Bergstraat 71,2020-02-04,07:00:00,102,18,84,FMN GV 11 Ramsel
66,Bergstraat 71,2020-02-04,08:00:00,88,10,78,FMN GV 11 Ramsel
66,Bergstraat 71,2020-02-04,09:00:00,16,6,10,FMN GV 11 Ramsel
66,Bergstraat 71,2020-02-04,10:00:00,12,6,6,FMN GV 11 Ramsel
66,Bergstraat 71,2020-02-04,11:00:00,12,4,8,FMN GV 11 Ramsel
66,Bergstraat 71,2020-02-04,12:00:00,18,12,6,FMN GV 11 Ramsel
66,Bergstraat 71,2020-02-04,13:00:00,12,6,6,FMN GV 11 Ramsel
66,Bergstraat 71,2020-02-04,14:00:00,22,10,12,FMN GV 11 Ramsel
66,Bergstraat 71,2020-02-04,15:00:00,100,90,10,FMN GV 11 Ramsel
66,Bergstraat 71,2020-02-04,16:00:00,84,70,14,FMN GV 11 Ramsel
66,Bergstraat 71,2020-02-04,17:00:00,56,40,16,FMN GV 11 Ramsel
66,Bergstraat 71,2020-02-04,18:00:00,22,12,10,FMN GV 11 Ramsel
66,Bergstraat 71,2020-02-04,19:00:00,16,6,10,FMN GV 11 Ramsel
66,Bergstraat 71,2020-02-04,20:00:00,14,10,4,FMN GV 11 Ramsel
66,Bergstraat 71,2020-02-04,21:00:00,2,0,2,FMN GV 11 Ramsel
66,Bergstraat 71,2020-02-04,22:00:00,8,8,0,FMN GV 11 Ramsel
66,Bergstraat 71,2020-02-04,23:00:00,4,4,0,FMN GV 11 Ramsel
66,Bergstraat 71,2020-02-05,00:00:00,0,0,0,FMN GV 11 Ramsel
66,Bergstraat 71,2020-02-05,01:00:00,0,0,0,FMN GV 11 Ramsel
66,Bergstraat 71,2020-02-05,02:00:00,0,0,0,FMN GV 11 Ramsel
66,Bergstraat 71,2020-02-05,03:00:00,0,0,0,FMN GV 11 Ramsel
66,Bergstraat 71,2020-02-05,04:00:00,2,2,0,FMN GV 11 Ramsel
66,Bergstraat 71,2020-02-05,05:00:00,14,12,2,FMN GV 11 Ramsel
66,Bergstraat 71,2020-02-05,06:00:00,26,8,18,FMN GV 11 Ramsel
66,Bergstraat 71,2020-02-05,07:00:00,112,16,96,FMN GV 11 Ramsel
66,Bergstraat 71,2020-02-05,08:00:00,144,28,116,FMN GV 11 Ramsel
66,Bergstraat 71,2020-02-05,09:00:00,30,12,18,FMN GV 11 Ramsel
66,Bergstraat 71,2020-02-05,10:00:00,30,20,10,FMN GV 11 Ramsel
66,Bergstraat 71,2020-02-05,11:00:00,40,22,18,FMN GV 11 Ramsel
66,Bergstraat 71,2020-02-05,12:00:00,194,146,48,FMN GV 11 Ramsel
66,Bergstraat 71,2020-02-05,13:00:00,138,82,56,FMN GV 11 Ramsel
66,Bergstraat 71,2020-02-05,14:00:00,134,54,80,FMN GV 11 Ramsel
66,Bergstraat 71,2020-02-05,15:00:00,96,64,32,FMN GV 11 Ramsel
66,Bergstraat 71,2020-02-05,16:00:00,94,64,30,FMN GV 11 Ramsel
66,Bergstraat 71,2020-02-05,17:00:00,70,44,26,FMN GV 11 Ramsel
66,Bergstraat 71,2020-02-05,18:00:00,42,16,26,FMN GV 11 Ramsel
66,Bergstraat 71,2020-02-05,19:00:00,28,24,4,FMN GV 11 Ramsel
66,Bergstraat 71,2020-02-05,20:00:00,10,8,2,FMN GV 11 Ramsel
66,Bergstraat 71,2020-02-05,21:00:00,6,4,2,FMN GV 11 Ramsel
66,Bergstraat 71,2020-02-05,22:00:00,8,4,4,FMN GV 11 Ramsel
66,Bergstraat 71,2020-02-05,23:00:00,6,4,2,FMN GV 11 Ramsel
66,Bergstraat 71,2020-02-06,00:00:00,0,0,0,FMN GV 11 Ramsel
66,Bergstraat 71,2020-02-06,01:00:00,0,0,0,FMN GV 11 Ramsel
66,Bergstraat 71,2020-02-06,02:00:00,0,0,0,FMN GV 11 Ramsel
66,Bergstraat 71,2020-02-06,03:00:00,0,0,0,FMN GV 11 Ramsel
66,Bergstraat 71,2020-02-06,04:00:00,2,2,0,FMN GV 11 Ramsel
66,Bergstraat 71,2020-02-06,05:00:00,16,12,4,FMN GV 11 Ramsel
66,Bergstraat 71,2020-02-06,06:00:00,28,10,18,FMN GV 11 Ramsel
66,Bergstraat 71,2020-02-06,07:00:00,118,14,104,FMN GV 11 Ramsel
66,Bergstraat 71,2020-02-06,08:00:00,110,6,104,FMN GV 11 Ramsel
66,Bergstraat 71,2020-02-06,09:00:00,34,8,26,FMN GV 11 Ramsel
66,Bergstraat 71,2020-02-06,10:00:00,54,22,32,FMN GV 11 Ramsel
66,Bergstraat 71,2020-02-06,11:00:00,62,30,32,FMN GV 11 Ramsel
66,Bergstraat 71,2020-02-06,12:00:00,62,28,34,FMN GV 11 Ramsel
66,Bergstraat 71,2020-02-06,13:00:00,124,54,70,FMN GV 11 Ramsel
66,Bergstraat 71,2020-02-06,14:00:00,132,70,62,FMN GV 11 Ramsel
66,Bergstraat 71,2020-02-06,15:00:00,146,120,26,FMN GV 11 Ramsel
66,Bergstraat 71,2020-02-06,16:00:00,172,128,44,FMN GV 11 Ramsel
66,Bergstraat 71,2020-02-06,17:00:00,96,68,28,FMN GV 11 Ramsel
66,Bergstraat 71,2020-02-06,18:00:00,34,24,10,FMN GV 11 Ramsel
66,Bergstraat 71,2020-02-06,19:00:00,24,14,10,FMN GV 11 Ramsel
66,Bergstraat 71,2020-02-06,20:00:00,24,18,6,FMN GV 11 Ramsel
66,Bergstraat 71,2020-02-06,21:00:00,6,4,2,FMN GV 11 Ramsel
66,Bergstraat 71,2020-02-06,22:00:00,8,6,2,FMN GV 11 Ramsel
66,Bergstraat 71,2020-02-06,23:00:00,0,0,0,FMN GV 11 Ramsel
66,Bergstraat 71,2020-02-07,00:00:00,2,2,0,FMN GV 11 Ramsel
66,Bergstraat 71,2020-02-07,01:00:00,0,0,0,FMN GV 11 Ramsel
66,Bergstraat 71,2020-02-07,02:00:00,0,0,0,FMN GV 11 Ramsel
66,Bergstraat 71,2020-02-07,03:00:00,0,0,0,FMN GV 11 Ramsel
66,Bergstraat 71,2020-02-07,04:00:00,6,2,4,FMN GV 11 Ramsel
66,Bergstraat 71,2020-02-07,05:00:00,10,10,0,FMN GV 11 Ramsel
66,Bergstraat 71,2020-02-07,06:00:00,28,10,18,FMN GV 11 Ramsel
66,Bergstraat 71,2020-02-07,07:00:00,126,16,110,FMN GV 11 Ramsel
66,Bergstraat 71,2020-02-07,08:00:00,110,10,100,FMN GV 11 Ramsel
66,Bergstraat 71,2020-02-07,09:00:00,24,12,12,FMN GV 11 Ramsel
66,Bergstraat 71,2020-02-07,10:00:00,42,18,24,FMN GV 11 Ramsel
66,Bergstraat 71,2020-02-07,11:00:00,40,28,12,FMN GV 11 Ramsel
66,Bergstraat 71,2020-02-07,12:00:00,96,44,52,FMN GV 11 Ramsel
66,Bergstraat 71,2020-02-07,13:00:00,162,54,108,FMN GV 11 Ramsel
66,Bergstraat 71,2020-02-07,14:00:00,206,104,102,FMN GV 11 Ramsel
66,Bergstraat 71,2020-02-07,15:00:00,244,150,94,FMN GV 11 Ramsel
66,Bergstraat 71,2020-02-07,16:00:00,144,110,34,FMN GV 11 Ramsel
66,Bergstraat 71,2020-02-07,17:00:00,74,58,16,FMN GV 11 Ramsel
66,Bergstraat 71,2020-02-07,18:00:00,56,36,20,FMN GV 11 Ramsel
66,Bergstraat 71,2020-02-07,19:00:00,40,24,16,FMN GV 11 Ramsel
66,Bergstraat 71,2020-02-07,20:00:00,6,2,4,FMN GV 11 Ramsel
66,Bergstraat 71,2020-02-07,21:00:00,12,6,6,FMN GV 11 Ramsel
66,Bergstraat 71,2020-02-07,22:00:00,4,2,2,FMN GV 11 Ramsel
66,Bergstraat 71,2020-02-07,23:00:00,2,2,0,FMN GV 11 Ramsel
66,Bergstraat 71,2020-02-08,00:00:00,2,0,2,FMN GV 11 Ramsel
66,Bergstraat 71,2020-02-08,01:00:00,2,2,0,FMN GV 11 Ramsel
66,Bergstraat 71,2020-02-08,02:00:00,6,4,2,FMN GV 11 Ramsel
66,Bergstraat 71,2020-02-08,03:00:00,6,6,0,FMN GV 11 Ramsel
66,Bergstraat 71,2020-02-08,04:00:00,0,0,0,FMN GV 11 Ramsel
66,Bergstraat 71,2020-02-08,05:00:00,0,0,0,FMN GV 11 Ramsel
66,Bergstraat 71,2020-02-08,06:00:00,4,0,4,FMN GV 11 Ramsel
66,Bergstraat 71,2020-02-08,07:00:00,12,6,6,FMN GV 11 Ramsel
66,Bergstraat 71,2020-02-08,08:00:00,42,16,26,FMN GV 11 Ramsel
66,Bergstraat 71,2020-02-08,09:00:00,84,16,68,FMN GV 11 Ramsel
66,Bergstraat 71,2020-02-08,10:00:00,104,46,58,FMN GV 11 Ramsel
66,Bergstraat 71,2020-02-08,11:00:00,112,56,56,FMN GV 11 Ramsel
66,Bergstraat 71,2020-02-08,12:00:00,82,46,36,FMN GV 11 Ramsel
66,Bergstraat 71,2020-02-08,13:00:00,84,32,52,FMN GV 11 Ramsel
66,Bergstraat 71,2020-02-08,14:00:00,80,46,34,FMN GV 11 Ramsel
66,Bergstraat 71,2020-02-08,15:00:00,56,38,18,FMN GV 11 Ramsel
66,Bergstraat 71,2020-02-08,16:00:00,28,8,20,FMN GV 11 Ramsel
66,Bergstraat 71,2020-02-08,17:00:00,12,4,8,FMN GV 11 Ramsel
66,Bergstraat 71,2020-02-08,18:00:00,12,8,4,FMN GV 11 Ramsel
66,Bergstraat 71,2020-02-08,19:00:00,6,4,2,FMN GV 11 Ramsel
66,Bergstraat 71,2020-02-08,20:00:00,4,2,2,FMN GV 11 Ramsel
66,Bergstraat 71,2020-02-08,21:00:00,2,0,2,FMN GV 11 Ramsel
66,Bergstraat 71,2020-02-08,22:00:00,2,2,0,FMN GV 11 Ramsel
66,Bergstraat 71,2020-02-08,23:00:00,8,6,2,FMN GV 11 Ramsel
66,Bergstraat 71,2020-02-09,00:00:00,6,4,2,FMN GV 11 Ramsel
66,Bergstraat 71,2020-02-09,01:00:00,0,0,0,FMN GV 11 Ramsel
66,Bergstraat 71,2020-02-09,02:00:00,2,2,0,FMN GV 11 Ramsel
66,Bergstraat 71,2020-02-09,03:00:00,0,0,0,FMN GV 11 Ramsel
66,Bergstraat 71,2020-02-09,04:00:00,2,2,0,FMN GV 11 Ramsel
66,Bergstraat 71,2020-02-09,05:00:00,2,2,0,FMN GV 11 Ramsel
66,Bergstraat 71,2020-02-09,06:00:00,4,2,2,FMN GV 11 Ramsel
66,Bergstraat 71,2020-02-09,07:00:00,2,0,2,FMN GV 11 Ramsel
66,Bergstraat 71,2020-02-09,08:00:00,12,2,10,FMN GV 11 Ramsel
66,Bergstraat 71,2020-02-09,09:00:00,32,8,24,FMN GV 11 Ramsel
66,Bergstraat 71,2020-02-09,10:00:00,42,30,12,FMN GV 11 Ramsel
66,Bergstraat 71,2020-02-09,11:00:00,12,10,2,FMN GV 11 Ramsel
66,Bergstraat 71,2020-02-09,12:00:00,4,4,0,FMN GV 11 Ramsel
66,Bergstraat 71,2020-02-09,13:00:00,0,0,0,FMN GV 11 Ramsel
66,Bergstraat 71,2020-02-09,14:00:00,10,4,6,FMN GV 11 Ramsel
66,Bergstraat 71,2020-02-09,15:00:00,2,2,0,FMN GV 11 Ramsel
66,Bergstraat 71,2020-02-09,16:00:00,2,0,2,FMN GV 11 Ramsel
66,Bergstraat 71,2020-02-09,17:00:00,4,4,0,FMN GV 11 Ramsel
66,Bergstraat 71,2020-02-09,18:00:00,0,0,0,FMN GV 11 Ramsel
66,Bergstraat 71,2020-02-09,19:00:00,4,0,4,FMN GV 11 Ramsel
66,Bergstraat 71,2020-02-09,20:00:00,2,2,0,FMN GV 11 Ramsel
66,Bergstraat 71,2020-02-09,21:00:00,0,0,0,FMN GV 11 Ramsel
66,Bergstraat 71,2020-02-09,22:00:00,0,0,0,FMN GV 11 Ramsel
66,Bergstraat 71,2020-02-09,23:00:00,0,0,0,FMN GV 11 Ramsel
66,Bergstraat 71,2020-02-10,00:00:00,0,0,0,FMN GV 11 Ramsel
66,Bergstraat 71,2020-02-10,01:00:00,0,0,0,FMN GV 11 Ramsel
66,Bergstraat 71,2020-02-10,02:00:00,0,0,0,FMN GV 11 Ramsel
66,Bergstraat 71,2020-02-10,03:00:00,0,0,0,FMN GV 11 Ramsel
66,Bergstraat 71,2020-02-10,04:00:00,2,2,0,FMN GV 11 Ramsel
66,Bergstraat 71,2020-02-10,05:00:00,4,4,0,FMN GV 11 Ramsel
66,Bergstraat 71,2020-02-10,06:00:00,8,0,8,FMN GV 11 Ramsel
66,Bergstraat 71,2020-02-10,07:00:00,24,4,20,FMN GV 11 Ramsel
66,Bergstraat 71,2020-02-10,08:00:00,26,2,24,FMN GV 11 Ramsel
66,Bergstraat 71,2020-02-10,09:00:00,10,2,8,FMN GV 11 Ramsel
66,Bergstraat 71,2020-02-10,10:00:00,8,4,4,FMN GV 11 Ramsel
66,Bergstraat 71,2020-02-10,11:00:00,10,2,8,FMN GV 11 Ramsel
66,Bergstraat 71,2020-02-10,12:00:00,14,8,6,FMN GV 11 Ramsel
66,Bergstraat 71,2020-02-10,13:00:00,16,4,12,FMN GV 11 Ramsel
66,Bergstraat 71,2020-02-10,14:00:00,12,6,6,FMN GV 11 Ramsel
66,Bergstraat 71,2020-02-10,15:00:00,30,22,8,FMN GV 11 Ramsel
66,Bergstraat 71,2020-02-10,16:00:00,16,16,0,FMN GV 11 Ramsel
66,Bergstraat 71,2020-02-10,17:00:00,26,18,8,FMN GV 11 Ramsel
66,Bergstraat 71,2020-02-10,18:00:00,6,2,4,FMN GV 11 Ramsel
66,Bergstraat 71,2020-02-10,19:00:00,4,2,2,FMN GV 11 Ramsel
66,Bergstraat 71,2020-02-10,20:00:00,4,2,2,FMN GV 11 Ramsel
66,Bergstraat 71,2020-02-10,21:00:00,2,0,2,FMN GV 11 Ramsel
66,Bergstraat 71,2020-02-10,22:00:00,6,2,4,FMN GV 11 Ramsel
66,Bergstraat 71,2020-02-10,23:00:00,2,2,0,FMN GV 11 Ramsel
66,Bergstraat 71,2020-02-11,00:00:00,4,0,4,FMN GV 11 Ramsel
66,Bergstraat 71,2020-02-11,01:00:00,0,0,0,FMN GV 11 Ramsel
66,Bergstraat 71,2020-02-11,02:00:00,0,0,0,FMN GV 11 Ramsel
66,Bergstraat 71,2020-02-11,03:00:00,0,0,0,FMN GV 11 Ramsel
66,Bergstraat 71,2020-02-11,04:00:00,2,2,0,FMN GV 11 Ramsel
66,Bergstraat 71,2020-02-11,05:00:00,8,4,4,FMN GV 11 Ramsel
66,Bergstraat 71,2020-02-11,06:00:00,24,4,20,FMN GV 11 Ramsel
66,Bergstraat 71,2020-02-11,07:00:00,96,10,86,FMN GV 11 Ramsel
66,Bergstraat 71,2020-02-11,08:00:00,110,10,100,FMN GV 11 Ramsel
66,Bergstraat 71,2020-02-11,09:00:00,34,18,16,FMN GV 11 Ramsel
66,Bergstraat 71,2020-02-11,10:00:00,18,12,6,FMN GV 11 Ramsel
66,Bergstraat 71,2020-02-11,11:00:00,26,8,18,FMN GV 11 Ramsel
66,Bergstraat 71,2020-02-11,12:00:00,34,12,22,FMN GV 11 Ramsel
66,Bergstraat 71,2020-02-11,13:00:00,106,64,42,FMN GV 11 Ramsel
66,Bergstraat 71,2020-02-11,14:00:00,28,20,8,FMN GV 11 Ramsel
66,Bergstraat 71,2020-02-11,15:00:00,92,74,18,FMN GV 11 Ramsel
66,Bergstraat 71,2020-02-11,16:00:00,82,70,12,FMN GV 11 Ramsel
66,Bergstraat 71,2020-02-11,17:00:00,58,40,18,FMN GV 11 Ramsel
66,Bergstraat 71,2020-02-11,18:00:00,16,8,8,FMN GV 11 Ramsel
66,Bergstraat 71,2020-02-11,19:00:00,16,2,14,FMN GV 11 Ramsel
66,Bergstraat 71,2020-02-11,20:00:00,14,12,2,FMN GV 11 Ramsel
66,Bergstraat 71,2020-02-11,21:00:00,2,2,0,FMN GV 11 Ramsel
66,Bergstraat 71,2020-02-11,22:00:00,10,2,8,FMN GV 11 Ramsel
66,Bergstraat 71,2020-02-11,23:00:00,0,0,0,FMN GV 11 Ramsel
66,Bergstraat 71,2020-02-12,00:00:00,2,2,0,FMN GV 11 Ramsel
66,Bergstraat 71,2020-02-12,01:00:00,0,0,0,FMN GV 11 Ramsel
66,Bergstraat 71,2020-02-12,02:00:00,0,0,0,FMN GV 11 Ramsel
66,Bergstraat 71,2020-02-12,03:00:00,2,2,0,FMN GV 11 Ramsel
66,Bergstraat 71,2020-02-12,04:00:00,4,2,2,FMN GV 11 Ramsel
66,Bergstraat 71,2020-02-12,05:00:00,6,4,2,FMN GV 11 Ramsel
66,Bergstraat 71,2020-02-12,06:00:00,22,2,20,FMN GV 11 Ramsel
66,Bergstraat 71,2020-02-12,07:00:00,110,16,94,FMN GV 11 Ramsel
66,Bergstraat 71,2020-02-12,08:00:00,104,20,84,FMN GV 11 Ramsel
66,Bergstraat 71,2020-02-12,09:00:00,12,2,10,FMN GV 11 Ramsel
66,Bergstraat 71,2020-02-12,10:00:00,36,22,14,FMN GV 11 Ramsel
66,Bergstraat 71,2020-02-12,11:00:00,48,28,20,FMN GV 11 Ramsel
66,Bergstraat 71,2020-02-12,12:00:00,140,110,30,FMN GV 11 Ramsel
66,Bergstraat 71,2020-02-12,13:00:00,86,48,38,FMN GV 11 Ramsel
66,Bergstraat 71,2020-02-12,14:00:00,60,28,32,FMN GV 11 Ramsel
66,Bergstraat 71,2020-02-12,15:00:00,82,50,32,FMN GV 11 Ramsel
66,Bergstraat 71,2020-02-12,16:00:00,72,46,26,FMN GV 11 Ramsel
66,Bergstraat 71,2020-02-12,17:00:00,66,50,16,FMN GV 11 Ramsel
66,Bergstraat 71,2020-02-12,18:00:00,30,16,14,FMN GV 11 Ramsel
66,Bergstraat 71,2020-02-12,19:00:00,12,8,4,FMN GV 11 Ramsel
66,Bergstraat 71,2020-02-12,20:00:00,14,10,4,FMN GV 11 Ramsel
66,Bergstraat 71,2020-02-12,21:00:00,6,4,2,FMN GV 11 Ramsel
66,Bergstraat 71,2020-02-12,22:00:00,12,8,4,FMN GV 11 Ramsel
66,Bergstraat 71,2020-02-12,23:00:00,4,4,0,FMN GV 11 Ramsel
66,Bergstraat 71,2020-02-13,00:00:00,2,0,2,FMN GV 11 Ramsel
66,Bergstraat 71,2020-02-13,01:00:00,0,0,0,FMN GV 11 Ramsel
66,Bergstraat 71,2020-02-13,02:00:00,0,0,0,FMN GV 11 Ramsel
66,Bergstraat 71,2020-02-13,03:00:00,0,0,0,FMN GV 11 Ramsel
66,Bergstraat 71,2020-02-13,04:00:00,2,2,0,FMN GV 11 Ramsel
66,Bergstraat 71,2020-02-13,05:00:00,8,6,2,FMN GV 11 Ramsel
66,Bergstraat 71,2020-02-13,06:00:00,18,2,16,FMN GV 11 Ramsel
66,Bergstraat 71,2020-02-13,07:00:00,56,8,48,FMN GV 11 Ramsel
66,Bergstraat 71,2020-02-13,08:00:00,66,2,64,FMN GV 11 Ramsel
66,Bergstraat 71,2020-02-13,09:00:00,16,2,14,FMN GV 11 Ramsel
66,Bergstraat 71,2020-02-13,10:00:00,6,4,2,FMN GV 11 Ramsel
66,Bergstraat 71,2020-02-13,11:00:00,0,0,0,FMN GV 11 Ramsel
66,Bergstraat 71,2020-02-13,12:00:00,6,2,4,FMN GV 11 Ramsel
66,Bergstraat 71,2020-02-13,13:00:00,36,20,16,FMN GV 11 Ramsel
66,Bergstraat 71,2020-02-13,14:00:00,34,20,14,FMN GV 11 Ramsel
66,Bergstraat 71,2020-02-13,15:00:00,86,66,20,FMN GV 11 Ramsel
66,Bergstraat 71,2020-02-13,16:00:00,56,48,8,FMN GV 11 Ramsel
66,Bergstraat 71,2020-02-13,17:00:00,32,22,10,FMN GV 11 Ramsel
66,Bergstraat 71,2020-02-13,18:00:00,22,16,6,FMN GV 11 Ramsel
66,Bergstraat 71,2020-02-13,19:00:00,10,4,6,FMN GV 11 Ramsel
66,Bergstraat 71,2020-02-13,20:00:00,10,6,4,FMN GV 11 Ramsel
66,Bergstraat 71,2020-02-13,21:00:00,10,10,0,FMN GV 11 Ramsel
66,Bergstraat 71,2020-02-13,22:00:00,4,2,2,FMN GV 11 Ramsel
66,Bergstraat 71,2020-02-13,23:00:00,0,0,0,FMN GV 11 Ramsel
66,Bergstraat 71,2020-02-14,00:00:00,2,2,0,FMN GV 11 Ramsel
66,Bergstraat 71,2020-02-14,01:00:00,0,0,0,FMN GV 11 Ramsel
66,Bergstraat 71,2020-02-14,02:00:00,2,2,0,FMN GV 11 Ramsel
66,Bergstraat 71,2020-02-14,03:00:00,0,0,0,FMN GV 11 Ramsel
66,Bergstraat 71,2020-02-14,04:00:00,2,2,0,FMN GV 11 Ramsel
66,Bergstraat 71,2020-02-14,05:00:00,8,4,4,FMN GV 11 Ramsel
66,Bergstraat 71,2020-02-14,06:00:00,14,2,12,FMN GV 11 Ramsel
66,Bergstraat 71,2020-02-14,07:00:00,102,16,86,FMN GV 11 Ramsel
66,Bergstraat 71,2020-02-14,08:00:00,98,14,84,FMN GV 11 Ramsel
66,Bergstraat 71,2020-02-14,09:00:00,56,20,36,FMN GV 11 Ramsel
66,Bergstraat 71,2020-02-14,10:00:00,48,16,32,FMN GV 11 Ramsel
66,Bergstraat 71,2020-02-14,11:00:00,30,22,8,FMN GV 11 Ramsel
66,Bergstraat 71,2020-02-14,12:00:00,86,36,50,FMN GV 11 Ramsel
66,Bergstraat 71,2020-02-14,13:00:00,104,42,62,FMN GV 11 Ramsel
66,Bergstraat 71,2020-02-14,14:00:00,124,76,48,FMN GV 11 Ramsel
66,Bergstraat 71,2020-02-14,15:00:00,200,142,58,FMN GV 11 Ramsel
66,Bergstraat 71,2020-02-14,16:00:00,146,92,54,FMN GV 11 Ramsel
66,Bergstraat 71,2020-02-14,17:00:00,94,72,22,FMN GV 11 Ramsel
66,Bergstraat 71,2020-02-14,18:00:00,46,32,14,FMN GV 11 Ramsel
66,Bergstraat 71,2020-02-14,19:00:00,20,16,4,FMN GV 11 Ramsel
66,Bergstraat 71,2020-02-14,20:00:00,20,2,18,FMN GV 11 Ramsel
66,Bergstraat 71,2020-02-14,21:00:00,6,0,6,FMN GV 11 Ramsel
66,Bergstraat 71,2020-02-14,22:00:00,20,4,16,FMN GV 11 Ramsel
66,Bergstraat 71,2020-02-14,23:00:00,10,0,10,FMN GV 11 Ramsel
66,Bergstraat 71,2020-02-15,00:00:00,2,0,2,FMN GV 11 Ramsel
66,Bergstraat 71,2020-02-15,01:00:00,2,0,2,FMN GV 11 Ramsel
66,Bergstraat 71,2020-02-15,02:00:00,10,8,2,FMN GV 11 Ramsel
66,Bergstraat 71,2020-02-15,03:00:00,14,12,2,FMN GV 11 Ramsel
66,Bergstraat 71,2020-02-15,04:00:00,8,8,0,FMN GV 11 Ramsel
66,Bergstraat 71,2020-02-15,05:00:00,0,0,0,FMN GV 11 Ramsel
66,Bergstraat 71,2020-02-15,06:00:00,2,0,2,FMN GV 11 Ramsel
66,Bergstraat 71,2020-02-15,07:00:00,6,2,4,FMN GV 11 Ramsel
66,Bergstraat 71,2020-02-15,08:00:00,26,10,16,FMN GV 11 Ramsel
66,Bergstraat 71,2020-02-15,09:00:00,74,22,52,FMN GV 11 Ramsel
66,Bergstraat 71,2020-02-15,10:00:00,96,44,52,FMN GV 11 Ramsel
66,Bergstraat 71,2020-02-15,11:00:00,80,36,44,FMN GV 11 Ramsel
66,Bergstraat 71,2020-02-15,12:00:00,124,56,68,FMN GV 11 Ramsel
66,Bergstraat 71,2020-02-15,13:00:00,124,48,76,FMN GV 11 Ramsel
66,Bergstraat 71,2020-02-15,14:00:00,152,80,72,FMN GV 11 Ramsel
66,Bergstraat 71,2020-02-15,15:00:00,110,76,34,FMN GV 11 Ramsel
66,Bergstraat 71,2020-02-15,16:00:00,74,52,22,FMN GV 11 Ramsel
66,Bergstraat 71,2020-02-15,17:00:00,48,22,26,FMN GV 11 Ramsel
66,Bergstraat 71,2020-02-15,18:00:00,14,8,6,FMN GV 11 Ramsel
66,Bergstraat 71,2020-02-15,19:00:00,2,2,0,FMN GV 11 Ramsel
66,Bergstraat 71,2020-02-15,20:00:00,10,4,6,FMN GV 11 Ramsel
66,Bergstraat 71,2020-02-15,21:00:00,10,10,0,FMN GV 11 Ramsel
66,Bergstraat 71,2020-02-15,22:00:00,2,2,0,FMN GV 11 Ramsel
66,Bergstraat 71,2020-02-15,23:00:00,12,4,8,FMN GV 11 Ramsel
66,Bergstraat 71,2020-02-16,00:00:00,4,4,0,FMN GV 11 Ramsel
66,Bergstraat 71,2020-02-16,01:00:00,0,0,0,FMN GV 11 Ramsel
66,Bergstraat 71,2020-02-16,02:00:00,2,2,0,FMN GV 11 Ramsel
66,Bergstraat 71,2020-02-16,03:00:00,0,0,0,FMN GV 11 Ramsel
66,Bergstraat 71,2020-02-16,04:00:00,2,0,2,FMN GV 11 Ramsel
66,Bergstraat 71,2020-02-16,05:00:00,0,0,0,FMN GV 11 Ramsel
66,Bergstraat 71,2020-02-16,06:00:00,0,0,0,FMN GV 11 Ramsel
66,Bergstraat 71,2020-02-16,07:00:00,0,0,0,FMN GV 11 Ramsel
66,Bergstraat 71,2020-02-16,08:00:00,14,4,10,FMN GV 11 Ramsel
66,Bergstraat 71,2020-02-16,09:00:00,12,8,4,FMN GV 11 Ramsel
66,Bergstraat 71,2020-02-16,10:00:00,10,10,0,FMN GV 11 Ramsel
66,Bergstraat 71,2020-02-16,11:00:00,10,8,2,FMN GV 11 Ramsel
66,Bergstraat 71,2020-02-16,12:00:00,8,2,6,FMN GV 11 Ramsel
66,Bergstraat 71,2020-02-16,13:00:00,2,2,0,FMN GV 11 Ramsel
66,Bergstraat 71,2020-02-16,14:00:00,8,4,4,FMN GV 11 Ramsel
66,Bergstraat 71,2020-02-16,15:00:00,14,8,6,FMN GV 11 Ramsel
66,Bergstraat 71,2020-02-16,16:00:00,6,6,0,FMN GV 11 Ramsel
66,Bergstraat 71,2020-02-16,17:00:00,10,0,10,FMN GV 11 Ramsel
66,Bergstraat 71,2020-02-16,18:00:00,10,6,4,FMN GV 11 Ramsel
66,Bergstraat 71,2020-02-16,19:00:00,0,0,0,FMN GV 11 Ramsel
66,Bergstraat 71,2020-02-16,20:00:00,2,0,2,FMN GV 11 Ramsel
66,Bergstraat 71,2020-02-16,21:00:00,2,2,0,FMN GV 11 Ramsel
66,Bergstraat 71,2020-02-16,22:00:00,0,0,0,FMN GV 11 Ramsel
66,Bergstraat 71,2020-02-16,23:00:00,0,0,0,FMN GV 11 Ramsel
66,Bergstraat 71,2020-02-17,00:00:00,0,0,0,FMN GV 11 Ramsel
66,Bergstraat 71,2020-02-17,01:00:00,0,0,0,FMN GV 11 Ramsel
66,Bergstraat 71,2020-02-17,02:00:00,0,0,0,FMN GV 11 Ramsel
66,Bergstraat 71,2020-02-17,03:00:00,0,0,0,FMN GV 11 Ramsel
66,Bergstraat 71,2020-02-17,04:00:00,2,2,0,FMN GV 11 Ramsel
66,Bergstraat 71,2020-02-17,05:00:00,8,8,0,FMN GV 11 Ramsel
66,Bergstraat 71,2020-02-17,06:00:00,34,6,28,FMN GV 11 Ramsel
66,Bergstraat 71,2020-02-17,07:00:00,106,8,98,FMN GV 11 Ramsel
66,Bergstraat 71,2020-02-17,08:00:00,112,6,106,FMN GV 11 Ramsel
66,Bergstraat 71,2020-02-17,09:00:00,38,16,22,FMN GV 11 Ramsel
66,Bergstraat 71,2020-02-17,10:00:00,48,26,22,FMN GV 11 Ramsel
66,Bergstraat 71,2020-02-17,11:00:00,46,24,22,FMN GV 11 Ramsel
66,Bergstraat 71,2020-02-17,12:00:00,38,20,18,FMN GV 11 Ramsel
66,Bergstraat 71,2020-02-17,13:00:00,66,40,26,FMN GV 11 Ramsel
66,Bergstraat 71,2020-02-17,14:00:00,34,24,10,FMN GV 11 Ramsel
66,Bergstraat 71,2020-02-17,15:00:00,130,110,20,FMN GV 11 Ramsel
66,Bergstraat 71,2020-02-17,16:00:00,94,86,8,FMN GV 11 Ramsel
66,Bergstraat 71,2020-02-17,17:00:00,52,32,20,FMN GV 11 Ramsel
66,Bergstraat 71,2020-02-17,18:00:00,32,26,6,FMN GV 11 Ramsel
66,Bergstraat 71,2020-02-17,19:00:00,20,16,4,FMN GV 11 Ramsel
66,Bergstraat 71,2020-02-17,20:00:00,8,4,4,FMN GV 11 Ramsel
66,Bergstraat 71,2020-02-17,21:00:00,10,6,4,FMN GV 11 Ramsel
66,Bergstraat 71,2020-02-17,22:00:00,2,2,0,FMN GV 11 Ramsel
66,Bergstraat 71,2020-02-17,23:00:00,6,4,2,FMN GV 11 Ramsel
66,Bergstraat 71,2020-02-18,00:00:00,0,0,0,FMN GV 11 Ramsel
66,Bergstraat 71,2020-02-18,01:00:00,0,0,0,FMN GV 11 Ramsel
66,Bergstraat 71,2020-02-18,02:00:00,2,0,2,FMN GV 11 Ramsel
66,Bergstraat 71,2020-02-18,03:00:00,0,0,0,FMN GV 11 Ramsel
66,Bergstraat 71,2020-02-18,04:00:00,2,2,0,FMN GV 11 Ramsel
66,Bergstraat 71,2020-02-18,05:00:00,14,12,2,FMN GV 11 Ramsel
66,Bergstraat 71,2020-02-18,06:00:00,42,4,38,FMN GV 11 Ramsel
66,Bergstraat 71,2020-02-18,07:00:00,102,20,82,FMN GV 11 Ramsel
66,Bergstraat 71,2020-02-18,08:00:00,122,30,92,FMN GV 11 Ramsel
66,Bergstraat 71,2020-02-18,09:00:00,32,16,16,FMN GV 11 Ramsel
66,Bergstraat 71,2020-02-18,10:00:00,42,12,30,FMN GV 11 Ramsel
66,Bergstraat 71,2020-02-18,11:00:00,46,30,16,FMN GV 11 Ramsel
66,Bergstraat 71,2020-02-18,12:00:00,48,26,22,FMN GV 11 Ramsel
66,Bergstraat 71,2020-02-18,13:00:00,98,48,50,FMN GV 11 Ramsel
66,Bergstraat 71,2020-02-18,14:00:00,66,42,24,FMN GV 11 Ramsel
66,Bergstraat 71,2020-02-18,15:00:00,150,116,34,FMN GV 11 Ramsel
66,Bergstraat 71,2020-02-18,16:00:00,136,104,32,FMN GV 11 Ramsel
66,Bergstraat 71,2020-02-18,17:00:00,84,50,34,FMN GV 11 Ramsel
66,Bergstraat 71,2020-02-18,18:00:00,30,18,12,FMN GV 11 Ramsel
66,Bergstraat 71,2020-02-18,19:00:00,36,10,26,FMN GV 11 Ramsel
66,Bergstraat 71,2020-02-18,20:00:00,18,18,0,FMN GV 11 Ramsel
66,Bergstraat 71,2020-02-18,21:00:00,4,4,0,FMN GV 11 Ramsel
66,Bergstraat 71,2020-02-18,22:00:00,4,2,2,FMN GV 11 Ramsel
66,Bergstraat 71,2020-02-18,23:00:00,6,6,0,FMN GV 11 Ramsel
66,Bergstraat 71,2020-02-19,00:00:00,0,0,0,FMN GV 11 Ramsel
66,Bergstraat 71,2020-02-19,01:00:00,2,2,0,FMN GV 11 Ramsel
66,Bergstraat 71,2020-02-19,02:00:00,0,0,0,FMN GV 11 Ramsel
66,Bergstraat 71,2020-02-19,03:00:00,0,0,0,FMN GV 11 Ramsel
66,Bergstraat 71,2020-02-19,04:00:00,4,2,2,FMN GV 11 Ramsel
66,Bergstraat 71,2020-02-19,05:00:00,12,8,4,FMN GV 11 Ramsel
66,Bergstraat 71,2020-02-19,06:00:00,42,4,38,FMN GV 11 Ramsel
66,Bergstraat 71,2020-02-19,07:00:00,114,20,94,FMN GV 11 Ramsel
66,Bergstraat 71,2020-02-19,08:00:00,120,16,104,FMN GV 11 Ramsel
66,Bergstraat 71,2020-02-19,09:00:00,42,20,22,FMN GV 11 Ramsel
66,Bergstraat 71,2020-02-19,10:00:00,26,4,22,FMN GV 11 Ramsel
66,Bergstraat 71,2020-02-19,11:00:00,40,20,20,FMN GV 11 Ramsel
66,Bergstraat 71,2020-02-19,12:00:00,194,152,42,FMN GV 11 Ramsel
66,Bergstraat 71,2020-02-19,13:00:00,66,34,32,FMN GV 11 Ramsel
66,Bergstraat 71,2020-02-19,14:00:00,114,54,60,FMN GV 11 Ramsel
66,Bergstraat 71,2020-02-19,15:00:00,80,54,26,FMN GV 11 Ramsel
66,Bergstraat 71,2020-02-19,16:00:00,108,80,28,FMN GV 11 Ramsel
66,Bergstraat 71,2020-02-19,17:00:00,76,42,34,FMN GV 11 Ramsel
66,Bergstraat 71,2020-02-19,18:00:00,68,36,32,FMN GV 11 Ramsel
66,Bergstraat 71,2020-02-19,19:00:00,32,24,8,FMN GV 11 Ramsel
66,Bergstraat 71,2020-02-19,20:00:00,12,4,8,FMN GV 11 Ramsel
66,Bergstraat 71,2020-02-19,21:00:00,14,8,6,FMN GV 11 Ramsel
66,Bergstraat 71,2020-02-19,22:00:00,8,8,0,FMN GV 11 Ramsel
66,Bergstraat 71,2020-02-19,23:00:00,4,4,0,FMN GV 11 Ramsel
66,Bergstraat 71,2020-02-20,00:00:00,0,0,0,FMN GV 11 Ramsel
66,Bergstraat 71,2020-02-20,01:00:00,2,2,0,FMN GV 11 Ramsel
66,Bergstraat 71,2020-02-20,02:00:00,0,0,0,FMN GV 11 Ramsel
66,Bergstraat 71,2020-02-20,03:00:00,0,0,0,FMN GV 11 Ramsel
66,Bergstraat 71,2020-02-20,04:00:00,4,2,2,FMN GV 11 Ramsel
66,Bergstraat 71,2020-02-20,05:00:00,18,10,8,FMN GV 11 Ramsel
66,Bergstraat 71,2020-02-20,06:00:00,28,6,22,FMN GV 11 Ramsel
66,Bergstraat 71,2020-02-20,07:00:00,106,8,98,FMN GV 11 Ramsel
66,Bergstraat 71,2020-02-20,08:00:00,108,12,96,FMN GV 11 Ramsel
66,Bergstraat 71,2020-02-20,09:00:00,26,6,20,FMN GV 11 Ramsel
66,Bergstraat 71,2020-02-20,10:00:00,50,24,26,FMN GV 11 Ramsel
66,Bergstraat 71,2020-02-20,11:00:00,36,16,20,FMN GV 11 Ramsel
66,Bergstraat 71,2020-02-20,12:00:00,28,20,8,FMN GV 11 Ramsel
66,Bergstraat 71,2020-02-20,13:00:00,32,8,24,FMN GV 11 Ramsel
66,Bergstraat 71,2020-02-20,14:00:00,80,36,44,FMN GV 11 Ramsel
66,Bergstraat 71,2020-02-20,15:00:00,150,138,12,FMN GV 11 Ramsel
66,Bergstraat 71,2020-02-20,16:00:00,96,86,10,FMN GV 11 Ramsel
66,Bergstraat 71,2020-02-20,17:00:00,66,46,20,FMN GV 11 Ramsel
66,Bergstraat 71,2020-02-20,18:00:00,36,22,14,FMN GV 11 Ramsel
66,Bergstraat 71,2020-02-20,19:00:00,8,8,0,FMN GV 11 Ramsel
66,Bergstraat 71,2020-02-20,20:00:00,4,2,2,FMN GV 11 Ramsel
66,Bergstraat 71,2020-02-20,21:00:00,0,0,0,FMN GV 11 Ramsel
66,Bergstraat 71,2020-02-20,22:00:00,0,0,0,FMN GV 11 Ramsel
66,Bergstraat 71,2020-02-20,23:00:00,6,4,2,FMN GV 11 Ramsel
66,Bergstraat 71,2020-02-21,00:00:00,0,0,0,FMN GV 11 Ramsel
66,Bergstraat 71,2020-02-21,01:00:00,0,0,0,FMN GV 11 Ramsel
66,Bergstraat 71,2020-02-21,02:00:00,0,0,0,FMN GV 11 Ramsel
66,Bergstraat 71,2020-02-21,03:00:00,2,0,2,FMN GV 11 Ramsel
66,Bergstraat 71,2020-02-21,04:00:00,0,0,0,FMN GV 11 Ramsel
66,Bergstraat 71,2020-02-21,05:00:00,10,10,0,FMN GV 11 Ramsel
66,Bergstraat 71,2020-02-21,06:00:00,16,0,16,FMN GV 11 Ramsel
66,Bergstraat 71,2020-02-21,07:00:00,104,14,90,FMN GV 11 Ramsel
66,Bergstraat 71,2020-02-21,08:00:00,94,12,82,FMN GV 11 Ramsel
66,Bergstraat 71,2020-02-21,09:00:00,34,18,16,FMN GV 11 Ramsel
66,Bergstraat 71,2020-02-21,10:00:00,60,28,32,FMN GV 11 Ramsel
66,Bergstraat 71,2020-02-21,11:00:00,44,32,12,FMN GV 11 Ramsel
66,Bergstraat 71,2020-02-21,12:00:00,66,34,32,FMN GV 11 Ramsel
66,Bergstraat 71,2020-02-21,13:00:00,120,38,82,FMN GV 11 Ramsel
66,Bergstraat 71,2020-02-21,14:00:00,112,68,44,FMN GV 11 Ramsel
66,Bergstraat 71,2020-02-21,15:00:00,150,108,42,FMN GV 11 Ramsel
66,Bergstraat 71,2020-02-21,16:00:00,112,84,28,FMN GV 11 Ramsel
66,Bergstraat 71,2020-02-21,17:00:00,76,56,20,FMN GV 11 Ramsel
66,Bergstraat 71,2020-02-21,18:00:00,36,20,16,FMN GV 11 Ramsel
66,Bergstraat 71,2020-02-21,19:00:00,16,10,6,FMN GV 11 Ramsel
66,Bergstraat 71,2020-02-21,20:00:00,22,12,10,FMN GV 11 Ramsel
66,Bergstraat 71,2020-02-21,21:00:00,24,6,18,FMN GV 11 Ramsel
66,Bergstraat 71,2020-02-21,22:00:00,12,2,10,FMN GV 11 Ramsel
66,Bergstraat 71,2020-02-21,23:00:00,8,2,6,FMN GV 11 Ramsel
66,Bergstraat 71,2020-02-22,00:00:00,4,4,0,FMN GV 11 Ramsel
66,Bergstraat 71,2020-02-22,01:00:00,2,2,0,FMN GV 11 Ramsel
66,Bergstraat 71,2020-02-22,02:00:00,8,8,0,FMN GV 11 Ramsel
66,Bergstraat 71,2020-02-22,03:00:00,4,4,0,FMN GV 11 Ramsel
66,Bergstraat 71,2020-02-22,04:00:00,10,10,0,FMN GV 11 Ramsel
66,Bergstraat 71,2020-02-22,05:00:00,8,4,4,FMN GV 11 Ramsel
66,Bergstraat 71,2020-02-22,06:00:00,0,0,0,FMN GV 11 Ramsel
66,Bergstraat 71,2020-02-22,07:00:00,16,10,6,FMN GV 11 Ramsel
66,Bergstraat 71,2020-02-22,08:00:00,36,10,26,FMN GV 11 Ramsel
66,Bergstraat 71,2020-02-22,09:00:00,28,12,16,FMN GV 11 Ramsel
66,Bergstraat 71,2020-02-22,10:00:00,60,34,26,FMN GV 11 Ramsel
66,Bergstraat 71,2020-02-22,11:00:00,74,36,38,FMN GV 11 Ramsel
66,Bergstraat 71,2020-02-22,12:00:00,50,34,16,FMN GV 11 Ramsel
66,Bergstraat 71,2020-02-22,13:00:00,52,24,28,FMN GV 11 Ramsel
66,Bergstraat 71,2020-02-22,14:00:00,60,32,28,FMN GV 11 Ramsel
66,Bergstraat 71,2020-02-22,15:00:00,36,26,10,FMN GV 11 Ramsel
66,Bergstraat 71,2020-02-22,16:00:00,42,28,14,FMN GV 11 Ramsel
66,Bergstraat 71,2020-02-22,17:00:00,14,8,6,FMN GV 11 Ramsel
66,Bergstraat 71,2020-02-22,18:00:00,14,8,6,FMN GV 11 Ramsel
66,Bergstraat 71,2020-02-22,19:00:00,12,0,12,FMN GV 11 Ramsel
66,Bergstraat 71,2020-02-22,20:00:00,6,2,4,FMN GV 11 Ramsel
66,Bergstraat 71,2020-02-22,21:00:00,2,2,0,FMN GV 11 Ramsel
66,Bergstraat 71,2020-02-22,22:00:00,4,0,4,FMN GV 11 Ramsel
66,Bergstraat 71,2020-02-22,23:00:00,8,8,0,FMN GV 11 Ramsel
66,Bergstraat 71,2020-02-23,00:00:00,0,0,0,FMN GV 11 Ramsel
66,Bergstraat 71,2020-02-23,01:00:00,2,2,0,FMN GV 11 Ramsel
66,Bergstraat 71,2020-02-23,02:00:00,2,2,0,FMN GV 11 Ramsel
66,Bergstraat 71,2020-02-23,03:00:00,0,0,0,FMN GV 11 Ramsel
66,Bergstraat 71,2020-02-23,04:00:00,2,0,2,FMN GV 11 Ramsel
66,Bergstraat 71,2020-02-23,05:00:00,0,0,0,FMN GV 11 Ramsel
66,Bergstraat 71,2020-02-23,06:00:00,4,0,4,FMN GV 11 Ramsel
66,Bergstraat 71,2020-02-23,07:00:00,2,0,2,FMN GV 11 Ramsel
66,Bergstraat 71,2020-02-23,08:00:00,18,2,16,FMN GV 11 Ramsel
66,Bergstraat 71,2020-02-23,09:00:00,14,8,6,FMN GV 11 Ramsel
66,Bergstraat 71,2020-02-23,10:00:00,10,8,2,FMN GV 11 Ramsel
66,Bergstraat 71,2020-02-23,11:00:00,2,0,2,FMN GV 11 Ramsel
66,Bergstraat 71,2020-02-23,12:00:00,8,2,6,FMN GV 11 Ramsel
66,Bergstraat 71,2020-02-23,13:00:00,6,2,4,FMN GV 11 Ramsel
66,Bergstraat 71,2020-02-23,14:00:00,8,2,6,FMN GV 11 Ramsel
66,Bergstraat 71,2020-02-23,15:00:00,6,2,4,FMN GV 11 Ramsel
66,Bergstraat 71,2020-02-23,16:00:00,2,2,0,FMN GV 11 Ramsel
66,Bergstraat 71,2020-02-23,17:00:00,4,2,2,FMN GV 11 Ramsel
66,Bergstraat 71,2020-02-23,18:00:00,0,0,0,FMN GV 11 Ramsel
66,Bergstraat 71,2020-02-23,19:00:00,0,0,0,FMN GV 11 Ramsel
66,Bergstraat 71,2020-02-23,20:00:00,4,4,0,FMN GV 11 Ramsel
66,Bergstraat 71,2020-02-23,21:00:00,4,2,2,FMN GV 11 Ramsel
66,Bergstraat 71,2020-02-23,22:00:00,4,4,0,FMN GV 11 Ramsel
66,Bergstraat 71,2020-02-23,23:00:00,2,0,2,FMN GV 11 Ramsel
66,Bergstraat 71,2020-02-24,00:00:00,0,0,0,FMN GV 11 Ramsel
66,Bergstraat 71,2020-02-24,01:00:00,0,0,0,FMN GV 11 Ramsel
66,Bergstraat 71,2020-02-24,02:00:00,0,0,0,FMN GV 11 Ramsel
66,Bergstraat 71,2020-02-24,03:00:00,0,0,0,FMN GV 11 Ramsel
66,Bergstraat 71,2020-02-24,04:00:00,2,0,2,FMN GV 11 Ramsel
66,Bergstraat 71,2020-02-24,05:00:00,8,6,2,FMN GV 11 Ramsel
66,Bergstraat 71,2020-02-24,06:00:00,30,4,26,FMN GV 11 Ramsel
66,Bergstraat 71,2020-02-24,07:00:00,46,4,42,FMN GV 11 Ramsel
66,Bergstraat 71,2020-02-24,08:00:00,20,2,18,FMN GV 11 Ramsel
66,Bergstraat 71,2020-02-24,09:00:00,18,8,10,FMN GV 11 Ramsel
66,Bergstraat 71,2020-02-24,10:00:00,16,6,10,FMN GV 11 Ramsel
66,Bergstraat 71,2020-02-24,11:00:00,24,10,14,FMN GV 11 Ramsel
66,Bergstraat 71,2020-02-24,12:00:00,22,12,10,FMN GV 11 Ramsel
66,Bergstraat 71,2020-02-24,13:00:00,30,18,12,FMN GV 11 Ramsel
66,Bergstraat 71,2020-02-24,14:00:00,28,12,16,FMN GV 11 Ramsel
66,Bergstraat 71,2020-02-24,15:00:00,28,22,6,FMN GV 11 Ramsel
66,Bergstraat 71,2020-02-24,16:00:00,32,22,10,FMN GV 11 Ramsel
66,Bergstraat 71,2020-02-24,17:00:00,34,24,10,FMN GV 11 Ramsel
66,Bergstraat 71,2020-02-24,18:00:00,14,10,4,FMN GV 11 Ramsel
66,Bergstraat 71,2020-02-24,19:00:00,4,4,0,FMN GV 11 Ramsel
66,Bergstraat 71,2020-02-24,20:00:00,10,10,0,FMN GV 11 Ramsel
66,Bergstraat 71,2020-02-24,21:00:00,2,2,0,FMN GV 11 Ramsel
66,Bergstraat 71,2020-02-24,22:00:00,10,4,6,FMN GV 11 Ramsel
66,Bergstraat 71,2020-02-24,23:00:00,6,4,2,FMN GV 11 Ramsel
66,Bergstraat 71,2020-02-25,00:00:00,0,0,0,FMN GV 11 Ramsel
66,Bergstraat 71,2020-02-25,01:00:00,0,0,0,FMN GV 11 Ramsel
66,Bergstraat 71,2020-02-25,02:00:00,0,0,0,FMN GV 11 Ramsel
66,Bergstraat 71,2020-02-25,03:00:00,0,0,0,FMN GV 11 Ramsel
66,Bergstraat 71,2020-02-25,04:00:00,4,2,2,FMN GV 11 Ramsel
66,Bergstraat 71,2020-02-25,05:00:00,6,2,4,FMN GV 11 Ramsel
66,Bergstraat 71,2020-02-25,06:00:00,30,4,26,FMN GV 11 Ramsel
66,Bergstraat 71,2020-02-25,07:00:00,36,4,32,FMN GV 11 Ramsel
66,Bergstraat 71,2020-02-25,08:00:00,34,12,22,FMN GV 11 Ramsel
66,Bergstraat 71,2020-02-25,09:00:00,54,22,32,FMN GV 11 Ramsel
66,Bergstraat 71,2020-02-25,10:00:00,36,18,18,FMN GV 11 Ramsel
66,Bergstraat 71,2020-02-25,11:00:00,48,36,12,FMN GV 11 Ramsel
66,Bergstraat 71,2020-02-25,12:00:00,62,38,24,FMN GV 11 Ramsel
66,Bergstraat 71,2020-02-25,13:00:00,72,30,42,FMN GV 11 Ramsel
66,Bergstraat 71,2020-02-25,14:00:00,84,58,26,FMN GV 11 Ramsel
66,Bergstraat 71,2020-02-25,15:00:00,44,36,8,FMN GV 11 Ramsel
66,Bergstraat 71,2020-02-25,16:00:00,22,16,6,FMN GV 11 Ramsel
66,Bergstraat 71,2020-02-25,17:00:00,42,26,16,FMN GV 11 Ramsel
66,Bergstraat 71,2020-02-25,18:00:00,20,18,2,FMN GV 11 Ramsel
66,Bergstraat 71,2020-02-25,19:00:00,16,10,6,FMN GV 11 Ramsel
66,Bergstraat 71,2020-02-25,20:00:00,6,6,0,FMN GV 11 Ramsel
66,Bergstraat 71,2020-02-25,21:00:00,6,4,2,FMN GV 11 Ramsel
66,Bergstraat 71,2020-02-25,22:00:00,12,6,6,FMN GV 11 Ramsel
66,Bergstraat 71,2020-02-25,23:00:00,4,4,0,FMN GV 11 Ramsel
66,Bergstraat 71,2020-02-26,00:00:00,0,0,0,FMN GV 11 Ramsel
66,Bergstraat 71,2020-02-26,01:00:00,2,0,2,FMN GV 11 Ramsel
66,Bergstraat 71,2020-02-26,02:00:00,0,0,0,FMN GV 11 Ramsel
66,Bergstraat 71,2020-02-26,03:00:00,0,0,0,FMN GV 11 Ramsel
66,Bergstraat 71,2020-02-26,04:00:00,2,2,0,FMN GV 11 Ramsel
66,Bergstraat 71,2020-02-26,05:00:00,8,2,6,FMN GV 11 Ramsel
66,Bergstraat 71,2020-02-26,06:00:00,8,0,8,FMN GV 11 Ramsel
66,Bergstraat 71,2020-02-26,07:00:00,20,4,16,FMN GV 11 Ramsel
66,Bergstraat 71,2020-02-26,08:00:00,8,4,4,FMN GV 11 Ramsel
66,Bergstraat 71,2020-02-26,09:00:00,14,4,10,FMN GV 11 Ramsel
66,Bergstraat 71,2020-02-26,10:00:00,2,0,2,FMN GV 11 Ramsel
66,Bergstraat 71,2020-02-26,11:00:00,10,4,6,FMN GV 11 Ramsel
66,Bergstraat 71,2020-02-26,12:00:00,8,8,0,FMN GV 11 Ramsel
66,Bergstraat 71,2020-02-26,13:00:00,14,6,8,FMN GV 11 Ramsel
66,Bergstraat 71,2020-02-26,14:00:00,16,8,8,FMN GV 11 Ramsel
66,Bergstraat 71,2020-02-26,15:00:00,14,10,4,FMN GV 11 Ramsel
66,Bergstraat 71,2020-02-26,16:00:00,18,8,10,FMN GV 11 Ramsel
66,Bergstraat 71,2020-02-26,17:00:00,30,18,12,FMN GV 11 Ramsel
66,Bergstraat 71,2020-02-26,18:00:00,8,4,4,FMN GV 11 Ramsel
66,Bergstraat 71,2020-02-26,19:00:00,10,8,2,FMN GV 11 Ramsel
66,Bergstraat 71,2020-02-26,20:00:00,4,4,0,FMN GV 11 Ramsel
66,Bergstraat 71,2020-02-26,21:00:00,0,0,0,FMN GV 11 Ramsel
66,Bergstraat 71,2020-02-26,22:00:00,4,2,2,FMN GV 11 Ramsel
66,Bergstraat 71,2020-02-26,23:00:00,2,2,0,FMN GV 11 Ramsel
66,Bergstraat 71,2020-02-27,00:00:00,6,4,2,FMN GV 11 Ramsel
66,Bergstraat 71,2020-02-27,01:00:00,0,0,0,FMN GV 11 Ramsel
66,Bergstraat 71,2020-02-27,02:00:00,0,0,0,FMN GV 11 Ramsel
66,Bergstraat 71,2020-02-27,03:00:00,0,0,0,FMN GV 11 Ramsel
66,Bergstraat 71,2020-02-27,04:00:00,2,0,2,FMN GV 11 Ramsel
66,Bergstraat 71,2020-02-27,05:00:00,12,6,6,FMN GV 11 Ramsel
66,Bergstraat 71,2020-02-27,06:00:00,22,2,20,FMN GV 11 Ramsel
66,Bergstraat 71,2020-02-27,07:00:00,20,8,12,FMN GV 11 Ramsel
66,Bergstraat 71,2020-02-27,08:00:00,10,2,8,FMN GV 11 Ramsel
66,Bergstraat 71,2020-02-27,09:00:00,8,4,4,FMN GV 11 Ramsel
66,Bergstraat 71,2020-02-27,10:00:00,8,2,6,FMN GV 11 Ramsel
66,Bergstraat 71,2020-02-27,11:00:00,4,2,2,FMN GV 11 Ramsel
66,Bergstraat 71,2020-02-27,12:00:00,8,8,0,FMN GV 11 Ramsel
66,Bergstraat 71,2020-02-27,13:00:00,8,6,2,FMN GV 11 Ramsel
66,Bergstraat 71,2020-02-27,14:00:00,12,4,8,FMN GV 11 Ramsel
66,Bergstraat 71,2020-02-27,15:00:00,8,4,4,FMN GV 11 Ramsel
66,Bergstraat 71,2020-02-27,16:00:00,14,10,4,FMN GV 11 Ramsel
66,Bergstraat 71,2020-02-27,17:00:00,18,10,8,FMN GV 11 Ramsel
66,Bergstraat 71,2020-02-27,18:00:00,14,10,4,FMN GV 11 Ramsel
66,Bergstraat 71,2020-02-27,19:00:00,2,2,0,FMN GV 11 Ramsel
66,Bergstraat 71,2020-02-27,20:00:00,6,2,4,FMN GV 11 Ramsel
66,Bergstraat 71,2020-02-27,21:00:00,4,0,4,FMN GV 11 Ramsel
66,Bergstraat 71,2020-02-27,22:00:00,4,0,4,FMN GV 11 Ramsel
66,Bergstraat 71,2020-02-27,23:00:00,2,2,0,FMN GV 11 Ramsel
66,Bergstraat 71,2020-02-28,00:00:00,2,2,0,FMN GV 11 Ramsel
66,Bergstraat 71,2020-02-28,01:00:00,0,0,0,FMN GV 11 Ramsel
66,Bergstraat 71,2020-02-28,02:00:00,0,0,0,FMN GV 11 Ramsel
66,Bergstraat 71,2020-02-28,03:00:00,0,0,0,FMN GV 11 Ramsel
66,Bergstraat 71,2020-02-28,04:00:00,2,2,0,FMN GV 11 Ramsel
66,Bergstraat 71,2020-02-28,05:00:00,0,0,0,FMN GV 11 Ramsel
66,Bergstraat 71,2020-02-28,06:00:00,4,0,4,FMN GV 11 Ramsel
66,Bergstraat 71,2020-02-28,07:00:00,4,2,2,FMN GV 11 Ramsel
66,Bergstraat 71,2020-02-28,08:00:00,8,4,4,FMN GV 11 Ramsel
66,Bergstraat 71,2020-02-28,09:00:00,14,4,10,FMN GV 11 Ramsel
66,Bergstraat 71,2020-02-28,10:00:00,28,10,18,FMN GV 11 Ramsel
66,Bergstraat 71,2020-02-28,11:00:00,60,28,32,FMN GV 11 Ramsel
66,Bergstraat 71,2020-02-28,12:00:00,64,34,30,FMN GV 11 Ramsel
66,Bergstraat 71,2020-02-28,13:00:00,58,32,26,FMN GV 11 Ramsel
66,Bergstraat 71,2020-02-28,14:00:00,56,36,20,FMN GV 11 Ramsel
66,Bergstraat 71,2020-02-28,15:00:00,28,16,12,FMN GV 11 Ramsel
66,Bergstraat 71,2020-02-28,16:00:00,28,14,14,FMN GV 11 Ramsel
66,Bergstraat 71,2020-02-28,17:00:00,16,8,8,FMN GV 11 Ramsel
66,Bergstraat 71,2020-02-28,18:00:00,12,10,2,FMN GV 11 Ramsel
66,Bergstraat 71,2020-02-28,19:00:00,4,2,2,FMN GV 11 Ramsel
66,Bergstraat 71,2020-02-28,20:00:00,2,0,2,FMN GV 11 Ramsel
66,Bergstraat 71,2020-02-28,21:00:00,2,0,2,FMN GV 11 Ramsel
66,Bergstraat 71,2020-02-28,22:00:00,6,0,6,FMN GV 11 Ramsel
66,Bergstraat 71,2020-02-28,23:00:00,6,6,0,FMN GV 11 Ramsel
66,Bergstraat 71,2020-02-29,00:00:00,2,2,0,FMN GV 11 Ramsel
66,Bergstraat 71,2020-02-29,01:00:00,4,2,2,FMN GV 11 Ramsel
66,Bergstraat 71,2020-02-29,02:00:00,4,2,2,FMN GV 11 Ramsel
66,Bergstraat 71,2020-02-29,03:00:00,0,0,0,FMN GV 11 Ramsel
66,Bergstraat 71,2020-02-29,04:00:00,0,0,0,FMN GV 11 Ramsel
66,Bergstraat 71,2020-02-29,05:00:00,0,0,0,FMN GV 11 Ramsel
66,Bergstraat 71,2020-02-29,06:00:00,2,2,0,FMN GV 11 Ramsel
66,Bergstraat 71,2020-02-29,07:00:00,8,0,8,FMN GV 11 Ramsel
66,Bergstraat 71,2020-02-29,08:00:00,24,10,14,FMN GV 11 Ramsel
66,Bergstraat 71,2020-02-29,09:00:00,44,22,22,FMN GV 11 Ramsel
66,Bergstraat 71,2020-02-29,10:00:00,118,40,78,FMN GV 11 Ramsel
66,Bergstraat 71,2020-02-29,11:00:00,84,44,40,FMN GV 11 Ramsel
66,Bergstraat 71,2020-02-29,12:00:00,40,30,10,FMN GV 11 Ramsel
66,Bergstraat 71,2020-02-29,13:00:00,20,8,12,FMN GV 11 Ramsel
66,Bergstraat 71,2020-02-29,14:00:00,22,14,8,FMN GV 11 Ramsel
66,Bergstraat 71,2020-02-29,15:00:00,10,10,0,FMN GV 11 Ramsel
66,Bergstraat 71,2020-02-29,16:00:00,4,2,2,FMN GV 11 Ramsel
66,Bergstraat 71,2020-02-29,17:00:00,10,2,8,FMN GV 11 Ramsel
66,Bergstraat 71,2020-02-29,18:00:00,4,0,4,FMN GV 11 Ramsel
66,Bergstraat 71,2020-02-29,19:00:00,4,0,4,FMN GV 11 Ramsel
66,Bergstraat 71,2020-02-29,20:00:00,4,0,4,FMN GV 11 Ramsel
66,Bergstraat 71,2020-02-29,21:00:00,10,4,6,FMN GV 11 Ramsel
66,Bergstraat 71,2020-02-29,22:00:00,4,2,2,FMN GV 11 Ramsel
66,Bergstraat 71,2020-02-29,23:00:00,4,2,2,FMN GV 11 Ramsel
66,Bergstraat 71,2020-03-01,00:00:00,0,0,0,FMN GV 11 Ramsel
66,Bergstraat 71,2020-03-01,01:00:00,2,2,0,FMN GV 11 Ramsel
66,Bergstraat 71,2020-03-01,02:00:00,2,2,0,FMN GV 11 Ramsel
66,Bergstraat 71,2020-03-01,03:00:00,2,0,2,FMN GV 11 Ramsel
66,Bergstraat 71,2020-03-01,04:00:00,0,0,0,FMN GV 11 Ramsel
66,Bergstraat 71,2020-03-01,05:00:00,2,2,0,FMN GV 11 Ramsel
66,Bergstraat 71,2020-03-01,06:00:00,2,0,2,FMN GV 11 Ramsel
66,Bergstraat 71,2020-03-01,07:00:00,4,2,2,FMN GV 11 Ramsel
66,Bergstraat 71,2020-03-01,08:00:00,52,8,44,FMN GV 11 Ramsel
66,Bergstraat 71,2020-03-01,09:00:00,76,40,36,FMN GV 11 Ramsel
66,Bergstraat 71,2020-03-01,10:00:00,118,72,46,FMN GV 11 Ramsel
66,Bergstraat 71,2020-03-01,11:00:00,94,74,20,FMN GV 11 Ramsel
66,Bergstraat 71,2020-03-01,12:00:00,52,32,20,FMN GV 11 Ramsel
66,Bergstraat 71,2020-03-01,13:00:00,58,24,34,FMN GV 11 Ramsel
66,Bergstraat 71,2020-03-01,14:00:00,26,12,14,FMN GV 11 Ramsel
66,Bergstraat 71,2020-03-01,15:00:00,30,20,10,FMN GV 11 Ramsel
66,Bergstraat 71,2020-03-01,16:00:00,24,12,12,FMN GV 11 Ramsel
66,Bergstraat 71,2020-03-01,17:00:00,20,10,10,FMN GV 11 Ramsel
66,Bergstraat 71,2020-03-01,18:00:00,10,6,4,FMN GV 11 Ramsel
66,Bergstraat 71,2020-03-01,19:00:00,4,0,4,FMN GV 11 Ramsel
66,Bergstraat 71,2020-03-01,20:00:00,8,4,4,FMN GV 11 Ramsel
66,Bergstraat 71,2020-03-01,21:00:00,0,0,0,FMN GV 11 Ramsel
66,Bergstraat 71,2020-03-01,22:00:00,2,0,2,FMN GV 11 Ramsel
66,Bergstraat 71,2020-03-01,23:00:00,0,0,0,FMN GV 11 Ramsel
66,Bergstraat 71,2020-03-02,00:00:00,0,0,0,FMN GV 11 Ramsel
66,Bergstraat 71,2020-03-02,01:00:00,0,0,0,FMN GV 11 Ramsel
66,Bergstraat 71,2020-03-02,02:00:00,0,0,0,FMN GV 11 Ramsel
66,Bergstraat 71,2020-03-02,03:00:00,2,0,2,FMN GV 11 Ramsel
66,Bergstraat 71,2020-03-02,04:00:00,2,2,0,FMN GV 11 Ramsel
66,Bergstraat 71,2020-03-02,05:00:00,12,12,0,FMN GV 11 Ramsel
66,Bergstraat 71,2020-03-02,06:00:00,16,4,12,FMN GV 11 Ramsel
66,Bergstraat 71,2020-03-02,07:00:00,84,12,72,FMN GV 11 Ramsel
66,Bergstraat 71,2020-03-02,08:00:00,66,6,60,FMN GV 11 Ramsel
66,Bergstraat 71,2020-03-02,09:00:00,22,6,16,FMN GV 11 Ramsel
66,Bergstraat 71,2020-03-02,10:00:00,34,24,10,FMN GV 11 Ramsel
66,Bergstraat 71,2020-03-02,11:00:00,34,16,18,FMN GV 11 Ramsel
66,Bergstraat 71,2020-03-02,12:00:00,20,10,10,FMN GV 11 Ramsel
66,Bergstraat 71,2020-03-02,13:00:00,36,16,20,FMN GV 11 Ramsel
66,Bergstraat 71,2020-03-02,14:00:00,42,22,20,FMN GV 11 Ramsel
66,Bergstraat 71,2020-03-02,15:00:00,100,92,8,FMN GV 11 Ramsel
66,Bergstraat 71,2020-03-02,16:00:00,52,40,12,FMN GV 11 Ramsel
66,Bergstraat 71,2020-03-02,17:00:00,54,38,16,FMN GV 11 Ramsel
66,Bergstraat 71,2020-03-02,18:00:00,22,8,14,FMN GV 11 Ramsel
66,Bergstraat 71,2020-03-02,19:00:00,8,6,2,FMN GV 11 Ramsel
66,Bergstraat 71,2020-03-02,20:00:00,8,6,2,FMN GV 11 Ramsel
66,Bergstraat 71,2020-03-02,21:00:00,2,0,2,FMN GV 11 Ramsel
66,Bergstraat 71,2020-03-02,22:00:00,4,4,0,FMN GV 11 Ramsel
66,Bergstraat 71,2020-03-02,23:00:00,4,4,0,FMN GV 11 Ramsel
66,Bergstraat 71,2020-03-03,00:00:00,2,0,2,FMN GV 11 Ramsel
66,Bergstraat 71,2020-03-03,01:00:00,0,0,0,FMN GV 11 Ramsel
66,Bergstraat 71,2020-03-03,02:00:00,2,2,0,FMN GV 11 Ramsel
66,Bergstraat 71,2020-03-03,03:00:00,0,0,0,FMN GV 11 Ramsel
66,Bergstraat 71,2020-03-03,04:00:00,4,2,2,FMN GV 11 Ramsel
66,Bergstraat 71,2020-03-03,05:00:00,8,8,0,FMN GV 11 Ramsel
66,Bergstraat 71,2020-03-03,06:00:00,24,6,18,FMN GV 11 Ramsel
66,Bergstraat 71,2020-03-03,07:00:00,80,8,72,FMN GV 11 Ramsel
66,Bergstraat 71,2020-03-03,08:00:00,100,12,88,FMN GV 11 Ramsel
66,Bergstraat 71,2020-03-03,09:00:00,40,14,26,FMN GV 11 Ramsel
66,Bergstraat 71,2020-03-03,10:00:00,52,24,28,FMN GV 11 Ramsel
66,Bergstraat 71,2020-03-03,11:00:00,66,38,28,FMN GV 11 Ramsel
66,Bergstraat 71,2020-03-03,12:00:00,118,56,62,FMN GV 11 Ramsel
66,Bergstraat 71,2020-03-03,13:00:00,98,66,32,FMN GV 11 Ramsel
66,Bergstraat 71,2020-03-03,14:00:00,46,20,26,FMN GV 11 Ramsel
66,Bergstraat 71,2020-03-03,15:00:00,152,126,26,FMN GV 11 Ramsel
66,Bergstraat 71,2020-03-03,16:00:00,88,64,24,FMN GV 11 Ramsel
66,Bergstraat 71,2020-03-03,17:00:00,94,48,46,FMN GV 11 Ramsel
66,Bergstraat 71,2020-03-03,18:00:00,46,32,14,FMN GV 11 Ramsel
66,Bergstraat 71,2020-03-03,19:00:00,26,12,14,FMN GV 11 Ramsel
66,Bergstraat 71,2020-03-03,20:00:00,18,14,4,FMN GV 11 Ramsel
66,Bergstraat 71,2020-03-03,21:00:00,6,4,2,FMN GV 11 Ramsel
66,Bergstraat 71,2020-03-03,22:00:00,2,2,0,FMN GV 11 Ramsel
66,Bergstraat 71,2020-03-03,23:00:00,0,0,0,FMN GV 11 Ramsel
66,Bergstraat 71,2020-03-04,00:00:00,0,0,0,FMN GV 11 Ramsel
66,Bergstraat 71,2020-03-04,01:00:00,0,0,0,FMN GV 11 Ramsel
66,Bergstraat 71,2020-03-04,02:00:00,0,0,0,FMN GV 11 Ramsel
66,Bergstraat 71,2020-03-04,03:00:00,0,0,0,FMN GV 11 Ramsel
66,Bergstraat 71,2020-03-04,04:00:00,2,2,0,FMN GV 11 Ramsel
66,Bergstraat 71,2020-03-04,05:00:00,8,8,0,FMN GV 11 Ramsel
66,Bergstraat 71,2020-03-04,06:00:00,34,10,24,FMN GV 11 Ramsel
66,Bergstraat 71,2020-03-04,07:00:00,130,20,110,FMN GV 11 Ramsel
66,Bergstraat 71,2020-03-04,08:00:00,114,14,100,FMN GV 11 Ramsel
66,Bergstraat 71,2020-03-04,09:00:00,38,18,20,FMN GV 11 Ramsel
66,Bergstraat 71,2020-03-04,10:00:00,70,20,50,FMN GV 11 Ramsel
66,Bergstraat 71,2020-03-04,11:00:00,60,26,34,FMN GV 11 Ramsel
66,Bergstraat 71,2020-03-04,12:00:00,180,136,44,FMN GV 11 Ramsel
66,Bergstraat 71,2020-03-04,13:00:00,110,64,46,FMN GV 11 Ramsel
66,Bergstraat 71,2020-03-04,14:00:00,94,66,28,FMN GV 11 Ramsel
66,Bergstraat 71,2020-03-04,15:00:00,56,34,22,FMN GV 11 Ramsel
66,Bergstraat 71,2020-03-04,16:00:00,84,62,22,FMN GV 11 Ramsel
66,Bergstraat 71,2020-03-04,17:00:00,92,54,38,FMN GV 11 Ramsel
66,Bergstraat 71,2020-03-04,18:00:00,42,22,20,FMN GV 11 Ramsel
66,Bergstraat 71,2020-03-04,19:00:00,12,4,8,FMN GV 11 Ramsel
66,Bergstraat 71,2020-03-04,20:00:00,16,10,6,FMN GV 11 Ramsel
66,Bergstraat 71,2020-03-04,21:00:00,8,4,4,FMN GV 11 Ramsel
66,Bergstraat 71,2020-03-04,22:00:00,6,6,0,FMN GV 11 Ramsel
66,Bergstraat 71,2020-03-04,23:00:00,2,2,0,FMN GV 11 Ramsel
66,Bergstraat 71,2020-03-05,00:00:00,2,0,2,FMN GV 11 Ramsel
66,Bergstraat 71,2020-03-05,01:00:00,0,0,0,FMN GV 11 Ramsel
66,Bergstraat 71,2020-03-05,02:00:00,0,0,0,FMN GV 11 Ramsel
66,Bergstraat 71,2020-03-05,03:00:00,0,0,0,FMN GV 11 Ramsel
66,Bergstraat 71,2020-03-05,04:00:00,2,2,0,FMN GV 11 Ramsel
66,Bergstraat 71,2020-03-05,05:00:00,10,8,2,FMN GV 11 Ramsel
66,Bergstraat 71,2020-03-05,06:00:00,18,2,16,FMN GV 11 Ramsel
66,Bergstraat 71,2020-03-05,07:00:00,90,10,80,FMN GV 11 Ramsel
66,Bergstraat 71,2020-03-05,08:00:00,74,12,62,FMN GV 11 Ramsel
66,Bergstraat 71,2020-03-05,09:00:00,18,4,14,FMN GV 11 Ramsel
66,Bergstraat 71,2020-03-05,10:00:00,10,4,6,FMN GV 11 Ramsel
66,Bergstraat 71,2020-03-05,11:00:00,18,12,6,FMN GV 11 Ramsel
66,Bergstraat 71,2020-03-05,12:00:00,4,0,4,FMN GV 11 Ramsel
66,Bergstraat 71,2020-03-05,13:00:00,4,4,0,FMN GV 11 Ramsel
66,Bergstraat 71,2020-03-05,14:00:00,14,10,4,FMN GV 11 Ramsel
66,Bergstraat 71,2020-03-05,15:00:00,74,64,10,FMN GV 11 Ramsel
66,Bergstraat 71,2020-03-05,16:00:00,54,42,12,FMN GV 11 Ramsel
66,Bergstraat 71,2020-03-05,17:00:00,26,20,6,FMN GV 11 Ramsel
66,Bergstraat 71,2020-03-05,18:00:00,20,16,4,FMN GV 11 Ramsel
66,Bergstraat 71,2020-03-05,19:00:00,2,2,0,FMN GV 11 Ramsel
66,Bergstraat 71,2020-03-05,20:00:00,6,2,4,FMN GV 11 Ramsel
66,Bergstraat 71,2020-03-05,21:00:00,4,2,2,FMN GV 11 Ramsel
66,Bergstraat 71,2020-03-05,22:00:00,0,0,0,FMN GV 11 Ramsel
66,Bergstraat 71,2020-03-05,23:00:00,2,0,2,FMN GV 11 Ramsel
66,Bergstraat 71,2020-03-06,00:00:00,0,0,0,FMN GV 11 Ramsel
66,Bergstraat 71,2020-03-06,01:00:00,0,0,0,FMN GV 11 Ramsel
66,Bergstraat 71,2020-03-06,02:00:00,0,0,0,FMN GV 11 Ramsel
66,Bergstraat 71,2020-03-06,03:00:00,0,0,0,FMN GV 11 Ramsel
66,Bergstraat 71,2020-03-06,04:00:00,2,2,0,FMN GV 11 Ramsel
66,Bergstraat 71,2020-03-06,05:00:00,6,6,0,FMN GV 11 Ramsel
66,Bergstraat 71,2020-03-06,06:00:00,8,2,6,FMN GV 11 Ramsel
66,Bergstraat 71,2020-03-06,07:00:00,56,10,46,FMN GV 11 Ramsel
66,Bergstraat 71,2020-03-06,08:00:00,58,4,54,FMN GV 11 Ramsel
66,Bergstraat 71,2020-03-06,09:00:00,22,2,20,FMN GV 11 Ramsel
66,Bergstraat 71,2020-03-06,10:00:00,32,18,14,FMN GV 11 Ramsel
66,Bergstraat 71,2020-03-06,11:00:00,24,14,10,FMN GV 11 Ramsel
66,Bergstraat 71,2020-03-06,12:00:00,46,16,30,FMN GV 11 Ramsel
66,Bergstraat 71,2020-03-06,13:00:00,44,26,18,FMN GV 11 Ramsel
66,Bergstraat 71,2020-03-06,14:00:00,44,32,12,FMN GV 11 Ramsel
66,Bergstraat 71,2020-03-06,15:00:00,88,72,16,FMN GV 11 Ramsel
66,Bergstraat 71,2020-03-06,16:00:00,48,30,18,FMN GV 11 Ramsel
66,Bergstraat 71,2020-03-06,17:00:00,64,42,22,FMN GV 11 Ramsel
66,Bergstraat 71,2020-03-06,18:00:00,16,12,4,FMN GV 11 Ramsel
66,Bergstraat 71,2020-03-06,19:00:00,10,2,8,FMN GV 11 Ramsel
66,Bergstraat 71,2020-03-06,20:00:00,12,6,6,FMN GV 11 Ramsel
66,Bergstraat 71,2020-03-06,21:00:00,8,4,4,FMN GV 11 Ramsel
66,Bergstraat 71,2020-03-06,22:00:00,12,2,10,FMN GV 11 Ramsel
66,Bergstraat 71,2020-03-06,23:00:00,4,0,4,FMN GV 11 Ramsel
66,Bergstraat 71,2020-03-07,00:00:00,4,4,0,FMN GV 11 Ramsel
66,Bergstraat 71,2020-03-07,01:00:00,4,4,0,FMN GV 11 Ramsel
66,Bergstraat 71,2020-03-07,02:00:00,4,4,0,FMN GV 11 Ramsel
66,Bergstraat 71,2020-03-07,03:00:00,2,2,0,FMN GV 11 Ramsel
66,Bergstraat 71,2020-03-07,04:00:00,2,2,0,FMN GV 11 Ramsel
66,Bergstraat 71,2020-03-07,05:00:00,6,4,2,FMN GV 11 Ramsel
66,Bergstraat 71,2020-03-07,06:00:00,6,4,2,FMN GV 11 Ramsel
66,Bergstraat 71,2020-03-07,07:00:00,14,2,12,FMN GV 11 Ramsel
66,Bergstraat 71,2020-03-07,08:00:00,36,6,30,FMN GV 11 Ramsel
66,Bergstraat 71,2020-03-07,09:00:00,46,14,32,FMN GV 11 Ramsel
66,Bergstraat 71,2020-03-07,10:00:00,86,48,38,FMN GV 11 Ramsel
66,Bergstraat 71,2020-03-07,11:00:00,126,72,54,FMN GV 11 Ramsel
66,Bergstraat 71,2020-03-07,12:00:00,148,78,70,FMN GV 11 Ramsel
66,Bergstraat 71,2020-03-07,13:00:00,248,112,136,FMN GV 11 Ramsel
66,Bergstraat 71,2020-03-07,14:00:00,200,126,74,FMN GV 11 Ramsel
66,Bergstraat 71,2020-03-07,15:00:00,184,132,52,FMN GV 11 Ramsel
66,Bergstraat 71,2020-03-07,16:00:00,140,78,62,FMN GV 11 Ramsel
66,Bergstraat 71,2020-03-07,17:00:00,86,62,24,FMN GV 11 Ramsel
66,Bergstraat 71,2020-03-07,18:00:00,8,2,6,FMN GV 11 Ramsel
66,Bergstraat 71,2020-03-07,19:00:00,6,0,6,FMN GV 11 Ramsel
66,Bergstraat 71,2020-03-07,20:00:00,8,2,6,FMN GV 11 Ramsel
66,Bergstraat 71,2020-03-07,21:00:00,14,10,4,FMN GV 11 Ramsel
66,Bergstraat 71,2020-03-07,22:00:00,4,4,0,FMN GV 11 Ramsel
66,Bergstraat 71,2020-03-07,23:00:00,16,16,0,FMN GV 11 Ramsel
66,Bergstraat 71,2020-03-08,00:00:00,2,2,0,FMN GV 11 Ramsel
66,Bergstraat 71,2020-03-08,01:00:00,4,0,4,FMN GV 11 Ramsel
66,Bergstraat 71,2020-03-08,02:00:00,2,0,2,FMN GV 11 Ramsel
66,Bergstraat 71,2020-03-08,03:00:00,0,0,0,FMN GV 11 Ramsel
66,Bergstraat 71,2020-03-08,04:00:00,0,0,0,FMN GV 11 Ramsel
66,Bergstraat 71,2020-03-08,05:00:00,0,0,0,FMN GV 11 Ramsel
66,Bergstraat 71,2020-03-08,06:00:00,4,2,2,FMN GV 11 Ramsel
66,Bergstraat 71,2020-03-08,07:00:00,14,4,10,FMN GV 11 Ramsel
66,Bergstraat 71,2020-03-08,08:00:00,48,16,32,FMN GV 11 Ramsel
66,Bergstraat 71,2020-03-08,09:00:00,70,28,42,FMN GV 11 Ramsel
66,Bergstraat 71,2020-03-08,10:00:00,118,68,50,FMN GV 11 Ramsel
66,Bergstraat 71,2020-03-08,11:00:00,96,80,16,FMN GV 11 Ramsel
66,Bergstraat 71,2020-03-08,12:00:00,26,14,12,FMN GV 11 Ramsel
66,Bergstraat 71,2020-03-08,13:00:00,26,20,6,FMN GV 11 Ramsel
66,Bergstraat 71,2020-03-08,14:00:00,26,14,12,FMN GV 11 Ramsel
66,Bergstraat 71,2020-03-08,15:00:00,6,4,2,FMN GV 11 Ramsel
66,Bergstraat 71,2020-03-08,16:00:00,6,6,0,FMN GV 11 Ramsel
66,Bergstraat 71,2020-03-08,17:00:00,0,0,0,FMN GV 11 Ramsel
66,Bergstraat 71,2020-03-08,18:00:00,6,2,4,FMN GV 11 Ramsel
66,Bergstraat 71,2020-03-08,19:00:00,6,2,4,FMN GV 11 Ramsel
66,Bergstraat 71,2020-03-08,20:00:00,8,0,8,FMN GV 11 Ramsel
66,Bergstraat 71,2020-03-08,21:00:00,4,4,0,FMN GV 11 Ramsel
66,Bergstraat 71,2020-03-08,22:00:00,2,2,0,FMN GV 11 Ramsel
66,Bergstraat 71,2020-03-08,23:00:00,2,0,2,FMN GV 11 Ramsel
66,Bergstraat 71,2020-03-09,00:00:00,0,0,0,FMN GV 11 Ramsel
66,Bergstraat 71,2020-03-09,01:00:00,0,0,0,FMN GV 11 Ramsel
66,Bergstraat 71,2020-03-09,02:00:00,8,4,4,FMN GV 11 Ramsel
66,Bergstraat 71,2020-03-09,03:00:00,0,0,0,FMN GV 11 Ramsel
66,Bergstraat 71,2020-03-09,04:00:00,2,2,0,FMN GV 11 Ramsel
66,Bergstraat 71,2020-03-09,05:00:00,6,6,0,FMN GV 11 Ramsel
66,Bergstraat 71,2020-03-09,06:00:00,28,8,20,FMN GV 11 Ramsel
66,Bergstraat 71,2020-03-09,07:00:00,118,18,100,FMN GV 11 Ramsel
66,Bergstraat 71,2020-03-09,08:00:00,98,16,82,FMN GV 11 Ramsel
66,Bergstraat 71,2020-03-09,09:00:00,54,22,32,FMN GV 11 Ramsel
66,Bergstraat 71,2020-03-09,10:00:00,54,26,28,FMN GV 11 Ramsel
66,Bergstraat 71,2020-03-09,11:00:00,56,28,28,FMN GV 11 Ramsel
66,Bergstraat 71,2020-03-09,12:00:00,40,20,20,FMN GV 11 Ramsel
66,Bergstraat 71,2020-03-09,13:00:00,70,36,34,FMN GV 11 Ramsel
66,Bergstraat 71,2020-03-09,14:00:00,70,40,30,FMN GV 11 Ramsel
66,Bergstraat 71,2020-03-09,15:00:00,124,98,26,FMN GV 11 Ramsel
66,Bergstraat 71,2020-03-09,16:00:00,110,88,22,FMN GV 11 Ramsel
66,Bergstraat 71,2020-03-09,17:00:00,72,50,22,FMN GV 11 Ramsel
66,Bergstraat 71,2020-03-09,18:00:00,34,16,18,FMN GV 11 Ramsel
66,Bergstraat 71,2020-03-09,19:00:00,20,12,8,FMN GV 11 Ramsel
66,Bergstraat 71,2020-03-09,20:00:00,8,6,2,FMN GV 11 Ramsel
66,Bergstraat 71,2020-03-09,21:00:00,8,6,2,FMN GV 11 Ramsel
66,Bergstraat 71,2020-03-09,22:00:00,8,2,6,FMN GV 11 Ramsel
66,Bergstraat 71,2020-03-09,23:00:00,4,4,0,FMN GV 11 Ramsel
66,Bergstraat 71,2020-03-10,00:00:00,4,0,4,FMN GV 11 Ramsel
66,Bergstraat 71,2020-03-10,01:00:00,2,0,2,FMN GV 11 Ramsel
66,Bergstraat 71,2020-03-10,02:00:00,0,0,0,FMN GV 11 Ramsel
66,Bergstraat 71,2020-03-10,03:00:00,0,0,0,FMN GV 11 Ramsel
66,Bergstraat 71,2020-03-10,04:00:00,2,2,0,FMN GV 11 Ramsel
66,Bergstraat 71,2020-03-10,05:00:00,6,4,2,FMN GV 11 Ramsel
66,Bergstraat 71,2020-03-10,06:00:00,14,4,10,FMN GV 11 Ramsel
66,Bergstraat 71,2020-03-10,07:00:00,70,10,60,FMN GV 11 Ramsel
66,Bergstraat 71,2020-03-10,08:00:00,68,6,62,FMN GV 11 Ramsel
66,Bergstraat 71,2020-03-10,09:00:00,6,0,6,FMN GV 11 Ramsel
66,Bergstraat 71,2020-03-10,10:00:00,2,2,0,FMN GV 11 Ramsel
66,Bergstraat 71,2020-03-10,11:00:00,6,4,2,FMN GV 11 Ramsel
66,Bergstraat 71,2020-03-10,12:00:00,22,18,4,FMN GV 11 Ramsel
66,Bergstraat 71,2020-03-10,13:00:00,26,16,10,FMN GV 11 Ramsel
66,Bergstraat 71,2020-03-10,14:00:00,28,14,14,FMN GV 11 Ramsel
66,Bergstraat 71,2020-03-10,15:00:00,72,58,14,FMN GV 11 Ramsel
66,Bergstraat 71,2020-03-10,16:00:00,54,38,16,FMN GV 11 Ramsel
66,Bergstraat 71,2020-03-10,17:00:00,50,24,26,FMN GV 11 Ramsel
66,Bergstraat 71,2020-03-10,18:00:00,30,22,8,FMN GV 11 Ramsel
66,Bergstraat 71,2020-03-10,19:00:00,22,4,18,FMN GV 11 Ramsel
66,Bergstraat 71,2020-03-10,20:00:00,16,16,0,FMN GV 11 Ramsel
66,Bergstraat 71,2020-03-10,21:00:00,4,4,0,FMN GV 11 Ramsel
66,Bergstraat 71,2020-03-10,22:00:00,10,0,10,FMN GV 11 Ramsel
66,Bergstraat 71,2020-03-10,23:00:00,0,0,0,FMN GV 11 Ramsel
66,Bergstraat 71,2020-03-11,00:00:00,0,0,0,FMN GV 11 Ramsel
66,Bergstraat 71,2020-03-11,01:00:00,0,0,0,FMN GV 11 Ramsel
66,Bergstraat 71,2020-03-11,02:00:00,2,0,2,FMN GV 11 Ramsel
66,Bergstraat 71,2020-03-11,03:00:00,0,0,0,FMN GV 11 Ramsel
66,Bergstraat 71,2020-03-11,04:00:00,4,4,0,FMN GV 11 Ramsel
66,Bergstraat 71,2020-03-11,05:00:00,2,2,0,FMN GV 11 Ramsel
66,Bergstraat 71,2020-03-11,06:00:00,12,6,6,FMN GV 11 Ramsel
66,Bergstraat 71,2020-03-11,07:00:00,62,6,56,FMN GV 11 Ramsel
66,Bergstraat 71,2020-03-11,08:00:00,72,10,62,FMN GV 11 Ramsel
66,Bergstraat 71,2020-03-11,09:00:00,2,0,2,FMN GV 11 Ramsel
66,Bergstraat 71,2020-03-11,10:00:00,4,0,4,FMN GV 11 Ramsel
66,Bergstraat 71,2020-03-11,11:00:00,8,0,8,FMN GV 11 Ramsel
66,Bergstraat 71,2020-03-11,12:00:00,80,74,6,FMN GV 11 Ramsel
66,Bergstraat 71,2020-03-11,13:00:00,54,40,14,FMN GV 11 Ramsel
66,Bergstraat 71,2020-03-11,14:00:00,58,26,32,FMN GV 11 Ramsel
66,Bergstraat 71,2020-03-11,15:00:00,64,28,36,FMN GV 11 Ramsel
66,Bergstraat 71,2020-03-11,16:00:00,38,22,16,FMN GV 11 Ramsel
66,Bergstraat 71,2020-03-11,17:00:00,62,42,20,FMN GV 11 Ramsel
66,Bergstraat 71,2020-03-11,18:00:00,42,22,20,FMN GV 11 Ramsel
66,Bergstraat 71,2020-03-11,19:00:00,16,12,4,FMN GV 11 Ramsel
66,Bergstraat 71,2020-03-11,20:00:00,6,4,2,FMN GV 11 Ramsel
66,Bergstraat 71,2020-03-11,21:00:00,2,2,0,FMN GV 11 Ramsel
66,Bergstraat 71,2020-03-11,22:00:00,10,2,8,FMN GV 11 Ramsel
66,Bergstraat 71,2020-03-11,23:00:00,0,0,0,FMN GV 11 Ramsel
66,Bergstraat 71,2020-03-12,00:00:00,0,0,0,FMN GV 11 Ramsel
66,Bergstraat 71,2020-03-12,01:00:00,0,0,0,FMN GV 11 Ramsel
66,Bergstraat 71,2020-03-12,02:00:00,0,0,0,FMN GV 11 Ramsel
66,Bergstraat 71,2020-03-12,03:00:00,0,0,0,FMN GV 11 Ramsel
66,Bergstraat 71,2020-03-12,04:00:00,2,2,0,FMN GV 11 Ramsel
66,Bergstraat 71,2020-03-12,05:00:00,6,4,2,FMN GV 11 Ramsel
66,Bergstraat 71,2020-03-12,06:00:00,22,6,16,FMN GV 11 Ramsel
66,Bergstraat 71,2020-03-12,07:00:00,106,6,100,FMN GV 11 Ramsel
66,Bergstraat 71,2020-03-12,08:00:00,88,8,80,FMN GV 11 Ramsel
66,Bergstraat 71,2020-03-12,09:00:00,36,18,18,FMN GV 11 Ramsel
66,Bergstraat 71,2020-03-12,10:00:00,48,30,18,FMN GV 11 Ramsel
66,Bergstraat 71,2020-03-12,11:00:00,66,36,30,FMN GV 11 Ramsel
66,Bergstraat 71,2020-03-12,12:00:00,66,38,28,FMN GV 11 Ramsel
66,Bergstraat 71,2020-03-12,13:00:00,134,62,72,FMN GV 11 Ramsel
66,Bergstraat 71,2020-03-12,14:00:00,92,52,40,FMN GV 11 Ramsel
66,Bergstraat 71,2020-03-12,15:00:00,204,158,46,FMN GV 11 Ramsel
66,Bergstraat 71,2020-03-12,16:00:00,80,64,16,FMN GV 11 Ramsel
66,Bergstraat 71,2020-03-12,17:00:00,56,32,24,FMN GV 11 Ramsel
66,Bergstraat 71,2020-03-12,18:00:00,44,28,16,FMN GV 11 Ramsel
66,Bergstraat 71,2020-03-12,19:00:00,14,12,2,FMN GV 11 Ramsel
66,Bergstraat 71,2020-03-12,20:00:00,12,8,4,FMN GV 11 Ramsel
66,Bergstraat 71,2020-03-12,21:00:00,4,2,2,FMN GV 11 Ramsel
66,Bergstraat 71,2020-03-12,22:00:00,6,0,6,FMN GV 11 Ramsel
66,Bergstraat 71,2020-03-12,23:00:00,0,0,0,FMN GV 11 Ramsel
66,Bergstraat 71,2020-03-13,00:00:00,4,2,2,FMN GV 11 Ramsel
66,Bergstraat 71,2020-03-13,01:00:00,0,0,0,FMN GV 11 Ramsel
66,Bergstraat 71,2020-03-13,02:00:00,0,0,0,FMN GV 11 Ramsel
66,Bergstraat 71,2020-03-13,03:00:00,0,0,0,FMN GV 11 Ramsel
66,Bergstraat 71,2020-03-13,04:00:00,2,2,0,FMN GV 11 Ramsel
66,Bergstraat 71,2020-03-13,05:00:00,4,4,0,FMN GV 11 Ramsel
66,Bergstraat 71,2020-03-13,06:00:00,14,8,6,FMN GV 11 Ramsel
66,Bergstraat 71,2020-03-13,07:00:00,90,16,74,FMN GV 11 Ramsel
66,Bergstraat 71,2020-03-13,08:00:00,124,22,102,FMN GV 11 Ramsel
66,Bergstraat 71,2020-03-13,09:00:00,16,8,8,FMN GV 11 Ramsel
66,Bergstraat 71,2020-03-13,10:00:00,26,8,18,FMN GV 11 Ramsel
66,Bergstraat 71,2020-03-13,11:00:00,30,24,6,FMN GV 11 Ramsel
66,Bergstraat 71,2020-03-13,12:00:00,36,20,16,FMN GV 11 Ramsel
66,Bergstraat 71,2020-03-13,13:00:00,42,20,22,FMN GV 11 Ramsel
66,Bergstraat 71,2020-03-13,14:00:00,52,30,22,FMN GV 11 Ramsel
66,Bergstraat 71,2020-03-13,15:00:00,138,110,28,FMN GV 11 Ramsel
66,Bergstraat 71,2020-03-13,16:00:00,94,76,18,FMN GV 11 Ramsel
66,Bergstraat 71,2020-03-13,17:00:00,34,22,12,FMN GV 11 Ramsel
66,Bergstraat 71,2020-03-13,18:00:00,34,18,16,FMN GV 11 Ramsel
66,Bergstraat 71,2020-03-13,19:00:00,12,10,2,FMN GV 11 Ramsel
66,Bergstraat 71,2020-03-13,20:00:00,8,4,4,FMN GV 11 Ramsel
66,Bergstraat 71,2020-03-13,21:00:00,12,6,6,FMN GV 11 Ramsel
66,Bergstraat 71,2020-03-13,22:00:00,2,2,0,FMN GV 11 Ramsel
66,Bergstraat 71,2020-03-13,23:00:00,4,4,0,FMN GV 11 Ramsel
66,Bergstraat 71,2020-03-14,00:00:00,2,0,2,FMN GV 11 Ramsel
66,Bergstraat 71,2020-03-14,01:00:00,4,0,4,FMN GV 11 Ramsel
66,Bergstraat 71,2020-03-14,02:00:00,2,0,2,FMN GV 11 Ramsel
66,Bergstraat 71,2020-03-14,03:00:00,0,0,0,FMN GV 11 Ramsel
66,Bergstraat 71,2020-03-14,04:00:00,0,0,0,FMN GV 11 Ramsel
66,Bergstraat 71,2020-03-14,05:00:00,2,2,0,FMN GV 11 Ramsel
66,Bergstraat 71,2020-03-14,06:00:00,4,0,4,FMN GV 11 Ramsel
66,Bergstraat 71,2020-03-14,07:00:00,14,8,6,FMN GV 11 Ramsel
66,Bergstraat 71,2020-03-14,08:00:00,48,8,40,FMN GV 11 Ramsel
66,Bergstraat 71,2020-03-14,09:00:00,70,26,44,FMN GV 11 Ramsel
66,Bergstraat 71,2020-03-14,10:00:00,134,72,62,FMN GV 11 Ramsel
66,Bergstraat 71,2020-03-14,11:00:00,144,68,76,FMN GV 11 Ramsel
66,Bergstraat 71,2020-03-14,12:00:00,148,86,62,FMN GV 11 Ramsel
66,Bergstraat 71,2020-03-14,13:00:00,188,72,116,FMN GV 11 Ramsel
66,Bergstraat 71,2020-03-14,14:00:00,202,62,140,FMN GV 11 Ramsel
66,Bergstraat 71,2020-03-14,15:00:00,194,106,88,FMN GV 11 Ramsel
66,Bergstraat 71,2020-03-14,16:00:00,110,66,44,FMN GV 11 Ramsel
66,Bergstraat 71,2020-03-14,17:00:00,36,14,22,FMN GV 11 Ramsel
66,Bergstraat 71,2020-03-14,18:00:00,20,10,10,FMN GV 11 Ramsel
66,Bergstraat 71,2020-03-14,19:00:00,2,0,2,FMN GV 11 Ramsel
66,Bergstraat 71,2020-03-14,20:00:00,8,2,6,FMN GV 11 Ramsel
66,Bergstraat 71,2020-03-14,21:00:00,0,0,0,FMN GV 11 Ramsel
66,Bergstraat 71,2020-03-14,22:00:00,12,10,2,FMN GV 11 Ramsel
66,Bergstraat 71,2020-03-14,23:00:00,2,2,0,FMN GV 11 Ramsel
66,Bergstraat 71,2020-03-15,00:00:00,0,0,0,FMN GV 11 Ramsel
66,Bergstraat 71,2020-03-15,01:00:00,0,0,0,FMN GV 11 Ramsel
66,Bergstraat 71,2020-03-15,02:00:00,0,0,0,FMN GV 11 Ramsel
66,Bergstraat 71,2020-03-15,03:00:00,6,4,2,FMN GV 11 Ramsel
66,Bergstraat 71,2020-03-15,04:00:00,0,0,0,FMN GV 11 Ramsel
66,Bergstraat 71,2020-03-15,05:00:00,0,0,0,FMN GV 11 Ramsel
66,Bergstraat 71,2020-03-15,06:00:00,0,0,0,FMN GV 11 Ramsel
66,Bergstraat 71,2020-03-15,07:00:00,22,8,14,FMN GV 11 Ramsel
66,Bergstraat 71,2020-03-15,08:00:00,56,18,38,FMN GV 11 Ramsel
66,Bergstraat 71,2020-03-15,09:00:00,204,38,166,FMN GV 11 Ramsel
66,Bergstraat 71,2020-03-15,10:00:00,258,102,156,FMN GV 11 Ramsel
66,Bergstraat 71,2020-03-15,11:00:00,234,160,74,FMN GV 11 Ramsel
66,Bergstraat 71,2020-03-15,12:00:00,112,66,46,FMN GV 11 Ramsel
66,Bergstraat 71,2020-03-15,13:00:00,126,70,56,FMN GV 11 Ramsel
66,Bergstraat 71,2020-03-15,14:00:00,200,84,116,FMN GV 11 Ramsel
66,Bergstraat 71,2020-03-15,15:00:00,118,70,48,FMN GV 11 Ramsel
66,Bergstraat 71,2020-03-15,16:00:00,120,64,56,FMN GV 11 Ramsel
66,Bergstraat 71,2020-03-15,17:00:00,78,42,36,FMN GV 11 Ramsel
66,Bergstraat 71,2020-03-15,18:00:00,28,14,14,FMN GV 11 Ramsel
66,Bergstraat 71,2020-03-15,19:00:00,14,6,8,FMN GV 11 Ramsel
66,Bergstraat 71,2020-03-15,20:00:00,18,10,8,FMN GV 11 Ramsel
66,Bergstraat 71,2020-03-15,21:00:00,2,0,2,FMN GV 11 Ramsel
66,Bergstraat 71,2020-03-15,22:00:00,0,0,0,FMN GV 11 Ramsel
66,Bergstraat 71,2020-03-15,23:00:00,0,0,0,FMN GV 11 Ramsel
66,Bergstraat 71,2020-03-16,00:00:00,4,0,4,FMN GV 11 Ramsel
66,Bergstraat 71,2020-03-16,01:00:00,0,0,0,FMN GV 11 Ramsel
66,Bergstraat 71,2020-03-16,02:00:00,0,0,0,FMN GV 11 Ramsel
66,Bergstraat 71,2020-03-16,03:00:00,0,0,0,FMN GV 11 Ramsel
66,Bergstraat 71,2020-03-16,04:00:00,2,2,0,FMN GV 11 Ramsel
66,Bergstraat 71,2020-03-16,05:00:00,6,4,2,FMN GV 11 Ramsel
66,Bergstraat 71,2020-03-16,06:00:00,36,8,28,FMN GV 11 Ramsel
66,Bergstraat 71,2020-03-16,07:00:00,56,22,34,FMN GV 11 Ramsel
66,Bergstraat 71,2020-03-16,08:00:00,32,6,26,FMN GV 11 Ramsel
66,Bergstraat 71,2020-03-16,09:00:00,56,18,38,FMN GV 11 Ramsel
66,Bergstraat 71,2020-03-16,10:00:00,38,18,20,FMN GV 11 Ramsel
66,Bergstraat 71,2020-03-16,11:00:00,82,34,48,FMN GV 11 Ramsel
66,Bergstraat 71,2020-03-16,12:00:00,64,38,26,FMN GV 11 Ramsel
66,Bergstraat 71,2020-03-16,13:00:00,128,70,58,FMN GV 11 Ramsel
66,Bergstraat 71,2020-03-16,14:00:00,190,70,120,FMN GV 11 Ramsel
66,Bergstraat 71,2020-03-16,15:00:00,166,106,60,FMN GV 11 Ramsel
66,Bergstraat 71,2020-03-16,16:00:00,120,70,50,FMN GV 11 Ramsel
66,Bergstraat 71,2020-03-16,17:00:00,102,64,38,FMN GV 11 Ramsel
66,Bergstraat 71,2020-03-16,18:00:00,34,20,14,FMN GV 11 Ramsel
66,Bergstraat 71,2020-03-16,19:00:00,20,8,12,FMN GV 11 Ramsel
66,Bergstraat 71,2020-03-16,20:00:00,10,6,4,FMN GV 11 Ramsel
66,Bergstraat 71,2020-03-16,21:00:00,0,0,0,FMN GV 11 Ramsel
66,Bergstraat 71,2020-03-16,22:00:00,2,2,0,FMN GV 11 Ramsel
66,Bergstraat 71,2020-03-16,23:00:00,0,0,0,FMN GV 11 Ramsel
66,Bergstraat 71,2020-03-17,00:00:00,2,0,2,FMN GV 11 Ramsel
66,Bergstraat 71,2020-03-17,01:00:00,0,0,0,FMN GV 11 Ramsel
66,Bergstraat 71,2020-03-17,02:00:00,0,0,0,FMN GV 11 Ramsel
66,Bergstraat 71,2020-03-17,03:00:00,0,0,0,FMN GV 11 Ramsel
66,Bergstraat 71,2020-03-17,04:00:00,4,2,2,FMN GV 11 Ramsel
66,Bergstraat 71,2020-03-17,05:00:00,16,12,4,FMN GV 11 Ramsel
66,Bergstraat 71,2020-03-17,06:00:00,36,14,22,FMN GV 11 Ramsel
66,Bergstraat 71,2020-03-17,07:00:00,32,14,18,FMN GV 11 Ramsel
66,Bergstraat 71,2020-03-17,08:00:00,46,18,28,FMN GV 11 Ramsel
66,Bergstraat 71,2020-03-17,09:00:00,46,24,22,FMN GV 11 Ramsel
66,Bergstraat 71,2020-03-17,10:00:00,66,26,40,FMN GV 11 Ramsel
66,Bergstraat 71,2020-03-17,11:00:00,70,28,42,FMN GV 11 Ramsel
66,Bergstraat 71,2020-03-17,12:00:00,98,38,60,FMN GV 11 Ramsel
66,Bergstraat 71,2020-03-17,13:00:00,198,70,128,FMN GV 11 Ramsel
66,Bergstraat 71,2020-03-17,14:00:00,260,140,120,FMN GV 11 Ramsel
66,Bergstraat 71,2020-03-17,15:00:00,200,132,68,FMN GV 11 Ramsel
66,Bergstraat 71,2020-03-17,16:00:00,226,114,112,FMN GV 11 Ramsel
66,Bergstraat 71,2020-03-17,17:00:00,122,60,62,FMN GV 11 Ramsel
66,Bergstraat 71,2020-03-17,18:00:00,62,42,20,FMN GV 11 Ramsel
66,Bergstraat 71,2020-03-17,19:00:00,38,18,20,FMN GV 11 Ramsel
66,Bergstraat 71,2020-03-17,20:00:00,16,12,4,FMN GV 11 Ramsel
66,Bergstraat 71,2020-03-17,21:00:00,8,8,0,FMN GV 11 Ramsel
66,Bergstraat 71,2020-03-17,22:00:00,0,0,0,FMN GV 11 Ramsel
66,Bergstraat 71,2020-03-17,23:00:00,0,0,0,FMN GV 11 Ramsel
66,Bergstraat 71,2020-03-18,00:00:00,0,0,0,FMN GV 11 Ramsel
66,Bergstraat 71,2020-03-18,01:00:00,0,0,0,FMN GV 11 Ramsel
66,Bergstraat 71,2020-03-18,02:00:00,0,0,0,FMN GV 11 Ramsel
66,Bergstraat 71,2020-03-18,03:00:00,2,0,2,FMN GV 11 Ramsel
66,Bergstraat 71,2020-03-18,04:00:00,4,2,2,FMN GV 11 Ramsel
66,Bergstraat 71,2020-03-18,05:00:00,8,4,4,FMN GV 11 Ramsel
66,Bergstraat 71,2020-03-18,06:00:00,30,10,20,FMN GV 11 Ramsel
66,Bergstraat 71,2020-03-18,07:00:00,36,10,26,FMN GV 11 Ramsel
66,Bergstraat 71,2020-03-18,08:00:00,20,8,12,FMN GV 11 Ramsel
66,Bergstraat 71,2020-03-18,09:00:00,56,20,36,FMN GV 11 Ramsel
66,Bergstraat 71,2020-03-18,10:00:00,78,32,46,FMN GV 11 Ramsel
66,Bergstraat 71,2020-03-18,11:00:00,90,40,50,FMN GV 11 Ramsel
66,Bergstraat 71,2020-03-18,12:00:00,116,64,52,FMN GV 11 Ramsel
66,Bergstraat 71,2020-03-18,13:00:00,210,112,98,FMN GV 11 Ramsel
66,Bergstraat 71,2020-03-18,14:00:00,340,180,160,FMN GV 11 Ramsel
66,Bergstraat 71,2020-03-18,15:00:00,218,94,124,FMN GV 11 Ramsel
66,Bergstraat 71,2020-03-18,16:00:00,248,142,106,FMN GV 11 Ramsel
66,Bergstraat 71,2020-03-18,17:00:00,198,100,98,FMN GV 11 Ramsel
66,Bergstraat 71,2020-03-18,18:00:00,96,56,40,FMN GV 11 Ramsel
66,Bergstraat 71,2020-03-18,19:00:00,22,12,10,FMN GV 11 Ramsel
66,Bergstraat 71,2020-03-18,20:00:00,18,8,10,FMN GV 11 Ramsel
66,Bergstraat 71,2020-03-18,21:00:00,2,2,0,FMN GV 11 Ramsel
66,Bergstraat 71,2020-03-18,22:00:00,10,8,2,FMN GV 11 Ramsel
66,Bergstraat 71,2020-03-18,23:00:00,2,2,0,FMN GV 11 Ramsel
66,Bergstraat 71,2020-03-19,00:00:00,0,0,0,FMN GV 11 Ramsel
66,Bergstraat 71,2020-03-19,01:00:00,0,0,0,FMN GV 11 Ramsel
66,Bergstraat 71,2020-03-19,02:00:00,0,0,0,FMN GV 11 Ramsel
66,Bergstraat 71,2020-03-19,03:00:00,0,0,0,FMN GV 11 Ramsel
66,Bergstraat 71,2020-03-19,04:00:00,2,2,0,FMN GV 11 Ramsel
66,Bergstraat 71,2020-03-19,05:00:00,8,4,4,FMN GV 11 Ramsel
66,Bergstraat 71,2020-03-19,06:00:00,24,10,14,FMN GV 11 Ramsel
66,Bergstraat 71,2020-03-19,07:00:00,34,14,20,FMN GV 11 Ramsel
66,Bergstraat 71,2020-03-19,08:00:00,20,6,14,FMN GV 11 Ramsel
66,Bergstraat 71,2020-03-19,09:00:00,38,16,22,FMN GV 11 Ramsel
66,Bergstraat 71,2020-03-19,10:00:00,36,12,24,FMN GV 11 Ramsel
66,Bergstraat 71,2020-03-19,11:00:00,52,22,30,FMN GV 11 Ramsel
66,Bergstraat 71,2020-03-19,12:00:00,88,52,36,FMN GV 11 Ramsel
66,Bergstraat 71,2020-03-19,13:00:00,130,58,72,FMN GV 11 Ramsel
66,Bergstraat 71,2020-03-19,14:00:00,212,100,112,FMN GV 11 Ramsel
66,Bergstraat 71,2020-03-19,15:00:00,174,100,74,FMN GV 11 Ramsel
66,Bergstraat 71,2020-03-19,16:00:00,118,70,48,FMN GV 11 Ramsel
66,Bergstraat 71,2020-03-19,17:00:00,94,52,42,FMN GV 11 Ramsel
66,Bergstraat 71,2020-03-19,18:00:00,52,32,20,FMN GV 11 Ramsel
66,Bergstraat 71,2020-03-19,19:00:00,18,10,8,FMN GV 11 Ramsel
66,Bergstraat 71,2020-03-19,20:00:00,6,0,6,FMN GV 11 Ramsel
66,Bergstraat 71,2020-03-19,21:00:00,2,2,0,FMN GV 11 Ramsel
66,Bergstraat 71,2020-03-19,22:00:00,2,2,0,FMN GV 11 Ramsel
66,Bergstraat 71,2020-03-19,23:00:00,0,0,0,FMN GV 11 Ramsel
66,Bergstraat 71,2020-03-20,00:00:00,0,0,0,FMN GV 11 Ramsel
66,Bergstraat 71,2020-03-20,01:00:00,2,2,0,FMN GV 11 Ramsel
66,Bergstraat 71,2020-03-20,02:00:00,0,0,0,FMN GV 11 Ramsel
66,Bergstraat 71,2020-03-20,03:00:00,0,0,0,FMN GV 11 Ramsel
66,Bergstraat 71,2020-03-20,04:00:00,2,2,0,FMN GV 11 Ramsel
66,Bergstraat 71,2020-03-20,05:00:00,4,4,0,FMN GV 11 Ramsel
66,Bergstraat 71,2020-03-20,06:00:00,8,4,4,FMN GV 11 Ramsel
66,Bergstraat 71,2020-03-20,07:00:00,52,18,34,FMN GV 11 Ramsel
66,Bergstraat 71,2020-03-20,08:00:00,18,6,12,FMN GV 11 Ramsel
66,Bergstraat 71,2020-03-20,09:00:00,36,14,22,FMN GV 11 Ramsel
66,Bergstraat 71,2020-03-20,10:00:00,30,8,22,FMN GV 11 Ramsel
66,Bergstraat 71,2020-03-20,11:00:00,38,20,18,FMN GV 11 Ramsel
66,Bergstraat 71,2020-03-20,12:00:00,60,28,32,FMN GV 11 Ramsel
66,Bergstraat 71,2020-03-20,13:00:00,64,38,26,FMN GV 11 Ramsel
66,Bergstraat 71,2020-03-20,14:00:00,80,32,48,FMN GV 11 Ramsel
66,Bergstraat 71,2020-03-20,15:00:00,48,26,22,FMN GV 11 Ramsel
66,Bergstraat 71,2020-03-20,16:00:00,94,48,46,FMN GV 11 Ramsel
66,Bergstraat 71,2020-03-20,17:00:00,38,14,24,FMN GV 11 Ramsel
66,Bergstraat 71,2020-03-20,18:00:00,18,14,4,FMN GV 11 Ramsel
66,Bergstraat 71,2020-03-20,19:00:00,2,0,2,FMN GV 11 Ramsel
66,Bergstraat 71,2020-03-20,20:00:00,0,0,0,FMN GV 11 Ramsel
66,Bergstraat 71,2020-03-20,21:00:00,2,0,2,FMN GV 11 Ramsel
66,Bergstraat 71,2020-03-20,22:00:00,4,2,2,FMN GV 11 Ramsel
66,Bergstraat 71,2020-03-20,23:00:00,0,0,0,FMN GV 11 Ramsel
66,Bergstraat 71,2020-03-21,00:00:00,0,0,0,FMN GV 11 Ramsel
66,Bergstraat 71,2020-03-21,01:00:00,2,0,2,FMN GV 11 Ramsel
66,Bergstraat 71,2020-03-21,02:00:00,2,2,0,FMN GV 11 Ramsel
66,Bergstraat 71,2020-03-21,03:00:00,0,0,0,FMN GV 11 Ramsel
66,Bergstraat 71,2020-03-21,04:00:00,0,0,0,FMN GV 11 Ramsel
66,Bergstraat 71,2020-03-21,05:00:00,0,0,0,FMN GV 11 Ramsel
66,Bergstraat 71,2020-03-21,06:00:00,2,0,2,FMN GV 11 Ramsel
66,Bergstraat 71,2020-03-21,07:00:00,12,4,8,FMN GV 11 Ramsel
66,Bergstraat 71,2020-03-21,08:00:00,16,6,10,FMN GV 11 Ramsel
66,Bergstraat 71,2020-03-21,09:00:00,58,12,46,FMN GV 11 Ramsel
66,Bergstraat 71,2020-03-21,10:00:00,140,58,82,FMN GV 11 Ramsel
66,Bergstraat 71,2020-03-21,11:00:00,94,40,54,FMN GV 11 Ramsel
66,Bergstraat 71,2020-03-21,12:00:00,146,80,66,FMN GV 11 Ramsel
66,Bergstraat 71,2020-03-21,13:00:00,214,122,92,FMN GV 11 Ramsel
66,Bergstraat 71,2020-03-21,14:00:00,328,138,190,FMN GV 11 Ramsel
66,Bergstraat 71,2020-03-21,15:00:00,274,134,140,FMN GV 11 Ramsel
66,Bergstraat 71,2020-03-21,16:00:00,176,96,80,FMN GV 11 Ramsel
66,Bergstraat 71,2020-03-21,17:00:00,80,46,34,FMN GV 11 Ramsel
66,Bergstraat 71,2020-03-21,18:00:00,60,26,34,FMN GV 11 Ramsel
66,Bergstraat 71,2020-03-21,19:00:00,18,6,12,FMN GV 11 Ramsel
66,Bergstraat 71,2020-03-21,20:00:00,4,2,2,FMN GV 11 Ramsel
66,Bergstraat 71,2020-03-21,21:00:00,8,2,6,FMN GV 11 Ramsel
66,Bergstraat 71,2020-03-21,22:00:00,2,2,0,FMN GV 11 Ramsel
66,Bergstraat 71,2020-03-21,23:00:00,0,0,0,FMN GV 11 Ramsel
66,Bergstraat 71,2020-03-22,00:00:00,0,0,0,FMN GV 11 Ramsel
66,Bergstraat 71,2020-03-22,01:00:00,0,0,0,FMN GV 11 Ramsel
66,Bergstraat 71,2020-03-22,02:00:00,0,0,0,FMN GV 11 Ramsel
66,Bergstraat 71,2020-03-22,03:00:00,0,0,0,FMN GV 11 Ramsel
66,Bergstraat 71,2020-03-22,04:00:00,0,0,0,FMN GV 11 Ramsel
66,Bergstraat 71,2020-03-22,05:00:00,0,0,0,FMN GV 11 Ramsel
66,Bergstraat 71,2020-03-22,06:00:00,6,0,6,FMN GV 11 Ramsel
66,Bergstraat 71,2020-03-22,07:00:00,10,4,6,FMN GV 11 Ramsel
66,Bergstraat 71,2020-03-22,08:00:00,46,20,26,FMN GV 11 Ramsel
66,Bergstraat 71,2020-03-22,09:00:00,114,38,76,FMN GV 11 Ramsel
66,Bergstraat 71,2020-03-22,10:00:00,200,68,132,FMN GV 11 Ramsel
66,Bergstraat 71,2020-03-22,11:00:00,298,136,162,FMN GV 11 Ramsel
66,Bergstraat 71,2020-03-22,12:00:00,190,106,84,FMN GV 11 Ramsel
66,Bergstraat 71,2020-03-22,13:00:00,196,104,92,FMN GV 11 Ramsel
66,Bergstraat 71,2020-03-22,14:00:00,326,134,192,FMN GV 11 Ramsel
66,Bergstraat 71,2020-03-22,15:00:00,254,132,122,FMN GV 11 Ramsel
66,Bergstraat 71,2020-03-22,16:00:00,164,76,88,FMN GV 11 Ramsel
66,Bergstraat 71,2020-03-22,17:00:00,112,64,48,FMN GV 11 Ramsel
66,Bergstraat 71,2020-03-22,18:00:00,60,28,32,FMN GV 11 Ramsel
66,Bergstraat 71,2020-03-22,19:00:00,24,8,16,FMN GV 11 Ramsel
66,Bergstraat 71,2020-03-22,20:00:00,2,0,2,FMN GV 11 Ramsel
66,Bergstraat 71,2020-03-22,21:00:00,4,2,2,FMN GV 11 Ramsel
66,Bergstraat 71,2020-03-22,22:00:00,4,4,0,FMN GV 11 Ramsel
66,Bergstraat 71,2020-03-22,23:00:00,0,0,0,FMN GV 11 Ramsel
66,Bergstraat 71,2020-03-23,00:00:00,0,0,0,FMN GV 11 Ramsel
66,Bergstraat 71,2020-03-23,01:00:00,0,0,0,FMN GV 11 Ramsel
66,Bergstraat 71,2020-03-23,02:00:00,0,0,0,FMN GV 11 Ramsel
66,Bergstraat 71,2020-03-23,03:00:00,0,0,0,FMN GV 11 Ramsel
66,Bergstraat 71,2020-03-23,04:00:00,4,2,2,FMN GV 11 Ramsel
66,Bergstraat 71,2020-03-23,05:00:00,2,2,0,FMN GV 11 Ramsel
66,Bergstraat 71,2020-03-23,06:00:00,22,10,12,FMN GV 11 Ramsel
66,Bergstraat 71,2020-03-23,07:00:00,32,12,20,FMN GV 11 Ramsel
66,Bergstraat 71,2020-03-23,08:00:00,20,6,14,FMN GV 11 Ramsel
66,Bergstraat 71,2020-03-23,09:00:00,30,8,22,FMN GV 11 Ramsel
66,Bergstraat 71,2020-03-23,10:00:00,38,16,22,FMN GV 11 Ramsel
66,Bergstraat 71,2020-03-23,11:00:00,56,22,34,FMN GV 11 Ramsel
66,Bergstraat 71,2020-03-23,12:00:00,56,36,20,FMN GV 11 Ramsel
66,Bergstraat 71,2020-03-23,13:00:00,92,28,64,FMN GV 11 Ramsel
66,Bergstraat 71,2020-03-23,14:00:00,236,98,138,FMN GV 11 Ramsel
66,Bergstraat 71,2020-03-23,15:00:00,210,114,96,FMN GV 11 Ramsel
66,Bergstraat 71,2020-03-23,16:00:00,150,96,54,FMN GV 11 Ramsel
66,Bergstraat 71,2020-03-23,17:00:00,92,40,52,FMN GV 11 Ramsel
66,Bergstraat 71,2020-03-23,18:00:00,40,18,22,FMN GV 11 Ramsel
66,Bergstraat 71,2020-03-23,19:00:00,20,14,6,FMN GV 11 Ramsel
66,Bergstraat 71,2020-03-23,20:00:00,12,6,6,FMN GV 11 Ramsel
66,Bergstraat 71,2020-03-23,21:00:00,6,2,4,FMN GV 11 Ramsel
66,Bergstraat 71,2020-03-23,22:00:00,2,2,0,FMN GV 11 Ramsel
66,Bergstraat 71,2020-03-23,23:00:00,0,0,0,FMN GV 11 Ramsel
66,Bergstraat 71,2020-03-24,00:00:00,0,0,0,FMN GV 11 Ramsel
66,Bergstraat 71,2020-03-24,01:00:00,0,0,0,FMN GV 11 Ramsel
66,Bergstraat 71,2020-03-24,02:00:00,0,0,0,FMN GV 11 Ramsel
66,Bergstraat 71,2020-03-24,03:00:00,0,0,0,FMN GV 11 Ramsel
66,Bergstraat 71,2020-03-24,04:00:00,6,2,4,FMN GV 11 Ramsel
66,Bergstraat 71,2020-03-24,05:00:00,10,4,6,FMN GV 11 Ramsel
66,Bergstraat 71,2020-03-24,06:00:00,16,8,8,FMN GV 11 Ramsel
66,Bergstraat 71,2020-03-24,07:00:00,16,8,8,FMN GV 11 Ramsel
66,Bergstraat 71,2020-03-24,08:00:00,28,10,18,FMN GV 11 Ramsel
66,Bergstraat 71,2020-03-24,09:00:00,38,12,26,FMN GV 11 Ramsel
66,Bergstraat 71,2020-03-24,10:00:00,50,18,32,FMN GV 11 Ramsel
66,Bergstraat 71,2020-03-24,11:00:00,84,34,50,FMN GV 11 Ramsel
66,Bergstraat 71,2020-03-24,12:00:00,78,26,52,FMN GV 11 Ramsel
66,Bergstraat 71,2020-03-24,13:00:00,256,126,130,FMN GV 11 Ramsel
66,Bergstraat 71,2020-03-24,14:00:00,304,116,188,FMN GV 11 Ramsel
66,Bergstraat 71,2020-03-24,15:00:00,284,146,138,FMN GV 11 Ramsel
66,Bergstraat 71,2020-03-24,16:00:00,230,146,84,FMN GV 11 Ramsel
66,Bergstraat 71,2020-03-24,17:00:00,176,84,92,FMN GV 11 Ramsel
66,Bergstraat 71,2020-03-24,18:00:00,58,46,12,FMN GV 11 Ramsel
66,Bergstraat 71,2020-03-24,19:00:00,18,6,12,FMN GV 11 Ramsel
66,Bergstraat 71,2020-03-24,20:00:00,8,4,4,FMN GV 11 Ramsel
66,Bergstraat 71,2020-03-24,21:00:00,0,0,0,FMN GV 11 Ramsel
66,Bergstraat 71,2020-03-24,22:00:00,2,2,0,FMN GV 11 Ramsel
66,Bergstraat 71,2020-03-24,23:00:00,0,0,0,FMN GV 11 Ramsel
66,Bergstraat 71,2020-03-25,00:00:00,0,0,0,FMN GV 11 Ramsel
66,Bergstraat 71,2020-03-25,01:00:00,0,0,0,FMN GV 11 Ramsel
66,Bergstraat 71,2020-03-25,02:00:00,0,0,0,FMN GV 11 Ramsel
66,Bergstraat 71,2020-03-25,03:00:00,0,0,0,FMN GV 11 Ramsel
66,Bergstraat 71,2020-03-25,04:00:00,6,2,4,FMN GV 11 Ramsel
66,Bergstraat 71,2020-03-25,05:00:00,4,0,4,FMN GV 11 Ramsel
66,Bergstraat 71,2020-03-25,06:00:00,12,8,4,FMN GV 11 Ramsel
66,Bergstraat 71,2020-03-25,07:00:00,34,10,24,FMN GV 11 Ramsel
66,Bergstraat 71,2020-03-25,08:00:00,28,18,10,FMN GV 11 Ramsel
66,Bergstraat 71,2020-03-25,09:00:00,38,14,24,FMN GV 11 Ramsel
66,Bergstraat 71,2020-03-25,10:00:00,76,36,40,FMN GV 11 Ramsel
66,Bergstraat 71,2020-03-25,11:00:00,116,48,68,FMN GV 11 Ramsel
66,Bergstraat 71,2020-03-25,12:00:00,110,36,74,FMN GV 11 Ramsel
66,Bergstraat 71,2020-03-25,13:00:00,230,112,118,FMN GV 11 Ramsel
66,Bergstraat 71,2020-03-25,14:00:00,280,122,158,FMN GV 11 Ramsel
66,Bergstraat 71,2020-03-25,15:00:00,284,168,116,FMN GV 11 Ramsel
66,Bergstraat 71,2020-03-25,16:00:00,194,114,80,FMN GV 11 Ramsel
66,Bergstraat 71,2020-03-25,17:00:00,152,72,80,FMN GV 11 Ramsel
66,Bergstraat 71,2020-03-25,18:00:00,98,52,46,FMN GV 11 Ramsel
66,Bergstraat 71,2020-03-25,19:00:00,20,16,4,FMN GV 11 Ramsel
66,Bergstraat 71,2020-03-25,20:00:00,18,4,14,FMN GV 11 Ramsel
66,Bergstraat 71,2020-03-25,21:00:00,0,0,0,FMN GV 11 Ramsel
66,Bergstraat 71,2020-03-25,22:00:00,0,0,0,FMN GV 11 Ramsel
66,Bergstraat 71,2020-03-25,23:00:00,2,0,2,FMN GV 11 Ramsel
66,Bergstraat 71,2020-03-26,00:00:00,0,0,0,FMN GV 11 Ramsel
66,Bergstraat 71,2020-03-26,01:00:00,0,0,0,FMN GV 11 Ramsel
66,Bergstraat 71,2020-03-26,02:00:00,0,0,0,FMN GV 11 Ramsel
66,Bergstraat 71,2020-03-26,03:00:00,2,0,2,FMN GV 11 Ramsel
66,Bergstraat 71,2020-03-26,04:00:00,4,0,4,FMN GV 11 Ramsel
66,Bergstraat 71,2020-03-26,05:00:00,6,2,4,FMN GV 11 Ramsel
66,Bergstraat 71,2020-03-26,06:00:00,18,10,8,FMN GV 11 Ramsel
66,Bergstraat 71,2020-03-26,07:00:00,22,10,12,FMN GV 11 Ramsel
66,Bergstraat 71,2020-03-26,08:00:00,24,14,10,FMN GV 11 Ramsel
66,Bergstraat 71,2020-03-26,09:00:00,30,12,18,FMN GV 11 Ramsel
66,Bergstraat 71,2020-03-26,10:00:00,60,22,38,FMN GV 11 Ramsel
66,Bergstraat 71,2020-03-26,11:00:00,102,34,68,FMN GV 11 Ramsel
66,Bergstraat 71,2020-03-26,12:00:00,98,56,42,FMN GV 11 Ramsel
66,Bergstraat 71,2020-03-26,13:00:00,134,46,88,FMN GV 11 Ramsel
66,Bergstraat 71,2020-03-26,14:00:00,212,114,98,FMN GV 11 Ramsel
66,Bergstraat 71,2020-03-26,15:00:00,184,88,96,FMN GV 11 Ramsel
66,Bergstraat 71,2020-03-26,16:00:00,164,88,76,FMN GV 11 Ramsel
66,Bergstraat 71,2020-03-26,17:00:00,124,64,60,FMN GV 11 Ramsel
66,Bergstraat 71,2020-03-26,18:00:00,56,24,32,FMN GV 11 Ramsel
66,Bergstraat 71,2020-03-26,19:00:00,30,18,12,FMN GV 11 Ramsel
66,Bergstraat 71,2020-03-26,20:00:00,8,6,2,FMN GV 11 Ramsel
66,Bergstraat 71,2020-03-26,21:00:00,0,0,0,FMN GV 11 Ramsel
66,Bergstraat 71,2020-03-26,22:00:00,2,0,2,FMN GV 11 Ramsel
66,Bergstraat 71,2020-03-26,23:00:00,0,0,0,FMN GV 11 Ramsel
66,Bergstraat 71,2020-03-27,00:00:00,0,0,0,FMN GV 11 Ramsel
66,Bergstraat 71,2020-03-27,01:00:00,4,2,2,FMN GV 11 Ramsel
66,Bergstraat 71,2020-03-27,02:00:00,0,0,0,FMN GV 11 Ramsel
66,Bergstraat 71,2020-03-27,03:00:00,0,0,0,FMN GV 11 Ramsel
66,Bergstraat 71,2020-03-27,04:00:00,6,2,4,FMN GV 11 Ramsel
66,Bergstraat 71,2020-03-27,05:00:00,6,4,2,FMN GV 11 Ramsel
66,Bergstraat 71,2020-03-27,06:00:00,6,2,4,FMN GV 11 Ramsel
66,Bergstraat 71,2020-03-27,07:00:00,36,16,20,FMN GV 11 Ramsel
66,Bergstraat 71,2020-03-27,08:00:00,18,8,10,FMN GV 11 Ramsel
66,Bergstraat 71,2020-03-27,09:00:00,36,12,24,FMN GV 11 Ramsel
66,Bergstraat 71,2020-03-27,10:00:00,68,22,46,FMN GV 11 Ramsel
66,Bergstraat 71,2020-03-27,11:00:00,114,54,60,FMN GV 11 Ramsel
66,Bergstraat 71,2020-03-27,12:00:00,124,54,70,FMN GV 11 Ramsel
66,Bergstraat 71,2020-03-27,13:00:00,206,126,80,FMN GV 11 Ramsel
66,Bergstraat 71,2020-03-27,14:00:00,300,130,170,FMN GV 11 Ramsel
66,Bergstraat 71,2020-03-27,15:00:00,342,166,176,FMN GV 11 Ramsel
66,Bergstraat 71,2020-03-27,16:00:00,242,134,108,FMN GV 11 Ramsel
66,Bergstraat 71,2020-03-27,17:00:00,140,84,56,FMN GV 11 Ramsel
66,Bergstraat 71,2020-03-27,18:00:00,54,36,18,FMN GV 11 Ramsel
66,Bergstraat 71,2020-03-27,19:00:00,30,14,16,FMN GV 11 Ramsel
66,Bergstraat 71,2020-03-27,20:00:00,2,2,0,FMN GV 11 Ramsel
66,Bergstraat 71,2020-03-27,21:00:00,0,0,0,FMN GV 11 Ramsel
66,Bergstraat 71,2020-03-27,22:00:00,2,2,0,FMN GV 11 Ramsel
66,Bergstraat 71,2020-03-27,23:00:00,2,2,0,FMN GV 11 Ramsel
66,Bergstraat 71,2020-03-28,00:00:00,2,2,0,FMN GV 11 Ramsel
66,Bergstraat 71,2020-03-28,01:00:00,0,0,0,FMN GV 11 Ramsel
66,Bergstraat 71,2020-03-28,02:00:00,0,0,0,FMN GV 11 Ramsel
66,Bergstraat 71,2020-03-28,03:00:00,0,0,0,FMN GV 11 Ramsel
66,Bergstraat 71,2020-03-28,04:00:00,0,0,0,FMN GV 11 Ramsel
66,Bergstraat 71,2020-03-28,05:00:00,2,2,0,FMN GV 11 Ramsel
66,Bergstraat 71,2020-03-28,06:00:00,4,0,4,FMN GV 11 Ramsel
66,Bergstraat 71,2020-03-28,07:00:00,10,0,10,FMN GV 11 Ramsel
66,Bergstraat 71,2020-03-28,08:00:00,36,12,24,FMN GV 11 Ramsel
66,Bergstraat 71,2020-03-28,09:00:00,116,56,60,FMN GV 11 Ramsel
66,Bergstraat 71,2020-03-28,10:00:00,114,46,68,FMN GV 11 Ramsel
66,Bergstraat 71,2020-03-28,11:00:00,166,74,92,FMN GV 11 Ramsel
66,Bergstraat 71,2020-03-28,12:00:00,176,90,86,FMN GV 11 Ramsel
66,Bergstraat 71,2020-03-28,13:00:00,346,156,190,FMN GV 11 Ramsel
66,Bergstraat 71,2020-03-28,14:00:00,440,210,230,FMN GV 11 Ramsel
66,Bergstraat 71,2020-03-28,15:00:00,408,218,190,FMN GV 11 Ramsel
66,Bergstraat 71,2020-03-28,16:00:00,294,184,110,FMN GV 11 Ramsel
66,Bergstraat 71,2020-03-28,17:00:00,132,88,44,FMN GV 11 Ramsel
66,Bergstraat 71,2020-03-28,18:00:00,70,40,30,FMN GV 11 Ramsel
66,Bergstraat 71,2020-03-28,19:00:00,30,12,18,FMN GV 11 Ramsel
66,Bergstraat 71,2020-03-28,20:00:00,6,2,4,FMN GV 11 Ramsel
66,Bergstraat 71,2020-03-28,21:00:00,0,0,0,FMN GV 11 Ramsel
66,Bergstraat 71,2020-03-28,22:00:00,4,4,0,FMN GV 11 Ramsel
66,Bergstraat 71,2020-03-28,23:00:00,2,0,2,FMN GV 11 Ramsel
66,Bergstraat 71,2020-03-29,00:00:00,0,0,0,FMN GV 11 Ramsel
66,Bergstraat 71,2020-03-29,01:00:00,0,0,0,FMN GV 11 Ramsel
66,Bergstraat 71,2020-03-29,02:00:00,0,0,0,FMN GV 11 Ramsel
66,Bergstraat 71,2020-03-29,03:00:00,2,2,0,FMN GV 11 Ramsel
66,Bergstraat 71,2020-03-29,04:00:00,0,0,0,FMN GV 11 Ramsel
66,Bergstraat 71,2020-03-29,05:00:00,0,0,0,FMN GV 11 Ramsel
66,Bergstraat 71,2020-03-29,06:00:00,6,2,4,FMN GV 11 Ramsel
66,Bergstraat 71,2020-03-29,07:00:00,14,4,10,FMN GV 11 Ramsel
66,Bergstraat 71,2020-03-29,08:00:00,28,10,18,FMN GV 11 Ramsel
66,Bergstraat 71,2020-03-29,09:00:00,68,28,40,FMN GV 11 Ramsel
66,Bergstraat 71,2020-03-29,10:00:00,106,72,34,FMN GV 11 Ramsel
66,Bergstraat 71,2020-03-29,11:00:00,128,64,64,FMN GV 11 Ramsel
66,Bergstraat 71,2020-03-29,12:00:00,66,36,30,FMN GV 11 Ramsel
66,Bergstraat 71,2020-03-29,13:00:00,64,38,26,FMN GV 11 Ramsel
66,Bergstraat 71,2020-03-29,14:00:00,42,24,18,FMN GV 11 Ramsel
66,Bergstraat 71,2020-03-29,15:00:00,52,32,20,FMN GV 11 Ramsel
66,Bergstraat 71,2020-03-29,16:00:00,44,18,26,FMN GV 11 Ramsel
66,Bergstraat 71,2020-03-29,17:00:00,14,12,2,FMN GV 11 Ramsel
66,Bergstraat 71,2020-03-29,18:00:00,18,12,6,FMN GV 11 Ramsel
66,Bergstraat 71,2020-03-29,19:00:00,16,8,8,FMN GV 11 Ramsel
66,Bergstraat 71,2020-03-29,20:00:00,6,4,2,FMN GV 11 Ramsel
66,Bergstraat 71,2020-03-29,21:00:00,0,0,0,FMN GV 11 Ramsel
66,Bergstraat 71,2020-03-29,22:00:00,2,0,2,FMN GV 11 Ramsel
66,Bergstraat 71,2020-03-29,23:00:00,0,0,0,FMN GV 11 Ramsel
66,Bergstraat 71,2020-03-30,00:00:00,0,0,0,FMN GV 11 Ramsel
66,Bergstraat 71,2020-03-30,01:00:00,0,0,0,FMN GV 11 Ramsel
66,Bergstraat 71,2020-03-30,02:00:00,2,0,2,FMN GV 11 Ramsel
66,Bergstraat 71,2020-03-30,03:00:00,0,0,0,FMN GV 11 Ramsel
66,Bergstraat 71,2020-03-30,04:00:00,4,2,2,FMN GV 11 Ramsel
66,Bergstraat 71,2020-03-30,05:00:00,6,4,2,FMN GV 11 Ramsel
66,Bergstraat 71,2020-03-30,06:00:00,10,4,6,FMN GV 11 Ramsel
66,Bergstraat 71,2020-03-30,07:00:00,16,8,8,FMN GV 11 Ramsel
66,Bergstraat 71,2020-03-30,08:00:00,10,4,6,FMN GV 11 Ramsel
66,Bergstraat 71,2020-03-30,09:00:00,16,2,14,FMN GV 11 Ramsel
66,Bergstraat 71,2020-03-30,10:00:00,44,14,30,FMN GV 11 Ramsel
66,Bergstraat 71,2020-03-30,11:00:00,68,30,38,FMN GV 11 Ramsel
66,Bergstraat 71,2020-03-30,12:00:00,64,30,34,FMN GV 11 Ramsel
66,Bergstraat 71,2020-03-30,13:00:00,122,50,72,FMN GV 11 Ramsel
66,Bergstraat 71,2020-03-30,14:00:00,108,68,40,FMN GV 11 Ramsel
66,Bergstraat 71,2020-03-30,15:00:00,114,74,40,FMN GV 11 Ramsel
66,Bergstraat 71,2020-03-30,16:00:00,88,52,36,FMN GV 11 Ramsel
66,Bergstraat 71,2020-03-30,17:00:00,68,32,36,FMN GV 11 Ramsel
66,Bergstraat 71,2020-03-30,18:00:00,58,32,26,FMN GV 11 Ramsel
66,Bergstraat 71,2020-03-30,19:00:00,20,8,12,FMN GV 11 Ramsel
66,Bergstraat 71,2020-03-30,20:00:00,20,6,14,FMN GV 11 Ramsel
66,Bergstraat 71,2020-03-30,21:00:00,4,4,0,FMN GV 11 Ramsel
66,Bergstraat 71,2020-03-30,22:00:00,4,4,0,FMN GV 11 Ramsel
66,Bergstraat 71,2020-03-30,23:00:00,4,2,2,FMN GV 11 Ramsel
66,Bergstraat 71,2020-03-31,00:00:00,0,0,0,FMN GV 11 Ramsel
66,Bergstraat 71,2020-03-31,01:00:00,0,0,0,FMN GV 11 Ramsel
66,Bergstraat 71,2020-03-31,02:00:00,0,0,0,FMN GV 11 Ramsel
66,Bergstraat 71,2020-03-31,03:00:00,0,0,0,FMN GV 11 Ramsel
66,Bergstraat 71,2020-03-31,04:00:00,4,2,2,FMN GV 11 Ramsel
66,Bergstraat 71,2020-03-31,05:00:00,8,2,6,FMN GV 11 Ramsel
66,Bergstraat 71,2020-03-31,06:00:00,20,8,12,FMN GV 11 Ramsel
66,Bergstraat 71,2020-03-31,07:00:00,24,12,12,FMN GV 11 Ramsel
66,Bergstraat 71,2020-03-31,08:00:00,18,8,10,FMN GV 11 Ramsel
66,Bergstraat 71,2020-03-31,09:00:00,20,12,8,FMN GV 11 Ramsel
66,Bergstraat 71,2020-03-31,10:00:00,34,8,26,FMN GV 11 Ramsel
66,Bergstraat 71,2020-03-31,11:00:00,58,28,30,FMN GV 11 Ramsel
66,Bergstraat 71,2020-03-31,12:00:00,62,36,26,FMN GV 11 Ramsel
66,Bergstraat 71,2020-03-31,13:00:00,134,50,84,FMN GV 11 Ramsel
66,Bergstraat 71,2020-03-31,14:00:00,202,90,112,FMN GV 11 Ramsel
66,Bergstraat 71,2020-03-31,15:00:00,198,116,82,FMN GV 11 Ramsel
66,Bergstraat 71,2020-03-31,16:00:00,170,92,78,FMN GV 11 Ramsel
66,Bergstraat 71,2020-03-31,17:00:00,124,54,70,FMN GV 11 Ramsel
66,Bergstraat 71,2020-03-31,18:00:00,94,46,48,FMN GV 11 Ramsel
66,Bergstraat 71,2020-03-31,19:00:00,60,38,22,FMN GV 11 Ramsel
66,Bergstraat 71,2020-03-31,20:00:00,28,14,14,FMN GV 11 Ramsel
66,Bergstraat 71,2020-03-31,21:00:00,4,4,0,FMN GV 11 Ramsel
66,Bergstraat 71,2020-03-31,22:00:00,0,0,0,FMN GV 11 Ramsel
66,Bergstraat 71,2020-03-31,23:00:00,0,0,0,FMN GV 11 Ramsel
66,Bergstraat 71,2020-04-01,00:00:00,0,0,0,FMN GV 11 Ramsel
66,Bergstraat 71,2020-04-01,01:00:00,0,0,0,FMN GV 11 Ramsel
66,Bergstraat 71,2020-04-01,02:00:00,0,0,0,FMN GV 11 Ramsel
66,Bergstraat 71,2020-04-01,03:00:00,0,0,0,FMN GV 11 Ramsel
66,Bergstraat 71,2020-04-01,04:00:00,4,2,2,FMN GV 11 Ramsel
66,Bergstraat 71,2020-04-01,05:00:00,6,4,2,FMN GV 11 Ramsel
66,Bergstraat 71,2020-04-01,06:00:00,18,6,12,FMN GV 11 Ramsel
66,Bergstraat 71,2020-04-01,07:00:00,16,10,6,FMN GV 11 Ramsel
66,Bergstraat 71,2020-04-01,08:00:00,22,10,12,FMN GV 11 Ramsel
66,Bergstraat 71,2020-04-01,09:00:00,22,14,8,FMN GV 11 Ramsel
66,Bergstraat 71,2020-04-01,10:00:00,40,12,28,FMN GV 11 Ramsel
66,Bergstraat 71,2020-04-01,11:00:00,84,46,38,FMN GV 11 Ramsel
66,Bergstraat 71,2020-04-01,12:00:00,106,42,64,FMN GV 11 Ramsel
66,Bergstraat 71,2020-04-01,13:00:00,218,114,104,FMN GV 11 Ramsel
66,Bergstraat 71,2020-04-01,14:00:00,298,156,142,FMN GV 11 Ramsel
66,Bergstraat 71,2020-04-01,15:00:00,300,172,128,FMN GV 11 Ramsel
66,Bergstraat 71,2020-04-01,16:00:00,256,134,122,FMN GV 11 Ramsel
66,Bergstraat 71,2020-04-01,17:00:00,184,104,80,FMN GV 11 Ramsel
66,Bergstraat 71,2020-04-01,18:00:00,108,54,54,FMN GV 11 Ramsel
66,Bergstraat 71,2020-04-01,19:00:00,44,28,16,FMN GV 11 Ramsel
66,Bergstraat 71,2020-04-01,20:00:00,30,16,14,FMN GV 11 Ramsel
66,Bergstraat 71,2020-04-01,21:00:00,14,8,6,FMN GV 11 Ramsel
66,Bergstraat 71,2020-04-01,22:00:00,4,4,0,FMN GV 11 Ramsel
66,Bergstraat 71,2020-04-01,23:00:00,0,0,0,FMN GV 11 Ramsel
66,Bergstraat 71,2020-04-02,00:00:00,2,0,2,FMN GV 11 Ramsel
66,Bergstraat 71,2020-04-02,01:00:00,0,0,0,FMN GV 11 Ramsel
66,Bergstraat 71,2020-04-02,02:00:00,0,0,0,FMN GV 11 Ramsel
66,Bergstraat 71,2020-04-02,03:00:00,0,0,0,FMN GV 11 Ramsel
66,Bergstraat 71,2020-04-02,04:00:00,4,2,2,FMN GV 11 Ramsel
66,Bergstraat 71,2020-04-02,05:00:00,8,4,4,FMN GV 11 Ramsel
66,Bergstraat 71,2020-04-02,06:00:00,18,6,12,FMN GV 11 Ramsel
66,Bergstraat 71,2020-04-02,07:00:00,16,10,6,FMN GV 11 Ramsel
66,Bergstraat 71,2020-04-02,08:00:00,24,12,12,FMN GV 11 Ramsel
66,Bergstraat 71,2020-04-02,09:00:00,38,8,30,FMN GV 11 Ramsel
66,Bergstraat 71,2020-04-02,10:00:00,54,14,40,FMN GV 11 Ramsel
66,Bergstraat 71,2020-04-02,11:00:00,78,48,30,FMN GV 11 Ramsel
66,Bergstraat 71,2020-04-02,12:00:00,114,52,62,FMN GV 11 Ramsel
66,Bergstraat 71,2020-04-02,13:00:00,196,90,106,FMN GV 11 Ramsel
66,Bergstraat 71,2020-04-02,14:00:00,176,96,80,FMN GV 11 Ramsel
66,Bergstraat 71,2020-04-02,15:00:00,186,98,88,FMN GV 11 Ramsel
66,Bergstraat 71,2020-04-02,16:00:00,122,74,48,FMN GV 11 Ramsel
66,Bergstraat 71,2020-04-02,17:00:00,74,50,24,FMN GV 11 Ramsel
66,Bergstraat 71,2020-04-02,18:00:00,44,22,22,FMN GV 11 Ramsel
66,Bergstraat 71,2020-04-02,19:00:00,42,20,22,FMN GV 11 Ramsel
66,Bergstraat 71,2020-04-02,20:00:00,28,18,10,FMN GV 11 Ramsel
66,Bergstraat 71,2020-04-02,21:00:00,4,4,0,FMN GV 11 Ramsel
66,Bergstraat 71,2020-04-02,22:00:00,4,4,0,FMN GV 11 Ramsel
66,Bergstraat 71,2020-04-02,23:00:00,2,2,0,FMN GV 11 Ramsel
66,Bergstraat 71,2020-04-03,00:00:00,2,0,2,FMN GV 11 Ramsel
66,Bergstraat 71,2020-04-03,01:00:00,0,0,0,FMN GV 11 Ramsel
66,Bergstraat 71,2020-04-03,02:00:00,0,0,0,FMN GV 11 Ramsel
66,Bergstraat 71,2020-04-03,03:00:00,0,0,0,FMN GV 11 Ramsel
66,Bergstraat 71,2020-04-03,04:00:00,4,2,2,FMN GV 11 Ramsel
66,Bergstraat 71,2020-04-03,05:00:00,4,2,2,FMN GV 11 Ramsel
66,Bergstraat 71,2020-04-03,06:00:00,14,4,10,FMN GV 11 Ramsel
66,Bergstraat 71,2020-04-03,07:00:00,26,12,14,FMN GV 11 Ramsel
66,Bergstraat 71,2020-04-03,08:00:00,38,22,16,FMN GV 11 Ramsel
66,Bergstraat 71,2020-04-03,09:00:00,18,8,10,FMN GV 11 Ramsel
66,Bergstraat 71,2020-04-03,10:00:00,62,26,36,FMN GV 11 Ramsel
66,Bergstraat 71,2020-04-03,11:00:00,62,34,28,FMN GV 11 Ramsel
66,Bergstraat 71,2020-04-03,12:00:00,80,40,40,FMN GV 11 Ramsel
66,Bergstraat 71,2020-04-03,13:00:00,124,62,62,FMN GV 11 Ramsel
66,Bergstraat 71,2020-04-03,14:00:00,112,68,44,FMN GV 11 Ramsel
66,Bergstraat 71,2020-04-03,15:00:00,142,80,62,FMN GV 11 Ramsel
66,Bergstraat 71,2020-04-03,16:00:00,110,60,50,FMN GV 11 Ramsel
66,Bergstraat 71,2020-04-03,17:00:00,90,48,42,FMN GV 11 Ramsel
66,Bergstraat 71,2020-04-03,18:00:00,80,34,46,FMN GV 11 Ramsel
66,Bergstraat 71,2020-04-03,19:00:00,36,24,12,FMN GV 11 Ramsel
66,Bergstraat 71,2020-04-03,20:00:00,12,4,8,FMN GV 11 Ramsel
66,Bergstraat 71,2020-04-03,21:00:00,12,4,8,FMN GV 11 Ramsel
66,Bergstraat 71,2020-04-03,22:00:00,2,2,0,FMN GV 11 Ramsel
66,Bergstraat 71,2020-04-03,23:00:00,4,4,0,FMN GV 11 Ramsel
66,Bergstraat 71,2020-04-04,00:00:00,4,4,0,FMN GV 11 Ramsel
66,Bergstraat 71,2020-04-04,01:00:00,0,0,0,FMN GV 11 Ramsel
66,Bergstraat 71,2020-04-04,02:00:00,0,0,0,FMN GV 11 Ramsel
66,Bergstraat 71,2020-04-04,03:00:00,0,0,0,FMN GV 11 Ramsel
66,Bergstraat 71,2020-04-04,04:00:00,2,2,0,FMN GV 11 Ramsel
66,Bergstraat 71,2020-04-04,05:00:00,2,0,2,FMN GV 11 Ramsel
66,Bergstraat 71,2020-04-04,06:00:00,6,0,6,FMN GV 11 Ramsel
66,Bergstraat 71,2020-04-04,07:00:00,10,2,8,FMN GV 11 Ramsel
66,Bergstraat 71,2020-04-04,08:00:00,22,4,18,FMN GV 11 Ramsel
66,Bergstraat 71,2020-04-04,09:00:00,94,26,68,FMN GV 11 Ramsel
66,Bergstraat 71,2020-04-04,10:00:00,162,58,104,FMN GV 11 Ramsel
66,Bergstraat 71,2020-04-04,11:00:00,194,98,96,FMN GV 11 Ramsel
66,Bergstraat 71,2020-04-04,12:00:00,210,102,108,FMN GV 11 Ramsel
66,Bergstraat 71,2020-04-04,13:00:00,370,168,202,FMN GV 11 Ramsel
66,Bergstraat 71,2020-04-04,14:00:00,506,214,292,FMN GV 11 Ramsel
66,Bergstraat 71,2020-04-04,15:00:00,460,238,222,FMN GV 11 Ramsel
66,Bergstraat 71,2020-04-04,16:00:00,296,184,112,FMN GV 11 Ramsel
66,Bergstraat 71,2020-04-04,17:00:00,150,78,72,FMN GV 11 Ramsel
66,Bergstraat 71,2020-04-04,18:00:00,98,52,46,FMN GV 11 Ramsel
66,Bergstraat 71,2020-04-04,19:00:00,34,20,14,FMN GV 11 Ramsel
66,Bergstraat 71,2020-04-04,20:00:00,28,16,12,FMN GV 11 Ramsel
66,Bergstraat 71,2020-04-04,21:00:00,4,2,2,FMN GV 11 Ramsel
66,Bergstraat 71,2020-04-04,22:00:00,4,4,0,FMN GV 11 Ramsel
66,Bergstraat 71,2020-04-04,23:00:00,0,0,0,FMN GV 11 Ramsel
66,Bergstraat 71,2020-04-05,00:00:00,0,0,0,FMN GV 11 Ramsel
66,Bergstraat 71,2020-04-05,01:00:00,0,0,0,FMN GV 11 Ramsel
66,Bergstraat 71,2020-04-05,02:00:00,4,2,2,FMN GV 11 Ramsel
66,Bergstraat 71,2020-04-05,03:00:00,0,0,0,FMN GV 11 Ramsel
66,Bergstraat 71,2020-04-05,04:00:00,0,0,0,FMN GV 11 Ramsel
66,Bergstraat 71,2020-04-05,05:00:00,0,0,0,FMN GV 11 Ramsel
66,Bergstraat 71,2020-04-05,06:00:00,4,2,2,FMN GV 11 Ramsel
66,Bergstraat 71,2020-04-05,07:00:00,28,4,24,FMN GV 11 Ramsel
66,Bergstraat 71,2020-04-05,08:00:00,82,28,54,FMN GV 11 Ramsel
66,Bergstraat 71,2020-04-05,09:00:00,220,54,166,FMN GV 11 Ramsel
66,Bergstraat 71,2020-04-05,10:00:00,316,128,188,FMN GV 11 Ramsel
66,Bergstraat 71,2020-04-05,11:00:00,412,180,232,FMN GV 11 Ramsel
66,Bergstraat 71,2020-04-05,12:00:00,378,170,208,FMN GV 11 Ramsel
66,Bergstraat 71,2020-04-05,13:00:00,430,206,224,FMN GV 11 Ramsel
66,Bergstraat 71,2020-04-05,14:00:00,636,306,330,FMN GV 11 Ramsel
66,Bergstraat 71,2020-04-05,15:00:00,552,312,240,FMN GV 11 Ramsel
66,Bergstraat 71,2020-04-05,16:00:00,420,240,180,FMN GV 11 Ramsel
66,Bergstraat 71,2020-04-05,17:00:00,236,134,102,FMN GV 11 Ramsel
66,Bergstraat 71,2020-04-05,18:00:00,134,64,70,FMN GV 11 Ramsel
66,Bergstraat 71,2020-04-05,19:00:00,66,30,36,FMN GV 11 Ramsel
66,Bergstraat 71,2020-04-05,20:00:00,36,26,10,FMN GV 11 Ramsel
66,Bergstraat 71,2020-04-05,21:00:00,0,0,0,FMN GV 11 Ramsel
66,Bergstraat 71,2020-04-05,22:00:00,2,2,0,FMN GV 11 Ramsel
66,Bergstraat 71,2020-04-05,23:00:00,0,0,0,FMN GV 11 Ramsel
66,Bergstraat 71,2020-04-06,00:00:00,0,0,0,FMN GV 11 Ramsel
66,Bergstraat 71,2020-04-06,01:00:00,0,0,0,FMN GV 11 Ramsel
66,Bergstraat 71,2020-04-06,02:00:00,0,0,0,FMN GV 11 Ramsel
66,Bergstraat 71,2020-04-06,03:00:00,0,0,0,FMN GV 11 Ramsel
66,Bergstraat 71,2020-04-06,04:00:00,4,4,0,FMN GV 11 Ramsel
66,Bergstraat 71,2020-04-06,05:00:00,6,2,4,FMN GV 11 Ramsel
66,Bergstraat 71,2020-04-06,06:00:00,24,14,10,FMN GV 11 Ramsel
66,Bergstraat 71,2020-04-06,07:00:00,26,6,20,FMN GV 11 Ramsel
66,Bergstraat 71,2020-04-06,08:00:00,28,10,18,FMN GV 11 Ramsel
66,Bergstraat 71,2020-04-06,09:00:00,54,18,36,FMN GV 11 Ramsel
66,Bergstraat 71,2020-04-06,10:00:00,122,54,68,FMN GV 11 Ramsel
66,Bergstraat 71,2020-04-06,11:00:00,102,32,70,FMN GV 11 Ramsel
66,Bergstraat 71,2020-04-06,12:00:00,134,66,68,FMN GV 11 Ramsel
66,Bergstraat 71,2020-04-06,13:00:00,214,102,112,FMN GV 11 Ramsel
66,Bergstraat 71,2020-04-06,14:00:00,298,164,134,FMN GV 11 Ramsel
66,Bergstraat 71,2020-04-06,15:00:00,290,174,116,FMN GV 11 Ramsel
66,Bergstraat 71,2020-04-06,16:00:00,270,118,152,FMN GV 11 Ramsel
66,Bergstraat 71,2020-04-06,17:00:00,154,112,42,FMN GV 11 Ramsel
66,Bergstraat 71,2020-04-06,18:00:00,84,40,44,FMN GV 11 Ramsel
66,Bergstraat 71,2020-04-06,19:00:00,52,26,26,FMN GV 11 Ramsel
66,Bergstraat 71,2020-04-06,20:00:00,28,20,8,FMN GV 11 Ramsel
66,Bergstraat 71,2020-04-06,21:00:00,10,4,6,FMN GV 11 Ramsel
66,Bergstraat 71,2020-04-06,22:00:00,6,6,0,FMN GV 11 Ramsel
66,Bergstraat 71,2020-04-06,23:00:00,2,2,0,FMN GV 11 Ramsel
66,Bergstraat 71,2020-04-07,00:00:00,0,0,0,FMN GV 11 Ramsel
66,Bergstraat 71,2020-04-07,01:00:00,0,0,0,FMN GV 11 Ramsel
66,Bergstraat 71,2020-04-07,02:00:00,0,0,0,FMN GV 11 Ramsel
66,Bergstraat 71,2020-04-07,03:00:00,0,0,0,FMN GV 11 Ramsel
66,Bergstraat 71,2020-04-07,04:00:00,4,2,2,FMN GV 11 Ramsel
66,Bergstraat 71,2020-04-07,05:00:00,6,2,4,FMN GV 11 Ramsel
66,Bergstraat 71,2020-04-07,06:00:00,36,20,16,FMN GV 11 Ramsel
66,Bergstraat 71,2020-04-07,07:00:00,28,10,18,FMN GV 11 Ramsel
66,Bergstraat 71,2020-04-07,08:00:00,38,20,18,FMN GV 11 Ramsel
66,Bergstraat 71,2020-04-07,09:00:00,42,14,28,FMN GV 11 Ramsel
66,Bergstraat 71,2020-04-07,10:00:00,112,42,70,FMN GV 11 Ramsel
66,Bergstraat 71,2020-04-07,11:00:00,114,48,66,FMN GV 11 Ramsel
66,Bergstraat 71,2020-04-07,12:00:00,172,104,68,FMN GV 11 Ramsel
66,Bergstraat 71,2020-04-07,13:00:00,316,150,166,FMN GV 11 Ramsel
66,Bergstraat 71,2020-04-07,14:00:00,440,228,212,FMN GV 11 Ramsel
66,Bergstraat 71,2020-04-07,15:00:00,454,218,236,FMN GV 11 Ramsel
66,Bergstraat 71,2020-04-07,16:00:00,266,158,108,FMN GV 11 Ramsel
66,Bergstraat 71,2020-04-07,17:00:00,198,102,96,FMN GV 11 Ramsel
66,Bergstraat 71,2020-04-07,18:00:00,156,82,74,FMN GV 11 Ramsel
66,Bergstraat 71,2020-04-07,19:00:00,102,60,42,FMN GV 11 Ramsel
66,Bergstraat 71,2020-04-07,20:00:00,44,32,12,FMN GV 11 Ramsel
66,Bergstraat 71,2020-04-07,21:00:00,20,8,12,FMN GV 11 Ramsel
66,Bergstraat 71,2020-04-07,22:00:00,8,8,0,FMN GV 11 Ramsel
66,Bergstraat 71,2020-04-07,23:00:00,2,2,0,FMN GV 11 Ramsel
66,Bergstraat 71,2020-04-08,00:00:00,2,0,2,FMN GV 11 Ramsel
66,Bergstraat 71,2020-04-08,01:00:00,0,0,0,FMN GV 11 Ramsel
66,Bergstraat 71,2020-04-08,02:00:00,0,0,0,FMN GV 11 Ramsel
66,Bergstraat 71,2020-04-08,03:00:00,0,0,0,FMN GV 11 Ramsel
66,Bergstraat 71,2020-04-08,04:00:00,6,2,4,FMN GV 11 Ramsel
66,Bergstraat 71,2020-04-08,05:00:00,6,0,6,FMN GV 11 Ramsel
66,Bergstraat 71,2020-04-08,06:00:00,28,18,10,FMN GV 11 Ramsel
66,Bergstraat 71,2020-04-08,07:00:00,30,10,20,FMN GV 11 Ramsel
66,Bergstraat 71,2020-04-08,08:00:00,54,28,26,FMN GV 11 Ramsel
66,Bergstraat 71,2020-04-08,09:00:00,84,42,42,FMN GV 11 Ramsel
66,Bergstraat 71,2020-04-08,10:00:00,156,46,110,FMN GV 11 Ramsel
66,Bergstraat 71,2020-04-08,11:00:00,186,80,106,FMN GV 11 Ramsel
66,Bergstraat 71,2020-04-08,12:00:00,230,94,136,FMN GV 11 Ramsel
66,Bergstraat 71,2020-04-08,13:00:00,412,198,214,FMN GV 11 Ramsel
66,Bergstraat 71,2020-04-08,14:00:00,528,266,262,FMN GV 11 Ramsel
66,Bergstraat 71,2020-04-08,15:00:00,560,336,224,FMN GV 11 Ramsel
66,Bergstraat 71,2020-04-08,16:00:00,338,150,188,FMN GV 11 Ramsel
66,Bergstraat 71,2020-04-08,17:00:00,250,138,112,FMN GV 11 Ramsel
66,Bergstraat 71,2020-04-08,18:00:00,182,110,72,FMN GV 11 Ramsel
66,Bergstraat 71,2020-04-08,19:00:00,128,56,72,FMN GV 11 Ramsel
66,Bergstraat 71,2020-04-08,20:00:00,78,40,38,FMN GV 11 Ramsel
66,Bergstraat 71,2020-04-08,21:00:00,12,6,6,FMN GV 11 Ramsel
66,Bergstraat 71,2020-04-08,22:00:00,8,6,2,FMN GV 11 Ramsel
66,Bergstraat 71,2020-04-08,23:00:00,2,2,0,FMN GV 11 Ramsel
66,Bergstraat 71,2020-04-09,00:00:00,2,0,2,FMN GV 11 Ramsel
66,Bergstraat 71,2020-04-09,01:00:00,0,0,0,FMN GV 11 Ramsel
66,Bergstraat 71,2020-04-09,02:00:00,0,0,0,FMN GV 11 Ramsel
66,Bergstraat 71,2020-04-09,03:00:00,0,0,0,FMN GV 11 Ramsel
66,Bergstraat 71,2020-04-09,04:00:00,6,2,4,FMN GV 11 Ramsel
66,Bergstraat 71,2020-04-09,05:00:00,10,4,6,FMN GV 11 Ramsel
66,Bergstraat 71,2020-04-09,06:00:00,32,16,16,FMN GV 11 Ramsel
66,Bergstraat 71,2020-04-09,07:00:00,24,12,12,FMN GV 11 Ramsel
66,Bergstraat 71,2020-04-09,08:00:00,50,24,26,FMN GV 11 Ramsel
66,Bergstraat 71,2020-04-09,09:00:00,50,26,24,FMN GV 11 Ramsel
66,Bergstraat 71,2020-04-09,10:00:00,132,44,88,FMN GV 11 Ramsel
66,Bergstraat 71,2020-04-09,11:00:00,156,60,96,FMN GV 11 Ramsel
66,Bergstraat 71,2020-04-09,12:00:00,162,76,86,FMN GV 11 Ramsel
66,Bergstraat 71,2020-04-09,13:00:00,314,132,182,FMN GV 11 Ramsel
66,Bergstraat 71,2020-04-09,14:00:00,412,172,240,FMN GV 11 Ramsel
66,Bergstraat 71,2020-04-09,15:00:00,400,206,194,FMN GV 11 Ramsel
66,Bergstraat 71,2020-04-09,16:00:00,294,156,138,FMN GV 11 Ramsel
66,Bergstraat 71,2020-04-09,17:00:00,240,130,110,FMN GV 11 Ramsel
66,Bergstraat 71,2020-04-09,18:00:00,164,74,90,FMN GV 11 Ramsel
66,Bergstraat 71,2020-04-09,19:00:00,132,56,76,FMN GV 11 Ramsel
66,Bergstraat 71,2020-04-09,20:00:00,50,28,22,FMN GV 11 Ramsel
66,Bergstraat 71,2020-04-09,21:00:00,12,8,4,FMN GV 11 Ramsel
66,Bergstraat 71,2020-04-09,22:00:00,10,8,2,FMN GV 11 Ramsel
66,Bergstraat 71,2020-04-09,23:00:00,6,6,0,FMN GV 11 Ramsel
66,Bergstraat 71,2020-04-10,00:00:00,0,0,0,FMN GV 11 Ramsel
66,Bergstraat 71,2020-04-10,01:00:00,0,0,0,FMN GV 11 Ramsel
66,Bergstraat 71,2020-04-10,02:00:00,0,0,0,FMN GV 11 Ramsel
66,Bergstraat 71,2020-04-10,03:00:00,0,0,0,FMN GV 11 Ramsel
66,Bergstraat 71,2020-04-10,04:00:00,6,2,4,FMN GV 11 Ramsel
66,Bergstraat 71,2020-04-10,05:00:00,6,2,4,FMN GV 11 Ramsel
66,Bergstraat 71,2020-04-10,06:00:00,26,12,14,FMN GV 11 Ramsel
66,Bergstraat 71,2020-04-10,07:00:00,26,8,18,FMN GV 11 Ramsel
66,Bergstraat 71,2020-04-10,08:00:00,36,10,26,FMN GV 11 Ramsel
66,Bergstraat 71,2020-04-10,09:00:00,62,28,34,FMN GV 11 Ramsel
66,Bergstraat 71,2020-04-10,10:00:00,168,68,100,FMN GV 11 Ramsel
66,Bergstraat 71,2020-04-10,11:00:00,158,48,110,FMN GV 11 Ramsel
66,Bergstraat 71,2020-04-10,12:00:00,184,96,88,FMN GV 11 Ramsel
66,Bergstraat 71,2020-04-10,13:00:00,374,188,186,FMN GV 11 Ramsel
66,Bergstraat 71,2020-04-10,14:00:00,408,180,228,FMN GV 11 Ramsel
66,Bergstraat 71,2020-04-10,15:00:00,430,216,214,FMN GV 11 Ramsel
66,Bergstraat 71,2020-04-10,16:00:00,274,146,128,FMN GV 11 Ramsel
66,Bergstraat 71,2020-04-10,17:00:00,224,118,106,FMN GV 11 Ramsel
66,Bergstraat 71,2020-04-10,18:00:00,142,86,56,FMN GV 11 Ramsel
66,Bergstraat 71,2020-04-10,19:00:00,108,58,50,FMN GV 11 Ramsel
66,Bergstraat 71,2020-04-10,20:00:00,38,28,10,FMN GV 11 Ramsel
66,Bergstraat 71,2020-04-10,21:00:00,28,12,16,FMN GV 11 Ramsel
66,Bergstraat 71,2020-04-10,22:00:00,2,2,0,FMN GV 11 Ramsel
66,Bergstraat 71,2020-04-10,23:00:00,2,2,0,FMN GV 11 Ramsel
66,Bergstraat 71,2020-04-11,00:00:00,2,2,0,FMN GV 11 Ramsel
66,Bergstraat 71,2020-04-11,01:00:00,6,6,0,FMN GV 11 Ramsel
66,Bergstraat 71,2020-04-11,02:00:00,0,0,0,FMN GV 11 Ramsel
66,Bergstraat 71,2020-04-11,03:00:00,2,0,2,FMN GV 11 Ramsel
66,Bergstraat 71,2020-04-11,04:00:00,0,0,0,FMN GV 11 Ramsel
66,Bergstraat 71,2020-04-11,05:00:00,2,0,2,FMN GV 11 Ramsel
66,Bergstraat 71,2020-04-11,06:00:00,4,0,4,FMN GV 11 Ramsel
66,Bergstraat 71,2020-04-11,07:00:00,12,4,8,FMN GV 11 Ramsel
66,Bergstraat 71,2020-04-11,08:00:00,54,20,34,FMN GV 11 Ramsel
66,Bergstraat 71,2020-04-11,09:00:00,140,18,122,FMN GV 11 Ramsel
66,Bergstraat 71,2020-04-11,10:00:00,228,90,138,FMN GV 11 Ramsel
66,Bergstraat 71,2020-04-11,11:00:00,286,128,158,FMN GV 11 Ramsel
66,Bergstraat 71,2020-04-11,12:00:00,370,190,180,FMN GV 11 Ramsel
66,Bergstraat 71,2020-04-11,13:00:00,420,180,240,FMN GV 11 Ramsel
66,Bergstraat 71,2020-04-11,14:00:00,626,302,324,FMN GV 11 Ramsel
66,Bergstraat 71,2020-04-11,15:00:00,600,326,274,FMN GV 11 Ramsel
66,Bergstraat 71,2020-04-11,16:00:00,452,280,172,FMN GV 11 Ramsel
66,Bergstraat 71,2020-04-11,17:00:00,302,194,108,FMN GV 11 Ramsel
66,Bergstraat 71,2020-04-11,18:00:00,154,86,68,FMN GV 11 Ramsel
66,Bergstraat 71,2020-04-11,19:00:00,130,36,94,FMN GV 11 Ramsel
66,Bergstraat 71,2020-04-11,20:00:00,58,38,20,FMN GV 11 Ramsel
66,Bergstraat 71,2020-04-11,21:00:00,18,14,4,FMN GV 11 Ramsel
66,Bergstraat 71,2020-04-11,22:00:00,8,4,4,FMN GV 11 Ramsel
66,Bergstraat 71,2020-04-11,23:00:00,6,2,4,FMN GV 11 Ramsel
66,Bergstraat 71,2020-04-12,00:00:00,0,0,0,FMN GV 11 Ramsel
66,Bergstraat 71,2020-04-12,01:00:00,0,0,0,FMN GV 11 Ramsel
66,Bergstraat 71,2020-04-12,02:00:00,0,0,0,FMN GV 11 Ramsel
66,Bergstraat 71,2020-04-12,03:00:00,2,2,0,FMN GV 11 Ramsel
66,Bergstraat 71,2020-04-12,04:00:00,0,0,0,FMN GV 11 Ramsel
66,Bergstraat 71,2020-04-12,05:00:00,0,0,0,FMN GV 11 Ramsel
66,Bergstraat 71,2020-04-12,06:00:00,2,0,2,FMN GV 11 Ramsel
66,Bergstraat 71,2020-04-12,07:00:00,24,10,14,FMN GV 11 Ramsel
66,Bergstraat 71,2020-04-12,08:00:00,64,18,46,FMN GV 11 Ramsel
66,Bergstraat 71,2020-04-12,09:00:00,186,56,130,FMN GV 11 Ramsel
66,Bergstraat 71,2020-04-12,10:00:00,310,128,182,FMN GV 11 Ramsel
66,Bergstraat 71,2020-04-12,11:00:00,392,206,186,FMN GV 11 Ramsel
66,Bergstraat 71,2020-04-12,12:00:00,368,192,176,FMN GV 11 Ramsel
66,Bergstraat 71,2020-04-12,13:00:00,432,224,208,FMN GV 11 Ramsel
66,Bergstraat 71,2020-04-12,14:00:00,478,218,260,FMN GV 11 Ramsel
66,Bergstraat 71,2020-04-12,15:00:00,448,244,204,FMN GV 11 Ramsel
66,Bergstraat 71,2020-04-12,16:00:00,308,164,144,FMN GV 11 Ramsel
66,Bergstraat 71,2020-04-12,17:00:00,230,142,88,FMN GV 11 Ramsel
66,Bergstraat 71,2020-04-12,18:00:00,102,48,54,FMN GV 11 Ramsel
66,Bergstraat 71,2020-04-12,19:00:00,122,68,54,FMN GV 11 Ramsel
66,Bergstraat 71,2020-04-12,20:00:00,30,16,14,FMN GV 11 Ramsel
66,Bergstraat 71,2020-04-12,21:00:00,16,8,8,FMN GV 11 Ramsel
66,Bergstraat 71,2020-04-12,22:00:00,4,0,4,FMN GV 11 Ramsel
66,Bergstraat 71,2020-04-12,23:00:00,4,2,2,FMN GV 11 Ramsel
66,Bergstraat 71,2020-04-13,00:00:00,0,0,0,FMN GV 11 Ramsel
66,Bergstraat 71,2020-04-13,01:00:00,0,0,0,FMN GV 11 Ramsel
66,Bergstraat 71,2020-04-13,02:00:00,0,0,0,FMN GV 11 Ramsel
66,Bergstraat 71,2020-04-13,03:00:00,0,0,0,FMN GV 11 Ramsel
66,Bergstraat 71,2020-04-13,04:00:00,0,0,0,FMN GV 11 Ramsel
66,Bergstraat 71,2020-04-13,05:00:00,0,0,0,FMN GV 11 Ramsel
66,Bergstraat 71,2020-04-13,06:00:00,6,6,0,FMN GV 11 Ramsel
66,Bergstraat 71,2020-04-13,07:00:00,8,4,4,FMN GV 11 Ramsel
66,Bergstraat 71,2020-04-13,08:00:00,12,4,8,FMN GV 11 Ramsel
66,Bergstraat 71,2020-04-13,09:00:00,36,14,22,FMN GV 11 Ramsel
66,Bergstraat 71,2020-04-13,10:00:00,52,30,22,FMN GV 11 Ramsel
66,Bergstraat 71,2020-04-13,11:00:00,58,22,36,FMN GV 11 Ramsel
66,Bergstraat 71,2020-04-13,12:00:00,38,18,20,FMN GV 11 Ramsel
66,Bergstraat 71,2020-04-13,13:00:00,86,34,52,FMN GV 11 Ramsel
66,Bergstraat 71,2020-04-13,14:00:00,152,64,88,FMN GV 11 Ramsel
66,Bergstraat 71,2020-04-13,15:00:00,186,112,74,FMN GV 11 Ramsel
66,Bergstraat 71,2020-04-13,16:00:00,154,106,48,FMN GV 11 Ramsel
66,Bergstraat 71,2020-04-13,17:00:00,94,40,54,FMN GV 11 Ramsel
66,Bergstraat 71,2020-04-13,18:00:00,76,36,40,FMN GV 11 Ramsel
66,Bergstraat 71,2020-04-13,19:00:00,58,40,18,FMN GV 11 Ramsel
66,Bergstraat 71,2020-04-13,20:00:00,28,24,4,FMN GV 11 Ramsel
66,Bergstraat 71,2020-04-13,21:00:00,10,6,4,FMN GV 11 Ramsel
66,Bergstraat 71,2020-04-13,22:00:00,2,2,0,FMN GV 11 Ramsel
66,Bergstraat 71,2020-04-13,23:00:00,2,2,0,FMN GV 11 Ramsel
66,Bergstraat 71,2020-04-14,00:00:00,0,0,0,FMN GV 11 Ramsel
66,Bergstraat 71,2020-04-14,01:00:00,0,0,0,FMN GV 11 Ramsel
66,Bergstraat 71,2020-04-14,02:00:00,0,0,0,FMN GV 11 Ramsel
66,Bergstraat 71,2020-04-14,03:00:00,0,0,0,FMN GV 11 Ramsel
66,Bergstraat 71,2020-04-14,04:00:00,2,0,2,FMN GV 11 Ramsel
66,Bergstraat 71,2020-04-14,05:00:00,8,2,6,FMN GV 11 Ramsel
66,Bergstraat 71,2020-04-14,06:00:00,18,14,4,FMN GV 11 Ramsel
66,Bergstraat 71,2020-04-14,07:00:00,26,6,20,FMN GV 11 Ramsel
66,Bergstraat 71,2020-04-14,08:00:00,32,18,14,FMN GV 11 Ramsel
66,Bergstraat 71,2020-04-14,09:00:00,46,14,32,FMN GV 11 Ramsel
66,Bergstraat 71,2020-04-14,10:00:00,78,26,52,FMN GV 11 Ramsel
66,Bergstraat 71,2020-04-14,11:00:00,78,44,34,FMN GV 11 Ramsel
66,Bergstraat 71,2020-04-14,12:00:00,54,26,28,FMN GV 11 Ramsel
66,Bergstraat 71,2020-04-14,13:00:00,126,44,82,FMN GV 11 Ramsel
66,Bergstraat 71,2020-04-14,14:00:00,120,48,72,FMN GV 11 Ramsel
66,Bergstraat 71,2020-04-14,15:00:00,138,66,72,FMN GV 11 Ramsel
66,Bergstraat 71,2020-04-14,16:00:00,130,80,50,FMN GV 11 Ramsel
66,Bergstraat 71,2020-04-14,17:00:00,106,46,60,FMN GV 11 Ramsel
66,Bergstraat 71,2020-04-14,18:00:00,112,44,68,FMN GV 11 Ramsel
66,Bergstraat 71,2020-04-14,19:00:00,38,20,18,FMN GV 11 Ramsel
66,Bergstraat 71,2020-04-14,20:00:00,46,32,14,FMN GV 11 Ramsel
66,Bergstraat 71,2020-04-14,21:00:00,8,2,6,FMN GV 11 Ramsel
66,Bergstraat 71,2020-04-14,22:00:00,2,0,2,FMN GV 11 Ramsel
66,Bergstraat 71,2020-04-14,23:00:00,0,0,0,FMN GV 11 Ramsel
66,Bergstraat 71,2020-04-15,00:00:00,0,0,0,FMN GV 11 Ramsel
66,Bergstraat 71,2020-04-15,01:00:00,0,0,0,FMN GV 11 Ramsel
66,Bergstraat 71,2020-04-15,02:00:00,0,0,0,FMN GV 11 Ramsel
66,Bergstraat 71,2020-04-15,03:00:00,0,0,0,FMN GV 11 Ramsel
66,Bergstraat 71,2020-04-15,04:00:00,4,2,2,FMN GV 11 Ramsel
66,Bergstraat 71,2020-04-15,05:00:00,4,0,4,FMN GV 11 Ramsel
66,Bergstraat 71,2020-04-15,06:00:00,24,12,12,FMN GV 11 Ramsel
66,Bergstraat 71,2020-04-15,07:00:00,24,8,16,FMN GV 11 Ramsel
66,Bergstraat 71,2020-04-15,08:00:00,32,12,20,FMN GV 11 Ramsel
66,Bergstraat 71,2020-04-15,09:00:00,40,14,26,FMN GV 11 Ramsel
66,Bergstraat 71,2020-04-15,10:00:00,90,28,62,FMN GV 11 Ramsel
66,Bergstraat 71,2020-04-15,11:00:00,104,48,56,FMN GV 11 Ramsel
66,Bergstraat 71,2020-04-15,12:00:00,116,72,44,FMN GV 11 Ramsel
66,Bergstraat 71,2020-04-15,13:00:00,248,98,150,FMN GV 11 Ramsel
66,Bergstraat 71,2020-04-15,14:00:00,350,136,214,FMN GV 11 Ramsel
66,Bergstraat 71,2020-04-15,15:00:00,396,216,180,FMN GV 11 Ramsel
66,Bergstraat 71,2020-04-15,16:00:00,306,200,106,FMN GV 11 Ramsel
66,Bergstraat 71,2020-04-15,17:00:00,232,122,110,FMN GV 11 Ramsel
66,Bergstraat 71,2020-04-15,18:00:00,152,78,74,FMN GV 11 Ramsel
66,Bergstraat 71,2020-04-15,19:00:00,92,46,46,FMN GV 11 Ramsel
66,Bergstraat 71,2020-04-15,20:00:00,74,30,44,FMN GV 11 Ramsel
66,Bergstraat 71,2020-04-15,21:00:00,8,8,0,FMN GV 11 Ramsel
66,Bergstraat 71,2020-04-15,22:00:00,8,6,2,FMN GV 11 Ramsel
66,Bergstraat 71,2020-04-15,23:00:00,0,0,0,FMN GV 11 Ramsel
66,Bergstraat 71,2020-04-16,00:00:00,0,0,0,FMN GV 11 Ramsel
66,Bergstraat 71,2020-04-16,01:00:00,0,0,0,FMN GV 11 Ramsel
66,Bergstraat 71,2020-04-16,02:00:00,0,0,0,FMN GV 11 Ramsel
66,Bergstraat 71,2020-04-16,03:00:00,0,0,0,FMN GV 11 Ramsel
66,Bergstraat 71,2020-04-16,04:00:00,6,2,4,FMN GV 11 Ramsel
66,Bergstraat 71,2020-04-16,05:00:00,4,2,2,FMN GV 11 Ramsel
66,Bergstraat 71,2020-04-16,06:00:00,20,12,8,FMN GV 11 Ramsel
66,Bergstraat 71,2020-04-16,07:00:00,20,12,8,FMN GV 11 Ramsel
66,Bergstraat 71,2020-04-16,08:00:00,28,14,14,FMN GV 11 Ramsel
66,Bergstraat 71,2020-04-16,09:00:00,94,30,64,FMN GV 11 Ramsel
66,Bergstraat 71,2020-04-16,10:00:00,122,36,86,FMN GV 11 Ramsel
66,Bergstraat 71,2020-04-16,11:00:00,146,62,84,FMN GV 11 Ramsel
66,Bergstraat 71,2020-04-16,12:00:00,200,90,110,FMN GV 11 Ramsel
66,Bergstraat 71,2020-04-16,13:00:00,360,166,194,FMN GV 11 Ramsel
66,Bergstraat 71,2020-04-16,14:00:00,560,292,268,FMN GV 11 Ramsel
66,Bergstraat 71,2020-04-16,15:00:00,442,238,204,FMN GV 11 Ramsel
66,Bergstraat 71,2020-04-16,16:00:00,368,204,164,FMN GV 11 Ramsel
66,Bergstraat 71,2020-04-16,17:00:00,282,140,142,FMN GV 11 Ramsel
66,Bergstraat 71,2020-04-16,18:00:00,166,64,102,FMN GV 11 Ramsel
66,Bergstraat 71,2020-04-16,19:00:00,110,64,46,FMN GV 11 Ramsel
66,Bergstraat 71,2020-04-16,20:00:00,82,48,34,FMN GV 11 Ramsel
66,Bergstraat 71,2020-04-16,21:00:00,30,18,12,FMN GV 11 Ramsel
66,Bergstraat 71,2020-04-16,22:00:00,8,8,0,FMN GV 11 Ramsel
66,Bergstraat 71,2020-04-16,23:00:00,2,0,2,FMN GV 11 Ramsel
66,Bergstraat 71,2020-04-17,00:00:00,0,0,0,FMN GV 11 Ramsel
66,Bergstraat 71,2020-04-17,01:00:00,0,0,0,FMN GV 11 Ramsel
66,Bergstraat 71,2020-04-17,02:00:00,4,0,4,FMN GV 11 Ramsel
66,Bergstraat 71,2020-04-17,03:00:00,0,0,0,FMN GV 11 Ramsel
66,Bergstraat 71,2020-04-17,04:00:00,8,4,4,FMN GV 11 Ramsel
66,Bergstraat 71,2020-04-17,05:00:00,6,4,2,FMN GV 11 Ramsel
66,Bergstraat 71,2020-04-17,06:00:00,16,8,8,FMN GV 11 Ramsel
66,Bergstraat 71,2020-04-17,07:00:00,24,12,12,FMN GV 11 Ramsel
66,Bergstraat 71,2020-04-17,08:00:00,50,22,28,FMN GV 11 Ramsel
66,Bergstraat 71,2020-04-17,09:00:00,82,24,58,FMN GV 11 Ramsel
66,Bergstraat 71,2020-04-17,10:00:00,130,52,78,FMN GV 11 Ramsel
66,Bergstraat 71,2020-04-17,11:00:00,160,84,76,FMN GV 11 Ramsel
66,Bergstraat 71,2020-04-17,12:00:00,162,90,72,FMN GV 11 Ramsel
66,Bergstraat 71,2020-04-17,13:00:00,302,132,170,FMN GV 11 Ramsel
66,Bergstraat 71,2020-04-17,14:00:00,426,210,216,FMN GV 11 Ramsel
66,Bergstraat 71,2020-04-17,15:00:00,432,256,176,FMN GV 11 Ramsel
66,Bergstraat 71,2020-04-17,16:00:00,346,188,158,FMN GV 11 Ramsel
66,Bergstraat 71,2020-04-17,17:00:00,248,136,112,FMN GV 11 Ramsel
66,Bergstraat 71,2020-04-17,18:00:00,154,64,90,FMN GV 11 Ramsel
66,Bergstraat 71,2020-04-17,19:00:00,90,38,52,FMN GV 11 Ramsel
66,Bergstraat 71,2020-04-17,20:00:00,76,46,30,FMN GV 11 Ramsel
66,Bergstraat 71,2020-04-17,21:00:00,4,2,2,FMN GV 11 Ramsel
66,Bergstraat 71,2020-04-17,22:00:00,14,12,2,FMN GV 11 Ramsel
66,Bergstraat 71,2020-04-17,23:00:00,6,2,4,FMN GV 11 Ramsel
66,Bergstraat 71,2020-04-18,00:00:00,2,2,0,FMN GV 11 Ramsel
66,Bergstraat 71,2020-04-18,01:00:00,4,2,2,FMN GV 11 Ramsel
66,Bergstraat 71,2020-04-18,02:00:00,2,0,2,FMN GV 11 Ramsel
66,Bergstraat 71,2020-04-18,03:00:00,0,0,0,FMN GV 11 Ramsel
66,Bergstraat 71,2020-04-18,04:00:00,2,2,0,FMN GV 11 Ramsel
66,Bergstraat 71,2020-04-18,05:00:00,2,0,2,FMN GV 11 Ramsel
66,Bergstraat 71,2020-04-18,06:00:00,8,4,4,FMN GV 11 Ramsel
66,Bergstraat 71,2020-04-18,07:00:00,20,14,6,FMN GV 11 Ramsel
66,Bergstraat 71,2020-04-18,08:00:00,32,12,20,FMN GV 11 Ramsel
66,Bergstraat 71,2020-04-18,09:00:00,56,14,42,FMN GV 11 Ramsel
66,Bergstraat 71,2020-04-18,10:00:00,122,52,70,FMN GV 11 Ramsel
66,Bergstraat 71,2020-04-18,11:00:00,66,32,34,FMN GV 11 Ramsel
66,Bergstraat 71,2020-04-18,12:00:00,30,14,16,FMN GV 11 Ramsel
66,Bergstraat 71,2020-04-18,13:00:00,34,18,16,FMN GV 11 Ramsel
66,Bergstraat 71,2020-04-18,14:00:00,94,32,62,FMN GV 11 Ramsel
66,Bergstraat 71,2020-04-18,15:00:00,92,48,44,FMN GV 11 Ramsel
66,Bergstraat 71,2020-04-18,16:00:00,108,66,42,FMN GV 11 Ramsel
66,Bergstraat 71,2020-04-18,17:00:00,80,52,28,FMN GV 11 Ramsel
66,Bergstraat 71,2020-04-18,18:00:00,78,46,32,FMN GV 11 Ramsel
66,Bergstraat 71,2020-04-18,19:00:00,32,14,18,FMN GV 11 Ramsel
66,Bergstraat 71,2020-04-18,20:00:00,44,30,14,FMN GV 11 Ramsel
66,Bergstraat 71,2020-04-18,21:00:00,20,10,10,FMN GV 11 Ramsel
66,Bergstraat 71,2020-04-18,22:00:00,0,0,0,FMN GV 11 Ramsel
66,Bergstraat 71,2020-04-18,23:00:00,2,0,2,FMN GV 11 Ramsel
66,Bergstraat 71,2020-04-19,00:00:00,0,0,0,FMN GV 11 Ramsel
66,Bergstraat 71,2020-04-19,01:00:00,2,0,2,FMN GV 11 Ramsel
66,Bergstraat 71,2020-04-19,02:00:00,0,0,0,FMN GV 11 Ramsel
66,Bergstraat 71,2020-04-19,03:00:00,2,2,0,FMN GV 11 Ramsel
66,Bergstraat 71,2020-04-19,04:00:00,0,0,0,FMN GV 11 Ramsel
66,Bergstraat 71,2020-04-19,05:00:00,0,0,0,FMN GV 11 Ramsel
66,Bergstraat 71,2020-04-19,06:00:00,8,2,6,FMN GV 11 Ramsel
66,Bergstraat 71,2020-04-19,07:00:00,30,6,24,FMN GV 11 Ramsel
66,Bergstraat 71,2020-04-19,08:00:00,82,24,58,FMN GV 11 Ramsel
66,Bergstraat 71,2020-04-19,09:00:00,222,72,150,FMN GV 11 Ramsel
66,Bergstraat 71,2020-04-19,10:00:00,378,168,210,FMN GV 11 Ramsel
66,Bergstraat 71,2020-04-19,11:00:00,354,188,166,FMN GV 11 Ramsel
66,Bergstraat 71,2020-04-19,12:00:00,356,190,166,FMN GV 11 Ramsel
66,Bergstraat 71,2020-04-19,13:00:00,350,212,138,FMN GV 11 Ramsel
66,Bergstraat 71,2020-04-19,14:00:00,558,256,302,FMN GV 11 Ramsel
66,Bergstraat 71,2020-04-19,15:00:00,436,242,194,FMN GV 11 Ramsel
66,Bergstraat 71,2020-04-19,16:00:00,402,214,188,FMN GV 11 Ramsel
66,Bergstraat 71,2020-04-19,17:00:00,246,134,112,FMN GV 11 Ramsel
66,Bergstraat 71,2020-04-19,18:00:00,104,70,34,FMN GV 11 Ramsel
66,Bergstraat 71,2020-04-19,19:00:00,66,30,36,FMN GV 11 Ramsel
66,Bergstraat 71,2020-04-19,20:00:00,32,16,16,FMN GV 11 Ramsel
66,Bergstraat 71,2020-04-19,21:00:00,8,6,2,FMN GV 11 Ramsel
66,Bergstraat 71,2020-04-19,22:00:00,4,2,2,FMN GV 11 Ramsel
66,Bergstraat 71,2020-04-19,23:00:00,0,0,0,FMN GV 11 Ramsel
66,Bergstraat 71,2020-04-20,00:00:00,2,0,2,FMN GV 11 Ramsel
66,Bergstraat 71,2020-04-20,01:00:00,0,0,0,FMN GV 11 Ramsel
66,Bergstraat 71,2020-04-20,02:00:00,0,0,0,FMN GV 11 Ramsel
66,Bergstraat 71,2020-04-20,03:00:00,0,0,0,FMN GV 11 Ramsel
66,Bergstraat 71,2020-04-20,04:00:00,4,2,2,FMN GV 11 Ramsel
66,Bergstraat 71,2020-04-20,05:00:00,4,4,0,FMN GV 11 Ramsel
66,Bergstraat 71,2020-04-20,06:00:00,32,14,18,FMN GV 11 Ramsel
66,Bergstraat 71,2020-04-20,07:00:00,32,10,22,FMN GV 11 Ramsel
66,Bergstraat 71,2020-04-20,08:00:00,26,12,14,FMN GV 11 Ramsel
66,Bergstraat 71,2020-04-20,09:00:00,36,10,26,FMN GV 11 Ramsel
66,Bergstraat 71,2020-04-20,10:00:00,98,26,72,FMN GV 11 Ramsel
66,Bergstraat 71,2020-04-20,11:00:00,68,32,36,FMN GV 11 Ramsel
66,Bergstraat 71,2020-04-20,12:00:00,86,42,44,FMN GV 11 Ramsel
66,Bergstraat 71,2020-04-20,13:00:00,128,60,68,FMN GV 11 Ramsel
66,Bergstraat 71,2020-04-20,14:00:00,204,100,104,FMN GV 11 Ramsel
66,Bergstraat 71,2020-04-20,15:00:00,204,134,70,FMN GV 11 Ramsel
66,Bergstraat 71,2020-04-20,16:00:00,194,120,74,FMN GV 11 Ramsel
66,Bergstraat 71,2020-04-20,17:00:00,102,42,60,FMN GV 11 Ramsel
66,Bergstraat 71,2020-04-20,18:00:00,96,62,34,FMN GV 11 Ramsel
66,Bergstraat 71,2020-04-20,19:00:00,76,46,30,FMN GV 11 Ramsel
66,Bergstraat 71,2020-04-20,20:00:00,34,24,10,FMN GV 11 Ramsel
66,Bergstraat 71,2020-04-20,21:00:00,10,8,2,FMN GV 11 Ramsel
66,Bergstraat 71,2020-04-20,22:00:00,18,8,10,FMN GV 11 Ramsel
66,Bergstraat 71,2020-04-20,23:00:00,4,4,0,FMN GV 11 Ramsel
66,Bergstraat 71,2020-04-21,00:00:00,0,0,0,FMN GV 11 Ramsel
66,Bergstraat 71,2020-04-21,01:00:00,2,2,0,FMN GV 11 Ramsel
66,Bergstraat 71,2020-04-21,02:00:00,0,0,0,FMN GV 11 Ramsel
66,Bergstraat 71,2020-04-21,03:00:00,0,0,0,FMN GV 11 Ramsel
66,Bergstraat 71,2020-04-21,04:00:00,6,2,4,FMN GV 11 Ramsel
66,Bergstraat 71,2020-04-21,05:00:00,10,2,8,FMN GV 11 Ramsel
66,Bergstraat 71,2020-04-21,06:00:00,36,22,14,FMN GV 11 Ramsel
66,Bergstraat 71,2020-04-21,07:00:00,46,8,38,FMN GV 11 Ramsel
66,Bergstraat 71,2020-04-21,08:00:00,40,18,22,FMN GV 11 Ramsel
66,Bergstraat 71,2020-04-21,09:00:00,44,16,28,FMN GV 11 Ramsel
66,Bergstraat 71,2020-04-21,10:00:00,84,34,50,FMN GV 11 Ramsel
66,Bergstraat 71,2020-04-21,11:00:00,96,58,38,FMN GV 11 Ramsel
66,Bergstraat 71,2020-04-21,12:00:00,86,44,42,FMN GV 11 Ramsel
66,Bergstraat 71,2020-04-21,13:00:00,140,60,80,FMN GV 11 Ramsel
66,Bergstraat 71,2020-04-21,14:00:00,218,92,126,FMN GV 11 Ramsel
66,Bergstraat 71,2020-04-21,15:00:00,220,112,108,FMN GV 11 Ramsel
66,Bergstraat 71,2020-04-21,16:00:00,200,116,84,FMN GV 11 Ramsel
66,Bergstraat 71,2020-04-21,17:00:00,144,78,66,FMN GV 11 Ramsel
66,Bergstraat 71,2020-04-21,18:00:00,152,80,72,FMN GV 11 Ramsel
66,Bergstraat 71,2020-04-21,19:00:00,94,38,56,FMN GV 11 Ramsel
66,Bergstraat 71,2020-04-21,20:00:00,68,42,26,FMN GV 11 Ramsel
66,Bergstraat 71,2020-04-21,21:00:00,26,14,12,FMN GV 11 Ramsel
66,Bergstraat 71,2020-04-21,22:00:00,12,4,8,FMN GV 11 Ramsel
66,Bergstraat 71,2020-04-21,23:00:00,0,0,0,FMN GV 11 Ramsel
66,Bergstraat 71,2020-04-22,00:00:00,0,0,0,FMN GV 11 Ramsel
66,Bergstraat 71,2020-04-22,01:00:00,0,0,0,FMN GV 11 Ramsel
66,Bergstraat 71,2020-04-22,02:00:00,4,0,4,FMN GV 11 Ramsel
66,Bergstraat 71,2020-04-22,03:00:00,0,0,0,FMN GV 11 Ramsel
66,Bergstraat 71,2020-04-22,04:00:00,4,2,2,FMN GV 11 Ramsel
66,Bergstraat 71,2020-04-22,05:00:00,10,4,6,FMN GV 11 Ramsel
66,Bergstraat 71,2020-04-22,06:00:00,26,14,12,FMN GV 11 Ramsel
66,Bergstraat 71,2020-04-22,07:00:00,28,12,16,FMN GV 11 Ramsel
66,Bergstraat 71,2020-04-22,08:00:00,40,16,24,FMN GV 11 Ramsel
66,Bergstraat 71,2020-04-22,09:00:00,42,24,18,FMN GV 11 Ramsel
66,Bergstraat 71,2020-04-22,10:00:00,66,26,40,FMN GV 11 Ramsel
66,Bergstraat 71,2020-04-22,11:00:00,102,50,52,FMN GV 11 Ramsel
66,Bergstraat 71,2020-04-22,12:00:00,118,44,74,FMN GV 11 Ramsel
66,Bergstraat 71,2020-04-22,13:00:00,226,110,116,FMN GV 11 Ramsel
66,Bergstraat 71,2020-04-22,14:00:00,298,144,154,FMN GV 11 Ramsel
66,Bergstraat 71,2020-04-22,15:00:00,304,156,148,FMN GV 11 Ramsel
66,Bergstraat 71,2020-04-22,16:00:00,338,198,140,FMN GV 11 Ramsel
66,Bergstraat 71,2020-04-22,17:00:00,230,110,120,FMN GV 11 Ramsel
66,Bergstraat 71,2020-04-22,18:00:00,216,130,86,FMN GV 11 Ramsel
66,Bergstraat 71,2020-04-22,19:00:00,144,62,82,FMN GV 11 Ramsel
66,Bergstraat 71,2020-04-22,20:00:00,114,68,46,FMN GV 11 Ramsel
66,Bergstraat 71,2020-04-22,21:00:00,24,18,6,FMN GV 11 Ramsel
66,Bergstraat 71,2020-04-22,22:00:00,14,8,6,FMN GV 11 Ramsel
66,Bergstraat 71,2020-04-22,23:00:00,2,2,0,FMN GV 11 Ramsel
66,Bergstraat 71,2020-04-23,00:00:00,2,0,2,FMN GV 11 Ramsel
66,Bergstraat 71,2020-04-23,01:00:00,0,0,0,FMN GV 11 Ramsel
66,Bergstraat 71,2020-04-23,02:00:00,0,0,0,FMN GV 11 Ramsel
66,Bergstraat 71,2020-04-23,03:00:00,0,0,0,FMN GV 11 Ramsel
66,Bergstraat 71,2020-04-23,04:00:00,6,2,4,FMN GV 11 Ramsel
66,Bergstraat 71,2020-04-23,05:00:00,8,2,6,FMN GV 11 Ramsel
66,Bergstraat 71,2020-04-23,06:00:00,30,14,16,FMN GV 11 Ramsel
66,Bergstraat 71,2020-04-23,07:00:00,28,14,14,FMN GV 11 Ramsel
66,Bergstraat 71,2020-04-23,08:00:00,46,16,30,FMN GV 11 Ramsel
66,Bergstraat 71,2020-04-23,09:00:00,56,22,34,FMN GV 11 Ramsel
66,Bergstraat 71,2020-04-23,10:00:00,142,58,84,FMN GV 11 Ramsel
66,Bergstraat 71,2020-04-23,11:00:00,142,72,70,FMN GV 11 Ramsel
66,Bergstraat 71,2020-04-23,12:00:00,202,86,116,FMN GV 11 Ramsel
66,Bergstraat 71,2020-04-23,13:00:00,368,150,218,FMN GV 11 Ramsel
66,Bergstraat 71,2020-04-23,14:00:00,510,294,216,FMN GV 11 Ramsel
66,Bergstraat 71,2020-04-23,15:00:00,486,272,214,FMN GV 11 Ramsel
66,Bergstraat 71,2020-04-23,16:00:00,482,242,240,FMN GV 11 Ramsel
66,Bergstraat 71,2020-04-23,17:00:00,264,146,118,FMN GV 11 Ramsel
66,Bergstraat 71,2020-04-23,18:00:00,248,114,134,FMN GV 11 Ramsel
66,Bergstraat 71,2020-04-23,19:00:00,146,86,60,FMN GV 11 Ramsel
66,Bergstraat 71,2020-04-23,20:00:00,102,80,22,FMN GV 11 Ramsel
66,Bergstraat 71,2020-04-23,21:00:00,54,20,34,FMN GV 11 Ramsel
66,Bergstraat 71,2020-04-23,22:00:00,22,12,10,FMN GV 11 Ramsel
66,Bergstraat 71,2020-04-23,23:00:00,4,2,2,FMN GV 11 Ramsel
66,Bergstraat 71,2020-04-24,00:00:00,0,0,0,FMN GV 11 Ramsel
66,Bergstraat 71,2020-04-24,01:00:00,6,4,2,FMN GV 11 Ramsel
66,Bergstraat 71,2020-04-24,02:00:00,0,0,0,FMN GV 11 Ramsel
66,Bergstraat 71,2020-04-24,03:00:00,0,0,0,FMN GV 11 Ramsel
66,Bergstraat 71,2020-04-24,04:00:00,4,2,2,FMN GV 11 Ramsel
66,Bergstraat 71,2020-04-24,05:00:00,4,2,2,FMN GV 11 Ramsel
66,Bergstraat 71,2020-04-24,06:00:00,30,12,18,FMN GV 11 Ramsel
66,Bergstraat 71,2020-04-24,07:00:00,24,2,22,FMN GV 11 Ramsel
66,Bergstraat 71,2020-04-24,08:00:00,48,20,28,FMN GV 11 Ramsel
66,Bergstraat 71,2020-04-24,09:00:00,50,22,28,FMN GV 11 Ramsel
66,Bergstraat 71,2020-04-24,10:00:00,108,38,70,FMN GV 11 Ramsel
66,Bergstraat 71,2020-04-24,11:00:00,94,38,56,FMN GV 11 Ramsel
66,Bergstraat 71,2020-04-24,12:00:00,148,80,68,FMN GV 11 Ramsel
66,Bergstraat 71,2020-04-24,13:00:00,226,112,114,FMN GV 11 Ramsel
66,Bergstraat 71,2020-04-24,14:00:00,378,164,214,FMN GV 11 Ramsel
66,Bergstraat 71,2020-04-24,15:00:00,446,204,242,FMN GV 11 Ramsel
66,Bergstraat 71,2020-04-24,16:00:00,348,196,152,FMN GV 11 Ramsel
66,Bergstraat 71,2020-04-24,17:00:00,220,140,80,FMN GV 11 Ramsel
66,Bergstraat 71,2020-04-24,18:00:00,172,98,74,FMN GV 11 Ramsel
66,Bergstraat 71,2020-04-24,19:00:00,148,74,74,FMN GV 11 Ramsel
66,Bergstraat 71,2020-04-24,20:00:00,66,46,20,FMN GV 11 Ramsel
66,Bergstraat 71,2020-04-24,21:00:00,28,8,20,FMN GV 11 Ramsel
66,Bergstraat 71,2020-04-24,22:00:00,2,2,0,FMN GV 11 Ramsel
66,Bergstraat 71,2020-04-24,23:00:00,2,2,0,FMN GV 11 Ramsel
66,Bergstraat 71,2020-04-25,00:00:00,2,2,0,FMN GV 11 Ramsel
66,Bergstraat 71,2020-04-25,01:00:00,0,0,0,FMN GV 11 Ramsel
66,Bergstraat 71,2020-04-25,02:00:00,0,0,0,FMN GV 11 Ramsel
66,Bergstraat 71,2020-04-25,03:00:00,0,0,0,FMN GV 11 Ramsel
66,Bergstraat 71,2020-04-25,04:00:00,0,0,0,FMN GV 11 Ramsel
66,Bergstraat 71,2020-04-25,05:00:00,2,2,0,FMN GV 11 Ramsel
66,Bergstraat 71,2020-04-25,06:00:00,6,0,6,FMN GV 11 Ramsel
66,Bergstraat 71,2020-04-25,07:00:00,18,8,10,FMN GV 11 Ramsel
66,Bergstraat 71,2020-04-25,08:00:00,42,8,34,FMN GV 11 Ramsel
66,Bergstraat 71,2020-04-25,09:00:00,112,36,76,FMN GV 11 Ramsel
66,Bergstraat 71,2020-04-25,10:00:00,132,44,88,FMN GV 11 Ramsel
66,Bergstraat 71,2020-04-25,11:00:00,158,64,94,FMN GV 11 Ramsel
66,Bergstraat 71,2020-04-25,12:00:00,178,104,74,FMN GV 11 Ramsel
66,Bergstraat 71,2020-04-25,13:00:00,298,138,160,FMN GV 11 Ramsel
66,Bergstraat 71,2020-04-25,14:00:00,390,194,196,FMN GV 11 Ramsel
66,Bergstraat 71,2020-04-25,15:00:00,456,256,200,FMN GV 11 Ramsel
66,Bergstraat 71,2020-04-25,16:00:00,338,166,172,FMN GV 11 Ramsel
66,Bergstraat 71,2020-04-25,17:00:00,232,136,96,FMN GV 11 Ramsel
66,Bergstraat 71,2020-04-25,18:00:00,100,52,48,FMN GV 11 Ramsel
66,Bergstraat 71,2020-04-25,19:00:00,74,36,38,FMN GV 11 Ramsel
66,Bergstraat 71,2020-04-25,20:00:00,78,34,44,FMN GV 11 Ramsel
66,Bergstraat 71,2020-04-25,21:00:00,16,12,4,FMN GV 11 Ramsel
66,Bergstraat 71,2020-04-25,22:00:00,12,8,4,FMN GV 11 Ramsel
66,Bergstraat 71,2020-04-25,23:00:00,2,0,2,FMN GV 11 Ramsel
66,Bergstraat 71,2020-04-26,00:00:00,0,0,0,FMN GV 11 Ramsel
66,Bergstraat 71,2020-04-26,01:00:00,2,2,0,FMN GV 11 Ramsel
66,Bergstraat 71,2020-04-26,02:00:00,0,0,0,FMN GV 11 Ramsel
66,Bergstraat 71,2020-04-26,03:00:00,2,2,0,FMN GV 11 Ramsel
66,Bergstraat 71,2020-04-26,04:00:00,0,0,0,FMN GV 11 Ramsel
66,Bergstraat 71,2020-04-26,05:00:00,0,0,0,FMN GV 11 Ramsel
66,Bergstraat 71,2020-04-26,06:00:00,4,0,4,FMN GV 11 Ramsel
66,Bergstraat 71,2020-04-26,07:00:00,26,8,18,FMN GV 11 Ramsel
66,Bergstraat 71,2020-04-26,08:00:00,104,28,76,FMN GV 11 Ramsel
66,Bergstraat 71,2020-04-26,09:00:00,188,54,134,FMN GV 11 Ramsel
66,Bergstraat 71,2020-04-26,10:00:00,342,174,168,FMN GV 11 Ramsel
66,Bergstraat 71,2020-04-26,11:00:00,350,180,170,FMN GV 11 Ramsel
66,Bergstraat 71,2020-04-26,12:00:00,348,164,184,FMN GV 11 Ramsel
66,Bergstraat 71,2020-04-26,13:00:00,564,290,274,FMN GV 11 Ramsel
66,Bergstraat 71,2020-04-26,14:00:00,648,332,316,FMN GV 11 Ramsel
66,Bergstraat 71,2020-04-26,15:00:00,682,398,284,FMN GV 11 Ramsel
66,Bergstraat 71,2020-04-26,16:00:00,586,304,282,FMN GV 11 Ramsel
66,Bergstraat 71,2020-04-26,17:00:00,316,182,134,FMN GV 11 Ramsel
66,Bergstraat 71,2020-04-26,18:00:00,232,104,128,FMN GV 11 Ramsel
66,Bergstraat 71,2020-04-26,19:00:00,126,72,54,FMN GV 11 Ramsel
66,Bergstraat 71,2020-04-26,20:00:00,54,24,30,FMN GV 11 Ramsel
66,Bergstraat 71,2020-04-26,21:00:00,22,6,16,FMN GV 11 Ramsel
66,Bergstraat 71,2020-04-26,22:00:00,4,4,0,FMN GV 11 Ramsel
66,Bergstraat 71,2020-04-26,23:00:00,0,0,0,FMN GV 11 Ramsel
66,Bergstraat 71,2020-04-27,00:00:00,0,0,0,FMN GV 11 Ramsel
66,Bergstraat 71,2020-04-27,01:00:00,0,0,0,FMN GV 11 Ramsel
66,Bergstraat 71,2020-04-27,02:00:00,0,0,0,FMN GV 11 Ramsel
66,Bergstraat 71,2020-04-27,03:00:00,0,0,0,FMN GV 11 Ramsel
66,Bergstraat 71,2020-04-27,04:00:00,4,2,2,FMN GV 11 Ramsel
66,Bergstraat 71,2020-04-27,05:00:00,10,8,2,FMN GV 11 Ramsel
66,Bergstraat 71,2020-04-27,06:00:00,34,16,18,FMN GV 11 Ramsel
66,Bergstraat 71,2020-04-27,07:00:00,36,12,24,FMN GV 11 Ramsel
66,Bergstraat 71,2020-04-27,08:00:00,16,6,10,FMN GV 11 Ramsel
66,Bergstraat 71,2020-04-27,09:00:00,66,34,32,FMN GV 11 Ramsel
66,Bergstraat 71,2020-04-27,10:00:00,110,38,72,FMN GV 11 Ramsel
66,Bergstraat 71,2020-04-27,11:00:00,134,60,74,FMN GV 11 Ramsel
66,Bergstraat 71,2020-04-27,12:00:00,202,80,122,FMN GV 11 Ramsel
66,Bergstraat 71,2020-04-27,13:00:00,220,94,126,FMN GV 11 Ramsel
66,Bergstraat 71,2020-04-27,14:00:00,416,196,220,FMN GV 11 Ramsel
66,Bergstraat 71,2020-04-27,15:00:00,380,218,162,FMN GV 11 Ramsel
66,Bergstraat 71,2020-04-27,16:00:00,304,188,116,FMN GV 11 Ramsel
66,Bergstraat 71,2020-04-27,17:00:00,222,116,106,FMN GV 11 Ramsel
66,Bergstraat 71,2020-04-27,18:00:00,128,66,62,FMN GV 11 Ramsel
66,Bergstraat 71,2020-04-27,19:00:00,158,82,76,FMN GV 11 Ramsel
66,Bergstraat 71,2020-04-27,20:00:00,92,52,40,FMN GV 11 Ramsel
66,Bergstraat 71,2020-04-27,21:00:00,18,12,6,FMN GV 11 Ramsel
66,Bergstraat 71,2020-04-27,22:00:00,10,6,4,FMN GV 11 Ramsel
66,Bergstraat 71,2020-04-27,23:00:00,2,2,0,FMN GV 11 Ramsel
66,Bergstraat 71,2020-04-28,00:00:00,2,0,2,FMN GV 11 Ramsel
66,Bergstraat 71,2020-04-28,01:00:00,0,0,0,FMN GV 11 Ramsel
66,Bergstraat 71,2020-04-28,02:00:00,2,2,0,FMN GV 11 Ramsel
66,Bergstraat 71,2020-04-28,03:00:00,0,0,0,FMN GV 11 Ramsel
66,Bergstraat 71,2020-04-28,04:00:00,6,2,4,FMN GV 11 Ramsel
66,Bergstraat 71,2020-04-28,05:00:00,8,6,2,FMN GV 11 Ramsel
66,Bergstraat 71,2020-04-28,06:00:00,24,14,10,FMN GV 11 Ramsel
66,Bergstraat 71,2020-04-28,07:00:00,30,12,18,FMN GV 11 Ramsel
66,Bergstraat 71,2020-04-28,08:00:00,16,8,8,FMN GV 11 Ramsel
66,Bergstraat 71,2020-04-28,09:00:00,10,6,4,FMN GV 11 Ramsel
66,Bergstraat 71,2020-04-28,10:00:00,38,12,26,FMN GV 11 Ramsel
66,Bergstraat 71,2020-04-28,11:00:00,44,22,22,FMN GV 11 Ramsel
66,Bergstraat 71,2020-04-28,12:00:00,24,16,8,FMN GV 11 Ramsel
66,Bergstraat 71,2020-04-28,13:00:00,22,12,10,FMN GV 11 Ramsel
66,Bergstraat 71,2020-04-28,14:00:00,32,16,16,FMN GV 11 Ramsel
66,Bergstraat 71,2020-04-28,15:00:00,30,18,12,FMN GV 11 Ramsel
66,Bergstraat 71,2020-04-28,16:00:00,44,22,22,FMN GV 11 Ramsel
66,Bergstraat 71,2020-04-28,17:00:00,62,36,26,FMN GV 11 Ramsel
66,Bergstraat 71,2020-04-28,18:00:00,54,20,34,FMN GV 11 Ramsel
66,Bergstraat 71,2020-04-28,19:00:00,14,6,8,FMN GV 11 Ramsel
66,Bergstraat 71,2020-04-28,20:00:00,18,12,6,FMN GV 11 Ramsel
66,Bergstraat 71,2020-04-28,21:00:00,4,2,2,FMN GV 11 Ramsel
66,Bergstraat 71,2020-04-28,22:00:00,2,2,0,FMN GV 11 Ramsel
66,Bergstraat 71,2020-04-28,23:00:00,0,0,0,FMN GV 11 Ramsel
66,Bergstraat 71,2020-04-29,00:00:00,0,0,0,FMN GV 11 Ramsel
66,Bergstraat 71,2020-04-29,01:00:00,0,0,0,FMN GV 11 Ramsel
66,Bergstraat 71,2020-04-29,02:00:00,0,0,0,FMN GV 11 Ramsel
66,Bergstraat 71,2020-04-29,03:00:00,0,0,0,FMN GV 11 Ramsel
66,Bergstraat 71,2020-04-29,04:00:00,6,4,2,FMN GV 11 Ramsel
66,Bergstraat 71,2020-04-29,05:00:00,8,4,4,FMN GV 11 Ramsel
66,Bergstraat 71,2020-04-29,06:00:00,22,14,8,FMN GV 11 Ramsel
66,Bergstraat 71,2020-04-29,07:00:00,30,12,18,FMN GV 11 Ramsel
66,Bergstraat 71,2020-04-29,08:00:00,48,22,26,FMN GV 11 Ramsel
66,Bergstraat 71,2020-04-29,09:00:00,34,14,20,FMN GV 11 Ramsel
66,Bergstraat 71,2020-04-29,10:00:00,26,16,10,FMN GV 11 Ramsel
66,Bergstraat 71,2020-04-29,11:00:00,46,12,34,FMN GV 11 Ramsel
66,Bergstraat 71,2020-04-29,12:00:00,82,52,30,FMN GV 11 Ramsel
66,Bergstraat 71,2020-04-29,13:00:00,150,90,60,FMN GV 11 Ramsel
66,Bergstraat 71,2020-04-29,14:00:00,154,86,68,FMN GV 11 Ramsel
66,Bergstraat 71,2020-04-29,15:00:00,178,102,76,FMN GV 11 Ramsel
66,Bergstraat 71,2020-04-29,16:00:00,198,122,76,FMN GV 11 Ramsel
66,Bergstraat 71,2020-04-29,17:00:00,94,50,44,FMN GV 11 Ramsel
66,Bergstraat 71,2020-04-29,18:00:00,80,30,50,FMN GV 11 Ramsel
66,Bergstraat 71,2020-04-29,19:00:00,30,18,12,FMN GV 11 Ramsel
66,Bergstraat 71,2020-04-29,20:00:00,16,12,4,FMN GV 11 Ramsel
66,Bergstraat 71,2020-04-29,21:00:00,4,2,2,FMN GV 11 Ramsel
66,Bergstraat 71,2020-04-29,22:00:00,6,2,4,FMN GV 11 Ramsel
66,Bergstraat 71,2020-04-29,23:00:00,2,0,2,FMN GV 11 Ramsel
66,Bergstraat 71,2020-04-30,00:00:00,0,0,0,FMN GV 11 Ramsel
66,Bergstraat 71,2020-04-30,01:00:00,0,0,0,FMN GV 11 Ramsel
66,Bergstraat 71,2020-04-30,02:00:00,0,0,0,FMN GV 11 Ramsel
66,Bergstraat 71,2020-04-30,03:00:00,0,0,0,FMN GV 11 Ramsel
66,Bergstraat 71,2020-04-30,04:00:00,2,0,2,FMN GV 11 Ramsel
66,Bergstraat 71,2020-04-30,05:00:00,10,8,2,FMN GV 11 Ramsel
66,Bergstraat 71,2020-04-30,06:00:00,20,14,6,FMN GV 11 Ramsel
66,Bergstraat 71,2020-04-30,07:00:00,22,10,12,FMN GV 11 Ramsel
66,Bergstraat 71,2020-04-30,08:00:00,18,8,10,FMN GV 11 Ramsel
66,Bergstraat 71,2020-04-30,09:00:00,18,12,6,FMN GV 11 Ramsel
66,Bergstraat 71,2020-04-30,10:00:00,46,22,24,FMN GV 11 Ramsel
66,Bergstraat 71,2020-04-30,11:00:00,50,28,22,FMN GV 11 Ramsel
66,Bergstraat 71,2020-04-30,12:00:00,78,34,44,FMN GV 11 Ramsel
66,Bergstraat 71,2020-04-30,13:00:00,136,66,70,FMN GV 11 Ramsel
66,Bergstraat 71,2020-04-30,14:00:00,114,48,66,FMN GV 11 Ramsel
66,Bergstraat 71,2020-04-30,15:00:00,166,106,60,FMN GV 11 Ramsel
66,Bergstraat 71,2020-04-30,16:00:00,96,50,46,FMN GV 11 Ramsel
66,Bergstraat 71,2020-04-30,17:00:00,74,40,34,FMN GV 11 Ramsel
66,Bergstraat 71,2020-04-30,18:00:00,70,36,34,FMN GV 11 Ramsel
66,Bergstraat 71,2020-04-30,19:00:00,32,20,12,FMN GV 11 Ramsel
66,Bergstraat 71,2020-04-30,20:00:00,30,8,22,FMN GV 11 Ramsel
66,Bergstraat 71,2020-04-30,21:00:00,12,8,4,FMN GV 11 Ramsel
66,Bergstraat 71,2020-04-30,22:00:00,2,2,0,FMN GV 11 Ramsel
66,Bergstraat 71,2020-04-30,23:00:00,0,0,0,FMN GV 11 Ramsel
66,Bergstraat 71,2020-05-01,00:00:00,0,0,0,FMN GV 11 Ramsel
66,Bergstraat 71,2020-05-01,01:00:00,2,2,0,FMN GV 11 Ramsel
66,Bergstraat 71,2020-05-01,02:00:00,0,0,0,FMN GV 11 Ramsel
66,Bergstraat 71,2020-05-01,03:00:00,0,0,0,FMN GV 11 Ramsel
66,Bergstraat 71,2020-05-01,04:00:00,0,0,0,FMN GV 11 Ramsel
66,Bergstraat 71,2020-05-01,05:00:00,0,0,0,FMN GV 11 Ramsel
66,Bergstraat 71,2020-05-01,06:00:00,14,6,8,FMN GV 11 Ramsel
66,Bergstraat 71,2020-05-01,07:00:00,8,4,4,FMN GV 11 Ramsel
66,Bergstraat 71,2020-05-01,08:00:00,50,14,36,FMN GV 11 Ramsel
66,Bergstraat 71,2020-05-01,09:00:00,110,40,70,FMN GV 11 Ramsel
66,Bergstraat 71,2020-05-01,10:00:00,94,22,72,FMN GV 11 Ramsel
66,Bergstraat 71,2020-05-01,11:00:00,74,42,32,FMN GV 11 Ramsel
66,Bergstraat 71,2020-05-01,12:00:00,74,40,34,FMN GV 11 Ramsel
66,Bergstraat 71,2020-05-01,13:00:00,108,44,64,FMN GV 11 Ramsel
66,Bergstraat 71,2020-05-01,14:00:00,114,54,60,FMN GV 11 Ramsel
66,Bergstraat 71,2020-05-01,15:00:00,78,44,34,FMN GV 11 Ramsel
66,Bergstraat 71,2020-05-01,16:00:00,54,32,22,FMN GV 11 Ramsel
66,Bergstraat 71,2020-05-01,17:00:00,46,28,18,FMN GV 11 Ramsel
66,Bergstraat 71,2020-05-01,18:00:00,40,14,26,FMN GV 11 Ramsel
66,Bergstraat 71,2020-05-01,19:00:00,26,24,2,FMN GV 11 Ramsel
66,Bergstraat 71,2020-05-01,20:00:00,6,2,4,FMN GV 11 Ramsel
66,Bergstraat 71,2020-05-01,21:00:00,4,2,2,FMN GV 11 Ramsel
66,Bergstraat 71,2020-05-01,22:00:00,2,0,2,FMN GV 11 Ramsel
66,Bergstraat 71,2020-05-01,23:00:00,6,4,2,FMN GV 11 Ramsel
66,Bergstraat 71,2020-05-02,00:00:00,2,2,0,FMN GV 11 Ramsel
66,Bergstraat 71,2020-05-02,01:00:00,0,0,0,FMN GV 11 Ramsel
66,Bergstraat 71,2020-05-02,02:00:00,0,0,0,FMN GV 11 Ramsel
66,Bergstraat 71,2020-05-02,03:00:00,2,2,0,FMN GV 11 Ramsel
66,Bergstraat 71,2020-05-02,04:00:00,0,0,0,FMN GV 11 Ramsel
66,Bergstraat 71,2020-05-02,05:00:00,0,0,0,FMN GV 11 Ramsel
66,Bergstraat 71,2020-05-02,06:00:00,6,4,2,FMN GV 11 Ramsel
66,Bergstraat 71,2020-05-02,07:00:00,16,6,10,FMN GV 11 Ramsel
66,Bergstraat 71,2020-05-02,08:00:00,10,4,6,FMN GV 11 Ramsel
66,Bergstraat 71,2020-05-02,09:00:00,18,10,8,FMN GV 11 Ramsel
66,Bergstraat 71,2020-05-02,10:00:00,38,18,20,FMN GV 11 Ramsel
66,Bergstraat 71,2020-05-02,11:00:00,38,30,8,FMN GV 11 Ramsel
66,Bergstraat 71,2020-05-02,12:00:00,20,10,10,FMN GV 11 Ramsel
66,Bergstraat 71,2020-05-02,13:00:00,110,48,62,FMN GV 11 Ramsel
66,Bergstraat 71,2020-05-02,14:00:00,134,64,70,FMN GV 11 Ramsel
66,Bergstraat 71,2020-05-02,15:00:00,144,70,74,FMN GV 11 Ramsel
66,Bergstraat 71,2020-05-02,16:00:00,198,110,88,FMN GV 11 Ramsel
66,Bergstraat 71,2020-05-02,17:00:00,148,80,68,FMN GV 11 Ramsel
66,Bergstraat 71,2020-05-02,18:00:00,72,34,38,FMN GV 11 Ramsel
66,Bergstraat 71,2020-05-02,19:00:00,28,16,12,FMN GV 11 Ramsel
66,Bergstraat 71,2020-05-02,20:00:00,52,32,20,FMN GV 11 Ramsel
66,Bergstraat 71,2020-05-02,21:00:00,16,2,14,FMN GV 11 Ramsel
66,Bergstraat 71,2020-05-02,22:00:00,12,8,4,FMN GV 11 Ramsel
66,Bergstraat 71,2020-05-02,23:00:00,0,0,0,FMN GV 11 Ramsel
66,Bergstraat 71,2020-05-03,00:00:00,4,4,0,FMN GV 11 Ramsel
66,Bergstraat 71,2020-05-03,01:00:00,2,0,2,FMN GV 11 Ramsel
66,Bergstraat 71,2020-05-03,02:00:00,0,0,0,FMN GV 11 Ramsel
66,Bergstraat 71,2020-05-03,03:00:00,2,2,0,FMN GV 11 Ramsel
66,Bergstraat 71,2020-05-03,04:00:00,0,0,0,FMN GV 11 Ramsel
66,Bergstraat 71,2020-05-03,05:00:00,0,0,0,FMN GV 11 Ramsel
66,Bergstraat 71,2020-05-03,06:00:00,12,2,10,FMN GV 11 Ramsel
66,Bergstraat 71,2020-05-03,07:00:00,36,12,24,FMN GV 11 Ramsel
66,Bergstraat 71,2020-05-03,08:00:00,100,34,66,FMN GV 11 Ramsel
66,Bergstraat 71,2020-05-03,09:00:00,296,64,232,FMN GV 11 Ramsel
66,Bergstraat 71,2020-05-03,10:00:00,450,144,306,FMN GV 11 Ramsel
66,Bergstraat 71,2020-05-03,11:00:00,546,266,280,FMN GV 11 Ramsel
66,Bergstraat 71,2020-05-03,12:00:00,446,232,214,FMN GV 11 Ramsel
66,Bergstraat 71,2020-05-03,13:00:00,490,248,242,FMN GV 11 Ramsel
66,Bergstraat 71,2020-05-03,14:00:00,706,344,362,FMN GV 11 Ramsel
66,Bergstraat 71,2020-05-03,15:00:00,646,370,276,FMN GV 11 Ramsel
66,Bergstraat 71,2020-05-03,16:00:00,428,256,172,FMN GV 11 Ramsel
66,Bergstraat 71,2020-05-03,17:00:00,286,194,92,FMN GV 11 Ramsel
66,Bergstraat 71,2020-05-03,18:00:00,142,70,72,FMN GV 11 Ramsel
66,Bergstraat 71,2020-05-03,19:00:00,42,18,24,FMN GV 11 Ramsel
66,Bergstraat 71,2020-05-03,20:00:00,28,12,16,FMN GV 11 Ramsel
66,Bergstraat 71,2020-05-03,21:00:00,22,10,12,FMN GV 11 Ramsel
66,Bergstraat 71,2020-05-03,22:00:00,6,6,0,FMN GV 11 Ramsel
66,Bergstraat 71,2020-05-03,23:00:00,2,2,0,FMN GV 11 Ramsel
66,Bergstraat 71,2020-05-04,00:00:00,0,0,0,FMN GV 11 Ramsel
66,Bergstraat 71,2020-05-04,01:00:00,0,0,0,FMN GV 11 Ramsel
66,Bergstraat 71,2020-05-04,02:00:00,0,0,0,FMN GV 11 Ramsel
66,Bergstraat 71,2020-05-04,03:00:00,0,0,0,FMN GV 11 Ramsel
66,Bergstraat 71,2020-05-04,04:00:00,4,2,2,FMN GV 11 Ramsel
66,Bergstraat 71,2020-05-04,05:00:00,4,0,4,FMN GV 11 Ramsel
66,Bergstraat 71,2020-05-04,06:00:00,40,20,20,FMN GV 11 Ramsel
66,Bergstraat 71,2020-05-04,07:00:00,24,10,14,FMN GV 11 Ramsel
66,Bergstraat 71,2020-05-04,08:00:00,10,4,6,FMN GV 11 Ramsel
66,Bergstraat 71,2020-05-04,09:00:00,22,14,8,FMN GV 11 Ramsel
66,Bergstraat 71,2020-05-04,10:00:00,30,18,12,FMN GV 11 Ramsel
66,Bergstraat 71,2020-05-04,11:00:00,42,18,24,FMN GV 11 Ramsel
66,Bergstraat 71,2020-05-04,12:00:00,54,24,30,FMN GV 11 Ramsel
66,Bergstraat 71,2020-05-04,13:00:00,94,32,62,FMN GV 11 Ramsel
66,Bergstraat 71,2020-05-04,14:00:00,134,52,82,FMN GV 11 Ramsel
66,Bergstraat 71,2020-05-04,15:00:00,182,102,80,FMN GV 11 Ramsel
66,Bergstraat 71,2020-05-04,16:00:00,138,96,42,FMN GV 11 Ramsel
66,Bergstraat 71,2020-05-04,17:00:00,122,70,52,FMN GV 11 Ramsel
66,Bergstraat 71,2020-05-04,18:00:00,96,56,40,FMN GV 11 Ramsel
66,Bergstraat 71,2020-05-04,19:00:00,84,42,42,FMN GV 11 Ramsel
66,Bergstraat 71,2020-05-04,20:00:00,46,16,30,FMN GV 11 Ramsel
66,Bergstraat 71,2020-05-04,21:00:00,28,10,18,FMN GV 11 Ramsel
66,Bergstraat 71,2020-05-04,22:00:00,8,2,6,FMN GV 11 Ramsel
66,Bergstraat 71,2020-05-04,23:00:00,0,0,0,FMN GV 11 Ramsel
66,Bergstraat 71,2020-05-05,00:00:00,2,2,0,FMN GV 11 Ramsel
66,Bergstraat 71,2020-05-05,01:00:00,0,0,0,FMN GV 11 Ramsel
66,Bergstraat 71,2020-05-05,02:00:00,2,0,2,FMN GV 11 Ramsel
66,Bergstraat 71,2020-05-05,03:00:00,0,0,0,FMN GV 11 Ramsel
66,Bergstraat 71,2020-05-05,04:00:00,6,2,4,FMN GV 11 Ramsel
66,Bergstraat 71,2020-05-05,05:00:00,8,4,4,FMN GV 11 Ramsel
66,Bergstraat 71,2020-05-05,06:00:00,44,20,24,FMN GV 11 Ramsel
66,Bergstraat 71,2020-05-05,07:00:00,50,24,26,FMN GV 11 Ramsel
66,Bergstraat 71,2020-05-05,08:00:00,28,8,20,FMN GV 11 Ramsel
66,Bergstraat 71,2020-05-05,09:00:00,60,18,42,FMN GV 11 Ramsel
66,Bergstraat 71,2020-05-05,10:00:00,62,28,34,FMN GV 11 Ramsel
66,Bergstraat 71,2020-05-05,11:00:00,66,40,26,FMN GV 11 Ramsel
66,Bergstraat 71,2020-05-05,12:00:00,110,48,62,FMN GV 11 Ramsel
66,Bergstraat 71,2020-05-05,13:00:00,172,98,74,FMN GV 11 Ramsel
66,Bergstraat 71,2020-05-05,14:00:00,204,102,102,FMN GV 11 Ramsel
66,Bergstraat 71,2020-05-05,15:00:00,234,124,110,FMN GV 11 Ramsel
66,Bergstraat 71,2020-05-05,16:00:00,202,120,82,FMN GV 11 Ramsel
66,Bergstraat 71,2020-05-05,17:00:00,176,92,84,FMN GV 11 Ramsel
66,Bergstraat 71,2020-05-05,18:00:00,176,78,98,FMN GV 11 Ramsel
66,Bergstraat 71,2020-05-05,19:00:00,76,28,48,FMN GV 11 Ramsel
66,Bergstraat 71,2020-05-05,20:00:00,96,52,44,FMN GV 11 Ramsel
66,Bergstraat 71,2020-05-05,21:00:00,18,8,10,FMN GV 11 Ramsel
66,Bergstraat 71,2020-05-05,22:00:00,10,2,8,FMN GV 11 Ramsel
66,Bergstraat 71,2020-05-05,23:00:00,0,0,0,FMN GV 11 Ramsel
66,Bergstraat 71,2020-05-06,00:00:00,0,0,0,FMN GV 11 Ramsel
66,Bergstraat 71,2020-05-06,01:00:00,0,0,0,FMN GV 11 Ramsel
66,Bergstraat 71,2020-05-06,02:00:00,0,0,0,FMN GV 11 Ramsel
66,Bergstraat 71,2020-05-06,03:00:00,0,0,0,FMN GV 11 Ramsel
66,Bergstraat 71,2020-05-06,04:00:00,4,2,2,FMN GV 11 Ramsel
66,Bergstraat 71,2020-05-06,05:00:00,14,4,10,FMN GV 11 Ramsel
66,Bergstraat 71,2020-05-06,06:00:00,32,16,16,FMN GV 11 Ramsel
66,Bergstraat 71,2020-05-06,07:00:00,42,20,22,FMN GV 11 Ramsel
66,Bergstraat 71,2020-05-06,08:00:00,28,14,14,FMN GV 11 Ramsel
66,Bergstraat 71,2020-05-06,09:00:00,42,12,30,FMN GV 11 Ramsel
66,Bergstraat 71,2020-05-06,10:00:00,106,30,76,FMN GV 11 Ramsel
66,Bergstraat 71,2020-05-06,11:00:00,124,60,64,FMN GV 11 Ramsel
66,Bergstraat 71,2020-05-06,12:00:00,178,78,100,FMN GV 11 Ramsel
66,Bergstraat 71,2020-05-06,13:00:00,254,128,126,FMN GV 11 Ramsel
66,Bergstraat 71,2020-05-06,14:00:00,354,164,190,FMN GV 11 Ramsel
66,Bergstraat 71,2020-05-06,15:00:00,332,194,138,FMN GV 11 Ramsel
66,Bergstraat 71,2020-05-06,16:00:00,348,200,148,FMN GV 11 Ramsel
66,Bergstraat 71,2020-05-06,17:00:00,272,132,140,FMN GV 11 Ramsel
66,Bergstraat 71,2020-05-06,18:00:00,200,92,108,FMN GV 11 Ramsel
66,Bergstraat 71,2020-05-06,19:00:00,126,58,68,FMN GV 11 Ramsel
66,Bergstraat 71,2020-05-06,20:00:00,104,70,34,FMN GV 11 Ramsel
66,Bergstraat 71,2020-05-06,21:00:00,40,20,20,FMN GV 11 Ramsel
66,Bergstraat 71,2020-05-06,22:00:00,8,6,2,FMN GV 11 Ramsel
66,Bergstraat 71,2020-05-06,23:00:00,6,6,0,FMN GV 11 Ramsel
66,Bergstraat 71,2020-05-07,00:00:00,0,0,0,FMN GV 11 Ramsel
66,Bergstraat 71,2020-05-07,01:00:00,0,0,0,FMN GV 11 Ramsel
66,Bergstraat 71,2020-05-07,02:00:00,2,2,0,FMN GV 11 Ramsel
66,Bergstraat 71,2020-05-07,03:00:00,0,0,0,FMN GV 11 Ramsel
66,Bergstraat 71,2020-05-07,04:00:00,6,2,4,FMN GV 11 Ramsel
66,Bergstraat 71,2020-05-07,05:00:00,16,8,8,FMN GV 11 Ramsel
66,Bergstraat 71,2020-05-07,06:00:00,30,14,16,FMN GV 11 Ramsel
66,Bergstraat 71,2020-05-07,07:00:00,44,16,28,FMN GV 11 Ramsel
66,Bergstraat 71,2020-05-07,08:00:00,42,16,26,FMN GV 11 Ramsel
66,Bergstraat 71,2020-05-07,09:00:00,54,16,38,FMN GV 11 Ramsel
66,Bergstraat 71,2020-05-07,10:00:00,110,30,80,FMN GV 11 Ramsel
66,Bergstraat 71,2020-05-07,11:00:00,140,64,76,FMN GV 11 Ramsel
66,Bergstraat 71,2020-05-07,12:00:00,188,76,112,FMN GV 11 Ramsel
66,Bergstraat 71,2020-05-07,13:00:00,382,204,178,FMN GV 11 Ramsel
66,Bergstraat 71,2020-05-07,14:00:00,490,262,228,FMN GV 11 Ramsel
66,Bergstraat 71,2020-05-07,15:00:00,448,226,222,FMN GV 11 Ramsel
66,Bergstraat 71,2020-05-07,16:00:00,426,246,180,FMN GV 11 Ramsel
66,Bergstraat 71,2020-05-07,17:00:00,276,158,118,FMN GV 11 Ramsel
66,Bergstraat 71,2020-05-07,18:00:00,178,84,94,FMN GV 11 Ramsel
66,Bergstraat 71,2020-05-07,19:00:00,114,70,44,FMN GV 11 Ramsel
66,Bergstraat 71,2020-05-07,20:00:00,94,42,52,FMN GV 11 Ramsel
66,Bergstraat 71,2020-05-07,21:00:00,34,12,22,FMN GV 11 Ramsel
66,Bergstraat 71,2020-05-07,22:00:00,14,8,6,FMN GV 11 Ramsel
66,Bergstraat 71,2020-05-07,23:00:00,8,2,6,FMN GV 11 Ramsel
66,Bergstraat 71,2020-05-08,00:00:00,2,2,0,FMN GV 11 Ramsel
66,Bergstraat 71,2020-05-08,01:00:00,2,0,2,FMN GV 11 Ramsel
66,Bergstraat 71,2020-05-08,02:00:00,0,0,0,FMN GV 11 Ramsel
66,Bergstraat 71,2020-05-08,03:00:00,0,0,0,FMN GV 11 Ramsel
66,Bergstraat 71,2020-05-08,04:00:00,4,2,2,FMN GV 11 Ramsel
66,Bergstraat 71,2020-05-08,05:00:00,16,6,10,FMN GV 11 Ramsel
66,Bergstraat 71,2020-05-08,06:00:00,28,16,12,FMN GV 11 Ramsel
66,Bergstraat 71,2020-05-08,07:00:00,44,18,26,FMN GV 11 Ramsel
66,Bergstraat 71,2020-05-08,08:00:00,30,4,26,FMN GV 11 Ramsel
66,Bergstraat 71,2020-05-08,09:00:00,66,32,34,FMN GV 11 Ramsel
66,Bergstraat 71,2020-05-08,10:00:00,130,46,84,FMN GV 11 Ramsel
66,Bergstraat 71,2020-05-08,11:00:00,134,64,70,FMN GV 11 Ramsel
66,Bergstraat 71,2020-05-08,12:00:00,192,94,98,FMN GV 11 Ramsel
66,Bergstraat 71,2020-05-08,13:00:00,340,130,210,FMN GV 11 Ramsel
66,Bergstraat 71,2020-05-08,14:00:00,446,232,214,FMN GV 11 Ramsel
66,Bergstraat 71,2020-05-08,15:00:00,440,260,180,FMN GV 11 Ramsel
66,Bergstraat 71,2020-05-08,16:00:00,350,188,162,FMN GV 11 Ramsel
66,Bergstraat 71,2020-05-08,17:00:00,256,146,110,FMN GV 11 Ramsel
66,Bergstraat 71,2020-05-08,18:00:00,194,104,90,FMN GV 11 Ramsel
66,Bergstraat 71,2020-05-08,19:00:00,100,52,48,FMN GV 11 Ramsel
66,Bergstraat 71,2020-05-08,20:00:00,68,36,32,FMN GV 11 Ramsel
66,Bergstraat 71,2020-05-08,21:00:00,38,20,18,FMN GV 11 Ramsel
66,Bergstraat 71,2020-05-08,22:00:00,12,2,10,FMN GV 11 Ramsel
66,Bergstraat 71,2020-05-08,23:00:00,8,8,0,FMN GV 11 Ramsel
66,Bergstraat 71,2020-05-09,00:00:00,2,2,0,FMN GV 11 Ramsel
66,Bergstraat 71,2020-05-09,01:00:00,4,2,2,FMN GV 11 Ramsel
66,Bergstraat 71,2020-05-09,02:00:00,0,0,0,FMN GV 11 Ramsel
66,Bergstraat 71,2020-05-09,03:00:00,0,0,0,FMN GV 11 Ramsel
66,Bergstraat 71,2020-05-09,04:00:00,0,0,0,FMN GV 11 Ramsel
66,Bergstraat 71,2020-05-09,05:00:00,6,0,6,FMN GV 11 Ramsel
66,Bergstraat 71,2020-05-09,06:00:00,16,6,10,FMN GV 11 Ramsel
66,Bergstraat 71,2020-05-09,07:00:00,24,10,14,FMN GV 11 Ramsel
66,Bergstraat 71,2020-05-09,08:00:00,82,20,62,FMN GV 11 Ramsel
66,Bergstraat 71,2020-05-09,09:00:00,190,74,116,FMN GV 11 Ramsel
66,Bergstraat 71,2020-05-09,10:00:00,272,78,194,FMN GV 11 Ramsel
66,Bergstraat 71,2020-05-09,11:00:00,330,136,194,FMN GV 11 Ramsel
66,Bergstraat 71,2020-05-09,12:00:00,322,176,146,FMN GV 11 Ramsel
66,Bergstraat 71,2020-05-09,13:00:00,576,314,262,FMN GV 11 Ramsel
66,Bergstraat 71,2020-05-09,14:00:00,678,364,314,FMN GV 11 Ramsel
66,Bergstraat 71,2020-05-09,15:00:00,694,364,330,FMN GV 11 Ramsel
66,Bergstraat 71,2020-05-09,16:00:00,562,298,264,FMN GV 11 Ramsel
66,Bergstraat 71,2020-05-09,17:00:00,378,218,160,FMN GV 11 Ramsel
66,Bergstraat 71,2020-05-09,18:00:00,222,128,94,FMN GV 11 Ramsel
66,Bergstraat 71,2020-05-09,19:00:00,160,96,64,FMN GV 11 Ramsel
66,Bergstraat 71,2020-05-09,20:00:00,86,54,32,FMN GV 11 Ramsel
66,Bergstraat 71,2020-05-09,21:00:00,30,6,24,FMN GV 11 Ramsel
66,Bergstraat 71,2020-05-09,22:00:00,16,6,10,FMN GV 11 Ramsel
66,Bergstraat 71,2020-05-09,23:00:00,8,4,4,FMN GV 11 Ramsel
66,Bergstraat 71,2020-05-10,00:00:00,0,0,0,FMN GV 11 Ramsel
66,Bergstraat 71,2020-05-10,01:00:00,2,2,0,FMN GV 11 Ramsel
66,Bergstraat 71,2020-05-10,02:00:00,0,0,0,FMN GV 11 Ramsel
66,Bergstraat 71,2020-05-10,03:00:00,4,4,0,FMN GV 11 Ramsel
66,Bergstraat 71,2020-05-10,04:00:00,2,0,2,FMN GV 11 Ramsel
66,Bergstraat 71,2020-05-10,05:00:00,0,0,0,FMN GV 11 Ramsel
66,Bergstraat 71,2020-05-10,06:00:00,4,2,2,FMN GV 11 Ramsel
66,Bergstraat 71,2020-05-10,07:00:00,34,12,22,FMN GV 11 Ramsel
66,Bergstraat 71,2020-05-10,08:00:00,46,18,28,FMN GV 11 Ramsel
66,Bergstraat 71,2020-05-10,09:00:00,74,30,44,FMN GV 11 Ramsel
66,Bergstraat 71,2020-05-10,10:00:00,78,28,50,FMN GV 11 Ramsel
66,Bergstraat 71,2020-05-10,11:00:00,128,60,68,FMN GV 11 Ramsel
66,Bergstraat 71,2020-05-10,12:00:00,92,54,38,FMN GV 11 Ramsel
66,Bergstraat 71,2020-05-10,13:00:00,130,60,70,FMN GV 11 Ramsel
66,Bergstraat 71,2020-05-10,14:00:00,264,122,142,FMN GV 11 Ramsel
66,Bergstraat 71,2020-05-10,15:00:00,248,142,106,FMN GV 11 Ramsel
66,Bergstraat 71,2020-05-10,16:00:00,212,106,106,FMN GV 11 Ramsel
66,Bergstraat 71,2020-05-10,17:00:00,150,92,58,FMN GV 11 Ramsel
66,Bergstraat 71,2020-05-10,18:00:00,24,14,10,FMN GV 11 Ramsel
66,Bergstraat 71,2020-05-10,19:00:00,32,10,22,FMN GV 11 Ramsel
66,Bergstraat 71,2020-05-10,20:00:00,18,4,14,FMN GV 11 Ramsel
66,Bergstraat 71,2020-05-10,21:00:00,2,2,0,FMN GV 11 Ramsel
66,Bergstraat 71,2020-05-10,22:00:00,2,0,2,FMN GV 11 Ramsel
66,Bergstraat 71,2020-05-10,23:00:00,0,0,0,FMN GV 11 Ramsel
66,Bergstraat 71,2020-05-11,00:00:00,0,0,0,FMN GV 11 Ramsel
66,Bergstraat 71,2020-05-11,01:00:00,0,0,0,FMN GV 11 Ramsel
66,Bergstraat 71,2020-05-11,02:00:00,0,0,0,FMN GV 11 Ramsel
66,Bergstraat 71,2020-05-11,03:00:00,0,0,0,FMN GV 11 Ramsel
66,Bergstraat 71,2020-05-11,04:00:00,4,2,2,FMN GV 11 Ramsel
66,Bergstraat 71,2020-05-11,05:00:00,4,4,0,FMN GV 11 Ramsel
66,Bergstraat 71,2020-05-11,06:00:00,36,20,16,FMN GV 11 Ramsel
66,Bergstraat 71,2020-05-11,07:00:00,22,6,16,FMN GV 11 Ramsel
66,Bergstraat 71,2020-05-11,08:00:00,8,6,2,FMN GV 11 Ramsel
66,Bergstraat 71,2020-05-11,09:00:00,26,12,14,FMN GV 11 Ramsel
66,Bergstraat 71,2020-05-11,10:00:00,26,12,14,FMN GV 11 Ramsel
66,Bergstraat 71,2020-05-11,11:00:00,26,14,12,FMN GV 11 Ramsel
66,Bergstraat 71,2020-05-11,12:00:00,20,12,8,FMN GV 11 Ramsel
66,Bergstraat 71,2020-05-11,13:00:00,52,14,38,FMN GV 11 Ramsel
66,Bergstraat 71,2020-05-11,14:00:00,62,32,30,FMN GV 11 Ramsel
66,Bergstraat 71,2020-05-11,15:00:00,62,34,28,FMN GV 11 Ramsel
66,Bergstraat 71,2020-05-11,16:00:00,60,40,20,FMN GV 11 Ramsel
66,Bergstraat 71,2020-05-11,17:00:00,50,16,34,FMN GV 11 Ramsel
66,Bergstraat 71,2020-05-11,18:00:00,64,38,26,FMN GV 11 Ramsel
66,Bergstraat 71,2020-05-11,19:00:00,34,20,14,FMN GV 11 Ramsel
66,Bergstraat 71,2020-05-11,20:00:00,24,12,12,FMN GV 11 Ramsel
66,Bergstraat 71,2020-05-11,21:00:00,14,10,4,FMN GV 11 Ramsel
66,Bergstraat 71,2020-05-11,22:00:00,14,4,10,FMN GV 11 Ramsel
66,Bergstraat 71,2020-05-11,23:00:00,0,0,0,FMN GV 11 Ramsel
66,Bergstraat 71,2020-05-12,00:00:00,0,0,0,FMN GV 11 Ramsel
66,Bergstraat 71,2020-05-12,01:00:00,0,0,0,FMN GV 11 Ramsel
66,Bergstraat 71,2020-05-12,02:00:00,0,0,0,FMN GV 11 Ramsel
66,Bergstraat 71,2020-05-12,03:00:00,0,0,0,FMN GV 11 Ramsel
66,Bergstraat 71,2020-05-12,04:00:00,6,2,4,FMN GV 11 Ramsel
66,Bergstraat 71,2020-05-12,05:00:00,10,4,6,FMN GV 11 Ramsel
66,Bergstraat 71,2020-05-12,06:00:00,38,20,18,FMN GV 11 Ramsel
66,Bergstraat 71,2020-05-12,07:00:00,36,14,22,FMN GV 11 Ramsel
66,Bergstraat 71,2020-05-12,08:00:00,44,14,30,FMN GV 11 Ramsel
66,Bergstraat 71,2020-05-12,09:00:00,54,24,30,FMN GV 11 Ramsel
66,Bergstraat 71,2020-05-12,10:00:00,58,14,44,FMN GV 11 Ramsel
66,Bergstraat 71,2020-05-12,11:00:00,82,48,34,FMN GV 11 Ramsel
66,Bergstraat 71,2020-05-12,12:00:00,92,58,34,FMN GV 11 Ramsel
66,Bergstraat 71,2020-05-12,13:00:00,136,76,60,FMN GV 11 Ramsel
66,Bergstraat 71,2020-05-12,14:00:00,172,78,94,FMN GV 11 Ramsel
66,Bergstraat 71,2020-05-12,15:00:00,184,110,74,FMN GV 11 Ramsel
66,Bergstraat 71,2020-05-12,16:00:00,176,104,72,FMN GV 11 Ramsel
66,Bergstraat 71,2020-05-12,17:00:00,150,94,56,FMN GV 11 Ramsel
66,Bergstraat 71,2020-05-12,18:00:00,100,42,58,FMN GV 11 Ramsel
66,Bergstraat 71,2020-05-12,19:00:00,78,32,46,FMN GV 11 Ramsel
66,Bergstraat 71,2020-05-12,20:00:00,52,36,16,FMN GV 11 Ramsel
66,Bergstraat 71,2020-05-12,21:00:00,14,6,8,FMN GV 11 Ramsel
66,Bergstraat 71,2020-05-12,22:00:00,12,4,8,FMN GV 11 Ramsel
66,Bergstraat 71,2020-05-12,23:00:00,4,2,2,FMN GV 11 Ramsel
66,Bergstraat 71,2020-05-13,00:00:00,0,0,0,FMN GV 11 Ramsel
66,Bergstraat 71,2020-05-13,01:00:00,0,0,0,FMN GV 11 Ramsel
66,Bergstraat 71,2020-05-13,02:00:00,0,0,0,FMN GV 11 Ramsel
66,Bergstraat 71,2020-05-13,03:00:00,0,0,0,FMN GV 11 Ramsel
66,Bergstraat 71,2020-05-13,04:00:00,2,2,0,FMN GV 11 Ramsel
66,Bergstraat 71,2020-05-13,05:00:00,10,6,4,FMN GV 11 Ramsel
66,Bergstraat 71,2020-05-13,06:00:00,32,18,14,FMN GV 11 Ramsel
66,Bergstraat 71,2020-05-13,07:00:00,26,10,16,FMN GV 11 Ramsel
66,Bergstraat 71,2020-05-13,08:00:00,24,8,16,FMN GV 11 Ramsel
66,Bergstraat 71,2020-05-13,09:00:00,52,20,32,FMN GV 11 Ramsel
66,Bergstraat 71,2020-05-13,10:00:00,74,32,42,FMN GV 11 Ramsel
66,Bergstraat 71,2020-05-13,11:00:00,92,46,46,FMN GV 11 Ramsel
66,Bergstraat 71,2020-05-13,12:00:00,102,52,50,FMN GV 11 Ramsel
66,Bergstraat 71,2020-05-13,13:00:00,126,64,62,FMN GV 11 Ramsel
66,Bergstraat 71,2020-05-13,14:00:00,162,88,74,FMN GV 11 Ramsel
66,Bergstraat 71,2020-05-13,15:00:00,190,106,84,FMN GV 11 Ramsel
66,Bergstraat 71,2020-05-13,16:00:00,154,88,66,FMN GV 11 Ramsel
66,Bergstraat 71,2020-05-13,17:00:00,114,64,50,FMN GV 11 Ramsel
66,Bergstraat 71,2020-05-13,18:00:00,90,38,52,FMN GV 11 Ramsel
66,Bergstraat 71,2020-05-13,19:00:00,52,36,16,FMN GV 11 Ramsel
66,Bergstraat 71,2020-05-13,20:00:00,64,40,24,FMN GV 11 Ramsel
66,Bergstraat 71,2020-05-13,21:00:00,14,8,6,FMN GV 11 Ramsel
66,Bergstraat 71,2020-05-13,22:00:00,10,8,2,FMN GV 11 Ramsel
66,Bergstraat 71,2020-05-13,23:00:00,4,4,0,FMN GV 11 Ramsel
66,Bergstraat 71,2020-05-14,00:00:00,0,0,0,FMN GV 11 Ramsel
66,Bergstraat 71,2020-05-14,01:00:00,2,2,0,FMN GV 11 Ramsel
66,Bergstraat 71,2020-05-14,02:00:00,0,0,0,FMN GV 11 Ramsel
66,Bergstraat 71,2020-05-14,03:00:00,0,0,0,FMN GV 11 Ramsel
66,Bergstraat 71,2020-05-14,04:00:00,6,2,4,FMN GV 11 Ramsel
66,Bergstraat 71,2020-05-14,05:00:00,10,4,6,FMN GV 11 Ramsel
66,Bergstraat 71,2020-05-14,06:00:00,28,18,10,FMN GV 11 Ramsel
66,Bergstraat 71,2020-05-14,07:00:00,38,16,22,FMN GV 11 Ramsel
66,Bergstraat 71,2020-05-14,08:00:00,28,8,20,FMN GV 11 Ramsel
66,Bergstraat 71,2020-05-14,09:00:00,52,20,32,FMN GV 11 Ramsel
66,Bergstraat 71,2020-05-14,10:00:00,76,22,54,FMN GV 11 Ramsel
66,Bergstraat 71,2020-05-14,11:00:00,82,44,38,FMN GV 11 Ramsel
66,Bergstraat 71,2020-05-14,12:00:00,78,38,40,FMN GV 11 Ramsel
66,Bergstraat 71,2020-05-14,13:00:00,134,68,66,FMN GV 11 Ramsel
66,Bergstraat 71,2020-05-14,14:00:00,202,104,98,FMN GV 11 Ramsel
66,Bergstraat 71,2020-05-14,15:00:00,212,122,90,FMN GV 11 Ramsel
66,Bergstraat 71,2020-05-14,16:00:00,180,94,86,FMN GV 11 Ramsel
66,Bergstraat 71,2020-05-14,17:00:00,146,86,60,FMN GV 11 Ramsel
66,Bergstraat 71,2020-05-14,18:00:00,100,56,44,FMN GV 11 Ramsel
66,Bergstraat 71,2020-05-14,19:00:00,92,52,40,FMN GV 11 Ramsel
66,Bergstraat 71,2020-05-14,20:00:00,66,26,40,FMN GV 11 Ramsel
66,Bergstraat 71,2020-05-14,21:00:00,28,14,14,FMN GV 11 Ramsel
66,Bergstraat 71,2020-05-14,22:00:00,16,8,8,FMN GV 11 Ramsel
66,Bergstraat 71,2020-05-14,23:00:00,0,0,0,FMN GV 11 Ramsel
66,Bergstraat 71,2020-05-15,00:00:00,0,0,0,FMN GV 11 Ramsel
66,Bergstraat 71,2020-05-15,01:00:00,0,0,0,FMN GV 11 Ramsel
66,Bergstraat 71,2020-05-15,02:00:00,0,0,0,FMN GV 11 Ramsel
66,Bergstraat 71,2020-05-15,03:00:00,0,0,0,FMN GV 11 Ramsel
66,Bergstraat 71,2020-05-15,04:00:00,6,2,4,FMN GV 11 Ramsel
66,Bergstraat 71,2020-05-15,05:00:00,10,8,2,FMN GV 11 Ramsel
66,Bergstraat 71,2020-05-15,06:00:00,34,18,16,FMN GV 11 Ramsel
66,Bergstraat 71,2020-05-15,07:00:00,24,6,18,FMN GV 11 Ramsel
66,Bergstraat 71,2020-05-15,08:00:00,60,16,44,FMN GV 11 Ramsel
66,Bergstraat 71,2020-05-15,09:00:00,56,26,30,FMN GV 11 Ramsel
66,Bergstraat 71,2020-05-15,10:00:00,72,32,40,FMN GV 11 Ramsel
66,Bergstraat 71,2020-05-15,11:00:00,106,42,64,FMN GV 11 Ramsel
66,Bergstraat 71,2020-05-15,12:00:00,132,56,76,FMN GV 11 Ramsel
66,Bergstraat 71,2020-05-15,13:00:00,226,116,110,FMN GV 11 Ramsel
66,Bergstraat 71,2020-05-15,14:00:00,260,114,146,FMN GV 11 Ramsel
66,Bergstraat 71,2020-05-15,15:00:00,292,158,134,FMN GV 11 Ramsel
66,Bergstraat 71,2020-05-15,16:00:00,224,132,92,FMN GV 11 Ramsel
66,Bergstraat 71,2020-05-15,17:00:00,160,88,72,FMN GV 11 Ramsel
66,Bergstraat 71,2020-05-15,18:00:00,116,62,54,FMN GV 11 Ramsel
66,Bergstraat 71,2020-05-15,19:00:00,50,26,24,FMN GV 11 Ramsel
66,Bergstraat 71,2020-05-15,20:00:00,72,42,30,FMN GV 11 Ramsel
66,Bergstraat 71,2020-05-15,21:00:00,28,16,12,FMN GV 11 Ramsel
66,Bergstraat 71,2020-05-15,22:00:00,22,10,12,FMN GV 11 Ramsel
66,Bergstraat 71,2020-05-15,23:00:00,6,6,0,FMN GV 11 Ramsel
66,Bergstraat 71,2020-05-16,00:00:00,6,6,0,FMN GV 11 Ramsel
66,Bergstraat 71,2020-05-16,01:00:00,4,0,4,FMN GV 11 Ramsel
66,Bergstraat 71,2020-05-16,02:00:00,2,0,2,FMN GV 11 Ramsel
66,Bergstraat 71,2020-05-16,03:00:00,0,0,0,FMN GV 11 Ramsel
66,Bergstraat 71,2020-05-16,04:00:00,0,0,0,FMN GV 11 Ramsel
66,Bergstraat 71,2020-05-16,05:00:00,4,2,2,FMN GV 11 Ramsel
66,Bergstraat 71,2020-05-16,06:00:00,2,2,0,FMN GV 11 Ramsel
66,Bergstraat 71,2020-05-16,07:00:00,18,6,12,FMN GV 11 Ramsel
66,Bergstraat 71,2020-05-16,08:00:00,38,16,22,FMN GV 11 Ramsel
66,Bergstraat 71,2020-05-16,09:00:00,138,32,106,FMN GV 11 Ramsel
66,Bergstraat 71,2020-05-16,10:00:00,196,92,104,FMN GV 11 Ramsel
66,Bergstraat 71,2020-05-16,11:00:00,168,72,96,FMN GV 11 Ramsel
66,Bergstraat 71,2020-05-16,12:00:00,230,96,134,FMN GV 11 Ramsel
66,Bergstraat 71,2020-05-16,13:00:00,328,164,164,FMN GV 11 Ramsel
66,Bergstraat 71,2020-05-16,14:00:00,398,184,214,FMN GV 11 Ramsel
66,Bergstraat 71,2020-05-16,15:00:00,416,282,134,FMN GV 11 Ramsel
66,Bergstraat 71,2020-05-16,16:00:00,320,192,128,FMN GV 11 Ramsel
66,Bergstraat 71,2020-05-16,17:00:00,248,148,100,FMN GV 11 Ramsel
66,Bergstraat 71,2020-05-16,18:00:00,90,48,42,FMN GV 11 Ramsel
66,Bergstraat 71,2020-05-16,19:00:00,42,22,20,FMN GV 11 Ramsel
66,Bergstraat 71,2020-05-16,20:00:00,44,28,16,FMN GV 11 Ramsel
66,Bergstraat 71,2020-05-16,21:00:00,40,10,30,FMN GV 11 Ramsel
66,Bergstraat 71,2020-05-16,22:00:00,12,10,2,FMN GV 11 Ramsel
66,Bergstraat 71,2020-05-16,23:00:00,2,2,0,FMN GV 11 Ramsel
66,Bergstraat 71,2020-05-17,00:00:00,4,2,2,FMN GV 11 Ramsel
66,Bergstraat 71,2020-05-17,01:00:00,2,2,0,FMN GV 11 Ramsel
66,Bergstraat 71,2020-05-17,02:00:00,4,0,4,FMN GV 11 Ramsel
66,Bergstraat 71,2020-05-17,03:00:00,2,2,0,FMN GV 11 Ramsel
66,Bergstraat 71,2020-05-17,04:00:00,0,0,0,FMN GV 11 Ramsel
66,Bergstraat 71,2020-05-17,05:00:00,0,0,0,FMN GV 11 Ramsel
66,Bergstraat 71,2020-05-17,06:00:00,12,6,6,FMN GV 11 Ramsel
66,Bergstraat 71,2020-05-17,07:00:00,38,4,34,FMN GV 11 Ramsel
66,Bergstraat 71,2020-05-17,08:00:00,86,24,62,FMN GV 11 Ramsel
66,Bergstraat 71,2020-05-17,09:00:00,226,56,170,FMN GV 11 Ramsel
66,Bergstraat 71,2020-05-17,10:00:00,434,200,234,FMN GV 11 Ramsel
66,Bergstraat 71,2020-05-17,11:00:00,424,210,214,FMN GV 11 Ramsel
66,Bergstraat 71,2020-05-17,12:00:00,304,158,146,FMN GV 11 Ramsel
66,Bergstraat 71,2020-05-17,13:00:00,478,258,220,FMN GV 11 Ramsel
66,Bergstraat 71,2020-05-17,14:00:00,640,348,292,FMN GV 11 Ramsel
66,Bergstraat 71,2020-05-17,15:00:00,514,284,230,FMN GV 11 Ramsel
66,Bergstraat 71,2020-05-17,16:00:00,448,230,218,FMN GV 11 Ramsel
66,Bergstraat 71,2020-05-17,17:00:00,354,198,156,FMN GV 11 Ramsel
66,Bergstraat 71,2020-05-17,18:00:00,152,70,82,FMN GV 11 Ramsel
66,Bergstraat 71,2020-05-17,19:00:00,98,56,42,FMN GV 11 Ramsel
66,Bergstraat 71,2020-05-17,20:00:00,64,30,34,FMN GV 11 Ramsel
66,Bergstraat 71,2020-05-17,21:00:00,20,14,6,FMN GV 11 Ramsel
66,Bergstraat 71,2020-05-17,22:00:00,14,10,4,FMN GV 11 Ramsel
66,Bergstraat 71,2020-05-17,23:00:00,0,0,0,FMN GV 11 Ramsel
66,Bergstraat 71,2020-05-18,00:00:00,2,0,2,FMN GV 11 Ramsel
66,Bergstraat 71,2020-05-18,01:00:00,0,0,0,FMN GV 11 Ramsel
66,Bergstraat 71,2020-05-18,02:00:00,0,0,0,FMN GV 11 Ramsel
66,Bergstraat 71,2020-05-18,03:00:00,0,0,0,FMN GV 11 Ramsel
66,Bergstraat 71,2020-05-18,04:00:00,4,4,0,FMN GV 11 Ramsel
66,Bergstraat 71,2020-05-18,05:00:00,10,4,6,FMN GV 11 Ramsel
66,Bergstraat 71,2020-05-18,06:00:00,36,16,20,FMN GV 11 Ramsel
66,Bergstraat 71,2020-05-18,07:00:00,78,20,58,FMN GV 11 Ramsel
66,Bergstraat 71,2020-05-18,08:00:00,76,30,46,FMN GV 11 Ramsel
66,Bergstraat 71,2020-05-18,09:00:00,26,8,18,FMN GV 11 Ramsel
66,Bergstraat 71,2020-05-18,10:00:00,98,50,48,FMN GV 11 Ramsel
66,Bergstraat 71,2020-05-18,11:00:00,66,26,40,FMN GV 11 Ramsel
66,Bergstraat 71,2020-05-18,12:00:00,110,64,46,FMN GV 11 Ramsel
66,Bergstraat 71,2020-05-18,13:00:00,174,60,114,FMN GV 11 Ramsel
66,Bergstraat 71,2020-05-18,14:00:00,246,126,120,FMN GV 11 Ramsel
66,Bergstraat 71,2020-05-18,15:00:00,284,182,102,FMN GV 11 Ramsel
66,Bergstraat 71,2020-05-18,16:00:00,274,138,136,FMN GV 11 Ramsel
66,Bergstraat 71,2020-05-18,17:00:00,150,74,76,FMN GV 11 Ramsel
66,Bergstraat 71,2020-05-18,18:00:00,134,62,72,FMN GV 11 Ramsel
66,Bergstraat 71,2020-05-18,19:00:00,124,76,48,FMN GV 11 Ramsel
66,Bergstraat 71,2020-05-18,20:00:00,76,36,40,FMN GV 11 Ramsel
66,Bergstraat 71,2020-05-18,21:00:00,26,10,16,FMN GV 11 Ramsel
66,Bergstraat 71,2020-05-18,22:00:00,14,6,8,FMN GV 11 Ramsel
66,Bergstraat 71,2020-05-18,23:00:00,4,4,0,FMN GV 11 Ramsel
66,Bergstraat 71,2020-05-19,00:00:00,0,0,0,FMN GV 11 Ramsel
66,Bergstraat 71,2020-05-19,01:00:00,0,0,0,FMN GV 11 Ramsel
66,Bergstraat 71,2020-05-19,02:00:00,0,0,0,FMN GV 11 Ramsel
66,Bergstraat 71,2020-05-19,03:00:00,0,0,0,FMN GV 11 Ramsel
66,Bergstraat 71,2020-05-19,04:00:00,6,2,4,FMN GV 11 Ramsel
66,Bergstraat 71,2020-05-19,05:00:00,4,0,4,FMN GV 11 Ramsel
66,Bergstraat 71,2020-05-19,06:00:00,42,24,18,FMN GV 11 Ramsel
66,Bergstraat 71,2020-05-19,07:00:00,64,28,36,FMN GV 11 Ramsel
66,Bergstraat 71,2020-05-19,08:00:00,78,24,54,FMN GV 11 Ramsel
66,Bergstraat 71,2020-05-19,09:00:00,84,28,56,FMN GV 11 Ramsel
66,Bergstraat 71,2020-05-19,10:00:00,124,42,82,FMN GV 11 Ramsel
66,Bergstraat 71,2020-05-19,11:00:00,76,30,46,FMN GV 11 Ramsel
66,Bergstraat 71,2020-05-19,12:00:00,178,102,76,FMN GV 11 Ramsel
66,Bergstraat 71,2020-05-19,13:00:00,248,114,134,FMN GV 11 Ramsel
66,Bergstraat 71,2020-05-19,14:00:00,344,152,192,FMN GV 11 Ramsel
66,Bergstraat 71,2020-05-19,15:00:00,372,228,144,FMN GV 11 Ramsel
66,Bergstraat 71,2020-05-19,16:00:00,264,134,130,FMN GV 11 Ramsel
66,Bergstraat 71,2020-05-19,17:00:00,208,106,102,FMN GV 11 Ramsel
66,Bergstraat 71,2020-05-19,18:00:00,164,82,82,FMN GV 11 Ramsel
66,Bergstraat 71,2020-05-19,19:00:00,168,102,66,FMN GV 11 Ramsel
66,Bergstraat 71,2020-05-19,20:00:00,126,62,64,FMN GV 11 Ramsel
66,Bergstraat 71,2020-05-19,21:00:00,42,22,20,FMN GV 11 Ramsel
66,Bergstraat 71,2020-05-19,22:00:00,14,10,4,FMN GV 11 Ramsel
66,Bergstraat 71,2020-05-19,23:00:00,2,2,0,FMN GV 11 Ramsel
66,Bergstraat 71,2020-05-20,00:00:00,2,2,0,FMN GV 11 Ramsel
66,Bergstraat 71,2020-05-20,01:00:00,0,0,0,FMN GV 11 Ramsel
66,Bergstraat 71,2020-05-20,02:00:00,0,0,0,FMN GV 11 Ramsel
66,Bergstraat 71,2020-05-20,03:00:00,0,0,0,FMN GV 11 Ramsel
66,Bergstraat 71,2020-05-20,04:00:00,2,2,0,FMN GV 11 Ramsel
66,Bergstraat 71,2020-05-20,05:00:00,8,2,6,FMN GV 11 Ramsel
66,Bergstraat 71,2020-05-20,06:00:00,30,18,12,FMN GV 11 Ramsel
66,Bergstraat 71,2020-05-20,07:00:00,50,24,26,FMN GV 11 Ramsel
66,Bergstraat 71,2020-05-20,08:00:00,72,32,40,FMN GV 11 Ramsel
66,Bergstraat 71,2020-05-20,09:00:00,72,22,50,FMN GV 11 Ramsel
66,Bergstraat 71,2020-05-20,10:00:00,170,92,78,FMN GV 11 Ramsel
66,Bergstraat 71,2020-05-20,11:00:00,122,60,62,FMN GV 11 Ramsel
66,Bergstraat 71,2020-05-20,12:00:00,176,94,82,FMN GV 11 Ramsel
66,Bergstraat 71,2020-05-20,13:00:00,272,128,144,FMN GV 11 Ramsel
66,Bergstraat 71,2020-05-20,14:00:00,368,178,190,FMN GV 11 Ramsel
66,Bergstraat 71,2020-05-20,15:00:00,340,192,148,FMN GV 11 Ramsel
66,Bergstraat 71,2020-05-20,16:00:00,276,122,154,FMN GV 11 Ramsel
66,Bergstraat 71,2020-05-20,17:00:00,190,122,68,FMN GV 11 Ramsel
66,Bergstraat 71,2020-05-20,18:00:00,130,52,78,FMN GV 11 Ramsel
66,Bergstraat 71,2020-05-20,19:00:00,114,66,48,FMN GV 11 Ramsel
66,Bergstraat 71,2020-05-20,20:00:00,112,60,52,FMN GV 11 Ramsel
66,Bergstraat 71,2020-05-20,21:00:00,58,46,12,FMN GV 11 Ramsel
66,Bergstraat 71,2020-05-20,22:00:00,20,12,8,FMN GV 11 Ramsel
66,Bergstraat 71,2020-05-20,23:00:00,6,4,2,FMN GV 11 Ramsel
66,Bergstraat 71,2020-05-21,00:00:00,2,2,0,FMN GV 11 Ramsel
66,Bergstraat 71,2020-05-21,01:00:00,4,0,4,FMN GV 11 Ramsel
66,Bergstraat 71,2020-05-21,02:00:00,6,4,2,FMN GV 11 Ramsel
66,Bergstraat 71,2020-05-21,03:00:00,8,6,2,FMN GV 11 Ramsel
66,Bergstraat 71,2020-05-21,04:00:00,2,0,2,FMN GV 11 Ramsel
66,Bergstraat 71,2020-05-21,05:00:00,0,0,0,FMN GV 11 Ramsel
66,Bergstraat 71,2020-05-21,06:00:00,14,4,10,FMN GV 11 Ramsel
66,Bergstraat 71,2020-05-21,07:00:00,36,14,22,FMN GV 11 Ramsel
66,Bergstraat 71,2020-05-21,08:00:00,142,48,94,FMN GV 11 Ramsel
66,Bergstraat 71,2020-05-21,09:00:00,324,156,168,FMN GV 11 Ramsel
66,Bergstraat 71,2020-05-21,10:00:00,442,154,288,FMN GV 11 Ramsel
66,Bergstraat 71,2020-05-21,11:00:00,524,260,264,FMN GV 11 Ramsel
66,Bergstraat 71,2020-05-21,12:00:00,380,198,182,FMN GV 11 Ramsel
66,Bergstraat 71,2020-05-21,13:00:00,586,298,288,FMN GV 11 Ramsel
66,Bergstraat 71,2020-05-21,14:00:00,662,334,328,FMN GV 11 Ramsel
66,Bergstraat 71,2020-05-21,15:00:00,596,338,258,FMN GV 11 Ramsel
66,Bergstraat 71,2020-05-21,16:00:00,448,218,230,FMN GV 11 Ramsel
66,Bergstraat 71,2020-05-21,17:00:00,282,172,110,FMN GV 11 Ramsel
66,Bergstraat 71,2020-05-21,18:00:00,182,86,96,FMN GV 11 Ramsel
66,Bergstraat 71,2020-05-21,19:00:00,134,80,54,FMN GV 11 Ramsel
66,Bergstraat 71,2020-05-21,20:00:00,164,92,72,FMN GV 11 Ramsel
66,Bergstraat 71,2020-05-21,21:00:00,54,32,22,FMN GV 11 Ramsel
66,Bergstraat 71,2020-05-21,22:00:00,44,22,22,FMN GV 11 Ramsel
66,Bergstraat 71,2020-05-21,23:00:00,0,0,0,FMN GV 11 Ramsel
66,Bergstraat 71,2020-05-22,00:00:00,4,4,0,FMN GV 11 Ramsel
66,Bergstraat 71,2020-05-22,01:00:00,2,0,2,FMN GV 11 Ramsel
66,Bergstraat 71,2020-05-22,02:00:00,2,2,0,FMN GV 11 Ramsel
66,Bergstraat 71,2020-05-22,03:00:00,2,2,0,FMN GV 11 Ramsel
66,Bergstraat 71,2020-05-22,04:00:00,0,0,0,FMN GV 11 Ramsel
66,Bergstraat 71,2020-05-22,05:00:00,4,2,2,FMN GV 11 Ramsel
66,Bergstraat 71,2020-05-22,06:00:00,28,16,12,FMN GV 11 Ramsel
66,Bergstraat 71,2020-05-22,07:00:00,38,12,26,FMN GV 11 Ramsel
66,Bergstraat 71,2020-05-22,08:00:00,40,12,28,FMN GV 11 Ramsel
66,Bergstraat 71,2020-05-22,09:00:00,78,32,46,FMN GV 11 Ramsel
66,Bergstraat 71,2020-05-22,10:00:00,156,70,86,FMN GV 11 Ramsel
66,Bergstraat 71,2020-05-22,11:00:00,172,92,80,FMN GV 11 Ramsel
66,Bergstraat 71,2020-05-22,12:00:00,144,56,88,FMN GV 11 Ramsel
66,Bergstraat 71,2020-05-22,13:00:00,232,100,132,FMN GV 11 Ramsel
66,Bergstraat 71,2020-05-22,14:00:00,276,120,156,FMN GV 11 Ramsel
66,Bergstraat 71,2020-05-22,15:00:00,272,170,102,FMN GV 11 Ramsel
66,Bergstraat 71,2020-05-22,16:00:00,136,90,46,FMN GV 11 Ramsel
66,Bergstraat 71,2020-05-22,17:00:00,90,40,50,FMN GV 11 Ramsel
66,Bergstraat 71,2020-05-22,18:00:00,92,58,34,FMN GV 11 Ramsel
66,Bergstraat 71,2020-05-22,19:00:00,80,36,44,FMN GV 11 Ramsel
66,Bergstraat 71,2020-05-22,20:00:00,52,28,24,FMN GV 11 Ramsel
66,Bergstraat 71,2020-05-22,21:00:00,40,22,18,FMN GV 11 Ramsel
66,Bergstraat 71,2020-05-22,22:00:00,20,4,16,FMN GV 11 Ramsel
66,Bergstraat 71,2020-05-22,23:00:00,8,4,4,FMN GV 11 Ramsel
66,Bergstraat 71,2020-05-23,00:00:00,0,0,0,FMN GV 11 Ramsel
66,Bergstraat 71,2020-05-23,01:00:00,0,0,0,FMN GV 11 Ramsel
66,Bergstraat 71,2020-05-23,02:00:00,2,2,0,FMN GV 11 Ramsel
66,Bergstraat 71,2020-05-23,03:00:00,0,0,0,FMN GV 11 Ramsel
66,Bergstraat 71,2020-05-23,04:00:00,0,0,0,FMN GV 11 Ramsel
66,Bergstraat 71,2020-05-23,05:00:00,2,2,0,FMN GV 11 Ramsel
66,Bergstraat 71,2020-05-23,06:00:00,12,4,8,FMN GV 11 Ramsel
66,Bergstraat 71,2020-05-23,07:00:00,28,6,22,FMN GV 11 Ramsel
66,Bergstraat 71,2020-05-23,08:00:00,28,8,20,FMN GV 11 Ramsel
66,Bergstraat 71,2020-05-23,09:00:00,58,18,40,FMN GV 11 Ramsel
66,Bergstraat 71,2020-05-23,10:00:00,80,26,54,FMN GV 11 Ramsel
66,Bergstraat 71,2020-05-23,11:00:00,98,36,62,FMN GV 11 Ramsel
66,Bergstraat 71,2020-05-23,12:00:00,130,92,38,FMN GV 11 Ramsel
66,Bergstraat 71,2020-05-23,13:00:00,218,98,120,FMN GV 11 Ramsel
66,Bergstraat 71,2020-05-23,14:00:00,238,122,116,FMN GV 11 Ramsel
66,Bergstraat 71,2020-05-23,15:00:00,344,188,156,FMN GV 11 Ramsel
66,Bergstraat 71,2020-05-23,16:00:00,186,116,70,FMN GV 11 Ramsel
66,Bergstraat 71,2020-05-23,17:00:00,118,62,56,FMN GV 11 Ramsel
66,Bergstraat 71,2020-05-23,18:00:00,74,40,34,FMN GV 11 Ramsel
66,Bergstraat 71,2020-05-23,19:00:00,38,10,28,FMN GV 11 Ramsel
66,Bergstraat 71,2020-05-23,20:00:00,58,38,20,FMN GV 11 Ramsel
66,Bergstraat 71,2020-05-23,21:00:00,20,16,4,FMN GV 11 Ramsel
66,Bergstraat 71,2020-05-23,22:00:00,20,12,8,FMN GV 11 Ramsel
66,Bergstraat 71,2020-05-23,23:00:00,4,4,0,FMN GV 11 Ramsel
66,Bergstraat 71,2020-05-24,00:00:00,8,6,2,FMN GV 11 Ramsel
66,Bergstraat 71,2020-05-24,01:00:00,2,0,2,FMN GV 11 Ramsel
66,Bergstraat 71,2020-05-24,02:00:00,0,0,0,FMN GV 11 Ramsel
66,Bergstraat 71,2020-05-24,03:00:00,2,2,0,FMN GV 11 Ramsel
66,Bergstraat 71,2020-05-24,04:00:00,2,0,2,FMN GV 11 Ramsel
66,Bergstraat 71,2020-05-24,05:00:00,4,2,2,FMN GV 11 Ramsel
66,Bergstraat 71,2020-05-24,06:00:00,8,4,4,FMN GV 11 Ramsel
66,Bergstraat 71,2020-05-24,07:00:00,20,10,10,FMN GV 11 Ramsel
66,Bergstraat 71,2020-05-24,08:00:00,124,40,84,FMN GV 11 Ramsel
66,Bergstraat 71,2020-05-24,09:00:00,230,64,166,FMN GV 11 Ramsel
66,Bergstraat 71,2020-05-24,10:00:00,308,186,122,FMN GV 11 Ramsel
66,Bergstraat 71,2020-05-24,11:00:00,334,220,114,FMN GV 11 Ramsel
66,Bergstraat 71,2020-05-24,12:00:00,166,108,58,FMN GV 11 Ramsel
66,Bergstraat 71,2020-05-24,13:00:00,182,64,118,FMN GV 11 Ramsel
66,Bergstraat 71,2020-05-24,14:00:00,228,134,94,FMN GV 11 Ramsel
66,Bergstraat 71,2020-05-24,15:00:00,266,140,126,FMN GV 11 Ramsel
66,Bergstraat 71,2020-05-24,16:00:00,218,136,82,FMN GV 11 Ramsel
66,Bergstraat 71,2020-05-24,17:00:00,114,62,52,FMN GV 11 Ramsel
66,Bergstraat 71,2020-05-24,18:00:00,86,50,36,FMN GV 11 Ramsel
66,Bergstraat 71,2020-05-24,19:00:00,34,24,10,FMN GV 11 Ramsel
66,Bergstraat 71,2020-05-24,20:00:00,30,8,22,FMN GV 11 Ramsel
66,Bergstraat 71,2020-05-24,21:00:00,18,2,16,FMN GV 11 Ramsel
66,Bergstraat 71,2020-05-24,22:00:00,2,0,2,FMN GV 11 Ramsel
66,Bergstraat 71,2020-05-24,23:00:00,6,4,2,FMN GV 11 Ramsel
66,Bergstraat 71,2020-05-25,00:00:00,0,0,0,FMN GV 11 Ramsel
66,Bergstraat 71,2020-05-25,01:00:00,0,0,0,FMN GV 11 Ramsel
66,Bergstraat 71,2020-05-25,02:00:00,0,0,0,FMN GV 11 Ramsel
66,Bergstraat 71,2020-05-25,03:00:00,0,0,0,FMN GV 11 Ramsel
66,Bergstraat 71,2020-05-25,04:00:00,4,2,2,FMN GV 11 Ramsel
66,Bergstraat 71,2020-05-25,05:00:00,18,12,6,FMN GV 11 Ramsel
66,Bergstraat 71,2020-05-25,06:00:00,32,16,16,FMN GV 11 Ramsel
66,Bergstraat 71,2020-05-25,07:00:00,58,8,50,FMN GV 11 Ramsel
66,Bergstraat 71,2020-05-25,08:00:00,72,16,56,FMN GV 11 Ramsel
66,Bergstraat 71,2020-05-25,09:00:00,70,22,48,FMN GV 11 Ramsel
66,Bergstraat 71,2020-05-25,10:00:00,74,32,42,FMN GV 11 Ramsel
66,Bergstraat 71,2020-05-25,11:00:00,82,44,38,FMN GV 11 Ramsel
66,Bergstraat 71,2020-05-25,12:00:00,116,52,64,FMN GV 11 Ramsel
66,Bergstraat 71,2020-05-25,13:00:00,166,92,74,FMN GV 11 Ramsel
66,Bergstraat 71,2020-05-25,14:00:00,232,116,116,FMN GV 11 Ramsel
66,Bergstraat 71,2020-05-25,15:00:00,290,168,122,FMN GV 11 Ramsel
66,Bergstraat 71,2020-05-25,16:00:00,224,134,90,FMN GV 11 Ramsel
66,Bergstraat 71,2020-05-25,17:00:00,134,82,52,FMN GV 11 Ramsel
66,Bergstraat 71,2020-05-25,18:00:00,116,68,48,FMN GV 11 Ramsel
66,Bergstraat 71,2020-05-25,19:00:00,108,64,44,FMN GV 11 Ramsel
66,Bergstraat 71,2020-05-25,20:00:00,84,42,42,FMN GV 11 Ramsel
66,Bergstraat 71,2020-05-25,21:00:00,42,24,18,FMN GV 11 Ramsel
66,Bergstraat 71,2020-05-25,22:00:00,10,4,6,FMN GV 11 Ramsel
66,Bergstraat 71,2020-05-25,23:00:00,0,0,0,FMN GV 11 Ramsel
66,Bergstraat 71,2020-05-26,00:00:00,0,0,0,FMN GV 11 Ramsel
66,Bergstraat 71,2020-05-26,01:00:00,0,0,0,FMN GV 11 Ramsel
66,Bergstraat 71,2020-05-26,02:00:00,0,0,0,FMN GV 11 Ramsel
66,Bergstraat 71,2020-05-26,03:00:00,0,0,0,FMN GV 11 Ramsel
66,Bergstraat 71,2020-05-26,04:00:00,6,2,4,FMN GV 11 Ramsel
66,Bergstraat 71,2020-05-26,05:00:00,18,6,12,FMN GV 11 Ramsel
66,Bergstraat 71,2020-05-26,06:00:00,36,18,18,FMN GV 11 Ramsel
66,Bergstraat 71,2020-05-26,07:00:00,62,22,40,FMN GV 11 Ramsel
66,Bergstraat 71,2020-05-26,08:00:00,70,16,54,FMN GV 11 Ramsel
66,Bergstraat 71,2020-05-26,09:00:00,82,32,50,FMN GV 11 Ramsel
66,Bergstraat 71,2020-05-26,10:00:00,138,60,78,FMN GV 11 Ramsel
66,Bergstraat 71,2020-05-26,11:00:00,132,48,84,FMN GV 11 Ramsel
66,Bergstraat 71,2020-05-26,12:00:00,158,78,80,FMN GV 11 Ramsel
66,Bergstraat 71,2020-05-26,13:00:00,312,158,154,FMN GV 11 Ramsel
66,Bergstraat 71,2020-05-26,14:00:00,310,176,134,FMN GV 11 Ramsel
66,Bergstraat 71,2020-05-26,15:00:00,344,196,148,FMN GV 11 Ramsel
66,Bergstraat 71,2020-05-26,16:00:00,276,160,116,FMN GV 11 Ramsel
66,Bergstraat 71,2020-05-26,17:00:00,196,106,90,FMN GV 11 Ramsel
66,Bergstraat 71,2020-05-26,18:00:00,166,88,78,FMN GV 11 Ramsel
66,Bergstraat 71,2020-05-26,19:00:00,152,78,74,FMN GV 11 Ramsel
66,Bergstraat 71,2020-05-26,20:00:00,110,56,54,FMN GV 11 Ramsel
66,Bergstraat 71,2020-05-26,21:00:00,36,18,18,FMN GV 11 Ramsel
66,Bergstraat 71,2020-05-26,22:00:00,18,12,6,FMN GV 11 Ramsel
66,Bergstraat 71,2020-05-26,23:00:00,4,4,0,FMN GV 11 Ramsel
66,Bergstraat 71,2020-05-27,00:00:00,0,0,0,FMN GV 11 Ramsel
66,Bergstraat 71,2020-05-27,01:00:00,0,0,0,FMN GV 11 Ramsel
66,Bergstraat 71,2020-05-27,02:00:00,0,0,0,FMN GV 11 Ramsel
66,Bergstraat 71,2020-05-27,03:00:00,2,0,2,FMN GV 11 Ramsel
66,Bergstraat 71,2020-05-27,04:00:00,6,4,2,FMN GV 11 Ramsel
66,Bergstraat 71,2020-05-27,05:00:00,14,6,8,FMN GV 11 Ramsel
66,Bergstraat 71,2020-05-27,06:00:00,50,28,22,FMN GV 11 Ramsel
66,Bergstraat 71,2020-05-27,07:00:00,52,18,34,FMN GV 11 Ramsel
66,Bergstraat 71,2020-05-27,08:00:00,70,16,54,FMN GV 11 Ramsel
66,Bergstraat 71,2020-05-27,09:00:00,64,30,34,FMN GV 11 Ramsel
66,Bergstraat 71,2020-05-27,10:00:00,116,46,70,FMN GV 11 Ramsel
66,Bergstraat 71,2020-05-27,11:00:00,108,48,60,FMN GV 11 Ramsel
66,Bergstraat 71,2020-05-27,12:00:00,174,82,92,FMN GV 11 Ramsel
66,Bergstraat 71,2020-05-27,13:00:00,288,122,166,FMN GV 11 Ramsel
66,Bergstraat 71,2020-05-27,14:00:00,320,156,164,FMN GV 11 Ramsel
66,Bergstraat 71,2020-05-27,15:00:00,302,142,160,FMN GV 11 Ramsel
66,Bergstraat 71,2020-05-27,16:00:00,306,178,128,FMN GV 11 Ramsel
66,Bergstraat 71,2020-05-27,17:00:00,258,150,108,FMN GV 11 Ramsel
66,Bergstraat 71,2020-05-27,18:00:00,224,110,114,FMN GV 11 Ramsel
66,Bergstraat 71,2020-05-27,19:00:00,198,76,122,FMN GV 11 Ramsel
66,Bergstraat 71,2020-05-27,20:00:00,120,66,54,FMN GV 11 Ramsel
66,Bergstraat 71,2020-05-27,21:00:00,48,32,16,FMN GV 11 Ramsel
66,Bergstraat 71,2020-05-27,22:00:00,10,6,4,FMN GV 11 Ramsel
66,Bergstraat 71,2020-05-27,23:00:00,10,8,2,FMN GV 11 Ramsel
66,Bergstraat 71,2020-05-28,00:00:00,6,0,6,FMN GV 11 Ramsel
66,Bergstraat 71,2020-05-28,01:00:00,0,0,0,FMN GV 11 Ramsel
66,Bergstraat 71,2020-05-28,02:00:00,0,0,0,FMN GV 11 Ramsel
66,Bergstraat 71,2020-05-28,03:00:00,0,0,0,FMN GV 11 Ramsel
66,Bergstraat 71,2020-05-28,04:00:00,6,2,4,FMN GV 11 Ramsel
66,Bergstraat 71,2020-05-28,05:00:00,20,8,12,FMN GV 11 Ramsel
66,Bergstraat 71,2020-05-28,06:00:00,30,10,20,FMN GV 11 Ramsel
66,Bergstraat 71,2020-05-28,07:00:00,52,26,26,FMN GV 11 Ramsel
66,Bergstraat 71,2020-05-28,08:00:00,54,18,36,FMN GV 11 Ramsel
66,Bergstraat 71,2020-05-28,09:00:00,74,24,50,FMN GV 11 Ramsel
66,Bergstraat 71,2020-05-28,10:00:00,98,38,60,FMN GV 11 Ramsel
66,Bergstraat 71,2020-05-28,11:00:00,108,70,38,FMN GV 11 Ramsel
66,Bergstraat 71,2020-05-28,12:00:00,138,74,64,FMN GV 11 Ramsel
66,Bergstraat 71,2020-05-28,13:00:00,240,112,128,FMN GV 11 Ramsel
66,Bergstraat 71,2020-05-28,14:00:00,292,156,136,FMN GV 11 Ramsel
66,Bergstraat 71,2020-05-28,15:00:00,254,136,118,FMN GV 11 Ramsel
66,Bergstraat 71,2020-05-28,16:00:00,256,142,114,FMN GV 11 Ramsel
66,Bergstraat 71,2020-05-28,17:00:00,202,118,84,FMN GV 11 Ramsel
66,Bergstraat 71,2020-05-28,18:00:00,140,74,66,FMN GV 11 Ramsel
66,Bergstraat 71,2020-05-28,19:00:00,108,48,60,FMN GV 11 Ramsel
66,Bergstraat 71,2020-05-28,20:00:00,88,42,46,FMN GV 11 Ramsel
66,Bergstraat 71,2020-05-28,21:00:00,50,32,18,FMN GV 11 Ramsel
66,Bergstraat 71,2020-05-28,22:00:00,20,14,6,FMN GV 11 Ramsel
66,Bergstraat 71,2020-05-28,23:00:00,8,8,0,FMN GV 11 Ramsel
66,Bergstraat 71,2020-05-29,00:00:00,4,0,4,FMN GV 11 Ramsel
66,Bergstraat 71,2020-05-29,01:00:00,4,2,2,FMN GV 11 Ramsel
66,Bergstraat 71,2020-05-29,02:00:00,4,0,4,FMN GV 11 Ramsel
66,Bergstraat 71,2020-05-29,03:00:00,0,0,0,FMN GV 11 Ramsel
66,Bergstraat 71,2020-05-29,04:00:00,6,4,2,FMN GV 11 Ramsel
66,Bergstraat 71,2020-05-29,05:00:00,14,4,10,FMN GV 11 Ramsel
66,Bergstraat 71,2020-05-29,06:00:00,28,16,12,FMN GV 11 Ramsel
66,Bergstraat 71,2020-05-29,07:00:00,56,18,38,FMN GV 11 Ramsel
66,Bergstraat 71,2020-05-29,08:00:00,68,14,54,FMN GV 11 Ramsel
66,Bergstraat 71,2020-05-29,09:00:00,60,44,16,FMN GV 11 Ramsel
66,Bergstraat 71,2020-05-29,10:00:00,122,56,66,FMN GV 11 Ramsel
66,Bergstraat 71,2020-05-29,11:00:00,108,56,52,FMN GV 11 Ramsel
66,Bergstraat 71,2020-05-29,12:00:00,122,60,62,FMN GV 11 Ramsel
66,Bergstraat 71,2020-05-29,13:00:00,246,122,124,FMN GV 11 Ramsel
66,Bergstraat 71,2020-05-29,14:00:00,332,138,194,FMN GV 11 Ramsel
66,Bergstraat 71,2020-05-29,15:00:00,366,182,184,FMN GV 11 Ramsel
66,Bergstraat 71,2020-05-29,16:00:00,276,162,114,FMN GV 11 Ramsel
66,Bergstraat 71,2020-05-29,17:00:00,234,122,112,FMN GV 11 Ramsel
66,Bergstraat 71,2020-05-29,18:00:00,170,78,92,FMN GV 11 Ramsel
66,Bergstraat 71,2020-05-29,19:00:00,130,86,44,FMN GV 11 Ramsel
66,Bergstraat 71,2020-05-29,20:00:00,116,68,48,FMN GV 11 Ramsel
66,Bergstraat 71,2020-05-29,21:00:00,48,14,34,FMN GV 11 Ramsel
66,Bergstraat 71,2020-05-29,22:00:00,22,16,6,FMN GV 11 Ramsel
66,Bergstraat 71,2020-05-29,23:00:00,4,4,0,FMN GV 11 Ramsel
66,Bergstraat 71,2020-05-30,00:00:00,4,4,0,FMN GV 11 Ramsel
66,Bergstraat 71,2020-05-30,01:00:00,4,0,4,FMN GV 11 Ramsel
66,Bergstraat 71,2020-05-30,02:00:00,2,2,0,FMN GV 11 Ramsel
66,Bergstraat 71,2020-05-30,03:00:00,0,0,0,FMN GV 11 Ramsel
66,Bergstraat 71,2020-05-30,04:00:00,2,2,0,FMN GV 11 Ramsel
66,Bergstraat 71,2020-05-30,05:00:00,2,2,0,FMN GV 11 Ramsel
66,Bergstraat 71,2020-05-30,06:00:00,16,2,14,FMN GV 11 Ramsel
66,Bergstraat 71,2020-05-30,07:00:00,26,12,14,FMN GV 11 Ramsel
66,Bergstraat 71,2020-05-30,08:00:00,70,26,44,FMN GV 11 Ramsel
66,Bergstraat 71,2020-05-30,09:00:00,134,62,72,FMN GV 11 Ramsel
66,Bergstraat 71,2020-05-30,10:00:00,164,48,116,FMN GV 11 Ramsel
66,Bergstraat 71,2020-05-30,11:00:00,232,84,148,FMN GV 11 Ramsel
66,Bergstraat 71,2020-05-30,12:00:00,222,102,120,FMN GV 11 Ramsel
66,Bergstraat 71,2020-05-30,13:00:00,354,140,214,FMN GV 11 Ramsel
66,Bergstraat 71,2020-05-30,14:00:00,392,208,184,FMN GV 11 Ramsel
66,Bergstraat 71,2020-05-30,15:00:00,426,264,162,FMN GV 11 Ramsel
66,Bergstraat 71,2020-05-30,16:00:00,398,234,164,FMN GV 11 Ramsel
66,Bergstraat 71,2020-05-30,17:00:00,232,120,112,FMN GV 11 Ramsel
66,Bergstraat 71,2020-05-30,18:00:00,138,68,70,FMN GV 11 Ramsel
66,Bergstraat 71,2020-05-30,19:00:00,100,52,48,FMN GV 11 Ramsel
66,Bergstraat 71,2020-05-30,20:00:00,88,34,54,FMN GV 11 Ramsel
66,Bergstraat 71,2020-05-30,21:00:00,42,14,28,FMN GV 11 Ramsel
66,Bergstraat 71,2020-05-30,22:00:00,40,20,20,FMN GV 11 Ramsel
66,Bergstraat 71,2020-05-30,23:00:00,6,4,2,FMN GV 11 Ramsel
66,Bergstraat 71,2020-05-31,00:00:00,8,6,2,FMN GV 11 Ramsel
66,Bergstraat 71,2020-05-31,01:00:00,0,0,0,FMN GV 11 Ramsel
66,Bergstraat 71,2020-05-31,02:00:00,2,0,2,FMN GV 11 Ramsel
66,Bergstraat 71,2020-05-31,03:00:00,2,2,0,FMN GV 11 Ramsel
66,Bergstraat 71,2020-05-31,04:00:00,0,0,0,FMN GV 11 Ramsel
66,Bergstraat 71,2020-05-31,05:00:00,0,0,0,FMN GV 11 Ramsel
66,Bergstraat 71,2020-05-31,06:00:00,8,2,6,FMN GV 11 Ramsel
66,Bergstraat 71,2020-05-31,07:00:00,34,10,24,FMN GV 11 Ramsel
66,Bergstraat 71,2020-05-31,08:00:00,148,44,104,FMN GV 11 Ramsel
66,Bergstraat 71,2020-05-31,09:00:00,284,86,198,FMN GV 11 Ramsel
66,Bergstraat 71,2020-05-31,10:00:00,316,178,138,FMN GV 11 Ramsel
66,Bergstraat 71,2020-05-31,11:00:00,374,216,158,FMN GV 11 Ramsel
66,Bergstraat 71,2020-05-31,12:00:00,262,160,102,FMN GV 11 Ramsel
66,Bergstraat 71,2020-05-31,13:00:00,326,168,158,FMN GV 11 Ramsel
66,Bergstraat 71,2020-05-31,14:00:00,662,374,288,FMN GV 11 Ramsel
66,Bergstraat 71,2020-05-31,15:00:00,500,252,248,FMN GV 11 Ramsel
66,Bergstraat 71,2020-05-31,16:00:00,422,272,150,FMN GV 11 Ramsel
66,Bergstraat 71,2020-05-31,17:00:00,222,152,70,FMN GV 11 Ramsel
66,Bergstraat 71,2020-05-31,18:00:00,212,110,102,FMN GV 11 Ramsel
66,Bergstraat 71,2020-05-31,19:00:00,162,80,82,FMN GV 11 Ramsel
66,Bergstraat 71,2020-05-31,20:00:00,132,68,64,FMN GV 11 Ramsel
66,Bergstraat 71,2020-05-31,21:00:00,58,24,34,FMN GV 11 Ramsel
66,Bergstraat 71,2020-05-31,22:00:00,16,14,2,FMN GV 11 Ramsel
66,Bergstraat 71,2020-05-31,23:00:00,30,12,18,FMN GV 11 Ramsel
66,Bergstraat 71,2020-06-01,00:00:00,16,16,0,FMN GV 11 Ramsel
66,Bergstraat 71,2020-06-01,01:00:00,0,0,0,FMN GV 11 Ramsel
66,Bergstraat 71,2020-06-01,02:00:00,0,0,0,FMN GV 11 Ramsel
66,Bergstraat 71,2020-06-01,03:00:00,0,0,0,FMN GV 11 Ramsel
66,Bergstraat 71,2020-06-01,04:00:00,0,0,0,FMN GV 11 Ramsel
66,Bergstraat 71,2020-06-01,05:00:00,6,2,4,FMN GV 11 Ramsel
66,Bergstraat 71,2020-06-01,06:00:00,14,6,8,FMN GV 11 Ramsel
66,Bergstraat 71,2020-06-01,07:00:00,26,10,16,FMN GV 11 Ramsel
66,Bergstraat 71,2020-06-01,08:00:00,52,22,30,FMN GV 11 Ramsel
66,Bergstraat 71,2020-06-01,09:00:00,178,58,120,FMN GV 11 Ramsel
66,Bergstraat 71,2020-06-01,10:00:00,300,140,160,FMN GV 11 Ramsel
66,Bergstraat 71,2020-06-01,11:00:00,368,188,180,FMN GV 11 Ramsel
66,Bergstraat 71,2020-06-01,12:00:00,284,118,166,FMN GV 11 Ramsel
66,Bergstraat 71,2020-06-01,13:00:00,356,208,148,FMN GV 11 Ramsel
66,Bergstraat 71,2020-06-01,14:00:00,596,318,278,FMN GV 11 Ramsel
66,Bergstraat 71,2020-06-01,15:00:00,566,324,242,FMN GV 11 Ramsel
66,Bergstraat 71,2020-06-01,16:00:00,454,258,196,FMN GV 11 Ramsel
66,Bergstraat 71,2020-06-01,17:00:00,264,136,128,FMN GV 11 Ramsel
66,Bergstraat 71,2020-06-01,18:00:00,200,106,94,FMN GV 11 Ramsel
66,Bergstraat 71,2020-06-01,19:00:00,126,60,66,FMN GV 11 Ramsel
66,Bergstraat 71,2020-06-01,20:00:00,126,60,66,FMN GV 11 Ramsel
66,Bergstraat 71,2020-06-01,21:00:00,28,14,14,FMN GV 11 Ramsel
66,Bergstraat 71,2020-06-01,22:00:00,22,14,8,FMN GV 11 Ramsel
66,Bergstraat 71,2020-06-01,23:00:00,10,4,6,FMN GV 11 Ramsel
66,Bergstraat 71,2020-06-02,00:00:00,2,0,2,FMN GV 11 Ramsel
66,Bergstraat 71,2020-06-02,01:00:00,0,0,0,FMN GV 11 Ramsel
66,Bergstraat 71,2020-06-02,02:00:00,0,0,0,FMN GV 11 Ramsel
66,Bergstraat 71,2020-06-02,03:00:00,0,0,0,FMN GV 11 Ramsel
66,Bergstraat 71,2020-06-02,04:00:00,6,4,2,FMN GV 11 Ramsel
66,Bergstraat 71,2020-06-02,05:00:00,12,2,10,FMN GV 11 Ramsel
66,Bergstraat 71,2020-06-02,06:00:00,36,20,16,FMN GV 11 Ramsel
66,Bergstraat 71,2020-06-02,07:00:00,94,20,74,FMN GV 11 Ramsel
66,Bergstraat 71,2020-06-02,08:00:00,96,24,72,FMN GV 11 Ramsel
66,Bergstraat 71,2020-06-02,09:00:00,108,38,70,FMN GV 11 Ramsel
66,Bergstraat 71,2020-06-02,10:00:00,150,64,86,FMN GV 11 Ramsel
66,Bergstraat 71,2020-06-02,11:00:00,138,92,46,FMN GV 11 Ramsel
66,Bergstraat 71,2020-06-02,12:00:00,154,82,72,FMN GV 11 Ramsel
66,Bergstraat 71,2020-06-02,13:00:00,236,112,124,FMN GV 11 Ramsel
66,Bergstraat 71,2020-06-02,14:00:00,366,194,172,FMN GV 11 Ramsel
66,Bergstraat 71,2020-06-02,15:00:00,270,164,106,FMN GV 11 Ramsel
66,Bergstraat 71,2020-06-02,16:00:00,290,122,168,FMN GV 11 Ramsel
66,Bergstraat 71,2020-06-02,17:00:00,180,102,78,FMN GV 11 Ramsel
66,Bergstraat 71,2020-06-02,18:00:00,182,84,98,FMN GV 11 Ramsel
66,Bergstraat 71,2020-06-02,19:00:00,158,64,94,FMN GV 11 Ramsel
66,Bergstraat 71,2020-06-02,20:00:00,136,72,64,FMN GV 11 Ramsel
66,Bergstraat 71,2020-06-02,21:00:00,62,28,34,FMN GV 11 Ramsel
66,Bergstraat 71,2020-06-02,22:00:00,14,6,8,FMN GV 11 Ramsel
66,Bergstraat 71,2020-06-02,23:00:00,6,4,2,FMN GV 11 Ramsel
66,Bergstraat 71,2020-06-03,00:00:00,0,0,0,FMN GV 11 Ramsel
66,Bergstraat 71,2020-06-03,01:00:00,0,0,0,FMN GV 11 Ramsel
66,Bergstraat 71,2020-06-03,02:00:00,0,0,0,FMN GV 11 Ramsel
66,Bergstraat 71,2020-06-03,03:00:00,0,0,0,FMN GV 11 Ramsel
66,Bergstraat 71,2020-06-03,04:00:00,6,4,2,FMN GV 11 Ramsel
66,Bergstraat 71,2020-06-03,05:00:00,20,2,18,FMN GV 11 Ramsel
66,Bergstraat 71,2020-06-03,06:00:00,44,30,14,FMN GV 11 Ramsel
66,Bergstraat 71,2020-06-03,07:00:00,70,18,52,FMN GV 11 Ramsel
66,Bergstraat 71,2020-06-03,08:00:00,88,48,40,FMN GV 11 Ramsel
66,Bergstraat 71,2020-06-03,09:00:00,72,32,40,FMN GV 11 Ramsel
66,Bergstraat 71,2020-06-03,10:00:00,112,42,70,FMN GV 11 Ramsel
66,Bergstraat 71,2020-06-03,11:00:00,178,78,100,FMN GV 11 Ramsel
66,Bergstraat 71,2020-06-03,12:00:00,140,78,62,FMN GV 11 Ramsel
66,Bergstraat 71,2020-06-03,13:00:00,264,118,146,FMN GV 11 Ramsel
66,Bergstraat 71,2020-06-03,14:00:00,308,124,184,FMN GV 11 Ramsel
66,Bergstraat 71,2020-06-03,15:00:00,334,182,152,FMN GV 11 Ramsel
66,Bergstraat 71,2020-06-03,16:00:00,274,156,118,FMN GV 11 Ramsel
66,Bergstraat 71,2020-06-03,17:00:00,230,134,96,FMN GV 11 Ramsel
66,Bergstraat 71,2020-06-03,18:00:00,154,78,76,FMN GV 11 Ramsel
66,Bergstraat 71,2020-06-03,19:00:00,142,82,60,FMN GV 11 Ramsel
66,Bergstraat 71,2020-06-03,20:00:00,102,58,44,FMN GV 11 Ramsel
66,Bergstraat 71,2020-06-03,21:00:00,44,32,12,FMN GV 11 Ramsel
66,Bergstraat 71,2020-06-03,22:00:00,14,8,6,FMN GV 11 Ramsel
66,Bergstraat 71,2020-06-03,23:00:00,2,2,0,FMN GV 11 Ramsel
66,Bergstraat 71,2020-06-04,00:00:00,6,2,4,FMN GV 11 Ramsel
66,Bergstraat 71,2020-06-04,01:00:00,2,0,2,FMN GV 11 Ramsel
66,Bergstraat 71,2020-06-04,02:00:00,2,2,0,FMN GV 11 Ramsel
66,Bergstraat 71,2020-06-04,03:00:00,0,0,0,FMN GV 11 Ramsel
66,Bergstraat 71,2020-06-04,04:00:00,6,4,2,FMN GV 11 Ramsel
66,Bergstraat 71,2020-06-04,05:00:00,8,0,8,FMN GV 11 Ramsel
66,Bergstraat 71,2020-06-04,06:00:00,38,22,16,FMN GV 11 Ramsel
66,Bergstraat 71,2020-06-04,07:00:00,46,12,34,FMN GV 11 Ramsel
66,Bergstraat 71,2020-06-04,08:00:00,68,14,54,FMN GV 11 Ramsel
66,Bergstraat 71,2020-06-04,09:00:00,62,34,28,FMN GV 11 Ramsel
66,Bergstraat 71,2020-06-04,10:00:00,64,32,32,FMN GV 11 Ramsel
66,Bergstraat 71,2020-06-04,11:00:00,56,28,28,FMN GV 11 Ramsel
66,Bergstraat 71,2020-06-04,12:00:00,50,34,16,FMN GV 11 Ramsel
66,Bergstraat 71,2020-06-04,13:00:00,54,26,28,FMN GV 11 Ramsel
66,Bergstraat 71,2020-06-04,14:00:00,56,28,28,FMN GV 11 Ramsel
66,Bergstraat 71,2020-06-04,15:00:00,66,36,30,FMN GV 11 Ramsel
66,Bergstraat 71,2020-06-04,16:00:00,58,38,20,FMN GV 11 Ramsel
66,Bergstraat 71,2020-06-04,17:00:00,66,34,32,FMN GV 11 Ramsel
66,Bergstraat 71,2020-06-04,18:00:00,50,20,30,FMN GV 11 Ramsel
66,Bergstraat 71,2020-06-04,19:00:00,44,30,14,FMN GV 11 Ramsel
66,Bergstraat 71,2020-06-04,20:00:00,54,42,12,FMN GV 11 Ramsel
66,Bergstraat 71,2020-06-04,21:00:00,22,12,10,FMN GV 11 Ramsel
66,Bergstraat 71,2020-06-04,22:00:00,10,6,4,FMN GV 11 Ramsel
66,Bergstraat 71,2020-06-04,23:00:00,0,0,0,FMN GV 11 Ramsel
66,Bergstraat 71,2020-06-05,00:00:00,0,0,0,FMN GV 11 Ramsel
66,Bergstraat 71,2020-06-05,01:00:00,0,0,0,FMN GV 11 Ramsel
66,Bergstraat 71,2020-06-05,02:00:00,2,0,2,FMN GV 11 Ramsel
66,Bergstraat 71,2020-06-05,03:00:00,0,0,0,FMN GV 11 Ramsel
66,Bergstraat 71,2020-06-05,04:00:00,6,4,2,FMN GV 11 Ramsel
66,Bergstraat 71,2020-06-05,05:00:00,2,2,0,FMN GV 11 Ramsel
66,Bergstraat 71,2020-06-05,06:00:00,26,12,14,FMN GV 11 Ramsel
66,Bergstraat 71,2020-06-05,07:00:00,34,6,28,FMN GV 11 Ramsel
66,Bergstraat 71,2020-06-05,08:00:00,48,12,36,FMN GV 11 Ramsel
66,Bergstraat 71,2020-06-05,09:00:00,20,8,12,FMN GV 11 Ramsel
66,Bergstraat 71,2020-06-05,10:00:00,14,2,12,FMN GV 11 Ramsel
66,Bergstraat 71,2020-06-05,11:00:00,24,18,6,FMN GV 11 Ramsel
66,Bergstraat 71,2020-06-05,12:00:00,30,26,4,FMN GV 11 Ramsel
66,Bergstraat 71,2020-06-05,13:00:00,18,10,8,FMN GV 11 Ramsel
66,Bergstraat 71,2020-06-05,14:00:00,50,32,18,FMN GV 11 Ramsel
66,Bergstraat 71,2020-06-05,15:00:00,60,28,32,FMN GV 11 Ramsel
66,Bergstraat 71,2020-06-05,16:00:00,18,14,4,FMN GV 11 Ramsel
66,Bergstraat 71,2020-06-05,17:00:00,46,32,14,FMN GV 11 Ramsel
66,Bergstraat 71,2020-06-05,18:00:00,20,14,6,FMN GV 11 Ramsel
66,Bergstraat 71,2020-06-05,19:00:00,20,8,12,FMN GV 11 Ramsel
66,Bergstraat 71,2020-06-05,20:00:00,32,16,16,FMN GV 11 Ramsel
66,Bergstraat 71,2020-06-05,21:00:00,10,8,2,FMN GV 11 Ramsel
66,Bergstraat 71,2020-06-05,22:00:00,0,0,0,FMN GV 11 Ramsel
66,Bergstraat 71,2020-06-05,23:00:00,2,2,0,FMN GV 11 Ramsel
66,Bergstraat 71,2020-06-06,00:00:00,0,0,0,FMN GV 11 Ramsel
66,Bergstraat 71,2020-06-06,01:00:00,6,2,4,FMN GV 11 Ramsel
66,Bergstraat 71,2020-06-06,02:00:00,0,0,0,FMN GV 11 Ramsel
66,Bergstraat 71,2020-06-06,03:00:00,0,0,0,FMN GV 11 Ramsel
66,Bergstraat 71,2020-06-06,04:00:00,0,0,0,FMN GV 11 Ramsel
66,Bergstraat 71,2020-06-06,05:00:00,6,2,4,FMN GV 11 Ramsel
66,Bergstraat 71,2020-06-06,06:00:00,8,2,6,FMN GV 11 Ramsel
66,Bergstraat 71,2020-06-06,07:00:00,12,2,10,FMN GV 11 Ramsel
66,Bergstraat 71,2020-06-06,08:00:00,20,10,10,FMN GV 11 Ramsel
66,Bergstraat 71,2020-06-06,09:00:00,74,22,52,FMN GV 11 Ramsel
66,Bergstraat 71,2020-06-06,10:00:00,100,28,72,FMN GV 11 Ramsel
66,Bergstraat 71,2020-06-06,11:00:00,96,50,46,FMN GV 11 Ramsel
66,Bergstraat 71,2020-06-06,12:00:00,140,74,66,FMN GV 11 Ramsel
66,Bergstraat 71,2020-06-06,13:00:00,162,76,86,FMN GV 11 Ramsel
66,Bergstraat 71,2020-06-06,14:00:00,170,98,72,FMN GV 11 Ramsel
66,Bergstraat 71,2020-06-06,15:00:00,184,132,52,FMN GV 11 Ramsel
66,Bergstraat 71,2020-06-06,16:00:00,116,80,36,FMN GV 11 Ramsel
66,Bergstraat 71,2020-06-06,17:00:00,70,40,30,FMN GV 11 Ramsel
66,Bergstraat 71,2020-06-06,18:00:00,50,24,26,FMN GV 11 Ramsel
66,Bergstraat 71,2020-06-06,19:00:00,26,4,22,FMN GV 11 Ramsel
66,Bergstraat 71,2020-06-06,20:00:00,30,16,14,FMN GV 11 Ramsel
66,Bergstraat 71,2020-06-06,21:00:00,14,10,4,FMN GV 11 Ramsel
66,Bergstraat 71,2020-06-06,22:00:00,4,2,2,FMN GV 11 Ramsel
66,Bergstraat 71,2020-06-06,23:00:00,6,0,6,FMN GV 11 Ramsel
66,Bergstraat 71,2020-06-07,00:00:00,4,0,4,FMN GV 11 Ramsel
66,Bergstraat 71,2020-06-07,01:00:00,6,4,2,FMN GV 11 Ramsel
66,Bergstraat 71,2020-06-07,02:00:00,2,0,2,FMN GV 11 Ramsel
66,Bergstraat 71,2020-06-07,03:00:00,2,2,0,FMN GV 11 Ramsel
66,Bergstraat 71,2020-06-07,04:00:00,2,0,2,FMN GV 11 Ramsel
66,Bergstraat 71,2020-06-07,05:00:00,2,2,0,FMN GV 11 Ramsel
66,Bergstraat 71,2020-06-07,06:00:00,4,0,4,FMN GV 11 Ramsel
66,Bergstraat 71,2020-06-07,07:00:00,28,6,22,FMN GV 11 Ramsel
66,Bergstraat 71,2020-06-07,08:00:00,116,20,96,FMN GV 11 Ramsel
66,Bergstraat 71,2020-06-07,09:00:00,166,56,110,FMN GV 11 Ramsel
66,Bergstraat 71,2020-06-07,10:00:00,250,124,126,FMN GV 11 Ramsel
66,Bergstraat 71,2020-06-07,11:00:00,354,234,120,FMN GV 11 Ramsel
66,Bergstraat 71,2020-06-07,12:00:00,154,104,50,FMN GV 11 Ramsel
66,Bergstraat 71,2020-06-07,13:00:00,202,82,120,FMN GV 11 Ramsel
66,Bergstraat 71,2020-06-07,14:00:00,296,150,146,FMN GV 11 Ramsel
66,Bergstraat 71,2020-06-07,15:00:00,310,170,140,FMN GV 11 Ramsel
66,Bergstraat 71,2020-06-07,16:00:00,268,148,120,FMN GV 11 Ramsel
66,Bergstraat 71,2020-06-07,17:00:00,160,86,74,FMN GV 11 Ramsel
66,Bergstraat 71,2020-06-07,18:00:00,64,26,38,FMN GV 11 Ramsel
66,Bergstraat 71,2020-06-07,19:00:00,42,28,14,FMN GV 11 Ramsel
66,Bergstraat 71,2020-06-07,20:00:00,36,16,20,FMN GV 11 Ramsel
66,Bergstraat 71,2020-06-07,21:00:00,40,30,10,FMN GV 11 Ramsel
66,Bergstraat 71,2020-06-07,22:00:00,14,6,8,FMN GV 11 Ramsel
66,Bergstraat 71,2020-06-07,23:00:00,0,0,0,FMN GV 11 Ramsel
66,Bergstraat 71,2020-06-08,00:00:00,0,0,0,FMN GV 11 Ramsel
66,Bergstraat 71,2020-06-08,01:00:00,0,0,0,FMN GV 11 Ramsel
66,Bergstraat 71,2020-06-08,02:00:00,0,0,0,FMN GV 11 Ramsel
66,Bergstraat 71,2020-06-08,03:00:00,0,0,0,FMN GV 11 Ramsel
66,Bergstraat 71,2020-06-08,04:00:00,2,2,0,FMN GV 11 Ramsel
66,Bergstraat 71,2020-06-08,05:00:00,8,4,4,FMN GV 11 Ramsel
66,Bergstraat 71,2020-06-08,06:00:00,38,18,20,FMN GV 11 Ramsel
66,Bergstraat 71,2020-06-08,07:00:00,38,12,26,FMN GV 11 Ramsel
66,Bergstraat 71,2020-06-08,08:00:00,60,18,42,FMN GV 11 Ramsel
66,Bergstraat 71,2020-06-08,09:00:00,36,10,26,FMN GV 11 Ramsel
66,Bergstraat 71,2020-06-08,10:00:00,18,2,16,FMN GV 11 Ramsel
66,Bergstraat 71,2020-06-08,11:00:00,30,16,14,FMN GV 11 Ramsel
66,Bergstraat 71,2020-06-08,12:00:00,56,40,16,FMN GV 11 Ramsel
66,Bergstraat 71,2020-06-08,13:00:00,50,30,20,FMN GV 11 Ramsel
66,Bergstraat 71,2020-06-08,14:00:00,54,40,14,FMN GV 11 Ramsel
66,Bergstraat 71,2020-06-08,15:00:00,62,42,20,FMN GV 11 Ramsel
66,Bergstraat 71,2020-06-08,16:00:00,68,38,30,FMN GV 11 Ramsel
66,Bergstraat 71,2020-06-08,17:00:00,44,22,22,FMN GV 11 Ramsel
66,Bergstraat 71,2020-06-08,18:00:00,30,14,16,FMN GV 11 Ramsel
66,Bergstraat 71,2020-06-08,19:00:00,28,10,18,FMN GV 11 Ramsel
66,Bergstraat 71,2020-06-08,20:00:00,62,22,40,FMN GV 11 Ramsel
66,Bergstraat 71,2020-06-08,21:00:00,12,8,4,FMN GV 11 Ramsel
66,Bergstraat 71,2020-06-08,22:00:00,16,10,6,FMN GV 11 Ramsel
66,Bergstraat 71,2020-06-08,23:00:00,12,12,0,FMN GV 11 Ramsel
66,Bergstraat 71,2020-06-09,00:00:00,2,2,0,FMN GV 11 Ramsel
66,Bergstraat 71,2020-06-09,01:00:00,10,6,4,FMN GV 11 Ramsel
66,Bergstraat 71,2020-06-09,02:00:00,0,0,0,FMN GV 11 Ramsel
66,Bergstraat 71,2020-06-09,03:00:00,0,0,0,FMN GV 11 Ramsel
66,Bergstraat 71,2020-06-09,04:00:00,6,2,4,FMN GV 11 Ramsel
66,Bergstraat 71,2020-06-09,05:00:00,16,4,12,FMN GV 11 Ramsel
66,Bergstraat 71,2020-06-09,06:00:00,40,20,20,FMN GV 11 Ramsel
66,Bergstraat 71,2020-06-09,07:00:00,62,10,52,FMN GV 11 Ramsel
66,Bergstraat 71,2020-06-09,08:00:00,116,30,86,FMN GV 11 Ramsel
66,Bergstraat 71,2020-06-09,09:00:00,66,32,34,FMN GV 11 Ramsel
66,Bergstraat 71,2020-06-09,10:00:00,36,14,22,FMN GV 11 Ramsel
66,Bergstraat 71,2020-06-09,11:00:00,60,20,40,FMN GV 11 Ramsel
66,Bergstraat 71,2020-06-09,12:00:00,118,54,64,FMN GV 11 Ramsel
66,Bergstraat 71,2020-06-09,13:00:00,146,86,60,FMN GV 11 Ramsel
66,Bergstraat 71,2020-06-09,14:00:00,146,66,80,FMN GV 11 Ramsel
66,Bergstraat 71,2020-06-09,15:00:00,198,118,80,FMN GV 11 Ramsel
66,Bergstraat 71,2020-06-09,16:00:00,160,102,58,FMN GV 11 Ramsel
66,Bergstraat 71,2020-06-09,17:00:00,138,78,60,FMN GV 11 Ramsel
66,Bergstraat 71,2020-06-09,18:00:00,80,48,32,FMN GV 11 Ramsel
66,Bergstraat 71,2020-06-09,19:00:00,76,44,32,FMN GV 11 Ramsel
66,Bergstraat 71,2020-06-09,20:00:00,58,28,30,FMN GV 11 Ramsel
66,Bergstraat 71,2020-06-09,21:00:00,42,28,14,FMN GV 11 Ramsel
66,Bergstraat 71,2020-06-09,22:00:00,10,10,0,FMN GV 11 Ramsel
66,Bergstraat 71,2020-06-09,23:00:00,6,4,2,FMN GV 11 Ramsel
66,Bergstraat 71,2020-06-10,00:00:00,4,2,2,FMN GV 11 Ramsel
66,Bergstraat 71,2020-06-10,01:00:00,4,2,2,FMN GV 11 Ramsel
66,Bergstraat 71,2020-06-10,02:00:00,0,0,0,FMN GV 11 Ramsel
66,Bergstraat 71,2020-06-10,03:00:00,0,0,0,FMN GV 11 Ramsel
66,Bergstraat 71,2020-06-10,04:00:00,4,2,2,FMN GV 11 Ramsel
66,Bergstraat 71,2020-06-10,05:00:00,10,2,8,FMN GV 11 Ramsel
66,Bergstraat 71,2020-06-10,06:00:00,38,22,16,FMN GV 11 Ramsel
66,Bergstraat 71,2020-06-10,07:00:00,68,12,56,FMN GV 11 Ramsel
66,Bergstraat 71,2020-06-10,08:00:00,96,28,68,FMN GV 11 Ramsel
66,Bergstraat 71,2020-06-10,09:00:00,58,32,26,FMN GV 11 Ramsel
66,Bergstraat 71,2020-06-10,10:00:00,106,58,48,FMN GV 11 Ramsel
66,Bergstraat 71,2020-06-10,11:00:00,158,60,98,FMN GV 11 Ramsel
66,Bergstraat 71,2020-06-10,12:00:00,150,72,78,FMN GV 11 Ramsel
66,Bergstraat 71,2020-06-10,13:00:00,156,80,76,FMN GV 11 Ramsel
66,Bergstraat 71,2020-06-10,14:00:00,158,68,90,FMN GV 11 Ramsel
66,Bergstraat 71,2020-06-10,15:00:00,172,76,96,FMN GV 11 Ramsel
66,Bergstraat 71,2020-06-10,16:00:00,172,94,78,FMN GV 11 Ramsel
66,Bergstraat 71,2020-06-10,17:00:00,146,78,68,FMN GV 11 Ramsel
66,Bergstraat 71,2020-06-10,18:00:00,144,58,86,FMN GV 11 Ramsel
66,Bergstraat 71,2020-06-10,19:00:00,128,76,52,FMN GV 11 Ramsel
66,Bergstraat 71,2020-06-10,20:00:00,126,78,48,FMN GV 11 Ramsel
66,Bergstraat 71,2020-06-10,21:00:00,32,16,16,FMN GV 11 Ramsel
66,Bergstraat 71,2020-06-10,22:00:00,14,10,4,FMN GV 11 Ramsel
66,Bergstraat 71,2020-06-10,23:00:00,6,2,4,FMN GV 11 Ramsel
66,Bergstraat 71,2020-06-11,00:00:00,4,0,4,FMN GV 11 Ramsel
66,Bergstraat 71,2020-06-11,01:00:00,2,0,2,FMN GV 11 Ramsel
66,Bergstraat 71,2020-06-11,02:00:00,2,2,0,FMN GV 11 Ramsel
66,Bergstraat 71,2020-06-11,03:00:00,0,0,0,FMN GV 11 Ramsel
66,Bergstraat 71,2020-06-11,04:00:00,6,2,4,FMN GV 11 Ramsel
66,Bergstraat 71,2020-06-11,05:00:00,14,6,8,FMN GV 11 Ramsel
66,Bergstraat 71,2020-06-11,06:00:00,42,16,26,FMN GV 11 Ramsel
66,Bergstraat 71,2020-06-11,07:00:00,56,8,48,FMN GV 11 Ramsel
66,Bergstraat 71,2020-06-11,08:00:00,136,24,112,FMN GV 11 Ramsel
66,Bergstraat 71,2020-06-11,09:00:00,70,24,46,FMN GV 11 Ramsel
66,Bergstraat 71,2020-06-11,10:00:00,100,54,46,FMN GV 11 Ramsel
66,Bergstraat 71,2020-06-11,11:00:00,104,46,58,FMN GV 11 Ramsel
66,Bergstraat 71,2020-06-11,12:00:00,158,96,62,FMN GV 11 Ramsel
66,Bergstraat 71,2020-06-11,13:00:00,136,68,68,FMN GV 11 Ramsel
66,Bergstraat 71,2020-06-11,14:00:00,162,94,68,FMN GV 11 Ramsel
66,Bergstraat 71,2020-06-11,15:00:00,196,122,74,FMN GV 11 Ramsel
66,Bergstraat 71,2020-06-11,16:00:00,192,108,84,FMN GV 11 Ramsel
66,Bergstraat 71,2020-06-11,17:00:00,138,80,58,FMN GV 11 Ramsel
66,Bergstraat 71,2020-06-11,18:00:00,140,72,68,FMN GV 11 Ramsel
66,Bergstraat 71,2020-06-11,19:00:00,62,28,34,FMN GV 11 Ramsel
66,Bergstraat 71,2020-06-11,20:00:00,74,50,24,FMN GV 11 Ramsel
66,Bergstraat 71,2020-06-11,21:00:00,52,30,22,FMN GV 11 Ramsel
66,Bergstraat 71,2020-06-11,22:00:00,24,14,10,FMN GV 11 Ramsel
66,Bergstraat 71,2020-06-11,23:00:00,6,6,0,FMN GV 11 Ramsel
66,Bergstraat 71,2020-06-12,00:00:00,4,4,0,FMN GV 11 Ramsel
66,Bergstraat 71,2020-06-12,01:00:00,0,0,0,FMN GV 11 Ramsel
66,Bergstraat 71,2020-06-12,02:00:00,0,0,0,FMN GV 11 Ramsel
66,Bergstraat 71,2020-06-12,03:00:00,0,0,0,FMN GV 11 Ramsel
66,Bergstraat 71,2020-06-12,04:00:00,2,2,0,FMN GV 11 Ramsel
66,Bergstraat 71,2020-06-12,05:00:00,6,2,4,FMN GV 11 Ramsel
66,Bergstraat 71,2020-06-12,06:00:00,34,18,16,FMN GV 11 Ramsel
66,Bergstraat 71,2020-06-12,07:00:00,56,8,48,FMN GV 11 Ramsel
66,Bergstraat 71,2020-06-12,08:00:00,106,30,76,FMN GV 11 Ramsel
66,Bergstraat 71,2020-06-12,09:00:00,88,36,52,FMN GV 11 Ramsel
66,Bergstraat 71,2020-06-12,10:00:00,122,70,52,FMN GV 11 Ramsel
66,Bergstraat 71,2020-06-12,11:00:00,210,86,124,FMN GV 11 Ramsel
66,Bergstraat 71,2020-06-12,12:00:00,128,60,68,FMN GV 11 Ramsel
66,Bergstraat 71,2020-06-12,13:00:00,244,128,116,FMN GV 11 Ramsel
66,Bergstraat 71,2020-06-12,14:00:00,172,102,70,FMN GV 11 Ramsel
66,Bergstraat 71,2020-06-12,15:00:00,202,146,56,FMN GV 11 Ramsel
66,Bergstraat 71,2020-06-12,16:00:00,138,86,52,FMN GV 11 Ramsel
66,Bergstraat 71,2020-06-12,17:00:00,76,48,28,FMN GV 11 Ramsel
66,Bergstraat 71,2020-06-12,18:00:00,70,42,28,FMN GV 11 Ramsel
66,Bergstraat 71,2020-06-12,19:00:00,44,10,34,FMN GV 11 Ramsel
66,Bergstraat 71,2020-06-12,20:00:00,62,36,26,FMN GV 11 Ramsel
66,Bergstraat 71,2020-06-12,21:00:00,14,10,4,FMN GV 11 Ramsel
66,Bergstraat 71,2020-06-12,22:00:00,0,0,0,FMN GV 11 Ramsel
66,Bergstraat 71,2020-06-12,23:00:00,6,4,2,FMN GV 11 Ramsel
66,Bergstraat 71,2020-06-13,00:00:00,0,0,0,FMN GV 11 Ramsel
66,Bergstraat 71,2020-06-13,01:00:00,4,4,0,FMN GV 11 Ramsel
66,Bergstraat 71,2020-06-13,02:00:00,2,2,0,FMN GV 11 Ramsel
66,Bergstraat 71,2020-06-13,03:00:00,0,0,0,FMN GV 11 Ramsel
66,Bergstraat 71,2020-06-13,04:00:00,0,0,0,FMN GV 11 Ramsel
66,Bergstraat 71,2020-06-13,05:00:00,4,0,4,FMN GV 11 Ramsel
66,Bergstraat 71,2020-06-13,06:00:00,12,4,8,FMN GV 11 Ramsel
66,Bergstraat 71,2020-06-13,07:00:00,22,8,14,FMN GV 11 Ramsel
66,Bergstraat 71,2020-06-13,08:00:00,60,20,40,FMN GV 11 Ramsel
66,Bergstraat 71,2020-06-13,09:00:00,120,32,88,FMN GV 11 Ramsel
66,Bergstraat 71,2020-06-13,10:00:00,156,86,70,FMN GV 11 Ramsel
66,Bergstraat 71,2020-06-13,11:00:00,242,152,90,FMN GV 11 Ramsel
66,Bergstraat 71,2020-06-13,12:00:00,250,102,148,FMN GV 11 Ramsel
66,Bergstraat 71,2020-06-13,13:00:00,308,142,166,FMN GV 11 Ramsel
66,Bergstraat 71,2020-06-13,14:00:00,456,208,248,FMN GV 11 Ramsel
66,Bergstraat 71,2020-06-13,15:00:00,344,194,150,FMN GV 11 Ramsel
66,Bergstraat 71,2020-06-13,16:00:00,288,166,122,FMN GV 11 Ramsel
66,Bergstraat 71,2020-06-13,17:00:00,222,104,118,FMN GV 11 Ramsel
66,Bergstraat 71,2020-06-13,18:00:00,134,78,56,FMN GV 11 Ramsel
66,Bergstraat 71,2020-06-13,19:00:00,94,52,42,FMN GV 11 Ramsel
66,Bergstraat 71,2020-06-13,20:00:00,112,54,58,FMN GV 11 Ramsel
66,Bergstraat 71,2020-06-13,21:00:00,48,32,16,FMN GV 11 Ramsel
66,Bergstraat 71,2020-06-13,22:00:00,16,4,12,FMN GV 11 Ramsel
66,Bergstraat 71,2020-06-13,23:00:00,14,8,6,FMN GV 11 Ramsel
66,Bergstraat 71,2020-06-14,00:00:00,6,0,6,FMN GV 11 Ramsel
66,Bergstraat 71,2020-06-14,01:00:00,2,2,0,FMN GV 11 Ramsel
66,Bergstraat 71,2020-06-14,02:00:00,4,4,0,FMN GV 11 Ramsel
66,Bergstraat 71,2020-06-14,03:00:00,4,2,2,FMN GV 11 Ramsel
66,Bergstraat 71,2020-06-14,04:00:00,0,0,0,FMN GV 11 Ramsel
66,Bergstraat 71,2020-06-14,05:00:00,2,2,0,FMN GV 11 Ramsel
66,Bergstraat 71,2020-06-14,06:00:00,18,4,14,FMN GV 11 Ramsel
66,Bergstraat 71,2020-06-14,07:00:00,22,10,12,FMN GV 11 Ramsel
66,Bergstraat 71,2020-06-14,08:00:00,138,32,106,FMN GV 11 Ramsel
66,Bergstraat 71,2020-06-14,09:00:00,232,76,156,FMN GV 11 Ramsel
66,Bergstraat 71,2020-06-14,10:00:00,282,146,136,FMN GV 11 Ramsel
66,Bergstraat 71,2020-06-14,11:00:00,342,208,134,FMN GV 11 Ramsel
66,Bergstraat 71,2020-06-14,12:00:00,368,212,156,FMN GV 11 Ramsel
66,Bergstraat 71,2020-06-14,13:00:00,352,184,168,FMN GV 11 Ramsel
66,Bergstraat 71,2020-06-14,14:00:00,504,276,228,FMN GV 11 Ramsel
66,Bergstraat 71,2020-06-14,15:00:00,374,204,170,FMN GV 11 Ramsel
66,Bergstraat 71,2020-06-14,16:00:00,294,164,130,FMN GV 11 Ramsel
66,Bergstraat 71,2020-06-14,17:00:00,236,102,134,FMN GV 11 Ramsel
66,Bergstraat 71,2020-06-14,18:00:00,114,74,40,FMN GV 11 Ramsel
66,Bergstraat 71,2020-06-14,19:00:00,102,44,58,FMN GV 11 Ramsel
66,Bergstraat 71,2020-06-14,20:00:00,64,34,30,FMN GV 11 Ramsel
66,Bergstraat 71,2020-06-14,21:00:00,18,10,8,FMN GV 11 Ramsel
66,Bergstraat 71,2020-06-14,22:00:00,10,8,2,FMN GV 11 Ramsel
66,Bergstraat 71,2020-06-14,23:00:00,2,2,0,FMN GV 11 Ramsel
66,Bergstraat 71,2020-06-15,00:00:00,0,0,0,FMN GV 11 Ramsel
66,Bergstraat 71,2020-06-15,01:00:00,0,0,0,FMN GV 11 Ramsel
66,Bergstraat 71,2020-06-15,02:00:00,0,0,0,FMN GV 11 Ramsel
66,Bergstraat 71,2020-06-15,03:00:00,0,0,0,FMN GV 11 Ramsel
66,Bergstraat 71,2020-06-15,04:00:00,4,4,0,FMN GV 11 Ramsel
66,Bergstraat 71,2020-06-15,05:00:00,6,4,2,FMN GV 11 Ramsel
66,Bergstraat 71,2020-06-15,06:00:00,52,22,30,FMN GV 11 Ramsel
66,Bergstraat 71,2020-06-15,07:00:00,92,14,78,FMN GV 11 Ramsel
66,Bergstraat 71,2020-06-15,08:00:00,118,24,94,FMN GV 11 Ramsel
66,Bergstraat 71,2020-06-15,09:00:00,60,24,36,FMN GV 11 Ramsel
66,Bergstraat 71,2020-06-15,10:00:00,116,46,70,FMN GV 11 Ramsel
66,Bergstraat 71,2020-06-15,11:00:00,136,60,76,FMN GV 11 Ramsel
66,Bergstraat 71,2020-06-15,12:00:00,158,92,66,FMN GV 11 Ramsel
66,Bergstraat 71,2020-06-15,13:00:00,210,66,144,FMN GV 11 Ramsel
66,Bergstraat 71,2020-06-15,14:00:00,192,98,94,FMN GV 11 Ramsel
66,Bergstraat 71,2020-06-15,15:00:00,212,132,80,FMN GV 11 Ramsel
66,Bergstraat 71,2020-06-15,16:00:00,224,134,90,FMN GV 11 Ramsel
66,Bergstraat 71,2020-06-15,17:00:00,158,104,54,FMN GV 11 Ramsel
66,Bergstraat 71,2020-06-15,18:00:00,114,62,52,FMN GV 11 Ramsel
66,Bergstraat 71,2020-06-15,19:00:00,74,36,38,FMN GV 11 Ramsel
66,Bergstraat 71,2020-06-15,20:00:00,54,36,18,FMN GV 11 Ramsel
66,Bergstraat 71,2020-06-15,21:00:00,42,18,24,FMN GV 11 Ramsel
66,Bergstraat 71,2020-06-15,22:00:00,12,6,6,FMN GV 11 Ramsel
66,Bergstraat 71,2020-06-15,23:00:00,2,2,0,FMN GV 11 Ramsel
66,Bergstraat 71,2020-06-16,00:00:00,2,0,2,FMN GV 11 Ramsel
66,Bergstraat 71,2020-06-16,01:00:00,0,0,0,FMN GV 11 Ramsel
66,Bergstraat 71,2020-06-16,02:00:00,18,16,2,FMN GV 11 Ramsel
66,Bergstraat 71,2020-06-16,03:00:00,8,0,8,FMN GV 11 Ramsel
66,Bergstraat 71,2020-06-16,04:00:00,6,4,2,FMN GV 11 Ramsel
66,Bergstraat 71,2020-06-16,05:00:00,12,2,10,FMN GV 11 Ramsel
66,Bergstraat 71,2020-06-16,06:00:00,46,24,22,FMN GV 11 Ramsel
66,Bergstraat 71,2020-06-16,07:00:00,72,16,56,FMN GV 11 Ramsel
66,Bergstraat 71,2020-06-16,08:00:00,114,24,90,FMN GV 11 Ramsel
66,Bergstraat 71,2020-06-16,09:00:00,102,40,62,FMN GV 11 Ramsel
66,Bergstraat 71,2020-06-16,10:00:00,140,76,64,FMN GV 11 Ramsel
66,Bergstraat 71,2020-06-16,11:00:00,92,48,44,FMN GV 11 Ramsel
66,Bergstraat 71,2020-06-16,12:00:00,154,98,56,FMN GV 11 Ramsel
66,Bergstraat 71,2020-06-16,13:00:00,162,60,102,FMN GV 11 Ramsel
66,Bergstraat 71,2020-06-16,14:00:00,212,138,74,FMN GV 11 Ramsel
66,Bergstraat 71,2020-06-16,15:00:00,208,112,96,FMN GV 11 Ramsel
66,Bergstraat 71,2020-06-16,16:00:00,172,110,62,FMN GV 11 Ramsel
66,Bergstraat 71,2020-06-16,17:00:00,142,68,74,FMN GV 11 Ramsel
66,Bergstraat 71,2020-06-16,18:00:00,86,42,44,FMN GV 11 Ramsel
66,Bergstraat 71,2020-06-16,19:00:00,92,50,42,FMN GV 11 Ramsel
66,Bergstraat 71,2020-06-16,20:00:00,70,40,30,FMN GV 11 Ramsel
66,Bergstraat 71,2020-06-16,21:00:00,34,22,12,FMN GV 11 Ramsel
66,Bergstraat 71,2020-06-16,22:00:00,14,8,6,FMN GV 11 Ramsel
66,Bergstraat 71,2020-06-16,23:00:00,4,4,0,FMN GV 11 Ramsel
66,Bergstraat 71,2020-06-17,00:00:00,0,0,0,FMN GV 11 Ramsel
66,Bergstraat 71,2020-06-17,01:00:00,2,2,0,FMN GV 11 Ramsel
66,Bergstraat 71,2020-06-17,02:00:00,0,0,0,FMN GV 11 Ramsel
66,Bergstraat 71,2020-06-17,03:00:00,0,0,0,FMN GV 11 Ramsel
66,Bergstraat 71,2020-06-17,04:00:00,2,2,0,FMN GV 11 Ramsel
66,Bergstraat 71,2020-06-17,05:00:00,4,2,2,FMN GV 11 Ramsel
66,Bergstraat 71,2020-06-17,06:00:00,36,16,20,FMN GV 11 Ramsel
66,Bergstraat 71,2020-06-17,07:00:00,62,14,48,FMN GV 11 Ramsel
66,Bergstraat 71,2020-06-17,08:00:00,106,28,78,FMN GV 11 Ramsel
66,Bergstraat 71,2020-06-17,09:00:00,60,20,40,FMN GV 11 Ramsel
66,Bergstraat 71,2020-06-17,10:00:00,104,56,48,FMN GV 11 Ramsel
66,Bergstraat 71,2020-06-17,11:00:00,106,68,38,FMN GV 11 Ramsel
66,Bergstraat 71,2020-06-17,12:00:00,102,52,50,FMN GV 11 Ramsel
66,Bergstraat 71,2020-06-17,13:00:00,104,72,32,FMN GV 11 Ramsel
66,Bergstraat 71,2020-06-17,14:00:00,110,54,56,FMN GV 11 Ramsel
66,Bergstraat 71,2020-06-17,15:00:00,94,48,46,FMN GV 11 Ramsel
66,Bergstraat 71,2020-06-17,16:00:00,42,26,16,FMN GV 11 Ramsel
66,Bergstraat 71,2020-06-17,17:00:00,24,8,16,FMN GV 11 Ramsel
66,Bergstraat 71,2020-06-17,18:00:00,18,18,0,FMN GV 11 Ramsel
66,Bergstraat 71,2020-06-17,19:00:00,20,12,8,FMN GV 11 Ramsel
66,Bergstraat 71,2020-06-17,20:00:00,8,2,6,FMN GV 11 Ramsel
66,Bergstraat 71,2020-06-17,21:00:00,6,6,0,FMN GV 11 Ramsel
66,Bergstraat 71,2020-06-17,22:00:00,2,2,0,FMN GV 11 Ramsel
66,Bergstraat 71,2020-06-17,23:00:00,0,0,0,FMN GV 11 Ramsel
66,Bergstraat 71,2020-06-18,00:00:00,0,0,0,FMN GV 11 Ramsel
66,Bergstraat 71,2020-06-18,01:00:00,0,0,0,FMN GV 11 Ramsel
66,Bergstraat 71,2020-06-18,02:00:00,0,0,0,FMN GV 11 Ramsel
66,Bergstraat 71,2020-06-18,03:00:00,0,0,0,FMN GV 11 Ramsel
66,Bergstraat 71,2020-06-18,04:00:00,4,2,2,FMN GV 11 Ramsel
66,Bergstraat 71,2020-06-18,05:00:00,2,0,2,FMN GV 11 Ramsel
66,Bergstraat 71,2020-06-18,06:00:00,50,22,28,FMN GV 11 Ramsel
66,Bergstraat 71,2020-06-18,07:00:00,44,10,34,FMN GV 11 Ramsel
66,Bergstraat 71,2020-06-18,08:00:00,80,8,72,FMN GV 11 Ramsel
66,Bergstraat 71,2020-06-18,09:00:00,50,12,38,FMN GV 11 Ramsel
66,Bergstraat 71,2020-06-18,10:00:00,76,46,30,FMN GV 11 Ramsel
66,Bergstraat 71,2020-06-18,11:00:00,96,64,32,FMN GV 11 Ramsel
66,Bergstraat 71,2020-06-18,12:00:00,130,68,62,FMN GV 11 Ramsel
66,Bergstraat 71,2020-06-18,13:00:00,122,70,52,FMN GV 11 Ramsel
66,Bergstraat 71,2020-06-18,14:00:00,122,48,74,FMN GV 11 Ramsel
66,Bergstraat 71,2020-06-18,15:00:00,172,108,64,FMN GV 11 Ramsel
66,Bergstraat 71,2020-06-18,16:00:00,138,92,46,FMN GV 11 Ramsel
66,Bergstraat 71,2020-06-18,17:00:00,86,56,30,FMN GV 11 Ramsel
66,Bergstraat 71,2020-06-18,18:00:00,82,52,30,FMN GV 11 Ramsel
66,Bergstraat 71,2020-06-18,19:00:00,66,38,28,FMN GV 11 Ramsel
66,Bergstraat 71,2020-06-18,20:00:00,82,52,30,FMN GV 11 Ramsel
66,Bergstraat 71,2020-06-18,21:00:00,52,34,18,FMN GV 11 Ramsel
66,Bergstraat 71,2020-06-18,22:00:00,16,8,8,FMN GV 11 Ramsel
66,Bergstraat 71,2020-06-18,23:00:00,2,2,0,FMN GV 11 Ramsel
66,Bergstraat 71,2020-06-19,00:00:00,2,2,0,FMN GV 11 Ramsel
66,Bergstraat 71,2020-06-19,01:00:00,0,0,0,FMN GV 11 Ramsel
66,Bergstraat 71,2020-06-19,02:00:00,2,2,0,FMN GV 11 Ramsel
66,Bergstraat 71,2020-06-19,03:00:00,0,0,0,FMN GV 11 Ramsel
66,Bergstraat 71,2020-06-19,04:00:00,4,4,0,FMN GV 11 Ramsel
66,Bergstraat 71,2020-06-19,05:00:00,8,2,6,FMN GV 11 Ramsel
66,Bergstraat 71,2020-06-19,06:00:00,30,14,16,FMN GV 11 Ramsel
66,Bergstraat 71,2020-06-19,07:00:00,54,8,46,FMN GV 11 Ramsel
66,Bergstraat 71,2020-06-19,08:00:00,96,20,76,FMN GV 11 Ramsel
66,Bergstraat 71,2020-06-19,09:00:00,98,46,52,FMN GV 11 Ramsel
66,Bergstraat 71,2020-06-19,10:00:00,170,64,106,FMN GV 11 Ramsel
66,Bergstraat 71,2020-06-19,11:00:00,132,84,48,FMN GV 11 Ramsel
66,Bergstraat 71,2020-06-19,12:00:00,152,78,74,FMN GV 11 Ramsel
66,Bergstraat 71,2020-06-19,13:00:00,188,88,100,FMN GV 11 Ramsel
66,Bergstraat 71,2020-06-19,14:00:00,222,128,94,FMN GV 11 Ramsel
66,Bergstraat 71,2020-06-19,15:00:00,198,116,82,FMN GV 11 Ramsel
66,Bergstraat 71,2020-06-19,16:00:00,140,74,66,FMN GV 11 Ramsel
66,Bergstraat 71,2020-06-19,17:00:00,128,78,50,FMN GV 11 Ramsel
66,Bergstraat 71,2020-06-19,18:00:00,84,34,50,FMN GV 11 Ramsel
66,Bergstraat 71,2020-06-19,19:00:00,90,54,36,FMN GV 11 Ramsel
66,Bergstraat 71,2020-06-19,20:00:00,102,56,46,FMN GV 11 Ramsel
66,Bergstraat 71,2020-06-19,21:00:00,32,12,20,FMN GV 11 Ramsel
66,Bergstraat 71,2020-06-19,22:00:00,20,10,10,FMN GV 11 Ramsel
66,Bergstraat 71,2020-06-19,23:00:00,18,10,8,FMN GV 11 Ramsel
66,Bergstraat 71,2020-06-20,00:00:00,16,8,8,FMN GV 11 Ramsel
66,Bergstraat 71,2020-06-20,01:00:00,28,22,6,FMN GV 11 Ramsel
66,Bergstraat 71,2020-06-20,02:00:00,4,2,2,FMN GV 11 Ramsel
66,Bergstraat 71,2020-06-20,03:00:00,0,0,0,FMN GV 11 Ramsel
66,Bergstraat 71,2020-06-20,04:00:00,0,0,0,FMN GV 11 Ramsel
66,Bergstraat 71,2020-06-20,05:00:00,2,2,0,FMN GV 11 Ramsel
66,Bergstraat 71,2020-06-20,06:00:00,10,0,10,FMN GV 11 Ramsel
66,Bergstraat 71,2020-06-20,07:00:00,18,8,10,FMN GV 11 Ramsel
66,Bergstraat 71,2020-06-20,08:00:00,62,14,48,FMN GV 11 Ramsel
66,Bergstraat 71,2020-06-20,09:00:00,90,54,36,FMN GV 11 Ramsel
66,Bergstraat 71,2020-06-20,10:00:00,148,66,82,FMN GV 11 Ramsel
66,Bergstraat 71,2020-06-20,11:00:00,254,94,160,FMN GV 11 Ramsel
66,Bergstraat 71,2020-06-20,12:00:00,180,86,94,FMN GV 11 Ramsel
66,Bergstraat 71,2020-06-20,13:00:00,318,156,162,FMN GV 11 Ramsel
66,Bergstraat 71,2020-06-20,14:00:00,318,140,178,FMN GV 11 Ramsel
66,Bergstraat 71,2020-06-20,15:00:00,342,204,138,FMN GV 11 Ramsel
66,Bergstraat 71,2020-06-20,16:00:00,336,178,158,FMN GV 11 Ramsel
66,Bergstraat 71,2020-06-20,17:00:00,216,130,86,FMN GV 11 Ramsel
66,Bergstraat 71,2020-06-20,18:00:00,104,58,46,FMN GV 11 Ramsel
66,Bergstraat 71,2020-06-20,19:00:00,80,34,46,FMN GV 11 Ramsel
66,Bergstraat 71,2020-06-20,20:00:00,64,42,22,FMN GV 11 Ramsel
66,Bergstraat 71,2020-06-20,21:00:00,44,20,24,FMN GV 11 Ramsel
66,Bergstraat 71,2020-06-20,22:00:00,12,8,4,FMN GV 11 Ramsel
66,Bergstraat 71,2020-06-20,23:00:00,12,10,2,FMN GV 11 Ramsel
66,Bergstraat 71,2020-06-21,00:00:00,14,4,10,FMN GV 11 Ramsel
66,Bergstraat 71,2020-06-21,01:00:00,6,6,0,FMN GV 11 Ramsel
66,Bergstraat 71,2020-06-21,02:00:00,2,2,0,FMN GV 11 Ramsel
66,Bergstraat 71,2020-06-21,03:00:00,2,0,2,FMN GV 11 Ramsel
66,Bergstraat 71,2020-06-21,04:00:00,0,0,0,FMN GV 11 Ramsel
66,Bergstraat 71,2020-06-21,05:00:00,2,2,0,FMN GV 11 Ramsel
66,Bergstraat 71,2020-06-21,06:00:00,10,0,10,FMN GV 11 Ramsel
66,Bergstraat 71,2020-06-21,07:00:00,34,12,22,FMN GV 11 Ramsel
66,Bergstraat 71,2020-06-21,08:00:00,158,38,120,FMN GV 11 Ramsel
66,Bergstraat 71,2020-06-21,09:00:00,306,82,224,FMN GV 11 Ramsel
66,Bergstraat 71,2020-06-21,10:00:00,334,150,184,FMN GV 11 Ramsel
66,Bergstraat 71,2020-06-21,11:00:00,310,152,158,FMN GV 11 Ramsel
66,Bergstraat 71,2020-06-21,12:00:00,294,170,124,FMN GV 11 Ramsel
66,Bergstraat 71,2020-06-21,13:00:00,282,158,124,FMN GV 11 Ramsel
66,Bergstraat 71,2020-06-21,14:00:00,356,186,170,FMN GV 11 Ramsel
66,Bergstraat 71,2020-06-21,15:00:00,362,210,152,FMN GV 11 Ramsel
66,Bergstraat 71,2020-06-21,16:00:00,314,162,152,FMN GV 11 Ramsel
66,Bergstraat 71,2020-06-21,17:00:00,190,84,106,FMN GV 11 Ramsel
66,Bergstraat 71,2020-06-21,18:00:00,112,58,54,FMN GV 11 Ramsel
66,Bergstraat 71,2020-06-21,19:00:00,88,48,40,FMN GV 11 Ramsel
66,Bergstraat 71,2020-06-21,20:00:00,38,18,20,FMN GV 11 Ramsel
66,Bergstraat 71,2020-06-21,21:00:00,12,12,0,FMN GV 11 Ramsel
66,Bergstraat 71,2020-06-21,22:00:00,8,6,2,FMN GV 11 Ramsel
66,Bergstraat 71,2020-06-21,23:00:00,0,0,0,FMN GV 11 Ramsel
66,Bergstraat 71,2020-06-22,00:00:00,0,0,0,FMN GV 11 Ramsel
66,Bergstraat 71,2020-06-22,01:00:00,0,0,0,FMN GV 11 Ramsel
66,Bergstraat 71,2020-06-22,02:00:00,0,0,0,FMN GV 11 Ramsel
66,Bergstraat 71,2020-06-22,03:00:00,0,0,0,FMN GV 11 Ramsel
66,Bergstraat 71,2020-06-22,04:00:00,2,2,0,FMN GV 11 Ramsel
66,Bergstraat 71,2020-06-22,05:00:00,12,4,8,FMN GV 11 Ramsel
66,Bergstraat 71,2020-06-22,06:00:00,60,24,36,FMN GV 11 Ramsel
66,Bergstraat 71,2020-06-22,07:00:00,76,18,58,FMN GV 11 Ramsel
66,Bergstraat 71,2020-06-22,08:00:00,126,36,90,FMN GV 11 Ramsel
66,Bergstraat 71,2020-06-22,09:00:00,66,24,42,FMN GV 11 Ramsel
66,Bergstraat 71,2020-06-22,10:00:00,92,26,66,FMN GV 11 Ramsel
66,Bergstraat 71,2020-06-22,11:00:00,126,66,60,FMN GV 11 Ramsel
66,Bergstraat 71,2020-06-22,12:00:00,146,80,66,FMN GV 11 Ramsel
66,Bergstraat 71,2020-06-22,13:00:00,242,100,142,FMN GV 11 Ramsel
66,Bergstraat 71,2020-06-22,14:00:00,228,104,124,FMN GV 11 Ramsel
66,Bergstraat 71,2020-06-22,15:00:00,302,206,96,FMN GV 11 Ramsel
66,Bergstraat 71,2020-06-22,16:00:00,242,152,90,FMN GV 11 Ramsel
66,Bergstraat 71,2020-06-22,17:00:00,134,86,48,FMN GV 11 Ramsel
66,Bergstraat 71,2020-06-22,18:00:00,114,74,40,FMN GV 11 Ramsel
66,Bergstraat 71,2020-06-22,19:00:00,112,62,50,FMN GV 11 Ramsel
66,Bergstraat 71,2020-06-22,20:00:00,106,62,44,FMN GV 11 Ramsel
66,Bergstraat 71,2020-06-22,21:00:00,26,16,10,FMN GV 11 Ramsel
66,Bergstraat 71,2020-06-22,22:00:00,16,8,8,FMN GV 11 Ramsel
66,Bergstraat 71,2020-06-22,23:00:00,2,0,2,FMN GV 11 Ramsel
66,Bergstraat 71,2020-06-23,00:00:00,2,0,2,FMN GV 11 Ramsel
66,Bergstraat 71,2020-06-23,01:00:00,2,2,0,FMN GV 11 Ramsel
66,Bergstraat 71,2020-06-23,02:00:00,0,0,0,FMN GV 11 Ramsel
66,Bergstraat 71,2020-06-23,03:00:00,0,0,0,FMN GV 11 Ramsel
66,Bergstraat 71,2020-06-23,04:00:00,8,6,2,FMN GV 11 Ramsel
66,Bergstraat 71,2020-06-23,05:00:00,20,8,12,FMN GV 11 Ramsel
66,Bergstraat 71,2020-06-23,06:00:00,46,26,20,FMN GV 11 Ramsel
66,Bergstraat 71,2020-06-23,07:00:00,66,24,42,FMN GV 11 Ramsel
66,Bergstraat 71,2020-06-23,08:00:00,216,92,124,FMN GV 11 Ramsel
66,Bergstraat 71,2020-06-23,09:00:00,118,62,56,FMN GV 11 Ramsel
66,Bergstraat 71,2020-06-23,10:00:00,136,46,90,FMN GV 11 Ramsel
66,Bergstraat 71,2020-06-23,11:00:00,186,96,90,FMN GV 11 Ramsel
66,Bergstraat 71,2020-06-23,12:00:00,198,92,106,FMN GV 11 Ramsel
66,Bergstraat 71,2020-06-23,13:00:00,266,142,124,FMN GV 11 Ramsel
66,Bergstraat 71,2020-06-23,14:00:00,314,168,146,FMN GV 11 Ramsel
66,Bergstraat 71,2020-06-23,15:00:00,308,176,132,FMN GV 11 Ramsel
66,Bergstraat 71,2020-06-23,16:00:00,278,148,130,FMN GV 11 Ramsel
66,Bergstraat 71,2020-06-23,17:00:00,196,108,88,FMN GV 11 Ramsel
66,Bergstraat 71,2020-06-23,18:00:00,164,70,94,FMN GV 11 Ramsel
66,Bergstraat 71,2020-06-23,19:00:00,138,70,68,FMN GV 11 Ramsel
66,Bergstraat 71,2020-06-23,20:00:00,120,70,50,FMN GV 11 Ramsel
66,Bergstraat 71,2020-06-23,21:00:00,80,58,22,FMN GV 11 Ramsel
66,Bergstraat 71,2020-06-23,22:00:00,32,22,10,FMN GV 11 Ramsel
66,Bergstraat 71,2020-06-23,23:00:00,10,6,4,FMN GV 11 Ramsel
66,Bergstraat 71,2020-06-24,00:00:00,0,0,0,FMN GV 11 Ramsel
66,Bergstraat 71,2020-06-24,01:00:00,4,0,4,FMN GV 11 Ramsel
66,Bergstraat 71,2020-06-24,02:00:00,2,0,2,FMN GV 11 Ramsel
66,Bergstraat 71,2020-06-24,03:00:00,2,2,0,FMN GV 11 Ramsel
66,Bergstraat 71,2020-06-24,04:00:00,6,2,4,FMN GV 11 Ramsel
66,Bergstraat 71,2020-06-24,05:00:00,24,14,10,FMN GV 11 Ramsel
66,Bergstraat 71,2020-06-24,06:00:00,46,10,36,FMN GV 11 Ramsel
66,Bergstraat 71,2020-06-24,07:00:00,116,44,72,FMN GV 11 Ramsel
66,Bergstraat 71,2020-06-24,08:00:00,160,56,104,FMN GV 11 Ramsel
66,Bergstraat 71,2020-06-24,09:00:00,118,66,52,FMN GV 11 Ramsel
66,Bergstraat 71,2020-06-24,10:00:00,178,84,94,FMN GV 11 Ramsel
66,Bergstraat 71,2020-06-24,11:00:00,194,104,90,FMN GV 11 Ramsel
66,Bergstraat 71,2020-06-24,12:00:00,160,78,82,FMN GV 11 Ramsel
66,Bergstraat 71,2020-06-24,13:00:00,212,108,104,FMN GV 11 Ramsel
66,Bergstraat 71,2020-06-24,14:00:00,208,100,108,FMN GV 11 Ramsel
66,Bergstraat 71,2020-06-24,15:00:00,172,96,76,FMN GV 11 Ramsel
66,Bergstraat 71,2020-06-24,16:00:00,234,148,86,FMN GV 11 Ramsel
66,Bergstraat 71,2020-06-24,17:00:00,192,98,94,FMN GV 11 Ramsel
66,Bergstraat 71,2020-06-24,18:00:00,156,70,86,FMN GV 11 Ramsel
66,Bergstraat 71,2020-06-24,19:00:00,228,128,100,FMN GV 11 Ramsel
66,Bergstraat 71,2020-06-24,20:00:00,160,78,82,FMN GV 11 Ramsel
66,Bergstraat 71,2020-06-24,21:00:00,82,54,28,FMN GV 11 Ramsel
66,Bergstraat 71,2020-06-24,22:00:00,28,12,16,FMN GV 11 Ramsel
66,Bergstraat 71,2020-06-24,23:00:00,2,2,0,FMN GV 11 Ramsel
66,Bergstraat 71,2020-06-25,00:00:00,2,2,0,FMN GV 11 Ramsel
66,Bergstraat 71,2020-06-25,01:00:00,2,2,0,FMN GV 11 Ramsel
66,Bergstraat 71,2020-06-25,02:00:00,2,2,0,FMN GV 11 Ramsel
66,Bergstraat 71,2020-06-25,03:00:00,0,0,0,FMN GV 11 Ramsel
66,Bergstraat 71,2020-06-25,04:00:00,18,12,6,FMN GV 11 Ramsel
66,Bergstraat 71,2020-06-25,05:00:00,24,12,12,FMN GV 11 Ramsel
66,Bergstraat 71,2020-06-25,06:00:00,48,18,30,FMN GV 11 Ramsel
66,Bergstraat 71,2020-06-25,07:00:00,100,20,80,FMN GV 11 Ramsel
66,Bergstraat 71,2020-06-25,08:00:00,128,46,82,FMN GV 11 Ramsel
66,Bergstraat 71,2020-06-25,09:00:00,142,48,94,FMN GV 11 Ramsel
66,Bergstraat 71,2020-06-25,10:00:00,218,94,124,FMN GV 11 Ramsel
66,Bergstraat 71,2020-06-25,11:00:00,162,78,84,FMN GV 11 Ramsel
66,Bergstraat 71,2020-06-25,12:00:00,166,118,48,FMN GV 11 Ramsel
66,Bergstraat 71,2020-06-25,13:00:00,208,110,98,FMN GV 11 Ramsel
66,Bergstraat 71,2020-06-25,14:00:00,206,94,112,FMN GV 11 Ramsel
66,Bergstraat 71,2020-06-25,15:00:00,186,102,84,FMN GV 11 Ramsel
66,Bergstraat 71,2020-06-25,16:00:00,182,114,68,FMN GV 11 Ramsel
66,Bergstraat 71,2020-06-25,17:00:00,176,106,70,FMN GV 11 Ramsel
66,Bergstraat 71,2020-06-25,18:00:00,130,80,50,FMN GV 11 Ramsel
66,Bergstraat 71,2020-06-25,19:00:00,142,86,56,FMN GV 11 Ramsel
66,Bergstraat 71,2020-06-25,20:00:00,142,86,56,FMN GV 11 Ramsel
66,Bergstraat 71,2020-06-25,21:00:00,66,36,30,FMN GV 11 Ramsel
66,Bergstraat 71,2020-06-25,22:00:00,34,16,18,FMN GV 11 Ramsel
66,Bergstraat 71,2020-06-25,23:00:00,8,4,4,FMN GV 11 Ramsel
66,Bergstraat 71,2020-06-26,00:00:00,4,2,2,FMN GV 11 Ramsel
66,Bergstraat 71,2020-06-26,01:00:00,4,2,2,FMN GV 11 Ramsel
66,Bergstraat 71,2020-06-26,02:00:00,8,8,0,FMN GV 11 Ramsel
66,Bergstraat 71,2020-06-26,03:00:00,0,0,0,FMN GV 11 Ramsel
66,Bergstraat 71,2020-06-26,04:00:00,6,4,2,FMN GV 11 Ramsel
66,Bergstraat 71,2020-06-26,05:00:00,24,18,6,FMN GV 11 Ramsel
66,Bergstraat 71,2020-06-26,06:00:00,44,14,30,FMN GV 11 Ramsel
66,Bergstraat 71,2020-06-26,07:00:00,76,26,50,FMN GV 11 Ramsel
66,Bergstraat 71,2020-06-26,08:00:00,134,50,84,FMN GV 11 Ramsel
66,Bergstraat 71,2020-06-26,09:00:00,188,64,124,FMN GV 11 Ramsel
66,Bergstraat 71,2020-06-26,10:00:00,162,80,82,FMN GV 11 Ramsel
66,Bergstraat 71,2020-06-26,11:00:00,146,88,58,FMN GV 11 Ramsel
66,Bergstraat 71,2020-06-26,12:00:00,142,72,70,FMN GV 11 Ramsel
66,Bergstraat 71,2020-06-26,13:00:00,142,76,66,FMN GV 11 Ramsel
66,Bergstraat 71,2020-06-26,14:00:00,178,94,84,FMN GV 11 Ramsel
66,Bergstraat 71,2020-06-26,15:00:00,176,106,70,FMN GV 11 Ramsel
66,Bergstraat 71,2020-06-26,16:00:00,144,70,74,FMN GV 11 Ramsel
66,Bergstraat 71,2020-06-26,17:00:00,124,72,52,FMN GV 11 Ramsel
66,Bergstraat 71,2020-06-26,18:00:00,80,46,34,FMN GV 11 Ramsel
66,Bergstraat 71,2020-06-26,19:00:00,30,18,12,FMN GV 11 Ramsel
66,Bergstraat 71,2020-06-26,20:00:00,72,22,50,FMN GV 11 Ramsel
66,Bergstraat 71,2020-06-26,21:00:00,38,28,10,FMN GV 11 Ramsel
66,Bergstraat 71,2020-06-26,22:00:00,8,0,8,FMN GV 11 Ramsel
66,Bergstraat 71,2020-06-26,23:00:00,6,4,2,FMN GV 11 Ramsel
66,Bergstraat 71,2020-06-27,00:00:00,14,14,0,FMN GV 11 Ramsel
66,Bergstraat 71,2020-06-27,01:00:00,18,10,8,FMN GV 11 Ramsel
66,Bergstraat 71,2020-06-27,02:00:00,4,2,2,FMN GV 11 Ramsel
66,Bergstraat 71,2020-06-27,03:00:00,0,0,0,FMN GV 11 Ramsel
66,Bergstraat 71,2020-06-27,04:00:00,4,2,2,FMN GV 11 Ramsel
66,Bergstraat 71,2020-06-27,05:00:00,10,10,0,FMN GV 11 Ramsel
66,Bergstraat 71,2020-06-27,06:00:00,6,0,6,FMN GV 11 Ramsel
66,Bergstraat 71,2020-06-27,07:00:00,10,4,6,FMN GV 11 Ramsel
66,Bergstraat 71,2020-06-27,08:00:00,36,16,20,FMN GV 11 Ramsel
66,Bergstraat 71,2020-06-27,09:00:00,78,24,54,FMN GV 11 Ramsel
66,Bergstraat 71,2020-06-27,10:00:00,116,52,64,FMN GV 11 Ramsel
66,Bergstraat 71,2020-06-27,11:00:00,136,74,62,FMN GV 11 Ramsel
66,Bergstraat 71,2020-06-27,12:00:00,144,92,52,FMN GV 11 Ramsel
66,Bergstraat 71,2020-06-27,13:00:00,198,86,112,FMN GV 11 Ramsel
66,Bergstraat 71,2020-06-27,14:00:00,234,114,120,FMN GV 11 Ramsel
66,Bergstraat 71,2020-06-27,15:00:00,200,102,98,FMN GV 11 Ramsel
66,Bergstraat 71,2020-06-27,16:00:00,116,78,38,FMN GV 11 Ramsel
66,Bergstraat 71,2020-06-27,17:00:00,128,58,70,FMN GV 11 Ramsel
66,Bergstraat 71,2020-06-27,18:00:00,70,44,26,FMN GV 11 Ramsel
66,Bergstraat 71,2020-06-27,19:00:00,50,32,18,FMN GV 11 Ramsel
66,Bergstraat 71,2020-06-27,20:00:00,74,42,32,FMN GV 11 Ramsel
66,Bergstraat 71,2020-06-27,21:00:00,34,18,16,FMN GV 11 Ramsel
66,Bergstraat 71,2020-06-27,22:00:00,22,10,12,FMN GV 11 Ramsel
66,Bergstraat 71,2020-06-27,23:00:00,4,4,0,FMN GV 11 Ramsel
66,Bergstraat 71,2020-06-28,00:00:00,12,10,2,FMN GV 11 Ramsel
66,Bergstraat 71,2020-06-28,01:00:00,20,10,10,FMN GV 11 Ramsel
66,Bergstraat 71,2020-06-28,02:00:00,0,0,0,FMN GV 11 Ramsel
66,Bergstraat 71,2020-06-28,03:00:00,2,0,2,FMN GV 11 Ramsel
66,Bergstraat 71,2020-06-28,04:00:00,2,2,0,FMN GV 11 Ramsel
66,Bergstraat 71,2020-06-28,05:00:00,0,0,0,FMN GV 11 Ramsel
66,Bergstraat 71,2020-06-28,06:00:00,12,6,6,FMN GV 11 Ramsel
66,Bergstraat 71,2020-06-28,07:00:00,30,18,12,FMN GV 11 Ramsel
66,Bergstraat 71,2020-06-28,08:00:00,98,48,50,FMN GV 11 Ramsel
66,Bergstraat 71,2020-06-28,09:00:00,214,80,134,FMN GV 11 Ramsel
66,Bergstraat 71,2020-06-28,10:00:00,190,106,84,FMN GV 11 Ramsel
66,Bergstraat 71,2020-06-28,11:00:00,256,156,100,FMN GV 11 Ramsel
66,Bergstraat 71,2020-06-28,12:00:00,174,118,56,FMN GV 11 Ramsel
66,Bergstraat 71,2020-06-28,13:00:00,250,114,136,FMN GV 11 Ramsel
66,Bergstraat 71,2020-06-28,14:00:00,324,164,160,FMN GV 11 Ramsel
66,Bergstraat 71,2020-06-28,15:00:00,270,120,150,FMN GV 11 Ramsel
66,Bergstraat 71,2020-06-28,16:00:00,260,138,122,FMN GV 11 Ramsel
66,Bergstraat 71,2020-06-28,17:00:00,176,84,92,FMN GV 11 Ramsel
66,Bergstraat 71,2020-06-28,18:00:00,100,42,58,FMN GV 11 Ramsel
66,Bergstraat 71,2020-06-28,19:00:00,72,22,50,FMN GV 11 Ramsel
66,Bergstraat 71,2020-06-28,20:00:00,56,30,26,FMN GV 11 Ramsel
66,Bergstraat 71,2020-06-28,21:00:00,42,18,24,FMN GV 11 Ramsel
66,Bergstraat 71,2020-06-28,22:00:00,14,12,2,FMN GV 11 Ramsel
66,Bergstraat 71,2020-06-28,23:00:00,6,4,2,FMN GV 11 Ramsel
66,Bergstraat 71,2020-06-29,00:00:00,4,0,4,FMN GV 11 Ramsel
66,Bergstraat 71,2020-06-29,01:00:00,4,2,2,FMN GV 11 Ramsel
66,Bergstraat 71,2020-06-29,02:00:00,0,0,0,FMN GV 11 Ramsel
66,Bergstraat 71,2020-06-29,03:00:00,0,0,0,FMN GV 11 Ramsel
66,Bergstraat 71,2020-06-29,04:00:00,4,4,0,FMN GV 11 Ramsel
66,Bergstraat 71,2020-06-29,05:00:00,12,6,6,FMN GV 11 Ramsel
66,Bergstraat 71,2020-06-29,06:00:00,44,12,32,FMN GV 11 Ramsel
66,Bergstraat 71,2020-06-29,07:00:00,64,20,44,FMN GV 11 Ramsel
66,Bergstraat 71,2020-06-29,08:00:00,90,30,60,FMN GV 11 Ramsel
66,Bergstraat 71,2020-06-29,09:00:00,96,66,30,FMN GV 11 Ramsel
66,Bergstraat 71,2020-06-29,10:00:00,66,42,24,FMN GV 11 Ramsel
66,Bergstraat 71,2020-06-29,11:00:00,50,20,30,FMN GV 11 Ramsel
66,Bergstraat 71,2020-06-29,12:00:00,72,36,36,FMN GV 11 Ramsel
66,Bergstraat 71,2020-06-29,13:00:00,118,56,62,FMN GV 11 Ramsel
66,Bergstraat 71,2020-06-29,14:00:00,158,72,86,FMN GV 11 Ramsel
66,Bergstraat 71,2020-06-29,15:00:00,186,98,88,FMN GV 11 Ramsel
66,Bergstraat 71,2020-06-29,16:00:00,166,86,80,FMN GV 11 Ramsel
66,Bergstraat 71,2020-06-29,17:00:00,96,52,44,FMN GV 11 Ramsel
66,Bergstraat 71,2020-06-29,18:00:00,92,44,48,FMN GV 11 Ramsel
66,Bergstraat 71,2020-06-29,19:00:00,54,28,26,FMN GV 11 Ramsel
66,Bergstraat 71,2020-06-29,20:00:00,50,22,28,FMN GV 11 Ramsel
66,Bergstraat 71,2020-06-29,21:00:00,38,18,20,FMN GV 11 Ramsel
66,Bergstraat 71,2020-06-29,22:00:00,36,18,18,FMN GV 11 Ramsel
66,Bergstraat 71,2020-06-29,23:00:00,6,4,2,FMN GV 11 Ramsel
66,Bergstraat 71,2020-06-30,00:00:00,10,10,0,FMN GV 11 Ramsel
66,Bergstraat 71,2020-06-30,01:00:00,34,34,0,FMN GV 11 Ramsel
66,Bergstraat 71,2020-06-30,02:00:00,4,0,4,FMN GV 11 Ramsel
66,Bergstraat 71,2020-06-30,03:00:00,0,0,0,FMN GV 11 Ramsel
66,Bergstraat 71,2020-06-30,04:00:00,6,4,2,FMN GV 11 Ramsel
66,Bergstraat 71,2020-06-30,05:00:00,8,2,6,FMN GV 11 Ramsel
66,Bergstraat 71,2020-06-30,06:00:00,36,20,16,FMN GV 11 Ramsel
66,Bergstraat 71,2020-06-30,07:00:00,40,6,34,FMN GV 11 Ramsel
66,Bergstraat 71,2020-06-30,08:00:00,90,28,62,FMN GV 11 Ramsel
66,Bergstraat 71,2020-06-30,09:00:00,66,22,44,FMN GV 11 Ramsel
66,Bergstraat 71,2020-06-30,10:00:00,92,40,52,FMN GV 11 Ramsel
66,Bergstraat 71,2020-06-30,11:00:00,100,46,54,FMN GV 11 Ramsel
66,Bergstraat 71,2020-06-30,12:00:00,112,68,44,FMN GV 11 Ramsel
66,Bergstraat 71,2020-06-30,13:00:00,128,72,56,FMN GV 11 Ramsel
66,Bergstraat 71,2020-06-30,14:00:00,148,86,62,FMN GV 11 Ramsel
66,Bergstraat 71,2020-06-30,15:00:00,134,76,58,FMN GV 11 Ramsel
66,Bergstraat 71,2020-06-30,16:00:00,118,50,68,FMN GV 11 Ramsel
66,Bergstraat 71,2020-06-30,17:00:00,116,54,62,FMN GV 11 Ramsel
66,Bergstraat 71,2020-06-30,18:00:00,56,34,22,FMN GV 11 Ramsel
66,Bergstraat 71,2020-06-30,19:00:00,28,16,12,FMN GV 11 Ramsel
66,Bergstraat 71,2020-06-30,20:00:00,50,36,14,FMN GV 11 Ramsel
66,Bergstraat 71,2020-06-30,21:00:00,16,8,8,FMN GV 11 Ramsel
66,Bergstraat 71,2020-06-30,22:00:00,14,2,12,FMN GV 11 Ramsel
66,Bergstraat 71,2020-06-30,23:00:00,4,0,4,FMN GV 11 Ramsel
66,Bergstraat 71,2020-07-01,00:00:00,4,4,0,FMN GV 11 Ramsel
66,Bergstraat 71,2020-07-01,01:00:00,4,2,2,FMN GV 11 Ramsel
66,Bergstraat 71,2020-07-01,02:00:00,0,0,0,FMN GV 11 Ramsel
66,Bergstraat 71,2020-07-01,03:00:00,0,0,0,FMN GV 11 Ramsel
66,Bergstraat 71,2020-07-01,04:00:00,6,2,4,FMN GV 11 Ramsel
66,Bergstraat 71,2020-07-01,05:00:00,2,0,2,FMN GV 11 Ramsel
66,Bergstraat 71,2020-07-01,06:00:00,8,6,2,FMN GV 11 Ramsel
66,Bergstraat 71,2020-07-01,07:00:00,16,2,14,FMN GV 11 Ramsel
66,Bergstraat 71,2020-07-01,08:00:00,8,0,8,FMN GV 11 Ramsel
66,Bergstraat 71,2020-07-01,09:00:00,10,6,4,FMN GV 11 Ramsel
66,Bergstraat 71,2020-07-01,10:00:00,8,6,2,FMN GV 11 Ramsel
66,Bergstraat 71,2020-07-01,11:00:00,112,96,16,FMN GV 11 Ramsel
66,Bergstraat 71,2020-07-01,12:00:00,40,34,6,FMN GV 11 Ramsel
66,Bergstraat 71,2020-07-01,13:00:00,42,16,26,FMN GV 11 Ramsel
66,Bergstraat 71,2020-07-01,14:00:00,110,44,66,FMN GV 11 Ramsel
66,Bergstraat 71,2020-07-01,15:00:00,106,38,68,FMN GV 11 Ramsel
66,Bergstraat 71,2020-07-01,16:00:00,78,44,34,FMN GV 11 Ramsel
66,Bergstraat 71,2020-07-01,17:00:00,76,30,46,FMN GV 11 Ramsel
66,Bergstraat 71,2020-07-01,18:00:00,88,58,30,FMN GV 11 Ramsel
66,Bergstraat 71,2020-07-01,19:00:00,116,56,60,FMN GV 11 Ramsel
66,Bergstraat 71,2020-07-01,20:00:00,102,22,80,FMN GV 11 Ramsel
66,Bergstraat 71,2020-07-01,21:00:00,32,26,6,FMN GV 11 Ramsel
66,Bergstraat 71,2020-07-01,22:00:00,26,16,10,FMN GV 11 Ramsel
66,Bergstraat 71,2020-07-01,23:00:00,10,10,0,FMN GV 11 Ramsel
66,Bergstraat 71,2020-07-02,00:00:00,0,0,0,FMN GV 11 Ramsel
66,Bergstraat 71,2020-07-02,01:00:00,0,0,0,FMN GV 11 Ramsel
66,Bergstraat 71,2020-07-02,02:00:00,2,0,2,FMN GV 11 Ramsel
66,Bergstraat 71,2020-07-02,03:00:00,0,0,0,FMN GV 11 Ramsel
66,Bergstraat 71,2020-07-02,04:00:00,2,2,0,FMN GV 11 Ramsel
66,Bergstraat 71,2020-07-02,05:00:00,6,2,4,FMN GV 11 Ramsel
66,Bergstraat 71,2020-07-02,06:00:00,44,18,26,FMN GV 11 Ramsel
66,Bergstraat 71,2020-07-02,07:00:00,44,14,30,FMN GV 11 Ramsel
66,Bergstraat 71,2020-07-02,08:00:00,46,10,36,FMN GV 11 Ramsel
66,Bergstraat 71,2020-07-02,09:00:00,82,16,66,FMN GV 11 Ramsel
66,Bergstraat 71,2020-07-02,10:00:00,112,44,68,FMN GV 11 Ramsel
66,Bergstraat 71,2020-07-02,11:00:00,102,60,42,FMN GV 11 Ramsel
66,Bergstraat 71,2020-07-02,12:00:00,116,54,62,FMN GV 11 Ramsel
66,Bergstraat 71,2020-07-02,13:00:00,128,56,72,FMN GV 11 Ramsel
66,Bergstraat 71,2020-07-02,14:00:00,148,86,62,FMN GV 11 Ramsel
66,Bergstraat 71,2020-07-02,15:00:00,162,82,80,FMN GV 11 Ramsel
66,Bergstraat 71,2020-07-02,16:00:00,146,100,46,FMN GV 11 Ramsel
66,Bergstraat 71,2020-07-02,17:00:00,158,104,54,FMN GV 11 Ramsel
66,Bergstraat 71,2020-07-02,18:00:00,104,52,52,FMN GV 11 Ramsel
66,Bergstraat 71,2020-07-02,19:00:00,80,32,48,FMN GV 11 Ramsel
66,Bergstraat 71,2020-07-02,20:00:00,82,48,34,FMN GV 11 Ramsel
66,Bergstraat 71,2020-07-02,21:00:00,38,28,10,FMN GV 11 Ramsel
66,Bergstraat 71,2020-07-02,22:00:00,40,16,24,FMN GV 11 Ramsel
66,Bergstraat 71,2020-07-02,23:00:00,6,4,2,FMN GV 11 Ramsel
66,Bergstraat 71,2020-07-03,00:00:00,2,2,0,FMN GV 11 Ramsel
66,Bergstraat 71,2020-07-03,01:00:00,4,4,0,FMN GV 11 Ramsel
66,Bergstraat 71,2020-07-03,02:00:00,2,2,0,FMN GV 11 Ramsel
66,Bergstraat 71,2020-07-03,03:00:00,2,2,0,FMN GV 11 Ramsel
66,Bergstraat 71,2020-07-03,04:00:00,4,4,0,FMN GV 11 Ramsel
66,Bergstraat 71,2020-07-03,05:00:00,4,2,2,FMN GV 11 Ramsel
66,Bergstraat 71,2020-07-03,06:00:00,42,22,20,FMN GV 11 Ramsel
66,Bergstraat 71,2020-07-03,07:00:00,42,12,30,FMN GV 11 Ramsel
66,Bergstraat 71,2020-07-03,08:00:00,36,12,24,FMN GV 11 Ramsel
66,Bergstraat 71,2020-07-03,09:00:00,90,40,50,FMN GV 11 Ramsel
66,Bergstraat 71,2020-07-03,10:00:00,116,42,74,FMN GV 11 Ramsel
66,Bergstraat 71,2020-07-03,11:00:00,70,42,28,FMN GV 11 Ramsel
66,Bergstraat 71,2020-07-03,12:00:00,108,36,72,FMN GV 11 Ramsel
66,Bergstraat 71,2020-07-03,13:00:00,196,86,110,FMN GV 11 Ramsel
66,Bergstraat 71,2020-07-03,14:00:00,246,122,124,FMN GV 11 Ramsel
66,Bergstraat 71,2020-07-03,15:00:00,226,120,106,FMN GV 11 Ramsel
66,Bergstraat 71,2020-07-03,16:00:00,224,152,72,FMN GV 11 Ramsel
66,Bergstraat 71,2020-07-03,17:00:00,148,100,48,FMN GV 11 Ramsel
66,Bergstraat 71,2020-07-03,18:00:00,92,46,46,FMN GV 11 Ramsel
66,Bergstraat 71,2020-07-03,19:00:00,88,42,46,FMN GV 11 Ramsel
66,Bergstraat 71,2020-07-03,20:00:00,38,20,18,FMN GV 11 Ramsel
66,Bergstraat 71,2020-07-03,21:00:00,56,28,28,FMN GV 11 Ramsel
66,Bergstraat 71,2020-07-03,22:00:00,10,2,8,FMN GV 11 Ramsel
66,Bergstraat 71,2020-07-03,23:00:00,8,6,2,FMN GV 11 Ramsel
66,Bergstraat 71,2020-07-04,00:00:00,6,4,2,FMN GV 11 Ramsel
66,Bergstraat 71,2020-07-04,01:00:00,20,16,4,FMN GV 11 Ramsel
66,Bergstraat 71,2020-07-04,02:00:00,6,6,0,FMN GV 11 Ramsel
66,Bergstraat 71,2020-07-04,03:00:00,0,0,0,FMN GV 11 Ramsel
66,Bergstraat 71,2020-07-04,04:00:00,2,2,0,FMN GV 11 Ramsel
66,Bergstraat 71,2020-07-04,05:00:00,8,4,4,FMN GV 11 Ramsel
66,Bergstraat 71,2020-07-04,06:00:00,16,10,6,FMN GV 11 Ramsel
66,Bergstraat 71,2020-07-04,07:00:00,18,8,10,FMN GV 11 Ramsel
66,Bergstraat 71,2020-07-04,08:00:00,44,18,26,FMN GV 11 Ramsel
66,Bergstraat 71,2020-07-04,09:00:00,80,34,46,FMN GV 11 Ramsel
66,Bergstraat 71,2020-07-04,10:00:00,80,38,42,FMN GV 11 Ramsel
66,Bergstraat 71,2020-07-04,11:00:00,126,80,46,FMN GV 11 Ramsel
66,Bergstraat 71,2020-07-04,12:00:00,104,56,48,FMN GV 11 Ramsel
66,Bergstraat 71,2020-07-04,13:00:00,74,34,40,FMN GV 11 Ramsel
66,Bergstraat 71,2020-07-04,14:00:00,136,70,66,FMN GV 11 Ramsel
66,Bergstraat 71,2020-07-04,15:00:00,130,60,70,FMN GV 11 Ramsel
66,Bergstraat 71,2020-07-04,16:00:00,168,104,64,FMN GV 11 Ramsel
66,Bergstraat 71,2020-07-04,17:00:00,92,70,22,FMN GV 11 Ramsel
66,Bergstraat 71,2020-07-04,18:00:00,68,24,44,FMN GV 11 Ramsel
66,Bergstraat 71,2020-07-04,19:00:00,28,6,22,FMN GV 11 Ramsel
66,Bergstraat 71,2020-07-04,20:00:00,26,10,16,FMN GV 11 Ramsel
66,Bergstraat 71,2020-07-04,21:00:00,16,4,12,FMN GV 11 Ramsel
66,Bergstraat 71,2020-07-04,22:00:00,8,6,2,FMN GV 11 Ramsel
66,Bergstraat 71,2020-07-04,23:00:00,4,2,2,FMN GV 11 Ramsel
66,Bergstraat 71,2020-07-05,00:00:00,4,2,2,FMN GV 11 Ramsel
66,Bergstraat 71,2020-07-05,01:00:00,6,6,0,FMN GV 11 Ramsel
66,Bergstraat 71,2020-07-05,02:00:00,0,0,0,FMN GV 11 Ramsel
66,Bergstraat 71,2020-07-05,03:00:00,4,4,0,FMN GV 11 Ramsel
66,Bergstraat 71,2020-07-05,04:00:00,2,0,2,FMN GV 11 Ramsel
66,Bergstraat 71,2020-07-05,05:00:00,0,0,0,FMN GV 11 Ramsel
66,Bergstraat 71,2020-07-05,06:00:00,8,2,6,FMN GV 11 Ramsel
66,Bergstraat 71,2020-07-05,07:00:00,20,10,10,FMN GV 11 Ramsel
66,Bergstraat 71,2020-07-05,08:00:00,68,26,42,FMN GV 11 Ramsel
66,Bergstraat 71,2020-07-05,09:00:00,200,92,108,FMN GV 11 Ramsel
66,Bergstraat 71,2020-07-05,10:00:00,172,104,68,FMN GV 11 Ramsel
66,Bergstraat 71,2020-07-05,11:00:00,198,118,80,FMN GV 11 Ramsel
66,Bergstraat 71,2020-07-05,12:00:00,148,76,72,FMN GV 11 Ramsel
66,Bergstraat 71,2020-07-05,13:00:00,120,34,86,FMN GV 11 Ramsel
66,Bergstraat 71,2020-07-05,14:00:00,152,58,94,FMN GV 11 Ramsel
66,Bergstraat 71,2020-07-05,15:00:00,112,58,54,FMN GV 11 Ramsel
66,Bergstraat 71,2020-07-05,16:00:00,130,94,36,FMN GV 11 Ramsel
66,Bergstraat 71,2020-07-05,17:00:00,66,50,16,FMN GV 11 Ramsel
66,Bergstraat 71,2020-07-05,18:00:00,90,50,40,FMN GV 11 Ramsel
66,Bergstraat 71,2020-07-05,19:00:00,40,22,18,FMN GV 11 Ramsel
66,Bergstraat 71,2020-07-05,20:00:00,60,26,34,FMN GV 11 Ramsel
66,Bergstraat 71,2020-07-05,21:00:00,30,18,12,FMN GV 11 Ramsel
66,Bergstraat 71,2020-07-05,22:00:00,8,4,4,FMN GV 11 Ramsel
66,Bergstraat 71,2020-07-05,23:00:00,2,2,0,FMN GV 11 Ramsel
66,Bergstraat 71,2020-07-06,00:00:00,10,4,6,FMN GV 11 Ramsel
66,Bergstraat 71,2020-07-06,01:00:00,2,0,2,FMN GV 11 Ramsel
66,Bergstraat 71,2020-07-06,02:00:00,0,0,0,FMN GV 11 Ramsel
66,Bergstraat 71,2020-07-06,03:00:00,2,0,2,FMN GV 11 Ramsel
66,Bergstraat 71,2020-07-06,04:00:00,6,4,2,FMN GV 11 Ramsel
66,Bergstraat 71,2020-07-06,05:00:00,14,14,0,FMN GV 11 Ramsel
66,Bergstraat 71,2020-07-06,06:00:00,44,16,28,FMN GV 11 Ramsel
66,Bergstraat 71,2020-07-06,07:00:00,40,12,28,FMN GV 11 Ramsel
66,Bergstraat 71,2020-07-06,08:00:00,36,16,20,FMN GV 11 Ramsel
66,Bergstraat 71,2020-07-06,09:00:00,58,28,30,FMN GV 11 Ramsel
66,Bergstraat 71,2020-07-06,10:00:00,62,34,28,FMN GV 11 Ramsel
66,Bergstraat 71,2020-07-06,11:00:00,50,28,22,FMN GV 11 Ramsel
66,Bergstraat 71,2020-07-06,12:00:00,74,40,34,FMN GV 11 Ramsel
66,Bergstraat 71,2020-07-06,13:00:00,134,62,72,FMN GV 11 Ramsel
66,Bergstraat 71,2020-07-06,14:00:00,102,46,56,FMN GV 11 Ramsel
66,Bergstraat 71,2020-07-06,15:00:00,110,42,68,FMN GV 11 Ramsel
66,Bergstraat 71,2020-07-06,16:00:00,138,66,72,FMN GV 11 Ramsel
66,Bergstraat 71,2020-07-06,17:00:00,88,54,34,FMN GV 11 Ramsel
66,Bergstraat 71,2020-07-06,18:00:00,68,34,34,FMN GV 11 Ramsel
66,Bergstraat 71,2020-07-06,19:00:00,64,42,22,FMN GV 11 Ramsel
66,Bergstraat 71,2020-07-06,20:00:00,46,24,22,FMN GV 11 Ramsel
66,Bergstraat 71,2020-07-06,21:00:00,16,12,4,FMN GV 11 Ramsel
66,Bergstraat 71,2020-07-06,22:00:00,16,8,8,FMN GV 11 Ramsel
66,Bergstraat 71,2020-07-06,23:00:00,0,0,0,FMN GV 11 Ramsel
66,Bergstraat 71,2020-07-07,00:00:00,0,0,0,FMN GV 11 Ramsel
66,Bergstraat 71,2020-07-07,01:00:00,0,0,0,FMN GV 11 Ramsel
66,Bergstraat 71,2020-07-07,02:00:00,4,2,2,FMN GV 11 Ramsel
66,Bergstraat 71,2020-07-07,03:00:00,0,0,0,FMN GV 11 Ramsel
66,Bergstraat 71,2020-07-07,04:00:00,6,6,0,FMN GV 11 Ramsel
66,Bergstraat 71,2020-07-07,05:00:00,10,4,6,FMN GV 11 Ramsel
66,Bergstraat 71,2020-07-07,06:00:00,34,18,16,FMN GV 11 Ramsel
66,Bergstraat 71,2020-07-07,07:00:00,58,24,34,FMN GV 11 Ramsel
66,Bergstraat 71,2020-07-07,08:00:00,46,8,38,FMN GV 11 Ramsel
66,Bergstraat 71,2020-07-07,09:00:00,60,26,34,FMN GV 11 Ramsel
66,Bergstraat 71,2020-07-07,10:00:00,110,46,64,FMN GV 11 Ramsel
66,Bergstraat 71,2020-07-07,11:00:00,128,78,50,FMN GV 11 Ramsel
66,Bergstraat 71,2020-07-07,12:00:00,150,52,98,FMN GV 11 Ramsel
66,Bergstraat 71,2020-07-07,13:00:00,250,118,132,FMN GV 11 Ramsel
66,Bergstraat 71,2020-07-07,14:00:00,272,136,136,FMN GV 11 Ramsel
66,Bergstraat 71,2020-07-07,15:00:00,278,186,92,FMN GV 11 Ramsel
66,Bergstraat 71,2020-07-07,16:00:00,246,150,96,FMN GV 11 Ramsel
66,Bergstraat 71,2020-07-07,17:00:00,210,106,104,FMN GV 11 Ramsel
66,Bergstraat 71,2020-07-07,18:00:00,112,48,64,FMN GV 11 Ramsel
66,Bergstraat 71,2020-07-07,19:00:00,104,60,44,FMN GV 11 Ramsel
66,Bergstraat 71,2020-07-07,20:00:00,110,72,38,FMN GV 11 Ramsel
66,Bergstraat 71,2020-07-07,21:00:00,34,22,12,FMN GV 11 Ramsel
66,Bergstraat 71,2020-07-07,22:00:00,14,8,6,FMN GV 11 Ramsel
66,Bergstraat 71,2020-07-07,23:00:00,4,2,2,FMN GV 11 Ramsel
66,Bergstraat 71,2020-07-08,00:00:00,4,2,2,FMN GV 11 Ramsel
66,Bergstraat 71,2020-07-08,01:00:00,0,0,0,FMN GV 11 Ramsel
66,Bergstraat 71,2020-07-08,02:00:00,0,0,0,FMN GV 11 Ramsel
66,Bergstraat 71,2020-07-08,03:00:00,0,0,0,FMN GV 11 Ramsel
66,Bergstraat 71,2020-07-08,04:00:00,6,4,2,FMN GV 11 Ramsel
66,Bergstraat 71,2020-07-08,05:00:00,8,6,2,FMN GV 11 Ramsel
66,Bergstraat 71,2020-07-08,06:00:00,26,12,14,FMN GV 11 Ramsel
66,Bergstraat 71,2020-07-08,07:00:00,14,4,10,FMN GV 11 Ramsel
66,Bergstraat 71,2020-07-08,08:00:00,18,4,14,FMN GV 11 Ramsel
66,Bergstraat 71,2020-07-08,09:00:00,8,6,2,FMN GV 11 Ramsel
66,Bergstraat 71,2020-07-08,10:00:00,8,2,6,FMN GV 11 Ramsel
66,Bergstraat 71,2020-07-08,11:00:00,48,8,40,FMN GV 11 Ramsel
66,Bergstraat 71,2020-07-08,12:00:00,8,6,2,FMN GV 11 Ramsel
66,Bergstraat 71,2020-07-08,13:00:00,36,16,20,FMN GV 11 Ramsel
66,Bergstraat 71,2020-07-08,14:00:00,40,14,26,FMN GV 11 Ramsel
66,Bergstraat 71,2020-07-08,15:00:00,46,22,24,FMN GV 11 Ramsel
66,Bergstraat 71,2020-07-08,16:00:00,54,22,32,FMN GV 11 Ramsel
66,Bergstraat 71,2020-07-08,17:00:00,28,18,10,FMN GV 11 Ramsel
66,Bergstraat 71,2020-07-08,18:00:00,38,18,20,FMN GV 11 Ramsel
66,Bergstraat 71,2020-07-08,19:00:00,2,2,0,FMN GV 11 Ramsel
66,Bergstraat 71,2020-07-08,20:00:00,6,2,4,FMN GV 11 Ramsel
66,Bergstraat 71,2020-07-08,21:00:00,8,8,0,FMN GV 11 Ramsel
66,Bergstraat 71,2020-07-08,22:00:00,6,4,2,FMN GV 11 Ramsel
66,Bergstraat 71,2020-07-08,23:00:00,0,0,0,FMN GV 11 Ramsel
66,Bergstraat 71,2020-07-09,00:00:00,0,0,0,FMN GV 11 Ramsel
66,Bergstraat 71,2020-07-09,01:00:00,0,0,0,FMN GV 11 Ramsel
66,Bergstraat 71,2020-07-09,02:00:00,2,2,0,FMN GV 11 Ramsel
66,Bergstraat 71,2020-07-09,03:00:00,0,0,0,FMN GV 11 Ramsel
66,Bergstraat 71,2020-07-09,04:00:00,6,2,4,FMN GV 11 Ramsel
66,Bergstraat 71,2020-07-09,05:00:00,8,4,4,FMN GV 11 Ramsel
66,Bergstraat 71,2020-07-09,06:00:00,16,6,10,FMN GV 11 Ramsel
66,Bergstraat 71,2020-07-09,07:00:00,32,4,28,FMN GV 11 Ramsel
66,Bergstraat 71,2020-07-09,08:00:00,18,10,8,FMN GV 11 Ramsel
66,Bergstraat 71,2020-07-09,09:00:00,28,10,18,FMN GV 11 Ramsel
66,Bergstraat 71,2020-07-09,10:00:00,56,18,38,FMN GV 11 Ramsel
66,Bergstraat 71,2020-07-09,11:00:00,82,28,54,FMN GV 11 Ramsel
66,Bergstraat 71,2020-07-09,12:00:00,48,26,22,FMN GV 11 Ramsel
66,Bergstraat 71,2020-07-09,13:00:00,140,78,62,FMN GV 11 Ramsel
66,Bergstraat 71,2020-07-09,14:00:00,142,74,68,FMN GV 11 Ramsel
66,Bergstraat 71,2020-07-09,15:00:00,124,70,54,FMN GV 11 Ramsel
66,Bergstraat 71,2020-07-09,16:00:00,150,92,58,FMN GV 11 Ramsel
66,Bergstraat 71,2020-07-09,17:00:00,92,46,46,FMN GV 11 Ramsel
66,Bergstraat 71,2020-07-09,18:00:00,84,46,38,FMN GV 11 Ramsel
66,Bergstraat 71,2020-07-09,19:00:00,100,60,40,FMN GV 11 Ramsel
66,Bergstraat 71,2020-07-09,20:00:00,82,48,34,FMN GV 11 Ramsel
66,Bergstraat 71,2020-07-09,21:00:00,50,14,36,FMN GV 11 Ramsel
66,Bergstraat 71,2020-07-09,22:00:00,22,12,10,FMN GV 11 Ramsel
66,Bergstraat 71,2020-07-09,23:00:00,8,6,2,FMN GV 11 Ramsel
66,Bergstraat 71,2020-07-10,00:00:00,2,2,0,FMN GV 11 Ramsel
66,Bergstraat 71,2020-07-10,01:00:00,12,10,2,FMN GV 11 Ramsel
66,Bergstraat 71,2020-07-10,02:00:00,0,0,0,FMN GV 11 Ramsel
66,Bergstraat 71,2020-07-10,03:00:00,0,0,0,FMN GV 11 Ramsel
66,Bergstraat 71,2020-07-10,04:00:00,2,0,2,FMN GV 11 Ramsel
66,Bergstraat 71,2020-07-10,05:00:00,16,12,4,FMN GV 11 Ramsel
66,Bergstraat 71,2020-07-10,06:00:00,28,16,12,FMN GV 11 Ramsel
66,Bergstraat 71,2020-07-10,07:00:00,40,4,36,FMN GV 11 Ramsel
66,Bergstraat 71,2020-07-10,08:00:00,22,10,12,FMN GV 11 Ramsel
66,Bergstraat 71,2020-07-10,09:00:00,18,10,8,FMN GV 11 Ramsel
66,Bergstraat 71,2020-07-10,10:00:00,30,14,16,FMN GV 11 Ramsel
66,Bergstraat 71,2020-07-10,11:00:00,50,30,20,FMN GV 11 Ramsel
66,Bergstraat 71,2020-07-10,12:00:00,60,32,28,FMN GV 11 Ramsel
66,Bergstraat 71,2020-07-10,13:00:00,206,94,112,FMN GV 11 Ramsel
66,Bergstraat 71,2020-07-10,14:00:00,130,58,72,FMN GV 11 Ramsel
66,Bergstraat 71,2020-07-10,15:00:00,152,54,98,FMN GV 11 Ramsel
66,Bergstraat 71,2020-07-10,16:00:00,118,76,42,FMN GV 11 Ramsel
66,Bergstraat 71,2020-07-10,17:00:00,90,54,36,FMN GV 11 Ramsel
66,Bergstraat 71,2020-07-10,18:00:00,108,58,50,FMN GV 11 Ramsel
66,Bergstraat 71,2020-07-10,19:00:00,86,48,38,FMN GV 11 Ramsel
66,Bergstraat 71,2020-07-10,20:00:00,50,30,20,FMN GV 11 Ramsel
66,Bergstraat 71,2020-07-10,21:00:00,46,16,30,FMN GV 11 Ramsel
66,Bergstraat 71,2020-07-10,22:00:00,22,4,18,FMN GV 11 Ramsel
66,Bergstraat 71,2020-07-10,23:00:00,6,2,4,FMN GV 11 Ramsel
66,Bergstraat 71,2020-07-11,00:00:00,0,0,0,FMN GV 11 Ramsel
66,Bergstraat 71,2020-07-11,01:00:00,30,26,4,FMN GV 11 Ramsel
66,Bergstraat 71,2020-07-11,02:00:00,2,2,0,FMN GV 11 Ramsel
66,Bergstraat 71,2020-07-11,03:00:00,6,0,6,FMN GV 11 Ramsel
66,Bergstraat 71,2020-07-11,04:00:00,0,0,0,FMN GV 11 Ramsel
66,Bergstraat 71,2020-07-11,05:00:00,6,4,2,FMN GV 11 Ramsel
66,Bergstraat 71,2020-07-11,06:00:00,14,6,8,FMN GV 11 Ramsel
66,Bergstraat 71,2020-07-11,07:00:00,32,20,12,FMN GV 11 Ramsel
66,Bergstraat 71,2020-07-11,08:00:00,44,14,30,FMN GV 11 Ramsel
66,Bergstraat 71,2020-07-11,09:00:00,134,16,118,FMN GV 11 Ramsel
66,Bergstraat 71,2020-07-11,10:00:00,118,60,58,FMN GV 11 Ramsel
66,Bergstraat 71,2020-07-11,11:00:00,160,60,100,FMN GV 11 Ramsel
66,Bergstraat 71,2020-07-11,12:00:00,244,100,144,FMN GV 11 Ramsel
66,Bergstraat 71,2020-07-11,13:00:00,210,100,110,FMN GV 11 Ramsel
66,Bergstraat 71,2020-07-11,14:00:00,308,156,152,FMN GV 11 Ramsel
66,Bergstraat 71,2020-07-11,15:00:00,328,194,134,FMN GV 11 Ramsel
66,Bergstraat 71,2020-07-11,16:00:00,310,150,160,FMN GV 11 Ramsel
66,Bergstraat 71,2020-07-11,17:00:00,148,96,52,FMN GV 11 Ramsel
66,Bergstraat 71,2020-07-11,18:00:00,94,40,54,FMN GV 11 Ramsel
66,Bergstraat 71,2020-07-11,19:00:00,52,28,24,FMN GV 11 Ramsel
66,Bergstraat 71,2020-07-11,20:00:00,70,32,38,FMN GV 11 Ramsel
66,Bergstraat 71,2020-07-11,21:00:00,38,24,14,FMN GV 11 Ramsel
66,Bergstraat 71,2020-07-11,22:00:00,20,6,14,FMN GV 11 Ramsel
66,Bergstraat 71,2020-07-11,23:00:00,12,8,4,FMN GV 11 Ramsel
66,Bergstraat 71,2020-07-12,00:00:00,0,0,0,FMN GV 11 Ramsel
66,Bergstraat 71,2020-07-12,01:00:00,2,2,0,FMN GV 11 Ramsel
66,Bergstraat 71,2020-07-12,02:00:00,0,0,0,FMN GV 11 Ramsel
66,Bergstraat 71,2020-07-12,03:00:00,0,0,0,FMN GV 11 Ramsel
66,Bergstraat 71,2020-07-12,04:00:00,0,0,0,FMN GV 11 Ramsel
66,Bergstraat 71,2020-07-12,05:00:00,2,0,2,FMN GV 11 Ramsel
66,Bergstraat 71,2020-07-12,06:00:00,16,4,12,FMN GV 11 Ramsel
66,Bergstraat 71,2020-07-12,07:00:00,32,14,18,FMN GV 11 Ramsel
66,Bergstraat 71,2020-07-12,08:00:00,108,20,88,FMN GV 11 Ramsel
66,Bergstraat 71,2020-07-12,09:00:00,166,54,112,FMN GV 11 Ramsel
66,Bergstraat 71,2020-07-12,10:00:00,282,130,152,FMN GV 11 Ramsel
66,Bergstraat 71,2020-07-12,11:00:00,338,202,136,FMN GV 11 Ramsel
66,Bergstraat 71,2020-07-12,12:00:00,188,92,96,FMN GV 11 Ramsel
66,Bergstraat 71,2020-07-12,13:00:00,504,234,270,FMN GV 11 Ramsel
66,Bergstraat 71,2020-07-12,14:00:00,536,206,330,FMN GV 11 Ramsel
66,Bergstraat 71,2020-07-12,15:00:00,398,202,196,FMN GV 11 Ramsel
66,Bergstraat 71,2020-07-12,16:00:00,330,182,148,FMN GV 11 Ramsel
66,Bergstraat 71,2020-07-12,17:00:00,224,106,118,FMN GV 11 Ramsel
66,Bergstraat 71,2020-07-12,18:00:00,148,80,68,FMN GV 11 Ramsel
66,Bergstraat 71,2020-07-12,19:00:00,96,52,44,FMN GV 11 Ramsel
66,Bergstraat 71,2020-07-12,20:00:00,50,26,24,FMN GV 11 Ramsel
66,Bergstraat 71,2020-07-12,21:00:00,28,16,12,FMN GV 11 Ramsel
66,Bergstraat 71,2020-07-12,22:00:00,8,8,0,FMN GV 11 Ramsel
66,Bergstraat 71,2020-07-12,23:00:00,12,12,0,FMN GV 11 Ramsel
66,Bergstraat 71,2020-07-13,00:00:00,0,0,0,FMN GV 11 Ramsel
66,Bergstraat 71,2020-07-13,01:00:00,0,0,0,FMN GV 11 Ramsel
66,Bergstraat 71,2020-07-13,02:00:00,0,0,0,FMN GV 11 Ramsel
66,Bergstraat 71,2020-07-13,03:00:00,0,0,0,FMN GV 11 Ramsel
66,Bergstraat 71,2020-07-13,04:00:00,6,2,4,FMN GV 11 Ramsel
66,Bergstraat 71,2020-07-13,05:00:00,14,14,0,FMN GV 11 Ramsel
66,Bergstraat 71,2020-07-13,06:00:00,30,14,16,FMN GV 11 Ramsel
66,Bergstraat 71,2020-07-13,07:00:00,52,24,28,FMN GV 11 Ramsel
66,Bergstraat 71,2020-07-13,08:00:00,52,22,30,FMN GV 11 Ramsel
66,Bergstraat 71,2020-07-13,09:00:00,70,22,48,FMN GV 11 Ramsel
66,Bergstraat 71,2020-07-13,10:00:00,96,40,56,FMN GV 11 Ramsel
66,Bergstraat 71,2020-07-13,11:00:00,208,68,140,FMN GV 11 Ramsel
66,Bergstraat 71,2020-07-13,12:00:00,144,72,72,FMN GV 11 Ramsel
66,Bergstraat 71,2020-07-13,13:00:00,388,138,250,FMN GV 11 Ramsel
66,Bergstraat 71,2020-07-13,14:00:00,350,144,206,FMN GV 11 Ramsel
66,Bergstraat 71,2020-07-13,15:00:00,306,144,162,FMN GV 11 Ramsel
66,Bergstraat 71,2020-07-13,16:00:00,302,170,132,FMN GV 11 Ramsel
66,Bergstraat 71,2020-07-13,17:00:00,174,110,64,FMN GV 11 Ramsel
66,Bergstraat 71,2020-07-13,18:00:00,140,84,56,FMN GV 11 Ramsel
66,Bergstraat 71,2020-07-13,19:00:00,122,40,82,FMN GV 11 Ramsel
66,Bergstraat 71,2020-07-13,20:00:00,80,58,22,FMN GV 11 Ramsel
66,Bergstraat 71,2020-07-13,21:00:00,44,30,14,FMN GV 11 Ramsel
66,Bergstraat 71,2020-07-13,22:00:00,38,26,12,FMN GV 11 Ramsel
66,Bergstraat 71,2020-07-13,23:00:00,0,0,0,FMN GV 11 Ramsel
66,Bergstraat 71,2020-07-14,00:00:00,0,0,0,FMN GV 11 Ramsel
66,Bergstraat 71,2020-07-14,01:00:00,8,0,8,FMN GV 11 Ramsel
66,Bergstraat 71,2020-07-14,02:00:00,0,0,0,FMN GV 11 Ramsel
66,Bergstraat 71,2020-07-14,03:00:00,2,0,2,FMN GV 11 Ramsel
66,Bergstraat 71,2020-07-14,04:00:00,0,0,0,FMN GV 11 Ramsel
66,Bergstraat 71,2020-07-14,05:00:00,10,6,4,FMN GV 11 Ramsel
66,Bergstraat 71,2020-07-14,06:00:00,34,16,18,FMN GV 11 Ramsel
66,Bergstraat 71,2020-07-14,07:00:00,62,18,44,FMN GV 11 Ramsel
66,Bergstraat 71,2020-07-14,08:00:00,38,14,24,FMN GV 11 Ramsel
66,Bergstraat 71,2020-07-14,09:00:00,52,20,32,FMN GV 11 Ramsel
66,Bergstraat 71,2020-07-14,10:00:00,74,24,50,FMN GV 11 Ramsel
66,Bergstraat 71,2020-07-14,11:00:00,42,22,20,FMN GV 11 Ramsel
66,Bergstraat 71,2020-07-14,12:00:00,30,22,8,FMN GV 11 Ramsel
66,Bergstraat 71,2020-07-14,13:00:00,46,28,18,FMN GV 11 Ramsel
66,Bergstraat 71,2020-07-14,14:00:00,42,22,20,FMN GV 11 Ramsel
66,Bergstraat 71,2020-07-14,15:00:00,48,32,16,FMN GV 11 Ramsel
66,Bergstraat 71,2020-07-14,16:00:00,70,40,30,FMN GV 11 Ramsel
66,Bergstraat 71,2020-07-14,17:00:00,54,34,20,FMN GV 11 Ramsel
66,Bergstraat 71,2020-07-14,18:00:00,38,32,6,FMN GV 11 Ramsel
66,Bergstraat 71,2020-07-14,19:00:00,22,6,16,FMN GV 11 Ramsel
66,Bergstraat 71,2020-07-14,20:00:00,20,10,10,FMN GV 11 Ramsel
66,Bergstraat 71,2020-07-14,21:00:00,12,6,6,FMN GV 11 Ramsel
66,Bergstraat 71,2020-07-14,22:00:00,12,6,6,FMN GV 11 Ramsel
66,Bergstraat 71,2020-07-14,23:00:00,0,0,0,FMN GV 11 Ramsel
66,Bergstraat 71,2020-07-15,00:00:00,0,0,0,FMN GV 11 Ramsel
66,Bergstraat 71,2020-07-15,01:00:00,12,10,2,FMN GV 11 Ramsel
66,Bergstraat 71,2020-07-15,02:00:00,2,0,2,FMN GV 11 Ramsel
66,Bergstraat 71,2020-07-15,03:00:00,0,0,0,FMN GV 11 Ramsel
66,Bergstraat 71,2020-07-15,04:00:00,2,0,2,FMN GV 11 Ramsel
66,Bergstraat 71,2020-07-15,05:00:00,10,6,4,FMN GV 11 Ramsel
66,Bergstraat 71,2020-07-15,06:00:00,28,14,14,FMN GV 11 Ramsel
66,Bergstraat 71,2020-07-15,07:00:00,54,16,38,FMN GV 11 Ramsel
66,Bergstraat 71,2020-07-15,08:00:00,42,24,18,FMN GV 11 Ramsel
66,Bergstraat 71,2020-07-15,09:00:00,80,42,38,FMN GV 11 Ramsel
66,Bergstraat 71,2020-07-15,10:00:00,94,28,66,FMN GV 11 Ramsel
66,Bergstraat 71,2020-07-15,11:00:00,132,60,72,FMN GV 11 Ramsel
66,Bergstraat 71,2020-07-15,12:00:00,104,42,62,FMN GV 11 Ramsel
66,Bergstraat 71,2020-07-15,13:00:00,224,90,134,FMN GV 11 Ramsel
66,Bergstraat 71,2020-07-15,14:00:00,194,134,60,FMN GV 11 Ramsel
66,Bergstraat 71,2020-07-15,15:00:00,192,84,108,FMN GV 11 Ramsel
66,Bergstraat 71,2020-07-15,16:00:00,180,86,94,FMN GV 11 Ramsel
66,Bergstraat 71,2020-07-15,17:00:00,194,102,92,FMN GV 11 Ramsel
66,Bergstraat 71,2020-07-15,18:00:00,86,42,44,FMN GV 11 Ramsel
66,Bergstraat 71,2020-07-15,19:00:00,64,48,16,FMN GV 11 Ramsel
66,Bergstraat 71,2020-07-15,20:00:00,76,34,42,FMN GV 11 Ramsel
66,Bergstraat 71,2020-07-15,21:00:00,54,26,28,FMN GV 11 Ramsel
66,Bergstraat 71,2020-07-15,22:00:00,26,16,10,FMN GV 11 Ramsel
66,Bergstraat 71,2020-07-15,23:00:00,0,0,0,FMN GV 11 Ramsel
66,Bergstraat 71,2020-07-16,00:00:00,2,0,2,FMN GV 11 Ramsel
66,Bergstraat 71,2020-07-16,01:00:00,2,0,2,FMN GV 11 Ramsel
66,Bergstraat 71,2020-07-16,02:00:00,2,2,0,FMN GV 11 Ramsel
66,Bergstraat 71,2020-07-16,03:00:00,0,0,0,FMN GV 11 Ramsel
66,Bergstraat 71,2020-07-16,04:00:00,2,0,2,FMN GV 11 Ramsel
66,Bergstraat 71,2020-07-16,05:00:00,12,8,4,FMN GV 11 Ramsel
66,Bergstraat 71,2020-07-16,06:00:00,32,10,22,FMN GV 11 Ramsel
66,Bergstraat 71,2020-07-16,07:00:00,34,10,24,FMN GV 11 Ramsel
66,Bergstraat 71,2020-07-16,08:00:00,20,10,10,FMN GV 11 Ramsel
66,Bergstraat 71,2020-07-16,09:00:00,28,8,20,FMN GV 11 Ramsel
66,Bergstraat 71,2020-07-16,10:00:00,30,8,22,FMN GV 11 Ramsel
66,Bergstraat 71,2020-07-16,11:00:00,24,12,12,FMN GV 11 Ramsel
66,Bergstraat 71,2020-07-16,12:00:00,42,14,28,FMN GV 11 Ramsel
66,Bergstraat 71,2020-07-16,13:00:00,62,18,44,FMN GV 11 Ramsel
66,Bergstraat 71,2020-07-16,14:00:00,82,60,22,FMN GV 11 Ramsel
66,Bergstraat 71,2020-07-16,15:00:00,76,34,42,FMN GV 11 Ramsel
66,Bergstraat 71,2020-07-16,16:00:00,78,50,28,FMN GV 11 Ramsel
66,Bergstraat 71,2020-07-16,17:00:00,42,22,20,FMN GV 11 Ramsel
66,Bergstraat 71,2020-07-16,18:00:00,48,34,14,FMN GV 11 Ramsel
66,Bergstraat 71,2020-07-16,19:00:00,28,12,16,FMN GV 11 Ramsel
66,Bergstraat 71,2020-07-16,20:00:00,24,12,12,FMN GV 11 Ramsel
66,Bergstraat 71,2020-07-16,21:00:00,20,10,10,FMN GV 11 Ramsel
66,Bergstraat 71,2020-07-16,22:00:00,14,8,6,FMN GV 11 Ramsel
66,Bergstraat 71,2020-07-16,23:00:00,6,4,2,FMN GV 11 Ramsel
66,Bergstraat 71,2020-07-17,00:00:00,0,0,0,FMN GV 11 Ramsel
66,Bergstraat 71,2020-07-17,01:00:00,6,6,0,FMN GV 11 Ramsel
66,Bergstraat 71,2020-07-17,02:00:00,2,0,2,FMN GV 11 Ramsel
66,Bergstraat 71,2020-07-17,03:00:00,2,0,2,FMN GV 11 Ramsel
66,Bergstraat 71,2020-07-17,04:00:00,2,0,2,FMN GV 11 Ramsel
66,Bergstraat 71,2020-07-17,05:00:00,6,4,2,FMN GV 11 Ramsel
66,Bergstraat 71,2020-07-17,06:00:00,22,14,8,FMN GV 11 Ramsel
66,Bergstraat 71,2020-07-17,07:00:00,44,12,32,FMN GV 11 Ramsel
66,Bergstraat 71,2020-07-17,08:00:00,48,12,36,FMN GV 11 Ramsel
66,Bergstraat 71,2020-07-17,09:00:00,58,26,32,FMN GV 11 Ramsel
66,Bergstraat 71,2020-07-17,10:00:00,84,34,50,FMN GV 11 Ramsel
66,Bergstraat 71,2020-07-17,11:00:00,140,80,60,FMN GV 11 Ramsel
66,Bergstraat 71,2020-07-17,12:00:00,184,108,76,FMN GV 11 Ramsel
66,Bergstraat 71,2020-07-17,13:00:00,172,70,102,FMN GV 11 Ramsel
66,Bergstraat 71,2020-07-17,14:00:00,176,82,94,FMN GV 11 Ramsel
66,Bergstraat 71,2020-07-17,15:00:00,210,96,114,FMN GV 11 Ramsel
66,Bergstraat 71,2020-07-17,16:00:00,152,102,50,FMN GV 11 Ramsel
66,Bergstraat 71,2020-07-17,17:00:00,120,68,52,FMN GV 11 Ramsel
66,Bergstraat 71,2020-07-17,18:00:00,136,88,48,FMN GV 11 Ramsel
66,Bergstraat 71,2020-07-17,19:00:00,104,40,64,FMN GV 11 Ramsel
66,Bergstraat 71,2020-07-17,20:00:00,58,22,36,FMN GV 11 Ramsel
66,Bergstraat 71,2020-07-17,21:00:00,30,20,10,FMN GV 11 Ramsel
66,Bergstraat 71,2020-07-17,22:00:00,36,28,8,FMN GV 11 Ramsel
66,Bergstraat 71,2020-07-17,23:00:00,14,10,4,FMN GV 11 Ramsel
66,Bergstraat 71,2020-07-18,00:00:00,2,2,0,FMN GV 11 Ramsel
66,Bergstraat 71,2020-07-18,01:00:00,16,14,2,FMN GV 11 Ramsel
66,Bergstraat 71,2020-07-18,02:00:00,2,0,2,FMN GV 11 Ramsel
66,Bergstraat 71,2020-07-18,03:00:00,14,14,0,FMN GV 11 Ramsel
66,Bergstraat 71,2020-07-18,04:00:00,6,0,6,FMN GV 11 Ramsel
66,Bergstraat 71,2020-07-18,05:00:00,14,6,8,FMN GV 11 Ramsel
66,Bergstraat 71,2020-07-18,06:00:00,12,6,6,FMN GV 11 Ramsel
66,Bergstraat 71,2020-07-18,07:00:00,38,12,26,FMN GV 11 Ramsel
66,Bergstraat 71,2020-07-18,08:00:00,62,20,42,FMN GV 11 Ramsel
66,Bergstraat 71,2020-07-18,09:00:00,102,16,86,FMN GV 11 Ramsel
66,Bergstraat 71,2020-07-18,10:00:00,160,78,82,FMN GV 11 Ramsel
66,Bergstraat 71,2020-07-18,11:00:00,212,100,112,FMN GV 11 Ramsel
66,Bergstraat 71,2020-07-18,12:00:00,216,90,126,FMN GV 11 Ramsel
66,Bergstraat 71,2020-07-18,13:00:00,280,138,142,FMN GV 11 Ramsel
66,Bergstraat 71,2020-07-18,14:00:00,490,238,252,FMN GV 11 Ramsel
66,Bergstraat 71,2020-07-18,15:00:00,346,146,200,FMN GV 11 Ramsel
66,Bergstraat 71,2020-07-18,16:00:00,300,176,124,FMN GV 11 Ramsel
66,Bergstraat 71,2020-07-18,17:00:00,194,110,84,FMN GV 11 Ramsel
66,Bergstraat 71,2020-07-18,18:00:00,170,94,76,FMN GV 11 Ramsel
66,Bergstraat 71,2020-07-18,19:00:00,102,48,54,FMN GV 11 Ramsel
66,Bergstraat 71,2020-07-18,20:00:00,72,54,18,FMN GV 11 Ramsel
66,Bergstraat 71,2020-07-18,21:00:00,44,18,26,FMN GV 11 Ramsel
66,Bergstraat 71,2020-07-18,22:00:00,24,8,16,FMN GV 11 Ramsel
66,Bergstraat 71,2020-07-18,23:00:00,2,2,0,FMN GV 11 Ramsel
66,Bergstraat 71,2020-07-19,00:00:00,16,4,12,FMN GV 11 Ramsel
66,Bergstraat 71,2020-07-19,01:00:00,18,12,6,FMN GV 11 Ramsel
66,Bergstraat 71,2020-07-19,02:00:00,0,0,0,FMN GV 11 Ramsel
66,Bergstraat 71,2020-07-19,03:00:00,0,0,0,FMN GV 11 Ramsel
66,Bergstraat 71,2020-07-19,04:00:00,6,4,2,FMN GV 11 Ramsel
66,Bergstraat 71,2020-07-19,05:00:00,0,0,0,FMN GV 11 Ramsel
66,Bergstraat 71,2020-07-19,06:00:00,12,4,8,FMN GV 11 Ramsel
66,Bergstraat 71,2020-07-19,07:00:00,38,18,20,FMN GV 11 Ramsel
66,Bergstraat 71,2020-07-19,08:00:00,86,28,58,FMN GV 11 Ramsel
66,Bergstraat 71,2020-07-19,09:00:00,190,54,136,FMN GV 11 Ramsel
66,Bergstraat 71,2020-07-19,10:00:00,244,142,102,FMN GV 11 Ramsel
66,Bergstraat 71,2020-07-19,11:00:00,362,204,158,FMN GV 11 Ramsel
66,Bergstraat 71,2020-07-19,12:00:00,278,162,116,FMN GV 11 Ramsel
66,Bergstraat 71,2020-07-19,13:00:00,254,128,126,FMN GV 11 Ramsel
66,Bergstraat 71,2020-07-19,14:00:00,420,240,180,FMN GV 11 Ramsel
66,Bergstraat 71,2020-07-19,15:00:00,360,162,198,FMN GV 11 Ramsel
66,Bergstraat 71,2020-07-19,16:00:00,312,166,146,FMN GV 11 Ramsel
66,Bergstraat 71,2020-07-19,17:00:00,220,110,110,FMN GV 11 Ramsel
66,Bergstraat 71,2020-07-19,18:00:00,178,70,108,FMN GV 11 Ramsel
66,Bergstraat 71,2020-07-19,19:00:00,134,52,82,FMN GV 11 Ramsel
66,Bergstraat 71,2020-07-19,20:00:00,78,42,36,FMN GV 11 Ramsel
66,Bergstraat 71,2020-07-19,21:00:00,20,8,12,FMN GV 11 Ramsel
66,Bergstraat 71,2020-07-19,22:00:00,14,10,4,FMN GV 11 Ramsel
66,Bergstraat 71,2020-07-19,23:00:00,0,0,0,FMN GV 11 Ramsel
66,Bergstraat 71,2020-07-20,00:00:00,2,2,0,FMN GV 11 Ramsel
66,Bergstraat 71,2020-07-20,01:00:00,0,0,0,FMN GV 11 Ramsel
66,Bergstraat 71,2020-07-20,02:00:00,2,2,0,FMN GV 11 Ramsel
66,Bergstraat 71,2020-07-20,03:00:00,0,0,0,FMN GV 11 Ramsel
66,Bergstraat 71,2020-07-20,04:00:00,4,2,2,FMN GV 11 Ramsel
66,Bergstraat 71,2020-07-20,05:00:00,2,2,0,FMN GV 11 Ramsel
66,Bergstraat 71,2020-07-20,06:00:00,20,10,10,FMN GV 11 Ramsel
66,Bergstraat 71,2020-07-20,07:00:00,34,8,26,FMN GV 11 Ramsel
66,Bergstraat 71,2020-07-20,08:00:00,32,20,12,FMN GV 11 Ramsel
66,Bergstraat 71,2020-07-20,09:00:00,100,48,52,FMN GV 11 Ramsel
66,Bergstraat 71,2020-07-20,10:00:00,102,42,60,FMN GV 11 Ramsel
66,Bergstraat 71,2020-07-20,11:00:00,92,46,46,FMN GV 11 Ramsel
66,Bergstraat 71,2020-07-20,12:00:00,156,90,66,FMN GV 11 Ramsel
66,Bergstraat 71,2020-07-20,13:00:00,218,108,110,FMN GV 11 Ramsel
66,Bergstraat 71,2020-07-20,14:00:00,244,108,136,FMN GV 11 Ramsel
66,Bergstraat 71,2020-07-20,15:00:00,276,158,118,FMN GV 11 Ramsel
66,Bergstraat 71,2020-07-20,16:00:00,156,92,64,FMN GV 11 Ramsel
66,Bergstraat 71,2020-07-20,17:00:00,124,72,52,FMN GV 11 Ramsel
66,Bergstraat 71,2020-07-20,18:00:00,86,56,30,FMN GV 11 Ramsel
66,Bergstraat 71,2020-07-20,19:00:00,76,32,44,FMN GV 11 Ramsel
66,Bergstraat 71,2020-07-20,20:00:00,72,48,24,FMN GV 11 Ramsel
66,Bergstraat 71,2020-07-20,21:00:00,42,30,12,FMN GV 11 Ramsel
66,Bergstraat 71,2020-07-20,22:00:00,20,8,12,FMN GV 11 Ramsel
66,Bergstraat 71,2020-07-20,23:00:00,2,0,2,FMN GV 11 Ramsel
66,Bergstraat 71,2020-07-21,00:00:00,6,2,4,FMN GV 11 Ramsel
66,Bergstraat 71,2020-07-21,01:00:00,4,0,4,FMN GV 11 Ramsel
66,Bergstraat 71,2020-07-21,02:00:00,0,0,0,FMN GV 11 Ramsel
66,Bergstraat 71,2020-07-21,03:00:00,0,0,0,FMN GV 11 Ramsel
66,Bergstraat 71,2020-07-21,04:00:00,0,0,0,FMN GV 11 Ramsel
66,Bergstraat 71,2020-07-21,05:00:00,2,0,2,FMN GV 11 Ramsel
66,Bergstraat 71,2020-07-21,06:00:00,18,10,8,FMN GV 11 Ramsel
66,Bergstraat 71,2020-07-21,07:00:00,36,16,20,FMN GV 11 Ramsel
66,Bergstraat 71,2020-07-21,08:00:00,68,36,32,FMN GV 11 Ramsel
66,Bergstraat 71,2020-07-21,09:00:00,94,42,52,FMN GV 11 Ramsel
66,Bergstraat 71,2020-07-21,10:00:00,280,146,134,FMN GV 11 Ramsel
66,Bergstraat 71,2020-07-21,11:00:00,342,166,176,FMN GV 11 Ramsel
66,Bergstraat 71,2020-07-21,12:00:00,390,242,148,FMN GV 11 Ramsel
66,Bergstraat 71,2020-07-21,13:00:00,460,220,240,FMN GV 11 Ramsel
66,Bergstraat 71,2020-07-21,14:00:00,434,206,228,FMN GV 11 Ramsel
66,Bergstraat 71,2020-07-21,15:00:00,444,222,222,FMN GV 11 Ramsel
66,Bergstraat 71,2020-07-21,16:00:00,404,272,132,FMN GV 11 Ramsel
66,Bergstraat 71,2020-07-21,17:00:00,242,132,110,FMN GV 11 Ramsel
66,Bergstraat 71,2020-07-21,18:00:00,186,104,82,FMN GV 11 Ramsel
66,Bergstraat 71,2020-07-21,19:00:00,94,44,50,FMN GV 11 Ramsel
66,Bergstraat 71,2020-07-21,20:00:00,64,30,34,FMN GV 11 Ramsel
66,Bergstraat 71,2020-07-21,21:00:00,48,34,14,FMN GV 11 Ramsel
66,Bergstraat 71,2020-07-21,22:00:00,24,14,10,FMN GV 11 Ramsel
66,Bergstraat 71,2020-07-21,23:00:00,14,10,4,FMN GV 11 Ramsel
66,Bergstraat 71,2020-07-22,00:00:00,2,0,2,FMN GV 11 Ramsel
66,Bergstraat 71,2020-07-22,01:00:00,2,0,2,FMN GV 11 Ramsel
66,Bergstraat 71,2020-07-22,02:00:00,0,0,0,FMN GV 11 Ramsel
66,Bergstraat 71,2020-07-22,03:00:00,0,0,0,FMN GV 11 Ramsel
66,Bergstraat 71,2020-07-22,04:00:00,2,0,2,FMN GV 11 Ramsel
66,Bergstraat 71,2020-07-22,05:00:00,14,10,4,FMN GV 11 Ramsel
66,Bergstraat 71,2020-07-22,06:00:00,26,16,10,FMN GV 11 Ramsel
66,Bergstraat 71,2020-07-22,07:00:00,42,10,32,FMN GV 11 Ramsel
66,Bergstraat 71,2020-07-22,08:00:00,110,86,24,FMN GV 11 Ramsel
66,Bergstraat 71,2020-07-22,09:00:00,132,72,60,FMN GV 11 Ramsel
66,Bergstraat 71,2020-07-22,10:00:00,148,64,84,FMN GV 11 Ramsel
66,Bergstraat 71,2020-07-22,11:00:00,138,72,66,FMN GV 11 Ramsel
66,Bergstraat 71,2020-07-22,12:00:00,138,76,62,FMN GV 11 Ramsel
66,Bergstraat 71,2020-07-22,13:00:00,204,86,118,FMN GV 11 Ramsel
66,Bergstraat 71,2020-07-22,14:00:00,278,142,136,FMN GV 11 Ramsel
66,Bergstraat 71,2020-07-22,15:00:00,248,124,124,FMN GV 11 Ramsel
66,Bergstraat 71,2020-07-22,16:00:00,178,104,74,FMN GV 11 Ramsel
66,Bergstraat 71,2020-07-22,17:00:00,134,54,80,FMN GV 11 Ramsel
66,Bergstraat 71,2020-07-22,18:00:00,118,76,42,FMN GV 11 Ramsel
66,Bergstraat 71,2020-07-22,19:00:00,114,44,70,FMN GV 11 Ramsel
66,Bergstraat 71,2020-07-22,20:00:00,78,54,24,FMN GV 11 Ramsel
66,Bergstraat 71,2020-07-22,21:00:00,50,26,24,FMN GV 11 Ramsel
66,Bergstraat 71,2020-07-22,22:00:00,24,14,10,FMN GV 11 Ramsel
66,Bergstraat 71,2020-07-22,23:00:00,10,6,4,FMN GV 11 Ramsel
66,Bergstraat 71,2020-07-23,00:00:00,4,4,0,FMN GV 11 Ramsel
66,Bergstraat 71,2020-07-23,01:00:00,10,4,6,FMN GV 11 Ramsel
66,Bergstraat 71,2020-07-23,02:00:00,0,0,0,FMN GV 11 Ramsel
66,Bergstraat 71,2020-07-23,03:00:00,0,0,0,FMN GV 11 Ramsel
66,Bergstraat 71,2020-07-23,04:00:00,2,0,2,FMN GV 11 Ramsel
66,Bergstraat 71,2020-07-23,05:00:00,16,10,6,FMN GV 11 Ramsel
66,Bergstraat 71,2020-07-23,06:00:00,34,12,22,FMN GV 11 Ramsel
66,Bergstraat 71,2020-07-23,07:00:00,54,18,36,FMN GV 11 Ramsel
66,Bergstraat 71,2020-07-23,08:00:00,84,24,60,FMN GV 11 Ramsel
66,Bergstraat 71,2020-07-23,09:00:00,126,66,60,FMN GV 11 Ramsel
66,Bergstraat 71,2020-07-23,10:00:00,128,70,58,FMN GV 11 Ramsel
66,Bergstraat 71,2020-07-23,11:00:00,192,98,94,FMN GV 11 Ramsel
66,Bergstraat 71,2020-07-23,12:00:00,220,108,112,FMN GV 11 Ramsel
66,Bergstraat 71,2020-07-23,13:00:00,292,138,154,FMN GV 11 Ramsel
66,Bergstraat 71,2020-07-23,14:00:00,276,164,112,FMN GV 11 Ramsel
66,Bergstraat 71,2020-07-23,15:00:00,244,128,116,FMN GV 11 Ramsel
66,Bergstraat 71,2020-07-23,16:00:00,302,182,120,FMN GV 11 Ramsel
66,Bergstraat 71,2020-07-23,17:00:00,214,134,80,FMN GV 11 Ramsel
66,Bergstraat 71,2020-07-23,18:00:00,162,64,98,FMN GV 11 Ramsel
66,Bergstraat 71,2020-07-23,19:00:00,156,70,86,FMN GV 11 Ramsel
66,Bergstraat 71,2020-07-23,20:00:00,108,58,50,FMN GV 11 Ramsel
66,Bergstraat 71,2020-07-23,21:00:00,36,22,14,FMN GV 11 Ramsel
66,Bergstraat 71,2020-07-23,22:00:00,28,20,8,FMN GV 11 Ramsel
66,Bergstraat 71,2020-07-23,23:00:00,16,4,12,FMN GV 11 Ramsel
66,Bergstraat 71,2020-07-24,00:00:00,10,4,6,FMN GV 11 Ramsel
66,Bergstraat 71,2020-07-24,01:00:00,4,2,2,FMN GV 11 Ramsel
66,Bergstraat 71,2020-07-24,02:00:00,0,0,0,FMN GV 11 Ramsel
66,Bergstraat 71,2020-07-24,03:00:00,0,0,0,FMN GV 11 Ramsel
66,Bergstraat 71,2020-07-24,04:00:00,4,2,2,FMN GV 11 Ramsel
66,Bergstraat 71,2020-07-24,05:00:00,8,8,0,FMN GV 11 Ramsel
66,Bergstraat 71,2020-07-24,06:00:00,24,14,10,FMN GV 11 Ramsel
66,Bergstraat 71,2020-07-24,07:00:00,44,6,38,FMN GV 11 Ramsel
66,Bergstraat 71,2020-07-24,08:00:00,40,12,28,FMN GV 11 Ramsel
66,Bergstraat 71,2020-07-24,09:00:00,42,16,26,FMN GV 11 Ramsel
66,Bergstraat 71,2020-07-24,10:00:00,82,40,42,FMN GV 11 Ramsel
66,Bergstraat 71,2020-07-24,11:00:00,72,34,38,FMN GV 11 Ramsel
66,Bergstraat 71,2020-07-24,12:00:00,56,18,38,FMN GV 11 Ramsel
66,Bergstraat 71,2020-07-24,13:00:00,90,40,50,FMN GV 11 Ramsel
66,Bergstraat 71,2020-07-24,14:00:00,96,44,52,FMN GV 11 Ramsel
66,Bergstraat 71,2020-07-24,15:00:00,148,80,68,FMN GV 11 Ramsel
66,Bergstraat 71,2020-07-24,16:00:00,118,70,48,FMN GV 11 Ramsel
66,Bergstraat 71,2020-07-24,17:00:00,76,48,28,FMN GV 11 Ramsel
66,Bergstraat 71,2020-07-24,18:00:00,26,16,10,FMN GV 11 Ramsel
66,Bergstraat 71,2020-07-24,19:00:00,72,18,54,FMN GV 11 Ramsel
66,Bergstraat 71,2020-07-24,20:00:00,44,28,16,FMN GV 11 Ramsel
66,Bergstraat 71,2020-07-24,21:00:00,18,6,12,FMN GV 11 Ramsel
66,Bergstraat 71,2020-07-24,22:00:00,16,6,10,FMN GV 11 Ramsel
66,Bergstraat 71,2020-07-24,23:00:00,0,0,0,FMN GV 11 Ramsel
66,Bergstraat 71,2020-07-25,00:00:00,14,6,8,FMN GV 11 Ramsel
66,Bergstraat 71,2020-07-25,01:00:00,12,12,0,FMN GV 11 Ramsel
66,Bergstraat 71,2020-07-25,02:00:00,2,0,2,FMN GV 11 Ramsel
66,Bergstraat 71,2020-07-25,03:00:00,2,2,0,FMN GV 11 Ramsel
66,Bergstraat 71,2020-07-25,04:00:00,8,2,6,FMN GV 11 Ramsel
66,Bergstraat 71,2020-07-25,05:00:00,2,0,2,FMN GV 11 Ramsel
66,Bergstraat 71,2020-07-25,06:00:00,10,4,6,FMN GV 11 Ramsel
66,Bergstraat 71,2020-07-25,07:00:00,12,4,8,FMN GV 11 Ramsel
66,Bergstraat 71,2020-07-25,08:00:00,34,18,16,FMN GV 11 Ramsel
66,Bergstraat 71,2020-07-25,09:00:00,84,22,62,FMN GV 11 Ramsel
66,Bergstraat 71,2020-07-25,10:00:00,118,38,80,FMN GV 11 Ramsel
66,Bergstraat 71,2020-07-25,11:00:00,140,54,86,FMN GV 11 Ramsel
66,Bergstraat 71,2020-07-25,12:00:00,106,56,50,FMN GV 11 Ramsel
66,Bergstraat 71,2020-07-25,13:00:00,142,78,64,FMN GV 11 Ramsel
66,Bergstraat 71,2020-07-25,14:00:00,106,58,48,FMN GV 11 Ramsel
66,Bergstraat 71,2020-07-25,15:00:00,212,118,94,FMN GV 11 Ramsel
66,Bergstraat 71,2020-07-25,16:00:00,214,114,100,FMN GV 11 Ramsel
66,Bergstraat 71,2020-07-25,17:00:00,148,94,54,FMN GV 11 Ramsel
66,Bergstraat 71,2020-07-25,18:00:00,46,28,18,FMN GV 11 Ramsel
66,Bergstraat 71,2020-07-25,19:00:00,42,18,24,FMN GV 11 Ramsel
66,Bergstraat 71,2020-07-25,20:00:00,38,14,24,FMN GV 11 Ramsel
66,Bergstraat 71,2020-07-25,21:00:00,32,18,14,FMN GV 11 Ramsel
66,Bergstraat 71,2020-07-25,22:00:00,6,4,2,FMN GV 11 Ramsel
66,Bergstraat 71,2020-07-25,23:00:00,4,2,2,FMN GV 11 Ramsel
66,Bergstraat 71,2020-07-26,00:00:00,6,6,0,FMN GV 11 Ramsel
66,Bergstraat 71,2020-07-26,01:00:00,2,2,0,FMN GV 11 Ramsel
66,Bergstraat 71,2020-07-26,02:00:00,6,2,4,FMN GV 11 Ramsel
66,Bergstraat 71,2020-07-26,03:00:00,0,0,0,FMN GV 11 Ramsel
66,Bergstraat 71,2020-07-26,04:00:00,2,0,2,FMN GV 11 Ramsel
66,Bergstraat 71,2020-07-26,05:00:00,0,0,0,FMN GV 11 Ramsel
66,Bergstraat 71,2020-07-26,06:00:00,4,2,2,FMN GV 11 Ramsel
66,Bergstraat 71,2020-07-26,07:00:00,16,10,6,FMN GV 11 Ramsel
66,Bergstraat 71,2020-07-26,08:00:00,76,30,46,FMN GV 11 Ramsel
66,Bergstraat 71,2020-07-26,09:00:00,154,68,86,FMN GV 11 Ramsel
66,Bergstraat 71,2020-07-26,10:00:00,200,92,108,FMN GV 11 Ramsel
66,Bergstraat 71,2020-07-26,11:00:00,178,110,68,FMN GV 11 Ramsel
66,Bergstraat 71,2020-07-26,12:00:00,142,82,60,FMN GV 11 Ramsel
66,Bergstraat 71,2020-07-26,13:00:00,216,112,104,FMN GV 11 Ramsel
66,Bergstraat 71,2020-07-26,14:00:00,336,174,162,FMN GV 11 Ramsel
66,Bergstraat 71,2020-07-26,15:00:00,280,114,166,FMN GV 11 Ramsel
66,Bergstraat 71,2020-07-26,16:00:00,224,128,96,FMN GV 11 Ramsel
66,Bergstraat 71,2020-07-26,17:00:00,208,126,82,FMN GV 11 Ramsel
66,Bergstraat 71,2020-07-26,18:00:00,86,38,48,FMN GV 11 Ramsel
66,Bergstraat 71,2020-07-26,19:00:00,68,42,26,FMN GV 11 Ramsel
66,Bergstraat 71,2020-07-26,20:00:00,62,28,34,FMN GV 11 Ramsel
66,Bergstraat 71,2020-07-26,21:00:00,42,24,18,FMN GV 11 Ramsel
66,Bergstraat 71,2020-07-26,22:00:00,10,6,4,FMN GV 11 Ramsel
66,Bergstraat 71,2020-07-26,23:00:00,2,2,0,FMN GV 11 Ramsel
66,Bergstraat 71,2020-07-27,00:00:00,2,2,0,FMN GV 11 Ramsel
66,Bergstraat 71,2020-07-27,01:00:00,2,2,0,FMN GV 11 Ramsel
66,Bergstraat 71,2020-07-27,02:00:00,2,0,2,FMN GV 11 Ramsel
66,Bergstraat 71,2020-07-27,03:00:00,0,0,0,FMN GV 11 Ramsel
66,Bergstraat 71,2020-07-27,04:00:00,4,2,2,FMN GV 11 Ramsel
66,Bergstraat 71,2020-07-27,05:00:00,12,8,4,FMN GV 11 Ramsel
66,Bergstraat 71,2020-07-27,06:00:00,28,10,18,FMN GV 11 Ramsel
66,Bergstraat 71,2020-07-27,07:00:00,26,14,12,FMN GV 11 Ramsel
66,Bergstraat 71,2020-07-27,08:00:00,36,16,20,FMN GV 11 Ramsel
66,Bergstraat 71,2020-07-27,09:00:00,38,10,28,FMN GV 11 Ramsel
66,Bergstraat 71,2020-07-27,10:00:00,46,20,26,FMN GV 11 Ramsel
66,Bergstraat 71,2020-07-27,11:00:00,58,28,30,FMN GV 11 Ramsel
66,Bergstraat 71,2020-07-27,12:00:00,80,50,30,FMN GV 11 Ramsel
66,Bergstraat 71,2020-07-27,13:00:00,128,58,70,FMN GV 11 Ramsel
66,Bergstraat 71,2020-07-27,14:00:00,216,106,110,FMN GV 11 Ramsel
66,Bergstraat 71,2020-07-27,15:00:00,238,112,126,FMN GV 11 Ramsel
66,Bergstraat 71,2020-07-27,16:00:00,194,120,74,FMN GV 11 Ramsel
66,Bergstraat 71,2020-07-27,17:00:00,138,92,46,FMN GV 11 Ramsel
66,Bergstraat 71,2020-07-27,18:00:00,100,50,50,FMN GV 11 Ramsel
66,Bergstraat 71,2020-07-27,19:00:00,94,30,64,FMN GV 11 Ramsel
66,Bergstraat 71,2020-07-27,20:00:00,80,40,40,FMN GV 11 Ramsel
66,Bergstraat 71,2020-07-27,21:00:00,70,32,38,FMN GV 11 Ramsel
66,Bergstraat 71,2020-07-27,22:00:00,12,6,6,FMN GV 11 Ramsel
66,Bergstraat 71,2020-07-27,23:00:00,0,0,0,FMN GV 11 Ramsel
66,Bergstraat 71,2020-07-28,00:00:00,2,0,2,FMN GV 11 Ramsel
66,Bergstraat 71,2020-07-28,01:00:00,4,0,4,FMN GV 11 Ramsel
66,Bergstraat 71,2020-07-28,02:00:00,0,0,0,FMN GV 11 Ramsel
66,Bergstraat 71,2020-07-28,03:00:00,0,0,0,FMN GV 11 Ramsel
66,Bergstraat 71,2020-07-28,04:00:00,2,2,0,FMN GV 11 Ramsel
66,Bergstraat 71,2020-07-28,05:00:00,10,4,6,FMN GV 11 Ramsel
66,Bergstraat 71,2020-07-28,06:00:00,36,20,16,FMN GV 11 Ramsel
66,Bergstraat 71,2020-07-28,07:00:00,52,24,28,FMN GV 11 Ramsel
66,Bergstraat 71,2020-07-28,08:00:00,42,16,26,FMN GV 11 Ramsel
66,Bergstraat 71,2020-07-28,09:00:00,64,36,28,FMN GV 11 Ramsel
66,Bergstraat 71,2020-07-28,10:00:00,82,24,58,FMN GV 11 Ramsel
66,Bergstraat 71,2020-07-28,11:00:00,66,28,38,FMN GV 11 Ramsel
66,Bergstraat 71,2020-07-28,12:00:00,102,56,46,FMN GV 11 Ramsel
66,Bergstraat 71,2020-07-28,13:00:00,162,48,114,FMN GV 11 Ramsel
66,Bergstraat 71,2020-07-28,14:00:00,236,134,102,FMN GV 11 Ramsel
66,Bergstraat 71,2020-07-28,15:00:00,216,114,102,FMN GV 11 Ramsel
66,Bergstraat 71,2020-07-28,16:00:00,168,110,58,FMN GV 11 Ramsel
66,Bergstraat 71,2020-07-28,17:00:00,110,72,38,FMN GV 11 Ramsel
66,Bergstraat 71,2020-07-28,18:00:00,88,40,48,FMN GV 11 Ramsel
66,Bergstraat 71,2020-07-28,19:00:00,76,38,38,FMN GV 11 Ramsel
66,Bergstraat 71,2020-07-28,20:00:00,84,50,34,FMN GV 11 Ramsel
66,Bergstraat 71,2020-07-28,21:00:00,30,22,8,FMN GV 11 Ramsel
66,Bergstraat 71,2020-07-28,22:00:00,16,8,8,FMN GV 11 Ramsel
66,Bergstraat 71,2020-07-28,23:00:00,4,4,0,FMN GV 11 Ramsel
66,Bergstraat 71,2020-07-29,00:00:00,0,0,0,FMN GV 11 Ramsel
66,Bergstraat 71,2020-07-29,01:00:00,0,0,0,FMN GV 11 Ramsel
66,Bergstraat 71,2020-07-29,02:00:00,4,0,4,FMN GV 11 Ramsel
66,Bergstraat 71,2020-07-29,03:00:00,0,0,0,FMN GV 11 Ramsel
66,Bergstraat 71,2020-07-29,04:00:00,2,0,2,FMN GV 11 Ramsel
66,Bergstraat 71,2020-07-29,05:00:00,18,6,12,FMN GV 11 Ramsel
66,Bergstraat 71,2020-07-29,06:00:00,26,16,10,FMN GV 11 Ramsel
66,Bergstraat 71,2020-07-29,07:00:00,38,14,24,FMN GV 11 Ramsel
66,Bergstraat 71,2020-07-29,08:00:00,38,14,24,FMN GV 11 Ramsel
66,Bergstraat 71,2020-07-29,09:00:00,112,18,94,FMN GV 11 Ramsel
66,Bergstraat 71,2020-07-29,10:00:00,110,38,72,FMN GV 11 Ramsel
66,Bergstraat 71,2020-07-29,11:00:00,128,66,62,FMN GV 11 Ramsel
66,Bergstraat 71,2020-07-29,12:00:00,190,116,74,FMN GV 11 Ramsel
66,Bergstraat 71,2020-07-29,13:00:00,190,78,112,FMN GV 11 Ramsel
66,Bergstraat 71,2020-07-29,14:00:00,284,120,164,FMN GV 11 Ramsel
66,Bergstraat 71,2020-07-29,15:00:00,314,180,134,FMN GV 11 Ramsel
66,Bergstraat 71,2020-07-29,16:00:00,276,160,116,FMN GV 11 Ramsel
66,Bergstraat 71,2020-07-29,17:00:00,228,160,68,FMN GV 11 Ramsel
66,Bergstraat 71,2020-07-29,18:00:00,132,80,52,FMN GV 11 Ramsel
66,Bergstraat 71,2020-07-29,19:00:00,70,28,42,FMN GV 11 Ramsel
66,Bergstraat 71,2020-07-29,20:00:00,90,56,34,FMN GV 11 Ramsel
66,Bergstraat 71,2020-07-29,21:00:00,48,32,16,FMN GV 11 Ramsel
66,Bergstraat 71,2020-07-29,22:00:00,14,8,6,FMN GV 11 Ramsel
66,Bergstraat 71,2020-07-29,23:00:00,4,0,4,FMN GV 11 Ramsel
66,Bergstraat 71,2020-07-30,00:00:00,0,0,0,FMN GV 11 Ramsel
66,Bergstraat 71,2020-07-30,01:00:00,0,0,0,FMN GV 11 Ramsel
66,Bergstraat 71,2020-07-30,02:00:00,0,0,0,FMN GV 11 Ramsel
66,Bergstraat 71,2020-07-30,03:00:00,0,0,0,FMN GV 11 Ramsel
66,Bergstraat 71,2020-07-30,04:00:00,2,0,2,FMN GV 11 Ramsel
66,Bergstraat 71,2020-07-30,05:00:00,12,6,6,FMN GV 11 Ramsel
66,Bergstraat 71,2020-07-30,06:00:00,24,10,14,FMN GV 11 Ramsel
66,Bergstraat 71,2020-07-30,07:00:00,44,18,26,FMN GV 11 Ramsel
66,Bergstraat 71,2020-07-30,08:00:00,80,24,56,FMN GV 11 Ramsel
66,Bergstraat 71,2020-07-30,09:00:00,106,36,70,FMN GV 11 Ramsel
66,Bergstraat 71,2020-07-30,10:00:00,172,80,92,FMN GV 11 Ramsel
66,Bergstraat 71,2020-07-30,11:00:00,138,44,94,FMN GV 11 Ramsel
66,Bergstraat 71,2020-07-30,12:00:00,180,96,84,FMN GV 11 Ramsel
66,Bergstraat 71,2020-07-30,13:00:00,296,124,172,FMN GV 11 Ramsel
66,Bergstraat 71,2020-07-30,14:00:00,280,136,144,FMN GV 11 Ramsel
66,Bergstraat 71,2020-07-30,15:00:00,246,126,120,FMN GV 11 Ramsel
66,Bergstraat 71,2020-07-30,16:00:00,180,126,54,FMN GV 11 Ramsel
66,Bergstraat 71,2020-07-30,17:00:00,206,120,86,FMN GV 11 Ramsel
66,Bergstraat 71,2020-07-30,18:00:00,146,104,42,FMN GV 11 Ramsel
66,Bergstraat 71,2020-07-30,19:00:00,74,28,46,FMN GV 11 Ramsel
66,Bergstraat 71,2020-07-30,20:00:00,92,48,44,FMN GV 11 Ramsel
66,Bergstraat 71,2020-07-30,21:00:00,48,18,30,FMN GV 11 Ramsel
66,Bergstraat 71,2020-07-30,22:00:00,22,12,10,FMN GV 11 Ramsel
66,Bergstraat 71,2020-07-30,23:00:00,14,10,4,FMN GV 11 Ramsel
66,Bergstraat 71,2020-07-31,00:00:00,0,0,0,FMN GV 11 Ramsel
66,Bergstraat 71,2020-07-31,01:00:00,0,0,0,FMN GV 11 Ramsel
66,Bergstraat 71,2020-07-31,02:00:00,0,0,0,FMN GV 11 Ramsel
66,Bergstraat 71,2020-07-31,03:00:00,0,0,0,FMN GV 11 Ramsel
66,Bergstraat 71,2020-07-31,04:00:00,4,2,2,FMN GV 11 Ramsel
66,Bergstraat 71,2020-07-31,05:00:00,20,10,10,FMN GV 11 Ramsel
66,Bergstraat 71,2020-07-31,06:00:00,18,2,16,FMN GV 11 Ramsel
66,Bergstraat 71,2020-07-31,07:00:00,54,6,48,FMN GV 11 Ramsel
66,Bergstraat 71,2020-07-31,08:00:00,156,70,86,FMN GV 11 Ramsel
66,Bergstraat 71,2020-07-31,09:00:00,136,62,74,FMN GV 11 Ramsel
66,Bergstraat 71,2020-07-31,10:00:00,186,100,86,FMN GV 11 Ramsel
66,Bergstraat 71,2020-07-31,11:00:00,278,158,120,FMN GV 11 Ramsel
66,Bergstraat 71,2020-07-31,12:00:00,206,112,94,FMN GV 11 Ramsel
66,Bergstraat 71,2020-07-31,13:00:00,168,68,100,FMN GV 11 Ramsel
66,Bergstraat 71,2020-07-31,14:00:00,140,48,92,FMN GV 11 Ramsel
66,Bergstraat 71,2020-07-31,15:00:00,94,56,38,FMN GV 11 Ramsel
66,Bergstraat 71,2020-07-31,16:00:00,88,52,36,FMN GV 11 Ramsel
66,Bergstraat 71,2020-07-31,17:00:00,60,38,22,FMN GV 11 Ramsel
66,Bergstraat 71,2020-07-31,18:00:00,102,56,46,FMN GV 11 Ramsel
66,Bergstraat 71,2020-07-31,19:00:00,28,20,8,FMN GV 11 Ramsel
66,Bergstraat 71,2020-07-31,20:00:00,68,30,38,FMN GV 11 Ramsel
66,Bergstraat 71,2020-07-31,21:00:00,58,26,32,FMN GV 11 Ramsel
66,Bergstraat 71,2020-07-31,22:00:00,38,22,16,FMN GV 11 Ramsel
66,Bergstraat 71,2020-07-31,23:00:00,14,8,6,FMN GV 11 Ramsel
66,Bergstraat 71,2020-08-01,00:00:00,0,0,0,FMN GV 11 Ramsel
66,Bergstraat 71,2020-08-01,01:00:00,0,0,0,FMN GV 11 Ramsel
66,Bergstraat 71,2020-08-01,02:00:00,0,0,0,FMN GV 11 Ramsel
66,Bergstraat 71,2020-08-01,03:00:00,0,0,0,FMN GV 11 Ramsel
66,Bergstraat 71,2020-08-01,04:00:00,0,0,0,FMN GV 11 Ramsel
66,Bergstraat 71,2020-08-01,05:00:00,0,0,0,FMN GV 11 Ramsel
66,Bergstraat 71,2020-08-01,06:00:00,26,10,16,FMN GV 11 Ramsel
66,Bergstraat 71,2020-08-01,07:00:00,20,6,14,FMN GV 11 Ramsel
66,Bergstraat 71,2020-08-01,08:00:00,68,22,46,FMN GV 11 Ramsel
66,Bergstraat 71,2020-08-01,09:00:00,70,20,50,FMN GV 11 Ramsel
66,Bergstraat 71,2020-08-01,10:00:00,170,72,98,FMN GV 11 Ramsel
66,Bergstraat 71,2020-08-01,11:00:00,198,78,120,FMN GV 11 Ramsel
66,Bergstraat 71,2020-08-01,12:00:00,138,76,62,FMN GV 11 Ramsel
66,Bergstraat 71,2020-08-01,13:00:00,202,88,114,FMN GV 11 Ramsel
66,Bergstraat 71,2020-08-01,14:00:00,280,136,144,FMN GV 11 Ramsel
66,Bergstraat 71,2020-08-01,15:00:00,224,144,80,FMN GV 11 Ramsel
66,Bergstraat 71,2020-08-01,16:00:00,166,106,60,FMN GV 11 Ramsel
66,Bergstraat 71,2020-08-01,17:00:00,174,140,34,FMN GV 11 Ramsel
66,Bergstraat 71,2020-08-01,18:00:00,86,46,40,FMN GV 11 Ramsel
66,Bergstraat 71,2020-08-01,19:00:00,94,54,40,FMN GV 11 Ramsel
66,Bergstraat 71,2020-08-01,20:00:00,58,26,32,FMN GV 11 Ramsel
66,Bergstraat 71,2020-08-01,21:00:00,46,18,28,FMN GV 11 Ramsel
66,Bergstraat 71,2020-08-01,22:00:00,14,12,2,FMN GV 11 Ramsel
66,Bergstraat 71,2020-08-01,23:00:00,42,18,24,FMN GV 11 Ramsel
66,Bergstraat 71,2020-08-02,00:00:00,2,2,0,FMN GV 11 Ramsel
66,Bergstraat 71,2020-08-02,01:00:00,0,0,0,FMN GV 11 Ramsel
66,Bergstraat 71,2020-08-02,02:00:00,8,4,4,FMN GV 11 Ramsel
66,Bergstraat 71,2020-08-02,03:00:00,4,0,4,FMN GV 11 Ramsel
66,Bergstraat 71,2020-08-02,04:00:00,0,0,0,FMN GV 11 Ramsel
66,Bergstraat 71,2020-08-02,05:00:00,2,2,0,FMN GV 11 Ramsel
66,Bergstraat 71,2020-08-02,06:00:00,16,4,12,FMN GV 11 Ramsel
66,Bergstraat 71,2020-08-02,07:00:00,36,8,28,FMN GV 11 Ramsel
66,Bergstraat 71,2020-08-02,08:00:00,126,36,90,FMN GV 11 Ramsel
66,Bergstraat 71,2020-08-02,09:00:00,222,72,150,FMN GV 11 Ramsel
66,Bergstraat 71,2020-08-02,10:00:00,232,122,110,FMN GV 11 Ramsel
66,Bergstraat 71,2020-08-02,11:00:00,308,208,100,FMN GV 11 Ramsel
66,Bergstraat 71,2020-08-02,12:00:00,214,118,96,FMN GV 11 Ramsel
66,Bergstraat 71,2020-08-02,13:00:00,200,86,114,FMN GV 11 Ramsel
66,Bergstraat 71,2020-08-02,14:00:00,310,144,166,FMN GV 11 Ramsel
66,Bergstraat 71,2020-08-02,15:00:00,240,124,116,FMN GV 11 Ramsel
66,Bergstraat 71,2020-08-02,16:00:00,230,136,94,FMN GV 11 Ramsel
66,Bergstraat 71,2020-08-02,17:00:00,134,74,60,FMN GV 11 Ramsel
66,Bergstraat 71,2020-08-02,18:00:00,134,70,64,FMN GV 11 Ramsel
66,Bergstraat 71,2020-08-02,19:00:00,74,54,20,FMN GV 11 Ramsel
66,Bergstraat 71,2020-08-02,20:00:00,46,30,16,FMN GV 11 Ramsel
66,Bergstraat 71,2020-08-02,21:00:00,24,14,10,FMN GV 11 Ramsel
66,Bergstraat 71,2020-08-02,22:00:00,6,4,2,FMN GV 11 Ramsel
66,Bergstraat 71,2020-08-02,23:00:00,2,2,0,FMN GV 11 Ramsel
66,Bergstraat 71,2020-08-03,00:00:00,2,0,2,FMN GV 11 Ramsel
66,Bergstraat 71,2020-08-03,01:00:00,2,0,2,FMN GV 11 Ramsel
66,Bergstraat 71,2020-08-03,02:00:00,0,0,0,FMN GV 11 Ramsel
66,Bergstraat 71,2020-08-03,03:00:00,0,0,0,FMN GV 11 Ramsel
66,Bergstraat 71,2020-08-03,04:00:00,4,2,2,FMN GV 11 Ramsel
66,Bergstraat 71,2020-08-03,05:00:00,14,10,4,FMN GV 11 Ramsel
66,Bergstraat 71,2020-08-03,06:00:00,36,18,18,FMN GV 11 Ramsel
66,Bergstraat 71,2020-08-03,07:00:00,26,6,20,FMN GV 11 Ramsel
66,Bergstraat 71,2020-08-03,08:00:00,44,12,32,FMN GV 11 Ramsel
66,Bergstraat 71,2020-08-03,09:00:00,54,28,26,FMN GV 11 Ramsel
66,Bergstraat 71,2020-08-03,10:00:00,72,24,48,FMN GV 11 Ramsel
66,Bergstraat 71,2020-08-03,11:00:00,84,38,46,FMN GV 11 Ramsel
66,Bergstraat 71,2020-08-03,12:00:00,68,26,42,FMN GV 11 Ramsel
66,Bergstraat 71,2020-08-03,13:00:00,172,66,106,FMN GV 11 Ramsel
66,Bergstraat 71,2020-08-03,14:00:00,180,84,96,FMN GV 11 Ramsel
66,Bergstraat 71,2020-08-03,15:00:00,178,90,88,FMN GV 11 Ramsel
66,Bergstraat 71,2020-08-03,16:00:00,168,84,84,FMN GV 11 Ramsel
66,Bergstraat 71,2020-08-03,17:00:00,106,66,40,FMN GV 11 Ramsel
66,Bergstraat 71,2020-08-03,18:00:00,70,36,34,FMN GV 11 Ramsel
66,Bergstraat 71,2020-08-03,19:00:00,50,34,16,FMN GV 11 Ramsel
66,Bergstraat 71,2020-08-03,20:00:00,52,34,18,FMN GV 11 Ramsel
66,Bergstraat 71,2020-08-03,21:00:00,14,10,4,FMN GV 11 Ramsel
66,Bergstraat 71,2020-08-03,22:00:00,22,20,2,FMN GV 11 Ramsel
66,Bergstraat 71,2020-08-03,23:00:00,0,0,0,FMN GV 11 Ramsel
66,Bergstraat 71,2020-08-04,00:00:00,0,0,0,FMN GV 11 Ramsel
66,Bergstraat 71,2020-08-04,01:00:00,0,0,0,FMN GV 11 Ramsel
66,Bergstraat 71,2020-08-04,02:00:00,0,0,0,FMN GV 11 Ramsel
66,Bergstraat 71,2020-08-04,03:00:00,0,0,0,FMN GV 11 Ramsel
66,Bergstraat 71,2020-08-04,04:00:00,10,8,2,FMN GV 11 Ramsel
66,Bergstraat 71,2020-08-04,05:00:00,12,8,4,FMN GV 11 Ramsel
66,Bergstraat 71,2020-08-04,06:00:00,34,10,24,FMN GV 11 Ramsel
66,Bergstraat 71,2020-08-04,07:00:00,46,14,32,FMN GV 11 Ramsel
66,Bergstraat 71,2020-08-04,08:00:00,48,20,28,FMN GV 11 Ramsel
66,Bergstraat 71,2020-08-04,09:00:00,100,24,76,FMN GV 11 Ramsel
66,Bergstraat 71,2020-08-04,10:00:00,132,46,86,FMN GV 11 Ramsel
66,Bergstraat 71,2020-08-04,11:00:00,126,60,66,FMN GV 11 Ramsel
66,Bergstraat 71,2020-08-04,12:00:00,198,90,108,FMN GV 11 Ramsel
66,Bergstraat 71,2020-08-04,13:00:00,260,82,178,FMN GV 11 Ramsel
66,Bergstraat 71,2020-08-04,14:00:00,294,106,188,FMN GV 11 Ramsel
66,Bergstraat 71,2020-08-04,15:00:00,266,190,76,FMN GV 11 Ramsel
66,Bergstraat 71,2020-08-04,16:00:00,332,188,144,FMN GV 11 Ramsel
66,Bergstraat 71,2020-08-04,17:00:00,236,134,102,FMN GV 11 Ramsel
66,Bergstraat 71,2020-08-04,18:00:00,180,74,106,FMN GV 11 Ramsel
66,Bergstraat 71,2020-08-04,19:00:00,112,86,26,FMN GV 11 Ramsel
66,Bergstraat 71,2020-08-04,20:00:00,146,92,54,FMN GV 11 Ramsel
66,Bergstraat 71,2020-08-04,21:00:00,60,40,20,FMN GV 11 Ramsel
66,Bergstraat 71,2020-08-04,22:00:00,20,18,2,FMN GV 11 Ramsel
66,Bergstraat 71,2020-08-04,23:00:00,2,2,0,FMN GV 11 Ramsel
66,Bergstraat 71,2020-08-05,00:00:00,0,0,0,FMN GV 11 Ramsel
66,Bergstraat 71,2020-08-05,01:00:00,0,0,0,FMN GV 11 Ramsel
66,Bergstraat 71,2020-08-05,02:00:00,4,0,4,FMN GV 11 Ramsel
66,Bergstraat 71,2020-08-05,03:00:00,0,0,0,FMN GV 11 Ramsel
66,Bergstraat 71,2020-08-05,04:00:00,10,8,2,FMN GV 11 Ramsel
66,Bergstraat 71,2020-08-05,05:00:00,22,8,14,FMN GV 11 Ramsel
66,Bergstraat 71,2020-08-05,06:00:00,44,18,26,FMN GV 11 Ramsel
66,Bergstraat 71,2020-08-05,07:00:00,56,16,40,FMN GV 11 Ramsel
66,Bergstraat 71,2020-08-05,08:00:00,94,34,60,FMN GV 11 Ramsel
66,Bergstraat 71,2020-08-05,09:00:00,122,46,76,FMN GV 11 Ramsel
66,Bergstraat 71,2020-08-05,10:00:00,154,66,88,FMN GV 11 Ramsel
66,Bergstraat 71,2020-08-05,11:00:00,186,80,106,FMN GV 11 Ramsel
66,Bergstraat 71,2020-08-05,12:00:00,168,86,82,FMN GV 11 Ramsel
66,Bergstraat 71,2020-08-05,13:00:00,214,82,132,FMN GV 11 Ramsel
66,Bergstraat 71,2020-08-05,14:00:00,306,164,142,FMN GV 11 Ramsel
66,Bergstraat 71,2020-08-05,15:00:00,178,122,56,FMN GV 11 Ramsel
66,Bergstraat 71,2020-08-05,16:00:00,234,154,80,FMN GV 11 Ramsel
66,Bergstraat 71,2020-08-05,17:00:00,174,86,88,FMN GV 11 Ramsel
66,Bergstraat 71,2020-08-05,18:00:00,132,50,82,FMN GV 11 Ramsel
66,Bergstraat 71,2020-08-05,19:00:00,130,62,68,FMN GV 11 Ramsel
66,Bergstraat 71,2020-08-05,20:00:00,120,74,46,FMN GV 11 Ramsel
66,Bergstraat 71,2020-08-05,21:00:00,62,30,32,FMN GV 11 Ramsel
66,Bergstraat 71,2020-08-05,22:00:00,36,28,8,FMN GV 11 Ramsel
66,Bergstraat 71,2020-08-05,23:00:00,10,10,0,FMN GV 11 Ramsel
66,Bergstraat 71,2020-08-06,00:00:00,0,0,0,FMN GV 11 Ramsel
66,Bergstraat 71,2020-08-06,01:00:00,0,0,0,FMN GV 11 Ramsel
66,Bergstraat 71,2020-08-06,02:00:00,2,2,0,FMN GV 11 Ramsel
66,Bergstraat 71,2020-08-06,03:00:00,4,0,4,FMN GV 11 Ramsel
66,Bergstraat 71,2020-08-06,04:00:00,14,8,6,FMN GV 11 Ramsel
66,Bergstraat 71,2020-08-06,05:00:00,18,10,8,FMN GV 11 Ramsel
66,Bergstraat 71,2020-08-06,06:00:00,30,10,20,FMN GV 11 Ramsel
66,Bergstraat 71,2020-08-06,07:00:00,50,12,38,FMN GV 11 Ramsel
66,Bergstraat 71,2020-08-06,08:00:00,118,38,80,FMN GV 11 Ramsel
66,Bergstraat 71,2020-08-06,09:00:00,172,80,92,FMN GV 11 Ramsel
66,Bergstraat 71,2020-08-06,10:00:00,204,82,122,FMN GV 11 Ramsel
66,Bergstraat 71,2020-08-06,11:00:00,172,108,64,FMN GV 11 Ramsel
66,Bergstraat 71,2020-08-06,12:00:00,178,90,88,FMN GV 11 Ramsel
66,Bergstraat 71,2020-08-06,13:00:00,122,64,58,FMN GV 11 Ramsel
66,Bergstraat 71,2020-08-06,14:00:00,158,80,78,FMN GV 11 Ramsel
66,Bergstraat 71,2020-08-06,15:00:00,114,62,52,FMN GV 11 Ramsel
66,Bergstraat 71,2020-08-06,16:00:00,136,90,46,FMN GV 11 Ramsel
66,Bergstraat 71,2020-08-06,17:00:00,132,76,56,FMN GV 11 Ramsel
66,Bergstraat 71,2020-08-06,18:00:00,106,60,46,FMN GV 11 Ramsel
66,Bergstraat 71,2020-08-06,19:00:00,150,72,78,FMN GV 11 Ramsel
66,Bergstraat 71,2020-08-06,20:00:00,84,54,30,FMN GV 11 Ramsel
66,Bergstraat 71,2020-08-06,21:00:00,72,48,24,FMN GV 11 Ramsel
66,Bergstraat 71,2020-08-06,22:00:00,38,20,18,FMN GV 11 Ramsel
66,Bergstraat 71,2020-08-06,23:00:00,14,6,8,FMN GV 11 Ramsel
66,Bergstraat 71,2020-08-07,00:00:00,6,6,0,FMN GV 11 Ramsel
66,Bergstraat 71,2020-08-07,01:00:00,0,0,0,FMN GV 11 Ramsel
66,Bergstraat 71,2020-08-07,02:00:00,2,0,2,FMN GV 11 Ramsel
66,Bergstraat 71,2020-08-07,03:00:00,4,2,2,FMN GV 11 Ramsel
66,Bergstraat 71,2020-08-07,04:00:00,14,10,4,FMN GV 11 Ramsel
66,Bergstraat 71,2020-08-07,05:00:00,24,12,12,FMN GV 11 Ramsel
66,Bergstraat 71,2020-08-07,06:00:00,26,6,20,FMN GV 11 Ramsel
66,Bergstraat 71,2020-08-07,07:00:00,90,28,62,FMN GV 11 Ramsel
66,Bergstraat 71,2020-08-07,08:00:00,104,42,62,FMN GV 11 Ramsel
66,Bergstraat 71,2020-08-07,09:00:00,180,72,108,FMN GV 11 Ramsel
66,Bergstraat 71,2020-08-07,10:00:00,160,78,82,FMN GV 11 Ramsel
66,Bergstraat 71,2020-08-07,11:00:00,140,78,62,FMN GV 11 Ramsel
66,Bergstraat 71,2020-08-07,12:00:00,100,58,42,FMN GV 11 Ramsel
66,Bergstraat 71,2020-08-07,13:00:00,56,18,38,FMN GV 11 Ramsel
66,Bergstraat 71,2020-08-07,14:00:00,94,54,40,FMN GV 11 Ramsel
66,Bergstraat 71,2020-08-07,15:00:00,88,42,46,FMN GV 11 Ramsel
66,Bergstraat 71,2020-08-07,16:00:00,62,28,34,FMN GV 11 Ramsel
66,Bergstraat 71,2020-08-07,17:00:00,68,38,30,FMN GV 11 Ramsel
66,Bergstraat 71,2020-08-07,18:00:00,90,54,36,FMN GV 11 Ramsel
66,Bergstraat 71,2020-08-07,19:00:00,64,32,32,FMN GV 11 Ramsel
66,Bergstraat 71,2020-08-07,20:00:00,104,50,54,FMN GV 11 Ramsel
66,Bergstraat 71,2020-08-07,21:00:00,66,28,38,FMN GV 11 Ramsel
66,Bergstraat 71,2020-08-07,22:00:00,24,8,16,FMN GV 11 Ramsel
66,Bergstraat 71,2020-08-07,23:00:00,12,8,4,FMN GV 11 Ramsel
66,Bergstraat 71,2020-08-08,00:00:00,12,6,6,FMN GV 11 Ramsel
66,Bergstraat 71,2020-08-08,01:00:00,8,6,2,FMN GV 11 Ramsel
66,Bergstraat 71,2020-08-08,02:00:00,2,2,0,FMN GV 11 Ramsel
66,Bergstraat 71,2020-08-08,03:00:00,4,0,4,FMN GV 11 Ramsel
66,Bergstraat 71,2020-08-08,04:00:00,4,0,4,FMN GV 11 Ramsel
66,Bergstraat 71,2020-08-08,05:00:00,4,2,2,FMN GV 11 Ramsel
66,Bergstraat 71,2020-08-08,06:00:00,36,12,24,FMN GV 11 Ramsel
66,Bergstraat 71,2020-08-08,07:00:00,42,10,32,FMN GV 11 Ramsel
66,Bergstraat 71,2020-08-08,08:00:00,184,82,102,FMN GV 11 Ramsel
66,Bergstraat 71,2020-08-08,09:00:00,220,106,114,FMN GV 11 Ramsel
66,Bergstraat 71,2020-08-08,10:00:00,212,98,114,FMN GV 11 Ramsel
66,Bergstraat 71,2020-08-08,11:00:00,174,104,70,FMN GV 11 Ramsel
66,Bergstraat 71,2020-08-08,12:00:00,96,62,34,FMN GV 11 Ramsel
66,Bergstraat 71,2020-08-08,13:00:00,68,30,38,FMN GV 11 Ramsel
66,Bergstraat 71,2020-08-08,14:00:00,110,58,52,FMN GV 11 Ramsel
66,Bergstraat 71,2020-08-08,15:00:00,70,36,34,FMN GV 11 Ramsel
66,Bergstraat 71,2020-08-08,16:00:00,46,24,22,FMN GV 11 Ramsel
66,Bergstraat 71,2020-08-08,17:00:00,54,32,22,FMN GV 11 Ramsel
66,Bergstraat 71,2020-08-08,18:00:00,78,22,56,FMN GV 11 Ramsel
66,Bergstraat 71,2020-08-08,19:00:00,76,28,48,FMN GV 11 Ramsel
66,Bergstraat 71,2020-08-08,20:00:00,122,50,72,FMN GV 11 Ramsel
66,Bergstraat 71,2020-08-08,21:00:00,112,74,38,FMN GV 11 Ramsel
66,Bergstraat 71,2020-08-08,22:00:00,50,24,26,FMN GV 11 Ramsel
66,Bergstraat 71,2020-08-08,23:00:00,28,20,8,FMN GV 11 Ramsel
66,Bergstraat 71,2020-08-09,00:00:00,10,6,4,FMN GV 11 Ramsel
66,Bergstraat 71,2020-08-09,01:00:00,18,16,2,FMN GV 11 Ramsel
66,Bergstraat 71,2020-08-09,02:00:00,2,0,2,FMN GV 11 Ramsel
66,Bergstraat 71,2020-08-09,03:00:00,2,2,0,FMN GV 11 Ramsel
66,Bergstraat 71,2020-08-09,04:00:00,0,0,0,FMN GV 11 Ramsel
66,Bergstraat 71,2020-08-09,05:00:00,6,2,4,FMN GV 11 Ramsel
66,Bergstraat 71,2020-08-09,06:00:00,20,2,18,FMN GV 11 Ramsel
66,Bergstraat 71,2020-08-09,07:00:00,54,24,30,FMN GV 11 Ramsel
66,Bergstraat 71,2020-08-09,08:00:00,238,88,150,FMN GV 11 Ramsel
66,Bergstraat 71,2020-08-09,09:00:00,310,138,172,FMN GV 11 Ramsel
66,Bergstraat 71,2020-08-09,10:00:00,302,186,116,FMN GV 11 Ramsel
66,Bergstraat 71,2020-08-09,11:00:00,270,190,80,FMN GV 11 Ramsel
66,Bergstraat 71,2020-08-09,12:00:00,64,38,26,FMN GV 11 Ramsel
66,Bergstraat 71,2020-08-09,13:00:00,102,46,56,FMN GV 11 Ramsel
66,Bergstraat 71,2020-08-09,14:00:00,122,52,70,FMN GV 11 Ramsel
66,Bergstraat 71,2020-08-09,15:00:00,94,44,50,FMN GV 11 Ramsel
66,Bergstraat 71,2020-08-09,16:00:00,110,62,48,FMN GV 11 Ramsel
66,Bergstraat 71,2020-08-09,17:00:00,64,42,22,FMN GV 11 Ramsel
66,Bergstraat 71,2020-08-09,18:00:00,68,32,36,FMN GV 11 Ramsel
66,Bergstraat 71,2020-08-09,19:00:00,60,28,32,FMN GV 11 Ramsel
66,Bergstraat 71,2020-08-09,20:00:00,116,52,64,FMN GV 11 Ramsel
66,Bergstraat 71,2020-08-09,21:00:00,56,20,36,FMN GV 11 Ramsel
66,Bergstraat 71,2020-08-09,22:00:00,40,28,12,FMN GV 11 Ramsel
66,Bergstraat 71,2020-08-09,23:00:00,24,16,8,FMN GV 11 Ramsel
66,Bergstraat 71,2020-08-10,00:00:00,10,8,2,FMN GV 11 Ramsel
66,Bergstraat 71,2020-08-10,01:00:00,0,0,0,FMN GV 11 Ramsel
66,Bergstraat 71,2020-08-10,02:00:00,0,0,0,FMN GV 11 Ramsel
66,Bergstraat 71,2020-08-10,03:00:00,2,2,0,FMN GV 11 Ramsel
66,Bergstraat 71,2020-08-10,04:00:00,10,4,6,FMN GV 11 Ramsel
66,Bergstraat 71,2020-08-10,05:00:00,18,10,8,FMN GV 11 Ramsel
66,Bergstraat 71,2020-08-10,06:00:00,28,8,20,FMN GV 11 Ramsel
66,Bergstraat 71,2020-08-10,07:00:00,62,32,30,FMN GV 11 Ramsel
66,Bergstraat 71,2020-08-10,08:00:00,124,42,82,FMN GV 11 Ramsel
66,Bergstraat 71,2020-08-10,09:00:00,116,50,66,FMN GV 11 Ramsel
66,Bergstraat 71,2020-08-10,10:00:00,136,72,64,FMN GV 11 Ramsel
66,Bergstraat 71,2020-08-10,11:00:00,112,68,44,FMN GV 11 Ramsel
66,Bergstraat 71,2020-08-10,12:00:00,106,60,46,FMN GV 11 Ramsel
66,Bergstraat 71,2020-08-10,13:00:00,96,44,52,FMN GV 11 Ramsel
66,Bergstraat 71,2020-08-10,14:00:00,130,70,60,FMN GV 11 Ramsel
66,Bergstraat 71,2020-08-10,15:00:00,70,50,20,FMN GV 11 Ramsel
66,Bergstraat 71,2020-08-10,16:00:00,94,44,50,FMN GV 11 Ramsel
66,Bergstraat 71,2020-08-10,17:00:00,84,54,30,FMN GV 11 Ramsel
66,Bergstraat 71,2020-08-10,18:00:00,106,42,64,FMN GV 11 Ramsel
66,Bergstraat 71,2020-08-10,19:00:00,88,46,42,FMN GV 11 Ramsel
66,Bergstraat 71,2020-08-10,20:00:00,108,52,56,FMN GV 11 Ramsel
66,Bergstraat 71,2020-08-10,21:00:00,58,30,28,FMN GV 11 Ramsel
66,Bergstraat 71,2020-08-10,22:00:00,22,6,16,FMN GV 11 Ramsel
66,Bergstraat 71,2020-08-10,23:00:00,10,6,4,FMN GV 11 Ramsel
66,Bergstraat 71,2020-08-11,00:00:00,0,0,0,FMN GV 11 Ramsel
66,Bergstraat 71,2020-08-11,01:00:00,4,2,2,FMN GV 11 Ramsel
66,Bergstraat 71,2020-08-11,02:00:00,2,0,2,FMN GV 11 Ramsel
66,Bergstraat 71,2020-08-11,03:00:00,0,0,0,FMN GV 11 Ramsel
66,Bergstraat 71,2020-08-11,04:00:00,10,8,2,FMN GV 11 Ramsel
66,Bergstraat 71,2020-08-11,05:00:00,18,10,8,FMN GV 11 Ramsel
66,Bergstraat 71,2020-08-11,06:00:00,34,10,24,FMN GV 11 Ramsel
66,Bergstraat 71,2020-08-11,07:00:00,80,28,52,FMN GV 11 Ramsel
66,Bergstraat 71,2020-08-11,08:00:00,124,42,82,FMN GV 11 Ramsel
66,Bergstraat 71,2020-08-11,09:00:00,154,66,88,FMN GV 11 Ramsel
66,Bergstraat 71,2020-08-11,10:00:00,174,92,82,FMN GV 11 Ramsel
66,Bergstraat 71,2020-08-11,11:00:00,128,70,58,FMN GV 11 Ramsel
66,Bergstraat 71,2020-08-11,12:00:00,126,78,48,FMN GV 11 Ramsel
66,Bergstraat 71,2020-08-11,13:00:00,94,40,54,FMN GV 11 Ramsel
66,Bergstraat 71,2020-08-11,14:00:00,104,56,48,FMN GV 11 Ramsel
66,Bergstraat 71,2020-08-11,15:00:00,78,44,34,FMN GV 11 Ramsel
66,Bergstraat 71,2020-08-11,16:00:00,80,62,18,FMN GV 11 Ramsel
66,Bergstraat 71,2020-08-11,17:00:00,104,48,56,FMN GV 11 Ramsel
66,Bergstraat 71,2020-08-11,18:00:00,84,40,44,FMN GV 11 Ramsel
66,Bergstraat 71,2020-08-11,19:00:00,74,58,16,FMN GV 11 Ramsel
66,Bergstraat 71,2020-08-11,20:00:00,70,40,30,FMN GV 11 Ramsel
66,Bergstraat 71,2020-08-11,21:00:00,32,18,14,FMN GV 11 Ramsel
66,Bergstraat 71,2020-08-11,22:00:00,22,10,12,FMN GV 11 Ramsel
66,Bergstraat 71,2020-08-11,23:00:00,14,8,6,FMN GV 11 Ramsel
66,Bergstraat 71,2020-08-12,00:00:00,6,6,0,FMN GV 11 Ramsel
66,Bergstraat 71,2020-08-12,01:00:00,0,0,0,FMN GV 11 Ramsel
66,Bergstraat 71,2020-08-12,02:00:00,2,2,0,FMN GV 11 Ramsel
66,Bergstraat 71,2020-08-12,03:00:00,2,0,2,FMN GV 11 Ramsel
66,Bergstraat 71,2020-08-12,04:00:00,8,4,4,FMN GV 11 Ramsel
66,Bergstraat 71,2020-08-12,05:00:00,22,10,12,FMN GV 11 Ramsel
66,Bergstraat 71,2020-08-12,06:00:00,34,12,22,FMN GV 11 Ramsel
66,Bergstraat 71,2020-08-12,07:00:00,88,32,56,FMN GV 11 Ramsel
66,Bergstraat 71,2020-08-12,08:00:00,126,52,74,FMN GV 11 Ramsel
66,Bergstraat 71,2020-08-12,09:00:00,150,96,54,FMN GV 11 Ramsel
66,Bergstraat 71,2020-08-12,10:00:00,162,82,80,FMN GV 11 Ramsel
66,Bergstraat 71,2020-08-12,11:00:00,148,82,66,FMN GV 11 Ramsel
66,Bergstraat 71,2020-08-12,12:00:00,100,58,42,FMN GV 11 Ramsel
66,Bergstraat 71,2020-08-12,13:00:00,138,66,72,FMN GV 11 Ramsel
66,Bergstraat 71,2020-08-12,14:00:00,116,54,62,FMN GV 11 Ramsel
66,Bergstraat 71,2020-08-12,15:00:00,120,78,42,FMN GV 11 Ramsel
66,Bergstraat 71,2020-08-12,16:00:00,88,52,36,FMN GV 11 Ramsel
66,Bergstraat 71,2020-08-12,17:00:00,90,50,40,FMN GV 11 Ramsel
66,Bergstraat 71,2020-08-12,18:00:00,122,54,68,FMN GV 11 Ramsel
66,Bergstraat 71,2020-08-12,19:00:00,130,48,82,FMN GV 11 Ramsel
66,Bergstraat 71,2020-08-12,20:00:00,106,62,44,FMN GV 11 Ramsel
66,Bergstraat 71,2020-08-12,21:00:00,108,70,38,FMN GV 11 Ramsel
66,Bergstraat 71,2020-08-12,22:00:00,46,24,22,FMN GV 11 Ramsel
66,Bergstraat 71,2020-08-12,23:00:00,20,10,10,FMN GV 11 Ramsel
66,Bergstraat 71,2020-08-13,00:00:00,8,6,2,FMN GV 11 Ramsel
66,Bergstraat 71,2020-08-13,01:00:00,12,10,2,FMN GV 11 Ramsel
66,Bergstraat 71,2020-08-13,02:00:00,4,2,2,FMN GV 11 Ramsel
66,Bergstraat 71,2020-08-13,03:00:00,0,0,0,FMN GV 11 Ramsel
66,Bergstraat 71,2020-08-13,04:00:00,4,2,2,FMN GV 11 Ramsel
66,Bergstraat 71,2020-08-13,05:00:00,18,8,10,FMN GV 11 Ramsel
66,Bergstraat 71,2020-08-13,06:00:00,24,10,14,FMN GV 11 Ramsel
66,Bergstraat 71,2020-08-13,07:00:00,42,12,30,FMN GV 11 Ramsel
66,Bergstraat 71,2020-08-13,08:00:00,72,30,42,FMN GV 11 Ramsel
66,Bergstraat 71,2020-08-13,09:00:00,114,44,70,FMN GV 11 Ramsel
66,Bergstraat 71,2020-08-13,10:00:00,128,52,76,FMN GV 11 Ramsel
66,Bergstraat 71,2020-08-13,11:00:00,148,82,66,FMN GV 11 Ramsel
66,Bergstraat 71,2020-08-13,12:00:00,104,60,44,FMN GV 11 Ramsel
66,Bergstraat 71,2020-08-13,13:00:00,130,58,72,FMN GV 11 Ramsel
66,Bergstraat 71,2020-08-13,14:00:00,134,70,64,FMN GV 11 Ramsel
66,Bergstraat 71,2020-08-13,15:00:00,116,70,46,FMN GV 11 Ramsel
66,Bergstraat 71,2020-08-13,16:00:00,106,48,58,FMN GV 11 Ramsel
66,Bergstraat 71,2020-08-13,17:00:00,78,46,32,FMN GV 11 Ramsel
66,Bergstraat 71,2020-08-13,18:00:00,36,10,26,FMN GV 11 Ramsel
66,Bergstraat 71,2020-08-13,19:00:00,48,20,28,FMN GV 11 Ramsel
66,Bergstraat 71,2020-08-13,20:00:00,44,30,14,FMN GV 11 Ramsel
66,Bergstraat 71,2020-08-13,21:00:00,42,18,24,FMN GV 11 Ramsel
66,Bergstraat 71,2020-08-13,22:00:00,12,6,6,FMN GV 11 Ramsel
66,Bergstraat 71,2020-08-13,23:00:00,2,2,0,FMN GV 11 Ramsel
66,Bergstraat 71,2020-08-14,00:00:00,2,2,0,FMN GV 11 Ramsel
66,Bergstraat 71,2020-08-14,01:00:00,4,2,2,FMN GV 11 Ramsel
66,Bergstraat 71,2020-08-14,02:00:00,2,0,2,FMN GV 11 Ramsel
66,Bergstraat 71,2020-08-14,03:00:00,0,0,0,FMN GV 11 Ramsel
66,Bergstraat 71,2020-08-14,04:00:00,12,6,6,FMN GV 11 Ramsel
66,Bergstraat 71,2020-08-14,05:00:00,14,6,8,FMN GV 11 Ramsel
66,Bergstraat 71,2020-08-14,06:00:00,14,10,4,FMN GV 11 Ramsel
66,Bergstraat 71,2020-08-14,07:00:00,42,20,22,FMN GV 11 Ramsel
66,Bergstraat 71,2020-08-14,08:00:00,76,22,54,FMN GV 11 Ramsel
66,Bergstraat 71,2020-08-14,09:00:00,130,68,62,FMN GV 11 Ramsel
66,Bergstraat 71,2020-08-14,10:00:00,158,64,94,FMN GV 11 Ramsel
66,Bergstraat 71,2020-08-14,11:00:00,142,78,64,FMN GV 11 Ramsel
66,Bergstraat 71,2020-08-14,12:00:00,120,60,60,FMN GV 11 Ramsel
66,Bergstraat 71,2020-08-14,13:00:00,80,36,44,FMN GV 11 Ramsel
66,Bergstraat 71,2020-08-14,14:00:00,86,40,46,FMN GV 11 Ramsel
66,Bergstraat 71,2020-08-14,15:00:00,88,54,34,FMN GV 11 Ramsel
66,Bergstraat 71,2020-08-14,16:00:00,88,34,54,FMN GV 11 Ramsel
66,Bergstraat 71,2020-08-14,17:00:00,104,40,64,FMN GV 11 Ramsel
66,Bergstraat 71,2020-08-14,18:00:00,128,72,56,FMN GV 11 Ramsel
66,Bergstraat 71,2020-08-14,19:00:00,84,38,46,FMN GV 11 Ramsel
66,Bergstraat 71,2020-08-14,20:00:00,80,40,40,FMN GV 11 Ramsel
66,Bergstraat 71,2020-08-14,21:00:00,50,34,16,FMN GV 11 Ramsel
66,Bergstraat 71,2020-08-14,22:00:00,14,2,12,FMN GV 11 Ramsel
66,Bergstraat 71,2020-08-14,23:00:00,10,4,6,FMN GV 11 Ramsel
66,Bergstraat 71,2020-08-15,00:00:00,12,10,2,FMN GV 11 Ramsel
66,Bergstraat 71,2020-08-15,01:00:00,8,6,2,FMN GV 11 Ramsel
66,Bergstraat 71,2020-08-15,02:00:00,0,0,0,FMN GV 11 Ramsel
66,Bergstraat 71,2020-08-15,03:00:00,0,0,0,FMN GV 11 Ramsel
66,Bergstraat 71,2020-08-15,04:00:00,4,4,0,FMN GV 11 Ramsel
66,Bergstraat 71,2020-08-15,05:00:00,8,4,4,FMN GV 11 Ramsel
66,Bergstraat 71,2020-08-15,06:00:00,14,4,10,FMN GV 11 Ramsel
66,Bergstraat 71,2020-08-15,07:00:00,18,12,6,FMN GV 11 Ramsel
66,Bergstraat 71,2020-08-15,08:00:00,82,26,56,FMN GV 11 Ramsel
66,Bergstraat 71,2020-08-15,09:00:00,162,52,110,FMN GV 11 Ramsel
66,Bergstraat 71,2020-08-15,10:00:00,196,72,124,FMN GV 11 Ramsel
66,Bergstraat 71,2020-08-15,11:00:00,252,122,130,FMN GV 11 Ramsel
66,Bergstraat 71,2020-08-15,12:00:00,210,96,114,FMN GV 11 Ramsel
66,Bergstraat 71,2020-08-15,13:00:00,238,94,144,FMN GV 11 Ramsel
66,Bergstraat 71,2020-08-15,14:00:00,240,120,120,FMN GV 11 Ramsel
66,Bergstraat 71,2020-08-15,15:00:00,232,154,78,FMN GV 11 Ramsel
66,Bergstraat 71,2020-08-15,16:00:00,156,88,68,FMN GV 11 Ramsel
66,Bergstraat 71,2020-08-15,17:00:00,144,80,64,FMN GV 11 Ramsel
66,Bergstraat 71,2020-08-15,18:00:00,54,30,24,FMN GV 11 Ramsel
66,Bergstraat 71,2020-08-15,19:00:00,60,24,36,FMN GV 11 Ramsel
66,Bergstraat 71,2020-08-15,20:00:00,74,34,40,FMN GV 11 Ramsel
66,Bergstraat 71,2020-08-15,21:00:00,30,12,18,FMN GV 11 Ramsel
66,Bergstraat 71,2020-08-15,22:00:00,24,18,6,FMN GV 11 Ramsel
66,Bergstraat 71,2020-08-15,23:00:00,10,8,2,FMN GV 11 Ramsel
66,Bergstraat 71,2020-08-16,00:00:00,18,16,2,FMN GV 11 Ramsel
66,Bergstraat 71,2020-08-16,01:00:00,4,4,0,FMN GV 11 Ramsel
66,Bergstraat 71,2020-08-16,02:00:00,4,4,0,FMN GV 11 Ramsel
66,Bergstraat 71,2020-08-16,03:00:00,0,0,0,FMN GV 11 Ramsel
66,Bergstraat 71,2020-08-16,04:00:00,2,2,0,FMN GV 11 Ramsel
66,Bergstraat 71,2020-08-16,05:00:00,2,0,2,FMN GV 11 Ramsel
66,Bergstraat 71,2020-08-16,06:00:00,18,8,10,FMN GV 11 Ramsel
66,Bergstraat 71,2020-08-16,07:00:00,54,20,34,FMN GV 11 Ramsel
66,Bergstraat 71,2020-08-16,08:00:00,148,52,96,FMN GV 11 Ramsel
66,Bergstraat 71,2020-08-16,09:00:00,282,78,204,FMN GV 11 Ramsel
66,Bergstraat 71,2020-08-16,10:00:00,346,188,158,FMN GV 11 Ramsel
66,Bergstraat 71,2020-08-16,11:00:00,356,208,148,FMN GV 11 Ramsel
66,Bergstraat 71,2020-08-16,12:00:00,186,84,102,FMN GV 11 Ramsel
66,Bergstraat 71,2020-08-16,13:00:00,314,154,160,FMN GV 11 Ramsel
66,Bergstraat 71,2020-08-16,14:00:00,348,200,148,FMN GV 11 Ramsel
66,Bergstraat 71,2020-08-16,15:00:00,298,194,104,FMN GV 11 Ramsel
66,Bergstraat 71,2020-08-16,16:00:00,130,76,54,FMN GV 11 Ramsel
66,Bergstraat 71,2020-08-16,17:00:00,64,60,4,FMN GV 11 Ramsel
66,Bergstraat 71,2020-08-16,18:00:00,22,16,6,FMN GV 11 Ramsel
66,Bergstraat 71,2020-08-16,19:00:00,54,24,30,FMN GV 11 Ramsel
66,Bergstraat 71,2020-08-16,20:00:00,48,26,22,FMN GV 11 Ramsel
66,Bergstraat 71,2020-08-16,21:00:00,20,12,8,FMN GV 11 Ramsel
66,Bergstraat 71,2020-08-16,22:00:00,8,8,0,FMN GV 11 Ramsel
66,Bergstraat 71,2020-08-16,23:00:00,0,0,0,FMN GV 11 Ramsel
66,Bergstraat 71,2020-08-17,00:00:00,2,2,0,FMN GV 11 Ramsel
66,Bergstraat 71,2020-08-17,01:00:00,0,0,0,FMN GV 11 Ramsel
66,Bergstraat 71,2020-08-17,02:00:00,0,0,0,FMN GV 11 Ramsel
66,Bergstraat 71,2020-08-17,03:00:00,0,0,0,FMN GV 11 Ramsel
66,Bergstraat 71,2020-08-17,04:00:00,4,0,4,FMN GV 11 Ramsel
66,Bergstraat 71,2020-08-17,05:00:00,14,8,6,FMN GV 11 Ramsel
66,Bergstraat 71,2020-08-17,06:00:00,34,12,22,FMN GV 11 Ramsel
66,Bergstraat 71,2020-08-17,07:00:00,46,20,26,FMN GV 11 Ramsel
66,Bergstraat 71,2020-08-17,08:00:00,44,16,28,FMN GV 11 Ramsel
66,Bergstraat 71,2020-08-17,09:00:00,62,30,32,FMN GV 11 Ramsel
66,Bergstraat 71,2020-08-17,10:00:00,94,40,54,FMN GV 11 Ramsel
66,Bergstraat 71,2020-08-17,11:00:00,138,80,58,FMN GV 11 Ramsel
66,Bergstraat 71,2020-08-17,12:00:00,104,54,50,FMN GV 11 Ramsel
66,Bergstraat 71,2020-08-17,13:00:00,246,96,150,FMN GV 11 Ramsel
66,Bergstraat 71,2020-08-17,14:00:00,236,110,126,FMN GV 11 Ramsel
66,Bergstraat 71,2020-08-17,15:00:00,152,70,82,FMN GV 11 Ramsel
66,Bergstraat 71,2020-08-17,16:00:00,160,116,44,FMN GV 11 Ramsel
66,Bergstraat 71,2020-08-17,17:00:00,122,62,60,FMN GV 11 Ramsel
66,Bergstraat 71,2020-08-17,18:00:00,66,38,28,FMN GV 11 Ramsel
66,Bergstraat 71,2020-08-17,19:00:00,88,36,52,FMN GV 11 Ramsel
66,Bergstraat 71,2020-08-17,20:00:00,70,28,42,FMN GV 11 Ramsel
66,Bergstraat 71,2020-08-17,21:00:00,32,14,18,FMN GV 11 Ramsel
66,Bergstraat 71,2020-08-17,22:00:00,18,12,6,FMN GV 11 Ramsel
66,Bergstraat 71,2020-08-17,23:00:00,4,4,0,FMN GV 11 Ramsel
66,Bergstraat 71,2020-08-18,00:00:00,0,0,0,FMN GV 11 Ramsel
66,Bergstraat 71,2020-08-18,01:00:00,0,0,0,FMN GV 11 Ramsel
66,Bergstraat 71,2020-08-18,02:00:00,0,0,0,FMN GV 11 Ramsel
66,Bergstraat 71,2020-08-18,03:00:00,2,0,2,FMN GV 11 Ramsel
66,Bergstraat 71,2020-08-18,04:00:00,8,4,4,FMN GV 11 Ramsel
66,Bergstraat 71,2020-08-18,05:00:00,14,6,8,FMN GV 11 Ramsel
66,Bergstraat 71,2020-08-18,06:00:00,40,18,22,FMN GV 11 Ramsel
66,Bergstraat 71,2020-08-18,07:00:00,44,20,24,FMN GV 11 Ramsel
66,Bergstraat 71,2020-08-18,08:00:00,42,12,30,FMN GV 11 Ramsel
66,Bergstraat 71,2020-08-18,09:00:00,112,36,76,FMN GV 11 Ramsel
66,Bergstraat 71,2020-08-18,10:00:00,204,84,120,FMN GV 11 Ramsel
66,Bergstraat 71,2020-08-18,11:00:00,108,76,32,FMN GV 11 Ramsel
66,Bergstraat 71,2020-08-18,12:00:00,130,72,58,FMN GV 11 Ramsel
66,Bergstraat 71,2020-08-18,13:00:00,200,88,112,FMN GV 11 Ramsel
66,Bergstraat 71,2020-08-18,14:00:00,140,74,66,FMN GV 11 Ramsel
66,Bergstraat 71,2020-08-18,15:00:00,132,66,66,FMN GV 11 Ramsel
66,Bergstraat 71,2020-08-18,16:00:00,154,92,62,FMN GV 11 Ramsel
66,Bergstraat 71,2020-08-18,17:00:00,138,74,64,FMN GV 11 Ramsel
66,Bergstraat 71,2020-08-18,18:00:00,128,42,86,FMN GV 11 Ramsel
66,Bergstraat 71,2020-08-18,19:00:00,98,44,54,FMN GV 11 Ramsel
66,Bergstraat 71,2020-08-18,20:00:00,78,48,30,FMN GV 11 Ramsel
66,Bergstraat 71,2020-08-18,21:00:00,32,26,6,FMN GV 11 Ramsel
66,Bergstraat 71,2020-08-18,22:00:00,30,14,16,FMN GV 11 Ramsel
66,Bergstraat 71,2020-08-18,23:00:00,16,12,4,FMN GV 11 Ramsel
66,Bergstraat 71,2020-08-19,00:00:00,6,6,0,FMN GV 11 Ramsel
66,Bergstraat 71,2020-08-19,01:00:00,2,2,0,FMN GV 11 Ramsel
66,Bergstraat 71,2020-08-19,02:00:00,0,0,0,FMN GV 11 Ramsel
66,Bergstraat 71,2020-08-19,03:00:00,0,0,0,FMN GV 11 Ramsel
66,Bergstraat 71,2020-08-19,04:00:00,8,6,2,FMN GV 11 Ramsel
66,Bergstraat 71,2020-08-19,05:00:00,14,4,10,FMN GV 11 Ramsel
66,Bergstraat 71,2020-08-19,06:00:00,26,14,12,FMN GV 11 Ramsel
66,Bergstraat 71,2020-08-19,07:00:00,54,18,36,FMN GV 11 Ramsel
66,Bergstraat 71,2020-08-19,08:00:00,56,24,32,FMN GV 11 Ramsel
66,Bergstraat 71,2020-08-19,09:00:00,86,30,56,FMN GV 11 Ramsel
66,Bergstraat 71,2020-08-19,10:00:00,160,74,86,FMN GV 11 Ramsel
66,Bergstraat 71,2020-08-19,11:00:00,178,104,74,FMN GV 11 Ramsel
66,Bergstraat 71,2020-08-19,12:00:00,172,68,104,FMN GV 11 Ramsel
66,Bergstraat 71,2020-08-19,13:00:00,154,92,62,FMN GV 11 Ramsel
66,Bergstraat 71,2020-08-19,14:00:00,250,132,118,FMN GV 11 Ramsel
66,Bergstraat 71,2020-08-19,15:00:00,250,122,128,FMN GV 11 Ramsel
66,Bergstraat 71,2020-08-19,16:00:00,222,146,76,FMN GV 11 Ramsel
66,Bergstraat 71,2020-08-19,17:00:00,166,96,70,FMN GV 11 Ramsel
66,Bergstraat 71,2020-08-19,18:00:00,122,68,54,FMN GV 11 Ramsel
66,Bergstraat 71,2020-08-19,19:00:00,92,50,42,FMN GV 11 Ramsel
66,Bergstraat 71,2020-08-19,20:00:00,50,28,22,FMN GV 11 Ramsel
66,Bergstraat 71,2020-08-19,21:00:00,24,12,12,FMN GV 11 Ramsel
66,Bergstraat 71,2020-08-19,22:00:00,12,8,4,FMN GV 11 Ramsel
66,Bergstraat 71,2020-08-19,23:00:00,8,8,0,FMN GV 11 Ramsel
66,Bergstraat 71,2020-08-20,00:00:00,2,2,0,FMN GV 11 Ramsel
66,Bergstraat 71,2020-08-20,01:00:00,6,2,4,FMN GV 11 Ramsel
66,Bergstraat 71,2020-08-20,02:00:00,2,0,2,FMN GV 11 Ramsel
66,Bergstraat 71,2020-08-20,03:00:00,0,0,0,FMN GV 11 Ramsel
66,Bergstraat 71,2020-08-20,04:00:00,4,2,2,FMN GV 11 Ramsel
66,Bergstraat 71,2020-08-20,05:00:00,16,4,12,FMN GV 11 Ramsel
66,Bergstraat 71,2020-08-20,06:00:00,46,18,28,FMN GV 11 Ramsel
66,Bergstraat 71,2020-08-20,07:00:00,36,14,22,FMN GV 11 Ramsel
66,Bergstraat 71,2020-08-20,08:00:00,98,36,62,FMN GV 11 Ramsel
66,Bergstraat 71,2020-08-20,09:00:00,92,38,54,FMN GV 11 Ramsel
66,Bergstraat 71,2020-08-20,10:00:00,168,82,86,FMN GV 11 Ramsel
66,Bergstraat 71,2020-08-20,11:00:00,158,90,68,FMN GV 11 Ramsel
66,Bergstraat 71,2020-08-20,12:00:00,170,98,72,FMN GV 11 Ramsel
66,Bergstraat 71,2020-08-20,13:00:00,198,94,104,FMN GV 11 Ramsel
66,Bergstraat 71,2020-08-20,14:00:00,190,102,88,FMN GV 11 Ramsel
66,Bergstraat 71,2020-08-20,15:00:00,174,108,66,FMN GV 11 Ramsel
66,Bergstraat 71,2020-08-20,16:00:00,214,116,98,FMN GV 11 Ramsel
66,Bergstraat 71,2020-08-20,17:00:00,142,66,76,FMN GV 11 Ramsel
66,Bergstraat 71,2020-08-20,18:00:00,162,90,72,FMN GV 11 Ramsel
66,Bergstraat 71,2020-08-20,19:00:00,150,84,66,FMN GV 11 Ramsel
66,Bergstraat 71,2020-08-20,20:00:00,88,38,50,FMN GV 11 Ramsel
66,Bergstraat 71,2020-08-20,21:00:00,32,22,10,FMN GV 11 Ramsel
66,Bergstraat 71,2020-08-20,22:00:00,22,14,8,FMN GV 11 Ramsel
66,Bergstraat 71,2020-08-20,23:00:00,2,2,0,FMN GV 11 Ramsel
66,Bergstraat 71,2020-08-21,00:00:00,4,0,4,FMN GV 11 Ramsel
66,Bergstraat 71,2020-08-21,01:00:00,2,0,2,FMN GV 11 Ramsel
66,Bergstraat 71,2020-08-21,02:00:00,0,0,0,FMN GV 11 Ramsel
66,Bergstraat 71,2020-08-21,03:00:00,4,2,2,FMN GV 11 Ramsel
66,Bergstraat 71,2020-08-21,04:00:00,8,6,2,FMN GV 11 Ramsel
66,Bergstraat 71,2020-08-21,05:00:00,10,6,4,FMN GV 11 Ramsel
66,Bergstraat 71,2020-08-21,06:00:00,18,8,10,FMN GV 11 Ramsel
66,Bergstraat 71,2020-08-21,07:00:00,16,4,12,FMN GV 11 Ramsel
66,Bergstraat 71,2020-08-21,08:00:00,28,12,16,FMN GV 11 Ramsel
66,Bergstraat 71,2020-08-21,09:00:00,18,4,14,FMN GV 11 Ramsel
66,Bergstraat 71,2020-08-21,10:00:00,44,28,16,FMN GV 11 Ramsel
66,Bergstraat 71,2020-08-21,11:00:00,70,32,38,FMN GV 11 Ramsel
66,Bergstraat 71,2020-08-21,12:00:00,98,60,38,FMN GV 11 Ramsel
66,Bergstraat 71,2020-08-21,13:00:00,198,76,122,FMN GV 11 Ramsel
66,Bergstraat 71,2020-08-21,14:00:00,170,68,102,FMN GV 11 Ramsel
66,Bergstraat 71,2020-08-21,15:00:00,228,124,104,FMN GV 11 Ramsel
66,Bergstraat 71,2020-08-21,16:00:00,162,96,66,FMN GV 11 Ramsel
66,Bergstraat 71,2020-08-21,17:00:00,144,70,74,FMN GV 11 Ramsel
66,Bergstraat 71,2020-08-21,18:00:00,96,46,50,FMN GV 11 Ramsel
66,Bergstraat 71,2020-08-21,19:00:00,108,64,44,FMN GV 11 Ramsel
66,Bergstraat 71,2020-08-21,20:00:00,78,30,48,FMN GV 11 Ramsel
66,Bergstraat 71,2020-08-21,21:00:00,54,32,22,FMN GV 11 Ramsel
66,Bergstraat 71,2020-08-21,22:00:00,18,8,10,FMN GV 11 Ramsel
66,Bergstraat 71,2020-08-21,23:00:00,6,4,2,FMN GV 11 Ramsel
66,Bergstraat 71,2020-08-22,00:00:00,6,4,2,FMN GV 11 Ramsel
66,Bergstraat 71,2020-08-22,01:00:00,6,2,4,FMN GV 11 Ramsel
66,Bergstraat 71,2020-08-22,02:00:00,6,6,0,FMN GV 11 Ramsel
66,Bergstraat 71,2020-08-22,03:00:00,2,2,0,FMN GV 11 Ramsel
66,Bergstraat 71,2020-08-22,04:00:00,2,2,0,FMN GV 11 Ramsel
66,Bergstraat 71,2020-08-22,05:00:00,2,0,2,FMN GV 11 Ramsel
66,Bergstraat 71,2020-08-22,06:00:00,12,4,8,FMN GV 11 Ramsel
66,Bergstraat 71,2020-08-22,07:00:00,24,10,14,FMN GV 11 Ramsel
66,Bergstraat 71,2020-08-22,08:00:00,72,18,54,FMN GV 11 Ramsel
66,Bergstraat 71,2020-08-22,09:00:00,116,36,80,FMN GV 11 Ramsel
66,Bergstraat 71,2020-08-22,10:00:00,192,72,120,FMN GV 11 Ramsel
66,Bergstraat 71,2020-08-22,11:00:00,202,132,70,FMN GV 11 Ramsel
66,Bergstraat 71,2020-08-22,12:00:00,152,102,50,FMN GV 11 Ramsel
66,Bergstraat 71,2020-08-22,13:00:00,188,114,74,FMN GV 11 Ramsel
66,Bergstraat 71,2020-08-22,14:00:00,210,124,86,FMN GV 11 Ramsel
66,Bergstraat 71,2020-08-22,15:00:00,152,84,68,FMN GV 11 Ramsel
66,Bergstraat 71,2020-08-22,16:00:00,150,110,40,FMN GV 11 Ramsel
66,Bergstraat 71,2020-08-22,17:00:00,106,36,70,FMN GV 11 Ramsel
66,Bergstraat 71,2020-08-22,18:00:00,58,30,28,FMN GV 11 Ramsel
66,Bergstraat 71,2020-08-22,19:00:00,54,14,40,FMN GV 11 Ramsel
66,Bergstraat 71,2020-08-22,20:00:00,46,20,26,FMN GV 11 Ramsel
66,Bergstraat 71,2020-08-22,21:00:00,20,14,6,FMN GV 11 Ramsel
66,Bergstraat 71,2020-08-22,22:00:00,10,8,2,FMN GV 11 Ramsel
66,Bergstraat 71,2020-08-22,23:00:00,12,10,2,FMN GV 11 Ramsel
66,Bergstraat 71,2020-08-23,00:00:00,2,2,0,FMN GV 11 Ramsel
66,Bergstraat 71,2020-08-23,01:00:00,12,12,0,FMN GV 11 Ramsel
66,Bergstraat 71,2020-08-23,02:00:00,0,0,0,FMN GV 11 Ramsel
66,Bergstraat 71,2020-08-23,03:00:00,0,0,0,FMN GV 11 Ramsel
66,Bergstraat 71,2020-08-23,04:00:00,0,0,0,FMN GV 11 Ramsel
66,Bergstraat 71,2020-08-23,05:00:00,2,0,2,FMN GV 11 Ramsel
66,Bergstraat 71,2020-08-23,06:00:00,10,4,6,FMN GV 11 Ramsel
66,Bergstraat 71,2020-08-23,07:00:00,40,10,30,FMN GV 11 Ramsel
66,Bergstraat 71,2020-08-23,08:00:00,144,22,122,FMN GV 11 Ramsel
66,Bergstraat 71,2020-08-23,09:00:00,156,44,112,FMN GV 11 Ramsel
66,Bergstraat 71,2020-08-23,10:00:00,222,104,118,FMN GV 11 Ramsel
66,Bergstraat 71,2020-08-23,11:00:00,184,134,50,FMN GV 11 Ramsel
66,Bergstraat 71,2020-08-23,12:00:00,118,66,52,FMN GV 11 Ramsel
66,Bergstraat 71,2020-08-23,13:00:00,114,60,54,FMN GV 11 Ramsel
66,Bergstraat 71,2020-08-23,14:00:00,134,40,94,FMN GV 11 Ramsel
66,Bergstraat 71,2020-08-23,15:00:00,190,98,92,FMN GV 11 Ramsel
66,Bergstraat 71,2020-08-23,16:00:00,48,32,16,FMN GV 11 Ramsel
66,Bergstraat 71,2020-08-23,17:00:00,82,48,34,FMN GV 11 Ramsel
66,Bergstraat 71,2020-08-23,18:00:00,60,16,44,FMN GV 11 Ramsel
66,Bergstraat 71,2020-08-23,19:00:00,60,20,40,FMN GV 11 Ramsel
66,Bergstraat 71,2020-08-23,20:00:00,42,14,28,FMN GV 11 Ramsel
66,Bergstraat 71,2020-08-23,21:00:00,18,10,8,FMN GV 11 Ramsel
66,Bergstraat 71,2020-08-23,22:00:00,8,6,2,FMN GV 11 Ramsel
66,Bergstraat 71,2020-08-23,23:00:00,8,8,0,FMN GV 11 Ramsel
66,Bergstraat 71,2020-08-24,00:00:00,12,10,2,FMN GV 11 Ramsel
66,Bergstraat 71,2020-08-24,01:00:00,4,2,2,FMN GV 11 Ramsel
66,Bergstraat 71,2020-08-24,02:00:00,0,0,0,FMN GV 11 Ramsel
66,Bergstraat 71,2020-08-24,03:00:00,4,2,2,FMN GV 11 Ramsel
66,Bergstraat 71,2020-08-24,04:00:00,10,6,4,FMN GV 11 Ramsel
66,Bergstraat 71,2020-08-24,05:00:00,12,4,8,FMN GV 11 Ramsel
66,Bergstraat 71,2020-08-24,06:00:00,34,16,18,FMN GV 11 Ramsel
66,Bergstraat 71,2020-08-24,07:00:00,32,10,22,FMN GV 11 Ramsel
66,Bergstraat 71,2020-08-24,08:00:00,58,26,32,FMN GV 11 Ramsel
66,Bergstraat 71,2020-08-24,09:00:00,40,18,22,FMN GV 11 Ramsel
66,Bergstraat 71,2020-08-24,10:00:00,128,48,80,FMN GV 11 Ramsel
66,Bergstraat 71,2020-08-24,11:00:00,92,52,40,FMN GV 11 Ramsel
66,Bergstraat 71,2020-08-24,12:00:00,94,48,46,FMN GV 11 Ramsel
66,Bergstraat 71,2020-08-24,13:00:00,124,44,80,FMN GV 11 Ramsel
66,Bergstraat 71,2020-08-24,14:00:00,174,68,106,FMN GV 11 Ramsel
66,Bergstraat 71,2020-08-24,15:00:00,178,114,64,FMN GV 11 Ramsel
66,Bergstraat 71,2020-08-24,16:00:00,124,64,60,FMN GV 11 Ramsel
66,Bergstraat 71,2020-08-24,17:00:00,90,54,36,FMN GV 11 Ramsel
66,Bergstraat 71,2020-08-24,18:00:00,94,64,30,FMN GV 11 Ramsel
66,Bergstraat 71,2020-08-24,19:00:00,90,26,64,FMN GV 11 Ramsel
66,Bergstraat 71,2020-08-24,20:00:00,58,44,14,FMN GV 11 Ramsel
66,Bergstraat 71,2020-08-24,21:00:00,10,6,4,FMN GV 11 Ramsel
66,Bergstraat 71,2020-08-24,22:00:00,16,8,8,FMN GV 11 Ramsel
66,Bergstraat 71,2020-08-24,23:00:00,6,6,0,FMN GV 11 Ramsel
66,Bergstraat 71,2020-08-25,00:00:00,2,0,2,FMN GV 11 Ramsel
66,Bergstraat 71,2020-08-25,01:00:00,4,2,2,FMN GV 11 Ramsel
66,Bergstraat 71,2020-08-25,02:00:00,0,0,0,FMN GV 11 Ramsel
66,Bergstraat 71,2020-08-25,03:00:00,2,0,2,FMN GV 11 Ramsel
66,Bergstraat 71,2020-08-25,04:00:00,4,4,0,FMN GV 11 Ramsel
66,Bergstraat 71,2020-08-25,05:00:00,8,8,0,FMN GV 11 Ramsel
66,Bergstraat 71,2020-08-25,06:00:00,20,10,10,FMN GV 11 Ramsel
66,Bergstraat 71,2020-08-25,07:00:00,30,4,26,FMN GV 11 Ramsel
66,Bergstraat 71,2020-08-25,08:00:00,42,12,30,FMN GV 11 Ramsel
66,Bergstraat 71,2020-08-25,09:00:00,32,14,18,FMN GV 11 Ramsel
66,Bergstraat 71,2020-08-25,10:00:00,38,14,24,FMN GV 11 Ramsel
66,Bergstraat 71,2020-08-25,11:00:00,32,18,14,FMN GV 11 Ramsel
66,Bergstraat 71,2020-08-25,12:00:00,50,32,18,FMN GV 11 Ramsel
66,Bergstraat 71,2020-08-25,13:00:00,72,24,48,FMN GV 11 Ramsel
66,Bergstraat 71,2020-08-25,14:00:00,88,36,52,FMN GV 11 Ramsel
66,Bergstraat 71,2020-08-25,15:00:00,64,32,32,FMN GV 11 Ramsel
66,Bergstraat 71,2020-08-25,16:00:00,48,32,16,FMN GV 11 Ramsel
66,Bergstraat 71,2020-08-25,17:00:00,82,38,44,FMN GV 11 Ramsel
66,Bergstraat 71,2020-08-25,18:00:00,60,20,40,FMN GV 11 Ramsel
66,Bergstraat 71,2020-08-25,19:00:00,76,38,38,FMN GV 11 Ramsel
66,Bergstraat 71,2020-08-25,20:00:00,60,36,24,FMN GV 11 Ramsel
66,Bergstraat 71,2020-08-25,21:00:00,44,44,0,FMN GV 11 Ramsel
66,Bergstraat 71,2020-08-25,22:00:00,26,12,14,FMN GV 11 Ramsel
66,Bergstraat 71,2020-08-25,23:00:00,2,2,0,FMN GV 11 Ramsel
66,Bergstraat 71,2020-08-26,00:00:00,2,2,0,FMN GV 11 Ramsel
66,Bergstraat 71,2020-08-26,01:00:00,0,0,0,FMN GV 11 Ramsel
66,Bergstraat 71,2020-08-26,02:00:00,0,0,0,FMN GV 11 Ramsel
66,Bergstraat 71,2020-08-26,03:00:00,4,0,4,FMN GV 11 Ramsel
66,Bergstraat 71,2020-08-26,04:00:00,6,4,2,FMN GV 11 Ramsel
66,Bergstraat 71,2020-08-26,05:00:00,12,10,2,FMN GV 11 Ramsel
66,Bergstraat 71,2020-08-26,06:00:00,14,8,6,FMN GV 11 Ramsel
66,Bergstraat 71,2020-08-26,07:00:00,20,4,16,FMN GV 11 Ramsel
66,Bergstraat 71,2020-08-26,08:00:00,24,8,16,FMN GV 11 Ramsel
66,Bergstraat 71,2020-08-26,09:00:00,26,16,10,FMN GV 11 Ramsel
66,Bergstraat 71,2020-08-26,10:00:00,8,4,4,FMN GV 11 Ramsel
66,Bergstraat 71,2020-08-26,11:00:00,32,12,20,FMN GV 11 Ramsel
66,Bergstraat 71,2020-08-26,12:00:00,38,18,20,FMN GV 11 Ramsel
66,Bergstraat 71,2020-08-26,13:00:00,70,32,38,FMN GV 11 Ramsel
66,Bergstraat 71,2020-08-26,14:00:00,78,32,46,FMN GV 11 Ramsel
66,Bergstraat 71,2020-08-26,15:00:00,78,44,34,FMN GV 11 Ramsel
66,Bergstraat 71,2020-08-26,16:00:00,70,44,26,FMN GV 11 Ramsel
66,Bergstraat 71,2020-08-26,17:00:00,68,28,40,FMN GV 11 Ramsel
66,Bergstraat 71,2020-08-26,18:00:00,74,30,44,FMN GV 11 Ramsel
66,Bergstraat 71,2020-08-26,19:00:00,60,30,30,FMN GV 11 Ramsel
66,Bergstraat 71,2020-08-26,20:00:00,60,20,40,FMN GV 11 Ramsel
66,Bergstraat 71,2020-08-26,21:00:00,6,6,0,FMN GV 11 Ramsel
66,Bergstraat 71,2020-08-26,22:00:00,10,8,2,FMN GV 11 Ramsel
66,Bergstraat 71,2020-08-26,23:00:00,4,0,4,FMN GV 11 Ramsel
66,Bergstraat 71,2020-08-27,00:00:00,16,14,2,FMN GV 11 Ramsel
66,Bergstraat 71,2020-08-27,01:00:00,0,0,0,FMN GV 11 Ramsel
66,Bergstraat 71,2020-08-27,02:00:00,0,0,0,FMN GV 11 Ramsel
66,Bergstraat 71,2020-08-27,03:00:00,4,2,2,FMN GV 11 Ramsel
66,Bergstraat 71,2020-08-27,04:00:00,6,4,2,FMN GV 11 Ramsel
66,Bergstraat 71,2020-08-27,05:00:00,6,4,2,FMN GV 11 Ramsel
66,Bergstraat 71,2020-08-27,06:00:00,24,12,12,FMN GV 11 Ramsel
66,Bergstraat 71,2020-08-27,07:00:00,36,14,22,FMN GV 11 Ramsel
66,Bergstraat 71,2020-08-27,08:00:00,46,10,36,FMN GV 11 Ramsel
66,Bergstraat 71,2020-08-27,09:00:00,100,30,70,FMN GV 11 Ramsel
66,Bergstraat 71,2020-08-27,10:00:00,138,60,78,FMN GV 11 Ramsel
66,Bergstraat 71,2020-08-27,11:00:00,116,50,66,FMN GV 11 Ramsel
66,Bergstraat 71,2020-08-27,12:00:00,158,74,84,FMN GV 11 Ramsel
66,Bergstraat 71,2020-08-27,13:00:00,238,108,130,FMN GV 11 Ramsel
66,Bergstraat 71,2020-08-27,14:00:00,324,166,158,FMN GV 11 Ramsel
66,Bergstraat 71,2020-08-27,15:00:00,248,124,124,FMN GV 11 Ramsel
66,Bergstraat 71,2020-08-27,16:00:00,262,124,138,FMN GV 11 Ramsel
66,Bergstraat 71,2020-08-27,17:00:00,182,86,96,FMN GV 11 Ramsel
66,Bergstraat 71,2020-08-27,18:00:00,140,58,82,FMN GV 11 Ramsel
66,Bergstraat 71,2020-08-27,19:00:00,82,38,44,FMN GV 11 Ramsel
66,Bergstraat 71,2020-08-27,20:00:00,84,66,18,FMN GV 11 Ramsel
66,Bergstraat 71,2020-08-27,21:00:00,30,20,10,FMN GV 11 Ramsel
66,Bergstraat 71,2020-08-27,22:00:00,24,12,12,FMN GV 11 Ramsel
66,Bergstraat 71,2020-08-27,23:00:00,0,0,0,FMN GV 11 Ramsel
66,Bergstraat 71,2020-08-28,00:00:00,6,6,0,FMN GV 11 Ramsel
66,Bergstraat 71,2020-08-28,01:00:00,0,0,0,FMN GV 11 Ramsel
66,Bergstraat 71,2020-08-28,02:00:00,0,0,0,FMN GV 11 Ramsel
66,Bergstraat 71,2020-08-28,03:00:00,2,2,0,FMN GV 11 Ramsel
66,Bergstraat 71,2020-08-28,04:00:00,4,2,2,FMN GV 11 Ramsel
66,Bergstraat 71,2020-08-28,05:00:00,12,6,6,FMN GV 11 Ramsel
66,Bergstraat 71,2020-08-28,06:00:00,16,12,4,FMN GV 11 Ramsel
66,Bergstraat 71,2020-08-28,07:00:00,20,6,14,FMN GV 11 Ramsel
66,Bergstraat 71,2020-08-28,08:00:00,42,14,28,FMN GV 11 Ramsel
66,Bergstraat 71,2020-08-28,09:00:00,60,28,32,FMN GV 11 Ramsel
66,Bergstraat 71,2020-08-28,10:00:00,46,32,14,FMN GV 11 Ramsel
66,Bergstraat 71,2020-08-28,11:00:00,56,20,36,FMN GV 11 Ramsel
66,Bergstraat 71,2020-08-28,12:00:00,70,26,44,FMN GV 11 Ramsel
66,Bergstraat 71,2020-08-28,13:00:00,104,50,54,FMN GV 11 Ramsel
66,Bergstraat 71,2020-08-28,14:00:00,84,42,42,FMN GV 11 Ramsel
66,Bergstraat 71,2020-08-28,15:00:00,88,42,46,FMN GV 11 Ramsel
66,Bergstraat 71,2020-08-28,16:00:00,62,34,28,FMN GV 11 Ramsel
66,Bergstraat 71,2020-08-28,17:00:00,40,34,6,FMN GV 11 Ramsel
66,Bergstraat 71,2020-08-28,18:00:00,8,6,2,FMN GV 11 Ramsel
66,Bergstraat 71,2020-08-28,19:00:00,20,6,14,FMN GV 11 Ramsel
66,Bergstraat 71,2020-08-28,20:00:00,32,14,18,FMN GV 11 Ramsel
66,Bergstraat 71,2020-08-28,21:00:00,20,2,18,FMN GV 11 Ramsel
66,Bergstraat 71,2020-08-28,22:00:00,4,0,4,FMN GV 11 Ramsel
66,Bergstraat 71,2020-08-28,23:00:00,0,0,0,FMN GV 11 Ramsel
66,Bergstraat 71,2020-08-29,00:00:00,6,6,0,FMN GV 11 Ramsel
66,Bergstraat 71,2020-08-29,01:00:00,14,8,6,FMN GV 11 Ramsel
66,Bergstraat 71,2020-08-29,02:00:00,0,0,0,FMN GV 11 Ramsel
66,Bergstraat 71,2020-08-29,03:00:00,0,0,0,FMN GV 11 Ramsel
66,Bergstraat 71,2020-08-29,04:00:00,2,0,2,FMN GV 11 Ramsel
66,Bergstraat 71,2020-08-29,05:00:00,2,2,0,FMN GV 11 Ramsel
66,Bergstraat 71,2020-08-29,06:00:00,14,10,4,FMN GV 11 Ramsel
66,Bergstraat 71,2020-08-29,07:00:00,14,10,4,FMN GV 11 Ramsel
66,Bergstraat 71,2020-08-29,08:00:00,36,14,22,FMN GV 11 Ramsel
66,Bergstraat 71,2020-08-29,09:00:00,70,30,40,FMN GV 11 Ramsel
66,Bergstraat 71,2020-08-29,10:00:00,88,38,50,FMN GV 11 Ramsel
66,Bergstraat 71,2020-08-29,11:00:00,96,46,50,FMN GV 11 Ramsel
66,Bergstraat 71,2020-08-29,12:00:00,88,46,42,FMN GV 11 Ramsel
66,Bergstraat 71,2020-08-29,13:00:00,96,60,36,FMN GV 11 Ramsel
66,Bergstraat 71,2020-08-29,14:00:00,120,54,66,FMN GV 11 Ramsel
66,Bergstraat 71,2020-08-29,15:00:00,158,92,66,FMN GV 11 Ramsel
66,Bergstraat 71,2020-08-29,16:00:00,134,54,80,FMN GV 11 Ramsel
66,Bergstraat 71,2020-08-29,17:00:00,84,42,42,FMN GV 11 Ramsel
66,Bergstraat 71,2020-08-29,18:00:00,44,20,24,FMN GV 11 Ramsel
66,Bergstraat 71,2020-08-29,19:00:00,68,34,34,FMN GV 11 Ramsel
66,Bergstraat 71,2020-08-29,20:00:00,32,14,18,FMN GV 11 Ramsel
66,Bergstraat 71,2020-08-29,21:00:00,6,2,4,FMN GV 11 Ramsel
66,Bergstraat 71,2020-08-29,22:00:00,6,4,2,FMN GV 11 Ramsel
66,Bergstraat 71,2020-08-29,23:00:00,2,2,0,FMN GV 11 Ramsel
66,Bergstraat 71,2020-08-30,00:00:00,8,6,2,FMN GV 11 Ramsel
66,Bergstraat 71,2020-08-30,01:00:00,16,14,2,FMN GV 11 Ramsel
66,Bergstraat 71,2020-08-30,02:00:00,2,0,2,FMN GV 11 Ramsel
66,Bergstraat 71,2020-08-30,03:00:00,0,0,0,FMN GV 11 Ramsel
66,Bergstraat 71,2020-08-30,04:00:00,0,0,0,FMN GV 11 Ramsel
66,Bergstraat 71,2020-08-30,05:00:00,0,0,0,FMN GV 11 Ramsel
66,Bergstraat 71,2020-08-30,06:00:00,6,2,4,FMN GV 11 Ramsel
66,Bergstraat 71,2020-08-30,07:00:00,20,10,10,FMN GV 11 Ramsel
66,Bergstraat 71,2020-08-30,08:00:00,82,34,48,FMN GV 11 Ramsel
66,Bergstraat 71,2020-08-30,09:00:00,166,64,102,FMN GV 11 Ramsel
66,Bergstraat 71,2020-08-30,10:00:00,254,142,112,FMN GV 11 Ramsel
66,Bergstraat 71,2020-08-30,11:00:00,214,146,68,FMN GV 11 Ramsel
66,Bergstraat 71,2020-08-30,12:00:00,144,56,88,FMN GV 11 Ramsel
66,Bergstraat 71,2020-08-30,13:00:00,94,62,32,FMN GV 11 Ramsel
66,Bergstraat 71,2020-08-30,14:00:00,64,40,24,FMN GV 11 Ramsel
66,Bergstraat 71,2020-08-30,15:00:00,10,8,2,FMN GV 11 Ramsel
66,Bergstraat 71,2020-08-30,16:00:00,22,4,18,FMN GV 11 Ramsel
66,Bergstraat 71,2020-08-30,17:00:00,44,24,20,FMN GV 11 Ramsel
66,Bergstraat 71,2020-08-30,18:00:00,14,4,10,FMN GV 11 Ramsel
66,Bergstraat 71,2020-08-30,19:00:00,20,8,12,FMN GV 11 Ramsel
66,Bergstraat 71,2020-08-30,20:00:00,34,22,12,FMN GV 11 Ramsel
66,Bergstraat 71,2020-08-30,21:00:00,8,2,6,FMN GV 11 Ramsel
66,Bergstraat 71,2020-08-30,22:00:00,2,2,0,FMN GV 11 Ramsel
66,Bergstraat 71,2020-08-30,23:00:00,0,0,0,FMN GV 11 Ramsel
66,Bergstraat 71,2020-08-31,00:00:00,2,2,0,FMN GV 11 Ramsel
66,Bergstraat 71,2020-08-31,01:00:00,2,2,0,FMN GV 11 Ramsel
66,Bergstraat 71,2020-08-31,02:00:00,0,0,0,FMN GV 11 Ramsel
66,Bergstraat 71,2020-08-31,03:00:00,2,2,0,FMN GV 11 Ramsel
66,Bergstraat 71,2020-08-31,04:00:00,6,4,2,FMN GV 11 Ramsel
66,Bergstraat 71,2020-08-31,05:00:00,14,12,2,FMN GV 11 Ramsel
66,Bergstraat 71,2020-08-31,06:00:00,28,12,16,FMN GV 11 Ramsel
66,Bergstraat 71,2020-08-31,07:00:00,28,6,22,FMN GV 11 Ramsel
66,Bergstraat 71,2020-08-31,08:00:00,48,22,26,FMN GV 11 Ramsel
66,Bergstraat 71,2020-08-31,09:00:00,44,16,28,FMN GV 11 Ramsel
66,Bergstraat 71,2020-08-31,10:00:00,56,30,26,FMN GV 11 Ramsel
66,Bergstraat 71,2020-08-31,11:00:00,70,36,34,FMN GV 11 Ramsel
66,Bergstraat 71,2020-08-31,12:00:00,108,60,48,FMN GV 11 Ramsel
66,Bergstraat 71,2020-08-31,13:00:00,178,82,96,FMN GV 11 Ramsel
66,Bergstraat 71,2020-08-31,14:00:00,192,88,104,FMN GV 11 Ramsel
66,Bergstraat 71,2020-08-31,15:00:00,176,82,94,FMN GV 11 Ramsel
66,Bergstraat 71,2020-08-31,16:00:00,158,94,64,FMN GV 11 Ramsel
66,Bergstraat 71,2020-08-31,17:00:00,106,70,36,FMN GV 11 Ramsel
66,Bergstraat 71,2020-08-31,18:00:00,96,54,42,FMN GV 11 Ramsel
66,Bergstraat 71,2020-08-31,19:00:00,76,34,42,FMN GV 11 Ramsel
66,Bergstraat 71,2020-08-31,20:00:00,38,30,8,FMN GV 11 Ramsel
66,Bergstraat 71,2020-08-31,21:00:00,26,8,18,FMN GV 11 Ramsel
66,Bergstraat 71,2020-08-31,22:00:00,10,10,0,FMN GV 11 Ramsel
66,Bergstraat 71,2020-08-31,23:00:00,0,0,0,FMN GV 11 Ramsel
66,Bergstraat 71,2020-09-01,00:00:00,0,0,0,FMN GV 11 Ramsel
66,Bergstraat 71,2020-09-01,01:00:00,0,0,0,FMN GV 11 Ramsel
66,Bergstraat 71,2020-09-01,02:00:00,0,0,0,FMN GV 11 Ramsel
66,Bergstraat 71,2020-09-01,03:00:00,0,0,0,FMN GV 11 Ramsel
66,Bergstraat 71,2020-09-01,04:00:00,6,4,2,FMN GV 11 Ramsel
66,Bergstraat 71,2020-09-01,05:00:00,20,12,8,FMN GV 11 Ramsel
66,Bergstraat 71,2020-09-01,06:00:00,22,8,14,FMN GV 11 Ramsel
66,Bergstraat 71,2020-09-01,07:00:00,184,26,158,FMN GV 11 Ramsel
66,Bergstraat 71,2020-09-01,08:00:00,234,40,194,FMN GV 11 Ramsel
66,Bergstraat 71,2020-09-01,09:00:00,204,30,174,FMN GV 11 Ramsel
66,Bergstraat 71,2020-09-01,10:00:00,114,36,78,FMN GV 11 Ramsel
66,Bergstraat 71,2020-09-01,11:00:00,136,50,86,FMN GV 11 Ramsel
66,Bergstraat 71,2020-09-01,12:00:00,374,296,78,FMN GV 11 Ramsel
66,Bergstraat 71,2020-09-01,13:00:00,270,130,140,FMN GV 11 Ramsel
66,Bergstraat 71,2020-09-01,14:00:00,248,146,102,FMN GV 11 Ramsel
66,Bergstraat 71,2020-09-01,15:00:00,298,178,120,FMN GV 11 Ramsel
66,Bergstraat 71,2020-09-01,16:00:00,210,114,96,FMN GV 11 Ramsel
66,Bergstraat 71,2020-09-01,17:00:00,162,82,80,FMN GV 11 Ramsel
66,Bergstraat 71,2020-09-01,18:00:00,124,50,74,FMN GV 11 Ramsel
66,Bergstraat 71,2020-09-01,19:00:00,74,32,42,FMN GV 11 Ramsel
66,Bergstraat 71,2020-09-01,20:00:00,44,28,16,FMN GV 11 Ramsel
66,Bergstraat 71,2020-09-01,21:00:00,24,16,8,FMN GV 11 Ramsel
66,Bergstraat 71,2020-09-01,22:00:00,10,8,2,FMN GV 11 Ramsel
66,Bergstraat 71,2020-09-01,23:00:00,6,0,6,FMN GV 11 Ramsel
66,Bergstraat 71,2020-09-02,00:00:00,0,0,0,FMN GV 11 Ramsel
66,Bergstraat 71,2020-09-02,01:00:00,4,4,0,FMN GV 11 Ramsel
66,Bergstraat 71,2020-09-02,02:00:00,0,0,0,FMN GV 11 Ramsel
66,Bergstraat 71,2020-09-02,03:00:00,0,0,0,FMN GV 11 Ramsel
66,Bergstraat 71,2020-09-02,04:00:00,4,4,0,FMN GV 11 Ramsel
66,Bergstraat 71,2020-09-02,05:00:00,14,6,8,FMN GV 11 Ramsel
66,Bergstraat 71,2020-09-02,06:00:00,28,8,20,FMN GV 11 Ramsel
66,Bergstraat 71,2020-09-02,07:00:00,322,22,300,FMN GV 11 Ramsel
66,Bergstraat 71,2020-09-02,08:00:00,180,32,148,FMN GV 11 Ramsel
66,Bergstraat 71,2020-09-02,09:00:00,74,24,50,FMN GV 11 Ramsel
66,Bergstraat 71,2020-09-02,10:00:00,82,36,46,FMN GV 11 Ramsel
66,Bergstraat 71,2020-09-02,11:00:00,128,66,62,FMN GV 11 Ramsel
66,Bergstraat 71,2020-09-02,12:00:00,440,356,84,FMN GV 11 Ramsel
66,Bergstraat 71,2020-09-02,13:00:00,280,142,138,FMN GV 11 Ramsel
66,Bergstraat 71,2020-09-02,14:00:00,306,156,150,FMN GV 11 Ramsel
66,Bergstraat 71,2020-09-02,15:00:00,280,192,88,FMN GV 11 Ramsel
66,Bergstraat 71,2020-09-02,16:00:00,248,166,82,FMN GV 11 Ramsel
66,Bergstraat 71,2020-09-02,17:00:00,198,116,82,FMN GV 11 Ramsel
66,Bergstraat 71,2020-09-02,18:00:00,118,50,68,FMN GV 11 Ramsel
66,Bergstraat 71,2020-09-02,19:00:00,108,48,60,FMN GV 11 Ramsel
66,Bergstraat 71,2020-09-02,20:00:00,64,46,18,FMN GV 11 Ramsel
66,Bergstraat 71,2020-09-02,21:00:00,14,12,2,FMN GV 11 Ramsel
66,Bergstraat 71,2020-09-02,22:00:00,4,4,0,FMN GV 11 Ramsel
66,Bergstraat 71,2020-09-02,23:00:00,2,0,2,FMN GV 11 Ramsel
66,Bergstraat 71,2020-09-03,00:00:00,2,2,0,FMN GV 11 Ramsel
66,Bergstraat 71,2020-09-03,01:00:00,0,0,0,FMN GV 11 Ramsel
66,Bergstraat 71,2020-09-03,02:00:00,0,0,0,FMN GV 11 Ramsel
66,Bergstraat 71,2020-09-03,03:00:00,0,0,0,FMN GV 11 Ramsel
66,Bergstraat 71,2020-09-03,04:00:00,6,2,4,FMN GV 11 Ramsel
66,Bergstraat 71,2020-09-03,05:00:00,12,12,0,FMN GV 11 Ramsel
66,Bergstraat 71,2020-09-03,06:00:00,24,10,14,FMN GV 11 Ramsel
66,Bergstraat 71,2020-09-03,07:00:00,212,18,194,FMN GV 11 Ramsel
66,Bergstraat 71,2020-09-03,08:00:00,108,18,90,FMN GV 11 Ramsel
66,Bergstraat 71,2020-09-03,09:00:00,28,10,18,FMN GV 11 Ramsel
66,Bergstraat 71,2020-09-03,10:00:00,26,12,14,FMN GV 11 Ramsel
66,Bergstraat 71,2020-09-03,11:00:00,32,18,14,FMN GV 11 Ramsel
66,Bergstraat 71,2020-09-03,12:00:00,86,48,38,FMN GV 11 Ramsel
66,Bergstraat 71,2020-09-03,13:00:00,94,48,46,FMN GV 11 Ramsel
66,Bergstraat 71,2020-09-03,14:00:00,62,28,34,FMN GV 11 Ramsel
66,Bergstraat 71,2020-09-03,15:00:00,260,202,58,FMN GV 11 Ramsel
66,Bergstraat 71,2020-09-03,16:00:00,200,166,34,FMN GV 11 Ramsel
66,Bergstraat 71,2020-09-03,17:00:00,110,64,46,FMN GV 11 Ramsel
66,Bergstraat 71,2020-09-03,18:00:00,102,50,52,FMN GV 11 Ramsel
66,Bergstraat 71,2020-09-03,19:00:00,76,44,32,FMN GV 11 Ramsel
66,Bergstraat 71,2020-09-03,20:00:00,40,24,16,FMN GV 11 Ramsel
66,Bergstraat 71,2020-09-03,21:00:00,8,8,0,FMN GV 11 Ramsel
66,Bergstraat 71,2020-09-03,22:00:00,12,10,2,FMN GV 11 Ramsel
66,Bergstraat 71,2020-09-03,23:00:00,4,4,0,FMN GV 11 Ramsel
66,Bergstraat 71,2020-09-04,00:00:00,0,0,0,FMN GV 11 Ramsel
66,Bergstraat 71,2020-09-04,01:00:00,0,0,0,FMN GV 11 Ramsel
66,Bergstraat 71,2020-09-04,02:00:00,0,0,0,FMN GV 11 Ramsel
66,Bergstraat 71,2020-09-04,03:00:00,0,0,0,FMN GV 11 Ramsel
66,Bergstraat 71,2020-09-04,04:00:00,6,4,2,FMN GV 11 Ramsel
66,Bergstraat 71,2020-09-04,05:00:00,10,6,4,FMN GV 11 Ramsel
66,Bergstraat 71,2020-09-04,06:00:00,22,6,16,FMN GV 11 Ramsel
66,Bergstraat 71,2020-09-04,07:00:00,216,14,202,FMN GV 11 Ramsel
66,Bergstraat 71,2020-09-04,08:00:00,104,16,88,FMN GV 11 Ramsel
66,Bergstraat 71,2020-09-04,09:00:00,50,12,38,FMN GV 11 Ramsel
66,Bergstraat 71,2020-09-04,10:00:00,40,18,22,FMN GV 11 Ramsel
66,Bergstraat 71,2020-09-04,11:00:00,48,28,20,FMN GV 11 Ramsel
66,Bergstraat 71,2020-09-04,12:00:00,74,26,48,FMN GV 11 Ramsel
66,Bergstraat 71,2020-09-04,13:00:00,92,46,46,FMN GV 11 Ramsel
66,Bergstraat 71,2020-09-04,14:00:00,140,76,64,FMN GV 11 Ramsel
66,Bergstraat 71,2020-09-04,15:00:00,266,216,50,FMN GV 11 Ramsel
66,Bergstraat 71,2020-09-04,16:00:00,132,100,32,FMN GV 11 Ramsel
66,Bergstraat 71,2020-09-04,17:00:00,106,66,40,FMN GV 11 Ramsel
66,Bergstraat 71,2020-09-04,18:00:00,82,38,44,FMN GV 11 Ramsel
66,Bergstraat 71,2020-09-04,19:00:00,100,50,50,FMN GV 11 Ramsel
66,Bergstraat 71,2020-09-04,20:00:00,64,38,26,FMN GV 11 Ramsel
66,Bergstraat 71,2020-09-04,21:00:00,30,14,16,FMN GV 11 Ramsel
66,Bergstraat 71,2020-09-04,22:00:00,12,8,4,FMN GV 11 Ramsel
66,Bergstraat 71,2020-09-04,23:00:00,6,6,0,FMN GV 11 Ramsel
66,Bergstraat 71,2020-09-05,00:00:00,22,20,2,FMN GV 11 Ramsel
66,Bergstraat 71,2020-09-05,01:00:00,4,2,2,FMN GV 11 Ramsel
66,Bergstraat 71,2020-09-05,02:00:00,4,4,0,FMN GV 11 Ramsel
66,Bergstraat 71,2020-09-05,03:00:00,2,0,2,FMN GV 11 Ramsel
66,Bergstraat 71,2020-09-05,04:00:00,0,0,0,FMN GV 11 Ramsel
66,Bergstraat 71,2020-09-05,05:00:00,4,2,2,FMN GV 11 Ramsel
66,Bergstraat 71,2020-09-05,06:00:00,4,4,0,FMN GV 11 Ramsel
66,Bergstraat 71,2020-09-05,07:00:00,6,6,0,FMN GV 11 Ramsel
66,Bergstraat 71,2020-09-05,08:00:00,20,10,10,FMN GV 11 Ramsel
66,Bergstraat 71,2020-09-05,09:00:00,98,46,52,FMN GV 11 Ramsel
66,Bergstraat 71,2020-09-05,10:00:00,72,32,40,FMN GV 11 Ramsel
66,Bergstraat 71,2020-09-05,11:00:00,88,54,34,FMN GV 11 Ramsel
66,Bergstraat 71,2020-09-05,12:00:00,138,66,72,FMN GV 11 Ramsel
66,Bergstraat 71,2020-09-05,13:00:00,220,120,100,FMN GV 11 Ramsel
66,Bergstraat 71,2020-09-05,14:00:00,194,90,104,FMN GV 11 Ramsel
66,Bergstraat 71,2020-09-05,15:00:00,156,92,64,FMN GV 11 Ramsel
66,Bergstraat 71,2020-09-05,16:00:00,162,88,74,FMN GV 11 Ramsel
66,Bergstraat 71,2020-09-05,17:00:00,104,60,44,FMN GV 11 Ramsel
66,Bergstraat 71,2020-09-05,18:00:00,112,58,54,FMN GV 11 Ramsel
66,Bergstraat 71,2020-09-05,19:00:00,46,16,30,FMN GV 11 Ramsel
66,Bergstraat 71,2020-09-05,20:00:00,40,20,20,FMN GV 11 Ramsel
66,Bergstraat 71,2020-09-05,21:00:00,22,16,6,FMN GV 11 Ramsel
66,Bergstraat 71,2020-09-05,22:00:00,8,6,2,FMN GV 11 Ramsel
66,Bergstraat 71,2020-09-05,23:00:00,12,10,2,FMN GV 11 Ramsel
66,Bergstraat 71,2020-09-06,00:00:00,12,10,2,FMN GV 11 Ramsel
66,Bergstraat 71,2020-09-06,01:00:00,8,8,0,FMN GV 11 Ramsel
66,Bergstraat 71,2020-09-06,02:00:00,6,0,6,FMN GV 11 Ramsel
66,Bergstraat 71,2020-09-06,03:00:00,4,2,2,FMN GV 11 Ramsel
66,Bergstraat 71,2020-09-06,04:00:00,0,0,0,FMN GV 11 Ramsel
66,Bergstraat 71,2020-09-06,05:00:00,6,2,4,FMN GV 11 Ramsel
66,Bergstraat 71,2020-09-06,06:00:00,4,2,2,FMN GV 11 Ramsel
66,Bergstraat 71,2020-09-06,07:00:00,22,2,20,FMN GV 11 Ramsel
66,Bergstraat 71,2020-09-06,08:00:00,90,36,54,FMN GV 11 Ramsel
66,Bergstraat 71,2020-09-06,09:00:00,202,50,152,FMN GV 11 Ramsel
66,Bergstraat 71,2020-09-06,10:00:00,308,142,166,FMN GV 11 Ramsel
66,Bergstraat 71,2020-09-06,11:00:00,248,148,100,FMN GV 11 Ramsel
66,Bergstraat 71,2020-09-06,12:00:00,190,114,76,FMN GV 11 Ramsel
66,Bergstraat 71,2020-09-06,13:00:00,312,144,168,FMN GV 11 Ramsel
66,Bergstraat 71,2020-09-06,14:00:00,306,176,130,FMN GV 11 Ramsel
66,Bergstraat 71,2020-09-06,15:00:00,222,128,94,FMN GV 11 Ramsel
66,Bergstraat 71,2020-09-06,16:00:00,158,78,80,FMN GV 11 Ramsel
66,Bergstraat 71,2020-09-06,17:00:00,140,78,62,FMN GV 11 Ramsel
66,Bergstraat 71,2020-09-06,18:00:00,94,50,44,FMN GV 11 Ramsel
66,Bergstraat 71,2020-09-06,19:00:00,48,22,26,FMN GV 11 Ramsel
66,Bergstraat 71,2020-09-06,20:00:00,50,22,28,FMN GV 11 Ramsel
66,Bergstraat 71,2020-09-06,21:00:00,6,6,0,FMN GV 11 Ramsel
66,Bergstraat 71,2020-09-06,22:00:00,2,2,0,FMN GV 11 Ramsel
66,Bergstraat 71,2020-09-06,23:00:00,2,2,0,FMN GV 11 Ramsel
66,Bergstraat 71,2020-09-07,00:00:00,0,0,0,FMN GV 11 Ramsel
66,Bergstraat 71,2020-09-07,01:00:00,0,0,0,FMN GV 11 Ramsel
66,Bergstraat 71,2020-09-07,02:00:00,0,0,0,FMN GV 11 Ramsel
66,Bergstraat 71,2020-09-07,03:00:00,0,0,0,FMN GV 11 Ramsel
66,Bergstraat 71,2020-09-07,04:00:00,4,2,2,FMN GV 11 Ramsel
66,Bergstraat 71,2020-09-07,05:00:00,10,6,4,FMN GV 11 Ramsel
66,Bergstraat 71,2020-09-07,06:00:00,34,18,16,FMN GV 11 Ramsel
66,Bergstraat 71,2020-09-07,07:00:00,268,14,254,FMN GV 11 Ramsel
66,Bergstraat 71,2020-09-07,08:00:00,198,24,174,FMN GV 11 Ramsel
66,Bergstraat 71,2020-09-07,09:00:00,78,30,48,FMN GV 11 Ramsel
66,Bergstraat 71,2020-09-07,10:00:00,48,22,26,FMN GV 11 Ramsel
66,Bergstraat 71,2020-09-07,11:00:00,76,36,40,FMN GV 11 Ramsel
66,Bergstraat 71,2020-09-07,12:00:00,146,72,74,FMN GV 11 Ramsel
66,Bergstraat 71,2020-09-07,13:00:00,200,98,102,FMN GV 11 Ramsel
66,Bergstraat 71,2020-09-07,14:00:00,238,104,134,FMN GV 11 Ramsel
66,Bergstraat 71,2020-09-07,15:00:00,386,324,62,FMN GV 11 Ramsel
66,Bergstraat 71,2020-09-07,16:00:00,266,190,76,FMN GV 11 Ramsel
66,Bergstraat 71,2020-09-07,17:00:00,144,80,64,FMN GV 11 Ramsel
66,Bergstraat 71,2020-09-07,18:00:00,104,48,56,FMN GV 11 Ramsel
66,Bergstraat 71,2020-09-07,19:00:00,56,26,30,FMN GV 11 Ramsel
66,Bergstraat 71,2020-09-07,20:00:00,38,22,16,FMN GV 11 Ramsel
66,Bergstraat 71,2020-09-07,21:00:00,20,12,8,FMN GV 11 Ramsel
66,Bergstraat 71,2020-09-07,22:00:00,20,8,12,FMN GV 11 Ramsel
66,Bergstraat 71,2020-09-07,23:00:00,2,2,0,FMN GV 11 Ramsel
66,Bergstraat 71,2020-09-08,00:00:00,0,0,0,FMN GV 11 Ramsel
66,Bergstraat 71,2020-09-08,01:00:00,0,0,0,FMN GV 11 Ramsel
66,Bergstraat 71,2020-09-08,02:00:00,0,0,0,FMN GV 11 Ramsel
66,Bergstraat 71,2020-09-08,03:00:00,0,0,0,FMN GV 11 Ramsel
66,Bergstraat 71,2020-09-08,04:00:00,6,4,2,FMN GV 11 Ramsel
66,Bergstraat 71,2020-09-08,05:00:00,6,4,2,FMN GV 11 Ramsel
66,Bergstraat 71,2020-09-08,06:00:00,36,16,20,FMN GV 11 Ramsel
66,Bergstraat 71,2020-09-08,07:00:00,286,26,260,FMN GV 11 Ramsel
66,Bergstraat 71,2020-09-08,08:00:00,202,24,178,FMN GV 11 Ramsel
66,Bergstraat 71,2020-09-08,09:00:00,80,28,52,FMN GV 11 Ramsel
66,Bergstraat 71,2020-09-08,10:00:00,82,38,44,FMN GV 11 Ramsel
66,Bergstraat 71,2020-09-08,11:00:00,116,42,74,FMN GV 11 Ramsel
66,Bergstraat 71,2020-09-08,12:00:00,102,54,48,FMN GV 11 Ramsel
66,Bergstraat 71,2020-09-08,13:00:00,266,138,128,FMN GV 11 Ramsel
66,Bergstraat 71,2020-09-08,14:00:00,142,96,46,FMN GV 11 Ramsel
66,Bergstraat 71,2020-09-08,15:00:00,314,254,60,FMN GV 11 Ramsel
66,Bergstraat 71,2020-09-08,16:00:00,296,222,74,FMN GV 11 Ramsel
66,Bergstraat 71,2020-09-08,17:00:00,132,64,68,FMN GV 11 Ramsel
66,Bergstraat 71,2020-09-08,18:00:00,90,50,40,FMN GV 11 Ramsel
66,Bergstraat 71,2020-09-08,19:00:00,62,30,32,FMN GV 11 Ramsel
66,Bergstraat 71,2020-09-08,20:00:00,48,30,18,FMN GV 11 Ramsel
66,Bergstraat 71,2020-09-08,21:00:00,12,10,2,FMN GV 11 Ramsel
66,Bergstraat 71,2020-09-08,22:00:00,14,2,12,FMN GV 11 Ramsel
66,Bergstraat 71,2020-09-08,23:00:00,2,2,0,FMN GV 11 Ramsel
66,Bergstraat 71,2020-09-09,00:00:00,6,6,0,FMN GV 11 Ramsel
66,Bergstraat 71,2020-09-09,01:00:00,0,0,0,FMN GV 11 Ramsel
66,Bergstraat 71,2020-09-09,02:00:00,0,0,0,FMN GV 11 Ramsel
66,Bergstraat 71,2020-09-09,03:00:00,0,0,0,FMN GV 11 Ramsel
66,Bergstraat 71,2020-09-09,04:00:00,4,0,4,FMN GV 11 Ramsel
66,Bergstraat 71,2020-09-09,05:00:00,8,4,4,FMN GV 11 Ramsel
66,Bergstraat 71,2020-09-09,06:00:00,28,12,16,FMN GV 11 Ramsel
66,Bergstraat 71,2020-09-09,07:00:00,258,40,218,FMN GV 11 Ramsel
66,Bergstraat 71,2020-09-09,08:00:00,198,18,180,FMN GV 11 Ramsel
66,Bergstraat 71,2020-09-09,09:00:00,62,26,36,FMN GV 11 Ramsel
66,Bergstraat 71,2020-09-09,10:00:00,64,30,34,FMN GV 11 Ramsel
66,Bergstraat 71,2020-09-09,11:00:00,70,48,22,FMN GV 11 Ramsel
66,Bergstraat 71,2020-09-09,12:00:00,324,270,54,FMN GV 11 Ramsel
66,Bergstraat 71,2020-09-09,13:00:00,120,56,64,FMN GV 11 Ramsel
66,Bergstraat 71,2020-09-09,14:00:00,210,104,106,FMN GV 11 Ramsel
66,Bergstraat 71,2020-09-09,15:00:00,182,120,62,FMN GV 11 Ramsel
66,Bergstraat 71,2020-09-09,16:00:00,154,78,76,FMN GV 11 Ramsel
66,Bergstraat 71,2020-09-09,17:00:00,128,74,54,FMN GV 11 Ramsel
66,Bergstraat 71,2020-09-09,18:00:00,80,44,36,FMN GV 11 Ramsel
66,Bergstraat 71,2020-09-09,19:00:00,84,56,28,FMN GV 11 Ramsel
66,Bergstraat 71,2020-09-09,20:00:00,68,46,22,FMN GV 11 Ramsel
66,Bergstraat 71,2020-09-09,21:00:00,30,18,12,FMN GV 11 Ramsel
66,Bergstraat 71,2020-09-09,22:00:00,20,8,12,FMN GV 11 Ramsel
66,Bergstraat 71,2020-09-09,23:00:00,4,4,0,FMN GV 11 Ramsel
66,Bergstraat 71,2020-09-10,00:00:00,2,2,0,FMN GV 11 Ramsel
66,Bergstraat 71,2020-09-10,01:00:00,0,0,0,FMN GV 11 Ramsel
66,Bergstraat 71,2020-09-10,02:00:00,0,0,0,FMN GV 11 Ramsel
66,Bergstraat 71,2020-09-10,03:00:00,0,0,0,FMN GV 11 Ramsel
66,Bergstraat 71,2020-09-10,04:00:00,6,4,2,FMN GV 11 Ramsel
66,Bergstraat 71,2020-09-10,05:00:00,8,4,4,FMN GV 11 Ramsel
66,Bergstraat 71,2020-09-10,06:00:00,40,12,28,FMN GV 11 Ramsel
66,Bergstraat 71,2020-09-10,07:00:00,264,22,242,FMN GV 11 Ramsel
66,Bergstraat 71,2020-09-10,08:00:00,230,44,186,FMN GV 11 Ramsel
66,Bergstraat 71,2020-09-10,09:00:00,92,22,70,FMN GV 11 Ramsel
66,Bergstraat 71,2020-09-10,10:00:00,108,50,58,FMN GV 11 Ramsel
66,Bergstraat 71,2020-09-10,11:00:00,104,40,64,FMN GV 11 Ramsel
66,Bergstraat 71,2020-09-10,12:00:00,130,86,44,FMN GV 11 Ramsel
66,Bergstraat 71,2020-09-10,13:00:00,212,104,108,FMN GV 11 Ramsel
66,Bergstraat 71,2020-09-10,14:00:00,222,120,102,FMN GV 11 Ramsel
66,Bergstraat 71,2020-09-10,15:00:00,400,310,90,FMN GV 11 Ramsel
66,Bergstraat 71,2020-09-10,16:00:00,318,242,76,FMN GV 11 Ramsel
66,Bergstraat 71,2020-09-10,17:00:00,156,104,52,FMN GV 11 Ramsel
66,Bergstraat 71,2020-09-10,18:00:00,156,76,80,FMN GV 11 Ramsel
66,Bergstraat 71,2020-09-10,19:00:00,104,50,54,FMN GV 11 Ramsel
66,Bergstraat 71,2020-09-10,20:00:00,70,50,20,FMN GV 11 Ramsel
66,Bergstraat 71,2020-09-10,21:00:00,16,12,4,FMN GV 11 Ramsel
66,Bergstraat 71,2020-09-10,22:00:00,18,12,6,FMN GV 11 Ramsel
66,Bergstraat 71,2020-09-10,23:00:00,0,0,0,FMN GV 11 Ramsel
66,Bergstraat 71,2020-09-11,00:00:00,6,4,2,FMN GV 11 Ramsel
66,Bergstraat 71,2020-09-11,01:00:00,2,0,2,FMN GV 11 Ramsel
66,Bergstraat 71,2020-09-11,02:00:00,0,0,0,FMN GV 11 Ramsel
66,Bergstraat 71,2020-09-11,03:00:00,0,0,0,FMN GV 11 Ramsel
66,Bergstraat 71,2020-09-11,04:00:00,4,2,2,FMN GV 11 Ramsel
66,Bergstraat 71,2020-09-11,05:00:00,8,4,4,FMN GV 11 Ramsel
66,Bergstraat 71,2020-09-11,06:00:00,40,18,22,FMN GV 11 Ramsel
66,Bergstraat 71,2020-09-11,07:00:00,266,28,238,FMN GV 11 Ramsel
66,Bergstraat 71,2020-09-11,08:00:00,202,30,172,FMN GV 11 Ramsel
66,Bergstraat 71,2020-09-11,09:00:00,64,22,42,FMN GV 11 Ramsel
66,Bergstraat 71,2020-09-11,10:00:00,88,44,44,FMN GV 11 Ramsel
66,Bergstraat 71,2020-09-11,11:00:00,114,54,60,FMN GV 11 Ramsel
66,Bergstraat 71,2020-09-11,12:00:00,132,56,76,FMN GV 11 Ramsel
66,Bergstraat 71,2020-09-11,13:00:00,220,82,138,FMN GV 11 Ramsel
66,Bergstraat 71,2020-09-11,14:00:00,214,102,112,FMN GV 11 Ramsel
66,Bergstraat 71,2020-09-11,15:00:00,432,320,112,FMN GV 11 Ramsel
66,Bergstraat 71,2020-09-11,16:00:00,296,234,62,FMN GV 11 Ramsel
66,Bergstraat 71,2020-09-11,17:00:00,192,120,72,FMN GV 11 Ramsel
66,Bergstraat 71,2020-09-11,18:00:00,102,56,46,FMN GV 11 Ramsel
66,Bergstraat 71,2020-09-11,19:00:00,114,64,50,FMN GV 11 Ramsel
66,Bergstraat 71,2020-09-11,20:00:00,34,10,24,FMN GV 11 Ramsel
66,Bergstraat 71,2020-09-11,21:00:00,28,18,10,FMN GV 11 Ramsel
66,Bergstraat 71,2020-09-11,22:00:00,14,10,4,FMN GV 11 Ramsel
66,Bergstraat 71,2020-09-11,23:00:00,8,4,4,FMN GV 11 Ramsel
66,Bergstraat 71,2020-09-12,00:00:00,4,4,0,FMN GV 11 Ramsel
66,Bergstraat 71,2020-09-12,01:00:00,14,10,4,FMN GV 11 Ramsel
66,Bergstraat 71,2020-09-12,02:00:00,8,8,0,FMN GV 11 Ramsel
66,Bergstraat 71,2020-09-12,03:00:00,4,0,4,FMN GV 11 Ramsel
66,Bergstraat 71,2020-09-12,04:00:00,0,0,0,FMN GV 11 Ramsel
66,Bergstraat 71,2020-09-12,05:00:00,4,2,2,FMN GV 11 Ramsel
66,Bergstraat 71,2020-09-12,06:00:00,4,2,2,FMN GV 11 Ramsel
66,Bergstraat 71,2020-09-12,07:00:00,28,12,16,FMN GV 11 Ramsel
66,Bergstraat 71,2020-09-12,08:00:00,26,6,20,FMN GV 11 Ramsel
66,Bergstraat 71,2020-09-12,09:00:00,110,38,72,FMN GV 11 Ramsel
66,Bergstraat 71,2020-09-12,10:00:00,124,62,62,FMN GV 11 Ramsel
66,Bergstraat 71,2020-09-12,11:00:00,164,66,98,FMN GV 11 Ramsel
66,Bergstraat 71,2020-09-12,12:00:00,182,82,100,FMN GV 11 Ramsel
66,Bergstraat 71,2020-09-12,13:00:00,290,124,166,FMN GV 11 Ramsel
66,Bergstraat 71,2020-09-12,14:00:00,290,164,126,FMN GV 11 Ramsel
66,Bergstraat 71,2020-09-12,15:00:00,296,158,138,FMN GV 11 Ramsel
66,Bergstraat 71,2020-09-12,16:00:00,302,168,134,FMN GV 11 Ramsel
66,Bergstraat 71,2020-09-12,17:00:00,126,54,72,FMN GV 11 Ramsel
66,Bergstraat 71,2020-09-12,18:00:00,120,52,68,FMN GV 11 Ramsel
66,Bergstraat 71,2020-09-12,19:00:00,92,40,52,FMN GV 11 Ramsel
66,Bergstraat 71,2020-09-12,20:00:00,52,30,22,FMN GV 11 Ramsel
66,Bergstraat 71,2020-09-12,21:00:00,40,22,18,FMN GV 11 Ramsel
66,Bergstraat 71,2020-09-12,22:00:00,12,2,10,FMN GV 11 Ramsel
66,Bergstraat 71,2020-09-12,23:00:00,20,8,12,FMN GV 11 Ramsel
66,Bergstraat 71,2020-09-13,00:00:00,2,0,2,FMN GV 11 Ramsel
66,Bergstraat 71,2020-09-13,01:00:00,10,6,4,FMN GV 11 Ramsel
66,Bergstraat 71,2020-09-13,02:00:00,2,2,0,FMN GV 11 Ramsel
66,Bergstraat 71,2020-09-13,03:00:00,8,2,6,FMN GV 11 Ramsel
66,Bergstraat 71,2020-09-13,04:00:00,2,0,2,FMN GV 11 Ramsel
66,Bergstraat 71,2020-09-13,05:00:00,14,10,4,FMN GV 11 Ramsel
66,Bergstraat 71,2020-09-13,06:00:00,2,0,2,FMN GV 11 Ramsel
66,Bergstraat 71,2020-09-13,07:00:00,32,10,22,FMN GV 11 Ramsel
66,Bergstraat 71,2020-09-13,08:00:00,150,38,112,FMN GV 11 Ramsel
66,Bergstraat 71,2020-09-13,09:00:00,176,58,118,FMN GV 11 Ramsel
66,Bergstraat 71,2020-09-13,10:00:00,304,144,160,FMN GV 11 Ramsel
66,Bergstraat 71,2020-09-13,11:00:00,296,176,120,FMN GV 11 Ramsel
66,Bergstraat 71,2020-09-13,12:00:00,244,118,126,FMN GV 11 Ramsel
66,Bergstraat 71,2020-09-13,13:00:00,374,200,174,FMN GV 11 Ramsel
66,Bergstraat 71,2020-09-13,14:00:00,472,252,220,FMN GV 11 Ramsel
66,Bergstraat 71,2020-09-13,15:00:00,366,218,148,FMN GV 11 Ramsel
66,Bergstraat 71,2020-09-13,16:00:00,348,208,140,FMN GV 11 Ramsel
66,Bergstraat 71,2020-09-13,17:00:00,214,82,132,FMN GV 11 Ramsel
66,Bergstraat 71,2020-09-13,18:00:00,154,68,86,FMN GV 11 Ramsel
66,Bergstraat 71,2020-09-13,19:00:00,68,38,30,FMN GV 11 Ramsel
66,Bergstraat 71,2020-09-13,20:00:00,30,16,14,FMN GV 11 Ramsel
66,Bergstraat 71,2020-09-13,21:00:00,16,14,2,FMN GV 11 Ramsel
66,Bergstraat 71,2020-09-13,22:00:00,6,6,0,FMN GV 11 Ramsel
66,Bergstraat 71,2020-09-13,23:00:00,2,0,2,FMN GV 11 Ramsel
66,Bergstraat 71,2020-09-14,00:00:00,0,0,0,FMN GV 11 Ramsel
66,Bergstraat 71,2020-09-14,01:00:00,0,0,0,FMN GV 11 Ramsel
66,Bergstraat 71,2020-09-14,02:00:00,0,0,0,FMN GV 11 Ramsel
66,Bergstraat 71,2020-09-14,03:00:00,0,0,0,FMN GV 11 Ramsel
66,Bergstraat 71,2020-09-14,04:00:00,6,4,2,FMN GV 11 Ramsel
66,Bergstraat 71,2020-09-14,05:00:00,8,6,2,FMN GV 11 Ramsel
66,Bergstraat 71,2020-09-14,06:00:00,48,20,28,FMN GV 11 Ramsel
66,Bergstraat 71,2020-09-14,07:00:00,290,26,264,FMN GV 11 Ramsel
66,Bergstraat 71,2020-09-14,08:00:00,220,44,176,FMN GV 11 Ramsel
66,Bergstraat 71,2020-09-14,09:00:00,52,20,32,FMN GV 11 Ramsel
66,Bergstraat 71,2020-09-14,10:00:00,92,44,48,FMN GV 11 Ramsel
66,Bergstraat 71,2020-09-14,11:00:00,132,50,82,FMN GV 11 Ramsel
66,Bergstraat 71,2020-09-14,12:00:00,154,76,78,FMN GV 11 Ramsel
66,Bergstraat 71,2020-09-14,13:00:00,254,130,124,FMN GV 11 Ramsel
66,Bergstraat 71,2020-09-14,14:00:00,276,144,132,FMN GV 11 Ramsel
66,Bergstraat 71,2020-09-14,15:00:00,450,336,114,FMN GV 11 Ramsel
66,Bergstraat 71,2020-09-14,16:00:00,268,194,74,FMN GV 11 Ramsel
66,Bergstraat 71,2020-09-14,17:00:00,168,112,56,FMN GV 11 Ramsel
66,Bergstraat 71,2020-09-14,18:00:00,168,104,64,FMN GV 11 Ramsel
66,Bergstraat 71,2020-09-14,19:00:00,122,78,44,FMN GV 11 Ramsel
66,Bergstraat 71,2020-09-14,20:00:00,68,28,40,FMN GV 11 Ramsel
66,Bergstraat 71,2020-09-14,21:00:00,26,14,12,FMN GV 11 Ramsel
66,Bergstraat 71,2020-09-14,22:00:00,20,18,2,FMN GV 11 Ramsel
66,Bergstraat 71,2020-09-14,23:00:00,2,0,2,FMN GV 11 Ramsel
66,Bergstraat 71,2020-09-15,00:00:00,2,2,0,FMN GV 11 Ramsel
66,Bergstraat 71,2020-09-15,01:00:00,4,4,0,FMN GV 11 Ramsel
66,Bergstraat 71,2020-09-15,02:00:00,0,0,0,FMN GV 11 Ramsel
66,Bergstraat 71,2020-09-15,03:00:00,0,0,0,FMN GV 11 Ramsel
66,Bergstraat 71,2020-09-15,04:00:00,10,6,4,FMN GV 11 Ramsel
66,Bergstraat 71,2020-09-15,05:00:00,24,12,12,FMN GV 11 Ramsel
66,Bergstraat 71,2020-09-15,06:00:00,38,14,24,FMN GV 11 Ramsel
66,Bergstraat 71,2020-09-15,07:00:00,258,34,224,FMN GV 11 Ramsel
66,Bergstraat 71,2020-09-15,08:00:00,244,20,224,FMN GV 11 Ramsel
66,Bergstraat 71,2020-09-15,09:00:00,86,36,50,FMN GV 11 Ramsel
66,Bergstraat 71,2020-09-15,10:00:00,186,66,120,FMN GV 11 Ramsel
66,Bergstraat 71,2020-09-15,11:00:00,186,70,116,FMN GV 11 Ramsel
66,Bergstraat 71,2020-09-15,12:00:00,178,102,76,FMN GV 11 Ramsel
66,Bergstraat 71,2020-09-15,13:00:00,256,92,164,FMN GV 11 Ramsel
66,Bergstraat 71,2020-09-15,14:00:00,268,172,96,FMN GV 11 Ramsel
66,Bergstraat 71,2020-09-15,15:00:00,464,342,122,FMN GV 11 Ramsel
66,Bergstraat 71,2020-09-15,16:00:00,294,206,88,FMN GV 11 Ramsel
66,Bergstraat 71,2020-09-15,17:00:00,172,96,76,FMN GV 11 Ramsel
66,Bergstraat 71,2020-09-15,18:00:00,182,98,84,FMN GV 11 Ramsel
66,Bergstraat 71,2020-09-15,19:00:00,120,74,46,FMN GV 11 Ramsel
66,Bergstraat 71,2020-09-15,20:00:00,64,42,22,FMN GV 11 Ramsel
66,Bergstraat 71,2020-09-15,21:00:00,22,16,6,FMN GV 11 Ramsel
66,Bergstraat 71,2020-09-15,22:00:00,22,10,12,FMN GV 11 Ramsel
66,Bergstraat 71,2020-09-15,23:00:00,10,2,8,FMN GV 11 Ramsel
66,Bergstraat 71,2020-09-16,00:00:00,6,2,4,FMN GV 11 Ramsel
66,Bergstraat 71,2020-09-16,01:00:00,10,6,4,FMN GV 11 Ramsel
66,Bergstraat 71,2020-09-16,02:00:00,2,2,0,FMN GV 11 Ramsel
66,Bergstraat 71,2020-09-16,03:00:00,0,0,0,FMN GV 11 Ramsel
66,Bergstraat 71,2020-09-16,04:00:00,4,4,0,FMN GV 11 Ramsel
66,Bergstraat 71,2020-09-16,05:00:00,22,10,12,FMN GV 11 Ramsel
66,Bergstraat 71,2020-09-16,06:00:00,36,8,28,FMN GV 11 Ramsel
66,Bergstraat 71,2020-09-16,07:00:00,288,32,256,FMN GV 11 Ramsel
66,Bergstraat 71,2020-09-16,08:00:00,206,34,172,FMN GV 11 Ramsel
66,Bergstraat 71,2020-09-16,09:00:00,114,40,74,FMN GV 11 Ramsel
66,Bergstraat 71,2020-09-16,10:00:00,138,74,64,FMN GV 11 Ramsel
66,Bergstraat 71,2020-09-16,11:00:00,150,62,88,FMN GV 11 Ramsel
66,Bergstraat 71,2020-09-16,12:00:00,352,280,72,FMN GV 11 Ramsel
66,Bergstraat 71,2020-09-16,13:00:00,266,142,124,FMN GV 11 Ramsel
66,Bergstraat 71,2020-09-16,14:00:00,288,148,140,FMN GV 11 Ramsel
66,Bergstraat 71,2020-09-16,15:00:00,232,122,110,FMN GV 11 Ramsel
66,Bergstraat 71,2020-09-16,16:00:00,190,98,92,FMN GV 11 Ramsel
66,Bergstraat 71,2020-09-16,17:00:00,212,126,86,FMN GV 11 Ramsel
66,Bergstraat 71,2020-09-16,18:00:00,130,76,54,FMN GV 11 Ramsel
66,Bergstraat 71,2020-09-16,19:00:00,136,68,68,FMN GV 11 Ramsel
66,Bergstraat 71,2020-09-16,20:00:00,68,44,24,FMN GV 11 Ramsel
66,Bergstraat 71,2020-09-16,21:00:00,24,8,16,FMN GV 11 Ramsel
66,Bergstraat 71,2020-09-16,22:00:00,18,8,10,FMN GV 11 Ramsel
66,Bergstraat 71,2020-09-16,23:00:00,10,8,2,FMN GV 11 Ramsel
66,Bergstraat 71,2020-09-17,00:00:00,0,0,0,FMN GV 11 Ramsel
66,Bergstraat 71,2020-09-17,01:00:00,8,6,2,FMN GV 11 Ramsel
66,Bergstraat 71,2020-09-17,02:00:00,0,0,0,FMN GV 11 Ramsel
66,Bergstraat 71,2020-09-17,03:00:00,2,0,2,FMN GV 11 Ramsel
66,Bergstraat 71,2020-09-17,04:00:00,4,4,0,FMN GV 11 Ramsel
66,Bergstraat 71,2020-09-17,05:00:00,16,8,8,FMN GV 11 Ramsel
66,Bergstraat 71,2020-09-17,06:00:00,30,8,22,FMN GV 11 Ramsel
66,Bergstraat 71,2020-09-17,07:00:00,252,28,224,FMN GV 11 Ramsel
66,Bergstraat 71,2020-09-17,08:00:00,186,30,156,FMN GV 11 Ramsel
66,Bergstraat 71,2020-09-17,09:00:00,112,46,66,FMN GV 11 Ramsel
66,Bergstraat 71,2020-09-17,10:00:00,146,44,102,FMN GV 11 Ramsel
66,Bergstraat 71,2020-09-17,11:00:00,136,76,60,FMN GV 11 Ramsel
66,Bergstraat 71,2020-09-17,12:00:00,114,58,56,FMN GV 11 Ramsel
66,Bergstraat 71,2020-09-17,13:00:00,186,72,114,FMN GV 11 Ramsel
66,Bergstraat 71,2020-09-17,14:00:00,192,122,70,FMN GV 11 Ramsel
66,Bergstraat 71,2020-09-17,15:00:00,312,226,86,FMN GV 11 Ramsel
66,Bergstraat 71,2020-09-17,16:00:00,232,158,74,FMN GV 11 Ramsel
66,Bergstraat 71,2020-09-17,17:00:00,174,100,74,FMN GV 11 Ramsel
66,Bergstraat 71,2020-09-17,18:00:00,174,92,82,FMN GV 11 Ramsel
66,Bergstraat 71,2020-09-17,19:00:00,82,48,34,FMN GV 11 Ramsel
66,Bergstraat 71,2020-09-17,20:00:00,52,30,22,FMN GV 11 Ramsel
66,Bergstraat 71,2020-09-17,21:00:00,12,10,2,FMN GV 11 Ramsel
66,Bergstraat 71,2020-09-17,22:00:00,14,12,2,FMN GV 11 Ramsel
66,Bergstraat 71,2020-09-17,23:00:00,8,6,2,FMN GV 11 Ramsel
66,Bergstraat 71,2020-09-18,00:00:00,2,0,2,FMN GV 11 Ramsel
66,Bergstraat 71,2020-09-18,01:00:00,0,0,0,FMN GV 11 Ramsel
66,Bergstraat 71,2020-09-18,02:00:00,0,0,0,FMN GV 11 Ramsel
66,Bergstraat 71,2020-09-18,03:00:00,0,0,0,FMN GV 11 Ramsel
66,Bergstraat 71,2020-09-18,04:00:00,4,4,0,FMN GV 11 Ramsel
66,Bergstraat 71,2020-09-18,05:00:00,16,8,8,FMN GV 11 Ramsel
66,Bergstraat 71,2020-09-18,06:00:00,36,12,24,FMN GV 11 Ramsel
66,Bergstraat 71,2020-09-18,07:00:00,244,24,220,FMN GV 11 Ramsel
66,Bergstraat 71,2020-09-18,08:00:00,222,34,188,FMN GV 11 Ramsel
66,Bergstraat 71,2020-09-18,09:00:00,94,32,62,FMN GV 11 Ramsel
66,Bergstraat 71,2020-09-18,10:00:00,60,36,24,FMN GV 11 Ramsel
66,Bergstraat 71,2020-09-18,11:00:00,126,46,80,FMN GV 11 Ramsel
66,Bergstraat 71,2020-09-18,12:00:00,118,78,40,FMN GV 11 Ramsel
66,Bergstraat 71,2020-09-18,13:00:00,138,90,48,FMN GV 11 Ramsel
66,Bergstraat 71,2020-09-18,14:00:00,250,126,124,FMN GV 11 Ramsel
66,Bergstraat 71,2020-09-18,15:00:00,382,282,100,FMN GV 11 Ramsel
66,Bergstraat 71,2020-09-18,16:00:00,306,198,108,FMN GV 11 Ramsel
66,Bergstraat 71,2020-09-18,17:00:00,164,102,62,FMN GV 11 Ramsel
66,Bergstraat 71,2020-09-18,18:00:00,140,76,64,FMN GV 11 Ramsel
66,Bergstraat 71,2020-09-18,19:00:00,88,46,42,FMN GV 11 Ramsel
66,Bergstraat 71,2020-09-18,20:00:00,54,26,28,FMN GV 11 Ramsel
66,Bergstraat 71,2020-09-18,21:00:00,32,6,26,FMN GV 11 Ramsel
66,Bergstraat 71,2020-09-18,22:00:00,12,2,10,FMN GV 11 Ramsel
66,Bergstraat 71,2020-09-18,23:00:00,4,2,2,FMN GV 11 Ramsel
66,Bergstraat 71,2020-09-19,00:00:00,12,10,2,FMN GV 11 Ramsel
66,Bergstraat 71,2020-09-19,01:00:00,24,22,2,FMN GV 11 Ramsel
66,Bergstraat 71,2020-09-19,02:00:00,4,0,4,FMN GV 11 Ramsel
66,Bergstraat 71,2020-09-19,03:00:00,16,6,10,FMN GV 11 Ramsel
66,Bergstraat 71,2020-09-19,04:00:00,0,0,0,FMN GV 11 Ramsel
66,Bergstraat 71,2020-09-19,05:00:00,0,0,0,FMN GV 11 Ramsel
66,Bergstraat 71,2020-09-19,06:00:00,4,4,0,FMN GV 11 Ramsel
66,Bergstraat 71,2020-09-19,07:00:00,14,8,6,FMN GV 11 Ramsel
66,Bergstraat 71,2020-09-19,08:00:00,50,18,32,FMN GV 11 Ramsel
66,Bergstraat 71,2020-09-19,09:00:00,78,28,50,FMN GV 11 Ramsel
66,Bergstraat 71,2020-09-19,10:00:00,114,46,68,FMN GV 11 Ramsel
66,Bergstraat 71,2020-09-19,11:00:00,168,94,74,FMN GV 11 Ramsel
66,Bergstraat 71,2020-09-19,12:00:00,234,126,108,FMN GV 11 Ramsel
66,Bergstraat 71,2020-09-19,13:00:00,320,128,192,FMN GV 11 Ramsel
66,Bergstraat 71,2020-09-19,14:00:00,336,174,162,FMN GV 11 Ramsel
66,Bergstraat 71,2020-09-19,15:00:00,360,184,176,FMN GV 11 Ramsel
66,Bergstraat 71,2020-09-19,16:00:00,266,164,102,FMN GV 11 Ramsel
66,Bergstraat 71,2020-09-19,17:00:00,196,82,114,FMN GV 11 Ramsel
66,Bergstraat 71,2020-09-19,18:00:00,140,66,74,FMN GV 11 Ramsel
66,Bergstraat 71,2020-09-19,19:00:00,100,42,58,FMN GV 11 Ramsel
66,Bergstraat 71,2020-09-19,20:00:00,68,22,46,FMN GV 11 Ramsel
66,Bergstraat 71,2020-09-19,21:00:00,18,14,4,FMN GV 11 Ramsel
66,Bergstraat 71,2020-09-19,22:00:00,18,10,8,FMN GV 11 Ramsel
66,Bergstraat 71,2020-09-19,23:00:00,18,16,2,FMN GV 11 Ramsel
66,Bergstraat 71,2020-09-20,00:00:00,24,20,4,FMN GV 11 Ramsel
66,Bergstraat 71,2020-09-20,01:00:00,10,10,0,FMN GV 11 Ramsel
66,Bergstraat 71,2020-09-20,02:00:00,12,10,2,FMN GV 11 Ramsel
66,Bergstraat 71,2020-09-20,03:00:00,4,4,0,FMN GV 11 Ramsel
66,Bergstraat 71,2020-09-20,04:00:00,0,0,0,FMN GV 11 Ramsel
66,Bergstraat 71,2020-09-20,05:00:00,6,2,4,FMN GV 11 Ramsel
66,Bergstraat 71,2020-09-20,06:00:00,4,2,2,FMN GV 11 Ramsel
66,Bergstraat 71,2020-09-20,07:00:00,16,10,6,FMN GV 11 Ramsel
66,Bergstraat 71,2020-09-20,08:00:00,102,26,76,FMN GV 11 Ramsel
66,Bergstraat 71,2020-09-20,09:00:00,218,78,140,FMN GV 11 Ramsel
66,Bergstraat 71,2020-09-20,10:00:00,270,130,140,FMN GV 11 Ramsel
66,Bergstraat 71,2020-09-20,11:00:00,312,164,148,FMN GV 11 Ramsel
66,Bergstraat 71,2020-09-20,12:00:00,214,90,124,FMN GV 11 Ramsel
66,Bergstraat 71,2020-09-20,13:00:00,346,194,152,FMN GV 11 Ramsel
66,Bergstraat 71,2020-09-20,14:00:00,524,270,254,FMN GV 11 Ramsel
66,Bergstraat 71,2020-09-20,15:00:00,436,196,240,FMN GV 11 Ramsel
66,Bergstraat 71,2020-09-20,16:00:00,488,256,232,FMN GV 11 Ramsel
66,Bergstraat 71,2020-09-20,17:00:00,266,132,134,FMN GV 11 Ramsel
66,Bergstraat 71,2020-09-20,18:00:00,152,80,72,FMN GV 11 Ramsel
66,Bergstraat 71,2020-09-20,19:00:00,134,66,68,FMN GV 11 Ramsel
66,Bergstraat 71,2020-09-20,20:00:00,44,24,20,FMN GV 11 Ramsel
66,Bergstraat 71,2020-09-20,21:00:00,14,12,2,FMN GV 11 Ramsel
66,Bergstraat 71,2020-09-20,22:00:00,6,2,4,FMN GV 11 Ramsel
66,Bergstraat 71,2020-09-20,23:00:00,0,0,0,FMN GV 11 Ramsel
66,Bergstraat 71,2020-09-21,00:00:00,6,4,2,FMN GV 11 Ramsel
66,Bergstraat 71,2020-09-21,01:00:00,2,0,2,FMN GV 11 Ramsel
66,Bergstraat 71,2020-09-21,02:00:00,0,0,0,FMN GV 11 Ramsel
66,Bergstraat 71,2020-09-21,03:00:00,0,0,0,FMN GV 11 Ramsel
66,Bergstraat 71,2020-09-21,04:00:00,8,4,4,FMN GV 11 Ramsel
66,Bergstraat 71,2020-09-21,05:00:00,12,8,4,FMN GV 11 Ramsel
66,Bergstraat 71,2020-09-21,06:00:00,42,12,30,FMN GV 11 Ramsel
66,Bergstraat 71,2020-09-21,07:00:00,276,34,242,FMN GV 11 Ramsel
66,Bergstraat 71,2020-09-21,08:00:00,212,30,182,FMN GV 11 Ramsel
66,Bergstraat 71,2020-09-21,09:00:00,80,42,38,FMN GV 11 Ramsel
66,Bergstraat 71,2020-09-21,10:00:00,90,40,50,FMN GV 11 Ramsel
66,Bergstraat 71,2020-09-21,11:00:00,100,48,52,FMN GV 11 Ramsel
66,Bergstraat 71,2020-09-21,12:00:00,138,56,82,FMN GV 11 Ramsel
66,Bergstraat 71,2020-09-21,13:00:00,208,88,120,FMN GV 11 Ramsel
66,Bergstraat 71,2020-09-21,14:00:00,304,184,120,FMN GV 11 Ramsel
66,Bergstraat 71,2020-09-21,15:00:00,414,322,92,FMN GV 11 Ramsel
66,Bergstraat 71,2020-09-21,16:00:00,296,212,84,FMN GV 11 Ramsel
66,Bergstraat 71,2020-09-21,17:00:00,184,94,90,FMN GV 11 Ramsel
66,Bergstraat 71,2020-09-21,18:00:00,142,68,74,FMN GV 11 Ramsel
66,Bergstraat 71,2020-09-21,19:00:00,94,48,46,FMN GV 11 Ramsel
66,Bergstraat 71,2020-09-21,20:00:00,34,20,14,FMN GV 11 Ramsel
66,Bergstraat 71,2020-09-21,21:00:00,24,6,18,FMN GV 11 Ramsel
66,Bergstraat 71,2020-09-21,22:00:00,14,8,6,FMN GV 11 Ramsel
66,Bergstraat 71,2020-09-21,23:00:00,0,0,0,FMN GV 11 Ramsel
66,Bergstraat 71,2020-09-22,00:00:00,0,0,0,FMN GV 11 Ramsel
66,Bergstraat 71,2020-09-22,01:00:00,0,0,0,FMN GV 11 Ramsel
66,Bergstraat 71,2020-09-22,02:00:00,0,0,0,FMN GV 11 Ramsel
66,Bergstraat 71,2020-09-22,03:00:00,0,0,0,FMN GV 11 Ramsel
66,Bergstraat 71,2020-09-22,04:00:00,12,8,4,FMN GV 11 Ramsel
66,Bergstraat 71,2020-09-22,05:00:00,12,2,10,FMN GV 11 Ramsel
66,Bergstraat 71,2020-09-22,06:00:00,40,8,32,FMN GV 11 Ramsel
66,Bergstraat 71,2020-09-22,07:00:00,280,36,244,FMN GV 11 Ramsel
66,Bergstraat 71,2020-09-22,08:00:00,194,28,166,FMN GV 11 Ramsel
66,Bergstraat 71,2020-09-22,09:00:00,62,20,42,FMN GV 11 Ramsel
66,Bergstraat 71,2020-09-22,10:00:00,66,40,26,FMN GV 11 Ramsel
66,Bergstraat 71,2020-09-22,11:00:00,112,42,70,FMN GV 11 Ramsel
66,Bergstraat 71,2020-09-22,12:00:00,154,54,100,FMN GV 11 Ramsel
66,Bergstraat 71,2020-09-22,13:00:00,250,116,134,FMN GV 11 Ramsel
66,Bergstraat 71,2020-09-22,14:00:00,256,142,114,FMN GV 11 Ramsel
66,Bergstraat 71,2020-09-22,15:00:00,430,318,112,FMN GV 11 Ramsel
66,Bergstraat 71,2020-09-22,16:00:00,342,226,116,FMN GV 11 Ramsel
66,Bergstraat 71,2020-09-22,17:00:00,300,162,138,FMN GV 11 Ramsel
66,Bergstraat 71,2020-09-22,18:00:00,156,96,60,FMN GV 11 Ramsel
66,Bergstraat 71,2020-09-22,19:00:00,120,54,66,FMN GV 11 Ramsel
66,Bergstraat 71,2020-09-22,20:00:00,62,54,8,FMN GV 11 Ramsel
66,Bergstraat 71,2020-09-22,21:00:00,48,36,12,FMN GV 11 Ramsel
66,Bergstraat 71,2020-09-22,22:00:00,18,8,10,FMN GV 11 Ramsel
66,Bergstraat 71,2020-09-22,23:00:00,0,0,0,FMN GV 11 Ramsel
66,Bergstraat 71,2020-09-23,00:00:00,2,2,0,FMN GV 11 Ramsel
66,Bergstraat 71,2020-09-23,01:00:00,0,0,0,FMN GV 11 Ramsel
66,Bergstraat 71,2020-09-23,02:00:00,0,0,0,FMN GV 11 Ramsel
66,Bergstraat 71,2020-09-23,03:00:00,0,0,0,FMN GV 11 Ramsel
66,Bergstraat 71,2020-09-23,04:00:00,12,6,6,FMN GV 11 Ramsel
66,Bergstraat 71,2020-09-23,05:00:00,10,2,8,FMN GV 11 Ramsel
66,Bergstraat 71,2020-09-23,06:00:00,32,14,18,FMN GV 11 Ramsel
66,Bergstraat 71,2020-09-23,07:00:00,260,32,228,FMN GV 11 Ramsel
66,Bergstraat 71,2020-09-23,08:00:00,208,22,186,FMN GV 11 Ramsel
66,Bergstraat 71,2020-09-23,09:00:00,58,30,28,FMN GV 11 Ramsel
66,Bergstraat 71,2020-09-23,10:00:00,58,20,38,FMN GV 11 Ramsel
66,Bergstraat 71,2020-09-23,11:00:00,88,54,34,FMN GV 11 Ramsel
66,Bergstraat 71,2020-09-23,12:00:00,344,294,50,FMN GV 11 Ramsel
66,Bergstraat 71,2020-09-23,13:00:00,126,54,72,FMN GV 11 Ramsel
66,Bergstraat 71,2020-09-23,14:00:00,134,58,76,FMN GV 11 Ramsel
66,Bergstraat 71,2020-09-23,15:00:00,132,66,66,FMN GV 11 Ramsel
66,Bergstraat 71,2020-09-23,16:00:00,150,58,92,FMN GV 11 Ramsel
66,Bergstraat 71,2020-09-23,17:00:00,134,98,36,FMN GV 11 Ramsel
66,Bergstraat 71,2020-09-23,18:00:00,104,46,58,FMN GV 11 Ramsel
66,Bergstraat 71,2020-09-23,19:00:00,54,32,22,FMN GV 11 Ramsel
66,Bergstraat 71,2020-09-23,20:00:00,38,26,12,FMN GV 11 Ramsel
66,Bergstraat 71,2020-09-23,21:00:00,6,2,4,FMN GV 11 Ramsel
66,Bergstraat 71,2020-09-23,22:00:00,12,4,8,FMN GV 11 Ramsel
66,Bergstraat 71,2020-09-23,23:00:00,4,4,0,FMN GV 11 Ramsel
66,Bergstraat 71,2020-09-24,00:00:00,0,0,0,FMN GV 11 Ramsel
66,Bergstraat 71,2020-09-24,01:00:00,2,2,0,FMN GV 11 Ramsel
66,Bergstraat 71,2020-09-24,02:00:00,2,2,0,FMN GV 11 Ramsel
66,Bergstraat 71,2020-09-24,03:00:00,2,0,2,FMN GV 11 Ramsel
66,Bergstraat 71,2020-09-24,04:00:00,6,6,0,FMN GV 11 Ramsel
66,Bergstraat 71,2020-09-24,05:00:00,8,6,2,FMN GV 11 Ramsel
66,Bergstraat 71,2020-09-24,06:00:00,34,10,24,FMN GV 11 Ramsel
66,Bergstraat 71,2020-09-24,07:00:00,234,34,200,FMN GV 11 Ramsel
66,Bergstraat 71,2020-09-24,08:00:00,176,18,158,FMN GV 11 Ramsel
66,Bergstraat 71,2020-09-24,09:00:00,74,28,46,FMN GV 11 Ramsel
66,Bergstraat 71,2020-09-24,10:00:00,48,26,22,FMN GV 11 Ramsel
66,Bergstraat 71,2020-09-24,11:00:00,68,34,34,FMN GV 11 Ramsel
66,Bergstraat 71,2020-09-24,12:00:00,64,42,22,FMN GV 11 Ramsel
66,Bergstraat 71,2020-09-24,13:00:00,96,64,32,FMN GV 11 Ramsel
66,Bergstraat 71,2020-09-24,14:00:00,104,50,54,FMN GV 11 Ramsel
66,Bergstraat 71,2020-09-24,15:00:00,272,234,38,FMN GV 11 Ramsel
66,Bergstraat 71,2020-09-24,16:00:00,158,128,30,FMN GV 11 Ramsel
66,Bergstraat 71,2020-09-24,17:00:00,58,40,18,FMN GV 11 Ramsel
66,Bergstraat 71,2020-09-24,18:00:00,46,30,16,FMN GV 11 Ramsel
66,Bergstraat 71,2020-09-24,19:00:00,38,16,22,FMN GV 11 Ramsel
66,Bergstraat 71,2020-09-24,20:00:00,10,6,4,FMN GV 11 Ramsel
66,Bergstraat 71,2020-09-24,21:00:00,16,14,2,FMN GV 11 Ramsel
66,Bergstraat 71,2020-09-24,22:00:00,14,4,10,FMN GV 11 Ramsel
66,Bergstraat 71,2020-09-24,23:00:00,0,0,0,FMN GV 11 Ramsel
66,Bergstraat 71,2020-09-25,00:00:00,4,2,2,FMN GV 11 Ramsel
66,Bergstraat 71,2020-09-25,01:00:00,0,0,0,FMN GV 11 Ramsel
66,Bergstraat 71,2020-09-25,02:00:00,0,0,0,FMN GV 11 Ramsel
66,Bergstraat 71,2020-09-25,03:00:00,2,2,0,FMN GV 11 Ramsel
66,Bergstraat 71,2020-09-25,04:00:00,6,2,4,FMN GV 11 Ramsel
66,Bergstraat 71,2020-09-25,05:00:00,10,8,2,FMN GV 11 Ramsel
66,Bergstraat 71,2020-09-25,06:00:00,22,8,14,FMN GV 11 Ramsel
66,Bergstraat 71,2020-09-25,07:00:00,178,6,172,FMN GV 11 Ramsel
66,Bergstraat 71,2020-09-25,08:00:00,140,16,124,FMN GV 11 Ramsel
66,Bergstraat 71,2020-09-25,09:00:00,48,26,22,FMN GV 11 Ramsel
66,Bergstraat 71,2020-09-25,10:00:00,38,18,20,FMN GV 11 Ramsel
66,Bergstraat 71,2020-09-25,11:00:00,50,26,24,FMN GV 11 Ramsel
66,Bergstraat 71,2020-09-25,12:00:00,50,38,12,FMN GV 11 Ramsel
66,Bergstraat 71,2020-09-25,13:00:00,28,20,8,FMN GV 11 Ramsel
66,Bergstraat 71,2020-09-25,14:00:00,62,44,18,FMN GV 11 Ramsel
66,Bergstraat 71,2020-09-25,15:00:00,202,194,8,FMN GV 11 Ramsel
66,Bergstraat 71,2020-09-25,16:00:00,62,52,10,FMN GV 11 Ramsel
66,Bergstraat 71,2020-09-25,17:00:00,38,30,8,FMN GV 11 Ramsel
66,Bergstraat 71,2020-09-25,18:00:00,18,16,2,FMN GV 11 Ramsel
66,Bergstraat 71,2020-09-25,19:00:00,30,16,14,FMN GV 11 Ramsel
66,Bergstraat 71,2020-09-25,20:00:00,20,6,14,FMN GV 11 Ramsel
66,Bergstraat 71,2020-09-25,21:00:00,2,2,0,FMN GV 11 Ramsel
66,Bergstraat 71,2020-09-25,22:00:00,4,0,4,FMN GV 11 Ramsel
66,Bergstraat 71,2020-09-25,23:00:00,2,0,2,FMN GV 11 Ramsel
66,Bergstraat 71,2020-09-26,00:00:00,2,2,0,FMN GV 11 Ramsel
66,Bergstraat 71,2020-09-26,01:00:00,2,2,0,FMN GV 11 Ramsel
66,Bergstraat 71,2020-09-26,02:00:00,0,0,0,FMN GV 11 Ramsel
66,Bergstraat 71,2020-09-26,03:00:00,0,0,0,FMN GV 11 Ramsel
66,Bergstraat 71,2020-09-26,04:00:00,0,0,0,FMN GV 11 Ramsel
66,Bergstraat 71,2020-09-26,05:00:00,0,0,0,FMN GV 11 Ramsel
66,Bergstraat 71,2020-09-26,06:00:00,2,0,2,FMN GV 11 Ramsel
66,Bergstraat 71,2020-09-26,07:00:00,10,6,4,FMN GV 11 Ramsel
66,Bergstraat 71,2020-09-26,08:00:00,22,4,18,FMN GV 11 Ramsel
66,Bergstraat 71,2020-09-26,09:00:00,42,18,24,FMN GV 11 Ramsel
66,Bergstraat 71,2020-09-26,10:00:00,70,26,44,FMN GV 11 Ramsel
66,Bergstraat 71,2020-09-26,11:00:00,50,28,22,FMN GV 11 Ramsel
66,Bergstraat 71,2020-09-26,12:00:00,52,26,26,FMN GV 11 Ramsel
66,Bergstraat 71,2020-09-26,13:00:00,62,44,18,FMN GV 11 Ramsel
66,Bergstraat 71,2020-09-26,14:00:00,84,46,38,FMN GV 11 Ramsel
66,Bergstraat 71,2020-09-26,15:00:00,118,56,62,FMN GV 11 Ramsel
66,Bergstraat 71,2020-09-26,16:00:00,64,38,26,FMN GV 11 Ramsel
66,Bergstraat 71,2020-09-26,17:00:00,30,14,16,FMN GV 11 Ramsel
66,Bergstraat 71,2020-09-26,18:00:00,24,12,12,FMN GV 11 Ramsel
66,Bergstraat 71,2020-09-26,19:00:00,18,8,10,FMN GV 11 Ramsel
66,Bergstraat 71,2020-09-26,20:00:00,10,2,8,FMN GV 11 Ramsel
66,Bergstraat 71,2020-09-26,21:00:00,6,4,2,FMN GV 11 Ramsel
66,Bergstraat 71,2020-09-26,22:00:00,0,0,0,FMN GV 11 Ramsel
66,Bergstraat 71,2020-09-26,23:00:00,6,4,2,FMN GV 11 Ramsel
66,Bergstraat 71,2020-09-27,00:00:00,0,0,0,FMN GV 11 Ramsel
66,Bergstraat 71,2020-09-27,01:00:00,2,2,0,FMN GV 11 Ramsel
66,Bergstraat 71,2020-09-27,02:00:00,2,2,0,FMN GV 11 Ramsel
66,Bergstraat 71,2020-09-27,03:00:00,0,0,0,FMN GV 11 Ramsel
66,Bergstraat 71,2020-09-27,04:00:00,0,0,0,FMN GV 11 Ramsel
66,Bergstraat 71,2020-09-27,05:00:00,0,0,0,FMN GV 11 Ramsel
66,Bergstraat 71,2020-09-27,06:00:00,0,0,0,FMN GV 11 Ramsel
66,Bergstraat 71,2020-09-27,07:00:00,12,6,6,FMN GV 11 Ramsel
66,Bergstraat 71,2020-09-27,08:00:00,34,10,24,FMN GV 11 Ramsel
66,Bergstraat 71,2020-09-27,09:00:00,58,26,32,FMN GV 11 Ramsel
66,Bergstraat 71,2020-09-27,10:00:00,54,22,32,FMN GV 11 Ramsel
66,Bergstraat 71,2020-09-27,11:00:00,56,42,14,FMN GV 11 Ramsel
66,Bergstraat 71,2020-09-27,12:00:00,46,24,22,FMN GV 11 Ramsel
66,Bergstraat 71,2020-09-27,13:00:00,130,84,46,FMN GV 11 Ramsel
66,Bergstraat 71,2020-09-27,14:00:00,116,64,52,FMN GV 11 Ramsel
66,Bergstraat 71,2020-09-27,15:00:00,82,46,36,FMN GV 11 Ramsel
66,Bergstraat 71,2020-09-27,16:00:00,48,32,16,FMN GV 11 Ramsel
66,Bergstraat 71,2020-09-27,17:00:00,66,32,34,FMN GV 11 Ramsel
66,Bergstraat 71,2020-09-27,18:00:00,40,16,24,FMN GV 11 Ramsel
66,Bergstraat 71,2020-09-27,19:00:00,24,6,18,FMN GV 11 Ramsel
66,Bergstraat 71,2020-09-27,20:00:00,16,6,10,FMN GV 11 Ramsel
66,Bergstraat 71,2020-09-27,21:00:00,10,8,2,FMN GV 11 Ramsel
66,Bergstraat 71,2020-09-27,22:00:00,6,4,2,FMN GV 11 Ramsel
66,Bergstraat 71,2020-09-27,23:00:00,0,0,0,FMN GV 11 Ramsel
66,Bergstraat 71,2020-09-28,00:00:00,0,0,0,FMN GV 11 Ramsel
66,Bergstraat 71,2020-09-28,01:00:00,0,0,0,FMN GV 11 Ramsel
66,Bergstraat 71,2020-09-28,02:00:00,0,0,0,FMN GV 11 Ramsel
66,Bergstraat 71,2020-09-28,03:00:00,0,0,0,FMN GV 11 Ramsel
66,Bergstraat 71,2020-09-28,04:00:00,2,2,0,FMN GV 11 Ramsel
66,Bergstraat 71,2020-09-28,05:00:00,6,4,2,FMN GV 11 Ramsel
66,Bergstraat 71,2020-09-28,06:00:00,28,10,18,FMN GV 11 Ramsel
66,Bergstraat 71,2020-09-28,07:00:00,166,14,152,FMN GV 11 Ramsel
66,Bergstraat 71,2020-09-28,08:00:00,120,22,98,FMN GV 11 Ramsel
66,Bergstraat 71,2020-09-28,09:00:00,10,2,8,FMN GV 11 Ramsel
66,Bergstraat 71,2020-09-28,10:00:00,14,8,6,FMN GV 11 Ramsel
66,Bergstraat 71,2020-09-28,11:00:00,6,4,2,FMN GV 11 Ramsel
66,Bergstraat 71,2020-09-28,12:00:00,22,8,14,FMN GV 11 Ramsel
66,Bergstraat 71,2020-09-28,13:00:00,12,10,2,FMN GV 11 Ramsel
66,Bergstraat 71,2020-09-28,14:00:00,20,8,12,FMN GV 11 Ramsel
66,Bergstraat 71,2020-09-28,15:00:00,148,140,8,FMN GV 11 Ramsel
66,Bergstraat 71,2020-09-28,16:00:00,96,84,12,FMN GV 11 Ramsel
66,Bergstraat 71,2020-09-28,17:00:00,36,18,18,FMN GV 11 Ramsel
66,Bergstraat 71,2020-09-28,18:00:00,18,14,4,FMN GV 11 Ramsel
66,Bergstraat 71,2020-09-28,19:00:00,12,4,8,FMN GV 11 Ramsel
66,Bergstraat 71,2020-09-28,20:00:00,8,6,2,FMN GV 11 Ramsel
66,Bergstraat 71,2020-09-28,21:00:00,6,6,0,FMN GV 11 Ramsel
66,Bergstraat 71,2020-09-28,22:00:00,4,4,0,FMN GV 11 Ramsel
66,Bergstraat 71,2020-09-28,23:00:00,0,0,0,FMN GV 11 Ramsel
66,Bergstraat 71,2020-09-29,00:00:00,0,0,0,FMN GV 11 Ramsel
66,Bergstraat 71,2020-09-29,01:00:00,0,0,0,FMN GV 11 Ramsel
66,Bergstraat 71,2020-09-29,02:00:00,0,0,0,FMN GV 11 Ramsel
66,Bergstraat 71,2020-09-29,03:00:00,0,0,0,FMN GV 11 Ramsel
66,Bergstraat 71,2020-09-29,04:00:00,6,6,0,FMN GV 11 Ramsel
66,Bergstraat 71,2020-09-29,05:00:00,16,14,2,FMN GV 11 Ramsel
66,Bergstraat 71,2020-09-29,06:00:00,36,16,20,FMN GV 11 Ramsel
66,Bergstraat 71,2020-09-29,07:00:00,194,26,168,FMN GV 11 Ramsel
66,Bergstraat 71,2020-09-29,08:00:00,146,14,132,FMN GV 11 Ramsel
66,Bergstraat 71,2020-09-29,09:00:00,64,26,38,FMN GV 11 Ramsel
66,Bergstraat 71,2020-09-29,10:00:00,102,42,60,FMN GV 11 Ramsel
66,Bergstraat 71,2020-09-29,11:00:00,100,44,56,FMN GV 11 Ramsel
66,Bergstraat 71,2020-09-29,12:00:00,122,50,72,FMN GV 11 Ramsel
66,Bergstraat 71,2020-09-29,13:00:00,216,114,102,FMN GV 11 Ramsel
66,Bergstraat 71,2020-09-29,14:00:00,238,100,138,FMN GV 11 Ramsel
66,Bergstraat 71,2020-09-29,15:00:00,296,246,50,FMN GV 11 Ramsel
66,Bergstraat 71,2020-09-29,16:00:00,198,140,58,FMN GV 11 Ramsel
66,Bergstraat 71,2020-09-29,17:00:00,120,72,48,FMN GV 11 Ramsel
66,Bergstraat 71,2020-09-29,18:00:00,94,40,54,FMN GV 11 Ramsel
66,Bergstraat 71,2020-09-29,19:00:00,46,20,26,FMN GV 11 Ramsel
66,Bergstraat 71,2020-09-29,20:00:00,60,50,10,FMN GV 11 Ramsel
66,Bergstraat 71,2020-09-29,21:00:00,8,4,4,FMN GV 11 Ramsel
66,Bergstraat 71,2020-09-29,22:00:00,10,8,2,FMN GV 11 Ramsel
66,Bergstraat 71,2020-09-29,23:00:00,14,8,6,FMN GV 11 Ramsel
66,Bergstraat 71,2020-09-30,00:00:00,2,0,2,FMN GV 11 Ramsel
66,Bergstraat 71,2020-09-30,01:00:00,4,2,2,FMN GV 11 Ramsel
66,Bergstraat 71,2020-09-30,02:00:00,0,0,0,FMN GV 11 Ramsel
66,Bergstraat 71,2020-09-30,03:00:00,0,0,0,FMN GV 11 Ramsel
66,Bergstraat 71,2020-09-30,04:00:00,6,6,0,FMN GV 11 Ramsel
66,Bergstraat 71,2020-09-30,05:00:00,10,6,4,FMN GV 11 Ramsel
66,Bergstraat 71,2020-09-30,06:00:00,26,10,16,FMN GV 11 Ramsel
66,Bergstraat 71,2020-09-30,07:00:00,262,28,234,FMN GV 11 Ramsel
66,Bergstraat 71,2020-09-30,08:00:00,180,26,154,FMN GV 11 Ramsel
66,Bergstraat 71,2020-09-30,09:00:00,70,20,50,FMN GV 11 Ramsel
66,Bergstraat 71,2020-09-30,10:00:00,48,16,32,FMN GV 11 Ramsel
66,Bergstraat 71,2020-09-30,11:00:00,100,60,40,FMN GV 11 Ramsel
66,Bergstraat 71,2020-09-30,12:00:00,338,274,64,FMN GV 11 Ramsel
66,Bergstraat 71,2020-09-30,13:00:00,164,82,82,FMN GV 11 Ramsel
66,Bergstraat 71,2020-09-30,14:00:00,190,74,116,FMN GV 11 Ramsel
66,Bergstraat 71,2020-09-30,15:00:00,182,104,78,FMN GV 11 Ramsel
66,Bergstraat 71,2020-09-30,16:00:00,156,98,58,FMN GV 11 Ramsel
66,Bergstraat 71,2020-09-30,17:00:00,114,62,52,FMN GV 11 Ramsel
66,Bergstraat 71,2020-09-30,18:00:00,102,56,46,FMN GV 11 Ramsel
66,Bergstraat 71,2020-09-30,19:00:00,74,50,24,FMN GV 11 Ramsel
66,Bergstraat 71,2020-09-30,20:00:00,32,26,6,FMN GV 11 Ramsel
66,Bergstraat 71,2020-09-30,21:00:00,10,8,2,FMN GV 11 Ramsel
66,Bergstraat 71,2020-09-30,22:00:00,12,8,4,FMN GV 11 Ramsel
66,Bergstraat 71,2020-09-30,23:00:00,10,6,4,FMN GV 11 Ramsel
66,Bergstraat 71,2020-10-01,00:00:00,0,0,0,FMN GV 11 Ramsel
66,Bergstraat 71,2020-10-01,01:00:00,2,2,0,FMN GV 11 Ramsel
66,Bergstraat 71,2020-10-01,02:00:00,2,0,2,FMN GV 11 Ramsel
66,Bergstraat 71,2020-10-01,03:00:00,0,0,0,FMN GV 11 Ramsel
66,Bergstraat 71,2020-10-01,04:00:00,2,2,0,FMN GV 11 Ramsel
66,Bergstraat 71,2020-10-01,05:00:00,14,8,6,FMN GV 11 Ramsel
66,Bergstraat 71,2020-10-01,06:00:00,22,12,10,FMN GV 11 Ramsel
66,Bergstraat 71,2020-10-01,07:00:00,140,14,126,FMN GV 11 Ramsel
66,Bergstraat 71,2020-10-01,08:00:00,120,10,110,FMN GV 11 Ramsel
66,Bergstraat 71,2020-10-01,09:00:00,16,6,10,FMN GV 11 Ramsel
66,Bergstraat 71,2020-10-01,10:00:00,14,2,12,FMN GV 11 Ramsel
66,Bergstraat 71,2020-10-01,11:00:00,12,10,2,FMN GV 11 Ramsel
66,Bergstraat 71,2020-10-01,12:00:00,26,20,6,FMN GV 11 Ramsel
66,Bergstraat 71,2020-10-01,13:00:00,8,2,6,FMN GV 11 Ramsel
66,Bergstraat 71,2020-10-01,14:00:00,42,28,14,FMN GV 11 Ramsel
66,Bergstraat 71,2020-10-01,15:00:00,134,120,14,FMN GV 11 Ramsel
66,Bergstraat 71,2020-10-01,16:00:00,88,80,8,FMN GV 11 Ramsel
66,Bergstraat 71,2020-10-01,17:00:00,56,30,26,FMN GV 11 Ramsel
66,Bergstraat 71,2020-10-01,18:00:00,50,28,22,FMN GV 11 Ramsel
66,Bergstraat 71,2020-10-01,19:00:00,60,28,32,FMN GV 11 Ramsel
66,Bergstraat 71,2020-10-01,20:00:00,28,18,10,FMN GV 11 Ramsel
66,Bergstraat 71,2020-10-01,21:00:00,16,14,2,FMN GV 11 Ramsel
66,Bergstraat 71,2020-10-01,22:00:00,2,0,2,FMN GV 11 Ramsel
66,Bergstraat 71,2020-10-01,23:00:00,4,4,0,FMN GV 11 Ramsel
66,Bergstraat 71,2020-10-02,00:00:00,0,0,0,FMN GV 11 Ramsel
66,Bergstraat 71,2020-10-02,01:00:00,0,0,0,FMN GV 11 Ramsel
66,Bergstraat 71,2020-10-02,02:00:00,0,0,0,FMN GV 11 Ramsel
66,Bergstraat 71,2020-10-02,03:00:00,0,0,0,FMN GV 11 Ramsel
66,Bergstraat 71,2020-10-02,04:00:00,2,2,0,FMN GV 11 Ramsel
66,Bergstraat 71,2020-10-02,05:00:00,8,6,2,FMN GV 11 Ramsel
66,Bergstraat 71,2020-10-02,06:00:00,22,6,16,FMN GV 11 Ramsel
66,Bergstraat 71,2020-10-02,07:00:00,166,18,148,FMN GV 11 Ramsel
66,Bergstraat 71,2020-10-02,08:00:00,150,18,132,FMN GV 11 Ramsel
66,Bergstraat 71,2020-10-02,09:00:00,44,26,18,FMN GV 11 Ramsel
66,Bergstraat 71,2020-10-02,10:00:00,22,16,6,FMN GV 11 Ramsel
66,Bergstraat 71,2020-10-02,11:00:00,22,10,12,FMN GV 11 Ramsel
66,Bergstraat 71,2020-10-02,12:00:00,38,18,20,FMN GV 11 Ramsel
66,Bergstraat 71,2020-10-02,13:00:00,38,24,14,FMN GV 11 Ramsel
66,Bergstraat 71,2020-10-02,14:00:00,58,22,36,FMN GV 11 Ramsel
66,Bergstraat 71,2020-10-02,15:00:00,208,186,22,FMN GV 11 Ramsel
66,Bergstraat 71,2020-10-02,16:00:00,90,60,30,FMN GV 11 Ramsel
66,Bergstraat 71,2020-10-02,17:00:00,64,42,22,FMN GV 11 Ramsel
66,Bergstraat 71,2020-10-02,18:00:00,24,14,10,FMN GV 11 Ramsel
66,Bergstraat 71,2020-10-02,19:00:00,22,14,8,FMN GV 11 Ramsel
66,Bergstraat 71,2020-10-02,20:00:00,18,10,8,FMN GV 11 Ramsel
66,Bergstraat 71,2020-10-02,21:00:00,4,2,2,FMN GV 11 Ramsel
66,Bergstraat 71,2020-10-02,22:00:00,6,2,4,FMN GV 11 Ramsel
66,Bergstraat 71,2020-10-02,23:00:00,0,0,0,FMN GV 11 Ramsel
66,Bergstraat 71,2020-10-03,00:00:00,0,0,0,FMN GV 11 Ramsel
66,Bergstraat 71,2020-10-03,01:00:00,6,6,0,FMN GV 11 Ramsel
66,Bergstraat 71,2020-10-03,02:00:00,10,6,4,FMN GV 11 Ramsel
66,Bergstraat 71,2020-10-03,03:00:00,2,0,2,FMN GV 11 Ramsel
66,Bergstraat 71,2020-10-03,04:00:00,0,0,0,FMN GV 11 Ramsel
66,Bergstraat 71,2020-10-03,05:00:00,2,0,2,FMN GV 11 Ramsel
66,Bergstraat 71,2020-10-03,06:00:00,6,4,2,FMN GV 11 Ramsel
66,Bergstraat 71,2020-10-03,07:00:00,2,0,2,FMN GV 11 Ramsel
66,Bergstraat 71,2020-10-03,08:00:00,16,2,14,FMN GV 11 Ramsel
66,Bergstraat 71,2020-10-03,09:00:00,12,2,10,FMN GV 11 Ramsel
66,Bergstraat 71,2020-10-03,10:00:00,20,14,6,FMN GV 11 Ramsel
66,Bergstraat 71,2020-10-03,11:00:00,6,2,4,FMN GV 11 Ramsel
66,Bergstraat 71,2020-10-03,12:00:00,18,12,6,FMN GV 11 Ramsel
66,Bergstraat 71,2020-10-03,13:00:00,48,26,22,FMN GV 11 Ramsel
66,Bergstraat 71,2020-10-03,14:00:00,32,18,14,FMN GV 11 Ramsel
66,Bergstraat 71,2020-10-03,15:00:00,30,16,14,FMN GV 11 Ramsel
66,Bergstraat 71,2020-10-03,16:00:00,52,22,30,FMN GV 11 Ramsel
66,Bergstraat 71,2020-10-03,17:00:00,34,18,16,FMN GV 11 Ramsel
66,Bergstraat 71,2020-10-03,18:00:00,38,18,20,FMN GV 11 Ramsel
66,Bergstraat 71,2020-10-03,19:00:00,36,14,22,FMN GV 11 Ramsel
66,Bergstraat 71,2020-10-03,20:00:00,20,4,16,FMN GV 11 Ramsel
66,Bergstraat 71,2020-10-03,21:00:00,10,4,6,FMN GV 11 Ramsel
66,Bergstraat 71,2020-10-03,22:00:00,4,2,2,FMN GV 11 Ramsel
66,Bergstraat 71,2020-10-03,23:00:00,4,4,0,FMN GV 11 Ramsel
66,Bergstraat 71,2020-10-04,00:00:00,10,10,0,FMN GV 11 Ramsel
66,Bergstraat 71,2020-10-04,01:00:00,22,22,0,FMN GV 11 Ramsel
66,Bergstraat 71,2020-10-04,02:00:00,0,0,0,FMN GV 11 Ramsel
66,Bergstraat 71,2020-10-04,03:00:00,2,0,2,FMN GV 11 Ramsel
66,Bergstraat 71,2020-10-04,04:00:00,2,0,2,FMN GV 11 Ramsel
66,Bergstraat 71,2020-10-04,05:00:00,2,2,0,FMN GV 11 Ramsel
66,Bergstraat 71,2020-10-04,06:00:00,4,0,4,FMN GV 11 Ramsel
66,Bergstraat 71,2020-10-04,07:00:00,12,4,8,FMN GV 11 Ramsel
66,Bergstraat 71,2020-10-04,08:00:00,32,4,28,FMN GV 11 Ramsel
66,Bergstraat 71,2020-10-04,09:00:00,56,12,44,FMN GV 11 Ramsel
66,Bergstraat 71,2020-10-04,10:00:00,80,40,40,FMN GV 11 Ramsel
66,Bergstraat 71,2020-10-04,11:00:00,66,40,26,FMN GV 11 Ramsel
66,Bergstraat 71,2020-10-04,12:00:00,34,16,18,FMN GV 11 Ramsel
66,Bergstraat 71,2020-10-04,13:00:00,50,26,24,FMN GV 11 Ramsel
66,Bergstraat 71,2020-10-04,14:00:00,66,26,40,FMN GV 11 Ramsel
66,Bergstraat 71,2020-10-04,15:00:00,52,32,20,FMN GV 11 Ramsel
66,Bergstraat 71,2020-10-04,16:00:00,42,20,22,FMN GV 11 Ramsel
66,Bergstraat 71,2020-10-04,17:00:00,40,24,16,FMN GV 11 Ramsel
66,Bergstraat 71,2020-10-04,18:00:00,24,6,18,FMN GV 11 Ramsel
66,Bergstraat 71,2020-10-04,19:00:00,14,8,6,FMN GV 11 Ramsel
66,Bergstraat 71,2020-10-04,20:00:00,14,6,8,FMN GV 11 Ramsel
66,Bergstraat 71,2020-10-04,21:00:00,6,2,4,FMN GV 11 Ramsel
66,Bergstraat 71,2020-10-04,22:00:00,2,0,2,FMN GV 11 Ramsel
66,Bergstraat 71,2020-10-04,23:00:00,2,2,0,FMN GV 11 Ramsel
66,Bergstraat 71,2020-10-05,00:00:00,4,4,0,FMN GV 11 Ramsel
66,Bergstraat 71,2020-10-05,01:00:00,0,0,0,FMN GV 11 Ramsel
66,Bergstraat 71,2020-10-05,02:00:00,0,0,0,FMN GV 11 Ramsel
66,Bergstraat 71,2020-10-05,03:00:00,0,0,0,FMN GV 11 Ramsel
66,Bergstraat 71,2020-10-05,04:00:00,0,0,0,FMN GV 11 Ramsel
66,Bergstraat 71,2020-10-05,05:00:00,4,4,0,FMN GV 11 Ramsel
66,Bergstraat 71,2020-10-05,06:00:00,12,8,4,FMN GV 11 Ramsel
66,Bergstraat 71,2020-10-05,07:00:00,116,4,112,FMN GV 11 Ramsel
66,Bergstraat 71,2020-10-05,08:00:00,104,8,96,FMN GV 11 Ramsel
66,Bergstraat 71,2020-10-05,09:00:00,22,12,10,FMN GV 11 Ramsel
66,Bergstraat 71,2020-10-05,10:00:00,26,8,18,FMN GV 11 Ramsel
66,Bergstraat 71,2020-10-05,11:00:00,30,16,14,FMN GV 11 Ramsel
66,Bergstraat 71,2020-10-05,12:00:00,32,14,18,FMN GV 11 Ramsel
66,Bergstraat 71,2020-10-05,13:00:00,80,38,42,FMN GV 11 Ramsel
66,Bergstraat 71,2020-10-05,14:00:00,66,26,40,FMN GV 11 Ramsel
66,Bergstraat 71,2020-10-05,15:00:00,178,138,40,FMN GV 11 Ramsel
66,Bergstraat 71,2020-10-05,16:00:00,126,106,20,FMN GV 11 Ramsel
66,Bergstraat 71,2020-10-05,17:00:00,54,34,20,FMN GV 11 Ramsel
66,Bergstraat 71,2020-10-05,18:00:00,56,36,20,FMN GV 11 Ramsel
66,Bergstraat 71,2020-10-05,19:00:00,28,12,16,FMN GV 11 Ramsel
66,Bergstraat 71,2020-10-05,20:00:00,16,8,8,FMN GV 11 Ramsel
66,Bergstraat 71,2020-10-05,21:00:00,12,6,6,FMN GV 11 Ramsel
66,Bergstraat 71,2020-10-05,22:00:00,12,4,8,FMN GV 11 Ramsel
66,Bergstraat 71,2020-10-05,23:00:00,2,0,2,FMN GV 11 Ramsel
66,Bergstraat 71,2020-10-06,00:00:00,0,0,0,FMN GV 11 Ramsel
66,Bergstraat 71,2020-10-06,01:00:00,2,2,0,FMN GV 11 Ramsel
66,Bergstraat 71,2020-10-06,02:00:00,2,0,2,FMN GV 11 Ramsel
66,Bergstraat 71,2020-10-06,03:00:00,0,0,0,FMN GV 11 Ramsel
66,Bergstraat 71,2020-10-06,04:00:00,4,4,0,FMN GV 11 Ramsel
66,Bergstraat 71,2020-10-06,05:00:00,2,2,0,FMN GV 11 Ramsel
66,Bergstraat 71,2020-10-06,06:00:00,30,12,18,FMN GV 11 Ramsel
66,Bergstraat 71,2020-10-06,07:00:00,150,16,134,FMN GV 11 Ramsel
66,Bergstraat 71,2020-10-06,08:00:00,60,10,50,FMN GV 11 Ramsel
66,Bergstraat 71,2020-10-06,09:00:00,24,4,20,FMN GV 11 Ramsel
66,Bergstraat 71,2020-10-06,10:00:00,18,6,12,FMN GV 11 Ramsel
66,Bergstraat 71,2020-10-06,11:00:00,16,6,10,FMN GV 11 Ramsel
66,Bergstraat 71,2020-10-06,12:00:00,66,34,32,FMN GV 11 Ramsel
66,Bergstraat 71,2020-10-06,13:00:00,94,42,52,FMN GV 11 Ramsel
66,Bergstraat 71,2020-10-06,14:00:00,88,36,52,FMN GV 11 Ramsel
66,Bergstraat 71,2020-10-06,15:00:00,206,174,32,FMN GV 11 Ramsel
66,Bergstraat 71,2020-10-06,16:00:00,126,96,30,FMN GV 11 Ramsel
66,Bergstraat 71,2020-10-06,17:00:00,136,76,60,FMN GV 11 Ramsel
66,Bergstraat 71,2020-10-06,18:00:00,48,36,12,FMN GV 11 Ramsel
66,Bergstraat 71,2020-10-06,19:00:00,34,8,26,FMN GV 11 Ramsel
66,Bergstraat 71,2020-10-06,20:00:00,28,24,4,FMN GV 11 Ramsel
66,Bergstraat 71,2020-10-06,21:00:00,16,6,10,FMN GV 11 Ramsel
66,Bergstraat 71,2020-10-06,22:00:00,16,6,10,FMN GV 11 Ramsel
66,Bergstraat 71,2020-10-06,23:00:00,2,0,2,FMN GV 11 Ramsel
66,Bergstraat 71,2020-10-07,00:00:00,0,0,0,FMN GV 11 Ramsel
66,Bergstraat 71,2020-10-07,01:00:00,0,0,0,FMN GV 11 Ramsel
66,Bergstraat 71,2020-10-07,02:00:00,0,0,0,FMN GV 11 Ramsel
66,Bergstraat 71,2020-10-07,03:00:00,0,0,0,FMN GV 11 Ramsel
66,Bergstraat 71,2020-10-07,04:00:00,2,2,0,FMN GV 11 Ramsel
66,Bergstraat 71,2020-10-07,05:00:00,2,0,2,FMN GV 11 Ramsel
66,Bergstraat 71,2020-10-07,06:00:00,30,18,12,FMN GV 11 Ramsel
66,Bergstraat 71,2020-10-07,07:00:00,108,14,94,FMN GV 11 Ramsel
66,Bergstraat 71,2020-10-07,08:00:00,98,22,76,FMN GV 11 Ramsel
66,Bergstraat 71,2020-10-07,09:00:00,32,10,22,FMN GV 11 Ramsel
66,Bergstraat 71,2020-10-07,10:00:00,52,20,32,FMN GV 11 Ramsel
66,Bergstraat 71,2020-10-07,11:00:00,52,20,32,FMN GV 11 Ramsel
66,Bergstraat 71,2020-10-07,12:00:00,114,90,24,FMN GV 11 Ramsel
66,Bergstraat 71,2020-10-07,13:00:00,106,70,36,FMN GV 11 Ramsel
66,Bergstraat 71,2020-10-07,14:00:00,130,72,58,FMN GV 11 Ramsel
66,Bergstraat 71,2020-10-07,15:00:00,126,46,80,FMN GV 11 Ramsel
66,Bergstraat 71,2020-10-07,16:00:00,144,88,56,FMN GV 11 Ramsel
66,Bergstraat 71,2020-10-07,17:00:00,104,66,38,FMN GV 11 Ramsel
66,Bergstraat 71,2020-10-07,18:00:00,72,50,22,FMN GV 11 Ramsel
66,Bergstraat 71,2020-10-07,19:00:00,44,26,18,FMN GV 11 Ramsel
66,Bergstraat 71,2020-10-07,20:00:00,36,22,14,FMN GV 11 Ramsel
66,Bergstraat 71,2020-10-07,21:00:00,12,6,6,FMN GV 11 Ramsel
66,Bergstraat 71,2020-10-07,22:00:00,10,4,6,FMN GV 11 Ramsel
66,Bergstraat 71,2020-10-07,23:00:00,10,6,4,FMN GV 11 Ramsel
66,Bergstraat 71,2020-10-08,00:00:00,0,0,0,FMN GV 11 Ramsel
66,Bergstraat 71,2020-10-08,01:00:00,0,0,0,FMN GV 11 Ramsel
66,Bergstraat 71,2020-10-08,02:00:00,0,0,0,FMN GV 11 Ramsel
66,Bergstraat 71,2020-10-08,03:00:00,0,0,0,FMN GV 11 Ramsel
66,Bergstraat 71,2020-10-08,04:00:00,2,2,0,FMN GV 11 Ramsel
66,Bergstraat 71,2020-10-08,05:00:00,2,2,0,FMN GV 11 Ramsel
66,Bergstraat 71,2020-10-08,06:00:00,26,6,20,FMN GV 11 Ramsel
66,Bergstraat 71,2020-10-08,07:00:00,152,10,142,FMN GV 11 Ramsel
66,Bergstraat 71,2020-10-08,08:00:00,140,16,124,FMN GV 11 Ramsel
66,Bergstraat 71,2020-10-08,09:00:00,32,6,26,FMN GV 11 Ramsel
66,Bergstraat 71,2020-10-08,10:00:00,44,14,30,FMN GV 11 Ramsel
66,Bergstraat 71,2020-10-08,11:00:00,48,30,18,FMN GV 11 Ramsel
66,Bergstraat 71,2020-10-08,12:00:00,32,14,18,FMN GV 11 Ramsel
66,Bergstraat 71,2020-10-08,13:00:00,66,36,30,FMN GV 11 Ramsel
66,Bergstraat 71,2020-10-08,14:00:00,60,28,32,FMN GV 11 Ramsel
66,Bergstraat 71,2020-10-08,15:00:00,208,190,18,FMN GV 11 Ramsel
66,Bergstraat 71,2020-10-08,16:00:00,104,76,28,FMN GV 11 Ramsel
66,Bergstraat 71,2020-10-08,17:00:00,50,34,16,FMN GV 11 Ramsel
66,Bergstraat 71,2020-10-08,18:00:00,52,36,16,FMN GV 11 Ramsel
66,Bergstraat 71,2020-10-08,19:00:00,18,8,10,FMN GV 11 Ramsel
66,Bergstraat 71,2020-10-08,20:00:00,20,18,2,FMN GV 11 Ramsel
66,Bergstraat 71,2020-10-08,21:00:00,6,4,2,FMN GV 11 Ramsel
66,Bergstraat 71,2020-10-08,22:00:00,14,8,6,FMN GV 11 Ramsel
66,Bergstraat 71,2020-10-08,23:00:00,2,2,0,FMN GV 11 Ramsel
66,Bergstraat 71,2020-10-09,00:00:00,0,0,0,FMN GV 11 Ramsel
66,Bergstraat 71,2020-10-09,01:00:00,0,0,0,FMN GV 11 Ramsel
66,Bergstraat 71,2020-10-09,02:00:00,0,0,0,FMN GV 11 Ramsel
66,Bergstraat 71,2020-10-09,03:00:00,0,0,0,FMN GV 11 Ramsel
66,Bergstraat 71,2020-10-09,04:00:00,0,0,0,FMN GV 11 Ramsel
66,Bergstraat 71,2020-10-09,05:00:00,6,2,4,FMN GV 11 Ramsel
66,Bergstraat 71,2020-10-09,06:00:00,24,8,16,FMN GV 11 Ramsel
66,Bergstraat 71,2020-10-09,07:00:00,140,14,126,FMN GV 11 Ramsel
66,Bergstraat 71,2020-10-09,08:00:00,144,24,120,FMN GV 11 Ramsel
66,Bergstraat 71,2020-10-09,09:00:00,56,14,42,FMN GV 11 Ramsel
66,Bergstraat 71,2020-10-09,10:00:00,68,28,40,FMN GV 11 Ramsel
66,Bergstraat 71,2020-10-09,11:00:00,66,40,26,FMN GV 11 Ramsel
66,Bergstraat 71,2020-10-09,12:00:00,112,64,48,FMN GV 11 Ramsel
66,Bergstraat 71,2020-10-09,13:00:00,178,82,96,FMN GV 11 Ramsel
66,Bergstraat 71,2020-10-09,14:00:00,224,110,114,FMN GV 11 Ramsel
66,Bergstraat 71,2020-10-09,15:00:00,262,194,68,FMN GV 11 Ramsel
66,Bergstraat 71,2020-10-09,16:00:00,166,110,56,FMN GV 11 Ramsel
66,Bergstraat 71,2020-10-09,17:00:00,92,64,28,FMN GV 11 Ramsel
66,Bergstraat 71,2020-10-09,18:00:00,44,28,16,FMN GV 11 Ramsel
66,Bergstraat 71,2020-10-09,19:00:00,40,22,18,FMN GV 11 Ramsel
66,Bergstraat 71,2020-10-09,20:00:00,16,10,6,FMN GV 11 Ramsel
66,Bergstraat 71,2020-10-09,21:00:00,16,4,12,FMN GV 11 Ramsel
66,Bergstraat 71,2020-10-09,22:00:00,16,8,8,FMN GV 11 Ramsel
66,Bergstraat 71,2020-10-09,23:00:00,4,2,2,FMN GV 11 Ramsel
66,Bergstraat 71,2020-10-10,00:00:00,6,4,2,FMN GV 11 Ramsel
66,Bergstraat 71,2020-10-10,01:00:00,10,0,10,FMN GV 11 Ramsel
66,Bergstraat 71,2020-10-10,02:00:00,2,2,0,FMN GV 11 Ramsel
66,Bergstraat 71,2020-10-10,03:00:00,0,0,0,FMN GV 11 Ramsel
66,Bergstraat 71,2020-10-10,04:00:00,4,2,2,FMN GV 11 Ramsel
66,Bergstraat 71,2020-10-10,05:00:00,2,0,2,FMN GV 11 Ramsel
66,Bergstraat 71,2020-10-10,06:00:00,4,2,2,FMN GV 11 Ramsel
66,Bergstraat 71,2020-10-10,07:00:00,8,0,8,FMN GV 11 Ramsel
66,Bergstraat 71,2020-10-10,08:00:00,26,16,10,FMN GV 11 Ramsel
66,Bergstraat 71,2020-10-10,09:00:00,58,24,34,FMN GV 11 Ramsel
66,Bergstraat 71,2020-10-10,10:00:00,108,48,60,FMN GV 11 Ramsel
66,Bergstraat 71,2020-10-10,11:00:00,108,62,46,FMN GV 11 Ramsel
66,Bergstraat 71,2020-10-10,12:00:00,88,42,46,FMN GV 11 Ramsel
66,Bergstraat 71,2020-10-10,13:00:00,148,64,84,FMN GV 11 Ramsel
66,Bergstraat 71,2020-10-10,14:00:00,120,60,60,FMN GV 11 Ramsel
66,Bergstraat 71,2020-10-10,15:00:00,110,50,60,FMN GV 11 Ramsel
66,Bergstraat 71,2020-10-10,16:00:00,96,66,30,FMN GV 11 Ramsel
66,Bergstraat 71,2020-10-10,17:00:00,56,24,32,FMN GV 11 Ramsel
66,Bergstraat 71,2020-10-10,18:00:00,16,4,12,FMN GV 11 Ramsel
66,Bergstraat 71,2020-10-10,19:00:00,10,6,4,FMN GV 11 Ramsel
66,Bergstraat 71,2020-10-10,20:00:00,4,0,4,FMN GV 11 Ramsel
66,Bergstraat 71,2020-10-10,21:00:00,6,2,4,FMN GV 11 Ramsel
66,Bergstraat 71,2020-10-10,22:00:00,4,4,0,FMN GV 11 Ramsel
66,Bergstraat 71,2020-10-10,23:00:00,12,8,4,FMN GV 11 Ramsel
66,Bergstraat 71,2020-10-11,00:00:00,4,4,0,FMN GV 11 Ramsel
66,Bergstraat 71,2020-10-11,01:00:00,10,8,2,FMN GV 11 Ramsel
66,Bergstraat 71,2020-10-11,02:00:00,4,0,4,FMN GV 11 Ramsel
66,Bergstraat 71,2020-10-11,03:00:00,0,0,0,FMN GV 11 Ramsel
66,Bergstraat 71,2020-10-11,04:00:00,0,0,0,FMN GV 11 Ramsel
66,Bergstraat 71,2020-10-11,05:00:00,0,0,0,FMN GV 11 Ramsel
66,Bergstraat 71,2020-10-11,06:00:00,6,2,4,FMN GV 11 Ramsel
66,Bergstraat 71,2020-10-11,07:00:00,8,4,4,FMN GV 11 Ramsel
66,Bergstraat 71,2020-10-11,08:00:00,48,18,30,FMN GV 11 Ramsel
66,Bergstraat 71,2020-10-11,09:00:00,70,30,40,FMN GV 11 Ramsel
66,Bergstraat 71,2020-10-11,10:00:00,114,56,58,FMN GV 11 Ramsel
66,Bergstraat 71,2020-10-11,11:00:00,108,78,30,FMN GV 11 Ramsel
66,Bergstraat 71,2020-10-11,12:00:00,100,58,42,FMN GV 11 Ramsel
66,Bergstraat 71,2020-10-11,13:00:00,106,46,60,FMN GV 11 Ramsel
66,Bergstraat 71,2020-10-11,14:00:00,116,56,60,FMN GV 11 Ramsel
66,Bergstraat 71,2020-10-11,15:00:00,110,58,52,FMN GV 11 Ramsel
66,Bergstraat 71,2020-10-11,16:00:00,86,52,34,FMN GV 11 Ramsel
66,Bergstraat 71,2020-10-11,17:00:00,50,26,24,FMN GV 11 Ramsel
66,Bergstraat 71,2020-10-11,18:00:00,24,8,16,FMN GV 11 Ramsel
66,Bergstraat 71,2020-10-11,19:00:00,14,4,10,FMN GV 11 Ramsel
66,Bergstraat 71,2020-10-11,20:00:00,14,6,8,FMN GV 11 Ramsel
66,Bergstraat 71,2020-10-11,21:00:00,4,2,2,FMN GV 11 Ramsel
66,Bergstraat 71,2020-10-11,22:00:00,2,0,2,FMN GV 11 Ramsel
66,Bergstraat 71,2020-10-11,23:00:00,2,2,0,FMN GV 11 Ramsel
66,Bergstraat 71,2020-10-12,00:00:00,0,0,0,FMN GV 11 Ramsel
66,Bergstraat 71,2020-10-12,01:00:00,2,2,0,FMN GV 11 Ramsel
66,Bergstraat 71,2020-10-12,02:00:00,0,0,0,FMN GV 11 Ramsel
66,Bergstraat 71,2020-10-12,03:00:00,0,0,0,FMN GV 11 Ramsel
66,Bergstraat 71,2020-10-12,04:00:00,2,2,0,FMN GV 11 Ramsel
66,Bergstraat 71,2020-10-12,05:00:00,10,8,2,FMN GV 11 Ramsel
66,Bergstraat 71,2020-10-12,06:00:00,28,10,18,FMN GV 11 Ramsel
66,Bergstraat 71,2020-10-12,07:00:00,216,28,188,FMN GV 11 Ramsel
66,Bergstraat 71,2020-10-12,08:00:00,148,26,122,FMN GV 11 Ramsel
66,Bergstraat 71,2020-10-12,09:00:00,30,20,10,FMN GV 11 Ramsel
66,Bergstraat 71,2020-10-12,10:00:00,44,12,32,FMN GV 11 Ramsel
66,Bergstraat 71,2020-10-12,11:00:00,26,16,10,FMN GV 11 Ramsel
66,Bergstraat 71,2020-10-12,12:00:00,100,44,56,FMN GV 11 Ramsel
66,Bergstraat 71,2020-10-12,13:00:00,118,58,60,FMN GV 11 Ramsel
66,Bergstraat 71,2020-10-12,14:00:00,126,48,78,FMN GV 11 Ramsel
66,Bergstraat 71,2020-10-12,15:00:00,286,228,58,FMN GV 11 Ramsel
66,Bergstraat 71,2020-10-12,16:00:00,148,118,30,FMN GV 11 Ramsel
66,Bergstraat 71,2020-10-12,17:00:00,88,52,36,FMN GV 11 Ramsel
66,Bergstraat 71,2020-10-12,18:00:00,84,46,38,FMN GV 11 Ramsel
66,Bergstraat 71,2020-10-12,19:00:00,32,14,18,FMN GV 11 Ramsel
66,Bergstraat 71,2020-10-12,20:00:00,26,18,8,FMN GV 11 Ramsel
66,Bergstraat 71,2020-10-12,21:00:00,14,6,8,FMN GV 11 Ramsel
66,Bergstraat 71,2020-10-12,22:00:00,16,10,6,FMN GV 11 Ramsel
66,Bergstraat 71,2020-10-12,23:00:00,0,0,0,FMN GV 11 Ramsel
66,Bergstraat 71,2020-10-13,00:00:00,0,0,0,FMN GV 11 Ramsel
66,Bergstraat 71,2020-10-13,01:00:00,0,0,0,FMN GV 11 Ramsel
66,Bergstraat 71,2020-10-13,02:00:00,0,0,0,FMN GV 11 Ramsel
66,Bergstraat 71,2020-10-13,03:00:00,2,2,0,FMN GV 11 Ramsel
66,Bergstraat 71,2020-10-13,04:00:00,2,2,0,FMN GV 11 Ramsel
66,Bergstraat 71,2020-10-13,05:00:00,10,8,2,FMN GV 11 Ramsel
66,Bergstraat 71,2020-10-13,06:00:00,26,8,18,FMN GV 11 Ramsel
66,Bergstraat 71,2020-10-13,07:00:00,202,30,172,FMN GV 11 Ramsel
66,Bergstraat 71,2020-10-13,08:00:00,168,16,152,FMN GV 11 Ramsel
66,Bergstraat 71,2020-10-13,09:00:00,44,18,26,FMN GV 11 Ramsel
66,Bergstraat 71,2020-10-13,10:00:00,54,16,38,FMN GV 11 Ramsel
66,Bergstraat 71,2020-10-13,11:00:00,66,36,30,FMN GV 11 Ramsel
66,Bergstraat 71,2020-10-13,12:00:00,72,46,26,FMN GV 11 Ramsel
66,Bergstraat 71,2020-10-13,13:00:00,164,90,74,FMN GV 11 Ramsel
66,Bergstraat 71,2020-10-13,14:00:00,128,66,62,FMN GV 11 Ramsel
66,Bergstraat 71,2020-10-13,15:00:00,290,236,54,FMN GV 11 Ramsel
66,Bergstraat 71,2020-10-13,16:00:00,164,134,30,FMN GV 11 Ramsel
66,Bergstraat 71,2020-10-13,17:00:00,108,74,34,FMN GV 11 Ramsel
66,Bergstraat 71,2020-10-13,18:00:00,50,34,16,FMN GV 11 Ramsel
66,Bergstraat 71,2020-10-13,19:00:00,46,22,24,FMN GV 11 Ramsel
66,Bergstraat 71,2020-10-13,20:00:00,34,28,6,FMN GV 11 Ramsel
66,Bergstraat 71,2020-10-13,21:00:00,16,14,2,FMN GV 11 Ramsel
66,Bergstraat 71,2020-10-13,22:00:00,14,8,6,FMN GV 11 Ramsel
66,Bergstraat 71,2020-10-13,23:00:00,6,4,2,FMN GV 11 Ramsel
66,Bergstraat 71,2020-10-14,00:00:00,0,0,0,FMN GV 11 Ramsel
66,Bergstraat 71,2020-10-14,01:00:00,0,0,0,FMN GV 11 Ramsel
66,Bergstraat 71,2020-10-14,02:00:00,0,0,0,FMN GV 11 Ramsel
66,Bergstraat 71,2020-10-14,03:00:00,0,0,0,FMN GV 11 Ramsel
66,Bergstraat 71,2020-10-14,04:00:00,4,4,0,FMN GV 11 Ramsel
66,Bergstraat 71,2020-10-14,05:00:00,14,6,8,FMN GV 11 Ramsel
66,Bergstraat 71,2020-10-14,06:00:00,32,10,22,FMN GV 11 Ramsel
66,Bergstraat 71,2020-10-14,07:00:00,220,28,192,FMN GV 11 Ramsel
66,Bergstraat 71,2020-10-14,08:00:00,158,24,134,FMN GV 11 Ramsel
66,Bergstraat 71,2020-10-14,09:00:00,48,16,32,FMN GV 11 Ramsel
66,Bergstraat 71,2020-10-14,10:00:00,60,16,44,FMN GV 11 Ramsel
66,Bergstraat 71,2020-10-14,11:00:00,80,34,46,FMN GV 11 Ramsel
66,Bergstraat 71,2020-10-14,12:00:00,302,264,38,FMN GV 11 Ramsel
66,Bergstraat 71,2020-10-14,13:00:00,124,62,62,FMN GV 11 Ramsel
66,Bergstraat 71,2020-10-14,14:00:00,134,64,70,FMN GV 11 Ramsel
66,Bergstraat 71,2020-10-14,15:00:00,136,72,64,FMN GV 11 Ramsel
66,Bergstraat 71,2020-10-14,16:00:00,128,76,52,FMN GV 11 Ramsel
66,Bergstraat 71,2020-10-14,17:00:00,80,48,32,FMN GV 11 Ramsel
66,Bergstraat 71,2020-10-14,18:00:00,46,28,18,FMN GV 11 Ramsel
66,Bergstraat 71,2020-10-14,19:00:00,42,30,12,FMN GV 11 Ramsel
66,Bergstraat 71,2020-10-14,20:00:00,14,8,6,FMN GV 11 Ramsel
66,Bergstraat 71,2020-10-14,21:00:00,4,2,2,FMN GV 11 Ramsel
66,Bergstraat 71,2020-10-14,22:00:00,8,6,2,FMN GV 11 Ramsel
66,Bergstraat 71,2020-10-14,23:00:00,4,4,0,FMN GV 11 Ramsel
66,Bergstraat 71,2020-10-15,00:00:00,2,2,0,FMN GV 11 Ramsel
66,Bergstraat 71,2020-10-15,01:00:00,2,2,0,FMN GV 11 Ramsel
66,Bergstraat 71,2020-10-15,02:00:00,2,0,2,FMN GV 11 Ramsel
66,Bergstraat 71,2020-10-15,03:00:00,0,0,0,FMN GV 11 Ramsel
66,Bergstraat 71,2020-10-15,04:00:00,4,2,2,FMN GV 11 Ramsel
66,Bergstraat 71,2020-10-15,05:00:00,16,8,8,FMN GV 11 Ramsel
66,Bergstraat 71,2020-10-15,06:00:00,32,10,22,FMN GV 11 Ramsel
66,Bergstraat 71,2020-10-15,07:00:00,208,28,180,FMN GV 11 Ramsel
66,Bergstraat 71,2020-10-15,08:00:00,158,12,146,FMN GV 11 Ramsel
66,Bergstraat 71,2020-10-15,09:00:00,26,4,22,FMN GV 11 Ramsel
66,Bergstraat 71,2020-10-15,10:00:00,40,16,24,FMN GV 11 Ramsel
66,Bergstraat 71,2020-10-15,11:00:00,50,22,28,FMN GV 11 Ramsel
66,Bergstraat 71,2020-10-15,12:00:00,76,42,34,FMN GV 11 Ramsel
66,Bergstraat 71,2020-10-15,13:00:00,120,50,70,FMN GV 11 Ramsel
66,Bergstraat 71,2020-10-15,14:00:00,132,60,72,FMN GV 11 Ramsel
66,Bergstraat 71,2020-10-15,15:00:00,210,186,24,FMN GV 11 Ramsel
66,Bergstraat 71,2020-10-15,16:00:00,158,118,40,FMN GV 11 Ramsel
66,Bergstraat 71,2020-10-15,17:00:00,100,64,36,FMN GV 11 Ramsel
66,Bergstraat 71,2020-10-15,18:00:00,46,30,16,FMN GV 11 Ramsel
66,Bergstraat 71,2020-10-15,19:00:00,32,18,14,FMN GV 11 Ramsel
66,Bergstraat 71,2020-10-15,20:00:00,24,18,6,FMN GV 11 Ramsel
66,Bergstraat 71,2020-10-15,21:00:00,8,6,2,FMN GV 11 Ramsel
66,Bergstraat 71,2020-10-15,22:00:00,18,16,2,FMN GV 11 Ramsel
66,Bergstraat 71,2020-10-15,23:00:00,4,4,0,FMN GV 11 Ramsel
66,Bergstraat 71,2020-10-16,00:00:00,0,0,0,FMN GV 11 Ramsel
66,Bergstraat 71,2020-10-16,01:00:00,0,0,0,FMN GV 11 Ramsel
66,Bergstraat 71,2020-10-16,02:00:00,0,0,0,FMN GV 11 Ramsel
66,Bergstraat 71,2020-10-16,03:00:00,0,0,0,FMN GV 11 Ramsel
66,Bergstraat 71,2020-10-16,04:00:00,0,0,0,FMN GV 11 Ramsel
66,Bergstraat 71,2020-10-16,05:00:00,10,4,6,FMN GV 11 Ramsel
66,Bergstraat 71,2020-10-16,06:00:00,38,8,30,FMN GV 11 Ramsel
66,Bergstraat 71,2020-10-16,07:00:00,202,12,190,FMN GV 11 Ramsel
66,Bergstraat 71,2020-10-16,08:00:00,130,16,114,FMN GV 11 Ramsel
66,Bergstraat 71,2020-10-16,09:00:00,40,16,24,FMN GV 11 Ramsel
66,Bergstraat 71,2020-10-16,10:00:00,50,36,14,FMN GV 11 Ramsel
66,Bergstraat 71,2020-10-16,11:00:00,68,28,40,FMN GV 11 Ramsel
66,Bergstraat 71,2020-10-16,12:00:00,58,22,36,FMN GV 11 Ramsel
66,Bergstraat 71,2020-10-16,13:00:00,92,60,32,FMN GV 11 Ramsel
66,Bergstraat 71,2020-10-16,14:00:00,110,62,48,FMN GV 11 Ramsel
66,Bergstraat 71,2020-10-16,15:00:00,258,218,40,FMN GV 11 Ramsel
66,Bergstraat 71,2020-10-16,16:00:00,144,104,40,FMN GV 11 Ramsel
66,Bergstraat 71,2020-10-16,17:00:00,56,42,14,FMN GV 11 Ramsel
66,Bergstraat 71,2020-10-16,18:00:00,64,42,22,FMN GV 11 Ramsel
66,Bergstraat 71,2020-10-16,19:00:00,30,16,14,FMN GV 11 Ramsel
66,Bergstraat 71,2020-10-16,20:00:00,18,12,6,FMN GV 11 Ramsel
66,Bergstraat 71,2020-10-16,21:00:00,16,6,10,FMN GV 11 Ramsel
66,Bergstraat 71,2020-10-16,22:00:00,10,8,2,FMN GV 11 Ramsel
66,Bergstraat 71,2020-10-16,23:00:00,8,2,6,FMN GV 11 Ramsel
66,Bergstraat 71,2020-10-17,00:00:00,0,0,0,FMN GV 11 Ramsel
66,Bergstraat 71,2020-10-17,01:00:00,2,2,0,FMN GV 11 Ramsel
66,Bergstraat 71,2020-10-17,02:00:00,2,2,0,FMN GV 11 Ramsel
66,Bergstraat 71,2020-10-17,03:00:00,0,0,0,FMN GV 11 Ramsel
66,Bergstraat 71,2020-10-17,04:00:00,0,0,0,FMN GV 11 Ramsel
66,Bergstraat 71,2020-10-17,05:00:00,6,2,4,FMN GV 11 Ramsel
66,Bergstraat 71,2020-10-17,06:00:00,2,0,2,FMN GV 11 Ramsel
66,Bergstraat 71,2020-10-17,07:00:00,6,2,4,FMN GV 11 Ramsel
66,Bergstraat 71,2020-10-17,08:00:00,44,10,34,FMN GV 11 Ramsel
66,Bergstraat 71,2020-10-17,09:00:00,60,32,28,FMN GV 11 Ramsel
66,Bergstraat 71,2020-10-17,10:00:00,64,30,34,FMN GV 11 Ramsel
66,Bergstraat 71,2020-10-17,11:00:00,110,38,72,FMN GV 11 Ramsel
66,Bergstraat 71,2020-10-17,12:00:00,156,86,70,FMN GV 11 Ramsel
66,Bergstraat 71,2020-10-17,13:00:00,186,80,106,FMN GV 11 Ramsel
66,Bergstraat 71,2020-10-17,14:00:00,220,106,114,FMN GV 11 Ramsel
66,Bergstraat 71,2020-10-17,15:00:00,214,92,122,FMN GV 11 Ramsel
66,Bergstraat 71,2020-10-17,16:00:00,190,118,72,FMN GV 11 Ramsel
66,Bergstraat 71,2020-10-17,17:00:00,96,66,30,FMN GV 11 Ramsel
66,Bergstraat 71,2020-10-17,18:00:00,26,12,14,FMN GV 11 Ramsel
66,Bergstraat 71,2020-10-17,19:00:00,8,2,6,FMN GV 11 Ramsel
66,Bergstraat 71,2020-10-17,20:00:00,8,4,4,FMN GV 11 Ramsel
66,Bergstraat 71,2020-10-17,21:00:00,10,6,4,FMN GV 11 Ramsel
66,Bergstraat 71,2020-10-17,22:00:00,10,10,0,FMN GV 11 Ramsel
66,Bergstraat 71,2020-10-17,23:00:00,8,8,0,FMN GV 11 Ramsel
66,Bergstraat 71,2020-10-18,00:00:00,2,2,0,FMN GV 11 Ramsel
66,Bergstraat 71,2020-10-18,01:00:00,0,0,0,FMN GV 11 Ramsel
66,Bergstraat 71,2020-10-18,02:00:00,0,0,0,FMN GV 11 Ramsel
66,Bergstraat 71,2020-10-18,03:00:00,0,0,0,FMN GV 11 Ramsel
66,Bergstraat 71,2020-10-18,04:00:00,0,0,0,FMN GV 11 Ramsel
66,Bergstraat 71,2020-10-18,05:00:00,2,2,0,FMN GV 11 Ramsel
66,Bergstraat 71,2020-10-18,06:00:00,0,0,0,FMN GV 11 Ramsel
66,Bergstraat 71,2020-10-18,07:00:00,22,6,16,FMN GV 11 Ramsel
66,Bergstraat 71,2020-10-18,08:00:00,66,18,48,FMN GV 11 Ramsel
66,Bergstraat 71,2020-10-18,09:00:00,130,56,74,FMN GV 11 Ramsel
66,Bergstraat 71,2020-10-18,10:00:00,188,104,84,FMN GV 11 Ramsel
66,Bergstraat 71,2020-10-18,11:00:00,188,106,82,FMN GV 11 Ramsel
66,Bergstraat 71,2020-10-18,12:00:00,136,84,52,FMN GV 11 Ramsel
66,Bergstraat 71,2020-10-18,13:00:00,94,52,42,FMN GV 11 Ramsel
66,Bergstraat 71,2020-10-18,14:00:00,110,66,44,FMN GV 11 Ramsel
66,Bergstraat 71,2020-10-18,15:00:00,116,64,52,FMN GV 11 Ramsel
66,Bergstraat 71,2020-10-18,16:00:00,92,44,48,FMN GV 11 Ramsel
66,Bergstraat 71,2020-10-18,17:00:00,52,20,32,FMN GV 11 Ramsel
66,Bergstraat 71,2020-10-18,18:00:00,22,12,10,FMN GV 11 Ramsel
66,Bergstraat 71,2020-10-18,19:00:00,10,4,6,FMN GV 11 Ramsel
66,Bergstraat 71,2020-10-18,20:00:00,4,4,0,FMN GV 11 Ramsel
66,Bergstraat 71,2020-10-18,21:00:00,10,8,2,FMN GV 11 Ramsel
66,Bergstraat 71,2020-10-18,22:00:00,0,0,0,FMN GV 11 Ramsel
66,Bergstraat 71,2020-10-18,23:00:00,4,2,2,FMN GV 11 Ramsel
66,Bergstraat 71,2020-10-19,00:00:00,0,0,0,FMN GV 11 Ramsel
66,Bergstraat 71,2020-10-19,01:00:00,0,0,0,FMN GV 11 Ramsel
66,Bergstraat 71,2020-10-19,02:00:00,2,0,2,FMN GV 11 Ramsel
66,Bergstraat 71,2020-10-19,03:00:00,2,2,0,FMN GV 11 Ramsel
66,Bergstraat 71,2020-10-19,04:00:00,4,4,0,FMN GV 11 Ramsel
66,Bergstraat 71,2020-10-19,05:00:00,12,6,6,FMN GV 11 Ramsel
66,Bergstraat 71,2020-10-19,06:00:00,14,4,10,FMN GV 11 Ramsel
66,Bergstraat 71,2020-10-19,07:00:00,186,18,168,FMN GV 11 Ramsel
66,Bergstraat 71,2020-10-19,08:00:00,178,18,160,FMN GV 11 Ramsel
66,Bergstraat 71,2020-10-19,09:00:00,22,10,12,FMN GV 11 Ramsel
66,Bergstraat 71,2020-10-19,10:00:00,32,14,18,FMN GV 11 Ramsel
66,Bergstraat 71,2020-10-19,11:00:00,58,26,32,FMN GV 11 Ramsel
66,Bergstraat 71,2020-10-19,12:00:00,54,30,24,FMN GV 11 Ramsel
66,Bergstraat 71,2020-10-19,13:00:00,170,82,88,FMN GV 11 Ramsel
66,Bergstraat 71,2020-10-19,14:00:00,240,96,144,FMN GV 11 Ramsel
66,Bergstraat 71,2020-10-19,15:00:00,378,314,64,FMN GV 11 Ramsel
66,Bergstraat 71,2020-10-19,16:00:00,186,134,52,FMN GV 11 Ramsel
66,Bergstraat 71,2020-10-19,17:00:00,120,60,60,FMN GV 11 Ramsel
66,Bergstraat 71,2020-10-19,18:00:00,42,22,20,FMN GV 11 Ramsel
66,Bergstraat 71,2020-10-19,19:00:00,16,10,6,FMN GV 11 Ramsel
66,Bergstraat 71,2020-10-19,20:00:00,18,12,6,FMN GV 11 Ramsel
66,Bergstraat 71,2020-10-19,21:00:00,4,2,2,FMN GV 11 Ramsel
66,Bergstraat 71,2020-10-19,22:00:00,16,2,14,FMN GV 11 Ramsel
66,Bergstraat 71,2020-10-19,23:00:00,2,2,0,FMN GV 11 Ramsel
66,Bergstraat 71,2020-10-20,00:00:00,0,0,0,FMN GV 11 Ramsel
66,Bergstraat 71,2020-10-20,01:00:00,0,0,0,FMN GV 11 Ramsel
66,Bergstraat 71,2020-10-20,02:00:00,0,0,0,FMN GV 11 Ramsel
66,Bergstraat 71,2020-10-20,03:00:00,0,0,0,FMN GV 11 Ramsel
66,Bergstraat 71,2020-10-20,04:00:00,4,4,0,FMN GV 11 Ramsel
66,Bergstraat 71,2020-10-20,05:00:00,6,0,6,FMN GV 11 Ramsel
66,Bergstraat 71,2020-10-20,06:00:00,20,8,12,FMN GV 11 Ramsel
66,Bergstraat 71,2020-10-20,07:00:00,210,20,190,FMN GV 11 Ramsel
66,Bergstraat 71,2020-10-20,08:00:00,174,22,152,FMN GV 11 Ramsel
66,Bergstraat 71,2020-10-20,09:00:00,34,10,24,FMN GV 11 Ramsel
66,Bergstraat 71,2020-10-20,10:00:00,36,18,18,FMN GV 11 Ramsel
66,Bergstraat 71,2020-10-20,11:00:00,34,24,10,FMN GV 11 Ramsel
66,Bergstraat 71,2020-10-20,12:00:00,50,26,24,FMN GV 11 Ramsel
66,Bergstraat 71,2020-10-20,13:00:00,92,40,52,FMN GV 11 Ramsel
66,Bergstraat 71,2020-10-20,14:00:00,38,20,18,FMN GV 11 Ramsel
66,Bergstraat 71,2020-10-20,15:00:00,286,240,46,FMN GV 11 Ramsel
66,Bergstraat 71,2020-10-20,16:00:00,106,80,26,FMN GV 11 Ramsel
66,Bergstraat 71,2020-10-20,17:00:00,52,38,14,FMN GV 11 Ramsel
66,Bergstraat 71,2020-10-20,18:00:00,28,14,14,FMN GV 11 Ramsel
66,Bergstraat 71,2020-10-20,19:00:00,20,10,10,FMN GV 11 Ramsel
66,Bergstraat 71,2020-10-20,20:00:00,26,18,8,FMN GV 11 Ramsel
66,Bergstraat 71,2020-10-20,21:00:00,4,4,0,FMN GV 11 Ramsel
66,Bergstraat 71,2020-10-20,22:00:00,14,2,12,FMN GV 11 Ramsel
66,Bergstraat 71,2020-10-20,23:00:00,2,2,0,FMN GV 11 Ramsel
66,Bergstraat 71,2020-10-21,00:00:00,0,0,0,FMN GV 11 Ramsel
66,Bergstraat 71,2020-10-21,01:00:00,0,0,0,FMN GV 11 Ramsel
66,Bergstraat 71,2020-10-21,02:00:00,0,0,0,FMN GV 11 Ramsel
66,Bergstraat 71,2020-10-21,03:00:00,0,0,0,FMN GV 11 Ramsel
66,Bergstraat 71,2020-10-21,04:00:00,4,4,0,FMN GV 11 Ramsel
66,Bergstraat 71,2020-10-21,05:00:00,8,2,6,FMN GV 11 Ramsel
66,Bergstraat 71,2020-10-21,06:00:00,14,8,6,FMN GV 11 Ramsel
66,Bergstraat 71,2020-10-21,07:00:00,102,8,94,FMN GV 11 Ramsel
66,Bergstraat 71,2020-10-21,08:00:00,104,18,86,FMN GV 11 Ramsel
66,Bergstraat 71,2020-10-21,09:00:00,12,4,8,FMN GV 11 Ramsel
66,Bergstraat 71,2020-10-21,10:00:00,12,8,4,FMN GV 11 Ramsel
66,Bergstraat 71,2020-10-21,11:00:00,14,4,10,FMN GV 11 Ramsel
66,Bergstraat 71,2020-10-21,12:00:00,194,156,38,FMN GV 11 Ramsel
66,Bergstraat 71,2020-10-21,13:00:00,120,58,62,FMN GV 11 Ramsel
66,Bergstraat 71,2020-10-21,14:00:00,126,50,76,FMN GV 11 Ramsel
66,Bergstraat 71,2020-10-21,15:00:00,102,54,48,FMN GV 11 Ramsel
66,Bergstraat 71,2020-10-21,16:00:00,68,36,32,FMN GV 11 Ramsel
66,Bergstraat 71,2020-10-21,17:00:00,66,44,22,FMN GV 11 Ramsel
66,Bergstraat 71,2020-10-21,18:00:00,50,26,24,FMN GV 11 Ramsel
66,Bergstraat 71,2020-10-21,19:00:00,16,6,10,FMN GV 11 Ramsel
66,Bergstraat 71,2020-10-21,20:00:00,24,12,12,FMN GV 11 Ramsel
66,Bergstraat 71,2020-10-21,21:00:00,2,0,2,FMN GV 11 Ramsel
66,Bergstraat 71,2020-10-21,22:00:00,14,6,8,FMN GV 11 Ramsel
66,Bergstraat 71,2020-10-21,23:00:00,2,2,0,FMN GV 11 Ramsel
66,Bergstraat 71,2020-10-22,00:00:00,0,0,0,FMN GV 11 Ramsel
66,Bergstraat 71,2020-10-22,01:00:00,2,2,0,FMN GV 11 Ramsel
66,Bergstraat 71,2020-10-22,02:00:00,0,0,0,FMN GV 11 Ramsel
66,Bergstraat 71,2020-10-22,03:00:00,2,0,2,FMN GV 11 Ramsel
66,Bergstraat 71,2020-10-22,04:00:00,2,0,2,FMN GV 11 Ramsel
66,Bergstraat 71,2020-10-22,05:00:00,6,0,6,FMN GV 11 Ramsel
66,Bergstraat 71,2020-10-22,06:00:00,22,10,12,FMN GV 11 Ramsel
66,Bergstraat 71,2020-10-22,07:00:00,182,6,176,FMN GV 11 Ramsel
66,Bergstraat 71,2020-10-22,08:00:00,142,12,130,FMN GV 11 Ramsel
66,Bergstraat 71,2020-10-22,09:00:00,50,10,40,FMN GV 11 Ramsel
66,Bergstraat 71,2020-10-22,10:00:00,54,34,20,FMN GV 11 Ramsel
66,Bergstraat 71,2020-10-22,11:00:00,84,48,36,FMN GV 11 Ramsel
66,Bergstraat 71,2020-10-22,12:00:00,98,44,54,FMN GV 11 Ramsel
66,Bergstraat 71,2020-10-22,13:00:00,56,38,18,FMN GV 11 Ramsel
66,Bergstraat 71,2020-10-22,14:00:00,114,78,36,FMN GV 11 Ramsel
66,Bergstraat 71,2020-10-22,15:00:00,204,180,24,FMN GV 11 Ramsel
66,Bergstraat 71,2020-10-22,16:00:00,102,100,2,FMN GV 11 Ramsel
66,Bergstraat 71,2020-10-22,17:00:00,64,42,22,FMN GV 11 Ramsel
66,Bergstraat 71,2020-10-22,18:00:00,56,24,32,FMN GV 11 Ramsel
66,Bergstraat 71,2020-10-22,19:00:00,38,20,18,FMN GV 11 Ramsel
66,Bergstraat 71,2020-10-22,20:00:00,38,28,10,FMN GV 11 Ramsel
66,Bergstraat 71,2020-10-22,21:00:00,4,2,2,FMN GV 11 Ramsel
66,Bergstraat 71,2020-10-22,22:00:00,10,2,8,FMN GV 11 Ramsel
66,Bergstraat 71,2020-10-22,23:00:00,0,0,0,FMN GV 11 Ramsel
66,Bergstraat 71,2020-10-23,00:00:00,0,0,0,FMN GV 11 Ramsel
66,Bergstraat 71,2020-10-23,01:00:00,0,0,0,FMN GV 11 Ramsel
66,Bergstraat 71,2020-10-23,02:00:00,0,0,0,FMN GV 11 Ramsel
66,Bergstraat 71,2020-10-23,03:00:00,0,0,0,FMN GV 11 Ramsel
66,Bergstraat 71,2020-10-23,04:00:00,0,0,0,FMN GV 11 Ramsel
66,Bergstraat 71,2020-10-23,05:00:00,8,2,6,FMN GV 11 Ramsel
66,Bergstraat 71,2020-10-23,06:00:00,20,8,12,FMN GV 11 Ramsel
66,Bergstraat 71,2020-10-23,07:00:00,196,24,172,FMN GV 11 Ramsel
66,Bergstraat 71,2020-10-23,08:00:00,164,26,138,FMN GV 11 Ramsel
66,Bergstraat 71,2020-10-23,09:00:00,22,12,10,FMN GV 11 Ramsel
66,Bergstraat 71,2020-10-23,10:00:00,56,28,28,FMN GV 11 Ramsel
66,Bergstraat 71,2020-10-23,11:00:00,60,28,32,FMN GV 11 Ramsel
66,Bergstraat 71,2020-10-23,12:00:00,86,58,28,FMN GV 11 Ramsel
66,Bergstraat 71,2020-10-23,13:00:00,176,104,72,FMN GV 11 Ramsel
66,Bergstraat 71,2020-10-23,14:00:00,228,110,118,FMN GV 11 Ramsel
66,Bergstraat 71,2020-10-23,15:00:00,304,236,68,FMN GV 11 Ramsel
66,Bergstraat 71,2020-10-23,16:00:00,188,134,54,FMN GV 11 Ramsel
66,Bergstraat 71,2020-10-23,17:00:00,82,48,34,FMN GV 11 Ramsel
66,Bergstraat 71,2020-10-23,18:00:00,66,26,40,FMN GV 11 Ramsel
66,Bergstraat 71,2020-10-23,19:00:00,20,12,8,FMN GV 11 Ramsel
66,Bergstraat 71,2020-10-23,20:00:00,18,6,12,FMN GV 11 Ramsel
66,Bergstraat 71,2020-10-23,21:00:00,12,6,6,FMN GV 11 Ramsel
66,Bergstraat 71,2020-10-23,22:00:00,8,0,8,FMN GV 11 Ramsel
66,Bergstraat 71,2020-10-23,23:00:00,12,8,4,FMN GV 11 Ramsel
66,Bergstraat 71,2020-10-24,00:00:00,2,2,0,FMN GV 11 Ramsel
66,Bergstraat 71,2020-10-24,01:00:00,0,0,0,FMN GV 11 Ramsel
66,Bergstraat 71,2020-10-24,02:00:00,0,0,0,FMN GV 11 Ramsel
66,Bergstraat 71,2020-10-24,03:00:00,0,0,0,FMN GV 11 Ramsel
66,Bergstraat 71,2020-10-24,04:00:00,0,0,0,FMN GV 11 Ramsel
66,Bergstraat 71,2020-10-24,05:00:00,0,0,0,FMN GV 11 Ramsel
66,Bergstraat 71,2020-10-24,06:00:00,8,2,6,FMN GV 11 Ramsel
66,Bergstraat 71,2020-10-24,07:00:00,2,2,0,FMN GV 11 Ramsel
66,Bergstraat 71,2020-10-24,08:00:00,18,10,8,FMN GV 11 Ramsel
66,Bergstraat 71,2020-10-24,09:00:00,46,16,30,FMN GV 11 Ramsel
66,Bergstraat 71,2020-10-24,10:00:00,92,32,60,FMN GV 11 Ramsel
66,Bergstraat 71,2020-10-24,11:00:00,76,36,40,FMN GV 11 Ramsel
66,Bergstraat 71,2020-10-24,12:00:00,92,36,56,FMN GV 11 Ramsel
66,Bergstraat 71,2020-10-24,13:00:00,200,100,100,FMN GV 11 Ramsel
66,Bergstraat 71,2020-10-24,14:00:00,182,92,90,FMN GV 11 Ramsel
66,Bergstraat 71,2020-10-24,15:00:00,96,56,40,FMN GV 11 Ramsel
66,Bergstraat 71,2020-10-24,16:00:00,102,52,50,FMN GV 11 Ramsel
66,Bergstraat 71,2020-10-24,17:00:00,56,24,32,FMN GV 11 Ramsel
66,Bergstraat 71,2020-10-24,18:00:00,30,18,12,FMN GV 11 Ramsel
66,Bergstraat 71,2020-10-24,19:00:00,26,12,14,FMN GV 11 Ramsel
66,Bergstraat 71,2020-10-24,20:00:00,8,4,4,FMN GV 11 Ramsel
66,Bergstraat 71,2020-10-24,21:00:00,14,4,10,FMN GV 11 Ramsel
66,Bergstraat 71,2020-10-24,22:00:00,4,4,0,FMN GV 11 Ramsel
66,Bergstraat 71,2020-10-24,23:00:00,2,2,0,FMN GV 11 Ramsel
66,Bergstraat 71,2020-10-25,00:00:00,2,2,0,FMN GV 11 Ramsel
66,Bergstraat 71,2020-10-25,01:00:00,0,0,0,FMN GV 11 Ramsel
66,Bergstraat 71,2020-10-25,02:00:00,0,0,0,FMN GV 11 Ramsel
66,Bergstraat 71,2020-10-25,03:00:00,0,0,0,FMN GV 11 Ramsel
66,Bergstraat 71,2020-10-25,04:00:00,0,0,0,FMN GV 11 Ramsel
66,Bergstraat 71,2020-10-25,05:00:00,2,2,0,FMN GV 11 Ramsel
66,Bergstraat 71,2020-10-25,06:00:00,2,0,2,FMN GV 11 Ramsel
66,Bergstraat 71,2020-10-25,07:00:00,8,2,6,FMN GV 11 Ramsel
66,Bergstraat 71,2020-10-25,08:00:00,26,4,22,FMN GV 11 Ramsel
66,Bergstraat 71,2020-10-25,09:00:00,72,22,50,FMN GV 11 Ramsel
66,Bergstraat 71,2020-10-25,10:00:00,46,26,20,FMN GV 11 Ramsel
66,Bergstraat 71,2020-10-25,11:00:00,76,60,16,FMN GV 11 Ramsel
66,Bergstraat 71,2020-10-25,12:00:00,46,38,8,FMN GV 11 Ramsel
66,Bergstraat 71,2020-10-25,13:00:00,22,10,12,FMN GV 11 Ramsel
66,Bergstraat 71,2020-10-25,14:00:00,50,20,30,FMN GV 11 Ramsel
66,Bergstraat 71,2020-10-25,15:00:00,84,46,38,FMN GV 11 Ramsel
66,Bergstraat 71,2020-10-25,16:00:00,66,26,40,FMN GV 11 Ramsel
66,Bergstraat 71,2020-10-25,17:00:00,16,8,8,FMN GV 11 Ramsel
66,Bergstraat 71,2020-10-25,18:00:00,16,8,8,FMN GV 11 Ramsel
66,Bergstraat 71,2020-10-25,19:00:00,10,4,6,FMN GV 11 Ramsel
66,Bergstraat 71,2020-10-25,20:00:00,6,2,4,FMN GV 11 Ramsel
66,Bergstraat 71,2020-10-25,21:00:00,2,2,0,FMN GV 11 Ramsel
66,Bergstraat 71,2020-10-25,22:00:00,0,0,0,FMN GV 11 Ramsel
66,Bergstraat 71,2020-10-25,23:00:00,0,0,0,FMN GV 11 Ramsel
66,Bergstraat 71,2020-10-26,00:00:00,0,0,0,FMN GV 11 Ramsel
66,Bergstraat 71,2020-10-26,01:00:00,0,0,0,FMN GV 11 Ramsel
66,Bergstraat 71,2020-10-26,02:00:00,0,0,0,FMN GV 11 Ramsel
66,Bergstraat 71,2020-10-26,03:00:00,0,0,0,FMN GV 11 Ramsel
66,Bergstraat 71,2020-10-26,04:00:00,2,2,0,FMN GV 11 Ramsel
66,Bergstraat 71,2020-10-26,05:00:00,10,6,4,FMN GV 11 Ramsel
66,Bergstraat 71,2020-10-26,06:00:00,26,8,18,FMN GV 11 Ramsel
66,Bergstraat 71,2020-10-26,07:00:00,160,20,140,FMN GV 11 Ramsel
66,Bergstraat 71,2020-10-26,08:00:00,142,22,120,FMN GV 11 Ramsel
66,Bergstraat 71,2020-10-26,09:00:00,48,22,26,FMN GV 11 Ramsel
66,Bergstraat 71,2020-10-26,10:00:00,62,24,38,FMN GV 11 Ramsel
66,Bergstraat 71,2020-10-26,11:00:00,38,14,24,FMN GV 11 Ramsel
66,Bergstraat 71,2020-10-26,12:00:00,94,42,52,FMN GV 11 Ramsel
66,Bergstraat 71,2020-10-26,13:00:00,118,70,48,FMN GV 11 Ramsel
66,Bergstraat 71,2020-10-26,14:00:00,142,70,72,FMN GV 11 Ramsel
66,Bergstraat 71,2020-10-26,15:00:00,268,224,44,FMN GV 11 Ramsel
66,Bergstraat 71,2020-10-26,16:00:00,124,92,32,FMN GV 11 Ramsel
66,Bergstraat 71,2020-10-26,17:00:00,50,26,24,FMN GV 11 Ramsel
66,Bergstraat 71,2020-10-26,18:00:00,14,8,6,FMN GV 11 Ramsel
66,Bergstraat 71,2020-10-26,19:00:00,16,4,12,FMN GV 11 Ramsel
66,Bergstraat 71,2020-10-26,20:00:00,14,8,6,FMN GV 11 Ramsel
66,Bergstraat 71,2020-10-26,21:00:00,12,4,8,FMN GV 11 Ramsel
66,Bergstraat 71,2020-10-26,22:00:00,12,8,4,FMN GV 11 Ramsel
66,Bergstraat 71,2020-10-26,23:00:00,2,2,0,FMN GV 11 Ramsel
66,Bergstraat 71,2020-10-27,00:00:00,0,0,0,FMN GV 11 Ramsel
66,Bergstraat 71,2020-10-27,01:00:00,0,0,0,FMN GV 11 Ramsel
66,Bergstraat 71,2020-10-27,02:00:00,0,0,0,FMN GV 11 Ramsel
66,Bergstraat 71,2020-10-27,03:00:00,0,0,0,FMN GV 11 Ramsel
66,Bergstraat 71,2020-10-27,04:00:00,6,4,2,FMN GV 11 Ramsel
66,Bergstraat 71,2020-10-27,05:00:00,8,8,0,FMN GV 11 Ramsel
66,Bergstraat 71,2020-10-27,06:00:00,34,14,20,FMN GV 11 Ramsel
66,Bergstraat 71,2020-10-27,07:00:00,172,20,152,FMN GV 11 Ramsel
66,Bergstraat 71,2020-10-27,08:00:00,150,16,134,FMN GV 11 Ramsel
66,Bergstraat 71,2020-10-27,09:00:00,64,28,36,FMN GV 11 Ramsel
66,Bergstraat 71,2020-10-27,10:00:00,58,18,40,FMN GV 11 Ramsel
66,Bergstraat 71,2020-10-27,11:00:00,68,22,46,FMN GV 11 Ramsel
66,Bergstraat 71,2020-10-27,12:00:00,56,32,24,FMN GV 11 Ramsel
66,Bergstraat 71,2020-10-27,13:00:00,100,52,48,FMN GV 11 Ramsel
66,Bergstraat 71,2020-10-27,14:00:00,104,58,46,FMN GV 11 Ramsel
66,Bergstraat 71,2020-10-27,15:00:00,256,230,26,FMN GV 11 Ramsel
66,Bergstraat 71,2020-10-27,16:00:00,94,76,18,FMN GV 11 Ramsel
66,Bergstraat 71,2020-10-27,17:00:00,54,36,18,FMN GV 11 Ramsel
66,Bergstraat 71,2020-10-27,18:00:00,24,10,14,FMN GV 11 Ramsel
66,Bergstraat 71,2020-10-27,19:00:00,18,6,12,FMN GV 11 Ramsel
66,Bergstraat 71,2020-10-27,20:00:00,34,20,14,FMN GV 11 Ramsel
66,Bergstraat 71,2020-10-27,21:00:00,8,6,2,FMN GV 11 Ramsel
66,Bergstraat 71,2020-10-27,22:00:00,4,2,2,FMN GV 11 Ramsel
66,Bergstraat 71,2020-10-27,23:00:00,2,2,0,FMN GV 11 Ramsel
66,Bergstraat 71,2020-10-28,00:00:00,0,0,0,FMN GV 11 Ramsel
66,Bergstraat 71,2020-10-28,01:00:00,0,0,0,FMN GV 11 Ramsel
66,Bergstraat 71,2020-10-28,02:00:00,0,0,0,FMN GV 11 Ramsel
66,Bergstraat 71,2020-10-28,03:00:00,0,0,0,FMN GV 11 Ramsel
66,Bergstraat 71,2020-10-28,04:00:00,6,4,2,FMN GV 11 Ramsel
66,Bergstraat 71,2020-10-28,05:00:00,8,6,2,FMN GV 11 Ramsel
66,Bergstraat 71,2020-10-28,06:00:00,26,6,20,FMN GV 11 Ramsel
66,Bergstraat 71,2020-10-28,07:00:00,168,8,160,FMN GV 11 Ramsel
66,Bergstraat 71,2020-10-28,08:00:00,172,16,156,FMN GV 11 Ramsel
66,Bergstraat 71,2020-10-28,09:00:00,38,14,24,FMN GV 11 Ramsel
66,Bergstraat 71,2020-10-28,10:00:00,42,16,26,FMN GV 11 Ramsel
66,Bergstraat 71,2020-10-28,11:00:00,42,28,14,FMN GV 11 Ramsel
66,Bergstraat 71,2020-10-28,12:00:00,270,208,62,FMN GV 11 Ramsel
66,Bergstraat 71,2020-10-28,13:00:00,124,72,52,FMN GV 11 Ramsel
66,Bergstraat 71,2020-10-28,14:00:00,78,36,42,FMN GV 11 Ramsel
66,Bergstraat 71,2020-10-28,15:00:00,88,54,34,FMN GV 11 Ramsel
66,Bergstraat 71,2020-10-28,16:00:00,70,38,32,FMN GV 11 Ramsel
66,Bergstraat 71,2020-10-28,17:00:00,24,20,4,FMN GV 11 Ramsel
66,Bergstraat 71,2020-10-28,18:00:00,24,14,10,FMN GV 11 Ramsel
66,Bergstraat 71,2020-10-28,19:00:00,8,6,2,FMN GV 11 Ramsel
66,Bergstraat 71,2020-10-28,20:00:00,12,4,8,FMN GV 11 Ramsel
66,Bergstraat 71,2020-10-28,21:00:00,4,2,2,FMN GV 11 Ramsel
66,Bergstraat 71,2020-10-28,22:00:00,12,6,6,FMN GV 11 Ramsel
66,Bergstraat 71,2020-10-28,23:00:00,2,2,0,FMN GV 11 Ramsel
66,Bergstraat 71,2020-10-29,00:00:00,0,0,0,FMN GV 11 Ramsel
66,Bergstraat 71,2020-10-29,01:00:00,0,0,0,FMN GV 11 Ramsel
66,Bergstraat 71,2020-10-29,02:00:00,0,0,0,FMN GV 11 Ramsel
66,Bergstraat 71,2020-10-29,03:00:00,0,0,0,FMN GV 11 Ramsel
66,Bergstraat 71,2020-10-29,04:00:00,2,0,2,FMN GV 11 Ramsel
66,Bergstraat 71,2020-10-29,05:00:00,10,8,2,FMN GV 11 Ramsel
66,Bergstraat 71,2020-10-29,06:00:00,26,10,16,FMN GV 11 Ramsel
66,Bergstraat 71,2020-10-29,07:00:00,148,8,140,FMN GV 11 Ramsel
66,Bergstraat 71,2020-10-29,08:00:00,114,10,104,FMN GV 11 Ramsel
66,Bergstraat 71,2020-10-29,09:00:00,56,22,34,FMN GV 11 Ramsel
66,Bergstraat 71,2020-10-29,10:00:00,40,18,22,FMN GV 11 Ramsel
66,Bergstraat 71,2020-10-29,11:00:00,54,34,20,FMN GV 11 Ramsel
66,Bergstraat 71,2020-10-29,12:00:00,78,54,24,FMN GV 11 Ramsel
66,Bergstraat 71,2020-10-29,13:00:00,72,26,46,FMN GV 11 Ramsel
66,Bergstraat 71,2020-10-29,14:00:00,50,28,22,FMN GV 11 Ramsel
66,Bergstraat 71,2020-10-29,15:00:00,176,162,14,FMN GV 11 Ramsel
66,Bergstraat 71,2020-10-29,16:00:00,82,66,16,FMN GV 11 Ramsel
66,Bergstraat 71,2020-10-29,17:00:00,28,24,4,FMN GV 11 Ramsel
66,Bergstraat 71,2020-10-29,18:00:00,6,0,6,FMN GV 11 Ramsel
66,Bergstraat 71,2020-10-29,19:00:00,18,10,8,FMN GV 11 Ramsel
66,Bergstraat 71,2020-10-29,20:00:00,8,4,4,FMN GV 11 Ramsel
66,Bergstraat 71,2020-10-29,21:00:00,2,0,2,FMN GV 11 Ramsel
66,Bergstraat 71,2020-10-29,22:00:00,8,6,2,FMN GV 11 Ramsel
66,Bergstraat 71,2020-10-29,23:00:00,2,2,0,FMN GV 11 Ramsel
66,Bergstraat 71,2020-10-30,00:00:00,0,0,0,FMN GV 11 Ramsel
66,Bergstraat 71,2020-10-30,01:00:00,0,0,0,FMN GV 11 Ramsel
66,Bergstraat 71,2020-10-30,02:00:00,0,0,0,FMN GV 11 Ramsel
66,Bergstraat 71,2020-10-30,03:00:00,0,0,0,FMN GV 11 Ramsel
66,Bergstraat 71,2020-10-30,04:00:00,0,0,0,FMN GV 11 Ramsel
66,Bergstraat 71,2020-10-30,05:00:00,8,8,0,FMN GV 11 Ramsel
66,Bergstraat 71,2020-10-30,06:00:00,26,10,16,FMN GV 11 Ramsel
66,Bergstraat 71,2020-10-30,07:00:00,136,8,128,FMN GV 11 Ramsel
66,Bergstraat 71,2020-10-30,08:00:00,146,12,134,FMN GV 11 Ramsel
66,Bergstraat 71,2020-10-30,09:00:00,30,6,24,FMN GV 11 Ramsel
66,Bergstraat 71,2020-10-30,10:00:00,56,30,26,FMN GV 11 Ramsel
66,Bergstraat 71,2020-10-30,11:00:00,54,26,28,FMN GV 11 Ramsel
66,Bergstraat 71,2020-10-30,12:00:00,62,36,26,FMN GV 11 Ramsel
66,Bergstraat 71,2020-10-30,13:00:00,84,54,30,FMN GV 11 Ramsel
66,Bergstraat 71,2020-10-30,14:00:00,134,84,50,FMN GV 11 Ramsel
66,Bergstraat 71,2020-10-30,15:00:00,210,166,44,FMN GV 11 Ramsel
66,Bergstraat 71,2020-10-30,16:00:00,126,98,28,FMN GV 11 Ramsel
66,Bergstraat 71,2020-10-30,17:00:00,48,24,24,FMN GV 11 Ramsel
66,Bergstraat 71,2020-10-30,18:00:00,28,14,14,FMN GV 11 Ramsel
66,Bergstraat 71,2020-10-30,19:00:00,18,6,12,FMN GV 11 Ramsel
66,Bergstraat 71,2020-10-30,20:00:00,22,12,10,FMN GV 11 Ramsel
66,Bergstraat 71,2020-10-30,21:00:00,14,10,4,FMN GV 11 Ramsel
66,Bergstraat 71,2020-10-30,22:00:00,4,4,0,FMN GV 11 Ramsel
66,Bergstraat 71,2020-10-30,23:00:00,2,0,2,FMN GV 11 Ramsel
66,Bergstraat 71,2020-10-31,00:00:00,2,2,0,FMN GV 11 Ramsel
66,Bergstraat 71,2020-10-31,01:00:00,0,0,0,FMN GV 11 Ramsel
66,Bergstraat 71,2020-10-31,02:00:00,2,2,0,FMN GV 11 Ramsel
66,Bergstraat 71,2020-10-31,03:00:00,2,0,2,FMN GV 11 Ramsel
66,Bergstraat 71,2020-10-31,04:00:00,0,0,0,FMN GV 11 Ramsel
66,Bergstraat 71,2020-10-31,05:00:00,0,0,0,FMN GV 11 Ramsel
66,Bergstraat 71,2020-10-31,06:00:00,6,2,4,FMN GV 11 Ramsel
66,Bergstraat 71,2020-10-31,07:00:00,12,4,8,FMN GV 11 Ramsel
66,Bergstraat 71,2020-10-31,08:00:00,42,14,28,FMN GV 11 Ramsel
66,Bergstraat 71,2020-10-31,09:00:00,94,30,64,FMN GV 11 Ramsel
66,Bergstraat 71,2020-10-31,10:00:00,174,70,104,FMN GV 11 Ramsel
66,Bergstraat 71,2020-10-31,11:00:00,254,108,146,FMN GV 11 Ramsel
66,Bergstraat 71,2020-10-31,12:00:00,234,106,128,FMN GV 11 Ramsel
66,Bergstraat 71,2020-10-31,13:00:00,328,132,196,FMN GV 11 Ramsel
66,Bergstraat 71,2020-10-31,14:00:00,378,206,172,FMN GV 11 Ramsel
66,Bergstraat 71,2020-10-31,15:00:00,272,158,114,FMN GV 11 Ramsel
66,Bergstraat 71,2020-10-31,16:00:00,196,124,72,FMN GV 11 Ramsel
66,Bergstraat 71,2020-10-31,17:00:00,74,62,12,FMN GV 11 Ramsel
66,Bergstraat 71,2020-10-31,18:00:00,20,16,4,FMN GV 11 Ramsel
66,Bergstraat 71,2020-10-31,19:00:00,8,8,0,FMN GV 11 Ramsel
66,Bergstraat 71,2020-10-31,20:00:00,6,4,2,FMN GV 11 Ramsel
66,Bergstraat 71,2020-10-31,21:00:00,6,2,4,FMN GV 11 Ramsel
66,Bergstraat 71,2020-10-31,22:00:00,2,2,0,FMN GV 11 Ramsel
66,Bergstraat 71,2020-10-31,23:00:00,10,4,6,FMN GV 11 Ramsel
66,Bergstraat 71,2020-11-01,00:00:00,2,2,0,FMN GV 11 Ramsel
66,Bergstraat 71,2020-11-01,01:00:00,0,0,0,FMN GV 11 Ramsel
66,Bergstraat 71,2020-11-01,02:00:00,0,0,0,FMN GV 11 Ramsel
66,Bergstraat 71,2020-11-01,03:00:00,0,0,0,FMN GV 11 Ramsel
66,Bergstraat 71,2020-11-01,04:00:00,0,0,0,FMN GV 11 Ramsel
66,Bergstraat 71,2020-11-01,05:00:00,0,0,0,FMN GV 11 Ramsel
66,Bergstraat 71,2020-11-01,06:00:00,6,2,4,FMN GV 11 Ramsel
66,Bergstraat 71,2020-11-01,07:00:00,10,2,8,FMN GV 11 Ramsel
66,Bergstraat 71,2020-11-01,08:00:00,58,26,32,FMN GV 11 Ramsel
66,Bergstraat 71,2020-11-01,09:00:00,118,38,80,FMN GV 11 Ramsel
66,Bergstraat 71,2020-11-01,10:00:00,140,74,66,FMN GV 11 Ramsel
66,Bergstraat 71,2020-11-01,11:00:00,128,88,40,FMN GV 11 Ramsel
66,Bergstraat 71,2020-11-01,12:00:00,70,56,14,FMN GV 11 Ramsel
66,Bergstraat 71,2020-11-01,13:00:00,26,16,10,FMN GV 11 Ramsel
66,Bergstraat 71,2020-11-01,14:00:00,50,24,26,FMN GV 11 Ramsel
66,Bergstraat 71,2020-11-01,15:00:00,60,34,26,FMN GV 11 Ramsel
66,Bergstraat 71,2020-11-01,16:00:00,64,24,40,FMN GV 11 Ramsel
66,Bergstraat 71,2020-11-01,17:00:00,18,8,10,FMN GV 11 Ramsel
66,Bergstraat 71,2020-11-01,18:00:00,6,6,0,FMN GV 11 Ramsel
66,Bergstraat 71,2020-11-01,19:00:00,10,2,8,FMN GV 11 Ramsel
66,Bergstraat 71,2020-11-01,20:00:00,4,2,2,FMN GV 11 Ramsel
66,Bergstraat 71,2020-11-01,21:00:00,0,0,0,FMN GV 11 Ramsel
66,Bergstraat 71,2020-11-01,22:00:00,6,6,0,FMN GV 11 Ramsel
66,Bergstraat 71,2020-11-01,23:00:00,6,4,2,FMN GV 11 Ramsel
66,Bergstraat 71,2020-11-02,00:00:00,2,0,2,FMN GV 11 Ramsel
66,Bergstraat 71,2020-11-02,01:00:00,0,0,0,FMN GV 11 Ramsel
66,Bergstraat 71,2020-11-02,02:00:00,0,0,0,FMN GV 11 Ramsel
66,Bergstraat 71,2020-11-02,03:00:00,0,0,0,FMN GV 11 Ramsel
66,Bergstraat 71,2020-11-02,04:00:00,0,0,0,FMN GV 11 Ramsel
66,Bergstraat 71,2020-11-02,05:00:00,4,2,2,FMN GV 11 Ramsel
66,Bergstraat 71,2020-11-02,06:00:00,20,12,8,FMN GV 11 Ramsel
66,Bergstraat 71,2020-11-02,07:00:00,16,4,12,FMN GV 11 Ramsel
66,Bergstraat 71,2020-11-02,08:00:00,28,6,22,FMN GV 11 Ramsel
66,Bergstraat 71,2020-11-02,09:00:00,44,12,32,FMN GV 11 Ramsel
66,Bergstraat 71,2020-11-02,10:00:00,102,40,62,FMN GV 11 Ramsel
66,Bergstraat 71,2020-11-02,11:00:00,42,22,20,FMN GV 11 Ramsel
66,Bergstraat 71,2020-11-02,12:00:00,68,38,30,FMN GV 11 Ramsel
66,Bergstraat 71,2020-11-02,13:00:00,64,32,32,FMN GV 11 Ramsel
66,Bergstraat 71,2020-11-02,14:00:00,76,46,30,FMN GV 11 Ramsel
66,Bergstraat 71,2020-11-02,15:00:00,28,14,14,FMN GV 11 Ramsel
66,Bergstraat 71,2020-11-02,16:00:00,44,26,18,FMN GV 11 Ramsel
66,Bergstraat 71,2020-11-02,17:00:00,22,12,10,FMN GV 11 Ramsel
66,Bergstraat 71,2020-11-02,18:00:00,8,4,4,FMN GV 11 Ramsel
66,Bergstraat 71,2020-11-02,19:00:00,18,4,14,FMN GV 11 Ramsel
66,Bergstraat 71,2020-11-02,20:00:00,2,0,2,FMN GV 11 Ramsel
66,Bergstraat 71,2020-11-02,21:00:00,24,12,12,FMN GV 11 Ramsel
66,Bergstraat 71,2020-11-02,22:00:00,8,4,4,FMN GV 11 Ramsel
66,Bergstraat 71,2020-11-02,23:00:00,0,0,0,FMN GV 11 Ramsel
66,Bergstraat 71,2020-11-03,00:00:00,0,0,0,FMN GV 11 Ramsel
66,Bergstraat 71,2020-11-03,01:00:00,0,0,0,FMN GV 11 Ramsel
66,Bergstraat 71,2020-11-03,02:00:00,0,0,0,FMN GV 11 Ramsel
66,Bergstraat 71,2020-11-03,03:00:00,0,0,0,FMN GV 11 Ramsel
66,Bergstraat 71,2020-11-03,04:00:00,4,2,2,FMN GV 11 Ramsel
66,Bergstraat 71,2020-11-03,05:00:00,6,4,2,FMN GV 11 Ramsel
66,Bergstraat 71,2020-11-03,06:00:00,32,14,18,FMN GV 11 Ramsel
66,Bergstraat 71,2020-11-03,07:00:00,32,10,22,FMN GV 11 Ramsel
66,Bergstraat 71,2020-11-03,08:00:00,18,6,12,FMN GV 11 Ramsel
66,Bergstraat 71,2020-11-03,09:00:00,68,22,46,FMN GV 11 Ramsel
66,Bergstraat 71,2020-11-03,10:00:00,86,32,54,FMN GV 11 Ramsel
66,Bergstraat 71,2020-11-03,11:00:00,110,60,50,FMN GV 11 Ramsel
66,Bergstraat 71,2020-11-03,12:00:00,114,62,52,FMN GV 11 Ramsel
66,Bergstraat 71,2020-11-03,13:00:00,206,98,108,FMN GV 11 Ramsel
66,Bergstraat 71,2020-11-03,14:00:00,112,52,60,FMN GV 11 Ramsel
66,Bergstraat 71,2020-11-03,15:00:00,124,64,60,FMN GV 11 Ramsel
66,Bergstraat 71,2020-11-03,16:00:00,86,50,36,FMN GV 11 Ramsel
66,Bergstraat 71,2020-11-03,17:00:00,46,28,18,FMN GV 11 Ramsel
66,Bergstraat 71,2020-11-03,18:00:00,24,12,12,FMN GV 11 Ramsel
66,Bergstraat 71,2020-11-03,19:00:00,30,8,22,FMN GV 11 Ramsel
66,Bergstraat 71,2020-11-03,20:00:00,28,20,8,FMN GV 11 Ramsel
66,Bergstraat 71,2020-11-03,21:00:00,4,0,4,FMN GV 11 Ramsel
66,Bergstraat 71,2020-11-03,22:00:00,10,4,6,FMN GV 11 Ramsel
66,Bergstraat 71,2020-11-03,23:00:00,2,2,0,FMN GV 11 Ramsel
66,Bergstraat 71,2020-11-04,00:00:00,0,0,0,FMN GV 11 Ramsel
66,Bergstraat 71,2020-11-04,01:00:00,0,0,0,FMN GV 11 Ramsel
66,Bergstraat 71,2020-11-04,02:00:00,0,0,0,FMN GV 11 Ramsel
66,Bergstraat 71,2020-11-04,03:00:00,0,0,0,FMN GV 11 Ramsel
66,Bergstraat 71,2020-11-04,04:00:00,2,2,0,FMN GV 11 Ramsel
66,Bergstraat 71,2020-11-04,05:00:00,4,2,2,FMN GV 11 Ramsel
66,Bergstraat 71,2020-11-04,06:00:00,20,10,10,FMN GV 11 Ramsel
66,Bergstraat 71,2020-11-04,07:00:00,26,8,18,FMN GV 11 Ramsel
66,Bergstraat 71,2020-11-04,08:00:00,32,10,22,FMN GV 11 Ramsel
66,Bergstraat 71,2020-11-04,09:00:00,32,10,22,FMN GV 11 Ramsel
66,Bergstraat 71,2020-11-04,10:00:00,60,26,34,FMN GV 11 Ramsel
66,Bergstraat 71,2020-11-04,11:00:00,102,46,56,FMN GV 11 Ramsel
66,Bergstraat 71,2020-11-04,12:00:00,112,60,52,FMN GV 11 Ramsel
66,Bergstraat 71,2020-11-04,13:00:00,230,106,124,FMN GV 11 Ramsel
66,Bergstraat 71,2020-11-04,14:00:00,256,114,142,FMN GV 11 Ramsel
66,Bergstraat 71,2020-11-04,15:00:00,254,152,102,FMN GV 11 Ramsel
66,Bergstraat 71,2020-11-04,16:00:00,158,88,70,FMN GV 11 Ramsel
66,Bergstraat 71,2020-11-04,17:00:00,98,66,32,FMN GV 11 Ramsel
66,Bergstraat 71,2020-11-04,18:00:00,28,2,26,FMN GV 11 Ramsel
66,Bergstraat 71,2020-11-04,19:00:00,30,14,16,FMN GV 11 Ramsel
66,Bergstraat 71,2020-11-04,20:00:00,22,12,10,FMN GV 11 Ramsel
66,Bergstraat 71,2020-11-04,21:00:00,8,6,2,FMN GV 11 Ramsel
66,Bergstraat 71,2020-11-04,22:00:00,18,8,10,FMN GV 11 Ramsel
66,Bergstraat 71,2020-11-04,23:00:00,2,2,0,FMN GV 11 Ramsel
66,Bergstraat 71,2020-11-05,00:00:00,0,0,0,FMN GV 11 Ramsel
66,Bergstraat 71,2020-11-05,01:00:00,0,0,0,FMN GV 11 Ramsel
66,Bergstraat 71,2020-11-05,02:00:00,0,0,0,FMN GV 11 Ramsel
66,Bergstraat 71,2020-11-05,03:00:00,2,0,2,FMN GV 11 Ramsel
66,Bergstraat 71,2020-11-05,04:00:00,0,0,0,FMN GV 11 Ramsel
66,Bergstraat 71,2020-11-05,05:00:00,8,4,4,FMN GV 11 Ramsel
66,Bergstraat 71,2020-11-05,06:00:00,20,6,14,FMN GV 11 Ramsel
66,Bergstraat 71,2020-11-05,07:00:00,20,4,16,FMN GV 11 Ramsel
66,Bergstraat 71,2020-11-05,08:00:00,26,10,16,FMN GV 11 Ramsel
66,Bergstraat 71,2020-11-05,09:00:00,24,6,18,FMN GV 11 Ramsel
66,Bergstraat 71,2020-11-05,10:00:00,58,24,34,FMN GV 11 Ramsel
66,Bergstraat 71,2020-11-05,11:00:00,64,30,34,FMN GV 11 Ramsel
66,Bergstraat 71,2020-11-05,12:00:00,102,46,56,FMN GV 11 Ramsel
66,Bergstraat 71,2020-11-05,13:00:00,236,88,148,FMN GV 11 Ramsel
66,Bergstraat 71,2020-11-05,14:00:00,230,96,134,FMN GV 11 Ramsel
66,Bergstraat 71,2020-11-05,15:00:00,222,122,100,FMN GV 11 Ramsel
66,Bergstraat 71,2020-11-05,16:00:00,126,66,60,FMN GV 11 Ramsel
66,Bergstraat 71,2020-11-05,17:00:00,74,38,36,FMN GV 11 Ramsel
66,Bergstraat 71,2020-11-05,18:00:00,20,8,12,FMN GV 11 Ramsel
66,Bergstraat 71,2020-11-05,19:00:00,10,4,6,FMN GV 11 Ramsel
66,Bergstraat 71,2020-11-05,20:00:00,6,4,2,FMN GV 11 Ramsel
66,Bergstraat 71,2020-11-05,21:00:00,12,12,0,FMN GV 11 Ramsel
66,Bergstraat 71,2020-11-05,22:00:00,16,8,8,FMN GV 11 Ramsel
66,Bergstraat 71,2020-11-05,23:00:00,0,0,0,FMN GV 11 Ramsel
66,Bergstraat 71,2020-11-06,00:00:00,0,0,0,FMN GV 11 Ramsel
66,Bergstraat 71,2020-11-06,01:00:00,0,0,0,FMN GV 11 Ramsel
66,Bergstraat 71,2020-11-06,02:00:00,0,0,0,FMN GV 11 Ramsel
66,Bergstraat 71,2020-11-06,03:00:00,0,0,0,FMN GV 11 Ramsel
66,Bergstraat 71,2020-11-06,04:00:00,2,2,0,FMN GV 11 Ramsel
66,Bergstraat 71,2020-11-06,05:00:00,4,2,2,FMN GV 11 Ramsel
66,Bergstraat 71,2020-11-06,06:00:00,22,10,12,FMN GV 11 Ramsel
66,Bergstraat 71,2020-11-06,07:00:00,10,2,8,FMN GV 11 Ramsel
66,Bergstraat 71,2020-11-06,08:00:00,22,4,18,FMN GV 11 Ramsel
66,Bergstraat 71,2020-11-06,09:00:00,30,14,16,FMN GV 11 Ramsel
66,Bergstraat 71,2020-11-06,10:00:00,64,34,30,FMN GV 11 Ramsel
66,Bergstraat 71,2020-11-06,11:00:00,60,20,40,FMN GV 11 Ramsel
66,Bergstraat 71,2020-11-06,12:00:00,84,44,40,FMN GV 11 Ramsel
66,Bergstraat 71,2020-11-06,13:00:00,194,86,108,FMN GV 11 Ramsel
66,Bergstraat 71,2020-11-06,14:00:00,266,140,126,FMN GV 11 Ramsel
66,Bergstraat 71,2020-11-06,15:00:00,238,120,118,FMN GV 11 Ramsel
66,Bergstraat 71,2020-11-06,16:00:00,140,80,60,FMN GV 11 Ramsel
66,Bergstraat 71,2020-11-06,17:00:00,96,56,40,FMN GV 11 Ramsel
66,Bergstraat 71,2020-11-06,18:00:00,32,26,6,FMN GV 11 Ramsel
66,Bergstraat 71,2020-11-06,19:00:00,32,16,16,FMN GV 11 Ramsel
66,Bergstraat 71,2020-11-06,20:00:00,8,0,8,FMN GV 11 Ramsel
66,Bergstraat 71,2020-11-06,21:00:00,2,0,2,FMN GV 11 Ramsel
66,Bergstraat 71,2020-11-06,22:00:00,2,2,0,FMN GV 11 Ramsel
66,Bergstraat 71,2020-11-06,23:00:00,10,6,4,FMN GV 11 Ramsel
66,Bergstraat 71,2020-11-07,00:00:00,2,2,0,FMN GV 11 Ramsel
66,Bergstraat 71,2020-11-07,01:00:00,0,0,0,FMN GV 11 Ramsel
66,Bergstraat 71,2020-11-07,02:00:00,0,0,0,FMN GV 11 Ramsel
66,Bergstraat 71,2020-11-07,03:00:00,0,0,0,FMN GV 11 Ramsel
66,Bergstraat 71,2020-11-07,04:00:00,0,0,0,FMN GV 11 Ramsel
66,Bergstraat 71,2020-11-07,05:00:00,0,0,0,FMN GV 11 Ramsel
66,Bergstraat 71,2020-11-07,06:00:00,4,0,4,FMN GV 11 Ramsel
66,Bergstraat 71,2020-11-07,07:00:00,10,4,6,FMN GV 11 Ramsel
66,Bergstraat 71,2020-11-07,08:00:00,18,6,12,FMN GV 11 Ramsel
66,Bergstraat 71,2020-11-07,09:00:00,72,34,38,FMN GV 11 Ramsel
66,Bergstraat 71,2020-11-07,10:00:00,194,62,132,FMN GV 11 Ramsel
66,Bergstraat 71,2020-11-07,11:00:00,172,88,84,FMN GV 11 Ramsel
66,Bergstraat 71,2020-11-07,12:00:00,220,102,118,FMN GV 11 Ramsel
66,Bergstraat 71,2020-11-07,13:00:00,414,180,234,FMN GV 11 Ramsel
66,Bergstraat 71,2020-11-07,14:00:00,462,236,226,FMN GV 11 Ramsel
66,Bergstraat 71,2020-11-07,15:00:00,388,240,148,FMN GV 11 Ramsel
66,Bergstraat 71,2020-11-07,16:00:00,300,182,118,FMN GV 11 Ramsel
66,Bergstraat 71,2020-11-07,17:00:00,64,50,14,FMN GV 11 Ramsel
66,Bergstraat 71,2020-11-07,18:00:00,10,4,6,FMN GV 11 Ramsel
66,Bergstraat 71,2020-11-07,19:00:00,16,8,8,FMN GV 11 Ramsel
66,Bergstraat 71,2020-11-07,20:00:00,8,0,8,FMN GV 11 Ramsel
66,Bergstraat 71,2020-11-07,21:00:00,8,6,2,FMN GV 11 Ramsel
66,Bergstraat 71,2020-11-07,22:00:00,4,4,0,FMN GV 11 Ramsel
66,Bergstraat 71,2020-11-07,23:00:00,2,0,2,FMN GV 11 Ramsel
66,Bergstraat 71,2020-11-08,00:00:00,2,2,0,FMN GV 11 Ramsel
66,Bergstraat 71,2020-11-08,01:00:00,4,2,2,FMN GV 11 Ramsel
66,Bergstraat 71,2020-11-08,02:00:00,0,0,0,FMN GV 11 Ramsel
66,Bergstraat 71,2020-11-08,03:00:00,0,0,0,FMN GV 11 Ramsel
66,Bergstraat 71,2020-11-08,04:00:00,2,0,2,FMN GV 11 Ramsel
66,Bergstraat 71,2020-11-08,05:00:00,0,0,0,FMN GV 11 Ramsel
66,Bergstraat 71,2020-11-08,06:00:00,6,4,2,FMN GV 11 Ramsel
66,Bergstraat 71,2020-11-08,07:00:00,10,2,8,FMN GV 11 Ramsel
66,Bergstraat 71,2020-11-08,08:00:00,60,20,40,FMN GV 11 Ramsel
66,Bergstraat 71,2020-11-08,09:00:00,104,26,78,FMN GV 11 Ramsel
66,Bergstraat 71,2020-11-08,10:00:00,190,78,112,FMN GV 11 Ramsel
66,Bergstraat 71,2020-11-08,11:00:00,268,148,120,FMN GV 11 Ramsel
66,Bergstraat 71,2020-11-08,12:00:00,240,174,66,FMN GV 11 Ramsel
66,Bergstraat 71,2020-11-08,13:00:00,204,102,102,FMN GV 11 Ramsel
66,Bergstraat 71,2020-11-08,14:00:00,352,166,186,FMN GV 11 Ramsel
66,Bergstraat 71,2020-11-08,15:00:00,296,162,134,FMN GV 11 Ramsel
66,Bergstraat 71,2020-11-08,16:00:00,188,116,72,FMN GV 11 Ramsel
66,Bergstraat 71,2020-11-08,17:00:00,88,58,30,FMN GV 11 Ramsel
66,Bergstraat 71,2020-11-08,18:00:00,12,8,4,FMN GV 11 Ramsel
66,Bergstraat 71,2020-11-08,19:00:00,4,2,2,FMN GV 11 Ramsel
66,Bergstraat 71,2020-11-08,20:00:00,12,12,0,FMN GV 11 Ramsel
66,Bergstraat 71,2020-11-08,21:00:00,2,2,0,FMN GV 11 Ramsel
66,Bergstraat 71,2020-11-08,22:00:00,0,0,0,FMN GV 11 Ramsel
66,Bergstraat 71,2020-11-08,23:00:00,2,0,2,FMN GV 11 Ramsel
66,Bergstraat 71,2020-11-09,00:00:00,2,0,2,FMN GV 11 Ramsel
66,Bergstraat 71,2020-11-09,01:00:00,0,0,0,FMN GV 11 Ramsel
66,Bergstraat 71,2020-11-09,02:00:00,0,0,0,FMN GV 11 Ramsel
66,Bergstraat 71,2020-11-09,03:00:00,0,0,0,FMN GV 11 Ramsel
66,Bergstraat 71,2020-11-09,04:00:00,4,2,2,FMN GV 11 Ramsel
66,Bergstraat 71,2020-11-09,05:00:00,16,10,6,FMN GV 11 Ramsel
66,Bergstraat 71,2020-11-09,06:00:00,28,10,18,FMN GV 11 Ramsel
66,Bergstraat 71,2020-11-09,07:00:00,30,8,22,FMN GV 11 Ramsel
66,Bergstraat 71,2020-11-09,08:00:00,30,6,24,FMN GV 11 Ramsel
66,Bergstraat 71,2020-11-09,09:00:00,50,14,36,FMN GV 11 Ramsel
66,Bergstraat 71,2020-11-09,10:00:00,84,30,54,FMN GV 11 Ramsel
66,Bergstraat 71,2020-11-09,11:00:00,86,40,46,FMN GV 11 Ramsel
66,Bergstraat 71,2020-11-09,12:00:00,148,60,88,FMN GV 11 Ramsel
66,Bergstraat 71,2020-11-09,13:00:00,260,110,150,FMN GV 11 Ramsel
66,Bergstraat 71,2020-11-09,14:00:00,284,138,146,FMN GV 11 Ramsel
66,Bergstraat 71,2020-11-09,15:00:00,222,118,104,FMN GV 11 Ramsel
66,Bergstraat 71,2020-11-09,16:00:00,154,104,50,FMN GV 11 Ramsel
66,Bergstraat 71,2020-11-09,17:00:00,44,28,16,FMN GV 11 Ramsel
66,Bergstraat 71,2020-11-09,18:00:00,36,20,16,FMN GV 11 Ramsel
66,Bergstraat 71,2020-11-09,19:00:00,12,8,4,FMN GV 11 Ramsel
66,Bergstraat 71,2020-11-09,20:00:00,14,8,6,FMN GV 11 Ramsel
66,Bergstraat 71,2020-11-09,21:00:00,10,10,0,FMN GV 11 Ramsel
66,Bergstraat 71,2020-11-09,22:00:00,8,6,2,FMN GV 11 Ramsel
66,Bergstraat 71,2020-11-09,23:00:00,2,0,2,FMN GV 11 Ramsel
66,Bergstraat 71,2020-11-10,00:00:00,0,0,0,FMN GV 11 Ramsel
66,Bergstraat 71,2020-11-10,01:00:00,2,2,0,FMN GV 11 Ramsel
66,Bergstraat 71,2020-11-10,02:00:00,0,0,0,FMN GV 11 Ramsel
66,Bergstraat 71,2020-11-10,03:00:00,0,0,0,FMN GV 11 Ramsel
66,Bergstraat 71,2020-11-10,04:00:00,2,0,2,FMN GV 11 Ramsel
66,Bergstraat 71,2020-11-10,05:00:00,8,6,2,FMN GV 11 Ramsel
66,Bergstraat 71,2020-11-10,06:00:00,22,8,14,FMN GV 11 Ramsel
66,Bergstraat 71,2020-11-10,07:00:00,32,10,22,FMN GV 11 Ramsel
66,Bergstraat 71,2020-11-10,08:00:00,38,14,24,FMN GV 11 Ramsel
66,Bergstraat 71,2020-11-10,09:00:00,34,8,26,FMN GV 11 Ramsel
66,Bergstraat 71,2020-11-10,10:00:00,66,38,28,FMN GV 11 Ramsel
66,Bergstraat 71,2020-11-10,11:00:00,64,38,26,FMN GV 11 Ramsel
66,Bergstraat 71,2020-11-10,12:00:00,48,18,30,FMN GV 11 Ramsel
66,Bergstraat 71,2020-11-10,13:00:00,248,112,136,FMN GV 11 Ramsel
66,Bergstraat 71,2020-11-10,14:00:00,194,98,96,FMN GV 11 Ramsel
66,Bergstraat 71,2020-11-10,15:00:00,184,118,66,FMN GV 11 Ramsel
66,Bergstraat 71,2020-11-10,16:00:00,38,32,6,FMN GV 11 Ramsel
66,Bergstraat 71,2020-11-10,17:00:00,48,30,18,FMN GV 11 Ramsel
66,Bergstraat 71,2020-11-10,18:00:00,38,14,24,FMN GV 11 Ramsel
66,Bergstraat 71,2020-11-10,19:00:00,20,14,6,FMN GV 11 Ramsel
66,Bergstraat 71,2020-11-10,20:00:00,16,10,6,FMN GV 11 Ramsel
66,Bergstraat 71,2020-11-10,21:00:00,0,0,0,FMN GV 11 Ramsel
66,Bergstraat 71,2020-11-10,22:00:00,10,6,4,FMN GV 11 Ramsel
66,Bergstraat 71,2020-11-10,23:00:00,0,0,0,FMN GV 11 Ramsel
66,Bergstraat 71,2020-11-11,00:00:00,0,0,0,FMN GV 11 Ramsel
66,Bergstraat 71,2020-11-11,01:00:00,0,0,0,FMN GV 11 Ramsel
66,Bergstraat 71,2020-11-11,02:00:00,0,0,0,FMN GV 11 Ramsel
66,Bergstraat 71,2020-11-11,03:00:00,0,0,0,FMN GV 11 Ramsel
66,Bergstraat 71,2020-11-11,04:00:00,2,0,2,FMN GV 11 Ramsel
66,Bergstraat 71,2020-11-11,05:00:00,0,0,0,FMN GV 11 Ramsel
66,Bergstraat 71,2020-11-11,06:00:00,8,2,6,FMN GV 11 Ramsel
66,Bergstraat 71,2020-11-11,07:00:00,14,4,10,FMN GV 11 Ramsel
66,Bergstraat 71,2020-11-11,08:00:00,32,14,18,FMN GV 11 Ramsel
66,Bergstraat 71,2020-11-11,09:00:00,74,22,52,FMN GV 11 Ramsel
66,Bergstraat 71,2020-11-11,10:00:00,128,60,68,FMN GV 11 Ramsel
66,Bergstraat 71,2020-11-11,11:00:00,122,68,54,FMN GV 11 Ramsel
66,Bergstraat 71,2020-11-11,12:00:00,198,98,100,FMN GV 11 Ramsel
66,Bergstraat 71,2020-11-11,13:00:00,214,100,114,FMN GV 11 Ramsel
66,Bergstraat 71,2020-11-11,14:00:00,240,122,118,FMN GV 11 Ramsel
66,Bergstraat 71,2020-11-11,15:00:00,228,122,106,FMN GV 11 Ramsel
66,Bergstraat 71,2020-11-11,16:00:00,158,110,48,FMN GV 11 Ramsel
66,Bergstraat 71,2020-11-11,17:00:00,38,22,16,FMN GV 11 Ramsel
66,Bergstraat 71,2020-11-11,18:00:00,16,4,12,FMN GV 11 Ramsel
66,Bergstraat 71,2020-11-11,19:00:00,12,6,6,FMN GV 11 Ramsel
66,Bergstraat 71,2020-11-11,20:00:00,8,6,2,FMN GV 11 Ramsel
66,Bergstraat 71,2020-11-11,21:00:00,2,2,0,FMN GV 11 Ramsel
66,Bergstraat 71,2020-11-11,22:00:00,4,2,2,FMN GV 11 Ramsel
66,Bergstraat 71,2020-11-11,23:00:00,0,0,0,FMN GV 11 Ramsel
66,Bergstraat 71,2020-11-12,00:00:00,0,0,0,FMN GV 11 Ramsel
66,Bergstraat 71,2020-11-12,01:00:00,0,0,0,FMN GV 11 Ramsel
66,Bergstraat 71,2020-11-12,02:00:00,0,0,0,FMN GV 11 Ramsel
66,Bergstraat 71,2020-11-12,03:00:00,0,0,0,FMN GV 11 Ramsel
66,Bergstraat 71,2020-11-12,04:00:00,2,2,0,FMN GV 11 Ramsel
66,Bergstraat 71,2020-11-12,05:00:00,10,6,4,FMN GV 11 Ramsel
66,Bergstraat 71,2020-11-12,06:00:00,14,6,8,FMN GV 11 Ramsel
66,Bergstraat 71,2020-11-12,07:00:00,24,12,12,FMN GV 11 Ramsel
66,Bergstraat 71,2020-11-12,08:00:00,32,8,24,FMN GV 11 Ramsel
66,Bergstraat 71,2020-11-12,09:00:00,44,16,28,FMN GV 11 Ramsel
66,Bergstraat 71,2020-11-12,10:00:00,58,22,36,FMN GV 11 Ramsel
66,Bergstraat 71,2020-11-12,11:00:00,84,42,42,FMN GV 11 Ramsel
66,Bergstraat 71,2020-11-12,12:00:00,96,46,50,FMN GV 11 Ramsel
66,Bergstraat 71,2020-11-12,13:00:00,148,70,78,FMN GV 11 Ramsel
66,Bergstraat 71,2020-11-12,14:00:00,150,64,86,FMN GV 11 Ramsel
66,Bergstraat 71,2020-11-12,15:00:00,102,72,30,FMN GV 11 Ramsel
66,Bergstraat 71,2020-11-12,16:00:00,90,60,30,FMN GV 11 Ramsel
66,Bergstraat 71,2020-11-12,17:00:00,42,20,22,FMN GV 11 Ramsel
66,Bergstraat 71,2020-11-12,18:00:00,24,12,12,FMN GV 11 Ramsel
66,Bergstraat 71,2020-11-12,19:00:00,18,8,10,FMN GV 11 Ramsel
66,Bergstraat 71,2020-11-12,20:00:00,18,10,8,FMN GV 11 Ramsel
66,Bergstraat 71,2020-11-12,21:00:00,8,4,4,FMN GV 11 Ramsel
66,Bergstraat 71,2020-11-12,22:00:00,8,6,2,FMN GV 11 Ramsel
66,Bergstraat 71,2020-11-12,23:00:00,4,2,2,FMN GV 11 Ramsel
66,Bergstraat 71,2020-11-13,00:00:00,0,0,0,FMN GV 11 Ramsel
66,Bergstraat 71,2020-11-13,01:00:00,0,0,0,FMN GV 11 Ramsel
66,Bergstraat 71,2020-11-13,02:00:00,0,0,0,FMN GV 11 Ramsel
66,Bergstraat 71,2020-11-13,03:00:00,2,0,2,FMN GV 11 Ramsel
66,Bergstraat 71,2020-11-13,04:00:00,0,0,0,FMN GV 11 Ramsel
66,Bergstraat 71,2020-11-13,05:00:00,8,8,0,FMN GV 11 Ramsel
66,Bergstraat 71,2020-11-13,06:00:00,18,4,14,FMN GV 11 Ramsel
66,Bergstraat 71,2020-11-13,07:00:00,28,4,24,FMN GV 11 Ramsel
66,Bergstraat 71,2020-11-13,08:00:00,26,14,12,FMN GV 11 Ramsel
66,Bergstraat 71,2020-11-13,09:00:00,42,6,36,FMN GV 11 Ramsel
66,Bergstraat 71,2020-11-13,10:00:00,94,38,56,FMN GV 11 Ramsel
66,Bergstraat 71,2020-11-13,11:00:00,66,30,36,FMN GV 11 Ramsel
66,Bergstraat 71,2020-11-13,12:00:00,76,32,44,FMN GV 11 Ramsel
66,Bergstraat 71,2020-11-13,13:00:00,74,40,34,FMN GV 11 Ramsel
66,Bergstraat 71,2020-11-13,14:00:00,104,44,60,FMN GV 11 Ramsel
66,Bergstraat 71,2020-11-13,15:00:00,124,76,48,FMN GV 11 Ramsel
66,Bergstraat 71,2020-11-13,16:00:00,98,76,22,FMN GV 11 Ramsel
66,Bergstraat 71,2020-11-13,17:00:00,22,22,0,FMN GV 11 Ramsel
66,Bergstraat 71,2020-11-13,18:00:00,26,16,10,FMN GV 11 Ramsel
66,Bergstraat 71,2020-11-13,19:00:00,16,10,6,FMN GV 11 Ramsel
66,Bergstraat 71,2020-11-13,20:00:00,14,6,8,FMN GV 11 Ramsel
66,Bergstraat 71,2020-11-13,21:00:00,18,8,10,FMN GV 11 Ramsel
66,Bergstraat 71,2020-11-13,22:00:00,2,2,0,FMN GV 11 Ramsel
66,Bergstraat 71,2020-11-13,23:00:00,4,4,0,FMN GV 11 Ramsel
66,Bergstraat 71,2020-11-14,00:00:00,4,4,0,FMN GV 11 Ramsel
66,Bergstraat 71,2020-11-14,01:00:00,2,0,2,FMN GV 11 Ramsel
66,Bergstraat 71,2020-11-14,02:00:00,0,0,0,FMN GV 11 Ramsel
66,Bergstraat 71,2020-11-14,03:00:00,0,0,0,FMN GV 11 Ramsel
66,Bergstraat 71,2020-11-14,04:00:00,0,0,0,FMN GV 11 Ramsel
66,Bergstraat 71,2020-11-14,05:00:00,2,0,2,FMN GV 11 Ramsel
66,Bergstraat 71,2020-11-14,06:00:00,8,0,8,FMN GV 11 Ramsel
66,Bergstraat 71,2020-11-14,07:00:00,8,6,2,FMN GV 11 Ramsel
66,Bergstraat 71,2020-11-14,08:00:00,20,8,12,FMN GV 11 Ramsel
66,Bergstraat 71,2020-11-14,09:00:00,82,20,62,FMN GV 11 Ramsel
66,Bergstraat 71,2020-11-14,10:00:00,158,62,96,FMN GV 11 Ramsel
66,Bergstraat 71,2020-11-14,11:00:00,146,90,56,FMN GV 11 Ramsel
66,Bergstraat 71,2020-11-14,12:00:00,216,84,132,FMN GV 11 Ramsel
66,Bergstraat 71,2020-11-14,13:00:00,358,154,204,FMN GV 11 Ramsel
66,Bergstraat 71,2020-11-14,14:00:00,460,228,232,FMN GV 11 Ramsel
66,Bergstraat 71,2020-11-14,15:00:00,320,188,132,FMN GV 11 Ramsel
66,Bergstraat 71,2020-11-14,16:00:00,242,134,108,FMN GV 11 Ramsel
66,Bergstraat 71,2020-11-14,17:00:00,74,54,20,FMN GV 11 Ramsel
66,Bergstraat 71,2020-11-14,18:00:00,24,14,10,FMN GV 11 Ramsel
66,Bergstraat 71,2020-11-14,19:00:00,6,2,4,FMN GV 11 Ramsel
66,Bergstraat 71,2020-11-14,20:00:00,6,4,2,FMN GV 11 Ramsel
66,Bergstraat 71,2020-11-14,21:00:00,18,6,12,FMN GV 11 Ramsel
66,Bergstraat 71,2020-11-14,22:00:00,4,4,0,FMN GV 11 Ramsel
66,Bergstraat 71,2020-11-14,23:00:00,16,8,8,FMN GV 11 Ramsel
66,Bergstraat 71,2020-11-15,00:00:00,2,2,0,FMN GV 11 Ramsel
66,Bergstraat 71,2020-11-15,01:00:00,2,0,2,FMN GV 11 Ramsel
66,Bergstraat 71,2020-11-15,02:00:00,0,0,0,FMN GV 11 Ramsel
66,Bergstraat 71,2020-11-15,03:00:00,0,0,0,FMN GV 11 Ramsel
66,Bergstraat 71,2020-11-15,04:00:00,0,0,0,FMN GV 11 Ramsel
66,Bergstraat 71,2020-11-15,05:00:00,4,2,2,FMN GV 11 Ramsel
66,Bergstraat 71,2020-11-15,06:00:00,6,2,4,FMN GV 11 Ramsel
66,Bergstraat 71,2020-11-15,07:00:00,18,0,18,FMN GV 11 Ramsel
66,Bergstraat 71,2020-11-15,08:00:00,54,16,38,FMN GV 11 Ramsel
66,Bergstraat 71,2020-11-15,09:00:00,196,68,128,FMN GV 11 Ramsel
66,Bergstraat 71,2020-11-15,10:00:00,200,98,102,FMN GV 11 Ramsel
66,Bergstraat 71,2020-11-15,11:00:00,220,166,54,FMN GV 11 Ramsel
66,Bergstraat 71,2020-11-15,12:00:00,60,38,22,FMN GV 11 Ramsel
66,Bergstraat 71,2020-11-15,13:00:00,36,16,20,FMN GV 11 Ramsel
66,Bergstraat 71,2020-11-15,14:00:00,24,14,10,FMN GV 11 Ramsel
66,Bergstraat 71,2020-11-15,15:00:00,10,6,4,FMN GV 11 Ramsel
66,Bergstraat 71,2020-11-15,16:00:00,10,6,4,FMN GV 11 Ramsel
66,Bergstraat 71,2020-11-15,17:00:00,4,4,0,FMN GV 11 Ramsel
66,Bergstraat 71,2020-11-15,18:00:00,12,8,4,FMN GV 11 Ramsel
66,Bergstraat 71,2020-11-15,19:00:00,8,6,2,FMN GV 11 Ramsel
66,Bergstraat 71,2020-11-15,20:00:00,2,2,0,FMN GV 11 Ramsel
66,Bergstraat 71,2020-11-15,21:00:00,8,0,8,FMN GV 11 Ramsel
66,Bergstraat 71,2020-11-15,22:00:00,0,0,0,FMN GV 11 Ramsel
66,Bergstraat 71,2020-11-15,23:00:00,0,0,0,FMN GV 11 Ramsel
66,Bergstraat 71,2020-11-16,00:00:00,0,0,0,FMN GV 11 Ramsel
66,Bergstraat 71,2020-11-16,01:00:00,2,2,0,FMN GV 11 Ramsel
66,Bergstraat 71,2020-11-16,02:00:00,2,0,2,FMN GV 11 Ramsel
66,Bergstraat 71,2020-11-16,03:00:00,2,0,2,FMN GV 11 Ramsel
66,Bergstraat 71,2020-11-16,04:00:00,0,0,0,FMN GV 11 Ramsel
66,Bergstraat 71,2020-11-16,05:00:00,8,6,2,FMN GV 11 Ramsel
66,Bergstraat 71,2020-11-16,06:00:00,26,8,18,FMN GV 11 Ramsel
66,Bergstraat 71,2020-11-16,07:00:00,170,12,158,FMN GV 11 Ramsel
66,Bergstraat 71,2020-11-16,08:00:00,106,12,94,FMN GV 11 Ramsel
66,Bergstraat 71,2020-11-16,09:00:00,36,10,26,FMN GV 11 Ramsel
66,Bergstraat 71,2020-11-16,10:00:00,34,18,16,FMN GV 11 Ramsel
66,Bergstraat 71,2020-11-16,11:00:00,32,12,20,FMN GV 11 Ramsel
66,Bergstraat 71,2020-11-16,12:00:00,46,18,28,FMN GV 11 Ramsel
66,Bergstraat 71,2020-11-16,13:00:00,98,74,24,FMN GV 11 Ramsel
66,Bergstraat 71,2020-11-16,14:00:00,62,32,30,FMN GV 11 Ramsel
66,Bergstraat 71,2020-11-16,15:00:00,188,174,14,FMN GV 11 Ramsel
66,Bergstraat 71,2020-11-16,16:00:00,96,70,26,FMN GV 11 Ramsel
66,Bergstraat 71,2020-11-16,17:00:00,30,24,6,FMN GV 11 Ramsel
66,Bergstraat 71,2020-11-16,18:00:00,8,4,4,FMN GV 11 Ramsel
66,Bergstraat 71,2020-11-16,19:00:00,10,6,4,FMN GV 11 Ramsel
66,Bergstraat 71,2020-11-16,20:00:00,16,8,8,FMN GV 11 Ramsel
66,Bergstraat 71,2020-11-16,21:00:00,2,2,0,FMN GV 11 Ramsel
66,Bergstraat 71,2020-11-16,22:00:00,12,2,10,FMN GV 11 Ramsel
66,Bergstraat 71,2020-11-16,23:00:00,0,0,0,FMN GV 11 Ramsel
66,Bergstraat 71,2020-11-17,00:00:00,0,0,0,FMN GV 11 Ramsel
66,Bergstraat 71,2020-11-17,01:00:00,0,0,0,FMN GV 11 Ramsel
66,Bergstraat 71,2020-11-17,02:00:00,0,0,0,FMN GV 11 Ramsel
66,Bergstraat 71,2020-11-17,03:00:00,2,0,2,FMN GV 11 Ramsel
66,Bergstraat 71,2020-11-17,04:00:00,2,0,2,FMN GV 11 Ramsel
66,Bergstraat 71,2020-11-17,05:00:00,12,8,4,FMN GV 11 Ramsel
66,Bergstraat 71,2020-11-17,06:00:00,34,18,16,FMN GV 11 Ramsel
66,Bergstraat 71,2020-11-17,07:00:00,132,20,112,FMN GV 11 Ramsel
66,Bergstraat 71,2020-11-17,08:00:00,102,12,90,FMN GV 11 Ramsel
66,Bergstraat 71,2020-11-17,09:00:00,20,4,16,FMN GV 11 Ramsel
66,Bergstraat 71,2020-11-17,10:00:00,42,10,32,FMN GV 11 Ramsel
66,Bergstraat 71,2020-11-17,11:00:00,68,34,34,FMN GV 11 Ramsel
66,Bergstraat 71,2020-11-17,12:00:00,78,40,38,FMN GV 11 Ramsel
66,Bergstraat 71,2020-11-17,13:00:00,130,74,56,FMN GV 11 Ramsel
66,Bergstraat 71,2020-11-17,14:00:00,116,56,60,FMN GV 11 Ramsel
66,Bergstraat 71,2020-11-17,15:00:00,312,252,60,FMN GV 11 Ramsel
66,Bergstraat 71,2020-11-17,16:00:00,100,58,42,FMN GV 11 Ramsel
66,Bergstraat 71,2020-11-17,17:00:00,62,20,42,FMN GV 11 Ramsel
66,Bergstraat 71,2020-11-17,18:00:00,34,12,22,FMN GV 11 Ramsel
66,Bergstraat 71,2020-11-17,19:00:00,24,16,8,FMN GV 11 Ramsel
66,Bergstraat 71,2020-11-17,20:00:00,14,10,4,FMN GV 11 Ramsel
66,Bergstraat 71,2020-11-17,21:00:00,8,6,2,FMN GV 11 Ramsel
66,Bergstraat 71,2020-11-17,22:00:00,20,6,14,FMN GV 11 Ramsel
66,Bergstraat 71,2020-11-17,23:00:00,4,4,0,FMN GV 11 Ramsel
66,Bergstraat 71,2020-11-18,00:00:00,0,0,0,FMN GV 11 Ramsel
66,Bergstraat 71,2020-11-18,01:00:00,0,0,0,FMN GV 11 Ramsel
66,Bergstraat 71,2020-11-18,02:00:00,0,0,0,FMN GV 11 Ramsel
66,Bergstraat 71,2020-11-18,03:00:00,0,0,0,FMN GV 11 Ramsel
66,Bergstraat 71,2020-11-18,04:00:00,0,0,0,FMN GV 11 Ramsel
66,Bergstraat 71,2020-11-18,05:00:00,10,6,4,FMN GV 11 Ramsel
66,Bergstraat 71,2020-11-18,06:00:00,24,12,12,FMN GV 11 Ramsel
66,Bergstraat 71,2020-11-18,07:00:00,168,20,148,FMN GV 11 Ramsel
66,Bergstraat 71,2020-11-18,08:00:00,142,22,120,FMN GV 11 Ramsel
66,Bergstraat 71,2020-11-18,09:00:00,64,24,40,FMN GV 11 Ramsel
66,Bergstraat 71,2020-11-18,10:00:00,84,42,42,FMN GV 11 Ramsel
66,Bergstraat 71,2020-11-18,11:00:00,182,78,104,FMN GV 11 Ramsel
66,Bergstraat 71,2020-11-18,12:00:00,350,268,82,FMN GV 11 Ramsel
66,Bergstraat 71,2020-11-18,13:00:00,358,152,206,FMN GV 11 Ramsel
66,Bergstraat 71,2020-11-18,14:00:00,404,176,228,FMN GV 11 Ramsel
66,Bergstraat 71,2020-11-18,15:00:00,338,200,138,FMN GV 11 Ramsel
66,Bergstraat 71,2020-11-18,16:00:00,194,120,74,FMN GV 11 Ramsel
66,Bergstraat 71,2020-11-18,17:00:00,78,50,28,FMN GV 11 Ramsel
66,Bergstraat 71,2020-11-18,18:00:00,34,16,18,FMN GV 11 Ramsel
66,Bergstraat 71,2020-11-18,19:00:00,34,20,14,FMN GV 11 Ramsel
66,Bergstraat 71,2020-11-18,20:00:00,8,4,4,FMN GV 11 Ramsel
66,Bergstraat 71,2020-11-18,21:00:00,6,4,2,FMN GV 11 Ramsel
66,Bergstraat 71,2020-11-18,22:00:00,12,4,8,FMN GV 11 Ramsel
66,Bergstraat 71,2020-11-18,23:00:00,0,0,0,FMN GV 11 Ramsel
66,Bergstraat 71,2020-11-19,00:00:00,0,0,0,FMN GV 11 Ramsel
66,Bergstraat 71,2020-11-19,01:00:00,0,0,0,FMN GV 11 Ramsel
66,Bergstraat 71,2020-11-19,02:00:00,0,0,0,FMN GV 11 Ramsel
66,Bergstraat 71,2020-11-19,03:00:00,0,0,0,FMN GV 11 Ramsel
66,Bergstraat 71,2020-11-19,04:00:00,2,2,0,FMN GV 11 Ramsel
66,Bergstraat 71,2020-11-19,05:00:00,6,4,2,FMN GV 11 Ramsel
66,Bergstraat 71,2020-11-19,06:00:00,30,10,20,FMN GV 11 Ramsel
66,Bergstraat 71,2020-11-19,07:00:00,108,10,98,FMN GV 11 Ramsel
66,Bergstraat 71,2020-11-19,08:00:00,116,22,94,FMN GV 11 Ramsel
66,Bergstraat 71,2020-11-19,09:00:00,12,4,8,FMN GV 11 Ramsel
66,Bergstraat 71,2020-11-19,10:00:00,38,16,22,FMN GV 11 Ramsel
66,Bergstraat 71,2020-11-19,11:00:00,54,24,30,FMN GV 11 Ramsel
66,Bergstraat 71,2020-11-19,12:00:00,36,20,16,FMN GV 11 Ramsel
66,Bergstraat 71,2020-11-19,13:00:00,36,24,12,FMN GV 11 Ramsel
66,Bergstraat 71,2020-11-19,14:00:00,34,20,14,FMN GV 11 Ramsel
66,Bergstraat 71,2020-11-19,15:00:00,132,112,20,FMN GV 11 Ramsel
66,Bergstraat 71,2020-11-19,16:00:00,82,68,14,FMN GV 11 Ramsel
66,Bergstraat 71,2020-11-19,17:00:00,32,18,14,FMN GV 11 Ramsel
66,Bergstraat 71,2020-11-19,18:00:00,6,4,2,FMN GV 11 Ramsel
66,Bergstraat 71,2020-11-19,19:00:00,16,10,6,FMN GV 11 Ramsel
66,Bergstraat 71,2020-11-19,20:00:00,10,4,6,FMN GV 11 Ramsel
66,Bergstraat 71,2020-11-19,21:00:00,6,2,4,FMN GV 11 Ramsel
66,Bergstraat 71,2020-11-19,22:00:00,8,2,6,FMN GV 11 Ramsel
66,Bergstraat 71,2020-11-19,23:00:00,4,4,0,FMN GV 11 Ramsel
66,Bergstraat 71,2020-11-20,00:00:00,0,0,0,FMN GV 11 Ramsel
66,Bergstraat 71,2020-11-20,01:00:00,0,0,0,FMN GV 11 Ramsel
66,Bergstraat 71,2020-11-20,02:00:00,4,2,2,FMN GV 11 Ramsel
66,Bergstraat 71,2020-11-20,03:00:00,0,0,0,FMN GV 11 Ramsel
66,Bergstraat 71,2020-11-20,04:00:00,2,0,2,FMN GV 11 Ramsel
66,Bergstraat 71,2020-11-20,05:00:00,2,2,0,FMN GV 11 Ramsel
66,Bergstraat 71,2020-11-20,06:00:00,38,14,24,FMN GV 11 Ramsel
66,Bergstraat 71,2020-11-20,07:00:00,142,8,134,FMN GV 11 Ramsel
66,Bergstraat 71,2020-11-20,08:00:00,98,16,82,FMN GV 11 Ramsel
66,Bergstraat 71,2020-11-20,09:00:00,32,12,20,FMN GV 11 Ramsel
66,Bergstraat 71,2020-11-20,10:00:00,60,30,30,FMN GV 11 Ramsel
66,Bergstraat 71,2020-11-20,11:00:00,78,32,46,FMN GV 11 Ramsel
66,Bergstraat 71,2020-11-20,12:00:00,80,34,46,FMN GV 11 Ramsel
66,Bergstraat 71,2020-11-20,13:00:00,156,96,60,FMN GV 11 Ramsel
66,Bergstraat 71,2020-11-20,14:00:00,240,114,126,FMN GV 11 Ramsel
66,Bergstraat 71,2020-11-20,15:00:00,308,232,76,FMN GV 11 Ramsel
66,Bergstraat 71,2020-11-20,16:00:00,112,76,36,FMN GV 11 Ramsel
66,Bergstraat 71,2020-11-20,17:00:00,64,44,20,FMN GV 11 Ramsel
66,Bergstraat 71,2020-11-20,18:00:00,20,6,14,FMN GV 11 Ramsel
66,Bergstraat 71,2020-11-20,19:00:00,42,20,22,FMN GV 11 Ramsel
66,Bergstraat 71,2020-11-20,20:00:00,14,6,8,FMN GV 11 Ramsel
66,Bergstraat 71,2020-11-20,21:00:00,8,2,6,FMN GV 11 Ramsel
66,Bergstraat 71,2020-11-20,22:00:00,6,4,2,FMN GV 11 Ramsel
66,Bergstraat 71,2020-11-20,23:00:00,4,4,0,FMN GV 11 Ramsel
66,Bergstraat 71,2020-11-21,00:00:00,2,2,0,FMN GV 11 Ramsel
66,Bergstraat 71,2020-11-21,01:00:00,2,2,0,FMN GV 11 Ramsel
66,Bergstraat 71,2020-11-21,02:00:00,2,0,2,FMN GV 11 Ramsel
66,Bergstraat 71,2020-11-21,03:00:00,0,0,0,FMN GV 11 Ramsel
66,Bergstraat 71,2020-11-21,04:00:00,0,0,0,FMN GV 11 Ramsel
66,Bergstraat 71,2020-11-21,05:00:00,4,0,4,FMN GV 11 Ramsel
66,Bergstraat 71,2020-11-21,06:00:00,4,2,2,FMN GV 11 Ramsel
66,Bergstraat 71,2020-11-21,07:00:00,10,6,4,FMN GV 11 Ramsel
66,Bergstraat 71,2020-11-21,08:00:00,26,6,20,FMN GV 11 Ramsel
66,Bergstraat 71,2020-11-21,09:00:00,58,22,36,FMN GV 11 Ramsel
66,Bergstraat 71,2020-11-21,10:00:00,72,32,40,FMN GV 11 Ramsel
66,Bergstraat 71,2020-11-21,11:00:00,100,50,50,FMN GV 11 Ramsel
66,Bergstraat 71,2020-11-21,12:00:00,104,34,70,FMN GV 11 Ramsel
66,Bergstraat 71,2020-11-21,13:00:00,234,92,142,FMN GV 11 Ramsel
66,Bergstraat 71,2020-11-21,14:00:00,190,78,112,FMN GV 11 Ramsel
66,Bergstraat 71,2020-11-21,15:00:00,196,108,88,FMN GV 11 Ramsel
66,Bergstraat 71,2020-11-21,16:00:00,70,56,14,FMN GV 11 Ramsel
66,Bergstraat 71,2020-11-21,17:00:00,26,18,8,FMN GV 11 Ramsel
66,Bergstraat 71,2020-11-21,18:00:00,18,8,10,FMN GV 11 Ramsel
66,Bergstraat 71,2020-11-21,19:00:00,12,0,12,FMN GV 11 Ramsel
66,Bergstraat 71,2020-11-21,20:00:00,4,4,0,FMN GV 11 Ramsel
66,Bergstraat 71,2020-11-21,21:00:00,6,2,4,FMN GV 11 Ramsel
66,Bergstraat 71,2020-11-21,22:00:00,6,4,2,FMN GV 11 Ramsel
66,Bergstraat 71,2020-11-21,23:00:00,8,2,6,FMN GV 11 Ramsel
66,Bergstraat 71,2020-11-22,00:00:00,2,2,0,FMN GV 11 Ramsel
66,Bergstraat 71,2020-11-22,01:00:00,0,0,0,FMN GV 11 Ramsel
66,Bergstraat 71,2020-11-22,02:00:00,0,0,0,FMN GV 11 Ramsel
66,Bergstraat 71,2020-11-22,03:00:00,2,2,0,FMN GV 11 Ramsel
66,Bergstraat 71,2020-11-22,04:00:00,0,0,0,FMN GV 11 Ramsel
66,Bergstraat 71,2020-11-22,05:00:00,2,0,2,FMN GV 11 Ramsel
66,Bergstraat 71,2020-11-22,06:00:00,6,2,4,FMN GV 11 Ramsel
66,Bergstraat 71,2020-11-22,07:00:00,10,4,6,FMN GV 11 Ramsel
66,Bergstraat 71,2020-11-22,08:00:00,64,12,52,FMN GV 11 Ramsel
66,Bergstraat 71,2020-11-22,09:00:00,130,34,96,FMN GV 11 Ramsel
66,Bergstraat 71,2020-11-22,10:00:00,150,78,72,FMN GV 11 Ramsel
66,Bergstraat 71,2020-11-22,11:00:00,110,78,32,FMN GV 11 Ramsel
66,Bergstraat 71,2020-11-22,12:00:00,126,96,30,FMN GV 11 Ramsel
66,Bergstraat 71,2020-11-22,13:00:00,60,28,32,FMN GV 11 Ramsel
66,Bergstraat 71,2020-11-22,14:00:00,54,26,28,FMN GV 11 Ramsel
66,Bergstraat 71,2020-11-22,15:00:00,64,36,28,FMN GV 11 Ramsel
66,Bergstraat 71,2020-11-22,16:00:00,34,30,4,FMN GV 11 Ramsel
66,Bergstraat 71,2020-11-22,17:00:00,20,6,14,FMN GV 11 Ramsel
66,Bergstraat 71,2020-11-22,18:00:00,2,2,0,FMN GV 11 Ramsel
66,Bergstraat 71,2020-11-22,19:00:00,8,4,4,FMN GV 11 Ramsel
66,Bergstraat 71,2020-11-22,20:00:00,4,2,2,FMN GV 11 Ramsel
66,Bergstraat 71,2020-11-22,21:00:00,2,0,2,FMN GV 11 Ramsel
66,Bergstraat 71,2020-11-22,22:00:00,0,0,0,FMN GV 11 Ramsel
66,Bergstraat 71,2020-11-22,23:00:00,4,4,0,FMN GV 11 Ramsel
66,Bergstraat 71,2020-11-23,00:00:00,0,0,0,FMN GV 11 Ramsel
66,Bergstraat 71,2020-11-23,01:00:00,0,0,0,FMN GV 11 Ramsel
66,Bergstraat 71,2020-11-23,02:00:00,0,0,0,FMN GV 11 Ramsel
66,Bergstraat 71,2020-11-23,03:00:00,2,2,0,FMN GV 11 Ramsel
66,Bergstraat 71,2020-11-23,04:00:00,2,0,2,FMN GV 11 Ramsel
66,Bergstraat 71,2020-11-23,05:00:00,8,8,0,FMN GV 11 Ramsel
66,Bergstraat 71,2020-11-23,06:00:00,18,10,8,FMN GV 11 Ramsel
66,Bergstraat 71,2020-11-23,07:00:00,148,22,126,FMN GV 11 Ramsel
66,Bergstraat 71,2020-11-23,08:00:00,102,10,92,FMN GV 11 Ramsel
66,Bergstraat 71,2020-11-23,09:00:00,32,12,20,FMN GV 11 Ramsel
66,Bergstraat 71,2020-11-23,10:00:00,54,20,34,FMN GV 11 Ramsel
66,Bergstraat 71,2020-11-23,11:00:00,68,28,40,FMN GV 11 Ramsel
66,Bergstraat 71,2020-11-23,12:00:00,126,58,68,FMN GV 11 Ramsel
66,Bergstraat 71,2020-11-23,13:00:00,170,70,100,FMN GV 11 Ramsel
66,Bergstraat 71,2020-11-23,14:00:00,258,130,128,FMN GV 11 Ramsel
66,Bergstraat 71,2020-11-23,15:00:00,292,232,60,FMN GV 11 Ramsel
66,Bergstraat 71,2020-11-23,16:00:00,160,116,44,FMN GV 11 Ramsel
66,Bergstraat 71,2020-11-23,17:00:00,44,28,16,FMN GV 11 Ramsel
66,Bergstraat 71,2020-11-23,18:00:00,22,10,12,FMN GV 11 Ramsel
66,Bergstraat 71,2020-11-23,19:00:00,16,6,10,FMN GV 11 Ramsel
66,Bergstraat 71,2020-11-23,20:00:00,18,8,10,FMN GV 11 Ramsel
66,Bergstraat 71,2020-11-23,21:00:00,12,12,0,FMN GV 11 Ramsel
66,Bergstraat 71,2020-11-23,22:00:00,10,4,6,FMN GV 11 Ramsel
66,Bergstraat 71,2020-11-23,23:00:00,0,0,0,FMN GV 11 Ramsel
66,Bergstraat 71,2020-11-24,00:00:00,0,0,0,FMN GV 11 Ramsel
66,Bergstraat 71,2020-11-24,01:00:00,0,0,0,FMN GV 11 Ramsel
66,Bergstraat 71,2020-11-24,02:00:00,0,0,0,FMN GV 11 Ramsel
66,Bergstraat 71,2020-11-24,03:00:00,0,0,0,FMN GV 11 Ramsel
66,Bergstraat 71,2020-11-24,04:00:00,0,0,0,FMN GV 11 Ramsel
66,Bergstraat 71,2020-11-24,05:00:00,8,2,6,FMN GV 11 Ramsel
66,Bergstraat 71,2020-11-24,06:00:00,20,10,10,FMN GV 11 Ramsel
66,Bergstraat 71,2020-11-24,07:00:00,168,22,146,FMN GV 11 Ramsel
66,Bergstraat 71,2020-11-24,08:00:00,98,14,84,FMN GV 11 Ramsel
66,Bergstraat 71,2020-11-24,09:00:00,38,14,24,FMN GV 11 Ramsel
66,Bergstraat 71,2020-11-24,10:00:00,50,22,28,FMN GV 11 Ramsel
66,Bergstraat 71,2020-11-24,11:00:00,56,18,38,FMN GV 11 Ramsel
66,Bergstraat 71,2020-11-24,12:00:00,122,58,64,FMN GV 11 Ramsel
66,Bergstraat 71,2020-11-24,13:00:00,286,118,168,FMN GV 11 Ramsel
66,Bergstraat 71,2020-11-24,14:00:00,270,134,136,FMN GV 11 Ramsel
66,Bergstraat 71,2020-11-24,15:00:00,288,222,66,FMN GV 11 Ramsel
66,Bergstraat 71,2020-11-24,16:00:00,178,120,58,FMN GV 11 Ramsel
66,Bergstraat 71,2020-11-24,17:00:00,40,28,12,FMN GV 11 Ramsel
66,Bergstraat 71,2020-11-24,18:00:00,28,12,16,FMN GV 11 Ramsel
66,Bergstraat 71,2020-11-24,19:00:00,20,16,4,FMN GV 11 Ramsel
66,Bergstraat 71,2020-11-24,20:00:00,18,6,12,FMN GV 11 Ramsel
66,Bergstraat 71,2020-11-24,21:00:00,8,6,2,FMN GV 11 Ramsel
66,Bergstraat 71,2020-11-24,22:00:00,6,6,0,FMN GV 11 Ramsel
66,Bergstraat 71,2020-11-24,23:00:00,0,0,0,FMN GV 11 Ramsel
66,Bergstraat 71,2020-11-25,00:00:00,0,0,0,FMN GV 11 Ramsel
66,Bergstraat 71,2020-11-25,01:00:00,0,0,0,FMN GV 11 Ramsel
66,Bergstraat 71,2020-11-25,02:00:00,0,0,0,FMN GV 11 Ramsel
66,Bergstraat 71,2020-11-25,03:00:00,0,0,0,FMN GV 11 Ramsel
66,Bergstraat 71,2020-11-25,04:00:00,2,2,0,FMN GV 11 Ramsel
66,Bergstraat 71,2020-11-25,05:00:00,12,6,6,FMN GV 11 Ramsel
66,Bergstraat 71,2020-11-25,06:00:00,20,10,10,FMN GV 11 Ramsel
66,Bergstraat 71,2020-11-25,07:00:00,168,22,146,FMN GV 11 Ramsel
66,Bergstraat 71,2020-11-25,08:00:00,144,24,120,FMN GV 11 Ramsel
66,Bergstraat 71,2020-11-25,09:00:00,24,10,14,FMN GV 11 Ramsel
66,Bergstraat 71,2020-11-25,10:00:00,68,24,44,FMN GV 11 Ramsel
66,Bergstraat 71,2020-11-25,11:00:00,114,68,46,FMN GV 11 Ramsel
66,Bergstraat 71,2020-11-25,12:00:00,240,202,38,FMN GV 11 Ramsel
66,Bergstraat 71,2020-11-25,13:00:00,208,66,142,FMN GV 11 Ramsel
66,Bergstraat 71,2020-11-25,14:00:00,208,112,96,FMN GV 11 Ramsel
66,Bergstraat 71,2020-11-25,15:00:00,194,114,80,FMN GV 11 Ramsel
66,Bergstraat 71,2020-11-25,16:00:00,104,80,24,FMN GV 11 Ramsel
66,Bergstraat 71,2020-11-25,17:00:00,70,38,32,FMN GV 11 Ramsel
66,Bergstraat 71,2020-11-25,18:00:00,38,20,18,FMN GV 11 Ramsel
66,Bergstraat 71,2020-11-25,19:00:00,18,10,8,FMN GV 11 Ramsel
66,Bergstraat 71,2020-11-25,20:00:00,10,2,8,FMN GV 11 Ramsel
66,Bergstraat 71,2020-11-25,21:00:00,18,8,10,FMN GV 11 Ramsel
66,Bergstraat 71,2020-11-25,22:00:00,8,6,2,FMN GV 11 Ramsel
66,Bergstraat 71,2020-11-25,23:00:00,0,0,0,FMN GV 11 Ramsel
66,Bergstraat 71,2020-11-26,00:00:00,0,0,0,FMN GV 11 Ramsel
66,Bergstraat 71,2020-11-26,01:00:00,0,0,0,FMN GV 11 Ramsel
66,Bergstraat 71,2020-11-26,02:00:00,0,0,0,FMN GV 11 Ramsel
66,Bergstraat 71,2020-11-26,03:00:00,0,0,0,FMN GV 11 Ramsel
66,Bergstraat 71,2020-11-26,04:00:00,0,0,0,FMN GV 11 Ramsel
66,Bergstraat 71,2020-11-26,05:00:00,12,10,2,FMN GV 11 Ramsel
66,Bergstraat 71,2020-11-26,06:00:00,24,8,16,FMN GV 11 Ramsel
66,Bergstraat 71,2020-11-26,07:00:00,138,8,130,FMN GV 11 Ramsel
66,Bergstraat 71,2020-11-26,08:00:00,106,10,96,FMN GV 11 Ramsel
66,Bergstraat 71,2020-11-26,09:00:00,68,24,44,FMN GV 11 Ramsel
66,Bergstraat 71,2020-11-26,10:00:00,62,22,40,FMN GV 11 Ramsel
66,Bergstraat 71,2020-11-26,11:00:00,72,40,32,FMN GV 11 Ramsel
66,Bergstraat 71,2020-11-26,12:00:00,60,32,28,FMN GV 11 Ramsel
66,Bergstraat 71,2020-11-26,13:00:00,168,74,94,FMN GV 11 Ramsel
66,Bergstraat 71,2020-11-26,14:00:00,162,70,92,FMN GV 11 Ramsel
66,Bergstraat 71,2020-11-26,15:00:00,240,180,60,FMN GV 11 Ramsel
66,Bergstraat 71,2020-11-26,16:00:00,148,114,34,FMN GV 11 Ramsel
66,Bergstraat 71,2020-11-26,17:00:00,58,38,20,FMN GV 11 Ramsel
66,Bergstraat 71,2020-11-26,18:00:00,32,16,16,FMN GV 11 Ramsel
66,Bergstraat 71,2020-11-26,19:00:00,30,12,18,FMN GV 11 Ramsel
66,Bergstraat 71,2020-11-26,20:00:00,20,8,12,FMN GV 11 Ramsel
66,Bergstraat 71,2020-11-26,21:00:00,10,10,0,FMN GV 11 Ramsel
66,Bergstraat 71,2020-11-26,22:00:00,12,6,6,FMN GV 11 Ramsel
66,Bergstraat 71,2020-11-26,23:00:00,2,2,0,FMN GV 11 Ramsel
66,Bergstraat 71,2020-11-27,00:00:00,0,0,0,FMN GV 11 Ramsel
66,Bergstraat 71,2020-11-27,01:00:00,0,0,0,FMN GV 11 Ramsel
66,Bergstraat 71,2020-11-27,02:00:00,0,0,0,FMN GV 11 Ramsel
66,Bergstraat 71,2020-11-27,03:00:00,0,0,0,FMN GV 11 Ramsel
66,Bergstraat 71,2020-11-27,04:00:00,2,2,0,FMN GV 11 Ramsel
66,Bergstraat 71,2020-11-27,05:00:00,14,10,4,FMN GV 11 Ramsel
66,Bergstraat 71,2020-11-27,06:00:00,24,10,14,FMN GV 11 Ramsel
66,Bergstraat 71,2020-11-27,07:00:00,120,18,102,FMN GV 11 Ramsel
66,Bergstraat 71,2020-11-27,08:00:00,118,24,94,FMN GV 11 Ramsel
66,Bergstraat 71,2020-11-27,09:00:00,30,12,18,FMN GV 11 Ramsel
66,Bergstraat 71,2020-11-27,10:00:00,60,28,32,FMN GV 11 Ramsel
66,Bergstraat 71,2020-11-27,11:00:00,76,34,42,FMN GV 11 Ramsel
66,Bergstraat 71,2020-11-27,12:00:00,88,58,30,FMN GV 11 Ramsel
66,Bergstraat 71,2020-11-27,13:00:00,110,64,46,FMN GV 11 Ramsel
66,Bergstraat 71,2020-11-27,14:00:00,126,60,66,FMN GV 11 Ramsel
66,Bergstraat 71,2020-11-27,15:00:00,226,202,24,FMN GV 11 Ramsel
66,Bergstraat 71,2020-11-27,16:00:00,82,52,30,FMN GV 11 Ramsel
66,Bergstraat 71,2020-11-27,17:00:00,40,24,16,FMN GV 11 Ramsel
66,Bergstraat 71,2020-11-27,18:00:00,24,16,8,FMN GV 11 Ramsel
66,Bergstraat 71,2020-11-27,19:00:00,10,4,6,FMN GV 11 Ramsel
66,Bergstraat 71,2020-11-27,20:00:00,12,6,6,FMN GV 11 Ramsel
66,Bergstraat 71,2020-11-27,21:00:00,6,2,4,FMN GV 11 Ramsel
66,Bergstraat 71,2020-11-27,22:00:00,4,4,0,FMN GV 11 Ramsel
66,Bergstraat 71,2020-11-27,23:00:00,4,4,0,FMN GV 11 Ramsel
66,Bergstraat 71,2020-11-28,00:00:00,2,2,0,FMN GV 11 Ramsel
66,Bergstraat 71,2020-11-28,01:00:00,0,0,0,FMN GV 11 Ramsel
66,Bergstraat 71,2020-11-28,02:00:00,0,0,0,FMN GV 11 Ramsel
66,Bergstraat 71,2020-11-28,03:00:00,0,0,0,FMN GV 11 Ramsel
66,Bergstraat 71,2020-11-28,04:00:00,0,0,0,FMN GV 11 Ramsel
66,Bergstraat 71,2020-11-28,05:00:00,0,0,0,FMN GV 11 Ramsel
66,Bergstraat 71,2020-11-28,06:00:00,0,0,0,FMN GV 11 Ramsel
66,Bergstraat 71,2020-11-28,07:00:00,8,6,2,FMN GV 11 Ramsel
66,Bergstraat 71,2020-11-28,08:00:00,16,6,10,FMN GV 11 Ramsel
66,Bergstraat 71,2020-11-28,09:00:00,44,22,22,FMN GV 11 Ramsel
66,Bergstraat 71,2020-11-28,10:00:00,90,44,46,FMN GV 11 Ramsel
66,Bergstraat 71,2020-11-28,11:00:00,132,56,76,FMN GV 11 Ramsel
66,Bergstraat 71,2020-11-28,12:00:00,178,98,80,FMN GV 11 Ramsel
66,Bergstraat 71,2020-11-28,13:00:00,216,106,110,FMN GV 11 Ramsel
66,Bergstraat 71,2020-11-28,14:00:00,236,126,110,FMN GV 11 Ramsel
66,Bergstraat 71,2020-11-28,15:00:00,204,86,118,FMN GV 11 Ramsel
66,Bergstraat 71,2020-11-28,16:00:00,108,52,56,FMN GV 11 Ramsel
66,Bergstraat 71,2020-11-28,17:00:00,44,24,20,FMN GV 11 Ramsel
66,Bergstraat 71,2020-11-28,18:00:00,28,14,14,FMN GV 11 Ramsel
66,Bergstraat 71,2020-11-28,19:00:00,6,2,4,FMN GV 11 Ramsel
66,Bergstraat 71,2020-11-28,20:00:00,10,2,8,FMN GV 11 Ramsel
66,Bergstraat 71,2020-11-28,21:00:00,2,0,2,FMN GV 11 Ramsel
66,Bergstraat 71,2020-11-28,22:00:00,6,6,0,FMN GV 11 Ramsel
66,Bergstraat 71,2020-11-28,23:00:00,4,2,2,FMN GV 11 Ramsel
66,Bergstraat 71,2020-11-29,00:00:00,4,4,0,FMN GV 11 Ramsel
66,Bergstraat 71,2020-11-29,01:00:00,0,0,0,FMN GV 11 Ramsel
66,Bergstraat 71,2020-11-29,02:00:00,2,2,0,FMN GV 11 Ramsel
66,Bergstraat 71,2020-11-29,03:00:00,2,0,2,FMN GV 11 Ramsel
66,Bergstraat 71,2020-11-29,04:00:00,2,2,0,FMN GV 11 Ramsel
66,Bergstraat 71,2020-11-29,05:00:00,6,2,4,FMN GV 11 Ramsel
66,Bergstraat 71,2020-11-29,06:00:00,4,2,2,FMN GV 11 Ramsel
66,Bergstraat 71,2020-11-29,07:00:00,12,2,10,FMN GV 11 Ramsel
66,Bergstraat 71,2020-11-29,08:00:00,64,18,46,FMN GV 11 Ramsel
66,Bergstraat 71,2020-11-29,09:00:00,98,20,78,FMN GV 11 Ramsel
66,Bergstraat 71,2020-11-29,10:00:00,102,64,38,FMN GV 11 Ramsel
66,Bergstraat 71,2020-11-29,11:00:00,112,68,44,FMN GV 11 Ramsel
66,Bergstraat 71,2020-11-29,12:00:00,94,64,30,FMN GV 11 Ramsel
66,Bergstraat 71,2020-11-29,13:00:00,102,42,60,FMN GV 11 Ramsel
66,Bergstraat 71,2020-11-29,14:00:00,98,50,48,FMN GV 11 Ramsel
66,Bergstraat 71,2020-11-29,15:00:00,100,64,36,FMN GV 11 Ramsel
66,Bergstraat 71,2020-11-29,16:00:00,56,36,20,FMN GV 11 Ramsel
66,Bergstraat 71,2020-11-29,17:00:00,14,12,2,FMN GV 11 Ramsel
66,Bergstraat 71,2020-11-29,18:00:00,4,0,4,FMN GV 11 Ramsel
66,Bergstraat 71,2020-11-29,19:00:00,0,0,0,FMN GV 11 Ramsel
66,Bergstraat 71,2020-11-29,20:00:00,14,10,4,FMN GV 11 Ramsel
66,Bergstraat 71,2020-11-29,21:00:00,0,0,0,FMN GV 11 Ramsel
66,Bergstraat 71,2020-11-29,22:00:00,2,2,0,FMN GV 11 Ramsel
66,Bergstraat 71,2020-11-29,23:00:00,0,0,0,FMN GV 11 Ramsel
66,Bergstraat 71,2020-11-30,00:00:00,0,0,0,FMN GV 11 Ramsel
66,Bergstraat 71,2020-11-30,01:00:00,0,0,0,FMN GV 11 Ramsel
66,Bergstraat 71,2020-11-30,02:00:00,0,0,0,FMN GV 11 Ramsel
66,Bergstraat 71,2020-11-30,03:00:00,2,2,0,FMN GV 11 Ramsel
66,Bergstraat 71,2020-11-30,04:00:00,4,2,2,FMN GV 11 Ramsel
66,Bergstraat 71,2020-11-30,05:00:00,6,2,4,FMN GV 11 Ramsel
66,Bergstraat 71,2020-11-30,06:00:00,18,10,8,FMN GV 11 Ramsel
66,Bergstraat 71,2020-11-30,07:00:00,114,12,102,FMN GV 11 Ramsel
66,Bergstraat 71,2020-11-30,08:00:00,130,18,112,FMN GV 11 Ramsel
66,Bergstraat 71,2020-11-30,09:00:00,20,10,10,FMN GV 11 Ramsel
66,Bergstraat 71,2020-11-30,10:00:00,18,6,12,FMN GV 11 Ramsel
66,Bergstraat 71,2020-11-30,11:00:00,26,18,8,FMN GV 11 Ramsel
66,Bergstraat 71,2020-11-30,12:00:00,32,14,18,FMN GV 11 Ramsel
66,Bergstraat 71,2020-11-30,13:00:00,48,18,30,FMN GV 11 Ramsel
66,Bergstraat 71,2020-11-30,14:00:00,58,24,34,FMN GV 11 Ramsel
66,Bergstraat 71,2020-11-30,15:00:00,150,132,18,FMN GV 11 Ramsel
66,Bergstraat 71,2020-11-30,16:00:00,86,74,12,FMN GV 11 Ramsel
66,Bergstraat 71,2020-11-30,17:00:00,28,18,10,FMN GV 11 Ramsel
66,Bergstraat 71,2020-11-30,18:00:00,18,12,6,FMN GV 11 Ramsel
66,Bergstraat 71,2020-11-30,19:00:00,8,2,6,FMN GV 11 Ramsel
66,Bergstraat 71,2020-11-30,20:00:00,2,2,0,FMN GV 11 Ramsel
66,Bergstraat 71,2020-11-30,21:00:00,4,2,2,FMN GV 11 Ramsel
66,Bergstraat 71,2020-11-30,22:00:00,10,2,8,FMN GV 11 Ramsel
66,Bergstraat 71,2020-11-30,23:00:00,0,0,0,FMN GV 11 Ramsel
66,Bergstraat 71,2020-12-01,00:00:00,0,0,0,FMN GV 11 Ramsel
66,Bergstraat 71,2020-12-01,01:00:00,0,0,0,FMN GV 11 Ramsel
66,Bergstraat 71,2020-12-01,02:00:00,0,0,0,FMN GV 11 Ramsel
66,Bergstraat 71,2020-12-01,03:00:00,0,0,0,FMN GV 11 Ramsel
66,Bergstraat 71,2020-12-01,04:00:00,0,0,0,FMN GV 11 Ramsel
66,Bergstraat 71,2020-12-01,05:00:00,8,6,2,FMN GV 11 Ramsel
66,Bergstraat 71,2020-12-01,06:00:00,10,6,4,FMN GV 11 Ramsel
66,Bergstraat 71,2020-12-01,07:00:00,52,2,50,FMN GV 11 Ramsel
66,Bergstraat 71,2020-12-01,08:00:00,30,0,30,FMN GV 11 Ramsel
66,Bergstraat 71,2020-12-01,09:00:00,4,2,2,FMN GV 11 Ramsel
66,Bergstraat 71,2020-12-01,10:00:00,8,2,6,FMN GV 11 Ramsel
66,Bergstraat 71,2020-12-01,11:00:00,22,6,16,FMN GV 11 Ramsel
66,Bergstraat 71,2020-12-01,12:00:00,24,14,10,FMN GV 11 Ramsel
66,Bergstraat 71,2020-12-01,13:00:00,60,32,28,FMN GV 11 Ramsel
66,Bergstraat 71,2020-12-01,14:00:00,52,20,32,FMN GV 11 Ramsel
66,Bergstraat 71,2020-12-01,15:00:00,108,72,36,FMN GV 11 Ramsel
66,Bergstraat 71,2020-12-01,16:00:00,38,26,12,FMN GV 11 Ramsel
66,Bergstraat 71,2020-12-01,17:00:00,32,22,10,FMN GV 11 Ramsel
66,Bergstraat 71,2020-12-01,18:00:00,10,2,8,FMN GV 11 Ramsel
66,Bergstraat 71,2020-12-01,19:00:00,18,8,10,FMN GV 11 Ramsel
66,Bergstraat 71,2020-12-01,20:00:00,16,12,4,FMN GV 11 Ramsel
66,Bergstraat 71,2020-12-01,21:00:00,6,4,2,FMN GV 11 Ramsel
66,Bergstraat 71,2020-12-01,22:00:00,12,2,10,FMN GV 11 Ramsel
66,Bergstraat 71,2020-12-01,23:00:00,2,2,0,FMN GV 11 Ramsel
66,Bergstraat 71,2020-12-02,00:00:00,0,0,0,FMN GV 11 Ramsel
66,Bergstraat 71,2020-12-02,01:00:00,0,0,0,FMN GV 11 Ramsel
66,Bergstraat 71,2020-12-02,02:00:00,0,0,0,FMN GV 11 Ramsel
66,Bergstraat 71,2020-12-02,03:00:00,0,0,0,FMN GV 11 Ramsel
66,Bergstraat 71,2020-12-02,04:00:00,2,2,0,FMN GV 11 Ramsel
66,Bergstraat 71,2020-12-02,05:00:00,8,4,4,FMN GV 11 Ramsel
66,Bergstraat 71,2020-12-02,06:00:00,14,6,8,FMN GV 11 Ramsel
66,Bergstraat 71,2020-12-02,07:00:00,140,6,134,FMN GV 11 Ramsel
66,Bergstraat 71,2020-12-02,08:00:00,110,8,102,FMN GV 11 Ramsel
66,Bergstraat 71,2020-12-02,09:00:00,52,18,34,FMN GV 11 Ramsel
66,Bergstraat 71,2020-12-02,10:00:00,46,28,18,FMN GV 11 Ramsel
66,Bergstraat 71,2020-12-02,11:00:00,60,44,16,FMN GV 11 Ramsel
66,Bergstraat 71,2020-12-02,12:00:00,184,158,26,FMN GV 11 Ramsel
66,Bergstraat 71,2020-12-02,13:00:00,104,46,58,FMN GV 11 Ramsel
66,Bergstraat 71,2020-12-02,14:00:00,120,62,58,FMN GV 11 Ramsel
66,Bergstraat 71,2020-12-02,15:00:00,112,84,28,FMN GV 11 Ramsel
66,Bergstraat 71,2020-12-02,16:00:00,52,34,18,FMN GV 11 Ramsel
66,Bergstraat 71,2020-12-02,17:00:00,50,38,12,FMN GV 11 Ramsel
66,Bergstraat 71,2020-12-02,18:00:00,34,20,14,FMN GV 11 Ramsel
66,Bergstraat 71,2020-12-02,19:00:00,30,6,24,FMN GV 11 Ramsel
66,Bergstraat 71,2020-12-02,20:00:00,12,6,6,FMN GV 11 Ramsel
66,Bergstraat 71,2020-12-02,21:00:00,10,8,2,FMN GV 11 Ramsel
66,Bergstraat 71,2020-12-02,22:00:00,8,4,4,FMN GV 11 Ramsel
66,Bergstraat 71,2020-12-02,23:00:00,0,0,0,FMN GV 11 Ramsel
66,Bergstraat 71,2020-12-03,00:00:00,0,0,0,FMN GV 11 Ramsel
66,Bergstraat 71,2020-12-03,01:00:00,0,0,0,FMN GV 11 Ramsel
66,Bergstraat 71,2020-12-03,02:00:00,0,0,0,FMN GV 11 Ramsel
66,Bergstraat 71,2020-12-03,03:00:00,0,0,0,FMN GV 11 Ramsel
66,Bergstraat 71,2020-12-03,04:00:00,4,0,4,FMN GV 11 Ramsel
66,Bergstraat 71,2020-12-03,05:00:00,2,0,2,FMN GV 11 Ramsel
66,Bergstraat 71,2020-12-03,06:00:00,22,6,16,FMN GV 11 Ramsel
66,Bergstraat 71,2020-12-03,07:00:00,80,12,68,FMN GV 11 Ramsel
66,Bergstraat 71,2020-12-03,08:00:00,106,10,96,FMN GV 11 Ramsel
66,Bergstraat 71,2020-12-03,09:00:00,22,8,14,FMN GV 11 Ramsel
66,Bergstraat 71,2020-12-03,10:00:00,38,28,10,FMN GV 11 Ramsel
66,Bergstraat 71,2020-12-03,11:00:00,44,28,16,FMN GV 11 Ramsel
66,Bergstraat 71,2020-12-03,12:00:00,40,26,14,FMN GV 11 Ramsel
66,Bergstraat 71,2020-12-03,13:00:00,22,14,8,FMN GV 11 Ramsel
66,Bergstraat 71,2020-12-03,14:00:00,32,28,4,FMN GV 11 Ramsel
66,Bergstraat 71,2020-12-03,15:00:00,88,76,12,FMN GV 11 Ramsel
66,Bergstraat 71,2020-12-03,16:00:00,56,46,10,FMN GV 11 Ramsel
66,Bergstraat 71,2020-12-03,17:00:00,40,30,10,FMN GV 11 Ramsel
66,Bergstraat 71,2020-12-03,18:00:00,20,10,10,FMN GV 11 Ramsel
66,Bergstraat 71,2020-12-03,19:00:00,12,10,2,FMN GV 11 Ramsel
66,Bergstraat 71,2020-12-03,20:00:00,2,2,0,FMN GV 11 Ramsel
66,Bergstraat 71,2020-12-03,21:00:00,6,4,2,FMN GV 11 Ramsel
66,Bergstraat 71,2020-12-03,22:00:00,10,4,6,FMN GV 11 Ramsel
66,Bergstraat 71,2020-12-03,23:00:00,2,2,0,FMN GV 11 Ramsel
66,Bergstraat 71,2020-12-04,00:00:00,0,0,0,FMN GV 11 Ramsel
66,Bergstraat 71,2020-12-04,01:00:00,0,0,0,FMN GV 11 Ramsel
66,Bergstraat 71,2020-12-04,02:00:00,0,0,0,FMN GV 11 Ramsel
66,Bergstraat 71,2020-12-04,03:00:00,0,0,0,FMN GV 11 Ramsel
66,Bergstraat 71,2020-12-04,04:00:00,6,2,4,FMN GV 11 Ramsel
66,Bergstraat 71,2020-12-04,05:00:00,4,2,2,FMN GV 11 Ramsel
66,Bergstraat 71,2020-12-04,06:00:00,10,4,6,FMN GV 11 Ramsel
66,Bergstraat 71,2020-12-04,07:00:00,110,10,100,FMN GV 11 Ramsel
66,Bergstraat 71,2020-12-04,08:00:00,66,4,62,FMN GV 11 Ramsel
66,Bergstraat 71,2020-12-04,09:00:00,34,8,26,FMN GV 11 Ramsel
66,Bergstraat 71,2020-12-04,10:00:00,44,26,18,FMN GV 11 Ramsel
66,Bergstraat 71,2020-12-04,11:00:00,36,22,14,FMN GV 11 Ramsel
66,Bergstraat 71,2020-12-04,12:00:00,136,60,76,FMN GV 11 Ramsel
66,Bergstraat 71,2020-12-04,13:00:00,64,30,34,FMN GV 11 Ramsel
66,Bergstraat 71,2020-12-04,14:00:00,88,36,52,FMN GV 11 Ramsel
66,Bergstraat 71,2020-12-04,15:00:00,126,90,36,FMN GV 11 Ramsel
66,Bergstraat 71,2020-12-04,16:00:00,112,86,26,FMN GV 11 Ramsel
66,Bergstraat 71,2020-12-04,17:00:00,38,22,16,FMN GV 11 Ramsel
66,Bergstraat 71,2020-12-04,18:00:00,8,8,0,FMN GV 11 Ramsel
66,Bergstraat 71,2020-12-04,19:00:00,12,4,8,FMN GV 11 Ramsel
66,Bergstraat 71,2020-12-04,20:00:00,10,6,4,FMN GV 11 Ramsel
66,Bergstraat 71,2020-12-04,21:00:00,12,6,6,FMN GV 11 Ramsel
66,Bergstraat 71,2020-12-04,22:00:00,4,0,4,FMN GV 11 Ramsel
66,Bergstraat 71,2020-12-04,23:00:00,0,0,0,FMN GV 11 Ramsel
66,Bergstraat 71,2020-12-05,00:00:00,2,2,0,FMN GV 11 Ramsel
66,Bergstraat 71,2020-12-05,01:00:00,0,0,0,FMN GV 11 Ramsel
66,Bergstraat 71,2020-12-05,02:00:00,0,0,0,FMN GV 11 Ramsel
66,Bergstraat 71,2020-12-05,03:00:00,0,0,0,FMN GV 11 Ramsel
66,Bergstraat 71,2020-12-05,04:00:00,0,0,0,FMN GV 11 Ramsel
66,Bergstraat 71,2020-12-05,05:00:00,2,0,2,FMN GV 11 Ramsel
66,Bergstraat 71,2020-12-05,06:00:00,6,4,2,FMN GV 11 Ramsel
66,Bergstraat 71,2020-12-05,07:00:00,4,2,2,FMN GV 11 Ramsel
66,Bergstraat 71,2020-12-05,08:00:00,16,4,12,FMN GV 11 Ramsel
66,Bergstraat 71,2020-12-05,09:00:00,18,8,10,FMN GV 11 Ramsel
66,Bergstraat 71,2020-12-05,10:00:00,60,26,34,FMN GV 11 Ramsel
66,Bergstraat 71,2020-12-05,11:00:00,94,40,54,FMN GV 11 Ramsel
66,Bergstraat 71,2020-12-05,12:00:00,86,48,38,FMN GV 11 Ramsel
66,Bergstraat 71,2020-12-05,13:00:00,170,38,132,FMN GV 11 Ramsel
66,Bergstraat 71,2020-12-05,14:00:00,170,98,72,FMN GV 11 Ramsel
66,Bergstraat 71,2020-12-05,15:00:00,144,110,34,FMN GV 11 Ramsel
66,Bergstraat 71,2020-12-05,16:00:00,74,52,22,FMN GV 11 Ramsel
66,Bergstraat 71,2020-12-05,17:00:00,20,8,12,FMN GV 11 Ramsel
66,Bergstraat 71,2020-12-05,18:00:00,6,6,0,FMN GV 11 Ramsel
66,Bergstraat 71,2020-12-05,19:00:00,6,6,0,FMN GV 11 Ramsel
66,Bergstraat 71,2020-12-05,20:00:00,16,12,4,FMN GV 11 Ramsel
66,Bergstraat 71,2020-12-05,21:00:00,6,2,4,FMN GV 11 Ramsel
66,Bergstraat 71,2020-12-05,22:00:00,4,4,0,FMN GV 11 Ramsel
66,Bergstraat 71,2020-12-05,23:00:00,10,0,10,FMN GV 11 Ramsel
66,Bergstraat 71,2020-12-06,00:00:00,2,2,0,FMN GV 11 Ramsel
66,Bergstraat 71,2020-12-06,01:00:00,0,0,0,FMN GV 11 Ramsel
66,Bergstraat 71,2020-12-06,02:00:00,0,0,0,FMN GV 11 Ramsel
66,Bergstraat 71,2020-12-06,03:00:00,0,0,0,FMN GV 11 Ramsel
66,Bergstraat 71,2020-12-06,04:00:00,0,0,0,FMN GV 11 Ramsel
66,Bergstraat 71,2020-12-06,05:00:00,0,0,0,FMN GV 11 Ramsel
66,Bergstraat 71,2020-12-06,06:00:00,0,0,0,FMN GV 11 Ramsel
66,Bergstraat 71,2020-12-06,07:00:00,6,0,6,FMN GV 11 Ramsel
66,Bergstraat 71,2020-12-06,08:00:00,28,8,20,FMN GV 11 Ramsel
66,Bergstraat 71,2020-12-06,09:00:00,42,16,26,FMN GV 11 Ramsel
66,Bergstraat 71,2020-12-06,10:00:00,66,38,28,FMN GV 11 Ramsel
66,Bergstraat 71,2020-12-06,11:00:00,90,44,46,FMN GV 11 Ramsel
66,Bergstraat 71,2020-12-06,12:00:00,74,50,24,FMN GV 11 Ramsel
66,Bergstraat 71,2020-12-06,13:00:00,78,34,44,FMN GV 11 Ramsel
66,Bergstraat 71,2020-12-06,14:00:00,90,40,50,FMN GV 11 Ramsel
66,Bergstraat 71,2020-12-06,15:00:00,52,32,20,FMN GV 11 Ramsel
66,Bergstraat 71,2020-12-06,16:00:00,28,18,10,FMN GV 11 Ramsel
66,Bergstraat 71,2020-12-06,17:00:00,14,4,10,FMN GV 11 Ramsel
66,Bergstraat 71,2020-12-06,18:00:00,4,2,2,FMN GV 11 Ramsel
66,Bergstraat 71,2020-12-06,19:00:00,10,4,6,FMN GV 11 Ramsel
66,Bergstraat 71,2020-12-06,20:00:00,6,4,2,FMN GV 11 Ramsel
66,Bergstraat 71,2020-12-06,21:00:00,6,2,4,FMN GV 11 Ramsel
66,Bergstraat 71,2020-12-06,22:00:00,2,0,2,FMN GV 11 Ramsel
66,Bergstraat 71,2020-12-06,23:00:00,2,0,2,FMN GV 11 Ramsel
66,Bergstraat 71,2020-12-07,00:00:00,0,0,0,FMN GV 11 Ramsel
66,Bergstraat 71,2020-12-07,01:00:00,0,0,0,FMN GV 11 Ramsel
66,Bergstraat 71,2020-12-07,02:00:00,0,0,0,FMN GV 11 Ramsel
66,Bergstraat 71,2020-12-07,03:00:00,0,0,0,FMN GV 11 Ramsel
66,Bergstraat 71,2020-12-07,04:00:00,0,0,0,FMN GV 11 Ramsel
66,Bergstraat 71,2020-12-07,05:00:00,6,4,2,FMN GV 11 Ramsel
66,Bergstraat 71,2020-12-07,06:00:00,14,6,8,FMN GV 11 Ramsel
66,Bergstraat 71,2020-12-07,07:00:00,96,8,88,FMN GV 11 Ramsel
66,Bergstraat 71,2020-12-07,08:00:00,74,4,70,FMN GV 11 Ramsel
66,Bergstraat 71,2020-12-07,09:00:00,18,10,8,FMN GV 11 Ramsel
66,Bergstraat 71,2020-12-07,10:00:00,34,18,16,FMN GV 11 Ramsel
66,Bergstraat 71,2020-12-07,11:00:00,42,18,24,FMN GV 11 Ramsel
66,Bergstraat 71,2020-12-07,12:00:00,136,68,68,FMN GV 11 Ramsel
66,Bergstraat 71,2020-12-07,13:00:00,40,14,26,FMN GV 11 Ramsel
66,Bergstraat 71,2020-12-07,14:00:00,88,40,48,FMN GV 11 Ramsel
66,Bergstraat 71,2020-12-07,15:00:00,110,84,26,FMN GV 11 Ramsel
66,Bergstraat 71,2020-12-07,16:00:00,88,74,14,FMN GV 11 Ramsel
66,Bergstraat 71,2020-12-07,17:00:00,24,12,12,FMN GV 11 Ramsel
66,Bergstraat 71,2020-12-07,18:00:00,18,12,6,FMN GV 11 Ramsel
66,Bergstraat 71,2020-12-07,19:00:00,6,2,4,FMN GV 11 Ramsel
66,Bergstraat 71,2020-12-07,20:00:00,16,10,6,FMN GV 11 Ramsel
66,Bergstraat 71,2020-12-07,21:00:00,4,2,2,FMN GV 11 Ramsel
66,Bergstraat 71,2020-12-07,22:00:00,4,4,0,FMN GV 11 Ramsel
66,Bergstraat 71,2020-12-07,23:00:00,0,0,0,FMN GV 11 Ramsel
66,Bergstraat 71,2020-12-08,00:00:00,0,0,0,FMN GV 11 Ramsel
66,Bergstraat 71,2020-12-08,01:00:00,0,0,0,FMN GV 11 Ramsel
66,Bergstraat 71,2020-12-08,02:00:00,0,0,0,FMN GV 11 Ramsel
66,Bergstraat 71,2020-12-08,03:00:00,0,0,0,FMN GV 11 Ramsel
66,Bergstraat 71,2020-12-08,04:00:00,0,0,0,FMN GV 11 Ramsel
66,Bergstraat 71,2020-12-08,05:00:00,10,10,0,FMN GV 11 Ramsel
66,Bergstraat 71,2020-12-08,06:00:00,12,2,10,FMN GV 11 Ramsel
66,Bergstraat 71,2020-12-08,07:00:00,86,10,76,FMN GV 11 Ramsel
66,Bergstraat 71,2020-12-08,08:00:00,96,12,84,FMN GV 11 Ramsel
66,Bergstraat 71,2020-12-08,09:00:00,10,2,8,FMN GV 11 Ramsel
66,Bergstraat 71,2020-12-08,10:00:00,64,38,26,FMN GV 11 Ramsel
66,Bergstraat 71,2020-12-08,11:00:00,48,32,16,FMN GV 11 Ramsel
66,Bergstraat 71,2020-12-08,12:00:00,110,42,68,FMN GV 11 Ramsel
66,Bergstraat 71,2020-12-08,13:00:00,112,28,84,FMN GV 11 Ramsel
66,Bergstraat 71,2020-12-08,14:00:00,136,74,62,FMN GV 11 Ramsel
66,Bergstraat 71,2020-12-08,15:00:00,144,100,44,FMN GV 11 Ramsel
66,Bergstraat 71,2020-12-08,16:00:00,84,72,12,FMN GV 11 Ramsel
66,Bergstraat 71,2020-12-08,17:00:00,30,24,6,FMN GV 11 Ramsel
66,Bergstraat 71,2020-12-08,18:00:00,8,6,2,FMN GV 11 Ramsel
66,Bergstraat 71,2020-12-08,19:00:00,24,12,12,FMN GV 11 Ramsel
66,Bergstraat 71,2020-12-08,20:00:00,24,16,8,FMN GV 11 Ramsel
66,Bergstraat 71,2020-12-08,21:00:00,4,0,4,FMN GV 11 Ramsel
66,Bergstraat 71,2020-12-08,22:00:00,6,0,6,FMN GV 11 Ramsel
66,Bergstraat 71,2020-12-08,23:00:00,0,0,0,FMN GV 11 Ramsel
66,Bergstraat 71,2020-12-09,00:00:00,0,0,0,FMN GV 11 Ramsel
66,Bergstraat 71,2020-12-09,01:00:00,0,0,0,FMN GV 11 Ramsel
66,Bergstraat 71,2020-12-09,02:00:00,0,0,0,FMN GV 11 Ramsel
66,Bergstraat 71,2020-12-09,03:00:00,0,0,0,FMN GV 11 Ramsel
66,Bergstraat 71,2020-12-09,04:00:00,0,0,0,FMN GV 11 Ramsel
66,Bergstraat 71,2020-12-09,05:00:00,6,4,2,FMN GV 11 Ramsel
66,Bergstraat 71,2020-12-09,06:00:00,22,12,10,FMN GV 11 Ramsel
66,Bergstraat 71,2020-12-09,07:00:00,114,10,104,FMN GV 11 Ramsel
66,Bergstraat 71,2020-12-09,08:00:00,104,6,98,FMN GV 11 Ramsel
66,Bergstraat 71,2020-12-09,09:00:00,52,10,42,FMN GV 11 Ramsel
66,Bergstraat 71,2020-12-09,10:00:00,64,42,22,FMN GV 11 Ramsel
66,Bergstraat 71,2020-12-09,11:00:00,98,58,40,FMN GV 11 Ramsel
66,Bergstraat 71,2020-12-09,12:00:00,128,112,16,FMN GV 11 Ramsel
66,Bergstraat 71,2020-12-09,13:00:00,58,30,28,FMN GV 11 Ramsel
66,Bergstraat 71,2020-12-09,14:00:00,72,36,36,FMN GV 11 Ramsel
66,Bergstraat 71,2020-12-09,15:00:00,50,28,22,FMN GV 11 Ramsel
66,Bergstraat 71,2020-12-09,16:00:00,44,30,14,FMN GV 11 Ramsel
66,Bergstraat 71,2020-12-09,17:00:00,46,30,16,FMN GV 11 Ramsel
66,Bergstraat 71,2020-12-09,18:00:00,22,14,8,FMN GV 11 Ramsel
66,Bergstraat 71,2020-12-09,19:00:00,36,22,14,FMN GV 11 Ramsel
66,Bergstraat 71,2020-12-09,20:00:00,20,6,14,FMN GV 11 Ramsel
66,Bergstraat 71,2020-12-09,21:00:00,2,0,2,FMN GV 11 Ramsel
66,Bergstraat 71,2020-12-09,22:00:00,6,4,2,FMN GV 11 Ramsel
66,Bergstraat 71,2020-12-09,23:00:00,6,4,2,FMN GV 11 Ramsel
66,Bergstraat 71,2020-12-10,00:00:00,0,0,0,FMN GV 11 Ramsel
66,Bergstraat 71,2020-12-10,01:00:00,0,0,0,FMN GV 11 Ramsel
66,Bergstraat 71,2020-12-10,02:00:00,0,0,0,FMN GV 11 Ramsel
66,Bergstraat 71,2020-12-10,03:00:00,0,0,0,FMN GV 11 Ramsel
66,Bergstraat 71,2020-12-10,04:00:00,0,0,0,FMN GV 11 Ramsel
66,Bergstraat 71,2020-12-10,05:00:00,10,8,2,FMN GV 11 Ramsel
66,Bergstraat 71,2020-12-10,06:00:00,18,4,14,FMN GV 11 Ramsel
66,Bergstraat 71,2020-12-10,07:00:00,128,16,112,FMN GV 11 Ramsel
66,Bergstraat 71,2020-12-10,08:00:00,92,6,86,FMN GV 11 Ramsel
66,Bergstraat 71,2020-12-10,09:00:00,32,8,24,FMN GV 11 Ramsel
66,Bergstraat 71,2020-12-10,10:00:00,94,70,24,FMN GV 11 Ramsel
66,Bergstraat 71,2020-12-10,11:00:00,74,50,24,FMN GV 11 Ramsel
66,Bergstraat 71,2020-12-10,12:00:00,140,48,92,FMN GV 11 Ramsel
66,Bergstraat 71,2020-12-10,13:00:00,100,36,64,FMN GV 11 Ramsel
66,Bergstraat 71,2020-12-10,14:00:00,156,76,80,FMN GV 11 Ramsel
66,Bergstraat 71,2020-12-10,15:00:00,142,82,60,FMN GV 11 Ramsel
66,Bergstraat 71,2020-12-10,16:00:00,84,58,26,FMN GV 11 Ramsel
66,Bergstraat 71,2020-12-10,17:00:00,40,28,12,FMN GV 11 Ramsel
66,Bergstraat 71,2020-12-10,18:00:00,26,14,12,FMN GV 11 Ramsel
66,Bergstraat 71,2020-12-10,19:00:00,24,16,8,FMN GV 11 Ramsel
66,Bergstraat 71,2020-12-10,20:00:00,10,4,6,FMN GV 11 Ramsel
66,Bergstraat 71,2020-12-10,21:00:00,0,0,0,FMN GV 11 Ramsel
66,Bergstraat 71,2020-12-10,22:00:00,8,4,4,FMN GV 11 Ramsel
66,Bergstraat 71,2020-12-10,23:00:00,0,0,0,FMN GV 11 Ramsel
66,Bergstraat 71,2020-12-11,00:00:00,0,0,0,FMN GV 11 Ramsel
66,Bergstraat 71,2020-12-11,01:00:00,0,0,0,FMN GV 11 Ramsel
66,Bergstraat 71,2020-12-11,02:00:00,0,0,0,FMN GV 11 Ramsel
66,Bergstraat 71,2020-12-11,03:00:00,0,0,0,FMN GV 11 Ramsel
66,Bergstraat 71,2020-12-11,04:00:00,0,0,0,FMN GV 11 Ramsel
66,Bergstraat 71,2020-12-11,05:00:00,4,4,0,FMN GV 11 Ramsel
66,Bergstraat 71,2020-12-11,06:00:00,12,2,10,FMN GV 11 Ramsel
66,Bergstraat 71,2020-12-11,07:00:00,76,4,72,FMN GV 11 Ramsel
66,Bergstraat 71,2020-12-11,08:00:00,46,8,38,FMN GV 11 Ramsel
66,Bergstraat 71,2020-12-11,09:00:00,18,6,12,FMN GV 11 Ramsel
66,Bergstraat 71,2020-12-11,10:00:00,62,46,16,FMN GV 11 Ramsel
66,Bergstraat 71,2020-12-11,11:00:00,50,34,16,FMN GV 11 Ramsel
66,Bergstraat 71,2020-12-11,12:00:00,72,36,36,FMN GV 11 Ramsel
66,Bergstraat 71,2020-12-11,13:00:00,18,10,8,FMN GV 11 Ramsel
66,Bergstraat 71,2020-12-11,14:00:00,32,28,4,FMN GV 11 Ramsel
66,Bergstraat 71,2020-12-11,15:00:00,38,26,12,FMN GV 11 Ramsel
66,Bergstraat 71,2020-12-11,16:00:00,24,22,2,FMN GV 11 Ramsel
66,Bergstraat 71,2020-12-11,17:00:00,12,6,6,FMN GV 11 Ramsel
66,Bergstraat 71,2020-12-11,18:00:00,14,8,6,FMN GV 11 Ramsel
66,Bergstraat 71,2020-12-11,19:00:00,20,14,6,FMN GV 11 Ramsel
66,Bergstraat 71,2020-12-11,20:00:00,8,6,2,FMN GV 11 Ramsel
66,Bergstraat 71,2020-12-11,21:00:00,6,2,4,FMN GV 11 Ramsel
66,Bergstraat 71,2020-12-11,22:00:00,6,6,0,FMN GV 11 Ramsel
66,Bergstraat 71,2020-12-11,23:00:00,6,0,6,FMN GV 11 Ramsel
66,Bergstraat 71,2020-12-12,00:00:00,6,4,2,FMN GV 11 Ramsel
66,Bergstraat 71,2020-12-12,01:00:00,0,0,0,FMN GV 11 Ramsel
66,Bergstraat 71,2020-12-12,02:00:00,0,0,0,FMN GV 11 Ramsel
66,Bergstraat 71,2020-12-12,03:00:00,2,0,2,FMN GV 11 Ramsel
66,Bergstraat 71,2020-12-12,04:00:00,2,0,2,FMN GV 11 Ramsel
66,Bergstraat 71,2020-12-12,05:00:00,0,0,0,FMN GV 11 Ramsel
66,Bergstraat 71,2020-12-12,06:00:00,4,0,4,FMN GV 11 Ramsel
66,Bergstraat 71,2020-12-12,07:00:00,6,2,4,FMN GV 11 Ramsel
66,Bergstraat 71,2020-12-12,08:00:00,24,6,18,FMN GV 11 Ramsel
66,Bergstraat 71,2020-12-12,09:00:00,40,12,28,FMN GV 11 Ramsel
66,Bergstraat 71,2020-12-12,10:00:00,70,20,50,FMN GV 11 Ramsel
66,Bergstraat 71,2020-12-12,11:00:00,74,40,34,FMN GV 11 Ramsel
66,Bergstraat 71,2020-12-12,12:00:00,30,18,12,FMN GV 11 Ramsel
66,Bergstraat 71,2020-12-12,13:00:00,78,28,50,FMN GV 11 Ramsel
66,Bergstraat 71,2020-12-12,14:00:00,56,24,32,FMN GV 11 Ramsel
66,Bergstraat 71,2020-12-12,15:00:00,94,62,32,FMN GV 11 Ramsel
66,Bergstraat 71,2020-12-12,16:00:00,36,20,16,FMN GV 11 Ramsel
66,Bergstraat 71,2020-12-12,17:00:00,14,6,8,FMN GV 11 Ramsel
66,Bergstraat 71,2020-12-12,18:00:00,6,2,4,FMN GV 11 Ramsel
66,Bergstraat 71,2020-12-12,19:00:00,8,8,0,FMN GV 11 Ramsel
66,Bergstraat 71,2020-12-12,20:00:00,6,2,4,FMN GV 11 Ramsel
66,Bergstraat 71,2020-12-12,21:00:00,8,6,2,FMN GV 11 Ramsel
66,Bergstraat 71,2020-12-12,22:00:00,4,2,2,FMN GV 11 Ramsel
66,Bergstraat 71,2020-12-12,23:00:00,8,2,6,FMN GV 11 Ramsel
66,Bergstraat 71,2020-12-13,00:00:00,2,2,0,FMN GV 11 Ramsel
66,Bergstraat 71,2020-12-13,01:00:00,0,0,0,FMN GV 11 Ramsel
66,Bergstraat 71,2020-12-13,02:00:00,0,0,0,FMN GV 11 Ramsel
66,Bergstraat 71,2020-12-13,03:00:00,0,0,0,FMN GV 11 Ramsel
66,Bergstraat 71,2020-12-13,04:00:00,0,0,0,FMN GV 11 Ramsel
66,Bergstraat 71,2020-12-13,05:00:00,2,0,2,FMN GV 11 Ramsel
66,Bergstraat 71,2020-12-13,06:00:00,6,2,4,FMN GV 11 Ramsel
66,Bergstraat 71,2020-12-13,07:00:00,8,4,4,FMN GV 11 Ramsel
66,Bergstraat 71,2020-12-13,08:00:00,40,2,38,FMN GV 11 Ramsel
66,Bergstraat 71,2020-12-13,09:00:00,184,38,146,FMN GV 11 Ramsel
66,Bergstraat 71,2020-12-13,10:00:00,214,98,116,FMN GV 11 Ramsel
66,Bergstraat 71,2020-12-13,11:00:00,224,114,110,FMN GV 11 Ramsel
66,Bergstraat 71,2020-12-13,12:00:00,154,84,70,FMN GV 11 Ramsel
66,Bergstraat 71,2020-12-13,13:00:00,120,68,52,FMN GV 11 Ramsel
66,Bergstraat 71,2020-12-13,14:00:00,158,72,86,FMN GV 11 Ramsel
66,Bergstraat 71,2020-12-13,15:00:00,88,38,50,FMN GV 11 Ramsel
66,Bergstraat 71,2020-12-13,16:00:00,68,38,30,FMN GV 11 Ramsel
66,Bergstraat 71,2020-12-13,17:00:00,12,8,4,FMN GV 11 Ramsel
66,Bergstraat 71,2020-12-13,18:00:00,8,4,4,FMN GV 11 Ramsel
66,Bergstraat 71,2020-12-13,19:00:00,4,2,2,FMN GV 11 Ramsel
66,Bergstraat 71,2020-12-13,20:00:00,2,2,0,FMN GV 11 Ramsel
66,Bergstraat 71,2020-12-13,21:00:00,0,0,0,FMN GV 11 Ramsel
66,Bergstraat 71,2020-12-13,22:00:00,2,2,0,FMN GV 11 Ramsel
66,Bergstraat 71,2020-12-13,23:00:00,0,0,0,FMN GV 11 Ramsel
66,Bergstraat 71,2020-12-14,00:00:00,0,0,0,FMN GV 11 Ramsel
66,Bergstraat 71,2020-12-14,01:00:00,0,0,0,FMN GV 11 Ramsel
66,Bergstraat 71,2020-12-14,02:00:00,0,0,0,FMN GV 11 Ramsel
66,Bergstraat 71,2020-12-14,03:00:00,0,0,0,FMN GV 11 Ramsel
66,Bergstraat 71,2020-12-14,04:00:00,0,0,0,FMN GV 11 Ramsel
66,Bergstraat 71,2020-12-14,05:00:00,4,2,2,FMN GV 11 Ramsel
66,Bergstraat 71,2020-12-14,06:00:00,10,2,8,FMN GV 11 Ramsel
66,Bergstraat 71,2020-12-14,07:00:00,66,8,58,FMN GV 11 Ramsel
66,Bergstraat 71,2020-12-14,08:00:00,48,4,44,FMN GV 11 Ramsel
66,Bergstraat 71,2020-12-14,09:00:00,16,6,10,FMN GV 11 Ramsel
66,Bergstraat 71,2020-12-14,10:00:00,22,14,8,FMN GV 11 Ramsel
66,Bergstraat 71,2020-12-14,11:00:00,34,18,16,FMN GV 11 Ramsel
66,Bergstraat 71,2020-12-14,12:00:00,142,48,94,FMN GV 11 Ramsel
66,Bergstraat 71,2020-12-14,13:00:00,92,48,44,FMN GV 11 Ramsel
66,Bergstraat 71,2020-12-14,14:00:00,120,92,28,FMN GV 11 Ramsel
66,Bergstraat 71,2020-12-14,15:00:00,116,82,34,FMN GV 11 Ramsel
66,Bergstraat 71,2020-12-14,16:00:00,66,50,16,FMN GV 11 Ramsel
66,Bergstraat 71,2020-12-14,17:00:00,16,12,4,FMN GV 11 Ramsel
66,Bergstraat 71,2020-12-14,18:00:00,6,6,0,FMN GV 11 Ramsel
66,Bergstraat 71,2020-12-14,19:00:00,6,0,6,FMN GV 11 Ramsel
66,Bergstraat 71,2020-12-14,20:00:00,0,0,0,FMN GV 11 Ramsel
66,Bergstraat 71,2020-12-14,21:00:00,4,4,0,FMN GV 11 Ramsel
66,Bergstraat 71,2020-12-14,22:00:00,14,2,12,FMN GV 11 Ramsel
66,Bergstraat 71,2020-12-14,23:00:00,0,0,0,FMN GV 11 Ramsel
66,Bergstraat 71,2020-12-15,00:00:00,0,0,0,FMN GV 11 Ramsel
66,Bergstraat 71,2020-12-15,01:00:00,0,0,0,FMN GV 11 Ramsel
66,Bergstraat 71,2020-12-15,02:00:00,0,0,0,FMN GV 11 Ramsel
66,Bergstraat 71,2020-12-15,03:00:00,0,0,0,FMN GV 11 Ramsel
66,Bergstraat 71,2020-12-15,04:00:00,0,0,0,FMN GV 11 Ramsel
66,Bergstraat 71,2020-12-15,05:00:00,8,6,2,FMN GV 11 Ramsel
66,Bergstraat 71,2020-12-15,06:00:00,10,4,6,FMN GV 11 Ramsel
66,Bergstraat 71,2020-12-15,07:00:00,118,14,104,FMN GV 11 Ramsel
66,Bergstraat 71,2020-12-15,08:00:00,70,12,58,FMN GV 11 Ramsel
66,Bergstraat 71,2020-12-15,09:00:00,26,12,14,FMN GV 11 Ramsel
66,Bergstraat 71,2020-12-15,10:00:00,74,52,22,FMN GV 11 Ramsel
66,Bergstraat 71,2020-12-15,11:00:00,46,18,28,FMN GV 11 Ramsel
66,Bergstraat 71,2020-12-15,12:00:00,48,24,24,FMN GV 11 Ramsel
66,Bergstraat 71,2020-12-15,13:00:00,32,28,4,FMN GV 11 Ramsel
66,Bergstraat 71,2020-12-15,14:00:00,30,24,6,FMN GV 11 Ramsel
66,Bergstraat 71,2020-12-15,15:00:00,86,54,32,FMN GV 11 Ramsel
66,Bergstraat 71,2020-12-15,16:00:00,78,46,32,FMN GV 11 Ramsel
66,Bergstraat 71,2020-12-15,17:00:00,36,20,16,FMN GV 11 Ramsel
66,Bergstraat 71,2020-12-15,18:00:00,12,8,4,FMN GV 11 Ramsel
66,Bergstraat 71,2020-12-15,19:00:00,18,4,14,FMN GV 11 Ramsel
66,Bergstraat 71,2020-12-15,20:00:00,20,10,10,FMN GV 11 Ramsel
66,Bergstraat 71,2020-12-15,21:00:00,2,0,2,FMN GV 11 Ramsel
66,Bergstraat 71,2020-12-15,22:00:00,8,2,6,FMN GV 11 Ramsel
66,Bergstraat 71,2020-12-15,23:00:00,2,2,0,FMN GV 11 Ramsel
66,Bergstraat 71,2020-12-16,00:00:00,0,0,0,FMN GV 11 Ramsel
66,Bergstraat 71,2020-12-16,01:00:00,0,0,0,FMN GV 11 Ramsel
66,Bergstraat 71,2020-12-16,02:00:00,0,0,0,FMN GV 11 Ramsel
66,Bergstraat 71,2020-12-16,03:00:00,0,0,0,FMN GV 11 Ramsel
66,Bergstraat 71,2020-12-16,04:00:00,4,2,2,FMN GV 11 Ramsel
66,Bergstraat 71,2020-12-16,05:00:00,8,2,6,FMN GV 11 Ramsel
66,Bergstraat 71,2020-12-16,06:00:00,22,8,14,FMN GV 11 Ramsel
66,Bergstraat 71,2020-12-16,07:00:00,62,16,46,FMN GV 11 Ramsel
66,Bergstraat 71,2020-12-16,08:00:00,52,6,46,FMN GV 11 Ramsel
66,Bergstraat 71,2020-12-16,09:00:00,58,28,30,FMN GV 11 Ramsel
66,Bergstraat 71,2020-12-16,10:00:00,90,36,54,FMN GV 11 Ramsel
66,Bergstraat 71,2020-12-16,11:00:00,84,52,32,FMN GV 11 Ramsel
66,Bergstraat 71,2020-12-16,12:00:00,114,70,44,FMN GV 11 Ramsel
66,Bergstraat 71,2020-12-16,13:00:00,238,82,156,FMN GV 11 Ramsel
66,Bergstraat 71,2020-12-16,14:00:00,238,128,110,FMN GV 11 Ramsel
66,Bergstraat 71,2020-12-16,15:00:00,194,134,60,FMN GV 11 Ramsel
66,Bergstraat 71,2020-12-16,16:00:00,74,48,26,FMN GV 11 Ramsel
66,Bergstraat 71,2020-12-16,17:00:00,52,34,18,FMN GV 11 Ramsel
66,Bergstraat 71,2020-12-16,18:00:00,30,16,14,FMN GV 11 Ramsel
66,Bergstraat 71,2020-12-16,19:00:00,14,6,8,FMN GV 11 Ramsel
66,Bergstraat 71,2020-12-16,20:00:00,16,4,12,FMN GV 11 Ramsel
66,Bergstraat 71,2020-12-16,21:00:00,14,14,0,FMN GV 11 Ramsel
66,Bergstraat 71,2020-12-16,22:00:00,16,6,10,FMN GV 11 Ramsel
66,Bergstraat 71,2020-12-16,23:00:00,16,6,10,FMN GV 11 Ramsel
66,Bergstraat 71,2020-12-17,00:00:00,0,0,0,FMN GV 11 Ramsel
66,Bergstraat 71,2020-12-17,01:00:00,0,0,0,FMN GV 11 Ramsel
66,Bergstraat 71,2020-12-17,02:00:00,0,0,0,FMN GV 11 Ramsel
66,Bergstraat 71,2020-12-17,03:00:00,0,0,0,FMN GV 11 Ramsel
66,Bergstraat 71,2020-12-17,04:00:00,2,2,0,FMN GV 11 Ramsel
66,Bergstraat 71,2020-12-17,05:00:00,6,4,2,FMN GV 11 Ramsel
66,Bergstraat 71,2020-12-17,06:00:00,20,8,12,FMN GV 11 Ramsel
66,Bergstraat 71,2020-12-17,07:00:00,22,4,18,FMN GV 11 Ramsel
66,Bergstraat 71,2020-12-17,08:00:00,46,14,32,FMN GV 11 Ramsel
66,Bergstraat 71,2020-12-17,09:00:00,36,4,32,FMN GV 11 Ramsel
66,Bergstraat 71,2020-12-17,10:00:00,48,18,30,FMN GV 11 Ramsel
66,Bergstraat 71,2020-12-17,11:00:00,58,42,16,FMN GV 11 Ramsel
66,Bergstraat 71,2020-12-17,12:00:00,60,30,30,FMN GV 11 Ramsel
66,Bergstraat 71,2020-12-17,13:00:00,124,64,60,FMN GV 11 Ramsel
66,Bergstraat 71,2020-12-17,14:00:00,174,84,90,FMN GV 11 Ramsel
66,Bergstraat 71,2020-12-17,15:00:00,98,70,28,FMN GV 11 Ramsel
66,Bergstraat 71,2020-12-17,16:00:00,70,50,20,FMN GV 11 Ramsel
66,Bergstraat 71,2020-12-17,17:00:00,22,18,4,FMN GV 11 Ramsel
66,Bergstraat 71,2020-12-17,18:00:00,30,16,14,FMN GV 11 Ramsel
66,Bergstraat 71,2020-12-17,19:00:00,26,16,10,FMN GV 11 Ramsel
66,Bergstraat 71,2020-12-17,20:00:00,10,8,2,FMN GV 11 Ramsel
66,Bergstraat 71,2020-12-17,21:00:00,2,2,0,FMN GV 11 Ramsel
66,Bergstraat 71,2020-12-17,22:00:00,10,2,8,FMN GV 11 Ramsel
66,Bergstraat 71,2020-12-17,23:00:00,6,0,6,FMN GV 11 Ramsel
66,Bergstraat 71,2020-12-18,00:00:00,0,0,0,FMN GV 11 Ramsel
66,Bergstraat 71,2020-12-18,01:00:00,0,0,0,FMN GV 11 Ramsel
66,Bergstraat 71,2020-12-18,02:00:00,0,0,0,FMN GV 11 Ramsel
66,Bergstraat 71,2020-12-18,03:00:00,0,0,0,FMN GV 11 Ramsel
66,Bergstraat 71,2020-12-18,04:00:00,0,0,0,FMN GV 11 Ramsel
66,Bergstraat 71,2020-12-18,05:00:00,8,6,2,FMN GV 11 Ramsel
66,Bergstraat 71,2020-12-18,06:00:00,18,6,12,FMN GV 11 Ramsel
66,Bergstraat 71,2020-12-18,07:00:00,30,18,12,FMN GV 11 Ramsel
66,Bergstraat 71,2020-12-18,08:00:00,30,6,24,FMN GV 11 Ramsel
66,Bergstraat 71,2020-12-18,09:00:00,38,16,22,FMN GV 11 Ramsel
66,Bergstraat 71,2020-12-18,10:00:00,70,24,46,FMN GV 11 Ramsel
66,Bergstraat 71,2020-12-18,11:00:00,62,34,28,FMN GV 11 Ramsel
66,Bergstraat 71,2020-12-18,12:00:00,116,56,60,FMN GV 11 Ramsel
66,Bergstraat 71,2020-12-18,13:00:00,252,94,158,FMN GV 11 Ramsel
66,Bergstraat 71,2020-12-18,14:00:00,236,126,110,FMN GV 11 Ramsel
66,Bergstraat 71,2020-12-18,15:00:00,206,124,82,FMN GV 11 Ramsel
66,Bergstraat 71,2020-12-18,16:00:00,110,56,54,FMN GV 11 Ramsel
66,Bergstraat 71,2020-12-18,17:00:00,38,24,14,FMN GV 11 Ramsel
66,Bergstraat 71,2020-12-18,18:00:00,14,8,6,FMN GV 11 Ramsel
66,Bergstraat 71,2020-12-18,19:00:00,20,12,8,FMN GV 11 Ramsel
66,Bergstraat 71,2020-12-18,20:00:00,4,0,4,FMN GV 11 Ramsel
66,Bergstraat 71,2020-12-18,21:00:00,14,10,4,FMN GV 11 Ramsel
66,Bergstraat 71,2020-12-18,22:00:00,2,2,0,FMN GV 11 Ramsel
66,Bergstraat 71,2020-12-18,23:00:00,10,4,6,FMN GV 11 Ramsel
66,Bergstraat 71,2020-12-19,00:00:00,4,2,2,FMN GV 11 Ramsel
66,Bergstraat 71,2020-12-19,01:00:00,0,0,0,FMN GV 11 Ramsel
66,Bergstraat 71,2020-12-19,02:00:00,0,0,0,FMN GV 11 Ramsel
66,Bergstraat 71,2020-12-19,03:00:00,0,0,0,FMN GV 11 Ramsel
66,Bergstraat 71,2020-12-19,04:00:00,0,0,0,FMN GV 11 Ramsel
66,Bergstraat 71,2020-12-19,05:00:00,0,0,0,FMN GV 11 Ramsel
66,Bergstraat 71,2020-12-19,06:00:00,2,0,2,FMN GV 11 Ramsel
66,Bergstraat 71,2020-12-19,07:00:00,4,4,0,FMN GV 11 Ramsel
66,Bergstraat 71,2020-12-19,08:00:00,24,10,14,FMN GV 11 Ramsel
66,Bergstraat 71,2020-12-19,09:00:00,30,14,16,FMN GV 11 Ramsel
66,Bergstraat 71,2020-12-19,10:00:00,86,38,48,FMN GV 11 Ramsel
66,Bergstraat 71,2020-12-19,11:00:00,104,46,58,FMN GV 11 Ramsel
66,Bergstraat 71,2020-12-19,12:00:00,94,40,54,FMN GV 11 Ramsel
66,Bergstraat 71,2020-12-19,13:00:00,72,54,18,FMN GV 11 Ramsel
66,Bergstraat 71,2020-12-19,14:00:00,42,28,14,FMN GV 11 Ramsel
66,Bergstraat 71,2020-12-19,15:00:00,64,42,22,FMN GV 11 Ramsel
66,Bergstraat 71,2020-12-19,16:00:00,44,18,26,FMN GV 11 Ramsel
66,Bergstraat 71,2020-12-19,17:00:00,16,8,8,FMN GV 11 Ramsel
66,Bergstraat 71,2020-12-19,18:00:00,12,10,2,FMN GV 11 Ramsel
66,Bergstraat 71,2020-12-19,19:00:00,6,2,4,FMN GV 11 Ramsel
66,Bergstraat 71,2020-12-19,20:00:00,2,0,2,FMN GV 11 Ramsel
66,Bergstraat 71,2020-12-19,21:00:00,8,4,4,FMN GV 11 Ramsel
66,Bergstraat 71,2020-12-19,22:00:00,4,4,0,FMN GV 11 Ramsel
66,Bergstraat 71,2020-12-19,23:00:00,2,2,0,FMN GV 11 Ramsel
66,Bergstraat 71,2020-12-20,00:00:00,2,2,0,FMN GV 11 Ramsel
66,Bergstraat 71,2020-12-20,01:00:00,0,0,0,FMN GV 11 Ramsel
66,Bergstraat 71,2020-12-20,02:00:00,0,0,0,FMN GV 11 Ramsel
66,Bergstraat 71,2020-12-20,03:00:00,0,0,0,FMN GV 11 Ramsel
66,Bergstraat 71,2020-12-20,04:00:00,0,0,0,FMN GV 11 Ramsel
66,Bergstraat 71,2020-12-20,05:00:00,0,0,0,FMN GV 11 Ramsel
66,Bergstraat 71,2020-12-20,06:00:00,0,0,0,FMN GV 11 Ramsel
66,Bergstraat 71,2020-12-20,07:00:00,10,0,10,FMN GV 11 Ramsel
66,Bergstraat 71,2020-12-20,08:00:00,56,26,30,FMN GV 11 Ramsel
66,Bergstraat 71,2020-12-20,09:00:00,168,28,140,FMN GV 11 Ramsel
66,Bergstraat 71,2020-12-20,10:00:00,170,66,104,FMN GV 11 Ramsel
66,Bergstraat 71,2020-12-20,11:00:00,234,130,104,FMN GV 11 Ramsel
66,Bergstraat 71,2020-12-20,12:00:00,162,96,66,FMN GV 11 Ramsel
66,Bergstraat 71,2020-12-20,13:00:00,230,100,130,FMN GV 11 Ramsel
66,Bergstraat 71,2020-12-20,14:00:00,160,88,72,FMN GV 11 Ramsel
66,Bergstraat 71,2020-12-20,15:00:00,144,78,66,FMN GV 11 Ramsel
66,Bergstraat 71,2020-12-20,16:00:00,68,42,26,FMN GV 11 Ramsel
66,Bergstraat 71,2020-12-20,17:00:00,28,18,10,FMN GV 11 Ramsel
66,Bergstraat 71,2020-12-20,18:00:00,8,4,4,FMN GV 11 Ramsel
66,Bergstraat 71,2020-12-20,19:00:00,6,2,4,FMN GV 11 Ramsel
66,Bergstraat 71,2020-12-20,20:00:00,0,0,0,FMN GV 11 Ramsel
66,Bergstraat 71,2020-12-20,21:00:00,2,2,0,FMN GV 11 Ramsel
66,Bergstraat 71,2020-12-20,22:00:00,2,2,0,FMN GV 11 Ramsel
66,Bergstraat 71,2020-12-20,23:00:00,0,0,0,FMN GV 11 Ramsel
66,Bergstraat 71,2020-12-21,00:00:00,0,0,0,FMN GV 11 Ramsel
66,Bergstraat 71,2020-12-21,01:00:00,0,0,0,FMN GV 11 Ramsel
66,Bergstraat 71,2020-12-21,02:00:00,0,0,0,FMN GV 11 Ramsel
66,Bergstraat 71,2020-12-21,03:00:00,0,0,0,FMN GV 11 Ramsel
66,Bergstraat 71,2020-12-21,04:00:00,0,0,0,FMN GV 11 Ramsel
66,Bergstraat 71,2020-12-21,05:00:00,8,6,2,FMN GV 11 Ramsel
66,Bergstraat 71,2020-12-21,06:00:00,14,8,6,FMN GV 11 Ramsel
66,Bergstraat 71,2020-12-21,07:00:00,4,0,4,FMN GV 11 Ramsel
66,Bergstraat 71,2020-12-21,08:00:00,10,2,8,FMN GV 11 Ramsel
66,Bergstraat 71,2020-12-21,09:00:00,12,6,6,FMN GV 11 Ramsel
66,Bergstraat 71,2020-12-21,10:00:00,20,12,8,FMN GV 11 Ramsel
66,Bergstraat 71,2020-12-21,11:00:00,26,10,16,FMN GV 11 Ramsel
66,Bergstraat 71,2020-12-21,12:00:00,8,6,2,FMN GV 11 Ramsel
66,Bergstraat 71,2020-12-21,13:00:00,10,4,6,FMN GV 11 Ramsel
66,Bergstraat 71,2020-12-21,14:00:00,18,8,10,FMN GV 11 Ramsel
66,Bergstraat 71,2020-12-21,15:00:00,12,6,6,FMN GV 11 Ramsel
66,Bergstraat 71,2020-12-21,16:00:00,16,8,8,FMN GV 11 Ramsel
66,Bergstraat 71,2020-12-21,17:00:00,10,4,6,FMN GV 11 Ramsel
66,Bergstraat 71,2020-12-21,18:00:00,4,4,0,FMN GV 11 Ramsel
66,Bergstraat 71,2020-12-21,19:00:00,2,0,2,FMN GV 11 Ramsel
66,Bergstraat 71,2020-12-21,20:00:00,6,2,4,FMN GV 11 Ramsel
66,Bergstraat 71,2020-12-21,21:00:00,8,6,2,FMN GV 11 Ramsel
66,Bergstraat 71,2020-12-21,22:00:00,0,0,0,FMN GV 11 Ramsel
66,Bergstraat 71,2020-12-21,23:00:00,2,2,0,FMN GV 11 Ramsel
66,Bergstraat 71,2020-12-22,00:00:00,0,0,0,FMN GV 11 Ramsel
66,Bergstraat 71,2020-12-22,01:00:00,0,0,0,FMN GV 11 Ramsel
66,Bergstraat 71,2020-12-22,02:00:00,0,0,0,FMN GV 11 Ramsel
66,Bergstraat 71,2020-12-22,03:00:00,0,0,0,FMN GV 11 Ramsel
66,Bergstraat 71,2020-12-22,04:00:00,0,0,0,FMN GV 11 Ramsel
66,Bergstraat 71,2020-12-22,05:00:00,6,4,2,FMN GV 11 Ramsel
66,Bergstraat 71,2020-12-22,06:00:00,24,6,18,FMN GV 11 Ramsel
66,Bergstraat 71,2020-12-22,07:00:00,10,0,10,FMN GV 11 Ramsel
66,Bergstraat 71,2020-12-22,08:00:00,12,6,6,FMN GV 11 Ramsel
66,Bergstraat 71,2020-12-22,09:00:00,14,6,8,FMN GV 11 Ramsel
66,Bergstraat 71,2020-12-22,10:00:00,26,16,10,FMN GV 11 Ramsel
66,Bergstraat 71,2020-12-22,11:00:00,14,8,6,FMN GV 11 Ramsel
66,Bergstraat 71,2020-12-22,12:00:00,20,10,10,FMN GV 11 Ramsel
66,Bergstraat 71,2020-12-22,13:00:00,90,48,42,FMN GV 11 Ramsel
66,Bergstraat 71,2020-12-22,14:00:00,88,52,36,FMN GV 11 Ramsel
66,Bergstraat 71,2020-12-22,15:00:00,70,36,34,FMN GV 11 Ramsel
66,Bergstraat 71,2020-12-22,16:00:00,50,34,16,FMN GV 11 Ramsel
66,Bergstraat 71,2020-12-22,17:00:00,26,16,10,FMN GV 11 Ramsel
66,Bergstraat 71,2020-12-22,18:00:00,24,10,14,FMN GV 11 Ramsel
66,Bergstraat 71,2020-12-22,19:00:00,14,4,10,FMN GV 11 Ramsel
66,Bergstraat 71,2020-12-22,20:00:00,4,2,2,FMN GV 11 Ramsel
66,Bergstraat 71,2020-12-22,21:00:00,0,0,0,FMN GV 11 Ramsel
66,Bergstraat 71,2020-12-22,22:00:00,6,4,2,FMN GV 11 Ramsel
66,Bergstraat 71,2020-12-22,23:00:00,6,6,0,FMN GV 11 Ramsel
66,Bergstraat 71,2020-12-23,00:00:00,0,0,0,FMN GV 11 Ramsel
66,Bergstraat 71,2020-12-23,01:00:00,2,2,0,FMN GV 11 Ramsel
66,Bergstraat 71,2020-12-23,02:00:00,0,0,0,FMN GV 11 Ramsel
66,Bergstraat 71,2020-12-23,03:00:00,0,0,0,FMN GV 11 Ramsel
66,Bergstraat 71,2020-12-23,04:00:00,2,2,0,FMN GV 11 Ramsel
66,Bergstraat 71,2020-12-23,05:00:00,6,4,2,FMN GV 11 Ramsel
66,Bergstraat 71,2020-12-23,06:00:00,10,4,6,FMN GV 11 Ramsel
66,Bergstraat 71,2020-12-23,07:00:00,18,6,12,FMN GV 11 Ramsel
66,Bergstraat 71,2020-12-23,08:00:00,18,8,10,FMN GV 11 Ramsel
66,Bergstraat 71,2020-12-23,09:00:00,20,10,10,FMN GV 11 Ramsel
66,Bergstraat 71,2020-12-23,10:00:00,20,14,6,FMN GV 11 Ramsel
66,Bergstraat 71,2020-12-23,11:00:00,12,10,2,FMN GV 11 Ramsel
66,Bergstraat 71,2020-12-23,12:00:00,16,6,10,FMN GV 11 Ramsel
66,Bergstraat 71,2020-12-23,13:00:00,24,8,16,FMN GV 11 Ramsel
66,Bergstraat 71,2020-12-23,14:00:00,28,8,20,FMN GV 11 Ramsel
66,Bergstraat 71,2020-12-23,15:00:00,20,18,2,FMN GV 11 Ramsel
66,Bergstraat 71,2020-12-23,16:00:00,32,18,14,FMN GV 11 Ramsel
66,Bergstraat 71,2020-12-23,17:00:00,20,16,4,FMN GV 11 Ramsel
66,Bergstraat 71,2020-12-23,18:00:00,28,18,10,FMN GV 11 Ramsel
66,Bergstraat 71,2020-12-23,19:00:00,20,14,6,FMN GV 11 Ramsel
66,Bergstraat 71,2020-12-23,20:00:00,12,6,6,FMN GV 11 Ramsel
66,Bergstraat 71,2020-12-23,21:00:00,12,10,2,FMN GV 11 Ramsel
66,Bergstraat 71,2020-12-23,22:00:00,6,6,0,FMN GV 11 Ramsel
66,Bergstraat 71,2020-12-23,23:00:00,10,4,6,FMN GV 11 Ramsel
66,Bergstraat 71,2020-12-24,00:00:00,0,0,0,FMN GV 11 Ramsel
66,Bergstraat 71,2020-12-24,01:00:00,0,0,0,FMN GV 11 Ramsel
66,Bergstraat 71,2020-12-24,02:00:00,0,0,0,FMN GV 11 Ramsel
66,Bergstraat 71,2020-12-24,03:00:00,0,0,0,FMN GV 11 Ramsel
66,Bergstraat 71,2020-12-24,04:00:00,0,0,0,FMN GV 11 Ramsel
66,Bergstraat 71,2020-12-24,05:00:00,2,2,0,FMN GV 11 Ramsel
66,Bergstraat 71,2020-12-24,06:00:00,12,2,10,FMN GV 11 Ramsel
66,Bergstraat 71,2020-12-24,07:00:00,4,0,4,FMN GV 11 Ramsel
66,Bergstraat 71,2020-12-24,08:00:00,16,6,10,FMN GV 11 Ramsel
66,Bergstraat 71,2020-12-24,09:00:00,12,8,4,FMN GV 11 Ramsel
66,Bergstraat 71,2020-12-24,10:00:00,24,6,18,FMN GV 11 Ramsel
66,Bergstraat 71,2020-12-24,11:00:00,22,12,10,FMN GV 11 Ramsel
66,Bergstraat 71,2020-12-24,12:00:00,18,6,12,FMN GV 11 Ramsel
66,Bergstraat 71,2020-12-24,13:00:00,20,16,4,FMN GV 11 Ramsel
66,Bergstraat 71,2020-12-24,14:00:00,60,20,40,FMN GV 11 Ramsel
66,Bergstraat 71,2020-12-24,15:00:00,64,44,20,FMN GV 11 Ramsel
66,Bergstraat 71,2020-12-24,16:00:00,34,20,14,FMN GV 11 Ramsel
66,Bergstraat 71,2020-12-24,17:00:00,16,8,8,FMN GV 11 Ramsel
66,Bergstraat 71,2020-12-24,18:00:00,10,4,6,FMN GV 11 Ramsel
66,Bergstraat 71,2020-12-24,19:00:00,2,2,0,FMN GV 11 Ramsel
66,Bergstraat 71,2020-12-24,20:00:00,4,2,2,FMN GV 11 Ramsel
66,Bergstraat 71,2020-12-24,21:00:00,6,4,2,FMN GV 11 Ramsel
66,Bergstraat 71,2020-12-24,22:00:00,10,4,6,FMN GV 11 Ramsel
66,Bergstraat 71,2020-12-24,23:00:00,0,0,0,FMN GV 11 Ramsel
66,Bergstraat 71,2020-12-25,00:00:00,0,0,0,FMN GV 11 Ramsel
66,Bergstraat 71,2020-12-25,01:00:00,0,0,0,FMN GV 11 Ramsel
66,Bergstraat 71,2020-12-25,02:00:00,0,0,0,FMN GV 11 Ramsel
66,Bergstraat 71,2020-12-25,03:00:00,2,2,0,FMN GV 11 Ramsel
66,Bergstraat 71,2020-12-25,04:00:00,0,0,0,FMN GV 11 Ramsel
66,Bergstraat 71,2020-12-25,05:00:00,0,0,0,FMN GV 11 Ramsel
66,Bergstraat 71,2020-12-25,06:00:00,0,0,0,FMN GV 11 Ramsel
66,Bergstraat 71,2020-12-25,07:00:00,2,0,2,FMN GV 11 Ramsel
66,Bergstraat 71,2020-12-25,08:00:00,2,0,2,FMN GV 11 Ramsel
66,Bergstraat 71,2020-12-25,09:00:00,18,6,12,FMN GV 11 Ramsel
66,Bergstraat 71,2020-12-25,10:00:00,106,52,54,FMN GV 11 Ramsel
66,Bergstraat 71,2020-12-25,11:00:00,134,64,70,FMN GV 11 Ramsel
66,Bergstraat 71,2020-12-25,12:00:00,94,42,52,FMN GV 11 Ramsel
66,Bergstraat 71,2020-12-25,13:00:00,154,60,94,FMN GV 11 Ramsel
66,Bergstraat 71,2020-12-25,14:00:00,110,54,56,FMN GV 11 Ramsel
66,Bergstraat 71,2020-12-25,15:00:00,88,58,30,FMN GV 11 Ramsel
66,Bergstraat 71,2020-12-25,16:00:00,38,26,12,FMN GV 11 Ramsel
66,Bergstraat 71,2020-12-25,17:00:00,16,10,6,FMN GV 11 Ramsel
66,Bergstraat 71,2020-12-25,18:00:00,6,4,2,FMN GV 11 Ramsel
66,Bergstraat 71,2020-12-25,19:00:00,24,14,10,FMN GV 11 Ramsel
66,Bergstraat 71,2020-12-25,20:00:00,16,4,12,FMN GV 11 Ramsel
66,Bergstraat 71,2020-12-25,21:00:00,4,2,2,FMN GV 11 Ramsel
66,Bergstraat 71,2020-12-25,22:00:00,10,10,0,FMN GV 11 Ramsel
66,Bergstraat 71,2020-12-25,23:00:00,0,0,0,FMN GV 11 Ramsel
66,Bergstraat 71,2020-12-26,00:00:00,6,4,2,FMN GV 11 Ramsel
66,Bergstraat 71,2020-12-26,01:00:00,0,0,0,FMN GV 11 Ramsel
66,Bergstraat 71,2020-12-26,02:00:00,2,0,2,FMN GV 11 Ramsel
66,Bergstraat 71,2020-12-26,03:00:00,0,0,0,FMN GV 11 Ramsel
66,Bergstraat 71,2020-12-26,04:00:00,0,0,0,FMN GV 11 Ramsel
66,Bergstraat 71,2020-12-26,05:00:00,0,0,0,FMN GV 11 Ramsel
66,Bergstraat 71,2020-12-26,06:00:00,4,2,2,FMN GV 11 Ramsel
66,Bergstraat 71,2020-12-26,07:00:00,4,0,4,FMN GV 11 Ramsel
66,Bergstraat 71,2020-12-26,08:00:00,12,2,10,FMN GV 11 Ramsel
66,Bergstraat 71,2020-12-26,09:00:00,64,16,48,FMN GV 11 Ramsel
66,Bergstraat 71,2020-12-26,10:00:00,150,62,88,FMN GV 11 Ramsel
66,Bergstraat 71,2020-12-26,11:00:00,188,100,88,FMN GV 11 Ramsel
66,Bergstraat 71,2020-12-26,12:00:00,122,76,46,FMN GV 11 Ramsel
66,Bergstraat 71,2020-12-26,13:00:00,112,50,62,FMN GV 11 Ramsel
66,Bergstraat 71,2020-12-26,14:00:00,90,52,38,FMN GV 11 Ramsel
66,Bergstraat 71,2020-12-26,15:00:00,64,38,26,FMN GV 11 Ramsel
66,Bergstraat 71,2020-12-26,16:00:00,38,22,16,FMN GV 11 Ramsel
66,Bergstraat 71,2020-12-26,17:00:00,8,6,2,FMN GV 11 Ramsel
66,Bergstraat 71,2020-12-26,18:00:00,10,6,4,FMN GV 11 Ramsel
66,Bergstraat 71,2020-12-26,19:00:00,6,2,4,FMN GV 11 Ramsel
66,Bergstraat 71,2020-12-26,20:00:00,4,2,2,FMN GV 11 Ramsel
66,Bergstraat 71,2020-12-26,21:00:00,2,0,2,FMN GV 11 Ramsel
66,Bergstraat 71,2020-12-26,22:00:00,0,0,0,FMN GV 11 Ramsel
66,Bergstraat 71,2020-12-26,23:00:00,6,4,2,FMN GV 11 Ramsel
66,Bergstraat 71,2020-12-27,00:00:00,2,2,0,FMN GV 11 Ramsel
66,Bergstraat 71,2020-12-27,01:00:00,0,0,0,FMN GV 11 Ramsel
66,Bergstraat 71,2020-12-27,02:00:00,0,0,0,FMN GV 11 Ramsel
66,Bergstraat 71,2020-12-27,03:00:00,0,0,0,FMN GV 11 Ramsel
66,Bergstraat 71,2020-12-27,04:00:00,0,0,0,FMN GV 11 Ramsel
66,Bergstraat 71,2020-12-27,05:00:00,0,0,0,FMN GV 11 Ramsel
66,Bergstraat 71,2020-12-27,06:00:00,0,0,0,FMN GV 11 Ramsel
66,Bergstraat 71,2020-12-27,07:00:00,2,0,2,FMN GV 11 Ramsel
66,Bergstraat 71,2020-12-27,08:00:00,2,2,0,FMN GV 11 Ramsel
66,Bergstraat 71,2020-12-27,09:00:00,2,0,2,FMN GV 11 Ramsel
66,Bergstraat 71,2020-12-27,10:00:00,4,4,0,FMN GV 11 Ramsel
66,Bergstraat 71,2020-12-27,11:00:00,8,0,8,FMN GV 11 Ramsel
66,Bergstraat 71,2020-12-27,12:00:00,0,0,0,FMN GV 11 Ramsel
66,Bergstraat 71,2020-12-27,13:00:00,0,0,0,FMN GV 11 Ramsel
66,Bergstraat 71,2020-12-27,14:00:00,4,4,0,FMN GV 11 Ramsel
66,Bergstraat 71,2020-12-27,15:00:00,8,4,4,FMN GV 11 Ramsel
66,Bergstraat 71,2020-12-27,16:00:00,6,2,4,FMN GV 11 Ramsel
66,Bergstraat 71,2020-12-27,17:00:00,8,4,4,FMN GV 11 Ramsel
66,Bergstraat 71,2020-12-27,18:00:00,6,0,6,FMN GV 11 Ramsel
66,Bergstraat 71,2020-12-27,19:00:00,4,0,4,FMN GV 11 Ramsel
66,Bergstraat 71,2020-12-27,20:00:00,4,4,0,FMN GV 11 Ramsel
66,Bergstraat 71,2020-12-27,21:00:00,2,2,0,FMN GV 11 Ramsel
66,Bergstraat 71,2020-12-27,22:00:00,2,0,2,FMN GV 11 Ramsel
66,Bergstraat 71,2020-12-27,23:00:00,2,2,0,FMN GV 11 Ramsel
66,Bergstraat 71,2020-12-28,00:00:00,0,0,0,FMN GV 11 Ramsel
66,Bergstraat 71,2020-12-28,01:00:00,0,0,0,FMN GV 11 Ramsel
66,Bergstraat 71,2020-12-28,02:00:00,0,0,0,FMN GV 11 Ramsel
66,Bergstraat 71,2020-12-28,03:00:00,0,0,0,FMN GV 11 Ramsel
66,Bergstraat 71,2020-12-28,04:00:00,0,0,0,FMN GV 11 Ramsel
66,Bergstraat 71,2020-12-28,05:00:00,2,2,0,FMN GV 11 Ramsel
66,Bergstraat 71,2020-12-28,06:00:00,4,0,4,FMN GV 11 Ramsel
66,Bergstraat 71,2020-12-28,07:00:00,2,2,0,FMN GV 11 Ramsel
66,Bergstraat 71,2020-12-28,08:00:00,14,2,12,FMN GV 11 Ramsel
66,Bergstraat 71,2020-12-28,09:00:00,18,10,8,FMN GV 11 Ramsel
66,Bergstraat 71,2020-12-28,10:00:00,28,10,18,FMN GV 11 Ramsel
66,Bergstraat 71,2020-12-28,11:00:00,52,36,16,FMN GV 11 Ramsel
66,Bergstraat 71,2020-12-28,12:00:00,52,22,30,FMN GV 11 Ramsel
66,Bergstraat 71,2020-12-28,13:00:00,42,18,24,FMN GV 11 Ramsel
66,Bergstraat 71,2020-12-28,14:00:00,96,60,36,FMN GV 11 Ramsel
66,Bergstraat 71,2020-12-28,15:00:00,62,36,26,FMN GV 11 Ramsel
66,Bergstraat 71,2020-12-28,16:00:00,44,36,8,FMN GV 11 Ramsel
66,Bergstraat 71,2020-12-28,17:00:00,30,18,12,FMN GV 11 Ramsel
66,Bergstraat 71,2020-12-28,18:00:00,10,4,6,FMN GV 11 Ramsel
66,Bergstraat 71,2020-12-28,19:00:00,4,2,2,FMN GV 11 Ramsel
66,Bergstraat 71,2020-12-28,20:00:00,8,6,2,FMN GV 11 Ramsel
66,Bergstraat 71,2020-12-28,21:00:00,8,6,2,FMN GV 11 Ramsel
66,Bergstraat 71,2020-12-28,22:00:00,2,0,2,FMN GV 11 Ramsel
66,Bergstraat 71,2020-12-28,23:00:00,2,0,2,FMN GV 11 Ramsel
66,Bergstraat 71,2020-12-29,00:00:00,0,0,0,FMN GV 11 Ramsel
66,Bergstraat 71,2020-12-29,01:00:00,0,0,0,FMN GV 11 Ramsel
66,Bergstraat 71,2020-12-29,02:00:00,0,0,0,FMN GV 11 Ramsel
66,Bergstraat 71,2020-12-29,03:00:00,0,0,0,FMN GV 11 Ramsel
66,Bergstraat 71,2020-12-29,04:00:00,0,0,0,FMN GV 11 Ramsel
66,Bergstraat 71,2020-12-29,05:00:00,0,0,0,FMN GV 11 Ramsel
66,Bergstraat 71,2020-12-29,06:00:00,2,0,2,FMN GV 11 Ramsel
66,Bergstraat 71,2020-12-29,07:00:00,0,0,0,FMN GV 11 Ramsel
66,Bergstraat 71,2020-12-29,08:00:00,10,2,8,FMN GV 11 Ramsel
66,Bergstraat 71,2020-12-29,09:00:00,16,8,8,FMN GV 11 Ramsel
66,Bergstraat 71,2020-12-29,10:00:00,40,18,22,FMN GV 11 Ramsel
66,Bergstraat 71,2020-12-29,11:00:00,60,34,26,FMN GV 11 Ramsel
66,Bergstraat 71,2020-12-29,12:00:00,44,16,28,FMN GV 11 Ramsel
66,Bergstraat 71,2020-12-29,13:00:00,94,56,38,FMN GV 11 Ramsel
66,Bergstraat 71,2020-12-29,14:00:00,78,28,50,FMN GV 11 Ramsel
66,Bergstraat 71,2020-12-29,15:00:00,60,32,28,FMN GV 11 Ramsel
66,Bergstraat 71,2020-12-29,16:00:00,54,32,22,FMN GV 11 Ramsel
66,Bergstraat 71,2020-12-29,17:00:00,24,18,6,FMN GV 11 Ramsel
66,Bergstraat 71,2020-12-29,18:00:00,18,6,12,FMN GV 11 Ramsel
66,Bergstraat 71,2020-12-29,19:00:00,10,0,10,FMN GV 11 Ramsel
66,Bergstraat 71,2020-12-29,20:00:00,4,2,2,FMN GV 11 Ramsel
66,Bergstraat 71,2020-12-29,21:00:00,6,4,2,FMN GV 11 Ramsel
66,Bergstraat 71,2020-12-29,22:00:00,2,2,0,FMN GV 11 Ramsel
66,Bergstraat 71,2020-12-29,23:00:00,2,2,0,FMN GV 11 Ramsel
66,Bergstraat 71,2020-12-30,00:00:00,0,0,0,FMN GV 11 Ramsel
66,Bergstraat 71,2020-12-30,01:00:00,0,0,0,FMN GV 11 Ramsel
66,Bergstraat 71,2020-12-30,02:00:00,0,0,0,FMN GV 11 Ramsel
66,Bergstraat 71,2020-12-30,03:00:00,0,0,0,FMN GV 11 Ramsel
66,Bergstraat 71,2020-12-30,04:00:00,0,0,0,FMN GV 11 Ramsel
66,Bergstraat 71,2020-12-30,05:00:00,0,0,0,FMN GV 11 Ramsel
66,Bergstraat 71,2020-12-30,06:00:00,4,2,2,FMN GV 11 Ramsel
66,Bergstraat 71,2020-12-30,07:00:00,2,2,0,FMN GV 11 Ramsel
66,Bergstraat 71,2020-12-30,08:00:00,14,4,10,FMN GV 11 Ramsel
66,Bergstraat 71,2020-12-30,09:00:00,36,6,30,FMN GV 11 Ramsel
66,Bergstraat 71,2020-12-30,10:00:00,82,32,50,FMN GV 11 Ramsel
66,Bergstraat 71,2020-12-30,11:00:00,70,42,28,FMN GV 11 Ramsel
66,Bergstraat 71,2020-12-30,12:00:00,74,32,42,FMN GV 11 Ramsel
66,Bergstraat 71,2020-12-30,13:00:00,118,48,70,FMN GV 11 Ramsel
66,Bergstraat 71,2020-12-30,14:00:00,130,54,76,FMN GV 11 Ramsel
66,Bergstraat 71,2020-12-30,15:00:00,122,78,44,FMN GV 11 Ramsel
66,Bergstraat 71,2020-12-30,16:00:00,64,40,24,FMN GV 11 Ramsel
66,Bergstraat 71,2020-12-30,17:00:00,30,20,10,FMN GV 11 Ramsel
66,Bergstraat 71,2020-12-30,18:00:00,12,4,8,FMN GV 11 Ramsel
66,Bergstraat 71,2020-12-30,19:00:00,2,2,0,FMN GV 11 Ramsel
66,Bergstraat 71,2020-12-30,20:00:00,12,6,6,FMN GV 11 Ramsel
66,Bergstraat 71,2020-12-30,21:00:00,4,2,2,FMN GV 11 Ramsel
66,Bergstraat 71,2020-12-30,22:00:00,4,4,0,FMN GV 11 Ramsel
66,Bergstraat 71,2020-12-30,23:00:00,4,4,0,FMN GV 11 Ramsel
66,Bergstraat 71,2020-12-31,00:00:00,0,0,0,FMN GV 11 Ramsel
66,Bergstraat 71,2020-12-31,01:00:00,4,2,2,FMN GV 11 Ramsel
66,Bergstraat 71,2020-12-31,02:00:00,0,0,0,FMN GV 11 Ramsel
66,Bergstraat 71,2020-12-31,03:00:00,0,0,0,FMN GV 11 Ramsel
66,Bergstraat 71,2020-12-31,04:00:00,0,0,0,FMN GV 11 Ramsel
66,Bergstraat 71,2020-12-31,05:00:00,0,0,0,FMN GV 11 Ramsel
66,Bergstraat 71,2020-12-31,06:00:00,4,2,2,FMN GV 11 Ramsel
66,Bergstraat 71,2020-12-31,07:00:00,6,2,4,FMN GV 11 Ramsel
66,Bergstraat 71,2020-12-31,08:00:00,0,0,0,FMN GV 11 Ramsel
66,Bergstraat 71,2020-12-31,09:00:00,14,6,8,FMN GV 11 Ramsel
66,Bergstraat 71,2020-12-31,10:00:00,14,10,4,FMN GV 11 Ramsel
66,Bergstraat 71,2020-12-31,11:00:00,34,12,22,FMN GV 11 Ramsel
66,Bergstraat 71,2020-12-31,12:00:00,34,12,22,FMN GV 11 Ramsel
66,Bergstraat 71,2020-12-31,13:00:00,74,32,42,FMN GV 11 Ramsel
66,Bergstraat 71,2020-12-31,14:00:00,76,30,46,FMN GV 11 Ramsel
66,Bergstraat 71,2020-12-31,15:00:00,84,56,28,FMN GV 11 Ramsel
66,Bergstraat 71,2020-12-31,16:00:00,26,12,14,FMN GV 11 Ramsel
66,Bergstraat 71,2020-12-31,17:00:00,8,4,4,FMN GV 11 Ramsel
66,Bergstraat 71,2020-12-31,18:00:00,6,4,2,FMN GV 11 Ramsel
66,Bergstraat 71,2020-12-31,19:00:00,4,2,2,FMN GV 11 Ramsel
66,Bergstraat 71,2020-12-31,20:00:00,8,4,4,FMN GV 11 Ramsel
66,Bergstraat 71,2020-12-31,21:00:00,4,0,4,FMN GV 11 Ramsel
66,Bergstraat 71,2020-12-31,22:00:00,4,4,0,FMN GV 11 Ramsel
66,Bergstraat 71,2020-12-31,23:00:00,10,6,4,FMN GV 11 Ramsel
66,Bergstraat 71,2021-01-01,00:00:00,2,2,0,FMN GV 11 Ramsel
66,Bergstraat 71,2021-01-01,01:00:00,0,0,0,FMN GV 11 Ramsel
66,Bergstraat 71,2021-01-01,02:00:00,2,0,2,FMN GV 11 Ramsel
66,Bergstraat 71,2021-01-01,03:00:00,2,0,2,FMN GV 11 Ramsel
66,Bergstraat 71,2021-01-01,04:00:00,0,0,0,FMN GV 11 Ramsel
66,Bergstraat 71,2021-01-01,05:00:00,4,2,2,FMN GV 11 Ramsel
66,Bergstraat 71,2021-01-01,06:00:00,2,2,0,FMN GV 11 Ramsel
66,Bergstraat 71,2021-01-01,07:00:00,0,0,0,FMN GV 11 Ramsel
66,Bergstraat 71,2021-01-01,08:00:00,6,2,4,FMN GV 11 Ramsel
66,Bergstraat 71,2021-01-01,09:00:00,14,6,8,FMN GV 11 Ramsel
66,Bergstraat 71,2021-01-01,10:00:00,54,16,38,FMN GV 11 Ramsel
66,Bergstraat 71,2021-01-01,11:00:00,62,40,22,FMN GV 11 Ramsel
66,Bergstraat 71,2021-01-01,12:00:00,64,40,24,FMN GV 11 Ramsel
66,Bergstraat 71,2021-01-01,13:00:00,78,32,46,FMN GV 11 Ramsel
66,Bergstraat 71,2021-01-01,14:00:00,118,38,80,FMN GV 11 Ramsel
66,Bergstraat 71,2021-01-01,15:00:00,112,64,48,FMN GV 11 Ramsel
66,Bergstraat 71,2021-01-01,16:00:00,26,20,6,FMN GV 11 Ramsel
66,Bergstraat 71,2021-01-01,17:00:00,10,6,4,FMN GV 11 Ramsel
66,Bergstraat 71,2021-01-01,18:00:00,6,2,4,FMN GV 11 Ramsel
66,Bergstraat 71,2021-01-01,19:00:00,0,0,0,FMN GV 11 Ramsel
66,Bergstraat 71,2021-01-01,20:00:00,4,2,2,FMN GV 11 Ramsel
66,Bergstraat 71,2021-01-01,21:00:00,4,0,4,FMN GV 11 Ramsel
66,Bergstraat 71,2021-01-01,22:00:00,0,0,0,FMN GV 11 Ramsel
66,Bergstraat 71,2021-01-01,23:00:00,2,2,0,FMN GV 11 Ramsel
66,Bergstraat 71,2021-01-02,00:00:00,2,2,0,FMN GV 11 Ramsel
66,Bergstraat 71,2021-01-02,01:00:00,0,0,0,FMN GV 11 Ramsel
66,Bergstraat 71,2021-01-02,02:00:00,2,2,0,FMN GV 11 Ramsel
66,Bergstraat 71,2021-01-02,03:00:00,2,0,2,FMN GV 11 Ramsel
66,Bergstraat 71,2021-01-02,04:00:00,0,0,0,FMN GV 11 Ramsel
66,Bergstraat 71,2021-01-02,05:00:00,0,0,0,FMN GV 11 Ramsel
66,Bergstraat 71,2021-01-02,06:00:00,0,0,0,FMN GV 11 Ramsel
66,Bergstraat 71,2021-01-02,07:00:00,0,0,0,FMN GV 11 Ramsel
66,Bergstraat 71,2021-01-02,08:00:00,18,0,18,FMN GV 11 Ramsel
66,Bergstraat 71,2021-01-02,09:00:00,50,24,26,FMN GV 11 Ramsel
66,Bergstraat 71,2021-01-02,10:00:00,72,34,38,FMN GV 11 Ramsel
66,Bergstraat 71,2021-01-02,11:00:00,72,24,48,FMN GV 11 Ramsel
66,Bergstraat 71,2021-01-02,12:00:00,112,50,62,FMN GV 11 Ramsel
66,Bergstraat 71,2021-01-02,13:00:00,114,40,74,FMN GV 11 Ramsel
66,Bergstraat 71,2021-01-02,14:00:00,156,82,74,FMN GV 11 Ramsel
66,Bergstraat 71,2021-01-02,15:00:00,104,72,32,FMN GV 11 Ramsel
66,Bergstraat 71,2021-01-02,16:00:00,74,36,38,FMN GV 11 Ramsel
66,Bergstraat 71,2021-01-02,17:00:00,12,6,6,FMN GV 11 Ramsel
66,Bergstraat 71,2021-01-02,18:00:00,8,6,2,FMN GV 11 Ramsel
66,Bergstraat 71,2021-01-02,19:00:00,6,0,6,FMN GV 11 Ramsel
66,Bergstraat 71,2021-01-02,20:00:00,4,4,0,FMN GV 11 Ramsel
66,Bergstraat 71,2021-01-02,21:00:00,4,4,0,FMN GV 11 Ramsel
66,Bergstraat 71,2021-01-02,22:00:00,4,4,0,FMN GV 11 Ramsel
66,Bergstraat 71,2021-01-02,23:00:00,2,2,0,FMN GV 11 Ramsel
66,Bergstraat 71,2021-01-03,00:00:00,2,2,0,FMN GV 11 Ramsel
66,Bergstraat 71,2021-01-03,01:00:00,0,0,0,FMN GV 11 Ramsel
66,Bergstraat 71,2021-01-03,02:00:00,0,0,0,FMN GV 11 Ramsel
66,Bergstraat 71,2021-01-03,03:00:00,0,0,0,FMN GV 11 Ramsel
66,Bergstraat 71,2021-01-03,04:00:00,0,0,0,FMN GV 11 Ramsel
66,Bergstraat 71,2021-01-03,05:00:00,0,0,0,FMN GV 11 Ramsel
66,Bergstraat 71,2021-01-03,06:00:00,2,2,0,FMN GV 11 Ramsel
66,Bergstraat 71,2021-01-03,07:00:00,6,0,6,FMN GV 11 Ramsel
66,Bergstraat 71,2021-01-03,08:00:00,26,4,22,FMN GV 11 Ramsel
66,Bergstraat 71,2021-01-03,09:00:00,114,28,86,FMN GV 11 Ramsel
66,Bergstraat 71,2021-01-03,10:00:00,98,40,58,FMN GV 11 Ramsel
66,Bergstraat 71,2021-01-03,11:00:00,154,80,74,FMN GV 11 Ramsel
66,Bergstraat 71,2021-01-03,12:00:00,94,62,32,FMN GV 11 Ramsel
66,Bergstraat 71,2021-01-03,13:00:00,80,38,42,FMN GV 11 Ramsel
66,Bergstraat 71,2021-01-03,14:00:00,80,44,36,FMN GV 11 Ramsel
66,Bergstraat 71,2021-01-03,15:00:00,48,26,22,FMN GV 11 Ramsel
66,Bergstraat 71,2021-01-03,16:00:00,36,18,18,FMN GV 11 Ramsel
66,Bergstraat 71,2021-01-03,17:00:00,26,16,10,FMN GV 11 Ramsel
66,Bergstraat 71,2021-01-03,18:00:00,16,8,8,FMN GV 11 Ramsel
66,Bergstraat 71,2021-01-03,19:00:00,4,4,0,FMN GV 11 Ramsel
66,Bergstraat 71,2021-01-03,20:00:00,6,6,0,FMN GV 11 Ramsel
66,Bergstraat 71,2021-01-03,21:00:00,0,0,0,FMN GV 11 Ramsel
66,Bergstraat 71,2021-01-03,22:00:00,4,2,2,FMN GV 11 Ramsel
66,Bergstraat 71,2021-01-03,23:00:00,0,0,0,FMN GV 11 Ramsel
66,Bergstraat 71,2021-01-04,00:00:00,0,0,0,FMN GV 11 Ramsel
66,Bergstraat 71,2021-01-04,01:00:00,0,0,0,FMN GV 11 Ramsel
66,Bergstraat 71,2021-01-04,02:00:00,0,0,0,FMN GV 11 Ramsel
66,Bergstraat 71,2021-01-04,03:00:00,0,0,0,FMN GV 11 Ramsel
66,Bergstraat 71,2021-01-04,04:00:00,0,0,0,FMN GV 11 Ramsel
66,Bergstraat 71,2021-01-04,05:00:00,8,4,4,FMN GV 11 Ramsel
66,Bergstraat 71,2021-01-04,06:00:00,30,12,18,FMN GV 11 Ramsel
66,Bergstraat 71,2021-01-04,07:00:00,130,6,124,FMN GV 11 Ramsel
66,Bergstraat 71,2021-01-04,08:00:00,78,18,60,FMN GV 11 Ramsel
66,Bergstraat 71,2021-01-04,09:00:00,16,10,6,FMN GV 11 Ramsel
66,Bergstraat 71,2021-01-04,10:00:00,28,14,14,FMN GV 11 Ramsel
66,Bergstraat 71,2021-01-04,11:00:00,22,6,16,FMN GV 11 Ramsel
66,Bergstraat 71,2021-01-04,12:00:00,24,12,12,FMN GV 11 Ramsel
66,Bergstraat 71,2021-01-04,13:00:00,26,18,8,FMN GV 11 Ramsel
66,Bergstraat 71,2021-01-04,14:00:00,18,6,12,FMN GV 11 Ramsel
66,Bergstraat 71,2021-01-04,15:00:00,128,110,18,FMN GV 11 Ramsel
66,Bergstraat 71,2021-01-04,16:00:00,94,88,6,FMN GV 11 Ramsel
66,Bergstraat 71,2021-01-04,17:00:00,36,28,8,FMN GV 11 Ramsel
66,Bergstraat 71,2021-01-04,18:00:00,8,6,2,FMN GV 11 Ramsel
66,Bergstraat 71,2021-01-04,19:00:00,8,2,6,FMN GV 11 Ramsel
66,Bergstraat 71,2021-01-04,20:00:00,8,8,0,FMN GV 11 Ramsel
66,Bergstraat 71,2021-01-04,21:00:00,4,2,2,FMN GV 11 Ramsel
66,Bergstraat 71,2021-01-04,22:00:00,4,2,2,FMN GV 11 Ramsel
66,Bergstraat 71,2021-01-04,23:00:00,2,2,0,FMN GV 11 Ramsel
66,Bergstraat 71,2021-01-05,00:00:00,0,0,0,FMN GV 11 Ramsel
66,Bergstraat 71,2021-01-05,01:00:00,0,0,0,FMN GV 11 Ramsel
66,Bergstraat 71,2021-01-05,02:00:00,0,0,0,FMN GV 11 Ramsel
66,Bergstraat 71,2021-01-05,03:00:00,0,0,0,FMN GV 11 Ramsel
66,Bergstraat 71,2021-01-05,04:00:00,2,2,0,FMN GV 11 Ramsel
66,Bergstraat 71,2021-01-05,05:00:00,10,6,4,FMN GV 11 Ramsel
66,Bergstraat 71,2021-01-05,06:00:00,24,10,14,FMN GV 11 Ramsel
66,Bergstraat 71,2021-01-05,07:00:00,90,4,86,FMN GV 11 Ramsel
66,Bergstraat 71,2021-01-05,08:00:00,114,12,102,FMN GV 11 Ramsel
66,Bergstraat 71,2021-01-05,09:00:00,20,8,12,FMN GV 11 Ramsel
66,Bergstraat 71,2021-01-05,10:00:00,20,6,14,FMN GV 11 Ramsel
66,Bergstraat 71,2021-01-05,11:00:00,36,24,12,FMN GV 11 Ramsel
66,Bergstraat 71,2021-01-05,12:00:00,38,16,22,FMN GV 11 Ramsel
66,Bergstraat 71,2021-01-05,13:00:00,86,44,42,FMN GV 11 Ramsel
66,Bergstraat 71,2021-01-05,14:00:00,106,54,52,FMN GV 11 Ramsel
66,Bergstraat 71,2021-01-05,15:00:00,158,122,36,FMN GV 11 Ramsel
66,Bergstraat 71,2021-01-05,16:00:00,98,78,20,FMN GV 11 Ramsel
66,Bergstraat 71,2021-01-05,17:00:00,50,40,10,FMN GV 11 Ramsel
66,Bergstraat 71,2021-01-05,18:00:00,14,4,10,FMN GV 11 Ramsel
66,Bergstraat 71,2021-01-05,19:00:00,20,6,14,FMN GV 11 Ramsel
66,Bergstraat 71,2021-01-05,20:00:00,16,16,0,FMN GV 11 Ramsel
66,Bergstraat 71,2021-01-05,21:00:00,6,6,0,FMN GV 11 Ramsel
66,Bergstraat 71,2021-01-05,22:00:00,6,4,2,FMN GV 11 Ramsel
66,Bergstraat 71,2021-01-05,23:00:00,0,0,0,FMN GV 11 Ramsel
66,Bergstraat 71,2021-01-06,00:00:00,4,2,2,FMN GV 11 Ramsel
66,Bergstraat 71,2021-01-06,01:00:00,0,0,0,FMN GV 11 Ramsel
66,Bergstraat 71,2021-01-06,02:00:00,0,0,0,FMN GV 11 Ramsel
66,Bergstraat 71,2021-01-06,03:00:00,0,0,0,FMN GV 11 Ramsel
66,Bergstraat 71,2021-01-06,04:00:00,2,2,0,FMN GV 11 Ramsel
66,Bergstraat 71,2021-01-06,05:00:00,10,6,4,FMN GV 11 Ramsel
66,Bergstraat 71,2021-01-06,06:00:00,20,10,10,FMN GV 11 Ramsel
66,Bergstraat 71,2021-01-06,07:00:00,120,10,110,FMN GV 11 Ramsel
66,Bergstraat 71,2021-01-06,08:00:00,100,6,94,FMN GV 11 Ramsel
66,Bergstraat 71,2021-01-06,09:00:00,22,12,10,FMN GV 11 Ramsel
66,Bergstraat 71,2021-01-06,10:00:00,36,22,14,FMN GV 11 Ramsel
66,Bergstraat 71,2021-01-06,11:00:00,28,20,8,FMN GV 11 Ramsel
66,Bergstraat 71,2021-01-06,12:00:00,158,134,24,FMN GV 11 Ramsel
66,Bergstraat 71,2021-01-06,13:00:00,52,22,30,FMN GV 11 Ramsel
66,Bergstraat 71,2021-01-06,14:00:00,114,64,50,FMN GV 11 Ramsel
66,Bergstraat 71,2021-01-06,15:00:00,56,28,28,FMN GV 11 Ramsel
66,Bergstraat 71,2021-01-06,16:00:00,56,38,18,FMN GV 11 Ramsel
66,Bergstraat 71,2021-01-06,17:00:00,32,18,14,FMN GV 11 Ramsel
66,Bergstraat 71,2021-01-06,18:00:00,26,8,18,FMN GV 11 Ramsel
66,Bergstraat 71,2021-01-06,19:00:00,18,10,8,FMN GV 11 Ramsel
66,Bergstraat 71,2021-01-06,20:00:00,18,6,12,FMN GV 11 Ramsel
66,Bergstraat 71,2021-01-06,21:00:00,6,4,2,FMN GV 11 Ramsel
66,Bergstraat 71,2021-01-06,22:00:00,8,8,0,FMN GV 11 Ramsel
66,Bergstraat 71,2021-01-06,23:00:00,0,0,0,FMN GV 11 Ramsel
66,Bergstraat 71,2021-01-07,00:00:00,0,0,0,FMN GV 11 Ramsel
66,Bergstraat 71,2021-01-07,01:00:00,0,0,0,FMN GV 11 Ramsel
66,Bergstraat 71,2021-01-07,02:00:00,0,0,0,FMN GV 11 Ramsel
66,Bergstraat 71,2021-01-07,03:00:00,0,0,0,FMN GV 11 Ramsel
66,Bergstraat 71,2021-01-07,04:00:00,2,0,2,FMN GV 11 Ramsel
66,Bergstraat 71,2021-01-07,05:00:00,6,4,2,FMN GV 11 Ramsel
66,Bergstraat 71,2021-01-07,06:00:00,18,4,14,FMN GV 11 Ramsel
66,Bergstraat 71,2021-01-07,07:00:00,88,6,82,FMN GV 11 Ramsel
66,Bergstraat 71,2021-01-07,08:00:00,84,8,76,FMN GV 11 Ramsel
66,Bergstraat 71,2021-01-07,09:00:00,4,0,4,FMN GV 11 Ramsel
66,Bergstraat 71,2021-01-07,10:00:00,14,8,6,FMN GV 11 Ramsel
66,Bergstraat 71,2021-01-07,11:00:00,20,6,14,FMN GV 11 Ramsel
66,Bergstraat 71,2021-01-07,12:00:00,22,12,10,FMN GV 11 Ramsel
66,Bergstraat 71,2021-01-07,13:00:00,26,6,20,FMN GV 11 Ramsel
66,Bergstraat 71,2021-01-07,14:00:00,58,28,30,FMN GV 11 Ramsel
66,Bergstraat 71,2021-01-07,15:00:00,134,104,30,FMN GV 11 Ramsel
66,Bergstraat 71,2021-01-07,16:00:00,56,52,4,FMN GV 11 Ramsel
66,Bergstraat 71,2021-01-07,17:00:00,28,20,8,FMN GV 11 Ramsel
66,Bergstraat 71,2021-01-07,18:00:00,10,6,4,FMN GV 11 Ramsel
66,Bergstraat 71,2021-01-07,19:00:00,20,16,4,FMN GV 11 Ramsel
66,Bergstraat 71,2021-01-07,20:00:00,6,2,4,FMN GV 11 Ramsel
66,Bergstraat 71,2021-01-07,21:00:00,2,2,0,FMN GV 11 Ramsel
66,Bergstraat 71,2021-01-07,22:00:00,8,8,0,FMN GV 11 Ramsel
66,Bergstraat 71,2021-01-07,23:00:00,0,0,0,FMN GV 11 Ramsel
66,Bergstraat 71,2021-01-08,00:00:00,2,0,2,FMN GV 11 Ramsel
66,Bergstraat 71,2021-01-08,01:00:00,0,0,0,FMN GV 11 Ramsel
66,Bergstraat 71,2021-01-08,02:00:00,0,0,0,FMN GV 11 Ramsel
66,Bergstraat 71,2021-01-08,03:00:00,0,0,0,FMN GV 11 Ramsel
66,Bergstraat 71,2021-01-08,04:00:00,0,0,0,FMN GV 11 Ramsel
66,Bergstraat 71,2021-01-08,05:00:00,6,6,0,FMN GV 11 Ramsel
66,Bergstraat 71,2021-01-08,06:00:00,10,4,6,FMN GV 11 Ramsel
66,Bergstraat 71,2021-01-08,07:00:00,74,8,66,FMN GV 11 Ramsel
66,Bergstraat 71,2021-01-08,08:00:00,82,18,64,FMN GV 11 Ramsel
66,Bergstraat 71,2021-01-08,09:00:00,10,6,4,FMN GV 11 Ramsel
66,Bergstraat 71,2021-01-08,10:00:00,24,18,6,FMN GV 11 Ramsel
66,Bergstraat 71,2021-01-08,11:00:00,18,12,6,FMN GV 11 Ramsel
66,Bergstraat 71,2021-01-08,12:00:00,28,12,16,FMN GV 11 Ramsel
66,Bergstraat 71,2021-01-08,13:00:00,42,20,22,FMN GV 11 Ramsel
66,Bergstraat 71,2021-01-08,14:00:00,60,22,38,FMN GV 11 Ramsel
66,Bergstraat 71,2021-01-08,15:00:00,160,136,24,FMN GV 11 Ramsel
66,Bergstraat 71,2021-01-08,16:00:00,40,32,8,FMN GV 11 Ramsel
66,Bergstraat 71,2021-01-08,17:00:00,30,18,12,FMN GV 11 Ramsel
66,Bergstraat 71,2021-01-08,18:00:00,8,6,2,FMN GV 11 Ramsel
66,Bergstraat 71,2021-01-08,19:00:00,8,4,4,FMN GV 11 Ramsel
66,Bergstraat 71,2021-01-08,20:00:00,8,2,6,FMN GV 11 Ramsel
66,Bergstraat 71,2021-01-08,21:00:00,8,6,2,FMN GV 11 Ramsel
66,Bergstraat 71,2021-01-08,22:00:00,0,0,0,FMN GV 11 Ramsel
66,Bergstraat 71,2021-01-08,23:00:00,6,2,4,FMN GV 11 Ramsel
66,Bergstraat 71,2021-01-09,00:00:00,0,0,0,FMN GV 11 Ramsel
66,Bergstraat 71,2021-01-09,01:00:00,0,0,0,FMN GV 11 Ramsel
66,Bergstraat 71,2021-01-09,02:00:00,0,0,0,FMN GV 11 Ramsel
66,Bergstraat 71,2021-01-09,03:00:00,0,0,0,FMN GV 11 Ramsel
66,Bergstraat 71,2021-01-09,04:00:00,0,0,0,FMN GV 11 Ramsel
66,Bergstraat 71,2021-01-09,05:00:00,0,0,0,FMN GV 11 Ramsel
66,Bergstraat 71,2021-01-09,06:00:00,2,0,2,FMN GV 11 Ramsel
66,Bergstraat 71,2021-01-09,07:00:00,4,4,0,FMN GV 11 Ramsel
66,Bergstraat 71,2021-01-09,08:00:00,6,0,6,FMN GV 11 Ramsel
66,Bergstraat 71,2021-01-09,09:00:00,6,6,0,FMN GV 11 Ramsel
66,Bergstraat 71,2021-01-09,10:00:00,16,4,12,FMN GV 11 Ramsel
66,Bergstraat 71,2021-01-09,11:00:00,22,6,16,FMN GV 11 Ramsel
66,Bergstraat 71,2021-01-09,12:00:00,14,10,4,FMN GV 11 Ramsel
66,Bergstraat 71,2021-01-09,13:00:00,56,22,34,FMN GV 11 Ramsel
66,Bergstraat 71,2021-01-09,14:00:00,80,36,44,FMN GV 11 Ramsel
66,Bergstraat 71,2021-01-09,15:00:00,70,44,26,FMN GV 11 Ramsel
66,Bergstraat 71,2021-01-09,16:00:00,32,18,14,FMN GV 11 Ramsel
66,Bergstraat 71,2021-01-09,17:00:00,8,4,4,FMN GV 11 Ramsel
66,Bergstraat 71,2021-01-09,18:00:00,2,0,2,FMN GV 11 Ramsel
66,Bergstraat 71,2021-01-09,19:00:00,4,2,2,FMN GV 11 Ramsel
66,Bergstraat 71,2021-01-09,20:00:00,0,0,0,FMN GV 11 Ramsel
66,Bergstraat 71,2021-01-09,21:00:00,6,4,2,FMN GV 11 Ramsel
66,Bergstraat 71,2021-01-09,22:00:00,0,0,0,FMN GV 11 Ramsel
66,Bergstraat 71,2021-01-09,23:00:00,0,0,0,FMN GV 11 Ramsel
66,Bergstraat 71,2021-01-10,00:00:00,0,0,0,FMN GV 11 Ramsel
66,Bergstraat 71,2021-01-10,01:00:00,0,0,0,FMN GV 11 Ramsel
66,Bergstraat 71,2021-01-10,02:00:00,0,0,0,FMN GV 11 Ramsel
66,Bergstraat 71,2021-01-10,03:00:00,0,0,0,FMN GV 11 Ramsel
66,Bergstraat 71,2021-01-10,04:00:00,0,0,0,FMN GV 11 Ramsel
66,Bergstraat 71,2021-01-10,05:00:00,0,0,0,FMN GV 11 Ramsel
66,Bergstraat 71,2021-01-10,06:00:00,0,0,0,FMN GV 11 Ramsel
66,Bergstraat 71,2021-01-10,07:00:00,2,0,2,FMN GV 11 Ramsel
66,Bergstraat 71,2021-01-10,08:00:00,4,0,4,FMN GV 11 Ramsel
66,Bergstraat 71,2021-01-10,09:00:00,4,4,0,FMN GV 11 Ramsel
66,Bergstraat 71,2021-01-10,10:00:00,26,14,12,FMN GV 11 Ramsel
66,Bergstraat 71,2021-01-10,11:00:00,70,28,42,FMN GV 11 Ramsel
66,Bergstraat 71,2021-01-10,12:00:00,82,54,28,FMN GV 11 Ramsel
66,Bergstraat 71,2021-01-10,13:00:00,86,34,52,FMN GV 11 Ramsel
66,Bergstraat 71,2021-01-10,14:00:00,94,48,46,FMN GV 11 Ramsel
66,Bergstraat 71,2021-01-10,15:00:00,66,24,42,FMN GV 11 Ramsel
66,Bergstraat 71,2021-01-10,16:00:00,52,30,22,FMN GV 11 Ramsel
66,Bergstraat 71,2021-01-10,17:00:00,16,6,10,FMN GV 11 Ramsel
66,Bergstraat 71,2021-01-10,18:00:00,8,2,6,FMN GV 11 Ramsel
66,Bergstraat 71,2021-01-10,19:00:00,2,2,0,FMN GV 11 Ramsel
66,Bergstraat 71,2021-01-10,20:00:00,4,4,0,FMN GV 11 Ramsel
66,Bergstraat 71,2021-01-10,21:00:00,2,2,0,FMN GV 11 Ramsel
66,Bergstraat 71,2021-01-10,22:00:00,0,0,0,FMN GV 11 Ramsel
66,Bergstraat 71,2021-01-10,23:00:00,0,0,0,FMN GV 11 Ramsel
66,Bergstraat 71,2021-01-11,00:00:00,0,0,0,FMN GV 11 Ramsel
66,Bergstraat 71,2021-01-11,01:00:00,0,0,0,FMN GV 11 Ramsel
66,Bergstraat 71,2021-01-11,02:00:00,0,0,0,FMN GV 11 Ramsel
66,Bergstraat 71,2021-01-11,03:00:00,0,0,0,FMN GV 11 Ramsel
66,Bergstraat 71,2021-01-11,04:00:00,2,2,0,FMN GV 11 Ramsel
66,Bergstraat 71,2021-01-11,05:00:00,10,6,4,FMN GV 11 Ramsel
66,Bergstraat 71,2021-01-11,06:00:00,12,4,8,FMN GV 11 Ramsel
66,Bergstraat 71,2021-01-11,07:00:00,112,12,100,FMN GV 11 Ramsel
66,Bergstraat 71,2021-01-11,08:00:00,104,10,94,FMN GV 11 Ramsel
66,Bergstraat 71,2021-01-11,09:00:00,26,16,10,FMN GV 11 Ramsel
66,Bergstraat 71,2021-01-11,10:00:00,22,4,18,FMN GV 11 Ramsel
66,Bergstraat 71,2021-01-11,11:00:00,24,8,16,FMN GV 11 Ramsel
66,Bergstraat 71,2021-01-11,12:00:00,56,28,28,FMN GV 11 Ramsel
66,Bergstraat 71,2021-01-11,13:00:00,84,34,50,FMN GV 11 Ramsel
66,Bergstraat 71,2021-01-11,14:00:00,72,46,26,FMN GV 11 Ramsel
66,Bergstraat 71,2021-01-11,15:00:00,178,150,28,FMN GV 11 Ramsel
66,Bergstraat 71,2021-01-11,16:00:00,90,70,20,FMN GV 11 Ramsel
66,Bergstraat 71,2021-01-11,17:00:00,36,26,10,FMN GV 11 Ramsel
66,Bergstraat 71,2021-01-11,18:00:00,26,18,8,FMN GV 11 Ramsel
66,Bergstraat 71,2021-01-11,19:00:00,14,8,6,FMN GV 11 Ramsel
66,Bergstraat 71,2021-01-11,20:00:00,18,8,10,FMN GV 11 Ramsel
66,Bergstraat 71,2021-01-11,21:00:00,2,0,2,FMN GV 11 Ramsel
66,Bergstraat 71,2021-01-11,22:00:00,10,4,6,FMN GV 11 Ramsel
66,Bergstraat 71,2021-01-11,23:00:00,2,2,0,FMN GV 11 Ramsel
66,Bergstraat 71,2021-01-12,00:00:00,0,0,0,FMN GV 11 Ramsel
66,Bergstraat 71,2021-01-12,01:00:00,0,0,0,FMN GV 11 Ramsel
66,Bergstraat 71,2021-01-12,02:00:00,0,0,0,FMN GV 11 Ramsel
66,Bergstraat 71,2021-01-12,03:00:00,0,0,0,FMN GV 11 Ramsel
66,Bergstraat 71,2021-01-12,04:00:00,2,2,0,FMN GV 11 Ramsel
66,Bergstraat 71,2021-01-12,05:00:00,2,0,2,FMN GV 11 Ramsel
66,Bergstraat 71,2021-01-12,06:00:00,16,6,10,FMN GV 11 Ramsel
66,Bergstraat 71,2021-01-12,07:00:00,42,2,40,FMN GV 11 Ramsel
66,Bergstraat 71,2021-01-12,08:00:00,32,2,30,FMN GV 11 Ramsel
66,Bergstraat 71,2021-01-12,09:00:00,6,0,6,FMN GV 11 Ramsel
66,Bergstraat 71,2021-01-12,10:00:00,12,4,8,FMN GV 11 Ramsel
66,Bergstraat 71,2021-01-12,11:00:00,6,0,6,FMN GV 11 Ramsel
66,Bergstraat 71,2021-01-12,12:00:00,10,6,4,FMN GV 11 Ramsel
66,Bergstraat 71,2021-01-12,13:00:00,82,44,38,FMN GV 11 Ramsel
66,Bergstraat 71,2021-01-12,14:00:00,62,30,32,FMN GV 11 Ramsel
66,Bergstraat 71,2021-01-12,15:00:00,106,78,28,FMN GV 11 Ramsel
66,Bergstraat 71,2021-01-12,16:00:00,20,20,0,FMN GV 11 Ramsel
66,Bergstraat 71,2021-01-12,17:00:00,48,26,22,FMN GV 11 Ramsel
66,Bergstraat 71,2021-01-12,18:00:00,8,4,4,FMN GV 11 Ramsel
66,Bergstraat 71,2021-01-12,19:00:00,26,10,16,FMN GV 11 Ramsel
66,Bergstraat 71,2021-01-12,20:00:00,24,16,8,FMN GV 11 Ramsel
66,Bergstraat 71,2021-01-12,21:00:00,4,2,2,FMN GV 11 Ramsel
66,Bergstraat 71,2021-01-12,22:00:00,10,2,8,FMN GV 11 Ramsel
66,Bergstraat 71,2021-01-12,23:00:00,4,4,0,FMN GV 11 Ramsel
66,Bergstraat 71,2021-01-13,00:00:00,0,0,0,FMN GV 11 Ramsel
66,Bergstraat 71,2021-01-13,01:00:00,0,0,0,FMN GV 11 Ramsel
66,Bergstraat 71,2021-01-13,02:00:00,0,0,0,FMN GV 11 Ramsel
66,Bergstraat 71,2021-01-13,03:00:00,0,0,0,FMN GV 11 Ramsel
66,Bergstraat 71,2021-01-13,04:00:00,0,0,0,FMN GV 11 Ramsel
66,Bergstraat 71,2021-01-13,05:00:00,2,0,2,FMN GV 11 Ramsel
66,Bergstraat 71,2021-01-13,06:00:00,18,8,10,FMN GV 11 Ramsel
66,Bergstraat 71,2021-01-13,07:00:00,58,4,54,FMN GV 11 Ramsel
66,Bergstraat 71,2021-01-13,08:00:00,66,6,60,FMN GV 11 Ramsel
66,Bergstraat 71,2021-01-13,09:00:00,26,8,18,FMN GV 11 Ramsel
66,Bergstraat 71,2021-01-13,10:00:00,34,26,8,FMN GV 11 Ramsel
66,Bergstraat 71,2021-01-13,11:00:00,42,20,22,FMN GV 11 Ramsel
66,Bergstraat 71,2021-01-13,12:00:00,152,118,34,FMN GV 11 Ramsel
66,Bergstraat 71,2021-01-13,13:00:00,140,70,70,FMN GV 11 Ramsel
66,Bergstraat 71,2021-01-13,14:00:00,158,84,74,FMN GV 11 Ramsel
66,Bergstraat 71,2021-01-13,15:00:00,58,42,16,FMN GV 11 Ramsel
66,Bergstraat 71,2021-01-13,16:00:00,60,34,26,FMN GV 11 Ramsel
66,Bergstraat 71,2021-01-13,17:00:00,36,24,12,FMN GV 11 Ramsel
66,Bergstraat 71,2021-01-13,18:00:00,24,4,20,FMN GV 11 Ramsel
66,Bergstraat 71,2021-01-13,19:00:00,18,14,4,FMN GV 11 Ramsel
66,Bergstraat 71,2021-01-13,20:00:00,12,6,6,FMN GV 11 Ramsel
66,Bergstraat 71,2021-01-13,21:00:00,12,10,2,FMN GV 11 Ramsel
66,Bergstraat 71,2021-01-13,22:00:00,6,2,4,FMN GV 11 Ramsel
66,Bergstraat 71,2021-01-13,23:00:00,2,0,2,FMN GV 11 Ramsel
66,Bergstraat 71,2021-01-14,00:00:00,0,0,0,FMN GV 11 Ramsel
66,Bergstraat 71,2021-01-14,01:00:00,2,2,0,FMN GV 11 Ramsel
66,Bergstraat 71,2021-01-14,02:00:00,0,0,0,FMN GV 11 Ramsel
66,Bergstraat 71,2021-01-14,03:00:00,0,0,0,FMN GV 11 Ramsel
66,Bergstraat 71,2021-01-14,04:00:00,0,0,0,FMN GV 11 Ramsel
66,Bergstraat 71,2021-01-14,05:00:00,6,4,2,FMN GV 11 Ramsel
66,Bergstraat 71,2021-01-14,06:00:00,12,4,8,FMN GV 11 Ramsel
66,Bergstraat 71,2021-01-14,07:00:00,88,6,82,FMN GV 11 Ramsel
66,Bergstraat 71,2021-01-14,08:00:00,82,8,74,FMN GV 11 Ramsel
66,Bergstraat 71,2021-01-14,09:00:00,12,4,8,FMN GV 11 Ramsel
66,Bergstraat 71,2021-01-14,10:00:00,12,4,8,FMN GV 11 Ramsel
66,Bergstraat 71,2021-01-14,11:00:00,18,8,10,FMN GV 11 Ramsel
66,Bergstraat 71,2021-01-14,12:00:00,24,16,8,FMN GV 11 Ramsel
66,Bergstraat 71,2021-01-14,13:00:00,50,18,32,FMN GV 11 Ramsel
66,Bergstraat 71,2021-01-14,14:00:00,34,26,8,FMN GV 11 Ramsel
66,Bergstraat 71,2021-01-14,15:00:00,170,148,22,FMN GV 11 Ramsel
66,Bergstraat 71,2021-01-14,16:00:00,44,34,10,FMN GV 11 Ramsel
66,Bergstraat 71,2021-01-14,17:00:00,18,14,4,FMN GV 11 Ramsel
66,Bergstraat 71,2021-01-14,18:00:00,8,2,6,FMN GV 11 Ramsel
66,Bergstraat 71,2021-01-14,19:00:00,26,20,6,FMN GV 11 Ramsel
66,Bergstraat 71,2021-01-14,20:00:00,4,4,0,FMN GV 11 Ramsel
66,Bergstraat 71,2021-01-14,21:00:00,2,0,2,FMN GV 11 Ramsel
66,Bergstraat 71,2021-01-14,22:00:00,8,4,4,FMN GV 11 Ramsel
66,Bergstraat 71,2021-01-14,23:00:00,0,0,0,FMN GV 11 Ramsel
66,Bergstraat 71,2021-01-15,00:00:00,0,0,0,FMN GV 11 Ramsel
66,Bergstraat 71,2021-01-15,01:00:00,0,0,0,FMN GV 11 Ramsel
66,Bergstraat 71,2021-01-15,02:00:00,0,0,0,FMN GV 11 Ramsel
66,Bergstraat 71,2021-01-15,03:00:00,0,0,0,FMN GV 11 Ramsel
66,Bergstraat 71,2021-01-15,04:00:00,2,2,0,FMN GV 11 Ramsel
66,Bergstraat 71,2021-01-15,05:00:00,2,2,0,FMN GV 11 Ramsel
66,Bergstraat 71,2021-01-15,06:00:00,16,4,12,FMN GV 11 Ramsel
66,Bergstraat 71,2021-01-15,07:00:00,76,8,68,FMN GV 11 Ramsel
66,Bergstraat 71,2021-01-15,08:00:00,108,18,90,FMN GV 11 Ramsel
66,Bergstraat 71,2021-01-15,09:00:00,22,12,10,FMN GV 11 Ramsel
66,Bergstraat 71,2021-01-15,10:00:00,26,12,14,FMN GV 11 Ramsel
66,Bergstraat 71,2021-01-15,11:00:00,40,26,14,FMN GV 11 Ramsel
66,Bergstraat 71,2021-01-15,12:00:00,50,22,28,FMN GV 11 Ramsel
66,Bergstraat 71,2021-01-15,13:00:00,64,36,28,FMN GV 11 Ramsel
66,Bergstraat 71,2021-01-15,14:00:00,84,32,52,FMN GV 11 Ramsel
66,Bergstraat 71,2021-01-15,15:00:00,180,144,36,FMN GV 11 Ramsel
66,Bergstraat 71,2021-01-15,16:00:00,106,96,10,FMN GV 11 Ramsel
66,Bergstraat 71,2021-01-15,17:00:00,32,14,18,FMN GV 11 Ramsel
66,Bergstraat 71,2021-01-15,18:00:00,16,8,8,FMN GV 11 Ramsel
66,Bergstraat 71,2021-01-15,19:00:00,22,10,12,FMN GV 11 Ramsel
66,Bergstraat 71,2021-01-15,20:00:00,16,6,10,FMN GV 11 Ramsel
66,Bergstraat 71,2021-01-15,21:00:00,8,4,4,FMN GV 11 Ramsel
66,Bergstraat 71,2021-01-15,22:00:00,4,2,2,FMN GV 11 Ramsel
66,Bergstraat 71,2021-01-15,23:00:00,0,0,0,FMN GV 11 Ramsel
66,Bergstraat 71,2021-01-16,00:00:00,2,2,0,FMN GV 11 Ramsel
66,Bergstraat 71,2021-01-16,01:00:00,0,0,0,FMN GV 11 Ramsel
66,Bergstraat 71,2021-01-16,02:00:00,4,0,4,FMN GV 11 Ramsel
66,Bergstraat 71,2021-01-16,03:00:00,0,0,0,FMN GV 11 Ramsel
66,Bergstraat 71,2021-01-16,04:00:00,0,0,0,FMN GV 11 Ramsel
66,Bergstraat 71,2021-01-16,05:00:00,0,0,0,FMN GV 11 Ramsel
66,Bergstraat 71,2021-01-16,06:00:00,2,0,2,FMN GV 11 Ramsel
66,Bergstraat 71,2021-01-16,07:00:00,0,0,0,FMN GV 11 Ramsel
66,Bergstraat 71,2021-01-16,08:00:00,10,2,8,FMN GV 11 Ramsel
66,Bergstraat 71,2021-01-16,09:00:00,20,2,18,FMN GV 11 Ramsel
66,Bergstraat 71,2021-01-16,10:00:00,70,32,38,FMN GV 11 Ramsel
66,Bergstraat 71,2021-01-16,11:00:00,52,30,22,FMN GV 11 Ramsel
66,Bergstraat 71,2021-01-16,12:00:00,36,26,10,FMN GV 11 Ramsel
66,Bergstraat 71,2021-01-16,13:00:00,66,36,30,FMN GV 11 Ramsel
66,Bergstraat 71,2021-01-16,14:00:00,48,30,18,FMN GV 11 Ramsel
66,Bergstraat 71,2021-01-16,15:00:00,14,10,4,FMN GV 11 Ramsel
66,Bergstraat 71,2021-01-16,16:00:00,12,4,8,FMN GV 11 Ramsel
66,Bergstraat 71,2021-01-16,17:00:00,4,4,0,FMN GV 11 Ramsel
66,Bergstraat 71,2021-01-16,18:00:00,8,2,6,FMN GV 11 Ramsel
66,Bergstraat 71,2021-01-16,19:00:00,6,6,0,FMN GV 11 Ramsel
66,Bergstraat 71,2021-01-16,20:00:00,2,0,2,FMN GV 11 Ramsel
66,Bergstraat 71,2021-01-16,21:00:00,2,0,2,FMN GV 11 Ramsel
66,Bergstraat 71,2021-01-16,22:00:00,0,0,0,FMN GV 11 Ramsel
66,Bergstraat 71,2021-01-16,23:00:00,0,0,0,FMN GV 11 Ramsel
66,Bergstraat 71,2021-01-17,00:00:00,0,0,0,FMN GV 11 Ramsel
66,Bergstraat 71,2021-01-17,01:00:00,0,0,0,FMN GV 11 Ramsel
66,Bergstraat 71,2021-01-17,02:00:00,0,0,0,FMN GV 11 Ramsel
66,Bergstraat 71,2021-01-17,03:00:00,0,0,0,FMN GV 11 Ramsel
66,Bergstraat 71,2021-01-17,04:00:00,0,0,0,FMN GV 11 Ramsel
66,Bergstraat 71,2021-01-17,05:00:00,0,0,0,FMN GV 11 Ramsel
66,Bergstraat 71,2021-01-17,06:00:00,2,2,0,FMN GV 11 Ramsel
66,Bergstraat 71,2021-01-17,07:00:00,2,0,2,FMN GV 11 Ramsel
66,Bergstraat 71,2021-01-17,08:00:00,20,4,16,FMN GV 11 Ramsel
66,Bergstraat 71,2021-01-17,09:00:00,42,16,26,FMN GV 11 Ramsel
66,Bergstraat 71,2021-01-17,10:00:00,26,14,12,FMN GV 11 Ramsel
66,Bergstraat 71,2021-01-17,11:00:00,36,20,16,FMN GV 11 Ramsel
66,Bergstraat 71,2021-01-17,12:00:00,62,40,22,FMN GV 11 Ramsel
66,Bergstraat 71,2021-01-17,13:00:00,60,18,42,FMN GV 11 Ramsel
66,Bergstraat 71,2021-01-17,14:00:00,90,60,30,FMN GV 11 Ramsel
66,Bergstraat 71,2021-01-17,15:00:00,62,38,24,FMN GV 11 Ramsel
66,Bergstraat 71,2021-01-17,16:00:00,14,6,8,FMN GV 11 Ramsel
66,Bergstraat 71,2021-01-17,17:00:00,14,10,4,FMN GV 11 Ramsel
66,Bergstraat 71,2021-01-17,18:00:00,6,2,4,FMN GV 11 Ramsel
66,Bergstraat 71,2021-01-17,19:00:00,2,0,2,FMN GV 11 Ramsel
66,Bergstraat 71,2021-01-17,20:00:00,6,4,2,FMN GV 11 Ramsel
66,Bergstraat 71,2021-01-17,21:00:00,2,2,0,FMN GV 11 Ramsel
66,Bergstraat 71,2021-01-17,22:00:00,0,0,0,FMN GV 11 Ramsel
66,Bergstraat 71,2021-01-17,23:00:00,0,0,0,FMN GV 11 Ramsel
66,Bergstraat 71,2021-01-18,00:00:00,0,0,0,FMN GV 11 Ramsel
66,Bergstraat 71,2021-01-18,01:00:00,0,0,0,FMN GV 11 Ramsel
66,Bergstraat 71,2021-01-18,02:00:00,0,0,0,FMN GV 11 Ramsel
66,Bergstraat 71,2021-01-18,03:00:00,0,0,0,FMN GV 11 Ramsel
66,Bergstraat 71,2021-01-18,04:00:00,4,2,2,FMN GV 11 Ramsel
66,Bergstraat 71,2021-01-18,05:00:00,6,2,4,FMN GV 11 Ramsel
66,Bergstraat 71,2021-01-18,06:00:00,14,4,10,FMN GV 11 Ramsel
66,Bergstraat 71,2021-01-18,07:00:00,100,6,94,FMN GV 11 Ramsel
66,Bergstraat 71,2021-01-18,08:00:00,100,8,92,FMN GV 11 Ramsel
66,Bergstraat 71,2021-01-18,09:00:00,22,4,18,FMN GV 11 Ramsel
66,Bergstraat 71,2021-01-18,10:00:00,46,16,30,FMN GV 11 Ramsel
66,Bergstraat 71,2021-01-18,11:00:00,66,28,38,FMN GV 11 Ramsel
66,Bergstraat 71,2021-01-18,12:00:00,84,52,32,FMN GV 11 Ramsel
66,Bergstraat 71,2021-01-18,13:00:00,144,48,96,FMN GV 11 Ramsel
66,Bergstraat 71,2021-01-18,14:00:00,146,70,76,FMN GV 11 Ramsel
66,Bergstraat 71,2021-01-18,15:00:00,196,150,46,FMN GV 11 Ramsel
66,Bergstraat 71,2021-01-18,16:00:00,82,60,22,FMN GV 11 Ramsel
66,Bergstraat 71,2021-01-18,17:00:00,34,18,16,FMN GV 11 Ramsel
66,Bergstraat 71,2021-01-18,18:00:00,26,22,4,FMN GV 11 Ramsel
66,Bergstraat 71,2021-01-18,19:00:00,24,12,12,FMN GV 11 Ramsel
66,Bergstraat 71,2021-01-18,20:00:00,10,8,2,FMN GV 11 Ramsel
66,Bergstraat 71,2021-01-18,21:00:00,6,6,0,FMN GV 11 Ramsel
66,Bergstraat 71,2021-01-18,22:00:00,12,8,4,FMN GV 11 Ramsel
66,Bergstraat 71,2021-01-18,23:00:00,0,0,0,FMN GV 11 Ramsel
66,Bergstraat 71,2021-01-19,00:00:00,0,0,0,FMN GV 11 Ramsel
66,Bergstraat 71,2021-01-19,01:00:00,0,0,0,FMN GV 11 Ramsel
66,Bergstraat 71,2021-01-19,02:00:00,0,0,0,FMN GV 11 Ramsel
66,Bergstraat 71,2021-01-19,03:00:00,0,0,0,FMN GV 11 Ramsel
66,Bergstraat 71,2021-01-19,04:00:00,0,0,0,FMN GV 11 Ramsel
66,Bergstraat 71,2021-01-19,05:00:00,4,2,2,FMN GV 11 Ramsel
66,Bergstraat 71,2021-01-19,06:00:00,22,10,12,FMN GV 11 Ramsel
66,Bergstraat 71,2021-01-19,07:00:00,44,6,38,FMN GV 11 Ramsel
66,Bergstraat 71,2021-01-19,08:00:00,32,0,32,FMN GV 11 Ramsel
66,Bergstraat 71,2021-01-19,09:00:00,8,2,6,FMN GV 11 Ramsel
66,Bergstraat 71,2021-01-19,10:00:00,10,2,8,FMN GV 11 Ramsel
66,Bergstraat 71,2021-01-19,11:00:00,10,4,6,FMN GV 11 Ramsel
66,Bergstraat 71,2021-01-19,12:00:00,16,12,4,FMN GV 11 Ramsel
66,Bergstraat 71,2021-01-19,13:00:00,28,10,18,FMN GV 11 Ramsel
66,Bergstraat 71,2021-01-19,14:00:00,30,12,18,FMN GV 11 Ramsel
66,Bergstraat 71,2021-01-19,15:00:00,48,40,8,FMN GV 11 Ramsel
66,Bergstraat 71,2021-01-19,16:00:00,34,30,4,FMN GV 11 Ramsel
66,Bergstraat 71,2021-01-19,17:00:00,20,12,8,FMN GV 11 Ramsel
66,Bergstraat 71,2021-01-19,18:00:00,20,10,10,FMN GV 11 Ramsel
66,Bergstraat 71,2021-01-19,19:00:00,4,2,2,FMN GV 11 Ramsel
66,Bergstraat 71,2021-01-19,20:00:00,12,8,4,FMN GV 11 Ramsel
66,Bergstraat 71,2021-01-19,21:00:00,4,2,2,FMN GV 11 Ramsel
66,Bergstraat 71,2021-01-19,22:00:00,4,2,2,FMN GV 11 Ramsel
66,Bergstraat 71,2021-01-19,23:00:00,0,0,0,FMN GV 11 Ramsel
66,Bergstraat 71,2021-01-20,00:00:00,0,0,0,FMN GV 11 Ramsel
66,Bergstraat 71,2021-01-20,01:00:00,0,0,0,FMN GV 11 Ramsel
66,Bergstraat 71,2021-01-20,02:00:00,0,0,0,FMN GV 11 Ramsel
66,Bergstraat 71,2021-01-20,03:00:00,0,0,0,FMN GV 11 Ramsel
66,Bergstraat 71,2021-01-20,04:00:00,0,0,0,FMN GV 11 Ramsel
66,Bergstraat 71,2021-01-20,05:00:00,2,0,2,FMN GV 11 Ramsel
66,Bergstraat 71,2021-01-20,06:00:00,16,4,12,FMN GV 11 Ramsel
66,Bergstraat 71,2021-01-20,07:00:00,90,12,78,FMN GV 11 Ramsel
66,Bergstraat 71,2021-01-20,08:00:00,84,8,76,FMN GV 11 Ramsel
66,Bergstraat 71,2021-01-20,09:00:00,18,4,14,FMN GV 11 Ramsel
66,Bergstraat 71,2021-01-20,10:00:00,22,6,16,FMN GV 11 Ramsel
66,Bergstraat 71,2021-01-20,11:00:00,50,26,24,FMN GV 11 Ramsel
66,Bergstraat 71,2021-01-20,12:00:00,142,100,42,FMN GV 11 Ramsel
66,Bergstraat 71,2021-01-20,13:00:00,108,44,64,FMN GV 11 Ramsel
66,Bergstraat 71,2021-01-20,14:00:00,122,60,62,FMN GV 11 Ramsel
66,Bergstraat 71,2021-01-20,15:00:00,90,58,32,FMN GV 11 Ramsel
66,Bergstraat 71,2021-01-20,16:00:00,100,74,26,FMN GV 11 Ramsel
66,Bergstraat 71,2021-01-20,17:00:00,58,38,20,FMN GV 11 Ramsel
66,Bergstraat 71,2021-01-20,18:00:00,32,18,14,FMN GV 11 Ramsel
66,Bergstraat 71,2021-01-20,19:00:00,24,18,6,FMN GV 11 Ramsel
66,Bergstraat 71,2021-01-20,20:00:00,12,8,4,FMN GV 11 Ramsel
66,Bergstraat 71,2021-01-20,21:00:00,10,10,0,FMN GV 11 Ramsel
66,Bergstraat 71,2021-01-20,22:00:00,2,2,0,FMN GV 11 Ramsel
66,Bergstraat 71,2021-01-20,23:00:00,0,0,0,FMN GV 11 Ramsel
66,Bergstraat 71,2021-01-21,00:00:00,0,0,0,FMN GV 11 Ramsel
66,Bergstraat 71,2021-01-21,01:00:00,0,0,0,FMN GV 11 Ramsel
66,Bergstraat 71,2021-01-21,02:00:00,0,0,0,FMN GV 11 Ramsel
66,Bergstraat 71,2021-01-21,03:00:00,0,0,0,FMN GV 11 Ramsel
66,Bergstraat 71,2021-01-21,04:00:00,0,0,0,FMN GV 11 Ramsel
66,Bergstraat 71,2021-01-21,05:00:00,8,6,2,FMN GV 11 Ramsel
66,Bergstraat 71,2021-01-21,06:00:00,18,8,10,FMN GV 11 Ramsel
66,Bergstraat 71,2021-01-21,07:00:00,108,12,96,FMN GV 11 Ramsel
66,Bergstraat 71,2021-01-21,08:00:00,86,16,70,FMN GV 11 Ramsel
66,Bergstraat 71,2021-01-21,09:00:00,22,10,12,FMN GV 11 Ramsel
66,Bergstraat 71,2021-01-21,10:00:00,30,12,18,FMN GV 11 Ramsel
66,Bergstraat 71,2021-01-21,11:00:00,42,16,26,FMN GV 11 Ramsel
66,Bergstraat 71,2021-01-21,12:00:00,54,26,28,FMN GV 11 Ramsel
66,Bergstraat 71,2021-01-21,13:00:00,46,14,32,FMN GV 11 Ramsel
66,Bergstraat 71,2021-01-21,14:00:00,88,30,58,FMN GV 11 Ramsel
66,Bergstraat 71,2021-01-21,15:00:00,142,118,24,FMN GV 11 Ramsel
66,Bergstraat 71,2021-01-21,16:00:00,80,54,26,FMN GV 11 Ramsel
66,Bergstraat 71,2021-01-21,17:00:00,44,30,14,FMN GV 11 Ramsel
66,Bergstraat 71,2021-01-21,18:00:00,22,12,10,FMN GV 11 Ramsel
66,Bergstraat 71,2021-01-21,19:00:00,8,4,4,FMN GV 11 Ramsel
66,Bergstraat 71,2021-01-21,20:00:00,6,4,2,FMN GV 11 Ramsel
66,Bergstraat 71,2021-01-21,21:00:00,0,0,0,FMN GV 11 Ramsel
66,Bergstraat 71,2021-01-21,22:00:00,6,4,2,FMN GV 11 Ramsel
66,Bergstraat 71,2021-01-21,23:00:00,0,0,0,FMN GV 11 Ramsel
66,Bergstraat 71,2021-01-22,00:00:00,0,0,0,FMN GV 11 Ramsel
66,Bergstraat 71,2021-01-22,01:00:00,0,0,0,FMN GV 11 Ramsel
66,Bergstraat 71,2021-01-22,02:00:00,0,0,0,FMN GV 11 Ramsel
66,Bergstraat 71,2021-01-22,03:00:00,2,0,2,FMN GV 11 Ramsel
66,Bergstraat 71,2021-01-22,04:00:00,0,0,0,FMN GV 11 Ramsel
66,Bergstraat 71,2021-01-22,05:00:00,6,6,0,FMN GV 11 Ramsel
66,Bergstraat 71,2021-01-22,06:00:00,10,0,10,FMN GV 11 Ramsel
66,Bergstraat 71,2021-01-22,07:00:00,120,16,104,FMN GV 11 Ramsel
66,Bergstraat 71,2021-01-22,08:00:00,88,14,74,FMN GV 11 Ramsel
66,Bergstraat 71,2021-01-22,09:00:00,58,18,40,FMN GV 11 Ramsel
66,Bergstraat 71,2021-01-22,10:00:00,34,18,16,FMN GV 11 Ramsel
66,Bergstraat 71,2021-01-22,11:00:00,68,30,38,FMN GV 11 Ramsel
66,Bergstraat 71,2021-01-22,12:00:00,88,36,52,FMN GV 11 Ramsel
66,Bergstraat 71,2021-01-22,13:00:00,132,54,78,FMN GV 11 Ramsel
66,Bergstraat 71,2021-01-22,14:00:00,174,90,84,FMN GV 11 Ramsel
66,Bergstraat 71,2021-01-22,15:00:00,258,202,56,FMN GV 11 Ramsel
66,Bergstraat 71,2021-01-22,16:00:00,120,90,30,FMN GV 11 Ramsel
66,Bergstraat 71,2021-01-22,17:00:00,66,48,18,FMN GV 11 Ramsel
66,Bergstraat 71,2021-01-22,18:00:00,26,14,12,FMN GV 11 Ramsel
66,Bergstraat 71,2021-01-22,19:00:00,18,10,8,FMN GV 11 Ramsel
66,Bergstraat 71,2021-01-22,20:00:00,18,4,14,FMN GV 11 Ramsel
66,Bergstraat 71,2021-01-22,21:00:00,4,0,4,FMN GV 11 Ramsel
66,Bergstraat 71,2021-01-22,22:00:00,0,0,0,FMN GV 11 Ramsel
66,Bergstraat 71,2021-01-22,23:00:00,6,2,4,FMN GV 11 Ramsel
66,Bergstraat 71,2021-01-23,00:00:00,2,2,0,FMN GV 11 Ramsel
66,Bergstraat 71,2021-01-23,01:00:00,0,0,0,FMN GV 11 Ramsel
66,Bergstraat 71,2021-01-23,02:00:00,4,4,0,FMN GV 11 Ramsel
66,Bergstraat 71,2021-01-23,03:00:00,0,0,0,FMN GV 11 Ramsel
66,Bergstraat 71,2021-01-23,04:00:00,0,0,0,FMN GV 11 Ramsel
66,Bergstraat 71,2021-01-23,05:00:00,4,2,2,FMN GV 11 Ramsel
66,Bergstraat 71,2021-01-23,06:00:00,4,0,4,FMN GV 11 Ramsel
66,Bergstraat 71,2021-01-23,07:00:00,8,4,4,FMN GV 11 Ramsel
66,Bergstraat 71,2021-01-23,08:00:00,18,6,12,FMN GV 11 Ramsel
66,Bergstraat 71,2021-01-23,09:00:00,34,14,20,FMN GV 11 Ramsel
66,Bergstraat 71,2021-01-23,10:00:00,68,34,34,FMN GV 11 Ramsel
66,Bergstraat 71,2021-01-23,11:00:00,74,34,40,FMN GV 11 Ramsel
66,Bergstraat 71,2021-01-23,12:00:00,98,42,56,FMN GV 11 Ramsel
66,Bergstraat 71,2021-01-23,13:00:00,94,26,68,FMN GV 11 Ramsel
66,Bergstraat 71,2021-01-23,14:00:00,94,38,56,FMN GV 11 Ramsel
66,Bergstraat 71,2021-01-23,15:00:00,82,52,30,FMN GV 11 Ramsel
66,Bergstraat 71,2021-01-23,16:00:00,50,30,20,FMN GV 11 Ramsel
66,Bergstraat 71,2021-01-23,17:00:00,26,12,14,FMN GV 11 Ramsel
66,Bergstraat 71,2021-01-23,18:00:00,10,6,4,FMN GV 11 Ramsel
66,Bergstraat 71,2021-01-23,19:00:00,6,2,4,FMN GV 11 Ramsel
66,Bergstraat 71,2021-01-23,20:00:00,2,2,0,FMN GV 11 Ramsel
66,Bergstraat 71,2021-01-23,21:00:00,6,6,0,FMN GV 11 Ramsel
66,Bergstraat 71,2021-01-23,22:00:00,4,2,2,FMN GV 11 Ramsel
66,Bergstraat 71,2021-01-23,23:00:00,2,0,2,FMN GV 11 Ramsel
66,Bergstraat 71,2021-01-24,00:00:00,2,2,0,FMN GV 11 Ramsel
66,Bergstraat 71,2021-01-24,01:00:00,0,0,0,FMN GV 11 Ramsel
66,Bergstraat 71,2021-01-24,02:00:00,0,0,0,FMN GV 11 Ramsel
66,Bergstraat 71,2021-01-24,03:00:00,0,0,0,FMN GV 11 Ramsel
66,Bergstraat 71,2021-01-24,04:00:00,0,0,0,FMN GV 11 Ramsel
66,Bergstraat 71,2021-01-24,05:00:00,0,0,0,FMN GV 11 Ramsel
66,Bergstraat 71,2021-01-24,06:00:00,4,0,4,FMN GV 11 Ramsel
66,Bergstraat 71,2021-01-24,07:00:00,0,0,0,FMN GV 11 Ramsel
66,Bergstraat 71,2021-01-24,08:00:00,26,14,12,FMN GV 11 Ramsel
66,Bergstraat 71,2021-01-24,09:00:00,56,16,40,FMN GV 11 Ramsel
66,Bergstraat 71,2021-01-24,10:00:00,64,24,40,FMN GV 11 Ramsel
66,Bergstraat 71,2021-01-24,11:00:00,100,58,42,FMN GV 11 Ramsel
66,Bergstraat 71,2021-01-24,12:00:00,112,58,54,FMN GV 11 Ramsel
66,Bergstraat 71,2021-01-24,13:00:00,132,72,60,FMN GV 11 Ramsel
66,Bergstraat 71,2021-01-24,14:00:00,84,42,42,FMN GV 11 Ramsel
66,Bergstraat 71,2021-01-24,15:00:00,64,28,36,FMN GV 11 Ramsel
66,Bergstraat 71,2021-01-24,16:00:00,36,16,20,FMN GV 11 Ramsel
66,Bergstraat 71,2021-01-24,17:00:00,22,16,6,FMN GV 11 Ramsel
66,Bergstraat 71,2021-01-24,18:00:00,4,2,2,FMN GV 11 Ramsel
66,Bergstraat 71,2021-01-24,19:00:00,4,0,4,FMN GV 11 Ramsel
66,Bergstraat 71,2021-01-24,20:00:00,0,0,0,FMN GV 11 Ramsel
66,Bergstraat 71,2021-01-24,21:00:00,4,2,2,FMN GV 11 Ramsel
66,Bergstraat 71,2021-01-24,22:00:00,0,0,0,FMN GV 11 Ramsel
66,Bergstraat 71,2021-01-24,23:00:00,0,0,0,FMN GV 11 Ramsel
66,Bergstraat 71,2021-01-25,00:00:00,0,0,0,FMN GV 11 Ramsel
66,Bergstraat 71,2021-01-25,01:00:00,0,0,0,FMN GV 11 Ramsel
66,Bergstraat 71,2021-01-25,02:00:00,0,0,0,FMN GV 11 Ramsel
66,Bergstraat 71,2021-01-25,03:00:00,0,0,0,FMN GV 11 Ramsel
66,Bergstraat 71,2021-01-25,04:00:00,2,2,0,FMN GV 11 Ramsel
66,Bergstraat 71,2021-01-25,05:00:00,2,0,2,FMN GV 11 Ramsel
66,Bergstraat 71,2021-01-25,06:00:00,20,4,16,FMN GV 11 Ramsel
66,Bergstraat 71,2021-01-25,07:00:00,92,4,88,FMN GV 11 Ramsel
66,Bergstraat 71,2021-01-25,08:00:00,102,6,96,FMN GV 11 Ramsel
66,Bergstraat 71,2021-01-25,09:00:00,16,6,10,FMN GV 11 Ramsel
66,Bergstraat 71,2021-01-25,10:00:00,16,8,8,FMN GV 11 Ramsel
66,Bergstraat 71,2021-01-25,11:00:00,38,16,22,FMN GV 11 Ramsel
66,Bergstraat 71,2021-01-25,12:00:00,44,30,14,FMN GV 11 Ramsel
66,Bergstraat 71,2021-01-25,13:00:00,92,34,58,FMN GV 11 Ramsel
66,Bergstraat 71,2021-01-25,14:00:00,114,50,64,FMN GV 11 Ramsel
66,Bergstraat 71,2021-01-25,15:00:00,168,132,36,FMN GV 11 Ramsel
66,Bergstraat 71,2021-01-25,16:00:00,68,50,18,FMN GV 11 Ramsel
66,Bergstraat 71,2021-01-25,17:00:00,46,38,8,FMN GV 11 Ramsel
66,Bergstraat 71,2021-01-25,18:00:00,12,12,0,FMN GV 11 Ramsel
66,Bergstraat 71,2021-01-25,19:00:00,20,8,12,FMN GV 11 Ramsel
66,Bergstraat 71,2021-01-25,20:00:00,14,8,6,FMN GV 11 Ramsel
66,Bergstraat 71,2021-01-25,21:00:00,4,4,0,FMN GV 11 Ramsel
66,Bergstraat 71,2021-01-25,22:00:00,12,0,12,FMN GV 11 Ramsel
66,Bergstraat 71,2021-01-25,23:00:00,0,0,0,FMN GV 11 Ramsel
66,Bergstraat 71,2021-01-26,00:00:00,0,0,0,FMN GV 11 Ramsel
66,Bergstraat 71,2021-01-26,01:00:00,0,0,0,FMN GV 11 Ramsel
66,Bergstraat 71,2021-01-26,02:00:00,0,0,0,FMN GV 11 Ramsel
66,Bergstraat 71,2021-01-26,03:00:00,0,0,0,FMN GV 11 Ramsel
66,Bergstraat 71,2021-01-26,04:00:00,2,2,0,FMN GV 11 Ramsel
66,Bergstraat 71,2021-01-26,05:00:00,2,0,2,FMN GV 11 Ramsel
66,Bergstraat 71,2021-01-26,06:00:00,22,12,10,FMN GV 11 Ramsel
66,Bergstraat 71,2021-01-26,07:00:00,114,18,96,FMN GV 11 Ramsel
66,Bergstraat 71,2021-01-26,08:00:00,118,18,100,FMN GV 11 Ramsel
66,Bergstraat 71,2021-01-26,09:00:00,20,12,8,FMN GV 11 Ramsel
66,Bergstraat 71,2021-01-26,10:00:00,48,18,30,FMN GV 11 Ramsel
66,Bergstraat 71,2021-01-26,11:00:00,52,22,30,FMN GV 11 Ramsel
66,Bergstraat 71,2021-01-26,12:00:00,68,34,34,FMN GV 11 Ramsel
66,Bergstraat 71,2021-01-26,13:00:00,148,68,80,FMN GV 11 Ramsel
66,Bergstraat 71,2021-01-26,14:00:00,130,68,62,FMN GV 11 Ramsel
66,Bergstraat 71,2021-01-26,15:00:00,246,182,64,FMN GV 11 Ramsel
66,Bergstraat 71,2021-01-26,16:00:00,98,76,22,FMN GV 11 Ramsel
66,Bergstraat 71,2021-01-26,17:00:00,50,42,8,FMN GV 11 Ramsel
66,Bergstraat 71,2021-01-26,18:00:00,34,12,22,FMN GV 11 Ramsel
66,Bergstraat 71,2021-01-26,19:00:00,30,8,22,FMN GV 11 Ramsel
66,Bergstraat 71,2021-01-26,20:00:00,32,26,6,FMN GV 11 Ramsel
66,Bergstraat 71,2021-01-26,21:00:00,2,0,2,FMN GV 11 Ramsel
66,Bergstraat 71,2021-01-26,22:00:00,12,2,10,FMN GV 11 Ramsel
66,Bergstraat 71,2021-01-26,23:00:00,0,0,0,FMN GV 11 Ramsel
66,Bergstraat 71,2021-01-27,00:00:00,0,0,0,FMN GV 11 Ramsel
66,Bergstraat 71,2021-01-27,01:00:00,0,0,0,FMN GV 11 Ramsel
66,Bergstraat 71,2021-01-27,02:00:00,0,0,0,FMN GV 11 Ramsel
66,Bergstraat 71,2021-01-27,03:00:00,0,0,0,FMN GV 11 Ramsel
66,Bergstraat 71,2021-01-27,04:00:00,0,0,0,FMN GV 11 Ramsel
66,Bergstraat 71,2021-01-27,05:00:00,2,0,2,FMN GV 11 Ramsel
66,Bergstraat 71,2021-01-27,06:00:00,12,4,8,FMN GV 11 Ramsel
66,Bergstraat 71,2021-01-27,07:00:00,92,10,82,FMN GV 11 Ramsel
66,Bergstraat 71,2021-01-27,08:00:00,112,14,98,FMN GV 11 Ramsel
66,Bergstraat 71,2021-01-27,09:00:00,14,4,10,FMN GV 11 Ramsel
66,Bergstraat 71,2021-01-27,10:00:00,30,14,16,FMN GV 11 Ramsel
66,Bergstraat 71,2021-01-27,11:00:00,30,26,4,FMN GV 11 Ramsel
66,Bergstraat 71,2021-01-27,12:00:00,124,110,14,FMN GV 11 Ramsel
66,Bergstraat 71,2021-01-27,13:00:00,34,26,8,FMN GV 11 Ramsel
66,Bergstraat 71,2021-01-27,14:00:00,44,18,26,FMN GV 11 Ramsel
66,Bergstraat 71,2021-01-27,15:00:00,30,14,16,FMN GV 11 Ramsel
66,Bergstraat 71,2021-01-27,16:00:00,60,46,14,FMN GV 11 Ramsel
66,Bergstraat 71,2021-01-27,17:00:00,38,28,10,FMN GV 11 Ramsel
66,Bergstraat 71,2021-01-27,18:00:00,16,8,8,FMN GV 11 Ramsel
66,Bergstraat 71,2021-01-27,19:00:00,10,4,6,FMN GV 11 Ramsel
66,Bergstraat 71,2021-01-27,20:00:00,8,8,0,FMN GV 11 Ramsel
66,Bergstraat 71,2021-01-27,21:00:00,14,12,2,FMN GV 11 Ramsel
66,Bergstraat 71,2021-01-27,22:00:00,10,4,6,FMN GV 11 Ramsel
66,Bergstraat 71,2021-01-27,23:00:00,2,0,2,FMN GV 11 Ramsel
66,Bergstraat 71,2021-01-28,00:00:00,0,0,0,FMN GV 11 Ramsel
66,Bergstraat 71,2021-01-28,01:00:00,0,0,0,FMN GV 11 Ramsel
66,Bergstraat 71,2021-01-28,02:00:00,0,0,0,FMN GV 11 Ramsel
66,Bergstraat 71,2021-01-28,03:00:00,0,0,0,FMN GV 11 Ramsel
66,Bergstraat 71,2021-01-28,04:00:00,0,0,0,FMN GV 11 Ramsel
66,Bergstraat 71,2021-01-28,05:00:00,2,0,2,FMN GV 11 Ramsel
66,Bergstraat 71,2021-01-28,06:00:00,16,6,10,FMN GV 11 Ramsel
66,Bergstraat 71,2021-01-28,07:00:00,40,2,38,FMN GV 11 Ramsel
66,Bergstraat 71,2021-01-28,08:00:00,32,0,32,FMN GV 11 Ramsel
66,Bergstraat 71,2021-01-28,09:00:00,20,6,14,FMN GV 11 Ramsel
66,Bergstraat 71,2021-01-28,10:00:00,8,4,4,FMN GV 11 Ramsel
66,Bergstraat 71,2021-01-28,11:00:00,12,6,6,FMN GV 11 Ramsel
66,Bergstraat 71,2021-01-28,12:00:00,10,2,8,FMN GV 11 Ramsel
66,Bergstraat 71,2021-01-28,13:00:00,20,12,8,FMN GV 11 Ramsel
66,Bergstraat 71,2021-01-28,14:00:00,14,14,0,FMN GV 11 Ramsel
66,Bergstraat 71,2021-01-28,15:00:00,44,40,4,FMN GV 11 Ramsel
66,Bergstraat 71,2021-01-28,16:00:00,28,18,10,FMN GV 11 Ramsel
66,Bergstraat 71,2021-01-28,17:00:00,20,10,10,FMN GV 11 Ramsel
66,Bergstraat 71,2021-01-28,18:00:00,6,4,2,FMN GV 11 Ramsel
66,Bergstraat 71,2021-01-28,19:00:00,10,6,4,FMN GV 11 Ramsel
66,Bergstraat 71,2021-01-28,20:00:00,2,2,0,FMN GV 11 Ramsel
66,Bergstraat 71,2021-01-28,21:00:00,2,2,0,FMN GV 11 Ramsel
66,Bergstraat 71,2021-01-28,22:00:00,12,4,8,FMN GV 11 Ramsel
66,Bergstraat 71,2021-01-28,23:00:00,0,0,0,FMN GV 11 Ramsel
66,Bergstraat 71,2021-01-29,00:00:00,0,0,0,FMN GV 11 Ramsel
66,Bergstraat 71,2021-01-29,01:00:00,0,0,0,FMN GV 11 Ramsel
66,Bergstraat 71,2021-01-29,02:00:00,0,0,0,FMN GV 11 Ramsel
66,Bergstraat 71,2021-01-29,03:00:00,0,0,0,FMN GV 11 Ramsel
66,Bergstraat 71,2021-01-29,04:00:00,0,0,0,FMN GV 11 Ramsel
66,Bergstraat 71,2021-01-29,05:00:00,0,0,0,FMN GV 11 Ramsel
66,Bergstraat 71,2021-01-29,06:00:00,12,6,6,FMN GV 11 Ramsel
66,Bergstraat 71,2021-01-29,07:00:00,48,2,46,FMN GV 11 Ramsel
66,Bergstraat 71,2021-01-29,08:00:00,44,4,40,FMN GV 11 Ramsel
66,Bergstraat 71,2021-01-29,09:00:00,12,8,4,FMN GV 11 Ramsel
66,Bergstraat 71,2021-01-29,10:00:00,52,18,34,FMN GV 11 Ramsel
66,Bergstraat 71,2021-01-29,11:00:00,52,20,32,FMN GV 11 Ramsel
66,Bergstraat 71,2021-01-29,12:00:00,44,26,18,FMN GV 11 Ramsel
66,Bergstraat 71,2021-01-29,13:00:00,46,18,28,FMN GV 11 Ramsel
66,Bergstraat 71,2021-01-29,14:00:00,64,22,42,FMN GV 11 Ramsel
66,Bergstraat 71,2021-01-29,15:00:00,134,106,28,FMN GV 11 Ramsel
66,Bergstraat 71,2021-01-29,16:00:00,44,28,16,FMN GV 11 Ramsel
66,Bergstraat 71,2021-01-29,17:00:00,40,24,16,FMN GV 11 Ramsel
66,Bergstraat 71,2021-01-29,18:00:00,26,8,18,FMN GV 11 Ramsel
66,Bergstraat 71,2021-01-29,19:00:00,6,4,2,FMN GV 11 Ramsel
66,Bergstraat 71,2021-01-29,20:00:00,6,2,4,FMN GV 11 Ramsel
66,Bergstraat 71,2021-01-29,21:00:00,6,2,4,FMN GV 11 Ramsel
66,Bergstraat 71,2021-01-29,22:00:00,2,0,2,FMN GV 11 Ramsel
66,Bergstraat 71,2021-01-29,23:00:00,2,2,0,FMN GV 11 Ramsel
66,Bergstraat 71,2021-01-30,00:00:00,2,2,0,FMN GV 11 Ramsel
66,Bergstraat 71,2021-01-30,01:00:00,0,0,0,FMN GV 11 Ramsel
66,Bergstraat 71,2021-01-30,02:00:00,0,0,0,FMN GV 11 Ramsel
66,Bergstraat 71,2021-01-30,03:00:00,0,0,0,FMN GV 11 Ramsel
66,Bergstraat 71,2021-01-30,04:00:00,0,0,0,FMN GV 11 Ramsel
66,Bergstraat 71,2021-01-30,05:00:00,2,0,2,FMN GV 11 Ramsel
66,Bergstraat 71,2021-01-30,06:00:00,4,4,0,FMN GV 11 Ramsel
66,Bergstraat 71,2021-01-30,07:00:00,2,2,0,FMN GV 11 Ramsel
66,Bergstraat 71,2021-01-30,08:00:00,10,0,10,FMN GV 11 Ramsel
66,Bergstraat 71,2021-01-30,09:00:00,6,4,2,FMN GV 11 Ramsel
66,Bergstraat 71,2021-01-30,10:00:00,4,2,2,FMN GV 11 Ramsel
66,Bergstraat 71,2021-01-30,11:00:00,10,6,4,FMN GV 11 Ramsel
66,Bergstraat 71,2021-01-30,12:00:00,2,0,2,FMN GV 11 Ramsel
66,Bergstraat 71,2021-01-30,13:00:00,8,4,4,FMN GV 11 Ramsel
66,Bergstraat 71,2021-01-30,14:00:00,10,6,4,FMN GV 11 Ramsel
66,Bergstraat 71,2021-01-30,15:00:00,8,6,2,FMN GV 11 Ramsel
66,Bergstraat 71,2021-01-30,16:00:00,10,6,4,FMN GV 11 Ramsel
66,Bergstraat 71,2021-01-30,17:00:00,12,6,6,FMN GV 11 Ramsel
66,Bergstraat 71,2021-01-30,18:00:00,10,2,8,FMN GV 11 Ramsel
66,Bergstraat 71,2021-01-30,19:00:00,4,2,2,FMN GV 11 Ramsel
66,Bergstraat 71,2021-01-30,20:00:00,2,2,0,FMN GV 11 Ramsel
66,Bergstraat 71,2021-01-30,21:00:00,4,0,4,FMN GV 11 Ramsel
66,Bergstraat 71,2021-01-30,22:00:00,0,0,0,FMN GV 11 Ramsel
66,Bergstraat 71,2021-01-30,23:00:00,2,0,2,FMN GV 11 Ramsel
66,Bergstraat 71,2021-01-31,00:00:00,2,2,0,FMN GV 11 Ramsel
66,Bergstraat 71,2021-01-31,01:00:00,0,0,0,FMN GV 11 Ramsel
66,Bergstraat 71,2021-01-31,02:00:00,0,0,0,FMN GV 11 Ramsel
66,Bergstraat 71,2021-01-31,03:00:00,0,0,0,FMN GV 11 Ramsel
66,Bergstraat 71,2021-01-31,04:00:00,0,0,0,FMN GV 11 Ramsel
66,Bergstraat 71,2021-01-31,05:00:00,0,0,0,FMN GV 11 Ramsel
66,Bergstraat 71,2021-01-31,06:00:00,0,0,0,FMN GV 11 Ramsel
66,Bergstraat 71,2021-01-31,07:00:00,0,0,0,FMN GV 11 Ramsel
66,Bergstraat 71,2021-01-31,08:00:00,4,4,0,FMN GV 11 Ramsel
66,Bergstraat 71,2021-01-31,09:00:00,24,4,20,FMN GV 11 Ramsel
66,Bergstraat 71,2021-01-31,10:00:00,64,34,30,FMN GV 11 Ramsel
66,Bergstraat 71,2021-01-31,11:00:00,130,78,52,FMN GV 11 Ramsel
66,Bergstraat 71,2021-01-31,12:00:00,122,76,46,FMN GV 11 Ramsel
66,Bergstraat 71,2021-01-31,13:00:00,122,64,58,FMN GV 11 Ramsel
66,Bergstraat 71,2021-01-31,14:00:00,98,36,62,FMN GV 11 Ramsel
66,Bergstraat 71,2021-01-31,15:00:00,56,36,20,FMN GV 11 Ramsel
66,Bergstraat 71,2021-01-31,16:00:00,22,14,8,FMN GV 11 Ramsel
66,Bergstraat 71,2021-01-31,17:00:00,26,12,14,FMN GV 11 Ramsel
66,Bergstraat 71,2021-01-31,18:00:00,16,4,12,FMN GV 11 Ramsel
66,Bergstraat 71,2021-01-31,19:00:00,4,2,2,FMN GV 11 Ramsel
66,Bergstraat 71,2021-01-31,20:00:00,4,2,2,FMN GV 11 Ramsel
66,Bergstraat 71,2021-01-31,21:00:00,2,2,0,FMN GV 11 Ramsel
66,Bergstraat 71,2021-01-31,22:00:00,0,0,0,FMN GV 11 Ramsel
66,Bergstraat 71,2021-01-31,23:00:00,0,0,0,FMN GV 11 Ramsel
66,Bergstraat 71,2021-02-01,00:00:00,0,0,0,FMN GV 11 Ramsel
66,Bergstraat 71,2021-02-01,01:00:00,0,0,0,FMN GV 11 Ramsel
66,Bergstraat 71,2021-02-01,02:00:00,0,0,0,FMN GV 11 Ramsel
66,Bergstraat 71,2021-02-01,03:00:00,0,0,0,FMN GV 11 Ramsel
66,Bergstraat 71,2021-02-01,04:00:00,2,2,0,FMN GV 11 Ramsel
66,Bergstraat 71,2021-02-01,05:00:00,8,6,2,FMN GV 11 Ramsel
66,Bergstraat 71,2021-02-01,06:00:00,26,14,12,FMN GV 11 Ramsel
66,Bergstraat 71,2021-02-01,07:00:00,130,16,114,FMN GV 11 Ramsel
66,Bergstraat 71,2021-02-01,08:00:00,86,26,60,FMN GV 11 Ramsel
66,Bergstraat 71,2021-02-01,09:00:00,14,2,12,FMN GV 11 Ramsel
66,Bergstraat 71,2021-02-01,10:00:00,22,6,16,FMN GV 11 Ramsel
66,Bergstraat 71,2021-02-01,11:00:00,26,16,10,FMN GV 11 Ramsel
66,Bergstraat 71,2021-02-01,12:00:00,30,14,16,FMN GV 11 Ramsel
66,Bergstraat 71,2021-02-01,13:00:00,62,30,32,FMN GV 11 Ramsel
66,Bergstraat 71,2021-02-01,14:00:00,62,32,30,FMN GV 11 Ramsel
66,Bergstraat 71,2021-02-01,15:00:00,110,82,28,FMN GV 11 Ramsel
66,Bergstraat 71,2021-02-01,16:00:00,110,86,24,FMN GV 11 Ramsel
66,Bergstraat 71,2021-02-01,17:00:00,36,30,6,FMN GV 11 Ramsel
66,Bergstraat 71,2021-02-01,18:00:00,16,8,8,FMN GV 11 Ramsel
66,Bergstraat 71,2021-02-01,19:00:00,4,2,2,FMN GV 11 Ramsel
66,Bergstraat 71,2021-02-01,20:00:00,6,6,0,FMN GV 11 Ramsel
66,Bergstraat 71,2021-02-01,21:00:00,2,0,2,FMN GV 11 Ramsel
66,Bergstraat 71,2021-02-01,22:00:00,6,4,2,FMN GV 11 Ramsel
66,Bergstraat 71,2021-02-01,23:00:00,0,0,0,FMN GV 11 Ramsel
66,Bergstraat 71,2021-02-02,00:00:00,0,0,0,FMN GV 11 Ramsel
66,Bergstraat 71,2021-02-02,01:00:00,0,0,0,FMN GV 11 Ramsel
66,Bergstraat 71,2021-02-02,02:00:00,0,0,0,FMN GV 11 Ramsel
66,Bergstraat 71,2021-02-02,03:00:00,0,0,0,FMN GV 11 Ramsel
66,Bergstraat 71,2021-02-02,04:00:00,2,2,0,FMN GV 11 Ramsel
66,Bergstraat 71,2021-02-02,05:00:00,12,8,4,FMN GV 11 Ramsel
66,Bergstraat 71,2021-02-02,06:00:00,20,12,8,FMN GV 11 Ramsel
66,Bergstraat 71,2021-02-02,07:00:00,38,6,32,FMN GV 11 Ramsel
66,Bergstraat 71,2021-02-02,08:00:00,48,4,44,FMN GV 11 Ramsel
66,Bergstraat 71,2021-02-02,09:00:00,18,6,12,FMN GV 11 Ramsel
66,Bergstraat 71,2021-02-02,10:00:00,10,0,10,FMN GV 11 Ramsel
66,Bergstraat 71,2021-02-02,11:00:00,14,8,6,FMN GV 11 Ramsel
66,Bergstraat 71,2021-02-02,12:00:00,22,10,12,FMN GV 11 Ramsel
66,Bergstraat 71,2021-02-02,13:00:00,50,20,30,FMN GV 11 Ramsel
66,Bergstraat 71,2021-02-02,14:00:00,44,20,24,FMN GV 11 Ramsel
66,Bergstraat 71,2021-02-02,15:00:00,94,64,30,FMN GV 11 Ramsel
66,Bergstraat 71,2021-02-02,16:00:00,44,28,16,FMN GV 11 Ramsel
66,Bergstraat 71,2021-02-02,17:00:00,32,16,16,FMN GV 11 Ramsel
66,Bergstraat 71,2021-02-02,18:00:00,24,12,12,FMN GV 11 Ramsel
66,Bergstraat 71,2021-02-02,19:00:00,34,18,16,FMN GV 11 Ramsel
66,Bergstraat 71,2021-02-02,20:00:00,28,18,10,FMN GV 11 Ramsel
66,Bergstraat 71,2021-02-02,21:00:00,2,2,0,FMN GV 11 Ramsel
66,Bergstraat 71,2021-02-02,22:00:00,8,2,6,FMN GV 11 Ramsel
66,Bergstraat 71,2021-02-02,23:00:00,2,0,2,FMN GV 11 Ramsel
66,Bergstraat 71,2021-02-03,00:00:00,0,0,0,FMN GV 11 Ramsel
66,Bergstraat 71,2021-02-03,01:00:00,0,0,0,FMN GV 11 Ramsel
66,Bergstraat 71,2021-02-03,02:00:00,0,0,0,FMN GV 11 Ramsel
66,Bergstraat 71,2021-02-03,03:00:00,0,0,0,FMN GV 11 Ramsel
66,Bergstraat 71,2021-02-03,04:00:00,4,2,2,FMN GV 11 Ramsel
66,Bergstraat 71,2021-02-03,05:00:00,6,4,2,FMN GV 11 Ramsel
66,Bergstraat 71,2021-02-03,06:00:00,22,8,14,FMN GV 11 Ramsel
66,Bergstraat 71,2021-02-03,07:00:00,64,8,56,FMN GV 11 Ramsel
66,Bergstraat 71,2021-02-03,08:00:00,38,2,36,FMN GV 11 Ramsel
66,Bergstraat 71,2021-02-03,09:00:00,10,4,6,FMN GV 11 Ramsel
66,Bergstraat 71,2021-02-03,10:00:00,6,4,2,FMN GV 11 Ramsel
66,Bergstraat 71,2021-02-03,11:00:00,4,4,0,FMN GV 11 Ramsel
66,Bergstraat 71,2021-02-03,12:00:00,62,52,10,FMN GV 11 Ramsel
66,Bergstraat 71,2021-02-03,13:00:00,24,12,12,FMN GV 11 Ramsel
66,Bergstraat 71,2021-02-03,14:00:00,54,12,42,FMN GV 11 Ramsel
66,Bergstraat 71,2021-02-03,15:00:00,62,26,36,FMN GV 11 Ramsel
66,Bergstraat 71,2021-02-03,16:00:00,34,24,10,FMN GV 11 Ramsel
66,Bergstraat 71,2021-02-03,17:00:00,34,16,18,FMN GV 11 Ramsel
66,Bergstraat 71,2021-02-03,18:00:00,14,8,6,FMN GV 11 Ramsel
66,Bergstraat 71,2021-02-03,19:00:00,0,0,0,FMN GV 11 Ramsel
66,Bergstraat 71,2021-02-03,20:00:00,10,4,6,FMN GV 11 Ramsel
66,Bergstraat 71,2021-02-03,21:00:00,0,0,0,FMN GV 11 Ramsel
66,Bergstraat 71,2021-02-03,22:00:00,4,4,0,FMN GV 11 Ramsel
66,Bergstraat 71,2021-02-03,23:00:00,2,0,2,FMN GV 11 Ramsel
66,Bergstraat 71,2021-02-04,00:00:00,0,0,0,FMN GV 11 Ramsel
66,Bergstraat 71,2021-02-04,01:00:00,0,0,0,FMN GV 11 Ramsel
66,Bergstraat 71,2021-02-04,02:00:00,0,0,0,FMN GV 11 Ramsel
66,Bergstraat 71,2021-02-04,03:00:00,2,2,0,FMN GV 11 Ramsel
66,Bergstraat 71,2021-02-04,04:00:00,6,2,4,FMN GV 11 Ramsel
66,Bergstraat 71,2021-02-04,05:00:00,10,6,4,FMN GV 11 Ramsel
66,Bergstraat 71,2021-02-04,06:00:00,28,14,14,FMN GV 11 Ramsel
66,Bergstraat 71,2021-02-04,07:00:00,104,16,88,FMN GV 11 Ramsel
66,Bergstraat 71,2021-02-04,08:00:00,88,12,76,FMN GV 11 Ramsel
66,Bergstraat 71,2021-02-04,09:00:00,80,24,56,FMN GV 11 Ramsel
66,Bergstraat 71,2021-02-04,10:00:00,60,28,32,FMN GV 11 Ramsel
66,Bergstraat 71,2021-02-04,11:00:00,142,72,70,FMN GV 11 Ramsel
66,Bergstraat 71,2021-02-04,12:00:00,162,66,96,FMN GV 11 Ramsel
66,Bergstraat 71,2021-02-04,13:00:00,208,80,128,FMN GV 11 Ramsel
66,Bergstraat 71,2021-02-04,14:00:00,230,120,110,FMN GV 11 Ramsel
66,Bergstraat 71,2021-02-04,15:00:00,190,144,46,FMN GV 11 Ramsel
66,Bergstraat 71,2021-02-04,16:00:00,116,76,40,FMN GV 11 Ramsel
66,Bergstraat 71,2021-02-04,17:00:00,60,34,26,FMN GV 11 Ramsel
66,Bergstraat 71,2021-02-04,18:00:00,18,12,6,FMN GV 11 Ramsel
66,Bergstraat 71,2021-02-04,19:00:00,26,12,14,FMN GV 11 Ramsel
66,Bergstraat 71,2021-02-04,20:00:00,24,20,4,FMN GV 11 Ramsel
66,Bergstraat 71,2021-02-04,21:00:00,6,2,4,FMN GV 11 Ramsel
66,Bergstraat 71,2021-02-04,22:00:00,10,8,2,FMN GV 11 Ramsel
66,Bergstraat 71,2021-02-04,23:00:00,6,4,2,FMN GV 11 Ramsel
66,Bergstraat 71,2021-02-05,00:00:00,0,0,0,FMN GV 11 Ramsel
66,Bergstraat 71,2021-02-05,01:00:00,0,0,0,FMN GV 11 Ramsel
66,Bergstraat 71,2021-02-05,02:00:00,0,0,0,FMN GV 11 Ramsel
66,Bergstraat 71,2021-02-05,03:00:00,0,0,0,FMN GV 11 Ramsel
66,Bergstraat 71,2021-02-05,04:00:00,0,0,0,FMN GV 11 Ramsel
66,Bergstraat 71,2021-02-05,05:00:00,8,6,2,FMN GV 11 Ramsel
66,Bergstraat 71,2021-02-05,06:00:00,18,4,14,FMN GV 11 Ramsel
66,Bergstraat 71,2021-02-05,07:00:00,130,16,114,FMN GV 11 Ramsel
66,Bergstraat 71,2021-02-05,08:00:00,78,12,66,FMN GV 11 Ramsel
66,Bergstraat 71,2021-02-05,09:00:00,54,32,22,FMN GV 11 Ramsel
66,Bergstraat 71,2021-02-05,10:00:00,72,26,46,FMN GV 11 Ramsel
66,Bergstraat 71,2021-02-05,11:00:00,62,32,30,FMN GV 11 Ramsel
66,Bergstraat 71,2021-02-05,12:00:00,134,66,68,FMN GV 11 Ramsel
66,Bergstraat 71,2021-02-05,13:00:00,128,54,74,FMN GV 11 Ramsel
66,Bergstraat 71,2021-02-05,14:00:00,208,100,108,FMN GV 11 Ramsel
66,Bergstraat 71,2021-02-05,15:00:00,226,160,66,FMN GV 11 Ramsel
66,Bergstraat 71,2021-02-05,16:00:00,130,86,44,FMN GV 11 Ramsel
66,Bergstraat 71,2021-02-05,17:00:00,56,42,14,FMN GV 11 Ramsel
66,Bergstraat 71,2021-02-05,18:00:00,40,24,16,FMN GV 11 Ramsel
66,Bergstraat 71,2021-02-05,19:00:00,28,10,18,FMN GV 11 Ramsel
66,Bergstraat 71,2021-02-05,20:00:00,18,12,6,FMN GV 11 Ramsel
66,Bergstraat 71,2021-02-05,21:00:00,4,4,0,FMN GV 11 Ramsel
66,Bergstraat 71,2021-02-05,22:00:00,0,0,0,FMN GV 11 Ramsel
66,Bergstraat 71,2021-02-05,23:00:00,4,2,2,FMN GV 11 Ramsel
66,Bergstraat 71,2021-02-06,00:00:00,2,2,0,FMN GV 11 Ramsel
66,Bergstraat 71,2021-02-06,01:00:00,0,0,0,FMN GV 11 Ramsel
66,Bergstraat 71,2021-02-06,02:00:00,0,0,0,FMN GV 11 Ramsel
66,Bergstraat 71,2021-02-06,03:00:00,0,0,0,FMN GV 11 Ramsel
66,Bergstraat 71,2021-02-06,04:00:00,0,0,0,FMN GV 11 Ramsel
66,Bergstraat 71,2021-02-06,05:00:00,0,0,0,FMN GV 11 Ramsel
66,Bergstraat 71,2021-02-06,06:00:00,6,0,6,FMN GV 11 Ramsel
66,Bergstraat 71,2021-02-06,07:00:00,4,2,2,FMN GV 11 Ramsel
66,Bergstraat 71,2021-02-06,08:00:00,12,4,8,FMN GV 11 Ramsel
66,Bergstraat 71,2021-02-06,09:00:00,26,16,10,FMN GV 11 Ramsel
66,Bergstraat 71,2021-02-06,10:00:00,50,22,28,FMN GV 11 Ramsel
66,Bergstraat 71,2021-02-06,11:00:00,40,20,20,FMN GV 11 Ramsel
66,Bergstraat 71,2021-02-06,12:00:00,50,24,26,FMN GV 11 Ramsel
66,Bergstraat 71,2021-02-06,13:00:00,52,22,30,FMN GV 11 Ramsel
66,Bergstraat 71,2021-02-06,14:00:00,50,24,26,FMN GV 11 Ramsel
66,Bergstraat 71,2021-02-06,15:00:00,36,26,10,FMN GV 11 Ramsel
66,Bergstraat 71,2021-02-06,16:00:00,22,8,14,FMN GV 11 Ramsel
66,Bergstraat 71,2021-02-06,17:00:00,16,14,2,FMN GV 11 Ramsel
66,Bergstraat 71,2021-02-06,18:00:00,6,0,6,FMN GV 11 Ramsel
66,Bergstraat 71,2021-02-06,19:00:00,10,4,6,FMN GV 11 Ramsel
66,Bergstraat 71,2021-02-06,20:00:00,8,2,6,FMN GV 11 Ramsel
66,Bergstraat 71,2021-02-06,21:00:00,0,0,0,FMN GV 11 Ramsel
66,Bergstraat 71,2021-02-06,22:00:00,2,0,2,FMN GV 11 Ramsel
66,Bergstraat 71,2021-02-06,23:00:00,2,0,2,FMN GV 11 Ramsel
66,Bergstraat 71,2021-02-07,00:00:00,0,0,0,FMN GV 11 Ramsel
66,Bergstraat 71,2021-02-07,01:00:00,0,0,0,FMN GV 11 Ramsel
66,Bergstraat 71,2021-02-07,02:00:00,0,0,0,FMN GV 11 Ramsel
66,Bergstraat 71,2021-02-07,03:00:00,0,0,0,FMN GV 11 Ramsel
66,Bergstraat 71,2021-02-07,04:00:00,0,0,0,FMN GV 11 Ramsel
66,Bergstraat 71,2021-02-07,05:00:00,0,0,0,FMN GV 11 Ramsel
66,Bergstraat 71,2021-02-07,06:00:00,0,0,0,FMN GV 11 Ramsel
66,Bergstraat 71,2021-02-07,07:00:00,2,2,0,FMN GV 11 Ramsel
66,Bergstraat 71,2021-02-07,08:00:00,6,2,4,FMN GV 11 Ramsel
66,Bergstraat 71,2021-02-07,09:00:00,6,2,4,FMN GV 11 Ramsel
66,Bergstraat 71,2021-02-07,10:00:00,2,2,0,FMN GV 11 Ramsel
66,Bergstraat 71,2021-02-07,11:00:00,12,6,6,FMN GV 11 Ramsel
66,Bergstraat 71,2021-02-07,12:00:00,2,2,0,FMN GV 11 Ramsel
66,Bergstraat 71,2021-02-07,13:00:00,6,4,2,FMN GV 11 Ramsel
66,Bergstraat 71,2021-02-07,14:00:00,4,2,2,FMN GV 11 Ramsel
66,Bergstraat 71,2021-02-07,15:00:00,8,4,4,FMN GV 11 Ramsel
66,Bergstraat 71,2021-02-07,16:00:00,6,4,2,FMN GV 11 Ramsel
66,Bergstraat 71,2021-02-07,17:00:00,2,2,0,FMN GV 11 Ramsel
66,Bergstraat 71,2021-02-07,18:00:00,0,0,0,FMN GV 11 Ramsel
66,Bergstraat 71,2021-02-07,19:00:00,0,0,0,FMN GV 11 Ramsel
66,Bergstraat 71,2021-02-07,20:00:00,0,0,0,FMN GV 11 Ramsel
66,Bergstraat 71,2021-02-07,21:00:00,0,0,0,FMN GV 11 Ramsel
66,Bergstraat 71,2021-02-07,22:00:00,0,0,0,FMN GV 11 Ramsel
66,Bergstraat 71,2021-02-07,23:00:00,0,0,0,FMN GV 11 Ramsel
66,Bergstraat 71,2021-02-08,00:00:00,0,0,0,FMN GV 11 Ramsel
66,Bergstraat 71,2021-02-08,01:00:00,0,0,0,FMN GV 11 Ramsel
66,Bergstraat 71,2021-02-08,02:00:00,0,0,0,FMN GV 11 Ramsel
66,Bergstraat 71,2021-02-08,03:00:00,0,0,0,FMN GV 11 Ramsel
66,Bergstraat 71,2021-02-08,04:00:00,0,0,0,FMN GV 11 Ramsel
66,Bergstraat 71,2021-02-08,05:00:00,0,0,0,FMN GV 11 Ramsel
66,Bergstraat 71,2021-02-08,06:00:00,0,0,0,FMN GV 11 Ramsel
66,Bergstraat 71,2021-02-08,07:00:00,0,0,0,FMN GV 11 Ramsel
66,Bergstraat 71,2021-02-08,08:00:00,8,4,4,FMN GV 11 Ramsel
66,Bergstraat 71,2021-02-08,09:00:00,0,0,0,FMN GV 11 Ramsel
66,Bergstraat 71,2021-02-08,10:00:00,2,0,2,FMN GV 11 Ramsel
66,Bergstraat 71,2021-02-08,11:00:00,0,0,0,FMN GV 11 Ramsel
66,Bergstraat 71,2021-02-08,12:00:00,0,0,0,FMN GV 11 Ramsel
66,Bergstraat 71,2021-02-08,13:00:00,2,2,0,FMN GV 11 Ramsel
66,Bergstraat 71,2021-02-08,14:00:00,0,0,0,FMN GV 11 Ramsel
66,Bergstraat 71,2021-02-08,15:00:00,4,2,2,FMN GV 11 Ramsel
66,Bergstraat 71,2021-02-08,16:00:00,4,4,0,FMN GV 11 Ramsel
66,Bergstraat 71,2021-02-08,17:00:00,0,0,0,FMN GV 11 Ramsel
66,Bergstraat 71,2021-02-08,18:00:00,0,0,0,FMN GV 11 Ramsel
66,Bergstraat 71,2021-02-08,19:00:00,0,0,0,FMN GV 11 Ramsel
66,Bergstraat 71,2021-02-08,20:00:00,2,0,2,FMN GV 11 Ramsel
66,Bergstraat 71,2021-02-08,21:00:00,4,4,0,FMN GV 11 Ramsel
66,Bergstraat 71,2021-02-08,22:00:00,2,0,2,FMN GV 11 Ramsel
66,Bergstraat 71,2021-02-08,23:00:00,0,0,0,FMN GV 11 Ramsel
66,Bergstraat 71,2021-02-09,00:00:00,0,0,0,FMN GV 11 Ramsel
66,Bergstraat 71,2021-02-09,01:00:00,0,0,0,FMN GV 11 Ramsel
66,Bergstraat 71,2021-02-09,02:00:00,0,0,0,FMN GV 11 Ramsel
66,Bergstraat 71,2021-02-09,03:00:00,0,0,0,FMN GV 11 Ramsel
66,Bergstraat 71,2021-02-09,04:00:00,0,0,0,FMN GV 11 Ramsel
66,Bergstraat 71,2021-02-09,05:00:00,0,0,0,FMN GV 11 Ramsel
66,Bergstraat 71,2021-02-09,06:00:00,4,0,4,FMN GV 11 Ramsel
66,Bergstraat 71,2021-02-09,07:00:00,2,0,2,FMN GV 11 Ramsel
66,Bergstraat 71,2021-02-09,08:00:00,4,4,0,FMN GV 11 Ramsel
66,Bergstraat 71,2021-02-09,09:00:00,8,0,8,FMN GV 11 Ramsel
66,Bergstraat 71,2021-02-09,10:00:00,0,0,0,FMN GV 11 Ramsel
66,Bergstraat 71,2021-02-09,11:00:00,4,4,0,FMN GV 11 Ramsel
66,Bergstraat 71,2021-02-09,12:00:00,2,0,2,FMN GV 11 Ramsel
66,Bergstraat 71,2021-02-09,13:00:00,8,4,4,FMN GV 11 Ramsel
66,Bergstraat 71,2021-02-09,14:00:00,12,12,0,FMN GV 11 Ramsel
66,Bergstraat 71,2021-02-09,15:00:00,14,8,6,FMN GV 11 Ramsel
66,Bergstraat 71,2021-02-09,16:00:00,18,8,10,FMN GV 11 Ramsel
66,Bergstraat 71,2021-02-09,17:00:00,14,8,6,FMN GV 11 Ramsel
66,Bergstraat 71,2021-02-09,18:00:00,4,2,2,FMN GV 11 Ramsel
66,Bergstraat 71,2021-02-09,19:00:00,2,0,2,FMN GV 11 Ramsel
66,Bergstraat 71,2021-02-09,20:00:00,4,2,2,FMN GV 11 Ramsel
66,Bergstraat 71,2021-02-09,21:00:00,0,0,0,FMN GV 11 Ramsel
66,Bergstraat 71,2021-02-09,22:00:00,0,0,0,FMN GV 11 Ramsel
66,Bergstraat 71,2021-02-09,23:00:00,0,0,0,FMN GV 11 Ramsel
66,Bergstraat 71,2021-02-10,00:00:00,0,0,0,FMN GV 11 Ramsel
66,Bergstraat 71,2021-02-10,01:00:00,0,0,0,FMN GV 11 Ramsel
66,Bergstraat 71,2021-02-10,02:00:00,0,0,0,FMN GV 11 Ramsel
66,Bergstraat 71,2021-02-10,03:00:00,0,0,0,FMN GV 11 Ramsel
66,Bergstraat 71,2021-02-10,04:00:00,0,0,0,FMN GV 11 Ramsel
66,Bergstraat 71,2021-02-10,05:00:00,0,0,0,FMN GV 11 Ramsel
66,Bergstraat 71,2021-02-10,06:00:00,2,0,2,FMN GV 11 Ramsel
66,Bergstraat 71,2021-02-10,07:00:00,4,0,4,FMN GV 11 Ramsel
66,Bergstraat 71,2021-02-10,08:00:00,4,0,4,FMN GV 11 Ramsel
66,Bergstraat 71,2021-02-10,09:00:00,0,0,0,FMN GV 11 Ramsel
66,Bergstraat 71,2021-02-10,10:00:00,0,0,0,FMN GV 11 Ramsel
66,Bergstraat 71,2021-02-10,11:00:00,6,4,2,FMN GV 11 Ramsel
66,Bergstraat 71,2021-02-10,12:00:00,2,2,0,FMN GV 11 Ramsel
66,Bergstraat 71,2021-02-10,13:00:00,16,4,12,FMN GV 11 Ramsel
66,Bergstraat 71,2021-02-10,14:00:00,12,10,2,FMN GV 11 Ramsel
66,Bergstraat 71,2021-02-10,15:00:00,8,2,6,FMN GV 11 Ramsel
66,Bergstraat 71,2021-02-10,16:00:00,16,12,4,FMN GV 11 Ramsel
66,Bergstraat 71,2021-02-10,17:00:00,14,12,2,FMN GV 11 Ramsel
66,Bergstraat 71,2021-02-10,18:00:00,6,4,2,FMN GV 11 Ramsel
66,Bergstraat 71,2021-02-10,19:00:00,2,2,0,FMN GV 11 Ramsel
66,Bergstraat 71,2021-02-10,20:00:00,2,0,2,FMN GV 11 Ramsel
66,Bergstraat 71,2021-02-10,21:00:00,0,0,0,FMN GV 11 Ramsel
66,Bergstraat 71,2021-02-10,22:00:00,0,0,0,FMN GV 11 Ramsel
66,Bergstraat 71,2021-02-10,23:00:00,0,0,0,FMN GV 11 Ramsel
66,Bergstraat 71,2021-02-11,00:00:00,0,0,0,FMN GV 11 Ramsel
66,Bergstraat 71,2021-02-11,01:00:00,0,0,0,FMN GV 11 Ramsel
66,Bergstraat 71,2021-02-11,02:00:00,0,0,0,FMN GV 11 Ramsel
66,Bergstraat 71,2021-02-11,03:00:00,0,0,0,FMN GV 11 Ramsel
66,Bergstraat 71,2021-02-11,04:00:00,0,0,0,FMN GV 11 Ramsel
66,Bergstraat 71,2021-02-11,05:00:00,2,2,0,FMN GV 11 Ramsel
66,Bergstraat 71,2021-02-11,06:00:00,4,2,2,FMN GV 11 Ramsel
66,Bergstraat 71,2021-02-11,07:00:00,4,0,4,FMN GV 11 Ramsel
66,Bergstraat 71,2021-02-11,08:00:00,2,2,0,FMN GV 11 Ramsel
66,Bergstraat 71,2021-02-11,09:00:00,2,0,2,FMN GV 11 Ramsel
66,Bergstraat 71,2021-02-11,10:00:00,0,0,0,FMN GV 11 Ramsel
66,Bergstraat 71,2021-02-11,11:00:00,14,8,6,FMN GV 11 Ramsel
66,Bergstraat 71,2021-02-11,12:00:00,14,6,8,FMN GV 11 Ramsel
66,Bergstraat 71,2021-02-11,13:00:00,14,8,6,FMN GV 11 Ramsel
66,Bergstraat 71,2021-02-11,14:00:00,20,16,4,FMN GV 11 Ramsel
66,Bergstraat 71,2021-02-11,15:00:00,38,22,16,FMN GV 11 Ramsel
66,Bergstraat 71,2021-02-11,16:00:00,18,10,8,FMN GV 11 Ramsel
66,Bergstraat 71,2021-02-11,17:00:00,18,16,2,FMN GV 11 Ramsel
66,Bergstraat 71,2021-02-11,18:00:00,12,4,8,FMN GV 11 Ramsel
66,Bergstraat 71,2021-02-11,19:00:00,2,0,2,FMN GV 11 Ramsel
66,Bergstraat 71,2021-02-11,20:00:00,2,2,0,FMN GV 11 Ramsel
66,Bergstraat 71,2021-02-11,21:00:00,0,0,0,FMN GV 11 Ramsel
66,Bergstraat 71,2021-02-11,22:00:00,8,2,6,FMN GV 11 Ramsel
66,Bergstraat 71,2021-02-11,23:00:00,0,0,0,FMN GV 11 Ramsel
66,Bergstraat 71,2021-02-12,00:00:00,0,0,0,FMN GV 11 Ramsel
66,Bergstraat 71,2021-02-12,01:00:00,0,0,0,FMN GV 11 Ramsel
66,Bergstraat 71,2021-02-12,02:00:00,0,0,0,FMN GV 11 Ramsel
66,Bergstraat 71,2021-02-12,03:00:00,0,0,0,FMN GV 11 Ramsel
66,Bergstraat 71,2021-02-12,04:00:00,0,0,0,FMN GV 11 Ramsel
66,Bergstraat 71,2021-02-12,05:00:00,0,0,0,FMN GV 11 Ramsel
66,Bergstraat 71,2021-02-12,06:00:00,4,2,2,FMN GV 11 Ramsel
66,Bergstraat 71,2021-02-12,07:00:00,2,0,2,FMN GV 11 Ramsel
66,Bergstraat 71,2021-02-12,08:00:00,4,0,4,FMN GV 11 Ramsel
66,Bergstraat 71,2021-02-12,09:00:00,8,2,6,FMN GV 11 Ramsel
66,Bergstraat 71,2021-02-12,10:00:00,2,2,0,FMN GV 11 Ramsel
66,Bergstraat 71,2021-02-12,11:00:00,6,4,2,FMN GV 11 Ramsel
66,Bergstraat 71,2021-02-12,12:00:00,20,16,4,FMN GV 11 Ramsel
66,Bergstraat 71,2021-02-12,13:00:00,20,10,10,FMN GV 11 Ramsel
66,Bergstraat 71,2021-02-12,14:00:00,28,20,8,FMN GV 11 Ramsel
66,Bergstraat 71,2021-02-12,15:00:00,42,20,22,FMN GV 11 Ramsel
66,Bergstraat 71,2021-02-12,16:00:00,24,16,8,FMN GV 11 Ramsel
66,Bergstraat 71,2021-02-12,17:00:00,20,12,8,FMN GV 11 Ramsel
66,Bergstraat 71,2021-02-12,18:00:00,4,2,2,FMN GV 11 Ramsel
66,Bergstraat 71,2021-02-12,19:00:00,10,4,6,FMN GV 11 Ramsel
66,Bergstraat 71,2021-02-12,20:00:00,4,2,2,FMN GV 11 Ramsel
66,Bergstraat 71,2021-02-12,21:00:00,0,0,0,FMN GV 11 Ramsel
66,Bergstraat 71,2021-02-12,22:00:00,2,2,0,FMN GV 11 Ramsel
66,Bergstraat 71,2021-02-12,23:00:00,0,0,0,FMN GV 11 Ramsel
66,Bergstraat 71,2021-02-13,00:00:00,2,2,0,FMN GV 11 Ramsel
66,Bergstraat 71,2021-02-13,01:00:00,0,0,0,FMN GV 11 Ramsel
66,Bergstraat 71,2021-02-13,02:00:00,0,0,0,FMN GV 11 Ramsel
66,Bergstraat 71,2021-02-13,03:00:00,0,0,0,FMN GV 11 Ramsel
66,Bergstraat 71,2021-02-13,04:00:00,0,0,0,FMN GV 11 Ramsel
66,Bergstraat 71,2021-02-13,05:00:00,2,0,2,FMN GV 11 Ramsel
66,Bergstraat 71,2021-02-13,06:00:00,0,0,0,FMN GV 11 Ramsel
66,Bergstraat 71,2021-02-13,07:00:00,0,0,0,FMN GV 11 Ramsel
66,Bergstraat 71,2021-02-13,08:00:00,0,0,0,FMN GV 11 Ramsel
66,Bergstraat 71,2021-02-13,09:00:00,6,2,4,FMN GV 11 Ramsel
66,Bergstraat 71,2021-02-13,10:00:00,10,2,8,FMN GV 11 Ramsel
66,Bergstraat 71,2021-02-13,11:00:00,12,8,4,FMN GV 11 Ramsel
66,Bergstraat 71,2021-02-13,12:00:00,36,18,18,FMN GV 11 Ramsel
66,Bergstraat 71,2021-02-13,13:00:00,30,16,14,FMN GV 11 Ramsel
66,Bergstraat 71,2021-02-13,14:00:00,64,38,26,FMN GV 11 Ramsel
66,Bergstraat 71,2021-02-13,15:00:00,22,12,10,FMN GV 11 Ramsel
66,Bergstraat 71,2021-02-13,16:00:00,42,18,24,FMN GV 11 Ramsel
66,Bergstraat 71,2021-02-13,17:00:00,20,10,10,FMN GV 11 Ramsel
66,Bergstraat 71,2021-02-13,18:00:00,4,0,4,FMN GV 11 Ramsel
66,Bergstraat 71,2021-02-13,19:00:00,2,0,2,FMN GV 11 Ramsel
66,Bergstraat 71,2021-02-13,20:00:00,2,0,2,FMN GV 11 Ramsel
66,Bergstraat 71,2021-02-13,21:00:00,2,0,2,FMN GV 11 Ramsel
66,Bergstraat 71,2021-02-13,22:00:00,2,2,0,FMN GV 11 Ramsel
66,Bergstraat 71,2021-02-13,23:00:00,2,0,2,FMN GV 11 Ramsel
66,Bergstraat 71,2021-02-14,00:00:00,2,2,0,FMN GV 11 Ramsel
66,Bergstraat 71,2021-02-14,01:00:00,0,0,0,FMN GV 11 Ramsel
66,Bergstraat 71,2021-02-14,02:00:00,0,0,0,FMN GV 11 Ramsel
66,Bergstraat 71,2021-02-14,03:00:00,0,0,0,FMN GV 11 Ramsel
66,Bergstraat 71,2021-02-14,04:00:00,0,0,0,FMN GV 11 Ramsel
66,Bergstraat 71,2021-02-14,05:00:00,0,0,0,FMN GV 11 Ramsel
66,Bergstraat 71,2021-02-14,06:00:00,0,0,0,FMN GV 11 Ramsel
66,Bergstraat 71,2021-02-14,07:00:00,0,0,0,FMN GV 11 Ramsel
66,Bergstraat 71,2021-02-14,08:00:00,12,4,8,FMN GV 11 Ramsel
66,Bergstraat 71,2021-02-14,09:00:00,12,0,12,FMN GV 11 Ramsel
66,Bergstraat 71,2021-02-14,10:00:00,16,4,12,FMN GV 11 Ramsel
66,Bergstraat 71,2021-02-14,11:00:00,38,16,22,FMN GV 11 Ramsel
66,Bergstraat 71,2021-02-14,12:00:00,16,10,6,FMN GV 11 Ramsel
66,Bergstraat 71,2021-02-14,13:00:00,68,28,40,FMN GV 11 Ramsel
66,Bergstraat 71,2021-02-14,14:00:00,64,34,30,FMN GV 11 Ramsel
66,Bergstraat 71,2021-02-14,15:00:00,64,36,28,FMN GV 11 Ramsel
66,Bergstraat 71,2021-02-14,16:00:00,30,20,10,FMN GV 11 Ramsel
66,Bergstraat 71,2021-02-14,17:00:00,30,16,14,FMN GV 11 Ramsel
66,Bergstraat 71,2021-02-14,18:00:00,6,4,2,FMN GV 11 Ramsel
66,Bergstraat 71,2021-02-14,19:00:00,8,4,4,FMN GV 11 Ramsel
66,Bergstraat 71,2021-02-14,20:00:00,10,6,4,FMN GV 11 Ramsel
66,Bergstraat 71,2021-02-14,21:00:00,0,0,0,FMN GV 11 Ramsel
66,Bergstraat 71,2021-02-14,22:00:00,0,0,0,FMN GV 11 Ramsel
66,Bergstraat 71,2021-02-14,23:00:00,0,0,0,FMN GV 11 Ramsel
66,Bergstraat 71,2021-02-15,00:00:00,2,0,2,FMN GV 11 Ramsel
66,Bergstraat 71,2021-02-15,01:00:00,0,0,0,FMN GV 11 Ramsel
66,Bergstraat 71,2021-02-15,02:00:00,0,0,0,FMN GV 11 Ramsel
66,Bergstraat 71,2021-02-15,03:00:00,0,0,0,FMN GV 11 Ramsel
66,Bergstraat 71,2021-02-15,04:00:00,2,2,0,FMN GV 11 Ramsel
66,Bergstraat 71,2021-02-15,05:00:00,10,6,4,FMN GV 11 Ramsel
66,Bergstraat 71,2021-02-15,06:00:00,10,0,10,FMN GV 11 Ramsel
66,Bergstraat 71,2021-02-15,07:00:00,18,6,12,FMN GV 11 Ramsel
66,Bergstraat 71,2021-02-15,08:00:00,16,6,10,FMN GV 11 Ramsel
66,Bergstraat 71,2021-02-15,09:00:00,10,2,8,FMN GV 11 Ramsel
66,Bergstraat 71,2021-02-15,10:00:00,12,2,10,FMN GV 11 Ramsel
66,Bergstraat 71,2021-02-15,11:00:00,6,0,6,FMN GV 11 Ramsel
66,Bergstraat 71,2021-02-15,12:00:00,16,4,12,FMN GV 11 Ramsel
66,Bergstraat 71,2021-02-15,13:00:00,10,4,6,FMN GV 11 Ramsel
66,Bergstraat 71,2021-02-15,14:00:00,30,18,12,FMN GV 11 Ramsel
66,Bergstraat 71,2021-02-15,15:00:00,18,6,12,FMN GV 11 Ramsel
66,Bergstraat 71,2021-02-15,16:00:00,30,22,8,FMN GV 11 Ramsel
66,Bergstraat 71,2021-02-15,17:00:00,38,24,14,FMN GV 11 Ramsel
66,Bergstraat 71,2021-02-15,18:00:00,4,2,2,FMN GV 11 Ramsel
66,Bergstraat 71,2021-02-15,19:00:00,10,8,2,FMN GV 11 Ramsel
66,Bergstraat 71,2021-02-15,20:00:00,10,6,4,FMN GV 11 Ramsel
66,Bergstraat 71,2021-02-15,21:00:00,8,6,2,FMN GV 11 Ramsel
66,Bergstraat 71,2021-02-15,22:00:00,6,4,2,FMN GV 11 Ramsel
66,Bergstraat 71,2021-02-15,23:00:00,0,0,0,FMN GV 11 Ramsel
66,Bergstraat 71,2021-02-16,00:00:00,0,0,0,FMN GV 11 Ramsel
66,Bergstraat 71,2021-02-16,01:00:00,2,0,2,FMN GV 11 Ramsel
66,Bergstraat 71,2021-02-16,02:00:00,0,0,0,FMN GV 11 Ramsel
66,Bergstraat 71,2021-02-16,03:00:00,0,0,0,FMN GV 11 Ramsel
66,Bergstraat 71,2021-02-16,04:00:00,2,2,0,FMN GV 11 Ramsel
66,Bergstraat 71,2021-02-16,05:00:00,8,6,2,FMN GV 11 Ramsel
66,Bergstraat 71,2021-02-16,06:00:00,12,2,10,FMN GV 11 Ramsel
66,Bergstraat 71,2021-02-16,07:00:00,20,6,14,FMN GV 11 Ramsel
66,Bergstraat 71,2021-02-16,08:00:00,34,12,22,FMN GV 11 Ramsel
66,Bergstraat 71,2021-02-16,09:00:00,34,14,20,FMN GV 11 Ramsel
66,Bergstraat 71,2021-02-16,10:00:00,48,28,20,FMN GV 11 Ramsel
66,Bergstraat 71,2021-02-16,11:00:00,48,24,24,FMN GV 11 Ramsel
66,Bergstraat 71,2021-02-16,12:00:00,76,36,40,FMN GV 11 Ramsel
66,Bergstraat 71,2021-02-16,13:00:00,158,52,106,FMN GV 11 Ramsel
66,Bergstraat 71,2021-02-16,14:00:00,154,72,82,FMN GV 11 Ramsel
66,Bergstraat 71,2021-02-16,15:00:00,146,72,74,FMN GV 11 Ramsel
66,Bergstraat 71,2021-02-16,16:00:00,86,54,32,FMN GV 11 Ramsel
66,Bergstraat 71,2021-02-16,17:00:00,50,28,22,FMN GV 11 Ramsel
66,Bergstraat 71,2021-02-16,18:00:00,10,6,4,FMN GV 11 Ramsel
66,Bergstraat 71,2021-02-16,19:00:00,20,6,14,FMN GV 11 Ramsel
66,Bergstraat 71,2021-02-16,20:00:00,18,12,6,FMN GV 11 Ramsel
66,Bergstraat 71,2021-02-16,21:00:00,0,0,0,FMN GV 11 Ramsel
66,Bergstraat 71,2021-02-16,22:00:00,8,6,2,FMN GV 11 Ramsel
66,Bergstraat 71,2021-02-16,23:00:00,0,0,0,FMN GV 11 Ramsel
66,Bergstraat 71,2021-02-17,00:00:00,0,0,0,FMN GV 11 Ramsel
66,Bergstraat 71,2021-02-17,01:00:00,0,0,0,FMN GV 11 Ramsel
66,Bergstraat 71,2021-02-17,02:00:00,0,0,0,FMN GV 11 Ramsel
66,Bergstraat 71,2021-02-17,03:00:00,0,0,0,FMN GV 11 Ramsel
66,Bergstraat 71,2021-02-17,04:00:00,2,2,0,FMN GV 11 Ramsel
66,Bergstraat 71,2021-02-17,05:00:00,6,4,2,FMN GV 11 Ramsel
66,Bergstraat 71,2021-02-17,06:00:00,16,4,12,FMN GV 11 Ramsel
66,Bergstraat 71,2021-02-17,07:00:00,30,12,18,FMN GV 11 Ramsel
66,Bergstraat 71,2021-02-17,08:00:00,34,14,20,FMN GV 11 Ramsel
66,Bergstraat 71,2021-02-17,09:00:00,32,8,24,FMN GV 11 Ramsel
66,Bergstraat 71,2021-02-17,10:00:00,66,32,34,FMN GV 11 Ramsel
66,Bergstraat 71,2021-02-17,11:00:00,54,24,30,FMN GV 11 Ramsel
66,Bergstraat 71,2021-02-17,12:00:00,68,30,38,FMN GV 11 Ramsel
66,Bergstraat 71,2021-02-17,13:00:00,170,72,98,FMN GV 11 Ramsel
66,Bergstraat 71,2021-02-17,14:00:00,164,86,78,FMN GV 11 Ramsel
66,Bergstraat 71,2021-02-17,15:00:00,118,72,46,FMN GV 11 Ramsel
66,Bergstraat 71,2021-02-17,16:00:00,132,80,52,FMN GV 11 Ramsel
66,Bergstraat 71,2021-02-17,17:00:00,66,24,42,FMN GV 11 Ramsel
66,Bergstraat 71,2021-02-17,18:00:00,34,14,20,FMN GV 11 Ramsel
66,Bergstraat 71,2021-02-17,19:00:00,36,24,12,FMN GV 11 Ramsel
66,Bergstraat 71,2021-02-17,20:00:00,12,4,8,FMN GV 11 Ramsel
66,Bergstraat 71,2021-02-17,21:00:00,14,14,0,FMN GV 11 Ramsel
66,Bergstraat 71,2021-02-17,22:00:00,14,14,0,FMN GV 11 Ramsel
66,Bergstraat 71,2021-02-17,23:00:00,2,0,2,FMN GV 11 Ramsel
66,Bergstraat 71,2021-02-18,00:00:00,0,0,0,FMN GV 11 Ramsel
66,Bergstraat 71,2021-02-18,01:00:00,0,0,0,FMN GV 11 Ramsel
66,Bergstraat 71,2021-02-18,02:00:00,0,0,0,FMN GV 11 Ramsel
66,Bergstraat 71,2021-02-18,03:00:00,0,0,0,FMN GV 11 Ramsel
66,Bergstraat 71,2021-02-18,04:00:00,0,0,0,FMN GV 11 Ramsel
66,Bergstraat 71,2021-02-18,05:00:00,8,4,4,FMN GV 11 Ramsel
66,Bergstraat 71,2021-02-18,06:00:00,16,6,10,FMN GV 11 Ramsel
66,Bergstraat 71,2021-02-18,07:00:00,24,8,16,FMN GV 11 Ramsel
66,Bergstraat 71,2021-02-18,08:00:00,40,16,24,FMN GV 11 Ramsel
66,Bergstraat 71,2021-02-18,09:00:00,44,12,32,FMN GV 11 Ramsel
66,Bergstraat 71,2021-02-18,10:00:00,72,30,42,FMN GV 11 Ramsel
66,Bergstraat 71,2021-02-18,11:00:00,54,28,26,FMN GV 11 Ramsel
66,Bergstraat 71,2021-02-18,12:00:00,52,36,16,FMN GV 11 Ramsel
66,Bergstraat 71,2021-02-18,13:00:00,54,26,28,FMN GV 11 Ramsel
66,Bergstraat 71,2021-02-18,14:00:00,50,24,26,FMN GV 11 Ramsel
66,Bergstraat 71,2021-02-18,15:00:00,22,16,6,FMN GV 11 Ramsel
66,Bergstraat 71,2021-02-18,16:00:00,12,6,6,FMN GV 11 Ramsel
66,Bergstraat 71,2021-02-18,17:00:00,28,18,10,FMN GV 11 Ramsel
66,Bergstraat 71,2021-02-18,18:00:00,14,10,4,FMN GV 11 Ramsel
66,Bergstraat 71,2021-02-18,19:00:00,10,6,4,FMN GV 11 Ramsel
66,Bergstraat 71,2021-02-18,20:00:00,4,4,0,FMN GV 11 Ramsel
66,Bergstraat 71,2021-02-18,21:00:00,6,2,4,FMN GV 11 Ramsel
66,Bergstraat 71,2021-02-18,22:00:00,10,8,2,FMN GV 11 Ramsel
66,Bergstraat 71,2021-02-18,23:00:00,4,2,2,FMN GV 11 Ramsel
66,Bergstraat 71,2021-02-19,00:00:00,0,0,0,FMN GV 11 Ramsel
66,Bergstraat 71,2021-02-19,01:00:00,0,0,0,FMN GV 11 Ramsel
66,Bergstraat 71,2021-02-19,02:00:00,0,0,0,FMN GV 11 Ramsel
66,Bergstraat 71,2021-02-19,03:00:00,0,0,0,FMN GV 11 Ramsel
66,Bergstraat 71,2021-02-19,04:00:00,4,4,0,FMN GV 11 Ramsel
66,Bergstraat 71,2021-02-19,05:00:00,6,4,2,FMN GV 11 Ramsel
66,Bergstraat 71,2021-02-19,06:00:00,10,2,8,FMN GV 11 Ramsel
66,Bergstraat 71,2021-02-19,07:00:00,30,10,20,FMN GV 11 Ramsel
66,Bergstraat 71,2021-02-19,08:00:00,20,8,12,FMN GV 11 Ramsel
66,Bergstraat 71,2021-02-19,09:00:00,42,8,34,FMN GV 11 Ramsel
66,Bergstraat 71,2021-02-19,10:00:00,68,32,36,FMN GV 11 Ramsel
66,Bergstraat 71,2021-02-19,11:00:00,64,32,32,FMN GV 11 Ramsel
66,Bergstraat 71,2021-02-19,12:00:00,86,32,54,FMN GV 11 Ramsel
66,Bergstraat 71,2021-02-19,13:00:00,166,76,90,FMN GV 11 Ramsel
66,Bergstraat 71,2021-02-19,14:00:00,198,80,118,FMN GV 11 Ramsel
66,Bergstraat 71,2021-02-19,15:00:00,174,120,54,FMN GV 11 Ramsel
66,Bergstraat 71,2021-02-19,16:00:00,126,84,42,FMN GV 11 Ramsel
66,Bergstraat 71,2021-02-19,17:00:00,84,38,46,FMN GV 11 Ramsel
66,Bergstraat 71,2021-02-19,18:00:00,38,22,16,FMN GV 11 Ramsel
66,Bergstraat 71,2021-02-19,19:00:00,20,14,6,FMN GV 11 Ramsel
66,Bergstraat 71,2021-02-19,20:00:00,12,6,6,FMN GV 11 Ramsel
66,Bergstraat 71,2021-02-19,21:00:00,4,0,4,FMN GV 11 Ramsel
66,Bergstraat 71,2021-02-19,22:00:00,4,2,2,FMN GV 11 Ramsel
66,Bergstraat 71,2021-02-19,23:00:00,2,0,2,FMN GV 11 Ramsel
66,Bergstraat 71,2021-02-20,00:00:00,2,2,0,FMN GV 11 Ramsel
66,Bergstraat 71,2021-02-20,01:00:00,0,0,0,FMN GV 11 Ramsel
66,Bergstraat 71,2021-02-20,02:00:00,0,0,0,FMN GV 11 Ramsel
66,Bergstraat 71,2021-02-20,03:00:00,0,0,0,FMN GV 11 Ramsel
66,Bergstraat 71,2021-02-20,04:00:00,0,0,0,FMN GV 11 Ramsel
66,Bergstraat 71,2021-02-20,05:00:00,4,0,4,FMN GV 11 Ramsel
66,Bergstraat 71,2021-02-20,06:00:00,4,2,2,FMN GV 11 Ramsel
66,Bergstraat 71,2021-02-20,07:00:00,10,6,4,FMN GV 11 Ramsel
66,Bergstraat 71,2021-02-20,08:00:00,34,8,26,FMN GV 11 Ramsel
66,Bergstraat 71,2021-02-20,09:00:00,104,38,66,FMN GV 11 Ramsel
66,Bergstraat 71,2021-02-20,10:00:00,174,62,112,FMN GV 11 Ramsel
66,Bergstraat 71,2021-02-20,11:00:00,192,102,90,FMN GV 11 Ramsel
66,Bergstraat 71,2021-02-20,12:00:00,190,78,112,FMN GV 11 Ramsel
66,Bergstraat 71,2021-02-20,13:00:00,392,178,214,FMN GV 11 Ramsel
66,Bergstraat 71,2021-02-20,14:00:00,372,176,196,FMN GV 11 Ramsel
66,Bergstraat 71,2021-02-20,15:00:00,338,184,154,FMN GV 11 Ramsel
66,Bergstraat 71,2021-02-20,16:00:00,306,168,138,FMN GV 11 Ramsel
66,Bergstraat 71,2021-02-20,17:00:00,98,74,24,FMN GV 11 Ramsel
66,Bergstraat 71,2021-02-20,18:00:00,46,18,28,FMN GV 11 Ramsel
66,Bergstraat 71,2021-02-20,19:00:00,14,8,6,FMN GV 11 Ramsel
66,Bergstraat 71,2021-02-20,20:00:00,14,4,10,FMN GV 11 Ramsel
66,Bergstraat 71,2021-02-20,21:00:00,6,2,4,FMN GV 11 Ramsel
66,Bergstraat 71,2021-02-20,22:00:00,8,2,6,FMN GV 11 Ramsel
66,Bergstraat 71,2021-02-20,23:00:00,10,4,6,FMN GV 11 Ramsel
66,Bergstraat 71,2021-02-21,00:00:00,2,2,0,FMN GV 11 Ramsel
66,Bergstraat 71,2021-02-21,01:00:00,0,0,0,FMN GV 11 Ramsel
66,Bergstraat 71,2021-02-21,02:00:00,0,0,0,FMN GV 11 Ramsel
66,Bergstraat 71,2021-02-21,03:00:00,0,0,0,FMN GV 11 Ramsel
66,Bergstraat 71,2021-02-21,04:00:00,0,0,0,FMN GV 11 Ramsel
66,Bergstraat 71,2021-02-21,05:00:00,2,0,2,FMN GV 11 Ramsel
66,Bergstraat 71,2021-02-21,06:00:00,6,2,4,FMN GV 11 Ramsel
66,Bergstraat 71,2021-02-21,07:00:00,42,14,28,FMN GV 11 Ramsel
66,Bergstraat 71,2021-02-21,08:00:00,104,32,72,FMN GV 11 Ramsel
66,Bergstraat 71,2021-02-21,09:00:00,204,50,154,FMN GV 11 Ramsel
66,Bergstraat 71,2021-02-21,10:00:00,406,180,226,FMN GV 11 Ramsel
66,Bergstraat 71,2021-02-21,11:00:00,298,170,128,FMN GV 11 Ramsel
66,Bergstraat 71,2021-02-21,12:00:00,284,172,112,FMN GV 11 Ramsel
66,Bergstraat 71,2021-02-21,13:00:00,440,172,268,FMN GV 11 Ramsel
66,Bergstraat 71,2021-02-21,14:00:00,598,276,322,FMN GV 11 Ramsel
66,Bergstraat 71,2021-02-21,15:00:00,384,220,164,FMN GV 11 Ramsel
66,Bergstraat 71,2021-02-21,16:00:00,322,200,122,FMN GV 11 Ramsel
66,Bergstraat 71,2021-02-21,17:00:00,120,78,42,FMN GV 11 Ramsel
66,Bergstraat 71,2021-02-21,18:00:00,32,20,12,FMN GV 11 Ramsel
66,Bergstraat 71,2021-02-21,19:00:00,28,12,16,FMN GV 11 Ramsel
66,Bergstraat 71,2021-02-21,20:00:00,6,2,4,FMN GV 11 Ramsel
66,Bergstraat 71,2021-02-21,21:00:00,10,8,2,FMN GV 11 Ramsel
66,Bergstraat 71,2021-02-21,22:00:00,6,4,2,FMN GV 11 Ramsel
66,Bergstraat 71,2021-02-21,23:00:00,0,0,0,FMN GV 11 Ramsel
66,Bergstraat 71,2021-02-22,00:00:00,0,0,0,FMN GV 11 Ramsel
66,Bergstraat 71,2021-02-22,01:00:00,0,0,0,FMN GV 11 Ramsel
66,Bergstraat 71,2021-02-22,02:00:00,0,0,0,FMN GV 11 Ramsel
66,Bergstraat 71,2021-02-22,03:00:00,0,0,0,FMN GV 11 Ramsel
66,Bergstraat 71,2021-02-22,04:00:00,4,4,0,FMN GV 11 Ramsel
66,Bergstraat 71,2021-02-22,05:00:00,10,8,2,FMN GV 11 Ramsel
66,Bergstraat 71,2021-02-22,06:00:00,32,14,18,FMN GV 11 Ramsel
66,Bergstraat 71,2021-02-22,07:00:00,182,20,162,FMN GV 11 Ramsel
66,Bergstraat 71,2021-02-22,08:00:00,182,28,154,FMN GV 11 Ramsel
66,Bergstraat 71,2021-02-22,09:00:00,44,14,30,FMN GV 11 Ramsel
66,Bergstraat 71,2021-02-22,10:00:00,82,36,46,FMN GV 11 Ramsel
66,Bergstraat 71,2021-02-22,11:00:00,78,40,38,FMN GV 11 Ramsel
66,Bergstraat 71,2021-02-22,12:00:00,102,38,64,FMN GV 11 Ramsel
66,Bergstraat 71,2021-02-22,13:00:00,200,100,100,FMN GV 11 Ramsel
66,Bergstraat 71,2021-02-22,14:00:00,240,126,114,FMN GV 11 Ramsel
66,Bergstraat 71,2021-02-22,15:00:00,344,226,118,FMN GV 11 Ramsel
66,Bergstraat 71,2021-02-22,16:00:00,212,134,78,FMN GV 11 Ramsel
66,Bergstraat 71,2021-02-22,17:00:00,82,42,40,FMN GV 11 Ramsel
66,Bergstraat 71,2021-02-22,18:00:00,44,32,12,FMN GV 11 Ramsel
66,Bergstraat 71,2021-02-22,19:00:00,12,4,8,FMN GV 11 Ramsel
66,Bergstraat 71,2021-02-22,20:00:00,12,4,8,FMN GV 11 Ramsel
66,Bergstraat 71,2021-02-22,21:00:00,4,4,0,FMN GV 11 Ramsel
66,Bergstraat 71,2021-02-22,22:00:00,12,4,8,FMN GV 11 Ramsel
66,Bergstraat 71,2021-02-22,23:00:00,2,2,0,FMN GV 11 Ramsel
66,Bergstraat 71,2021-02-23,00:00:00,0,0,0,FMN GV 11 Ramsel
66,Bergstraat 71,2021-02-23,01:00:00,0,0,0,FMN GV 11 Ramsel
66,Bergstraat 71,2021-02-23,02:00:00,0,0,0,FMN GV 11 Ramsel
66,Bergstraat 71,2021-02-23,03:00:00,0,0,0,FMN GV 11 Ramsel
66,Bergstraat 71,2021-02-23,04:00:00,4,4,0,FMN GV 11 Ramsel
66,Bergstraat 71,2021-02-23,05:00:00,14,6,8,FMN GV 11 Ramsel
66,Bergstraat 71,2021-02-23,06:00:00,26,12,14,FMN GV 11 Ramsel
66,Bergstraat 71,2021-02-23,07:00:00,200,32,168,FMN GV 11 Ramsel
66,Bergstraat 71,2021-02-23,08:00:00,154,36,118,FMN GV 11 Ramsel
66,Bergstraat 71,2021-02-23,09:00:00,50,26,24,FMN GV 11 Ramsel
66,Bergstraat 71,2021-02-23,10:00:00,88,28,60,FMN GV 11 Ramsel
66,Bergstraat 71,2021-02-23,11:00:00,74,40,34,FMN GV 11 Ramsel
66,Bergstraat 71,2021-02-23,12:00:00,120,42,78,FMN GV 11 Ramsel
66,Bergstraat 71,2021-02-23,13:00:00,270,98,172,FMN GV 11 Ramsel
66,Bergstraat 71,2021-02-23,14:00:00,276,142,134,FMN GV 11 Ramsel
66,Bergstraat 71,2021-02-23,15:00:00,390,308,82,FMN GV 11 Ramsel
66,Bergstraat 71,2021-02-23,16:00:00,236,156,80,FMN GV 11 Ramsel
66,Bergstraat 71,2021-02-23,17:00:00,122,68,54,FMN GV 11 Ramsel
66,Bergstraat 71,2021-02-23,18:00:00,86,36,50,FMN GV 11 Ramsel
66,Bergstraat 71,2021-02-23,19:00:00,50,24,26,FMN GV 11 Ramsel
66,Bergstraat 71,2021-02-23,20:00:00,38,32,6,FMN GV 11 Ramsel
66,Bergstraat 71,2021-02-23,21:00:00,4,2,2,FMN GV 11 Ramsel
66,Bergstraat 71,2021-02-23,22:00:00,14,8,6,FMN GV 11 Ramsel
66,Bergstraat 71,2021-02-23,23:00:00,8,8,0,FMN GV 11 Ramsel
66,Bergstraat 71,2021-02-24,00:00:00,0,0,0,FMN GV 11 Ramsel
66,Bergstraat 71,2021-02-24,01:00:00,0,0,0,FMN GV 11 Ramsel
66,Bergstraat 71,2021-02-24,02:00:00,0,0,0,FMN GV 11 Ramsel
66,Bergstraat 71,2021-02-24,03:00:00,0,0,0,FMN GV 11 Ramsel
66,Bergstraat 71,2021-02-24,04:00:00,4,4,0,FMN GV 11 Ramsel
66,Bergstraat 71,2021-02-24,05:00:00,20,4,16,FMN GV 11 Ramsel
66,Bergstraat 71,2021-02-24,06:00:00,30,14,16,FMN GV 11 Ramsel
66,Bergstraat 71,2021-02-24,07:00:00,198,30,168,FMN GV 11 Ramsel
66,Bergstraat 71,2021-02-24,08:00:00,178,26,152,FMN GV 11 Ramsel
66,Bergstraat 71,2021-02-24,09:00:00,84,28,56,FMN GV 11 Ramsel
66,Bergstraat 71,2021-02-24,10:00:00,110,48,62,FMN GV 11 Ramsel
66,Bergstraat 71,2021-02-24,11:00:00,134,74,60,FMN GV 11 Ramsel
66,Bergstraat 71,2021-02-24,12:00:00,324,234,90,FMN GV 11 Ramsel
66,Bergstraat 71,2021-02-24,13:00:00,328,152,176,FMN GV 11 Ramsel
66,Bergstraat 71,2021-02-24,14:00:00,398,212,186,FMN GV 11 Ramsel
66,Bergstraat 71,2021-02-24,15:00:00,396,246,150,FMN GV 11 Ramsel
66,Bergstraat 71,2021-02-24,16:00:00,284,174,110,FMN GV 11 Ramsel
66,Bergstraat 71,2021-02-24,17:00:00,210,120,90,FMN GV 11 Ramsel
66,Bergstraat 71,2021-02-24,18:00:00,102,48,54,FMN GV 11 Ramsel
66,Bergstraat 71,2021-02-24,19:00:00,38,22,16,FMN GV 11 Ramsel
66,Bergstraat 71,2021-02-24,20:00:00,18,6,12,FMN GV 11 Ramsel
66,Bergstraat 71,2021-02-24,21:00:00,24,22,2,FMN GV 11 Ramsel
66,Bergstraat 71,2021-02-24,22:00:00,10,4,6,FMN GV 11 Ramsel
66,Bergstraat 71,2021-02-24,23:00:00,4,4,0,FMN GV 11 Ramsel
66,Bergstraat 71,2021-02-25,00:00:00,0,0,0,FMN GV 11 Ramsel
66,Bergstraat 71,2021-02-25,01:00:00,0,0,0,FMN GV 11 Ramsel
66,Bergstraat 71,2021-02-25,02:00:00,0,0,0,FMN GV 11 Ramsel
66,Bergstraat 71,2021-02-25,03:00:00,0,0,0,FMN GV 11 Ramsel
66,Bergstraat 71,2021-02-25,04:00:00,8,4,4,FMN GV 11 Ramsel
66,Bergstraat 71,2021-02-25,05:00:00,10,6,4,FMN GV 11 Ramsel
66,Bergstraat 71,2021-02-25,06:00:00,30,6,24,FMN GV 11 Ramsel
66,Bergstraat 71,2021-02-25,07:00:00,182,26,156,FMN GV 11 Ramsel
66,Bergstraat 71,2021-02-25,08:00:00,168,30,138,FMN GV 11 Ramsel
66,Bergstraat 71,2021-02-25,09:00:00,74,26,48,FMN GV 11 Ramsel
66,Bergstraat 71,2021-02-25,10:00:00,60,36,24,FMN GV 11 Ramsel
66,Bergstraat 71,2021-02-25,11:00:00,92,44,48,FMN GV 11 Ramsel
66,Bergstraat 71,2021-02-25,12:00:00,88,58,30,FMN GV 11 Ramsel
66,Bergstraat 71,2021-02-25,13:00:00,180,92,88,FMN GV 11 Ramsel
66,Bergstraat 71,2021-02-25,14:00:00,252,122,130,FMN GV 11 Ramsel
66,Bergstraat 71,2021-02-25,15:00:00,330,232,98,FMN GV 11 Ramsel
66,Bergstraat 71,2021-02-25,16:00:00,196,150,46,FMN GV 11 Ramsel
66,Bergstraat 71,2021-02-25,17:00:00,78,44,34,FMN GV 11 Ramsel
66,Bergstraat 71,2021-02-25,18:00:00,52,28,24,FMN GV 11 Ramsel
66,Bergstraat 71,2021-02-25,19:00:00,22,20,2,FMN GV 11 Ramsel
66,Bergstraat 71,2021-02-25,20:00:00,16,8,8,FMN GV 11 Ramsel
66,Bergstraat 71,2021-02-25,21:00:00,4,2,2,FMN GV 11 Ramsel
66,Bergstraat 71,2021-02-25,22:00:00,14,4,10,FMN GV 11 Ramsel
66,Bergstraat 71,2021-02-25,23:00:00,4,4,0,FMN GV 11 Ramsel
66,Bergstraat 71,2021-02-26,00:00:00,0,0,0,FMN GV 11 Ramsel
66,Bergstraat 71,2021-02-26,01:00:00,0,0,0,FMN GV 11 Ramsel
66,Bergstraat 71,2021-02-26,02:00:00,0,0,0,FMN GV 11 Ramsel
66,Bergstraat 71,2021-02-26,03:00:00,0,0,0,FMN GV 11 Ramsel
66,Bergstraat 71,2021-02-26,04:00:00,4,2,2,FMN GV 11 Ramsel
66,Bergstraat 71,2021-02-26,05:00:00,6,4,2,FMN GV 11 Ramsel
66,Bergstraat 71,2021-02-26,06:00:00,18,0,18,FMN GV 11 Ramsel
66,Bergstraat 71,2021-02-26,07:00:00,146,20,126,FMN GV 11 Ramsel
66,Bergstraat 71,2021-02-26,08:00:00,142,22,120,FMN GV 11 Ramsel
66,Bergstraat 71,2021-02-26,09:00:00,36,2,34,FMN GV 11 Ramsel
66,Bergstraat 71,2021-02-26,10:00:00,50,16,34,FMN GV 11 Ramsel
66,Bergstraat 71,2021-02-26,11:00:00,62,28,34,FMN GV 11 Ramsel
66,Bergstraat 71,2021-02-26,12:00:00,88,36,52,FMN GV 11 Ramsel
66,Bergstraat 71,2021-02-26,13:00:00,138,54,84,FMN GV 11 Ramsel
66,Bergstraat 71,2021-02-26,14:00:00,128,60,68,FMN GV 11 Ramsel
66,Bergstraat 71,2021-02-26,15:00:00,242,176,66,FMN GV 11 Ramsel
66,Bergstraat 71,2021-02-26,16:00:00,172,132,40,FMN GV 11 Ramsel
66,Bergstraat 71,2021-02-26,17:00:00,80,44,36,FMN GV 11 Ramsel
66,Bergstraat 71,2021-02-26,18:00:00,30,20,10,FMN GV 11 Ramsel
66,Bergstraat 71,2021-02-26,19:00:00,30,14,16,FMN GV 11 Ramsel
66,Bergstraat 71,2021-02-26,20:00:00,24,8,16,FMN GV 11 Ramsel
66,Bergstraat 71,2021-02-26,21:00:00,6,2,4,FMN GV 11 Ramsel
66,Bergstraat 71,2021-02-26,22:00:00,6,4,2,FMN GV 11 Ramsel
66,Bergstraat 71,2021-02-26,23:00:00,10,10,0,FMN GV 11 Ramsel
66,Bergstraat 71,2021-02-27,00:00:00,2,2,0,FMN GV 11 Ramsel
66,Bergstraat 71,2021-02-27,01:00:00,0,0,0,FMN GV 11 Ramsel
66,Bergstraat 71,2021-02-27,02:00:00,0,0,0,FMN GV 11 Ramsel
66,Bergstraat 71,2021-02-27,03:00:00,0,0,0,FMN GV 11 Ramsel
66,Bergstraat 71,2021-02-27,04:00:00,0,0,0,FMN GV 11 Ramsel
66,Bergstraat 71,2021-02-27,05:00:00,2,0,2,FMN GV 11 Ramsel
66,Bergstraat 71,2021-02-27,06:00:00,0,0,0,FMN GV 11 Ramsel
66,Bergstraat 71,2021-02-27,07:00:00,6,4,2,FMN GV 11 Ramsel
66,Bergstraat 71,2021-02-27,08:00:00,26,6,20,FMN GV 11 Ramsel
66,Bergstraat 71,2021-02-27,09:00:00,74,28,46,FMN GV 11 Ramsel
66,Bergstraat 71,2021-02-27,10:00:00,74,42,32,FMN GV 11 Ramsel
66,Bergstraat 71,2021-02-27,11:00:00,114,80,34,FMN GV 11 Ramsel
66,Bergstraat 71,2021-02-27,12:00:00,92,56,36,FMN GV 11 Ramsel
66,Bergstraat 71,2021-02-27,13:00:00,154,58,96,FMN GV 11 Ramsel
66,Bergstraat 71,2021-02-27,14:00:00,142,74,68,FMN GV 11 Ramsel
66,Bergstraat 71,2021-02-27,15:00:00,166,114,52,FMN GV 11 Ramsel
66,Bergstraat 71,2021-02-27,16:00:00,114,62,52,FMN GV 11 Ramsel
66,Bergstraat 71,2021-02-27,17:00:00,54,22,32,FMN GV 11 Ramsel
66,Bergstraat 71,2021-02-27,18:00:00,24,10,14,FMN GV 11 Ramsel
66,Bergstraat 71,2021-02-27,19:00:00,12,2,10,FMN GV 11 Ramsel
66,Bergstraat 71,2021-02-27,20:00:00,6,0,6,FMN GV 11 Ramsel
66,Bergstraat 71,2021-02-27,21:00:00,6,2,4,FMN GV 11 Ramsel
66,Bergstraat 71,2021-02-27,22:00:00,2,2,0,FMN GV 11 Ramsel
66,Bergstraat 71,2021-02-27,23:00:00,6,2,4,FMN GV 11 Ramsel
66,Bergstraat 71,2021-02-28,00:00:00,4,4,0,FMN GV 11 Ramsel
66,Bergstraat 71,2021-02-28,01:00:00,0,0,0,FMN GV 11 Ramsel
66,Bergstraat 71,2021-02-28,02:00:00,0,0,0,FMN GV 11 Ramsel
66,Bergstraat 71,2021-02-28,03:00:00,0,0,0,FMN GV 11 Ramsel
66,Bergstraat 71,2021-02-28,04:00:00,0,0,0,FMN GV 11 Ramsel
66,Bergstraat 71,2021-02-28,05:00:00,2,2,0,FMN GV 11 Ramsel
66,Bergstraat 71,2021-02-28,06:00:00,0,0,0,FMN GV 11 Ramsel
66,Bergstraat 71,2021-02-28,07:00:00,12,4,8,FMN GV 11 Ramsel
66,Bergstraat 71,2021-02-28,08:00:00,60,24,36,FMN GV 11 Ramsel
66,Bergstraat 71,2021-02-28,09:00:00,114,26,88,FMN GV 11 Ramsel
66,Bergstraat 71,2021-02-28,10:00:00,178,86,92,FMN GV 11 Ramsel
66,Bergstraat 71,2021-02-28,11:00:00,316,176,140,FMN GV 11 Ramsel
66,Bergstraat 71,2021-02-28,12:00:00,198,94,104,FMN GV 11 Ramsel
66,Bergstraat 71,2021-02-28,13:00:00,270,136,134,FMN GV 11 Ramsel
66,Bergstraat 71,2021-02-28,14:00:00,276,120,156,FMN GV 11 Ramsel
66,Bergstraat 71,2021-02-28,15:00:00,232,106,126,FMN GV 11 Ramsel
66,Bergstraat 71,2021-02-28,16:00:00,184,110,74,FMN GV 11 Ramsel
66,Bergstraat 71,2021-02-28,17:00:00,70,46,24,FMN GV 11 Ramsel
66,Bergstraat 71,2021-02-28,18:00:00,54,20,34,FMN GV 11 Ramsel
66,Bergstraat 71,2021-02-28,19:00:00,8,4,4,FMN GV 11 Ramsel
66,Bergstraat 71,2021-02-28,20:00:00,12,6,6,FMN GV 11 Ramsel
66,Bergstraat 71,2021-02-28,21:00:00,8,8,0,FMN GV 11 Ramsel
66,Bergstraat 71,2021-02-28,22:00:00,0,0,0,FMN GV 11 Ramsel
66,Bergstraat 71,2021-02-28,23:00:00,4,4,0,FMN GV 11 Ramsel
66,Bergstraat 71,2021-03-01,00:00:00,4,4,0,FMN GV 11 Ramsel
66,Bergstraat 71,2021-03-01,01:00:00,0,0,0,FMN GV 11 Ramsel
66,Bergstraat 71,2021-03-01,02:00:00,0,0,0,FMN GV 11 Ramsel
66,Bergstraat 71,2021-03-01,03:00:00,0,0,0,FMN GV 11 Ramsel
66,Bergstraat 71,2021-03-01,04:00:00,4,4,0,FMN GV 11 Ramsel
66,Bergstraat 71,2021-03-01,05:00:00,6,4,2,FMN GV 11 Ramsel
66,Bergstraat 71,2021-03-01,06:00:00,32,10,22,FMN GV 11 Ramsel
66,Bergstraat 71,2021-03-01,07:00:00,184,24,160,FMN GV 11 Ramsel
66,Bergstraat 71,2021-03-01,08:00:00,122,22,100,FMN GV 11 Ramsel
66,Bergstraat 71,2021-03-01,09:00:00,30,8,22,FMN GV 11 Ramsel
66,Bergstraat 71,2021-03-01,10:00:00,32,14,18,FMN GV 11 Ramsel
66,Bergstraat 71,2021-03-01,11:00:00,44,16,28,FMN GV 11 Ramsel
66,Bergstraat 71,2021-03-01,12:00:00,68,32,36,FMN GV 11 Ramsel
66,Bergstraat 71,2021-03-01,13:00:00,110,52,58,FMN GV 11 Ramsel
66,Bergstraat 71,2021-03-01,14:00:00,150,74,76,FMN GV 11 Ramsel
66,Bergstraat 71,2021-03-01,15:00:00,280,226,54,FMN GV 11 Ramsel
66,Bergstraat 71,2021-03-01,16:00:00,166,106,60,FMN GV 11 Ramsel
66,Bergstraat 71,2021-03-01,17:00:00,96,48,48,FMN GV 11 Ramsel
66,Bergstraat 71,2021-03-01,18:00:00,54,40,14,FMN GV 11 Ramsel
66,Bergstraat 71,2021-03-01,19:00:00,28,16,12,FMN GV 11 Ramsel
66,Bergstraat 71,2021-03-01,20:00:00,10,8,2,FMN GV 11 Ramsel
66,Bergstraat 71,2021-03-01,21:00:00,2,2,0,FMN GV 11 Ramsel
66,Bergstraat 71,2021-03-01,22:00:00,8,6,2,FMN GV 11 Ramsel
66,Bergstraat 71,2021-03-01,23:00:00,0,0,0,FMN GV 11 Ramsel
66,Bergstraat 71,2021-03-02,00:00:00,2,0,2,FMN GV 11 Ramsel
66,Bergstraat 71,2021-03-02,01:00:00,0,0,0,FMN GV 11 Ramsel
66,Bergstraat 71,2021-03-02,02:00:00,0,0,0,FMN GV 11 Ramsel
66,Bergstraat 71,2021-03-02,03:00:00,0,0,0,FMN GV 11 Ramsel
66,Bergstraat 71,2021-03-02,04:00:00,4,4,0,FMN GV 11 Ramsel
66,Bergstraat 71,2021-03-02,05:00:00,14,10,4,FMN GV 11 Ramsel
66,Bergstraat 71,2021-03-02,06:00:00,44,14,30,FMN GV 11 Ramsel
66,Bergstraat 71,2021-03-02,07:00:00,190,38,152,FMN GV 11 Ramsel
66,Bergstraat 71,2021-03-02,08:00:00,102,20,82,FMN GV 11 Ramsel
66,Bergstraat 71,2021-03-02,09:00:00,30,18,12,FMN GV 11 Ramsel
66,Bergstraat 71,2021-03-02,10:00:00,72,26,46,FMN GV 11 Ramsel
66,Bergstraat 71,2021-03-02,11:00:00,70,22,48,FMN GV 11 Ramsel
66,Bergstraat 71,2021-03-02,12:00:00,106,56,50,FMN GV 11 Ramsel
66,Bergstraat 71,2021-03-02,13:00:00,318,148,170,FMN GV 11 Ramsel
66,Bergstraat 71,2021-03-02,14:00:00,354,174,180,FMN GV 11 Ramsel
66,Bergstraat 71,2021-03-02,15:00:00,432,310,122,FMN GV 11 Ramsel
66,Bergstraat 71,2021-03-02,16:00:00,262,144,118,FMN GV 11 Ramsel
66,Bergstraat 71,2021-03-02,17:00:00,170,100,70,FMN GV 11 Ramsel
66,Bergstraat 71,2021-03-02,18:00:00,74,36,38,FMN GV 11 Ramsel
66,Bergstraat 71,2021-03-02,19:00:00,50,20,30,FMN GV 11 Ramsel
66,Bergstraat 71,2021-03-02,20:00:00,44,28,16,FMN GV 11 Ramsel
66,Bergstraat 71,2021-03-02,21:00:00,4,2,2,FMN GV 11 Ramsel
66,Bergstraat 71,2021-03-02,22:00:00,16,8,8,FMN GV 11 Ramsel
66,Bergstraat 71,2021-03-02,23:00:00,4,4,0,FMN GV 11 Ramsel
66,Bergstraat 71,2021-03-03,00:00:00,0,0,0,FMN GV 11 Ramsel
66,Bergstraat 71,2021-03-03,01:00:00,0,0,0,FMN GV 11 Ramsel
66,Bergstraat 71,2021-03-03,02:00:00,0,0,0,FMN GV 11 Ramsel
66,Bergstraat 71,2021-03-03,03:00:00,0,0,0,FMN GV 11 Ramsel
66,Bergstraat 71,2021-03-03,04:00:00,4,4,0,FMN GV 11 Ramsel
66,Bergstraat 71,2021-03-03,05:00:00,10,4,6,FMN GV 11 Ramsel
66,Bergstraat 71,2021-03-03,06:00:00,28,12,16,FMN GV 11 Ramsel
66,Bergstraat 71,2021-03-03,07:00:00,188,26,162,FMN GV 11 Ramsel
66,Bergstraat 71,2021-03-03,08:00:00,122,18,104,FMN GV 11 Ramsel
66,Bergstraat 71,2021-03-03,09:00:00,52,16,36,FMN GV 11 Ramsel
66,Bergstraat 71,2021-03-03,10:00:00,106,44,62,FMN GV 11 Ramsel
66,Bergstraat 71,2021-03-03,11:00:00,106,44,62,FMN GV 11 Ramsel
66,Bergstraat 71,2021-03-03,12:00:00,260,196,64,FMN GV 11 Ramsel
66,Bergstraat 71,2021-03-03,13:00:00,344,114,230,FMN GV 11 Ramsel
66,Bergstraat 71,2021-03-03,14:00:00,292,158,134,FMN GV 11 Ramsel
66,Bergstraat 71,2021-03-03,15:00:00,320,172,148,FMN GV 11 Ramsel
66,Bergstraat 71,2021-03-03,16:00:00,310,200,110,FMN GV 11 Ramsel
66,Bergstraat 71,2021-03-03,17:00:00,194,128,66,FMN GV 11 Ramsel
66,Bergstraat 71,2021-03-03,18:00:00,80,56,24,FMN GV 11 Ramsel
66,Bergstraat 71,2021-03-03,19:00:00,52,30,22,FMN GV 11 Ramsel
66,Bergstraat 71,2021-03-03,20:00:00,6,2,4,FMN GV 11 Ramsel
66,Bergstraat 71,2021-03-03,21:00:00,12,10,2,FMN GV 11 Ramsel
66,Bergstraat 71,2021-03-03,22:00:00,14,10,4,FMN GV 11 Ramsel
66,Bergstraat 71,2021-03-03,23:00:00,0,0,0,FMN GV 11 Ramsel
66,Bergstraat 71,2021-03-04,00:00:00,0,0,0,FMN GV 11 Ramsel
66,Bergstraat 71,2021-03-04,01:00:00,0,0,0,FMN GV 11 Ramsel
66,Bergstraat 71,2021-03-04,02:00:00,0,0,0,FMN GV 11 Ramsel
66,Bergstraat 71,2021-03-04,03:00:00,0,0,0,FMN GV 11 Ramsel
66,Bergstraat 71,2021-03-04,04:00:00,0,0,0,FMN GV 11 Ramsel
66,Bergstraat 71,2021-03-04,05:00:00,4,2,2,FMN GV 11 Ramsel
66,Bergstraat 71,2021-03-04,06:00:00,14,4,10,FMN GV 11 Ramsel
66,Bergstraat 71,2021-03-04,07:00:00,60,14,46,FMN GV 11 Ramsel
66,Bergstraat 71,2021-03-04,08:00:00,72,16,56,FMN GV 11 Ramsel
66,Bergstraat 71,2021-03-04,09:00:00,12,4,8,FMN GV 11 Ramsel
66,Bergstraat 71,2021-03-04,10:00:00,16,6,10,FMN GV 11 Ramsel
66,Bergstraat 71,2021-03-04,11:00:00,12,8,4,FMN GV 11 Ramsel
66,Bergstraat 71,2021-03-04,12:00:00,12,6,6,FMN GV 11 Ramsel
66,Bergstraat 71,2021-03-04,13:00:00,16,12,4,FMN GV 11 Ramsel
66,Bergstraat 71,2021-03-04,14:00:00,26,12,14,FMN GV 11 Ramsel
66,Bergstraat 71,2021-03-04,15:00:00,52,38,14,FMN GV 11 Ramsel
66,Bergstraat 71,2021-03-04,16:00:00,56,30,26,FMN GV 11 Ramsel
66,Bergstraat 71,2021-03-04,17:00:00,48,20,28,FMN GV 11 Ramsel
66,Bergstraat 71,2021-03-04,18:00:00,20,10,10,FMN GV 11 Ramsel
66,Bergstraat 71,2021-03-04,19:00:00,8,6,2,FMN GV 11 Ramsel
66,Bergstraat 71,2021-03-04,20:00:00,4,2,2,FMN GV 11 Ramsel
66,Bergstraat 71,2021-03-04,21:00:00,2,0,2,FMN GV 11 Ramsel
66,Bergstraat 71,2021-03-04,22:00:00,4,4,0,FMN GV 11 Ramsel
66,Bergstraat 71,2021-03-04,23:00:00,0,0,0,FMN GV 11 Ramsel
66,Bergstraat 71,2021-03-05,00:00:00,0,0,0,FMN GV 11 Ramsel
66,Bergstraat 71,2021-03-05,01:00:00,0,0,0,FMN GV 11 Ramsel
66,Bergstraat 71,2021-03-05,02:00:00,0,0,0,FMN GV 11 Ramsel
66,Bergstraat 71,2021-03-05,03:00:00,0,0,0,FMN GV 11 Ramsel
66,Bergstraat 71,2021-03-05,04:00:00,4,4,0,FMN GV 11 Ramsel
66,Bergstraat 71,2021-03-05,05:00:00,4,2,2,FMN GV 11 Ramsel
66,Bergstraat 71,2021-03-05,06:00:00,20,8,12,FMN GV 11 Ramsel
66,Bergstraat 71,2021-03-05,07:00:00,126,16,110,FMN GV 11 Ramsel
66,Bergstraat 71,2021-03-05,08:00:00,94,4,90,FMN GV 11 Ramsel
66,Bergstraat 71,2021-03-05,09:00:00,38,16,22,FMN GV 11 Ramsel
66,Bergstraat 71,2021-03-05,10:00:00,38,16,22,FMN GV 11 Ramsel
66,Bergstraat 71,2021-03-05,11:00:00,58,34,24,FMN GV 11 Ramsel
66,Bergstraat 71,2021-03-05,12:00:00,100,54,46,FMN GV 11 Ramsel
66,Bergstraat 71,2021-03-05,13:00:00,106,44,62,FMN GV 11 Ramsel
66,Bergstraat 71,2021-03-05,14:00:00,120,62,58,FMN GV 11 Ramsel
66,Bergstraat 71,2021-03-05,15:00:00,196,156,40,FMN GV 11 Ramsel
66,Bergstraat 71,2021-03-05,16:00:00,134,94,40,FMN GV 11 Ramsel
66,Bergstraat 71,2021-03-05,17:00:00,80,50,30,FMN GV 11 Ramsel
66,Bergstraat 71,2021-03-05,18:00:00,50,34,16,FMN GV 11 Ramsel
66,Bergstraat 71,2021-03-05,19:00:00,12,6,6,FMN GV 11 Ramsel
66,Bergstraat 71,2021-03-05,20:00:00,20,10,10,FMN GV 11 Ramsel
66,Bergstraat 71,2021-03-05,21:00:00,6,0,6,FMN GV 11 Ramsel
66,Bergstraat 71,2021-03-05,22:00:00,6,6,0,FMN GV 11 Ramsel
66,Bergstraat 71,2021-03-05,23:00:00,2,0,2,FMN GV 11 Ramsel
66,Bergstraat 71,2021-03-06,00:00:00,2,2,0,FMN GV 11 Ramsel
66,Bergstraat 71,2021-03-06,01:00:00,0,0,0,FMN GV 11 Ramsel
66,Bergstraat 71,2021-03-06,02:00:00,0,0,0,FMN GV 11 Ramsel
66,Bergstraat 71,2021-03-06,03:00:00,0,0,0,FMN GV 11 Ramsel
66,Bergstraat 71,2021-03-06,04:00:00,0,0,0,FMN GV 11 Ramsel
66,Bergstraat 71,2021-03-06,05:00:00,2,2,0,FMN GV 11 Ramsel
66,Bergstraat 71,2021-03-06,06:00:00,2,0,2,FMN GV 11 Ramsel
66,Bergstraat 71,2021-03-06,07:00:00,6,2,4,FMN GV 11 Ramsel
66,Bergstraat 71,2021-03-06,08:00:00,18,8,10,FMN GV 11 Ramsel
66,Bergstraat 71,2021-03-06,09:00:00,62,24,38,FMN GV 11 Ramsel
66,Bergstraat 71,2021-03-06,10:00:00,112,36,76,FMN GV 11 Ramsel
66,Bergstraat 71,2021-03-06,11:00:00,124,68,56,FMN GV 11 Ramsel
66,Bergstraat 71,2021-03-06,12:00:00,134,66,68,FMN GV 11 Ramsel
66,Bergstraat 71,2021-03-06,13:00:00,172,82,90,FMN GV 11 Ramsel
66,Bergstraat 71,2021-03-06,14:00:00,148,76,72,FMN GV 11 Ramsel
66,Bergstraat 71,2021-03-06,15:00:00,184,114,70,FMN GV 11 Ramsel
66,Bergstraat 71,2021-03-06,16:00:00,90,40,50,FMN GV 11 Ramsel
66,Bergstraat 71,2021-03-06,17:00:00,48,26,22,FMN GV 11 Ramsel
66,Bergstraat 71,2021-03-06,18:00:00,28,16,12,FMN GV 11 Ramsel
66,Bergstraat 71,2021-03-06,19:00:00,4,0,4,FMN GV 11 Ramsel
66,Bergstraat 71,2021-03-06,20:00:00,14,8,6,FMN GV 11 Ramsel
66,Bergstraat 71,2021-03-06,21:00:00,10,4,6,FMN GV 11 Ramsel
66,Bergstraat 71,2021-03-06,22:00:00,0,0,0,FMN GV 11 Ramsel
66,Bergstraat 71,2021-03-06,23:00:00,2,2,0,FMN GV 11 Ramsel
66,Bergstraat 71,2021-03-07,00:00:00,2,2,0,FMN GV 11 Ramsel
66,Bergstraat 71,2021-03-07,01:00:00,0,0,0,FMN GV 11 Ramsel
66,Bergstraat 71,2021-03-07,02:00:00,0,0,0,FMN GV 11 Ramsel
66,Bergstraat 71,2021-03-07,03:00:00,0,0,0,FMN GV 11 Ramsel
66,Bergstraat 71,2021-03-07,04:00:00,0,0,0,FMN GV 11 Ramsel
66,Bergstraat 71,2021-03-07,05:00:00,0,0,0,FMN GV 11 Ramsel
66,Bergstraat 71,2021-03-07,06:00:00,0,0,0,FMN GV 11 Ramsel
66,Bergstraat 71,2021-03-07,07:00:00,10,4,6,FMN GV 11 Ramsel
66,Bergstraat 71,2021-03-07,08:00:00,66,24,42,FMN GV 11 Ramsel
66,Bergstraat 71,2021-03-07,09:00:00,124,42,82,FMN GV 11 Ramsel
66,Bergstraat 71,2021-03-07,10:00:00,148,84,64,FMN GV 11 Ramsel
66,Bergstraat 71,2021-03-07,11:00:00,226,106,120,FMN GV 11 Ramsel
66,Bergstraat 71,2021-03-07,12:00:00,102,66,36,FMN GV 11 Ramsel
66,Bergstraat 71,2021-03-07,13:00:00,202,102,100,FMN GV 11 Ramsel
66,Bergstraat 71,2021-03-07,14:00:00,164,92,72,FMN GV 11 Ramsel
66,Bergstraat 71,2021-03-07,15:00:00,160,98,62,FMN GV 11 Ramsel
66,Bergstraat 71,2021-03-07,16:00:00,108,64,44,FMN GV 11 Ramsel
66,Bergstraat 71,2021-03-07,17:00:00,72,54,18,FMN GV 11 Ramsel
66,Bergstraat 71,2021-03-07,18:00:00,22,4,18,FMN GV 11 Ramsel
66,Bergstraat 71,2021-03-07,19:00:00,8,4,4,FMN GV 11 Ramsel
66,Bergstraat 71,2021-03-07,20:00:00,4,0,4,FMN GV 11 Ramsel
66,Bergstraat 71,2021-03-07,21:00:00,6,6,0,FMN GV 11 Ramsel
66,Bergstraat 71,2021-03-07,22:00:00,0,0,0,FMN GV 11 Ramsel
66,Bergstraat 71,2021-03-07,23:00:00,4,4,0,FMN GV 11 Ramsel
66,Bergstraat 71,2021-03-08,00:00:00,0,0,0,FMN GV 11 Ramsel
66,Bergstraat 71,2021-03-08,01:00:00,0,0,0,FMN GV 11 Ramsel
66,Bergstraat 71,2021-03-08,02:00:00,0,0,0,FMN GV 11 Ramsel
66,Bergstraat 71,2021-03-08,03:00:00,0,0,0,FMN GV 11 Ramsel
66,Bergstraat 71,2021-03-08,04:00:00,2,0,2,FMN GV 11 Ramsel
66,Bergstraat 71,2021-03-08,05:00:00,6,4,2,FMN GV 11 Ramsel
66,Bergstraat 71,2021-03-08,06:00:00,28,12,16,FMN GV 11 Ramsel
66,Bergstraat 71,2021-03-08,07:00:00,120,18,102,FMN GV 11 Ramsel
66,Bergstraat 71,2021-03-08,08:00:00,162,32,130,FMN GV 11 Ramsel
66,Bergstraat 71,2021-03-08,09:00:00,42,12,30,FMN GV 11 Ramsel
66,Bergstraat 71,2021-03-08,10:00:00,64,32,32,FMN GV 11 Ramsel
66,Bergstraat 71,2021-03-08,11:00:00,52,24,28,FMN GV 11 Ramsel
66,Bergstraat 71,2021-03-08,12:00:00,74,26,48,FMN GV 11 Ramsel
66,Bergstraat 71,2021-03-08,13:00:00,192,80,112,FMN GV 11 Ramsel
66,Bergstraat 71,2021-03-08,14:00:00,170,84,86,FMN GV 11 Ramsel
66,Bergstraat 71,2021-03-08,15:00:00,248,196,52,FMN GV 11 Ramsel
66,Bergstraat 71,2021-03-08,16:00:00,182,152,30,FMN GV 11 Ramsel
66,Bergstraat 71,2021-03-08,17:00:00,86,56,30,FMN GV 11 Ramsel
66,Bergstraat 71,2021-03-08,18:00:00,54,32,22,FMN GV 11 Ramsel
66,Bergstraat 71,2021-03-08,19:00:00,10,2,8,FMN GV 11 Ramsel
66,Bergstraat 71,2021-03-08,20:00:00,8,6,2,FMN GV 11 Ramsel
66,Bergstraat 71,2021-03-08,21:00:00,6,6,0,FMN GV 11 Ramsel
66,Bergstraat 71,2021-03-08,22:00:00,10,4,6,FMN GV 11 Ramsel
66,Bergstraat 71,2021-03-08,23:00:00,0,0,0,FMN GV 11 Ramsel
66,Bergstraat 71,2021-03-09,00:00:00,0,0,0,FMN GV 11 Ramsel
66,Bergstraat 71,2021-03-09,01:00:00,0,0,0,FMN GV 11 Ramsel
66,Bergstraat 71,2021-03-09,02:00:00,0,0,0,FMN GV 11 Ramsel
66,Bergstraat 71,2021-03-09,03:00:00,0,0,0,FMN GV 11 Ramsel
66,Bergstraat 71,2021-03-09,04:00:00,2,2,0,FMN GV 11 Ramsel
66,Bergstraat 71,2021-03-09,05:00:00,4,2,2,FMN GV 11 Ramsel
66,Bergstraat 71,2021-03-09,06:00:00,24,10,14,FMN GV 11 Ramsel
66,Bergstraat 71,2021-03-09,07:00:00,118,24,94,FMN GV 11 Ramsel
66,Bergstraat 71,2021-03-09,08:00:00,86,6,80,FMN GV 11 Ramsel
66,Bergstraat 71,2021-03-09,09:00:00,26,12,14,FMN GV 11 Ramsel
66,Bergstraat 71,2021-03-09,10:00:00,32,20,12,FMN GV 11 Ramsel
66,Bergstraat 71,2021-03-09,11:00:00,14,8,6,FMN GV 11 Ramsel
66,Bergstraat 71,2021-03-09,12:00:00,38,16,22,FMN GV 11 Ramsel
66,Bergstraat 71,2021-03-09,13:00:00,100,56,44,FMN GV 11 Ramsel
66,Bergstraat 71,2021-03-09,14:00:00,82,42,40,FMN GV 11 Ramsel
66,Bergstraat 71,2021-03-09,15:00:00,160,124,36,FMN GV 11 Ramsel
66,Bergstraat 71,2021-03-09,16:00:00,98,86,12,FMN GV 11 Ramsel
66,Bergstraat 71,2021-03-09,17:00:00,58,36,22,FMN GV 11 Ramsel
66,Bergstraat 71,2021-03-09,18:00:00,38,18,20,FMN GV 11 Ramsel
66,Bergstraat 71,2021-03-09,19:00:00,32,12,20,FMN GV 11 Ramsel
66,Bergstraat 71,2021-03-09,20:00:00,20,16,4,FMN GV 11 Ramsel
66,Bergstraat 71,2021-03-09,21:00:00,2,2,0,FMN GV 11 Ramsel
66,Bergstraat 71,2021-03-09,22:00:00,10,4,6,FMN GV 11 Ramsel
66,Bergstraat 71,2021-03-09,23:00:00,0,0,0,FMN GV 11 Ramsel
66,Bergstraat 71,2021-03-10,00:00:00,0,0,0,FMN GV 11 Ramsel
66,Bergstraat 71,2021-03-10,01:00:00,0,0,0,FMN GV 11 Ramsel
66,Bergstraat 71,2021-03-10,02:00:00,0,0,0,FMN GV 11 Ramsel
66,Bergstraat 71,2021-03-10,03:00:00,0,0,0,FMN GV 11 Ramsel
66,Bergstraat 71,2021-03-10,04:00:00,4,2,2,FMN GV 11 Ramsel
66,Bergstraat 71,2021-03-10,05:00:00,4,4,0,FMN GV 11 Ramsel
66,Bergstraat 71,2021-03-10,06:00:00,22,4,18,FMN GV 11 Ramsel
66,Bergstraat 71,2021-03-10,07:00:00,144,16,128,FMN GV 11 Ramsel
66,Bergstraat 71,2021-03-10,08:00:00,142,18,124,FMN GV 11 Ramsel
66,Bergstraat 71,2021-03-10,09:00:00,36,8,28,FMN GV 11 Ramsel
66,Bergstraat 71,2021-03-10,10:00:00,78,40,38,FMN GV 11 Ramsel
66,Bergstraat 71,2021-03-10,11:00:00,74,36,38,FMN GV 11 Ramsel
66,Bergstraat 71,2021-03-10,12:00:00,214,166,48,FMN GV 11 Ramsel
66,Bergstraat 71,2021-03-10,13:00:00,116,56,60,FMN GV 11 Ramsel
66,Bergstraat 71,2021-03-10,14:00:00,80,44,36,FMN GV 11 Ramsel
66,Bergstraat 71,2021-03-10,15:00:00,86,64,22,FMN GV 11 Ramsel
66,Bergstraat 71,2021-03-10,16:00:00,72,34,38,FMN GV 11 Ramsel
66,Bergstraat 71,2021-03-10,17:00:00,82,56,26,FMN GV 11 Ramsel
66,Bergstraat 71,2021-03-10,18:00:00,34,18,16,FMN GV 11 Ramsel
66,Bergstraat 71,2021-03-10,19:00:00,8,6,2,FMN GV 11 Ramsel
66,Bergstraat 71,2021-03-10,20:00:00,2,0,2,FMN GV 11 Ramsel
66,Bergstraat 71,2021-03-10,21:00:00,0,0,0,FMN GV 11 Ramsel
66,Bergstraat 71,2021-03-10,22:00:00,14,8,6,FMN GV 11 Ramsel
66,Bergstraat 71,2021-03-10,23:00:00,0,0,0,FMN GV 11 Ramsel
66,Bergstraat 71,2021-03-11,00:00:00,0,0,0,FMN GV 11 Ramsel
66,Bergstraat 71,2021-03-11,01:00:00,0,0,0,FMN GV 11 Ramsel
66,Bergstraat 71,2021-03-11,02:00:00,0,0,0,FMN GV 11 Ramsel
66,Bergstraat 71,2021-03-11,03:00:00,0,0,0,FMN GV 11 Ramsel
66,Bergstraat 71,2021-03-11,04:00:00,0,0,0,FMN GV 11 Ramsel
66,Bergstraat 71,2021-03-11,05:00:00,2,2,0,FMN GV 11 Ramsel
66,Bergstraat 71,2021-03-11,06:00:00,16,4,12,FMN GV 11 Ramsel
66,Bergstraat 71,2021-03-11,07:00:00,48,8,40,FMN GV 11 Ramsel
66,Bergstraat 71,2021-03-11,08:00:00,50,2,48,FMN GV 11 Ramsel
66,Bergstraat 71,2021-03-11,09:00:00,14,4,10,FMN GV 11 Ramsel
66,Bergstraat 71,2021-03-11,10:00:00,4,0,4,FMN GV 11 Ramsel
66,Bergstraat 71,2021-03-11,11:00:00,10,2,8,FMN GV 11 Ramsel
66,Bergstraat 71,2021-03-11,12:00:00,6,4,2,FMN GV 11 Ramsel
66,Bergstraat 71,2021-03-11,13:00:00,10,2,8,FMN GV 11 Ramsel
66,Bergstraat 71,2021-03-11,14:00:00,14,8,6,FMN GV 11 Ramsel
66,Bergstraat 71,2021-03-11,15:00:00,68,64,4,FMN GV 11 Ramsel
66,Bergstraat 71,2021-03-11,16:00:00,44,34,10,FMN GV 11 Ramsel
66,Bergstraat 71,2021-03-11,17:00:00,18,10,8,FMN GV 11 Ramsel
66,Bergstraat 71,2021-03-11,18:00:00,24,14,10,FMN GV 11 Ramsel
66,Bergstraat 71,2021-03-11,19:00:00,18,6,12,FMN GV 11 Ramsel
66,Bergstraat 71,2021-03-11,20:00:00,4,2,2,FMN GV 11 Ramsel
66,Bergstraat 71,2021-03-11,21:00:00,2,2,0,FMN GV 11 Ramsel
66,Bergstraat 71,2021-03-11,22:00:00,6,4,2,FMN GV 11 Ramsel
66,Bergstraat 71,2021-03-11,23:00:00,0,0,0,FMN GV 11 Ramsel
66,Bergstraat 71,2021-03-12,00:00:00,0,0,0,FMN GV 11 Ramsel
66,Bergstraat 71,2021-03-12,01:00:00,0,0,0,FMN GV 11 Ramsel
66,Bergstraat 71,2021-03-12,02:00:00,0,0,0,FMN GV 11 Ramsel
66,Bergstraat 71,2021-03-12,03:00:00,0,0,0,FMN GV 11 Ramsel
66,Bergstraat 71,2021-03-12,04:00:00,0,0,0,FMN GV 11 Ramsel
66,Bergstraat 71,2021-03-12,05:00:00,2,2,0,FMN GV 11 Ramsel
66,Bergstraat 71,2021-03-12,06:00:00,18,8,10,FMN GV 11 Ramsel
66,Bergstraat 71,2021-03-12,07:00:00,94,10,84,FMN GV 11 Ramsel
66,Bergstraat 71,2021-03-12,08:00:00,90,14,76,FMN GV 11 Ramsel
66,Bergstraat 71,2021-03-12,09:00:00,56,14,42,FMN GV 11 Ramsel
66,Bergstraat 71,2021-03-12,10:00:00,28,16,12,FMN GV 11 Ramsel
66,Bergstraat 71,2021-03-12,11:00:00,26,14,12,FMN GV 11 Ramsel
66,Bergstraat 71,2021-03-12,12:00:00,36,24,12,FMN GV 11 Ramsel
66,Bergstraat 71,2021-03-12,13:00:00,44,22,22,FMN GV 11 Ramsel
66,Bergstraat 71,2021-03-12,14:00:00,52,24,28,FMN GV 11 Ramsel
66,Bergstraat 71,2021-03-12,15:00:00,120,94,26,FMN GV 11 Ramsel
66,Bergstraat 71,2021-03-12,16:00:00,68,54,14,FMN GV 11 Ramsel
66,Bergstraat 71,2021-03-12,17:00:00,34,22,12,FMN GV 11 Ramsel
66,Bergstraat 71,2021-03-12,18:00:00,24,16,8,FMN GV 11 Ramsel
66,Bergstraat 71,2021-03-12,19:00:00,10,4,6,FMN GV 11 Ramsel
66,Bergstraat 71,2021-03-12,20:00:00,12,4,8,FMN GV 11 Ramsel
66,Bergstraat 71,2021-03-12,21:00:00,4,4,0,FMN GV 11 Ramsel
66,Bergstraat 71,2021-03-12,22:00:00,2,2,0,FMN GV 11 Ramsel
66,Bergstraat 71,2021-03-12,23:00:00,12,4,8,FMN GV 11 Ramsel
66,Bergstraat 71,2021-03-13,00:00:00,0,0,0,FMN GV 11 Ramsel
66,Bergstraat 71,2021-03-13,01:00:00,2,0,2,FMN GV 11 Ramsel
66,Bergstraat 71,2021-03-13,02:00:00,0,0,0,FMN GV 11 Ramsel
66,Bergstraat 71,2021-03-13,03:00:00,4,4,0,FMN GV 11 Ramsel
66,Bergstraat 71,2021-03-13,04:00:00,0,0,0,FMN GV 11 Ramsel
66,Bergstraat 71,2021-03-13,05:00:00,0,0,0,FMN GV 11 Ramsel
66,Bergstraat 71,2021-03-13,06:00:00,2,0,2,FMN GV 11 Ramsel
66,Bergstraat 71,2021-03-13,07:00:00,2,2,0,FMN GV 11 Ramsel
66,Bergstraat 71,2021-03-13,08:00:00,14,10,4,FMN GV 11 Ramsel
66,Bergstraat 71,2021-03-13,09:00:00,26,12,14,FMN GV 11 Ramsel
66,Bergstraat 71,2021-03-13,10:00:00,34,20,14,FMN GV 11 Ramsel
66,Bergstraat 71,2021-03-13,11:00:00,38,20,18,FMN GV 11 Ramsel
66,Bergstraat 71,2021-03-13,12:00:00,28,12,16,FMN GV 11 Ramsel
66,Bergstraat 71,2021-03-13,13:00:00,66,26,40,FMN GV 11 Ramsel
66,Bergstraat 71,2021-03-13,14:00:00,36,12,24,FMN GV 11 Ramsel
66,Bergstraat 71,2021-03-13,15:00:00,20,6,14,FMN GV 11 Ramsel
66,Bergstraat 71,2021-03-13,16:00:00,32,20,12,FMN GV 11 Ramsel
66,Bergstraat 71,2021-03-13,17:00:00,18,8,10,FMN GV 11 Ramsel
66,Bergstraat 71,2021-03-13,18:00:00,8,4,4,FMN GV 11 Ramsel
66,Bergstraat 71,2021-03-13,19:00:00,8,2,6,FMN GV 11 Ramsel
66,Bergstraat 71,2021-03-13,20:00:00,10,6,4,FMN GV 11 Ramsel
66,Bergstraat 71,2021-03-13,21:00:00,2,2,0,FMN GV 11 Ramsel
66,Bergstraat 71,2021-03-13,22:00:00,0,0,0,FMN GV 11 Ramsel
66,Bergstraat 71,2021-03-13,23:00:00,14,6,8,FMN GV 11 Ramsel
66,Bergstraat 71,2021-03-14,00:00:00,6,4,2,FMN GV 11 Ramsel
66,Bergstraat 71,2021-03-14,01:00:00,2,0,2,FMN GV 11 Ramsel
66,Bergstraat 71,2021-03-14,02:00:00,0,0,0,FMN GV 11 Ramsel
66,Bergstraat 71,2021-03-14,03:00:00,0,0,0,FMN GV 11 Ramsel
66,Bergstraat 71,2021-03-14,04:00:00,0,0,0,FMN GV 11 Ramsel
66,Bergstraat 71,2021-03-14,05:00:00,0,0,0,FMN GV 11 Ramsel
66,Bergstraat 71,2021-03-14,06:00:00,0,0,0,FMN GV 11 Ramsel
66,Bergstraat 71,2021-03-14,07:00:00,14,2,12,FMN GV 11 Ramsel
66,Bergstraat 71,2021-03-14,08:00:00,74,12,62,FMN GV 11 Ramsel
66,Bergstraat 71,2021-03-14,09:00:00,84,30,54,FMN GV 11 Ramsel
66,Bergstraat 71,2021-03-14,10:00:00,50,20,30,FMN GV 11 Ramsel
66,Bergstraat 71,2021-03-14,11:00:00,108,74,34,FMN GV 11 Ramsel
66,Bergstraat 71,2021-03-14,12:00:00,62,36,26,FMN GV 11 Ramsel
66,Bergstraat 71,2021-03-14,13:00:00,76,34,42,FMN GV 11 Ramsel
66,Bergstraat 71,2021-03-14,14:00:00,76,58,18,FMN GV 11 Ramsel
66,Bergstraat 71,2021-03-14,15:00:00,70,44,26,FMN GV 11 Ramsel
66,Bergstraat 71,2021-03-14,16:00:00,74,34,40,FMN GV 11 Ramsel
66,Bergstraat 71,2021-03-14,17:00:00,54,34,20,FMN GV 11 Ramsel
66,Bergstraat 71,2021-03-14,18:00:00,28,14,14,FMN GV 11 Ramsel
66,Bergstraat 71,2021-03-14,19:00:00,6,2,4,FMN GV 11 Ramsel
66,Bergstraat 71,2021-03-14,20:00:00,12,6,6,FMN GV 11 Ramsel
66,Bergstraat 71,2021-03-14,21:00:00,2,0,2,FMN GV 11 Ramsel
66,Bergstraat 71,2021-03-14,22:00:00,4,2,2,FMN GV 11 Ramsel
66,Bergstraat 71,2021-03-14,23:00:00,0,0,0,FMN GV 11 Ramsel
66,Bergstraat 71,2021-03-15,00:00:00,0,0,0,FMN GV 11 Ramsel
66,Bergstraat 71,2021-03-15,01:00:00,0,0,0,FMN GV 11 Ramsel
66,Bergstraat 71,2021-03-15,02:00:00,0,0,0,FMN GV 11 Ramsel
66,Bergstraat 71,2021-03-15,03:00:00,0,0,0,FMN GV 11 Ramsel
66,Bergstraat 71,2021-03-15,04:00:00,2,2,0,FMN GV 11 Ramsel
66,Bergstraat 71,2021-03-15,05:00:00,12,6,6,FMN GV 11 Ramsel
66,Bergstraat 71,2021-03-15,06:00:00,28,10,18,FMN GV 11 Ramsel
66,Bergstraat 71,2021-03-15,07:00:00,142,16,126,FMN GV 11 Ramsel
66,Bergstraat 71,2021-03-15,08:00:00,76,8,68,FMN GV 11 Ramsel
66,Bergstraat 71,2021-03-15,09:00:00,18,6,12,FMN GV 11 Ramsel
66,Bergstraat 71,2021-03-15,10:00:00,26,8,18,FMN GV 11 Ramsel
66,Bergstraat 71,2021-03-15,11:00:00,24,14,10,FMN GV 11 Ramsel
66,Bergstraat 71,2021-03-15,12:00:00,26,6,20,FMN GV 11 Ramsel
66,Bergstraat 71,2021-03-15,13:00:00,42,20,22,FMN GV 11 Ramsel
66,Bergstraat 71,2021-03-15,14:00:00,44,30,14,FMN GV 11 Ramsel
66,Bergstraat 71,2021-03-15,15:00:00,114,94,20,FMN GV 11 Ramsel
66,Bergstraat 71,2021-03-15,16:00:00,130,100,30,FMN GV 11 Ramsel
66,Bergstraat 71,2021-03-15,17:00:00,48,32,16,FMN GV 11 Ramsel
66,Bergstraat 71,2021-03-15,18:00:00,12,10,2,FMN GV 11 Ramsel
66,Bergstraat 71,2021-03-15,19:00:00,18,10,8,FMN GV 11 Ramsel
66,Bergstraat 71,2021-03-15,20:00:00,8,4,4,FMN GV 11 Ramsel
66,Bergstraat 71,2021-03-15,21:00:00,6,0,6,FMN GV 11 Ramsel
66,Bergstraat 71,2021-03-15,22:00:00,10,8,2,FMN GV 11 Ramsel
66,Bergstraat 71,2021-03-15,23:00:00,0,0,0,FMN GV 11 Ramsel
66,Bergstraat 71,2021-03-16,00:00:00,0,0,0,FMN GV 11 Ramsel
66,Bergstraat 71,2021-03-16,01:00:00,0,0,0,FMN GV 11 Ramsel
66,Bergstraat 71,2021-03-16,02:00:00,0,0,0,FMN GV 11 Ramsel
66,Bergstraat 71,2021-03-16,03:00:00,0,0,0,FMN GV 11 Ramsel
66,Bergstraat 71,2021-03-16,04:00:00,2,2,0,FMN GV 11 Ramsel
66,Bergstraat 71,2021-03-16,05:00:00,12,8,4,FMN GV 11 Ramsel
66,Bergstraat 71,2021-03-16,06:00:00,30,8,22,FMN GV 11 Ramsel
66,Bergstraat 71,2021-03-16,07:00:00,104,12,92,FMN GV 11 Ramsel
66,Bergstraat 71,2021-03-16,08:00:00,96,12,84,FMN GV 11 Ramsel
66,Bergstraat 71,2021-03-16,09:00:00,28,14,14,FMN GV 11 Ramsel
66,Bergstraat 71,2021-03-16,10:00:00,8,6,2,FMN GV 11 Ramsel
66,Bergstraat 71,2021-03-16,11:00:00,20,12,8,FMN GV 11 Ramsel
66,Bergstraat 71,2021-03-16,12:00:00,16,14,2,FMN GV 11 Ramsel
66,Bergstraat 71,2021-03-16,13:00:00,32,10,22,FMN GV 11 Ramsel
66,Bergstraat 71,2021-03-16,14:00:00,28,18,10,FMN GV 11 Ramsel
66,Bergstraat 71,2021-03-16,15:00:00,112,106,6,FMN GV 11 Ramsel
66,Bergstraat 71,2021-03-16,16:00:00,60,42,18,FMN GV 11 Ramsel
66,Bergstraat 71,2021-03-16,17:00:00,30,18,12,FMN GV 11 Ramsel
66,Bergstraat 71,2021-03-16,18:00:00,14,6,8,FMN GV 11 Ramsel
66,Bergstraat 71,2021-03-16,19:00:00,12,6,6,FMN GV 11 Ramsel
66,Bergstraat 71,2021-03-16,20:00:00,10,4,6,FMN GV 11 Ramsel
66,Bergstraat 71,2021-03-16,21:00:00,4,0,4,FMN GV 11 Ramsel
66,Bergstraat 71,2021-03-16,22:00:00,6,4,2,FMN GV 11 Ramsel
66,Bergstraat 71,2021-03-16,23:00:00,0,0,0,FMN GV 11 Ramsel
66,Bergstraat 71,2021-03-17,00:00:00,0,0,0,FMN GV 11 Ramsel
66,Bergstraat 71,2021-03-17,01:00:00,0,0,0,FMN GV 11 Ramsel
66,Bergstraat 71,2021-03-17,02:00:00,0,0,0,FMN GV 11 Ramsel
66,Bergstraat 71,2021-03-17,03:00:00,0,0,0,FMN GV 11 Ramsel
66,Bergstraat 71,2021-03-17,04:00:00,2,2,0,FMN GV 11 Ramsel
66,Bergstraat 71,2021-03-17,05:00:00,4,2,2,FMN GV 11 Ramsel
66,Bergstraat 71,2021-03-17,06:00:00,24,8,16,FMN GV 11 Ramsel
66,Bergstraat 71,2021-03-17,07:00:00,128,10,118,FMN GV 11 Ramsel
66,Bergstraat 71,2021-03-17,08:00:00,90,14,76,FMN GV 11 Ramsel
66,Bergstraat 71,2021-03-17,09:00:00,34,18,16,FMN GV 11 Ramsel
66,Bergstraat 71,2021-03-17,10:00:00,26,14,12,FMN GV 11 Ramsel
66,Bergstraat 71,2021-03-17,11:00:00,42,34,8,FMN GV 11 Ramsel
66,Bergstraat 71,2021-03-17,12:00:00,164,138,26,FMN GV 11 Ramsel
66,Bergstraat 71,2021-03-17,13:00:00,80,34,46,FMN GV 11 Ramsel
66,Bergstraat 71,2021-03-17,14:00:00,82,38,44,FMN GV 11 Ramsel
66,Bergstraat 71,2021-03-17,15:00:00,50,34,16,FMN GV 11 Ramsel
66,Bergstraat 71,2021-03-17,16:00:00,80,48,32,FMN GV 11 Ramsel
66,Bergstraat 71,2021-03-17,17:00:00,62,40,22,FMN GV 11 Ramsel
66,Bergstraat 71,2021-03-17,18:00:00,50,32,18,FMN GV 11 Ramsel
66,Bergstraat 71,2021-03-17,19:00:00,30,4,26,FMN GV 11 Ramsel
66,Bergstraat 71,2021-03-17,20:00:00,14,6,8,FMN GV 11 Ramsel
66,Bergstraat 71,2021-03-17,21:00:00,4,4,0,FMN GV 11 Ramsel
66,Bergstraat 71,2021-03-17,22:00:00,8,8,0,FMN GV 11 Ramsel
66,Bergstraat 71,2021-03-17,23:00:00,0,0,0,FMN GV 11 Ramsel
66,Bergstraat 71,2021-03-18,00:00:00,0,0,0,FMN GV 11 Ramsel
66,Bergstraat 71,2021-03-18,01:00:00,0,0,0,FMN GV 11 Ramsel
66,Bergstraat 71,2021-03-18,02:00:00,0,0,0,FMN GV 11 Ramsel
66,Bergstraat 71,2021-03-18,03:00:00,0,0,0,FMN GV 11 Ramsel
66,Bergstraat 71,2021-03-18,04:00:00,0,0,0,FMN GV 11 Ramsel
66,Bergstraat 71,2021-03-18,05:00:00,6,6,0,FMN GV 11 Ramsel
66,Bergstraat 71,2021-03-18,06:00:00,28,10,18,FMN GV 11 Ramsel
66,Bergstraat 71,2021-03-18,07:00:00,116,10,106,FMN GV 11 Ramsel
66,Bergstraat 71,2021-03-18,08:00:00,114,20,94,FMN GV 11 Ramsel
66,Bergstraat 71,2021-03-18,09:00:00,38,8,30,FMN GV 11 Ramsel
66,Bergstraat 71,2021-03-18,10:00:00,50,28,22,FMN GV 11 Ramsel
66,Bergstraat 71,2021-03-18,11:00:00,34,22,12,FMN GV 11 Ramsel
66,Bergstraat 71,2021-03-18,12:00:00,78,40,38,FMN GV 11 Ramsel
66,Bergstraat 71,2021-03-18,13:00:00,92,44,48,FMN GV 11 Ramsel
66,Bergstraat 71,2021-03-18,14:00:00,72,46,26,FMN GV 11 Ramsel
66,Bergstraat 71,2021-03-18,15:00:00,140,100,40,FMN GV 11 Ramsel
66,Bergstraat 71,2021-03-18,16:00:00,88,68,20,FMN GV 11 Ramsel
66,Bergstraat 71,2021-03-18,17:00:00,44,28,16,FMN GV 11 Ramsel
66,Bergstraat 71,2021-03-18,18:00:00,24,10,14,FMN GV 11 Ramsel
66,Bergstraat 71,2021-03-18,19:00:00,14,8,6,FMN GV 11 Ramsel
66,Bergstraat 71,2021-03-18,20:00:00,10,2,8,FMN GV 11 Ramsel
66,Bergstraat 71,2021-03-18,21:00:00,2,0,2,FMN GV 11 Ramsel
66,Bergstraat 71,2021-03-18,22:00:00,12,10,2,FMN GV 11 Ramsel
66,Bergstraat 71,2021-03-18,23:00:00,0,0,0,FMN GV 11 Ramsel
66,Bergstraat 71,2021-03-19,00:00:00,0,0,0,FMN GV 11 Ramsel
66,Bergstraat 71,2021-03-19,01:00:00,0,0,0,FMN GV 11 Ramsel
66,Bergstraat 71,2021-03-19,02:00:00,0,0,0,FMN GV 11 Ramsel
66,Bergstraat 71,2021-03-19,03:00:00,0,0,0,FMN GV 11 Ramsel
66,Bergstraat 71,2021-03-19,04:00:00,4,4,0,FMN GV 11 Ramsel
66,Bergstraat 71,2021-03-19,05:00:00,6,2,4,FMN GV 11 Ramsel
66,Bergstraat 71,2021-03-19,06:00:00,16,4,12,FMN GV 11 Ramsel
66,Bergstraat 71,2021-03-19,07:00:00,116,16,100,FMN GV 11 Ramsel
66,Bergstraat 71,2021-03-19,08:00:00,90,6,84,FMN GV 11 Ramsel
66,Bergstraat 71,2021-03-19,09:00:00,36,14,22,FMN GV 11 Ramsel
66,Bergstraat 71,2021-03-19,10:00:00,70,34,36,FMN GV 11 Ramsel
66,Bergstraat 71,2021-03-19,11:00:00,74,42,32,FMN GV 11 Ramsel
66,Bergstraat 71,2021-03-19,12:00:00,84,46,38,FMN GV 11 Ramsel
66,Bergstraat 71,2021-03-19,13:00:00,134,62,72,FMN GV 11 Ramsel
66,Bergstraat 71,2021-03-19,14:00:00,134,72,62,FMN GV 11 Ramsel
66,Bergstraat 71,2021-03-19,15:00:00,166,124,42,FMN GV 11 Ramsel
66,Bergstraat 71,2021-03-19,16:00:00,184,122,62,FMN GV 11 Ramsel
66,Bergstraat 71,2021-03-19,17:00:00,78,50,28,FMN GV 11 Ramsel
66,Bergstraat 71,2021-03-19,18:00:00,62,36,26,FMN GV 11 Ramsel
66,Bergstraat 71,2021-03-19,19:00:00,14,2,12,FMN GV 11 Ramsel
66,Bergstraat 71,2021-03-19,20:00:00,8,0,8,FMN GV 11 Ramsel
66,Bergstraat 71,2021-03-19,21:00:00,4,2,2,FMN GV 11 Ramsel
66,Bergstraat 71,2021-03-19,22:00:00,6,6,0,FMN GV 11 Ramsel
66,Bergstraat 71,2021-03-19,23:00:00,8,4,4,FMN GV 11 Ramsel
66,Bergstraat 71,2021-03-20,00:00:00,2,2,0,FMN GV 11 Ramsel
66,Bergstraat 71,2021-03-20,01:00:00,0,0,0,FMN GV 11 Ramsel
66,Bergstraat 71,2021-03-20,02:00:00,0,0,0,FMN GV 11 Ramsel
66,Bergstraat 71,2021-03-20,03:00:00,0,0,0,FMN GV 11 Ramsel
66,Bergstraat 71,2021-03-20,04:00:00,0,0,0,FMN GV 11 Ramsel
66,Bergstraat 71,2021-03-20,05:00:00,2,2,0,FMN GV 11 Ramsel
66,Bergstraat 71,2021-03-20,06:00:00,2,0,2,FMN GV 11 Ramsel
66,Bergstraat 71,2021-03-20,07:00:00,10,6,4,FMN GV 11 Ramsel
66,Bergstraat 71,2021-03-20,08:00:00,42,12,30,FMN GV 11 Ramsel
66,Bergstraat 71,2021-03-20,09:00:00,54,22,32,FMN GV 11 Ramsel
66,Bergstraat 71,2021-03-20,10:00:00,128,46,82,FMN GV 11 Ramsel
66,Bergstraat 71,2021-03-20,11:00:00,162,64,98,FMN GV 11 Ramsel
66,Bergstraat 71,2021-03-20,12:00:00,144,78,66,FMN GV 11 Ramsel
66,Bergstraat 71,2021-03-20,13:00:00,292,122,170,FMN GV 11 Ramsel
66,Bergstraat 71,2021-03-20,14:00:00,322,158,164,FMN GV 11 Ramsel
66,Bergstraat 71,2021-03-20,15:00:00,206,128,78,FMN GV 11 Ramsel
66,Bergstraat 71,2021-03-20,16:00:00,106,64,42,FMN GV 11 Ramsel
66,Bergstraat 71,2021-03-20,17:00:00,100,58,42,FMN GV 11 Ramsel
66,Bergstraat 71,2021-03-20,18:00:00,44,34,10,FMN GV 11 Ramsel
66,Bergstraat 71,2021-03-20,19:00:00,22,12,10,FMN GV 11 Ramsel
66,Bergstraat 71,2021-03-20,20:00:00,22,12,10,FMN GV 11 Ramsel
66,Bergstraat 71,2021-03-20,21:00:00,20,8,12,FMN GV 11 Ramsel
66,Bergstraat 71,2021-03-20,22:00:00,4,4,0,FMN GV 11 Ramsel
66,Bergstraat 71,2021-03-20,23:00:00,8,0,8,FMN GV 11 Ramsel
66,Bergstraat 71,2021-03-21,00:00:00,2,2,0,FMN GV 11 Ramsel
66,Bergstraat 71,2021-03-21,01:00:00,0,0,0,FMN GV 11 Ramsel
66,Bergstraat 71,2021-03-21,02:00:00,0,0,0,FMN GV 11 Ramsel
66,Bergstraat 71,2021-03-21,03:00:00,0,0,0,FMN GV 11 Ramsel
66,Bergstraat 71,2021-03-21,04:00:00,0,0,0,FMN GV 11 Ramsel
66,Bergstraat 71,2021-03-21,05:00:00,2,2,0,FMN GV 11 Ramsel
66,Bergstraat 71,2021-03-21,06:00:00,8,0,8,FMN GV 11 Ramsel
66,Bergstraat 71,2021-03-21,07:00:00,6,2,4,FMN GV 11 Ramsel
66,Bergstraat 71,2021-03-21,08:00:00,70,16,54,FMN GV 11 Ramsel
66,Bergstraat 71,2021-03-21,09:00:00,78,32,46,FMN GV 11 Ramsel
66,Bergstraat 71,2021-03-21,10:00:00,262,152,110,FMN GV 11 Ramsel
66,Bergstraat 71,2021-03-21,11:00:00,198,136,62,FMN GV 11 Ramsel
66,Bergstraat 71,2021-03-21,12:00:00,118,60,58,FMN GV 11 Ramsel
66,Bergstraat 71,2021-03-21,13:00:00,138,66,72,FMN GV 11 Ramsel
66,Bergstraat 71,2021-03-21,14:00:00,188,100,88,FMN GV 11 Ramsel
66,Bergstraat 71,2021-03-21,15:00:00,108,62,46,FMN GV 11 Ramsel
66,Bergstraat 71,2021-03-21,16:00:00,120,52,68,FMN GV 11 Ramsel
66,Bergstraat 71,2021-03-21,17:00:00,42,24,18,FMN GV 11 Ramsel
66,Bergstraat 71,2021-03-21,18:00:00,30,10,20,FMN GV 11 Ramsel
66,Bergstraat 71,2021-03-21,19:00:00,12,2,10,FMN GV 11 Ramsel
66,Bergstraat 71,2021-03-21,20:00:00,8,6,2,FMN GV 11 Ramsel
66,Bergstraat 71,2021-03-21,21:00:00,2,0,2,FMN GV 11 Ramsel
66,Bergstraat 71,2021-03-21,22:00:00,0,0,0,FMN GV 11 Ramsel
66,Bergstraat 71,2021-03-21,23:00:00,2,2,0,FMN GV 11 Ramsel
66,Bergstraat 71,2021-03-22,00:00:00,0,0,0,FMN GV 11 Ramsel
66,Bergstraat 71,2021-03-22,01:00:00,0,0,0,FMN GV 11 Ramsel
66,Bergstraat 71,2021-03-22,02:00:00,0,0,0,FMN GV 11 Ramsel
66,Bergstraat 71,2021-03-22,03:00:00,0,0,0,FMN GV 11 Ramsel
66,Bergstraat 71,2021-03-22,04:00:00,4,4,0,FMN GV 11 Ramsel
66,Bergstraat 71,2021-03-22,05:00:00,4,0,4,FMN GV 11 Ramsel
66,Bergstraat 71,2021-03-22,06:00:00,26,12,14,FMN GV 11 Ramsel
66,Bergstraat 71,2021-03-22,07:00:00,118,18,100,FMN GV 11 Ramsel
66,Bergstraat 71,2021-03-22,08:00:00,122,18,104,FMN GV 11 Ramsel
66,Bergstraat 71,2021-03-22,09:00:00,46,20,26,FMN GV 11 Ramsel
66,Bergstraat 71,2021-03-22,10:00:00,40,14,26,FMN GV 11 Ramsel
66,Bergstraat 71,2021-03-22,11:00:00,34,18,16,FMN GV 11 Ramsel
66,Bergstraat 71,2021-03-22,12:00:00,42,18,24,FMN GV 11 Ramsel
66,Bergstraat 71,2021-03-22,13:00:00,88,32,56,FMN GV 11 Ramsel
66,Bergstraat 71,2021-03-22,14:00:00,156,96,60,FMN GV 11 Ramsel
66,Bergstraat 71,2021-03-22,15:00:00,170,138,32,FMN GV 11 Ramsel
66,Bergstraat 71,2021-03-22,16:00:00,86,74,12,FMN GV 11 Ramsel
66,Bergstraat 71,2021-03-22,17:00:00,76,50,26,FMN GV 11 Ramsel
66,Bergstraat 71,2021-03-22,18:00:00,40,26,14,FMN GV 11 Ramsel
66,Bergstraat 71,2021-03-22,19:00:00,12,10,2,FMN GV 11 Ramsel
66,Bergstraat 71,2021-03-22,20:00:00,10,8,2,FMN GV 11 Ramsel
66,Bergstraat 71,2021-03-22,21:00:00,6,4,2,FMN GV 11 Ramsel
66,Bergstraat 71,2021-03-22,22:00:00,6,4,2,FMN GV 11 Ramsel
66,Bergstraat 71,2021-03-22,23:00:00,0,0,0,FMN GV 11 Ramsel
66,Bergstraat 71,2021-03-23,00:00:00,0,0,0,FMN GV 11 Ramsel
66,Bergstraat 71,2021-03-23,01:00:00,0,0,0,FMN GV 11 Ramsel
66,Bergstraat 71,2021-03-23,02:00:00,0,0,0,FMN GV 11 Ramsel
66,Bergstraat 71,2021-03-23,03:00:00,0,0,0,FMN GV 11 Ramsel
66,Bergstraat 71,2021-03-23,04:00:00,4,4,0,FMN GV 11 Ramsel
66,Bergstraat 71,2021-03-23,05:00:00,10,4,6,FMN GV 11 Ramsel
66,Bergstraat 71,2021-03-23,06:00:00,36,12,24,FMN GV 11 Ramsel
66,Bergstraat 71,2021-03-23,07:00:00,154,20,134,FMN GV 11 Ramsel
66,Bergstraat 71,2021-03-23,08:00:00,156,18,138,FMN GV 11 Ramsel
66,Bergstraat 71,2021-03-23,09:00:00,44,10,34,FMN GV 11 Ramsel
66,Bergstraat 71,2021-03-23,10:00:00,72,22,50,FMN GV 11 Ramsel
66,Bergstraat 71,2021-03-23,11:00:00,52,18,34,FMN GV 11 Ramsel
66,Bergstraat 71,2021-03-23,12:00:00,124,70,54,FMN GV 11 Ramsel
66,Bergstraat 71,2021-03-23,13:00:00,186,90,96,FMN GV 11 Ramsel
66,Bergstraat 71,2021-03-23,14:00:00,220,148,72,FMN GV 11 Ramsel
66,Bergstraat 71,2021-03-23,15:00:00,338,242,96,FMN GV 11 Ramsel
66,Bergstraat 71,2021-03-23,16:00:00,200,142,58,FMN GV 11 Ramsel
66,Bergstraat 71,2021-03-23,17:00:00,114,58,56,FMN GV 11 Ramsel
66,Bergstraat 71,2021-03-23,18:00:00,56,38,18,FMN GV 11 Ramsel
66,Bergstraat 71,2021-03-23,19:00:00,38,10,28,FMN GV 11 Ramsel
66,Bergstraat 71,2021-03-23,20:00:00,22,16,6,FMN GV 11 Ramsel
66,Bergstraat 71,2021-03-23,21:00:00,10,6,4,FMN GV 11 Ramsel
66,Bergstraat 71,2021-03-23,22:00:00,8,4,4,FMN GV 11 Ramsel
66,Bergstraat 71,2021-03-23,23:00:00,4,4,0,FMN GV 11 Ramsel
66,Bergstraat 71,2021-03-24,00:00:00,0,0,0,FMN GV 11 Ramsel
66,Bergstraat 71,2021-03-24,01:00:00,0,0,0,FMN GV 11 Ramsel
66,Bergstraat 71,2021-03-24,02:00:00,0,0,0,FMN GV 11 Ramsel
66,Bergstraat 71,2021-03-24,03:00:00,0,0,0,FMN GV 11 Ramsel
66,Bergstraat 71,2021-03-24,04:00:00,4,4,0,FMN GV 11 Ramsel
66,Bergstraat 71,2021-03-24,05:00:00,10,6,4,FMN GV 11 Ramsel
66,Bergstraat 71,2021-03-24,06:00:00,26,8,18,FMN GV 11 Ramsel
66,Bergstraat 71,2021-03-24,07:00:00,134,22,112,FMN GV 11 Ramsel
66,Bergstraat 71,2021-03-24,08:00:00,158,24,134,FMN GV 11 Ramsel
66,Bergstraat 71,2021-03-24,09:00:00,68,20,48,FMN GV 11 Ramsel
66,Bergstraat 71,2021-03-24,10:00:00,98,42,56,FMN GV 11 Ramsel
66,Bergstraat 71,2021-03-24,11:00:00,136,98,38,FMN GV 11 Ramsel
66,Bergstraat 71,2021-03-24,12:00:00,256,206,50,FMN GV 11 Ramsel
66,Bergstraat 71,2021-03-24,13:00:00,288,134,154,FMN GV 11 Ramsel
66,Bergstraat 71,2021-03-24,14:00:00,288,134,154,FMN GV 11 Ramsel
66,Bergstraat 71,2021-03-24,15:00:00,230,116,114,FMN GV 11 Ramsel
66,Bergstraat 71,2021-03-24,16:00:00,200,122,78,FMN GV 11 Ramsel
66,Bergstraat 71,2021-03-24,17:00:00,166,102,64,FMN GV 11 Ramsel
66,Bergstraat 71,2021-03-24,18:00:00,118,68,50,FMN GV 11 Ramsel
66,Bergstraat 71,2021-03-24,19:00:00,40,26,14,FMN GV 11 Ramsel
66,Bergstraat 71,2021-03-24,20:00:00,10,6,4,FMN GV 11 Ramsel
66,Bergstraat 71,2021-03-24,21:00:00,8,6,2,FMN GV 11 Ramsel
66,Bergstraat 71,2021-03-24,22:00:00,10,8,2,FMN GV 11 Ramsel
66,Bergstraat 71,2021-03-24,23:00:00,0,0,0,FMN GV 11 Ramsel
66,Bergstraat 71,2021-03-25,00:00:00,2,0,2,FMN GV 11 Ramsel
66,Bergstraat 71,2021-03-25,01:00:00,0,0,0,FMN GV 11 Ramsel
66,Bergstraat 71,2021-03-25,02:00:00,0,0,0,FMN GV 11 Ramsel
66,Bergstraat 71,2021-03-25,03:00:00,0,0,0,FMN GV 11 Ramsel
66,Bergstraat 71,2021-03-25,04:00:00,4,4,0,FMN GV 11 Ramsel
66,Bergstraat 71,2021-03-25,05:00:00,10,4,6,FMN GV 11 Ramsel
66,Bergstraat 71,2021-03-25,06:00:00,32,8,24,FMN GV 11 Ramsel
66,Bergstraat 71,2021-03-25,07:00:00,154,30,124,FMN GV 11 Ramsel
66,Bergstraat 71,2021-03-25,08:00:00,144,20,124,FMN GV 11 Ramsel
66,Bergstraat 71,2021-03-25,09:00:00,56,26,30,FMN GV 11 Ramsel
66,Bergstraat 71,2021-03-25,10:00:00,72,44,28,FMN GV 11 Ramsel
66,Bergstraat 71,2021-03-25,11:00:00,74,42,32,FMN GV 11 Ramsel
66,Bergstraat 71,2021-03-25,12:00:00,116,86,30,FMN GV 11 Ramsel
66,Bergstraat 71,2021-03-25,13:00:00,122,52,70,FMN GV 11 Ramsel
66,Bergstraat 71,2021-03-25,14:00:00,138,80,58,FMN GV 11 Ramsel
66,Bergstraat 71,2021-03-25,15:00:00,176,148,28,FMN GV 11 Ramsel
66,Bergstraat 71,2021-03-25,16:00:00,88,74,14,FMN GV 11 Ramsel
66,Bergstraat 71,2021-03-25,17:00:00,56,28,28,FMN GV 11 Ramsel
66,Bergstraat 71,2021-03-25,18:00:00,50,36,14,FMN GV 11 Ramsel
66,Bergstraat 71,2021-03-25,19:00:00,20,16,4,FMN GV 11 Ramsel
66,Bergstraat 71,2021-03-25,20:00:00,22,10,12,FMN GV 11 Ramsel
66,Bergstraat 71,2021-03-25,21:00:00,6,4,2,FMN GV 11 Ramsel
66,Bergstraat 71,2021-03-25,22:00:00,20,18,2,FMN GV 11 Ramsel
66,Bergstraat 71,2021-03-25,23:00:00,0,0,0,FMN GV 11 Ramsel
66,Bergstraat 71,2021-03-26,00:00:00,0,0,0,FMN GV 11 Ramsel
66,Bergstraat 71,2021-03-26,01:00:00,0,0,0,FMN GV 11 Ramsel
66,Bergstraat 71,2021-03-26,02:00:00,0,0,0,FMN GV 11 Ramsel
66,Bergstraat 71,2021-03-26,03:00:00,0,0,0,FMN GV 11 Ramsel
66,Bergstraat 71,2021-03-26,04:00:00,2,2,0,FMN GV 11 Ramsel
66,Bergstraat 71,2021-03-26,05:00:00,12,8,4,FMN GV 11 Ramsel
66,Bergstraat 71,2021-03-26,06:00:00,16,4,12,FMN GV 11 Ramsel
66,Bergstraat 71,2021-03-26,07:00:00,146,20,126,FMN GV 11 Ramsel
66,Bergstraat 71,2021-03-26,08:00:00,148,22,126,FMN GV 11 Ramsel
66,Bergstraat 71,2021-03-26,09:00:00,56,16,40,FMN GV 11 Ramsel
66,Bergstraat 71,2021-03-26,10:00:00,78,36,42,FMN GV 11 Ramsel
66,Bergstraat 71,2021-03-26,11:00:00,130,84,46,FMN GV 11 Ramsel
66,Bergstraat 71,2021-03-26,12:00:00,144,88,56,FMN GV 11 Ramsel
66,Bergstraat 71,2021-03-26,13:00:00,150,52,98,FMN GV 11 Ramsel
66,Bergstraat 71,2021-03-26,14:00:00,146,62,84,FMN GV 11 Ramsel
66,Bergstraat 71,2021-03-26,15:00:00,226,164,62,FMN GV 11 Ramsel
66,Bergstraat 71,2021-03-26,16:00:00,110,60,50,FMN GV 11 Ramsel
66,Bergstraat 71,2021-03-26,17:00:00,76,48,28,FMN GV 11 Ramsel
66,Bergstraat 71,2021-03-26,18:00:00,34,20,14,FMN GV 11 Ramsel
66,Bergstraat 71,2021-03-26,19:00:00,18,10,8,FMN GV 11 Ramsel
66,Bergstraat 71,2021-03-26,20:00:00,14,6,8,FMN GV 11 Ramsel
66,Bergstraat 71,2021-03-26,21:00:00,10,2,8,FMN GV 11 Ramsel
66,Bergstraat 71,2021-03-26,22:00:00,2,2,0,FMN GV 11 Ramsel
66,Bergstraat 71,2021-03-26,23:00:00,2,2,0,FMN GV 11 Ramsel
66,Bergstraat 71,2021-03-27,00:00:00,4,4,0,FMN GV 11 Ramsel
66,Bergstraat 71,2021-03-27,01:00:00,0,0,0,FMN GV 11 Ramsel
66,Bergstraat 71,2021-03-27,02:00:00,0,0,0,FMN GV 11 Ramsel
66,Bergstraat 71,2021-03-27,03:00:00,0,0,0,FMN GV 11 Ramsel
66,Bergstraat 71,2021-03-27,04:00:00,0,0,0,FMN GV 11 Ramsel
66,Bergstraat 71,2021-03-27,05:00:00,0,0,0,FMN GV 11 Ramsel
66,Bergstraat 71,2021-03-27,06:00:00,8,6,2,FMN GV 11 Ramsel
66,Bergstraat 71,2021-03-27,07:00:00,10,4,6,FMN GV 11 Ramsel
66,Bergstraat 71,2021-03-27,08:00:00,24,12,12,FMN GV 11 Ramsel
66,Bergstraat 71,2021-03-27,09:00:00,28,8,20,FMN GV 11 Ramsel
66,Bergstraat 71,2021-03-27,10:00:00,60,22,38,FMN GV 11 Ramsel
66,Bergstraat 71,2021-03-27,11:00:00,66,34,32,FMN GV 11 Ramsel
66,Bergstraat 71,2021-03-27,12:00:00,50,32,18,FMN GV 11 Ramsel
66,Bergstraat 71,2021-03-27,13:00:00,132,64,68,FMN GV 11 Ramsel
66,Bergstraat 71,2021-03-27,14:00:00,110,60,50,FMN GV 11 Ramsel
66,Bergstraat 71,2021-03-27,15:00:00,162,102,60,FMN GV 11 Ramsel
66,Bergstraat 71,2021-03-27,16:00:00,72,34,38,FMN GV 11 Ramsel
66,Bergstraat 71,2021-03-27,17:00:00,48,32,16,FMN GV 11 Ramsel
66,Bergstraat 71,2021-03-27,18:00:00,40,18,22,FMN GV 11 Ramsel
66,Bergstraat 71,2021-03-27,19:00:00,12,2,10,FMN GV 11 Ramsel
66,Bergstraat 71,2021-03-27,20:00:00,12,4,8,FMN GV 11 Ramsel
66,Bergstraat 71,2021-03-27,21:00:00,14,6,8,FMN GV 11 Ramsel
66,Bergstraat 71,2021-03-27,22:00:00,10,8,2,FMN GV 11 Ramsel
66,Bergstraat 71,2021-03-27,23:00:00,2,0,2,FMN GV 11 Ramsel
66,Bergstraat 71,2021-03-28,00:00:00,2,2,0,FMN GV 11 Ramsel
66,Bergstraat 71,2021-03-28,01:00:00,0,0,0,FMN GV 11 Ramsel
66,Bergstraat 71,2021-03-28,02:00:00,0,0,0,FMN GV 11 Ramsel
66,Bergstraat 71,2021-03-28,03:00:00,0,0,0,FMN GV 11 Ramsel
66,Bergstraat 71,2021-03-28,04:00:00,0,0,0,FMN GV 11 Ramsel
66,Bergstraat 71,2021-03-28,05:00:00,2,2,0,FMN GV 11 Ramsel
66,Bergstraat 71,2021-03-28,06:00:00,2,0,2,FMN GV 11 Ramsel
66,Bergstraat 71,2021-03-28,07:00:00,18,4,14,FMN GV 11 Ramsel
66,Bergstraat 71,2021-03-28,08:00:00,76,22,54,FMN GV 11 Ramsel
66,Bergstraat 71,2021-03-28,09:00:00,182,50,132,FMN GV 11 Ramsel
66,Bergstraat 71,2021-03-28,10:00:00,322,114,208,FMN GV 11 Ramsel
66,Bergstraat 71,2021-03-28,11:00:00,364,240,124,FMN GV 11 Ramsel
66,Bergstraat 71,2021-03-28,12:00:00,242,170,72,FMN GV 11 Ramsel
66,Bergstraat 71,2021-03-28,13:00:00,224,84,140,FMN GV 11 Ramsel
66,Bergstraat 71,2021-03-28,14:00:00,196,114,82,FMN GV 11 Ramsel
66,Bergstraat 71,2021-03-28,15:00:00,222,152,70,FMN GV 11 Ramsel
66,Bergstraat 71,2021-03-28,16:00:00,134,78,56,FMN GV 11 Ramsel
66,Bergstraat 71,2021-03-28,17:00:00,80,52,28,FMN GV 11 Ramsel
66,Bergstraat 71,2021-03-28,18:00:00,44,16,28,FMN GV 11 Ramsel
66,Bergstraat 71,2021-03-28,19:00:00,38,14,24,FMN GV 11 Ramsel
66,Bergstraat 71,2021-03-28,20:00:00,22,14,8,FMN GV 11 Ramsel
66,Bergstraat 71,2021-03-28,21:00:00,18,12,6,FMN GV 11 Ramsel
66,Bergstraat 71,2021-03-28,22:00:00,6,4,2,FMN GV 11 Ramsel
66,Bergstraat 71,2021-03-28,23:00:00,2,2,0,FMN GV 11 Ramsel
66,Bergstraat 71,2021-03-29,00:00:00,0,0,0,FMN GV 11 Ramsel
66,Bergstraat 71,2021-03-29,01:00:00,0,0,0,FMN GV 11 Ramsel
66,Bergstraat 71,2021-03-29,02:00:00,0,0,0,FMN GV 11 Ramsel
66,Bergstraat 71,2021-03-29,03:00:00,0,0,0,FMN GV 11 Ramsel
66,Bergstraat 71,2021-03-29,04:00:00,4,4,0,FMN GV 11 Ramsel
66,Bergstraat 71,2021-03-29,05:00:00,14,6,8,FMN GV 11 Ramsel
66,Bergstraat 71,2021-03-29,06:00:00,30,12,18,FMN GV 11 Ramsel
66,Bergstraat 71,2021-03-29,07:00:00,146,20,126,FMN GV 11 Ramsel
66,Bergstraat 71,2021-03-29,08:00:00,72,18,54,FMN GV 11 Ramsel
66,Bergstraat 71,2021-03-29,09:00:00,72,40,32,FMN GV 11 Ramsel
66,Bergstraat 71,2021-03-29,10:00:00,118,56,62,FMN GV 11 Ramsel
66,Bergstraat 71,2021-03-29,11:00:00,100,66,34,FMN GV 11 Ramsel
66,Bergstraat 71,2021-03-29,12:00:00,182,120,62,FMN GV 11 Ramsel
66,Bergstraat 71,2021-03-29,13:00:00,300,162,138,FMN GV 11 Ramsel
66,Bergstraat 71,2021-03-29,14:00:00,284,148,136,FMN GV 11 Ramsel
66,Bergstraat 71,2021-03-29,15:00:00,264,134,130,FMN GV 11 Ramsel
66,Bergstraat 71,2021-03-29,16:00:00,242,130,112,FMN GV 11 Ramsel
66,Bergstraat 71,2021-03-29,17:00:00,150,86,64,FMN GV 11 Ramsel
66,Bergstraat 71,2021-03-29,18:00:00,80,42,38,FMN GV 11 Ramsel
66,Bergstraat 71,2021-03-29,19:00:00,108,56,52,FMN GV 11 Ramsel
66,Bergstraat 71,2021-03-29,20:00:00,38,24,14,FMN GV 11 Ramsel
66,Bergstraat 71,2021-03-29,21:00:00,18,8,10,FMN GV 11 Ramsel
66,Bergstraat 71,2021-03-29,22:00:00,12,10,2,FMN GV 11 Ramsel
66,Bergstraat 71,2021-03-29,23:00:00,4,4,0,FMN GV 11 Ramsel
66,Bergstraat 71,2021-03-30,00:00:00,0,0,0,FMN GV 11 Ramsel
66,Bergstraat 71,2021-03-30,01:00:00,0,0,0,FMN GV 11 Ramsel
66,Bergstraat 71,2021-03-30,02:00:00,0,0,0,FMN GV 11 Ramsel
66,Bergstraat 71,2021-03-30,03:00:00,0,0,0,FMN GV 11 Ramsel
66,Bergstraat 71,2021-03-30,04:00:00,6,4,2,FMN GV 11 Ramsel
66,Bergstraat 71,2021-03-30,05:00:00,12,2,10,FMN GV 11 Ramsel
66,Bergstraat 71,2021-03-30,06:00:00,32,12,20,FMN GV 11 Ramsel
66,Bergstraat 71,2021-03-30,07:00:00,148,24,124,FMN GV 11 Ramsel
66,Bergstraat 71,2021-03-30,08:00:00,64,10,54,FMN GV 11 Ramsel
66,Bergstraat 71,2021-03-30,09:00:00,108,44,64,FMN GV 11 Ramsel
66,Bergstraat 71,2021-03-30,10:00:00,144,88,56,FMN GV 11 Ramsel
66,Bergstraat 71,2021-03-30,11:00:00,164,80,84,FMN GV 11 Ramsel
66,Bergstraat 71,2021-03-30,12:00:00,206,98,108,FMN GV 11 Ramsel
66,Bergstraat 71,2021-03-30,13:00:00,450,190,260,FMN GV 11 Ramsel
66,Bergstraat 71,2021-03-30,14:00:00,468,230,238,FMN GV 11 Ramsel
66,Bergstraat 71,2021-03-30,15:00:00,422,240,182,FMN GV 11 Ramsel
66,Bergstraat 71,2021-03-30,16:00:00,306,176,130,FMN GV 11 Ramsel
66,Bergstraat 71,2021-03-30,17:00:00,250,124,126,FMN GV 11 Ramsel
66,Bergstraat 71,2021-03-30,18:00:00,152,96,56,FMN GV 11 Ramsel
66,Bergstraat 71,2021-03-30,19:00:00,126,86,40,FMN GV 11 Ramsel
66,Bergstraat 71,2021-03-30,20:00:00,78,38,40,FMN GV 11 Ramsel
66,Bergstraat 71,2021-03-30,21:00:00,20,18,2,FMN GV 11 Ramsel
66,Bergstraat 71,2021-03-30,22:00:00,18,14,4,FMN GV 11 Ramsel
66,Bergstraat 71,2021-03-30,23:00:00,4,2,2,FMN GV 11 Ramsel
66,Bergstraat 71,2021-03-31,00:00:00,2,0,2,FMN GV 11 Ramsel
66,Bergstraat 71,2021-03-31,01:00:00,0,0,0,FMN GV 11 Ramsel
66,Bergstraat 71,2021-03-31,02:00:00,0,0,0,FMN GV 11 Ramsel
66,Bergstraat 71,2021-03-31,03:00:00,0,0,0,FMN GV 11 Ramsel
66,Bergstraat 71,2021-03-31,04:00:00,4,4,0,FMN GV 11 Ramsel
66,Bergstraat 71,2021-03-31,05:00:00,12,2,10,FMN GV 11 Ramsel
66,Bergstraat 71,2021-03-31,06:00:00,28,12,16,FMN GV 11 Ramsel
66,Bergstraat 71,2021-03-31,07:00:00,114,22,92,FMN GV 11 Ramsel
66,Bergstraat 71,2021-03-31,08:00:00,76,18,58,FMN GV 11 Ramsel
66,Bergstraat 71,2021-03-31,09:00:00,42,12,30,FMN GV 11 Ramsel
66,Bergstraat 71,2021-03-31,10:00:00,172,80,92,FMN GV 11 Ramsel
66,Bergstraat 71,2021-03-31,11:00:00,134,48,86,FMN GV 11 Ramsel
66,Bergstraat 71,2021-03-31,12:00:00,220,106,114,FMN GV 11 Ramsel
66,Bergstraat 71,2021-03-31,13:00:00,406,198,208,FMN GV 11 Ramsel
66,Bergstraat 71,2021-03-31,14:00:00,472,228,244,FMN GV 11 Ramsel
66,Bergstraat 71,2021-03-31,15:00:00,352,196,156,FMN GV 11 Ramsel
66,Bergstraat 71,2021-03-31,16:00:00,330,184,146,FMN GV 11 Ramsel
66,Bergstraat 71,2021-03-31,17:00:00,316,156,160,FMN GV 11 Ramsel
66,Bergstraat 71,2021-03-31,18:00:00,180,116,64,FMN GV 11 Ramsel
66,Bergstraat 71,2021-03-31,19:00:00,106,66,40,FMN GV 11 Ramsel
66,Bergstraat 71,2021-03-31,20:00:00,64,42,22,FMN GV 11 Ramsel
66,Bergstraat 71,2021-03-31,21:00:00,30,22,8,FMN GV 11 Ramsel
66,Bergstraat 71,2021-03-31,22:00:00,28,18,10,FMN GV 11 Ramsel
66,Bergstraat 71,2021-03-31,23:00:00,2,2,0,FMN GV 11 Ramsel
66,Bergstraat 71,2021-04-01,00:00:00,0,0,0,FMN GV 11 Ramsel
66,Bergstraat 71,2021-04-01,01:00:00,0,0,0,FMN GV 11 Ramsel
66,Bergstraat 71,2021-04-01,02:00:00,0,0,0,FMN GV 11 Ramsel
66,Bergstraat 71,2021-04-01,03:00:00,0,0,0,FMN GV 11 Ramsel
66,Bergstraat 71,2021-04-01,04:00:00,4,2,2,FMN GV 11 Ramsel
66,Bergstraat 71,2021-04-01,05:00:00,6,2,4,FMN GV 11 Ramsel
66,Bergstraat 71,2021-04-01,06:00:00,36,10,26,FMN GV 11 Ramsel
66,Bergstraat 71,2021-04-01,07:00:00,74,20,54,FMN GV 11 Ramsel
66,Bergstraat 71,2021-04-01,08:00:00,60,18,42,FMN GV 11 Ramsel
66,Bergstraat 71,2021-04-01,09:00:00,94,44,50,FMN GV 11 Ramsel
66,Bergstraat 71,2021-04-01,10:00:00,108,56,52,FMN GV 11 Ramsel
66,Bergstraat 71,2021-04-01,11:00:00,132,78,54,FMN GV 11 Ramsel
66,Bergstraat 71,2021-04-01,12:00:00,152,90,62,FMN GV 11 Ramsel
66,Bergstraat 71,2021-04-01,13:00:00,254,92,162,FMN GV 11 Ramsel
66,Bergstraat 71,2021-04-01,14:00:00,348,190,158,FMN GV 11 Ramsel
66,Bergstraat 71,2021-04-01,15:00:00,266,160,106,FMN GV 11 Ramsel
66,Bergstraat 71,2021-04-01,16:00:00,210,132,78,FMN GV 11 Ramsel
66,Bergstraat 71,2021-04-01,17:00:00,206,108,98,FMN GV 11 Ramsel
66,Bergstraat 71,2021-04-01,18:00:00,146,82,64,FMN GV 11 Ramsel
66,Bergstraat 71,2021-04-01,19:00:00,106,62,44,FMN GV 11 Ramsel
66,Bergstraat 71,2021-04-01,20:00:00,30,16,14,FMN GV 11 Ramsel
66,Bergstraat 71,2021-04-01,21:00:00,12,10,2,FMN GV 11 Ramsel
66,Bergstraat 71,2021-04-01,22:00:00,12,8,4,FMN GV 11 Ramsel
66,Bergstraat 71,2021-04-01,23:00:00,0,0,0,FMN GV 11 Ramsel
66,Bergstraat 71,2021-04-02,00:00:00,0,0,0,FMN GV 11 Ramsel
66,Bergstraat 71,2021-04-02,01:00:00,0,0,0,FMN GV 11 Ramsel
66,Bergstraat 71,2021-04-02,02:00:00,0,0,0,FMN GV 11 Ramsel
66,Bergstraat 71,2021-04-02,03:00:00,0,0,0,FMN GV 11 Ramsel
66,Bergstraat 71,2021-04-02,04:00:00,8,6,2,FMN GV 11 Ramsel
66,Bergstraat 71,2021-04-02,05:00:00,2,2,0,FMN GV 11 Ramsel
66,Bergstraat 71,2021-04-02,06:00:00,20,4,16,FMN GV 11 Ramsel
66,Bergstraat 71,2021-04-02,07:00:00,40,12,28,FMN GV 11 Ramsel
66,Bergstraat 71,2021-04-02,08:00:00,46,20,26,FMN GV 11 Ramsel
66,Bergstraat 71,2021-04-02,09:00:00,34,12,22,FMN GV 11 Ramsel
66,Bergstraat 71,2021-04-02,10:00:00,60,22,38,FMN GV 11 Ramsel
66,Bergstraat 71,2021-04-02,11:00:00,78,24,54,FMN GV 11 Ramsel
66,Bergstraat 71,2021-04-02,12:00:00,84,46,38,FMN GV 11 Ramsel
66,Bergstraat 71,2021-04-02,13:00:00,84,48,36,FMN GV 11 Ramsel
66,Bergstraat 71,2021-04-02,14:00:00,92,54,38,FMN GV 11 Ramsel
66,Bergstraat 71,2021-04-02,15:00:00,120,64,56,FMN GV 11 Ramsel
66,Bergstraat 71,2021-04-02,16:00:00,72,40,32,FMN GV 11 Ramsel
66,Bergstraat 71,2021-04-02,17:00:00,74,50,24,FMN GV 11 Ramsel
66,Bergstraat 71,2021-04-02,18:00:00,62,32,30,FMN GV 11 Ramsel
66,Bergstraat 71,2021-04-02,19:00:00,22,12,10,FMN GV 11 Ramsel
66,Bergstraat 71,2021-04-02,20:00:00,22,8,14,FMN GV 11 Ramsel
66,Bergstraat 71,2021-04-02,21:00:00,10,4,6,FMN GV 11 Ramsel
66,Bergstraat 71,2021-04-02,22:00:00,6,4,2,FMN GV 11 Ramsel
66,Bergstraat 71,2021-04-02,23:00:00,6,4,2,FMN GV 11 Ramsel
66,Bergstraat 71,2021-04-03,00:00:00,2,2,0,FMN GV 11 Ramsel
66,Bergstraat 71,2021-04-03,01:00:00,0,0,0,FMN GV 11 Ramsel
66,Bergstraat 71,2021-04-03,02:00:00,0,0,0,FMN GV 11 Ramsel
66,Bergstraat 71,2021-04-03,03:00:00,0,0,0,FMN GV 11 Ramsel
66,Bergstraat 71,2021-04-03,04:00:00,0,0,0,FMN GV 11 Ramsel
66,Bergstraat 71,2021-04-03,05:00:00,2,2,0,FMN GV 11 Ramsel
66,Bergstraat 71,2021-04-03,06:00:00,6,2,4,FMN GV 11 Ramsel
66,Bergstraat 71,2021-04-03,07:00:00,8,2,6,FMN GV 11 Ramsel
66,Bergstraat 71,2021-04-03,08:00:00,30,18,12,FMN GV 11 Ramsel
66,Bergstraat 71,2021-04-03,09:00:00,56,20,36,FMN GV 11 Ramsel
66,Bergstraat 71,2021-04-03,10:00:00,142,70,72,FMN GV 11 Ramsel
66,Bergstraat 71,2021-04-03,11:00:00,124,56,68,FMN GV 11 Ramsel
66,Bergstraat 71,2021-04-03,12:00:00,154,58,96,FMN GV 11 Ramsel
66,Bergstraat 71,2021-04-03,13:00:00,144,50,94,FMN GV 11 Ramsel
66,Bergstraat 71,2021-04-03,14:00:00,196,80,116,FMN GV 11 Ramsel
66,Bergstraat 71,2021-04-03,15:00:00,220,118,102,FMN GV 11 Ramsel
66,Bergstraat 71,2021-04-03,16:00:00,192,140,52,FMN GV 11 Ramsel
66,Bergstraat 71,2021-04-03,17:00:00,86,42,44,FMN GV 11 Ramsel
66,Bergstraat 71,2021-04-03,18:00:00,48,24,24,FMN GV 11 Ramsel
66,Bergstraat 71,2021-04-03,19:00:00,16,12,4,FMN GV 11 Ramsel
66,Bergstraat 71,2021-04-03,20:00:00,20,10,10,FMN GV 11 Ramsel
66,Bergstraat 71,2021-04-03,21:00:00,14,6,8,FMN GV 11 Ramsel
66,Bergstraat 71,2021-04-03,22:00:00,2,2,0,FMN GV 11 Ramsel
66,Bergstraat 71,2021-04-03,23:00:00,12,6,6,FMN GV 11 Ramsel
66,Bergstraat 71,2021-04-04,00:00:00,2,2,0,FMN GV 11 Ramsel
66,Bergstraat 71,2021-04-04,01:00:00,0,0,0,FMN GV 11 Ramsel
66,Bergstraat 71,2021-04-04,02:00:00,0,0,0,FMN GV 11 Ramsel
66,Bergstraat 71,2021-04-04,03:00:00,0,0,0,FMN GV 11 Ramsel
66,Bergstraat 71,2021-04-04,04:00:00,0,0,0,FMN GV 11 Ramsel
66,Bergstraat 71,2021-04-04,05:00:00,2,2,0,FMN GV 11 Ramsel
66,Bergstraat 71,2021-04-04,06:00:00,0,0,0,FMN GV 11 Ramsel
66,Bergstraat 71,2021-04-04,07:00:00,26,10,16,FMN GV 11 Ramsel
66,Bergstraat 71,2021-04-04,08:00:00,52,20,32,FMN GV 11 Ramsel
66,Bergstraat 71,2021-04-04,09:00:00,116,50,66,FMN GV 11 Ramsel
66,Bergstraat 71,2021-04-04,10:00:00,164,90,74,FMN GV 11 Ramsel
66,Bergstraat 71,2021-04-04,11:00:00,186,124,62,FMN GV 11 Ramsel
66,Bergstraat 71,2021-04-04,12:00:00,122,64,58,FMN GV 11 Ramsel
66,Bergstraat 71,2021-04-04,13:00:00,96,38,58,FMN GV 11 Ramsel
66,Bergstraat 71,2021-04-04,14:00:00,88,40,48,FMN GV 11 Ramsel
66,Bergstraat 71,2021-04-04,15:00:00,106,68,38,FMN GV 11 Ramsel
66,Bergstraat 71,2021-04-04,16:00:00,80,28,52,FMN GV 11 Ramsel
66,Bergstraat 71,2021-04-04,17:00:00,84,26,58,FMN GV 11 Ramsel
66,Bergstraat 71,2021-04-04,18:00:00,58,32,26,FMN GV 11 Ramsel
66,Bergstraat 71,2021-04-04,19:00:00,46,22,24,FMN GV 11 Ramsel
66,Bergstraat 71,2021-04-04,20:00:00,18,2,16,FMN GV 11 Ramsel
66,Bergstraat 71,2021-04-04,21:00:00,12,8,4,FMN GV 11 Ramsel
66,Bergstraat 71,2021-04-04,22:00:00,4,2,2,FMN GV 11 Ramsel
66,Bergstraat 71,2021-04-04,23:00:00,2,0,2,FMN GV 11 Ramsel
66,Bergstraat 71,2021-04-05,00:00:00,2,2,0,FMN GV 11 Ramsel
66,Bergstraat 71,2021-04-05,01:00:00,0,0,0,FMN GV 11 Ramsel
66,Bergstraat 71,2021-04-05,02:00:00,0,0,0,FMN GV 11 Ramsel
66,Bergstraat 71,2021-04-05,03:00:00,0,0,0,FMN GV 11 Ramsel
66,Bergstraat 71,2021-04-05,04:00:00,0,0,0,FMN GV 11 Ramsel
66,Bergstraat 71,2021-04-05,05:00:00,4,4,0,FMN GV 11 Ramsel
66,Bergstraat 71,2021-04-05,06:00:00,2,0,2,FMN GV 11 Ramsel
66,Bergstraat 71,2021-04-05,07:00:00,10,2,8,FMN GV 11 Ramsel
66,Bergstraat 71,2021-04-05,08:00:00,10,2,8,FMN GV 11 Ramsel
66,Bergstraat 71,2021-04-05,09:00:00,16,6,10,FMN GV 11 Ramsel
66,Bergstraat 71,2021-04-05,10:00:00,8,6,2,FMN GV 11 Ramsel
66,Bergstraat 71,2021-04-05,11:00:00,16,12,4,FMN GV 11 Ramsel
66,Bergstraat 71,2021-04-05,12:00:00,20,12,8,FMN GV 11 Ramsel
66,Bergstraat 71,2021-04-05,13:00:00,14,10,4,FMN GV 11 Ramsel
66,Bergstraat 71,2021-04-05,14:00:00,44,18,26,FMN GV 11 Ramsel
66,Bergstraat 71,2021-04-05,15:00:00,50,36,14,FMN GV 11 Ramsel
66,Bergstraat 71,2021-04-05,16:00:00,36,24,12,FMN GV 11 Ramsel
66,Bergstraat 71,2021-04-05,17:00:00,10,4,6,FMN GV 11 Ramsel
66,Bergstraat 71,2021-04-05,18:00:00,20,10,10,FMN GV 11 Ramsel
66,Bergstraat 71,2021-04-05,19:00:00,6,4,2,FMN GV 11 Ramsel
66,Bergstraat 71,2021-04-05,20:00:00,8,0,8,FMN GV 11 Ramsel
66,Bergstraat 71,2021-04-05,21:00:00,4,4,0,FMN GV 11 Ramsel
66,Bergstraat 71,2021-04-05,22:00:00,0,0,0,FMN GV 11 Ramsel
66,Bergstraat 71,2021-04-05,23:00:00,0,0,0,FMN GV 11 Ramsel
66,Bergstraat 71,2021-04-06,00:00:00,0,0,0,FMN GV 11 Ramsel
66,Bergstraat 71,2021-04-06,01:00:00,0,0,0,FMN GV 11 Ramsel
66,Bergstraat 71,2021-04-06,02:00:00,0,0,0,FMN GV 11 Ramsel
66,Bergstraat 71,2021-04-06,03:00:00,0,0,0,FMN GV 11 Ramsel
66,Bergstraat 71,2021-04-06,04:00:00,0,0,0,FMN GV 11 Ramsel
66,Bergstraat 71,2021-04-06,05:00:00,8,2,6,FMN GV 11 Ramsel
66,Bergstraat 71,2021-04-06,06:00:00,14,4,10,FMN GV 11 Ramsel
66,Bergstraat 71,2021-04-06,07:00:00,12,4,8,FMN GV 11 Ramsel
66,Bergstraat 71,2021-04-06,08:00:00,8,2,6,FMN GV 11 Ramsel
66,Bergstraat 71,2021-04-06,09:00:00,8,4,4,FMN GV 11 Ramsel
66,Bergstraat 71,2021-04-06,10:00:00,2,0,2,FMN GV 11 Ramsel
66,Bergstraat 71,2021-04-06,11:00:00,14,8,6,FMN GV 11 Ramsel
66,Bergstraat 71,2021-04-06,12:00:00,12,10,2,FMN GV 11 Ramsel
66,Bergstraat 71,2021-04-06,13:00:00,10,6,4,FMN GV 11 Ramsel
66,Bergstraat 71,2021-04-06,14:00:00,22,12,10,FMN GV 11 Ramsel
66,Bergstraat 71,2021-04-06,15:00:00,16,8,8,FMN GV 11 Ramsel
66,Bergstraat 71,2021-04-06,16:00:00,20,14,6,FMN GV 11 Ramsel
66,Bergstraat 71,2021-04-06,17:00:00,28,16,12,FMN GV 11 Ramsel
66,Bergstraat 71,2021-04-06,18:00:00,8,2,6,FMN GV 11 Ramsel
66,Bergstraat 71,2021-04-06,19:00:00,8,2,6,FMN GV 11 Ramsel
66,Bergstraat 71,2021-04-06,20:00:00,8,4,4,FMN GV 11 Ramsel
66,Bergstraat 71,2021-04-06,21:00:00,6,6,0,FMN GV 11 Ramsel
66,Bergstraat 71,2021-04-06,22:00:00,4,0,4,FMN GV 11 Ramsel
66,Bergstraat 71,2021-04-06,23:00:00,0,0,0,FMN GV 11 Ramsel
66,Bergstraat 71,2021-04-07,00:00:00,0,0,0,FMN GV 11 Ramsel
66,Bergstraat 71,2021-04-07,01:00:00,0,0,0,FMN GV 11 Ramsel
66,Bergstraat 71,2021-04-07,02:00:00,0,0,0,FMN GV 11 Ramsel
66,Bergstraat 71,2021-04-07,03:00:00,0,0,0,FMN GV 11 Ramsel
66,Bergstraat 71,2021-04-07,04:00:00,0,0,0,FMN GV 11 Ramsel
66,Bergstraat 71,2021-04-07,05:00:00,0,0,0,FMN GV 11 Ramsel
66,Bergstraat 71,2021-04-07,06:00:00,8,4,4,FMN GV 11 Ramsel
66,Bergstraat 71,2021-04-07,07:00:00,12,8,4,FMN GV 11 Ramsel
66,Bergstraat 71,2021-04-07,08:00:00,4,2,2,FMN GV 11 Ramsel
66,Bergstraat 71,2021-04-07,09:00:00,2,2,0,FMN GV 11 Ramsel
66,Bergstraat 71,2021-04-07,10:00:00,4,0,4,FMN GV 11 Ramsel
66,Bergstraat 71,2021-04-07,11:00:00,8,6,2,FMN GV 11 Ramsel
66,Bergstraat 71,2021-04-07,12:00:00,12,4,8,FMN GV 11 Ramsel
66,Bergstraat 71,2021-04-07,13:00:00,18,4,14,FMN GV 11 Ramsel
66,Bergstraat 71,2021-04-07,14:00:00,18,12,6,FMN GV 11 Ramsel
66,Bergstraat 71,2021-04-07,15:00:00,26,10,16,FMN GV 11 Ramsel
66,Bergstraat 71,2021-04-07,16:00:00,24,18,6,FMN GV 11 Ramsel
66,Bergstraat 71,2021-04-07,17:00:00,28,12,16,FMN GV 11 Ramsel
66,Bergstraat 71,2021-04-07,18:00:00,14,8,6,FMN GV 11 Ramsel
66,Bergstraat 71,2021-04-07,19:00:00,6,0,6,FMN GV 11 Ramsel
66,Bergstraat 71,2021-04-07,20:00:00,8,4,4,FMN GV 11 Ramsel
66,Bergstraat 71,2021-04-07,21:00:00,2,0,2,FMN GV 11 Ramsel
66,Bergstraat 71,2021-04-07,22:00:00,0,0,0,FMN GV 11 Ramsel
66,Bergstraat 71,2021-04-07,23:00:00,2,0,2,FMN GV 11 Ramsel
66,Bergstraat 71,2021-04-08,00:00:00,2,2,0,FMN GV 11 Ramsel
66,Bergstraat 71,2021-04-08,01:00:00,0,0,0,FMN GV 11 Ramsel
66,Bergstraat 71,2021-04-08,02:00:00,0,0,0,FMN GV 11 Ramsel
66,Bergstraat 71,2021-04-08,03:00:00,0,0,0,FMN GV 11 Ramsel
66,Bergstraat 71,2021-04-08,04:00:00,0,0,0,FMN GV 11 Ramsel
66,Bergstraat 71,2021-04-08,05:00:00,4,2,2,FMN GV 11 Ramsel
66,Bergstraat 71,2021-04-08,06:00:00,18,8,10,FMN GV 11 Ramsel
66,Bergstraat 71,2021-04-08,07:00:00,26,6,20,FMN GV 11 Ramsel
66,Bergstraat 71,2021-04-08,08:00:00,42,14,28,FMN GV 11 Ramsel
66,Bergstraat 71,2021-04-08,09:00:00,58,32,26,FMN GV 11 Ramsel
66,Bergstraat 71,2021-04-08,10:00:00,42,12,30,FMN GV 11 Ramsel
66,Bergstraat 71,2021-04-08,11:00:00,82,32,50,FMN GV 11 Ramsel
66,Bergstraat 71,2021-04-08,12:00:00,92,42,50,FMN GV 11 Ramsel
66,Bergstraat 71,2021-04-08,13:00:00,204,58,146,FMN GV 11 Ramsel
66,Bergstraat 71,2021-04-08,14:00:00,148,80,68,FMN GV 11 Ramsel
66,Bergstraat 71,2021-04-08,15:00:00,124,58,66,FMN GV 11 Ramsel
66,Bergstraat 71,2021-04-08,16:00:00,124,70,54,FMN GV 11 Ramsel
66,Bergstraat 71,2021-04-08,17:00:00,102,72,30,FMN GV 11 Ramsel
66,Bergstraat 71,2021-04-08,18:00:00,74,50,24,FMN GV 11 Ramsel
66,Bergstraat 71,2021-04-08,19:00:00,60,40,20,FMN GV 11 Ramsel
66,Bergstraat 71,2021-04-08,20:00:00,48,28,20,FMN GV 11 Ramsel
66,Bergstraat 71,2021-04-08,21:00:00,10,6,4,FMN GV 11 Ramsel
66,Bergstraat 71,2021-04-08,22:00:00,12,6,6,FMN GV 11 Ramsel
66,Bergstraat 71,2021-04-08,23:00:00,4,4,0,FMN GV 11 Ramsel
66,Bergstraat 71,2021-04-09,00:00:00,0,0,0,FMN GV 11 Ramsel
66,Bergstraat 71,2021-04-09,01:00:00,0,0,0,FMN GV 11 Ramsel
66,Bergstraat 71,2021-04-09,02:00:00,0,0,0,FMN GV 11 Ramsel
66,Bergstraat 71,2021-04-09,03:00:00,2,0,2,FMN GV 11 Ramsel
66,Bergstraat 71,2021-04-09,04:00:00,2,2,0,FMN GV 11 Ramsel
66,Bergstraat 71,2021-04-09,05:00:00,0,0,0,FMN GV 11 Ramsel
66,Bergstraat 71,2021-04-09,06:00:00,12,6,6,FMN GV 11 Ramsel
66,Bergstraat 71,2021-04-09,07:00:00,34,12,22,FMN GV 11 Ramsel
66,Bergstraat 71,2021-04-09,08:00:00,24,10,14,FMN GV 11 Ramsel
66,Bergstraat 71,2021-04-09,09:00:00,40,20,20,FMN GV 11 Ramsel
66,Bergstraat 71,2021-04-09,10:00:00,66,30,36,FMN GV 11 Ramsel
66,Bergstraat 71,2021-04-09,11:00:00,74,40,34,FMN GV 11 Ramsel
66,Bergstraat 71,2021-04-09,12:00:00,130,44,86,FMN GV 11 Ramsel
66,Bergstraat 71,2021-04-09,13:00:00,222,76,146,FMN GV 11 Ramsel
66,Bergstraat 71,2021-04-09,14:00:00,246,124,122,FMN GV 11 Ramsel
66,Bergstraat 71,2021-04-09,15:00:00,294,188,106,FMN GV 11 Ramsel
66,Bergstraat 71,2021-04-09,16:00:00,220,144,76,FMN GV 11 Ramsel
66,Bergstraat 71,2021-04-09,17:00:00,112,66,46,FMN GV 11 Ramsel
66,Bergstraat 71,2021-04-09,18:00:00,74,38,36,FMN GV 11 Ramsel
66,Bergstraat 71,2021-04-09,19:00:00,30,24,6,FMN GV 11 Ramsel
66,Bergstraat 71,2021-04-09,20:00:00,34,18,16,FMN GV 11 Ramsel
66,Bergstraat 71,2021-04-09,21:00:00,12,2,10,FMN GV 11 Ramsel
66,Bergstraat 71,2021-04-09,22:00:00,6,4,2,FMN GV 11 Ramsel
66,Bergstraat 71,2021-04-09,23:00:00,2,0,2,FMN GV 11 Ramsel
66,Bergstraat 71,2021-04-10,00:00:00,2,2,0,FMN GV 11 Ramsel
66,Bergstraat 71,2021-04-10,01:00:00,0,0,0,FMN GV 11 Ramsel
66,Bergstraat 71,2021-04-10,02:00:00,0,0,0,FMN GV 11 Ramsel
66,Bergstraat 71,2021-04-10,03:00:00,0,0,0,FMN GV 11 Ramsel
66,Bergstraat 71,2021-04-10,04:00:00,0,0,0,FMN GV 11 Ramsel
66,Bergstraat 71,2021-04-10,05:00:00,2,2,0,FMN GV 11 Ramsel
66,Bergstraat 71,2021-04-10,06:00:00,8,2,6,FMN GV 11 Ramsel
66,Bergstraat 71,2021-04-10,07:00:00,4,4,0,FMN GV 11 Ramsel
66,Bergstraat 71,2021-04-10,08:00:00,16,8,8,FMN GV 11 Ramsel
66,Bergstraat 71,2021-04-10,09:00:00,6,2,4,FMN GV 11 Ramsel
66,Bergstraat 71,2021-04-10,10:00:00,20,12,8,FMN GV 11 Ramsel
66,Bergstraat 71,2021-04-10,11:00:00,10,4,6,FMN GV 11 Ramsel
66,Bergstraat 71,2021-04-10,12:00:00,2,0,2,FMN GV 11 Ramsel
66,Bergstraat 71,2021-04-10,13:00:00,12,10,2,FMN GV 11 Ramsel
66,Bergstraat 71,2021-04-10,14:00:00,28,10,18,FMN GV 11 Ramsel
66,Bergstraat 71,2021-04-10,15:00:00,12,8,4,FMN GV 11 Ramsel
66,Bergstraat 71,2021-04-10,16:00:00,4,4,0,FMN GV 11 Ramsel
66,Bergstraat 71,2021-04-10,17:00:00,8,2,6,FMN GV 11 Ramsel
66,Bergstraat 71,2021-04-10,18:00:00,8,2,6,FMN GV 11 Ramsel
66,Bergstraat 71,2021-04-10,19:00:00,2,0,2,FMN GV 11 Ramsel
66,Bergstraat 71,2021-04-10,20:00:00,2,0,2,FMN GV 11 Ramsel
66,Bergstraat 71,2021-04-10,21:00:00,6,2,4,FMN GV 11 Ramsel
66,Bergstraat 71,2021-04-10,22:00:00,0,0,0,FMN GV 11 Ramsel
66,Bergstraat 71,2021-04-10,23:00:00,0,0,0,FMN GV 11 Ramsel
66,Bergstraat 71,2021-04-11,00:00:00,0,0,0,FMN GV 11 Ramsel
66,Bergstraat 71,2021-04-11,01:00:00,0,0,0,FMN GV 11 Ramsel
66,Bergstraat 71,2021-04-11,02:00:00,0,0,0,FMN GV 11 Ramsel
66,Bergstraat 71,2021-04-11,03:00:00,0,0,0,FMN GV 11 Ramsel
66,Bergstraat 71,2021-04-11,04:00:00,0,0,0,FMN GV 11 Ramsel
66,Bergstraat 71,2021-04-11,05:00:00,0,0,0,FMN GV 11 Ramsel
66,Bergstraat 71,2021-04-11,06:00:00,2,2,0,FMN GV 11 Ramsel
66,Bergstraat 71,2021-04-11,07:00:00,6,2,4,FMN GV 11 Ramsel
66,Bergstraat 71,2021-04-11,08:00:00,12,2,10,FMN GV 11 Ramsel
66,Bergstraat 71,2021-04-11,09:00:00,54,18,36,FMN GV 11 Ramsel
66,Bergstraat 71,2021-04-11,10:00:00,54,26,28,FMN GV 11 Ramsel
66,Bergstraat 71,2021-04-11,11:00:00,102,62,40,FMN GV 11 Ramsel
66,Bergstraat 71,2021-04-11,12:00:00,80,50,30,FMN GV 11 Ramsel
66,Bergstraat 71,2021-04-11,13:00:00,106,64,42,FMN GV 11 Ramsel
66,Bergstraat 71,2021-04-11,14:00:00,78,44,34,FMN GV 11 Ramsel
66,Bergstraat 71,2021-04-11,15:00:00,132,80,52,FMN GV 11 Ramsel
66,Bergstraat 71,2021-04-11,16:00:00,86,40,46,FMN GV 11 Ramsel
66,Bergstraat 71,2021-04-11,17:00:00,36,16,20,FMN GV 11 Ramsel
66,Bergstraat 71,2021-04-11,18:00:00,24,14,10,FMN GV 11 Ramsel
66,Bergstraat 71,2021-04-11,19:00:00,18,6,12,FMN GV 11 Ramsel
66,Bergstraat 71,2021-04-11,20:00:00,22,12,10,FMN GV 11 Ramsel
66,Bergstraat 71,2021-04-11,21:00:00,0,0,0,FMN GV 11 Ramsel
66,Bergstraat 71,2021-04-11,22:00:00,2,2,0,FMN GV 11 Ramsel
66,Bergstraat 71,2021-04-11,23:00:00,0,0,0,FMN GV 11 Ramsel
66,Bergstraat 71,2021-04-12,00:00:00,0,0,0,FMN GV 11 Ramsel
66,Bergstraat 71,2021-04-12,01:00:00,0,0,0,FMN GV 11 Ramsel
66,Bergstraat 71,2021-04-12,02:00:00,0,0,0,FMN GV 11 Ramsel
66,Bergstraat 71,2021-04-12,03:00:00,0,0,0,FMN GV 11 Ramsel
66,Bergstraat 71,2021-04-12,04:00:00,4,4,0,FMN GV 11 Ramsel
66,Bergstraat 71,2021-04-12,05:00:00,6,4,2,FMN GV 11 Ramsel
66,Bergstraat 71,2021-04-12,06:00:00,18,6,12,FMN GV 11 Ramsel
66,Bergstraat 71,2021-04-12,07:00:00,22,10,12,FMN GV 11 Ramsel
66,Bergstraat 71,2021-04-12,08:00:00,28,10,18,FMN GV 11 Ramsel
66,Bergstraat 71,2021-04-12,09:00:00,22,6,16,FMN GV 11 Ramsel
66,Bergstraat 71,2021-04-12,10:00:00,48,24,24,FMN GV 11 Ramsel
66,Bergstraat 71,2021-04-12,11:00:00,28,16,12,FMN GV 11 Ramsel
66,Bergstraat 71,2021-04-12,12:00:00,38,24,14,FMN GV 11 Ramsel
66,Bergstraat 71,2021-04-12,13:00:00,34,10,24,FMN GV 11 Ramsel
66,Bergstraat 71,2021-04-12,14:00:00,32,14,18,FMN GV 11 Ramsel
66,Bergstraat 71,2021-04-12,15:00:00,68,48,20,FMN GV 11 Ramsel
66,Bergstraat 71,2021-04-12,16:00:00,60,28,32,FMN GV 11 Ramsel
66,Bergstraat 71,2021-04-12,17:00:00,62,30,32,FMN GV 11 Ramsel
66,Bergstraat 71,2021-04-12,18:00:00,20,12,8,FMN GV 11 Ramsel
66,Bergstraat 71,2021-04-12,19:00:00,20,12,8,FMN GV 11 Ramsel
66,Bergstraat 71,2021-04-12,20:00:00,12,6,6,FMN GV 11 Ramsel
66,Bergstraat 71,2021-04-12,21:00:00,8,2,6,FMN GV 11 Ramsel
66,Bergstraat 71,2021-04-12,22:00:00,4,4,0,FMN GV 11 Ramsel
66,Bergstraat 71,2021-04-12,23:00:00,2,0,2,FMN GV 11 Ramsel
66,Bergstraat 71,2021-04-13,00:00:00,2,2,0,FMN GV 11 Ramsel
66,Bergstraat 71,2021-04-13,01:00:00,0,0,0,FMN GV 11 Ramsel
66,Bergstraat 71,2021-04-13,02:00:00,0,0,0,FMN GV 11 Ramsel
66,Bergstraat 71,2021-04-13,03:00:00,0,0,0,FMN GV 11 Ramsel
66,Bergstraat 71,2021-04-13,04:00:00,4,4,0,FMN GV 11 Ramsel
66,Bergstraat 71,2021-04-13,05:00:00,4,0,4,FMN GV 11 Ramsel
66,Bergstraat 71,2021-04-13,06:00:00,18,6,12,FMN GV 11 Ramsel
66,Bergstraat 71,2021-04-13,07:00:00,24,10,14,FMN GV 11 Ramsel
66,Bergstraat 71,2021-04-13,08:00:00,24,10,14,FMN GV 11 Ramsel
66,Bergstraat 71,2021-04-13,09:00:00,36,16,20,FMN GV 11 Ramsel
66,Bergstraat 71,2021-04-13,10:00:00,56,22,34,FMN GV 11 Ramsel
66,Bergstraat 71,2021-04-13,11:00:00,94,46,48,FMN GV 11 Ramsel
66,Bergstraat 71,2021-04-13,12:00:00,96,68,28,FMN GV 11 Ramsel
66,Bergstraat 71,2021-04-13,13:00:00,168,82,86,FMN GV 11 Ramsel
66,Bergstraat 71,2021-04-13,14:00:00,172,90,82,FMN GV 11 Ramsel
66,Bergstraat 71,2021-04-13,15:00:00,184,104,80,FMN GV 11 Ramsel
66,Bergstraat 71,2021-04-13,16:00:00,156,74,82,FMN GV 11 Ramsel
66,Bergstraat 71,2021-04-13,17:00:00,72,30,42,FMN GV 11 Ramsel
66,Bergstraat 71,2021-04-13,18:00:00,50,20,30,FMN GV 11 Ramsel
66,Bergstraat 71,2021-04-13,19:00:00,62,38,24,FMN GV 11 Ramsel
66,Bergstraat 71,2021-04-13,20:00:00,40,22,18,FMN GV 11 Ramsel
66,Bergstraat 71,2021-04-13,21:00:00,26,20,6,FMN GV 11 Ramsel
66,Bergstraat 71,2021-04-13,22:00:00,12,10,2,FMN GV 11 Ramsel
66,Bergstraat 71,2021-04-13,23:00:00,0,0,0,FMN GV 11 Ramsel
66,Bergstraat 71,2021-04-14,00:00:00,4,0,4,FMN GV 11 Ramsel
66,Bergstraat 71,2021-04-14,01:00:00,0,0,0,FMN GV 11 Ramsel
66,Bergstraat 71,2021-04-14,02:00:00,0,0,0,FMN GV 11 Ramsel
66,Bergstraat 71,2021-04-14,03:00:00,0,0,0,FMN GV 11 Ramsel
66,Bergstraat 71,2021-04-14,04:00:00,6,4,2,FMN GV 11 Ramsel
66,Bergstraat 71,2021-04-14,05:00:00,8,8,0,FMN GV 11 Ramsel
66,Bergstraat 71,2021-04-14,06:00:00,16,4,12,FMN GV 11 Ramsel
66,Bergstraat 71,2021-04-14,07:00:00,34,14,20,FMN GV 11 Ramsel
66,Bergstraat 71,2021-04-14,08:00:00,30,8,22,FMN GV 11 Ramsel
66,Bergstraat 71,2021-04-14,09:00:00,62,18,44,FMN GV 11 Ramsel
66,Bergstraat 71,2021-04-14,10:00:00,80,22,58,FMN GV 11 Ramsel
66,Bergstraat 71,2021-04-14,11:00:00,92,38,54,FMN GV 11 Ramsel
66,Bergstraat 71,2021-04-14,12:00:00,68,36,32,FMN GV 11 Ramsel
66,Bergstraat 71,2021-04-14,13:00:00,138,80,58,FMN GV 11 Ramsel
66,Bergstraat 71,2021-04-14,14:00:00,134,62,72,FMN GV 11 Ramsel
66,Bergstraat 71,2021-04-14,15:00:00,112,70,42,FMN GV 11 Ramsel
66,Bergstraat 71,2021-04-14,16:00:00,72,44,28,FMN GV 11 Ramsel
66,Bergstraat 71,2021-04-14,17:00:00,108,74,34,FMN GV 11 Ramsel
66,Bergstraat 71,2021-04-14,18:00:00,86,28,58,FMN GV 11 Ramsel
66,Bergstraat 71,2021-04-14,19:00:00,54,32,22,FMN GV 11 Ramsel
66,Bergstraat 71,2021-04-14,20:00:00,20,12,8,FMN GV 11 Ramsel
66,Bergstraat 71,2021-04-14,21:00:00,6,4,2,FMN GV 11 Ramsel
66,Bergstraat 71,2021-04-14,22:00:00,10,10,0,FMN GV 11 Ramsel
66,Bergstraat 71,2021-04-14,23:00:00,0,0,0,FMN GV 11 Ramsel
66,Bergstraat 71,2021-04-15,00:00:00,0,0,0,FMN GV 11 Ramsel
66,Bergstraat 71,2021-04-15,01:00:00,0,0,0,FMN GV 11 Ramsel
66,Bergstraat 71,2021-04-15,02:00:00,0,0,0,FMN GV 11 Ramsel
66,Bergstraat 71,2021-04-15,03:00:00,0,0,0,FMN GV 11 Ramsel
66,Bergstraat 71,2021-04-15,04:00:00,4,4,0,FMN GV 11 Ramsel
66,Bergstraat 71,2021-04-15,05:00:00,4,4,0,FMN GV 11 Ramsel
66,Bergstraat 71,2021-04-15,06:00:00,24,8,16,FMN GV 11 Ramsel
66,Bergstraat 71,2021-04-15,07:00:00,34,12,22,FMN GV 11 Ramsel
66,Bergstraat 71,2021-04-15,08:00:00,36,16,20,FMN GV 11 Ramsel
66,Bergstraat 71,2021-04-15,09:00:00,26,12,14,FMN GV 11 Ramsel
66,Bergstraat 71,2021-04-15,10:00:00,138,36,102,FMN GV 11 Ramsel
66,Bergstraat 71,2021-04-15,11:00:00,62,34,28,FMN GV 11 Ramsel
66,Bergstraat 71,2021-04-15,12:00:00,58,24,34,FMN GV 11 Ramsel
66,Bergstraat 71,2021-04-15,13:00:00,130,26,104,FMN GV 11 Ramsel
66,Bergstraat 71,2021-04-15,14:00:00,80,46,34,FMN GV 11 Ramsel
66,Bergstraat 71,2021-04-15,15:00:00,138,92,46,FMN GV 11 Ramsel
66,Bergstraat 71,2021-04-15,16:00:00,134,86,48,FMN GV 11 Ramsel
66,Bergstraat 71,2021-04-15,17:00:00,76,42,34,FMN GV 11 Ramsel
66,Bergstraat 71,2021-04-15,18:00:00,48,28,20,FMN GV 11 Ramsel
66,Bergstraat 71,2021-04-15,19:00:00,38,16,22,FMN GV 11 Ramsel
66,Bergstraat 71,2021-04-15,20:00:00,44,34,10,FMN GV 11 Ramsel
66,Bergstraat 71,2021-04-15,21:00:00,4,4,0,FMN GV 11 Ramsel
66,Bergstraat 71,2021-04-15,22:00:00,12,6,6,FMN GV 11 Ramsel
66,Bergstraat 71,2021-04-15,23:00:00,2,0,2,FMN GV 11 Ramsel
66,Bergstraat 71,2021-04-16,00:00:00,0,0,0,FMN GV 11 Ramsel
66,Bergstraat 71,2021-04-16,01:00:00,0,0,0,FMN GV 11 Ramsel
66,Bergstraat 71,2021-04-16,02:00:00,0,0,0,FMN GV 11 Ramsel
66,Bergstraat 71,2021-04-16,03:00:00,0,0,0,FMN GV 11 Ramsel
66,Bergstraat 71,2021-04-16,04:00:00,4,4,0,FMN GV 11 Ramsel
66,Bergstraat 71,2021-04-16,05:00:00,4,2,2,FMN GV 11 Ramsel
66,Bergstraat 71,2021-04-16,06:00:00,12,4,8,FMN GV 11 Ramsel
66,Bergstraat 71,2021-04-16,07:00:00,30,12,18,FMN GV 11 Ramsel
66,Bergstraat 71,2021-04-16,08:00:00,30,8,22,FMN GV 11 Ramsel
66,Bergstraat 71,2021-04-16,09:00:00,30,16,14,FMN GV 11 Ramsel
66,Bergstraat 71,2021-04-16,10:00:00,56,24,32,FMN GV 11 Ramsel
66,Bergstraat 71,2021-04-16,11:00:00,68,28,40,FMN GV 11 Ramsel
66,Bergstraat 71,2021-04-16,12:00:00,84,30,54,FMN GV 11 Ramsel
66,Bergstraat 71,2021-04-16,13:00:00,136,62,74,FMN GV 11 Ramsel
66,Bergstraat 71,2021-04-16,14:00:00,222,108,114,FMN GV 11 Ramsel
66,Bergstraat 71,2021-04-16,15:00:00,128,60,68,FMN GV 11 Ramsel
66,Bergstraat 71,2021-04-16,16:00:00,172,92,80,FMN GV 11 Ramsel
66,Bergstraat 71,2021-04-16,17:00:00,76,46,30,FMN GV 11 Ramsel
66,Bergstraat 71,2021-04-16,18:00:00,98,50,48,FMN GV 11 Ramsel
66,Bergstraat 71,2021-04-16,19:00:00,20,8,12,FMN GV 11 Ramsel
66,Bergstraat 71,2021-04-16,20:00:00,26,14,12,FMN GV 11 Ramsel
66,Bergstraat 71,2021-04-16,21:00:00,20,6,14,FMN GV 11 Ramsel
66,Bergstraat 71,2021-04-16,22:00:00,4,4,0,FMN GV 11 Ramsel
66,Bergstraat 71,2021-04-16,23:00:00,16,4,12,FMN GV 11 Ramsel
66,Bergstraat 71,2021-04-17,00:00:00,8,8,0,FMN GV 11 Ramsel
66,Bergstraat 71,2021-04-17,01:00:00,0,0,0,FMN GV 11 Ramsel
66,Bergstraat 71,2021-04-17,02:00:00,0,0,0,FMN GV 11 Ramsel
66,Bergstraat 71,2021-04-17,03:00:00,0,0,0,FMN GV 11 Ramsel
66,Bergstraat 71,2021-04-17,04:00:00,0,0,0,FMN GV 11 Ramsel
66,Bergstraat 71,2021-04-17,05:00:00,6,4,2,FMN GV 11 Ramsel
66,Bergstraat 71,2021-04-17,06:00:00,6,2,4,FMN GV 11 Ramsel
66,Bergstraat 71,2021-04-17,07:00:00,12,8,4,FMN GV 11 Ramsel
66,Bergstraat 71,2021-04-17,08:00:00,38,18,20,FMN GV 11 Ramsel
66,Bergstraat 71,2021-04-17,09:00:00,44,24,20,FMN GV 11 Ramsel
66,Bergstraat 71,2021-04-17,10:00:00,82,26,56,FMN GV 11 Ramsel
66,Bergstraat 71,2021-04-17,11:00:00,158,80,78,FMN GV 11 Ramsel
66,Bergstraat 71,2021-04-17,12:00:00,180,74,106,FMN GV 11 Ramsel
66,Bergstraat 71,2021-04-17,13:00:00,286,118,168,FMN GV 11 Ramsel
66,Bergstraat 71,2021-04-17,14:00:00,342,160,182,FMN GV 11 Ramsel
66,Bergstraat 71,2021-04-17,15:00:00,272,162,110,FMN GV 11 Ramsel
66,Bergstraat 71,2021-04-17,16:00:00,214,126,88,FMN GV 11 Ramsel
66,Bergstraat 71,2021-04-17,17:00:00,152,92,60,FMN GV 11 Ramsel
66,Bergstraat 71,2021-04-17,18:00:00,62,40,22,FMN GV 11 Ramsel
66,Bergstraat 71,2021-04-17,19:00:00,30,8,22,FMN GV 11 Ramsel
66,Bergstraat 71,2021-04-17,20:00:00,12,4,8,FMN GV 11 Ramsel
66,Bergstraat 71,2021-04-17,21:00:00,6,2,4,FMN GV 11 Ramsel
66,Bergstraat 71,2021-04-17,22:00:00,0,0,0,FMN GV 11 Ramsel
66,Bergstraat 71,2021-04-17,23:00:00,0,0,0,FMN GV 11 Ramsel
66,Bergstraat 71,2021-04-18,00:00:00,2,2,0,FMN GV 11 Ramsel
66,Bergstraat 71,2021-04-18,01:00:00,0,0,0,FMN GV 11 Ramsel
66,Bergstraat 71,2021-04-18,02:00:00,2,2,0,FMN GV 11 Ramsel
66,Bergstraat 71,2021-04-18,03:00:00,0,0,0,FMN GV 11 Ramsel
66,Bergstraat 71,2021-04-18,04:00:00,0,0,0,FMN GV 11 Ramsel
66,Bergstraat 71,2021-04-18,05:00:00,2,2,0,FMN GV 11 Ramsel
66,Bergstraat 71,2021-04-18,06:00:00,2,0,2,FMN GV 11 Ramsel
66,Bergstraat 71,2021-04-18,07:00:00,30,10,20,FMN GV 11 Ramsel
66,Bergstraat 71,2021-04-18,08:00:00,98,32,66,FMN GV 11 Ramsel
66,Bergstraat 71,2021-04-18,09:00:00,156,64,92,FMN GV 11 Ramsel
66,Bergstraat 71,2021-04-18,10:00:00,294,128,166,FMN GV 11 Ramsel
66,Bergstraat 71,2021-04-18,11:00:00,330,174,156,FMN GV 11 Ramsel
66,Bergstraat 71,2021-04-18,12:00:00,228,164,64,FMN GV 11 Ramsel
66,Bergstraat 71,2021-04-18,13:00:00,336,182,154,FMN GV 11 Ramsel
66,Bergstraat 71,2021-04-18,14:00:00,456,246,210,FMN GV 11 Ramsel
66,Bergstraat 71,2021-04-18,15:00:00,336,186,150,FMN GV 11 Ramsel
66,Bergstraat 71,2021-04-18,16:00:00,286,152,134,FMN GV 11 Ramsel
66,Bergstraat 71,2021-04-18,17:00:00,144,90,54,FMN GV 11 Ramsel
66,Bergstraat 71,2021-04-18,18:00:00,126,46,80,FMN GV 11 Ramsel
66,Bergstraat 71,2021-04-18,19:00:00,78,48,30,FMN GV 11 Ramsel
66,Bergstraat 71,2021-04-18,20:00:00,24,20,4,FMN GV 11 Ramsel
66,Bergstraat 71,2021-04-18,21:00:00,18,12,6,FMN GV 11 Ramsel
66,Bergstraat 71,2021-04-18,22:00:00,4,2,2,FMN GV 11 Ramsel
66,Bergstraat 71,2021-04-18,23:00:00,4,2,2,FMN GV 11 Ramsel
66,Bergstraat 71,2021-04-19,00:00:00,0,0,0,FMN GV 11 Ramsel
66,Bergstraat 71,2021-04-19,01:00:00,0,0,0,FMN GV 11 Ramsel
66,Bergstraat 71,2021-04-19,02:00:00,0,0,0,FMN GV 11 Ramsel
66,Bergstraat 71,2021-04-19,03:00:00,0,0,0,FMN GV 11 Ramsel
66,Bergstraat 71,2021-04-19,04:00:00,4,4,0,FMN GV 11 Ramsel
66,Bergstraat 71,2021-04-19,05:00:00,6,4,2,FMN GV 11 Ramsel
66,Bergstraat 71,2021-04-19,06:00:00,36,12,24,FMN GV 11 Ramsel
66,Bergstraat 71,2021-04-19,07:00:00,148,18,130,FMN GV 11 Ramsel
66,Bergstraat 71,2021-04-19,08:00:00,110,28,82,FMN GV 11 Ramsel
66,Bergstraat 71,2021-04-19,09:00:00,50,24,26,FMN GV 11 Ramsel
66,Bergstraat 71,2021-04-19,10:00:00,56,22,34,FMN GV 11 Ramsel
66,Bergstraat 71,2021-04-19,11:00:00,68,40,28,FMN GV 11 Ramsel
66,Bergstraat 71,2021-04-19,12:00:00,42,14,28,FMN GV 11 Ramsel
66,Bergstraat 71,2021-04-19,13:00:00,70,38,32,FMN GV 11 Ramsel
66,Bergstraat 71,2021-04-19,14:00:00,74,44,30,FMN GV 11 Ramsel
66,Bergstraat 71,2021-04-19,15:00:00,196,164,32,FMN GV 11 Ramsel
66,Bergstraat 71,2021-04-19,16:00:00,150,102,48,FMN GV 11 Ramsel
66,Bergstraat 71,2021-04-19,17:00:00,74,50,24,FMN GV 11 Ramsel
66,Bergstraat 71,2021-04-19,18:00:00,48,30,18,FMN GV 11 Ramsel
66,Bergstraat 71,2021-04-19,19:00:00,50,18,32,FMN GV 11 Ramsel
66,Bergstraat 71,2021-04-19,20:00:00,6,2,4,FMN GV 11 Ramsel
66,Bergstraat 71,2021-04-19,21:00:00,10,10,0,FMN GV 11 Ramsel
66,Bergstraat 71,2021-04-19,22:00:00,12,6,6,FMN GV 11 Ramsel
66,Bergstraat 71,2021-04-19,23:00:00,4,0,4,FMN GV 11 Ramsel
66,Bergstraat 71,2021-04-20,00:00:00,0,0,0,FMN GV 11 Ramsel
66,Bergstraat 71,2021-04-20,01:00:00,0,0,0,FMN GV 11 Ramsel
66,Bergstraat 71,2021-04-20,02:00:00,0,0,0,FMN GV 11 Ramsel
66,Bergstraat 71,2021-04-20,03:00:00,0,0,0,FMN GV 11 Ramsel
66,Bergstraat 71,2021-04-20,04:00:00,2,2,0,FMN GV 11 Ramsel
66,Bergstraat 71,2021-04-20,05:00:00,8,2,6,FMN GV 11 Ramsel
66,Bergstraat 71,2021-04-20,06:00:00,36,14,22,FMN GV 11 Ramsel
66,Bergstraat 71,2021-04-20,07:00:00,186,36,150,FMN GV 11 Ramsel
66,Bergstraat 71,2021-04-20,08:00:00,170,30,140,FMN GV 11 Ramsel
66,Bergstraat 71,2021-04-20,09:00:00,28,8,20,FMN GV 11 Ramsel
66,Bergstraat 71,2021-04-20,10:00:00,62,22,40,FMN GV 11 Ramsel
66,Bergstraat 71,2021-04-20,11:00:00,96,48,48,FMN GV 11 Ramsel
66,Bergstraat 71,2021-04-20,12:00:00,98,46,52,FMN GV 11 Ramsel
66,Bergstraat 71,2021-04-20,13:00:00,284,124,160,FMN GV 11 Ramsel
66,Bergstraat 71,2021-04-20,14:00:00,292,174,118,FMN GV 11 Ramsel
66,Bergstraat 71,2021-04-20,15:00:00,386,268,118,FMN GV 11 Ramsel
66,Bergstraat 71,2021-04-20,16:00:00,250,152,98,FMN GV 11 Ramsel
66,Bergstraat 71,2021-04-20,17:00:00,124,54,70,FMN GV 11 Ramsel
66,Bergstraat 71,2021-04-20,18:00:00,92,56,36,FMN GV 11 Ramsel
66,Bergstraat 71,2021-04-20,19:00:00,82,44,38,FMN GV 11 Ramsel
66,Bergstraat 71,2021-04-20,20:00:00,48,32,16,FMN GV 11 Ramsel
66,Bergstraat 71,2021-04-20,21:00:00,24,18,6,FMN GV 11 Ramsel
66,Bergstraat 71,2021-04-20,22:00:00,12,6,6,FMN GV 11 Ramsel
66,Bergstraat 71,2021-04-20,23:00:00,2,2,0,FMN GV 11 Ramsel
66,Bergstraat 71,2021-04-21,00:00:00,0,0,0,FMN GV 11 Ramsel
66,Bergstraat 71,2021-04-21,01:00:00,0,0,0,FMN GV 11 Ramsel
66,Bergstraat 71,2021-04-21,02:00:00,0,0,0,FMN GV 11 Ramsel
66,Bergstraat 71,2021-04-21,03:00:00,0,0,0,FMN GV 11 Ramsel
66,Bergstraat 71,2021-04-21,04:00:00,4,4,0,FMN GV 11 Ramsel
66,Bergstraat 71,2021-04-21,05:00:00,6,2,4,FMN GV 11 Ramsel
66,Bergstraat 71,2021-04-21,06:00:00,32,6,26,FMN GV 11 Ramsel
66,Bergstraat 71,2021-04-21,07:00:00,192,26,166,FMN GV 11 Ramsel
66,Bergstraat 71,2021-04-21,08:00:00,146,28,118,FMN GV 11 Ramsel
66,Bergstraat 71,2021-04-21,09:00:00,62,24,38,FMN GV 11 Ramsel
66,Bergstraat 71,2021-04-21,10:00:00,60,24,36,FMN GV 11 Ramsel
66,Bergstraat 71,2021-04-21,11:00:00,120,70,50,FMN GV 11 Ramsel
66,Bergstraat 71,2021-04-21,12:00:00,218,172,46,FMN GV 11 Ramsel
66,Bergstraat 71,2021-04-21,13:00:00,198,96,102,FMN GV 11 Ramsel
66,Bergstraat 71,2021-04-21,14:00:00,250,132,118,FMN GV 11 Ramsel
66,Bergstraat 71,2021-04-21,15:00:00,206,114,92,FMN GV 11 Ramsel
66,Bergstraat 71,2021-04-21,16:00:00,148,84,64,FMN GV 11 Ramsel
66,Bergstraat 71,2021-04-21,17:00:00,128,72,56,FMN GV 11 Ramsel
66,Bergstraat 71,2021-04-21,18:00:00,126,70,56,FMN GV 11 Ramsel
66,Bergstraat 71,2021-04-21,19:00:00,72,50,22,FMN GV 11 Ramsel
66,Bergstraat 71,2021-04-21,20:00:00,48,30,18,FMN GV 11 Ramsel
66,Bergstraat 71,2021-04-21,21:00:00,18,18,0,FMN GV 11 Ramsel
66,Bergstraat 71,2021-04-21,22:00:00,8,6,2,FMN GV 11 Ramsel
66,Bergstraat 71,2021-04-21,23:00:00,0,0,0,FMN GV 11 Ramsel
66,Bergstraat 71,2021-04-22,00:00:00,0,0,0,FMN GV 11 Ramsel
66,Bergstraat 71,2021-04-22,01:00:00,0,0,0,FMN GV 11 Ramsel
66,Bergstraat 71,2021-04-22,02:00:00,0,0,0,FMN GV 11 Ramsel
66,Bergstraat 71,2021-04-22,03:00:00,2,0,2,FMN GV 11 Ramsel
66,Bergstraat 71,2021-04-22,04:00:00,4,4,0,FMN GV 11 Ramsel
66,Bergstraat 71,2021-04-22,05:00:00,12,2,10,FMN GV 11 Ramsel
66,Bergstraat 71,2021-04-22,06:00:00,46,12,34,FMN GV 11 Ramsel
66,Bergstraat 71,2021-04-22,07:00:00,160,18,142,FMN GV 11 Ramsel
66,Bergstraat 71,2021-04-22,08:00:00,134,26,108,FMN GV 11 Ramsel
66,Bergstraat 71,2021-04-22,09:00:00,54,24,30,FMN GV 11 Ramsel
66,Bergstraat 71,2021-04-22,10:00:00,76,26,50,FMN GV 11 Ramsel
66,Bergstraat 71,2021-04-22,11:00:00,58,30,28,FMN GV 11 Ramsel
66,Bergstraat 71,2021-04-22,12:00:00,58,30,28,FMN GV 11 Ramsel
66,Bergstraat 71,2021-04-22,13:00:00,134,60,74,FMN GV 11 Ramsel
66,Bergstraat 71,2021-04-22,14:00:00,152,58,94,FMN GV 11 Ramsel
66,Bergstraat 71,2021-04-22,15:00:00,316,240,76,FMN GV 11 Ramsel
66,Bergstraat 71,2021-04-22,16:00:00,180,122,58,FMN GV 11 Ramsel
66,Bergstraat 71,2021-04-22,17:00:00,130,72,58,FMN GV 11 Ramsel
66,Bergstraat 71,2021-04-22,18:00:00,68,36,32,FMN GV 11 Ramsel
66,Bergstraat 71,2021-04-22,19:00:00,48,22,26,FMN GV 11 Ramsel
66,Bergstraat 71,2021-04-22,20:00:00,82,44,38,FMN GV 11 Ramsel
66,Bergstraat 71,2021-04-22,21:00:00,10,8,2,FMN GV 11 Ramsel
66,Bergstraat 71,2021-04-22,22:00:00,12,8,4,FMN GV 11 Ramsel
66,Bergstraat 71,2021-04-22,23:00:00,2,2,0,FMN GV 11 Ramsel
66,Bergstraat 71,2021-04-23,00:00:00,0,0,0,FMN GV 11 Ramsel
66,Bergstraat 71,2021-04-23,01:00:00,0,0,0,FMN GV 11 Ramsel
66,Bergstraat 71,2021-04-23,02:00:00,0,0,0,FMN GV 11 Ramsel
66,Bergstraat 71,2021-04-23,03:00:00,0,0,0,FMN GV 11 Ramsel
66,Bergstraat 71,2021-04-23,04:00:00,4,4,0,FMN GV 11 Ramsel
66,Bergstraat 71,2021-04-23,05:00:00,6,0,6,FMN GV 11 Ramsel
66,Bergstraat 71,2021-04-23,06:00:00,30,6,24,FMN GV 11 Ramsel
66,Bergstraat 71,2021-04-23,07:00:00,154,10,144,FMN GV 11 Ramsel
66,Bergstraat 71,2021-04-23,08:00:00,122,14,108,FMN GV 11 Ramsel
66,Bergstraat 71,2021-04-23,09:00:00,38,8,30,FMN GV 11 Ramsel
66,Bergstraat 71,2021-04-23,10:00:00,56,18,38,FMN GV 11 Ramsel
66,Bergstraat 71,2021-04-23,11:00:00,70,32,38,FMN GV 11 Ramsel
66,Bergstraat 71,2021-04-23,12:00:00,102,48,54,FMN GV 11 Ramsel
66,Bergstraat 71,2021-04-23,13:00:00,176,86,90,FMN GV 11 Ramsel
66,Bergstraat 71,2021-04-23,14:00:00,258,142,116,FMN GV 11 Ramsel
66,Bergstraat 71,2021-04-23,15:00:00,332,234,98,FMN GV 11 Ramsel
66,Bergstraat 71,2021-04-23,16:00:00,226,160,66,FMN GV 11 Ramsel
66,Bergstraat 71,2021-04-23,17:00:00,84,50,34,FMN GV 11 Ramsel
66,Bergstraat 71,2021-04-23,18:00:00,108,66,42,FMN GV 11 Ramsel
66,Bergstraat 71,2021-04-23,19:00:00,56,30,26,FMN GV 11 Ramsel
66,Bergstraat 71,2021-04-23,20:00:00,32,16,16,FMN GV 11 Ramsel
66,Bergstraat 71,2021-04-23,21:00:00,30,10,20,FMN GV 11 Ramsel
66,Bergstraat 71,2021-04-23,22:00:00,6,0,6,FMN GV 11 Ramsel
66,Bergstraat 71,2021-04-23,23:00:00,4,4,0,FMN GV 11 Ramsel
66,Bergstraat 71,2021-04-24,00:00:00,6,2,4,FMN GV 11 Ramsel
66,Bergstraat 71,2021-04-24,01:00:00,0,0,0,FMN GV 11 Ramsel
66,Bergstraat 71,2021-04-24,02:00:00,0,0,0,FMN GV 11 Ramsel
66,Bergstraat 71,2021-04-24,03:00:00,0,0,0,FMN GV 11 Ramsel
66,Bergstraat 71,2021-04-24,04:00:00,0,0,0,FMN GV 11 Ramsel
66,Bergstraat 71,2021-04-24,05:00:00,0,0,0,FMN GV 11 Ramsel
66,Bergstraat 71,2021-04-24,06:00:00,0,0,0,FMN GV 11 Ramsel
66,Bergstraat 71,2021-04-24,07:00:00,22,6,16,FMN GV 11 Ramsel
66,Bergstraat 71,2021-04-24,08:00:00,24,12,12,FMN GV 11 Ramsel
66,Bergstraat 71,2021-04-24,09:00:00,68,18,50,FMN GV 11 Ramsel
66,Bergstraat 71,2021-04-24,10:00:00,84,40,44,FMN GV 11 Ramsel
66,Bergstraat 71,2021-04-24,11:00:00,126,58,68,FMN GV 11 Ramsel
66,Bergstraat 71,2021-04-24,12:00:00,122,58,64,FMN GV 11 Ramsel
66,Bergstraat 71,2021-04-24,13:00:00,262,122,140,FMN GV 11 Ramsel
66,Bergstraat 71,2021-04-24,14:00:00,330,140,190,FMN GV 11 Ramsel
66,Bergstraat 71,2021-04-24,15:00:00,322,146,176,FMN GV 11 Ramsel
66,Bergstraat 71,2021-04-24,16:00:00,316,194,122,FMN GV 11 Ramsel
66,Bergstraat 71,2021-04-24,17:00:00,138,74,64,FMN GV 11 Ramsel
66,Bergstraat 71,2021-04-24,18:00:00,78,52,26,FMN GV 11 Ramsel
66,Bergstraat 71,2021-04-24,19:00:00,66,32,34,FMN GV 11 Ramsel
66,Bergstraat 71,2021-04-24,20:00:00,30,8,22,FMN GV 11 Ramsel
66,Bergstraat 71,2021-04-24,21:00:00,16,2,14,FMN GV 11 Ramsel
66,Bergstraat 71,2021-04-24,22:00:00,6,4,2,FMN GV 11 Ramsel
66,Bergstraat 71,2021-04-24,23:00:00,2,0,2,FMN GV 11 Ramsel
66,Bergstraat 71,2021-04-25,00:00:00,8,8,0,FMN GV 11 Ramsel
66,Bergstraat 71,2021-04-25,01:00:00,0,0,0,FMN GV 11 Ramsel
66,Bergstraat 71,2021-04-25,02:00:00,0,0,0,FMN GV 11 Ramsel
66,Bergstraat 71,2021-04-25,03:00:00,0,0,0,FMN GV 11 Ramsel
66,Bergstraat 71,2021-04-25,04:00:00,0,0,0,FMN GV 11 Ramsel
66,Bergstraat 71,2021-04-25,05:00:00,2,0,2,FMN GV 11 Ramsel
66,Bergstraat 71,2021-04-25,06:00:00,4,4,0,FMN GV 11 Ramsel
66,Bergstraat 71,2021-04-25,07:00:00,40,8,32,FMN GV 11 Ramsel
66,Bergstraat 71,2021-04-25,08:00:00,102,32,70,FMN GV 11 Ramsel
66,Bergstraat 71,2021-04-25,09:00:00,192,94,98,FMN GV 11 Ramsel
66,Bergstraat 71,2021-04-25,10:00:00,218,134,84,FMN GV 11 Ramsel
66,Bergstraat 71,2021-04-25,11:00:00,256,156,100,FMN GV 11 Ramsel
66,Bergstraat 71,2021-04-25,12:00:00,174,118,56,FMN GV 11 Ramsel
66,Bergstraat 71,2021-04-25,13:00:00,198,106,92,FMN GV 11 Ramsel
66,Bergstraat 71,2021-04-25,14:00:00,232,102,130,FMN GV 11 Ramsel
66,Bergstraat 71,2021-04-25,15:00:00,286,122,164,FMN GV 11 Ramsel
66,Bergstraat 71,2021-04-25,16:00:00,188,88,100,FMN GV 11 Ramsel
66,Bergstraat 71,2021-04-25,17:00:00,142,74,68,FMN GV 11 Ramsel
66,Bergstraat 71,2021-04-25,18:00:00,88,44,44,FMN GV 11 Ramsel
66,Bergstraat 71,2021-04-25,19:00:00,40,14,26,FMN GV 11 Ramsel
66,Bergstraat 71,2021-04-25,20:00:00,28,12,16,FMN GV 11 Ramsel
66,Bergstraat 71,2021-04-25,21:00:00,10,6,4,FMN GV 11 Ramsel
66,Bergstraat 71,2021-04-25,22:00:00,4,2,2,FMN GV 11 Ramsel
66,Bergstraat 71,2021-04-25,23:00:00,2,2,0,FMN GV 11 Ramsel
66,Bergstraat 71,2021-04-26,00:00:00,0,0,0,FMN GV 11 Ramsel
66,Bergstraat 71,2021-04-26,01:00:00,0,0,0,FMN GV 11 Ramsel
66,Bergstraat 71,2021-04-26,02:00:00,0,0,0,FMN GV 11 Ramsel
66,Bergstraat 71,2021-04-26,03:00:00,0,0,0,FMN GV 11 Ramsel
66,Bergstraat 71,2021-04-26,04:00:00,6,4,2,FMN GV 11 Ramsel
66,Bergstraat 71,2021-04-26,05:00:00,8,2,6,FMN GV 11 Ramsel
66,Bergstraat 71,2021-04-26,06:00:00,42,20,22,FMN GV 11 Ramsel
66,Bergstraat 71,2021-04-26,07:00:00,188,18,170,FMN GV 11 Ramsel
66,Bergstraat 71,2021-04-26,08:00:00,164,26,138,FMN GV 11 Ramsel
66,Bergstraat 71,2021-04-26,09:00:00,46,22,24,FMN GV 11 Ramsel
66,Bergstraat 71,2021-04-26,10:00:00,48,28,20,FMN GV 11 Ramsel
66,Bergstraat 71,2021-04-26,11:00:00,52,36,16,FMN GV 11 Ramsel
66,Bergstraat 71,2021-04-26,12:00:00,98,42,56,FMN GV 11 Ramsel
66,Bergstraat 71,2021-04-26,13:00:00,158,70,88,FMN GV 11 Ramsel
66,Bergstraat 71,2021-04-26,14:00:00,150,76,74,FMN GV 11 Ramsel
66,Bergstraat 71,2021-04-26,15:00:00,252,172,80,FMN GV 11 Ramsel
66,Bergstraat 71,2021-04-26,16:00:00,232,160,72,FMN GV 11 Ramsel
66,Bergstraat 71,2021-04-26,17:00:00,98,50,48,FMN GV 11 Ramsel
66,Bergstraat 71,2021-04-26,18:00:00,74,40,34,FMN GV 11 Ramsel
66,Bergstraat 71,2021-04-26,19:00:00,50,22,28,FMN GV 11 Ramsel
66,Bergstraat 71,2021-04-26,20:00:00,32,14,18,FMN GV 11 Ramsel
66,Bergstraat 71,2021-04-26,21:00:00,8,8,0,FMN GV 11 Ramsel
66,Bergstraat 71,2021-04-26,22:00:00,12,8,4,FMN GV 11 Ramsel
66,Bergstraat 71,2021-04-26,23:00:00,2,0,2,FMN GV 11 Ramsel
66,Bergstraat 71,2021-04-27,00:00:00,0,0,0,FMN GV 11 Ramsel
66,Bergstraat 71,2021-04-27,01:00:00,2,2,0,FMN GV 11 Ramsel
66,Bergstraat 71,2021-04-27,02:00:00,0,0,0,FMN GV 11 Ramsel
66,Bergstraat 71,2021-04-27,03:00:00,0,0,0,FMN GV 11 Ramsel
66,Bergstraat 71,2021-04-27,04:00:00,6,4,2,FMN GV 11 Ramsel
66,Bergstraat 71,2021-04-27,05:00:00,8,4,4,FMN GV 11 Ramsel
66,Bergstraat 71,2021-04-27,06:00:00,34,16,18,FMN GV 11 Ramsel
66,Bergstraat 71,2021-04-27,07:00:00,162,22,140,FMN GV 11 Ramsel
66,Bergstraat 71,2021-04-27,08:00:00,166,24,142,FMN GV 11 Ramsel
66,Bergstraat 71,2021-04-27,09:00:00,44,18,26,FMN GV 11 Ramsel
66,Bergstraat 71,2021-04-27,10:00:00,98,34,64,FMN GV 11 Ramsel
66,Bergstraat 71,2021-04-27,11:00:00,88,54,34,FMN GV 11 Ramsel
66,Bergstraat 71,2021-04-27,12:00:00,124,68,56,FMN GV 11 Ramsel
66,Bergstraat 71,2021-04-27,13:00:00,274,142,132,FMN GV 11 Ramsel
66,Bergstraat 71,2021-04-27,14:00:00,250,108,142,FMN GV 11 Ramsel
66,Bergstraat 71,2021-04-27,15:00:00,386,274,112,FMN GV 11 Ramsel
66,Bergstraat 71,2021-04-27,16:00:00,290,166,124,FMN GV 11 Ramsel
66,Bergstraat 71,2021-04-27,17:00:00,184,94,90,FMN GV 11 Ramsel
66,Bergstraat 71,2021-04-27,18:00:00,112,62,50,FMN GV 11 Ramsel
66,Bergstraat 71,2021-04-27,19:00:00,88,54,34,FMN GV 11 Ramsel
66,Bergstraat 71,2021-04-27,20:00:00,72,36,36,FMN GV 11 Ramsel
66,Bergstraat 71,2021-04-27,21:00:00,22,22,0,FMN GV 11 Ramsel
66,Bergstraat 71,2021-04-27,22:00:00,14,10,4,FMN GV 11 Ramsel
66,Bergstraat 71,2021-04-27,23:00:00,0,0,0,FMN GV 11 Ramsel
66,Bergstraat 71,2021-04-28,00:00:00,0,0,0,FMN GV 11 Ramsel
66,Bergstraat 71,2021-04-28,01:00:00,0,0,0,FMN GV 11 Ramsel
66,Bergstraat 71,2021-04-28,02:00:00,0,0,0,FMN GV 11 Ramsel
66,Bergstraat 71,2021-04-28,03:00:00,0,0,0,FMN GV 11 Ramsel
66,Bergstraat 71,2021-04-28,04:00:00,6,6,0,FMN GV 11 Ramsel
66,Bergstraat 71,2021-04-28,05:00:00,16,8,8,FMN GV 11 Ramsel
66,Bergstraat 71,2021-04-28,06:00:00,46,20,26,FMN GV 11 Ramsel
66,Bergstraat 71,2021-04-28,07:00:00,152,20,132,FMN GV 11 Ramsel
66,Bergstraat 71,2021-04-28,08:00:00,156,28,128,FMN GV 11 Ramsel
66,Bergstraat 71,2021-04-28,09:00:00,46,20,26,FMN GV 11 Ramsel
66,Bergstraat 71,2021-04-28,10:00:00,80,28,52,FMN GV 11 Ramsel
66,Bergstraat 71,2021-04-28,11:00:00,112,58,54,FMN GV 11 Ramsel
66,Bergstraat 71,2021-04-28,12:00:00,274,188,86,FMN GV 11 Ramsel
66,Bergstraat 71,2021-04-28,13:00:00,268,124,144,FMN GV 11 Ramsel
66,Bergstraat 71,2021-04-28,14:00:00,380,180,200,FMN GV 11 Ramsel
66,Bergstraat 71,2021-04-28,15:00:00,334,146,188,FMN GV 11 Ramsel
66,Bergstraat 71,2021-04-28,16:00:00,266,134,132,FMN GV 11 Ramsel
66,Bergstraat 71,2021-04-28,17:00:00,190,110,80,FMN GV 11 Ramsel
66,Bergstraat 71,2021-04-28,18:00:00,158,86,72,FMN GV 11 Ramsel
66,Bergstraat 71,2021-04-28,19:00:00,126,72,54,FMN GV 11 Ramsel
66,Bergstraat 71,2021-04-28,20:00:00,42,28,14,FMN GV 11 Ramsel
66,Bergstraat 71,2021-04-28,21:00:00,14,8,6,FMN GV 11 Ramsel
66,Bergstraat 71,2021-04-28,22:00:00,26,22,4,FMN GV 11 Ramsel
66,Bergstraat 71,2021-04-28,23:00:00,2,2,0,FMN GV 11 Ramsel
66,Bergstraat 71,2021-04-29,00:00:00,0,0,0,FMN GV 11 Ramsel
66,Bergstraat 71,2021-04-29,01:00:00,0,0,0,FMN GV 11 Ramsel
66,Bergstraat 71,2021-04-29,02:00:00,0,0,0,FMN GV 11 Ramsel
66,Bergstraat 71,2021-04-29,03:00:00,0,0,0,FMN GV 11 Ramsel
66,Bergstraat 71,2021-04-29,04:00:00,2,2,0,FMN GV 11 Ramsel
66,Bergstraat 71,2021-04-29,05:00:00,10,8,2,FMN GV 11 Ramsel
66,Bergstraat 71,2021-04-29,06:00:00,32,8,24,FMN GV 11 Ramsel
66,Bergstraat 71,2021-04-29,07:00:00,130,12,118,FMN GV 11 Ramsel
66,Bergstraat 71,2021-04-29,08:00:00,118,12,106,FMN GV 11 Ramsel
66,Bergstraat 71,2021-04-29,09:00:00,40,12,28,FMN GV 11 Ramsel
66,Bergstraat 71,2021-04-29,10:00:00,34,18,16,FMN GV 11 Ramsel
66,Bergstraat 71,2021-04-29,11:00:00,16,4,12,FMN GV 11 Ramsel
66,Bergstraat 71,2021-04-29,12:00:00,34,26,8,FMN GV 11 Ramsel
66,Bergstraat 71,2021-04-29,13:00:00,46,20,26,FMN GV 11 Ramsel
66,Bergstraat 71,2021-04-29,14:00:00,30,12,18,FMN GV 11 Ramsel
66,Bergstraat 71,2021-04-29,15:00:00,144,122,22,FMN GV 11 Ramsel
66,Bergstraat 71,2021-04-29,16:00:00,118,100,18,FMN GV 11 Ramsel
66,Bergstraat 71,2021-04-29,17:00:00,62,40,22,FMN GV 11 Ramsel
66,Bergstraat 71,2021-04-29,18:00:00,50,26,24,FMN GV 11 Ramsel
66,Bergstraat 71,2021-04-29,19:00:00,30,22,8,FMN GV 11 Ramsel
66,Bergstraat 71,2021-04-29,20:00:00,32,20,12,FMN GV 11 Ramsel
66,Bergstraat 71,2021-04-29,21:00:00,10,4,6,FMN GV 11 Ramsel
66,Bergstraat 71,2021-04-29,22:00:00,10,6,4,FMN GV 11 Ramsel
66,Bergstraat 71,2021-04-29,23:00:00,6,2,4,FMN GV 11 Ramsel
66,Bergstraat 71,2021-04-30,00:00:00,0,0,0,FMN GV 11 Ramsel
66,Bergstraat 71,2021-04-30,01:00:00,0,0,0,FMN GV 11 Ramsel
66,Bergstraat 71,2021-04-30,02:00:00,0,0,0,FMN GV 11 Ramsel
66,Bergstraat 71,2021-04-30,03:00:00,0,0,0,FMN GV 11 Ramsel
66,Bergstraat 71,2021-04-30,04:00:00,2,2,0,FMN GV 11 Ramsel
66,Bergstraat 71,2021-04-30,05:00:00,4,2,2,FMN GV 11 Ramsel
66,Bergstraat 71,2021-04-30,06:00:00,24,8,16,FMN GV 11 Ramsel
66,Bergstraat 71,2021-04-30,07:00:00,152,22,130,FMN GV 11 Ramsel
66,Bergstraat 71,2021-04-30,08:00:00,98,8,90,FMN GV 11 Ramsel
66,Bergstraat 71,2021-04-30,09:00:00,58,16,42,FMN GV 11 Ramsel
66,Bergstraat 71,2021-04-30,10:00:00,60,40,20,FMN GV 11 Ramsel
66,Bergstraat 71,2021-04-30,11:00:00,70,38,32,FMN GV 11 Ramsel
66,Bergstraat 71,2021-04-30,12:00:00,78,30,48,FMN GV 11 Ramsel
66,Bergstraat 71,2021-04-30,13:00:00,106,58,48,FMN GV 11 Ramsel
66,Bergstraat 71,2021-04-30,14:00:00,130,70,60,FMN GV 11 Ramsel
66,Bergstraat 71,2021-04-30,15:00:00,220,144,76,FMN GV 11 Ramsel
66,Bergstraat 71,2021-04-30,16:00:00,186,136,50,FMN GV 11 Ramsel
66,Bergstraat 71,2021-04-30,17:00:00,74,54,20,FMN GV 11 Ramsel
66,Bergstraat 71,2021-04-30,18:00:00,64,48,16,FMN GV 11 Ramsel
66,Bergstraat 71,2021-04-30,19:00:00,30,12,18,FMN GV 11 Ramsel
66,Bergstraat 71,2021-04-30,20:00:00,20,2,18,FMN GV 11 Ramsel
66,Bergstraat 71,2021-04-30,21:00:00,12,6,6,FMN GV 11 Ramsel
66,Bergstraat 71,2021-04-30,22:00:00,14,8,6,FMN GV 11 Ramsel
66,Bergstraat 71,2021-04-30,23:00:00,4,4,0,FMN GV 11 Ramsel
66,Bergstraat 71,2021-05-01,00:00:00,2,2,0,FMN GV 11 Ramsel
66,Bergstraat 71,2021-05-01,01:00:00,2,2,0,FMN GV 11 Ramsel
66,Bergstraat 71,2021-05-01,02:00:00,0,0,0,FMN GV 11 Ramsel
66,Bergstraat 71,2021-05-01,03:00:00,0,0,0,FMN GV 11 Ramsel
66,Bergstraat 71,2021-05-01,04:00:00,0,0,0,FMN GV 11 Ramsel
66,Bergstraat 71,2021-05-01,05:00:00,0,0,0,FMN GV 11 Ramsel
66,Bergstraat 71,2021-05-01,06:00:00,6,2,4,FMN GV 11 Ramsel
66,Bergstraat 71,2021-05-01,07:00:00,24,8,16,FMN GV 11 Ramsel
66,Bergstraat 71,2021-05-01,08:00:00,24,6,18,FMN GV 11 Ramsel
66,Bergstraat 71,2021-05-01,09:00:00,86,30,56,FMN GV 11 Ramsel
66,Bergstraat 71,2021-05-01,10:00:00,164,100,64,FMN GV 11 Ramsel
66,Bergstraat 71,2021-05-01,11:00:00,126,56,70,FMN GV 11 Ramsel
66,Bergstraat 71,2021-05-01,12:00:00,174,76,98,FMN GV 11 Ramsel
66,Bergstraat 71,2021-05-01,13:00:00,230,86,144,FMN GV 11 Ramsel
66,Bergstraat 71,2021-05-01,14:00:00,296,152,144,FMN GV 11 Ramsel
66,Bergstraat 71,2021-05-01,15:00:00,308,156,152,FMN GV 11 Ramsel
66,Bergstraat 71,2021-05-01,16:00:00,224,132,92,FMN GV 11 Ramsel
66,Bergstraat 71,2021-05-01,17:00:00,88,58,30,FMN GV 11 Ramsel
66,Bergstraat 71,2021-05-01,18:00:00,54,28,26,FMN GV 11 Ramsel
66,Bergstraat 71,2021-05-01,19:00:00,34,14,20,FMN GV 11 Ramsel
66,Bergstraat 71,2021-05-01,20:00:00,10,6,4,FMN GV 11 Ramsel
66,Bergstraat 71,2021-05-01,21:00:00,16,6,10,FMN GV 11 Ramsel
66,Bergstraat 71,2021-05-01,22:00:00,10,2,8,FMN GV 11 Ramsel
66,Bergstraat 71,2021-05-01,23:00:00,14,6,8,FMN GV 11 Ramsel
66,Bergstraat 71,2021-05-02,00:00:00,6,6,0,FMN GV 11 Ramsel
66,Bergstraat 71,2021-05-02,01:00:00,4,4,0,FMN GV 11 Ramsel
66,Bergstraat 71,2021-05-02,02:00:00,0,0,0,FMN GV 11 Ramsel
66,Bergstraat 71,2021-05-02,03:00:00,0,0,0,FMN GV 11 Ramsel
66,Bergstraat 71,2021-05-02,04:00:00,0,0,0,FMN GV 11 Ramsel
66,Bergstraat 71,2021-05-02,05:00:00,0,0,0,FMN GV 11 Ramsel
66,Bergstraat 71,2021-05-02,06:00:00,0,0,0,FMN GV 11 Ramsel
66,Bergstraat 71,2021-05-02,07:00:00,26,4,22,FMN GV 11 Ramsel
66,Bergstraat 71,2021-05-02,08:00:00,116,50,66,FMN GV 11 Ramsel
66,Bergstraat 71,2021-05-02,09:00:00,186,60,126,FMN GV 11 Ramsel
66,Bergstraat 71,2021-05-02,10:00:00,252,136,116,FMN GV 11 Ramsel
66,Bergstraat 71,2021-05-02,11:00:00,216,122,94,FMN GV 11 Ramsel
66,Bergstraat 71,2021-05-02,12:00:00,224,146,78,FMN GV 11 Ramsel
66,Bergstraat 71,2021-05-02,13:00:00,118,76,42,FMN GV 11 Ramsel
66,Bergstraat 71,2021-05-02,14:00:00,154,76,78,FMN GV 11 Ramsel
66,Bergstraat 71,2021-05-02,15:00:00,152,74,78,FMN GV 11 Ramsel
66,Bergstraat 71,2021-05-02,16:00:00,100,32,68,FMN GV 11 Ramsel
66,Bergstraat 71,2021-05-02,17:00:00,78,52,26,FMN GV 11 Ramsel
66,Bergstraat 71,2021-05-02,18:00:00,50,32,18,FMN GV 11 Ramsel
66,Bergstraat 71,2021-05-02,19:00:00,44,22,22,FMN GV 11 Ramsel
66,Bergstraat 71,2021-05-02,20:00:00,22,12,10,FMN GV 11 Ramsel
66,Bergstraat 71,2021-05-02,21:00:00,12,12,0,FMN GV 11 Ramsel
66,Bergstraat 71,2021-05-02,22:00:00,4,0,4,FMN GV 11 Ramsel
66,Bergstraat 71,2021-05-02,23:00:00,10,6,4,FMN GV 11 Ramsel
66,Bergstraat 71,2021-05-03,00:00:00,0,0,0,FMN GV 11 Ramsel
66,Bergstraat 71,2021-05-03,01:00:00,0,0,0,FMN GV 11 Ramsel
66,Bergstraat 71,2021-05-03,02:00:00,0,0,0,FMN GV 11 Ramsel
66,Bergstraat 71,2021-05-03,03:00:00,2,0,2,FMN GV 11 Ramsel
66,Bergstraat 71,2021-05-03,04:00:00,2,2,0,FMN GV 11 Ramsel
66,Bergstraat 71,2021-05-03,05:00:00,4,2,2,FMN GV 11 Ramsel
66,Bergstraat 71,2021-05-03,06:00:00,38,14,24,FMN GV 11 Ramsel
66,Bergstraat 71,2021-05-03,07:00:00,122,18,104,FMN GV 11 Ramsel
66,Bergstraat 71,2021-05-03,08:00:00,132,16,116,FMN GV 11 Ramsel
66,Bergstraat 71,2021-05-03,09:00:00,54,10,44,FMN GV 11 Ramsel
66,Bergstraat 71,2021-05-03,10:00:00,80,42,38,FMN GV 11 Ramsel
66,Bergstraat 71,2021-05-03,11:00:00,68,32,36,FMN GV 11 Ramsel
66,Bergstraat 71,2021-05-03,12:00:00,116,70,46,FMN GV 11 Ramsel
66,Bergstraat 71,2021-05-03,13:00:00,150,66,84,FMN GV 11 Ramsel
66,Bergstraat 71,2021-05-03,14:00:00,176,124,52,FMN GV 11 Ramsel
66,Bergstraat 71,2021-05-03,15:00:00,306,226,80,FMN GV 11 Ramsel
66,Bergstraat 71,2021-05-03,16:00:00,190,132,58,FMN GV 11 Ramsel
66,Bergstraat 71,2021-05-03,17:00:00,56,40,16,FMN GV 11 Ramsel
66,Bergstraat 71,2021-05-03,18:00:00,60,30,30,FMN GV 11 Ramsel
66,Bergstraat 71,2021-05-03,19:00:00,50,36,14,FMN GV 11 Ramsel
66,Bergstraat 71,2021-05-03,20:00:00,40,16,24,FMN GV 11 Ramsel
66,Bergstraat 71,2021-05-03,21:00:00,20,14,6,FMN GV 11 Ramsel
66,Bergstraat 71,2021-05-03,22:00:00,8,2,6,FMN GV 11 Ramsel
66,Bergstraat 71,2021-05-03,23:00:00,4,2,2,FMN GV 11 Ramsel
66,Bergstraat 71,2021-05-04,00:00:00,0,0,0,FMN GV 11 Ramsel
66,Bergstraat 71,2021-05-04,01:00:00,0,0,0,FMN GV 11 Ramsel
66,Bergstraat 71,2021-05-04,02:00:00,0,0,0,FMN GV 11 Ramsel
66,Bergstraat 71,2021-05-04,03:00:00,0,0,0,FMN GV 11 Ramsel
66,Bergstraat 71,2021-05-04,04:00:00,2,0,2,FMN GV 11 Ramsel
66,Bergstraat 71,2021-05-04,05:00:00,10,6,4,FMN GV 11 Ramsel
66,Bergstraat 71,2021-05-04,06:00:00,28,8,20,FMN GV 11 Ramsel
66,Bergstraat 71,2021-05-04,07:00:00,66,4,62,FMN GV 11 Ramsel
66,Bergstraat 71,2021-05-04,08:00:00,62,6,56,FMN GV 11 Ramsel
66,Bergstraat 71,2021-05-04,09:00:00,12,4,8,FMN GV 11 Ramsel
66,Bergstraat 71,2021-05-04,10:00:00,6,0,6,FMN GV 11 Ramsel
66,Bergstraat 71,2021-05-04,11:00:00,8,2,6,FMN GV 11 Ramsel
66,Bergstraat 71,2021-05-04,12:00:00,12,8,4,FMN GV 11 Ramsel
66,Bergstraat 71,2021-05-04,13:00:00,24,22,2,FMN GV 11 Ramsel
66,Bergstraat 71,2021-05-04,14:00:00,24,14,10,FMN GV 11 Ramsel
66,Bergstraat 71,2021-05-04,15:00:00,110,94,16,FMN GV 11 Ramsel
66,Bergstraat 71,2021-05-04,16:00:00,42,32,10,FMN GV 11 Ramsel
66,Bergstraat 71,2021-05-04,17:00:00,38,24,14,FMN GV 11 Ramsel
66,Bergstraat 71,2021-05-04,18:00:00,12,6,6,FMN GV 11 Ramsel
66,Bergstraat 71,2021-05-04,19:00:00,4,2,2,FMN GV 11 Ramsel
66,Bergstraat 71,2021-05-04,20:00:00,14,6,8,FMN GV 11 Ramsel
66,Bergstraat 71,2021-05-04,21:00:00,6,4,2,FMN GV 11 Ramsel
66,Bergstraat 71,2021-05-04,22:00:00,8,4,4,FMN GV 11 Ramsel
66,Bergstraat 71,2021-05-04,23:00:00,0,0,0,FMN GV 11 Ramsel
66,Bergstraat 71,2021-05-05,00:00:00,0,0,0,FMN GV 11 Ramsel
66,Bergstraat 71,2021-05-05,01:00:00,0,0,0,FMN GV 11 Ramsel
66,Bergstraat 71,2021-05-05,02:00:00,0,0,0,FMN GV 11 Ramsel
66,Bergstraat 71,2021-05-05,03:00:00,0,0,0,FMN GV 11 Ramsel
66,Bergstraat 71,2021-05-05,04:00:00,0,0,0,FMN GV 11 Ramsel
66,Bergstraat 71,2021-05-05,05:00:00,2,0,2,FMN GV 11 Ramsel
66,Bergstraat 71,2021-05-05,06:00:00,20,8,12,FMN GV 11 Ramsel
66,Bergstraat 71,2021-05-05,07:00:00,94,10,84,FMN GV 11 Ramsel
66,Bergstraat 71,2021-05-05,08:00:00,50,4,46,FMN GV 11 Ramsel
66,Bergstraat 71,2021-05-05,09:00:00,16,6,10,FMN GV 11 Ramsel
66,Bergstraat 71,2021-05-05,10:00:00,10,0,10,FMN GV 11 Ramsel
66,Bergstraat 71,2021-05-05,11:00:00,32,24,8,FMN GV 11 Ramsel
66,Bergstraat 71,2021-05-05,12:00:00,112,102,10,FMN GV 11 Ramsel
66,Bergstraat 71,2021-05-05,13:00:00,46,16,30,FMN GV 11 Ramsel
66,Bergstraat 71,2021-05-05,14:00:00,68,32,36,FMN GV 11 Ramsel
66,Bergstraat 71,2021-05-05,15:00:00,94,44,50,FMN GV 11 Ramsel
66,Bergstraat 71,2021-05-05,16:00:00,90,60,30,FMN GV 11 Ramsel
66,Bergstraat 71,2021-05-05,17:00:00,78,44,34,FMN GV 11 Ramsel
66,Bergstraat 71,2021-05-05,18:00:00,60,22,38,FMN GV 11 Ramsel
66,Bergstraat 71,2021-05-05,19:00:00,52,28,24,FMN GV 11 Ramsel
66,Bergstraat 71,2021-05-05,20:00:00,32,10,22,FMN GV 11 Ramsel
66,Bergstraat 71,2021-05-05,21:00:00,20,16,4,FMN GV 11 Ramsel
66,Bergstraat 71,2021-05-05,22:00:00,14,6,8,FMN GV 11 Ramsel
66,Bergstraat 71,2021-05-05,23:00:00,0,0,0,FMN GV 11 Ramsel
66,Bergstraat 71,2021-05-06,00:00:00,0,0,0,FMN GV 11 Ramsel
66,Bergstraat 71,2021-05-06,01:00:00,0,0,0,FMN GV 11 Ramsel
66,Bergstraat 71,2021-05-06,02:00:00,0,0,0,FMN GV 11 Ramsel
66,Bergstraat 71,2021-05-06,03:00:00,0,0,0,FMN GV 11 Ramsel
66,Bergstraat 71,2021-05-06,04:00:00,2,2,0,FMN GV 11 Ramsel
66,Bergstraat 71,2021-05-06,05:00:00,4,2,2,FMN GV 11 Ramsel
66,Bergstraat 71,2021-05-06,06:00:00,26,8,18,FMN GV 11 Ramsel
66,Bergstraat 71,2021-05-06,07:00:00,110,12,98,FMN GV 11 Ramsel
66,Bergstraat 71,2021-05-06,08:00:00,130,26,104,FMN GV 11 Ramsel
66,Bergstraat 71,2021-05-06,09:00:00,46,12,34,FMN GV 11 Ramsel
66,Bergstraat 71,2021-05-06,10:00:00,76,30,46,FMN GV 11 Ramsel
66,Bergstraat 71,2021-05-06,11:00:00,44,24,20,FMN GV 11 Ramsel
66,Bergstraat 71,2021-05-06,12:00:00,66,40,26,FMN GV 11 Ramsel
66,Bergstraat 71,2021-05-06,13:00:00,78,40,38,FMN GV 11 Ramsel
66,Bergstraat 71,2021-05-06,14:00:00,74,30,44,FMN GV 11 Ramsel
66,Bergstraat 71,2021-05-06,15:00:00,200,170,30,FMN GV 11 Ramsel
66,Bergstraat 71,2021-05-06,16:00:00,76,54,22,FMN GV 11 Ramsel
66,Bergstraat 71,2021-05-06,17:00:00,58,22,36,FMN GV 11 Ramsel
66,Bergstraat 71,2021-05-06,18:00:00,52,26,26,FMN GV 11 Ramsel
66,Bergstraat 71,2021-05-06,19:00:00,20,16,4,FMN GV 11 Ramsel
66,Bergstraat 71,2021-05-06,20:00:00,8,6,2,FMN GV 11 Ramsel
66,Bergstraat 71,2021-05-06,21:00:00,0,0,0,FMN GV 11 Ramsel
66,Bergstraat 71,2021-05-06,22:00:00,6,4,2,FMN GV 11 Ramsel
66,Bergstraat 71,2021-05-06,23:00:00,0,0,0,FMN GV 11 Ramsel
66,Bergstraat 71,2021-05-07,00:00:00,2,2,0,FMN GV 11 Ramsel
66,Bergstraat 71,2021-05-07,01:00:00,0,0,0,FMN GV 11 Ramsel
66,Bergstraat 71,2021-05-07,02:00:00,0,0,0,FMN GV 11 Ramsel
66,Bergstraat 71,2021-05-07,03:00:00,0,0,0,FMN GV 11 Ramsel
66,Bergstraat 71,2021-05-07,04:00:00,6,4,2,FMN GV 11 Ramsel
66,Bergstraat 71,2021-05-07,05:00:00,4,0,4,FMN GV 11 Ramsel
66,Bergstraat 71,2021-05-07,06:00:00,12,4,8,FMN GV 11 Ramsel
66,Bergstraat 71,2021-05-07,07:00:00,88,4,84,FMN GV 11 Ramsel
66,Bergstraat 71,2021-05-07,08:00:00,88,8,80,FMN GV 11 Ramsel
66,Bergstraat 71,2021-05-07,09:00:00,28,10,18,FMN GV 11 Ramsel
66,Bergstraat 71,2021-05-07,10:00:00,24,6,18,FMN GV 11 Ramsel
66,Bergstraat 71,2021-05-07,11:00:00,62,26,36,FMN GV 11 Ramsel
66,Bergstraat 71,2021-05-07,12:00:00,64,16,48,FMN GV 11 Ramsel
66,Bergstraat 71,2021-05-07,13:00:00,80,44,36,FMN GV 11 Ramsel
66,Bergstraat 71,2021-05-07,14:00:00,164,90,74,FMN GV 11 Ramsel
66,Bergstraat 71,2021-05-07,15:00:00,278,200,78,FMN GV 11 Ramsel
66,Bergstraat 71,2021-05-07,16:00:00,150,90,60,FMN GV 11 Ramsel
66,Bergstraat 71,2021-05-07,17:00:00,74,48,26,FMN GV 11 Ramsel
66,Bergstraat 71,2021-05-07,18:00:00,70,50,20,FMN GV 11 Ramsel
66,Bergstraat 71,2021-05-07,19:00:00,32,10,22,FMN GV 11 Ramsel
66,Bergstraat 71,2021-05-07,20:00:00,50,26,24,FMN GV 11 Ramsel
66,Bergstraat 71,2021-05-07,21:00:00,28,10,18,FMN GV 11 Ramsel
66,Bergstraat 71,2021-05-07,22:00:00,8,4,4,FMN GV 11 Ramsel
66,Bergstraat 71,2021-05-07,23:00:00,2,0,2,FMN GV 11 Ramsel
66,Bergstraat 71,2021-05-08,00:00:00,6,6,0,FMN GV 11 Ramsel
66,Bergstraat 71,2021-05-08,01:00:00,0,0,0,FMN GV 11 Ramsel
66,Bergstraat 71,2021-05-08,02:00:00,2,2,0,FMN GV 11 Ramsel
66,Bergstraat 71,2021-05-08,03:00:00,0,0,0,FMN GV 11 Ramsel
66,Bergstraat 71,2021-05-08,04:00:00,0,0,0,FMN GV 11 Ramsel
66,Bergstraat 71,2021-05-08,05:00:00,0,0,0,FMN GV 11 Ramsel
66,Bergstraat 71,2021-05-08,06:00:00,4,2,2,FMN GV 11 Ramsel
66,Bergstraat 71,2021-05-08,07:00:00,30,10,20,FMN GV 11 Ramsel
66,Bergstraat 71,2021-05-08,08:00:00,38,18,20,FMN GV 11 Ramsel
66,Bergstraat 71,2021-05-08,09:00:00,72,38,34,FMN GV 11 Ramsel
66,Bergstraat 71,2021-05-08,10:00:00,68,28,40,FMN GV 11 Ramsel
66,Bergstraat 71,2021-05-08,11:00:00,26,12,14,FMN GV 11 Ramsel
66,Bergstraat 71,2021-05-08,12:00:00,40,20,20,FMN GV 11 Ramsel
66,Bergstraat 71,2021-05-08,13:00:00,54,30,24,FMN GV 11 Ramsel
66,Bergstraat 71,2021-05-08,14:00:00,84,44,40,FMN GV 11 Ramsel
66,Bergstraat 71,2021-05-08,15:00:00,88,36,52,FMN GV 11 Ramsel
66,Bergstraat 71,2021-05-08,16:00:00,86,40,46,FMN GV 11 Ramsel
66,Bergstraat 71,2021-05-08,17:00:00,84,48,36,FMN GV 11 Ramsel
66,Bergstraat 71,2021-05-08,18:00:00,66,32,34,FMN GV 11 Ramsel
66,Bergstraat 71,2021-05-08,19:00:00,58,20,38,FMN GV 11 Ramsel
66,Bergstraat 71,2021-05-08,20:00:00,18,4,14,FMN GV 11 Ramsel
66,Bergstraat 71,2021-05-08,21:00:00,20,16,4,FMN GV 11 Ramsel
66,Bergstraat 71,2021-05-08,22:00:00,16,8,8,FMN GV 11 Ramsel
66,Bergstraat 71,2021-05-08,23:00:00,2,2,0,FMN GV 11 Ramsel
66,Bergstraat 71,2021-05-09,00:00:00,10,4,6,FMN GV 11 Ramsel
66,Bergstraat 71,2021-05-09,01:00:00,6,6,0,FMN GV 11 Ramsel
66,Bergstraat 71,2021-05-09,02:00:00,2,2,0,FMN GV 11 Ramsel
66,Bergstraat 71,2021-05-09,03:00:00,6,4,2,FMN GV 11 Ramsel
66,Bergstraat 71,2021-05-09,04:00:00,0,0,0,FMN GV 11 Ramsel
66,Bergstraat 71,2021-05-09,05:00:00,0,0,0,FMN GV 11 Ramsel
66,Bergstraat 71,2021-05-09,06:00:00,8,4,4,FMN GV 11 Ramsel
66,Bergstraat 71,2021-05-09,07:00:00,44,8,36,FMN GV 11 Ramsel
66,Bergstraat 71,2021-05-09,08:00:00,104,18,86,FMN GV 11 Ramsel
66,Bergstraat 71,2021-05-09,09:00:00,294,88,206,FMN GV 11 Ramsel
66,Bergstraat 71,2021-05-09,10:00:00,330,150,180,FMN GV 11 Ramsel
66,Bergstraat 71,2021-05-09,11:00:00,388,238,150,FMN GV 11 Ramsel
66,Bergstraat 71,2021-05-09,12:00:00,238,134,104,FMN GV 11 Ramsel
66,Bergstraat 71,2021-05-09,13:00:00,160,88,72,FMN GV 11 Ramsel
66,Bergstraat 71,2021-05-09,14:00:00,236,82,154,FMN GV 11 Ramsel
66,Bergstraat 71,2021-05-09,15:00:00,324,158,166,FMN GV 11 Ramsel
66,Bergstraat 71,2021-05-09,16:00:00,298,154,144,FMN GV 11 Ramsel
66,Bergstraat 71,2021-05-09,17:00:00,172,100,72,FMN GV 11 Ramsel
66,Bergstraat 71,2021-05-09,18:00:00,112,66,46,FMN GV 11 Ramsel
66,Bergstraat 71,2021-05-09,19:00:00,46,18,28,FMN GV 11 Ramsel
66,Bergstraat 71,2021-05-09,20:00:00,22,8,14,FMN GV 11 Ramsel
66,Bergstraat 71,2021-05-09,21:00:00,14,10,4,FMN GV 11 Ramsel
66,Bergstraat 71,2021-05-09,22:00:00,8,4,4,FMN GV 11 Ramsel
66,Bergstraat 71,2021-05-09,23:00:00,0,0,0,FMN GV 11 Ramsel
66,Bergstraat 71,2021-05-10,00:00:00,0,0,0,FMN GV 11 Ramsel
66,Bergstraat 71,2021-05-10,01:00:00,0,0,0,FMN GV 11 Ramsel
66,Bergstraat 71,2021-05-10,02:00:00,0,0,0,FMN GV 11 Ramsel
66,Bergstraat 71,2021-05-10,03:00:00,4,2,2,FMN GV 11 Ramsel
66,Bergstraat 71,2021-05-10,04:00:00,4,4,0,FMN GV 11 Ramsel
66,Bergstraat 71,2021-05-10,05:00:00,10,10,0,FMN GV 11 Ramsel
66,Bergstraat 71,2021-05-10,06:00:00,24,8,16,FMN GV 11 Ramsel
66,Bergstraat 71,2021-05-10,07:00:00,156,16,140,FMN GV 11 Ramsel
66,Bergstraat 71,2021-05-10,08:00:00,128,12,116,FMN GV 11 Ramsel
66,Bergstraat 71,2021-05-10,09:00:00,114,92,22,FMN GV 11 Ramsel
66,Bergstraat 71,2021-05-10,10:00:00,32,12,20,FMN GV 11 Ramsel
66,Bergstraat 71,2021-05-10,11:00:00,36,12,24,FMN GV 11 Ramsel
66,Bergstraat 71,2021-05-10,12:00:00,44,20,24,FMN GV 11 Ramsel
66,Bergstraat 71,2021-05-10,13:00:00,130,64,66,FMN GV 11 Ramsel
66,Bergstraat 71,2021-05-10,14:00:00,134,58,76,FMN GV 11 Ramsel
66,Bergstraat 71,2021-05-10,15:00:00,310,208,102,FMN GV 11 Ramsel
66,Bergstraat 71,2021-05-10,16:00:00,160,106,54,FMN GV 11 Ramsel
66,Bergstraat 71,2021-05-10,17:00:00,78,56,22,FMN GV 11 Ramsel
66,Bergstraat 71,2021-05-10,18:00:00,82,64,18,FMN GV 11 Ramsel
66,Bergstraat 71,2021-05-10,19:00:00,82,36,46,FMN GV 11 Ramsel
66,Bergstraat 71,2021-05-10,20:00:00,66,36,30,FMN GV 11 Ramsel
66,Bergstraat 71,2021-05-10,21:00:00,34,16,18,FMN GV 11 Ramsel
66,Bergstraat 71,2021-05-10,22:00:00,12,6,6,FMN GV 11 Ramsel
66,Bergstraat 71,2021-05-10,23:00:00,0,0,0,FMN GV 11 Ramsel
66,Bergstraat 71,2021-05-11,00:00:00,0,0,0,FMN GV 11 Ramsel
66,Bergstraat 71,2021-05-11,01:00:00,2,0,2,FMN GV 11 Ramsel
66,Bergstraat 71,2021-05-11,02:00:00,2,0,2,FMN GV 11 Ramsel
66,Bergstraat 71,2021-05-11,03:00:00,0,0,0,FMN GV 11 Ramsel
66,Bergstraat 71,2021-05-11,04:00:00,2,2,0,FMN GV 11 Ramsel
66,Bergstraat 71,2021-05-11,05:00:00,10,8,2,FMN GV 11 Ramsel
66,Bergstraat 71,2021-05-11,06:00:00,28,16,12,FMN GV 11 Ramsel
66,Bergstraat 71,2021-05-11,07:00:00,188,12,176,FMN GV 11 Ramsel
66,Bergstraat 71,2021-05-11,08:00:00,190,32,158,FMN GV 11 Ramsel
66,Bergstraat 71,2021-05-11,09:00:00,78,22,56,FMN GV 11 Ramsel
66,Bergstraat 71,2021-05-11,10:00:00,82,32,50,FMN GV 11 Ramsel
66,Bergstraat 71,2021-05-11,11:00:00,72,34,38,FMN GV 11 Ramsel
66,Bergstraat 71,2021-05-11,12:00:00,94,60,34,FMN GV 11 Ramsel
66,Bergstraat 71,2021-05-11,13:00:00,152,68,84,FMN GV 11 Ramsel
66,Bergstraat 71,2021-05-11,14:00:00,132,72,60,FMN GV 11 Ramsel
66,Bergstraat 71,2021-05-11,15:00:00,196,162,34,FMN GV 11 Ramsel
66,Bergstraat 71,2021-05-11,16:00:00,166,134,32,FMN GV 11 Ramsel
66,Bergstraat 71,2021-05-11,17:00:00,60,24,36,FMN GV 11 Ramsel
66,Bergstraat 71,2021-05-11,18:00:00,50,18,32,FMN GV 11 Ramsel
66,Bergstraat 71,2021-05-11,19:00:00,44,24,20,FMN GV 11 Ramsel
66,Bergstraat 71,2021-05-11,20:00:00,48,32,16,FMN GV 11 Ramsel
66,Bergstraat 71,2021-05-11,21:00:00,6,2,4,FMN GV 11 Ramsel
66,Bergstraat 71,2021-05-11,22:00:00,12,10,2,FMN GV 11 Ramsel
66,Bergstraat 71,2021-05-11,23:00:00,4,4,0,FMN GV 11 Ramsel
66,Bergstraat 71,2021-05-12,00:00:00,2,2,0,FMN GV 11 Ramsel
66,Bergstraat 71,2021-05-12,01:00:00,0,0,0,FMN GV 11 Ramsel
66,Bergstraat 71,2021-05-12,02:00:00,0,0,0,FMN GV 11 Ramsel
66,Bergstraat 71,2021-05-12,03:00:00,0,0,0,FMN GV 11 Ramsel
66,Bergstraat 71,2021-05-12,04:00:00,4,4,0,FMN GV 11 Ramsel
66,Bergstraat 71,2021-05-12,05:00:00,8,4,4,FMN GV 11 Ramsel
66,Bergstraat 71,2021-05-12,06:00:00,28,12,16,FMN GV 11 Ramsel
66,Bergstraat 71,2021-05-12,07:00:00,78,18,60,FMN GV 11 Ramsel
66,Bergstraat 71,2021-05-12,08:00:00,124,36,88,FMN GV 11 Ramsel
66,Bergstraat 71,2021-05-12,09:00:00,86,34,52,FMN GV 11 Ramsel
66,Bergstraat 71,2021-05-12,10:00:00,110,44,66,FMN GV 11 Ramsel
66,Bergstraat 71,2021-05-12,11:00:00,146,74,72,FMN GV 11 Ramsel
66,Bergstraat 71,2021-05-12,12:00:00,176,98,78,FMN GV 11 Ramsel
66,Bergstraat 71,2021-05-12,13:00:00,190,86,104,FMN GV 11 Ramsel
66,Bergstraat 71,2021-05-12,14:00:00,86,44,42,FMN GV 11 Ramsel
66,Bergstraat 71,2021-05-12,15:00:00,96,50,46,FMN GV 11 Ramsel
66,Bergstraat 71,2021-05-12,16:00:00,164,100,64,FMN GV 11 Ramsel
66,Bergstraat 71,2021-05-12,17:00:00,104,62,42,FMN GV 11 Ramsel
66,Bergstraat 71,2021-05-12,18:00:00,76,28,48,FMN GV 11 Ramsel
66,Bergstraat 71,2021-05-12,19:00:00,60,32,28,FMN GV 11 Ramsel
66,Bergstraat 71,2021-05-12,20:00:00,36,20,16,FMN GV 11 Ramsel
66,Bergstraat 71,2021-05-12,21:00:00,26,24,2,FMN GV 11 Ramsel
66,Bergstraat 71,2021-05-12,22:00:00,28,8,20,FMN GV 11 Ramsel
66,Bergstraat 71,2021-05-12,23:00:00,10,10,0,FMN GV 11 Ramsel
66,Bergstraat 71,2021-05-13,00:00:00,4,4,0,FMN GV 11 Ramsel
66,Bergstraat 71,2021-05-13,01:00:00,4,2,2,FMN GV 11 Ramsel
66,Bergstraat 71,2021-05-13,02:00:00,0,0,0,FMN GV 11 Ramsel
66,Bergstraat 71,2021-05-13,03:00:00,0,0,0,FMN GV 11 Ramsel
66,Bergstraat 71,2021-05-13,04:00:00,0,0,0,FMN GV 11 Ramsel
66,Bergstraat 71,2021-05-13,05:00:00,0,0,0,FMN GV 11 Ramsel
66,Bergstraat 71,2021-05-13,06:00:00,14,8,6,FMN GV 11 Ramsel
66,Bergstraat 71,2021-05-13,07:00:00,12,4,8,FMN GV 11 Ramsel
66,Bergstraat 71,2021-05-13,08:00:00,46,24,22,FMN GV 11 Ramsel
66,Bergstraat 71,2021-05-13,09:00:00,152,42,110,FMN GV 11 Ramsel
66,Bergstraat 71,2021-05-13,10:00:00,236,126,110,FMN GV 11 Ramsel
66,Bergstraat 71,2021-05-13,11:00:00,192,116,76,FMN GV 11 Ramsel
66,Bergstraat 71,2021-05-13,12:00:00,188,118,70,FMN GV 11 Ramsel
66,Bergstraat 71,2021-05-13,13:00:00,240,132,108,FMN GV 11 Ramsel
66,Bergstraat 71,2021-05-13,14:00:00,280,134,146,FMN GV 11 Ramsel
66,Bergstraat 71,2021-05-13,15:00:00,196,118,78,FMN GV 11 Ramsel
66,Bergstraat 71,2021-05-13,16:00:00,110,54,56,FMN GV 11 Ramsel
66,Bergstraat 71,2021-05-13,17:00:00,100,64,36,FMN GV 11 Ramsel
66,Bergstraat 71,2021-05-13,18:00:00,58,36,22,FMN GV 11 Ramsel
66,Bergstraat 71,2021-05-13,19:00:00,32,20,12,FMN GV 11 Ramsel
66,Bergstraat 71,2021-05-13,20:00:00,38,16,22,FMN GV 11 Ramsel
66,Bergstraat 71,2021-05-13,21:00:00,10,8,2,FMN GV 11 Ramsel
66,Bergstraat 71,2021-05-13,22:00:00,14,4,10,FMN GV 11 Ramsel
66,Bergstraat 71,2021-05-13,23:00:00,8,6,2,FMN GV 11 Ramsel
66,Bergstraat 71,2021-05-14,00:00:00,2,2,0,FMN GV 11 Ramsel
66,Bergstraat 71,2021-05-14,01:00:00,2,2,0,FMN GV 11 Ramsel
66,Bergstraat 71,2021-05-14,02:00:00,6,0,6,FMN GV 11 Ramsel
66,Bergstraat 71,2021-05-14,03:00:00,2,2,0,FMN GV 11 Ramsel
66,Bergstraat 71,2021-05-14,04:00:00,0,0,0,FMN GV 11 Ramsel
66,Bergstraat 71,2021-05-14,05:00:00,2,2,0,FMN GV 11 Ramsel
66,Bergstraat 71,2021-05-14,06:00:00,10,2,8,FMN GV 11 Ramsel
66,Bergstraat 71,2021-05-14,07:00:00,28,6,22,FMN GV 11 Ramsel
66,Bergstraat 71,2021-05-14,08:00:00,46,18,28,FMN GV 11 Ramsel
66,Bergstraat 71,2021-05-14,09:00:00,90,36,54,FMN GV 11 Ramsel
66,Bergstraat 71,2021-05-14,10:00:00,140,68,72,FMN GV 11 Ramsel
66,Bergstraat 71,2021-05-14,11:00:00,156,94,62,FMN GV 11 Ramsel
66,Bergstraat 71,2021-05-14,12:00:00,92,64,28,FMN GV 11 Ramsel
66,Bergstraat 71,2021-05-14,13:00:00,70,38,32,FMN GV 11 Ramsel
66,Bergstraat 71,2021-05-14,14:00:00,94,46,48,FMN GV 11 Ramsel
66,Bergstraat 71,2021-05-14,15:00:00,114,58,56,FMN GV 11 Ramsel
66,Bergstraat 71,2021-05-14,16:00:00,82,38,44,FMN GV 11 Ramsel
66,Bergstraat 71,2021-05-14,17:00:00,30,26,4,FMN GV 11 Ramsel
66,Bergstraat 71,2021-05-14,18:00:00,28,18,10,FMN GV 11 Ramsel
66,Bergstraat 71,2021-05-14,19:00:00,24,6,18,FMN GV 11 Ramsel
66,Bergstraat 71,2021-05-14,20:00:00,30,18,12,FMN GV 11 Ramsel
66,Bergstraat 71,2021-05-14,21:00:00,12,6,6,FMN GV 11 Ramsel
66,Bergstraat 71,2021-05-14,22:00:00,14,8,6,FMN GV 11 Ramsel
66,Bergstraat 71,2021-05-14,23:00:00,2,0,2,FMN GV 11 Ramsel
66,Bergstraat 71,2021-05-15,00:00:00,4,2,2,FMN GV 11 Ramsel
66,Bergstraat 71,2021-05-15,01:00:00,8,4,4,FMN GV 11 Ramsel
66,Bergstraat 71,2021-05-15,02:00:00,2,2,0,FMN GV 11 Ramsel
66,Bergstraat 71,2021-05-15,03:00:00,2,2,0,FMN GV 11 Ramsel
66,Bergstraat 71,2021-05-15,04:00:00,0,0,0,FMN GV 11 Ramsel
66,Bergstraat 71,2021-05-15,05:00:00,2,2,0,FMN GV 11 Ramsel
66,Bergstraat 71,2021-05-15,06:00:00,4,0,4,FMN GV 11 Ramsel
66,Bergstraat 71,2021-05-15,07:00:00,22,6,16,FMN GV 11 Ramsel
66,Bergstraat 71,2021-05-15,08:00:00,50,12,38,FMN GV 11 Ramsel
66,Bergstraat 71,2021-05-15,09:00:00,72,38,34,FMN GV 11 Ramsel
66,Bergstraat 71,2021-05-15,10:00:00,124,66,58,FMN GV 11 Ramsel
66,Bergstraat 71,2021-05-15,11:00:00,106,60,46,FMN GV 11 Ramsel
66,Bergstraat 71,2021-05-15,12:00:00,76,46,30,FMN GV 11 Ramsel
66,Bergstraat 71,2021-05-15,13:00:00,92,30,62,FMN GV 11 Ramsel
66,Bergstraat 71,2021-05-15,14:00:00,44,22,22,FMN GV 11 Ramsel
66,Bergstraat 71,2021-05-15,15:00:00,50,22,28,FMN GV 11 Ramsel
66,Bergstraat 71,2021-05-15,16:00:00,64,24,40,FMN GV 11 Ramsel
66,Bergstraat 71,2021-05-15,17:00:00,44,22,22,FMN GV 11 Ramsel
66,Bergstraat 71,2021-05-15,18:00:00,24,14,10,FMN GV 11 Ramsel
66,Bergstraat 71,2021-05-15,19:00:00,44,26,18,FMN GV 11 Ramsel
66,Bergstraat 71,2021-05-15,20:00:00,42,24,18,FMN GV 11 Ramsel
66,Bergstraat 71,2021-05-15,21:00:00,20,10,10,FMN GV 11 Ramsel
66,Bergstraat 71,2021-05-15,22:00:00,4,2,2,FMN GV 11 Ramsel
66,Bergstraat 71,2021-05-15,23:00:00,12,12,0,FMN GV 11 Ramsel
66,Bergstraat 71,2021-05-16,00:00:00,6,4,2,FMN GV 11 Ramsel
66,Bergstraat 71,2021-05-16,01:00:00,8,6,2,FMN GV 11 Ramsel
66,Bergstraat 71,2021-05-16,02:00:00,0,0,0,FMN GV 11 Ramsel
66,Bergstraat 71,2021-05-16,03:00:00,4,4,0,FMN GV 11 Ramsel
66,Bergstraat 71,2021-05-16,04:00:00,0,0,0,FMN GV 11 Ramsel
66,Bergstraat 71,2021-05-16,05:00:00,0,0,0,FMN GV 11 Ramsel
66,Bergstraat 71,2021-05-16,06:00:00,10,2,8,FMN GV 11 Ramsel
66,Bergstraat 71,2021-05-16,07:00:00,42,10,32,FMN GV 11 Ramsel
66,Bergstraat 71,2021-05-16,08:00:00,72,8,64,FMN GV 11 Ramsel
66,Bergstraat 71,2021-05-16,09:00:00,178,40,138,FMN GV 11 Ramsel
66,Bergstraat 71,2021-05-16,10:00:00,174,88,86,FMN GV 11 Ramsel
66,Bergstraat 71,2021-05-16,11:00:00,190,136,54,FMN GV 11 Ramsel
66,Bergstraat 71,2021-05-16,12:00:00,110,88,22,FMN GV 11 Ramsel
66,Bergstraat 71,2021-05-16,13:00:00,78,44,34,FMN GV 11 Ramsel
66,Bergstraat 71,2021-05-16,14:00:00,130,60,70,FMN GV 11 Ramsel
66,Bergstraat 71,2021-05-16,15:00:00,102,36,66,FMN GV 11 Ramsel
66,Bergstraat 71,2021-05-16,16:00:00,30,24,6,FMN GV 11 Ramsel
66,Bergstraat 71,2021-05-16,17:00:00,28,10,18,FMN GV 11 Ramsel
66,Bergstraat 71,2021-05-16,18:00:00,46,26,20,FMN GV 11 Ramsel
66,Bergstraat 71,2021-05-16,19:00:00,20,10,10,FMN GV 11 Ramsel
66,Bergstraat 71,2021-05-16,20:00:00,34,14,20,FMN GV 11 Ramsel
66,Bergstraat 71,2021-05-16,21:00:00,10,4,6,FMN GV 11 Ramsel
66,Bergstraat 71,2021-05-16,22:00:00,2,0,2,FMN GV 11 Ramsel
66,Bergstraat 71,2021-05-16,23:00:00,0,0,0,FMN GV 11 Ramsel
66,Bergstraat 71,2021-05-17,00:00:00,0,0,0,FMN GV 11 Ramsel
66,Bergstraat 71,2021-05-17,01:00:00,0,0,0,FMN GV 11 Ramsel
66,Bergstraat 71,2021-05-17,02:00:00,0,0,0,FMN GV 11 Ramsel
66,Bergstraat 71,2021-05-17,03:00:00,0,0,0,FMN GV 11 Ramsel
66,Bergstraat 71,2021-05-17,04:00:00,0,0,0,FMN GV 11 Ramsel
66,Bergstraat 71,2021-05-17,05:00:00,8,4,4,FMN GV 11 Ramsel
66,Bergstraat 71,2021-05-17,06:00:00,32,12,20,FMN GV 11 Ramsel
66,Bergstraat 71,2021-05-17,07:00:00,130,12,118,FMN GV 11 Ramsel
66,Bergstraat 71,2021-05-17,08:00:00,116,12,104,FMN GV 11 Ramsel
66,Bergstraat 71,2021-05-17,09:00:00,22,10,12,FMN GV 11 Ramsel
66,Bergstraat 71,2021-05-17,10:00:00,6,2,4,FMN GV 11 Ramsel
66,Bergstraat 71,2021-05-17,11:00:00,2,2,0,FMN GV 11 Ramsel
66,Bergstraat 71,2021-05-17,12:00:00,6,0,6,FMN GV 11 Ramsel
66,Bergstraat 71,2021-05-17,13:00:00,20,10,10,FMN GV 11 Ramsel
66,Bergstraat 71,2021-05-17,14:00:00,32,20,12,FMN GV 11 Ramsel
66,Bergstraat 71,2021-05-17,15:00:00,128,114,14,FMN GV 11 Ramsel
66,Bergstraat 71,2021-05-17,16:00:00,138,104,34,FMN GV 11 Ramsel
66,Bergstraat 71,2021-05-17,17:00:00,46,22,24,FMN GV 11 Ramsel
66,Bergstraat 71,2021-05-17,18:00:00,40,18,22,FMN GV 11 Ramsel
66,Bergstraat 71,2021-05-17,19:00:00,26,10,16,FMN GV 11 Ramsel
66,Bergstraat 71,2021-05-17,20:00:00,46,16,30,FMN GV 11 Ramsel
66,Bergstraat 71,2021-05-17,21:00:00,14,10,4,FMN GV 11 Ramsel
66,Bergstraat 71,2021-05-17,22:00:00,14,4,10,FMN GV 11 Ramsel
66,Bergstraat 71,2021-05-17,23:00:00,0,0,0,FMN GV 11 Ramsel
66,Bergstraat 71,2021-05-18,00:00:00,0,0,0,FMN GV 11 Ramsel
66,Bergstraat 71,2021-05-18,01:00:00,0,0,0,FMN GV 11 Ramsel
66,Bergstraat 71,2021-05-18,02:00:00,0,0,0,FMN GV 11 Ramsel
66,Bergstraat 71,2021-05-18,03:00:00,0,0,0,FMN GV 11 Ramsel
66,Bergstraat 71,2021-05-18,04:00:00,0,0,0,FMN GV 11 Ramsel
66,Bergstraat 71,2021-05-18,05:00:00,6,4,2,FMN GV 11 Ramsel
66,Bergstraat 71,2021-05-18,06:00:00,22,8,14,FMN GV 11 Ramsel
66,Bergstraat 71,2021-05-18,07:00:00,132,16,116,FMN GV 11 Ramsel
66,Bergstraat 71,2021-05-18,08:00:00,144,10,134,FMN GV 11 Ramsel
66,Bergstraat 71,2021-05-18,09:00:00,40,22,18,FMN GV 11 Ramsel
66,Bergstraat 71,2021-05-18,10:00:00,40,16,24,FMN GV 11 Ramsel
66,Bergstraat 71,2021-05-18,11:00:00,44,28,16,FMN GV 11 Ramsel
66,Bergstraat 71,2021-05-18,12:00:00,50,30,20,FMN GV 11 Ramsel
66,Bergstraat 71,2021-05-18,13:00:00,132,82,50,FMN GV 11 Ramsel
66,Bergstraat 71,2021-05-18,14:00:00,168,98,70,FMN GV 11 Ramsel
66,Bergstraat 71,2021-05-18,15:00:00,218,160,58,FMN GV 11 Ramsel
66,Bergstraat 71,2021-05-18,16:00:00,172,126,46,FMN GV 11 Ramsel
66,Bergstraat 71,2021-05-18,17:00:00,64,34,30,FMN GV 11 Ramsel
66,Bergstraat 71,2021-05-18,18:00:00,90,50,40,FMN GV 11 Ramsel
66,Bergstraat 71,2021-05-18,19:00:00,90,46,44,FMN GV 11 Ramsel
66,Bergstraat 71,2021-05-18,20:00:00,64,16,48,FMN GV 11 Ramsel
66,Bergstraat 71,2021-05-18,21:00:00,24,16,8,FMN GV 11 Ramsel
66,Bergstraat 71,2021-05-18,22:00:00,10,4,6,FMN GV 11 Ramsel
66,Bergstraat 71,2021-05-18,23:00:00,0,0,0,FMN GV 11 Ramsel
66,Bergstraat 71,2021-05-19,00:00:00,0,0,0,FMN GV 11 Ramsel
66,Bergstraat 71,2021-05-19,01:00:00,0,0,0,FMN GV 11 Ramsel
66,Bergstraat 71,2021-05-19,02:00:00,2,0,2,FMN GV 11 Ramsel
66,Bergstraat 71,2021-05-19,03:00:00,0,0,0,FMN GV 11 Ramsel
66,Bergstraat 71,2021-05-19,04:00:00,2,2,0,FMN GV 11 Ramsel
66,Bergstraat 71,2021-05-19,05:00:00,8,6,2,FMN GV 11 Ramsel
66,Bergstraat 71,2021-05-19,06:00:00,32,10,22,FMN GV 11 Ramsel
66,Bergstraat 71,2021-05-19,07:00:00,162,24,138,FMN GV 11 Ramsel
66,Bergstraat 71,2021-05-19,08:00:00,144,22,122,FMN GV 11 Ramsel
66,Bergstraat 71,2021-05-19,09:00:00,54,18,36,FMN GV 11 Ramsel
66,Bergstraat 71,2021-05-19,10:00:00,40,34,6,FMN GV 11 Ramsel
66,Bergstraat 71,2021-05-19,11:00:00,58,42,16,FMN GV 11 Ramsel
66,Bergstraat 71,2021-05-19,12:00:00,218,188,30,FMN GV 11 Ramsel
66,Bergstraat 71,2021-05-19,13:00:00,102,60,42,FMN GV 11 Ramsel
66,Bergstraat 71,2021-05-19,14:00:00,102,56,46,FMN GV 11 Ramsel
66,Bergstraat 71,2021-05-19,15:00:00,76,34,42,FMN GV 11 Ramsel
66,Bergstraat 71,2021-05-19,16:00:00,80,58,22,FMN GV 11 Ramsel
66,Bergstraat 71,2021-05-19,17:00:00,48,32,16,FMN GV 11 Ramsel
66,Bergstraat 71,2021-05-19,18:00:00,46,22,24,FMN GV 11 Ramsel
66,Bergstraat 71,2021-05-19,19:00:00,26,16,10,FMN GV 11 Ramsel
66,Bergstraat 71,2021-05-19,20:00:00,16,8,8,FMN GV 11 Ramsel
66,Bergstraat 71,2021-05-19,21:00:00,20,14,6,FMN GV 11 Ramsel
66,Bergstraat 71,2021-05-19,22:00:00,10,6,4,FMN GV 11 Ramsel
66,Bergstraat 71,2021-05-19,23:00:00,0,0,0,FMN GV 11 Ramsel
66,Bergstraat 71,2021-05-20,00:00:00,0,0,0,FMN GV 11 Ramsel
66,Bergstraat 71,2021-05-20,01:00:00,0,0,0,FMN GV 11 Ramsel
66,Bergstraat 71,2021-05-20,02:00:00,0,0,0,FMN GV 11 Ramsel
66,Bergstraat 71,2021-05-20,03:00:00,0,0,0,FMN GV 11 Ramsel
66,Bergstraat 71,2021-05-20,04:00:00,6,4,2,FMN GV 11 Ramsel
66,Bergstraat 71,2021-05-20,05:00:00,8,4,4,FMN GV 11 Ramsel
66,Bergstraat 71,2021-05-20,06:00:00,36,14,22,FMN GV 11 Ramsel
66,Bergstraat 71,2021-05-20,07:00:00,192,32,160,FMN GV 11 Ramsel
66,Bergstraat 71,2021-05-20,08:00:00,202,42,160,FMN GV 11 Ramsel
66,Bergstraat 71,2021-05-20,09:00:00,142,26,116,FMN GV 11 Ramsel
66,Bergstraat 71,2021-05-20,10:00:00,144,64,80,FMN GV 11 Ramsel
66,Bergstraat 71,2021-05-20,11:00:00,138,82,56,FMN GV 11 Ramsel
66,Bergstraat 71,2021-05-20,12:00:00,182,98,84,FMN GV 11 Ramsel
66,Bergstraat 71,2021-05-20,13:00:00,256,106,150,FMN GV 11 Ramsel
66,Bergstraat 71,2021-05-20,14:00:00,244,114,130,FMN GV 11 Ramsel
66,Bergstraat 71,2021-05-20,15:00:00,396,304,92,FMN GV 11 Ramsel
66,Bergstraat 71,2021-05-20,16:00:00,254,178,76,FMN GV 11 Ramsel
66,Bergstraat 71,2021-05-20,17:00:00,154,92,62,FMN GV 11 Ramsel
66,Bergstraat 71,2021-05-20,18:00:00,98,44,54,FMN GV 11 Ramsel
66,Bergstraat 71,2021-05-20,19:00:00,80,54,26,FMN GV 11 Ramsel
66,Bergstraat 71,2021-05-20,20:00:00,66,42,24,FMN GV 11 Ramsel
66,Bergstraat 71,2021-05-20,21:00:00,14,8,6,FMN GV 11 Ramsel
66,Bergstraat 71,2021-05-20,22:00:00,12,6,6,FMN GV 11 Ramsel
66,Bergstraat 71,2021-05-20,23:00:00,2,2,0,FMN GV 11 Ramsel
66,Bergstraat 71,2021-05-21,00:00:00,0,0,0,FMN GV 11 Ramsel
66,Bergstraat 71,2021-05-21,01:00:00,2,2,0,FMN GV 11 Ramsel
66,Bergstraat 71,2021-05-21,02:00:00,0,0,0,FMN GV 11 Ramsel
66,Bergstraat 71,2021-05-21,03:00:00,0,0,0,FMN GV 11 Ramsel
66,Bergstraat 71,2021-05-21,04:00:00,2,2,0,FMN GV 11 Ramsel
66,Bergstraat 71,2021-05-21,05:00:00,4,2,2,FMN GV 11 Ramsel
66,Bergstraat 71,2021-05-21,06:00:00,24,12,12,FMN GV 11 Ramsel
66,Bergstraat 71,2021-05-21,07:00:00,118,12,106,FMN GV 11 Ramsel
66,Bergstraat 71,2021-05-21,08:00:00,138,16,122,FMN GV 11 Ramsel
66,Bergstraat 71,2021-05-21,09:00:00,18,10,8,FMN GV 11 Ramsel
66,Bergstraat 71,2021-05-21,10:00:00,36,14,22,FMN GV 11 Ramsel
66,Bergstraat 71,2021-05-21,11:00:00,16,6,10,FMN GV 11 Ramsel
66,Bergstraat 71,2021-05-21,12:00:00,44,32,12,FMN GV 11 Ramsel
66,Bergstraat 71,2021-05-21,13:00:00,48,28,20,FMN GV 11 Ramsel
66,Bergstraat 71,2021-05-21,14:00:00,56,38,18,FMN GV 11 Ramsel
66,Bergstraat 71,2021-05-21,15:00:00,184,158,26,FMN GV 11 Ramsel
66,Bergstraat 71,2021-05-21,16:00:00,86,62,24,FMN GV 11 Ramsel
66,Bergstraat 71,2021-05-21,17:00:00,52,40,12,FMN GV 11 Ramsel
66,Bergstraat 71,2021-05-21,18:00:00,42,36,6,FMN GV 11 Ramsel
66,Bergstraat 71,2021-05-21,19:00:00,30,10,20,FMN GV 11 Ramsel
66,Bergstraat 71,2021-05-21,20:00:00,16,6,10,FMN GV 11 Ramsel
66,Bergstraat 71,2021-05-21,21:00:00,28,12,16,FMN GV 11 Ramsel
66,Bergstraat 71,2021-05-21,22:00:00,8,4,4,FMN GV 11 Ramsel
66,Bergstraat 71,2021-05-21,23:00:00,12,8,4,FMN GV 11 Ramsel
66,Bergstraat 71,2021-05-22,00:00:00,4,2,2,FMN GV 11 Ramsel
66,Bergstraat 71,2021-05-22,01:00:00,4,4,0,FMN GV 11 Ramsel
66,Bergstraat 71,2021-05-22,02:00:00,4,4,0,FMN GV 11 Ramsel
66,Bergstraat 71,2021-05-22,03:00:00,2,0,2,FMN GV 11 Ramsel
66,Bergstraat 71,2021-05-22,04:00:00,0,0,0,FMN GV 11 Ramsel
66,Bergstraat 71,2021-05-22,05:00:00,2,2,0,FMN GV 11 Ramsel
66,Bergstraat 71,2021-05-22,06:00:00,4,0,4,FMN GV 11 Ramsel
66,Bergstraat 71,2021-05-22,07:00:00,10,4,6,FMN GV 11 Ramsel
66,Bergstraat 71,2021-05-22,08:00:00,16,10,6,FMN GV 11 Ramsel
66,Bergstraat 71,2021-05-22,09:00:00,16,8,8,FMN GV 11 Ramsel
66,Bergstraat 71,2021-05-22,10:00:00,8,2,6,FMN GV 11 Ramsel
66,Bergstraat 71,2021-05-22,11:00:00,16,12,4,FMN GV 11 Ramsel
66,Bergstraat 71,2021-05-22,12:00:00,22,2,20,FMN GV 11 Ramsel
66,Bergstraat 71,2021-05-22,13:00:00,18,8,10,FMN GV 11 Ramsel
66,Bergstraat 71,2021-05-22,14:00:00,2,2,0,FMN GV 11 Ramsel
66,Bergstraat 71,2021-05-22,15:00:00,18,12,6,FMN GV 11 Ramsel
66,Bergstraat 71,2021-05-22,16:00:00,8,2,6,FMN GV 11 Ramsel
66,Bergstraat 71,2021-05-22,17:00:00,4,2,2,FMN GV 11 Ramsel
66,Bergstraat 71,2021-05-22,18:00:00,6,2,4,FMN GV 11 Ramsel
66,Bergstraat 71,2021-05-22,19:00:00,16,4,12,FMN GV 11 Ramsel
66,Bergstraat 71,2021-05-22,20:00:00,16,8,8,FMN GV 11 Ramsel
66,Bergstraat 71,2021-05-22,21:00:00,2,2,0,FMN GV 11 Ramsel
66,Bergstraat 71,2021-05-22,22:00:00,8,2,6,FMN GV 11 Ramsel
66,Bergstraat 71,2021-05-22,23:00:00,2,2,0,FMN GV 11 Ramsel
66,Bergstraat 71,2021-05-23,00:00:00,4,4,0,FMN GV 11 Ramsel
66,Bergstraat 71,2021-05-23,01:00:00,4,0,4,FMN GV 11 Ramsel
66,Bergstraat 71,2021-05-23,02:00:00,2,2,0,FMN GV 11 Ramsel
66,Bergstraat 71,2021-05-23,03:00:00,0,0,0,FMN GV 11 Ramsel
66,Bergstraat 71,2021-05-23,04:00:00,0,0,0,FMN GV 11 Ramsel
66,Bergstraat 71,2021-05-23,05:00:00,0,0,0,FMN GV 11 Ramsel
66,Bergstraat 71,2021-05-23,06:00:00,6,4,2,FMN GV 11 Ramsel
66,Bergstraat 71,2021-05-23,07:00:00,38,8,30,FMN GV 11 Ramsel
66,Bergstraat 71,2021-05-23,08:00:00,76,24,52,FMN GV 11 Ramsel
66,Bergstraat 71,2021-05-23,09:00:00,214,58,156,FMN GV 11 Ramsel
66,Bergstraat 71,2021-05-23,10:00:00,236,104,132,FMN GV 11 Ramsel
66,Bergstraat 71,2021-05-23,11:00:00,288,170,118,FMN GV 11 Ramsel
66,Bergstraat 71,2021-05-23,12:00:00,146,104,42,FMN GV 11 Ramsel
66,Bergstraat 71,2021-05-23,13:00:00,168,88,80,FMN GV 11 Ramsel
66,Bergstraat 71,2021-05-23,14:00:00,210,86,124,FMN GV 11 Ramsel
66,Bergstraat 71,2021-05-23,15:00:00,192,98,94,FMN GV 11 Ramsel
66,Bergstraat 71,2021-05-23,16:00:00,188,80,108,FMN GV 11 Ramsel
66,Bergstraat 71,2021-05-23,17:00:00,114,58,56,FMN GV 11 Ramsel
66,Bergstraat 71,2021-05-23,18:00:00,74,38,36,FMN GV 11 Ramsel
66,Bergstraat 71,2021-05-23,19:00:00,54,26,28,FMN GV 11 Ramsel
66,Bergstraat 71,2021-05-23,20:00:00,30,8,22,FMN GV 11 Ramsel
66,Bergstraat 71,2021-05-23,21:00:00,30,20,10,FMN GV 11 Ramsel
66,Bergstraat 71,2021-05-23,22:00:00,20,16,4,FMN GV 11 Ramsel
66,Bergstraat 71,2021-05-23,23:00:00,0,0,0,FMN GV 11 Ramsel
66,Bergstraat 71,2021-05-24,00:00:00,2,2,0,FMN GV 11 Ramsel
66,Bergstraat 71,2021-05-24,01:00:00,2,0,2,FMN GV 11 Ramsel
66,Bergstraat 71,2021-05-24,02:00:00,10,10,0,FMN GV 11 Ramsel
66,Bergstraat 71,2021-05-24,03:00:00,4,0,4,FMN GV 11 Ramsel
66,Bergstraat 71,2021-05-24,04:00:00,0,0,0,FMN GV 11 Ramsel
66,Bergstraat 71,2021-05-24,05:00:00,4,2,2,FMN GV 11 Ramsel
66,Bergstraat 71,2021-05-24,06:00:00,6,6,0,FMN GV 11 Ramsel
66,Bergstraat 71,2021-05-24,07:00:00,6,2,4,FMN GV 11 Ramsel
66,Bergstraat 71,2021-05-24,08:00:00,12,2,10,FMN GV 11 Ramsel
66,Bergstraat 71,2021-05-24,09:00:00,12,8,4,FMN GV 11 Ramsel
66,Bergstraat 71,2021-05-24,10:00:00,14,6,8,FMN GV 11 Ramsel
66,Bergstraat 71,2021-05-24,11:00:00,18,12,6,FMN GV 11 Ramsel
66,Bergstraat 71,2021-05-24,12:00:00,8,8,0,FMN GV 11 Ramsel
66,Bergstraat 71,2021-05-24,13:00:00,38,14,24,FMN GV 11 Ramsel
66,Bergstraat 71,2021-05-24,14:00:00,106,50,56,FMN GV 11 Ramsel
66,Bergstraat 71,2021-05-24,15:00:00,84,32,52,FMN GV 11 Ramsel
66,Bergstraat 71,2021-05-24,16:00:00,112,72,40,FMN GV 11 Ramsel
66,Bergstraat 71,2021-05-24,17:00:00,56,24,32,FMN GV 11 Ramsel
66,Bergstraat 71,2021-05-24,18:00:00,6,0,6,FMN GV 11 Ramsel
66,Bergstraat 71,2021-05-24,19:00:00,12,2,10,FMN GV 11 Ramsel
66,Bergstraat 71,2021-05-24,20:00:00,14,4,10,FMN GV 11 Ramsel
66,Bergstraat 71,2021-05-24,21:00:00,6,4,2,FMN GV 11 Ramsel
66,Bergstraat 71,2021-05-24,22:00:00,4,4,0,FMN GV 11 Ramsel
66,Bergstraat 71,2021-05-24,23:00:00,0,0,0,FMN GV 11 Ramsel
66,Bergstraat 71,2021-05-25,00:00:00,0,0,0,FMN GV 11 Ramsel
66,Bergstraat 71,2021-05-25,01:00:00,0,0,0,FMN GV 11 Ramsel
66,Bergstraat 71,2021-05-25,02:00:00,0,0,0,FMN GV 11 Ramsel
66,Bergstraat 71,2021-05-25,03:00:00,0,0,0,FMN GV 11 Ramsel
66,Bergstraat 71,2021-05-25,04:00:00,0,0,0,FMN GV 11 Ramsel
66,Bergstraat 71,2021-05-25,05:00:00,6,4,2,FMN GV 11 Ramsel
66,Bergstraat 71,2021-05-25,06:00:00,20,12,8,FMN GV 11 Ramsel
66,Bergstraat 71,2021-05-25,07:00:00,54,8,46,FMN GV 11 Ramsel
66,Bergstraat 71,2021-05-25,08:00:00,46,0,46,FMN GV 11 Ramsel
66,Bergstraat 71,2021-05-25,09:00:00,16,6,10,FMN GV 11 Ramsel
66,Bergstraat 71,2021-05-25,10:00:00,8,2,6,FMN GV 11 Ramsel
66,Bergstraat 71,2021-05-25,11:00:00,28,8,20,FMN GV 11 Ramsel
66,Bergstraat 71,2021-05-25,12:00:00,6,6,0,FMN GV 11 Ramsel
66,Bergstraat 71,2021-05-25,13:00:00,18,12,6,FMN GV 11 Ramsel
66,Bergstraat 71,2021-05-25,14:00:00,38,20,18,FMN GV 11 Ramsel
66,Bergstraat 71,2021-05-25,15:00:00,70,66,4,FMN GV 11 Ramsel
66,Bergstraat 71,2021-05-25,16:00:00,34,28,6,FMN GV 11 Ramsel
66,Bergstraat 71,2021-05-25,17:00:00,28,12,16,FMN GV 11 Ramsel
66,Bergstraat 71,2021-05-25,18:00:00,28,12,16,FMN GV 11 Ramsel
66,Bergstraat 71,2021-05-25,19:00:00,12,8,4,FMN GV 11 Ramsel
66,Bergstraat 71,2021-05-25,20:00:00,24,10,14,FMN GV 11 Ramsel
66,Bergstraat 71,2021-05-25,21:00:00,0,0,0,FMN GV 11 Ramsel
66,Bergstraat 71,2021-05-25,22:00:00,6,4,2,FMN GV 11 Ramsel
66,Bergstraat 71,2021-05-25,23:00:00,4,4,0,FMN GV 11 Ramsel
66,Bergstraat 71,2021-05-26,00:00:00,0,0,0,FMN GV 11 Ramsel
66,Bergstraat 71,2021-05-26,01:00:00,0,0,0,FMN GV 11 Ramsel
66,Bergstraat 71,2021-05-26,02:00:00,0,0,0,FMN GV 11 Ramsel
66,Bergstraat 71,2021-05-26,03:00:00,0,0,0,FMN GV 11 Ramsel
66,Bergstraat 71,2021-05-26,04:00:00,2,0,2,FMN GV 11 Ramsel
66,Bergstraat 71,2021-05-26,05:00:00,8,2,6,FMN GV 11 Ramsel
66,Bergstraat 71,2021-05-26,06:00:00,30,12,18,FMN GV 11 Ramsel
66,Bergstraat 71,2021-05-26,07:00:00,150,12,138,FMN GV 11 Ramsel
66,Bergstraat 71,2021-05-26,08:00:00,144,24,120,FMN GV 11 Ramsel
66,Bergstraat 71,2021-05-26,09:00:00,34,10,24,FMN GV 11 Ramsel
66,Bergstraat 71,2021-05-26,10:00:00,42,16,26,FMN GV 11 Ramsel
66,Bergstraat 71,2021-05-26,11:00:00,78,50,28,FMN GV 11 Ramsel
66,Bergstraat 71,2021-05-26,12:00:00,188,170,18,FMN GV 11 Ramsel
66,Bergstraat 71,2021-05-26,13:00:00,86,46,40,FMN GV 11 Ramsel
66,Bergstraat 71,2021-05-26,14:00:00,80,26,54,FMN GV 11 Ramsel
66,Bergstraat 71,2021-05-26,15:00:00,70,40,30,FMN GV 11 Ramsel
66,Bergstraat 71,2021-05-26,16:00:00,68,40,28,FMN GV 11 Ramsel
66,Bergstraat 71,2021-05-26,17:00:00,78,52,26,FMN GV 11 Ramsel
66,Bergstraat 71,2021-05-26,18:00:00,58,32,26,FMN GV 11 Ramsel
66,Bergstraat 71,2021-05-26,19:00:00,44,24,20,FMN GV 11 Ramsel
66,Bergstraat 71,2021-05-26,20:00:00,56,38,18,FMN GV 11 Ramsel
66,Bergstraat 71,2021-05-26,21:00:00,56,44,12,FMN GV 11 Ramsel
66,Bergstraat 71,2021-05-26,22:00:00,12,10,2,FMN GV 11 Ramsel
66,Bergstraat 71,2021-05-26,23:00:00,0,0,0,FMN GV 11 Ramsel
66,Bergstraat 71,2021-05-27,00:00:00,0,0,0,FMN GV 11 Ramsel
66,Bergstraat 71,2021-05-27,01:00:00,0,0,0,FMN GV 11 Ramsel
66,Bergstraat 71,2021-05-27,02:00:00,0,0,0,FMN GV 11 Ramsel
66,Bergstraat 71,2021-05-27,03:00:00,0,0,0,FMN GV 11 Ramsel
66,Bergstraat 71,2021-05-27,04:00:00,2,2,0,FMN GV 11 Ramsel
66,Bergstraat 71,2021-05-27,05:00:00,14,8,6,FMN GV 11 Ramsel
66,Bergstraat 71,2021-05-27,06:00:00,40,16,24,FMN GV 11 Ramsel
66,Bergstraat 71,2021-05-27,07:00:00,152,12,140,FMN GV 11 Ramsel
66,Bergstraat 71,2021-05-27,08:00:00,182,32,150,FMN GV 11 Ramsel
66,Bergstraat 71,2021-05-27,09:00:00,50,12,38,FMN GV 11 Ramsel
66,Bergstraat 71,2021-05-27,10:00:00,50,10,40,FMN GV 11 Ramsel
66,Bergstraat 71,2021-05-27,11:00:00,54,30,24,FMN GV 11 Ramsel
66,Bergstraat 71,2021-05-27,12:00:00,58,32,26,FMN GV 11 Ramsel
66,Bergstraat 71,2021-05-27,13:00:00,116,70,46,FMN GV 11 Ramsel
66,Bergstraat 71,2021-05-27,14:00:00,84,54,30,FMN GV 11 Ramsel
66,Bergstraat 71,2021-05-27,15:00:00,264,208,56,FMN GV 11 Ramsel
66,Bergstraat 71,2021-05-27,16:00:00,148,96,52,FMN GV 11 Ramsel
66,Bergstraat 71,2021-05-27,17:00:00,92,54,38,FMN GV 11 Ramsel
66,Bergstraat 71,2021-05-27,18:00:00,70,30,40,FMN GV 11 Ramsel
66,Bergstraat 71,2021-05-27,19:00:00,42,24,18,FMN GV 11 Ramsel
66,Bergstraat 71,2021-05-27,20:00:00,54,40,14,FMN GV 11 Ramsel
66,Bergstraat 71,2021-05-27,21:00:00,8,4,4,FMN GV 11 Ramsel
66,Bergstraat 71,2021-05-27,22:00:00,12,8,4,FMN GV 11 Ramsel
66,Bergstraat 71,2021-05-27,23:00:00,8,4,4,FMN GV 11 Ramsel
66,Bergstraat 71,2021-05-28,00:00:00,0,0,0,FMN GV 11 Ramsel
66,Bergstraat 71,2021-05-28,01:00:00,0,0,0,FMN GV 11 Ramsel
66,Bergstraat 71,2021-05-28,02:00:00,0,0,0,FMN GV 11 Ramsel
66,Bergstraat 71,2021-05-28,03:00:00,0,0,0,FMN GV 11 Ramsel
66,Bergstraat 71,2021-05-28,04:00:00,4,4,0,FMN GV 11 Ramsel
66,Bergstraat 71,2021-05-28,05:00:00,4,2,2,FMN GV 11 Ramsel
66,Bergstraat 71,2021-05-28,06:00:00,26,8,18,FMN GV 11 Ramsel
66,Bergstraat 71,2021-05-28,07:00:00,180,24,156,FMN GV 11 Ramsel
66,Bergstraat 71,2021-05-28,08:00:00,150,16,134,FMN GV 11 Ramsel
66,Bergstraat 71,2021-05-28,09:00:00,76,36,40,FMN GV 11 Ramsel
66,Bergstraat 71,2021-05-28,10:00:00,88,32,56,FMN GV 11 Ramsel
66,Bergstraat 71,2021-05-28,11:00:00,64,36,28,FMN GV 11 Ramsel
66,Bergstraat 71,2021-05-28,12:00:00,116,58,58,FMN GV 11 Ramsel
66,Bergstraat 71,2021-05-28,13:00:00,196,94,102,FMN GV 11 Ramsel
66,Bergstraat 71,2021-05-28,14:00:00,228,120,108,FMN GV 11 Ramsel
66,Bergstraat 71,2021-05-28,15:00:00,372,288,84,FMN GV 11 Ramsel
66,Bergstraat 71,2021-05-28,16:00:00,262,168,94,FMN GV 11 Ramsel
66,Bergstraat 71,2021-05-28,17:00:00,176,108,68,FMN GV 11 Ramsel
66,Bergstraat 71,2021-05-28,18:00:00,106,54,52,FMN GV 11 Ramsel
66,Bergstraat 71,2021-05-28,19:00:00,82,48,34,FMN GV 11 Ramsel
66,Bergstraat 71,2021-05-28,20:00:00,62,36,26,FMN GV 11 Ramsel
66,Bergstraat 71,2021-05-28,21:00:00,36,24,12,FMN GV 11 Ramsel
66,Bergstraat 71,2021-05-28,22:00:00,18,12,6,FMN GV 11 Ramsel
66,Bergstraat 71,2021-05-28,23:00:00,8,6,2,FMN GV 11 Ramsel
66,Bergstraat 71,2021-05-29,00:00:00,8,4,4,FMN GV 11 Ramsel
66,Bergstraat 71,2021-05-29,01:00:00,14,14,0,FMN GV 11 Ramsel
66,Bergstraat 71,2021-05-29,02:00:00,2,2,0,FMN GV 11 Ramsel
66,Bergstraat 71,2021-05-29,03:00:00,4,4,0,FMN GV 11 Ramsel
66,Bergstraat 71,2021-05-29,04:00:00,0,0,0,FMN GV 11 Ramsel
66,Bergstraat 71,2021-05-29,05:00:00,2,0,2,FMN GV 11 Ramsel
66,Bergstraat 71,2021-05-29,06:00:00,6,0,6,FMN GV 11 Ramsel
66,Bergstraat 71,2021-05-29,07:00:00,10,4,6,FMN GV 11 Ramsel
66,Bergstraat 71,2021-05-29,08:00:00,58,26,32,FMN GV 11 Ramsel
66,Bergstraat 71,2021-05-29,09:00:00,76,24,52,FMN GV 11 Ramsel
66,Bergstraat 71,2021-05-29,10:00:00,154,86,68,FMN GV 11 Ramsel
66,Bergstraat 71,2021-05-29,11:00:00,150,72,78,FMN GV 11 Ramsel
66,Bergstraat 71,2021-05-29,12:00:00,182,78,104,FMN GV 11 Ramsel
66,Bergstraat 71,2021-05-29,13:00:00,296,130,166,FMN GV 11 Ramsel
66,Bergstraat 71,2021-05-29,14:00:00,376,192,184,FMN GV 11 Ramsel
66,Bergstraat 71,2021-05-29,15:00:00,394,224,170,FMN GV 11 Ramsel
66,Bergstraat 71,2021-05-29,16:00:00,326,180,146,FMN GV 11 Ramsel
66,Bergstraat 71,2021-05-29,17:00:00,182,122,60,FMN GV 11 Ramsel
66,Bergstraat 71,2021-05-29,18:00:00,144,54,90,FMN GV 11 Ramsel
66,Bergstraat 71,2021-05-29,19:00:00,70,20,50,FMN GV 11 Ramsel
66,Bergstraat 71,2021-05-29,20:00:00,54,36,18,FMN GV 11 Ramsel
66,Bergstraat 71,2021-05-29,21:00:00,32,20,12,FMN GV 11 Ramsel
66,Bergstraat 71,2021-05-29,22:00:00,22,16,6,FMN GV 11 Ramsel
66,Bergstraat 71,2021-05-29,23:00:00,8,6,2,FMN GV 11 Ramsel
66,Bergstraat 71,2021-05-30,00:00:00,12,6,6,FMN GV 11 Ramsel
66,Bergstraat 71,2021-05-30,01:00:00,6,6,0,FMN GV 11 Ramsel
66,Bergstraat 71,2021-05-30,02:00:00,26,24,2,FMN GV 11 Ramsel
66,Bergstraat 71,2021-05-30,03:00:00,2,0,2,FMN GV 11 Ramsel
66,Bergstraat 71,2021-05-30,04:00:00,0,0,0,FMN GV 11 Ramsel
66,Bergstraat 71,2021-05-30,05:00:00,4,4,0,FMN GV 11 Ramsel
66,Bergstraat 71,2021-05-30,06:00:00,8,2,6,FMN GV 11 Ramsel
66,Bergstraat 71,2021-05-30,07:00:00,40,18,22,FMN GV 11 Ramsel
66,Bergstraat 71,2021-05-30,08:00:00,142,38,104,FMN GV 11 Ramsel
66,Bergstraat 71,2021-05-30,09:00:00,292,116,176,FMN GV 11 Ramsel
66,Bergstraat 71,2021-05-30,10:00:00,242,120,122,FMN GV 11 Ramsel
66,Bergstraat 71,2021-05-30,11:00:00,374,216,158,FMN GV 11 Ramsel
66,Bergstraat 71,2021-05-30,12:00:00,320,158,162,FMN GV 11 Ramsel
66,Bergstraat 71,2021-05-30,13:00:00,442,242,200,FMN GV 11 Ramsel
66,Bergstraat 71,2021-05-30,14:00:00,534,264,270,FMN GV 11 Ramsel
66,Bergstraat 71,2021-05-30,15:00:00,456,258,198,FMN GV 11 Ramsel
66,Bergstraat 71,2021-05-30,16:00:00,384,198,186,FMN GV 11 Ramsel
66,Bergstraat 71,2021-05-30,17:00:00,224,134,90,FMN GV 11 Ramsel
66,Bergstraat 71,2021-05-30,18:00:00,186,108,78,FMN GV 11 Ramsel
66,Bergstraat 71,2021-05-30,19:00:00,78,36,42,FMN GV 11 Ramsel
66,Bergstraat 71,2021-05-30,20:00:00,84,38,46,FMN GV 11 Ramsel
66,Bergstraat 71,2021-05-30,21:00:00,30,14,16,FMN GV 11 Ramsel
66,Bergstraat 71,2021-05-30,22:00:00,16,4,12,FMN GV 11 Ramsel
66,Bergstraat 71,2021-05-30,23:00:00,6,6,0,FMN GV 11 Ramsel
66,Bergstraat 71,2021-05-31,00:00:00,0,0,0,FMN GV 11 Ramsel
66,Bergstraat 71,2021-05-31,01:00:00,0,0,0,FMN GV 11 Ramsel
66,Bergstraat 71,2021-05-31,02:00:00,0,0,0,FMN GV 11 Ramsel
66,Bergstraat 71,2021-05-31,03:00:00,0,0,0,FMN GV 11 Ramsel
66,Bergstraat 71,2021-05-31,04:00:00,4,4,0,FMN GV 11 Ramsel
66,Bergstraat 71,2021-05-31,05:00:00,20,8,12,FMN GV 11 Ramsel
66,Bergstraat 71,2021-05-31,06:00:00,54,28,26,FMN GV 11 Ramsel
66,Bergstraat 71,2021-05-31,07:00:00,238,30,208,FMN GV 11 Ramsel
66,Bergstraat 71,2021-05-31,08:00:00,198,28,170,FMN GV 11 Ramsel
66,Bergstraat 71,2021-05-31,09:00:00,98,42,56,FMN GV 11 Ramsel
66,Bergstraat 71,2021-05-31,10:00:00,118,52,66,FMN GV 11 Ramsel
66,Bergstraat 71,2021-05-31,11:00:00,84,44,40,FMN GV 11 Ramsel
66,Bergstraat 71,2021-05-31,12:00:00,76,36,40,FMN GV 11 Ramsel
66,Bergstraat 71,2021-05-31,13:00:00,220,104,116,FMN GV 11 Ramsel
66,Bergstraat 71,2021-05-31,14:00:00,274,156,118,FMN GV 11 Ramsel
66,Bergstraat 71,2021-05-31,15:00:00,384,286,98,FMN GV 11 Ramsel
66,Bergstraat 71,2021-05-31,16:00:00,280,200,80,FMN GV 11 Ramsel
66,Bergstraat 71,2021-05-31,17:00:00,186,118,68,FMN GV 11 Ramsel
66,Bergstraat 71,2021-05-31,18:00:00,64,32,32,FMN GV 11 Ramsel
66,Bergstraat 71,2021-05-31,19:00:00,124,56,68,FMN GV 11 Ramsel
66,Bergstraat 71,2021-05-31,20:00:00,68,28,40,FMN GV 11 Ramsel
66,Bergstraat 71,2021-05-31,21:00:00,36,16,20,FMN GV 11 Ramsel
66,Bergstraat 71,2021-05-31,22:00:00,18,10,8,FMN GV 11 Ramsel
66,Bergstraat 71,2021-05-31,23:00:00,2,2,0,FMN GV 11 Ramsel
66,Bergstraat 71,2021-06-01,00:00:00,0,0,0,FMN GV 11 Ramsel
66,Bergstraat 71,2021-06-01,01:00:00,0,0,0,FMN GV 11 Ramsel
66,Bergstraat 71,2021-06-01,02:00:00,0,0,0,FMN GV 11 Ramsel
66,Bergstraat 71,2021-06-01,03:00:00,0,0,0,FMN GV 11 Ramsel
66,Bergstraat 71,2021-06-01,04:00:00,8,4,4,FMN GV 11 Ramsel
66,Bergstraat 71,2021-06-01,05:00:00,16,6,10,FMN GV 11 Ramsel
66,Bergstraat 71,2021-06-01,06:00:00,44,24,20,FMN GV 11 Ramsel
66,Bergstraat 71,2021-06-01,07:00:00,270,26,244,FMN GV 11 Ramsel
66,Bergstraat 71,2021-06-01,08:00:00,220,36,184,FMN GV 11 Ramsel
66,Bergstraat 71,2021-06-01,09:00:00,90,32,58,FMN GV 11 Ramsel
66,Bergstraat 71,2021-06-01,10:00:00,146,56,90,FMN GV 11 Ramsel
66,Bergstraat 71,2021-06-01,11:00:00,112,50,62,FMN GV 11 Ramsel
66,Bergstraat 71,2021-06-01,12:00:00,152,84,68,FMN GV 11 Ramsel
66,Bergstraat 71,2021-06-01,13:00:00,318,162,156,FMN GV 11 Ramsel
66,Bergstraat 71,2021-06-01,14:00:00,330,190,140,FMN GV 11 Ramsel
66,Bergstraat 71,2021-06-01,15:00:00,432,318,114,FMN GV 11 Ramsel
66,Bergstraat 71,2021-06-01,16:00:00,348,248,100,FMN GV 11 Ramsel
66,Bergstraat 71,2021-06-01,17:00:00,212,104,108,FMN GV 11 Ramsel
66,Bergstraat 71,2021-06-01,18:00:00,206,96,110,FMN GV 11 Ramsel
66,Bergstraat 71,2021-06-01,19:00:00,148,96,52,FMN GV 11 Ramsel
66,Bergstraat 71,2021-06-01,20:00:00,102,50,52,FMN GV 11 Ramsel
66,Bergstraat 71,2021-06-01,21:00:00,76,36,40,FMN GV 11 Ramsel
66,Bergstraat 71,2021-06-01,22:00:00,24,14,10,FMN GV 11 Ramsel
66,Bergstraat 71,2021-06-01,23:00:00,6,4,2,FMN GV 11 Ramsel
66,Bergstraat 71,2021-06-02,00:00:00,2,0,2,FMN GV 11 Ramsel
66,Bergstraat 71,2021-06-02,01:00:00,0,0,0,FMN GV 11 Ramsel
66,Bergstraat 71,2021-06-02,02:00:00,0,0,0,FMN GV 11 Ramsel
66,Bergstraat 71,2021-06-02,03:00:00,0,0,0,FMN GV 11 Ramsel
66,Bergstraat 71,2021-06-02,04:00:00,8,4,4,FMN GV 11 Ramsel
66,Bergstraat 71,2021-06-02,05:00:00,10,4,6,FMN GV 11 Ramsel
66,Bergstraat 71,2021-06-02,06:00:00,50,22,28,FMN GV 11 Ramsel
66,Bergstraat 71,2021-06-02,07:00:00,230,18,212,FMN GV 11 Ramsel
66,Bergstraat 71,2021-06-02,08:00:00,256,50,206,FMN GV 11 Ramsel
66,Bergstraat 71,2021-06-02,09:00:00,96,32,64,FMN GV 11 Ramsel
66,Bergstraat 71,2021-06-02,10:00:00,130,70,60,FMN GV 11 Ramsel
66,Bergstraat 71,2021-06-02,11:00:00,182,88,94,FMN GV 11 Ramsel
66,Bergstraat 71,2021-06-02,12:00:00,408,330,78,FMN GV 11 Ramsel
66,Bergstraat 71,2021-06-02,13:00:00,320,184,136,FMN GV 11 Ramsel
66,Bergstraat 71,2021-06-02,14:00:00,356,166,190,FMN GV 11 Ramsel
66,Bergstraat 71,2021-06-02,15:00:00,290,160,130,FMN GV 11 Ramsel
66,Bergstraat 71,2021-06-02,16:00:00,344,186,158,FMN GV 11 Ramsel
66,Bergstraat 71,2021-06-02,17:00:00,238,158,80,FMN GV 11 Ramsel
66,Bergstraat 71,2021-06-02,18:00:00,152,74,78,FMN GV 11 Ramsel
66,Bergstraat 71,2021-06-02,19:00:00,138,78,60,FMN GV 11 Ramsel
66,Bergstraat 71,2021-06-02,20:00:00,116,52,64,FMN GV 11 Ramsel
66,Bergstraat 71,2021-06-02,21:00:00,60,40,20,FMN GV 11 Ramsel
66,Bergstraat 71,2021-06-02,22:00:00,32,24,8,FMN GV 11 Ramsel
66,Bergstraat 71,2021-06-02,23:00:00,2,2,0,FMN GV 11 Ramsel
66,Bergstraat 71,2021-06-03,00:00:00,0,0,0,FMN GV 11 Ramsel
66,Bergstraat 71,2021-06-03,01:00:00,0,0,0,FMN GV 11 Ramsel
66,Bergstraat 71,2021-06-03,02:00:00,0,0,0,FMN GV 11 Ramsel
66,Bergstraat 71,2021-06-03,03:00:00,0,0,0,FMN GV 11 Ramsel
66,Bergstraat 71,2021-06-03,04:00:00,2,2,0,FMN GV 11 Ramsel
66,Bergstraat 71,2021-06-03,05:00:00,6,2,4,FMN GV 11 Ramsel
66,Bergstraat 71,2021-06-03,06:00:00,50,22,28,FMN GV 11 Ramsel
66,Bergstraat 71,2021-06-03,07:00:00,182,12,170,FMN GV 11 Ramsel
66,Bergstraat 71,2021-06-03,08:00:00,212,44,168,FMN GV 11 Ramsel
66,Bergstraat 71,2021-06-03,09:00:00,78,28,50,FMN GV 11 Ramsel
66,Bergstraat 71,2021-06-03,10:00:00,86,30,56,FMN GV 11 Ramsel
66,Bergstraat 71,2021-06-03,11:00:00,64,28,36,FMN GV 11 Ramsel
66,Bergstraat 71,2021-06-03,12:00:00,92,64,28,FMN GV 11 Ramsel
66,Bergstraat 71,2021-06-03,13:00:00,74,18,56,FMN GV 11 Ramsel
66,Bergstraat 71,2021-06-03,14:00:00,152,98,54,FMN GV 11 Ramsel
66,Bergstraat 71,2021-06-03,15:00:00,264,226,38,FMN GV 11 Ramsel
66,Bergstraat 71,2021-06-03,16:00:00,182,124,58,FMN GV 11 Ramsel
66,Bergstraat 71,2021-06-03,17:00:00,106,76,30,FMN GV 11 Ramsel
66,Bergstraat 71,2021-06-03,18:00:00,102,42,60,FMN GV 11 Ramsel
66,Bergstraat 71,2021-06-03,19:00:00,110,58,52,FMN GV 11 Ramsel
66,Bergstraat 71,2021-06-03,20:00:00,110,66,44,FMN GV 11 Ramsel
66,Bergstraat 71,2021-06-03,21:00:00,34,16,18,FMN GV 11 Ramsel
66,Bergstraat 71,2021-06-03,22:00:00,28,18,10,FMN GV 11 Ramsel
66,Bergstraat 71,2021-06-03,23:00:00,10,8,2,FMN GV 11 Ramsel
66,Bergstraat 71,2021-06-04,00:00:00,0,0,0,FMN GV 11 Ramsel
66,Bergstraat 71,2021-06-04,01:00:00,0,0,0,FMN GV 11 Ramsel
66,Bergstraat 71,2021-06-04,02:00:00,0,0,0,FMN GV 11 Ramsel
66,Bergstraat 71,2021-06-04,03:00:00,2,2,0,FMN GV 11 Ramsel
66,Bergstraat 71,2021-06-04,04:00:00,2,2,0,FMN GV 11 Ramsel
66,Bergstraat 71,2021-06-04,05:00:00,6,4,2,FMN GV 11 Ramsel
66,Bergstraat 71,2021-06-04,06:00:00,36,14,22,FMN GV 11 Ramsel
66,Bergstraat 71,2021-06-04,07:00:00,190,20,170,FMN GV 11 Ramsel
66,Bergstraat 71,2021-06-04,08:00:00,174,14,160,FMN GV 11 Ramsel
66,Bergstraat 71,2021-06-04,09:00:00,92,48,44,FMN GV 11 Ramsel
66,Bergstraat 71,2021-06-04,10:00:00,130,72,58,FMN GV 11 Ramsel
66,Bergstraat 71,2021-06-04,11:00:00,100,46,54,FMN GV 11 Ramsel
66,Bergstraat 71,2021-06-04,12:00:00,102,42,60,FMN GV 11 Ramsel
66,Bergstraat 71,2021-06-04,13:00:00,120,70,50,FMN GV 11 Ramsel
66,Bergstraat 71,2021-06-04,14:00:00,142,74,68,FMN GV 11 Ramsel
66,Bergstraat 71,2021-06-04,15:00:00,334,254,80,FMN GV 11 Ramsel
66,Bergstraat 71,2021-06-04,16:00:00,94,78,16,FMN GV 11 Ramsel
66,Bergstraat 71,2021-06-04,17:00:00,62,28,34,FMN GV 11 Ramsel
66,Bergstraat 71,2021-06-04,18:00:00,34,16,18,FMN GV 11 Ramsel
66,Bergstraat 71,2021-06-04,19:00:00,22,8,14,FMN GV 11 Ramsel
66,Bergstraat 71,2021-06-04,20:00:00,10,4,6,FMN GV 11 Ramsel
66,Bergstraat 71,2021-06-04,21:00:00,22,6,16,FMN GV 11 Ramsel
66,Bergstraat 71,2021-06-04,22:00:00,20,18,2,FMN GV 11 Ramsel
66,Bergstraat 71,2021-06-04,23:00:00,10,2,8,FMN GV 11 Ramsel
66,Bergstraat 71,2021-06-05,00:00:00,12,6,6,FMN GV 11 Ramsel
66,Bergstraat 71,2021-06-05,01:00:00,10,10,0,FMN GV 11 Ramsel
66,Bergstraat 71,2021-06-05,02:00:00,6,0,6,FMN GV 11 Ramsel
66,Bergstraat 71,2021-06-05,03:00:00,8,0,8,FMN GV 11 Ramsel
66,Bergstraat 71,2021-06-05,04:00:00,0,0,0,FMN GV 11 Ramsel
66,Bergstraat 71,2021-06-05,05:00:00,4,2,2,FMN GV 11 Ramsel
66,Bergstraat 71,2021-06-05,06:00:00,6,2,4,FMN GV 11 Ramsel
66,Bergstraat 71,2021-06-05,07:00:00,18,6,12,FMN GV 11 Ramsel
66,Bergstraat 71,2021-06-05,08:00:00,46,26,20,FMN GV 11 Ramsel
66,Bergstraat 71,2021-06-05,09:00:00,58,18,40,FMN GV 11 Ramsel
66,Bergstraat 71,2021-06-05,10:00:00,44,22,22,FMN GV 11 Ramsel
66,Bergstraat 71,2021-06-05,11:00:00,78,30,48,FMN GV 11 Ramsel
66,Bergstraat 71,2021-06-05,12:00:00,144,80,64,FMN GV 11 Ramsel
66,Bergstraat 71,2021-06-05,13:00:00,112,42,70,FMN GV 11 Ramsel
66,Bergstraat 71,2021-06-05,14:00:00,104,56,48,FMN GV 11 Ramsel
66,Bergstraat 71,2021-06-05,15:00:00,98,62,36,FMN GV 11 Ramsel
66,Bergstraat 71,2021-06-05,16:00:00,136,84,52,FMN GV 11 Ramsel
66,Bergstraat 71,2021-06-05,17:00:00,66,40,26,FMN GV 11 Ramsel
66,Bergstraat 71,2021-06-05,18:00:00,82,44,38,FMN GV 11 Ramsel
66,Bergstraat 71,2021-06-05,19:00:00,66,36,30,FMN GV 11 Ramsel
66,Bergstraat 71,2021-06-05,20:00:00,26,14,12,FMN GV 11 Ramsel
66,Bergstraat 71,2021-06-05,21:00:00,30,16,14,FMN GV 11 Ramsel
66,Bergstraat 71,2021-06-05,22:00:00,12,8,4,FMN GV 11 Ramsel
66,Bergstraat 71,2021-06-05,23:00:00,4,2,2,FMN GV 11 Ramsel
66,Bergstraat 71,2021-06-06,00:00:00,6,6,0,FMN GV 11 Ramsel
66,Bergstraat 71,2021-06-06,01:00:00,6,6,0,FMN GV 11 Ramsel
66,Bergstraat 71,2021-06-06,02:00:00,2,0,2,FMN GV 11 Ramsel
66,Bergstraat 71,2021-06-06,03:00:00,0,0,0,FMN GV 11 Ramsel
66,Bergstraat 71,2021-06-06,04:00:00,0,0,0,FMN GV 11 Ramsel
66,Bergstraat 71,2021-06-06,05:00:00,4,2,2,FMN GV 11 Ramsel
66,Bergstraat 71,2021-06-06,06:00:00,6,2,4,FMN GV 11 Ramsel
66,Bergstraat 71,2021-06-06,07:00:00,40,18,22,FMN GV 11 Ramsel
66,Bergstraat 71,2021-06-06,08:00:00,158,68,90,FMN GV 11 Ramsel
66,Bergstraat 71,2021-06-06,09:00:00,192,84,108,FMN GV 11 Ramsel
66,Bergstraat 71,2021-06-06,10:00:00,270,120,150,FMN GV 11 Ramsel
66,Bergstraat 71,2021-06-06,11:00:00,324,158,166,FMN GV 11 Ramsel
66,Bergstraat 71,2021-06-06,12:00:00,278,152,126,FMN GV 11 Ramsel
66,Bergstraat 71,2021-06-06,13:00:00,384,202,182,FMN GV 11 Ramsel
66,Bergstraat 71,2021-06-06,14:00:00,452,240,212,FMN GV 11 Ramsel
66,Bergstraat 71,2021-06-06,15:00:00,352,222,130,FMN GV 11 Ramsel
66,Bergstraat 71,2021-06-06,16:00:00,266,130,136,FMN GV 11 Ramsel
66,Bergstraat 71,2021-06-06,17:00:00,196,94,102,FMN GV 11 Ramsel
66,Bergstraat 71,2021-06-06,18:00:00,128,48,80,FMN GV 11 Ramsel
66,Bergstraat 71,2021-06-06,19:00:00,112,60,52,FMN GV 11 Ramsel
66,Bergstraat 71,2021-06-06,20:00:00,84,32,52,FMN GV 11 Ramsel
66,Bergstraat 71,2021-06-06,21:00:00,32,16,16,FMN GV 11 Ramsel
66,Bergstraat 71,2021-06-06,22:00:00,22,20,2,FMN GV 11 Ramsel
66,Bergstraat 71,2021-06-06,23:00:00,8,4,4,FMN GV 11 Ramsel
66,Bergstraat 71,2021-06-07,00:00:00,0,0,0,FMN GV 11 Ramsel
66,Bergstraat 71,2021-06-07,01:00:00,0,0,0,FMN GV 11 Ramsel
66,Bergstraat 71,2021-06-07,02:00:00,0,0,0,FMN GV 11 Ramsel
66,Bergstraat 71,2021-06-07,03:00:00,0,0,0,FMN GV 11 Ramsel
66,Bergstraat 71,2021-06-07,04:00:00,4,4,0,FMN GV 11 Ramsel
66,Bergstraat 71,2021-06-07,05:00:00,10,6,4,FMN GV 11 Ramsel
66,Bergstraat 71,2021-06-07,06:00:00,52,16,36,FMN GV 11 Ramsel
66,Bergstraat 71,2021-06-07,07:00:00,258,24,234,FMN GV 11 Ramsel
66,Bergstraat 71,2021-06-07,08:00:00,208,22,186,FMN GV 11 Ramsel
66,Bergstraat 71,2021-06-07,09:00:00,94,48,46,FMN GV 11 Ramsel
66,Bergstraat 71,2021-06-07,10:00:00,96,44,52,FMN GV 11 Ramsel
66,Bergstraat 71,2021-06-07,11:00:00,54,22,32,FMN GV 11 Ramsel
66,Bergstraat 71,2021-06-07,12:00:00,106,58,48,FMN GV 11 Ramsel
66,Bergstraat 71,2021-06-07,13:00:00,178,100,78,FMN GV 11 Ramsel
66,Bergstraat 71,2021-06-07,14:00:00,168,72,96,FMN GV 11 Ramsel
66,Bergstraat 71,2021-06-07,15:00:00,368,298,70,FMN GV 11 Ramsel
66,Bergstraat 71,2021-06-07,16:00:00,272,182,90,FMN GV 11 Ramsel
66,Bergstraat 71,2021-06-07,17:00:00,158,110,48,FMN GV 11 Ramsel
66,Bergstraat 71,2021-06-07,18:00:00,76,40,36,FMN GV 11 Ramsel
66,Bergstraat 71,2021-06-07,19:00:00,102,40,62,FMN GV 11 Ramsel
66,Bergstraat 71,2021-06-07,20:00:00,66,28,38,FMN GV 11 Ramsel
66,Bergstraat 71,2021-06-07,21:00:00,46,20,26,FMN GV 11 Ramsel
66,Bergstraat 71,2021-06-07,22:00:00,22,12,10,FMN GV 11 Ramsel
66,Bergstraat 71,2021-06-07,23:00:00,2,0,2,FMN GV 11 Ramsel
66,Bergstraat 71,2021-06-08,00:00:00,0,0,0,FMN GV 11 Ramsel
66,Bergstraat 71,2021-06-08,01:00:00,0,0,0,FMN GV 11 Ramsel
66,Bergstraat 71,2021-06-08,02:00:00,0,0,0,FMN GV 11 Ramsel
66,Bergstraat 71,2021-06-08,03:00:00,0,0,0,FMN GV 11 Ramsel
66,Bergstraat 71,2021-06-08,04:00:00,4,4,0,FMN GV 11 Ramsel
66,Bergstraat 71,2021-06-08,05:00:00,18,10,8,FMN GV 11 Ramsel
66,Bergstraat 71,2021-06-08,06:00:00,60,18,42,FMN GV 11 Ramsel
66,Bergstraat 71,2021-06-08,07:00:00,210,20,190,FMN GV 11 Ramsel
66,Bergstraat 71,2021-06-08,08:00:00,222,26,196,FMN GV 11 Ramsel
66,Bergstraat 71,2021-06-08,09:00:00,102,46,56,FMN GV 11 Ramsel
66,Bergstraat 71,2021-06-08,10:00:00,112,38,74,FMN GV 11 Ramsel
66,Bergstraat 71,2021-06-08,11:00:00,142,72,70,FMN GV 11 Ramsel
66,Bergstraat 71,2021-06-08,12:00:00,138,78,60,FMN GV 11 Ramsel
66,Bergstraat 71,2021-06-08,13:00:00,190,98,92,FMN GV 11 Ramsel
66,Bergstraat 71,2021-06-08,14:00:00,234,128,106,FMN GV 11 Ramsel
66,Bergstraat 71,2021-06-08,15:00:00,416,270,146,FMN GV 11 Ramsel
66,Bergstraat 71,2021-06-08,16:00:00,322,206,116,FMN GV 11 Ramsel
66,Bergstraat 71,2021-06-08,17:00:00,152,94,58,FMN GV 11 Ramsel
66,Bergstraat 71,2021-06-08,18:00:00,146,78,68,FMN GV 11 Ramsel
66,Bergstraat 71,2021-06-08,19:00:00,122,48,74,FMN GV 11 Ramsel
66,Bergstraat 71,2021-06-08,20:00:00,102,74,28,FMN GV 11 Ramsel
66,Bergstraat 71,2021-06-08,21:00:00,72,46,26,FMN GV 11 Ramsel
66,Bergstraat 71,2021-06-08,22:00:00,12,10,2,FMN GV 11 Ramsel
66,Bergstraat 71,2021-06-08,23:00:00,6,4,2,FMN GV 11 Ramsel
66,Bergstraat 71,2021-06-09,00:00:00,2,2,0,FMN GV 11 Ramsel
66,Bergstraat 71,2021-06-09,01:00:00,0,0,0,FMN GV 11 Ramsel
66,Bergstraat 71,2021-06-09,02:00:00,2,2,0,FMN GV 11 Ramsel
66,Bergstraat 71,2021-06-09,03:00:00,2,0,2,FMN GV 11 Ramsel
66,Bergstraat 71,2021-06-09,04:00:00,6,4,2,FMN GV 11 Ramsel
66,Bergstraat 71,2021-06-09,05:00:00,18,8,10,FMN GV 11 Ramsel
66,Bergstraat 71,2021-06-09,06:00:00,44,18,26,FMN GV 11 Ramsel
66,Bergstraat 71,2021-06-09,07:00:00,238,14,224,FMN GV 11 Ramsel
66,Bergstraat 71,2021-06-09,08:00:00,258,44,214,FMN GV 11 Ramsel
66,Bergstraat 71,2021-06-09,09:00:00,74,26,48,FMN GV 11 Ramsel
66,Bergstraat 71,2021-06-09,10:00:00,120,62,58,FMN GV 11 Ramsel
66,Bergstraat 71,2021-06-09,11:00:00,156,98,58,FMN GV 11 Ramsel
66,Bergstraat 71,2021-06-09,12:00:00,390,314,76,FMN GV 11 Ramsel
66,Bergstraat 71,2021-06-09,13:00:00,236,132,104,FMN GV 11 Ramsel
66,Bergstraat 71,2021-06-09,14:00:00,236,112,124,FMN GV 11 Ramsel
66,Bergstraat 71,2021-06-09,15:00:00,258,164,94,FMN GV 11 Ramsel
66,Bergstraat 71,2021-06-09,16:00:00,216,120,96,FMN GV 11 Ramsel
66,Bergstraat 71,2021-06-09,17:00:00,184,84,100,FMN GV 11 Ramsel
66,Bergstraat 71,2021-06-09,18:00:00,182,86,96,FMN GV 11 Ramsel
66,Bergstraat 71,2021-06-09,19:00:00,170,98,72,FMN GV 11 Ramsel
66,Bergstraat 71,2021-06-09,20:00:00,96,52,44,FMN GV 11 Ramsel
66,Bergstraat 71,2021-06-09,21:00:00,50,36,14,FMN GV 11 Ramsel
66,Bergstraat 71,2021-06-09,22:00:00,40,20,20,FMN GV 11 Ramsel
66,Bergstraat 71,2021-06-09,23:00:00,2,0,2,FMN GV 11 Ramsel
66,Bergstraat 71,2021-06-10,00:00:00,2,2,0,FMN GV 11 Ramsel
66,Bergstraat 71,2021-06-10,01:00:00,0,0,0,FMN GV 11 Ramsel
66,Bergstraat 71,2021-06-10,02:00:00,0,0,0,FMN GV 11 Ramsel
66,Bergstraat 71,2021-06-10,03:00:00,0,0,0,FMN GV 11 Ramsel
66,Bergstraat 71,2021-06-10,04:00:00,2,2,0,FMN GV 11 Ramsel
66,Bergstraat 71,2021-06-10,05:00:00,22,12,10,FMN GV 11 Ramsel
66,Bergstraat 71,2021-06-10,06:00:00,56,22,34,FMN GV 11 Ramsel
66,Bergstraat 71,2021-06-10,07:00:00,230,26,204,FMN GV 11 Ramsel
66,Bergstraat 71,2021-06-10,08:00:00,248,44,204,FMN GV 11 Ramsel
66,Bergstraat 71,2021-06-10,09:00:00,142,28,114,FMN GV 11 Ramsel
66,Bergstraat 71,2021-06-10,10:00:00,206,104,102,FMN GV 11 Ramsel
66,Bergstraat 71,2021-06-10,11:00:00,134,76,58,FMN GV 11 Ramsel
66,Bergstraat 71,2021-06-10,12:00:00,182,106,76,FMN GV 11 Ramsel
66,Bergstraat 71,2021-06-10,13:00:00,184,96,88,FMN GV 11 Ramsel
66,Bergstraat 71,2021-06-10,14:00:00,270,154,116,FMN GV 11 Ramsel
66,Bergstraat 71,2021-06-10,15:00:00,358,274,84,FMN GV 11 Ramsel
66,Bergstraat 71,2021-06-10,16:00:00,234,156,78,FMN GV 11 Ramsel
66,Bergstraat 71,2021-06-10,17:00:00,140,86,54,FMN GV 11 Ramsel
66,Bergstraat 71,2021-06-10,18:00:00,124,74,50,FMN GV 11 Ramsel
66,Bergstraat 71,2021-06-10,19:00:00,144,86,58,FMN GV 11 Ramsel
66,Bergstraat 71,2021-06-10,20:00:00,142,66,76,FMN GV 11 Ramsel
66,Bergstraat 71,2021-06-10,21:00:00,68,38,30,FMN GV 11 Ramsel
66,Bergstraat 71,2021-06-10,22:00:00,32,22,10,FMN GV 11 Ramsel
66,Bergstraat 71,2021-06-10,23:00:00,14,12,2,FMN GV 11 Ramsel
66,Bergstraat 71,2021-06-11,00:00:00,4,4,0,FMN GV 11 Ramsel
66,Bergstraat 71,2021-06-11,01:00:00,0,0,0,FMN GV 11 Ramsel
66,Bergstraat 71,2021-06-11,02:00:00,0,0,0,FMN GV 11 Ramsel
66,Bergstraat 71,2021-06-11,03:00:00,0,0,0,FMN GV 11 Ramsel
66,Bergstraat 71,2021-06-11,04:00:00,2,2,0,FMN GV 11 Ramsel
66,Bergstraat 71,2021-06-11,05:00:00,6,4,2,FMN GV 11 Ramsel
66,Bergstraat 71,2021-06-11,06:00:00,36,12,24,FMN GV 11 Ramsel
66,Bergstraat 71,2021-06-11,07:00:00,240,28,212,FMN GV 11 Ramsel
66,Bergstraat 71,2021-06-11,08:00:00,210,34,176,FMN GV 11 Ramsel
66,Bergstraat 71,2021-06-11,09:00:00,112,32,80,FMN GV 11 Ramsel
66,Bergstraat 71,2021-06-11,10:00:00,144,74,70,FMN GV 11 Ramsel
66,Bergstraat 71,2021-06-11,11:00:00,152,104,48,FMN GV 11 Ramsel
66,Bergstraat 71,2021-06-11,12:00:00,136,80,56,FMN GV 11 Ramsel
66,Bergstraat 71,2021-06-11,13:00:00,172,70,102,FMN GV 11 Ramsel
66,Bergstraat 71,2021-06-11,14:00:00,268,132,136,FMN GV 11 Ramsel
66,Bergstraat 71,2021-06-11,15:00:00,388,278,110,FMN GV 11 Ramsel
66,Bergstraat 71,2021-06-11,16:00:00,246,166,80,FMN GV 11 Ramsel
66,Bergstraat 71,2021-06-11,17:00:00,160,110,50,FMN GV 11 Ramsel
66,Bergstraat 71,2021-06-11,18:00:00,126,54,72,FMN GV 11 Ramsel
66,Bergstraat 71,2021-06-11,19:00:00,108,64,44,FMN GV 11 Ramsel
66,Bergstraat 71,2021-06-11,20:00:00,88,54,34,FMN GV 11 Ramsel
66,Bergstraat 71,2021-06-11,21:00:00,82,24,58,FMN GV 11 Ramsel
66,Bergstraat 71,2021-06-11,22:00:00,18,12,6,FMN GV 11 Ramsel
66,Bergstraat 71,2021-06-11,23:00:00,26,12,14,FMN GV 11 Ramsel
66,Bergstraat 71,2021-06-12,00:00:00,16,12,4,FMN GV 11 Ramsel
66,Bergstraat 71,2021-06-12,01:00:00,8,6,2,FMN GV 11 Ramsel
66,Bergstraat 71,2021-06-12,02:00:00,14,12,2,FMN GV 11 Ramsel
66,Bergstraat 71,2021-06-12,03:00:00,4,4,0,FMN GV 11 Ramsel
66,Bergstraat 71,2021-06-12,04:00:00,0,0,0,FMN GV 11 Ramsel
66,Bergstraat 71,2021-06-12,05:00:00,4,4,0,FMN GV 11 Ramsel
66,Bergstraat 71,2021-06-12,06:00:00,14,2,12,FMN GV 11 Ramsel
66,Bergstraat 71,2021-06-12,07:00:00,18,6,12,FMN GV 11 Ramsel
66,Bergstraat 71,2021-06-12,08:00:00,40,22,18,FMN GV 11 Ramsel
66,Bergstraat 71,2021-06-12,09:00:00,86,34,52,FMN GV 11 Ramsel
66,Bergstraat 71,2021-06-12,10:00:00,80,44,36,FMN GV 11 Ramsel
66,Bergstraat 71,2021-06-12,11:00:00,92,56,36,FMN GV 11 Ramsel
66,Bergstraat 71,2021-06-12,12:00:00,102,44,58,FMN GV 11 Ramsel
66,Bergstraat 71,2021-06-12,13:00:00,166,62,104,FMN GV 11 Ramsel
66,Bergstraat 71,2021-06-12,14:00:00,146,56,90,FMN GV 11 Ramsel
66,Bergstraat 71,2021-06-12,15:00:00,272,134,138,FMN GV 11 Ramsel
66,Bergstraat 71,2021-06-12,16:00:00,198,106,92,FMN GV 11 Ramsel
66,Bergstraat 71,2021-06-12,17:00:00,152,86,66,FMN GV 11 Ramsel
66,Bergstraat 71,2021-06-12,18:00:00,100,38,62,FMN GV 11 Ramsel
66,Bergstraat 71,2021-06-12,19:00:00,58,24,34,FMN GV 11 Ramsel
66,Bergstraat 71,2021-06-12,20:00:00,54,26,28,FMN GV 11 Ramsel
66,Bergstraat 71,2021-06-12,21:00:00,28,18,10,FMN GV 11 Ramsel
66,Bergstraat 71,2021-06-12,22:00:00,20,16,4,FMN GV 11 Ramsel
66,Bergstraat 71,2021-06-12,23:00:00,30,18,12,FMN GV 11 Ramsel
66,Bergstraat 71,2021-06-13,00:00:00,22,22,0,FMN GV 11 Ramsel
66,Bergstraat 71,2021-06-13,01:00:00,12,10,2,FMN GV 11 Ramsel
66,Bergstraat 71,2021-06-13,02:00:00,6,2,4,FMN GV 11 Ramsel
66,Bergstraat 71,2021-06-13,03:00:00,6,6,0,FMN GV 11 Ramsel
66,Bergstraat 71,2021-06-13,04:00:00,2,0,2,FMN GV 11 Ramsel
66,Bergstraat 71,2021-06-13,05:00:00,4,4,0,FMN GV 11 Ramsel
66,Bergstraat 71,2021-06-13,06:00:00,12,2,10,FMN GV 11 Ramsel
66,Bergstraat 71,2021-06-13,07:00:00,34,18,16,FMN GV 11 Ramsel
66,Bergstraat 71,2021-06-13,08:00:00,132,36,96,FMN GV 11 Ramsel
66,Bergstraat 71,2021-06-13,09:00:00,184,80,104,FMN GV 11 Ramsel
66,Bergstraat 71,2021-06-13,10:00:00,222,120,102,FMN GV 11 Ramsel
66,Bergstraat 71,2021-06-13,11:00:00,300,154,146,FMN GV 11 Ramsel
66,Bergstraat 71,2021-06-13,12:00:00,280,138,142,FMN GV 11 Ramsel
66,Bergstraat 71,2021-06-13,13:00:00,362,180,182,FMN GV 11 Ramsel
66,Bergstraat 71,2021-06-13,14:00:00,430,228,202,FMN GV 11 Ramsel
66,Bergstraat 71,2021-06-13,15:00:00,358,204,154,FMN GV 11 Ramsel
66,Bergstraat 71,2021-06-13,16:00:00,294,138,156,FMN GV 11 Ramsel
66,Bergstraat 71,2021-06-13,17:00:00,250,144,106,FMN GV 11 Ramsel
66,Bergstraat 71,2021-06-13,18:00:00,230,124,106,FMN GV 11 Ramsel
66,Bergstraat 71,2021-06-13,19:00:00,86,38,48,FMN GV 11 Ramsel
66,Bergstraat 71,2021-06-13,20:00:00,112,54,58,FMN GV 11 Ramsel
66,Bergstraat 71,2021-06-13,21:00:00,62,32,30,FMN GV 11 Ramsel
66,Bergstraat 71,2021-06-13,22:00:00,8,0,8,FMN GV 11 Ramsel
66,Bergstraat 71,2021-06-13,23:00:00,4,0,4,FMN GV 11 Ramsel
66,Bergstraat 71,2021-06-14,00:00:00,2,0,2,FMN GV 11 Ramsel
66,Bergstraat 71,2021-06-14,01:00:00,0,0,0,FMN GV 11 Ramsel
66,Bergstraat 71,2021-06-14,02:00:00,0,0,0,FMN GV 11 Ramsel
66,Bergstraat 71,2021-06-14,03:00:00,2,0,2,FMN GV 11 Ramsel
66,Bergstraat 71,2021-06-14,04:00:00,4,4,0,FMN GV 11 Ramsel
66,Bergstraat 71,2021-06-14,05:00:00,16,6,10,FMN GV 11 Ramsel
66,Bergstraat 71,2021-06-14,06:00:00,46,14,32,FMN GV 11 Ramsel
66,Bergstraat 71,2021-06-14,07:00:00,258,26,232,FMN GV 11 Ramsel
66,Bergstraat 71,2021-06-14,08:00:00,190,24,166,FMN GV 11 Ramsel
66,Bergstraat 71,2021-06-14,09:00:00,110,48,62,FMN GV 11 Ramsel
66,Bergstraat 71,2021-06-14,10:00:00,152,102,50,FMN GV 11 Ramsel
66,Bergstraat 71,2021-06-14,11:00:00,166,104,62,FMN GV 11 Ramsel
66,Bergstraat 71,2021-06-14,12:00:00,226,158,68,FMN GV 11 Ramsel
66,Bergstraat 71,2021-06-14,13:00:00,158,60,98,FMN GV 11 Ramsel
66,Bergstraat 71,2021-06-14,14:00:00,182,88,94,FMN GV 11 Ramsel
66,Bergstraat 71,2021-06-14,15:00:00,272,202,70,FMN GV 11 Ramsel
66,Bergstraat 71,2021-06-14,16:00:00,248,152,96,FMN GV 11 Ramsel
66,Bergstraat 71,2021-06-14,17:00:00,130,54,76,FMN GV 11 Ramsel
66,Bergstraat 71,2021-06-14,18:00:00,106,54,52,FMN GV 11 Ramsel
66,Bergstraat 71,2021-06-14,19:00:00,90,54,36,FMN GV 11 Ramsel
66,Bergstraat 71,2021-06-14,20:00:00,128,74,54,FMN GV 11 Ramsel
66,Bergstraat 71,2021-06-14,21:00:00,62,32,30,FMN GV 11 Ramsel
66,Bergstraat 71,2021-06-14,22:00:00,12,8,4,FMN GV 11 Ramsel
66,Bergstraat 71,2021-06-14,23:00:00,14,12,2,FMN GV 11 Ramsel
66,Bergstraat 71,2021-06-15,00:00:00,2,2,0,FMN GV 11 Ramsel
66,Bergstraat 71,2021-06-15,01:00:00,0,0,0,FMN GV 11 Ramsel
66,Bergstraat 71,2021-06-15,02:00:00,0,0,0,FMN GV 11 Ramsel
66,Bergstraat 71,2021-06-15,03:00:00,0,0,0,FMN GV 11 Ramsel
66,Bergstraat 71,2021-06-15,04:00:00,6,4,2,FMN GV 11 Ramsel
66,Bergstraat 71,2021-06-15,05:00:00,6,4,2,FMN GV 11 Ramsel
66,Bergstraat 71,2021-06-15,06:00:00,62,22,40,FMN GV 11 Ramsel
66,Bergstraat 71,2021-06-15,07:00:00,238,36,202,FMN GV 11 Ramsel
66,Bergstraat 71,2021-06-15,08:00:00,232,50,182,FMN GV 11 Ramsel
66,Bergstraat 71,2021-06-15,09:00:00,142,76,66,FMN GV 11 Ramsel
66,Bergstraat 71,2021-06-15,10:00:00,220,126,94,FMN GV 11 Ramsel
66,Bergstraat 71,2021-06-15,11:00:00,172,120,52,FMN GV 11 Ramsel
66,Bergstraat 71,2021-06-15,12:00:00,190,114,76,FMN GV 11 Ramsel
66,Bergstraat 71,2021-06-15,13:00:00,268,118,150,FMN GV 11 Ramsel
66,Bergstraat 71,2021-06-15,14:00:00,192,94,98,FMN GV 11 Ramsel
66,Bergstraat 71,2021-06-15,15:00:00,268,180,88,FMN GV 11 Ramsel
66,Bergstraat 71,2021-06-15,16:00:00,242,158,84,FMN GV 11 Ramsel
66,Bergstraat 71,2021-06-15,17:00:00,176,74,102,FMN GV 11 Ramsel
66,Bergstraat 71,2021-06-15,18:00:00,166,78,88,FMN GV 11 Ramsel
66,Bergstraat 71,2021-06-15,19:00:00,104,58,46,FMN GV 11 Ramsel
66,Bergstraat 71,2021-06-15,20:00:00,130,94,36,FMN GV 11 Ramsel
66,Bergstraat 71,2021-06-15,21:00:00,84,56,28,FMN GV 11 Ramsel
66,Bergstraat 71,2021-06-15,22:00:00,36,26,10,FMN GV 11 Ramsel
66,Bergstraat 71,2021-06-15,23:00:00,8,4,4,FMN GV 11 Ramsel
66,Bergstraat 71,2021-06-16,00:00:00,2,2,0,FMN GV 11 Ramsel
66,Bergstraat 71,2021-06-16,01:00:00,0,0,0,FMN GV 11 Ramsel
66,Bergstraat 71,2021-06-16,02:00:00,0,0,0,FMN GV 11 Ramsel
66,Bergstraat 71,2021-06-16,03:00:00,2,2,0,FMN GV 11 Ramsel
66,Bergstraat 71,2021-06-16,04:00:00,4,4,0,FMN GV 11 Ramsel
66,Bergstraat 71,2021-06-16,05:00:00,18,10,8,FMN GV 11 Ramsel
66,Bergstraat 71,2021-06-16,06:00:00,38,12,26,FMN GV 11 Ramsel
66,Bergstraat 71,2021-06-16,07:00:00,260,22,238,FMN GV 11 Ramsel
66,Bergstraat 71,2021-06-16,08:00:00,214,44,170,FMN GV 11 Ramsel
66,Bergstraat 71,2021-06-16,09:00:00,146,48,98,FMN GV 11 Ramsel
66,Bergstraat 71,2021-06-16,10:00:00,246,138,108,FMN GV 11 Ramsel
66,Bergstraat 71,2021-06-16,11:00:00,162,104,58,FMN GV 11 Ramsel
66,Bergstraat 71,2021-06-16,12:00:00,244,186,58,FMN GV 11 Ramsel
66,Bergstraat 71,2021-06-16,13:00:00,144,76,68,FMN GV 11 Ramsel
66,Bergstraat 71,2021-06-16,14:00:00,164,88,76,FMN GV 11 Ramsel
66,Bergstraat 71,2021-06-16,15:00:00,146,86,60,FMN GV 11 Ramsel
66,Bergstraat 71,2021-06-16,16:00:00,166,88,78,FMN GV 11 Ramsel
66,Bergstraat 71,2021-06-16,17:00:00,154,88,66,FMN GV 11 Ramsel
66,Bergstraat 71,2021-06-16,18:00:00,146,92,54,FMN GV 11 Ramsel
66,Bergstraat 71,2021-06-16,19:00:00,144,84,60,FMN GV 11 Ramsel
66,Bergstraat 71,2021-06-16,20:00:00,154,74,80,FMN GV 11 Ramsel
66,Bergstraat 71,2021-06-16,21:00:00,94,70,24,FMN GV 11 Ramsel
66,Bergstraat 71,2021-06-16,22:00:00,46,30,16,FMN GV 11 Ramsel
66,Bergstraat 71,2021-06-16,23:00:00,4,4,0,FMN GV 11 Ramsel
66,Bergstraat 71,2021-06-17,00:00:00,0,0,0,FMN GV 11 Ramsel
66,Bergstraat 71,2021-06-17,01:00:00,0,0,0,FMN GV 11 Ramsel
66,Bergstraat 71,2021-06-17,02:00:00,0,0,0,FMN GV 11 Ramsel
66,Bergstraat 71,2021-06-17,03:00:00,0,0,0,FMN GV 11 Ramsel
66,Bergstraat 71,2021-06-17,04:00:00,8,6,2,FMN GV 11 Ramsel
66,Bergstraat 71,2021-06-17,05:00:00,12,6,6,FMN GV 11 Ramsel
66,Bergstraat 71,2021-06-17,06:00:00,46,16,30,FMN GV 11 Ramsel
66,Bergstraat 71,2021-06-17,07:00:00,230,24,206,FMN GV 11 Ramsel
66,Bergstraat 71,2021-06-17,08:00:00,178,26,152,FMN GV 11 Ramsel
66,Bergstraat 71,2021-06-17,09:00:00,134,50,84,FMN GV 11 Ramsel
66,Bergstraat 71,2021-06-17,10:00:00,180,138,42,FMN GV 11 Ramsel
66,Bergstraat 71,2021-06-17,11:00:00,138,90,48,FMN GV 11 Ramsel
66,Bergstraat 71,2021-06-17,12:00:00,168,126,42,FMN GV 11 Ramsel
66,Bergstraat 71,2021-06-17,13:00:00,86,50,36,FMN GV 11 Ramsel
66,Bergstraat 71,2021-06-17,14:00:00,126,90,36,FMN GV 11 Ramsel
66,Bergstraat 71,2021-06-17,15:00:00,148,106,42,FMN GV 11 Ramsel
66,Bergstraat 71,2021-06-17,16:00:00,92,62,30,FMN GV 11 Ramsel
66,Bergstraat 71,2021-06-17,17:00:00,110,64,46,FMN GV 11 Ramsel
66,Bergstraat 71,2021-06-17,18:00:00,52,20,32,FMN GV 11 Ramsel
66,Bergstraat 71,2021-06-17,19:00:00,54,36,18,FMN GV 11 Ramsel
66,Bergstraat 71,2021-06-17,20:00:00,76,40,36,FMN GV 11 Ramsel
66,Bergstraat 71,2021-06-17,21:00:00,32,6,26,FMN GV 11 Ramsel
66,Bergstraat 71,2021-06-17,22:00:00,32,16,16,FMN GV 11 Ramsel
66,Bergstraat 71,2021-06-17,23:00:00,16,12,4,FMN GV 11 Ramsel
66,Bergstraat 71,2021-06-18,00:00:00,6,2,4,FMN GV 11 Ramsel
66,Bergstraat 71,2021-06-18,01:00:00,2,2,0,FMN GV 11 Ramsel
66,Bergstraat 71,2021-06-18,02:00:00,2,0,2,FMN GV 11 Ramsel
66,Bergstraat 71,2021-06-18,03:00:00,0,0,0,FMN GV 11 Ramsel
66,Bergstraat 71,2021-06-18,04:00:00,2,2,0,FMN GV 11 Ramsel
66,Bergstraat 71,2021-06-18,05:00:00,8,4,4,FMN GV 11 Ramsel
66,Bergstraat 71,2021-06-18,06:00:00,30,8,22,FMN GV 11 Ramsel
66,Bergstraat 71,2021-06-18,07:00:00,156,10,146,FMN GV 11 Ramsel
66,Bergstraat 71,2021-06-18,08:00:00,124,14,110,FMN GV 11 Ramsel
66,Bergstraat 71,2021-06-18,09:00:00,82,30,52,FMN GV 11 Ramsel
66,Bergstraat 71,2021-06-18,10:00:00,142,88,54,FMN GV 11 Ramsel
66,Bergstraat 71,2021-06-18,11:00:00,148,118,30,FMN GV 11 Ramsel
66,Bergstraat 71,2021-06-18,12:00:00,108,70,38,FMN GV 11 Ramsel
66,Bergstraat 71,2021-06-18,13:00:00,112,56,56,FMN GV 11 Ramsel
66,Bergstraat 71,2021-06-18,14:00:00,128,64,64,FMN GV 11 Ramsel
66,Bergstraat 71,2021-06-18,15:00:00,120,70,50,FMN GV 11 Ramsel
66,Bergstraat 71,2021-06-18,16:00:00,140,104,36,FMN GV 11 Ramsel
66,Bergstraat 71,2021-06-18,17:00:00,68,40,28,FMN GV 11 Ramsel
66,Bergstraat 71,2021-06-18,18:00:00,60,22,38,FMN GV 11 Ramsel
66,Bergstraat 71,2021-06-18,19:00:00,48,22,26,FMN GV 11 Ramsel
66,Bergstraat 71,2021-06-18,20:00:00,82,44,38,FMN GV 11 Ramsel
66,Bergstraat 71,2021-06-18,21:00:00,64,34,30,FMN GV 11 Ramsel
66,Bergstraat 71,2021-06-18,22:00:00,14,4,10,FMN GV 11 Ramsel
66,Bergstraat 71,2021-06-18,23:00:00,8,4,4,FMN GV 11 Ramsel
66,Bergstraat 71,2021-06-19,00:00:00,18,12,6,FMN GV 11 Ramsel
66,Bergstraat 71,2021-06-19,01:00:00,2,2,0,FMN GV 11 Ramsel
66,Bergstraat 71,2021-06-19,02:00:00,12,10,2,FMN GV 11 Ramsel
66,Bergstraat 71,2021-06-19,03:00:00,0,0,0,FMN GV 11 Ramsel
66,Bergstraat 71,2021-06-19,04:00:00,0,0,0,FMN GV 11 Ramsel
66,Bergstraat 71,2021-06-19,05:00:00,4,4,0,FMN GV 11 Ramsel
66,Bergstraat 71,2021-06-19,06:00:00,12,4,8,FMN GV 11 Ramsel
66,Bergstraat 71,2021-06-19,07:00:00,14,2,12,FMN GV 11 Ramsel
66,Bergstraat 71,2021-06-19,08:00:00,54,16,38,FMN GV 11 Ramsel
66,Bergstraat 71,2021-06-19,09:00:00,114,46,68,FMN GV 11 Ramsel
66,Bergstraat 71,2021-06-19,10:00:00,142,64,78,FMN GV 11 Ramsel
66,Bergstraat 71,2021-06-19,11:00:00,170,88,82,FMN GV 11 Ramsel
66,Bergstraat 71,2021-06-19,12:00:00,164,82,82,FMN GV 11 Ramsel
66,Bergstraat 71,2021-06-19,13:00:00,224,102,122,FMN GV 11 Ramsel
66,Bergstraat 71,2021-06-19,14:00:00,286,120,166,FMN GV 11 Ramsel
66,Bergstraat 71,2021-06-19,15:00:00,224,138,86,FMN GV 11 Ramsel
66,Bergstraat 71,2021-06-19,16:00:00,200,114,86,FMN GV 11 Ramsel
66,Bergstraat 71,2021-06-19,17:00:00,140,78,62,FMN GV 11 Ramsel
66,Bergstraat 71,2021-06-19,18:00:00,56,38,18,FMN GV 11 Ramsel
66,Bergstraat 71,2021-06-19,19:00:00,34,20,14,FMN GV 11 Ramsel
66,Bergstraat 71,2021-06-19,20:00:00,50,20,30,FMN GV 11 Ramsel
66,Bergstraat 71,2021-06-19,21:00:00,24,10,14,FMN GV 11 Ramsel
66,Bergstraat 71,2021-06-19,22:00:00,26,16,10,FMN GV 11 Ramsel
66,Bergstraat 71,2021-06-19,23:00:00,2,0,2,FMN GV 11 Ramsel
66,Bergstraat 71,2021-06-20,00:00:00,12,12,0,FMN GV 11 Ramsel
66,Bergstraat 71,2021-06-20,01:00:00,4,4,0,FMN GV 11 Ramsel
66,Bergstraat 71,2021-06-20,02:00:00,0,0,0,FMN GV 11 Ramsel
66,Bergstraat 71,2021-06-20,03:00:00,0,0,0,FMN GV 11 Ramsel
66,Bergstraat 71,2021-06-20,04:00:00,0,0,0,FMN GV 11 Ramsel
66,Bergstraat 71,2021-06-20,05:00:00,2,2,0,FMN GV 11 Ramsel
66,Bergstraat 71,2021-06-20,06:00:00,16,6,10,FMN GV 11 Ramsel
66,Bergstraat 71,2021-06-20,07:00:00,38,10,28,FMN GV 11 Ramsel
66,Bergstraat 71,2021-06-20,08:00:00,126,28,98,FMN GV 11 Ramsel
66,Bergstraat 71,2021-06-20,09:00:00,254,118,136,FMN GV 11 Ramsel
66,Bergstraat 71,2021-06-20,10:00:00,188,92,96,FMN GV 11 Ramsel
66,Bergstraat 71,2021-06-20,11:00:00,198,118,80,FMN GV 11 Ramsel
66,Bergstraat 71,2021-06-20,12:00:00,194,132,62,FMN GV 11 Ramsel
66,Bergstraat 71,2021-06-20,13:00:00,254,106,148,FMN GV 11 Ramsel
66,Bergstraat 71,2021-06-20,14:00:00,328,192,136,FMN GV 11 Ramsel
66,Bergstraat 71,2021-06-20,15:00:00,274,146,128,FMN GV 11 Ramsel
66,Bergstraat 71,2021-06-20,16:00:00,208,110,98,FMN GV 11 Ramsel
66,Bergstraat 71,2021-06-20,17:00:00,152,88,64,FMN GV 11 Ramsel
66,Bergstraat 71,2021-06-20,18:00:00,94,48,46,FMN GV 11 Ramsel
66,Bergstraat 71,2021-06-20,19:00:00,66,14,52,FMN GV 11 Ramsel
66,Bergstraat 71,2021-06-20,20:00:00,52,28,24,FMN GV 11 Ramsel
66,Bergstraat 71,2021-06-20,21:00:00,60,32,28,FMN GV 11 Ramsel
66,Bergstraat 71,2021-06-20,22:00:00,22,10,12,FMN GV 11 Ramsel
66,Bergstraat 71,2021-06-20,23:00:00,6,4,2,FMN GV 11 Ramsel
66,Bergstraat 71,2021-06-21,00:00:00,0,0,0,FMN GV 11 Ramsel
66,Bergstraat 71,2021-06-21,01:00:00,0,0,0,FMN GV 11 Ramsel
66,Bergstraat 71,2021-06-21,02:00:00,0,0,0,FMN GV 11 Ramsel
66,Bergstraat 71,2021-06-21,03:00:00,0,0,0,FMN GV 11 Ramsel
66,Bergstraat 71,2021-06-21,04:00:00,4,4,0,FMN GV 11 Ramsel
66,Bergstraat 71,2021-06-21,05:00:00,2,0,2,FMN GV 11 Ramsel
66,Bergstraat 71,2021-06-21,06:00:00,20,4,16,FMN GV 11 Ramsel
66,Bergstraat 71,2021-06-21,07:00:00,66,4,62,FMN GV 11 Ramsel
66,Bergstraat 71,2021-06-21,08:00:00,68,12,56,FMN GV 11 Ramsel
66,Bergstraat 71,2021-06-21,09:00:00,22,2,20,FMN GV 11 Ramsel
66,Bergstraat 71,2021-06-21,10:00:00,28,16,12,FMN GV 11 Ramsel
66,Bergstraat 71,2021-06-21,11:00:00,62,52,10,FMN GV 11 Ramsel
66,Bergstraat 71,2021-06-21,12:00:00,52,30,22,FMN GV 11 Ramsel
66,Bergstraat 71,2021-06-21,13:00:00,64,32,32,FMN GV 11 Ramsel
66,Bergstraat 71,2021-06-21,14:00:00,64,34,30,FMN GV 11 Ramsel
66,Bergstraat 71,2021-06-21,15:00:00,64,48,16,FMN GV 11 Ramsel
66,Bergstraat 71,2021-06-21,16:00:00,72,34,38,FMN GV 11 Ramsel
66,Bergstraat 71,2021-06-21,17:00:00,46,34,12,FMN GV 11 Ramsel
66,Bergstraat 71,2021-06-21,18:00:00,32,24,8,FMN GV 11 Ramsel
66,Bergstraat 71,2021-06-21,19:00:00,46,18,28,FMN GV 11 Ramsel
66,Bergstraat 71,2021-06-21,20:00:00,26,12,14,FMN GV 11 Ramsel
66,Bergstraat 71,2021-06-21,21:00:00,10,8,2,FMN GV 11 Ramsel
66,Bergstraat 71,2021-06-21,22:00:00,4,4,0,FMN GV 11 Ramsel
66,Bergstraat 71,2021-06-21,23:00:00,8,4,4,FMN GV 11 Ramsel
66,Bergstraat 71,2021-06-22,00:00:00,8,8,0,FMN GV 11 Ramsel
66,Bergstraat 71,2021-06-22,01:00:00,0,0,0,FMN GV 11 Ramsel
66,Bergstraat 71,2021-06-22,02:00:00,0,0,0,FMN GV 11 Ramsel
66,Bergstraat 71,2021-06-22,03:00:00,0,0,0,FMN GV 11 Ramsel
66,Bergstraat 71,2021-06-22,04:00:00,4,4,0,FMN GV 11 Ramsel
66,Bergstraat 71,2021-06-22,05:00:00,8,4,4,FMN GV 11 Ramsel
66,Bergstraat 71,2021-06-22,06:00:00,26,6,20,FMN GV 11 Ramsel
66,Bergstraat 71,2021-06-22,07:00:00,180,16,164,FMN GV 11 Ramsel
66,Bergstraat 71,2021-06-22,08:00:00,108,12,96,FMN GV 11 Ramsel
66,Bergstraat 71,2021-06-22,09:00:00,38,14,24,FMN GV 11 Ramsel
66,Bergstraat 71,2021-06-22,10:00:00,114,90,24,FMN GV 11 Ramsel
66,Bergstraat 71,2021-06-22,11:00:00,82,54,28,FMN GV 11 Ramsel
66,Bergstraat 71,2021-06-22,12:00:00,70,48,22,FMN GV 11 Ramsel
66,Bergstraat 71,2021-06-22,13:00:00,68,46,22,FMN GV 11 Ramsel
66,Bergstraat 71,2021-06-22,14:00:00,50,18,32,FMN GV 11 Ramsel
66,Bergstraat 71,2021-06-22,15:00:00,88,60,28,FMN GV 11 Ramsel
66,Bergstraat 71,2021-06-22,16:00:00,74,44,30,FMN GV 11 Ramsel
66,Bergstraat 71,2021-06-22,17:00:00,74,34,40,FMN GV 11 Ramsel
66,Bergstraat 71,2021-06-22,18:00:00,50,24,26,FMN GV 11 Ramsel
66,Bergstraat 71,2021-06-22,19:00:00,20,8,12,FMN GV 11 Ramsel
66,Bergstraat 71,2021-06-22,20:00:00,24,18,6,FMN GV 11 Ramsel
66,Bergstraat 71,2021-06-22,21:00:00,18,12,6,FMN GV 11 Ramsel
66,Bergstraat 71,2021-06-22,22:00:00,4,2,2,FMN GV 11 Ramsel
66,Bergstraat 71,2021-06-22,23:00:00,0,0,0,FMN GV 11 Ramsel
66,Bergstraat 71,2021-06-23,00:00:00,0,0,0,FMN GV 11 Ramsel
66,Bergstraat 71,2021-06-23,01:00:00,0,0,0,FMN GV 11 Ramsel
66,Bergstraat 71,2021-06-23,02:00:00,0,0,0,FMN GV 11 Ramsel
66,Bergstraat 71,2021-06-23,03:00:00,0,0,0,FMN GV 11 Ramsel
66,Bergstraat 71,2021-06-23,04:00:00,4,4,0,FMN GV 11 Ramsel
66,Bergstraat 71,2021-06-23,05:00:00,14,6,8,FMN GV 11 Ramsel
66,Bergstraat 71,2021-06-23,06:00:00,24,8,16,FMN GV 11 Ramsel
66,Bergstraat 71,2021-06-23,07:00:00,158,18,140,FMN GV 11 Ramsel
66,Bergstraat 71,2021-06-23,08:00:00,140,16,124,FMN GV 11 Ramsel
66,Bergstraat 71,2021-06-23,09:00:00,72,26,46,FMN GV 11 Ramsel
66,Bergstraat 71,2021-06-23,10:00:00,112,70,42,FMN GV 11 Ramsel
66,Bergstraat 71,2021-06-23,11:00:00,112,62,50,FMN GV 11 Ramsel
66,Bergstraat 71,2021-06-23,12:00:00,120,76,44,FMN GV 11 Ramsel
66,Bergstraat 71,2021-06-23,13:00:00,208,130,78,FMN GV 11 Ramsel
66,Bergstraat 71,2021-06-23,14:00:00,184,74,110,FMN GV 11 Ramsel
66,Bergstraat 71,2021-06-23,15:00:00,150,78,72,FMN GV 11 Ramsel
66,Bergstraat 71,2021-06-23,16:00:00,142,96,46,FMN GV 11 Ramsel
66,Bergstraat 71,2021-06-23,17:00:00,132,64,68,FMN GV 11 Ramsel
66,Bergstraat 71,2021-06-23,18:00:00,84,52,32,FMN GV 11 Ramsel
66,Bergstraat 71,2021-06-23,19:00:00,66,34,32,FMN GV 11 Ramsel
66,Bergstraat 71,2021-06-23,20:00:00,90,36,54,FMN GV 11 Ramsel
66,Bergstraat 71,2021-06-23,21:00:00,36,18,18,FMN GV 11 Ramsel
66,Bergstraat 71,2021-06-23,22:00:00,18,12,6,FMN GV 11 Ramsel
66,Bergstraat 71,2021-06-23,23:00:00,14,0,14,FMN GV 11 Ramsel
66,Bergstraat 71,2021-06-24,00:00:00,28,24,4,FMN GV 11 Ramsel
66,Bergstraat 71,2021-06-24,01:00:00,6,6,0,FMN GV 11 Ramsel
66,Bergstraat 71,2021-06-24,02:00:00,12,12,0,FMN GV 11 Ramsel
66,Bergstraat 71,2021-06-24,03:00:00,0,0,0,FMN GV 11 Ramsel
66,Bergstraat 71,2021-06-24,04:00:00,6,6,0,FMN GV 11 Ramsel
66,Bergstraat 71,2021-06-24,05:00:00,8,4,4,FMN GV 11 Ramsel
66,Bergstraat 71,2021-06-24,06:00:00,36,12,24,FMN GV 11 Ramsel
66,Bergstraat 71,2021-06-24,07:00:00,62,22,40,FMN GV 11 Ramsel
66,Bergstraat 71,2021-06-24,08:00:00,72,26,46,FMN GV 11 Ramsel
66,Bergstraat 71,2021-06-24,09:00:00,140,98,42,FMN GV 11 Ramsel
66,Bergstraat 71,2021-06-24,10:00:00,88,22,66,FMN GV 11 Ramsel
66,Bergstraat 71,2021-06-24,11:00:00,116,68,48,FMN GV 11 Ramsel
66,Bergstraat 71,2021-06-24,12:00:00,112,48,64,FMN GV 11 Ramsel
66,Bergstraat 71,2021-06-24,13:00:00,164,76,88,FMN GV 11 Ramsel
66,Bergstraat 71,2021-06-24,14:00:00,162,80,82,FMN GV 11 Ramsel
66,Bergstraat 71,2021-06-24,15:00:00,192,102,90,FMN GV 11 Ramsel
66,Bergstraat 71,2021-06-24,16:00:00,220,112,108,FMN GV 11 Ramsel
66,Bergstraat 71,2021-06-24,17:00:00,104,56,48,FMN GV 11 Ramsel
66,Bergstraat 71,2021-06-24,18:00:00,126,56,70,FMN GV 11 Ramsel
66,Bergstraat 71,2021-06-24,19:00:00,110,52,58,FMN GV 11 Ramsel
66,Bergstraat 71,2021-06-24,20:00:00,92,48,44,FMN GV 11 Ramsel
66,Bergstraat 71,2021-06-24,21:00:00,14,4,10,FMN GV 11 Ramsel
66,Bergstraat 71,2021-06-24,22:00:00,28,14,14,FMN GV 11 Ramsel
66,Bergstraat 71,2021-06-24,23:00:00,18,16,2,FMN GV 11 Ramsel
66,Bergstraat 71,2021-06-25,00:00:00,12,12,0,FMN GV 11 Ramsel
66,Bergstraat 71,2021-06-25,01:00:00,0,0,0,FMN GV 11 Ramsel
66,Bergstraat 71,2021-06-25,02:00:00,4,4,0,FMN GV 11 Ramsel
66,Bergstraat 71,2021-06-25,03:00:00,0,0,0,FMN GV 11 Ramsel
66,Bergstraat 71,2021-06-25,04:00:00,8,8,0,FMN GV 11 Ramsel
66,Bergstraat 71,2021-06-25,05:00:00,8,4,4,FMN GV 11 Ramsel
66,Bergstraat 71,2021-06-25,06:00:00,30,6,24,FMN GV 11 Ramsel
66,Bergstraat 71,2021-06-25,07:00:00,42,12,30,FMN GV 11 Ramsel
66,Bergstraat 71,2021-06-25,08:00:00,92,24,68,FMN GV 11 Ramsel
66,Bergstraat 71,2021-06-25,09:00:00,110,42,68,FMN GV 11 Ramsel
66,Bergstraat 71,2021-06-25,10:00:00,98,42,56,FMN GV 11 Ramsel
66,Bergstraat 71,2021-06-25,11:00:00,98,28,70,FMN GV 11 Ramsel
66,Bergstraat 71,2021-06-25,12:00:00,134,72,62,FMN GV 11 Ramsel
66,Bergstraat 71,2021-06-25,13:00:00,158,68,90,FMN GV 11 Ramsel
66,Bergstraat 71,2021-06-25,14:00:00,164,108,56,FMN GV 11 Ramsel
66,Bergstraat 71,2021-06-25,15:00:00,158,82,76,FMN GV 11 Ramsel
66,Bergstraat 71,2021-06-25,16:00:00,154,88,66,FMN GV 11 Ramsel
66,Bergstraat 71,2021-06-25,17:00:00,98,70,28,FMN GV 11 Ramsel
66,Bergstraat 71,2021-06-25,18:00:00,38,26,12,FMN GV 11 Ramsel
66,Bergstraat 71,2021-06-25,19:00:00,30,28,2,FMN GV 11 Ramsel
66,Bergstraat 71,2021-06-25,20:00:00,32,26,6,FMN GV 11 Ramsel
66,Bergstraat 71,2021-06-25,21:00:00,34,16,18,FMN GV 11 Ramsel
66,Bergstraat 71,2021-06-25,22:00:00,18,14,4,FMN GV 11 Ramsel
66,Bergstraat 71,2021-06-25,23:00:00,12,6,6,FMN GV 11 Ramsel
66,Bergstraat 71,2021-06-26,00:00:00,18,16,2,FMN GV 11 Ramsel
66,Bergstraat 71,2021-06-26,01:00:00,0,0,0,FMN GV 11 Ramsel
66,Bergstraat 71,2021-06-26,02:00:00,0,0,0,FMN GV 11 Ramsel
66,Bergstraat 71,2021-06-26,03:00:00,0,0,0,FMN GV 11 Ramsel
66,Bergstraat 71,2021-06-26,04:00:00,0,0,0,FMN GV 11 Ramsel
66,Bergstraat 71,2021-06-26,05:00:00,6,4,2,FMN GV 11 Ramsel
66,Bergstraat 71,2021-06-26,06:00:00,12,4,8,FMN GV 11 Ramsel
66,Bergstraat 71,2021-06-26,07:00:00,12,0,12,FMN GV 11 Ramsel
66,Bergstraat 71,2021-06-26,08:00:00,54,14,40,FMN GV 11 Ramsel
66,Bergstraat 71,2021-06-26,09:00:00,86,38,48,FMN GV 11 Ramsel
66,Bergstraat 71,2021-06-26,10:00:00,124,64,60,FMN GV 11 Ramsel
66,Bergstraat 71,2021-06-26,11:00:00,122,72,50,FMN GV 11 Ramsel
66,Bergstraat 71,2021-06-26,12:00:00,112,42,70,FMN GV 11 Ramsel
66,Bergstraat 71,2021-06-26,13:00:00,144,80,64,FMN GV 11 Ramsel
66,Bergstraat 71,2021-06-26,14:00:00,218,100,118,FMN GV 11 Ramsel
66,Bergstraat 71,2021-06-26,15:00:00,204,112,92,FMN GV 11 Ramsel
66,Bergstraat 71,2021-06-26,16:00:00,170,106,64,FMN GV 11 Ramsel
66,Bergstraat 71,2021-06-26,17:00:00,60,42,18,FMN GV 11 Ramsel
66,Bergstraat 71,2021-06-26,18:00:00,54,32,22,FMN GV 11 Ramsel
66,Bergstraat 71,2021-06-26,19:00:00,42,20,22,FMN GV 11 Ramsel
66,Bergstraat 71,2021-06-26,20:00:00,52,32,20,FMN GV 11 Ramsel
66,Bergstraat 71,2021-06-26,21:00:00,22,12,10,FMN GV 11 Ramsel
66,Bergstraat 71,2021-06-26,22:00:00,8,4,4,FMN GV 11 Ramsel
66,Bergstraat 71,2021-06-26,23:00:00,28,18,10,FMN GV 11 Ramsel
66,Bergstraat 71,2021-06-27,00:00:00,14,14,0,FMN GV 11 Ramsel
66,Bergstraat 71,2021-06-27,01:00:00,2,2,0,FMN GV 11 Ramsel
66,Bergstraat 71,2021-06-27,02:00:00,20,14,6,FMN GV 11 Ramsel
66,Bergstraat 71,2021-06-27,03:00:00,0,0,0,FMN GV 11 Ramsel
66,Bergstraat 71,2021-06-27,04:00:00,0,0,0,FMN GV 11 Ramsel
66,Bergstraat 71,2021-06-27,05:00:00,6,2,4,FMN GV 11 Ramsel
66,Bergstraat 71,2021-06-27,06:00:00,16,4,12,FMN GV 11 Ramsel
66,Bergstraat 71,2021-06-27,07:00:00,32,14,18,FMN GV 11 Ramsel
66,Bergstraat 71,2021-06-27,08:00:00,126,44,82,FMN GV 11 Ramsel
66,Bergstraat 71,2021-06-27,09:00:00,242,126,116,FMN GV 11 Ramsel
66,Bergstraat 71,2021-06-27,10:00:00,362,160,202,FMN GV 11 Ramsel
66,Bergstraat 71,2021-06-27,11:00:00,250,144,106,FMN GV 11 Ramsel
66,Bergstraat 71,2021-06-27,12:00:00,288,188,100,FMN GV 11 Ramsel
66,Bergstraat 71,2021-06-27,13:00:00,290,148,142,FMN GV 11 Ramsel
66,Bergstraat 71,2021-06-27,14:00:00,332,176,156,FMN GV 11 Ramsel
66,Bergstraat 71,2021-06-27,15:00:00,246,110,136,FMN GV 11 Ramsel
66,Bergstraat 71,2021-06-27,16:00:00,102,40,62,FMN GV 11 Ramsel
66,Bergstraat 71,2021-06-27,17:00:00,58,36,22,FMN GV 11 Ramsel
66,Bergstraat 71,2021-06-27,18:00:00,44,20,24,FMN GV 11 Ramsel
66,Bergstraat 71,2021-06-27,19:00:00,46,34,12,FMN GV 11 Ramsel
66,Bergstraat 71,2021-06-27,20:00:00,20,12,8,FMN GV 11 Ramsel
66,Bergstraat 71,2021-06-27,21:00:00,12,6,6,FMN GV 11 Ramsel
66,Bergstraat 71,2021-06-27,22:00:00,6,0,6,FMN GV 11 Ramsel
66,Bergstraat 71,2021-06-27,23:00:00,22,4,18,FMN GV 11 Ramsel
66,Bergstraat 71,2021-06-28,00:00:00,16,8,8,FMN GV 11 Ramsel
66,Bergstraat 71,2021-06-28,01:00:00,8,0,8,FMN GV 11 Ramsel
66,Bergstraat 71,2021-06-28,02:00:00,4,4,0,FMN GV 11 Ramsel
66,Bergstraat 71,2021-06-28,03:00:00,12,12,0,FMN GV 11 Ramsel
66,Bergstraat 71,2021-06-28,04:00:00,4,4,0,FMN GV 11 Ramsel
66,Bergstraat 71,2021-06-28,05:00:00,24,16,8,FMN GV 11 Ramsel
66,Bergstraat 71,2021-06-28,06:00:00,34,10,24,FMN GV 11 Ramsel
66,Bergstraat 71,2021-06-28,07:00:00,38,12,26,FMN GV 11 Ramsel
66,Bergstraat 71,2021-06-28,08:00:00,56,12,44,FMN GV 11 Ramsel
66,Bergstraat 71,2021-06-28,09:00:00,70,34,36,FMN GV 11 Ramsel
66,Bergstraat 71,2021-06-28,10:00:00,50,20,30,FMN GV 11 Ramsel
66,Bergstraat 71,2021-06-28,11:00:00,30,16,14,FMN GV 11 Ramsel
66,Bergstraat 71,2021-06-28,12:00:00,28,16,12,FMN GV 11 Ramsel
66,Bergstraat 71,2021-06-28,13:00:00,84,38,46,FMN GV 11 Ramsel
66,Bergstraat 71,2021-06-28,14:00:00,108,52,56,FMN GV 11 Ramsel
66,Bergstraat 71,2021-06-28,15:00:00,94,60,34,FMN GV 11 Ramsel
66,Bergstraat 71,2021-06-28,16:00:00,112,66,46,FMN GV 11 Ramsel
66,Bergstraat 71,2021-06-28,17:00:00,72,46,26,FMN GV 11 Ramsel
66,Bergstraat 71,2021-06-28,18:00:00,76,32,44,FMN GV 11 Ramsel
66,Bergstraat 71,2021-06-28,19:00:00,48,20,28,FMN GV 11 Ramsel
66,Bergstraat 71,2021-06-28,20:00:00,68,40,28,FMN GV 11 Ramsel
66,Bergstraat 71,2021-06-28,21:00:00,18,10,8,FMN GV 11 Ramsel
66,Bergstraat 71,2021-06-28,22:00:00,16,14,2,FMN GV 11 Ramsel
66,Bergstraat 71,2021-06-28,23:00:00,4,2,2,FMN GV 11 Ramsel
66,Bergstraat 71,2021-06-29,00:00:00,2,0,2,FMN GV 11 Ramsel
66,Bergstraat 71,2021-06-29,01:00:00,4,4,0,FMN GV 11 Ramsel
66,Bergstraat 71,2021-06-29,02:00:00,8,8,0,FMN GV 11 Ramsel
66,Bergstraat 71,2021-06-29,03:00:00,0,0,0,FMN GV 11 Ramsel
66,Bergstraat 71,2021-06-29,04:00:00,4,2,2,FMN GV 11 Ramsel
66,Bergstraat 71,2021-06-29,05:00:00,8,4,4,FMN GV 11 Ramsel
66,Bergstraat 71,2021-06-29,06:00:00,32,8,24,FMN GV 11 Ramsel
66,Bergstraat 71,2021-06-29,07:00:00,92,14,78,FMN GV 11 Ramsel
66,Bergstraat 71,2021-06-29,08:00:00,114,20,94,FMN GV 11 Ramsel
66,Bergstraat 71,2021-06-29,09:00:00,122,68,54,FMN GV 11 Ramsel
66,Bergstraat 71,2021-06-29,10:00:00,204,110,94,FMN GV 11 Ramsel
66,Bergstraat 71,2021-06-29,11:00:00,106,48,58,FMN GV 11 Ramsel
66,Bergstraat 71,2021-06-29,12:00:00,138,76,62,FMN GV 11 Ramsel
66,Bergstraat 71,2021-06-29,13:00:00,212,72,140,FMN GV 11 Ramsel
66,Bergstraat 71,2021-06-29,14:00:00,162,94,68,FMN GV 11 Ramsel
66,Bergstraat 71,2021-06-29,15:00:00,176,102,74,FMN GV 11 Ramsel
66,Bergstraat 71,2021-06-29,16:00:00,186,110,76,FMN GV 11 Ramsel
66,Bergstraat 71,2021-06-29,17:00:00,96,52,44,FMN GV 11 Ramsel
66,Bergstraat 71,2021-06-29,18:00:00,44,22,22,FMN GV 11 Ramsel
66,Bergstraat 71,2021-06-29,19:00:00,42,18,24,FMN GV 11 Ramsel
66,Bergstraat 71,2021-06-29,20:00:00,68,56,12,FMN GV 11 Ramsel
66,Bergstraat 71,2021-06-29,21:00:00,22,16,6,FMN GV 11 Ramsel
66,Bergstraat 71,2021-06-29,22:00:00,14,6,8,FMN GV 11 Ramsel
66,Bergstraat 71,2021-06-29,23:00:00,12,8,4,FMN GV 11 Ramsel
66,Bergstraat 71,2021-06-30,00:00:00,4,2,2,FMN GV 11 Ramsel
66,Bergstraat 71,2021-06-30,01:00:00,2,2,0,FMN GV 11 Ramsel
66,Bergstraat 71,2021-06-30,02:00:00,0,0,0,FMN GV 11 Ramsel
66,Bergstraat 71,2021-06-30,03:00:00,0,0,0,FMN GV 11 Ramsel
66,Bergstraat 71,2021-06-30,04:00:00,2,2,0,FMN GV 11 Ramsel
66,Bergstraat 71,2021-06-30,05:00:00,4,0,4,FMN GV 11 Ramsel
66,Bergstraat 71,2021-06-30,06:00:00,14,4,10,FMN GV 11 Ramsel
66,Bergstraat 71,2021-06-30,07:00:00,22,4,18,FMN GV 11 Ramsel
66,Bergstraat 71,2021-06-30,08:00:00,30,6,24,FMN GV 11 Ramsel
66,Bergstraat 71,2021-06-30,09:00:00,22,4,18,FMN GV 11 Ramsel
66,Bergstraat 71,2021-06-30,10:00:00,26,14,12,FMN GV 11 Ramsel
66,Bergstraat 71,2021-06-30,11:00:00,50,32,18,FMN GV 11 Ramsel
66,Bergstraat 71,2021-06-30,12:00:00,30,18,12,FMN GV 11 Ramsel
66,Bergstraat 71,2021-06-30,13:00:00,42,22,20,FMN GV 11 Ramsel
66,Bergstraat 71,2021-06-30,14:00:00,58,24,34,FMN GV 11 Ramsel
66,Bergstraat 71,2021-06-30,15:00:00,34,22,12,FMN GV 11 Ramsel
66,Bergstraat 71,2021-06-30,16:00:00,38,16,22,FMN GV 11 Ramsel
66,Bergstraat 71,2021-06-30,17:00:00,58,38,20,FMN GV 11 Ramsel
66,Bergstraat 71,2021-06-30,18:00:00,44,20,24,FMN GV 11 Ramsel
66,Bergstraat 71,2021-06-30,19:00:00,18,10,8,FMN GV 11 Ramsel
66,Bergstraat 71,2021-06-30,20:00:00,8,8,0,FMN GV 11 Ramsel
66,Bergstraat 71,2021-06-30,21:00:00,6,4,2,FMN GV 11 Ramsel
66,Bergstraat 71,2021-06-30,22:00:00,8,4,4,FMN GV 11 Ramsel
66,Bergstraat 71,2021-06-30,23:00:00,0,0,0,FMN GV 11 Ramsel
66,Bergstraat 71,2021-07-01,00:00:00,0,0,0,FMN GV 11 Ramsel
66,Bergstraat 71,2021-07-01,01:00:00,2,2,0,FMN GV 11 Ramsel
66,Bergstraat 71,2021-07-01,02:00:00,2,2,0,FMN GV 11 Ramsel
66,Bergstraat 71,2021-07-01,03:00:00,0,0,0,FMN GV 11 Ramsel
66,Bergstraat 71,2021-07-01,04:00:00,4,4,0,FMN GV 11 Ramsel
66,Bergstraat 71,2021-07-01,05:00:00,8,2,6,FMN GV 11 Ramsel
66,Bergstraat 71,2021-07-01,06:00:00,34,10,24,FMN GV 11 Ramsel
66,Bergstraat 71,2021-07-01,07:00:00,34,10,24,FMN GV 11 Ramsel
66,Bergstraat 71,2021-07-01,08:00:00,50,8,42,FMN GV 11 Ramsel
66,Bergstraat 71,2021-07-01,09:00:00,24,8,16,FMN GV 11 Ramsel
66,Bergstraat 71,2021-07-01,10:00:00,64,28,36,FMN GV 11 Ramsel
66,Bergstraat 71,2021-07-01,11:00:00,60,42,18,FMN GV 11 Ramsel
66,Bergstraat 71,2021-07-01,12:00:00,112,70,42,FMN GV 11 Ramsel
66,Bergstraat 71,2021-07-01,13:00:00,136,74,62,FMN GV 11 Ramsel
66,Bergstraat 71,2021-07-01,14:00:00,188,132,56,FMN GV 11 Ramsel
66,Bergstraat 71,2021-07-01,15:00:00,122,64,58,FMN GV 11 Ramsel
66,Bergstraat 71,2021-07-01,16:00:00,132,50,82,FMN GV 11 Ramsel
66,Bergstraat 71,2021-07-01,17:00:00,84,60,24,FMN GV 11 Ramsel
66,Bergstraat 71,2021-07-01,18:00:00,82,34,48,FMN GV 11 Ramsel
66,Bergstraat 71,2021-07-01,19:00:00,68,32,36,FMN GV 11 Ramsel
66,Bergstraat 71,2021-07-01,20:00:00,48,30,18,FMN GV 11 Ramsel
66,Bergstraat 71,2021-07-01,21:00:00,38,20,18,FMN GV 11 Ramsel
66,Bergstraat 71,2021-07-01,22:00:00,16,8,8,FMN GV 11 Ramsel
66,Bergstraat 71,2021-07-01,23:00:00,4,2,2,FMN GV 11 Ramsel
66,Bergstraat 71,2021-07-02,00:00:00,4,2,2,FMN GV 11 Ramsel
66,Bergstraat 71,2021-07-02,01:00:00,4,4,0,FMN GV 11 Ramsel
66,Bergstraat 71,2021-07-02,02:00:00,0,0,0,FMN GV 11 Ramsel
66,Bergstraat 71,2021-07-02,03:00:00,0,0,0,FMN GV 11 Ramsel
66,Bergstraat 71,2021-07-02,04:00:00,4,4,0,FMN GV 11 Ramsel
66,Bergstraat 71,2021-07-02,05:00:00,2,0,2,FMN GV 11 Ramsel
66,Bergstraat 71,2021-07-02,06:00:00,16,6,10,FMN GV 11 Ramsel
66,Bergstraat 71,2021-07-02,07:00:00,50,14,36,FMN GV 11 Ramsel
66,Bergstraat 71,2021-07-02,08:00:00,50,18,32,FMN GV 11 Ramsel
66,Bergstraat 71,2021-07-02,09:00:00,84,38,46,FMN GV 11 Ramsel
66,Bergstraat 71,2021-07-02,10:00:00,100,40,60,FMN GV 11 Ramsel
66,Bergstraat 71,2021-07-02,11:00:00,150,58,92,FMN GV 11 Ramsel
66,Bergstraat 71,2021-07-02,12:00:00,134,60,74,FMN GV 11 Ramsel
66,Bergstraat 71,2021-07-02,13:00:00,216,84,132,FMN GV 11 Ramsel
66,Bergstraat 71,2021-07-02,14:00:00,186,98,88,FMN GV 11 Ramsel
66,Bergstraat 71,2021-07-02,15:00:00,256,112,144,FMN GV 11 Ramsel
66,Bergstraat 71,2021-07-02,16:00:00,136,76,60,FMN GV 11 Ramsel
66,Bergstraat 71,2021-07-02,17:00:00,126,68,58,FMN GV 11 Ramsel
66,Bergstraat 71,2021-07-02,18:00:00,110,76,34,FMN GV 11 Ramsel
66,Bergstraat 71,2021-07-02,19:00:00,106,40,66,FMN GV 11 Ramsel
66,Bergstraat 71,2021-07-02,20:00:00,76,30,46,FMN GV 11 Ramsel
66,Bergstraat 71,2021-07-02,21:00:00,24,14,10,FMN GV 11 Ramsel
66,Bergstraat 71,2021-07-02,22:00:00,14,8,6,FMN GV 11 Ramsel
66,Bergstraat 71,2021-07-02,23:00:00,20,10,10,FMN GV 11 Ramsel
66,Bergstraat 71,2021-07-03,00:00:00,16,12,4,FMN GV 11 Ramsel
66,Bergstraat 71,2021-07-03,01:00:00,28,26,2,FMN GV 11 Ramsel
66,Bergstraat 71,2021-07-03,02:00:00,6,2,4,FMN GV 11 Ramsel
66,Bergstraat 71,2021-07-03,03:00:00,4,4,0,FMN GV 11 Ramsel
66,Bergstraat 71,2021-07-03,04:00:00,2,0,2,FMN GV 11 Ramsel
66,Bergstraat 71,2021-07-03,05:00:00,0,0,0,FMN GV 11 Ramsel
66,Bergstraat 71,2021-07-03,06:00:00,22,6,16,FMN GV 11 Ramsel
66,Bergstraat 71,2021-07-03,07:00:00,30,14,16,FMN GV 11 Ramsel
66,Bergstraat 71,2021-07-03,08:00:00,44,16,28,FMN GV 11 Ramsel
66,Bergstraat 71,2021-07-03,09:00:00,68,16,52,FMN GV 11 Ramsel
66,Bergstraat 71,2021-07-03,10:00:00,100,46,54,FMN GV 11 Ramsel
66,Bergstraat 71,2021-07-03,11:00:00,162,60,102,FMN GV 11 Ramsel
66,Bergstraat 71,2021-07-03,12:00:00,148,84,64,FMN GV 11 Ramsel
66,Bergstraat 71,2021-07-03,13:00:00,146,78,68,FMN GV 11 Ramsel
66,Bergstraat 71,2021-07-03,14:00:00,184,88,96,FMN GV 11 Ramsel
66,Bergstraat 71,2021-07-03,15:00:00,170,106,64,FMN GV 11 Ramsel
66,Bergstraat 71,2021-07-03,16:00:00,154,58,96,FMN GV 11 Ramsel
66,Bergstraat 71,2021-07-03,17:00:00,44,32,12,FMN GV 11 Ramsel
66,Bergstraat 71,2021-07-03,18:00:00,26,12,14,FMN GV 11 Ramsel
66,Bergstraat 71,2021-07-03,19:00:00,26,10,16,FMN GV 11 Ramsel
66,Bergstraat 71,2021-07-03,20:00:00,28,8,20,FMN GV 11 Ramsel
66,Bergstraat 71,2021-07-03,21:00:00,20,20,0,FMN GV 11 Ramsel
66,Bergstraat 71,2021-07-03,22:00:00,14,6,8,FMN GV 11 Ramsel
66,Bergstraat 71,2021-07-03,23:00:00,4,4,0,FMN GV 11 Ramsel
66,Bergstraat 71,2021-07-04,00:00:00,6,6,0,FMN GV 11 Ramsel
66,Bergstraat 71,2021-07-04,01:00:00,8,8,0,FMN GV 11 Ramsel
66,Bergstraat 71,2021-07-04,02:00:00,2,2,0,FMN GV 11 Ramsel
66,Bergstraat 71,2021-07-04,03:00:00,2,0,2,FMN GV 11 Ramsel
66,Bergstraat 71,2021-07-04,04:00:00,0,0,0,FMN GV 11 Ramsel
66,Bergstraat 71,2021-07-04,05:00:00,2,0,2,FMN GV 11 Ramsel
66,Bergstraat 71,2021-07-04,06:00:00,10,4,6,FMN GV 11 Ramsel
66,Bergstraat 71,2021-07-04,07:00:00,20,12,8,FMN GV 11 Ramsel
66,Bergstraat 71,2021-07-04,08:00:00,66,18,48,FMN GV 11 Ramsel
66,Bergstraat 71,2021-07-04,09:00:00,150,46,104,FMN GV 11 Ramsel
66,Bergstraat 71,2021-07-04,10:00:00,262,142,120,FMN GV 11 Ramsel
66,Bergstraat 71,2021-07-04,11:00:00,248,162,86,FMN GV 11 Ramsel
66,Bergstraat 71,2021-07-04,12:00:00,200,108,92,FMN GV 11 Ramsel
66,Bergstraat 71,2021-07-04,13:00:00,80,50,30,FMN GV 11 Ramsel
66,Bergstraat 71,2021-07-04,14:00:00,16,12,4,FMN GV 11 Ramsel
66,Bergstraat 71,2021-07-04,15:00:00,26,12,14,FMN GV 11 Ramsel
66,Bergstraat 71,2021-07-04,16:00:00,26,6,20,FMN GV 11 Ramsel
66,Bergstraat 71,2021-07-04,17:00:00,50,20,30,FMN GV 11 Ramsel
66,Bergstraat 71,2021-07-04,18:00:00,58,26,32,FMN GV 11 Ramsel
66,Bergstraat 71,2021-07-04,19:00:00,66,42,24,FMN GV 11 Ramsel
66,Bergstraat 71,2021-07-04,20:00:00,60,14,46,FMN GV 11 Ramsel
66,Bergstraat 71,2021-07-04,21:00:00,42,34,8,FMN GV 11 Ramsel
66,Bergstraat 71,2021-07-04,22:00:00,8,4,4,FMN GV 11 Ramsel
66,Bergstraat 71,2021-07-04,23:00:00,2,2,0,FMN GV 11 Ramsel
66,Bergstraat 71,2021-07-05,00:00:00,6,6,0,FMN GV 11 Ramsel
66,Bergstraat 71,2021-07-05,01:00:00,4,2,2,FMN GV 11 Ramsel
66,Bergstraat 71,2021-07-05,02:00:00,0,0,0,FMN GV 11 Ramsel
66,Bergstraat 71,2021-07-05,03:00:00,0,0,0,FMN GV 11 Ramsel
66,Bergstraat 71,2021-07-05,04:00:00,4,4,0,FMN GV 11 Ramsel
66,Bergstraat 71,2021-07-05,05:00:00,8,6,2,FMN GV 11 Ramsel
66,Bergstraat 71,2021-07-05,06:00:00,38,16,22,FMN GV 11 Ramsel
66,Bergstraat 71,2021-07-05,07:00:00,22,10,12,FMN GV 11 Ramsel
66,Bergstraat 71,2021-07-05,08:00:00,20,4,16,FMN GV 11 Ramsel
66,Bergstraat 71,2021-07-05,09:00:00,8,6,2,FMN GV 11 Ramsel
66,Bergstraat 71,2021-07-05,10:00:00,14,8,6,FMN GV 11 Ramsel
66,Bergstraat 71,2021-07-05,11:00:00,54,38,16,FMN GV 11 Ramsel
66,Bergstraat 71,2021-07-05,12:00:00,62,24,38,FMN GV 11 Ramsel
66,Bergstraat 71,2021-07-05,13:00:00,112,34,78,FMN GV 11 Ramsel
66,Bergstraat 71,2021-07-05,14:00:00,142,50,92,FMN GV 11 Ramsel
66,Bergstraat 71,2021-07-05,15:00:00,98,38,60,FMN GV 11 Ramsel
66,Bergstraat 71,2021-07-05,16:00:00,152,84,68,FMN GV 11 Ramsel
66,Bergstraat 71,2021-07-05,17:00:00,90,52,38,FMN GV 11 Ramsel
66,Bergstraat 71,2021-07-05,18:00:00,60,30,30,FMN GV 11 Ramsel
66,Bergstraat 71,2021-07-05,19:00:00,50,14,36,FMN GV 11 Ramsel
66,Bergstraat 71,2021-07-05,20:00:00,36,16,20,FMN GV 11 Ramsel
66,Bergstraat 71,2021-07-05,21:00:00,34,14,20,FMN GV 11 Ramsel
66,Bergstraat 71,2021-07-05,22:00:00,14,8,6,FMN GV 11 Ramsel
66,Bergstraat 71,2021-07-05,23:00:00,2,2,0,FMN GV 11 Ramsel
66,Bergstraat 71,2021-07-06,00:00:00,4,2,2,FMN GV 11 Ramsel
66,Bergstraat 71,2021-07-06,01:00:00,0,0,0,FMN GV 11 Ramsel
66,Bergstraat 71,2021-07-06,02:00:00,2,2,0,FMN GV 11 Ramsel
66,Bergstraat 71,2021-07-06,03:00:00,2,0,2,FMN GV 11 Ramsel
66,Bergstraat 71,2021-07-06,04:00:00,6,6,0,FMN GV 11 Ramsel
66,Bergstraat 71,2021-07-06,05:00:00,8,4,4,FMN GV 11 Ramsel
66,Bergstraat 71,2021-07-06,06:00:00,40,12,28,FMN GV 11 Ramsel
66,Bergstraat 71,2021-07-06,07:00:00,40,20,20,FMN GV 11 Ramsel
66,Bergstraat 71,2021-07-06,08:00:00,26,4,22,FMN GV 11 Ramsel
66,Bergstraat 71,2021-07-06,09:00:00,34,16,18,FMN GV 11 Ramsel
66,Bergstraat 71,2021-07-06,10:00:00,32,14,18,FMN GV 11 Ramsel
66,Bergstraat 71,2021-07-06,11:00:00,46,26,20,FMN GV 11 Ramsel
66,Bergstraat 71,2021-07-06,12:00:00,38,20,18,FMN GV 11 Ramsel
66,Bergstraat 71,2021-07-06,13:00:00,94,50,44,FMN GV 11 Ramsel
66,Bergstraat 71,2021-07-06,14:00:00,80,36,44,FMN GV 11 Ramsel
66,Bergstraat 71,2021-07-06,15:00:00,78,42,36,FMN GV 11 Ramsel
66,Bergstraat 71,2021-07-06,16:00:00,94,40,54,FMN GV 11 Ramsel
66,Bergstraat 71,2021-07-06,17:00:00,94,56,38,FMN GV 11 Ramsel
66,Bergstraat 71,2021-07-06,18:00:00,16,8,8,FMN GV 11 Ramsel
66,Bergstraat 71,2021-07-06,19:00:00,46,22,24,FMN GV 11 Ramsel
66,Bergstraat 71,2021-07-06,20:00:00,52,32,20,FMN GV 11 Ramsel
66,Bergstraat 71,2021-07-06,21:00:00,30,24,6,FMN GV 11 Ramsel
66,Bergstraat 71,2021-07-06,22:00:00,10,8,2,FMN GV 11 Ramsel
66,Bergstraat 71,2021-07-06,23:00:00,4,4,0,FMN GV 11 Ramsel
66,Bergstraat 71,2021-07-07,00:00:00,6,4,2,FMN GV 11 Ramsel
66,Bergstraat 71,2021-07-07,01:00:00,10,10,0,FMN GV 11 Ramsel
66,Bergstraat 71,2021-07-07,02:00:00,0,0,0,FMN GV 11 Ramsel
66,Bergstraat 71,2021-07-07,03:00:00,2,0,2,FMN GV 11 Ramsel
66,Bergstraat 71,2021-07-07,04:00:00,2,2,0,FMN GV 11 Ramsel
66,Bergstraat 71,2021-07-07,05:00:00,12,8,4,FMN GV 11 Ramsel
66,Bergstraat 71,2021-07-07,06:00:00,38,10,28,FMN GV 11 Ramsel
66,Bergstraat 71,2021-07-07,07:00:00,28,12,16,FMN GV 11 Ramsel
66,Bergstraat 71,2021-07-07,08:00:00,52,18,34,FMN GV 11 Ramsel
66,Bergstraat 71,2021-07-07,09:00:00,84,38,46,FMN GV 11 Ramsel
66,Bergstraat 71,2021-07-07,10:00:00,112,42,70,FMN GV 11 Ramsel
66,Bergstraat 71,2021-07-07,11:00:00,114,54,60,FMN GV 11 Ramsel
66,Bergstraat 71,2021-07-07,12:00:00,128,56,72,FMN GV 11 Ramsel
66,Bergstraat 71,2021-07-07,13:00:00,226,82,144,FMN GV 11 Ramsel
66,Bergstraat 71,2021-07-07,14:00:00,240,122,118,FMN GV 11 Ramsel
66,Bergstraat 71,2021-07-07,15:00:00,152,88,64,FMN GV 11 Ramsel
66,Bergstraat 71,2021-07-07,16:00:00,140,68,72,FMN GV 11 Ramsel
66,Bergstraat 71,2021-07-07,17:00:00,104,44,60,FMN GV 11 Ramsel
66,Bergstraat 71,2021-07-07,18:00:00,140,76,64,FMN GV 11 Ramsel
66,Bergstraat 71,2021-07-07,19:00:00,124,34,90,FMN GV 11 Ramsel
66,Bergstraat 71,2021-07-07,20:00:00,106,52,54,FMN GV 11 Ramsel
66,Bergstraat 71,2021-07-07,21:00:00,84,70,14,FMN GV 11 Ramsel
66,Bergstraat 71,2021-07-07,22:00:00,36,6,30,FMN GV 11 Ramsel
66,Bergstraat 71,2021-07-07,23:00:00,16,6,10,FMN GV 11 Ramsel
66,Bergstraat 71,2021-07-08,00:00:00,6,4,2,FMN GV 11 Ramsel
66,Bergstraat 71,2021-07-08,01:00:00,10,10,0,FMN GV 11 Ramsel
66,Bergstraat 71,2021-07-08,02:00:00,0,0,0,FMN GV 11 Ramsel
66,Bergstraat 71,2021-07-08,03:00:00,6,6,0,FMN GV 11 Ramsel
66,Bergstraat 71,2021-07-08,04:00:00,4,2,2,FMN GV 11 Ramsel
66,Bergstraat 71,2021-07-08,05:00:00,18,6,12,FMN GV 11 Ramsel
66,Bergstraat 71,2021-07-08,06:00:00,34,14,20,FMN GV 11 Ramsel
66,Bergstraat 71,2021-07-08,07:00:00,54,16,38,FMN GV 11 Ramsel
66,Bergstraat 71,2021-07-08,08:00:00,52,18,34,FMN GV 11 Ramsel
66,Bergstraat 71,2021-07-08,09:00:00,76,16,60,FMN GV 11 Ramsel
66,Bergstraat 71,2021-07-08,10:00:00,100,56,44,FMN GV 11 Ramsel
66,Bergstraat 71,2021-07-08,11:00:00,132,70,62,FMN GV 11 Ramsel
66,Bergstraat 71,2021-07-08,12:00:00,98,44,54,FMN GV 11 Ramsel
66,Bergstraat 71,2021-07-08,13:00:00,144,70,74,FMN GV 11 Ramsel
66,Bergstraat 71,2021-07-08,14:00:00,252,170,82,FMN GV 11 Ramsel
66,Bergstraat 71,2021-07-08,15:00:00,172,78,94,FMN GV 11 Ramsel
66,Bergstraat 71,2021-07-08,16:00:00,144,82,62,FMN GV 11 Ramsel
66,Bergstraat 71,2021-07-08,17:00:00,110,66,44,FMN GV 11 Ramsel
66,Bergstraat 71,2021-07-08,18:00:00,76,44,32,FMN GV 11 Ramsel
66,Bergstraat 71,2021-07-08,19:00:00,78,44,34,FMN GV 11 Ramsel
66,Bergstraat 71,2021-07-08,20:00:00,50,26,24,FMN GV 11 Ramsel
66,Bergstraat 71,2021-07-08,21:00:00,42,24,18,FMN GV 11 Ramsel
66,Bergstraat 71,2021-07-08,22:00:00,32,20,12,FMN GV 11 Ramsel
66,Bergstraat 71,2021-07-08,23:00:00,8,6,2,FMN GV 11 Ramsel
66,Bergstraat 71,2021-07-09,00:00:00,0,0,0,FMN GV 11 Ramsel
66,Bergstraat 71,2021-07-09,01:00:00,8,2,6,FMN GV 11 Ramsel
66,Bergstraat 71,2021-07-09,02:00:00,6,0,6,FMN GV 11 Ramsel
66,Bergstraat 71,2021-07-09,03:00:00,0,0,0,FMN GV 11 Ramsel
66,Bergstraat 71,2021-07-09,04:00:00,4,4,0,FMN GV 11 Ramsel
66,Bergstraat 71,2021-07-09,05:00:00,6,2,4,FMN GV 11 Ramsel
66,Bergstraat 71,2021-07-09,06:00:00,22,6,16,FMN GV 11 Ramsel
66,Bergstraat 71,2021-07-09,07:00:00,32,12,20,FMN GV 11 Ramsel
66,Bergstraat 71,2021-07-09,08:00:00,68,26,42,FMN GV 11 Ramsel
66,Bergstraat 71,2021-07-09,09:00:00,66,30,36,FMN GV 11 Ramsel
66,Bergstraat 71,2021-07-09,10:00:00,138,78,60,FMN GV 11 Ramsel
66,Bergstraat 71,2021-07-09,11:00:00,112,64,48,FMN GV 11 Ramsel
66,Bergstraat 71,2021-07-09,12:00:00,162,48,114,FMN GV 11 Ramsel
66,Bergstraat 71,2021-07-09,13:00:00,262,118,144,FMN GV 11 Ramsel
66,Bergstraat 71,2021-07-09,14:00:00,222,124,98,FMN GV 11 Ramsel
66,Bergstraat 71,2021-07-09,15:00:00,258,118,140,FMN GV 11 Ramsel
66,Bergstraat 71,2021-07-09,16:00:00,154,86,68,FMN GV 11 Ramsel
66,Bergstraat 71,2021-07-09,17:00:00,106,60,46,FMN GV 11 Ramsel
66,Bergstraat 71,2021-07-09,18:00:00,108,48,60,FMN GV 11 Ramsel
66,Bergstraat 71,2021-07-09,19:00:00,120,40,80,FMN GV 11 Ramsel
66,Bergstraat 71,2021-07-09,20:00:00,58,26,32,FMN GV 11 Ramsel
66,Bergstraat 71,2021-07-09,21:00:00,76,34,42,FMN GV 11 Ramsel
66,Bergstraat 71,2021-07-09,22:00:00,14,10,4,FMN GV 11 Ramsel
66,Bergstraat 71,2021-07-09,23:00:00,16,12,4,FMN GV 11 Ramsel
66,Bergstraat 71,2021-07-10,00:00:00,16,10,6,FMN GV 11 Ramsel
66,Bergstraat 71,2021-07-10,01:00:00,4,4,0,FMN GV 11 Ramsel
66,Bergstraat 71,2021-07-10,02:00:00,2,2,0,FMN GV 11 Ramsel
66,Bergstraat 71,2021-07-10,03:00:00,0,0,0,FMN GV 11 Ramsel
66,Bergstraat 71,2021-07-10,04:00:00,0,0,0,FMN GV 11 Ramsel
66,Bergstraat 71,2021-07-10,05:00:00,2,2,0,FMN GV 11 Ramsel
66,Bergstraat 71,2021-07-10,06:00:00,14,4,10,FMN GV 11 Ramsel
66,Bergstraat 71,2021-07-10,07:00:00,22,8,14,FMN GV 11 Ramsel
66,Bergstraat 71,2021-07-10,08:00:00,30,18,12,FMN GV 11 Ramsel
66,Bergstraat 71,2021-07-10,09:00:00,80,24,56,FMN GV 11 Ramsel
66,Bergstraat 71,2021-07-10,10:00:00,68,36,32,FMN GV 11 Ramsel
66,Bergstraat 71,2021-07-10,11:00:00,124,68,56,FMN GV 11 Ramsel
66,Bergstraat 71,2021-07-10,12:00:00,140,78,62,FMN GV 11 Ramsel
66,Bergstraat 71,2021-07-10,13:00:00,192,92,100,FMN GV 11 Ramsel
66,Bergstraat 71,2021-07-10,14:00:00,162,56,106,FMN GV 11 Ramsel
66,Bergstraat 71,2021-07-10,15:00:00,150,86,64,FMN GV 11 Ramsel
66,Bergstraat 71,2021-07-10,16:00:00,100,48,52,FMN GV 11 Ramsel
66,Bergstraat 71,2021-07-10,17:00:00,54,42,12,FMN GV 11 Ramsel
66,Bergstraat 71,2021-07-10,18:00:00,18,12,6,FMN GV 11 Ramsel
66,Bergstraat 71,2021-07-10,19:00:00,14,6,8,FMN GV 11 Ramsel
66,Bergstraat 71,2021-07-10,20:00:00,16,10,6,FMN GV 11 Ramsel
66,Bergstraat 71,2021-07-10,21:00:00,8,4,4,FMN GV 11 Ramsel
66,Bergstraat 71,2021-07-10,22:00:00,6,2,4,FMN GV 11 Ramsel
66,Bergstraat 71,2021-07-10,23:00:00,8,6,2,FMN GV 11 Ramsel
66,Bergstraat 71,2021-07-11,00:00:00,4,0,4,FMN GV 11 Ramsel
66,Bergstraat 71,2021-07-11,01:00:00,8,8,0,FMN GV 11 Ramsel
66,Bergstraat 71,2021-07-11,02:00:00,0,0,0,FMN GV 11 Ramsel
66,Bergstraat 71,2021-07-11,03:00:00,4,4,0,FMN GV 11 Ramsel
66,Bergstraat 71,2021-07-11,04:00:00,0,0,0,FMN GV 11 Ramsel
66,Bergstraat 71,2021-07-11,05:00:00,6,2,4,FMN GV 11 Ramsel
66,Bergstraat 71,2021-07-11,06:00:00,8,4,4,FMN GV 11 Ramsel
66,Bergstraat 71,2021-07-11,07:00:00,26,12,14,FMN GV 11 Ramsel
66,Bergstraat 71,2021-07-11,08:00:00,104,28,76,FMN GV 11 Ramsel
66,Bergstraat 71,2021-07-11,09:00:00,202,74,128,FMN GV 11 Ramsel
66,Bergstraat 71,2021-07-11,10:00:00,302,158,144,FMN GV 11 Ramsel
66,Bergstraat 71,2021-07-11,11:00:00,322,172,150,FMN GV 11 Ramsel
66,Bergstraat 71,2021-07-11,12:00:00,284,108,176,FMN GV 11 Ramsel
66,Bergstraat 71,2021-07-11,13:00:00,370,144,226,FMN GV 11 Ramsel
66,Bergstraat 71,2021-07-11,14:00:00,374,168,206,FMN GV 11 Ramsel
66,Bergstraat 71,2021-07-11,15:00:00,294,132,162,FMN GV 11 Ramsel
66,Bergstraat 71,2021-07-11,16:00:00,286,148,138,FMN GV 11 Ramsel
66,Bergstraat 71,2021-07-11,17:00:00,190,98,92,FMN GV 11 Ramsel
66,Bergstraat 71,2021-07-11,18:00:00,148,80,68,FMN GV 11 Ramsel
66,Bergstraat 71,2021-07-11,19:00:00,164,104,60,FMN GV 11 Ramsel
66,Bergstraat 71,2021-07-11,20:00:00,64,34,30,FMN GV 11 Ramsel
66,Bergstraat 71,2021-07-11,21:00:00,24,10,14,FMN GV 11 Ramsel
66,Bergstraat 71,2021-07-11,22:00:00,12,2,10,FMN GV 11 Ramsel
66,Bergstraat 71,2021-07-11,23:00:00,4,2,2,FMN GV 11 Ramsel
66,Bergstraat 71,2021-07-12,00:00:00,12,10,2,FMN GV 11 Ramsel
66,Bergstraat 71,2021-07-12,01:00:00,0,0,0,FMN GV 11 Ramsel
66,Bergstraat 71,2021-07-12,02:00:00,8,4,4,FMN GV 11 Ramsel
66,Bergstraat 71,2021-07-12,03:00:00,4,0,4,FMN GV 11 Ramsel
66,Bergstraat 71,2021-07-12,04:00:00,10,8,2,FMN GV 11 Ramsel
66,Bergstraat 71,2021-07-12,05:00:00,10,4,6,FMN GV 11 Ramsel
66,Bergstraat 71,2021-07-12,06:00:00,22,2,20,FMN GV 11 Ramsel
66,Bergstraat 71,2021-07-12,07:00:00,28,8,20,FMN GV 11 Ramsel
66,Bergstraat 71,2021-07-12,08:00:00,54,16,38,FMN GV 11 Ramsel
66,Bergstraat 71,2021-07-12,09:00:00,46,24,22,FMN GV 11 Ramsel
66,Bergstraat 71,2021-07-12,10:00:00,102,42,60,FMN GV 11 Ramsel
66,Bergstraat 71,2021-07-12,11:00:00,102,52,50,FMN GV 11 Ramsel
66,Bergstraat 71,2021-07-12,12:00:00,114,48,66,FMN GV 11 Ramsel
66,Bergstraat 71,2021-07-12,13:00:00,128,66,62,FMN GV 11 Ramsel
66,Bergstraat 71,2021-07-12,14:00:00,228,80,148,FMN GV 11 Ramsel
66,Bergstraat 71,2021-07-12,15:00:00,160,88,72,FMN GV 11 Ramsel
66,Bergstraat 71,2021-07-12,16:00:00,76,54,22,FMN GV 11 Ramsel
66,Bergstraat 71,2021-07-12,17:00:00,56,34,22,FMN GV 11 Ramsel
66,Bergstraat 71,2021-07-12,18:00:00,46,28,18,FMN GV 11 Ramsel
66,Bergstraat 71,2021-07-12,19:00:00,42,20,22,FMN GV 11 Ramsel
66,Bergstraat 71,2021-07-12,20:00:00,50,20,30,FMN GV 11 Ramsel
66,Bergstraat 71,2021-07-12,21:00:00,12,6,6,FMN GV 11 Ramsel
66,Bergstraat 71,2021-07-12,22:00:00,8,6,2,FMN GV 11 Ramsel
66,Bergstraat 71,2021-07-12,23:00:00,0,0,0,FMN GV 11 Ramsel
66,Bergstraat 71,2021-07-13,00:00:00,2,0,2,FMN GV 11 Ramsel
66,Bergstraat 71,2021-07-13,01:00:00,6,6,0,FMN GV 11 Ramsel
66,Bergstraat 71,2021-07-13,02:00:00,0,0,0,FMN GV 11 Ramsel
66,Bergstraat 71,2021-07-13,03:00:00,2,2,0,FMN GV 11 Ramsel
66,Bergstraat 71,2021-07-13,04:00:00,4,4,0,FMN GV 11 Ramsel
66,Bergstraat 71,2021-07-13,05:00:00,12,6,6,FMN GV 11 Ramsel
66,Bergstraat 71,2021-07-13,06:00:00,24,6,18,FMN GV 11 Ramsel
66,Bergstraat 71,2021-07-13,07:00:00,36,8,28,FMN GV 11 Ramsel
66,Bergstraat 71,2021-07-13,08:00:00,12,8,4,FMN GV 11 Ramsel
66,Bergstraat 71,2021-07-13,09:00:00,26,14,12,FMN GV 11 Ramsel
66,Bergstraat 71,2021-07-13,10:00:00,26,8,18,FMN GV 11 Ramsel
66,Bergstraat 71,2021-07-13,11:00:00,24,6,18,FMN GV 11 Ramsel
66,Bergstraat 71,2021-07-13,12:00:00,24,16,8,FMN GV 11 Ramsel
66,Bergstraat 71,2021-07-13,13:00:00,46,18,28,FMN GV 11 Ramsel
66,Bergstraat 71,2021-07-13,14:00:00,48,32,16,FMN GV 11 Ramsel
66,Bergstraat 71,2021-07-13,15:00:00,40,18,22,FMN GV 11 Ramsel
66,Bergstraat 71,2021-07-13,16:00:00,48,38,10,FMN GV 11 Ramsel
66,Bergstraat 71,2021-07-13,17:00:00,42,16,26,FMN GV 11 Ramsel
66,Bergstraat 71,2021-07-13,18:00:00,26,18,8,FMN GV 11 Ramsel
66,Bergstraat 71,2021-07-13,19:00:00,22,12,10,FMN GV 11 Ramsel
66,Bergstraat 71,2021-07-13,20:00:00,10,10,0,FMN GV 11 Ramsel
66,Bergstraat 71,2021-07-13,21:00:00,8,4,4,FMN GV 11 Ramsel
66,Bergstraat 71,2021-07-13,22:00:00,10,8,2,FMN GV 11 Ramsel
66,Bergstraat 71,2021-07-13,23:00:00,4,0,4,FMN GV 11 Ramsel
66,Bergstraat 71,2021-07-14,00:00:00,0,0,0,FMN GV 11 Ramsel
66,Bergstraat 71,2021-07-14,01:00:00,0,0,0,FMN GV 11 Ramsel
66,Bergstraat 71,2021-07-14,02:00:00,0,0,0,FMN GV 11 Ramsel
66,Bergstraat 71,2021-07-14,03:00:00,0,0,0,FMN GV 11 Ramsel
66,Bergstraat 71,2021-07-14,04:00:00,2,2,0,FMN GV 11 Ramsel
66,Bergstraat 71,2021-07-14,05:00:00,6,2,4,FMN GV 11 Ramsel
66,Bergstraat 71,2021-07-14,06:00:00,28,10,18,FMN GV 11 Ramsel
66,Bergstraat 71,2021-07-14,07:00:00,24,4,20,FMN GV 11 Ramsel
66,Bergstraat 71,2021-07-14,08:00:00,16,2,14,FMN GV 11 Ramsel
66,Bergstraat 71,2021-07-14,09:00:00,18,10,8,FMN GV 11 Ramsel
66,Bergstraat 71,2021-07-14,10:00:00,0,0,0,FMN GV 11 Ramsel
66,Bergstraat 71,2021-07-14,11:00:00,18,14,4,FMN GV 11 Ramsel
66,Bergstraat 71,2021-07-14,12:00:00,20,6,14,FMN GV 11 Ramsel
66,Bergstraat 71,2021-07-14,13:00:00,28,16,12,FMN GV 11 Ramsel
66,Bergstraat 71,2021-07-14,14:00:00,30,18,12,FMN GV 11 Ramsel
66,Bergstraat 71,2021-07-14,15:00:00,22,6,16,FMN GV 11 Ramsel
66,Bergstraat 71,2021-07-14,16:00:00,56,38,18,FMN GV 11 Ramsel
66,Bergstraat 71,2021-07-14,17:00:00,40,22,18,FMN GV 11 Ramsel
66,Bergstraat 71,2021-07-14,18:00:00,72,50,22,FMN GV 11 Ramsel
66,Bergstraat 71,2021-07-14,19:00:00,40,14,26,FMN GV 11 Ramsel
66,Bergstraat 71,2021-07-14,20:00:00,32,18,14,FMN GV 11 Ramsel
66,Bergstraat 71,2021-07-14,21:00:00,12,6,6,FMN GV 11 Ramsel
66,Bergstraat 71,2021-07-14,22:00:00,14,6,8,FMN GV 11 Ramsel
66,Bergstraat 71,2021-07-14,23:00:00,12,10,2,FMN GV 11 Ramsel
66,Bergstraat 71,2021-07-15,00:00:00,8,6,2,FMN GV 11 Ramsel
66,Bergstraat 71,2021-07-15,01:00:00,0,0,0,FMN GV 11 Ramsel
66,Bergstraat 71,2021-07-15,02:00:00,2,0,2,FMN GV 11 Ramsel
66,Bergstraat 71,2021-07-15,03:00:00,0,0,0,FMN GV 11 Ramsel
66,Bergstraat 71,2021-07-15,04:00:00,0,0,0,FMN GV 11 Ramsel
66,Bergstraat 71,2021-07-15,05:00:00,14,8,6,FMN GV 11 Ramsel
66,Bergstraat 71,2021-07-15,06:00:00,4,0,4,FMN GV 11 Ramsel
66,Bergstraat 71,2021-07-15,07:00:00,4,0,4,FMN GV 11 Ramsel
66,Bergstraat 71,2021-07-15,08:00:00,12,4,8,FMN GV 11 Ramsel
66,Bergstraat 71,2021-07-15,09:00:00,6,2,4,FMN GV 11 Ramsel
66,Bergstraat 71,2021-07-15,10:00:00,22,16,6,FMN GV 11 Ramsel
66,Bergstraat 71,2021-07-15,11:00:00,6,4,2,FMN GV 11 Ramsel
66,Bergstraat 71,2021-07-15,12:00:00,12,8,4,FMN GV 11 Ramsel
66,Bergstraat 71,2021-07-15,13:00:00,2,0,2,FMN GV 11 Ramsel
66,Bergstraat 71,2021-07-15,14:00:00,8,4,4,FMN GV 11 Ramsel
66,Bergstraat 71,2021-07-15,15:00:00,6,2,4,FMN GV 11 Ramsel
66,Bergstraat 71,2021-07-15,16:00:00,12,8,4,FMN GV 11 Ramsel
66,Bergstraat 71,2021-07-15,17:00:00,16,8,8,FMN GV 11 Ramsel
66,Bergstraat 71,2021-07-15,18:00:00,10,4,6,FMN GV 11 Ramsel
66,Bergstraat 71,2021-07-15,19:00:00,4,2,2,FMN GV 11 Ramsel
66,Bergstraat 71,2021-07-15,20:00:00,2,0,2,FMN GV 11 Ramsel
66,Bergstraat 71,2021-07-15,21:00:00,4,2,2,FMN GV 11 Ramsel
66,Bergstraat 71,2021-07-15,22:00:00,6,4,2,FMN GV 11 Ramsel
66,Bergstraat 71,2021-07-15,23:00:00,10,6,4,FMN GV 11 Ramsel
66,Bergstraat 71,2021-07-16,00:00:00,0,0,0,FMN GV 11 Ramsel
66,Bergstraat 71,2021-07-16,01:00:00,0,0,0,FMN GV 11 Ramsel
66,Bergstraat 71,2021-07-16,02:00:00,0,0,0,FMN GV 11 Ramsel
66,Bergstraat 71,2021-07-16,03:00:00,0,0,0,FMN GV 11 Ramsel
66,Bergstraat 71,2021-07-16,04:00:00,24,24,0,FMN GV 11 Ramsel
66,Bergstraat 71,2021-07-16,05:00:00,10,4,6,FMN GV 11 Ramsel
66,Bergstraat 71,2021-07-16,06:00:00,18,6,12,FMN GV 11 Ramsel
66,Bergstraat 71,2021-07-16,07:00:00,24,6,18,FMN GV 11 Ramsel
66,Bergstraat 71,2021-07-16,08:00:00,48,22,26,FMN GV 11 Ramsel
66,Bergstraat 71,2021-07-16,09:00:00,58,24,34,FMN GV 11 Ramsel
66,Bergstraat 71,2021-07-16,10:00:00,56,26,30,FMN GV 11 Ramsel
66,Bergstraat 71,2021-07-16,11:00:00,106,44,62,FMN GV 11 Ramsel
66,Bergstraat 71,2021-07-16,12:00:00,88,34,54,FMN GV 11 Ramsel
66,Bergstraat 71,2021-07-16,13:00:00,190,80,110,FMN GV 11 Ramsel
66,Bergstraat 71,2021-07-16,14:00:00,168,70,98,FMN GV 11 Ramsel
66,Bergstraat 71,2021-07-16,15:00:00,128,56,72,FMN GV 11 Ramsel
66,Bergstraat 71,2021-07-16,16:00:00,100,58,42,FMN GV 11 Ramsel
66,Bergstraat 71,2021-07-16,17:00:00,118,56,62,FMN GV 11 Ramsel
66,Bergstraat 71,2021-07-16,18:00:00,66,32,34,FMN GV 11 Ramsel
66,Bergstraat 71,2021-07-16,19:00:00,74,56,18,FMN GV 11 Ramsel
66,Bergstraat 71,2021-07-16,20:00:00,60,18,42,FMN GV 11 Ramsel
66,Bergstraat 71,2021-07-16,21:00:00,34,10,24,FMN GV 11 Ramsel
66,Bergstraat 71,2021-07-16,22:00:00,10,4,6,FMN GV 11 Ramsel
66,Bergstraat 71,2021-07-16,23:00:00,12,6,6,FMN GV 11 Ramsel
66,Bergstraat 71,2021-07-17,00:00:00,4,4,0,FMN GV 11 Ramsel
66,Bergstraat 71,2021-07-17,01:00:00,8,8,0,FMN GV 11 Ramsel
66,Bergstraat 71,2021-07-17,02:00:00,10,10,0,FMN GV 11 Ramsel
66,Bergstraat 71,2021-07-17,03:00:00,0,0,0,FMN GV 11 Ramsel
66,Bergstraat 71,2021-07-17,04:00:00,12,12,0,FMN GV 11 Ramsel
66,Bergstraat 71,2021-07-17,05:00:00,6,6,0,FMN GV 11 Ramsel
66,Bergstraat 71,2021-07-17,06:00:00,8,6,2,FMN GV 11 Ramsel
66,Bergstraat 71,2021-07-17,07:00:00,20,6,14,FMN GV 11 Ramsel
66,Bergstraat 71,2021-07-17,08:00:00,32,8,24,FMN GV 11 Ramsel
66,Bergstraat 71,2021-07-17,09:00:00,116,32,84,FMN GV 11 Ramsel
66,Bergstraat 71,2021-07-17,10:00:00,94,34,60,FMN GV 11 Ramsel
66,Bergstraat 71,2021-07-17,11:00:00,148,68,80,FMN GV 11 Ramsel
66,Bergstraat 71,2021-07-17,12:00:00,178,112,66,FMN GV 11 Ramsel
66,Bergstraat 71,2021-07-17,13:00:00,226,108,118,FMN GV 11 Ramsel
66,Bergstraat 71,2021-07-17,14:00:00,346,170,176,FMN GV 11 Ramsel
66,Bergstraat 71,2021-07-17,15:00:00,246,130,116,FMN GV 11 Ramsel
66,Bergstraat 71,2021-07-17,16:00:00,306,148,158,FMN GV 11 Ramsel
66,Bergstraat 71,2021-07-17,17:00:00,180,104,76,FMN GV 11 Ramsel
66,Bergstraat 71,2021-07-17,18:00:00,118,72,46,FMN GV 11 Ramsel
66,Bergstraat 71,2021-07-17,19:00:00,100,38,62,FMN GV 11 Ramsel
66,Bergstraat 71,2021-07-17,20:00:00,70,34,36,FMN GV 11 Ramsel
66,Bergstraat 71,2021-07-17,21:00:00,50,26,24,FMN GV 11 Ramsel
66,Bergstraat 71,2021-07-17,22:00:00,28,12,16,FMN GV 11 Ramsel
66,Bergstraat 71,2021-07-17,23:00:00,22,12,10,FMN GV 11 Ramsel
66,Bergstraat 71,2021-07-18,00:00:00,22,14,8,FMN GV 11 Ramsel
66,Bergstraat 71,2021-07-18,01:00:00,16,16,0,FMN GV 11 Ramsel
66,Bergstraat 71,2021-07-18,02:00:00,34,2,32,FMN GV 11 Ramsel
66,Bergstraat 71,2021-07-18,03:00:00,2,2,0,FMN GV 11 Ramsel
66,Bergstraat 71,2021-07-18,04:00:00,6,6,0,FMN GV 11 Ramsel
66,Bergstraat 71,2021-07-18,05:00:00,2,2,0,FMN GV 11 Ramsel
66,Bergstraat 71,2021-07-18,06:00:00,10,4,6,FMN GV 11 Ramsel
66,Bergstraat 71,2021-07-18,07:00:00,18,8,10,FMN GV 11 Ramsel
66,Bergstraat 71,2021-07-18,08:00:00,104,20,84,FMN GV 11 Ramsel
66,Bergstraat 71,2021-07-18,09:00:00,200,76,124,FMN GV 11 Ramsel
66,Bergstraat 71,2021-07-18,10:00:00,368,134,234,FMN GV 11 Ramsel
66,Bergstraat 71,2021-07-18,11:00:00,378,188,190,FMN GV 11 Ramsel
66,Bergstraat 71,2021-07-18,12:00:00,324,142,182,FMN GV 11 Ramsel
66,Bergstraat 71,2021-07-18,13:00:00,412,162,250,FMN GV 11 Ramsel
66,Bergstraat 71,2021-07-18,14:00:00,620,310,310,FMN GV 11 Ramsel
66,Bergstraat 71,2021-07-18,15:00:00,478,270,208,FMN GV 11 Ramsel
66,Bergstraat 71,2021-07-18,16:00:00,440,232,208,FMN GV 11 Ramsel
66,Bergstraat 71,2021-07-18,17:00:00,212,146,66,FMN GV 11 Ramsel
66,Bergstraat 71,2021-07-18,18:00:00,174,96,78,FMN GV 11 Ramsel
66,Bergstraat 71,2021-07-18,19:00:00,104,34,70,FMN GV 11 Ramsel
66,Bergstraat 71,2021-07-18,20:00:00,80,36,44,FMN GV 11 Ramsel
66,Bergstraat 71,2021-07-18,21:00:00,78,30,48,FMN GV 11 Ramsel
66,Bergstraat 71,2021-07-18,22:00:00,18,14,4,FMN GV 11 Ramsel
66,Bergstraat 71,2021-07-18,23:00:00,6,4,2,FMN GV 11 Ramsel
66,Bergstraat 71,2021-07-19,00:00:00,8,8,0,FMN GV 11 Ramsel
66,Bergstraat 71,2021-07-19,01:00:00,4,4,0,FMN GV 11 Ramsel
66,Bergstraat 71,2021-07-19,02:00:00,0,0,0,FMN GV 11 Ramsel
66,Bergstraat 71,2021-07-19,03:00:00,0,0,0,FMN GV 11 Ramsel
66,Bergstraat 71,2021-07-19,04:00:00,2,2,0,FMN GV 11 Ramsel
66,Bergstraat 71,2021-07-19,05:00:00,14,10,4,FMN GV 11 Ramsel
66,Bergstraat 71,2021-07-19,06:00:00,28,16,12,FMN GV 11 Ramsel
66,Bergstraat 71,2021-07-19,07:00:00,34,14,20,FMN GV 11 Ramsel
66,Bergstraat 71,2021-07-19,08:00:00,52,18,34,FMN GV 11 Ramsel
66,Bergstraat 71,2021-07-19,09:00:00,74,26,48,FMN GV 11 Ramsel
66,Bergstraat 71,2021-07-19,10:00:00,108,52,56,FMN GV 11 Ramsel
66,Bergstraat 71,2021-07-19,11:00:00,108,54,54,FMN GV 11 Ramsel
66,Bergstraat 71,2021-07-19,12:00:00,132,70,62,FMN GV 11 Ramsel
66,Bergstraat 71,2021-07-19,13:00:00,202,86,116,FMN GV 11 Ramsel
66,Bergstraat 71,2021-07-19,14:00:00,254,136,118,FMN GV 11 Ramsel
66,Bergstraat 71,2021-07-19,15:00:00,238,120,118,FMN GV 11 Ramsel
66,Bergstraat 71,2021-07-19,16:00:00,172,88,84,FMN GV 11 Ramsel
66,Bergstraat 71,2021-07-19,17:00:00,134,70,64,FMN GV 11 Ramsel
66,Bergstraat 71,2021-07-19,18:00:00,124,48,76,FMN GV 11 Ramsel
66,Bergstraat 71,2021-07-19,19:00:00,112,62,50,FMN GV 11 Ramsel
66,Bergstraat 71,2021-07-19,20:00:00,80,30,50,FMN GV 11 Ramsel
66,Bergstraat 71,2021-07-19,21:00:00,66,24,42,FMN GV 11 Ramsel
66,Bergstraat 71,2021-07-19,22:00:00,16,8,8,FMN GV 11 Ramsel
66,Bergstraat 71,2021-07-19,23:00:00,6,2,4,FMN GV 11 Ramsel
66,Bergstraat 71,2021-07-20,00:00:00,6,2,4,FMN GV 11 Ramsel
66,Bergstraat 71,2021-07-20,01:00:00,0,0,0,FMN GV 11 Ramsel
66,Bergstraat 71,2021-07-20,02:00:00,0,0,0,FMN GV 11 Ramsel
66,Bergstraat 71,2021-07-20,03:00:00,0,0,0,FMN GV 11 Ramsel
66,Bergstraat 71,2021-07-20,04:00:00,2,2,0,FMN GV 11 Ramsel
66,Bergstraat 71,2021-07-20,05:00:00,16,10,6,FMN GV 11 Ramsel
66,Bergstraat 71,2021-07-20,06:00:00,18,12,6,FMN GV 11 Ramsel
66,Bergstraat 71,2021-07-20,07:00:00,50,16,34,FMN GV 11 Ramsel
66,Bergstraat 71,2021-07-20,08:00:00,48,14,34,FMN GV 11 Ramsel
66,Bergstraat 71,2021-07-20,09:00:00,80,34,46,FMN GV 11 Ramsel
66,Bergstraat 71,2021-07-20,10:00:00,132,56,76,FMN GV 11 Ramsel
66,Bergstraat 71,2021-07-20,11:00:00,146,58,88,FMN GV 11 Ramsel
66,Bergstraat 71,2021-07-20,12:00:00,142,66,76,FMN GV 11 Ramsel
66,Bergstraat 71,2021-07-20,13:00:00,340,190,150,FMN GV 11 Ramsel
66,Bergstraat 71,2021-07-20,14:00:00,364,194,170,FMN GV 11 Ramsel
66,Bergstraat 71,2021-07-20,15:00:00,232,138,94,FMN GV 11 Ramsel
66,Bergstraat 71,2021-07-20,16:00:00,234,112,122,FMN GV 11 Ramsel
66,Bergstraat 71,2021-07-20,17:00:00,176,94,82,FMN GV 11 Ramsel
66,Bergstraat 71,2021-07-20,18:00:00,154,100,54,FMN GV 11 Ramsel
66,Bergstraat 71,2021-07-20,19:00:00,142,70,72,FMN GV 11 Ramsel
66,Bergstraat 71,2021-07-20,20:00:00,82,50,32,FMN GV 11 Ramsel
66,Bergstraat 71,2021-07-20,21:00:00,68,30,38,FMN GV 11 Ramsel
66,Bergstraat 71,2021-07-20,22:00:00,58,22,36,FMN GV 11 Ramsel
66,Bergstraat 71,2021-07-20,23:00:00,14,12,2,FMN GV 11 Ramsel
66,Bergstraat 71,2021-07-21,00:00:00,4,2,2,FMN GV 11 Ramsel
66,Bergstraat 71,2021-07-21,01:00:00,8,4,4,FMN GV 11 Ramsel
66,Bergstraat 71,2021-07-21,02:00:00,0,0,0,FMN GV 11 Ramsel
66,Bergstraat 71,2021-07-21,03:00:00,0,0,0,FMN GV 11 Ramsel
66,Bergstraat 71,2021-07-21,04:00:00,2,2,0,FMN GV 11 Ramsel
66,Bergstraat 71,2021-07-21,05:00:00,4,4,0,FMN GV 11 Ramsel
66,Bergstraat 71,2021-07-21,06:00:00,12,4,8,FMN GV 11 Ramsel
66,Bergstraat 71,2021-07-21,07:00:00,16,8,8,FMN GV 11 Ramsel
66,Bergstraat 71,2021-07-21,08:00:00,40,10,30,FMN GV 11 Ramsel
66,Bergstraat 71,2021-07-21,09:00:00,166,78,88,FMN GV 11 Ramsel
66,Bergstraat 71,2021-07-21,10:00:00,240,84,156,FMN GV 11 Ramsel
66,Bergstraat 71,2021-07-21,11:00:00,322,164,158,FMN GV 11 Ramsel
66,Bergstraat 71,2021-07-21,12:00:00,282,132,150,FMN GV 11 Ramsel
66,Bergstraat 71,2021-07-21,13:00:00,454,208,246,FMN GV 11 Ramsel
66,Bergstraat 71,2021-07-21,14:00:00,546,274,272,FMN GV 11 Ramsel
66,Bergstraat 71,2021-07-21,15:00:00,416,206,210,FMN GV 11 Ramsel
66,Bergstraat 71,2021-07-21,16:00:00,366,158,208,FMN GV 11 Ramsel
66,Bergstraat 71,2021-07-21,17:00:00,258,100,158,FMN GV 11 Ramsel
66,Bergstraat 71,2021-07-21,18:00:00,234,92,142,FMN GV 11 Ramsel
66,Bergstraat 71,2021-07-21,19:00:00,134,70,64,FMN GV 11 Ramsel
66,Bergstraat 71,2021-07-21,20:00:00,88,34,54,FMN GV 11 Ramsel
66,Bergstraat 71,2021-07-21,21:00:00,82,58,24,FMN GV 11 Ramsel
66,Bergstraat 71,2021-07-21,22:00:00,14,14,0,FMN GV 11 Ramsel
66,Bergstraat 71,2021-07-21,23:00:00,10,8,2,FMN GV 11 Ramsel
66,Bergstraat 71,2021-07-22,00:00:00,6,2,4,FMN GV 11 Ramsel
66,Bergstraat 71,2021-07-22,01:00:00,6,6,0,FMN GV 11 Ramsel
66,Bergstraat 71,2021-07-22,02:00:00,6,0,6,FMN GV 11 Ramsel
66,Bergstraat 71,2021-07-22,03:00:00,0,0,0,FMN GV 11 Ramsel
66,Bergstraat 71,2021-07-22,04:00:00,2,2,0,FMN GV 11 Ramsel
66,Bergstraat 71,2021-07-22,05:00:00,6,6,0,FMN GV 11 Ramsel
66,Bergstraat 71,2021-07-22,06:00:00,32,16,16,FMN GV 11 Ramsel
66,Bergstraat 71,2021-07-22,07:00:00,42,14,28,FMN GV 11 Ramsel
66,Bergstraat 71,2021-07-22,08:00:00,54,16,38,FMN GV 11 Ramsel
66,Bergstraat 71,2021-07-22,09:00:00,112,60,52,FMN GV 11 Ramsel
66,Bergstraat 71,2021-07-22,10:00:00,112,54,58,FMN GV 11 Ramsel
66,Bergstraat 71,2021-07-22,11:00:00,212,110,102,FMN GV 11 Ramsel
66,Bergstraat 71,2021-07-22,12:00:00,174,88,86,FMN GV 11 Ramsel
66,Bergstraat 71,2021-07-22,13:00:00,240,122,118,FMN GV 11 Ramsel
66,Bergstraat 71,2021-07-22,14:00:00,264,126,138,FMN GV 11 Ramsel
66,Bergstraat 71,2021-07-22,15:00:00,248,128,120,FMN GV 11 Ramsel
66,Bergstraat 71,2021-07-22,16:00:00,154,90,64,FMN GV 11 Ramsel
66,Bergstraat 71,2021-07-22,17:00:00,154,110,44,FMN GV 11 Ramsel
66,Bergstraat 71,2021-07-22,18:00:00,96,48,48,FMN GV 11 Ramsel
66,Bergstraat 71,2021-07-22,19:00:00,136,70,66,FMN GV 11 Ramsel
66,Bergstraat 71,2021-07-22,20:00:00,94,64,30,FMN GV 11 Ramsel
66,Bergstraat 71,2021-07-22,21:00:00,58,38,20,FMN GV 11 Ramsel
66,Bergstraat 71,2021-07-22,22:00:00,38,30,8,FMN GV 11 Ramsel
66,Bergstraat 71,2021-07-22,23:00:00,14,10,4,FMN GV 11 Ramsel
66,Bergstraat 71,2021-07-23,00:00:00,10,2,8,FMN GV 11 Ramsel
66,Bergstraat 71,2021-07-23,01:00:00,4,2,2,FMN GV 11 Ramsel
66,Bergstraat 71,2021-07-23,02:00:00,4,0,4,FMN GV 11 Ramsel
66,Bergstraat 71,2021-07-23,03:00:00,0,0,0,FMN GV 11 Ramsel
66,Bergstraat 71,2021-07-23,04:00:00,2,2,0,FMN GV 11 Ramsel
66,Bergstraat 71,2021-07-23,05:00:00,8,6,2,FMN GV 11 Ramsel
66,Bergstraat 71,2021-07-23,06:00:00,20,2,18,FMN GV 11 Ramsel
66,Bergstraat 71,2021-07-23,07:00:00,52,18,34,FMN GV 11 Ramsel
66,Bergstraat 71,2021-07-23,08:00:00,46,18,28,FMN GV 11 Ramsel
66,Bergstraat 71,2021-07-23,09:00:00,114,42,72,FMN GV 11 Ramsel
66,Bergstraat 71,2021-07-23,10:00:00,138,74,64,FMN GV 11 Ramsel
66,Bergstraat 71,2021-07-23,11:00:00,142,70,72,FMN GV 11 Ramsel
66,Bergstraat 71,2021-07-23,12:00:00,200,96,104,FMN GV 11 Ramsel
66,Bergstraat 71,2021-07-23,13:00:00,294,116,178,FMN GV 11 Ramsel
66,Bergstraat 71,2021-07-23,14:00:00,340,212,128,FMN GV 11 Ramsel
66,Bergstraat 71,2021-07-23,15:00:00,244,108,136,FMN GV 11 Ramsel
66,Bergstraat 71,2021-07-23,16:00:00,224,112,112,FMN GV 11 Ramsel
66,Bergstraat 71,2021-07-23,17:00:00,174,102,72,FMN GV 11 Ramsel
66,Bergstraat 71,2021-07-23,18:00:00,114,36,78,FMN GV 11 Ramsel
66,Bergstraat 71,2021-07-23,19:00:00,90,66,24,FMN GV 11 Ramsel
66,Bergstraat 71,2021-07-23,20:00:00,74,34,40,FMN GV 11 Ramsel
66,Bergstraat 71,2021-07-23,21:00:00,52,36,16,FMN GV 11 Ramsel
66,Bergstraat 71,2021-07-23,22:00:00,62,32,30,FMN GV 11 Ramsel
66,Bergstraat 71,2021-07-23,23:00:00,28,16,12,FMN GV 11 Ramsel
66,Bergstraat 71,2021-07-24,00:00:00,14,10,4,FMN GV 11 Ramsel
66,Bergstraat 71,2021-07-24,01:00:00,14,14,0,FMN GV 11 Ramsel
66,Bergstraat 71,2021-07-24,02:00:00,14,8,6,FMN GV 11 Ramsel
66,Bergstraat 71,2021-07-24,03:00:00,2,0,2,FMN GV 11 Ramsel
66,Bergstraat 71,2021-07-24,04:00:00,0,0,0,FMN GV 11 Ramsel
66,Bergstraat 71,2021-07-24,05:00:00,10,6,4,FMN GV 11 Ramsel
66,Bergstraat 71,2021-07-24,06:00:00,14,4,10,FMN GV 11 Ramsel
66,Bergstraat 71,2021-07-24,07:00:00,16,8,8,FMN GV 11 Ramsel
66,Bergstraat 71,2021-07-24,08:00:00,64,28,36,FMN GV 11 Ramsel
66,Bergstraat 71,2021-07-24,09:00:00,40,26,14,FMN GV 11 Ramsel
66,Bergstraat 71,2021-07-24,10:00:00,86,36,50,FMN GV 11 Ramsel
66,Bergstraat 71,2021-07-24,11:00:00,84,44,40,FMN GV 11 Ramsel
66,Bergstraat 71,2021-07-24,12:00:00,104,56,48,FMN GV 11 Ramsel
66,Bergstraat 71,2021-07-24,13:00:00,44,26,18,FMN GV 11 Ramsel
66,Bergstraat 71,2021-07-24,14:00:00,70,46,24,FMN GV 11 Ramsel
66,Bergstraat 71,2021-07-24,15:00:00,22,12,10,FMN GV 11 Ramsel
66,Bergstraat 71,2021-07-24,16:00:00,14,12,2,FMN GV 11 Ramsel
66,Bergstraat 71,2021-07-24,17:00:00,28,10,18,FMN GV 11 Ramsel
66,Bergstraat 71,2021-07-24,18:00:00,30,10,20,FMN GV 11 Ramsel
66,Bergstraat 71,2021-07-24,19:00:00,22,8,14,FMN GV 11 Ramsel
66,Bergstraat 71,2021-07-24,20:00:00,16,10,6,FMN GV 11 Ramsel
66,Bergstraat 71,2021-07-24,21:00:00,12,8,4,FMN GV 11 Ramsel
66,Bergstraat 71,2021-07-24,22:00:00,6,2,4,FMN GV 11 Ramsel
66,Bergstraat 71,2021-07-24,23:00:00,10,8,2,FMN GV 11 Ramsel
66,Bergstraat 71,2021-07-25,00:00:00,2,2,0,FMN GV 11 Ramsel
66,Bergstraat 71,2021-07-25,01:00:00,4,4,0,FMN GV 11 Ramsel
66,Bergstraat 71,2021-07-25,02:00:00,6,4,2,FMN GV 11 Ramsel
66,Bergstraat 71,2021-07-25,03:00:00,2,2,0,FMN GV 11 Ramsel
66,Bergstraat 71,2021-07-25,04:00:00,0,0,0,FMN GV 11 Ramsel
66,Bergstraat 71,2021-07-25,05:00:00,2,0,2,FMN GV 11 Ramsel
66,Bergstraat 71,2021-07-25,06:00:00,2,0,2,FMN GV 11 Ramsel
66,Bergstraat 71,2021-07-25,07:00:00,30,12,18,FMN GV 11 Ramsel
66,Bergstraat 71,2021-07-25,08:00:00,80,18,62,FMN GV 11 Ramsel
66,Bergstraat 71,2021-07-25,09:00:00,240,66,174,FMN GV 11 Ramsel
66,Bergstraat 71,2021-07-25,10:00:00,220,132,88,FMN GV 11 Ramsel
66,Bergstraat 71,2021-07-25,11:00:00,290,162,128,FMN GV 11 Ramsel
66,Bergstraat 71,2021-07-25,12:00:00,174,90,84,FMN GV 11 Ramsel
66,Bergstraat 71,2021-07-25,13:00:00,148,70,78,FMN GV 11 Ramsel
66,Bergstraat 71,2021-07-25,14:00:00,126,60,66,FMN GV 11 Ramsel
66,Bergstraat 71,2021-07-25,15:00:00,124,54,70,FMN GV 11 Ramsel
66,Bergstraat 71,2021-07-25,16:00:00,102,50,52,FMN GV 11 Ramsel
66,Bergstraat 71,2021-07-25,17:00:00,106,44,62,FMN GV 11 Ramsel
66,Bergstraat 71,2021-07-25,18:00:00,66,38,28,FMN GV 11 Ramsel
66,Bergstraat 71,2021-07-25,19:00:00,40,24,16,FMN GV 11 Ramsel
66,Bergstraat 71,2021-07-25,20:00:00,42,22,20,FMN GV 11 Ramsel
66,Bergstraat 71,2021-07-25,21:00:00,18,10,8,FMN GV 11 Ramsel
66,Bergstraat 71,2021-07-25,22:00:00,14,6,8,FMN GV 11 Ramsel
66,Bergstraat 71,2021-07-25,23:00:00,8,4,4,FMN GV 11 Ramsel
66,Bergstraat 71,2021-07-26,00:00:00,4,0,4,FMN GV 11 Ramsel
66,Bergstraat 71,2021-07-26,01:00:00,8,6,2,FMN GV 11 Ramsel
66,Bergstraat 71,2021-07-26,02:00:00,0,0,0,FMN GV 11 Ramsel
66,Bergstraat 71,2021-07-26,03:00:00,0,0,0,FMN GV 11 Ramsel
66,Bergstraat 71,2021-07-26,04:00:00,4,2,2,FMN GV 11 Ramsel
66,Bergstraat 71,2021-07-26,05:00:00,14,6,8,FMN GV 11 Ramsel
66,Bergstraat 71,2021-07-26,06:00:00,28,10,18,FMN GV 11 Ramsel
66,Bergstraat 71,2021-07-26,07:00:00,34,8,26,FMN GV 11 Ramsel
66,Bergstraat 71,2021-07-26,08:00:00,34,8,26,FMN GV 11 Ramsel
66,Bergstraat 71,2021-07-26,09:00:00,58,16,42,FMN GV 11 Ramsel
66,Bergstraat 71,2021-07-26,10:00:00,76,28,48,FMN GV 11 Ramsel
66,Bergstraat 71,2021-07-26,11:00:00,48,38,10,FMN GV 11 Ramsel
66,Bergstraat 71,2021-07-26,12:00:00,80,42,38,FMN GV 11 Ramsel
66,Bergstraat 71,2021-07-26,13:00:00,104,40,64,FMN GV 11 Ramsel
66,Bergstraat 71,2021-07-26,14:00:00,116,56,60,FMN GV 11 Ramsel
66,Bergstraat 71,2021-07-26,15:00:00,56,26,30,FMN GV 11 Ramsel
66,Bergstraat 71,2021-07-26,16:00:00,52,32,20,FMN GV 11 Ramsel
66,Bergstraat 71,2021-07-26,17:00:00,58,36,22,FMN GV 11 Ramsel
66,Bergstraat 71,2021-07-26,18:00:00,50,16,34,FMN GV 11 Ramsel
66,Bergstraat 71,2021-07-26,19:00:00,50,20,30,FMN GV 11 Ramsel
66,Bergstraat 71,2021-07-26,20:00:00,36,22,14,FMN GV 11 Ramsel
66,Bergstraat 71,2021-07-26,21:00:00,22,12,10,FMN GV 11 Ramsel
66,Bergstraat 71,2021-07-26,22:00:00,6,6,0,FMN GV 11 Ramsel
66,Bergstraat 71,2021-07-26,23:00:00,6,6,0,FMN GV 11 Ramsel
66,Bergstraat 71,2021-07-27,00:00:00,12,10,2,FMN GV 11 Ramsel
66,Bergstraat 71,2021-07-27,01:00:00,2,2,0,FMN GV 11 Ramsel
66,Bergstraat 71,2021-07-27,02:00:00,4,2,2,FMN GV 11 Ramsel
66,Bergstraat 71,2021-07-27,03:00:00,0,0,0,FMN GV 11 Ramsel
66,Bergstraat 71,2021-07-27,04:00:00,2,2,0,FMN GV 11 Ramsel
66,Bergstraat 71,2021-07-27,05:00:00,12,8,4,FMN GV 11 Ramsel
66,Bergstraat 71,2021-07-27,06:00:00,16,2,14,FMN GV 11 Ramsel
66,Bergstraat 71,2021-07-27,07:00:00,44,4,40,FMN GV 11 Ramsel
66,Bergstraat 71,2021-07-27,08:00:00,44,12,32,FMN GV 11 Ramsel
66,Bergstraat 71,2021-07-27,09:00:00,60,16,44,FMN GV 11 Ramsel
66,Bergstraat 71,2021-07-27,10:00:00,126,44,82,FMN GV 11 Ramsel
66,Bergstraat 71,2021-07-27,11:00:00,86,28,58,FMN GV 11 Ramsel
66,Bergstraat 71,2021-07-27,12:00:00,102,52,50,FMN GV 11 Ramsel
66,Bergstraat 71,2021-07-27,13:00:00,140,76,64,FMN GV 11 Ramsel
66,Bergstraat 71,2021-07-27,14:00:00,128,68,60,FMN GV 11 Ramsel
66,Bergstraat 71,2021-07-27,15:00:00,64,42,22,FMN GV 11 Ramsel
66,Bergstraat 71,2021-07-27,16:00:00,92,46,46,FMN GV 11 Ramsel
66,Bergstraat 71,2021-07-27,17:00:00,90,46,44,FMN GV 11 Ramsel
66,Bergstraat 71,2021-07-27,18:00:00,70,40,30,FMN GV 11 Ramsel
66,Bergstraat 71,2021-07-27,19:00:00,96,36,60,FMN GV 11 Ramsel
66,Bergstraat 71,2021-07-27,20:00:00,70,44,26,FMN GV 11 Ramsel
66,Bergstraat 71,2021-07-27,21:00:00,36,26,10,FMN GV 11 Ramsel
66,Bergstraat 71,2021-07-27,22:00:00,20,16,4,FMN GV 11 Ramsel
66,Bergstraat 71,2021-07-27,23:00:00,12,12,0,FMN GV 11 Ramsel
66,Bergstraat 71,2021-07-28,00:00:00,12,6,6,FMN GV 11 Ramsel
66,Bergstraat 71,2021-07-28,01:00:00,2,2,0,FMN GV 11 Ramsel
66,Bergstraat 71,2021-07-28,02:00:00,2,2,0,FMN GV 11 Ramsel
66,Bergstraat 71,2021-07-28,03:00:00,0,0,0,FMN GV 11 Ramsel
66,Bergstraat 71,2021-07-28,04:00:00,0,0,0,FMN GV 11 Ramsel
66,Bergstraat 71,2021-07-28,05:00:00,14,6,8,FMN GV 11 Ramsel
66,Bergstraat 71,2021-07-28,06:00:00,26,8,18,FMN GV 11 Ramsel
66,Bergstraat 71,2021-07-28,07:00:00,34,12,22,FMN GV 11 Ramsel
66,Bergstraat 71,2021-07-28,08:00:00,42,10,32,FMN GV 11 Ramsel
66,Bergstraat 71,2021-07-28,09:00:00,32,6,26,FMN GV 11 Ramsel
66,Bergstraat 71,2021-07-28,10:00:00,86,44,42,FMN GV 11 Ramsel
66,Bergstraat 71,2021-07-28,11:00:00,104,56,48,FMN GV 11 Ramsel
66,Bergstraat 71,2021-07-28,12:00:00,92,38,54,FMN GV 11 Ramsel
66,Bergstraat 71,2021-07-28,13:00:00,154,72,82,FMN GV 11 Ramsel
66,Bergstraat 71,2021-07-28,14:00:00,160,78,82,FMN GV 11 Ramsel
66,Bergstraat 71,2021-07-28,15:00:00,66,40,26,FMN GV 11 Ramsel
66,Bergstraat 71,2021-07-28,16:00:00,92,40,52,FMN GV 11 Ramsel
66,Bergstraat 71,2021-07-28,17:00:00,88,44,44,FMN GV 11 Ramsel
66,Bergstraat 71,2021-07-28,18:00:00,70,36,34,FMN GV 11 Ramsel
66,Bergstraat 71,2021-07-28,19:00:00,112,56,56,FMN GV 11 Ramsel
66,Bergstraat 71,2021-07-28,20:00:00,66,40,26,FMN GV 11 Ramsel
66,Bergstraat 71,2021-07-28,21:00:00,36,22,14,FMN GV 11 Ramsel
66,Bergstraat 71,2021-07-28,22:00:00,14,10,4,FMN GV 11 Ramsel
66,Bergstraat 71,2021-07-28,23:00:00,22,16,6,FMN GV 11 Ramsel
66,Bergstraat 71,2021-07-29,00:00:00,4,4,0,FMN GV 11 Ramsel
66,Bergstraat 71,2021-07-29,01:00:00,2,2,0,FMN GV 11 Ramsel
66,Bergstraat 71,2021-07-29,02:00:00,0,0,0,FMN GV 11 Ramsel
66,Bergstraat 71,2021-07-29,03:00:00,0,0,0,FMN GV 11 Ramsel
66,Bergstraat 71,2021-07-29,04:00:00,4,2,2,FMN GV 11 Ramsel
66,Bergstraat 71,2021-07-29,05:00:00,14,6,8,FMN GV 11 Ramsel
66,Bergstraat 71,2021-07-29,06:00:00,22,6,16,FMN GV 11 Ramsel
66,Bergstraat 71,2021-07-29,07:00:00,34,8,26,FMN GV 11 Ramsel
66,Bergstraat 71,2021-07-29,08:00:00,38,16,22,FMN GV 11 Ramsel
66,Bergstraat 71,2021-07-29,09:00:00,98,40,58,FMN GV 11 Ramsel
66,Bergstraat 71,2021-07-29,10:00:00,146,60,86,FMN GV 11 Ramsel
66,Bergstraat 71,2021-07-29,11:00:00,158,54,104,FMN GV 11 Ramsel
66,Bergstraat 71,2021-07-29,12:00:00,124,62,62,FMN GV 11 Ramsel
66,Bergstraat 71,2021-07-29,13:00:00,112,46,66,FMN GV 11 Ramsel
66,Bergstraat 71,2021-07-29,14:00:00,218,116,102,FMN GV 11 Ramsel
66,Bergstraat 71,2021-07-29,15:00:00,210,138,72,FMN GV 11 Ramsel
66,Bergstraat 71,2021-07-29,16:00:00,186,124,62,FMN GV 11 Ramsel
66,Bergstraat 71,2021-07-29,17:00:00,166,96,70,FMN GV 11 Ramsel
66,Bergstraat 71,2021-07-29,18:00:00,102,58,44,FMN GV 11 Ramsel
66,Bergstraat 71,2021-07-29,19:00:00,102,56,46,FMN GV 11 Ramsel
66,Bergstraat 71,2021-07-29,20:00:00,106,62,44,FMN GV 11 Ramsel
66,Bergstraat 71,2021-07-29,21:00:00,54,22,32,FMN GV 11 Ramsel
66,Bergstraat 71,2021-07-29,22:00:00,12,10,2,FMN GV 11 Ramsel
66,Bergstraat 71,2021-07-29,23:00:00,2,0,2,FMN GV 11 Ramsel
66,Bergstraat 71,2021-07-30,00:00:00,2,2,0,FMN GV 11 Ramsel
66,Bergstraat 71,2021-07-30,01:00:00,8,8,0,FMN GV 11 Ramsel
66,Bergstraat 71,2021-07-30,02:00:00,0,0,0,FMN GV 11 Ramsel
66,Bergstraat 71,2021-07-30,03:00:00,0,0,0,FMN GV 11 Ramsel
66,Bergstraat 71,2021-07-30,04:00:00,4,2,2,FMN GV 11 Ramsel
66,Bergstraat 71,2021-07-30,05:00:00,12,6,6,FMN GV 11 Ramsel
66,Bergstraat 71,2021-07-30,06:00:00,22,8,14,FMN GV 11 Ramsel
66,Bergstraat 71,2021-07-30,07:00:00,32,10,22,FMN GV 11 Ramsel
66,Bergstraat 71,2021-07-30,08:00:00,16,4,12,FMN GV 11 Ramsel
66,Bergstraat 71,2021-07-30,09:00:00,86,28,58,FMN GV 11 Ramsel
66,Bergstraat 71,2021-07-30,10:00:00,120,50,70,FMN GV 11 Ramsel
66,Bergstraat 71,2021-07-30,11:00:00,92,54,38,FMN GV 11 Ramsel
66,Bergstraat 71,2021-07-30,12:00:00,122,72,50,FMN GV 11 Ramsel
66,Bergstraat 71,2021-07-30,13:00:00,132,66,66,FMN GV 11 Ramsel
66,Bergstraat 71,2021-07-30,14:00:00,188,98,90,FMN GV 11 Ramsel
66,Bergstraat 71,2021-07-30,15:00:00,132,82,50,FMN GV 11 Ramsel
66,Bergstraat 71,2021-07-30,16:00:00,100,54,46,FMN GV 11 Ramsel
66,Bergstraat 71,2021-07-30,17:00:00,62,22,40,FMN GV 11 Ramsel
66,Bergstraat 71,2021-07-30,18:00:00,68,42,26,FMN GV 11 Ramsel
66,Bergstraat 71,2021-07-30,19:00:00,68,36,32,FMN GV 11 Ramsel
66,Bergstraat 71,2021-07-30,20:00:00,40,20,20,FMN GV 11 Ramsel
66,Bergstraat 71,2021-07-30,21:00:00,24,10,14,FMN GV 11 Ramsel
66,Bergstraat 71,2021-07-30,22:00:00,8,2,6,FMN GV 11 Ramsel
66,Bergstraat 71,2021-07-30,23:00:00,6,6,0,FMN GV 11 Ramsel
66,Bergstraat 71,2021-07-31,00:00:00,6,2,4,FMN GV 11 Ramsel
66,Bergstraat 71,2021-07-31,01:00:00,16,16,0,FMN GV 11 Ramsel
66,Bergstraat 71,2021-07-31,02:00:00,10,8,2,FMN GV 11 Ramsel
66,Bergstraat 71,2021-07-31,03:00:00,4,0,4,FMN GV 11 Ramsel
66,Bergstraat 71,2021-07-31,04:00:00,2,2,0,FMN GV 11 Ramsel
66,Bergstraat 71,2021-07-31,05:00:00,4,2,2,FMN GV 11 Ramsel
66,Bergstraat 71,2021-07-31,06:00:00,10,4,6,FMN GV 11 Ramsel
66,Bergstraat 71,2021-07-31,07:00:00,16,2,14,FMN GV 11 Ramsel
66,Bergstraat 71,2021-07-31,08:00:00,32,18,14,FMN GV 11 Ramsel
66,Bergstraat 71,2021-07-31,09:00:00,92,54,38,FMN GV 11 Ramsel
66,Bergstraat 71,2021-07-31,10:00:00,176,102,74,FMN GV 11 Ramsel
66,Bergstraat 71,2021-07-31,11:00:00,76,40,36,FMN GV 11 Ramsel
66,Bergstraat 71,2021-07-31,12:00:00,98,42,56,FMN GV 11 Ramsel
66,Bergstraat 71,2021-07-31,13:00:00,106,66,40,FMN GV 11 Ramsel
66,Bergstraat 71,2021-07-31,14:00:00,148,62,86,FMN GV 11 Ramsel
66,Bergstraat 71,2021-07-31,15:00:00,152,86,66,FMN GV 11 Ramsel
66,Bergstraat 71,2021-07-31,16:00:00,178,88,90,FMN GV 11 Ramsel
66,Bergstraat 71,2021-07-31,17:00:00,70,34,36,FMN GV 11 Ramsel
66,Bergstraat 71,2021-07-31,18:00:00,42,12,30,FMN GV 11 Ramsel
66,Bergstraat 71,2021-07-31,19:00:00,40,18,22,FMN GV 11 Ramsel
66,Bergstraat 71,2021-07-31,20:00:00,16,8,8,FMN GV 11 Ramsel
66,Bergstraat 71,2021-07-31,21:00:00,26,16,10,FMN GV 11 Ramsel
66,Bergstraat 71,2021-07-31,22:00:00,10,8,2,FMN GV 11 Ramsel
66,Bergstraat 71,2021-07-31,23:00:00,0,0,0,FMN GV 11 Ramsel
66,Bergstraat 71,2021-08-01,00:00:00,16,4,12,FMN GV 11 Ramsel
66,Bergstraat 71,2021-08-01,01:00:00,14,10,4,FMN GV 11 Ramsel
66,Bergstraat 71,2021-08-01,02:00:00,2,2,0,FMN GV 11 Ramsel
66,Bergstraat 71,2021-08-01,03:00:00,0,0,0,FMN GV 11 Ramsel
66,Bergstraat 71,2021-08-01,04:00:00,14,14,0,FMN GV 11 Ramsel
66,Bergstraat 71,2021-08-01,05:00:00,4,0,4,FMN GV 11 Ramsel
66,Bergstraat 71,2021-08-01,06:00:00,8,2,6,FMN GV 11 Ramsel
66,Bergstraat 71,2021-08-01,07:00:00,18,8,10,FMN GV 11 Ramsel
66,Bergstraat 71,2021-08-01,08:00:00,92,36,56,FMN GV 11 Ramsel
66,Bergstraat 71,2021-08-01,09:00:00,92,30,62,FMN GV 11 Ramsel
66,Bergstraat 71,2021-08-01,10:00:00,106,52,54,FMN GV 11 Ramsel
66,Bergstraat 71,2021-08-01,11:00:00,144,80,64,FMN GV 11 Ramsel
66,Bergstraat 71,2021-08-01,12:00:00,80,42,38,FMN GV 11 Ramsel
66,Bergstraat 71,2021-08-01,13:00:00,58,26,32,FMN GV 11 Ramsel
66,Bergstraat 71,2021-08-01,14:00:00,36,10,26,FMN GV 11 Ramsel
66,Bergstraat 71,2021-08-01,15:00:00,32,14,18,FMN GV 11 Ramsel
66,Bergstraat 71,2021-08-01,16:00:00,36,18,18,FMN GV 11 Ramsel
66,Bergstraat 71,2021-08-01,17:00:00,16,12,4,FMN GV 11 Ramsel
66,Bergstraat 71,2021-08-01,18:00:00,10,4,6,FMN GV 11 Ramsel
66,Bergstraat 71,2021-08-01,19:00:00,26,10,16,FMN GV 11 Ramsel
66,Bergstraat 71,2021-08-01,20:00:00,20,10,10,FMN GV 11 Ramsel
66,Bergstraat 71,2021-08-01,21:00:00,20,16,4,FMN GV 11 Ramsel
66,Bergstraat 71,2021-08-01,22:00:00,2,0,2,FMN GV 11 Ramsel
66,Bergstraat 71,2021-08-01,23:00:00,4,2,2,FMN GV 11 Ramsel
66,Bergstraat 71,2021-08-02,00:00:00,0,0,0,FMN GV 11 Ramsel
66,Bergstraat 71,2021-08-02,01:00:00,0,0,0,FMN GV 11 Ramsel
66,Bergstraat 71,2021-08-02,02:00:00,0,0,0,FMN GV 11 Ramsel
66,Bergstraat 71,2021-08-02,03:00:00,0,0,0,FMN GV 11 Ramsel
66,Bergstraat 71,2021-08-02,04:00:00,2,2,0,FMN GV 11 Ramsel
66,Bergstraat 71,2021-08-02,05:00:00,8,2,6,FMN GV 11 Ramsel
66,Bergstraat 71,2021-08-02,06:00:00,32,14,18,FMN GV 11 Ramsel
66,Bergstraat 71,2021-08-02,07:00:00,30,12,18,FMN GV 11 Ramsel
66,Bergstraat 71,2021-08-02,08:00:00,50,18,32,FMN GV 11 Ramsel
66,Bergstraat 71,2021-08-02,09:00:00,30,16,14,FMN GV 11 Ramsel
66,Bergstraat 71,2021-08-02,10:00:00,68,46,22,FMN GV 11 Ramsel
66,Bergstraat 71,2021-08-02,11:00:00,48,16,32,FMN GV 11 Ramsel
66,Bergstraat 71,2021-08-02,12:00:00,62,42,20,FMN GV 11 Ramsel
66,Bergstraat 71,2021-08-02,13:00:00,128,58,70,FMN GV 11 Ramsel
66,Bergstraat 71,2021-08-02,14:00:00,196,86,110,FMN GV 11 Ramsel
66,Bergstraat 71,2021-08-02,15:00:00,178,86,92,FMN GV 11 Ramsel
66,Bergstraat 71,2021-08-02,16:00:00,180,92,88,FMN GV 11 Ramsel
66,Bergstraat 71,2021-08-02,17:00:00,130,88,42,FMN GV 11 Ramsel
66,Bergstraat 71,2021-08-02,18:00:00,78,48,30,FMN GV 11 Ramsel
66,Bergstraat 71,2021-08-02,19:00:00,102,60,42,FMN GV 11 Ramsel
66,Bergstraat 71,2021-08-02,20:00:00,80,40,40,FMN GV 11 Ramsel
66,Bergstraat 71,2021-08-02,21:00:00,32,24,8,FMN GV 11 Ramsel
66,Bergstraat 71,2021-08-02,22:00:00,20,14,6,FMN GV 11 Ramsel
66,Bergstraat 71,2021-08-02,23:00:00,6,2,4,FMN GV 11 Ramsel
66,Bergstraat 71,2021-08-03,00:00:00,2,2,0,FMN GV 11 Ramsel
66,Bergstraat 71,2021-08-03,01:00:00,0,0,0,FMN GV 11 Ramsel
66,Bergstraat 71,2021-08-03,02:00:00,0,0,0,FMN GV 11 Ramsel
66,Bergstraat 71,2021-08-03,03:00:00,0,0,0,FMN GV 11 Ramsel
66,Bergstraat 71,2021-08-03,04:00:00,4,4,0,FMN GV 11 Ramsel
66,Bergstraat 71,2021-08-03,05:00:00,8,6,2,FMN GV 11 Ramsel
66,Bergstraat 71,2021-08-03,06:00:00,14,4,10,FMN GV 11 Ramsel
66,Bergstraat 71,2021-08-03,07:00:00,12,10,2,FMN GV 11 Ramsel
66,Bergstraat 71,2021-08-03,08:00:00,26,2,24,FMN GV 11 Ramsel
66,Bergstraat 71,2021-08-03,09:00:00,30,16,14,FMN GV 11 Ramsel
66,Bergstraat 71,2021-08-03,10:00:00,44,16,28,FMN GV 11 Ramsel
66,Bergstraat 71,2021-08-03,11:00:00,68,20,48,FMN GV 11 Ramsel
66,Bergstraat 71,2021-08-03,12:00:00,108,44,64,FMN GV 11 Ramsel
66,Bergstraat 71,2021-08-03,13:00:00,190,96,94,FMN GV 11 Ramsel
66,Bergstraat 71,2021-08-03,14:00:00,216,86,130,FMN GV 11 Ramsel
66,Bergstraat 71,2021-08-03,15:00:00,282,122,160,FMN GV 11 Ramsel
66,Bergstraat 71,2021-08-03,16:00:00,166,62,104,FMN GV 11 Ramsel
66,Bergstraat 71,2021-08-03,17:00:00,146,68,78,FMN GV 11 Ramsel
66,Bergstraat 71,2021-08-03,18:00:00,90,44,46,FMN GV 11 Ramsel
66,Bergstraat 71,2021-08-03,19:00:00,44,14,30,FMN GV 11 Ramsel
66,Bergstraat 71,2021-08-03,20:00:00,100,68,32,FMN GV 11 Ramsel
66,Bergstraat 71,2021-08-03,21:00:00,42,24,18,FMN GV 11 Ramsel
66,Bergstraat 71,2021-08-03,22:00:00,26,20,6,FMN GV 11 Ramsel
66,Bergstraat 71,2021-08-03,23:00:00,18,10,8,FMN GV 11 Ramsel
66,Bergstraat 71,2021-08-04,00:00:00,4,4,0,FMN GV 11 Ramsel
66,Bergstraat 71,2021-08-04,01:00:00,0,0,0,FMN GV 11 Ramsel
66,Bergstraat 71,2021-08-04,02:00:00,2,0,2,FMN GV 11 Ramsel
66,Bergstraat 71,2021-08-04,03:00:00,0,0,0,FMN GV 11 Ramsel
66,Bergstraat 71,2021-08-04,04:00:00,6,6,0,FMN GV 11 Ramsel
66,Bergstraat 71,2021-08-04,05:00:00,10,6,4,FMN GV 11 Ramsel
66,Bergstraat 71,2021-08-04,06:00:00,32,10,22,FMN GV 11 Ramsel
66,Bergstraat 71,2021-08-04,07:00:00,26,12,14,FMN GV 11 Ramsel
66,Bergstraat 71,2021-08-04,08:00:00,60,22,38,FMN GV 11 Ramsel
66,Bergstraat 71,2021-08-04,09:00:00,82,42,40,FMN GV 11 Ramsel
66,Bergstraat 71,2021-08-04,10:00:00,108,48,60,FMN GV 11 Ramsel
66,Bergstraat 71,2021-08-04,11:00:00,204,98,106,FMN GV 11 Ramsel
66,Bergstraat 71,2021-08-04,12:00:00,118,62,56,FMN GV 11 Ramsel
66,Bergstraat 71,2021-08-04,13:00:00,216,102,114,FMN GV 11 Ramsel
66,Bergstraat 71,2021-08-04,14:00:00,180,90,90,FMN GV 11 Ramsel
66,Bergstraat 71,2021-08-04,15:00:00,162,62,100,FMN GV 11 Ramsel
66,Bergstraat 71,2021-08-04,16:00:00,122,76,46,FMN GV 11 Ramsel
66,Bergstraat 71,2021-08-04,17:00:00,150,102,48,FMN GV 11 Ramsel
66,Bergstraat 71,2021-08-04,18:00:00,102,30,72,FMN GV 11 Ramsel
66,Bergstraat 71,2021-08-04,19:00:00,78,20,58,FMN GV 11 Ramsel
66,Bergstraat 71,2021-08-04,20:00:00,56,22,34,FMN GV 11 Ramsel
66,Bergstraat 71,2021-08-04,21:00:00,40,22,18,FMN GV 11 Ramsel
66,Bergstraat 71,2021-08-04,22:00:00,40,20,20,FMN GV 11 Ramsel
66,Bergstraat 71,2021-08-04,23:00:00,12,4,8,FMN GV 11 Ramsel
66,Bergstraat 71,2021-08-05,00:00:00,0,0,0,FMN GV 11 Ramsel
66,Bergstraat 71,2021-08-05,01:00:00,4,4,0,FMN GV 11 Ramsel
66,Bergstraat 71,2021-08-05,02:00:00,8,6,2,FMN GV 11 Ramsel
66,Bergstraat 71,2021-08-05,03:00:00,0,0,0,FMN GV 11 Ramsel
66,Bergstraat 71,2021-08-05,04:00:00,6,6,0,FMN GV 11 Ramsel
66,Bergstraat 71,2021-08-05,05:00:00,18,8,10,FMN GV 11 Ramsel
66,Bergstraat 71,2021-08-05,06:00:00,30,10,20,FMN GV 11 Ramsel
66,Bergstraat 71,2021-08-05,07:00:00,32,6,26,FMN GV 11 Ramsel
66,Bergstraat 71,2021-08-05,08:00:00,50,20,30,FMN GV 11 Ramsel
66,Bergstraat 71,2021-08-05,09:00:00,114,44,70,FMN GV 11 Ramsel
66,Bergstraat 71,2021-08-05,10:00:00,136,70,66,FMN GV 11 Ramsel
66,Bergstraat 71,2021-08-05,11:00:00,158,70,88,FMN GV 11 Ramsel
66,Bergstraat 71,2021-08-05,12:00:00,144,96,48,FMN GV 11 Ramsel
66,Bergstraat 71,2021-08-05,13:00:00,198,50,148,FMN GV 11 Ramsel
66,Bergstraat 71,2021-08-05,14:00:00,192,78,114,FMN GV 11 Ramsel
66,Bergstraat 71,2021-08-05,15:00:00,238,108,130,FMN GV 11 Ramsel
66,Bergstraat 71,2021-08-05,16:00:00,170,108,62,FMN GV 11 Ramsel
66,Bergstraat 71,2021-08-05,17:00:00,152,90,62,FMN GV 11 Ramsel
66,Bergstraat 71,2021-08-05,18:00:00,176,76,100,FMN GV 11 Ramsel
66,Bergstraat 71,2021-08-05,19:00:00,92,52,40,FMN GV 11 Ramsel
66,Bergstraat 71,2021-08-05,20:00:00,62,36,26,FMN GV 11 Ramsel
66,Bergstraat 71,2021-08-05,21:00:00,40,24,16,FMN GV 11 Ramsel
66,Bergstraat 71,2021-08-05,22:00:00,20,14,6,FMN GV 11 Ramsel
66,Bergstraat 71,2021-08-05,23:00:00,8,6,2,FMN GV 11 Ramsel
66,Bergstraat 71,2021-08-06,00:00:00,4,2,2,FMN GV 11 Ramsel
66,Bergstraat 71,2021-08-06,01:00:00,6,2,4,FMN GV 11 Ramsel
66,Bergstraat 71,2021-08-06,02:00:00,6,0,6,FMN GV 11 Ramsel
66,Bergstraat 71,2021-08-06,03:00:00,0,0,0,FMN GV 11 Ramsel
66,Bergstraat 71,2021-08-06,04:00:00,6,6,0,FMN GV 11 Ramsel
66,Bergstraat 71,2021-08-06,05:00:00,6,4,2,FMN GV 11 Ramsel
66,Bergstraat 71,2021-08-06,06:00:00,12,2,10,FMN GV 11 Ramsel
66,Bergstraat 71,2021-08-06,07:00:00,34,14,20,FMN GV 11 Ramsel
66,Bergstraat 71,2021-08-06,08:00:00,30,6,24,FMN GV 11 Ramsel
66,Bergstraat 71,2021-08-06,09:00:00,74,40,34,FMN GV 11 Ramsel
66,Bergstraat 71,2021-08-06,10:00:00,58,34,24,FMN GV 11 Ramsel
66,Bergstraat 71,2021-08-06,11:00:00,62,34,28,FMN GV 11 Ramsel
66,Bergstraat 71,2021-08-06,12:00:00,52,20,32,FMN GV 11 Ramsel
66,Bergstraat 71,2021-08-06,13:00:00,100,34,66,FMN GV 11 Ramsel
66,Bergstraat 71,2021-08-06,14:00:00,62,36,26,FMN GV 11 Ramsel
66,Bergstraat 71,2021-08-06,15:00:00,90,42,48,FMN GV 11 Ramsel
66,Bergstraat 71,2021-08-06,16:00:00,70,52,18,FMN GV 11 Ramsel
66,Bergstraat 71,2021-08-06,17:00:00,72,46,26,FMN GV 11 Ramsel
66,Bergstraat 71,2021-08-06,18:00:00,42,22,20,FMN GV 11 Ramsel
66,Bergstraat 71,2021-08-06,19:00:00,40,20,20,FMN GV 11 Ramsel
66,Bergstraat 71,2021-08-06,20:00:00,56,34,22,FMN GV 11 Ramsel
66,Bergstraat 71,2021-08-06,21:00:00,28,10,18,FMN GV 11 Ramsel
66,Bergstraat 71,2021-08-06,22:00:00,16,4,12,FMN GV 11 Ramsel
66,Bergstraat 71,2021-08-06,23:00:00,8,2,6,FMN GV 11 Ramsel
66,Bergstraat 71,2021-08-07,00:00:00,6,6,0,FMN GV 11 Ramsel
66,Bergstraat 71,2021-08-07,01:00:00,16,8,8,FMN GV 11 Ramsel
66,Bergstraat 71,2021-08-07,02:00:00,2,2,0,FMN GV 11 Ramsel
66,Bergstraat 71,2021-08-07,03:00:00,10,10,0,FMN GV 11 Ramsel
66,Bergstraat 71,2021-08-07,04:00:00,2,0,2,FMN GV 11 Ramsel
66,Bergstraat 71,2021-08-07,05:00:00,2,2,0,FMN GV 11 Ramsel
66,Bergstraat 71,2021-08-07,06:00:00,12,6,6,FMN GV 11 Ramsel
66,Bergstraat 71,2021-08-07,07:00:00,14,8,6,FMN GV 11 Ramsel
66,Bergstraat 71,2021-08-07,08:00:00,30,6,24,FMN GV 11 Ramsel
66,Bergstraat 71,2021-08-07,09:00:00,110,40,70,FMN GV 11 Ramsel
66,Bergstraat 71,2021-08-07,10:00:00,144,64,80,FMN GV 11 Ramsel
66,Bergstraat 71,2021-08-07,11:00:00,108,54,54,FMN GV 11 Ramsel
66,Bergstraat 71,2021-08-07,12:00:00,142,76,66,FMN GV 11 Ramsel
66,Bergstraat 71,2021-08-07,13:00:00,152,70,82,FMN GV 11 Ramsel
66,Bergstraat 71,2021-08-07,14:00:00,148,80,68,FMN GV 11 Ramsel
66,Bergstraat 71,2021-08-07,15:00:00,162,98,64,FMN GV 11 Ramsel
66,Bergstraat 71,2021-08-07,16:00:00,106,66,40,FMN GV 11 Ramsel
66,Bergstraat 71,2021-08-07,17:00:00,28,14,14,FMN GV 11 Ramsel
66,Bergstraat 71,2021-08-07,18:00:00,16,6,10,FMN GV 11 Ramsel
66,Bergstraat 71,2021-08-07,19:00:00,12,4,8,FMN GV 11 Ramsel
66,Bergstraat 71,2021-08-07,20:00:00,16,6,10,FMN GV 11 Ramsel
66,Bergstraat 71,2021-08-07,21:00:00,2,2,0,FMN GV 11 Ramsel
66,Bergstraat 71,2021-08-07,22:00:00,10,6,4,FMN GV 11 Ramsel
66,Bergstraat 71,2021-08-07,23:00:00,4,2,2,FMN GV 11 Ramsel
66,Bergstraat 71,2021-08-08,00:00:00,4,2,2,FMN GV 11 Ramsel
66,Bergstraat 71,2021-08-08,01:00:00,4,4,0,FMN GV 11 Ramsel
66,Bergstraat 71,2021-08-08,02:00:00,2,0,2,FMN GV 11 Ramsel
66,Bergstraat 71,2021-08-08,03:00:00,0,0,0,FMN GV 11 Ramsel
66,Bergstraat 71,2021-08-08,04:00:00,2,0,2,FMN GV 11 Ramsel
66,Bergstraat 71,2021-08-08,05:00:00,2,0,2,FMN GV 11 Ramsel
66,Bergstraat 71,2021-08-08,06:00:00,12,6,6,FMN GV 11 Ramsel
66,Bergstraat 71,2021-08-08,07:00:00,28,8,20,FMN GV 11 Ramsel
66,Bergstraat 71,2021-08-08,08:00:00,74,34,40,FMN GV 11 Ramsel
66,Bergstraat 71,2021-08-08,09:00:00,194,58,136,FMN GV 11 Ramsel
66,Bergstraat 71,2021-08-08,10:00:00,226,140,86,FMN GV 11 Ramsel
66,Bergstraat 71,2021-08-08,11:00:00,230,130,100,FMN GV 11 Ramsel
66,Bergstraat 71,2021-08-08,12:00:00,116,66,50,FMN GV 11 Ramsel
66,Bergstraat 71,2021-08-08,13:00:00,110,58,52,FMN GV 11 Ramsel
66,Bergstraat 71,2021-08-08,14:00:00,186,48,138,FMN GV 11 Ramsel
66,Bergstraat 71,2021-08-08,15:00:00,116,74,42,FMN GV 11 Ramsel
66,Bergstraat 71,2021-08-08,16:00:00,70,46,24,FMN GV 11 Ramsel
66,Bergstraat 71,2021-08-08,17:00:00,74,50,24,FMN GV 11 Ramsel
66,Bergstraat 71,2021-08-08,18:00:00,32,8,24,FMN GV 11 Ramsel
66,Bergstraat 71,2021-08-08,19:00:00,24,12,12,FMN GV 11 Ramsel
66,Bergstraat 71,2021-08-08,20:00:00,38,16,22,FMN GV 11 Ramsel
66,Bergstraat 71,2021-08-08,21:00:00,12,6,6,FMN GV 11 Ramsel
66,Bergstraat 71,2021-08-08,22:00:00,10,10,0,FMN GV 11 Ramsel
66,Bergstraat 71,2021-08-08,23:00:00,8,2,6,FMN GV 11 Ramsel
66,Bergstraat 71,2021-08-09,00:00:00,2,2,0,FMN GV 11 Ramsel
66,Bergstraat 71,2021-08-09,01:00:00,0,0,0,FMN GV 11 Ramsel
66,Bergstraat 71,2021-08-09,02:00:00,0,0,0,FMN GV 11 Ramsel
66,Bergstraat 71,2021-08-09,03:00:00,0,0,0,FMN GV 11 Ramsel
66,Bergstraat 71,2021-08-09,04:00:00,4,4,0,FMN GV 11 Ramsel
66,Bergstraat 71,2021-08-09,05:00:00,12,8,4,FMN GV 11 Ramsel
66,Bergstraat 71,2021-08-09,06:00:00,20,12,8,FMN GV 11 Ramsel
66,Bergstraat 71,2021-08-09,07:00:00,30,6,24,FMN GV 11 Ramsel
66,Bergstraat 71,2021-08-09,08:00:00,34,8,26,FMN GV 11 Ramsel
66,Bergstraat 71,2021-08-09,09:00:00,54,26,28,FMN GV 11 Ramsel
66,Bergstraat 71,2021-08-09,10:00:00,46,28,18,FMN GV 11 Ramsel
66,Bergstraat 71,2021-08-09,11:00:00,42,16,26,FMN GV 11 Ramsel
66,Bergstraat 71,2021-08-09,12:00:00,66,38,28,FMN GV 11 Ramsel
66,Bergstraat 71,2021-08-09,13:00:00,48,12,36,FMN GV 11 Ramsel
66,Bergstraat 71,2021-08-09,14:00:00,94,54,40,FMN GV 11 Ramsel
66,Bergstraat 71,2021-08-09,15:00:00,48,38,10,FMN GV 11 Ramsel
66,Bergstraat 71,2021-08-09,16:00:00,46,26,20,FMN GV 11 Ramsel
66,Bergstraat 71,2021-08-09,17:00:00,74,36,38,FMN GV 11 Ramsel
66,Bergstraat 71,2021-08-09,18:00:00,60,28,32,FMN GV 11 Ramsel
66,Bergstraat 71,2021-08-09,19:00:00,32,16,16,FMN GV 11 Ramsel
66,Bergstraat 71,2021-08-09,20:00:00,52,38,14,FMN GV 11 Ramsel
66,Bergstraat 71,2021-08-09,21:00:00,24,14,10,FMN GV 11 Ramsel
66,Bergstraat 71,2021-08-09,22:00:00,6,4,2,FMN GV 11 Ramsel
66,Bergstraat 71,2021-08-09,23:00:00,6,2,4,FMN GV 11 Ramsel
66,Bergstraat 71,2021-08-10,00:00:00,0,0,0,FMN GV 11 Ramsel
66,Bergstraat 71,2021-08-10,01:00:00,2,2,0,FMN GV 11 Ramsel
66,Bergstraat 71,2021-08-10,02:00:00,0,0,0,FMN GV 11 Ramsel
66,Bergstraat 71,2021-08-10,03:00:00,0,0,0,FMN GV 11 Ramsel
66,Bergstraat 71,2021-08-10,04:00:00,6,6,0,FMN GV 11 Ramsel
66,Bergstraat 71,2021-08-10,05:00:00,8,4,4,FMN GV 11 Ramsel
66,Bergstraat 71,2021-08-10,06:00:00,34,16,18,FMN GV 11 Ramsel
66,Bergstraat 71,2021-08-10,07:00:00,36,8,28,FMN GV 11 Ramsel
66,Bergstraat 71,2021-08-10,08:00:00,28,6,22,FMN GV 11 Ramsel
66,Bergstraat 71,2021-08-10,09:00:00,36,18,18,FMN GV 11 Ramsel
66,Bergstraat 71,2021-08-10,10:00:00,60,18,42,FMN GV 11 Ramsel
66,Bergstraat 71,2021-08-10,11:00:00,48,18,30,FMN GV 11 Ramsel
66,Bergstraat 71,2021-08-10,12:00:00,92,38,54,FMN GV 11 Ramsel
66,Bergstraat 71,2021-08-10,13:00:00,108,50,58,FMN GV 11 Ramsel
66,Bergstraat 71,2021-08-10,14:00:00,76,40,36,FMN GV 11 Ramsel
66,Bergstraat 71,2021-08-10,15:00:00,74,50,24,FMN GV 11 Ramsel
66,Bergstraat 71,2021-08-10,16:00:00,38,26,12,FMN GV 11 Ramsel
66,Bergstraat 71,2021-08-10,17:00:00,64,28,36,FMN GV 11 Ramsel
66,Bergstraat 71,2021-08-10,18:00:00,78,46,32,FMN GV 11 Ramsel
66,Bergstraat 71,2021-08-10,19:00:00,60,16,44,FMN GV 11 Ramsel
66,Bergstraat 71,2021-08-10,20:00:00,56,30,26,FMN GV 11 Ramsel
66,Bergstraat 71,2021-08-10,21:00:00,38,32,6,FMN GV 11 Ramsel
66,Bergstraat 71,2021-08-10,22:00:00,6,6,0,FMN GV 11 Ramsel
66,Bergstraat 71,2021-08-10,23:00:00,8,2,6,FMN GV 11 Ramsel
66,Bergstraat 71,2021-08-11,00:00:00,2,2,0,FMN GV 11 Ramsel
66,Bergstraat 71,2021-08-11,01:00:00,8,2,6,FMN GV 11 Ramsel
66,Bergstraat 71,2021-08-11,02:00:00,0,0,0,FMN GV 11 Ramsel
66,Bergstraat 71,2021-08-11,03:00:00,0,0,0,FMN GV 11 Ramsel
66,Bergstraat 71,2021-08-11,04:00:00,6,6,0,FMN GV 11 Ramsel
66,Bergstraat 71,2021-08-11,05:00:00,18,6,12,FMN GV 11 Ramsel
66,Bergstraat 71,2021-08-11,06:00:00,32,12,20,FMN GV 11 Ramsel
66,Bergstraat 71,2021-08-11,07:00:00,38,16,22,FMN GV 11 Ramsel
66,Bergstraat 71,2021-08-11,08:00:00,60,14,46,FMN GV 11 Ramsel
66,Bergstraat 71,2021-08-11,09:00:00,80,18,62,FMN GV 11 Ramsel
66,Bergstraat 71,2021-08-11,10:00:00,176,82,94,FMN GV 11 Ramsel
66,Bergstraat 71,2021-08-11,11:00:00,140,54,86,FMN GV 11 Ramsel
66,Bergstraat 71,2021-08-11,12:00:00,222,140,82,FMN GV 11 Ramsel
66,Bergstraat 71,2021-08-11,13:00:00,262,144,118,FMN GV 11 Ramsel
66,Bergstraat 71,2021-08-11,14:00:00,338,184,154,FMN GV 11 Ramsel
66,Bergstraat 71,2021-08-11,15:00:00,264,118,146,FMN GV 11 Ramsel
66,Bergstraat 71,2021-08-11,16:00:00,230,122,108,FMN GV 11 Ramsel
66,Bergstraat 71,2021-08-11,17:00:00,202,114,88,FMN GV 11 Ramsel
66,Bergstraat 71,2021-08-11,18:00:00,162,106,56,FMN GV 11 Ramsel
66,Bergstraat 71,2021-08-11,19:00:00,164,80,84,FMN GV 11 Ramsel
66,Bergstraat 71,2021-08-11,20:00:00,86,50,36,FMN GV 11 Ramsel
66,Bergstraat 71,2021-08-11,21:00:00,48,24,24,FMN GV 11 Ramsel
66,Bergstraat 71,2021-08-11,22:00:00,8,4,4,FMN GV 11 Ramsel
66,Bergstraat 71,2021-08-11,23:00:00,22,12,10,FMN GV 11 Ramsel
66,Bergstraat 71,2021-08-12,00:00:00,6,6,0,FMN GV 11 Ramsel
66,Bergstraat 71,2021-08-12,01:00:00,2,2,0,FMN GV 11 Ramsel
66,Bergstraat 71,2021-08-12,02:00:00,0,0,0,FMN GV 11 Ramsel
66,Bergstraat 71,2021-08-12,03:00:00,0,0,0,FMN GV 11 Ramsel
66,Bergstraat 71,2021-08-12,04:00:00,12,6,6,FMN GV 11 Ramsel
66,Bergstraat 71,2021-08-12,05:00:00,18,6,12,FMN GV 11 Ramsel
66,Bergstraat 71,2021-08-12,06:00:00,26,12,14,FMN GV 11 Ramsel
66,Bergstraat 71,2021-08-12,07:00:00,40,20,20,FMN GV 11 Ramsel
66,Bergstraat 71,2021-08-12,08:00:00,74,24,50,FMN GV 11 Ramsel
66,Bergstraat 71,2021-08-12,09:00:00,88,30,58,FMN GV 11 Ramsel
66,Bergstraat 71,2021-08-12,10:00:00,174,42,132,FMN GV 11 Ramsel
66,Bergstraat 71,2021-08-12,11:00:00,230,124,106,FMN GV 11 Ramsel
66,Bergstraat 71,2021-08-12,12:00:00,176,98,78,FMN GV 11 Ramsel
66,Bergstraat 71,2021-08-12,13:00:00,244,102,142,FMN GV 11 Ramsel
66,Bergstraat 71,2021-08-12,14:00:00,360,172,188,FMN GV 11 Ramsel
66,Bergstraat 71,2021-08-12,15:00:00,298,148,150,FMN GV 11 Ramsel
66,Bergstraat 71,2021-08-12,16:00:00,234,116,118,FMN GV 11 Ramsel
66,Bergstraat 71,2021-08-12,17:00:00,192,110,82,FMN GV 11 Ramsel
66,Bergstraat 71,2021-08-12,18:00:00,134,70,64,FMN GV 11 Ramsel
66,Bergstraat 71,2021-08-12,19:00:00,100,38,62,FMN GV 11 Ramsel
66,Bergstraat 71,2021-08-12,20:00:00,90,32,58,FMN GV 11 Ramsel
66,Bergstraat 71,2021-08-12,21:00:00,60,38,22,FMN GV 11 Ramsel
66,Bergstraat 71,2021-08-12,22:00:00,32,30,2,FMN GV 11 Ramsel
66,Bergstraat 71,2021-08-12,23:00:00,6,6,0,FMN GV 11 Ramsel
66,Bergstraat 71,2021-08-13,00:00:00,8,6,2,FMN GV 11 Ramsel
66,Bergstraat 71,2021-08-13,01:00:00,6,2,4,FMN GV 11 Ramsel
66,Bergstraat 71,2021-08-13,02:00:00,10,8,2,FMN GV 11 Ramsel
66,Bergstraat 71,2021-08-13,03:00:00,0,0,0,FMN GV 11 Ramsel
66,Bergstraat 71,2021-08-13,04:00:00,8,6,2,FMN GV 11 Ramsel
66,Bergstraat 71,2021-08-13,05:00:00,14,2,12,FMN GV 11 Ramsel
66,Bergstraat 71,2021-08-13,06:00:00,18,8,10,FMN GV 11 Ramsel
66,Bergstraat 71,2021-08-13,07:00:00,26,8,18,FMN GV 11 Ramsel
66,Bergstraat 71,2021-08-13,08:00:00,64,16,48,FMN GV 11 Ramsel
66,Bergstraat 71,2021-08-13,09:00:00,50,22,28,FMN GV 11 Ramsel
66,Bergstraat 71,2021-08-13,10:00:00,158,74,84,FMN GV 11 Ramsel
66,Bergstraat 71,2021-08-13,11:00:00,132,64,68,FMN GV 11 Ramsel
66,Bergstraat 71,2021-08-13,12:00:00,168,88,80,FMN GV 11 Ramsel
66,Bergstraat 71,2021-08-13,13:00:00,266,134,132,FMN GV 11 Ramsel
66,Bergstraat 71,2021-08-13,14:00:00,292,126,166,FMN GV 11 Ramsel
66,Bergstraat 71,2021-08-13,15:00:00,228,114,114,FMN GV 11 Ramsel
66,Bergstraat 71,2021-08-13,16:00:00,228,122,106,FMN GV 11 Ramsel
66,Bergstraat 71,2021-08-13,17:00:00,176,112,64,FMN GV 11 Ramsel
66,Bergstraat 71,2021-08-13,18:00:00,146,66,80,FMN GV 11 Ramsel
66,Bergstraat 71,2021-08-13,19:00:00,78,36,42,FMN GV 11 Ramsel
66,Bergstraat 71,2021-08-13,20:00:00,76,50,26,FMN GV 11 Ramsel
66,Bergstraat 71,2021-08-13,21:00:00,54,30,24,FMN GV 11 Ramsel
66,Bergstraat 71,2021-08-13,22:00:00,20,14,6,FMN GV 11 Ramsel
66,Bergstraat 71,2021-08-13,23:00:00,12,6,6,FMN GV 11 Ramsel
66,Bergstraat 71,2021-08-14,00:00:00,10,8,2,FMN GV 11 Ramsel
66,Bergstraat 71,2021-08-14,01:00:00,26,24,2,FMN GV 11 Ramsel
66,Bergstraat 71,2021-08-14,02:00:00,8,6,2,FMN GV 11 Ramsel
66,Bergstraat 71,2021-08-14,03:00:00,0,0,0,FMN GV 11 Ramsel
66,Bergstraat 71,2021-08-14,04:00:00,0,0,0,FMN GV 11 Ramsel
66,Bergstraat 71,2021-08-14,05:00:00,0,0,0,FMN GV 11 Ramsel
66,Bergstraat 71,2021-08-14,06:00:00,6,2,4,FMN GV 11 Ramsel
66,Bergstraat 71,2021-08-14,07:00:00,12,4,8,FMN GV 11 Ramsel
66,Bergstraat 71,2021-08-14,08:00:00,44,24,20,FMN GV 11 Ramsel
66,Bergstraat 71,2021-08-14,09:00:00,84,36,48,FMN GV 11 Ramsel
66,Bergstraat 71,2021-08-14,10:00:00,148,74,74,FMN GV 11 Ramsel
66,Bergstraat 71,2021-08-14,11:00:00,194,78,116,FMN GV 11 Ramsel
66,Bergstraat 71,2021-08-14,12:00:00,132,52,80,FMN GV 11 Ramsel
66,Bergstraat 71,2021-08-14,13:00:00,244,116,128,FMN GV 11 Ramsel
66,Bergstraat 71,2021-08-14,14:00:00,298,134,164,FMN GV 11 Ramsel
66,Bergstraat 71,2021-08-14,15:00:00,260,116,144,FMN GV 11 Ramsel
66,Bergstraat 71,2021-08-14,16:00:00,206,106,100,FMN GV 11 Ramsel
66,Bergstraat 71,2021-08-14,17:00:00,202,140,62,FMN GV 11 Ramsel
66,Bergstraat 71,2021-08-14,18:00:00,124,68,56,FMN GV 11 Ramsel
66,Bergstraat 71,2021-08-14,19:00:00,66,30,36,FMN GV 11 Ramsel
66,Bergstraat 71,2021-08-14,20:00:00,72,44,28,FMN GV 11 Ramsel
66,Bergstraat 71,2021-08-14,21:00:00,44,24,20,FMN GV 11 Ramsel
66,Bergstraat 71,2021-08-14,22:00:00,20,18,2,FMN GV 11 Ramsel
66,Bergstraat 71,2021-08-14,23:00:00,2,2,0,FMN GV 11 Ramsel
66,Bergstraat 71,2021-08-15,00:00:00,18,6,12,FMN GV 11 Ramsel
66,Bergstraat 71,2021-08-15,01:00:00,6,2,4,FMN GV 11 Ramsel
66,Bergstraat 71,2021-08-15,02:00:00,6,6,0,FMN GV 11 Ramsel
66,Bergstraat 71,2021-08-15,03:00:00,0,0,0,FMN GV 11 Ramsel
66,Bergstraat 71,2021-08-15,04:00:00,0,0,0,FMN GV 11 Ramsel
66,Bergstraat 71,2021-08-15,05:00:00,0,0,0,FMN GV 11 Ramsel
66,Bergstraat 71,2021-08-15,06:00:00,8,4,4,FMN GV 11 Ramsel
66,Bergstraat 71,2021-08-15,07:00:00,26,8,18,FMN GV 11 Ramsel
66,Bergstraat 71,2021-08-15,08:00:00,82,20,62,FMN GV 11 Ramsel
66,Bergstraat 71,2021-08-15,09:00:00,148,66,82,FMN GV 11 Ramsel
66,Bergstraat 71,2021-08-15,10:00:00,268,158,110,FMN GV 11 Ramsel
66,Bergstraat 71,2021-08-15,11:00:00,222,122,100,FMN GV 11 Ramsel
66,Bergstraat 71,2021-08-15,12:00:00,194,118,76,FMN GV 11 Ramsel
66,Bergstraat 71,2021-08-15,13:00:00,294,146,148,FMN GV 11 Ramsel
66,Bergstraat 71,2021-08-15,14:00:00,414,170,244,FMN GV 11 Ramsel
66,Bergstraat 71,2021-08-15,15:00:00,408,194,214,FMN GV 11 Ramsel
66,Bergstraat 71,2021-08-15,16:00:00,292,128,164,FMN GV 11 Ramsel
66,Bergstraat 71,2021-08-15,17:00:00,226,120,106,FMN GV 11 Ramsel
66,Bergstraat 71,2021-08-15,18:00:00,120,62,58,FMN GV 11 Ramsel
66,Bergstraat 71,2021-08-15,19:00:00,128,68,60,FMN GV 11 Ramsel
66,Bergstraat 71,2021-08-15,20:00:00,72,16,56,FMN GV 11 Ramsel
66,Bergstraat 71,2021-08-15,21:00:00,60,16,44,FMN GV 11 Ramsel
66,Bergstraat 71,2021-08-15,22:00:00,44,38,6,FMN GV 11 Ramsel
66,Bergstraat 71,2021-08-15,23:00:00,34,32,2,FMN GV 11 Ramsel
66,Bergstraat 71,2021-08-16,00:00:00,44,42,2,FMN GV 11 Ramsel
66,Bergstraat 71,2021-08-16,01:00:00,30,30,0,FMN GV 11 Ramsel
66,Bergstraat 71,2021-08-16,02:00:00,8,6,2,FMN GV 11 Ramsel
66,Bergstraat 71,2021-08-16,03:00:00,4,0,4,FMN GV 11 Ramsel
66,Bergstraat 71,2021-08-16,04:00:00,2,2,0,FMN GV 11 Ramsel
66,Bergstraat 71,2021-08-16,05:00:00,6,4,2,FMN GV 11 Ramsel
66,Bergstraat 71,2021-08-16,06:00:00,16,10,6,FMN GV 11 Ramsel
66,Bergstraat 71,2021-08-16,07:00:00,36,20,16,FMN GV 11 Ramsel
66,Bergstraat 71,2021-08-16,08:00:00,30,14,16,FMN GV 11 Ramsel
66,Bergstraat 71,2021-08-16,09:00:00,32,8,24,FMN GV 11 Ramsel
66,Bergstraat 71,2021-08-16,10:00:00,14,14,0,FMN GV 11 Ramsel
66,Bergstraat 71,2021-08-16,11:00:00,34,18,16,FMN GV 11 Ramsel
66,Bergstraat 71,2021-08-16,12:00:00,38,18,20,FMN GV 11 Ramsel
66,Bergstraat 71,2021-08-16,13:00:00,104,66,38,FMN GV 11 Ramsel
66,Bergstraat 71,2021-08-16,14:00:00,78,40,38,FMN GV 11 Ramsel
66,Bergstraat 71,2021-08-16,15:00:00,54,20,34,FMN GV 11 Ramsel
66,Bergstraat 71,2021-08-16,16:00:00,38,16,22,FMN GV 11 Ramsel
66,Bergstraat 71,2021-08-16,17:00:00,36,30,6,FMN GV 11 Ramsel
66,Bergstraat 71,2021-08-16,18:00:00,26,16,10,FMN GV 11 Ramsel
66,Bergstraat 71,2021-08-16,19:00:00,24,10,14,FMN GV 11 Ramsel
66,Bergstraat 71,2021-08-16,20:00:00,60,24,36,FMN GV 11 Ramsel
66,Bergstraat 71,2021-08-16,21:00:00,24,8,16,FMN GV 11 Ramsel
66,Bergstraat 71,2021-08-16,22:00:00,24,22,2,FMN GV 11 Ramsel
66,Bergstraat 71,2021-08-16,23:00:00,0,0,0,FMN GV 11 Ramsel
66,Bergstraat 71,2021-08-17,00:00:00,10,10,0,FMN GV 11 Ramsel
66,Bergstraat 71,2021-08-17,01:00:00,0,0,0,FMN GV 11 Ramsel
66,Bergstraat 71,2021-08-17,02:00:00,2,0,2,FMN GV 11 Ramsel
66,Bergstraat 71,2021-08-17,03:00:00,2,0,2,FMN GV 11 Ramsel
66,Bergstraat 71,2021-08-17,04:00:00,4,4,0,FMN GV 11 Ramsel
66,Bergstraat 71,2021-08-17,05:00:00,2,0,2,FMN GV 11 Ramsel
66,Bergstraat 71,2021-08-17,06:00:00,22,14,8,FMN GV 11 Ramsel
66,Bergstraat 71,2021-08-17,07:00:00,38,20,18,FMN GV 11 Ramsel
66,Bergstraat 71,2021-08-17,08:00:00,38,10,28,FMN GV 11 Ramsel
66,Bergstraat 71,2021-08-17,09:00:00,60,22,38,FMN GV 11 Ramsel
66,Bergstraat 71,2021-08-17,10:00:00,78,42,36,FMN GV 11 Ramsel
66,Bergstraat 71,2021-08-17,11:00:00,72,48,24,FMN GV 11 Ramsel
66,Bergstraat 71,2021-08-17,12:00:00,70,38,32,FMN GV 11 Ramsel
66,Bergstraat 71,2021-08-17,13:00:00,70,32,38,FMN GV 11 Ramsel
66,Bergstraat 71,2021-08-17,14:00:00,16,12,4,FMN GV 11 Ramsel
66,Bergstraat 71,2021-08-17,15:00:00,16,14,2,FMN GV 11 Ramsel
66,Bergstraat 71,2021-08-17,16:00:00,20,8,12,FMN GV 11 Ramsel
66,Bergstraat 71,2021-08-17,17:00:00,42,24,18,FMN GV 11 Ramsel
66,Bergstraat 71,2021-08-17,18:00:00,26,16,10,FMN GV 11 Ramsel
66,Bergstraat 71,2021-08-17,19:00:00,12,6,6,FMN GV 11 Ramsel
66,Bergstraat 71,2021-08-17,20:00:00,10,2,8,FMN GV 11 Ramsel
66,Bergstraat 71,2021-08-17,21:00:00,12,10,2,FMN GV 11 Ramsel
66,Bergstraat 71,2021-08-17,22:00:00,14,8,6,FMN GV 11 Ramsel
66,Bergstraat 71,2021-08-17,23:00:00,4,0,4,FMN GV 11 Ramsel
66,Bergstraat 71,2021-08-18,00:00:00,2,2,0,FMN GV 11 Ramsel
66,Bergstraat 71,2021-08-18,01:00:00,0,0,0,FMN GV 11 Ramsel
66,Bergstraat 71,2021-08-18,02:00:00,0,0,0,FMN GV 11 Ramsel
66,Bergstraat 71,2021-08-18,03:00:00,0,0,0,FMN GV 11 Ramsel
66,Bergstraat 71,2021-08-18,04:00:00,4,4,0,FMN GV 11 Ramsel
66,Bergstraat 71,2021-08-18,05:00:00,4,0,4,FMN GV 11 Ramsel
66,Bergstraat 71,2021-08-18,06:00:00,26,14,12,FMN GV 11 Ramsel
66,Bergstraat 71,2021-08-18,07:00:00,20,6,14,FMN GV 11 Ramsel
66,Bergstraat 71,2021-08-18,08:00:00,30,12,18,FMN GV 11 Ramsel
66,Bergstraat 71,2021-08-18,09:00:00,28,10,18,FMN GV 11 Ramsel
66,Bergstraat 71,2021-08-18,10:00:00,42,12,30,FMN GV 11 Ramsel
66,Bergstraat 71,2021-08-18,11:00:00,32,16,16,FMN GV 11 Ramsel
66,Bergstraat 71,2021-08-18,12:00:00,46,22,24,FMN GV 11 Ramsel
66,Bergstraat 71,2021-08-18,13:00:00,98,34,64,FMN GV 11 Ramsel
66,Bergstraat 71,2021-08-18,14:00:00,162,66,96,FMN GV 11 Ramsel
66,Bergstraat 71,2021-08-18,15:00:00,122,56,66,FMN GV 11 Ramsel
66,Bergstraat 71,2021-08-18,16:00:00,100,60,40,FMN GV 11 Ramsel
66,Bergstraat 71,2021-08-18,17:00:00,76,46,30,FMN GV 11 Ramsel
66,Bergstraat 71,2021-08-18,18:00:00,54,26,28,FMN GV 11 Ramsel
66,Bergstraat 71,2021-08-18,19:00:00,60,44,16,FMN GV 11 Ramsel
66,Bergstraat 71,2021-08-18,20:00:00,44,28,16,FMN GV 11 Ramsel
66,Bergstraat 71,2021-08-18,21:00:00,24,16,8,FMN GV 11 Ramsel
66,Bergstraat 71,2021-08-18,22:00:00,12,10,2,FMN GV 11 Ramsel
66,Bergstraat 71,2021-08-18,23:00:00,10,0,10,FMN GV 11 Ramsel
66,Bergstraat 71,2021-08-19,00:00:00,0,0,0,FMN GV 11 Ramsel
66,Bergstraat 71,2021-08-19,01:00:00,4,4,0,FMN GV 11 Ramsel
66,Bergstraat 71,2021-08-19,02:00:00,0,0,0,FMN GV 11 Ramsel
66,Bergstraat 71,2021-08-19,03:00:00,0,0,0,FMN GV 11 Ramsel
66,Bergstraat 71,2021-08-19,04:00:00,4,4,0,FMN GV 11 Ramsel
66,Bergstraat 71,2021-08-19,05:00:00,12,6,6,FMN GV 11 Ramsel
66,Bergstraat 71,2021-08-19,06:00:00,18,12,6,FMN GV 11 Ramsel
66,Bergstraat 71,2021-08-19,07:00:00,34,18,16,FMN GV 11 Ramsel
66,Bergstraat 71,2021-08-19,08:00:00,46,16,30,FMN GV 11 Ramsel
66,Bergstraat 71,2021-08-19,09:00:00,40,10,30,FMN GV 11 Ramsel
66,Bergstraat 71,2021-08-19,10:00:00,80,32,48,FMN GV 11 Ramsel
66,Bergstraat 71,2021-08-19,11:00:00,70,38,32,FMN GV 11 Ramsel
66,Bergstraat 71,2021-08-19,12:00:00,92,34,58,FMN GV 11 Ramsel
66,Bergstraat 71,2021-08-19,13:00:00,134,72,62,FMN GV 11 Ramsel
66,Bergstraat 71,2021-08-19,14:00:00,134,68,66,FMN GV 11 Ramsel
66,Bergstraat 71,2021-08-19,15:00:00,140,74,66,FMN GV 11 Ramsel
66,Bergstraat 71,2021-08-19,16:00:00,144,90,54,FMN GV 11 Ramsel
66,Bergstraat 71,2021-08-19,17:00:00,114,52,62,FMN GV 11 Ramsel
66,Bergstraat 71,2021-08-19,18:00:00,80,34,46,FMN GV 11 Ramsel
66,Bergstraat 71,2021-08-19,19:00:00,80,50,30,FMN GV 11 Ramsel
66,Bergstraat 71,2021-08-19,20:00:00,42,18,24,FMN GV 11 Ramsel
66,Bergstraat 71,2021-08-19,21:00:00,34,26,8,FMN GV 11 Ramsel
66,Bergstraat 71,2021-08-19,22:00:00,10,6,4,FMN GV 11 Ramsel
66,Bergstraat 71,2021-08-19,23:00:00,10,6,4,FMN GV 11 Ramsel
66,Bergstraat 71,2021-08-20,00:00:00,6,6,0,FMN GV 11 Ramsel
66,Bergstraat 71,2021-08-20,01:00:00,0,0,0,FMN GV 11 Ramsel
66,Bergstraat 71,2021-08-20,02:00:00,4,4,0,FMN GV 11 Ramsel
66,Bergstraat 71,2021-08-20,03:00:00,2,0,2,FMN GV 11 Ramsel
66,Bergstraat 71,2021-08-20,04:00:00,10,6,4,FMN GV 11 Ramsel
66,Bergstraat 71,2021-08-20,05:00:00,4,4,0,FMN GV 11 Ramsel
66,Bergstraat 71,2021-08-20,06:00:00,22,12,10,FMN GV 11 Ramsel
66,Bergstraat 71,2021-08-20,07:00:00,28,14,14,FMN GV 11 Ramsel
66,Bergstraat 71,2021-08-20,08:00:00,36,10,26,FMN GV 11 Ramsel
66,Bergstraat 71,2021-08-20,09:00:00,30,14,16,FMN GV 11 Ramsel
66,Bergstraat 71,2021-08-20,10:00:00,68,42,26,FMN GV 11 Ramsel
66,Bergstraat 71,2021-08-20,11:00:00,68,24,44,FMN GV 11 Ramsel
66,Bergstraat 71,2021-08-20,12:00:00,106,36,70,FMN GV 11 Ramsel
66,Bergstraat 71,2021-08-20,13:00:00,134,64,70,FMN GV 11 Ramsel
66,Bergstraat 71,2021-08-20,14:00:00,248,106,142,FMN GV 11 Ramsel
66,Bergstraat 71,2021-08-20,15:00:00,170,90,80,FMN GV 11 Ramsel
66,Bergstraat 71,2021-08-20,16:00:00,170,80,90,FMN GV 11 Ramsel
66,Bergstraat 71,2021-08-20,17:00:00,174,122,52,FMN GV 11 Ramsel
66,Bergstraat 71,2021-08-20,18:00:00,76,38,38,FMN GV 11 Ramsel
66,Bergstraat 71,2021-08-20,19:00:00,52,22,30,FMN GV 11 Ramsel
66,Bergstraat 71,2021-08-20,20:00:00,70,22,48,FMN GV 11 Ramsel
66,Bergstraat 71,2021-08-20,21:00:00,26,20,6,FMN GV 11 Ramsel
66,Bergstraat 71,2021-08-20,22:00:00,18,6,12,FMN GV 11 Ramsel
66,Bergstraat 71,2021-08-20,23:00:00,10,8,2,FMN GV 11 Ramsel
66,Bergstraat 71,2021-08-21,00:00:00,18,12,6,FMN GV 11 Ramsel
66,Bergstraat 71,2021-08-21,01:00:00,6,6,0,FMN GV 11 Ramsel
66,Bergstraat 71,2021-08-21,02:00:00,4,4,0,FMN GV 11 Ramsel
66,Bergstraat 71,2021-08-21,03:00:00,2,0,2,FMN GV 11 Ramsel
66,Bergstraat 71,2021-08-21,04:00:00,0,0,0,FMN GV 11 Ramsel
66,Bergstraat 71,2021-08-21,05:00:00,4,2,2,FMN GV 11 Ramsel
66,Bergstraat 71,2021-08-21,06:00:00,6,4,2,FMN GV 11 Ramsel
66,Bergstraat 71,2021-08-21,07:00:00,22,4,18,FMN GV 11 Ramsel
66,Bergstraat 71,2021-08-21,08:00:00,46,16,30,FMN GV 11 Ramsel
66,Bergstraat 71,2021-08-21,09:00:00,124,48,76,FMN GV 11 Ramsel
66,Bergstraat 71,2021-08-21,10:00:00,174,86,88,FMN GV 11 Ramsel
66,Bergstraat 71,2021-08-21,11:00:00,248,118,130,FMN GV 11 Ramsel
66,Bergstraat 71,2021-08-21,12:00:00,282,132,150,FMN GV 11 Ramsel
66,Bergstraat 71,2021-08-21,13:00:00,368,176,192,FMN GV 11 Ramsel
66,Bergstraat 71,2021-08-21,14:00:00,456,246,210,FMN GV 11 Ramsel
66,Bergstraat 71,2021-08-21,15:00:00,278,150,128,FMN GV 11 Ramsel
66,Bergstraat 71,2021-08-21,16:00:00,324,166,158,FMN GV 11 Ramsel
66,Bergstraat 71,2021-08-21,17:00:00,190,108,82,FMN GV 11 Ramsel
66,Bergstraat 71,2021-08-21,18:00:00,126,100,26,FMN GV 11 Ramsel
66,Bergstraat 71,2021-08-21,19:00:00,64,14,50,FMN GV 11 Ramsel
66,Bergstraat 71,2021-08-21,20:00:00,40,16,24,FMN GV 11 Ramsel
66,Bergstraat 71,2021-08-21,21:00:00,14,8,6,FMN GV 11 Ramsel
66,Bergstraat 71,2021-08-21,22:00:00,8,4,4,FMN GV 11 Ramsel
66,Bergstraat 71,2021-08-21,23:00:00,24,16,8,FMN GV 11 Ramsel
66,Bergstraat 71,2021-08-22,00:00:00,4,4,0,FMN GV 11 Ramsel
66,Bergstraat 71,2021-08-22,01:00:00,14,10,4,FMN GV 11 Ramsel
66,Bergstraat 71,2021-08-22,02:00:00,0,0,0,FMN GV 11 Ramsel
66,Bergstraat 71,2021-08-22,03:00:00,2,2,0,FMN GV 11 Ramsel
66,Bergstraat 71,2021-08-22,04:00:00,0,0,0,FMN GV 11 Ramsel
66,Bergstraat 71,2021-08-22,05:00:00,4,2,2,FMN GV 11 Ramsel
66,Bergstraat 71,2021-08-22,06:00:00,2,2,0,FMN GV 11 Ramsel
66,Bergstraat 71,2021-08-22,07:00:00,18,8,10,FMN GV 11 Ramsel
66,Bergstraat 71,2021-08-22,08:00:00,52,10,42,FMN GV 11 Ramsel
66,Bergstraat 71,2021-08-22,09:00:00,96,44,52,FMN GV 11 Ramsel
66,Bergstraat 71,2021-08-22,10:00:00,114,72,42,FMN GV 11 Ramsel
66,Bergstraat 71,2021-08-22,11:00:00,176,118,58,FMN GV 11 Ramsel
66,Bergstraat 71,2021-08-22,12:00:00,92,68,24,FMN GV 11 Ramsel
66,Bergstraat 71,2021-08-22,13:00:00,68,28,40,FMN GV 11 Ramsel
66,Bergstraat 71,2021-08-22,14:00:00,92,24,68,FMN GV 11 Ramsel
66,Bergstraat 71,2021-08-22,15:00:00,66,34,32,FMN GV 11 Ramsel
66,Bergstraat 71,2021-08-22,16:00:00,18,14,4,FMN GV 11 Ramsel
66,Bergstraat 71,2021-08-22,17:00:00,20,18,2,FMN GV 11 Ramsel
66,Bergstraat 71,2021-08-22,18:00:00,24,14,10,FMN GV 11 Ramsel
66,Bergstraat 71,2021-08-22,19:00:00,32,12,20,FMN GV 11 Ramsel
66,Bergstraat 71,2021-08-22,20:00:00,16,2,14,FMN GV 11 Ramsel
66,Bergstraat 71,2021-08-22,21:00:00,14,4,10,FMN GV 11 Ramsel
66,Bergstraat 71,2021-08-22,22:00:00,8,6,2,FMN GV 11 Ramsel
66,Bergstraat 71,2021-08-22,23:00:00,12,6,6,FMN GV 11 Ramsel
66,Bergstraat 71,2021-08-23,00:00:00,4,4,0,FMN GV 11 Ramsel
66,Bergstraat 71,2021-08-23,01:00:00,2,2,0,FMN GV 11 Ramsel
66,Bergstraat 71,2021-08-23,02:00:00,4,2,2,FMN GV 11 Ramsel
66,Bergstraat 71,2021-08-23,03:00:00,0,0,0,FMN GV 11 Ramsel
66,Bergstraat 71,2021-08-23,04:00:00,6,6,0,FMN GV 11 Ramsel
66,Bergstraat 71,2021-08-23,05:00:00,4,0,4,FMN GV 11 Ramsel
66,Bergstraat 71,2021-08-23,06:00:00,24,14,10,FMN GV 11 Ramsel
66,Bergstraat 71,2021-08-23,07:00:00,26,12,14,FMN GV 11 Ramsel
66,Bergstraat 71,2021-08-23,08:00:00,36,10,26,FMN GV 11 Ramsel
66,Bergstraat 71,2021-08-23,09:00:00,10,6,4,FMN GV 11 Ramsel
66,Bergstraat 71,2021-08-23,10:00:00,12,6,6,FMN GV 11 Ramsel
66,Bergstraat 71,2021-08-23,11:00:00,40,16,24,FMN GV 11 Ramsel
66,Bergstraat 71,2021-08-23,12:00:00,50,30,20,FMN GV 11 Ramsel
66,Bergstraat 71,2021-08-23,13:00:00,124,68,56,FMN GV 11 Ramsel
66,Bergstraat 71,2021-08-23,14:00:00,106,42,64,FMN GV 11 Ramsel
66,Bergstraat 71,2021-08-23,15:00:00,118,64,54,FMN GV 11 Ramsel
66,Bergstraat 71,2021-08-23,16:00:00,122,68,54,FMN GV 11 Ramsel
66,Bergstraat 71,2021-08-23,17:00:00,92,60,32,FMN GV 11 Ramsel
66,Bergstraat 71,2021-08-23,18:00:00,52,24,28,FMN GV 11 Ramsel
66,Bergstraat 71,2021-08-23,19:00:00,80,46,34,FMN GV 11 Ramsel
66,Bergstraat 71,2021-08-23,20:00:00,36,20,16,FMN GV 11 Ramsel
66,Bergstraat 71,2021-08-23,21:00:00,18,4,14,FMN GV 11 Ramsel
66,Bergstraat 71,2021-08-23,22:00:00,6,4,2,FMN GV 11 Ramsel
66,Bergstraat 71,2021-08-23,23:00:00,4,2,2,FMN GV 11 Ramsel
66,Bergstraat 71,2021-08-24,00:00:00,0,0,0,FMN GV 11 Ramsel
66,Bergstraat 71,2021-08-24,01:00:00,4,4,0,FMN GV 11 Ramsel
66,Bergstraat 71,2021-08-24,02:00:00,0,0,0,FMN GV 11 Ramsel
66,Bergstraat 71,2021-08-24,03:00:00,2,0,2,FMN GV 11 Ramsel
66,Bergstraat 71,2021-08-24,04:00:00,6,4,2,FMN GV 11 Ramsel
66,Bergstraat 71,2021-08-24,05:00:00,10,4,6,FMN GV 11 Ramsel
66,Bergstraat 71,2021-08-24,06:00:00,22,14,8,FMN GV 11 Ramsel
66,Bergstraat 71,2021-08-24,07:00:00,62,20,42,FMN GV 11 Ramsel
66,Bergstraat 71,2021-08-24,08:00:00,54,18,36,FMN GV 11 Ramsel
66,Bergstraat 71,2021-08-24,09:00:00,62,30,32,FMN GV 11 Ramsel
66,Bergstraat 71,2021-08-24,10:00:00,102,52,50,FMN GV 11 Ramsel
66,Bergstraat 71,2021-08-24,11:00:00,148,42,106,FMN GV 11 Ramsel
66,Bergstraat 71,2021-08-24,12:00:00,138,72,66,FMN GV 11 Ramsel
66,Bergstraat 71,2021-08-24,13:00:00,304,170,134,FMN GV 11 Ramsel
66,Bergstraat 71,2021-08-24,14:00:00,340,178,162,FMN GV 11 Ramsel
66,Bergstraat 71,2021-08-24,15:00:00,266,150,116,FMN GV 11 Ramsel
66,Bergstraat 71,2021-08-24,16:00:00,266,180,86,FMN GV 11 Ramsel
66,Bergstraat 71,2021-08-24,17:00:00,182,90,92,FMN GV 11 Ramsel
66,Bergstraat 71,2021-08-24,18:00:00,144,84,60,FMN GV 11 Ramsel
66,Bergstraat 71,2021-08-24,19:00:00,136,66,70,FMN GV 11 Ramsel
66,Bergstraat 71,2021-08-24,20:00:00,62,32,30,FMN GV 11 Ramsel
66,Bergstraat 71,2021-08-24,21:00:00,28,16,12,FMN GV 11 Ramsel
66,Bergstraat 71,2021-08-24,22:00:00,18,10,8,FMN GV 11 Ramsel
66,Bergstraat 71,2021-08-24,23:00:00,4,4,0,FMN GV 11 Ramsel
66,Bergstraat 71,2021-08-25,00:00:00,10,8,2,FMN GV 11 Ramsel
66,Bergstraat 71,2021-08-25,01:00:00,8,8,0,FMN GV 11 Ramsel
66,Bergstraat 71,2021-08-25,02:00:00,0,0,0,FMN GV 11 Ramsel
66,Bergstraat 71,2021-08-25,03:00:00,0,0,0,FMN GV 11 Ramsel
66,Bergstraat 71,2021-08-25,04:00:00,8,4,4,FMN GV 11 Ramsel
66,Bergstraat 71,2021-08-25,05:00:00,10,2,8,FMN GV 11 Ramsel
66,Bergstraat 71,2021-08-25,06:00:00,26,20,6,FMN GV 11 Ramsel
66,Bergstraat 71,2021-08-25,07:00:00,50,16,34,FMN GV 11 Ramsel
66,Bergstraat 71,2021-08-25,08:00:00,44,22,22,FMN GV 11 Ramsel
66,Bergstraat 71,2021-08-25,09:00:00,78,32,46,FMN GV 11 Ramsel
66,Bergstraat 71,2021-08-25,10:00:00,120,34,86,FMN GV 11 Ramsel
66,Bergstraat 71,2021-08-25,11:00:00,78,38,40,FMN GV 11 Ramsel
66,Bergstraat 71,2021-08-25,12:00:00,122,54,68,FMN GV 11 Ramsel
66,Bergstraat 71,2021-08-25,13:00:00,284,140,144,FMN GV 11 Ramsel
66,Bergstraat 71,2021-08-25,14:00:00,352,212,140,FMN GV 11 Ramsel
66,Bergstraat 71,2021-08-25,15:00:00,328,170,158,FMN GV 11 Ramsel
66,Bergstraat 71,2021-08-25,16:00:00,286,166,120,FMN GV 11 Ramsel
66,Bergstraat 71,2021-08-25,17:00:00,238,108,130,FMN GV 11 Ramsel
66,Bergstraat 71,2021-08-25,18:00:00,166,68,98,FMN GV 11 Ramsel
66,Bergstraat 71,2021-08-25,19:00:00,114,66,48,FMN GV 11 Ramsel
66,Bergstraat 71,2021-08-25,20:00:00,62,36,26,FMN GV 11 Ramsel
66,Bergstraat 71,2021-08-25,21:00:00,30,30,0,FMN GV 11 Ramsel
66,Bergstraat 71,2021-08-25,22:00:00,12,6,6,FMN GV 11 Ramsel
66,Bergstraat 71,2021-08-25,23:00:00,8,2,6,FMN GV 11 Ramsel
66,Bergstraat 71,2021-08-26,00:00:00,4,4,0,FMN GV 11 Ramsel
66,Bergstraat 71,2021-08-26,01:00:00,2,2,0,FMN GV 11 Ramsel
66,Bergstraat 71,2021-08-26,02:00:00,14,8,6,FMN GV 11 Ramsel
66,Bergstraat 71,2021-08-26,03:00:00,0,0,0,FMN GV 11 Ramsel
66,Bergstraat 71,2021-08-26,04:00:00,4,4,0,FMN GV 11 Ramsel
66,Bergstraat 71,2021-08-26,05:00:00,10,4,6,FMN GV 11 Ramsel
66,Bergstraat 71,2021-08-26,06:00:00,24,12,12,FMN GV 11 Ramsel
66,Bergstraat 71,2021-08-26,07:00:00,44,16,28,FMN GV 11 Ramsel
66,Bergstraat 71,2021-08-26,08:00:00,28,8,20,FMN GV 11 Ramsel
66,Bergstraat 71,2021-08-26,09:00:00,26,8,18,FMN GV 11 Ramsel
66,Bergstraat 71,2021-08-26,10:00:00,42,18,24,FMN GV 11 Ramsel
66,Bergstraat 71,2021-08-26,11:00:00,100,62,38,FMN GV 11 Ramsel
66,Bergstraat 71,2021-08-26,12:00:00,44,30,14,FMN GV 11 Ramsel
66,Bergstraat 71,2021-08-26,13:00:00,138,62,76,FMN GV 11 Ramsel
66,Bergstraat 71,2021-08-26,14:00:00,124,52,72,FMN GV 11 Ramsel
66,Bergstraat 71,2021-08-26,15:00:00,86,50,36,FMN GV 11 Ramsel
66,Bergstraat 71,2021-08-26,16:00:00,110,60,50,FMN GV 11 Ramsel
66,Bergstraat 71,2021-08-26,17:00:00,102,54,48,FMN GV 11 Ramsel
66,Bergstraat 71,2021-08-26,18:00:00,80,40,40,FMN GV 11 Ramsel
66,Bergstraat 71,2021-08-26,19:00:00,72,38,34,FMN GV 11 Ramsel
66,Bergstraat 71,2021-08-26,20:00:00,30,14,16,FMN GV 11 Ramsel
66,Bergstraat 71,2021-08-26,21:00:00,26,12,14,FMN GV 11 Ramsel
66,Bergstraat 71,2021-08-26,22:00:00,40,24,16,FMN GV 11 Ramsel
66,Bergstraat 71,2021-08-26,23:00:00,14,10,4,FMN GV 11 Ramsel
66,Bergstraat 71,2021-08-27,00:00:00,2,2,0,FMN GV 11 Ramsel
66,Bergstraat 71,2021-08-27,01:00:00,14,10,4,FMN GV 11 Ramsel
66,Bergstraat 71,2021-08-27,02:00:00,0,0,0,FMN GV 11 Ramsel
66,Bergstraat 71,2021-08-27,03:00:00,0,0,0,FMN GV 11 Ramsel
66,Bergstraat 71,2021-08-27,04:00:00,4,4,0,FMN GV 11 Ramsel
66,Bergstraat 71,2021-08-27,05:00:00,12,4,8,FMN GV 11 Ramsel
66,Bergstraat 71,2021-08-27,06:00:00,20,8,12,FMN GV 11 Ramsel
66,Bergstraat 71,2021-08-27,07:00:00,42,10,32,FMN GV 11 Ramsel
66,Bergstraat 71,2021-08-27,08:00:00,32,8,24,FMN GV 11 Ramsel
66,Bergstraat 71,2021-08-27,09:00:00,38,18,20,FMN GV 11 Ramsel
66,Bergstraat 71,2021-08-27,10:00:00,92,38,54,FMN GV 11 Ramsel
66,Bergstraat 71,2021-08-27,11:00:00,92,42,50,FMN GV 11 Ramsel
66,Bergstraat 71,2021-08-27,12:00:00,100,50,50,FMN GV 11 Ramsel
66,Bergstraat 71,2021-08-27,13:00:00,150,78,72,FMN GV 11 Ramsel
66,Bergstraat 71,2021-08-27,14:00:00,134,64,70,FMN GV 11 Ramsel
66,Bergstraat 71,2021-08-27,15:00:00,128,70,58,FMN GV 11 Ramsel
66,Bergstraat 71,2021-08-27,16:00:00,120,58,62,FMN GV 11 Ramsel
66,Bergstraat 71,2021-08-27,17:00:00,86,56,30,FMN GV 11 Ramsel
66,Bergstraat 71,2021-08-27,18:00:00,70,40,30,FMN GV 11 Ramsel
66,Bergstraat 71,2021-08-27,19:00:00,16,8,8,FMN GV 11 Ramsel
66,Bergstraat 71,2021-08-27,20:00:00,40,20,20,FMN GV 11 Ramsel
66,Bergstraat 71,2021-08-27,21:00:00,26,14,12,FMN GV 11 Ramsel
66,Bergstraat 71,2021-08-27,22:00:00,14,4,10,FMN GV 11 Ramsel
66,Bergstraat 71,2021-08-27,23:00:00,18,14,4,FMN GV 11 Ramsel
66,Bergstraat 71,2021-08-28,00:00:00,10,8,2,FMN GV 11 Ramsel
66,Bergstraat 71,2021-08-28,01:00:00,22,18,4,FMN GV 11 Ramsel
66,Bergstraat 71,2021-08-28,02:00:00,0,0,0,FMN GV 11 Ramsel
66,Bergstraat 71,2021-08-28,03:00:00,0,0,0,FMN GV 11 Ramsel
66,Bergstraat 71,2021-08-28,04:00:00,2,2,0,FMN GV 11 Ramsel
66,Bergstraat 71,2021-08-28,05:00:00,4,4,0,FMN GV 11 Ramsel
66,Bergstraat 71,2021-08-28,06:00:00,10,4,6,FMN GV 11 Ramsel
66,Bergstraat 71,2021-08-28,07:00:00,20,10,10,FMN GV 11 Ramsel
66,Bergstraat 71,2021-08-28,08:00:00,30,14,16,FMN GV 11 Ramsel
66,Bergstraat 71,2021-08-28,09:00:00,62,32,30,FMN GV 11 Ramsel
66,Bergstraat 71,2021-08-28,10:00:00,116,44,72,FMN GV 11 Ramsel
66,Bergstraat 71,2021-08-28,11:00:00,92,46,46,FMN GV 11 Ramsel
66,Bergstraat 71,2021-08-28,12:00:00,96,52,44,FMN GV 11 Ramsel
66,Bergstraat 71,2021-08-28,13:00:00,112,64,48,FMN GV 11 Ramsel
66,Bergstraat 71,2021-08-28,14:00:00,88,40,48,FMN GV 11 Ramsel
66,Bergstraat 71,2021-08-28,15:00:00,110,52,58,FMN GV 11 Ramsel
66,Bergstraat 71,2021-08-28,16:00:00,114,60,54,FMN GV 11 Ramsel
66,Bergstraat 71,2021-08-28,17:00:00,72,22,50,FMN GV 11 Ramsel
66,Bergstraat 71,2021-08-28,18:00:00,60,24,36,FMN GV 11 Ramsel
66,Bergstraat 71,2021-08-28,19:00:00,60,22,38,FMN GV 11 Ramsel
66,Bergstraat 71,2021-08-28,20:00:00,28,12,16,FMN GV 11 Ramsel
66,Bergstraat 71,2021-08-28,21:00:00,30,26,4,FMN GV 11 Ramsel
66,Bergstraat 71,2021-08-28,22:00:00,10,4,6,FMN GV 11 Ramsel
66,Bergstraat 71,2021-08-28,23:00:00,12,6,6,FMN GV 11 Ramsel
66,Bergstraat 71,2021-08-29,00:00:00,14,6,8,FMN GV 11 Ramsel
66,Bergstraat 71,2021-08-29,01:00:00,18,16,2,FMN GV 11 Ramsel
66,Bergstraat 71,2021-08-29,02:00:00,8,6,2,FMN GV 11 Ramsel
66,Bergstraat 71,2021-08-29,03:00:00,6,6,0,FMN GV 11 Ramsel
66,Bergstraat 71,2021-08-29,04:00:00,4,4,0,FMN GV 11 Ramsel
66,Bergstraat 71,2021-08-29,05:00:00,4,4,0,FMN GV 11 Ramsel
66,Bergstraat 71,2021-08-29,06:00:00,6,4,2,FMN GV 11 Ramsel
66,Bergstraat 71,2021-08-29,07:00:00,24,10,14,FMN GV 11 Ramsel
66,Bergstraat 71,2021-08-29,08:00:00,52,28,24,FMN GV 11 Ramsel
66,Bergstraat 71,2021-08-29,09:00:00,132,44,88,FMN GV 11 Ramsel
66,Bergstraat 71,2021-08-29,10:00:00,140,64,76,FMN GV 11 Ramsel
66,Bergstraat 71,2021-08-29,11:00:00,152,76,76,FMN GV 11 Ramsel
66,Bergstraat 71,2021-08-29,12:00:00,86,58,28,FMN GV 11 Ramsel
66,Bergstraat 71,2021-08-29,13:00:00,56,26,30,FMN GV 11 Ramsel
66,Bergstraat 71,2021-08-29,14:00:00,48,20,28,FMN GV 11 Ramsel
66,Bergstraat 71,2021-08-29,15:00:00,22,14,8,FMN GV 11 Ramsel
66,Bergstraat 71,2021-08-29,16:00:00,38,18,20,FMN GV 11 Ramsel
66,Bergstraat 71,2021-08-29,17:00:00,32,18,14,FMN GV 11 Ramsel
66,Bergstraat 71,2021-08-29,18:00:00,26,14,12,FMN GV 11 Ramsel
66,Bergstraat 71,2021-08-29,19:00:00,26,8,18,FMN GV 11 Ramsel
66,Bergstraat 71,2021-08-29,20:00:00,4,2,2,FMN GV 11 Ramsel
66,Bergstraat 71,2021-08-29,21:00:00,16,8,8,FMN GV 11 Ramsel
66,Bergstraat 71,2021-08-29,22:00:00,6,4,2,FMN GV 11 Ramsel
66,Bergstraat 71,2021-08-29,23:00:00,0,0,0,FMN GV 11 Ramsel
66,Bergstraat 71,2021-08-30,00:00:00,6,6,0,FMN GV 11 Ramsel
66,Bergstraat 71,2021-08-30,01:00:00,2,2,0,FMN GV 11 Ramsel
66,Bergstraat 71,2021-08-30,02:00:00,2,2,0,FMN GV 11 Ramsel
66,Bergstraat 71,2021-08-30,03:00:00,0,0,0,FMN GV 11 Ramsel
66,Bergstraat 71,2021-08-30,04:00:00,4,4,0,FMN GV 11 Ramsel
66,Bergstraat 71,2021-08-30,05:00:00,8,8,0,FMN GV 11 Ramsel
66,Bergstraat 71,2021-08-30,06:00:00,32,12,20,FMN GV 11 Ramsel
66,Bergstraat 71,2021-08-30,07:00:00,48,12,36,FMN GV 11 Ramsel
66,Bergstraat 71,2021-08-30,08:00:00,56,18,38,FMN GV 11 Ramsel
66,Bergstraat 71,2021-08-30,09:00:00,34,20,14,FMN GV 11 Ramsel
66,Bergstraat 71,2021-08-30,10:00:00,54,36,18,FMN GV 11 Ramsel
66,Bergstraat 71,2021-08-30,11:00:00,50,28,22,FMN GV 11 Ramsel
66,Bergstraat 71,2021-08-30,12:00:00,84,46,38,FMN GV 11 Ramsel
66,Bergstraat 71,2021-08-30,13:00:00,132,62,70,FMN GV 11 Ramsel
66,Bergstraat 71,2021-08-30,14:00:00,130,54,76,FMN GV 11 Ramsel
66,Bergstraat 71,2021-08-30,15:00:00,100,48,52,FMN GV 11 Ramsel
66,Bergstraat 71,2021-08-30,16:00:00,124,64,60,FMN GV 11 Ramsel
66,Bergstraat 71,2021-08-30,17:00:00,98,60,38,FMN GV 11 Ramsel
66,Bergstraat 71,2021-08-30,18:00:00,62,34,28,FMN GV 11 Ramsel
66,Bergstraat 71,2021-08-30,19:00:00,74,28,46,FMN GV 11 Ramsel
66,Bergstraat 71,2021-08-30,20:00:00,68,44,24,FMN GV 11 Ramsel
66,Bergstraat 71,2021-08-30,21:00:00,26,20,6,FMN GV 11 Ramsel
66,Bergstraat 71,2021-08-30,22:00:00,10,4,6,FMN GV 11 Ramsel
66,Bergstraat 71,2021-08-30,23:00:00,8,4,4,FMN GV 11 Ramsel
66,Bergstraat 71,2021-08-31,00:00:00,2,2,0,FMN GV 11 Ramsel
66,Bergstraat 71,2021-08-31,01:00:00,2,0,2,FMN GV 11 Ramsel
66,Bergstraat 71,2021-08-31,02:00:00,0,0,0,FMN GV 11 Ramsel
66,Bergstraat 71,2021-08-31,03:00:00,0,0,0,FMN GV 11 Ramsel
66,Bergstraat 71,2021-08-31,04:00:00,6,4,2,FMN GV 11 Ramsel
66,Bergstraat 71,2021-08-31,05:00:00,12,6,6,FMN GV 11 Ramsel
66,Bergstraat 71,2021-08-31,06:00:00,30,12,18,FMN GV 11 Ramsel
66,Bergstraat 71,2021-08-31,07:00:00,52,14,38,FMN GV 11 Ramsel
66,Bergstraat 71,2021-08-31,08:00:00,64,20,44,FMN GV 11 Ramsel
66,Bergstraat 71,2021-08-31,09:00:00,84,24,60,FMN GV 11 Ramsel
66,Bergstraat 71,2021-08-31,10:00:00,72,34,38,FMN GV 11 Ramsel
66,Bergstraat 71,2021-08-31,11:00:00,66,26,40,FMN GV 11 Ramsel
66,Bergstraat 71,2021-08-31,12:00:00,90,44,46,FMN GV 11 Ramsel
66,Bergstraat 71,2021-08-31,13:00:00,224,96,128,FMN GV 11 Ramsel
66,Bergstraat 71,2021-08-31,14:00:00,250,136,114,FMN GV 11 Ramsel
66,Bergstraat 71,2021-08-31,15:00:00,294,142,152,FMN GV 11 Ramsel
66,Bergstraat 71,2021-08-31,16:00:00,184,108,76,FMN GV 11 Ramsel
66,Bergstraat 71,2021-08-31,17:00:00,226,112,114,FMN GV 11 Ramsel
66,Bergstraat 71,2021-08-31,18:00:00,82,54,28,FMN GV 11 Ramsel
66,Bergstraat 71,2021-08-31,19:00:00,56,40,16,FMN GV 11 Ramsel
66,Bergstraat 71,2021-08-31,20:00:00,86,42,44,FMN GV 11 Ramsel
66,Bergstraat 71,2021-08-31,21:00:00,10,6,4,FMN GV 11 Ramsel
66,Bergstraat 71,2021-08-31,22:00:00,10,6,4,FMN GV 11 Ramsel
66,Bergstraat 71,2021-08-31,23:00:00,8,6,2,FMN GV 11 Ramsel
66,Bergstraat 71,2021-09-01,00:00:00,0,0,0,FMN GV 11 Ramsel
66,Bergstraat 71,2021-09-01,01:00:00,0,0,0,FMN GV 11 Ramsel
66,Bergstraat 71,2021-09-01,02:00:00,0,0,0,FMN GV 11 Ramsel
66,Bergstraat 71,2021-09-01,03:00:00,0,0,0,FMN GV 11 Ramsel
66,Bergstraat 71,2021-09-01,04:00:00,4,4,0,FMN GV 11 Ramsel
66,Bergstraat 71,2021-09-01,05:00:00,18,12,6,FMN GV 11 Ramsel
66,Bergstraat 71,2021-09-01,06:00:00,32,14,18,FMN GV 11 Ramsel
66,Bergstraat 71,2021-09-01,07:00:00,178,10,168,FMN GV 11 Ramsel
66,Bergstraat 71,2021-09-01,08:00:00,256,40,216,FMN GV 11 Ramsel
66,Bergstraat 71,2021-09-01,09:00:00,126,20,106,FMN GV 11 Ramsel
66,Bergstraat 71,2021-09-01,10:00:00,98,56,42,FMN GV 11 Ramsel
66,Bergstraat 71,2021-09-01,11:00:00,106,70,36,FMN GV 11 Ramsel
66,Bergstraat 71,2021-09-01,12:00:00,374,306,68,FMN GV 11 Ramsel
66,Bergstraat 71,2021-09-01,13:00:00,188,112,76,FMN GV 11 Ramsel
66,Bergstraat 71,2021-09-01,14:00:00,214,96,118,FMN GV 11 Ramsel
66,Bergstraat 71,2021-09-01,15:00:00,144,90,54,FMN GV 11 Ramsel
66,Bergstraat 71,2021-09-01,16:00:00,160,98,62,FMN GV 11 Ramsel
66,Bergstraat 71,2021-09-01,17:00:00,144,66,78,FMN GV 11 Ramsel
66,Bergstraat 71,2021-09-01,18:00:00,120,50,70,FMN GV 11 Ramsel
66,Bergstraat 71,2021-09-01,19:00:00,84,52,32,FMN GV 11 Ramsel
66,Bergstraat 71,2021-09-01,20:00:00,54,36,18,FMN GV 11 Ramsel
66,Bergstraat 71,2021-09-01,21:00:00,10,8,2,FMN GV 11 Ramsel
66,Bergstraat 71,2021-09-01,22:00:00,14,8,6,FMN GV 11 Ramsel
66,Bergstraat 71,2021-09-01,23:00:00,6,4,2,FMN GV 11 Ramsel
66,Bergstraat 71,2021-09-02,00:00:00,12,6,6,FMN GV 11 Ramsel
66,Bergstraat 71,2021-09-02,01:00:00,4,4,0,FMN GV 11 Ramsel
66,Bergstraat 71,2021-09-02,02:00:00,0,0,0,FMN GV 11 Ramsel
66,Bergstraat 71,2021-09-02,03:00:00,2,0,2,FMN GV 11 Ramsel
66,Bergstraat 71,2021-09-02,04:00:00,4,4,0,FMN GV 11 Ramsel
66,Bergstraat 71,2021-09-02,05:00:00,10,8,2,FMN GV 11 Ramsel
66,Bergstraat 71,2021-09-02,06:00:00,38,20,18,FMN GV 11 Ramsel
66,Bergstraat 71,2021-09-02,07:00:00,326,30,296,FMN GV 11 Ramsel
66,Bergstraat 71,2021-09-02,08:00:00,202,20,182,FMN GV 11 Ramsel
66,Bergstraat 71,2021-09-02,09:00:00,230,164,66,FMN GV 11 Ramsel
66,Bergstraat 71,2021-09-02,10:00:00,128,60,68,FMN GV 11 Ramsel
66,Bergstraat 71,2021-09-02,11:00:00,90,58,32,FMN GV 11 Ramsel
66,Bergstraat 71,2021-09-02,12:00:00,100,48,52,FMN GV 11 Ramsel
66,Bergstraat 71,2021-09-02,13:00:00,172,70,102,FMN GV 11 Ramsel
66,Bergstraat 71,2021-09-02,14:00:00,386,140,246,FMN GV 11 Ramsel
66,Bergstraat 71,2021-09-02,15:00:00,408,304,104,FMN GV 11 Ramsel
66,Bergstraat 71,2021-09-02,16:00:00,274,182,92,FMN GV 11 Ramsel
66,Bergstraat 71,2021-09-02,17:00:00,166,114,52,FMN GV 11 Ramsel
66,Bergstraat 71,2021-09-02,18:00:00,92,40,52,FMN GV 11 Ramsel
66,Bergstraat 71,2021-09-02,19:00:00,86,40,46,FMN GV 11 Ramsel
66,Bergstraat 71,2021-09-02,20:00:00,66,44,22,FMN GV 11 Ramsel
66,Bergstraat 71,2021-09-02,21:00:00,8,4,4,FMN GV 11 Ramsel
66,Bergstraat 71,2021-09-02,22:00:00,18,16,2,FMN GV 11 Ramsel
66,Bergstraat 71,2021-09-02,23:00:00,6,6,0,FMN GV 11 Ramsel
66,Bergstraat 71,2021-09-03,00:00:00,4,2,2,FMN GV 11 Ramsel
66,Bergstraat 71,2021-09-03,01:00:00,0,0,0,FMN GV 11 Ramsel
66,Bergstraat 71,2021-09-03,02:00:00,2,0,2,FMN GV 11 Ramsel
66,Bergstraat 71,2021-09-03,03:00:00,0,0,0,FMN GV 11 Ramsel
66,Bergstraat 71,2021-09-03,04:00:00,6,4,2,FMN GV 11 Ramsel
66,Bergstraat 71,2021-09-03,05:00:00,14,8,6,FMN GV 11 Ramsel
66,Bergstraat 71,2021-09-03,06:00:00,32,8,24,FMN GV 11 Ramsel
66,Bergstraat 71,2021-09-03,07:00:00,250,10,240,FMN GV 11 Ramsel
66,Bergstraat 71,2021-09-03,08:00:00,204,38,166,FMN GV 11 Ramsel
66,Bergstraat 71,2021-09-03,09:00:00,72,36,36,FMN GV 11 Ramsel
66,Bergstraat 71,2021-09-03,10:00:00,122,58,64,FMN GV 11 Ramsel
66,Bergstraat 71,2021-09-03,11:00:00,146,64,82,FMN GV 11 Ramsel
66,Bergstraat 71,2021-09-03,12:00:00,140,48,92,FMN GV 11 Ramsel
66,Bergstraat 71,2021-09-03,13:00:00,232,92,140,FMN GV 11 Ramsel
66,Bergstraat 71,2021-09-03,14:00:00,242,146,96,FMN GV 11 Ramsel
66,Bergstraat 71,2021-09-03,15:00:00,526,376,150,FMN GV 11 Ramsel
66,Bergstraat 71,2021-09-03,16:00:00,308,214,94,FMN GV 11 Ramsel
66,Bergstraat 71,2021-09-03,17:00:00,228,110,118,FMN GV 11 Ramsel
66,Bergstraat 71,2021-09-03,18:00:00,112,62,50,FMN GV 11 Ramsel
66,Bergstraat 71,2021-09-03,19:00:00,100,34,66,FMN GV 11 Ramsel
66,Bergstraat 71,2021-09-03,20:00:00,64,28,36,FMN GV 11 Ramsel
66,Bergstraat 71,2021-09-03,21:00:00,34,28,6,FMN GV 11 Ramsel
66,Bergstraat 71,2021-09-03,22:00:00,22,18,4,FMN GV 11 Ramsel
66,Bergstraat 71,2021-09-03,23:00:00,28,22,6,FMN GV 11 Ramsel
66,Bergstraat 71,2021-09-04,00:00:00,16,14,2,FMN GV 11 Ramsel
66,Bergstraat 71,2021-09-04,01:00:00,6,2,4,FMN GV 11 Ramsel
66,Bergstraat 71,2021-09-04,02:00:00,6,6,0,FMN GV 11 Ramsel
66,Bergstraat 71,2021-09-04,03:00:00,2,0,2,FMN GV 11 Ramsel
66,Bergstraat 71,2021-09-04,04:00:00,0,0,0,FMN GV 11 Ramsel
66,Bergstraat 71,2021-09-04,05:00:00,2,2,0,FMN GV 11 Ramsel
66,Bergstraat 71,2021-09-04,06:00:00,4,2,2,FMN GV 11 Ramsel
66,Bergstraat 71,2021-09-04,07:00:00,10,4,6,FMN GV 11 Ramsel
66,Bergstraat 71,2021-09-04,08:00:00,52,18,34,FMN GV 11 Ramsel
66,Bergstraat 71,2021-09-04,09:00:00,98,14,84,FMN GV 11 Ramsel
66,Bergstraat 71,2021-09-04,10:00:00,118,46,72,FMN GV 11 Ramsel
66,Bergstraat 71,2021-09-04,11:00:00,80,48,32,FMN GV 11 Ramsel
66,Bergstraat 71,2021-09-04,12:00:00,108,48,60,FMN GV 11 Ramsel
66,Bergstraat 71,2021-09-04,13:00:00,156,70,86,FMN GV 11 Ramsel
66,Bergstraat 71,2021-09-04,14:00:00,230,112,118,FMN GV 11 Ramsel
66,Bergstraat 71,2021-09-04,15:00:00,214,116,98,FMN GV 11 Ramsel
66,Bergstraat 71,2021-09-04,16:00:00,228,132,96,FMN GV 11 Ramsel
66,Bergstraat 71,2021-09-04,17:00:00,128,68,60,FMN GV 11 Ramsel
66,Bergstraat 71,2021-09-04,18:00:00,74,38,36,FMN GV 11 Ramsel
66,Bergstraat 71,2021-09-04,19:00:00,100,44,56,FMN GV 11 Ramsel
66,Bergstraat 71,2021-09-04,20:00:00,36,18,18,FMN GV 11 Ramsel
66,Bergstraat 71,2021-09-04,21:00:00,36,24,12,FMN GV 11 Ramsel
66,Bergstraat 71,2021-09-04,22:00:00,28,22,6,FMN GV 11 Ramsel
66,Bergstraat 71,2021-09-04,23:00:00,2,2,0,FMN GV 11 Ramsel
66,Bergstraat 71,2021-09-05,00:00:00,16,12,4,FMN GV 11 Ramsel
66,Bergstraat 71,2021-09-05,01:00:00,12,4,8,FMN GV 11 Ramsel
66,Bergstraat 71,2021-09-05,02:00:00,14,14,0,FMN GV 11 Ramsel
66,Bergstraat 71,2021-09-05,03:00:00,4,2,2,FMN GV 11 Ramsel
66,Bergstraat 71,2021-09-05,04:00:00,0,0,0,FMN GV 11 Ramsel
66,Bergstraat 71,2021-09-05,05:00:00,0,0,0,FMN GV 11 Ramsel
66,Bergstraat 71,2021-09-05,06:00:00,10,6,4,FMN GV 11 Ramsel
66,Bergstraat 71,2021-09-05,07:00:00,24,6,18,FMN GV 11 Ramsel
66,Bergstraat 71,2021-09-05,08:00:00,74,22,52,FMN GV 11 Ramsel
66,Bergstraat 71,2021-09-05,09:00:00,186,100,86,FMN GV 11 Ramsel
66,Bergstraat 71,2021-09-05,10:00:00,296,176,120,FMN GV 11 Ramsel
66,Bergstraat 71,2021-09-05,11:00:00,342,228,114,FMN GV 11 Ramsel
66,Bergstraat 71,2021-09-05,12:00:00,272,164,108,FMN GV 11 Ramsel
66,Bergstraat 71,2021-09-05,13:00:00,434,230,204,FMN GV 11 Ramsel
66,Bergstraat 71,2021-09-05,14:00:00,592,340,252,FMN GV 11 Ramsel
66,Bergstraat 71,2021-09-05,15:00:00,402,224,178,FMN GV 11 Ramsel
66,Bergstraat 71,2021-09-05,16:00:00,414,234,180,FMN GV 11 Ramsel
66,Bergstraat 71,2021-09-05,17:00:00,272,182,90,FMN GV 11 Ramsel
66,Bergstraat 71,2021-09-05,18:00:00,234,94,140,FMN GV 11 Ramsel
66,Bergstraat 71,2021-09-05,19:00:00,108,54,54,FMN GV 11 Ramsel
66,Bergstraat 71,2021-09-05,20:00:00,78,32,46,FMN GV 11 Ramsel
66,Bergstraat 71,2021-09-05,21:00:00,38,28,10,FMN GV 11 Ramsel
66,Bergstraat 71,2021-09-05,22:00:00,6,6,0,FMN GV 11 Ramsel
66,Bergstraat 71,2021-09-05,23:00:00,0,0,0,FMN GV 11 Ramsel
66,Bergstraat 71,2021-09-06,00:00:00,2,2,0,FMN GV 11 Ramsel
66,Bergstraat 71,2021-09-06,01:00:00,0,0,0,FMN GV 11 Ramsel
66,Bergstraat 71,2021-09-06,02:00:00,0,0,0,FMN GV 11 Ramsel
66,Bergstraat 71,2021-09-06,03:00:00,0,0,0,FMN GV 11 Ramsel
66,Bergstraat 71,2021-09-06,04:00:00,4,2,2,FMN GV 11 Ramsel
66,Bergstraat 71,2021-09-06,05:00:00,16,10,6,FMN GV 11 Ramsel
66,Bergstraat 71,2021-09-06,06:00:00,38,14,24,FMN GV 11 Ramsel
66,Bergstraat 71,2021-09-06,07:00:00,298,22,276,FMN GV 11 Ramsel
66,Bergstraat 71,2021-09-06,08:00:00,220,34,186,FMN GV 11 Ramsel
66,Bergstraat 71,2021-09-06,09:00:00,78,42,36,FMN GV 11 Ramsel
66,Bergstraat 71,2021-09-06,10:00:00,82,46,36,FMN GV 11 Ramsel
66,Bergstraat 71,2021-09-06,11:00:00,88,50,38,FMN GV 11 Ramsel
66,Bergstraat 71,2021-09-06,12:00:00,110,60,50,FMN GV 11 Ramsel
66,Bergstraat 71,2021-09-06,13:00:00,258,158,100,FMN GV 11 Ramsel
66,Bergstraat 71,2021-09-06,14:00:00,292,162,130,FMN GV 11 Ramsel
66,Bergstraat 71,2021-09-06,15:00:00,440,332,108,FMN GV 11 Ramsel
66,Bergstraat 71,2021-09-06,16:00:00,316,220,96,FMN GV 11 Ramsel
66,Bergstraat 71,2021-09-06,17:00:00,162,108,54,FMN GV 11 Ramsel
66,Bergstraat 71,2021-09-06,18:00:00,122,76,46,FMN GV 11 Ramsel
66,Bergstraat 71,2021-09-06,19:00:00,88,44,44,FMN GV 11 Ramsel
66,Bergstraat 71,2021-09-06,20:00:00,62,36,26,FMN GV 11 Ramsel
66,Bergstraat 71,2021-09-06,21:00:00,20,12,8,FMN GV 11 Ramsel
66,Bergstraat 71,2021-09-06,22:00:00,18,8,10,FMN GV 11 Ramsel
66,Bergstraat 71,2021-09-06,23:00:00,4,4,0,FMN GV 11 Ramsel
66,Bergstraat 71,2021-09-07,00:00:00,2,2,0,FMN GV 11 Ramsel
66,Bergstraat 71,2021-09-07,01:00:00,0,0,0,FMN GV 11 Ramsel
66,Bergstraat 71,2021-09-07,02:00:00,0,0,0,FMN GV 11 Ramsel
66,Bergstraat 71,2021-09-07,03:00:00,0,0,0,FMN GV 11 Ramsel
66,Bergstraat 71,2021-09-07,04:00:00,2,2,0,FMN GV 11 Ramsel
66,Bergstraat 71,2021-09-07,05:00:00,14,6,8,FMN GV 11 Ramsel
66,Bergstraat 71,2021-09-07,06:00:00,52,24,28,FMN GV 11 Ramsel
66,Bergstraat 71,2021-09-07,07:00:00,318,22,296,FMN GV 11 Ramsel
66,Bergstraat 71,2021-09-07,08:00:00,214,34,180,FMN GV 11 Ramsel
66,Bergstraat 71,2021-09-07,09:00:00,104,50,54,FMN GV 11 Ramsel
66,Bergstraat 71,2021-09-07,10:00:00,140,50,90,FMN GV 11 Ramsel
66,Bergstraat 71,2021-09-07,11:00:00,112,44,68,FMN GV 11 Ramsel
66,Bergstraat 71,2021-09-07,12:00:00,370,114,256,FMN GV 11 Ramsel
66,Bergstraat 71,2021-09-07,13:00:00,286,100,186,FMN GV 11 Ramsel
66,Bergstraat 71,2021-09-07,14:00:00,402,182,220,FMN GV 11 Ramsel
66,Bergstraat 71,2021-09-07,15:00:00,530,348,182,FMN GV 11 Ramsel
66,Bergstraat 71,2021-09-07,16:00:00,366,270,96,FMN GV 11 Ramsel
66,Bergstraat 71,2021-09-07,17:00:00,178,88,90,FMN GV 11 Ramsel
66,Bergstraat 71,2021-09-07,18:00:00,142,64,78,FMN GV 11 Ramsel
66,Bergstraat 71,2021-09-07,19:00:00,100,50,50,FMN GV 11 Ramsel
66,Bergstraat 71,2021-09-07,20:00:00,92,68,24,FMN GV 11 Ramsel
66,Bergstraat 71,2021-09-07,21:00:00,12,8,4,FMN GV 11 Ramsel
66,Bergstraat 71,2021-09-07,22:00:00,16,8,8,FMN GV 11 Ramsel
66,Bergstraat 71,2021-09-07,23:00:00,14,12,2,FMN GV 11 Ramsel
66,Bergstraat 71,2021-09-08,00:00:00,8,4,4,FMN GV 11 Ramsel
66,Bergstraat 71,2021-09-08,01:00:00,0,0,0,FMN GV 11 Ramsel
66,Bergstraat 71,2021-09-08,02:00:00,2,0,2,FMN GV 11 Ramsel
66,Bergstraat 71,2021-09-08,03:00:00,0,0,0,FMN GV 11 Ramsel
66,Bergstraat 71,2021-09-08,04:00:00,2,2,0,FMN GV 11 Ramsel
66,Bergstraat 71,2021-09-08,05:00:00,10,6,4,FMN GV 11 Ramsel
66,Bergstraat 71,2021-09-08,06:00:00,52,18,34,FMN GV 11 Ramsel
66,Bergstraat 71,2021-09-08,07:00:00,312,32,280,FMN GV 11 Ramsel
66,Bergstraat 71,2021-09-08,08:00:00,218,44,174,FMN GV 11 Ramsel
66,Bergstraat 71,2021-09-08,09:00:00,62,22,40,FMN GV 11 Ramsel
66,Bergstraat 71,2021-09-08,10:00:00,100,44,56,FMN GV 11 Ramsel
66,Bergstraat 71,2021-09-08,11:00:00,170,82,88,FMN GV 11 Ramsel
66,Bergstraat 71,2021-09-08,12:00:00,486,366,120,FMN GV 11 Ramsel
66,Bergstraat 71,2021-09-08,13:00:00,308,168,140,FMN GV 11 Ramsel
66,Bergstraat 71,2021-09-08,14:00:00,308,192,116,FMN GV 11 Ramsel
66,Bergstraat 71,2021-09-08,15:00:00,232,128,104,FMN GV 11 Ramsel
66,Bergstraat 71,2021-09-08,16:00:00,272,152,120,FMN GV 11 Ramsel
66,Bergstraat 71,2021-09-08,17:00:00,192,72,120,FMN GV 11 Ramsel
66,Bergstraat 71,2021-09-08,18:00:00,166,82,84,FMN GV 11 Ramsel
66,Bergstraat 71,2021-09-08,19:00:00,148,96,52,FMN GV 11 Ramsel
66,Bergstraat 71,2021-09-08,20:00:00,60,38,22,FMN GV 11 Ramsel
66,Bergstraat 71,2021-09-08,21:00:00,40,28,12,FMN GV 11 Ramsel
66,Bergstraat 71,2021-09-08,22:00:00,22,10,12,FMN GV 11 Ramsel
66,Bergstraat 71,2021-09-08,23:00:00,4,0,4,FMN GV 11 Ramsel
66,Bergstraat 71,2021-09-09,00:00:00,2,2,0,FMN GV 11 Ramsel
66,Bergstraat 71,2021-09-09,01:00:00,0,0,0,FMN GV 11 Ramsel
66,Bergstraat 71,2021-09-09,02:00:00,0,0,0,FMN GV 11 Ramsel
66,Bergstraat 71,2021-09-09,03:00:00,2,0,2,FMN GV 11 Ramsel
66,Bergstraat 71,2021-09-09,04:00:00,2,2,0,FMN GV 11 Ramsel
66,Bergstraat 71,2021-09-09,05:00:00,8,6,2,FMN GV 11 Ramsel
66,Bergstraat 71,2021-09-09,06:00:00,36,12,24,FMN GV 11 Ramsel
66,Bergstraat 71,2021-09-09,07:00:00,252,10,242,FMN GV 11 Ramsel
66,Bergstraat 71,2021-09-09,08:00:00,198,26,172,FMN GV 11 Ramsel
66,Bergstraat 71,2021-09-09,09:00:00,106,30,76,FMN GV 11 Ramsel
66,Bergstraat 71,2021-09-09,10:00:00,92,36,56,FMN GV 11 Ramsel
66,Bergstraat 71,2021-09-09,11:00:00,90,56,34,FMN GV 11 Ramsel
66,Bergstraat 71,2021-09-09,12:00:00,132,74,58,FMN GV 11 Ramsel
66,Bergstraat 71,2021-09-09,13:00:00,136,74,62,FMN GV 11 Ramsel
66,Bergstraat 71,2021-09-09,14:00:00,134,94,40,FMN GV 11 Ramsel
66,Bergstraat 71,2021-09-09,15:00:00,294,244,50,FMN GV 11 Ramsel
66,Bergstraat 71,2021-09-09,16:00:00,216,168,48,FMN GV 11 Ramsel
66,Bergstraat 71,2021-09-09,17:00:00,142,80,62,FMN GV 11 Ramsel
66,Bergstraat 71,2021-09-09,18:00:00,84,60,24,FMN GV 11 Ramsel
66,Bergstraat 71,2021-09-09,19:00:00,56,34,22,FMN GV 11 Ramsel
66,Bergstraat 71,2021-09-09,20:00:00,38,18,20,FMN GV 11 Ramsel
66,Bergstraat 71,2021-09-09,21:00:00,26,16,10,FMN GV 11 Ramsel
66,Bergstraat 71,2021-09-09,22:00:00,10,4,6,FMN GV 11 Ramsel
66,Bergstraat 71,2021-09-09,23:00:00,10,6,4,FMN GV 11 Ramsel
66,Bergstraat 71,2021-09-10,00:00:00,2,2,0,FMN GV 11 Ramsel
66,Bergstraat 71,2021-09-10,01:00:00,0,0,0,FMN GV 11 Ramsel
66,Bergstraat 71,2021-09-10,02:00:00,0,0,0,FMN GV 11 Ramsel
66,Bergstraat 71,2021-09-10,03:00:00,0,0,0,FMN GV 11 Ramsel
66,Bergstraat 71,2021-09-10,04:00:00,2,2,0,FMN GV 11 Ramsel
66,Bergstraat 71,2021-09-10,05:00:00,10,6,4,FMN GV 11 Ramsel
66,Bergstraat 71,2021-09-10,06:00:00,34,10,24,FMN GV 11 Ramsel
66,Bergstraat 71,2021-09-10,07:00:00,256,18,238,FMN GV 11 Ramsel
66,Bergstraat 71,2021-09-10,08:00:00,176,22,154,FMN GV 11 Ramsel
66,Bergstraat 71,2021-09-10,09:00:00,122,48,74,FMN GV 11 Ramsel
66,Bergstraat 71,2021-09-10,10:00:00,64,42,22,FMN GV 11 Ramsel
66,Bergstraat 71,2021-09-10,11:00:00,112,38,74,FMN GV 11 Ramsel
66,Bergstraat 71,2021-09-10,12:00:00,48,34,14,FMN GV 11 Ramsel
66,Bergstraat 71,2021-09-10,13:00:00,26,12,14,FMN GV 11 Ramsel
66,Bergstraat 71,2021-09-10,14:00:00,38,34,4,FMN GV 11 Ramsel
66,Bergstraat 71,2021-09-10,15:00:00,250,214,36,FMN GV 11 Ramsel
66,Bergstraat 71,2021-09-10,16:00:00,158,118,40,FMN GV 11 Ramsel
66,Bergstraat 71,2021-09-10,17:00:00,66,48,18,FMN GV 11 Ramsel
66,Bergstraat 71,2021-09-10,18:00:00,88,40,48,FMN GV 11 Ramsel
66,Bergstraat 71,2021-09-10,19:00:00,68,44,24,FMN GV 11 Ramsel
66,Bergstraat 71,2021-09-10,20:00:00,32,14,18,FMN GV 11 Ramsel
66,Bergstraat 71,2021-09-10,21:00:00,6,4,2,FMN GV 11 Ramsel
66,Bergstraat 71,2021-09-10,22:00:00,8,6,2,FMN GV 11 Ramsel
66,Bergstraat 71,2021-09-10,23:00:00,8,4,4,FMN GV 11 Ramsel
66,Bergstraat 71,2021-09-11,00:00:00,0,0,0,FMN GV 11 Ramsel
66,Bergstraat 71,2021-09-11,01:00:00,8,4,4,FMN GV 11 Ramsel
66,Bergstraat 71,2021-09-11,02:00:00,10,4,6,FMN GV 11 Ramsel
66,Bergstraat 71,2021-09-11,03:00:00,6,2,4,FMN GV 11 Ramsel
66,Bergstraat 71,2021-09-11,04:00:00,4,0,4,FMN GV 11 Ramsel
66,Bergstraat 71,2021-09-11,05:00:00,4,4,0,FMN GV 11 Ramsel
66,Bergstraat 71,2021-09-11,06:00:00,4,4,0,FMN GV 11 Ramsel
66,Bergstraat 71,2021-09-11,07:00:00,18,8,10,FMN GV 11 Ramsel
66,Bergstraat 71,2021-09-11,08:00:00,34,12,22,FMN GV 11 Ramsel
66,Bergstraat 71,2021-09-11,09:00:00,86,36,50,FMN GV 11 Ramsel
66,Bergstraat 71,2021-09-11,10:00:00,104,62,42,FMN GV 11 Ramsel
66,Bergstraat 71,2021-09-11,11:00:00,136,62,74,FMN GV 11 Ramsel
66,Bergstraat 71,2021-09-11,12:00:00,122,58,64,FMN GV 11 Ramsel
66,Bergstraat 71,2021-09-11,13:00:00,88,46,42,FMN GV 11 Ramsel
66,Bergstraat 71,2021-09-11,14:00:00,82,42,40,FMN GV 11 Ramsel
66,Bergstraat 71,2021-09-11,15:00:00,70,28,42,FMN GV 11 Ramsel
66,Bergstraat 71,2021-09-11,16:00:00,92,50,42,FMN GV 11 Ramsel
66,Bergstraat 71,2021-09-11,17:00:00,58,38,20,FMN GV 11 Ramsel
66,Bergstraat 71,2021-09-11,18:00:00,30,8,22,FMN GV 11 Ramsel
66,Bergstraat 71,2021-09-11,19:00:00,38,18,20,FMN GV 11 Ramsel
66,Bergstraat 71,2021-09-11,20:00:00,40,22,18,FMN GV 11 Ramsel
66,Bergstraat 71,2021-09-11,21:00:00,10,6,4,FMN GV 11 Ramsel
66,Bergstraat 71,2021-09-11,22:00:00,6,2,4,FMN GV 11 Ramsel
66,Bergstraat 71,2021-09-11,23:00:00,2,2,0,FMN GV 11 Ramsel
66,Bergstraat 71,2021-09-12,00:00:00,8,8,0,FMN GV 11 Ramsel
66,Bergstraat 71,2021-09-12,01:00:00,4,0,4,FMN GV 11 Ramsel
66,Bergstraat 71,2021-09-12,02:00:00,0,0,0,FMN GV 11 Ramsel
66,Bergstraat 71,2021-09-12,03:00:00,4,2,2,FMN GV 11 Ramsel
66,Bergstraat 71,2021-09-12,04:00:00,2,0,2,FMN GV 11 Ramsel
66,Bergstraat 71,2021-09-12,05:00:00,0,0,0,FMN GV 11 Ramsel
66,Bergstraat 71,2021-09-12,06:00:00,4,4,0,FMN GV 11 Ramsel
66,Bergstraat 71,2021-09-12,07:00:00,16,4,12,FMN GV 11 Ramsel
66,Bergstraat 71,2021-09-12,08:00:00,102,28,74,FMN GV 11 Ramsel
66,Bergstraat 71,2021-09-12,09:00:00,160,60,100,FMN GV 11 Ramsel
66,Bergstraat 71,2021-09-12,10:00:00,222,126,96,FMN GV 11 Ramsel
66,Bergstraat 71,2021-09-12,11:00:00,200,126,74,FMN GV 11 Ramsel
66,Bergstraat 71,2021-09-12,12:00:00,176,98,78,FMN GV 11 Ramsel
66,Bergstraat 71,2021-09-12,13:00:00,226,116,110,FMN GV 11 Ramsel
66,Bergstraat 71,2021-09-12,14:00:00,248,124,124,FMN GV 11 Ramsel
66,Bergstraat 71,2021-09-12,15:00:00,214,108,106,FMN GV 11 Ramsel
66,Bergstraat 71,2021-09-12,16:00:00,202,90,112,FMN GV 11 Ramsel
66,Bergstraat 71,2021-09-12,17:00:00,156,88,68,FMN GV 11 Ramsel
66,Bergstraat 71,2021-09-12,18:00:00,58,32,26,FMN GV 11 Ramsel
66,Bergstraat 71,2021-09-12,19:00:00,60,34,26,FMN GV 11 Ramsel
66,Bergstraat 71,2021-09-12,20:00:00,42,20,22,FMN GV 11 Ramsel
66,Bergstraat 71,2021-09-12,21:00:00,6,4,2,FMN GV 11 Ramsel
66,Bergstraat 71,2021-09-12,22:00:00,6,6,0,FMN GV 11 Ramsel
66,Bergstraat 71,2021-09-12,23:00:00,4,4,0,FMN GV 11 Ramsel
66,Bergstraat 71,2021-09-13,00:00:00,0,0,0,FMN GV 11 Ramsel
66,Bergstraat 71,2021-09-13,01:00:00,0,0,0,FMN GV 11 Ramsel
66,Bergstraat 71,2021-09-13,02:00:00,0,0,0,FMN GV 11 Ramsel
66,Bergstraat 71,2021-09-13,03:00:00,0,0,0,FMN GV 11 Ramsel
66,Bergstraat 71,2021-09-13,04:00:00,2,2,0,FMN GV 11 Ramsel
66,Bergstraat 71,2021-09-13,05:00:00,12,8,4,FMN GV 11 Ramsel
66,Bergstraat 71,2021-09-13,06:00:00,38,10,28,FMN GV 11 Ramsel
66,Bergstraat 71,2021-09-13,07:00:00,278,14,264,FMN GV 11 Ramsel
66,Bergstraat 71,2021-09-13,08:00:00,210,42,168,FMN GV 11 Ramsel
66,Bergstraat 71,2021-09-13,09:00:00,56,34,22,FMN GV 11 Ramsel
66,Bergstraat 71,2021-09-13,10:00:00,66,38,28,FMN GV 11 Ramsel
66,Bergstraat 71,2021-09-13,11:00:00,80,38,42,FMN GV 11 Ramsel
66,Bergstraat 71,2021-09-13,12:00:00,134,84,50,FMN GV 11 Ramsel
66,Bergstraat 71,2021-09-13,13:00:00,192,80,112,FMN GV 11 Ramsel
66,Bergstraat 71,2021-09-13,14:00:00,236,106,130,FMN GV 11 Ramsel
66,Bergstraat 71,2021-09-13,15:00:00,410,306,104,FMN GV 11 Ramsel
66,Bergstraat 71,2021-09-13,16:00:00,310,214,96,FMN GV 11 Ramsel
66,Bergstraat 71,2021-09-13,17:00:00,170,88,82,FMN GV 11 Ramsel
66,Bergstraat 71,2021-09-13,18:00:00,122,74,48,FMN GV 11 Ramsel
66,Bergstraat 71,2021-09-13,19:00:00,70,38,32,FMN GV 11 Ramsel
66,Bergstraat 71,2021-09-13,20:00:00,38,20,18,FMN GV 11 Ramsel
66,Bergstraat 71,2021-09-13,21:00:00,28,22,6,FMN GV 11 Ramsel
66,Bergstraat 71,2021-09-13,22:00:00,18,14,4,FMN GV 11 Ramsel
66,Bergstraat 71,2021-09-13,23:00:00,0,0,0,FMN GV 11 Ramsel
66,Bergstraat 71,2021-09-14,00:00:00,0,0,0,FMN GV 11 Ramsel
66,Bergstraat 71,2021-09-14,01:00:00,0,0,0,FMN GV 11 Ramsel
66,Bergstraat 71,2021-09-14,02:00:00,0,0,0,FMN GV 11 Ramsel
66,Bergstraat 71,2021-09-14,03:00:00,0,0,0,FMN GV 11 Ramsel
66,Bergstraat 71,2021-09-14,04:00:00,4,4,0,FMN GV 11 Ramsel
66,Bergstraat 71,2021-09-14,05:00:00,12,8,4,FMN GV 11 Ramsel
66,Bergstraat 71,2021-09-14,06:00:00,36,24,12,FMN GV 11 Ramsel
66,Bergstraat 71,2021-09-14,07:00:00,268,18,250,FMN GV 11 Ramsel
66,Bergstraat 71,2021-09-14,08:00:00,182,26,156,FMN GV 11 Ramsel
66,Bergstraat 71,2021-09-14,09:00:00,68,22,46,FMN GV 11 Ramsel
66,Bergstraat 71,2021-09-14,10:00:00,122,42,80,FMN GV 11 Ramsel
66,Bergstraat 71,2021-09-14,11:00:00,88,48,40,FMN GV 11 Ramsel
66,Bergstraat 71,2021-09-14,12:00:00,106,48,58,FMN GV 11 Ramsel
66,Bergstraat 71,2021-09-14,13:00:00,202,102,100,FMN GV 11 Ramsel
66,Bergstraat 71,2021-09-14,14:00:00,180,96,84,FMN GV 11 Ramsel
66,Bergstraat 71,2021-09-14,15:00:00,266,228,38,FMN GV 11 Ramsel
66,Bergstraat 71,2021-09-14,16:00:00,210,160,50,FMN GV 11 Ramsel
66,Bergstraat 71,2021-09-14,17:00:00,146,70,76,FMN GV 11 Ramsel
66,Bergstraat 71,2021-09-14,18:00:00,66,28,38,FMN GV 11 Ramsel
66,Bergstraat 71,2021-09-14,19:00:00,42,20,22,FMN GV 11 Ramsel
66,Bergstraat 71,2021-09-14,20:00:00,52,40,12,FMN GV 11 Ramsel
66,Bergstraat 71,2021-09-14,21:00:00,22,20,2,FMN GV 11 Ramsel
66,Bergstraat 71,2021-09-14,22:00:00,10,8,2,FMN GV 11 Ramsel
66,Bergstraat 71,2021-09-14,23:00:00,6,2,4,FMN GV 11 Ramsel
66,Bergstraat 71,2021-09-15,00:00:00,2,2,0,FMN GV 11 Ramsel
66,Bergstraat 71,2021-09-15,01:00:00,0,0,0,FMN GV 11 Ramsel
66,Bergstraat 71,2021-09-15,02:00:00,4,4,0,FMN GV 11 Ramsel
66,Bergstraat 71,2021-09-15,03:00:00,0,0,0,FMN GV 11 Ramsel
66,Bergstraat 71,2021-09-15,04:00:00,4,4,0,FMN GV 11 Ramsel
66,Bergstraat 71,2021-09-15,05:00:00,8,8,0,FMN GV 11 Ramsel
66,Bergstraat 71,2021-09-15,06:00:00,24,8,16,FMN GV 11 Ramsel
66,Bergstraat 71,2021-09-15,07:00:00,98,10,88,FMN GV 11 Ramsel
66,Bergstraat 71,2021-09-15,08:00:00,80,18,62,FMN GV 11 Ramsel
66,Bergstraat 71,2021-09-15,09:00:00,10,4,6,FMN GV 11 Ramsel
66,Bergstraat 71,2021-09-15,10:00:00,12,6,6,FMN GV 11 Ramsel
66,Bergstraat 71,2021-09-15,11:00:00,42,22,20,FMN GV 11 Ramsel
66,Bergstraat 71,2021-09-15,12:00:00,146,106,40,FMN GV 11 Ramsel
66,Bergstraat 71,2021-09-15,13:00:00,136,58,78,FMN GV 11 Ramsel
66,Bergstraat 71,2021-09-15,14:00:00,140,52,88,FMN GV 11 Ramsel
66,Bergstraat 71,2021-09-15,15:00:00,112,56,56,FMN GV 11 Ramsel
66,Bergstraat 71,2021-09-15,16:00:00,140,82,58,FMN GV 11 Ramsel
66,Bergstraat 71,2021-09-15,17:00:00,92,56,36,FMN GV 11 Ramsel
66,Bergstraat 71,2021-09-15,18:00:00,84,46,38,FMN GV 11 Ramsel
66,Bergstraat 71,2021-09-15,19:00:00,100,76,24,FMN GV 11 Ramsel
66,Bergstraat 71,2021-09-15,20:00:00,22,14,8,FMN GV 11 Ramsel
66,Bergstraat 71,2021-09-15,21:00:00,8,4,4,FMN GV 11 Ramsel
66,Bergstraat 71,2021-09-15,22:00:00,14,10,4,FMN GV 11 Ramsel
66,Bergstraat 71,2021-09-15,23:00:00,8,6,2,FMN GV 11 Ramsel
66,Bergstraat 71,2021-09-16,00:00:00,0,0,0,FMN GV 11 Ramsel
66,Bergstraat 71,2021-09-16,01:00:00,8,2,6,FMN GV 11 Ramsel
66,Bergstraat 71,2021-09-16,02:00:00,0,0,0,FMN GV 11 Ramsel
66,Bergstraat 71,2021-09-16,03:00:00,0,0,0,FMN GV 11 Ramsel
66,Bergstraat 71,2021-09-16,04:00:00,4,4,0,FMN GV 11 Ramsel
66,Bergstraat 71,2021-09-16,05:00:00,10,4,6,FMN GV 11 Ramsel
66,Bergstraat 71,2021-09-16,06:00:00,28,16,12,FMN GV 11 Ramsel
66,Bergstraat 71,2021-09-16,07:00:00,152,22,130,FMN GV 11 Ramsel
66,Bergstraat 71,2021-09-16,08:00:00,144,28,116,FMN GV 11 Ramsel
66,Bergstraat 71,2021-09-16,09:00:00,50,16,34,FMN GV 11 Ramsel
66,Bergstraat 71,2021-09-16,10:00:00,114,38,76,FMN GV 11 Ramsel
66,Bergstraat 71,2021-09-16,11:00:00,94,52,42,FMN GV 11 Ramsel
66,Bergstraat 71,2021-09-16,12:00:00,136,62,74,FMN GV 11 Ramsel
66,Bergstraat 71,2021-09-16,13:00:00,196,104,92,FMN GV 11 Ramsel
66,Bergstraat 71,2021-09-16,14:00:00,202,90,112,FMN GV 11 Ramsel
66,Bergstraat 71,2021-09-16,15:00:00,296,214,82,FMN GV 11 Ramsel
66,Bergstraat 71,2021-09-16,16:00:00,206,156,50,FMN GV 11 Ramsel
66,Bergstraat 71,2021-09-16,17:00:00,154,86,68,FMN GV 11 Ramsel
66,Bergstraat 71,2021-09-16,18:00:00,116,64,52,FMN GV 11 Ramsel
66,Bergstraat 71,2021-09-16,19:00:00,98,50,48,FMN GV 11 Ramsel
66,Bergstraat 71,2021-09-16,20:00:00,44,18,26,FMN GV 11 Ramsel
66,Bergstraat 71,2021-09-16,21:00:00,16,8,8,FMN GV 11 Ramsel
66,Bergstraat 71,2021-09-16,22:00:00,28,26,2,FMN GV 11 Ramsel
66,Bergstraat 71,2021-09-16,23:00:00,8,6,2,FMN GV 11 Ramsel
66,Bergstraat 71,2021-09-17,00:00:00,2,2,0,FMN GV 11 Ramsel
66,Bergstraat 71,2021-09-17,01:00:00,10,10,0,FMN GV 11 Ramsel
66,Bergstraat 71,2021-09-17,02:00:00,0,0,0,FMN GV 11 Ramsel
66,Bergstraat 71,2021-09-17,03:00:00,0,0,0,FMN GV 11 Ramsel
66,Bergstraat 71,2021-09-17,04:00:00,8,6,2,FMN GV 11 Ramsel
66,Bergstraat 71,2021-09-17,05:00:00,14,8,6,FMN GV 11 Ramsel
66,Bergstraat 71,2021-09-17,06:00:00,28,14,14,FMN GV 11 Ramsel
66,Bergstraat 71,2021-09-17,07:00:00,270,18,252,FMN GV 11 Ramsel
66,Bergstraat 71,2021-09-17,08:00:00,198,30,168,FMN GV 11 Ramsel
66,Bergstraat 71,2021-09-17,09:00:00,82,30,52,FMN GV 11 Ramsel
66,Bergstraat 71,2021-09-17,10:00:00,100,36,64,FMN GV 11 Ramsel
66,Bergstraat 71,2021-09-17,11:00:00,90,44,46,FMN GV 11 Ramsel
66,Bergstraat 71,2021-09-17,12:00:00,134,60,74,FMN GV 11 Ramsel
66,Bergstraat 71,2021-09-17,13:00:00,178,82,96,FMN GV 11 Ramsel
66,Bergstraat 71,2021-09-17,14:00:00,308,148,160,FMN GV 11 Ramsel
66,Bergstraat 71,2021-09-17,15:00:00,406,288,118,FMN GV 11 Ramsel
66,Bergstraat 71,2021-09-17,16:00:00,286,196,90,FMN GV 11 Ramsel
66,Bergstraat 71,2021-09-17,17:00:00,204,94,110,FMN GV 11 Ramsel
66,Bergstraat 71,2021-09-17,18:00:00,106,50,56,FMN GV 11 Ramsel
66,Bergstraat 71,2021-09-17,19:00:00,76,36,40,FMN GV 11 Ramsel
66,Bergstraat 71,2021-09-17,20:00:00,66,42,24,FMN GV 11 Ramsel
66,Bergstraat 71,2021-09-17,21:00:00,24,8,16,FMN GV 11 Ramsel
66,Bergstraat 71,2021-09-17,22:00:00,16,8,8,FMN GV 11 Ramsel
66,Bergstraat 71,2021-09-17,23:00:00,8,2,6,FMN GV 11 Ramsel
66,Bergstraat 71,2021-09-18,00:00:00,4,2,2,FMN GV 11 Ramsel
66,Bergstraat 71,2021-09-18,01:00:00,12,12,0,FMN GV 11 Ramsel
66,Bergstraat 71,2021-09-18,02:00:00,20,12,8,FMN GV 11 Ramsel
66,Bergstraat 71,2021-09-18,03:00:00,2,2,0,FMN GV 11 Ramsel
66,Bergstraat 71,2021-09-18,04:00:00,2,2,0,FMN GV 11 Ramsel
66,Bergstraat 71,2021-09-18,05:00:00,4,2,2,FMN GV 11 Ramsel
66,Bergstraat 71,2021-09-18,06:00:00,14,6,8,FMN GV 11 Ramsel
66,Bergstraat 71,2021-09-18,07:00:00,12,6,6,FMN GV 11 Ramsel
66,Bergstraat 71,2021-09-18,08:00:00,60,22,38,FMN GV 11 Ramsel
66,Bergstraat 71,2021-09-18,09:00:00,84,28,56,FMN GV 11 Ramsel
66,Bergstraat 71,2021-09-18,10:00:00,118,42,76,FMN GV 11 Ramsel
66,Bergstraat 71,2021-09-18,11:00:00,146,74,72,FMN GV 11 Ramsel
66,Bergstraat 71,2021-09-18,12:00:00,168,104,64,FMN GV 11 Ramsel
66,Bergstraat 71,2021-09-18,13:00:00,224,112,112,FMN GV 11 Ramsel
66,Bergstraat 71,2021-09-18,14:00:00,378,162,216,FMN GV 11 Ramsel
66,Bergstraat 71,2021-09-18,15:00:00,250,128,122,FMN GV 11 Ramsel
66,Bergstraat 71,2021-09-18,16:00:00,218,120,98,FMN GV 11 Ramsel
66,Bergstraat 71,2021-09-18,17:00:00,158,62,96,FMN GV 11 Ramsel
66,Bergstraat 71,2021-09-18,18:00:00,112,66,46,FMN GV 11 Ramsel
66,Bergstraat 71,2021-09-18,19:00:00,42,20,22,FMN GV 11 Ramsel
66,Bergstraat 71,2021-09-18,20:00:00,38,14,24,FMN GV 11 Ramsel
66,Bergstraat 71,2021-09-18,21:00:00,18,8,10,FMN GV 11 Ramsel
66,Bergstraat 71,2021-09-18,22:00:00,12,10,2,FMN GV 11 Ramsel
66,Bergstraat 71,2021-09-18,23:00:00,2,0,2,FMN GV 11 Ramsel
66,Bergstraat 71,2021-09-19,00:00:00,4,2,2,FMN GV 11 Ramsel
66,Bergstraat 71,2021-09-19,01:00:00,2,0,2,FMN GV 11 Ramsel
66,Bergstraat 71,2021-09-19,02:00:00,4,4,0,FMN GV 11 Ramsel
66,Bergstraat 71,2021-09-19,03:00:00,0,0,0,FMN GV 11 Ramsel
66,Bergstraat 71,2021-09-19,04:00:00,6,4,2,FMN GV 11 Ramsel
66,Bergstraat 71,2021-09-19,05:00:00,2,0,2,FMN GV 11 Ramsel
66,Bergstraat 71,2021-09-19,06:00:00,6,6,0,FMN GV 11 Ramsel
66,Bergstraat 71,2021-09-19,07:00:00,6,2,4,FMN GV 11 Ramsel
66,Bergstraat 71,2021-09-19,08:00:00,68,14,54,FMN GV 11 Ramsel
66,Bergstraat 71,2021-09-19,09:00:00,112,36,76,FMN GV 11 Ramsel
66,Bergstraat 71,2021-09-19,10:00:00,192,90,102,FMN GV 11 Ramsel
66,Bergstraat 71,2021-09-19,11:00:00,226,128,98,FMN GV 11 Ramsel
66,Bergstraat 71,2021-09-19,12:00:00,146,94,52,FMN GV 11 Ramsel
66,Bergstraat 71,2021-09-19,13:00:00,294,126,168,FMN GV 11 Ramsel
66,Bergstraat 71,2021-09-19,14:00:00,320,142,178,FMN GV 11 Ramsel
66,Bergstraat 71,2021-09-19,15:00:00,264,126,138,FMN GV 11 Ramsel
66,Bergstraat 71,2021-09-19,16:00:00,196,112,84,FMN GV 11 Ramsel
66,Bergstraat 71,2021-09-19,17:00:00,148,80,68,FMN GV 11 Ramsel
66,Bergstraat 71,2021-09-19,18:00:00,130,62,68,FMN GV 11 Ramsel
66,Bergstraat 71,2021-09-19,19:00:00,38,28,10,FMN GV 11 Ramsel
66,Bergstraat 71,2021-09-19,20:00:00,18,2,16,FMN GV 11 Ramsel
66,Bergstraat 71,2021-09-19,21:00:00,12,6,6,FMN GV 11 Ramsel
66,Bergstraat 71,2021-09-19,22:00:00,6,4,2,FMN GV 11 Ramsel
66,Bergstraat 71,2021-09-19,23:00:00,6,0,6,FMN GV 11 Ramsel
66,Bergstraat 71,2021-09-20,00:00:00,4,2,2,FMN GV 11 Ramsel
66,Bergstraat 71,2021-09-20,01:00:00,0,0,0,FMN GV 11 Ramsel
66,Bergstraat 71,2021-09-20,02:00:00,0,0,0,FMN GV 11 Ramsel
66,Bergstraat 71,2021-09-20,03:00:00,0,0,0,FMN GV 11 Ramsel
66,Bergstraat 71,2021-09-20,04:00:00,2,2,0,FMN GV 11 Ramsel
66,Bergstraat 71,2021-09-20,05:00:00,10,6,4,FMN GV 11 Ramsel
66,Bergstraat 71,2021-09-20,06:00:00,44,16,28,FMN GV 11 Ramsel
66,Bergstraat 71,2021-09-20,07:00:00,256,22,234,FMN GV 11 Ramsel
66,Bergstraat 71,2021-09-20,08:00:00,202,32,170,FMN GV 11 Ramsel
66,Bergstraat 71,2021-09-20,09:00:00,72,24,48,FMN GV 11 Ramsel
66,Bergstraat 71,2021-09-20,10:00:00,60,30,30,FMN GV 11 Ramsel
66,Bergstraat 71,2021-09-20,11:00:00,66,28,38,FMN GV 11 Ramsel
66,Bergstraat 71,2021-09-20,12:00:00,62,26,36,FMN GV 11 Ramsel
66,Bergstraat 71,2021-09-20,13:00:00,178,76,102,FMN GV 11 Ramsel
66,Bergstraat 71,2021-09-20,14:00:00,154,86,68,FMN GV 11 Ramsel
66,Bergstraat 71,2021-09-20,15:00:00,330,276,54,FMN GV 11 Ramsel
66,Bergstraat 71,2021-09-20,16:00:00,320,234,86,FMN GV 11 Ramsel
66,Bergstraat 71,2021-09-20,17:00:00,108,62,46,FMN GV 11 Ramsel
66,Bergstraat 71,2021-09-20,18:00:00,70,44,26,FMN GV 11 Ramsel
66,Bergstraat 71,2021-09-20,19:00:00,60,36,24,FMN GV 11 Ramsel
66,Bergstraat 71,2021-09-20,20:00:00,42,24,18,FMN GV 11 Ramsel
66,Bergstraat 71,2021-09-20,21:00:00,18,10,8,FMN GV 11 Ramsel
66,Bergstraat 71,2021-09-20,22:00:00,14,4,10,FMN GV 11 Ramsel
66,Bergstraat 71,2021-09-20,23:00:00,6,6,0,FMN GV 11 Ramsel
66,Bergstraat 71,2021-09-21,00:00:00,2,0,2,FMN GV 11 Ramsel
66,Bergstraat 71,2021-09-21,01:00:00,0,0,0,FMN GV 11 Ramsel
66,Bergstraat 71,2021-09-21,02:00:00,0,0,0,FMN GV 11 Ramsel
66,Bergstraat 71,2021-09-21,03:00:00,0,0,0,FMN GV 11 Ramsel
66,Bergstraat 71,2021-09-21,04:00:00,4,2,2,FMN GV 11 Ramsel
66,Bergstraat 71,2021-09-21,05:00:00,12,6,6,FMN GV 11 Ramsel
66,Bergstraat 71,2021-09-21,06:00:00,40,12,28,FMN GV 11 Ramsel
66,Bergstraat 71,2021-09-21,07:00:00,254,32,222,FMN GV 11 Ramsel
66,Bergstraat 71,2021-09-21,08:00:00,210,32,178,FMN GV 11 Ramsel
66,Bergstraat 71,2021-09-21,09:00:00,56,26,30,FMN GV 11 Ramsel
66,Bergstraat 71,2021-09-21,10:00:00,56,16,40,FMN GV 11 Ramsel
66,Bergstraat 71,2021-09-21,11:00:00,96,42,54,FMN GV 11 Ramsel
66,Bergstraat 71,2021-09-21,12:00:00,124,58,66,FMN GV 11 Ramsel
66,Bergstraat 71,2021-09-21,13:00:00,210,82,128,FMN GV 11 Ramsel
66,Bergstraat 71,2021-09-21,14:00:00,216,122,94,FMN GV 11 Ramsel
66,Bergstraat 71,2021-09-21,15:00:00,386,282,104,FMN GV 11 Ramsel
66,Bergstraat 71,2021-09-21,16:00:00,418,286,132,FMN GV 11 Ramsel
66,Bergstraat 71,2021-09-21,17:00:00,168,86,82,FMN GV 11 Ramsel
66,Bergstraat 71,2021-09-21,18:00:00,100,48,52,FMN GV 11 Ramsel
66,Bergstraat 71,2021-09-21,19:00:00,60,34,26,FMN GV 11 Ramsel
66,Bergstraat 71,2021-09-21,20:00:00,30,24,6,FMN GV 11 Ramsel
66,Bergstraat 71,2021-09-21,21:00:00,34,30,4,FMN GV 11 Ramsel
66,Bergstraat 71,2021-09-21,22:00:00,14,6,8,FMN GV 11 Ramsel
66,Bergstraat 71,2021-09-21,23:00:00,6,4,2,FMN GV 11 Ramsel
66,Bergstraat 71,2021-09-22,00:00:00,2,2,0,FMN GV 11 Ramsel
66,Bergstraat 71,2021-09-22,01:00:00,2,0,2,FMN GV 11 Ramsel
66,Bergstraat 71,2021-09-22,02:00:00,0,0,0,FMN GV 11 Ramsel
66,Bergstraat 71,2021-09-22,03:00:00,0,0,0,FMN GV 11 Ramsel
66,Bergstraat 71,2021-09-22,04:00:00,6,4,2,FMN GV 11 Ramsel
66,Bergstraat 71,2021-09-22,05:00:00,8,4,4,FMN GV 11 Ramsel
66,Bergstraat 71,2021-09-22,06:00:00,32,12,20,FMN GV 11 Ramsel
66,Bergstraat 71,2021-09-22,07:00:00,244,16,228,FMN GV 11 Ramsel
66,Bergstraat 71,2021-09-22,08:00:00,188,28,160,FMN GV 11 Ramsel
66,Bergstraat 71,2021-09-22,09:00:00,56,14,42,FMN GV 11 Ramsel
66,Bergstraat 71,2021-09-22,10:00:00,100,52,48,FMN GV 11 Ramsel
66,Bergstraat 71,2021-09-22,11:00:00,136,76,60,FMN GV 11 Ramsel
66,Bergstraat 71,2021-09-22,12:00:00,344,270,74,FMN GV 11 Ramsel
66,Bergstraat 71,2021-09-22,13:00:00,212,112,100,FMN GV 11 Ramsel
66,Bergstraat 71,2021-09-22,14:00:00,276,138,138,FMN GV 11 Ramsel
66,Bergstraat 71,2021-09-22,15:00:00,218,142,76,FMN GV 11 Ramsel
66,Bergstraat 71,2021-09-22,16:00:00,204,106,98,FMN GV 11 Ramsel
66,Bergstraat 71,2021-09-22,17:00:00,178,98,80,FMN GV 11 Ramsel
66,Bergstraat 71,2021-09-22,18:00:00,142,78,64,FMN GV 11 Ramsel
66,Bergstraat 71,2021-09-22,19:00:00,82,46,36,FMN GV 11 Ramsel
66,Bergstraat 71,2021-09-22,20:00:00,22,6,16,FMN GV 11 Ramsel
66,Bergstraat 71,2021-09-22,21:00:00,22,8,14,FMN GV 11 Ramsel
66,Bergstraat 71,2021-09-22,22:00:00,16,12,4,FMN GV 11 Ramsel
66,Bergstraat 71,2021-09-22,23:00:00,4,4,0,FMN GV 11 Ramsel
66,Bergstraat 71,2021-09-23,00:00:00,4,4,0,FMN GV 11 Ramsel
66,Bergstraat 71,2021-09-23,01:00:00,6,6,0,FMN GV 11 Ramsel
66,Bergstraat 71,2021-09-23,02:00:00,0,0,0,FMN GV 11 Ramsel
66,Bergstraat 71,2021-09-23,03:00:00,2,0,2,FMN GV 11 Ramsel
66,Bergstraat 71,2021-09-23,04:00:00,6,4,2,FMN GV 11 Ramsel
66,Bergstraat 71,2021-09-23,05:00:00,10,6,4,FMN GV 11 Ramsel
66,Bergstraat 71,2021-09-23,06:00:00,30,8,22,FMN GV 11 Ramsel
66,Bergstraat 71,2021-09-23,07:00:00,240,22,218,FMN GV 11 Ramsel
66,Bergstraat 71,2021-09-23,08:00:00,212,28,184,FMN GV 11 Ramsel
66,Bergstraat 71,2021-09-23,09:00:00,72,18,54,FMN GV 11 Ramsel
66,Bergstraat 71,2021-09-23,10:00:00,62,34,28,FMN GV 11 Ramsel
66,Bergstraat 71,2021-09-23,11:00:00,116,44,72,FMN GV 11 Ramsel
66,Bergstraat 71,2021-09-23,12:00:00,136,96,40,FMN GV 11 Ramsel
66,Bergstraat 71,2021-09-23,13:00:00,166,86,80,FMN GV 11 Ramsel
66,Bergstraat 71,2021-09-23,14:00:00,160,86,74,FMN GV 11 Ramsel
66,Bergstraat 71,2021-09-23,15:00:00,304,244,60,FMN GV 11 Ramsel
66,Bergstraat 71,2021-09-23,16:00:00,204,152,52,FMN GV 11 Ramsel
66,Bergstraat 71,2021-09-23,17:00:00,146,100,46,FMN GV 11 Ramsel
66,Bergstraat 71,2021-09-23,18:00:00,70,42,28,FMN GV 11 Ramsel
66,Bergstraat 71,2021-09-23,19:00:00,56,16,40,FMN GV 11 Ramsel
66,Bergstraat 71,2021-09-23,20:00:00,18,8,10,FMN GV 11 Ramsel
66,Bergstraat 71,2021-09-23,21:00:00,16,12,4,FMN GV 11 Ramsel
66,Bergstraat 71,2021-09-23,22:00:00,10,6,4,FMN GV 11 Ramsel
66,Bergstraat 71,2021-09-23,23:00:00,2,2,0,FMN GV 11 Ramsel
66,Bergstraat 71,2021-09-24,00:00:00,4,4,0,FMN GV 11 Ramsel
66,Bergstraat 71,2021-09-24,01:00:00,0,0,0,FMN GV 11 Ramsel
66,Bergstraat 71,2021-09-24,02:00:00,0,0,0,FMN GV 11 Ramsel
66,Bergstraat 71,2021-09-24,03:00:00,2,2,0,FMN GV 11 Ramsel
66,Bergstraat 71,2021-09-24,04:00:00,6,4,2,FMN GV 11 Ramsel
66,Bergstraat 71,2021-09-24,05:00:00,8,4,4,FMN GV 11 Ramsel
66,Bergstraat 71,2021-09-24,06:00:00,28,8,20,FMN GV 11 Ramsel
66,Bergstraat 71,2021-09-24,07:00:00,250,12,238,FMN GV 11 Ramsel
66,Bergstraat 71,2021-09-24,08:00:00,180,34,146,FMN GV 11 Ramsel
66,Bergstraat 71,2021-09-24,09:00:00,70,22,48,FMN GV 11 Ramsel
66,Bergstraat 71,2021-09-24,10:00:00,94,24,70,FMN GV 11 Ramsel
66,Bergstraat 71,2021-09-24,11:00:00,96,54,42,FMN GV 11 Ramsel
66,Bergstraat 71,2021-09-24,12:00:00,124,64,60,FMN GV 11 Ramsel
66,Bergstraat 71,2021-09-24,13:00:00,104,46,58,FMN GV 11 Ramsel
66,Bergstraat 71,2021-09-24,14:00:00,150,78,72,FMN GV 11 Ramsel
66,Bergstraat 71,2021-09-24,15:00:00,316,246,70,FMN GV 11 Ramsel
66,Bergstraat 71,2021-09-24,16:00:00,204,158,46,FMN GV 11 Ramsel
66,Bergstraat 71,2021-09-24,17:00:00,106,64,42,FMN GV 11 Ramsel
66,Bergstraat 71,2021-09-24,18:00:00,86,38,48,FMN GV 11 Ramsel
66,Bergstraat 71,2021-09-24,19:00:00,78,46,32,FMN GV 11 Ramsel
66,Bergstraat 71,2021-09-24,20:00:00,42,22,20,FMN GV 11 Ramsel
66,Bergstraat 71,2021-09-24,21:00:00,12,2,10,FMN GV 11 Ramsel
66,Bergstraat 71,2021-09-24,22:00:00,10,0,10,FMN GV 11 Ramsel
66,Bergstraat 71,2021-09-24,23:00:00,2,2,0,FMN GV 11 Ramsel
66,Bergstraat 71,2021-09-25,00:00:00,12,12,0,FMN GV 11 Ramsel
66,Bergstraat 71,2021-09-25,01:00:00,4,2,2,FMN GV 11 Ramsel
66,Bergstraat 71,2021-09-25,02:00:00,16,14,2,FMN GV 11 Ramsel
66,Bergstraat 71,2021-09-25,03:00:00,6,4,2,FMN GV 11 Ramsel
66,Bergstraat 71,2021-09-25,04:00:00,0,0,0,FMN GV 11 Ramsel
66,Bergstraat 71,2021-09-25,05:00:00,2,2,0,FMN GV 11 Ramsel
66,Bergstraat 71,2021-09-25,06:00:00,8,6,2,FMN GV 11 Ramsel
66,Bergstraat 71,2021-09-25,07:00:00,8,2,6,FMN GV 11 Ramsel
66,Bergstraat 71,2021-09-25,08:00:00,30,8,22,FMN GV 11 Ramsel
66,Bergstraat 71,2021-09-25,09:00:00,100,44,56,FMN GV 11 Ramsel
66,Bergstraat 71,2021-09-25,10:00:00,160,76,84,FMN GV 11 Ramsel
66,Bergstraat 71,2021-09-25,11:00:00,186,62,124,FMN GV 11 Ramsel
66,Bergstraat 71,2021-09-25,12:00:00,210,112,98,FMN GV 11 Ramsel
66,Bergstraat 71,2021-09-25,13:00:00,298,122,176,FMN GV 11 Ramsel
66,Bergstraat 71,2021-09-25,14:00:00,294,168,126,FMN GV 11 Ramsel
66,Bergstraat 71,2021-09-25,15:00:00,276,148,128,FMN GV 11 Ramsel
66,Bergstraat 71,2021-09-25,16:00:00,264,166,98,FMN GV 11 Ramsel
66,Bergstraat 71,2021-09-25,17:00:00,224,146,78,FMN GV 11 Ramsel
66,Bergstraat 71,2021-09-25,18:00:00,100,52,48,FMN GV 11 Ramsel
66,Bergstraat 71,2021-09-25,19:00:00,98,52,46,FMN GV 11 Ramsel
66,Bergstraat 71,2021-09-25,20:00:00,16,10,6,FMN GV 11 Ramsel
66,Bergstraat 71,2021-09-25,21:00:00,30,18,12,FMN GV 11 Ramsel
66,Bergstraat 71,2021-09-25,22:00:00,16,10,6,FMN GV 11 Ramsel
66,Bergstraat 71,2021-09-25,23:00:00,14,10,4,FMN GV 11 Ramsel
66,Bergstraat 71,2021-09-26,00:00:00,2,2,0,FMN GV 11 Ramsel
66,Bergstraat 71,2021-09-26,01:00:00,8,0,8,FMN GV 11 Ramsel
66,Bergstraat 71,2021-09-26,02:00:00,10,6,4,FMN GV 11 Ramsel
66,Bergstraat 71,2021-09-26,03:00:00,2,2,0,FMN GV 11 Ramsel
66,Bergstraat 71,2021-09-26,04:00:00,2,0,2,FMN GV 11 Ramsel
66,Bergstraat 71,2021-09-26,05:00:00,0,0,0,FMN GV 11 Ramsel
66,Bergstraat 71,2021-09-26,06:00:00,8,6,2,FMN GV 11 Ramsel
66,Bergstraat 71,2021-09-26,07:00:00,10,2,8,FMN GV 11 Ramsel
66,Bergstraat 71,2021-09-26,08:00:00,102,16,86,FMN GV 11 Ramsel
66,Bergstraat 71,2021-09-26,09:00:00,148,32,116,FMN GV 11 Ramsel
66,Bergstraat 71,2021-09-26,10:00:00,218,78,140,FMN GV 11 Ramsel
66,Bergstraat 71,2021-09-26,11:00:00,166,72,94,FMN GV 11 Ramsel
66,Bergstraat 71,2021-09-26,12:00:00,162,108,54,FMN GV 11 Ramsel
66,Bergstraat 71,2021-09-26,13:00:00,240,146,94,FMN GV 11 Ramsel
66,Bergstraat 71,2021-09-26,14:00:00,200,100,100,FMN GV 11 Ramsel
66,Bergstraat 71,2021-09-26,15:00:00,154,88,66,FMN GV 11 Ramsel
66,Bergstraat 71,2021-09-26,16:00:00,92,52,40,FMN GV 11 Ramsel
66,Bergstraat 71,2021-09-26,17:00:00,154,82,72,FMN GV 11 Ramsel
66,Bergstraat 71,2021-09-26,18:00:00,108,76,32,FMN GV 11 Ramsel
66,Bergstraat 71,2021-09-26,19:00:00,68,50,18,FMN GV 11 Ramsel
66,Bergstraat 71,2021-09-26,20:00:00,28,12,16,FMN GV 11 Ramsel
66,Bergstraat 71,2021-09-26,21:00:00,10,4,6,FMN GV 11 Ramsel
66,Bergstraat 71,2021-09-26,22:00:00,6,6,0,FMN GV 11 Ramsel
66,Bergstraat 71,2021-09-26,23:00:00,2,0,2,FMN GV 11 Ramsel
66,Bergstraat 71,2021-09-27,00:00:00,2,2,0,FMN GV 11 Ramsel
66,Bergstraat 71,2021-09-27,01:00:00,0,0,0,FMN GV 11 Ramsel
66,Bergstraat 71,2021-09-27,02:00:00,0,0,0,FMN GV 11 Ramsel
66,Bergstraat 71,2021-09-27,03:00:00,0,0,0,FMN GV 11 Ramsel
66,Bergstraat 71,2021-09-27,04:00:00,2,2,0,FMN GV 11 Ramsel
66,Bergstraat 71,2021-09-27,05:00:00,6,2,4,FMN GV 11 Ramsel
66,Bergstraat 71,2021-09-27,06:00:00,36,8,28,FMN GV 11 Ramsel
66,Bergstraat 71,2021-09-27,07:00:00,274,22,252,FMN GV 11 Ramsel
66,Bergstraat 71,2021-09-27,08:00:00,178,30,148,FMN GV 11 Ramsel
66,Bergstraat 71,2021-09-27,09:00:00,56,38,18,FMN GV 11 Ramsel
66,Bergstraat 71,2021-09-27,10:00:00,86,58,28,FMN GV 11 Ramsel
66,Bergstraat 71,2021-09-27,11:00:00,34,14,20,FMN GV 11 Ramsel
66,Bergstraat 71,2021-09-27,12:00:00,38,26,12,FMN GV 11 Ramsel
66,Bergstraat 71,2021-09-27,13:00:00,52,30,22,FMN GV 11 Ramsel
66,Bergstraat 71,2021-09-27,14:00:00,36,24,12,FMN GV 11 Ramsel
66,Bergstraat 71,2021-09-27,15:00:00,228,204,24,FMN GV 11 Ramsel
66,Bergstraat 71,2021-09-27,16:00:00,136,118,18,FMN GV 11 Ramsel
66,Bergstraat 71,2021-09-27,17:00:00,62,46,16,FMN GV 11 Ramsel
66,Bergstraat 71,2021-09-27,18:00:00,46,24,22,FMN GV 11 Ramsel
66,Bergstraat 71,2021-09-27,19:00:00,36,20,16,FMN GV 11 Ramsel
66,Bergstraat 71,2021-09-27,20:00:00,18,14,4,FMN GV 11 Ramsel
66,Bergstraat 71,2021-09-27,21:00:00,6,4,2,FMN GV 11 Ramsel
66,Bergstraat 71,2021-09-27,22:00:00,12,6,6,FMN GV 11 Ramsel
66,Bergstraat 71,2021-09-27,23:00:00,4,4,0,FMN GV 11 Ramsel
66,Bergstraat 71,2021-09-28,00:00:00,0,0,0,FMN GV 11 Ramsel
66,Bergstraat 71,2021-09-28,01:00:00,0,0,0,FMN GV 11 Ramsel
66,Bergstraat 71,2021-09-28,02:00:00,0,0,0,FMN GV 11 Ramsel
66,Bergstraat 71,2021-09-28,03:00:00,0,0,0,FMN GV 11 Ramsel
66,Bergstraat 71,2021-09-28,04:00:00,2,2,0,FMN GV 11 Ramsel
66,Bergstraat 71,2021-09-28,05:00:00,10,6,4,FMN GV 11 Ramsel
66,Bergstraat 71,2021-09-28,06:00:00,36,14,22,FMN GV 11 Ramsel
66,Bergstraat 71,2021-09-28,07:00:00,272,12,260,FMN GV 11 Ramsel
66,Bergstraat 71,2021-09-28,08:00:00,186,14,172,FMN GV 11 Ramsel
66,Bergstraat 71,2021-09-28,09:00:00,92,44,48,FMN GV 11 Ramsel
66,Bergstraat 71,2021-09-28,10:00:00,128,48,80,FMN GV 11 Ramsel
66,Bergstraat 71,2021-09-28,11:00:00,96,40,56,FMN GV 11 Ramsel
66,Bergstraat 71,2021-09-28,12:00:00,130,68,62,FMN GV 11 Ramsel
66,Bergstraat 71,2021-09-28,13:00:00,230,82,148,FMN GV 11 Ramsel
66,Bergstraat 71,2021-09-28,14:00:00,192,110,82,FMN GV 11 Ramsel
66,Bergstraat 71,2021-09-28,15:00:00,404,306,98,FMN GV 11 Ramsel
66,Bergstraat 71,2021-09-28,16:00:00,230,172,58,FMN GV 11 Ramsel
66,Bergstraat 71,2021-09-28,17:00:00,132,80,52,FMN GV 11 Ramsel
66,Bergstraat 71,2021-09-28,18:00:00,134,86,48,FMN GV 11 Ramsel
66,Bergstraat 71,2021-09-28,19:00:00,60,24,36,FMN GV 11 Ramsel
66,Bergstraat 71,2021-09-28,20:00:00,50,24,26,FMN GV 11 Ramsel
66,Bergstraat 71,2021-09-28,21:00:00,30,18,12,FMN GV 11 Ramsel
66,Bergstraat 71,2021-09-28,22:00:00,20,12,8,FMN GV 11 Ramsel
66,Bergstraat 71,2021-09-28,23:00:00,6,6,0,FMN GV 11 Ramsel
66,Bergstraat 71,2021-09-29,00:00:00,2,2,0,FMN GV 11 Ramsel
66,Bergstraat 71,2021-09-29,01:00:00,0,0,0,FMN GV 11 Ramsel
66,Bergstraat 71,2021-09-29,02:00:00,0,0,0,FMN GV 11 Ramsel
66,Bergstraat 71,2021-09-29,03:00:00,0,0,0,FMN GV 11 Ramsel
66,Bergstraat 71,2021-09-29,04:00:00,2,2,0,FMN GV 11 Ramsel
66,Bergstraat 71,2021-09-29,05:00:00,14,10,4,FMN GV 11 Ramsel
66,Bergstraat 71,2021-09-29,06:00:00,20,8,12,FMN GV 11 Ramsel
66,Bergstraat 71,2021-09-29,07:00:00,194,14,180,FMN GV 11 Ramsel
66,Bergstraat 71,2021-09-29,08:00:00,110,16,94,FMN GV 11 Ramsel
66,Bergstraat 71,2021-09-29,09:00:00,8,2,6,FMN GV 11 Ramsel
66,Bergstraat 71,2021-09-29,10:00:00,24,10,14,FMN GV 11 Ramsel
66,Bergstraat 71,2021-09-29,11:00:00,44,18,26,FMN GV 11 Ramsel
66,Bergstraat 71,2021-09-29,12:00:00,204,184,20,FMN GV 11 Ramsel
66,Bergstraat 71,2021-09-29,13:00:00,42,26,16,FMN GV 11 Ramsel
66,Bergstraat 71,2021-09-29,14:00:00,42,16,26,FMN GV 11 Ramsel
66,Bergstraat 71,2021-09-29,15:00:00,54,30,24,FMN GV 11 Ramsel
66,Bergstraat 71,2021-09-29,16:00:00,60,48,12,FMN GV 11 Ramsel
66,Bergstraat 71,2021-09-29,17:00:00,58,28,30,FMN GV 11 Ramsel
66,Bergstraat 71,2021-09-29,18:00:00,42,16,26,FMN GV 11 Ramsel
66,Bergstraat 71,2021-09-29,19:00:00,56,42,14,FMN GV 11 Ramsel
66,Bergstraat 71,2021-09-29,20:00:00,14,8,6,FMN GV 11 Ramsel
66,Bergstraat 71,2021-09-29,21:00:00,8,4,4,FMN GV 11 Ramsel
66,Bergstraat 71,2021-09-29,22:00:00,12,10,2,FMN GV 11 Ramsel
66,Bergstraat 71,2021-09-29,23:00:00,0,0,0,FMN GV 11 Ramsel
66,Bergstraat 71,2021-09-30,00:00:00,8,6,2,FMN GV 11 Ramsel
66,Bergstraat 71,2021-09-30,01:00:00,0,0,0,FMN GV 11 Ramsel
66,Bergstraat 71,2021-09-30,02:00:00,0,0,0,FMN GV 11 Ramsel
66,Bergstraat 71,2021-09-30,03:00:00,0,0,0,FMN GV 11 Ramsel
66,Bergstraat 71,2021-09-30,04:00:00,2,0,2,FMN GV 11 Ramsel
66,Bergstraat 71,2021-09-30,05:00:00,12,8,4,FMN GV 11 Ramsel
66,Bergstraat 71,2021-09-30,06:00:00,40,14,26,FMN GV 11 Ramsel
66,Bergstraat 71,2021-09-30,07:00:00,226,14,212,FMN GV 11 Ramsel
66,Bergstraat 71,2021-09-30,08:00:00,224,30,194,FMN GV 11 Ramsel
66,Bergstraat 71,2021-09-30,09:00:00,76,28,48,FMN GV 11 Ramsel
66,Bergstraat 71,2021-09-30,10:00:00,76,40,36,FMN GV 11 Ramsel
66,Bergstraat 71,2021-09-30,11:00:00,66,36,30,FMN GV 11 Ramsel
66,Bergstraat 71,2021-09-30,12:00:00,82,56,26,FMN GV 11 Ramsel
66,Bergstraat 71,2021-09-30,13:00:00,134,58,76,FMN GV 11 Ramsel
66,Bergstraat 71,2021-09-30,14:00:00,154,86,68,FMN GV 11 Ramsel
66,Bergstraat 71,2021-09-30,15:00:00,306,230,76,FMN GV 11 Ramsel
66,Bergstraat 71,2021-09-30,16:00:00,210,166,44,FMN GV 11 Ramsel
66,Bergstraat 71,2021-09-30,17:00:00,94,68,26,FMN GV 11 Ramsel
66,Bergstraat 71,2021-09-30,18:00:00,74,50,24,FMN GV 11 Ramsel
66,Bergstraat 71,2021-09-30,19:00:00,54,32,22,FMN GV 11 Ramsel
66,Bergstraat 71,2021-09-30,20:00:00,30,18,12,FMN GV 11 Ramsel
66,Bergstraat 71,2021-09-30,21:00:00,8,6,2,FMN GV 11 Ramsel
66,Bergstraat 71,2021-09-30,22:00:00,10,6,4,FMN GV 11 Ramsel
66,Bergstraat 71,2021-09-30,23:00:00,6,4,2,FMN GV 11 Ramsel
66,Bergstraat 71,2021-10-01,00:00:00,2,2,0,FMN GV 11 Ramsel
66,Bergstraat 71,2021-10-01,01:00:00,0,0,0,FMN GV 11 Ramsel
66,Bergstraat 71,2021-10-01,02:00:00,4,4,0,FMN GV 11 Ramsel
66,Bergstraat 71,2021-10-01,03:00:00,0,0,0,FMN GV 11 Ramsel
66,Bergstraat 71,2021-10-01,04:00:00,4,2,2,FMN GV 11 Ramsel
66,Bergstraat 71,2021-10-01,05:00:00,2,2,0,FMN GV 11 Ramsel
66,Bergstraat 71,2021-10-01,06:00:00,18,4,14,FMN GV 11 Ramsel
66,Bergstraat 71,2021-10-01,07:00:00,212,26,186,FMN GV 11 Ramsel
66,Bergstraat 71,2021-10-01,08:00:00,164,18,146,FMN GV 11 Ramsel
66,Bergstraat 71,2021-10-01,09:00:00,48,20,28,FMN GV 11 Ramsel
66,Bergstraat 71,2021-10-01,10:00:00,58,26,32,FMN GV 11 Ramsel
66,Bergstraat 71,2021-10-01,11:00:00,64,40,24,FMN GV 11 Ramsel
66,Bergstraat 71,2021-10-01,12:00:00,40,16,24,FMN GV 11 Ramsel
66,Bergstraat 71,2021-10-01,13:00:00,56,22,34,FMN GV 11 Ramsel
66,Bergstraat 71,2021-10-01,14:00:00,100,54,46,FMN GV 11 Ramsel
66,Bergstraat 71,2021-10-01,15:00:00,218,186,32,FMN GV 11 Ramsel
66,Bergstraat 71,2021-10-01,16:00:00,162,130,32,FMN GV 11 Ramsel
66,Bergstraat 71,2021-10-01,17:00:00,74,48,26,FMN GV 11 Ramsel
66,Bergstraat 71,2021-10-01,18:00:00,72,46,26,FMN GV 11 Ramsel
66,Bergstraat 71,2021-10-01,19:00:00,22,4,18,FMN GV 11 Ramsel
66,Bergstraat 71,2021-10-01,20:00:00,16,6,10,FMN GV 11 Ramsel
66,Bergstraat 71,2021-10-01,21:00:00,14,10,4,FMN GV 11 Ramsel
66,Bergstraat 71,2021-10-01,22:00:00,2,0,2,FMN GV 11 Ramsel
66,Bergstraat 71,2021-10-01,23:00:00,6,4,2,FMN GV 11 Ramsel
66,Bergstraat 71,2021-10-02,00:00:00,8,6,2,FMN GV 11 Ramsel
66,Bergstraat 71,2021-10-02,01:00:00,4,4,0,FMN GV 11 Ramsel
66,Bergstraat 71,2021-10-02,02:00:00,2,2,0,FMN GV 11 Ramsel
66,Bergstraat 71,2021-10-02,03:00:00,4,4,0,FMN GV 11 Ramsel
66,Bergstraat 71,2021-10-02,04:00:00,0,0,0,FMN GV 11 Ramsel
66,Bergstraat 71,2021-10-02,05:00:00,4,2,2,FMN GV 11 Ramsel
66,Bergstraat 71,2021-10-02,06:00:00,4,0,4,FMN GV 11 Ramsel
66,Bergstraat 71,2021-10-02,07:00:00,8,4,4,FMN GV 11 Ramsel
66,Bergstraat 71,2021-10-02,08:00:00,40,6,34,FMN GV 11 Ramsel
66,Bergstraat 71,2021-10-02,09:00:00,48,14,34,FMN GV 11 Ramsel
66,Bergstraat 71,2021-10-02,10:00:00,100,48,52,FMN GV 11 Ramsel
66,Bergstraat 71,2021-10-02,11:00:00,114,46,68,FMN GV 11 Ramsel
66,Bergstraat 71,2021-10-02,12:00:00,92,58,34,FMN GV 11 Ramsel
66,Bergstraat 71,2021-10-02,13:00:00,118,54,64,FMN GV 11 Ramsel
66,Bergstraat 71,2021-10-02,14:00:00,112,54,58,FMN GV 11 Ramsel
66,Bergstraat 71,2021-10-02,15:00:00,96,60,36,FMN GV 11 Ramsel
66,Bergstraat 71,2021-10-02,16:00:00,78,30,48,FMN GV 11 Ramsel
66,Bergstraat 71,2021-10-02,17:00:00,46,22,24,FMN GV 11 Ramsel
66,Bergstraat 71,2021-10-02,18:00:00,28,14,14,FMN GV 11 Ramsel
66,Bergstraat 71,2021-10-02,19:00:00,12,2,10,FMN GV 11 Ramsel
66,Bergstraat 71,2021-10-02,20:00:00,8,4,4,FMN GV 11 Ramsel
66,Bergstraat 71,2021-10-02,21:00:00,6,4,2,FMN GV 11 Ramsel
66,Bergstraat 71,2021-10-02,22:00:00,2,2,0,FMN GV 11 Ramsel
66,Bergstraat 71,2021-10-02,23:00:00,0,0,0,FMN GV 11 Ramsel
66,Bergstraat 71,2021-10-03,00:00:00,6,6,0,FMN GV 11 Ramsel
66,Bergstraat 71,2021-10-03,01:00:00,0,0,0,FMN GV 11 Ramsel
66,Bergstraat 71,2021-10-03,02:00:00,0,0,0,FMN GV 11 Ramsel
66,Bergstraat 71,2021-10-03,03:00:00,2,2,0,FMN GV 11 Ramsel
66,Bergstraat 71,2021-10-03,04:00:00,0,0,0,FMN GV 11 Ramsel
66,Bergstraat 71,2021-10-03,05:00:00,2,0,2,FMN GV 11 Ramsel
66,Bergstraat 71,2021-10-03,06:00:00,6,4,2,FMN GV 11 Ramsel
66,Bergstraat 71,2021-10-03,07:00:00,2,2,0,FMN GV 11 Ramsel
66,Bergstraat 71,2021-10-03,08:00:00,0,0,0,FMN GV 11 Ramsel
66,Bergstraat 71,2021-10-03,09:00:00,16,4,12,FMN GV 11 Ramsel
66,Bergstraat 71,2021-10-03,10:00:00,8,4,4,FMN GV 11 Ramsel
66,Bergstraat 71,2021-10-03,11:00:00,6,2,4,FMN GV 11 Ramsel
66,Bergstraat 71,2021-10-03,12:00:00,8,8,0,FMN GV 11 Ramsel
66,Bergstraat 71,2021-10-03,13:00:00,0,0,0,FMN GV 11 Ramsel
66,Bergstraat 71,2021-10-03,14:00:00,4,4,0,FMN GV 11 Ramsel
66,Bergstraat 71,2021-10-03,15:00:00,4,2,2,FMN GV 11 Ramsel
66,Bergstraat 71,2021-10-03,16:00:00,22,4,18,FMN GV 11 Ramsel
66,Bergstraat 71,2021-10-03,17:00:00,16,10,6,FMN GV 11 Ramsel
66,Bergstraat 71,2021-10-03,18:00:00,48,20,28,FMN GV 11 Ramsel
66,Bergstraat 71,2021-10-03,19:00:00,30,12,18,FMN GV 11 Ramsel
66,Bergstraat 71,2021-10-03,20:00:00,10,4,6,FMN GV 11 Ramsel
66,Bergstraat 71,2021-10-03,21:00:00,10,0,10,FMN GV 11 Ramsel
66,Bergstraat 71,2021-10-03,22:00:00,6,0,6,FMN GV 11 Ramsel
66,Bergstraat 71,2021-10-03,23:00:00,0,0,0,FMN GV 11 Ramsel
66,Bergstraat 71,2021-10-04,00:00:00,2,2,0,FMN GV 11 Ramsel
66,Bergstraat 71,2021-10-04,01:00:00,0,0,0,FMN GV 11 Ramsel
66,Bergstraat 71,2021-10-04,02:00:00,8,8,0,FMN GV 11 Ramsel
66,Bergstraat 71,2021-10-04,03:00:00,0,0,0,FMN GV 11 Ramsel
66,Bergstraat 71,2021-10-04,04:00:00,4,2,2,FMN GV 11 Ramsel
66,Bergstraat 71,2021-10-04,05:00:00,10,6,4,FMN GV 11 Ramsel
66,Bergstraat 71,2021-10-04,06:00:00,26,8,18,FMN GV 11 Ramsel
66,Bergstraat 71,2021-10-04,07:00:00,232,20,212,FMN GV 11 Ramsel
66,Bergstraat 71,2021-10-04,08:00:00,202,40,162,FMN GV 11 Ramsel
66,Bergstraat 71,2021-10-04,09:00:00,50,14,36,FMN GV 11 Ramsel
66,Bergstraat 71,2021-10-04,10:00:00,72,26,46,FMN GV 11 Ramsel
66,Bergstraat 71,2021-10-04,11:00:00,82,36,46,FMN GV 11 Ramsel
66,Bergstraat 71,2021-10-04,12:00:00,94,42,52,FMN GV 11 Ramsel
66,Bergstraat 71,2021-10-04,13:00:00,124,64,60,FMN GV 11 Ramsel
66,Bergstraat 71,2021-10-04,14:00:00,108,46,62,FMN GV 11 Ramsel
66,Bergstraat 71,2021-10-04,15:00:00,260,212,48,FMN GV 11 Ramsel
66,Bergstraat 71,2021-10-04,16:00:00,286,196,90,FMN GV 11 Ramsel
66,Bergstraat 71,2021-10-04,17:00:00,108,78,30,FMN GV 11 Ramsel
66,Bergstraat 71,2021-10-04,18:00:00,84,48,36,FMN GV 11 Ramsel
66,Bergstraat 71,2021-10-04,19:00:00,56,26,30,FMN GV 11 Ramsel
66,Bergstraat 71,2021-10-04,20:00:00,26,16,10,FMN GV 11 Ramsel
66,Bergstraat 71,2021-10-04,21:00:00,14,14,0,FMN GV 11 Ramsel
66,Bergstraat 71,2021-10-04,22:00:00,16,4,12,FMN GV 11 Ramsel
66,Bergstraat 71,2021-10-04,23:00:00,2,2,0,FMN GV 11 Ramsel
66,Bergstraat 71,2021-10-05,00:00:00,0,0,0,FMN GV 11 Ramsel
66,Bergstraat 71,2021-10-05,01:00:00,0,0,0,FMN GV 11 Ramsel
66,Bergstraat 71,2021-10-05,02:00:00,2,2,0,FMN GV 11 Ramsel
66,Bergstraat 71,2021-10-05,03:00:00,0,0,0,FMN GV 11 Ramsel
66,Bergstraat 71,2021-10-05,04:00:00,2,2,0,FMN GV 11 Ramsel
66,Bergstraat 71,2021-10-05,05:00:00,10,6,4,FMN GV 11 Ramsel
66,Bergstraat 71,2021-10-05,06:00:00,30,10,20,FMN GV 11 Ramsel
66,Bergstraat 71,2021-10-05,07:00:00,222,12,210,FMN GV 11 Ramsel
66,Bergstraat 71,2021-10-05,08:00:00,172,12,160,FMN GV 11 Ramsel
66,Bergstraat 71,2021-10-05,09:00:00,64,20,44,FMN GV 11 Ramsel
66,Bergstraat 71,2021-10-05,10:00:00,72,28,44,FMN GV 11 Ramsel
66,Bergstraat 71,2021-10-05,11:00:00,52,30,22,FMN GV 11 Ramsel
66,Bergstraat 71,2021-10-05,12:00:00,52,36,16,FMN GV 11 Ramsel
66,Bergstraat 71,2021-10-05,13:00:00,22,4,18,FMN GV 11 Ramsel
66,Bergstraat 71,2021-10-05,14:00:00,28,22,6,FMN GV 11 Ramsel
66,Bergstraat 71,2021-10-05,15:00:00,190,180,10,FMN GV 11 Ramsel
66,Bergstraat 71,2021-10-05,16:00:00,138,124,14,FMN GV 11 Ramsel
66,Bergstraat 71,2021-10-05,17:00:00,70,50,20,FMN GV 11 Ramsel
66,Bergstraat 71,2021-10-05,18:00:00,58,32,26,FMN GV 11 Ramsel
66,Bergstraat 71,2021-10-05,19:00:00,40,20,20,FMN GV 11 Ramsel
66,Bergstraat 71,2021-10-05,20:00:00,20,16,4,FMN GV 11 Ramsel
66,Bergstraat 71,2021-10-05,21:00:00,10,4,6,FMN GV 11 Ramsel
66,Bergstraat 71,2021-10-05,22:00:00,14,8,6,FMN GV 11 Ramsel
66,Bergstraat 71,2021-10-05,23:00:00,6,4,2,FMN GV 11 Ramsel
66,Bergstraat 71,2021-10-06,00:00:00,0,0,0,FMN GV 11 Ramsel
66,Bergstraat 71,2021-10-06,01:00:00,0,0,0,FMN GV 11 Ramsel
66,Bergstraat 71,2021-10-06,02:00:00,0,0,0,FMN GV 11 Ramsel
66,Bergstraat 71,2021-10-06,03:00:00,0,0,0,FMN GV 11 Ramsel
66,Bergstraat 71,2021-10-06,04:00:00,2,2,0,FMN GV 11 Ramsel
66,Bergstraat 71,2021-10-06,05:00:00,2,2,0,FMN GV 11 Ramsel
66,Bergstraat 71,2021-10-06,06:00:00,18,10,8,FMN GV 11 Ramsel
66,Bergstraat 71,2021-10-06,07:00:00,40,4,36,FMN GV 11 Ramsel
66,Bergstraat 71,2021-10-06,08:00:00,66,4,62,FMN GV 11 Ramsel
66,Bergstraat 71,2021-10-06,09:00:00,16,6,10,FMN GV 11 Ramsel
66,Bergstraat 71,2021-10-06,10:00:00,8,4,4,FMN GV 11 Ramsel
66,Bergstraat 71,2021-10-06,11:00:00,10,8,2,FMN GV 11 Ramsel
66,Bergstraat 71,2021-10-06,12:00:00,66,58,8,FMN GV 11 Ramsel
66,Bergstraat 71,2021-10-06,13:00:00,18,10,8,FMN GV 11 Ramsel
66,Bergstraat 71,2021-10-06,14:00:00,18,12,6,FMN GV 11 Ramsel
66,Bergstraat 71,2021-10-06,15:00:00,28,10,18,FMN GV 11 Ramsel
66,Bergstraat 71,2021-10-06,16:00:00,66,36,30,FMN GV 11 Ramsel
66,Bergstraat 71,2021-10-06,17:00:00,46,24,22,FMN GV 11 Ramsel
66,Bergstraat 71,2021-10-06,18:00:00,50,24,26,FMN GV 11 Ramsel
66,Bergstraat 71,2021-10-06,19:00:00,28,20,8,FMN GV 11 Ramsel
66,Bergstraat 71,2021-10-06,20:00:00,10,10,0,FMN GV 11 Ramsel
66,Bergstraat 71,2021-10-06,21:00:00,22,10,12,FMN GV 11 Ramsel
66,Bergstraat 71,2021-10-06,22:00:00,8,2,6,FMN GV 11 Ramsel
66,Bergstraat 71,2021-10-06,23:00:00,2,2,0,FMN GV 11 Ramsel
66,Bergstraat 71,2021-10-07,00:00:00,0,0,0,FMN GV 11 Ramsel
66,Bergstraat 71,2021-10-07,01:00:00,0,0,0,FMN GV 11 Ramsel
66,Bergstraat 71,2021-10-07,02:00:00,0,0,0,FMN GV 11 Ramsel
66,Bergstraat 71,2021-10-07,03:00:00,2,0,2,FMN GV 11 Ramsel
66,Bergstraat 71,2021-10-07,04:00:00,2,2,0,FMN GV 11 Ramsel
66,Bergstraat 71,2021-10-07,05:00:00,8,4,4,FMN GV 11 Ramsel
66,Bergstraat 71,2021-10-07,06:00:00,38,12,26,FMN GV 11 Ramsel
66,Bergstraat 71,2021-10-07,07:00:00,254,24,230,FMN GV 11 Ramsel
66,Bergstraat 71,2021-10-07,08:00:00,194,10,184,FMN GV 11 Ramsel
66,Bergstraat 71,2021-10-07,09:00:00,72,20,52,FMN GV 11 Ramsel
66,Bergstraat 71,2021-10-07,10:00:00,52,22,30,FMN GV 11 Ramsel
66,Bergstraat 71,2021-10-07,11:00:00,64,42,22,FMN GV 11 Ramsel
66,Bergstraat 71,2021-10-07,12:00:00,110,74,36,FMN GV 11 Ramsel
66,Bergstraat 71,2021-10-07,13:00:00,138,84,54,FMN GV 11 Ramsel
66,Bergstraat 71,2021-10-07,14:00:00,140,88,52,FMN GV 11 Ramsel
66,Bergstraat 71,2021-10-07,15:00:00,238,180,58,FMN GV 11 Ramsel
66,Bergstraat 71,2021-10-07,16:00:00,210,184,26,FMN GV 11 Ramsel
66,Bergstraat 71,2021-10-07,17:00:00,122,78,44,FMN GV 11 Ramsel
66,Bergstraat 71,2021-10-07,18:00:00,62,30,32,FMN GV 11 Ramsel
66,Bergstraat 71,2021-10-07,19:00:00,62,40,22,FMN GV 11 Ramsel
66,Bergstraat 71,2021-10-07,20:00:00,20,18,2,FMN GV 11 Ramsel
66,Bergstraat 71,2021-10-07,21:00:00,14,6,8,FMN GV 11 Ramsel
66,Bergstraat 71,2021-10-07,22:00:00,12,6,6,FMN GV 11 Ramsel
66,Bergstraat 71,2021-10-07,23:00:00,4,4,0,FMN GV 11 Ramsel
66,Bergstraat 71,2021-10-08,00:00:00,4,2,2,FMN GV 11 Ramsel
66,Bergstraat 71,2021-10-08,01:00:00,0,0,0,FMN GV 11 Ramsel
66,Bergstraat 71,2021-10-08,02:00:00,0,0,0,FMN GV 11 Ramsel
66,Bergstraat 71,2021-10-08,03:00:00,2,0,2,FMN GV 11 Ramsel
66,Bergstraat 71,2021-10-08,04:00:00,2,2,0,FMN GV 11 Ramsel
66,Bergstraat 71,2021-10-08,05:00:00,6,4,2,FMN GV 11 Ramsel
66,Bergstraat 71,2021-10-08,06:00:00,32,12,20,FMN GV 11 Ramsel
66,Bergstraat 71,2021-10-08,07:00:00,204,14,190,FMN GV 11 Ramsel
66,Bergstraat 71,2021-10-08,08:00:00,96,10,86,FMN GV 11 Ramsel
66,Bergstraat 71,2021-10-08,09:00:00,38,12,26,FMN GV 11 Ramsel
66,Bergstraat 71,2021-10-08,10:00:00,54,14,40,FMN GV 11 Ramsel
66,Bergstraat 71,2021-10-08,11:00:00,72,46,26,FMN GV 11 Ramsel
66,Bergstraat 71,2021-10-08,12:00:00,96,50,46,FMN GV 11 Ramsel
66,Bergstraat 71,2021-10-08,13:00:00,214,114,100,FMN GV 11 Ramsel
66,Bergstraat 71,2021-10-08,14:00:00,220,104,116,FMN GV 11 Ramsel
66,Bergstraat 71,2021-10-08,15:00:00,286,210,76,FMN GV 11 Ramsel
66,Bergstraat 71,2021-10-08,16:00:00,262,172,90,FMN GV 11 Ramsel
66,Bergstraat 71,2021-10-08,17:00:00,128,88,40,FMN GV 11 Ramsel
66,Bergstraat 71,2021-10-08,18:00:00,62,36,26,FMN GV 11 Ramsel
66,Bergstraat 71,2021-10-08,19:00:00,40,14,26,FMN GV 11 Ramsel
66,Bergstraat 71,2021-10-08,20:00:00,28,14,14,FMN GV 11 Ramsel
66,Bergstraat 71,2021-10-08,21:00:00,16,8,8,FMN GV 11 Ramsel
66,Bergstraat 71,2021-10-08,22:00:00,20,6,14,FMN GV 11 Ramsel
66,Bergstraat 71,2021-10-08,23:00:00,2,0,2,FMN GV 11 Ramsel
66,Bergstraat 71,2021-10-09,00:00:00,4,2,2,FMN GV 11 Ramsel
66,Bergstraat 71,2021-10-09,01:00:00,2,2,0,FMN GV 11 Ramsel
66,Bergstraat 71,2021-10-09,02:00:00,6,6,0,FMN GV 11 Ramsel
66,Bergstraat 71,2021-10-09,03:00:00,4,4,0,FMN GV 11 Ramsel
66,Bergstraat 71,2021-10-09,04:00:00,2,0,2,FMN GV 11 Ramsel
66,Bergstraat 71,2021-10-09,05:00:00,2,0,2,FMN GV 11 Ramsel
66,Bergstraat 71,2021-10-09,06:00:00,2,0,2,FMN GV 11 Ramsel
66,Bergstraat 71,2021-10-09,07:00:00,10,2,8,FMN GV 11 Ramsel
66,Bergstraat 71,2021-10-09,08:00:00,26,14,12,FMN GV 11 Ramsel
66,Bergstraat 71,2021-10-09,09:00:00,58,32,26,FMN GV 11 Ramsel
66,Bergstraat 71,2021-10-09,10:00:00,118,54,64,FMN GV 11 Ramsel
66,Bergstraat 71,2021-10-09,11:00:00,130,60,70,FMN GV 11 Ramsel
66,Bergstraat 71,2021-10-09,12:00:00,188,62,126,FMN GV 11 Ramsel
66,Bergstraat 71,2021-10-09,13:00:00,214,96,118,FMN GV 11 Ramsel
66,Bergstraat 71,2021-10-09,14:00:00,258,136,122,FMN GV 11 Ramsel
66,Bergstraat 71,2021-10-09,15:00:00,240,152,88,FMN GV 11 Ramsel
66,Bergstraat 71,2021-10-09,16:00:00,208,116,92,FMN GV 11 Ramsel
66,Bergstraat 71,2021-10-09,17:00:00,112,54,58,FMN GV 11 Ramsel
66,Bergstraat 71,2021-10-09,18:00:00,52,22,30,FMN GV 11 Ramsel
66,Bergstraat 71,2021-10-09,19:00:00,40,22,18,FMN GV 11 Ramsel
66,Bergstraat 71,2021-10-09,20:00:00,6,4,2,FMN GV 11 Ramsel
66,Bergstraat 71,2021-10-09,21:00:00,22,12,10,FMN GV 11 Ramsel
66,Bergstraat 71,2021-10-09,22:00:00,20,6,14,FMN GV 11 Ramsel
66,Bergstraat 71,2021-10-09,23:00:00,4,2,2,FMN GV 11 Ramsel
66,Bergstraat 71,2021-10-10,00:00:00,0,0,0,FMN GV 11 Ramsel
66,Bergstraat 71,2021-10-10,01:00:00,10,4,6,FMN GV 11 Ramsel
66,Bergstraat 71,2021-10-10,02:00:00,18,12,6,FMN GV 11 Ramsel
66,Bergstraat 71,2021-10-10,03:00:00,4,4,0,FMN GV 11 Ramsel
66,Bergstraat 71,2021-10-10,04:00:00,4,4,0,FMN GV 11 Ramsel
66,Bergstraat 71,2021-10-10,05:00:00,0,0,0,FMN GV 11 Ramsel
66,Bergstraat 71,2021-10-10,06:00:00,0,0,0,FMN GV 11 Ramsel
66,Bergstraat 71,2021-10-10,07:00:00,12,2,10,FMN GV 11 Ramsel
66,Bergstraat 71,2021-10-10,08:00:00,50,4,46,FMN GV 11 Ramsel
66,Bergstraat 71,2021-10-10,09:00:00,126,48,78,FMN GV 11 Ramsel
66,Bergstraat 71,2021-10-10,10:00:00,198,80,118,FMN GV 11 Ramsel
66,Bergstraat 71,2021-10-10,11:00:00,164,108,56,FMN GV 11 Ramsel
66,Bergstraat 71,2021-10-10,12:00:00,114,56,58,FMN GV 11 Ramsel
66,Bergstraat 71,2021-10-10,13:00:00,146,72,74,FMN GV 11 Ramsel
66,Bergstraat 71,2021-10-10,14:00:00,232,130,102,FMN GV 11 Ramsel
66,Bergstraat 71,2021-10-10,15:00:00,248,122,126,FMN GV 11 Ramsel
66,Bergstraat 71,2021-10-10,16:00:00,156,76,80,FMN GV 11 Ramsel
66,Bergstraat 71,2021-10-10,17:00:00,76,28,48,FMN GV 11 Ramsel
66,Bergstraat 71,2021-10-10,18:00:00,30,12,18,FMN GV 11 Ramsel
66,Bergstraat 71,2021-10-10,19:00:00,42,8,34,FMN GV 11 Ramsel
66,Bergstraat 71,2021-10-10,20:00:00,8,4,4,FMN GV 11 Ramsel
66,Bergstraat 71,2021-10-10,21:00:00,8,4,4,FMN GV 11 Ramsel
66,Bergstraat 71,2021-10-10,22:00:00,8,6,2,FMN GV 11 Ramsel
66,Bergstraat 71,2021-10-10,23:00:00,2,2,0,FMN GV 11 Ramsel
66,Bergstraat 71,2021-10-11,00:00:00,2,0,2,FMN GV 11 Ramsel
66,Bergstraat 71,2021-10-11,01:00:00,0,0,0,FMN GV 11 Ramsel
66,Bergstraat 71,2021-10-11,02:00:00,0,0,0,FMN GV 11 Ramsel
66,Bergstraat 71,2021-10-11,03:00:00,0,0,0,FMN GV 11 Ramsel
66,Bergstraat 71,2021-10-11,04:00:00,2,0,2,FMN GV 11 Ramsel
66,Bergstraat 71,2021-10-11,05:00:00,16,10,6,FMN GV 11 Ramsel
66,Bergstraat 71,2021-10-11,06:00:00,26,8,18,FMN GV 11 Ramsel
66,Bergstraat 71,2021-10-11,07:00:00,248,22,226,FMN GV 11 Ramsel
66,Bergstraat 71,2021-10-11,08:00:00,168,18,150,FMN GV 11 Ramsel
66,Bergstraat 71,2021-10-11,09:00:00,50,14,36,FMN GV 11 Ramsel
66,Bergstraat 71,2021-10-11,10:00:00,32,10,22,FMN GV 11 Ramsel
66,Bergstraat 71,2021-10-11,11:00:00,56,40,16,FMN GV 11 Ramsel
66,Bergstraat 71,2021-10-11,12:00:00,76,32,44,FMN GV 11 Ramsel
66,Bergstraat 71,2021-10-11,13:00:00,98,56,42,FMN GV 11 Ramsel
66,Bergstraat 71,2021-10-11,14:00:00,126,48,78,FMN GV 11 Ramsel
66,Bergstraat 71,2021-10-11,15:00:00,262,224,38,FMN GV 11 Ramsel
66,Bergstraat 71,2021-10-11,16:00:00,176,144,32,FMN GV 11 Ramsel
66,Bergstraat 71,2021-10-11,17:00:00,70,50,20,FMN GV 11 Ramsel
66,Bergstraat 71,2021-10-11,18:00:00,44,32,12,FMN GV 11 Ramsel
66,Bergstraat 71,2021-10-11,19:00:00,20,12,8,FMN GV 11 Ramsel
66,Bergstraat 71,2021-10-11,20:00:00,12,8,4,FMN GV 11 Ramsel
66,Bergstraat 71,2021-10-11,21:00:00,8,6,2,FMN GV 11 Ramsel
66,Bergstraat 71,2021-10-11,22:00:00,22,10,12,FMN GV 11 Ramsel
66,Bergstraat 71,2021-10-11,23:00:00,0,0,0,FMN GV 11 Ramsel
66,Bergstraat 71,2021-10-12,00:00:00,2,2,0,FMN GV 11 Ramsel
66,Bergstraat 71,2021-10-12,01:00:00,0,0,0,FMN GV 11 Ramsel
66,Bergstraat 71,2021-10-12,02:00:00,0,0,0,FMN GV 11 Ramsel
66,Bergstraat 71,2021-10-12,03:00:00,0,0,0,FMN GV 11 Ramsel
66,Bergstraat 71,2021-10-12,04:00:00,4,2,2,FMN GV 11 Ramsel
66,Bergstraat 71,2021-10-12,05:00:00,8,8,0,FMN GV 11 Ramsel
66,Bergstraat 71,2021-10-12,06:00:00,30,14,16,FMN GV 11 Ramsel
66,Bergstraat 71,2021-10-12,07:00:00,202,12,190,FMN GV 11 Ramsel
66,Bergstraat 71,2021-10-12,08:00:00,156,14,142,FMN GV 11 Ramsel
66,Bergstraat 71,2021-10-12,09:00:00,48,18,30,FMN GV 11 Ramsel
66,Bergstraat 71,2021-10-12,10:00:00,24,8,16,FMN GV 11 Ramsel
66,Bergstraat 71,2021-10-12,11:00:00,36,20,16,FMN GV 11 Ramsel
66,Bergstraat 71,2021-10-12,12:00:00,22,20,2,FMN GV 11 Ramsel
66,Bergstraat 71,2021-10-12,13:00:00,24,10,14,FMN GV 11 Ramsel
66,Bergstraat 71,2021-10-12,14:00:00,50,34,16,FMN GV 11 Ramsel
66,Bergstraat 71,2021-10-12,15:00:00,152,146,6,FMN GV 11 Ramsel
66,Bergstraat 71,2021-10-12,16:00:00,104,90,14,FMN GV 11 Ramsel
66,Bergstraat 71,2021-10-12,17:00:00,52,34,18,FMN GV 11 Ramsel
66,Bergstraat 71,2021-10-12,18:00:00,26,18,8,FMN GV 11 Ramsel
66,Bergstraat 71,2021-10-12,19:00:00,22,8,14,FMN GV 11 Ramsel
66,Bergstraat 71,2021-10-12,20:00:00,20,16,4,FMN GV 11 Ramsel
66,Bergstraat 71,2021-10-12,21:00:00,8,4,4,FMN GV 11 Ramsel
66,Bergstraat 71,2021-10-12,22:00:00,4,4,0,FMN GV 11 Ramsel
66,Bergstraat 71,2021-10-12,23:00:00,4,4,0,FMN GV 11 Ramsel
66,Bergstraat 71,2021-10-13,00:00:00,0,0,0,FMN GV 11 Ramsel
66,Bergstraat 71,2021-10-13,01:00:00,0,0,0,FMN GV 11 Ramsel
66,Bergstraat 71,2021-10-13,02:00:00,0,0,0,FMN GV 11 Ramsel
66,Bergstraat 71,2021-10-13,03:00:00,0,0,0,FMN GV 11 Ramsel
66,Bergstraat 71,2021-10-13,04:00:00,2,2,0,FMN GV 11 Ramsel
66,Bergstraat 71,2021-10-13,05:00:00,10,6,4,FMN GV 11 Ramsel
66,Bergstraat 71,2021-10-13,06:00:00,38,12,26,FMN GV 11 Ramsel
66,Bergstraat 71,2021-10-13,07:00:00,210,24,186,FMN GV 11 Ramsel
66,Bergstraat 71,2021-10-13,08:00:00,148,20,128,FMN GV 11 Ramsel
66,Bergstraat 71,2021-10-13,09:00:00,24,10,14,FMN GV 11 Ramsel
66,Bergstraat 71,2021-10-13,10:00:00,40,24,16,FMN GV 11 Ramsel
66,Bergstraat 71,2021-10-13,11:00:00,78,50,28,FMN GV 11 Ramsel
66,Bergstraat 71,2021-10-13,12:00:00,254,220,34,FMN GV 11 Ramsel
66,Bergstraat 71,2021-10-13,13:00:00,110,72,38,FMN GV 11 Ramsel
66,Bergstraat 71,2021-10-13,14:00:00,96,50,46,FMN GV 11 Ramsel
66,Bergstraat 71,2021-10-13,15:00:00,106,62,44,FMN GV 11 Ramsel
66,Bergstraat 71,2021-10-13,16:00:00,84,54,30,FMN GV 11 Ramsel
66,Bergstraat 71,2021-10-13,17:00:00,70,38,32,FMN GV 11 Ramsel
66,Bergstraat 71,2021-10-13,18:00:00,66,34,32,FMN GV 11 Ramsel
66,Bergstraat 71,2021-10-13,19:00:00,58,42,16,FMN GV 11 Ramsel
66,Bergstraat 71,2021-10-13,20:00:00,16,10,6,FMN GV 11 Ramsel
66,Bergstraat 71,2021-10-13,21:00:00,6,4,2,FMN GV 11 Ramsel
66,Bergstraat 71,2021-10-13,22:00:00,20,14,6,FMN GV 11 Ramsel
66,Bergstraat 71,2021-10-13,23:00:00,2,2,0,FMN GV 11 Ramsel
66,Bergstraat 71,2021-10-14,00:00:00,0,0,0,FMN GV 11 Ramsel
66,Bergstraat 71,2021-10-14,01:00:00,2,0,2,FMN GV 11 Ramsel
66,Bergstraat 71,2021-10-14,02:00:00,0,0,0,FMN GV 11 Ramsel
66,Bergstraat 71,2021-10-14,03:00:00,0,0,0,FMN GV 11 Ramsel
66,Bergstraat 71,2021-10-14,04:00:00,6,6,0,FMN GV 11 Ramsel
66,Bergstraat 71,2021-10-14,05:00:00,10,8,2,FMN GV 11 Ramsel
66,Bergstraat 71,2021-10-14,06:00:00,28,10,18,FMN GV 11 Ramsel
66,Bergstraat 71,2021-10-14,07:00:00,238,18,220,FMN GV 11 Ramsel
66,Bergstraat 71,2021-10-14,08:00:00,188,34,154,FMN GV 11 Ramsel
66,Bergstraat 71,2021-10-14,09:00:00,92,38,54,FMN GV 11 Ramsel
66,Bergstraat 71,2021-10-14,10:00:00,64,32,32,FMN GV 11 Ramsel
66,Bergstraat 71,2021-10-14,11:00:00,80,56,24,FMN GV 11 Ramsel
66,Bergstraat 71,2021-10-14,12:00:00,56,32,24,FMN GV 11 Ramsel
66,Bergstraat 71,2021-10-14,13:00:00,142,66,76,FMN GV 11 Ramsel
66,Bergstraat 71,2021-10-14,14:00:00,102,48,54,FMN GV 11 Ramsel
66,Bergstraat 71,2021-10-14,15:00:00,280,236,44,FMN GV 11 Ramsel
66,Bergstraat 71,2021-10-14,16:00:00,186,148,38,FMN GV 11 Ramsel
66,Bergstraat 71,2021-10-14,17:00:00,96,70,26,FMN GV 11 Ramsel
66,Bergstraat 71,2021-10-14,18:00:00,42,28,14,FMN GV 11 Ramsel
66,Bergstraat 71,2021-10-14,19:00:00,42,24,18,FMN GV 11 Ramsel
66,Bergstraat 71,2021-10-14,20:00:00,24,16,8,FMN GV 11 Ramsel
66,Bergstraat 71,2021-10-14,21:00:00,12,10,2,FMN GV 11 Ramsel
66,Bergstraat 71,2021-10-14,22:00:00,20,14,6,FMN GV 11 Ramsel
66,Bergstraat 71,2021-10-14,23:00:00,0,0,0,FMN GV 11 Ramsel
66,Bergstraat 71,2021-10-15,00:00:00,6,6,0,FMN GV 11 Ramsel
66,Bergstraat 71,2021-10-15,01:00:00,0,0,0,FMN GV 11 Ramsel
66,Bergstraat 71,2021-10-15,02:00:00,0,0,0,FMN GV 11 Ramsel
66,Bergstraat 71,2021-10-15,03:00:00,0,0,0,FMN GV 11 Ramsel
66,Bergstraat 71,2021-10-15,04:00:00,4,4,0,FMN GV 11 Ramsel
66,Bergstraat 71,2021-10-15,05:00:00,8,8,0,FMN GV 11 Ramsel
66,Bergstraat 71,2021-10-15,06:00:00,14,2,12,FMN GV 11 Ramsel
66,Bergstraat 71,2021-10-15,07:00:00,212,18,194,FMN GV 11 Ramsel
66,Bergstraat 71,2021-10-15,08:00:00,182,28,154,FMN GV 11 Ramsel
66,Bergstraat 71,2021-10-15,09:00:00,52,28,24,FMN GV 11 Ramsel
66,Bergstraat 71,2021-10-15,10:00:00,30,14,16,FMN GV 11 Ramsel
66,Bergstraat 71,2021-10-15,11:00:00,26,20,6,FMN GV 11 Ramsel
66,Bergstraat 71,2021-10-15,12:00:00,44,20,24,FMN GV 11 Ramsel
66,Bergstraat 71,2021-10-15,13:00:00,46,22,24,FMN GV 11 Ramsel
66,Bergstraat 71,2021-10-15,14:00:00,90,44,46,FMN GV 11 Ramsel
66,Bergstraat 71,2021-10-15,15:00:00,234,182,52,FMN GV 11 Ramsel
66,Bergstraat 71,2021-10-15,16:00:00,146,116,30,FMN GV 11 Ramsel
66,Bergstraat 71,2021-10-15,17:00:00,84,58,26,FMN GV 11 Ramsel
66,Bergstraat 71,2021-10-15,18:00:00,50,24,26,FMN GV 11 Ramsel
66,Bergstraat 71,2021-10-15,19:00:00,42,20,22,FMN GV 11 Ramsel
66,Bergstraat 71,2021-10-15,20:00:00,34,16,18,FMN GV 11 Ramsel
66,Bergstraat 71,2021-10-15,21:00:00,16,12,4,FMN GV 11 Ramsel
66,Bergstraat 71,2021-10-15,22:00:00,10,6,4,FMN GV 11 Ramsel
66,Bergstraat 71,2021-10-15,23:00:00,0,0,0,FMN GV 11 Ramsel
66,Bergstraat 71,2021-10-16,00:00:00,24,14,10,FMN GV 11 Ramsel
66,Bergstraat 71,2021-10-16,01:00:00,6,6,0,FMN GV 11 Ramsel
66,Bergstraat 71,2021-10-16,02:00:00,8,8,0,FMN GV 11 Ramsel
66,Bergstraat 71,2021-10-16,03:00:00,2,0,2,FMN GV 11 Ramsel
66,Bergstraat 71,2021-10-16,04:00:00,0,0,0,FMN GV 11 Ramsel
66,Bergstraat 71,2021-10-16,05:00:00,4,4,0,FMN GV 11 Ramsel
66,Bergstraat 71,2021-10-16,06:00:00,2,2,0,FMN GV 11 Ramsel
66,Bergstraat 71,2021-10-16,07:00:00,4,0,4,FMN GV 11 Ramsel
66,Bergstraat 71,2021-10-16,08:00:00,20,6,14,FMN GV 11 Ramsel
66,Bergstraat 71,2021-10-16,09:00:00,56,22,34,FMN GV 11 Ramsel
66,Bergstraat 71,2021-10-16,10:00:00,76,26,50,FMN GV 11 Ramsel
66,Bergstraat 71,2021-10-16,11:00:00,100,52,48,FMN GV 11 Ramsel
66,Bergstraat 71,2021-10-16,12:00:00,126,80,46,FMN GV 11 Ramsel
66,Bergstraat 71,2021-10-16,13:00:00,246,98,148,FMN GV 11 Ramsel
66,Bergstraat 71,2021-10-16,14:00:00,242,102,140,FMN GV 11 Ramsel
66,Bergstraat 71,2021-10-16,15:00:00,180,88,92,FMN GV 11 Ramsel
66,Bergstraat 71,2021-10-16,16:00:00,92,44,48,FMN GV 11 Ramsel
66,Bergstraat 71,2021-10-16,17:00:00,96,62,34,FMN GV 11 Ramsel
66,Bergstraat 71,2021-10-16,18:00:00,28,16,12,FMN GV 11 Ramsel
66,Bergstraat 71,2021-10-16,19:00:00,20,8,12,FMN GV 11 Ramsel
66,Bergstraat 71,2021-10-16,20:00:00,32,12,20,FMN GV 11 Ramsel
66,Bergstraat 71,2021-10-16,21:00:00,8,4,4,FMN GV 11 Ramsel
66,Bergstraat 71,2021-10-16,22:00:00,6,6,0,FMN GV 11 Ramsel
66,Bergstraat 71,2021-10-16,23:00:00,4,4,0,FMN GV 11 Ramsel
66,Bergstraat 71,2021-10-17,00:00:00,2,2,0,FMN GV 11 Ramsel
66,Bergstraat 71,2021-10-17,01:00:00,6,4,2,FMN GV 11 Ramsel
66,Bergstraat 71,2021-10-17,02:00:00,8,6,2,FMN GV 11 Ramsel
66,Bergstraat 71,2021-10-17,03:00:00,0,0,0,FMN GV 11 Ramsel
66,Bergstraat 71,2021-10-17,04:00:00,0,0,0,FMN GV 11 Ramsel
66,Bergstraat 71,2021-10-17,05:00:00,2,2,0,FMN GV 11 Ramsel
66,Bergstraat 71,2021-10-17,06:00:00,4,4,0,FMN GV 11 Ramsel
66,Bergstraat 71,2021-10-17,07:00:00,42,0,42,FMN GV 11 Ramsel
66,Bergstraat 71,2021-10-17,08:00:00,100,14,86,FMN GV 11 Ramsel
66,Bergstraat 71,2021-10-17,09:00:00,92,12,80,FMN GV 11 Ramsel
66,Bergstraat 71,2021-10-17,10:00:00,174,132,42,FMN GV 11 Ramsel
66,Bergstraat 71,2021-10-17,11:00:00,196,102,94,FMN GV 11 Ramsel
66,Bergstraat 71,2021-10-17,12:00:00,108,66,42,FMN GV 11 Ramsel
66,Bergstraat 71,2021-10-17,13:00:00,194,88,106,FMN GV 11 Ramsel
66,Bergstraat 71,2021-10-17,14:00:00,236,106,130,FMN GV 11 Ramsel
66,Bergstraat 71,2021-10-17,15:00:00,206,88,118,FMN GV 11 Ramsel
66,Bergstraat 71,2021-10-17,16:00:00,112,72,40,FMN GV 11 Ramsel
66,Bergstraat 71,2021-10-17,17:00:00,74,32,42,FMN GV 11 Ramsel
66,Bergstraat 71,2021-10-17,18:00:00,26,18,8,FMN GV 11 Ramsel
66,Bergstraat 71,2021-10-17,19:00:00,32,18,14,FMN GV 11 Ramsel
66,Bergstraat 71,2021-10-17,20:00:00,4,4,0,FMN GV 11 Ramsel
66,Bergstraat 71,2021-10-17,21:00:00,2,2,0,FMN GV 11 Ramsel
66,Bergstraat 71,2021-10-17,22:00:00,2,2,0,FMN GV 11 Ramsel
66,Bergstraat 71,2021-10-17,23:00:00,6,2,4,FMN GV 11 Ramsel
66,Bergstraat 71,2021-10-18,00:00:00,2,0,2,FMN GV 11 Ramsel
66,Bergstraat 71,2021-10-18,01:00:00,0,0,0,FMN GV 11 Ramsel
66,Bergstraat 71,2021-10-18,02:00:00,0,0,0,FMN GV 11 Ramsel
66,Bergstraat 71,2021-10-18,03:00:00,2,0,2,FMN GV 11 Ramsel
66,Bergstraat 71,2021-10-18,04:00:00,4,2,2,FMN GV 11 Ramsel
66,Bergstraat 71,2021-10-18,05:00:00,12,8,4,FMN GV 11 Ramsel
66,Bergstraat 71,2021-10-18,06:00:00,16,4,12,FMN GV 11 Ramsel
66,Bergstraat 71,2021-10-18,07:00:00,264,20,244,FMN GV 11 Ramsel
66,Bergstraat 71,2021-10-18,08:00:00,222,22,200,FMN GV 11 Ramsel
66,Bergstraat 71,2021-10-18,09:00:00,48,22,26,FMN GV 11 Ramsel
66,Bergstraat 71,2021-10-18,10:00:00,62,26,36,FMN GV 11 Ramsel
66,Bergstraat 71,2021-10-18,11:00:00,52,18,34,FMN GV 11 Ramsel
66,Bergstraat 71,2021-10-18,12:00:00,98,38,60,FMN GV 11 Ramsel
66,Bergstraat 71,2021-10-18,13:00:00,180,70,110,FMN GV 11 Ramsel
66,Bergstraat 71,2021-10-18,14:00:00,174,82,92,FMN GV 11 Ramsel
66,Bergstraat 71,2021-10-18,15:00:00,350,290,60,FMN GV 11 Ramsel
66,Bergstraat 71,2021-10-18,16:00:00,234,188,46,FMN GV 11 Ramsel
66,Bergstraat 71,2021-10-18,17:00:00,90,60,30,FMN GV 11 Ramsel
66,Bergstraat 71,2021-10-18,18:00:00,66,40,26,FMN GV 11 Ramsel
66,Bergstraat 71,2021-10-18,19:00:00,24,16,8,FMN GV 11 Ramsel
66,Bergstraat 71,2021-10-18,20:00:00,28,22,6,FMN GV 11 Ramsel
66,Bergstraat 71,2021-10-18,21:00:00,4,2,2,FMN GV 11 Ramsel
66,Bergstraat 71,2021-10-18,22:00:00,26,12,14,FMN GV 11 Ramsel
66,Bergstraat 71,2021-10-18,23:00:00,6,2,4,FMN GV 11 Ramsel
66,Bergstraat 71,2021-10-19,00:00:00,0,0,0,FMN GV 11 Ramsel
66,Bergstraat 71,2021-10-19,01:00:00,0,0,0,FMN GV 11 Ramsel
66,Bergstraat 71,2021-10-19,02:00:00,0,0,0,FMN GV 11 Ramsel
66,Bergstraat 71,2021-10-19,03:00:00,2,0,2,FMN GV 11 Ramsel
66,Bergstraat 71,2021-10-19,04:00:00,0,0,0,FMN GV 11 Ramsel
66,Bergstraat 71,2021-10-19,05:00:00,10,6,4,FMN GV 11 Ramsel
66,Bergstraat 71,2021-10-19,06:00:00,30,8,22,FMN GV 11 Ramsel
66,Bergstraat 71,2021-10-19,07:00:00,220,24,196,FMN GV 11 Ramsel
66,Bergstraat 71,2021-10-19,08:00:00,186,32,154,FMN GV 11 Ramsel
66,Bergstraat 71,2021-10-19,09:00:00,36,8,28,FMN GV 11 Ramsel
66,Bergstraat 71,2021-10-19,10:00:00,34,12,22,FMN GV 11 Ramsel
66,Bergstraat 71,2021-10-19,11:00:00,30,12,18,FMN GV 11 Ramsel
66,Bergstraat 71,2021-10-19,12:00:00,58,38,20,FMN GV 11 Ramsel
66,Bergstraat 71,2021-10-19,13:00:00,124,56,68,FMN GV 11 Ramsel
66,Bergstraat 71,2021-10-19,14:00:00,106,68,38,FMN GV 11 Ramsel
66,Bergstraat 71,2021-10-19,15:00:00,232,182,50,FMN GV 11 Ramsel
66,Bergstraat 71,2021-10-19,16:00:00,152,122,30,FMN GV 11 Ramsel
66,Bergstraat 71,2021-10-19,17:00:00,82,40,42,FMN GV 11 Ramsel
66,Bergstraat 71,2021-10-19,18:00:00,38,22,16,FMN GV 11 Ramsel
66,Bergstraat 71,2021-10-19,19:00:00,48,24,24,FMN GV 11 Ramsel
66,Bergstraat 71,2021-10-19,20:00:00,42,30,12,FMN GV 11 Ramsel
66,Bergstraat 71,2021-10-19,21:00:00,14,12,2,FMN GV 11 Ramsel
66,Bergstraat 71,2021-10-19,22:00:00,22,14,8,FMN GV 11 Ramsel
66,Bergstraat 71,2021-10-19,23:00:00,8,8,0,FMN GV 11 Ramsel
66,Bergstraat 71,2021-10-20,00:00:00,0,0,0,FMN GV 11 Ramsel
66,Bergstraat 71,2021-10-20,01:00:00,0,0,0,FMN GV 11 Ramsel
66,Bergstraat 71,2021-10-20,02:00:00,0,0,0,FMN GV 11 Ramsel
66,Bergstraat 71,2021-10-20,03:00:00,0,0,0,FMN GV 11 Ramsel
66,Bergstraat 71,2021-10-20,04:00:00,0,0,0,FMN GV 11 Ramsel
66,Bergstraat 71,2021-10-20,05:00:00,10,6,4,FMN GV 11 Ramsel
66,Bergstraat 71,2021-10-20,06:00:00,30,10,20,FMN GV 11 Ramsel
66,Bergstraat 71,2021-10-20,07:00:00,214,18,196,FMN GV 11 Ramsel
66,Bergstraat 71,2021-10-20,08:00:00,198,28,170,FMN GV 11 Ramsel
66,Bergstraat 71,2021-10-20,09:00:00,16,6,10,FMN GV 11 Ramsel
66,Bergstraat 71,2021-10-20,10:00:00,20,8,12,FMN GV 11 Ramsel
66,Bergstraat 71,2021-10-20,11:00:00,44,30,14,FMN GV 11 Ramsel
66,Bergstraat 71,2021-10-20,12:00:00,252,226,26,FMN GV 11 Ramsel
66,Bergstraat 71,2021-10-20,13:00:00,36,20,16,FMN GV 11 Ramsel
66,Bergstraat 71,2021-10-20,14:00:00,50,26,24,FMN GV 11 Ramsel
66,Bergstraat 71,2021-10-20,15:00:00,48,22,26,FMN GV 11 Ramsel
66,Bergstraat 71,2021-10-20,16:00:00,72,48,24,FMN GV 11 Ramsel
66,Bergstraat 71,2021-10-20,17:00:00,66,46,20,FMN GV 11 Ramsel
66,Bergstraat 71,2021-10-20,18:00:00,30,20,10,FMN GV 11 Ramsel
66,Bergstraat 71,2021-10-20,19:00:00,38,22,16,FMN GV 11 Ramsel
66,Bergstraat 71,2021-10-20,20:00:00,10,8,2,FMN GV 11 Ramsel
66,Bergstraat 71,2021-10-20,21:00:00,0,0,0,FMN GV 11 Ramsel
66,Bergstraat 71,2021-10-20,22:00:00,12,8,4,FMN GV 11 Ramsel
66,Bergstraat 71,2021-10-20,23:00:00,0,0,0,FMN GV 11 Ramsel
66,Bergstraat 71,2021-10-21,00:00:00,0,0,0,FMN GV 11 Ramsel
66,Bergstraat 71,2021-10-21,01:00:00,0,0,0,FMN GV 11 Ramsel
66,Bergstraat 71,2021-10-21,02:00:00,0,0,0,FMN GV 11 Ramsel
66,Bergstraat 71,2021-10-21,03:00:00,0,0,0,FMN GV 11 Ramsel
66,Bergstraat 71,2021-10-21,04:00:00,0,0,0,FMN GV 11 Ramsel
66,Bergstraat 71,2021-10-21,05:00:00,4,2,2,FMN GV 11 Ramsel
66,Bergstraat 71,2021-10-21,06:00:00,10,4,6,FMN GV 11 Ramsel
66,Bergstraat 71,2021-10-21,07:00:00,76,6,70,FMN GV 11 Ramsel
66,Bergstraat 71,2021-10-21,08:00:00,56,12,44,FMN GV 11 Ramsel
66,Bergstraat 71,2021-10-21,09:00:00,18,8,10,FMN GV 11 Ramsel
66,Bergstraat 71,2021-10-21,10:00:00,14,8,6,FMN GV 11 Ramsel
66,Bergstraat 71,2021-10-21,11:00:00,12,6,6,FMN GV 11 Ramsel
66,Bergstraat 71,2021-10-21,12:00:00,22,20,2,FMN GV 11 Ramsel
66,Bergstraat 71,2021-10-21,13:00:00,14,10,4,FMN GV 11 Ramsel
66,Bergstraat 71,2021-10-21,14:00:00,10,4,6,FMN GV 11 Ramsel
66,Bergstraat 71,2021-10-21,15:00:00,40,32,8,FMN GV 11 Ramsel
66,Bergstraat 71,2021-10-21,16:00:00,62,54,8,FMN GV 11 Ramsel
66,Bergstraat 71,2021-10-21,17:00:00,28,22,6,FMN GV 11 Ramsel
66,Bergstraat 71,2021-10-21,18:00:00,16,6,10,FMN GV 11 Ramsel
66,Bergstraat 71,2021-10-21,19:00:00,18,6,12,FMN GV 11 Ramsel
66,Bergstraat 71,2021-10-21,20:00:00,6,2,4,FMN GV 11 Ramsel
66,Bergstraat 71,2021-10-21,21:00:00,8,6,2,FMN GV 11 Ramsel
66,Bergstraat 71,2021-10-21,22:00:00,10,4,6,FMN GV 11 Ramsel
66,Bergstraat 71,2021-10-21,23:00:00,10,8,2,FMN GV 11 Ramsel
66,Bergstraat 71,2021-10-22,00:00:00,2,0,2,FMN GV 11 Ramsel
66,Bergstraat 71,2021-10-22,01:00:00,0,0,0,FMN GV 11 Ramsel
66,Bergstraat 71,2021-10-22,02:00:00,0,0,0,FMN GV 11 Ramsel
66,Bergstraat 71,2021-10-22,03:00:00,0,0,0,FMN GV 11 Ramsel
66,Bergstraat 71,2021-10-22,04:00:00,2,2,0,FMN GV 11 Ramsel
66,Bergstraat 71,2021-10-22,05:00:00,10,6,4,FMN GV 11 Ramsel
66,Bergstraat 71,2021-10-22,06:00:00,28,6,22,FMN GV 11 Ramsel
66,Bergstraat 71,2021-10-22,07:00:00,280,16,264,FMN GV 11 Ramsel
66,Bergstraat 71,2021-10-22,08:00:00,102,12,90,FMN GV 11 Ramsel
66,Bergstraat 71,2021-10-22,09:00:00,50,16,34,FMN GV 11 Ramsel
66,Bergstraat 71,2021-10-22,10:00:00,40,24,16,FMN GV 11 Ramsel
66,Bergstraat 71,2021-10-22,11:00:00,48,28,20,FMN GV 11 Ramsel
66,Bergstraat 71,2021-10-22,12:00:00,94,52,42,FMN GV 11 Ramsel
66,Bergstraat 71,2021-10-22,13:00:00,88,44,44,FMN GV 11 Ramsel
66,Bergstraat 71,2021-10-22,14:00:00,104,56,48,FMN GV 11 Ramsel
66,Bergstraat 71,2021-10-22,15:00:00,140,126,14,FMN GV 11 Ramsel
66,Bergstraat 71,2021-10-22,16:00:00,182,162,20,FMN GV 11 Ramsel
66,Bergstraat 71,2021-10-22,17:00:00,76,50,26,FMN GV 11 Ramsel
66,Bergstraat 71,2021-10-22,18:00:00,42,24,18,FMN GV 11 Ramsel
66,Bergstraat 71,2021-10-22,19:00:00,16,4,12,FMN GV 11 Ramsel
66,Bergstraat 71,2021-10-22,20:00:00,10,6,4,FMN GV 11 Ramsel
66,Bergstraat 71,2021-10-22,21:00:00,10,0,10,FMN GV 11 Ramsel
66,Bergstraat 71,2021-10-22,22:00:00,16,6,10,FMN GV 11 Ramsel
66,Bergstraat 71,2021-10-22,23:00:00,4,4,0,FMN GV 11 Ramsel
66,Bergstraat 71,2021-10-23,00:00:00,2,2,0,FMN GV 11 Ramsel
66,Bergstraat 71,2021-10-23,01:00:00,6,4,2,FMN GV 11 Ramsel
66,Bergstraat 71,2021-10-23,02:00:00,12,12,0,FMN GV 11 Ramsel
66,Bergstraat 71,2021-10-23,03:00:00,2,0,2,FMN GV 11 Ramsel
66,Bergstraat 71,2021-10-23,04:00:00,6,6,0,FMN GV 11 Ramsel
66,Bergstraat 71,2021-10-23,05:00:00,2,0,2,FMN GV 11 Ramsel
66,Bergstraat 71,2021-10-23,06:00:00,8,4,4,FMN GV 11 Ramsel
66,Bergstraat 71,2021-10-23,07:00:00,8,0,8,FMN GV 11 Ramsel
66,Bergstraat 71,2021-10-23,08:00:00,34,10,24,FMN GV 11 Ramsel
66,Bergstraat 71,2021-10-23,09:00:00,52,14,38,FMN GV 11 Ramsel
66,Bergstraat 71,2021-10-23,10:00:00,70,36,34,FMN GV 11 Ramsel
66,Bergstraat 71,2021-10-23,11:00:00,66,36,30,FMN GV 11 Ramsel
66,Bergstraat 71,2021-10-23,12:00:00,76,46,30,FMN GV 11 Ramsel
66,Bergstraat 71,2021-10-23,13:00:00,214,72,142,FMN GV 11 Ramsel
66,Bergstraat 71,2021-10-23,14:00:00,156,68,88,FMN GV 11 Ramsel
66,Bergstraat 71,2021-10-23,15:00:00,120,84,36,FMN GV 11 Ramsel
66,Bergstraat 71,2021-10-23,16:00:00,134,70,64,FMN GV 11 Ramsel
66,Bergstraat 71,2021-10-23,17:00:00,64,22,42,FMN GV 11 Ramsel
66,Bergstraat 71,2021-10-23,18:00:00,56,30,26,FMN GV 11 Ramsel
66,Bergstraat 71,2021-10-23,19:00:00,32,0,32,FMN GV 11 Ramsel
66,Bergstraat 71,2021-10-23,20:00:00,14,2,12,FMN GV 11 Ramsel
66,Bergstraat 71,2021-10-23,21:00:00,2,2,0,FMN GV 11 Ramsel
66,Bergstraat 71,2021-10-23,22:00:00,16,14,2,FMN GV 11 Ramsel
66,Bergstraat 71,2021-10-23,23:00:00,14,14,0,FMN GV 11 Ramsel
66,Bergstraat 71,2021-10-24,00:00:00,4,4,0,FMN GV 11 Ramsel
66,Bergstraat 71,2021-10-24,01:00:00,24,24,0,FMN GV 11 Ramsel
66,Bergstraat 71,2021-10-24,02:00:00,2,2,0,FMN GV 11 Ramsel
66,Bergstraat 71,2021-10-24,03:00:00,0,0,0,FMN GV 11 Ramsel
66,Bergstraat 71,2021-10-24,04:00:00,2,2,0,FMN GV 11 Ramsel
66,Bergstraat 71,2021-10-24,05:00:00,8,8,0,FMN GV 11 Ramsel
66,Bergstraat 71,2021-10-24,06:00:00,6,2,4,FMN GV 11 Ramsel
66,Bergstraat 71,2021-10-24,07:00:00,6,4,2,FMN GV 11 Ramsel
66,Bergstraat 71,2021-10-24,08:00:00,40,10,30,FMN GV 11 Ramsel
66,Bergstraat 71,2021-10-24,09:00:00,96,30,66,FMN GV 11 Ramsel
66,Bergstraat 71,2021-10-24,10:00:00,188,78,110,FMN GV 11 Ramsel
66,Bergstraat 71,2021-10-24,11:00:00,134,78,56,FMN GV 11 Ramsel
66,Bergstraat 71,2021-10-24,12:00:00,146,78,68,FMN GV 11 Ramsel
66,Bergstraat 71,2021-10-24,13:00:00,172,90,82,FMN GV 11 Ramsel
66,Bergstraat 71,2021-10-24,14:00:00,252,120,132,FMN GV 11 Ramsel
66,Bergstraat 71,2021-10-24,15:00:00,232,120,112,FMN GV 11 Ramsel
66,Bergstraat 71,2021-10-24,16:00:00,122,82,40,FMN GV 11 Ramsel
66,Bergstraat 71,2021-10-24,17:00:00,50,30,20,FMN GV 11 Ramsel
66,Bergstraat 71,2021-10-24,18:00:00,48,22,26,FMN GV 11 Ramsel
66,Bergstraat 71,2021-10-24,19:00:00,14,10,4,FMN GV 11 Ramsel
66,Bergstraat 71,2021-10-24,20:00:00,10,4,6,FMN GV 11 Ramsel
66,Bergstraat 71,2021-10-24,21:00:00,6,6,0,FMN GV 11 Ramsel
66,Bergstraat 71,2021-10-24,22:00:00,0,0,0,FMN GV 11 Ramsel
66,Bergstraat 71,2021-10-24,23:00:00,2,2,0,FMN GV 11 Ramsel
66,Bergstraat 71,2021-10-25,00:00:00,0,0,0,FMN GV 11 Ramsel
66,Bergstraat 71,2021-10-25,01:00:00,2,2,0,FMN GV 11 Ramsel
66,Bergstraat 71,2021-10-25,02:00:00,0,0,0,FMN GV 11 Ramsel
66,Bergstraat 71,2021-10-25,03:00:00,0,0,0,FMN GV 11 Ramsel
66,Bergstraat 71,2021-10-25,04:00:00,2,2,0,FMN GV 11 Ramsel
66,Bergstraat 71,2021-10-25,05:00:00,12,6,6,FMN GV 11 Ramsel
66,Bergstraat 71,2021-10-25,06:00:00,26,6,20,FMN GV 11 Ramsel
66,Bergstraat 71,2021-10-25,07:00:00,194,22,172,FMN GV 11 Ramsel
66,Bergstraat 71,2021-10-25,08:00:00,150,6,144,FMN GV 11 Ramsel
66,Bergstraat 71,2021-10-25,09:00:00,30,10,20,FMN GV 11 Ramsel
66,Bergstraat 71,2021-10-25,10:00:00,34,18,16,FMN GV 11 Ramsel
66,Bergstraat 71,2021-10-25,11:00:00,32,12,20,FMN GV 11 Ramsel
66,Bergstraat 71,2021-10-25,12:00:00,44,24,20,FMN GV 11 Ramsel
66,Bergstraat 71,2021-10-25,13:00:00,84,52,32,FMN GV 11 Ramsel
66,Bergstraat 71,2021-10-25,14:00:00,74,46,28,FMN GV 11 Ramsel
66,Bergstraat 71,2021-10-25,15:00:00,242,168,74,FMN GV 11 Ramsel
66,Bergstraat 71,2021-10-25,16:00:00,128,88,40,FMN GV 11 Ramsel
66,Bergstraat 71,2021-10-25,17:00:00,80,56,24,FMN GV 11 Ramsel
66,Bergstraat 71,2021-10-25,18:00:00,50,40,10,FMN GV 11 Ramsel
66,Bergstraat 71,2021-10-25,19:00:00,22,10,12,FMN GV 11 Ramsel
66,Bergstraat 71,2021-10-25,20:00:00,22,12,10,FMN GV 11 Ramsel
66,Bergstraat 71,2021-10-25,21:00:00,10,10,0,FMN GV 11 Ramsel
66,Bergstraat 71,2021-10-25,22:00:00,6,4,2,FMN GV 11 Ramsel
66,Bergstraat 71,2021-10-25,23:00:00,2,0,2,FMN GV 11 Ramsel
66,Bergstraat 71,2021-10-26,00:00:00,2,2,0,FMN GV 11 Ramsel
66,Bergstraat 71,2021-10-26,01:00:00,0,0,0,FMN GV 11 Ramsel
66,Bergstraat 71,2021-10-26,02:00:00,0,0,0,FMN GV 11 Ramsel
66,Bergstraat 71,2021-10-26,03:00:00,0,0,0,FMN GV 11 Ramsel
66,Bergstraat 71,2021-10-26,04:00:00,2,2,0,FMN GV 11 Ramsel
66,Bergstraat 71,2021-10-26,05:00:00,14,8,6,FMN GV 11 Ramsel
66,Bergstraat 71,2021-10-26,06:00:00,26,6,20,FMN GV 11 Ramsel
66,Bergstraat 71,2021-10-26,07:00:00,244,22,222,FMN GV 11 Ramsel
66,Bergstraat 71,2021-10-26,08:00:00,178,10,168,FMN GV 11 Ramsel
66,Bergstraat 71,2021-10-26,09:00:00,54,22,32,FMN GV 11 Ramsel
66,Bergstraat 71,2021-10-26,10:00:00,86,30,56,FMN GV 11 Ramsel
66,Bergstraat 71,2021-10-26,11:00:00,46,22,24,FMN GV 11 Ramsel
66,Bergstraat 71,2021-10-26,12:00:00,128,70,58,FMN GV 11 Ramsel
66,Bergstraat 71,2021-10-26,13:00:00,150,56,94,FMN GV 11 Ramsel
66,Bergstraat 71,2021-10-26,14:00:00,134,68,66,FMN GV 11 Ramsel
66,Bergstraat 71,2021-10-26,15:00:00,276,236,40,FMN GV 11 Ramsel
66,Bergstraat 71,2021-10-26,16:00:00,170,134,36,FMN GV 11 Ramsel
66,Bergstraat 71,2021-10-26,17:00:00,82,52,30,FMN GV 11 Ramsel
66,Bergstraat 71,2021-10-26,18:00:00,44,28,16,FMN GV 11 Ramsel
66,Bergstraat 71,2021-10-26,19:00:00,44,16,28,FMN GV 11 Ramsel
66,Bergstraat 71,2021-10-26,20:00:00,32,24,8,FMN GV 11 Ramsel
66,Bergstraat 71,2021-10-26,21:00:00,18,12,6,FMN GV 11 Ramsel
66,Bergstraat 71,2021-10-26,22:00:00,16,12,4,FMN GV 11 Ramsel
66,Bergstraat 71,2021-10-26,23:00:00,4,0,4,FMN GV 11 Ramsel
66,Bergstraat 71,2021-10-27,00:00:00,2,2,0,FMN GV 11 Ramsel
66,Bergstraat 71,2021-10-27,01:00:00,0,0,0,FMN GV 11 Ramsel
66,Bergstraat 71,2021-10-27,02:00:00,0,0,0,FMN GV 11 Ramsel
66,Bergstraat 71,2021-10-27,03:00:00,0,0,0,FMN GV 11 Ramsel
66,Bergstraat 71,2021-10-27,04:00:00,2,2,0,FMN GV 11 Ramsel
66,Bergstraat 71,2021-10-27,05:00:00,16,10,6,FMN GV 11 Ramsel
66,Bergstraat 71,2021-10-27,06:00:00,30,10,20,FMN GV 11 Ramsel
66,Bergstraat 71,2021-10-27,07:00:00,224,20,204,FMN GV 11 Ramsel
66,Bergstraat 71,2021-10-27,08:00:00,158,16,142,FMN GV 11 Ramsel
66,Bergstraat 71,2021-10-27,09:00:00,44,26,18,FMN GV 11 Ramsel
66,Bergstraat 71,2021-10-27,10:00:00,56,20,36,FMN GV 11 Ramsel
66,Bergstraat 71,2021-10-27,11:00:00,64,42,22,FMN GV 11 Ramsel
66,Bergstraat 71,2021-10-27,12:00:00,266,226,40,FMN GV 11 Ramsel
66,Bergstraat 71,2021-10-27,13:00:00,120,56,64,FMN GV 11 Ramsel
66,Bergstraat 71,2021-10-27,14:00:00,142,64,78,FMN GV 11 Ramsel
66,Bergstraat 71,2021-10-27,15:00:00,150,98,52,FMN GV 11 Ramsel
66,Bergstraat 71,2021-10-27,16:00:00,172,110,62,FMN GV 11 Ramsel
66,Bergstraat 71,2021-10-27,17:00:00,112,58,54,FMN GV 11 Ramsel
66,Bergstraat 71,2021-10-27,18:00:00,86,50,36,FMN GV 11 Ramsel
66,Bergstraat 71,2021-10-27,19:00:00,36,20,16,FMN GV 11 Ramsel
66,Bergstraat 71,2021-10-27,20:00:00,24,16,8,FMN GV 11 Ramsel
66,Bergstraat 71,2021-10-27,21:00:00,16,16,0,FMN GV 11 Ramsel
66,Bergstraat 71,2021-10-27,22:00:00,16,12,4,FMN GV 11 Ramsel
66,Bergstraat 71,2021-10-27,23:00:00,8,4,4,FMN GV 11 Ramsel
66,Bergstraat 71,2021-10-28,00:00:00,0,0,0,FMN GV 11 Ramsel
66,Bergstraat 71,2021-10-28,01:00:00,8,6,2,FMN GV 11 Ramsel
66,Bergstraat 71,2021-10-28,02:00:00,0,0,0,FMN GV 11 Ramsel
66,Bergstraat 71,2021-10-28,03:00:00,0,0,0,FMN GV 11 Ramsel
66,Bergstraat 71,2021-10-28,04:00:00,2,2,0,FMN GV 11 Ramsel
66,Bergstraat 71,2021-10-28,05:00:00,14,10,4,FMN GV 11 Ramsel
66,Bergstraat 71,2021-10-28,06:00:00,42,12,30,FMN GV 11 Ramsel
66,Bergstraat 71,2021-10-28,07:00:00,254,14,240,FMN GV 11 Ramsel
66,Bergstraat 71,2021-10-28,08:00:00,178,28,150,FMN GV 11 Ramsel
66,Bergstraat 71,2021-10-28,09:00:00,84,32,52,FMN GV 11 Ramsel
66,Bergstraat 71,2021-10-28,10:00:00,68,24,44,FMN GV 11 Ramsel
66,Bergstraat 71,2021-10-28,11:00:00,84,40,44,FMN GV 11 Ramsel
66,Bergstraat 71,2021-10-28,12:00:00,106,50,56,FMN GV 11 Ramsel
66,Bergstraat 71,2021-10-28,13:00:00,194,78,116,FMN GV 11 Ramsel
66,Bergstraat 71,2021-10-28,14:00:00,278,156,122,FMN GV 11 Ramsel
66,Bergstraat 71,2021-10-28,15:00:00,372,276,96,FMN GV 11 Ramsel
66,Bergstraat 71,2021-10-28,16:00:00,212,170,42,FMN GV 11 Ramsel
66,Bergstraat 71,2021-10-28,17:00:00,110,76,34,FMN GV 11 Ramsel
66,Bergstraat 71,2021-10-28,18:00:00,64,44,20,FMN GV 11 Ramsel
66,Bergstraat 71,2021-10-28,19:00:00,22,16,6,FMN GV 11 Ramsel
66,Bergstraat 71,2021-10-28,20:00:00,16,8,8,FMN GV 11 Ramsel
66,Bergstraat 71,2021-10-28,21:00:00,4,2,2,FMN GV 11 Ramsel
66,Bergstraat 71,2021-10-28,22:00:00,10,10,0,FMN GV 11 Ramsel
66,Bergstraat 71,2021-10-28,23:00:00,8,4,4,FMN GV 11 Ramsel
66,Bergstraat 71,2021-10-29,00:00:00,4,4,0,FMN GV 11 Ramsel
66,Bergstraat 71,2021-10-29,01:00:00,0,0,0,FMN GV 11 Ramsel
66,Bergstraat 71,2021-10-29,02:00:00,0,0,0,FMN GV 11 Ramsel
66,Bergstraat 71,2021-10-29,03:00:00,0,0,0,FMN GV 11 Ramsel
66,Bergstraat 71,2021-10-29,04:00:00,2,2,0,FMN GV 11 Ramsel
66,Bergstraat 71,2021-10-29,05:00:00,2,2,0,FMN GV 11 Ramsel
66,Bergstraat 71,2021-10-29,06:00:00,22,6,16,FMN GV 11 Ramsel
66,Bergstraat 71,2021-10-29,07:00:00,200,18,182,FMN GV 11 Ramsel
66,Bergstraat 71,2021-10-29,08:00:00,184,24,160,FMN GV 11 Ramsel
66,Bergstraat 71,2021-10-29,09:00:00,68,16,52,FMN GV 11 Ramsel
66,Bergstraat 71,2021-10-29,10:00:00,62,32,30,FMN GV 11 Ramsel
66,Bergstraat 71,2021-10-29,11:00:00,68,38,30,FMN GV 11 Ramsel
66,Bergstraat 71,2021-10-29,12:00:00,94,38,56,FMN GV 11 Ramsel
66,Bergstraat 71,2021-10-29,13:00:00,134,74,60,FMN GV 11 Ramsel
66,Bergstraat 71,2021-10-29,14:00:00,150,76,74,FMN GV 11 Ramsel
66,Bergstraat 71,2021-10-29,15:00:00,284,218,66,FMN GV 11 Ramsel
66,Bergstraat 71,2021-10-29,16:00:00,148,108,40,FMN GV 11 Ramsel
66,Bergstraat 71,2021-10-29,17:00:00,74,62,12,FMN GV 11 Ramsel
66,Bergstraat 71,2021-10-29,18:00:00,32,16,16,FMN GV 11 Ramsel
66,Bergstraat 71,2021-10-29,19:00:00,28,14,14,FMN GV 11 Ramsel
66,Bergstraat 71,2021-10-29,20:00:00,16,8,8,FMN GV 11 Ramsel
66,Bergstraat 71,2021-10-29,21:00:00,18,8,10,FMN GV 11 Ramsel
66,Bergstraat 71,2021-10-29,22:00:00,14,2,12,FMN GV 11 Ramsel
66,Bergstraat 71,2021-10-29,23:00:00,12,4,8,FMN GV 11 Ramsel
66,Bergstraat 71,2021-10-30,00:00:00,0,0,0,FMN GV 11 Ramsel
66,Bergstraat 71,2021-10-30,01:00:00,4,2,2,FMN GV 11 Ramsel
66,Bergstraat 71,2021-10-30,02:00:00,10,10,0,FMN GV 11 Ramsel
66,Bergstraat 71,2021-10-30,03:00:00,4,2,2,FMN GV 11 Ramsel
66,Bergstraat 71,2021-10-30,04:00:00,6,6,0,FMN GV 11 Ramsel
66,Bergstraat 71,2021-10-30,05:00:00,6,6,0,FMN GV 11 Ramsel
66,Bergstraat 71,2021-10-30,06:00:00,4,2,2,FMN GV 11 Ramsel
66,Bergstraat 71,2021-10-30,07:00:00,6,4,2,FMN GV 11 Ramsel
66,Bergstraat 71,2021-10-30,08:00:00,18,10,8,FMN GV 11 Ramsel
66,Bergstraat 71,2021-10-30,09:00:00,20,10,10,FMN GV 11 Ramsel
66,Bergstraat 71,2021-10-30,10:00:00,10,6,4,FMN GV 11 Ramsel
66,Bergstraat 71,2021-10-30,11:00:00,18,14,4,FMN GV 11 Ramsel
66,Bergstraat 71,2021-10-30,12:00:00,12,12,0,FMN GV 11 Ramsel
66,Bergstraat 71,2021-10-30,13:00:00,20,2,18,FMN GV 11 Ramsel
66,Bergstraat 71,2021-10-30,14:00:00,34,18,16,FMN GV 11 Ramsel
66,Bergstraat 71,2021-10-30,15:00:00,24,8,16,FMN GV 11 Ramsel
66,Bergstraat 71,2021-10-30,16:00:00,18,10,8,FMN GV 11 Ramsel
66,Bergstraat 71,2021-10-30,17:00:00,12,10,2,FMN GV 11 Ramsel
66,Bergstraat 71,2021-10-30,18:00:00,8,4,4,FMN GV 11 Ramsel
66,Bergstraat 71,2021-10-30,19:00:00,8,4,4,FMN GV 11 Ramsel
66,Bergstraat 71,2021-10-30,20:00:00,14,2,12,FMN GV 11 Ramsel
66,Bergstraat 71,2021-10-30,21:00:00,6,4,2,FMN GV 11 Ramsel
66,Bergstraat 71,2021-10-30,22:00:00,4,2,2,FMN GV 11 Ramsel
66,Bergstraat 71,2021-10-30,23:00:00,0,0,0,FMN GV 11 Ramsel
66,Bergstraat 71,2021-10-31,00:00:00,0,0,0,FMN GV 11 Ramsel
66,Bergstraat 71,2021-10-31,01:00:00,6,6,0,FMN GV 11 Ramsel
66,Bergstraat 71,2021-10-31,02:00:00,4,2,2,FMN GV 11 Ramsel
66,Bergstraat 71,2021-10-31,03:00:00,2,2,0,FMN GV 11 Ramsel
66,Bergstraat 71,2021-10-31,04:00:00,0,0,0,FMN GV 11 Ramsel
66,Bergstraat 71,2021-10-31,05:00:00,4,4,0,FMN GV 11 Ramsel
66,Bergstraat 71,2021-10-31,06:00:00,6,0,6,FMN GV 11 Ramsel
66,Bergstraat 71,2021-10-31,07:00:00,8,2,6,FMN GV 11 Ramsel
66,Bergstraat 71,2021-10-31,08:00:00,70,6,64,FMN GV 11 Ramsel
66,Bergstraat 71,2021-10-31,09:00:00,132,22,110,FMN GV 11 Ramsel
66,Bergstraat 71,2021-10-31,10:00:00,172,72,100,FMN GV 11 Ramsel
66,Bergstraat 71,2021-10-31,11:00:00,126,86,40,FMN GV 11 Ramsel
66,Bergstraat 71,2021-10-31,12:00:00,72,34,38,FMN GV 11 Ramsel
66,Bergstraat 71,2021-10-31,13:00:00,114,64,50,FMN GV 11 Ramsel
66,Bergstraat 71,2021-10-31,14:00:00,68,42,26,FMN GV 11 Ramsel
66,Bergstraat 71,2021-10-31,15:00:00,38,24,14,FMN GV 11 Ramsel
66,Bergstraat 71,2021-10-31,16:00:00,16,6,10,FMN GV 11 Ramsel
66,Bergstraat 71,2021-10-31,17:00:00,16,4,12,FMN GV 11 Ramsel
66,Bergstraat 71,2021-10-31,18:00:00,4,4,0,FMN GV 11 Ramsel
66,Bergstraat 71,2021-10-31,19:00:00,6,4,2,FMN GV 11 Ramsel
66,Bergstraat 71,2021-10-31,20:00:00,2,2,0,FMN GV 11 Ramsel
66,Bergstraat 71,2021-10-31,21:00:00,8,2,6,FMN GV 11 Ramsel
66,Bergstraat 71,2021-10-31,22:00:00,2,2,0,FMN GV 11 Ramsel
66,Bergstraat 71,2021-10-31,23:00:00,0,0,0,FMN GV 11 Ramsel
66,Bergstraat 71,2021-11-01,00:00:00,2,2,0,FMN GV 11 Ramsel
66,Bergstraat 71,2021-11-01,01:00:00,0,0,0,FMN GV 11 Ramsel
66,Bergstraat 71,2021-11-01,02:00:00,0,0,0,FMN GV 11 Ramsel
66,Bergstraat 71,2021-11-01,03:00:00,2,0,2,FMN GV 11 Ramsel
66,Bergstraat 71,2021-11-01,04:00:00,0,0,0,FMN GV 11 Ramsel
66,Bergstraat 71,2021-11-01,05:00:00,0,0,0,FMN GV 11 Ramsel
66,Bergstraat 71,2021-11-01,06:00:00,0,0,0,FMN GV 11 Ramsel
66,Bergstraat 71,2021-11-01,07:00:00,2,0,2,FMN GV 11 Ramsel
66,Bergstraat 71,2021-11-01,08:00:00,30,14,16,FMN GV 11 Ramsel
66,Bergstraat 71,2021-11-01,09:00:00,70,22,48,FMN GV 11 Ramsel
66,Bergstraat 71,2021-11-01,10:00:00,120,84,36,FMN GV 11 Ramsel
66,Bergstraat 71,2021-11-01,11:00:00,94,42,52,FMN GV 11 Ramsel
66,Bergstraat 71,2021-11-01,12:00:00,54,24,30,FMN GV 11 Ramsel
66,Bergstraat 71,2021-11-01,13:00:00,52,28,24,FMN GV 11 Ramsel
66,Bergstraat 71,2021-11-01,14:00:00,60,26,34,FMN GV 11 Ramsel
66,Bergstraat 71,2021-11-01,15:00:00,62,48,14,FMN GV 11 Ramsel
66,Bergstraat 71,2021-11-01,16:00:00,36,30,6,FMN GV 11 Ramsel
66,Bergstraat 71,2021-11-01,17:00:00,44,18,26,FMN GV 11 Ramsel
66,Bergstraat 71,2021-11-01,18:00:00,4,2,2,FMN GV 11 Ramsel
66,Bergstraat 71,2021-11-01,19:00:00,10,6,4,FMN GV 11 Ramsel
66,Bergstraat 71,2021-11-01,20:00:00,16,6,10,FMN GV 11 Ramsel
66,Bergstraat 71,2021-11-01,21:00:00,4,2,2,FMN GV 11 Ramsel
66,Bergstraat 71,2021-11-01,22:00:00,10,8,2,FMN GV 11 Ramsel
66,Bergstraat 71,2021-11-01,23:00:00,4,2,2,FMN GV 11 Ramsel
66,Bergstraat 71,2021-11-02,00:00:00,4,2,2,FMN GV 11 Ramsel
66,Bergstraat 71,2021-11-02,01:00:00,0,0,0,FMN GV 11 Ramsel
66,Bergstraat 71,2021-11-02,02:00:00,0,0,0,FMN GV 11 Ramsel
66,Bergstraat 71,2021-11-02,03:00:00,0,0,0,FMN GV 11 Ramsel
66,Bergstraat 71,2021-11-02,04:00:00,2,2,0,FMN GV 11 Ramsel
66,Bergstraat 71,2021-11-02,05:00:00,6,4,2,FMN GV 11 Ramsel
66,Bergstraat 71,2021-11-02,06:00:00,12,4,8,FMN GV 11 Ramsel
66,Bergstraat 71,2021-11-02,07:00:00,20,10,10,FMN GV 11 Ramsel
66,Bergstraat 71,2021-11-02,08:00:00,22,10,12,FMN GV 11 Ramsel
66,Bergstraat 71,2021-11-02,09:00:00,34,16,18,FMN GV 11 Ramsel
66,Bergstraat 71,2021-11-02,10:00:00,44,22,22,FMN GV 11 Ramsel
66,Bergstraat 71,2021-11-02,11:00:00,34,18,16,FMN GV 11 Ramsel
66,Bergstraat 71,2021-11-02,12:00:00,44,30,14,FMN GV 11 Ramsel
66,Bergstraat 71,2021-11-02,13:00:00,60,36,24,FMN GV 11 Ramsel
66,Bergstraat 71,2021-11-02,14:00:00,68,26,42,FMN GV 11 Ramsel
66,Bergstraat 71,2021-11-02,15:00:00,86,22,64,FMN GV 11 Ramsel
66,Bergstraat 71,2021-11-02,16:00:00,78,38,40,FMN GV 11 Ramsel
66,Bergstraat 71,2021-11-02,17:00:00,56,28,28,FMN GV 11 Ramsel
66,Bergstraat 71,2021-11-02,18:00:00,20,12,8,FMN GV 11 Ramsel
66,Bergstraat 71,2021-11-02,19:00:00,26,8,18,FMN GV 11 Ramsel
66,Bergstraat 71,2021-11-02,20:00:00,18,14,4,FMN GV 11 Ramsel
66,Bergstraat 71,2021-11-02,21:00:00,12,4,8,FMN GV 11 Ramsel
66,Bergstraat 71,2021-11-02,22:00:00,14,4,10,FMN GV 11 Ramsel
66,Bergstraat 71,2021-11-02,23:00:00,12,12,0,FMN GV 11 Ramsel
66,Bergstraat 71,2021-11-03,00:00:00,0,0,0,FMN GV 11 Ramsel
66,Bergstraat 71,2021-11-03,01:00:00,0,0,0,FMN GV 11 Ramsel
66,Bergstraat 71,2021-11-03,02:00:00,0,0,0,FMN GV 11 Ramsel
66,Bergstraat 71,2021-11-03,03:00:00,0,0,0,FMN GV 11 Ramsel
66,Bergstraat 71,2021-11-03,04:00:00,0,0,0,FMN GV 11 Ramsel
66,Bergstraat 71,2021-11-03,05:00:00,4,2,2,FMN GV 11 Ramsel
66,Bergstraat 71,2021-11-03,06:00:00,18,4,14,FMN GV 11 Ramsel
66,Bergstraat 71,2021-11-03,07:00:00,28,8,20,FMN GV 11 Ramsel
66,Bergstraat 71,2021-11-03,08:00:00,28,6,22,FMN GV 11 Ramsel
66,Bergstraat 71,2021-11-03,09:00:00,38,16,22,FMN GV 11 Ramsel
66,Bergstraat 71,2021-11-03,10:00:00,18,10,8,FMN GV 11 Ramsel
66,Bergstraat 71,2021-11-03,11:00:00,44,32,12,FMN GV 11 Ramsel
66,Bergstraat 71,2021-11-03,12:00:00,62,32,30,FMN GV 11 Ramsel
66,Bergstraat 71,2021-11-03,13:00:00,90,40,50,FMN GV 11 Ramsel
66,Bergstraat 71,2021-11-03,14:00:00,108,48,60,FMN GV 11 Ramsel
66,Bergstraat 71,2021-11-03,15:00:00,68,38,30,FMN GV 11 Ramsel
66,Bergstraat 71,2021-11-03,16:00:00,58,38,20,FMN GV 11 Ramsel
66,Bergstraat 71,2021-11-03,17:00:00,66,34,32,FMN GV 11 Ramsel
66,Bergstraat 71,2021-11-03,18:00:00,30,14,16,FMN GV 11 Ramsel
66,Bergstraat 71,2021-11-03,19:00:00,30,16,14,FMN GV 11 Ramsel
66,Bergstraat 71,2021-11-03,20:00:00,14,8,6,FMN GV 11 Ramsel
66,Bergstraat 71,2021-11-03,21:00:00,14,12,2,FMN GV 11 Ramsel
66,Bergstraat 71,2021-11-03,22:00:00,8,2,6,FMN GV 11 Ramsel
66,Bergstraat 71,2021-11-03,23:00:00,6,6,0,FMN GV 11 Ramsel
66,Bergstraat 71,2021-11-04,00:00:00,0,0,0,FMN GV 11 Ramsel
66,Bergstraat 71,2021-11-04,01:00:00,0,0,0,FMN GV 11 Ramsel
66,Bergstraat 71,2021-11-04,02:00:00,0,0,0,FMN GV 11 Ramsel
66,Bergstraat 71,2021-11-04,03:00:00,0,0,0,FMN GV 11 Ramsel
66,Bergstraat 71,2021-11-04,04:00:00,4,2,2,FMN GV 11 Ramsel
66,Bergstraat 71,2021-11-04,05:00:00,0,0,0,FMN GV 11 Ramsel
66,Bergstraat 71,2021-11-04,06:00:00,22,8,14,FMN GV 11 Ramsel
66,Bergstraat 71,2021-11-04,07:00:00,36,14,22,FMN GV 11 Ramsel
66,Bergstraat 71,2021-11-04,08:00:00,36,8,28,FMN GV 11 Ramsel
66,Bergstraat 71,2021-11-04,09:00:00,40,10,30,FMN GV 11 Ramsel
66,Bergstraat 71,2021-11-04,10:00:00,32,16,16,FMN GV 11 Ramsel
66,Bergstraat 71,2021-11-04,11:00:00,52,28,24,FMN GV 11 Ramsel
66,Bergstraat 71,2021-11-04,12:00:00,24,16,8,FMN GV 11 Ramsel
66,Bergstraat 71,2021-11-04,13:00:00,52,32,20,FMN GV 11 Ramsel
66,Bergstraat 71,2021-11-04,14:00:00,28,14,14,FMN GV 11 Ramsel
66,Bergstraat 71,2021-11-04,15:00:00,60,30,30,FMN GV 11 Ramsel
66,Bergstraat 71,2021-11-04,16:00:00,56,30,26,FMN GV 11 Ramsel
66,Bergstraat 71,2021-11-04,17:00:00,50,40,10,FMN GV 11 Ramsel
66,Bergstraat 71,2021-11-04,18:00:00,22,14,8,FMN GV 11 Ramsel
66,Bergstraat 71,2021-11-04,19:00:00,12,10,2,FMN GV 11 Ramsel
66,Bergstraat 71,2021-11-04,20:00:00,16,8,8,FMN GV 11 Ramsel
66,Bergstraat 71,2021-11-04,21:00:00,8,0,8,FMN GV 11 Ramsel
66,Bergstraat 71,2021-11-04,22:00:00,10,8,2,FMN GV 11 Ramsel
66,Bergstraat 71,2021-11-04,23:00:00,2,0,2,FMN GV 11 Ramsel
66,Bergstraat 71,2021-11-05,00:00:00,0,0,0,FMN GV 11 Ramsel
66,Bergstraat 71,2021-11-05,01:00:00,4,0,4,FMN GV 11 Ramsel
66,Bergstraat 71,2021-11-05,02:00:00,0,0,0,FMN GV 11 Ramsel
66,Bergstraat 71,2021-11-05,03:00:00,0,0,0,FMN GV 11 Ramsel
66,Bergstraat 71,2021-11-05,04:00:00,4,2,2,FMN GV 11 Ramsel
66,Bergstraat 71,2021-11-05,05:00:00,6,4,2,FMN GV 11 Ramsel
66,Bergstraat 71,2021-11-05,06:00:00,12,2,10,FMN GV 11 Ramsel
66,Bergstraat 71,2021-11-05,07:00:00,18,6,12,FMN GV 11 Ramsel
66,Bergstraat 71,2021-11-05,08:00:00,34,12,22,FMN GV 11 Ramsel
66,Bergstraat 71,2021-11-05,09:00:00,20,10,10,FMN GV 11 Ramsel
66,Bergstraat 71,2021-11-05,10:00:00,62,30,32,FMN GV 11 Ramsel
66,Bergstraat 71,2021-11-05,11:00:00,34,22,12,FMN GV 11 Ramsel
66,Bergstraat 71,2021-11-05,12:00:00,92,50,42,FMN GV 11 Ramsel
66,Bergstraat 71,2021-11-05,13:00:00,74,52,22,FMN GV 11 Ramsel
66,Bergstraat 71,2021-11-05,14:00:00,72,36,36,FMN GV 11 Ramsel
66,Bergstraat 71,2021-11-05,15:00:00,56,22,34,FMN GV 11 Ramsel
66,Bergstraat 71,2021-11-05,16:00:00,64,40,24,FMN GV 11 Ramsel
66,Bergstraat 71,2021-11-05,17:00:00,24,18,6,FMN GV 11 Ramsel
66,Bergstraat 71,2021-11-05,18:00:00,34,20,14,FMN GV 11 Ramsel
66,Bergstraat 71,2021-11-05,19:00:00,18,4,14,FMN GV 11 Ramsel
66,Bergstraat 71,2021-11-05,20:00:00,22,6,16,FMN GV 11 Ramsel
66,Bergstraat 71,2021-11-05,21:00:00,16,2,14,FMN GV 11 Ramsel
66,Bergstraat 71,2021-11-05,22:00:00,22,0,22,FMN GV 11 Ramsel
66,Bergstraat 71,2021-11-05,23:00:00,10,2,8,FMN GV 11 Ramsel
66,Bergstraat 71,2021-11-06,00:00:00,2,2,0,FMN GV 11 Ramsel
66,Bergstraat 71,2021-11-06,01:00:00,2,2,0,FMN GV 11 Ramsel
66,Bergstraat 71,2021-11-06,02:00:00,30,28,2,FMN GV 11 Ramsel
66,Bergstraat 71,2021-11-06,03:00:00,18,18,0,FMN GV 11 Ramsel
66,Bergstraat 71,2021-11-06,04:00:00,6,6,0,FMN GV 11 Ramsel
66,Bergstraat 71,2021-11-06,05:00:00,2,2,0,FMN GV 11 Ramsel
66,Bergstraat 71,2021-11-06,06:00:00,2,2,0,FMN GV 11 Ramsel
66,Bergstraat 71,2021-11-06,07:00:00,6,2,4,FMN GV 11 Ramsel
66,Bergstraat 71,2021-11-06,08:00:00,30,12,18,FMN GV 11 Ramsel
66,Bergstraat 71,2021-11-06,09:00:00,48,18,30,FMN GV 11 Ramsel
66,Bergstraat 71,2021-11-06,10:00:00,72,38,34,FMN GV 11 Ramsel
66,Bergstraat 71,2021-11-06,11:00:00,90,50,40,FMN GV 11 Ramsel
66,Bergstraat 71,2021-11-06,12:00:00,74,38,36,FMN GV 11 Ramsel
66,Bergstraat 71,2021-11-06,13:00:00,114,60,54,FMN GV 11 Ramsel
66,Bergstraat 71,2021-11-06,14:00:00,96,52,44,FMN GV 11 Ramsel
66,Bergstraat 71,2021-11-06,15:00:00,62,34,28,FMN GV 11 Ramsel
66,Bergstraat 71,2021-11-06,16:00:00,48,32,16,FMN GV 11 Ramsel
66,Bergstraat 71,2021-11-06,17:00:00,34,20,14,FMN GV 11 Ramsel
66,Bergstraat 71,2021-11-06,18:00:00,10,6,4,FMN GV 11 Ramsel
66,Bergstraat 71,2021-11-06,19:00:00,18,4,14,FMN GV 11 Ramsel
66,Bergstraat 71,2021-11-06,20:00:00,8,2,6,FMN GV 11 Ramsel
66,Bergstraat 71,2021-11-06,21:00:00,4,2,2,FMN GV 11 Ramsel
66,Bergstraat 71,2021-11-06,22:00:00,12,4,8,FMN GV 11 Ramsel
66,Bergstraat 71,2021-11-06,23:00:00,6,6,0,FMN GV 11 Ramsel
66,Bergstraat 71,2021-11-07,00:00:00,0,0,0,FMN GV 11 Ramsel
66,Bergstraat 71,2021-11-07,01:00:00,10,8,2,FMN GV 11 Ramsel
66,Bergstraat 71,2021-11-07,02:00:00,10,10,0,FMN GV 11 Ramsel
66,Bergstraat 71,2021-11-07,03:00:00,2,2,0,FMN GV 11 Ramsel
66,Bergstraat 71,2021-11-07,04:00:00,10,10,0,FMN GV 11 Ramsel
66,Bergstraat 71,2021-11-07,05:00:00,2,2,0,FMN GV 11 Ramsel
66,Bergstraat 71,2021-11-07,06:00:00,0,0,0,FMN GV 11 Ramsel
66,Bergstraat 71,2021-11-07,07:00:00,6,4,2,FMN GV 11 Ramsel
66,Bergstraat 71,2021-11-07,08:00:00,18,12,6,FMN GV 11 Ramsel
66,Bergstraat 71,2021-11-07,09:00:00,60,16,44,FMN GV 11 Ramsel
66,Bergstraat 71,2021-11-07,10:00:00,100,58,42,FMN GV 11 Ramsel
66,Bergstraat 71,2021-11-07,11:00:00,152,90,62,FMN GV 11 Ramsel
66,Bergstraat 71,2021-11-07,12:00:00,74,54,20,FMN GV 11 Ramsel
66,Bergstraat 71,2021-11-07,13:00:00,114,66,48,FMN GV 11 Ramsel
66,Bergstraat 71,2021-11-07,14:00:00,100,36,64,FMN GV 11 Ramsel
66,Bergstraat 71,2021-11-07,15:00:00,62,34,28,FMN GV 11 Ramsel
66,Bergstraat 71,2021-11-07,16:00:00,44,26,18,FMN GV 11 Ramsel
66,Bergstraat 71,2021-11-07,17:00:00,34,22,12,FMN GV 11 Ramsel
66,Bergstraat 71,2021-11-07,18:00:00,8,2,6,FMN GV 11 Ramsel
66,Bergstraat 71,2021-11-07,19:00:00,4,0,4,FMN GV 11 Ramsel
66,Bergstraat 71,2021-11-07,20:00:00,4,2,2,FMN GV 11 Ramsel
66,Bergstraat 71,2021-11-07,21:00:00,2,2,0,FMN GV 11 Ramsel
66,Bergstraat 71,2021-11-07,22:00:00,6,4,2,FMN GV 11 Ramsel
66,Bergstraat 71,2021-11-07,23:00:00,2,2,0,FMN GV 11 Ramsel
66,Bergstraat 71,2021-11-08,00:00:00,2,0,2,FMN GV 11 Ramsel
66,Bergstraat 71,2021-11-08,01:00:00,2,2,0,FMN GV 11 Ramsel
66,Bergstraat 71,2021-11-08,02:00:00,0,0,0,FMN GV 11 Ramsel
66,Bergstraat 71,2021-11-08,03:00:00,0,0,0,FMN GV 11 Ramsel
66,Bergstraat 71,2021-11-08,04:00:00,2,2,0,FMN GV 11 Ramsel
66,Bergstraat 71,2021-11-08,05:00:00,8,6,2,FMN GV 11 Ramsel
66,Bergstraat 71,2021-11-08,06:00:00,30,8,22,FMN GV 11 Ramsel
66,Bergstraat 71,2021-11-08,07:00:00,244,6,238,FMN GV 11 Ramsel
66,Bergstraat 71,2021-11-08,08:00:00,160,24,136,FMN GV 11 Ramsel
66,Bergstraat 71,2021-11-08,09:00:00,58,18,40,FMN GV 11 Ramsel
66,Bergstraat 71,2021-11-08,10:00:00,58,26,32,FMN GV 11 Ramsel
66,Bergstraat 71,2021-11-08,11:00:00,46,26,20,FMN GV 11 Ramsel
66,Bergstraat 71,2021-11-08,12:00:00,106,48,58,FMN GV 11 Ramsel
66,Bergstraat 71,2021-11-08,13:00:00,126,62,64,FMN GV 11 Ramsel
66,Bergstraat 71,2021-11-08,14:00:00,138,52,86,FMN GV 11 Ramsel
66,Bergstraat 71,2021-11-08,15:00:00,288,226,62,FMN GV 11 Ramsel
66,Bergstraat 71,2021-11-08,16:00:00,208,176,32,FMN GV 11 Ramsel
66,Bergstraat 71,2021-11-08,17:00:00,60,30,30,FMN GV 11 Ramsel
66,Bergstraat 71,2021-11-08,18:00:00,28,22,6,FMN GV 11 Ramsel
66,Bergstraat 71,2021-11-08,19:00:00,16,6,10,FMN GV 11 Ramsel
66,Bergstraat 71,2021-11-08,20:00:00,18,14,4,FMN GV 11 Ramsel
66,Bergstraat 71,2021-11-08,21:00:00,12,10,2,FMN GV 11 Ramsel
66,Bergstraat 71,2021-11-08,22:00:00,12,6,6,FMN GV 11 Ramsel
66,Bergstraat 71,2021-11-08,23:00:00,2,0,2,FMN GV 11 Ramsel
66,Bergstraat 71,2021-11-09,00:00:00,0,0,0,FMN GV 11 Ramsel
66,Bergstraat 71,2021-11-09,01:00:00,0,0,0,FMN GV 11 Ramsel
66,Bergstraat 71,2021-11-09,02:00:00,0,0,0,FMN GV 11 Ramsel
66,Bergstraat 71,2021-11-09,03:00:00,0,0,0,FMN GV 11 Ramsel
66,Bergstraat 71,2021-11-09,04:00:00,2,2,0,FMN GV 11 Ramsel
66,Bergstraat 71,2021-11-09,05:00:00,10,4,6,FMN GV 11 Ramsel
66,Bergstraat 71,2021-11-09,06:00:00,28,6,22,FMN GV 11 Ramsel
66,Bergstraat 71,2021-11-09,07:00:00,226,14,212,FMN GV 11 Ramsel
66,Bergstraat 71,2021-11-09,08:00:00,198,28,170,FMN GV 11 Ramsel
66,Bergstraat 71,2021-11-09,09:00:00,32,14,18,FMN GV 11 Ramsel
66,Bergstraat 71,2021-11-09,10:00:00,46,18,28,FMN GV 11 Ramsel
66,Bergstraat 71,2021-11-09,11:00:00,102,22,80,FMN GV 11 Ramsel
66,Bergstraat 71,2021-11-09,12:00:00,102,46,56,FMN GV 11 Ramsel
66,Bergstraat 71,2021-11-09,13:00:00,168,54,114,FMN GV 11 Ramsel
66,Bergstraat 71,2021-11-09,14:00:00,112,50,62,FMN GV 11 Ramsel
66,Bergstraat 71,2021-11-09,15:00:00,288,248,40,FMN GV 11 Ramsel
66,Bergstraat 71,2021-11-09,16:00:00,180,146,34,FMN GV 11 Ramsel
66,Bergstraat 71,2021-11-09,17:00:00,82,54,28,FMN GV 11 Ramsel
66,Bergstraat 71,2021-11-09,18:00:00,30,14,16,FMN GV 11 Ramsel
66,Bergstraat 71,2021-11-09,19:00:00,28,8,20,FMN GV 11 Ramsel
66,Bergstraat 71,2021-11-09,20:00:00,30,28,2,FMN GV 11 Ramsel
66,Bergstraat 71,2021-11-09,21:00:00,12,8,4,FMN GV 11 Ramsel
66,Bergstraat 71,2021-11-09,22:00:00,6,2,4,FMN GV 11 Ramsel
66,Bergstraat 71,2021-11-09,23:00:00,6,4,2,FMN GV 11 Ramsel
66,Bergstraat 71,2021-11-10,00:00:00,2,2,0,FMN GV 11 Ramsel
66,Bergstraat 71,2021-11-10,01:00:00,0,0,0,FMN GV 11 Ramsel
66,Bergstraat 71,2021-11-10,02:00:00,0,0,0,FMN GV 11 Ramsel
66,Bergstraat 71,2021-11-10,03:00:00,0,0,0,FMN GV 11 Ramsel
66,Bergstraat 71,2021-11-10,04:00:00,2,2,0,FMN GV 11 Ramsel
66,Bergstraat 71,2021-11-10,05:00:00,10,6,4,FMN GV 11 Ramsel
66,Bergstraat 71,2021-11-10,06:00:00,22,4,18,FMN GV 11 Ramsel
66,Bergstraat 71,2021-11-10,07:00:00,188,18,170,FMN GV 11 Ramsel
66,Bergstraat 71,2021-11-10,08:00:00,156,20,136,FMN GV 11 Ramsel
66,Bergstraat 71,2021-11-10,09:00:00,40,16,24,FMN GV 11 Ramsel
66,Bergstraat 71,2021-11-10,10:00:00,38,22,16,FMN GV 11 Ramsel
66,Bergstraat 71,2021-11-10,11:00:00,40,18,22,FMN GV 11 Ramsel
66,Bergstraat 71,2021-11-10,12:00:00,304,252,52,FMN GV 11 Ramsel
66,Bergstraat 71,2021-11-10,13:00:00,82,40,42,FMN GV 11 Ramsel
66,Bergstraat 71,2021-11-10,14:00:00,132,68,64,FMN GV 11 Ramsel
66,Bergstraat 71,2021-11-10,15:00:00,100,64,36,FMN GV 11 Ramsel
66,Bergstraat 71,2021-11-10,16:00:00,112,56,56,FMN GV 11 Ramsel
66,Bergstraat 71,2021-11-10,17:00:00,82,48,34,FMN GV 11 Ramsel
66,Bergstraat 71,2021-11-10,18:00:00,38,20,18,FMN GV 11 Ramsel
66,Bergstraat 71,2021-11-10,19:00:00,24,10,14,FMN GV 11 Ramsel
66,Bergstraat 71,2021-11-10,20:00:00,12,8,4,FMN GV 11 Ramsel
66,Bergstraat 71,2021-11-10,21:00:00,4,2,2,FMN GV 11 Ramsel
66,Bergstraat 71,2021-11-10,22:00:00,16,16,0,FMN GV 11 Ramsel
66,Bergstraat 71,2021-11-10,23:00:00,4,4,0,FMN GV 11 Ramsel
66,Bergstraat 71,2021-11-11,00:00:00,0,0,0,FMN GV 11 Ramsel
66,Bergstraat 71,2021-11-11,01:00:00,2,2,0,FMN GV 11 Ramsel
66,Bergstraat 71,2021-11-11,02:00:00,4,4,0,FMN GV 11 Ramsel
66,Bergstraat 71,2021-11-11,03:00:00,0,0,0,FMN GV 11 Ramsel
66,Bergstraat 71,2021-11-11,04:00:00,0,0,0,FMN GV 11 Ramsel
66,Bergstraat 71,2021-11-11,05:00:00,0,0,0,FMN GV 11 Ramsel
66,Bergstraat 71,2021-11-11,06:00:00,0,0,0,FMN GV 11 Ramsel
66,Bergstraat 71,2021-11-11,07:00:00,2,2,0,FMN GV 11 Ramsel
66,Bergstraat 71,2021-11-11,08:00:00,12,6,6,FMN GV 11 Ramsel
66,Bergstraat 71,2021-11-11,09:00:00,32,20,12,FMN GV 11 Ramsel
66,Bergstraat 71,2021-11-11,10:00:00,48,22,26,FMN GV 11 Ramsel
66,Bergstraat 71,2021-11-11,11:00:00,88,38,50,FMN GV 11 Ramsel
66,Bergstraat 71,2021-11-11,12:00:00,56,36,20,FMN GV 11 Ramsel
66,Bergstraat 71,2021-11-11,13:00:00,86,44,42,FMN GV 11 Ramsel
66,Bergstraat 71,2021-11-11,14:00:00,88,28,60,FMN GV 11 Ramsel
66,Bergstraat 71,2021-11-11,15:00:00,106,82,24,FMN GV 11 Ramsel
66,Bergstraat 71,2021-11-11,16:00:00,80,40,40,FMN GV 11 Ramsel
66,Bergstraat 71,2021-11-11,17:00:00,20,8,12,FMN GV 11 Ramsel
66,Bergstraat 71,2021-11-11,18:00:00,10,2,8,FMN GV 11 Ramsel
66,Bergstraat 71,2021-11-11,19:00:00,6,2,4,FMN GV 11 Ramsel
66,Bergstraat 71,2021-11-11,20:00:00,4,2,2,FMN GV 11 Ramsel
66,Bergstraat 71,2021-11-11,21:00:00,8,2,6,FMN GV 11 Ramsel
66,Bergstraat 71,2021-11-11,22:00:00,6,2,4,FMN GV 11 Ramsel
66,Bergstraat 71,2021-11-11,23:00:00,2,2,0,FMN GV 11 Ramsel
66,Bergstraat 71,2021-11-12,00:00:00,10,8,2,FMN GV 11 Ramsel
66,Bergstraat 71,2021-11-12,01:00:00,0,0,0,FMN GV 11 Ramsel
66,Bergstraat 71,2021-11-12,02:00:00,0,0,0,FMN GV 11 Ramsel
66,Bergstraat 71,2021-11-12,03:00:00,0,0,0,FMN GV 11 Ramsel
66,Bergstraat 71,2021-11-12,04:00:00,0,0,0,FMN GV 11 Ramsel
66,Bergstraat 71,2021-11-12,05:00:00,0,0,0,FMN GV 11 Ramsel
66,Bergstraat 71,2021-11-12,06:00:00,8,0,8,FMN GV 11 Ramsel
66,Bergstraat 71,2021-11-12,07:00:00,90,8,82,FMN GV 11 Ramsel
66,Bergstraat 71,2021-11-12,08:00:00,52,14,38,FMN GV 11 Ramsel
66,Bergstraat 71,2021-11-12,09:00:00,42,20,22,FMN GV 11 Ramsel
66,Bergstraat 71,2021-11-12,10:00:00,52,18,34,FMN GV 11 Ramsel
66,Bergstraat 71,2021-11-12,11:00:00,88,38,50,FMN GV 11 Ramsel
66,Bergstraat 71,2021-11-12,12:00:00,90,32,58,FMN GV 11 Ramsel
66,Bergstraat 71,2021-11-12,13:00:00,118,44,74,FMN GV 11 Ramsel
66,Bergstraat 71,2021-11-12,14:00:00,156,82,74,FMN GV 11 Ramsel
66,Bergstraat 71,2021-11-12,15:00:00,176,128,48,FMN GV 11 Ramsel
66,Bergstraat 71,2021-11-12,16:00:00,122,86,36,FMN GV 11 Ramsel
66,Bergstraat 71,2021-11-12,17:00:00,40,26,14,FMN GV 11 Ramsel
66,Bergstraat 71,2021-11-12,18:00:00,32,20,12,FMN GV 11 Ramsel
66,Bergstraat 71,2021-11-12,19:00:00,12,4,8,FMN GV 11 Ramsel
66,Bergstraat 71,2021-11-12,20:00:00,16,4,12,FMN GV 11 Ramsel
66,Bergstraat 71,2021-11-12,21:00:00,12,6,6,FMN GV 11 Ramsel
66,Bergstraat 71,2021-11-12,22:00:00,16,8,8,FMN GV 11 Ramsel
66,Bergstraat 71,2021-11-12,23:00:00,8,2,6,FMN GV 11 Ramsel
66,Bergstraat 71,2021-11-13,00:00:00,8,8,0,FMN GV 11 Ramsel
66,Bergstraat 71,2021-11-13,01:00:00,4,2,2,FMN GV 11 Ramsel
66,Bergstraat 71,2021-11-13,02:00:00,12,12,0,FMN GV 11 Ramsel
66,Bergstraat 71,2021-11-13,03:00:00,2,2,0,FMN GV 11 Ramsel
66,Bergstraat 71,2021-11-13,04:00:00,0,0,0,FMN GV 11 Ramsel
66,Bergstraat 71,2021-11-13,05:00:00,2,2,0,FMN GV 11 Ramsel
66,Bergstraat 71,2021-11-13,06:00:00,2,2,0,FMN GV 11 Ramsel
66,Bergstraat 71,2021-11-13,07:00:00,2,0,2,FMN GV 11 Ramsel
66,Bergstraat 71,2021-11-13,08:00:00,12,2,10,FMN GV 11 Ramsel
66,Bergstraat 71,2021-11-13,09:00:00,6,4,2,FMN GV 11 Ramsel
66,Bergstraat 71,2021-11-13,10:00:00,14,8,6,FMN GV 11 Ramsel
66,Bergstraat 71,2021-11-13,11:00:00,22,4,18,FMN GV 11 Ramsel
66,Bergstraat 71,2021-11-13,12:00:00,34,20,14,FMN GV 11 Ramsel
66,Bergstraat 71,2021-11-13,13:00:00,54,22,32,FMN GV 11 Ramsel
66,Bergstraat 71,2021-11-13,14:00:00,44,18,26,FMN GV 11 Ramsel
66,Bergstraat 71,2021-11-13,15:00:00,40,26,14,FMN GV 11 Ramsel
66,Bergstraat 71,2021-11-13,16:00:00,34,16,18,FMN GV 11 Ramsel
66,Bergstraat 71,2021-11-13,17:00:00,34,16,18,FMN GV 11 Ramsel
66,Bergstraat 71,2021-11-13,18:00:00,12,6,6,FMN GV 11 Ramsel
66,Bergstraat 71,2021-11-13,19:00:00,12,6,6,FMN GV 11 Ramsel
66,Bergstraat 71,2021-11-13,20:00:00,2,0,2,FMN GV 11 Ramsel
66,Bergstraat 71,2021-11-13,21:00:00,12,6,6,FMN GV 11 Ramsel
66,Bergstraat 71,2021-11-13,22:00:00,0,0,0,FMN GV 11 Ramsel
66,Bergstraat 71,2021-11-13,23:00:00,6,4,2,FMN GV 11 Ramsel
66,Bergstraat 71,2021-11-14,00:00:00,0,0,0,FMN GV 11 Ramsel
66,Bergstraat 71,2021-11-14,01:00:00,2,2,0,FMN GV 11 Ramsel
66,Bergstraat 71,2021-11-14,02:00:00,2,2,0,FMN GV 11 Ramsel
66,Bergstraat 71,2021-11-14,03:00:00,4,4,0,FMN GV 11 Ramsel
66,Bergstraat 71,2021-11-14,04:00:00,0,0,0,FMN GV 11 Ramsel
66,Bergstraat 71,2021-11-14,05:00:00,2,2,0,FMN GV 11 Ramsel
66,Bergstraat 71,2021-11-14,06:00:00,2,2,0,FMN GV 11 Ramsel
66,Bergstraat 71,2021-11-14,07:00:00,0,0,0,FMN GV 11 Ramsel
66,Bergstraat 71,2021-11-14,08:00:00,54,14,40,FMN GV 11 Ramsel
66,Bergstraat 71,2021-11-14,09:00:00,84,38,46,FMN GV 11 Ramsel
66,Bergstraat 71,2021-11-14,10:00:00,94,44,50,FMN GV 11 Ramsel
66,Bergstraat 71,2021-11-14,11:00:00,78,44,34,FMN GV 11 Ramsel
66,Bergstraat 71,2021-11-14,12:00:00,58,26,32,FMN GV 11 Ramsel
66,Bergstraat 71,2021-11-14,13:00:00,62,24,38,FMN GV 11 Ramsel
66,Bergstraat 71,2021-11-14,14:00:00,80,28,52,FMN GV 11 Ramsel
66,Bergstraat 71,2021-11-14,15:00:00,80,36,44,FMN GV 11 Ramsel
66,Bergstraat 71,2021-11-14,16:00:00,52,36,16,FMN GV 11 Ramsel
66,Bergstraat 71,2021-11-14,17:00:00,38,12,26,FMN GV 11 Ramsel
66,Bergstraat 71,2021-11-14,18:00:00,14,8,6,FMN GV 11 Ramsel
66,Bergstraat 71,2021-11-14,19:00:00,18,10,8,FMN GV 11 Ramsel
66,Bergstraat 71,2021-11-14,20:00:00,6,2,4,FMN GV 11 Ramsel
66,Bergstraat 71,2021-11-14,21:00:00,8,6,2,FMN GV 11 Ramsel
66,Bergstraat 71,2021-11-14,22:00:00,8,4,4,FMN GV 11 Ramsel
66,Bergstraat 71,2021-11-14,23:00:00,2,0,2,FMN GV 11 Ramsel
66,Bergstraat 71,2021-11-15,00:00:00,0,0,0,FMN GV 11 Ramsel
66,Bergstraat 71,2021-11-15,01:00:00,0,0,0,FMN GV 11 Ramsel
66,Bergstraat 71,2021-11-15,02:00:00,2,2,0,FMN GV 11 Ramsel
66,Bergstraat 71,2021-11-15,03:00:00,0,0,0,FMN GV 11 Ramsel
66,Bergstraat 71,2021-11-15,04:00:00,6,4,2,FMN GV 11 Ramsel
66,Bergstraat 71,2021-11-15,05:00:00,6,0,6,FMN GV 11 Ramsel
66,Bergstraat 71,2021-11-15,06:00:00,24,6,18,FMN GV 11 Ramsel
66,Bergstraat 71,2021-11-15,07:00:00,236,28,208,FMN GV 11 Ramsel
66,Bergstraat 71,2021-11-15,08:00:00,142,28,114,FMN GV 11 Ramsel
66,Bergstraat 71,2021-11-15,09:00:00,32,10,22,FMN GV 11 Ramsel
66,Bergstraat 71,2021-11-15,10:00:00,36,20,16,FMN GV 11 Ramsel
66,Bergstraat 71,2021-11-15,11:00:00,30,16,14,FMN GV 11 Ramsel
66,Bergstraat 71,2021-11-15,12:00:00,50,24,26,FMN GV 11 Ramsel
66,Bergstraat 71,2021-11-15,13:00:00,70,48,22,FMN GV 11 Ramsel
66,Bergstraat 71,2021-11-15,14:00:00,80,48,32,FMN GV 11 Ramsel
66,Bergstraat 71,2021-11-15,15:00:00,238,202,36,FMN GV 11 Ramsel
66,Bergstraat 71,2021-11-15,16:00:00,134,122,12,FMN GV 11 Ramsel
66,Bergstraat 71,2021-11-15,17:00:00,54,38,16,FMN GV 11 Ramsel
66,Bergstraat 71,2021-11-15,18:00:00,26,16,10,FMN GV 11 Ramsel
66,Bergstraat 71,2021-11-15,19:00:00,18,10,8,FMN GV 11 Ramsel
66,Bergstraat 71,2021-11-15,20:00:00,14,8,6,FMN GV 11 Ramsel
66,Bergstraat 71,2021-11-15,21:00:00,10,6,4,FMN GV 11 Ramsel
66,Bergstraat 71,2021-11-15,22:00:00,10,4,6,FMN GV 11 Ramsel
66,Bergstraat 71,2021-11-15,23:00:00,4,4,0,FMN GV 11 Ramsel
66,Bergstraat 71,2021-11-16,00:00:00,0,0,0,FMN GV 11 Ramsel
66,Bergstraat 71,2021-11-16,01:00:00,0,0,0,FMN GV 11 Ramsel
66,Bergstraat 71,2021-11-16,02:00:00,2,2,0,FMN GV 11 Ramsel
66,Bergstraat 71,2021-11-16,03:00:00,0,0,0,FMN GV 11 Ramsel
66,Bergstraat 71,2021-11-16,04:00:00,2,2,0,FMN GV 11 Ramsel
66,Bergstraat 71,2021-11-16,05:00:00,10,2,8,FMN GV 11 Ramsel
66,Bergstraat 71,2021-11-16,06:00:00,30,10,20,FMN GV 11 Ramsel
66,Bergstraat 71,2021-11-16,07:00:00,204,16,188,FMN GV 11 Ramsel
66,Bergstraat 71,2021-11-16,08:00:00,166,18,148,FMN GV 11 Ramsel
66,Bergstraat 71,2021-11-16,09:00:00,36,16,20,FMN GV 11 Ramsel
66,Bergstraat 71,2021-11-16,10:00:00,32,8,24,FMN GV 11 Ramsel
66,Bergstraat 71,2021-11-16,11:00:00,38,10,28,FMN GV 11 Ramsel
66,Bergstraat 71,2021-11-16,12:00:00,28,18,10,FMN GV 11 Ramsel
66,Bergstraat 71,2021-11-16,13:00:00,86,54,32,FMN GV 11 Ramsel
66,Bergstraat 71,2021-11-16,14:00:00,66,46,20,FMN GV 11 Ramsel
66,Bergstraat 71,2021-11-16,15:00:00,190,152,38,FMN GV 11 Ramsel
66,Bergstraat 71,2021-11-16,16:00:00,150,118,32,FMN GV 11 Ramsel
66,Bergstraat 71,2021-11-16,17:00:00,34,24,10,FMN GV 11 Ramsel
66,Bergstraat 71,2021-11-16,18:00:00,34,18,16,FMN GV 11 Ramsel
66,Bergstraat 71,2021-11-16,19:00:00,24,14,10,FMN GV 11 Ramsel
66,Bergstraat 71,2021-11-16,20:00:00,28,28,0,FMN GV 11 Ramsel
66,Bergstraat 71,2021-11-16,21:00:00,10,2,8,FMN GV 11 Ramsel
66,Bergstraat 71,2021-11-16,22:00:00,24,12,12,FMN GV 11 Ramsel
66,Bergstraat 71,2021-11-16,23:00:00,0,0,0,FMN GV 11 Ramsel
66,Bergstraat 71,2021-11-17,00:00:00,0,0,0,FMN GV 11 Ramsel
66,Bergstraat 71,2021-11-17,01:00:00,0,0,0,FMN GV 11 Ramsel
66,Bergstraat 71,2021-11-17,02:00:00,0,0,0,FMN GV 11 Ramsel
66,Bergstraat 71,2021-11-17,03:00:00,0,0,0,FMN GV 11 Ramsel
66,Bergstraat 71,2021-11-17,04:00:00,2,2,0,FMN GV 11 Ramsel
66,Bergstraat 71,2021-11-17,05:00:00,6,4,2,FMN GV 11 Ramsel
66,Bergstraat 71,2021-11-17,06:00:00,18,0,18,FMN GV 11 Ramsel
66,Bergstraat 71,2021-11-17,07:00:00,198,22,176,FMN GV 11 Ramsel
66,Bergstraat 71,2021-11-17,08:00:00,168,18,150,FMN GV 11 Ramsel
66,Bergstraat 71,2021-11-17,09:00:00,44,14,30,FMN GV 11 Ramsel
66,Bergstraat 71,2021-11-17,10:00:00,32,14,18,FMN GV 11 Ramsel
66,Bergstraat 71,2021-11-17,11:00:00,40,16,24,FMN GV 11 Ramsel
66,Bergstraat 71,2021-11-17,12:00:00,250,220,30,FMN GV 11 Ramsel
66,Bergstraat 71,2021-11-17,13:00:00,92,46,46,FMN GV 11 Ramsel
66,Bergstraat 71,2021-11-17,14:00:00,116,48,68,FMN GV 11 Ramsel
66,Bergstraat 71,2021-11-17,15:00:00,86,54,32,FMN GV 11 Ramsel
66,Bergstraat 71,2021-11-17,16:00:00,74,54,20,FMN GV 11 Ramsel
66,Bergstraat 71,2021-11-17,17:00:00,90,50,40,FMN GV 11 Ramsel
66,Bergstraat 71,2021-11-17,18:00:00,28,14,14,FMN GV 11 Ramsel
66,Bergstraat 71,2021-11-17,19:00:00,36,32,4,FMN GV 11 Ramsel
66,Bergstraat 71,2021-11-17,20:00:00,20,14,6,FMN GV 11 Ramsel
66,Bergstraat 71,2021-11-17,21:00:00,8,2,6,FMN GV 11 Ramsel
66,Bergstraat 71,2021-11-17,22:00:00,14,10,4,FMN GV 11 Ramsel
66,Bergstraat 71,2021-11-17,23:00:00,4,2,2,FMN GV 11 Ramsel
66,Bergstraat 71,2021-11-18,00:00:00,0,0,0,FMN GV 11 Ramsel
66,Bergstraat 71,2021-11-18,01:00:00,0,0,0,FMN GV 11 Ramsel
66,Bergstraat 71,2021-11-18,02:00:00,0,0,0,FMN GV 11 Ramsel
66,Bergstraat 71,2021-11-18,03:00:00,0,0,0,FMN GV 11 Ramsel
66,Bergstraat 71,2021-11-18,04:00:00,6,4,2,FMN GV 11 Ramsel
66,Bergstraat 71,2021-11-18,05:00:00,10,6,4,FMN GV 11 Ramsel
66,Bergstraat 71,2021-11-18,06:00:00,38,8,30,FMN GV 11 Ramsel
66,Bergstraat 71,2021-11-18,07:00:00,198,22,176,FMN GV 11 Ramsel
66,Bergstraat 71,2021-11-18,08:00:00,158,26,132,FMN GV 11 Ramsel
66,Bergstraat 71,2021-11-18,09:00:00,42,16,26,FMN GV 11 Ramsel
66,Bergstraat 71,2021-11-18,10:00:00,52,20,32,FMN GV 11 Ramsel
66,Bergstraat 71,2021-11-18,11:00:00,78,28,50,FMN GV 11 Ramsel
66,Bergstraat 71,2021-11-18,12:00:00,82,54,28,FMN GV 11 Ramsel
66,Bergstraat 71,2021-11-18,13:00:00,130,66,64,FMN GV 11 Ramsel
66,Bergstraat 71,2021-11-18,14:00:00,138,90,48,FMN GV 11 Ramsel
66,Bergstraat 71,2021-11-18,15:00:00,310,228,82,FMN GV 11 Ramsel
66,Bergstraat 71,2021-11-18,16:00:00,160,132,28,FMN GV 11 Ramsel
66,Bergstraat 71,2021-11-18,17:00:00,50,32,18,FMN GV 11 Ramsel
66,Bergstraat 71,2021-11-18,18:00:00,36,26,10,FMN GV 11 Ramsel
66,Bergstraat 71,2021-11-18,19:00:00,18,10,8,FMN GV 11 Ramsel
66,Bergstraat 71,2021-11-18,20:00:00,28,12,16,FMN GV 11 Ramsel
66,Bergstraat 71,2021-11-18,21:00:00,0,0,0,FMN GV 11 Ramsel
66,Bergstraat 71,2021-11-18,22:00:00,10,8,2,FMN GV 11 Ramsel
66,Bergstraat 71,2021-11-18,23:00:00,8,6,2,FMN GV 11 Ramsel
66,Bergstraat 71,2021-11-19,00:00:00,6,6,0,FMN GV 11 Ramsel
66,Bergstraat 71,2021-11-19,01:00:00,0,0,0,FMN GV 11 Ramsel
66,Bergstraat 71,2021-11-19,02:00:00,0,0,0,FMN GV 11 Ramsel
66,Bergstraat 71,2021-11-19,03:00:00,0,0,0,FMN GV 11 Ramsel
66,Bergstraat 71,2021-11-19,04:00:00,4,4,0,FMN GV 11 Ramsel
66,Bergstraat 71,2021-11-19,05:00:00,8,2,6,FMN GV 11 Ramsel
66,Bergstraat 71,2021-11-19,06:00:00,30,6,24,FMN GV 11 Ramsel
66,Bergstraat 71,2021-11-19,07:00:00,174,10,164,FMN GV 11 Ramsel
66,Bergstraat 71,2021-11-19,08:00:00,134,12,122,FMN GV 11 Ramsel
66,Bergstraat 71,2021-11-19,09:00:00,62,10,52,FMN GV 11 Ramsel
66,Bergstraat 71,2021-11-19,10:00:00,26,6,20,FMN GV 11 Ramsel
66,Bergstraat 71,2021-11-19,11:00:00,28,16,12,FMN GV 11 Ramsel
66,Bergstraat 71,2021-11-19,12:00:00,50,28,22,FMN GV 11 Ramsel
66,Bergstraat 71,2021-11-19,13:00:00,68,44,24,FMN GV 11 Ramsel
66,Bergstraat 71,2021-11-19,14:00:00,96,64,32,FMN GV 11 Ramsel
66,Bergstraat 71,2021-11-19,15:00:00,238,192,46,FMN GV 11 Ramsel
66,Bergstraat 71,2021-11-19,16:00:00,126,102,24,FMN GV 11 Ramsel
66,Bergstraat 71,2021-11-19,17:00:00,50,30,20,FMN GV 11 Ramsel
66,Bergstraat 71,2021-11-19,18:00:00,18,16,2,FMN GV 11 Ramsel
66,Bergstraat 71,2021-11-19,19:00:00,26,12,14,FMN GV 11 Ramsel
66,Bergstraat 71,2021-11-19,20:00:00,22,6,16,FMN GV 11 Ramsel
66,Bergstraat 71,2021-11-19,21:00:00,10,6,4,FMN GV 11 Ramsel
66,Bergstraat 71,2021-11-19,22:00:00,10,6,4,FMN GV 11 Ramsel
66,Bergstraat 71,2021-11-19,23:00:00,2,2,0,FMN GV 11 Ramsel
66,Bergstraat 71,2021-11-20,00:00:00,8,4,4,FMN GV 11 Ramsel
66,Bergstraat 71,2021-11-20,01:00:00,0,0,0,FMN GV 11 Ramsel
66,Bergstraat 71,2021-11-20,02:00:00,2,2,0,FMN GV 11 Ramsel
66,Bergstraat 71,2021-11-20,03:00:00,0,0,0,FMN GV 11 Ramsel
66,Bergstraat 71,2021-11-20,04:00:00,0,0,0,FMN GV 11 Ramsel
66,Bergstraat 71,2021-11-20,05:00:00,0,0,0,FMN GV 11 Ramsel
66,Bergstraat 71,2021-11-20,06:00:00,4,0,4,FMN GV 11 Ramsel
66,Bergstraat 71,2021-11-20,07:00:00,12,10,2,FMN GV 11 Ramsel
66,Bergstraat 71,2021-11-20,08:00:00,26,12,14,FMN GV 11 Ramsel
66,Bergstraat 71,2021-11-20,09:00:00,62,22,40,FMN GV 11 Ramsel
66,Bergstraat 71,2021-11-20,10:00:00,76,22,54,FMN GV 11 Ramsel
66,Bergstraat 71,2021-11-20,11:00:00,60,32,28,FMN GV 11 Ramsel
66,Bergstraat 71,2021-11-20,12:00:00,62,24,38,FMN GV 11 Ramsel
66,Bergstraat 71,2021-11-20,13:00:00,106,34,72,FMN GV 11 Ramsel
66,Bergstraat 71,2021-11-20,14:00:00,98,30,68,FMN GV 11 Ramsel
66,Bergstraat 71,2021-11-20,15:00:00,148,90,58,FMN GV 11 Ramsel
66,Bergstraat 71,2021-11-20,16:00:00,80,58,22,FMN GV 11 Ramsel
66,Bergstraat 71,2021-11-20,17:00:00,28,12,16,FMN GV 11 Ramsel
66,Bergstraat 71,2021-11-20,18:00:00,18,12,6,FMN GV 11 Ramsel
66,Bergstraat 71,2021-11-20,19:00:00,10,2,8,FMN GV 11 Ramsel
66,Bergstraat 71,2021-11-20,20:00:00,4,2,2,FMN GV 11 Ramsel
66,Bergstraat 71,2021-11-20,21:00:00,14,12,2,FMN GV 11 Ramsel
66,Bergstraat 71,2021-11-20,22:00:00,6,4,2,FMN GV 11 Ramsel
66,Bergstraat 71,2021-11-20,23:00:00,6,6,0,FMN GV 11 Ramsel
66,Bergstraat 71,2021-11-21,00:00:00,6,2,4,FMN GV 11 Ramsel
66,Bergstraat 71,2021-11-21,01:00:00,4,4,0,FMN GV 11 Ramsel
66,Bergstraat 71,2021-11-21,02:00:00,2,2,0,FMN GV 11 Ramsel
66,Bergstraat 71,2021-11-21,03:00:00,0,0,0,FMN GV 11 Ramsel
66,Bergstraat 71,2021-11-21,04:00:00,4,4,0,FMN GV 11 Ramsel
66,Bergstraat 71,2021-11-21,05:00:00,2,2,0,FMN GV 11 Ramsel
66,Bergstraat 71,2021-11-21,06:00:00,4,4,0,FMN GV 11 Ramsel
66,Bergstraat 71,2021-11-21,07:00:00,14,2,12,FMN GV 11 Ramsel
66,Bergstraat 71,2021-11-21,08:00:00,24,2,22,FMN GV 11 Ramsel
66,Bergstraat 71,2021-11-21,09:00:00,20,10,10,FMN GV 11 Ramsel
66,Bergstraat 71,2021-11-21,10:00:00,30,18,12,FMN GV 11 Ramsel
66,Bergstraat 71,2021-11-21,11:00:00,46,28,18,FMN GV 11 Ramsel
66,Bergstraat 71,2021-11-21,12:00:00,24,22,2,FMN GV 11 Ramsel
66,Bergstraat 71,2021-11-21,13:00:00,52,28,24,FMN GV 11 Ramsel
66,Bergstraat 71,2021-11-21,14:00:00,56,20,36,FMN GV 11 Ramsel
66,Bergstraat 71,2021-11-21,15:00:00,60,28,32,FMN GV 11 Ramsel
66,Bergstraat 71,2021-11-21,16:00:00,40,26,14,FMN GV 11 Ramsel
66,Bergstraat 71,2021-11-21,17:00:00,20,12,8,FMN GV 11 Ramsel
66,Bergstraat 71,2021-11-21,18:00:00,14,8,6,FMN GV 11 Ramsel
66,Bergstraat 71,2021-11-21,19:00:00,14,4,10,FMN GV 11 Ramsel
66,Bergstraat 71,2021-11-21,20:00:00,10,4,6,FMN GV 11 Ramsel
66,Bergstraat 71,2021-11-21,21:00:00,6,4,2,FMN GV 11 Ramsel
66,Bergstraat 71,2021-11-21,22:00:00,6,4,2,FMN GV 11 Ramsel
66,Bergstraat 71,2021-11-21,23:00:00,0,0,0,FMN GV 11 Ramsel
66,Bergstraat 71,2021-11-22,00:00:00,0,0,0,FMN GV 11 Ramsel
66,Bergstraat 71,2021-11-22,01:00:00,0,0,0,FMN GV 11 Ramsel
66,Bergstraat 71,2021-11-22,02:00:00,0,0,0,FMN GV 11 Ramsel
66,Bergstraat 71,2021-11-22,03:00:00,0,0,0,FMN GV 11 Ramsel
66,Bergstraat 71,2021-11-22,04:00:00,2,2,0,FMN GV 11 Ramsel
66,Bergstraat 71,2021-11-22,05:00:00,10,6,4,FMN GV 11 Ramsel
66,Bergstraat 71,2021-11-22,06:00:00,22,4,18,FMN GV 11 Ramsel
66,Bergstraat 71,2021-11-22,07:00:00,184,16,168,FMN GV 11 Ramsel
66,Bergstraat 71,2021-11-22,08:00:00,178,20,158,FMN GV 11 Ramsel
66,Bergstraat 71,2021-11-22,09:00:00,46,20,26,FMN GV 11 Ramsel
66,Bergstraat 71,2021-11-22,10:00:00,58,26,32,FMN GV 11 Ramsel
66,Bergstraat 71,2021-11-22,11:00:00,48,24,24,FMN GV 11 Ramsel
66,Bergstraat 71,2021-11-22,12:00:00,48,26,22,FMN GV 11 Ramsel
66,Bergstraat 71,2021-11-22,13:00:00,96,52,44,FMN GV 11 Ramsel
66,Bergstraat 71,2021-11-22,14:00:00,110,66,44,FMN GV 11 Ramsel
66,Bergstraat 71,2021-11-22,15:00:00,286,224,62,FMN GV 11 Ramsel
66,Bergstraat 71,2021-11-22,16:00:00,138,110,28,FMN GV 11 Ramsel
66,Bergstraat 71,2021-11-22,17:00:00,48,34,14,FMN GV 11 Ramsel
66,Bergstraat 71,2021-11-22,18:00:00,16,10,6,FMN GV 11 Ramsel
66,Bergstraat 71,2021-11-22,19:00:00,22,8,14,FMN GV 11 Ramsel
66,Bergstraat 71,2021-11-22,20:00:00,32,14,18,FMN GV 11 Ramsel
66,Bergstraat 71,2021-11-22,21:00:00,16,12,4,FMN GV 11 Ramsel
66,Bergstraat 71,2021-11-22,22:00:00,20,14,6,FMN GV 11 Ramsel
66,Bergstraat 71,2021-11-22,23:00:00,2,0,2,FMN GV 11 Ramsel
66,Bergstraat 71,2021-11-23,00:00:00,0,0,0,FMN GV 11 Ramsel
66,Bergstraat 71,2021-11-23,01:00:00,0,0,0,FMN GV 11 Ramsel
66,Bergstraat 71,2021-11-23,02:00:00,0,0,0,FMN GV 11 Ramsel
66,Bergstraat 71,2021-11-23,03:00:00,0,0,0,FMN GV 11 Ramsel
66,Bergstraat 71,2021-11-23,04:00:00,4,4,0,FMN GV 11 Ramsel
66,Bergstraat 71,2021-11-23,05:00:00,12,6,6,FMN GV 11 Ramsel
66,Bergstraat 71,2021-11-23,06:00:00,20,8,12,FMN GV 11 Ramsel
66,Bergstraat 71,2021-11-23,07:00:00,166,22,144,FMN GV 11 Ramsel
66,Bergstraat 71,2021-11-23,08:00:00,148,8,140,FMN GV 11 Ramsel
66,Bergstraat 71,2021-11-23,09:00:00,30,12,18,FMN GV 11 Ramsel
66,Bergstraat 71,2021-11-23,10:00:00,26,10,16,FMN GV 11 Ramsel
66,Bergstraat 71,2021-11-23,11:00:00,36,16,20,FMN GV 11 Ramsel
66,Bergstraat 71,2021-11-23,12:00:00,50,34,16,FMN GV 11 Ramsel
66,Bergstraat 71,2021-11-23,13:00:00,94,54,40,FMN GV 11 Ramsel
66,Bergstraat 71,2021-11-23,14:00:00,132,88,44,FMN GV 11 Ramsel
66,Bergstraat 71,2021-11-23,15:00:00,236,200,36,FMN GV 11 Ramsel
66,Bergstraat 71,2021-11-23,16:00:00,156,128,28,FMN GV 11 Ramsel
66,Bergstraat 71,2021-11-23,17:00:00,42,20,22,FMN GV 11 Ramsel
66,Bergstraat 71,2021-11-23,18:00:00,36,24,12,FMN GV 11 Ramsel
66,Bergstraat 71,2021-11-23,19:00:00,36,12,24,FMN GV 11 Ramsel
66,Bergstraat 71,2021-11-23,20:00:00,30,20,10,FMN GV 11 Ramsel
66,Bergstraat 71,2021-11-23,21:00:00,18,8,10,FMN GV 11 Ramsel
66,Bergstraat 71,2021-11-23,22:00:00,16,10,6,FMN GV 11 Ramsel
66,Bergstraat 71,2021-11-23,23:00:00,6,6,0,FMN GV 11 Ramsel
66,Bergstraat 71,2021-11-24,00:00:00,0,0,0,FMN GV 11 Ramsel
66,Bergstraat 71,2021-11-24,01:00:00,0,0,0,FMN GV 11 Ramsel
66,Bergstraat 71,2021-11-24,02:00:00,0,0,0,FMN GV 11 Ramsel
66,Bergstraat 71,2021-11-24,03:00:00,0,0,0,FMN GV 11 Ramsel
66,Bergstraat 71,2021-11-24,04:00:00,2,2,0,FMN GV 11 Ramsel
66,Bergstraat 71,2021-11-24,05:00:00,8,4,4,FMN GV 11 Ramsel
66,Bergstraat 71,2021-11-24,06:00:00,24,4,20,FMN GV 11 Ramsel
66,Bergstraat 71,2021-11-24,07:00:00,178,20,158,FMN GV 11 Ramsel
66,Bergstraat 71,2021-11-24,08:00:00,140,12,128,FMN GV 11 Ramsel
66,Bergstraat 71,2021-11-24,09:00:00,44,16,28,FMN GV 11 Ramsel
66,Bergstraat 71,2021-11-24,10:00:00,18,6,12,FMN GV 11 Ramsel
66,Bergstraat 71,2021-11-24,11:00:00,36,16,20,FMN GV 11 Ramsel
66,Bergstraat 71,2021-11-24,12:00:00,222,206,16,FMN GV 11 Ramsel
66,Bergstraat 71,2021-11-24,13:00:00,64,28,36,FMN GV 11 Ramsel
66,Bergstraat 71,2021-11-24,14:00:00,88,46,42,FMN GV 11 Ramsel
66,Bergstraat 71,2021-11-24,15:00:00,88,46,42,FMN GV 11 Ramsel
66,Bergstraat 71,2021-11-24,16:00:00,68,42,26,FMN GV 11 Ramsel
66,Bergstraat 71,2021-11-24,17:00:00,82,50,32,FMN GV 11 Ramsel
66,Bergstraat 71,2021-11-24,18:00:00,36,12,24,FMN GV 11 Ramsel
66,Bergstraat 71,2021-11-24,19:00:00,42,30,12,FMN GV 11 Ramsel
66,Bergstraat 71,2021-11-24,20:00:00,16,8,8,FMN GV 11 Ramsel
66,Bergstraat 71,2021-11-24,21:00:00,8,2,6,FMN GV 11 Ramsel
66,Bergstraat 71,2021-11-24,22:00:00,12,10,2,FMN GV 11 Ramsel
66,Bergstraat 71,2021-11-24,23:00:00,2,0,2,FMN GV 11 Ramsel
66,Bergstraat 71,2021-11-25,00:00:00,0,0,0,FMN GV 11 Ramsel
66,Bergstraat 71,2021-11-25,01:00:00,0,0,0,FMN GV 11 Ramsel
66,Bergstraat 71,2021-11-25,02:00:00,0,0,0,FMN GV 11 Ramsel
66,Bergstraat 71,2021-11-25,03:00:00,0,0,0,FMN GV 11 Ramsel
66,Bergstraat 71,2021-11-25,04:00:00,6,6,0,FMN GV 11 Ramsel
66,Bergstraat 71,2021-11-25,05:00:00,8,4,4,FMN GV 11 Ramsel
66,Bergstraat 71,2021-11-25,06:00:00,18,4,14,FMN GV 11 Ramsel
66,Bergstraat 71,2021-11-25,07:00:00,162,20,142,FMN GV 11 Ramsel
66,Bergstraat 71,2021-11-25,08:00:00,132,16,116,FMN GV 11 Ramsel
66,Bergstraat 71,2021-11-25,09:00:00,36,12,24,FMN GV 11 Ramsel
66,Bergstraat 71,2021-11-25,10:00:00,24,6,18,FMN GV 11 Ramsel
66,Bergstraat 71,2021-11-25,11:00:00,38,22,16,FMN GV 11 Ramsel
66,Bergstraat 71,2021-11-25,12:00:00,34,26,8,FMN GV 11 Ramsel
66,Bergstraat 71,2021-11-25,13:00:00,34,16,18,FMN GV 11 Ramsel
66,Bergstraat 71,2021-11-25,14:00:00,38,20,18,FMN GV 11 Ramsel
66,Bergstraat 71,2021-11-25,15:00:00,146,130,16,FMN GV 11 Ramsel
66,Bergstraat 71,2021-11-25,16:00:00,108,86,22,FMN GV 11 Ramsel
66,Bergstraat 71,2021-11-25,17:00:00,52,36,16,FMN GV 11 Ramsel
66,Bergstraat 71,2021-11-25,18:00:00,30,14,16,FMN GV 11 Ramsel
66,Bergstraat 71,2021-11-25,19:00:00,8,4,4,FMN GV 11 Ramsel
66,Bergstraat 71,2021-11-25,20:00:00,20,14,6,FMN GV 11 Ramsel
66,Bergstraat 71,2021-11-25,21:00:00,18,12,6,FMN GV 11 Ramsel
66,Bergstraat 71,2021-11-25,22:00:00,12,12,0,FMN GV 11 Ramsel
66,Bergstraat 71,2021-11-25,23:00:00,6,0,6,FMN GV 11 Ramsel
66,Bergstraat 71,2021-11-26,00:00:00,2,2,0,FMN GV 11 Ramsel
66,Bergstraat 71,2021-11-26,01:00:00,0,0,0,FMN GV 11 Ramsel
66,Bergstraat 71,2021-11-26,02:00:00,0,0,0,FMN GV 11 Ramsel
66,Bergstraat 71,2021-11-26,03:00:00,2,2,0,FMN GV 11 Ramsel
66,Bergstraat 71,2021-11-26,04:00:00,4,4,0,FMN GV 11 Ramsel
66,Bergstraat 71,2021-11-26,05:00:00,6,6,0,FMN GV 11 Ramsel
66,Bergstraat 71,2021-11-26,06:00:00,22,2,20,FMN GV 11 Ramsel
66,Bergstraat 71,2021-11-26,07:00:00,148,12,136,FMN GV 11 Ramsel
66,Bergstraat 71,2021-11-26,08:00:00,124,6,118,FMN GV 11 Ramsel
66,Bergstraat 71,2021-11-26,09:00:00,74,18,56,FMN GV 11 Ramsel
66,Bergstraat 71,2021-11-26,10:00:00,38,16,22,FMN GV 11 Ramsel
66,Bergstraat 71,2021-11-26,11:00:00,32,22,10,FMN GV 11 Ramsel
66,Bergstraat 71,2021-11-26,12:00:00,34,18,16,FMN GV 11 Ramsel
66,Bergstraat 71,2021-11-26,13:00:00,30,22,8,FMN GV 11 Ramsel
66,Bergstraat 71,2021-11-26,14:00:00,44,36,8,FMN GV 11 Ramsel
66,Bergstraat 71,2021-11-26,15:00:00,120,116,4,FMN GV 11 Ramsel
66,Bergstraat 71,2021-11-26,16:00:00,80,70,10,FMN GV 11 Ramsel
66,Bergstraat 71,2021-11-26,17:00:00,30,24,6,FMN GV 11 Ramsel
66,Bergstraat 71,2021-11-26,18:00:00,20,10,10,FMN GV 11 Ramsel
66,Bergstraat 71,2021-11-26,19:00:00,10,4,6,FMN GV 11 Ramsel
66,Bergstraat 71,2021-11-26,20:00:00,6,4,2,FMN GV 11 Ramsel
66,Bergstraat 71,2021-11-26,21:00:00,10,4,6,FMN GV 11 Ramsel
66,Bergstraat 71,2021-11-26,22:00:00,6,4,2,FMN GV 11 Ramsel
66,Bergstraat 71,2021-11-26,23:00:00,2,0,2,FMN GV 11 Ramsel
66,Bergstraat 71,2021-11-27,00:00:00,0,0,0,FMN GV 11 Ramsel
66,Bergstraat 71,2021-11-27,01:00:00,0,0,0,FMN GV 11 Ramsel
66,Bergstraat 71,2021-11-27,02:00:00,0,0,0,FMN GV 11 Ramsel
66,Bergstraat 71,2021-11-27,03:00:00,0,0,0,FMN GV 11 Ramsel
66,Bergstraat 71,2021-11-27,04:00:00,2,2,0,FMN GV 11 Ramsel
66,Bergstraat 71,2021-11-27,05:00:00,6,6,0,FMN GV 11 Ramsel
66,Bergstraat 71,2021-11-27,06:00:00,4,2,2,FMN GV 11 Ramsel
66,Bergstraat 71,2021-11-27,07:00:00,2,2,0,FMN GV 11 Ramsel
66,Bergstraat 71,2021-11-27,08:00:00,4,2,2,FMN GV 11 Ramsel
66,Bergstraat 71,2021-11-27,09:00:00,12,8,4,FMN GV 11 Ramsel
66,Bergstraat 71,2021-11-27,10:00:00,42,18,24,FMN GV 11 Ramsel
66,Bergstraat 71,2021-11-27,11:00:00,40,16,24,FMN GV 11 Ramsel
66,Bergstraat 71,2021-11-27,12:00:00,56,34,22,FMN GV 11 Ramsel
66,Bergstraat 71,2021-11-27,13:00:00,102,56,46,FMN GV 11 Ramsel
66,Bergstraat 71,2021-11-27,14:00:00,114,56,58,FMN GV 11 Ramsel
66,Bergstraat 71,2021-11-27,15:00:00,82,46,36,FMN GV 11 Ramsel
66,Bergstraat 71,2021-11-27,16:00:00,58,34,24,FMN GV 11 Ramsel
66,Bergstraat 71,2021-11-27,17:00:00,20,8,12,FMN GV 11 Ramsel
66,Bergstraat 71,2021-11-27,18:00:00,12,8,4,FMN GV 11 Ramsel
66,Bergstraat 71,2021-11-27,19:00:00,8,6,2,FMN GV 11 Ramsel
66,Bergstraat 71,2021-11-27,20:00:00,8,4,4,FMN GV 11 Ramsel
66,Bergstraat 71,2021-11-27,21:00:00,2,2,0,FMN GV 11 Ramsel
66,Bergstraat 71,2021-11-27,22:00:00,2,0,2,FMN GV 11 Ramsel
66,Bergstraat 71,2021-11-27,23:00:00,10,10,0,FMN GV 11 Ramsel
66,Bergstraat 71,2021-11-28,00:00:00,4,0,4,FMN GV 11 Ramsel
66,Bergstraat 71,2021-11-28,01:00:00,0,0,0,FMN GV 11 Ramsel
66,Bergstraat 71,2021-11-28,02:00:00,0,0,0,FMN GV 11 Ramsel
66,Bergstraat 71,2021-11-28,03:00:00,0,0,0,FMN GV 11 Ramsel
66,Bergstraat 71,2021-11-28,04:00:00,2,2,0,FMN GV 11 Ramsel
66,Bergstraat 71,2021-11-28,05:00:00,0,0,0,FMN GV 11 Ramsel
66,Bergstraat 71,2021-11-28,06:00:00,4,4,0,FMN GV 11 Ramsel
66,Bergstraat 71,2021-11-28,07:00:00,0,0,0,FMN GV 11 Ramsel
66,Bergstraat 71,2021-11-28,08:00:00,10,2,8,FMN GV 11 Ramsel
66,Bergstraat 71,2021-11-28,09:00:00,66,34,32,FMN GV 11 Ramsel
66,Bergstraat 71,2021-11-28,10:00:00,52,30,22,FMN GV 11 Ramsel
66,Bergstraat 71,2021-11-28,11:00:00,64,44,20,FMN GV 11 Ramsel
66,Bergstraat 71,2021-11-28,12:00:00,44,28,16,FMN GV 11 Ramsel
66,Bergstraat 71,2021-11-28,13:00:00,58,36,22,FMN GV 11 Ramsel
66,Bergstraat 71,2021-11-28,14:00:00,24,16,8,FMN GV 11 Ramsel
66,Bergstraat 71,2021-11-28,15:00:00,30,10,20,FMN GV 11 Ramsel
66,Bergstraat 71,2021-11-28,16:00:00,20,10,10,FMN GV 11 Ramsel
66,Bergstraat 71,2021-11-28,17:00:00,6,4,2,FMN GV 11 Ramsel
66,Bergstraat 71,2021-11-28,18:00:00,4,4,0,FMN GV 11 Ramsel
66,Bergstraat 71,2021-11-28,19:00:00,18,6,12,FMN GV 11 Ramsel
66,Bergstraat 71,2021-11-28,20:00:00,4,0,4,FMN GV 11 Ramsel
66,Bergstraat 71,2021-11-28,21:00:00,2,0,2,FMN GV 11 Ramsel
66,Bergstraat 71,2021-11-28,22:00:00,4,4,0,FMN GV 11 Ramsel
66,Bergstraat 71,2021-11-28,23:00:00,2,2,0,FMN GV 11 Ramsel
66,Bergstraat 71,2021-11-29,00:00:00,2,2,0,FMN GV 11 Ramsel
66,Bergstraat 71,2021-11-29,01:00:00,0,0,0,FMN GV 11 Ramsel
66,Bergstraat 71,2021-11-29,02:00:00,0,0,0,FMN GV 11 Ramsel
66,Bergstraat 71,2021-11-29,03:00:00,0,0,0,FMN GV 11 Ramsel
66,Bergstraat 71,2021-11-29,04:00:00,2,2,0,FMN GV 11 Ramsel
66,Bergstraat 71,2021-11-29,05:00:00,0,0,0,FMN GV 11 Ramsel
66,Bergstraat 71,2021-11-29,06:00:00,12,8,4,FMN GV 11 Ramsel
66,Bergstraat 71,2021-11-29,07:00:00,66,20,46,FMN GV 11 Ramsel
66,Bergstraat 71,2021-11-29,08:00:00,76,8,68,FMN GV 11 Ramsel
66,Bergstraat 71,2021-11-29,09:00:00,16,4,12,FMN GV 11 Ramsel
66,Bergstraat 71,2021-11-29,10:00:00,24,22,2,FMN GV 11 Ramsel
66,Bergstraat 71,2021-11-29,11:00:00,28,12,16,FMN GV 11 Ramsel
66,Bergstraat 71,2021-11-29,12:00:00,50,32,18,FMN GV 11 Ramsel
66,Bergstraat 71,2021-11-29,13:00:00,66,34,32,FMN GV 11 Ramsel
66,Bergstraat 71,2021-11-29,14:00:00,58,32,26,FMN GV 11 Ramsel
66,Bergstraat 71,2021-11-29,15:00:00,124,98,26,FMN GV 11 Ramsel
66,Bergstraat 71,2021-11-29,16:00:00,138,118,20,FMN GV 11 Ramsel
66,Bergstraat 71,2021-11-29,17:00:00,36,24,12,FMN GV 11 Ramsel
66,Bergstraat 71,2021-11-29,18:00:00,6,4,2,FMN GV 11 Ramsel
66,Bergstraat 71,2021-11-29,19:00:00,10,4,6,FMN GV 11 Ramsel
66,Bergstraat 71,2021-11-29,20:00:00,16,12,4,FMN GV 11 Ramsel
66,Bergstraat 71,2021-11-29,21:00:00,10,8,2,FMN GV 11 Ramsel
66,Bergstraat 71,2021-11-29,22:00:00,14,10,4,FMN GV 11 Ramsel
66,Bergstraat 71,2021-11-29,23:00:00,2,2,0,FMN GV 11 Ramsel
66,Bergstraat 71,2021-11-30,00:00:00,0,0,0,FMN GV 11 Ramsel
66,Bergstraat 71,2021-11-30,01:00:00,0,0,0,FMN GV 11 Ramsel
66,Bergstraat 71,2021-11-30,02:00:00,0,0,0,FMN GV 11 Ramsel
66,Bergstraat 71,2021-11-30,03:00:00,2,2,0,FMN GV 11 Ramsel
66,Bergstraat 71,2021-11-30,04:00:00,4,4,0,FMN GV 11 Ramsel
66,Bergstraat 71,2021-11-30,05:00:00,0,0,0,FMN GV 11 Ramsel
66,Bergstraat 71,2021-11-30,06:00:00,14,8,6,FMN GV 11 Ramsel
66,Bergstraat 71,2021-11-30,07:00:00,78,12,66,FMN GV 11 Ramsel
66,Bergstraat 71,2021-11-30,08:00:00,88,12,76,FMN GV 11 Ramsel
66,Bergstraat 71,2021-11-30,09:00:00,14,8,6,FMN GV 11 Ramsel
66,Bergstraat 71,2021-11-30,10:00:00,6,4,2,FMN GV 11 Ramsel
66,Bergstraat 71,2021-11-30,11:00:00,12,6,6,FMN GV 11 Ramsel
66,Bergstraat 71,2021-11-30,12:00:00,22,14,8,FMN GV 11 Ramsel
66,Bergstraat 71,2021-11-30,13:00:00,16,12,4,FMN GV 11 Ramsel
66,Bergstraat 71,2021-11-30,14:00:00,16,10,6,FMN GV 11 Ramsel
66,Bergstraat 71,2021-11-30,15:00:00,58,50,8,FMN GV 11 Ramsel
66,Bergstraat 71,2021-11-30,16:00:00,70,56,14,FMN GV 11 Ramsel
66,Bergstraat 71,2021-11-30,17:00:00,28,12,16,FMN GV 11 Ramsel
66,Bergstraat 71,2021-11-30,18:00:00,14,6,8,FMN GV 11 Ramsel
66,Bergstraat 71,2021-11-30,19:00:00,16,10,6,FMN GV 11 Ramsel
66,Bergstraat 71,2021-11-30,20:00:00,6,2,4,FMN GV 11 Ramsel
66,Bergstraat 71,2021-11-30,21:00:00,8,6,2,FMN GV 11 Ramsel
66,Bergstraat 71,2021-11-30,22:00:00,10,6,4,FMN GV 11 Ramsel
66,Bergstraat 71,2021-11-30,23:00:00,0,0,0,FMN GV 11 Ramsel
66,Bergstraat 71,2021-12-01,00:00:00,4,2,2,FMN GV 11 Ramsel
66,Bergstraat 71,2021-12-01,01:00:00,0,0,0,FMN GV 11 Ramsel
66,Bergstraat 71,2021-12-01,02:00:00,0,0,0,FMN GV 11 Ramsel
66,Bergstraat 71,2021-12-01,03:00:00,0,0,0,FMN GV 11 Ramsel
66,Bergstraat 71,2021-12-01,04:00:00,4,4,0,FMN GV 11 Ramsel
66,Bergstraat 71,2021-12-01,05:00:00,0,0,0,FMN GV 11 Ramsel
66,Bergstraat 71,2021-12-01,06:00:00,10,4,6,FMN GV 11 Ramsel
66,Bergstraat 71,2021-12-01,07:00:00,82,12,70,FMN GV 11 Ramsel
66,Bergstraat 71,2021-12-01,08:00:00,70,10,60,FMN GV 11 Ramsel
66,Bergstraat 71,2021-12-01,09:00:00,18,6,12,FMN GV 11 Ramsel
66,Bergstraat 71,2021-12-01,10:00:00,12,6,6,FMN GV 11 Ramsel
66,Bergstraat 71,2021-12-01,11:00:00,14,12,2,FMN GV 11 Ramsel
66,Bergstraat 71,2021-12-01,12:00:00,92,90,2,FMN GV 11 Ramsel
66,Bergstraat 71,2021-12-01,13:00:00,32,16,16,FMN GV 11 Ramsel
66,Bergstraat 71,2021-12-01,14:00:00,30,10,20,FMN GV 11 Ramsel
66,Bergstraat 71,2021-12-01,15:00:00,22,18,4,FMN GV 11 Ramsel
66,Bergstraat 71,2021-12-01,16:00:00,28,14,14,FMN GV 11 Ramsel
66,Bergstraat 71,2021-12-01,17:00:00,22,10,12,FMN GV 11 Ramsel
66,Bergstraat 71,2021-12-01,18:00:00,26,14,12,FMN GV 11 Ramsel
66,Bergstraat 71,2021-12-01,19:00:00,28,10,18,FMN GV 11 Ramsel
66,Bergstraat 71,2021-12-01,20:00:00,4,2,2,FMN GV 11 Ramsel
66,Bergstraat 71,2021-12-01,21:00:00,4,0,4,FMN GV 11 Ramsel
66,Bergstraat 71,2021-12-01,22:00:00,10,6,4,FMN GV 11 Ramsel
66,Bergstraat 71,2021-12-01,23:00:00,2,2,0,FMN GV 11 Ramsel
66,Bergstraat 71,2021-12-02,00:00:00,0,0,0,FMN GV 11 Ramsel
66,Bergstraat 71,2021-12-02,01:00:00,4,4,0,FMN GV 11 Ramsel
66,Bergstraat 71,2021-12-02,02:00:00,2,2,0,FMN GV 11 Ramsel
66,Bergstraat 71,2021-12-02,03:00:00,0,0,0,FMN GV 11 Ramsel
66,Bergstraat 71,2021-12-02,04:00:00,2,2,0,FMN GV 11 Ramsel
66,Bergstraat 71,2021-12-02,05:00:00,0,0,0,FMN GV 11 Ramsel
66,Bergstraat 71,2021-12-02,06:00:00,14,6,8,FMN GV 11 Ramsel
66,Bergstraat 71,2021-12-02,07:00:00,80,12,68,FMN GV 11 Ramsel
66,Bergstraat 71,2021-12-02,08:00:00,70,8,62,FMN GV 11 Ramsel
66,Bergstraat 71,2021-12-02,09:00:00,8,2,6,FMN GV 11 Ramsel
66,Bergstraat 71,2021-12-02,10:00:00,6,6,0,FMN GV 11 Ramsel
66,Bergstraat 71,2021-12-02,11:00:00,18,6,12,FMN GV 11 Ramsel
66,Bergstraat 71,2021-12-02,12:00:00,24,20,4,FMN GV 11 Ramsel
66,Bergstraat 71,2021-12-02,13:00:00,38,18,20,FMN GV 11 Ramsel
66,Bergstraat 71,2021-12-02,14:00:00,36,22,14,FMN GV 11 Ramsel
66,Bergstraat 71,2021-12-02,15:00:00,76,66,10,FMN GV 11 Ramsel
66,Bergstraat 71,2021-12-02,16:00:00,44,34,10,FMN GV 11 Ramsel
66,Bergstraat 71,2021-12-02,17:00:00,30,18,12,FMN GV 11 Ramsel
66,Bergstraat 71,2021-12-02,18:00:00,16,10,6,FMN GV 11 Ramsel
66,Bergstraat 71,2021-12-02,19:00:00,6,2,4,FMN GV 11 Ramsel
66,Bergstraat 71,2021-12-02,20:00:00,14,10,4,FMN GV 11 Ramsel
66,Bergstraat 71,2021-12-02,21:00:00,8,0,8,FMN GV 11 Ramsel
66,Bergstraat 71,2021-12-02,22:00:00,14,8,6,FMN GV 11 Ramsel
66,Bergstraat 71,2021-12-02,23:00:00,2,0,2,FMN GV 11 Ramsel
66,Bergstraat 71,2021-12-03,00:00:00,0,0,0,FMN GV 11 Ramsel
66,Bergstraat 71,2021-12-03,01:00:00,0,0,0,FMN GV 11 Ramsel
66,Bergstraat 71,2021-12-03,02:00:00,2,0,2,FMN GV 11 Ramsel
66,Bergstraat 71,2021-12-03,03:00:00,0,0,0,FMN GV 11 Ramsel
66,Bergstraat 71,2021-12-03,04:00:00,4,4,0,FMN GV 11 Ramsel
66,Bergstraat 71,2021-12-03,05:00:00,4,2,2,FMN GV 11 Ramsel
66,Bergstraat 71,2021-12-03,06:00:00,6,0,6,FMN GV 11 Ramsel
66,Bergstraat 71,2021-12-03,07:00:00,64,18,46,FMN GV 11 Ramsel
66,Bergstraat 71,2021-12-03,08:00:00,78,12,66,FMN GV 11 Ramsel
66,Bergstraat 71,2021-12-03,09:00:00,30,8,22,FMN GV 11 Ramsel
66,Bergstraat 71,2021-12-03,10:00:00,22,10,12,FMN GV 11 Ramsel
66,Bergstraat 71,2021-12-03,11:00:00,26,20,6,FMN GV 11 Ramsel
66,Bergstraat 71,2021-12-03,12:00:00,14,4,10,FMN GV 11 Ramsel
66,Bergstraat 71,2021-12-03,13:00:00,54,26,28,FMN GV 11 Ramsel
66,Bergstraat 71,2021-12-03,14:00:00,66,42,24,FMN GV 11 Ramsel
66,Bergstraat 71,2021-12-03,15:00:00,72,52,20,FMN GV 11 Ramsel
66,Bergstraat 71,2021-12-03,16:00:00,56,46,10,FMN GV 11 Ramsel
66,Bergstraat 71,2021-12-03,17:00:00,18,10,8,FMN GV 11 Ramsel
66,Bergstraat 71,2021-12-03,18:00:00,14,6,8,FMN GV 11 Ramsel
66,Bergstraat 71,2021-12-03,19:00:00,16,6,10,FMN GV 11 Ramsel
66,Bergstraat 71,2021-12-03,20:00:00,8,8,0,FMN GV 11 Ramsel
66,Bergstraat 71,2021-12-03,21:00:00,12,6,6,FMN GV 11 Ramsel
66,Bergstraat 71,2021-12-03,22:00:00,12,8,4,FMN GV 11 Ramsel
66,Bergstraat 71,2021-12-03,23:00:00,4,4,0,FMN GV 11 Ramsel
66,Bergstraat 71,2021-12-04,00:00:00,0,0,0,FMN GV 11 Ramsel
66,Bergstraat 71,2021-12-04,01:00:00,0,0,0,FMN GV 11 Ramsel
66,Bergstraat 71,2021-12-04,02:00:00,2,2,0,FMN GV 11 Ramsel
66,Bergstraat 71,2021-12-04,03:00:00,0,0,0,FMN GV 11 Ramsel
66,Bergstraat 71,2021-12-04,04:00:00,2,2,0,FMN GV 11 Ramsel
66,Bergstraat 71,2021-12-04,05:00:00,0,0,0,FMN GV 11 Ramsel
66,Bergstraat 71,2021-12-04,06:00:00,0,0,0,FMN GV 11 Ramsel
66,Bergstraat 71,2021-12-04,07:00:00,4,2,2,FMN GV 11 Ramsel
66,Bergstraat 71,2021-12-04,08:00:00,16,4,12,FMN GV 11 Ramsel
66,Bergstraat 71,2021-12-04,09:00:00,34,10,24,FMN GV 11 Ramsel
66,Bergstraat 71,2021-12-04,10:00:00,74,32,42,FMN GV 11 Ramsel
66,Bergstraat 71,2021-12-04,11:00:00,48,24,24,FMN GV 11 Ramsel
66,Bergstraat 71,2021-12-04,12:00:00,32,22,10,FMN GV 11 Ramsel
66,Bergstraat 71,2021-12-04,13:00:00,8,6,2,FMN GV 11 Ramsel
66,Bergstraat 71,2021-12-04,14:00:00,10,6,4,FMN GV 11 Ramsel
66,Bergstraat 71,2021-12-04,15:00:00,6,2,4,FMN GV 11 Ramsel
66,Bergstraat 71,2021-12-04,16:00:00,18,8,10,FMN GV 11 Ramsel
66,Bergstraat 71,2021-12-04,17:00:00,14,8,6,FMN GV 11 Ramsel
66,Bergstraat 71,2021-12-04,18:00:00,18,6,12,FMN GV 11 Ramsel
66,Bergstraat 71,2021-12-04,19:00:00,12,2,10,FMN GV 11 Ramsel
66,Bergstraat 71,2021-12-04,20:00:00,10,6,4,FMN GV 11 Ramsel
66,Bergstraat 71,2021-12-04,21:00:00,6,6,0,FMN GV 11 Ramsel
66,Bergstraat 71,2021-12-04,22:00:00,4,2,2,FMN GV 11 Ramsel
66,Bergstraat 71,2021-12-04,23:00:00,12,8,4,FMN GV 11 Ramsel
66,Bergstraat 71,2021-12-05,00:00:00,2,2,0,FMN GV 11 Ramsel
66,Bergstraat 71,2021-12-05,01:00:00,2,0,2,FMN GV 11 Ramsel
66,Bergstraat 71,2021-12-05,02:00:00,0,0,0,FMN GV 11 Ramsel
66,Bergstraat 71,2021-12-05,03:00:00,0,0,0,FMN GV 11 Ramsel
66,Bergstraat 71,2021-12-05,04:00:00,0,0,0,FMN GV 11 Ramsel
66,Bergstraat 71,2021-12-05,05:00:00,0,0,0,FMN GV 11 Ramsel
66,Bergstraat 71,2021-12-05,06:00:00,0,0,0,FMN GV 11 Ramsel
66,Bergstraat 71,2021-12-05,07:00:00,0,0,0,FMN GV 11 Ramsel
66,Bergstraat 71,2021-12-05,08:00:00,8,2,6,FMN GV 11 Ramsel
66,Bergstraat 71,2021-12-05,09:00:00,24,12,12,FMN GV 11 Ramsel
66,Bergstraat 71,2021-12-05,10:00:00,36,18,18,FMN GV 11 Ramsel
66,Bergstraat 71,2021-12-05,11:00:00,58,28,30,FMN GV 11 Ramsel
66,Bergstraat 71,2021-12-05,12:00:00,20,10,10,FMN GV 11 Ramsel
66,Bergstraat 71,2021-12-05,13:00:00,50,18,32,FMN GV 11 Ramsel
66,Bergstraat 71,2021-12-05,14:00:00,44,32,12,FMN GV 11 Ramsel
66,Bergstraat 71,2021-12-05,15:00:00,34,26,8,FMN GV 11 Ramsel
66,Bergstraat 71,2021-12-05,16:00:00,16,8,8,FMN GV 11 Ramsel
66,Bergstraat 71,2021-12-05,17:00:00,18,6,12,FMN GV 11 Ramsel
66,Bergstraat 71,2021-12-05,18:00:00,6,0,6,FMN GV 11 Ramsel
66,Bergstraat 71,2021-12-05,19:00:00,14,10,4,FMN GV 11 Ramsel
66,Bergstraat 71,2021-12-05,20:00:00,6,2,4,FMN GV 11 Ramsel
66,Bergstraat 71,2021-12-05,21:00:00,0,0,0,FMN GV 11 Ramsel
66,Bergstraat 71,2021-12-05,22:00:00,2,2,0,FMN GV 11 Ramsel
66,Bergstraat 71,2021-12-05,23:00:00,0,0,0,FMN GV 11 Ramsel
66,Bergstraat 71,2021-12-06,00:00:00,2,0,2,FMN GV 11 Ramsel
66,Bergstraat 71,2021-12-06,01:00:00,0,0,0,FMN GV 11 Ramsel
66,Bergstraat 71,2021-12-06,02:00:00,0,0,0,FMN GV 11 Ramsel
66,Bergstraat 71,2021-12-06,03:00:00,2,0,2,FMN GV 11 Ramsel
66,Bergstraat 71,2021-12-06,04:00:00,2,2,0,FMN GV 11 Ramsel
66,Bergstraat 71,2021-12-06,05:00:00,6,2,4,FMN GV 11 Ramsel
66,Bergstraat 71,2021-12-06,06:00:00,12,0,12,FMN GV 11 Ramsel
66,Bergstraat 71,2021-12-06,07:00:00,80,16,64,FMN GV 11 Ramsel
66,Bergstraat 71,2021-12-06,08:00:00,78,8,70,FMN GV 11 Ramsel
66,Bergstraat 71,2021-12-06,09:00:00,22,12,10,FMN GV 11 Ramsel
66,Bergstraat 71,2021-12-06,10:00:00,36,16,20,FMN GV 11 Ramsel
66,Bergstraat 71,2021-12-06,11:00:00,42,26,16,FMN GV 11 Ramsel
66,Bergstraat 71,2021-12-06,12:00:00,34,20,14,FMN GV 11 Ramsel
66,Bergstraat 71,2021-12-06,13:00:00,76,24,52,FMN GV 11 Ramsel
66,Bergstraat 71,2021-12-06,14:00:00,88,30,58,FMN GV 11 Ramsel
66,Bergstraat 71,2021-12-06,15:00:00,84,56,28,FMN GV 11 Ramsel
66,Bergstraat 71,2021-12-06,16:00:00,96,74,22,FMN GV 11 Ramsel
66,Bergstraat 71,2021-12-06,17:00:00,32,26,6,FMN GV 11 Ramsel
66,Bergstraat 71,2021-12-06,18:00:00,12,10,2,FMN GV 11 Ramsel
66,Bergstraat 71,2021-12-06,19:00:00,14,10,4,FMN GV 11 Ramsel
66,Bergstraat 71,2021-12-06,20:00:00,6,4,2,FMN GV 11 Ramsel
66,Bergstraat 71,2021-12-06,21:00:00,0,0,0,FMN GV 11 Ramsel
66,Bergstraat 71,2021-12-06,22:00:00,6,2,4,FMN GV 11 Ramsel
66,Bergstraat 71,2021-12-06,23:00:00,2,2,0,FMN GV 11 Ramsel
66,Bergstraat 71,2021-12-07,00:00:00,0,0,0,FMN GV 11 Ramsel
66,Bergstraat 71,2021-12-07,01:00:00,0,0,0,FMN GV 11 Ramsel
66,Bergstraat 71,2021-12-07,02:00:00,2,0,2,FMN GV 11 Ramsel
66,Bergstraat 71,2021-12-07,03:00:00,0,0,0,FMN GV 11 Ramsel
66,Bergstraat 71,2021-12-07,04:00:00,2,2,0,FMN GV 11 Ramsel
66,Bergstraat 71,2021-12-07,05:00:00,6,4,2,FMN GV 11 Ramsel
66,Bergstraat 71,2021-12-07,06:00:00,20,10,10,FMN GV 11 Ramsel
66,Bergstraat 71,2021-12-07,07:00:00,80,18,62,FMN GV 11 Ramsel
66,Bergstraat 71,2021-12-07,08:00:00,38,4,34,FMN GV 11 Ramsel
66,Bergstraat 71,2021-12-07,09:00:00,22,10,12,FMN GV 11 Ramsel
66,Bergstraat 71,2021-12-07,10:00:00,40,20,20,FMN GV 11 Ramsel
66,Bergstraat 71,2021-12-07,11:00:00,52,36,16,FMN GV 11 Ramsel
66,Bergstraat 71,2021-12-07,12:00:00,90,56,34,FMN GV 11 Ramsel
66,Bergstraat 71,2021-12-07,13:00:00,140,58,82,FMN GV 11 Ramsel
66,Bergstraat 71,2021-12-07,14:00:00,92,42,50,FMN GV 11 Ramsel
66,Bergstraat 71,2021-12-07,15:00:00,128,94,34,FMN GV 11 Ramsel
66,Bergstraat 71,2021-12-07,16:00:00,64,44,20,FMN GV 11 Ramsel
66,Bergstraat 71,2021-12-07,17:00:00,40,28,12,FMN GV 11 Ramsel
66,Bergstraat 71,2021-12-07,18:00:00,14,8,6,FMN GV 11 Ramsel
66,Bergstraat 71,2021-12-07,19:00:00,22,14,8,FMN GV 11 Ramsel
66,Bergstraat 71,2021-12-07,20:00:00,8,4,4,FMN GV 11 Ramsel
66,Bergstraat 71,2021-12-07,21:00:00,10,4,6,FMN GV 11 Ramsel
66,Bergstraat 71,2021-12-07,22:00:00,10,10,0,FMN GV 11 Ramsel
66,Bergstraat 71,2021-12-07,23:00:00,2,2,0,FMN GV 11 Ramsel
66,Bergstraat 71,2021-12-08,00:00:00,0,0,0,FMN GV 11 Ramsel
66,Bergstraat 71,2021-12-08,01:00:00,0,0,0,FMN GV 11 Ramsel
66,Bergstraat 71,2021-12-08,02:00:00,0,0,0,FMN GV 11 Ramsel
66,Bergstraat 71,2021-12-08,03:00:00,0,0,0,FMN GV 11 Ramsel
66,Bergstraat 71,2021-12-08,04:00:00,8,6,2,FMN GV 11 Ramsel
66,Bergstraat 71,2021-12-08,05:00:00,4,2,2,FMN GV 11 Ramsel
66,Bergstraat 71,2021-12-08,06:00:00,10,4,6,FMN GV 11 Ramsel
66,Bergstraat 71,2021-12-08,07:00:00,72,14,58,FMN GV 11 Ramsel
66,Bergstraat 71,2021-12-08,08:00:00,76,6,70,FMN GV 11 Ramsel
66,Bergstraat 71,2021-12-08,09:00:00,14,6,8,FMN GV 11 Ramsel
66,Bergstraat 71,2021-12-08,10:00:00,44,36,8,FMN GV 11 Ramsel
66,Bergstraat 71,2021-12-08,11:00:00,72,48,24,FMN GV 11 Ramsel
66,Bergstraat 71,2021-12-08,12:00:00,112,74,38,FMN GV 11 Ramsel
66,Bergstraat 71,2021-12-08,13:00:00,78,36,42,FMN GV 11 Ramsel
66,Bergstraat 71,2021-12-08,14:00:00,102,40,62,FMN GV 11 Ramsel
66,Bergstraat 71,2021-12-08,15:00:00,62,42,20,FMN GV 11 Ramsel
66,Bergstraat 71,2021-12-08,16:00:00,62,38,24,FMN GV 11 Ramsel
66,Bergstraat 71,2021-12-08,17:00:00,64,32,32,FMN GV 11 Ramsel
66,Bergstraat 71,2021-12-08,18:00:00,26,14,12,FMN GV 11 Ramsel
66,Bergstraat 71,2021-12-08,19:00:00,24,14,10,FMN GV 11 Ramsel
66,Bergstraat 71,2021-12-08,20:00:00,16,8,8,FMN GV 11 Ramsel
66,Bergstraat 71,2021-12-08,21:00:00,6,2,4,FMN GV 11 Ramsel
66,Bergstraat 71,2021-12-08,22:00:00,8,6,2,FMN GV 11 Ramsel
66,Bergstraat 71,2021-12-08,23:00:00,6,4,2,FMN GV 11 Ramsel
66,Bergstraat 71,2021-12-09,00:00:00,0,0,0,FMN GV 11 Ramsel
66,Bergstraat 71,2021-12-09,01:00:00,0,0,0,FMN GV 11 Ramsel
66,Bergstraat 71,2021-12-09,02:00:00,0,0,0,FMN GV 11 Ramsel
66,Bergstraat 71,2021-12-09,03:00:00,0,0,0,FMN GV 11 Ramsel
66,Bergstraat 71,2021-12-09,04:00:00,4,4,0,FMN GV 11 Ramsel
66,Bergstraat 71,2021-12-09,05:00:00,10,6,4,FMN GV 11 Ramsel
66,Bergstraat 71,2021-12-09,06:00:00,12,2,10,FMN GV 11 Ramsel
66,Bergstraat 71,2021-12-09,07:00:00,80,14,66,FMN GV 11 Ramsel
66,Bergstraat 71,2021-12-09,08:00:00,104,20,84,FMN GV 11 Ramsel
66,Bergstraat 71,2021-12-09,09:00:00,42,6,36,FMN GV 11 Ramsel
66,Bergstraat 71,2021-12-09,10:00:00,66,54,12,FMN GV 11 Ramsel
66,Bergstraat 71,2021-12-09,11:00:00,50,46,4,FMN GV 11 Ramsel
66,Bergstraat 71,2021-12-09,12:00:00,58,40,18,FMN GV 11 Ramsel
66,Bergstraat 71,2021-12-09,13:00:00,42,18,24,FMN GV 11 Ramsel
66,Bergstraat 71,2021-12-09,14:00:00,38,20,18,FMN GV 11 Ramsel
66,Bergstraat 71,2021-12-09,15:00:00,48,36,12,FMN GV 11 Ramsel
66,Bergstraat 71,2021-12-09,16:00:00,76,54,22,FMN GV 11 Ramsel
66,Bergstraat 71,2021-12-09,17:00:00,36,24,12,FMN GV 11 Ramsel
66,Bergstraat 71,2021-12-09,18:00:00,20,12,8,FMN GV 11 Ramsel
66,Bergstraat 71,2021-12-09,19:00:00,14,14,0,FMN GV 11 Ramsel
66,Bergstraat 71,2021-12-09,20:00:00,12,6,6,FMN GV 11 Ramsel
66,Bergstraat 71,2021-12-09,21:00:00,8,4,4,FMN GV 11 Ramsel
66,Bergstraat 71,2021-12-09,22:00:00,12,10,2,FMN GV 11 Ramsel
66,Bergstraat 71,2021-12-09,23:00:00,0,0,0,FMN GV 11 Ramsel
66,Bergstraat 71,2021-12-10,00:00:00,2,0,2,FMN GV 11 Ramsel
66,Bergstraat 71,2021-12-10,01:00:00,2,2,0,FMN GV 11 Ramsel
66,Bergstraat 71,2021-12-10,02:00:00,0,0,0,FMN GV 11 Ramsel
66,Bergstraat 71,2021-12-10,03:00:00,0,0,0,FMN GV 11 Ramsel
66,Bergstraat 71,2021-12-10,04:00:00,0,0,0,FMN GV 11 Ramsel
66,Bergstraat 71,2021-12-10,05:00:00,4,4,0,FMN GV 11 Ramsel
66,Bergstraat 71,2021-12-10,06:00:00,6,4,2,FMN GV 11 Ramsel
66,Bergstraat 71,2021-12-10,07:00:00,80,12,68,FMN GV 11 Ramsel
66,Bergstraat 71,2021-12-10,08:00:00,80,2,78,FMN GV 11 Ramsel
66,Bergstraat 71,2021-12-10,09:00:00,12,2,10,FMN GV 11 Ramsel
66,Bergstraat 71,2021-12-10,10:00:00,50,46,4,FMN GV 11 Ramsel
66,Bergstraat 71,2021-12-10,11:00:00,28,20,8,FMN GV 11 Ramsel
66,Bergstraat 71,2021-12-10,12:00:00,48,38,10,FMN GV 11 Ramsel
66,Bergstraat 71,2021-12-10,13:00:00,14,4,10,FMN GV 11 Ramsel
66,Bergstraat 71,2021-12-10,14:00:00,16,14,2,FMN GV 11 Ramsel
66,Bergstraat 71,2021-12-10,15:00:00,32,20,12,FMN GV 11 Ramsel
66,Bergstraat 71,2021-12-10,16:00:00,24,12,12,FMN GV 11 Ramsel
66,Bergstraat 71,2021-12-10,17:00:00,22,14,8,FMN GV 11 Ramsel
66,Bergstraat 71,2021-12-10,18:00:00,16,6,10,FMN GV 11 Ramsel
66,Bergstraat 71,2021-12-10,19:00:00,10,2,8,FMN GV 11 Ramsel
66,Bergstraat 71,2021-12-10,20:00:00,6,6,0,FMN GV 11 Ramsel
66,Bergstraat 71,2021-12-10,21:00:00,8,2,6,FMN GV 11 Ramsel
66,Bergstraat 71,2021-12-10,22:00:00,6,4,2,FMN GV 11 Ramsel
66,Bergstraat 71,2021-12-10,23:00:00,8,4,4,FMN GV 11 Ramsel
66,Bergstraat 71,2021-12-11,00:00:00,4,2,2,FMN GV 11 Ramsel
66,Bergstraat 71,2021-12-11,01:00:00,6,6,0,FMN GV 11 Ramsel
66,Bergstraat 71,2021-12-11,02:00:00,2,0,2,FMN GV 11 Ramsel
66,Bergstraat 71,2021-12-11,03:00:00,0,0,0,FMN GV 11 Ramsel
66,Bergstraat 71,2021-12-11,04:00:00,0,0,0,FMN GV 11 Ramsel
66,Bergstraat 71,2021-12-11,05:00:00,2,0,2,FMN GV 11 Ramsel
66,Bergstraat 71,2021-12-11,06:00:00,0,0,0,FMN GV 11 Ramsel
66,Bergstraat 71,2021-12-11,07:00:00,4,0,4,FMN GV 11 Ramsel
66,Bergstraat 71,2021-12-11,08:00:00,20,8,12,FMN GV 11 Ramsel
66,Bergstraat 71,2021-12-11,09:00:00,32,20,12,FMN GV 11 Ramsel
66,Bergstraat 71,2021-12-11,10:00:00,58,30,28,FMN GV 11 Ramsel
66,Bergstraat 71,2021-12-11,11:00:00,68,22,46,FMN GV 11 Ramsel
66,Bergstraat 71,2021-12-11,12:00:00,92,42,50,FMN GV 11 Ramsel
66,Bergstraat 71,2021-12-11,13:00:00,96,40,56,FMN GV 11 Ramsel
66,Bergstraat 71,2021-12-11,14:00:00,148,74,74,FMN GV 11 Ramsel
66,Bergstraat 71,2021-12-11,15:00:00,72,46,26,FMN GV 11 Ramsel
66,Bergstraat 71,2021-12-11,16:00:00,46,40,6,FMN GV 11 Ramsel
66,Bergstraat 71,2021-12-11,17:00:00,20,12,8,FMN GV 11 Ramsel
66,Bergstraat 71,2021-12-11,18:00:00,18,14,4,FMN GV 11 Ramsel
66,Bergstraat 71,2021-12-11,19:00:00,6,2,4,FMN GV 11 Ramsel
66,Bergstraat 71,2021-12-11,20:00:00,14,8,6,FMN GV 11 Ramsel
66,Bergstraat 71,2021-12-11,21:00:00,12,4,8,FMN GV 11 Ramsel
66,Bergstraat 71,2021-12-11,22:00:00,10,4,6,FMN GV 11 Ramsel
66,Bergstraat 71,2021-12-11,23:00:00,10,10,0,FMN GV 11 Ramsel
66,Bergstraat 71,2021-12-12,00:00:00,4,2,2,FMN GV 11 Ramsel
66,Bergstraat 71,2021-12-12,01:00:00,6,0,6,FMN GV 11 Ramsel
66,Bergstraat 71,2021-12-12,02:00:00,0,0,0,FMN GV 11 Ramsel
66,Bergstraat 71,2021-12-12,03:00:00,0,0,0,FMN GV 11 Ramsel
66,Bergstraat 71,2021-12-12,04:00:00,2,2,0,FMN GV 11 Ramsel
66,Bergstraat 71,2021-12-12,05:00:00,0,0,0,FMN GV 11 Ramsel
66,Bergstraat 71,2021-12-12,06:00:00,4,2,2,FMN GV 11 Ramsel
66,Bergstraat 71,2021-12-12,07:00:00,4,0,4,FMN GV 11 Ramsel
66,Bergstraat 71,2021-12-12,08:00:00,20,2,18,FMN GV 11 Ramsel
66,Bergstraat 71,2021-12-12,09:00:00,42,20,22,FMN GV 11 Ramsel
66,Bergstraat 71,2021-12-12,10:00:00,60,32,28,FMN GV 11 Ramsel
66,Bergstraat 71,2021-12-12,11:00:00,36,18,18,FMN GV 11 Ramsel
66,Bergstraat 71,2021-12-12,12:00:00,40,32,8,FMN GV 11 Ramsel
66,Bergstraat 71,2021-12-12,13:00:00,16,6,10,FMN GV 11 Ramsel
66,Bergstraat 71,2021-12-12,14:00:00,18,10,8,FMN GV 11 Ramsel
66,Bergstraat 71,2021-12-12,15:00:00,16,6,10,FMN GV 11 Ramsel
66,Bergstraat 71,2021-12-12,16:00:00,18,10,8,FMN GV 11 Ramsel
66,Bergstraat 71,2021-12-12,17:00:00,10,10,0,FMN GV 11 Ramsel
66,Bergstraat 71,2021-12-12,18:00:00,6,2,4,FMN GV 11 Ramsel
66,Bergstraat 71,2021-12-12,19:00:00,4,0,4,FMN GV 11 Ramsel
66,Bergstraat 71,2021-12-12,20:00:00,2,0,2,FMN GV 11 Ramsel
66,Bergstraat 71,2021-12-12,21:00:00,2,0,2,FMN GV 11 Ramsel
66,Bergstraat 71,2021-12-12,22:00:00,4,4,0,FMN GV 11 Ramsel
66,Bergstraat 71,2021-12-12,23:00:00,2,0,2,FMN GV 11 Ramsel
66,Bergstraat 71,2021-12-13,00:00:00,0,0,0,FMN GV 11 Ramsel
66,Bergstraat 71,2021-12-13,01:00:00,0,0,0,FMN GV 11 Ramsel
66,Bergstraat 71,2021-12-13,02:00:00,2,0,2,FMN GV 11 Ramsel
66,Bergstraat 71,2021-12-13,03:00:00,0,0,0,FMN GV 11 Ramsel
66,Bergstraat 71,2021-12-13,04:00:00,2,2,0,FMN GV 11 Ramsel
66,Bergstraat 71,2021-12-13,05:00:00,8,2,6,FMN GV 11 Ramsel
66,Bergstraat 71,2021-12-13,06:00:00,20,4,16,FMN GV 11 Ramsel
66,Bergstraat 71,2021-12-13,07:00:00,160,12,148,FMN GV 11 Ramsel
66,Bergstraat 71,2021-12-13,08:00:00,130,24,106,FMN GV 11 Ramsel
66,Bergstraat 71,2021-12-13,09:00:00,32,16,16,FMN GV 11 Ramsel
66,Bergstraat 71,2021-12-13,10:00:00,84,64,20,FMN GV 11 Ramsel
66,Bergstraat 71,2021-12-13,11:00:00,74,50,24,FMN GV 11 Ramsel
66,Bergstraat 71,2021-12-13,12:00:00,126,96,30,FMN GV 11 Ramsel
66,Bergstraat 71,2021-12-13,13:00:00,102,58,44,FMN GV 11 Ramsel
66,Bergstraat 71,2021-12-13,14:00:00,66,34,32,FMN GV 11 Ramsel
66,Bergstraat 71,2021-12-13,15:00:00,130,92,38,FMN GV 11 Ramsel
66,Bergstraat 71,2021-12-13,16:00:00,52,36,16,FMN GV 11 Ramsel
66,Bergstraat 71,2021-12-13,17:00:00,28,20,8,FMN GV 11 Ramsel
66,Bergstraat 71,2021-12-13,18:00:00,18,10,8,FMN GV 11 Ramsel
66,Bergstraat 71,2021-12-13,19:00:00,28,20,8,FMN GV 11 Ramsel
66,Bergstraat 71,2021-12-13,20:00:00,22,12,10,FMN GV 11 Ramsel
66,Bergstraat 71,2021-12-13,21:00:00,10,6,4,FMN GV 11 Ramsel
66,Bergstraat 71,2021-12-13,22:00:00,14,6,8,FMN GV 11 Ramsel
66,Bergstraat 71,2021-12-13,23:00:00,8,2,6,FMN GV 11 Ramsel
66,Bergstraat 71,2021-12-14,00:00:00,0,0,0,FMN GV 11 Ramsel
66,Bergstraat 71,2021-12-14,01:00:00,0,0,0,FMN GV 11 Ramsel
66,Bergstraat 71,2021-12-14,02:00:00,0,0,0,FMN GV 11 Ramsel
66,Bergstraat 71,2021-12-14,03:00:00,0,0,0,FMN GV 11 Ramsel
66,Bergstraat 71,2021-12-14,04:00:00,4,4,0,FMN GV 11 Ramsel
66,Bergstraat 71,2021-12-14,05:00:00,10,4,6,FMN GV 11 Ramsel
66,Bergstraat 71,2021-12-14,06:00:00,18,10,8,FMN GV 11 Ramsel
66,Bergstraat 71,2021-12-14,07:00:00,158,18,140,FMN GV 11 Ramsel
66,Bergstraat 71,2021-12-14,08:00:00,132,16,116,FMN GV 11 Ramsel
66,Bergstraat 71,2021-12-14,09:00:00,26,14,12,FMN GV 11 Ramsel
66,Bergstraat 71,2021-12-14,10:00:00,122,96,26,FMN GV 11 Ramsel
66,Bergstraat 71,2021-12-14,11:00:00,58,50,8,FMN GV 11 Ramsel
66,Bergstraat 71,2021-12-14,12:00:00,90,64,26,FMN GV 11 Ramsel
66,Bergstraat 71,2021-12-14,13:00:00,144,82,62,FMN GV 11 Ramsel
66,Bergstraat 71,2021-12-14,14:00:00,78,46,32,FMN GV 11 Ramsel
66,Bergstraat 71,2021-12-14,15:00:00,108,72,36,FMN GV 11 Ramsel
66,Bergstraat 71,2021-12-14,16:00:00,74,38,36,FMN GV 11 Ramsel
66,Bergstraat 71,2021-12-14,17:00:00,70,40,30,FMN GV 11 Ramsel
66,Bergstraat 71,2021-12-14,18:00:00,22,12,10,FMN GV 11 Ramsel
66,Bergstraat 71,2021-12-14,19:00:00,30,6,24,FMN GV 11 Ramsel
66,Bergstraat 71,2021-12-14,20:00:00,26,14,12,FMN GV 11 Ramsel
66,Bergstraat 71,2021-12-14,21:00:00,10,8,2,FMN GV 11 Ramsel
66,Bergstraat 71,2021-12-14,22:00:00,16,10,6,FMN GV 11 Ramsel
66,Bergstraat 71,2021-12-14,23:00:00,2,2,0,FMN GV 11 Ramsel
66,Bergstraat 71,2021-12-15,00:00:00,2,2,0,FMN GV 11 Ramsel
66,Bergstraat 71,2021-12-15,01:00:00,0,0,0,FMN GV 11 Ramsel
66,Bergstraat 71,2021-12-15,02:00:00,0,0,0,FMN GV 11 Ramsel
66,Bergstraat 71,2021-12-15,03:00:00,0,0,0,FMN GV 11 Ramsel
66,Bergstraat 71,2021-12-15,04:00:00,4,4,0,FMN GV 11 Ramsel
66,Bergstraat 71,2021-12-15,05:00:00,6,6,0,FMN GV 11 Ramsel
66,Bergstraat 71,2021-12-15,06:00:00,16,2,14,FMN GV 11 Ramsel
66,Bergstraat 71,2021-12-15,07:00:00,180,8,172,FMN GV 11 Ramsel
66,Bergstraat 71,2021-12-15,08:00:00,136,10,126,FMN GV 11 Ramsel
66,Bergstraat 71,2021-12-15,09:00:00,34,12,22,FMN GV 11 Ramsel
66,Bergstraat 71,2021-12-15,10:00:00,132,110,22,FMN GV 11 Ramsel
66,Bergstraat 71,2021-12-15,11:00:00,128,100,28,FMN GV 11 Ramsel
66,Bergstraat 71,2021-12-15,12:00:00,100,74,26,FMN GV 11 Ramsel
66,Bergstraat 71,2021-12-15,13:00:00,78,34,44,FMN GV 11 Ramsel
66,Bergstraat 71,2021-12-15,14:00:00,90,44,46,FMN GV 11 Ramsel
66,Bergstraat 71,2021-12-15,15:00:00,88,46,42,FMN GV 11 Ramsel
66,Bergstraat 71,2021-12-15,16:00:00,42,28,14,FMN GV 11 Ramsel
66,Bergstraat 71,2021-12-15,17:00:00,48,32,16,FMN GV 11 Ramsel
66,Bergstraat 71,2021-12-15,18:00:00,56,34,22,FMN GV 11 Ramsel
66,Bergstraat 71,2021-12-15,19:00:00,46,22,24,FMN GV 11 Ramsel
66,Bergstraat 71,2021-12-15,20:00:00,10,2,8,FMN GV 11 Ramsel
66,Bergstraat 71,2021-12-15,21:00:00,20,12,8,FMN GV 11 Ramsel
66,Bergstraat 71,2021-12-15,22:00:00,14,6,8,FMN GV 11 Ramsel
66,Bergstraat 71,2021-12-15,23:00:00,4,4,0,FMN GV 11 Ramsel
66,Bergstraat 71,2021-12-16,00:00:00,0,0,0,FMN GV 11 Ramsel
66,Bergstraat 71,2021-12-16,01:00:00,0,0,0,FMN GV 11 Ramsel
66,Bergstraat 71,2021-12-16,02:00:00,0,0,0,FMN GV 11 Ramsel
66,Bergstraat 71,2021-12-16,03:00:00,0,0,0,FMN GV 11 Ramsel
66,Bergstraat 71,2021-12-16,04:00:00,4,4,0,FMN GV 11 Ramsel
66,Bergstraat 71,2021-12-16,05:00:00,6,2,4,FMN GV 11 Ramsel
66,Bergstraat 71,2021-12-16,06:00:00,18,2,16,FMN GV 11 Ramsel
66,Bergstraat 71,2021-12-16,07:00:00,148,14,134,FMN GV 11 Ramsel
66,Bergstraat 71,2021-12-16,08:00:00,142,24,118,FMN GV 11 Ramsel
66,Bergstraat 71,2021-12-16,09:00:00,68,30,38,FMN GV 11 Ramsel
66,Bergstraat 71,2021-12-16,10:00:00,146,108,38,FMN GV 11 Ramsel
66,Bergstraat 71,2021-12-16,11:00:00,114,90,24,FMN GV 11 Ramsel
66,Bergstraat 71,2021-12-16,12:00:00,74,38,36,FMN GV 11 Ramsel
66,Bergstraat 71,2021-12-16,13:00:00,148,84,64,FMN GV 11 Ramsel
66,Bergstraat 71,2021-12-16,14:00:00,138,68,70,FMN GV 11 Ramsel
66,Bergstraat 71,2021-12-16,15:00:00,130,74,56,FMN GV 11 Ramsel
66,Bergstraat 71,2021-12-16,16:00:00,88,70,18,FMN GV 11 Ramsel
66,Bergstraat 71,2021-12-16,17:00:00,44,22,22,FMN GV 11 Ramsel
66,Bergstraat 71,2021-12-16,18:00:00,28,18,10,FMN GV 11 Ramsel
66,Bergstraat 71,2021-12-16,19:00:00,16,8,8,FMN GV 11 Ramsel
66,Bergstraat 71,2021-12-16,20:00:00,22,10,12,FMN GV 11 Ramsel
66,Bergstraat 71,2021-12-16,21:00:00,8,4,4,FMN GV 11 Ramsel
66,Bergstraat 71,2021-12-16,22:00:00,18,10,8,FMN GV 11 Ramsel
66,Bergstraat 71,2021-12-16,23:00:00,6,2,4,FMN GV 11 Ramsel
66,Bergstraat 71,2021-12-17,00:00:00,0,0,0,FMN GV 11 Ramsel
66,Bergstraat 71,2021-12-17,01:00:00,0,0,0,FMN GV 11 Ramsel
66,Bergstraat 71,2021-12-17,02:00:00,0,0,0,FMN GV 11 Ramsel
66,Bergstraat 71,2021-12-17,03:00:00,0,0,0,FMN GV 11 Ramsel
66,Bergstraat 71,2021-12-17,04:00:00,4,4,0,FMN GV 11 Ramsel
66,Bergstraat 71,2021-12-17,05:00:00,6,2,4,FMN GV 11 Ramsel
66,Bergstraat 71,2021-12-17,06:00:00,20,2,18,FMN GV 11 Ramsel
66,Bergstraat 71,2021-12-17,07:00:00,162,16,146,FMN GV 11 Ramsel
66,Bergstraat 71,2021-12-17,08:00:00,138,10,128,FMN GV 11 Ramsel
66,Bergstraat 71,2021-12-17,09:00:00,48,14,34,FMN GV 11 Ramsel
66,Bergstraat 71,2021-12-17,10:00:00,86,78,8,FMN GV 11 Ramsel
66,Bergstraat 71,2021-12-17,11:00:00,108,72,36,FMN GV 11 Ramsel
66,Bergstraat 71,2021-12-17,12:00:00,92,50,42,FMN GV 11 Ramsel
66,Bergstraat 71,2021-12-17,13:00:00,50,34,16,FMN GV 11 Ramsel
66,Bergstraat 71,2021-12-17,14:00:00,66,38,28,FMN GV 11 Ramsel
66,Bergstraat 71,2021-12-17,15:00:00,74,64,10,FMN GV 11 Ramsel
66,Bergstraat 71,2021-12-17,16:00:00,54,40,14,FMN GV 11 Ramsel
66,Bergstraat 71,2021-12-17,17:00:00,38,24,14,FMN GV 11 Ramsel
66,Bergstraat 71,2021-12-17,18:00:00,36,18,18,FMN GV 11 Ramsel
66,Bergstraat 71,2021-12-17,19:00:00,32,16,16,FMN GV 11 Ramsel
66,Bergstraat 71,2021-12-17,20:00:00,26,10,16,FMN GV 11 Ramsel
66,Bergstraat 71,2021-12-17,21:00:00,16,8,8,FMN GV 11 Ramsel
66,Bergstraat 71,2021-12-17,22:00:00,10,6,4,FMN GV 11 Ramsel
66,Bergstraat 71,2021-12-17,23:00:00,22,10,12,FMN GV 11 Ramsel
66,Bergstraat 71,2021-12-18,00:00:00,14,12,2,FMN GV 11 Ramsel
66,Bergstraat 71,2021-12-18,01:00:00,10,4,6,FMN GV 11 Ramsel
66,Bergstraat 71,2021-12-18,02:00:00,2,0,2,FMN GV 11 Ramsel
66,Bergstraat 71,2021-12-18,03:00:00,0,0,0,FMN GV 11 Ramsel
66,Bergstraat 71,2021-12-18,04:00:00,0,0,0,FMN GV 11 Ramsel
66,Bergstraat 71,2021-12-18,05:00:00,2,2,0,FMN GV 11 Ramsel
66,Bergstraat 71,2021-12-18,06:00:00,2,2,0,FMN GV 11 Ramsel
66,Bergstraat 71,2021-12-18,07:00:00,4,2,2,FMN GV 11 Ramsel
66,Bergstraat 71,2021-12-18,08:00:00,16,6,10,FMN GV 11 Ramsel
66,Bergstraat 71,2021-12-18,09:00:00,30,14,16,FMN GV 11 Ramsel
66,Bergstraat 71,2021-12-18,10:00:00,72,26,46,FMN GV 11 Ramsel
66,Bergstraat 71,2021-12-18,11:00:00,78,42,36,FMN GV 11 Ramsel
66,Bergstraat 71,2021-12-18,12:00:00,60,34,26,FMN GV 11 Ramsel
66,Bergstraat 71,2021-12-18,13:00:00,110,76,34,FMN GV 11 Ramsel
66,Bergstraat 71,2021-12-18,14:00:00,66,38,28,FMN GV 11 Ramsel
66,Bergstraat 71,2021-12-18,15:00:00,98,46,52,FMN GV 11 Ramsel
66,Bergstraat 71,2021-12-18,16:00:00,58,50,8,FMN GV 11 Ramsel
66,Bergstraat 71,2021-12-18,17:00:00,20,8,12,FMN GV 11 Ramsel
66,Bergstraat 71,2021-12-18,18:00:00,16,8,8,FMN GV 11 Ramsel
66,Bergstraat 71,2021-12-18,19:00:00,8,4,4,FMN GV 11 Ramsel
66,Bergstraat 71,2021-12-18,20:00:00,12,2,10,FMN GV 11 Ramsel
66,Bergstraat 71,2021-12-18,21:00:00,10,2,8,FMN GV 11 Ramsel
66,Bergstraat 71,2021-12-18,22:00:00,6,6,0,FMN GV 11 Ramsel
66,Bergstraat 71,2021-12-18,23:00:00,8,8,0,FMN GV 11 Ramsel
66,Bergstraat 71,2021-12-19,00:00:00,6,6,0,FMN GV 11 Ramsel
66,Bergstraat 71,2021-12-19,01:00:00,2,2,0,FMN GV 11 Ramsel
66,Bergstraat 71,2021-12-19,02:00:00,0,0,0,FMN GV 11 Ramsel
66,Bergstraat 71,2021-12-19,03:00:00,0,0,0,FMN GV 11 Ramsel
66,Bergstraat 71,2021-12-19,04:00:00,4,0,4,FMN GV 11 Ramsel
66,Bergstraat 71,2021-12-19,05:00:00,0,0,0,FMN GV 11 Ramsel
66,Bergstraat 71,2021-12-19,06:00:00,2,2,0,FMN GV 11 Ramsel
66,Bergstraat 71,2021-12-19,07:00:00,4,2,2,FMN GV 11 Ramsel
66,Bergstraat 71,2021-12-19,08:00:00,22,4,18,FMN GV 11 Ramsel
66,Bergstraat 71,2021-12-19,09:00:00,68,30,38,FMN GV 11 Ramsel
66,Bergstraat 71,2021-12-19,10:00:00,88,36,52,FMN GV 11 Ramsel
66,Bergstraat 71,2021-12-19,11:00:00,116,72,44,FMN GV 11 Ramsel
66,Bergstraat 71,2021-12-19,12:00:00,56,30,26,FMN GV 11 Ramsel
66,Bergstraat 71,2021-12-19,13:00:00,50,18,32,FMN GV 11 Ramsel
66,Bergstraat 71,2021-12-19,14:00:00,52,22,30,FMN GV 11 Ramsel
66,Bergstraat 71,2021-12-19,15:00:00,58,38,20,FMN GV 11 Ramsel
66,Bergstraat 71,2021-12-19,16:00:00,26,12,14,FMN GV 11 Ramsel
66,Bergstraat 71,2021-12-19,17:00:00,16,14,2,FMN GV 11 Ramsel
66,Bergstraat 71,2021-12-19,18:00:00,16,12,4,FMN GV 11 Ramsel
66,Bergstraat 71,2021-12-19,19:00:00,12,0,12,FMN GV 11 Ramsel
66,Bergstraat 71,2021-12-19,20:00:00,2,2,0,FMN GV 11 Ramsel
66,Bergstraat 71,2021-12-19,21:00:00,2,2,0,FMN GV 11 Ramsel
66,Bergstraat 71,2021-12-19,22:00:00,8,4,4,FMN GV 11 Ramsel
66,Bergstraat 71,2021-12-19,23:00:00,6,2,4,FMN GV 11 Ramsel
66,Bergstraat 71,2021-12-20,00:00:00,2,2,0,FMN GV 11 Ramsel
66,Bergstraat 71,2021-12-20,01:00:00,0,0,0,FMN GV 11 Ramsel
66,Bergstraat 71,2021-12-20,02:00:00,0,0,0,FMN GV 11 Ramsel
66,Bergstraat 71,2021-12-20,03:00:00,0,0,0,FMN GV 11 Ramsel
66,Bergstraat 71,2021-12-20,04:00:00,4,4,0,FMN GV 11 Ramsel
66,Bergstraat 71,2021-12-20,05:00:00,8,4,4,FMN GV 11 Ramsel
66,Bergstraat 71,2021-12-20,06:00:00,24,6,18,FMN GV 11 Ramsel
66,Bergstraat 71,2021-12-20,07:00:00,124,8,116,FMN GV 11 Ramsel
66,Bergstraat 71,2021-12-20,08:00:00,86,4,82,FMN GV 11 Ramsel
66,Bergstraat 71,2021-12-20,09:00:00,36,16,20,FMN GV 11 Ramsel
66,Bergstraat 71,2021-12-20,10:00:00,112,78,34,FMN GV 11 Ramsel
66,Bergstraat 71,2021-12-20,11:00:00,68,52,16,FMN GV 11 Ramsel
66,Bergstraat 71,2021-12-20,12:00:00,108,84,24,FMN GV 11 Ramsel
66,Bergstraat 71,2021-12-20,13:00:00,102,48,54,FMN GV 11 Ramsel
66,Bergstraat 71,2021-12-20,14:00:00,138,74,64,FMN GV 11 Ramsel
66,Bergstraat 71,2021-12-20,15:00:00,110,84,26,FMN GV 11 Ramsel
66,Bergstraat 71,2021-12-20,16:00:00,66,34,32,FMN GV 11 Ramsel
66,Bergstraat 71,2021-12-20,17:00:00,26,20,6,FMN GV 11 Ramsel
66,Bergstraat 71,2021-12-20,18:00:00,20,8,12,FMN GV 11 Ramsel
66,Bergstraat 71,2021-12-20,19:00:00,16,8,8,FMN GV 11 Ramsel
66,Bergstraat 71,2021-12-20,20:00:00,22,12,10,FMN GV 11 Ramsel
66,Bergstraat 71,2021-12-20,21:00:00,14,8,6,FMN GV 11 Ramsel
66,Bergstraat 71,2021-12-20,22:00:00,18,12,6,FMN GV 11 Ramsel
66,Bergstraat 71,2021-12-20,23:00:00,0,0,0,FMN GV 11 Ramsel
66,Bergstraat 71,2021-12-21,00:00:00,0,0,0,FMN GV 11 Ramsel
66,Bergstraat 71,2021-12-21,01:00:00,0,0,0,FMN GV 11 Ramsel
66,Bergstraat 71,2021-12-21,02:00:00,0,0,0,FMN GV 11 Ramsel
66,Bergstraat 71,2021-12-21,03:00:00,0,0,0,FMN GV 11 Ramsel
66,Bergstraat 71,2021-12-21,04:00:00,4,4,0,FMN GV 11 Ramsel
66,Bergstraat 71,2021-12-21,05:00:00,6,4,2,FMN GV 11 Ramsel
66,Bergstraat 71,2021-12-21,06:00:00,14,6,8,FMN GV 11 Ramsel
66,Bergstraat 71,2021-12-21,07:00:00,60,14,46,FMN GV 11 Ramsel
66,Bergstraat 71,2021-12-21,08:00:00,40,4,36,FMN GV 11 Ramsel
66,Bergstraat 71,2021-12-21,09:00:00,12,6,6,FMN GV 11 Ramsel
66,Bergstraat 71,2021-12-21,10:00:00,60,40,20,FMN GV 11 Ramsel
66,Bergstraat 71,2021-12-21,11:00:00,30,18,12,FMN GV 11 Ramsel
66,Bergstraat 71,2021-12-21,12:00:00,68,44,24,FMN GV 11 Ramsel
66,Bergstraat 71,2021-12-21,13:00:00,80,50,30,FMN GV 11 Ramsel
66,Bergstraat 71,2021-12-21,14:00:00,102,60,42,FMN GV 11 Ramsel
66,Bergstraat 71,2021-12-21,15:00:00,136,84,52,FMN GV 11 Ramsel
66,Bergstraat 71,2021-12-21,16:00:00,60,36,24,FMN GV 11 Ramsel
66,Bergstraat 71,2021-12-21,17:00:00,30,8,22,FMN GV 11 Ramsel
66,Bergstraat 71,2021-12-21,18:00:00,18,12,6,FMN GV 11 Ramsel
66,Bergstraat 71,2021-12-21,19:00:00,18,6,12,FMN GV 11 Ramsel
66,Bergstraat 71,2021-12-21,20:00:00,22,12,10,FMN GV 11 Ramsel
66,Bergstraat 71,2021-12-21,21:00:00,4,2,2,FMN GV 11 Ramsel
66,Bergstraat 71,2021-12-21,22:00:00,14,10,4,FMN GV 11 Ramsel
66,Bergstraat 71,2021-12-21,23:00:00,2,2,0,FMN GV 11 Ramsel
66,Bergstraat 71,2021-12-22,00:00:00,4,0,4,FMN GV 11 Ramsel
66,Bergstraat 71,2021-12-22,01:00:00,4,4,0,FMN GV 11 Ramsel
66,Bergstraat 71,2021-12-22,02:00:00,0,0,0,FMN GV 11 Ramsel
66,Bergstraat 71,2021-12-22,03:00:00,0,0,0,FMN GV 11 Ramsel
66,Bergstraat 71,2021-12-22,04:00:00,4,2,2,FMN GV 11 Ramsel
66,Bergstraat 71,2021-12-22,05:00:00,0,0,0,FMN GV 11 Ramsel
66,Bergstraat 71,2021-12-22,06:00:00,2,2,0,FMN GV 11 Ramsel
66,Bergstraat 71,2021-12-22,07:00:00,16,2,14,FMN GV 11 Ramsel
66,Bergstraat 71,2021-12-22,08:00:00,24,8,16,FMN GV 11 Ramsel
66,Bergstraat 71,2021-12-22,09:00:00,2,0,2,FMN GV 11 Ramsel
66,Bergstraat 71,2021-12-22,10:00:00,22,10,12,FMN GV 11 Ramsel
66,Bergstraat 71,2021-12-22,11:00:00,28,6,22,FMN GV 11 Ramsel
66,Bergstraat 71,2021-12-22,12:00:00,38,20,18,FMN GV 11 Ramsel
66,Bergstraat 71,2021-12-22,13:00:00,84,26,58,FMN GV 11 Ramsel
66,Bergstraat 71,2021-12-22,14:00:00,68,22,46,FMN GV 11 Ramsel
66,Bergstraat 71,2021-12-22,15:00:00,56,30,26,FMN GV 11 Ramsel
66,Bergstraat 71,2021-12-22,16:00:00,40,30,10,FMN GV 11 Ramsel
66,Bergstraat 71,2021-12-22,17:00:00,42,26,16,FMN GV 11 Ramsel
66,Bergstraat 71,2021-12-22,18:00:00,36,28,8,FMN GV 11 Ramsel
66,Bergstraat 71,2021-12-22,19:00:00,10,8,2,FMN GV 11 Ramsel
66,Bergstraat 71,2021-12-22,20:00:00,6,2,4,FMN GV 11 Ramsel
66,Bergstraat 71,2021-12-22,21:00:00,0,0,0,FMN GV 11 Ramsel
66,Bergstraat 71,2021-12-22,22:00:00,6,6,0,FMN GV 11 Ramsel
66,Bergstraat 71,2021-12-22,23:00:00,8,0,8,FMN GV 11 Ramsel
66,Bergstraat 71,2021-12-23,00:00:00,0,0,0,FMN GV 11 Ramsel
66,Bergstraat 71,2021-12-23,01:00:00,0,0,0,FMN GV 11 Ramsel
66,Bergstraat 71,2021-12-23,02:00:00,0,0,0,FMN GV 11 Ramsel
66,Bergstraat 71,2021-12-23,03:00:00,0,0,0,FMN GV 11 Ramsel
66,Bergstraat 71,2021-12-23,04:00:00,8,6,2,FMN GV 11 Ramsel
66,Bergstraat 71,2021-12-23,05:00:00,0,0,0,FMN GV 11 Ramsel
66,Bergstraat 71,2021-12-23,06:00:00,6,4,2,FMN GV 11 Ramsel
66,Bergstraat 71,2021-12-23,07:00:00,26,8,18,FMN GV 11 Ramsel
66,Bergstraat 71,2021-12-23,08:00:00,26,12,14,FMN GV 11 Ramsel
66,Bergstraat 71,2021-12-23,09:00:00,14,2,12,FMN GV 11 Ramsel
66,Bergstraat 71,2021-12-23,10:00:00,26,8,18,FMN GV 11 Ramsel
66,Bergstraat 71,2021-12-23,11:00:00,30,20,10,FMN GV 11 Ramsel
66,Bergstraat 71,2021-12-23,12:00:00,48,24,24,FMN GV 11 Ramsel
66,Bergstraat 71,2021-12-23,13:00:00,68,22,46,FMN GV 11 Ramsel
66,Bergstraat 71,2021-12-23,14:00:00,84,38,46,FMN GV 11 Ramsel
66,Bergstraat 71,2021-12-23,15:00:00,88,64,24,FMN GV 11 Ramsel
66,Bergstraat 71,2021-12-23,16:00:00,70,42,28,FMN GV 11 Ramsel
66,Bergstraat 71,2021-12-23,17:00:00,20,10,10,FMN GV 11 Ramsel
66,Bergstraat 71,2021-12-23,18:00:00,26,16,10,FMN GV 11 Ramsel
66,Bergstraat 71,2021-12-23,19:00:00,14,8,6,FMN GV 11 Ramsel
66,Bergstraat 71,2021-12-23,20:00:00,2,2,0,FMN GV 11 Ramsel
66,Bergstraat 71,2021-12-23,21:00:00,10,2,8,FMN GV 11 Ramsel
66,Bergstraat 71,2021-12-23,22:00:00,8,8,0,FMN GV 11 Ramsel
66,Bergstraat 71,2021-12-23,23:00:00,4,4,0,FMN GV 11 Ramsel
66,Bergstraat 71,2021-12-24,00:00:00,2,0,2,FMN GV 11 Ramsel
66,Bergstraat 71,2021-12-24,01:00:00,0,0,0,FMN GV 11 Ramsel
66,Bergstraat 71,2021-12-24,02:00:00,0,0,0,FMN GV 11 Ramsel
66,Bergstraat 71,2021-12-24,03:00:00,0,0,0,FMN GV 11 Ramsel
66,Bergstraat 71,2021-12-24,04:00:00,2,2,0,FMN GV 11 Ramsel
66,Bergstraat 71,2021-12-24,05:00:00,0,0,0,FMN GV 11 Ramsel
66,Bergstraat 71,2021-12-24,06:00:00,6,2,4,FMN GV 11 Ramsel
66,Bergstraat 71,2021-12-24,07:00:00,42,4,38,FMN GV 11 Ramsel
66,Bergstraat 71,2021-12-24,08:00:00,56,6,50,FMN GV 11 Ramsel
66,Bergstraat 71,2021-12-24,09:00:00,60,16,44,FMN GV 11 Ramsel
66,Bergstraat 71,2021-12-24,10:00:00,84,52,32,FMN GV 11 Ramsel
66,Bergstraat 71,2021-12-24,11:00:00,72,54,18,FMN GV 11 Ramsel
66,Bergstraat 71,2021-12-24,12:00:00,78,48,30,FMN GV 11 Ramsel
66,Bergstraat 71,2021-12-24,13:00:00,66,32,34,FMN GV 11 Ramsel
66,Bergstraat 71,2021-12-24,14:00:00,64,34,30,FMN GV 11 Ramsel
66,Bergstraat 71,2021-12-24,15:00:00,60,40,20,FMN GV 11 Ramsel
66,Bergstraat 71,2021-12-24,16:00:00,40,28,12,FMN GV 11 Ramsel
66,Bergstraat 71,2021-12-24,17:00:00,20,8,12,FMN GV 11 Ramsel
66,Bergstraat 71,2021-12-24,18:00:00,0,0,0,FMN GV 11 Ramsel
66,Bergstraat 71,2021-12-24,19:00:00,4,0,4,FMN GV 11 Ramsel
66,Bergstraat 71,2021-12-24,20:00:00,4,2,2,FMN GV 11 Ramsel
66,Bergstraat 71,2021-12-24,21:00:00,6,0,6,FMN GV 11 Ramsel
66,Bergstraat 71,2021-12-24,22:00:00,2,2,0,FMN GV 11 Ramsel
66,Bergstraat 71,2021-12-24,23:00:00,6,6,0,FMN GV 11 Ramsel
66,Bergstraat 71,2021-12-25,00:00:00,2,0,2,FMN GV 11 Ramsel
66,Bergstraat 71,2021-12-25,01:00:00,2,2,0,FMN GV 11 Ramsel
66,Bergstraat 71,2021-12-25,02:00:00,0,0,0,FMN GV 11 Ramsel
66,Bergstraat 71,2021-12-25,03:00:00,0,0,0,FMN GV 11 Ramsel
66,Bergstraat 71,2021-12-25,04:00:00,0,0,0,FMN GV 11 Ramsel
66,Bergstraat 71,2021-12-25,05:00:00,0,0,0,FMN GV 11 Ramsel
66,Bergstraat 71,2021-12-25,06:00:00,0,0,0,FMN GV 11 Ramsel
66,Bergstraat 71,2021-12-25,07:00:00,0,0,0,FMN GV 11 Ramsel
66,Bergstraat 71,2021-12-25,08:00:00,0,0,0,FMN GV 11 Ramsel
66,Bergstraat 71,2021-12-25,09:00:00,4,4,0,FMN GV 11 Ramsel
66,Bergstraat 71,2021-12-25,10:00:00,8,4,4,FMN GV 11 Ramsel
66,Bergstraat 71,2021-12-25,11:00:00,10,6,4,FMN GV 11 Ramsel
66,Bergstraat 71,2021-12-25,12:00:00,16,12,4,FMN GV 11 Ramsel
66,Bergstraat 71,2021-12-25,13:00:00,30,18,12,FMN GV 11 Ramsel
66,Bergstraat 71,2021-12-25,14:00:00,28,16,12,FMN GV 11 Ramsel
66,Bergstraat 71,2021-12-25,15:00:00,18,16,2,FMN GV 11 Ramsel
66,Bergstraat 71,2021-12-25,16:00:00,16,6,10,FMN GV 11 Ramsel
66,Bergstraat 71,2021-12-25,17:00:00,8,4,4,FMN GV 11 Ramsel
66,Bergstraat 71,2021-12-25,18:00:00,8,4,4,FMN GV 11 Ramsel
66,Bergstraat 71,2021-12-25,19:00:00,2,2,0,FMN GV 11 Ramsel
66,Bergstraat 71,2021-12-25,20:00:00,2,0,2,FMN GV 11 Ramsel
66,Bergstraat 71,2021-12-25,21:00:00,2,0,2,FMN GV 11 Ramsel
66,Bergstraat 71,2021-12-25,22:00:00,4,2,2,FMN GV 11 Ramsel
66,Bergstraat 71,2021-12-25,23:00:00,4,2,2,FMN GV 11 Ramsel
66,Bergstraat 71,2021-12-26,00:00:00,0,0,0,FMN GV 11 Ramsel
66,Bergstraat 71,2021-12-26,01:00:00,2,0,2,FMN GV 11 Ramsel
66,Bergstraat 71,2021-12-26,02:00:00,2,2,0,FMN GV 11 Ramsel
66,Bergstraat 71,2021-12-26,03:00:00,0,0,0,FMN GV 11 Ramsel
66,Bergstraat 71,2021-12-26,04:00:00,0,0,0,FMN GV 11 Ramsel
66,Bergstraat 71,2021-12-26,05:00:00,0,0,0,FMN GV 11 Ramsel
66,Bergstraat 71,2021-12-26,06:00:00,0,0,0,FMN GV 11 Ramsel
66,Bergstraat 71,2021-12-26,07:00:00,4,0,4,FMN GV 11 Ramsel
66,Bergstraat 71,2021-12-26,08:00:00,16,6,10,FMN GV 11 Ramsel
66,Bergstraat 71,2021-12-26,09:00:00,52,22,30,FMN GV 11 Ramsel
66,Bergstraat 71,2021-12-26,10:00:00,72,24,48,FMN GV 11 Ramsel
66,Bergstraat 71,2021-12-26,11:00:00,90,52,38,FMN GV 11 Ramsel
66,Bergstraat 71,2021-12-26,12:00:00,70,40,30,FMN GV 11 Ramsel
66,Bergstraat 71,2021-12-26,13:00:00,56,32,24,FMN GV 11 Ramsel
66,Bergstraat 71,2021-12-26,14:00:00,64,30,34,FMN GV 11 Ramsel
66,Bergstraat 71,2021-12-26,15:00:00,38,18,20,FMN GV 11 Ramsel
66,Bergstraat 71,2021-12-26,16:00:00,22,16,6,FMN GV 11 Ramsel
66,Bergstraat 71,2021-12-26,17:00:00,6,4,2,FMN GV 11 Ramsel
66,Bergstraat 71,2021-12-26,18:00:00,10,2,8,FMN GV 11 Ramsel
66,Bergstraat 71,2021-12-26,19:00:00,4,2,2,FMN GV 11 Ramsel
66,Bergstraat 71,2021-12-26,20:00:00,14,4,10,FMN GV 11 Ramsel
66,Bergstraat 71,2021-12-26,21:00:00,0,0,0,FMN GV 11 Ramsel
66,Bergstraat 71,2021-12-26,22:00:00,0,0,0,FMN GV 11 Ramsel
66,Bergstraat 71,2021-12-26,23:00:00,6,4,2,FMN GV 11 Ramsel
66,Bergstraat 71,2021-12-27,00:00:00,0,0,0,FMN GV 11 Ramsel
66,Bergstraat 71,2021-12-27,01:00:00,0,0,0,FMN GV 11 Ramsel
66,Bergstraat 71,2021-12-27,02:00:00,0,0,0,FMN GV 11 Ramsel
66,Bergstraat 71,2021-12-27,03:00:00,0,0,0,FMN GV 11 Ramsel
66,Bergstraat 71,2021-12-27,04:00:00,2,2,0,FMN GV 11 Ramsel
66,Bergstraat 71,2021-12-27,05:00:00,8,2,6,FMN GV 11 Ramsel
66,Bergstraat 71,2021-12-27,06:00:00,8,0,8,FMN GV 11 Ramsel
66,Bergstraat 71,2021-12-27,07:00:00,10,4,6,FMN GV 11 Ramsel
66,Bergstraat 71,2021-12-27,08:00:00,10,2,8,FMN GV 11 Ramsel
66,Bergstraat 71,2021-12-27,09:00:00,38,16,22,FMN GV 11 Ramsel
66,Bergstraat 71,2021-12-27,10:00:00,66,30,36,FMN GV 11 Ramsel
66,Bergstraat 71,2021-12-27,11:00:00,62,26,36,FMN GV 11 Ramsel
66,Bergstraat 71,2021-12-27,12:00:00,62,32,30,FMN GV 11 Ramsel
66,Bergstraat 71,2021-12-27,13:00:00,54,20,34,FMN GV 11 Ramsel
66,Bergstraat 71,2021-12-27,14:00:00,52,16,36,FMN GV 11 Ramsel
66,Bergstraat 71,2021-12-27,15:00:00,74,50,24,FMN GV 11 Ramsel
66,Bergstraat 71,2021-12-27,16:00:00,30,24,6,FMN GV 11 Ramsel
66,Bergstraat 71,2021-12-27,17:00:00,8,4,4,FMN GV 11 Ramsel
66,Bergstraat 71,2021-12-27,18:00:00,20,6,14,FMN GV 11 Ramsel
66,Bergstraat 71,2021-12-27,19:00:00,20,10,10,FMN GV 11 Ramsel
66,Bergstraat 71,2021-12-27,20:00:00,12,4,8,FMN GV 11 Ramsel
66,Bergstraat 71,2021-12-27,21:00:00,4,2,2,FMN GV 11 Ramsel
66,Bergstraat 71,2021-12-27,22:00:00,2,2,0,FMN GV 11 Ramsel
66,Bergstraat 71,2021-12-27,23:00:00,8,8,0,FMN GV 11 Ramsel
66,Bergstraat 71,2021-12-28,00:00:00,0,0,0,FMN GV 11 Ramsel
66,Bergstraat 71,2021-12-28,01:00:00,2,2,0,FMN GV 11 Ramsel
66,Bergstraat 71,2021-12-28,02:00:00,0,0,0,FMN GV 11 Ramsel
66,Bergstraat 71,2021-12-28,03:00:00,0,0,0,FMN GV 11 Ramsel
66,Bergstraat 71,2021-12-28,04:00:00,0,0,0,FMN GV 11 Ramsel
66,Bergstraat 71,2021-12-28,05:00:00,4,2,2,FMN GV 11 Ramsel
66,Bergstraat 71,2021-12-28,06:00:00,6,0,6,FMN GV 11 Ramsel
66,Bergstraat 71,2021-12-28,07:00:00,4,2,2,FMN GV 11 Ramsel
66,Bergstraat 71,2021-12-28,08:00:00,14,2,12,FMN GV 11 Ramsel
66,Bergstraat 71,2021-12-28,09:00:00,30,10,20,FMN GV 11 Ramsel
66,Bergstraat 71,2021-12-28,10:00:00,22,14,8,FMN GV 11 Ramsel
66,Bergstraat 71,2021-12-28,11:00:00,30,14,16,FMN GV 11 Ramsel
66,Bergstraat 71,2021-12-28,12:00:00,20,12,8,FMN GV 11 Ramsel
66,Bergstraat 71,2021-12-28,13:00:00,34,22,12,FMN GV 11 Ramsel
66,Bergstraat 71,2021-12-28,14:00:00,12,6,6,FMN GV 11 Ramsel
66,Bergstraat 71,2021-12-28,15:00:00,26,10,16,FMN GV 11 Ramsel
66,Bergstraat 71,2021-12-28,16:00:00,18,8,10,FMN GV 11 Ramsel
66,Bergstraat 71,2021-12-28,17:00:00,10,2,8,FMN GV 11 Ramsel
66,Bergstraat 71,2021-12-28,18:00:00,8,6,2,FMN GV 11 Ramsel
66,Bergstraat 71,2021-12-28,19:00:00,8,4,4,FMN GV 11 Ramsel
66,Bergstraat 71,2021-12-28,20:00:00,10,4,6,FMN GV 11 Ramsel
66,Bergstraat 71,2021-12-28,21:00:00,14,8,6,FMN GV 11 Ramsel
66,Bergstraat 71,2021-12-28,22:00:00,12,12,0,FMN GV 11 Ramsel
66,Bergstraat 71,2021-12-28,23:00:00,0,0,0,FMN GV 11 Ramsel
66,Bergstraat 71,2021-12-29,00:00:00,0,0,0,FMN GV 11 Ramsel
66,Bergstraat 71,2021-12-29,01:00:00,0,0,0,FMN GV 11 Ramsel
66,Bergstraat 71,2021-12-29,02:00:00,0,0,0,FMN GV 11 Ramsel
66,Bergstraat 71,2021-12-29,03:00:00,0,0,0,FMN GV 11 Ramsel
66,Bergstraat 71,2021-12-29,04:00:00,2,2,0,FMN GV 11 Ramsel
66,Bergstraat 71,2021-12-29,05:00:00,6,2,4,FMN GV 11 Ramsel
66,Bergstraat 71,2021-12-29,06:00:00,4,0,4,FMN GV 11 Ramsel
66,Bergstraat 71,2021-12-29,07:00:00,8,0,8,FMN GV 11 Ramsel
66,Bergstraat 71,2021-12-29,08:00:00,24,8,16,FMN GV 11 Ramsel
66,Bergstraat 71,2021-12-29,09:00:00,32,14,18,FMN GV 11 Ramsel
66,Bergstraat 71,2021-12-29,10:00:00,32,18,14,FMN GV 11 Ramsel
66,Bergstraat 71,2021-12-29,11:00:00,26,18,8,FMN GV 11 Ramsel
66,Bergstraat 71,2021-12-29,12:00:00,46,26,20,FMN GV 11 Ramsel
66,Bergstraat 71,2021-12-29,13:00:00,66,38,28,FMN GV 11 Ramsel
66,Bergstraat 71,2021-12-29,14:00:00,54,34,20,FMN GV 11 Ramsel
66,Bergstraat 71,2021-12-29,15:00:00,26,14,12,FMN GV 11 Ramsel
66,Bergstraat 71,2021-12-29,16:00:00,12,8,4,FMN GV 11 Ramsel
66,Bergstraat 71,2021-12-29,17:00:00,18,12,6,FMN GV 11 Ramsel
66,Bergstraat 71,2021-12-29,18:00:00,20,14,6,FMN GV 11 Ramsel
66,Bergstraat 71,2021-12-29,19:00:00,16,2,14,FMN GV 11 Ramsel
66,Bergstraat 71,2021-12-29,20:00:00,6,2,4,FMN GV 11 Ramsel
66,Bergstraat 71,2021-12-29,21:00:00,12,6,6,FMN GV 11 Ramsel
66,Bergstraat 71,2021-12-29,22:00:00,10,8,2,FMN GV 11 Ramsel
66,Bergstraat 71,2021-12-29,23:00:00,2,2,0,FMN GV 11 Ramsel
66,Bergstraat 71,2021-12-30,00:00:00,2,0,2,FMN GV 11 Ramsel
66,Bergstraat 71,2021-12-30,01:00:00,0,0,0,FMN GV 11 Ramsel
66,Bergstraat 71,2021-12-30,02:00:00,2,0,2,FMN GV 11 Ramsel
66,Bergstraat 71,2021-12-30,03:00:00,0,0,0,FMN GV 11 Ramsel
66,Bergstraat 71,2021-12-30,04:00:00,0,0,0,FMN GV 11 Ramsel
66,Bergstraat 71,2021-12-30,05:00:00,2,0,2,FMN GV 11 Ramsel
66,Bergstraat 71,2021-12-30,06:00:00,2,0,2,FMN GV 11 Ramsel
66,Bergstraat 71,2021-12-30,07:00:00,8,6,2,FMN GV 11 Ramsel
66,Bergstraat 71,2021-12-30,08:00:00,8,0,8,FMN GV 11 Ramsel
66,Bergstraat 71,2021-12-30,09:00:00,40,12,28,FMN GV 11 Ramsel
66,Bergstraat 71,2021-12-30,10:00:00,78,32,46,FMN GV 11 Ramsel
66,Bergstraat 71,2021-12-30,11:00:00,54,30,24,FMN GV 11 Ramsel
66,Bergstraat 71,2021-12-30,12:00:00,64,26,38,FMN GV 11 Ramsel
66,Bergstraat 71,2021-12-30,13:00:00,138,46,92,FMN GV 11 Ramsel
66,Bergstraat 71,2021-12-30,14:00:00,138,62,76,FMN GV 11 Ramsel
66,Bergstraat 71,2021-12-30,15:00:00,78,42,36,FMN GV 11 Ramsel
66,Bergstraat 71,2021-12-30,16:00:00,74,64,10,FMN GV 11 Ramsel
66,Bergstraat 71,2021-12-30,17:00:00,26,14,12,FMN GV 11 Ramsel
66,Bergstraat 71,2021-12-30,18:00:00,26,12,14,FMN GV 11 Ramsel
66,Bergstraat 71,2021-12-30,19:00:00,22,6,16,FMN GV 11 Ramsel
66,Bergstraat 71,2021-12-30,20:00:00,20,6,14,FMN GV 11 Ramsel
66,Bergstraat 71,2021-12-30,21:00:00,18,8,10,FMN GV 11 Ramsel
66,Bergstraat 71,2021-12-30,22:00:00,18,16,2,FMN GV 11 Ramsel
66,Bergstraat 71,2021-12-30,23:00:00,10,6,4,FMN GV 11 Ramsel
66,Bergstraat 71,2021-12-31,00:00:00,2,2,0,FMN GV 11 Ramsel
66,Bergstraat 71,2021-12-31,01:00:00,4,2,2,FMN GV 11 Ramsel
66,Bergstraat 71,2021-12-31,02:00:00,0,0,0,FMN GV 11 Ramsel
66,Bergstraat 71,2021-12-31,03:00:00,0,0,0,FMN GV 11 Ramsel
66,Bergstraat 71,2021-12-31,04:00:00,0,0,0,FMN GV 11 Ramsel
66,Bergstraat 71,2021-12-31,05:00:00,2,0,2,FMN GV 11 Ramsel
66,Bergstraat 71,2021-12-31,06:00:00,2,0,2,FMN GV 11 Ramsel
66,Bergstraat 71,2021-12-31,07:00:00,6,0,6,FMN GV 11 Ramsel
66,Bergstraat 71,2021-12-31,08:00:00,14,6,8,FMN GV 11 Ramsel
66,Bergstraat 71,2021-12-31,09:00:00,64,16,48,FMN GV 11 Ramsel
66,Bergstraat 71,2021-12-31,10:00:00,60,30,30,FMN GV 11 Ramsel
66,Bergstraat 71,2021-12-31,11:00:00,80,32,48,FMN GV 11 Ramsel
66,Bergstraat 71,2021-12-31,12:00:00,92,58,34,FMN GV 11 Ramsel
66,Bergstraat 71,2021-12-31,13:00:00,106,26,80,FMN GV 11 Ramsel
66,Bergstraat 71,2021-12-31,14:00:00,136,68,68,FMN GV 11 Ramsel
66,Bergstraat 71,2021-12-31,15:00:00,134,80,54,FMN GV 11 Ramsel
66,Bergstraat 71,2021-12-31,16:00:00,94,74,20,FMN GV 11 Ramsel
66,Bergstraat 71,2021-12-31,17:00:00,38,12,26,FMN GV 11 Ramsel
66,Bergstraat 71,2021-12-31,18:00:00,36,8,28,FMN GV 11 Ramsel
66,Bergstraat 71,2021-12-31,19:00:00,28,16,12,FMN GV 11 Ramsel
66,Bergstraat 71,2021-12-31,20:00:00,24,4,20,FMN GV 11 Ramsel
66,Bergstraat 71,2021-12-31,21:00:00,2,2,0,FMN GV 11 Ramsel
66,Bergstraat 71,2021-12-31,22:00:00,14,12,2,FMN GV 11 Ramsel
66,Bergstraat 71,2021-12-31,23:00:00,12,4,8,FMN GV 11 Ramsel
66,Bergstraat 71,2022-01-01,00:00:00,8,6,2,FMN GV 11 Ramsel
66,Bergstraat 71,2022-01-01,01:00:00,2,0,2,FMN GV 11 Ramsel
66,Bergstraat 71,2022-01-01,02:00:00,24,20,4,FMN GV 11 Ramsel
66,Bergstraat 71,2022-01-01,03:00:00,14,8,6,FMN GV 11 Ramsel
66,Bergstraat 71,2022-01-01,04:00:00,0,0,0,FMN GV 11 Ramsel
66,Bergstraat 71,2022-01-01,05:00:00,4,4,0,FMN GV 11 Ramsel
66,Bergstraat 71,2022-01-01,06:00:00,0,0,0,FMN GV 11 Ramsel
66,Bergstraat 71,2022-01-01,07:00:00,2,0,2,FMN GV 11 Ramsel
66,Bergstraat 71,2022-01-01,08:00:00,8,4,4,FMN GV 11 Ramsel
66,Bergstraat 71,2022-01-01,09:00:00,48,14,34,FMN GV 11 Ramsel
66,Bergstraat 71,2022-01-01,10:00:00,80,36,44,FMN GV 11 Ramsel
66,Bergstraat 71,2022-01-01,11:00:00,114,66,48,FMN GV 11 Ramsel
66,Bergstraat 71,2022-01-01,12:00:00,102,56,46,FMN GV 11 Ramsel
66,Bergstraat 71,2022-01-01,13:00:00,130,74,56,FMN GV 11 Ramsel
66,Bergstraat 71,2022-01-01,14:00:00,162,86,76,FMN GV 11 Ramsel
66,Bergstraat 71,2022-01-01,15:00:00,92,46,46,FMN GV 11 Ramsel
66,Bergstraat 71,2022-01-01,16:00:00,80,50,30,FMN GV 11 Ramsel
66,Bergstraat 71,2022-01-01,17:00:00,24,12,12,FMN GV 11 Ramsel
66,Bergstraat 71,2022-01-01,18:00:00,6,4,2,FMN GV 11 Ramsel
66,Bergstraat 71,2022-01-01,19:00:00,0,0,0,FMN GV 11 Ramsel
66,Bergstraat 71,2022-01-01,20:00:00,16,12,4,FMN GV 11 Ramsel
66,Bergstraat 71,2022-01-01,21:00:00,12,8,4,FMN GV 11 Ramsel
66,Bergstraat 71,2022-01-01,22:00:00,8,0,8,FMN GV 11 Ramsel
66,Bergstraat 71,2022-01-01,23:00:00,8,4,4,FMN GV 11 Ramsel
66,Bergstraat 71,2022-01-02,00:00:00,0,0,0,FMN GV 11 Ramsel
66,Bergstraat 71,2022-01-02,01:00:00,0,0,0,FMN GV 11 Ramsel
66,Bergstraat 71,2022-01-02,02:00:00,0,0,0,FMN GV 11 Ramsel
66,Bergstraat 71,2022-01-02,03:00:00,0,0,0,FMN GV 11 Ramsel
66,Bergstraat 71,2022-01-02,04:00:00,0,0,0,FMN GV 11 Ramsel
66,Bergstraat 71,2022-01-02,05:00:00,0,0,0,FMN GV 11 Ramsel
66,Bergstraat 71,2022-01-02,06:00:00,0,0,0,FMN GV 11 Ramsel
66,Bergstraat 71,2022-01-02,07:00:00,4,2,2,FMN GV 11 Ramsel
66,Bergstraat 71,2022-01-02,08:00:00,32,16,16,FMN GV 11 Ramsel
66,Bergstraat 71,2022-01-02,09:00:00,106,30,76,FMN GV 11 Ramsel
66,Bergstraat 71,2022-01-02,10:00:00,86,32,54,FMN GV 11 Ramsel
66,Bergstraat 71,2022-01-02,11:00:00,112,78,34,FMN GV 11 Ramsel
66,Bergstraat 71,2022-01-02,12:00:00,84,54,30,FMN GV 11 Ramsel
66,Bergstraat 71,2022-01-02,13:00:00,88,46,42,FMN GV 11 Ramsel
66,Bergstraat 71,2022-01-02,14:00:00,102,42,60,FMN GV 11 Ramsel
66,Bergstraat 71,2022-01-02,15:00:00,62,26,36,FMN GV 11 Ramsel
66,Bergstraat 71,2022-01-02,16:00:00,50,28,22,FMN GV 11 Ramsel
66,Bergstraat 71,2022-01-02,17:00:00,22,20,2,FMN GV 11 Ramsel
66,Bergstraat 71,2022-01-02,18:00:00,10,6,4,FMN GV 11 Ramsel
66,Bergstraat 71,2022-01-02,19:00:00,8,0,8,FMN GV 11 Ramsel
66,Bergstraat 71,2022-01-02,20:00:00,6,2,4,FMN GV 11 Ramsel
66,Bergstraat 71,2022-01-02,21:00:00,2,2,0,FMN GV 11 Ramsel
66,Bergstraat 71,2022-01-02,22:00:00,4,4,0,FMN GV 11 Ramsel
66,Bergstraat 71,2022-01-02,23:00:00,8,8,0,FMN GV 11 Ramsel
66,Bergstraat 71,2022-01-03,00:00:00,4,2,2,FMN GV 11 Ramsel
66,Bergstraat 71,2022-01-03,01:00:00,2,0,2,FMN GV 11 Ramsel
66,Bergstraat 71,2022-01-03,02:00:00,0,0,0,FMN GV 11 Ramsel
66,Bergstraat 71,2022-01-03,03:00:00,0,0,0,FMN GV 11 Ramsel
66,Bergstraat 71,2022-01-03,04:00:00,2,2,0,FMN GV 11 Ramsel
66,Bergstraat 71,2022-01-03,05:00:00,2,0,2,FMN GV 11 Ramsel
66,Bergstraat 71,2022-01-03,06:00:00,12,0,12,FMN GV 11 Ramsel
66,Bergstraat 71,2022-01-03,07:00:00,24,4,20,FMN GV 11 Ramsel
66,Bergstraat 71,2022-01-03,08:00:00,18,2,16,FMN GV 11 Ramsel
66,Bergstraat 71,2022-01-03,09:00:00,40,24,16,FMN GV 11 Ramsel
66,Bergstraat 71,2022-01-03,10:00:00,38,10,28,FMN GV 11 Ramsel
66,Bergstraat 71,2022-01-03,11:00:00,48,26,22,FMN GV 11 Ramsel
66,Bergstraat 71,2022-01-03,12:00:00,48,28,20,FMN GV 11 Ramsel
66,Bergstraat 71,2022-01-03,13:00:00,26,18,8,FMN GV 11 Ramsel
66,Bergstraat 71,2022-01-03,14:00:00,34,18,16,FMN GV 11 Ramsel
66,Bergstraat 71,2022-01-03,15:00:00,10,4,6,FMN GV 11 Ramsel
66,Bergstraat 71,2022-01-03,16:00:00,6,6,0,FMN GV 11 Ramsel
66,Bergstraat 71,2022-01-03,17:00:00,34,24,10,FMN GV 11 Ramsel
66,Bergstraat 71,2022-01-03,18:00:00,12,10,2,FMN GV 11 Ramsel
66,Bergstraat 71,2022-01-03,19:00:00,16,10,6,FMN GV 11 Ramsel
66,Bergstraat 71,2022-01-03,20:00:00,8,4,4,FMN GV 11 Ramsel
66,Bergstraat 71,2022-01-03,21:00:00,4,2,2,FMN GV 11 Ramsel
66,Bergstraat 71,2022-01-03,22:00:00,8,8,0,FMN GV 11 Ramsel
66,Bergstraat 71,2022-01-03,23:00:00,0,0,0,FMN GV 11 Ramsel
66,Bergstraat 71,2022-01-04,00:00:00,2,0,2,FMN GV 11 Ramsel
66,Bergstraat 71,2022-01-04,01:00:00,0,0,0,FMN GV 11 Ramsel
66,Bergstraat 71,2022-01-04,02:00:00,0,0,0,FMN GV 11 Ramsel
66,Bergstraat 71,2022-01-04,03:00:00,2,2,0,FMN GV 11 Ramsel
66,Bergstraat 71,2022-01-04,04:00:00,2,2,0,FMN GV 11 Ramsel
66,Bergstraat 71,2022-01-04,05:00:00,6,2,4,FMN GV 11 Ramsel
66,Bergstraat 71,2022-01-04,06:00:00,20,4,16,FMN GV 11 Ramsel
66,Bergstraat 71,2022-01-04,07:00:00,14,8,6,FMN GV 11 Ramsel
66,Bergstraat 71,2022-01-04,08:00:00,12,0,12,FMN GV 11 Ramsel
66,Bergstraat 71,2022-01-04,09:00:00,32,14,18,FMN GV 11 Ramsel
66,Bergstraat 71,2022-01-04,10:00:00,52,14,38,FMN GV 11 Ramsel
66,Bergstraat 71,2022-01-04,11:00:00,46,20,26,FMN GV 11 Ramsel
66,Bergstraat 71,2022-01-04,12:00:00,30,20,10,FMN GV 11 Ramsel
66,Bergstraat 71,2022-01-04,13:00:00,38,14,24,FMN GV 11 Ramsel
66,Bergstraat 71,2022-01-04,14:00:00,54,26,28,FMN GV 11 Ramsel
66,Bergstraat 71,2022-01-04,15:00:00,34,22,12,FMN GV 11 Ramsel
66,Bergstraat 71,2022-01-04,16:00:00,26,16,10,FMN GV 11 Ramsel
66,Bergstraat 71,2022-01-04,17:00:00,30,16,14,FMN GV 11 Ramsel
66,Bergstraat 71,2022-01-04,18:00:00,16,10,6,FMN GV 11 Ramsel
66,Bergstraat 71,2022-01-04,19:00:00,8,8,0,FMN GV 11 Ramsel
66,Bergstraat 71,2022-01-04,20:00:00,6,4,2,FMN GV 11 Ramsel
66,Bergstraat 71,2022-01-04,21:00:00,12,8,4,FMN GV 11 Ramsel
66,Bergstraat 71,2022-01-04,22:00:00,16,12,4,FMN GV 11 Ramsel
66,Bergstraat 71,2022-01-04,23:00:00,2,2,0,FMN GV 11 Ramsel
66,Bergstraat 71,2022-01-05,00:00:00,2,0,2,FMN GV 11 Ramsel
66,Bergstraat 71,2022-01-05,01:00:00,0,0,0,FMN GV 11 Ramsel
66,Bergstraat 71,2022-01-05,02:00:00,0,0,0,FMN GV 11 Ramsel
66,Bergstraat 71,2022-01-05,03:00:00,0,0,0,FMN GV 11 Ramsel
66,Bergstraat 71,2022-01-05,04:00:00,2,2,0,FMN GV 11 Ramsel
66,Bergstraat 71,2022-01-05,05:00:00,4,2,2,FMN GV 11 Ramsel
66,Bergstraat 71,2022-01-05,06:00:00,10,2,8,FMN GV 11 Ramsel
66,Bergstraat 71,2022-01-05,07:00:00,14,8,6,FMN GV 11 Ramsel
66,Bergstraat 71,2022-01-05,08:00:00,16,6,10,FMN GV 11 Ramsel
66,Bergstraat 71,2022-01-05,09:00:00,20,8,12,FMN GV 11 Ramsel
66,Bergstraat 71,2022-01-05,10:00:00,42,14,28,FMN GV 11 Ramsel
66,Bergstraat 71,2022-01-05,11:00:00,28,12,16,FMN GV 11 Ramsel
66,Bergstraat 71,2022-01-05,12:00:00,46,20,26,FMN GV 11 Ramsel
66,Bergstraat 71,2022-01-05,13:00:00,44,30,14,FMN GV 11 Ramsel
66,Bergstraat 71,2022-01-05,14:00:00,82,36,46,FMN GV 11 Ramsel
66,Bergstraat 71,2022-01-05,15:00:00,50,30,20,FMN GV 11 Ramsel
66,Bergstraat 71,2022-01-05,16:00:00,52,28,24,FMN GV 11 Ramsel
66,Bergstraat 71,2022-01-05,17:00:00,22,16,6,FMN GV 11 Ramsel
66,Bergstraat 71,2022-01-05,18:00:00,18,8,10,FMN GV 11 Ramsel
66,Bergstraat 71,2022-01-05,19:00:00,10,2,8,FMN GV 11 Ramsel
66,Bergstraat 71,2022-01-05,20:00:00,4,0,4,FMN GV 11 Ramsel
66,Bergstraat 71,2022-01-05,21:00:00,2,2,0,FMN GV 11 Ramsel
66,Bergstraat 71,2022-01-05,22:00:00,14,12,2,FMN GV 11 Ramsel
66,Bergstraat 71,2022-01-05,23:00:00,8,8,0,FMN GV 11 Ramsel
66,Bergstraat 71,2022-01-06,00:00:00,0,0,0,FMN GV 11 Ramsel
66,Bergstraat 71,2022-01-06,01:00:00,0,0,0,FMN GV 11 Ramsel
66,Bergstraat 71,2022-01-06,02:00:00,0,0,0,FMN GV 11 Ramsel
66,Bergstraat 71,2022-01-06,03:00:00,0,0,0,FMN GV 11 Ramsel
66,Bergstraat 71,2022-01-06,04:00:00,4,2,2,FMN GV 11 Ramsel
66,Bergstraat 71,2022-01-06,05:00:00,12,4,8,FMN GV 11 Ramsel
66,Bergstraat 71,2022-01-06,06:00:00,22,4,18,FMN GV 11 Ramsel
66,Bergstraat 71,2022-01-06,07:00:00,20,10,10,FMN GV 11 Ramsel
66,Bergstraat 71,2022-01-06,08:00:00,26,8,18,FMN GV 11 Ramsel
66,Bergstraat 71,2022-01-06,09:00:00,42,18,24,FMN GV 11 Ramsel
66,Bergstraat 71,2022-01-06,10:00:00,38,12,26,FMN GV 11 Ramsel
66,Bergstraat 71,2022-01-06,11:00:00,64,26,38,FMN GV 11 Ramsel
66,Bergstraat 71,2022-01-06,12:00:00,72,24,48,FMN GV 11 Ramsel
66,Bergstraat 71,2022-01-06,13:00:00,126,60,66,FMN GV 11 Ramsel
66,Bergstraat 71,2022-01-06,14:00:00,144,84,60,FMN GV 11 Ramsel
66,Bergstraat 71,2022-01-06,15:00:00,126,82,44,FMN GV 11 Ramsel
66,Bergstraat 71,2022-01-06,16:00:00,66,48,18,FMN GV 11 Ramsel
66,Bergstraat 71,2022-01-06,17:00:00,68,40,28,FMN GV 11 Ramsel
66,Bergstraat 71,2022-01-06,18:00:00,20,14,6,FMN GV 11 Ramsel
66,Bergstraat 71,2022-01-06,19:00:00,14,10,4,FMN GV 11 Ramsel
66,Bergstraat 71,2022-01-06,20:00:00,24,8,16,FMN GV 11 Ramsel
66,Bergstraat 71,2022-01-06,21:00:00,2,2,0,FMN GV 11 Ramsel
66,Bergstraat 71,2022-01-06,22:00:00,10,8,2,FMN GV 11 Ramsel
66,Bergstraat 71,2022-01-06,23:00:00,4,4,0,FMN GV 11 Ramsel
66,Bergstraat 71,2022-01-07,00:00:00,0,0,0,FMN GV 11 Ramsel
66,Bergstraat 71,2022-01-07,01:00:00,0,0,0,FMN GV 11 Ramsel
66,Bergstraat 71,2022-01-07,02:00:00,2,2,0,FMN GV 11 Ramsel
66,Bergstraat 71,2022-01-07,03:00:00,2,0,2,FMN GV 11 Ramsel
66,Bergstraat 71,2022-01-07,04:00:00,2,2,0,FMN GV 11 Ramsel
66,Bergstraat 71,2022-01-07,05:00:00,0,0,0,FMN GV 11 Ramsel
66,Bergstraat 71,2022-01-07,06:00:00,10,2,8,FMN GV 11 Ramsel
66,Bergstraat 71,2022-01-07,07:00:00,14,8,6,FMN GV 11 Ramsel
66,Bergstraat 71,2022-01-07,08:00:00,16,0,16,FMN GV 11 Ramsel
66,Bergstraat 71,2022-01-07,09:00:00,10,4,6,FMN GV 11 Ramsel
66,Bergstraat 71,2022-01-07,10:00:00,34,16,18,FMN GV 11 Ramsel
66,Bergstraat 71,2022-01-07,11:00:00,54,24,30,FMN GV 11 Ramsel
66,Bergstraat 71,2022-01-07,12:00:00,40,24,16,FMN GV 11 Ramsel
66,Bergstraat 71,2022-01-07,13:00:00,36,14,22,FMN GV 11 Ramsel
66,Bergstraat 71,2022-01-07,14:00:00,42,22,20,FMN GV 11 Ramsel
66,Bergstraat 71,2022-01-07,15:00:00,48,32,16,FMN GV 11 Ramsel
66,Bergstraat 71,2022-01-07,16:00:00,46,28,18,FMN GV 11 Ramsel
66,Bergstraat 71,2022-01-07,17:00:00,32,14,18,FMN GV 11 Ramsel
66,Bergstraat 71,2022-01-07,18:00:00,18,14,4,FMN GV 11 Ramsel
66,Bergstraat 71,2022-01-07,19:00:00,16,6,10,FMN GV 11 Ramsel
66,Bergstraat 71,2022-01-07,20:00:00,12,2,10,FMN GV 11 Ramsel
66,Bergstraat 71,2022-01-07,21:00:00,6,4,2,FMN GV 11 Ramsel
66,Bergstraat 71,2022-01-07,22:00:00,16,12,4,FMN GV 11 Ramsel
66,Bergstraat 71,2022-01-07,23:00:00,2,2,0,FMN GV 11 Ramsel
66,Bergstraat 71,2022-01-08,00:00:00,10,8,2,FMN GV 11 Ramsel
66,Bergstraat 71,2022-01-08,01:00:00,6,6,0,FMN GV 11 Ramsel
66,Bergstraat 71,2022-01-08,02:00:00,2,0,2,FMN GV 11 Ramsel
66,Bergstraat 71,2022-01-08,03:00:00,2,0,2,FMN GV 11 Ramsel
66,Bergstraat 71,2022-01-08,04:00:00,0,0,0,FMN GV 11 Ramsel
66,Bergstraat 71,2022-01-08,05:00:00,0,0,0,FMN GV 11 Ramsel
66,Bergstraat 71,2022-01-08,06:00:00,0,0,0,FMN GV 11 Ramsel
66,Bergstraat 71,2022-01-08,07:00:00,2,0,2,FMN GV 11 Ramsel
66,Bergstraat 71,2022-01-08,08:00:00,20,6,14,FMN GV 11 Ramsel
66,Bergstraat 71,2022-01-08,09:00:00,12,4,8,FMN GV 11 Ramsel
66,Bergstraat 71,2022-01-08,10:00:00,26,14,12,FMN GV 11 Ramsel
66,Bergstraat 71,2022-01-08,11:00:00,58,40,18,FMN GV 11 Ramsel
66,Bergstraat 71,2022-01-08,12:00:00,24,14,10,FMN GV 11 Ramsel
66,Bergstraat 71,2022-01-08,13:00:00,6,4,2,FMN GV 11 Ramsel
66,Bergstraat 71,2022-01-08,14:00:00,12,12,0,FMN GV 11 Ramsel
66,Bergstraat 71,2022-01-08,15:00:00,14,6,8,FMN GV 11 Ramsel
66,Bergstraat 71,2022-01-08,16:00:00,20,4,16,FMN GV 11 Ramsel
66,Bergstraat 71,2022-01-08,17:00:00,4,2,2,FMN GV 11 Ramsel
66,Bergstraat 71,2022-01-08,18:00:00,4,4,0,FMN GV 11 Ramsel
66,Bergstraat 71,2022-01-08,19:00:00,8,2,6,FMN GV 11 Ramsel
66,Bergstraat 71,2022-01-08,20:00:00,6,2,4,FMN GV 11 Ramsel
66,Bergstraat 71,2022-01-08,21:00:00,6,0,6,FMN GV 11 Ramsel
66,Bergstraat 71,2022-01-08,22:00:00,4,4,0,FMN GV 11 Ramsel
66,Bergstraat 71,2022-01-08,23:00:00,4,4,0,FMN GV 11 Ramsel
66,Bergstraat 71,2022-01-09,00:00:00,2,2,0,FMN GV 11 Ramsel
66,Bergstraat 71,2022-01-09,01:00:00,2,0,2,FMN GV 11 Ramsel
66,Bergstraat 71,2022-01-09,02:00:00,0,0,0,FMN GV 11 Ramsel
66,Bergstraat 71,2022-01-09,03:00:00,2,2,0,FMN GV 11 Ramsel
66,Bergstraat 71,2022-01-09,04:00:00,2,2,0,FMN GV 11 Ramsel
66,Bergstraat 71,2022-01-09,05:00:00,0,0,0,FMN GV 11 Ramsel
66,Bergstraat 71,2022-01-09,06:00:00,0,0,0,FMN GV 11 Ramsel
66,Bergstraat 71,2022-01-09,07:00:00,4,0,4,FMN GV 11 Ramsel
66,Bergstraat 71,2022-01-09,08:00:00,50,26,24,FMN GV 11 Ramsel
66,Bergstraat 71,2022-01-09,09:00:00,142,42,100,FMN GV 11 Ramsel
66,Bergstraat 71,2022-01-09,10:00:00,106,62,44,FMN GV 11 Ramsel
66,Bergstraat 71,2022-01-09,11:00:00,86,54,32,FMN GV 11 Ramsel
66,Bergstraat 71,2022-01-09,12:00:00,76,58,18,FMN GV 11 Ramsel
66,Bergstraat 71,2022-01-09,13:00:00,70,26,44,FMN GV 11 Ramsel
66,Bergstraat 71,2022-01-09,14:00:00,66,38,28,FMN GV 11 Ramsel
66,Bergstraat 71,2022-01-09,15:00:00,26,4,22,FMN GV 11 Ramsel
66,Bergstraat 71,2022-01-09,16:00:00,24,14,10,FMN GV 11 Ramsel
66,Bergstraat 71,2022-01-09,17:00:00,14,4,10,FMN GV 11 Ramsel
66,Bergstraat 71,2022-01-09,18:00:00,8,6,2,FMN GV 11 Ramsel
66,Bergstraat 71,2022-01-09,19:00:00,8,4,4,FMN GV 11 Ramsel
66,Bergstraat 71,2022-01-09,20:00:00,6,4,2,FMN GV 11 Ramsel
66,Bergstraat 71,2022-01-09,21:00:00,4,4,0,FMN GV 11 Ramsel
66,Bergstraat 71,2022-01-09,22:00:00,0,0,0,FMN GV 11 Ramsel
66,Bergstraat 71,2022-01-09,23:00:00,0,0,0,FMN GV 11 Ramsel
66,Bergstraat 71,2022-01-10,00:00:00,0,0,0,FMN GV 11 Ramsel
66,Bergstraat 71,2022-01-10,01:00:00,0,0,0,FMN GV 11 Ramsel
66,Bergstraat 71,2022-01-10,02:00:00,0,0,0,FMN GV 11 Ramsel
66,Bergstraat 71,2022-01-10,03:00:00,0,0,0,FMN GV 11 Ramsel
66,Bergstraat 71,2022-01-10,04:00:00,2,2,0,FMN GV 11 Ramsel
66,Bergstraat 71,2022-01-10,05:00:00,0,0,0,FMN GV 11 Ramsel
66,Bergstraat 71,2022-01-10,06:00:00,8,4,4,FMN GV 11 Ramsel
66,Bergstraat 71,2022-01-10,07:00:00,88,18,70,FMN GV 11 Ramsel
66,Bergstraat 71,2022-01-10,08:00:00,80,12,68,FMN GV 11 Ramsel
66,Bergstraat 71,2022-01-10,09:00:00,18,4,14,FMN GV 11 Ramsel
66,Bergstraat 71,2022-01-10,10:00:00,12,10,2,FMN GV 11 Ramsel
66,Bergstraat 71,2022-01-10,11:00:00,10,4,6,FMN GV 11 Ramsel
66,Bergstraat 71,2022-01-10,12:00:00,32,24,8,FMN GV 11 Ramsel
66,Bergstraat 71,2022-01-10,13:00:00,44,16,28,FMN GV 11 Ramsel
66,Bergstraat 71,2022-01-10,14:00:00,76,42,34,FMN GV 11 Ramsel
66,Bergstraat 71,2022-01-10,15:00:00,142,120,22,FMN GV 11 Ramsel
66,Bergstraat 71,2022-01-10,16:00:00,138,114,24,FMN GV 11 Ramsel
66,Bergstraat 71,2022-01-10,17:00:00,40,28,12,FMN GV 11 Ramsel
66,Bergstraat 71,2022-01-10,18:00:00,6,2,4,FMN GV 11 Ramsel
66,Bergstraat 71,2022-01-10,19:00:00,12,6,6,FMN GV 11 Ramsel
66,Bergstraat 71,2022-01-10,20:00:00,6,6,0,FMN GV 11 Ramsel
66,Bergstraat 71,2022-01-10,21:00:00,8,4,4,FMN GV 11 Ramsel
66,Bergstraat 71,2022-01-10,22:00:00,18,10,8,FMN GV 11 Ramsel
66,Bergstraat 71,2022-01-10,23:00:00,2,2,0,FMN GV 11 Ramsel
66,Bergstraat 71,2022-01-11,00:00:00,0,0,0,FMN GV 11 Ramsel
66,Bergstraat 71,2022-01-11,01:00:00,0,0,0,FMN GV 11 Ramsel
66,Bergstraat 71,2022-01-11,02:00:00,0,0,0,FMN GV 11 Ramsel
66,Bergstraat 71,2022-01-11,03:00:00,0,0,0,FMN GV 11 Ramsel
66,Bergstraat 71,2022-01-11,04:00:00,2,2,0,FMN GV 11 Ramsel
66,Bergstraat 71,2022-01-11,05:00:00,4,0,4,FMN GV 11 Ramsel
66,Bergstraat 71,2022-01-11,06:00:00,18,6,12,FMN GV 11 Ramsel
66,Bergstraat 71,2022-01-11,07:00:00,102,20,82,FMN GV 11 Ramsel
66,Bergstraat 71,2022-01-11,08:00:00,104,10,94,FMN GV 11 Ramsel
66,Bergstraat 71,2022-01-11,09:00:00,14,8,6,FMN GV 11 Ramsel
66,Bergstraat 71,2022-01-11,10:00:00,24,8,16,FMN GV 11 Ramsel
66,Bergstraat 71,2022-01-11,11:00:00,48,20,28,FMN GV 11 Ramsel
66,Bergstraat 71,2022-01-11,12:00:00,60,36,24,FMN GV 11 Ramsel
66,Bergstraat 71,2022-01-11,13:00:00,102,46,56,FMN GV 11 Ramsel
66,Bergstraat 71,2022-01-11,14:00:00,118,60,58,FMN GV 11 Ramsel
66,Bergstraat 71,2022-01-11,15:00:00,224,180,44,FMN GV 11 Ramsel
66,Bergstraat 71,2022-01-11,16:00:00,156,126,30,FMN GV 11 Ramsel
66,Bergstraat 71,2022-01-11,17:00:00,56,24,32,FMN GV 11 Ramsel
66,Bergstraat 71,2022-01-11,18:00:00,30,16,14,FMN GV 11 Ramsel
66,Bergstraat 71,2022-01-11,19:00:00,24,6,18,FMN GV 11 Ramsel
66,Bergstraat 71,2022-01-11,20:00:00,12,10,2,FMN GV 11 Ramsel
66,Bergstraat 71,2022-01-11,21:00:00,4,0,4,FMN GV 11 Ramsel
66,Bergstraat 71,2022-01-11,22:00:00,10,10,0,FMN GV 11 Ramsel
66,Bergstraat 71,2022-01-11,23:00:00,0,0,0,FMN GV 11 Ramsel
66,Bergstraat 71,2022-01-12,00:00:00,0,0,0,FMN GV 11 Ramsel
66,Bergstraat 71,2022-01-12,01:00:00,0,0,0,FMN GV 11 Ramsel
66,Bergstraat 71,2022-01-12,02:00:00,0,0,0,FMN GV 11 Ramsel
66,Bergstraat 71,2022-01-12,03:00:00,0,0,0,FMN GV 11 Ramsel
66,Bergstraat 71,2022-01-12,04:00:00,2,2,0,FMN GV 11 Ramsel
66,Bergstraat 71,2022-01-12,05:00:00,10,6,4,FMN GV 11 Ramsel
66,Bergstraat 71,2022-01-12,06:00:00,16,4,12,FMN GV 11 Ramsel
66,Bergstraat 71,2022-01-12,07:00:00,124,16,108,FMN GV 11 Ramsel
66,Bergstraat 71,2022-01-12,08:00:00,164,10,154,FMN GV 11 Ramsel
66,Bergstraat 71,2022-01-12,09:00:00,24,6,18,FMN GV 11 Ramsel
66,Bergstraat 71,2022-01-12,10:00:00,12,6,6,FMN GV 11 Ramsel
66,Bergstraat 71,2022-01-12,11:00:00,44,30,14,FMN GV 11 Ramsel
66,Bergstraat 71,2022-01-12,12:00:00,190,176,14,FMN GV 11 Ramsel
66,Bergstraat 71,2022-01-12,13:00:00,52,28,24,FMN GV 11 Ramsel
66,Bergstraat 71,2022-01-12,14:00:00,84,38,46,FMN GV 11 Ramsel
66,Bergstraat 71,2022-01-12,15:00:00,52,28,24,FMN GV 11 Ramsel
66,Bergstraat 71,2022-01-12,16:00:00,42,26,16,FMN GV 11 Ramsel
66,Bergstraat 71,2022-01-12,17:00:00,74,44,30,FMN GV 11 Ramsel
66,Bergstraat 71,2022-01-12,18:00:00,36,22,14,FMN GV 11 Ramsel
66,Bergstraat 71,2022-01-12,19:00:00,18,14,4,FMN GV 11 Ramsel
66,Bergstraat 71,2022-01-12,20:00:00,8,6,2,FMN GV 11 Ramsel
66,Bergstraat 71,2022-01-12,21:00:00,12,8,4,FMN GV 11 Ramsel
66,Bergstraat 71,2022-01-12,22:00:00,12,4,8,FMN GV 11 Ramsel
66,Bergstraat 71,2022-01-12,23:00:00,0,0,0,FMN GV 11 Ramsel
66,Bergstraat 71,2022-01-13,00:00:00,0,0,0,FMN GV 11 Ramsel
66,Bergstraat 71,2022-01-13,01:00:00,0,0,0,FMN GV 11 Ramsel
66,Bergstraat 71,2022-01-13,02:00:00,0,0,0,FMN GV 11 Ramsel
66,Bergstraat 71,2022-01-13,03:00:00,0,0,0,FMN GV 11 Ramsel
66,Bergstraat 71,2022-01-13,04:00:00,4,4,0,FMN GV 11 Ramsel
66,Bergstraat 71,2022-01-13,05:00:00,10,6,4,FMN GV 11 Ramsel
66,Bergstraat 71,2022-01-13,06:00:00,22,4,18,FMN GV 11 Ramsel
66,Bergstraat 71,2022-01-13,07:00:00,146,14,132,FMN GV 11 Ramsel
66,Bergstraat 71,2022-01-13,08:00:00,144,20,124,FMN GV 11 Ramsel
66,Bergstraat 71,2022-01-13,09:00:00,18,6,12,FMN GV 11 Ramsel
66,Bergstraat 71,2022-01-13,10:00:00,34,22,12,FMN GV 11 Ramsel
66,Bergstraat 71,2022-01-13,11:00:00,28,20,8,FMN GV 11 Ramsel
66,Bergstraat 71,2022-01-13,12:00:00,34,24,10,FMN GV 11 Ramsel
66,Bergstraat 71,2022-01-13,13:00:00,68,32,36,FMN GV 11 Ramsel
66,Bergstraat 71,2022-01-13,14:00:00,60,38,22,FMN GV 11 Ramsel
66,Bergstraat 71,2022-01-13,15:00:00,172,148,24,FMN GV 11 Ramsel
66,Bergstraat 71,2022-01-13,16:00:00,110,98,12,FMN GV 11 Ramsel
66,Bergstraat 71,2022-01-13,17:00:00,34,22,12,FMN GV 11 Ramsel
66,Bergstraat 71,2022-01-13,18:00:00,24,14,10,FMN GV 11 Ramsel
66,Bergstraat 71,2022-01-13,19:00:00,10,6,4,FMN GV 11 Ramsel
66,Bergstraat 71,2022-01-13,20:00:00,12,8,4,FMN GV 11 Ramsel
66,Bergstraat 71,2022-01-13,21:00:00,2,2,0,FMN GV 11 Ramsel
66,Bergstraat 71,2022-01-13,22:00:00,16,8,8,FMN GV 11 Ramsel
66,Bergstraat 71,2022-01-13,23:00:00,2,0,2,FMN GV 11 Ramsel
66,Bergstraat 71,2022-01-14,00:00:00,2,0,2,FMN GV 11 Ramsel
66,Bergstraat 71,2022-01-14,01:00:00,0,0,0,FMN GV 11 Ramsel
66,Bergstraat 71,2022-01-14,02:00:00,0,0,0,FMN GV 11 Ramsel
66,Bergstraat 71,2022-01-14,03:00:00,0,0,0,FMN GV 11 Ramsel
66,Bergstraat 71,2022-01-14,04:00:00,6,6,0,FMN GV 11 Ramsel
66,Bergstraat 71,2022-01-14,05:00:00,6,2,4,FMN GV 11 Ramsel
66,Bergstraat 71,2022-01-14,06:00:00,12,2,10,FMN GV 11 Ramsel
66,Bergstraat 71,2022-01-14,07:00:00,128,20,108,FMN GV 11 Ramsel
66,Bergstraat 71,2022-01-14,08:00:00,138,10,128,FMN GV 11 Ramsel
66,Bergstraat 71,2022-01-14,09:00:00,36,6,30,FMN GV 11 Ramsel
66,Bergstraat 71,2022-01-14,10:00:00,38,18,20,FMN GV 11 Ramsel
66,Bergstraat 71,2022-01-14,11:00:00,34,20,14,FMN GV 11 Ramsel
66,Bergstraat 71,2022-01-14,12:00:00,64,34,30,FMN GV 11 Ramsel
66,Bergstraat 71,2022-01-14,13:00:00,128,54,74,FMN GV 11 Ramsel
66,Bergstraat 71,2022-01-14,14:00:00,152,80,72,FMN GV 11 Ramsel
66,Bergstraat 71,2022-01-14,15:00:00,182,152,30,FMN GV 11 Ramsel
66,Bergstraat 71,2022-01-14,16:00:00,144,114,30,FMN GV 11 Ramsel
66,Bergstraat 71,2022-01-14,17:00:00,44,30,14,FMN GV 11 Ramsel
66,Bergstraat 71,2022-01-14,18:00:00,42,20,22,FMN GV 11 Ramsel
66,Bergstraat 71,2022-01-14,19:00:00,22,2,20,FMN GV 11 Ramsel
66,Bergstraat 71,2022-01-14,20:00:00,24,14,10,FMN GV 11 Ramsel
66,Bergstraat 71,2022-01-14,21:00:00,6,4,2,FMN GV 11 Ramsel
66,Bergstraat 71,2022-01-14,22:00:00,12,10,2,FMN GV 11 Ramsel
66,Bergstraat 71,2022-01-14,23:00:00,8,8,0,FMN GV 11 Ramsel
66,Bergstraat 71,2022-01-15,00:00:00,10,8,2,FMN GV 11 Ramsel
66,Bergstraat 71,2022-01-15,01:00:00,0,0,0,FMN GV 11 Ramsel
66,Bergstraat 71,2022-01-15,02:00:00,0,0,0,FMN GV 11 Ramsel
66,Bergstraat 71,2022-01-15,03:00:00,0,0,0,FMN GV 11 Ramsel
66,Bergstraat 71,2022-01-15,04:00:00,0,0,0,FMN GV 11 Ramsel
66,Bergstraat 71,2022-01-15,05:00:00,2,0,2,FMN GV 11 Ramsel
66,Bergstraat 71,2022-01-15,06:00:00,2,0,2,FMN GV 11 Ramsel
66,Bergstraat 71,2022-01-15,07:00:00,4,0,4,FMN GV 11 Ramsel
66,Bergstraat 71,2022-01-15,08:00:00,24,6,18,FMN GV 11 Ramsel
66,Bergstraat 71,2022-01-15,09:00:00,48,10,38,FMN GV 11 Ramsel
66,Bergstraat 71,2022-01-15,10:00:00,48,14,34,FMN GV 11 Ramsel
66,Bergstraat 71,2022-01-15,11:00:00,70,20,50,FMN GV 11 Ramsel
66,Bergstraat 71,2022-01-15,12:00:00,88,46,42,FMN GV 11 Ramsel
66,Bergstraat 71,2022-01-15,13:00:00,166,70,96,FMN GV 11 Ramsel
66,Bergstraat 71,2022-01-15,14:00:00,152,82,70,FMN GV 11 Ramsel
66,Bergstraat 71,2022-01-15,15:00:00,124,62,62,FMN GV 11 Ramsel
66,Bergstraat 71,2022-01-15,16:00:00,76,62,14,FMN GV 11 Ramsel
66,Bergstraat 71,2022-01-15,17:00:00,36,16,20,FMN GV 11 Ramsel
66,Bergstraat 71,2022-01-15,18:00:00,22,14,8,FMN GV 11 Ramsel
66,Bergstraat 71,2022-01-15,19:00:00,14,6,8,FMN GV 11 Ramsel
66,Bergstraat 71,2022-01-15,20:00:00,10,4,6,FMN GV 11 Ramsel
66,Bergstraat 71,2022-01-15,21:00:00,4,2,2,FMN GV 11 Ramsel
66,Bergstraat 71,2022-01-15,22:00:00,4,4,0,FMN GV 11 Ramsel
66,Bergstraat 71,2022-01-15,23:00:00,4,2,2,FMN GV 11 Ramsel
66,Bergstraat 71,2022-01-16,00:00:00,2,0,2,FMN GV 11 Ramsel
66,Bergstraat 71,2022-01-16,01:00:00,4,4,0,FMN GV 11 Ramsel
66,Bergstraat 71,2022-01-16,02:00:00,0,0,0,FMN GV 11 Ramsel
66,Bergstraat 71,2022-01-16,03:00:00,0,0,0,FMN GV 11 Ramsel
66,Bergstraat 71,2022-01-16,04:00:00,0,0,0,FMN GV 11 Ramsel
66,Bergstraat 71,2022-01-16,05:00:00,0,0,0,FMN GV 11 Ramsel
66,Bergstraat 71,2022-01-16,06:00:00,2,0,2,FMN GV 11 Ramsel
66,Bergstraat 71,2022-01-16,07:00:00,6,0,6,FMN GV 11 Ramsel
66,Bergstraat 71,2022-01-16,08:00:00,38,6,32,FMN GV 11 Ramsel
66,Bergstraat 71,2022-01-16,09:00:00,74,18,56,FMN GV 11 Ramsel
66,Bergstraat 71,2022-01-16,10:00:00,114,52,62,FMN GV 11 Ramsel
66,Bergstraat 71,2022-01-16,11:00:00,78,52,26,FMN GV 11 Ramsel
66,Bergstraat 71,2022-01-16,12:00:00,36,22,14,FMN GV 11 Ramsel
66,Bergstraat 71,2022-01-16,13:00:00,38,28,10,FMN GV 11 Ramsel
66,Bergstraat 71,2022-01-16,14:00:00,58,14,44,FMN GV 11 Ramsel
66,Bergstraat 71,2022-01-16,15:00:00,30,24,6,FMN GV 11 Ramsel
66,Bergstraat 71,2022-01-16,16:00:00,30,16,14,FMN GV 11 Ramsel
66,Bergstraat 71,2022-01-16,17:00:00,28,20,8,FMN GV 11 Ramsel
66,Bergstraat 71,2022-01-16,18:00:00,8,2,6,FMN GV 11 Ramsel
66,Bergstraat 71,2022-01-16,19:00:00,4,2,2,FMN GV 11 Ramsel
66,Bergstraat 71,2022-01-16,20:00:00,10,6,4,FMN GV 11 Ramsel
66,Bergstraat 71,2022-01-16,21:00:00,4,0,4,FMN GV 11 Ramsel
66,Bergstraat 71,2022-01-16,22:00:00,10,8,2,FMN GV 11 Ramsel
66,Bergstraat 71,2022-01-16,23:00:00,2,2,0,FMN GV 11 Ramsel
66,Bergstraat 71,2022-01-17,00:00:00,0,0,0,FMN GV 11 Ramsel
66,Bergstraat 71,2022-01-17,01:00:00,0,0,0,FMN GV 11 Ramsel
66,Bergstraat 71,2022-01-17,02:00:00,0,0,0,FMN GV 11 Ramsel
66,Bergstraat 71,2022-01-17,03:00:00,0,0,0,FMN GV 11 Ramsel
66,Bergstraat 71,2022-01-17,04:00:00,6,4,2,FMN GV 11 Ramsel
66,Bergstraat 71,2022-01-17,05:00:00,8,6,2,FMN GV 11 Ramsel
66,Bergstraat 71,2022-01-17,06:00:00,22,8,14,FMN GV 11 Ramsel
66,Bergstraat 71,2022-01-17,07:00:00,166,22,144,FMN GV 11 Ramsel
66,Bergstraat 71,2022-01-17,08:00:00,150,14,136,FMN GV 11 Ramsel
66,Bergstraat 71,2022-01-17,09:00:00,16,2,14,FMN GV 11 Ramsel
66,Bergstraat 71,2022-01-17,10:00:00,28,14,14,FMN GV 11 Ramsel
66,Bergstraat 71,2022-01-17,11:00:00,24,6,18,FMN GV 11 Ramsel
66,Bergstraat 71,2022-01-17,12:00:00,68,38,30,FMN GV 11 Ramsel
66,Bergstraat 71,2022-01-17,13:00:00,128,76,52,FMN GV 11 Ramsel
66,Bergstraat 71,2022-01-17,14:00:00,118,78,40,FMN GV 11 Ramsel
66,Bergstraat 71,2022-01-17,15:00:00,238,180,58,FMN GV 11 Ramsel
66,Bergstraat 71,2022-01-17,16:00:00,126,82,44,FMN GV 11 Ramsel
66,Bergstraat 71,2022-01-17,17:00:00,58,44,14,FMN GV 11 Ramsel
66,Bergstraat 71,2022-01-17,18:00:00,26,16,10,FMN GV 11 Ramsel
66,Bergstraat 71,2022-01-17,19:00:00,24,10,14,FMN GV 11 Ramsel
66,Bergstraat 71,2022-01-17,20:00:00,20,12,8,FMN GV 11 Ramsel
66,Bergstraat 71,2022-01-17,21:00:00,10,10,0,FMN GV 11 Ramsel
66,Bergstraat 71,2022-01-17,22:00:00,12,8,4,FMN GV 11 Ramsel
66,Bergstraat 71,2022-01-17,23:00:00,8,4,4,FMN GV 11 Ramsel
66,Bergstraat 71,2022-01-18,00:00:00,0,0,0,FMN GV 11 Ramsel
66,Bergstraat 71,2022-01-18,01:00:00,6,2,4,FMN GV 11 Ramsel
66,Bergstraat 71,2022-01-18,02:00:00,0,0,0,FMN GV 11 Ramsel
66,Bergstraat 71,2022-01-18,03:00:00,0,0,0,FMN GV 11 Ramsel
66,Bergstraat 71,2022-01-18,04:00:00,2,2,0,FMN GV 11 Ramsel
66,Bergstraat 71,2022-01-18,05:00:00,12,8,4,FMN GV 11 Ramsel
66,Bergstraat 71,2022-01-18,06:00:00,24,10,14,FMN GV 11 Ramsel
66,Bergstraat 71,2022-01-18,07:00:00,182,26,156,FMN GV 11 Ramsel
66,Bergstraat 71,2022-01-18,08:00:00,122,8,114,FMN GV 11 Ramsel
66,Bergstraat 71,2022-01-18,09:00:00,18,2,16,FMN GV 11 Ramsel
66,Bergstraat 71,2022-01-18,10:00:00,36,28,8,FMN GV 11 Ramsel
66,Bergstraat 71,2022-01-18,11:00:00,36,18,18,FMN GV 11 Ramsel
66,Bergstraat 71,2022-01-18,12:00:00,84,40,44,FMN GV 11 Ramsel
66,Bergstraat 71,2022-01-18,13:00:00,148,78,70,FMN GV 11 Ramsel
66,Bergstraat 71,2022-01-18,14:00:00,160,80,80,FMN GV 11 Ramsel
66,Bergstraat 71,2022-01-18,15:00:00,244,198,46,FMN GV 11 Ramsel
66,Bergstraat 71,2022-01-18,16:00:00,200,144,56,FMN GV 11 Ramsel
66,Bergstraat 71,2022-01-18,17:00:00,82,40,42,FMN GV 11 Ramsel
66,Bergstraat 71,2022-01-18,18:00:00,22,12,10,FMN GV 11 Ramsel
66,Bergstraat 71,2022-01-18,19:00:00,32,16,16,FMN GV 11 Ramsel
66,Bergstraat 71,2022-01-18,20:00:00,28,20,8,FMN GV 11 Ramsel
66,Bergstraat 71,2022-01-18,21:00:00,10,6,4,FMN GV 11 Ramsel
66,Bergstraat 71,2022-01-18,22:00:00,10,6,4,FMN GV 11 Ramsel
66,Bergstraat 71,2022-01-18,23:00:00,0,0,0,FMN GV 11 Ramsel
66,Bergstraat 71,2022-01-19,00:00:00,0,0,0,FMN GV 11 Ramsel
66,Bergstraat 71,2022-01-19,01:00:00,0,0,0,FMN GV 11 Ramsel
66,Bergstraat 71,2022-01-19,02:00:00,0,0,0,FMN GV 11 Ramsel
66,Bergstraat 71,2022-01-19,03:00:00,0,0,0,FMN GV 11 Ramsel
66,Bergstraat 71,2022-01-19,04:00:00,2,2,0,FMN GV 11 Ramsel
66,Bergstraat 71,2022-01-19,05:00:00,4,2,2,FMN GV 11 Ramsel
66,Bergstraat 71,2022-01-19,06:00:00,16,4,12,FMN GV 11 Ramsel
66,Bergstraat 71,2022-01-19,07:00:00,130,12,118,FMN GV 11 Ramsel
66,Bergstraat 71,2022-01-19,08:00:00,146,14,132,FMN GV 11 Ramsel
66,Bergstraat 71,2022-01-19,09:00:00,36,12,24,FMN GV 11 Ramsel
66,Bergstraat 71,2022-01-19,10:00:00,26,8,18,FMN GV 11 Ramsel
66,Bergstraat 71,2022-01-19,11:00:00,70,50,20,FMN GV 11 Ramsel
66,Bergstraat 71,2022-01-19,12:00:00,184,160,24,FMN GV 11 Ramsel
66,Bergstraat 71,2022-01-19,13:00:00,34,16,18,FMN GV 11 Ramsel
66,Bergstraat 71,2022-01-19,14:00:00,50,22,28,FMN GV 11 Ramsel
66,Bergstraat 71,2022-01-19,15:00:00,44,24,20,FMN GV 11 Ramsel
66,Bergstraat 71,2022-01-19,16:00:00,64,50,14,FMN GV 11 Ramsel
66,Bergstraat 71,2022-01-19,17:00:00,46,28,18,FMN GV 11 Ramsel
66,Bergstraat 71,2022-01-19,18:00:00,10,6,4,FMN GV 11 Ramsel
66,Bergstraat 71,2022-01-19,19:00:00,16,10,6,FMN GV 11 Ramsel
66,Bergstraat 71,2022-01-19,20:00:00,4,2,2,FMN GV 11 Ramsel
66,Bergstraat 71,2022-01-19,21:00:00,4,2,2,FMN GV 11 Ramsel
66,Bergstraat 71,2022-01-19,22:00:00,10,10,0,FMN GV 11 Ramsel
66,Bergstraat 71,2022-01-19,23:00:00,4,4,0,FMN GV 11 Ramsel
66,Bergstraat 71,2022-01-20,00:00:00,0,0,0,FMN GV 11 Ramsel
66,Bergstraat 71,2022-01-20,01:00:00,0,0,0,FMN GV 11 Ramsel
66,Bergstraat 71,2022-01-20,02:00:00,0,0,0,FMN GV 11 Ramsel
66,Bergstraat 71,2022-01-20,03:00:00,0,0,0,FMN GV 11 Ramsel
66,Bergstraat 71,2022-01-20,04:00:00,2,2,0,FMN GV 11 Ramsel
66,Bergstraat 71,2022-01-20,05:00:00,8,6,2,FMN GV 11 Ramsel
66,Bergstraat 71,2022-01-20,06:00:00,16,8,8,FMN GV 11 Ramsel
66,Bergstraat 71,2022-01-20,07:00:00,110,10,100,FMN GV 11 Ramsel
66,Bergstraat 71,2022-01-20,08:00:00,66,2,64,FMN GV 11 Ramsel
66,Bergstraat 71,2022-01-20,09:00:00,16,4,12,FMN GV 11 Ramsel
66,Bergstraat 71,2022-01-20,10:00:00,22,8,14,FMN GV 11 Ramsel
66,Bergstraat 71,2022-01-20,11:00:00,18,8,10,FMN GV 11 Ramsel
66,Bergstraat 71,2022-01-20,12:00:00,36,16,20,FMN GV 11 Ramsel
66,Bergstraat 71,2022-01-20,13:00:00,78,40,38,FMN GV 11 Ramsel
66,Bergstraat 71,2022-01-20,14:00:00,70,22,48,FMN GV 11 Ramsel
66,Bergstraat 71,2022-01-20,15:00:00,112,82,30,FMN GV 11 Ramsel
66,Bergstraat 71,2022-01-20,16:00:00,82,68,14,FMN GV 11 Ramsel
66,Bergstraat 71,2022-01-20,17:00:00,34,26,8,FMN GV 11 Ramsel
66,Bergstraat 71,2022-01-20,18:00:00,12,8,4,FMN GV 11 Ramsel
66,Bergstraat 71,2022-01-20,19:00:00,18,12,6,FMN GV 11 Ramsel
66,Bergstraat 71,2022-01-20,20:00:00,12,4,8,FMN GV 11 Ramsel
66,Bergstraat 71,2022-01-20,21:00:00,8,4,4,FMN GV 11 Ramsel
66,Bergstraat 71,2022-01-20,22:00:00,6,2,4,FMN GV 11 Ramsel
66,Bergstraat 71,2022-01-20,23:00:00,4,4,0,FMN GV 11 Ramsel
66,Bergstraat 71,2022-01-21,00:00:00,2,2,0,FMN GV 11 Ramsel
66,Bergstraat 71,2022-01-21,01:00:00,0,0,0,FMN GV 11 Ramsel
66,Bergstraat 71,2022-01-21,02:00:00,0,0,0,FMN GV 11 Ramsel
66,Bergstraat 71,2022-01-21,03:00:00,0,0,0,FMN GV 11 Ramsel
66,Bergstraat 71,2022-01-21,04:00:00,2,2,0,FMN GV 11 Ramsel
66,Bergstraat 71,2022-01-21,05:00:00,4,2,2,FMN GV 11 Ramsel
66,Bergstraat 71,2022-01-21,06:00:00,10,6,4,FMN GV 11 Ramsel
66,Bergstraat 71,2022-01-21,07:00:00,52,12,40,FMN GV 11 Ramsel
66,Bergstraat 71,2022-01-21,08:00:00,44,4,40,FMN GV 11 Ramsel
66,Bergstraat 71,2022-01-21,09:00:00,34,10,24,FMN GV 11 Ramsel
66,Bergstraat 71,2022-01-21,10:00:00,22,16,6,FMN GV 11 Ramsel
66,Bergstraat 71,2022-01-21,11:00:00,38,14,24,FMN GV 11 Ramsel
66,Bergstraat 71,2022-01-21,12:00:00,80,46,34,FMN GV 11 Ramsel
66,Bergstraat 71,2022-01-21,13:00:00,88,38,50,FMN GV 11 Ramsel
66,Bergstraat 71,2022-01-21,14:00:00,76,58,18,FMN GV 11 Ramsel
66,Bergstraat 71,2022-01-21,15:00:00,130,110,20,FMN GV 11 Ramsel
66,Bergstraat 71,2022-01-21,16:00:00,72,56,16,FMN GV 11 Ramsel
66,Bergstraat 71,2022-01-21,17:00:00,42,28,14,FMN GV 11 Ramsel
66,Bergstraat 71,2022-01-21,18:00:00,20,10,10,FMN GV 11 Ramsel
66,Bergstraat 71,2022-01-21,19:00:00,40,10,30,FMN GV 11 Ramsel
66,Bergstraat 71,2022-01-21,20:00:00,16,6,10,FMN GV 11 Ramsel
66,Bergstraat 71,2022-01-21,21:00:00,16,6,10,FMN GV 11 Ramsel
66,Bergstraat 71,2022-01-21,22:00:00,4,2,2,FMN GV 11 Ramsel
66,Bergstraat 71,2022-01-21,23:00:00,14,10,4,FMN GV 11 Ramsel
66,Bergstraat 71,2022-01-22,00:00:00,12,10,2,FMN GV 11 Ramsel
66,Bergstraat 71,2022-01-22,01:00:00,12,12,0,FMN GV 11 Ramsel
66,Bergstraat 71,2022-01-22,02:00:00,6,4,2,FMN GV 11 Ramsel
66,Bergstraat 71,2022-01-22,03:00:00,0,0,0,FMN GV 11 Ramsel
66,Bergstraat 71,2022-01-22,04:00:00,0,0,0,FMN GV 11 Ramsel
66,Bergstraat 71,2022-01-22,05:00:00,2,2,0,FMN GV 11 Ramsel
66,Bergstraat 71,2022-01-22,06:00:00,0,0,0,FMN GV 11 Ramsel
66,Bergstraat 71,2022-01-22,07:00:00,8,6,2,FMN GV 11 Ramsel
66,Bergstraat 71,2022-01-22,08:00:00,16,6,10,FMN GV 11 Ramsel
66,Bergstraat 71,2022-01-22,09:00:00,40,20,20,FMN GV 11 Ramsel
66,Bergstraat 71,2022-01-22,10:00:00,80,30,50,FMN GV 11 Ramsel
66,Bergstraat 71,2022-01-22,11:00:00,50,26,24,FMN GV 11 Ramsel
66,Bergstraat 71,2022-01-22,12:00:00,54,30,24,FMN GV 11 Ramsel
66,Bergstraat 71,2022-01-22,13:00:00,112,62,50,FMN GV 11 Ramsel
66,Bergstraat 71,2022-01-22,14:00:00,118,74,44,FMN GV 11 Ramsel
66,Bergstraat 71,2022-01-22,15:00:00,90,44,46,FMN GV 11 Ramsel
66,Bergstraat 71,2022-01-22,16:00:00,40,22,18,FMN GV 11 Ramsel
66,Bergstraat 71,2022-01-22,17:00:00,26,8,18,FMN GV 11 Ramsel
66,Bergstraat 71,2022-01-22,18:00:00,10,8,2,FMN GV 11 Ramsel
66,Bergstraat 71,2022-01-22,19:00:00,8,2,6,FMN GV 11 Ramsel
66,Bergstraat 71,2022-01-22,20:00:00,12,0,12,FMN GV 11 Ramsel
66,Bergstraat 71,2022-01-22,21:00:00,4,2,2,FMN GV 11 Ramsel
66,Bergstraat 71,2022-01-22,22:00:00,8,8,0,FMN GV 11 Ramsel
66,Bergstraat 71,2022-01-22,23:00:00,10,10,0,FMN GV 11 Ramsel
66,Bergstraat 71,2022-01-23,00:00:00,10,8,2,FMN GV 11 Ramsel
66,Bergstraat 71,2022-01-23,01:00:00,0,0,0,FMN GV 11 Ramsel
66,Bergstraat 71,2022-01-23,02:00:00,2,2,0,FMN GV 11 Ramsel
66,Bergstraat 71,2022-01-23,03:00:00,0,0,0,FMN GV 11 Ramsel
66,Bergstraat 71,2022-01-23,04:00:00,0,0,0,FMN GV 11 Ramsel
66,Bergstraat 71,2022-01-23,05:00:00,0,0,0,FMN GV 11 Ramsel
66,Bergstraat 71,2022-01-23,06:00:00,4,0,4,FMN GV 11 Ramsel
66,Bergstraat 71,2022-01-23,07:00:00,2,0,2,FMN GV 11 Ramsel
66,Bergstraat 71,2022-01-23,08:00:00,50,12,38,FMN GV 11 Ramsel
66,Bergstraat 71,2022-01-23,09:00:00,104,50,54,FMN GV 11 Ramsel
66,Bergstraat 71,2022-01-23,10:00:00,130,80,50,FMN GV 11 Ramsel
66,Bergstraat 71,2022-01-23,11:00:00,136,94,42,FMN GV 11 Ramsel
66,Bergstraat 71,2022-01-23,12:00:00,122,90,32,FMN GV 11 Ramsel
66,Bergstraat 71,2022-01-23,13:00:00,86,54,32,FMN GV 11 Ramsel
66,Bergstraat 71,2022-01-23,14:00:00,68,30,38,FMN GV 11 Ramsel
66,Bergstraat 71,2022-01-23,15:00:00,66,38,28,FMN GV 11 Ramsel
66,Bergstraat 71,2022-01-23,16:00:00,60,34,26,FMN GV 11 Ramsel
66,Bergstraat 71,2022-01-23,17:00:00,36,16,20,FMN GV 11 Ramsel
66,Bergstraat 71,2022-01-23,18:00:00,6,4,2,FMN GV 11 Ramsel
66,Bergstraat 71,2022-01-23,19:00:00,8,2,6,FMN GV 11 Ramsel
66,Bergstraat 71,2022-01-23,20:00:00,6,2,4,FMN GV 11 Ramsel
66,Bergstraat 71,2022-01-23,21:00:00,0,0,0,FMN GV 11 Ramsel
66,Bergstraat 71,2022-01-23,22:00:00,2,2,0,FMN GV 11 Ramsel
66,Bergstraat 71,2022-01-23,23:00:00,0,0,0,FMN GV 11 Ramsel
66,Bergstraat 71,2022-01-24,00:00:00,6,4,2,FMN GV 11 Ramsel
66,Bergstraat 71,2022-01-24,01:00:00,2,2,0,FMN GV 11 Ramsel
66,Bergstraat 71,2022-01-24,02:00:00,0,0,0,FMN GV 11 Ramsel
66,Bergstraat 71,2022-01-24,03:00:00,0,0,0,FMN GV 11 Ramsel
66,Bergstraat 71,2022-01-24,04:00:00,0,0,0,FMN GV 11 Ramsel
66,Bergstraat 71,2022-01-24,05:00:00,10,6,4,FMN GV 11 Ramsel
66,Bergstraat 71,2022-01-24,06:00:00,16,4,12,FMN GV 11 Ramsel
66,Bergstraat 71,2022-01-24,07:00:00,130,16,114,FMN GV 11 Ramsel
66,Bergstraat 71,2022-01-24,08:00:00,110,20,90,FMN GV 11 Ramsel
66,Bergstraat 71,2022-01-24,09:00:00,28,14,14,FMN GV 11 Ramsel
66,Bergstraat 71,2022-01-24,10:00:00,30,18,12,FMN GV 11 Ramsel
66,Bergstraat 71,2022-01-24,11:00:00,38,26,12,FMN GV 11 Ramsel
66,Bergstraat 71,2022-01-24,12:00:00,62,36,26,FMN GV 11 Ramsel
66,Bergstraat 71,2022-01-24,13:00:00,130,62,68,FMN GV 11 Ramsel
66,Bergstraat 71,2022-01-24,14:00:00,188,98,90,FMN GV 11 Ramsel
66,Bergstraat 71,2022-01-24,15:00:00,172,130,42,FMN GV 11 Ramsel
66,Bergstraat 71,2022-01-24,16:00:00,152,122,30,FMN GV 11 Ramsel
66,Bergstraat 71,2022-01-24,17:00:00,54,40,14,FMN GV 11 Ramsel
66,Bergstraat 71,2022-01-24,18:00:00,22,14,8,FMN GV 11 Ramsel
66,Bergstraat 71,2022-01-24,19:00:00,20,6,14,FMN GV 11 Ramsel
66,Bergstraat 71,2022-01-24,20:00:00,22,10,12,FMN GV 11 Ramsel
66,Bergstraat 71,2022-01-24,21:00:00,6,4,2,FMN GV 11 Ramsel
66,Bergstraat 71,2022-01-24,22:00:00,16,10,6,FMN GV 11 Ramsel
66,Bergstraat 71,2022-01-24,23:00:00,4,0,4,FMN GV 11 Ramsel
66,Bergstraat 71,2022-01-25,00:00:00,0,0,0,FMN GV 11 Ramsel
66,Bergstraat 71,2022-01-25,01:00:00,0,0,0,FMN GV 11 Ramsel
66,Bergstraat 71,2022-01-25,02:00:00,0,0,0,FMN GV 11 Ramsel
66,Bergstraat 71,2022-01-25,03:00:00,0,0,0,FMN GV 11 Ramsel
66,Bergstraat 71,2022-01-25,04:00:00,4,4,0,FMN GV 11 Ramsel
66,Bergstraat 71,2022-01-25,05:00:00,8,4,4,FMN GV 11 Ramsel
66,Bergstraat 71,2022-01-25,06:00:00,14,4,10,FMN GV 11 Ramsel
66,Bergstraat 71,2022-01-25,07:00:00,142,26,116,FMN GV 11 Ramsel
66,Bergstraat 71,2022-01-25,08:00:00,106,12,94,FMN GV 11 Ramsel
66,Bergstraat 71,2022-01-25,09:00:00,28,12,16,FMN GV 11 Ramsel
66,Bergstraat 71,2022-01-25,10:00:00,20,10,10,FMN GV 11 Ramsel
66,Bergstraat 71,2022-01-25,11:00:00,38,12,26,FMN GV 11 Ramsel
66,Bergstraat 71,2022-01-25,12:00:00,52,32,20,FMN GV 11 Ramsel
66,Bergstraat 71,2022-01-25,13:00:00,104,56,48,FMN GV 11 Ramsel
66,Bergstraat 71,2022-01-25,14:00:00,88,54,34,FMN GV 11 Ramsel
66,Bergstraat 71,2022-01-25,15:00:00,192,164,28,FMN GV 11 Ramsel
66,Bergstraat 71,2022-01-25,16:00:00,130,88,42,FMN GV 11 Ramsel
66,Bergstraat 71,2022-01-25,17:00:00,40,32,8,FMN GV 11 Ramsel
66,Bergstraat 71,2022-01-25,18:00:00,34,22,12,FMN GV 11 Ramsel
66,Bergstraat 71,2022-01-25,19:00:00,20,4,16,FMN GV 11 Ramsel
66,Bergstraat 71,2022-01-25,20:00:00,26,16,10,FMN GV 11 Ramsel
66,Bergstraat 71,2022-01-25,21:00:00,8,6,2,FMN GV 11 Ramsel
66,Bergstraat 71,2022-01-25,22:00:00,14,4,10,FMN GV 11 Ramsel
66,Bergstraat 71,2022-01-25,23:00:00,10,8,2,FMN GV 11 Ramsel
66,Bergstraat 71,2022-01-26,00:00:00,2,2,0,FMN GV 11 Ramsel
66,Bergstraat 71,2022-01-26,01:00:00,0,0,0,FMN GV 11 Ramsel
66,Bergstraat 71,2022-01-26,02:00:00,0,0,0,FMN GV 11 Ramsel
66,Bergstraat 71,2022-01-26,03:00:00,0,0,0,FMN GV 11 Ramsel
66,Bergstraat 71,2022-01-26,04:00:00,2,2,0,FMN GV 11 Ramsel
66,Bergstraat 71,2022-01-26,05:00:00,12,6,6,FMN GV 11 Ramsel
66,Bergstraat 71,2022-01-26,06:00:00,16,6,10,FMN GV 11 Ramsel
66,Bergstraat 71,2022-01-26,07:00:00,114,12,102,FMN GV 11 Ramsel
66,Bergstraat 71,2022-01-26,08:00:00,86,8,78,FMN GV 11 Ramsel
66,Bergstraat 71,2022-01-26,09:00:00,38,12,26,FMN GV 11 Ramsel
66,Bergstraat 71,2022-01-26,10:00:00,32,12,20,FMN GV 11 Ramsel
66,Bergstraat 71,2022-01-26,11:00:00,50,36,14,FMN GV 11 Ramsel
66,Bergstraat 71,2022-01-26,12:00:00,164,148,16,FMN GV 11 Ramsel
66,Bergstraat 71,2022-01-26,13:00:00,68,32,36,FMN GV 11 Ramsel
66,Bergstraat 71,2022-01-26,14:00:00,66,38,28,FMN GV 11 Ramsel
66,Bergstraat 71,2022-01-26,15:00:00,74,48,26,FMN GV 11 Ramsel
66,Bergstraat 71,2022-01-26,16:00:00,56,34,22,FMN GV 11 Ramsel
66,Bergstraat 71,2022-01-26,17:00:00,32,24,8,FMN GV 11 Ramsel
66,Bergstraat 71,2022-01-26,18:00:00,36,8,28,FMN GV 11 Ramsel
66,Bergstraat 71,2022-01-26,19:00:00,24,16,8,FMN GV 11 Ramsel
66,Bergstraat 71,2022-01-26,20:00:00,6,0,6,FMN GV 11 Ramsel
66,Bergstraat 71,2022-01-26,21:00:00,6,4,2,FMN GV 11 Ramsel
66,Bergstraat 71,2022-01-26,22:00:00,10,6,4,FMN GV 11 Ramsel
66,Bergstraat 71,2022-01-26,23:00:00,4,2,2,FMN GV 11 Ramsel
66,Bergstraat 71,2022-01-27,00:00:00,0,0,0,FMN GV 11 Ramsel
66,Bergstraat 71,2022-01-27,01:00:00,0,0,0,FMN GV 11 Ramsel
66,Bergstraat 71,2022-01-27,02:00:00,0,0,0,FMN GV 11 Ramsel
66,Bergstraat 71,2022-01-27,03:00:00,0,0,0,FMN GV 11 Ramsel
66,Bergstraat 71,2022-01-27,04:00:00,2,2,0,FMN GV 11 Ramsel
66,Bergstraat 71,2022-01-27,05:00:00,4,4,0,FMN GV 11 Ramsel
66,Bergstraat 71,2022-01-27,06:00:00,14,4,10,FMN GV 11 Ramsel
66,Bergstraat 71,2022-01-27,07:00:00,142,14,128,FMN GV 11 Ramsel
66,Bergstraat 71,2022-01-27,08:00:00,120,14,106,FMN GV 11 Ramsel
66,Bergstraat 71,2022-01-27,09:00:00,42,10,32,FMN GV 11 Ramsel
66,Bergstraat 71,2022-01-27,10:00:00,20,8,12,FMN GV 11 Ramsel
66,Bergstraat 71,2022-01-27,11:00:00,30,20,10,FMN GV 11 Ramsel
66,Bergstraat 71,2022-01-27,12:00:00,18,14,4,FMN GV 11 Ramsel
66,Bergstraat 71,2022-01-27,13:00:00,18,12,6,FMN GV 11 Ramsel
66,Bergstraat 71,2022-01-27,14:00:00,48,32,16,FMN GV 11 Ramsel
66,Bergstraat 71,2022-01-27,15:00:00,132,116,16,FMN GV 11 Ramsel
66,Bergstraat 71,2022-01-27,16:00:00,82,70,12,FMN GV 11 Ramsel
66,Bergstraat 71,2022-01-27,17:00:00,24,16,8,FMN GV 11 Ramsel
66,Bergstraat 71,2022-01-27,18:00:00,30,8,22,FMN GV 11 Ramsel
66,Bergstraat 71,2022-01-27,19:00:00,10,6,4,FMN GV 11 Ramsel
66,Bergstraat 71,2022-01-27,20:00:00,24,12,12,FMN GV 11 Ramsel
66,Bergstraat 71,2022-01-27,21:00:00,0,0,0,FMN GV 11 Ramsel
66,Bergstraat 71,2022-01-27,22:00:00,8,4,4,FMN GV 11 Ramsel
66,Bergstraat 71,2022-01-27,23:00:00,8,6,2,FMN GV 11 Ramsel
66,Bergstraat 71,2022-01-28,00:00:00,14,14,0,FMN GV 11 Ramsel
66,Bergstraat 71,2022-01-28,01:00:00,4,2,2,FMN GV 11 Ramsel
66,Bergstraat 71,2022-01-28,02:00:00,0,0,0,FMN GV 11 Ramsel
66,Bergstraat 71,2022-01-28,03:00:00,0,0,0,FMN GV 11 Ramsel
66,Bergstraat 71,2022-01-28,04:00:00,2,2,0,FMN GV 11 Ramsel
66,Bergstraat 71,2022-01-28,05:00:00,2,0,2,FMN GV 11 Ramsel
66,Bergstraat 71,2022-01-28,06:00:00,18,4,14,FMN GV 11 Ramsel
66,Bergstraat 71,2022-01-28,07:00:00,86,8,78,FMN GV 11 Ramsel
66,Bergstraat 71,2022-01-28,08:00:00,78,12,66,FMN GV 11 Ramsel
66,Bergstraat 71,2022-01-28,09:00:00,40,12,28,FMN GV 11 Ramsel
66,Bergstraat 71,2022-01-28,10:00:00,44,16,28,FMN GV 11 Ramsel
66,Bergstraat 71,2022-01-28,11:00:00,60,16,44,FMN GV 11 Ramsel
66,Bergstraat 71,2022-01-28,12:00:00,84,42,42,FMN GV 11 Ramsel
66,Bergstraat 71,2022-01-28,13:00:00,108,46,62,FMN GV 11 Ramsel
66,Bergstraat 71,2022-01-28,14:00:00,192,114,78,FMN GV 11 Ramsel
66,Bergstraat 71,2022-01-28,15:00:00,212,150,62,FMN GV 11 Ramsel
66,Bergstraat 71,2022-01-28,16:00:00,156,106,50,FMN GV 11 Ramsel
66,Bergstraat 71,2022-01-28,17:00:00,56,36,20,FMN GV 11 Ramsel
66,Bergstraat 71,2022-01-28,18:00:00,26,16,10,FMN GV 11 Ramsel
66,Bergstraat 71,2022-01-28,19:00:00,14,8,6,FMN GV 11 Ramsel
66,Bergstraat 71,2022-01-28,20:00:00,34,18,16,FMN GV 11 Ramsel
66,Bergstraat 71,2022-01-28,21:00:00,4,2,2,FMN GV 11 Ramsel
66,Bergstraat 71,2022-01-28,22:00:00,6,0,6,FMN GV 11 Ramsel
66,Bergstraat 71,2022-01-28,23:00:00,6,4,2,FMN GV 11 Ramsel
66,Bergstraat 71,2022-01-29,00:00:00,6,6,0,FMN GV 11 Ramsel
66,Bergstraat 71,2022-01-29,01:00:00,4,4,0,FMN GV 11 Ramsel
66,Bergstraat 71,2022-01-29,02:00:00,0,0,0,FMN GV 11 Ramsel
66,Bergstraat 71,2022-01-29,03:00:00,0,0,0,FMN GV 11 Ramsel
66,Bergstraat 71,2022-01-29,04:00:00,0,0,0,FMN GV 11 Ramsel
66,Bergstraat 71,2022-01-29,05:00:00,4,2,2,FMN GV 11 Ramsel
66,Bergstraat 71,2022-01-29,06:00:00,4,4,0,FMN GV 11 Ramsel
66,Bergstraat 71,2022-01-29,07:00:00,4,0,4,FMN GV 11 Ramsel
66,Bergstraat 71,2022-01-29,08:00:00,16,8,8,FMN GV 11 Ramsel
66,Bergstraat 71,2022-01-29,09:00:00,52,12,40,FMN GV 11 Ramsel
66,Bergstraat 71,2022-01-29,10:00:00,64,6,58,FMN GV 11 Ramsel
66,Bergstraat 71,2022-01-29,11:00:00,40,26,14,FMN GV 11 Ramsel
66,Bergstraat 71,2022-01-29,12:00:00,56,36,20,FMN GV 11 Ramsel
66,Bergstraat 71,2022-01-29,13:00:00,54,24,30,FMN GV 11 Ramsel
66,Bergstraat 71,2022-01-29,14:00:00,76,28,48,FMN GV 11 Ramsel
66,Bergstraat 71,2022-01-29,15:00:00,66,44,22,FMN GV 11 Ramsel
66,Bergstraat 71,2022-01-29,16:00:00,52,36,16,FMN GV 11 Ramsel
66,Bergstraat 71,2022-01-29,17:00:00,26,10,16,FMN GV 11 Ramsel
66,Bergstraat 71,2022-01-29,18:00:00,14,8,6,FMN GV 11 Ramsel
66,Bergstraat 71,2022-01-29,19:00:00,8,2,6,FMN GV 11 Ramsel
66,Bergstraat 71,2022-01-29,20:00:00,14,6,8,FMN GV 11 Ramsel
66,Bergstraat 71,2022-01-29,21:00:00,10,0,10,FMN GV 11 Ramsel
66,Bergstraat 71,2022-01-29,22:00:00,14,14,0,FMN GV 11 Ramsel
66,Bergstraat 71,2022-01-29,23:00:00,2,2,0,FMN GV 11 Ramsel
66,Bergstraat 71,2022-01-30,00:00:00,24,18,6,FMN GV 11 Ramsel
66,Bergstraat 71,2022-01-30,01:00:00,2,2,0,FMN GV 11 Ramsel
66,Bergstraat 71,2022-01-30,02:00:00,0,0,0,FMN GV 11 Ramsel
66,Bergstraat 71,2022-01-30,03:00:00,0,0,0,FMN GV 11 Ramsel
66,Bergstraat 71,2022-01-30,04:00:00,0,0,0,FMN GV 11 Ramsel
66,Bergstraat 71,2022-01-30,05:00:00,0,0,0,FMN GV 11 Ramsel
66,Bergstraat 71,2022-01-30,06:00:00,4,2,2,FMN GV 11 Ramsel
66,Bergstraat 71,2022-01-30,07:00:00,8,6,2,FMN GV 11 Ramsel
66,Bergstraat 71,2022-01-30,08:00:00,66,22,44,FMN GV 11 Ramsel
66,Bergstraat 71,2022-01-30,09:00:00,116,18,98,FMN GV 11 Ramsel
66,Bergstraat 71,2022-01-30,10:00:00,138,84,54,FMN GV 11 Ramsel
66,Bergstraat 71,2022-01-30,11:00:00,186,106,80,FMN GV 11 Ramsel
66,Bergstraat 71,2022-01-30,12:00:00,132,84,48,FMN GV 11 Ramsel
66,Bergstraat 71,2022-01-30,13:00:00,182,84,98,FMN GV 11 Ramsel
66,Bergstraat 71,2022-01-30,14:00:00,194,92,102,FMN GV 11 Ramsel
66,Bergstraat 71,2022-01-30,15:00:00,148,78,70,FMN GV 11 Ramsel
66,Bergstraat 71,2022-01-30,16:00:00,60,46,14,FMN GV 11 Ramsel
66,Bergstraat 71,2022-01-30,17:00:00,36,28,8,FMN GV 11 Ramsel
66,Bergstraat 71,2022-01-30,18:00:00,14,6,8,FMN GV 11 Ramsel
66,Bergstraat 71,2022-01-30,19:00:00,0,0,0,FMN GV 11 Ramsel
66,Bergstraat 71,2022-01-30,20:00:00,0,0,0,FMN GV 11 Ramsel
66,Bergstraat 71,2022-01-30,21:00:00,2,0,2,FMN GV 11 Ramsel
66,Bergstraat 71,2022-01-30,22:00:00,6,4,2,FMN GV 11 Ramsel
66,Bergstraat 71,2022-01-30,23:00:00,0,0,0,FMN GV 11 Ramsel
66,Bergstraat 71,2022-01-31,00:00:00,2,2,0,FMN GV 11 Ramsel
66,Bergstraat 71,2022-01-31,01:00:00,0,0,0,FMN GV 11 Ramsel
66,Bergstraat 71,2022-01-31,02:00:00,0,0,0,FMN GV 11 Ramsel
66,Bergstraat 71,2022-01-31,03:00:00,0,0,0,FMN GV 11 Ramsel
66,Bergstraat 71,2022-01-31,04:00:00,6,4,2,FMN GV 11 Ramsel
66,Bergstraat 71,2022-01-31,05:00:00,10,6,4,FMN GV 11 Ramsel
66,Bergstraat 71,2022-01-31,06:00:00,16,4,12,FMN GV 11 Ramsel
66,Bergstraat 71,2022-01-31,07:00:00,68,6,62,FMN GV 11 Ramsel
66,Bergstraat 71,2022-01-31,08:00:00,70,4,66,FMN GV 11 Ramsel
66,Bergstraat 71,2022-01-31,09:00:00,20,4,16,FMN GV 11 Ramsel
66,Bergstraat 71,2022-01-31,10:00:00,8,2,6,FMN GV 11 Ramsel
66,Bergstraat 71,2022-01-31,11:00:00,12,4,8,FMN GV 11 Ramsel
66,Bergstraat 71,2022-01-31,12:00:00,8,6,2,FMN GV 11 Ramsel
66,Bergstraat 71,2022-01-31,13:00:00,8,4,4,FMN GV 11 Ramsel
66,Bergstraat 71,2022-01-31,14:00:00,34,20,14,FMN GV 11 Ramsel
66,Bergstraat 71,2022-01-31,15:00:00,60,56,4,FMN GV 11 Ramsel
66,Bergstraat 71,2022-01-31,16:00:00,56,50,6,FMN GV 11 Ramsel
66,Bergstraat 71,2022-01-31,17:00:00,32,20,12,FMN GV 11 Ramsel
66,Bergstraat 71,2022-01-31,18:00:00,14,8,6,FMN GV 11 Ramsel
66,Bergstraat 71,2022-01-31,19:00:00,10,6,4,FMN GV 11 Ramsel
66,Bergstraat 71,2022-01-31,20:00:00,6,4,2,FMN GV 11 Ramsel
66,Bergstraat 71,2022-01-31,21:00:00,2,2,0,FMN GV 11 Ramsel
66,Bergstraat 71,2022-01-31,22:00:00,8,6,2,FMN GV 11 Ramsel
66,Bergstraat 71,2022-01-31,23:00:00,2,2,0,FMN GV 11 Ramsel
66,Bergstraat 71,2022-02-01,00:00:00,4,2,2,FMN GV 11 Ramsel
66,Bergstraat 71,2022-02-01,01:00:00,0,0,0,FMN GV 11 Ramsel
66,Bergstraat 71,2022-02-01,02:00:00,0,0,0,FMN GV 11 Ramsel
66,Bergstraat 71,2022-02-01,03:00:00,0,0,0,FMN GV 11 Ramsel
66,Bergstraat 71,2022-02-01,04:00:00,4,4,0,FMN GV 11 Ramsel
66,Bergstraat 71,2022-02-01,05:00:00,14,8,6,FMN GV 11 Ramsel
66,Bergstraat 71,2022-02-01,06:00:00,20,6,14,FMN GV 11 Ramsel
66,Bergstraat 71,2022-02-01,07:00:00,104,10,94,FMN GV 11 Ramsel
66,Bergstraat 71,2022-02-01,08:00:00,116,8,108,FMN GV 11 Ramsel
66,Bergstraat 71,2022-02-01,09:00:00,16,8,8,FMN GV 11 Ramsel
66,Bergstraat 71,2022-02-01,10:00:00,10,4,6,FMN GV 11 Ramsel
66,Bergstraat 71,2022-02-01,11:00:00,8,4,4,FMN GV 11 Ramsel
66,Bergstraat 71,2022-02-01,12:00:00,14,8,6,FMN GV 11 Ramsel
66,Bergstraat 71,2022-02-01,13:00:00,32,10,22,FMN GV 11 Ramsel
66,Bergstraat 71,2022-02-01,14:00:00,56,30,26,FMN GV 11 Ramsel
66,Bergstraat 71,2022-02-01,15:00:00,126,114,12,FMN GV 11 Ramsel
66,Bergstraat 71,2022-02-01,16:00:00,102,78,24,FMN GV 11 Ramsel
66,Bergstraat 71,2022-02-01,17:00:00,74,46,28,FMN GV 11 Ramsel
66,Bergstraat 71,2022-02-01,18:00:00,26,16,10,FMN GV 11 Ramsel
66,Bergstraat 71,2022-02-01,19:00:00,20,4,16,FMN GV 11 Ramsel
66,Bergstraat 71,2022-02-01,20:00:00,12,12,0,FMN GV 11 Ramsel
66,Bergstraat 71,2022-02-01,21:00:00,0,0,0,FMN GV 11 Ramsel
66,Bergstraat 71,2022-02-01,22:00:00,10,8,2,FMN GV 11 Ramsel
66,Bergstraat 71,2022-02-01,23:00:00,8,8,0,FMN GV 11 Ramsel
66,Bergstraat 71,2022-02-02,00:00:00,0,0,0,FMN GV 11 Ramsel
66,Bergstraat 71,2022-02-02,01:00:00,2,2,0,FMN GV 11 Ramsel
66,Bergstraat 71,2022-02-02,02:00:00,0,0,0,FMN GV 11 Ramsel
66,Bergstraat 71,2022-02-02,03:00:00,0,0,0,FMN GV 11 Ramsel
66,Bergstraat 71,2022-02-02,04:00:00,8,4,4,FMN GV 11 Ramsel
66,Bergstraat 71,2022-02-02,05:00:00,8,4,4,FMN GV 11 Ramsel
66,Bergstraat 71,2022-02-02,06:00:00,20,8,12,FMN GV 11 Ramsel
66,Bergstraat 71,2022-02-02,07:00:00,120,10,110,FMN GV 11 Ramsel
66,Bergstraat 71,2022-02-02,08:00:00,120,6,114,FMN GV 11 Ramsel
66,Bergstraat 71,2022-02-02,09:00:00,28,6,22,FMN GV 11 Ramsel
66,Bergstraat 71,2022-02-02,10:00:00,40,20,20,FMN GV 11 Ramsel
66,Bergstraat 71,2022-02-02,11:00:00,50,34,16,FMN GV 11 Ramsel
66,Bergstraat 71,2022-02-02,12:00:00,182,162,20,FMN GV 11 Ramsel
66,Bergstraat 71,2022-02-02,13:00:00,64,32,32,FMN GV 11 Ramsel
66,Bergstraat 71,2022-02-02,14:00:00,78,44,34,FMN GV 11 Ramsel
66,Bergstraat 71,2022-02-02,15:00:00,88,56,32,FMN GV 11 Ramsel
66,Bergstraat 71,2022-02-02,16:00:00,58,46,12,FMN GV 11 Ramsel
66,Bergstraat 71,2022-02-02,17:00:00,44,16,28,FMN GV 11 Ramsel
66,Bergstraat 71,2022-02-02,18:00:00,34,18,16,FMN GV 11 Ramsel
66,Bergstraat 71,2022-02-02,19:00:00,28,16,12,FMN GV 11 Ramsel
66,Bergstraat 71,2022-02-02,20:00:00,14,10,4,FMN GV 11 Ramsel
66,Bergstraat 71,2022-02-02,21:00:00,10,8,2,FMN GV 11 Ramsel
66,Bergstraat 71,2022-02-02,22:00:00,6,4,2,FMN GV 11 Ramsel
66,Bergstraat 71,2022-02-02,23:00:00,2,2,0,FMN GV 11 Ramsel
66,Bergstraat 71,2022-02-03,00:00:00,4,2,2,FMN GV 11 Ramsel
66,Bergstraat 71,2022-02-03,01:00:00,0,0,0,FMN GV 11 Ramsel
66,Bergstraat 71,2022-02-03,02:00:00,2,2,0,FMN GV 11 Ramsel
66,Bergstraat 71,2022-02-03,03:00:00,0,0,0,FMN GV 11 Ramsel
66,Bergstraat 71,2022-02-03,04:00:00,6,4,2,FMN GV 11 Ramsel
66,Bergstraat 71,2022-02-03,05:00:00,8,6,2,FMN GV 11 Ramsel
66,Bergstraat 71,2022-02-03,06:00:00,16,8,8,FMN GV 11 Ramsel
66,Bergstraat 71,2022-02-03,07:00:00,136,10,126,FMN GV 11 Ramsel
66,Bergstraat 71,2022-02-03,08:00:00,118,20,98,FMN GV 11 Ramsel
66,Bergstraat 71,2022-02-03,09:00:00,62,12,50,FMN GV 11 Ramsel
66,Bergstraat 71,2022-02-03,10:00:00,48,26,22,FMN GV 11 Ramsel
66,Bergstraat 71,2022-02-03,11:00:00,50,34,16,FMN GV 11 Ramsel
66,Bergstraat 71,2022-02-03,12:00:00,48,22,26,FMN GV 11 Ramsel
66,Bergstraat 71,2022-02-03,13:00:00,78,32,46,FMN GV 11 Ramsel
66,Bergstraat 71,2022-02-03,14:00:00,88,58,30,FMN GV 11 Ramsel
66,Bergstraat 71,2022-02-03,15:00:00,146,114,32,FMN GV 11 Ramsel
66,Bergstraat 71,2022-02-03,16:00:00,136,110,26,FMN GV 11 Ramsel
66,Bergstraat 71,2022-02-03,17:00:00,52,24,28,FMN GV 11 Ramsel
66,Bergstraat 71,2022-02-03,18:00:00,24,16,8,FMN GV 11 Ramsel
66,Bergstraat 71,2022-02-03,19:00:00,20,14,6,FMN GV 11 Ramsel
66,Bergstraat 71,2022-02-03,20:00:00,16,14,2,FMN GV 11 Ramsel
66,Bergstraat 71,2022-02-03,21:00:00,10,6,4,FMN GV 11 Ramsel
66,Bergstraat 71,2022-02-03,22:00:00,6,4,2,FMN GV 11 Ramsel
66,Bergstraat 71,2022-02-03,23:00:00,6,6,0,FMN GV 11 Ramsel
66,Bergstraat 71,2022-02-04,00:00:00,4,0,4,FMN GV 11 Ramsel
66,Bergstraat 71,2022-02-04,01:00:00,0,0,0,FMN GV 11 Ramsel
66,Bergstraat 71,2022-02-04,02:00:00,0,0,0,FMN GV 11 Ramsel
66,Bergstraat 71,2022-02-04,03:00:00,2,0,2,FMN GV 11 Ramsel
66,Bergstraat 71,2022-02-04,04:00:00,4,2,2,FMN GV 11 Ramsel
66,Bergstraat 71,2022-02-04,05:00:00,2,2,0,FMN GV 11 Ramsel
66,Bergstraat 71,2022-02-04,06:00:00,12,4,8,FMN GV 11 Ramsel
66,Bergstraat 71,2022-02-04,07:00:00,50,8,42,FMN GV 11 Ramsel
66,Bergstraat 71,2022-02-04,08:00:00,62,6,56,FMN GV 11 Ramsel
66,Bergstraat 71,2022-02-04,09:00:00,30,8,22,FMN GV 11 Ramsel
66,Bergstraat 71,2022-02-04,10:00:00,34,18,16,FMN GV 11 Ramsel
66,Bergstraat 71,2022-02-04,11:00:00,58,32,26,FMN GV 11 Ramsel
66,Bergstraat 71,2022-02-04,12:00:00,44,20,24,FMN GV 11 Ramsel
66,Bergstraat 71,2022-02-04,13:00:00,42,24,18,FMN GV 11 Ramsel
66,Bergstraat 71,2022-02-04,14:00:00,46,30,16,FMN GV 11 Ramsel
66,Bergstraat 71,2022-02-04,15:00:00,78,58,20,FMN GV 11 Ramsel
66,Bergstraat 71,2022-02-04,16:00:00,46,40,6,FMN GV 11 Ramsel
66,Bergstraat 71,2022-02-04,17:00:00,12,10,2,FMN GV 11 Ramsel
66,Bergstraat 71,2022-02-04,18:00:00,26,20,6,FMN GV 11 Ramsel
66,Bergstraat 71,2022-02-04,19:00:00,24,10,14,FMN GV 11 Ramsel
66,Bergstraat 71,2022-02-04,20:00:00,14,4,10,FMN GV 11 Ramsel
66,Bergstraat 71,2022-02-04,21:00:00,8,4,4,FMN GV 11 Ramsel
66,Bergstraat 71,2022-02-04,22:00:00,6,2,4,FMN GV 11 Ramsel
66,Bergstraat 71,2022-02-04,23:00:00,8,0,8,FMN GV 11 Ramsel
66,Bergstraat 71,2022-02-05,00:00:00,8,8,0,FMN GV 11 Ramsel
66,Bergstraat 71,2022-02-05,01:00:00,4,2,2,FMN GV 11 Ramsel
66,Bergstraat 71,2022-02-05,02:00:00,6,6,0,FMN GV 11 Ramsel
66,Bergstraat 71,2022-02-05,03:00:00,0,0,0,FMN GV 11 Ramsel
66,Bergstraat 71,2022-02-05,04:00:00,0,0,0,FMN GV 11 Ramsel
66,Bergstraat 71,2022-02-05,05:00:00,0,0,0,FMN GV 11 Ramsel
66,Bergstraat 71,2022-02-05,06:00:00,2,2,0,FMN GV 11 Ramsel
66,Bergstraat 71,2022-02-05,07:00:00,6,4,2,FMN GV 11 Ramsel
66,Bergstraat 71,2022-02-05,08:00:00,38,6,32,FMN GV 11 Ramsel
66,Bergstraat 71,2022-02-05,09:00:00,78,24,54,FMN GV 11 Ramsel
66,Bergstraat 71,2022-02-05,10:00:00,94,46,48,FMN GV 11 Ramsel
66,Bergstraat 71,2022-02-05,11:00:00,130,72,58,FMN GV 11 Ramsel
66,Bergstraat 71,2022-02-05,12:00:00,130,66,64,FMN GV 11 Ramsel
66,Bergstraat 71,2022-02-05,13:00:00,232,100,132,FMN GV 11 Ramsel
66,Bergstraat 71,2022-02-05,14:00:00,226,112,114,FMN GV 11 Ramsel
66,Bergstraat 71,2022-02-05,15:00:00,170,122,48,FMN GV 11 Ramsel
66,Bergstraat 71,2022-02-05,16:00:00,98,60,38,FMN GV 11 Ramsel
66,Bergstraat 71,2022-02-05,17:00:00,50,30,20,FMN GV 11 Ramsel
66,Bergstraat 71,2022-02-05,18:00:00,10,4,6,FMN GV 11 Ramsel
66,Bergstraat 71,2022-02-05,19:00:00,12,6,6,FMN GV 11 Ramsel
66,Bergstraat 71,2022-02-05,20:00:00,6,4,2,FMN GV 11 Ramsel
66,Bergstraat 71,2022-02-05,21:00:00,6,4,2,FMN GV 11 Ramsel
66,Bergstraat 71,2022-02-05,22:00:00,8,4,4,FMN GV 11 Ramsel
66,Bergstraat 71,2022-02-05,23:00:00,10,10,0,FMN GV 11 Ramsel
66,Bergstraat 71,2022-02-06,00:00:00,10,6,4,FMN GV 11 Ramsel
66,Bergstraat 71,2022-02-06,01:00:00,0,0,0,FMN GV 11 Ramsel
66,Bergstraat 71,2022-02-06,02:00:00,0,0,0,FMN GV 11 Ramsel
66,Bergstraat 71,2022-02-06,03:00:00,0,0,0,FMN GV 11 Ramsel
66,Bergstraat 71,2022-02-06,04:00:00,0,0,0,FMN GV 11 Ramsel
66,Bergstraat 71,2022-02-06,05:00:00,0,0,0,FMN GV 11 Ramsel
66,Bergstraat 71,2022-02-06,06:00:00,0,0,0,FMN GV 11 Ramsel
66,Bergstraat 71,2022-02-06,07:00:00,2,2,0,FMN GV 11 Ramsel
66,Bergstraat 71,2022-02-06,08:00:00,6,2,4,FMN GV 11 Ramsel
66,Bergstraat 71,2022-02-06,09:00:00,8,6,2,FMN GV 11 Ramsel
66,Bergstraat 71,2022-02-06,10:00:00,12,6,6,FMN GV 11 Ramsel
66,Bergstraat 71,2022-02-06,11:00:00,4,4,0,FMN GV 11 Ramsel
66,Bergstraat 71,2022-02-06,12:00:00,2,2,0,FMN GV 11 Ramsel
66,Bergstraat 71,2022-02-06,13:00:00,6,4,2,FMN GV 11 Ramsel
66,Bergstraat 71,2022-02-06,14:00:00,2,0,2,FMN GV 11 Ramsel
66,Bergstraat 71,2022-02-06,15:00:00,8,2,6,FMN GV 11 Ramsel
66,Bergstraat 71,2022-02-06,16:00:00,10,4,6,FMN GV 11 Ramsel
66,Bergstraat 71,2022-02-06,17:00:00,10,2,8,FMN GV 11 Ramsel
66,Bergstraat 71,2022-02-06,18:00:00,2,0,2,FMN GV 11 Ramsel
66,Bergstraat 71,2022-02-06,19:00:00,0,0,0,FMN GV 11 Ramsel
66,Bergstraat 71,2022-02-06,20:00:00,2,0,2,FMN GV 11 Ramsel
66,Bergstraat 71,2022-02-06,21:00:00,0,0,0,FMN GV 11 Ramsel
66,Bergstraat 71,2022-02-06,22:00:00,0,0,0,FMN GV 11 Ramsel
66,Bergstraat 71,2022-02-06,23:00:00,0,0,0,FMN GV 11 Ramsel
66,Bergstraat 71,2022-02-07,00:00:00,0,0,0,FMN GV 11 Ramsel
66,Bergstraat 71,2022-02-07,01:00:00,0,0,0,FMN GV 11 Ramsel
66,Bergstraat 71,2022-02-07,02:00:00,0,0,0,FMN GV 11 Ramsel
66,Bergstraat 71,2022-02-07,03:00:00,0,0,0,FMN GV 11 Ramsel
66,Bergstraat 71,2022-02-07,04:00:00,4,4,0,FMN GV 11 Ramsel
66,Bergstraat 71,2022-02-07,05:00:00,2,0,2,FMN GV 11 Ramsel
66,Bergstraat 71,2022-02-07,06:00:00,22,4,18,FMN GV 11 Ramsel
66,Bergstraat 71,2022-02-07,07:00:00,96,16,80,FMN GV 11 Ramsel
66,Bergstraat 71,2022-02-07,08:00:00,84,10,74,FMN GV 11 Ramsel
66,Bergstraat 71,2022-02-07,09:00:00,36,12,24,FMN GV 11 Ramsel
66,Bergstraat 71,2022-02-07,10:00:00,56,34,22,FMN GV 11 Ramsel
66,Bergstraat 71,2022-02-07,11:00:00,50,16,34,FMN GV 11 Ramsel
66,Bergstraat 71,2022-02-07,12:00:00,68,44,24,FMN GV 11 Ramsel
66,Bergstraat 71,2022-02-07,13:00:00,142,70,72,FMN GV 11 Ramsel
66,Bergstraat 71,2022-02-07,14:00:00,128,78,50,FMN GV 11 Ramsel
66,Bergstraat 71,2022-02-07,15:00:00,178,134,44,FMN GV 11 Ramsel
66,Bergstraat 71,2022-02-07,16:00:00,128,96,32,FMN GV 11 Ramsel
66,Bergstraat 71,2022-02-07,17:00:00,50,26,24,FMN GV 11 Ramsel
66,Bergstraat 71,2022-02-07,18:00:00,24,16,8,FMN GV 11 Ramsel
66,Bergstraat 71,2022-02-07,19:00:00,20,8,12,FMN GV 11 Ramsel
66,Bergstraat 71,2022-02-07,20:00:00,12,8,4,FMN GV 11 Ramsel
66,Bergstraat 71,2022-02-07,21:00:00,2,2,0,FMN GV 11 Ramsel
66,Bergstraat 71,2022-02-07,22:00:00,14,4,10,FMN GV 11 Ramsel
66,Bergstraat 71,2022-02-07,23:00:00,4,4,0,FMN GV 11 Ramsel
66,Bergstraat 71,2022-02-08,00:00:00,0,0,0,FMN GV 11 Ramsel
66,Bergstraat 71,2022-02-08,01:00:00,0,0,0,FMN GV 11 Ramsel
66,Bergstraat 71,2022-02-08,02:00:00,0,0,0,FMN GV 11 Ramsel
66,Bergstraat 71,2022-02-08,03:00:00,0,0,0,FMN GV 11 Ramsel
66,Bergstraat 71,2022-02-08,04:00:00,8,6,2,FMN GV 11 Ramsel
66,Bergstraat 71,2022-02-08,05:00:00,4,0,4,FMN GV 11 Ramsel
66,Bergstraat 71,2022-02-08,06:00:00,24,4,20,FMN GV 11 Ramsel
66,Bergstraat 71,2022-02-08,07:00:00,158,24,134,FMN GV 11 Ramsel
66,Bergstraat 71,2022-02-08,08:00:00,122,8,114,FMN GV 11 Ramsel
66,Bergstraat 71,2022-02-08,09:00:00,46,12,34,FMN GV 11 Ramsel
66,Bergstraat 71,2022-02-08,10:00:00,30,16,14,FMN GV 11 Ramsel
66,Bergstraat 71,2022-02-08,11:00:00,20,8,12,FMN GV 11 Ramsel
66,Bergstraat 71,2022-02-08,12:00:00,56,42,14,FMN GV 11 Ramsel
66,Bergstraat 71,2022-02-08,13:00:00,92,60,32,FMN GV 11 Ramsel
66,Bergstraat 71,2022-02-08,14:00:00,102,76,26,FMN GV 11 Ramsel
66,Bergstraat 71,2022-02-08,15:00:00,226,180,46,FMN GV 11 Ramsel
66,Bergstraat 71,2022-02-08,16:00:00,124,84,40,FMN GV 11 Ramsel
66,Bergstraat 71,2022-02-08,17:00:00,66,30,36,FMN GV 11 Ramsel
66,Bergstraat 71,2022-02-08,18:00:00,26,18,8,FMN GV 11 Ramsel
66,Bergstraat 71,2022-02-08,19:00:00,34,16,18,FMN GV 11 Ramsel
66,Bergstraat 71,2022-02-08,20:00:00,32,32,0,FMN GV 11 Ramsel
66,Bergstraat 71,2022-02-08,21:00:00,2,0,2,FMN GV 11 Ramsel
66,Bergstraat 71,2022-02-08,22:00:00,14,2,12,FMN GV 11 Ramsel
66,Bergstraat 71,2022-02-08,23:00:00,6,6,0,FMN GV 11 Ramsel
66,Bergstraat 71,2022-02-09,00:00:00,10,6,4,FMN GV 11 Ramsel
66,Bergstraat 71,2022-02-09,01:00:00,2,2,0,FMN GV 11 Ramsel
66,Bergstraat 71,2022-02-09,02:00:00,2,0,2,FMN GV 11 Ramsel
66,Bergstraat 71,2022-02-09,03:00:00,0,0,0,FMN GV 11 Ramsel
66,Bergstraat 71,2022-02-09,04:00:00,4,4,0,FMN GV 11 Ramsel
66,Bergstraat 71,2022-02-09,05:00:00,6,2,4,FMN GV 11 Ramsel
66,Bergstraat 71,2022-02-09,06:00:00,34,4,30,FMN GV 11 Ramsel
66,Bergstraat 71,2022-02-09,07:00:00,186,16,170,FMN GV 11 Ramsel
66,Bergstraat 71,2022-02-09,08:00:00,130,20,110,FMN GV 11 Ramsel
66,Bergstraat 71,2022-02-09,09:00:00,44,20,24,FMN GV 11 Ramsel
66,Bergstraat 71,2022-02-09,10:00:00,48,28,20,FMN GV 11 Ramsel
66,Bergstraat 71,2022-02-09,11:00:00,64,40,24,FMN GV 11 Ramsel
66,Bergstraat 71,2022-02-09,12:00:00,248,222,26,FMN GV 11 Ramsel
66,Bergstraat 71,2022-02-09,13:00:00,134,66,68,FMN GV 11 Ramsel
66,Bergstraat 71,2022-02-09,14:00:00,180,102,78,FMN GV 11 Ramsel
66,Bergstraat 71,2022-02-09,15:00:00,132,64,68,FMN GV 11 Ramsel
66,Bergstraat 71,2022-02-09,16:00:00,114,86,28,FMN GV 11 Ramsel
66,Bergstraat 71,2022-02-09,17:00:00,92,46,46,FMN GV 11 Ramsel
66,Bergstraat 71,2022-02-09,18:00:00,66,30,36,FMN GV 11 Ramsel
66,Bergstraat 71,2022-02-09,19:00:00,36,20,16,FMN GV 11 Ramsel
66,Bergstraat 71,2022-02-09,20:00:00,16,6,10,FMN GV 11 Ramsel
66,Bergstraat 71,2022-02-09,21:00:00,10,6,4,FMN GV 11 Ramsel
66,Bergstraat 71,2022-02-09,22:00:00,14,8,6,FMN GV 11 Ramsel
66,Bergstraat 71,2022-02-09,23:00:00,2,2,0,FMN GV 11 Ramsel
66,Bergstraat 71,2022-02-10,00:00:00,2,2,0,FMN GV 11 Ramsel
66,Bergstraat 71,2022-02-10,01:00:00,0,0,0,FMN GV 11 Ramsel
66,Bergstraat 71,2022-02-10,02:00:00,0,0,0,FMN GV 11 Ramsel
66,Bergstraat 71,2022-02-10,03:00:00,0,0,0,FMN GV 11 Ramsel
66,Bergstraat 71,2022-02-10,04:00:00,6,4,2,FMN GV 11 Ramsel
66,Bergstraat 71,2022-02-10,05:00:00,10,2,8,FMN GV 11 Ramsel
66,Bergstraat 71,2022-02-10,06:00:00,24,8,16,FMN GV 11 Ramsel
66,Bergstraat 71,2022-02-10,07:00:00,142,18,124,FMN GV 11 Ramsel
66,Bergstraat 71,2022-02-10,08:00:00,148,18,130,FMN GV 11 Ramsel
66,Bergstraat 71,2022-02-10,09:00:00,20,6,14,FMN GV 11 Ramsel
66,Bergstraat 71,2022-02-10,10:00:00,4,4,0,FMN GV 11 Ramsel
66,Bergstraat 71,2022-02-10,11:00:00,18,14,4,FMN GV 11 Ramsel
66,Bergstraat 71,2022-02-10,12:00:00,20,14,6,FMN GV 11 Ramsel
66,Bergstraat 71,2022-02-10,13:00:00,12,8,4,FMN GV 11 Ramsel
66,Bergstraat 71,2022-02-10,14:00:00,50,28,22,FMN GV 11 Ramsel
66,Bergstraat 71,2022-02-10,15:00:00,148,132,16,FMN GV 11 Ramsel
66,Bergstraat 71,2022-02-10,16:00:00,98,88,10,FMN GV 11 Ramsel
66,Bergstraat 71,2022-02-10,17:00:00,22,12,10,FMN GV 11 Ramsel
66,Bergstraat 71,2022-02-10,18:00:00,30,22,8,FMN GV 11 Ramsel
66,Bergstraat 71,2022-02-10,19:00:00,6,2,4,FMN GV 11 Ramsel
66,Bergstraat 71,2022-02-10,20:00:00,4,4,0,FMN GV 11 Ramsel
66,Bergstraat 71,2022-02-10,21:00:00,2,0,2,FMN GV 11 Ramsel
66,Bergstraat 71,2022-02-10,22:00:00,6,2,4,FMN GV 11 Ramsel
66,Bergstraat 71,2022-02-10,23:00:00,2,2,0,FMN GV 11 Ramsel
66,Bergstraat 71,2022-02-11,00:00:00,2,0,2,FMN GV 11 Ramsel
66,Bergstraat 71,2022-02-11,01:00:00,0,0,0,FMN GV 11 Ramsel
66,Bergstraat 71,2022-02-11,02:00:00,0,0,0,FMN GV 11 Ramsel
66,Bergstraat 71,2022-02-11,03:00:00,0,0,0,FMN GV 11 Ramsel
66,Bergstraat 71,2022-02-11,04:00:00,4,4,0,FMN GV 11 Ramsel
66,Bergstraat 71,2022-02-11,05:00:00,6,0,6,FMN GV 11 Ramsel
66,Bergstraat 71,2022-02-11,06:00:00,10,0,10,FMN GV 11 Ramsel
66,Bergstraat 71,2022-02-11,07:00:00,106,12,94,FMN GV 11 Ramsel
66,Bergstraat 71,2022-02-11,08:00:00,176,20,156,FMN GV 11 Ramsel
66,Bergstraat 71,2022-02-11,09:00:00,26,6,20,FMN GV 11 Ramsel
66,Bergstraat 71,2022-02-11,10:00:00,34,16,18,FMN GV 11 Ramsel
66,Bergstraat 71,2022-02-11,11:00:00,50,22,28,FMN GV 11 Ramsel
66,Bergstraat 71,2022-02-11,12:00:00,62,26,36,FMN GV 11 Ramsel
66,Bergstraat 71,2022-02-11,13:00:00,92,34,58,FMN GV 11 Ramsel
66,Bergstraat 71,2022-02-11,14:00:00,134,90,44,FMN GV 11 Ramsel
66,Bergstraat 71,2022-02-11,15:00:00,170,150,20,FMN GV 11 Ramsel
66,Bergstraat 71,2022-02-11,16:00:00,160,124,36,FMN GV 11 Ramsel
66,Bergstraat 71,2022-02-11,17:00:00,48,28,20,FMN GV 11 Ramsel
66,Bergstraat 71,2022-02-11,18:00:00,38,22,16,FMN GV 11 Ramsel
66,Bergstraat 71,2022-02-11,19:00:00,48,18,30,FMN GV 11 Ramsel
66,Bergstraat 71,2022-02-11,20:00:00,16,8,8,FMN GV 11 Ramsel
66,Bergstraat 71,2022-02-11,21:00:00,4,2,2,FMN GV 11 Ramsel
66,Bergstraat 71,2022-02-11,22:00:00,10,2,8,FMN GV 11 Ramsel
66,Bergstraat 71,2022-02-11,23:00:00,2,2,0,FMN GV 11 Ramsel
66,Bergstraat 71,2022-02-12,00:00:00,22,16,6,FMN GV 11 Ramsel
66,Bergstraat 71,2022-02-12,01:00:00,2,2,0,FMN GV 11 Ramsel
66,Bergstraat 71,2022-02-12,02:00:00,0,0,0,FMN GV 11 Ramsel
66,Bergstraat 71,2022-02-12,03:00:00,2,0,2,FMN GV 11 Ramsel
66,Bergstraat 71,2022-02-12,04:00:00,0,0,0,FMN GV 11 Ramsel
66,Bergstraat 71,2022-02-12,05:00:00,2,2,0,FMN GV 11 Ramsel
66,Bergstraat 71,2022-02-12,06:00:00,0,0,0,FMN GV 11 Ramsel
66,Bergstraat 71,2022-02-12,07:00:00,0,0,0,FMN GV 11 Ramsel
66,Bergstraat 71,2022-02-12,08:00:00,12,2,10,FMN GV 11 Ramsel
66,Bergstraat 71,2022-02-12,09:00:00,38,12,26,FMN GV 11 Ramsel
66,Bergstraat 71,2022-02-12,10:00:00,50,18,32,FMN GV 11 Ramsel
66,Bergstraat 71,2022-02-12,11:00:00,104,44,60,FMN GV 11 Ramsel
66,Bergstraat 71,2022-02-12,12:00:00,132,72,60,FMN GV 11 Ramsel
66,Bergstraat 71,2022-02-12,13:00:00,166,90,76,FMN GV 11 Ramsel
66,Bergstraat 71,2022-02-12,14:00:00,172,88,84,FMN GV 11 Ramsel
66,Bergstraat 71,2022-02-12,15:00:00,130,88,42,FMN GV 11 Ramsel
66,Bergstraat 71,2022-02-12,16:00:00,96,68,28,FMN GV 11 Ramsel
66,Bergstraat 71,2022-02-12,17:00:00,94,34,60,FMN GV 11 Ramsel
66,Bergstraat 71,2022-02-12,18:00:00,20,18,2,FMN GV 11 Ramsel
66,Bergstraat 71,2022-02-12,19:00:00,12,2,10,FMN GV 11 Ramsel
66,Bergstraat 71,2022-02-12,20:00:00,16,6,10,FMN GV 11 Ramsel
66,Bergstraat 71,2022-02-12,21:00:00,2,2,0,FMN GV 11 Ramsel
66,Bergstraat 71,2022-02-12,22:00:00,12,6,6,FMN GV 11 Ramsel
66,Bergstraat 71,2022-02-12,23:00:00,4,4,0,FMN GV 11 Ramsel
66,Bergstraat 71,2022-02-13,00:00:00,12,10,2,FMN GV 11 Ramsel
66,Bergstraat 71,2022-02-13,01:00:00,16,14,2,FMN GV 11 Ramsel
66,Bergstraat 71,2022-02-13,02:00:00,4,4,0,FMN GV 11 Ramsel
66,Bergstraat 71,2022-02-13,03:00:00,0,0,0,FMN GV 11 Ramsel
66,Bergstraat 71,2022-02-13,04:00:00,0,0,0,FMN GV 11 Ramsel
66,Bergstraat 71,2022-02-13,05:00:00,0,0,0,FMN GV 11 Ramsel
66,Bergstraat 71,2022-02-13,06:00:00,2,2,0,FMN GV 11 Ramsel
66,Bergstraat 71,2022-02-13,07:00:00,6,0,6,FMN GV 11 Ramsel
66,Bergstraat 71,2022-02-13,08:00:00,34,16,18,FMN GV 11 Ramsel
66,Bergstraat 71,2022-02-13,09:00:00,106,42,64,FMN GV 11 Ramsel
66,Bergstraat 71,2022-02-13,10:00:00,144,50,94,FMN GV 11 Ramsel
66,Bergstraat 71,2022-02-13,11:00:00,182,136,46,FMN GV 11 Ramsel
66,Bergstraat 71,2022-02-13,12:00:00,88,56,32,FMN GV 11 Ramsel
66,Bergstraat 71,2022-02-13,13:00:00,120,54,66,FMN GV 11 Ramsel
66,Bergstraat 71,2022-02-13,14:00:00,158,88,70,FMN GV 11 Ramsel
66,Bergstraat 71,2022-02-13,15:00:00,120,84,36,FMN GV 11 Ramsel
66,Bergstraat 71,2022-02-13,16:00:00,38,26,12,FMN GV 11 Ramsel
66,Bergstraat 71,2022-02-13,17:00:00,16,8,8,FMN GV 11 Ramsel
66,Bergstraat 71,2022-02-13,18:00:00,8,2,6,FMN GV 11 Ramsel
66,Bergstraat 71,2022-02-13,19:00:00,8,4,4,FMN GV 11 Ramsel
66,Bergstraat 71,2022-02-13,20:00:00,4,0,4,FMN GV 11 Ramsel
66,Bergstraat 71,2022-02-13,21:00:00,12,6,6,FMN GV 11 Ramsel
66,Bergstraat 71,2022-02-13,22:00:00,8,6,2,FMN GV 11 Ramsel
66,Bergstraat 71,2022-02-13,23:00:00,2,2,0,FMN GV 11 Ramsel
66,Bergstraat 71,2022-02-14,00:00:00,0,0,0,FMN GV 11 Ramsel
66,Bergstraat 71,2022-02-14,01:00:00,0,0,0,FMN GV 11 Ramsel
66,Bergstraat 71,2022-02-14,02:00:00,0,0,0,FMN GV 11 Ramsel
66,Bergstraat 71,2022-02-14,03:00:00,0,0,0,FMN GV 11 Ramsel
66,Bergstraat 71,2022-02-14,04:00:00,6,4,2,FMN GV 11 Ramsel
66,Bergstraat 71,2022-02-14,05:00:00,8,4,4,FMN GV 11 Ramsel
66,Bergstraat 71,2022-02-14,06:00:00,16,2,14,FMN GV 11 Ramsel
66,Bergstraat 71,2022-02-14,07:00:00,122,8,114,FMN GV 11 Ramsel
66,Bergstraat 71,2022-02-14,08:00:00,124,12,112,FMN GV 11 Ramsel
66,Bergstraat 71,2022-02-14,09:00:00,14,6,8,FMN GV 11 Ramsel
66,Bergstraat 71,2022-02-14,10:00:00,12,2,10,FMN GV 11 Ramsel
66,Bergstraat 71,2022-02-14,11:00:00,24,16,8,FMN GV 11 Ramsel
66,Bergstraat 71,2022-02-14,12:00:00,36,26,10,FMN GV 11 Ramsel
66,Bergstraat 71,2022-02-14,13:00:00,56,20,36,FMN GV 11 Ramsel
66,Bergstraat 71,2022-02-14,14:00:00,62,34,28,FMN GV 11 Ramsel
66,Bergstraat 71,2022-02-14,15:00:00,128,110,18,FMN GV 11 Ramsel
66,Bergstraat 71,2022-02-14,16:00:00,116,94,22,FMN GV 11 Ramsel
66,Bergstraat 71,2022-02-14,17:00:00,48,30,18,FMN GV 11 Ramsel
66,Bergstraat 71,2022-02-14,18:00:00,22,14,8,FMN GV 11 Ramsel
66,Bergstraat 71,2022-02-14,19:00:00,18,16,2,FMN GV 11 Ramsel
66,Bergstraat 71,2022-02-14,20:00:00,14,8,6,FMN GV 11 Ramsel
66,Bergstraat 71,2022-02-14,21:00:00,4,2,2,FMN GV 11 Ramsel
66,Bergstraat 71,2022-02-14,22:00:00,4,4,0,FMN GV 11 Ramsel
66,Bergstraat 71,2022-02-14,23:00:00,2,2,0,FMN GV 11 Ramsel
66,Bergstraat 71,2022-02-15,00:00:00,0,0,0,FMN GV 11 Ramsel
66,Bergstraat 71,2022-02-15,01:00:00,4,0,4,FMN GV 11 Ramsel
66,Bergstraat 71,2022-02-15,02:00:00,0,0,0,FMN GV 11 Ramsel
66,Bergstraat 71,2022-02-15,03:00:00,0,0,0,FMN GV 11 Ramsel
66,Bergstraat 71,2022-02-15,04:00:00,4,4,0,FMN GV 11 Ramsel
66,Bergstraat 71,2022-02-15,05:00:00,10,6,4,FMN GV 11 Ramsel
66,Bergstraat 71,2022-02-15,06:00:00,12,2,10,FMN GV 11 Ramsel
66,Bergstraat 71,2022-02-15,07:00:00,106,16,90,FMN GV 11 Ramsel
66,Bergstraat 71,2022-02-15,08:00:00,156,16,140,FMN GV 11 Ramsel
66,Bergstraat 71,2022-02-15,09:00:00,36,12,24,FMN GV 11 Ramsel
66,Bergstraat 71,2022-02-15,10:00:00,56,16,40,FMN GV 11 Ramsel
66,Bergstraat 71,2022-02-15,11:00:00,50,28,22,FMN GV 11 Ramsel
66,Bergstraat 71,2022-02-15,12:00:00,76,54,22,FMN GV 11 Ramsel
66,Bergstraat 71,2022-02-15,13:00:00,134,50,84,FMN GV 11 Ramsel
66,Bergstraat 71,2022-02-15,14:00:00,106,64,42,FMN GV 11 Ramsel
66,Bergstraat 71,2022-02-15,15:00:00,176,150,26,FMN GV 11 Ramsel
66,Bergstraat 71,2022-02-15,16:00:00,114,88,26,FMN GV 11 Ramsel
66,Bergstraat 71,2022-02-15,17:00:00,54,32,22,FMN GV 11 Ramsel
66,Bergstraat 71,2022-02-15,18:00:00,22,10,12,FMN GV 11 Ramsel
66,Bergstraat 71,2022-02-15,19:00:00,12,6,6,FMN GV 11 Ramsel
66,Bergstraat 71,2022-02-15,20:00:00,8,4,4,FMN GV 11 Ramsel
66,Bergstraat 71,2022-02-15,21:00:00,0,0,0,FMN GV 11 Ramsel
66,Bergstraat 71,2022-02-15,22:00:00,10,6,4,FMN GV 11 Ramsel
66,Bergstraat 71,2022-02-15,23:00:00,4,4,0,FMN GV 11 Ramsel
66,Bergstraat 71,2022-02-16,00:00:00,0,0,0,FMN GV 11 Ramsel
66,Bergstraat 71,2022-02-16,01:00:00,0,0,0,FMN GV 11 Ramsel
66,Bergstraat 71,2022-02-16,02:00:00,0,0,0,FMN GV 11 Ramsel
66,Bergstraat 71,2022-02-16,03:00:00,0,0,0,FMN GV 11 Ramsel
66,Bergstraat 71,2022-02-16,04:00:00,4,4,0,FMN GV 11 Ramsel
66,Bergstraat 71,2022-02-16,05:00:00,8,4,4,FMN GV 11 Ramsel
66,Bergstraat 71,2022-02-16,06:00:00,20,4,16,FMN GV 11 Ramsel
66,Bergstraat 71,2022-02-16,07:00:00,86,4,82,FMN GV 11 Ramsel
66,Bergstraat 71,2022-02-16,08:00:00,90,8,82,FMN GV 11 Ramsel
66,Bergstraat 71,2022-02-16,09:00:00,12,2,10,FMN GV 11 Ramsel
66,Bergstraat 71,2022-02-16,10:00:00,24,20,4,FMN GV 11 Ramsel
66,Bergstraat 71,2022-02-16,11:00:00,16,14,2,FMN GV 11 Ramsel
66,Bergstraat 71,2022-02-16,12:00:00,132,124,8,FMN GV 11 Ramsel
66,Bergstraat 71,2022-02-16,13:00:00,38,22,16,FMN GV 11 Ramsel
66,Bergstraat 71,2022-02-16,14:00:00,50,30,20,FMN GV 11 Ramsel
66,Bergstraat 71,2022-02-16,15:00:00,40,18,22,FMN GV 11 Ramsel
66,Bergstraat 71,2022-02-16,16:00:00,30,22,8,FMN GV 11 Ramsel
66,Bergstraat 71,2022-02-16,17:00:00,34,16,18,FMN GV 11 Ramsel
66,Bergstraat 71,2022-02-16,18:00:00,16,6,10,FMN GV 11 Ramsel
66,Bergstraat 71,2022-02-16,19:00:00,12,6,6,FMN GV 11 Ramsel
66,Bergstraat 71,2022-02-16,20:00:00,10,8,2,FMN GV 11 Ramsel
66,Bergstraat 71,2022-02-16,21:00:00,4,0,4,FMN GV 11 Ramsel
66,Bergstraat 71,2022-02-16,22:00:00,2,2,0,FMN GV 11 Ramsel
66,Bergstraat 71,2022-02-16,23:00:00,4,4,0,FMN GV 11 Ramsel
66,Bergstraat 71,2022-02-17,00:00:00,0,0,0,FMN GV 11 Ramsel
66,Bergstraat 71,2022-02-17,01:00:00,0,0,0,FMN GV 11 Ramsel
66,Bergstraat 71,2022-02-17,02:00:00,0,0,0,FMN GV 11 Ramsel
66,Bergstraat 71,2022-02-17,03:00:00,0,0,0,FMN GV 11 Ramsel
66,Bergstraat 71,2022-02-17,04:00:00,4,4,0,FMN GV 11 Ramsel
66,Bergstraat 71,2022-02-17,05:00:00,8,6,2,FMN GV 11 Ramsel
66,Bergstraat 71,2022-02-17,06:00:00,18,2,16,FMN GV 11 Ramsel
66,Bergstraat 71,2022-02-17,07:00:00,114,10,104,FMN GV 11 Ramsel
66,Bergstraat 71,2022-02-17,08:00:00,104,8,96,FMN GV 11 Ramsel
66,Bergstraat 71,2022-02-17,09:00:00,38,10,28,FMN GV 11 Ramsel
66,Bergstraat 71,2022-02-17,10:00:00,32,24,8,FMN GV 11 Ramsel
66,Bergstraat 71,2022-02-17,11:00:00,54,36,18,FMN GV 11 Ramsel
66,Bergstraat 71,2022-02-17,12:00:00,22,18,4,FMN GV 11 Ramsel
66,Bergstraat 71,2022-02-17,13:00:00,38,12,26,FMN GV 11 Ramsel
66,Bergstraat 71,2022-02-17,14:00:00,62,38,24,FMN GV 11 Ramsel
66,Bergstraat 71,2022-02-17,15:00:00,172,140,32,FMN GV 11 Ramsel
66,Bergstraat 71,2022-02-17,16:00:00,100,74,26,FMN GV 11 Ramsel
66,Bergstraat 71,2022-02-17,17:00:00,38,24,14,FMN GV 11 Ramsel
66,Bergstraat 71,2022-02-17,18:00:00,20,12,8,FMN GV 11 Ramsel
66,Bergstraat 71,2022-02-17,19:00:00,18,10,8,FMN GV 11 Ramsel
66,Bergstraat 71,2022-02-17,20:00:00,8,4,4,FMN GV 11 Ramsel
66,Bergstraat 71,2022-02-17,21:00:00,6,2,4,FMN GV 11 Ramsel
66,Bergstraat 71,2022-02-17,22:00:00,10,8,2,FMN GV 11 Ramsel
66,Bergstraat 71,2022-02-17,23:00:00,4,4,0,FMN GV 11 Ramsel
66,Bergstraat 71,2022-02-18,00:00:00,0,0,0,FMN GV 11 Ramsel
66,Bergstraat 71,2022-02-18,01:00:00,0,0,0,FMN GV 11 Ramsel
66,Bergstraat 71,2022-02-18,02:00:00,0,0,0,FMN GV 11 Ramsel
66,Bergstraat 71,2022-02-18,03:00:00,0,0,0,FMN GV 11 Ramsel
66,Bergstraat 71,2022-02-18,04:00:00,6,6,0,FMN GV 11 Ramsel
66,Bergstraat 71,2022-02-18,05:00:00,8,6,2,FMN GV 11 Ramsel
66,Bergstraat 71,2022-02-18,06:00:00,8,0,8,FMN GV 11 Ramsel
66,Bergstraat 71,2022-02-18,07:00:00,50,8,42,FMN GV 11 Ramsel
66,Bergstraat 71,2022-02-18,08:00:00,80,10,70,FMN GV 11 Ramsel
66,Bergstraat 71,2022-02-18,09:00:00,18,6,12,FMN GV 11 Ramsel
66,Bergstraat 71,2022-02-18,10:00:00,18,12,6,FMN GV 11 Ramsel
66,Bergstraat 71,2022-02-18,11:00:00,16,8,8,FMN GV 11 Ramsel
66,Bergstraat 71,2022-02-18,12:00:00,50,38,12,FMN GV 11 Ramsel
66,Bergstraat 71,2022-02-18,13:00:00,18,8,10,FMN GV 11 Ramsel
66,Bergstraat 71,2022-02-18,14:00:00,14,12,2,FMN GV 11 Ramsel
66,Bergstraat 71,2022-02-18,15:00:00,20,16,4,FMN GV 11 Ramsel
66,Bergstraat 71,2022-02-18,16:00:00,14,14,0,FMN GV 11 Ramsel
66,Bergstraat 71,2022-02-18,17:00:00,6,4,2,FMN GV 11 Ramsel
66,Bergstraat 71,2022-02-18,18:00:00,8,8,0,FMN GV 11 Ramsel
66,Bergstraat 71,2022-02-18,19:00:00,4,2,2,FMN GV 11 Ramsel
66,Bergstraat 71,2022-02-18,20:00:00,0,0,0,FMN GV 11 Ramsel
66,Bergstraat 71,2022-02-18,21:00:00,2,0,2,FMN GV 11 Ramsel
66,Bergstraat 71,2022-02-18,22:00:00,2,0,2,FMN GV 11 Ramsel
66,Bergstraat 71,2022-02-18,23:00:00,0,0,0,FMN GV 11 Ramsel
66,Bergstraat 71,2022-02-19,00:00:00,2,0,2,FMN GV 11 Ramsel
66,Bergstraat 71,2022-02-19,01:00:00,0,0,0,FMN GV 11 Ramsel
66,Bergstraat 71,2022-02-19,02:00:00,2,2,0,FMN GV 11 Ramsel
66,Bergstraat 71,2022-02-19,03:00:00,0,0,0,FMN GV 11 Ramsel
66,Bergstraat 71,2022-02-19,04:00:00,0,0,0,FMN GV 11 Ramsel
66,Bergstraat 71,2022-02-19,05:00:00,4,4,0,FMN GV 11 Ramsel
66,Bergstraat 71,2022-02-19,06:00:00,2,2,0,FMN GV 11 Ramsel
66,Bergstraat 71,2022-02-19,07:00:00,4,0,4,FMN GV 11 Ramsel
66,Bergstraat 71,2022-02-19,08:00:00,20,8,12,FMN GV 11 Ramsel
66,Bergstraat 71,2022-02-19,09:00:00,50,10,40,FMN GV 11 Ramsel
66,Bergstraat 71,2022-02-19,10:00:00,38,16,22,FMN GV 11 Ramsel
66,Bergstraat 71,2022-02-19,11:00:00,60,28,32,FMN GV 11 Ramsel
66,Bergstraat 71,2022-02-19,12:00:00,60,42,18,FMN GV 11 Ramsel
66,Bergstraat 71,2022-02-19,13:00:00,96,62,34,FMN GV 11 Ramsel
66,Bergstraat 71,2022-02-19,14:00:00,88,28,60,FMN GV 11 Ramsel
66,Bergstraat 71,2022-02-19,15:00:00,40,32,8,FMN GV 11 Ramsel
66,Bergstraat 71,2022-02-19,16:00:00,54,48,6,FMN GV 11 Ramsel
66,Bergstraat 71,2022-02-19,17:00:00,24,12,12,FMN GV 11 Ramsel
66,Bergstraat 71,2022-02-19,18:00:00,6,2,4,FMN GV 11 Ramsel
66,Bergstraat 71,2022-02-19,19:00:00,4,4,0,FMN GV 11 Ramsel
66,Bergstraat 71,2022-02-19,20:00:00,4,2,2,FMN GV 11 Ramsel
66,Bergstraat 71,2022-02-19,21:00:00,0,0,0,FMN GV 11 Ramsel
66,Bergstraat 71,2022-02-19,22:00:00,6,6,0,FMN GV 11 Ramsel
66,Bergstraat 71,2022-02-19,23:00:00,22,0,22,FMN GV 11 Ramsel
66,Bergstraat 71,2022-02-20,00:00:00,0,0,0,FMN GV 11 Ramsel
66,Bergstraat 71,2022-02-20,01:00:00,2,2,0,FMN GV 11 Ramsel
66,Bergstraat 71,2022-02-20,02:00:00,2,2,0,FMN GV 11 Ramsel
66,Bergstraat 71,2022-02-20,03:00:00,8,8,0,FMN GV 11 Ramsel
66,Bergstraat 71,2022-02-20,04:00:00,0,0,0,FMN GV 11 Ramsel
66,Bergstraat 71,2022-02-20,05:00:00,0,0,0,FMN GV 11 Ramsel
66,Bergstraat 71,2022-02-20,06:00:00,4,0,4,FMN GV 11 Ramsel
66,Bergstraat 71,2022-02-20,07:00:00,6,0,6,FMN GV 11 Ramsel
66,Bergstraat 71,2022-02-20,08:00:00,2,0,2,FMN GV 11 Ramsel
66,Bergstraat 71,2022-02-20,09:00:00,40,22,18,FMN GV 11 Ramsel
66,Bergstraat 71,2022-02-20,10:00:00,24,10,14,FMN GV 11 Ramsel
66,Bergstraat 71,2022-02-20,11:00:00,24,18,6,FMN GV 11 Ramsel
66,Bergstraat 71,2022-02-20,12:00:00,8,6,2,FMN GV 11 Ramsel
66,Bergstraat 71,2022-02-20,13:00:00,6,4,2,FMN GV 11 Ramsel
66,Bergstraat 71,2022-02-20,14:00:00,4,2,2,FMN GV 11 Ramsel
66,Bergstraat 71,2022-02-20,15:00:00,8,4,4,FMN GV 11 Ramsel
66,Bergstraat 71,2022-02-20,16:00:00,4,4,0,FMN GV 11 Ramsel
66,Bergstraat 71,2022-02-20,17:00:00,10,2,8,FMN GV 11 Ramsel
66,Bergstraat 71,2022-02-20,18:00:00,8,6,2,FMN GV 11 Ramsel
66,Bergstraat 71,2022-02-20,19:00:00,4,2,2,FMN GV 11 Ramsel
66,Bergstraat 71,2022-02-20,20:00:00,2,2,0,FMN GV 11 Ramsel
66,Bergstraat 71,2022-02-20,21:00:00,0,0,0,FMN GV 11 Ramsel
66,Bergstraat 71,2022-02-20,22:00:00,0,0,0,FMN GV 11 Ramsel
66,Bergstraat 71,2022-02-20,23:00:00,2,2,0,FMN GV 11 Ramsel
66,Bergstraat 71,2022-02-21,00:00:00,0,0,0,FMN GV 11 Ramsel
66,Bergstraat 71,2022-02-21,01:00:00,0,0,0,FMN GV 11 Ramsel
66,Bergstraat 71,2022-02-21,02:00:00,0,0,0,FMN GV 11 Ramsel
66,Bergstraat 71,2022-02-21,03:00:00,0,0,0,FMN GV 11 Ramsel
66,Bergstraat 71,2022-02-21,04:00:00,2,2,0,FMN GV 11 Ramsel
66,Bergstraat 71,2022-02-21,05:00:00,6,2,4,FMN GV 11 Ramsel
66,Bergstraat 71,2022-02-21,06:00:00,8,2,6,FMN GV 11 Ramsel
66,Bergstraat 71,2022-02-21,07:00:00,60,2,58,FMN GV 11 Ramsel
66,Bergstraat 71,2022-02-21,08:00:00,76,10,66,FMN GV 11 Ramsel
66,Bergstraat 71,2022-02-21,09:00:00,22,12,10,FMN GV 11 Ramsel
66,Bergstraat 71,2022-02-21,10:00:00,10,6,4,FMN GV 11 Ramsel
66,Bergstraat 71,2022-02-21,11:00:00,6,2,4,FMN GV 11 Ramsel
66,Bergstraat 71,2022-02-21,12:00:00,10,8,2,FMN GV 11 Ramsel
66,Bergstraat 71,2022-02-21,13:00:00,8,4,4,FMN GV 11 Ramsel
66,Bergstraat 71,2022-02-21,14:00:00,14,10,4,FMN GV 11 Ramsel
66,Bergstraat 71,2022-02-21,15:00:00,90,88,2,FMN GV 11 Ramsel
66,Bergstraat 71,2022-02-21,16:00:00,52,50,2,FMN GV 11 Ramsel
66,Bergstraat 71,2022-02-21,17:00:00,16,10,6,FMN GV 11 Ramsel
66,Bergstraat 71,2022-02-21,18:00:00,16,8,8,FMN GV 11 Ramsel
66,Bergstraat 71,2022-02-21,19:00:00,22,14,8,FMN GV 11 Ramsel
66,Bergstraat 71,2022-02-21,20:00:00,8,2,6,FMN GV 11 Ramsel
66,Bergstraat 71,2022-02-21,21:00:00,2,2,0,FMN GV 11 Ramsel
66,Bergstraat 71,2022-02-21,22:00:00,2,0,2,FMN GV 11 Ramsel
66,Bergstraat 71,2022-02-21,23:00:00,6,4,2,FMN GV 11 Ramsel
66,Bergstraat 71,2022-02-22,00:00:00,0,0,0,FMN GV 11 Ramsel
66,Bergstraat 71,2022-02-22,01:00:00,0,0,0,FMN GV 11 Ramsel
66,Bergstraat 71,2022-02-22,02:00:00,0,0,0,FMN GV 11 Ramsel
66,Bergstraat 71,2022-02-22,03:00:00,0,0,0,FMN GV 11 Ramsel
66,Bergstraat 71,2022-02-22,04:00:00,6,2,4,FMN GV 11 Ramsel
66,Bergstraat 71,2022-02-22,05:00:00,8,2,6,FMN GV 11 Ramsel
66,Bergstraat 71,2022-02-22,06:00:00,22,4,18,FMN GV 11 Ramsel
66,Bergstraat 71,2022-02-22,07:00:00,118,10,108,FMN GV 11 Ramsel
66,Bergstraat 71,2022-02-22,08:00:00,150,16,134,FMN GV 11 Ramsel
66,Bergstraat 71,2022-02-22,09:00:00,36,8,28,FMN GV 11 Ramsel
66,Bergstraat 71,2022-02-22,10:00:00,32,22,10,FMN GV 11 Ramsel
66,Bergstraat 71,2022-02-22,11:00:00,32,22,10,FMN GV 11 Ramsel
66,Bergstraat 71,2022-02-22,12:00:00,26,16,10,FMN GV 11 Ramsel
66,Bergstraat 71,2022-02-22,13:00:00,30,18,12,FMN GV 11 Ramsel
66,Bergstraat 71,2022-02-22,14:00:00,42,28,14,FMN GV 11 Ramsel
66,Bergstraat 71,2022-02-22,15:00:00,188,158,30,FMN GV 11 Ramsel
66,Bergstraat 71,2022-02-22,16:00:00,86,78,8,FMN GV 11 Ramsel
66,Bergstraat 71,2022-02-22,17:00:00,26,20,6,FMN GV 11 Ramsel
66,Bergstraat 71,2022-02-22,18:00:00,20,10,10,FMN GV 11 Ramsel
66,Bergstraat 71,2022-02-22,19:00:00,22,6,16,FMN GV 11 Ramsel
66,Bergstraat 71,2022-02-22,20:00:00,14,14,0,FMN GV 11 Ramsel
66,Bergstraat 71,2022-02-22,21:00:00,2,2,0,FMN GV 11 Ramsel
66,Bergstraat 71,2022-02-22,22:00:00,10,2,8,FMN GV 11 Ramsel
66,Bergstraat 71,2022-02-22,23:00:00,2,2,0,FMN GV 11 Ramsel
66,Bergstraat 71,2022-02-23,00:00:00,0,0,0,FMN GV 11 Ramsel
66,Bergstraat 71,2022-02-23,01:00:00,2,2,0,FMN GV 11 Ramsel
66,Bergstraat 71,2022-02-23,02:00:00,0,0,0,FMN GV 11 Ramsel
66,Bergstraat 71,2022-02-23,03:00:00,0,0,0,FMN GV 11 Ramsel
66,Bergstraat 71,2022-02-23,04:00:00,2,2,0,FMN GV 11 Ramsel
66,Bergstraat 71,2022-02-23,05:00:00,6,4,2,FMN GV 11 Ramsel
66,Bergstraat 71,2022-02-23,06:00:00,22,4,18,FMN GV 11 Ramsel
66,Bergstraat 71,2022-02-23,07:00:00,136,26,110,FMN GV 11 Ramsel
66,Bergstraat 71,2022-02-23,08:00:00,134,16,118,FMN GV 11 Ramsel
66,Bergstraat 71,2022-02-23,09:00:00,36,12,24,FMN GV 11 Ramsel
66,Bergstraat 71,2022-02-23,10:00:00,70,36,34,FMN GV 11 Ramsel
66,Bergstraat 71,2022-02-23,11:00:00,84,30,54,FMN GV 11 Ramsel
66,Bergstraat 71,2022-02-23,12:00:00,250,212,38,FMN GV 11 Ramsel
66,Bergstraat 71,2022-02-23,13:00:00,280,136,144,FMN GV 11 Ramsel
66,Bergstraat 71,2022-02-23,14:00:00,234,110,124,FMN GV 11 Ramsel
66,Bergstraat 71,2022-02-23,15:00:00,180,86,94,FMN GV 11 Ramsel
66,Bergstraat 71,2022-02-23,16:00:00,136,90,46,FMN GV 11 Ramsel
66,Bergstraat 71,2022-02-23,17:00:00,102,56,46,FMN GV 11 Ramsel
66,Bergstraat 71,2022-02-23,18:00:00,76,42,34,FMN GV 11 Ramsel
66,Bergstraat 71,2022-02-23,19:00:00,30,16,14,FMN GV 11 Ramsel
66,Bergstraat 71,2022-02-23,20:00:00,18,8,10,FMN GV 11 Ramsel
66,Bergstraat 71,2022-02-23,21:00:00,4,4,0,FMN GV 11 Ramsel
66,Bergstraat 71,2022-02-23,22:00:00,22,10,12,FMN GV 11 Ramsel
66,Bergstraat 71,2022-02-23,23:00:00,2,2,0,FMN GV 11 Ramsel
66,Bergstraat 71,2022-02-24,00:00:00,2,2,0,FMN GV 11 Ramsel
66,Bergstraat 71,2022-02-24,01:00:00,0,0,0,FMN GV 11 Ramsel
66,Bergstraat 71,2022-02-24,02:00:00,0,0,0,FMN GV 11 Ramsel
66,Bergstraat 71,2022-02-24,03:00:00,0,0,0,FMN GV 11 Ramsel
66,Bergstraat 71,2022-02-24,04:00:00,2,2,0,FMN GV 11 Ramsel
66,Bergstraat 71,2022-02-24,05:00:00,8,4,4,FMN GV 11 Ramsel
66,Bergstraat 71,2022-02-24,06:00:00,20,4,16,FMN GV 11 Ramsel
66,Bergstraat 71,2022-02-24,07:00:00,160,12,148,FMN GV 11 Ramsel
66,Bergstraat 71,2022-02-24,08:00:00,156,18,138,FMN GV 11 Ramsel
66,Bergstraat 71,2022-02-24,09:00:00,58,24,34,FMN GV 11 Ramsel
66,Bergstraat 71,2022-02-24,10:00:00,60,30,30,FMN GV 11 Ramsel
66,Bergstraat 71,2022-02-24,11:00:00,50,34,16,FMN GV 11 Ramsel
66,Bergstraat 71,2022-02-24,12:00:00,38,24,14,FMN GV 11 Ramsel
66,Bergstraat 71,2022-02-24,13:00:00,20,14,6,FMN GV 11 Ramsel
66,Bergstraat 71,2022-02-24,14:00:00,22,14,8,FMN GV 11 Ramsel
66,Bergstraat 71,2022-02-24,15:00:00,192,182,10,FMN GV 11 Ramsel
66,Bergstraat 71,2022-02-24,16:00:00,80,72,8,FMN GV 11 Ramsel
66,Bergstraat 71,2022-02-24,17:00:00,28,14,14,FMN GV 11 Ramsel
66,Bergstraat 71,2022-02-24,18:00:00,14,4,10,FMN GV 11 Ramsel
66,Bergstraat 71,2022-02-24,19:00:00,16,12,4,FMN GV 11 Ramsel
66,Bergstraat 71,2022-02-24,20:00:00,10,2,8,FMN GV 11 Ramsel
66,Bergstraat 71,2022-02-24,21:00:00,0,0,0,FMN GV 11 Ramsel
66,Bergstraat 71,2022-02-24,22:00:00,8,4,4,FMN GV 11 Ramsel
66,Bergstraat 71,2022-02-24,23:00:00,2,2,0,FMN GV 11 Ramsel
66,Bergstraat 71,2022-02-25,00:00:00,2,2,0,FMN GV 11 Ramsel
66,Bergstraat 71,2022-02-25,01:00:00,2,0,2,FMN GV 11 Ramsel
66,Bergstraat 71,2022-02-25,02:00:00,2,2,0,FMN GV 11 Ramsel
66,Bergstraat 71,2022-02-25,03:00:00,0,0,0,FMN GV 11 Ramsel
66,Bergstraat 71,2022-02-25,04:00:00,4,4,0,FMN GV 11 Ramsel
66,Bergstraat 71,2022-02-25,05:00:00,4,2,2,FMN GV 11 Ramsel
66,Bergstraat 71,2022-02-25,06:00:00,10,0,10,FMN GV 11 Ramsel
66,Bergstraat 71,2022-02-25,07:00:00,94,0,94,FMN GV 11 Ramsel
66,Bergstraat 71,2022-02-25,08:00:00,100,6,94,FMN GV 11 Ramsel
66,Bergstraat 71,2022-02-25,09:00:00,28,6,22,FMN GV 11 Ramsel
66,Bergstraat 71,2022-02-25,10:00:00,22,16,6,FMN GV 11 Ramsel
66,Bergstraat 71,2022-02-25,11:00:00,22,14,8,FMN GV 11 Ramsel
66,Bergstraat 71,2022-02-25,12:00:00,32,16,16,FMN GV 11 Ramsel
66,Bergstraat 71,2022-02-25,13:00:00,28,10,18,FMN GV 11 Ramsel
66,Bergstraat 71,2022-02-25,14:00:00,46,24,22,FMN GV 11 Ramsel
66,Bergstraat 71,2022-02-25,15:00:00,132,114,18,FMN GV 11 Ramsel
66,Bergstraat 71,2022-02-25,16:00:00,76,74,2,FMN GV 11 Ramsel
66,Bergstraat 71,2022-02-25,17:00:00,44,28,16,FMN GV 11 Ramsel
66,Bergstraat 71,2022-02-25,18:00:00,28,16,12,FMN GV 11 Ramsel
66,Bergstraat 71,2022-02-25,19:00:00,14,8,6,FMN GV 11 Ramsel
66,Bergstraat 71,2022-02-25,20:00:00,18,8,10,FMN GV 11 Ramsel
66,Bergstraat 71,2022-02-25,21:00:00,10,4,6,FMN GV 11 Ramsel
66,Bergstraat 71,2022-02-25,22:00:00,16,4,12,FMN GV 11 Ramsel
66,Bergstraat 71,2022-02-25,23:00:00,4,4,0,FMN GV 11 Ramsel
66,Bergstraat 71,2022-02-26,00:00:00,2,2,0,FMN GV 11 Ramsel
66,Bergstraat 71,2022-02-26,01:00:00,6,6,0,FMN GV 11 Ramsel
66,Bergstraat 71,2022-02-26,02:00:00,2,0,2,FMN GV 11 Ramsel
66,Bergstraat 71,2022-02-26,03:00:00,2,2,0,FMN GV 11 Ramsel
66,Bergstraat 71,2022-02-26,04:00:00,0,0,0,FMN GV 11 Ramsel
66,Bergstraat 71,2022-02-26,05:00:00,0,0,0,FMN GV 11 Ramsel
66,Bergstraat 71,2022-02-26,06:00:00,0,0,0,FMN GV 11 Ramsel
66,Bergstraat 71,2022-02-26,07:00:00,4,4,0,FMN GV 11 Ramsel
66,Bergstraat 71,2022-02-26,08:00:00,14,10,4,FMN GV 11 Ramsel
66,Bergstraat 71,2022-02-26,09:00:00,32,14,18,FMN GV 11 Ramsel
66,Bergstraat 71,2022-02-26,10:00:00,96,40,56,FMN GV 11 Ramsel
66,Bergstraat 71,2022-02-26,11:00:00,82,32,50,FMN GV 11 Ramsel
66,Bergstraat 71,2022-02-26,12:00:00,160,50,110,FMN GV 11 Ramsel
66,Bergstraat 71,2022-02-26,13:00:00,162,82,80,FMN GV 11 Ramsel
66,Bergstraat 71,2022-02-26,14:00:00,122,58,64,FMN GV 11 Ramsel
66,Bergstraat 71,2022-02-26,15:00:00,116,62,54,FMN GV 11 Ramsel
66,Bergstraat 71,2022-02-26,16:00:00,122,82,40,FMN GV 11 Ramsel
66,Bergstraat 71,2022-02-26,17:00:00,68,38,30,FMN GV 11 Ramsel
66,Bergstraat 71,2022-02-26,18:00:00,20,12,8,FMN GV 11 Ramsel
66,Bergstraat 71,2022-02-26,19:00:00,26,4,22,FMN GV 11 Ramsel
66,Bergstraat 71,2022-02-26,20:00:00,4,2,2,FMN GV 11 Ramsel
66,Bergstraat 71,2022-02-26,21:00:00,0,0,0,FMN GV 11 Ramsel
66,Bergstraat 71,2022-02-26,22:00:00,6,0,6,FMN GV 11 Ramsel
66,Bergstraat 71,2022-02-26,23:00:00,6,4,2,FMN GV 11 Ramsel
66,Bergstraat 71,2022-02-27,00:00:00,2,2,0,FMN GV 11 Ramsel
66,Bergstraat 71,2022-02-27,01:00:00,6,2,4,FMN GV 11 Ramsel
66,Bergstraat 71,2022-02-27,02:00:00,2,2,0,FMN GV 11 Ramsel
66,Bergstraat 71,2022-02-27,03:00:00,4,4,0,FMN GV 11 Ramsel
66,Bergstraat 71,2022-02-27,04:00:00,0,0,0,FMN GV 11 Ramsel
66,Bergstraat 71,2022-02-27,05:00:00,0,0,0,FMN GV 11 Ramsel
66,Bergstraat 71,2022-02-27,06:00:00,2,2,0,FMN GV 11 Ramsel
66,Bergstraat 71,2022-02-27,07:00:00,0,0,0,FMN GV 11 Ramsel
66,Bergstraat 71,2022-02-27,08:00:00,36,10,26,FMN GV 11 Ramsel
66,Bergstraat 71,2022-02-27,09:00:00,90,32,58,FMN GV 11 Ramsel
66,Bergstraat 71,2022-02-27,10:00:00,122,56,66,FMN GV 11 Ramsel
66,Bergstraat 71,2022-02-27,11:00:00,196,90,106,FMN GV 11 Ramsel
66,Bergstraat 71,2022-02-27,12:00:00,162,108,54,FMN GV 11 Ramsel
66,Bergstraat 71,2022-02-27,13:00:00,208,86,122,FMN GV 11 Ramsel
66,Bergstraat 71,2022-02-27,14:00:00,204,88,116,FMN GV 11 Ramsel
66,Bergstraat 71,2022-02-27,15:00:00,142,82,60,FMN GV 11 Ramsel
66,Bergstraat 71,2022-02-27,16:00:00,126,78,48,FMN GV 11 Ramsel
66,Bergstraat 71,2022-02-27,17:00:00,84,56,28,FMN GV 11 Ramsel
66,Bergstraat 71,2022-02-27,18:00:00,38,22,16,FMN GV 11 Ramsel
66,Bergstraat 71,2022-02-27,19:00:00,22,10,12,FMN GV 11 Ramsel
66,Bergstraat 71,2022-02-27,20:00:00,14,12,2,FMN GV 11 Ramsel
66,Bergstraat 71,2022-02-27,21:00:00,10,4,6,FMN GV 11 Ramsel
66,Bergstraat 71,2022-02-27,22:00:00,0,0,0,FMN GV 11 Ramsel
66,Bergstraat 71,2022-02-27,23:00:00,0,0,0,FMN GV 11 Ramsel
66,Bergstraat 71,2022-02-28,00:00:00,2,0,2,FMN GV 11 Ramsel
66,Bergstraat 71,2022-02-28,01:00:00,2,2,0,FMN GV 11 Ramsel
66,Bergstraat 71,2022-02-28,02:00:00,0,0,0,FMN GV 11 Ramsel
66,Bergstraat 71,2022-02-28,03:00:00,0,0,0,FMN GV 11 Ramsel
66,Bergstraat 71,2022-02-28,04:00:00,4,4,0,FMN GV 11 Ramsel
66,Bergstraat 71,2022-02-28,05:00:00,12,6,6,FMN GV 11 Ramsel
66,Bergstraat 71,2022-02-28,06:00:00,26,6,20,FMN GV 11 Ramsel
66,Bergstraat 71,2022-02-28,07:00:00,42,12,30,FMN GV 11 Ramsel
66,Bergstraat 71,2022-02-28,08:00:00,36,12,24,FMN GV 11 Ramsel
66,Bergstraat 71,2022-02-28,09:00:00,30,8,22,FMN GV 11 Ramsel
66,Bergstraat 71,2022-02-28,10:00:00,54,22,32,FMN GV 11 Ramsel
66,Bergstraat 71,2022-02-28,11:00:00,46,26,20,FMN GV 11 Ramsel
66,Bergstraat 71,2022-02-28,12:00:00,96,52,44,FMN GV 11 Ramsel
66,Bergstraat 71,2022-02-28,13:00:00,194,62,132,FMN GV 11 Ramsel
66,Bergstraat 71,2022-02-28,14:00:00,214,114,100,FMN GV 11 Ramsel
66,Bergstraat 71,2022-02-28,15:00:00,170,80,90,FMN GV 11 Ramsel
66,Bergstraat 71,2022-02-28,16:00:00,144,74,70,FMN GV 11 Ramsel
66,Bergstraat 71,2022-02-28,17:00:00,88,62,26,FMN GV 11 Ramsel
66,Bergstraat 71,2022-02-28,18:00:00,48,32,16,FMN GV 11 Ramsel
66,Bergstraat 71,2022-02-28,19:00:00,28,24,4,FMN GV 11 Ramsel
66,Bergstraat 71,2022-02-28,20:00:00,16,8,8,FMN GV 11 Ramsel
66,Bergstraat 71,2022-02-28,21:00:00,2,0,2,FMN GV 11 Ramsel
66,Bergstraat 71,2022-02-28,22:00:00,10,6,4,FMN GV 11 Ramsel
66,Bergstraat 71,2022-02-28,23:00:00,0,0,0,FMN GV 11 Ramsel
66,Bergstraat 71,2022-03-01,00:00:00,4,0,4,FMN GV 11 Ramsel
66,Bergstraat 71,2022-03-01,01:00:00,4,4,0,FMN GV 11 Ramsel
66,Bergstraat 71,2022-03-01,02:00:00,0,0,0,FMN GV 11 Ramsel
66,Bergstraat 71,2022-03-01,03:00:00,0,0,0,FMN GV 11 Ramsel
66,Bergstraat 71,2022-03-01,04:00:00,4,4,0,FMN GV 11 Ramsel
66,Bergstraat 71,2022-03-01,05:00:00,14,8,6,FMN GV 11 Ramsel
66,Bergstraat 71,2022-03-01,06:00:00,20,8,12,FMN GV 11 Ramsel
66,Bergstraat 71,2022-03-01,07:00:00,38,16,22,FMN GV 11 Ramsel
66,Bergstraat 71,2022-03-01,08:00:00,48,10,38,FMN GV 11 Ramsel
66,Bergstraat 71,2022-03-01,09:00:00,18,12,6,FMN GV 11 Ramsel
66,Bergstraat 71,2022-03-01,10:00:00,44,20,24,FMN GV 11 Ramsel
66,Bergstraat 71,2022-03-01,11:00:00,38,20,18,FMN GV 11 Ramsel
66,Bergstraat 71,2022-03-01,12:00:00,70,48,22,FMN GV 11 Ramsel
66,Bergstraat 71,2022-03-01,13:00:00,134,76,58,FMN GV 11 Ramsel
66,Bergstraat 71,2022-03-01,14:00:00,102,64,38,FMN GV 11 Ramsel
66,Bergstraat 71,2022-03-01,15:00:00,96,50,46,FMN GV 11 Ramsel
66,Bergstraat 71,2022-03-01,16:00:00,78,44,34,FMN GV 11 Ramsel
66,Bergstraat 71,2022-03-01,17:00:00,90,34,56,FMN GV 11 Ramsel
66,Bergstraat 71,2022-03-01,18:00:00,28,16,12,FMN GV 11 Ramsel
66,Bergstraat 71,2022-03-01,19:00:00,36,14,22,FMN GV 11 Ramsel
66,Bergstraat 71,2022-03-01,20:00:00,26,20,6,FMN GV 11 Ramsel
66,Bergstraat 71,2022-03-01,21:00:00,6,4,2,FMN GV 11 Ramsel
66,Bergstraat 71,2022-03-01,22:00:00,2,0,2,FMN GV 11 Ramsel
66,Bergstraat 71,2022-03-01,23:00:00,2,2,0,FMN GV 11 Ramsel
66,Bergstraat 71,2022-03-02,00:00:00,4,0,4,FMN GV 11 Ramsel
66,Bergstraat 71,2022-03-02,01:00:00,0,0,0,FMN GV 11 Ramsel
66,Bergstraat 71,2022-03-02,02:00:00,0,0,0,FMN GV 11 Ramsel
66,Bergstraat 71,2022-03-02,03:00:00,0,0,0,FMN GV 11 Ramsel
66,Bergstraat 71,2022-03-02,04:00:00,4,4,0,FMN GV 11 Ramsel
66,Bergstraat 71,2022-03-02,05:00:00,14,8,6,FMN GV 11 Ramsel
66,Bergstraat 71,2022-03-02,06:00:00,24,6,18,FMN GV 11 Ramsel
66,Bergstraat 71,2022-03-02,07:00:00,34,16,18,FMN GV 11 Ramsel
66,Bergstraat 71,2022-03-02,08:00:00,34,8,26,FMN GV 11 Ramsel
66,Bergstraat 71,2022-03-02,09:00:00,26,10,16,FMN GV 11 Ramsel
66,Bergstraat 71,2022-03-02,10:00:00,48,20,28,FMN GV 11 Ramsel
66,Bergstraat 71,2022-03-02,11:00:00,70,30,40,FMN GV 11 Ramsel
66,Bergstraat 71,2022-03-02,12:00:00,102,48,54,FMN GV 11 Ramsel
66,Bergstraat 71,2022-03-02,13:00:00,138,58,80,FMN GV 11 Ramsel
66,Bergstraat 71,2022-03-02,14:00:00,172,68,104,FMN GV 11 Ramsel
66,Bergstraat 71,2022-03-02,15:00:00,124,58,66,FMN GV 11 Ramsel
66,Bergstraat 71,2022-03-02,16:00:00,114,68,46,FMN GV 11 Ramsel
66,Bergstraat 71,2022-03-02,17:00:00,94,66,28,FMN GV 11 Ramsel
66,Bergstraat 71,2022-03-02,18:00:00,82,42,40,FMN GV 11 Ramsel
66,Bergstraat 71,2022-03-02,19:00:00,40,26,14,FMN GV 11 Ramsel
66,Bergstraat 71,2022-03-02,20:00:00,14,12,2,FMN GV 11 Ramsel
66,Bergstraat 71,2022-03-02,21:00:00,6,4,2,FMN GV 11 Ramsel
66,Bergstraat 71,2022-03-02,22:00:00,8,4,4,FMN GV 11 Ramsel
66,Bergstraat 71,2022-03-02,23:00:00,0,0,0,FMN GV 11 Ramsel
66,Bergstraat 71,2022-03-03,00:00:00,4,2,2,FMN GV 11 Ramsel
66,Bergstraat 71,2022-03-03,01:00:00,0,0,0,FMN GV 11 Ramsel
66,Bergstraat 71,2022-03-03,02:00:00,0,0,0,FMN GV 11 Ramsel
66,Bergstraat 71,2022-03-03,03:00:00,0,0,0,FMN GV 11 Ramsel
66,Bergstraat 71,2022-03-03,04:00:00,4,4,0,FMN GV 11 Ramsel
66,Bergstraat 71,2022-03-03,05:00:00,8,4,4,FMN GV 11 Ramsel
66,Bergstraat 71,2022-03-03,06:00:00,22,6,16,FMN GV 11 Ramsel
66,Bergstraat 71,2022-03-03,07:00:00,32,12,20,FMN GV 11 Ramsel
66,Bergstraat 71,2022-03-03,08:00:00,42,22,20,FMN GV 11 Ramsel
66,Bergstraat 71,2022-03-03,09:00:00,46,16,30,FMN GV 11 Ramsel
66,Bergstraat 71,2022-03-03,10:00:00,74,28,46,FMN GV 11 Ramsel
66,Bergstraat 71,2022-03-03,11:00:00,74,46,28,FMN GV 11 Ramsel
66,Bergstraat 71,2022-03-03,12:00:00,88,48,40,FMN GV 11 Ramsel
66,Bergstraat 71,2022-03-03,13:00:00,184,84,100,FMN GV 11 Ramsel
66,Bergstraat 71,2022-03-03,14:00:00,198,110,88,FMN GV 11 Ramsel
66,Bergstraat 71,2022-03-03,15:00:00,170,86,84,FMN GV 11 Ramsel
66,Bergstraat 71,2022-03-03,16:00:00,122,74,48,FMN GV 11 Ramsel
66,Bergstraat 71,2022-03-03,17:00:00,88,62,26,FMN GV 11 Ramsel
66,Bergstraat 71,2022-03-03,18:00:00,64,40,24,FMN GV 11 Ramsel
66,Bergstraat 71,2022-03-03,19:00:00,22,14,8,FMN GV 11 Ramsel
66,Bergstraat 71,2022-03-03,20:00:00,28,14,14,FMN GV 11 Ramsel
66,Bergstraat 71,2022-03-03,21:00:00,8,2,6,FMN GV 11 Ramsel
66,Bergstraat 71,2022-03-03,22:00:00,12,10,2,FMN GV 11 Ramsel
66,Bergstraat 71,2022-03-03,23:00:00,10,8,2,FMN GV 11 Ramsel
66,Bergstraat 71,2022-03-04,00:00:00,4,4,0,FMN GV 11 Ramsel
66,Bergstraat 71,2022-03-04,01:00:00,2,2,0,FMN GV 11 Ramsel
66,Bergstraat 71,2022-03-04,02:00:00,2,0,2,FMN GV 11 Ramsel
66,Bergstraat 71,2022-03-04,03:00:00,0,0,0,FMN GV 11 Ramsel
66,Bergstraat 71,2022-03-04,04:00:00,6,4,2,FMN GV 11 Ramsel
66,Bergstraat 71,2022-03-04,05:00:00,6,2,4,FMN GV 11 Ramsel
66,Bergstraat 71,2022-03-04,06:00:00,16,4,12,FMN GV 11 Ramsel
66,Bergstraat 71,2022-03-04,07:00:00,20,10,10,FMN GV 11 Ramsel
66,Bergstraat 71,2022-03-04,08:00:00,30,4,26,FMN GV 11 Ramsel
66,Bergstraat 71,2022-03-04,09:00:00,44,18,26,FMN GV 11 Ramsel
66,Bergstraat 71,2022-03-04,10:00:00,46,28,18,FMN GV 11 Ramsel
66,Bergstraat 71,2022-03-04,11:00:00,80,22,58,FMN GV 11 Ramsel
66,Bergstraat 71,2022-03-04,12:00:00,110,48,62,FMN GV 11 Ramsel
66,Bergstraat 71,2022-03-04,13:00:00,140,50,90,FMN GV 11 Ramsel
66,Bergstraat 71,2022-03-04,14:00:00,204,90,114,FMN GV 11 Ramsel
66,Bergstraat 71,2022-03-04,15:00:00,172,98,74,FMN GV 11 Ramsel
66,Bergstraat 71,2022-03-04,16:00:00,132,72,60,FMN GV 11 Ramsel
66,Bergstraat 71,2022-03-04,17:00:00,124,92,32,FMN GV 11 Ramsel
66,Bergstraat 71,2022-03-04,18:00:00,50,26,24,FMN GV 11 Ramsel
66,Bergstraat 71,2022-03-04,19:00:00,26,4,22,FMN GV 11 Ramsel
66,Bergstraat 71,2022-03-04,20:00:00,24,6,18,FMN GV 11 Ramsel
66,Bergstraat 71,2022-03-04,21:00:00,26,10,16,FMN GV 11 Ramsel
66,Bergstraat 71,2022-03-04,22:00:00,18,12,6,FMN GV 11 Ramsel
66,Bergstraat 71,2022-03-04,23:00:00,8,2,6,FMN GV 11 Ramsel
66,Bergstraat 71,2022-03-05,00:00:00,2,0,2,FMN GV 11 Ramsel
66,Bergstraat 71,2022-03-05,01:00:00,6,6,0,FMN GV 11 Ramsel
66,Bergstraat 71,2022-03-05,02:00:00,14,12,2,FMN GV 11 Ramsel
66,Bergstraat 71,2022-03-05,03:00:00,6,6,0,FMN GV 11 Ramsel
66,Bergstraat 71,2022-03-05,04:00:00,8,8,0,FMN GV 11 Ramsel
66,Bergstraat 71,2022-03-05,05:00:00,4,2,2,FMN GV 11 Ramsel
66,Bergstraat 71,2022-03-05,06:00:00,4,2,2,FMN GV 11 Ramsel
66,Bergstraat 71,2022-03-05,07:00:00,6,2,4,FMN GV 11 Ramsel
66,Bergstraat 71,2022-03-05,08:00:00,24,16,8,FMN GV 11 Ramsel
66,Bergstraat 71,2022-03-05,09:00:00,50,14,36,FMN GV 11 Ramsel
66,Bergstraat 71,2022-03-05,10:00:00,56,24,32,FMN GV 11 Ramsel
66,Bergstraat 71,2022-03-05,11:00:00,94,62,32,FMN GV 11 Ramsel
66,Bergstraat 71,2022-03-05,12:00:00,114,42,72,FMN GV 11 Ramsel
66,Bergstraat 71,2022-03-05,13:00:00,180,84,96,FMN GV 11 Ramsel
66,Bergstraat 71,2022-03-05,14:00:00,202,88,114,FMN GV 11 Ramsel
66,Bergstraat 71,2022-03-05,15:00:00,224,134,90,FMN GV 11 Ramsel
66,Bergstraat 71,2022-03-05,16:00:00,142,82,60,FMN GV 11 Ramsel
66,Bergstraat 71,2022-03-05,17:00:00,74,26,48,FMN GV 11 Ramsel
66,Bergstraat 71,2022-03-05,18:00:00,30,18,12,FMN GV 11 Ramsel
66,Bergstraat 71,2022-03-05,19:00:00,26,8,18,FMN GV 11 Ramsel
66,Bergstraat 71,2022-03-05,20:00:00,14,2,12,FMN GV 11 Ramsel
66,Bergstraat 71,2022-03-05,21:00:00,14,6,8,FMN GV 11 Ramsel
66,Bergstraat 71,2022-03-05,22:00:00,20,16,4,FMN GV 11 Ramsel
66,Bergstraat 71,2022-03-05,23:00:00,6,4,2,FMN GV 11 Ramsel
66,Bergstraat 71,2022-03-06,00:00:00,2,2,0,FMN GV 11 Ramsel
66,Bergstraat 71,2022-03-06,01:00:00,10,10,0,FMN GV 11 Ramsel
66,Bergstraat 71,2022-03-06,02:00:00,2,2,0,FMN GV 11 Ramsel
66,Bergstraat 71,2022-03-06,03:00:00,6,6,0,FMN GV 11 Ramsel
66,Bergstraat 71,2022-03-06,04:00:00,2,2,0,FMN GV 11 Ramsel
66,Bergstraat 71,2022-03-06,05:00:00,2,0,2,FMN GV 11 Ramsel
66,Bergstraat 71,2022-03-06,06:00:00,0,0,0,FMN GV 11 Ramsel
66,Bergstraat 71,2022-03-06,07:00:00,10,0,10,FMN GV 11 Ramsel
66,Bergstraat 71,2022-03-06,08:00:00,36,14,22,FMN GV 11 Ramsel
66,Bergstraat 71,2022-03-06,09:00:00,68,10,58,FMN GV 11 Ramsel
66,Bergstraat 71,2022-03-06,10:00:00,122,76,46,FMN GV 11 Ramsel
66,Bergstraat 71,2022-03-06,11:00:00,94,50,44,FMN GV 11 Ramsel
66,Bergstraat 71,2022-03-06,12:00:00,134,74,60,FMN GV 11 Ramsel
66,Bergstraat 71,2022-03-06,13:00:00,178,96,82,FMN GV 11 Ramsel
66,Bergstraat 71,2022-03-06,14:00:00,180,84,96,FMN GV 11 Ramsel
66,Bergstraat 71,2022-03-06,15:00:00,140,78,62,FMN GV 11 Ramsel
66,Bergstraat 71,2022-03-06,16:00:00,74,24,50,FMN GV 11 Ramsel
66,Bergstraat 71,2022-03-06,17:00:00,56,30,26,FMN GV 11 Ramsel
66,Bergstraat 71,2022-03-06,18:00:00,30,22,8,FMN GV 11 Ramsel
66,Bergstraat 71,2022-03-06,19:00:00,10,2,8,FMN GV 11 Ramsel
66,Bergstraat 71,2022-03-06,20:00:00,6,4,2,FMN GV 11 Ramsel
66,Bergstraat 71,2022-03-06,21:00:00,2,2,0,FMN GV 11 Ramsel
66,Bergstraat 71,2022-03-06,22:00:00,6,6,0,FMN GV 11 Ramsel
66,Bergstraat 71,2022-03-06,23:00:00,2,2,0,FMN GV 11 Ramsel
66,Bergstraat 71,2022-03-07,00:00:00,2,0,2,FMN GV 11 Ramsel
66,Bergstraat 71,2022-03-07,01:00:00,0,0,0,FMN GV 11 Ramsel
66,Bergstraat 71,2022-03-07,02:00:00,0,0,0,FMN GV 11 Ramsel
66,Bergstraat 71,2022-03-07,03:00:00,0,0,0,FMN GV 11 Ramsel
66,Bergstraat 71,2022-03-07,04:00:00,4,4,0,FMN GV 11 Ramsel
66,Bergstraat 71,2022-03-07,05:00:00,8,2,6,FMN GV 11 Ramsel
66,Bergstraat 71,2022-03-07,06:00:00,28,8,20,FMN GV 11 Ramsel
66,Bergstraat 71,2022-03-07,07:00:00,196,14,182,FMN GV 11 Ramsel
66,Bergstraat 71,2022-03-07,08:00:00,150,18,132,FMN GV 11 Ramsel
66,Bergstraat 71,2022-03-07,09:00:00,34,14,20,FMN GV 11 Ramsel
66,Bergstraat 71,2022-03-07,10:00:00,30,10,20,FMN GV 11 Ramsel
66,Bergstraat 71,2022-03-07,11:00:00,30,14,16,FMN GV 11 Ramsel
66,Bergstraat 71,2022-03-07,12:00:00,38,20,18,FMN GV 11 Ramsel
66,Bergstraat 71,2022-03-07,13:00:00,86,50,36,FMN GV 11 Ramsel
66,Bergstraat 71,2022-03-07,14:00:00,68,32,36,FMN GV 11 Ramsel
66,Bergstraat 71,2022-03-07,15:00:00,214,166,48,FMN GV 11 Ramsel
66,Bergstraat 71,2022-03-07,16:00:00,158,126,32,FMN GV 11 Ramsel
66,Bergstraat 71,2022-03-07,17:00:00,64,56,8,FMN GV 11 Ramsel
66,Bergstraat 71,2022-03-07,18:00:00,36,20,16,FMN GV 11 Ramsel
66,Bergstraat 71,2022-03-07,19:00:00,20,14,6,FMN GV 11 Ramsel
66,Bergstraat 71,2022-03-07,20:00:00,14,10,4,FMN GV 11 Ramsel
66,Bergstraat 71,2022-03-07,21:00:00,8,4,4,FMN GV 11 Ramsel
66,Bergstraat 71,2022-03-07,22:00:00,14,4,10,FMN GV 11 Ramsel
66,Bergstraat 71,2022-03-07,23:00:00,2,2,0,FMN GV 11 Ramsel
66,Bergstraat 71,2022-03-08,00:00:00,4,0,4,FMN GV 11 Ramsel
66,Bergstraat 71,2022-03-08,01:00:00,4,4,0,FMN GV 11 Ramsel
66,Bergstraat 71,2022-03-08,02:00:00,0,0,0,FMN GV 11 Ramsel
66,Bergstraat 71,2022-03-08,03:00:00,0,0,0,FMN GV 11 Ramsel
66,Bergstraat 71,2022-03-08,04:00:00,6,4,2,FMN GV 11 Ramsel
66,Bergstraat 71,2022-03-08,05:00:00,10,2,8,FMN GV 11 Ramsel
66,Bergstraat 71,2022-03-08,06:00:00,34,10,24,FMN GV 11 Ramsel
66,Bergstraat 71,2022-03-08,07:00:00,178,22,156,FMN GV 11 Ramsel
66,Bergstraat 71,2022-03-08,08:00:00,158,16,142,FMN GV 11 Ramsel
66,Bergstraat 71,2022-03-08,09:00:00,42,14,28,FMN GV 11 Ramsel
66,Bergstraat 71,2022-03-08,10:00:00,42,20,22,FMN GV 11 Ramsel
66,Bergstraat 71,2022-03-08,11:00:00,72,32,40,FMN GV 11 Ramsel
66,Bergstraat 71,2022-03-08,12:00:00,76,52,24,FMN GV 11 Ramsel
66,Bergstraat 71,2022-03-08,13:00:00,126,52,74,FMN GV 11 Ramsel
66,Bergstraat 71,2022-03-08,14:00:00,116,58,58,FMN GV 11 Ramsel
66,Bergstraat 71,2022-03-08,15:00:00,332,254,78,FMN GV 11 Ramsel
66,Bergstraat 71,2022-03-08,16:00:00,214,158,56,FMN GV 11 Ramsel
66,Bergstraat 71,2022-03-08,17:00:00,90,46,44,FMN GV 11 Ramsel
66,Bergstraat 71,2022-03-08,18:00:00,64,42,22,FMN GV 11 Ramsel
66,Bergstraat 71,2022-03-08,19:00:00,26,10,16,FMN GV 11 Ramsel
66,Bergstraat 71,2022-03-08,20:00:00,26,22,4,FMN GV 11 Ramsel
66,Bergstraat 71,2022-03-08,21:00:00,4,4,0,FMN GV 11 Ramsel
66,Bergstraat 71,2022-03-08,22:00:00,12,2,10,FMN GV 11 Ramsel
66,Bergstraat 71,2022-03-08,23:00:00,4,2,2,FMN GV 11 Ramsel
66,Bergstraat 71,2022-03-09,00:00:00,2,2,0,FMN GV 11 Ramsel
66,Bergstraat 71,2022-03-09,01:00:00,0,0,0,FMN GV 11 Ramsel
66,Bergstraat 71,2022-03-09,02:00:00,2,2,0,FMN GV 11 Ramsel
66,Bergstraat 71,2022-03-09,03:00:00,0,0,0,FMN GV 11 Ramsel
66,Bergstraat 71,2022-03-09,04:00:00,4,2,2,FMN GV 11 Ramsel
66,Bergstraat 71,2022-03-09,05:00:00,10,4,6,FMN GV 11 Ramsel
66,Bergstraat 71,2022-03-09,06:00:00,22,8,14,FMN GV 11 Ramsel
66,Bergstraat 71,2022-03-09,07:00:00,186,24,162,FMN GV 11 Ramsel
66,Bergstraat 71,2022-03-09,08:00:00,162,30,132,FMN GV 11 Ramsel
66,Bergstraat 71,2022-03-09,09:00:00,54,22,32,FMN GV 11 Ramsel
66,Bergstraat 71,2022-03-09,10:00:00,66,34,32,FMN GV 11 Ramsel
66,Bergstraat 71,2022-03-09,11:00:00,64,28,36,FMN GV 11 Ramsel
66,Bergstraat 71,2022-03-09,12:00:00,282,240,42,FMN GV 11 Ramsel
66,Bergstraat 71,2022-03-09,13:00:00,184,80,104,FMN GV 11 Ramsel
66,Bergstraat 71,2022-03-09,14:00:00,240,102,138,FMN GV 11 Ramsel
66,Bergstraat 71,2022-03-09,15:00:00,252,130,122,FMN GV 11 Ramsel
66,Bergstraat 71,2022-03-09,16:00:00,184,88,96,FMN GV 11 Ramsel
66,Bergstraat 71,2022-03-09,17:00:00,178,98,80,FMN GV 11 Ramsel
66,Bergstraat 71,2022-03-09,18:00:00,114,66,48,FMN GV 11 Ramsel
66,Bergstraat 71,2022-03-09,19:00:00,58,40,18,FMN GV 11 Ramsel
66,Bergstraat 71,2022-03-09,20:00:00,18,10,8,FMN GV 11 Ramsel
66,Bergstraat 71,2022-03-09,21:00:00,8,8,0,FMN GV 11 Ramsel
66,Bergstraat 71,2022-03-09,22:00:00,16,14,2,FMN GV 11 Ramsel
66,Bergstraat 71,2022-03-09,23:00:00,10,6,4,FMN GV 11 Ramsel
66,Bergstraat 71,2022-03-10,00:00:00,4,0,4,FMN GV 11 Ramsel
66,Bergstraat 71,2022-03-10,01:00:00,4,4,0,FMN GV 11 Ramsel
66,Bergstraat 71,2022-03-10,02:00:00,0,0,0,FMN GV 11 Ramsel
66,Bergstraat 71,2022-03-10,03:00:00,0,0,0,FMN GV 11 Ramsel
66,Bergstraat 71,2022-03-10,04:00:00,4,2,2,FMN GV 11 Ramsel
66,Bergstraat 71,2022-03-10,05:00:00,12,4,8,FMN GV 11 Ramsel
66,Bergstraat 71,2022-03-10,06:00:00,38,14,24,FMN GV 11 Ramsel
66,Bergstraat 71,2022-03-10,07:00:00,226,30,196,FMN GV 11 Ramsel
66,Bergstraat 71,2022-03-10,08:00:00,156,24,132,FMN GV 11 Ramsel
66,Bergstraat 71,2022-03-10,09:00:00,54,16,38,FMN GV 11 Ramsel
66,Bergstraat 71,2022-03-10,10:00:00,72,30,42,FMN GV 11 Ramsel
66,Bergstraat 71,2022-03-10,11:00:00,102,44,58,FMN GV 11 Ramsel
66,Bergstraat 71,2022-03-10,12:00:00,114,72,42,FMN GV 11 Ramsel
66,Bergstraat 71,2022-03-10,13:00:00,182,96,86,FMN GV 11 Ramsel
66,Bergstraat 71,2022-03-10,14:00:00,230,120,110,FMN GV 11 Ramsel
66,Bergstraat 71,2022-03-10,15:00:00,342,260,82,FMN GV 11 Ramsel
66,Bergstraat 71,2022-03-10,16:00:00,286,210,76,FMN GV 11 Ramsel
66,Bergstraat 71,2022-03-10,17:00:00,138,68,70,FMN GV 11 Ramsel
66,Bergstraat 71,2022-03-10,18:00:00,88,52,36,FMN GV 11 Ramsel
66,Bergstraat 71,2022-03-10,19:00:00,40,26,14,FMN GV 11 Ramsel
66,Bergstraat 71,2022-03-10,20:00:00,16,12,4,FMN GV 11 Ramsel
66,Bergstraat 71,2022-03-10,21:00:00,16,12,4,FMN GV 11 Ramsel
66,Bergstraat 71,2022-03-10,22:00:00,18,8,10,FMN GV 11 Ramsel
66,Bergstraat 71,2022-03-10,23:00:00,4,0,4,FMN GV 11 Ramsel
66,Bergstraat 71,2022-03-11,00:00:00,2,0,2,FMN GV 11 Ramsel
66,Bergstraat 71,2022-03-11,01:00:00,4,4,0,FMN GV 11 Ramsel
66,Bergstraat 71,2022-03-11,02:00:00,0,0,0,FMN GV 11 Ramsel
66,Bergstraat 71,2022-03-11,03:00:00,0,0,0,FMN GV 11 Ramsel
66,Bergstraat 71,2022-03-11,04:00:00,4,4,0,FMN GV 11 Ramsel
66,Bergstraat 71,2022-03-11,05:00:00,6,2,4,FMN GV 11 Ramsel
66,Bergstraat 71,2022-03-11,06:00:00,26,12,14,FMN GV 11 Ramsel
66,Bergstraat 71,2022-03-11,07:00:00,198,24,174,FMN GV 11 Ramsel
66,Bergstraat 71,2022-03-11,08:00:00,174,26,148,FMN GV 11 Ramsel
66,Bergstraat 71,2022-03-11,09:00:00,70,26,44,FMN GV 11 Ramsel
66,Bergstraat 71,2022-03-11,10:00:00,58,32,26,FMN GV 11 Ramsel
66,Bergstraat 71,2022-03-11,11:00:00,106,56,50,FMN GV 11 Ramsel
66,Bergstraat 71,2022-03-11,12:00:00,94,46,48,FMN GV 11 Ramsel
66,Bergstraat 71,2022-03-11,13:00:00,134,76,58,FMN GV 11 Ramsel
66,Bergstraat 71,2022-03-11,14:00:00,204,110,94,FMN GV 11 Ramsel
66,Bergstraat 71,2022-03-11,15:00:00,288,226,62,FMN GV 11 Ramsel
66,Bergstraat 71,2022-03-11,16:00:00,190,136,54,FMN GV 11 Ramsel
66,Bergstraat 71,2022-03-11,17:00:00,120,92,28,FMN GV 11 Ramsel
66,Bergstraat 71,2022-03-11,18:00:00,64,36,28,FMN GV 11 Ramsel
66,Bergstraat 71,2022-03-11,19:00:00,20,6,14,FMN GV 11 Ramsel
66,Bergstraat 71,2022-03-11,20:00:00,36,20,16,FMN GV 11 Ramsel
66,Bergstraat 71,2022-03-11,21:00:00,8,2,6,FMN GV 11 Ramsel
66,Bergstraat 71,2022-03-11,22:00:00,26,10,16,FMN GV 11 Ramsel
66,Bergstraat 71,2022-03-11,23:00:00,10,4,6,FMN GV 11 Ramsel
66,Bergstraat 71,2022-03-12,00:00:00,12,8,4,FMN GV 11 Ramsel
66,Bergstraat 71,2022-03-12,01:00:00,14,14,0,FMN GV 11 Ramsel
66,Bergstraat 71,2022-03-12,02:00:00,6,6,0,FMN GV 11 Ramsel
66,Bergstraat 71,2022-03-12,03:00:00,6,6,0,FMN GV 11 Ramsel
66,Bergstraat 71,2022-03-12,04:00:00,6,6,0,FMN GV 11 Ramsel
66,Bergstraat 71,2022-03-12,05:00:00,2,2,0,FMN GV 11 Ramsel
66,Bergstraat 71,2022-03-12,06:00:00,6,4,2,FMN GV 11 Ramsel
66,Bergstraat 71,2022-03-12,07:00:00,8,4,4,FMN GV 11 Ramsel
66,Bergstraat 71,2022-03-12,08:00:00,52,20,32,FMN GV 11 Ramsel
66,Bergstraat 71,2022-03-12,09:00:00,52,22,30,FMN GV 11 Ramsel
66,Bergstraat 71,2022-03-12,10:00:00,102,46,56,FMN GV 11 Ramsel
66,Bergstraat 71,2022-03-12,11:00:00,82,40,42,FMN GV 11 Ramsel
66,Bergstraat 71,2022-03-12,12:00:00,128,56,72,FMN GV 11 Ramsel
66,Bergstraat 71,2022-03-12,13:00:00,160,86,74,FMN GV 11 Ramsel
66,Bergstraat 71,2022-03-12,14:00:00,128,68,60,FMN GV 11 Ramsel
66,Bergstraat 71,2022-03-12,15:00:00,146,78,68,FMN GV 11 Ramsel
66,Bergstraat 71,2022-03-12,16:00:00,108,68,40,FMN GV 11 Ramsel
66,Bergstraat 71,2022-03-12,17:00:00,62,24,38,FMN GV 11 Ramsel
66,Bergstraat 71,2022-03-12,18:00:00,42,24,18,FMN GV 11 Ramsel
66,Bergstraat 71,2022-03-12,19:00:00,26,4,22,FMN GV 11 Ramsel
66,Bergstraat 71,2022-03-12,20:00:00,8,8,0,FMN GV 11 Ramsel
66,Bergstraat 71,2022-03-12,21:00:00,10,8,2,FMN GV 11 Ramsel
66,Bergstraat 71,2022-03-12,22:00:00,16,14,2,FMN GV 11 Ramsel
66,Bergstraat 71,2022-03-12,23:00:00,10,10,0,FMN GV 11 Ramsel
66,Bergstraat 71,2022-03-13,00:00:00,14,10,4,FMN GV 11 Ramsel
66,Bergstraat 71,2022-03-13,01:00:00,4,2,2,FMN GV 11 Ramsel
66,Bergstraat 71,2022-03-13,02:00:00,4,2,2,FMN GV 11 Ramsel
66,Bergstraat 71,2022-03-13,03:00:00,4,0,4,FMN GV 11 Ramsel
66,Bergstraat 71,2022-03-13,04:00:00,0,0,0,FMN GV 11 Ramsel
66,Bergstraat 71,2022-03-13,05:00:00,0,0,0,FMN GV 11 Ramsel
66,Bergstraat 71,2022-03-13,06:00:00,2,0,2,FMN GV 11 Ramsel
66,Bergstraat 71,2022-03-13,07:00:00,10,4,6,FMN GV 11 Ramsel
66,Bergstraat 71,2022-03-13,08:00:00,74,6,68,FMN GV 11 Ramsel
66,Bergstraat 71,2022-03-13,09:00:00,128,42,86,FMN GV 11 Ramsel
66,Bergstraat 71,2022-03-13,10:00:00,186,86,100,FMN GV 11 Ramsel
66,Bergstraat 71,2022-03-13,11:00:00,206,132,74,FMN GV 11 Ramsel
66,Bergstraat 71,2022-03-13,12:00:00,118,66,52,FMN GV 11 Ramsel
66,Bergstraat 71,2022-03-13,13:00:00,248,114,134,FMN GV 11 Ramsel
66,Bergstraat 71,2022-03-13,14:00:00,246,102,144,FMN GV 11 Ramsel
66,Bergstraat 71,2022-03-13,15:00:00,262,146,116,FMN GV 11 Ramsel
66,Bergstraat 71,2022-03-13,16:00:00,130,78,52,FMN GV 11 Ramsel
66,Bergstraat 71,2022-03-13,17:00:00,104,66,38,FMN GV 11 Ramsel
66,Bergstraat 71,2022-03-13,18:00:00,30,16,14,FMN GV 11 Ramsel
66,Bergstraat 71,2022-03-13,19:00:00,20,8,12,FMN GV 11 Ramsel
66,Bergstraat 71,2022-03-13,20:00:00,8,4,4,FMN GV 11 Ramsel
66,Bergstraat 71,2022-03-13,21:00:00,6,2,4,FMN GV 11 Ramsel
66,Bergstraat 71,2022-03-13,22:00:00,0,0,0,FMN GV 11 Ramsel
66,Bergstraat 71,2022-03-13,23:00:00,4,4,0,FMN GV 11 Ramsel
66,Bergstraat 71,2022-03-14,00:00:00,2,2,0,FMN GV 11 Ramsel
66,Bergstraat 71,2022-03-14,01:00:00,0,0,0,FMN GV 11 Ramsel
66,Bergstraat 71,2022-03-14,02:00:00,0,0,0,FMN GV 11 Ramsel
66,Bergstraat 71,2022-03-14,03:00:00,0,0,0,FMN GV 11 Ramsel
66,Bergstraat 71,2022-03-14,04:00:00,10,8,2,FMN GV 11 Ramsel
66,Bergstraat 71,2022-03-14,05:00:00,14,8,6,FMN GV 11 Ramsel
66,Bergstraat 71,2022-03-14,06:00:00,30,14,16,FMN GV 11 Ramsel
66,Bergstraat 71,2022-03-14,07:00:00,202,22,180,FMN GV 11 Ramsel
66,Bergstraat 71,2022-03-14,08:00:00,186,18,168,FMN GV 11 Ramsel
66,Bergstraat 71,2022-03-14,09:00:00,46,24,22,FMN GV 11 Ramsel
66,Bergstraat 71,2022-03-14,10:00:00,66,30,36,FMN GV 11 Ramsel
66,Bergstraat 71,2022-03-14,11:00:00,46,18,28,FMN GV 11 Ramsel
66,Bergstraat 71,2022-03-14,12:00:00,72,44,28,FMN GV 11 Ramsel
66,Bergstraat 71,2022-03-14,13:00:00,140,72,68,FMN GV 11 Ramsel
66,Bergstraat 71,2022-03-14,14:00:00,128,62,66,FMN GV 11 Ramsel
66,Bergstraat 71,2022-03-14,15:00:00,286,220,66,FMN GV 11 Ramsel
66,Bergstraat 71,2022-03-14,16:00:00,194,156,38,FMN GV 11 Ramsel
66,Bergstraat 71,2022-03-14,17:00:00,76,48,28,FMN GV 11 Ramsel
66,Bergstraat 71,2022-03-14,18:00:00,68,38,30,FMN GV 11 Ramsel
66,Bergstraat 71,2022-03-14,19:00:00,32,20,12,FMN GV 11 Ramsel
66,Bergstraat 71,2022-03-14,20:00:00,14,12,2,FMN GV 11 Ramsel
66,Bergstraat 71,2022-03-14,21:00:00,6,6,0,FMN GV 11 Ramsel
66,Bergstraat 71,2022-03-14,22:00:00,20,12,8,FMN GV 11 Ramsel
66,Bergstraat 71,2022-03-14,23:00:00,12,6,6,FMN GV 11 Ramsel
66,Bergstraat 71,2022-03-15,00:00:00,0,0,0,FMN GV 11 Ramsel
66,Bergstraat 71,2022-03-15,01:00:00,4,4,0,FMN GV 11 Ramsel
66,Bergstraat 71,2022-03-15,02:00:00,0,0,0,FMN GV 11 Ramsel
66,Bergstraat 71,2022-03-15,03:00:00,0,0,0,FMN GV 11 Ramsel
66,Bergstraat 71,2022-03-15,04:00:00,4,4,0,FMN GV 11 Ramsel
66,Bergstraat 71,2022-03-15,05:00:00,20,12,8,FMN GV 11 Ramsel
66,Bergstraat 71,2022-03-15,06:00:00,38,16,22,FMN GV 11 Ramsel
66,Bergstraat 71,2022-03-15,07:00:00,176,18,158,FMN GV 11 Ramsel
66,Bergstraat 71,2022-03-15,08:00:00,158,30,128,FMN GV 11 Ramsel
66,Bergstraat 71,2022-03-15,09:00:00,32,10,22,FMN GV 11 Ramsel
66,Bergstraat 71,2022-03-15,10:00:00,48,14,34,FMN GV 11 Ramsel
66,Bergstraat 71,2022-03-15,11:00:00,24,16,8,FMN GV 11 Ramsel
66,Bergstraat 71,2022-03-15,12:00:00,54,38,16,FMN GV 11 Ramsel
66,Bergstraat 71,2022-03-15,13:00:00,140,70,70,FMN GV 11 Ramsel
66,Bergstraat 71,2022-03-15,14:00:00,106,48,58,FMN GV 11 Ramsel
66,Bergstraat 71,2022-03-15,15:00:00,230,186,44,FMN GV 11 Ramsel
66,Bergstraat 71,2022-03-15,16:00:00,142,114,28,FMN GV 11 Ramsel
66,Bergstraat 71,2022-03-15,17:00:00,76,36,40,FMN GV 11 Ramsel
66,Bergstraat 71,2022-03-15,18:00:00,62,36,26,FMN GV 11 Ramsel
66,Bergstraat 71,2022-03-15,19:00:00,38,24,14,FMN GV 11 Ramsel
66,Bergstraat 71,2022-03-15,20:00:00,30,22,8,FMN GV 11 Ramsel
66,Bergstraat 71,2022-03-15,21:00:00,12,8,4,FMN GV 11 Ramsel
66,Bergstraat 71,2022-03-15,22:00:00,6,6,0,FMN GV 11 Ramsel
66,Bergstraat 71,2022-03-15,23:00:00,4,2,2,FMN GV 11 Ramsel
66,Bergstraat 71,2022-03-16,00:00:00,2,0,2,FMN GV 11 Ramsel
66,Bergstraat 71,2022-03-16,01:00:00,2,2,0,FMN GV 11 Ramsel
66,Bergstraat 71,2022-03-16,02:00:00,0,0,0,FMN GV 11 Ramsel
66,Bergstraat 71,2022-03-16,03:00:00,0,0,0,FMN GV 11 Ramsel
66,Bergstraat 71,2022-03-16,04:00:00,8,4,4,FMN GV 11 Ramsel
66,Bergstraat 71,2022-03-16,05:00:00,14,10,4,FMN GV 11 Ramsel
66,Bergstraat 71,2022-03-16,06:00:00,46,16,30,FMN GV 11 Ramsel
66,Bergstraat 71,2022-03-16,07:00:00,208,32,176,FMN GV 11 Ramsel
66,Bergstraat 71,2022-03-16,08:00:00,212,28,184,FMN GV 11 Ramsel
66,Bergstraat 71,2022-03-16,09:00:00,90,28,62,FMN GV 11 Ramsel
66,Bergstraat 71,2022-03-16,10:00:00,100,52,48,FMN GV 11 Ramsel
66,Bergstraat 71,2022-03-16,11:00:00,168,90,78,FMN GV 11 Ramsel
66,Bergstraat 71,2022-03-16,12:00:00,358,274,84,FMN GV 11 Ramsel
66,Bergstraat 71,2022-03-16,13:00:00,248,126,122,FMN GV 11 Ramsel
66,Bergstraat 71,2022-03-16,14:00:00,236,112,124,FMN GV 11 Ramsel
66,Bergstraat 71,2022-03-16,15:00:00,198,132,66,FMN GV 11 Ramsel
66,Bergstraat 71,2022-03-16,16:00:00,238,170,68,FMN GV 11 Ramsel
66,Bergstraat 71,2022-03-16,17:00:00,160,68,92,FMN GV 11 Ramsel
66,Bergstraat 71,2022-03-16,18:00:00,116,82,34,FMN GV 11 Ramsel
66,Bergstraat 71,2022-03-16,19:00:00,66,32,34,FMN GV 11 Ramsel
66,Bergstraat 71,2022-03-16,20:00:00,34,24,10,FMN GV 11 Ramsel
66,Bergstraat 71,2022-03-16,21:00:00,4,2,2,FMN GV 11 Ramsel
66,Bergstraat 71,2022-03-16,22:00:00,10,6,4,FMN GV 11 Ramsel
66,Bergstraat 71,2022-03-16,23:00:00,10,8,2,FMN GV 11 Ramsel
66,Bergstraat 71,2022-03-17,00:00:00,6,2,4,FMN GV 11 Ramsel
66,Bergstraat 71,2022-03-17,01:00:00,2,2,0,FMN GV 11 Ramsel
66,Bergstraat 71,2022-03-17,02:00:00,0,0,0,FMN GV 11 Ramsel
66,Bergstraat 71,2022-03-17,03:00:00,0,0,0,FMN GV 11 Ramsel
66,Bergstraat 71,2022-03-17,04:00:00,4,2,2,FMN GV 11 Ramsel
66,Bergstraat 71,2022-03-17,05:00:00,16,12,4,FMN GV 11 Ramsel
66,Bergstraat 71,2022-03-17,06:00:00,50,16,34,FMN GV 11 Ramsel
66,Bergstraat 71,2022-03-17,07:00:00,206,26,180,FMN GV 11 Ramsel
66,Bergstraat 71,2022-03-17,08:00:00,180,30,150,FMN GV 11 Ramsel
66,Bergstraat 71,2022-03-17,09:00:00,56,22,34,FMN GV 11 Ramsel
66,Bergstraat 71,2022-03-17,10:00:00,40,28,12,FMN GV 11 Ramsel
66,Bergstraat 71,2022-03-17,11:00:00,48,28,20,FMN GV 11 Ramsel
66,Bergstraat 71,2022-03-17,12:00:00,86,64,22,FMN GV 11 Ramsel
66,Bergstraat 71,2022-03-17,13:00:00,114,60,54,FMN GV 11 Ramsel
66,Bergstraat 71,2022-03-17,14:00:00,122,64,58,FMN GV 11 Ramsel
66,Bergstraat 71,2022-03-17,15:00:00,210,156,54,FMN GV 11 Ramsel
66,Bergstraat 71,2022-03-17,16:00:00,164,124,40,FMN GV 11 Ramsel
66,Bergstraat 71,2022-03-17,17:00:00,114,60,54,FMN GV 11 Ramsel
66,Bergstraat 71,2022-03-17,18:00:00,50,30,20,FMN GV 11 Ramsel
66,Bergstraat 71,2022-03-17,19:00:00,28,18,10,FMN GV 11 Ramsel
66,Bergstraat 71,2022-03-17,20:00:00,22,14,8,FMN GV 11 Ramsel
66,Bergstraat 71,2022-03-17,21:00:00,8,6,2,FMN GV 11 Ramsel
66,Bergstraat 71,2022-03-17,22:00:00,16,12,4,FMN GV 11 Ramsel
66,Bergstraat 71,2022-03-17,23:00:00,2,2,0,FMN GV 11 Ramsel
66,Bergstraat 71,2022-03-18,00:00:00,4,0,4,FMN GV 11 Ramsel
66,Bergstraat 71,2022-03-18,01:00:00,8,4,4,FMN GV 11 Ramsel
66,Bergstraat 71,2022-03-18,02:00:00,0,0,0,FMN GV 11 Ramsel
66,Bergstraat 71,2022-03-18,03:00:00,0,0,0,FMN GV 11 Ramsel
66,Bergstraat 71,2022-03-18,04:00:00,8,4,4,FMN GV 11 Ramsel
66,Bergstraat 71,2022-03-18,05:00:00,10,8,2,FMN GV 11 Ramsel
66,Bergstraat 71,2022-03-18,06:00:00,20,2,18,FMN GV 11 Ramsel
66,Bergstraat 71,2022-03-18,07:00:00,164,16,148,FMN GV 11 Ramsel
66,Bergstraat 71,2022-03-18,08:00:00,128,14,114,FMN GV 11 Ramsel
66,Bergstraat 71,2022-03-18,09:00:00,68,22,46,FMN GV 11 Ramsel
66,Bergstraat 71,2022-03-18,10:00:00,70,32,38,FMN GV 11 Ramsel
66,Bergstraat 71,2022-03-18,11:00:00,80,24,56,FMN GV 11 Ramsel
66,Bergstraat 71,2022-03-18,12:00:00,100,70,30,FMN GV 11 Ramsel
66,Bergstraat 71,2022-03-18,13:00:00,150,68,82,FMN GV 11 Ramsel
66,Bergstraat 71,2022-03-18,14:00:00,212,124,88,FMN GV 11 Ramsel
66,Bergstraat 71,2022-03-18,15:00:00,258,182,76,FMN GV 11 Ramsel
66,Bergstraat 71,2022-03-18,16:00:00,186,136,50,FMN GV 11 Ramsel
66,Bergstraat 71,2022-03-18,17:00:00,94,62,32,FMN GV 11 Ramsel
66,Bergstraat 71,2022-03-18,18:00:00,64,32,32,FMN GV 11 Ramsel
66,Bergstraat 71,2022-03-18,19:00:00,54,14,40,FMN GV 11 Ramsel
66,Bergstraat 71,2022-03-18,20:00:00,50,22,28,FMN GV 11 Ramsel
66,Bergstraat 71,2022-03-18,21:00:00,22,18,4,FMN GV 11 Ramsel
66,Bergstraat 71,2022-03-18,22:00:00,16,14,2,FMN GV 11 Ramsel
66,Bergstraat 71,2022-03-18,23:00:00,2,2,0,FMN GV 11 Ramsel
66,Bergstraat 71,2022-03-19,00:00:00,20,2,18,FMN GV 11 Ramsel
66,Bergstraat 71,2022-03-19,01:00:00,10,8,2,FMN GV 11 Ramsel
66,Bergstraat 71,2022-03-19,02:00:00,14,12,2,FMN GV 11 Ramsel
66,Bergstraat 71,2022-03-19,03:00:00,10,6,4,FMN GV 11 Ramsel
66,Bergstraat 71,2022-03-19,04:00:00,12,8,4,FMN GV 11 Ramsel
66,Bergstraat 71,2022-03-19,05:00:00,2,2,0,FMN GV 11 Ramsel
66,Bergstraat 71,2022-03-19,06:00:00,10,6,4,FMN GV 11 Ramsel
66,Bergstraat 71,2022-03-19,07:00:00,12,4,8,FMN GV 11 Ramsel
66,Bergstraat 71,2022-03-19,08:00:00,32,10,22,FMN GV 11 Ramsel
66,Bergstraat 71,2022-03-19,09:00:00,80,32,48,FMN GV 11 Ramsel
66,Bergstraat 71,2022-03-19,10:00:00,110,48,62,FMN GV 11 Ramsel
66,Bergstraat 71,2022-03-19,11:00:00,102,48,54,FMN GV 11 Ramsel
66,Bergstraat 71,2022-03-19,12:00:00,118,72,46,FMN GV 11 Ramsel
66,Bergstraat 71,2022-03-19,13:00:00,192,88,104,FMN GV 11 Ramsel
66,Bergstraat 71,2022-03-19,14:00:00,202,120,82,FMN GV 11 Ramsel
66,Bergstraat 71,2022-03-19,15:00:00,178,112,66,FMN GV 11 Ramsel
66,Bergstraat 71,2022-03-19,16:00:00,76,54,22,FMN GV 11 Ramsel
66,Bergstraat 71,2022-03-19,17:00:00,66,40,26,FMN GV 11 Ramsel
66,Bergstraat 71,2022-03-19,18:00:00,50,20,30,FMN GV 11 Ramsel
66,Bergstraat 71,2022-03-19,19:00:00,28,18,10,FMN GV 11 Ramsel
66,Bergstraat 71,2022-03-19,20:00:00,4,4,0,FMN GV 11 Ramsel
66,Bergstraat 71,2022-03-19,21:00:00,6,2,4,FMN GV 11 Ramsel
66,Bergstraat 71,2022-03-19,22:00:00,20,16,4,FMN GV 11 Ramsel
66,Bergstraat 71,2022-03-19,23:00:00,12,4,8,FMN GV 11 Ramsel
66,Bergstraat 71,2022-03-20,00:00:00,6,4,2,FMN GV 11 Ramsel
66,Bergstraat 71,2022-03-20,01:00:00,2,2,0,FMN GV 11 Ramsel
66,Bergstraat 71,2022-03-20,02:00:00,2,0,2,FMN GV 11 Ramsel
66,Bergstraat 71,2022-03-20,03:00:00,2,2,0,FMN GV 11 Ramsel
66,Bergstraat 71,2022-03-20,04:00:00,2,0,2,FMN GV 11 Ramsel
66,Bergstraat 71,2022-03-20,05:00:00,2,0,2,FMN GV 11 Ramsel
66,Bergstraat 71,2022-03-20,06:00:00,8,4,4,FMN GV 11 Ramsel
66,Bergstraat 71,2022-03-20,07:00:00,20,6,14,FMN GV 11 Ramsel
66,Bergstraat 71,2022-03-20,08:00:00,34,8,26,FMN GV 11 Ramsel
66,Bergstraat 71,2022-03-20,09:00:00,66,48,18,FMN GV 11 Ramsel
66,Bergstraat 71,2022-03-20,10:00:00,84,48,36,FMN GV 11 Ramsel
66,Bergstraat 71,2022-03-20,11:00:00,120,76,44,FMN GV 11 Ramsel
66,Bergstraat 71,2022-03-20,12:00:00,80,64,16,FMN GV 11 Ramsel
66,Bergstraat 71,2022-03-20,13:00:00,134,60,74,FMN GV 11 Ramsel
66,Bergstraat 71,2022-03-20,14:00:00,188,88,100,FMN GV 11 Ramsel
66,Bergstraat 71,2022-03-20,15:00:00,102,66,36,FMN GV 11 Ramsel
66,Bergstraat 71,2022-03-20,16:00:00,92,42,50,FMN GV 11 Ramsel
66,Bergstraat 71,2022-03-20,17:00:00,54,40,14,FMN GV 11 Ramsel
66,Bergstraat 71,2022-03-20,18:00:00,24,16,8,FMN GV 11 Ramsel
66,Bergstraat 71,2022-03-20,19:00:00,38,30,8,FMN GV 11 Ramsel
66,Bergstraat 71,2022-03-20,20:00:00,16,10,6,FMN GV 11 Ramsel
66,Bergstraat 71,2022-03-20,21:00:00,0,0,0,FMN GV 11 Ramsel
66,Bergstraat 71,2022-03-20,22:00:00,0,0,0,FMN GV 11 Ramsel
66,Bergstraat 71,2022-03-20,23:00:00,2,2,0,FMN GV 11 Ramsel
66,Bergstraat 71,2022-03-21,00:00:00,0,0,0,FMN GV 11 Ramsel
66,Bergstraat 71,2022-03-21,01:00:00,2,2,0,FMN GV 11 Ramsel
66,Bergstraat 71,2022-03-21,02:00:00,0,0,0,FMN GV 11 Ramsel
66,Bergstraat 71,2022-03-21,03:00:00,0,0,0,FMN GV 11 Ramsel
66,Bergstraat 71,2022-03-21,04:00:00,2,2,0,FMN GV 11 Ramsel
66,Bergstraat 71,2022-03-21,05:00:00,10,4,6,FMN GV 11 Ramsel
66,Bergstraat 71,2022-03-21,06:00:00,32,12,20,FMN GV 11 Ramsel
66,Bergstraat 71,2022-03-21,07:00:00,170,26,144,FMN GV 11 Ramsel
66,Bergstraat 71,2022-03-21,08:00:00,178,22,156,FMN GV 11 Ramsel
66,Bergstraat 71,2022-03-21,09:00:00,62,28,34,FMN GV 11 Ramsel
66,Bergstraat 71,2022-03-21,10:00:00,58,26,32,FMN GV 11 Ramsel
66,Bergstraat 71,2022-03-21,11:00:00,48,22,26,FMN GV 11 Ramsel
66,Bergstraat 71,2022-03-21,12:00:00,164,98,66,FMN GV 11 Ramsel
66,Bergstraat 71,2022-03-21,13:00:00,168,72,96,FMN GV 11 Ramsel
66,Bergstraat 71,2022-03-21,14:00:00,214,114,100,FMN GV 11 Ramsel
66,Bergstraat 71,2022-03-21,15:00:00,286,214,72,FMN GV 11 Ramsel
66,Bergstraat 71,2022-03-21,16:00:00,214,168,46,FMN GV 11 Ramsel
66,Bergstraat 71,2022-03-21,17:00:00,114,78,36,FMN GV 11 Ramsel
66,Bergstraat 71,2022-03-21,18:00:00,82,48,34,FMN GV 11 Ramsel
66,Bergstraat 71,2022-03-21,19:00:00,46,26,20,FMN GV 11 Ramsel
66,Bergstraat 71,2022-03-21,20:00:00,22,10,12,FMN GV 11 Ramsel
66,Bergstraat 71,2022-03-21,21:00:00,4,4,0,FMN GV 11 Ramsel
66,Bergstraat 71,2022-03-21,22:00:00,18,12,6,FMN GV 11 Ramsel
66,Bergstraat 71,2022-03-21,23:00:00,6,6,0,FMN GV 11 Ramsel
66,Bergstraat 71,2022-03-22,00:00:00,4,0,4,FMN GV 11 Ramsel
66,Bergstraat 71,2022-03-22,01:00:00,4,4,0,FMN GV 11 Ramsel
66,Bergstraat 71,2022-03-22,02:00:00,0,0,0,FMN GV 11 Ramsel
66,Bergstraat 71,2022-03-22,03:00:00,0,0,0,FMN GV 11 Ramsel
66,Bergstraat 71,2022-03-22,04:00:00,4,4,0,FMN GV 11 Ramsel
66,Bergstraat 71,2022-03-22,05:00:00,10,4,6,FMN GV 11 Ramsel
66,Bergstraat 71,2022-03-22,06:00:00,42,8,34,FMN GV 11 Ramsel
66,Bergstraat 71,2022-03-22,07:00:00,216,36,180,FMN GV 11 Ramsel
66,Bergstraat 71,2022-03-22,08:00:00,196,38,158,FMN GV 11 Ramsel
66,Bergstraat 71,2022-03-22,09:00:00,56,24,32,FMN GV 11 Ramsel
66,Bergstraat 71,2022-03-22,10:00:00,74,36,38,FMN GV 11 Ramsel
66,Bergstraat 71,2022-03-22,11:00:00,112,42,70,FMN GV 11 Ramsel
66,Bergstraat 71,2022-03-22,12:00:00,166,92,74,FMN GV 11 Ramsel
66,Bergstraat 71,2022-03-22,13:00:00,302,116,186,FMN GV 11 Ramsel
66,Bergstraat 71,2022-03-22,14:00:00,308,162,146,FMN GV 11 Ramsel
66,Bergstraat 71,2022-03-22,15:00:00,384,292,92,FMN GV 11 Ramsel
66,Bergstraat 71,2022-03-22,16:00:00,278,210,68,FMN GV 11 Ramsel
66,Bergstraat 71,2022-03-22,17:00:00,174,100,74,FMN GV 11 Ramsel
66,Bergstraat 71,2022-03-22,18:00:00,80,58,22,FMN GV 11 Ramsel
66,Bergstraat 71,2022-03-22,19:00:00,62,36,26,FMN GV 11 Ramsel
66,Bergstraat 71,2022-03-22,20:00:00,46,26,20,FMN GV 11 Ramsel
66,Bergstraat 71,2022-03-22,21:00:00,4,2,2,FMN GV 11 Ramsel
66,Bergstraat 71,2022-03-22,22:00:00,22,10,12,FMN GV 11 Ramsel
66,Bergstraat 71,2022-03-22,23:00:00,2,2,0,FMN GV 11 Ramsel
66,Bergstraat 71,2022-03-23,00:00:00,10,6,4,FMN GV 11 Ramsel
66,Bergstraat 71,2022-03-23,01:00:00,0,0,0,FMN GV 11 Ramsel
66,Bergstraat 71,2022-03-23,02:00:00,0,0,0,FMN GV 11 Ramsel
66,Bergstraat 71,2022-03-23,03:00:00,0,0,0,FMN GV 11 Ramsel
66,Bergstraat 71,2022-03-23,04:00:00,2,2,0,FMN GV 11 Ramsel
66,Bergstraat 71,2022-03-23,05:00:00,12,4,8,FMN GV 11 Ramsel
66,Bergstraat 71,2022-03-23,06:00:00,38,8,30,FMN GV 11 Ramsel
66,Bergstraat 71,2022-03-23,07:00:00,222,32,190,FMN GV 11 Ramsel
66,Bergstraat 71,2022-03-23,08:00:00,184,24,160,FMN GV 11 Ramsel
66,Bergstraat 71,2022-03-23,09:00:00,66,30,36,FMN GV 11 Ramsel
66,Bergstraat 71,2022-03-23,10:00:00,86,34,52,FMN GV 11 Ramsel
66,Bergstraat 71,2022-03-23,11:00:00,96,60,36,FMN GV 11 Ramsel
66,Bergstraat 71,2022-03-23,12:00:00,380,328,52,FMN GV 11 Ramsel
66,Bergstraat 71,2022-03-23,13:00:00,266,126,140,FMN GV 11 Ramsel
66,Bergstraat 71,2022-03-23,14:00:00,296,160,136,FMN GV 11 Ramsel
66,Bergstraat 71,2022-03-23,15:00:00,230,122,108,FMN GV 11 Ramsel
66,Bergstraat 71,2022-03-23,16:00:00,220,128,92,FMN GV 11 Ramsel
66,Bergstraat 71,2022-03-23,17:00:00,208,104,104,FMN GV 11 Ramsel
66,Bergstraat 71,2022-03-23,18:00:00,112,88,24,FMN GV 11 Ramsel
66,Bergstraat 71,2022-03-23,19:00:00,48,38,10,FMN GV 11 Ramsel
66,Bergstraat 71,2022-03-23,20:00:00,20,14,6,FMN GV 11 Ramsel
66,Bergstraat 71,2022-03-23,21:00:00,10,10,0,FMN GV 11 Ramsel
66,Bergstraat 71,2022-03-23,22:00:00,12,8,4,FMN GV 11 Ramsel
66,Bergstraat 71,2022-03-23,23:00:00,4,4,0,FMN GV 11 Ramsel
66,Bergstraat 71,2022-03-24,00:00:00,12,6,6,FMN GV 11 Ramsel
66,Bergstraat 71,2022-03-24,01:00:00,4,4,0,FMN GV 11 Ramsel
66,Bergstraat 71,2022-03-24,02:00:00,0,0,0,FMN GV 11 Ramsel
66,Bergstraat 71,2022-03-24,03:00:00,2,0,2,FMN GV 11 Ramsel
66,Bergstraat 71,2022-03-24,04:00:00,4,2,2,FMN GV 11 Ramsel
66,Bergstraat 71,2022-03-24,05:00:00,16,6,10,FMN GV 11 Ramsel
66,Bergstraat 71,2022-03-24,06:00:00,40,8,32,FMN GV 11 Ramsel
66,Bergstraat 71,2022-03-24,07:00:00,216,36,180,FMN GV 11 Ramsel
66,Bergstraat 71,2022-03-24,08:00:00,204,38,166,FMN GV 11 Ramsel
66,Bergstraat 71,2022-03-24,09:00:00,94,30,64,FMN GV 11 Ramsel
66,Bergstraat 71,2022-03-24,10:00:00,96,50,46,FMN GV 11 Ramsel
66,Bergstraat 71,2022-03-24,11:00:00,110,72,38,FMN GV 11 Ramsel
66,Bergstraat 71,2022-03-24,12:00:00,172,114,58,FMN GV 11 Ramsel
66,Bergstraat 71,2022-03-24,13:00:00,232,102,130,FMN GV 11 Ramsel
66,Bergstraat 71,2022-03-24,14:00:00,226,142,84,FMN GV 11 Ramsel
66,Bergstraat 71,2022-03-24,15:00:00,366,248,118,FMN GV 11 Ramsel
66,Bergstraat 71,2022-03-24,16:00:00,198,142,56,FMN GV 11 Ramsel
66,Bergstraat 71,2022-03-24,17:00:00,170,96,74,FMN GV 11 Ramsel
66,Bergstraat 71,2022-03-24,18:00:00,102,48,54,FMN GV 11 Ramsel
66,Bergstraat 71,2022-03-24,19:00:00,44,24,20,FMN GV 11 Ramsel
66,Bergstraat 71,2022-03-24,20:00:00,26,20,6,FMN GV 11 Ramsel
66,Bergstraat 71,2022-03-24,21:00:00,14,4,10,FMN GV 11 Ramsel
66,Bergstraat 71,2022-03-24,22:00:00,18,14,4,FMN GV 11 Ramsel
66,Bergstraat 71,2022-03-24,23:00:00,6,4,2,FMN GV 11 Ramsel
66,Bergstraat 71,2022-03-25,00:00:00,4,0,4,FMN GV 11 Ramsel
66,Bergstraat 71,2022-03-25,01:00:00,4,4,0,FMN GV 11 Ramsel
66,Bergstraat 71,2022-03-25,02:00:00,0,0,0,FMN GV 11 Ramsel
66,Bergstraat 71,2022-03-25,03:00:00,0,0,0,FMN GV 11 Ramsel
66,Bergstraat 71,2022-03-25,04:00:00,4,4,0,FMN GV 11 Ramsel
66,Bergstraat 71,2022-03-25,05:00:00,10,2,8,FMN GV 11 Ramsel
66,Bergstraat 71,2022-03-25,06:00:00,28,10,18,FMN GV 11 Ramsel
66,Bergstraat 71,2022-03-25,07:00:00,208,42,166,FMN GV 11 Ramsel
66,Bergstraat 71,2022-03-25,08:00:00,164,26,138,FMN GV 11 Ramsel
66,Bergstraat 71,2022-03-25,09:00:00,64,22,42,FMN GV 11 Ramsel
66,Bergstraat 71,2022-03-25,10:00:00,90,62,28,FMN GV 11 Ramsel
66,Bergstraat 71,2022-03-25,11:00:00,150,82,68,FMN GV 11 Ramsel
66,Bergstraat 71,2022-03-25,12:00:00,172,64,108,FMN GV 11 Ramsel
66,Bergstraat 71,2022-03-25,13:00:00,144,72,72,FMN GV 11 Ramsel
66,Bergstraat 71,2022-03-25,14:00:00,262,166,96,FMN GV 11 Ramsel
66,Bergstraat 71,2022-03-25,15:00:00,330,232,98,FMN GV 11 Ramsel
66,Bergstraat 71,2022-03-25,16:00:00,192,140,52,FMN GV 11 Ramsel
66,Bergstraat 71,2022-03-25,17:00:00,122,76,46,FMN GV 11 Ramsel
66,Bergstraat 71,2022-03-25,18:00:00,62,46,16,FMN GV 11 Ramsel
66,Bergstraat 71,2022-03-25,19:00:00,48,34,14,FMN GV 11 Ramsel
66,Bergstraat 71,2022-03-25,20:00:00,36,18,18,FMN GV 11 Ramsel
66,Bergstraat 71,2022-03-25,21:00:00,10,8,2,FMN GV 11 Ramsel
66,Bergstraat 71,2022-03-25,22:00:00,10,8,2,FMN GV 11 Ramsel
66,Bergstraat 71,2022-03-25,23:00:00,4,4,0,FMN GV 11 Ramsel
66,Bergstraat 71,2022-03-26,00:00:00,10,2,8,FMN GV 11 Ramsel
66,Bergstraat 71,2022-03-26,01:00:00,8,2,6,FMN GV 11 Ramsel
66,Bergstraat 71,2022-03-26,02:00:00,4,4,0,FMN GV 11 Ramsel
66,Bergstraat 71,2022-03-26,03:00:00,4,2,2,FMN GV 11 Ramsel
66,Bergstraat 71,2022-03-26,04:00:00,2,2,0,FMN GV 11 Ramsel
66,Bergstraat 71,2022-03-26,05:00:00,0,0,0,FMN GV 11 Ramsel
66,Bergstraat 71,2022-03-26,06:00:00,4,2,2,FMN GV 11 Ramsel
66,Bergstraat 71,2022-03-26,07:00:00,18,8,10,FMN GV 11 Ramsel
66,Bergstraat 71,2022-03-26,08:00:00,44,10,34,FMN GV 11 Ramsel
66,Bergstraat 71,2022-03-26,09:00:00,78,34,44,FMN GV 11 Ramsel
66,Bergstraat 71,2022-03-26,10:00:00,112,64,48,FMN GV 11 Ramsel
66,Bergstraat 71,2022-03-26,11:00:00,164,62,102,FMN GV 11 Ramsel
66,Bergstraat 71,2022-03-26,12:00:00,104,52,52,FMN GV 11 Ramsel
66,Bergstraat 71,2022-03-26,13:00:00,320,140,180,FMN GV 11 Ramsel
66,Bergstraat 71,2022-03-26,14:00:00,312,134,178,FMN GV 11 Ramsel
66,Bergstraat 71,2022-03-26,15:00:00,278,154,124,FMN GV 11 Ramsel
66,Bergstraat 71,2022-03-26,16:00:00,186,102,84,FMN GV 11 Ramsel
66,Bergstraat 71,2022-03-26,17:00:00,116,62,54,FMN GV 11 Ramsel
66,Bergstraat 71,2022-03-26,18:00:00,70,38,32,FMN GV 11 Ramsel
66,Bergstraat 71,2022-03-26,19:00:00,38,16,22,FMN GV 11 Ramsel
66,Bergstraat 71,2022-03-26,20:00:00,14,8,6,FMN GV 11 Ramsel
66,Bergstraat 71,2022-03-26,21:00:00,34,20,14,FMN GV 11 Ramsel
66,Bergstraat 71,2022-03-26,22:00:00,22,20,2,FMN GV 11 Ramsel
66,Bergstraat 71,2022-03-26,23:00:00,26,14,12,FMN GV 11 Ramsel
66,Bergstraat 71,2022-03-27,00:00:00,10,10,0,FMN GV 11 Ramsel
66,Bergstraat 71,2022-03-27,01:00:00,8,4,4,FMN GV 11 Ramsel
66,Bergstraat 71,2022-03-27,02:00:00,0,0,0,FMN GV 11 Ramsel
66,Bergstraat 71,2022-03-27,03:00:00,4,0,4,FMN GV 11 Ramsel
66,Bergstraat 71,2022-03-27,04:00:00,6,6,0,FMN GV 11 Ramsel
66,Bergstraat 71,2022-03-27,05:00:00,2,2,0,FMN GV 11 Ramsel
66,Bergstraat 71,2022-03-27,06:00:00,6,2,4,FMN GV 11 Ramsel
66,Bergstraat 71,2022-03-27,07:00:00,30,2,28,FMN GV 11 Ramsel
66,Bergstraat 71,2022-03-27,08:00:00,60,22,38,FMN GV 11 Ramsel
66,Bergstraat 71,2022-03-27,09:00:00,72,28,44,FMN GV 11 Ramsel
66,Bergstraat 71,2022-03-27,10:00:00,218,142,76,FMN GV 11 Ramsel
66,Bergstraat 71,2022-03-27,11:00:00,118,68,50,FMN GV 11 Ramsel
66,Bergstraat 71,2022-03-27,12:00:00,112,76,36,FMN GV 11 Ramsel
66,Bergstraat 71,2022-03-27,13:00:00,148,66,82,FMN GV 11 Ramsel
66,Bergstraat 71,2022-03-27,14:00:00,108,66,42,FMN GV 11 Ramsel
66,Bergstraat 71,2022-03-27,15:00:00,118,50,68,FMN GV 11 Ramsel
66,Bergstraat 71,2022-03-27,16:00:00,84,58,26,FMN GV 11 Ramsel
66,Bergstraat 71,2022-03-27,17:00:00,74,32,42,FMN GV 11 Ramsel
66,Bergstraat 71,2022-03-27,18:00:00,56,30,26,FMN GV 11 Ramsel
66,Bergstraat 71,2022-03-27,19:00:00,44,18,26,FMN GV 11 Ramsel
66,Bergstraat 71,2022-03-27,20:00:00,10,6,4,FMN GV 11 Ramsel
66,Bergstraat 71,2022-03-27,21:00:00,12,6,6,FMN GV 11 Ramsel
66,Bergstraat 71,2022-03-27,22:00:00,6,6,0,FMN GV 11 Ramsel
66,Bergstraat 71,2022-03-27,23:00:00,4,2,2,FMN GV 11 Ramsel
66,Bergstraat 71,2022-03-28,00:00:00,4,4,0,FMN GV 11 Ramsel
66,Bergstraat 71,2022-03-28,01:00:00,0,0,0,FMN GV 11 Ramsel
66,Bergstraat 71,2022-03-28,02:00:00,0,0,0,FMN GV 11 Ramsel
66,Bergstraat 71,2022-03-28,03:00:00,0,0,0,FMN GV 11 Ramsel
66,Bergstraat 71,2022-03-28,04:00:00,4,2,2,FMN GV 11 Ramsel
66,Bergstraat 71,2022-03-28,05:00:00,14,8,6,FMN GV 11 Ramsel
66,Bergstraat 71,2022-03-28,06:00:00,36,16,20,FMN GV 11 Ramsel
66,Bergstraat 71,2022-03-28,07:00:00,198,26,172,FMN GV 11 Ramsel
66,Bergstraat 71,2022-03-28,08:00:00,182,24,158,FMN GV 11 Ramsel
66,Bergstraat 71,2022-03-28,09:00:00,36,22,14,FMN GV 11 Ramsel
66,Bergstraat 71,2022-03-28,10:00:00,94,54,40,FMN GV 11 Ramsel
66,Bergstraat 71,2022-03-28,11:00:00,82,58,24,FMN GV 11 Ramsel
66,Bergstraat 71,2022-03-28,12:00:00,152,88,64,FMN GV 11 Ramsel
66,Bergstraat 71,2022-03-28,13:00:00,252,146,106,FMN GV 11 Ramsel
66,Bergstraat 71,2022-03-28,14:00:00,236,90,146,FMN GV 11 Ramsel
66,Bergstraat 71,2022-03-28,15:00:00,240,162,78,FMN GV 11 Ramsel
66,Bergstraat 71,2022-03-28,16:00:00,266,164,102,FMN GV 11 Ramsel
66,Bergstraat 71,2022-03-28,17:00:00,156,92,64,FMN GV 11 Ramsel
66,Bergstraat 71,2022-03-28,18:00:00,72,36,36,FMN GV 11 Ramsel
66,Bergstraat 71,2022-03-28,19:00:00,54,30,24,FMN GV 11 Ramsel
66,Bergstraat 71,2022-03-28,20:00:00,34,30,4,FMN GV 11 Ramsel
66,Bergstraat 71,2022-03-28,21:00:00,16,12,4,FMN GV 11 Ramsel
66,Bergstraat 71,2022-03-28,22:00:00,22,4,18,FMN GV 11 Ramsel
66,Bergstraat 71,2022-03-28,23:00:00,6,2,4,FMN GV 11 Ramsel
66,Bergstraat 71,2022-03-29,00:00:00,4,4,0,FMN GV 11 Ramsel
66,Bergstraat 71,2022-03-29,01:00:00,4,4,0,FMN GV 11 Ramsel
66,Bergstraat 71,2022-03-29,02:00:00,0,0,0,FMN GV 11 Ramsel
66,Bergstraat 71,2022-03-29,03:00:00,2,2,0,FMN GV 11 Ramsel
66,Bergstraat 71,2022-03-29,04:00:00,6,4,2,FMN GV 11 Ramsel
66,Bergstraat 71,2022-03-29,05:00:00,18,10,8,FMN GV 11 Ramsel
66,Bergstraat 71,2022-03-29,06:00:00,32,12,20,FMN GV 11 Ramsel
66,Bergstraat 71,2022-03-29,07:00:00,188,28,160,FMN GV 11 Ramsel
66,Bergstraat 71,2022-03-29,08:00:00,152,24,128,FMN GV 11 Ramsel
66,Bergstraat 71,2022-03-29,09:00:00,120,78,42,FMN GV 11 Ramsel
66,Bergstraat 71,2022-03-29,10:00:00,118,76,42,FMN GV 11 Ramsel
66,Bergstraat 71,2022-03-29,11:00:00,72,44,28,FMN GV 11 Ramsel
66,Bergstraat 71,2022-03-29,12:00:00,94,40,54,FMN GV 11 Ramsel
66,Bergstraat 71,2022-03-29,13:00:00,138,78,60,FMN GV 11 Ramsel
66,Bergstraat 71,2022-03-29,14:00:00,108,60,48,FMN GV 11 Ramsel
66,Bergstraat 71,2022-03-29,15:00:00,170,120,50,FMN GV 11 Ramsel
66,Bergstraat 71,2022-03-29,16:00:00,172,130,42,FMN GV 11 Ramsel
66,Bergstraat 71,2022-03-29,17:00:00,128,72,56,FMN GV 11 Ramsel
66,Bergstraat 71,2022-03-29,18:00:00,78,52,26,FMN GV 11 Ramsel
66,Bergstraat 71,2022-03-29,19:00:00,52,22,30,FMN GV 11 Ramsel
66,Bergstraat 71,2022-03-29,20:00:00,56,38,18,FMN GV 11 Ramsel
66,Bergstraat 71,2022-03-29,21:00:00,12,8,4,FMN GV 11 Ramsel
66,Bergstraat 71,2022-03-29,22:00:00,12,8,4,FMN GV 11 Ramsel
66,Bergstraat 71,2022-03-29,23:00:00,2,2,0,FMN GV 11 Ramsel
66,Bergstraat 71,2022-03-30,00:00:00,10,6,4,FMN GV 11 Ramsel
66,Bergstraat 71,2022-03-30,01:00:00,4,4,0,FMN GV 11 Ramsel
66,Bergstraat 71,2022-03-30,02:00:00,2,2,0,FMN GV 11 Ramsel
66,Bergstraat 71,2022-03-30,03:00:00,0,0,0,FMN GV 11 Ramsel
66,Bergstraat 71,2022-03-30,04:00:00,4,0,4,FMN GV 11 Ramsel
66,Bergstraat 71,2022-03-30,05:00:00,16,12,4,FMN GV 11 Ramsel
66,Bergstraat 71,2022-03-30,06:00:00,46,16,30,FMN GV 11 Ramsel
66,Bergstraat 71,2022-03-30,07:00:00,144,22,122,FMN GV 11 Ramsel
66,Bergstraat 71,2022-03-30,08:00:00,146,36,110,FMN GV 11 Ramsel
66,Bergstraat 71,2022-03-30,09:00:00,32,8,24,FMN GV 11 Ramsel
66,Bergstraat 71,2022-03-30,10:00:00,74,52,22,FMN GV 11 Ramsel
66,Bergstraat 71,2022-03-30,11:00:00,68,34,34,FMN GV 11 Ramsel
66,Bergstraat 71,2022-03-30,12:00:00,190,138,52,FMN GV 11 Ramsel
66,Bergstraat 71,2022-03-30,13:00:00,144,72,72,FMN GV 11 Ramsel
66,Bergstraat 71,2022-03-30,14:00:00,130,64,66,FMN GV 11 Ramsel
66,Bergstraat 71,2022-03-30,15:00:00,106,54,52,FMN GV 11 Ramsel
66,Bergstraat 71,2022-03-30,16:00:00,118,76,42,FMN GV 11 Ramsel
66,Bergstraat 71,2022-03-30,17:00:00,110,52,58,FMN GV 11 Ramsel
66,Bergstraat 71,2022-03-30,18:00:00,44,38,6,FMN GV 11 Ramsel
66,Bergstraat 71,2022-03-30,19:00:00,50,40,10,FMN GV 11 Ramsel
66,Bergstraat 71,2022-03-30,20:00:00,36,20,16,FMN GV 11 Ramsel
66,Bergstraat 71,2022-03-30,21:00:00,14,8,6,FMN GV 11 Ramsel
66,Bergstraat 71,2022-03-30,22:00:00,18,14,4,FMN GV 11 Ramsel
66,Bergstraat 71,2022-03-30,23:00:00,6,0,6,FMN GV 11 Ramsel
66,Bergstraat 71,2022-03-31,00:00:00,14,8,6,FMN GV 11 Ramsel
66,Bergstraat 71,2022-03-31,01:00:00,0,0,0,FMN GV 11 Ramsel
66,Bergstraat 71,2022-03-31,02:00:00,2,2,0,FMN GV 11 Ramsel
66,Bergstraat 71,2022-03-31,03:00:00,0,0,0,FMN GV 11 Ramsel
66,Bergstraat 71,2022-03-31,04:00:00,4,2,2,FMN GV 11 Ramsel
66,Bergstraat 71,2022-03-31,05:00:00,8,6,2,FMN GV 11 Ramsel
66,Bergstraat 71,2022-03-31,06:00:00,26,8,18,FMN GV 11 Ramsel
66,Bergstraat 71,2022-03-31,07:00:00,48,14,34,FMN GV 11 Ramsel
66,Bergstraat 71,2022-03-31,08:00:00,40,10,30,FMN GV 11 Ramsel
66,Bergstraat 71,2022-03-31,09:00:00,20,8,12,FMN GV 11 Ramsel
66,Bergstraat 71,2022-03-31,10:00:00,18,6,12,FMN GV 11 Ramsel
66,Bergstraat 71,2022-03-31,11:00:00,32,18,14,FMN GV 11 Ramsel
66,Bergstraat 71,2022-03-31,12:00:00,28,20,8,FMN GV 11 Ramsel
66,Bergstraat 71,2022-03-31,13:00:00,40,12,28,FMN GV 11 Ramsel
66,Bergstraat 71,2022-03-31,14:00:00,42,26,16,FMN GV 11 Ramsel
66,Bergstraat 71,2022-03-31,15:00:00,56,36,20,FMN GV 11 Ramsel
66,Bergstraat 71,2022-03-31,16:00:00,56,44,12,FMN GV 11 Ramsel
66,Bergstraat 71,2022-03-31,17:00:00,58,30,28,FMN GV 11 Ramsel
66,Bergstraat 71,2022-03-31,18:00:00,36,18,18,FMN GV 11 Ramsel
66,Bergstraat 71,2022-03-31,19:00:00,10,2,8,FMN GV 11 Ramsel
66,Bergstraat 71,2022-03-31,20:00:00,18,12,6,FMN GV 11 Ramsel
66,Bergstraat 71,2022-03-31,21:00:00,10,8,2,FMN GV 11 Ramsel
66,Bergstraat 71,2022-03-31,22:00:00,4,4,0,FMN GV 11 Ramsel
66,Bergstraat 71,2022-03-31,23:00:00,0,0,0,FMN GV 11 Ramsel
66,Bergstraat 71,2022-04-01,00:00:00,2,0,2,FMN GV 11 Ramsel
66,Bergstraat 71,2022-04-01,01:00:00,4,4,0,FMN GV 11 Ramsel
66,Bergstraat 71,2022-04-01,02:00:00,0,0,0,FMN GV 11 Ramsel
66,Bergstraat 71,2022-04-01,03:00:00,0,0,0,FMN GV 11 Ramsel
66,Bergstraat 71,2022-04-01,04:00:00,4,4,0,FMN GV 11 Ramsel
66,Bergstraat 71,2022-04-01,05:00:00,8,2,6,FMN GV 11 Ramsel
66,Bergstraat 71,2022-04-01,06:00:00,8,0,8,FMN GV 11 Ramsel
66,Bergstraat 71,2022-04-01,07:00:00,36,8,28,FMN GV 11 Ramsel
66,Bergstraat 71,2022-04-01,08:00:00,38,0,38,FMN GV 11 Ramsel
66,Bergstraat 71,2022-04-01,09:00:00,6,0,6,FMN GV 11 Ramsel
66,Bergstraat 71,2022-04-01,10:00:00,16,4,12,FMN GV 11 Ramsel
66,Bergstraat 71,2022-04-01,11:00:00,22,12,10,FMN GV 11 Ramsel
66,Bergstraat 71,2022-04-01,12:00:00,34,32,2,FMN GV 11 Ramsel
66,Bergstraat 71,2022-04-01,13:00:00,22,12,10,FMN GV 11 Ramsel
66,Bergstraat 71,2022-04-01,14:00:00,122,22,100,FMN GV 11 Ramsel
66,Bergstraat 71,2022-04-01,15:00:00,26,20,6,FMN GV 11 Ramsel
66,Bergstraat 71,2022-04-01,16:00:00,30,26,4,FMN GV 11 Ramsel
66,Bergstraat 71,2022-04-01,17:00:00,20,10,10,FMN GV 11 Ramsel
66,Bergstraat 71,2022-04-01,18:00:00,36,18,18,FMN GV 11 Ramsel
66,Bergstraat 71,2022-04-01,19:00:00,12,12,0,FMN GV 11 Ramsel
66,Bergstraat 71,2022-04-01,20:00:00,6,6,0,FMN GV 11 Ramsel
66,Bergstraat 71,2022-04-01,21:00:00,6,4,2,FMN GV 11 Ramsel
66,Bergstraat 71,2022-04-01,22:00:00,2,0,2,FMN GV 11 Ramsel
66,Bergstraat 71,2022-04-01,23:00:00,6,6,0,FMN GV 11 Ramsel
66,Bergstraat 71,2022-04-02,00:00:00,4,2,2,FMN GV 11 Ramsel
66,Bergstraat 71,2022-04-02,01:00:00,10,10,0,FMN GV 11 Ramsel
66,Bergstraat 71,2022-04-02,02:00:00,6,2,4,FMN GV 11 Ramsel
66,Bergstraat 71,2022-04-02,03:00:00,0,0,0,FMN GV 11 Ramsel
66,Bergstraat 71,2022-04-02,04:00:00,0,0,0,FMN GV 11 Ramsel
66,Bergstraat 71,2022-04-02,05:00:00,4,4,0,FMN GV 11 Ramsel
66,Bergstraat 71,2022-04-02,06:00:00,4,0,4,FMN GV 11 Ramsel
66,Bergstraat 71,2022-04-02,07:00:00,10,6,4,FMN GV 11 Ramsel
66,Bergstraat 71,2022-04-02,08:00:00,14,6,8,FMN GV 11 Ramsel
66,Bergstraat 71,2022-04-02,09:00:00,38,12,26,FMN GV 11 Ramsel
66,Bergstraat 71,2022-04-02,10:00:00,52,28,24,FMN GV 11 Ramsel
66,Bergstraat 71,2022-04-02,11:00:00,38,16,22,FMN GV 11 Ramsel
66,Bergstraat 71,2022-04-02,12:00:00,70,42,28,FMN GV 11 Ramsel
66,Bergstraat 71,2022-04-02,13:00:00,96,38,58,FMN GV 11 Ramsel
66,Bergstraat 71,2022-04-02,14:00:00,68,40,28,FMN GV 11 Ramsel
66,Bergstraat 71,2022-04-02,15:00:00,56,24,32,FMN GV 11 Ramsel
66,Bergstraat 71,2022-04-02,16:00:00,42,20,22,FMN GV 11 Ramsel
66,Bergstraat 71,2022-04-02,17:00:00,34,14,20,FMN GV 11 Ramsel
66,Bergstraat 71,2022-04-02,18:00:00,28,20,8,FMN GV 11 Ramsel
66,Bergstraat 71,2022-04-02,19:00:00,16,10,6,FMN GV 11 Ramsel
66,Bergstraat 71,2022-04-02,20:00:00,10,6,4,FMN GV 11 Ramsel
66,Bergstraat 71,2022-04-02,21:00:00,4,4,0,FMN GV 11 Ramsel
66,Bergstraat 71,2022-04-02,22:00:00,6,6,0,FMN GV 11 Ramsel
66,Bergstraat 71,2022-04-02,23:00:00,4,2,2,FMN GV 11 Ramsel
66,Bergstraat 71,2022-04-03,00:00:00,6,2,4,FMN GV 11 Ramsel
66,Bergstraat 71,2022-04-03,01:00:00,0,0,0,FMN GV 11 Ramsel
66,Bergstraat 71,2022-04-03,02:00:00,10,6,4,FMN GV 11 Ramsel
66,Bergstraat 71,2022-04-03,03:00:00,0,0,0,FMN GV 11 Ramsel
66,Bergstraat 71,2022-04-03,04:00:00,0,0,0,FMN GV 11 Ramsel
66,Bergstraat 71,2022-04-03,05:00:00,0,0,0,FMN GV 11 Ramsel
66,Bergstraat 71,2022-04-03,06:00:00,2,2,0,FMN GV 11 Ramsel
66,Bergstraat 71,2022-04-03,07:00:00,2,2,0,FMN GV 11 Ramsel
66,Bergstraat 71,2022-04-03,08:00:00,20,2,18,FMN GV 11 Ramsel
66,Bergstraat 71,2022-04-03,09:00:00,78,38,40,FMN GV 11 Ramsel
66,Bergstraat 71,2022-04-03,10:00:00,104,76,28,FMN GV 11 Ramsel
66,Bergstraat 71,2022-04-03,11:00:00,82,54,28,FMN GV 11 Ramsel
66,Bergstraat 71,2022-04-03,12:00:00,68,38,30,FMN GV 11 Ramsel
66,Bergstraat 71,2022-04-03,13:00:00,102,56,46,FMN GV 11 Ramsel
66,Bergstraat 71,2022-04-03,14:00:00,94,54,40,FMN GV 11 Ramsel
66,Bergstraat 71,2022-04-03,15:00:00,62,32,30,FMN GV 11 Ramsel
66,Bergstraat 71,2022-04-03,16:00:00,26,10,16,FMN GV 11 Ramsel
66,Bergstraat 71,2022-04-03,17:00:00,80,44,36,FMN GV 11 Ramsel
66,Bergstraat 71,2022-04-03,18:00:00,32,6,26,FMN GV 11 Ramsel
66,Bergstraat 71,2022-04-03,19:00:00,26,8,18,FMN GV 11 Ramsel
66,Bergstraat 71,2022-04-03,20:00:00,8,8,0,FMN GV 11 Ramsel
66,Bergstraat 71,2022-04-03,21:00:00,4,4,0,FMN GV 11 Ramsel
66,Bergstraat 71,2022-04-03,22:00:00,2,2,0,FMN GV 11 Ramsel
66,Bergstraat 71,2022-04-03,23:00:00,2,2,0,FMN GV 11 Ramsel
66,Bergstraat 71,2022-04-04,00:00:00,4,2,2,FMN GV 11 Ramsel
66,Bergstraat 71,2022-04-04,01:00:00,0,0,0,FMN GV 11 Ramsel
66,Bergstraat 71,2022-04-04,02:00:00,0,0,0,FMN GV 11 Ramsel
66,Bergstraat 71,2022-04-04,03:00:00,0,0,0,FMN GV 11 Ramsel
66,Bergstraat 71,2022-04-04,04:00:00,6,6,0,FMN GV 11 Ramsel
66,Bergstraat 71,2022-04-04,05:00:00,6,2,4,FMN GV 11 Ramsel
66,Bergstraat 71,2022-04-04,06:00:00,22,8,14,FMN GV 11 Ramsel
66,Bergstraat 71,2022-04-04,07:00:00,38,16,22,FMN GV 11 Ramsel
66,Bergstraat 71,2022-04-04,08:00:00,42,8,34,FMN GV 11 Ramsel
66,Bergstraat 71,2022-04-04,09:00:00,32,16,16,FMN GV 11 Ramsel
66,Bergstraat 71,2022-04-04,10:00:00,26,6,20,FMN GV 11 Ramsel
66,Bergstraat 71,2022-04-04,11:00:00,32,22,10,FMN GV 11 Ramsel
66,Bergstraat 71,2022-04-04,12:00:00,32,18,14,FMN GV 11 Ramsel
66,Bergstraat 71,2022-04-04,13:00:00,16,12,4,FMN GV 11 Ramsel
66,Bergstraat 71,2022-04-04,14:00:00,24,18,6,FMN GV 11 Ramsel
66,Bergstraat 71,2022-04-04,15:00:00,26,16,10,FMN GV 11 Ramsel
66,Bergstraat 71,2022-04-04,16:00:00,24,20,4,FMN GV 11 Ramsel
66,Bergstraat 71,2022-04-04,17:00:00,32,16,16,FMN GV 11 Ramsel
66,Bergstraat 71,2022-04-04,18:00:00,24,12,12,FMN GV 11 Ramsel
66,Bergstraat 71,2022-04-04,19:00:00,8,4,4,FMN GV 11 Ramsel
66,Bergstraat 71,2022-04-04,20:00:00,18,18,0,FMN GV 11 Ramsel
66,Bergstraat 71,2022-04-04,21:00:00,2,2,0,FMN GV 11 Ramsel
66,Bergstraat 71,2022-04-04,22:00:00,8,4,4,FMN GV 11 Ramsel
66,Bergstraat 71,2022-04-04,23:00:00,6,6,0,FMN GV 11 Ramsel
66,Bergstraat 71,2022-04-05,00:00:00,6,2,4,FMN GV 11 Ramsel
66,Bergstraat 71,2022-04-05,01:00:00,2,2,0,FMN GV 11 Ramsel
66,Bergstraat 71,2022-04-05,02:00:00,2,2,0,FMN GV 11 Ramsel
66,Bergstraat 71,2022-04-05,03:00:00,0,0,0,FMN GV 11 Ramsel
66,Bergstraat 71,2022-04-05,04:00:00,6,4,2,FMN GV 11 Ramsel
66,Bergstraat 71,2022-04-05,05:00:00,14,6,8,FMN GV 11 Ramsel
66,Bergstraat 71,2022-04-05,06:00:00,28,8,20,FMN GV 11 Ramsel
66,Bergstraat 71,2022-04-05,07:00:00,20,12,8,FMN GV 11 Ramsel
66,Bergstraat 71,2022-04-05,08:00:00,38,8,30,FMN GV 11 Ramsel
66,Bergstraat 71,2022-04-05,09:00:00,22,8,14,FMN GV 11 Ramsel
66,Bergstraat 71,2022-04-05,10:00:00,8,0,8,FMN GV 11 Ramsel
66,Bergstraat 71,2022-04-05,11:00:00,52,18,34,FMN GV 11 Ramsel
66,Bergstraat 71,2022-04-05,12:00:00,20,8,12,FMN GV 11 Ramsel
66,Bergstraat 71,2022-04-05,13:00:00,30,28,2,FMN GV 11 Ramsel
66,Bergstraat 71,2022-04-05,14:00:00,46,28,18,FMN GV 11 Ramsel
66,Bergstraat 71,2022-04-05,15:00:00,38,16,22,FMN GV 11 Ramsel
66,Bergstraat 71,2022-04-05,16:00:00,48,32,16,FMN GV 11 Ramsel
66,Bergstraat 71,2022-04-05,17:00:00,66,26,40,FMN GV 11 Ramsel
66,Bergstraat 71,2022-04-05,18:00:00,32,16,16,FMN GV 11 Ramsel
66,Bergstraat 71,2022-04-05,19:00:00,18,10,8,FMN GV 11 Ramsel
66,Bergstraat 71,2022-04-05,20:00:00,26,24,2,FMN GV 11 Ramsel
66,Bergstraat 71,2022-04-05,21:00:00,16,10,6,FMN GV 11 Ramsel
66,Bergstraat 71,2022-04-05,22:00:00,14,10,4,FMN GV 11 Ramsel
66,Bergstraat 71,2022-04-05,23:00:00,12,8,4,FMN GV 11 Ramsel
66,Bergstraat 71,2022-04-06,00:00:00,2,2,0,FMN GV 11 Ramsel
66,Bergstraat 71,2022-04-06,01:00:00,4,4,0,FMN GV 11 Ramsel
66,Bergstraat 71,2022-04-06,02:00:00,4,2,2,FMN GV 11 Ramsel
66,Bergstraat 71,2022-04-06,03:00:00,0,0,0,FMN GV 11 Ramsel
66,Bergstraat 71,2022-04-06,04:00:00,4,4,0,FMN GV 11 Ramsel
66,Bergstraat 71,2022-04-06,05:00:00,12,8,4,FMN GV 11 Ramsel
66,Bergstraat 71,2022-04-06,06:00:00,24,4,20,FMN GV 11 Ramsel
66,Bergstraat 71,2022-04-06,07:00:00,32,16,16,FMN GV 11 Ramsel
66,Bergstraat 71,2022-04-06,08:00:00,40,16,24,FMN GV 11 Ramsel
66,Bergstraat 71,2022-04-06,09:00:00,24,16,8,FMN GV 11 Ramsel
66,Bergstraat 71,2022-04-06,10:00:00,58,22,36,FMN GV 11 Ramsel
66,Bergstraat 71,2022-04-06,11:00:00,64,34,30,FMN GV 11 Ramsel
66,Bergstraat 71,2022-04-06,12:00:00,38,30,8,FMN GV 11 Ramsel
66,Bergstraat 71,2022-04-06,13:00:00,38,16,22,FMN GV 11 Ramsel
66,Bergstraat 71,2022-04-06,14:00:00,38,28,10,FMN GV 11 Ramsel
66,Bergstraat 71,2022-04-06,15:00:00,40,28,12,FMN GV 11 Ramsel
66,Bergstraat 71,2022-04-06,16:00:00,50,24,26,FMN GV 11 Ramsel
66,Bergstraat 71,2022-04-06,17:00:00,40,20,20,FMN GV 11 Ramsel
66,Bergstraat 71,2022-04-06,18:00:00,24,16,8,FMN GV 11 Ramsel
66,Bergstraat 71,2022-04-06,19:00:00,12,8,4,FMN GV 11 Ramsel
66,Bergstraat 71,2022-04-06,20:00:00,12,8,4,FMN GV 11 Ramsel
66,Bergstraat 71,2022-04-06,21:00:00,4,2,2,FMN GV 11 Ramsel
66,Bergstraat 71,2022-04-06,22:00:00,10,4,6,FMN GV 11 Ramsel
66,Bergstraat 71,2022-04-06,23:00:00,4,4,0,FMN GV 11 Ramsel
66,Bergstraat 71,2022-04-07,00:00:00,2,0,2,FMN GV 11 Ramsel
66,Bergstraat 71,2022-04-07,01:00:00,4,4,0,FMN GV 11 Ramsel
66,Bergstraat 71,2022-04-07,02:00:00,0,0,0,FMN GV 11 Ramsel
66,Bergstraat 71,2022-04-07,03:00:00,0,0,0,FMN GV 11 Ramsel
66,Bergstraat 71,2022-04-07,04:00:00,2,0,2,FMN GV 11 Ramsel
66,Bergstraat 71,2022-04-07,05:00:00,4,2,2,FMN GV 11 Ramsel
66,Bergstraat 71,2022-04-07,06:00:00,18,6,12,FMN GV 11 Ramsel
66,Bergstraat 71,2022-04-07,07:00:00,22,10,12,FMN GV 11 Ramsel
66,Bergstraat 71,2022-04-07,08:00:00,16,6,10,FMN GV 11 Ramsel
66,Bergstraat 71,2022-04-07,09:00:00,2,2,0,FMN GV 11 Ramsel
66,Bergstraat 71,2022-04-07,10:00:00,0,0,0,FMN GV 11 Ramsel
66,Bergstraat 71,2022-04-07,11:00:00,8,4,4,FMN GV 11 Ramsel
66,Bergstraat 71,2022-04-07,12:00:00,26,10,16,FMN GV 11 Ramsel
66,Bergstraat 71,2022-04-07,13:00:00,26,14,12,FMN GV 11 Ramsel
66,Bergstraat 71,2022-04-07,14:00:00,44,18,26,FMN GV 11 Ramsel
66,Bergstraat 71,2022-04-07,15:00:00,26,14,12,FMN GV 11 Ramsel
66,Bergstraat 71,2022-04-07,16:00:00,52,36,16,FMN GV 11 Ramsel
66,Bergstraat 71,2022-04-07,17:00:00,28,16,12,FMN GV 11 Ramsel
66,Bergstraat 71,2022-04-07,18:00:00,24,8,16,FMN GV 11 Ramsel
66,Bergstraat 71,2022-04-07,19:00:00,20,10,10,FMN GV 11 Ramsel
66,Bergstraat 71,2022-04-07,20:00:00,10,6,4,FMN GV 11 Ramsel
66,Bergstraat 71,2022-04-07,21:00:00,16,12,4,FMN GV 11 Ramsel
66,Bergstraat 71,2022-04-07,22:00:00,10,4,6,FMN GV 11 Ramsel
66,Bergstraat 71,2022-04-07,23:00:00,0,0,0,FMN GV 11 Ramsel
66,Bergstraat 71,2022-04-08,00:00:00,6,0,6,FMN GV 11 Ramsel
66,Bergstraat 71,2022-04-08,01:00:00,4,4,0,FMN GV 11 Ramsel
66,Bergstraat 71,2022-04-08,02:00:00,0,0,0,FMN GV 11 Ramsel
66,Bergstraat 71,2022-04-08,03:00:00,0,0,0,FMN GV 11 Ramsel
66,Bergstraat 71,2022-04-08,04:00:00,2,2,0,FMN GV 11 Ramsel
66,Bergstraat 71,2022-04-08,05:00:00,10,4,6,FMN GV 11 Ramsel
66,Bergstraat 71,2022-04-08,06:00:00,24,10,14,FMN GV 11 Ramsel
66,Bergstraat 71,2022-04-08,07:00:00,22,12,10,FMN GV 11 Ramsel
66,Bergstraat 71,2022-04-08,08:00:00,22,8,14,FMN GV 11 Ramsel
66,Bergstraat 71,2022-04-08,09:00:00,36,12,24,FMN GV 11 Ramsel
66,Bergstraat 71,2022-04-08,10:00:00,60,24,36,FMN GV 11 Ramsel
66,Bergstraat 71,2022-04-08,11:00:00,72,38,34,FMN GV 11 Ramsel
66,Bergstraat 71,2022-04-08,12:00:00,48,32,16,FMN GV 11 Ramsel
66,Bergstraat 71,2022-04-08,13:00:00,66,24,42,FMN GV 11 Ramsel
66,Bergstraat 71,2022-04-08,14:00:00,74,20,54,FMN GV 11 Ramsel
66,Bergstraat 71,2022-04-08,15:00:00,64,34,30,FMN GV 11 Ramsel
66,Bergstraat 71,2022-04-08,16:00:00,62,36,26,FMN GV 11 Ramsel
66,Bergstraat 71,2022-04-08,17:00:00,52,22,30,FMN GV 11 Ramsel
66,Bergstraat 71,2022-04-08,18:00:00,52,26,26,FMN GV 11 Ramsel
66,Bergstraat 71,2022-04-08,19:00:00,28,14,14,FMN GV 11 Ramsel
66,Bergstraat 71,2022-04-08,20:00:00,30,16,14,FMN GV 11 Ramsel
66,Bergstraat 71,2022-04-08,21:00:00,8,6,2,FMN GV 11 Ramsel
66,Bergstraat 71,2022-04-08,22:00:00,16,12,4,FMN GV 11 Ramsel
66,Bergstraat 71,2022-04-08,23:00:00,6,2,4,FMN GV 11 Ramsel
66,Bergstraat 71,2022-04-09,00:00:00,6,2,4,FMN GV 11 Ramsel
66,Bergstraat 71,2022-04-09,01:00:00,2,2,0,FMN GV 11 Ramsel
66,Bergstraat 71,2022-04-09,02:00:00,6,4,2,FMN GV 11 Ramsel
66,Bergstraat 71,2022-04-09,03:00:00,4,2,2,FMN GV 11 Ramsel
66,Bergstraat 71,2022-04-09,04:00:00,2,2,0,FMN GV 11 Ramsel
66,Bergstraat 71,2022-04-09,05:00:00,4,0,4,FMN GV 11 Ramsel
66,Bergstraat 71,2022-04-09,06:00:00,2,0,2,FMN GV 11 Ramsel
66,Bergstraat 71,2022-04-09,07:00:00,16,8,8,FMN GV 11 Ramsel
66,Bergstraat 71,2022-04-09,08:00:00,24,4,20,FMN GV 11 Ramsel
66,Bergstraat 71,2022-04-09,09:00:00,42,14,28,FMN GV 11 Ramsel
66,Bergstraat 71,2022-04-09,10:00:00,88,30,58,FMN GV 11 Ramsel
66,Bergstraat 71,2022-04-09,11:00:00,58,32,26,FMN GV 11 Ramsel
66,Bergstraat 71,2022-04-09,12:00:00,88,52,36,FMN GV 11 Ramsel
66,Bergstraat 71,2022-04-09,13:00:00,92,46,46,FMN GV 11 Ramsel
66,Bergstraat 71,2022-04-09,14:00:00,94,32,62,FMN GV 11 Ramsel
66,Bergstraat 71,2022-04-09,15:00:00,84,52,32,FMN GV 11 Ramsel
66,Bergstraat 71,2022-04-09,16:00:00,56,32,24,FMN GV 11 Ramsel
66,Bergstraat 71,2022-04-09,17:00:00,58,34,24,FMN GV 11 Ramsel
66,Bergstraat 71,2022-04-09,18:00:00,38,22,16,FMN GV 11 Ramsel
66,Bergstraat 71,2022-04-09,19:00:00,30,10,20,FMN GV 11 Ramsel
66,Bergstraat 71,2022-04-09,20:00:00,6,4,2,FMN GV 11 Ramsel
66,Bergstraat 71,2022-04-09,21:00:00,8,6,2,FMN GV 11 Ramsel
66,Bergstraat 71,2022-04-09,22:00:00,10,6,4,FMN GV 11 Ramsel
66,Bergstraat 71,2022-04-09,23:00:00,2,2,0,FMN GV 11 Ramsel
66,Bergstraat 71,2022-04-10,00:00:00,4,2,2,FMN GV 11 Ramsel
66,Bergstraat 71,2022-04-10,01:00:00,4,4,0,FMN GV 11 Ramsel
66,Bergstraat 71,2022-04-10,02:00:00,4,4,0,FMN GV 11 Ramsel
66,Bergstraat 71,2022-04-10,03:00:00,6,6,0,FMN GV 11 Ramsel
66,Bergstraat 71,2022-04-10,04:00:00,6,2,4,FMN GV 11 Ramsel
66,Bergstraat 71,2022-04-10,05:00:00,0,0,0,FMN GV 11 Ramsel
66,Bergstraat 71,2022-04-10,06:00:00,4,0,4,FMN GV 11 Ramsel
66,Bergstraat 71,2022-04-10,07:00:00,14,2,12,FMN GV 11 Ramsel
66,Bergstraat 71,2022-04-10,08:00:00,46,8,38,FMN GV 11 Ramsel
66,Bergstraat 71,2022-04-10,09:00:00,82,20,62,FMN GV 11 Ramsel
66,Bergstraat 71,2022-04-10,10:00:00,180,92,88,FMN GV 11 Ramsel
66,Bergstraat 71,2022-04-10,11:00:00,162,100,62,FMN GV 11 Ramsel
66,Bergstraat 71,2022-04-10,12:00:00,144,82,62,FMN GV 11 Ramsel
66,Bergstraat 71,2022-04-10,13:00:00,196,88,108,FMN GV 11 Ramsel
66,Bergstraat 71,2022-04-10,14:00:00,222,122,100,FMN GV 11 Ramsel
66,Bergstraat 71,2022-04-10,15:00:00,160,92,68,FMN GV 11 Ramsel
66,Bergstraat 71,2022-04-10,16:00:00,124,68,56,FMN GV 11 Ramsel
66,Bergstraat 71,2022-04-10,17:00:00,78,52,26,FMN GV 11 Ramsel
66,Bergstraat 71,2022-04-10,18:00:00,44,22,22,FMN GV 11 Ramsel
66,Bergstraat 71,2022-04-10,19:00:00,68,34,34,FMN GV 11 Ramsel
66,Bergstraat 71,2022-04-10,20:00:00,32,14,18,FMN GV 11 Ramsel
66,Bergstraat 71,2022-04-10,21:00:00,14,10,4,FMN GV 11 Ramsel
66,Bergstraat 71,2022-04-10,22:00:00,8,4,4,FMN GV 11 Ramsel
66,Bergstraat 71,2022-04-10,23:00:00,2,2,0,FMN GV 11 Ramsel
66,Bergstraat 71,2022-04-11,00:00:00,4,4,0,FMN GV 11 Ramsel
66,Bergstraat 71,2022-04-11,01:00:00,4,0,4,FMN GV 11 Ramsel
66,Bergstraat 71,2022-04-11,02:00:00,0,0,0,FMN GV 11 Ramsel
66,Bergstraat 71,2022-04-11,03:00:00,0,0,0,FMN GV 11 Ramsel
66,Bergstraat 71,2022-04-11,04:00:00,6,2,4,FMN GV 11 Ramsel
66,Bergstraat 71,2022-04-11,05:00:00,20,12,8,FMN GV 11 Ramsel
66,Bergstraat 71,2022-04-11,06:00:00,32,12,20,FMN GV 11 Ramsel
66,Bergstraat 71,2022-04-11,07:00:00,46,20,26,FMN GV 11 Ramsel
66,Bergstraat 71,2022-04-11,08:00:00,48,14,34,FMN GV 11 Ramsel
66,Bergstraat 71,2022-04-11,09:00:00,44,16,28,FMN GV 11 Ramsel
66,Bergstraat 71,2022-04-11,10:00:00,120,86,34,FMN GV 11 Ramsel
66,Bergstraat 71,2022-04-11,11:00:00,80,44,36,FMN GV 11 Ramsel
66,Bergstraat 71,2022-04-11,12:00:00,90,46,44,FMN GV 11 Ramsel
66,Bergstraat 71,2022-04-11,13:00:00,174,74,100,FMN GV 11 Ramsel
66,Bergstraat 71,2022-04-11,14:00:00,226,128,98,FMN GV 11 Ramsel
66,Bergstraat 71,2022-04-11,15:00:00,182,98,84,FMN GV 11 Ramsel
66,Bergstraat 71,2022-04-11,16:00:00,140,76,64,FMN GV 11 Ramsel
66,Bergstraat 71,2022-04-11,17:00:00,116,72,44,FMN GV 11 Ramsel
66,Bergstraat 71,2022-04-11,18:00:00,74,36,38,FMN GV 11 Ramsel
66,Bergstraat 71,2022-04-11,19:00:00,62,32,30,FMN GV 11 Ramsel
66,Bergstraat 71,2022-04-11,20:00:00,36,22,14,FMN GV 11 Ramsel
66,Bergstraat 71,2022-04-11,21:00:00,12,10,2,FMN GV 11 Ramsel
66,Bergstraat 71,2022-04-11,22:00:00,10,8,2,FMN GV 11 Ramsel
66,Bergstraat 71,2022-04-11,23:00:00,4,2,2,FMN GV 11 Ramsel
66,Bergstraat 71,2022-04-12,00:00:00,6,0,6,FMN GV 11 Ramsel
66,Bergstraat 71,2022-04-12,01:00:00,0,0,0,FMN GV 11 Ramsel
66,Bergstraat 71,2022-04-12,02:00:00,4,4,0,FMN GV 11 Ramsel
66,Bergstraat 71,2022-04-12,03:00:00,2,2,0,FMN GV 11 Ramsel
66,Bergstraat 71,2022-04-12,04:00:00,6,4,2,FMN GV 11 Ramsel
66,Bergstraat 71,2022-04-12,05:00:00,16,8,8,FMN GV 11 Ramsel
66,Bergstraat 71,2022-04-12,06:00:00,36,14,22,FMN GV 11 Ramsel
66,Bergstraat 71,2022-04-12,07:00:00,50,20,30,FMN GV 11 Ramsel
66,Bergstraat 71,2022-04-12,08:00:00,40,14,26,FMN GV 11 Ramsel
66,Bergstraat 71,2022-04-12,09:00:00,60,22,38,FMN GV 11 Ramsel
66,Bergstraat 71,2022-04-12,10:00:00,134,38,96,FMN GV 11 Ramsel
66,Bergstraat 71,2022-04-12,11:00:00,92,34,58,FMN GV 11 Ramsel
66,Bergstraat 71,2022-04-12,12:00:00,196,76,120,FMN GV 11 Ramsel
66,Bergstraat 71,2022-04-12,13:00:00,346,106,240,FMN GV 11 Ramsel
66,Bergstraat 71,2022-04-12,14:00:00,312,156,156,FMN GV 11 Ramsel
66,Bergstraat 71,2022-04-12,15:00:00,322,202,120,FMN GV 11 Ramsel
66,Bergstraat 71,2022-04-12,16:00:00,244,124,120,FMN GV 11 Ramsel
66,Bergstraat 71,2022-04-12,17:00:00,274,166,108,FMN GV 11 Ramsel
66,Bergstraat 71,2022-04-12,18:00:00,168,98,70,FMN GV 11 Ramsel
66,Bergstraat 71,2022-04-12,19:00:00,82,48,34,FMN GV 11 Ramsel
66,Bergstraat 71,2022-04-12,20:00:00,76,52,24,FMN GV 11 Ramsel
66,Bergstraat 71,2022-04-12,21:00:00,16,8,8,FMN GV 11 Ramsel
66,Bergstraat 71,2022-04-12,22:00:00,14,12,2,FMN GV 11 Ramsel
66,Bergstraat 71,2022-04-12,23:00:00,8,8,0,FMN GV 11 Ramsel
66,Bergstraat 71,2022-04-13,00:00:00,4,0,4,FMN GV 11 Ramsel
66,Bergstraat 71,2022-04-13,01:00:00,0,0,0,FMN GV 11 Ramsel
66,Bergstraat 71,2022-04-13,02:00:00,10,10,0,FMN GV 11 Ramsel
66,Bergstraat 71,2022-04-13,03:00:00,0,0,0,FMN GV 11 Ramsel
66,Bergstraat 71,2022-04-13,04:00:00,6,4,2,FMN GV 11 Ramsel
66,Bergstraat 71,2022-04-13,05:00:00,16,6,10,FMN GV 11 Ramsel
66,Bergstraat 71,2022-04-13,06:00:00,26,12,14,FMN GV 11 Ramsel
66,Bergstraat 71,2022-04-13,07:00:00,50,16,34,FMN GV 11 Ramsel
66,Bergstraat 71,2022-04-13,08:00:00,58,22,36,FMN GV 11 Ramsel
66,Bergstraat 71,2022-04-13,09:00:00,52,26,26,FMN GV 11 Ramsel
66,Bergstraat 71,2022-04-13,10:00:00,60,24,36,FMN GV 11 Ramsel
66,Bergstraat 71,2022-04-13,11:00:00,58,26,32,FMN GV 11 Ramsel
66,Bergstraat 71,2022-04-13,12:00:00,40,20,20,FMN GV 11 Ramsel
66,Bergstraat 71,2022-04-13,13:00:00,54,40,14,FMN GV 11 Ramsel
66,Bergstraat 71,2022-04-13,14:00:00,52,28,24,FMN GV 11 Ramsel
66,Bergstraat 71,2022-04-13,15:00:00,66,28,38,FMN GV 11 Ramsel
66,Bergstraat 71,2022-04-13,16:00:00,82,56,26,FMN GV 11 Ramsel
66,Bergstraat 71,2022-04-13,17:00:00,92,52,40,FMN GV 11 Ramsel
66,Bergstraat 71,2022-04-13,18:00:00,50,36,14,FMN GV 11 Ramsel
66,Bergstraat 71,2022-04-13,19:00:00,42,30,12,FMN GV 11 Ramsel
66,Bergstraat 71,2022-04-13,20:00:00,30,18,12,FMN GV 11 Ramsel
66,Bergstraat 71,2022-04-13,21:00:00,6,2,4,FMN GV 11 Ramsel
66,Bergstraat 71,2022-04-13,22:00:00,14,12,2,FMN GV 11 Ramsel
66,Bergstraat 71,2022-04-13,23:00:00,6,2,4,FMN GV 11 Ramsel
66,Bergstraat 71,2022-04-14,00:00:00,2,2,0,FMN GV 11 Ramsel
66,Bergstraat 71,2022-04-14,01:00:00,8,6,2,FMN GV 11 Ramsel
66,Bergstraat 71,2022-04-14,02:00:00,0,0,0,FMN GV 11 Ramsel
66,Bergstraat 71,2022-04-14,03:00:00,0,0,0,FMN GV 11 Ramsel
66,Bergstraat 71,2022-04-14,04:00:00,2,2,0,FMN GV 11 Ramsel
66,Bergstraat 71,2022-04-14,05:00:00,22,14,8,FMN GV 11 Ramsel
66,Bergstraat 71,2022-04-14,06:00:00,22,10,12,FMN GV 11 Ramsel
66,Bergstraat 71,2022-04-14,07:00:00,50,20,30,FMN GV 11 Ramsel
66,Bergstraat 71,2022-04-14,08:00:00,50,26,24,FMN GV 11 Ramsel
66,Bergstraat 71,2022-04-14,09:00:00,82,24,58,FMN GV 11 Ramsel
66,Bergstraat 71,2022-04-14,10:00:00,88,40,48,FMN GV 11 Ramsel
66,Bergstraat 71,2022-04-14,11:00:00,86,58,28,FMN GV 11 Ramsel
66,Bergstraat 71,2022-04-14,12:00:00,170,86,84,FMN GV 11 Ramsel
66,Bergstraat 71,2022-04-14,13:00:00,226,78,148,FMN GV 11 Ramsel
66,Bergstraat 71,2022-04-14,14:00:00,228,130,98,FMN GV 11 Ramsel
66,Bergstraat 71,2022-04-14,15:00:00,226,132,94,FMN GV 11 Ramsel
66,Bergstraat 71,2022-04-14,16:00:00,140,82,58,FMN GV 11 Ramsel
66,Bergstraat 71,2022-04-14,17:00:00,156,70,86,FMN GV 11 Ramsel
66,Bergstraat 71,2022-04-14,18:00:00,86,44,42,FMN GV 11 Ramsel
66,Bergstraat 71,2022-04-14,19:00:00,64,26,38,FMN GV 11 Ramsel
66,Bergstraat 71,2022-04-14,20:00:00,48,24,24,FMN GV 11 Ramsel
66,Bergstraat 71,2022-04-14,21:00:00,38,24,14,FMN GV 11 Ramsel
66,Bergstraat 71,2022-04-14,22:00:00,22,16,6,FMN GV 11 Ramsel
66,Bergstraat 71,2022-04-14,23:00:00,4,4,0,FMN GV 11 Ramsel
66,Bergstraat 71,2022-04-15,00:00:00,8,4,4,FMN GV 11 Ramsel
66,Bergstraat 71,2022-04-15,01:00:00,2,0,2,FMN GV 11 Ramsel
66,Bergstraat 71,2022-04-15,02:00:00,6,4,2,FMN GV 11 Ramsel
66,Bergstraat 71,2022-04-15,03:00:00,0,0,0,FMN GV 11 Ramsel
66,Bergstraat 71,2022-04-15,04:00:00,6,4,2,FMN GV 11 Ramsel
66,Bergstraat 71,2022-04-15,05:00:00,14,8,6,FMN GV 11 Ramsel
66,Bergstraat 71,2022-04-15,06:00:00,22,10,12,FMN GV 11 Ramsel
66,Bergstraat 71,2022-04-15,07:00:00,50,24,26,FMN GV 11 Ramsel
66,Bergstraat 71,2022-04-15,08:00:00,34,14,20,FMN GV 11 Ramsel
66,Bergstraat 71,2022-04-15,09:00:00,82,30,52,FMN GV 11 Ramsel
66,Bergstraat 71,2022-04-15,10:00:00,88,38,50,FMN GV 11 Ramsel
66,Bergstraat 71,2022-04-15,11:00:00,90,36,54,FMN GV 11 Ramsel
66,Bergstraat 71,2022-04-15,12:00:00,92,44,48,FMN GV 11 Ramsel
66,Bergstraat 71,2022-04-15,13:00:00,128,66,62,FMN GV 11 Ramsel
66,Bergstraat 71,2022-04-15,14:00:00,202,82,120,FMN GV 11 Ramsel
66,Bergstraat 71,2022-04-15,15:00:00,212,104,108,FMN GV 11 Ramsel
66,Bergstraat 71,2022-04-15,16:00:00,202,108,94,FMN GV 11 Ramsel
66,Bergstraat 71,2022-04-15,17:00:00,174,100,74,FMN GV 11 Ramsel
66,Bergstraat 71,2022-04-15,18:00:00,92,60,32,FMN GV 11 Ramsel
66,Bergstraat 71,2022-04-15,19:00:00,70,28,42,FMN GV 11 Ramsel
66,Bergstraat 71,2022-04-15,20:00:00,50,22,28,FMN GV 11 Ramsel
66,Bergstraat 71,2022-04-15,21:00:00,26,14,12,FMN GV 11 Ramsel
66,Bergstraat 71,2022-04-15,22:00:00,20,12,8,FMN GV 11 Ramsel
66,Bergstraat 71,2022-04-15,23:00:00,58,6,52,FMN GV 11 Ramsel
66,Bergstraat 71,2022-04-16,00:00:00,2,2,0,FMN GV 11 Ramsel
66,Bergstraat 71,2022-04-16,01:00:00,4,4,0,FMN GV 11 Ramsel
66,Bergstraat 71,2022-04-16,02:00:00,32,26,6,FMN GV 11 Ramsel
66,Bergstraat 71,2022-04-16,03:00:00,10,10,0,FMN GV 11 Ramsel
66,Bergstraat 71,2022-04-16,04:00:00,28,28,0,FMN GV 11 Ramsel
66,Bergstraat 71,2022-04-16,05:00:00,16,14,2,FMN GV 11 Ramsel
66,Bergstraat 71,2022-04-16,06:00:00,4,0,4,FMN GV 11 Ramsel
66,Bergstraat 71,2022-04-16,07:00:00,18,6,12,FMN GV 11 Ramsel
66,Bergstraat 71,2022-04-16,08:00:00,22,4,18,FMN GV 11 Ramsel
66,Bergstraat 71,2022-04-16,09:00:00,68,22,46,FMN GV 11 Ramsel
66,Bergstraat 71,2022-04-16,10:00:00,124,56,68,FMN GV 11 Ramsel
66,Bergstraat 71,2022-04-16,11:00:00,96,32,64,FMN GV 11 Ramsel
66,Bergstraat 71,2022-04-16,12:00:00,156,82,74,FMN GV 11 Ramsel
66,Bergstraat 71,2022-04-16,13:00:00,250,94,156,FMN GV 11 Ramsel
66,Bergstraat 71,2022-04-16,14:00:00,284,152,132,FMN GV 11 Ramsel
66,Bergstraat 71,2022-04-16,15:00:00,328,188,140,FMN GV 11 Ramsel
66,Bergstraat 71,2022-04-16,16:00:00,178,110,68,FMN GV 11 Ramsel
66,Bergstraat 71,2022-04-16,17:00:00,176,108,68,FMN GV 11 Ramsel
66,Bergstraat 71,2022-04-16,18:00:00,82,36,46,FMN GV 11 Ramsel
66,Bergstraat 71,2022-04-16,19:00:00,30,16,14,FMN GV 11 Ramsel
66,Bergstraat 71,2022-04-16,20:00:00,20,12,8,FMN GV 11 Ramsel
66,Bergstraat 71,2022-04-16,21:00:00,18,8,10,FMN GV 11 Ramsel
66,Bergstraat 71,2022-04-16,22:00:00,20,10,10,FMN GV 11 Ramsel
66,Bergstraat 71,2022-04-16,23:00:00,6,6,0,FMN GV 11 Ramsel
66,Bergstraat 71,2022-04-17,00:00:00,2,2,0,FMN GV 11 Ramsel
66,Bergstraat 71,2022-04-17,01:00:00,6,4,2,FMN GV 11 Ramsel
66,Bergstraat 71,2022-04-17,02:00:00,4,4,0,FMN GV 11 Ramsel
66,Bergstraat 71,2022-04-17,03:00:00,2,0,2,FMN GV 11 Ramsel
66,Bergstraat 71,2022-04-17,04:00:00,0,0,0,FMN GV 11 Ramsel
66,Bergstraat 71,2022-04-17,05:00:00,0,0,0,FMN GV 11 Ramsel
66,Bergstraat 71,2022-04-17,06:00:00,8,2,6,FMN GV 11 Ramsel
66,Bergstraat 71,2022-04-17,07:00:00,14,2,12,FMN GV 11 Ramsel
66,Bergstraat 71,2022-04-17,08:00:00,36,16,20,FMN GV 11 Ramsel
66,Bergstraat 71,2022-04-17,09:00:00,122,62,60,FMN GV 11 Ramsel
66,Bergstraat 71,2022-04-17,10:00:00,194,110,84,FMN GV 11 Ramsel
66,Bergstraat 71,2022-04-17,11:00:00,222,124,98,FMN GV 11 Ramsel
66,Bergstraat 71,2022-04-17,12:00:00,170,86,84,FMN GV 11 Ramsel
66,Bergstraat 71,2022-04-17,13:00:00,188,70,118,FMN GV 11 Ramsel
66,Bergstraat 71,2022-04-17,14:00:00,242,116,126,FMN GV 11 Ramsel
66,Bergstraat 71,2022-04-17,15:00:00,202,100,102,FMN GV 11 Ramsel
66,Bergstraat 71,2022-04-17,16:00:00,178,96,82,FMN GV 11 Ramsel
66,Bergstraat 71,2022-04-17,17:00:00,118,68,50,FMN GV 11 Ramsel
66,Bergstraat 71,2022-04-17,18:00:00,104,42,62,FMN GV 11 Ramsel
66,Bergstraat 71,2022-04-17,19:00:00,76,20,56,FMN GV 11 Ramsel
66,Bergstraat 71,2022-04-17,20:00:00,44,20,24,FMN GV 11 Ramsel
66,Bergstraat 71,2022-04-17,21:00:00,24,16,8,FMN GV 11 Ramsel
66,Bergstraat 71,2022-04-17,22:00:00,12,10,2,FMN GV 11 Ramsel
66,Bergstraat 71,2022-04-17,23:00:00,4,2,2,FMN GV 11 Ramsel
66,Bergstraat 71,2022-04-18,00:00:00,2,0,2,FMN GV 11 Ramsel
66,Bergstraat 71,2022-04-18,01:00:00,6,2,4,FMN GV 11 Ramsel
66,Bergstraat 71,2022-04-18,02:00:00,0,0,0,FMN GV 11 Ramsel
66,Bergstraat 71,2022-04-18,03:00:00,0,0,0,FMN GV 11 Ramsel
66,Bergstraat 71,2022-04-18,04:00:00,0,0,0,FMN GV 11 Ramsel
66,Bergstraat 71,2022-04-18,05:00:00,4,4,0,FMN GV 11 Ramsel
66,Bergstraat 71,2022-04-18,06:00:00,6,2,4,FMN GV 11 Ramsel
66,Bergstraat 71,2022-04-18,07:00:00,16,6,10,FMN GV 11 Ramsel
66,Bergstraat 71,2022-04-18,08:00:00,42,14,28,FMN GV 11 Ramsel
66,Bergstraat 71,2022-04-18,09:00:00,92,32,60,FMN GV 11 Ramsel
66,Bergstraat 71,2022-04-18,10:00:00,188,78,110,FMN GV 11 Ramsel
66,Bergstraat 71,2022-04-18,11:00:00,140,68,72,FMN GV 11 Ramsel
66,Bergstraat 71,2022-04-18,12:00:00,240,128,112,FMN GV 11 Ramsel
66,Bergstraat 71,2022-04-18,13:00:00,332,158,174,FMN GV 11 Ramsel
66,Bergstraat 71,2022-04-18,14:00:00,440,220,220,FMN GV 11 Ramsel
66,Bergstraat 71,2022-04-18,15:00:00,320,186,134,FMN GV 11 Ramsel
66,Bergstraat 71,2022-04-18,16:00:00,336,188,148,FMN GV 11 Ramsel
66,Bergstraat 71,2022-04-18,17:00:00,198,68,130,FMN GV 11 Ramsel
66,Bergstraat 71,2022-04-18,18:00:00,120,54,66,FMN GV 11 Ramsel
66,Bergstraat 71,2022-04-18,19:00:00,114,58,56,FMN GV 11 Ramsel
66,Bergstraat 71,2022-04-18,20:00:00,26,8,18,FMN GV 11 Ramsel
66,Bergstraat 71,2022-04-18,21:00:00,18,8,10,FMN GV 11 Ramsel
66,Bergstraat 71,2022-04-18,22:00:00,12,10,2,FMN GV 11 Ramsel
66,Bergstraat 71,2022-04-18,23:00:00,6,2,4,FMN GV 11 Ramsel
66,Bergstraat 71,2022-04-19,00:00:00,0,0,0,FMN GV 11 Ramsel
66,Bergstraat 71,2022-04-19,01:00:00,0,0,0,FMN GV 11 Ramsel
66,Bergstraat 71,2022-04-19,02:00:00,4,4,0,FMN GV 11 Ramsel
66,Bergstraat 71,2022-04-19,03:00:00,2,0,2,FMN GV 11 Ramsel
66,Bergstraat 71,2022-04-19,04:00:00,6,4,2,FMN GV 11 Ramsel
66,Bergstraat 71,2022-04-19,05:00:00,22,10,12,FMN GV 11 Ramsel
66,Bergstraat 71,2022-04-19,06:00:00,52,14,38,FMN GV 11 Ramsel
66,Bergstraat 71,2022-04-19,07:00:00,284,48,236,FMN GV 11 Ramsel
66,Bergstraat 71,2022-04-19,08:00:00,220,44,176,FMN GV 11 Ramsel
66,Bergstraat 71,2022-04-19,09:00:00,80,26,54,FMN GV 11 Ramsel
66,Bergstraat 71,2022-04-19,10:00:00,60,26,34,FMN GV 11 Ramsel
66,Bergstraat 71,2022-04-19,11:00:00,142,44,98,FMN GV 11 Ramsel
66,Bergstraat 71,2022-04-19,12:00:00,154,86,68,FMN GV 11 Ramsel
66,Bergstraat 71,2022-04-19,13:00:00,272,124,148,FMN GV 11 Ramsel
66,Bergstraat 71,2022-04-19,14:00:00,254,170,84,FMN GV 11 Ramsel
66,Bergstraat 71,2022-04-19,15:00:00,436,334,102,FMN GV 11 Ramsel
66,Bergstraat 71,2022-04-19,16:00:00,270,194,76,FMN GV 11 Ramsel
66,Bergstraat 71,2022-04-19,17:00:00,200,132,68,FMN GV 11 Ramsel
66,Bergstraat 71,2022-04-19,18:00:00,128,64,64,FMN GV 11 Ramsel
66,Bergstraat 71,2022-04-19,19:00:00,112,54,58,FMN GV 11 Ramsel
66,Bergstraat 71,2022-04-19,20:00:00,56,42,14,FMN GV 11 Ramsel
66,Bergstraat 71,2022-04-19,21:00:00,28,22,6,FMN GV 11 Ramsel
66,Bergstraat 71,2022-04-19,22:00:00,24,12,12,FMN GV 11 Ramsel
66,Bergstraat 71,2022-04-19,23:00:00,8,8,0,FMN GV 11 Ramsel
66,Bergstraat 71,2022-04-20,00:00:00,4,4,0,FMN GV 11 Ramsel
66,Bergstraat 71,2022-04-20,01:00:00,2,2,0,FMN GV 11 Ramsel
66,Bergstraat 71,2022-04-20,02:00:00,0,0,0,FMN GV 11 Ramsel
66,Bergstraat 71,2022-04-20,03:00:00,0,0,0,FMN GV 11 Ramsel
66,Bergstraat 71,2022-04-20,04:00:00,6,4,2,FMN GV 11 Ramsel
66,Bergstraat 71,2022-04-20,05:00:00,18,6,12,FMN GV 11 Ramsel
66,Bergstraat 71,2022-04-20,06:00:00,64,20,44,FMN GV 11 Ramsel
66,Bergstraat 71,2022-04-20,07:00:00,266,46,220,FMN GV 11 Ramsel
66,Bergstraat 71,2022-04-20,08:00:00,258,40,218,FMN GV 11 Ramsel
66,Bergstraat 71,2022-04-20,09:00:00,72,28,44,FMN GV 11 Ramsel
66,Bergstraat 71,2022-04-20,10:00:00,78,36,42,FMN GV 11 Ramsel
66,Bergstraat 71,2022-04-20,11:00:00,132,72,60,FMN GV 11 Ramsel
66,Bergstraat 71,2022-04-20,12:00:00,346,314,32,FMN GV 11 Ramsel
66,Bergstraat 71,2022-04-20,13:00:00,168,86,82,FMN GV 11 Ramsel
66,Bergstraat 71,2022-04-20,14:00:00,172,90,82,FMN GV 11 Ramsel
66,Bergstraat 71,2022-04-20,15:00:00,196,104,92,FMN GV 11 Ramsel
66,Bergstraat 71,2022-04-20,16:00:00,162,84,78,FMN GV 11 Ramsel
66,Bergstraat 71,2022-04-20,17:00:00,172,88,84,FMN GV 11 Ramsel
66,Bergstraat 71,2022-04-20,18:00:00,132,72,60,FMN GV 11 Ramsel
66,Bergstraat 71,2022-04-20,19:00:00,100,60,40,FMN GV 11 Ramsel
66,Bergstraat 71,2022-04-20,20:00:00,76,42,34,FMN GV 11 Ramsel
66,Bergstraat 71,2022-04-20,21:00:00,20,10,10,FMN GV 11 Ramsel
66,Bergstraat 71,2022-04-20,22:00:00,18,12,6,FMN GV 11 Ramsel
66,Bergstraat 71,2022-04-20,23:00:00,6,2,4,FMN GV 11 Ramsel
66,Bergstraat 71,2022-04-21,00:00:00,8,8,0,FMN GV 11 Ramsel
66,Bergstraat 71,2022-04-21,01:00:00,6,6,0,FMN GV 11 Ramsel
66,Bergstraat 71,2022-04-21,02:00:00,6,2,4,FMN GV 11 Ramsel
66,Bergstraat 71,2022-04-21,03:00:00,0,0,0,FMN GV 11 Ramsel
66,Bergstraat 71,2022-04-21,04:00:00,4,4,0,FMN GV 11 Ramsel
66,Bergstraat 71,2022-04-21,05:00:00,26,14,12,FMN GV 11 Ramsel
66,Bergstraat 71,2022-04-21,06:00:00,66,18,48,FMN GV 11 Ramsel
66,Bergstraat 71,2022-04-21,07:00:00,310,44,266,FMN GV 11 Ramsel
66,Bergstraat 71,2022-04-21,08:00:00,252,40,212,FMN GV 11 Ramsel
66,Bergstraat 71,2022-04-21,09:00:00,86,28,58,FMN GV 11 Ramsel
66,Bergstraat 71,2022-04-21,10:00:00,92,38,54,FMN GV 11 Ramsel
66,Bergstraat 71,2022-04-21,11:00:00,120,62,58,FMN GV 11 Ramsel
66,Bergstraat 71,2022-04-21,12:00:00,126,76,50,FMN GV 11 Ramsel
66,Bergstraat 71,2022-04-21,13:00:00,228,80,148,FMN GV 11 Ramsel
66,Bergstraat 71,2022-04-21,14:00:00,172,96,76,FMN GV 11 Ramsel
66,Bergstraat 71,2022-04-21,15:00:00,372,298,74,FMN GV 11 Ramsel
66,Bergstraat 71,2022-04-21,16:00:00,270,212,58,FMN GV 11 Ramsel
66,Bergstraat 71,2022-04-21,17:00:00,216,130,86,FMN GV 11 Ramsel
66,Bergstraat 71,2022-04-21,18:00:00,114,68,46,FMN GV 11 Ramsel
66,Bergstraat 71,2022-04-21,19:00:00,118,66,52,FMN GV 11 Ramsel
66,Bergstraat 71,2022-04-21,20:00:00,76,34,42,FMN GV 11 Ramsel
66,Bergstraat 71,2022-04-21,21:00:00,24,12,12,FMN GV 11 Ramsel
66,Bergstraat 71,2022-04-21,22:00:00,20,10,10,FMN GV 11 Ramsel
66,Bergstraat 71,2022-04-21,23:00:00,2,2,0,FMN GV 11 Ramsel
66,Bergstraat 71,2022-04-22,00:00:00,8,4,4,FMN GV 11 Ramsel
66,Bergstraat 71,2022-04-22,01:00:00,6,6,0,FMN GV 11 Ramsel
66,Bergstraat 71,2022-04-22,02:00:00,0,0,0,FMN GV 11 Ramsel
66,Bergstraat 71,2022-04-22,03:00:00,0,0,0,FMN GV 11 Ramsel
66,Bergstraat 71,2022-04-22,04:00:00,4,4,0,FMN GV 11 Ramsel
66,Bergstraat 71,2022-04-22,05:00:00,16,4,12,FMN GV 11 Ramsel
66,Bergstraat 71,2022-04-22,06:00:00,46,16,30,FMN GV 11 Ramsel
66,Bergstraat 71,2022-04-22,07:00:00,232,40,192,FMN GV 11 Ramsel
66,Bergstraat 71,2022-04-22,08:00:00,276,34,242,FMN GV 11 Ramsel
66,Bergstraat 71,2022-04-22,09:00:00,74,24,50,FMN GV 11 Ramsel
66,Bergstraat 71,2022-04-22,10:00:00,68,34,34,FMN GV 11 Ramsel
66,Bergstraat 71,2022-04-22,11:00:00,86,52,34,FMN GV 11 Ramsel
66,Bergstraat 71,2022-04-22,12:00:00,98,60,38,FMN GV 11 Ramsel
66,Bergstraat 71,2022-04-22,13:00:00,98,54,44,FMN GV 11 Ramsel
66,Bergstraat 71,2022-04-22,14:00:00,164,112,52,FMN GV 11 Ramsel
66,Bergstraat 71,2022-04-22,15:00:00,302,238,64,FMN GV 11 Ramsel
66,Bergstraat 71,2022-04-22,16:00:00,152,118,34,FMN GV 11 Ramsel
66,Bergstraat 71,2022-04-22,17:00:00,184,108,76,FMN GV 11 Ramsel
66,Bergstraat 71,2022-04-22,18:00:00,90,44,46,FMN GV 11 Ramsel
66,Bergstraat 71,2022-04-22,19:00:00,166,120,46,FMN GV 11 Ramsel
66,Bergstraat 71,2022-04-22,20:00:00,56,30,26,FMN GV 11 Ramsel
66,Bergstraat 71,2022-04-22,21:00:00,36,10,26,FMN GV 11 Ramsel
66,Bergstraat 71,2022-04-22,22:00:00,20,8,12,FMN GV 11 Ramsel
66,Bergstraat 71,2022-04-22,23:00:00,0,0,0,FMN GV 11 Ramsel
66,Bergstraat 71,2022-04-23,00:00:00,12,6,6,FMN GV 11 Ramsel
66,Bergstraat 71,2022-04-23,01:00:00,10,10,0,FMN GV 11 Ramsel
66,Bergstraat 71,2022-04-23,02:00:00,6,6,0,FMN GV 11 Ramsel
66,Bergstraat 71,2022-04-23,03:00:00,8,8,0,FMN GV 11 Ramsel
66,Bergstraat 71,2022-04-23,04:00:00,0,0,0,FMN GV 11 Ramsel
66,Bergstraat 71,2022-04-23,05:00:00,6,6,0,FMN GV 11 Ramsel
66,Bergstraat 71,2022-04-23,06:00:00,10,8,2,FMN GV 11 Ramsel
66,Bergstraat 71,2022-04-23,07:00:00,26,16,10,FMN GV 11 Ramsel
66,Bergstraat 71,2022-04-23,08:00:00,58,26,32,FMN GV 11 Ramsel
66,Bergstraat 71,2022-04-23,09:00:00,86,32,54,FMN GV 11 Ramsel
66,Bergstraat 71,2022-04-23,10:00:00,102,50,52,FMN GV 11 Ramsel
66,Bergstraat 71,2022-04-23,11:00:00,144,88,56,FMN GV 11 Ramsel
66,Bergstraat 71,2022-04-23,12:00:00,134,62,72,FMN GV 11 Ramsel
66,Bergstraat 71,2022-04-23,13:00:00,230,104,126,FMN GV 11 Ramsel
66,Bergstraat 71,2022-04-23,14:00:00,236,94,142,FMN GV 11 Ramsel
66,Bergstraat 71,2022-04-23,15:00:00,222,120,102,FMN GV 11 Ramsel
66,Bergstraat 71,2022-04-23,16:00:00,158,100,58,FMN GV 11 Ramsel
66,Bergstraat 71,2022-04-23,17:00:00,108,60,48,FMN GV 11 Ramsel
66,Bergstraat 71,2022-04-23,18:00:00,82,58,24,FMN GV 11 Ramsel
66,Bergstraat 71,2022-04-23,19:00:00,62,24,38,FMN GV 11 Ramsel
66,Bergstraat 71,2022-04-23,20:00:00,38,16,22,FMN GV 11 Ramsel
66,Bergstraat 71,2022-04-23,21:00:00,16,2,14,FMN GV 11 Ramsel
66,Bergstraat 71,2022-04-23,22:00:00,14,8,6,FMN GV 11 Ramsel
66,Bergstraat 71,2022-04-23,23:00:00,8,4,4,FMN GV 11 Ramsel
66,Bergstraat 71,2022-04-24,00:00:00,2,2,0,FMN GV 11 Ramsel
66,Bergstraat 71,2022-04-24,01:00:00,12,10,2,FMN GV 11 Ramsel
66,Bergstraat 71,2022-04-24,02:00:00,4,2,2,FMN GV 11 Ramsel
66,Bergstraat 71,2022-04-24,03:00:00,4,4,0,FMN GV 11 Ramsel
66,Bergstraat 71,2022-04-24,04:00:00,2,0,2,FMN GV 11 Ramsel
66,Bergstraat 71,2022-04-24,05:00:00,0,0,0,FMN GV 11 Ramsel
66,Bergstraat 71,2022-04-24,06:00:00,6,2,4,FMN GV 11 Ramsel
66,Bergstraat 71,2022-04-24,07:00:00,34,10,24,FMN GV 11 Ramsel
66,Bergstraat 71,2022-04-24,08:00:00,112,36,76,FMN GV 11 Ramsel
66,Bergstraat 71,2022-04-24,09:00:00,186,72,114,FMN GV 11 Ramsel
66,Bergstraat 71,2022-04-24,10:00:00,164,92,72,FMN GV 11 Ramsel
66,Bergstraat 71,2022-04-24,11:00:00,318,106,212,FMN GV 11 Ramsel
66,Bergstraat 71,2022-04-24,12:00:00,242,154,88,FMN GV 11 Ramsel
66,Bergstraat 71,2022-04-24,13:00:00,312,150,162,FMN GV 11 Ramsel
66,Bergstraat 71,2022-04-24,14:00:00,278,134,144,FMN GV 11 Ramsel
66,Bergstraat 71,2022-04-24,15:00:00,196,110,86,FMN GV 11 Ramsel
66,Bergstraat 71,2022-04-24,16:00:00,170,84,86,FMN GV 11 Ramsel
66,Bergstraat 71,2022-04-24,17:00:00,162,90,72,FMN GV 11 Ramsel
66,Bergstraat 71,2022-04-24,18:00:00,64,50,14,FMN GV 11 Ramsel
66,Bergstraat 71,2022-04-24,19:00:00,86,32,54,FMN GV 11 Ramsel
66,Bergstraat 71,2022-04-24,20:00:00,54,24,30,FMN GV 11 Ramsel
66,Bergstraat 71,2022-04-24,21:00:00,22,10,12,FMN GV 11 Ramsel
66,Bergstraat 71,2022-04-24,22:00:00,6,4,2,FMN GV 11 Ramsel
66,Bergstraat 71,2022-04-24,23:00:00,2,2,0,FMN GV 11 Ramsel
66,Bergstraat 71,2022-04-25,00:00:00,2,2,0,FMN GV 11 Ramsel
66,Bergstraat 71,2022-04-25,01:00:00,4,4,0,FMN GV 11 Ramsel
66,Bergstraat 71,2022-04-25,02:00:00,0,0,0,FMN GV 11 Ramsel
66,Bergstraat 71,2022-04-25,03:00:00,0,0,0,FMN GV 11 Ramsel
66,Bergstraat 71,2022-04-25,04:00:00,4,4,0,FMN GV 11 Ramsel
66,Bergstraat 71,2022-04-25,05:00:00,20,14,6,FMN GV 11 Ramsel
66,Bergstraat 71,2022-04-25,06:00:00,40,14,26,FMN GV 11 Ramsel
66,Bergstraat 71,2022-04-25,07:00:00,260,24,236,FMN GV 11 Ramsel
66,Bergstraat 71,2022-04-25,08:00:00,264,50,214,FMN GV 11 Ramsel
66,Bergstraat 71,2022-04-25,09:00:00,70,40,30,FMN GV 11 Ramsel
66,Bergstraat 71,2022-04-25,10:00:00,46,22,24,FMN GV 11 Ramsel
66,Bergstraat 71,2022-04-25,11:00:00,64,34,30,FMN GV 11 Ramsel
66,Bergstraat 71,2022-04-25,12:00:00,84,54,30,FMN GV 11 Ramsel
66,Bergstraat 71,2022-04-25,13:00:00,62,32,30,FMN GV 11 Ramsel
66,Bergstraat 71,2022-04-25,14:00:00,88,34,54,FMN GV 11 Ramsel
66,Bergstraat 71,2022-04-25,15:00:00,248,198,50,FMN GV 11 Ramsel
66,Bergstraat 71,2022-04-25,16:00:00,218,174,44,FMN GV 11 Ramsel
66,Bergstraat 71,2022-04-25,17:00:00,132,86,46,FMN GV 11 Ramsel
66,Bergstraat 71,2022-04-25,18:00:00,74,50,24,FMN GV 11 Ramsel
66,Bergstraat 71,2022-04-25,19:00:00,60,24,36,FMN GV 11 Ramsel
66,Bergstraat 71,2022-04-25,20:00:00,38,24,14,FMN GV 11 Ramsel
66,Bergstraat 71,2022-04-25,21:00:00,22,20,2,FMN GV 11 Ramsel
66,Bergstraat 71,2022-04-25,22:00:00,8,8,0,FMN GV 11 Ramsel
66,Bergstraat 71,2022-04-25,23:00:00,0,0,0,FMN GV 11 Ramsel
66,Bergstraat 71,2022-04-26,00:00:00,6,0,6,FMN GV 11 Ramsel
66,Bergstraat 71,2022-04-26,01:00:00,4,4,0,FMN GV 11 Ramsel
66,Bergstraat 71,2022-04-26,02:00:00,0,0,0,FMN GV 11 Ramsel
66,Bergstraat 71,2022-04-26,03:00:00,0,0,0,FMN GV 11 Ramsel
66,Bergstraat 71,2022-04-26,04:00:00,4,2,2,FMN GV 11 Ramsel
66,Bergstraat 71,2022-04-26,05:00:00,18,12,6,FMN GV 11 Ramsel
66,Bergstraat 71,2022-04-26,06:00:00,62,16,46,FMN GV 11 Ramsel
66,Bergstraat 71,2022-04-26,07:00:00,264,48,216,FMN GV 11 Ramsel
66,Bergstraat 71,2022-04-26,08:00:00,240,24,216,FMN GV 11 Ramsel
66,Bergstraat 71,2022-04-26,09:00:00,58,24,34,FMN GV 11 Ramsel
66,Bergstraat 71,2022-04-26,10:00:00,62,30,32,FMN GV 11 Ramsel
66,Bergstraat 71,2022-04-26,11:00:00,58,24,34,FMN GV 11 Ramsel
66,Bergstraat 71,2022-04-26,12:00:00,120,76,44,FMN GV 11 Ramsel
66,Bergstraat 71,2022-04-26,13:00:00,184,90,94,FMN GV 11 Ramsel
66,Bergstraat 71,2022-04-26,14:00:00,202,118,84,FMN GV 11 Ramsel
66,Bergstraat 71,2022-04-26,15:00:00,260,198,62,FMN GV 11 Ramsel
66,Bergstraat 71,2022-04-26,16:00:00,264,202,62,FMN GV 11 Ramsel
66,Bergstraat 71,2022-04-26,17:00:00,218,120,98,FMN GV 11 Ramsel
66,Bergstraat 71,2022-04-26,18:00:00,112,52,60,FMN GV 11 Ramsel
66,Bergstraat 71,2022-04-26,19:00:00,104,46,58,FMN GV 11 Ramsel
66,Bergstraat 71,2022-04-26,20:00:00,80,60,20,FMN GV 11 Ramsel
66,Bergstraat 71,2022-04-26,21:00:00,34,28,6,FMN GV 11 Ramsel
66,Bergstraat 71,2022-04-26,22:00:00,22,6,16,FMN GV 11 Ramsel
66,Bergstraat 71,2022-04-26,23:00:00,10,8,2,FMN GV 11 Ramsel
66,Bergstraat 71,2022-04-27,00:00:00,8,4,4,FMN GV 11 Ramsel
66,Bergstraat 71,2022-04-27,01:00:00,2,2,0,FMN GV 11 Ramsel
66,Bergstraat 71,2022-04-27,02:00:00,0,0,0,FMN GV 11 Ramsel
66,Bergstraat 71,2022-04-27,03:00:00,0,0,0,FMN GV 11 Ramsel
66,Bergstraat 71,2022-04-27,04:00:00,8,4,4,FMN GV 11 Ramsel
66,Bergstraat 71,2022-04-27,05:00:00,14,6,8,FMN GV 11 Ramsel
66,Bergstraat 71,2022-04-27,06:00:00,60,20,40,FMN GV 11 Ramsel
66,Bergstraat 71,2022-04-27,07:00:00,256,28,228,FMN GV 11 Ramsel
66,Bergstraat 71,2022-04-27,08:00:00,256,34,222,FMN GV 11 Ramsel
66,Bergstraat 71,2022-04-27,09:00:00,44,20,24,FMN GV 11 Ramsel
66,Bergstraat 71,2022-04-27,10:00:00,70,38,32,FMN GV 11 Ramsel
66,Bergstraat 71,2022-04-27,11:00:00,118,52,66,FMN GV 11 Ramsel
66,Bergstraat 71,2022-04-27,12:00:00,340,274,66,FMN GV 11 Ramsel
66,Bergstraat 71,2022-04-27,13:00:00,222,110,112,FMN GV 11 Ramsel
66,Bergstraat 71,2022-04-27,14:00:00,266,114,152,FMN GV 11 Ramsel
66,Bergstraat 71,2022-04-27,15:00:00,236,130,106,FMN GV 11 Ramsel
66,Bergstraat 71,2022-04-27,16:00:00,242,154,88,FMN GV 11 Ramsel
66,Bergstraat 71,2022-04-27,17:00:00,212,118,94,FMN GV 11 Ramsel
66,Bergstraat 71,2022-04-27,18:00:00,158,86,72,FMN GV 11 Ramsel
66,Bergstraat 71,2022-04-27,19:00:00,86,56,30,FMN GV 11 Ramsel
66,Bergstraat 71,2022-04-27,20:00:00,92,40,52,FMN GV 11 Ramsel
66,Bergstraat 71,2022-04-27,21:00:00,40,38,2,FMN GV 11 Ramsel
66,Bergstraat 71,2022-04-27,22:00:00,22,18,4,FMN GV 11 Ramsel
66,Bergstraat 71,2022-04-27,23:00:00,2,2,0,FMN GV 11 Ramsel
66,Bergstraat 71,2022-04-28,00:00:00,10,8,2,FMN GV 11 Ramsel
66,Bergstraat 71,2022-04-28,01:00:00,4,2,2,FMN GV 11 Ramsel
66,Bergstraat 71,2022-04-28,02:00:00,0,0,0,FMN GV 11 Ramsel
66,Bergstraat 71,2022-04-28,03:00:00,0,0,0,FMN GV 11 Ramsel
66,Bergstraat 71,2022-04-28,04:00:00,6,4,2,FMN GV 11 Ramsel
66,Bergstraat 71,2022-04-28,05:00:00,28,14,14,FMN GV 11 Ramsel
66,Bergstraat 71,2022-04-28,06:00:00,68,26,42,FMN GV 11 Ramsel
66,Bergstraat 71,2022-04-28,07:00:00,292,54,238,FMN GV 11 Ramsel
66,Bergstraat 71,2022-04-28,08:00:00,264,36,228,FMN GV 11 Ramsel
66,Bergstraat 71,2022-04-28,09:00:00,70,22,48,FMN GV 11 Ramsel
66,Bergstraat 71,2022-04-28,10:00:00,100,36,64,FMN GV 11 Ramsel
66,Bergstraat 71,2022-04-28,11:00:00,134,62,72,FMN GV 11 Ramsel
66,Bergstraat 71,2022-04-28,12:00:00,170,84,86,FMN GV 11 Ramsel
66,Bergstraat 71,2022-04-28,13:00:00,240,106,134,FMN GV 11 Ramsel
66,Bergstraat 71,2022-04-28,14:00:00,220,140,80,FMN GV 11 Ramsel
66,Bergstraat 71,2022-04-28,15:00:00,454,298,156,FMN GV 11 Ramsel
66,Bergstraat 71,2022-04-28,16:00:00,308,226,82,FMN GV 11 Ramsel
66,Bergstraat 71,2022-04-28,17:00:00,250,166,84,FMN GV 11 Ramsel
66,Bergstraat 71,2022-04-28,18:00:00,140,76,64,FMN GV 11 Ramsel
66,Bergstraat 71,2022-04-28,19:00:00,104,42,62,FMN GV 11 Ramsel
66,Bergstraat 71,2022-04-28,20:00:00,100,54,46,FMN GV 11 Ramsel
66,Bergstraat 71,2022-04-28,21:00:00,24,22,2,FMN GV 11 Ramsel
66,Bergstraat 71,2022-04-28,22:00:00,10,8,2,FMN GV 11 Ramsel
66,Bergstraat 71,2022-04-28,23:00:00,20,14,6,FMN GV 11 Ramsel
66,Bergstraat 71,2022-04-29,00:00:00,2,0,2,FMN GV 11 Ramsel
66,Bergstraat 71,2022-04-29,01:00:00,4,4,0,FMN GV 11 Ramsel
66,Bergstraat 71,2022-04-29,02:00:00,0,0,0,FMN GV 11 Ramsel
66,Bergstraat 71,2022-04-29,03:00:00,0,0,0,FMN GV 11 Ramsel
66,Bergstraat 71,2022-04-29,04:00:00,2,2,0,FMN GV 11 Ramsel
66,Bergstraat 71,2022-04-29,05:00:00,16,4,12,FMN GV 11 Ramsel
66,Bergstraat 71,2022-04-29,06:00:00,42,6,36,FMN GV 11 Ramsel
66,Bergstraat 71,2022-04-29,07:00:00,220,36,184,FMN GV 11 Ramsel
66,Bergstraat 71,2022-04-29,08:00:00,228,36,192,FMN GV 11 Ramsel
66,Bergstraat 71,2022-04-29,09:00:00,84,26,58,FMN GV 11 Ramsel
66,Bergstraat 71,2022-04-29,10:00:00,76,28,48,FMN GV 11 Ramsel
66,Bergstraat 71,2022-04-29,11:00:00,76,54,22,FMN GV 11 Ramsel
66,Bergstraat 71,2022-04-29,12:00:00,90,42,48,FMN GV 11 Ramsel
66,Bergstraat 71,2022-04-29,13:00:00,84,36,48,FMN GV 11 Ramsel
66,Bergstraat 71,2022-04-29,14:00:00,100,52,48,FMN GV 11 Ramsel
66,Bergstraat 71,2022-04-29,15:00:00,280,222,58,FMN GV 11 Ramsel
66,Bergstraat 71,2022-04-29,16:00:00,242,182,60,FMN GV 11 Ramsel
66,Bergstraat 71,2022-04-29,17:00:00,118,82,36,FMN GV 11 Ramsel
66,Bergstraat 71,2022-04-29,18:00:00,92,52,40,FMN GV 11 Ramsel
66,Bergstraat 71,2022-04-29,19:00:00,70,24,46,FMN GV 11 Ramsel
66,Bergstraat 71,2022-04-29,20:00:00,44,14,30,FMN GV 11 Ramsel
66,Bergstraat 71,2022-04-29,21:00:00,22,8,14,FMN GV 11 Ramsel
66,Bergstraat 71,2022-04-29,22:00:00,10,6,4,FMN GV 11 Ramsel
66,Bergstraat 71,2022-04-29,23:00:00,30,8,22,FMN GV 11 Ramsel
66,Bergstraat 71,2022-04-30,00:00:00,6,0,6,FMN GV 11 Ramsel
66,Bergstraat 71,2022-04-30,01:00:00,10,6,4,FMN GV 11 Ramsel
66,Bergstraat 71,2022-04-30,02:00:00,12,12,0,FMN GV 11 Ramsel
66,Bergstraat 71,2022-04-30,03:00:00,18,18,0,FMN GV 11 Ramsel
66,Bergstraat 71,2022-04-30,04:00:00,0,0,0,FMN GV 11 Ramsel
66,Bergstraat 71,2022-04-30,05:00:00,2,2,0,FMN GV 11 Ramsel
66,Bergstraat 71,2022-04-30,06:00:00,8,6,2,FMN GV 11 Ramsel
66,Bergstraat 71,2022-04-30,07:00:00,22,8,14,FMN GV 11 Ramsel
66,Bergstraat 71,2022-04-30,08:00:00,34,6,28,FMN GV 11 Ramsel
66,Bergstraat 71,2022-04-30,09:00:00,84,40,44,FMN GV 11 Ramsel
66,Bergstraat 71,2022-04-30,10:00:00,110,56,54,FMN GV 11 Ramsel
66,Bergstraat 71,2022-04-30,11:00:00,114,38,76,FMN GV 11 Ramsel
66,Bergstraat 71,2022-04-30,12:00:00,162,72,90,FMN GV 11 Ramsel
66,Bergstraat 71,2022-04-30,13:00:00,148,84,64,FMN GV 11 Ramsel
66,Bergstraat 71,2022-04-30,14:00:00,154,80,74,FMN GV 11 Ramsel
66,Bergstraat 71,2022-04-30,15:00:00,132,86,46,FMN GV 11 Ramsel
66,Bergstraat 71,2022-04-30,16:00:00,118,70,48,FMN GV 11 Ramsel
66,Bergstraat 71,2022-04-30,17:00:00,84,38,46,FMN GV 11 Ramsel
66,Bergstraat 71,2022-04-30,18:00:00,36,18,18,FMN GV 11 Ramsel
66,Bergstraat 71,2022-04-30,19:00:00,52,24,28,FMN GV 11 Ramsel
66,Bergstraat 71,2022-04-30,20:00:00,34,12,22,FMN GV 11 Ramsel
66,Bergstraat 71,2022-04-30,21:00:00,28,12,16,FMN GV 11 Ramsel
66,Bergstraat 71,2022-04-30,22:00:00,10,2,8,FMN GV 11 Ramsel
66,Bergstraat 71,2022-04-30,23:00:00,16,2,14,FMN GV 11 Ramsel
66,Bergstraat 71,2022-05-01,00:00:00,0,0,0,FMN GV 11 Ramsel
66,Bergstraat 71,2022-05-01,01:00:00,4,4,0,FMN GV 11 Ramsel
66,Bergstraat 71,2022-05-01,02:00:00,14,12,2,FMN GV 11 Ramsel
66,Bergstraat 71,2022-05-01,03:00:00,2,0,2,FMN GV 11 Ramsel
66,Bergstraat 71,2022-05-01,04:00:00,14,14,0,FMN GV 11 Ramsel
66,Bergstraat 71,2022-05-01,05:00:00,14,14,0,FMN GV 11 Ramsel
66,Bergstraat 71,2022-05-01,06:00:00,2,2,0,FMN GV 11 Ramsel
66,Bergstraat 71,2022-05-01,07:00:00,14,6,8,FMN GV 11 Ramsel
66,Bergstraat 71,2022-05-01,08:00:00,76,30,46,FMN GV 11 Ramsel
66,Bergstraat 71,2022-05-01,09:00:00,130,66,64,FMN GV 11 Ramsel
66,Bergstraat 71,2022-05-01,10:00:00,204,136,68,FMN GV 11 Ramsel
66,Bergstraat 71,2022-05-01,11:00:00,170,86,84,FMN GV 11 Ramsel
66,Bergstraat 71,2022-05-01,12:00:00,120,56,64,FMN GV 11 Ramsel
66,Bergstraat 71,2022-05-01,13:00:00,180,106,74,FMN GV 11 Ramsel
66,Bergstraat 71,2022-05-01,14:00:00,318,114,204,FMN GV 11 Ramsel
66,Bergstraat 71,2022-05-01,15:00:00,192,110,82,FMN GV 11 Ramsel
66,Bergstraat 71,2022-05-01,16:00:00,192,104,88,FMN GV 11 Ramsel
66,Bergstraat 71,2022-05-01,17:00:00,162,86,76,FMN GV 11 Ramsel
66,Bergstraat 71,2022-05-01,18:00:00,68,46,22,FMN GV 11 Ramsel
66,Bergstraat 71,2022-05-01,19:00:00,64,22,42,FMN GV 11 Ramsel
66,Bergstraat 71,2022-05-01,20:00:00,30,6,24,FMN GV 11 Ramsel
66,Bergstraat 71,2022-05-01,21:00:00,36,24,12,FMN GV 11 Ramsel
66,Bergstraat 71,2022-05-01,22:00:00,0,0,0,FMN GV 11 Ramsel
66,Bergstraat 71,2022-05-01,23:00:00,4,4,0,FMN GV 11 Ramsel
66,Bergstraat 71,2022-05-02,00:00:00,4,4,0,FMN GV 11 Ramsel
66,Bergstraat 71,2022-05-02,01:00:00,2,2,0,FMN GV 11 Ramsel
66,Bergstraat 71,2022-05-02,02:00:00,0,0,0,FMN GV 11 Ramsel
66,Bergstraat 71,2022-05-02,03:00:00,0,0,0,FMN GV 11 Ramsel
66,Bergstraat 71,2022-05-02,04:00:00,8,4,4,FMN GV 11 Ramsel
66,Bergstraat 71,2022-05-02,05:00:00,14,6,8,FMN GV 11 Ramsel
66,Bergstraat 71,2022-05-02,06:00:00,50,18,32,FMN GV 11 Ramsel
66,Bergstraat 71,2022-05-02,07:00:00,246,40,206,FMN GV 11 Ramsel
66,Bergstraat 71,2022-05-02,08:00:00,210,32,178,FMN GV 11 Ramsel
66,Bergstraat 71,2022-05-02,09:00:00,54,32,22,FMN GV 11 Ramsel
66,Bergstraat 71,2022-05-02,10:00:00,94,48,46,FMN GV 11 Ramsel
66,Bergstraat 71,2022-05-02,11:00:00,84,42,42,FMN GV 11 Ramsel
66,Bergstraat 71,2022-05-02,12:00:00,134,54,80,FMN GV 11 Ramsel
66,Bergstraat 71,2022-05-02,13:00:00,234,80,154,FMN GV 11 Ramsel
66,Bergstraat 71,2022-05-02,14:00:00,266,130,136,FMN GV 11 Ramsel
66,Bergstraat 71,2022-05-02,15:00:00,354,254,100,FMN GV 11 Ramsel
66,Bergstraat 71,2022-05-02,16:00:00,246,178,68,FMN GV 11 Ramsel
66,Bergstraat 71,2022-05-02,17:00:00,158,104,54,FMN GV 11 Ramsel
66,Bergstraat 71,2022-05-02,18:00:00,140,84,56,FMN GV 11 Ramsel
66,Bergstraat 71,2022-05-02,19:00:00,106,56,50,FMN GV 11 Ramsel
66,Bergstraat 71,2022-05-02,20:00:00,72,44,28,FMN GV 11 Ramsel
66,Bergstraat 71,2022-05-02,21:00:00,32,16,16,FMN GV 11 Ramsel
66,Bergstraat 71,2022-05-02,22:00:00,20,12,8,FMN GV 11 Ramsel
66,Bergstraat 71,2022-05-02,23:00:00,8,4,4,FMN GV 11 Ramsel
66,Bergstraat 71,2022-05-03,00:00:00,4,0,4,FMN GV 11 Ramsel
66,Bergstraat 71,2022-05-03,01:00:00,4,4,0,FMN GV 11 Ramsel
66,Bergstraat 71,2022-05-03,02:00:00,0,0,0,FMN GV 11 Ramsel
66,Bergstraat 71,2022-05-03,03:00:00,0,0,0,FMN GV 11 Ramsel
66,Bergstraat 71,2022-05-03,04:00:00,8,4,4,FMN GV 11 Ramsel
66,Bergstraat 71,2022-05-03,05:00:00,18,8,10,FMN GV 11 Ramsel
66,Bergstraat 71,2022-05-03,06:00:00,64,24,40,FMN GV 11 Ramsel
66,Bergstraat 71,2022-05-03,07:00:00,284,44,240,FMN GV 11 Ramsel
66,Bergstraat 71,2022-05-03,08:00:00,272,48,224,FMN GV 11 Ramsel
66,Bergstraat 71,2022-05-03,09:00:00,82,36,46,FMN GV 11 Ramsel
66,Bergstraat 71,2022-05-03,10:00:00,78,34,44,FMN GV 11 Ramsel
66,Bergstraat 71,2022-05-03,11:00:00,102,50,52,FMN GV 11 Ramsel
66,Bergstraat 71,2022-05-03,12:00:00,190,76,114,FMN GV 11 Ramsel
66,Bergstraat 71,2022-05-03,13:00:00,236,94,142,FMN GV 11 Ramsel
66,Bergstraat 71,2022-05-03,14:00:00,234,138,96,FMN GV 11 Ramsel
66,Bergstraat 71,2022-05-03,15:00:00,392,298,94,FMN GV 11 Ramsel
66,Bergstraat 71,2022-05-03,16:00:00,336,228,108,FMN GV 11 Ramsel
66,Bergstraat 71,2022-05-03,17:00:00,210,126,84,FMN GV 11 Ramsel
66,Bergstraat 71,2022-05-03,18:00:00,150,88,62,FMN GV 11 Ramsel
66,Bergstraat 71,2022-05-03,19:00:00,102,54,48,FMN GV 11 Ramsel
66,Bergstraat 71,2022-05-03,20:00:00,92,66,26,FMN GV 11 Ramsel
66,Bergstraat 71,2022-05-03,21:00:00,24,16,8,FMN GV 11 Ramsel
66,Bergstraat 71,2022-05-03,22:00:00,20,10,10,FMN GV 11 Ramsel
66,Bergstraat 71,2022-05-03,23:00:00,12,12,0,FMN GV 11 Ramsel
66,Bergstraat 71,2022-05-04,00:00:00,4,0,4,FMN GV 11 Ramsel
66,Bergstraat 71,2022-05-04,01:00:00,4,4,0,FMN GV 11 Ramsel
66,Bergstraat 71,2022-05-04,02:00:00,0,0,0,FMN GV 11 Ramsel
66,Bergstraat 71,2022-05-04,03:00:00,0,0,0,FMN GV 11 Ramsel
66,Bergstraat 71,2022-05-04,04:00:00,8,4,4,FMN GV 11 Ramsel
66,Bergstraat 71,2022-05-04,05:00:00,16,4,12,FMN GV 11 Ramsel
66,Bergstraat 71,2022-05-04,06:00:00,62,20,42,FMN GV 11 Ramsel
66,Bergstraat 71,2022-05-04,07:00:00,278,32,246,FMN GV 11 Ramsel
66,Bergstraat 71,2022-05-04,08:00:00,234,46,188,FMN GV 11 Ramsel
66,Bergstraat 71,2022-05-04,09:00:00,64,22,42,FMN GV 11 Ramsel
66,Bergstraat 71,2022-05-04,10:00:00,84,36,48,FMN GV 11 Ramsel
66,Bergstraat 71,2022-05-04,11:00:00,124,66,58,FMN GV 11 Ramsel
66,Bergstraat 71,2022-05-04,12:00:00,348,310,38,FMN GV 11 Ramsel
66,Bergstraat 71,2022-05-04,13:00:00,228,128,100,FMN GV 11 Ramsel
66,Bergstraat 71,2022-05-04,14:00:00,246,144,102,FMN GV 11 Ramsel
66,Bergstraat 71,2022-05-04,15:00:00,224,118,106,FMN GV 11 Ramsel
66,Bergstraat 71,2022-05-04,16:00:00,222,118,104,FMN GV 11 Ramsel
66,Bergstraat 71,2022-05-04,17:00:00,200,110,90,FMN GV 11 Ramsel
66,Bergstraat 71,2022-05-04,18:00:00,148,76,72,FMN GV 11 Ramsel
66,Bergstraat 71,2022-05-04,19:00:00,140,74,66,FMN GV 11 Ramsel
66,Bergstraat 71,2022-05-04,20:00:00,80,50,30,FMN GV 11 Ramsel
66,Bergstraat 71,2022-05-04,21:00:00,28,20,8,FMN GV 11 Ramsel
66,Bergstraat 71,2022-05-04,22:00:00,16,10,6,FMN GV 11 Ramsel
66,Bergstraat 71,2022-05-04,23:00:00,6,4,2,FMN GV 11 Ramsel
66,Bergstraat 71,2022-05-05,00:00:00,2,2,0,FMN GV 11 Ramsel
66,Bergstraat 71,2022-05-05,01:00:00,2,2,0,FMN GV 11 Ramsel
66,Bergstraat 71,2022-05-05,02:00:00,0,0,0,FMN GV 11 Ramsel
66,Bergstraat 71,2022-05-05,03:00:00,0,0,0,FMN GV 11 Ramsel
66,Bergstraat 71,2022-05-05,04:00:00,8,2,6,FMN GV 11 Ramsel
66,Bergstraat 71,2022-05-05,05:00:00,18,8,10,FMN GV 11 Ramsel
66,Bergstraat 71,2022-05-05,06:00:00,56,14,42,FMN GV 11 Ramsel
66,Bergstraat 71,2022-05-05,07:00:00,318,40,278,FMN GV 11 Ramsel
66,Bergstraat 71,2022-05-05,08:00:00,262,42,220,FMN GV 11 Ramsel
66,Bergstraat 71,2022-05-05,09:00:00,92,30,62,FMN GV 11 Ramsel
66,Bergstraat 71,2022-05-05,10:00:00,118,30,88,FMN GV 11 Ramsel
66,Bergstraat 71,2022-05-05,11:00:00,106,52,54,FMN GV 11 Ramsel
66,Bergstraat 71,2022-05-05,12:00:00,112,82,30,FMN GV 11 Ramsel
66,Bergstraat 71,2022-05-05,13:00:00,166,84,82,FMN GV 11 Ramsel
66,Bergstraat 71,2022-05-05,14:00:00,162,100,62,FMN GV 11 Ramsel
66,Bergstraat 71,2022-05-05,15:00:00,330,272,58,FMN GV 11 Ramsel
66,Bergstraat 71,2022-05-05,16:00:00,198,140,58,FMN GV 11 Ramsel
66,Bergstraat 71,2022-05-05,17:00:00,148,110,38,FMN GV 11 Ramsel
66,Bergstraat 71,2022-05-05,18:00:00,62,30,32,FMN GV 11 Ramsel
66,Bergstraat 71,2022-05-05,19:00:00,96,56,40,FMN GV 11 Ramsel
66,Bergstraat 71,2022-05-05,20:00:00,38,20,18,FMN GV 11 Ramsel
66,Bergstraat 71,2022-05-05,21:00:00,26,14,12,FMN GV 11 Ramsel
66,Bergstraat 71,2022-05-05,22:00:00,12,8,4,FMN GV 11 Ramsel
66,Bergstraat 71,2022-05-05,23:00:00,4,2,2,FMN GV 11 Ramsel
66,Bergstraat 71,2022-05-06,00:00:00,2,0,2,FMN GV 11 Ramsel
66,Bergstraat 71,2022-05-06,01:00:00,4,4,0,FMN GV 11 Ramsel
66,Bergstraat 71,2022-05-06,02:00:00,0,0,0,FMN GV 11 Ramsel
66,Bergstraat 71,2022-05-06,03:00:00,2,2,0,FMN GV 11 Ramsel
66,Bergstraat 71,2022-05-06,04:00:00,2,2,0,FMN GV 11 Ramsel
66,Bergstraat 71,2022-05-06,05:00:00,14,4,10,FMN GV 11 Ramsel
66,Bergstraat 71,2022-05-06,06:00:00,42,10,32,FMN GV 11 Ramsel
66,Bergstraat 71,2022-05-06,07:00:00,256,24,232,FMN GV 11 Ramsel
66,Bergstraat 71,2022-05-06,08:00:00,248,32,216,FMN GV 11 Ramsel
66,Bergstraat 71,2022-05-06,09:00:00,60,20,40,FMN GV 11 Ramsel
66,Bergstraat 71,2022-05-06,10:00:00,78,34,44,FMN GV 11 Ramsel
66,Bergstraat 71,2022-05-06,11:00:00,104,54,50,FMN GV 11 Ramsel
66,Bergstraat 71,2022-05-06,12:00:00,116,72,44,FMN GV 11 Ramsel
66,Bergstraat 71,2022-05-06,13:00:00,188,80,108,FMN GV 11 Ramsel
66,Bergstraat 71,2022-05-06,14:00:00,254,156,98,FMN GV 11 Ramsel
66,Bergstraat 71,2022-05-06,15:00:00,384,268,116,FMN GV 11 Ramsel
66,Bergstraat 71,2022-05-06,16:00:00,322,228,94,FMN GV 11 Ramsel
66,Bergstraat 71,2022-05-06,17:00:00,224,166,58,FMN GV 11 Ramsel
66,Bergstraat 71,2022-05-06,18:00:00,100,42,58,FMN GV 11 Ramsel
66,Bergstraat 71,2022-05-06,19:00:00,148,96,52,FMN GV 11 Ramsel
66,Bergstraat 71,2022-05-06,20:00:00,70,30,40,FMN GV 11 Ramsel
66,Bergstraat 71,2022-05-06,21:00:00,56,24,32,FMN GV 11 Ramsel
66,Bergstraat 71,2022-05-06,22:00:00,16,10,6,FMN GV 11 Ramsel
66,Bergstraat 71,2022-05-06,23:00:00,18,16,2,FMN GV 11 Ramsel
66,Bergstraat 71,2022-05-07,00:00:00,20,10,10,FMN GV 11 Ramsel
66,Bergstraat 71,2022-05-07,01:00:00,12,8,4,FMN GV 11 Ramsel
66,Bergstraat 71,2022-05-07,02:00:00,8,4,4,FMN GV 11 Ramsel
66,Bergstraat 71,2022-05-07,03:00:00,8,8,0,FMN GV 11 Ramsel
66,Bergstraat 71,2022-05-07,04:00:00,2,2,0,FMN GV 11 Ramsel
66,Bergstraat 71,2022-05-07,05:00:00,2,2,0,FMN GV 11 Ramsel
66,Bergstraat 71,2022-05-07,06:00:00,14,8,6,FMN GV 11 Ramsel
66,Bergstraat 71,2022-05-07,07:00:00,18,12,6,FMN GV 11 Ramsel
66,Bergstraat 71,2022-05-07,08:00:00,56,32,24,FMN GV 11 Ramsel
66,Bergstraat 71,2022-05-07,09:00:00,66,16,50,FMN GV 11 Ramsel
66,Bergstraat 71,2022-05-07,10:00:00,98,60,38,FMN GV 11 Ramsel
66,Bergstraat 71,2022-05-07,11:00:00,140,50,90,FMN GV 11 Ramsel
66,Bergstraat 71,2022-05-07,12:00:00,168,70,98,FMN GV 11 Ramsel
66,Bergstraat 71,2022-05-07,13:00:00,264,128,136,FMN GV 11 Ramsel
66,Bergstraat 71,2022-05-07,14:00:00,190,80,110,FMN GV 11 Ramsel
66,Bergstraat 71,2022-05-07,15:00:00,198,122,76,FMN GV 11 Ramsel
66,Bergstraat 71,2022-05-07,16:00:00,148,92,56,FMN GV 11 Ramsel
66,Bergstraat 71,2022-05-07,17:00:00,136,74,62,FMN GV 11 Ramsel
66,Bergstraat 71,2022-05-07,18:00:00,86,50,36,FMN GV 11 Ramsel
66,Bergstraat 71,2022-05-07,19:00:00,58,32,26,FMN GV 11 Ramsel
66,Bergstraat 71,2022-05-07,20:00:00,52,28,24,FMN GV 11 Ramsel
66,Bergstraat 71,2022-05-07,21:00:00,26,16,10,FMN GV 11 Ramsel
66,Bergstraat 71,2022-05-07,22:00:00,26,20,6,FMN GV 11 Ramsel
66,Bergstraat 71,2022-05-07,23:00:00,18,16,2,FMN GV 11 Ramsel
66,Bergstraat 71,2022-05-08,00:00:00,8,6,2,FMN GV 11 Ramsel
66,Bergstraat 71,2022-05-08,01:00:00,6,2,4,FMN GV 11 Ramsel
66,Bergstraat 71,2022-05-08,02:00:00,4,4,0,FMN GV 11 Ramsel
66,Bergstraat 71,2022-05-08,03:00:00,2,0,2,FMN GV 11 Ramsel
66,Bergstraat 71,2022-05-08,04:00:00,0,0,0,FMN GV 11 Ramsel
66,Bergstraat 71,2022-05-08,05:00:00,4,4,0,FMN GV 11 Ramsel
66,Bergstraat 71,2022-05-08,06:00:00,6,4,2,FMN GV 11 Ramsel
66,Bergstraat 71,2022-05-08,07:00:00,34,10,24,FMN GV 11 Ramsel
66,Bergstraat 71,2022-05-08,08:00:00,74,24,50,FMN GV 11 Ramsel
66,Bergstraat 71,2022-05-08,09:00:00,170,40,130,FMN GV 11 Ramsel
66,Bergstraat 71,2022-05-08,10:00:00,170,98,72,FMN GV 11 Ramsel
66,Bergstraat 71,2022-05-08,11:00:00,276,156,120,FMN GV 11 Ramsel
66,Bergstraat 71,2022-05-08,12:00:00,200,122,78,FMN GV 11 Ramsel
66,Bergstraat 71,2022-05-08,13:00:00,226,100,126,FMN GV 11 Ramsel
66,Bergstraat 71,2022-05-08,14:00:00,262,124,138,FMN GV 11 Ramsel
66,Bergstraat 71,2022-05-08,15:00:00,298,152,146,FMN GV 11 Ramsel
66,Bergstraat 71,2022-05-08,16:00:00,326,160,166,FMN GV 11 Ramsel
66,Bergstraat 71,2022-05-08,17:00:00,180,96,84,FMN GV 11 Ramsel
66,Bergstraat 71,2022-05-08,18:00:00,126,56,70,FMN GV 11 Ramsel
66,Bergstraat 71,2022-05-08,19:00:00,88,40,48,FMN GV 11 Ramsel
66,Bergstraat 71,2022-05-08,20:00:00,66,44,22,FMN GV 11 Ramsel
66,Bergstraat 71,2022-05-08,21:00:00,30,14,16,FMN GV 11 Ramsel
66,Bergstraat 71,2022-05-08,22:00:00,12,4,8,FMN GV 11 Ramsel
66,Bergstraat 71,2022-05-08,23:00:00,6,6,0,FMN GV 11 Ramsel
66,Bergstraat 71,2022-05-09,00:00:00,4,4,0,FMN GV 11 Ramsel
66,Bergstraat 71,2022-05-09,01:00:00,0,0,0,FMN GV 11 Ramsel
66,Bergstraat 71,2022-05-09,02:00:00,0,0,0,FMN GV 11 Ramsel
66,Bergstraat 71,2022-05-09,03:00:00,0,0,0,FMN GV 11 Ramsel
66,Bergstraat 71,2022-05-09,04:00:00,6,6,0,FMN GV 11 Ramsel
66,Bergstraat 71,2022-05-09,05:00:00,14,4,10,FMN GV 11 Ramsel
66,Bergstraat 71,2022-05-09,06:00:00,58,24,34,FMN GV 11 Ramsel
66,Bergstraat 71,2022-05-09,07:00:00,296,40,256,FMN GV 11 Ramsel
66,Bergstraat 71,2022-05-09,08:00:00,290,50,240,FMN GV 11 Ramsel
66,Bergstraat 71,2022-05-09,09:00:00,106,38,68,FMN GV 11 Ramsel
66,Bergstraat 71,2022-05-09,10:00:00,98,48,50,FMN GV 11 Ramsel
66,Bergstraat 71,2022-05-09,11:00:00,96,42,54,FMN GV 11 Ramsel
66,Bergstraat 71,2022-05-09,12:00:00,164,72,92,FMN GV 11 Ramsel
66,Bergstraat 71,2022-05-09,13:00:00,206,90,116,FMN GV 11 Ramsel
66,Bergstraat 71,2022-05-09,14:00:00,280,154,126,FMN GV 11 Ramsel
66,Bergstraat 71,2022-05-09,15:00:00,466,356,110,FMN GV 11 Ramsel
66,Bergstraat 71,2022-05-09,16:00:00,370,266,104,FMN GV 11 Ramsel
66,Bergstraat 71,2022-05-09,17:00:00,216,136,80,FMN GV 11 Ramsel
66,Bergstraat 71,2022-05-09,18:00:00,164,98,66,FMN GV 11 Ramsel
66,Bergstraat 71,2022-05-09,19:00:00,118,52,66,FMN GV 11 Ramsel
66,Bergstraat 71,2022-05-09,20:00:00,66,48,18,FMN GV 11 Ramsel
66,Bergstraat 71,2022-05-09,21:00:00,22,18,4,FMN GV 11 Ramsel
66,Bergstraat 71,2022-05-09,22:00:00,18,16,2,FMN GV 11 Ramsel
66,Bergstraat 71,2022-05-09,23:00:00,14,6,8,FMN GV 11 Ramsel
66,Bergstraat 71,2022-05-10,00:00:00,2,2,0,FMN GV 11 Ramsel
66,Bergstraat 71,2022-05-10,01:00:00,4,4,0,FMN GV 11 Ramsel
66,Bergstraat 71,2022-05-10,02:00:00,0,0,0,FMN GV 11 Ramsel
66,Bergstraat 71,2022-05-10,03:00:00,0,0,0,FMN GV 11 Ramsel
66,Bergstraat 71,2022-05-10,04:00:00,8,6,2,FMN GV 11 Ramsel
66,Bergstraat 71,2022-05-10,05:00:00,20,6,14,FMN GV 11 Ramsel
66,Bergstraat 71,2022-05-10,06:00:00,62,22,40,FMN GV 11 Ramsel
66,Bergstraat 71,2022-05-10,07:00:00,288,48,240,FMN GV 11 Ramsel
66,Bergstraat 71,2022-05-10,08:00:00,316,30,286,FMN GV 11 Ramsel
66,Bergstraat 71,2022-05-10,09:00:00,96,42,54,FMN GV 11 Ramsel
66,Bergstraat 71,2022-05-10,10:00:00,134,66,68,FMN GV 11 Ramsel
66,Bergstraat 71,2022-05-10,11:00:00,94,34,60,FMN GV 11 Ramsel
66,Bergstraat 71,2022-05-10,12:00:00,170,96,74,FMN GV 11 Ramsel
66,Bergstraat 71,2022-05-10,13:00:00,284,164,120,FMN GV 11 Ramsel
66,Bergstraat 71,2022-05-10,14:00:00,224,130,94,FMN GV 11 Ramsel
66,Bergstraat 71,2022-05-10,15:00:00,432,320,112,FMN GV 11 Ramsel
66,Bergstraat 71,2022-05-10,16:00:00,392,244,148,FMN GV 11 Ramsel
66,Bergstraat 71,2022-05-10,17:00:00,192,116,76,FMN GV 11 Ramsel
66,Bergstraat 71,2022-05-10,18:00:00,148,78,70,FMN GV 11 Ramsel
66,Bergstraat 71,2022-05-10,19:00:00,100,52,48,FMN GV 11 Ramsel
66,Bergstraat 71,2022-05-10,20:00:00,50,32,18,FMN GV 11 Ramsel
66,Bergstraat 71,2022-05-10,21:00:00,52,44,8,FMN GV 11 Ramsel
66,Bergstraat 71,2022-05-10,22:00:00,24,22,2,FMN GV 11 Ramsel
66,Bergstraat 71,2022-05-10,23:00:00,6,2,4,FMN GV 11 Ramsel
66,Bergstraat 71,2022-05-11,00:00:00,8,8,0,FMN GV 11 Ramsel
66,Bergstraat 71,2022-05-11,01:00:00,4,4,0,FMN GV 11 Ramsel
66,Bergstraat 71,2022-05-11,02:00:00,0,0,0,FMN GV 11 Ramsel
66,Bergstraat 71,2022-05-11,03:00:00,0,0,0,FMN GV 11 Ramsel
66,Bergstraat 71,2022-05-11,04:00:00,8,6,2,FMN GV 11 Ramsel
66,Bergstraat 71,2022-05-11,05:00:00,24,10,14,FMN GV 11 Ramsel
66,Bergstraat 71,2022-05-11,06:00:00,78,36,42,FMN GV 11 Ramsel
66,Bergstraat 71,2022-05-11,07:00:00,258,32,226,FMN GV 11 Ramsel
66,Bergstraat 71,2022-05-11,08:00:00,288,46,242,FMN GV 11 Ramsel
66,Bergstraat 71,2022-05-11,09:00:00,128,40,88,FMN GV 11 Ramsel
66,Bergstraat 71,2022-05-11,10:00:00,94,40,54,FMN GV 11 Ramsel
66,Bergstraat 71,2022-05-11,11:00:00,170,64,106,FMN GV 11 Ramsel
66,Bergstraat 71,2022-05-11,12:00:00,420,326,94,FMN GV 11 Ramsel
66,Bergstraat 71,2022-05-11,13:00:00,238,114,124,FMN GV 11 Ramsel
66,Bergstraat 71,2022-05-11,14:00:00,324,194,130,FMN GV 11 Ramsel
66,Bergstraat 71,2022-05-11,15:00:00,226,122,104,FMN GV 11 Ramsel
66,Bergstraat 71,2022-05-11,16:00:00,256,144,112,FMN GV 11 Ramsel
66,Bergstraat 71,2022-05-11,17:00:00,246,124,122,FMN GV 11 Ramsel
66,Bergstraat 71,2022-05-11,18:00:00,148,84,64,FMN GV 11 Ramsel
66,Bergstraat 71,2022-05-11,19:00:00,140,78,62,FMN GV 11 Ramsel
66,Bergstraat 71,2022-05-11,20:00:00,94,58,36,FMN GV 11 Ramsel
66,Bergstraat 71,2022-05-11,21:00:00,30,22,8,FMN GV 11 Ramsel
66,Bergstraat 71,2022-05-11,22:00:00,22,20,2,FMN GV 11 Ramsel
66,Bergstraat 71,2022-05-11,23:00:00,12,10,2,FMN GV 11 Ramsel
66,Bergstraat 71,2022-05-12,00:00:00,8,6,2,FMN GV 11 Ramsel
66,Bergstraat 71,2022-05-12,01:00:00,2,2,0,FMN GV 11 Ramsel
66,Bergstraat 71,2022-05-12,02:00:00,0,0,0,FMN GV 11 Ramsel
66,Bergstraat 71,2022-05-12,03:00:00,0,0,0,FMN GV 11 Ramsel
66,Bergstraat 71,2022-05-12,04:00:00,6,4,2,FMN GV 11 Ramsel
66,Bergstraat 71,2022-05-12,05:00:00,12,6,6,FMN GV 11 Ramsel
66,Bergstraat 71,2022-05-12,06:00:00,68,30,38,FMN GV 11 Ramsel
66,Bergstraat 71,2022-05-12,07:00:00,252,34,218,FMN GV 11 Ramsel
66,Bergstraat 71,2022-05-12,08:00:00,288,42,246,FMN GV 11 Ramsel
66,Bergstraat 71,2022-05-12,09:00:00,102,24,78,FMN GV 11 Ramsel
66,Bergstraat 71,2022-05-12,10:00:00,124,62,62,FMN GV 11 Ramsel
66,Bergstraat 71,2022-05-12,11:00:00,102,48,54,FMN GV 11 Ramsel
66,Bergstraat 71,2022-05-12,12:00:00,112,62,50,FMN GV 11 Ramsel
66,Bergstraat 71,2022-05-12,13:00:00,194,68,126,FMN GV 11 Ramsel
66,Bergstraat 71,2022-05-12,14:00:00,216,124,92,FMN GV 11 Ramsel
66,Bergstraat 71,2022-05-12,15:00:00,384,316,68,FMN GV 11 Ramsel
66,Bergstraat 71,2022-05-12,16:00:00,232,170,62,FMN GV 11 Ramsel
66,Bergstraat 71,2022-05-12,17:00:00,188,118,70,FMN GV 11 Ramsel
66,Bergstraat 71,2022-05-12,18:00:00,136,50,86,FMN GV 11 Ramsel
66,Bergstraat 71,2022-05-12,19:00:00,94,42,52,FMN GV 11 Ramsel
66,Bergstraat 71,2022-05-12,20:00:00,92,54,38,FMN GV 11 Ramsel
66,Bergstraat 71,2022-05-12,21:00:00,44,34,10,FMN GV 11 Ramsel
66,Bergstraat 71,2022-05-12,22:00:00,20,16,4,FMN GV 11 Ramsel
66,Bergstraat 71,2022-05-12,23:00:00,2,0,2,FMN GV 11 Ramsel
66,Bergstraat 71,2022-05-13,00:00:00,10,6,4,FMN GV 11 Ramsel
66,Bergstraat 71,2022-05-13,01:00:00,6,4,2,FMN GV 11 Ramsel
66,Bergstraat 71,2022-05-13,02:00:00,2,2,0,FMN GV 11 Ramsel
66,Bergstraat 71,2022-05-13,03:00:00,0,0,0,FMN GV 11 Ramsel
66,Bergstraat 71,2022-05-13,04:00:00,6,6,0,FMN GV 11 Ramsel
66,Bergstraat 71,2022-05-13,05:00:00,10,4,6,FMN GV 11 Ramsel
66,Bergstraat 71,2022-05-13,06:00:00,40,18,22,FMN GV 11 Ramsel
66,Bergstraat 71,2022-05-13,07:00:00,248,38,210,FMN GV 11 Ramsel
66,Bergstraat 71,2022-05-13,08:00:00,268,42,226,FMN GV 11 Ramsel
66,Bergstraat 71,2022-05-13,09:00:00,78,26,52,FMN GV 11 Ramsel
66,Bergstraat 71,2022-05-13,10:00:00,50,30,20,FMN GV 11 Ramsel
66,Bergstraat 71,2022-05-13,11:00:00,94,48,46,FMN GV 11 Ramsel
66,Bergstraat 71,2022-05-13,12:00:00,150,66,84,FMN GV 11 Ramsel
66,Bergstraat 71,2022-05-13,13:00:00,128,64,64,FMN GV 11 Ramsel
66,Bergstraat 71,2022-05-13,14:00:00,186,100,86,FMN GV 11 Ramsel
66,Bergstraat 71,2022-05-13,15:00:00,320,244,76,FMN GV 11 Ramsel
66,Bergstraat 71,2022-05-13,16:00:00,204,150,54,FMN GV 11 Ramsel
66,Bergstraat 71,2022-05-13,17:00:00,150,108,42,FMN GV 11 Ramsel
66,Bergstraat 71,2022-05-13,18:00:00,112,78,34,FMN GV 11 Ramsel
66,Bergstraat 71,2022-05-13,19:00:00,98,38,60,FMN GV 11 Ramsel
66,Bergstraat 71,2022-05-13,20:00:00,60,28,32,FMN GV 11 Ramsel
66,Bergstraat 71,2022-05-13,21:00:00,40,22,18,FMN GV 11 Ramsel
66,Bergstraat 71,2022-05-13,22:00:00,24,18,6,FMN GV 11 Ramsel
66,Bergstraat 71,2022-05-13,23:00:00,8,4,4,FMN GV 11 Ramsel
66,Bergstraat 71,2022-05-14,00:00:00,18,12,6,FMN GV 11 Ramsel
66,Bergstraat 71,2022-05-14,01:00:00,12,8,4,FMN GV 11 Ramsel
66,Bergstraat 71,2022-05-14,02:00:00,6,6,0,FMN GV 11 Ramsel
66,Bergstraat 71,2022-05-14,03:00:00,2,0,2,FMN GV 11 Ramsel
66,Bergstraat 71,2022-05-14,04:00:00,0,0,0,FMN GV 11 Ramsel
66,Bergstraat 71,2022-05-14,05:00:00,2,0,2,FMN GV 11 Ramsel
66,Bergstraat 71,2022-05-14,06:00:00,10,6,4,FMN GV 11 Ramsel
66,Bergstraat 71,2022-05-14,07:00:00,22,10,12,FMN GV 11 Ramsel
66,Bergstraat 71,2022-05-14,08:00:00,52,22,30,FMN GV 11 Ramsel
66,Bergstraat 71,2022-05-14,09:00:00,106,34,72,FMN GV 11 Ramsel
66,Bergstraat 71,2022-05-14,10:00:00,158,70,88,FMN GV 11 Ramsel
66,Bergstraat 71,2022-05-14,11:00:00,156,82,74,FMN GV 11 Ramsel
66,Bergstraat 71,2022-05-14,12:00:00,194,94,100,FMN GV 11 Ramsel
66,Bergstraat 71,2022-05-14,13:00:00,284,136,148,FMN GV 11 Ramsel
66,Bergstraat 71,2022-05-14,14:00:00,374,162,212,FMN GV 11 Ramsel
66,Bergstraat 71,2022-05-14,15:00:00,352,222,130,FMN GV 11 Ramsel
66,Bergstraat 71,2022-05-14,16:00:00,298,130,168,FMN GV 11 Ramsel
66,Bergstraat 71,2022-05-14,17:00:00,140,72,68,FMN GV 11 Ramsel
66,Bergstraat 71,2022-05-14,18:00:00,126,54,72,FMN GV 11 Ramsel
66,Bergstraat 71,2022-05-14,19:00:00,78,44,34,FMN GV 11 Ramsel
66,Bergstraat 71,2022-05-14,20:00:00,84,40,44,FMN GV 11 Ramsel
66,Bergstraat 71,2022-05-14,21:00:00,42,18,24,FMN GV 11 Ramsel
66,Bergstraat 71,2022-05-14,22:00:00,38,26,12,FMN GV 11 Ramsel
66,Bergstraat 71,2022-05-14,23:00:00,16,12,4,FMN GV 11 Ramsel
66,Bergstraat 71,2022-05-15,00:00:00,10,4,6,FMN GV 11 Ramsel
66,Bergstraat 71,2022-05-15,01:00:00,0,0,0,FMN GV 11 Ramsel
66,Bergstraat 71,2022-05-15,02:00:00,6,6,0,FMN GV 11 Ramsel
66,Bergstraat 71,2022-05-15,03:00:00,4,2,2,FMN GV 11 Ramsel
66,Bergstraat 71,2022-05-15,04:00:00,0,0,0,FMN GV 11 Ramsel
66,Bergstraat 71,2022-05-15,05:00:00,4,4,0,FMN GV 11 Ramsel
66,Bergstraat 71,2022-05-15,06:00:00,8,2,6,FMN GV 11 Ramsel
66,Bergstraat 71,2022-05-15,07:00:00,34,6,28,FMN GV 11 Ramsel
66,Bergstraat 71,2022-05-15,08:00:00,106,34,72,FMN GV 11 Ramsel
66,Bergstraat 71,2022-05-15,09:00:00,184,76,108,FMN GV 11 Ramsel
66,Bergstraat 71,2022-05-15,10:00:00,188,90,98,FMN GV 11 Ramsel
66,Bergstraat 71,2022-05-15,11:00:00,306,128,178,FMN GV 11 Ramsel
66,Bergstraat 71,2022-05-15,12:00:00,230,122,108,FMN GV 11 Ramsel
66,Bergstraat 71,2022-05-15,13:00:00,394,172,222,FMN GV 11 Ramsel
66,Bergstraat 71,2022-05-15,14:00:00,390,200,190,FMN GV 11 Ramsel
66,Bergstraat 71,2022-05-15,15:00:00,302,136,166,FMN GV 11 Ramsel
66,Bergstraat 71,2022-05-15,16:00:00,238,138,100,FMN GV 11 Ramsel
66,Bergstraat 71,2022-05-15,17:00:00,138,60,78,FMN GV 11 Ramsel
66,Bergstraat 71,2022-05-15,18:00:00,142,78,64,FMN GV 11 Ramsel
66,Bergstraat 71,2022-05-15,19:00:00,128,66,62,FMN GV 11 Ramsel
66,Bergstraat 71,2022-05-15,20:00:00,90,44,46,FMN GV 11 Ramsel
66,Bergstraat 71,2022-05-15,21:00:00,26,18,8,FMN GV 11 Ramsel
66,Bergstraat 71,2022-05-15,22:00:00,8,8,0,FMN GV 11 Ramsel
66,Bergstraat 71,2022-05-15,23:00:00,2,0,2,FMN GV 11 Ramsel
66,Bergstraat 71,2022-05-16,00:00:00,0,0,0,FMN GV 11 Ramsel
66,Bergstraat 71,2022-05-16,01:00:00,2,0,2,FMN GV 11 Ramsel
66,Bergstraat 71,2022-05-16,02:00:00,0,0,0,FMN GV 11 Ramsel
66,Bergstraat 71,2022-05-16,03:00:00,2,0,2,FMN GV 11 Ramsel
66,Bergstraat 71,2022-05-16,04:00:00,6,4,2,FMN GV 11 Ramsel
66,Bergstraat 71,2022-05-16,05:00:00,14,8,6,FMN GV 11 Ramsel
66,Bergstraat 71,2022-05-16,06:00:00,54,22,32,FMN GV 11 Ramsel
66,Bergstraat 71,2022-05-16,07:00:00,236,26,210,FMN GV 11 Ramsel
66,Bergstraat 71,2022-05-16,08:00:00,276,36,240,FMN GV 11 Ramsel
66,Bergstraat 71,2022-05-16,09:00:00,92,44,48,FMN GV 11 Ramsel
66,Bergstraat 71,2022-05-16,10:00:00,88,46,42,FMN GV 11 Ramsel
66,Bergstraat 71,2022-05-16,11:00:00,86,44,42,FMN GV 11 Ramsel
66,Bergstraat 71,2022-05-16,12:00:00,90,60,30,FMN GV 11 Ramsel
66,Bergstraat 71,2022-05-16,13:00:00,72,28,44,FMN GV 11 Ramsel
66,Bergstraat 71,2022-05-16,14:00:00,92,42,50,FMN GV 11 Ramsel
66,Bergstraat 71,2022-05-16,15:00:00,300,260,40,FMN GV 11 Ramsel
66,Bergstraat 71,2022-05-16,16:00:00,262,194,68,FMN GV 11 Ramsel
66,Bergstraat 71,2022-05-16,17:00:00,128,88,40,FMN GV 11 Ramsel
66,Bergstraat 71,2022-05-16,18:00:00,104,50,54,FMN GV 11 Ramsel
66,Bergstraat 71,2022-05-16,19:00:00,84,44,40,FMN GV 11 Ramsel
66,Bergstraat 71,2022-05-16,20:00:00,52,34,18,FMN GV 11 Ramsel
66,Bergstraat 71,2022-05-16,21:00:00,40,20,20,FMN GV 11 Ramsel
66,Bergstraat 71,2022-05-16,22:00:00,24,18,6,FMN GV 11 Ramsel
66,Bergstraat 71,2022-05-16,23:00:00,0,0,0,FMN GV 11 Ramsel
66,Bergstraat 71,2022-05-17,00:00:00,4,0,4,FMN GV 11 Ramsel
66,Bergstraat 71,2022-05-17,01:00:00,4,4,0,FMN GV 11 Ramsel
66,Bergstraat 71,2022-05-17,02:00:00,0,0,0,FMN GV 11 Ramsel
66,Bergstraat 71,2022-05-17,03:00:00,0,0,0,FMN GV 11 Ramsel
66,Bergstraat 71,2022-05-17,04:00:00,8,4,4,FMN GV 11 Ramsel
66,Bergstraat 71,2022-05-17,05:00:00,14,10,4,FMN GV 11 Ramsel
66,Bergstraat 71,2022-05-17,06:00:00,68,24,44,FMN GV 11 Ramsel
66,Bergstraat 71,2022-05-17,07:00:00,300,48,252,FMN GV 11 Ramsel
66,Bergstraat 71,2022-05-17,08:00:00,300,44,256,FMN GV 11 Ramsel
66,Bergstraat 71,2022-05-17,09:00:00,50,28,22,FMN GV 11 Ramsel
66,Bergstraat 71,2022-05-17,10:00:00,52,30,22,FMN GV 11 Ramsel
66,Bergstraat 71,2022-05-17,11:00:00,80,22,58,FMN GV 11 Ramsel
66,Bergstraat 71,2022-05-17,12:00:00,134,62,72,FMN GV 11 Ramsel
66,Bergstraat 71,2022-05-17,13:00:00,214,94,120,FMN GV 11 Ramsel
66,Bergstraat 71,2022-05-17,14:00:00,286,146,140,FMN GV 11 Ramsel
66,Bergstraat 71,2022-05-17,15:00:00,464,352,112,FMN GV 11 Ramsel
66,Bergstraat 71,2022-05-17,16:00:00,314,202,112,FMN GV 11 Ramsel
66,Bergstraat 71,2022-05-17,17:00:00,232,140,92,FMN GV 11 Ramsel
66,Bergstraat 71,2022-05-17,18:00:00,206,94,112,FMN GV 11 Ramsel
66,Bergstraat 71,2022-05-17,19:00:00,110,46,64,FMN GV 11 Ramsel
66,Bergstraat 71,2022-05-17,20:00:00,136,84,52,FMN GV 11 Ramsel
66,Bergstraat 71,2022-05-17,21:00:00,56,38,18,FMN GV 11 Ramsel
66,Bergstraat 71,2022-05-17,22:00:00,34,24,10,FMN GV 11 Ramsel
66,Bergstraat 71,2022-05-17,23:00:00,18,12,6,FMN GV 11 Ramsel
66,Bergstraat 71,2022-05-18,00:00:00,4,4,0,FMN GV 11 Ramsel
66,Bergstraat 71,2022-05-18,01:00:00,4,4,0,FMN GV 11 Ramsel
66,Bergstraat 71,2022-05-18,02:00:00,0,0,0,FMN GV 11 Ramsel
66,Bergstraat 71,2022-05-18,03:00:00,0,0,0,FMN GV 11 Ramsel
66,Bergstraat 71,2022-05-18,04:00:00,6,4,2,FMN GV 11 Ramsel
66,Bergstraat 71,2022-05-18,05:00:00,22,6,16,FMN GV 11 Ramsel
66,Bergstraat 71,2022-05-18,06:00:00,74,30,44,FMN GV 11 Ramsel
66,Bergstraat 71,2022-05-18,07:00:00,270,38,232,FMN GV 11 Ramsel
66,Bergstraat 71,2022-05-18,08:00:00,296,46,250,FMN GV 11 Ramsel
66,Bergstraat 71,2022-05-18,09:00:00,108,40,68,FMN GV 11 Ramsel
66,Bergstraat 71,2022-05-18,10:00:00,144,64,80,FMN GV 11 Ramsel
66,Bergstraat 71,2022-05-18,11:00:00,182,94,88,FMN GV 11 Ramsel
66,Bergstraat 71,2022-05-18,12:00:00,418,344,74,FMN GV 11 Ramsel
66,Bergstraat 71,2022-05-18,13:00:00,252,126,126,FMN GV 11 Ramsel
66,Bergstraat 71,2022-05-18,14:00:00,260,158,102,FMN GV 11 Ramsel
66,Bergstraat 71,2022-05-18,15:00:00,246,162,84,FMN GV 11 Ramsel
66,Bergstraat 71,2022-05-18,16:00:00,304,182,122,FMN GV 11 Ramsel
66,Bergstraat 71,2022-05-18,17:00:00,304,162,142,FMN GV 11 Ramsel
66,Bergstraat 71,2022-05-18,18:00:00,174,86,88,FMN GV 11 Ramsel
66,Bergstraat 71,2022-05-18,19:00:00,190,94,96,FMN GV 11 Ramsel
66,Bergstraat 71,2022-05-18,20:00:00,128,72,56,FMN GV 11 Ramsel
66,Bergstraat 71,2022-05-18,21:00:00,82,40,42,FMN GV 11 Ramsel
66,Bergstraat 71,2022-05-18,22:00:00,32,20,12,FMN GV 11 Ramsel
66,Bergstraat 71,2022-05-18,23:00:00,2,2,0,FMN GV 11 Ramsel
66,Bergstraat 71,2022-05-19,00:00:00,8,4,4,FMN GV 11 Ramsel
66,Bergstraat 71,2022-05-19,01:00:00,6,6,0,FMN GV 11 Ramsel
66,Bergstraat 71,2022-05-19,02:00:00,0,0,0,FMN GV 11 Ramsel
66,Bergstraat 71,2022-05-19,03:00:00,0,0,0,FMN GV 11 Ramsel
66,Bergstraat 71,2022-05-19,04:00:00,10,4,6,FMN GV 11 Ramsel
66,Bergstraat 71,2022-05-19,05:00:00,14,10,4,FMN GV 11 Ramsel
66,Bergstraat 71,2022-05-19,06:00:00,24,10,14,FMN GV 11 Ramsel
66,Bergstraat 71,2022-05-19,07:00:00,154,14,140,FMN GV 11 Ramsel
66,Bergstraat 71,2022-05-19,08:00:00,188,20,168,FMN GV 11 Ramsel
66,Bergstraat 71,2022-05-19,09:00:00,82,14,68,FMN GV 11 Ramsel
66,Bergstraat 71,2022-05-19,10:00:00,96,44,52,FMN GV 11 Ramsel
66,Bergstraat 71,2022-05-19,11:00:00,66,38,28,FMN GV 11 Ramsel
66,Bergstraat 71,2022-05-19,12:00:00,66,36,30,FMN GV 11 Ramsel
66,Bergstraat 71,2022-05-19,13:00:00,48,38,10,FMN GV 11 Ramsel
66,Bergstraat 71,2022-05-19,14:00:00,60,46,14,FMN GV 11 Ramsel
66,Bergstraat 71,2022-05-19,15:00:00,158,134,24,FMN GV 11 Ramsel
66,Bergstraat 71,2022-05-19,16:00:00,136,102,34,FMN GV 11 Ramsel
66,Bergstraat 71,2022-05-19,17:00:00,80,42,38,FMN GV 11 Ramsel
66,Bergstraat 71,2022-05-19,18:00:00,102,58,44,FMN GV 11 Ramsel
66,Bergstraat 71,2022-05-19,19:00:00,40,22,18,FMN GV 11 Ramsel
66,Bergstraat 71,2022-05-19,20:00:00,44,34,10,FMN GV 11 Ramsel
66,Bergstraat 71,2022-05-19,21:00:00,20,10,10,FMN GV 11 Ramsel
66,Bergstraat 71,2022-05-19,22:00:00,6,4,2,FMN GV 11 Ramsel
66,Bergstraat 71,2022-05-19,23:00:00,4,2,2,FMN GV 11 Ramsel
66,Bergstraat 71,2022-05-20,00:00:00,8,2,6,FMN GV 11 Ramsel
66,Bergstraat 71,2022-05-20,01:00:00,4,4,0,FMN GV 11 Ramsel
66,Bergstraat 71,2022-05-20,02:00:00,0,0,0,FMN GV 11 Ramsel
66,Bergstraat 71,2022-05-20,03:00:00,0,0,0,FMN GV 11 Ramsel
66,Bergstraat 71,2022-05-20,04:00:00,2,2,0,FMN GV 11 Ramsel
66,Bergstraat 71,2022-05-20,05:00:00,12,6,6,FMN GV 11 Ramsel
66,Bergstraat 71,2022-05-20,06:00:00,26,10,16,FMN GV 11 Ramsel
66,Bergstraat 71,2022-05-20,07:00:00,126,22,104,FMN GV 11 Ramsel
66,Bergstraat 71,2022-05-20,08:00:00,190,32,158,FMN GV 11 Ramsel
66,Bergstraat 71,2022-05-20,09:00:00,82,46,36,FMN GV 11 Ramsel
66,Bergstraat 71,2022-05-20,10:00:00,40,24,16,FMN GV 11 Ramsel
66,Bergstraat 71,2022-05-20,11:00:00,34,18,16,FMN GV 11 Ramsel
66,Bergstraat 71,2022-05-20,12:00:00,34,20,14,FMN GV 11 Ramsel
66,Bergstraat 71,2022-05-20,13:00:00,32,26,6,FMN GV 11 Ramsel
66,Bergstraat 71,2022-05-20,14:00:00,34,16,18,FMN GV 11 Ramsel
66,Bergstraat 71,2022-05-20,15:00:00,120,110,10,FMN GV 11 Ramsel
66,Bergstraat 71,2022-05-20,16:00:00,110,96,14,FMN GV 11 Ramsel
66,Bergstraat 71,2022-05-20,17:00:00,56,38,18,FMN GV 11 Ramsel
66,Bergstraat 71,2022-05-20,18:00:00,44,24,20,FMN GV 11 Ramsel
66,Bergstraat 71,2022-05-20,19:00:00,44,20,24,FMN GV 11 Ramsel
66,Bergstraat 71,2022-05-20,20:00:00,30,16,14,FMN GV 11 Ramsel
66,Bergstraat 71,2022-05-20,21:00:00,22,12,10,FMN GV 11 Ramsel
66,Bergstraat 71,2022-05-20,22:00:00,16,6,10,FMN GV 11 Ramsel
66,Bergstraat 71,2022-05-20,23:00:00,12,12,0,FMN GV 11 Ramsel
66,Bergstraat 71,2022-05-21,00:00:00,8,0,8,FMN GV 11 Ramsel
66,Bergstraat 71,2022-05-21,01:00:00,10,8,2,FMN GV 11 Ramsel
66,Bergstraat 71,2022-05-21,02:00:00,8,4,4,FMN GV 11 Ramsel
66,Bergstraat 71,2022-05-21,03:00:00,4,2,2,FMN GV 11 Ramsel
66,Bergstraat 71,2022-05-21,04:00:00,0,0,0,FMN GV 11 Ramsel
66,Bergstraat 71,2022-05-21,05:00:00,0,0,0,FMN GV 11 Ramsel
66,Bergstraat 71,2022-05-21,06:00:00,10,2,8,FMN GV 11 Ramsel
66,Bergstraat 71,2022-05-21,07:00:00,26,14,12,FMN GV 11 Ramsel
66,Bergstraat 71,2022-05-21,08:00:00,42,14,28,FMN GV 11 Ramsel
66,Bergstraat 71,2022-05-21,09:00:00,82,24,58,FMN GV 11 Ramsel
66,Bergstraat 71,2022-05-21,10:00:00,108,50,58,FMN GV 11 Ramsel
66,Bergstraat 71,2022-05-21,11:00:00,138,66,72,FMN GV 11 Ramsel
66,Bergstraat 71,2022-05-21,12:00:00,178,70,108,FMN GV 11 Ramsel
66,Bergstraat 71,2022-05-21,13:00:00,220,110,110,FMN GV 11 Ramsel
66,Bergstraat 71,2022-05-21,14:00:00,230,112,118,FMN GV 11 Ramsel
66,Bergstraat 71,2022-05-21,15:00:00,236,144,92,FMN GV 11 Ramsel
66,Bergstraat 71,2022-05-21,16:00:00,190,128,62,FMN GV 11 Ramsel
66,Bergstraat 71,2022-05-21,17:00:00,162,106,56,FMN GV 11 Ramsel
66,Bergstraat 71,2022-05-21,18:00:00,94,68,26,FMN GV 11 Ramsel
66,Bergstraat 71,2022-05-21,19:00:00,76,46,30,FMN GV 11 Ramsel
66,Bergstraat 71,2022-05-21,20:00:00,50,26,24,FMN GV 11 Ramsel
66,Bergstraat 71,2022-05-21,21:00:00,52,18,34,FMN GV 11 Ramsel
66,Bergstraat 71,2022-05-21,22:00:00,22,12,10,FMN GV 11 Ramsel
66,Bergstraat 71,2022-05-21,23:00:00,12,4,8,FMN GV 11 Ramsel
66,Bergstraat 71,2022-05-22,00:00:00,4,2,2,FMN GV 11 Ramsel
66,Bergstraat 71,2022-05-22,01:00:00,6,6,0,FMN GV 11 Ramsel
66,Bergstraat 71,2022-05-22,02:00:00,2,2,0,FMN GV 11 Ramsel
66,Bergstraat 71,2022-05-22,03:00:00,4,0,4,FMN GV 11 Ramsel
66,Bergstraat 71,2022-05-22,04:00:00,2,2,0,FMN GV 11 Ramsel
66,Bergstraat 71,2022-05-22,05:00:00,2,0,2,FMN GV 11 Ramsel
66,Bergstraat 71,2022-05-22,06:00:00,16,8,8,FMN GV 11 Ramsel
66,Bergstraat 71,2022-05-22,07:00:00,26,8,18,FMN GV 11 Ramsel
66,Bergstraat 71,2022-05-22,08:00:00,120,50,70,FMN GV 11 Ramsel
66,Bergstraat 71,2022-05-22,09:00:00,190,62,128,FMN GV 11 Ramsel
66,Bergstraat 71,2022-05-22,10:00:00,246,112,134,FMN GV 11 Ramsel
66,Bergstraat 71,2022-05-22,11:00:00,290,164,126,FMN GV 11 Ramsel
66,Bergstraat 71,2022-05-22,12:00:00,230,112,118,FMN GV 11 Ramsel
66,Bergstraat 71,2022-05-22,13:00:00,276,114,162,FMN GV 11 Ramsel
66,Bergstraat 71,2022-05-22,14:00:00,456,236,220,FMN GV 11 Ramsel
66,Bergstraat 71,2022-05-22,15:00:00,334,190,144,FMN GV 11 Ramsel
66,Bergstraat 71,2022-05-22,16:00:00,232,144,88,FMN GV 11 Ramsel
66,Bergstraat 71,2022-05-22,17:00:00,226,76,150,FMN GV 11 Ramsel
66,Bergstraat 71,2022-05-22,18:00:00,182,74,108,FMN GV 11 Ramsel
66,Bergstraat 71,2022-05-22,19:00:00,78,44,34,FMN GV 11 Ramsel
66,Bergstraat 71,2022-05-22,20:00:00,70,20,50,FMN GV 11 Ramsel
66,Bergstraat 71,2022-05-22,21:00:00,40,18,22,FMN GV 11 Ramsel
66,Bergstraat 71,2022-05-22,22:00:00,16,10,6,FMN GV 11 Ramsel
66,Bergstraat 71,2022-05-22,23:00:00,2,2,0,FMN GV 11 Ramsel
66,Bergstraat 71,2022-05-23,00:00:00,2,0,2,FMN GV 11 Ramsel
66,Bergstraat 71,2022-05-23,01:00:00,0,0,0,FMN GV 11 Ramsel
66,Bergstraat 71,2022-05-23,02:00:00,0,0,0,FMN GV 11 Ramsel
66,Bergstraat 71,2022-05-23,03:00:00,2,0,2,FMN GV 11 Ramsel
66,Bergstraat 71,2022-05-23,04:00:00,6,2,4,FMN GV 11 Ramsel
66,Bergstraat 71,2022-05-23,05:00:00,12,8,4,FMN GV 11 Ramsel
66,Bergstraat 71,2022-05-23,06:00:00,40,12,28,FMN GV 11 Ramsel
66,Bergstraat 71,2022-05-23,07:00:00,186,24,162,FMN GV 11 Ramsel
66,Bergstraat 71,2022-05-23,08:00:00,232,32,200,FMN GV 11 Ramsel
66,Bergstraat 71,2022-05-23,09:00:00,52,26,26,FMN GV 11 Ramsel
66,Bergstraat 71,2022-05-23,10:00:00,56,26,30,FMN GV 11 Ramsel
66,Bergstraat 71,2022-05-23,11:00:00,26,6,20,FMN GV 11 Ramsel
66,Bergstraat 71,2022-05-23,12:00:00,70,46,24,FMN GV 11 Ramsel
66,Bergstraat 71,2022-05-23,13:00:00,40,22,18,FMN GV 11 Ramsel
66,Bergstraat 71,2022-05-23,14:00:00,48,22,26,FMN GV 11 Ramsel
66,Bergstraat 71,2022-05-23,15:00:00,224,202,22,FMN GV 11 Ramsel
66,Bergstraat 71,2022-05-23,16:00:00,138,118,20,FMN GV 11 Ramsel
66,Bergstraat 71,2022-05-23,17:00:00,54,44,10,FMN GV 11 Ramsel
66,Bergstraat 71,2022-05-23,18:00:00,34,16,18,FMN GV 11 Ramsel
66,Bergstraat 71,2022-05-23,19:00:00,24,12,12,FMN GV 11 Ramsel
66,Bergstraat 71,2022-05-23,20:00:00,20,18,2,FMN GV 11 Ramsel
66,Bergstraat 71,2022-05-23,21:00:00,14,8,6,FMN GV 11 Ramsel
66,Bergstraat 71,2022-05-23,22:00:00,14,8,6,FMN GV 11 Ramsel
66,Bergstraat 71,2022-05-23,23:00:00,2,2,0,FMN GV 11 Ramsel
66,Bergstraat 71,2022-05-24,00:00:00,0,0,0,FMN GV 11 Ramsel
66,Bergstraat 71,2022-05-24,01:00:00,0,0,0,FMN GV 11 Ramsel
66,Bergstraat 71,2022-05-24,02:00:00,0,0,0,FMN GV 11 Ramsel
66,Bergstraat 71,2022-05-24,03:00:00,0,0,0,FMN GV 11 Ramsel
66,Bergstraat 71,2022-05-24,04:00:00,6,4,2,FMN GV 11 Ramsel
66,Bergstraat 71,2022-05-24,05:00:00,14,8,6,FMN GV 11 Ramsel
66,Bergstraat 71,2022-05-24,06:00:00,50,12,38,FMN GV 11 Ramsel
66,Bergstraat 71,2022-05-24,07:00:00,190,26,164,FMN GV 11 Ramsel
66,Bergstraat 71,2022-05-24,08:00:00,236,44,192,FMN GV 11 Ramsel
66,Bergstraat 71,2022-05-24,09:00:00,62,28,34,FMN GV 11 Ramsel
66,Bergstraat 71,2022-05-24,10:00:00,108,48,60,FMN GV 11 Ramsel
66,Bergstraat 71,2022-05-24,11:00:00,54,28,26,FMN GV 11 Ramsel
66,Bergstraat 71,2022-05-24,12:00:00,80,58,22,FMN GV 11 Ramsel
66,Bergstraat 71,2022-05-24,13:00:00,72,34,38,FMN GV 11 Ramsel
66,Bergstraat 71,2022-05-24,14:00:00,68,40,28,FMN GV 11 Ramsel
66,Bergstraat 71,2022-05-24,15:00:00,250,202,48,FMN GV 11 Ramsel
66,Bergstraat 71,2022-05-24,16:00:00,138,106,32,FMN GV 11 Ramsel
66,Bergstraat 71,2022-05-24,17:00:00,98,62,36,FMN GV 11 Ramsel
66,Bergstraat 71,2022-05-24,18:00:00,50,28,22,FMN GV 11 Ramsel
66,Bergstraat 71,2022-05-24,19:00:00,76,40,36,FMN GV 11 Ramsel
66,Bergstraat 71,2022-05-24,20:00:00,42,24,18,FMN GV 11 Ramsel
66,Bergstraat 71,2022-05-24,21:00:00,22,18,4,FMN GV 11 Ramsel
66,Bergstraat 71,2022-05-24,22:00:00,14,6,8,FMN GV 11 Ramsel
66,Bergstraat 71,2022-05-24,23:00:00,6,6,0,FMN GV 11 Ramsel
66,Bergstraat 71,2022-05-25,00:00:00,0,0,0,FMN GV 11 Ramsel
66,Bergstraat 71,2022-05-25,01:00:00,2,2,0,FMN GV 11 Ramsel
66,Bergstraat 71,2022-05-25,02:00:00,0,0,0,FMN GV 11 Ramsel
66,Bergstraat 71,2022-05-25,03:00:00,0,0,0,FMN GV 11 Ramsel
66,Bergstraat 71,2022-05-25,04:00:00,6,2,4,FMN GV 11 Ramsel
66,Bergstraat 71,2022-05-25,05:00:00,12,6,6,FMN GV 11 Ramsel
66,Bergstraat 71,2022-05-25,06:00:00,34,18,16,FMN GV 11 Ramsel
66,Bergstraat 71,2022-05-25,07:00:00,162,22,140,FMN GV 11 Ramsel
66,Bergstraat 71,2022-05-25,08:00:00,176,26,150,FMN GV 11 Ramsel
66,Bergstraat 71,2022-05-25,09:00:00,84,30,54,FMN GV 11 Ramsel
66,Bergstraat 71,2022-05-25,10:00:00,108,50,58,FMN GV 11 Ramsel
66,Bergstraat 71,2022-05-25,11:00:00,112,58,54,FMN GV 11 Ramsel
66,Bergstraat 71,2022-05-25,12:00:00,220,166,54,FMN GV 11 Ramsel
66,Bergstraat 71,2022-05-25,13:00:00,208,110,98,FMN GV 11 Ramsel
66,Bergstraat 71,2022-05-25,14:00:00,134,78,56,FMN GV 11 Ramsel
66,Bergstraat 71,2022-05-25,15:00:00,166,104,62,FMN GV 11 Ramsel
66,Bergstraat 71,2022-05-25,16:00:00,142,84,58,FMN GV 11 Ramsel
66,Bergstraat 71,2022-05-25,17:00:00,102,44,58,FMN GV 11 Ramsel
66,Bergstraat 71,2022-05-25,18:00:00,104,60,44,FMN GV 11 Ramsel
66,Bergstraat 71,2022-05-25,19:00:00,84,58,26,FMN GV 11 Ramsel
66,Bergstraat 71,2022-05-25,20:00:00,60,36,24,FMN GV 11 Ramsel
66,Bergstraat 71,2022-05-25,21:00:00,110,44,66,FMN GV 11 Ramsel
66,Bergstraat 71,2022-05-25,22:00:00,174,124,50,FMN GV 11 Ramsel
66,Bergstraat 71,2022-05-25,23:00:00,30,20,10,FMN GV 11 Ramsel
66,Bergstraat 71,2022-05-26,00:00:00,10,4,6,FMN GV 11 Ramsel
66,Bergstraat 71,2022-05-26,01:00:00,30,14,16,FMN GV 11 Ramsel
66,Bergstraat 71,2022-05-26,02:00:00,8,2,6,FMN GV 11 Ramsel
66,Bergstraat 71,2022-05-26,03:00:00,6,2,4,FMN GV 11 Ramsel
66,Bergstraat 71,2022-05-26,04:00:00,6,4,2,FMN GV 11 Ramsel
66,Bergstraat 71,2022-05-26,05:00:00,10,4,6,FMN GV 11 Ramsel
66,Bergstraat 71,2022-05-26,06:00:00,12,6,6,FMN GV 11 Ramsel
66,Bergstraat 71,2022-05-26,07:00:00,20,6,14,FMN GV 11 Ramsel
66,Bergstraat 71,2022-05-26,08:00:00,30,4,26,FMN GV 11 Ramsel
66,Bergstraat 71,2022-05-26,09:00:00,114,28,86,FMN GV 11 Ramsel
66,Bergstraat 71,2022-05-26,10:00:00,232,86,146,FMN GV 11 Ramsel
66,Bergstraat 71,2022-05-26,11:00:00,142,58,84,FMN GV 11 Ramsel
66,Bergstraat 71,2022-05-26,12:00:00,200,88,112,FMN GV 11 Ramsel
66,Bergstraat 71,2022-05-26,13:00:00,340,164,176,FMN GV 11 Ramsel
66,Bergstraat 71,2022-05-26,14:00:00,430,206,224,FMN GV 11 Ramsel
66,Bergstraat 71,2022-05-26,15:00:00,410,132,278,FMN GV 11 Ramsel
66,Bergstraat 71,2022-05-26,16:00:00,218,112,106,FMN GV 11 Ramsel
66,Bergstraat 71,2022-05-26,17:00:00,234,88,146,FMN GV 11 Ramsel
66,Bergstraat 71,2022-05-26,18:00:00,170,78,92,FMN GV 11 Ramsel
66,Bergstraat 71,2022-05-26,19:00:00,60,30,30,FMN GV 11 Ramsel
66,Bergstraat 71,2022-05-26,20:00:00,76,32,44,FMN GV 11 Ramsel
66,Bergstraat 71,2022-05-26,21:00:00,26,6,20,FMN GV 11 Ramsel
66,Bergstraat 71,2022-05-26,22:00:00,22,10,12,FMN GV 11 Ramsel
66,Bergstraat 71,2022-05-26,23:00:00,14,6,8,FMN GV 11 Ramsel
66,Bergstraat 71,2022-05-27,00:00:00,20,2,18,FMN GV 11 Ramsel
66,Bergstraat 71,2022-05-27,01:00:00,8,4,4,FMN GV 11 Ramsel
66,Bergstraat 71,2022-05-27,02:00:00,0,0,0,FMN GV 11 Ramsel
66,Bergstraat 71,2022-05-27,03:00:00,0,0,0,FMN GV 11 Ramsel
66,Bergstraat 71,2022-05-27,04:00:00,4,0,4,FMN GV 11 Ramsel
66,Bergstraat 71,2022-05-27,05:00:00,10,6,4,FMN GV 11 Ramsel
66,Bergstraat 71,2022-05-27,06:00:00,6,0,6,FMN GV 11 Ramsel
66,Bergstraat 71,2022-05-27,07:00:00,24,6,18,FMN GV 11 Ramsel
66,Bergstraat 71,2022-05-27,08:00:00,30,18,12,FMN GV 11 Ramsel
66,Bergstraat 71,2022-05-27,09:00:00,58,8,50,FMN GV 11 Ramsel
66,Bergstraat 71,2022-05-27,10:00:00,104,64,40,FMN GV 11 Ramsel
66,Bergstraat 71,2022-05-27,11:00:00,146,92,54,FMN GV 11 Ramsel
66,Bergstraat 71,2022-05-27,12:00:00,136,42,94,FMN GV 11 Ramsel
66,Bergstraat 71,2022-05-27,13:00:00,112,34,78,FMN GV 11 Ramsel
66,Bergstraat 71,2022-05-27,14:00:00,190,100,90,FMN GV 11 Ramsel
66,Bergstraat 71,2022-05-27,15:00:00,180,106,74,FMN GV 11 Ramsel
66,Bergstraat 71,2022-05-27,16:00:00,126,62,64,FMN GV 11 Ramsel
66,Bergstraat 71,2022-05-27,17:00:00,90,58,32,FMN GV 11 Ramsel
66,Bergstraat 71,2022-05-27,18:00:00,40,20,20,FMN GV 11 Ramsel
66,Bergstraat 71,2022-05-27,19:00:00,50,22,28,FMN GV 11 Ramsel
66,Bergstraat 71,2022-05-27,20:00:00,48,16,32,FMN GV 11 Ramsel
66,Bergstraat 71,2022-05-27,21:00:00,22,14,8,FMN GV 11 Ramsel
66,Bergstraat 71,2022-05-27,22:00:00,18,14,4,FMN GV 11 Ramsel
66,Bergstraat 71,2022-05-27,23:00:00,8,6,2,FMN GV 11 Ramsel
66,Bergstraat 71,2022-05-28,00:00:00,8,8,0,FMN GV 11 Ramsel
66,Bergstraat 71,2022-05-28,01:00:00,0,0,0,FMN GV 11 Ramsel
66,Bergstraat 71,2022-05-28,02:00:00,2,2,0,FMN GV 11 Ramsel
66,Bergstraat 71,2022-05-28,03:00:00,2,2,0,FMN GV 11 Ramsel
66,Bergstraat 71,2022-05-28,04:00:00,0,0,0,FMN GV 11 Ramsel
66,Bergstraat 71,2022-05-28,05:00:00,8,4,4,FMN GV 11 Ramsel
66,Bergstraat 71,2022-05-28,06:00:00,16,6,10,FMN GV 11 Ramsel
66,Bergstraat 71,2022-05-28,07:00:00,18,8,10,FMN GV 11 Ramsel
66,Bergstraat 71,2022-05-28,08:00:00,30,10,20,FMN GV 11 Ramsel
66,Bergstraat 71,2022-05-28,09:00:00,78,42,36,FMN GV 11 Ramsel
66,Bergstraat 71,2022-05-28,10:00:00,90,50,40,FMN GV 11 Ramsel
66,Bergstraat 71,2022-05-28,11:00:00,82,36,46,FMN GV 11 Ramsel
66,Bergstraat 71,2022-05-28,12:00:00,136,62,74,FMN GV 11 Ramsel
66,Bergstraat 71,2022-05-28,13:00:00,150,46,104,FMN GV 11 Ramsel
66,Bergstraat 71,2022-05-28,14:00:00,216,88,128,FMN GV 11 Ramsel
66,Bergstraat 71,2022-05-28,15:00:00,202,140,62,FMN GV 11 Ramsel
66,Bergstraat 71,2022-05-28,16:00:00,130,50,80,FMN GV 11 Ramsel
66,Bergstraat 71,2022-05-28,17:00:00,86,52,34,FMN GV 11 Ramsel
66,Bergstraat 71,2022-05-28,18:00:00,58,40,18,FMN GV 11 Ramsel
66,Bergstraat 71,2022-05-28,19:00:00,50,28,22,FMN GV 11 Ramsel
66,Bergstraat 71,2022-05-28,20:00:00,30,4,26,FMN GV 11 Ramsel
66,Bergstraat 71,2022-05-28,21:00:00,18,4,14,FMN GV 11 Ramsel
66,Bergstraat 71,2022-05-28,22:00:00,16,14,2,FMN GV 11 Ramsel
66,Bergstraat 71,2022-05-28,23:00:00,2,0,2,FMN GV 11 Ramsel
66,Bergstraat 71,2022-05-29,00:00:00,12,2,10,FMN GV 11 Ramsel
66,Bergstraat 71,2022-05-29,01:00:00,8,8,0,FMN GV 11 Ramsel
66,Bergstraat 71,2022-05-29,02:00:00,0,0,0,FMN GV 11 Ramsel
66,Bergstraat 71,2022-05-29,03:00:00,6,0,6,FMN GV 11 Ramsel
66,Bergstraat 71,2022-05-29,04:00:00,16,4,12,FMN GV 11 Ramsel
66,Bergstraat 71,2022-05-29,05:00:00,0,0,0,FMN GV 11 Ramsel
66,Bergstraat 71,2022-05-29,06:00:00,8,2,6,FMN GV 11 Ramsel
66,Bergstraat 71,2022-05-29,07:00:00,16,8,8,FMN GV 11 Ramsel
66,Bergstraat 71,2022-05-29,08:00:00,72,20,52,FMN GV 11 Ramsel
66,Bergstraat 71,2022-05-29,09:00:00,98,56,42,FMN GV 11 Ramsel
66,Bergstraat 71,2022-05-29,10:00:00,94,72,22,FMN GV 11 Ramsel
66,Bergstraat 71,2022-05-29,11:00:00,108,72,36,FMN GV 11 Ramsel
66,Bergstraat 71,2022-05-29,12:00:00,78,48,30,FMN GV 11 Ramsel
66,Bergstraat 71,2022-05-29,13:00:00,74,32,42,FMN GV 11 Ramsel
66,Bergstraat 71,2022-05-29,14:00:00,86,30,56,FMN GV 11 Ramsel
66,Bergstraat 71,2022-05-29,15:00:00,58,30,28,FMN GV 11 Ramsel
66,Bergstraat 71,2022-05-29,16:00:00,34,14,20,FMN GV 11 Ramsel
66,Bergstraat 71,2022-05-29,17:00:00,32,8,24,FMN GV 11 Ramsel
66,Bergstraat 71,2022-05-29,18:00:00,28,16,12,FMN GV 11 Ramsel
66,Bergstraat 71,2022-05-29,19:00:00,14,8,6,FMN GV 11 Ramsel
66,Bergstraat 71,2022-05-29,20:00:00,10,4,6,FMN GV 11 Ramsel
66,Bergstraat 71,2022-05-29,21:00:00,12,4,8,FMN GV 11 Ramsel
66,Bergstraat 71,2022-05-29,22:00:00,0,0,0,FMN GV 11 Ramsel
66,Bergstraat 71,2022-05-29,23:00:00,2,2,0,FMN GV 11 Ramsel
66,Bergstraat 71,2022-05-30,00:00:00,0,0,0,FMN GV 11 Ramsel
66,Bergstraat 71,2022-05-30,01:00:00,0,0,0,FMN GV 11 Ramsel
66,Bergstraat 71,2022-05-30,02:00:00,0,0,0,FMN GV 11 Ramsel
66,Bergstraat 71,2022-05-30,03:00:00,2,0,2,FMN GV 11 Ramsel
66,Bergstraat 71,2022-05-30,04:00:00,2,2,0,FMN GV 11 Ramsel
66,Bergstraat 71,2022-05-30,05:00:00,18,6,12,FMN GV 11 Ramsel
66,Bergstraat 71,2022-05-30,06:00:00,50,16,34,FMN GV 11 Ramsel
66,Bergstraat 71,2022-05-30,07:00:00,254,26,228,FMN GV 11 Ramsel
66,Bergstraat 71,2022-05-30,08:00:00,260,58,202,FMN GV 11 Ramsel
66,Bergstraat 71,2022-05-30,09:00:00,62,32,30,FMN GV 11 Ramsel
66,Bergstraat 71,2022-05-30,10:00:00,68,26,42,FMN GV 11 Ramsel
66,Bergstraat 71,2022-05-30,11:00:00,62,38,24,FMN GV 11 Ramsel
66,Bergstraat 71,2022-05-30,12:00:00,96,60,36,FMN GV 11 Ramsel
66,Bergstraat 71,2022-05-30,13:00:00,134,46,88,FMN GV 11 Ramsel
66,Bergstraat 71,2022-05-30,14:00:00,110,52,58,FMN GV 11 Ramsel
66,Bergstraat 71,2022-05-30,15:00:00,334,266,68,FMN GV 11 Ramsel
66,Bergstraat 71,2022-05-30,16:00:00,236,184,52,FMN GV 11 Ramsel
66,Bergstraat 71,2022-05-30,17:00:00,124,90,34,FMN GV 11 Ramsel
66,Bergstraat 71,2022-05-30,18:00:00,70,38,32,FMN GV 11 Ramsel
66,Bergstraat 71,2022-05-30,19:00:00,84,46,38,FMN GV 11 Ramsel
66,Bergstraat 71,2022-05-30,20:00:00,48,32,16,FMN GV 11 Ramsel
66,Bergstraat 71,2022-05-30,21:00:00,20,14,6,FMN GV 11 Ramsel
66,Bergstraat 71,2022-05-30,22:00:00,16,8,8,FMN GV 11 Ramsel
66,Bergstraat 71,2022-05-30,23:00:00,8,4,4,FMN GV 11 Ramsel
66,Bergstraat 71,2022-05-31,00:00:00,4,2,2,FMN GV 11 Ramsel
66,Bergstraat 71,2022-05-31,01:00:00,0,0,0,FMN GV 11 Ramsel
66,Bergstraat 71,2022-05-31,02:00:00,0,0,0,FMN GV 11 Ramsel
66,Bergstraat 71,2022-05-31,03:00:00,0,0,0,FMN GV 11 Ramsel
66,Bergstraat 71,2022-05-31,04:00:00,8,4,4,FMN GV 11 Ramsel
66,Bergstraat 71,2022-05-31,05:00:00,12,8,4,FMN GV 11 Ramsel
66,Bergstraat 71,2022-05-31,06:00:00,56,24,32,FMN GV 11 Ramsel
66,Bergstraat 71,2022-05-31,07:00:00,262,32,230,FMN GV 11 Ramsel
66,Bergstraat 71,2022-05-31,08:00:00,276,46,230,FMN GV 11 Ramsel
66,Bergstraat 71,2022-05-31,09:00:00,74,22,52,FMN GV 11 Ramsel
66,Bergstraat 71,2022-05-31,10:00:00,82,42,40,FMN GV 11 Ramsel
66,Bergstraat 71,2022-05-31,11:00:00,104,42,62,FMN GV 11 Ramsel
66,Bergstraat 71,2022-05-31,12:00:00,124,68,56,FMN GV 11 Ramsel
66,Bergstraat 71,2022-05-31,13:00:00,216,118,98,FMN GV 11 Ramsel
66,Bergstraat 71,2022-05-31,14:00:00,168,108,60,FMN GV 11 Ramsel
66,Bergstraat 71,2022-05-31,15:00:00,332,240,92,FMN GV 11 Ramsel
66,Bergstraat 71,2022-05-31,16:00:00,296,188,108,FMN GV 11 Ramsel
66,Bergstraat 71,2022-05-31,17:00:00,146,80,66,FMN GV 11 Ramsel
66,Bergstraat 71,2022-05-31,18:00:00,96,64,32,FMN GV 11 Ramsel
66,Bergstraat 71,2022-05-31,19:00:00,52,16,36,FMN GV 11 Ramsel
66,Bergstraat 71,2022-05-31,20:00:00,28,18,10,FMN GV 11 Ramsel
66,Bergstraat 71,2022-05-31,21:00:00,20,10,10,FMN GV 11 Ramsel
66,Bergstraat 71,2022-05-31,22:00:00,20,6,14,FMN GV 11 Ramsel
66,Bergstraat 71,2022-05-31,23:00:00,2,2,0,FMN GV 11 Ramsel
66,Bergstraat 71,2022-06-01,00:00:00,4,0,4,FMN GV 11 Ramsel
66,Bergstraat 71,2022-06-01,01:00:00,0,0,0,FMN GV 11 Ramsel
66,Bergstraat 71,2022-06-01,02:00:00,4,4,0,FMN GV 11 Ramsel
66,Bergstraat 71,2022-06-01,03:00:00,0,0,0,FMN GV 11 Ramsel
66,Bergstraat 71,2022-06-01,04:00:00,4,2,2,FMN GV 11 Ramsel
66,Bergstraat 71,2022-06-01,05:00:00,20,10,10,FMN GV 11 Ramsel
66,Bergstraat 71,2022-06-01,06:00:00,60,26,34,FMN GV 11 Ramsel
66,Bergstraat 71,2022-06-01,07:00:00,268,30,238,FMN GV 11 Ramsel
66,Bergstraat 71,2022-06-01,08:00:00,250,46,204,FMN GV 11 Ramsel
66,Bergstraat 71,2022-06-01,09:00:00,76,40,36,FMN GV 11 Ramsel
66,Bergstraat 71,2022-06-01,10:00:00,94,46,48,FMN GV 11 Ramsel
66,Bergstraat 71,2022-06-01,11:00:00,126,56,70,FMN GV 11 Ramsel
66,Bergstraat 71,2022-06-01,12:00:00,338,292,46,FMN GV 11 Ramsel
66,Bergstraat 71,2022-06-01,13:00:00,200,112,88,FMN GV 11 Ramsel
66,Bergstraat 71,2022-06-01,14:00:00,134,68,66,FMN GV 11 Ramsel
66,Bergstraat 71,2022-06-01,15:00:00,152,78,74,FMN GV 11 Ramsel
66,Bergstraat 71,2022-06-01,16:00:00,166,98,68,FMN GV 11 Ramsel
66,Bergstraat 71,2022-06-01,17:00:00,136,68,68,FMN GV 11 Ramsel
66,Bergstraat 71,2022-06-01,18:00:00,114,62,52,FMN GV 11 Ramsel
66,Bergstraat 71,2022-06-01,19:00:00,40,18,22,FMN GV 11 Ramsel
66,Bergstraat 71,2022-06-01,20:00:00,64,34,30,FMN GV 11 Ramsel
66,Bergstraat 71,2022-06-01,21:00:00,32,24,8,FMN GV 11 Ramsel
66,Bergstraat 71,2022-06-01,22:00:00,16,12,4,FMN GV 11 Ramsel
66,Bergstraat 71,2022-06-01,23:00:00,0,0,0,FMN GV 11 Ramsel
66,Bergstraat 71,2022-06-02,00:00:00,2,2,0,FMN GV 11 Ramsel
66,Bergstraat 71,2022-06-02,01:00:00,2,2,0,FMN GV 11 Ramsel
66,Bergstraat 71,2022-06-02,02:00:00,2,2,0,FMN GV 11 Ramsel
66,Bergstraat 71,2022-06-02,03:00:00,0,0,0,FMN GV 11 Ramsel
66,Bergstraat 71,2022-06-02,04:00:00,6,2,4,FMN GV 11 Ramsel
66,Bergstraat 71,2022-06-02,05:00:00,24,14,10,FMN GV 11 Ramsel
66,Bergstraat 71,2022-06-02,06:00:00,58,18,40,FMN GV 11 Ramsel
66,Bergstraat 71,2022-06-02,07:00:00,272,48,224,FMN GV 11 Ramsel
66,Bergstraat 71,2022-06-02,08:00:00,304,62,242,FMN GV 11 Ramsel
66,Bergstraat 71,2022-06-02,09:00:00,120,52,68,FMN GV 11 Ramsel
66,Bergstraat 71,2022-06-02,10:00:00,128,28,100,FMN GV 11 Ramsel
66,Bergstraat 71,2022-06-02,11:00:00,100,50,50,FMN GV 11 Ramsel
66,Bergstraat 71,2022-06-02,12:00:00,140,76,64,FMN GV 11 Ramsel
66,Bergstraat 71,2022-06-02,13:00:00,216,100,116,FMN GV 11 Ramsel
66,Bergstraat 71,2022-06-02,14:00:00,256,120,136,FMN GV 11 Ramsel
66,Bergstraat 71,2022-06-02,15:00:00,456,292,164,FMN GV 11 Ramsel
66,Bergstraat 71,2022-06-02,16:00:00,304,246,58,FMN GV 11 Ramsel
66,Bergstraat 71,2022-06-02,17:00:00,168,106,62,FMN GV 11 Ramsel
66,Bergstraat 71,2022-06-02,18:00:00,132,76,56,FMN GV 11 Ramsel
66,Bergstraat 71,2022-06-02,19:00:00,104,46,58,FMN GV 11 Ramsel
66,Bergstraat 71,2022-06-02,20:00:00,98,54,44,FMN GV 11 Ramsel
66,Bergstraat 71,2022-06-02,21:00:00,30,20,10,FMN GV 11 Ramsel
66,Bergstraat 71,2022-06-02,22:00:00,20,14,6,FMN GV 11 Ramsel
66,Bergstraat 71,2022-06-02,23:00:00,8,4,4,FMN GV 11 Ramsel
66,Bergstraat 71,2022-06-03,00:00:00,0,0,0,FMN GV 11 Ramsel
66,Bergstraat 71,2022-06-03,01:00:00,0,0,0,FMN GV 11 Ramsel
66,Bergstraat 71,2022-06-03,02:00:00,0,0,0,FMN GV 11 Ramsel
66,Bergstraat 71,2022-06-03,03:00:00,0,0,0,FMN GV 11 Ramsel
66,Bergstraat 71,2022-06-03,04:00:00,4,4,0,FMN GV 11 Ramsel
66,Bergstraat 71,2022-06-03,05:00:00,20,12,8,FMN GV 11 Ramsel
66,Bergstraat 71,2022-06-03,06:00:00,32,10,22,FMN GV 11 Ramsel
66,Bergstraat 71,2022-06-03,07:00:00,290,32,258,FMN GV 11 Ramsel
66,Bergstraat 71,2022-06-03,08:00:00,240,40,200,FMN GV 11 Ramsel
66,Bergstraat 71,2022-06-03,09:00:00,100,32,68,FMN GV 11 Ramsel
66,Bergstraat 71,2022-06-03,10:00:00,110,42,68,FMN GV 11 Ramsel
66,Bergstraat 71,2022-06-03,11:00:00,150,80,70,FMN GV 11 Ramsel
66,Bergstraat 71,2022-06-03,12:00:00,180,86,94,FMN GV 11 Ramsel
66,Bergstraat 71,2022-06-03,13:00:00,208,142,66,FMN GV 11 Ramsel
66,Bergstraat 71,2022-06-03,14:00:00,298,138,160,FMN GV 11 Ramsel
66,Bergstraat 71,2022-06-03,15:00:00,410,302,108,FMN GV 11 Ramsel
66,Bergstraat 71,2022-06-03,16:00:00,314,234,80,FMN GV 11 Ramsel
66,Bergstraat 71,2022-06-03,17:00:00,200,118,82,FMN GV 11 Ramsel
66,Bergstraat 71,2022-06-03,18:00:00,152,70,82,FMN GV 11 Ramsel
66,Bergstraat 71,2022-06-03,19:00:00,76,40,36,FMN GV 11 Ramsel
66,Bergstraat 71,2022-06-03,20:00:00,54,18,36,FMN GV 11 Ramsel
66,Bergstraat 71,2022-06-03,21:00:00,46,14,32,FMN GV 11 Ramsel
66,Bergstraat 71,2022-06-03,22:00:00,18,10,8,FMN GV 11 Ramsel
66,Bergstraat 71,2022-06-03,23:00:00,32,12,20,FMN GV 11 Ramsel
66,Bergstraat 71,2022-06-04,00:00:00,6,4,2,FMN GV 11 Ramsel
66,Bergstraat 71,2022-06-04,01:00:00,2,2,0,FMN GV 11 Ramsel
66,Bergstraat 71,2022-06-04,02:00:00,2,2,0,FMN GV 11 Ramsel
66,Bergstraat 71,2022-06-04,03:00:00,2,2,0,FMN GV 11 Ramsel
66,Bergstraat 71,2022-06-04,04:00:00,4,4,0,FMN GV 11 Ramsel
66,Bergstraat 71,2022-06-04,05:00:00,4,2,2,FMN GV 11 Ramsel
66,Bergstraat 71,2022-06-04,06:00:00,16,4,12,FMN GV 11 Ramsel
66,Bergstraat 71,2022-06-04,07:00:00,30,12,18,FMN GV 11 Ramsel
66,Bergstraat 71,2022-06-04,08:00:00,52,30,22,FMN GV 11 Ramsel
66,Bergstraat 71,2022-06-04,09:00:00,90,30,60,FMN GV 11 Ramsel
66,Bergstraat 71,2022-06-04,10:00:00,184,112,72,FMN GV 11 Ramsel
66,Bergstraat 71,2022-06-04,11:00:00,142,68,74,FMN GV 11 Ramsel
66,Bergstraat 71,2022-06-04,12:00:00,200,82,118,FMN GV 11 Ramsel
66,Bergstraat 71,2022-06-04,13:00:00,212,90,122,FMN GV 11 Ramsel
66,Bergstraat 71,2022-06-04,14:00:00,286,170,116,FMN GV 11 Ramsel
66,Bergstraat 71,2022-06-04,15:00:00,304,182,122,FMN GV 11 Ramsel
66,Bergstraat 71,2022-06-04,16:00:00,250,112,138,FMN GV 11 Ramsel
66,Bergstraat 71,2022-06-04,17:00:00,150,74,76,FMN GV 11 Ramsel
66,Bergstraat 71,2022-06-04,18:00:00,90,34,56,FMN GV 11 Ramsel
66,Bergstraat 71,2022-06-04,19:00:00,66,16,50,FMN GV 11 Ramsel
66,Bergstraat 71,2022-06-04,20:00:00,76,26,50,FMN GV 11 Ramsel
66,Bergstraat 71,2022-06-04,21:00:00,46,16,30,FMN GV 11 Ramsel
66,Bergstraat 71,2022-06-04,22:00:00,20,16,4,FMN GV 11 Ramsel
66,Bergstraat 71,2022-06-04,23:00:00,8,8,0,FMN GV 11 Ramsel
66,Bergstraat 71,2022-06-05,00:00:00,8,6,2,FMN GV 11 Ramsel
66,Bergstraat 71,2022-06-05,01:00:00,14,4,10,FMN GV 11 Ramsel
66,Bergstraat 71,2022-06-05,02:00:00,4,4,0,FMN GV 11 Ramsel
66,Bergstraat 71,2022-06-05,03:00:00,6,4,2,FMN GV 11 Ramsel
66,Bergstraat 71,2022-06-05,04:00:00,0,0,0,FMN GV 11 Ramsel
66,Bergstraat 71,2022-06-05,05:00:00,2,0,2,FMN GV 11 Ramsel
66,Bergstraat 71,2022-06-05,06:00:00,0,0,0,FMN GV 11 Ramsel
66,Bergstraat 71,2022-06-05,07:00:00,16,8,8,FMN GV 11 Ramsel
66,Bergstraat 71,2022-06-05,08:00:00,58,34,24,FMN GV 11 Ramsel
66,Bergstraat 71,2022-06-05,09:00:00,84,28,56,FMN GV 11 Ramsel
66,Bergstraat 71,2022-06-05,10:00:00,80,40,40,FMN GV 11 Ramsel
66,Bergstraat 71,2022-06-05,11:00:00,54,40,14,FMN GV 11 Ramsel
66,Bergstraat 71,2022-06-05,12:00:00,24,18,6,FMN GV 11 Ramsel
66,Bergstraat 71,2022-06-05,13:00:00,10,4,6,FMN GV 11 Ramsel
66,Bergstraat 71,2022-06-05,14:00:00,14,8,6,FMN GV 11 Ramsel
66,Bergstraat 71,2022-06-05,15:00:00,2,2,0,FMN GV 11 Ramsel
66,Bergstraat 71,2022-06-05,16:00:00,6,2,4,FMN GV 11 Ramsel
66,Bergstraat 71,2022-06-05,17:00:00,16,6,10,FMN GV 11 Ramsel
66,Bergstraat 71,2022-06-05,18:00:00,10,2,8,FMN GV 11 Ramsel
66,Bergstraat 71,2022-06-05,19:00:00,16,6,10,FMN GV 11 Ramsel
66,Bergstraat 71,2022-06-05,20:00:00,28,18,10,FMN GV 11 Ramsel
66,Bergstraat 71,2022-06-05,21:00:00,10,6,4,FMN GV 11 Ramsel
66,Bergstraat 71,2022-06-05,22:00:00,6,4,2,FMN GV 11 Ramsel
66,Bergstraat 71,2022-06-05,23:00:00,2,2,0,FMN GV 11 Ramsel
66,Bergstraat 71,2022-06-06,00:00:00,4,2,2,FMN GV 11 Ramsel
66,Bergstraat 71,2022-06-06,01:00:00,0,0,0,FMN GV 11 Ramsel
66,Bergstraat 71,2022-06-06,02:00:00,4,4,0,FMN GV 11 Ramsel
66,Bergstraat 71,2022-06-06,03:00:00,0,0,0,FMN GV 11 Ramsel
66,Bergstraat 71,2022-06-06,04:00:00,0,0,0,FMN GV 11 Ramsel
66,Bergstraat 71,2022-06-06,05:00:00,4,4,0,FMN GV 11 Ramsel
66,Bergstraat 71,2022-06-06,06:00:00,6,2,4,FMN GV 11 Ramsel
66,Bergstraat 71,2022-06-06,07:00:00,10,6,4,FMN GV 11 Ramsel
66,Bergstraat 71,2022-06-06,08:00:00,38,10,28,FMN GV 11 Ramsel
66,Bergstraat 71,2022-06-06,09:00:00,92,36,56,FMN GV 11 Ramsel
66,Bergstraat 71,2022-06-06,10:00:00,110,46,64,FMN GV 11 Ramsel
66,Bergstraat 71,2022-06-06,11:00:00,150,80,70,FMN GV 11 Ramsel
66,Bergstraat 71,2022-06-06,12:00:00,100,50,50,FMN GV 11 Ramsel
66,Bergstraat 71,2022-06-06,13:00:00,124,52,72,FMN GV 11 Ramsel
66,Bergstraat 71,2022-06-06,14:00:00,180,100,80,FMN GV 11 Ramsel
66,Bergstraat 71,2022-06-06,15:00:00,116,58,58,FMN GV 11 Ramsel
66,Bergstraat 71,2022-06-06,16:00:00,156,96,60,FMN GV 11 Ramsel
66,Bergstraat 71,2022-06-06,17:00:00,50,26,24,FMN GV 11 Ramsel
66,Bergstraat 71,2022-06-06,18:00:00,42,26,16,FMN GV 11 Ramsel
66,Bergstraat 71,2022-06-06,19:00:00,24,16,8,FMN GV 11 Ramsel
66,Bergstraat 71,2022-06-06,20:00:00,26,14,12,FMN GV 11 Ramsel
66,Bergstraat 71,2022-06-06,21:00:00,22,12,10,FMN GV 11 Ramsel
66,Bergstraat 71,2022-06-06,22:00:00,8,6,2,FMN GV 11 Ramsel
66,Bergstraat 71,2022-06-06,23:00:00,2,0,2,FMN GV 11 Ramsel
66,Bergstraat 71,2022-06-07,00:00:00,10,6,4,FMN GV 11 Ramsel
66,Bergstraat 71,2022-06-07,01:00:00,4,4,0,FMN GV 11 Ramsel
66,Bergstraat 71,2022-06-07,02:00:00,2,2,0,FMN GV 11 Ramsel
66,Bergstraat 71,2022-06-07,03:00:00,2,0,2,FMN GV 11 Ramsel
66,Bergstraat 71,2022-06-07,04:00:00,4,4,0,FMN GV 11 Ramsel
66,Bergstraat 71,2022-06-07,05:00:00,20,14,6,FMN GV 11 Ramsel
66,Bergstraat 71,2022-06-07,06:00:00,60,20,40,FMN GV 11 Ramsel
66,Bergstraat 71,2022-06-07,07:00:00,246,30,216,FMN GV 11 Ramsel
66,Bergstraat 71,2022-06-07,08:00:00,258,30,228,FMN GV 11 Ramsel
66,Bergstraat 71,2022-06-07,09:00:00,66,26,40,FMN GV 11 Ramsel
66,Bergstraat 71,2022-06-07,10:00:00,94,40,54,FMN GV 11 Ramsel
66,Bergstraat 71,2022-06-07,11:00:00,78,46,32,FMN GV 11 Ramsel
66,Bergstraat 71,2022-06-07,12:00:00,94,62,32,FMN GV 11 Ramsel
66,Bergstraat 71,2022-06-07,13:00:00,94,58,36,FMN GV 11 Ramsel
66,Bergstraat 71,2022-06-07,14:00:00,96,66,30,FMN GV 11 Ramsel
66,Bergstraat 71,2022-06-07,15:00:00,244,210,34,FMN GV 11 Ramsel
66,Bergstraat 71,2022-06-07,16:00:00,198,164,34,FMN GV 11 Ramsel
66,Bergstraat 71,2022-06-07,17:00:00,128,76,52,FMN GV 11 Ramsel
66,Bergstraat 71,2022-06-07,18:00:00,90,54,36,FMN GV 11 Ramsel
66,Bergstraat 71,2022-06-07,19:00:00,74,28,46,FMN GV 11 Ramsel
66,Bergstraat 71,2022-06-07,20:00:00,56,42,14,FMN GV 11 Ramsel
66,Bergstraat 71,2022-06-07,21:00:00,38,26,12,FMN GV 11 Ramsel
66,Bergstraat 71,2022-06-07,22:00:00,18,14,4,FMN GV 11 Ramsel
66,Bergstraat 71,2022-06-07,23:00:00,6,6,0,FMN GV 11 Ramsel
66,Bergstraat 71,2022-06-08,00:00:00,2,2,0,FMN GV 11 Ramsel
66,Bergstraat 71,2022-06-08,01:00:00,0,0,0,FMN GV 11 Ramsel
66,Bergstraat 71,2022-06-08,02:00:00,2,0,2,FMN GV 11 Ramsel
66,Bergstraat 71,2022-06-08,03:00:00,0,0,0,FMN GV 11 Ramsel
66,Bergstraat 71,2022-06-08,04:00:00,8,6,2,FMN GV 11 Ramsel
66,Bergstraat 71,2022-06-08,05:00:00,16,12,4,FMN GV 11 Ramsel
66,Bergstraat 71,2022-06-08,06:00:00,40,20,20,FMN GV 11 Ramsel
66,Bergstraat 71,2022-06-08,07:00:00,228,24,204,FMN GV 11 Ramsel
66,Bergstraat 71,2022-06-08,08:00:00,218,42,176,FMN GV 11 Ramsel
66,Bergstraat 71,2022-06-08,09:00:00,22,14,8,FMN GV 11 Ramsel
66,Bergstraat 71,2022-06-08,10:00:00,28,14,14,FMN GV 11 Ramsel
66,Bergstraat 71,2022-06-08,11:00:00,46,34,12,FMN GV 11 Ramsel
66,Bergstraat 71,2022-06-08,12:00:00,216,204,12,FMN GV 11 Ramsel
66,Bergstraat 71,2022-06-08,13:00:00,38,24,14,FMN GV 11 Ramsel
66,Bergstraat 71,2022-06-08,14:00:00,22,10,12,FMN GV 11 Ramsel
66,Bergstraat 71,2022-06-08,15:00:00,40,16,24,FMN GV 11 Ramsel
66,Bergstraat 71,2022-06-08,16:00:00,52,28,24,FMN GV 11 Ramsel
66,Bergstraat 71,2022-06-08,17:00:00,66,38,28,FMN GV 11 Ramsel
66,Bergstraat 71,2022-06-08,18:00:00,74,26,48,FMN GV 11 Ramsel
66,Bergstraat 71,2022-06-08,19:00:00,56,32,24,FMN GV 11 Ramsel
66,Bergstraat 71,2022-06-08,20:00:00,42,28,14,FMN GV 11 Ramsel
66,Bergstraat 71,2022-06-08,21:00:00,38,22,16,FMN GV 11 Ramsel
66,Bergstraat 71,2022-06-08,22:00:00,10,10,0,FMN GV 11 Ramsel
66,Bergstraat 71,2022-06-08,23:00:00,6,2,4,FMN GV 11 Ramsel
66,Bergstraat 71,2022-06-09,00:00:00,0,0,0,FMN GV 11 Ramsel
66,Bergstraat 71,2022-06-09,01:00:00,8,8,0,FMN GV 11 Ramsel
66,Bergstraat 71,2022-06-09,02:00:00,0,0,0,FMN GV 11 Ramsel
66,Bergstraat 71,2022-06-09,03:00:00,0,0,0,FMN GV 11 Ramsel
66,Bergstraat 71,2022-06-09,04:00:00,6,4,2,FMN GV 11 Ramsel
66,Bergstraat 71,2022-06-09,05:00:00,16,8,8,FMN GV 11 Ramsel
66,Bergstraat 71,2022-06-09,06:00:00,54,18,36,FMN GV 11 Ramsel
66,Bergstraat 71,2022-06-09,07:00:00,298,32,266,FMN GV 11 Ramsel
66,Bergstraat 71,2022-06-09,08:00:00,222,38,184,FMN GV 11 Ramsel
66,Bergstraat 71,2022-06-09,09:00:00,82,34,48,FMN GV 11 Ramsel
66,Bergstraat 71,2022-06-09,10:00:00,160,52,108,FMN GV 11 Ramsel
66,Bergstraat 71,2022-06-09,11:00:00,226,196,30,FMN GV 11 Ramsel
66,Bergstraat 71,2022-06-09,12:00:00,116,94,22,FMN GV 11 Ramsel
66,Bergstraat 71,2022-06-09,13:00:00,110,52,58,FMN GV 11 Ramsel
66,Bergstraat 71,2022-06-09,14:00:00,216,48,168,FMN GV 11 Ramsel
66,Bergstraat 71,2022-06-09,15:00:00,290,234,56,FMN GV 11 Ramsel
66,Bergstraat 71,2022-06-09,16:00:00,194,144,50,FMN GV 11 Ramsel
66,Bergstraat 71,2022-06-09,17:00:00,172,118,54,FMN GV 11 Ramsel
66,Bergstraat 71,2022-06-09,18:00:00,142,58,84,FMN GV 11 Ramsel
66,Bergstraat 71,2022-06-09,19:00:00,84,46,38,FMN GV 11 Ramsel
66,Bergstraat 71,2022-06-09,20:00:00,50,24,26,FMN GV 11 Ramsel
66,Bergstraat 71,2022-06-09,21:00:00,36,18,18,FMN GV 11 Ramsel
66,Bergstraat 71,2022-06-09,22:00:00,22,18,4,FMN GV 11 Ramsel
66,Bergstraat 71,2022-06-09,23:00:00,4,2,2,FMN GV 11 Ramsel
66,Bergstraat 71,2022-06-10,00:00:00,4,4,0,FMN GV 11 Ramsel
66,Bergstraat 71,2022-06-10,01:00:00,12,6,6,FMN GV 11 Ramsel
66,Bergstraat 71,2022-06-10,02:00:00,2,2,0,FMN GV 11 Ramsel
66,Bergstraat 71,2022-06-10,03:00:00,0,0,0,FMN GV 11 Ramsel
66,Bergstraat 71,2022-06-10,04:00:00,4,4,0,FMN GV 11 Ramsel
66,Bergstraat 71,2022-06-10,05:00:00,12,8,4,FMN GV 11 Ramsel
66,Bergstraat 71,2022-06-10,06:00:00,34,18,16,FMN GV 11 Ramsel
66,Bergstraat 71,2022-06-10,07:00:00,280,36,244,FMN GV 11 Ramsel
66,Bergstraat 71,2022-06-10,08:00:00,220,32,188,FMN GV 11 Ramsel
66,Bergstraat 71,2022-06-10,09:00:00,62,20,42,FMN GV 11 Ramsel
66,Bergstraat 71,2022-06-10,10:00:00,120,70,50,FMN GV 11 Ramsel
66,Bergstraat 71,2022-06-10,11:00:00,142,82,60,FMN GV 11 Ramsel
66,Bergstraat 71,2022-06-10,12:00:00,112,76,36,FMN GV 11 Ramsel
66,Bergstraat 71,2022-06-10,13:00:00,142,64,78,FMN GV 11 Ramsel
66,Bergstraat 71,2022-06-10,14:00:00,200,102,98,FMN GV 11 Ramsel
66,Bergstraat 71,2022-06-10,15:00:00,372,276,96,FMN GV 11 Ramsel
66,Bergstraat 71,2022-06-10,16:00:00,212,136,76,FMN GV 11 Ramsel
66,Bergstraat 71,2022-06-10,17:00:00,146,100,46,FMN GV 11 Ramsel
66,Bergstraat 71,2022-06-10,18:00:00,84,62,22,FMN GV 11 Ramsel
66,Bergstraat 71,2022-06-10,19:00:00,68,36,32,FMN GV 11 Ramsel
66,Bergstraat 71,2022-06-10,20:00:00,48,24,24,FMN GV 11 Ramsel
66,Bergstraat 71,2022-06-10,21:00:00,36,16,20,FMN GV 11 Ramsel
66,Bergstraat 71,2022-06-10,22:00:00,28,10,18,FMN GV 11 Ramsel
66,Bergstraat 71,2022-06-10,23:00:00,6,2,4,FMN GV 11 Ramsel
66,Bergstraat 71,2022-06-11,00:00:00,16,14,2,FMN GV 11 Ramsel
66,Bergstraat 71,2022-06-11,01:00:00,4,2,2,FMN GV 11 Ramsel
66,Bergstraat 71,2022-06-11,02:00:00,2,2,0,FMN GV 11 Ramsel
66,Bergstraat 71,2022-06-11,03:00:00,2,2,0,FMN GV 11 Ramsel
66,Bergstraat 71,2022-06-11,04:00:00,0,0,0,FMN GV 11 Ramsel
66,Bergstraat 71,2022-06-11,05:00:00,4,2,2,FMN GV 11 Ramsel
66,Bergstraat 71,2022-06-11,06:00:00,12,8,4,FMN GV 11 Ramsel
66,Bergstraat 71,2022-06-11,07:00:00,22,10,12,FMN GV 11 Ramsel
66,Bergstraat 71,2022-06-11,08:00:00,30,4,26,FMN GV 11 Ramsel
66,Bergstraat 71,2022-06-11,09:00:00,94,30,64,FMN GV 11 Ramsel
66,Bergstraat 71,2022-06-11,10:00:00,140,60,80,FMN GV 11 Ramsel
66,Bergstraat 71,2022-06-11,11:00:00,126,62,64,FMN GV 11 Ramsel
66,Bergstraat 71,2022-06-11,12:00:00,186,106,80,FMN GV 11 Ramsel
66,Bergstraat 71,2022-06-11,13:00:00,258,100,158,FMN GV 11 Ramsel
66,Bergstraat 71,2022-06-11,14:00:00,346,178,168,FMN GV 11 Ramsel
66,Bergstraat 71,2022-06-11,15:00:00,266,132,134,FMN GV 11 Ramsel
66,Bergstraat 71,2022-06-11,16:00:00,252,154,98,FMN GV 11 Ramsel
66,Bergstraat 71,2022-06-11,17:00:00,128,80,48,FMN GV 11 Ramsel
66,Bergstraat 71,2022-06-11,18:00:00,128,70,58,FMN GV 11 Ramsel
66,Bergstraat 71,2022-06-11,19:00:00,74,38,36,FMN GV 11 Ramsel
66,Bergstraat 71,2022-06-11,20:00:00,52,18,34,FMN GV 11 Ramsel
66,Bergstraat 71,2022-06-11,21:00:00,42,22,20,FMN GV 11 Ramsel
66,Bergstraat 71,2022-06-11,22:00:00,14,8,6,FMN GV 11 Ramsel
66,Bergstraat 71,2022-06-11,23:00:00,32,28,4,FMN GV 11 Ramsel
66,Bergstraat 71,2022-06-12,00:00:00,4,4,0,FMN GV 11 Ramsel
66,Bergstraat 71,2022-06-12,01:00:00,10,8,2,FMN GV 11 Ramsel
66,Bergstraat 71,2022-06-12,02:00:00,8,8,0,FMN GV 11 Ramsel
66,Bergstraat 71,2022-06-12,03:00:00,8,6,2,FMN GV 11 Ramsel
66,Bergstraat 71,2022-06-12,04:00:00,8,6,2,FMN GV 11 Ramsel
66,Bergstraat 71,2022-06-12,05:00:00,6,6,0,FMN GV 11 Ramsel
66,Bergstraat 71,2022-06-12,06:00:00,18,12,6,FMN GV 11 Ramsel
66,Bergstraat 71,2022-06-12,07:00:00,44,16,28,FMN GV 11 Ramsel
66,Bergstraat 71,2022-06-12,08:00:00,100,24,76,FMN GV 11 Ramsel
66,Bergstraat 71,2022-06-12,09:00:00,166,86,80,FMN GV 11 Ramsel
66,Bergstraat 71,2022-06-12,10:00:00,202,80,122,FMN GV 11 Ramsel
66,Bergstraat 71,2022-06-12,11:00:00,332,196,136,FMN GV 11 Ramsel
66,Bergstraat 71,2022-06-12,12:00:00,232,82,150,FMN GV 11 Ramsel
66,Bergstraat 71,2022-06-12,13:00:00,338,192,146,FMN GV 11 Ramsel
66,Bergstraat 71,2022-06-12,14:00:00,402,202,200,FMN GV 11 Ramsel
66,Bergstraat 71,2022-06-12,15:00:00,340,202,138,FMN GV 11 Ramsel
66,Bergstraat 71,2022-06-12,16:00:00,246,136,110,FMN GV 11 Ramsel
66,Bergstraat 71,2022-06-12,17:00:00,196,100,96,FMN GV 11 Ramsel
66,Bergstraat 71,2022-06-12,18:00:00,132,56,76,FMN GV 11 Ramsel
66,Bergstraat 71,2022-06-12,19:00:00,72,28,44,FMN GV 11 Ramsel
66,Bergstraat 71,2022-06-12,20:00:00,60,34,26,FMN GV 11 Ramsel
66,Bergstraat 71,2022-06-12,21:00:00,32,14,18,FMN GV 11 Ramsel
66,Bergstraat 71,2022-06-12,22:00:00,8,2,6,FMN GV 11 Ramsel
66,Bergstraat 71,2022-06-12,23:00:00,12,10,2,FMN GV 11 Ramsel
66,Bergstraat 71,2022-06-13,00:00:00,2,2,0,FMN GV 11 Ramsel
66,Bergstraat 71,2022-06-13,01:00:00,0,0,0,FMN GV 11 Ramsel
66,Bergstraat 71,2022-06-13,02:00:00,0,0,0,FMN GV 11 Ramsel
66,Bergstraat 71,2022-06-13,03:00:00,0,0,0,FMN GV 11 Ramsel
66,Bergstraat 71,2022-06-13,04:00:00,6,4,2,FMN GV 11 Ramsel
66,Bergstraat 71,2022-06-13,05:00:00,10,2,8,FMN GV 11 Ramsel
66,Bergstraat 71,2022-06-13,06:00:00,52,18,34,FMN GV 11 Ramsel
66,Bergstraat 71,2022-06-13,07:00:00,320,32,288,FMN GV 11 Ramsel
66,Bergstraat 71,2022-06-13,08:00:00,252,40,212,FMN GV 11 Ramsel
66,Bergstraat 71,2022-06-13,09:00:00,78,40,38,FMN GV 11 Ramsel
66,Bergstraat 71,2022-06-13,10:00:00,100,48,52,FMN GV 11 Ramsel
66,Bergstraat 71,2022-06-13,11:00:00,96,56,40,FMN GV 11 Ramsel
66,Bergstraat 71,2022-06-13,12:00:00,172,144,28,FMN GV 11 Ramsel
66,Bergstraat 71,2022-06-13,13:00:00,146,74,72,FMN GV 11 Ramsel
66,Bergstraat 71,2022-06-13,14:00:00,168,100,68,FMN GV 11 Ramsel
66,Bergstraat 71,2022-06-13,15:00:00,224,152,72,FMN GV 11 Ramsel
66,Bergstraat 71,2022-06-13,16:00:00,188,144,44,FMN GV 11 Ramsel
66,Bergstraat 71,2022-06-13,17:00:00,144,90,54,FMN GV 11 Ramsel
66,Bergstraat 71,2022-06-13,18:00:00,130,64,66,FMN GV 11 Ramsel
66,Bergstraat 71,2022-06-13,19:00:00,102,40,62,FMN GV 11 Ramsel
66,Bergstraat 71,2022-06-13,20:00:00,60,38,22,FMN GV 11 Ramsel
66,Bergstraat 71,2022-06-13,21:00:00,22,16,6,FMN GV 11 Ramsel
66,Bergstraat 71,2022-06-13,22:00:00,16,2,14,FMN GV 11 Ramsel
66,Bergstraat 71,2022-06-13,23:00:00,2,2,0,FMN GV 11 Ramsel
66,Bergstraat 71,2022-06-14,00:00:00,4,2,2,FMN GV 11 Ramsel
66,Bergstraat 71,2022-06-14,01:00:00,2,2,0,FMN GV 11 Ramsel
66,Bergstraat 71,2022-06-14,02:00:00,2,0,2,FMN GV 11 Ramsel
66,Bergstraat 71,2022-06-14,03:00:00,0,0,0,FMN GV 11 Ramsel
66,Bergstraat 71,2022-06-14,04:00:00,10,4,6,FMN GV 11 Ramsel
66,Bergstraat 71,2022-06-14,05:00:00,12,4,8,FMN GV 11 Ramsel
66,Bergstraat 71,2022-06-14,06:00:00,68,30,38,FMN GV 11 Ramsel
66,Bergstraat 71,2022-06-14,07:00:00,342,36,306,FMN GV 11 Ramsel
66,Bergstraat 71,2022-06-14,08:00:00,244,40,204,FMN GV 11 Ramsel
66,Bergstraat 71,2022-06-14,09:00:00,64,24,40,FMN GV 11 Ramsel
66,Bergstraat 71,2022-06-14,10:00:00,172,114,58,FMN GV 11 Ramsel
66,Bergstraat 71,2022-06-14,11:00:00,138,80,58,FMN GV 11 Ramsel
66,Bergstraat 71,2022-06-14,12:00:00,272,172,100,FMN GV 11 Ramsel
66,Bergstraat 71,2022-06-14,13:00:00,206,88,118,FMN GV 11 Ramsel
66,Bergstraat 71,2022-06-14,14:00:00,238,134,104,FMN GV 11 Ramsel
66,Bergstraat 71,2022-06-14,15:00:00,274,194,80,FMN GV 11 Ramsel
66,Bergstraat 71,2022-06-14,16:00:00,278,174,104,FMN GV 11 Ramsel
66,Bergstraat 71,2022-06-14,17:00:00,178,102,76,FMN GV 11 Ramsel
66,Bergstraat 71,2022-06-14,18:00:00,180,78,102,FMN GV 11 Ramsel
66,Bergstraat 71,2022-06-14,19:00:00,170,70,100,FMN GV 11 Ramsel
66,Bergstraat 71,2022-06-14,20:00:00,136,80,56,FMN GV 11 Ramsel
66,Bergstraat 71,2022-06-14,21:00:00,62,50,12,FMN GV 11 Ramsel
66,Bergstraat 71,2022-06-14,22:00:00,28,14,14,FMN GV 11 Ramsel
66,Bergstraat 71,2022-06-14,23:00:00,16,8,8,FMN GV 11 Ramsel
66,Bergstraat 71,2022-06-15,00:00:00,4,4,0,FMN GV 11 Ramsel
66,Bergstraat 71,2022-06-15,01:00:00,2,2,0,FMN GV 11 Ramsel
66,Bergstraat 71,2022-06-15,02:00:00,0,0,0,FMN GV 11 Ramsel
66,Bergstraat 71,2022-06-15,03:00:00,0,0,0,FMN GV 11 Ramsel
66,Bergstraat 71,2022-06-15,04:00:00,2,2,0,FMN GV 11 Ramsel
66,Bergstraat 71,2022-06-15,05:00:00,16,6,10,FMN GV 11 Ramsel
66,Bergstraat 71,2022-06-15,06:00:00,54,22,32,FMN GV 11 Ramsel
66,Bergstraat 71,2022-06-15,07:00:00,358,42,316,FMN GV 11 Ramsel
66,Bergstraat 71,2022-06-15,08:00:00,244,52,192,FMN GV 11 Ramsel
66,Bergstraat 71,2022-06-15,09:00:00,138,88,50,FMN GV 11 Ramsel
66,Bergstraat 71,2022-06-15,10:00:00,210,160,50,FMN GV 11 Ramsel
66,Bergstraat 71,2022-06-15,11:00:00,190,120,70,FMN GV 11 Ramsel
66,Bergstraat 71,2022-06-15,12:00:00,298,214,84,FMN GV 11 Ramsel
66,Bergstraat 71,2022-06-15,13:00:00,214,134,80,FMN GV 11 Ramsel
66,Bergstraat 71,2022-06-15,14:00:00,230,112,118,FMN GV 11 Ramsel
66,Bergstraat 71,2022-06-15,15:00:00,220,100,120,FMN GV 11 Ramsel
66,Bergstraat 71,2022-06-15,16:00:00,236,132,104,FMN GV 11 Ramsel
66,Bergstraat 71,2022-06-15,17:00:00,222,132,90,FMN GV 11 Ramsel
66,Bergstraat 71,2022-06-15,18:00:00,170,72,98,FMN GV 11 Ramsel
66,Bergstraat 71,2022-06-15,19:00:00,142,82,60,FMN GV 11 Ramsel
66,Bergstraat 71,2022-06-15,20:00:00,112,72,40,FMN GV 11 Ramsel
66,Bergstraat 71,2022-06-15,21:00:00,62,38,24,FMN GV 11 Ramsel
66,Bergstraat 71,2022-06-15,22:00:00,34,12,22,FMN GV 11 Ramsel
66,Bergstraat 71,2022-06-15,23:00:00,10,8,2,FMN GV 11 Ramsel
66,Bergstraat 71,2022-06-16,00:00:00,6,2,4,FMN GV 11 Ramsel
66,Bergstraat 71,2022-06-16,01:00:00,6,6,0,FMN GV 11 Ramsel
66,Bergstraat 71,2022-06-16,02:00:00,2,0,2,FMN GV 11 Ramsel
66,Bergstraat 71,2022-06-16,03:00:00,2,2,0,FMN GV 11 Ramsel
66,Bergstraat 71,2022-06-16,04:00:00,4,2,2,FMN GV 11 Ramsel
66,Bergstraat 71,2022-06-16,05:00:00,18,6,12,FMN GV 11 Ramsel
66,Bergstraat 71,2022-06-16,06:00:00,66,22,44,FMN GV 11 Ramsel
66,Bergstraat 71,2022-06-16,07:00:00,352,56,296,FMN GV 11 Ramsel
66,Bergstraat 71,2022-06-16,08:00:00,234,46,188,FMN GV 11 Ramsel
66,Bergstraat 71,2022-06-16,09:00:00,246,148,98,FMN GV 11 Ramsel
66,Bergstraat 71,2022-06-16,10:00:00,228,150,78,FMN GV 11 Ramsel
66,Bergstraat 71,2022-06-16,11:00:00,200,152,48,FMN GV 11 Ramsel
66,Bergstraat 71,2022-06-16,12:00:00,198,142,56,FMN GV 11 Ramsel
66,Bergstraat 71,2022-06-16,13:00:00,184,104,80,FMN GV 11 Ramsel
66,Bergstraat 71,2022-06-16,14:00:00,326,162,164,FMN GV 11 Ramsel
66,Bergstraat 71,2022-06-16,15:00:00,242,154,88,FMN GV 11 Ramsel
66,Bergstraat 71,2022-06-16,16:00:00,218,158,60,FMN GV 11 Ramsel
66,Bergstraat 71,2022-06-16,17:00:00,192,106,86,FMN GV 11 Ramsel
66,Bergstraat 71,2022-06-16,18:00:00,154,90,64,FMN GV 11 Ramsel
66,Bergstraat 71,2022-06-16,19:00:00,130,56,74,FMN GV 11 Ramsel
66,Bergstraat 71,2022-06-16,20:00:00,74,46,28,FMN GV 11 Ramsel
66,Bergstraat 71,2022-06-16,21:00:00,40,24,16,FMN GV 11 Ramsel
66,Bergstraat 71,2022-06-16,22:00:00,28,16,12,FMN GV 11 Ramsel
66,Bergstraat 71,2022-06-16,23:00:00,2,0,2,FMN GV 11 Ramsel
66,Bergstraat 71,2022-06-17,00:00:00,2,0,2,FMN GV 11 Ramsel
66,Bergstraat 71,2022-06-17,01:00:00,0,0,0,FMN GV 11 Ramsel
66,Bergstraat 71,2022-06-17,02:00:00,0,0,0,FMN GV 11 Ramsel
66,Bergstraat 71,2022-06-17,03:00:00,0,0,0,FMN GV 11 Ramsel
66,Bergstraat 71,2022-06-17,04:00:00,4,4,0,FMN GV 11 Ramsel
66,Bergstraat 71,2022-06-17,05:00:00,18,8,10,FMN GV 11 Ramsel
66,Bergstraat 71,2022-06-17,06:00:00,38,18,20,FMN GV 11 Ramsel
66,Bergstraat 71,2022-06-17,07:00:00,304,46,258,FMN GV 11 Ramsel
66,Bergstraat 71,2022-06-17,08:00:00,258,50,208,FMN GV 11 Ramsel
66,Bergstraat 71,2022-06-17,09:00:00,138,60,78,FMN GV 11 Ramsel
66,Bergstraat 71,2022-06-17,10:00:00,318,210,108,FMN GV 11 Ramsel
66,Bergstraat 71,2022-06-17,11:00:00,170,108,62,FMN GV 11 Ramsel
66,Bergstraat 71,2022-06-17,12:00:00,170,124,46,FMN GV 11 Ramsel
66,Bergstraat 71,2022-06-17,13:00:00,148,86,62,FMN GV 11 Ramsel
66,Bergstraat 71,2022-06-17,14:00:00,208,100,108,FMN GV 11 Ramsel
66,Bergstraat 71,2022-06-17,15:00:00,280,160,120,FMN GV 11 Ramsel
66,Bergstraat 71,2022-06-17,16:00:00,194,118,76,FMN GV 11 Ramsel
66,Bergstraat 71,2022-06-17,17:00:00,214,86,128,FMN GV 11 Ramsel
66,Bergstraat 71,2022-06-17,18:00:00,114,56,58,FMN GV 11 Ramsel
66,Bergstraat 71,2022-06-17,19:00:00,110,62,48,FMN GV 11 Ramsel
66,Bergstraat 71,2022-06-17,20:00:00,78,36,42,FMN GV 11 Ramsel
66,Bergstraat 71,2022-06-17,21:00:00,58,36,22,FMN GV 11 Ramsel
66,Bergstraat 71,2022-06-17,22:00:00,36,14,22,FMN GV 11 Ramsel
66,Bergstraat 71,2022-06-17,23:00:00,8,8,0,FMN GV 11 Ramsel
66,Bergstraat 71,2022-06-18,00:00:00,12,6,6,FMN GV 11 Ramsel
66,Bergstraat 71,2022-06-18,01:00:00,8,8,0,FMN GV 11 Ramsel
66,Bergstraat 71,2022-06-18,02:00:00,4,4,0,FMN GV 11 Ramsel
66,Bergstraat 71,2022-06-18,03:00:00,4,0,4,FMN GV 11 Ramsel
66,Bergstraat 71,2022-06-18,04:00:00,2,2,0,FMN GV 11 Ramsel
66,Bergstraat 71,2022-06-18,05:00:00,12,6,6,FMN GV 11 Ramsel
66,Bergstraat 71,2022-06-18,06:00:00,14,4,10,FMN GV 11 Ramsel
66,Bergstraat 71,2022-06-18,07:00:00,40,12,28,FMN GV 11 Ramsel
66,Bergstraat 71,2022-06-18,08:00:00,80,36,44,FMN GV 11 Ramsel
66,Bergstraat 71,2022-06-18,09:00:00,186,100,86,FMN GV 11 Ramsel
66,Bergstraat 71,2022-06-18,10:00:00,188,74,114,FMN GV 11 Ramsel
66,Bergstraat 71,2022-06-18,11:00:00,188,98,90,FMN GV 11 Ramsel
66,Bergstraat 71,2022-06-18,12:00:00,132,76,56,FMN GV 11 Ramsel
66,Bergstraat 71,2022-06-18,13:00:00,146,54,92,FMN GV 11 Ramsel
66,Bergstraat 71,2022-06-18,14:00:00,160,80,80,FMN GV 11 Ramsel
66,Bergstraat 71,2022-06-18,15:00:00,164,96,68,FMN GV 11 Ramsel
66,Bergstraat 71,2022-06-18,16:00:00,150,78,72,FMN GV 11 Ramsel
66,Bergstraat 71,2022-06-18,17:00:00,112,62,50,FMN GV 11 Ramsel
66,Bergstraat 71,2022-06-18,18:00:00,82,44,38,FMN GV 11 Ramsel
66,Bergstraat 71,2022-06-18,19:00:00,88,40,48,FMN GV 11 Ramsel
66,Bergstraat 71,2022-06-18,20:00:00,96,40,56,FMN GV 11 Ramsel
66,Bergstraat 71,2022-06-18,21:00:00,64,34,30,FMN GV 11 Ramsel
66,Bergstraat 71,2022-06-18,22:00:00,54,28,26,FMN GV 11 Ramsel
66,Bergstraat 71,2022-06-18,23:00:00,32,26,6,FMN GV 11 Ramsel
66,Bergstraat 71,2022-06-19,00:00:00,16,8,8,FMN GV 11 Ramsel
66,Bergstraat 71,2022-06-19,01:00:00,2,2,0,FMN GV 11 Ramsel
66,Bergstraat 71,2022-06-19,02:00:00,6,4,2,FMN GV 11 Ramsel
66,Bergstraat 71,2022-06-19,03:00:00,2,0,2,FMN GV 11 Ramsel
66,Bergstraat 71,2022-06-19,04:00:00,0,0,0,FMN GV 11 Ramsel
66,Bergstraat 71,2022-06-19,05:00:00,6,6,0,FMN GV 11 Ramsel
66,Bergstraat 71,2022-06-19,06:00:00,8,4,4,FMN GV 11 Ramsel
66,Bergstraat 71,2022-06-19,07:00:00,36,12,24,FMN GV 11 Ramsel
66,Bergstraat 71,2022-06-19,08:00:00,68,24,44,FMN GV 11 Ramsel
66,Bergstraat 71,2022-06-19,09:00:00,38,32,6,FMN GV 11 Ramsel
66,Bergstraat 71,2022-06-19,10:00:00,64,28,36,FMN GV 11 Ramsel
66,Bergstraat 71,2022-06-19,11:00:00,94,64,30,FMN GV 11 Ramsel
66,Bergstraat 71,2022-06-19,12:00:00,78,28,50,FMN GV 11 Ramsel
66,Bergstraat 71,2022-06-19,13:00:00,66,38,28,FMN GV 11 Ramsel
66,Bergstraat 71,2022-06-19,14:00:00,108,46,62,FMN GV 11 Ramsel
66,Bergstraat 71,2022-06-19,15:00:00,140,62,78,FMN GV 11 Ramsel
66,Bergstraat 71,2022-06-19,16:00:00,150,102,48,FMN GV 11 Ramsel
66,Bergstraat 71,2022-06-19,17:00:00,96,46,50,FMN GV 11 Ramsel
66,Bergstraat 71,2022-06-19,18:00:00,70,34,36,FMN GV 11 Ramsel
66,Bergstraat 71,2022-06-19,19:00:00,36,10,26,FMN GV 11 Ramsel
66,Bergstraat 71,2022-06-19,20:00:00,34,16,18,FMN GV 11 Ramsel
66,Bergstraat 71,2022-06-19,21:00:00,18,14,4,FMN GV 11 Ramsel
66,Bergstraat 71,2022-06-19,22:00:00,18,14,4,FMN GV 11 Ramsel
66,Bergstraat 71,2022-06-19,23:00:00,6,6,0,FMN GV 11 Ramsel
66,Bergstraat 71,2022-06-20,00:00:00,8,8,0,FMN GV 11 Ramsel
66,Bergstraat 71,2022-06-20,01:00:00,4,4,0,FMN GV 11 Ramsel
66,Bergstraat 71,2022-06-20,02:00:00,0,0,0,FMN GV 11 Ramsel
66,Bergstraat 71,2022-06-20,03:00:00,4,0,4,FMN GV 11 Ramsel
66,Bergstraat 71,2022-06-20,04:00:00,4,4,0,FMN GV 11 Ramsel
66,Bergstraat 71,2022-06-20,05:00:00,10,2,8,FMN GV 11 Ramsel
66,Bergstraat 71,2022-06-20,06:00:00,40,12,28,FMN GV 11 Ramsel
66,Bergstraat 71,2022-06-20,07:00:00,280,28,252,FMN GV 11 Ramsel
66,Bergstraat 71,2022-06-20,08:00:00,236,30,206,FMN GV 11 Ramsel
66,Bergstraat 71,2022-06-20,09:00:00,72,36,36,FMN GV 11 Ramsel
66,Bergstraat 71,2022-06-20,10:00:00,118,76,42,FMN GV 11 Ramsel
66,Bergstraat 71,2022-06-20,11:00:00,152,110,42,FMN GV 11 Ramsel
66,Bergstraat 71,2022-06-20,12:00:00,220,172,48,FMN GV 11 Ramsel
66,Bergstraat 71,2022-06-20,13:00:00,296,96,200,FMN GV 11 Ramsel
66,Bergstraat 71,2022-06-20,14:00:00,138,56,82,FMN GV 11 Ramsel
66,Bergstraat 71,2022-06-20,15:00:00,226,122,104,FMN GV 11 Ramsel
66,Bergstraat 71,2022-06-20,16:00:00,154,100,54,FMN GV 11 Ramsel
66,Bergstraat 71,2022-06-20,17:00:00,142,80,62,FMN GV 11 Ramsel
66,Bergstraat 71,2022-06-20,18:00:00,112,54,58,FMN GV 11 Ramsel
66,Bergstraat 71,2022-06-20,19:00:00,92,50,42,FMN GV 11 Ramsel
66,Bergstraat 71,2022-06-20,20:00:00,68,42,26,FMN GV 11 Ramsel
66,Bergstraat 71,2022-06-20,21:00:00,44,24,20,FMN GV 11 Ramsel
66,Bergstraat 71,2022-06-20,22:00:00,22,16,6,FMN GV 11 Ramsel
66,Bergstraat 71,2022-06-20,23:00:00,6,6,0,FMN GV 11 Ramsel
66,Bergstraat 71,2022-06-21,00:00:00,4,0,4,FMN GV 11 Ramsel
66,Bergstraat 71,2022-06-21,01:00:00,4,4,0,FMN GV 11 Ramsel
66,Bergstraat 71,2022-06-21,02:00:00,0,0,0,FMN GV 11 Ramsel
66,Bergstraat 71,2022-06-21,03:00:00,2,2,0,FMN GV 11 Ramsel
66,Bergstraat 71,2022-06-21,04:00:00,8,4,4,FMN GV 11 Ramsel
66,Bergstraat 71,2022-06-21,05:00:00,20,12,8,FMN GV 11 Ramsel
66,Bergstraat 71,2022-06-21,06:00:00,66,30,36,FMN GV 11 Ramsel
66,Bergstraat 71,2022-06-21,07:00:00,284,26,258,FMN GV 11 Ramsel
66,Bergstraat 71,2022-06-21,08:00:00,216,28,188,FMN GV 11 Ramsel
66,Bergstraat 71,2022-06-21,09:00:00,112,50,62,FMN GV 11 Ramsel
66,Bergstraat 71,2022-06-21,10:00:00,270,204,66,FMN GV 11 Ramsel
66,Bergstraat 71,2022-06-21,11:00:00,136,90,46,FMN GV 11 Ramsel
66,Bergstraat 71,2022-06-21,12:00:00,178,112,66,FMN GV 11 Ramsel
66,Bergstraat 71,2022-06-21,13:00:00,228,106,122,FMN GV 11 Ramsel
66,Bergstraat 71,2022-06-21,14:00:00,222,142,80,FMN GV 11 Ramsel
66,Bergstraat 71,2022-06-21,15:00:00,238,134,104,FMN GV 11 Ramsel
66,Bergstraat 71,2022-06-21,16:00:00,188,136,52,FMN GV 11 Ramsel
66,Bergstraat 71,2022-06-21,17:00:00,174,92,82,FMN GV 11 Ramsel
66,Bergstraat 71,2022-06-21,18:00:00,112,54,58,FMN GV 11 Ramsel
66,Bergstraat 71,2022-06-21,19:00:00,114,40,74,FMN GV 11 Ramsel
66,Bergstraat 71,2022-06-21,20:00:00,62,42,20,FMN GV 11 Ramsel
66,Bergstraat 71,2022-06-21,21:00:00,46,36,10,FMN GV 11 Ramsel
66,Bergstraat 71,2022-06-21,22:00:00,26,22,4,FMN GV 11 Ramsel
66,Bergstraat 71,2022-06-21,23:00:00,18,12,6,FMN GV 11 Ramsel
66,Bergstraat 71,2022-06-22,00:00:00,6,2,4,FMN GV 11 Ramsel
66,Bergstraat 71,2022-06-22,01:00:00,12,12,0,FMN GV 11 Ramsel
66,Bergstraat 71,2022-06-22,02:00:00,0,0,0,FMN GV 11 Ramsel
66,Bergstraat 71,2022-06-22,03:00:00,0,0,0,FMN GV 11 Ramsel
66,Bergstraat 71,2022-06-22,04:00:00,14,8,6,FMN GV 11 Ramsel
66,Bergstraat 71,2022-06-22,05:00:00,22,4,18,FMN GV 11 Ramsel
66,Bergstraat 71,2022-06-22,06:00:00,64,28,36,FMN GV 11 Ramsel
66,Bergstraat 71,2022-06-22,07:00:00,290,52,238,FMN GV 11 Ramsel
66,Bergstraat 71,2022-06-22,08:00:00,216,30,186,FMN GV 11 Ramsel
66,Bergstraat 71,2022-06-22,09:00:00,472,298,174,FMN GV 11 Ramsel
66,Bergstraat 71,2022-06-22,10:00:00,212,142,70,FMN GV 11 Ramsel
66,Bergstraat 71,2022-06-22,11:00:00,218,156,62,FMN GV 11 Ramsel
66,Bergstraat 71,2022-06-22,12:00:00,224,154,70,FMN GV 11 Ramsel
66,Bergstraat 71,2022-06-22,13:00:00,234,150,84,FMN GV 11 Ramsel
66,Bergstraat 71,2022-06-22,14:00:00,322,146,176,FMN GV 11 Ramsel
66,Bergstraat 71,2022-06-22,15:00:00,338,196,142,FMN GV 11 Ramsel
66,Bergstraat 71,2022-06-22,16:00:00,244,124,120,FMN GV 11 Ramsel
66,Bergstraat 71,2022-06-22,17:00:00,242,120,122,FMN GV 11 Ramsel
66,Bergstraat 71,2022-06-22,18:00:00,174,102,72,FMN GV 11 Ramsel
66,Bergstraat 71,2022-06-22,19:00:00,192,118,74,FMN GV 11 Ramsel
66,Bergstraat 71,2022-06-22,20:00:00,136,46,90,FMN GV 11 Ramsel
66,Bergstraat 71,2022-06-22,21:00:00,96,36,60,FMN GV 11 Ramsel
66,Bergstraat 71,2022-06-22,22:00:00,50,34,16,FMN GV 11 Ramsel
66,Bergstraat 71,2022-06-22,23:00:00,18,6,12,FMN GV 11 Ramsel
66,Bergstraat 71,2022-06-23,00:00:00,12,10,2,FMN GV 11 Ramsel
66,Bergstraat 71,2022-06-23,01:00:00,42,26,16,FMN GV 11 Ramsel
66,Bergstraat 71,2022-06-23,02:00:00,4,4,0,FMN GV 11 Ramsel
66,Bergstraat 71,2022-06-23,03:00:00,4,4,0,FMN GV 11 Ramsel
66,Bergstraat 71,2022-06-23,04:00:00,12,10,2,FMN GV 11 Ramsel
66,Bergstraat 71,2022-06-23,05:00:00,28,16,12,FMN GV 11 Ramsel
66,Bergstraat 71,2022-06-23,06:00:00,66,26,40,FMN GV 11 Ramsel
66,Bergstraat 71,2022-06-23,07:00:00,234,40,194,FMN GV 11 Ramsel
66,Bergstraat 71,2022-06-23,08:00:00,190,40,150,FMN GV 11 Ramsel
66,Bergstraat 71,2022-06-23,09:00:00,108,32,76,FMN GV 11 Ramsel
66,Bergstraat 71,2022-06-23,10:00:00,232,122,110,FMN GV 11 Ramsel
66,Bergstraat 71,2022-06-23,11:00:00,150,76,74,FMN GV 11 Ramsel
66,Bergstraat 71,2022-06-23,12:00:00,174,114,60,FMN GV 11 Ramsel
66,Bergstraat 71,2022-06-23,13:00:00,228,132,96,FMN GV 11 Ramsel
66,Bergstraat 71,2022-06-23,14:00:00,234,152,82,FMN GV 11 Ramsel
66,Bergstraat 71,2022-06-23,15:00:00,344,124,220,FMN GV 11 Ramsel
66,Bergstraat 71,2022-06-23,16:00:00,222,148,74,FMN GV 11 Ramsel
66,Bergstraat 71,2022-06-23,17:00:00,262,168,94,FMN GV 11 Ramsel
66,Bergstraat 71,2022-06-23,18:00:00,122,64,58,FMN GV 11 Ramsel
66,Bergstraat 71,2022-06-23,19:00:00,110,46,64,FMN GV 11 Ramsel
66,Bergstraat 71,2022-06-23,20:00:00,68,44,24,FMN GV 11 Ramsel
66,Bergstraat 71,2022-06-23,21:00:00,52,26,26,FMN GV 11 Ramsel
66,Bergstraat 71,2022-06-23,22:00:00,42,28,14,FMN GV 11 Ramsel
66,Bergstraat 71,2022-06-23,23:00:00,20,16,4,FMN GV 11 Ramsel
66,Bergstraat 71,2022-06-24,00:00:00,14,12,2,FMN GV 11 Ramsel
66,Bergstraat 71,2022-06-24,01:00:00,2,2,0,FMN GV 11 Ramsel
66,Bergstraat 71,2022-06-24,02:00:00,0,0,0,FMN GV 11 Ramsel
66,Bergstraat 71,2022-06-24,03:00:00,0,0,0,FMN GV 11 Ramsel
66,Bergstraat 71,2022-06-24,04:00:00,6,4,2,FMN GV 11 Ramsel
66,Bergstraat 71,2022-06-24,05:00:00,12,10,2,FMN GV 11 Ramsel
66,Bergstraat 71,2022-06-24,06:00:00,30,8,22,FMN GV 11 Ramsel
66,Bergstraat 71,2022-06-24,07:00:00,38,16,22,FMN GV 11 Ramsel
66,Bergstraat 71,2022-06-24,08:00:00,38,14,24,FMN GV 11 Ramsel
66,Bergstraat 71,2022-06-24,09:00:00,42,14,28,FMN GV 11 Ramsel
66,Bergstraat 71,2022-06-24,10:00:00,50,20,30,FMN GV 11 Ramsel
66,Bergstraat 71,2022-06-24,11:00:00,56,18,38,FMN GV 11 Ramsel
66,Bergstraat 71,2022-06-24,12:00:00,62,38,24,FMN GV 11 Ramsel
66,Bergstraat 71,2022-06-24,13:00:00,72,38,34,FMN GV 11 Ramsel
66,Bergstraat 71,2022-06-24,14:00:00,56,34,22,FMN GV 11 Ramsel
66,Bergstraat 71,2022-06-24,15:00:00,98,38,60,FMN GV 11 Ramsel
66,Bergstraat 71,2022-06-24,16:00:00,72,32,40,FMN GV 11 Ramsel
66,Bergstraat 71,2022-06-24,17:00:00,58,16,42,FMN GV 11 Ramsel
66,Bergstraat 71,2022-06-24,18:00:00,72,20,52,FMN GV 11 Ramsel
66,Bergstraat 71,2022-06-24,19:00:00,60,16,44,FMN GV 11 Ramsel
66,Bergstraat 71,2022-06-24,20:00:00,72,14,58,FMN GV 11 Ramsel
66,Bergstraat 71,2022-06-24,21:00:00,36,14,22,FMN GV 11 Ramsel
66,Bergstraat 71,2022-06-24,22:00:00,48,30,18,FMN GV 11 Ramsel
66,Bergstraat 71,2022-06-24,23:00:00,8,8,0,FMN GV 11 Ramsel
66,Bergstraat 71,2022-06-25,00:00:00,24,18,6,FMN GV 11 Ramsel
66,Bergstraat 71,2022-06-25,01:00:00,20,16,4,FMN GV 11 Ramsel
66,Bergstraat 71,2022-06-25,02:00:00,26,24,2,FMN GV 11 Ramsel
66,Bergstraat 71,2022-06-25,03:00:00,10,10,0,FMN GV 11 Ramsel
66,Bergstraat 71,2022-06-25,04:00:00,6,6,0,FMN GV 11 Ramsel
66,Bergstraat 71,2022-06-25,05:00:00,2,2,0,FMN GV 11 Ramsel
66,Bergstraat 71,2022-06-25,06:00:00,22,10,12,FMN GV 11 Ramsel
66,Bergstraat 71,2022-06-25,07:00:00,42,8,34,FMN GV 11 Ramsel
66,Bergstraat 71,2022-06-25,08:00:00,50,22,28,FMN GV 11 Ramsel
66,Bergstraat 71,2022-06-25,09:00:00,52,20,32,FMN GV 11 Ramsel
66,Bergstraat 71,2022-06-25,10:00:00,156,74,82,FMN GV 11 Ramsel
66,Bergstraat 71,2022-06-25,11:00:00,120,66,54,FMN GV 11 Ramsel
66,Bergstraat 71,2022-06-25,12:00:00,80,30,50,FMN GV 11 Ramsel
66,Bergstraat 71,2022-06-25,13:00:00,136,60,76,FMN GV 11 Ramsel
66,Bergstraat 71,2022-06-25,14:00:00,132,68,64,FMN GV 11 Ramsel
66,Bergstraat 71,2022-06-25,15:00:00,142,96,46,FMN GV 11 Ramsel
66,Bergstraat 71,2022-06-25,16:00:00,134,86,48,FMN GV 11 Ramsel
66,Bergstraat 71,2022-06-25,17:00:00,70,48,22,FMN GV 11 Ramsel
66,Bergstraat 71,2022-06-25,18:00:00,40,8,32,FMN GV 11 Ramsel
66,Bergstraat 71,2022-06-25,19:00:00,30,10,20,FMN GV 11 Ramsel
66,Bergstraat 71,2022-06-25,20:00:00,14,8,6,FMN GV 11 Ramsel
66,Bergstraat 71,2022-06-25,21:00:00,18,12,6,FMN GV 11 Ramsel
66,Bergstraat 71,2022-06-25,22:00:00,10,6,4,FMN GV 11 Ramsel
66,Bergstraat 71,2022-06-25,23:00:00,6,4,2,FMN GV 11 Ramsel
66,Bergstraat 71,2022-06-26,00:00:00,20,18,2,FMN GV 11 Ramsel
66,Bergstraat 71,2022-06-26,01:00:00,16,12,4,FMN GV 11 Ramsel
66,Bergstraat 71,2022-06-26,02:00:00,0,0,0,FMN GV 11 Ramsel
66,Bergstraat 71,2022-06-26,03:00:00,0,0,0,FMN GV 11 Ramsel
66,Bergstraat 71,2022-06-26,04:00:00,2,2,0,FMN GV 11 Ramsel
66,Bergstraat 71,2022-06-26,05:00:00,4,2,2,FMN GV 11 Ramsel
66,Bergstraat 71,2022-06-26,06:00:00,16,8,8,FMN GV 11 Ramsel
66,Bergstraat 71,2022-06-26,07:00:00,28,12,16,FMN GV 11 Ramsel
66,Bergstraat 71,2022-06-26,08:00:00,64,28,36,FMN GV 11 Ramsel
66,Bergstraat 71,2022-06-26,09:00:00,138,64,74,FMN GV 11 Ramsel
66,Bergstraat 71,2022-06-26,10:00:00,164,54,110,FMN GV 11 Ramsel
66,Bergstraat 71,2022-06-26,11:00:00,182,108,74,FMN GV 11 Ramsel
66,Bergstraat 71,2022-06-26,12:00:00,142,76,66,FMN GV 11 Ramsel
66,Bergstraat 71,2022-06-26,13:00:00,158,94,64,FMN GV 11 Ramsel
66,Bergstraat 71,2022-06-26,14:00:00,214,104,110,FMN GV 11 Ramsel
66,Bergstraat 71,2022-06-26,15:00:00,202,106,96,FMN GV 11 Ramsel
66,Bergstraat 71,2022-06-26,16:00:00,192,110,82,FMN GV 11 Ramsel
66,Bergstraat 71,2022-06-26,17:00:00,126,62,64,FMN GV 11 Ramsel
66,Bergstraat 71,2022-06-26,18:00:00,90,58,32,FMN GV 11 Ramsel
66,Bergstraat 71,2022-06-26,19:00:00,48,24,24,FMN GV 11 Ramsel
66,Bergstraat 71,2022-06-26,20:00:00,60,36,24,FMN GV 11 Ramsel
66,Bergstraat 71,2022-06-26,21:00:00,40,22,18,FMN GV 11 Ramsel
66,Bergstraat 71,2022-06-26,22:00:00,10,6,4,FMN GV 11 Ramsel
66,Bergstraat 71,2022-06-26,23:00:00,8,6,2,FMN GV 11 Ramsel
66,Bergstraat 71,2022-06-27,00:00:00,0,0,0,FMN GV 11 Ramsel
66,Bergstraat 71,2022-06-27,01:00:00,4,4,0,FMN GV 11 Ramsel
66,Bergstraat 71,2022-06-27,02:00:00,0,0,0,FMN GV 11 Ramsel
66,Bergstraat 71,2022-06-27,03:00:00,4,2,2,FMN GV 11 Ramsel
66,Bergstraat 71,2022-06-27,04:00:00,2,2,0,FMN GV 11 Ramsel
66,Bergstraat 71,2022-06-27,05:00:00,20,6,14,FMN GV 11 Ramsel
66,Bergstraat 71,2022-06-27,06:00:00,36,14,22,FMN GV 11 Ramsel
66,Bergstraat 71,2022-06-27,07:00:00,88,24,64,FMN GV 11 Ramsel
66,Bergstraat 71,2022-06-27,08:00:00,120,56,64,FMN GV 11 Ramsel
66,Bergstraat 71,2022-06-27,09:00:00,62,26,36,FMN GV 11 Ramsel
66,Bergstraat 71,2022-06-27,10:00:00,70,28,42,FMN GV 11 Ramsel
66,Bergstraat 71,2022-06-27,11:00:00,126,102,24,FMN GV 11 Ramsel
66,Bergstraat 71,2022-06-27,12:00:00,68,44,24,FMN GV 11 Ramsel
66,Bergstraat 71,2022-06-27,13:00:00,46,24,22,FMN GV 11 Ramsel
66,Bergstraat 71,2022-06-27,14:00:00,34,26,8,FMN GV 11 Ramsel
66,Bergstraat 71,2022-06-27,15:00:00,34,18,16,FMN GV 11 Ramsel
66,Bergstraat 71,2022-06-27,16:00:00,108,84,24,FMN GV 11 Ramsel
66,Bergstraat 71,2022-06-27,17:00:00,92,70,22,FMN GV 11 Ramsel
66,Bergstraat 71,2022-06-27,18:00:00,90,46,44,FMN GV 11 Ramsel
66,Bergstraat 71,2022-06-27,19:00:00,82,46,36,FMN GV 11 Ramsel
66,Bergstraat 71,2022-06-27,20:00:00,54,24,30,FMN GV 11 Ramsel
66,Bergstraat 71,2022-06-27,21:00:00,34,20,14,FMN GV 11 Ramsel
66,Bergstraat 71,2022-06-27,22:00:00,22,12,10,FMN GV 11 Ramsel
66,Bergstraat 71,2022-06-27,23:00:00,10,2,8,FMN GV 11 Ramsel
66,Bergstraat 71,2022-06-28,00:00:00,10,8,2,FMN GV 11 Ramsel
66,Bergstraat 71,2022-06-28,01:00:00,0,0,0,FMN GV 11 Ramsel
66,Bergstraat 71,2022-06-28,02:00:00,12,12,0,FMN GV 11 Ramsel
66,Bergstraat 71,2022-06-28,03:00:00,2,0,2,FMN GV 11 Ramsel
66,Bergstraat 71,2022-06-28,04:00:00,6,2,4,FMN GV 11 Ramsel
66,Bergstraat 71,2022-06-28,05:00:00,12,4,8,FMN GV 11 Ramsel
66,Bergstraat 71,2022-06-28,06:00:00,52,20,32,FMN GV 11 Ramsel
66,Bergstraat 71,2022-06-28,07:00:00,134,28,106,FMN GV 11 Ramsel
66,Bergstraat 71,2022-06-28,08:00:00,172,48,124,FMN GV 11 Ramsel
66,Bergstraat 71,2022-06-28,09:00:00,80,36,44,FMN GV 11 Ramsel
66,Bergstraat 71,2022-06-28,10:00:00,124,68,56,FMN GV 11 Ramsel
66,Bergstraat 71,2022-06-28,11:00:00,114,56,58,FMN GV 11 Ramsel
66,Bergstraat 71,2022-06-28,12:00:00,196,80,116,FMN GV 11 Ramsel
66,Bergstraat 71,2022-06-28,13:00:00,252,130,122,FMN GV 11 Ramsel
66,Bergstraat 71,2022-06-28,14:00:00,236,134,102,FMN GV 11 Ramsel
66,Bergstraat 71,2022-06-28,15:00:00,262,146,116,FMN GV 11 Ramsel
66,Bergstraat 71,2022-06-28,16:00:00,244,158,86,FMN GV 11 Ramsel
66,Bergstraat 71,2022-06-28,17:00:00,190,94,96,FMN GV 11 Ramsel
66,Bergstraat 71,2022-06-28,18:00:00,200,128,72,FMN GV 11 Ramsel
66,Bergstraat 71,2022-06-28,19:00:00,136,72,64,FMN GV 11 Ramsel
66,Bergstraat 71,2022-06-28,20:00:00,88,48,40,FMN GV 11 Ramsel
66,Bergstraat 71,2022-06-28,21:00:00,152,100,52,FMN GV 11 Ramsel
66,Bergstraat 71,2022-06-28,22:00:00,44,32,12,FMN GV 11 Ramsel
66,Bergstraat 71,2022-06-28,23:00:00,12,6,6,FMN GV 11 Ramsel
66,Bergstraat 71,2022-06-29,00:00:00,6,4,2,FMN GV 11 Ramsel
66,Bergstraat 71,2022-06-29,01:00:00,0,0,0,FMN GV 11 Ramsel
66,Bergstraat 71,2022-06-29,02:00:00,2,0,2,FMN GV 11 Ramsel
66,Bergstraat 71,2022-06-29,03:00:00,4,2,2,FMN GV 11 Ramsel
66,Bergstraat 71,2022-06-29,04:00:00,10,6,4,FMN GV 11 Ramsel
66,Bergstraat 71,2022-06-29,05:00:00,22,8,14,FMN GV 11 Ramsel
66,Bergstraat 71,2022-06-29,06:00:00,50,18,32,FMN GV 11 Ramsel
66,Bergstraat 71,2022-06-29,07:00:00,150,22,128,FMN GV 11 Ramsel
66,Bergstraat 71,2022-06-29,08:00:00,192,26,166,FMN GV 11 Ramsel
66,Bergstraat 71,2022-06-29,09:00:00,170,78,92,FMN GV 11 Ramsel
66,Bergstraat 71,2022-06-29,10:00:00,232,136,96,FMN GV 11 Ramsel
66,Bergstraat 71,2022-06-29,11:00:00,200,118,82,FMN GV 11 Ramsel
66,Bergstraat 71,2022-06-29,12:00:00,160,82,78,FMN GV 11 Ramsel
66,Bergstraat 71,2022-06-29,13:00:00,234,144,90,FMN GV 11 Ramsel
66,Bergstraat 71,2022-06-29,14:00:00,254,112,142,FMN GV 11 Ramsel
66,Bergstraat 71,2022-06-29,15:00:00,294,174,120,FMN GV 11 Ramsel
66,Bergstraat 71,2022-06-29,16:00:00,250,146,104,FMN GV 11 Ramsel
66,Bergstraat 71,2022-06-29,17:00:00,238,124,114,FMN GV 11 Ramsel
66,Bergstraat 71,2022-06-29,18:00:00,186,86,100,FMN GV 11 Ramsel
66,Bergstraat 71,2022-06-29,19:00:00,142,88,54,FMN GV 11 Ramsel
66,Bergstraat 71,2022-06-29,20:00:00,150,90,60,FMN GV 11 Ramsel
66,Bergstraat 71,2022-06-29,21:00:00,52,32,20,FMN GV 11 Ramsel
66,Bergstraat 71,2022-06-29,22:00:00,58,36,22,FMN GV 11 Ramsel
66,Bergstraat 71,2022-06-29,23:00:00,10,6,4,FMN GV 11 Ramsel
66,Bergstraat 71,2022-06-30,00:00:00,16,16,0,FMN GV 11 Ramsel
66,Bergstraat 71,2022-06-30,01:00:00,0,0,0,FMN GV 11 Ramsel
66,Bergstraat 71,2022-06-30,02:00:00,0,0,0,FMN GV 11 Ramsel
66,Bergstraat 71,2022-06-30,03:00:00,0,0,0,FMN GV 11 Ramsel
66,Bergstraat 71,2022-06-30,04:00:00,10,4,6,FMN GV 11 Ramsel
66,Bergstraat 71,2022-06-30,05:00:00,6,2,4,FMN GV 11 Ramsel
66,Bergstraat 71,2022-06-30,06:00:00,46,20,26,FMN GV 11 Ramsel
66,Bergstraat 71,2022-06-30,07:00:00,66,26,40,FMN GV 11 Ramsel
66,Bergstraat 71,2022-06-30,08:00:00,128,28,100,FMN GV 11 Ramsel
66,Bergstraat 71,2022-06-30,09:00:00,102,32,70,FMN GV 11 Ramsel
66,Bergstraat 71,2022-06-30,10:00:00,142,62,80,FMN GV 11 Ramsel
66,Bergstraat 71,2022-06-30,11:00:00,104,70,34,FMN GV 11 Ramsel
66,Bergstraat 71,2022-06-30,12:00:00,92,68,24,FMN GV 11 Ramsel
66,Bergstraat 71,2022-06-30,13:00:00,74,58,16,FMN GV 11 Ramsel
66,Bergstraat 71,2022-06-30,14:00:00,78,48,30,FMN GV 11 Ramsel
66,Bergstraat 71,2022-06-30,15:00:00,64,42,22,FMN GV 11 Ramsel
66,Bergstraat 71,2022-06-30,16:00:00,98,40,58,FMN GV 11 Ramsel
66,Bergstraat 71,2022-06-30,17:00:00,46,18,28,FMN GV 11 Ramsel
66,Bergstraat 71,2022-06-30,18:00:00,26,16,10,FMN GV 11 Ramsel
66,Bergstraat 71,2022-06-30,19:00:00,14,4,10,FMN GV 11 Ramsel
66,Bergstraat 71,2022-06-30,20:00:00,20,8,12,FMN GV 11 Ramsel
66,Bergstraat 71,2022-06-30,21:00:00,14,8,6,FMN GV 11 Ramsel
66,Bergstraat 71,2022-06-30,22:00:00,12,4,8,FMN GV 11 Ramsel
66,Bergstraat 71,2022-06-30,23:00:00,6,2,4,FMN GV 11 Ramsel
66,Bergstraat 71,2022-07-01,00:00:00,12,12,0,FMN GV 11 Ramsel
66,Bergstraat 71,2022-07-01,01:00:00,0,0,0,FMN GV 11 Ramsel
66,Bergstraat 71,2022-07-01,02:00:00,12,12,0,FMN GV 11 Ramsel
66,Bergstraat 71,2022-07-01,03:00:00,2,2,0,FMN GV 11 Ramsel
66,Bergstraat 71,2022-07-01,04:00:00,4,4,0,FMN GV 11 Ramsel
66,Bergstraat 71,2022-07-01,05:00:00,6,2,4,FMN GV 11 Ramsel
66,Bergstraat 71,2022-07-01,06:00:00,34,18,16,FMN GV 11 Ramsel
66,Bergstraat 71,2022-07-01,07:00:00,46,20,26,FMN GV 11 Ramsel
66,Bergstraat 71,2022-07-01,08:00:00,48,10,38,FMN GV 11 Ramsel
66,Bergstraat 71,2022-07-01,09:00:00,66,16,50,FMN GV 11 Ramsel
66,Bergstraat 71,2022-07-01,10:00:00,86,26,60,FMN GV 11 Ramsel
66,Bergstraat 71,2022-07-01,11:00:00,100,46,54,FMN GV 11 Ramsel
66,Bergstraat 71,2022-07-01,12:00:00,150,102,48,FMN GV 11 Ramsel
66,Bergstraat 71,2022-07-01,13:00:00,194,126,68,FMN GV 11 Ramsel
66,Bergstraat 71,2022-07-01,14:00:00,154,84,70,FMN GV 11 Ramsel
66,Bergstraat 71,2022-07-01,15:00:00,158,84,74,FMN GV 11 Ramsel
66,Bergstraat 71,2022-07-01,16:00:00,134,70,64,FMN GV 11 Ramsel
66,Bergstraat 71,2022-07-01,17:00:00,136,88,48,FMN GV 11 Ramsel
66,Bergstraat 71,2022-07-01,18:00:00,104,54,50,FMN GV 11 Ramsel
66,Bergstraat 71,2022-07-01,19:00:00,60,34,26,FMN GV 11 Ramsel
66,Bergstraat 71,2022-07-01,20:00:00,58,30,28,FMN GV 11 Ramsel
66,Bergstraat 71,2022-07-01,21:00:00,32,16,16,FMN GV 11 Ramsel
66,Bergstraat 71,2022-07-01,22:00:00,26,14,12,FMN GV 11 Ramsel
66,Bergstraat 71,2022-07-01,23:00:00,10,6,4,FMN GV 11 Ramsel
66,Bergstraat 71,2022-07-02,00:00:00,6,4,2,FMN GV 11 Ramsel
66,Bergstraat 71,2022-07-02,01:00:00,16,12,4,FMN GV 11 Ramsel
66,Bergstraat 71,2022-07-02,02:00:00,20,20,0,FMN GV 11 Ramsel
66,Bergstraat 71,2022-07-02,03:00:00,4,4,0,FMN GV 11 Ramsel
66,Bergstraat 71,2022-07-02,04:00:00,10,2,8,FMN GV 11 Ramsel
66,Bergstraat 71,2022-07-02,05:00:00,4,2,2,FMN GV 11 Ramsel
66,Bergstraat 71,2022-07-02,06:00:00,16,6,10,FMN GV 11 Ramsel
66,Bergstraat 71,2022-07-02,07:00:00,26,6,20,FMN GV 11 Ramsel
66,Bergstraat 71,2022-07-02,08:00:00,44,18,26,FMN GV 11 Ramsel
66,Bergstraat 71,2022-07-02,09:00:00,78,26,52,FMN GV 11 Ramsel
66,Bergstraat 71,2022-07-02,10:00:00,146,64,82,FMN GV 11 Ramsel
66,Bergstraat 71,2022-07-02,11:00:00,168,86,82,FMN GV 11 Ramsel
66,Bergstraat 71,2022-07-02,12:00:00,192,94,98,FMN GV 11 Ramsel
66,Bergstraat 71,2022-07-02,13:00:00,244,110,134,FMN GV 11 Ramsel
66,Bergstraat 71,2022-07-02,14:00:00,298,122,176,FMN GV 11 Ramsel
66,Bergstraat 71,2022-07-02,15:00:00,202,106,96,FMN GV 11 Ramsel
66,Bergstraat 71,2022-07-02,16:00:00,176,98,78,FMN GV 11 Ramsel
66,Bergstraat 71,2022-07-02,17:00:00,146,70,76,FMN GV 11 Ramsel
66,Bergstraat 71,2022-07-02,18:00:00,98,68,30,FMN GV 11 Ramsel
66,Bergstraat 71,2022-07-02,19:00:00,66,36,30,FMN GV 11 Ramsel
66,Bergstraat 71,2022-07-02,20:00:00,64,34,30,FMN GV 11 Ramsel
66,Bergstraat 71,2022-07-02,21:00:00,32,20,12,FMN GV 11 Ramsel
66,Bergstraat 71,2022-07-02,22:00:00,22,18,4,FMN GV 11 Ramsel
66,Bergstraat 71,2022-07-02,23:00:00,10,6,4,FMN GV 11 Ramsel
66,Bergstraat 71,2022-07-03,00:00:00,2,2,0,FMN GV 11 Ramsel
66,Bergstraat 71,2022-07-03,01:00:00,10,8,2,FMN GV 11 Ramsel
66,Bergstraat 71,2022-07-03,02:00:00,8,2,6,FMN GV 11 Ramsel
66,Bergstraat 71,2022-07-03,03:00:00,0,0,0,FMN GV 11 Ramsel
66,Bergstraat 71,2022-07-03,04:00:00,4,2,2,FMN GV 11 Ramsel
66,Bergstraat 71,2022-07-03,05:00:00,2,2,0,FMN GV 11 Ramsel
66,Bergstraat 71,2022-07-03,06:00:00,14,6,8,FMN GV 11 Ramsel
66,Bergstraat 71,2022-07-03,07:00:00,28,12,16,FMN GV 11 Ramsel
66,Bergstraat 71,2022-07-03,08:00:00,72,24,48,FMN GV 11 Ramsel
66,Bergstraat 71,2022-07-03,09:00:00,178,74,104,FMN GV 11 Ramsel
66,Bergstraat 71,2022-07-03,10:00:00,194,102,92,FMN GV 11 Ramsel
66,Bergstraat 71,2022-07-03,11:00:00,266,112,154,FMN GV 11 Ramsel
66,Bergstraat 71,2022-07-03,12:00:00,198,88,110,FMN GV 11 Ramsel
66,Bergstraat 71,2022-07-03,13:00:00,320,108,212,FMN GV 11 Ramsel
66,Bergstraat 71,2022-07-03,14:00:00,388,194,194,FMN GV 11 Ramsel
66,Bergstraat 71,2022-07-03,15:00:00,238,148,90,FMN GV 11 Ramsel
66,Bergstraat 71,2022-07-03,16:00:00,242,102,140,FMN GV 11 Ramsel
66,Bergstraat 71,2022-07-03,17:00:00,164,108,56,FMN GV 11 Ramsel
66,Bergstraat 71,2022-07-03,18:00:00,98,42,56,FMN GV 11 Ramsel
66,Bergstraat 71,2022-07-03,19:00:00,56,34,22,FMN GV 11 Ramsel
66,Bergstraat 71,2022-07-03,20:00:00,76,40,36,FMN GV 11 Ramsel
66,Bergstraat 71,2022-07-03,21:00:00,38,22,16,FMN GV 11 Ramsel
66,Bergstraat 71,2022-07-03,22:00:00,14,10,4,FMN GV 11 Ramsel
66,Bergstraat 71,2022-07-03,23:00:00,4,4,0,FMN GV 11 Ramsel
66,Bergstraat 71,2022-07-04,00:00:00,6,6,0,FMN GV 11 Ramsel
66,Bergstraat 71,2022-07-04,01:00:00,10,10,0,FMN GV 11 Ramsel
66,Bergstraat 71,2022-07-04,02:00:00,0,0,0,FMN GV 11 Ramsel
66,Bergstraat 71,2022-07-04,03:00:00,4,4,0,FMN GV 11 Ramsel
66,Bergstraat 71,2022-07-04,04:00:00,4,2,2,FMN GV 11 Ramsel
66,Bergstraat 71,2022-07-04,05:00:00,14,6,8,FMN GV 11 Ramsel
66,Bergstraat 71,2022-07-04,06:00:00,62,26,36,FMN GV 11 Ramsel
66,Bergstraat 71,2022-07-04,07:00:00,66,26,40,FMN GV 11 Ramsel
66,Bergstraat 71,2022-07-04,08:00:00,88,24,64,FMN GV 11 Ramsel
66,Bergstraat 71,2022-07-04,09:00:00,58,30,28,FMN GV 11 Ramsel
66,Bergstraat 71,2022-07-04,10:00:00,76,28,48,FMN GV 11 Ramsel
66,Bergstraat 71,2022-07-04,11:00:00,88,42,46,FMN GV 11 Ramsel
66,Bergstraat 71,2022-07-04,12:00:00,118,66,52,FMN GV 11 Ramsel
66,Bergstraat 71,2022-07-04,13:00:00,140,54,86,FMN GV 11 Ramsel
66,Bergstraat 71,2022-07-04,14:00:00,174,68,106,FMN GV 11 Ramsel
66,Bergstraat 71,2022-07-04,15:00:00,152,92,60,FMN GV 11 Ramsel
66,Bergstraat 71,2022-07-04,16:00:00,182,78,104,FMN GV 11 Ramsel
66,Bergstraat 71,2022-07-04,17:00:00,118,78,40,FMN GV 11 Ramsel
66,Bergstraat 71,2022-07-04,18:00:00,84,54,30,FMN GV 11 Ramsel
66,Bergstraat 71,2022-07-04,19:00:00,86,50,36,FMN GV 11 Ramsel
66,Bergstraat 71,2022-07-04,20:00:00,60,32,28,FMN GV 11 Ramsel
66,Bergstraat 71,2022-07-04,21:00:00,32,18,14,FMN GV 11 Ramsel
66,Bergstraat 71,2022-07-04,22:00:00,10,8,2,FMN GV 11 Ramsel
66,Bergstraat 71,2022-07-04,23:00:00,4,4,0,FMN GV 11 Ramsel
66,Bergstraat 71,2022-07-05,00:00:00,12,10,2,FMN GV 11 Ramsel
66,Bergstraat 71,2022-07-05,01:00:00,4,4,0,FMN GV 11 Ramsel
66,Bergstraat 71,2022-07-05,02:00:00,0,0,0,FMN GV 11 Ramsel
66,Bergstraat 71,2022-07-05,03:00:00,0,0,0,FMN GV 11 Ramsel
66,Bergstraat 71,2022-07-05,04:00:00,2,2,0,FMN GV 11 Ramsel
66,Bergstraat 71,2022-07-05,05:00:00,14,8,6,FMN GV 11 Ramsel
66,Bergstraat 71,2022-07-05,06:00:00,74,30,44,FMN GV 11 Ramsel
66,Bergstraat 71,2022-07-05,07:00:00,78,28,50,FMN GV 11 Ramsel
66,Bergstraat 71,2022-07-05,08:00:00,62,24,38,FMN GV 11 Ramsel
66,Bergstraat 71,2022-07-05,09:00:00,56,20,36,FMN GV 11 Ramsel
66,Bergstraat 71,2022-07-05,10:00:00,96,32,64,FMN GV 11 Ramsel
66,Bergstraat 71,2022-07-05,11:00:00,132,50,82,FMN GV 11 Ramsel
66,Bergstraat 71,2022-07-05,12:00:00,96,40,56,FMN GV 11 Ramsel
66,Bergstraat 71,2022-07-05,13:00:00,234,82,152,FMN GV 11 Ramsel
66,Bergstraat 71,2022-07-05,14:00:00,194,104,90,FMN GV 11 Ramsel
66,Bergstraat 71,2022-07-05,15:00:00,188,98,90,FMN GV 11 Ramsel
66,Bergstraat 71,2022-07-05,16:00:00,196,100,96,FMN GV 11 Ramsel
66,Bergstraat 71,2022-07-05,17:00:00,144,72,72,FMN GV 11 Ramsel
66,Bergstraat 71,2022-07-05,18:00:00,132,78,54,FMN GV 11 Ramsel
66,Bergstraat 71,2022-07-05,19:00:00,88,40,48,FMN GV 11 Ramsel
66,Bergstraat 71,2022-07-05,20:00:00,100,68,32,FMN GV 11 Ramsel
66,Bergstraat 71,2022-07-05,21:00:00,40,22,18,FMN GV 11 Ramsel
66,Bergstraat 71,2022-07-05,22:00:00,30,26,4,FMN GV 11 Ramsel
66,Bergstraat 71,2022-07-05,23:00:00,12,6,6,FMN GV 11 Ramsel
66,Bergstraat 71,2022-07-06,00:00:00,8,6,2,FMN GV 11 Ramsel
66,Bergstraat 71,2022-07-06,01:00:00,6,4,2,FMN GV 11 Ramsel
66,Bergstraat 71,2022-07-06,02:00:00,0,0,0,FMN GV 11 Ramsel
66,Bergstraat 71,2022-07-06,03:00:00,0,0,0,FMN GV 11 Ramsel
66,Bergstraat 71,2022-07-06,04:00:00,2,0,2,FMN GV 11 Ramsel
66,Bergstraat 71,2022-07-06,05:00:00,20,6,14,FMN GV 11 Ramsel
66,Bergstraat 71,2022-07-06,06:00:00,46,18,28,FMN GV 11 Ramsel
66,Bergstraat 71,2022-07-06,07:00:00,56,18,38,FMN GV 11 Ramsel
66,Bergstraat 71,2022-07-06,08:00:00,76,36,40,FMN GV 11 Ramsel
66,Bergstraat 71,2022-07-06,09:00:00,76,26,50,FMN GV 11 Ramsel
66,Bergstraat 71,2022-07-06,10:00:00,84,34,50,FMN GV 11 Ramsel
66,Bergstraat 71,2022-07-06,11:00:00,72,40,32,FMN GV 11 Ramsel
66,Bergstraat 71,2022-07-06,12:00:00,106,42,64,FMN GV 11 Ramsel
66,Bergstraat 71,2022-07-06,13:00:00,162,74,88,FMN GV 11 Ramsel
66,Bergstraat 71,2022-07-06,14:00:00,212,106,106,FMN GV 11 Ramsel
66,Bergstraat 71,2022-07-06,15:00:00,176,78,98,FMN GV 11 Ramsel
66,Bergstraat 71,2022-07-06,16:00:00,168,88,80,FMN GV 11 Ramsel
66,Bergstraat 71,2022-07-06,17:00:00,144,82,62,FMN GV 11 Ramsel
66,Bergstraat 71,2022-07-06,18:00:00,164,100,64,FMN GV 11 Ramsel
66,Bergstraat 71,2022-07-06,19:00:00,108,36,72,FMN GV 11 Ramsel
66,Bergstraat 71,2022-07-06,20:00:00,136,42,94,FMN GV 11 Ramsel
66,Bergstraat 71,2022-07-06,21:00:00,56,38,18,FMN GV 11 Ramsel
66,Bergstraat 71,2022-07-06,22:00:00,34,20,14,FMN GV 11 Ramsel
66,Bergstraat 71,2022-07-06,23:00:00,6,2,4,FMN GV 11 Ramsel
66,Bergstraat 71,2022-07-07,00:00:00,8,8,0,FMN GV 11 Ramsel
66,Bergstraat 71,2022-07-07,01:00:00,12,10,2,FMN GV 11 Ramsel
66,Bergstraat 71,2022-07-07,02:00:00,0,0,0,FMN GV 11 Ramsel
66,Bergstraat 71,2022-07-07,03:00:00,0,0,0,FMN GV 11 Ramsel
66,Bergstraat 71,2022-07-07,04:00:00,4,2,2,FMN GV 11 Ramsel
66,Bergstraat 71,2022-07-07,05:00:00,18,10,8,FMN GV 11 Ramsel
66,Bergstraat 71,2022-07-07,06:00:00,46,20,26,FMN GV 11 Ramsel
66,Bergstraat 71,2022-07-07,07:00:00,58,26,32,FMN GV 11 Ramsel
66,Bergstraat 71,2022-07-07,08:00:00,44,16,28,FMN GV 11 Ramsel
66,Bergstraat 71,2022-07-07,09:00:00,52,18,34,FMN GV 11 Ramsel
66,Bergstraat 71,2022-07-07,10:00:00,48,34,14,FMN GV 11 Ramsel
66,Bergstraat 71,2022-07-07,11:00:00,50,32,18,FMN GV 11 Ramsel
66,Bergstraat 71,2022-07-07,12:00:00,56,32,24,FMN GV 11 Ramsel
66,Bergstraat 71,2022-07-07,13:00:00,52,34,18,FMN GV 11 Ramsel
66,Bergstraat 71,2022-07-07,14:00:00,58,24,34,FMN GV 11 Ramsel
66,Bergstraat 71,2022-07-07,15:00:00,106,54,52,FMN GV 11 Ramsel
66,Bergstraat 71,2022-07-07,16:00:00,106,66,40,FMN GV 11 Ramsel
66,Bergstraat 71,2022-07-07,17:00:00,72,34,38,FMN GV 11 Ramsel
66,Bergstraat 71,2022-07-07,18:00:00,74,32,42,FMN GV 11 Ramsel
66,Bergstraat 71,2022-07-07,19:00:00,96,50,46,FMN GV 11 Ramsel
66,Bergstraat 71,2022-07-07,20:00:00,72,48,24,FMN GV 11 Ramsel
66,Bergstraat 71,2022-07-07,21:00:00,38,24,14,FMN GV 11 Ramsel
66,Bergstraat 71,2022-07-07,22:00:00,34,26,8,FMN GV 11 Ramsel
66,Bergstraat 71,2022-07-07,23:00:00,10,2,8,FMN GV 11 Ramsel
66,Bergstraat 71,2022-07-08,00:00:00,6,6,0,FMN GV 11 Ramsel
66,Bergstraat 71,2022-07-08,01:00:00,8,6,2,FMN GV 11 Ramsel
66,Bergstraat 71,2022-07-08,02:00:00,2,2,0,FMN GV 11 Ramsel
66,Bergstraat 71,2022-07-08,03:00:00,0,0,0,FMN GV 11 Ramsel
66,Bergstraat 71,2022-07-08,04:00:00,4,2,2,FMN GV 11 Ramsel
66,Bergstraat 71,2022-07-08,05:00:00,10,4,6,FMN GV 11 Ramsel
66,Bergstraat 71,2022-07-08,06:00:00,26,10,16,FMN GV 11 Ramsel
66,Bergstraat 71,2022-07-08,07:00:00,54,22,32,FMN GV 11 Ramsel
66,Bergstraat 71,2022-07-08,08:00:00,44,18,26,FMN GV 11 Ramsel
66,Bergstraat 71,2022-07-08,09:00:00,66,26,40,FMN GV 11 Ramsel
66,Bergstraat 71,2022-07-08,10:00:00,122,38,84,FMN GV 11 Ramsel
66,Bergstraat 71,2022-07-08,11:00:00,100,48,52,FMN GV 11 Ramsel
66,Bergstraat 71,2022-07-08,12:00:00,128,56,72,FMN GV 11 Ramsel
66,Bergstraat 71,2022-07-08,13:00:00,148,80,68,FMN GV 11 Ramsel
66,Bergstraat 71,2022-07-08,14:00:00,266,116,150,FMN GV 11 Ramsel
66,Bergstraat 71,2022-07-08,15:00:00,188,100,88,FMN GV 11 Ramsel
66,Bergstraat 71,2022-07-08,16:00:00,166,74,92,FMN GV 11 Ramsel
66,Bergstraat 71,2022-07-08,17:00:00,150,106,44,FMN GV 11 Ramsel
66,Bergstraat 71,2022-07-08,18:00:00,124,72,52,FMN GV 11 Ramsel
66,Bergstraat 71,2022-07-08,19:00:00,100,52,48,FMN GV 11 Ramsel
66,Bergstraat 71,2022-07-08,20:00:00,62,24,38,FMN GV 11 Ramsel
66,Bergstraat 71,2022-07-08,21:00:00,36,16,20,FMN GV 11 Ramsel
66,Bergstraat 71,2022-07-08,22:00:00,26,16,10,FMN GV 11 Ramsel
66,Bergstraat 71,2022-07-08,23:00:00,18,16,2,FMN GV 11 Ramsel
66,Bergstraat 71,2022-07-09,00:00:00,8,8,0,FMN GV 11 Ramsel
66,Bergstraat 71,2022-07-09,01:00:00,14,14,0,FMN GV 11 Ramsel
66,Bergstraat 71,2022-07-09,02:00:00,6,6,0,FMN GV 11 Ramsel
66,Bergstraat 71,2022-07-09,03:00:00,6,4,2,FMN GV 11 Ramsel
66,Bergstraat 71,2022-07-09,04:00:00,0,0,0,FMN GV 11 Ramsel
66,Bergstraat 71,2022-07-09,05:00:00,8,4,4,FMN GV 11 Ramsel
66,Bergstraat 71,2022-07-09,06:00:00,14,4,10,FMN GV 11 Ramsel
66,Bergstraat 71,2022-07-09,07:00:00,34,18,16,FMN GV 11 Ramsel
66,Bergstraat 71,2022-07-09,08:00:00,52,16,36,FMN GV 11 Ramsel
66,Bergstraat 71,2022-07-09,09:00:00,94,30,64,FMN GV 11 Ramsel
66,Bergstraat 71,2022-07-09,10:00:00,138,64,74,FMN GV 11 Ramsel
66,Bergstraat 71,2022-07-09,11:00:00,142,80,62,FMN GV 11 Ramsel
66,Bergstraat 71,2022-07-09,12:00:00,176,72,104,FMN GV 11 Ramsel
66,Bergstraat 71,2022-07-09,13:00:00,254,58,196,FMN GV 11 Ramsel
66,Bergstraat 71,2022-07-09,14:00:00,278,106,172,FMN GV 11 Ramsel
66,Bergstraat 71,2022-07-09,15:00:00,246,128,118,FMN GV 11 Ramsel
66,Bergstraat 71,2022-07-09,16:00:00,198,122,76,FMN GV 11 Ramsel
66,Bergstraat 71,2022-07-09,17:00:00,146,114,32,FMN GV 11 Ramsel
66,Bergstraat 71,2022-07-09,18:00:00,126,74,52,FMN GV 11 Ramsel
66,Bergstraat 71,2022-07-09,19:00:00,90,46,44,FMN GV 11 Ramsel
66,Bergstraat 71,2022-07-09,20:00:00,50,24,26,FMN GV 11 Ramsel
66,Bergstraat 71,2022-07-09,21:00:00,62,44,18,FMN GV 11 Ramsel
66,Bergstraat 71,2022-07-09,22:00:00,10,4,6,FMN GV 11 Ramsel
66,Bergstraat 71,2022-07-09,23:00:00,6,2,4,FMN GV 11 Ramsel
66,Bergstraat 71,2022-07-10,00:00:00,2,2,0,FMN GV 11 Ramsel
66,Bergstraat 71,2022-07-10,01:00:00,10,6,4,FMN GV 11 Ramsel
66,Bergstraat 71,2022-07-10,02:00:00,8,6,2,FMN GV 11 Ramsel
66,Bergstraat 71,2022-07-10,03:00:00,6,6,0,FMN GV 11 Ramsel
66,Bergstraat 71,2022-07-10,04:00:00,2,2,0,FMN GV 11 Ramsel
66,Bergstraat 71,2022-07-10,05:00:00,6,4,2,FMN GV 11 Ramsel
66,Bergstraat 71,2022-07-10,06:00:00,12,2,10,FMN GV 11 Ramsel
66,Bergstraat 71,2022-07-10,07:00:00,18,8,10,FMN GV 11 Ramsel
66,Bergstraat 71,2022-07-10,08:00:00,88,24,64,FMN GV 11 Ramsel
66,Bergstraat 71,2022-07-10,09:00:00,126,56,70,FMN GV 11 Ramsel
66,Bergstraat 71,2022-07-10,10:00:00,162,78,84,FMN GV 11 Ramsel
66,Bergstraat 71,2022-07-10,11:00:00,212,114,98,FMN GV 11 Ramsel
66,Bergstraat 71,2022-07-10,12:00:00,220,112,108,FMN GV 11 Ramsel
66,Bergstraat 71,2022-07-10,13:00:00,166,98,68,FMN GV 11 Ramsel
66,Bergstraat 71,2022-07-10,14:00:00,336,104,232,FMN GV 11 Ramsel
66,Bergstraat 71,2022-07-10,15:00:00,324,184,140,FMN GV 11 Ramsel
66,Bergstraat 71,2022-07-10,16:00:00,242,162,80,FMN GV 11 Ramsel
66,Bergstraat 71,2022-07-10,17:00:00,118,66,52,FMN GV 11 Ramsel
66,Bergstraat 71,2022-07-10,18:00:00,90,54,36,FMN GV 11 Ramsel
66,Bergstraat 71,2022-07-10,19:00:00,86,52,34,FMN GV 11 Ramsel
66,Bergstraat 71,2022-07-10,20:00:00,92,38,54,FMN GV 11 Ramsel
66,Bergstraat 71,2022-07-10,21:00:00,52,34,18,FMN GV 11 Ramsel
66,Bergstraat 71,2022-07-10,22:00:00,16,6,10,FMN GV 11 Ramsel
66,Bergstraat 71,2022-07-10,23:00:00,12,12,0,FMN GV 11 Ramsel
66,Bergstraat 71,2022-07-11,00:00:00,12,12,0,FMN GV 11 Ramsel
66,Bergstraat 71,2022-07-11,01:00:00,10,8,2,FMN GV 11 Ramsel
66,Bergstraat 71,2022-07-11,02:00:00,4,4,0,FMN GV 11 Ramsel
66,Bergstraat 71,2022-07-11,03:00:00,10,8,2,FMN GV 11 Ramsel
66,Bergstraat 71,2022-07-11,04:00:00,4,2,2,FMN GV 11 Ramsel
66,Bergstraat 71,2022-07-11,05:00:00,20,8,12,FMN GV 11 Ramsel
66,Bergstraat 71,2022-07-11,06:00:00,34,12,22,FMN GV 11 Ramsel
66,Bergstraat 71,2022-07-11,07:00:00,44,22,22,FMN GV 11 Ramsel
66,Bergstraat 71,2022-07-11,08:00:00,58,22,36,FMN GV 11 Ramsel
66,Bergstraat 71,2022-07-11,09:00:00,56,40,16,FMN GV 11 Ramsel
66,Bergstraat 71,2022-07-11,10:00:00,112,46,66,FMN GV 11 Ramsel
66,Bergstraat 71,2022-07-11,11:00:00,90,48,42,FMN GV 11 Ramsel
66,Bergstraat 71,2022-07-11,12:00:00,124,62,62,FMN GV 11 Ramsel
66,Bergstraat 71,2022-07-11,13:00:00,314,74,240,FMN GV 11 Ramsel
66,Bergstraat 71,2022-07-11,14:00:00,196,96,100,FMN GV 11 Ramsel
66,Bergstraat 71,2022-07-11,15:00:00,166,78,88,FMN GV 11 Ramsel
66,Bergstraat 71,2022-07-11,16:00:00,222,118,104,FMN GV 11 Ramsel
66,Bergstraat 71,2022-07-11,17:00:00,154,98,56,FMN GV 11 Ramsel
66,Bergstraat 71,2022-07-11,18:00:00,122,68,54,FMN GV 11 Ramsel
66,Bergstraat 71,2022-07-11,19:00:00,108,50,58,FMN GV 11 Ramsel
66,Bergstraat 71,2022-07-11,20:00:00,84,44,40,FMN GV 11 Ramsel
66,Bergstraat 71,2022-07-11,21:00:00,60,34,26,FMN GV 11 Ramsel
66,Bergstraat 71,2022-07-11,22:00:00,24,16,8,FMN GV 11 Ramsel
66,Bergstraat 71,2022-07-11,23:00:00,10,6,4,FMN GV 11 Ramsel
66,Bergstraat 71,2022-07-12,00:00:00,6,4,2,FMN GV 11 Ramsel
66,Bergstraat 71,2022-07-12,01:00:00,0,0,0,FMN GV 11 Ramsel
66,Bergstraat 71,2022-07-12,02:00:00,4,4,0,FMN GV 11 Ramsel
66,Bergstraat 71,2022-07-12,03:00:00,0,0,0,FMN GV 11 Ramsel
66,Bergstraat 71,2022-07-12,04:00:00,4,2,2,FMN GV 11 Ramsel
66,Bergstraat 71,2022-07-12,05:00:00,20,8,12,FMN GV 11 Ramsel
66,Bergstraat 71,2022-07-12,06:00:00,50,22,28,FMN GV 11 Ramsel
66,Bergstraat 71,2022-07-12,07:00:00,68,26,42,FMN GV 11 Ramsel
66,Bergstraat 71,2022-07-12,08:00:00,86,26,60,FMN GV 11 Ramsel
66,Bergstraat 71,2022-07-12,09:00:00,106,54,52,FMN GV 11 Ramsel
66,Bergstraat 71,2022-07-12,10:00:00,124,48,76,FMN GV 11 Ramsel
66,Bergstraat 71,2022-07-12,11:00:00,92,34,58,FMN GV 11 Ramsel
66,Bergstraat 71,2022-07-12,12:00:00,116,60,56,FMN GV 11 Ramsel
66,Bergstraat 71,2022-07-12,13:00:00,250,132,118,FMN GV 11 Ramsel
66,Bergstraat 71,2022-07-12,14:00:00,258,122,136,FMN GV 11 Ramsel
66,Bergstraat 71,2022-07-12,15:00:00,198,114,84,FMN GV 11 Ramsel
66,Bergstraat 71,2022-07-12,16:00:00,266,152,114,FMN GV 11 Ramsel
66,Bergstraat 71,2022-07-12,17:00:00,196,88,108,FMN GV 11 Ramsel
66,Bergstraat 71,2022-07-12,18:00:00,166,90,76,FMN GV 11 Ramsel
66,Bergstraat 71,2022-07-12,19:00:00,182,104,78,FMN GV 11 Ramsel
66,Bergstraat 71,2022-07-12,20:00:00,100,46,54,FMN GV 11 Ramsel
66,Bergstraat 71,2022-07-12,21:00:00,50,24,26,FMN GV 11 Ramsel
66,Bergstraat 71,2022-07-12,22:00:00,32,24,8,FMN GV 11 Ramsel
66,Bergstraat 71,2022-07-12,23:00:00,16,14,2,FMN GV 11 Ramsel
66,Bergstraat 71,2022-07-13,00:00:00,6,4,2,FMN GV 11 Ramsel
66,Bergstraat 71,2022-07-13,01:00:00,6,4,2,FMN GV 11 Ramsel
66,Bergstraat 71,2022-07-13,02:00:00,4,4,0,FMN GV 11 Ramsel
66,Bergstraat 71,2022-07-13,03:00:00,2,0,2,FMN GV 11 Ramsel
66,Bergstraat 71,2022-07-13,04:00:00,6,4,2,FMN GV 11 Ramsel
66,Bergstraat 71,2022-07-13,05:00:00,16,6,10,FMN GV 11 Ramsel
66,Bergstraat 71,2022-07-13,06:00:00,56,32,24,FMN GV 11 Ramsel
66,Bergstraat 71,2022-07-13,07:00:00,50,18,32,FMN GV 11 Ramsel
66,Bergstraat 71,2022-07-13,08:00:00,54,22,32,FMN GV 11 Ramsel
66,Bergstraat 71,2022-07-13,09:00:00,82,32,50,FMN GV 11 Ramsel
66,Bergstraat 71,2022-07-13,10:00:00,124,40,84,FMN GV 11 Ramsel
66,Bergstraat 71,2022-07-13,11:00:00,132,60,72,FMN GV 11 Ramsel
66,Bergstraat 71,2022-07-13,12:00:00,138,48,90,FMN GV 11 Ramsel
66,Bergstraat 71,2022-07-13,13:00:00,186,100,86,FMN GV 11 Ramsel
66,Bergstraat 71,2022-07-13,14:00:00,220,96,124,FMN GV 11 Ramsel
66,Bergstraat 71,2022-07-13,15:00:00,196,114,82,FMN GV 11 Ramsel
66,Bergstraat 71,2022-07-13,16:00:00,172,82,90,FMN GV 11 Ramsel
66,Bergstraat 71,2022-07-13,17:00:00,178,112,66,FMN GV 11 Ramsel
66,Bergstraat 71,2022-07-13,18:00:00,156,88,68,FMN GV 11 Ramsel
66,Bergstraat 71,2022-07-13,19:00:00,126,76,50,FMN GV 11 Ramsel
66,Bergstraat 71,2022-07-13,20:00:00,78,40,38,FMN GV 11 Ramsel
66,Bergstraat 71,2022-07-13,21:00:00,46,16,30,FMN GV 11 Ramsel
66,Bergstraat 71,2022-07-13,22:00:00,30,14,16,FMN GV 11 Ramsel
66,Bergstraat 71,2022-07-13,23:00:00,20,14,6,FMN GV 11 Ramsel
66,Bergstraat 71,2022-07-14,00:00:00,2,2,0,FMN GV 11 Ramsel
66,Bergstraat 71,2022-07-14,01:00:00,2,2,0,FMN GV 11 Ramsel
66,Bergstraat 71,2022-07-14,02:00:00,0,0,0,FMN GV 11 Ramsel
66,Bergstraat 71,2022-07-14,03:00:00,6,6,0,FMN GV 11 Ramsel
66,Bergstraat 71,2022-07-14,04:00:00,4,4,0,FMN GV 11 Ramsel
66,Bergstraat 71,2022-07-14,05:00:00,20,6,14,FMN GV 11 Ramsel
66,Bergstraat 71,2022-07-14,06:00:00,54,18,36,FMN GV 11 Ramsel
66,Bergstraat 71,2022-07-14,07:00:00,66,30,36,FMN GV 11 Ramsel
66,Bergstraat 71,2022-07-14,08:00:00,64,24,40,FMN GV 11 Ramsel
66,Bergstraat 71,2022-07-14,09:00:00,122,54,68,FMN GV 11 Ramsel
66,Bergstraat 71,2022-07-14,10:00:00,174,64,110,FMN GV 11 Ramsel
66,Bergstraat 71,2022-07-14,11:00:00,198,78,120,FMN GV 11 Ramsel
66,Bergstraat 71,2022-07-14,12:00:00,166,92,74,FMN GV 11 Ramsel
66,Bergstraat 71,2022-07-14,13:00:00,146,80,66,FMN GV 11 Ramsel
66,Bergstraat 71,2022-07-14,14:00:00,212,92,120,FMN GV 11 Ramsel
66,Bergstraat 71,2022-07-14,15:00:00,176,94,82,FMN GV 11 Ramsel
66,Bergstraat 71,2022-07-14,16:00:00,184,108,76,FMN GV 11 Ramsel
66,Bergstraat 71,2022-07-14,17:00:00,134,84,50,FMN GV 11 Ramsel
66,Bergstraat 71,2022-07-14,18:00:00,106,56,50,FMN GV 11 Ramsel
66,Bergstraat 71,2022-07-14,19:00:00,96,54,42,FMN GV 11 Ramsel
66,Bergstraat 71,2022-07-14,20:00:00,116,64,52,FMN GV 11 Ramsel
66,Bergstraat 71,2022-07-14,21:00:00,74,46,28,FMN GV 11 Ramsel
66,Bergstraat 71,2022-07-14,22:00:00,34,30,4,FMN GV 11 Ramsel
66,Bergstraat 71,2022-07-14,23:00:00,16,10,6,FMN GV 11 Ramsel
66,Bergstraat 71,2022-07-15,00:00:00,10,10,0,FMN GV 11 Ramsel
66,Bergstraat 71,2022-07-15,01:00:00,0,0,0,FMN GV 11 Ramsel
66,Bergstraat 71,2022-07-15,02:00:00,2,0,2,FMN GV 11 Ramsel
66,Bergstraat 71,2022-07-15,03:00:00,0,0,0,FMN GV 11 Ramsel
66,Bergstraat 71,2022-07-15,04:00:00,8,4,4,FMN GV 11 Ramsel
66,Bergstraat 71,2022-07-15,05:00:00,18,8,10,FMN GV 11 Ramsel
66,Bergstraat 71,2022-07-15,06:00:00,30,6,24,FMN GV 11 Ramsel
66,Bergstraat 71,2022-07-15,07:00:00,56,24,32,FMN GV 11 Ramsel
66,Bergstraat 71,2022-07-15,08:00:00,54,10,44,FMN GV 11 Ramsel
66,Bergstraat 71,2022-07-15,09:00:00,104,38,66,FMN GV 11 Ramsel
66,Bergstraat 71,2022-07-15,10:00:00,136,42,94,FMN GV 11 Ramsel
66,Bergstraat 71,2022-07-15,11:00:00,110,72,38,FMN GV 11 Ramsel
66,Bergstraat 71,2022-07-15,12:00:00,112,64,48,FMN GV 11 Ramsel
66,Bergstraat 71,2022-07-15,13:00:00,210,100,110,FMN GV 11 Ramsel
66,Bergstraat 71,2022-07-15,14:00:00,228,100,128,FMN GV 11 Ramsel
66,Bergstraat 71,2022-07-15,15:00:00,200,66,134,FMN GV 11 Ramsel
66,Bergstraat 71,2022-07-15,16:00:00,194,104,90,FMN GV 11 Ramsel
66,Bergstraat 71,2022-07-15,17:00:00,168,102,66,FMN GV 11 Ramsel
66,Bergstraat 71,2022-07-15,18:00:00,100,54,46,FMN GV 11 Ramsel
66,Bergstraat 71,2022-07-15,19:00:00,112,74,38,FMN GV 11 Ramsel
66,Bergstraat 71,2022-07-15,20:00:00,78,24,54,FMN GV 11 Ramsel
66,Bergstraat 71,2022-07-15,21:00:00,38,18,20,FMN GV 11 Ramsel
66,Bergstraat 71,2022-07-15,22:00:00,12,6,6,FMN GV 11 Ramsel
66,Bergstraat 71,2022-07-15,23:00:00,20,20,0,FMN GV 11 Ramsel
66,Bergstraat 71,2022-07-16,00:00:00,10,10,0,FMN GV 11 Ramsel
66,Bergstraat 71,2022-07-16,01:00:00,10,8,2,FMN GV 11 Ramsel
66,Bergstraat 71,2022-07-16,02:00:00,0,0,0,FMN GV 11 Ramsel
66,Bergstraat 71,2022-07-16,03:00:00,2,2,0,FMN GV 11 Ramsel
66,Bergstraat 71,2022-07-16,04:00:00,2,0,2,FMN GV 11 Ramsel
66,Bergstraat 71,2022-07-16,05:00:00,4,0,4,FMN GV 11 Ramsel
66,Bergstraat 71,2022-07-16,06:00:00,6,4,2,FMN GV 11 Ramsel
66,Bergstraat 71,2022-07-16,07:00:00,28,16,12,FMN GV 11 Ramsel
66,Bergstraat 71,2022-07-16,08:00:00,40,14,26,FMN GV 11 Ramsel
66,Bergstraat 71,2022-07-16,09:00:00,126,52,74,FMN GV 11 Ramsel
66,Bergstraat 71,2022-07-16,10:00:00,178,118,60,FMN GV 11 Ramsel
66,Bergstraat 71,2022-07-16,11:00:00,216,108,108,FMN GV 11 Ramsel
66,Bergstraat 71,2022-07-16,12:00:00,206,94,112,FMN GV 11 Ramsel
66,Bergstraat 71,2022-07-16,13:00:00,222,98,124,FMN GV 11 Ramsel
66,Bergstraat 71,2022-07-16,14:00:00,298,156,142,FMN GV 11 Ramsel
66,Bergstraat 71,2022-07-16,15:00:00,304,166,138,FMN GV 11 Ramsel
66,Bergstraat 71,2022-07-16,16:00:00,252,158,94,FMN GV 11 Ramsel
66,Bergstraat 71,2022-07-16,17:00:00,144,62,82,FMN GV 11 Ramsel
66,Bergstraat 71,2022-07-16,18:00:00,112,52,60,FMN GV 11 Ramsel
66,Bergstraat 71,2022-07-16,19:00:00,128,76,52,FMN GV 11 Ramsel
66,Bergstraat 71,2022-07-16,20:00:00,62,24,38,FMN GV 11 Ramsel
66,Bergstraat 71,2022-07-16,21:00:00,90,62,28,FMN GV 11 Ramsel
66,Bergstraat 71,2022-07-16,22:00:00,18,12,6,FMN GV 11 Ramsel
66,Bergstraat 71,2022-07-16,23:00:00,6,4,2,FMN GV 11 Ramsel
66,Bergstraat 71,2022-07-17,00:00:00,8,6,2,FMN GV 11 Ramsel
66,Bergstraat 71,2022-07-17,01:00:00,4,0,4,FMN GV 11 Ramsel
66,Bergstraat 71,2022-07-17,02:00:00,8,8,0,FMN GV 11 Ramsel
66,Bergstraat 71,2022-07-17,03:00:00,4,4,0,FMN GV 11 Ramsel
66,Bergstraat 71,2022-07-17,04:00:00,0,0,0,FMN GV 11 Ramsel
66,Bergstraat 71,2022-07-17,05:00:00,2,0,2,FMN GV 11 Ramsel
66,Bergstraat 71,2022-07-17,06:00:00,6,4,2,FMN GV 11 Ramsel
66,Bergstraat 71,2022-07-17,07:00:00,40,14,26,FMN GV 11 Ramsel
66,Bergstraat 71,2022-07-17,08:00:00,76,36,40,FMN GV 11 Ramsel
66,Bergstraat 71,2022-07-17,09:00:00,250,112,138,FMN GV 11 Ramsel
66,Bergstraat 71,2022-07-17,10:00:00,280,104,176,FMN GV 11 Ramsel
66,Bergstraat 71,2022-07-17,11:00:00,322,164,158,FMN GV 11 Ramsel
66,Bergstraat 71,2022-07-17,12:00:00,240,96,144,FMN GV 11 Ramsel
66,Bergstraat 71,2022-07-17,13:00:00,284,156,128,FMN GV 11 Ramsel
66,Bergstraat 71,2022-07-17,14:00:00,402,172,230,FMN GV 11 Ramsel
66,Bergstraat 71,2022-07-17,15:00:00,388,208,180,FMN GV 11 Ramsel
66,Bergstraat 71,2022-07-17,16:00:00,264,134,130,FMN GV 11 Ramsel
66,Bergstraat 71,2022-07-17,17:00:00,192,110,82,FMN GV 11 Ramsel
66,Bergstraat 71,2022-07-17,18:00:00,134,74,60,FMN GV 11 Ramsel
66,Bergstraat 71,2022-07-17,19:00:00,144,66,78,FMN GV 11 Ramsel
66,Bergstraat 71,2022-07-17,20:00:00,126,56,70,FMN GV 11 Ramsel
66,Bergstraat 71,2022-07-17,21:00:00,64,40,24,FMN GV 11 Ramsel
66,Bergstraat 71,2022-07-17,22:00:00,40,20,20,FMN GV 11 Ramsel
66,Bergstraat 71,2022-07-17,23:00:00,18,12,6,FMN GV 11 Ramsel
66,Bergstraat 71,2022-07-18,00:00:00,2,2,0,FMN GV 11 Ramsel
66,Bergstraat 71,2022-07-18,01:00:00,0,0,0,FMN GV 11 Ramsel
66,Bergstraat 71,2022-07-18,02:00:00,2,0,2,FMN GV 11 Ramsel
66,Bergstraat 71,2022-07-18,03:00:00,0,0,0,FMN GV 11 Ramsel
66,Bergstraat 71,2022-07-18,04:00:00,4,2,2,FMN GV 11 Ramsel
66,Bergstraat 71,2022-07-18,05:00:00,18,4,14,FMN GV 11 Ramsel
66,Bergstraat 71,2022-07-18,06:00:00,30,14,16,FMN GV 11 Ramsel
66,Bergstraat 71,2022-07-18,07:00:00,66,16,50,FMN GV 11 Ramsel
66,Bergstraat 71,2022-07-18,08:00:00,86,22,64,FMN GV 11 Ramsel
66,Bergstraat 71,2022-07-18,09:00:00,116,54,62,FMN GV 11 Ramsel
66,Bergstraat 71,2022-07-18,10:00:00,128,66,62,FMN GV 11 Ramsel
66,Bergstraat 71,2022-07-18,11:00:00,152,68,84,FMN GV 11 Ramsel
66,Bergstraat 71,2022-07-18,12:00:00,90,48,42,FMN GV 11 Ramsel
66,Bergstraat 71,2022-07-18,13:00:00,120,58,62,FMN GV 11 Ramsel
66,Bergstraat 71,2022-07-18,14:00:00,120,54,66,FMN GV 11 Ramsel
66,Bergstraat 71,2022-07-18,15:00:00,88,54,34,FMN GV 11 Ramsel
66,Bergstraat 71,2022-07-18,16:00:00,92,46,46,FMN GV 11 Ramsel
66,Bergstraat 71,2022-07-18,17:00:00,116,86,30,FMN GV 11 Ramsel
66,Bergstraat 71,2022-07-18,18:00:00,72,42,30,FMN GV 11 Ramsel
66,Bergstraat 71,2022-07-18,19:00:00,80,26,54,FMN GV 11 Ramsel
66,Bergstraat 71,2022-07-18,20:00:00,90,48,42,FMN GV 11 Ramsel
66,Bergstraat 71,2022-07-18,21:00:00,48,36,12,FMN GV 11 Ramsel
66,Bergstraat 71,2022-07-18,22:00:00,58,22,36,FMN GV 11 Ramsel
66,Bergstraat 71,2022-07-18,23:00:00,16,16,0,FMN GV 11 Ramsel
66,Bergstraat 71,2022-07-19,00:00:00,2,2,0,FMN GV 11 Ramsel
66,Bergstraat 71,2022-07-19,01:00:00,2,2,0,FMN GV 11 Ramsel
66,Bergstraat 71,2022-07-19,02:00:00,0,0,0,FMN GV 11 Ramsel
66,Bergstraat 71,2022-07-19,03:00:00,2,0,2,FMN GV 11 Ramsel
66,Bergstraat 71,2022-07-19,04:00:00,4,2,2,FMN GV 11 Ramsel
66,Bergstraat 71,2022-07-19,05:00:00,26,14,12,FMN GV 11 Ramsel
66,Bergstraat 71,2022-07-19,06:00:00,46,18,28,FMN GV 11 Ramsel
66,Bergstraat 71,2022-07-19,07:00:00,96,28,68,FMN GV 11 Ramsel
66,Bergstraat 71,2022-07-19,08:00:00,102,32,70,FMN GV 11 Ramsel
66,Bergstraat 71,2022-07-19,09:00:00,118,54,64,FMN GV 11 Ramsel
66,Bergstraat 71,2022-07-19,10:00:00,134,68,66,FMN GV 11 Ramsel
66,Bergstraat 71,2022-07-19,11:00:00,134,74,60,FMN GV 11 Ramsel
66,Bergstraat 71,2022-07-19,12:00:00,48,26,22,FMN GV 11 Ramsel
66,Bergstraat 71,2022-07-19,13:00:00,50,26,24,FMN GV 11 Ramsel
66,Bergstraat 71,2022-07-19,14:00:00,82,36,46,FMN GV 11 Ramsel
66,Bergstraat 71,2022-07-19,15:00:00,56,36,20,FMN GV 11 Ramsel
66,Bergstraat 71,2022-07-19,16:00:00,64,34,30,FMN GV 11 Ramsel
66,Bergstraat 71,2022-07-19,17:00:00,72,60,12,FMN GV 11 Ramsel
66,Bergstraat 71,2022-07-19,18:00:00,56,34,22,FMN GV 11 Ramsel
66,Bergstraat 71,2022-07-19,19:00:00,58,28,30,FMN GV 11 Ramsel
66,Bergstraat 71,2022-07-19,20:00:00,56,32,24,FMN GV 11 Ramsel
66,Bergstraat 71,2022-07-19,21:00:00,60,30,30,FMN GV 11 Ramsel
66,Bergstraat 71,2022-07-19,22:00:00,44,24,20,FMN GV 11 Ramsel
66,Bergstraat 71,2022-07-19,23:00:00,16,10,6,FMN GV 11 Ramsel
66,Bergstraat 71,2022-07-20,00:00:00,14,12,2,FMN GV 11 Ramsel
66,Bergstraat 71,2022-07-20,01:00:00,0,0,0,FMN GV 11 Ramsel
66,Bergstraat 71,2022-07-20,02:00:00,0,0,0,FMN GV 11 Ramsel
66,Bergstraat 71,2022-07-20,03:00:00,0,0,0,FMN GV 11 Ramsel
66,Bergstraat 71,2022-07-20,04:00:00,2,2,0,FMN GV 11 Ramsel
66,Bergstraat 71,2022-07-20,05:00:00,16,12,4,FMN GV 11 Ramsel
66,Bergstraat 71,2022-07-20,06:00:00,22,8,14,FMN GV 11 Ramsel
66,Bergstraat 71,2022-07-20,07:00:00,56,20,36,FMN GV 11 Ramsel
66,Bergstraat 71,2022-07-20,08:00:00,60,20,40,FMN GV 11 Ramsel
66,Bergstraat 71,2022-07-20,09:00:00,72,48,24,FMN GV 11 Ramsel
66,Bergstraat 71,2022-07-20,10:00:00,150,80,70,FMN GV 11 Ramsel
66,Bergstraat 71,2022-07-20,11:00:00,110,48,62,FMN GV 11 Ramsel
66,Bergstraat 71,2022-07-20,12:00:00,158,66,92,FMN GV 11 Ramsel
66,Bergstraat 71,2022-07-20,13:00:00,60,28,32,FMN GV 11 Ramsel
66,Bergstraat 71,2022-07-20,14:00:00,138,74,64,FMN GV 11 Ramsel
66,Bergstraat 71,2022-07-20,15:00:00,126,72,54,FMN GV 11 Ramsel
66,Bergstraat 71,2022-07-20,16:00:00,86,40,46,FMN GV 11 Ramsel
66,Bergstraat 71,2022-07-20,17:00:00,92,48,44,FMN GV 11 Ramsel
66,Bergstraat 71,2022-07-20,18:00:00,88,46,42,FMN GV 11 Ramsel
66,Bergstraat 71,2022-07-20,19:00:00,56,24,32,FMN GV 11 Ramsel
66,Bergstraat 71,2022-07-20,20:00:00,42,14,28,FMN GV 11 Ramsel
66,Bergstraat 71,2022-07-20,21:00:00,14,10,4,FMN GV 11 Ramsel
66,Bergstraat 71,2022-07-20,22:00:00,14,12,2,FMN GV 11 Ramsel
66,Bergstraat 71,2022-07-20,23:00:00,10,2,8,FMN GV 11 Ramsel
66,Bergstraat 71,2022-07-21,00:00:00,16,10,6,FMN GV 11 Ramsel
66,Bergstraat 71,2022-07-21,01:00:00,6,6,0,FMN GV 11 Ramsel
66,Bergstraat 71,2022-07-21,02:00:00,0,0,0,FMN GV 11 Ramsel
66,Bergstraat 71,2022-07-21,03:00:00,4,4,0,FMN GV 11 Ramsel
66,Bergstraat 71,2022-07-21,04:00:00,2,2,0,FMN GV 11 Ramsel
66,Bergstraat 71,2022-07-21,05:00:00,2,2,0,FMN GV 11 Ramsel
66,Bergstraat 71,2022-07-21,06:00:00,6,0,6,FMN GV 11 Ramsel
66,Bergstraat 71,2022-07-21,07:00:00,18,6,12,FMN GV 11 Ramsel
66,Bergstraat 71,2022-07-21,08:00:00,14,6,8,FMN GV 11 Ramsel
66,Bergstraat 71,2022-07-21,09:00:00,56,14,42,FMN GV 11 Ramsel
66,Bergstraat 71,2022-07-21,10:00:00,52,4,48,FMN GV 11 Ramsel
66,Bergstraat 71,2022-07-21,11:00:00,58,46,12,FMN GV 11 Ramsel
66,Bergstraat 71,2022-07-21,12:00:00,46,12,34,FMN GV 11 Ramsel
66,Bergstraat 71,2022-07-21,13:00:00,250,202,48,FMN GV 11 Ramsel
66,Bergstraat 71,2022-07-21,14:00:00,184,136,48,FMN GV 11 Ramsel
66,Bergstraat 71,2022-07-21,15:00:00,64,48,16,FMN GV 11 Ramsel
66,Bergstraat 71,2022-07-21,16:00:00,68,38,30,FMN GV 11 Ramsel
66,Bergstraat 71,2022-07-21,17:00:00,48,32,16,FMN GV 11 Ramsel
66,Bergstraat 71,2022-07-21,18:00:00,78,24,54,FMN GV 11 Ramsel
66,Bergstraat 71,2022-07-21,19:00:00,56,24,32,FMN GV 11 Ramsel
66,Bergstraat 71,2022-07-21,20:00:00,42,26,16,FMN GV 11 Ramsel
66,Bergstraat 71,2022-07-21,21:00:00,24,12,12,FMN GV 11 Ramsel
66,Bergstraat 71,2022-07-21,22:00:00,10,8,2,FMN GV 11 Ramsel
66,Bergstraat 71,2022-07-21,23:00:00,2,2,0,FMN GV 11 Ramsel
66,Bergstraat 71,2022-07-22,00:00:00,4,2,2,FMN GV 11 Ramsel
66,Bergstraat 71,2022-07-22,01:00:00,6,0,6,FMN GV 11 Ramsel
66,Bergstraat 71,2022-07-22,02:00:00,0,0,0,FMN GV 11 Ramsel
66,Bergstraat 71,2022-07-22,03:00:00,2,0,2,FMN GV 11 Ramsel
66,Bergstraat 71,2022-07-22,04:00:00,4,0,4,FMN GV 11 Ramsel
66,Bergstraat 71,2022-07-22,05:00:00,10,6,4,FMN GV 11 Ramsel
66,Bergstraat 71,2022-07-22,06:00:00,16,8,8,FMN GV 11 Ramsel
66,Bergstraat 71,2022-07-22,07:00:00,22,4,18,FMN GV 11 Ramsel
66,Bergstraat 71,2022-07-22,08:00:00,48,18,30,FMN GV 11 Ramsel
66,Bergstraat 71,2022-07-22,09:00:00,74,16,58,FMN GV 11 Ramsel
66,Bergstraat 71,2022-07-22,10:00:00,104,54,50,FMN GV 11 Ramsel
66,Bergstraat 71,2022-07-22,11:00:00,138,60,78,FMN GV 11 Ramsel
66,Bergstraat 71,2022-07-22,12:00:00,164,70,94,FMN GV 11 Ramsel
66,Bergstraat 71,2022-07-22,13:00:00,240,116,124,FMN GV 11 Ramsel
66,Bergstraat 71,2022-07-22,14:00:00,242,136,106,FMN GV 11 Ramsel
66,Bergstraat 71,2022-07-22,15:00:00,216,90,126,FMN GV 11 Ramsel
66,Bergstraat 71,2022-07-22,16:00:00,188,86,102,FMN GV 11 Ramsel
66,Bergstraat 71,2022-07-22,17:00:00,160,92,68,FMN GV 11 Ramsel
66,Bergstraat 71,2022-07-22,18:00:00,100,48,52,FMN GV 11 Ramsel
66,Bergstraat 71,2022-07-22,19:00:00,52,22,30,FMN GV 11 Ramsel
66,Bergstraat 71,2022-07-22,20:00:00,56,32,24,FMN GV 11 Ramsel
66,Bergstraat 71,2022-07-22,21:00:00,18,10,8,FMN GV 11 Ramsel
66,Bergstraat 71,2022-07-22,22:00:00,8,6,2,FMN GV 11 Ramsel
66,Bergstraat 71,2022-07-22,23:00:00,4,4,0,FMN GV 11 Ramsel
66,Bergstraat 71,2022-07-23,00:00:00,6,6,0,FMN GV 11 Ramsel
66,Bergstraat 71,2022-07-23,01:00:00,4,2,2,FMN GV 11 Ramsel
66,Bergstraat 71,2022-07-23,02:00:00,10,8,2,FMN GV 11 Ramsel
66,Bergstraat 71,2022-07-23,03:00:00,2,0,2,FMN GV 11 Ramsel
66,Bergstraat 71,2022-07-23,04:00:00,0,0,0,FMN GV 11 Ramsel
66,Bergstraat 71,2022-07-23,05:00:00,0,0,0,FMN GV 11 Ramsel
66,Bergstraat 71,2022-07-23,06:00:00,4,2,2,FMN GV 11 Ramsel
66,Bergstraat 71,2022-07-23,07:00:00,10,2,8,FMN GV 11 Ramsel
66,Bergstraat 71,2022-07-23,08:00:00,46,26,20,FMN GV 11 Ramsel
66,Bergstraat 71,2022-07-23,09:00:00,112,44,68,FMN GV 11 Ramsel
66,Bergstraat 71,2022-07-23,10:00:00,168,114,54,FMN GV 11 Ramsel
66,Bergstraat 71,2022-07-23,11:00:00,118,68,50,FMN GV 11 Ramsel
66,Bergstraat 71,2022-07-23,12:00:00,198,70,128,FMN GV 11 Ramsel
66,Bergstraat 71,2022-07-23,13:00:00,312,142,170,FMN GV 11 Ramsel
66,Bergstraat 71,2022-07-23,14:00:00,284,124,160,FMN GV 11 Ramsel
66,Bergstraat 71,2022-07-23,15:00:00,274,150,124,FMN GV 11 Ramsel
66,Bergstraat 71,2022-07-23,16:00:00,258,144,114,FMN GV 11 Ramsel
66,Bergstraat 71,2022-07-23,17:00:00,188,114,74,FMN GV 11 Ramsel
66,Bergstraat 71,2022-07-23,18:00:00,72,38,34,FMN GV 11 Ramsel
66,Bergstraat 71,2022-07-23,19:00:00,102,44,58,FMN GV 11 Ramsel
66,Bergstraat 71,2022-07-23,20:00:00,94,46,48,FMN GV 11 Ramsel
66,Bergstraat 71,2022-07-23,21:00:00,52,30,22,FMN GV 11 Ramsel
66,Bergstraat 71,2022-07-23,22:00:00,24,10,14,FMN GV 11 Ramsel
66,Bergstraat 71,2022-07-23,23:00:00,12,8,4,FMN GV 11 Ramsel
66,Bergstraat 71,2022-07-24,00:00:00,28,6,22,FMN GV 11 Ramsel
66,Bergstraat 71,2022-07-24,01:00:00,8,8,0,FMN GV 11 Ramsel
66,Bergstraat 71,2022-07-24,02:00:00,4,0,4,FMN GV 11 Ramsel
66,Bergstraat 71,2022-07-24,03:00:00,6,6,0,FMN GV 11 Ramsel
66,Bergstraat 71,2022-07-24,04:00:00,4,4,0,FMN GV 11 Ramsel
66,Bergstraat 71,2022-07-24,05:00:00,14,8,6,FMN GV 11 Ramsel
66,Bergstraat 71,2022-07-24,06:00:00,0,0,0,FMN GV 11 Ramsel
66,Bergstraat 71,2022-07-24,07:00:00,26,8,18,FMN GV 11 Ramsel
66,Bergstraat 71,2022-07-24,08:00:00,116,44,72,FMN GV 11 Ramsel
66,Bergstraat 71,2022-07-24,09:00:00,226,72,154,FMN GV 11 Ramsel
66,Bergstraat 71,2022-07-24,10:00:00,298,136,162,FMN GV 11 Ramsel
66,Bergstraat 71,2022-07-24,11:00:00,300,194,106,FMN GV 11 Ramsel
66,Bergstraat 71,2022-07-24,12:00:00,198,110,88,FMN GV 11 Ramsel
66,Bergstraat 71,2022-07-24,13:00:00,290,150,140,FMN GV 11 Ramsel
66,Bergstraat 71,2022-07-24,14:00:00,360,166,194,FMN GV 11 Ramsel
66,Bergstraat 71,2022-07-24,15:00:00,228,110,118,FMN GV 11 Ramsel
66,Bergstraat 71,2022-07-24,16:00:00,202,90,112,FMN GV 11 Ramsel
66,Bergstraat 71,2022-07-24,17:00:00,122,50,72,FMN GV 11 Ramsel
66,Bergstraat 71,2022-07-24,18:00:00,92,40,52,FMN GV 11 Ramsel
66,Bergstraat 71,2022-07-24,19:00:00,68,38,30,FMN GV 11 Ramsel
66,Bergstraat 71,2022-07-24,20:00:00,78,34,44,FMN GV 11 Ramsel
66,Bergstraat 71,2022-07-24,21:00:00,58,36,22,FMN GV 11 Ramsel
66,Bergstraat 71,2022-07-24,22:00:00,20,12,8,FMN GV 11 Ramsel
66,Bergstraat 71,2022-07-24,23:00:00,4,0,4,FMN GV 11 Ramsel
66,Bergstraat 71,2022-07-25,00:00:00,4,4,0,FMN GV 11 Ramsel
66,Bergstraat 71,2022-07-25,01:00:00,12,6,6,FMN GV 11 Ramsel
66,Bergstraat 71,2022-07-25,02:00:00,0,0,0,FMN GV 11 Ramsel
66,Bergstraat 71,2022-07-25,03:00:00,2,0,2,FMN GV 11 Ramsel
66,Bergstraat 71,2022-07-25,04:00:00,4,2,2,FMN GV 11 Ramsel
66,Bergstraat 71,2022-07-25,05:00:00,20,8,12,FMN GV 11 Ramsel
66,Bergstraat 71,2022-07-25,06:00:00,28,16,12,FMN GV 11 Ramsel
66,Bergstraat 71,2022-07-25,07:00:00,82,20,62,FMN GV 11 Ramsel
66,Bergstraat 71,2022-07-25,08:00:00,54,22,32,FMN GV 11 Ramsel
66,Bergstraat 71,2022-07-25,09:00:00,90,32,58,FMN GV 11 Ramsel
66,Bergstraat 71,2022-07-25,10:00:00,76,32,44,FMN GV 11 Ramsel
66,Bergstraat 71,2022-07-25,11:00:00,98,46,52,FMN GV 11 Ramsel
66,Bergstraat 71,2022-07-25,12:00:00,92,60,32,FMN GV 11 Ramsel
66,Bergstraat 71,2022-07-25,13:00:00,136,62,74,FMN GV 11 Ramsel
66,Bergstraat 71,2022-07-25,14:00:00,174,72,102,FMN GV 11 Ramsel
66,Bergstraat 71,2022-07-25,15:00:00,208,96,112,FMN GV 11 Ramsel
66,Bergstraat 71,2022-07-25,16:00:00,162,96,66,FMN GV 11 Ramsel
66,Bergstraat 71,2022-07-25,17:00:00,144,72,72,FMN GV 11 Ramsel
66,Bergstraat 71,2022-07-25,18:00:00,92,46,46,FMN GV 11 Ramsel
66,Bergstraat 71,2022-07-25,19:00:00,112,62,50,FMN GV 11 Ramsel
66,Bergstraat 71,2022-07-25,20:00:00,54,34,20,FMN GV 11 Ramsel
66,Bergstraat 71,2022-07-25,21:00:00,48,28,20,FMN GV 11 Ramsel
66,Bergstraat 71,2022-07-25,22:00:00,38,22,16,FMN GV 11 Ramsel
66,Bergstraat 71,2022-07-25,23:00:00,26,12,14,FMN GV 11 Ramsel
66,Bergstraat 71,2022-07-26,00:00:00,8,6,2,FMN GV 11 Ramsel
66,Bergstraat 71,2022-07-26,01:00:00,2,2,0,FMN GV 11 Ramsel
66,Bergstraat 71,2022-07-26,02:00:00,6,6,0,FMN GV 11 Ramsel
66,Bergstraat 71,2022-07-26,03:00:00,0,0,0,FMN GV 11 Ramsel
66,Bergstraat 71,2022-07-26,04:00:00,6,2,4,FMN GV 11 Ramsel
66,Bergstraat 71,2022-07-26,05:00:00,20,10,10,FMN GV 11 Ramsel
66,Bergstraat 71,2022-07-26,06:00:00,40,14,26,FMN GV 11 Ramsel
66,Bergstraat 71,2022-07-26,07:00:00,70,20,50,FMN GV 11 Ramsel
66,Bergstraat 71,2022-07-26,08:00:00,64,20,44,FMN GV 11 Ramsel
66,Bergstraat 71,2022-07-26,09:00:00,68,30,38,FMN GV 11 Ramsel
66,Bergstraat 71,2022-07-26,10:00:00,84,26,58,FMN GV 11 Ramsel
66,Bergstraat 71,2022-07-26,11:00:00,88,42,46,FMN GV 11 Ramsel
66,Bergstraat 71,2022-07-26,12:00:00,114,50,64,FMN GV 11 Ramsel
66,Bergstraat 71,2022-07-26,13:00:00,186,90,96,FMN GV 11 Ramsel
66,Bergstraat 71,2022-07-26,14:00:00,146,88,58,FMN GV 11 Ramsel
66,Bergstraat 71,2022-07-26,15:00:00,114,56,58,FMN GV 11 Ramsel
66,Bergstraat 71,2022-07-26,16:00:00,132,84,48,FMN GV 11 Ramsel
66,Bergstraat 71,2022-07-26,17:00:00,168,74,94,FMN GV 11 Ramsel
66,Bergstraat 71,2022-07-26,18:00:00,84,46,38,FMN GV 11 Ramsel
66,Bergstraat 71,2022-07-26,19:00:00,88,50,38,FMN GV 11 Ramsel
66,Bergstraat 71,2022-07-26,20:00:00,46,20,26,FMN GV 11 Ramsel
66,Bergstraat 71,2022-07-26,21:00:00,36,22,14,FMN GV 11 Ramsel
66,Bergstraat 71,2022-07-26,22:00:00,24,10,14,FMN GV 11 Ramsel
66,Bergstraat 71,2022-07-26,23:00:00,8,8,0,FMN GV 11 Ramsel
66,Bergstraat 71,2022-07-27,00:00:00,6,0,6,FMN GV 11 Ramsel
66,Bergstraat 71,2022-07-27,01:00:00,0,0,0,FMN GV 11 Ramsel
66,Bergstraat 71,2022-07-27,02:00:00,2,0,2,FMN GV 11 Ramsel
66,Bergstraat 71,2022-07-27,03:00:00,8,6,2,FMN GV 11 Ramsel
66,Bergstraat 71,2022-07-27,04:00:00,4,2,2,FMN GV 11 Ramsel
66,Bergstraat 71,2022-07-27,05:00:00,24,8,16,FMN GV 11 Ramsel
66,Bergstraat 71,2022-07-27,06:00:00,34,16,18,FMN GV 11 Ramsel
66,Bergstraat 71,2022-07-27,07:00:00,60,16,44,FMN GV 11 Ramsel
66,Bergstraat 71,2022-07-27,08:00:00,72,32,40,FMN GV 11 Ramsel
66,Bergstraat 71,2022-07-27,09:00:00,74,30,44,FMN GV 11 Ramsel
66,Bergstraat 71,2022-07-27,10:00:00,114,58,56,FMN GV 11 Ramsel
66,Bergstraat 71,2022-07-27,11:00:00,114,60,54,FMN GV 11 Ramsel
66,Bergstraat 71,2022-07-27,12:00:00,150,62,88,FMN GV 11 Ramsel
66,Bergstraat 71,2022-07-27,13:00:00,270,144,126,FMN GV 11 Ramsel
66,Bergstraat 71,2022-07-27,14:00:00,244,136,108,FMN GV 11 Ramsel
66,Bergstraat 71,2022-07-27,15:00:00,154,90,64,FMN GV 11 Ramsel
66,Bergstraat 71,2022-07-27,16:00:00,248,162,86,FMN GV 11 Ramsel
66,Bergstraat 71,2022-07-27,17:00:00,216,120,96,FMN GV 11 Ramsel
66,Bergstraat 71,2022-07-27,18:00:00,150,66,84,FMN GV 11 Ramsel
66,Bergstraat 71,2022-07-27,19:00:00,112,58,54,FMN GV 11 Ramsel
66,Bergstraat 71,2022-07-27,20:00:00,84,42,42,FMN GV 11 Ramsel
66,Bergstraat 71,2022-07-27,21:00:00,80,46,34,FMN GV 11 Ramsel
66,Bergstraat 71,2022-07-27,22:00:00,24,20,4,FMN GV 11 Ramsel
66,Bergstraat 71,2022-07-27,23:00:00,12,10,2,FMN GV 11 Ramsel
66,Bergstraat 71,2022-07-28,00:00:00,8,8,0,FMN GV 11 Ramsel
66,Bergstraat 71,2022-07-28,01:00:00,4,2,2,FMN GV 11 Ramsel
66,Bergstraat 71,2022-07-28,02:00:00,2,0,2,FMN GV 11 Ramsel
66,Bergstraat 71,2022-07-28,03:00:00,0,0,0,FMN GV 11 Ramsel
66,Bergstraat 71,2022-07-28,04:00:00,4,4,0,FMN GV 11 Ramsel
66,Bergstraat 71,2022-07-28,05:00:00,28,18,10,FMN GV 11 Ramsel
66,Bergstraat 71,2022-07-28,06:00:00,34,16,18,FMN GV 11 Ramsel
66,Bergstraat 71,2022-07-28,07:00:00,58,16,42,FMN GV 11 Ramsel
66,Bergstraat 71,2022-07-28,08:00:00,100,38,62,FMN GV 11 Ramsel
66,Bergstraat 71,2022-07-28,09:00:00,108,38,70,FMN GV 11 Ramsel
66,Bergstraat 71,2022-07-28,10:00:00,140,50,90,FMN GV 11 Ramsel
66,Bergstraat 71,2022-07-28,11:00:00,166,94,72,FMN GV 11 Ramsel
66,Bergstraat 71,2022-07-28,12:00:00,122,58,64,FMN GV 11 Ramsel
66,Bergstraat 71,2022-07-28,13:00:00,204,110,94,FMN GV 11 Ramsel
66,Bergstraat 71,2022-07-28,14:00:00,300,154,146,FMN GV 11 Ramsel
66,Bergstraat 71,2022-07-28,15:00:00,210,104,106,FMN GV 11 Ramsel
66,Bergstraat 71,2022-07-28,16:00:00,192,102,90,FMN GV 11 Ramsel
66,Bergstraat 71,2022-07-28,17:00:00,176,90,86,FMN GV 11 Ramsel
66,Bergstraat 71,2022-07-28,18:00:00,128,74,54,FMN GV 11 Ramsel
66,Bergstraat 71,2022-07-28,19:00:00,120,54,66,FMN GV 11 Ramsel
66,Bergstraat 71,2022-07-28,20:00:00,134,68,66,FMN GV 11 Ramsel
66,Bergstraat 71,2022-07-28,21:00:00,52,30,22,FMN GV 11 Ramsel
66,Bergstraat 71,2022-07-28,22:00:00,34,22,12,FMN GV 11 Ramsel
66,Bergstraat 71,2022-07-28,23:00:00,28,24,4,FMN GV 11 Ramsel
66,Bergstraat 71,2022-07-29,00:00:00,6,2,4,FMN GV 11 Ramsel
66,Bergstraat 71,2022-07-29,01:00:00,0,0,0,FMN GV 11 Ramsel
66,Bergstraat 71,2022-07-29,02:00:00,0,0,0,FMN GV 11 Ramsel
66,Bergstraat 71,2022-07-29,03:00:00,4,0,4,FMN GV 11 Ramsel
66,Bergstraat 71,2022-07-29,04:00:00,4,4,0,FMN GV 11 Ramsel
66,Bergstraat 71,2022-07-29,05:00:00,18,8,10,FMN GV 11 Ramsel
66,Bergstraat 71,2022-07-29,06:00:00,32,16,16,FMN GV 11 Ramsel
66,Bergstraat 71,2022-07-29,07:00:00,56,20,36,FMN GV 11 Ramsel
66,Bergstraat 71,2022-07-29,08:00:00,42,8,34,FMN GV 11 Ramsel
66,Bergstraat 71,2022-07-29,09:00:00,84,28,56,FMN GV 11 Ramsel
66,Bergstraat 71,2022-07-29,10:00:00,118,66,52,FMN GV 11 Ramsel
66,Bergstraat 71,2022-07-29,11:00:00,132,66,66,FMN GV 11 Ramsel
66,Bergstraat 71,2022-07-29,12:00:00,212,82,130,FMN GV 11 Ramsel
66,Bergstraat 71,2022-07-29,13:00:00,288,140,148,FMN GV 11 Ramsel
66,Bergstraat 71,2022-07-29,14:00:00,276,130,146,FMN GV 11 Ramsel
66,Bergstraat 71,2022-07-29,15:00:00,282,144,138,FMN GV 11 Ramsel
66,Bergstraat 71,2022-07-29,16:00:00,180,92,88,FMN GV 11 Ramsel
66,Bergstraat 71,2022-07-29,17:00:00,174,110,64,FMN GV 11 Ramsel
66,Bergstraat 71,2022-07-29,18:00:00,112,58,54,FMN GV 11 Ramsel
66,Bergstraat 71,2022-07-29,19:00:00,112,56,56,FMN GV 11 Ramsel
66,Bergstraat 71,2022-07-29,20:00:00,76,30,46,FMN GV 11 Ramsel
66,Bergstraat 71,2022-07-29,21:00:00,74,36,38,FMN GV 11 Ramsel
66,Bergstraat 71,2022-07-29,22:00:00,38,22,16,FMN GV 11 Ramsel
66,Bergstraat 71,2022-07-29,23:00:00,4,4,0,FMN GV 11 Ramsel
66,Bergstraat 71,2022-07-30,00:00:00,20,20,0,FMN GV 11 Ramsel
66,Bergstraat 71,2022-07-30,01:00:00,16,14,2,FMN GV 11 Ramsel
66,Bergstraat 71,2022-07-30,02:00:00,4,2,2,FMN GV 11 Ramsel
66,Bergstraat 71,2022-07-30,03:00:00,2,0,2,FMN GV 11 Ramsel
66,Bergstraat 71,2022-07-30,04:00:00,4,4,0,FMN GV 11 Ramsel
66,Bergstraat 71,2022-07-30,05:00:00,6,4,2,FMN GV 11 Ramsel
66,Bergstraat 71,2022-07-30,06:00:00,14,4,10,FMN GV 11 Ramsel
66,Bergstraat 71,2022-07-30,07:00:00,30,14,16,FMN GV 11 Ramsel
66,Bergstraat 71,2022-07-30,08:00:00,64,20,44,FMN GV 11 Ramsel
66,Bergstraat 71,2022-07-30,09:00:00,98,40,58,FMN GV 11 Ramsel
66,Bergstraat 71,2022-07-30,10:00:00,156,86,70,FMN GV 11 Ramsel
66,Bergstraat 71,2022-07-30,11:00:00,182,86,96,FMN GV 11 Ramsel
66,Bergstraat 71,2022-07-30,12:00:00,192,82,110,FMN GV 11 Ramsel
66,Bergstraat 71,2022-07-30,13:00:00,232,100,132,FMN GV 11 Ramsel
66,Bergstraat 71,2022-07-30,14:00:00,276,136,140,FMN GV 11 Ramsel
66,Bergstraat 71,2022-07-30,15:00:00,318,174,144,FMN GV 11 Ramsel
66,Bergstraat 71,2022-07-30,16:00:00,268,160,108,FMN GV 11 Ramsel
66,Bergstraat 71,2022-07-30,17:00:00,210,140,70,FMN GV 11 Ramsel
66,Bergstraat 71,2022-07-30,18:00:00,106,66,40,FMN GV 11 Ramsel
66,Bergstraat 71,2022-07-30,19:00:00,46,24,22,FMN GV 11 Ramsel
66,Bergstraat 71,2022-07-30,20:00:00,130,76,54,FMN GV 11 Ramsel
66,Bergstraat 71,2022-07-30,21:00:00,40,28,12,FMN GV 11 Ramsel
66,Bergstraat 71,2022-07-30,22:00:00,18,16,2,FMN GV 11 Ramsel
66,Bergstraat 71,2022-07-30,23:00:00,26,10,16,FMN GV 11 Ramsel
66,Bergstraat 71,2022-07-31,00:00:00,34,4,30,FMN GV 11 Ramsel
66,Bergstraat 71,2022-07-31,01:00:00,12,2,10,FMN GV 11 Ramsel
66,Bergstraat 71,2022-07-31,02:00:00,18,4,14,FMN GV 11 Ramsel
66,Bergstraat 71,2022-07-31,03:00:00,6,2,4,FMN GV 11 Ramsel
66,Bergstraat 71,2022-07-31,04:00:00,12,4,8,FMN GV 11 Ramsel
66,Bergstraat 71,2022-07-31,05:00:00,10,8,2,FMN GV 11 Ramsel
66,Bergstraat 71,2022-07-31,06:00:00,14,8,6,FMN GV 11 Ramsel
66,Bergstraat 71,2022-07-31,07:00:00,14,4,10,FMN GV 11 Ramsel
66,Bergstraat 71,2022-07-31,08:00:00,54,22,32,FMN GV 11 Ramsel
66,Bergstraat 71,2022-07-31,09:00:00,178,66,112,FMN GV 11 Ramsel
66,Bergstraat 71,2022-07-31,10:00:00,362,160,202,FMN GV 11 Ramsel
66,Bergstraat 71,2022-07-31,11:00:00,406,242,164,FMN GV 11 Ramsel
66,Bergstraat 71,2022-07-31,12:00:00,234,126,108,FMN GV 11 Ramsel
66,Bergstraat 71,2022-07-31,13:00:00,200,82,118,FMN GV 11 Ramsel
66,Bergstraat 71,2022-07-31,14:00:00,250,98,152,FMN GV 11 Ramsel
66,Bergstraat 71,2022-07-31,15:00:00,204,82,122,FMN GV 11 Ramsel
66,Bergstraat 71,2022-07-31,16:00:00,160,114,46,FMN GV 11 Ramsel
66,Bergstraat 71,2022-07-31,17:00:00,132,102,30,FMN GV 11 Ramsel
66,Bergstraat 71,2022-07-31,18:00:00,110,48,62,FMN GV 11 Ramsel
66,Bergstraat 71,2022-07-31,19:00:00,56,38,18,FMN GV 11 Ramsel
66,Bergstraat 71,2022-07-31,20:00:00,50,26,24,FMN GV 11 Ramsel
66,Bergstraat 71,2022-07-31,21:00:00,18,10,8,FMN GV 11 Ramsel
66,Bergstraat 71,2022-07-31,22:00:00,14,14,0,FMN GV 11 Ramsel
66,Bergstraat 71,2022-07-31,23:00:00,26,2,24,FMN GV 11 Ramsel
66,Bergstraat 71,2022-08-01,00:00:00,12,8,4,FMN GV 11 Ramsel
66,Bergstraat 71,2022-08-01,01:00:00,12,0,12,FMN GV 11 Ramsel
66,Bergstraat 71,2022-08-01,02:00:00,0,0,0,FMN GV 11 Ramsel
66,Bergstraat 71,2022-08-01,03:00:00,0,0,0,FMN GV 11 Ramsel
66,Bergstraat 71,2022-08-01,04:00:00,4,4,0,FMN GV 11 Ramsel
66,Bergstraat 71,2022-08-01,05:00:00,16,8,8,FMN GV 11 Ramsel
66,Bergstraat 71,2022-08-01,06:00:00,30,18,12,FMN GV 11 Ramsel
66,Bergstraat 71,2022-08-01,07:00:00,56,16,40,FMN GV 11 Ramsel
66,Bergstraat 71,2022-08-01,08:00:00,70,16,54,FMN GV 11 Ramsel
66,Bergstraat 71,2022-08-01,09:00:00,56,32,24,FMN GV 11 Ramsel
66,Bergstraat 71,2022-08-01,10:00:00,84,44,40,FMN GV 11 Ramsel
66,Bergstraat 71,2022-08-01,11:00:00,68,28,40,FMN GV 11 Ramsel
66,Bergstraat 71,2022-08-01,12:00:00,114,50,64,FMN GV 11 Ramsel
66,Bergstraat 71,2022-08-01,13:00:00,204,120,84,FMN GV 11 Ramsel
66,Bergstraat 71,2022-08-01,14:00:00,196,90,106,FMN GV 11 Ramsel
66,Bergstraat 71,2022-08-01,15:00:00,218,130,88,FMN GV 11 Ramsel
66,Bergstraat 71,2022-08-01,16:00:00,164,102,62,FMN GV 11 Ramsel
66,Bergstraat 71,2022-08-01,17:00:00,142,82,60,FMN GV 11 Ramsel
66,Bergstraat 71,2022-08-01,18:00:00,142,84,58,FMN GV 11 Ramsel
66,Bergstraat 71,2022-08-01,19:00:00,146,40,106,FMN GV 11 Ramsel
66,Bergstraat 71,2022-08-01,20:00:00,106,58,48,FMN GV 11 Ramsel
66,Bergstraat 71,2022-08-01,21:00:00,64,46,18,FMN GV 11 Ramsel
66,Bergstraat 71,2022-08-01,22:00:00,14,10,4,FMN GV 11 Ramsel
66,Bergstraat 71,2022-08-01,23:00:00,6,6,0,FMN GV 11 Ramsel
66,Bergstraat 71,2022-08-02,00:00:00,2,2,0,FMN GV 11 Ramsel
66,Bergstraat 71,2022-08-02,01:00:00,2,2,0,FMN GV 11 Ramsel
66,Bergstraat 71,2022-08-02,02:00:00,2,2,0,FMN GV 11 Ramsel
66,Bergstraat 71,2022-08-02,03:00:00,0,0,0,FMN GV 11 Ramsel
66,Bergstraat 71,2022-08-02,04:00:00,10,8,2,FMN GV 11 Ramsel
66,Bergstraat 71,2022-08-02,05:00:00,24,10,14,FMN GV 11 Ramsel
66,Bergstraat 71,2022-08-02,06:00:00,54,24,30,FMN GV 11 Ramsel
66,Bergstraat 71,2022-08-02,07:00:00,54,16,38,FMN GV 11 Ramsel
66,Bergstraat 71,2022-08-02,08:00:00,94,20,74,FMN GV 11 Ramsel
66,Bergstraat 71,2022-08-02,09:00:00,120,52,68,FMN GV 11 Ramsel
66,Bergstraat 71,2022-08-02,10:00:00,170,68,102,FMN GV 11 Ramsel
66,Bergstraat 71,2022-08-02,11:00:00,198,98,100,FMN GV 11 Ramsel
66,Bergstraat 71,2022-08-02,12:00:00,212,104,108,FMN GV 11 Ramsel
66,Bergstraat 71,2022-08-02,13:00:00,260,114,146,FMN GV 11 Ramsel
66,Bergstraat 71,2022-08-02,14:00:00,234,104,130,FMN GV 11 Ramsel
66,Bergstraat 71,2022-08-02,15:00:00,222,140,82,FMN GV 11 Ramsel
66,Bergstraat 71,2022-08-02,16:00:00,198,100,98,FMN GV 11 Ramsel
66,Bergstraat 71,2022-08-02,17:00:00,232,112,120,FMN GV 11 Ramsel
66,Bergstraat 71,2022-08-02,18:00:00,132,64,68,FMN GV 11 Ramsel
66,Bergstraat 71,2022-08-02,19:00:00,176,96,80,FMN GV 11 Ramsel
66,Bergstraat 71,2022-08-02,20:00:00,172,102,70,FMN GV 11 Ramsel
66,Bergstraat 71,2022-08-02,21:00:00,80,44,36,FMN GV 11 Ramsel
66,Bergstraat 71,2022-08-02,22:00:00,32,26,6,FMN GV 11 Ramsel
66,Bergstraat 71,2022-08-02,23:00:00,4,4,0,FMN GV 11 Ramsel
66,Bergstraat 71,2022-08-03,00:00:00,2,2,0,FMN GV 11 Ramsel
66,Bergstraat 71,2022-08-03,01:00:00,4,4,0,FMN GV 11 Ramsel
66,Bergstraat 71,2022-08-03,02:00:00,2,0,2,FMN GV 11 Ramsel
66,Bergstraat 71,2022-08-03,03:00:00,2,0,2,FMN GV 11 Ramsel
66,Bergstraat 71,2022-08-03,04:00:00,4,4,0,FMN GV 11 Ramsel
66,Bergstraat 71,2022-08-03,05:00:00,22,10,12,FMN GV 11 Ramsel
66,Bergstraat 71,2022-08-03,06:00:00,44,18,26,FMN GV 11 Ramsel
66,Bergstraat 71,2022-08-03,07:00:00,90,24,66,FMN GV 11 Ramsel
66,Bergstraat 71,2022-08-03,08:00:00,96,40,56,FMN GV 11 Ramsel
66,Bergstraat 71,2022-08-03,09:00:00,156,64,92,FMN GV 11 Ramsel
66,Bergstraat 71,2022-08-03,10:00:00,166,88,78,FMN GV 11 Ramsel
66,Bergstraat 71,2022-08-03,11:00:00,146,86,60,FMN GV 11 Ramsel
66,Bergstraat 71,2022-08-03,12:00:00,166,92,74,FMN GV 11 Ramsel
66,Bergstraat 71,2022-08-03,13:00:00,156,78,78,FMN GV 11 Ramsel
66,Bergstraat 71,2022-08-03,14:00:00,136,56,80,FMN GV 11 Ramsel
66,Bergstraat 71,2022-08-03,15:00:00,176,84,92,FMN GV 11 Ramsel
66,Bergstraat 71,2022-08-03,16:00:00,166,122,44,FMN GV 11 Ramsel
66,Bergstraat 71,2022-08-03,17:00:00,164,80,84,FMN GV 11 Ramsel
66,Bergstraat 71,2022-08-03,18:00:00,108,56,52,FMN GV 11 Ramsel
66,Bergstraat 71,2022-08-03,19:00:00,152,86,66,FMN GV 11 Ramsel
66,Bergstraat 71,2022-08-03,20:00:00,116,60,56,FMN GV 11 Ramsel
66,Bergstraat 71,2022-08-03,21:00:00,68,34,34,FMN GV 11 Ramsel
66,Bergstraat 71,2022-08-03,22:00:00,44,36,8,FMN GV 11 Ramsel
66,Bergstraat 71,2022-08-03,23:00:00,2,2,0,FMN GV 11 Ramsel
66,Bergstraat 71,2022-08-04,00:00:00,4,2,2,FMN GV 11 Ramsel
66,Bergstraat 71,2022-08-04,01:00:00,14,14,0,FMN GV 11 Ramsel
66,Bergstraat 71,2022-08-04,02:00:00,0,0,0,FMN GV 11 Ramsel
66,Bergstraat 71,2022-08-04,03:00:00,4,4,0,FMN GV 11 Ramsel
66,Bergstraat 71,2022-08-04,04:00:00,4,4,0,FMN GV 11 Ramsel
66,Bergstraat 71,2022-08-04,05:00:00,24,16,8,FMN GV 11 Ramsel
66,Bergstraat 71,2022-08-04,06:00:00,40,18,22,FMN GV 11 Ramsel
66,Bergstraat 71,2022-08-04,07:00:00,64,28,36,FMN GV 11 Ramsel
66,Bergstraat 71,2022-08-04,08:00:00,76,24,52,FMN GV 11 Ramsel
66,Bergstraat 71,2022-08-04,09:00:00,132,58,74,FMN GV 11 Ramsel
66,Bergstraat 71,2022-08-04,10:00:00,136,50,86,FMN GV 11 Ramsel
66,Bergstraat 71,2022-08-04,11:00:00,160,92,68,FMN GV 11 Ramsel
66,Bergstraat 71,2022-08-04,12:00:00,156,112,44,FMN GV 11 Ramsel
66,Bergstraat 71,2022-08-04,13:00:00,158,70,88,FMN GV 11 Ramsel
66,Bergstraat 71,2022-08-04,14:00:00,174,64,110,FMN GV 11 Ramsel
66,Bergstraat 71,2022-08-04,15:00:00,146,74,72,FMN GV 11 Ramsel
66,Bergstraat 71,2022-08-04,16:00:00,192,124,68,FMN GV 11 Ramsel
66,Bergstraat 71,2022-08-04,17:00:00,140,90,50,FMN GV 11 Ramsel
66,Bergstraat 71,2022-08-04,18:00:00,92,54,38,FMN GV 11 Ramsel
66,Bergstraat 71,2022-08-04,19:00:00,90,58,32,FMN GV 11 Ramsel
66,Bergstraat 71,2022-08-04,20:00:00,104,56,48,FMN GV 11 Ramsel
66,Bergstraat 71,2022-08-04,21:00:00,38,30,8,FMN GV 11 Ramsel
66,Bergstraat 71,2022-08-04,22:00:00,12,10,2,FMN GV 11 Ramsel
66,Bergstraat 71,2022-08-04,23:00:00,12,4,8,FMN GV 11 Ramsel
66,Bergstraat 71,2022-08-05,00:00:00,10,2,8,FMN GV 11 Ramsel
66,Bergstraat 71,2022-08-05,01:00:00,2,2,0,FMN GV 11 Ramsel
66,Bergstraat 71,2022-08-05,02:00:00,0,0,0,FMN GV 11 Ramsel
66,Bergstraat 71,2022-08-05,03:00:00,2,0,2,FMN GV 11 Ramsel
66,Bergstraat 71,2022-08-05,04:00:00,8,8,0,FMN GV 11 Ramsel
66,Bergstraat 71,2022-08-05,05:00:00,10,4,6,FMN GV 11 Ramsel
66,Bergstraat 71,2022-08-05,06:00:00,26,6,20,FMN GV 11 Ramsel
66,Bergstraat 71,2022-08-05,07:00:00,54,24,30,FMN GV 11 Ramsel
66,Bergstraat 71,2022-08-05,08:00:00,60,24,36,FMN GV 11 Ramsel
66,Bergstraat 71,2022-08-05,09:00:00,64,28,36,FMN GV 11 Ramsel
66,Bergstraat 71,2022-08-05,10:00:00,106,56,50,FMN GV 11 Ramsel
66,Bergstraat 71,2022-08-05,11:00:00,104,54,50,FMN GV 11 Ramsel
66,Bergstraat 71,2022-08-05,12:00:00,138,74,64,FMN GV 11 Ramsel
66,Bergstraat 71,2022-08-05,13:00:00,194,86,108,FMN GV 11 Ramsel
66,Bergstraat 71,2022-08-05,14:00:00,206,90,116,FMN GV 11 Ramsel
66,Bergstraat 71,2022-08-05,15:00:00,218,140,78,FMN GV 11 Ramsel
66,Bergstraat 71,2022-08-05,16:00:00,212,128,84,FMN GV 11 Ramsel
66,Bergstraat 71,2022-08-05,17:00:00,144,72,72,FMN GV 11 Ramsel
66,Bergstraat 71,2022-08-05,18:00:00,164,84,80,FMN GV 11 Ramsel
66,Bergstraat 71,2022-08-05,19:00:00,70,40,30,FMN GV 11 Ramsel
66,Bergstraat 71,2022-08-05,20:00:00,94,44,50,FMN GV 11 Ramsel
66,Bergstraat 71,2022-08-05,21:00:00,42,8,34,FMN GV 11 Ramsel
66,Bergstraat 71,2022-08-05,22:00:00,16,8,8,FMN GV 11 Ramsel
66,Bergstraat 71,2022-08-05,23:00:00,14,12,2,FMN GV 11 Ramsel
66,Bergstraat 71,2022-08-06,00:00:00,6,4,2,FMN GV 11 Ramsel
66,Bergstraat 71,2022-08-06,01:00:00,2,2,0,FMN GV 11 Ramsel
66,Bergstraat 71,2022-08-06,02:00:00,8,6,2,FMN GV 11 Ramsel
66,Bergstraat 71,2022-08-06,03:00:00,2,2,0,FMN GV 11 Ramsel
66,Bergstraat 71,2022-08-06,04:00:00,2,2,0,FMN GV 11 Ramsel
66,Bergstraat 71,2022-08-06,05:00:00,4,2,2,FMN GV 11 Ramsel
66,Bergstraat 71,2022-08-06,06:00:00,8,4,4,FMN GV 11 Ramsel
66,Bergstraat 71,2022-08-06,07:00:00,28,12,16,FMN GV 11 Ramsel
66,Bergstraat 71,2022-08-06,08:00:00,28,12,16,FMN GV 11 Ramsel
66,Bergstraat 71,2022-08-06,09:00:00,110,46,64,FMN GV 11 Ramsel
66,Bergstraat 71,2022-08-06,10:00:00,126,52,74,FMN GV 11 Ramsel
66,Bergstraat 71,2022-08-06,11:00:00,158,102,56,FMN GV 11 Ramsel
66,Bergstraat 71,2022-08-06,12:00:00,172,118,54,FMN GV 11 Ramsel
66,Bergstraat 71,2022-08-06,13:00:00,214,128,86,FMN GV 11 Ramsel
66,Bergstraat 71,2022-08-06,14:00:00,258,124,134,FMN GV 11 Ramsel
66,Bergstraat 71,2022-08-06,15:00:00,268,136,132,FMN GV 11 Ramsel
66,Bergstraat 71,2022-08-06,16:00:00,196,102,94,FMN GV 11 Ramsel
66,Bergstraat 71,2022-08-06,17:00:00,182,80,102,FMN GV 11 Ramsel
66,Bergstraat 71,2022-08-06,18:00:00,70,34,36,FMN GV 11 Ramsel
66,Bergstraat 71,2022-08-06,19:00:00,56,36,20,FMN GV 11 Ramsel
66,Bergstraat 71,2022-08-06,20:00:00,44,16,28,FMN GV 11 Ramsel
66,Bergstraat 71,2022-08-06,21:00:00,38,18,20,FMN GV 11 Ramsel
66,Bergstraat 71,2022-08-06,22:00:00,20,10,10,FMN GV 11 Ramsel
66,Bergstraat 71,2022-08-06,23:00:00,24,6,18,FMN GV 11 Ramsel
66,Bergstraat 71,2022-08-07,00:00:00,16,14,2,FMN GV 11 Ramsel
66,Bergstraat 71,2022-08-07,01:00:00,0,0,0,FMN GV 11 Ramsel
66,Bergstraat 71,2022-08-07,02:00:00,6,2,4,FMN GV 11 Ramsel
66,Bergstraat 71,2022-08-07,03:00:00,4,0,4,FMN GV 11 Ramsel
66,Bergstraat 71,2022-08-07,04:00:00,2,2,0,FMN GV 11 Ramsel
66,Bergstraat 71,2022-08-07,05:00:00,2,0,2,FMN GV 11 Ramsel
66,Bergstraat 71,2022-08-07,06:00:00,2,0,2,FMN GV 11 Ramsel
66,Bergstraat 71,2022-08-07,07:00:00,30,12,18,FMN GV 11 Ramsel
66,Bergstraat 71,2022-08-07,08:00:00,98,34,64,FMN GV 11 Ramsel
66,Bergstraat 71,2022-08-07,09:00:00,132,40,92,FMN GV 11 Ramsel
66,Bergstraat 71,2022-08-07,10:00:00,262,150,112,FMN GV 11 Ramsel
66,Bergstraat 71,2022-08-07,11:00:00,272,144,128,FMN GV 11 Ramsel
66,Bergstraat 71,2022-08-07,12:00:00,242,130,112,FMN GV 11 Ramsel
66,Bergstraat 71,2022-08-07,13:00:00,288,118,170,FMN GV 11 Ramsel
66,Bergstraat 71,2022-08-07,14:00:00,326,160,166,FMN GV 11 Ramsel
66,Bergstraat 71,2022-08-07,15:00:00,422,258,164,FMN GV 11 Ramsel
66,Bergstraat 71,2022-08-07,16:00:00,264,132,132,FMN GV 11 Ramsel
66,Bergstraat 71,2022-08-07,17:00:00,202,112,90,FMN GV 11 Ramsel
66,Bergstraat 71,2022-08-07,18:00:00,156,82,74,FMN GV 11 Ramsel
66,Bergstraat 71,2022-08-07,19:00:00,136,64,72,FMN GV 11 Ramsel
66,Bergstraat 71,2022-08-07,20:00:00,92,34,58,FMN GV 11 Ramsel
66,Bergstraat 71,2022-08-07,21:00:00,52,36,16,FMN GV 11 Ramsel
66,Bergstraat 71,2022-08-07,22:00:00,18,10,8,FMN GV 11 Ramsel
66,Bergstraat 71,2022-08-07,23:00:00,8,4,4,FMN GV 11 Ramsel
66,Bergstraat 71,2022-08-08,00:00:00,2,2,0,FMN GV 11 Ramsel
66,Bergstraat 71,2022-08-08,01:00:00,4,0,4,FMN GV 11 Ramsel
66,Bergstraat 71,2022-08-08,02:00:00,2,2,0,FMN GV 11 Ramsel
66,Bergstraat 71,2022-08-08,03:00:00,0,0,0,FMN GV 11 Ramsel
66,Bergstraat 71,2022-08-08,04:00:00,8,6,2,FMN GV 11 Ramsel
66,Bergstraat 71,2022-08-08,05:00:00,16,8,8,FMN GV 11 Ramsel
66,Bergstraat 71,2022-08-08,06:00:00,36,20,16,FMN GV 11 Ramsel
66,Bergstraat 71,2022-08-08,07:00:00,56,24,32,FMN GV 11 Ramsel
66,Bergstraat 71,2022-08-08,08:00:00,58,28,30,FMN GV 11 Ramsel
66,Bergstraat 71,2022-08-08,09:00:00,60,28,32,FMN GV 11 Ramsel
66,Bergstraat 71,2022-08-08,10:00:00,108,46,62,FMN GV 11 Ramsel
66,Bergstraat 71,2022-08-08,11:00:00,144,66,78,FMN GV 11 Ramsel
66,Bergstraat 71,2022-08-08,12:00:00,134,64,70,FMN GV 11 Ramsel
66,Bergstraat 71,2022-08-08,13:00:00,260,102,158,FMN GV 11 Ramsel
66,Bergstraat 71,2022-08-08,14:00:00,204,90,114,FMN GV 11 Ramsel
66,Bergstraat 71,2022-08-08,15:00:00,184,90,94,FMN GV 11 Ramsel
66,Bergstraat 71,2022-08-08,16:00:00,224,114,110,FMN GV 11 Ramsel
66,Bergstraat 71,2022-08-08,17:00:00,172,98,74,FMN GV 11 Ramsel
66,Bergstraat 71,2022-08-08,18:00:00,92,42,50,FMN GV 11 Ramsel
66,Bergstraat 71,2022-08-08,19:00:00,96,60,36,FMN GV 11 Ramsel
66,Bergstraat 71,2022-08-08,20:00:00,82,44,38,FMN GV 11 Ramsel
66,Bergstraat 71,2022-08-08,21:00:00,52,24,28,FMN GV 11 Ramsel
66,Bergstraat 71,2022-08-08,22:00:00,32,18,14,FMN GV 11 Ramsel
66,Bergstraat 71,2022-08-08,23:00:00,4,4,0,FMN GV 11 Ramsel
66,Bergstraat 71,2022-08-09,00:00:00,8,6,2,FMN GV 11 Ramsel
66,Bergstraat 71,2022-08-09,01:00:00,0,0,0,FMN GV 11 Ramsel
66,Bergstraat 71,2022-08-09,02:00:00,0,0,0,FMN GV 11 Ramsel
66,Bergstraat 71,2022-08-09,03:00:00,2,0,2,FMN GV 11 Ramsel
66,Bergstraat 71,2022-08-09,04:00:00,8,8,0,FMN GV 11 Ramsel
66,Bergstraat 71,2022-08-09,05:00:00,18,6,12,FMN GV 11 Ramsel
66,Bergstraat 71,2022-08-09,06:00:00,46,18,28,FMN GV 11 Ramsel
66,Bergstraat 71,2022-08-09,07:00:00,72,32,40,FMN GV 11 Ramsel
66,Bergstraat 71,2022-08-09,08:00:00,90,34,56,FMN GV 11 Ramsel
66,Bergstraat 71,2022-08-09,09:00:00,124,48,76,FMN GV 11 Ramsel
66,Bergstraat 71,2022-08-09,10:00:00,158,66,92,FMN GV 11 Ramsel
66,Bergstraat 71,2022-08-09,11:00:00,152,88,64,FMN GV 11 Ramsel
66,Bergstraat 71,2022-08-09,12:00:00,180,92,88,FMN GV 11 Ramsel
66,Bergstraat 71,2022-08-09,13:00:00,294,124,170,FMN GV 11 Ramsel
66,Bergstraat 71,2022-08-09,14:00:00,280,126,154,FMN GV 11 Ramsel
66,Bergstraat 71,2022-08-09,15:00:00,238,124,114,FMN GV 11 Ramsel
66,Bergstraat 71,2022-08-09,16:00:00,204,90,114,FMN GV 11 Ramsel
66,Bergstraat 71,2022-08-09,17:00:00,242,132,110,FMN GV 11 Ramsel
66,Bergstraat 71,2022-08-09,18:00:00,168,68,100,FMN GV 11 Ramsel
66,Bergstraat 71,2022-08-09,19:00:00,166,90,76,FMN GV 11 Ramsel
66,Bergstraat 71,2022-08-09,20:00:00,142,78,64,FMN GV 11 Ramsel
66,Bergstraat 71,2022-08-09,21:00:00,42,26,16,FMN GV 11 Ramsel
66,Bergstraat 71,2022-08-09,22:00:00,34,22,12,FMN GV 11 Ramsel
66,Bergstraat 71,2022-08-09,23:00:00,16,12,4,FMN GV 11 Ramsel
66,Bergstraat 71,2022-08-10,00:00:00,2,2,0,FMN GV 11 Ramsel
66,Bergstraat 71,2022-08-10,01:00:00,0,0,0,FMN GV 11 Ramsel
66,Bergstraat 71,2022-08-10,02:00:00,0,0,0,FMN GV 11 Ramsel
66,Bergstraat 71,2022-08-10,03:00:00,0,0,0,FMN GV 11 Ramsel
66,Bergstraat 71,2022-08-10,04:00:00,8,6,2,FMN GV 11 Ramsel
66,Bergstraat 71,2022-08-10,05:00:00,16,6,10,FMN GV 11 Ramsel
66,Bergstraat 71,2022-08-10,06:00:00,50,22,28,FMN GV 11 Ramsel
66,Bergstraat 71,2022-08-10,07:00:00,62,18,44,FMN GV 11 Ramsel
66,Bergstraat 71,2022-08-10,08:00:00,82,30,52,FMN GV 11 Ramsel
66,Bergstraat 71,2022-08-10,09:00:00,138,70,68,FMN GV 11 Ramsel
66,Bergstraat 71,2022-08-10,10:00:00,176,78,98,FMN GV 11 Ramsel
66,Bergstraat 71,2022-08-10,11:00:00,166,96,70,FMN GV 11 Ramsel
66,Bergstraat 71,2022-08-10,12:00:00,164,108,56,FMN GV 11 Ramsel
66,Bergstraat 71,2022-08-10,13:00:00,170,82,88,FMN GV 11 Ramsel
66,Bergstraat 71,2022-08-10,14:00:00,218,136,82,FMN GV 11 Ramsel
66,Bergstraat 71,2022-08-10,15:00:00,134,74,60,FMN GV 11 Ramsel
66,Bergstraat 71,2022-08-10,16:00:00,186,78,108,FMN GV 11 Ramsel
66,Bergstraat 71,2022-08-10,17:00:00,162,90,72,FMN GV 11 Ramsel
66,Bergstraat 71,2022-08-10,18:00:00,162,78,84,FMN GV 11 Ramsel
66,Bergstraat 71,2022-08-10,19:00:00,156,84,72,FMN GV 11 Ramsel
66,Bergstraat 71,2022-08-10,20:00:00,138,60,78,FMN GV 11 Ramsel
66,Bergstraat 71,2022-08-10,21:00:00,128,88,40,FMN GV 11 Ramsel
66,Bergstraat 71,2022-08-10,22:00:00,36,22,14,FMN GV 11 Ramsel
66,Bergstraat 71,2022-08-10,23:00:00,8,6,2,FMN GV 11 Ramsel
66,Bergstraat 71,2022-08-11,00:00:00,4,4,0,FMN GV 11 Ramsel
66,Bergstraat 71,2022-08-11,01:00:00,2,0,2,FMN GV 11 Ramsel
66,Bergstraat 71,2022-08-11,02:00:00,0,0,0,FMN GV 11 Ramsel
66,Bergstraat 71,2022-08-11,03:00:00,0,0,0,FMN GV 11 Ramsel
66,Bergstraat 71,2022-08-11,04:00:00,4,4,0,FMN GV 11 Ramsel
66,Bergstraat 71,2022-08-11,05:00:00,22,8,14,FMN GV 11 Ramsel
66,Bergstraat 71,2022-08-11,06:00:00,44,14,30,FMN GV 11 Ramsel
66,Bergstraat 71,2022-08-11,07:00:00,86,28,58,FMN GV 11 Ramsel
66,Bergstraat 71,2022-08-11,08:00:00,120,44,76,FMN GV 11 Ramsel
66,Bergstraat 71,2022-08-11,09:00:00,134,66,68,FMN GV 11 Ramsel
66,Bergstraat 71,2022-08-11,10:00:00,200,86,114,FMN GV 11 Ramsel
66,Bergstraat 71,2022-08-11,11:00:00,164,92,72,FMN GV 11 Ramsel
66,Bergstraat 71,2022-08-11,12:00:00,160,90,70,FMN GV 11 Ramsel
66,Bergstraat 71,2022-08-11,13:00:00,124,88,36,FMN GV 11 Ramsel
66,Bergstraat 71,2022-08-11,14:00:00,118,50,68,FMN GV 11 Ramsel
66,Bergstraat 71,2022-08-11,15:00:00,144,76,68,FMN GV 11 Ramsel
66,Bergstraat 71,2022-08-11,16:00:00,124,74,50,FMN GV 11 Ramsel
66,Bergstraat 71,2022-08-11,17:00:00,142,90,52,FMN GV 11 Ramsel
66,Bergstraat 71,2022-08-11,18:00:00,138,68,70,FMN GV 11 Ramsel
66,Bergstraat 71,2022-08-11,19:00:00,104,62,42,FMN GV 11 Ramsel
66,Bergstraat 71,2022-08-11,20:00:00,136,74,62,FMN GV 11 Ramsel
66,Bergstraat 71,2022-08-11,21:00:00,68,30,38,FMN GV 11 Ramsel
66,Bergstraat 71,2022-08-11,22:00:00,28,18,10,FMN GV 11 Ramsel
66,Bergstraat 71,2022-08-11,23:00:00,12,6,6,FMN GV 11 Ramsel
66,Bergstraat 71,2022-08-12,00:00:00,4,2,2,FMN GV 11 Ramsel
66,Bergstraat 71,2022-08-12,01:00:00,4,2,2,FMN GV 11 Ramsel
66,Bergstraat 71,2022-08-12,02:00:00,4,4,0,FMN GV 11 Ramsel
66,Bergstraat 71,2022-08-12,03:00:00,2,2,0,FMN GV 11 Ramsel
66,Bergstraat 71,2022-08-12,04:00:00,4,4,0,FMN GV 11 Ramsel
66,Bergstraat 71,2022-08-12,05:00:00,14,8,6,FMN GV 11 Ramsel
66,Bergstraat 71,2022-08-12,06:00:00,26,12,14,FMN GV 11 Ramsel
66,Bergstraat 71,2022-08-12,07:00:00,72,26,46,FMN GV 11 Ramsel
66,Bergstraat 71,2022-08-12,08:00:00,90,38,52,FMN GV 11 Ramsel
66,Bergstraat 71,2022-08-12,09:00:00,150,64,86,FMN GV 11 Ramsel
66,Bergstraat 71,2022-08-12,10:00:00,228,108,120,FMN GV 11 Ramsel
66,Bergstraat 71,2022-08-12,11:00:00,178,94,84,FMN GV 11 Ramsel
66,Bergstraat 71,2022-08-12,12:00:00,138,82,56,FMN GV 11 Ramsel
66,Bergstraat 71,2022-08-12,13:00:00,106,50,56,FMN GV 11 Ramsel
66,Bergstraat 71,2022-08-12,14:00:00,110,50,60,FMN GV 11 Ramsel
66,Bergstraat 71,2022-08-12,15:00:00,76,32,44,FMN GV 11 Ramsel
66,Bergstraat 71,2022-08-12,16:00:00,152,78,74,FMN GV 11 Ramsel
66,Bergstraat 71,2022-08-12,17:00:00,112,72,40,FMN GV 11 Ramsel
66,Bergstraat 71,2022-08-12,18:00:00,86,42,44,FMN GV 11 Ramsel
66,Bergstraat 71,2022-08-12,19:00:00,102,56,46,FMN GV 11 Ramsel
66,Bergstraat 71,2022-08-12,20:00:00,100,40,60,FMN GV 11 Ramsel
66,Bergstraat 71,2022-08-12,21:00:00,66,22,44,FMN GV 11 Ramsel
66,Bergstraat 71,2022-08-12,22:00:00,32,22,10,FMN GV 11 Ramsel
66,Bergstraat 71,2022-08-12,23:00:00,22,18,4,FMN GV 11 Ramsel
66,Bergstraat 71,2022-08-13,00:00:00,8,2,6,FMN GV 11 Ramsel
66,Bergstraat 71,2022-08-13,01:00:00,10,6,4,FMN GV 11 Ramsel
66,Bergstraat 71,2022-08-13,02:00:00,8,8,0,FMN GV 11 Ramsel
66,Bergstraat 71,2022-08-13,03:00:00,2,2,0,FMN GV 11 Ramsel
66,Bergstraat 71,2022-08-13,04:00:00,8,6,2,FMN GV 11 Ramsel
66,Bergstraat 71,2022-08-13,05:00:00,0,0,0,FMN GV 11 Ramsel
66,Bergstraat 71,2022-08-13,06:00:00,18,12,6,FMN GV 11 Ramsel
66,Bergstraat 71,2022-08-13,07:00:00,50,18,32,FMN GV 11 Ramsel
66,Bergstraat 71,2022-08-13,08:00:00,134,54,80,FMN GV 11 Ramsel
66,Bergstraat 71,2022-08-13,09:00:00,194,94,100,FMN GV 11 Ramsel
66,Bergstraat 71,2022-08-13,10:00:00,208,104,104,FMN GV 11 Ramsel
66,Bergstraat 71,2022-08-13,11:00:00,170,78,92,FMN GV 11 Ramsel
66,Bergstraat 71,2022-08-13,12:00:00,140,86,54,FMN GV 11 Ramsel
66,Bergstraat 71,2022-08-13,13:00:00,102,50,52,FMN GV 11 Ramsel
66,Bergstraat 71,2022-08-13,14:00:00,134,50,84,FMN GV 11 Ramsel
66,Bergstraat 71,2022-08-13,15:00:00,134,58,76,FMN GV 11 Ramsel
66,Bergstraat 71,2022-08-13,16:00:00,86,52,34,FMN GV 11 Ramsel
66,Bergstraat 71,2022-08-13,17:00:00,82,58,24,FMN GV 11 Ramsel
66,Bergstraat 71,2022-08-13,18:00:00,106,50,56,FMN GV 11 Ramsel
66,Bergstraat 71,2022-08-13,19:00:00,130,56,74,FMN GV 11 Ramsel
66,Bergstraat 71,2022-08-13,20:00:00,128,66,62,FMN GV 11 Ramsel
66,Bergstraat 71,2022-08-13,21:00:00,96,32,64,FMN GV 11 Ramsel
66,Bergstraat 71,2022-08-13,22:00:00,52,34,18,FMN GV 11 Ramsel
66,Bergstraat 71,2022-08-13,23:00:00,12,2,10,FMN GV 11 Ramsel
66,Bergstraat 71,2022-08-14,00:00:00,10,4,6,FMN GV 11 Ramsel
66,Bergstraat 71,2022-08-14,01:00:00,18,14,4,FMN GV 11 Ramsel
66,Bergstraat 71,2022-08-14,02:00:00,14,6,8,FMN GV 11 Ramsel
66,Bergstraat 71,2022-08-14,03:00:00,0,0,0,FMN GV 11 Ramsel
66,Bergstraat 71,2022-08-14,04:00:00,2,2,0,FMN GV 11 Ramsel
66,Bergstraat 71,2022-08-14,05:00:00,6,2,4,FMN GV 11 Ramsel
66,Bergstraat 71,2022-08-14,06:00:00,12,6,6,FMN GV 11 Ramsel
66,Bergstraat 71,2022-08-14,07:00:00,76,32,44,FMN GV 11 Ramsel
66,Bergstraat 71,2022-08-14,08:00:00,154,52,102,FMN GV 11 Ramsel
66,Bergstraat 71,2022-08-14,09:00:00,326,160,166,FMN GV 11 Ramsel
66,Bergstraat 71,2022-08-14,10:00:00,460,260,200,FMN GV 11 Ramsel
66,Bergstraat 71,2022-08-14,11:00:00,318,218,100,FMN GV 11 Ramsel
66,Bergstraat 71,2022-08-14,12:00:00,294,216,78,FMN GV 11 Ramsel
66,Bergstraat 71,2022-08-14,13:00:00,228,132,96,FMN GV 11 Ramsel
66,Bergstraat 71,2022-08-14,14:00:00,196,106,90,FMN GV 11 Ramsel
66,Bergstraat 71,2022-08-14,15:00:00,216,114,102,FMN GV 11 Ramsel
66,Bergstraat 71,2022-08-14,16:00:00,166,72,94,FMN GV 11 Ramsel
66,Bergstraat 71,2022-08-14,17:00:00,126,56,70,FMN GV 11 Ramsel
66,Bergstraat 71,2022-08-14,18:00:00,96,48,48,FMN GV 11 Ramsel
66,Bergstraat 71,2022-08-14,19:00:00,136,66,70,FMN GV 11 Ramsel
66,Bergstraat 71,2022-08-14,20:00:00,112,50,62,FMN GV 11 Ramsel
66,Bergstraat 71,2022-08-14,21:00:00,56,26,30,FMN GV 11 Ramsel
66,Bergstraat 71,2022-08-14,22:00:00,20,12,8,FMN GV 11 Ramsel
66,Bergstraat 71,2022-08-14,23:00:00,22,20,2,FMN GV 11 Ramsel
66,Bergstraat 71,2022-08-15,00:00:00,2,2,0,FMN GV 11 Ramsel
66,Bergstraat 71,2022-08-15,01:00:00,6,0,6,FMN GV 11 Ramsel
66,Bergstraat 71,2022-08-15,02:00:00,0,0,0,FMN GV 11 Ramsel
66,Bergstraat 71,2022-08-15,03:00:00,2,2,0,FMN GV 11 Ramsel
66,Bergstraat 71,2022-08-15,04:00:00,2,2,0,FMN GV 11 Ramsel
66,Bergstraat 71,2022-08-15,05:00:00,6,6,0,FMN GV 11 Ramsel
66,Bergstraat 71,2022-08-15,06:00:00,4,2,2,FMN GV 11 Ramsel
66,Bergstraat 71,2022-08-15,07:00:00,10,4,6,FMN GV 11 Ramsel
66,Bergstraat 71,2022-08-15,08:00:00,50,18,32,FMN GV 11 Ramsel
66,Bergstraat 71,2022-08-15,09:00:00,102,36,66,FMN GV 11 Ramsel
66,Bergstraat 71,2022-08-15,10:00:00,150,74,76,FMN GV 11 Ramsel
66,Bergstraat 71,2022-08-15,11:00:00,126,66,60,FMN GV 11 Ramsel
66,Bergstraat 71,2022-08-15,12:00:00,124,80,44,FMN GV 11 Ramsel
66,Bergstraat 71,2022-08-15,13:00:00,290,138,152,FMN GV 11 Ramsel
66,Bergstraat 71,2022-08-15,14:00:00,216,144,72,FMN GV 11 Ramsel
66,Bergstraat 71,2022-08-15,15:00:00,98,34,64,FMN GV 11 Ramsel
66,Bergstraat 71,2022-08-15,16:00:00,52,18,34,FMN GV 11 Ramsel
66,Bergstraat 71,2022-08-15,17:00:00,66,30,36,FMN GV 11 Ramsel
66,Bergstraat 71,2022-08-15,18:00:00,86,42,44,FMN GV 11 Ramsel
66,Bergstraat 71,2022-08-15,19:00:00,122,32,90,FMN GV 11 Ramsel
66,Bergstraat 71,2022-08-15,20:00:00,152,42,110,FMN GV 11 Ramsel
66,Bergstraat 71,2022-08-15,21:00:00,90,22,68,FMN GV 11 Ramsel
66,Bergstraat 71,2022-08-15,22:00:00,48,42,6,FMN GV 11 Ramsel
66,Bergstraat 71,2022-08-15,23:00:00,84,82,2,FMN GV 11 Ramsel
66,Bergstraat 71,2022-08-16,00:00:00,70,66,4,FMN GV 11 Ramsel
66,Bergstraat 71,2022-08-16,01:00:00,40,40,0,FMN GV 11 Ramsel
66,Bergstraat 71,2022-08-16,02:00:00,16,16,0,FMN GV 11 Ramsel
66,Bergstraat 71,2022-08-16,03:00:00,0,0,0,FMN GV 11 Ramsel
66,Bergstraat 71,2022-08-16,04:00:00,8,4,4,FMN GV 11 Ramsel
66,Bergstraat 71,2022-08-16,05:00:00,16,6,10,FMN GV 11 Ramsel
66,Bergstraat 71,2022-08-16,06:00:00,36,10,26,FMN GV 11 Ramsel
66,Bergstraat 71,2022-08-16,07:00:00,78,30,48,FMN GV 11 Ramsel
66,Bergstraat 71,2022-08-16,08:00:00,58,20,38,FMN GV 11 Ramsel
66,Bergstraat 71,2022-08-16,09:00:00,96,42,54,FMN GV 11 Ramsel
66,Bergstraat 71,2022-08-16,10:00:00,198,82,116,FMN GV 11 Ramsel
66,Bergstraat 71,2022-08-16,11:00:00,204,86,118,FMN GV 11 Ramsel
66,Bergstraat 71,2022-08-16,12:00:00,152,58,94,FMN GV 11 Ramsel
66,Bergstraat 71,2022-08-16,13:00:00,216,120,96,FMN GV 11 Ramsel
66,Bergstraat 71,2022-08-16,14:00:00,252,148,104,FMN GV 11 Ramsel
66,Bergstraat 71,2022-08-16,15:00:00,208,114,94,FMN GV 11 Ramsel
66,Bergstraat 71,2022-08-16,16:00:00,188,84,104,FMN GV 11 Ramsel
66,Bergstraat 71,2022-08-16,17:00:00,212,124,88,FMN GV 11 Ramsel
66,Bergstraat 71,2022-08-16,18:00:00,146,64,82,FMN GV 11 Ramsel
66,Bergstraat 71,2022-08-16,19:00:00,136,72,64,FMN GV 11 Ramsel
66,Bergstraat 71,2022-08-16,20:00:00,130,64,66,FMN GV 11 Ramsel
66,Bergstraat 71,2022-08-16,21:00:00,54,32,22,FMN GV 11 Ramsel
66,Bergstraat 71,2022-08-16,22:00:00,16,10,6,FMN GV 11 Ramsel
66,Bergstraat 71,2022-08-16,23:00:00,6,6,0,FMN GV 11 Ramsel
66,Bergstraat 71,2022-08-17,00:00:00,2,2,0,FMN GV 11 Ramsel
66,Bergstraat 71,2022-08-17,01:00:00,0,0,0,FMN GV 11 Ramsel
66,Bergstraat 71,2022-08-17,02:00:00,0,0,0,FMN GV 11 Ramsel
66,Bergstraat 71,2022-08-17,03:00:00,2,0,2,FMN GV 11 Ramsel
66,Bergstraat 71,2022-08-17,04:00:00,4,2,2,FMN GV 11 Ramsel
66,Bergstraat 71,2022-08-17,05:00:00,12,6,6,FMN GV 11 Ramsel
66,Bergstraat 71,2022-08-17,06:00:00,24,12,12,FMN GV 11 Ramsel
66,Bergstraat 71,2022-08-17,07:00:00,38,18,20,FMN GV 11 Ramsel
66,Bergstraat 71,2022-08-17,08:00:00,36,16,20,FMN GV 11 Ramsel
66,Bergstraat 71,2022-08-17,09:00:00,10,6,4,FMN GV 11 Ramsel
66,Bergstraat 71,2022-08-17,10:00:00,16,6,10,FMN GV 11 Ramsel
66,Bergstraat 71,2022-08-17,11:00:00,8,4,4,FMN GV 11 Ramsel
66,Bergstraat 71,2022-08-17,12:00:00,12,2,10,FMN GV 11 Ramsel
66,Bergstraat 71,2022-08-17,13:00:00,40,26,14,FMN GV 11 Ramsel
66,Bergstraat 71,2022-08-17,14:00:00,56,28,28,FMN GV 11 Ramsel
66,Bergstraat 71,2022-08-17,15:00:00,52,24,28,FMN GV 11 Ramsel
66,Bergstraat 71,2022-08-17,16:00:00,94,56,38,FMN GV 11 Ramsel
66,Bergstraat 71,2022-08-17,17:00:00,108,54,54,FMN GV 11 Ramsel
66,Bergstraat 71,2022-08-17,18:00:00,94,54,40,FMN GV 11 Ramsel
66,Bergstraat 71,2022-08-17,19:00:00,70,26,44,FMN GV 11 Ramsel
66,Bergstraat 71,2022-08-17,20:00:00,54,30,24,FMN GV 11 Ramsel
66,Bergstraat 71,2022-08-17,21:00:00,24,16,8,FMN GV 11 Ramsel
66,Bergstraat 71,2022-08-17,22:00:00,18,12,6,FMN GV 11 Ramsel
66,Bergstraat 71,2022-08-17,23:00:00,6,6,0,FMN GV 11 Ramsel
66,Bergstraat 71,2022-08-18,00:00:00,6,4,2,FMN GV 11 Ramsel
66,Bergstraat 71,2022-08-18,01:00:00,0,0,0,FMN GV 11 Ramsel
66,Bergstraat 71,2022-08-18,02:00:00,0,0,0,FMN GV 11 Ramsel
66,Bergstraat 71,2022-08-18,03:00:00,0,0,0,FMN GV 11 Ramsel
66,Bergstraat 71,2022-08-18,04:00:00,4,2,2,FMN GV 11 Ramsel
66,Bergstraat 71,2022-08-18,05:00:00,14,8,6,FMN GV 11 Ramsel
66,Bergstraat 71,2022-08-18,06:00:00,24,8,16,FMN GV 11 Ramsel
66,Bergstraat 71,2022-08-18,07:00:00,72,26,46,FMN GV 11 Ramsel
66,Bergstraat 71,2022-08-18,08:00:00,74,20,54,FMN GV 11 Ramsel
66,Bergstraat 71,2022-08-18,09:00:00,92,34,58,FMN GV 11 Ramsel
66,Bergstraat 71,2022-08-18,10:00:00,152,56,96,FMN GV 11 Ramsel
66,Bergstraat 71,2022-08-18,11:00:00,122,54,68,FMN GV 11 Ramsel
66,Bergstraat 71,2022-08-18,12:00:00,128,74,54,FMN GV 11 Ramsel
66,Bergstraat 71,2022-08-18,13:00:00,196,106,90,FMN GV 11 Ramsel
66,Bergstraat 71,2022-08-18,14:00:00,204,126,78,FMN GV 11 Ramsel
66,Bergstraat 71,2022-08-18,15:00:00,262,154,108,FMN GV 11 Ramsel
66,Bergstraat 71,2022-08-18,16:00:00,182,98,84,FMN GV 11 Ramsel
66,Bergstraat 71,2022-08-18,17:00:00,216,142,74,FMN GV 11 Ramsel
66,Bergstraat 71,2022-08-18,18:00:00,150,86,64,FMN GV 11 Ramsel
66,Bergstraat 71,2022-08-18,19:00:00,130,56,74,FMN GV 11 Ramsel
66,Bergstraat 71,2022-08-18,20:00:00,112,52,60,FMN GV 11 Ramsel
66,Bergstraat 71,2022-08-18,21:00:00,34,22,12,FMN GV 11 Ramsel
66,Bergstraat 71,2022-08-18,22:00:00,16,16,0,FMN GV 11 Ramsel
66,Bergstraat 71,2022-08-18,23:00:00,8,8,0,FMN GV 11 Ramsel
66,Bergstraat 71,2022-08-19,00:00:00,12,8,4,FMN GV 11 Ramsel
66,Bergstraat 71,2022-08-19,01:00:00,6,4,2,FMN GV 11 Ramsel
66,Bergstraat 71,2022-08-19,02:00:00,2,2,0,FMN GV 11 Ramsel
66,Bergstraat 71,2022-08-19,03:00:00,2,2,0,FMN GV 11 Ramsel
66,Bergstraat 71,2022-08-19,04:00:00,6,4,2,FMN GV 11 Ramsel
66,Bergstraat 71,2022-08-19,05:00:00,8,4,4,FMN GV 11 Ramsel
66,Bergstraat 71,2022-08-19,06:00:00,18,6,12,FMN GV 11 Ramsel
66,Bergstraat 71,2022-08-19,07:00:00,56,20,36,FMN GV 11 Ramsel
66,Bergstraat 71,2022-08-19,08:00:00,56,20,36,FMN GV 11 Ramsel
66,Bergstraat 71,2022-08-19,09:00:00,82,42,40,FMN GV 11 Ramsel
66,Bergstraat 71,2022-08-19,10:00:00,74,36,38,FMN GV 11 Ramsel
66,Bergstraat 71,2022-08-19,11:00:00,150,70,80,FMN GV 11 Ramsel
66,Bergstraat 71,2022-08-19,12:00:00,92,34,58,FMN GV 11 Ramsel
66,Bergstraat 71,2022-08-19,13:00:00,112,64,48,FMN GV 11 Ramsel
66,Bergstraat 71,2022-08-19,14:00:00,92,42,50,FMN GV 11 Ramsel
66,Bergstraat 71,2022-08-19,15:00:00,98,56,42,FMN GV 11 Ramsel
66,Bergstraat 71,2022-08-19,16:00:00,104,60,44,FMN GV 11 Ramsel
66,Bergstraat 71,2022-08-19,17:00:00,98,58,40,FMN GV 11 Ramsel
66,Bergstraat 71,2022-08-19,18:00:00,70,36,34,FMN GV 11 Ramsel
66,Bergstraat 71,2022-08-19,19:00:00,44,14,30,FMN GV 11 Ramsel
66,Bergstraat 71,2022-08-19,20:00:00,44,22,22,FMN GV 11 Ramsel
66,Bergstraat 71,2022-08-19,21:00:00,22,6,16,FMN GV 11 Ramsel
66,Bergstraat 71,2022-08-19,22:00:00,10,8,2,FMN GV 11 Ramsel
66,Bergstraat 71,2022-08-19,23:00:00,16,8,8,FMN GV 11 Ramsel
66,Bergstraat 71,2022-08-20,00:00:00,4,2,2,FMN GV 11 Ramsel
66,Bergstraat 71,2022-08-20,01:00:00,16,12,4,FMN GV 11 Ramsel
66,Bergstraat 71,2022-08-20,02:00:00,6,4,2,FMN GV 11 Ramsel
66,Bergstraat 71,2022-08-20,03:00:00,2,2,0,FMN GV 11 Ramsel
66,Bergstraat 71,2022-08-20,04:00:00,2,0,2,FMN GV 11 Ramsel
66,Bergstraat 71,2022-08-20,05:00:00,0,0,0,FMN GV 11 Ramsel
66,Bergstraat 71,2022-08-20,06:00:00,8,4,4,FMN GV 11 Ramsel
66,Bergstraat 71,2022-08-20,07:00:00,16,6,10,FMN GV 11 Ramsel
66,Bergstraat 71,2022-08-20,08:00:00,52,26,26,FMN GV 11 Ramsel
66,Bergstraat 71,2022-08-20,09:00:00,102,32,70,FMN GV 11 Ramsel
66,Bergstraat 71,2022-08-20,10:00:00,128,56,72,FMN GV 11 Ramsel
66,Bergstraat 71,2022-08-20,11:00:00,128,62,66,FMN GV 11 Ramsel
66,Bergstraat 71,2022-08-20,12:00:00,160,92,68,FMN GV 11 Ramsel
66,Bergstraat 71,2022-08-20,13:00:00,246,96,150,FMN GV 11 Ramsel
66,Bergstraat 71,2022-08-20,14:00:00,316,144,172,FMN GV 11 Ramsel
66,Bergstraat 71,2022-08-20,15:00:00,250,112,138,FMN GV 11 Ramsel
66,Bergstraat 71,2022-08-20,16:00:00,262,168,94,FMN GV 11 Ramsel
66,Bergstraat 71,2022-08-20,17:00:00,198,96,102,FMN GV 11 Ramsel
66,Bergstraat 71,2022-08-20,18:00:00,90,64,26,FMN GV 11 Ramsel
66,Bergstraat 71,2022-08-20,19:00:00,60,44,16,FMN GV 11 Ramsel
66,Bergstraat 71,2022-08-20,20:00:00,76,22,54,FMN GV 11 Ramsel
66,Bergstraat 71,2022-08-20,21:00:00,42,16,26,FMN GV 11 Ramsel
66,Bergstraat 71,2022-08-20,22:00:00,20,10,10,FMN GV 11 Ramsel
66,Bergstraat 71,2022-08-20,23:00:00,18,6,12,FMN GV 11 Ramsel
66,Bergstraat 71,2022-08-21,00:00:00,12,8,4,FMN GV 11 Ramsel
66,Bergstraat 71,2022-08-21,01:00:00,16,10,6,FMN GV 11 Ramsel
66,Bergstraat 71,2022-08-21,02:00:00,22,18,4,FMN GV 11 Ramsel
66,Bergstraat 71,2022-08-21,03:00:00,8,6,2,FMN GV 11 Ramsel
66,Bergstraat 71,2022-08-21,04:00:00,0,0,0,FMN GV 11 Ramsel
66,Bergstraat 71,2022-08-21,05:00:00,4,2,2,FMN GV 11 Ramsel
66,Bergstraat 71,2022-08-21,06:00:00,6,2,4,FMN GV 11 Ramsel
66,Bergstraat 71,2022-08-21,07:00:00,28,12,16,FMN GV 11 Ramsel
66,Bergstraat 71,2022-08-21,08:00:00,74,18,56,FMN GV 11 Ramsel
66,Bergstraat 71,2022-08-21,09:00:00,162,54,108,FMN GV 11 Ramsel
66,Bergstraat 71,2022-08-21,10:00:00,244,146,98,FMN GV 11 Ramsel
66,Bergstraat 71,2022-08-21,11:00:00,196,106,90,FMN GV 11 Ramsel
66,Bergstraat 71,2022-08-21,12:00:00,188,86,102,FMN GV 11 Ramsel
66,Bergstraat 71,2022-08-21,13:00:00,334,114,220,FMN GV 11 Ramsel
66,Bergstraat 71,2022-08-21,14:00:00,376,178,198,FMN GV 11 Ramsel
66,Bergstraat 71,2022-08-21,15:00:00,304,154,150,FMN GV 11 Ramsel
66,Bergstraat 71,2022-08-21,16:00:00,256,132,124,FMN GV 11 Ramsel
66,Bergstraat 71,2022-08-21,17:00:00,204,124,80,FMN GV 11 Ramsel
66,Bergstraat 71,2022-08-21,18:00:00,138,86,52,FMN GV 11 Ramsel
66,Bergstraat 71,2022-08-21,19:00:00,126,66,60,FMN GV 11 Ramsel
66,Bergstraat 71,2022-08-21,20:00:00,48,14,34,FMN GV 11 Ramsel
66,Bergstraat 71,2022-08-21,21:00:00,26,16,10,FMN GV 11 Ramsel
66,Bergstraat 71,2022-08-21,22:00:00,16,12,4,FMN GV 11 Ramsel
66,Bergstraat 71,2022-08-21,23:00:00,6,6,0,FMN GV 11 Ramsel
66,Bergstraat 71,2022-08-22,00:00:00,4,2,2,FMN GV 11 Ramsel
66,Bergstraat 71,2022-08-22,01:00:00,6,4,2,FMN GV 11 Ramsel
66,Bergstraat 71,2022-08-22,02:00:00,2,2,0,FMN GV 11 Ramsel
66,Bergstraat 71,2022-08-22,03:00:00,10,6,4,FMN GV 11 Ramsel
66,Bergstraat 71,2022-08-22,04:00:00,6,6,0,FMN GV 11 Ramsel
66,Bergstraat 71,2022-08-22,05:00:00,6,0,6,FMN GV 11 Ramsel
66,Bergstraat 71,2022-08-22,06:00:00,22,12,10,FMN GV 11 Ramsel
66,Bergstraat 71,2022-08-22,07:00:00,76,24,52,FMN GV 11 Ramsel
66,Bergstraat 71,2022-08-22,08:00:00,88,32,56,FMN GV 11 Ramsel
66,Bergstraat 71,2022-08-22,09:00:00,50,26,24,FMN GV 11 Ramsel
66,Bergstraat 71,2022-08-22,10:00:00,76,28,48,FMN GV 11 Ramsel
66,Bergstraat 71,2022-08-22,11:00:00,56,24,32,FMN GV 11 Ramsel
66,Bergstraat 71,2022-08-22,12:00:00,88,46,42,FMN GV 11 Ramsel
66,Bergstraat 71,2022-08-22,13:00:00,168,74,94,FMN GV 11 Ramsel
66,Bergstraat 71,2022-08-22,14:00:00,210,74,136,FMN GV 11 Ramsel
66,Bergstraat 71,2022-08-22,15:00:00,212,126,86,FMN GV 11 Ramsel
66,Bergstraat 71,2022-08-22,16:00:00,186,108,78,FMN GV 11 Ramsel
66,Bergstraat 71,2022-08-22,17:00:00,168,108,60,FMN GV 11 Ramsel
66,Bergstraat 71,2022-08-22,18:00:00,108,52,56,FMN GV 11 Ramsel
66,Bergstraat 71,2022-08-22,19:00:00,92,50,42,FMN GV 11 Ramsel
66,Bergstraat 71,2022-08-22,20:00:00,60,30,30,FMN GV 11 Ramsel
66,Bergstraat 71,2022-08-22,21:00:00,36,20,16,FMN GV 11 Ramsel
66,Bergstraat 71,2022-08-22,22:00:00,26,16,10,FMN GV 11 Ramsel
66,Bergstraat 71,2022-08-22,23:00:00,2,2,0,FMN GV 11 Ramsel
66,Bergstraat 71,2022-08-23,00:00:00,12,10,2,FMN GV 11 Ramsel
66,Bergstraat 71,2022-08-23,01:00:00,0,0,0,FMN GV 11 Ramsel
66,Bergstraat 71,2022-08-23,02:00:00,2,0,2,FMN GV 11 Ramsel
66,Bergstraat 71,2022-08-23,03:00:00,0,0,0,FMN GV 11 Ramsel
66,Bergstraat 71,2022-08-23,04:00:00,10,8,2,FMN GV 11 Ramsel
66,Bergstraat 71,2022-08-23,05:00:00,10,6,4,FMN GV 11 Ramsel
66,Bergstraat 71,2022-08-23,06:00:00,34,14,20,FMN GV 11 Ramsel
66,Bergstraat 71,2022-08-23,07:00:00,84,26,58,FMN GV 11 Ramsel
66,Bergstraat 71,2022-08-23,08:00:00,80,24,56,FMN GV 11 Ramsel
66,Bergstraat 71,2022-08-23,09:00:00,92,34,58,FMN GV 11 Ramsel
66,Bergstraat 71,2022-08-23,10:00:00,206,102,104,FMN GV 11 Ramsel
66,Bergstraat 71,2022-08-23,11:00:00,196,88,108,FMN GV 11 Ramsel
66,Bergstraat 71,2022-08-23,12:00:00,150,84,66,FMN GV 11 Ramsel
66,Bergstraat 71,2022-08-23,13:00:00,298,138,160,FMN GV 11 Ramsel
66,Bergstraat 71,2022-08-23,14:00:00,322,110,212,FMN GV 11 Ramsel
66,Bergstraat 71,2022-08-23,15:00:00,246,136,110,FMN GV 11 Ramsel
66,Bergstraat 71,2022-08-23,16:00:00,226,122,104,FMN GV 11 Ramsel
66,Bergstraat 71,2022-08-23,17:00:00,186,94,92,FMN GV 11 Ramsel
66,Bergstraat 71,2022-08-23,18:00:00,192,106,86,FMN GV 11 Ramsel
66,Bergstraat 71,2022-08-23,19:00:00,148,76,72,FMN GV 11 Ramsel
66,Bergstraat 71,2022-08-23,20:00:00,148,74,74,FMN GV 11 Ramsel
66,Bergstraat 71,2022-08-23,21:00:00,56,42,14,FMN GV 11 Ramsel
66,Bergstraat 71,2022-08-23,22:00:00,30,24,6,FMN GV 11 Ramsel
66,Bergstraat 71,2022-08-23,23:00:00,10,8,2,FMN GV 11 Ramsel
66,Bergstraat 71,2022-08-24,00:00:00,4,4,0,FMN GV 11 Ramsel
66,Bergstraat 71,2022-08-24,01:00:00,6,2,4,FMN GV 11 Ramsel
66,Bergstraat 71,2022-08-24,02:00:00,0,0,0,FMN GV 11 Ramsel
66,Bergstraat 71,2022-08-24,03:00:00,0,0,0,FMN GV 11 Ramsel
66,Bergstraat 71,2022-08-24,04:00:00,12,8,4,FMN GV 11 Ramsel
66,Bergstraat 71,2022-08-24,05:00:00,8,6,2,FMN GV 11 Ramsel
66,Bergstraat 71,2022-08-24,06:00:00,36,16,20,FMN GV 11 Ramsel
66,Bergstraat 71,2022-08-24,07:00:00,74,20,54,FMN GV 11 Ramsel
66,Bergstraat 71,2022-08-24,08:00:00,92,40,52,FMN GV 11 Ramsel
66,Bergstraat 71,2022-08-24,09:00:00,146,58,88,FMN GV 11 Ramsel
66,Bergstraat 71,2022-08-24,10:00:00,174,70,104,FMN GV 11 Ramsel
66,Bergstraat 71,2022-08-24,11:00:00,146,94,52,FMN GV 11 Ramsel
66,Bergstraat 71,2022-08-24,12:00:00,150,80,70,FMN GV 11 Ramsel
66,Bergstraat 71,2022-08-24,13:00:00,216,100,116,FMN GV 11 Ramsel
66,Bergstraat 71,2022-08-24,14:00:00,248,108,140,FMN GV 11 Ramsel
66,Bergstraat 71,2022-08-24,15:00:00,172,98,74,FMN GV 11 Ramsel
66,Bergstraat 71,2022-08-24,16:00:00,178,92,86,FMN GV 11 Ramsel
66,Bergstraat 71,2022-08-24,17:00:00,208,96,112,FMN GV 11 Ramsel
66,Bergstraat 71,2022-08-24,18:00:00,150,60,90,FMN GV 11 Ramsel
66,Bergstraat 71,2022-08-24,19:00:00,148,72,76,FMN GV 11 Ramsel
66,Bergstraat 71,2022-08-24,20:00:00,198,104,94,FMN GV 11 Ramsel
66,Bergstraat 71,2022-08-24,21:00:00,90,52,38,FMN GV 11 Ramsel
66,Bergstraat 71,2022-08-24,22:00:00,28,18,10,FMN GV 11 Ramsel
66,Bergstraat 71,2022-08-24,23:00:00,10,10,0,FMN GV 11 Ramsel
66,Bergstraat 71,2022-08-25,00:00:00,16,10,6,FMN GV 11 Ramsel
66,Bergstraat 71,2022-08-25,01:00:00,2,2,0,FMN GV 11 Ramsel
66,Bergstraat 71,2022-08-25,02:00:00,0,0,0,FMN GV 11 Ramsel
66,Bergstraat 71,2022-08-25,03:00:00,2,2,0,FMN GV 11 Ramsel
66,Bergstraat 71,2022-08-25,04:00:00,10,6,4,FMN GV 11 Ramsel
66,Bergstraat 71,2022-08-25,05:00:00,12,8,4,FMN GV 11 Ramsel
66,Bergstraat 71,2022-08-25,06:00:00,46,10,36,FMN GV 11 Ramsel
66,Bergstraat 71,2022-08-25,07:00:00,88,22,66,FMN GV 11 Ramsel
66,Bergstraat 71,2022-08-25,08:00:00,98,36,62,FMN GV 11 Ramsel
66,Bergstraat 71,2022-08-25,09:00:00,106,42,64,FMN GV 11 Ramsel
66,Bergstraat 71,2022-08-25,10:00:00,172,72,100,FMN GV 11 Ramsel
66,Bergstraat 71,2022-08-25,11:00:00,122,60,62,FMN GV 11 Ramsel
66,Bergstraat 71,2022-08-25,12:00:00,132,60,72,FMN GV 11 Ramsel
66,Bergstraat 71,2022-08-25,13:00:00,136,64,72,FMN GV 11 Ramsel
66,Bergstraat 71,2022-08-25,14:00:00,168,84,84,FMN GV 11 Ramsel
66,Bergstraat 71,2022-08-25,15:00:00,116,70,46,FMN GV 11 Ramsel
66,Bergstraat 71,2022-08-25,16:00:00,150,84,66,FMN GV 11 Ramsel
66,Bergstraat 71,2022-08-25,17:00:00,218,104,114,FMN GV 11 Ramsel
66,Bergstraat 71,2022-08-25,18:00:00,106,30,76,FMN GV 11 Ramsel
66,Bergstraat 71,2022-08-25,19:00:00,124,68,56,FMN GV 11 Ramsel
66,Bergstraat 71,2022-08-25,20:00:00,88,62,26,FMN GV 11 Ramsel
66,Bergstraat 71,2022-08-25,21:00:00,46,24,22,FMN GV 11 Ramsel
66,Bergstraat 71,2022-08-25,22:00:00,30,26,4,FMN GV 11 Ramsel
66,Bergstraat 71,2022-08-25,23:00:00,22,20,2,FMN GV 11 Ramsel
66,Bergstraat 71,2022-08-26,00:00:00,14,12,2,FMN GV 11 Ramsel
66,Bergstraat 71,2022-08-26,01:00:00,14,14,0,FMN GV 11 Ramsel
66,Bergstraat 71,2022-08-26,02:00:00,2,2,0,FMN GV 11 Ramsel
66,Bergstraat 71,2022-08-26,03:00:00,0,0,0,FMN GV 11 Ramsel
66,Bergstraat 71,2022-08-26,04:00:00,10,6,4,FMN GV 11 Ramsel
66,Bergstraat 71,2022-08-26,05:00:00,4,2,2,FMN GV 11 Ramsel
66,Bergstraat 71,2022-08-26,06:00:00,22,12,10,FMN GV 11 Ramsel
66,Bergstraat 71,2022-08-26,07:00:00,62,22,40,FMN GV 11 Ramsel
66,Bergstraat 71,2022-08-26,08:00:00,60,20,40,FMN GV 11 Ramsel
66,Bergstraat 71,2022-08-26,09:00:00,74,34,40,FMN GV 11 Ramsel
66,Bergstraat 71,2022-08-26,10:00:00,62,28,34,FMN GV 11 Ramsel
66,Bergstraat 71,2022-08-26,11:00:00,84,42,42,FMN GV 11 Ramsel
66,Bergstraat 71,2022-08-26,12:00:00,86,44,42,FMN GV 11 Ramsel
66,Bergstraat 71,2022-08-26,13:00:00,106,76,30,FMN GV 11 Ramsel
66,Bergstraat 71,2022-08-26,14:00:00,118,62,56,FMN GV 11 Ramsel
66,Bergstraat 71,2022-08-26,15:00:00,118,54,64,FMN GV 11 Ramsel
66,Bergstraat 71,2022-08-26,16:00:00,128,72,56,FMN GV 11 Ramsel
66,Bergstraat 71,2022-08-26,17:00:00,102,64,38,FMN GV 11 Ramsel
66,Bergstraat 71,2022-08-26,18:00:00,80,42,38,FMN GV 11 Ramsel
66,Bergstraat 71,2022-08-26,19:00:00,86,26,60,FMN GV 11 Ramsel
66,Bergstraat 71,2022-08-26,20:00:00,52,22,30,FMN GV 11 Ramsel
66,Bergstraat 71,2022-08-26,21:00:00,46,22,24,FMN GV 11 Ramsel
66,Bergstraat 71,2022-08-26,22:00:00,12,6,6,FMN GV 11 Ramsel
66,Bergstraat 71,2022-08-26,23:00:00,6,2,4,FMN GV 11 Ramsel
66,Bergstraat 71,2022-08-27,00:00:00,2,0,2,FMN GV 11 Ramsel
66,Bergstraat 71,2022-08-27,01:00:00,8,6,2,FMN GV 11 Ramsel
66,Bergstraat 71,2022-08-27,02:00:00,4,4,0,FMN GV 11 Ramsel
66,Bergstraat 71,2022-08-27,03:00:00,0,0,0,FMN GV 11 Ramsel
66,Bergstraat 71,2022-08-27,04:00:00,4,2,2,FMN GV 11 Ramsel
66,Bergstraat 71,2022-08-27,05:00:00,6,4,2,FMN GV 11 Ramsel
66,Bergstraat 71,2022-08-27,06:00:00,12,4,8,FMN GV 11 Ramsel
66,Bergstraat 71,2022-08-27,07:00:00,20,8,12,FMN GV 11 Ramsel
66,Bergstraat 71,2022-08-27,08:00:00,52,18,34,FMN GV 11 Ramsel
66,Bergstraat 71,2022-08-27,09:00:00,98,38,60,FMN GV 11 Ramsel
66,Bergstraat 71,2022-08-27,10:00:00,122,56,66,FMN GV 11 Ramsel
66,Bergstraat 71,2022-08-27,11:00:00,154,82,72,FMN GV 11 Ramsel
66,Bergstraat 71,2022-08-27,12:00:00,196,92,104,FMN GV 11 Ramsel
66,Bergstraat 71,2022-08-27,13:00:00,208,86,122,FMN GV 11 Ramsel
66,Bergstraat 71,2022-08-27,14:00:00,210,114,96,FMN GV 11 Ramsel
66,Bergstraat 71,2022-08-27,15:00:00,214,126,88,FMN GV 11 Ramsel
66,Bergstraat 71,2022-08-27,16:00:00,188,90,98,FMN GV 11 Ramsel
66,Bergstraat 71,2022-08-27,17:00:00,152,72,80,FMN GV 11 Ramsel
66,Bergstraat 71,2022-08-27,18:00:00,74,34,40,FMN GV 11 Ramsel
66,Bergstraat 71,2022-08-27,19:00:00,72,42,30,FMN GV 11 Ramsel
66,Bergstraat 71,2022-08-27,20:00:00,58,24,34,FMN GV 11 Ramsel
66,Bergstraat 71,2022-08-27,21:00:00,38,8,30,FMN GV 11 Ramsel
66,Bergstraat 71,2022-08-27,22:00:00,10,4,6,FMN GV 11 Ramsel
66,Bergstraat 71,2022-08-27,23:00:00,8,4,4,FMN GV 11 Ramsel
66,Bergstraat 71,2022-08-28,00:00:00,18,18,0,FMN GV 11 Ramsel
66,Bergstraat 71,2022-08-28,01:00:00,6,2,4,FMN GV 11 Ramsel
66,Bergstraat 71,2022-08-28,02:00:00,6,6,0,FMN GV 11 Ramsel
66,Bergstraat 71,2022-08-28,03:00:00,2,2,0,FMN GV 11 Ramsel
66,Bergstraat 71,2022-08-28,04:00:00,8,6,2,FMN GV 11 Ramsel
66,Bergstraat 71,2022-08-28,05:00:00,8,4,4,FMN GV 11 Ramsel
66,Bergstraat 71,2022-08-28,06:00:00,10,2,8,FMN GV 11 Ramsel
66,Bergstraat 71,2022-08-28,07:00:00,32,12,20,FMN GV 11 Ramsel
66,Bergstraat 71,2022-08-28,08:00:00,70,20,50,FMN GV 11 Ramsel
66,Bergstraat 71,2022-08-28,09:00:00,88,32,56,FMN GV 11 Ramsel
66,Bergstraat 71,2022-08-28,10:00:00,224,134,90,FMN GV 11 Ramsel
66,Bergstraat 71,2022-08-28,11:00:00,176,98,78,FMN GV 11 Ramsel
66,Bergstraat 71,2022-08-28,12:00:00,168,94,74,FMN GV 11 Ramsel
66,Bergstraat 71,2022-08-28,13:00:00,196,94,102,FMN GV 11 Ramsel
66,Bergstraat 71,2022-08-28,14:00:00,300,144,156,FMN GV 11 Ramsel
66,Bergstraat 71,2022-08-28,15:00:00,248,104,144,FMN GV 11 Ramsel
66,Bergstraat 71,2022-08-28,16:00:00,220,112,108,FMN GV 11 Ramsel
66,Bergstraat 71,2022-08-28,17:00:00,164,72,92,FMN GV 11 Ramsel
66,Bergstraat 71,2022-08-28,18:00:00,132,74,58,FMN GV 11 Ramsel
66,Bergstraat 71,2022-08-28,19:00:00,96,40,56,FMN GV 11 Ramsel
66,Bergstraat 71,2022-08-28,20:00:00,70,44,26,FMN GV 11 Ramsel
66,Bergstraat 71,2022-08-28,21:00:00,14,12,2,FMN GV 11 Ramsel
66,Bergstraat 71,2022-08-28,22:00:00,6,4,2,FMN GV 11 Ramsel
66,Bergstraat 71,2022-08-28,23:00:00,12,6,6,FMN GV 11 Ramsel
66,Bergstraat 71,2022-08-29,00:00:00,6,6,0,FMN GV 11 Ramsel
66,Bergstraat 71,2022-08-29,01:00:00,2,2,0,FMN GV 11 Ramsel
66,Bergstraat 71,2022-08-29,02:00:00,4,4,0,FMN GV 11 Ramsel
66,Bergstraat 71,2022-08-29,03:00:00,2,0,2,FMN GV 11 Ramsel
66,Bergstraat 71,2022-08-29,04:00:00,8,8,0,FMN GV 11 Ramsel
66,Bergstraat 71,2022-08-29,05:00:00,12,8,4,FMN GV 11 Ramsel
66,Bergstraat 71,2022-08-29,06:00:00,42,14,28,FMN GV 11 Ramsel
66,Bergstraat 71,2022-08-29,07:00:00,66,24,42,FMN GV 11 Ramsel
66,Bergstraat 71,2022-08-29,08:00:00,104,38,66,FMN GV 11 Ramsel
66,Bergstraat 71,2022-08-29,09:00:00,56,22,34,FMN GV 11 Ramsel
66,Bergstraat 71,2022-08-29,10:00:00,60,30,30,FMN GV 11 Ramsel
66,Bergstraat 71,2022-08-29,11:00:00,96,42,54,FMN GV 11 Ramsel
66,Bergstraat 71,2022-08-29,12:00:00,112,58,54,FMN GV 11 Ramsel
66,Bergstraat 71,2022-08-29,13:00:00,208,90,118,FMN GV 11 Ramsel
66,Bergstraat 71,2022-08-29,14:00:00,264,122,142,FMN GV 11 Ramsel
66,Bergstraat 71,2022-08-29,15:00:00,272,110,162,FMN GV 11 Ramsel
66,Bergstraat 71,2022-08-29,16:00:00,206,132,74,FMN GV 11 Ramsel
66,Bergstraat 71,2022-08-29,17:00:00,182,110,72,FMN GV 11 Ramsel
66,Bergstraat 71,2022-08-29,18:00:00,104,54,50,FMN GV 11 Ramsel
66,Bergstraat 71,2022-08-29,19:00:00,104,58,46,FMN GV 11 Ramsel
66,Bergstraat 71,2022-08-29,20:00:00,68,42,26,FMN GV 11 Ramsel
66,Bergstraat 71,2022-08-29,21:00:00,32,12,20,FMN GV 11 Ramsel
66,Bergstraat 71,2022-08-29,22:00:00,26,20,6,FMN GV 11 Ramsel
66,Bergstraat 71,2022-08-29,23:00:00,4,4,0,FMN GV 11 Ramsel
66,Bergstraat 71,2022-08-30,00:00:00,6,0,6,FMN GV 11 Ramsel
66,Bergstraat 71,2022-08-30,01:00:00,0,0,0,FMN GV 11 Ramsel
66,Bergstraat 71,2022-08-30,02:00:00,0,0,0,FMN GV 11 Ramsel
66,Bergstraat 71,2022-08-30,03:00:00,0,0,0,FMN GV 11 Ramsel
66,Bergstraat 71,2022-08-30,04:00:00,8,8,0,FMN GV 11 Ramsel
66,Bergstraat 71,2022-08-30,05:00:00,14,8,6,FMN GV 11 Ramsel
66,Bergstraat 71,2022-08-30,06:00:00,50,14,36,FMN GV 11 Ramsel
66,Bergstraat 71,2022-08-30,07:00:00,80,40,40,FMN GV 11 Ramsel
66,Bergstraat 71,2022-08-30,08:00:00,84,18,66,FMN GV 11 Ramsel
66,Bergstraat 71,2022-08-30,09:00:00,82,24,58,FMN GV 11 Ramsel
66,Bergstraat 71,2022-08-30,10:00:00,104,42,62,FMN GV 11 Ramsel
66,Bergstraat 71,2022-08-30,11:00:00,92,42,50,FMN GV 11 Ramsel
66,Bergstraat 71,2022-08-30,12:00:00,152,66,86,FMN GV 11 Ramsel
66,Bergstraat 71,2022-08-30,13:00:00,162,68,94,FMN GV 11 Ramsel
66,Bergstraat 71,2022-08-30,14:00:00,274,138,136,FMN GV 11 Ramsel
66,Bergstraat 71,2022-08-30,15:00:00,266,140,126,FMN GV 11 Ramsel
66,Bergstraat 71,2022-08-30,16:00:00,226,124,102,FMN GV 11 Ramsel
66,Bergstraat 71,2022-08-30,17:00:00,178,94,84,FMN GV 11 Ramsel
66,Bergstraat 71,2022-08-30,18:00:00,192,86,106,FMN GV 11 Ramsel
66,Bergstraat 71,2022-08-30,19:00:00,150,54,96,FMN GV 11 Ramsel
66,Bergstraat 71,2022-08-30,20:00:00,140,106,34,FMN GV 11 Ramsel
66,Bergstraat 71,2022-08-30,21:00:00,58,46,12,FMN GV 11 Ramsel
66,Bergstraat 71,2022-08-30,22:00:00,44,38,6,FMN GV 11 Ramsel
66,Bergstraat 71,2022-08-30,23:00:00,22,18,4,FMN GV 11 Ramsel
66,Bergstraat 71,2022-08-31,00:00:00,6,6,0,FMN GV 11 Ramsel
66,Bergstraat 71,2022-08-31,01:00:00,2,0,2,FMN GV 11 Ramsel
66,Bergstraat 71,2022-08-31,02:00:00,0,0,0,FMN GV 11 Ramsel
66,Bergstraat 71,2022-08-31,03:00:00,6,4,2,FMN GV 11 Ramsel
66,Bergstraat 71,2022-08-31,04:00:00,8,6,2,FMN GV 11 Ramsel
66,Bergstraat 71,2022-08-31,05:00:00,26,14,12,FMN GV 11 Ramsel
66,Bergstraat 71,2022-08-31,06:00:00,42,20,22,FMN GV 11 Ramsel
66,Bergstraat 71,2022-08-31,07:00:00,76,28,48,FMN GV 11 Ramsel
66,Bergstraat 71,2022-08-31,08:00:00,68,22,46,FMN GV 11 Ramsel
66,Bergstraat 71,2022-08-31,09:00:00,84,30,54,FMN GV 11 Ramsel
66,Bergstraat 71,2022-08-31,10:00:00,130,54,76,FMN GV 11 Ramsel
66,Bergstraat 71,2022-08-31,11:00:00,118,60,58,FMN GV 11 Ramsel
66,Bergstraat 71,2022-08-31,12:00:00,166,78,88,FMN GV 11 Ramsel
66,Bergstraat 71,2022-08-31,13:00:00,270,164,106,FMN GV 11 Ramsel
66,Bergstraat 71,2022-08-31,14:00:00,234,108,126,FMN GV 11 Ramsel
66,Bergstraat 71,2022-08-31,15:00:00,220,100,120,FMN GV 11 Ramsel
66,Bergstraat 71,2022-08-31,16:00:00,258,152,106,FMN GV 11 Ramsel
66,Bergstraat 71,2022-08-31,17:00:00,188,92,96,FMN GV 11 Ramsel
66,Bergstraat 71,2022-08-31,18:00:00,136,72,64,FMN GV 11 Ramsel
66,Bergstraat 71,2022-08-31,19:00:00,156,98,58,FMN GV 11 Ramsel
66,Bergstraat 71,2022-08-31,20:00:00,94,48,46,FMN GV 11 Ramsel
66,Bergstraat 71,2022-08-31,21:00:00,32,16,16,FMN GV 11 Ramsel
66,Bergstraat 71,2022-08-31,22:00:00,28,24,4,FMN GV 11 Ramsel
66,Bergstraat 71,2022-08-31,23:00:00,6,4,2,FMN GV 11 Ramsel
66,Bergstraat 71,2022-09-01,00:00:00,4,4,0,FMN GV 11 Ramsel
66,Bergstraat 71,2022-09-01,01:00:00,2,2,0,FMN GV 11 Ramsel
66,Bergstraat 71,2022-09-01,02:00:00,2,2,0,FMN GV 11 Ramsel
66,Bergstraat 71,2022-09-01,03:00:00,2,0,2,FMN GV 11 Ramsel
66,Bergstraat 71,2022-09-01,04:00:00,8,6,2,FMN GV 11 Ramsel
66,Bergstraat 71,2022-09-01,05:00:00,22,10,12,FMN GV 11 Ramsel
66,Bergstraat 71,2022-09-01,06:00:00,46,18,28,FMN GV 11 Ramsel
66,Bergstraat 71,2022-09-01,07:00:00,218,40,178,FMN GV 11 Ramsel
66,Bergstraat 71,2022-09-01,08:00:00,298,50,248,FMN GV 11 Ramsel
66,Bergstraat 71,2022-09-01,09:00:00,184,26,158,FMN GV 11 Ramsel
66,Bergstraat 71,2022-09-01,10:00:00,136,54,82,FMN GV 11 Ramsel
66,Bergstraat 71,2022-09-01,11:00:00,140,70,70,FMN GV 11 Ramsel
66,Bergstraat 71,2022-09-01,12:00:00,318,260,58,FMN GV 11 Ramsel
66,Bergstraat 71,2022-09-01,13:00:00,252,134,118,FMN GV 11 Ramsel
66,Bergstraat 71,2022-09-01,14:00:00,266,140,126,FMN GV 11 Ramsel
66,Bergstraat 71,2022-09-01,15:00:00,368,262,106,FMN GV 11 Ramsel
66,Bergstraat 71,2022-09-01,16:00:00,246,144,102,FMN GV 11 Ramsel
66,Bergstraat 71,2022-09-01,17:00:00,210,126,84,FMN GV 11 Ramsel
66,Bergstraat 71,2022-09-01,18:00:00,128,58,70,FMN GV 11 Ramsel
66,Bergstraat 71,2022-09-01,19:00:00,116,54,62,FMN GV 11 Ramsel
66,Bergstraat 71,2022-09-01,20:00:00,58,34,24,FMN GV 11 Ramsel
66,Bergstraat 71,2022-09-01,21:00:00,30,18,12,FMN GV 11 Ramsel
66,Bergstraat 71,2022-09-01,22:00:00,30,20,10,FMN GV 11 Ramsel
66,Bergstraat 71,2022-09-01,23:00:00,12,8,4,FMN GV 11 Ramsel
66,Bergstraat 71,2022-09-02,00:00:00,2,2,0,FMN GV 11 Ramsel
66,Bergstraat 71,2022-09-02,01:00:00,6,4,2,FMN GV 11 Ramsel
66,Bergstraat 71,2022-09-02,02:00:00,2,2,0,FMN GV 11 Ramsel
66,Bergstraat 71,2022-09-02,03:00:00,2,0,2,FMN GV 11 Ramsel
66,Bergstraat 71,2022-09-02,04:00:00,8,6,2,FMN GV 11 Ramsel
66,Bergstraat 71,2022-09-02,05:00:00,8,2,6,FMN GV 11 Ramsel
66,Bergstraat 71,2022-09-02,06:00:00,30,10,20,FMN GV 11 Ramsel
66,Bergstraat 71,2022-09-02,07:00:00,352,40,312,FMN GV 11 Ramsel
66,Bergstraat 71,2022-09-02,08:00:00,244,46,198,FMN GV 11 Ramsel
66,Bergstraat 71,2022-09-02,09:00:00,86,44,42,FMN GV 11 Ramsel
66,Bergstraat 71,2022-09-02,10:00:00,110,54,56,FMN GV 11 Ramsel
66,Bergstraat 71,2022-09-02,11:00:00,142,72,70,FMN GV 11 Ramsel
66,Bergstraat 71,2022-09-02,12:00:00,134,72,62,FMN GV 11 Ramsel
66,Bergstraat 71,2022-09-02,13:00:00,170,72,98,FMN GV 11 Ramsel
66,Bergstraat 71,2022-09-02,14:00:00,234,102,132,FMN GV 11 Ramsel
66,Bergstraat 71,2022-09-02,15:00:00,422,332,90,FMN GV 11 Ramsel
66,Bergstraat 71,2022-09-02,16:00:00,320,230,90,FMN GV 11 Ramsel
66,Bergstraat 71,2022-09-02,17:00:00,176,122,54,FMN GV 11 Ramsel
66,Bergstraat 71,2022-09-02,18:00:00,180,76,104,FMN GV 11 Ramsel
66,Bergstraat 71,2022-09-02,19:00:00,110,56,54,FMN GV 11 Ramsel
66,Bergstraat 71,2022-09-02,20:00:00,96,46,50,FMN GV 11 Ramsel
66,Bergstraat 71,2022-09-02,21:00:00,42,28,14,FMN GV 11 Ramsel
66,Bergstraat 71,2022-09-02,22:00:00,34,26,8,FMN GV 11 Ramsel
66,Bergstraat 71,2022-09-02,23:00:00,32,22,10,FMN GV 11 Ramsel
66,Bergstraat 71,2022-09-03,00:00:00,12,8,4,FMN GV 11 Ramsel
66,Bergstraat 71,2022-09-03,01:00:00,4,4,0,FMN GV 11 Ramsel
66,Bergstraat 71,2022-09-03,02:00:00,6,6,0,FMN GV 11 Ramsel
66,Bergstraat 71,2022-09-03,03:00:00,4,4,0,FMN GV 11 Ramsel
66,Bergstraat 71,2022-09-03,04:00:00,6,6,0,FMN GV 11 Ramsel
66,Bergstraat 71,2022-09-03,05:00:00,6,4,2,FMN GV 11 Ramsel
66,Bergstraat 71,2022-09-03,06:00:00,8,2,6,FMN GV 11 Ramsel
66,Bergstraat 71,2022-09-03,07:00:00,24,8,16,FMN GV 11 Ramsel
66,Bergstraat 71,2022-09-03,08:00:00,44,12,32,FMN GV 11 Ramsel
66,Bergstraat 71,2022-09-03,09:00:00,48,24,24,FMN GV 11 Ramsel
66,Bergstraat 71,2022-09-03,10:00:00,164,84,80,FMN GV 11 Ramsel
66,Bergstraat 71,2022-09-03,11:00:00,192,124,68,FMN GV 11 Ramsel
66,Bergstraat 71,2022-09-03,12:00:00,138,88,50,FMN GV 11 Ramsel
66,Bergstraat 71,2022-09-03,13:00:00,168,76,92,FMN GV 11 Ramsel
66,Bergstraat 71,2022-09-03,14:00:00,196,98,98,FMN GV 11 Ramsel
66,Bergstraat 71,2022-09-03,15:00:00,244,124,120,FMN GV 11 Ramsel
66,Bergstraat 71,2022-09-03,16:00:00,188,90,98,FMN GV 11 Ramsel
66,Bergstraat 71,2022-09-03,17:00:00,102,54,48,FMN GV 11 Ramsel
66,Bergstraat 71,2022-09-03,18:00:00,88,40,48,FMN GV 11 Ramsel
66,Bergstraat 71,2022-09-03,19:00:00,52,28,24,FMN GV 11 Ramsel
66,Bergstraat 71,2022-09-03,20:00:00,40,18,22,FMN GV 11 Ramsel
66,Bergstraat 71,2022-09-03,21:00:00,28,18,10,FMN GV 11 Ramsel
66,Bergstraat 71,2022-09-03,22:00:00,22,16,6,FMN GV 11 Ramsel
66,Bergstraat 71,2022-09-03,23:00:00,8,8,0,FMN GV 11 Ramsel
66,Bergstraat 71,2022-09-04,00:00:00,10,8,2,FMN GV 11 Ramsel
66,Bergstraat 71,2022-09-04,01:00:00,4,4,0,FMN GV 11 Ramsel
66,Bergstraat 71,2022-09-04,02:00:00,4,4,0,FMN GV 11 Ramsel
66,Bergstraat 71,2022-09-04,03:00:00,2,0,2,FMN GV 11 Ramsel
66,Bergstraat 71,2022-09-04,04:00:00,0,0,0,FMN GV 11 Ramsel
66,Bergstraat 71,2022-09-04,05:00:00,2,2,0,FMN GV 11 Ramsel
66,Bergstraat 71,2022-09-04,06:00:00,14,6,8,FMN GV 11 Ramsel
66,Bergstraat 71,2022-09-04,07:00:00,26,14,12,FMN GV 11 Ramsel
66,Bergstraat 71,2022-09-04,08:00:00,110,42,68,FMN GV 11 Ramsel
66,Bergstraat 71,2022-09-04,09:00:00,188,52,136,FMN GV 11 Ramsel
66,Bergstraat 71,2022-09-04,10:00:00,220,124,96,FMN GV 11 Ramsel
66,Bergstraat 71,2022-09-04,11:00:00,336,192,144,FMN GV 11 Ramsel
66,Bergstraat 71,2022-09-04,12:00:00,224,116,108,FMN GV 11 Ramsel
66,Bergstraat 71,2022-09-04,13:00:00,278,122,156,FMN GV 11 Ramsel
66,Bergstraat 71,2022-09-04,14:00:00,398,186,212,FMN GV 11 Ramsel
66,Bergstraat 71,2022-09-04,15:00:00,244,120,124,FMN GV 11 Ramsel
66,Bergstraat 71,2022-09-04,16:00:00,266,150,116,FMN GV 11 Ramsel
66,Bergstraat 71,2022-09-04,17:00:00,202,112,90,FMN GV 11 Ramsel
66,Bergstraat 71,2022-09-04,18:00:00,186,56,130,FMN GV 11 Ramsel
66,Bergstraat 71,2022-09-04,19:00:00,128,68,60,FMN GV 11 Ramsel
66,Bergstraat 71,2022-09-04,20:00:00,100,52,48,FMN GV 11 Ramsel
66,Bergstraat 71,2022-09-04,21:00:00,14,14,0,FMN GV 11 Ramsel
66,Bergstraat 71,2022-09-04,22:00:00,10,6,4,FMN GV 11 Ramsel
66,Bergstraat 71,2022-09-04,23:00:00,6,6,0,FMN GV 11 Ramsel
66,Bergstraat 71,2022-09-05,00:00:00,4,4,0,FMN GV 11 Ramsel
66,Bergstraat 71,2022-09-05,01:00:00,0,0,0,FMN GV 11 Ramsel
66,Bergstraat 71,2022-09-05,02:00:00,0,0,0,FMN GV 11 Ramsel
66,Bergstraat 71,2022-09-05,03:00:00,2,0,2,FMN GV 11 Ramsel
66,Bergstraat 71,2022-09-05,04:00:00,6,4,2,FMN GV 11 Ramsel
66,Bergstraat 71,2022-09-05,05:00:00,12,8,4,FMN GV 11 Ramsel
66,Bergstraat 71,2022-09-05,06:00:00,46,10,36,FMN GV 11 Ramsel
66,Bergstraat 71,2022-09-05,07:00:00,318,32,286,FMN GV 11 Ramsel
66,Bergstraat 71,2022-09-05,08:00:00,246,42,204,FMN GV 11 Ramsel
66,Bergstraat 71,2022-09-05,09:00:00,108,44,64,FMN GV 11 Ramsel
66,Bergstraat 71,2022-09-05,10:00:00,106,40,66,FMN GV 11 Ramsel
66,Bergstraat 71,2022-09-05,11:00:00,98,42,56,FMN GV 11 Ramsel
66,Bergstraat 71,2022-09-05,12:00:00,100,54,46,FMN GV 11 Ramsel
66,Bergstraat 71,2022-09-05,13:00:00,192,82,110,FMN GV 11 Ramsel
66,Bergstraat 71,2022-09-05,14:00:00,156,64,92,FMN GV 11 Ramsel
66,Bergstraat 71,2022-09-05,15:00:00,370,288,82,FMN GV 11 Ramsel
66,Bergstraat 71,2022-09-05,16:00:00,294,224,70,FMN GV 11 Ramsel
66,Bergstraat 71,2022-09-05,17:00:00,184,118,66,FMN GV 11 Ramsel
66,Bergstraat 71,2022-09-05,18:00:00,70,44,26,FMN GV 11 Ramsel
66,Bergstraat 71,2022-09-05,19:00:00,54,26,28,FMN GV 11 Ramsel
66,Bergstraat 71,2022-09-05,20:00:00,44,28,16,FMN GV 11 Ramsel
66,Bergstraat 71,2022-09-05,21:00:00,20,14,6,FMN GV 11 Ramsel
66,Bergstraat 71,2022-09-05,22:00:00,12,6,6,FMN GV 11 Ramsel
66,Bergstraat 71,2022-09-05,23:00:00,4,2,2,FMN GV 11 Ramsel
66,Bergstraat 71,2022-09-06,00:00:00,2,2,0,FMN GV 11 Ramsel
66,Bergstraat 71,2022-09-06,01:00:00,0,0,0,FMN GV 11 Ramsel
66,Bergstraat 71,2022-09-06,02:00:00,0,0,0,FMN GV 11 Ramsel
66,Bergstraat 71,2022-09-06,03:00:00,0,0,0,FMN GV 11 Ramsel
66,Bergstraat 71,2022-09-06,04:00:00,10,6,4,FMN GV 11 Ramsel
66,Bergstraat 71,2022-09-06,05:00:00,10,6,4,FMN GV 11 Ramsel
66,Bergstraat 71,2022-09-06,06:00:00,42,8,34,FMN GV 11 Ramsel
66,Bergstraat 71,2022-09-06,07:00:00,316,34,282,FMN GV 11 Ramsel
66,Bergstraat 71,2022-09-06,08:00:00,238,46,192,FMN GV 11 Ramsel
66,Bergstraat 71,2022-09-06,09:00:00,110,24,86,FMN GV 11 Ramsel
66,Bergstraat 71,2022-09-06,10:00:00,88,34,54,FMN GV 11 Ramsel
66,Bergstraat 71,2022-09-06,11:00:00,120,54,66,FMN GV 11 Ramsel
66,Bergstraat 71,2022-09-06,12:00:00,114,58,56,FMN GV 11 Ramsel
66,Bergstraat 71,2022-09-06,13:00:00,190,94,96,FMN GV 11 Ramsel
66,Bergstraat 71,2022-09-06,14:00:00,288,184,104,FMN GV 11 Ramsel
66,Bergstraat 71,2022-09-06,15:00:00,368,248,120,FMN GV 11 Ramsel
66,Bergstraat 71,2022-09-06,16:00:00,338,248,90,FMN GV 11 Ramsel
66,Bergstraat 71,2022-09-06,17:00:00,228,140,88,FMN GV 11 Ramsel
66,Bergstraat 71,2022-09-06,18:00:00,160,76,84,FMN GV 11 Ramsel
66,Bergstraat 71,2022-09-06,19:00:00,94,48,46,FMN GV 11 Ramsel
66,Bergstraat 71,2022-09-06,20:00:00,68,54,14,FMN GV 11 Ramsel
66,Bergstraat 71,2022-09-06,21:00:00,18,14,4,FMN GV 11 Ramsel
66,Bergstraat 71,2022-09-06,22:00:00,20,14,6,FMN GV 11 Ramsel
66,Bergstraat 71,2022-09-06,23:00:00,14,12,2,FMN GV 11 Ramsel
66,Bergstraat 71,2022-09-07,00:00:00,2,2,0,FMN GV 11 Ramsel
66,Bergstraat 71,2022-09-07,01:00:00,0,0,0,FMN GV 11 Ramsel
66,Bergstraat 71,2022-09-07,02:00:00,0,0,0,FMN GV 11 Ramsel
66,Bergstraat 71,2022-09-07,03:00:00,0,0,0,FMN GV 11 Ramsel
66,Bergstraat 71,2022-09-07,04:00:00,10,6,4,FMN GV 11 Ramsel
66,Bergstraat 71,2022-09-07,05:00:00,12,6,6,FMN GV 11 Ramsel
66,Bergstraat 71,2022-09-07,06:00:00,48,10,38,FMN GV 11 Ramsel
66,Bergstraat 71,2022-09-07,07:00:00,290,24,266,FMN GV 11 Ramsel
66,Bergstraat 71,2022-09-07,08:00:00,242,28,214,FMN GV 11 Ramsel
66,Bergstraat 71,2022-09-07,09:00:00,98,38,60,FMN GV 11 Ramsel
66,Bergstraat 71,2022-09-07,10:00:00,98,42,56,FMN GV 11 Ramsel
66,Bergstraat 71,2022-09-07,11:00:00,140,92,48,FMN GV 11 Ramsel
66,Bergstraat 71,2022-09-07,12:00:00,422,352,70,FMN GV 11 Ramsel
66,Bergstraat 71,2022-09-07,13:00:00,240,120,120,FMN GV 11 Ramsel
66,Bergstraat 71,2022-09-07,14:00:00,200,88,112,FMN GV 11 Ramsel
66,Bergstraat 71,2022-09-07,15:00:00,182,122,60,FMN GV 11 Ramsel
66,Bergstraat 71,2022-09-07,16:00:00,172,108,64,FMN GV 11 Ramsel
66,Bergstraat 71,2022-09-07,17:00:00,180,102,78,FMN GV 11 Ramsel
66,Bergstraat 71,2022-09-07,18:00:00,154,96,58,FMN GV 11 Ramsel
66,Bergstraat 71,2022-09-07,19:00:00,94,62,32,FMN GV 11 Ramsel
66,Bergstraat 71,2022-09-07,20:00:00,46,32,14,FMN GV 11 Ramsel
66,Bergstraat 71,2022-09-07,21:00:00,30,24,6,FMN GV 11 Ramsel
66,Bergstraat 71,2022-09-07,22:00:00,22,14,8,FMN GV 11 Ramsel
66,Bergstraat 71,2022-09-07,23:00:00,0,0,0,FMN GV 11 Ramsel
66,Bergstraat 71,2022-09-08,00:00:00,2,2,0,FMN GV 11 Ramsel
66,Bergstraat 71,2022-09-08,01:00:00,6,6,0,FMN GV 11 Ramsel
66,Bergstraat 71,2022-09-08,02:00:00,0,0,0,FMN GV 11 Ramsel
66,Bergstraat 71,2022-09-08,03:00:00,0,0,0,FMN GV 11 Ramsel
66,Bergstraat 71,2022-09-08,04:00:00,6,4,2,FMN GV 11 Ramsel
66,Bergstraat 71,2022-09-08,05:00:00,8,6,2,FMN GV 11 Ramsel
66,Bergstraat 71,2022-09-08,06:00:00,38,6,32,FMN GV 11 Ramsel
66,Bergstraat 71,2022-09-08,07:00:00,256,28,228,FMN GV 11 Ramsel
66,Bergstraat 71,2022-09-08,08:00:00,204,28,176,FMN GV 11 Ramsel
66,Bergstraat 71,2022-09-08,09:00:00,46,8,38,FMN GV 11 Ramsel
66,Bergstraat 71,2022-09-08,10:00:00,60,20,40,FMN GV 11 Ramsel
66,Bergstraat 71,2022-09-08,11:00:00,80,44,36,FMN GV 11 Ramsel
66,Bergstraat 71,2022-09-08,12:00:00,54,34,20,FMN GV 11 Ramsel
66,Bergstraat 71,2022-09-08,13:00:00,104,66,38,FMN GV 11 Ramsel
66,Bergstraat 71,2022-09-08,14:00:00,96,58,38,FMN GV 11 Ramsel
66,Bergstraat 71,2022-09-08,15:00:00,226,194,32,FMN GV 11 Ramsel
66,Bergstraat 71,2022-09-08,16:00:00,186,158,28,FMN GV 11 Ramsel
66,Bergstraat 71,2022-09-08,17:00:00,72,42,30,FMN GV 11 Ramsel
66,Bergstraat 71,2022-09-08,18:00:00,76,30,46,FMN GV 11 Ramsel
66,Bergstraat 71,2022-09-08,19:00:00,44,28,16,FMN GV 11 Ramsel
66,Bergstraat 71,2022-09-08,20:00:00,40,34,6,FMN GV 11 Ramsel
66,Bergstraat 71,2022-09-08,21:00:00,12,12,0,FMN GV 11 Ramsel
66,Bergstraat 71,2022-09-08,22:00:00,14,6,8,FMN GV 11 Ramsel
66,Bergstraat 71,2022-09-08,23:00:00,0,0,0,FMN GV 11 Ramsel
66,Bergstraat 71,2022-09-09,00:00:00,2,0,2,FMN GV 11 Ramsel
66,Bergstraat 71,2022-09-09,01:00:00,2,0,2,FMN GV 11 Ramsel
66,Bergstraat 71,2022-09-09,02:00:00,2,2,0,FMN GV 11 Ramsel
66,Bergstraat 71,2022-09-09,03:00:00,0,0,0,FMN GV 11 Ramsel
66,Bergstraat 71,2022-09-09,04:00:00,4,4,0,FMN GV 11 Ramsel
66,Bergstraat 71,2022-09-09,05:00:00,8,4,4,FMN GV 11 Ramsel
66,Bergstraat 71,2022-09-09,06:00:00,28,6,22,FMN GV 11 Ramsel
66,Bergstraat 71,2022-09-09,07:00:00,206,32,174,FMN GV 11 Ramsel
66,Bergstraat 71,2022-09-09,08:00:00,218,32,186,FMN GV 11 Ramsel
66,Bergstraat 71,2022-09-09,09:00:00,56,16,40,FMN GV 11 Ramsel
66,Bergstraat 71,2022-09-09,10:00:00,22,18,4,FMN GV 11 Ramsel
66,Bergstraat 71,2022-09-09,11:00:00,36,16,20,FMN GV 11 Ramsel
66,Bergstraat 71,2022-09-09,12:00:00,44,30,14,FMN GV 11 Ramsel
66,Bergstraat 71,2022-09-09,13:00:00,32,16,16,FMN GV 11 Ramsel
66,Bergstraat 71,2022-09-09,14:00:00,76,54,22,FMN GV 11 Ramsel
66,Bergstraat 71,2022-09-09,15:00:00,242,208,34,FMN GV 11 Ramsel
66,Bergstraat 71,2022-09-09,16:00:00,158,120,38,FMN GV 11 Ramsel
66,Bergstraat 71,2022-09-09,17:00:00,72,50,22,FMN GV 11 Ramsel
66,Bergstraat 71,2022-09-09,18:00:00,40,18,22,FMN GV 11 Ramsel
66,Bergstraat 71,2022-09-09,19:00:00,50,14,36,FMN GV 11 Ramsel
66,Bergstraat 71,2022-09-09,20:00:00,26,18,8,FMN GV 11 Ramsel
66,Bergstraat 71,2022-09-09,21:00:00,16,6,10,FMN GV 11 Ramsel
66,Bergstraat 71,2022-09-09,22:00:00,24,14,10,FMN GV 11 Ramsel
66,Bergstraat 71,2022-09-09,23:00:00,14,0,14,FMN GV 11 Ramsel
66,Bergstraat 71,2022-09-10,00:00:00,0,0,0,FMN GV 11 Ramsel
66,Bergstraat 71,2022-09-10,01:00:00,0,0,0,FMN GV 11 Ramsel
66,Bergstraat 71,2022-09-10,02:00:00,8,8,0,FMN GV 11 Ramsel
66,Bergstraat 71,2022-09-10,03:00:00,16,16,0,FMN GV 11 Ramsel
66,Bergstraat 71,2022-09-10,04:00:00,2,2,0,FMN GV 11 Ramsel
66,Bergstraat 71,2022-09-10,05:00:00,2,2,0,FMN GV 11 Ramsel
66,Bergstraat 71,2022-09-10,06:00:00,0,0,0,FMN GV 11 Ramsel
66,Bergstraat 71,2022-09-10,07:00:00,2,0,2,FMN GV 11 Ramsel
66,Bergstraat 71,2022-09-10,08:00:00,8,2,6,FMN GV 11 Ramsel
66,Bergstraat 71,2022-09-10,09:00:00,8,8,0,FMN GV 11 Ramsel
66,Bergstraat 71,2022-09-10,10:00:00,18,6,12,FMN GV 11 Ramsel
66,Bergstraat 71,2022-09-10,11:00:00,16,6,10,FMN GV 11 Ramsel
66,Bergstraat 71,2022-09-10,12:00:00,18,8,10,FMN GV 11 Ramsel
66,Bergstraat 71,2022-09-10,13:00:00,24,12,12,FMN GV 11 Ramsel
66,Bergstraat 71,2022-09-10,14:00:00,44,14,30,FMN GV 11 Ramsel
66,Bergstraat 71,2022-09-10,15:00:00,68,38,30,FMN GV 11 Ramsel
66,Bergstraat 71,2022-09-10,16:00:00,18,14,4,FMN GV 11 Ramsel
66,Bergstraat 71,2022-09-10,17:00:00,62,30,32,FMN GV 11 Ramsel
66,Bergstraat 71,2022-09-10,18:00:00,46,18,28,FMN GV 11 Ramsel
66,Bergstraat 71,2022-09-10,19:00:00,20,10,10,FMN GV 11 Ramsel
66,Bergstraat 71,2022-09-10,20:00:00,24,12,12,FMN GV 11 Ramsel
66,Bergstraat 71,2022-09-10,21:00:00,18,8,10,FMN GV 11 Ramsel
66,Bergstraat 71,2022-09-10,22:00:00,20,14,6,FMN GV 11 Ramsel
66,Bergstraat 71,2022-09-10,23:00:00,14,6,8,FMN GV 11 Ramsel
66,Bergstraat 71,2022-09-11,00:00:00,10,6,4,FMN GV 11 Ramsel
66,Bergstraat 71,2022-09-11,01:00:00,2,2,0,FMN GV 11 Ramsel
66,Bergstraat 71,2022-09-11,02:00:00,2,2,0,FMN GV 11 Ramsel
66,Bergstraat 71,2022-09-11,03:00:00,0,0,0,FMN GV 11 Ramsel
66,Bergstraat 71,2022-09-11,04:00:00,0,0,0,FMN GV 11 Ramsel
66,Bergstraat 71,2022-09-11,05:00:00,6,6,0,FMN GV 11 Ramsel
66,Bergstraat 71,2022-09-11,06:00:00,2,2,0,FMN GV 11 Ramsel
66,Bergstraat 71,2022-09-11,07:00:00,10,4,6,FMN GV 11 Ramsel
66,Bergstraat 71,2022-09-11,08:00:00,42,10,32,FMN GV 11 Ramsel
66,Bergstraat 71,2022-09-11,09:00:00,134,50,84,FMN GV 11 Ramsel
66,Bergstraat 71,2022-09-11,10:00:00,132,80,52,FMN GV 11 Ramsel
66,Bergstraat 71,2022-09-11,11:00:00,140,72,68,FMN GV 11 Ramsel
66,Bergstraat 71,2022-09-11,12:00:00,116,64,52,FMN GV 11 Ramsel
66,Bergstraat 71,2022-09-11,13:00:00,192,122,70,FMN GV 11 Ramsel
66,Bergstraat 71,2022-09-11,14:00:00,334,160,174,FMN GV 11 Ramsel
66,Bergstraat 71,2022-09-11,15:00:00,224,130,94,FMN GV 11 Ramsel
66,Bergstraat 71,2022-09-11,16:00:00,250,140,110,FMN GV 11 Ramsel
66,Bergstraat 71,2022-09-11,17:00:00,196,96,100,FMN GV 11 Ramsel
66,Bergstraat 71,2022-09-11,18:00:00,142,62,80,FMN GV 11 Ramsel
66,Bergstraat 71,2022-09-11,19:00:00,88,30,58,FMN GV 11 Ramsel
66,Bergstraat 71,2022-09-11,20:00:00,62,38,24,FMN GV 11 Ramsel
66,Bergstraat 71,2022-09-11,21:00:00,14,14,0,FMN GV 11 Ramsel
66,Bergstraat 71,2022-09-11,22:00:00,16,10,6,FMN GV 11 Ramsel
66,Bergstraat 71,2022-09-11,23:00:00,8,4,4,FMN GV 11 Ramsel
66,Bergstraat 71,2022-09-12,00:00:00,0,0,0,FMN GV 11 Ramsel
66,Bergstraat 71,2022-09-12,01:00:00,0,0,0,FMN GV 11 Ramsel
66,Bergstraat 71,2022-09-12,02:00:00,4,4,0,FMN GV 11 Ramsel
66,Bergstraat 71,2022-09-12,03:00:00,2,0,2,FMN GV 11 Ramsel
66,Bergstraat 71,2022-09-12,04:00:00,8,6,2,FMN GV 11 Ramsel
66,Bergstraat 71,2022-09-12,05:00:00,12,4,8,FMN GV 11 Ramsel
66,Bergstraat 71,2022-09-12,06:00:00,44,8,36,FMN GV 11 Ramsel
66,Bergstraat 71,2022-09-12,07:00:00,342,36,306,FMN GV 11 Ramsel
66,Bergstraat 71,2022-09-12,08:00:00,292,56,236,FMN GV 11 Ramsel
66,Bergstraat 71,2022-09-12,09:00:00,88,24,64,FMN GV 11 Ramsel
66,Bergstraat 71,2022-09-12,10:00:00,138,56,82,FMN GV 11 Ramsel
66,Bergstraat 71,2022-09-12,11:00:00,166,52,114,FMN GV 11 Ramsel
66,Bergstraat 71,2022-09-12,12:00:00,154,70,84,FMN GV 11 Ramsel
66,Bergstraat 71,2022-09-12,13:00:00,278,124,154,FMN GV 11 Ramsel
66,Bergstraat 71,2022-09-12,14:00:00,282,128,154,FMN GV 11 Ramsel
66,Bergstraat 71,2022-09-12,15:00:00,448,314,134,FMN GV 11 Ramsel
66,Bergstraat 71,2022-09-12,16:00:00,438,306,132,FMN GV 11 Ramsel
66,Bergstraat 71,2022-09-12,17:00:00,220,136,84,FMN GV 11 Ramsel
66,Bergstraat 71,2022-09-12,18:00:00,144,84,60,FMN GV 11 Ramsel
66,Bergstraat 71,2022-09-12,19:00:00,102,48,54,FMN GV 11 Ramsel
66,Bergstraat 71,2022-09-12,20:00:00,68,48,20,FMN GV 11 Ramsel
66,Bergstraat 71,2022-09-12,21:00:00,22,18,4,FMN GV 11 Ramsel
66,Bergstraat 71,2022-09-12,22:00:00,12,8,4,FMN GV 11 Ramsel
66,Bergstraat 71,2022-09-12,23:00:00,4,2,2,FMN GV 11 Ramsel
66,Bergstraat 71,2022-09-13,00:00:00,2,2,0,FMN GV 11 Ramsel
66,Bergstraat 71,2022-09-13,01:00:00,0,0,0,FMN GV 11 Ramsel
66,Bergstraat 71,2022-09-13,02:00:00,0,0,0,FMN GV 11 Ramsel
66,Bergstraat 71,2022-09-13,03:00:00,0,0,0,FMN GV 11 Ramsel
66,Bergstraat 71,2022-09-13,04:00:00,12,6,6,FMN GV 11 Ramsel
66,Bergstraat 71,2022-09-13,05:00:00,12,6,6,FMN GV 11 Ramsel
66,Bergstraat 71,2022-09-13,06:00:00,26,8,18,FMN GV 11 Ramsel
66,Bergstraat 71,2022-09-13,07:00:00,276,28,248,FMN GV 11 Ramsel
66,Bergstraat 71,2022-09-13,08:00:00,238,24,214,FMN GV 11 Ramsel
66,Bergstraat 71,2022-09-13,09:00:00,76,24,52,FMN GV 11 Ramsel
66,Bergstraat 71,2022-09-13,10:00:00,68,24,44,FMN GV 11 Ramsel
66,Bergstraat 71,2022-09-13,11:00:00,60,16,44,FMN GV 11 Ramsel
66,Bergstraat 71,2022-09-13,12:00:00,104,64,40,FMN GV 11 Ramsel
66,Bergstraat 71,2022-09-13,13:00:00,170,68,102,FMN GV 11 Ramsel
66,Bergstraat 71,2022-09-13,14:00:00,176,104,72,FMN GV 11 Ramsel
66,Bergstraat 71,2022-09-13,15:00:00,320,262,58,FMN GV 11 Ramsel
66,Bergstraat 71,2022-09-13,16:00:00,240,194,46,FMN GV 11 Ramsel
66,Bergstraat 71,2022-09-13,17:00:00,148,90,58,FMN GV 11 Ramsel
66,Bergstraat 71,2022-09-13,18:00:00,96,48,48,FMN GV 11 Ramsel
66,Bergstraat 71,2022-09-13,19:00:00,44,28,16,FMN GV 11 Ramsel
66,Bergstraat 71,2022-09-13,20:00:00,30,18,12,FMN GV 11 Ramsel
66,Bergstraat 71,2022-09-13,21:00:00,10,10,0,FMN GV 11 Ramsel
66,Bergstraat 71,2022-09-13,22:00:00,12,6,6,FMN GV 11 Ramsel
66,Bergstraat 71,2022-09-13,23:00:00,4,2,2,FMN GV 11 Ramsel
66,Bergstraat 71,2022-09-14,00:00:00,4,2,2,FMN GV 11 Ramsel
66,Bergstraat 71,2022-09-14,01:00:00,4,4,0,FMN GV 11 Ramsel
66,Bergstraat 71,2022-09-14,02:00:00,0,0,0,FMN GV 11 Ramsel
66,Bergstraat 71,2022-09-14,03:00:00,0,0,0,FMN GV 11 Ramsel
66,Bergstraat 71,2022-09-14,04:00:00,6,4,2,FMN GV 11 Ramsel
66,Bergstraat 71,2022-09-14,05:00:00,12,6,6,FMN GV 11 Ramsel
66,Bergstraat 71,2022-09-14,06:00:00,14,4,10,FMN GV 11 Ramsel
66,Bergstraat 71,2022-09-14,07:00:00,78,16,62,FMN GV 11 Ramsel
66,Bergstraat 71,2022-09-14,08:00:00,52,10,42,FMN GV 11 Ramsel
66,Bergstraat 71,2022-09-14,09:00:00,8,2,6,FMN GV 11 Ramsel
66,Bergstraat 71,2022-09-14,10:00:00,12,2,10,FMN GV 11 Ramsel
66,Bergstraat 71,2022-09-14,11:00:00,10,8,2,FMN GV 11 Ramsel
66,Bergstraat 71,2022-09-14,12:00:00,92,90,2,FMN GV 11 Ramsel
66,Bergstraat 71,2022-09-14,13:00:00,30,18,12,FMN GV 11 Ramsel
66,Bergstraat 71,2022-09-14,14:00:00,34,10,24,FMN GV 11 Ramsel
66,Bergstraat 71,2022-09-14,15:00:00,28,14,14,FMN GV 11 Ramsel
66,Bergstraat 71,2022-09-14,16:00:00,50,32,18,FMN GV 11 Ramsel
66,Bergstraat 71,2022-09-14,17:00:00,74,32,42,FMN GV 11 Ramsel
66,Bergstraat 71,2022-09-14,18:00:00,28,18,10,FMN GV 11 Ramsel
66,Bergstraat 71,2022-09-14,19:00:00,20,8,12,FMN GV 11 Ramsel
66,Bergstraat 71,2022-09-14,20:00:00,16,6,10,FMN GV 11 Ramsel
66,Bergstraat 71,2022-09-14,21:00:00,16,10,6,FMN GV 11 Ramsel
66,Bergstraat 71,2022-09-14,22:00:00,10,6,4,FMN GV 11 Ramsel
66,Bergstraat 71,2022-09-14,23:00:00,0,0,0,FMN GV 11 Ramsel
66,Bergstraat 71,2022-09-15,00:00:00,4,2,2,FMN GV 11 Ramsel
66,Bergstraat 71,2022-09-15,01:00:00,2,2,0,FMN GV 11 Ramsel
66,Bergstraat 71,2022-09-15,02:00:00,0,0,0,FMN GV 11 Ramsel
66,Bergstraat 71,2022-09-15,03:00:00,2,2,0,FMN GV 11 Ramsel
66,Bergstraat 71,2022-09-15,04:00:00,8,4,4,FMN GV 11 Ramsel
66,Bergstraat 71,2022-09-15,05:00:00,18,12,6,FMN GV 11 Ramsel
66,Bergstraat 71,2022-09-15,06:00:00,40,14,26,FMN GV 11 Ramsel
66,Bergstraat 71,2022-09-15,07:00:00,154,16,138,FMN GV 11 Ramsel
66,Bergstraat 71,2022-09-15,08:00:00,130,28,102,FMN GV 11 Ramsel
66,Bergstraat 71,2022-09-15,09:00:00,78,12,66,FMN GV 11 Ramsel
66,Bergstraat 71,2022-09-15,10:00:00,70,34,36,FMN GV 11 Ramsel
66,Bergstraat 71,2022-09-15,11:00:00,80,54,26,FMN GV 11 Ramsel
66,Bergstraat 71,2022-09-15,12:00:00,74,50,24,FMN GV 11 Ramsel
66,Bergstraat 71,2022-09-15,13:00:00,124,52,72,FMN GV 11 Ramsel
66,Bergstraat 71,2022-09-15,14:00:00,106,64,42,FMN GV 11 Ramsel
66,Bergstraat 71,2022-09-15,15:00:00,192,130,62,FMN GV 11 Ramsel
66,Bergstraat 71,2022-09-15,16:00:00,178,134,44,FMN GV 11 Ramsel
66,Bergstraat 71,2022-09-15,17:00:00,120,62,58,FMN GV 11 Ramsel
66,Bergstraat 71,2022-09-15,18:00:00,82,42,40,FMN GV 11 Ramsel
66,Bergstraat 71,2022-09-15,19:00:00,82,40,42,FMN GV 11 Ramsel
66,Bergstraat 71,2022-09-15,20:00:00,52,42,10,FMN GV 11 Ramsel
66,Bergstraat 71,2022-09-15,21:00:00,20,10,10,FMN GV 11 Ramsel
66,Bergstraat 71,2022-09-15,22:00:00,20,14,6,FMN GV 11 Ramsel
66,Bergstraat 71,2022-09-15,23:00:00,0,0,0,FMN GV 11 Ramsel
66,Bergstraat 71,2022-09-16,00:00:00,4,4,0,FMN GV 11 Ramsel
66,Bergstraat 71,2022-09-16,01:00:00,4,4,0,FMN GV 11 Ramsel
66,Bergstraat 71,2022-09-16,02:00:00,0,0,0,FMN GV 11 Ramsel
66,Bergstraat 71,2022-09-16,03:00:00,4,4,0,FMN GV 11 Ramsel
66,Bergstraat 71,2022-09-16,04:00:00,4,4,0,FMN GV 11 Ramsel
66,Bergstraat 71,2022-09-16,05:00:00,8,4,4,FMN GV 11 Ramsel
66,Bergstraat 71,2022-09-16,06:00:00,24,6,18,FMN GV 11 Ramsel
66,Bergstraat 71,2022-09-16,07:00:00,192,22,170,FMN GV 11 Ramsel
66,Bergstraat 71,2022-09-16,08:00:00,170,18,152,FMN GV 11 Ramsel
66,Bergstraat 71,2022-09-16,09:00:00,22,6,16,FMN GV 11 Ramsel
66,Bergstraat 71,2022-09-16,10:00:00,20,10,10,FMN GV 11 Ramsel
66,Bergstraat 71,2022-09-16,11:00:00,16,6,10,FMN GV 11 Ramsel
66,Bergstraat 71,2022-09-16,12:00:00,24,18,6,FMN GV 11 Ramsel
66,Bergstraat 71,2022-09-16,13:00:00,22,14,8,FMN GV 11 Ramsel
66,Bergstraat 71,2022-09-16,14:00:00,38,30,8,FMN GV 11 Ramsel
66,Bergstraat 71,2022-09-16,15:00:00,188,158,30,FMN GV 11 Ramsel
66,Bergstraat 71,2022-09-16,16:00:00,158,124,34,FMN GV 11 Ramsel
66,Bergstraat 71,2022-09-16,17:00:00,66,30,36,FMN GV 11 Ramsel
66,Bergstraat 71,2022-09-16,18:00:00,52,36,16,FMN GV 11 Ramsel
66,Bergstraat 71,2022-09-16,19:00:00,40,14,26,FMN GV 11 Ramsel
66,Bergstraat 71,2022-09-16,20:00:00,20,12,8,FMN GV 11 Ramsel
66,Bergstraat 71,2022-09-16,21:00:00,14,8,6,FMN GV 11 Ramsel
66,Bergstraat 71,2022-09-16,22:00:00,8,0,8,FMN GV 11 Ramsel
66,Bergstraat 71,2022-09-16,23:00:00,22,10,12,FMN GV 11 Ramsel
66,Bergstraat 71,2022-09-17,00:00:00,8,6,2,FMN GV 11 Ramsel
66,Bergstraat 71,2022-09-17,01:00:00,6,6,0,FMN GV 11 Ramsel
66,Bergstraat 71,2022-09-17,02:00:00,2,2,0,FMN GV 11 Ramsel
66,Bergstraat 71,2022-09-17,03:00:00,12,6,6,FMN GV 11 Ramsel
66,Bergstraat 71,2022-09-17,04:00:00,2,2,0,FMN GV 11 Ramsel
66,Bergstraat 71,2022-09-17,05:00:00,6,0,6,FMN GV 11 Ramsel
66,Bergstraat 71,2022-09-17,06:00:00,2,2,0,FMN GV 11 Ramsel
66,Bergstraat 71,2022-09-17,07:00:00,6,0,6,FMN GV 11 Ramsel
66,Bergstraat 71,2022-09-17,08:00:00,28,16,12,FMN GV 11 Ramsel
66,Bergstraat 71,2022-09-17,09:00:00,12,0,12,FMN GV 11 Ramsel
66,Bergstraat 71,2022-09-17,10:00:00,34,26,8,FMN GV 11 Ramsel
66,Bergstraat 71,2022-09-17,11:00:00,40,18,22,FMN GV 11 Ramsel
66,Bergstraat 71,2022-09-17,12:00:00,32,12,20,FMN GV 11 Ramsel
66,Bergstraat 71,2022-09-17,13:00:00,48,22,26,FMN GV 11 Ramsel
66,Bergstraat 71,2022-09-17,14:00:00,40,22,18,FMN GV 11 Ramsel
66,Bergstraat 71,2022-09-17,15:00:00,18,10,8,FMN GV 11 Ramsel
66,Bergstraat 71,2022-09-17,16:00:00,34,18,16,FMN GV 11 Ramsel
66,Bergstraat 71,2022-09-17,17:00:00,28,18,10,FMN GV 11 Ramsel
66,Bergstraat 71,2022-09-17,18:00:00,16,4,12,FMN GV 11 Ramsel
66,Bergstraat 71,2022-09-17,19:00:00,18,10,8,FMN GV 11 Ramsel
66,Bergstraat 71,2022-09-17,20:00:00,8,8,0,FMN GV 11 Ramsel
66,Bergstraat 71,2022-09-17,21:00:00,18,10,8,FMN GV 11 Ramsel
66,Bergstraat 71,2022-09-17,22:00:00,6,0,6,FMN GV 11 Ramsel
66,Bergstraat 71,2022-09-17,23:00:00,12,2,10,FMN GV 11 Ramsel
66,Bergstraat 71,2022-09-18,00:00:00,4,0,4,FMN GV 11 Ramsel
66,Bergstraat 71,2022-09-18,01:00:00,4,2,2,FMN GV 11 Ramsel
66,Bergstraat 71,2022-09-18,02:00:00,6,6,0,FMN GV 11 Ramsel
66,Bergstraat 71,2022-09-18,03:00:00,4,0,4,FMN GV 11 Ramsel
66,Bergstraat 71,2022-09-18,04:00:00,2,2,0,FMN GV 11 Ramsel
66,Bergstraat 71,2022-09-18,05:00:00,2,2,0,FMN GV 11 Ramsel
66,Bergstraat 71,2022-09-18,06:00:00,0,0,0,FMN GV 11 Ramsel
66,Bergstraat 71,2022-09-18,07:00:00,6,4,2,FMN GV 11 Ramsel
66,Bergstraat 71,2022-09-18,08:00:00,22,6,16,FMN GV 11 Ramsel
66,Bergstraat 71,2022-09-18,09:00:00,36,16,20,FMN GV 11 Ramsel
66,Bergstraat 71,2022-09-18,10:00:00,82,50,32,FMN GV 11 Ramsel
66,Bergstraat 71,2022-09-18,11:00:00,60,50,10,FMN GV 11 Ramsel
66,Bergstraat 71,2022-09-18,12:00:00,68,36,32,FMN GV 11 Ramsel
66,Bergstraat 71,2022-09-18,13:00:00,20,10,10,FMN GV 11 Ramsel
66,Bergstraat 71,2022-09-18,14:00:00,40,14,26,FMN GV 11 Ramsel
66,Bergstraat 71,2022-09-18,15:00:00,28,14,14,FMN GV 11 Ramsel
66,Bergstraat 71,2022-09-18,16:00:00,28,18,10,FMN GV 11 Ramsel
66,Bergstraat 71,2022-09-18,17:00:00,18,14,4,FMN GV 11 Ramsel
66,Bergstraat 71,2022-09-18,18:00:00,6,4,2,FMN GV 11 Ramsel
66,Bergstraat 71,2022-09-18,19:00:00,8,6,2,FMN GV 11 Ramsel
66,Bergstraat 71,2022-09-18,20:00:00,4,0,4,FMN GV 11 Ramsel
66,Bergstraat 71,2022-09-18,21:00:00,4,4,0,FMN GV 11 Ramsel
66,Bergstraat 71,2022-09-18,22:00:00,6,4,2,FMN GV 11 Ramsel
66,Bergstraat 71,2022-09-18,23:00:00,2,2,0,FMN GV 11 Ramsel
66,Bergstraat 71,2022-09-19,00:00:00,0,0,0,FMN GV 11 Ramsel
66,Bergstraat 71,2022-09-19,01:00:00,2,2,0,FMN GV 11 Ramsel
66,Bergstraat 71,2022-09-19,02:00:00,0,0,0,FMN GV 11 Ramsel
66,Bergstraat 71,2022-09-19,03:00:00,2,0,2,FMN GV 11 Ramsel
66,Bergstraat 71,2022-09-19,04:00:00,4,4,0,FMN GV 11 Ramsel
66,Bergstraat 71,2022-09-19,05:00:00,8,4,4,FMN GV 11 Ramsel
66,Bergstraat 71,2022-09-19,06:00:00,42,16,26,FMN GV 11 Ramsel
66,Bergstraat 71,2022-09-19,07:00:00,266,20,246,FMN GV 11 Ramsel
66,Bergstraat 71,2022-09-19,08:00:00,246,30,216,FMN GV 11 Ramsel
66,Bergstraat 71,2022-09-19,09:00:00,66,18,48,FMN GV 11 Ramsel
66,Bergstraat 71,2022-09-19,10:00:00,18,6,12,FMN GV 11 Ramsel
66,Bergstraat 71,2022-09-19,11:00:00,48,16,32,FMN GV 11 Ramsel
66,Bergstraat 71,2022-09-19,12:00:00,62,42,20,FMN GV 11 Ramsel
66,Bergstraat 71,2022-09-19,13:00:00,120,60,60,FMN GV 11 Ramsel
66,Bergstraat 71,2022-09-19,14:00:00,86,42,44,FMN GV 11 Ramsel
66,Bergstraat 71,2022-09-19,15:00:00,288,220,68,FMN GV 11 Ramsel
66,Bergstraat 71,2022-09-19,16:00:00,216,164,52,FMN GV 11 Ramsel
66,Bergstraat 71,2022-09-19,17:00:00,158,100,58,FMN GV 11 Ramsel
66,Bergstraat 71,2022-09-19,18:00:00,56,34,22,FMN GV 11 Ramsel
66,Bergstraat 71,2022-09-19,19:00:00,76,36,40,FMN GV 11 Ramsel
66,Bergstraat 71,2022-09-19,20:00:00,46,36,10,FMN GV 11 Ramsel
66,Bergstraat 71,2022-09-19,21:00:00,40,30,10,FMN GV 11 Ramsel
66,Bergstraat 71,2022-09-19,22:00:00,24,18,6,FMN GV 11 Ramsel
66,Bergstraat 71,2022-09-19,23:00:00,4,4,0,FMN GV 11 Ramsel
66,Bergstraat 71,2022-09-20,00:00:00,2,2,0,FMN GV 11 Ramsel
66,Bergstraat 71,2022-09-20,01:00:00,0,0,0,FMN GV 11 Ramsel
66,Bergstraat 71,2022-09-20,02:00:00,0,0,0,FMN GV 11 Ramsel
66,Bergstraat 71,2022-09-20,03:00:00,2,0,2,FMN GV 11 Ramsel
66,Bergstraat 71,2022-09-20,04:00:00,2,2,0,FMN GV 11 Ramsel
66,Bergstraat 71,2022-09-20,05:00:00,22,14,8,FMN GV 11 Ramsel
66,Bergstraat 71,2022-09-20,06:00:00,50,22,28,FMN GV 11 Ramsel
66,Bergstraat 71,2022-09-20,07:00:00,286,30,256,FMN GV 11 Ramsel
66,Bergstraat 71,2022-09-20,08:00:00,254,24,230,FMN GV 11 Ramsel
66,Bergstraat 71,2022-09-20,09:00:00,116,58,58,FMN GV 11 Ramsel
66,Bergstraat 71,2022-09-20,10:00:00,72,40,32,FMN GV 11 Ramsel
66,Bergstraat 71,2022-09-20,11:00:00,50,26,24,FMN GV 11 Ramsel
66,Bergstraat 71,2022-09-20,12:00:00,72,44,28,FMN GV 11 Ramsel
66,Bergstraat 71,2022-09-20,13:00:00,176,94,82,FMN GV 11 Ramsel
66,Bergstraat 71,2022-09-20,14:00:00,180,70,110,FMN GV 11 Ramsel
66,Bergstraat 71,2022-09-20,15:00:00,324,262,62,FMN GV 11 Ramsel
66,Bergstraat 71,2022-09-20,16:00:00,314,246,68,FMN GV 11 Ramsel
66,Bergstraat 71,2022-09-20,17:00:00,146,80,66,FMN GV 11 Ramsel
66,Bergstraat 71,2022-09-20,18:00:00,102,38,64,FMN GV 11 Ramsel
66,Bergstraat 71,2022-09-20,19:00:00,58,34,24,FMN GV 11 Ramsel
66,Bergstraat 71,2022-09-20,20:00:00,40,28,12,FMN GV 11 Ramsel
66,Bergstraat 71,2022-09-20,21:00:00,8,2,6,FMN GV 11 Ramsel
66,Bergstraat 71,2022-09-20,22:00:00,22,14,8,FMN GV 11 Ramsel
66,Bergstraat 71,2022-09-20,23:00:00,6,6,0,FMN GV 11 Ramsel
66,Bergstraat 71,2022-09-21,00:00:00,4,4,0,FMN GV 11 Ramsel
66,Bergstraat 71,2022-09-21,01:00:00,0,0,0,FMN GV 11 Ramsel
66,Bergstraat 71,2022-09-21,02:00:00,0,0,0,FMN GV 11 Ramsel
66,Bergstraat 71,2022-09-21,03:00:00,0,0,0,FMN GV 11 Ramsel
66,Bergstraat 71,2022-09-21,04:00:00,10,6,4,FMN GV 11 Ramsel
66,Bergstraat 71,2022-09-21,05:00:00,24,14,10,FMN GV 11 Ramsel
66,Bergstraat 71,2022-09-21,06:00:00,36,14,22,FMN GV 11 Ramsel
66,Bergstraat 71,2022-09-21,07:00:00,314,36,278,FMN GV 11 Ramsel
66,Bergstraat 71,2022-09-21,08:00:00,270,42,228,FMN GV 11 Ramsel
66,Bergstraat 71,2022-09-21,09:00:00,50,26,24,FMN GV 11 Ramsel
66,Bergstraat 71,2022-09-21,10:00:00,64,24,40,FMN GV 11 Ramsel
66,Bergstraat 71,2022-09-21,11:00:00,140,70,70,FMN GV 11 Ramsel
66,Bergstraat 71,2022-09-21,12:00:00,452,386,66,FMN GV 11 Ramsel
66,Bergstraat 71,2022-09-21,13:00:00,166,88,78,FMN GV 11 Ramsel
66,Bergstraat 71,2022-09-21,14:00:00,168,78,90,FMN GV 11 Ramsel
66,Bergstraat 71,2022-09-21,15:00:00,148,94,54,FMN GV 11 Ramsel
66,Bergstraat 71,2022-09-21,16:00:00,162,92,70,FMN GV 11 Ramsel
66,Bergstraat 71,2022-09-21,17:00:00,138,74,64,FMN GV 11 Ramsel
66,Bergstraat 71,2022-09-21,18:00:00,102,54,48,FMN GV 11 Ramsel
66,Bergstraat 71,2022-09-21,19:00:00,62,34,28,FMN GV 11 Ramsel
66,Bergstraat 71,2022-09-21,20:00:00,30,16,14,FMN GV 11 Ramsel
66,Bergstraat 71,2022-09-21,21:00:00,14,10,4,FMN GV 11 Ramsel
66,Bergstraat 71,2022-09-21,22:00:00,22,16,6,FMN GV 11 Ramsel
66,Bergstraat 71,2022-09-21,23:00:00,6,4,2,FMN GV 11 Ramsel
66,Bergstraat 71,2022-09-22,00:00:00,4,2,2,FMN GV 11 Ramsel
66,Bergstraat 71,2022-09-22,01:00:00,0,0,0,FMN GV 11 Ramsel
66,Bergstraat 71,2022-09-22,02:00:00,2,2,0,FMN GV 11 Ramsel
66,Bergstraat 71,2022-09-22,03:00:00,0,0,0,FMN GV 11 Ramsel
66,Bergstraat 71,2022-09-22,04:00:00,8,6,2,FMN GV 11 Ramsel
66,Bergstraat 71,2022-09-22,05:00:00,16,10,6,FMN GV 11 Ramsel
66,Bergstraat 71,2022-09-22,06:00:00,40,14,26,FMN GV 11 Ramsel
66,Bergstraat 71,2022-09-22,07:00:00,290,50,240,FMN GV 11 Ramsel
66,Bergstraat 71,2022-09-22,08:00:00,280,32,248,FMN GV 11 Ramsel
66,Bergstraat 71,2022-09-22,09:00:00,68,26,42,FMN GV 11 Ramsel
66,Bergstraat 71,2022-09-22,10:00:00,102,42,60,FMN GV 11 Ramsel
66,Bergstraat 71,2022-09-22,11:00:00,122,50,72,FMN GV 11 Ramsel
66,Bergstraat 71,2022-09-22,12:00:00,136,76,60,FMN GV 11 Ramsel
66,Bergstraat 71,2022-09-22,13:00:00,230,130,100,FMN GV 11 Ramsel
66,Bergstraat 71,2022-09-22,14:00:00,236,120,116,FMN GV 11 Ramsel
66,Bergstraat 71,2022-09-22,15:00:00,424,306,118,FMN GV 11 Ramsel
66,Bergstraat 71,2022-09-22,16:00:00,356,256,100,FMN GV 11 Ramsel
66,Bergstraat 71,2022-09-22,17:00:00,184,118,66,FMN GV 11 Ramsel
66,Bergstraat 71,2022-09-22,18:00:00,126,72,54,FMN GV 11 Ramsel
66,Bergstraat 71,2022-09-22,19:00:00,66,28,38,FMN GV 11 Ramsel
66,Bergstraat 71,2022-09-22,20:00:00,34,22,12,FMN GV 11 Ramsel
66,Bergstraat 71,2022-09-22,21:00:00,16,10,6,FMN GV 11 Ramsel
66,Bergstraat 71,2022-09-22,22:00:00,22,18,4,FMN GV 11 Ramsel
66,Bergstraat 71,2022-09-22,23:00:00,6,4,2,FMN GV 11 Ramsel
66,Bergstraat 71,2022-09-23,00:00:00,0,0,0,FMN GV 11 Ramsel
66,Bergstraat 71,2022-09-23,01:00:00,0,0,0,FMN GV 11 Ramsel
66,Bergstraat 71,2022-09-23,02:00:00,0,0,0,FMN GV 11 Ramsel
66,Bergstraat 71,2022-09-23,03:00:00,0,0,0,FMN GV 11 Ramsel
66,Bergstraat 71,2022-09-23,04:00:00,6,4,2,FMN GV 11 Ramsel
66,Bergstraat 71,2022-09-23,05:00:00,10,2,8,FMN GV 11 Ramsel
66,Bergstraat 71,2022-09-23,06:00:00,20,4,16,FMN GV 11 Ramsel
66,Bergstraat 71,2022-09-23,07:00:00,246,30,216,FMN GV 11 Ramsel
66,Bergstraat 71,2022-09-23,08:00:00,258,40,218,FMN GV 11 Ramsel
66,Bergstraat 71,2022-09-23,09:00:00,56,10,46,FMN GV 11 Ramsel
66,Bergstraat 71,2022-09-23,10:00:00,92,26,66,FMN GV 11 Ramsel
66,Bergstraat 71,2022-09-23,11:00:00,104,66,38,FMN GV 11 Ramsel
66,Bergstraat 71,2022-09-23,12:00:00,90,50,40,FMN GV 11 Ramsel
66,Bergstraat 71,2022-09-23,13:00:00,126,68,58,FMN GV 11 Ramsel
66,Bergstraat 71,2022-09-23,14:00:00,208,94,114,FMN GV 11 Ramsel
66,Bergstraat 71,2022-09-23,15:00:00,288,230,58,FMN GV 11 Ramsel
66,Bergstraat 71,2022-09-23,16:00:00,252,206,46,FMN GV 11 Ramsel
66,Bergstraat 71,2022-09-23,17:00:00,120,82,38,FMN GV 11 Ramsel
66,Bergstraat 71,2022-09-23,18:00:00,88,46,42,FMN GV 11 Ramsel
66,Bergstraat 71,2022-09-23,19:00:00,58,30,28,FMN GV 11 Ramsel
66,Bergstraat 71,2022-09-23,20:00:00,32,20,12,FMN GV 11 Ramsel
66,Bergstraat 71,2022-09-23,21:00:00,18,14,4,FMN GV 11 Ramsel
66,Bergstraat 71,2022-09-23,22:00:00,14,6,8,FMN GV 11 Ramsel
66,Bergstraat 71,2022-09-23,23:00:00,8,6,2,FMN GV 11 Ramsel
66,Bergstraat 71,2022-09-24,00:00:00,8,4,4,FMN GV 11 Ramsel
66,Bergstraat 71,2022-09-24,01:00:00,10,8,2,FMN GV 11 Ramsel
66,Bergstraat 71,2022-09-24,02:00:00,18,12,6,FMN GV 11 Ramsel
66,Bergstraat 71,2022-09-24,03:00:00,10,10,0,FMN GV 11 Ramsel
66,Bergstraat 71,2022-09-24,04:00:00,8,6,2,FMN GV 11 Ramsel
66,Bergstraat 71,2022-09-24,05:00:00,2,2,0,FMN GV 11 Ramsel
66,Bergstraat 71,2022-09-24,06:00:00,2,2,0,FMN GV 11 Ramsel
66,Bergstraat 71,2022-09-24,07:00:00,4,2,2,FMN GV 11 Ramsel
66,Bergstraat 71,2022-09-24,08:00:00,18,6,12,FMN GV 11 Ramsel
66,Bergstraat 71,2022-09-24,09:00:00,14,6,8,FMN GV 11 Ramsel
66,Bergstraat 71,2022-09-24,10:00:00,24,12,12,FMN GV 11 Ramsel
66,Bergstraat 71,2022-09-24,11:00:00,28,18,10,FMN GV 11 Ramsel
66,Bergstraat 71,2022-09-24,12:00:00,24,14,10,FMN GV 11 Ramsel
66,Bergstraat 71,2022-09-24,13:00:00,20,6,14,FMN GV 11 Ramsel
66,Bergstraat 71,2022-09-24,14:00:00,32,12,20,FMN GV 11 Ramsel
66,Bergstraat 71,2022-09-24,15:00:00,22,8,14,FMN GV 11 Ramsel
66,Bergstraat 71,2022-09-24,16:00:00,22,12,10,FMN GV 11 Ramsel
66,Bergstraat 71,2022-09-24,17:00:00,18,8,10,FMN GV 11 Ramsel
66,Bergstraat 71,2022-09-24,18:00:00,4,4,0,FMN GV 11 Ramsel
66,Bergstraat 71,2022-09-24,19:00:00,12,6,6,FMN GV 11 Ramsel
66,Bergstraat 71,2022-09-24,20:00:00,10,2,8,FMN GV 11 Ramsel
66,Bergstraat 71,2022-09-24,21:00:00,10,6,4,FMN GV 11 Ramsel
66,Bergstraat 71,2022-09-24,22:00:00,8,0,8,FMN GV 11 Ramsel
66,Bergstraat 71,2022-09-24,23:00:00,10,0,10,FMN GV 11 Ramsel
66,Bergstraat 71,2022-09-25,00:00:00,4,4,0,FMN GV 11 Ramsel
66,Bergstraat 71,2022-09-25,01:00:00,6,6,0,FMN GV 11 Ramsel
66,Bergstraat 71,2022-09-25,02:00:00,4,4,0,FMN GV 11 Ramsel
66,Bergstraat 71,2022-09-25,03:00:00,6,6,0,FMN GV 11 Ramsel
66,Bergstraat 71,2022-09-25,04:00:00,4,4,0,FMN GV 11 Ramsel
66,Bergstraat 71,2022-09-25,05:00:00,2,2,0,FMN GV 11 Ramsel
66,Bergstraat 71,2022-09-25,06:00:00,0,0,0,FMN GV 11 Ramsel
66,Bergstraat 71,2022-09-25,07:00:00,10,2,8,FMN GV 11 Ramsel
66,Bergstraat 71,2022-09-25,08:00:00,22,10,12,FMN GV 11 Ramsel
66,Bergstraat 71,2022-09-25,09:00:00,110,20,90,FMN GV 11 Ramsel
66,Bergstraat 71,2022-09-25,10:00:00,170,80,90,FMN GV 11 Ramsel
66,Bergstraat 71,2022-09-25,11:00:00,156,82,74,FMN GV 11 Ramsel
66,Bergstraat 71,2022-09-25,12:00:00,184,86,98,FMN GV 11 Ramsel
66,Bergstraat 71,2022-09-25,13:00:00,220,132,88,FMN GV 11 Ramsel
66,Bergstraat 71,2022-09-25,14:00:00,284,160,124,FMN GV 11 Ramsel
66,Bergstraat 71,2022-09-25,15:00:00,210,136,74,FMN GV 11 Ramsel
66,Bergstraat 71,2022-09-25,16:00:00,202,108,94,FMN GV 11 Ramsel
66,Bergstraat 71,2022-09-25,17:00:00,142,76,66,FMN GV 11 Ramsel
66,Bergstraat 71,2022-09-25,18:00:00,54,14,40,FMN GV 11 Ramsel
66,Bergstraat 71,2022-09-25,19:00:00,60,26,34,FMN GV 11 Ramsel
66,Bergstraat 71,2022-09-25,20:00:00,12,4,8,FMN GV 11 Ramsel
66,Bergstraat 71,2022-09-25,21:00:00,16,12,4,FMN GV 11 Ramsel
66,Bergstraat 71,2022-09-25,22:00:00,12,10,2,FMN GV 11 Ramsel
66,Bergstraat 71,2022-09-25,23:00:00,2,0,2,FMN GV 11 Ramsel
66,Bergstraat 71,2022-09-26,00:00:00,4,2,2,FMN GV 11 Ramsel
66,Bergstraat 71,2022-09-26,01:00:00,0,0,0,FMN GV 11 Ramsel
66,Bergstraat 71,2022-09-26,02:00:00,0,0,0,FMN GV 11 Ramsel
66,Bergstraat 71,2022-09-26,03:00:00,2,0,2,FMN GV 11 Ramsel
66,Bergstraat 71,2022-09-26,04:00:00,2,2,0,FMN GV 11 Ramsel
66,Bergstraat 71,2022-09-26,05:00:00,10,6,4,FMN GV 11 Ramsel
66,Bergstraat 71,2022-09-26,06:00:00,24,10,14,FMN GV 11 Ramsel
66,Bergstraat 71,2022-09-26,07:00:00,170,14,156,FMN GV 11 Ramsel
66,Bergstraat 71,2022-09-26,08:00:00,204,34,170,FMN GV 11 Ramsel
66,Bergstraat 71,2022-09-26,09:00:00,32,10,22,FMN GV 11 Ramsel
66,Bergstraat 71,2022-09-26,10:00:00,30,18,12,FMN GV 11 Ramsel
66,Bergstraat 71,2022-09-26,11:00:00,28,18,10,FMN GV 11 Ramsel
66,Bergstraat 71,2022-09-26,12:00:00,20,10,10,FMN GV 11 Ramsel
66,Bergstraat 71,2022-09-26,13:00:00,12,8,4,FMN GV 11 Ramsel
66,Bergstraat 71,2022-09-26,14:00:00,78,30,48,FMN GV 11 Ramsel
66,Bergstraat 71,2022-09-26,15:00:00,178,166,12,FMN GV 11 Ramsel
66,Bergstraat 71,2022-09-26,16:00:00,104,86,18,FMN GV 11 Ramsel
66,Bergstraat 71,2022-09-26,17:00:00,46,30,16,FMN GV 11 Ramsel
66,Bergstraat 71,2022-09-26,18:00:00,32,20,12,FMN GV 11 Ramsel
66,Bergstraat 71,2022-09-26,19:00:00,26,14,12,FMN GV 11 Ramsel
66,Bergstraat 71,2022-09-26,20:00:00,14,6,8,FMN GV 11 Ramsel
66,Bergstraat 71,2022-09-26,21:00:00,14,14,0,FMN GV 11 Ramsel
66,Bergstraat 71,2022-09-26,22:00:00,8,6,2,FMN GV 11 Ramsel
66,Bergstraat 71,2022-09-26,23:00:00,2,2,0,FMN GV 11 Ramsel
66,Bergstraat 71,2022-09-27,00:00:00,0,0,0,FMN GV 11 Ramsel
66,Bergstraat 71,2022-09-27,01:00:00,0,0,0,FMN GV 11 Ramsel
66,Bergstraat 71,2022-09-27,02:00:00,0,0,0,FMN GV 11 Ramsel
66,Bergstraat 71,2022-09-27,03:00:00,0,0,0,FMN GV 11 Ramsel
66,Bergstraat 71,2022-09-27,04:00:00,4,2,2,FMN GV 11 Ramsel
66,Bergstraat 71,2022-09-27,05:00:00,8,4,4,FMN GV 11 Ramsel
66,Bergstraat 71,2022-09-27,06:00:00,38,16,22,FMN GV 11 Ramsel
66,Bergstraat 71,2022-09-27,07:00:00,128,14,114,FMN GV 11 Ramsel
66,Bergstraat 71,2022-09-27,08:00:00,152,20,132,FMN GV 11 Ramsel
66,Bergstraat 71,2022-09-27,09:00:00,30,8,22,FMN GV 11 Ramsel
66,Bergstraat 71,2022-09-27,10:00:00,16,4,12,FMN GV 11 Ramsel
66,Bergstraat 71,2022-09-27,11:00:00,18,12,6,FMN GV 11 Ramsel
66,Bergstraat 71,2022-09-27,12:00:00,30,16,14,FMN GV 11 Ramsel
66,Bergstraat 71,2022-09-27,13:00:00,44,14,30,FMN GV 11 Ramsel
66,Bergstraat 71,2022-09-27,14:00:00,52,38,14,FMN GV 11 Ramsel
66,Bergstraat 71,2022-09-27,15:00:00,146,130,16,FMN GV 11 Ramsel
66,Bergstraat 71,2022-09-27,16:00:00,142,116,26,FMN GV 11 Ramsel
66,Bergstraat 71,2022-09-27,17:00:00,70,36,34,FMN GV 11 Ramsel
66,Bergstraat 71,2022-09-27,18:00:00,60,38,22,FMN GV 11 Ramsel
66,Bergstraat 71,2022-09-27,19:00:00,36,22,14,FMN GV 11 Ramsel
66,Bergstraat 71,2022-09-27,20:00:00,24,12,12,FMN GV 11 Ramsel
66,Bergstraat 71,2022-09-27,21:00:00,4,4,0,FMN GV 11 Ramsel
66,Bergstraat 71,2022-09-27,22:00:00,14,6,8,FMN GV 11 Ramsel
66,Bergstraat 71,2022-09-27,23:00:00,2,2,0,FMN GV 11 Ramsel
66,Bergstraat 71,2022-09-28,00:00:00,2,2,0,FMN GV 11 Ramsel
66,Bergstraat 71,2022-09-28,01:00:00,0,0,0,FMN GV 11 Ramsel
66,Bergstraat 71,2022-09-28,02:00:00,0,0,0,FMN GV 11 Ramsel
66,Bergstraat 71,2022-09-28,03:00:00,0,0,0,FMN GV 11 Ramsel
66,Bergstraat 71,2022-09-28,04:00:00,6,2,4,FMN GV 11 Ramsel
66,Bergstraat 71,2022-09-28,05:00:00,12,8,4,FMN GV 11 Ramsel
66,Bergstraat 71,2022-09-28,06:00:00,32,16,16,FMN GV 11 Ramsel
66,Bergstraat 71,2022-09-28,07:00:00,196,14,182,FMN GV 11 Ramsel
66,Bergstraat 71,2022-09-28,08:00:00,210,30,180,FMN GV 11 Ramsel
66,Bergstraat 71,2022-09-28,09:00:00,54,16,38,FMN GV 11 Ramsel
66,Bergstraat 71,2022-09-28,10:00:00,58,30,28,FMN GV 11 Ramsel
66,Bergstraat 71,2022-09-28,11:00:00,80,52,28,FMN GV 11 Ramsel
66,Bergstraat 71,2022-09-28,12:00:00,306,266,40,FMN GV 11 Ramsel
66,Bergstraat 71,2022-09-28,13:00:00,110,60,50,FMN GV 11 Ramsel
66,Bergstraat 71,2022-09-28,14:00:00,84,42,42,FMN GV 11 Ramsel
66,Bergstraat 71,2022-09-28,15:00:00,58,42,16,FMN GV 11 Ramsel
66,Bergstraat 71,2022-09-28,16:00:00,80,38,42,FMN GV 11 Ramsel
66,Bergstraat 71,2022-09-28,17:00:00,74,50,24,FMN GV 11 Ramsel
66,Bergstraat 71,2022-09-28,18:00:00,50,28,22,FMN GV 11 Ramsel
66,Bergstraat 71,2022-09-28,19:00:00,52,34,18,FMN GV 11 Ramsel
66,Bergstraat 71,2022-09-28,20:00:00,34,8,26,FMN GV 11 Ramsel
66,Bergstraat 71,2022-09-28,21:00:00,14,14,0,FMN GV 11 Ramsel
66,Bergstraat 71,2022-09-28,22:00:00,18,16,2,FMN GV 11 Ramsel
66,Bergstraat 71,2022-09-28,23:00:00,2,2,0,FMN GV 11 Ramsel
66,Bergstraat 71,2022-09-29,00:00:00,2,2,0,FMN GV 11 Ramsel
66,Bergstraat 71,2022-09-29,01:00:00,0,0,0,FMN GV 11 Ramsel
66,Bergstraat 71,2022-09-29,02:00:00,0,0,0,FMN GV 11 Ramsel
66,Bergstraat 71,2022-09-29,03:00:00,0,0,0,FMN GV 11 Ramsel
66,Bergstraat 71,2022-09-29,04:00:00,6,2,4,FMN GV 11 Ramsel
66,Bergstraat 71,2022-09-29,05:00:00,10,4,6,FMN GV 11 Ramsel
66,Bergstraat 71,2022-09-29,06:00:00,32,14,18,FMN GV 11 Ramsel
66,Bergstraat 71,2022-09-29,07:00:00,232,28,204,FMN GV 11 Ramsel
66,Bergstraat 71,2022-09-29,08:00:00,226,26,200,FMN GV 11 Ramsel
66,Bergstraat 71,2022-09-29,09:00:00,50,18,32,FMN GV 11 Ramsel
66,Bergstraat 71,2022-09-29,10:00:00,56,14,42,FMN GV 11 Ramsel
66,Bergstraat 71,2022-09-29,11:00:00,86,44,42,FMN GV 11 Ramsel
66,Bergstraat 71,2022-09-29,12:00:00,110,42,68,FMN GV 11 Ramsel
66,Bergstraat 71,2022-09-29,13:00:00,140,66,74,FMN GV 11 Ramsel
66,Bergstraat 71,2022-09-29,14:00:00,142,78,64,FMN GV 11 Ramsel
66,Bergstraat 71,2022-09-29,15:00:00,344,270,74,FMN GV 11 Ramsel
66,Bergstraat 71,2022-09-29,16:00:00,238,194,44,FMN GV 11 Ramsel
66,Bergstraat 71,2022-09-29,17:00:00,116,76,40,FMN GV 11 Ramsel
66,Bergstraat 71,2022-09-29,18:00:00,86,56,30,FMN GV 11 Ramsel
66,Bergstraat 71,2022-09-29,19:00:00,50,24,26,FMN GV 11 Ramsel
66,Bergstraat 71,2022-09-29,20:00:00,38,32,6,FMN GV 11 Ramsel
66,Bergstraat 71,2022-09-29,21:00:00,12,12,0,FMN GV 11 Ramsel
66,Bergstraat 71,2022-09-29,22:00:00,18,12,6,FMN GV 11 Ramsel
66,Bergstraat 71,2022-09-29,23:00:00,0,0,0,FMN GV 11 Ramsel
66,Bergstraat 71,2022-09-30,00:00:00,2,0,2,FMN GV 11 Ramsel
66,Bergstraat 71,2022-09-30,01:00:00,0,0,0,FMN GV 11 Ramsel
66,Bergstraat 71,2022-09-30,02:00:00,2,2,0,FMN GV 11 Ramsel
66,Bergstraat 71,2022-09-30,03:00:00,0,0,0,FMN GV 11 Ramsel
66,Bergstraat 71,2022-09-30,04:00:00,2,2,0,FMN GV 11 Ramsel
66,Bergstraat 71,2022-09-30,05:00:00,12,2,10,FMN GV 11 Ramsel
66,Bergstraat 71,2022-09-30,06:00:00,30,10,20,FMN GV 11 Ramsel
66,Bergstraat 71,2022-09-30,07:00:00,224,18,206,FMN GV 11 Ramsel
66,Bergstraat 71,2022-09-30,08:00:00,232,24,208,FMN GV 11 Ramsel
66,Bergstraat 71,2022-09-30,09:00:00,44,14,30,FMN GV 11 Ramsel
66,Bergstraat 71,2022-09-30,10:00:00,96,40,56,FMN GV 11 Ramsel
66,Bergstraat 71,2022-09-30,11:00:00,56,26,30,FMN GV 11 Ramsel
66,Bergstraat 71,2022-09-30,12:00:00,148,84,64,FMN GV 11 Ramsel
66,Bergstraat 71,2022-09-30,13:00:00,172,68,104,FMN GV 11 Ramsel
66,Bergstraat 71,2022-09-30,14:00:00,208,124,84,FMN GV 11 Ramsel
66,Bergstraat 71,2022-09-30,15:00:00,328,270,58,FMN GV 11 Ramsel
66,Bergstraat 71,2022-09-30,16:00:00,230,176,54,FMN GV 11 Ramsel
66,Bergstraat 71,2022-09-30,17:00:00,108,56,52,FMN GV 11 Ramsel
66,Bergstraat 71,2022-09-30,18:00:00,98,78,20,FMN GV 11 Ramsel
66,Bergstraat 71,2022-09-30,19:00:00,60,30,30,FMN GV 11 Ramsel
66,Bergstraat 71,2022-09-30,20:00:00,58,24,34,FMN GV 11 Ramsel
66,Bergstraat 71,2022-09-30,21:00:00,24,12,12,FMN GV 11 Ramsel
66,Bergstraat 71,2022-09-30,22:00:00,28,8,20,FMN GV 11 Ramsel
66,Bergstraat 71,2022-09-30,23:00:00,10,10,0,FMN GV 11 Ramsel
66,Bergstraat 71,2022-10-01,00:00:00,8,4,4,FMN GV 11 Ramsel
66,Bergstraat 71,2022-10-01,01:00:00,20,20,0,FMN GV 11 Ramsel
66,Bergstraat 71,2022-10-01,02:00:00,10,10,0,FMN GV 11 Ramsel
66,Bergstraat 71,2022-10-01,03:00:00,4,4,0,FMN GV 11 Ramsel
66,Bergstraat 71,2022-10-01,04:00:00,2,0,2,FMN GV 11 Ramsel
66,Bergstraat 71,2022-10-01,05:00:00,2,2,0,FMN GV 11 Ramsel
66,Bergstraat 71,2022-10-01,06:00:00,8,6,2,FMN GV 11 Ramsel
66,Bergstraat 71,2022-10-01,07:00:00,8,6,2,FMN GV 11 Ramsel
66,Bergstraat 71,2022-10-01,08:00:00,10,2,8,FMN GV 11 Ramsel
66,Bergstraat 71,2022-10-01,09:00:00,48,18,30,FMN GV 11 Ramsel
66,Bergstraat 71,2022-10-01,10:00:00,52,22,30,FMN GV 11 Ramsel
66,Bergstraat 71,2022-10-01,11:00:00,42,18,24,FMN GV 11 Ramsel
66,Bergstraat 71,2022-10-01,12:00:00,58,42,16,FMN GV 11 Ramsel
66,Bergstraat 71,2022-10-01,13:00:00,110,52,58,FMN GV 11 Ramsel
66,Bergstraat 71,2022-10-01,14:00:00,114,50,64,FMN GV 11 Ramsel
66,Bergstraat 71,2022-10-01,15:00:00,116,54,62,FMN GV 11 Ramsel
66,Bergstraat 71,2022-10-01,16:00:00,60,30,30,FMN GV 11 Ramsel
66,Bergstraat 71,2022-10-01,17:00:00,80,38,42,FMN GV 11 Ramsel
66,Bergstraat 71,2022-10-01,18:00:00,22,10,12,FMN GV 11 Ramsel
66,Bergstraat 71,2022-10-01,19:00:00,16,10,6,FMN GV 11 Ramsel
66,Bergstraat 71,2022-10-01,20:00:00,22,8,14,FMN GV 11 Ramsel
66,Bergstraat 71,2022-10-01,21:00:00,8,4,4,FMN GV 11 Ramsel
66,Bergstraat 71,2022-10-01,22:00:00,16,8,8,FMN GV 11 Ramsel
66,Bergstraat 71,2022-10-01,23:00:00,6,2,4,FMN GV 11 Ramsel
66,Bergstraat 71,2022-10-02,00:00:00,8,6,2,FMN GV 11 Ramsel
66,Bergstraat 71,2022-10-02,01:00:00,2,0,2,FMN GV 11 Ramsel
66,Bergstraat 71,2022-10-02,02:00:00,6,4,2,FMN GV 11 Ramsel
66,Bergstraat 71,2022-10-02,03:00:00,6,6,0,FMN GV 11 Ramsel
66,Bergstraat 71,2022-10-02,04:00:00,0,0,0,FMN GV 11 Ramsel
66,Bergstraat 71,2022-10-02,05:00:00,4,2,2,FMN GV 11 Ramsel
66,Bergstraat 71,2022-10-02,06:00:00,6,6,0,FMN GV 11 Ramsel
66,Bergstraat 71,2022-10-02,07:00:00,0,0,0,FMN GV 11 Ramsel
66,Bergstraat 71,2022-10-02,08:00:00,24,8,16,FMN GV 11 Ramsel
66,Bergstraat 71,2022-10-02,09:00:00,32,14,18,FMN GV 11 Ramsel
66,Bergstraat 71,2022-10-02,10:00:00,50,22,28,FMN GV 11 Ramsel
66,Bergstraat 71,2022-10-02,11:00:00,90,58,32,FMN GV 11 Ramsel
66,Bergstraat 71,2022-10-02,12:00:00,34,20,14,FMN GV 11 Ramsel
66,Bergstraat 71,2022-10-02,13:00:00,72,34,38,FMN GV 11 Ramsel
66,Bergstraat 71,2022-10-02,14:00:00,116,54,62,FMN GV 11 Ramsel
66,Bergstraat 71,2022-10-02,15:00:00,80,38,42,FMN GV 11 Ramsel
66,Bergstraat 71,2022-10-02,16:00:00,80,36,44,FMN GV 11 Ramsel
66,Bergstraat 71,2022-10-02,17:00:00,96,50,46,FMN GV 11 Ramsel
66,Bergstraat 71,2022-10-02,18:00:00,58,22,36,FMN GV 11 Ramsel
66,Bergstraat 71,2022-10-02,19:00:00,32,10,22,FMN GV 11 Ramsel
66,Bergstraat 71,2022-10-02,20:00:00,12,8,4,FMN GV 11 Ramsel
66,Bergstraat 71,2022-10-02,21:00:00,12,8,4,FMN GV 11 Ramsel
66,Bergstraat 71,2022-10-02,22:00:00,0,0,0,FMN GV 11 Ramsel
66,Bergstraat 71,2022-10-02,23:00:00,0,0,0,FMN GV 11 Ramsel
66,Bergstraat 71,2022-10-03,00:00:00,2,2,0,FMN GV 11 Ramsel
66,Bergstraat 71,2022-10-03,01:00:00,0,0,0,FMN GV 11 Ramsel
66,Bergstraat 71,2022-10-03,02:00:00,0,0,0,FMN GV 11 Ramsel
66,Bergstraat 71,2022-10-03,03:00:00,2,0,2,FMN GV 11 Ramsel
66,Bergstraat 71,2022-10-03,04:00:00,4,2,2,FMN GV 11 Ramsel
66,Bergstraat 71,2022-10-03,05:00:00,14,2,12,FMN GV 11 Ramsel
66,Bergstraat 71,2022-10-03,06:00:00,46,10,36,FMN GV 11 Ramsel
66,Bergstraat 71,2022-10-03,07:00:00,290,24,266,FMN GV 11 Ramsel
66,Bergstraat 71,2022-10-03,08:00:00,246,24,222,FMN GV 11 Ramsel
66,Bergstraat 71,2022-10-03,09:00:00,64,26,38,FMN GV 11 Ramsel
66,Bergstraat 71,2022-10-03,10:00:00,82,26,56,FMN GV 11 Ramsel
66,Bergstraat 71,2022-10-03,11:00:00,46,22,24,FMN GV 11 Ramsel
66,Bergstraat 71,2022-10-03,12:00:00,90,40,50,FMN GV 11 Ramsel
66,Bergstraat 71,2022-10-03,13:00:00,148,64,84,FMN GV 11 Ramsel
66,Bergstraat 71,2022-10-03,14:00:00,210,114,96,FMN GV 11 Ramsel
66,Bergstraat 71,2022-10-03,15:00:00,362,244,118,FMN GV 11 Ramsel
66,Bergstraat 71,2022-10-03,16:00:00,262,218,44,FMN GV 11 Ramsel
66,Bergstraat 71,2022-10-03,17:00:00,136,98,38,FMN GV 11 Ramsel
66,Bergstraat 71,2022-10-03,18:00:00,90,50,40,FMN GV 11 Ramsel
66,Bergstraat 71,2022-10-03,19:00:00,68,40,28,FMN GV 11 Ramsel
66,Bergstraat 71,2022-10-03,20:00:00,30,16,14,FMN GV 11 Ramsel
66,Bergstraat 71,2022-10-03,21:00:00,14,6,8,FMN GV 11 Ramsel
66,Bergstraat 71,2022-10-03,22:00:00,26,10,16,FMN GV 11 Ramsel
66,Bergstraat 71,2022-10-03,23:00:00,4,4,0,FMN GV 11 Ramsel
66,Bergstraat 71,2022-10-04,00:00:00,2,2,0,FMN GV 11 Ramsel
66,Bergstraat 71,2022-10-04,01:00:00,0,0,0,FMN GV 11 Ramsel
66,Bergstraat 71,2022-10-04,02:00:00,0,0,0,FMN GV 11 Ramsel
66,Bergstraat 71,2022-10-04,03:00:00,0,0,0,FMN GV 11 Ramsel
66,Bergstraat 71,2022-10-04,04:00:00,8,6,2,FMN GV 11 Ramsel
66,Bergstraat 71,2022-10-04,05:00:00,20,8,12,FMN GV 11 Ramsel
66,Bergstraat 71,2022-10-04,06:00:00,54,20,34,FMN GV 11 Ramsel
66,Bergstraat 71,2022-10-04,07:00:00,272,36,236,FMN GV 11 Ramsel
66,Bergstraat 71,2022-10-04,08:00:00,198,32,166,FMN GV 11 Ramsel
66,Bergstraat 71,2022-10-04,09:00:00,106,26,80,FMN GV 11 Ramsel
66,Bergstraat 71,2022-10-04,10:00:00,88,34,54,FMN GV 11 Ramsel
66,Bergstraat 71,2022-10-04,11:00:00,110,50,60,FMN GV 11 Ramsel
66,Bergstraat 71,2022-10-04,12:00:00,102,48,54,FMN GV 11 Ramsel
66,Bergstraat 71,2022-10-04,13:00:00,224,106,118,FMN GV 11 Ramsel
66,Bergstraat 71,2022-10-04,14:00:00,222,126,96,FMN GV 11 Ramsel
66,Bergstraat 71,2022-10-04,15:00:00,280,212,68,FMN GV 11 Ramsel
66,Bergstraat 71,2022-10-04,16:00:00,304,228,76,FMN GV 11 Ramsel
66,Bergstraat 71,2022-10-04,17:00:00,200,106,94,FMN GV 11 Ramsel
66,Bergstraat 71,2022-10-04,18:00:00,128,60,68,FMN GV 11 Ramsel
66,Bergstraat 71,2022-10-04,19:00:00,86,50,36,FMN GV 11 Ramsel
66,Bergstraat 71,2022-10-04,20:00:00,74,50,24,FMN GV 11 Ramsel
66,Bergstraat 71,2022-10-04,21:00:00,22,14,8,FMN GV 11 Ramsel
66,Bergstraat 71,2022-10-04,22:00:00,24,22,2,FMN GV 11 Ramsel
66,Bergstraat 71,2022-10-04,23:00:00,8,6,2,FMN GV 11 Ramsel
66,Bergstraat 71,2022-10-05,00:00:00,2,2,0,FMN GV 11 Ramsel
66,Bergstraat 71,2022-10-05,01:00:00,0,0,0,FMN GV 11 Ramsel
66,Bergstraat 71,2022-10-05,02:00:00,0,0,0,FMN GV 11 Ramsel
66,Bergstraat 71,2022-10-05,03:00:00,0,0,0,FMN GV 11 Ramsel
66,Bergstraat 71,2022-10-05,04:00:00,2,2,0,FMN GV 11 Ramsel
66,Bergstraat 71,2022-10-05,05:00:00,26,14,12,FMN GV 11 Ramsel
66,Bergstraat 71,2022-10-05,06:00:00,38,10,28,FMN GV 11 Ramsel
66,Bergstraat 71,2022-10-05,07:00:00,138,36,102,FMN GV 11 Ramsel
66,Bergstraat 71,2022-10-05,08:00:00,158,36,122,FMN GV 11 Ramsel
66,Bergstraat 71,2022-10-05,09:00:00,78,28,50,FMN GV 11 Ramsel
66,Bergstraat 71,2022-10-05,10:00:00,86,34,52,FMN GV 11 Ramsel
66,Bergstraat 71,2022-10-05,11:00:00,126,76,50,FMN GV 11 Ramsel
66,Bergstraat 71,2022-10-05,12:00:00,156,122,34,FMN GV 11 Ramsel
66,Bergstraat 71,2022-10-05,13:00:00,146,50,96,FMN GV 11 Ramsel
66,Bergstraat 71,2022-10-05,14:00:00,222,108,114,FMN GV 11 Ramsel
66,Bergstraat 71,2022-10-05,15:00:00,190,118,72,FMN GV 11 Ramsel
66,Bergstraat 71,2022-10-05,16:00:00,132,70,62,FMN GV 11 Ramsel
66,Bergstraat 71,2022-10-05,17:00:00,144,104,40,FMN GV 11 Ramsel
66,Bergstraat 71,2022-10-05,18:00:00,68,38,30,FMN GV 11 Ramsel
66,Bergstraat 71,2022-10-05,19:00:00,54,30,24,FMN GV 11 Ramsel
66,Bergstraat 71,2022-10-05,20:00:00,40,22,18,FMN GV 11 Ramsel
66,Bergstraat 71,2022-10-05,21:00:00,18,16,2,FMN GV 11 Ramsel
66,Bergstraat 71,2022-10-05,22:00:00,12,10,2,FMN GV 11 Ramsel
66,Bergstraat 71,2022-10-05,23:00:00,4,0,4,FMN GV 11 Ramsel
66,Bergstraat 71,2022-10-06,00:00:00,2,2,0,FMN GV 11 Ramsel
66,Bergstraat 71,2022-10-06,01:00:00,0,0,0,FMN GV 11 Ramsel
66,Bergstraat 71,2022-10-06,02:00:00,0,0,0,FMN GV 11 Ramsel
66,Bergstraat 71,2022-10-06,03:00:00,0,0,0,FMN GV 11 Ramsel
66,Bergstraat 71,2022-10-06,04:00:00,6,2,4,FMN GV 11 Ramsel
66,Bergstraat 71,2022-10-06,05:00:00,12,0,12,FMN GV 11 Ramsel
66,Bergstraat 71,2022-10-06,06:00:00,60,16,44,FMN GV 11 Ramsel
66,Bergstraat 71,2022-10-06,07:00:00,294,24,270,FMN GV 11 Ramsel
66,Bergstraat 71,2022-10-06,08:00:00,260,36,224,FMN GV 11 Ramsel
66,Bergstraat 71,2022-10-06,09:00:00,80,24,56,FMN GV 11 Ramsel
66,Bergstraat 71,2022-10-06,10:00:00,90,30,60,FMN GV 11 Ramsel
66,Bergstraat 71,2022-10-06,11:00:00,88,32,56,FMN GV 11 Ramsel
66,Bergstraat 71,2022-10-06,12:00:00,122,70,52,FMN GV 11 Ramsel
66,Bergstraat 71,2022-10-06,13:00:00,170,68,102,FMN GV 11 Ramsel
66,Bergstraat 71,2022-10-06,14:00:00,212,94,118,FMN GV 11 Ramsel
66,Bergstraat 71,2022-10-06,15:00:00,360,286,74,FMN GV 11 Ramsel
66,Bergstraat 71,2022-10-06,16:00:00,290,236,54,FMN GV 11 Ramsel
66,Bergstraat 71,2022-10-06,17:00:00,146,90,56,FMN GV 11 Ramsel
66,Bergstraat 71,2022-10-06,18:00:00,116,62,54,FMN GV 11 Ramsel
66,Bergstraat 71,2022-10-06,19:00:00,56,30,26,FMN GV 11 Ramsel
66,Bergstraat 71,2022-10-06,20:00:00,44,26,18,FMN GV 11 Ramsel
66,Bergstraat 71,2022-10-06,21:00:00,24,14,10,FMN GV 11 Ramsel
66,Bergstraat 71,2022-10-06,22:00:00,20,18,2,FMN GV 11 Ramsel
66,Bergstraat 71,2022-10-06,23:00:00,12,6,6,FMN GV 11 Ramsel
66,Bergstraat 71,2022-10-07,00:00:00,0,0,0,FMN GV 11 Ramsel
66,Bergstraat 71,2022-10-07,01:00:00,4,2,2,FMN GV 11 Ramsel
66,Bergstraat 71,2022-10-07,02:00:00,0,0,0,FMN GV 11 Ramsel
66,Bergstraat 71,2022-10-07,03:00:00,2,2,0,FMN GV 11 Ramsel
66,Bergstraat 71,2022-10-07,04:00:00,4,2,2,FMN GV 11 Ramsel
66,Bergstraat 71,2022-10-07,05:00:00,10,0,10,FMN GV 11 Ramsel
66,Bergstraat 71,2022-10-07,06:00:00,34,14,20,FMN GV 11 Ramsel
66,Bergstraat 71,2022-10-07,07:00:00,186,18,168,FMN GV 11 Ramsel
66,Bergstraat 71,2022-10-07,08:00:00,198,44,154,FMN GV 11 Ramsel
66,Bergstraat 71,2022-10-07,09:00:00,72,24,48,FMN GV 11 Ramsel
66,Bergstraat 71,2022-10-07,10:00:00,72,36,36,FMN GV 11 Ramsel
66,Bergstraat 71,2022-10-07,11:00:00,68,28,40,FMN GV 11 Ramsel
66,Bergstraat 71,2022-10-07,12:00:00,106,62,44,FMN GV 11 Ramsel
66,Bergstraat 71,2022-10-07,13:00:00,174,88,86,FMN GV 11 Ramsel
66,Bergstraat 71,2022-10-07,14:00:00,206,102,104,FMN GV 11 Ramsel
66,Bergstraat 71,2022-10-07,15:00:00,320,232,88,FMN GV 11 Ramsel
66,Bergstraat 71,2022-10-07,16:00:00,216,156,60,FMN GV 11 Ramsel
66,Bergstraat 71,2022-10-07,17:00:00,174,116,58,FMN GV 11 Ramsel
66,Bergstraat 71,2022-10-07,18:00:00,110,48,62,FMN GV 11 Ramsel
66,Bergstraat 71,2022-10-07,19:00:00,82,42,40,FMN GV 11 Ramsel
66,Bergstraat 71,2022-10-07,20:00:00,28,8,20,FMN GV 11 Ramsel
66,Bergstraat 71,2022-10-07,21:00:00,26,14,12,FMN GV 11 Ramsel
66,Bergstraat 71,2022-10-07,22:00:00,24,18,6,FMN GV 11 Ramsel
66,Bergstraat 71,2022-10-07,23:00:00,8,6,2,FMN GV 11 Ramsel
66,Bergstraat 71,2022-10-08,00:00:00,12,8,4,FMN GV 11 Ramsel
66,Bergstraat 71,2022-10-08,01:00:00,4,4,0,FMN GV 11 Ramsel
66,Bergstraat 71,2022-10-08,02:00:00,4,4,0,FMN GV 11 Ramsel
66,Bergstraat 71,2022-10-08,03:00:00,2,2,0,FMN GV 11 Ramsel
66,Bergstraat 71,2022-10-08,04:00:00,4,2,2,FMN GV 11 Ramsel
66,Bergstraat 71,2022-10-08,05:00:00,2,0,2,FMN GV 11 Ramsel
66,Bergstraat 71,2022-10-08,06:00:00,2,0,2,FMN GV 11 Ramsel
66,Bergstraat 71,2022-10-08,07:00:00,14,6,8,FMN GV 11 Ramsel
66,Bergstraat 71,2022-10-08,08:00:00,28,12,16,FMN GV 11 Ramsel
66,Bergstraat 71,2022-10-08,09:00:00,56,10,46,FMN GV 11 Ramsel
66,Bergstraat 71,2022-10-08,10:00:00,102,42,60,FMN GV 11 Ramsel
66,Bergstraat 71,2022-10-08,11:00:00,120,56,64,FMN GV 11 Ramsel
66,Bergstraat 71,2022-10-08,12:00:00,92,46,46,FMN GV 11 Ramsel
66,Bergstraat 71,2022-10-08,13:00:00,136,56,80,FMN GV 11 Ramsel
66,Bergstraat 71,2022-10-08,14:00:00,188,110,78,FMN GV 11 Ramsel
66,Bergstraat 71,2022-10-08,15:00:00,76,34,42,FMN GV 11 Ramsel
66,Bergstraat 71,2022-10-08,16:00:00,60,32,28,FMN GV 11 Ramsel
66,Bergstraat 71,2022-10-08,17:00:00,64,32,32,FMN GV 11 Ramsel
66,Bergstraat 71,2022-10-08,18:00:00,42,26,16,FMN GV 11 Ramsel
66,Bergstraat 71,2022-10-08,19:00:00,62,14,48,FMN GV 11 Ramsel
66,Bergstraat 71,2022-10-08,20:00:00,14,4,10,FMN GV 11 Ramsel
66,Bergstraat 71,2022-10-08,21:00:00,26,18,8,FMN GV 11 Ramsel
66,Bergstraat 71,2022-10-08,22:00:00,22,14,8,FMN GV 11 Ramsel
66,Bergstraat 71,2022-10-08,23:00:00,14,14,0,FMN GV 11 Ramsel
66,Bergstraat 71,2022-10-09,00:00:00,12,10,2,FMN GV 11 Ramsel
66,Bergstraat 71,2022-10-09,01:00:00,2,2,0,FMN GV 11 Ramsel
66,Bergstraat 71,2022-10-09,02:00:00,8,4,4,FMN GV 11 Ramsel
66,Bergstraat 71,2022-10-09,03:00:00,0,0,0,FMN GV 11 Ramsel
66,Bergstraat 71,2022-10-09,04:00:00,4,4,0,FMN GV 11 Ramsel
66,Bergstraat 71,2022-10-09,05:00:00,0,0,0,FMN GV 11 Ramsel
66,Bergstraat 71,2022-10-09,06:00:00,2,0,2,FMN GV 11 Ramsel
66,Bergstraat 71,2022-10-09,07:00:00,18,2,16,FMN GV 11 Ramsel
66,Bergstraat 71,2022-10-09,08:00:00,56,16,40,FMN GV 11 Ramsel
66,Bergstraat 71,2022-10-09,09:00:00,98,24,74,FMN GV 11 Ramsel
66,Bergstraat 71,2022-10-09,10:00:00,122,78,44,FMN GV 11 Ramsel
66,Bergstraat 71,2022-10-09,11:00:00,162,80,82,FMN GV 11 Ramsel
66,Bergstraat 71,2022-10-09,12:00:00,146,72,74,FMN GV 11 Ramsel
66,Bergstraat 71,2022-10-09,13:00:00,270,114,156,FMN GV 11 Ramsel
66,Bergstraat 71,2022-10-09,14:00:00,298,154,144,FMN GV 11 Ramsel
66,Bergstraat 71,2022-10-09,15:00:00,190,112,78,FMN GV 11 Ramsel
66,Bergstraat 71,2022-10-09,16:00:00,218,140,78,FMN GV 11 Ramsel
66,Bergstraat 71,2022-10-09,17:00:00,132,56,76,FMN GV 11 Ramsel
66,Bergstraat 71,2022-10-09,18:00:00,108,70,38,FMN GV 11 Ramsel
66,Bergstraat 71,2022-10-09,19:00:00,32,6,26,FMN GV 11 Ramsel
66,Bergstraat 71,2022-10-09,20:00:00,16,16,0,FMN GV 11 Ramsel
66,Bergstraat 71,2022-10-09,21:00:00,16,8,8,FMN GV 11 Ramsel
66,Bergstraat 71,2022-10-09,22:00:00,12,6,6,FMN GV 11 Ramsel
66,Bergstraat 71,2022-10-09,23:00:00,10,2,8,FMN GV 11 Ramsel
66,Bergstraat 71,2022-10-10,00:00:00,2,0,2,FMN GV 11 Ramsel
66,Bergstraat 71,2022-10-10,01:00:00,2,0,2,FMN GV 11 Ramsel
66,Bergstraat 71,2022-10-10,02:00:00,2,2,0,FMN GV 11 Ramsel
66,Bergstraat 71,2022-10-10,03:00:00,2,0,2,FMN GV 11 Ramsel
66,Bergstraat 71,2022-10-10,04:00:00,2,0,2,FMN GV 11 Ramsel
66,Bergstraat 71,2022-10-10,05:00:00,14,4,10,FMN GV 11 Ramsel
66,Bergstraat 71,2022-10-10,06:00:00,52,12,40,FMN GV 11 Ramsel
66,Bergstraat 71,2022-10-10,07:00:00,254,28,226,FMN GV 11 Ramsel
66,Bergstraat 71,2022-10-10,08:00:00,252,32,220,FMN GV 11 Ramsel
66,Bergstraat 71,2022-10-10,09:00:00,60,16,44,FMN GV 11 Ramsel
66,Bergstraat 71,2022-10-10,10:00:00,58,28,30,FMN GV 11 Ramsel
66,Bergstraat 71,2022-10-10,11:00:00,70,24,46,FMN GV 11 Ramsel
66,Bergstraat 71,2022-10-10,12:00:00,90,54,36,FMN GV 11 Ramsel
66,Bergstraat 71,2022-10-10,13:00:00,136,68,68,FMN GV 11 Ramsel
66,Bergstraat 71,2022-10-10,14:00:00,134,82,52,FMN GV 11 Ramsel
66,Bergstraat 71,2022-10-10,15:00:00,292,234,58,FMN GV 11 Ramsel
66,Bergstraat 71,2022-10-10,16:00:00,214,172,42,FMN GV 11 Ramsel
66,Bergstraat 71,2022-10-10,17:00:00,136,104,32,FMN GV 11 Ramsel
66,Bergstraat 71,2022-10-10,18:00:00,70,40,30,FMN GV 11 Ramsel
66,Bergstraat 71,2022-10-10,19:00:00,30,14,16,FMN GV 11 Ramsel
66,Bergstraat 71,2022-10-10,20:00:00,20,16,4,FMN GV 11 Ramsel
66,Bergstraat 71,2022-10-10,21:00:00,20,14,6,FMN GV 11 Ramsel
66,Bergstraat 71,2022-10-10,22:00:00,4,4,0,FMN GV 11 Ramsel
66,Bergstraat 71,2022-10-10,23:00:00,0,0,0,FMN GV 11 Ramsel
66,Bergstraat 71,2022-10-11,00:00:00,2,0,2,FMN GV 11 Ramsel
66,Bergstraat 71,2022-10-11,01:00:00,4,2,2,FMN GV 11 Ramsel
66,Bergstraat 71,2022-10-11,02:00:00,0,0,0,FMN GV 11 Ramsel
66,Bergstraat 71,2022-10-11,03:00:00,0,0,0,FMN GV 11 Ramsel
66,Bergstraat 71,2022-10-11,04:00:00,2,0,2,FMN GV 11 Ramsel
66,Bergstraat 71,2022-10-11,05:00:00,22,10,12,FMN GV 11 Ramsel
66,Bergstraat 71,2022-10-11,06:00:00,62,26,36,FMN GV 11 Ramsel
66,Bergstraat 71,2022-10-11,07:00:00,266,24,242,FMN GV 11 Ramsel
66,Bergstraat 71,2022-10-11,08:00:00,240,20,220,FMN GV 11 Ramsel
66,Bergstraat 71,2022-10-11,09:00:00,56,16,40,FMN GV 11 Ramsel
66,Bergstraat 71,2022-10-11,10:00:00,66,22,44,FMN GV 11 Ramsel
66,Bergstraat 71,2022-10-11,11:00:00,56,26,30,FMN GV 11 Ramsel
66,Bergstraat 71,2022-10-11,12:00:00,74,38,36,FMN GV 11 Ramsel
66,Bergstraat 71,2022-10-11,13:00:00,214,100,114,FMN GV 11 Ramsel
66,Bergstraat 71,2022-10-11,14:00:00,172,80,92,FMN GV 11 Ramsel
66,Bergstraat 71,2022-10-11,15:00:00,338,246,92,FMN GV 11 Ramsel
66,Bergstraat 71,2022-10-11,16:00:00,280,208,72,FMN GV 11 Ramsel
66,Bergstraat 71,2022-10-11,17:00:00,210,126,84,FMN GV 11 Ramsel
66,Bergstraat 71,2022-10-11,18:00:00,128,74,54,FMN GV 11 Ramsel
66,Bergstraat 71,2022-10-11,19:00:00,48,28,20,FMN GV 11 Ramsel
66,Bergstraat 71,2022-10-11,20:00:00,38,24,14,FMN GV 11 Ramsel
66,Bergstraat 71,2022-10-11,21:00:00,28,22,6,FMN GV 11 Ramsel
66,Bergstraat 71,2022-10-11,22:00:00,10,8,2,FMN GV 11 Ramsel
66,Bergstraat 71,2022-10-11,23:00:00,2,0,2,FMN GV 11 Ramsel
66,Bergstraat 71,2022-10-12,00:00:00,4,2,2,FMN GV 11 Ramsel
66,Bergstraat 71,2022-10-12,01:00:00,0,0,0,FMN GV 11 Ramsel
66,Bergstraat 71,2022-10-12,02:00:00,0,0,0,FMN GV 11 Ramsel
66,Bergstraat 71,2022-10-12,03:00:00,0,0,0,FMN GV 11 Ramsel
66,Bergstraat 71,2022-10-12,04:00:00,2,0,2,FMN GV 11 Ramsel
66,Bergstraat 71,2022-10-12,05:00:00,24,10,14,FMN GV 11 Ramsel
66,Bergstraat 71,2022-10-12,06:00:00,48,20,28,FMN GV 11 Ramsel
66,Bergstraat 71,2022-10-12,07:00:00,232,12,220,FMN GV 11 Ramsel
66,Bergstraat 71,2022-10-12,08:00:00,264,30,234,FMN GV 11 Ramsel
66,Bergstraat 71,2022-10-12,09:00:00,58,14,44,FMN GV 11 Ramsel
66,Bergstraat 71,2022-10-12,10:00:00,66,44,22,FMN GV 11 Ramsel
66,Bergstraat 71,2022-10-12,11:00:00,98,54,44,FMN GV 11 Ramsel
66,Bergstraat 71,2022-10-12,12:00:00,364,294,70,FMN GV 11 Ramsel
66,Bergstraat 71,2022-10-12,13:00:00,118,54,64,FMN GV 11 Ramsel
66,Bergstraat 71,2022-10-12,14:00:00,192,104,88,FMN GV 11 Ramsel
66,Bergstraat 71,2022-10-12,15:00:00,204,118,86,FMN GV 11 Ramsel
66,Bergstraat 71,2022-10-12,16:00:00,200,124,76,FMN GV 11 Ramsel
66,Bergstraat 71,2022-10-12,17:00:00,150,90,60,FMN GV 11 Ramsel
66,Bergstraat 71,2022-10-12,18:00:00,76,60,16,FMN GV 11 Ramsel
66,Bergstraat 71,2022-10-12,19:00:00,78,42,36,FMN GV 11 Ramsel
66,Bergstraat 71,2022-10-12,20:00:00,20,10,10,FMN GV 11 Ramsel
66,Bergstraat 71,2022-10-12,21:00:00,8,2,6,FMN GV 11 Ramsel
66,Bergstraat 71,2022-10-12,22:00:00,16,12,4,FMN GV 11 Ramsel
66,Bergstraat 71,2022-10-12,23:00:00,6,2,4,FMN GV 11 Ramsel
66,Bergstraat 71,2022-10-13,00:00:00,6,6,0,FMN GV 11 Ramsel
66,Bergstraat 71,2022-10-13,01:00:00,0,0,0,FMN GV 11 Ramsel
66,Bergstraat 71,2022-10-13,02:00:00,0,0,0,FMN GV 11 Ramsel
66,Bergstraat 71,2022-10-13,03:00:00,0,0,0,FMN GV 11 Ramsel
66,Bergstraat 71,2022-10-13,04:00:00,0,0,0,FMN GV 11 Ramsel
66,Bergstraat 71,2022-10-13,05:00:00,18,10,8,FMN GV 11 Ramsel
66,Bergstraat 71,2022-10-13,06:00:00,44,12,32,FMN GV 11 Ramsel
66,Bergstraat 71,2022-10-13,07:00:00,238,20,218,FMN GV 11 Ramsel
66,Bergstraat 71,2022-10-13,08:00:00,240,30,210,FMN GV 11 Ramsel
66,Bergstraat 71,2022-10-13,09:00:00,32,12,20,FMN GV 11 Ramsel
66,Bergstraat 71,2022-10-13,10:00:00,44,24,20,FMN GV 11 Ramsel
66,Bergstraat 71,2022-10-13,11:00:00,56,38,18,FMN GV 11 Ramsel
66,Bergstraat 71,2022-10-13,12:00:00,38,28,10,FMN GV 11 Ramsel
66,Bergstraat 71,2022-10-13,13:00:00,44,24,20,FMN GV 11 Ramsel
66,Bergstraat 71,2022-10-13,14:00:00,44,28,16,FMN GV 11 Ramsel
66,Bergstraat 71,2022-10-13,15:00:00,200,176,24,FMN GV 11 Ramsel
66,Bergstraat 71,2022-10-13,16:00:00,168,146,22,FMN GV 11 Ramsel
66,Bergstraat 71,2022-10-13,17:00:00,72,42,30,FMN GV 11 Ramsel
66,Bergstraat 71,2022-10-13,18:00:00,64,36,28,FMN GV 11 Ramsel
66,Bergstraat 71,2022-10-13,19:00:00,30,10,20,FMN GV 11 Ramsel
66,Bergstraat 71,2022-10-13,20:00:00,22,14,8,FMN GV 11 Ramsel
66,Bergstraat 71,2022-10-13,21:00:00,6,0,6,FMN GV 11 Ramsel
66,Bergstraat 71,2022-10-13,22:00:00,14,14,0,FMN GV 11 Ramsel
66,Bergstraat 71,2022-10-13,23:00:00,2,2,0,FMN GV 11 Ramsel
66,Bergstraat 71,2022-10-14,00:00:00,6,4,2,FMN GV 11 Ramsel
66,Bergstraat 71,2022-10-14,01:00:00,0,0,0,FMN GV 11 Ramsel
66,Bergstraat 71,2022-10-14,02:00:00,0,0,0,FMN GV 11 Ramsel
66,Bergstraat 71,2022-10-14,03:00:00,0,0,0,FMN GV 11 Ramsel
66,Bergstraat 71,2022-10-14,04:00:00,0,0,0,FMN GV 11 Ramsel
66,Bergstraat 71,2022-10-14,05:00:00,12,6,6,FMN GV 11 Ramsel
66,Bergstraat 71,2022-10-14,06:00:00,34,8,26,FMN GV 11 Ramsel
66,Bergstraat 71,2022-10-14,07:00:00,180,22,158,FMN GV 11 Ramsel
66,Bergstraat 71,2022-10-14,08:00:00,244,24,220,FMN GV 11 Ramsel
66,Bergstraat 71,2022-10-14,09:00:00,36,8,28,FMN GV 11 Ramsel
66,Bergstraat 71,2022-10-14,10:00:00,16,12,4,FMN GV 11 Ramsel
66,Bergstraat 71,2022-10-14,11:00:00,38,10,28,FMN GV 11 Ramsel
66,Bergstraat 71,2022-10-14,12:00:00,34,20,14,FMN GV 11 Ramsel
66,Bergstraat 71,2022-10-14,13:00:00,50,28,22,FMN GV 11 Ramsel
66,Bergstraat 71,2022-10-14,14:00:00,50,40,10,FMN GV 11 Ramsel
66,Bergstraat 71,2022-10-14,15:00:00,218,192,26,FMN GV 11 Ramsel
66,Bergstraat 71,2022-10-14,16:00:00,126,88,38,FMN GV 11 Ramsel
66,Bergstraat 71,2022-10-14,17:00:00,92,64,28,FMN GV 11 Ramsel
66,Bergstraat 71,2022-10-14,18:00:00,48,36,12,FMN GV 11 Ramsel
66,Bergstraat 71,2022-10-14,19:00:00,30,12,18,FMN GV 11 Ramsel
66,Bergstraat 71,2022-10-14,20:00:00,52,32,20,FMN GV 11 Ramsel
66,Bergstraat 71,2022-10-14,21:00:00,18,8,10,FMN GV 11 Ramsel
66,Bergstraat 71,2022-10-14,22:00:00,8,4,4,FMN GV 11 Ramsel
66,Bergstraat 71,2022-10-14,23:00:00,6,6,0,FMN GV 11 Ramsel
66,Bergstraat 71,2022-10-15,00:00:00,14,6,8,FMN GV 11 Ramsel
66,Bergstraat 71,2022-10-15,01:00:00,8,6,2,FMN GV 11 Ramsel
66,Bergstraat 71,2022-10-15,02:00:00,10,8,2,FMN GV 11 Ramsel
66,Bergstraat 71,2022-10-15,03:00:00,2,0,2,FMN GV 11 Ramsel
66,Bergstraat 71,2022-10-15,04:00:00,0,0,0,FMN GV 11 Ramsel
66,Bergstraat 71,2022-10-15,05:00:00,4,0,4,FMN GV 11 Ramsel
66,Bergstraat 71,2022-10-15,06:00:00,4,2,2,FMN GV 11 Ramsel
66,Bergstraat 71,2022-10-15,07:00:00,10,2,8,FMN GV 11 Ramsel
66,Bergstraat 71,2022-10-15,08:00:00,22,8,14,FMN GV 11 Ramsel
66,Bergstraat 71,2022-10-15,09:00:00,52,18,34,FMN GV 11 Ramsel
66,Bergstraat 71,2022-10-15,10:00:00,74,28,46,FMN GV 11 Ramsel
66,Bergstraat 71,2022-10-15,11:00:00,88,34,54,FMN GV 11 Ramsel
66,Bergstraat 71,2022-10-15,12:00:00,58,28,30,FMN GV 11 Ramsel
66,Bergstraat 71,2022-10-15,13:00:00,94,34,60,FMN GV 11 Ramsel
66,Bergstraat 71,2022-10-15,14:00:00,102,46,56,FMN GV 11 Ramsel
66,Bergstraat 71,2022-10-15,15:00:00,70,46,24,FMN GV 11 Ramsel
66,Bergstraat 71,2022-10-15,16:00:00,76,50,26,FMN GV 11 Ramsel
66,Bergstraat 71,2022-10-15,17:00:00,62,30,32,FMN GV 11 Ramsel
66,Bergstraat 71,2022-10-15,18:00:00,54,36,18,FMN GV 11 Ramsel
66,Bergstraat 71,2022-10-15,19:00:00,26,22,4,FMN GV 11 Ramsel
66,Bergstraat 71,2022-10-15,20:00:00,24,10,14,FMN GV 11 Ramsel
66,Bergstraat 71,2022-10-15,21:00:00,8,2,6,FMN GV 11 Ramsel
66,Bergstraat 71,2022-10-15,22:00:00,12,8,4,FMN GV 11 Ramsel
66,Bergstraat 71,2022-10-15,23:00:00,8,0,8,FMN GV 11 Ramsel
66,Bergstraat 71,2022-10-16,00:00:00,18,10,8,FMN GV 11 Ramsel
66,Bergstraat 71,2022-10-16,01:00:00,4,4,0,FMN GV 11 Ramsel
66,Bergstraat 71,2022-10-16,02:00:00,12,10,2,FMN GV 11 Ramsel
66,Bergstraat 71,2022-10-16,03:00:00,0,0,0,FMN GV 11 Ramsel
66,Bergstraat 71,2022-10-16,04:00:00,0,0,0,FMN GV 11 Ramsel
66,Bergstraat 71,2022-10-16,05:00:00,4,0,4,FMN GV 11 Ramsel
66,Bergstraat 71,2022-10-16,06:00:00,0,0,0,FMN GV 11 Ramsel
66,Bergstraat 71,2022-10-16,07:00:00,12,2,10,FMN GV 11 Ramsel
66,Bergstraat 71,2022-10-16,08:00:00,46,12,34,FMN GV 11 Ramsel
66,Bergstraat 71,2022-10-16,09:00:00,124,42,82,FMN GV 11 Ramsel
66,Bergstraat 71,2022-10-16,10:00:00,152,68,84,FMN GV 11 Ramsel
66,Bergstraat 71,2022-10-16,11:00:00,224,114,110,FMN GV 11 Ramsel
66,Bergstraat 71,2022-10-16,12:00:00,124,54,70,FMN GV 11 Ramsel
66,Bergstraat 71,2022-10-16,13:00:00,204,102,102,FMN GV 11 Ramsel
66,Bergstraat 71,2022-10-16,14:00:00,256,126,130,FMN GV 11 Ramsel
66,Bergstraat 71,2022-10-16,15:00:00,170,106,64,FMN GV 11 Ramsel
66,Bergstraat 71,2022-10-16,16:00:00,146,92,54,FMN GV 11 Ramsel
66,Bergstraat 71,2022-10-16,17:00:00,132,62,70,FMN GV 11 Ramsel
66,Bergstraat 71,2022-10-16,18:00:00,30,16,14,FMN GV 11 Ramsel
66,Bergstraat 71,2022-10-16,19:00:00,20,16,4,FMN GV 11 Ramsel
66,Bergstraat 71,2022-10-16,20:00:00,8,2,6,FMN GV 11 Ramsel
66,Bergstraat 71,2022-10-16,21:00:00,8,4,4,FMN GV 11 Ramsel
66,Bergstraat 71,2022-10-16,22:00:00,10,4,6,FMN GV 11 Ramsel
66,Bergstraat 71,2022-10-16,23:00:00,4,4,0,FMN GV 11 Ramsel
66,Bergstraat 71,2022-10-17,00:00:00,0,0,0,FMN GV 11 Ramsel
66,Bergstraat 71,2022-10-17,01:00:00,2,2,0,FMN GV 11 Ramsel
66,Bergstraat 71,2022-10-17,02:00:00,0,0,0,FMN GV 11 Ramsel
66,Bergstraat 71,2022-10-17,03:00:00,2,0,2,FMN GV 11 Ramsel
66,Bergstraat 71,2022-10-17,04:00:00,0,0,0,FMN GV 11 Ramsel
66,Bergstraat 71,2022-10-17,05:00:00,16,8,8,FMN GV 11 Ramsel
66,Bergstraat 71,2022-10-17,06:00:00,62,22,40,FMN GV 11 Ramsel
66,Bergstraat 71,2022-10-17,07:00:00,240,20,220,FMN GV 11 Ramsel
66,Bergstraat 71,2022-10-17,08:00:00,192,14,178,FMN GV 11 Ramsel
66,Bergstraat 71,2022-10-17,09:00:00,40,12,28,FMN GV 11 Ramsel
66,Bergstraat 71,2022-10-17,10:00:00,16,8,8,FMN GV 11 Ramsel
66,Bergstraat 71,2022-10-17,11:00:00,24,8,16,FMN GV 11 Ramsel
66,Bergstraat 71,2022-10-17,12:00:00,20,18,2,FMN GV 11 Ramsel
66,Bergstraat 71,2022-10-17,13:00:00,34,14,20,FMN GV 11 Ramsel
66,Bergstraat 71,2022-10-17,14:00:00,56,52,4,FMN GV 11 Ramsel
66,Bergstraat 71,2022-10-17,15:00:00,202,172,30,FMN GV 11 Ramsel
66,Bergstraat 71,2022-10-17,16:00:00,176,140,36,FMN GV 11 Ramsel
66,Bergstraat 71,2022-10-17,17:00:00,116,86,30,FMN GV 11 Ramsel
66,Bergstraat 71,2022-10-17,18:00:00,60,36,24,FMN GV 11 Ramsel
66,Bergstraat 71,2022-10-17,19:00:00,48,32,16,FMN GV 11 Ramsel
66,Bergstraat 71,2022-10-17,20:00:00,20,8,12,FMN GV 11 Ramsel
66,Bergstraat 71,2022-10-17,21:00:00,18,18,0,FMN GV 11 Ramsel
66,Bergstraat 71,2022-10-17,22:00:00,10,4,6,FMN GV 11 Ramsel
66,Bergstraat 71,2022-10-17,23:00:00,0,0,0,FMN GV 11 Ramsel
66,Bergstraat 71,2022-10-18,00:00:00,0,0,0,FMN GV 11 Ramsel
66,Bergstraat 71,2022-10-18,01:00:00,0,0,0,FMN GV 11 Ramsel
66,Bergstraat 71,2022-10-18,02:00:00,0,0,0,FMN GV 11 Ramsel
66,Bergstraat 71,2022-10-18,03:00:00,0,0,0,FMN GV 11 Ramsel
66,Bergstraat 71,2022-10-18,04:00:00,8,2,6,FMN GV 11 Ramsel
66,Bergstraat 71,2022-10-18,05:00:00,14,8,6,FMN GV 11 Ramsel
66,Bergstraat 71,2022-10-18,06:00:00,54,24,30,FMN GV 11 Ramsel
66,Bergstraat 71,2022-10-18,07:00:00,270,24,246,FMN GV 11 Ramsel
66,Bergstraat 71,2022-10-18,08:00:00,214,24,190,FMN GV 11 Ramsel
66,Bergstraat 71,2022-10-18,09:00:00,68,18,50,FMN GV 11 Ramsel
66,Bergstraat 71,2022-10-18,10:00:00,68,30,38,FMN GV 11 Ramsel
66,Bergstraat 71,2022-10-18,11:00:00,68,24,44,FMN GV 11 Ramsel
66,Bergstraat 71,2022-10-18,12:00:00,102,54,48,FMN GV 11 Ramsel
66,Bergstraat 71,2022-10-18,13:00:00,270,128,142,FMN GV 11 Ramsel
66,Bergstraat 71,2022-10-18,14:00:00,296,130,166,FMN GV 11 Ramsel
66,Bergstraat 71,2022-10-18,15:00:00,428,336,92,FMN GV 11 Ramsel
66,Bergstraat 71,2022-10-18,16:00:00,286,204,82,FMN GV 11 Ramsel
66,Bergstraat 71,2022-10-18,17:00:00,220,130,90,FMN GV 11 Ramsel
66,Bergstraat 71,2022-10-18,18:00:00,128,68,60,FMN GV 11 Ramsel
66,Bergstraat 71,2022-10-18,19:00:00,82,42,40,FMN GV 11 Ramsel
66,Bergstraat 71,2022-10-18,20:00:00,54,42,12,FMN GV 11 Ramsel
66,Bergstraat 71,2022-10-18,21:00:00,16,6,10,FMN GV 11 Ramsel
66,Bergstraat 71,2022-10-18,22:00:00,18,14,4,FMN GV 11 Ramsel
66,Bergstraat 71,2022-10-18,23:00:00,6,4,2,FMN GV 11 Ramsel
66,Bergstraat 71,2022-10-19,00:00:00,2,2,0,FMN GV 11 Ramsel
66,Bergstraat 71,2022-10-19,01:00:00,0,0,0,FMN GV 11 Ramsel
66,Bergstraat 71,2022-10-19,02:00:00,0,0,0,FMN GV 11 Ramsel
66,Bergstraat 71,2022-10-19,03:00:00,0,0,0,FMN GV 11 Ramsel
66,Bergstraat 71,2022-10-19,04:00:00,8,2,6,FMN GV 11 Ramsel
66,Bergstraat 71,2022-10-19,05:00:00,14,4,10,FMN GV 11 Ramsel
66,Bergstraat 71,2022-10-19,06:00:00,50,14,36,FMN GV 11 Ramsel
66,Bergstraat 71,2022-10-19,07:00:00,246,18,228,FMN GV 11 Ramsel
66,Bergstraat 71,2022-10-19,08:00:00,250,24,226,FMN GV 11 Ramsel
66,Bergstraat 71,2022-10-19,09:00:00,54,22,32,FMN GV 11 Ramsel
66,Bergstraat 71,2022-10-19,10:00:00,76,32,44,FMN GV 11 Ramsel
66,Bergstraat 71,2022-10-19,11:00:00,90,52,38,FMN GV 11 Ramsel
66,Bergstraat 71,2022-10-19,12:00:00,382,342,40,FMN GV 11 Ramsel
66,Bergstraat 71,2022-10-19,13:00:00,180,84,96,FMN GV 11 Ramsel
66,Bergstraat 71,2022-10-19,14:00:00,288,136,152,FMN GV 11 Ramsel
66,Bergstraat 71,2022-10-19,15:00:00,168,112,56,FMN GV 11 Ramsel
66,Bergstraat 71,2022-10-19,16:00:00,186,108,78,FMN GV 11 Ramsel
66,Bergstraat 71,2022-10-19,17:00:00,164,98,66,FMN GV 11 Ramsel
66,Bergstraat 71,2022-10-19,18:00:00,92,62,30,FMN GV 11 Ramsel
66,Bergstraat 71,2022-10-19,19:00:00,66,24,42,FMN GV 11 Ramsel
66,Bergstraat 71,2022-10-19,20:00:00,40,16,24,FMN GV 11 Ramsel
66,Bergstraat 71,2022-10-19,21:00:00,20,16,4,FMN GV 11 Ramsel
66,Bergstraat 71,2022-10-19,22:00:00,32,28,4,FMN GV 11 Ramsel
66,Bergstraat 71,2022-10-19,23:00:00,6,2,4,FMN GV 11 Ramsel
66,Bergstraat 71,2022-10-20,00:00:00,4,4,0,FMN GV 11 Ramsel
66,Bergstraat 71,2022-10-20,01:00:00,2,2,0,FMN GV 11 Ramsel
66,Bergstraat 71,2022-10-20,02:00:00,0,0,0,FMN GV 11 Ramsel
66,Bergstraat 71,2022-10-20,03:00:00,0,0,0,FMN GV 11 Ramsel
66,Bergstraat 71,2022-10-20,04:00:00,4,2,2,FMN GV 11 Ramsel
66,Bergstraat 71,2022-10-20,05:00:00,16,4,12,FMN GV 11 Ramsel
66,Bergstraat 71,2022-10-20,06:00:00,46,18,28,FMN GV 11 Ramsel
66,Bergstraat 71,2022-10-20,07:00:00,240,36,204,FMN GV 11 Ramsel
66,Bergstraat 71,2022-10-20,08:00:00,258,36,222,FMN GV 11 Ramsel
66,Bergstraat 71,2022-10-20,09:00:00,46,8,38,FMN GV 11 Ramsel
66,Bergstraat 71,2022-10-20,10:00:00,40,18,22,FMN GV 11 Ramsel
66,Bergstraat 71,2022-10-20,11:00:00,32,22,10,FMN GV 11 Ramsel
66,Bergstraat 71,2022-10-20,12:00:00,32,18,14,FMN GV 11 Ramsel
66,Bergstraat 71,2022-10-20,13:00:00,58,20,38,FMN GV 11 Ramsel
66,Bergstraat 71,2022-10-20,14:00:00,130,92,38,FMN GV 11 Ramsel
66,Bergstraat 71,2022-10-20,15:00:00,204,160,44,FMN GV 11 Ramsel
66,Bergstraat 71,2022-10-20,16:00:00,230,194,36,FMN GV 11 Ramsel
66,Bergstraat 71,2022-10-20,17:00:00,106,60,46,FMN GV 11 Ramsel
66,Bergstraat 71,2022-10-20,18:00:00,84,46,38,FMN GV 11 Ramsel
66,Bergstraat 71,2022-10-20,19:00:00,34,18,16,FMN GV 11 Ramsel
66,Bergstraat 71,2022-10-20,20:00:00,34,24,10,FMN GV 11 Ramsel
66,Bergstraat 71,2022-10-20,21:00:00,6,4,2,FMN GV 11 Ramsel
66,Bergstraat 71,2022-10-20,22:00:00,26,12,14,FMN GV 11 Ramsel
66,Bergstraat 71,2022-10-20,23:00:00,10,6,4,FMN GV 11 Ramsel
66,Bergstraat 71,2022-10-21,00:00:00,2,2,0,FMN GV 11 Ramsel
66,Bergstraat 71,2022-10-21,01:00:00,0,0,0,FMN GV 11 Ramsel
66,Bergstraat 71,2022-10-21,02:00:00,0,0,0,FMN GV 11 Ramsel
66,Bergstraat 71,2022-10-21,03:00:00,2,2,0,FMN GV 11 Ramsel
66,Bergstraat 71,2022-10-21,04:00:00,2,2,0,FMN GV 11 Ramsel
66,Bergstraat 71,2022-10-21,05:00:00,12,4,8,FMN GV 11 Ramsel
66,Bergstraat 71,2022-10-21,06:00:00,36,10,26,FMN GV 11 Ramsel
66,Bergstraat 71,2022-10-21,07:00:00,270,26,244,FMN GV 11 Ramsel
66,Bergstraat 71,2022-10-21,08:00:00,210,20,190,FMN GV 11 Ramsel
66,Bergstraat 71,2022-10-21,09:00:00,46,20,26,FMN GV 11 Ramsel
66,Bergstraat 71,2022-10-21,10:00:00,36,18,18,FMN GV 11 Ramsel
66,Bergstraat 71,2022-10-21,11:00:00,60,30,30,FMN GV 11 Ramsel
66,Bergstraat 71,2022-10-21,12:00:00,78,40,38,FMN GV 11 Ramsel
66,Bergstraat 71,2022-10-21,13:00:00,118,68,50,FMN GV 11 Ramsel
66,Bergstraat 71,2022-10-21,14:00:00,168,90,78,FMN GV 11 Ramsel
66,Bergstraat 71,2022-10-21,15:00:00,310,240,70,FMN GV 11 Ramsel
66,Bergstraat 71,2022-10-21,16:00:00,254,188,66,FMN GV 11 Ramsel
66,Bergstraat 71,2022-10-21,17:00:00,150,104,46,FMN GV 11 Ramsel
66,Bergstraat 71,2022-10-21,18:00:00,76,50,26,FMN GV 11 Ramsel
66,Bergstraat 71,2022-10-21,19:00:00,50,18,32,FMN GV 11 Ramsel
66,Bergstraat 71,2022-10-21,20:00:00,28,14,14,FMN GV 11 Ramsel
66,Bergstraat 71,2022-10-21,21:00:00,30,4,26,FMN GV 11 Ramsel
66,Bergstraat 71,2022-10-21,22:00:00,20,12,8,FMN GV 11 Ramsel
66,Bergstraat 71,2022-10-21,23:00:00,30,20,10,FMN GV 11 Ramsel
66,Bergstraat 71,2022-10-22,00:00:00,18,16,2,FMN GV 11 Ramsel
66,Bergstraat 71,2022-10-22,01:00:00,6,4,2,FMN GV 11 Ramsel
66,Bergstraat 71,2022-10-22,02:00:00,34,34,0,FMN GV 11 Ramsel
66,Bergstraat 71,2022-10-22,03:00:00,2,2,0,FMN GV 11 Ramsel
66,Bergstraat 71,2022-10-22,04:00:00,2,2,0,FMN GV 11 Ramsel
66,Bergstraat 71,2022-10-22,05:00:00,2,2,0,FMN GV 11 Ramsel
66,Bergstraat 71,2022-10-22,06:00:00,6,0,6,FMN GV 11 Ramsel
66,Bergstraat 71,2022-10-22,07:00:00,14,4,10,FMN GV 11 Ramsel
66,Bergstraat 71,2022-10-22,08:00:00,40,18,22,FMN GV 11 Ramsel
66,Bergstraat 71,2022-10-22,09:00:00,74,20,54,FMN GV 11 Ramsel
66,Bergstraat 71,2022-10-22,10:00:00,118,44,74,FMN GV 11 Ramsel
66,Bergstraat 71,2022-10-22,11:00:00,112,66,46,FMN GV 11 Ramsel
66,Bergstraat 71,2022-10-22,12:00:00,130,54,76,FMN GV 11 Ramsel
66,Bergstraat 71,2022-10-22,13:00:00,172,84,88,FMN GV 11 Ramsel
66,Bergstraat 71,2022-10-22,14:00:00,194,70,124,FMN GV 11 Ramsel
66,Bergstraat 71,2022-10-22,15:00:00,214,118,96,FMN GV 11 Ramsel
66,Bergstraat 71,2022-10-22,16:00:00,160,84,76,FMN GV 11 Ramsel
66,Bergstraat 71,2022-10-22,17:00:00,84,42,42,FMN GV 11 Ramsel
66,Bergstraat 71,2022-10-22,18:00:00,38,18,20,FMN GV 11 Ramsel
66,Bergstraat 71,2022-10-22,19:00:00,30,14,16,FMN GV 11 Ramsel
66,Bergstraat 71,2022-10-22,20:00:00,30,14,16,FMN GV 11 Ramsel
66,Bergstraat 71,2022-10-22,21:00:00,8,4,4,FMN GV 11 Ramsel
66,Bergstraat 71,2022-10-22,22:00:00,12,8,4,FMN GV 11 Ramsel
66,Bergstraat 71,2022-10-22,23:00:00,8,8,0,FMN GV 11 Ramsel
66,Bergstraat 71,2022-10-23,00:00:00,12,10,2,FMN GV 11 Ramsel
66,Bergstraat 71,2022-10-23,01:00:00,0,0,0,FMN GV 11 Ramsel
66,Bergstraat 71,2022-10-23,02:00:00,4,4,0,FMN GV 11 Ramsel
66,Bergstraat 71,2022-10-23,03:00:00,4,2,2,FMN GV 11 Ramsel
66,Bergstraat 71,2022-10-23,04:00:00,0,0,0,FMN GV 11 Ramsel
66,Bergstraat 71,2022-10-23,05:00:00,2,2,0,FMN GV 11 Ramsel
66,Bergstraat 71,2022-10-23,06:00:00,0,0,0,FMN GV 11 Ramsel
66,Bergstraat 71,2022-10-23,07:00:00,4,0,4,FMN GV 11 Ramsel
66,Bergstraat 71,2022-10-23,08:00:00,62,22,40,FMN GV 11 Ramsel
66,Bergstraat 71,2022-10-23,09:00:00,126,24,102,FMN GV 11 Ramsel
66,Bergstraat 71,2022-10-23,10:00:00,120,70,50,FMN GV 11 Ramsel
66,Bergstraat 71,2022-10-23,11:00:00,134,90,44,FMN GV 11 Ramsel
66,Bergstraat 71,2022-10-23,12:00:00,128,78,50,FMN GV 11 Ramsel
66,Bergstraat 71,2022-10-23,13:00:00,146,88,58,FMN GV 11 Ramsel
66,Bergstraat 71,2022-10-23,14:00:00,192,86,106,FMN GV 11 Ramsel
66,Bergstraat 71,2022-10-23,15:00:00,206,100,106,FMN GV 11 Ramsel
66,Bergstraat 71,2022-10-23,16:00:00,100,66,34,FMN GV 11 Ramsel
66,Bergstraat 71,2022-10-23,17:00:00,98,52,46,FMN GV 11 Ramsel
66,Bergstraat 71,2022-10-23,18:00:00,40,24,16,FMN GV 11 Ramsel
66,Bergstraat 71,2022-10-23,19:00:00,14,6,8,FMN GV 11 Ramsel
66,Bergstraat 71,2022-10-23,20:00:00,18,4,14,FMN GV 11 Ramsel
66,Bergstraat 71,2022-10-23,21:00:00,4,4,0,FMN GV 11 Ramsel
66,Bergstraat 71,2022-10-23,22:00:00,4,2,2,FMN GV 11 Ramsel
66,Bergstraat 71,2022-10-23,23:00:00,4,0,4,FMN GV 11 Ramsel
66,Bergstraat 71,2022-10-24,00:00:00,0,0,0,FMN GV 11 Ramsel
66,Bergstraat 71,2022-10-24,01:00:00,2,2,0,FMN GV 11 Ramsel
66,Bergstraat 71,2022-10-24,02:00:00,0,0,0,FMN GV 11 Ramsel
66,Bergstraat 71,2022-10-24,03:00:00,0,0,0,FMN GV 11 Ramsel
66,Bergstraat 71,2022-10-24,04:00:00,6,4,2,FMN GV 11 Ramsel
66,Bergstraat 71,2022-10-24,05:00:00,16,6,10,FMN GV 11 Ramsel
66,Bergstraat 71,2022-10-24,06:00:00,32,8,24,FMN GV 11 Ramsel
66,Bergstraat 71,2022-10-24,07:00:00,194,36,158,FMN GV 11 Ramsel
66,Bergstraat 71,2022-10-24,08:00:00,194,22,172,FMN GV 11 Ramsel
66,Bergstraat 71,2022-10-24,09:00:00,38,16,22,FMN GV 11 Ramsel
66,Bergstraat 71,2022-10-24,10:00:00,32,8,24,FMN GV 11 Ramsel
66,Bergstraat 71,2022-10-24,11:00:00,44,24,20,FMN GV 11 Ramsel
66,Bergstraat 71,2022-10-24,12:00:00,48,22,26,FMN GV 11 Ramsel
66,Bergstraat 71,2022-10-24,13:00:00,34,24,10,FMN GV 11 Ramsel
66,Bergstraat 71,2022-10-24,14:00:00,54,34,20,FMN GV 11 Ramsel
66,Bergstraat 71,2022-10-24,15:00:00,226,182,44,FMN GV 11 Ramsel
66,Bergstraat 71,2022-10-24,16:00:00,164,128,36,FMN GV 11 Ramsel
66,Bergstraat 71,2022-10-24,17:00:00,110,74,36,FMN GV 11 Ramsel
66,Bergstraat 71,2022-10-24,18:00:00,52,32,20,FMN GV 11 Ramsel
66,Bergstraat 71,2022-10-24,19:00:00,48,30,18,FMN GV 11 Ramsel
66,Bergstraat 71,2022-10-24,20:00:00,32,18,14,FMN GV 11 Ramsel
66,Bergstraat 71,2022-10-24,21:00:00,26,18,8,FMN GV 11 Ramsel
66,Bergstraat 71,2022-10-24,22:00:00,2,2,0,FMN GV 11 Ramsel
66,Bergstraat 71,2022-10-24,23:00:00,0,0,0,FMN GV 11 Ramsel
66,Bergstraat 71,2022-10-25,00:00:00,2,2,0,FMN GV 11 Ramsel
66,Bergstraat 71,2022-10-25,01:00:00,0,0,0,FMN GV 11 Ramsel
66,Bergstraat 71,2022-10-25,02:00:00,0,0,0,FMN GV 11 Ramsel
66,Bergstraat 71,2022-10-25,03:00:00,0,0,0,FMN GV 11 Ramsel
66,Bergstraat 71,2022-10-25,04:00:00,6,4,2,FMN GV 11 Ramsel
66,Bergstraat 71,2022-10-25,05:00:00,16,6,10,FMN GV 11 Ramsel
66,Bergstraat 71,2022-10-25,06:00:00,62,22,40,FMN GV 11 Ramsel
66,Bergstraat 71,2022-10-25,07:00:00,286,32,254,FMN GV 11 Ramsel
66,Bergstraat 71,2022-10-25,08:00:00,236,34,202,FMN GV 11 Ramsel
66,Bergstraat 71,2022-10-25,09:00:00,82,16,66,FMN GV 11 Ramsel
66,Bergstraat 71,2022-10-25,10:00:00,62,38,24,FMN GV 11 Ramsel
66,Bergstraat 71,2022-10-25,11:00:00,40,16,24,FMN GV 11 Ramsel
66,Bergstraat 71,2022-10-25,12:00:00,52,26,26,FMN GV 11 Ramsel
66,Bergstraat 71,2022-10-25,13:00:00,250,112,138,FMN GV 11 Ramsel
66,Bergstraat 71,2022-10-25,14:00:00,152,82,70,FMN GV 11 Ramsel
66,Bergstraat 71,2022-10-25,15:00:00,332,272,60,FMN GV 11 Ramsel
66,Bergstraat 71,2022-10-25,16:00:00,288,228,60,FMN GV 11 Ramsel
66,Bergstraat 71,2022-10-25,17:00:00,132,78,54,FMN GV 11 Ramsel
66,Bergstraat 71,2022-10-25,18:00:00,102,58,44,FMN GV 11 Ramsel
66,Bergstraat 71,2022-10-25,19:00:00,72,30,42,FMN GV 11 Ramsel
66,Bergstraat 71,2022-10-25,20:00:00,50,36,14,FMN GV 11 Ramsel
66,Bergstraat 71,2022-10-25,21:00:00,24,16,8,FMN GV 11 Ramsel
66,Bergstraat 71,2022-10-25,22:00:00,8,4,4,FMN GV 11 Ramsel
66,Bergstraat 71,2022-10-25,23:00:00,10,8,2,FMN GV 11 Ramsel
66,Bergstraat 71,2022-10-26,00:00:00,4,4,0,FMN GV 11 Ramsel
66,Bergstraat 71,2022-10-26,01:00:00,0,0,0,FMN GV 11 Ramsel
66,Bergstraat 71,2022-10-26,02:00:00,0,0,0,FMN GV 11 Ramsel
66,Bergstraat 71,2022-10-26,03:00:00,2,0,2,FMN GV 11 Ramsel
66,Bergstraat 71,2022-10-26,04:00:00,8,4,4,FMN GV 11 Ramsel
66,Bergstraat 71,2022-10-26,05:00:00,18,8,10,FMN GV 11 Ramsel
66,Bergstraat 71,2022-10-26,06:00:00,48,26,22,FMN GV 11 Ramsel
66,Bergstraat 71,2022-10-26,07:00:00,256,34,222,FMN GV 11 Ramsel
66,Bergstraat 71,2022-10-26,08:00:00,250,38,212,FMN GV 11 Ramsel
66,Bergstraat 71,2022-10-26,09:00:00,48,22,26,FMN GV 11 Ramsel
66,Bergstraat 71,2022-10-26,10:00:00,114,58,56,FMN GV 11 Ramsel
66,Bergstraat 71,2022-10-26,11:00:00,122,74,48,FMN GV 11 Ramsel
66,Bergstraat 71,2022-10-26,12:00:00,382,320,62,FMN GV 11 Ramsel
66,Bergstraat 71,2022-10-26,13:00:00,204,94,110,FMN GV 11 Ramsel
66,Bergstraat 71,2022-10-26,14:00:00,200,96,104,FMN GV 11 Ramsel
66,Bergstraat 71,2022-10-26,15:00:00,216,136,80,FMN GV 11 Ramsel
66,Bergstraat 71,2022-10-26,16:00:00,164,104,60,FMN GV 11 Ramsel
66,Bergstraat 71,2022-10-26,17:00:00,154,96,58,FMN GV 11 Ramsel
66,Bergstraat 71,2022-10-26,18:00:00,114,68,46,FMN GV 11 Ramsel
66,Bergstraat 71,2022-10-26,19:00:00,38,24,14,FMN GV 11 Ramsel
66,Bergstraat 71,2022-10-26,20:00:00,20,8,12,FMN GV 11 Ramsel
66,Bergstraat 71,2022-10-26,21:00:00,24,20,4,FMN GV 11 Ramsel
66,Bergstraat 71,2022-10-26,22:00:00,22,20,2,FMN GV 11 Ramsel
66,Bergstraat 71,2022-10-26,23:00:00,0,0,0,FMN GV 11 Ramsel
66,Bergstraat 71,2022-10-27,00:00:00,6,6,0,FMN GV 11 Ramsel
66,Bergstraat 71,2022-10-27,01:00:00,0,0,0,FMN GV 11 Ramsel
66,Bergstraat 71,2022-10-27,02:00:00,0,0,0,FMN GV 11 Ramsel
66,Bergstraat 71,2022-10-27,03:00:00,2,0,2,FMN GV 11 Ramsel
66,Bergstraat 71,2022-10-27,04:00:00,4,2,2,FMN GV 11 Ramsel
66,Bergstraat 71,2022-10-27,05:00:00,16,6,10,FMN GV 11 Ramsel
66,Bergstraat 71,2022-10-27,06:00:00,50,18,32,FMN GV 11 Ramsel
66,Bergstraat 71,2022-10-27,07:00:00,244,36,208,FMN GV 11 Ramsel
66,Bergstraat 71,2022-10-27,08:00:00,278,34,244,FMN GV 11 Ramsel
66,Bergstraat 71,2022-10-27,09:00:00,92,22,70,FMN GV 11 Ramsel
66,Bergstraat 71,2022-10-27,10:00:00,114,40,74,FMN GV 11 Ramsel
66,Bergstraat 71,2022-10-27,11:00:00,124,52,72,FMN GV 11 Ramsel
66,Bergstraat 71,2022-10-27,12:00:00,122,70,52,FMN GV 11 Ramsel
66,Bergstraat 71,2022-10-27,13:00:00,186,72,114,FMN GV 11 Ramsel
66,Bergstraat 71,2022-10-27,14:00:00,186,106,80,FMN GV 11 Ramsel
66,Bergstraat 71,2022-10-27,15:00:00,284,226,58,FMN GV 11 Ramsel
66,Bergstraat 71,2022-10-27,16:00:00,304,210,94,FMN GV 11 Ramsel
66,Bergstraat 71,2022-10-27,17:00:00,174,114,60,FMN GV 11 Ramsel
66,Bergstraat 71,2022-10-27,18:00:00,90,54,36,FMN GV 11 Ramsel
66,Bergstraat 71,2022-10-27,19:00:00,40,24,16,FMN GV 11 Ramsel
66,Bergstraat 71,2022-10-27,20:00:00,30,20,10,FMN GV 11 Ramsel
66,Bergstraat 71,2022-10-27,21:00:00,20,12,8,FMN GV 11 Ramsel
66,Bergstraat 71,2022-10-27,22:00:00,12,12,0,FMN GV 11 Ramsel
66,Bergstraat 71,2022-10-27,23:00:00,6,2,4,FMN GV 11 Ramsel
66,Bergstraat 71,2022-10-28,00:00:00,12,4,8,FMN GV 11 Ramsel
66,Bergstraat 71,2022-10-28,01:00:00,4,4,0,FMN GV 11 Ramsel
66,Bergstraat 71,2022-10-28,02:00:00,0,0,0,FMN GV 11 Ramsel
66,Bergstraat 71,2022-10-28,03:00:00,0,0,0,FMN GV 11 Ramsel
66,Bergstraat 71,2022-10-28,04:00:00,6,4,2,FMN GV 11 Ramsel
66,Bergstraat 71,2022-10-28,05:00:00,12,4,8,FMN GV 11 Ramsel
66,Bergstraat 71,2022-10-28,06:00:00,34,18,16,FMN GV 11 Ramsel
66,Bergstraat 71,2022-10-28,07:00:00,234,26,208,FMN GV 11 Ramsel
66,Bergstraat 71,2022-10-28,08:00:00,232,24,208,FMN GV 11 Ramsel
66,Bergstraat 71,2022-10-28,09:00:00,62,6,56,FMN GV 11 Ramsel
66,Bergstraat 71,2022-10-28,10:00:00,74,26,48,FMN GV 11 Ramsel
66,Bergstraat 71,2022-10-28,11:00:00,118,46,72,FMN GV 11 Ramsel
66,Bergstraat 71,2022-10-28,12:00:00,108,56,52,FMN GV 11 Ramsel
66,Bergstraat 71,2022-10-28,13:00:00,238,116,122,FMN GV 11 Ramsel
66,Bergstraat 71,2022-10-28,14:00:00,194,112,82,FMN GV 11 Ramsel
66,Bergstraat 71,2022-10-28,15:00:00,318,248,70,FMN GV 11 Ramsel
66,Bergstraat 71,2022-10-28,16:00:00,232,156,76,FMN GV 11 Ramsel
66,Bergstraat 71,2022-10-28,17:00:00,130,106,24,FMN GV 11 Ramsel
66,Bergstraat 71,2022-10-28,18:00:00,154,98,56,FMN GV 11 Ramsel
66,Bergstraat 71,2022-10-28,19:00:00,74,42,32,FMN GV 11 Ramsel
66,Bergstraat 71,2022-10-28,20:00:00,46,16,30,FMN GV 11 Ramsel
66,Bergstraat 71,2022-10-28,21:00:00,56,16,40,FMN GV 11 Ramsel
66,Bergstraat 71,2022-10-28,22:00:00,32,22,10,FMN GV 11 Ramsel
66,Bergstraat 71,2022-10-28,23:00:00,18,8,10,FMN GV 11 Ramsel
66,Bergstraat 71,2022-10-29,00:00:00,6,2,4,FMN GV 11 Ramsel
66,Bergstraat 71,2022-10-29,01:00:00,16,14,2,FMN GV 11 Ramsel
66,Bergstraat 71,2022-10-29,02:00:00,8,8,0,FMN GV 11 Ramsel
66,Bergstraat 71,2022-10-29,03:00:00,0,0,0,FMN GV 11 Ramsel
66,Bergstraat 71,2022-10-29,04:00:00,8,8,0,FMN GV 11 Ramsel
66,Bergstraat 71,2022-10-29,05:00:00,4,2,2,FMN GV 11 Ramsel
66,Bergstraat 71,2022-10-29,06:00:00,4,4,0,FMN GV 11 Ramsel
66,Bergstraat 71,2022-10-29,07:00:00,8,4,4,FMN GV 11 Ramsel
66,Bergstraat 71,2022-10-29,08:00:00,28,8,20,FMN GV 11 Ramsel
66,Bergstraat 71,2022-10-29,09:00:00,64,38,26,FMN GV 11 Ramsel
66,Bergstraat 71,2022-10-29,10:00:00,102,62,40,FMN GV 11 Ramsel
66,Bergstraat 71,2022-10-29,11:00:00,138,66,72,FMN GV 11 Ramsel
66,Bergstraat 71,2022-10-29,12:00:00,124,42,82,FMN GV 11 Ramsel
66,Bergstraat 71,2022-10-29,13:00:00,240,100,140,FMN GV 11 Ramsel
66,Bergstraat 71,2022-10-29,14:00:00,288,146,142,FMN GV 11 Ramsel
66,Bergstraat 71,2022-10-29,15:00:00,210,124,86,FMN GV 11 Ramsel
66,Bergstraat 71,2022-10-29,16:00:00,248,138,110,FMN GV 11 Ramsel
66,Bergstraat 71,2022-10-29,17:00:00,146,88,58,FMN GV 11 Ramsel
66,Bergstraat 71,2022-10-29,18:00:00,48,20,28,FMN GV 11 Ramsel
66,Bergstraat 71,2022-10-29,19:00:00,34,12,22,FMN GV 11 Ramsel
66,Bergstraat 71,2022-10-29,20:00:00,16,4,12,FMN GV 11 Ramsel
66,Bergstraat 71,2022-10-29,21:00:00,16,12,4,FMN GV 11 Ramsel
66,Bergstraat 71,2022-10-29,22:00:00,18,10,8,FMN GV 11 Ramsel
66,Bergstraat 71,2022-10-29,23:00:00,12,10,2,FMN GV 11 Ramsel
66,Bergstraat 71,2022-10-30,00:00:00,0,0,0,FMN GV 11 Ramsel
66,Bergstraat 71,2022-10-30,01:00:00,10,10,0,FMN GV 11 Ramsel
66,Bergstraat 71,2022-10-30,02:00:00,10,10,0,FMN GV 11 Ramsel
66,Bergstraat 71,2022-10-30,03:00:00,0,0,0,FMN GV 11 Ramsel
66,Bergstraat 71,2022-10-30,04:00:00,2,0,2,FMN GV 11 Ramsel
66,Bergstraat 71,2022-10-30,05:00:00,2,0,2,FMN GV 11 Ramsel
66,Bergstraat 71,2022-10-30,06:00:00,0,0,0,FMN GV 11 Ramsel
66,Bergstraat 71,2022-10-30,07:00:00,14,8,6,FMN GV 11 Ramsel
66,Bergstraat 71,2022-10-30,08:00:00,80,20,60,FMN GV 11 Ramsel
66,Bergstraat 71,2022-10-30,09:00:00,120,52,68,FMN GV 11 Ramsel
66,Bergstraat 71,2022-10-30,10:00:00,142,82,60,FMN GV 11 Ramsel
66,Bergstraat 71,2022-10-30,11:00:00,182,84,98,FMN GV 11 Ramsel
66,Bergstraat 71,2022-10-30,12:00:00,188,86,102,FMN GV 11 Ramsel
66,Bergstraat 71,2022-10-30,13:00:00,280,132,148,FMN GV 11 Ramsel
66,Bergstraat 71,2022-10-30,14:00:00,330,190,140,FMN GV 11 Ramsel
66,Bergstraat 71,2022-10-30,15:00:00,292,170,122,FMN GV 11 Ramsel
66,Bergstraat 71,2022-10-30,16:00:00,210,114,96,FMN GV 11 Ramsel
66,Bergstraat 71,2022-10-30,17:00:00,66,30,36,FMN GV 11 Ramsel
66,Bergstraat 71,2022-10-30,18:00:00,30,14,16,FMN GV 11 Ramsel
66,Bergstraat 71,2022-10-30,19:00:00,2,0,2,FMN GV 11 Ramsel
66,Bergstraat 71,2022-10-30,20:00:00,12,6,6,FMN GV 11 Ramsel
66,Bergstraat 71,2022-10-30,21:00:00,22,0,22,FMN GV 11 Ramsel
66,Bergstraat 71,2022-10-30,22:00:00,4,2,2,FMN GV 11 Ramsel
66,Bergstraat 71,2022-10-30,23:00:00,2,2,0,FMN GV 11 Ramsel
66,Bergstraat 71,2022-10-31,00:00:00,2,2,0,FMN GV 11 Ramsel
66,Bergstraat 71,2022-10-31,01:00:00,4,2,2,FMN GV 11 Ramsel
66,Bergstraat 71,2022-10-31,02:00:00,0,0,0,FMN GV 11 Ramsel
66,Bergstraat 71,2022-10-31,03:00:00,2,0,2,FMN GV 11 Ramsel
66,Bergstraat 71,2022-10-31,04:00:00,0,0,0,FMN GV 11 Ramsel
66,Bergstraat 71,2022-10-31,05:00:00,8,4,4,FMN GV 11 Ramsel
66,Bergstraat 71,2022-10-31,06:00:00,8,6,2,FMN GV 11 Ramsel
66,Bergstraat 71,2022-10-31,07:00:00,30,16,14,FMN GV 11 Ramsel
66,Bergstraat 71,2022-10-31,08:00:00,26,14,12,FMN GV 11 Ramsel
66,Bergstraat 71,2022-10-31,09:00:00,24,8,16,FMN GV 11 Ramsel
66,Bergstraat 71,2022-10-31,10:00:00,68,30,38,FMN GV 11 Ramsel
66,Bergstraat 71,2022-10-31,11:00:00,50,24,26,FMN GV 11 Ramsel
66,Bergstraat 71,2022-10-31,12:00:00,100,52,48,FMN GV 11 Ramsel
66,Bergstraat 71,2022-10-31,13:00:00,134,54,80,FMN GV 11 Ramsel
66,Bergstraat 71,2022-10-31,14:00:00,188,106,82,FMN GV 11 Ramsel
66,Bergstraat 71,2022-10-31,15:00:00,150,84,66,FMN GV 11 Ramsel
66,Bergstraat 71,2022-10-31,16:00:00,102,50,52,FMN GV 11 Ramsel
66,Bergstraat 71,2022-10-31,17:00:00,90,56,34,FMN GV 11 Ramsel
66,Bergstraat 71,2022-10-31,18:00:00,38,14,24,FMN GV 11 Ramsel
66,Bergstraat 71,2022-10-31,19:00:00,14,8,6,FMN GV 11 Ramsel
66,Bergstraat 71,2022-10-31,20:00:00,28,18,10,FMN GV 11 Ramsel
66,Bergstraat 71,2022-10-31,21:00:00,18,8,10,FMN GV 11 Ramsel
66,Bergstraat 71,2022-10-31,22:00:00,22,20,2,FMN GV 11 Ramsel
66,Bergstraat 71,2022-10-31,23:00:00,8,6,2,FMN GV 11 Ramsel
66,Bergstraat 71,2022-11-01,00:00:00,4,4,0,FMN GV 11 Ramsel
66,Bergstraat 71,2022-11-01,01:00:00,8,8,0,FMN GV 11 Ramsel
66,Bergstraat 71,2022-11-01,02:00:00,0,0,0,FMN GV 11 Ramsel
66,Bergstraat 71,2022-11-01,03:00:00,6,4,2,FMN GV 11 Ramsel
66,Bergstraat 71,2022-11-01,04:00:00,0,0,0,FMN GV 11 Ramsel
66,Bergstraat 71,2022-11-01,05:00:00,2,2,0,FMN GV 11 Ramsel
66,Bergstraat 71,2022-11-01,06:00:00,4,2,2,FMN GV 11 Ramsel
66,Bergstraat 71,2022-11-01,07:00:00,14,2,12,FMN GV 11 Ramsel
66,Bergstraat 71,2022-11-01,08:00:00,38,2,36,FMN GV 11 Ramsel
66,Bergstraat 71,2022-11-01,09:00:00,76,24,52,FMN GV 11 Ramsel
66,Bergstraat 71,2022-11-01,10:00:00,100,46,54,FMN GV 11 Ramsel
66,Bergstraat 71,2022-11-01,11:00:00,136,70,66,FMN GV 11 Ramsel
66,Bergstraat 71,2022-11-01,12:00:00,100,64,36,FMN GV 11 Ramsel
66,Bergstraat 71,2022-11-01,13:00:00,136,78,58,FMN GV 11 Ramsel
66,Bergstraat 71,2022-11-01,14:00:00,168,86,82,FMN GV 11 Ramsel
66,Bergstraat 71,2022-11-01,15:00:00,116,58,58,FMN GV 11 Ramsel
66,Bergstraat 71,2022-11-01,16:00:00,72,38,34,FMN GV 11 Ramsel
66,Bergstraat 71,2022-11-01,17:00:00,32,18,14,FMN GV 11 Ramsel
66,Bergstraat 71,2022-11-01,18:00:00,12,6,6,FMN GV 11 Ramsel
66,Bergstraat 71,2022-11-01,19:00:00,16,4,12,FMN GV 11 Ramsel
66,Bergstraat 71,2022-11-01,20:00:00,16,10,6,FMN GV 11 Ramsel
66,Bergstraat 71,2022-11-01,21:00:00,2,2,0,FMN GV 11 Ramsel
66,Bergstraat 71,2022-11-01,22:00:00,4,2,2,FMN GV 11 Ramsel
66,Bergstraat 71,2022-11-01,23:00:00,8,2,6,FMN GV 11 Ramsel
66,Bergstraat 71,2022-11-02,00:00:00,6,6,0,FMN GV 11 Ramsel
66,Bergstraat 71,2022-11-02,01:00:00,2,2,0,FMN GV 11 Ramsel
66,Bergstraat 71,2022-11-02,02:00:00,0,0,0,FMN GV 11 Ramsel
66,Bergstraat 71,2022-11-02,03:00:00,0,0,0,FMN GV 11 Ramsel
66,Bergstraat 71,2022-11-02,04:00:00,2,0,2,FMN GV 11 Ramsel
66,Bergstraat 71,2022-11-02,05:00:00,14,6,8,FMN GV 11 Ramsel
66,Bergstraat 71,2022-11-02,06:00:00,24,10,14,FMN GV 11 Ramsel
66,Bergstraat 71,2022-11-02,07:00:00,56,22,34,FMN GV 11 Ramsel
66,Bergstraat 71,2022-11-02,08:00:00,64,28,36,FMN GV 11 Ramsel
66,Bergstraat 71,2022-11-02,09:00:00,72,18,54,FMN GV 11 Ramsel
66,Bergstraat 71,2022-11-02,10:00:00,82,44,38,FMN GV 11 Ramsel
66,Bergstraat 71,2022-11-02,11:00:00,96,44,52,FMN GV 11 Ramsel
66,Bergstraat 71,2022-11-02,12:00:00,74,42,32,FMN GV 11 Ramsel
66,Bergstraat 71,2022-11-02,13:00:00,148,66,82,FMN GV 11 Ramsel
66,Bergstraat 71,2022-11-02,14:00:00,204,94,110,FMN GV 11 Ramsel
66,Bergstraat 71,2022-11-02,15:00:00,182,92,90,FMN GV 11 Ramsel
66,Bergstraat 71,2022-11-02,16:00:00,174,110,64,FMN GV 11 Ramsel
66,Bergstraat 71,2022-11-02,17:00:00,114,68,46,FMN GV 11 Ramsel
66,Bergstraat 71,2022-11-02,18:00:00,54,24,30,FMN GV 11 Ramsel
66,Bergstraat 71,2022-11-02,19:00:00,72,44,28,FMN GV 11 Ramsel
66,Bergstraat 71,2022-11-02,20:00:00,22,10,12,FMN GV 11 Ramsel
66,Bergstraat 71,2022-11-02,21:00:00,22,14,8,FMN GV 11 Ramsel
66,Bergstraat 71,2022-11-02,22:00:00,12,6,6,FMN GV 11 Ramsel
66,Bergstraat 71,2022-11-02,23:00:00,14,10,4,FMN GV 11 Ramsel
66,Bergstraat 71,2022-11-03,00:00:00,2,2,0,FMN GV 11 Ramsel
66,Bergstraat 71,2022-11-03,01:00:00,6,6,0,FMN GV 11 Ramsel
66,Bergstraat 71,2022-11-03,02:00:00,0,0,0,FMN GV 11 Ramsel
66,Bergstraat 71,2022-11-03,03:00:00,0,0,0,FMN GV 11 Ramsel
66,Bergstraat 71,2022-11-03,04:00:00,2,2,0,FMN GV 11 Ramsel
66,Bergstraat 71,2022-11-03,05:00:00,18,10,8,FMN GV 11 Ramsel
66,Bergstraat 71,2022-11-03,06:00:00,34,12,22,FMN GV 11 Ramsel
66,Bergstraat 71,2022-11-03,07:00:00,44,16,28,FMN GV 11 Ramsel
66,Bergstraat 71,2022-11-03,08:00:00,46,14,32,FMN GV 11 Ramsel
66,Bergstraat 71,2022-11-03,09:00:00,72,28,44,FMN GV 11 Ramsel
66,Bergstraat 71,2022-11-03,10:00:00,92,46,46,FMN GV 11 Ramsel
66,Bergstraat 71,2022-11-03,11:00:00,82,50,32,FMN GV 11 Ramsel
66,Bergstraat 71,2022-11-03,12:00:00,66,32,34,FMN GV 11 Ramsel
66,Bergstraat 71,2022-11-03,13:00:00,66,28,38,FMN GV 11 Ramsel
66,Bergstraat 71,2022-11-03,14:00:00,62,46,16,FMN GV 11 Ramsel
66,Bergstraat 71,2022-11-03,15:00:00,28,16,12,FMN GV 11 Ramsel
66,Bergstraat 71,2022-11-03,16:00:00,48,32,16,FMN GV 11 Ramsel
66,Bergstraat 71,2022-11-03,17:00:00,54,34,20,FMN GV 11 Ramsel
66,Bergstraat 71,2022-11-03,18:00:00,24,8,16,FMN GV 11 Ramsel
66,Bergstraat 71,2022-11-03,19:00:00,34,22,12,FMN GV 11 Ramsel
66,Bergstraat 71,2022-11-03,20:00:00,10,8,2,FMN GV 11 Ramsel
66,Bergstraat 71,2022-11-03,21:00:00,12,8,4,FMN GV 11 Ramsel
66,Bergstraat 71,2022-11-03,22:00:00,8,2,6,FMN GV 11 Ramsel
66,Bergstraat 71,2022-11-03,23:00:00,14,4,10,FMN GV 11 Ramsel
66,Bergstraat 71,2022-11-04,00:00:00,0,0,0,FMN GV 11 Ramsel
66,Bergstraat 71,2022-11-04,01:00:00,0,0,0,FMN GV 11 Ramsel
66,Bergstraat 71,2022-11-04,02:00:00,0,0,0,FMN GV 11 Ramsel
66,Bergstraat 71,2022-11-04,03:00:00,0,0,0,FMN GV 11 Ramsel
66,Bergstraat 71,2022-11-04,04:00:00,2,2,0,FMN GV 11 Ramsel
66,Bergstraat 71,2022-11-04,05:00:00,16,8,8,FMN GV 11 Ramsel
66,Bergstraat 71,2022-11-04,06:00:00,16,4,12,FMN GV 11 Ramsel
66,Bergstraat 71,2022-11-04,07:00:00,34,14,20,FMN GV 11 Ramsel
66,Bergstraat 71,2022-11-04,08:00:00,22,4,18,FMN GV 11 Ramsel
66,Bergstraat 71,2022-11-04,09:00:00,18,10,8,FMN GV 11 Ramsel
66,Bergstraat 71,2022-11-04,10:00:00,28,14,14,FMN GV 11 Ramsel
66,Bergstraat 71,2022-11-04,11:00:00,48,24,24,FMN GV 11 Ramsel
66,Bergstraat 71,2022-11-04,12:00:00,48,20,28,FMN GV 11 Ramsel
66,Bergstraat 71,2022-11-04,13:00:00,60,28,32,FMN GV 11 Ramsel
66,Bergstraat 71,2022-11-04,14:00:00,86,48,38,FMN GV 11 Ramsel
66,Bergstraat 71,2022-11-04,15:00:00,48,28,20,FMN GV 11 Ramsel
66,Bergstraat 71,2022-11-04,16:00:00,64,34,30,FMN GV 11 Ramsel
66,Bergstraat 71,2022-11-04,17:00:00,70,50,20,FMN GV 11 Ramsel
66,Bergstraat 71,2022-11-04,18:00:00,34,18,16,FMN GV 11 Ramsel
66,Bergstraat 71,2022-11-04,19:00:00,26,4,22,FMN GV 11 Ramsel
66,Bergstraat 71,2022-11-04,20:00:00,10,4,6,FMN GV 11 Ramsel
66,Bergstraat 71,2022-11-04,21:00:00,8,6,2,FMN GV 11 Ramsel
66,Bergstraat 71,2022-11-04,22:00:00,26,14,12,FMN GV 11 Ramsel
66,Bergstraat 71,2022-11-04,23:00:00,8,4,4,FMN GV 11 Ramsel
66,Bergstraat 71,2022-11-05,00:00:00,6,2,4,FMN GV 11 Ramsel
66,Bergstraat 71,2022-11-05,01:00:00,10,8,2,FMN GV 11 Ramsel
66,Bergstraat 71,2022-11-05,02:00:00,6,6,0,FMN GV 11 Ramsel
66,Bergstraat 71,2022-11-05,03:00:00,14,8,6,FMN GV 11 Ramsel
66,Bergstraat 71,2022-11-05,04:00:00,0,0,0,FMN GV 11 Ramsel
66,Bergstraat 71,2022-11-05,05:00:00,2,2,0,FMN GV 11 Ramsel
66,Bergstraat 71,2022-11-05,06:00:00,2,2,0,FMN GV 11 Ramsel
66,Bergstraat 71,2022-11-05,07:00:00,6,0,6,FMN GV 11 Ramsel
66,Bergstraat 71,2022-11-05,08:00:00,34,10,24,FMN GV 11 Ramsel
66,Bergstraat 71,2022-11-05,09:00:00,50,22,28,FMN GV 11 Ramsel
66,Bergstraat 71,2022-11-05,10:00:00,112,32,80,FMN GV 11 Ramsel
66,Bergstraat 71,2022-11-05,11:00:00,124,46,78,FMN GV 11 Ramsel
66,Bergstraat 71,2022-11-05,12:00:00,102,52,50,FMN GV 11 Ramsel
66,Bergstraat 71,2022-11-05,13:00:00,160,82,78,FMN GV 11 Ramsel
66,Bergstraat 71,2022-11-05,14:00:00,172,86,86,FMN GV 11 Ramsel
66,Bergstraat 71,2022-11-05,15:00:00,92,44,48,FMN GV 11 Ramsel
66,Bergstraat 71,2022-11-05,16:00:00,86,50,36,FMN GV 11 Ramsel
66,Bergstraat 71,2022-11-05,17:00:00,42,24,18,FMN GV 11 Ramsel
66,Bergstraat 71,2022-11-05,18:00:00,20,4,16,FMN GV 11 Ramsel
66,Bergstraat 71,2022-11-05,19:00:00,10,6,4,FMN GV 11 Ramsel
66,Bergstraat 71,2022-11-05,20:00:00,26,10,16,FMN GV 11 Ramsel
66,Bergstraat 71,2022-11-05,21:00:00,12,6,6,FMN GV 11 Ramsel
66,Bergstraat 71,2022-11-05,22:00:00,10,2,8,FMN GV 11 Ramsel
66,Bergstraat 71,2022-11-05,23:00:00,12,2,10,FMN GV 11 Ramsel
66,Bergstraat 71,2022-11-06,00:00:00,4,4,0,FMN GV 11 Ramsel
66,Bergstraat 71,2022-11-06,01:00:00,16,6,10,FMN GV 11 Ramsel
66,Bergstraat 71,2022-11-06,02:00:00,2,2,0,FMN GV 11 Ramsel
66,Bergstraat 71,2022-11-06,03:00:00,4,2,2,FMN GV 11 Ramsel
66,Bergstraat 71,2022-11-06,04:00:00,8,8,0,FMN GV 11 Ramsel
66,Bergstraat 71,2022-11-06,05:00:00,2,2,0,FMN GV 11 Ramsel
66,Bergstraat 71,2022-11-06,06:00:00,4,0,4,FMN GV 11 Ramsel
66,Bergstraat 71,2022-11-06,07:00:00,6,0,6,FMN GV 11 Ramsel
66,Bergstraat 71,2022-11-06,08:00:00,60,14,46,FMN GV 11 Ramsel
66,Bergstraat 71,2022-11-06,09:00:00,84,28,56,FMN GV 11 Ramsel
66,Bergstraat 71,2022-11-06,10:00:00,78,42,36,FMN GV 11 Ramsel
66,Bergstraat 71,2022-11-06,11:00:00,70,42,28,FMN GV 11 Ramsel
66,Bergstraat 71,2022-11-06,12:00:00,40,18,22,FMN GV 11 Ramsel
66,Bergstraat 71,2022-11-06,13:00:00,60,34,26,FMN GV 11 Ramsel
66,Bergstraat 71,2022-11-06,14:00:00,22,6,16,FMN GV 11 Ramsel
66,Bergstraat 71,2022-11-06,15:00:00,22,14,8,FMN GV 11 Ramsel
66,Bergstraat 71,2022-11-06,16:00:00,2,0,2,FMN GV 11 Ramsel
66,Bergstraat 71,2022-11-06,17:00:00,8,6,2,FMN GV 11 Ramsel
66,Bergstraat 71,2022-11-06,18:00:00,12,0,12,FMN GV 11 Ramsel
66,Bergstraat 71,2022-11-06,19:00:00,24,16,8,FMN GV 11 Ramsel
66,Bergstraat 71,2022-11-06,20:00:00,12,4,8,FMN GV 11 Ramsel
66,Bergstraat 71,2022-11-06,21:00:00,8,4,4,FMN GV 11 Ramsel
66,Bergstraat 71,2022-11-06,22:00:00,6,6,0,FMN GV 11 Ramsel
66,Bergstraat 71,2022-11-06,23:00:00,2,2,0,FMN GV 11 Ramsel
66,Bergstraat 71,2022-11-07,00:00:00,6,2,4,FMN GV 11 Ramsel
66,Bergstraat 71,2022-11-07,01:00:00,0,0,0,FMN GV 11 Ramsel
66,Bergstraat 71,2022-11-07,02:00:00,2,0,2,FMN GV 11 Ramsel
66,Bergstraat 71,2022-11-07,03:00:00,2,0,2,FMN GV 11 Ramsel
66,Bergstraat 71,2022-11-07,04:00:00,6,6,0,FMN GV 11 Ramsel
66,Bergstraat 71,2022-11-07,05:00:00,16,12,4,FMN GV 11 Ramsel
66,Bergstraat 71,2022-11-07,06:00:00,46,10,36,FMN GV 11 Ramsel
66,Bergstraat 71,2022-11-07,07:00:00,228,24,204,FMN GV 11 Ramsel
66,Bergstraat 71,2022-11-07,08:00:00,226,14,212,FMN GV 11 Ramsel
66,Bergstraat 71,2022-11-07,09:00:00,52,16,36,FMN GV 11 Ramsel
66,Bergstraat 71,2022-11-07,10:00:00,24,10,14,FMN GV 11 Ramsel
66,Bergstraat 71,2022-11-07,11:00:00,28,16,12,FMN GV 11 Ramsel
66,Bergstraat 71,2022-11-07,12:00:00,36,20,16,FMN GV 11 Ramsel
66,Bergstraat 71,2022-11-07,13:00:00,72,34,38,FMN GV 11 Ramsel
66,Bergstraat 71,2022-11-07,14:00:00,108,60,48,FMN GV 11 Ramsel
66,Bergstraat 71,2022-11-07,15:00:00,306,254,52,FMN GV 11 Ramsel
66,Bergstraat 71,2022-11-07,16:00:00,182,146,36,FMN GV 11 Ramsel
66,Bergstraat 71,2022-11-07,17:00:00,86,58,28,FMN GV 11 Ramsel
66,Bergstraat 71,2022-11-07,18:00:00,42,24,18,FMN GV 11 Ramsel
66,Bergstraat 71,2022-11-07,19:00:00,36,18,18,FMN GV 11 Ramsel
66,Bergstraat 71,2022-11-07,20:00:00,38,26,12,FMN GV 11 Ramsel
66,Bergstraat 71,2022-11-07,21:00:00,22,18,4,FMN GV 11 Ramsel
66,Bergstraat 71,2022-11-07,22:00:00,14,10,4,FMN GV 11 Ramsel
66,Bergstraat 71,2022-11-07,23:00:00,2,0,2,FMN GV 11 Ramsel
66,Bergstraat 71,2022-11-08,00:00:00,0,0,0,FMN GV 11 Ramsel
66,Bergstraat 71,2022-11-08,01:00:00,0,0,0,FMN GV 11 Ramsel
66,Bergstraat 71,2022-11-08,02:00:00,0,0,0,FMN GV 11 Ramsel
66,Bergstraat 71,2022-11-08,03:00:00,0,0,0,FMN GV 11 Ramsel
66,Bergstraat 71,2022-11-08,04:00:00,6,4,2,FMN GV 11 Ramsel
66,Bergstraat 71,2022-11-08,05:00:00,18,8,10,FMN GV 11 Ramsel
66,Bergstraat 71,2022-11-08,06:00:00,62,22,40,FMN GV 11 Ramsel
66,Bergstraat 71,2022-11-08,07:00:00,298,32,266,FMN GV 11 Ramsel
66,Bergstraat 71,2022-11-08,08:00:00,228,42,186,FMN GV 11 Ramsel
66,Bergstraat 71,2022-11-08,09:00:00,94,24,70,FMN GV 11 Ramsel
66,Bergstraat 71,2022-11-08,10:00:00,76,26,50,FMN GV 11 Ramsel
66,Bergstraat 71,2022-11-08,11:00:00,84,48,36,FMN GV 11 Ramsel
66,Bergstraat 71,2022-11-08,12:00:00,98,54,44,FMN GV 11 Ramsel
66,Bergstraat 71,2022-11-08,13:00:00,212,96,116,FMN GV 11 Ramsel
66,Bergstraat 71,2022-11-08,14:00:00,196,106,90,FMN GV 11 Ramsel
66,Bergstraat 71,2022-11-08,15:00:00,294,244,50,FMN GV 11 Ramsel
66,Bergstraat 71,2022-11-08,16:00:00,294,226,68,FMN GV 11 Ramsel
66,Bergstraat 71,2022-11-08,17:00:00,164,90,74,FMN GV 11 Ramsel
66,Bergstraat 71,2022-11-08,18:00:00,94,64,30,FMN GV 11 Ramsel
66,Bergstraat 71,2022-11-08,19:00:00,56,22,34,FMN GV 11 Ramsel
66,Bergstraat 71,2022-11-08,20:00:00,44,32,12,FMN GV 11 Ramsel
66,Bergstraat 71,2022-11-08,21:00:00,34,28,6,FMN GV 11 Ramsel
66,Bergstraat 71,2022-11-08,22:00:00,8,6,2,FMN GV 11 Ramsel
66,Bergstraat 71,2022-11-08,23:00:00,0,0,0,FMN GV 11 Ramsel
66,Bergstraat 71,2022-11-09,00:00:00,0,0,0,FMN GV 11 Ramsel
66,Bergstraat 71,2022-11-09,01:00:00,0,0,0,FMN GV 11 Ramsel
66,Bergstraat 71,2022-11-09,02:00:00,2,2,0,FMN GV 11 Ramsel
66,Bergstraat 71,2022-11-09,03:00:00,0,0,0,FMN GV 11 Ramsel
66,Bergstraat 71,2022-11-09,04:00:00,6,4,2,FMN GV 11 Ramsel
66,Bergstraat 71,2022-11-09,05:00:00,12,6,6,FMN GV 11 Ramsel
66,Bergstraat 71,2022-11-09,06:00:00,48,22,26,FMN GV 11 Ramsel
66,Bergstraat 71,2022-11-09,07:00:00,256,24,232,FMN GV 11 Ramsel
66,Bergstraat 71,2022-11-09,08:00:00,232,36,196,FMN GV 11 Ramsel
66,Bergstraat 71,2022-11-09,09:00:00,70,26,44,FMN GV 11 Ramsel
66,Bergstraat 71,2022-11-09,10:00:00,82,46,36,FMN GV 11 Ramsel
66,Bergstraat 71,2022-11-09,11:00:00,108,68,40,FMN GV 11 Ramsel
66,Bergstraat 71,2022-11-09,12:00:00,318,276,42,FMN GV 11 Ramsel
66,Bergstraat 71,2022-11-09,13:00:00,92,46,46,FMN GV 11 Ramsel
66,Bergstraat 71,2022-11-09,14:00:00,66,36,30,FMN GV 11 Ramsel
66,Bergstraat 71,2022-11-09,15:00:00,88,46,42,FMN GV 11 Ramsel
66,Bergstraat 71,2022-11-09,16:00:00,104,62,42,FMN GV 11 Ramsel
66,Bergstraat 71,2022-11-09,17:00:00,104,54,50,FMN GV 11 Ramsel
66,Bergstraat 71,2022-11-09,18:00:00,72,34,38,FMN GV 11 Ramsel
66,Bergstraat 71,2022-11-09,19:00:00,42,22,20,FMN GV 11 Ramsel
66,Bergstraat 71,2022-11-09,20:00:00,40,28,12,FMN GV 11 Ramsel
66,Bergstraat 71,2022-11-09,21:00:00,8,6,2,FMN GV 11 Ramsel
66,Bergstraat 71,2022-11-09,22:00:00,24,24,0,FMN GV 11 Ramsel
66,Bergstraat 71,2022-11-09,23:00:00,4,2,2,FMN GV 11 Ramsel
66,Bergstraat 71,2022-11-10,00:00:00,2,0,2,FMN GV 11 Ramsel
66,Bergstraat 71,2022-11-10,01:00:00,2,2,0,FMN GV 11 Ramsel
66,Bergstraat 71,2022-11-10,02:00:00,4,2,2,FMN GV 11 Ramsel
66,Bergstraat 71,2022-11-10,03:00:00,0,0,0,FMN GV 11 Ramsel
66,Bergstraat 71,2022-11-10,04:00:00,8,6,2,FMN GV 11 Ramsel
66,Bergstraat 71,2022-11-10,05:00:00,22,12,10,FMN GV 11 Ramsel
66,Bergstraat 71,2022-11-10,06:00:00,48,20,28,FMN GV 11 Ramsel
66,Bergstraat 71,2022-11-10,07:00:00,250,32,218,FMN GV 11 Ramsel
66,Bergstraat 71,2022-11-10,08:00:00,242,40,202,FMN GV 11 Ramsel
66,Bergstraat 71,2022-11-10,09:00:00,74,16,58,FMN GV 11 Ramsel
66,Bergstraat 71,2022-11-10,10:00:00,74,16,58,FMN GV 11 Ramsel
66,Bergstraat 71,2022-11-10,11:00:00,70,46,24,FMN GV 11 Ramsel
66,Bergstraat 71,2022-11-10,12:00:00,112,70,42,FMN GV 11 Ramsel
66,Bergstraat 71,2022-11-10,13:00:00,130,60,70,FMN GV 11 Ramsel
66,Bergstraat 71,2022-11-10,14:00:00,138,64,74,FMN GV 11 Ramsel
66,Bergstraat 71,2022-11-10,15:00:00,308,256,52,FMN GV 11 Ramsel
66,Bergstraat 71,2022-11-10,16:00:00,264,202,62,FMN GV 11 Ramsel
66,Bergstraat 71,2022-11-10,17:00:00,98,72,26,FMN GV 11 Ramsel
66,Bergstraat 71,2022-11-10,18:00:00,84,42,42,FMN GV 11 Ramsel
66,Bergstraat 71,2022-11-10,19:00:00,56,24,32,FMN GV 11 Ramsel
66,Bergstraat 71,2022-11-10,20:00:00,26,18,8,FMN GV 11 Ramsel
66,Bergstraat 71,2022-11-10,21:00:00,12,6,6,FMN GV 11 Ramsel
66,Bergstraat 71,2022-11-10,22:00:00,18,18,0,FMN GV 11 Ramsel
66,Bergstraat 71,2022-11-10,23:00:00,10,4,6,FMN GV 11 Ramsel
66,Bergstraat 71,2022-11-11,00:00:00,8,8,0,FMN GV 11 Ramsel
66,Bergstraat 71,2022-11-11,01:00:00,6,2,4,FMN GV 11 Ramsel
66,Bergstraat 71,2022-11-11,02:00:00,6,6,0,FMN GV 11 Ramsel
66,Bergstraat 71,2022-11-11,03:00:00,0,0,0,FMN GV 11 Ramsel
66,Bergstraat 71,2022-11-11,04:00:00,4,4,0,FMN GV 11 Ramsel
66,Bergstraat 71,2022-11-11,05:00:00,4,4,0,FMN GV 11 Ramsel
66,Bergstraat 71,2022-11-11,06:00:00,8,2,6,FMN GV 11 Ramsel
66,Bergstraat 71,2022-11-11,07:00:00,6,4,2,FMN GV 11 Ramsel
66,Bergstraat 71,2022-11-11,08:00:00,38,16,22,FMN GV 11 Ramsel
66,Bergstraat 71,2022-11-11,09:00:00,64,20,44,FMN GV 11 Ramsel
66,Bergstraat 71,2022-11-11,10:00:00,90,28,62,FMN GV 11 Ramsel
66,Bergstraat 71,2022-11-11,11:00:00,146,78,68,FMN GV 11 Ramsel
66,Bergstraat 71,2022-11-11,12:00:00,136,60,76,FMN GV 11 Ramsel
66,Bergstraat 71,2022-11-11,13:00:00,188,84,104,FMN GV 11 Ramsel
66,Bergstraat 71,2022-11-11,14:00:00,194,84,110,FMN GV 11 Ramsel
66,Bergstraat 71,2022-11-11,15:00:00,192,120,72,FMN GV 11 Ramsel
66,Bergstraat 71,2022-11-11,16:00:00,118,82,36,FMN GV 11 Ramsel
66,Bergstraat 71,2022-11-11,17:00:00,44,16,28,FMN GV 11 Ramsel
66,Bergstraat 71,2022-11-11,18:00:00,12,0,12,FMN GV 11 Ramsel
66,Bergstraat 71,2022-11-11,19:00:00,16,8,8,FMN GV 11 Ramsel
66,Bergstraat 71,2022-11-11,20:00:00,8,4,4,FMN GV 11 Ramsel
66,Bergstraat 71,2022-11-11,21:00:00,8,4,4,FMN GV 11 Ramsel
66,Bergstraat 71,2022-11-11,22:00:00,16,12,4,FMN GV 11 Ramsel
66,Bergstraat 71,2022-11-11,23:00:00,22,16,6,FMN GV 11 Ramsel
66,Bergstraat 71,2022-11-12,00:00:00,4,2,2,FMN GV 11 Ramsel
66,Bergstraat 71,2022-11-12,01:00:00,0,0,0,FMN GV 11 Ramsel
66,Bergstraat 71,2022-11-12,02:00:00,4,2,2,FMN GV 11 Ramsel
66,Bergstraat 71,2022-11-12,03:00:00,0,0,0,FMN GV 11 Ramsel
66,Bergstraat 71,2022-11-12,04:00:00,2,2,0,FMN GV 11 Ramsel
66,Bergstraat 71,2022-11-12,05:00:00,2,0,2,FMN GV 11 Ramsel
66,Bergstraat 71,2022-11-12,06:00:00,2,2,0,FMN GV 11 Ramsel
66,Bergstraat 71,2022-11-12,07:00:00,4,2,2,FMN GV 11 Ramsel
66,Bergstraat 71,2022-11-12,08:00:00,18,4,14,FMN GV 11 Ramsel
66,Bergstraat 71,2022-11-12,09:00:00,60,14,46,FMN GV 11 Ramsel
66,Bergstraat 71,2022-11-12,10:00:00,106,68,38,FMN GV 11 Ramsel
66,Bergstraat 71,2022-11-12,11:00:00,122,70,52,FMN GV 11 Ramsel
66,Bergstraat 71,2022-11-12,12:00:00,150,58,92,FMN GV 11 Ramsel
66,Bergstraat 71,2022-11-12,13:00:00,268,98,170,FMN GV 11 Ramsel
66,Bergstraat 71,2022-11-12,14:00:00,248,126,122,FMN GV 11 Ramsel
66,Bergstraat 71,2022-11-12,15:00:00,276,170,106,FMN GV 11 Ramsel
66,Bergstraat 71,2022-11-12,16:00:00,136,68,68,FMN GV 11 Ramsel
66,Bergstraat 71,2022-11-12,17:00:00,76,38,38,FMN GV 11 Ramsel
66,Bergstraat 71,2022-11-12,18:00:00,22,10,12,FMN GV 11 Ramsel
66,Bergstraat 71,2022-11-12,19:00:00,16,2,14,FMN GV 11 Ramsel
66,Bergstraat 71,2022-11-12,20:00:00,26,12,14,FMN GV 11 Ramsel
66,Bergstraat 71,2022-11-12,21:00:00,34,8,26,FMN GV 11 Ramsel
66,Bergstraat 71,2022-11-12,22:00:00,10,10,0,FMN GV 11 Ramsel
66,Bergstraat 71,2022-11-12,23:00:00,20,12,8,FMN GV 11 Ramsel
66,Bergstraat 71,2022-11-13,00:00:00,4,4,0,FMN GV 11 Ramsel
66,Bergstraat 71,2022-11-13,01:00:00,8,6,2,FMN GV 11 Ramsel
66,Bergstraat 71,2022-11-13,02:00:00,8,4,4,FMN GV 11 Ramsel
66,Bergstraat 71,2022-11-13,03:00:00,20,14,6,FMN GV 11 Ramsel
66,Bergstraat 71,2022-11-13,04:00:00,0,0,0,FMN GV 11 Ramsel
66,Bergstraat 71,2022-11-13,05:00:00,4,4,0,FMN GV 11 Ramsel
66,Bergstraat 71,2022-11-13,06:00:00,0,0,0,FMN GV 11 Ramsel
66,Bergstraat 71,2022-11-13,07:00:00,8,2,6,FMN GV 11 Ramsel
66,Bergstraat 71,2022-11-13,08:00:00,66,14,52,FMN GV 11 Ramsel
66,Bergstraat 71,2022-11-13,09:00:00,88,24,64,FMN GV 11 Ramsel
66,Bergstraat 71,2022-11-13,10:00:00,106,68,38,FMN GV 11 Ramsel
66,Bergstraat 71,2022-11-13,11:00:00,150,100,50,FMN GV 11 Ramsel
66,Bergstraat 71,2022-11-13,12:00:00,132,58,74,FMN GV 11 Ramsel
66,Bergstraat 71,2022-11-13,13:00:00,184,88,96,FMN GV 11 Ramsel
66,Bergstraat 71,2022-11-13,14:00:00,232,124,108,FMN GV 11 Ramsel
66,Bergstraat 71,2022-11-13,15:00:00,194,94,100,FMN GV 11 Ramsel
66,Bergstraat 71,2022-11-13,16:00:00,156,90,66,FMN GV 11 Ramsel
66,Bergstraat 71,2022-11-13,17:00:00,62,30,32,FMN GV 11 Ramsel
66,Bergstraat 71,2022-11-13,18:00:00,26,16,10,FMN GV 11 Ramsel
66,Bergstraat 71,2022-11-13,19:00:00,10,4,6,FMN GV 11 Ramsel
66,Bergstraat 71,2022-11-13,20:00:00,22,8,14,FMN GV 11 Ramsel
66,Bergstraat 71,2022-11-13,21:00:00,2,0,2,FMN GV 11 Ramsel
66,Bergstraat 71,2022-11-13,22:00:00,4,4,0,FMN GV 11 Ramsel
66,Bergstraat 71,2022-11-13,23:00:00,2,2,0,FMN GV 11 Ramsel
66,Bergstraat 71,2022-11-14,00:00:00,0,0,0,FMN GV 11 Ramsel
66,Bergstraat 71,2022-11-14,01:00:00,2,0,2,FMN GV 11 Ramsel
66,Bergstraat 71,2022-11-14,02:00:00,2,2,0,FMN GV 11 Ramsel
66,Bergstraat 71,2022-11-14,03:00:00,0,0,0,FMN GV 11 Ramsel
66,Bergstraat 71,2022-11-14,04:00:00,4,2,2,FMN GV 11 Ramsel
66,Bergstraat 71,2022-11-14,05:00:00,16,8,8,FMN GV 11 Ramsel
66,Bergstraat 71,2022-11-14,06:00:00,34,10,24,FMN GV 11 Ramsel
66,Bergstraat 71,2022-11-14,07:00:00,228,20,208,FMN GV 11 Ramsel
66,Bergstraat 71,2022-11-14,08:00:00,230,26,204,FMN GV 11 Ramsel
66,Bergstraat 71,2022-11-14,09:00:00,34,18,16,FMN GV 11 Ramsel
66,Bergstraat 71,2022-11-14,10:00:00,46,12,34,FMN GV 11 Ramsel
66,Bergstraat 71,2022-11-14,11:00:00,40,12,28,FMN GV 11 Ramsel
66,Bergstraat 71,2022-11-14,12:00:00,68,28,40,FMN GV 11 Ramsel
66,Bergstraat 71,2022-11-14,13:00:00,164,86,78,FMN GV 11 Ramsel
66,Bergstraat 71,2022-11-14,14:00:00,142,94,48,FMN GV 11 Ramsel
66,Bergstraat 71,2022-11-14,15:00:00,250,204,46,FMN GV 11 Ramsel
66,Bergstraat 71,2022-11-14,16:00:00,196,164,32,FMN GV 11 Ramsel
66,Bergstraat 71,2022-11-14,17:00:00,104,72,32,FMN GV 11 Ramsel
66,Bergstraat 71,2022-11-14,18:00:00,44,28,16,FMN GV 11 Ramsel
66,Bergstraat 71,2022-11-14,19:00:00,32,18,14,FMN GV 11 Ramsel
66,Bergstraat 71,2022-11-14,20:00:00,26,14,12,FMN GV 11 Ramsel
66,Bergstraat 71,2022-11-14,21:00:00,10,8,2,FMN GV 11 Ramsel
66,Bergstraat 71,2022-11-14,22:00:00,12,8,4,FMN GV 11 Ramsel
66,Bergstraat 71,2022-11-14,23:00:00,2,0,2,FMN GV 11 Ramsel
66,Bergstraat 71,2022-11-15,00:00:00,4,4,0,FMN GV 11 Ramsel
66,Bergstraat 71,2022-11-15,01:00:00,0,0,0,FMN GV 11 Ramsel
66,Bergstraat 71,2022-11-15,02:00:00,0,0,0,FMN GV 11 Ramsel
66,Bergstraat 71,2022-11-15,03:00:00,0,0,0,FMN GV 11 Ramsel
66,Bergstraat 71,2022-11-15,04:00:00,2,2,0,FMN GV 11 Ramsel
66,Bergstraat 71,2022-11-15,05:00:00,18,4,14,FMN GV 11 Ramsel
66,Bergstraat 71,2022-11-15,06:00:00,44,20,24,FMN GV 11 Ramsel
66,Bergstraat 71,2022-11-15,07:00:00,244,28,216,FMN GV 11 Ramsel
66,Bergstraat 71,2022-11-15,08:00:00,216,18,198,FMN GV 11 Ramsel
66,Bergstraat 71,2022-11-15,09:00:00,72,22,50,FMN GV 11 Ramsel
66,Bergstraat 71,2022-11-15,10:00:00,40,14,26,FMN GV 11 Ramsel
66,Bergstraat 71,2022-11-15,11:00:00,68,38,30,FMN GV 11 Ramsel
66,Bergstraat 71,2022-11-15,12:00:00,98,46,52,FMN GV 11 Ramsel
66,Bergstraat 71,2022-11-15,13:00:00,132,88,44,FMN GV 11 Ramsel
66,Bergstraat 71,2022-11-15,14:00:00,108,62,46,FMN GV 11 Ramsel
66,Bergstraat 71,2022-11-15,15:00:00,238,210,28,FMN GV 11 Ramsel
66,Bergstraat 71,2022-11-15,16:00:00,196,140,56,FMN GV 11 Ramsel
66,Bergstraat 71,2022-11-15,17:00:00,114,80,34,FMN GV 11 Ramsel
66,Bergstraat 71,2022-11-15,18:00:00,66,32,34,FMN GV 11 Ramsel
66,Bergstraat 71,2022-11-15,19:00:00,10,4,6,FMN GV 11 Ramsel
66,Bergstraat 71,2022-11-15,20:00:00,36,24,12,FMN GV 11 Ramsel
66,Bergstraat 71,2022-11-15,21:00:00,6,6,0,FMN GV 11 Ramsel
66,Bergstraat 71,2022-11-15,22:00:00,10,8,2,FMN GV 11 Ramsel
66,Bergstraat 71,2022-11-15,23:00:00,4,2,2,FMN GV 11 Ramsel
66,Bergstraat 71,2022-11-16,00:00:00,0,0,0,FMN GV 11 Ramsel
66,Bergstraat 71,2022-11-16,01:00:00,0,0,0,FMN GV 11 Ramsel
66,Bergstraat 71,2022-11-16,02:00:00,0,0,0,FMN GV 11 Ramsel
66,Bergstraat 71,2022-11-16,03:00:00,0,0,0,FMN GV 11 Ramsel
66,Bergstraat 71,2022-11-16,04:00:00,6,2,4,FMN GV 11 Ramsel
66,Bergstraat 71,2022-11-16,05:00:00,14,4,10,FMN GV 11 Ramsel
66,Bergstraat 71,2022-11-16,06:00:00,36,14,22,FMN GV 11 Ramsel
66,Bergstraat 71,2022-11-16,07:00:00,218,28,190,FMN GV 11 Ramsel
66,Bergstraat 71,2022-11-16,08:00:00,200,28,172,FMN GV 11 Ramsel
66,Bergstraat 71,2022-11-16,09:00:00,58,26,32,FMN GV 11 Ramsel
66,Bergstraat 71,2022-11-16,10:00:00,54,20,34,FMN GV 11 Ramsel
66,Bergstraat 71,2022-11-16,11:00:00,98,66,32,FMN GV 11 Ramsel
66,Bergstraat 71,2022-11-16,12:00:00,310,262,48,FMN GV 11 Ramsel
66,Bergstraat 71,2022-11-16,13:00:00,90,44,46,FMN GV 11 Ramsel
66,Bergstraat 71,2022-11-16,14:00:00,88,50,38,FMN GV 11 Ramsel
66,Bergstraat 71,2022-11-16,15:00:00,108,74,34,FMN GV 11 Ramsel
66,Bergstraat 71,2022-11-16,16:00:00,96,42,54,FMN GV 11 Ramsel
66,Bergstraat 71,2022-11-16,17:00:00,108,74,34,FMN GV 11 Ramsel
66,Bergstraat 71,2022-11-16,18:00:00,54,32,22,FMN GV 11 Ramsel
66,Bergstraat 71,2022-11-16,19:00:00,26,6,20,FMN GV 11 Ramsel
66,Bergstraat 71,2022-11-16,20:00:00,20,18,2,FMN GV 11 Ramsel
66,Bergstraat 71,2022-11-16,21:00:00,8,4,4,FMN GV 11 Ramsel
66,Bergstraat 71,2022-11-16,22:00:00,10,4,6,FMN GV 11 Ramsel
66,Bergstraat 71,2022-11-16,23:00:00,0,0,0,FMN GV 11 Ramsel
66,Bergstraat 71,2022-11-17,00:00:00,4,2,2,FMN GV 11 Ramsel
66,Bergstraat 71,2022-11-17,01:00:00,2,2,0,FMN GV 11 Ramsel
66,Bergstraat 71,2022-11-17,02:00:00,0,0,0,FMN GV 11 Ramsel
66,Bergstraat 71,2022-11-17,03:00:00,0,0,0,FMN GV 11 Ramsel
66,Bergstraat 71,2022-11-17,04:00:00,2,2,0,FMN GV 11 Ramsel
66,Bergstraat 71,2022-11-17,05:00:00,12,6,6,FMN GV 11 Ramsel
66,Bergstraat 71,2022-11-17,06:00:00,22,14,8,FMN GV 11 Ramsel
66,Bergstraat 71,2022-11-17,07:00:00,114,12,102,FMN GV 11 Ramsel
66,Bergstraat 71,2022-11-17,08:00:00,132,12,120,FMN GV 11 Ramsel
66,Bergstraat 71,2022-11-17,09:00:00,24,2,22,FMN GV 11 Ramsel
66,Bergstraat 71,2022-11-17,10:00:00,22,14,8,FMN GV 11 Ramsel
66,Bergstraat 71,2022-11-17,11:00:00,30,18,12,FMN GV 11 Ramsel
66,Bergstraat 71,2022-11-17,12:00:00,32,18,14,FMN GV 11 Ramsel
66,Bergstraat 71,2022-11-17,13:00:00,44,28,16,FMN GV 11 Ramsel
66,Bergstraat 71,2022-11-17,14:00:00,54,38,16,FMN GV 11 Ramsel
66,Bergstraat 71,2022-11-17,15:00:00,136,118,18,FMN GV 11 Ramsel
66,Bergstraat 71,2022-11-17,16:00:00,122,80,42,FMN GV 11 Ramsel
66,Bergstraat 71,2022-11-17,17:00:00,52,30,22,FMN GV 11 Ramsel
66,Bergstraat 71,2022-11-17,18:00:00,52,32,20,FMN GV 11 Ramsel
66,Bergstraat 71,2022-11-17,19:00:00,30,8,22,FMN GV 11 Ramsel
66,Bergstraat 71,2022-11-17,20:00:00,50,42,8,FMN GV 11 Ramsel
66,Bergstraat 71,2022-11-17,21:00:00,20,18,2,FMN GV 11 Ramsel
66,Bergstraat 71,2022-11-17,22:00:00,14,10,4,FMN GV 11 Ramsel
66,Bergstraat 71,2022-11-17,23:00:00,0,0,0,FMN GV 11 Ramsel
66,Bergstraat 71,2022-11-18,00:00:00,2,2,0,FMN GV 11 Ramsel
66,Bergstraat 71,2022-11-18,01:00:00,0,0,0,FMN GV 11 Ramsel
66,Bergstraat 71,2022-11-18,02:00:00,0,0,0,FMN GV 11 Ramsel
66,Bergstraat 71,2022-11-18,03:00:00,2,0,2,FMN GV 11 Ramsel
66,Bergstraat 71,2022-11-18,04:00:00,2,2,0,FMN GV 11 Ramsel
66,Bergstraat 71,2022-11-18,05:00:00,24,10,14,FMN GV 11 Ramsel
66,Bergstraat 71,2022-11-18,06:00:00,26,12,14,FMN GV 11 Ramsel
66,Bergstraat 71,2022-11-18,07:00:00,192,24,168,FMN GV 11 Ramsel
66,Bergstraat 71,2022-11-18,08:00:00,182,18,164,FMN GV 11 Ramsel
66,Bergstraat 71,2022-11-18,09:00:00,36,2,34,FMN GV 11 Ramsel
66,Bergstraat 71,2022-11-18,10:00:00,68,28,40,FMN GV 11 Ramsel
66,Bergstraat 71,2022-11-18,11:00:00,76,42,34,FMN GV 11 Ramsel
66,Bergstraat 71,2022-11-18,12:00:00,74,34,40,FMN GV 11 Ramsel
66,Bergstraat 71,2022-11-18,13:00:00,48,22,26,FMN GV 11 Ramsel
66,Bergstraat 71,2022-11-18,14:00:00,50,38,12,FMN GV 11 Ramsel
66,Bergstraat 71,2022-11-18,15:00:00,160,152,8,FMN GV 11 Ramsel
66,Bergstraat 71,2022-11-18,16:00:00,102,80,22,FMN GV 11 Ramsel
66,Bergstraat 71,2022-11-18,17:00:00,72,52,20,FMN GV 11 Ramsel
66,Bergstraat 71,2022-11-18,18:00:00,54,36,18,FMN GV 11 Ramsel
66,Bergstraat 71,2022-11-18,19:00:00,22,0,22,FMN GV 11 Ramsel
66,Bergstraat 71,2022-11-18,20:00:00,12,12,0,FMN GV 11 Ramsel
66,Bergstraat 71,2022-11-18,21:00:00,6,6,0,FMN GV 11 Ramsel
66,Bergstraat 71,2022-11-18,22:00:00,10,8,2,FMN GV 11 Ramsel
66,Bergstraat 71,2022-11-18,23:00:00,0,0,0,FMN GV 11 Ramsel
66,Bergstraat 71,2022-11-19,00:00:00,4,2,2,FMN GV 11 Ramsel
66,Bergstraat 71,2022-11-19,01:00:00,6,2,4,FMN GV 11 Ramsel
66,Bergstraat 71,2022-11-19,02:00:00,2,2,0,FMN GV 11 Ramsel
66,Bergstraat 71,2022-11-19,03:00:00,2,2,0,FMN GV 11 Ramsel
66,Bergstraat 71,2022-11-19,04:00:00,2,2,0,FMN GV 11 Ramsel
66,Bergstraat 71,2022-11-19,05:00:00,0,0,0,FMN GV 11 Ramsel
66,Bergstraat 71,2022-11-19,06:00:00,2,0,2,FMN GV 11 Ramsel
66,Bergstraat 71,2022-11-19,07:00:00,6,2,4,FMN GV 11 Ramsel
66,Bergstraat 71,2022-11-19,08:00:00,10,6,4,FMN GV 11 Ramsel
66,Bergstraat 71,2022-11-19,09:00:00,10,2,8,FMN GV 11 Ramsel
66,Bergstraat 71,2022-11-19,10:00:00,16,12,4,FMN GV 11 Ramsel
66,Bergstraat 71,2022-11-19,11:00:00,10,6,4,FMN GV 11 Ramsel
66,Bergstraat 71,2022-11-19,12:00:00,36,14,22,FMN GV 11 Ramsel
66,Bergstraat 71,2022-11-19,13:00:00,30,20,10,FMN GV 11 Ramsel
66,Bergstraat 71,2022-11-19,14:00:00,28,8,20,FMN GV 11 Ramsel
66,Bergstraat 71,2022-11-19,15:00:00,66,26,40,FMN GV 11 Ramsel
66,Bergstraat 71,2022-11-19,16:00:00,18,10,8,FMN GV 11 Ramsel
66,Bergstraat 71,2022-11-19,17:00:00,18,14,4,FMN GV 11 Ramsel
66,Bergstraat 71,2022-11-19,18:00:00,2,0,2,FMN GV 11 Ramsel
66,Bergstraat 71,2022-11-19,19:00:00,8,4,4,FMN GV 11 Ramsel
66,Bergstraat 71,2022-11-19,20:00:00,14,8,6,FMN GV 11 Ramsel
66,Bergstraat 71,2022-11-19,21:00:00,4,2,2,FMN GV 11 Ramsel
66,Bergstraat 71,2022-11-19,22:00:00,6,0,6,FMN GV 11 Ramsel
66,Bergstraat 71,2022-11-19,23:00:00,8,2,6,FMN GV 11 Ramsel
66,Bergstraat 71,2022-11-20,00:00:00,4,4,0,FMN GV 11 Ramsel
66,Bergstraat 71,2022-11-20,01:00:00,0,0,0,FMN GV 11 Ramsel
66,Bergstraat 71,2022-11-20,02:00:00,4,4,0,FMN GV 11 Ramsel
66,Bergstraat 71,2022-11-20,03:00:00,4,4,0,FMN GV 11 Ramsel
66,Bergstraat 71,2022-11-20,04:00:00,0,0,0,FMN GV 11 Ramsel
66,Bergstraat 71,2022-11-20,05:00:00,0,0,0,FMN GV 11 Ramsel
66,Bergstraat 71,2022-11-20,06:00:00,0,0,0,FMN GV 11 Ramsel
66,Bergstraat 71,2022-11-20,07:00:00,8,2,6,FMN GV 11 Ramsel
66,Bergstraat 71,2022-11-20,08:00:00,38,10,28,FMN GV 11 Ramsel
66,Bergstraat 71,2022-11-20,09:00:00,70,16,54,FMN GV 11 Ramsel
66,Bergstraat 71,2022-11-20,10:00:00,54,24,30,FMN GV 11 Ramsel
66,Bergstraat 71,2022-11-20,11:00:00,72,50,22,FMN GV 11 Ramsel
66,Bergstraat 71,2022-11-20,12:00:00,44,28,16,FMN GV 11 Ramsel
66,Bergstraat 71,2022-11-20,13:00:00,36,18,18,FMN GV 11 Ramsel
66,Bergstraat 71,2022-11-20,14:00:00,12,10,2,FMN GV 11 Ramsel
66,Bergstraat 71,2022-11-20,15:00:00,18,14,4,FMN GV 11 Ramsel
66,Bergstraat 71,2022-11-20,16:00:00,14,6,8,FMN GV 11 Ramsel
66,Bergstraat 71,2022-11-20,17:00:00,10,8,2,FMN GV 11 Ramsel
66,Bergstraat 71,2022-11-20,18:00:00,10,0,10,FMN GV 11 Ramsel
66,Bergstraat 71,2022-11-20,19:00:00,6,4,2,FMN GV 11 Ramsel
66,Bergstraat 71,2022-11-20,20:00:00,6,4,2,FMN GV 11 Ramsel
66,Bergstraat 71,2022-11-20,21:00:00,4,2,2,FMN GV 11 Ramsel
66,Bergstraat 71,2022-11-20,22:00:00,0,0,0,FMN GV 11 Ramsel
66,Bergstraat 71,2022-11-20,23:00:00,0,0,0,FMN GV 11 Ramsel
66,Bergstraat 71,2022-11-21,00:00:00,0,0,0,FMN GV 11 Ramsel
66,Bergstraat 71,2022-11-21,01:00:00,0,0,0,FMN GV 11 Ramsel
66,Bergstraat 71,2022-11-21,02:00:00,0,0,0,FMN GV 11 Ramsel
66,Bergstraat 71,2022-11-21,03:00:00,0,0,0,FMN GV 11 Ramsel
66,Bergstraat 71,2022-11-21,04:00:00,2,2,0,FMN GV 11 Ramsel
66,Bergstraat 71,2022-11-21,05:00:00,22,12,10,FMN GV 11 Ramsel
66,Bergstraat 71,2022-11-21,06:00:00,30,12,18,FMN GV 11 Ramsel
66,Bergstraat 71,2022-11-21,07:00:00,166,24,142,FMN GV 11 Ramsel
66,Bergstraat 71,2022-11-21,08:00:00,202,26,176,FMN GV 11 Ramsel
66,Bergstraat 71,2022-11-21,09:00:00,46,12,34,FMN GV 11 Ramsel
66,Bergstraat 71,2022-11-21,10:00:00,56,32,24,FMN GV 11 Ramsel
66,Bergstraat 71,2022-11-21,11:00:00,34,12,22,FMN GV 11 Ramsel
66,Bergstraat 71,2022-11-21,12:00:00,76,34,42,FMN GV 11 Ramsel
66,Bergstraat 71,2022-11-21,13:00:00,82,34,48,FMN GV 11 Ramsel
66,Bergstraat 71,2022-11-21,14:00:00,106,64,42,FMN GV 11 Ramsel
66,Bergstraat 71,2022-11-21,15:00:00,198,186,12,FMN GV 11 Ramsel
66,Bergstraat 71,2022-11-21,16:00:00,156,124,32,FMN GV 11 Ramsel
66,Bergstraat 71,2022-11-21,17:00:00,74,52,22,FMN GV 11 Ramsel
66,Bergstraat 71,2022-11-21,18:00:00,22,16,6,FMN GV 11 Ramsel
66,Bergstraat 71,2022-11-21,19:00:00,36,20,16,FMN GV 11 Ramsel
66,Bergstraat 71,2022-11-21,20:00:00,12,6,6,FMN GV 11 Ramsel
66,Bergstraat 71,2022-11-21,21:00:00,8,6,2,FMN GV 11 Ramsel
66,Bergstraat 71,2022-11-21,22:00:00,8,8,0,FMN GV 11 Ramsel
66,Bergstraat 71,2022-11-21,23:00:00,2,0,2,FMN GV 11 Ramsel
66,Bergstraat 71,2022-11-22,00:00:00,4,4,0,FMN GV 11 Ramsel
66,Bergstraat 71,2022-11-22,01:00:00,0,0,0,FMN GV 11 Ramsel
66,Bergstraat 71,2022-11-22,02:00:00,0,0,0,FMN GV 11 Ramsel
66,Bergstraat 71,2022-11-22,03:00:00,0,0,0,FMN GV 11 Ramsel
66,Bergstraat 71,2022-11-22,04:00:00,6,2,4,FMN GV 11 Ramsel
66,Bergstraat 71,2022-11-22,05:00:00,18,8,10,FMN GV 11 Ramsel
66,Bergstraat 71,2022-11-22,06:00:00,34,18,16,FMN GV 11 Ramsel
66,Bergstraat 71,2022-11-22,07:00:00,180,16,164,FMN GV 11 Ramsel
66,Bergstraat 71,2022-11-22,08:00:00,196,16,180,FMN GV 11 Ramsel
66,Bergstraat 71,2022-11-22,09:00:00,56,14,42,FMN GV 11 Ramsel
66,Bergstraat 71,2022-11-22,10:00:00,40,22,18,FMN GV 11 Ramsel
66,Bergstraat 71,2022-11-22,11:00:00,22,12,10,FMN GV 11 Ramsel
66,Bergstraat 71,2022-11-22,12:00:00,56,42,14,FMN GV 11 Ramsel
66,Bergstraat 71,2022-11-22,13:00:00,90,36,54,FMN GV 11 Ramsel
66,Bergstraat 71,2022-11-22,14:00:00,58,32,26,FMN GV 11 Ramsel
66,Bergstraat 71,2022-11-22,15:00:00,230,198,32,FMN GV 11 Ramsel
66,Bergstraat 71,2022-11-22,16:00:00,176,146,30,FMN GV 11 Ramsel
66,Bergstraat 71,2022-11-22,17:00:00,82,46,36,FMN GV 11 Ramsel
66,Bergstraat 71,2022-11-22,18:00:00,50,30,20,FMN GV 11 Ramsel
66,Bergstraat 71,2022-11-22,19:00:00,60,26,34,FMN GV 11 Ramsel
66,Bergstraat 71,2022-11-22,20:00:00,26,22,4,FMN GV 11 Ramsel
66,Bergstraat 71,2022-11-22,21:00:00,12,10,2,FMN GV 11 Ramsel
66,Bergstraat 71,2022-11-22,22:00:00,16,12,4,FMN GV 11 Ramsel
66,Bergstraat 71,2022-11-22,23:00:00,2,2,0,FMN GV 11 Ramsel
66,Bergstraat 71,2022-11-23,00:00:00,0,0,0,FMN GV 11 Ramsel
66,Bergstraat 71,2022-11-23,01:00:00,2,0,2,FMN GV 11 Ramsel
66,Bergstraat 71,2022-11-23,02:00:00,0,0,0,FMN GV 11 Ramsel
66,Bergstraat 71,2022-11-23,03:00:00,0,0,0,FMN GV 11 Ramsel
66,Bergstraat 71,2022-11-23,04:00:00,4,2,2,FMN GV 11 Ramsel
66,Bergstraat 71,2022-11-23,05:00:00,14,8,6,FMN GV 11 Ramsel
66,Bergstraat 71,2022-11-23,06:00:00,38,20,18,FMN GV 11 Ramsel
66,Bergstraat 71,2022-11-23,07:00:00,176,22,154,FMN GV 11 Ramsel
66,Bergstraat 71,2022-11-23,08:00:00,220,26,194,FMN GV 11 Ramsel
66,Bergstraat 71,2022-11-23,09:00:00,42,16,26,FMN GV 11 Ramsel
66,Bergstraat 71,2022-11-23,10:00:00,50,34,16,FMN GV 11 Ramsel
66,Bergstraat 71,2022-11-23,11:00:00,82,48,34,FMN GV 11 Ramsel
66,Bergstraat 71,2022-11-23,12:00:00,278,252,26,FMN GV 11 Ramsel
66,Bergstraat 71,2022-11-23,13:00:00,68,32,36,FMN GV 11 Ramsel
66,Bergstraat 71,2022-11-23,14:00:00,40,24,16,FMN GV 11 Ramsel
66,Bergstraat 71,2022-11-23,15:00:00,14,8,6,FMN GV 11 Ramsel
66,Bergstraat 71,2022-11-23,16:00:00,44,26,18,FMN GV 11 Ramsel
66,Bergstraat 71,2022-11-23,17:00:00,78,46,32,FMN GV 11 Ramsel
66,Bergstraat 71,2022-11-23,18:00:00,30,22,8,FMN GV 11 Ramsel
66,Bergstraat 71,2022-11-23,19:00:00,24,12,12,FMN GV 11 Ramsel
66,Bergstraat 71,2022-11-23,20:00:00,10,8,2,FMN GV 11 Ramsel
66,Bergstraat 71,2022-11-23,21:00:00,2,2,0,FMN GV 11 Ramsel
66,Bergstraat 71,2022-11-23,22:00:00,18,12,6,FMN GV 11 Ramsel
66,Bergstraat 71,2022-11-23,23:00:00,8,6,2,FMN GV 11 Ramsel
66,Bergstraat 71,2022-11-24,00:00:00,2,0,2,FMN GV 11 Ramsel
66,Bergstraat 71,2022-11-24,01:00:00,2,2,0,FMN GV 11 Ramsel
66,Bergstraat 71,2022-11-24,02:00:00,0,0,0,FMN GV 11 Ramsel
66,Bergstraat 71,2022-11-24,03:00:00,4,2,2,FMN GV 11 Ramsel
66,Bergstraat 71,2022-11-24,04:00:00,4,4,0,FMN GV 11 Ramsel
66,Bergstraat 71,2022-11-24,05:00:00,16,8,8,FMN GV 11 Ramsel
66,Bergstraat 71,2022-11-24,06:00:00,28,8,20,FMN GV 11 Ramsel
66,Bergstraat 71,2022-11-24,07:00:00,156,20,136,FMN GV 11 Ramsel
66,Bergstraat 71,2022-11-24,08:00:00,264,36,228,FMN GV 11 Ramsel
66,Bergstraat 71,2022-11-24,09:00:00,28,8,20,FMN GV 11 Ramsel
66,Bergstraat 71,2022-11-24,10:00:00,68,20,48,FMN GV 11 Ramsel
66,Bergstraat 71,2022-11-24,11:00:00,56,32,24,FMN GV 11 Ramsel
66,Bergstraat 71,2022-11-24,12:00:00,76,40,36,FMN GV 11 Ramsel
66,Bergstraat 71,2022-11-24,13:00:00,134,68,66,FMN GV 11 Ramsel
66,Bergstraat 71,2022-11-24,14:00:00,148,78,70,FMN GV 11 Ramsel
66,Bergstraat 71,2022-11-24,15:00:00,280,214,66,FMN GV 11 Ramsel
66,Bergstraat 71,2022-11-24,16:00:00,166,132,34,FMN GV 11 Ramsel
66,Bergstraat 71,2022-11-24,17:00:00,90,52,38,FMN GV 11 Ramsel
66,Bergstraat 71,2022-11-24,18:00:00,62,30,32,FMN GV 11 Ramsel
66,Bergstraat 71,2022-11-24,19:00:00,16,10,6,FMN GV 11 Ramsel
66,Bergstraat 71,2022-11-24,20:00:00,44,40,4,FMN GV 11 Ramsel
66,Bergstraat 71,2022-11-24,21:00:00,18,14,4,FMN GV 11 Ramsel
66,Bergstraat 71,2022-11-24,22:00:00,10,8,2,FMN GV 11 Ramsel
66,Bergstraat 71,2022-11-24,23:00:00,8,6,2,FMN GV 11 Ramsel
66,Bergstraat 71,2022-11-25,00:00:00,2,2,0,FMN GV 11 Ramsel
66,Bergstraat 71,2022-11-25,01:00:00,2,0,2,FMN GV 11 Ramsel
66,Bergstraat 71,2022-11-25,02:00:00,0,0,0,FMN GV 11 Ramsel
66,Bergstraat 71,2022-11-25,03:00:00,0,0,0,FMN GV 11 Ramsel
66,Bergstraat 71,2022-11-25,04:00:00,2,2,0,FMN GV 11 Ramsel
66,Bergstraat 71,2022-11-25,05:00:00,12,8,4,FMN GV 11 Ramsel
66,Bergstraat 71,2022-11-25,06:00:00,32,18,14,FMN GV 11 Ramsel
66,Bergstraat 71,2022-11-25,07:00:00,174,20,154,FMN GV 11 Ramsel
66,Bergstraat 71,2022-11-25,08:00:00,218,30,188,FMN GV 11 Ramsel
66,Bergstraat 71,2022-11-25,09:00:00,44,14,30,FMN GV 11 Ramsel
66,Bergstraat 71,2022-11-25,10:00:00,52,20,32,FMN GV 11 Ramsel
66,Bergstraat 71,2022-11-25,11:00:00,62,32,30,FMN GV 11 Ramsel
66,Bergstraat 71,2022-11-25,12:00:00,84,30,54,FMN GV 11 Ramsel
66,Bergstraat 71,2022-11-25,13:00:00,86,28,58,FMN GV 11 Ramsel
66,Bergstraat 71,2022-11-25,14:00:00,138,70,68,FMN GV 11 Ramsel
66,Bergstraat 71,2022-11-25,15:00:00,268,210,58,FMN GV 11 Ramsel
66,Bergstraat 71,2022-11-25,16:00:00,160,124,36,FMN GV 11 Ramsel
66,Bergstraat 71,2022-11-25,17:00:00,52,38,14,FMN GV 11 Ramsel
66,Bergstraat 71,2022-11-25,18:00:00,56,40,16,FMN GV 11 Ramsel
66,Bergstraat 71,2022-11-25,19:00:00,38,10,28,FMN GV 11 Ramsel
66,Bergstraat 71,2022-11-25,20:00:00,16,8,8,FMN GV 11 Ramsel
66,Bergstraat 71,2022-11-25,21:00:00,16,10,6,FMN GV 11 Ramsel
66,Bergstraat 71,2022-11-25,22:00:00,8,4,4,FMN GV 11 Ramsel
66,Bergstraat 71,2022-11-25,23:00:00,6,6,0,FMN GV 11 Ramsel
66,Bergstraat 71,2022-11-26,00:00:00,8,6,2,FMN GV 11 Ramsel
66,Bergstraat 71,2022-11-26,01:00:00,10,4,6,FMN GV 11 Ramsel
66,Bergstraat 71,2022-11-26,02:00:00,4,4,0,FMN GV 11 Ramsel
66,Bergstraat 71,2022-11-26,03:00:00,6,2,4,FMN GV 11 Ramsel
66,Bergstraat 71,2022-11-26,04:00:00,2,2,0,FMN GV 11 Ramsel
66,Bergstraat 71,2022-11-26,05:00:00,0,0,0,FMN GV 11 Ramsel
66,Bergstraat 71,2022-11-26,06:00:00,4,4,0,FMN GV 11 Ramsel
66,Bergstraat 71,2022-11-26,07:00:00,4,0,4,FMN GV 11 Ramsel
66,Bergstraat 71,2022-11-26,08:00:00,30,12,18,FMN GV 11 Ramsel
66,Bergstraat 71,2022-11-26,09:00:00,58,26,32,FMN GV 11 Ramsel
66,Bergstraat 71,2022-11-26,10:00:00,74,30,44,FMN GV 11 Ramsel
66,Bergstraat 71,2022-11-26,11:00:00,120,62,58,FMN GV 11 Ramsel
66,Bergstraat 71,2022-11-26,12:00:00,154,78,76,FMN GV 11 Ramsel
66,Bergstraat 71,2022-11-26,13:00:00,140,80,60,FMN GV 11 Ramsel
66,Bergstraat 71,2022-11-26,14:00:00,130,78,52,FMN GV 11 Ramsel
66,Bergstraat 71,2022-11-26,15:00:00,108,76,32,FMN GV 11 Ramsel
66,Bergstraat 71,2022-11-26,16:00:00,66,38,28,FMN GV 11 Ramsel
66,Bergstraat 71,2022-11-26,17:00:00,30,14,16,FMN GV 11 Ramsel
66,Bergstraat 71,2022-11-26,18:00:00,16,4,12,FMN GV 11 Ramsel
66,Bergstraat 71,2022-11-26,19:00:00,22,10,12,FMN GV 11 Ramsel
66,Bergstraat 71,2022-11-26,20:00:00,20,4,16,FMN GV 11 Ramsel
66,Bergstraat 71,2022-11-26,21:00:00,6,2,4,FMN GV 11 Ramsel
66,Bergstraat 71,2022-11-26,22:00:00,8,2,6,FMN GV 11 Ramsel
66,Bergstraat 71,2022-11-26,23:00:00,12,6,6,FMN GV 11 Ramsel
66,Bergstraat 71,2022-11-27,00:00:00,6,6,0,FMN GV 11 Ramsel
66,Bergstraat 71,2022-11-27,01:00:00,6,6,0,FMN GV 11 Ramsel
66,Bergstraat 71,2022-11-27,02:00:00,4,4,0,FMN GV 11 Ramsel
66,Bergstraat 71,2022-11-27,03:00:00,0,0,0,FMN GV 11 Ramsel
66,Bergstraat 71,2022-11-27,04:00:00,2,2,0,FMN GV 11 Ramsel
66,Bergstraat 71,2022-11-27,05:00:00,0,0,0,FMN GV 11 Ramsel
66,Bergstraat 71,2022-11-27,06:00:00,0,0,0,FMN GV 11 Ramsel
66,Bergstraat 71,2022-11-27,07:00:00,8,2,6,FMN GV 11 Ramsel
66,Bergstraat 71,2022-11-27,08:00:00,12,4,8,FMN GV 11 Ramsel
66,Bergstraat 71,2022-11-27,09:00:00,28,14,14,FMN GV 11 Ramsel
66,Bergstraat 71,2022-11-27,10:00:00,34,24,10,FMN GV 11 Ramsel
66,Bergstraat 71,2022-11-27,11:00:00,34,8,26,FMN GV 11 Ramsel
66,Bergstraat 71,2022-11-27,12:00:00,30,10,20,FMN GV 11 Ramsel
66,Bergstraat 71,2022-11-27,13:00:00,32,18,14,FMN GV 11 Ramsel
66,Bergstraat 71,2022-11-27,14:00:00,14,8,6,FMN GV 11 Ramsel
66,Bergstraat 71,2022-11-27,15:00:00,12,4,8,FMN GV 11 Ramsel
66,Bergstraat 71,2022-11-27,16:00:00,16,10,6,FMN GV 11 Ramsel
66,Bergstraat 71,2022-11-27,17:00:00,14,4,10,FMN GV 11 Ramsel
66,Bergstraat 71,2022-11-27,18:00:00,6,2,4,FMN GV 11 Ramsel
66,Bergstraat 71,2022-11-27,19:00:00,4,2,2,FMN GV 11 Ramsel
66,Bergstraat 71,2022-11-27,20:00:00,2,2,0,FMN GV 11 Ramsel
66,Bergstraat 71,2022-11-27,21:00:00,4,0,4,FMN GV 11 Ramsel
66,Bergstraat 71,2022-11-27,22:00:00,8,4,4,FMN GV 11 Ramsel
66,Bergstraat 71,2022-11-27,23:00:00,0,0,0,FMN GV 11 Ramsel
66,Bergstraat 71,2022-11-28,00:00:00,0,0,0,FMN GV 11 Ramsel
66,Bergstraat 71,2022-11-28,01:00:00,0,0,0,FMN GV 11 Ramsel
66,Bergstraat 71,2022-11-28,02:00:00,0,0,0,FMN GV 11 Ramsel
66,Bergstraat 71,2022-11-28,03:00:00,0,0,0,FMN GV 11 Ramsel
66,Bergstraat 71,2022-11-28,04:00:00,0,0,0,FMN GV 11 Ramsel
66,Bergstraat 71,2022-11-28,05:00:00,8,4,4,FMN GV 11 Ramsel
66,Bergstraat 71,2022-11-28,06:00:00,28,10,18,FMN GV 11 Ramsel
66,Bergstraat 71,2022-11-28,07:00:00,156,12,144,FMN GV 11 Ramsel
66,Bergstraat 71,2022-11-28,08:00:00,202,16,186,FMN GV 11 Ramsel
66,Bergstraat 71,2022-11-28,09:00:00,22,8,14,FMN GV 11 Ramsel
66,Bergstraat 71,2022-11-28,10:00:00,18,8,10,FMN GV 11 Ramsel
66,Bergstraat 71,2022-11-28,11:00:00,22,12,10,FMN GV 11 Ramsel
66,Bergstraat 71,2022-11-28,12:00:00,28,20,8,FMN GV 11 Ramsel
66,Bergstraat 71,2022-11-28,13:00:00,64,28,36,FMN GV 11 Ramsel
66,Bergstraat 71,2022-11-28,14:00:00,72,58,14,FMN GV 11 Ramsel
66,Bergstraat 71,2022-11-28,15:00:00,226,188,38,FMN GV 11 Ramsel
66,Bergstraat 71,2022-11-28,16:00:00,152,112,40,FMN GV 11 Ramsel
66,Bergstraat 71,2022-11-28,17:00:00,54,38,16,FMN GV 11 Ramsel
66,Bergstraat 71,2022-11-28,18:00:00,46,34,12,FMN GV 11 Ramsel
66,Bergstraat 71,2022-11-28,19:00:00,34,12,22,FMN GV 11 Ramsel
66,Bergstraat 71,2022-11-28,20:00:00,24,12,12,FMN GV 11 Ramsel
66,Bergstraat 71,2022-11-28,21:00:00,12,12,0,FMN GV 11 Ramsel
66,Bergstraat 71,2022-11-28,22:00:00,18,8,10,FMN GV 11 Ramsel
66,Bergstraat 71,2022-11-28,23:00:00,0,0,0,FMN GV 11 Ramsel
66,Bergstraat 71,2022-11-29,00:00:00,0,0,0,FMN GV 11 Ramsel
66,Bergstraat 71,2022-11-29,01:00:00,0,0,0,FMN GV 11 Ramsel
66,Bergstraat 71,2022-11-29,02:00:00,0,0,0,FMN GV 11 Ramsel
66,Bergstraat 71,2022-11-29,03:00:00,0,0,0,FMN GV 11 Ramsel
66,Bergstraat 71,2022-11-29,04:00:00,6,2,4,FMN GV 11 Ramsel
66,Bergstraat 71,2022-11-29,05:00:00,12,2,10,FMN GV 11 Ramsel
66,Bergstraat 71,2022-11-29,06:00:00,32,18,14,FMN GV 11 Ramsel
66,Bergstraat 71,2022-11-29,07:00:00,190,26,164,FMN GV 11 Ramsel
66,Bergstraat 71,2022-11-29,08:00:00,228,28,200,FMN GV 11 Ramsel
66,Bergstraat 71,2022-11-29,09:00:00,50,12,38,FMN GV 11 Ramsel
66,Bergstraat 71,2022-11-29,10:00:00,46,22,24,FMN GV 11 Ramsel
66,Bergstraat 71,2022-11-29,11:00:00,50,18,32,FMN GV 11 Ramsel
66,Bergstraat 71,2022-11-29,12:00:00,82,38,44,FMN GV 11 Ramsel
66,Bergstraat 71,2022-11-29,13:00:00,152,58,94,FMN GV 11 Ramsel
66,Bergstraat 71,2022-11-29,14:00:00,98,72,26,FMN GV 11 Ramsel
66,Bergstraat 71,2022-11-29,15:00:00,236,198,38,FMN GV 11 Ramsel
66,Bergstraat 71,2022-11-29,16:00:00,254,194,60,FMN GV 11 Ramsel
66,Bergstraat 71,2022-11-29,17:00:00,52,32,20,FMN GV 11 Ramsel
66,Bergstraat 71,2022-11-29,18:00:00,78,26,52,FMN GV 11 Ramsel
66,Bergstraat 71,2022-11-29,19:00:00,44,10,34,FMN GV 11 Ramsel
66,Bergstraat 71,2022-11-29,20:00:00,34,18,16,FMN GV 11 Ramsel
66,Bergstraat 71,2022-11-29,21:00:00,28,20,8,FMN GV 11 Ramsel
66,Bergstraat 71,2022-11-29,22:00:00,14,6,8,FMN GV 11 Ramsel
66,Bergstraat 71,2022-11-29,23:00:00,6,6,0,FMN GV 11 Ramsel
66,Bergstraat 71,2022-11-30,00:00:00,2,2,0,FMN GV 11 Ramsel
66,Bergstraat 71,2022-11-30,01:00:00,0,0,0,FMN GV 11 Ramsel
66,Bergstraat 71,2022-11-30,02:00:00,2,2,0,FMN GV 11 Ramsel
66,Bergstraat 71,2022-11-30,03:00:00,0,0,0,FMN GV 11 Ramsel
66,Bergstraat 71,2022-11-30,04:00:00,6,4,2,FMN GV 11 Ramsel
66,Bergstraat 71,2022-11-30,05:00:00,10,2,8,FMN GV 11 Ramsel
66,Bergstraat 71,2022-11-30,06:00:00,36,18,18,FMN GV 11 Ramsel
66,Bergstraat 71,2022-11-30,07:00:00,208,26,182,FMN GV 11 Ramsel
66,Bergstraat 71,2022-11-30,08:00:00,208,24,184,FMN GV 11 Ramsel
66,Bergstraat 71,2022-11-30,09:00:00,32,6,26,FMN GV 11 Ramsel
66,Bergstraat 71,2022-11-30,10:00:00,20,8,12,FMN GV 11 Ramsel
66,Bergstraat 71,2022-11-30,11:00:00,58,32,26,FMN GV 11 Ramsel
66,Bergstraat 71,2022-11-30,12:00:00,318,278,40,FMN GV 11 Ramsel
66,Bergstraat 71,2022-11-30,13:00:00,106,52,54,FMN GV 11 Ramsel
66,Bergstraat 71,2022-11-30,14:00:00,118,66,52,FMN GV 11 Ramsel
66,Bergstraat 71,2022-11-30,15:00:00,108,70,38,FMN GV 11 Ramsel
66,Bergstraat 71,2022-11-30,16:00:00,88,54,34,FMN GV 11 Ramsel
66,Bergstraat 71,2022-11-30,17:00:00,70,40,30,FMN GV 11 Ramsel
66,Bergstraat 71,2022-11-30,18:00:00,48,32,16,FMN GV 11 Ramsel
66,Bergstraat 71,2022-11-30,19:00:00,22,12,10,FMN GV 11 Ramsel
66,Bergstraat 71,2022-11-30,20:00:00,26,12,14,FMN GV 11 Ramsel
66,Bergstraat 71,2022-11-30,21:00:00,10,8,2,FMN GV 11 Ramsel
66,Bergstraat 71,2022-11-30,22:00:00,16,10,6,FMN GV 11 Ramsel
66,Bergstraat 71,2022-11-30,23:00:00,0,0,0,FMN GV 11 Ramsel
66,Bergstraat 71,2022-12-01,00:00:00,0,0,0,FMN GV 11 Ramsel
66,Bergstraat 71,2022-12-01,01:00:00,0,0,0,FMN GV 11 Ramsel
66,Bergstraat 71,2022-12-01,02:00:00,0,0,0,FMN GV 11 Ramsel
66,Bergstraat 71,2022-12-01,03:00:00,4,0,4,FMN GV 11 Ramsel
66,Bergstraat 71,2022-12-01,04:00:00,8,6,2,FMN GV 11 Ramsel
66,Bergstraat 71,2022-12-01,05:00:00,8,6,2,FMN GV 11 Ramsel
66,Bergstraat 71,2022-12-01,06:00:00,30,10,20,FMN GV 11 Ramsel
66,Bergstraat 71,2022-12-01,07:00:00,198,26,172,FMN GV 11 Ramsel
66,Bergstraat 71,2022-12-01,08:00:00,246,26,220,FMN GV 11 Ramsel
66,Bergstraat 71,2022-12-01,09:00:00,42,8,34,FMN GV 11 Ramsel
66,Bergstraat 71,2022-12-01,10:00:00,60,32,28,FMN GV 11 Ramsel
66,Bergstraat 71,2022-12-01,11:00:00,28,16,12,FMN GV 11 Ramsel
66,Bergstraat 71,2022-12-01,12:00:00,68,42,26,FMN GV 11 Ramsel
66,Bergstraat 71,2022-12-01,13:00:00,70,50,20,FMN GV 11 Ramsel
66,Bergstraat 71,2022-12-01,14:00:00,78,60,18,FMN GV 11 Ramsel
66,Bergstraat 71,2022-12-01,15:00:00,258,206,52,FMN GV 11 Ramsel
66,Bergstraat 71,2022-12-01,16:00:00,170,158,12,FMN GV 11 Ramsel
66,Bergstraat 71,2022-12-01,17:00:00,54,38,16,FMN GV 11 Ramsel
66,Bergstraat 71,2022-12-01,18:00:00,42,22,20,FMN GV 11 Ramsel
66,Bergstraat 71,2022-12-01,19:00:00,28,8,20,FMN GV 11 Ramsel
66,Bergstraat 71,2022-12-01,20:00:00,8,6,2,FMN GV 11 Ramsel
66,Bergstraat 71,2022-12-01,21:00:00,8,8,0,FMN GV 11 Ramsel
66,Bergstraat 71,2022-12-01,22:00:00,16,12,4,FMN GV 11 Ramsel
66,Bergstraat 71,2022-12-01,23:00:00,8,6,2,FMN GV 11 Ramsel
66,Bergstraat 71,2022-12-02,00:00:00,0,0,0,FMN GV 11 Ramsel
66,Bergstraat 71,2022-12-02,01:00:00,2,0,2,FMN GV 11 Ramsel
66,Bergstraat 71,2022-12-02,02:00:00,0,0,0,FMN GV 11 Ramsel
66,Bergstraat 71,2022-12-02,03:00:00,0,0,0,FMN GV 11 Ramsel
66,Bergstraat 71,2022-12-02,04:00:00,6,6,0,FMN GV 11 Ramsel
66,Bergstraat 71,2022-12-02,05:00:00,6,6,0,FMN GV 11 Ramsel
66,Bergstraat 71,2022-12-02,06:00:00,20,6,14,FMN GV 11 Ramsel
66,Bergstraat 71,2022-12-02,07:00:00,156,16,140,FMN GV 11 Ramsel
66,Bergstraat 71,2022-12-02,08:00:00,222,18,204,FMN GV 11 Ramsel
66,Bergstraat 71,2022-12-02,09:00:00,52,10,42,FMN GV 11 Ramsel
66,Bergstraat 71,2022-12-02,10:00:00,34,16,18,FMN GV 11 Ramsel
66,Bergstraat 71,2022-12-02,11:00:00,42,20,22,FMN GV 11 Ramsel
66,Bergstraat 71,2022-12-02,12:00:00,62,32,30,FMN GV 11 Ramsel
66,Bergstraat 71,2022-12-02,13:00:00,42,36,6,FMN GV 11 Ramsel
66,Bergstraat 71,2022-12-02,14:00:00,68,54,14,FMN GV 11 Ramsel
66,Bergstraat 71,2022-12-02,15:00:00,204,174,30,FMN GV 11 Ramsel
66,Bergstraat 71,2022-12-02,16:00:00,182,144,38,FMN GV 11 Ramsel
66,Bergstraat 71,2022-12-02,17:00:00,48,26,22,FMN GV 11 Ramsel
66,Bergstraat 71,2022-12-02,18:00:00,42,30,12,FMN GV 11 Ramsel
66,Bergstraat 71,2022-12-02,19:00:00,28,10,18,FMN GV 11 Ramsel
66,Bergstraat 71,2022-12-02,20:00:00,16,8,8,FMN GV 11 Ramsel
66,Bergstraat 71,2022-12-02,21:00:00,26,12,14,FMN GV 11 Ramsel
66,Bergstraat 71,2022-12-02,22:00:00,14,10,4,FMN GV 11 Ramsel
66,Bergstraat 71,2022-12-02,23:00:00,18,18,0,FMN GV 11 Ramsel
66,Bergstraat 71,2022-12-03,00:00:00,4,2,2,FMN GV 11 Ramsel
66,Bergstraat 71,2022-12-03,01:00:00,6,4,2,FMN GV 11 Ramsel
66,Bergstraat 71,2022-12-03,02:00:00,2,2,0,FMN GV 11 Ramsel
66,Bergstraat 71,2022-12-03,03:00:00,4,2,2,FMN GV 11 Ramsel
66,Bergstraat 71,2022-12-03,04:00:00,6,4,2,FMN GV 11 Ramsel
66,Bergstraat 71,2022-12-03,05:00:00,0,0,0,FMN GV 11 Ramsel
66,Bergstraat 71,2022-12-03,06:00:00,0,0,0,FMN GV 11 Ramsel
66,Bergstraat 71,2022-12-03,07:00:00,2,2,0,FMN GV 11 Ramsel
66,Bergstraat 71,2022-12-03,08:00:00,24,6,18,FMN GV 11 Ramsel
66,Bergstraat 71,2022-12-03,09:00:00,22,12,10,FMN GV 11 Ramsel
66,Bergstraat 71,2022-12-03,10:00:00,30,12,18,FMN GV 11 Ramsel
66,Bergstraat 71,2022-12-03,11:00:00,50,32,18,FMN GV 11 Ramsel
66,Bergstraat 71,2022-12-03,12:00:00,34,24,10,FMN GV 11 Ramsel
66,Bergstraat 71,2022-12-03,13:00:00,66,38,28,FMN GV 11 Ramsel
66,Bergstraat 71,2022-12-03,14:00:00,66,32,34,FMN GV 11 Ramsel
66,Bergstraat 71,2022-12-03,15:00:00,34,18,16,FMN GV 11 Ramsel
66,Bergstraat 71,2022-12-03,16:00:00,48,22,26,FMN GV 11 Ramsel
66,Bergstraat 71,2022-12-03,17:00:00,18,8,10,FMN GV 11 Ramsel
66,Bergstraat 71,2022-12-03,18:00:00,34,24,10,FMN GV 11 Ramsel
66,Bergstraat 71,2022-12-03,19:00:00,16,10,6,FMN GV 11 Ramsel
66,Bergstraat 71,2022-12-03,20:00:00,4,0,4,FMN GV 11 Ramsel
66,Bergstraat 71,2022-12-03,21:00:00,10,8,2,FMN GV 11 Ramsel
66,Bergstraat 71,2022-12-03,22:00:00,10,4,6,FMN GV 11 Ramsel
66,Bergstraat 71,2022-12-03,23:00:00,2,2,0,FMN GV 11 Ramsel
66,Bergstraat 71,2022-12-04,00:00:00,10,10,0,FMN GV 11 Ramsel
66,Bergstraat 71,2022-12-04,01:00:00,2,2,0,FMN GV 11 Ramsel
66,Bergstraat 71,2022-12-04,02:00:00,2,2,0,FMN GV 11 Ramsel
66,Bergstraat 71,2022-12-04,03:00:00,0,0,0,FMN GV 11 Ramsel
66,Bergstraat 71,2022-12-04,04:00:00,0,0,0,FMN GV 11 Ramsel
66,Bergstraat 71,2022-12-04,05:00:00,2,2,0,FMN GV 11 Ramsel
66,Bergstraat 71,2022-12-04,06:00:00,2,0,2,FMN GV 11 Ramsel
66,Bergstraat 71,2022-12-04,07:00:00,2,0,2,FMN GV 11 Ramsel
66,Bergstraat 71,2022-12-04,08:00:00,34,14,20,FMN GV 11 Ramsel
66,Bergstraat 71,2022-12-04,09:00:00,46,16,30,FMN GV 11 Ramsel
66,Bergstraat 71,2022-12-04,10:00:00,80,38,42,FMN GV 11 Ramsel
66,Bergstraat 71,2022-12-04,11:00:00,80,44,36,FMN GV 11 Ramsel
66,Bergstraat 71,2022-12-04,12:00:00,38,26,12,FMN GV 11 Ramsel
66,Bergstraat 71,2022-12-04,13:00:00,56,34,22,FMN GV 11 Ramsel
66,Bergstraat 71,2022-12-04,14:00:00,52,22,30,FMN GV 11 Ramsel
66,Bergstraat 71,2022-12-04,15:00:00,36,18,18,FMN GV 11 Ramsel
66,Bergstraat 71,2022-12-04,16:00:00,24,22,2,FMN GV 11 Ramsel
66,Bergstraat 71,2022-12-04,17:00:00,20,10,10,FMN GV 11 Ramsel
66,Bergstraat 71,2022-12-04,18:00:00,2,2,0,FMN GV 11 Ramsel
66,Bergstraat 71,2022-12-04,19:00:00,14,4,10,FMN GV 11 Ramsel
66,Bergstraat 71,2022-12-04,20:00:00,8,6,2,FMN GV 11 Ramsel
66,Bergstraat 71,2022-12-04,21:00:00,4,2,2,FMN GV 11 Ramsel
66,Bergstraat 71,2022-12-04,22:00:00,2,0,2,FMN GV 11 Ramsel
66,Bergstraat 71,2022-12-04,23:00:00,0,0,0,FMN GV 11 Ramsel
66,Bergstraat 71,2022-12-05,00:00:00,0,0,0,FMN GV 11 Ramsel
66,Bergstraat 71,2022-12-05,01:00:00,0,0,0,FMN GV 11 Ramsel
66,Bergstraat 71,2022-12-05,02:00:00,2,0,2,FMN GV 11 Ramsel
66,Bergstraat 71,2022-12-05,03:00:00,0,0,0,FMN GV 11 Ramsel
66,Bergstraat 71,2022-12-05,04:00:00,4,4,0,FMN GV 11 Ramsel
66,Bergstraat 71,2022-12-05,05:00:00,14,10,4,FMN GV 11 Ramsel
66,Bergstraat 71,2022-12-05,06:00:00,26,2,24,FMN GV 11 Ramsel
66,Bergstraat 71,2022-12-05,07:00:00,142,16,126,FMN GV 11 Ramsel
66,Bergstraat 71,2022-12-05,08:00:00,156,6,150,FMN GV 11 Ramsel
66,Bergstraat 71,2022-12-05,09:00:00,32,6,26,FMN GV 11 Ramsel
66,Bergstraat 71,2022-12-05,10:00:00,14,10,4,FMN GV 11 Ramsel
66,Bergstraat 71,2022-12-05,11:00:00,26,18,8,FMN GV 11 Ramsel
66,Bergstraat 71,2022-12-05,12:00:00,20,18,2,FMN GV 11 Ramsel
66,Bergstraat 71,2022-12-05,13:00:00,16,8,8,FMN GV 11 Ramsel
66,Bergstraat 71,2022-12-05,14:00:00,62,48,14,FMN GV 11 Ramsel
66,Bergstraat 71,2022-12-05,15:00:00,122,112,10,FMN GV 11 Ramsel
66,Bergstraat 71,2022-12-05,16:00:00,116,106,10,FMN GV 11 Ramsel
66,Bergstraat 71,2022-12-05,17:00:00,36,22,14,FMN GV 11 Ramsel
66,Bergstraat 71,2022-12-05,18:00:00,36,30,6,FMN GV 11 Ramsel
66,Bergstraat 71,2022-12-05,19:00:00,16,10,6,FMN GV 11 Ramsel
66,Bergstraat 71,2022-12-05,20:00:00,6,2,4,FMN GV 11 Ramsel
66,Bergstraat 71,2022-12-05,21:00:00,0,0,0,FMN GV 11 Ramsel
66,Bergstraat 71,2022-12-05,22:00:00,4,4,0,FMN GV 11 Ramsel
66,Bergstraat 71,2022-12-05,23:00:00,2,2,0,FMN GV 11 Ramsel
66,Bergstraat 71,2022-12-06,00:00:00,0,0,0,FMN GV 11 Ramsel
66,Bergstraat 71,2022-12-06,01:00:00,0,0,0,FMN GV 11 Ramsel
66,Bergstraat 71,2022-12-06,02:00:00,0,0,0,FMN GV 11 Ramsel
66,Bergstraat 71,2022-12-06,03:00:00,0,0,0,FMN GV 11 Ramsel
66,Bergstraat 71,2022-12-06,04:00:00,10,8,2,FMN GV 11 Ramsel
66,Bergstraat 71,2022-12-06,05:00:00,16,8,8,FMN GV 11 Ramsel
66,Bergstraat 71,2022-12-06,06:00:00,32,10,22,FMN GV 11 Ramsel
66,Bergstraat 71,2022-12-06,07:00:00,186,22,164,FMN GV 11 Ramsel
66,Bergstraat 71,2022-12-06,08:00:00,212,24,188,FMN GV 11 Ramsel
66,Bergstraat 71,2022-12-06,09:00:00,40,12,28,FMN GV 11 Ramsel
66,Bergstraat 71,2022-12-06,10:00:00,46,22,24,FMN GV 11 Ramsel
66,Bergstraat 71,2022-12-06,11:00:00,32,8,24,FMN GV 11 Ramsel
66,Bergstraat 71,2022-12-06,12:00:00,106,72,34,FMN GV 11 Ramsel
66,Bergstraat 71,2022-12-06,13:00:00,82,28,54,FMN GV 11 Ramsel
66,Bergstraat 71,2022-12-06,14:00:00,112,64,48,FMN GV 11 Ramsel
66,Bergstraat 71,2022-12-06,15:00:00,218,180,38,FMN GV 11 Ramsel
66,Bergstraat 71,2022-12-06,16:00:00,180,144,36,FMN GV 11 Ramsel
66,Bergstraat 71,2022-12-06,17:00:00,68,36,32,FMN GV 11 Ramsel
66,Bergstraat 71,2022-12-06,18:00:00,52,30,22,FMN GV 11 Ramsel
66,Bergstraat 71,2022-12-06,19:00:00,40,20,20,FMN GV 11 Ramsel
66,Bergstraat 71,2022-12-06,20:00:00,20,10,10,FMN GV 11 Ramsel
66,Bergstraat 71,2022-12-06,21:00:00,16,12,4,FMN GV 11 Ramsel
66,Bergstraat 71,2022-12-06,22:00:00,12,12,0,FMN GV 11 Ramsel
66,Bergstraat 71,2022-12-06,23:00:00,4,4,0,FMN GV 11 Ramsel
66,Bergstraat 71,2022-12-07,00:00:00,0,0,0,FMN GV 11 Ramsel
66,Bergstraat 71,2022-12-07,01:00:00,0,0,0,FMN GV 11 Ramsel
66,Bergstraat 71,2022-12-07,02:00:00,0,0,0,FMN GV 11 Ramsel
66,Bergstraat 71,2022-12-07,03:00:00,0,0,0,FMN GV 11 Ramsel
66,Bergstraat 71,2022-12-07,04:00:00,8,6,2,FMN GV 11 Ramsel
66,Bergstraat 71,2022-12-07,05:00:00,16,6,10,FMN GV 11 Ramsel
66,Bergstraat 71,2022-12-07,06:00:00,18,6,12,FMN GV 11 Ramsel
66,Bergstraat 71,2022-12-07,07:00:00,162,18,144,FMN GV 11 Ramsel
66,Bergstraat 71,2022-12-07,08:00:00,168,10,158,FMN GV 11 Ramsel
66,Bergstraat 71,2022-12-07,09:00:00,44,22,22,FMN GV 11 Ramsel
66,Bergstraat 71,2022-12-07,10:00:00,46,26,20,FMN GV 11 Ramsel
66,Bergstraat 71,2022-12-07,11:00:00,72,56,16,FMN GV 11 Ramsel
66,Bergstraat 71,2022-12-07,12:00:00,228,204,24,FMN GV 11 Ramsel
66,Bergstraat 71,2022-12-07,13:00:00,54,26,28,FMN GV 11 Ramsel
66,Bergstraat 71,2022-12-07,14:00:00,54,32,22,FMN GV 11 Ramsel
66,Bergstraat 71,2022-12-07,15:00:00,58,38,20,FMN GV 11 Ramsel
66,Bergstraat 71,2022-12-07,16:00:00,46,30,16,FMN GV 11 Ramsel
66,Bergstraat 71,2022-12-07,17:00:00,54,42,12,FMN GV 11 Ramsel
66,Bergstraat 71,2022-12-07,18:00:00,34,22,12,FMN GV 11 Ramsel
66,Bergstraat 71,2022-12-07,19:00:00,32,18,14,FMN GV 11 Ramsel
66,Bergstraat 71,2022-12-07,20:00:00,12,10,2,FMN GV 11 Ramsel
66,Bergstraat 71,2022-12-07,21:00:00,6,4,2,FMN GV 11 Ramsel
66,Bergstraat 71,2022-12-07,22:00:00,4,4,0,FMN GV 11 Ramsel
66,Bergstraat 71,2022-12-07,23:00:00,0,0,0,FMN GV 11 Ramsel
66,Bergstraat 71,2022-12-08,00:00:00,0,0,0,FMN GV 11 Ramsel
66,Bergstraat 71,2022-12-08,01:00:00,0,0,0,FMN GV 11 Ramsel
66,Bergstraat 71,2022-12-08,02:00:00,0,0,0,FMN GV 11 Ramsel
66,Bergstraat 71,2022-12-08,03:00:00,0,0,0,FMN GV 11 Ramsel
66,Bergstraat 71,2022-12-08,04:00:00,4,4,0,FMN GV 11 Ramsel
66,Bergstraat 71,2022-12-08,05:00:00,16,8,8,FMN GV 11 Ramsel
66,Bergstraat 71,2022-12-08,06:00:00,32,14,18,FMN GV 11 Ramsel
66,Bergstraat 71,2022-12-08,07:00:00,174,14,160,FMN GV 11 Ramsel
66,Bergstraat 71,2022-12-08,08:00:00,196,16,180,FMN GV 11 Ramsel
66,Bergstraat 71,2022-12-08,09:00:00,28,18,10,FMN GV 11 Ramsel
66,Bergstraat 71,2022-12-08,10:00:00,74,44,30,FMN GV 11 Ramsel
66,Bergstraat 71,2022-12-08,11:00:00,54,44,10,FMN GV 11 Ramsel
66,Bergstraat 71,2022-12-08,12:00:00,110,86,24,FMN GV 11 Ramsel
66,Bergstraat 71,2022-12-08,13:00:00,56,26,30,FMN GV 11 Ramsel
66,Bergstraat 71,2022-12-08,14:00:00,54,34,20,FMN GV 11 Ramsel
66,Bergstraat 71,2022-12-08,15:00:00,132,106,26,FMN GV 11 Ramsel
66,Bergstraat 71,2022-12-08,16:00:00,84,70,14,FMN GV 11 Ramsel
66,Bergstraat 71,2022-12-08,17:00:00,46,30,16,FMN GV 11 Ramsel
66,Bergstraat 71,2022-12-08,18:00:00,36,20,16,FMN GV 11 Ramsel
66,Bergstraat 71,2022-12-08,19:00:00,12,4,8,FMN GV 11 Ramsel
66,Bergstraat 71,2022-12-08,20:00:00,8,4,4,FMN GV 11 Ramsel
66,Bergstraat 71,2022-12-08,21:00:00,6,4,2,FMN GV 11 Ramsel
66,Bergstraat 71,2022-12-08,22:00:00,12,10,2,FMN GV 11 Ramsel
66,Bergstraat 71,2022-12-08,23:00:00,4,4,0,FMN GV 11 Ramsel
66,Bergstraat 71,2022-12-09,00:00:00,2,2,0,FMN GV 11 Ramsel
66,Bergstraat 71,2022-12-09,01:00:00,2,2,0,FMN GV 11 Ramsel
66,Bergstraat 71,2022-12-09,02:00:00,0,0,0,FMN GV 11 Ramsel
66,Bergstraat 71,2022-12-09,03:00:00,0,0,0,FMN GV 11 Ramsel
66,Bergstraat 71,2022-12-09,04:00:00,2,2,0,FMN GV 11 Ramsel
66,Bergstraat 71,2022-12-09,05:00:00,10,8,2,FMN GV 11 Ramsel
66,Bergstraat 71,2022-12-09,06:00:00,14,10,4,FMN GV 11 Ramsel
66,Bergstraat 71,2022-12-09,07:00:00,116,12,104,FMN GV 11 Ramsel
66,Bergstraat 71,2022-12-09,08:00:00,118,26,92,FMN GV 11 Ramsel
66,Bergstraat 71,2022-12-09,09:00:00,36,6,30,FMN GV 11 Ramsel
66,Bergstraat 71,2022-12-09,10:00:00,74,60,14,FMN GV 11 Ramsel
66,Bergstraat 71,2022-12-09,11:00:00,64,46,18,FMN GV 11 Ramsel
66,Bergstraat 71,2022-12-09,12:00:00,82,60,22,FMN GV 11 Ramsel
66,Bergstraat 71,2022-12-09,13:00:00,62,32,30,FMN GV 11 Ramsel
66,Bergstraat 71,2022-12-09,14:00:00,50,34,16,FMN GV 11 Ramsel
66,Bergstraat 71,2022-12-09,15:00:00,94,74,20,FMN GV 11 Ramsel
66,Bergstraat 71,2022-12-09,16:00:00,78,56,22,FMN GV 11 Ramsel
66,Bergstraat 71,2022-12-09,17:00:00,48,28,20,FMN GV 11 Ramsel
66,Bergstraat 71,2022-12-09,18:00:00,30,18,12,FMN GV 11 Ramsel
66,Bergstraat 71,2022-12-09,19:00:00,34,12,22,FMN GV 11 Ramsel
66,Bergstraat 71,2022-12-09,20:00:00,16,8,8,FMN GV 11 Ramsel
66,Bergstraat 71,2022-12-09,21:00:00,8,2,6,FMN GV 11 Ramsel
66,Bergstraat 71,2022-12-09,22:00:00,6,2,4,FMN GV 11 Ramsel
66,Bergstraat 71,2022-12-09,23:00:00,8,8,0,FMN GV 11 Ramsel
66,Bergstraat 71,2022-12-10,00:00:00,14,12,2,FMN GV 11 Ramsel
66,Bergstraat 71,2022-12-10,01:00:00,2,2,0,FMN GV 11 Ramsel
66,Bergstraat 71,2022-12-10,02:00:00,4,4,0,FMN GV 11 Ramsel
66,Bergstraat 71,2022-12-10,03:00:00,6,2,4,FMN GV 11 Ramsel
66,Bergstraat 71,2022-12-10,04:00:00,0,0,0,FMN GV 11 Ramsel
66,Bergstraat 71,2022-12-10,05:00:00,4,2,2,FMN GV 11 Ramsel
66,Bergstraat 71,2022-12-10,06:00:00,8,6,2,FMN GV 11 Ramsel
66,Bergstraat 71,2022-12-10,07:00:00,0,0,0,FMN GV 11 Ramsel
66,Bergstraat 71,2022-12-10,08:00:00,14,4,10,FMN GV 11 Ramsel
66,Bergstraat 71,2022-12-10,09:00:00,24,14,10,FMN GV 11 Ramsel
66,Bergstraat 71,2022-12-10,10:00:00,20,8,12,FMN GV 11 Ramsel
66,Bergstraat 71,2022-12-10,11:00:00,28,18,10,FMN GV 11 Ramsel
66,Bergstraat 71,2022-12-10,12:00:00,34,12,22,FMN GV 11 Ramsel
66,Bergstraat 71,2022-12-10,13:00:00,62,26,36,FMN GV 11 Ramsel
66,Bergstraat 71,2022-12-10,14:00:00,48,22,26,FMN GV 11 Ramsel
66,Bergstraat 71,2022-12-10,15:00:00,38,24,14,FMN GV 11 Ramsel
66,Bergstraat 71,2022-12-10,16:00:00,30,12,18,FMN GV 11 Ramsel
66,Bergstraat 71,2022-12-10,17:00:00,32,18,14,FMN GV 11 Ramsel
66,Bergstraat 71,2022-12-10,18:00:00,8,0,8,FMN GV 11 Ramsel
66,Bergstraat 71,2022-12-10,19:00:00,8,4,4,FMN GV 11 Ramsel
66,Bergstraat 71,2022-12-10,20:00:00,10,2,8,FMN GV 11 Ramsel
66,Bergstraat 71,2022-12-10,21:00:00,6,4,2,FMN GV 11 Ramsel
66,Bergstraat 71,2022-12-10,22:00:00,12,6,6,FMN GV 11 Ramsel
66,Bergstraat 71,2022-12-10,23:00:00,6,4,2,FMN GV 11 Ramsel
66,Bergstraat 71,2022-12-11,00:00:00,2,2,0,FMN GV 11 Ramsel
66,Bergstraat 71,2022-12-11,01:00:00,4,2,2,FMN GV 11 Ramsel
66,Bergstraat 71,2022-12-11,02:00:00,0,0,0,FMN GV 11 Ramsel
66,Bergstraat 71,2022-12-11,03:00:00,4,4,0,FMN GV 11 Ramsel
66,Bergstraat 71,2022-12-11,04:00:00,0,0,0,FMN GV 11 Ramsel
66,Bergstraat 71,2022-12-11,05:00:00,4,2,2,FMN GV 11 Ramsel
66,Bergstraat 71,2022-12-11,06:00:00,0,0,0,FMN GV 11 Ramsel
66,Bergstraat 71,2022-12-11,07:00:00,6,0,6,FMN GV 11 Ramsel
66,Bergstraat 71,2022-12-11,08:00:00,10,2,8,FMN GV 11 Ramsel
66,Bergstraat 71,2022-12-11,09:00:00,24,4,20,FMN GV 11 Ramsel
66,Bergstraat 71,2022-12-11,10:00:00,46,26,20,FMN GV 11 Ramsel
66,Bergstraat 71,2022-12-11,11:00:00,50,24,26,FMN GV 11 Ramsel
66,Bergstraat 71,2022-12-11,12:00:00,36,12,24,FMN GV 11 Ramsel
66,Bergstraat 71,2022-12-11,13:00:00,54,30,24,FMN GV 11 Ramsel
66,Bergstraat 71,2022-12-11,14:00:00,40,12,28,FMN GV 11 Ramsel
66,Bergstraat 71,2022-12-11,15:00:00,14,10,4,FMN GV 11 Ramsel
66,Bergstraat 71,2022-12-11,16:00:00,20,6,14,FMN GV 11 Ramsel
66,Bergstraat 71,2022-12-11,17:00:00,6,2,4,FMN GV 11 Ramsel
66,Bergstraat 71,2022-12-11,18:00:00,6,4,2,FMN GV 11 Ramsel
66,Bergstraat 71,2022-12-11,19:00:00,8,4,4,FMN GV 11 Ramsel
66,Bergstraat 71,2022-12-11,20:00:00,0,0,0,FMN GV 11 Ramsel
66,Bergstraat 71,2022-12-11,21:00:00,4,2,2,FMN GV 11 Ramsel
66,Bergstraat 71,2022-12-11,22:00:00,0,0,0,FMN GV 11 Ramsel
66,Bergstraat 71,2022-12-11,23:00:00,4,4,0,FMN GV 11 Ramsel
66,Bergstraat 71,2022-12-12,00:00:00,0,0,0,FMN GV 11 Ramsel
66,Bergstraat 71,2022-12-12,01:00:00,0,0,0,FMN GV 11 Ramsel
66,Bergstraat 71,2022-12-12,02:00:00,0,0,0,FMN GV 11 Ramsel
66,Bergstraat 71,2022-12-12,03:00:00,0,0,0,FMN GV 11 Ramsel
66,Bergstraat 71,2022-12-12,04:00:00,2,2,0,FMN GV 11 Ramsel
66,Bergstraat 71,2022-12-12,05:00:00,6,2,4,FMN GV 11 Ramsel
66,Bergstraat 71,2022-12-12,06:00:00,16,4,12,FMN GV 11 Ramsel
66,Bergstraat 71,2022-12-12,07:00:00,130,22,108,FMN GV 11 Ramsel
66,Bergstraat 71,2022-12-12,08:00:00,108,10,98,FMN GV 11 Ramsel
66,Bergstraat 71,2022-12-12,09:00:00,16,4,12,FMN GV 11 Ramsel
66,Bergstraat 71,2022-12-12,10:00:00,36,24,12,FMN GV 11 Ramsel
66,Bergstraat 71,2022-12-12,11:00:00,64,50,14,FMN GV 11 Ramsel
66,Bergstraat 71,2022-12-12,12:00:00,122,96,26,FMN GV 11 Ramsel
66,Bergstraat 71,2022-12-12,13:00:00,68,42,26,FMN GV 11 Ramsel
66,Bergstraat 71,2022-12-12,14:00:00,48,24,24,FMN GV 11 Ramsel
66,Bergstraat 71,2022-12-12,15:00:00,68,46,22,FMN GV 11 Ramsel
66,Bergstraat 71,2022-12-12,16:00:00,66,44,22,FMN GV 11 Ramsel
66,Bergstraat 71,2022-12-12,17:00:00,50,36,14,FMN GV 11 Ramsel
66,Bergstraat 71,2022-12-12,18:00:00,14,8,6,FMN GV 11 Ramsel
66,Bergstraat 71,2022-12-12,19:00:00,14,8,6,FMN GV 11 Ramsel
66,Bergstraat 71,2022-12-12,20:00:00,10,6,4,FMN GV 11 Ramsel
66,Bergstraat 71,2022-12-12,21:00:00,6,6,0,FMN GV 11 Ramsel
66,Bergstraat 71,2022-12-12,22:00:00,6,2,4,FMN GV 11 Ramsel
66,Bergstraat 71,2022-12-12,23:00:00,2,0,2,FMN GV 11 Ramsel
66,Bergstraat 71,2022-12-13,00:00:00,0,0,0,FMN GV 11 Ramsel
66,Bergstraat 71,2022-12-13,01:00:00,0,0,0,FMN GV 11 Ramsel
66,Bergstraat 71,2022-12-13,02:00:00,0,0,0,FMN GV 11 Ramsel
66,Bergstraat 71,2022-12-13,03:00:00,0,0,0,FMN GV 11 Ramsel
66,Bergstraat 71,2022-12-13,04:00:00,4,4,0,FMN GV 11 Ramsel
66,Bergstraat 71,2022-12-13,05:00:00,6,2,4,FMN GV 11 Ramsel
66,Bergstraat 71,2022-12-13,06:00:00,16,4,12,FMN GV 11 Ramsel
66,Bergstraat 71,2022-12-13,07:00:00,126,20,106,FMN GV 11 Ramsel
66,Bergstraat 71,2022-12-13,08:00:00,98,10,88,FMN GV 11 Ramsel
66,Bergstraat 71,2022-12-13,09:00:00,18,2,16,FMN GV 11 Ramsel
66,Bergstraat 71,2022-12-13,10:00:00,102,88,14,FMN GV 11 Ramsel
66,Bergstraat 71,2022-12-13,11:00:00,62,44,18,FMN GV 11 Ramsel
66,Bergstraat 71,2022-12-13,12:00:00,80,54,26,FMN GV 11 Ramsel
66,Bergstraat 71,2022-12-13,13:00:00,36,24,12,FMN GV 11 Ramsel
66,Bergstraat 71,2022-12-13,14:00:00,44,26,18,FMN GV 11 Ramsel
66,Bergstraat 71,2022-12-13,15:00:00,74,64,10,FMN GV 11 Ramsel
66,Bergstraat 71,2022-12-13,16:00:00,50,36,14,FMN GV 11 Ramsel
66,Bergstraat 71,2022-12-13,17:00:00,56,34,22,FMN GV 11 Ramsel
66,Bergstraat 71,2022-12-13,18:00:00,20,10,10,FMN GV 11 Ramsel
66,Bergstraat 71,2022-12-13,19:00:00,12,8,4,FMN GV 11 Ramsel
66,Bergstraat 71,2022-12-13,20:00:00,16,12,4,FMN GV 11 Ramsel
66,Bergstraat 71,2022-12-13,21:00:00,8,6,2,FMN GV 11 Ramsel
66,Bergstraat 71,2022-12-13,22:00:00,14,8,6,FMN GV 11 Ramsel
66,Bergstraat 71,2022-12-13,23:00:00,0,0,0,FMN GV 11 Ramsel
66,Bergstraat 71,2022-12-14,00:00:00,2,0,2,FMN GV 11 Ramsel
66,Bergstraat 71,2022-12-14,01:00:00,0,0,0,FMN GV 11 Ramsel
66,Bergstraat 71,2022-12-14,02:00:00,0,0,0,FMN GV 11 Ramsel
66,Bergstraat 71,2022-12-14,03:00:00,0,0,0,FMN GV 11 Ramsel
66,Bergstraat 71,2022-12-14,04:00:00,4,4,0,FMN GV 11 Ramsel
66,Bergstraat 71,2022-12-14,05:00:00,10,4,6,FMN GV 11 Ramsel
66,Bergstraat 71,2022-12-14,06:00:00,8,2,6,FMN GV 11 Ramsel
66,Bergstraat 71,2022-12-14,07:00:00,142,20,122,FMN GV 11 Ramsel
66,Bergstraat 71,2022-12-14,08:00:00,130,8,122,FMN GV 11 Ramsel
66,Bergstraat 71,2022-12-14,09:00:00,20,10,10,FMN GV 11 Ramsel
66,Bergstraat 71,2022-12-14,10:00:00,72,60,12,FMN GV 11 Ramsel
66,Bergstraat 71,2022-12-14,11:00:00,118,94,24,FMN GV 11 Ramsel
66,Bergstraat 71,2022-12-14,12:00:00,100,90,10,FMN GV 11 Ramsel
66,Bergstraat 71,2022-12-14,13:00:00,48,26,22,FMN GV 11 Ramsel
66,Bergstraat 71,2022-12-14,14:00:00,56,16,40,FMN GV 11 Ramsel
66,Bergstraat 71,2022-12-14,15:00:00,48,32,16,FMN GV 11 Ramsel
66,Bergstraat 71,2022-12-14,16:00:00,44,24,20,FMN GV 11 Ramsel
66,Bergstraat 71,2022-12-14,17:00:00,30,18,12,FMN GV 11 Ramsel
66,Bergstraat 71,2022-12-14,18:00:00,28,18,10,FMN GV 11 Ramsel
66,Bergstraat 71,2022-12-14,19:00:00,12,8,4,FMN GV 11 Ramsel
66,Bergstraat 71,2022-12-14,20:00:00,10,6,4,FMN GV 11 Ramsel
66,Bergstraat 71,2022-12-14,21:00:00,0,0,0,FMN GV 11 Ramsel
66,Bergstraat 71,2022-12-14,22:00:00,8,8,0,FMN GV 11 Ramsel
66,Bergstraat 71,2022-12-14,23:00:00,6,6,0,FMN GV 11 Ramsel
66,Bergstraat 71,2022-12-15,00:00:00,0,0,0,FMN GV 11 Ramsel
66,Bergstraat 71,2022-12-15,01:00:00,0,0,0,FMN GV 11 Ramsel
66,Bergstraat 71,2022-12-15,02:00:00,0,0,0,FMN GV 11 Ramsel
66,Bergstraat 71,2022-12-15,03:00:00,0,0,0,FMN GV 11 Ramsel
66,Bergstraat 71,2022-12-15,04:00:00,4,4,0,FMN GV 11 Ramsel
66,Bergstraat 71,2022-12-15,05:00:00,10,6,4,FMN GV 11 Ramsel
66,Bergstraat 71,2022-12-15,06:00:00,18,4,14,FMN GV 11 Ramsel
66,Bergstraat 71,2022-12-15,07:00:00,134,16,118,FMN GV 11 Ramsel
66,Bergstraat 71,2022-12-15,08:00:00,130,24,106,FMN GV 11 Ramsel
66,Bergstraat 71,2022-12-15,09:00:00,14,4,10,FMN GV 11 Ramsel
66,Bergstraat 71,2022-12-15,10:00:00,78,72,6,FMN GV 11 Ramsel
66,Bergstraat 71,2022-12-15,11:00:00,80,72,8,FMN GV 11 Ramsel
66,Bergstraat 71,2022-12-15,12:00:00,76,60,16,FMN GV 11 Ramsel
66,Bergstraat 71,2022-12-15,13:00:00,46,30,16,FMN GV 11 Ramsel
66,Bergstraat 71,2022-12-15,14:00:00,58,24,34,FMN GV 11 Ramsel
66,Bergstraat 71,2022-12-15,15:00:00,58,40,18,FMN GV 11 Ramsel
66,Bergstraat 71,2022-12-15,16:00:00,48,30,18,FMN GV 11 Ramsel
66,Bergstraat 71,2022-12-15,17:00:00,50,30,20,FMN GV 11 Ramsel
66,Bergstraat 71,2022-12-15,18:00:00,34,20,14,FMN GV 11 Ramsel
66,Bergstraat 71,2022-12-15,19:00:00,14,6,8,FMN GV 11 Ramsel
66,Bergstraat 71,2022-12-15,20:00:00,8,6,2,FMN GV 11 Ramsel
66,Bergstraat 71,2022-12-15,21:00:00,8,6,2,FMN GV 11 Ramsel
66,Bergstraat 71,2022-12-15,22:00:00,10,6,4,FMN GV 11 Ramsel
66,Bergstraat 71,2022-12-15,23:00:00,4,2,2,FMN GV 11 Ramsel
66,Bergstraat 71,2022-12-16,00:00:00,8,6,2,FMN GV 11 Ramsel
66,Bergstraat 71,2022-12-16,01:00:00,0,0,0,FMN GV 11 Ramsel
66,Bergstraat 71,2022-12-16,02:00:00,2,0,2,FMN GV 11 Ramsel
66,Bergstraat 71,2022-12-16,03:00:00,2,0,2,FMN GV 11 Ramsel
66,Bergstraat 71,2022-12-16,04:00:00,4,4,0,FMN GV 11 Ramsel
66,Bergstraat 71,2022-12-16,05:00:00,4,4,0,FMN GV 11 Ramsel
66,Bergstraat 71,2022-12-16,06:00:00,4,2,2,FMN GV 11 Ramsel
66,Bergstraat 71,2022-12-16,07:00:00,144,12,132,FMN GV 11 Ramsel
66,Bergstraat 71,2022-12-16,08:00:00,104,6,98,FMN GV 11 Ramsel
66,Bergstraat 71,2022-12-16,09:00:00,14,6,8,FMN GV 11 Ramsel
66,Bergstraat 71,2022-12-16,10:00:00,90,82,8,FMN GV 11 Ramsel
66,Bergstraat 71,2022-12-16,11:00:00,66,52,14,FMN GV 11 Ramsel
66,Bergstraat 71,2022-12-16,12:00:00,52,40,12,FMN GV 11 Ramsel
66,Bergstraat 71,2022-12-16,13:00:00,46,16,30,FMN GV 11 Ramsel
66,Bergstraat 71,2022-12-16,14:00:00,56,30,26,FMN GV 11 Ramsel
66,Bergstraat 71,2022-12-16,15:00:00,34,30,4,FMN GV 11 Ramsel
66,Bergstraat 71,2022-12-16,16:00:00,40,28,12,FMN GV 11 Ramsel
66,Bergstraat 71,2022-12-16,17:00:00,24,12,12,FMN GV 11 Ramsel
66,Bergstraat 71,2022-12-16,18:00:00,10,6,4,FMN GV 11 Ramsel
66,Bergstraat 71,2022-12-16,19:00:00,8,2,6,FMN GV 11 Ramsel
66,Bergstraat 71,2022-12-16,20:00:00,16,10,6,FMN GV 11 Ramsel
66,Bergstraat 71,2022-12-16,21:00:00,6,2,4,FMN GV 11 Ramsel
66,Bergstraat 71,2022-12-16,22:00:00,8,4,4,FMN GV 11 Ramsel
66,Bergstraat 71,2022-12-16,23:00:00,6,2,4,FMN GV 11 Ramsel
66,Bergstraat 71,2022-12-17,00:00:00,4,2,2,FMN GV 11 Ramsel
66,Bergstraat 71,2022-12-17,01:00:00,4,4,0,FMN GV 11 Ramsel
66,Bergstraat 71,2022-12-17,02:00:00,0,0,0,FMN GV 11 Ramsel
66,Bergstraat 71,2022-12-17,03:00:00,4,2,2,FMN GV 11 Ramsel
66,Bergstraat 71,2022-12-17,04:00:00,2,2,0,FMN GV 11 Ramsel
66,Bergstraat 71,2022-12-17,05:00:00,0,0,0,FMN GV 11 Ramsel
66,Bergstraat 71,2022-12-17,06:00:00,2,0,2,FMN GV 11 Ramsel
66,Bergstraat 71,2022-12-17,07:00:00,2,0,2,FMN GV 11 Ramsel
66,Bergstraat 71,2022-12-17,08:00:00,4,0,4,FMN GV 11 Ramsel
66,Bergstraat 71,2022-12-17,09:00:00,6,2,4,FMN GV 11 Ramsel
66,Bergstraat 71,2022-12-17,10:00:00,18,4,14,FMN GV 11 Ramsel
66,Bergstraat 71,2022-12-17,11:00:00,14,6,8,FMN GV 11 Ramsel
66,Bergstraat 71,2022-12-17,12:00:00,18,16,2,FMN GV 11 Ramsel
66,Bergstraat 71,2022-12-17,13:00:00,16,10,6,FMN GV 11 Ramsel
66,Bergstraat 71,2022-12-17,14:00:00,28,16,12,FMN GV 11 Ramsel
66,Bergstraat 71,2022-12-17,15:00:00,24,8,16,FMN GV 11 Ramsel
66,Bergstraat 71,2022-12-17,16:00:00,14,10,4,FMN GV 11 Ramsel
66,Bergstraat 71,2022-12-17,17:00:00,12,8,4,FMN GV 11 Ramsel
66,Bergstraat 71,2022-12-17,18:00:00,20,12,8,FMN GV 11 Ramsel
66,Bergstraat 71,2022-12-17,19:00:00,4,2,2,FMN GV 11 Ramsel
66,Bergstraat 71,2022-12-17,20:00:00,6,0,6,FMN GV 11 Ramsel
66,Bergstraat 71,2022-12-17,21:00:00,12,0,12,FMN GV 11 Ramsel
66,Bergstraat 71,2022-12-17,22:00:00,4,2,2,FMN GV 11 Ramsel
66,Bergstraat 71,2022-12-17,23:00:00,0,0,0,FMN GV 11 Ramsel
66,Bergstraat 71,2022-12-18,00:00:00,2,2,0,FMN GV 11 Ramsel
66,Bergstraat 71,2022-12-18,01:00:00,0,0,0,FMN GV 11 Ramsel
66,Bergstraat 71,2022-12-18,02:00:00,4,2,2,FMN GV 11 Ramsel
66,Bergstraat 71,2022-12-18,03:00:00,0,0,0,FMN GV 11 Ramsel
66,Bergstraat 71,2022-12-18,04:00:00,0,0,0,FMN GV 11 Ramsel
66,Bergstraat 71,2022-12-18,05:00:00,0,0,0,FMN GV 11 Ramsel
66,Bergstraat 71,2022-12-18,06:00:00,2,0,2,FMN GV 11 Ramsel
66,Bergstraat 71,2022-12-18,07:00:00,0,0,0,FMN GV 11 Ramsel
66,Bergstraat 71,2022-12-18,08:00:00,4,2,2,FMN GV 11 Ramsel
66,Bergstraat 71,2022-12-18,09:00:00,12,6,6,FMN GV 11 Ramsel
66,Bergstraat 71,2022-12-18,10:00:00,18,4,14,FMN GV 11 Ramsel
66,Bergstraat 71,2022-12-18,11:00:00,16,12,4,FMN GV 11 Ramsel
66,Bergstraat 71,2022-12-18,12:00:00,12,6,6,FMN GV 11 Ramsel
66,Bergstraat 71,2022-12-18,13:00:00,28,16,12,FMN GV 11 Ramsel
66,Bergstraat 71,2022-12-18,14:00:00,10,2,8,FMN GV 11 Ramsel
66,Bergstraat 71,2022-12-18,15:00:00,16,10,6,FMN GV 11 Ramsel
66,Bergstraat 71,2022-12-18,16:00:00,16,6,10,FMN GV 11 Ramsel
66,Bergstraat 71,2022-12-18,17:00:00,12,2,10,FMN GV 11 Ramsel
66,Bergstraat 71,2022-12-18,18:00:00,6,0,6,FMN GV 11 Ramsel
66,Bergstraat 71,2022-12-18,19:00:00,4,4,0,FMN GV 11 Ramsel
66,Bergstraat 71,2022-12-18,20:00:00,0,0,0,FMN GV 11 Ramsel
66,Bergstraat 71,2022-12-18,21:00:00,0,0,0,FMN GV 11 Ramsel
66,Bergstraat 71,2022-12-18,22:00:00,2,2,0,FMN GV 11 Ramsel
66,Bergstraat 71,2022-12-18,23:00:00,0,0,0,FMN GV 11 Ramsel
66,Bergstraat 71,2022-12-19,00:00:00,0,0,0,FMN GV 11 Ramsel
66,Bergstraat 71,2022-12-19,01:00:00,2,0,2,FMN GV 11 Ramsel
66,Bergstraat 71,2022-12-19,02:00:00,0,0,0,FMN GV 11 Ramsel
66,Bergstraat 71,2022-12-19,03:00:00,0,0,0,FMN GV 11 Ramsel
66,Bergstraat 71,2022-12-19,04:00:00,2,2,0,FMN GV 11 Ramsel
66,Bergstraat 71,2022-12-19,05:00:00,6,4,2,FMN GV 11 Ramsel
66,Bergstraat 71,2022-12-19,06:00:00,14,4,10,FMN GV 11 Ramsel
66,Bergstraat 71,2022-12-19,07:00:00,154,14,140,FMN GV 11 Ramsel
66,Bergstraat 71,2022-12-19,08:00:00,146,14,132,FMN GV 11 Ramsel
66,Bergstraat 71,2022-12-19,09:00:00,44,16,28,FMN GV 11 Ramsel
66,Bergstraat 71,2022-12-19,10:00:00,48,42,6,FMN GV 11 Ramsel
66,Bergstraat 71,2022-12-19,11:00:00,84,72,12,FMN GV 11 Ramsel
66,Bergstraat 71,2022-12-19,12:00:00,100,80,20,FMN GV 11 Ramsel
66,Bergstraat 71,2022-12-19,13:00:00,36,18,18,FMN GV 11 Ramsel
66,Bergstraat 71,2022-12-19,14:00:00,94,48,46,FMN GV 11 Ramsel
66,Bergstraat 71,2022-12-19,15:00:00,72,48,24,FMN GV 11 Ramsel
66,Bergstraat 71,2022-12-19,16:00:00,60,46,14,FMN GV 11 Ramsel
66,Bergstraat 71,2022-12-19,17:00:00,40,28,12,FMN GV 11 Ramsel
66,Bergstraat 71,2022-12-19,18:00:00,14,4,10,FMN GV 11 Ramsel
66,Bergstraat 71,2022-12-19,19:00:00,26,14,12,FMN GV 11 Ramsel
66,Bergstraat 71,2022-12-19,20:00:00,14,10,4,FMN GV 11 Ramsel
66,Bergstraat 71,2022-12-19,21:00:00,2,0,2,FMN GV 11 Ramsel
66,Bergstraat 71,2022-12-19,22:00:00,8,6,2,FMN GV 11 Ramsel
66,Bergstraat 71,2022-12-19,23:00:00,4,2,2,FMN GV 11 Ramsel
66,Bergstraat 71,2022-12-20,00:00:00,0,0,0,FMN GV 11 Ramsel
66,Bergstraat 71,2022-12-20,01:00:00,0,0,0,FMN GV 11 Ramsel
66,Bergstraat 71,2022-12-20,02:00:00,0,0,0,FMN GV 11 Ramsel
66,Bergstraat 71,2022-12-20,03:00:00,0,0,0,FMN GV 11 Ramsel
66,Bergstraat 71,2022-12-20,04:00:00,4,4,0,FMN GV 11 Ramsel
66,Bergstraat 71,2022-12-20,05:00:00,12,8,4,FMN GV 11 Ramsel
66,Bergstraat 71,2022-12-20,06:00:00,16,8,8,FMN GV 11 Ramsel
66,Bergstraat 71,2022-12-20,07:00:00,164,20,144,FMN GV 11 Ramsel
66,Bergstraat 71,2022-12-20,08:00:00,76,6,70,FMN GV 11 Ramsel
66,Bergstraat 71,2022-12-20,09:00:00,24,12,12,FMN GV 11 Ramsel
66,Bergstraat 71,2022-12-20,10:00:00,76,70,6,FMN GV 11 Ramsel
66,Bergstraat 71,2022-12-20,11:00:00,32,22,10,FMN GV 11 Ramsel
66,Bergstraat 71,2022-12-20,12:00:00,64,42,22,FMN GV 11 Ramsel
66,Bergstraat 71,2022-12-20,13:00:00,32,16,16,FMN GV 11 Ramsel
66,Bergstraat 71,2022-12-20,14:00:00,30,16,14,FMN GV 11 Ramsel
66,Bergstraat 71,2022-12-20,15:00:00,38,34,4,FMN GV 11 Ramsel
66,Bergstraat 71,2022-12-20,16:00:00,34,26,8,FMN GV 11 Ramsel
66,Bergstraat 71,2022-12-20,17:00:00,44,22,22,FMN GV 11 Ramsel
66,Bergstraat 71,2022-12-20,18:00:00,32,14,18,FMN GV 11 Ramsel
66,Bergstraat 71,2022-12-20,19:00:00,14,12,2,FMN GV 11 Ramsel
66,Bergstraat 71,2022-12-20,20:00:00,18,12,6,FMN GV 11 Ramsel
66,Bergstraat 71,2022-12-20,21:00:00,2,2,0,FMN GV 11 Ramsel
66,Bergstraat 71,2022-12-20,22:00:00,6,6,0,FMN GV 11 Ramsel
66,Bergstraat 71,2022-12-20,23:00:00,4,4,0,FMN GV 11 Ramsel
66,Bergstraat 71,2022-12-21,00:00:00,6,6,0,FMN GV 11 Ramsel
66,Bergstraat 71,2022-12-21,01:00:00,0,0,0,FMN GV 11 Ramsel
66,Bergstraat 71,2022-12-21,02:00:00,0,0,0,FMN GV 11 Ramsel
66,Bergstraat 71,2022-12-21,03:00:00,0,0,0,FMN GV 11 Ramsel
66,Bergstraat 71,2022-12-21,04:00:00,6,4,2,FMN GV 11 Ramsel
66,Bergstraat 71,2022-12-21,05:00:00,8,6,2,FMN GV 11 Ramsel
66,Bergstraat 71,2022-12-21,06:00:00,18,8,10,FMN GV 11 Ramsel
66,Bergstraat 71,2022-12-21,07:00:00,70,8,62,FMN GV 11 Ramsel
66,Bergstraat 71,2022-12-21,08:00:00,70,6,64,FMN GV 11 Ramsel
66,Bergstraat 71,2022-12-21,09:00:00,34,10,24,FMN GV 11 Ramsel
66,Bergstraat 71,2022-12-21,10:00:00,86,58,28,FMN GV 11 Ramsel
66,Bergstraat 71,2022-12-21,11:00:00,76,48,28,FMN GV 11 Ramsel
66,Bergstraat 71,2022-12-21,12:00:00,114,76,38,FMN GV 11 Ramsel
66,Bergstraat 71,2022-12-21,13:00:00,96,62,34,FMN GV 11 Ramsel
66,Bergstraat 71,2022-12-21,14:00:00,70,30,40,FMN GV 11 Ramsel
66,Bergstraat 71,2022-12-21,15:00:00,114,60,54,FMN GV 11 Ramsel
66,Bergstraat 71,2022-12-21,16:00:00,58,42,16,FMN GV 11 Ramsel
66,Bergstraat 71,2022-12-21,17:00:00,66,48,18,FMN GV 11 Ramsel
66,Bergstraat 71,2022-12-21,18:00:00,26,16,10,FMN GV 11 Ramsel
66,Bergstraat 71,2022-12-21,19:00:00,10,6,4,FMN GV 11 Ramsel
66,Bergstraat 71,2022-12-21,20:00:00,12,10,2,FMN GV 11 Ramsel
66,Bergstraat 71,2022-12-21,21:00:00,0,0,0,FMN GV 11 Ramsel
66,Bergstraat 71,2022-12-21,22:00:00,10,8,2,FMN GV 11 Ramsel
66,Bergstraat 71,2022-12-21,23:00:00,6,6,0,FMN GV 11 Ramsel
66,Bergstraat 71,2022-12-22,00:00:00,2,2,0,FMN GV 11 Ramsel
66,Bergstraat 71,2022-12-22,01:00:00,0,0,0,FMN GV 11 Ramsel
66,Bergstraat 71,2022-12-22,02:00:00,0,0,0,FMN GV 11 Ramsel
66,Bergstraat 71,2022-12-22,03:00:00,0,0,0,FMN GV 11 Ramsel
66,Bergstraat 71,2022-12-22,04:00:00,6,4,2,FMN GV 11 Ramsel
66,Bergstraat 71,2022-12-22,05:00:00,6,0,6,FMN GV 11 Ramsel
66,Bergstraat 71,2022-12-22,06:00:00,14,4,10,FMN GV 11 Ramsel
66,Bergstraat 71,2022-12-22,07:00:00,28,8,20,FMN GV 11 Ramsel
66,Bergstraat 71,2022-12-22,08:00:00,36,10,26,FMN GV 11 Ramsel
66,Bergstraat 71,2022-12-22,09:00:00,46,10,36,FMN GV 11 Ramsel
66,Bergstraat 71,2022-12-22,10:00:00,40,16,24,FMN GV 11 Ramsel
66,Bergstraat 71,2022-12-22,11:00:00,54,36,18,FMN GV 11 Ramsel
66,Bergstraat 71,2022-12-22,12:00:00,42,16,26,FMN GV 11 Ramsel
66,Bergstraat 71,2022-12-22,13:00:00,86,44,42,FMN GV 11 Ramsel
66,Bergstraat 71,2022-12-22,14:00:00,58,38,20,FMN GV 11 Ramsel
66,Bergstraat 71,2022-12-22,15:00:00,38,22,16,FMN GV 11 Ramsel
66,Bergstraat 71,2022-12-22,16:00:00,62,46,16,FMN GV 11 Ramsel
66,Bergstraat 71,2022-12-22,17:00:00,28,18,10,FMN GV 11 Ramsel
66,Bergstraat 71,2022-12-22,18:00:00,16,8,8,FMN GV 11 Ramsel
66,Bergstraat 71,2022-12-22,19:00:00,12,6,6,FMN GV 11 Ramsel
66,Bergstraat 71,2022-12-22,20:00:00,14,8,6,FMN GV 11 Ramsel
66,Bergstraat 71,2022-12-22,21:00:00,4,2,2,FMN GV 11 Ramsel
66,Bergstraat 71,2022-12-22,22:00:00,10,6,4,FMN GV 11 Ramsel
66,Bergstraat 71,2022-12-22,23:00:00,4,4,0,FMN GV 11 Ramsel
66,Bergstraat 71,2022-12-23,00:00:00,2,0,2,FMN GV 11 Ramsel
66,Bergstraat 71,2022-12-23,01:00:00,0,0,0,FMN GV 11 Ramsel
66,Bergstraat 71,2022-12-23,02:00:00,0,0,0,FMN GV 11 Ramsel
66,Bergstraat 71,2022-12-23,03:00:00,0,0,0,FMN GV 11 Ramsel
66,Bergstraat 71,2022-12-23,04:00:00,4,4,0,FMN GV 11 Ramsel
66,Bergstraat 71,2022-12-23,05:00:00,4,4,0,FMN GV 11 Ramsel
66,Bergstraat 71,2022-12-23,06:00:00,8,4,4,FMN GV 11 Ramsel
66,Bergstraat 71,2022-12-23,07:00:00,48,12,36,FMN GV 11 Ramsel
66,Bergstraat 71,2022-12-23,08:00:00,60,4,56,FMN GV 11 Ramsel
66,Bergstraat 71,2022-12-23,09:00:00,54,22,32,FMN GV 11 Ramsel
66,Bergstraat 71,2022-12-23,10:00:00,56,28,28,FMN GV 11 Ramsel
66,Bergstraat 71,2022-12-23,11:00:00,28,24,4,FMN GV 11 Ramsel
66,Bergstraat 71,2022-12-23,12:00:00,34,24,10,FMN GV 11 Ramsel
66,Bergstraat 71,2022-12-23,13:00:00,12,8,4,FMN GV 11 Ramsel
66,Bergstraat 71,2022-12-23,14:00:00,30,22,8,FMN GV 11 Ramsel
66,Bergstraat 71,2022-12-23,15:00:00,28,16,12,FMN GV 11 Ramsel
66,Bergstraat 71,2022-12-23,16:00:00,52,38,14,FMN GV 11 Ramsel
66,Bergstraat 71,2022-12-23,17:00:00,30,16,14,FMN GV 11 Ramsel
66,Bergstraat 71,2022-12-23,18:00:00,10,4,6,FMN GV 11 Ramsel
66,Bergstraat 71,2022-12-23,19:00:00,22,6,16,FMN GV 11 Ramsel
66,Bergstraat 71,2022-12-23,20:00:00,14,6,8,FMN GV 11 Ramsel
66,Bergstraat 71,2022-12-23,21:00:00,12,4,8,FMN GV 11 Ramsel
66,Bergstraat 71,2022-12-23,22:00:00,4,0,4,FMN GV 11 Ramsel
66,Bergstraat 71,2022-12-23,23:00:00,8,6,2,FMN GV 11 Ramsel
66,Bergstraat 71,2022-12-24,00:00:00,0,0,0,FMN GV 11 Ramsel
66,Bergstraat 71,2022-12-24,01:00:00,4,4,0,FMN GV 11 Ramsel
66,Bergstraat 71,2022-12-24,02:00:00,4,4,0,FMN GV 11 Ramsel
66,Bergstraat 71,2022-12-24,03:00:00,2,2,0,FMN GV 11 Ramsel
66,Bergstraat 71,2022-12-24,04:00:00,6,4,2,FMN GV 11 Ramsel
66,Bergstraat 71,2022-12-24,05:00:00,0,0,0,FMN GV 11 Ramsel
66,Bergstraat 71,2022-12-24,06:00:00,8,4,4,FMN GV 11 Ramsel
66,Bergstraat 71,2022-12-24,07:00:00,0,0,0,FMN GV 11 Ramsel
66,Bergstraat 71,2022-12-24,08:00:00,20,6,14,FMN GV 11 Ramsel
66,Bergstraat 71,2022-12-24,09:00:00,40,16,24,FMN GV 11 Ramsel
66,Bergstraat 71,2022-12-24,10:00:00,52,28,24,FMN GV 11 Ramsel
66,Bergstraat 71,2022-12-24,11:00:00,84,32,52,FMN GV 11 Ramsel
66,Bergstraat 71,2022-12-24,12:00:00,86,32,54,FMN GV 11 Ramsel
66,Bergstraat 71,2022-12-24,13:00:00,106,72,34,FMN GV 11 Ramsel
66,Bergstraat 71,2022-12-24,14:00:00,138,78,60,FMN GV 11 Ramsel
66,Bergstraat 71,2022-12-24,15:00:00,90,56,34,FMN GV 11 Ramsel
66,Bergstraat 71,2022-12-24,16:00:00,38,28,10,FMN GV 11 Ramsel
66,Bergstraat 71,2022-12-24,17:00:00,24,14,10,FMN GV 11 Ramsel
66,Bergstraat 71,2022-12-24,18:00:00,8,4,4,FMN GV 11 Ramsel
66,Bergstraat 71,2022-12-24,19:00:00,4,2,2,FMN GV 11 Ramsel
66,Bergstraat 71,2022-12-24,20:00:00,6,2,4,FMN GV 11 Ramsel
66,Bergstraat 71,2022-12-24,21:00:00,4,2,2,FMN GV 11 Ramsel
66,Bergstraat 71,2022-12-24,22:00:00,8,6,2,FMN GV 11 Ramsel
66,Bergstraat 71,2022-12-24,23:00:00,0,0,0,FMN GV 11 Ramsel
66,Bergstraat 71,2022-12-25,00:00:00,8,2,6,FMN GV 11 Ramsel
66,Bergstraat 71,2022-12-25,01:00:00,2,2,0,FMN GV 11 Ramsel
66,Bergstraat 71,2022-12-25,02:00:00,4,4,0,FMN GV 11 Ramsel
66,Bergstraat 71,2022-12-25,03:00:00,0,0,0,FMN GV 11 Ramsel
66,Bergstraat 71,2022-12-25,04:00:00,4,4,0,FMN GV 11 Ramsel
66,Bergstraat 71,2022-12-25,05:00:00,0,0,0,FMN GV 11 Ramsel
66,Bergstraat 71,2022-12-25,06:00:00,6,2,4,FMN GV 11 Ramsel
66,Bergstraat 71,2022-12-25,07:00:00,6,2,4,FMN GV 11 Ramsel
66,Bergstraat 71,2022-12-25,08:00:00,12,4,8,FMN GV 11 Ramsel
66,Bergstraat 71,2022-12-25,09:00:00,10,4,6,FMN GV 11 Ramsel
66,Bergstraat 71,2022-12-25,10:00:00,10,8,2,FMN GV 11 Ramsel
66,Bergstraat 71,2022-12-25,11:00:00,22,20,2,FMN GV 11 Ramsel
66,Bergstraat 71,2022-12-25,12:00:00,14,10,4,FMN GV 11 Ramsel
66,Bergstraat 71,2022-12-25,13:00:00,4,2,2,FMN GV 11 Ramsel
66,Bergstraat 71,2022-12-25,14:00:00,2,2,0,FMN GV 11 Ramsel
66,Bergstraat 71,2022-12-25,15:00:00,8,6,2,FMN GV 11 Ramsel
66,Bergstraat 71,2022-12-25,16:00:00,2,0,2,FMN GV 11 Ramsel
66,Bergstraat 71,2022-12-25,17:00:00,0,0,0,FMN GV 11 Ramsel
66,Bergstraat 71,2022-12-25,18:00:00,0,0,0,FMN GV 11 Ramsel
66,Bergstraat 71,2022-12-25,19:00:00,2,0,2,FMN GV 11 Ramsel
66,Bergstraat 71,2022-12-25,20:00:00,6,0,6,FMN GV 11 Ramsel
66,Bergstraat 71,2022-12-25,21:00:00,4,2,2,FMN GV 11 Ramsel
66,Bergstraat 71,2022-12-25,22:00:00,2,2,0,FMN GV 11 Ramsel
66,Bergstraat 71,2022-12-25,23:00:00,0,0,0,FMN GV 11 Ramsel
66,Bergstraat 71,2022-12-26,00:00:00,0,0,0,FMN GV 11 Ramsel
66,Bergstraat 71,2022-12-26,01:00:00,0,0,0,FMN GV 11 Ramsel
66,Bergstraat 71,2022-12-26,02:00:00,0,0,0,FMN GV 11 Ramsel
66,Bergstraat 71,2022-12-26,03:00:00,0,0,0,FMN GV 11 Ramsel
66,Bergstraat 71,2022-12-26,04:00:00,0,0,0,FMN GV 11 Ramsel
66,Bergstraat 71,2022-12-26,05:00:00,4,2,2,FMN GV 11 Ramsel
66,Bergstraat 71,2022-12-26,06:00:00,2,2,0,FMN GV 11 Ramsel
66,Bergstraat 71,2022-12-26,07:00:00,8,2,6,FMN GV 11 Ramsel
66,Bergstraat 71,2022-12-26,08:00:00,14,6,8,FMN GV 11 Ramsel
66,Bergstraat 71,2022-12-26,09:00:00,62,16,46,FMN GV 11 Ramsel
66,Bergstraat 71,2022-12-26,10:00:00,64,44,20,FMN GV 11 Ramsel
66,Bergstraat 71,2022-12-26,11:00:00,32,18,14,FMN GV 11 Ramsel
66,Bergstraat 71,2022-12-26,12:00:00,56,28,28,FMN GV 11 Ramsel
66,Bergstraat 71,2022-12-26,13:00:00,88,48,40,FMN GV 11 Ramsel
66,Bergstraat 71,2022-12-26,14:00:00,94,50,44,FMN GV 11 Ramsel
66,Bergstraat 71,2022-12-26,15:00:00,86,60,26,FMN GV 11 Ramsel
66,Bergstraat 71,2022-12-26,16:00:00,72,54,18,FMN GV 11 Ramsel
66,Bergstraat 71,2022-12-26,17:00:00,20,14,6,FMN GV 11 Ramsel
66,Bergstraat 71,2022-12-26,18:00:00,24,16,8,FMN GV 11 Ramsel
66,Bergstraat 71,2022-12-26,19:00:00,10,2,8,FMN GV 11 Ramsel
66,Bergstraat 71,2022-12-26,20:00:00,8,0,8,FMN GV 11 Ramsel
66,Bergstraat 71,2022-12-26,21:00:00,6,2,4,FMN GV 11 Ramsel
66,Bergstraat 71,2022-12-26,22:00:00,12,6,6,FMN GV 11 Ramsel
66,Bergstraat 71,2022-12-26,23:00:00,2,0,2,FMN GV 11 Ramsel
66,Bergstraat 71,2022-12-27,00:00:00,4,2,2,FMN GV 11 Ramsel
66,Bergstraat 71,2022-12-27,01:00:00,2,2,0,FMN GV 11 Ramsel
66,Bergstraat 71,2022-12-27,02:00:00,2,0,2,FMN GV 11 Ramsel
66,Bergstraat 71,2022-12-27,03:00:00,0,0,0,FMN GV 11 Ramsel
66,Bergstraat 71,2022-12-27,04:00:00,0,0,0,FMN GV 11 Ramsel
66,Bergstraat 71,2022-12-27,05:00:00,10,6,4,FMN GV 11 Ramsel
66,Bergstraat 71,2022-12-27,06:00:00,6,4,2,FMN GV 11 Ramsel
66,Bergstraat 71,2022-12-27,07:00:00,10,0,10,FMN GV 11 Ramsel
66,Bergstraat 71,2022-12-27,08:00:00,18,6,12,FMN GV 11 Ramsel
66,Bergstraat 71,2022-12-27,09:00:00,28,12,16,FMN GV 11 Ramsel
66,Bergstraat 71,2022-12-27,10:00:00,68,36,32,FMN GV 11 Ramsel
66,Bergstraat 71,2022-12-27,11:00:00,86,28,58,FMN GV 11 Ramsel
66,Bergstraat 71,2022-12-27,12:00:00,86,40,46,FMN GV 11 Ramsel
66,Bergstraat 71,2022-12-27,13:00:00,138,70,68,FMN GV 11 Ramsel
66,Bergstraat 71,2022-12-27,14:00:00,82,48,34,FMN GV 11 Ramsel
66,Bergstraat 71,2022-12-27,15:00:00,90,54,36,FMN GV 11 Ramsel
66,Bergstraat 71,2022-12-27,16:00:00,72,52,20,FMN GV 11 Ramsel
66,Bergstraat 71,2022-12-27,17:00:00,64,30,34,FMN GV 11 Ramsel
66,Bergstraat 71,2022-12-27,18:00:00,26,10,16,FMN GV 11 Ramsel
66,Bergstraat 71,2022-12-27,19:00:00,14,8,6,FMN GV 11 Ramsel
66,Bergstraat 71,2022-12-27,20:00:00,26,14,12,FMN GV 11 Ramsel
66,Bergstraat 71,2022-12-27,21:00:00,2,2,0,FMN GV 11 Ramsel
66,Bergstraat 71,2022-12-27,22:00:00,18,12,6,FMN GV 11 Ramsel
66,Bergstraat 71,2022-12-27,23:00:00,12,10,2,FMN GV 11 Ramsel
66,Bergstraat 71,2022-12-28,00:00:00,0,0,0,FMN GV 11 Ramsel
66,Bergstraat 71,2022-12-28,01:00:00,6,4,2,FMN GV 11 Ramsel
66,Bergstraat 71,2022-12-28,02:00:00,0,0,0,FMN GV 11 Ramsel
66,Bergstraat 71,2022-12-28,03:00:00,0,0,0,FMN GV 11 Ramsel
66,Bergstraat 71,2022-12-28,04:00:00,2,2,0,FMN GV 11 Ramsel
66,Bergstraat 71,2022-12-28,05:00:00,4,2,2,FMN GV 11 Ramsel
66,Bergstraat 71,2022-12-28,06:00:00,8,2,6,FMN GV 11 Ramsel
66,Bergstraat 71,2022-12-28,07:00:00,6,0,6,FMN GV 11 Ramsel
66,Bergstraat 71,2022-12-28,08:00:00,10,0,10,FMN GV 11 Ramsel
66,Bergstraat 71,2022-12-28,09:00:00,24,6,18,FMN GV 11 Ramsel
66,Bergstraat 71,2022-12-28,10:00:00,16,10,6,FMN GV 11 Ramsel
66,Bergstraat 71,2022-12-28,11:00:00,10,4,6,FMN GV 11 Ramsel
66,Bergstraat 71,2022-12-28,12:00:00,36,20,16,FMN GV 11 Ramsel
66,Bergstraat 71,2022-12-28,13:00:00,30,16,14,FMN GV 11 Ramsel
66,Bergstraat 71,2022-12-28,14:00:00,42,20,22,FMN GV 11 Ramsel
66,Bergstraat 71,2022-12-28,15:00:00,58,32,26,FMN GV 11 Ramsel
66,Bergstraat 71,2022-12-28,16:00:00,36,26,10,FMN GV 11 Ramsel
66,Bergstraat 71,2022-12-28,17:00:00,18,8,10,FMN GV 11 Ramsel
66,Bergstraat 71,2022-12-28,18:00:00,8,4,4,FMN GV 11 Ramsel
66,Bergstraat 71,2022-12-28,19:00:00,12,8,4,FMN GV 11 Ramsel
66,Bergstraat 71,2022-12-28,20:00:00,14,10,4,FMN GV 11 Ramsel
66,Bergstraat 71,2022-12-28,21:00:00,0,0,0,FMN GV 11 Ramsel
66,Bergstraat 71,2022-12-28,22:00:00,2,0,2,FMN GV 11 Ramsel
66,Bergstraat 71,2022-12-28,23:00:00,0,0,0,FMN GV 11 Ramsel
66,Bergstraat 71,2022-12-29,00:00:00,2,2,0,FMN GV 11 Ramsel
66,Bergstraat 71,2022-12-29,01:00:00,0,0,0,FMN GV 11 Ramsel
66,Bergstraat 71,2022-12-29,02:00:00,0,0,0,FMN GV 11 Ramsel
66,Bergstraat 71,2022-12-29,03:00:00,0,0,0,FMN GV 11 Ramsel
66,Bergstraat 71,2022-12-29,04:00:00,0,0,0,FMN GV 11 Ramsel
66,Bergstraat 71,2022-12-29,05:00:00,2,2,0,FMN GV 11 Ramsel
66,Bergstraat 71,2022-12-29,06:00:00,4,4,0,FMN GV 11 Ramsel
66,Bergstraat 71,2022-12-29,07:00:00,10,2,8,FMN GV 11 Ramsel
66,Bergstraat 71,2022-12-29,08:00:00,12,0,12,FMN GV 11 Ramsel
66,Bergstraat 71,2022-12-29,09:00:00,18,4,14,FMN GV 11 Ramsel
66,Bergstraat 71,2022-12-29,10:00:00,36,14,22,FMN GV 11 Ramsel
66,Bergstraat 71,2022-12-29,11:00:00,40,24,16,FMN GV 11 Ramsel
66,Bergstraat 71,2022-12-29,12:00:00,30,18,12,FMN GV 11 Ramsel
66,Bergstraat 71,2022-12-29,13:00:00,40,22,18,FMN GV 11 Ramsel
66,Bergstraat 71,2022-12-29,14:00:00,34,18,16,FMN GV 11 Ramsel
66,Bergstraat 71,2022-12-29,15:00:00,38,12,26,FMN GV 11 Ramsel
66,Bergstraat 71,2022-12-29,16:00:00,24,16,8,FMN GV 11 Ramsel
66,Bergstraat 71,2022-12-29,17:00:00,12,6,6,FMN GV 11 Ramsel
66,Bergstraat 71,2022-12-29,18:00:00,22,16,6,FMN GV 11 Ramsel
66,Bergstraat 71,2022-12-29,19:00:00,22,8,14,FMN GV 11 Ramsel
66,Bergstraat 71,2022-12-29,20:00:00,12,6,6,FMN GV 11 Ramsel
66,Bergstraat 71,2022-12-29,21:00:00,4,4,0,FMN GV 11 Ramsel
66,Bergstraat 71,2022-12-29,22:00:00,4,4,0,FMN GV 11 Ramsel
66,Bergstraat 71,2022-12-29,23:00:00,4,2,2,FMN GV 11 Ramsel
66,Bergstraat 71,2022-12-30,00:00:00,16,10,6,FMN GV 11 Ramsel
66,Bergstraat 71,2022-12-30,01:00:00,4,4,0,FMN GV 11 Ramsel
66,Bergstraat 71,2022-12-30,02:00:00,0,0,0,FMN GV 11 Ramsel
66,Bergstraat 71,2022-12-30,03:00:00,0,0,0,FMN GV 11 Ramsel
66,Bergstraat 71,2022-12-30,04:00:00,0,0,0,FMN GV 11 Ramsel
66,Bergstraat 71,2022-12-30,05:00:00,6,4,2,FMN GV 11 Ramsel
66,Bergstraat 71,2022-12-30,06:00:00,2,2,0,FMN GV 11 Ramsel
66,Bergstraat 71,2022-12-30,07:00:00,12,4,8,FMN GV 11 Ramsel
66,Bergstraat 71,2022-12-30,08:00:00,8,0,8,FMN GV 11 Ramsel
66,Bergstraat 71,2022-12-30,09:00:00,48,14,34,FMN GV 11 Ramsel
66,Bergstraat 71,2022-12-30,10:00:00,86,32,54,FMN GV 11 Ramsel
66,Bergstraat 71,2022-12-30,11:00:00,64,40,24,FMN GV 11 Ramsel
66,Bergstraat 71,2022-12-30,12:00:00,38,28,10,FMN GV 11 Ramsel
66,Bergstraat 71,2022-12-30,13:00:00,8,8,0,FMN GV 11 Ramsel
66,Bergstraat 71,2022-12-30,14:00:00,6,2,4,FMN GV 11 Ramsel
66,Bergstraat 71,2022-12-30,15:00:00,24,10,14,FMN GV 11 Ramsel
66,Bergstraat 71,2022-12-30,16:00:00,18,8,10,FMN GV 11 Ramsel
66,Bergstraat 71,2022-12-30,17:00:00,8,6,2,FMN GV 11 Ramsel
66,Bergstraat 71,2022-12-30,18:00:00,18,6,12,FMN GV 11 Ramsel
66,Bergstraat 71,2022-12-30,19:00:00,20,12,8,FMN GV 11 Ramsel
66,Bergstraat 71,2022-12-30,20:00:00,12,6,6,FMN GV 11 Ramsel
66,Bergstraat 71,2022-12-30,21:00:00,2,2,0,FMN GV 11 Ramsel
66,Bergstraat 71,2022-12-30,22:00:00,8,4,4,FMN GV 11 Ramsel
66,Bergstraat 71,2022-12-30,23:00:00,4,4,0,FMN GV 11 Ramsel
66,Bergstraat 71,2022-12-31,00:00:00,0,0,0,FMN GV 11 Ramsel
66,Bergstraat 71,2022-12-31,01:00:00,6,2,4,FMN GV 11 Ramsel
66,Bergstraat 71,2022-12-31,02:00:00,0,0,0,FMN GV 11 Ramsel
66,Bergstraat 71,2022-12-31,03:00:00,0,0,0,FMN GV 11 Ramsel
66,Bergstraat 71,2022-12-31,04:00:00,2,2,0,FMN GV 11 Ramsel
66,Bergstraat 71,2022-12-31,05:00:00,2,2,0,FMN GV 11 Ramsel
66,Bergstraat 71,2022-12-31,06:00:00,2,2,0,FMN GV 11 Ramsel
66,Bergstraat 71,2022-12-31,07:00:00,4,0,4,FMN GV 11 Ramsel
66,Bergstraat 71,2022-12-31,08:00:00,24,10,14,FMN GV 11 Ramsel
66,Bergstraat 71,2022-12-31,09:00:00,18,8,10,FMN GV 11 Ramsel
66,Bergstraat 71,2022-12-31,10:00:00,18,4,14,FMN GV 11 Ramsel
66,Bergstraat 71,2022-12-31,11:00:00,20,10,10,FMN GV 11 Ramsel
66,Bergstraat 71,2022-12-31,12:00:00,44,12,32,FMN GV 11 Ramsel
66,Bergstraat 71,2022-12-31,13:00:00,74,46,28,FMN GV 11 Ramsel
66,Bergstraat 71,2022-12-31,14:00:00,46,20,26,FMN GV 11 Ramsel
66,Bergstraat 71,2022-12-31,15:00:00,46,22,24,FMN GV 11 Ramsel
66,Bergstraat 71,2022-12-31,16:00:00,44,26,18,FMN GV 11 Ramsel
66,Bergstraat 71,2022-12-31,17:00:00,32,22,10,FMN GV 11 Ramsel
66,Bergstraat 71,2022-12-31,18:00:00,18,6,12,FMN GV 11 Ramsel
66,Bergstraat 71,2022-12-31,19:00:00,2,0,2,FMN GV 11 Ramsel
66,Bergstraat 71,2022-12-31,20:00:00,4,4,0,FMN GV 11 Ramsel
66,Bergstraat 71,2022-12-31,21:00:00,2,2,0,FMN GV 11 Ramsel
66,Bergstraat 71,2022-12-31,22:00:00,4,4,0,FMN GV 11 Ramsel
66,Bergstraat 71,2022-12-31,23:00:00,2,2,0,FMN GV 11 Ramsel
66,Bergstraat 71,2023-01-01,00:00:00,0,0,0,FMN GV 11 Ramsel
66,Bergstraat 71,2023-01-01,01:00:00,10,0,10,FMN GV 11 Ramsel
66,Bergstraat 71,2023-01-01,02:00:00,6,0,6,FMN GV 11 Ramsel
66,Bergstraat 71,2023-01-01,03:00:00,6,4,2,FMN GV 11 Ramsel
66,Bergstraat 71,2023-01-01,04:00:00,8,4,4,FMN GV 11 Ramsel
66,Bergstraat 71,2023-01-01,05:00:00,2,2,0,FMN GV 11 Ramsel
66,Bergstraat 71,2023-01-01,06:00:00,2,2,0,FMN GV 11 Ramsel
66,Bergstraat 71,2023-01-01,07:00:00,6,2,4,FMN GV 11 Ramsel
66,Bergstraat 71,2023-01-01,08:00:00,14,0,14,FMN GV 11 Ramsel
66,Bergstraat 71,2023-01-01,09:00:00,30,8,22,FMN GV 11 Ramsel
66,Bergstraat 71,2023-01-01,10:00:00,42,30,12,FMN GV 11 Ramsel
66,Bergstraat 71,2023-01-01,11:00:00,62,36,26,FMN GV 11 Ramsel
66,Bergstraat 71,2023-01-01,12:00:00,52,30,22,FMN GV 11 Ramsel
66,Bergstraat 71,2023-01-01,13:00:00,60,24,36,FMN GV 11 Ramsel
66,Bergstraat 71,2023-01-01,14:00:00,66,44,22,FMN GV 11 Ramsel
66,Bergstraat 71,2023-01-01,15:00:00,26,14,12,FMN GV 11 Ramsel
66,Bergstraat 71,2023-01-01,16:00:00,12,2,10,FMN GV 11 Ramsel
66,Bergstraat 71,2023-01-01,17:00:00,6,2,4,FMN GV 11 Ramsel
66,Bergstraat 71,2023-01-01,18:00:00,0,0,0,FMN GV 11 Ramsel
66,Bergstraat 71,2023-01-01,19:00:00,2,2,0,FMN GV 11 Ramsel
66,Bergstraat 71,2023-01-01,20:00:00,4,4,0,FMN GV 11 Ramsel
66,Bergstraat 71,2023-01-01,21:00:00,2,0,2,FMN GV 11 Ramsel
66,Bergstraat 71,2023-01-01,22:00:00,0,0,0,FMN GV 11 Ramsel
66,Bergstraat 71,2023-01-01,23:00:00,0,0,0,FMN GV 11 Ramsel
66,Bergstraat 71,2023-01-02,00:00:00,0,0,0,FMN GV 11 Ramsel
66,Bergstraat 71,2023-01-02,01:00:00,0,0,0,FMN GV 11 Ramsel
66,Bergstraat 71,2023-01-02,02:00:00,0,0,0,FMN GV 11 Ramsel
66,Bergstraat 71,2023-01-02,03:00:00,0,0,0,FMN GV 11 Ramsel
66,Bergstraat 71,2023-01-02,04:00:00,0,0,0,FMN GV 11 Ramsel
66,Bergstraat 71,2023-01-02,05:00:00,12,6,6,FMN GV 11 Ramsel
66,Bergstraat 71,2023-01-02,06:00:00,10,4,6,FMN GV 11 Ramsel
66,Bergstraat 71,2023-01-02,07:00:00,10,6,4,FMN GV 11 Ramsel
66,Bergstraat 71,2023-01-02,08:00:00,10,2,8,FMN GV 11 Ramsel
66,Bergstraat 71,2023-01-02,09:00:00,10,2,8,FMN GV 11 Ramsel
66,Bergstraat 71,2023-01-02,10:00:00,12,6,6,FMN GV 11 Ramsel
66,Bergstraat 71,2023-01-02,11:00:00,18,8,10,FMN GV 11 Ramsel
66,Bergstraat 71,2023-01-02,12:00:00,44,18,26,FMN GV 11 Ramsel
66,Bergstraat 71,2023-01-02,13:00:00,74,34,40,FMN GV 11 Ramsel
66,Bergstraat 71,2023-01-02,14:00:00,60,28,32,FMN GV 11 Ramsel
66,Bergstraat 71,2023-01-02,15:00:00,40,22,18,FMN GV 11 Ramsel
66,Bergstraat 71,2023-01-02,16:00:00,30,20,10,FMN GV 11 Ramsel
66,Bergstraat 71,2023-01-02,17:00:00,24,6,18,FMN GV 11 Ramsel
66,Bergstraat 71,2023-01-02,18:00:00,10,8,2,FMN GV 11 Ramsel
66,Bergstraat 71,2023-01-02,19:00:00,12,6,6,FMN GV 11 Ramsel
66,Bergstraat 71,2023-01-02,20:00:00,6,4,2,FMN GV 11 Ramsel
66,Bergstraat 71,2023-01-02,21:00:00,4,2,2,FMN GV 11 Ramsel
66,Bergstraat 71,2023-01-02,22:00:00,8,6,2,FMN GV 11 Ramsel
66,Bergstraat 71,2023-01-02,23:00:00,4,4,0,FMN GV 11 Ramsel
66,Bergstraat 71,2023-01-03,00:00:00,0,0,0,FMN GV 11 Ramsel
66,Bergstraat 71,2023-01-03,01:00:00,4,4,0,FMN GV 11 Ramsel
66,Bergstraat 71,2023-01-03,02:00:00,0,0,0,FMN GV 11 Ramsel
66,Bergstraat 71,2023-01-03,03:00:00,4,2,2,FMN GV 11 Ramsel
66,Bergstraat 71,2023-01-03,04:00:00,2,2,0,FMN GV 11 Ramsel
66,Bergstraat 71,2023-01-03,05:00:00,14,8,6,FMN GV 11 Ramsel
66,Bergstraat 71,2023-01-03,06:00:00,18,8,10,FMN GV 11 Ramsel
66,Bergstraat 71,2023-01-03,07:00:00,40,16,24,FMN GV 11 Ramsel
66,Bergstraat 71,2023-01-03,08:00:00,20,2,18,FMN GV 11 Ramsel
66,Bergstraat 71,2023-01-03,09:00:00,52,18,34,FMN GV 11 Ramsel
66,Bergstraat 71,2023-01-03,10:00:00,46,16,30,FMN GV 11 Ramsel
66,Bergstraat 71,2023-01-03,11:00:00,42,28,14,FMN GV 11 Ramsel
66,Bergstraat 71,2023-01-03,12:00:00,86,44,42,FMN GV 11 Ramsel
66,Bergstraat 71,2023-01-03,13:00:00,132,76,56,FMN GV 11 Ramsel
66,Bergstraat 71,2023-01-03,14:00:00,84,50,34,FMN GV 11 Ramsel
66,Bergstraat 71,2023-01-03,15:00:00,94,60,34,FMN GV 11 Ramsel
66,Bergstraat 71,2023-01-03,16:00:00,82,44,38,FMN GV 11 Ramsel
66,Bergstraat 71,2023-01-03,17:00:00,72,44,28,FMN GV 11 Ramsel
66,Bergstraat 71,2023-01-03,18:00:00,48,18,30,FMN GV 11 Ramsel
66,Bergstraat 71,2023-01-03,19:00:00,30,14,16,FMN GV 11 Ramsel
66,Bergstraat 71,2023-01-03,20:00:00,22,12,10,FMN GV 11 Ramsel
66,Bergstraat 71,2023-01-03,21:00:00,12,10,2,FMN GV 11 Ramsel
66,Bergstraat 71,2023-01-03,22:00:00,6,4,2,FMN GV 11 Ramsel
66,Bergstraat 71,2023-01-03,23:00:00,2,2,0,FMN GV 11 Ramsel
66,Bergstraat 71,2023-01-04,00:00:00,0,0,0,FMN GV 11 Ramsel
66,Bergstraat 71,2023-01-04,01:00:00,0,0,0,FMN GV 11 Ramsel
66,Bergstraat 71,2023-01-04,02:00:00,0,0,0,FMN GV 11 Ramsel
66,Bergstraat 71,2023-01-04,03:00:00,0,0,0,FMN GV 11 Ramsel
66,Bergstraat 71,2023-01-04,04:00:00,2,2,0,FMN GV 11 Ramsel
66,Bergstraat 71,2023-01-04,05:00:00,10,8,2,FMN GV 11 Ramsel
66,Bergstraat 71,2023-01-04,06:00:00,18,8,10,FMN GV 11 Ramsel
66,Bergstraat 71,2023-01-04,07:00:00,24,6,18,FMN GV 11 Ramsel
66,Bergstraat 71,2023-01-04,08:00:00,16,10,6,FMN GV 11 Ramsel
66,Bergstraat 71,2023-01-04,09:00:00,10,0,10,FMN GV 11 Ramsel
66,Bergstraat 71,2023-01-04,10:00:00,16,10,6,FMN GV 11 Ramsel
66,Bergstraat 71,2023-01-04,11:00:00,22,6,16,FMN GV 11 Ramsel
66,Bergstraat 71,2023-01-04,12:00:00,22,8,14,FMN GV 11 Ramsel
66,Bergstraat 71,2023-01-04,13:00:00,28,4,24,FMN GV 11 Ramsel
66,Bergstraat 71,2023-01-04,14:00:00,20,10,10,FMN GV 11 Ramsel
66,Bergstraat 71,2023-01-04,15:00:00,16,6,10,FMN GV 11 Ramsel
66,Bergstraat 71,2023-01-04,16:00:00,30,18,12,FMN GV 11 Ramsel
66,Bergstraat 71,2023-01-04,17:00:00,24,14,10,FMN GV 11 Ramsel
66,Bergstraat 71,2023-01-04,18:00:00,24,14,10,FMN GV 11 Ramsel
66,Bergstraat 71,2023-01-04,19:00:00,26,16,10,FMN GV 11 Ramsel
66,Bergstraat 71,2023-01-04,20:00:00,24,16,8,FMN GV 11 Ramsel
66,Bergstraat 71,2023-01-04,21:00:00,4,2,2,FMN GV 11 Ramsel
66,Bergstraat 71,2023-01-04,22:00:00,8,8,0,FMN GV 11 Ramsel
66,Bergstraat 71,2023-01-04,23:00:00,0,0,0,FMN GV 11 Ramsel
66,Bergstraat 71,2023-01-05,00:00:00,0,0,0,FMN GV 11 Ramsel
66,Bergstraat 71,2023-01-05,01:00:00,4,2,2,FMN GV 11 Ramsel
66,Bergstraat 71,2023-01-05,02:00:00,0,0,0,FMN GV 11 Ramsel
66,Bergstraat 71,2023-01-05,03:00:00,2,0,2,FMN GV 11 Ramsel
66,Bergstraat 71,2023-01-05,04:00:00,6,2,4,FMN GV 11 Ramsel
66,Bergstraat 71,2023-01-05,05:00:00,14,8,6,FMN GV 11 Ramsel
66,Bergstraat 71,2023-01-05,06:00:00,18,8,10,FMN GV 11 Ramsel
66,Bergstraat 71,2023-01-05,07:00:00,30,8,22,FMN GV 11 Ramsel
66,Bergstraat 71,2023-01-05,08:00:00,32,8,24,FMN GV 11 Ramsel
66,Bergstraat 71,2023-01-05,09:00:00,30,12,18,FMN GV 11 Ramsel
66,Bergstraat 71,2023-01-05,10:00:00,38,22,16,FMN GV 11 Ramsel
66,Bergstraat 71,2023-01-05,11:00:00,64,30,34,FMN GV 11 Ramsel
66,Bergstraat 71,2023-01-05,12:00:00,78,42,36,FMN GV 11 Ramsel
66,Bergstraat 71,2023-01-05,13:00:00,94,46,48,FMN GV 11 Ramsel
66,Bergstraat 71,2023-01-05,14:00:00,80,46,34,FMN GV 11 Ramsel
66,Bergstraat 71,2023-01-05,15:00:00,62,40,22,FMN GV 11 Ramsel
66,Bergstraat 71,2023-01-05,16:00:00,64,42,22,FMN GV 11 Ramsel
66,Bergstraat 71,2023-01-05,17:00:00,50,26,24,FMN GV 11 Ramsel
66,Bergstraat 71,2023-01-05,18:00:00,18,12,6,FMN GV 11 Ramsel
66,Bergstraat 71,2023-01-05,19:00:00,26,8,18,FMN GV 11 Ramsel
66,Bergstraat 71,2023-01-05,20:00:00,10,6,4,FMN GV 11 Ramsel
66,Bergstraat 71,2023-01-05,21:00:00,12,6,6,FMN GV 11 Ramsel
66,Bergstraat 71,2023-01-05,22:00:00,18,16,2,FMN GV 11 Ramsel
66,Bergstraat 71,2023-01-05,23:00:00,8,0,8,FMN GV 11 Ramsel
66,Bergstraat 71,2023-01-06,00:00:00,8,2,6,FMN GV 11 Ramsel
66,Bergstraat 71,2023-01-06,01:00:00,2,2,0,FMN GV 11 Ramsel
66,Bergstraat 71,2023-01-06,02:00:00,0,0,0,FMN GV 11 Ramsel
66,Bergstraat 71,2023-01-06,03:00:00,0,0,0,FMN GV 11 Ramsel
66,Bergstraat 71,2023-01-06,04:00:00,2,2,0,FMN GV 11 Ramsel
66,Bergstraat 71,2023-01-06,05:00:00,12,10,2,FMN GV 11 Ramsel
66,Bergstraat 71,2023-01-06,06:00:00,18,6,12,FMN GV 11 Ramsel
66,Bergstraat 71,2023-01-06,07:00:00,26,14,12,FMN GV 11 Ramsel
66,Bergstraat 71,2023-01-06,08:00:00,16,0,16,FMN GV 11 Ramsel
66,Bergstraat 71,2023-01-06,09:00:00,6,2,4,FMN GV 11 Ramsel
66,Bergstraat 71,2023-01-06,10:00:00,22,12,10,FMN GV 11 Ramsel
66,Bergstraat 71,2023-01-06,11:00:00,54,24,30,FMN GV 11 Ramsel
66,Bergstraat 71,2023-01-06,12:00:00,54,22,32,FMN GV 11 Ramsel
66,Bergstraat 71,2023-01-06,13:00:00,50,16,34,FMN GV 11 Ramsel
66,Bergstraat 71,2023-01-06,14:00:00,44,26,18,FMN GV 11 Ramsel
66,Bergstraat 71,2023-01-06,15:00:00,64,40,24,FMN GV 11 Ramsel
66,Bergstraat 71,2023-01-06,16:00:00,50,42,8,FMN GV 11 Ramsel
66,Bergstraat 71,2023-01-06,17:00:00,40,18,22,FMN GV 11 Ramsel
66,Bergstraat 71,2023-01-06,18:00:00,20,14,6,FMN GV 11 Ramsel
66,Bergstraat 71,2023-01-06,19:00:00,16,6,10,FMN GV 11 Ramsel
66,Bergstraat 71,2023-01-06,20:00:00,14,4,10,FMN GV 11 Ramsel
66,Bergstraat 71,2023-01-06,21:00:00,10,6,4,FMN GV 11 Ramsel
66,Bergstraat 71,2023-01-06,22:00:00,26,4,22,FMN GV 11 Ramsel
66,Bergstraat 71,2023-01-06,23:00:00,6,4,2,FMN GV 11 Ramsel
66,Bergstraat 71,2023-01-07,00:00:00,6,4,2,FMN GV 11 Ramsel
66,Bergstraat 71,2023-01-07,01:00:00,8,8,0,FMN GV 11 Ramsel
66,Bergstraat 71,2023-01-07,02:00:00,14,12,2,FMN GV 11 Ramsel
66,Bergstraat 71,2023-01-07,03:00:00,4,4,0,FMN GV 11 Ramsel
66,Bergstraat 71,2023-01-07,04:00:00,2,0,2,FMN GV 11 Ramsel
66,Bergstraat 71,2023-01-07,05:00:00,2,2,0,FMN GV 11 Ramsel
66,Bergstraat 71,2023-01-07,06:00:00,6,4,2,FMN GV 11 Ramsel
66,Bergstraat 71,2023-01-07,07:00:00,14,4,10,FMN GV 11 Ramsel
66,Bergstraat 71,2023-01-07,08:00:00,24,10,14,FMN GV 11 Ramsel
66,Bergstraat 71,2023-01-07,09:00:00,36,14,22,FMN GV 11 Ramsel
66,Bergstraat 71,2023-01-07,10:00:00,104,52,52,FMN GV 11 Ramsel
66,Bergstraat 71,2023-01-07,11:00:00,138,64,74,FMN GV 11 Ramsel
66,Bergstraat 71,2023-01-07,12:00:00,138,64,74,FMN GV 11 Ramsel
66,Bergstraat 71,2023-01-07,13:00:00,132,72,60,FMN GV 11 Ramsel
66,Bergstraat 71,2023-01-07,14:00:00,114,70,44,FMN GV 11 Ramsel
66,Bergstraat 71,2023-01-07,15:00:00,116,68,48,FMN GV 11 Ramsel
66,Bergstraat 71,2023-01-07,16:00:00,74,40,34,FMN GV 11 Ramsel
66,Bergstraat 71,2023-01-07,17:00:00,24,16,8,FMN GV 11 Ramsel
66,Bergstraat 71,2023-01-07,18:00:00,22,10,12,FMN GV 11 Ramsel
66,Bergstraat 71,2023-01-07,19:00:00,8,4,4,FMN GV 11 Ramsel
66,Bergstraat 71,2023-01-07,20:00:00,14,10,4,FMN GV 11 Ramsel
66,Bergstraat 71,2023-01-07,21:00:00,8,8,0,FMN GV 11 Ramsel
66,Bergstraat 71,2023-01-07,22:00:00,8,0,8,FMN GV 11 Ramsel
66,Bergstraat 71,2023-01-07,23:00:00,0,0,0,FMN GV 11 Ramsel
66,Bergstraat 71,2023-01-08,00:00:00,6,4,2,FMN GV 11 Ramsel
66,Bergstraat 71,2023-01-08,01:00:00,4,0,4,FMN GV 11 Ramsel
66,Bergstraat 71,2023-01-08,02:00:00,2,2,0,FMN GV 11 Ramsel
66,Bergstraat 71,2023-01-08,03:00:00,0,0,0,FMN GV 11 Ramsel
66,Bergstraat 71,2023-01-08,04:00:00,0,0,0,FMN GV 11 Ramsel
66,Bergstraat 71,2023-01-08,05:00:00,2,2,0,FMN GV 11 Ramsel
66,Bergstraat 71,2023-01-08,06:00:00,2,0,2,FMN GV 11 Ramsel
66,Bergstraat 71,2023-01-08,07:00:00,4,0,4,FMN GV 11 Ramsel
66,Bergstraat 71,2023-01-08,08:00:00,30,4,26,FMN GV 11 Ramsel
66,Bergstraat 71,2023-01-08,09:00:00,82,28,54,FMN GV 11 Ramsel
66,Bergstraat 71,2023-01-08,10:00:00,148,64,84,FMN GV 11 Ramsel
66,Bergstraat 71,2023-01-08,11:00:00,98,46,52,FMN GV 11 Ramsel
66,Bergstraat 71,2023-01-08,12:00:00,82,48,34,FMN GV 11 Ramsel
66,Bergstraat 71,2023-01-08,13:00:00,78,26,52,FMN GV 11 Ramsel
66,Bergstraat 71,2023-01-08,14:00:00,104,60,44,FMN GV 11 Ramsel
66,Bergstraat 71,2023-01-08,15:00:00,92,44,48,FMN GV 11 Ramsel
66,Bergstraat 71,2023-01-08,16:00:00,48,26,22,FMN GV 11 Ramsel
66,Bergstraat 71,2023-01-08,17:00:00,24,10,14,FMN GV 11 Ramsel
66,Bergstraat 71,2023-01-08,18:00:00,4,2,2,FMN GV 11 Ramsel
66,Bergstraat 71,2023-01-08,19:00:00,6,4,2,FMN GV 11 Ramsel
66,Bergstraat 71,2023-01-08,20:00:00,2,0,2,FMN GV 11 Ramsel
66,Bergstraat 71,2023-01-08,21:00:00,2,2,0,FMN GV 11 Ramsel
66,Bergstraat 71,2023-01-08,22:00:00,2,2,0,FMN GV 11 Ramsel
66,Bergstraat 71,2023-01-08,23:00:00,2,0,2,FMN GV 11 Ramsel
66,Bergstraat 71,2023-01-09,00:00:00,2,2,0,FMN GV 11 Ramsel
66,Bergstraat 71,2023-01-09,01:00:00,0,0,0,FMN GV 11 Ramsel
66,Bergstraat 71,2023-01-09,02:00:00,0,0,0,FMN GV 11 Ramsel
66,Bergstraat 71,2023-01-09,03:00:00,0,0,0,FMN GV 11 Ramsel
66,Bergstraat 71,2023-01-09,04:00:00,6,6,0,FMN GV 11 Ramsel
66,Bergstraat 71,2023-01-09,05:00:00,6,4,2,FMN GV 11 Ramsel
66,Bergstraat 71,2023-01-09,06:00:00,40,18,22,FMN GV 11 Ramsel
66,Bergstraat 71,2023-01-09,07:00:00,182,20,162,FMN GV 11 Ramsel
66,Bergstraat 71,2023-01-09,08:00:00,180,10,170,FMN GV 11 Ramsel
66,Bergstraat 71,2023-01-09,09:00:00,22,6,16,FMN GV 11 Ramsel
66,Bergstraat 71,2023-01-09,10:00:00,30,20,10,FMN GV 11 Ramsel
66,Bergstraat 71,2023-01-09,11:00:00,30,12,18,FMN GV 11 Ramsel
66,Bergstraat 71,2023-01-09,12:00:00,32,24,8,FMN GV 11 Ramsel
66,Bergstraat 71,2023-01-09,13:00:00,54,36,18,FMN GV 11 Ramsel
66,Bergstraat 71,2023-01-09,14:00:00,70,34,36,FMN GV 11 Ramsel
66,Bergstraat 71,2023-01-09,15:00:00,212,184,28,FMN GV 11 Ramsel
66,Bergstraat 71,2023-01-09,16:00:00,146,122,24,FMN GV 11 Ramsel
66,Bergstraat 71,2023-01-09,17:00:00,68,48,20,FMN GV 11 Ramsel
66,Bergstraat 71,2023-01-09,18:00:00,14,8,6,FMN GV 11 Ramsel
66,Bergstraat 71,2023-01-09,19:00:00,30,20,10,FMN GV 11 Ramsel
66,Bergstraat 71,2023-01-09,20:00:00,20,8,12,FMN GV 11 Ramsel
66,Bergstraat 71,2023-01-09,21:00:00,4,4,0,FMN GV 11 Ramsel
66,Bergstraat 71,2023-01-09,22:00:00,14,12,2,FMN GV 11 Ramsel
66,Bergstraat 71,2023-01-09,23:00:00,0,0,0,FMN GV 11 Ramsel
66,Bergstraat 71,2023-01-10,00:00:00,0,0,0,FMN GV 11 Ramsel
66,Bergstraat 71,2023-01-10,01:00:00,0,0,0,FMN GV 11 Ramsel
66,Bergstraat 71,2023-01-10,02:00:00,0,0,0,FMN GV 11 Ramsel
66,Bergstraat 71,2023-01-10,03:00:00,0,0,0,FMN GV 11 Ramsel
66,Bergstraat 71,2023-01-10,04:00:00,6,6,0,FMN GV 11 Ramsel
66,Bergstraat 71,2023-01-10,05:00:00,10,4,6,FMN GV 11 Ramsel
66,Bergstraat 71,2023-01-10,06:00:00,36,18,18,FMN GV 11 Ramsel
66,Bergstraat 71,2023-01-10,07:00:00,172,22,150,FMN GV 11 Ramsel
66,Bergstraat 71,2023-01-10,08:00:00,154,22,132,FMN GV 11 Ramsel
66,Bergstraat 71,2023-01-10,09:00:00,58,10,48,FMN GV 11 Ramsel
66,Bergstraat 71,2023-01-10,10:00:00,74,24,50,FMN GV 11 Ramsel
66,Bergstraat 71,2023-01-10,11:00:00,56,38,18,FMN GV 11 Ramsel
66,Bergstraat 71,2023-01-10,12:00:00,64,24,40,FMN GV 11 Ramsel
66,Bergstraat 71,2023-01-10,13:00:00,64,36,28,FMN GV 11 Ramsel
66,Bergstraat 71,2023-01-10,14:00:00,48,34,14,FMN GV 11 Ramsel
66,Bergstraat 71,2023-01-10,15:00:00,174,154,20,FMN GV 11 Ramsel
66,Bergstraat 71,2023-01-10,16:00:00,166,150,16,FMN GV 11 Ramsel
66,Bergstraat 71,2023-01-10,17:00:00,84,52,32,FMN GV 11 Ramsel
66,Bergstraat 71,2023-01-10,18:00:00,38,22,16,FMN GV 11 Ramsel
66,Bergstraat 71,2023-01-10,19:00:00,26,14,12,FMN GV 11 Ramsel
66,Bergstraat 71,2023-01-10,20:00:00,12,6,6,FMN GV 11 Ramsel
66,Bergstraat 71,2023-01-10,21:00:00,8,8,0,FMN GV 11 Ramsel
66,Bergstraat 71,2023-01-10,22:00:00,8,4,4,FMN GV 11 Ramsel
66,Bergstraat 71,2023-01-10,23:00:00,0,0,0,FMN GV 11 Ramsel
66,Bergstraat 71,2023-01-11,00:00:00,0,0,0,FMN GV 11 Ramsel
66,Bergstraat 71,2023-01-11,01:00:00,0,0,0,FMN GV 11 Ramsel
66,Bergstraat 71,2023-01-11,02:00:00,0,0,0,FMN GV 11 Ramsel
66,Bergstraat 71,2023-01-11,03:00:00,0,0,0,FMN GV 11 Ramsel
66,Bergstraat 71,2023-01-11,04:00:00,6,6,0,FMN GV 11 Ramsel
66,Bergstraat 71,2023-01-11,05:00:00,8,4,4,FMN GV 11 Ramsel
66,Bergstraat 71,2023-01-11,06:00:00,20,6,14,FMN GV 11 Ramsel
66,Bergstraat 71,2023-01-11,07:00:00,202,34,168,FMN GV 11 Ramsel
66,Bergstraat 71,2023-01-11,08:00:00,144,14,130,FMN GV 11 Ramsel
66,Bergstraat 71,2023-01-11,09:00:00,32,14,18,FMN GV 11 Ramsel
66,Bergstraat 71,2023-01-11,10:00:00,50,30,20,FMN GV 11 Ramsel
66,Bergstraat 71,2023-01-11,11:00:00,64,46,18,FMN GV 11 Ramsel
66,Bergstraat 71,2023-01-11,12:00:00,270,232,38,FMN GV 11 Ramsel
66,Bergstraat 71,2023-01-11,13:00:00,138,64,74,FMN GV 11 Ramsel
66,Bergstraat 71,2023-01-11,14:00:00,128,76,52,FMN GV 11 Ramsel
66,Bergstraat 71,2023-01-11,15:00:00,104,68,36,FMN GV 11 Ramsel
66,Bergstraat 71,2023-01-11,16:00:00,96,62,34,FMN GV 11 Ramsel
66,Bergstraat 71,2023-01-11,17:00:00,78,54,24,FMN GV 11 Ramsel
66,Bergstraat 71,2023-01-11,18:00:00,36,18,18,FMN GV 11 Ramsel
66,Bergstraat 71,2023-01-11,19:00:00,32,24,8,FMN GV 11 Ramsel
66,Bergstraat 71,2023-01-11,20:00:00,20,8,12,FMN GV 11 Ramsel
66,Bergstraat 71,2023-01-11,21:00:00,6,6,0,FMN GV 11 Ramsel
66,Bergstraat 71,2023-01-11,22:00:00,6,6,0,FMN GV 11 Ramsel
66,Bergstraat 71,2023-01-11,23:00:00,2,0,2,FMN GV 11 Ramsel
66,Bergstraat 71,2023-01-12,00:00:00,2,2,0,FMN GV 11 Ramsel
66,Bergstraat 71,2023-01-12,01:00:00,2,0,2,FMN GV 11 Ramsel
66,Bergstraat 71,2023-01-12,02:00:00,0,0,0,FMN GV 11 Ramsel
66,Bergstraat 71,2023-01-12,03:00:00,2,2,0,FMN GV 11 Ramsel
66,Bergstraat 71,2023-01-12,04:00:00,6,4,2,FMN GV 11 Ramsel
66,Bergstraat 71,2023-01-12,05:00:00,4,2,2,FMN GV 11 Ramsel
66,Bergstraat 71,2023-01-12,06:00:00,16,6,10,FMN GV 11 Ramsel
66,Bergstraat 71,2023-01-12,07:00:00,52,6,46,FMN GV 11 Ramsel
66,Bergstraat 71,2023-01-12,08:00:00,62,6,56,FMN GV 11 Ramsel
66,Bergstraat 71,2023-01-12,09:00:00,4,4,0,FMN GV 11 Ramsel
66,Bergstraat 71,2023-01-12,10:00:00,8,4,4,FMN GV 11 Ramsel
66,Bergstraat 71,2023-01-12,11:00:00,20,12,8,FMN GV 11 Ramsel
66,Bergstraat 71,2023-01-12,12:00:00,4,4,0,FMN GV 11 Ramsel
66,Bergstraat 71,2023-01-12,13:00:00,20,10,10,FMN GV 11 Ramsel
66,Bergstraat 71,2023-01-12,14:00:00,12,6,6,FMN GV 11 Ramsel
66,Bergstraat 71,2023-01-12,15:00:00,54,48,6,FMN GV 11 Ramsel
66,Bergstraat 71,2023-01-12,16:00:00,56,50,6,FMN GV 11 Ramsel
66,Bergstraat 71,2023-01-12,17:00:00,52,42,10,FMN GV 11 Ramsel
66,Bergstraat 71,2023-01-12,18:00:00,12,8,4,FMN GV 11 Ramsel
66,Bergstraat 71,2023-01-12,19:00:00,20,10,10,FMN GV 11 Ramsel
66,Bergstraat 71,2023-01-12,20:00:00,8,4,4,FMN GV 11 Ramsel
66,Bergstraat 71,2023-01-12,21:00:00,10,10,0,FMN GV 11 Ramsel
66,Bergstraat 71,2023-01-12,22:00:00,10,8,2,FMN GV 11 Ramsel
66,Bergstraat 71,2023-01-12,23:00:00,2,0,2,FMN GV 11 Ramsel
66,Bergstraat 71,2023-01-13,00:00:00,0,0,0,FMN GV 11 Ramsel
66,Bergstraat 71,2023-01-13,01:00:00,2,0,2,FMN GV 11 Ramsel
66,Bergstraat 71,2023-01-13,02:00:00,2,0,2,FMN GV 11 Ramsel
66,Bergstraat 71,2023-01-13,03:00:00,0,0,0,FMN GV 11 Ramsel
66,Bergstraat 71,2023-01-13,04:00:00,6,4,2,FMN GV 11 Ramsel
66,Bergstraat 71,2023-01-13,05:00:00,8,4,4,FMN GV 11 Ramsel
66,Bergstraat 71,2023-01-13,06:00:00,16,6,10,FMN GV 11 Ramsel
66,Bergstraat 71,2023-01-13,07:00:00,164,22,142,FMN GV 11 Ramsel
66,Bergstraat 71,2023-01-13,08:00:00,158,14,144,FMN GV 11 Ramsel
66,Bergstraat 71,2023-01-13,09:00:00,32,8,24,FMN GV 11 Ramsel
66,Bergstraat 71,2023-01-13,10:00:00,58,20,38,FMN GV 11 Ramsel
66,Bergstraat 71,2023-01-13,11:00:00,40,18,22,FMN GV 11 Ramsel
66,Bergstraat 71,2023-01-13,12:00:00,42,26,16,FMN GV 11 Ramsel
66,Bergstraat 71,2023-01-13,13:00:00,62,30,32,FMN GV 11 Ramsel
66,Bergstraat 71,2023-01-13,14:00:00,54,34,20,FMN GV 11 Ramsel
66,Bergstraat 71,2023-01-13,15:00:00,178,144,34,FMN GV 11 Ramsel
66,Bergstraat 71,2023-01-13,16:00:00,118,92,26,FMN GV 11 Ramsel
66,Bergstraat 71,2023-01-13,17:00:00,56,40,16,FMN GV 11 Ramsel
66,Bergstraat 71,2023-01-13,18:00:00,42,16,26,FMN GV 11 Ramsel
66,Bergstraat 71,2023-01-13,19:00:00,28,12,16,FMN GV 11 Ramsel
66,Bergstraat 71,2023-01-13,20:00:00,40,20,20,FMN GV 11 Ramsel
66,Bergstraat 71,2023-01-13,21:00:00,14,6,8,FMN GV 11 Ramsel
66,Bergstraat 71,2023-01-13,22:00:00,16,8,8,FMN GV 11 Ramsel
66,Bergstraat 71,2023-01-13,23:00:00,12,8,4,FMN GV 11 Ramsel
66,Bergstraat 71,2023-01-14,00:00:00,10,4,6,FMN GV 11 Ramsel
66,Bergstraat 71,2023-01-14,01:00:00,12,10,2,FMN GV 11 Ramsel
66,Bergstraat 71,2023-01-14,02:00:00,6,6,0,FMN GV 11 Ramsel
66,Bergstraat 71,2023-01-14,03:00:00,4,4,0,FMN GV 11 Ramsel
66,Bergstraat 71,2023-01-14,04:00:00,8,8,0,FMN GV 11 Ramsel
66,Bergstraat 71,2023-01-14,05:00:00,0,0,0,FMN GV 11 Ramsel
66,Bergstraat 71,2023-01-14,06:00:00,0,0,0,FMN GV 11 Ramsel
66,Bergstraat 71,2023-01-14,07:00:00,0,0,0,FMN GV 11 Ramsel
66,Bergstraat 71,2023-01-14,08:00:00,14,2,12,FMN GV 11 Ramsel
66,Bergstraat 71,2023-01-14,09:00:00,16,10,6,FMN GV 11 Ramsel
66,Bergstraat 71,2023-01-14,10:00:00,16,10,6,FMN GV 11 Ramsel
66,Bergstraat 71,2023-01-14,11:00:00,6,2,4,FMN GV 11 Ramsel
66,Bergstraat 71,2023-01-14,12:00:00,16,12,4,FMN GV 11 Ramsel
66,Bergstraat 71,2023-01-14,13:00:00,22,6,16,FMN GV 11 Ramsel
66,Bergstraat 71,2023-01-14,14:00:00,8,2,6,FMN GV 11 Ramsel
66,Bergstraat 71,2023-01-14,15:00:00,16,10,6,FMN GV 11 Ramsel
66,Bergstraat 71,2023-01-14,16:00:00,14,8,6,FMN GV 11 Ramsel
66,Bergstraat 71,2023-01-14,17:00:00,10,10,0,FMN GV 11 Ramsel
66,Bergstraat 71,2023-01-14,18:00:00,8,4,4,FMN GV 11 Ramsel
66,Bergstraat 71,2023-01-14,19:00:00,12,4,8,FMN GV 11 Ramsel
66,Bergstraat 71,2023-01-14,20:00:00,4,0,4,FMN GV 11 Ramsel
66,Bergstraat 71,2023-01-14,21:00:00,8,4,4,FMN GV 11 Ramsel
66,Bergstraat 71,2023-01-14,22:00:00,4,2,2,FMN GV 11 Ramsel
66,Bergstraat 71,2023-01-14,23:00:00,8,6,2,FMN GV 11 Ramsel
66,Bergstraat 71,2023-01-15,00:00:00,8,8,0,FMN GV 11 Ramsel
66,Bergstraat 71,2023-01-15,01:00:00,0,0,0,FMN GV 11 Ramsel
66,Bergstraat 71,2023-01-15,02:00:00,4,2,2,FMN GV 11 Ramsel
66,Bergstraat 71,2023-01-15,03:00:00,0,0,0,FMN GV 11 Ramsel
66,Bergstraat 71,2023-01-15,04:00:00,0,0,0,FMN GV 11 Ramsel
66,Bergstraat 71,2023-01-15,05:00:00,0,0,0,FMN GV 11 Ramsel
66,Bergstraat 71,2023-01-15,06:00:00,0,0,0,FMN GV 11 Ramsel
66,Bergstraat 71,2023-01-15,07:00:00,2,0,2,FMN GV 11 Ramsel
66,Bergstraat 71,2023-01-15,08:00:00,52,14,38,FMN GV 11 Ramsel
66,Bergstraat 71,2023-01-15,09:00:00,84,32,52,FMN GV 11 Ramsel
66,Bergstraat 71,2023-01-15,10:00:00,168,86,82,FMN GV 11 Ramsel
66,Bergstraat 71,2023-01-15,11:00:00,132,86,46,FMN GV 11 Ramsel
66,Bergstraat 71,2023-01-15,12:00:00,116,84,32,FMN GV 11 Ramsel
66,Bergstraat 71,2023-01-15,13:00:00,40,24,16,FMN GV 11 Ramsel
66,Bergstraat 71,2023-01-15,14:00:00,22,18,4,FMN GV 11 Ramsel
66,Bergstraat 71,2023-01-15,15:00:00,22,10,12,FMN GV 11 Ramsel
66,Bergstraat 71,2023-01-15,16:00:00,14,10,4,FMN GV 11 Ramsel
66,Bergstraat 71,2023-01-15,17:00:00,10,4,6,FMN GV 11 Ramsel
66,Bergstraat 71,2023-01-15,18:00:00,6,0,6,FMN GV 11 Ramsel
66,Bergstraat 71,2023-01-15,19:00:00,12,6,6,FMN GV 11 Ramsel
66,Bergstraat 71,2023-01-15,20:00:00,2,2,0,FMN GV 11 Ramsel
66,Bergstraat 71,2023-01-15,21:00:00,0,0,0,FMN GV 11 Ramsel
66,Bergstraat 71,2023-01-15,22:00:00,8,6,2,FMN GV 11 Ramsel
66,Bergstraat 71,2023-01-15,23:00:00,2,2,0,FMN GV 11 Ramsel
66,Bergstraat 71,2023-01-16,00:00:00,0,0,0,FMN GV 11 Ramsel
66,Bergstraat 71,2023-01-16,01:00:00,0,0,0,FMN GV 11 Ramsel
66,Bergstraat 71,2023-01-16,02:00:00,2,0,2,FMN GV 11 Ramsel
66,Bergstraat 71,2023-01-16,03:00:00,0,0,0,FMN GV 11 Ramsel
66,Bergstraat 71,2023-01-16,04:00:00,4,4,0,FMN GV 11 Ramsel
66,Bergstraat 71,2023-01-16,05:00:00,20,10,10,FMN GV 11 Ramsel
66,Bergstraat 71,2023-01-16,06:00:00,18,6,12,FMN GV 11 Ramsel
66,Bergstraat 71,2023-01-16,07:00:00,96,8,88,FMN GV 11 Ramsel
66,Bergstraat 71,2023-01-16,08:00:00,70,4,66,FMN GV 11 Ramsel
66,Bergstraat 71,2023-01-16,09:00:00,12,8,4,FMN GV 11 Ramsel
66,Bergstraat 71,2023-01-16,10:00:00,24,14,10,FMN GV 11 Ramsel
66,Bergstraat 71,2023-01-16,11:00:00,12,4,8,FMN GV 11 Ramsel
66,Bergstraat 71,2023-01-16,12:00:00,26,8,18,FMN GV 11 Ramsel
66,Bergstraat 71,2023-01-16,13:00:00,30,26,4,FMN GV 11 Ramsel
66,Bergstraat 71,2023-01-16,14:00:00,26,18,8,FMN GV 11 Ramsel
66,Bergstraat 71,2023-01-16,15:00:00,94,84,10,FMN GV 11 Ramsel
66,Bergstraat 71,2023-01-16,16:00:00,82,72,10,FMN GV 11 Ramsel
66,Bergstraat 71,2023-01-16,17:00:00,36,22,14,FMN GV 11 Ramsel
66,Bergstraat 71,2023-01-16,18:00:00,14,10,4,FMN GV 11 Ramsel
66,Bergstraat 71,2023-01-16,19:00:00,20,10,10,FMN GV 11 Ramsel
66,Bergstraat 71,2023-01-16,20:00:00,10,4,6,FMN GV 11 Ramsel
66,Bergstraat 71,2023-01-16,21:00:00,4,4,0,FMN GV 11 Ramsel
66,Bergstraat 71,2023-01-16,22:00:00,2,2,0,FMN GV 11 Ramsel
66,Bergstraat 71,2023-01-16,23:00:00,0,0,0,FMN GV 11 Ramsel
66,Bergstraat 71,2023-01-17,00:00:00,0,0,0,FMN GV 11 Ramsel
66,Bergstraat 71,2023-01-17,01:00:00,0,0,0,FMN GV 11 Ramsel
66,Bergstraat 71,2023-01-17,02:00:00,2,0,2,FMN GV 11 Ramsel
66,Bergstraat 71,2023-01-17,03:00:00,0,0,0,FMN GV 11 Ramsel
66,Bergstraat 71,2023-01-17,04:00:00,6,6,0,FMN GV 11 Ramsel
66,Bergstraat 71,2023-01-17,05:00:00,14,4,10,FMN GV 11 Ramsel
66,Bergstraat 71,2023-01-17,06:00:00,28,10,18,FMN GV 11 Ramsel
66,Bergstraat 71,2023-01-17,07:00:00,102,8,94,FMN GV 11 Ramsel
66,Bergstraat 71,2023-01-17,08:00:00,96,10,86,FMN GV 11 Ramsel
66,Bergstraat 71,2023-01-17,09:00:00,16,4,12,FMN GV 11 Ramsel
66,Bergstraat 71,2023-01-17,10:00:00,16,8,8,FMN GV 11 Ramsel
66,Bergstraat 71,2023-01-17,11:00:00,30,16,14,FMN GV 11 Ramsel
66,Bergstraat 71,2023-01-17,12:00:00,72,36,36,FMN GV 11 Ramsel
66,Bergstraat 71,2023-01-17,13:00:00,114,52,62,FMN GV 11 Ramsel
66,Bergstraat 71,2023-01-17,14:00:00,108,64,44,FMN GV 11 Ramsel
66,Bergstraat 71,2023-01-17,15:00:00,198,158,40,FMN GV 11 Ramsel
66,Bergstraat 71,2023-01-17,16:00:00,162,136,26,FMN GV 11 Ramsel
66,Bergstraat 71,2023-01-17,17:00:00,70,44,26,FMN GV 11 Ramsel
66,Bergstraat 71,2023-01-17,18:00:00,42,30,12,FMN GV 11 Ramsel
66,Bergstraat 71,2023-01-17,19:00:00,26,16,10,FMN GV 11 Ramsel
66,Bergstraat 71,2023-01-17,20:00:00,20,8,12,FMN GV 11 Ramsel
66,Bergstraat 71,2023-01-17,21:00:00,6,6,0,FMN GV 11 Ramsel
66,Bergstraat 71,2023-01-17,22:00:00,6,2,4,FMN GV 11 Ramsel
66,Bergstraat 71,2023-01-17,23:00:00,0,0,0,FMN GV 11 Ramsel
66,Bergstraat 71,2023-01-18,00:00:00,2,2,0,FMN GV 11 Ramsel
66,Bergstraat 71,2023-01-18,01:00:00,0,0,0,FMN GV 11 Ramsel
66,Bergstraat 71,2023-01-18,02:00:00,0,0,0,FMN GV 11 Ramsel
66,Bergstraat 71,2023-01-18,03:00:00,2,2,0,FMN GV 11 Ramsel
66,Bergstraat 71,2023-01-18,04:00:00,2,2,0,FMN GV 11 Ramsel
66,Bergstraat 71,2023-01-18,05:00:00,8,6,2,FMN GV 11 Ramsel
66,Bergstraat 71,2023-01-18,06:00:00,18,10,8,FMN GV 11 Ramsel
66,Bergstraat 71,2023-01-18,07:00:00,126,18,108,FMN GV 11 Ramsel
66,Bergstraat 71,2023-01-18,08:00:00,104,14,90,FMN GV 11 Ramsel
66,Bergstraat 71,2023-01-18,09:00:00,14,4,10,FMN GV 11 Ramsel
66,Bergstraat 71,2023-01-18,10:00:00,22,10,12,FMN GV 11 Ramsel
66,Bergstraat 71,2023-01-18,11:00:00,54,24,30,FMN GV 11 Ramsel
66,Bergstraat 71,2023-01-18,12:00:00,212,190,22,FMN GV 11 Ramsel
66,Bergstraat 71,2023-01-18,13:00:00,90,44,46,FMN GV 11 Ramsel
66,Bergstraat 71,2023-01-18,14:00:00,124,72,52,FMN GV 11 Ramsel
66,Bergstraat 71,2023-01-18,15:00:00,80,56,24,FMN GV 11 Ramsel
66,Bergstraat 71,2023-01-18,16:00:00,84,62,22,FMN GV 11 Ramsel
66,Bergstraat 71,2023-01-18,17:00:00,60,32,28,FMN GV 11 Ramsel
66,Bergstraat 71,2023-01-18,18:00:00,30,20,10,FMN GV 11 Ramsel
66,Bergstraat 71,2023-01-18,19:00:00,8,6,2,FMN GV 11 Ramsel
66,Bergstraat 71,2023-01-18,20:00:00,16,6,10,FMN GV 11 Ramsel
66,Bergstraat 71,2023-01-18,21:00:00,2,2,0,FMN GV 11 Ramsel
66,Bergstraat 71,2023-01-18,22:00:00,4,2,2,FMN GV 11 Ramsel
66,Bergstraat 71,2023-01-18,23:00:00,0,0,0,FMN GV 11 Ramsel
66,Bergstraat 71,2023-01-19,00:00:00,0,0,0,FMN GV 11 Ramsel
66,Bergstraat 71,2023-01-19,01:00:00,0,0,0,FMN GV 11 Ramsel
66,Bergstraat 71,2023-01-19,02:00:00,0,0,0,FMN GV 11 Ramsel
66,Bergstraat 71,2023-01-19,03:00:00,0,0,0,FMN GV 11 Ramsel
66,Bergstraat 71,2023-01-19,04:00:00,6,6,0,FMN GV 11 Ramsel
66,Bergstraat 71,2023-01-19,05:00:00,10,6,4,FMN GV 11 Ramsel
66,Bergstraat 71,2023-01-19,06:00:00,22,10,12,FMN GV 11 Ramsel
66,Bergstraat 71,2023-01-19,07:00:00,74,18,56,FMN GV 11 Ramsel
66,Bergstraat 71,2023-01-19,08:00:00,92,10,82,FMN GV 11 Ramsel
66,Bergstraat 71,2023-01-19,09:00:00,18,8,10,FMN GV 11 Ramsel
66,Bergstraat 71,2023-01-19,10:00:00,18,10,8,FMN GV 11 Ramsel
66,Bergstraat 71,2023-01-19,11:00:00,26,16,10,FMN GV 11 Ramsel
66,Bergstraat 71,2023-01-19,12:00:00,30,14,16,FMN GV 11 Ramsel
66,Bergstraat 71,2023-01-19,13:00:00,34,22,12,FMN GV 11 Ramsel
66,Bergstraat 71,2023-01-19,14:00:00,50,32,18,FMN GV 11 Ramsel
66,Bergstraat 71,2023-01-19,15:00:00,138,122,16,FMN GV 11 Ramsel
66,Bergstraat 71,2023-01-19,16:00:00,110,102,8,FMN GV 11 Ramsel
66,Bergstraat 71,2023-01-19,17:00:00,54,30,24,FMN GV 11 Ramsel
66,Bergstraat 71,2023-01-19,18:00:00,22,12,10,FMN GV 11 Ramsel
66,Bergstraat 71,2023-01-19,19:00:00,8,4,4,FMN GV 11 Ramsel
66,Bergstraat 71,2023-01-19,20:00:00,6,4,2,FMN GV 11 Ramsel
66,Bergstraat 71,2023-01-19,21:00:00,4,2,2,FMN GV 11 Ramsel
66,Bergstraat 71,2023-01-19,22:00:00,4,4,0,FMN GV 11 Ramsel
66,Bergstraat 71,2023-01-19,23:00:00,0,0,0,FMN GV 11 Ramsel
66,Bergstraat 71,2023-01-20,00:00:00,2,0,2,FMN GV 11 Ramsel
66,Bergstraat 71,2023-01-20,01:00:00,0,0,0,FMN GV 11 Ramsel
66,Bergstraat 71,2023-01-20,02:00:00,2,2,0,FMN GV 11 Ramsel
66,Bergstraat 71,2023-01-20,03:00:00,0,0,0,FMN GV 11 Ramsel
66,Bergstraat 71,2023-01-20,04:00:00,6,6,0,FMN GV 11 Ramsel
66,Bergstraat 71,2023-01-20,05:00:00,16,8,8,FMN GV 11 Ramsel
66,Bergstraat 71,2023-01-20,06:00:00,14,8,6,FMN GV 11 Ramsel
66,Bergstraat 71,2023-01-20,07:00:00,124,20,104,FMN GV 11 Ramsel
66,Bergstraat 71,2023-01-20,08:00:00,134,6,128,FMN GV 11 Ramsel
66,Bergstraat 71,2023-01-20,09:00:00,6,4,2,FMN GV 11 Ramsel
66,Bergstraat 71,2023-01-20,10:00:00,14,10,4,FMN GV 11 Ramsel
66,Bergstraat 71,2023-01-20,11:00:00,8,4,4,FMN GV 11 Ramsel
66,Bergstraat 71,2023-01-20,12:00:00,20,14,6,FMN GV 11 Ramsel
66,Bergstraat 71,2023-01-20,13:00:00,20,10,10,FMN GV 11 Ramsel
66,Bergstraat 71,2023-01-20,14:00:00,30,24,6,FMN GV 11 Ramsel
66,Bergstraat 71,2023-01-20,15:00:00,102,100,2,FMN GV 11 Ramsel
66,Bergstraat 71,2023-01-20,16:00:00,64,60,4,FMN GV 11 Ramsel
66,Bergstraat 71,2023-01-20,17:00:00,38,28,10,FMN GV 11 Ramsel
66,Bergstraat 71,2023-01-20,18:00:00,10,4,6,FMN GV 11 Ramsel
66,Bergstraat 71,2023-01-20,19:00:00,8,6,2,FMN GV 11 Ramsel
66,Bergstraat 71,2023-01-20,20:00:00,6,0,6,FMN GV 11 Ramsel
66,Bergstraat 71,2023-01-20,21:00:00,10,8,2,FMN GV 11 Ramsel
66,Bergstraat 71,2023-01-20,22:00:00,8,4,4,FMN GV 11 Ramsel
66,Bergstraat 71,2023-01-20,23:00:00,4,4,0,FMN GV 11 Ramsel
66,Bergstraat 71,2023-01-21,00:00:00,0,0,0,FMN GV 11 Ramsel
66,Bergstraat 71,2023-01-21,01:00:00,0,0,0,FMN GV 11 Ramsel
66,Bergstraat 71,2023-01-21,02:00:00,4,2,2,FMN GV 11 Ramsel
66,Bergstraat 71,2023-01-21,03:00:00,0,0,0,FMN GV 11 Ramsel
66,Bergstraat 71,2023-01-21,04:00:00,0,0,0,FMN GV 11 Ramsel
66,Bergstraat 71,2023-01-21,05:00:00,0,0,0,FMN GV 11 Ramsel
66,Bergstraat 71,2023-01-21,06:00:00,0,0,0,FMN GV 11 Ramsel
66,Bergstraat 71,2023-01-21,07:00:00,4,0,4,FMN GV 11 Ramsel
66,Bergstraat 71,2023-01-21,08:00:00,8,8,0,FMN GV 11 Ramsel
66,Bergstraat 71,2023-01-21,09:00:00,2,2,0,FMN GV 11 Ramsel
66,Bergstraat 71,2023-01-21,10:00:00,4,0,4,FMN GV 11 Ramsel
66,Bergstraat 71,2023-01-21,11:00:00,10,2,8,FMN GV 11 Ramsel
66,Bergstraat 71,2023-01-21,12:00:00,18,10,8,FMN GV 11 Ramsel
66,Bergstraat 71,2023-01-21,13:00:00,24,12,12,FMN GV 11 Ramsel
66,Bergstraat 71,2023-01-21,14:00:00,22,10,12,FMN GV 11 Ramsel
66,Bergstraat 71,2023-01-21,15:00:00,40,18,22,FMN GV 11 Ramsel
66,Bergstraat 71,2023-01-21,16:00:00,14,6,8,FMN GV 11 Ramsel
66,Bergstraat 71,2023-01-21,17:00:00,18,8,10,FMN GV 11 Ramsel
66,Bergstraat 71,2023-01-21,18:00:00,8,2,6,FMN GV 11 Ramsel
66,Bergstraat 71,2023-01-21,19:00:00,2,0,2,FMN GV 11 Ramsel
66,Bergstraat 71,2023-01-21,20:00:00,2,0,2,FMN GV 11 Ramsel
66,Bergstraat 71,2023-01-21,21:00:00,4,0,4,FMN GV 11 Ramsel
66,Bergstraat 71,2023-01-21,22:00:00,10,2,8,FMN GV 11 Ramsel
66,Bergstraat 71,2023-01-21,23:00:00,0,0,0,FMN GV 11 Ramsel
66,Bergstraat 71,2023-01-22,00:00:00,0,0,0,FMN GV 11 Ramsel
66,Bergstraat 71,2023-01-22,01:00:00,6,6,0,FMN GV 11 Ramsel
66,Bergstraat 71,2023-01-22,02:00:00,0,0,0,FMN GV 11 Ramsel
66,Bergstraat 71,2023-01-22,03:00:00,0,0,0,FMN GV 11 Ramsel
66,Bergstraat 71,2023-01-22,04:00:00,0,0,0,FMN GV 11 Ramsel
66,Bergstraat 71,2023-01-22,05:00:00,6,6,0,FMN GV 11 Ramsel
66,Bergstraat 71,2023-01-22,06:00:00,2,0,2,FMN GV 11 Ramsel
66,Bergstraat 71,2023-01-22,07:00:00,0,0,0,FMN GV 11 Ramsel
66,Bergstraat 71,2023-01-22,08:00:00,14,8,6,FMN GV 11 Ramsel
66,Bergstraat 71,2023-01-22,09:00:00,10,4,6,FMN GV 11 Ramsel
66,Bergstraat 71,2023-01-22,10:00:00,20,6,14,FMN GV 11 Ramsel
66,Bergstraat 71,2023-01-22,11:00:00,30,24,6,FMN GV 11 Ramsel
66,Bergstraat 71,2023-01-22,12:00:00,16,8,8,FMN GV 11 Ramsel
66,Bergstraat 71,2023-01-22,13:00:00,24,10,14,FMN GV 11 Ramsel
66,Bergstraat 71,2023-01-22,14:00:00,26,16,10,FMN GV 11 Ramsel
66,Bergstraat 71,2023-01-22,15:00:00,18,8,10,FMN GV 11 Ramsel
66,Bergstraat 71,2023-01-22,16:00:00,4,4,0,FMN GV 11 Ramsel
66,Bergstraat 71,2023-01-22,17:00:00,4,0,4,FMN GV 11 Ramsel
66,Bergstraat 71,2023-01-22,18:00:00,6,6,0,FMN GV 11 Ramsel
66,Bergstraat 71,2023-01-22,19:00:00,6,6,0,FMN GV 11 Ramsel
66,Bergstraat 71,2023-01-22,20:00:00,2,2,0,FMN GV 11 Ramsel
66,Bergstraat 71,2023-01-22,21:00:00,2,2,0,FMN GV 11 Ramsel
66,Bergstraat 71,2023-01-22,22:00:00,2,0,2,FMN GV 11 Ramsel
66,Bergstraat 71,2023-01-22,23:00:00,0,0,0,FMN GV 11 Ramsel
66,Bergstraat 71,2023-01-23,00:00:00,0,0,0,FMN GV 11 Ramsel
66,Bergstraat 71,2023-01-23,01:00:00,2,0,2,FMN GV 11 Ramsel
66,Bergstraat 71,2023-01-23,02:00:00,0,0,0,FMN GV 11 Ramsel
66,Bergstraat 71,2023-01-23,03:00:00,0,0,0,FMN GV 11 Ramsel
66,Bergstraat 71,2023-01-23,04:00:00,4,4,0,FMN GV 11 Ramsel
66,Bergstraat 71,2023-01-23,05:00:00,6,4,2,FMN GV 11 Ramsel
66,Bergstraat 71,2023-01-23,06:00:00,26,12,14,FMN GV 11 Ramsel
66,Bergstraat 71,2023-01-23,07:00:00,160,14,146,FMN GV 11 Ramsel
66,Bergstraat 71,2023-01-23,08:00:00,110,6,104,FMN GV 11 Ramsel
66,Bergstraat 71,2023-01-23,09:00:00,28,12,16,FMN GV 11 Ramsel
66,Bergstraat 71,2023-01-23,10:00:00,18,12,6,FMN GV 11 Ramsel
66,Bergstraat 71,2023-01-23,11:00:00,22,14,8,FMN GV 11 Ramsel
66,Bergstraat 71,2023-01-23,12:00:00,40,20,20,FMN GV 11 Ramsel
66,Bergstraat 71,2023-01-23,13:00:00,58,36,22,FMN GV 11 Ramsel
66,Bergstraat 71,2023-01-23,14:00:00,72,52,20,FMN GV 11 Ramsel
66,Bergstraat 71,2023-01-23,15:00:00,132,118,14,FMN GV 11 Ramsel
66,Bergstraat 71,2023-01-23,16:00:00,128,114,14,FMN GV 11 Ramsel
66,Bergstraat 71,2023-01-23,17:00:00,50,26,24,FMN GV 11 Ramsel
66,Bergstraat 71,2023-01-23,18:00:00,32,18,14,FMN GV 11 Ramsel
66,Bergstraat 71,2023-01-23,19:00:00,30,14,16,FMN GV 11 Ramsel
66,Bergstraat 71,2023-01-23,20:00:00,12,6,6,FMN GV 11 Ramsel
66,Bergstraat 71,2023-01-23,21:00:00,10,6,4,FMN GV 11 Ramsel
66,Bergstraat 71,2023-01-23,22:00:00,10,4,6,FMN GV 11 Ramsel
66,Bergstraat 71,2023-01-23,23:00:00,4,2,2,FMN GV 11 Ramsel
66,Bergstraat 71,2023-01-24,00:00:00,2,2,0,FMN GV 11 Ramsel
66,Bergstraat 71,2023-01-24,01:00:00,0,0,0,FMN GV 11 Ramsel
66,Bergstraat 71,2023-01-24,02:00:00,0,0,0,FMN GV 11 Ramsel
66,Bergstraat 71,2023-01-24,03:00:00,0,0,0,FMN GV 11 Ramsel
66,Bergstraat 71,2023-01-24,04:00:00,4,4,0,FMN GV 11 Ramsel
66,Bergstraat 71,2023-01-24,05:00:00,8,4,4,FMN GV 11 Ramsel
66,Bergstraat 71,2023-01-24,06:00:00,26,8,18,FMN GV 11 Ramsel
66,Bergstraat 71,2023-01-24,07:00:00,170,26,144,FMN GV 11 Ramsel
66,Bergstraat 71,2023-01-24,08:00:00,168,8,160,FMN GV 11 Ramsel
66,Bergstraat 71,2023-01-24,09:00:00,42,6,36,FMN GV 11 Ramsel
66,Bergstraat 71,2023-01-24,10:00:00,30,18,12,FMN GV 11 Ramsel
66,Bergstraat 71,2023-01-24,11:00:00,32,22,10,FMN GV 11 Ramsel
66,Bergstraat 71,2023-01-24,12:00:00,46,22,24,FMN GV 11 Ramsel
66,Bergstraat 71,2023-01-24,13:00:00,70,46,24,FMN GV 11 Ramsel
66,Bergstraat 71,2023-01-24,14:00:00,108,96,12,FMN GV 11 Ramsel
66,Bergstraat 71,2023-01-24,15:00:00,198,174,24,FMN GV 11 Ramsel
66,Bergstraat 71,2023-01-24,16:00:00,104,80,24,FMN GV 11 Ramsel
66,Bergstraat 71,2023-01-24,17:00:00,62,42,20,FMN GV 11 Ramsel
66,Bergstraat 71,2023-01-24,18:00:00,60,36,24,FMN GV 11 Ramsel
66,Bergstraat 71,2023-01-24,19:00:00,40,20,20,FMN GV 11 Ramsel
66,Bergstraat 71,2023-01-24,20:00:00,32,20,12,FMN GV 11 Ramsel
66,Bergstraat 71,2023-01-24,21:00:00,30,22,8,FMN GV 11 Ramsel
66,Bergstraat 71,2023-01-24,22:00:00,10,6,4,FMN GV 11 Ramsel
66,Bergstraat 71,2023-01-24,23:00:00,2,2,0,FMN GV 11 Ramsel
66,Bergstraat 71,2023-01-25,00:00:00,0,0,0,FMN GV 11 Ramsel
66,Bergstraat 71,2023-01-25,01:00:00,2,2,0,FMN GV 11 Ramsel
66,Bergstraat 71,2023-01-25,02:00:00,0,0,0,FMN GV 11 Ramsel
66,Bergstraat 71,2023-01-25,03:00:00,0,0,0,FMN GV 11 Ramsel
66,Bergstraat 71,2023-01-25,04:00:00,2,2,0,FMN GV 11 Ramsel
66,Bergstraat 71,2023-01-25,05:00:00,8,2,6,FMN GV 11 Ramsel
66,Bergstraat 71,2023-01-25,06:00:00,18,6,12,FMN GV 11 Ramsel
66,Bergstraat 71,2023-01-25,07:00:00,172,24,148,FMN GV 11 Ramsel
66,Bergstraat 71,2023-01-25,08:00:00,152,6,146,FMN GV 11 Ramsel
66,Bergstraat 71,2023-01-25,09:00:00,18,12,6,FMN GV 11 Ramsel
66,Bergstraat 71,2023-01-25,10:00:00,26,16,10,FMN GV 11 Ramsel
66,Bergstraat 71,2023-01-25,11:00:00,46,34,12,FMN GV 11 Ramsel
66,Bergstraat 71,2023-01-25,12:00:00,274,240,34,FMN GV 11 Ramsel
66,Bergstraat 71,2023-01-25,13:00:00,56,28,28,FMN GV 11 Ramsel
66,Bergstraat 71,2023-01-25,14:00:00,58,34,24,FMN GV 11 Ramsel
66,Bergstraat 71,2023-01-25,15:00:00,54,42,12,FMN GV 11 Ramsel
66,Bergstraat 71,2023-01-25,16:00:00,60,40,20,FMN GV 11 Ramsel
66,Bergstraat 71,2023-01-25,17:00:00,46,32,14,FMN GV 11 Ramsel
66,Bergstraat 71,2023-01-25,18:00:00,36,24,12,FMN GV 11 Ramsel
66,Bergstraat 71,2023-01-25,19:00:00,16,10,6,FMN GV 11 Ramsel
66,Bergstraat 71,2023-01-25,20:00:00,20,8,12,FMN GV 11 Ramsel
66,Bergstraat 71,2023-01-25,21:00:00,10,6,4,FMN GV 11 Ramsel
66,Bergstraat 71,2023-01-25,22:00:00,16,10,6,FMN GV 11 Ramsel
66,Bergstraat 71,2023-01-25,23:00:00,2,2,0,FMN GV 11 Ramsel
66,Bergstraat 71,2023-01-26,00:00:00,4,4,0,FMN GV 11 Ramsel
66,Bergstraat 71,2023-01-26,01:00:00,0,0,0,FMN GV 11 Ramsel
66,Bergstraat 71,2023-01-26,02:00:00,0,0,0,FMN GV 11 Ramsel
66,Bergstraat 71,2023-01-26,03:00:00,0,0,0,FMN GV 11 Ramsel
66,Bergstraat 71,2023-01-26,04:00:00,4,4,0,FMN GV 11 Ramsel
66,Bergstraat 71,2023-01-26,05:00:00,10,4,6,FMN GV 11 Ramsel
66,Bergstraat 71,2023-01-26,06:00:00,20,10,10,FMN GV 11 Ramsel
66,Bergstraat 71,2023-01-26,07:00:00,126,18,108,FMN GV 11 Ramsel
66,Bergstraat 71,2023-01-26,08:00:00,126,8,118,FMN GV 11 Ramsel
66,Bergstraat 71,2023-01-26,09:00:00,20,6,14,FMN GV 11 Ramsel
66,Bergstraat 71,2023-01-26,10:00:00,6,2,4,FMN GV 11 Ramsel
66,Bergstraat 71,2023-01-26,11:00:00,10,4,6,FMN GV 11 Ramsel
66,Bergstraat 71,2023-01-26,12:00:00,28,16,12,FMN GV 11 Ramsel
66,Bergstraat 71,2023-01-26,13:00:00,32,12,20,FMN GV 11 Ramsel
66,Bergstraat 71,2023-01-26,14:00:00,46,36,10,FMN GV 11 Ramsel
66,Bergstraat 71,2023-01-26,15:00:00,152,126,26,FMN GV 11 Ramsel
66,Bergstraat 71,2023-01-26,16:00:00,114,98,16,FMN GV 11 Ramsel
66,Bergstraat 71,2023-01-26,17:00:00,76,50,26,FMN GV 11 Ramsel
66,Bergstraat 71,2023-01-26,18:00:00,20,10,10,FMN GV 11 Ramsel
66,Bergstraat 71,2023-01-26,19:00:00,24,12,12,FMN GV 11 Ramsel
66,Bergstraat 71,2023-01-26,20:00:00,24,10,14,FMN GV 11 Ramsel
66,Bergstraat 71,2023-01-26,21:00:00,8,4,4,FMN GV 11 Ramsel
66,Bergstraat 71,2023-01-26,22:00:00,8,6,2,FMN GV 11 Ramsel
66,Bergstraat 71,2023-01-26,23:00:00,2,0,2,FMN GV 11 Ramsel
66,Bergstraat 71,2023-01-27,00:00:00,6,6,0,FMN GV 11 Ramsel
66,Bergstraat 71,2023-01-27,01:00:00,0,0,0,FMN GV 11 Ramsel
66,Bergstraat 71,2023-01-27,02:00:00,0,0,0,FMN GV 11 Ramsel
66,Bergstraat 71,2023-01-27,03:00:00,0,0,0,FMN GV 11 Ramsel
66,Bergstraat 71,2023-01-27,04:00:00,4,4,0,FMN GV 11 Ramsel
66,Bergstraat 71,2023-01-27,05:00:00,8,6,2,FMN GV 11 Ramsel
66,Bergstraat 71,2023-01-27,06:00:00,24,14,10,FMN GV 11 Ramsel
66,Bergstraat 71,2023-01-27,07:00:00,130,8,122,FMN GV 11 Ramsel
66,Bergstraat 71,2023-01-27,08:00:00,136,22,114,FMN GV 11 Ramsel
66,Bergstraat 71,2023-01-27,09:00:00,58,10,48,FMN GV 11 Ramsel
66,Bergstraat 71,2023-01-27,10:00:00,20,10,10,FMN GV 11 Ramsel
66,Bergstraat 71,2023-01-27,11:00:00,46,24,22,FMN GV 11 Ramsel
66,Bergstraat 71,2023-01-27,12:00:00,58,40,18,FMN GV 11 Ramsel
66,Bergstraat 71,2023-01-27,13:00:00,54,36,18,FMN GV 11 Ramsel
66,Bergstraat 71,2023-01-27,14:00:00,58,28,30,FMN GV 11 Ramsel
66,Bergstraat 71,2023-01-27,15:00:00,168,144,24,FMN GV 11 Ramsel
66,Bergstraat 71,2023-01-27,16:00:00,82,66,16,FMN GV 11 Ramsel
66,Bergstraat 71,2023-01-27,17:00:00,58,32,26,FMN GV 11 Ramsel
66,Bergstraat 71,2023-01-27,18:00:00,42,22,20,FMN GV 11 Ramsel
66,Bergstraat 71,2023-01-27,19:00:00,22,12,10,FMN GV 11 Ramsel
66,Bergstraat 71,2023-01-27,20:00:00,24,10,14,FMN GV 11 Ramsel
66,Bergstraat 71,2023-01-27,21:00:00,8,6,2,FMN GV 11 Ramsel
66,Bergstraat 71,2023-01-27,22:00:00,8,8,0,FMN GV 11 Ramsel
66,Bergstraat 71,2023-01-27,23:00:00,16,4,12,FMN GV 11 Ramsel
66,Bergstraat 71,2023-01-28,00:00:00,10,8,2,FMN GV 11 Ramsel
66,Bergstraat 71,2023-01-28,01:00:00,8,8,0,FMN GV 11 Ramsel
66,Bergstraat 71,2023-01-28,02:00:00,6,6,0,FMN GV 11 Ramsel
66,Bergstraat 71,2023-01-28,03:00:00,0,0,0,FMN GV 11 Ramsel
66,Bergstraat 71,2023-01-28,04:00:00,4,4,0,FMN GV 11 Ramsel
66,Bergstraat 71,2023-01-28,05:00:00,0,0,0,FMN GV 11 Ramsel
66,Bergstraat 71,2023-01-28,06:00:00,2,2,0,FMN GV 11 Ramsel
66,Bergstraat 71,2023-01-28,07:00:00,10,4,6,FMN GV 11 Ramsel
66,Bergstraat 71,2023-01-28,08:00:00,26,14,12,FMN GV 11 Ramsel
66,Bergstraat 71,2023-01-28,09:00:00,38,16,22,FMN GV 11 Ramsel
66,Bergstraat 71,2023-01-28,10:00:00,46,24,22,FMN GV 11 Ramsel
66,Bergstraat 71,2023-01-28,11:00:00,66,34,32,FMN GV 11 Ramsel
66,Bergstraat 71,2023-01-28,12:00:00,84,28,56,FMN GV 11 Ramsel
66,Bergstraat 71,2023-01-28,13:00:00,110,54,56,FMN GV 11 Ramsel
66,Bergstraat 71,2023-01-28,14:00:00,112,58,54,FMN GV 11 Ramsel
66,Bergstraat 71,2023-01-28,15:00:00,90,58,32,FMN GV 11 Ramsel
66,Bergstraat 71,2023-01-28,16:00:00,42,24,18,FMN GV 11 Ramsel
66,Bergstraat 71,2023-01-28,17:00:00,38,20,18,FMN GV 11 Ramsel
66,Bergstraat 71,2023-01-28,18:00:00,28,8,20,FMN GV 11 Ramsel
66,Bergstraat 71,2023-01-28,19:00:00,18,4,14,FMN GV 11 Ramsel
66,Bergstraat 71,2023-01-28,20:00:00,12,2,10,FMN GV 11 Ramsel
66,Bergstraat 71,2023-01-28,21:00:00,14,14,0,FMN GV 11 Ramsel
66,Bergstraat 71,2023-01-28,22:00:00,22,8,14,FMN GV 11 Ramsel
66,Bergstraat 71,2023-01-28,23:00:00,24,18,6,FMN GV 11 Ramsel
66,Bergstraat 71,2023-01-29,00:00:00,2,2,0,FMN GV 11 Ramsel
66,Bergstraat 71,2023-01-29,01:00:00,0,0,0,FMN GV 11 Ramsel
66,Bergstraat 71,2023-01-29,02:00:00,2,2,0,FMN GV 11 Ramsel
66,Bergstraat 71,2023-01-29,03:00:00,2,2,0,FMN GV 11 Ramsel
66,Bergstraat 71,2023-01-29,04:00:00,2,2,0,FMN GV 11 Ramsel
66,Bergstraat 71,2023-01-29,05:00:00,0,0,0,FMN GV 11 Ramsel
66,Bergstraat 71,2023-01-29,06:00:00,0,0,0,FMN GV 11 Ramsel
66,Bergstraat 71,2023-01-29,07:00:00,0,0,0,FMN GV 11 Ramsel
66,Bergstraat 71,2023-01-29,08:00:00,18,8,10,FMN GV 11 Ramsel
66,Bergstraat 71,2023-01-29,09:00:00,40,14,26,FMN GV 11 Ramsel
66,Bergstraat 71,2023-01-29,10:00:00,52,24,28,FMN GV 11 Ramsel
66,Bergstraat 71,2023-01-29,11:00:00,94,60,34,FMN GV 11 Ramsel
66,Bergstraat 71,2023-01-29,12:00:00,60,46,14,FMN GV 11 Ramsel
66,Bergstraat 71,2023-01-29,13:00:00,72,28,44,FMN GV 11 Ramsel
66,Bergstraat 71,2023-01-29,14:00:00,54,24,30,FMN GV 11 Ramsel
66,Bergstraat 71,2023-01-29,15:00:00,48,38,10,FMN GV 11 Ramsel
66,Bergstraat 71,2023-01-29,16:00:00,40,22,18,FMN GV 11 Ramsel
66,Bergstraat 71,2023-01-29,17:00:00,20,6,14,FMN GV 11 Ramsel
66,Bergstraat 71,2023-01-29,18:00:00,6,6,0,FMN GV 11 Ramsel
66,Bergstraat 71,2023-01-29,19:00:00,16,6,10,FMN GV 11 Ramsel
66,Bergstraat 71,2023-01-29,20:00:00,0,0,0,FMN GV 11 Ramsel
66,Bergstraat 71,2023-01-29,21:00:00,6,0,6,FMN GV 11 Ramsel
66,Bergstraat 71,2023-01-29,22:00:00,2,0,2,FMN GV 11 Ramsel
66,Bergstraat 71,2023-01-29,23:00:00,2,2,0,FMN GV 11 Ramsel
66,Bergstraat 71,2023-01-30,00:00:00,0,0,0,FMN GV 11 Ramsel
66,Bergstraat 71,2023-01-30,01:00:00,0,0,0,FMN GV 11 Ramsel
66,Bergstraat 71,2023-01-30,02:00:00,2,2,0,FMN GV 11 Ramsel
66,Bergstraat 71,2023-01-30,03:00:00,2,0,2,FMN GV 11 Ramsel
66,Bergstraat 71,2023-01-30,04:00:00,4,4,0,FMN GV 11 Ramsel
66,Bergstraat 71,2023-01-30,05:00:00,14,6,8,FMN GV 11 Ramsel
66,Bergstraat 71,2023-01-30,06:00:00,30,10,20,FMN GV 11 Ramsel
66,Bergstraat 71,2023-01-30,07:00:00,124,22,102,FMN GV 11 Ramsel
66,Bergstraat 71,2023-01-30,08:00:00,112,10,102,FMN GV 11 Ramsel
66,Bergstraat 71,2023-01-30,09:00:00,52,16,36,FMN GV 11 Ramsel
66,Bergstraat 71,2023-01-30,10:00:00,58,20,38,FMN GV 11 Ramsel
66,Bergstraat 71,2023-01-30,11:00:00,54,26,28,FMN GV 11 Ramsel
66,Bergstraat 71,2023-01-30,12:00:00,82,40,42,FMN GV 11 Ramsel
66,Bergstraat 71,2023-01-30,13:00:00,94,56,38,FMN GV 11 Ramsel
66,Bergstraat 71,2023-01-30,14:00:00,68,42,26,FMN GV 11 Ramsel
66,Bergstraat 71,2023-01-30,15:00:00,142,116,26,FMN GV 11 Ramsel
66,Bergstraat 71,2023-01-30,16:00:00,132,108,24,FMN GV 11 Ramsel
66,Bergstraat 71,2023-01-30,17:00:00,68,44,24,FMN GV 11 Ramsel
66,Bergstraat 71,2023-01-30,18:00:00,22,10,12,FMN GV 11 Ramsel
66,Bergstraat 71,2023-01-30,19:00:00,32,18,14,FMN GV 11 Ramsel
66,Bergstraat 71,2023-01-30,20:00:00,14,8,6,FMN GV 11 Ramsel
66,Bergstraat 71,2023-01-30,21:00:00,16,16,0,FMN GV 11 Ramsel
66,Bergstraat 71,2023-01-30,22:00:00,8,4,4,FMN GV 11 Ramsel
66,Bergstraat 71,2023-01-30,23:00:00,2,2,0,FMN GV 11 Ramsel
66,Bergstraat 71,2023-01-31,00:00:00,4,2,2,FMN GV 11 Ramsel
66,Bergstraat 71,2023-01-31,01:00:00,0,0,0,FMN GV 11 Ramsel
66,Bergstraat 71,2023-01-31,02:00:00,0,0,0,FMN GV 11 Ramsel
66,Bergstraat 71,2023-01-31,03:00:00,0,0,0,FMN GV 11 Ramsel
66,Bergstraat 71,2023-01-31,04:00:00,4,4,0,FMN GV 11 Ramsel
66,Bergstraat 71,2023-01-31,05:00:00,20,12,8,FMN GV 11 Ramsel
66,Bergstraat 71,2023-01-31,06:00:00,26,8,18,FMN GV 11 Ramsel
66,Bergstraat 71,2023-01-31,07:00:00,174,24,150,FMN GV 11 Ramsel
66,Bergstraat 71,2023-01-31,08:00:00,162,14,148,FMN GV 11 Ramsel
66,Bergstraat 71,2023-01-31,09:00:00,48,16,32,FMN GV 11 Ramsel
66,Bergstraat 71,2023-01-31,10:00:00,46,24,22,FMN GV 11 Ramsel
66,Bergstraat 71,2023-01-31,11:00:00,40,22,18,FMN GV 11 Ramsel
66,Bergstraat 71,2023-01-31,12:00:00,76,38,38,FMN GV 11 Ramsel
66,Bergstraat 71,2023-01-31,13:00:00,110,30,80,FMN GV 11 Ramsel
66,Bergstraat 71,2023-01-31,14:00:00,90,70,20,FMN GV 11 Ramsel
66,Bergstraat 71,2023-01-31,15:00:00,174,156,18,FMN GV 11 Ramsel
66,Bergstraat 71,2023-01-31,16:00:00,190,148,42,FMN GV 11 Ramsel
66,Bergstraat 71,2023-01-31,17:00:00,98,58,40,FMN GV 11 Ramsel
66,Bergstraat 71,2023-01-31,18:00:00,32,14,18,FMN GV 11 Ramsel
66,Bergstraat 71,2023-01-31,19:00:00,38,8,30,FMN GV 11 Ramsel
66,Bergstraat 71,2023-01-31,20:00:00,20,12,8,FMN GV 11 Ramsel
66,Bergstraat 71,2023-01-31,21:00:00,18,18,0,FMN GV 11 Ramsel
66,Bergstraat 71,2023-01-31,22:00:00,14,12,2,FMN GV 11 Ramsel
66,Bergstraat 71,2023-01-31,23:00:00,4,2,2,FMN GV 11 Ramsel
66,Bergstraat 71,2023-02-01,00:00:00,6,6,0,FMN GV 11 Ramsel
66,Bergstraat 71,2023-02-01,01:00:00,4,4,0,FMN GV 11 Ramsel
66,Bergstraat 71,2023-02-01,02:00:00,0,0,0,FMN GV 11 Ramsel
66,Bergstraat 71,2023-02-01,03:00:00,0,0,0,FMN GV 11 Ramsel
66,Bergstraat 71,2023-02-01,04:00:00,8,6,2,FMN GV 11 Ramsel
66,Bergstraat 71,2023-02-01,05:00:00,14,6,8,FMN GV 11 Ramsel
66,Bergstraat 71,2023-02-01,06:00:00,28,14,14,FMN GV 11 Ramsel
66,Bergstraat 71,2023-02-01,07:00:00,174,22,152,FMN GV 11 Ramsel
66,Bergstraat 71,2023-02-01,08:00:00,152,14,138,FMN GV 11 Ramsel
66,Bergstraat 71,2023-02-01,09:00:00,58,30,28,FMN GV 11 Ramsel
66,Bergstraat 71,2023-02-01,10:00:00,48,34,14,FMN GV 11 Ramsel
66,Bergstraat 71,2023-02-01,11:00:00,96,52,44,FMN GV 11 Ramsel
66,Bergstraat 71,2023-02-01,12:00:00,266,232,34,FMN GV 11 Ramsel
66,Bergstraat 71,2023-02-01,13:00:00,128,72,56,FMN GV 11 Ramsel
66,Bergstraat 71,2023-02-01,14:00:00,122,74,48,FMN GV 11 Ramsel
66,Bergstraat 71,2023-02-01,15:00:00,90,60,30,FMN GV 11 Ramsel
66,Bergstraat 71,2023-02-01,16:00:00,60,36,24,FMN GV 11 Ramsel
66,Bergstraat 71,2023-02-01,17:00:00,76,44,32,FMN GV 11 Ramsel
66,Bergstraat 71,2023-02-01,18:00:00,44,24,20,FMN GV 11 Ramsel
66,Bergstraat 71,2023-02-01,19:00:00,28,18,10,FMN GV 11 Ramsel
66,Bergstraat 71,2023-02-01,20:00:00,8,6,2,FMN GV 11 Ramsel
66,Bergstraat 71,2023-02-01,21:00:00,6,4,2,FMN GV 11 Ramsel
66,Bergstraat 71,2023-02-01,22:00:00,16,12,4,FMN GV 11 Ramsel
66,Bergstraat 71,2023-02-01,23:00:00,0,0,0,FMN GV 11 Ramsel
66,Bergstraat 71,2023-02-02,00:00:00,0,0,0,FMN GV 11 Ramsel
66,Bergstraat 71,2023-02-02,01:00:00,0,0,0,FMN GV 11 Ramsel
66,Bergstraat 71,2023-02-02,02:00:00,0,0,0,FMN GV 11 Ramsel
66,Bergstraat 71,2023-02-02,03:00:00,0,0,0,FMN GV 11 Ramsel
66,Bergstraat 71,2023-02-02,04:00:00,6,6,0,FMN GV 11 Ramsel
66,Bergstraat 71,2023-02-02,05:00:00,14,8,6,FMN GV 11 Ramsel
66,Bergstraat 71,2023-02-02,06:00:00,38,10,28,FMN GV 11 Ramsel
66,Bergstraat 71,2023-02-02,07:00:00,172,18,154,FMN GV 11 Ramsel
66,Bergstraat 71,2023-02-02,08:00:00,230,22,208,FMN GV 11 Ramsel
66,Bergstraat 71,2023-02-02,09:00:00,42,2,40,FMN GV 11 Ramsel
66,Bergstraat 71,2023-02-02,10:00:00,42,26,16,FMN GV 11 Ramsel
66,Bergstraat 71,2023-02-02,11:00:00,94,78,16,FMN GV 11 Ramsel
66,Bergstraat 71,2023-02-02,12:00:00,32,20,12,FMN GV 11 Ramsel
66,Bergstraat 71,2023-02-02,13:00:00,76,38,38,FMN GV 11 Ramsel
66,Bergstraat 71,2023-02-02,14:00:00,82,50,32,FMN GV 11 Ramsel
66,Bergstraat 71,2023-02-02,15:00:00,222,172,50,FMN GV 11 Ramsel
66,Bergstraat 71,2023-02-02,16:00:00,138,118,20,FMN GV 11 Ramsel
66,Bergstraat 71,2023-02-02,17:00:00,64,44,20,FMN GV 11 Ramsel
66,Bergstraat 71,2023-02-02,18:00:00,58,36,22,FMN GV 11 Ramsel
66,Bergstraat 71,2023-02-02,19:00:00,30,16,14,FMN GV 11 Ramsel
66,Bergstraat 71,2023-02-02,20:00:00,20,8,12,FMN GV 11 Ramsel
66,Bergstraat 71,2023-02-02,21:00:00,12,8,4,FMN GV 11 Ramsel
66,Bergstraat 71,2023-02-02,22:00:00,12,10,2,FMN GV 11 Ramsel
66,Bergstraat 71,2023-02-02,23:00:00,8,4,4,FMN GV 11 Ramsel
66,Bergstraat 71,2023-02-03,00:00:00,10,8,2,FMN GV 11 Ramsel
66,Bergstraat 71,2023-02-03,01:00:00,0,0,0,FMN GV 11 Ramsel
66,Bergstraat 71,2023-02-03,02:00:00,8,0,8,FMN GV 11 Ramsel
66,Bergstraat 71,2023-02-03,03:00:00,0,0,0,FMN GV 11 Ramsel
66,Bergstraat 71,2023-02-03,04:00:00,10,6,4,FMN GV 11 Ramsel
66,Bergstraat 71,2023-02-03,05:00:00,20,14,6,FMN GV 11 Ramsel
66,Bergstraat 71,2023-02-03,06:00:00,30,14,16,FMN GV 11 Ramsel
66,Bergstraat 71,2023-02-03,07:00:00,94,24,70,FMN GV 11 Ramsel
66,Bergstraat 71,2023-02-03,08:00:00,120,12,108,FMN GV 11 Ramsel
66,Bergstraat 71,2023-02-03,09:00:00,36,6,30,FMN GV 11 Ramsel
66,Bergstraat 71,2023-02-03,10:00:00,52,32,20,FMN GV 11 Ramsel
66,Bergstraat 71,2023-02-03,11:00:00,88,46,42,FMN GV 11 Ramsel
66,Bergstraat 71,2023-02-03,12:00:00,60,38,22,FMN GV 11 Ramsel
66,Bergstraat 71,2023-02-03,13:00:00,38,22,16,FMN GV 11 Ramsel
66,Bergstraat 71,2023-02-03,14:00:00,72,40,32,FMN GV 11 Ramsel
66,Bergstraat 71,2023-02-03,15:00:00,112,78,34,FMN GV 11 Ramsel
66,Bergstraat 71,2023-02-03,16:00:00,98,66,32,FMN GV 11 Ramsel
66,Bergstraat 71,2023-02-03,17:00:00,66,48,18,FMN GV 11 Ramsel
66,Bergstraat 71,2023-02-03,18:00:00,46,30,16,FMN GV 11 Ramsel
66,Bergstraat 71,2023-02-03,19:00:00,30,6,24,FMN GV 11 Ramsel
66,Bergstraat 71,2023-02-03,20:00:00,8,0,8,FMN GV 11 Ramsel
66,Bergstraat 71,2023-02-03,21:00:00,16,10,6,FMN GV 11 Ramsel
66,Bergstraat 71,2023-02-03,22:00:00,8,2,6,FMN GV 11 Ramsel
66,Bergstraat 71,2023-02-03,23:00:00,6,6,0,FMN GV 11 Ramsel
66,Bergstraat 71,2023-02-04,00:00:00,2,2,0,FMN GV 11 Ramsel
66,Bergstraat 71,2023-02-04,01:00:00,0,0,0,FMN GV 11 Ramsel
66,Bergstraat 71,2023-02-04,02:00:00,2,2,0,FMN GV 11 Ramsel
66,Bergstraat 71,2023-02-04,03:00:00,6,4,2,FMN GV 11 Ramsel
66,Bergstraat 71,2023-02-04,04:00:00,6,6,0,FMN GV 11 Ramsel
66,Bergstraat 71,2023-02-04,05:00:00,2,0,2,FMN GV 11 Ramsel
66,Bergstraat 71,2023-02-04,06:00:00,4,4,0,FMN GV 11 Ramsel
66,Bergstraat 71,2023-02-04,07:00:00,6,6,0,FMN GV 11 Ramsel
66,Bergstraat 71,2023-02-04,08:00:00,20,8,12,FMN GV 11 Ramsel
66,Bergstraat 71,2023-02-04,09:00:00,50,20,30,FMN GV 11 Ramsel
66,Bergstraat 71,2023-02-04,10:00:00,46,22,24,FMN GV 11 Ramsel
66,Bergstraat 71,2023-02-04,11:00:00,64,22,42,FMN GV 11 Ramsel
66,Bergstraat 71,2023-02-04,12:00:00,50,20,30,FMN GV 11 Ramsel
66,Bergstraat 71,2023-02-04,13:00:00,36,22,14,FMN GV 11 Ramsel
66,Bergstraat 71,2023-02-04,14:00:00,42,22,20,FMN GV 11 Ramsel
66,Bergstraat 71,2023-02-04,15:00:00,22,10,12,FMN GV 11 Ramsel
66,Bergstraat 71,2023-02-04,16:00:00,36,12,24,FMN GV 11 Ramsel
66,Bergstraat 71,2023-02-04,17:00:00,32,18,14,FMN GV 11 Ramsel
66,Bergstraat 71,2023-02-04,18:00:00,10,2,8,FMN GV 11 Ramsel
66,Bergstraat 71,2023-02-04,19:00:00,14,8,6,FMN GV 11 Ramsel
66,Bergstraat 71,2023-02-04,20:00:00,16,2,14,FMN GV 11 Ramsel
66,Bergstraat 71,2023-02-04,21:00:00,12,4,8,FMN GV 11 Ramsel
66,Bergstraat 71,2023-02-04,22:00:00,8,4,4,FMN GV 11 Ramsel
66,Bergstraat 71,2023-02-04,23:00:00,2,2,0,FMN GV 11 Ramsel
66,Bergstraat 71,2023-02-05,00:00:00,2,2,0,FMN GV 11 Ramsel
66,Bergstraat 71,2023-02-05,01:00:00,2,2,0,FMN GV 11 Ramsel
66,Bergstraat 71,2023-02-05,02:00:00,2,2,0,FMN GV 11 Ramsel
66,Bergstraat 71,2023-02-05,03:00:00,0,0,0,FMN GV 11 Ramsel
66,Bergstraat 71,2023-02-05,04:00:00,6,6,0,FMN GV 11 Ramsel
66,Bergstraat 71,2023-02-05,05:00:00,6,6,0,FMN GV 11 Ramsel
66,Bergstraat 71,2023-02-05,06:00:00,0,0,0,FMN GV 11 Ramsel
66,Bergstraat 71,2023-02-05,07:00:00,2,0,2,FMN GV 11 Ramsel
66,Bergstraat 71,2023-02-05,08:00:00,20,6,14,FMN GV 11 Ramsel
66,Bergstraat 71,2023-02-05,09:00:00,72,28,44,FMN GV 11 Ramsel
66,Bergstraat 71,2023-02-05,10:00:00,94,44,50,FMN GV 11 Ramsel
66,Bergstraat 71,2023-02-05,11:00:00,104,50,54,FMN GV 11 Ramsel
66,Bergstraat 71,2023-02-05,12:00:00,114,60,54,FMN GV 11 Ramsel
66,Bergstraat 71,2023-02-05,13:00:00,56,28,28,FMN GV 11 Ramsel
66,Bergstraat 71,2023-02-05,14:00:00,72,34,38,FMN GV 11 Ramsel
66,Bergstraat 71,2023-02-05,15:00:00,52,28,24,FMN GV 11 Ramsel
66,Bergstraat 71,2023-02-05,16:00:00,60,28,32,FMN GV 11 Ramsel
66,Bergstraat 71,2023-02-05,17:00:00,42,22,20,FMN GV 11 Ramsel
66,Bergstraat 71,2023-02-05,18:00:00,20,12,8,FMN GV 11 Ramsel
66,Bergstraat 71,2023-02-05,19:00:00,14,4,10,FMN GV 11 Ramsel
66,Bergstraat 71,2023-02-05,20:00:00,12,6,6,FMN GV 11 Ramsel
66,Bergstraat 71,2023-02-05,21:00:00,12,10,2,FMN GV 11 Ramsel
66,Bergstraat 71,2023-02-05,22:00:00,4,4,0,FMN GV 11 Ramsel
66,Bergstraat 71,2023-02-05,23:00:00,0,0,0,FMN GV 11 Ramsel
66,Bergstraat 71,2023-02-06,00:00:00,0,0,0,FMN GV 11 Ramsel
66,Bergstraat 71,2023-02-06,01:00:00,0,0,0,FMN GV 11 Ramsel
66,Bergstraat 71,2023-02-06,02:00:00,0,0,0,FMN GV 11 Ramsel
66,Bergstraat 71,2023-02-06,03:00:00,2,2,0,FMN GV 11 Ramsel
66,Bergstraat 71,2023-02-06,04:00:00,4,4,0,FMN GV 11 Ramsel
66,Bergstraat 71,2023-02-06,05:00:00,12,4,8,FMN GV 11 Ramsel
66,Bergstraat 71,2023-02-06,06:00:00,28,12,16,FMN GV 11 Ramsel
66,Bergstraat 71,2023-02-06,07:00:00,156,24,132,FMN GV 11 Ramsel
66,Bergstraat 71,2023-02-06,08:00:00,172,22,150,FMN GV 11 Ramsel
66,Bergstraat 71,2023-02-06,09:00:00,50,20,30,FMN GV 11 Ramsel
66,Bergstraat 71,2023-02-06,10:00:00,18,8,10,FMN GV 11 Ramsel
66,Bergstraat 71,2023-02-06,11:00:00,32,16,16,FMN GV 11 Ramsel
66,Bergstraat 71,2023-02-06,12:00:00,34,12,22,FMN GV 11 Ramsel
66,Bergstraat 71,2023-02-06,13:00:00,98,62,36,FMN GV 11 Ramsel
66,Bergstraat 71,2023-02-06,14:00:00,138,84,54,FMN GV 11 Ramsel
66,Bergstraat 71,2023-02-06,15:00:00,216,178,38,FMN GV 11 Ramsel
66,Bergstraat 71,2023-02-06,16:00:00,138,100,38,FMN GV 11 Ramsel
66,Bergstraat 71,2023-02-06,17:00:00,82,66,16,FMN GV 11 Ramsel
66,Bergstraat 71,2023-02-06,18:00:00,52,34,18,FMN GV 11 Ramsel
66,Bergstraat 71,2023-02-06,19:00:00,40,22,18,FMN GV 11 Ramsel
66,Bergstraat 71,2023-02-06,20:00:00,14,10,4,FMN GV 11 Ramsel
66,Bergstraat 71,2023-02-06,21:00:00,12,6,6,FMN GV 11 Ramsel
66,Bergstraat 71,2023-02-06,22:00:00,4,4,0,FMN GV 11 Ramsel
66,Bergstraat 71,2023-02-06,23:00:00,2,0,2,FMN GV 11 Ramsel
66,Bergstraat 71,2023-02-07,00:00:00,4,2,2,FMN GV 11 Ramsel
66,Bergstraat 71,2023-02-07,01:00:00,0,0,0,FMN GV 11 Ramsel
66,Bergstraat 71,2023-02-07,02:00:00,0,0,0,FMN GV 11 Ramsel
66,Bergstraat 71,2023-02-07,03:00:00,2,2,0,FMN GV 11 Ramsel
66,Bergstraat 71,2023-02-07,04:00:00,4,4,0,FMN GV 11 Ramsel
66,Bergstraat 71,2023-02-07,05:00:00,14,6,8,FMN GV 11 Ramsel
66,Bergstraat 71,2023-02-07,06:00:00,34,12,22,FMN GV 11 Ramsel
66,Bergstraat 71,2023-02-07,07:00:00,142,32,110,FMN GV 11 Ramsel
66,Bergstraat 71,2023-02-07,08:00:00,166,28,138,FMN GV 11 Ramsel
66,Bergstraat 71,2023-02-07,09:00:00,38,14,24,FMN GV 11 Ramsel
66,Bergstraat 71,2023-02-07,10:00:00,32,14,18,FMN GV 11 Ramsel
66,Bergstraat 71,2023-02-07,11:00:00,32,14,18,FMN GV 11 Ramsel
66,Bergstraat 71,2023-02-07,12:00:00,98,28,70,FMN GV 11 Ramsel
66,Bergstraat 71,2023-02-07,13:00:00,148,70,78,FMN GV 11 Ramsel
66,Bergstraat 71,2023-02-07,14:00:00,132,72,60,FMN GV 11 Ramsel
66,Bergstraat 71,2023-02-07,15:00:00,258,208,50,FMN GV 11 Ramsel
66,Bergstraat 71,2023-02-07,16:00:00,232,176,56,FMN GV 11 Ramsel
66,Bergstraat 71,2023-02-07,17:00:00,130,70,60,FMN GV 11 Ramsel
66,Bergstraat 71,2023-02-07,18:00:00,70,34,36,FMN GV 11 Ramsel
66,Bergstraat 71,2023-02-07,19:00:00,64,38,26,FMN GV 11 Ramsel
66,Bergstraat 71,2023-02-07,20:00:00,30,20,10,FMN GV 11 Ramsel
66,Bergstraat 71,2023-02-07,21:00:00,32,26,6,FMN GV 11 Ramsel
66,Bergstraat 71,2023-02-07,22:00:00,10,6,4,FMN GV 11 Ramsel
66,Bergstraat 71,2023-02-07,23:00:00,4,4,0,FMN GV 11 Ramsel
66,Bergstraat 71,2023-02-08,00:00:00,0,0,0,FMN GV 11 Ramsel
66,Bergstraat 71,2023-02-08,01:00:00,2,2,0,FMN GV 11 Ramsel
66,Bergstraat 71,2023-02-08,02:00:00,0,0,0,FMN GV 11 Ramsel
66,Bergstraat 71,2023-02-08,03:00:00,2,2,0,FMN GV 11 Ramsel
66,Bergstraat 71,2023-02-08,04:00:00,4,2,2,FMN GV 11 Ramsel
66,Bergstraat 71,2023-02-08,05:00:00,8,2,6,FMN GV 11 Ramsel
66,Bergstraat 71,2023-02-08,06:00:00,24,8,16,FMN GV 11 Ramsel
66,Bergstraat 71,2023-02-08,07:00:00,174,26,148,FMN GV 11 Ramsel
66,Bergstraat 71,2023-02-08,08:00:00,136,8,128,FMN GV 11 Ramsel
66,Bergstraat 71,2023-02-08,09:00:00,32,10,22,FMN GV 11 Ramsel
66,Bergstraat 71,2023-02-08,10:00:00,26,12,14,FMN GV 11 Ramsel
66,Bergstraat 71,2023-02-08,11:00:00,60,30,30,FMN GV 11 Ramsel
66,Bergstraat 71,2023-02-08,12:00:00,242,208,34,FMN GV 11 Ramsel
66,Bergstraat 71,2023-02-08,13:00:00,142,54,88,FMN GV 11 Ramsel
66,Bergstraat 71,2023-02-08,14:00:00,160,98,62,FMN GV 11 Ramsel
66,Bergstraat 71,2023-02-08,15:00:00,128,92,36,FMN GV 11 Ramsel
66,Bergstraat 71,2023-02-08,16:00:00,86,64,22,FMN GV 11 Ramsel
66,Bergstraat 71,2023-02-08,17:00:00,98,72,26,FMN GV 11 Ramsel
66,Bergstraat 71,2023-02-08,18:00:00,58,34,24,FMN GV 11 Ramsel
66,Bergstraat 71,2023-02-08,19:00:00,32,14,18,FMN GV 11 Ramsel
66,Bergstraat 71,2023-02-08,20:00:00,22,8,14,FMN GV 11 Ramsel
66,Bergstraat 71,2023-02-08,21:00:00,18,12,6,FMN GV 11 Ramsel
66,Bergstraat 71,2023-02-08,22:00:00,14,10,4,FMN GV 11 Ramsel
66,Bergstraat 71,2023-02-08,23:00:00,2,2,0,FMN GV 11 Ramsel
66,Bergstraat 71,2023-02-09,00:00:00,0,0,0,FMN GV 11 Ramsel
66,Bergstraat 71,2023-02-09,01:00:00,2,2,0,FMN GV 11 Ramsel
66,Bergstraat 71,2023-02-09,02:00:00,0,0,0,FMN GV 11 Ramsel
66,Bergstraat 71,2023-02-09,03:00:00,0,0,0,FMN GV 11 Ramsel
66,Bergstraat 71,2023-02-09,04:00:00,8,6,2,FMN GV 11 Ramsel
66,Bergstraat 71,2023-02-09,05:00:00,4,0,4,FMN GV 11 Ramsel
66,Bergstraat 71,2023-02-09,06:00:00,16,6,10,FMN GV 11 Ramsel
66,Bergstraat 71,2023-02-09,07:00:00,148,24,124,FMN GV 11 Ramsel
66,Bergstraat 71,2023-02-09,08:00:00,186,20,166,FMN GV 11 Ramsel
66,Bergstraat 71,2023-02-09,09:00:00,32,6,26,FMN GV 11 Ramsel
66,Bergstraat 71,2023-02-09,10:00:00,50,28,22,FMN GV 11 Ramsel
66,Bergstraat 71,2023-02-09,11:00:00,48,20,28,FMN GV 11 Ramsel
66,Bergstraat 71,2023-02-09,12:00:00,66,34,32,FMN GV 11 Ramsel
66,Bergstraat 71,2023-02-09,13:00:00,74,32,42,FMN GV 11 Ramsel
66,Bergstraat 71,2023-02-09,14:00:00,116,68,48,FMN GV 11 Ramsel
66,Bergstraat 71,2023-02-09,15:00:00,210,178,32,FMN GV 11 Ramsel
66,Bergstraat 71,2023-02-09,16:00:00,162,124,38,FMN GV 11 Ramsel
66,Bergstraat 71,2023-02-09,17:00:00,82,64,18,FMN GV 11 Ramsel
66,Bergstraat 71,2023-02-09,18:00:00,54,32,22,FMN GV 11 Ramsel
66,Bergstraat 71,2023-02-09,19:00:00,28,12,16,FMN GV 11 Ramsel
66,Bergstraat 71,2023-02-09,20:00:00,24,14,10,FMN GV 11 Ramsel
66,Bergstraat 71,2023-02-09,21:00:00,14,14,0,FMN GV 11 Ramsel
66,Bergstraat 71,2023-02-09,22:00:00,14,12,2,FMN GV 11 Ramsel
66,Bergstraat 71,2023-02-09,23:00:00,4,2,2,FMN GV 11 Ramsel
66,Bergstraat 71,2023-02-10,00:00:00,6,6,0,FMN GV 11 Ramsel
66,Bergstraat 71,2023-02-10,01:00:00,2,0,2,FMN GV 11 Ramsel
66,Bergstraat 71,2023-02-10,02:00:00,2,2,0,FMN GV 11 Ramsel
66,Bergstraat 71,2023-02-10,03:00:00,0,0,0,FMN GV 11 Ramsel
66,Bergstraat 71,2023-02-10,04:00:00,8,8,0,FMN GV 11 Ramsel
66,Bergstraat 71,2023-02-10,05:00:00,6,2,4,FMN GV 11 Ramsel
66,Bergstraat 71,2023-02-10,06:00:00,20,8,12,FMN GV 11 Ramsel
66,Bergstraat 71,2023-02-10,07:00:00,136,22,114,FMN GV 11 Ramsel
66,Bergstraat 71,2023-02-10,08:00:00,186,28,158,FMN GV 11 Ramsel
66,Bergstraat 71,2023-02-10,09:00:00,28,8,20,FMN GV 11 Ramsel
66,Bergstraat 71,2023-02-10,10:00:00,46,12,34,FMN GV 11 Ramsel
66,Bergstraat 71,2023-02-10,11:00:00,64,30,34,FMN GV 11 Ramsel
66,Bergstraat 71,2023-02-10,12:00:00,52,28,24,FMN GV 11 Ramsel
66,Bergstraat 71,2023-02-10,13:00:00,88,52,36,FMN GV 11 Ramsel
66,Bergstraat 71,2023-02-10,14:00:00,146,90,56,FMN GV 11 Ramsel
66,Bergstraat 71,2023-02-10,15:00:00,160,136,24,FMN GV 11 Ramsel
66,Bergstraat 71,2023-02-10,16:00:00,170,132,38,FMN GV 11 Ramsel
66,Bergstraat 71,2023-02-10,17:00:00,80,40,40,FMN GV 11 Ramsel
66,Bergstraat 71,2023-02-10,18:00:00,44,26,18,FMN GV 11 Ramsel
66,Bergstraat 71,2023-02-10,19:00:00,30,10,20,FMN GV 11 Ramsel
66,Bergstraat 71,2023-02-10,20:00:00,32,16,16,FMN GV 11 Ramsel
66,Bergstraat 71,2023-02-10,21:00:00,16,8,8,FMN GV 11 Ramsel
66,Bergstraat 71,2023-02-10,22:00:00,22,8,14,FMN GV 11 Ramsel
66,Bergstraat 71,2023-02-10,23:00:00,16,6,10,FMN GV 11 Ramsel
66,Bergstraat 71,2023-02-11,00:00:00,10,6,4,FMN GV 11 Ramsel
66,Bergstraat 71,2023-02-11,01:00:00,8,8,0,FMN GV 11 Ramsel
66,Bergstraat 71,2023-02-11,02:00:00,12,12,0,FMN GV 11 Ramsel
66,Bergstraat 71,2023-02-11,03:00:00,8,6,2,FMN GV 11 Ramsel
66,Bergstraat 71,2023-02-11,04:00:00,2,2,0,FMN GV 11 Ramsel
66,Bergstraat 71,2023-02-11,05:00:00,6,2,4,FMN GV 11 Ramsel
66,Bergstraat 71,2023-02-11,06:00:00,2,0,2,FMN GV 11 Ramsel
66,Bergstraat 71,2023-02-11,07:00:00,6,6,0,FMN GV 11 Ramsel
66,Bergstraat 71,2023-02-11,08:00:00,28,10,18,FMN GV 11 Ramsel
66,Bergstraat 71,2023-02-11,09:00:00,34,8,26,FMN GV 11 Ramsel
66,Bergstraat 71,2023-02-11,10:00:00,74,32,42,FMN GV 11 Ramsel
66,Bergstraat 71,2023-02-11,11:00:00,114,64,50,FMN GV 11 Ramsel
66,Bergstraat 71,2023-02-11,12:00:00,108,38,70,FMN GV 11 Ramsel
66,Bergstraat 71,2023-02-11,13:00:00,98,70,28,FMN GV 11 Ramsel
66,Bergstraat 71,2023-02-11,14:00:00,54,34,20,FMN GV 11 Ramsel
66,Bergstraat 71,2023-02-11,15:00:00,74,44,30,FMN GV 11 Ramsel
66,Bergstraat 71,2023-02-11,16:00:00,50,30,20,FMN GV 11 Ramsel
66,Bergstraat 71,2023-02-11,17:00:00,42,18,24,FMN GV 11 Ramsel
66,Bergstraat 71,2023-02-11,18:00:00,6,0,6,FMN GV 11 Ramsel
66,Bergstraat 71,2023-02-11,19:00:00,18,6,12,FMN GV 11 Ramsel
66,Bergstraat 71,2023-02-11,20:00:00,16,4,12,FMN GV 11 Ramsel
66,Bergstraat 71,2023-02-11,21:00:00,16,8,8,FMN GV 11 Ramsel
66,Bergstraat 71,2023-02-11,22:00:00,6,4,2,FMN GV 11 Ramsel
66,Bergstraat 71,2023-02-11,23:00:00,6,2,4,FMN GV 11 Ramsel
66,Bergstraat 71,2023-02-12,00:00:00,10,8,2,FMN GV 11 Ramsel
66,Bergstraat 71,2023-02-12,01:00:00,10,8,2,FMN GV 11 Ramsel
66,Bergstraat 71,2023-02-12,02:00:00,10,10,0,FMN GV 11 Ramsel
66,Bergstraat 71,2023-02-12,03:00:00,4,2,2,FMN GV 11 Ramsel
66,Bergstraat 71,2023-02-12,04:00:00,0,0,0,FMN GV 11 Ramsel
66,Bergstraat 71,2023-02-12,05:00:00,0,0,0,FMN GV 11 Ramsel
66,Bergstraat 71,2023-02-12,06:00:00,2,2,0,FMN GV 11 Ramsel
66,Bergstraat 71,2023-02-12,07:00:00,20,2,18,FMN GV 11 Ramsel
66,Bergstraat 71,2023-02-12,08:00:00,56,26,30,FMN GV 11 Ramsel
66,Bergstraat 71,2023-02-12,09:00:00,122,28,94,FMN GV 11 Ramsel
66,Bergstraat 71,2023-02-12,10:00:00,110,72,38,FMN GV 11 Ramsel
66,Bergstraat 71,2023-02-12,11:00:00,144,60,84,FMN GV 11 Ramsel
66,Bergstraat 71,2023-02-12,12:00:00,94,82,12,FMN GV 11 Ramsel
66,Bergstraat 71,2023-02-12,13:00:00,78,44,34,FMN GV 11 Ramsel
66,Bergstraat 71,2023-02-12,14:00:00,96,42,54,FMN GV 11 Ramsel
66,Bergstraat 71,2023-02-12,15:00:00,100,64,36,FMN GV 11 Ramsel
66,Bergstraat 71,2023-02-12,16:00:00,62,40,22,FMN GV 11 Ramsel
66,Bergstraat 71,2023-02-12,17:00:00,54,16,38,FMN GV 11 Ramsel
66,Bergstraat 71,2023-02-12,18:00:00,14,12,2,FMN GV 11 Ramsel
66,Bergstraat 71,2023-02-12,19:00:00,6,2,4,FMN GV 11 Ramsel
66,Bergstraat 71,2023-02-12,20:00:00,10,8,2,FMN GV 11 Ramsel
66,Bergstraat 71,2023-02-12,21:00:00,4,2,2,FMN GV 11 Ramsel
66,Bergstraat 71,2023-02-12,22:00:00,2,0,2,FMN GV 11 Ramsel
66,Bergstraat 71,2023-02-12,23:00:00,0,0,0,FMN GV 11 Ramsel
66,Bergstraat 71,2023-02-13,00:00:00,0,0,0,FMN GV 11 Ramsel
66,Bergstraat 71,2023-02-13,01:00:00,2,2,0,FMN GV 11 Ramsel
66,Bergstraat 71,2023-02-13,02:00:00,0,0,0,FMN GV 11 Ramsel
66,Bergstraat 71,2023-02-13,03:00:00,0,0,0,FMN GV 11 Ramsel
66,Bergstraat 71,2023-02-13,04:00:00,6,6,0,FMN GV 11 Ramsel
66,Bergstraat 71,2023-02-13,05:00:00,16,6,10,FMN GV 11 Ramsel
66,Bergstraat 71,2023-02-13,06:00:00,30,8,22,FMN GV 11 Ramsel
66,Bergstraat 71,2023-02-13,07:00:00,210,28,182,FMN GV 11 Ramsel
66,Bergstraat 71,2023-02-13,08:00:00,156,12,144,FMN GV 11 Ramsel
66,Bergstraat 71,2023-02-13,09:00:00,44,14,30,FMN GV 11 Ramsel
66,Bergstraat 71,2023-02-13,10:00:00,36,24,12,FMN GV 11 Ramsel
66,Bergstraat 71,2023-02-13,11:00:00,50,26,24,FMN GV 11 Ramsel
66,Bergstraat 71,2023-02-13,12:00:00,86,50,36,FMN GV 11 Ramsel
66,Bergstraat 71,2023-02-13,13:00:00,110,58,52,FMN GV 11 Ramsel
66,Bergstraat 71,2023-02-13,14:00:00,220,132,88,FMN GV 11 Ramsel
66,Bergstraat 71,2023-02-13,15:00:00,258,202,56,FMN GV 11 Ramsel
66,Bergstraat 71,2023-02-13,16:00:00,234,166,68,FMN GV 11 Ramsel
66,Bergstraat 71,2023-02-13,17:00:00,114,80,34,FMN GV 11 Ramsel
66,Bergstraat 71,2023-02-13,18:00:00,58,46,12,FMN GV 11 Ramsel
66,Bergstraat 71,2023-02-13,19:00:00,44,16,28,FMN GV 11 Ramsel
66,Bergstraat 71,2023-02-13,20:00:00,12,4,8,FMN GV 11 Ramsel
66,Bergstraat 71,2023-02-13,21:00:00,12,10,2,FMN GV 11 Ramsel
66,Bergstraat 71,2023-02-13,22:00:00,12,12,0,FMN GV 11 Ramsel
66,Bergstraat 71,2023-02-13,23:00:00,0,0,0,FMN GV 11 Ramsel
66,Bergstraat 71,2023-02-14,00:00:00,0,0,0,FMN GV 11 Ramsel
66,Bergstraat 71,2023-02-14,01:00:00,0,0,0,FMN GV 11 Ramsel
66,Bergstraat 71,2023-02-14,02:00:00,0,0,0,FMN GV 11 Ramsel
66,Bergstraat 71,2023-02-14,03:00:00,0,0,0,FMN GV 11 Ramsel
66,Bergstraat 71,2023-02-14,04:00:00,8,4,4,FMN GV 11 Ramsel
66,Bergstraat 71,2023-02-14,05:00:00,14,8,6,FMN GV 11 Ramsel
66,Bergstraat 71,2023-02-14,06:00:00,42,14,28,FMN GV 11 Ramsel
66,Bergstraat 71,2023-02-14,07:00:00,216,44,172,FMN GV 11 Ramsel
66,Bergstraat 71,2023-02-14,08:00:00,186,24,162,FMN GV 11 Ramsel
66,Bergstraat 71,2023-02-14,09:00:00,34,14,20,FMN GV 11 Ramsel
66,Bergstraat 71,2023-02-14,10:00:00,34,12,22,FMN GV 11 Ramsel
66,Bergstraat 71,2023-02-14,11:00:00,50,18,32,FMN GV 11 Ramsel
66,Bergstraat 71,2023-02-14,12:00:00,150,42,108,FMN GV 11 Ramsel
66,Bergstraat 71,2023-02-14,13:00:00,150,82,68,FMN GV 11 Ramsel
66,Bergstraat 71,2023-02-14,14:00:00,248,170,78,FMN GV 11 Ramsel
66,Bergstraat 71,2023-02-14,15:00:00,288,228,60,FMN GV 11 Ramsel
66,Bergstraat 71,2023-02-14,16:00:00,270,180,90,FMN GV 11 Ramsel
66,Bergstraat 71,2023-02-14,17:00:00,140,70,70,FMN GV 11 Ramsel
66,Bergstraat 71,2023-02-14,18:00:00,80,40,40,FMN GV 11 Ramsel
66,Bergstraat 71,2023-02-14,19:00:00,56,24,32,FMN GV 11 Ramsel
66,Bergstraat 71,2023-02-14,20:00:00,42,30,12,FMN GV 11 Ramsel
66,Bergstraat 71,2023-02-14,21:00:00,14,6,8,FMN GV 11 Ramsel
66,Bergstraat 71,2023-02-14,22:00:00,18,18,0,FMN GV 11 Ramsel
66,Bergstraat 71,2023-02-14,23:00:00,6,2,4,FMN GV 11 Ramsel
66,Bergstraat 71,2023-02-15,00:00:00,0,0,0,FMN GV 11 Ramsel
66,Bergstraat 71,2023-02-15,01:00:00,2,2,0,FMN GV 11 Ramsel
66,Bergstraat 71,2023-02-15,02:00:00,0,0,0,FMN GV 11 Ramsel
66,Bergstraat 71,2023-02-15,03:00:00,0,0,0,FMN GV 11 Ramsel
66,Bergstraat 71,2023-02-15,04:00:00,8,4,4,FMN GV 11 Ramsel
66,Bergstraat 71,2023-02-15,05:00:00,14,8,6,FMN GV 11 Ramsel
66,Bergstraat 71,2023-02-15,06:00:00,28,10,18,FMN GV 11 Ramsel
66,Bergstraat 71,2023-02-15,07:00:00,212,36,176,FMN GV 11 Ramsel
66,Bergstraat 71,2023-02-15,08:00:00,186,28,158,FMN GV 11 Ramsel
66,Bergstraat 71,2023-02-15,09:00:00,20,2,18,FMN GV 11 Ramsel
66,Bergstraat 71,2023-02-15,10:00:00,52,30,22,FMN GV 11 Ramsel
66,Bergstraat 71,2023-02-15,11:00:00,72,42,30,FMN GV 11 Ramsel
66,Bergstraat 71,2023-02-15,12:00:00,276,218,58,FMN GV 11 Ramsel
66,Bergstraat 71,2023-02-15,13:00:00,194,80,114,FMN GV 11 Ramsel
66,Bergstraat 71,2023-02-15,14:00:00,206,102,104,FMN GV 11 Ramsel
66,Bergstraat 71,2023-02-15,15:00:00,168,120,48,FMN GV 11 Ramsel
66,Bergstraat 71,2023-02-15,16:00:00,180,112,68,FMN GV 11 Ramsel
66,Bergstraat 71,2023-02-15,17:00:00,156,110,46,FMN GV 11 Ramsel
66,Bergstraat 71,2023-02-15,18:00:00,74,38,36,FMN GV 11 Ramsel
66,Bergstraat 71,2023-02-15,19:00:00,28,12,16,FMN GV 11 Ramsel
66,Bergstraat 71,2023-02-15,20:00:00,20,12,8,FMN GV 11 Ramsel
66,Bergstraat 71,2023-02-15,21:00:00,10,4,6,FMN GV 11 Ramsel
66,Bergstraat 71,2023-02-15,22:00:00,12,10,2,FMN GV 11 Ramsel
66,Bergstraat 71,2023-02-15,23:00:00,12,10,2,FMN GV 11 Ramsel
66,Bergstraat 71,2023-02-16,00:00:00,2,2,0,FMN GV 11 Ramsel
66,Bergstraat 71,2023-02-16,01:00:00,2,2,0,FMN GV 11 Ramsel
66,Bergstraat 71,2023-02-16,02:00:00,2,0,2,FMN GV 11 Ramsel
66,Bergstraat 71,2023-02-16,03:00:00,0,0,0,FMN GV 11 Ramsel
66,Bergstraat 71,2023-02-16,04:00:00,8,4,4,FMN GV 11 Ramsel
66,Bergstraat 71,2023-02-16,05:00:00,12,2,10,FMN GV 11 Ramsel
66,Bergstraat 71,2023-02-16,06:00:00,40,20,20,FMN GV 11 Ramsel
66,Bergstraat 71,2023-02-16,07:00:00,174,30,144,FMN GV 11 Ramsel
66,Bergstraat 71,2023-02-16,08:00:00,190,26,164,FMN GV 11 Ramsel
66,Bergstraat 71,2023-02-16,09:00:00,44,12,32,FMN GV 11 Ramsel
66,Bergstraat 71,2023-02-16,10:00:00,42,16,26,FMN GV 11 Ramsel
66,Bergstraat 71,2023-02-16,11:00:00,40,28,12,FMN GV 11 Ramsel
66,Bergstraat 71,2023-02-16,12:00:00,46,20,26,FMN GV 11 Ramsel
66,Bergstraat 71,2023-02-16,13:00:00,46,20,26,FMN GV 11 Ramsel
66,Bergstraat 71,2023-02-16,14:00:00,72,40,32,FMN GV 11 Ramsel
66,Bergstraat 71,2023-02-16,15:00:00,226,180,46,FMN GV 11 Ramsel
66,Bergstraat 71,2023-02-16,16:00:00,186,152,34,FMN GV 11 Ramsel
66,Bergstraat 71,2023-02-16,17:00:00,112,80,32,FMN GV 11 Ramsel
66,Bergstraat 71,2023-02-16,18:00:00,40,20,20,FMN GV 11 Ramsel
66,Bergstraat 71,2023-02-16,19:00:00,22,10,12,FMN GV 11 Ramsel
66,Bergstraat 71,2023-02-16,20:00:00,22,12,10,FMN GV 11 Ramsel
66,Bergstraat 71,2023-02-16,21:00:00,8,6,2,FMN GV 11 Ramsel
66,Bergstraat 71,2023-02-16,22:00:00,12,10,2,FMN GV 11 Ramsel
66,Bergstraat 71,2023-02-16,23:00:00,8,2,6,FMN GV 11 Ramsel
66,Bergstraat 71,2023-02-17,00:00:00,2,2,0,FMN GV 11 Ramsel
66,Bergstraat 71,2023-02-17,01:00:00,0,0,0,FMN GV 11 Ramsel
66,Bergstraat 71,2023-02-17,02:00:00,0,0,0,FMN GV 11 Ramsel
66,Bergstraat 71,2023-02-17,03:00:00,2,0,2,FMN GV 11 Ramsel
66,Bergstraat 71,2023-02-17,04:00:00,8,4,4,FMN GV 11 Ramsel
66,Bergstraat 71,2023-02-17,05:00:00,20,12,8,FMN GV 11 Ramsel
66,Bergstraat 71,2023-02-17,06:00:00,24,14,10,FMN GV 11 Ramsel
66,Bergstraat 71,2023-02-17,07:00:00,156,30,126,FMN GV 11 Ramsel
66,Bergstraat 71,2023-02-17,08:00:00,178,30,148,FMN GV 11 Ramsel
66,Bergstraat 71,2023-02-17,09:00:00,28,4,24,FMN GV 11 Ramsel
66,Bergstraat 71,2023-02-17,10:00:00,34,12,22,FMN GV 11 Ramsel
66,Bergstraat 71,2023-02-17,11:00:00,36,26,10,FMN GV 11 Ramsel
66,Bergstraat 71,2023-02-17,12:00:00,44,26,18,FMN GV 11 Ramsel
66,Bergstraat 71,2023-02-17,13:00:00,54,26,28,FMN GV 11 Ramsel
66,Bergstraat 71,2023-02-17,14:00:00,68,50,18,FMN GV 11 Ramsel
66,Bergstraat 71,2023-02-17,15:00:00,194,152,42,FMN GV 11 Ramsel
66,Bergstraat 71,2023-02-17,16:00:00,138,112,26,FMN GV 11 Ramsel
66,Bergstraat 71,2023-02-17,17:00:00,60,32,28,FMN GV 11 Ramsel
66,Bergstraat 71,2023-02-17,18:00:00,56,28,28,FMN GV 11 Ramsel
66,Bergstraat 71,2023-02-17,19:00:00,10,4,6,FMN GV 11 Ramsel
66,Bergstraat 71,2023-02-17,20:00:00,26,12,14,FMN GV 11 Ramsel
66,Bergstraat 71,2023-02-17,21:00:00,18,10,8,FMN GV 11 Ramsel
66,Bergstraat 71,2023-02-17,22:00:00,14,6,8,FMN GV 11 Ramsel
66,Bergstraat 71,2023-02-17,23:00:00,2,0,2,FMN GV 11 Ramsel
66,Bergstraat 71,2023-02-18,00:00:00,4,2,2,FMN GV 11 Ramsel
66,Bergstraat 71,2023-02-18,01:00:00,0,0,0,FMN GV 11 Ramsel
66,Bergstraat 71,2023-02-18,02:00:00,4,4,0,FMN GV 11 Ramsel
66,Bergstraat 71,2023-02-18,03:00:00,0,0,0,FMN GV 11 Ramsel
66,Bergstraat 71,2023-02-18,04:00:00,2,2,0,FMN GV 11 Ramsel
66,Bergstraat 71,2023-02-18,05:00:00,0,0,0,FMN GV 11 Ramsel
66,Bergstraat 71,2023-02-18,06:00:00,4,2,2,FMN GV 11 Ramsel
66,Bergstraat 71,2023-02-18,07:00:00,12,10,2,FMN GV 11 Ramsel
66,Bergstraat 71,2023-02-18,08:00:00,26,6,20,FMN GV 11 Ramsel
66,Bergstraat 71,2023-02-18,09:00:00,32,14,18,FMN GV 11 Ramsel
66,Bergstraat 71,2023-02-18,10:00:00,42,16,26,FMN GV 11 Ramsel
66,Bergstraat 71,2023-02-18,11:00:00,40,30,10,FMN GV 11 Ramsel
66,Bergstraat 71,2023-02-18,12:00:00,56,24,32,FMN GV 11 Ramsel
66,Bergstraat 71,2023-02-18,13:00:00,66,32,34,FMN GV 11 Ramsel
66,Bergstraat 71,2023-02-18,14:00:00,58,28,30,FMN GV 11 Ramsel
66,Bergstraat 71,2023-02-18,15:00:00,56,36,20,FMN GV 11 Ramsel
66,Bergstraat 71,2023-02-18,16:00:00,52,32,20,FMN GV 11 Ramsel
66,Bergstraat 71,2023-02-18,17:00:00,24,14,10,FMN GV 11 Ramsel
66,Bergstraat 71,2023-02-18,18:00:00,18,12,6,FMN GV 11 Ramsel
66,Bergstraat 71,2023-02-18,19:00:00,10,2,8,FMN GV 11 Ramsel
66,Bergstraat 71,2023-02-18,20:00:00,26,4,22,FMN GV 11 Ramsel
66,Bergstraat 71,2023-02-18,21:00:00,10,10,0,FMN GV 11 Ramsel
66,Bergstraat 71,2023-02-18,22:00:00,22,12,10,FMN GV 11 Ramsel
66,Bergstraat 71,2023-02-18,23:00:00,16,8,8,FMN GV 11 Ramsel
66,Bergstraat 71,2023-02-19,00:00:00,12,6,6,FMN GV 11 Ramsel
66,Bergstraat 71,2023-02-19,01:00:00,2,2,0,FMN GV 11 Ramsel
66,Bergstraat 71,2023-02-19,02:00:00,4,2,2,FMN GV 11 Ramsel
66,Bergstraat 71,2023-02-19,03:00:00,4,4,0,FMN GV 11 Ramsel
66,Bergstraat 71,2023-02-19,04:00:00,2,2,0,FMN GV 11 Ramsel
66,Bergstraat 71,2023-02-19,05:00:00,4,4,0,FMN GV 11 Ramsel
66,Bergstraat 71,2023-02-19,06:00:00,6,2,4,FMN GV 11 Ramsel
66,Bergstraat 71,2023-02-19,07:00:00,8,8,0,FMN GV 11 Ramsel
66,Bergstraat 71,2023-02-19,08:00:00,70,20,50,FMN GV 11 Ramsel
66,Bergstraat 71,2023-02-19,09:00:00,80,36,44,FMN GV 11 Ramsel
66,Bergstraat 71,2023-02-19,10:00:00,132,68,64,FMN GV 11 Ramsel
66,Bergstraat 71,2023-02-19,11:00:00,134,84,50,FMN GV 11 Ramsel
66,Bergstraat 71,2023-02-19,12:00:00,68,42,26,FMN GV 11 Ramsel
66,Bergstraat 71,2023-02-19,13:00:00,44,28,16,FMN GV 11 Ramsel
66,Bergstraat 71,2023-02-19,14:00:00,42,16,26,FMN GV 11 Ramsel
66,Bergstraat 71,2023-02-19,15:00:00,46,24,22,FMN GV 11 Ramsel
66,Bergstraat 71,2023-02-19,16:00:00,58,42,16,FMN GV 11 Ramsel
66,Bergstraat 71,2023-02-19,17:00:00,32,12,20,FMN GV 11 Ramsel
66,Bergstraat 71,2023-02-19,18:00:00,4,4,0,FMN GV 11 Ramsel
66,Bergstraat 71,2023-02-19,19:00:00,12,12,0,FMN GV 11 Ramsel
66,Bergstraat 71,2023-02-19,20:00:00,10,2,8,FMN GV 11 Ramsel
66,Bergstraat 71,2023-02-19,21:00:00,6,2,4,FMN GV 11 Ramsel
66,Bergstraat 71,2023-02-19,22:00:00,8,8,0,FMN GV 11 Ramsel
66,Bergstraat 71,2023-02-19,23:00:00,0,0,0,FMN GV 11 Ramsel
66,Bergstraat 71,2023-02-20,00:00:00,0,0,0,FMN GV 11 Ramsel
66,Bergstraat 71,2023-02-20,01:00:00,2,0,2,FMN GV 11 Ramsel
66,Bergstraat 71,2023-02-20,02:00:00,0,0,0,FMN GV 11 Ramsel
66,Bergstraat 71,2023-02-20,03:00:00,0,0,0,FMN GV 11 Ramsel
66,Bergstraat 71,2023-02-20,04:00:00,6,4,2,FMN GV 11 Ramsel
66,Bergstraat 71,2023-02-20,05:00:00,12,6,6,FMN GV 11 Ramsel
66,Bergstraat 71,2023-02-20,06:00:00,30,18,12,FMN GV 11 Ramsel
66,Bergstraat 71,2023-02-20,07:00:00,48,18,30,FMN GV 11 Ramsel
66,Bergstraat 71,2023-02-20,08:00:00,54,18,36,FMN GV 11 Ramsel
66,Bergstraat 71,2023-02-20,09:00:00,28,12,16,FMN GV 11 Ramsel
66,Bergstraat 71,2023-02-20,10:00:00,36,20,16,FMN GV 11 Ramsel
66,Bergstraat 71,2023-02-20,11:00:00,56,20,36,FMN GV 11 Ramsel
66,Bergstraat 71,2023-02-20,12:00:00,70,32,38,FMN GV 11 Ramsel
66,Bergstraat 71,2023-02-20,13:00:00,76,32,44,FMN GV 11 Ramsel
66,Bergstraat 71,2023-02-20,14:00:00,86,52,34,FMN GV 11 Ramsel
66,Bergstraat 71,2023-02-20,15:00:00,92,44,48,FMN GV 11 Ramsel
66,Bergstraat 71,2023-02-20,16:00:00,114,68,46,FMN GV 11 Ramsel
66,Bergstraat 71,2023-02-20,17:00:00,88,46,42,FMN GV 11 Ramsel
66,Bergstraat 71,2023-02-20,18:00:00,50,24,26,FMN GV 11 Ramsel
66,Bergstraat 71,2023-02-20,19:00:00,38,22,16,FMN GV 11 Ramsel
66,Bergstraat 71,2023-02-20,20:00:00,24,8,16,FMN GV 11 Ramsel
66,Bergstraat 71,2023-02-20,21:00:00,20,18,2,FMN GV 11 Ramsel
66,Bergstraat 71,2023-02-20,22:00:00,20,14,6,FMN GV 11 Ramsel
66,Bergstraat 71,2023-02-20,23:00:00,2,2,0,FMN GV 11 Ramsel
66,Bergstraat 71,2023-02-21,00:00:00,2,0,2,FMN GV 11 Ramsel
66,Bergstraat 71,2023-02-21,01:00:00,0,0,0,FMN GV 11 Ramsel
66,Bergstraat 71,2023-02-21,02:00:00,0,0,0,FMN GV 11 Ramsel
66,Bergstraat 71,2023-02-21,03:00:00,0,0,0,FMN GV 11 Ramsel
66,Bergstraat 71,2023-02-21,04:00:00,8,4,4,FMN GV 11 Ramsel
66,Bergstraat 71,2023-02-21,05:00:00,14,8,6,FMN GV 11 Ramsel
66,Bergstraat 71,2023-02-21,06:00:00,20,10,10,FMN GV 11 Ramsel
66,Bergstraat 71,2023-02-21,07:00:00,60,26,34,FMN GV 11 Ramsel
66,Bergstraat 71,2023-02-21,08:00:00,38,18,20,FMN GV 11 Ramsel
66,Bergstraat 71,2023-02-21,09:00:00,38,16,22,FMN GV 11 Ramsel
66,Bergstraat 71,2023-02-21,10:00:00,38,12,26,FMN GV 11 Ramsel
66,Bergstraat 71,2023-02-21,11:00:00,46,18,28,FMN GV 11 Ramsel
66,Bergstraat 71,2023-02-21,12:00:00,78,38,40,FMN GV 11 Ramsel
66,Bergstraat 71,2023-02-21,13:00:00,158,70,88,FMN GV 11 Ramsel
66,Bergstraat 71,2023-02-21,14:00:00,110,66,44,FMN GV 11 Ramsel
66,Bergstraat 71,2023-02-21,15:00:00,84,60,24,FMN GV 11 Ramsel
66,Bergstraat 71,2023-02-21,16:00:00,122,64,58,FMN GV 11 Ramsel
66,Bergstraat 71,2023-02-21,17:00:00,100,48,52,FMN GV 11 Ramsel
66,Bergstraat 71,2023-02-21,18:00:00,60,24,36,FMN GV 11 Ramsel
66,Bergstraat 71,2023-02-21,19:00:00,74,44,30,FMN GV 11 Ramsel
66,Bergstraat 71,2023-02-21,20:00:00,26,18,8,FMN GV 11 Ramsel
66,Bergstraat 71,2023-02-21,21:00:00,24,22,2,FMN GV 11 Ramsel
66,Bergstraat 71,2023-02-21,22:00:00,16,10,6,FMN GV 11 Ramsel
66,Bergstraat 71,2023-02-21,23:00:00,4,2,2,FMN GV 11 Ramsel
66,Bergstraat 71,2023-02-22,00:00:00,0,0,0,FMN GV 11 Ramsel
66,Bergstraat 71,2023-02-22,01:00:00,0,0,0,FMN GV 11 Ramsel
66,Bergstraat 71,2023-02-22,02:00:00,2,0,2,FMN GV 11 Ramsel
66,Bergstraat 71,2023-02-22,03:00:00,0,0,0,FMN GV 11 Ramsel
66,Bergstraat 71,2023-02-22,04:00:00,12,10,2,FMN GV 11 Ramsel
66,Bergstraat 71,2023-02-22,05:00:00,10,2,8,FMN GV 11 Ramsel
66,Bergstraat 71,2023-02-22,06:00:00,22,8,14,FMN GV 11 Ramsel
66,Bergstraat 71,2023-02-22,07:00:00,52,24,28,FMN GV 11 Ramsel
66,Bergstraat 71,2023-02-22,08:00:00,28,12,16,FMN GV 11 Ramsel
66,Bergstraat 71,2023-02-22,09:00:00,40,6,34,FMN GV 11 Ramsel
66,Bergstraat 71,2023-02-22,10:00:00,70,40,30,FMN GV 11 Ramsel
66,Bergstraat 71,2023-02-22,11:00:00,72,34,38,FMN GV 11 Ramsel
66,Bergstraat 71,2023-02-22,12:00:00,56,34,22,FMN GV 11 Ramsel
66,Bergstraat 71,2023-02-22,13:00:00,60,22,38,FMN GV 11 Ramsel
66,Bergstraat 71,2023-02-22,14:00:00,102,60,42,FMN GV 11 Ramsel
66,Bergstraat 71,2023-02-22,15:00:00,62,32,30,FMN GV 11 Ramsel
66,Bergstraat 71,2023-02-22,16:00:00,72,48,24,FMN GV 11 Ramsel
66,Bergstraat 71,2023-02-22,17:00:00,82,52,30,FMN GV 11 Ramsel
66,Bergstraat 71,2023-02-22,18:00:00,58,36,22,FMN GV 11 Ramsel
66,Bergstraat 71,2023-02-22,19:00:00,14,6,8,FMN GV 11 Ramsel
66,Bergstraat 71,2023-02-22,20:00:00,32,16,16,FMN GV 11 Ramsel
66,Bergstraat 71,2023-02-22,21:00:00,14,8,6,FMN GV 11 Ramsel
66,Bergstraat 71,2023-02-22,22:00:00,8,6,2,FMN GV 11 Ramsel
66,Bergstraat 71,2023-02-22,23:00:00,0,0,0,FMN GV 11 Ramsel
66,Bergstraat 71,2023-02-23,00:00:00,0,0,0,FMN GV 11 Ramsel
66,Bergstraat 71,2023-02-23,01:00:00,4,4,0,FMN GV 11 Ramsel
66,Bergstraat 71,2023-02-23,02:00:00,0,0,0,FMN GV 11 Ramsel
66,Bergstraat 71,2023-02-23,03:00:00,2,0,2,FMN GV 11 Ramsel
66,Bergstraat 71,2023-02-23,04:00:00,4,2,2,FMN GV 11 Ramsel
66,Bergstraat 71,2023-02-23,05:00:00,10,6,4,FMN GV 11 Ramsel
66,Bergstraat 71,2023-02-23,06:00:00,10,0,10,FMN GV 11 Ramsel
66,Bergstraat 71,2023-02-23,07:00:00,46,20,26,FMN GV 11 Ramsel
66,Bergstraat 71,2023-02-23,08:00:00,52,22,30,FMN GV 11 Ramsel
66,Bergstraat 71,2023-02-23,09:00:00,30,12,18,FMN GV 11 Ramsel
66,Bergstraat 71,2023-02-23,10:00:00,44,26,18,FMN GV 11 Ramsel
66,Bergstraat 71,2023-02-23,11:00:00,40,14,26,FMN GV 11 Ramsel
66,Bergstraat 71,2023-02-23,12:00:00,64,36,28,FMN GV 11 Ramsel
66,Bergstraat 71,2023-02-23,13:00:00,78,32,46,FMN GV 11 Ramsel
66,Bergstraat 71,2023-02-23,14:00:00,112,48,64,FMN GV 11 Ramsel
66,Bergstraat 71,2023-02-23,15:00:00,70,36,34,FMN GV 11 Ramsel
66,Bergstraat 71,2023-02-23,16:00:00,68,44,24,FMN GV 11 Ramsel
66,Bergstraat 71,2023-02-23,17:00:00,78,56,22,FMN GV 11 Ramsel
66,Bergstraat 71,2023-02-23,18:00:00,50,24,26,FMN GV 11 Ramsel
66,Bergstraat 71,2023-02-23,19:00:00,30,18,12,FMN GV 11 Ramsel
66,Bergstraat 71,2023-02-23,20:00:00,16,8,8,FMN GV 11 Ramsel
66,Bergstraat 71,2023-02-23,21:00:00,16,10,6,FMN GV 11 Ramsel
66,Bergstraat 71,2023-02-23,22:00:00,12,12,0,FMN GV 11 Ramsel
66,Bergstraat 71,2023-02-23,23:00:00,6,4,2,FMN GV 11 Ramsel
66,Bergstraat 71,2023-02-24,00:00:00,8,2,6,FMN GV 11 Ramsel
66,Bergstraat 71,2023-02-24,01:00:00,0,0,0,FMN GV 11 Ramsel
66,Bergstraat 71,2023-02-24,02:00:00,2,0,2,FMN GV 11 Ramsel
66,Bergstraat 71,2023-02-24,03:00:00,0,0,0,FMN GV 11 Ramsel
66,Bergstraat 71,2023-02-24,04:00:00,8,4,4,FMN GV 11 Ramsel
66,Bergstraat 71,2023-02-24,05:00:00,8,6,2,FMN GV 11 Ramsel
66,Bergstraat 71,2023-02-24,06:00:00,6,0,6,FMN GV 11 Ramsel
66,Bergstraat 71,2023-02-24,07:00:00,40,20,20,FMN GV 11 Ramsel
66,Bergstraat 71,2023-02-24,08:00:00,44,18,26,FMN GV 11 Ramsel
66,Bergstraat 71,2023-02-24,09:00:00,22,10,12,FMN GV 11 Ramsel
66,Bergstraat 71,2023-02-24,10:00:00,50,20,30,FMN GV 11 Ramsel
66,Bergstraat 71,2023-02-24,11:00:00,46,18,28,FMN GV 11 Ramsel
66,Bergstraat 71,2023-02-24,12:00:00,74,32,42,FMN GV 11 Ramsel
66,Bergstraat 71,2023-02-24,13:00:00,76,48,28,FMN GV 11 Ramsel
66,Bergstraat 71,2023-02-24,14:00:00,64,36,28,FMN GV 11 Ramsel
66,Bergstraat 71,2023-02-24,15:00:00,38,26,12,FMN GV 11 Ramsel
66,Bergstraat 71,2023-02-24,16:00:00,56,26,30,FMN GV 11 Ramsel
66,Bergstraat 71,2023-02-24,17:00:00,58,40,18,FMN GV 11 Ramsel
66,Bergstraat 71,2023-02-24,18:00:00,50,28,22,FMN GV 11 Ramsel
66,Bergstraat 71,2023-02-24,19:00:00,18,12,6,FMN GV 11 Ramsel
66,Bergstraat 71,2023-02-24,20:00:00,16,4,12,FMN GV 11 Ramsel
66,Bergstraat 71,2023-02-24,21:00:00,10,4,6,FMN GV 11 Ramsel
66,Bergstraat 71,2023-02-24,22:00:00,8,6,2,FMN GV 11 Ramsel
66,Bergstraat 71,2023-02-24,23:00:00,12,8,4,FMN GV 11 Ramsel
66,Bergstraat 71,2023-02-25,00:00:00,6,4,2,FMN GV 11 Ramsel
66,Bergstraat 71,2023-02-25,01:00:00,4,2,2,FMN GV 11 Ramsel
66,Bergstraat 71,2023-02-25,02:00:00,4,4,0,FMN GV 11 Ramsel
66,Bergstraat 71,2023-02-25,03:00:00,0,0,0,FMN GV 11 Ramsel
66,Bergstraat 71,2023-02-25,04:00:00,0,0,0,FMN GV 11 Ramsel
66,Bergstraat 71,2023-02-25,05:00:00,4,0,4,FMN GV 11 Ramsel
66,Bergstraat 71,2023-02-25,06:00:00,8,6,2,FMN GV 11 Ramsel
66,Bergstraat 71,2023-02-25,07:00:00,16,6,10,FMN GV 11 Ramsel
66,Bergstraat 71,2023-02-25,08:00:00,22,8,14,FMN GV 11 Ramsel
66,Bergstraat 71,2023-02-25,09:00:00,40,12,28,FMN GV 11 Ramsel
66,Bergstraat 71,2023-02-25,10:00:00,94,56,38,FMN GV 11 Ramsel
66,Bergstraat 71,2023-02-25,11:00:00,84,50,34,FMN GV 11 Ramsel
66,Bergstraat 71,2023-02-25,12:00:00,76,40,36,FMN GV 11 Ramsel
66,Bergstraat 71,2023-02-25,13:00:00,88,42,46,FMN GV 11 Ramsel
66,Bergstraat 71,2023-02-25,14:00:00,80,52,28,FMN GV 11 Ramsel
66,Bergstraat 71,2023-02-25,15:00:00,48,38,10,FMN GV 11 Ramsel
66,Bergstraat 71,2023-02-25,16:00:00,40,22,18,FMN GV 11 Ramsel
66,Bergstraat 71,2023-02-25,17:00:00,50,26,24,FMN GV 11 Ramsel
66,Bergstraat 71,2023-02-25,18:00:00,26,10,16,FMN GV 11 Ramsel
66,Bergstraat 71,2023-02-25,19:00:00,14,8,6,FMN GV 11 Ramsel
66,Bergstraat 71,2023-02-25,20:00:00,12,4,8,FMN GV 11 Ramsel
66,Bergstraat 71,2023-02-25,21:00:00,2,0,2,FMN GV 11 Ramsel
66,Bergstraat 71,2023-02-25,22:00:00,2,0,2,FMN GV 11 Ramsel
66,Bergstraat 71,2023-02-25,23:00:00,10,0,10,FMN GV 11 Ramsel
66,Bergstraat 71,2023-02-26,00:00:00,8,4,4,FMN GV 11 Ramsel
66,Bergstraat 71,2023-02-26,01:00:00,8,4,4,FMN GV 11 Ramsel
66,Bergstraat 71,2023-02-26,02:00:00,6,6,0,FMN GV 11 Ramsel
66,Bergstraat 71,2023-02-26,03:00:00,2,2,0,FMN GV 11 Ramsel
66,Bergstraat 71,2023-02-26,04:00:00,4,0,4,FMN GV 11 Ramsel
66,Bergstraat 71,2023-02-26,05:00:00,0,0,0,FMN GV 11 Ramsel
66,Bergstraat 71,2023-02-26,06:00:00,2,2,0,FMN GV 11 Ramsel
66,Bergstraat 71,2023-02-26,07:00:00,8,6,2,FMN GV 11 Ramsel
66,Bergstraat 71,2023-02-26,08:00:00,26,4,22,FMN GV 11 Ramsel
66,Bergstraat 71,2023-02-26,09:00:00,44,20,24,FMN GV 11 Ramsel
66,Bergstraat 71,2023-02-26,10:00:00,94,42,52,FMN GV 11 Ramsel
66,Bergstraat 71,2023-02-26,11:00:00,104,58,46,FMN GV 11 Ramsel
66,Bergstraat 71,2023-02-26,12:00:00,108,64,44,FMN GV 11 Ramsel
66,Bergstraat 71,2023-02-26,13:00:00,98,58,40,FMN GV 11 Ramsel
66,Bergstraat 71,2023-02-26,14:00:00,92,42,50,FMN GV 11 Ramsel
66,Bergstraat 71,2023-02-26,15:00:00,46,22,24,FMN GV 11 Ramsel
66,Bergstraat 71,2023-02-26,16:00:00,54,18,36,FMN GV 11 Ramsel
66,Bergstraat 71,2023-02-26,17:00:00,60,26,34,FMN GV 11 Ramsel
66,Bergstraat 71,2023-02-26,18:00:00,30,14,16,FMN GV 11 Ramsel
66,Bergstraat 71,2023-02-26,19:00:00,18,4,14,FMN GV 11 Ramsel
66,Bergstraat 71,2023-02-26,20:00:00,8,6,2,FMN GV 11 Ramsel
66,Bergstraat 71,2023-02-26,21:00:00,0,0,0,FMN GV 11 Ramsel
66,Bergstraat 71,2023-02-26,22:00:00,14,12,2,FMN GV 11 Ramsel
66,Bergstraat 71,2023-02-26,23:00:00,0,0,0,FMN GV 11 Ramsel
66,Bergstraat 71,2023-02-27,00:00:00,0,0,0,FMN GV 11 Ramsel
66,Bergstraat 71,2023-02-27,01:00:00,0,0,0,FMN GV 11 Ramsel
66,Bergstraat 71,2023-02-27,02:00:00,0,0,0,FMN GV 11 Ramsel
66,Bergstraat 71,2023-02-27,03:00:00,2,2,0,FMN GV 11 Ramsel
66,Bergstraat 71,2023-02-27,04:00:00,6,6,0,FMN GV 11 Ramsel
66,Bergstraat 71,2023-02-27,05:00:00,18,10,8,FMN GV 11 Ramsel
66,Bergstraat 71,2023-02-27,06:00:00,30,6,24,FMN GV 11 Ramsel
66,Bergstraat 71,2023-02-27,07:00:00,192,36,156,FMN GV 11 Ramsel
66,Bergstraat 71,2023-02-27,08:00:00,164,8,156,FMN GV 11 Ramsel
66,Bergstraat 71,2023-02-27,09:00:00,62,22,40,FMN GV 11 Ramsel
66,Bergstraat 71,2023-02-27,10:00:00,40,16,24,FMN GV 11 Ramsel
66,Bergstraat 71,2023-02-27,11:00:00,58,28,30,FMN GV 11 Ramsel
66,Bergstraat 71,2023-02-27,12:00:00,64,24,40,FMN GV 11 Ramsel
66,Bergstraat 71,2023-02-27,13:00:00,88,50,38,FMN GV 11 Ramsel
66,Bergstraat 71,2023-02-27,14:00:00,100,64,36,FMN GV 11 Ramsel
66,Bergstraat 71,2023-02-27,15:00:00,224,186,38,FMN GV 11 Ramsel
66,Bergstraat 71,2023-02-27,16:00:00,186,148,38,FMN GV 11 Ramsel
66,Bergstraat 71,2023-02-27,17:00:00,90,62,28,FMN GV 11 Ramsel
66,Bergstraat 71,2023-02-27,18:00:00,56,28,28,FMN GV 11 Ramsel
66,Bergstraat 71,2023-02-27,19:00:00,34,14,20,FMN GV 11 Ramsel
66,Bergstraat 71,2023-02-27,20:00:00,16,12,4,FMN GV 11 Ramsel
66,Bergstraat 71,2023-02-27,21:00:00,8,6,2,FMN GV 11 Ramsel
66,Bergstraat 71,2023-02-27,22:00:00,4,4,0,FMN GV 11 Ramsel
66,Bergstraat 71,2023-02-27,23:00:00,4,2,2,FMN GV 11 Ramsel
66,Bergstraat 71,2023-02-28,00:00:00,2,2,0,FMN GV 11 Ramsel
66,Bergstraat 71,2023-02-28,01:00:00,0,0,0,FMN GV 11 Ramsel
66,Bergstraat 71,2023-02-28,02:00:00,0,0,0,FMN GV 11 Ramsel
66,Bergstraat 71,2023-02-28,03:00:00,0,0,0,FMN GV 11 Ramsel
66,Bergstraat 71,2023-02-28,04:00:00,8,6,2,FMN GV 11 Ramsel
66,Bergstraat 71,2023-02-28,05:00:00,20,12,8,FMN GV 11 Ramsel
66,Bergstraat 71,2023-02-28,06:00:00,30,14,16,FMN GV 11 Ramsel
66,Bergstraat 71,2023-02-28,07:00:00,164,26,138,FMN GV 11 Ramsel
66,Bergstraat 71,2023-02-28,08:00:00,186,22,164,FMN GV 11 Ramsel
66,Bergstraat 71,2023-02-28,09:00:00,52,16,36,FMN GV 11 Ramsel
66,Bergstraat 71,2023-02-28,10:00:00,46,24,22,FMN GV 11 Ramsel
66,Bergstraat 71,2023-02-28,11:00:00,40,16,24,FMN GV 11 Ramsel
66,Bergstraat 71,2023-02-28,12:00:00,80,36,44,FMN GV 11 Ramsel
66,Bergstraat 71,2023-02-28,13:00:00,106,54,52,FMN GV 11 Ramsel
66,Bergstraat 71,2023-02-28,14:00:00,88,56,32,FMN GV 11 Ramsel
66,Bergstraat 71,2023-02-28,15:00:00,210,178,32,FMN GV 11 Ramsel
66,Bergstraat 71,2023-02-28,16:00:00,196,142,54,FMN GV 11 Ramsel
66,Bergstraat 71,2023-02-28,17:00:00,110,68,42,FMN GV 11 Ramsel
66,Bergstraat 71,2023-02-28,18:00:00,84,46,38,FMN GV 11 Ramsel
66,Bergstraat 71,2023-02-28,19:00:00,50,18,32,FMN GV 11 Ramsel
66,Bergstraat 71,2023-02-28,20:00:00,32,20,12,FMN GV 11 Ramsel
66,Bergstraat 71,2023-02-28,21:00:00,22,18,4,FMN GV 11 Ramsel
66,Bergstraat 71,2023-02-28,22:00:00,14,14,0,FMN GV 11 Ramsel
66,Bergstraat 71,2023-02-28,23:00:00,6,6,0,FMN GV 11 Ramsel
66,Bergstraat 71,2023-03-01,00:00:00,2,2,0,FMN GV 11 Ramsel
66,Bergstraat 71,2023-03-01,01:00:00,0,0,0,FMN GV 11 Ramsel
66,Bergstraat 71,2023-03-01,02:00:00,0,0,0,FMN GV 11 Ramsel
66,Bergstraat 71,2023-03-01,03:00:00,2,0,2,FMN GV 11 Ramsel
66,Bergstraat 71,2023-03-01,04:00:00,6,4,2,FMN GV 11 Ramsel
66,Bergstraat 71,2023-03-01,05:00:00,18,8,10,FMN GV 11 Ramsel
66,Bergstraat 71,2023-03-01,06:00:00,20,8,12,FMN GV 11 Ramsel
66,Bergstraat 71,2023-03-01,07:00:00,186,40,146,FMN GV 11 Ramsel
66,Bergstraat 71,2023-03-01,08:00:00,160,18,142,FMN GV 11 Ramsel
66,Bergstraat 71,2023-03-01,09:00:00,38,10,28,FMN GV 11 Ramsel
66,Bergstraat 71,2023-03-01,10:00:00,36,20,16,FMN GV 11 Ramsel
66,Bergstraat 71,2023-03-01,11:00:00,74,56,18,FMN GV 11 Ramsel
66,Bergstraat 71,2023-03-01,12:00:00,232,200,32,FMN GV 11 Ramsel
66,Bergstraat 71,2023-03-01,13:00:00,86,46,40,FMN GV 11 Ramsel
66,Bergstraat 71,2023-03-01,14:00:00,142,76,66,FMN GV 11 Ramsel
66,Bergstraat 71,2023-03-01,15:00:00,152,104,48,FMN GV 11 Ramsel
66,Bergstraat 71,2023-03-01,16:00:00,88,58,30,FMN GV 11 Ramsel
66,Bergstraat 71,2023-03-01,17:00:00,104,74,30,FMN GV 11 Ramsel
66,Bergstraat 71,2023-03-01,18:00:00,50,30,20,FMN GV 11 Ramsel
66,Bergstraat 71,2023-03-01,19:00:00,36,18,18,FMN GV 11 Ramsel
66,Bergstraat 71,2023-03-01,20:00:00,20,6,14,FMN GV 11 Ramsel
66,Bergstraat 71,2023-03-01,21:00:00,20,20,0,FMN GV 11 Ramsel
66,Bergstraat 71,2023-03-01,22:00:00,14,14,0,FMN GV 11 Ramsel
66,Bergstraat 71,2023-03-01,23:00:00,4,0,4,FMN GV 11 Ramsel
66,Bergstraat 71,2023-03-02,00:00:00,2,0,2,FMN GV 11 Ramsel
66,Bergstraat 71,2023-03-02,01:00:00,0,0,0,FMN GV 11 Ramsel
66,Bergstraat 71,2023-03-02,02:00:00,0,0,0,FMN GV 11 Ramsel
66,Bergstraat 71,2023-03-02,03:00:00,0,0,0,FMN GV 11 Ramsel
66,Bergstraat 71,2023-03-02,04:00:00,6,4,2,FMN GV 11 Ramsel
66,Bergstraat 71,2023-03-02,05:00:00,16,8,8,FMN GV 11 Ramsel
66,Bergstraat 71,2023-03-02,06:00:00,26,12,14,FMN GV 11 Ramsel
66,Bergstraat 71,2023-03-02,07:00:00,174,30,144,FMN GV 11 Ramsel
66,Bergstraat 71,2023-03-02,08:00:00,188,22,166,FMN GV 11 Ramsel
66,Bergstraat 71,2023-03-02,09:00:00,28,2,26,FMN GV 11 Ramsel
66,Bergstraat 71,2023-03-02,10:00:00,42,14,28,FMN GV 11 Ramsel
66,Bergstraat 71,2023-03-02,11:00:00,48,30,18,FMN GV 11 Ramsel
66,Bergstraat 71,2023-03-02,12:00:00,76,26,50,FMN GV 11 Ramsel
66,Bergstraat 71,2023-03-02,13:00:00,106,44,62,FMN GV 11 Ramsel
66,Bergstraat 71,2023-03-02,14:00:00,174,106,68,FMN GV 11 Ramsel
66,Bergstraat 71,2023-03-02,15:00:00,218,168,50,FMN GV 11 Ramsel
66,Bergstraat 71,2023-03-02,16:00:00,216,166,50,FMN GV 11 Ramsel
66,Bergstraat 71,2023-03-02,17:00:00,108,66,42,FMN GV 11 Ramsel
66,Bergstraat 71,2023-03-02,18:00:00,76,46,30,FMN GV 11 Ramsel
66,Bergstraat 71,2023-03-02,19:00:00,34,14,20,FMN GV 11 Ramsel
66,Bergstraat 71,2023-03-02,20:00:00,30,24,6,FMN GV 11 Ramsel
66,Bergstraat 71,2023-03-02,21:00:00,16,16,0,FMN GV 11 Ramsel
66,Bergstraat 71,2023-03-02,22:00:00,10,10,0,FMN GV 11 Ramsel
66,Bergstraat 71,2023-03-02,23:00:00,6,6,0,FMN GV 11 Ramsel
66,Bergstraat 71,2023-03-03,00:00:00,0,0,0,FMN GV 11 Ramsel
66,Bergstraat 71,2023-03-03,01:00:00,4,0,4,FMN GV 11 Ramsel
66,Bergstraat 71,2023-03-03,02:00:00,0,0,0,FMN GV 11 Ramsel
66,Bergstraat 71,2023-03-03,03:00:00,0,0,0,FMN GV 11 Ramsel
66,Bergstraat 71,2023-03-03,04:00:00,6,4,2,FMN GV 11 Ramsel
66,Bergstraat 71,2023-03-03,05:00:00,18,12,6,FMN GV 11 Ramsel
66,Bergstraat 71,2023-03-03,06:00:00,24,12,12,FMN GV 11 Ramsel
66,Bergstraat 71,2023-03-03,07:00:00,138,16,122,FMN GV 11 Ramsel
66,Bergstraat 71,2023-03-03,08:00:00,150,22,128,FMN GV 11 Ramsel
66,Bergstraat 71,2023-03-03,09:00:00,40,14,26,FMN GV 11 Ramsel
66,Bergstraat 71,2023-03-03,10:00:00,28,18,10,FMN GV 11 Ramsel
66,Bergstraat 71,2023-03-03,11:00:00,40,24,16,FMN GV 11 Ramsel
66,Bergstraat 71,2023-03-03,12:00:00,38,30,8,FMN GV 11 Ramsel
66,Bergstraat 71,2023-03-03,13:00:00,74,36,38,FMN GV 11 Ramsel
66,Bergstraat 71,2023-03-03,14:00:00,90,48,42,FMN GV 11 Ramsel
66,Bergstraat 71,2023-03-03,15:00:00,180,138,42,FMN GV 11 Ramsel
66,Bergstraat 71,2023-03-03,16:00:00,178,156,22,FMN GV 11 Ramsel
66,Bergstraat 71,2023-03-03,17:00:00,76,40,36,FMN GV 11 Ramsel
66,Bergstraat 71,2023-03-03,18:00:00,72,38,34,FMN GV 11 Ramsel
66,Bergstraat 71,2023-03-03,19:00:00,38,16,22,FMN GV 11 Ramsel
66,Bergstraat 71,2023-03-03,20:00:00,34,14,20,FMN GV 11 Ramsel
66,Bergstraat 71,2023-03-03,21:00:00,14,6,8,FMN GV 11 Ramsel
66,Bergstraat 71,2023-03-03,22:00:00,16,14,2,FMN GV 11 Ramsel
66,Bergstraat 71,2023-03-03,23:00:00,4,2,2,FMN GV 11 Ramsel
66,Bergstraat 71,2023-03-04,00:00:00,2,2,0,FMN GV 11 Ramsel
66,Bergstraat 71,2023-03-04,01:00:00,0,0,0,FMN GV 11 Ramsel
66,Bergstraat 71,2023-03-04,02:00:00,4,2,2,FMN GV 11 Ramsel
66,Bergstraat 71,2023-03-04,03:00:00,2,2,0,FMN GV 11 Ramsel
66,Bergstraat 71,2023-03-04,04:00:00,2,2,0,FMN GV 11 Ramsel
66,Bergstraat 71,2023-03-04,05:00:00,4,4,0,FMN GV 11 Ramsel
66,Bergstraat 71,2023-03-04,06:00:00,8,4,4,FMN GV 11 Ramsel
66,Bergstraat 71,2023-03-04,07:00:00,8,4,4,FMN GV 11 Ramsel
66,Bergstraat 71,2023-03-04,08:00:00,30,12,18,FMN GV 11 Ramsel
66,Bergstraat 71,2023-03-04,09:00:00,48,18,30,FMN GV 11 Ramsel
66,Bergstraat 71,2023-03-04,10:00:00,84,54,30,FMN GV 11 Ramsel
66,Bergstraat 71,2023-03-04,11:00:00,52,24,28,FMN GV 11 Ramsel
66,Bergstraat 71,2023-03-04,12:00:00,102,48,54,FMN GV 11 Ramsel
66,Bergstraat 71,2023-03-04,13:00:00,120,74,46,FMN GV 11 Ramsel
66,Bergstraat 71,2023-03-04,14:00:00,94,50,44,FMN GV 11 Ramsel
66,Bergstraat 71,2023-03-04,15:00:00,108,66,42,FMN GV 11 Ramsel
66,Bergstraat 71,2023-03-04,16:00:00,56,26,30,FMN GV 11 Ramsel
66,Bergstraat 71,2023-03-04,17:00:00,34,22,12,FMN GV 11 Ramsel
66,Bergstraat 71,2023-03-04,18:00:00,20,8,12,FMN GV 11 Ramsel
66,Bergstraat 71,2023-03-04,19:00:00,8,2,6,FMN GV 11 Ramsel
66,Bergstraat 71,2023-03-04,20:00:00,14,4,10,FMN GV 11 Ramsel
66,Bergstraat 71,2023-03-04,21:00:00,12,6,6,FMN GV 11 Ramsel
66,Bergstraat 71,2023-03-04,22:00:00,8,2,6,FMN GV 11 Ramsel
66,Bergstraat 71,2023-03-04,23:00:00,0,0,0,FMN GV 11 Ramsel
66,Bergstraat 71,2023-03-05,00:00:00,14,10,4,FMN GV 11 Ramsel
66,Bergstraat 71,2023-03-05,01:00:00,8,6,2,FMN GV 11 Ramsel
66,Bergstraat 71,2023-03-05,02:00:00,2,0,2,FMN GV 11 Ramsel
66,Bergstraat 71,2023-03-05,03:00:00,4,4,0,FMN GV 11 Ramsel
66,Bergstraat 71,2023-03-05,04:00:00,2,2,0,FMN GV 11 Ramsel
66,Bergstraat 71,2023-03-05,05:00:00,2,2,0,FMN GV 11 Ramsel
66,Bergstraat 71,2023-03-05,06:00:00,2,0,2,FMN GV 11 Ramsel
66,Bergstraat 71,2023-03-05,07:00:00,8,4,4,FMN GV 11 Ramsel
66,Bergstraat 71,2023-03-05,08:00:00,64,24,40,FMN GV 11 Ramsel
66,Bergstraat 71,2023-03-05,09:00:00,48,20,28,FMN GV 11 Ramsel
66,Bergstraat 71,2023-03-05,10:00:00,70,24,46,FMN GV 11 Ramsel
66,Bergstraat 71,2023-03-05,11:00:00,92,80,12,FMN GV 11 Ramsel
66,Bergstraat 71,2023-03-05,12:00:00,60,48,12,FMN GV 11 Ramsel
66,Bergstraat 71,2023-03-05,13:00:00,48,22,26,FMN GV 11 Ramsel
66,Bergstraat 71,2023-03-05,14:00:00,58,30,28,FMN GV 11 Ramsel
66,Bergstraat 71,2023-03-05,15:00:00,48,18,30,FMN GV 11 Ramsel
66,Bergstraat 71,2023-03-05,16:00:00,26,16,10,FMN GV 11 Ramsel
66,Bergstraat 71,2023-03-05,17:00:00,16,14,2,FMN GV 11 Ramsel
66,Bergstraat 71,2023-03-05,18:00:00,18,16,2,FMN GV 11 Ramsel
66,Bergstraat 71,2023-03-05,19:00:00,12,6,6,FMN GV 11 Ramsel
66,Bergstraat 71,2023-03-05,20:00:00,6,0,6,FMN GV 11 Ramsel
66,Bergstraat 71,2023-03-05,21:00:00,8,6,2,FMN GV 11 Ramsel
66,Bergstraat 71,2023-03-05,22:00:00,2,2,0,FMN GV 11 Ramsel
66,Bergstraat 71,2023-03-05,23:00:00,0,0,0,FMN GV 11 Ramsel
66,Bergstraat 71,2023-03-06,00:00:00,0,0,0,FMN GV 11 Ramsel
66,Bergstraat 71,2023-03-06,01:00:00,0,0,0,FMN GV 11 Ramsel
66,Bergstraat 71,2023-03-06,02:00:00,0,0,0,FMN GV 11 Ramsel
66,Bergstraat 71,2023-03-06,03:00:00,0,0,0,FMN GV 11 Ramsel
66,Bergstraat 71,2023-03-06,04:00:00,6,4,2,FMN GV 11 Ramsel
66,Bergstraat 71,2023-03-06,05:00:00,8,4,4,FMN GV 11 Ramsel
66,Bergstraat 71,2023-03-06,06:00:00,26,8,18,FMN GV 11 Ramsel
66,Bergstraat 71,2023-03-06,07:00:00,162,22,140,FMN GV 11 Ramsel
66,Bergstraat 71,2023-03-06,08:00:00,156,24,132,FMN GV 11 Ramsel
66,Bergstraat 71,2023-03-06,09:00:00,36,18,18,FMN GV 11 Ramsel
66,Bergstraat 71,2023-03-06,10:00:00,48,22,26,FMN GV 11 Ramsel
66,Bergstraat 71,2023-03-06,11:00:00,40,16,24,FMN GV 11 Ramsel
66,Bergstraat 71,2023-03-06,12:00:00,52,36,16,FMN GV 11 Ramsel
66,Bergstraat 71,2023-03-06,13:00:00,46,24,22,FMN GV 11 Ramsel
66,Bergstraat 71,2023-03-06,14:00:00,90,50,40,FMN GV 11 Ramsel
66,Bergstraat 71,2023-03-06,15:00:00,144,122,22,FMN GV 11 Ramsel
66,Bergstraat 71,2023-03-06,16:00:00,158,128,30,FMN GV 11 Ramsel
66,Bergstraat 71,2023-03-06,17:00:00,90,64,26,FMN GV 11 Ramsel
66,Bergstraat 71,2023-03-06,18:00:00,48,24,24,FMN GV 11 Ramsel
66,Bergstraat 71,2023-03-06,19:00:00,28,16,12,FMN GV 11 Ramsel
66,Bergstraat 71,2023-03-06,20:00:00,24,12,12,FMN GV 11 Ramsel
66,Bergstraat 71,2023-03-06,21:00:00,8,6,2,FMN GV 11 Ramsel
66,Bergstraat 71,2023-03-06,22:00:00,8,4,4,FMN GV 11 Ramsel
66,Bergstraat 71,2023-03-06,23:00:00,0,0,0,FMN GV 11 Ramsel
66,Bergstraat 71,2023-03-07,00:00:00,0,0,0,FMN GV 11 Ramsel
66,Bergstraat 71,2023-03-07,01:00:00,0,0,0,FMN GV 11 Ramsel
66,Bergstraat 71,2023-03-07,02:00:00,0,0,0,FMN GV 11 Ramsel
66,Bergstraat 71,2023-03-07,03:00:00,0,0,0,FMN GV 11 Ramsel
66,Bergstraat 71,2023-03-07,04:00:00,6,4,2,FMN GV 11 Ramsel
66,Bergstraat 71,2023-03-07,05:00:00,8,4,4,FMN GV 11 Ramsel
66,Bergstraat 71,2023-03-07,06:00:00,22,8,14,FMN GV 11 Ramsel
66,Bergstraat 71,2023-03-07,07:00:00,164,32,132,FMN GV 11 Ramsel
66,Bergstraat 71,2023-03-07,08:00:00,134,12,122,FMN GV 11 Ramsel
66,Bergstraat 71,2023-03-07,09:00:00,22,4,18,FMN GV 11 Ramsel
66,Bergstraat 71,2023-03-07,10:00:00,8,2,6,FMN GV 11 Ramsel
66,Bergstraat 71,2023-03-07,11:00:00,12,8,4,FMN GV 11 Ramsel
66,Bergstraat 71,2023-03-07,12:00:00,10,2,8,FMN GV 11 Ramsel
66,Bergstraat 71,2023-03-07,13:00:00,12,10,2,FMN GV 11 Ramsel
66,Bergstraat 71,2023-03-07,14:00:00,14,12,2,FMN GV 11 Ramsel
66,Bergstraat 71,2023-03-07,15:00:00,134,130,4,FMN GV 11 Ramsel
66,Bergstraat 71,2023-03-07,16:00:00,96,82,14,FMN GV 11 Ramsel
66,Bergstraat 71,2023-03-07,17:00:00,34,22,12,FMN GV 11 Ramsel
66,Bergstraat 71,2023-03-07,18:00:00,36,24,12,FMN GV 11 Ramsel
66,Bergstraat 71,2023-03-07,19:00:00,20,8,12,FMN GV 11 Ramsel
66,Bergstraat 71,2023-03-07,20:00:00,4,4,0,FMN GV 11 Ramsel
66,Bergstraat 71,2023-03-07,21:00:00,6,6,0,FMN GV 11 Ramsel
66,Bergstraat 71,2023-03-07,22:00:00,8,4,4,FMN GV 11 Ramsel
66,Bergstraat 71,2023-03-07,23:00:00,0,0,0,FMN GV 11 Ramsel
66,Bergstraat 71,2023-03-08,00:00:00,0,0,0,FMN GV 11 Ramsel
66,Bergstraat 71,2023-03-08,01:00:00,0,0,0,FMN GV 11 Ramsel
66,Bergstraat 71,2023-03-08,02:00:00,0,0,0,FMN GV 11 Ramsel
66,Bergstraat 71,2023-03-08,03:00:00,0,0,0,FMN GV 11 Ramsel
66,Bergstraat 71,2023-03-08,04:00:00,4,4,0,FMN GV 11 Ramsel
66,Bergstraat 71,2023-03-08,05:00:00,8,4,4,FMN GV 11 Ramsel
66,Bergstraat 71,2023-03-08,06:00:00,4,2,2,FMN GV 11 Ramsel
66,Bergstraat 71,2023-03-08,07:00:00,68,10,58,FMN GV 11 Ramsel
66,Bergstraat 71,2023-03-08,08:00:00,92,10,82,FMN GV 11 Ramsel
66,Bergstraat 71,2023-03-08,09:00:00,10,6,4,FMN GV 11 Ramsel
66,Bergstraat 71,2023-03-08,10:00:00,6,2,4,FMN GV 11 Ramsel
66,Bergstraat 71,2023-03-08,11:00:00,36,28,8,FMN GV 11 Ramsel
66,Bergstraat 71,2023-03-08,12:00:00,100,86,14,FMN GV 11 Ramsel
66,Bergstraat 71,2023-03-08,13:00:00,30,20,10,FMN GV 11 Ramsel
66,Bergstraat 71,2023-03-08,14:00:00,32,16,16,FMN GV 11 Ramsel
66,Bergstraat 71,2023-03-08,15:00:00,36,32,4,FMN GV 11 Ramsel
66,Bergstraat 71,2023-03-08,16:00:00,28,16,12,FMN GV 11 Ramsel
66,Bergstraat 71,2023-03-08,17:00:00,28,14,14,FMN GV 11 Ramsel
66,Bergstraat 71,2023-03-08,18:00:00,18,12,6,FMN GV 11 Ramsel
66,Bergstraat 71,2023-03-08,19:00:00,8,4,4,FMN GV 11 Ramsel
66,Bergstraat 71,2023-03-08,20:00:00,8,4,4,FMN GV 11 Ramsel
66,Bergstraat 71,2023-03-08,21:00:00,8,6,2,FMN GV 11 Ramsel
66,Bergstraat 71,2023-03-08,22:00:00,4,0,4,FMN GV 11 Ramsel
66,Bergstraat 71,2023-03-08,23:00:00,0,0,0,FMN GV 11 Ramsel
66,Bergstraat 71,2023-03-09,00:00:00,0,0,0,FMN GV 11 Ramsel
66,Bergstraat 71,2023-03-09,01:00:00,0,0,0,FMN GV 11 Ramsel
66,Bergstraat 71,2023-03-09,02:00:00,0,0,0,FMN GV 11 Ramsel
66,Bergstraat 71,2023-03-09,03:00:00,0,0,0,FMN GV 11 Ramsel
66,Bergstraat 71,2023-03-09,04:00:00,4,4,0,FMN GV 11 Ramsel
66,Bergstraat 71,2023-03-09,05:00:00,6,2,4,FMN GV 11 Ramsel
66,Bergstraat 71,2023-03-09,06:00:00,18,6,12,FMN GV 11 Ramsel
66,Bergstraat 71,2023-03-09,07:00:00,136,30,106,FMN GV 11 Ramsel
66,Bergstraat 71,2023-03-09,08:00:00,134,12,122,FMN GV 11 Ramsel
66,Bergstraat 71,2023-03-09,09:00:00,24,6,18,FMN GV 11 Ramsel
66,Bergstraat 71,2023-03-09,10:00:00,34,28,6,FMN GV 11 Ramsel
66,Bergstraat 71,2023-03-09,11:00:00,32,22,10,FMN GV 11 Ramsel
66,Bergstraat 71,2023-03-09,12:00:00,18,8,10,FMN GV 11 Ramsel
66,Bergstraat 71,2023-03-09,13:00:00,14,8,6,FMN GV 11 Ramsel
66,Bergstraat 71,2023-03-09,14:00:00,52,34,18,FMN GV 11 Ramsel
66,Bergstraat 71,2023-03-09,15:00:00,122,96,26,FMN GV 11 Ramsel
66,Bergstraat 71,2023-03-09,16:00:00,122,100,22,FMN GV 11 Ramsel
66,Bergstraat 71,2023-03-09,17:00:00,60,34,26,FMN GV 11 Ramsel
66,Bergstraat 71,2023-03-09,18:00:00,24,16,8,FMN GV 11 Ramsel
66,Bergstraat 71,2023-03-09,19:00:00,16,10,6,FMN GV 11 Ramsel
66,Bergstraat 71,2023-03-09,20:00:00,12,10,2,FMN GV 11 Ramsel
66,Bergstraat 71,2023-03-09,21:00:00,6,2,4,FMN GV 11 Ramsel
66,Bergstraat 71,2023-03-09,22:00:00,8,6,2,FMN GV 11 Ramsel
66,Bergstraat 71,2023-03-09,23:00:00,4,4,0,FMN GV 11 Ramsel
66,Bergstraat 71,2023-03-10,00:00:00,4,4,0,FMN GV 11 Ramsel
66,Bergstraat 71,2023-03-10,01:00:00,2,2,0,FMN GV 11 Ramsel
66,Bergstraat 71,2023-03-10,02:00:00,0,0,0,FMN GV 11 Ramsel
66,Bergstraat 71,2023-03-10,03:00:00,0,0,0,FMN GV 11 Ramsel
66,Bergstraat 71,2023-03-10,04:00:00,6,4,2,FMN GV 11 Ramsel
66,Bergstraat 71,2023-03-10,05:00:00,6,4,2,FMN GV 11 Ramsel
66,Bergstraat 71,2023-03-10,06:00:00,14,6,8,FMN GV 11 Ramsel
66,Bergstraat 71,2023-03-10,07:00:00,142,18,124,FMN GV 11 Ramsel
66,Bergstraat 71,2023-03-10,08:00:00,154,12,142,FMN GV 11 Ramsel
66,Bergstraat 71,2023-03-10,09:00:00,18,8,10,FMN GV 11 Ramsel
66,Bergstraat 71,2023-03-10,10:00:00,18,6,12,FMN GV 11 Ramsel
66,Bergstraat 71,2023-03-10,11:00:00,20,10,10,FMN GV 11 Ramsel
66,Bergstraat 71,2023-03-10,12:00:00,40,26,14,FMN GV 11 Ramsel
66,Bergstraat 71,2023-03-10,13:00:00,26,20,6,FMN GV 11 Ramsel
66,Bergstraat 71,2023-03-10,14:00:00,44,30,14,FMN GV 11 Ramsel
66,Bergstraat 71,2023-03-10,15:00:00,114,108,6,FMN GV 11 Ramsel
66,Bergstraat 71,2023-03-10,16:00:00,94,90,4,FMN GV 11 Ramsel
66,Bergstraat 71,2023-03-10,17:00:00,22,14,8,FMN GV 11 Ramsel
66,Bergstraat 71,2023-03-10,18:00:00,26,20,6,FMN GV 11 Ramsel
66,Bergstraat 71,2023-03-10,19:00:00,2,0,2,FMN GV 11 Ramsel
66,Bergstraat 71,2023-03-10,20:00:00,20,6,14,FMN GV 11 Ramsel
66,Bergstraat 71,2023-03-10,21:00:00,4,2,2,FMN GV 11 Ramsel
66,Bergstraat 71,2023-03-10,22:00:00,10,4,6,FMN GV 11 Ramsel
66,Bergstraat 71,2023-03-10,23:00:00,2,2,0,FMN GV 11 Ramsel
66,Bergstraat 71,2023-03-11,00:00:00,2,2,0,FMN GV 11 Ramsel
66,Bergstraat 71,2023-03-11,01:00:00,8,4,4,FMN GV 11 Ramsel
66,Bergstraat 71,2023-03-11,02:00:00,10,10,0,FMN GV 11 Ramsel
66,Bergstraat 71,2023-03-11,03:00:00,2,2,0,FMN GV 11 Ramsel
66,Bergstraat 71,2023-03-11,04:00:00,6,4,2,FMN GV 11 Ramsel
66,Bergstraat 71,2023-03-11,05:00:00,0,0,0,FMN GV 11 Ramsel
66,Bergstraat 71,2023-03-11,06:00:00,0,0,0,FMN GV 11 Ramsel
66,Bergstraat 71,2023-03-11,07:00:00,6,2,4,FMN GV 11 Ramsel
66,Bergstraat 71,2023-03-11,08:00:00,16,2,14,FMN GV 11 Ramsel
66,Bergstraat 71,2023-03-11,09:00:00,20,8,12,FMN GV 11 Ramsel
66,Bergstraat 71,2023-03-11,10:00:00,76,38,38,FMN GV 11 Ramsel
66,Bergstraat 71,2023-03-11,11:00:00,78,40,38,FMN GV 11 Ramsel
66,Bergstraat 71,2023-03-11,12:00:00,118,54,64,FMN GV 11 Ramsel
66,Bergstraat 71,2023-03-11,13:00:00,198,72,126,FMN GV 11 Ramsel
66,Bergstraat 71,2023-03-11,14:00:00,210,90,120,FMN GV 11 Ramsel
66,Bergstraat 71,2023-03-11,15:00:00,162,104,58,FMN GV 11 Ramsel
66,Bergstraat 71,2023-03-11,16:00:00,142,90,52,FMN GV 11 Ramsel
66,Bergstraat 71,2023-03-11,17:00:00,76,34,42,FMN GV 11 Ramsel
66,Bergstraat 71,2023-03-11,18:00:00,22,18,4,FMN GV 11 Ramsel
66,Bergstraat 71,2023-03-11,19:00:00,16,10,6,FMN GV 11 Ramsel
66,Bergstraat 71,2023-03-11,20:00:00,8,4,4,FMN GV 11 Ramsel
66,Bergstraat 71,2023-03-11,21:00:00,6,2,4,FMN GV 11 Ramsel
66,Bergstraat 71,2023-03-11,22:00:00,6,2,4,FMN GV 11 Ramsel
66,Bergstraat 71,2023-03-11,23:00:00,4,4,0,FMN GV 11 Ramsel
66,Bergstraat 71,2023-03-12,00:00:00,4,4,0,FMN GV 11 Ramsel
66,Bergstraat 71,2023-03-12,01:00:00,0,0,0,FMN GV 11 Ramsel
66,Bergstraat 71,2023-03-12,02:00:00,2,2,0,FMN GV 11 Ramsel
66,Bergstraat 71,2023-03-12,03:00:00,4,4,0,FMN GV 11 Ramsel
66,Bergstraat 71,2023-03-12,04:00:00,0,0,0,FMN GV 11 Ramsel
66,Bergstraat 71,2023-03-12,05:00:00,0,0,0,FMN GV 11 Ramsel
66,Bergstraat 71,2023-03-12,06:00:00,2,2,0,FMN GV 11 Ramsel
66,Bergstraat 71,2023-03-12,07:00:00,10,2,8,FMN GV 11 Ramsel
66,Bergstraat 71,2023-03-12,08:00:00,52,8,44,FMN GV 11 Ramsel
66,Bergstraat 71,2023-03-12,09:00:00,90,46,44,FMN GV 11 Ramsel
66,Bergstraat 71,2023-03-12,10:00:00,54,26,28,FMN GV 11 Ramsel
66,Bergstraat 71,2023-03-12,11:00:00,88,70,18,FMN GV 11 Ramsel
66,Bergstraat 71,2023-03-12,12:00:00,76,58,18,FMN GV 11 Ramsel
66,Bergstraat 71,2023-03-12,13:00:00,68,20,48,FMN GV 11 Ramsel
66,Bergstraat 71,2023-03-12,14:00:00,74,32,42,FMN GV 11 Ramsel
66,Bergstraat 71,2023-03-12,15:00:00,64,30,34,FMN GV 11 Ramsel
66,Bergstraat 71,2023-03-12,16:00:00,58,36,22,FMN GV 11 Ramsel
66,Bergstraat 71,2023-03-12,17:00:00,54,14,40,FMN GV 11 Ramsel
66,Bergstraat 71,2023-03-12,18:00:00,8,2,6,FMN GV 11 Ramsel
66,Bergstraat 71,2023-03-12,19:00:00,8,6,2,FMN GV 11 Ramsel
66,Bergstraat 71,2023-03-12,20:00:00,4,4,0,FMN GV 11 Ramsel
66,Bergstraat 71,2023-03-12,21:00:00,2,2,0,FMN GV 11 Ramsel
66,Bergstraat 71,2023-03-12,22:00:00,2,2,0,FMN GV 11 Ramsel
66,Bergstraat 71,2023-03-12,23:00:00,2,2,0,FMN GV 11 Ramsel
66,Bergstraat 71,2023-03-13,00:00:00,2,2,0,FMN GV 11 Ramsel
66,Bergstraat 71,2023-03-13,01:00:00,0,0,0,FMN GV 11 Ramsel
66,Bergstraat 71,2023-03-13,02:00:00,0,0,0,FMN GV 11 Ramsel
66,Bergstraat 71,2023-03-13,03:00:00,0,0,0,FMN GV 11 Ramsel
66,Bergstraat 71,2023-03-13,04:00:00,4,4,0,FMN GV 11 Ramsel
66,Bergstraat 71,2023-03-13,05:00:00,14,10,4,FMN GV 11 Ramsel
66,Bergstraat 71,2023-03-13,06:00:00,24,10,14,FMN GV 11 Ramsel
66,Bergstraat 71,2023-03-13,07:00:00,154,22,132,FMN GV 11 Ramsel
66,Bergstraat 71,2023-03-13,08:00:00,150,14,136,FMN GV 11 Ramsel
66,Bergstraat 71,2023-03-13,09:00:00,24,8,16,FMN GV 11 Ramsel
66,Bergstraat 71,2023-03-13,10:00:00,36,26,10,FMN GV 11 Ramsel
66,Bergstraat 71,2023-03-13,11:00:00,28,6,22,FMN GV 11 Ramsel
66,Bergstraat 71,2023-03-13,12:00:00,34,22,12,FMN GV 11 Ramsel
66,Bergstraat 71,2023-03-13,13:00:00,74,40,34,FMN GV 11 Ramsel
66,Bergstraat 71,2023-03-13,14:00:00,96,38,58,FMN GV 11 Ramsel
66,Bergstraat 71,2023-03-13,15:00:00,198,160,38,FMN GV 11 Ramsel
66,Bergstraat 71,2023-03-13,16:00:00,148,114,34,FMN GV 11 Ramsel
66,Bergstraat 71,2023-03-13,17:00:00,64,36,28,FMN GV 11 Ramsel
66,Bergstraat 71,2023-03-13,18:00:00,34,20,14,FMN GV 11 Ramsel
66,Bergstraat 71,2023-03-13,19:00:00,44,14,30,FMN GV 11 Ramsel
66,Bergstraat 71,2023-03-13,20:00:00,16,8,8,FMN GV 11 Ramsel
66,Bergstraat 71,2023-03-13,21:00:00,12,10,2,FMN GV 11 Ramsel
66,Bergstraat 71,2023-03-13,22:00:00,4,4,0,FMN GV 11 Ramsel
66,Bergstraat 71,2023-03-13,23:00:00,2,2,0,FMN GV 11 Ramsel
66,Bergstraat 71,2023-03-14,00:00:00,2,0,2,FMN GV 11 Ramsel
66,Bergstraat 71,2023-03-14,01:00:00,0,0,0,FMN GV 11 Ramsel
66,Bergstraat 71,2023-03-14,02:00:00,0,0,0,FMN GV 11 Ramsel
66,Bergstraat 71,2023-03-14,03:00:00,4,2,2,FMN GV 11 Ramsel
66,Bergstraat 71,2023-03-14,04:00:00,6,4,2,FMN GV 11 Ramsel
66,Bergstraat 71,2023-03-14,05:00:00,14,8,6,FMN GV 11 Ramsel
66,Bergstraat 71,2023-03-14,06:00:00,20,10,10,FMN GV 11 Ramsel
66,Bergstraat 71,2023-03-14,07:00:00,134,16,118,FMN GV 11 Ramsel
66,Bergstraat 71,2023-03-14,08:00:00,108,14,94,FMN GV 11 Ramsel
66,Bergstraat 71,2023-03-14,09:00:00,18,2,16,FMN GV 11 Ramsel
66,Bergstraat 71,2023-03-14,10:00:00,24,8,16,FMN GV 11 Ramsel
66,Bergstraat 71,2023-03-14,11:00:00,16,14,2,FMN GV 11 Ramsel
66,Bergstraat 71,2023-03-14,12:00:00,12,6,6,FMN GV 11 Ramsel
66,Bergstraat 71,2023-03-14,13:00:00,36,10,26,FMN GV 11 Ramsel
66,Bergstraat 71,2023-03-14,14:00:00,50,32,18,FMN GV 11 Ramsel
66,Bergstraat 71,2023-03-14,15:00:00,106,92,14,FMN GV 11 Ramsel
66,Bergstraat 71,2023-03-14,16:00:00,66,54,12,FMN GV 11 Ramsel
66,Bergstraat 71,2023-03-14,17:00:00,70,52,18,FMN GV 11 Ramsel
66,Bergstraat 71,2023-03-14,18:00:00,48,22,26,FMN GV 11 Ramsel
66,Bergstraat 71,2023-03-14,19:00:00,34,12,22,FMN GV 11 Ramsel
66,Bergstraat 71,2023-03-14,20:00:00,22,14,8,FMN GV 11 Ramsel
66,Bergstraat 71,2023-03-14,21:00:00,12,8,4,FMN GV 11 Ramsel
66,Bergstraat 71,2023-03-14,22:00:00,6,6,0,FMN GV 11 Ramsel
66,Bergstraat 71,2023-03-14,23:00:00,0,0,0,FMN GV 11 Ramsel
66,Bergstraat 71,2023-03-15,00:00:00,0,0,0,FMN GV 11 Ramsel
66,Bergstraat 71,2023-03-15,01:00:00,0,0,0,FMN GV 11 Ramsel
66,Bergstraat 71,2023-03-15,02:00:00,0,0,0,FMN GV 11 Ramsel
66,Bergstraat 71,2023-03-15,03:00:00,2,0,2,FMN GV 11 Ramsel
66,Bergstraat 71,2023-03-15,04:00:00,6,4,2,FMN GV 11 Ramsel
66,Bergstraat 71,2023-03-15,05:00:00,14,6,8,FMN GV 11 Ramsel
66,Bergstraat 71,2023-03-15,06:00:00,20,12,8,FMN GV 11 Ramsel
66,Bergstraat 71,2023-03-15,07:00:00,168,22,146,FMN GV 11 Ramsel
66,Bergstraat 71,2023-03-15,08:00:00,142,10,132,FMN GV 11 Ramsel
66,Bergstraat 71,2023-03-15,09:00:00,42,16,26,FMN GV 11 Ramsel
66,Bergstraat 71,2023-03-15,10:00:00,56,28,28,FMN GV 11 Ramsel
66,Bergstraat 71,2023-03-15,11:00:00,64,44,20,FMN GV 11 Ramsel
66,Bergstraat 71,2023-03-15,12:00:00,262,236,26,FMN GV 11 Ramsel
66,Bergstraat 71,2023-03-15,13:00:00,78,30,48,FMN GV 11 Ramsel
66,Bergstraat 71,2023-03-15,14:00:00,112,48,64,FMN GV 11 Ramsel
66,Bergstraat 71,2023-03-15,15:00:00,94,58,36,FMN GV 11 Ramsel
66,Bergstraat 71,2023-03-15,16:00:00,100,68,32,FMN GV 11 Ramsel
66,Bergstraat 71,2023-03-15,17:00:00,112,70,42,FMN GV 11 Ramsel
66,Bergstraat 71,2023-03-15,18:00:00,88,54,34,FMN GV 11 Ramsel
66,Bergstraat 71,2023-03-15,19:00:00,40,20,20,FMN GV 11 Ramsel
66,Bergstraat 71,2023-03-15,20:00:00,20,8,12,FMN GV 11 Ramsel
66,Bergstraat 71,2023-03-15,21:00:00,24,22,2,FMN GV 11 Ramsel
66,Bergstraat 71,2023-03-15,22:00:00,12,10,2,FMN GV 11 Ramsel
66,Bergstraat 71,2023-03-15,23:00:00,2,2,0,FMN GV 11 Ramsel
66,Bergstraat 71,2023-03-16,00:00:00,2,2,0,FMN GV 11 Ramsel
66,Bergstraat 71,2023-03-16,01:00:00,2,0,2,FMN GV 11 Ramsel
66,Bergstraat 71,2023-03-16,02:00:00,0,0,0,FMN GV 11 Ramsel
66,Bergstraat 71,2023-03-16,03:00:00,0,0,0,FMN GV 11 Ramsel
66,Bergstraat 71,2023-03-16,04:00:00,8,4,4,FMN GV 11 Ramsel
66,Bergstraat 71,2023-03-16,05:00:00,14,8,6,FMN GV 11 Ramsel
66,Bergstraat 71,2023-03-16,06:00:00,22,6,16,FMN GV 11 Ramsel
66,Bergstraat 71,2023-03-16,07:00:00,178,26,152,FMN GV 11 Ramsel
66,Bergstraat 71,2023-03-16,08:00:00,224,42,182,FMN GV 11 Ramsel
66,Bergstraat 71,2023-03-16,09:00:00,54,12,42,FMN GV 11 Ramsel
66,Bergstraat 71,2023-03-16,10:00:00,40,20,20,FMN GV 11 Ramsel
66,Bergstraat 71,2023-03-16,11:00:00,74,42,32,FMN GV 11 Ramsel
66,Bergstraat 71,2023-03-16,12:00:00,90,40,50,FMN GV 11 Ramsel
66,Bergstraat 71,2023-03-16,13:00:00,116,44,72,FMN GV 11 Ramsel
66,Bergstraat 71,2023-03-16,14:00:00,144,70,74,FMN GV 11 Ramsel
66,Bergstraat 71,2023-03-16,15:00:00,270,218,52,FMN GV 11 Ramsel
66,Bergstraat 71,2023-03-16,16:00:00,232,170,62,FMN GV 11 Ramsel
66,Bergstraat 71,2023-03-16,17:00:00,102,60,42,FMN GV 11 Ramsel
66,Bergstraat 71,2023-03-16,18:00:00,82,44,38,FMN GV 11 Ramsel
66,Bergstraat 71,2023-03-16,19:00:00,24,8,16,FMN GV 11 Ramsel
66,Bergstraat 71,2023-03-16,20:00:00,22,16,6,FMN GV 11 Ramsel
66,Bergstraat 71,2023-03-16,21:00:00,12,12,0,FMN GV 11 Ramsel
66,Bergstraat 71,2023-03-16,22:00:00,26,24,2,FMN GV 11 Ramsel
66,Bergstraat 71,2023-03-16,23:00:00,8,6,2,FMN GV 11 Ramsel
66,Bergstraat 71,2023-03-17,00:00:00,0,0,0,FMN GV 11 Ramsel
66,Bergstraat 71,2023-03-17,01:00:00,2,2,0,FMN GV 11 Ramsel
66,Bergstraat 71,2023-03-17,02:00:00,2,0,2,FMN GV 11 Ramsel
66,Bergstraat 71,2023-03-17,03:00:00,2,0,2,FMN GV 11 Ramsel
66,Bergstraat 71,2023-03-17,04:00:00,12,8,4,FMN GV 11 Ramsel
66,Bergstraat 71,2023-03-17,05:00:00,20,12,8,FMN GV 11 Ramsel
66,Bergstraat 71,2023-03-17,06:00:00,30,12,18,FMN GV 11 Ramsel
66,Bergstraat 71,2023-03-17,07:00:00,160,26,134,FMN GV 11 Ramsel
66,Bergstraat 71,2023-03-17,08:00:00,196,28,168,FMN GV 11 Ramsel
66,Bergstraat 71,2023-03-17,09:00:00,82,24,58,FMN GV 11 Ramsel
66,Bergstraat 71,2023-03-17,10:00:00,66,40,26,FMN GV 11 Ramsel
66,Bergstraat 71,2023-03-17,11:00:00,64,18,46,FMN GV 11 Ramsel
66,Bergstraat 71,2023-03-17,12:00:00,86,36,50,FMN GV 11 Ramsel
66,Bergstraat 71,2023-03-17,13:00:00,134,44,90,FMN GV 11 Ramsel
66,Bergstraat 71,2023-03-17,14:00:00,214,126,88,FMN GV 11 Ramsel
66,Bergstraat 71,2023-03-17,15:00:00,282,210,72,FMN GV 11 Ramsel
66,Bergstraat 71,2023-03-17,16:00:00,196,136,60,FMN GV 11 Ramsel
66,Bergstraat 71,2023-03-17,17:00:00,120,74,46,FMN GV 11 Ramsel
66,Bergstraat 71,2023-03-17,18:00:00,86,54,32,FMN GV 11 Ramsel
66,Bergstraat 71,2023-03-17,19:00:00,32,14,18,FMN GV 11 Ramsel
66,Bergstraat 71,2023-03-17,20:00:00,20,8,12,FMN GV 11 Ramsel
66,Bergstraat 71,2023-03-17,21:00:00,26,18,8,FMN GV 11 Ramsel
66,Bergstraat 71,2023-03-17,22:00:00,24,12,12,FMN GV 11 Ramsel
66,Bergstraat 71,2023-03-17,23:00:00,24,6,18,FMN GV 11 Ramsel
66,Bergstraat 71,2023-03-18,00:00:00,6,2,4,FMN GV 11 Ramsel
66,Bergstraat 71,2023-03-18,01:00:00,6,6,0,FMN GV 11 Ramsel
66,Bergstraat 71,2023-03-18,02:00:00,22,22,0,FMN GV 11 Ramsel
66,Bergstraat 71,2023-03-18,03:00:00,4,0,4,FMN GV 11 Ramsel
66,Bergstraat 71,2023-03-18,04:00:00,12,10,2,FMN GV 11 Ramsel
66,Bergstraat 71,2023-03-18,05:00:00,4,4,0,FMN GV 11 Ramsel
66,Bergstraat 71,2023-03-18,06:00:00,4,2,2,FMN GV 11 Ramsel
66,Bergstraat 71,2023-03-18,07:00:00,14,6,8,FMN GV 11 Ramsel
66,Bergstraat 71,2023-03-18,08:00:00,32,10,22,FMN GV 11 Ramsel
66,Bergstraat 71,2023-03-18,09:00:00,70,24,46,FMN GV 11 Ramsel
66,Bergstraat 71,2023-03-18,10:00:00,152,66,86,FMN GV 11 Ramsel
66,Bergstraat 71,2023-03-18,11:00:00,110,48,62,FMN GV 11 Ramsel
66,Bergstraat 71,2023-03-18,12:00:00,126,82,44,FMN GV 11 Ramsel
66,Bergstraat 71,2023-03-18,13:00:00,128,66,62,FMN GV 11 Ramsel
66,Bergstraat 71,2023-03-18,14:00:00,176,92,84,FMN GV 11 Ramsel
66,Bergstraat 71,2023-03-18,15:00:00,142,88,54,FMN GV 11 Ramsel
66,Bergstraat 71,2023-03-18,16:00:00,80,48,32,FMN GV 11 Ramsel
66,Bergstraat 71,2023-03-18,17:00:00,66,38,28,FMN GV 11 Ramsel
66,Bergstraat 71,2023-03-18,18:00:00,34,16,18,FMN GV 11 Ramsel
66,Bergstraat 71,2023-03-18,19:00:00,12,6,6,FMN GV 11 Ramsel
66,Bergstraat 71,2023-03-18,20:00:00,12,10,2,FMN GV 11 Ramsel
66,Bergstraat 71,2023-03-18,21:00:00,8,8,0,FMN GV 11 Ramsel
66,Bergstraat 71,2023-03-18,22:00:00,12,8,4,FMN GV 11 Ramsel
66,Bergstraat 71,2023-03-18,23:00:00,2,2,0,FMN GV 11 Ramsel
66,Bergstraat 71,2023-03-19,00:00:00,4,4,0,FMN GV 11 Ramsel
66,Bergstraat 71,2023-03-19,01:00:00,6,6,0,FMN GV 11 Ramsel
66,Bergstraat 71,2023-03-19,02:00:00,2,2,0,FMN GV 11 Ramsel
66,Bergstraat 71,2023-03-19,03:00:00,4,4,0,FMN GV 11 Ramsel
66,Bergstraat 71,2023-03-19,04:00:00,2,0,2,FMN GV 11 Ramsel
66,Bergstraat 71,2023-03-19,05:00:00,0,0,0,FMN GV 11 Ramsel
66,Bergstraat 71,2023-03-19,06:00:00,10,0,10,FMN GV 11 Ramsel
66,Bergstraat 71,2023-03-19,07:00:00,14,12,2,FMN GV 11 Ramsel
66,Bergstraat 71,2023-03-19,08:00:00,82,30,52,FMN GV 11 Ramsel
66,Bergstraat 71,2023-03-19,09:00:00,120,34,86,FMN GV 11 Ramsel
66,Bergstraat 71,2023-03-19,10:00:00,174,82,92,FMN GV 11 Ramsel
66,Bergstraat 71,2023-03-19,11:00:00,186,122,64,FMN GV 11 Ramsel
66,Bergstraat 71,2023-03-19,12:00:00,140,90,50,FMN GV 11 Ramsel
66,Bergstraat 71,2023-03-19,13:00:00,150,72,78,FMN GV 11 Ramsel
66,Bergstraat 71,2023-03-19,14:00:00,168,78,90,FMN GV 11 Ramsel
66,Bergstraat 71,2023-03-19,15:00:00,178,110,68,FMN GV 11 Ramsel
66,Bergstraat 71,2023-03-19,16:00:00,116,66,50,FMN GV 11 Ramsel
66,Bergstraat 71,2023-03-19,17:00:00,96,52,44,FMN GV 11 Ramsel
66,Bergstraat 71,2023-03-19,18:00:00,24,12,12,FMN GV 11 Ramsel
66,Bergstraat 71,2023-03-19,19:00:00,26,12,14,FMN GV 11 Ramsel
66,Bergstraat 71,2023-03-19,20:00:00,10,4,6,FMN GV 11 Ramsel
66,Bergstraat 71,2023-03-19,21:00:00,2,0,2,FMN GV 11 Ramsel
66,Bergstraat 71,2023-03-19,22:00:00,10,4,6,FMN GV 11 Ramsel
66,Bergstraat 71,2023-03-19,23:00:00,2,0,2,FMN GV 11 Ramsel
66,Bergstraat 71,2023-03-20,00:00:00,4,2,2,FMN GV 11 Ramsel
66,Bergstraat 71,2023-03-20,01:00:00,2,2,0,FMN GV 11 Ramsel
66,Bergstraat 71,2023-03-20,02:00:00,0,0,0,FMN GV 11 Ramsel
66,Bergstraat 71,2023-03-20,03:00:00,0,0,0,FMN GV 11 Ramsel
66,Bergstraat 71,2023-03-20,04:00:00,6,4,2,FMN GV 11 Ramsel
66,Bergstraat 71,2023-03-20,05:00:00,10,4,6,FMN GV 11 Ramsel
66,Bergstraat 71,2023-03-20,06:00:00,42,18,24,FMN GV 11 Ramsel
66,Bergstraat 71,2023-03-20,07:00:00,220,16,204,FMN GV 11 Ramsel
66,Bergstraat 71,2023-03-20,08:00:00,186,24,162,FMN GV 11 Ramsel
66,Bergstraat 71,2023-03-20,09:00:00,54,28,26,FMN GV 11 Ramsel
66,Bergstraat 71,2023-03-20,10:00:00,50,24,26,FMN GV 11 Ramsel
66,Bergstraat 71,2023-03-20,11:00:00,48,26,22,FMN GV 11 Ramsel
66,Bergstraat 71,2023-03-20,12:00:00,58,34,24,FMN GV 11 Ramsel
66,Bergstraat 71,2023-03-20,13:00:00,126,68,58,FMN GV 11 Ramsel
66,Bergstraat 71,2023-03-20,14:00:00,102,64,38,FMN GV 11 Ramsel
66,Bergstraat 71,2023-03-20,15:00:00,200,162,38,FMN GV 11 Ramsel
66,Bergstraat 71,2023-03-20,16:00:00,154,124,30,FMN GV 11 Ramsel
66,Bergstraat 71,2023-03-20,17:00:00,74,56,18,FMN GV 11 Ramsel
66,Bergstraat 71,2023-03-20,18:00:00,52,22,30,FMN GV 11 Ramsel
66,Bergstraat 71,2023-03-20,19:00:00,24,6,18,FMN GV 11 Ramsel
66,Bergstraat 71,2023-03-20,20:00:00,24,12,12,FMN GV 11 Ramsel
66,Bergstraat 71,2023-03-20,21:00:00,12,10,2,FMN GV 11 Ramsel
66,Bergstraat 71,2023-03-20,22:00:00,6,4,2,FMN GV 11 Ramsel
66,Bergstraat 71,2023-03-20,23:00:00,0,0,0,FMN GV 11 Ramsel
66,Bergstraat 71,2023-03-21,00:00:00,0,0,0,FMN GV 11 Ramsel
66,Bergstraat 71,2023-03-21,01:00:00,0,0,0,FMN GV 11 Ramsel
66,Bergstraat 71,2023-03-21,02:00:00,0,0,0,FMN GV 11 Ramsel
66,Bergstraat 71,2023-03-21,03:00:00,0,0,0,FMN GV 11 Ramsel
66,Bergstraat 71,2023-03-21,04:00:00,2,2,0,FMN GV 11 Ramsel
66,Bergstraat 71,2023-03-21,05:00:00,16,10,6,FMN GV 11 Ramsel
66,Bergstraat 71,2023-03-21,06:00:00,26,6,20,FMN GV 11 Ramsel
66,Bergstraat 71,2023-03-21,07:00:00,156,30,126,FMN GV 11 Ramsel
66,Bergstraat 71,2023-03-21,08:00:00,150,12,138,FMN GV 11 Ramsel
66,Bergstraat 71,2023-03-21,09:00:00,24,10,14,FMN GV 11 Ramsel
66,Bergstraat 71,2023-03-21,10:00:00,32,20,12,FMN GV 11 Ramsel
66,Bergstraat 71,2023-03-21,11:00:00,40,22,18,FMN GV 11 Ramsel
66,Bergstraat 71,2023-03-21,12:00:00,58,36,22,FMN GV 11 Ramsel
66,Bergstraat 71,2023-03-21,13:00:00,106,54,52,FMN GV 11 Ramsel
66,Bergstraat 71,2023-03-21,14:00:00,174,98,76,FMN GV 11 Ramsel
66,Bergstraat 71,2023-03-21,15:00:00,186,134,52,FMN GV 11 Ramsel
66,Bergstraat 71,2023-03-21,16:00:00,144,100,44,FMN GV 11 Ramsel
66,Bergstraat 71,2023-03-21,17:00:00,94,64,30,FMN GV 11 Ramsel
66,Bergstraat 71,2023-03-21,18:00:00,78,52,26,FMN GV 11 Ramsel
66,Bergstraat 71,2023-03-21,19:00:00,56,20,36,FMN GV 11 Ramsel
66,Bergstraat 71,2023-03-21,20:00:00,30,20,10,FMN GV 11 Ramsel
66,Bergstraat 71,2023-03-21,21:00:00,18,16,2,FMN GV 11 Ramsel
66,Bergstraat 71,2023-03-21,22:00:00,16,10,6,FMN GV 11 Ramsel
66,Bergstraat 71,2023-03-21,23:00:00,2,2,0,FMN GV 11 Ramsel
66,Bergstraat 71,2023-03-22,00:00:00,2,2,0,FMN GV 11 Ramsel
66,Bergstraat 71,2023-03-22,01:00:00,0,0,0,FMN GV 11 Ramsel
66,Bergstraat 71,2023-03-22,02:00:00,0,0,0,FMN GV 11 Ramsel
66,Bergstraat 71,2023-03-22,03:00:00,0,0,0,FMN GV 11 Ramsel
66,Bergstraat 71,2023-03-22,04:00:00,6,4,2,FMN GV 11 Ramsel
66,Bergstraat 71,2023-03-22,05:00:00,18,8,10,FMN GV 11 Ramsel
66,Bergstraat 71,2023-03-22,06:00:00,20,10,10,FMN GV 11 Ramsel
66,Bergstraat 71,2023-03-22,07:00:00,170,26,144,FMN GV 11 Ramsel
66,Bergstraat 71,2023-03-22,08:00:00,176,20,156,FMN GV 11 Ramsel
66,Bergstraat 71,2023-03-22,09:00:00,42,6,36,FMN GV 11 Ramsel
66,Bergstraat 71,2023-03-22,10:00:00,32,18,14,FMN GV 11 Ramsel
66,Bergstraat 71,2023-03-22,11:00:00,58,54,4,FMN GV 11 Ramsel
66,Bergstraat 71,2023-03-22,12:00:00,222,214,8,FMN GV 11 Ramsel
66,Bergstraat 71,2023-03-22,13:00:00,54,24,30,FMN GV 11 Ramsel
66,Bergstraat 71,2023-03-22,14:00:00,70,46,24,FMN GV 11 Ramsel
66,Bergstraat 71,2023-03-22,15:00:00,78,42,36,FMN GV 11 Ramsel
66,Bergstraat 71,2023-03-22,16:00:00,86,52,34,FMN GV 11 Ramsel
66,Bergstraat 71,2023-03-22,17:00:00,68,44,24,FMN GV 11 Ramsel
66,Bergstraat 71,2023-03-22,18:00:00,46,30,16,FMN GV 11 Ramsel
66,Bergstraat 71,2023-03-22,19:00:00,38,16,22,FMN GV 11 Ramsel
66,Bergstraat 71,2023-03-22,20:00:00,18,14,4,FMN GV 11 Ramsel
66,Bergstraat 71,2023-03-22,21:00:00,8,6,2,FMN GV 11 Ramsel
66,Bergstraat 71,2023-03-22,22:00:00,14,4,10,FMN GV 11 Ramsel
66,Bergstraat 71,2023-03-22,23:00:00,0,0,0,FMN GV 11 Ramsel
66,Bergstraat 71,2023-03-23,00:00:00,2,2,0,FMN GV 11 Ramsel
66,Bergstraat 71,2023-03-23,01:00:00,0,0,0,FMN GV 11 Ramsel
66,Bergstraat 71,2023-03-23,02:00:00,2,2,0,FMN GV 11 Ramsel
66,Bergstraat 71,2023-03-23,03:00:00,2,0,2,FMN GV 11 Ramsel
66,Bergstraat 71,2023-03-23,04:00:00,10,6,4,FMN GV 11 Ramsel
66,Bergstraat 71,2023-03-23,05:00:00,14,6,8,FMN GV 11 Ramsel
66,Bergstraat 71,2023-03-23,06:00:00,38,12,26,FMN GV 11 Ramsel
66,Bergstraat 71,2023-03-23,07:00:00,196,26,170,FMN GV 11 Ramsel
66,Bergstraat 71,2023-03-23,08:00:00,140,12,128,FMN GV 11 Ramsel
66,Bergstraat 71,2023-03-23,09:00:00,20,6,14,FMN GV 11 Ramsel
66,Bergstraat 71,2023-03-23,10:00:00,22,16,6,FMN GV 11 Ramsel
66,Bergstraat 71,2023-03-23,11:00:00,46,22,24,FMN GV 11 Ramsel
66,Bergstraat 71,2023-03-23,12:00:00,88,74,14,FMN GV 11 Ramsel
66,Bergstraat 71,2023-03-23,13:00:00,60,32,28,FMN GV 11 Ramsel
66,Bergstraat 71,2023-03-23,14:00:00,78,46,32,FMN GV 11 Ramsel
66,Bergstraat 71,2023-03-23,15:00:00,184,148,36,FMN GV 11 Ramsel
66,Bergstraat 71,2023-03-23,16:00:00,112,86,26,FMN GV 11 Ramsel
66,Bergstraat 71,2023-03-23,17:00:00,76,52,24,FMN GV 11 Ramsel
66,Bergstraat 71,2023-03-23,18:00:00,60,32,28,FMN GV 11 Ramsel
66,Bergstraat 71,2023-03-23,19:00:00,22,16,6,FMN GV 11 Ramsel
66,Bergstraat 71,2023-03-23,20:00:00,22,6,16,FMN GV 11 Ramsel
66,Bergstraat 71,2023-03-23,21:00:00,8,8,0,FMN GV 11 Ramsel
66,Bergstraat 71,2023-03-23,22:00:00,14,12,2,FMN GV 11 Ramsel
66,Bergstraat 71,2023-03-23,23:00:00,12,8,4,FMN GV 11 Ramsel
66,Bergstraat 71,2023-03-24,00:00:00,0,0,0,FMN GV 11 Ramsel
66,Bergstraat 71,2023-03-24,01:00:00,0,0,0,FMN GV 11 Ramsel
66,Bergstraat 71,2023-03-24,02:00:00,0,0,0,FMN GV 11 Ramsel
66,Bergstraat 71,2023-03-24,03:00:00,0,0,0,FMN GV 11 Ramsel
66,Bergstraat 71,2023-03-24,04:00:00,10,6,4,FMN GV 11 Ramsel
66,Bergstraat 71,2023-03-24,05:00:00,14,8,6,FMN GV 11 Ramsel
66,Bergstraat 71,2023-03-24,06:00:00,14,8,6,FMN GV 11 Ramsel
66,Bergstraat 71,2023-03-24,07:00:00,158,14,144,FMN GV 11 Ramsel
66,Bergstraat 71,2023-03-24,08:00:00,182,26,156,FMN GV 11 Ramsel
66,Bergstraat 71,2023-03-24,09:00:00,56,16,40,FMN GV 11 Ramsel
66,Bergstraat 71,2023-03-24,10:00:00,96,66,30,FMN GV 11 Ramsel
66,Bergstraat 71,2023-03-24,11:00:00,62,40,22,FMN GV 11 Ramsel
66,Bergstraat 71,2023-03-24,12:00:00,96,72,24,FMN GV 11 Ramsel
66,Bergstraat 71,2023-03-24,13:00:00,38,28,10,FMN GV 11 Ramsel
66,Bergstraat 71,2023-03-24,14:00:00,54,40,14,FMN GV 11 Ramsel
66,Bergstraat 71,2023-03-24,15:00:00,126,98,28,FMN GV 11 Ramsel
66,Bergstraat 71,2023-03-24,16:00:00,74,52,22,FMN GV 11 Ramsel
66,Bergstraat 71,2023-03-24,17:00:00,64,38,26,FMN GV 11 Ramsel
66,Bergstraat 71,2023-03-24,18:00:00,74,50,24,FMN GV 11 Ramsel
66,Bergstraat 71,2023-03-24,19:00:00,34,8,26,FMN GV 11 Ramsel
66,Bergstraat 71,2023-03-24,20:00:00,24,20,4,FMN GV 11 Ramsel
66,Bergstraat 71,2023-03-24,21:00:00,16,14,2,FMN GV 11 Ramsel
66,Bergstraat 71,2023-03-24,22:00:00,10,6,4,FMN GV 11 Ramsel
66,Bergstraat 71,2023-03-24,23:00:00,8,6,2,FMN GV 11 Ramsel
66,Bergstraat 71,2023-03-25,00:00:00,2,2,0,FMN GV 11 Ramsel
66,Bergstraat 71,2023-03-25,01:00:00,10,8,2,FMN GV 11 Ramsel
66,Bergstraat 71,2023-03-25,02:00:00,4,4,0,FMN GV 11 Ramsel
66,Bergstraat 71,2023-03-25,03:00:00,0,0,0,FMN GV 11 Ramsel
66,Bergstraat 71,2023-03-25,04:00:00,4,2,2,FMN GV 11 Ramsel
66,Bergstraat 71,2023-03-25,05:00:00,2,2,0,FMN GV 11 Ramsel
66,Bergstraat 71,2023-03-25,06:00:00,2,2,0,FMN GV 11 Ramsel
66,Bergstraat 71,2023-03-25,07:00:00,10,4,6,FMN GV 11 Ramsel
66,Bergstraat 71,2023-03-25,08:00:00,54,10,44,FMN GV 11 Ramsel
66,Bergstraat 71,2023-03-25,09:00:00,42,24,18,FMN GV 11 Ramsel
66,Bergstraat 71,2023-03-25,10:00:00,54,34,20,FMN GV 11 Ramsel
66,Bergstraat 71,2023-03-25,11:00:00,56,32,24,FMN GV 11 Ramsel
66,Bergstraat 71,2023-03-25,12:00:00,52,42,10,FMN GV 11 Ramsel
66,Bergstraat 71,2023-03-25,13:00:00,54,32,22,FMN GV 11 Ramsel
66,Bergstraat 71,2023-03-25,14:00:00,26,14,12,FMN GV 11 Ramsel
66,Bergstraat 71,2023-03-25,15:00:00,32,16,16,FMN GV 11 Ramsel
66,Bergstraat 71,2023-03-25,16:00:00,14,4,10,FMN GV 11 Ramsel
66,Bergstraat 71,2023-03-25,17:00:00,12,4,8,FMN GV 11 Ramsel
66,Bergstraat 71,2023-03-25,18:00:00,24,16,8,FMN GV 11 Ramsel
66,Bergstraat 71,2023-03-25,19:00:00,24,14,10,FMN GV 11 Ramsel
66,Bergstraat 71,2023-03-25,20:00:00,4,2,2,FMN GV 11 Ramsel
66,Bergstraat 71,2023-03-25,21:00:00,14,6,8,FMN GV 11 Ramsel
66,Bergstraat 71,2023-03-25,22:00:00,16,8,8,FMN GV 11 Ramsel
66,Bergstraat 71,2023-03-25,23:00:00,12,6,6,FMN GV 11 Ramsel
66,Bergstraat 71,2023-03-26,00:00:00,14,14,0,FMN GV 11 Ramsel
66,Bergstraat 71,2023-03-26,01:00:00,12,8,4,FMN GV 11 Ramsel
66,Bergstraat 71,2023-03-26,02:00:00,0,0,0,FMN GV 11 Ramsel
66,Bergstraat 71,2023-03-26,03:00:00,4,2,2,FMN GV 11 Ramsel
66,Bergstraat 71,2023-03-26,04:00:00,6,0,6,FMN GV 11 Ramsel
66,Bergstraat 71,2023-03-26,05:00:00,16,6,10,FMN GV 11 Ramsel
66,Bergstraat 71,2023-03-26,06:00:00,0,0,0,FMN GV 11 Ramsel
66,Bergstraat 71,2023-03-26,07:00:00,8,0,8,FMN GV 11 Ramsel
66,Bergstraat 71,2023-03-26,08:00:00,14,8,6,FMN GV 11 Ramsel
66,Bergstraat 71,2023-03-26,09:00:00,8,2,6,FMN GV 11 Ramsel
66,Bergstraat 71,2023-03-26,10:00:00,20,12,8,FMN GV 11 Ramsel
66,Bergstraat 71,2023-03-26,11:00:00,26,24,2,FMN GV 11 Ramsel
66,Bergstraat 71,2023-03-26,12:00:00,2,2,0,FMN GV 11 Ramsel
66,Bergstraat 71,2023-03-26,13:00:00,4,2,2,FMN GV 11 Ramsel
66,Bergstraat 71,2023-03-26,14:00:00,2,2,0,FMN GV 11 Ramsel
66,Bergstraat 71,2023-03-26,15:00:00,12,2,10,FMN GV 11 Ramsel
66,Bergstraat 71,2023-03-26,16:00:00,6,6,0,FMN GV 11 Ramsel
66,Bergstraat 71,2023-03-26,17:00:00,8,2,6,FMN GV 11 Ramsel
66,Bergstraat 71,2023-03-26,18:00:00,12,6,6,FMN GV 11 Ramsel
66,Bergstraat 71,2023-03-26,19:00:00,2,0,2,FMN GV 11 Ramsel
66,Bergstraat 71,2023-03-26,20:00:00,16,8,8,FMN GV 11 Ramsel
66,Bergstraat 71,2023-03-26,21:00:00,2,2,0,FMN GV 11 Ramsel
66,Bergstraat 71,2023-03-26,22:00:00,0,0,0,FMN GV 11 Ramsel
66,Bergstraat 71,2023-03-26,23:00:00,2,2,0,FMN GV 11 Ramsel
66,Bergstraat 71,2023-03-27,00:00:00,0,0,0,FMN GV 11 Ramsel
66,Bergstraat 71,2023-03-27,01:00:00,0,0,0,FMN GV 11 Ramsel
66,Bergstraat 71,2023-03-27,02:00:00,2,2,0,FMN GV 11 Ramsel
66,Bergstraat 71,2023-03-27,03:00:00,0,0,0,FMN GV 11 Ramsel
66,Bergstraat 71,2023-03-27,04:00:00,4,4,0,FMN GV 11 Ramsel
66,Bergstraat 71,2023-03-27,05:00:00,16,10,6,FMN GV 11 Ramsel
66,Bergstraat 71,2023-03-27,06:00:00,28,6,22,FMN GV 11 Ramsel
66,Bergstraat 71,2023-03-27,07:00:00,180,34,146,FMN GV 11 Ramsel
66,Bergstraat 71,2023-03-27,08:00:00,118,10,108,FMN GV 11 Ramsel
66,Bergstraat 71,2023-03-27,09:00:00,20,12,8,FMN GV 11 Ramsel
66,Bergstraat 71,2023-03-27,10:00:00,74,56,18,FMN GV 11 Ramsel
66,Bergstraat 71,2023-03-27,11:00:00,50,32,18,FMN GV 11 Ramsel
66,Bergstraat 71,2023-03-27,12:00:00,98,72,26,FMN GV 11 Ramsel
66,Bergstraat 71,2023-03-27,13:00:00,46,34,12,FMN GV 11 Ramsel
66,Bergstraat 71,2023-03-27,14:00:00,92,42,50,FMN GV 11 Ramsel
66,Bergstraat 71,2023-03-27,15:00:00,112,96,16,FMN GV 11 Ramsel
66,Bergstraat 71,2023-03-27,16:00:00,112,86,26,FMN GV 11 Ramsel
66,Bergstraat 71,2023-03-27,17:00:00,94,64,30,FMN GV 11 Ramsel
66,Bergstraat 71,2023-03-27,18:00:00,54,22,32,FMN GV 11 Ramsel
66,Bergstraat 71,2023-03-27,19:00:00,58,34,24,FMN GV 11 Ramsel
66,Bergstraat 71,2023-03-27,20:00:00,26,18,8,FMN GV 11 Ramsel
66,Bergstraat 71,2023-03-27,21:00:00,12,6,6,FMN GV 11 Ramsel
66,Bergstraat 71,2023-03-27,22:00:00,8,4,4,FMN GV 11 Ramsel
66,Bergstraat 71,2023-03-27,23:00:00,2,2,0,FMN GV 11 Ramsel
66,Bergstraat 71,2023-03-28,00:00:00,0,0,0,FMN GV 11 Ramsel
66,Bergstraat 71,2023-03-28,01:00:00,2,2,0,FMN GV 11 Ramsel
66,Bergstraat 71,2023-03-28,02:00:00,2,0,2,FMN GV 11 Ramsel
66,Bergstraat 71,2023-03-28,03:00:00,0,0,0,FMN GV 11 Ramsel
66,Bergstraat 71,2023-03-28,04:00:00,4,4,0,FMN GV 11 Ramsel
66,Bergstraat 71,2023-03-28,05:00:00,12,10,2,FMN GV 11 Ramsel
66,Bergstraat 71,2023-03-28,06:00:00,26,12,14,FMN GV 11 Ramsel
66,Bergstraat 71,2023-03-28,07:00:00,188,30,158,FMN GV 11 Ramsel
66,Bergstraat 71,2023-03-28,08:00:00,102,12,90,FMN GV 11 Ramsel
66,Bergstraat 71,2023-03-28,09:00:00,44,14,30,FMN GV 11 Ramsel
66,Bergstraat 71,2023-03-28,10:00:00,88,64,24,FMN GV 11 Ramsel
66,Bergstraat 71,2023-03-28,11:00:00,58,30,28,FMN GV 11 Ramsel
66,Bergstraat 71,2023-03-28,12:00:00,102,60,42,FMN GV 11 Ramsel
66,Bergstraat 71,2023-03-28,13:00:00,158,64,94,FMN GV 11 Ramsel
66,Bergstraat 71,2023-03-28,14:00:00,134,64,70,FMN GV 11 Ramsel
66,Bergstraat 71,2023-03-28,15:00:00,160,130,30,FMN GV 11 Ramsel
66,Bergstraat 71,2023-03-28,16:00:00,182,126,56,FMN GV 11 Ramsel
66,Bergstraat 71,2023-03-28,17:00:00,122,68,54,FMN GV 11 Ramsel
66,Bergstraat 71,2023-03-28,18:00:00,86,46,40,FMN GV 11 Ramsel
66,Bergstraat 71,2023-03-28,19:00:00,48,20,28,FMN GV 11 Ramsel
66,Bergstraat 71,2023-03-28,20:00:00,26,18,8,FMN GV 11 Ramsel
66,Bergstraat 71,2023-03-28,21:00:00,16,10,6,FMN GV 11 Ramsel
66,Bergstraat 71,2023-03-28,22:00:00,18,16,2,FMN GV 11 Ramsel
66,Bergstraat 71,2023-03-28,23:00:00,2,2,0,FMN GV 11 Ramsel
66,Bergstraat 71,2023-03-29,00:00:00,0,0,0,FMN GV 11 Ramsel
66,Bergstraat 71,2023-03-29,01:00:00,2,2,0,FMN GV 11 Ramsel
66,Bergstraat 71,2023-03-29,02:00:00,0,0,0,FMN GV 11 Ramsel
66,Bergstraat 71,2023-03-29,03:00:00,0,0,0,FMN GV 11 Ramsel
66,Bergstraat 71,2023-03-29,04:00:00,6,6,0,FMN GV 11 Ramsel
66,Bergstraat 71,2023-03-29,05:00:00,18,8,10,FMN GV 11 Ramsel
66,Bergstraat 71,2023-03-29,06:00:00,28,18,10,FMN GV 11 Ramsel
66,Bergstraat 71,2023-03-29,07:00:00,112,26,86,FMN GV 11 Ramsel
66,Bergstraat 71,2023-03-29,08:00:00,88,28,60,FMN GV 11 Ramsel
66,Bergstraat 71,2023-03-29,09:00:00,68,20,48,FMN GV 11 Ramsel
66,Bergstraat 71,2023-03-29,10:00:00,60,36,24,FMN GV 11 Ramsel
66,Bergstraat 71,2023-03-29,11:00:00,70,42,28,FMN GV 11 Ramsel
66,Bergstraat 71,2023-03-29,12:00:00,122,88,34,FMN GV 11 Ramsel
66,Bergstraat 71,2023-03-29,13:00:00,148,70,78,FMN GV 11 Ramsel
66,Bergstraat 71,2023-03-29,14:00:00,168,82,86,FMN GV 11 Ramsel
66,Bergstraat 71,2023-03-29,15:00:00,144,68,76,FMN GV 11 Ramsel
66,Bergstraat 71,2023-03-29,16:00:00,168,94,74,FMN GV 11 Ramsel
66,Bergstraat 71,2023-03-29,17:00:00,126,82,44,FMN GV 11 Ramsel
66,Bergstraat 71,2023-03-29,18:00:00,88,50,38,FMN GV 11 Ramsel
66,Bergstraat 71,2023-03-29,19:00:00,90,48,42,FMN GV 11 Ramsel
66,Bergstraat 71,2023-03-29,20:00:00,34,24,10,FMN GV 11 Ramsel
66,Bergstraat 71,2023-03-29,21:00:00,14,6,8,FMN GV 11 Ramsel
66,Bergstraat 71,2023-03-29,22:00:00,26,24,2,FMN GV 11 Ramsel
66,Bergstraat 71,2023-03-29,23:00:00,8,8,0,FMN GV 11 Ramsel
66,Bergstraat 71,2023-03-30,00:00:00,0,0,0,FMN GV 11 Ramsel
66,Bergstraat 71,2023-03-30,01:00:00,0,0,0,FMN GV 11 Ramsel
66,Bergstraat 71,2023-03-30,02:00:00,4,2,2,FMN GV 11 Ramsel
66,Bergstraat 71,2023-03-30,03:00:00,0,0,0,FMN GV 11 Ramsel
66,Bergstraat 71,2023-03-30,04:00:00,6,6,0,FMN GV 11 Ramsel
66,Bergstraat 71,2023-03-30,05:00:00,10,6,4,FMN GV 11 Ramsel
66,Bergstraat 71,2023-03-30,06:00:00,36,12,24,FMN GV 11 Ramsel
66,Bergstraat 71,2023-03-30,07:00:00,72,16,56,FMN GV 11 Ramsel
66,Bergstraat 71,2023-03-30,08:00:00,58,24,34,FMN GV 11 Ramsel
66,Bergstraat 71,2023-03-30,09:00:00,44,18,26,FMN GV 11 Ramsel
66,Bergstraat 71,2023-03-30,10:00:00,54,30,24,FMN GV 11 Ramsel
66,Bergstraat 71,2023-03-30,11:00:00,40,26,14,FMN GV 11 Ramsel
66,Bergstraat 71,2023-03-30,12:00:00,56,36,20,FMN GV 11 Ramsel
66,Bergstraat 71,2023-03-30,13:00:00,52,20,32,FMN GV 11 Ramsel
66,Bergstraat 71,2023-03-30,14:00:00,58,32,26,FMN GV 11 Ramsel
66,Bergstraat 71,2023-03-30,15:00:00,68,50,18,FMN GV 11 Ramsel
66,Bergstraat 71,2023-03-30,16:00:00,82,62,20,FMN GV 11 Ramsel
66,Bergstraat 71,2023-03-30,17:00:00,62,36,26,FMN GV 11 Ramsel
66,Bergstraat 71,2023-03-30,18:00:00,54,28,26,FMN GV 11 Ramsel
66,Bergstraat 71,2023-03-30,19:00:00,34,18,16,FMN GV 11 Ramsel
66,Bergstraat 71,2023-03-30,20:00:00,34,22,12,FMN GV 11 Ramsel
66,Bergstraat 71,2023-03-30,21:00:00,18,12,6,FMN GV 11 Ramsel
66,Bergstraat 71,2023-03-30,22:00:00,22,12,10,FMN GV 11 Ramsel
66,Bergstraat 71,2023-03-30,23:00:00,2,2,0,FMN GV 11 Ramsel
66,Bergstraat 71,2023-03-31,00:00:00,4,0,4,FMN GV 11 Ramsel
66,Bergstraat 71,2023-03-31,01:00:00,0,0,0,FMN GV 11 Ramsel
66,Bergstraat 71,2023-03-31,02:00:00,0,0,0,FMN GV 11 Ramsel
66,Bergstraat 71,2023-03-31,03:00:00,0,0,0,FMN GV 11 Ramsel
66,Bergstraat 71,2023-03-31,04:00:00,6,6,0,FMN GV 11 Ramsel
66,Bergstraat 71,2023-03-31,05:00:00,6,2,4,FMN GV 11 Ramsel
66,Bergstraat 71,2023-03-31,06:00:00,8,4,4,FMN GV 11 Ramsel
66,Bergstraat 71,2023-03-31,07:00:00,36,10,26,FMN GV 11 Ramsel
66,Bergstraat 71,2023-03-31,08:00:00,44,4,40,FMN GV 11 Ramsel
66,Bergstraat 71,2023-03-31,09:00:00,20,6,14,FMN GV 11 Ramsel
66,Bergstraat 71,2023-03-31,10:00:00,34,26,8,FMN GV 11 Ramsel
66,Bergstraat 71,2023-03-31,11:00:00,22,14,8,FMN GV 11 Ramsel
66,Bergstraat 71,2023-03-31,12:00:00,24,20,4,FMN GV 11 Ramsel
66,Bergstraat 71,2023-03-31,13:00:00,16,8,8,FMN GV 11 Ramsel
66,Bergstraat 71,2023-03-31,14:00:00,22,12,10,FMN GV 11 Ramsel
66,Bergstraat 71,2023-03-31,15:00:00,50,42,8,FMN GV 11 Ramsel
66,Bergstraat 71,2023-03-31,16:00:00,50,22,28,FMN GV 11 Ramsel
66,Bergstraat 71,2023-03-31,17:00:00,22,18,4,FMN GV 11 Ramsel
66,Bergstraat 71,2023-03-31,18:00:00,18,6,12,FMN GV 11 Ramsel
66,Bergstraat 71,2023-03-31,19:00:00,10,6,4,FMN GV 11 Ramsel
66,Bergstraat 71,2023-03-31,20:00:00,10,6,4,FMN GV 11 Ramsel
66,Bergstraat 71,2023-03-31,21:00:00,4,2,2,FMN GV 11 Ramsel
66,Bergstraat 71,2023-03-31,22:00:00,4,2,2,FMN GV 11 Ramsel
66,Bergstraat 71,2023-03-31,23:00:00,8,2,6,FMN GV 11 Ramsel
66,Bergstraat 71,2023-04-01,00:00:00,14,6,8,FMN GV 11 Ramsel
66,Bergstraat 71,2023-04-01,01:00:00,2,2,0,FMN GV 11 Ramsel
66,Bergstraat 71,2023-04-01,02:00:00,0,0,0,FMN GV 11 Ramsel
66,Bergstraat 71,2023-04-01,03:00:00,0,0,0,FMN GV 11 Ramsel
66,Bergstraat 71,2023-04-01,04:00:00,2,2,0,FMN GV 11 Ramsel
66,Bergstraat 71,2023-04-01,05:00:00,8,8,0,FMN GV 11 Ramsel
66,Bergstraat 71,2023-04-01,06:00:00,2,2,0,FMN GV 11 Ramsel
66,Bergstraat 71,2023-04-01,07:00:00,2,0,2,FMN GV 11 Ramsel
66,Bergstraat 71,2023-04-01,08:00:00,8,0,8,FMN GV 11 Ramsel
66,Bergstraat 71,2023-04-01,09:00:00,10,6,4,FMN GV 11 Ramsel
66,Bergstraat 71,2023-04-01,10:00:00,20,14,6,FMN GV 11 Ramsel
66,Bergstraat 71,2023-04-01,11:00:00,6,4,2,FMN GV 11 Ramsel
66,Bergstraat 71,2023-04-01,12:00:00,12,6,6,FMN GV 11 Ramsel
66,Bergstraat 71,2023-04-01,13:00:00,36,10,26,FMN GV 11 Ramsel
66,Bergstraat 71,2023-04-01,14:00:00,20,8,12,FMN GV 11 Ramsel
66,Bergstraat 71,2023-04-01,15:00:00,14,8,6,FMN GV 11 Ramsel
66,Bergstraat 71,2023-04-01,16:00:00,14,8,6,FMN GV 11 Ramsel
66,Bergstraat 71,2023-04-01,17:00:00,20,12,8,FMN GV 11 Ramsel
66,Bergstraat 71,2023-04-01,18:00:00,16,8,8,FMN GV 11 Ramsel
66,Bergstraat 71,2023-04-01,19:00:00,8,2,6,FMN GV 11 Ramsel
66,Bergstraat 71,2023-04-01,20:00:00,8,4,4,FMN GV 11 Ramsel
66,Bergstraat 71,2023-04-01,21:00:00,8,4,4,FMN GV 11 Ramsel
66,Bergstraat 71,2023-04-01,22:00:00,2,0,2,FMN GV 11 Ramsel
66,Bergstraat 71,2023-04-01,23:00:00,8,6,2,FMN GV 11 Ramsel
66,Bergstraat 71,2023-04-02,00:00:00,6,4,2,FMN GV 11 Ramsel
66,Bergstraat 71,2023-04-02,01:00:00,10,4,6,FMN GV 11 Ramsel
66,Bergstraat 71,2023-04-02,02:00:00,0,0,0,FMN GV 11 Ramsel
66,Bergstraat 71,2023-04-02,03:00:00,0,0,0,FMN GV 11 Ramsel
66,Bergstraat 71,2023-04-02,04:00:00,0,0,0,FMN GV 11 Ramsel
66,Bergstraat 71,2023-04-02,05:00:00,0,0,0,FMN GV 11 Ramsel
66,Bergstraat 71,2023-04-02,06:00:00,2,0,2,FMN GV 11 Ramsel
66,Bergstraat 71,2023-04-02,07:00:00,18,8,10,FMN GV 11 Ramsel
66,Bergstraat 71,2023-04-02,08:00:00,80,22,58,FMN GV 11 Ramsel
66,Bergstraat 71,2023-04-02,09:00:00,142,64,78,FMN GV 11 Ramsel
66,Bergstraat 71,2023-04-02,10:00:00,106,42,64,FMN GV 11 Ramsel
66,Bergstraat 71,2023-04-02,11:00:00,158,116,42,FMN GV 11 Ramsel
66,Bergstraat 71,2023-04-02,12:00:00,78,50,28,FMN GV 11 Ramsel
66,Bergstraat 71,2023-04-02,13:00:00,110,62,48,FMN GV 11 Ramsel
66,Bergstraat 71,2023-04-02,14:00:00,82,36,46,FMN GV 11 Ramsel
66,Bergstraat 71,2023-04-02,15:00:00,40,30,10,FMN GV 11 Ramsel
66,Bergstraat 71,2023-04-02,16:00:00,52,32,20,FMN GV 11 Ramsel
66,Bergstraat 71,2023-04-02,17:00:00,36,18,18,FMN GV 11 Ramsel
66,Bergstraat 71,2023-04-02,18:00:00,28,18,10,FMN GV 11 Ramsel
66,Bergstraat 71,2023-04-02,19:00:00,18,12,6,FMN GV 11 Ramsel
66,Bergstraat 71,2023-04-02,20:00:00,4,4,0,FMN GV 11 Ramsel
66,Bergstraat 71,2023-04-02,21:00:00,8,8,0,FMN GV 11 Ramsel
66,Bergstraat 71,2023-04-02,22:00:00,2,2,0,FMN GV 11 Ramsel
66,Bergstraat 71,2023-04-02,23:00:00,4,2,2,FMN GV 11 Ramsel
66,Bergstraat 71,2023-04-03,00:00:00,2,2,0,FMN GV 11 Ramsel
66,Bergstraat 71,2023-04-03,01:00:00,0,0,0,FMN GV 11 Ramsel
66,Bergstraat 71,2023-04-03,02:00:00,0,0,0,FMN GV 11 Ramsel
66,Bergstraat 71,2023-04-03,03:00:00,0,0,0,FMN GV 11 Ramsel
66,Bergstraat 71,2023-04-03,04:00:00,6,2,4,FMN GV 11 Ramsel
66,Bergstraat 71,2023-04-03,05:00:00,14,10,4,FMN GV 11 Ramsel
66,Bergstraat 71,2023-04-03,06:00:00,26,10,16,FMN GV 11 Ramsel
66,Bergstraat 71,2023-04-03,07:00:00,42,16,26,FMN GV 11 Ramsel
66,Bergstraat 71,2023-04-03,08:00:00,50,18,32,FMN GV 11 Ramsel
66,Bergstraat 71,2023-04-03,09:00:00,36,14,22,FMN GV 11 Ramsel
66,Bergstraat 71,2023-04-03,10:00:00,62,32,30,FMN GV 11 Ramsel
66,Bergstraat 71,2023-04-03,11:00:00,58,26,32,FMN GV 11 Ramsel
66,Bergstraat 71,2023-04-03,12:00:00,104,56,48,FMN GV 11 Ramsel
66,Bergstraat 71,2023-04-03,13:00:00,150,74,76,FMN GV 11 Ramsel
66,Bergstraat 71,2023-04-03,14:00:00,144,88,56,FMN GV 11 Ramsel
66,Bergstraat 71,2023-04-03,15:00:00,184,88,96,FMN GV 11 Ramsel
66,Bergstraat 71,2023-04-03,16:00:00,120,70,50,FMN GV 11 Ramsel
66,Bergstraat 71,2023-04-03,17:00:00,122,72,50,FMN GV 11 Ramsel
66,Bergstraat 71,2023-04-03,18:00:00,72,44,28,FMN GV 11 Ramsel
66,Bergstraat 71,2023-04-03,19:00:00,80,32,48,FMN GV 11 Ramsel
66,Bergstraat 71,2023-04-03,20:00:00,20,8,12,FMN GV 11 Ramsel
66,Bergstraat 71,2023-04-03,21:00:00,20,14,6,FMN GV 11 Ramsel
66,Bergstraat 71,2023-04-03,22:00:00,26,16,10,FMN GV 11 Ramsel
66,Bergstraat 71,2023-04-03,23:00:00,2,2,0,FMN GV 11 Ramsel
66,Bergstraat 71,2023-04-04,00:00:00,4,0,4,FMN GV 11 Ramsel
66,Bergstraat 71,2023-04-04,01:00:00,2,2,0,FMN GV 11 Ramsel
66,Bergstraat 71,2023-04-04,02:00:00,0,0,0,FMN GV 11 Ramsel
66,Bergstraat 71,2023-04-04,03:00:00,0,0,0,FMN GV 11 Ramsel
66,Bergstraat 71,2023-04-04,04:00:00,10,6,4,FMN GV 11 Ramsel
66,Bergstraat 71,2023-04-04,05:00:00,12,6,6,FMN GV 11 Ramsel
66,Bergstraat 71,2023-04-04,06:00:00,36,14,22,FMN GV 11 Ramsel
66,Bergstraat 71,2023-04-04,07:00:00,62,20,42,FMN GV 11 Ramsel
66,Bergstraat 71,2023-04-04,08:00:00,52,10,42,FMN GV 11 Ramsel
66,Bergstraat 71,2023-04-04,09:00:00,42,22,20,FMN GV 11 Ramsel
66,Bergstraat 71,2023-04-04,10:00:00,50,28,22,FMN GV 11 Ramsel
66,Bergstraat 71,2023-04-04,11:00:00,52,20,32,FMN GV 11 Ramsel
66,Bergstraat 71,2023-04-04,12:00:00,94,52,42,FMN GV 11 Ramsel
66,Bergstraat 71,2023-04-04,13:00:00,188,74,114,FMN GV 11 Ramsel
66,Bergstraat 71,2023-04-04,14:00:00,172,92,80,FMN GV 11 Ramsel
66,Bergstraat 71,2023-04-04,15:00:00,194,116,78,FMN GV 11 Ramsel
66,Bergstraat 71,2023-04-04,16:00:00,168,88,80,FMN GV 11 Ramsel
66,Bergstraat 71,2023-04-04,17:00:00,162,94,68,FMN GV 11 Ramsel
66,Bergstraat 71,2023-04-04,18:00:00,108,56,52,FMN GV 11 Ramsel
66,Bergstraat 71,2023-04-04,19:00:00,62,42,20,FMN GV 11 Ramsel
66,Bergstraat 71,2023-04-04,20:00:00,44,16,28,FMN GV 11 Ramsel
66,Bergstraat 71,2023-04-04,21:00:00,12,8,4,FMN GV 11 Ramsel
66,Bergstraat 71,2023-04-04,22:00:00,18,16,2,FMN GV 11 Ramsel
66,Bergstraat 71,2023-04-04,23:00:00,8,8,0,FMN GV 11 Ramsel
66,Bergstraat 71,2023-04-05,00:00:00,2,2,0,FMN GV 11 Ramsel
66,Bergstraat 71,2023-04-05,01:00:00,0,0,0,FMN GV 11 Ramsel
66,Bergstraat 71,2023-04-05,02:00:00,2,0,2,FMN GV 11 Ramsel
66,Bergstraat 71,2023-04-05,03:00:00,2,2,0,FMN GV 11 Ramsel
66,Bergstraat 71,2023-04-05,04:00:00,10,6,4,FMN GV 11 Ramsel
66,Bergstraat 71,2023-04-05,05:00:00,12,6,6,FMN GV 11 Ramsel
66,Bergstraat 71,2023-04-05,06:00:00,24,12,12,FMN GV 11 Ramsel
66,Bergstraat 71,2023-04-05,07:00:00,58,14,44,FMN GV 11 Ramsel
66,Bergstraat 71,2023-04-05,08:00:00,84,42,42,FMN GV 11 Ramsel
66,Bergstraat 71,2023-04-05,09:00:00,30,14,16,FMN GV 11 Ramsel
66,Bergstraat 71,2023-04-05,10:00:00,62,22,40,FMN GV 11 Ramsel
66,Bergstraat 71,2023-04-05,11:00:00,64,34,30,FMN GV 11 Ramsel
66,Bergstraat 71,2023-04-05,12:00:00,124,56,68,FMN GV 11 Ramsel
66,Bergstraat 71,2023-04-05,13:00:00,236,100,136,FMN GV 11 Ramsel
66,Bergstraat 71,2023-04-05,14:00:00,214,102,112,FMN GV 11 Ramsel
66,Bergstraat 71,2023-04-05,15:00:00,140,90,50,FMN GV 11 Ramsel
66,Bergstraat 71,2023-04-05,16:00:00,160,98,62,FMN GV 11 Ramsel
66,Bergstraat 71,2023-04-05,17:00:00,134,82,52,FMN GV 11 Ramsel
66,Bergstraat 71,2023-04-05,18:00:00,100,50,50,FMN GV 11 Ramsel
66,Bergstraat 71,2023-04-05,19:00:00,96,42,54,FMN GV 11 Ramsel
66,Bergstraat 71,2023-04-05,20:00:00,46,30,16,FMN GV 11 Ramsel
66,Bergstraat 71,2023-04-05,21:00:00,26,14,12,FMN GV 11 Ramsel
66,Bergstraat 71,2023-04-05,22:00:00,36,18,18,FMN GV 11 Ramsel
66,Bergstraat 71,2023-04-05,23:00:00,4,4,0,FMN GV 11 Ramsel
66,Bergstraat 71,2023-04-06,00:00:00,6,4,2,FMN GV 11 Ramsel
66,Bergstraat 71,2023-04-06,01:00:00,2,2,0,FMN GV 11 Ramsel
66,Bergstraat 71,2023-04-06,02:00:00,0,0,0,FMN GV 11 Ramsel
66,Bergstraat 71,2023-04-06,03:00:00,0,0,0,FMN GV 11 Ramsel
66,Bergstraat 71,2023-04-06,04:00:00,4,2,2,FMN GV 11 Ramsel
66,Bergstraat 71,2023-04-06,05:00:00,8,4,4,FMN GV 11 Ramsel
66,Bergstraat 71,2023-04-06,06:00:00,16,6,10,FMN GV 11 Ramsel
66,Bergstraat 71,2023-04-06,07:00:00,44,16,28,FMN GV 11 Ramsel
66,Bergstraat 71,2023-04-06,08:00:00,34,20,14,FMN GV 11 Ramsel
66,Bergstraat 71,2023-04-06,09:00:00,32,10,22,FMN GV 11 Ramsel
66,Bergstraat 71,2023-04-06,10:00:00,18,10,8,FMN GV 11 Ramsel
66,Bergstraat 71,2023-04-06,11:00:00,24,18,6,FMN GV 11 Ramsel
66,Bergstraat 71,2023-04-06,12:00:00,16,8,8,FMN GV 11 Ramsel
66,Bergstraat 71,2023-04-06,13:00:00,20,8,12,FMN GV 11 Ramsel
66,Bergstraat 71,2023-04-06,14:00:00,34,22,12,FMN GV 11 Ramsel
66,Bergstraat 71,2023-04-06,15:00:00,38,22,16,FMN GV 11 Ramsel
66,Bergstraat 71,2023-04-06,16:00:00,40,20,20,FMN GV 11 Ramsel
66,Bergstraat 71,2023-04-06,17:00:00,56,30,26,FMN GV 11 Ramsel
66,Bergstraat 71,2023-04-06,18:00:00,24,12,12,FMN GV 11 Ramsel
66,Bergstraat 71,2023-04-06,19:00:00,12,6,6,FMN GV 11 Ramsel
66,Bergstraat 71,2023-04-06,20:00:00,8,6,2,FMN GV 11 Ramsel
66,Bergstraat 71,2023-04-06,21:00:00,6,6,0,FMN GV 11 Ramsel
66,Bergstraat 71,2023-04-06,22:00:00,6,4,2,FMN GV 11 Ramsel
66,Bergstraat 71,2023-04-06,23:00:00,2,2,0,FMN GV 11 Ramsel
66,Bergstraat 71,2023-04-07,00:00:00,0,0,0,FMN GV 11 Ramsel
66,Bergstraat 71,2023-04-07,01:00:00,0,0,0,FMN GV 11 Ramsel
66,Bergstraat 71,2023-04-07,02:00:00,0,0,0,FMN GV 11 Ramsel
66,Bergstraat 71,2023-04-07,03:00:00,0,0,0,FMN GV 11 Ramsel
66,Bergstraat 71,2023-04-07,04:00:00,4,2,2,FMN GV 11 Ramsel
66,Bergstraat 71,2023-04-07,05:00:00,14,8,6,FMN GV 11 Ramsel
66,Bergstraat 71,2023-04-07,06:00:00,16,12,4,FMN GV 11 Ramsel
66,Bergstraat 71,2023-04-07,07:00:00,22,12,10,FMN GV 11 Ramsel
66,Bergstraat 71,2023-04-07,08:00:00,36,14,22,FMN GV 11 Ramsel
66,Bergstraat 71,2023-04-07,09:00:00,20,6,14,FMN GV 11 Ramsel
66,Bergstraat 71,2023-04-07,10:00:00,40,20,20,FMN GV 11 Ramsel
66,Bergstraat 71,2023-04-07,11:00:00,44,28,16,FMN GV 11 Ramsel
66,Bergstraat 71,2023-04-07,12:00:00,72,34,38,FMN GV 11 Ramsel
66,Bergstraat 71,2023-04-07,13:00:00,66,32,34,FMN GV 11 Ramsel
66,Bergstraat 71,2023-04-07,14:00:00,50,32,18,FMN GV 11 Ramsel
66,Bergstraat 71,2023-04-07,15:00:00,98,46,52,FMN GV 11 Ramsel
66,Bergstraat 71,2023-04-07,16:00:00,70,36,34,FMN GV 11 Ramsel
66,Bergstraat 71,2023-04-07,17:00:00,70,56,14,FMN GV 11 Ramsel
66,Bergstraat 71,2023-04-07,18:00:00,44,24,20,FMN GV 11 Ramsel
66,Bergstraat 71,2023-04-07,19:00:00,32,12,20,FMN GV 11 Ramsel
66,Bergstraat 71,2023-04-07,20:00:00,24,12,12,FMN GV 11 Ramsel
66,Bergstraat 71,2023-04-07,21:00:00,20,14,6,FMN GV 11 Ramsel
66,Bergstraat 71,2023-04-07,22:00:00,6,2,4,FMN GV 11 Ramsel
66,Bergstraat 71,2023-04-07,23:00:00,2,0,2,FMN GV 11 Ramsel
66,Bergstraat 71,2023-04-08,00:00:00,2,2,0,FMN GV 11 Ramsel
66,Bergstraat 71,2023-04-08,01:00:00,4,2,2,FMN GV 11 Ramsel
66,Bergstraat 71,2023-04-08,02:00:00,2,2,0,FMN GV 11 Ramsel
66,Bergstraat 71,2023-04-08,03:00:00,8,4,4,FMN GV 11 Ramsel
66,Bergstraat 71,2023-04-08,04:00:00,2,0,2,FMN GV 11 Ramsel
66,Bergstraat 71,2023-04-08,05:00:00,2,2,0,FMN GV 11 Ramsel
66,Bergstraat 71,2023-04-08,06:00:00,4,2,2,FMN GV 11 Ramsel
66,Bergstraat 71,2023-04-08,07:00:00,8,8,0,FMN GV 11 Ramsel
66,Bergstraat 71,2023-04-08,08:00:00,42,8,34,FMN GV 11 Ramsel
66,Bergstraat 71,2023-04-08,09:00:00,92,28,64,FMN GV 11 Ramsel
66,Bergstraat 71,2023-04-08,10:00:00,78,44,34,FMN GV 11 Ramsel
66,Bergstraat 71,2023-04-08,11:00:00,110,68,42,FMN GV 11 Ramsel
66,Bergstraat 71,2023-04-08,12:00:00,118,62,56,FMN GV 11 Ramsel
66,Bergstraat 71,2023-04-08,13:00:00,166,70,96,FMN GV 11 Ramsel
66,Bergstraat 71,2023-04-08,14:00:00,222,112,110,FMN GV 11 Ramsel
66,Bergstraat 71,2023-04-08,15:00:00,182,70,112,FMN GV 11 Ramsel
66,Bergstraat 71,2023-04-08,16:00:00,148,94,54,FMN GV 11 Ramsel
66,Bergstraat 71,2023-04-08,17:00:00,92,50,42,FMN GV 11 Ramsel
66,Bergstraat 71,2023-04-08,18:00:00,66,44,22,FMN GV 11 Ramsel
66,Bergstraat 71,2023-04-08,19:00:00,64,26,38,FMN GV 11 Ramsel
66,Bergstraat 71,2023-04-08,20:00:00,26,16,10,FMN GV 11 Ramsel
66,Bergstraat 71,2023-04-08,21:00:00,16,14,2,FMN GV 11 Ramsel
66,Bergstraat 71,2023-04-08,22:00:00,10,6,4,FMN GV 11 Ramsel
66,Bergstraat 71,2023-04-08,23:00:00,6,4,2,FMN GV 11 Ramsel
66,Bergstraat 71,2023-04-09,00:00:00,12,8,4,FMN GV 11 Ramsel
66,Bergstraat 71,2023-04-09,01:00:00,4,0,4,FMN GV 11 Ramsel
66,Bergstraat 71,2023-04-09,02:00:00,8,4,4,FMN GV 11 Ramsel
66,Bergstraat 71,2023-04-09,03:00:00,0,0,0,FMN GV 11 Ramsel
66,Bergstraat 71,2023-04-09,04:00:00,6,4,2,FMN GV 11 Ramsel
66,Bergstraat 71,2023-04-09,05:00:00,2,2,0,FMN GV 11 Ramsel
66,Bergstraat 71,2023-04-09,06:00:00,4,2,2,FMN GV 11 Ramsel
66,Bergstraat 71,2023-04-09,07:00:00,18,8,10,FMN GV 11 Ramsel
66,Bergstraat 71,2023-04-09,08:00:00,32,10,22,FMN GV 11 Ramsel
66,Bergstraat 71,2023-04-09,09:00:00,156,80,76,FMN GV 11 Ramsel
66,Bergstraat 71,2023-04-09,10:00:00,190,128,62,FMN GV 11 Ramsel
66,Bergstraat 71,2023-04-09,11:00:00,144,96,48,FMN GV 11 Ramsel
66,Bergstraat 71,2023-04-09,12:00:00,140,68,72,FMN GV 11 Ramsel
66,Bergstraat 71,2023-04-09,13:00:00,190,96,94,FMN GV 11 Ramsel
66,Bergstraat 71,2023-04-09,14:00:00,222,108,114,FMN GV 11 Ramsel
66,Bergstraat 71,2023-04-09,15:00:00,352,192,160,FMN GV 11 Ramsel
66,Bergstraat 71,2023-04-09,16:00:00,142,62,80,FMN GV 11 Ramsel
66,Bergstraat 71,2023-04-09,17:00:00,74,40,34,FMN GV 11 Ramsel
66,Bergstraat 71,2023-04-09,18:00:00,110,52,58,FMN GV 11 Ramsel
66,Bergstraat 71,2023-04-09,19:00:00,90,48,42,FMN GV 11 Ramsel
66,Bergstraat 71,2023-04-09,20:00:00,24,16,8,FMN GV 11 Ramsel
66,Bergstraat 71,2023-04-09,21:00:00,16,12,4,FMN GV 11 Ramsel
66,Bergstraat 71,2023-04-09,22:00:00,12,8,4,FMN GV 11 Ramsel
66,Bergstraat 71,2023-04-09,23:00:00,2,2,0,FMN GV 11 Ramsel
66,Bergstraat 71,2023-04-10,00:00:00,12,4,8,FMN GV 11 Ramsel
66,Bergstraat 71,2023-04-10,01:00:00,0,0,0,FMN GV 11 Ramsel
66,Bergstraat 71,2023-04-10,02:00:00,0,0,0,FMN GV 11 Ramsel
66,Bergstraat 71,2023-04-10,03:00:00,6,0,6,FMN GV 11 Ramsel
66,Bergstraat 71,2023-04-10,04:00:00,8,0,8,FMN GV 11 Ramsel
66,Bergstraat 71,2023-04-10,05:00:00,2,2,0,FMN GV 11 Ramsel
66,Bergstraat 71,2023-04-10,06:00:00,2,2,0,FMN GV 11 Ramsel
66,Bergstraat 71,2023-04-10,07:00:00,16,6,10,FMN GV 11 Ramsel
66,Bergstraat 71,2023-04-10,08:00:00,50,10,40,FMN GV 11 Ramsel
66,Bergstraat 71,2023-04-10,09:00:00,68,16,52,FMN GV 11 Ramsel
66,Bergstraat 71,2023-04-10,10:00:00,216,136,80,FMN GV 11 Ramsel
66,Bergstraat 71,2023-04-10,11:00:00,136,66,70,FMN GV 11 Ramsel
66,Bergstraat 71,2023-04-10,12:00:00,124,62,62,FMN GV 11 Ramsel
66,Bergstraat 71,2023-04-10,13:00:00,178,120,58,FMN GV 11 Ramsel
66,Bergstraat 71,2023-04-10,14:00:00,180,98,82,FMN GV 11 Ramsel
66,Bergstraat 71,2023-04-10,15:00:00,88,48,40,FMN GV 11 Ramsel
66,Bergstraat 71,2023-04-10,16:00:00,56,18,38,FMN GV 11 Ramsel
66,Bergstraat 71,2023-04-10,17:00:00,22,14,8,FMN GV 11 Ramsel
66,Bergstraat 71,2023-04-10,18:00:00,24,18,6,FMN GV 11 Ramsel
66,Bergstraat 71,2023-04-10,19:00:00,14,2,12,FMN GV 11 Ramsel
66,Bergstraat 71,2023-04-10,20:00:00,2,2,0,FMN GV 11 Ramsel
66,Bergstraat 71,2023-04-10,21:00:00,4,4,0,FMN GV 11 Ramsel
66,Bergstraat 71,2023-04-10,22:00:00,4,2,2,FMN GV 11 Ramsel
66,Bergstraat 71,2023-04-10,23:00:00,4,4,0,FMN GV 11 Ramsel
66,Bergstraat 71,2023-04-11,00:00:00,2,0,2,FMN GV 11 Ramsel
66,Bergstraat 71,2023-04-11,01:00:00,0,0,0,FMN GV 11 Ramsel
66,Bergstraat 71,2023-04-11,02:00:00,0,0,0,FMN GV 11 Ramsel
66,Bergstraat 71,2023-04-11,03:00:00,0,0,0,FMN GV 11 Ramsel
66,Bergstraat 71,2023-04-11,04:00:00,8,6,2,FMN GV 11 Ramsel
66,Bergstraat 71,2023-04-11,05:00:00,10,6,4,FMN GV 11 Ramsel
66,Bergstraat 71,2023-04-11,06:00:00,28,12,16,FMN GV 11 Ramsel
66,Bergstraat 71,2023-04-11,07:00:00,52,18,34,FMN GV 11 Ramsel
66,Bergstraat 71,2023-04-11,08:00:00,48,20,28,FMN GV 11 Ramsel
66,Bergstraat 71,2023-04-11,09:00:00,48,16,32,FMN GV 11 Ramsel
66,Bergstraat 71,2023-04-11,10:00:00,46,16,30,FMN GV 11 Ramsel
66,Bergstraat 71,2023-04-11,11:00:00,64,40,24,FMN GV 11 Ramsel
66,Bergstraat 71,2023-04-11,12:00:00,84,48,36,FMN GV 11 Ramsel
66,Bergstraat 71,2023-04-11,13:00:00,146,66,80,FMN GV 11 Ramsel
66,Bergstraat 71,2023-04-11,14:00:00,132,80,52,FMN GV 11 Ramsel
66,Bergstraat 71,2023-04-11,15:00:00,164,108,56,FMN GV 11 Ramsel
66,Bergstraat 71,2023-04-11,16:00:00,130,62,68,FMN GV 11 Ramsel
66,Bergstraat 71,2023-04-11,17:00:00,94,46,48,FMN GV 11 Ramsel
66,Bergstraat 71,2023-04-11,18:00:00,100,58,42,FMN GV 11 Ramsel
66,Bergstraat 71,2023-04-11,19:00:00,50,28,22,FMN GV 11 Ramsel
66,Bergstraat 71,2023-04-11,20:00:00,50,30,20,FMN GV 11 Ramsel
66,Bergstraat 71,2023-04-11,21:00:00,20,16,4,FMN GV 11 Ramsel
66,Bergstraat 71,2023-04-11,22:00:00,14,14,0,FMN GV 11 Ramsel
66,Bergstraat 71,2023-04-11,23:00:00,4,4,0,FMN GV 11 Ramsel
66,Bergstraat 71,2023-04-12,00:00:00,2,0,2,FMN GV 11 Ramsel
66,Bergstraat 71,2023-04-12,01:00:00,2,2,0,FMN GV 11 Ramsel
66,Bergstraat 71,2023-04-12,02:00:00,0,0,0,FMN GV 11 Ramsel
66,Bergstraat 71,2023-04-12,03:00:00,0,0,0,FMN GV 11 Ramsel
66,Bergstraat 71,2023-04-12,04:00:00,6,4,2,FMN GV 11 Ramsel
66,Bergstraat 71,2023-04-12,05:00:00,16,4,12,FMN GV 11 Ramsel
66,Bergstraat 71,2023-04-12,06:00:00,12,4,8,FMN GV 11 Ramsel
66,Bergstraat 71,2023-04-12,07:00:00,20,10,10,FMN GV 11 Ramsel
66,Bergstraat 71,2023-04-12,08:00:00,28,14,14,FMN GV 11 Ramsel
66,Bergstraat 71,2023-04-12,09:00:00,22,8,14,FMN GV 11 Ramsel
66,Bergstraat 71,2023-04-12,10:00:00,12,8,4,FMN GV 11 Ramsel
66,Bergstraat 71,2023-04-12,11:00:00,16,6,10,FMN GV 11 Ramsel
66,Bergstraat 71,2023-04-12,12:00:00,28,22,6,FMN GV 11 Ramsel
66,Bergstraat 71,2023-04-12,13:00:00,40,18,22,FMN GV 11 Ramsel
66,Bergstraat 71,2023-04-12,14:00:00,28,4,24,FMN GV 11 Ramsel
66,Bergstraat 71,2023-04-12,15:00:00,40,32,8,FMN GV 11 Ramsel
66,Bergstraat 71,2023-04-12,16:00:00,38,24,14,FMN GV 11 Ramsel
66,Bergstraat 71,2023-04-12,17:00:00,38,18,20,FMN GV 11 Ramsel
66,Bergstraat 71,2023-04-12,18:00:00,68,46,22,FMN GV 11 Ramsel
66,Bergstraat 71,2023-04-12,19:00:00,46,16,30,FMN GV 11 Ramsel
66,Bergstraat 71,2023-04-12,20:00:00,16,6,10,FMN GV 11 Ramsel
66,Bergstraat 71,2023-04-12,21:00:00,26,20,6,FMN GV 11 Ramsel
66,Bergstraat 71,2023-04-12,22:00:00,8,6,2,FMN GV 11 Ramsel
66,Bergstraat 71,2023-04-12,23:00:00,0,0,0,FMN GV 11 Ramsel
66,Bergstraat 71,2023-04-13,00:00:00,0,0,0,FMN GV 11 Ramsel
66,Bergstraat 71,2023-04-13,01:00:00,0,0,0,FMN GV 11 Ramsel
66,Bergstraat 71,2023-04-13,02:00:00,0,0,0,FMN GV 11 Ramsel
66,Bergstraat 71,2023-04-13,03:00:00,0,0,0,FMN GV 11 Ramsel
66,Bergstraat 71,2023-04-13,04:00:00,4,2,2,FMN GV 11 Ramsel
66,Bergstraat 71,2023-04-13,05:00:00,18,8,10,FMN GV 11 Ramsel
66,Bergstraat 71,2023-04-13,06:00:00,32,14,18,FMN GV 11 Ramsel
66,Bergstraat 71,2023-04-13,07:00:00,34,14,20,FMN GV 11 Ramsel
66,Bergstraat 71,2023-04-13,08:00:00,38,6,32,FMN GV 11 Ramsel
66,Bergstraat 71,2023-04-13,09:00:00,40,8,32,FMN GV 11 Ramsel
66,Bergstraat 71,2023-04-13,10:00:00,54,26,28,FMN GV 11 Ramsel
66,Bergstraat 71,2023-04-13,11:00:00,38,22,16,FMN GV 11 Ramsel
66,Bergstraat 71,2023-04-13,12:00:00,66,28,38,FMN GV 11 Ramsel
66,Bergstraat 71,2023-04-13,13:00:00,128,60,68,FMN GV 11 Ramsel
66,Bergstraat 71,2023-04-13,14:00:00,106,52,54,FMN GV 11 Ramsel
66,Bergstraat 71,2023-04-13,15:00:00,106,68,38,FMN GV 11 Ramsel
66,Bergstraat 71,2023-04-13,16:00:00,94,54,40,FMN GV 11 Ramsel
66,Bergstraat 71,2023-04-13,17:00:00,76,36,40,FMN GV 11 Ramsel
66,Bergstraat 71,2023-04-13,18:00:00,100,42,58,FMN GV 11 Ramsel
66,Bergstraat 71,2023-04-13,19:00:00,52,38,14,FMN GV 11 Ramsel
66,Bergstraat 71,2023-04-13,20:00:00,26,22,4,FMN GV 11 Ramsel
66,Bergstraat 71,2023-04-13,21:00:00,18,14,4,FMN GV 11 Ramsel
66,Bergstraat 71,2023-04-13,22:00:00,14,10,4,FMN GV 11 Ramsel
66,Bergstraat 71,2023-04-13,23:00:00,12,8,4,FMN GV 11 Ramsel
66,Bergstraat 71,2023-04-14,00:00:00,4,4,0,FMN GV 11 Ramsel
66,Bergstraat 71,2023-04-14,01:00:00,4,0,4,FMN GV 11 Ramsel
66,Bergstraat 71,2023-04-14,02:00:00,0,0,0,FMN GV 11 Ramsel
66,Bergstraat 71,2023-04-14,03:00:00,0,0,0,FMN GV 11 Ramsel
66,Bergstraat 71,2023-04-14,04:00:00,10,6,4,FMN GV 11 Ramsel
66,Bergstraat 71,2023-04-14,05:00:00,14,8,6,FMN GV 11 Ramsel
66,Bergstraat 71,2023-04-14,06:00:00,18,10,8,FMN GV 11 Ramsel
66,Bergstraat 71,2023-04-14,07:00:00,28,20,8,FMN GV 11 Ramsel
66,Bergstraat 71,2023-04-14,08:00:00,44,14,30,FMN GV 11 Ramsel
66,Bergstraat 71,2023-04-14,09:00:00,60,12,48,FMN GV 11 Ramsel
66,Bergstraat 71,2023-04-14,10:00:00,68,46,22,FMN GV 11 Ramsel
66,Bergstraat 71,2023-04-14,11:00:00,68,22,46,FMN GV 11 Ramsel
66,Bergstraat 71,2023-04-14,12:00:00,74,30,44,FMN GV 11 Ramsel
66,Bergstraat 71,2023-04-14,13:00:00,148,70,78,FMN GV 11 Ramsel
66,Bergstraat 71,2023-04-14,14:00:00,146,84,62,FMN GV 11 Ramsel
66,Bergstraat 71,2023-04-14,15:00:00,120,88,32,FMN GV 11 Ramsel
66,Bergstraat 71,2023-04-14,16:00:00,150,82,68,FMN GV 11 Ramsel
66,Bergstraat 71,2023-04-14,17:00:00,162,54,108,FMN GV 11 Ramsel
66,Bergstraat 71,2023-04-14,18:00:00,52,36,16,FMN GV 11 Ramsel
66,Bergstraat 71,2023-04-14,19:00:00,70,34,36,FMN GV 11 Ramsel
66,Bergstraat 71,2023-04-14,20:00:00,28,14,14,FMN GV 11 Ramsel
66,Bergstraat 71,2023-04-14,21:00:00,48,26,22,FMN GV 11 Ramsel
66,Bergstraat 71,2023-04-14,22:00:00,8,8,0,FMN GV 11 Ramsel
66,Bergstraat 71,2023-04-14,23:00:00,24,18,6,FMN GV 11 Ramsel
66,Bergstraat 71,2023-04-15,00:00:00,10,4,6,FMN GV 11 Ramsel
66,Bergstraat 71,2023-04-15,01:00:00,0,0,0,FMN GV 11 Ramsel
66,Bergstraat 71,2023-04-15,02:00:00,16,8,8,FMN GV 11 Ramsel
66,Bergstraat 71,2023-04-15,03:00:00,14,12,2,FMN GV 11 Ramsel
66,Bergstraat 71,2023-04-15,04:00:00,4,4,0,FMN GV 11 Ramsel
66,Bergstraat 71,2023-04-15,05:00:00,2,2,0,FMN GV 11 Ramsel
66,Bergstraat 71,2023-04-15,06:00:00,4,2,2,FMN GV 11 Ramsel
66,Bergstraat 71,2023-04-15,07:00:00,18,8,10,FMN GV 11 Ramsel
66,Bergstraat 71,2023-04-15,08:00:00,26,8,18,FMN GV 11 Ramsel
66,Bergstraat 71,2023-04-15,09:00:00,60,38,22,FMN GV 11 Ramsel
66,Bergstraat 71,2023-04-15,10:00:00,124,66,58,FMN GV 11 Ramsel
66,Bergstraat 71,2023-04-15,11:00:00,138,64,74,FMN GV 11 Ramsel
66,Bergstraat 71,2023-04-15,12:00:00,164,58,106,FMN GV 11 Ramsel
66,Bergstraat 71,2023-04-15,13:00:00,210,80,130,FMN GV 11 Ramsel
66,Bergstraat 71,2023-04-15,14:00:00,252,122,130,FMN GV 11 Ramsel
66,Bergstraat 71,2023-04-15,15:00:00,228,112,116,FMN GV 11 Ramsel
66,Bergstraat 71,2023-04-15,16:00:00,178,118,60,FMN GV 11 Ramsel
66,Bergstraat 71,2023-04-15,17:00:00,88,30,58,FMN GV 11 Ramsel
66,Bergstraat 71,2023-04-15,18:00:00,54,30,24,FMN GV 11 Ramsel
66,Bergstraat 71,2023-04-15,19:00:00,74,28,46,FMN GV 11 Ramsel
66,Bergstraat 71,2023-04-15,20:00:00,34,18,16,FMN GV 11 Ramsel
66,Bergstraat 71,2023-04-15,21:00:00,28,16,12,FMN GV 11 Ramsel
66,Bergstraat 71,2023-04-15,22:00:00,4,2,2,FMN GV 11 Ramsel
66,Bergstraat 71,2023-04-15,23:00:00,8,2,6,FMN GV 11 Ramsel
66,Bergstraat 71,2023-04-16,00:00:00,4,4,0,FMN GV 11 Ramsel
66,Bergstraat 71,2023-04-16,01:00:00,2,2,0,FMN GV 11 Ramsel
66,Bergstraat 71,2023-04-16,02:00:00,4,4,0,FMN GV 11 Ramsel
66,Bergstraat 71,2023-04-16,03:00:00,4,4,0,FMN GV 11 Ramsel
66,Bergstraat 71,2023-04-16,04:00:00,0,0,0,FMN GV 11 Ramsel
66,Bergstraat 71,2023-04-16,05:00:00,4,4,0,FMN GV 11 Ramsel
66,Bergstraat 71,2023-04-16,06:00:00,6,0,6,FMN GV 11 Ramsel
66,Bergstraat 71,2023-04-16,07:00:00,12,6,6,FMN GV 11 Ramsel
66,Bergstraat 71,2023-04-16,08:00:00,40,10,30,FMN GV 11 Ramsel
66,Bergstraat 71,2023-04-16,09:00:00,50,18,32,FMN GV 11 Ramsel
66,Bergstraat 71,2023-04-16,10:00:00,88,44,44,FMN GV 11 Ramsel
66,Bergstraat 71,2023-04-16,11:00:00,68,44,24,FMN GV 11 Ramsel
66,Bergstraat 71,2023-04-16,12:00:00,94,34,60,FMN GV 11 Ramsel
66,Bergstraat 71,2023-04-16,13:00:00,64,22,42,FMN GV 11 Ramsel
66,Bergstraat 71,2023-04-16,14:00:00,72,28,44,FMN GV 11 Ramsel
66,Bergstraat 71,2023-04-16,15:00:00,46,34,12,FMN GV 11 Ramsel
66,Bergstraat 71,2023-04-16,16:00:00,38,26,12,FMN GV 11 Ramsel
66,Bergstraat 71,2023-04-16,17:00:00,44,24,20,FMN GV 11 Ramsel
66,Bergstraat 71,2023-04-16,18:00:00,22,8,14,FMN GV 11 Ramsel
66,Bergstraat 71,2023-04-16,19:00:00,32,22,10,FMN GV 11 Ramsel
66,Bergstraat 71,2023-04-16,20:00:00,24,10,14,FMN GV 11 Ramsel
66,Bergstraat 71,2023-04-16,21:00:00,6,4,2,FMN GV 11 Ramsel
66,Bergstraat 71,2023-04-16,22:00:00,6,2,4,FMN GV 11 Ramsel
66,Bergstraat 71,2023-04-16,23:00:00,2,2,0,FMN GV 11 Ramsel
66,Bergstraat 71,2023-04-17,00:00:00,0,0,0,FMN GV 11 Ramsel
66,Bergstraat 71,2023-04-17,01:00:00,4,2,2,FMN GV 11 Ramsel
66,Bergstraat 71,2023-04-17,02:00:00,0,0,0,FMN GV 11 Ramsel
66,Bergstraat 71,2023-04-17,03:00:00,2,0,2,FMN GV 11 Ramsel
66,Bergstraat 71,2023-04-17,04:00:00,8,4,4,FMN GV 11 Ramsel
66,Bergstraat 71,2023-04-17,05:00:00,14,6,8,FMN GV 11 Ramsel
66,Bergstraat 71,2023-04-17,06:00:00,46,16,30,FMN GV 11 Ramsel
66,Bergstraat 71,2023-04-17,07:00:00,248,18,230,FMN GV 11 Ramsel
66,Bergstraat 71,2023-04-17,08:00:00,190,14,176,FMN GV 11 Ramsel
66,Bergstraat 71,2023-04-17,09:00:00,48,26,22,FMN GV 11 Ramsel
66,Bergstraat 71,2023-04-17,10:00:00,40,24,16,FMN GV 11 Ramsel
66,Bergstraat 71,2023-04-17,11:00:00,48,26,22,FMN GV 11 Ramsel
66,Bergstraat 71,2023-04-17,12:00:00,90,46,44,FMN GV 11 Ramsel
66,Bergstraat 71,2023-04-17,13:00:00,74,30,44,FMN GV 11 Ramsel
66,Bergstraat 71,2023-04-17,14:00:00,110,58,52,FMN GV 11 Ramsel
66,Bergstraat 71,2023-04-17,15:00:00,316,240,76,FMN GV 11 Ramsel
66,Bergstraat 71,2023-04-17,16:00:00,200,164,36,FMN GV 11 Ramsel
66,Bergstraat 71,2023-04-17,17:00:00,106,76,30,FMN GV 11 Ramsel
66,Bergstraat 71,2023-04-17,18:00:00,86,44,42,FMN GV 11 Ramsel
66,Bergstraat 71,2023-04-17,19:00:00,88,52,36,FMN GV 11 Ramsel
66,Bergstraat 71,2023-04-17,20:00:00,34,14,20,FMN GV 11 Ramsel
66,Bergstraat 71,2023-04-17,21:00:00,18,14,4,FMN GV 11 Ramsel
66,Bergstraat 71,2023-04-17,22:00:00,16,12,4,FMN GV 11 Ramsel
66,Bergstraat 71,2023-04-17,23:00:00,6,2,4,FMN GV 11 Ramsel
66,Bergstraat 71,2023-04-18,00:00:00,4,2,2,FMN GV 11 Ramsel
66,Bergstraat 71,2023-04-18,01:00:00,0,0,0,FMN GV 11 Ramsel
66,Bergstraat 71,2023-04-18,02:00:00,0,0,0,FMN GV 11 Ramsel
66,Bergstraat 71,2023-04-18,03:00:00,0,0,0,FMN GV 11 Ramsel
66,Bergstraat 71,2023-04-18,04:00:00,8,4,4,FMN GV 11 Ramsel
66,Bergstraat 71,2023-04-18,05:00:00,12,8,4,FMN GV 11 Ramsel
66,Bergstraat 71,2023-04-18,06:00:00,56,24,32,FMN GV 11 Ramsel
66,Bergstraat 71,2023-04-18,07:00:00,260,32,228,FMN GV 11 Ramsel
66,Bergstraat 71,2023-04-18,08:00:00,212,36,176,FMN GV 11 Ramsel
66,Bergstraat 71,2023-04-18,09:00:00,86,26,60,FMN GV 11 Ramsel
66,Bergstraat 71,2023-04-18,10:00:00,62,20,42,FMN GV 11 Ramsel
66,Bergstraat 71,2023-04-18,11:00:00,68,40,28,FMN GV 11 Ramsel
66,Bergstraat 71,2023-04-18,12:00:00,100,62,38,FMN GV 11 Ramsel
66,Bergstraat 71,2023-04-18,13:00:00,142,60,82,FMN GV 11 Ramsel
66,Bergstraat 71,2023-04-18,14:00:00,122,66,56,FMN GV 11 Ramsel
66,Bergstraat 71,2023-04-18,15:00:00,240,194,46,FMN GV 11 Ramsel
66,Bergstraat 71,2023-04-18,16:00:00,268,184,84,FMN GV 11 Ramsel
66,Bergstraat 71,2023-04-18,17:00:00,188,108,80,FMN GV 11 Ramsel
66,Bergstraat 71,2023-04-18,18:00:00,116,58,58,FMN GV 11 Ramsel
66,Bergstraat 71,2023-04-18,19:00:00,76,36,40,FMN GV 11 Ramsel
66,Bergstraat 71,2023-04-18,20:00:00,58,36,22,FMN GV 11 Ramsel
66,Bergstraat 71,2023-04-18,21:00:00,30,16,14,FMN GV 11 Ramsel
66,Bergstraat 71,2023-04-18,22:00:00,14,14,0,FMN GV 11 Ramsel
66,Bergstraat 71,2023-04-18,23:00:00,8,6,2,FMN GV 11 Ramsel
66,Bergstraat 71,2023-04-19,00:00:00,2,2,0,FMN GV 11 Ramsel
66,Bergstraat 71,2023-04-19,01:00:00,2,2,0,FMN GV 11 Ramsel
66,Bergstraat 71,2023-04-19,02:00:00,0,0,0,FMN GV 11 Ramsel
66,Bergstraat 71,2023-04-19,03:00:00,0,0,0,FMN GV 11 Ramsel
66,Bergstraat 71,2023-04-19,04:00:00,10,4,6,FMN GV 11 Ramsel
66,Bergstraat 71,2023-04-19,05:00:00,20,8,12,FMN GV 11 Ramsel
66,Bergstraat 71,2023-04-19,06:00:00,60,32,28,FMN GV 11 Ramsel
66,Bergstraat 71,2023-04-19,07:00:00,218,26,192,FMN GV 11 Ramsel
66,Bergstraat 71,2023-04-19,08:00:00,234,42,192,FMN GV 11 Ramsel
66,Bergstraat 71,2023-04-19,09:00:00,64,18,46,FMN GV 11 Ramsel
66,Bergstraat 71,2023-04-19,10:00:00,70,34,36,FMN GV 11 Ramsel
66,Bergstraat 71,2023-04-19,11:00:00,108,60,48,FMN GV 11 Ramsel
66,Bergstraat 71,2023-04-19,12:00:00,298,250,48,FMN GV 11 Ramsel
66,Bergstraat 71,2023-04-19,13:00:00,202,114,88,FMN GV 11 Ramsel
66,Bergstraat 71,2023-04-19,14:00:00,164,84,80,FMN GV 11 Ramsel
66,Bergstraat 71,2023-04-19,15:00:00,176,110,66,FMN GV 11 Ramsel
66,Bergstraat 71,2023-04-19,16:00:00,164,112,52,FMN GV 11 Ramsel
66,Bergstraat 71,2023-04-19,17:00:00,160,68,92,FMN GV 11 Ramsel
66,Bergstraat 71,2023-04-19,18:00:00,146,70,76,FMN GV 11 Ramsel
66,Bergstraat 71,2023-04-19,19:00:00,102,52,50,FMN GV 11 Ramsel
66,Bergstraat 71,2023-04-19,20:00:00,66,44,22,FMN GV 11 Ramsel
66,Bergstraat 71,2023-04-19,21:00:00,38,30,8,FMN GV 11 Ramsel
66,Bergstraat 71,2023-04-19,22:00:00,14,10,4,FMN GV 11 Ramsel
66,Bergstraat 71,2023-04-19,23:00:00,6,4,2,FMN GV 11 Ramsel
66,Bergstraat 71,2023-04-20,00:00:00,0,0,0,FMN GV 11 Ramsel
66,Bergstraat 71,2023-04-20,01:00:00,0,0,0,FMN GV 11 Ramsel
66,Bergstraat 71,2023-04-20,02:00:00,0,0,0,FMN GV 11 Ramsel
66,Bergstraat 71,2023-04-20,03:00:00,0,0,0,FMN GV 11 Ramsel
66,Bergstraat 71,2023-04-20,04:00:00,6,4,2,FMN GV 11 Ramsel
66,Bergstraat 71,2023-04-20,05:00:00,10,4,6,FMN GV 11 Ramsel
66,Bergstraat 71,2023-04-20,06:00:00,38,22,16,FMN GV 11 Ramsel
66,Bergstraat 71,2023-04-20,07:00:00,170,16,154,FMN GV 11 Ramsel
66,Bergstraat 71,2023-04-20,08:00:00,190,36,154,FMN GV 11 Ramsel
66,Bergstraat 71,2023-04-20,09:00:00,40,22,18,FMN GV 11 Ramsel
66,Bergstraat 71,2023-04-20,10:00:00,40,16,24,FMN GV 11 Ramsel
66,Bergstraat 71,2023-04-20,11:00:00,44,20,24,FMN GV 11 Ramsel
66,Bergstraat 71,2023-04-20,12:00:00,36,20,16,FMN GV 11 Ramsel
66,Bergstraat 71,2023-04-20,13:00:00,46,28,18,FMN GV 11 Ramsel
66,Bergstraat 71,2023-04-20,14:00:00,94,72,22,FMN GV 11 Ramsel
66,Bergstraat 71,2023-04-20,15:00:00,202,178,24,FMN GV 11 Ramsel
66,Bergstraat 71,2023-04-20,16:00:00,146,128,18,FMN GV 11 Ramsel
66,Bergstraat 71,2023-04-20,17:00:00,64,34,30,FMN GV 11 Ramsel
66,Bergstraat 71,2023-04-20,18:00:00,42,26,16,FMN GV 11 Ramsel
66,Bergstraat 71,2023-04-20,19:00:00,32,20,12,FMN GV 11 Ramsel
66,Bergstraat 71,2023-04-20,20:00:00,24,14,10,FMN GV 11 Ramsel
66,Bergstraat 71,2023-04-20,21:00:00,8,6,2,FMN GV 11 Ramsel
66,Bergstraat 71,2023-04-20,22:00:00,16,14,2,FMN GV 11 Ramsel
66,Bergstraat 71,2023-04-20,23:00:00,8,4,4,FMN GV 11 Ramsel
66,Bergstraat 71,2023-04-21,00:00:00,6,2,4,FMN GV 11 Ramsel
66,Bergstraat 71,2023-04-21,01:00:00,2,0,2,FMN GV 11 Ramsel
66,Bergstraat 71,2023-04-21,02:00:00,0,0,0,FMN GV 11 Ramsel
66,Bergstraat 71,2023-04-21,03:00:00,0,0,0,FMN GV 11 Ramsel
66,Bergstraat 71,2023-04-21,04:00:00,6,4,2,FMN GV 11 Ramsel
66,Bergstraat 71,2023-04-21,05:00:00,18,6,12,FMN GV 11 Ramsel
66,Bergstraat 71,2023-04-21,06:00:00,24,6,18,FMN GV 11 Ramsel
66,Bergstraat 71,2023-04-21,07:00:00,204,24,180,FMN GV 11 Ramsel
66,Bergstraat 71,2023-04-21,08:00:00,220,38,182,FMN GV 11 Ramsel
66,Bergstraat 71,2023-04-21,09:00:00,78,34,44,FMN GV 11 Ramsel
66,Bergstraat 71,2023-04-21,10:00:00,90,30,60,FMN GV 11 Ramsel
66,Bergstraat 71,2023-04-21,11:00:00,102,42,60,FMN GV 11 Ramsel
66,Bergstraat 71,2023-04-21,12:00:00,112,48,64,FMN GV 11 Ramsel
66,Bergstraat 71,2023-04-21,13:00:00,188,86,102,FMN GV 11 Ramsel
66,Bergstraat 71,2023-04-21,14:00:00,214,130,84,FMN GV 11 Ramsel
66,Bergstraat 71,2023-04-21,15:00:00,348,252,96,FMN GV 11 Ramsel
66,Bergstraat 71,2023-04-21,16:00:00,224,142,82,FMN GV 11 Ramsel
66,Bergstraat 71,2023-04-21,17:00:00,122,78,44,FMN GV 11 Ramsel
66,Bergstraat 71,2023-04-21,18:00:00,66,34,32,FMN GV 11 Ramsel
66,Bergstraat 71,2023-04-21,19:00:00,52,32,20,FMN GV 11 Ramsel
66,Bergstraat 71,2023-04-21,20:00:00,72,36,36,FMN GV 11 Ramsel
66,Bergstraat 71,2023-04-21,21:00:00,2,0,2,FMN GV 11 Ramsel
66,Bergstraat 71,2023-04-21,22:00:00,10,4,6,FMN GV 11 Ramsel
66,Bergstraat 71,2023-04-21,23:00:00,6,4,2,FMN GV 11 Ramsel
66,Bergstraat 71,2023-04-22,00:00:00,2,2,0,FMN GV 11 Ramsel
66,Bergstraat 71,2023-04-22,01:00:00,0,0,0,FMN GV 11 Ramsel
66,Bergstraat 71,2023-04-22,02:00:00,2,2,0,FMN GV 11 Ramsel
66,Bergstraat 71,2023-04-22,03:00:00,0,0,0,FMN GV 11 Ramsel
66,Bergstraat 71,2023-04-22,04:00:00,2,2,0,FMN GV 11 Ramsel
66,Bergstraat 71,2023-04-22,05:00:00,8,0,8,FMN GV 11 Ramsel
66,Bergstraat 71,2023-04-22,06:00:00,6,2,4,FMN GV 11 Ramsel
66,Bergstraat 71,2023-04-22,07:00:00,16,8,8,FMN GV 11 Ramsel
66,Bergstraat 71,2023-04-22,08:00:00,46,18,28,FMN GV 11 Ramsel
66,Bergstraat 71,2023-04-22,09:00:00,102,62,40,FMN GV 11 Ramsel
66,Bergstraat 71,2023-04-22,10:00:00,98,50,48,FMN GV 11 Ramsel
66,Bergstraat 71,2023-04-22,11:00:00,124,72,52,FMN GV 11 Ramsel
66,Bergstraat 71,2023-04-22,12:00:00,58,36,22,FMN GV 11 Ramsel
66,Bergstraat 71,2023-04-22,13:00:00,44,34,10,FMN GV 11 Ramsel
66,Bergstraat 71,2023-04-22,14:00:00,30,12,18,FMN GV 11 Ramsel
66,Bergstraat 71,2023-04-22,15:00:00,38,26,12,FMN GV 11 Ramsel
66,Bergstraat 71,2023-04-22,16:00:00,18,16,2,FMN GV 11 Ramsel
66,Bergstraat 71,2023-04-22,17:00:00,24,4,20,FMN GV 11 Ramsel
66,Bergstraat 71,2023-04-22,18:00:00,22,10,12,FMN GV 11 Ramsel
66,Bergstraat 71,2023-04-22,19:00:00,26,14,12,FMN GV 11 Ramsel
66,Bergstraat 71,2023-04-22,20:00:00,10,2,8,FMN GV 11 Ramsel
66,Bergstraat 71,2023-04-22,21:00:00,0,0,0,FMN GV 11 Ramsel
66,Bergstraat 71,2023-04-22,22:00:00,10,8,2,FMN GV 11 Ramsel
66,Bergstraat 71,2023-04-22,23:00:00,12,4,8,FMN GV 11 Ramsel
66,Bergstraat 71,2023-04-23,00:00:00,0,0,0,FMN GV 11 Ramsel
66,Bergstraat 71,2023-04-23,01:00:00,4,4,0,FMN GV 11 Ramsel
66,Bergstraat 71,2023-04-23,02:00:00,2,2,0,FMN GV 11 Ramsel
66,Bergstraat 71,2023-04-23,03:00:00,2,0,2,FMN GV 11 Ramsel
66,Bergstraat 71,2023-04-23,04:00:00,2,2,0,FMN GV 11 Ramsel
66,Bergstraat 71,2023-04-23,05:00:00,4,2,2,FMN GV 11 Ramsel
66,Bergstraat 71,2023-04-23,06:00:00,0,0,0,FMN GV 11 Ramsel
66,Bergstraat 71,2023-04-23,07:00:00,34,8,26,FMN GV 11 Ramsel
66,Bergstraat 71,2023-04-23,08:00:00,102,18,84,FMN GV 11 Ramsel
66,Bergstraat 71,2023-04-23,09:00:00,246,58,188,FMN GV 11 Ramsel
66,Bergstraat 71,2023-04-23,10:00:00,154,72,82,FMN GV 11 Ramsel
66,Bergstraat 71,2023-04-23,11:00:00,256,160,96,FMN GV 11 Ramsel
66,Bergstraat 71,2023-04-23,12:00:00,112,70,42,FMN GV 11 Ramsel
66,Bergstraat 71,2023-04-23,13:00:00,120,60,60,FMN GV 11 Ramsel
66,Bergstraat 71,2023-04-23,14:00:00,62,36,26,FMN GV 11 Ramsel
66,Bergstraat 71,2023-04-23,15:00:00,10,10,0,FMN GV 11 Ramsel
66,Bergstraat 71,2023-04-23,16:00:00,26,24,2,FMN GV 11 Ramsel
66,Bergstraat 71,2023-04-23,17:00:00,20,16,4,FMN GV 11 Ramsel
66,Bergstraat 71,2023-04-23,18:00:00,30,16,14,FMN GV 11 Ramsel
66,Bergstraat 71,2023-04-23,19:00:00,16,8,8,FMN GV 11 Ramsel
66,Bergstraat 71,2023-04-23,20:00:00,14,4,10,FMN GV 11 Ramsel
66,Bergstraat 71,2023-04-23,21:00:00,12,6,6,FMN GV 11 Ramsel
66,Bergstraat 71,2023-04-23,22:00:00,4,4,0,FMN GV 11 Ramsel
66,Bergstraat 71,2023-04-23,23:00:00,4,4,0,FMN GV 11 Ramsel
66,Bergstraat 71,2023-04-24,00:00:00,2,2,0,FMN GV 11 Ramsel
66,Bergstraat 71,2023-04-24,01:00:00,0,0,0,FMN GV 11 Ramsel
66,Bergstraat 71,2023-04-24,02:00:00,0,0,0,FMN GV 11 Ramsel
66,Bergstraat 71,2023-04-24,03:00:00,0,0,0,FMN GV 11 Ramsel
66,Bergstraat 71,2023-04-24,04:00:00,6,4,2,FMN GV 11 Ramsel
66,Bergstraat 71,2023-04-24,05:00:00,20,14,6,FMN GV 11 Ramsel
66,Bergstraat 71,2023-04-24,06:00:00,16,2,14,FMN GV 11 Ramsel
66,Bergstraat 71,2023-04-24,07:00:00,76,18,58,FMN GV 11 Ramsel
66,Bergstraat 71,2023-04-24,08:00:00,90,14,76,FMN GV 11 Ramsel
66,Bergstraat 71,2023-04-24,09:00:00,24,10,14,FMN GV 11 Ramsel
66,Bergstraat 71,2023-04-24,10:00:00,8,4,4,FMN GV 11 Ramsel
66,Bergstraat 71,2023-04-24,11:00:00,12,6,6,FMN GV 11 Ramsel
66,Bergstraat 71,2023-04-24,12:00:00,30,14,16,FMN GV 11 Ramsel
66,Bergstraat 71,2023-04-24,13:00:00,52,26,26,FMN GV 11 Ramsel
66,Bergstraat 71,2023-04-24,14:00:00,56,40,16,FMN GV 11 Ramsel
66,Bergstraat 71,2023-04-24,15:00:00,96,78,18,FMN GV 11 Ramsel
66,Bergstraat 71,2023-04-24,16:00:00,82,52,30,FMN GV 11 Ramsel
66,Bergstraat 71,2023-04-24,17:00:00,62,40,22,FMN GV 11 Ramsel
66,Bergstraat 71,2023-04-24,18:00:00,34,10,24,FMN GV 11 Ramsel
66,Bergstraat 71,2023-04-24,19:00:00,44,20,24,FMN GV 11 Ramsel
66,Bergstraat 71,2023-04-24,20:00:00,30,18,12,FMN GV 11 Ramsel
66,Bergstraat 71,2023-04-24,21:00:00,24,22,2,FMN GV 11 Ramsel
66,Bergstraat 71,2023-04-24,22:00:00,14,10,4,FMN GV 11 Ramsel
66,Bergstraat 71,2023-04-24,23:00:00,6,4,2,FMN GV 11 Ramsel
66,Bergstraat 71,2023-04-25,00:00:00,0,0,0,FMN GV 11 Ramsel
66,Bergstraat 71,2023-04-25,01:00:00,0,0,0,FMN GV 11 Ramsel
66,Bergstraat 71,2023-04-25,02:00:00,0,0,0,FMN GV 11 Ramsel
66,Bergstraat 71,2023-04-25,03:00:00,0,0,0,FMN GV 11 Ramsel
66,Bergstraat 71,2023-04-25,04:00:00,8,6,2,FMN GV 11 Ramsel
66,Bergstraat 71,2023-04-25,05:00:00,16,6,10,FMN GV 11 Ramsel
66,Bergstraat 71,2023-04-25,06:00:00,52,22,30,FMN GV 11 Ramsel
66,Bergstraat 71,2023-04-25,07:00:00,200,24,176,FMN GV 11 Ramsel
66,Bergstraat 71,2023-04-25,08:00:00,152,18,134,FMN GV 11 Ramsel
66,Bergstraat 71,2023-04-25,09:00:00,46,18,28,FMN GV 11 Ramsel
66,Bergstraat 71,2023-04-25,10:00:00,46,28,18,FMN GV 11 Ramsel
66,Bergstraat 71,2023-04-25,11:00:00,52,18,34,FMN GV 11 Ramsel
66,Bergstraat 71,2023-04-25,12:00:00,66,32,34,FMN GV 11 Ramsel
66,Bergstraat 71,2023-04-25,13:00:00,126,66,60,FMN GV 11 Ramsel
66,Bergstraat 71,2023-04-25,14:00:00,92,60,32,FMN GV 11 Ramsel
66,Bergstraat 71,2023-04-25,15:00:00,230,182,48,FMN GV 11 Ramsel
66,Bergstraat 71,2023-04-25,16:00:00,210,146,64,FMN GV 11 Ramsel
66,Bergstraat 71,2023-04-25,17:00:00,162,102,60,FMN GV 11 Ramsel
66,Bergstraat 71,2023-04-25,18:00:00,124,66,58,FMN GV 11 Ramsel
66,Bergstraat 71,2023-04-25,19:00:00,78,34,44,FMN GV 11 Ramsel
66,Bergstraat 71,2023-04-25,20:00:00,40,22,18,FMN GV 11 Ramsel
66,Bergstraat 71,2023-04-25,21:00:00,40,34,6,FMN GV 11 Ramsel
66,Bergstraat 71,2023-04-25,22:00:00,12,10,2,FMN GV 11 Ramsel
66,Bergstraat 71,2023-04-25,23:00:00,2,2,0,FMN GV 11 Ramsel
66,Bergstraat 71,2023-04-26,00:00:00,0,0,0,FMN GV 11 Ramsel
66,Bergstraat 71,2023-04-26,01:00:00,0,0,0,FMN GV 11 Ramsel
66,Bergstraat 71,2023-04-26,02:00:00,0,0,0,FMN GV 11 Ramsel
66,Bergstraat 71,2023-04-26,03:00:00,0,0,0,FMN GV 11 Ramsel
66,Bergstraat 71,2023-04-26,04:00:00,8,8,0,FMN GV 11 Ramsel
66,Bergstraat 71,2023-04-26,05:00:00,16,4,12,FMN GV 11 Ramsel
66,Bergstraat 71,2023-04-26,06:00:00,28,12,16,FMN GV 11 Ramsel
66,Bergstraat 71,2023-04-26,07:00:00,192,18,174,FMN GV 11 Ramsel
66,Bergstraat 71,2023-04-26,08:00:00,192,18,174,FMN GV 11 Ramsel
66,Bergstraat 71,2023-04-26,09:00:00,74,34,40,FMN GV 11 Ramsel
66,Bergstraat 71,2023-04-26,10:00:00,80,42,38,FMN GV 11 Ramsel
66,Bergstraat 71,2023-04-26,11:00:00,104,60,44,FMN GV 11 Ramsel
66,Bergstraat 71,2023-04-26,12:00:00,264,222,42,FMN GV 11 Ramsel
66,Bergstraat 71,2023-04-26,13:00:00,162,76,86,FMN GV 11 Ramsel
66,Bergstraat 71,2023-04-26,14:00:00,192,104,88,FMN GV 11 Ramsel
66,Bergstraat 71,2023-04-26,15:00:00,166,94,72,FMN GV 11 Ramsel
66,Bergstraat 71,2023-04-26,16:00:00,136,80,56,FMN GV 11 Ramsel
66,Bergstraat 71,2023-04-26,17:00:00,162,76,86,FMN GV 11 Ramsel
66,Bergstraat 71,2023-04-26,18:00:00,132,94,38,FMN GV 11 Ramsel
66,Bergstraat 71,2023-04-26,19:00:00,102,62,40,FMN GV 11 Ramsel
66,Bergstraat 71,2023-04-26,20:00:00,56,40,16,FMN GV 11 Ramsel
66,Bergstraat 71,2023-04-26,21:00:00,32,26,6,FMN GV 11 Ramsel
66,Bergstraat 71,2023-04-26,22:00:00,20,12,8,FMN GV 11 Ramsel
66,Bergstraat 71,2023-04-26,23:00:00,4,2,2,FMN GV 11 Ramsel
66,Bergstraat 71,2023-04-27,00:00:00,0,0,0,FMN GV 11 Ramsel
66,Bergstraat 71,2023-04-27,01:00:00,2,2,0,FMN GV 11 Ramsel
66,Bergstraat 71,2023-04-27,02:00:00,0,0,0,FMN GV 11 Ramsel
66,Bergstraat 71,2023-04-27,03:00:00,0,0,0,FMN GV 11 Ramsel
66,Bergstraat 71,2023-04-27,04:00:00,8,6,2,FMN GV 11 Ramsel
66,Bergstraat 71,2023-04-27,05:00:00,10,4,6,FMN GV 11 Ramsel
66,Bergstraat 71,2023-04-27,06:00:00,52,20,32,FMN GV 11 Ramsel
66,Bergstraat 71,2023-04-27,07:00:00,190,14,176,FMN GV 11 Ramsel
66,Bergstraat 71,2023-04-27,08:00:00,226,42,184,FMN GV 11 Ramsel
66,Bergstraat 71,2023-04-27,09:00:00,68,14,54,FMN GV 11 Ramsel
66,Bergstraat 71,2023-04-27,10:00:00,68,20,48,FMN GV 11 Ramsel
66,Bergstraat 71,2023-04-27,11:00:00,74,40,34,FMN GV 11 Ramsel
66,Bergstraat 71,2023-04-27,12:00:00,76,40,36,FMN GV 11 Ramsel
66,Bergstraat 71,2023-04-27,13:00:00,144,58,86,FMN GV 11 Ramsel
66,Bergstraat 71,2023-04-27,14:00:00,184,90,94,FMN GV 11 Ramsel
66,Bergstraat 71,2023-04-27,15:00:00,248,180,68,FMN GV 11 Ramsel
66,Bergstraat 71,2023-04-27,16:00:00,230,176,54,FMN GV 11 Ramsel
66,Bergstraat 71,2023-04-27,17:00:00,186,94,92,FMN GV 11 Ramsel
66,Bergstraat 71,2023-04-27,18:00:00,136,64,72,FMN GV 11 Ramsel
66,Bergstraat 71,2023-04-27,19:00:00,54,42,12,FMN GV 11 Ramsel
66,Bergstraat 71,2023-04-27,20:00:00,70,68,2,FMN GV 11 Ramsel
66,Bergstraat 71,2023-04-27,21:00:00,18,16,2,FMN GV 11 Ramsel
66,Bergstraat 71,2023-04-27,22:00:00,14,10,4,FMN GV 11 Ramsel
66,Bergstraat 71,2023-04-27,23:00:00,8,6,2,FMN GV 11 Ramsel
66,Bergstraat 71,2023-04-28,00:00:00,2,2,0,FMN GV 11 Ramsel
66,Bergstraat 71,2023-04-28,01:00:00,2,2,0,FMN GV 11 Ramsel
66,Bergstraat 71,2023-04-28,02:00:00,0,0,0,FMN GV 11 Ramsel
66,Bergstraat 71,2023-04-28,03:00:00,0,0,0,FMN GV 11 Ramsel
66,Bergstraat 71,2023-04-28,04:00:00,6,4,2,FMN GV 11 Ramsel
66,Bergstraat 71,2023-04-28,05:00:00,12,4,8,FMN GV 11 Ramsel
66,Bergstraat 71,2023-04-28,06:00:00,36,16,20,FMN GV 11 Ramsel
66,Bergstraat 71,2023-04-28,07:00:00,160,22,138,FMN GV 11 Ramsel
66,Bergstraat 71,2023-04-28,08:00:00,168,22,146,FMN GV 11 Ramsel
66,Bergstraat 71,2023-04-28,09:00:00,34,6,28,FMN GV 11 Ramsel
66,Bergstraat 71,2023-04-28,10:00:00,34,12,22,FMN GV 11 Ramsel
66,Bergstraat 71,2023-04-28,11:00:00,48,22,26,FMN GV 11 Ramsel
66,Bergstraat 71,2023-04-28,12:00:00,42,18,24,FMN GV 11 Ramsel
66,Bergstraat 71,2023-04-28,13:00:00,58,44,14,FMN GV 11 Ramsel
66,Bergstraat 71,2023-04-28,14:00:00,100,50,50,FMN GV 11 Ramsel
66,Bergstraat 71,2023-04-28,15:00:00,212,176,36,FMN GV 11 Ramsel
66,Bergstraat 71,2023-04-28,16:00:00,132,114,18,FMN GV 11 Ramsel
66,Bergstraat 71,2023-04-28,17:00:00,68,40,28,FMN GV 11 Ramsel
66,Bergstraat 71,2023-04-28,18:00:00,56,28,28,FMN GV 11 Ramsel
66,Bergstraat 71,2023-04-28,19:00:00,48,30,18,FMN GV 11 Ramsel
66,Bergstraat 71,2023-04-28,20:00:00,20,6,14,FMN GV 11 Ramsel
66,Bergstraat 71,2023-04-28,21:00:00,8,6,2,FMN GV 11 Ramsel
66,Bergstraat 71,2023-04-28,22:00:00,8,2,6,FMN GV 11 Ramsel
66,Bergstraat 71,2023-04-28,23:00:00,8,6,2,FMN GV 11 Ramsel
66,Bergstraat 71,2023-04-29,00:00:00,6,4,2,FMN GV 11 Ramsel
66,Bergstraat 71,2023-04-29,01:00:00,12,10,2,FMN GV 11 Ramsel
66,Bergstraat 71,2023-04-29,02:00:00,6,2,4,FMN GV 11 Ramsel
66,Bergstraat 71,2023-04-29,03:00:00,2,0,2,FMN GV 11 Ramsel
66,Bergstraat 71,2023-04-29,04:00:00,2,0,2,FMN GV 11 Ramsel
66,Bergstraat 71,2023-04-29,05:00:00,0,0,0,FMN GV 11 Ramsel
66,Bergstraat 71,2023-04-29,06:00:00,6,4,2,FMN GV 11 Ramsel
66,Bergstraat 71,2023-04-29,07:00:00,18,6,12,FMN GV 11 Ramsel
66,Bergstraat 71,2023-04-29,08:00:00,42,22,20,FMN GV 11 Ramsel
66,Bergstraat 71,2023-04-29,09:00:00,90,36,54,FMN GV 11 Ramsel
66,Bergstraat 71,2023-04-29,10:00:00,98,52,46,FMN GV 11 Ramsel
66,Bergstraat 71,2023-04-29,11:00:00,118,62,56,FMN GV 11 Ramsel
66,Bergstraat 71,2023-04-29,12:00:00,122,58,64,FMN GV 11 Ramsel
66,Bergstraat 71,2023-04-29,13:00:00,158,80,78,FMN GV 11 Ramsel
66,Bergstraat 71,2023-04-29,14:00:00,194,90,104,FMN GV 11 Ramsel
66,Bergstraat 71,2023-04-29,15:00:00,152,82,70,FMN GV 11 Ramsel
66,Bergstraat 71,2023-04-29,16:00:00,154,96,58,FMN GV 11 Ramsel
66,Bergstraat 71,2023-04-29,17:00:00,104,46,58,FMN GV 11 Ramsel
66,Bergstraat 71,2023-04-29,18:00:00,40,24,16,FMN GV 11 Ramsel
66,Bergstraat 71,2023-04-29,19:00:00,38,20,18,FMN GV 11 Ramsel
66,Bergstraat 71,2023-04-29,20:00:00,22,10,12,FMN GV 11 Ramsel
66,Bergstraat 71,2023-04-29,21:00:00,12,8,4,FMN GV 11 Ramsel
66,Bergstraat 71,2023-04-29,22:00:00,16,6,10,FMN GV 11 Ramsel
66,Bergstraat 71,2023-04-29,23:00:00,8,4,4,FMN GV 11 Ramsel
66,Bergstraat 71,2023-04-30,00:00:00,4,2,2,FMN GV 11 Ramsel
66,Bergstraat 71,2023-04-30,01:00:00,16,4,12,FMN GV 11 Ramsel
66,Bergstraat 71,2023-04-30,02:00:00,2,2,0,FMN GV 11 Ramsel
66,Bergstraat 71,2023-04-30,03:00:00,2,2,0,FMN GV 11 Ramsel
66,Bergstraat 71,2023-04-30,04:00:00,4,0,4,FMN GV 11 Ramsel
66,Bergstraat 71,2023-04-30,05:00:00,0,0,0,FMN GV 11 Ramsel
66,Bergstraat 71,2023-04-30,06:00:00,8,2,6,FMN GV 11 Ramsel
66,Bergstraat 71,2023-04-30,07:00:00,34,10,24,FMN GV 11 Ramsel
66,Bergstraat 71,2023-04-30,08:00:00,86,34,52,FMN GV 11 Ramsel
66,Bergstraat 71,2023-04-30,09:00:00,108,38,70,FMN GV 11 Ramsel
66,Bergstraat 71,2023-04-30,10:00:00,206,90,116,FMN GV 11 Ramsel
66,Bergstraat 71,2023-04-30,11:00:00,248,140,108,FMN GV 11 Ramsel
66,Bergstraat 71,2023-04-30,12:00:00,208,104,104,FMN GV 11 Ramsel
66,Bergstraat 71,2023-04-30,13:00:00,272,156,116,FMN GV 11 Ramsel
66,Bergstraat 71,2023-04-30,14:00:00,460,230,230,FMN GV 11 Ramsel
66,Bergstraat 71,2023-04-30,15:00:00,312,158,154,FMN GV 11 Ramsel
66,Bergstraat 71,2023-04-30,16:00:00,260,128,132,FMN GV 11 Ramsel
66,Bergstraat 71,2023-04-30,17:00:00,162,80,82,FMN GV 11 Ramsel
66,Bergstraat 71,2023-04-30,18:00:00,118,66,52,FMN GV 11 Ramsel
66,Bergstraat 71,2023-04-30,19:00:00,154,66,88,FMN GV 11 Ramsel
66,Bergstraat 71,2023-04-30,20:00:00,52,14,38,FMN GV 11 Ramsel
66,Bergstraat 71,2023-04-30,21:00:00,40,32,8,FMN GV 11 Ramsel
66,Bergstraat 71,2023-04-30,22:00:00,32,24,8,FMN GV 11 Ramsel
66,Bergstraat 71,2023-04-30,23:00:00,8,8,0,FMN GV 11 Ramsel
66,Bergstraat 71,2023-05-01,00:00:00,14,14,0,FMN GV 11 Ramsel
66,Bergstraat 71,2023-05-01,01:00:00,18,14,4,FMN GV 11 Ramsel
66,Bergstraat 71,2023-05-01,02:00:00,24,20,4,FMN GV 11 Ramsel
66,Bergstraat 71,2023-05-01,03:00:00,18,18,0,FMN GV 11 Ramsel
66,Bergstraat 71,2023-05-01,04:00:00,4,4,0,FMN GV 11 Ramsel
66,Bergstraat 71,2023-05-01,05:00:00,2,2,0,FMN GV 11 Ramsel
66,Bergstraat 71,2023-05-01,06:00:00,0,0,0,FMN GV 11 Ramsel
66,Bergstraat 71,2023-05-01,07:00:00,16,14,2,FMN GV 11 Ramsel
66,Bergstraat 71,2023-05-01,08:00:00,38,16,22,FMN GV 11 Ramsel
66,Bergstraat 71,2023-05-01,09:00:00,152,88,64,FMN GV 11 Ramsel
66,Bergstraat 71,2023-05-01,10:00:00,164,66,98,FMN GV 11 Ramsel
66,Bergstraat 71,2023-05-01,11:00:00,184,86,98,FMN GV 11 Ramsel
66,Bergstraat 71,2023-05-01,12:00:00,160,94,66,FMN GV 11 Ramsel
66,Bergstraat 71,2023-05-01,13:00:00,190,88,102,FMN GV 11 Ramsel
66,Bergstraat 71,2023-05-01,14:00:00,224,130,94,FMN GV 11 Ramsel
66,Bergstraat 71,2023-05-01,15:00:00,192,106,86,FMN GV 11 Ramsel
66,Bergstraat 71,2023-05-01,16:00:00,160,86,74,FMN GV 11 Ramsel
66,Bergstraat 71,2023-05-01,17:00:00,110,58,52,FMN GV 11 Ramsel
66,Bergstraat 71,2023-05-01,18:00:00,54,16,38,FMN GV 11 Ramsel
66,Bergstraat 71,2023-05-01,19:00:00,56,24,32,FMN GV 11 Ramsel
66,Bergstraat 71,2023-05-01,20:00:00,42,16,26,FMN GV 11 Ramsel
66,Bergstraat 71,2023-05-01,21:00:00,16,12,4,FMN GV 11 Ramsel
66,Bergstraat 71,2023-05-01,22:00:00,4,4,0,FMN GV 11 Ramsel
66,Bergstraat 71,2023-05-01,23:00:00,10,6,4,FMN GV 11 Ramsel
66,Bergstraat 71,2023-05-02,00:00:00,0,0,0,FMN GV 11 Ramsel
66,Bergstraat 71,2023-05-02,01:00:00,0,0,0,FMN GV 11 Ramsel
66,Bergstraat 71,2023-05-02,02:00:00,0,0,0,FMN GV 11 Ramsel
66,Bergstraat 71,2023-05-02,03:00:00,0,0,0,FMN GV 11 Ramsel
66,Bergstraat 71,2023-05-02,04:00:00,8,6,2,FMN GV 11 Ramsel
66,Bergstraat 71,2023-05-02,05:00:00,18,8,10,FMN GV 11 Ramsel
66,Bergstraat 71,2023-05-02,06:00:00,74,26,48,FMN GV 11 Ramsel
66,Bergstraat 71,2023-05-02,07:00:00,220,30,190,FMN GV 11 Ramsel
66,Bergstraat 71,2023-05-02,08:00:00,198,30,168,FMN GV 11 Ramsel
66,Bergstraat 71,2023-05-02,09:00:00,76,20,56,FMN GV 11 Ramsel
66,Bergstraat 71,2023-05-02,10:00:00,68,34,34,FMN GV 11 Ramsel
66,Bergstraat 71,2023-05-02,11:00:00,44,16,28,FMN GV 11 Ramsel
66,Bergstraat 71,2023-05-02,12:00:00,112,66,46,FMN GV 11 Ramsel
66,Bergstraat 71,2023-05-02,13:00:00,126,66,60,FMN GV 11 Ramsel
66,Bergstraat 71,2023-05-02,14:00:00,150,74,76,FMN GV 11 Ramsel
66,Bergstraat 71,2023-05-02,15:00:00,256,206,50,FMN GV 11 Ramsel
66,Bergstraat 71,2023-05-02,16:00:00,278,212,66,FMN GV 11 Ramsel
66,Bergstraat 71,2023-05-02,17:00:00,188,108,80,FMN GV 11 Ramsel
66,Bergstraat 71,2023-05-02,18:00:00,144,78,66,FMN GV 11 Ramsel
66,Bergstraat 71,2023-05-02,19:00:00,96,48,48,FMN GV 11 Ramsel
66,Bergstraat 71,2023-05-02,20:00:00,98,38,60,FMN GV 11 Ramsel
66,Bergstraat 71,2023-05-02,21:00:00,46,26,20,FMN GV 11 Ramsel
66,Bergstraat 71,2023-05-02,22:00:00,20,10,10,FMN GV 11 Ramsel
66,Bergstraat 71,2023-05-02,23:00:00,2,2,0,FMN GV 11 Ramsel
66,Bergstraat 71,2023-05-03,00:00:00,2,2,0,FMN GV 11 Ramsel
66,Bergstraat 71,2023-05-03,01:00:00,0,0,0,FMN GV 11 Ramsel
66,Bergstraat 71,2023-05-03,02:00:00,0,0,0,FMN GV 11 Ramsel
66,Bergstraat 71,2023-05-03,03:00:00,2,0,2,FMN GV 11 Ramsel
66,Bergstraat 71,2023-05-03,04:00:00,4,2,2,FMN GV 11 Ramsel
66,Bergstraat 71,2023-05-03,05:00:00,16,10,6,FMN GV 11 Ramsel
66,Bergstraat 71,2023-05-03,06:00:00,50,24,26,FMN GV 11 Ramsel
66,Bergstraat 71,2023-05-03,07:00:00,236,30,206,FMN GV 11 Ramsel
66,Bergstraat 71,2023-05-03,08:00:00,204,30,174,FMN GV 11 Ramsel
66,Bergstraat 71,2023-05-03,09:00:00,84,40,44,FMN GV 11 Ramsel
66,Bergstraat 71,2023-05-03,10:00:00,68,38,30,FMN GV 11 Ramsel
66,Bergstraat 71,2023-05-03,11:00:00,118,66,52,FMN GV 11 Ramsel
66,Bergstraat 71,2023-05-03,12:00:00,320,270,50,FMN GV 11 Ramsel
66,Bergstraat 71,2023-05-03,13:00:00,226,120,106,FMN GV 11 Ramsel
66,Bergstraat 71,2023-05-03,14:00:00,190,100,90,FMN GV 11 Ramsel
66,Bergstraat 71,2023-05-03,15:00:00,196,110,86,FMN GV 11 Ramsel
66,Bergstraat 71,2023-05-03,16:00:00,238,134,104,FMN GV 11 Ramsel
66,Bergstraat 71,2023-05-03,17:00:00,186,94,92,FMN GV 11 Ramsel
66,Bergstraat 71,2023-05-03,18:00:00,136,74,62,FMN GV 11 Ramsel
66,Bergstraat 71,2023-05-03,19:00:00,102,50,52,FMN GV 11 Ramsel
66,Bergstraat 71,2023-05-03,20:00:00,96,62,34,FMN GV 11 Ramsel
66,Bergstraat 71,2023-05-03,21:00:00,46,34,12,FMN GV 11 Ramsel
66,Bergstraat 71,2023-05-03,22:00:00,28,20,8,FMN GV 11 Ramsel
66,Bergstraat 71,2023-05-03,23:00:00,4,4,0,FMN GV 11 Ramsel
66,Bergstraat 71,2023-05-04,00:00:00,0,0,0,FMN GV 11 Ramsel
66,Bergstraat 71,2023-05-04,01:00:00,0,0,0,FMN GV 11 Ramsel
66,Bergstraat 71,2023-05-04,02:00:00,0,0,0,FMN GV 11 Ramsel
66,Bergstraat 71,2023-05-04,03:00:00,0,0,0,FMN GV 11 Ramsel
66,Bergstraat 71,2023-05-04,04:00:00,6,4,2,FMN GV 11 Ramsel
66,Bergstraat 71,2023-05-04,05:00:00,20,10,10,FMN GV 11 Ramsel
66,Bergstraat 71,2023-05-04,06:00:00,62,16,46,FMN GV 11 Ramsel
66,Bergstraat 71,2023-05-04,07:00:00,244,32,212,FMN GV 11 Ramsel
66,Bergstraat 71,2023-05-04,08:00:00,254,42,212,FMN GV 11 Ramsel
66,Bergstraat 71,2023-05-04,09:00:00,84,10,74,FMN GV 11 Ramsel
66,Bergstraat 71,2023-05-04,10:00:00,102,52,50,FMN GV 11 Ramsel
66,Bergstraat 71,2023-05-04,11:00:00,98,48,50,FMN GV 11 Ramsel
66,Bergstraat 71,2023-05-04,12:00:00,186,90,96,FMN GV 11 Ramsel
66,Bergstraat 71,2023-05-04,13:00:00,248,100,148,FMN GV 11 Ramsel
66,Bergstraat 71,2023-05-04,14:00:00,310,182,128,FMN GV 11 Ramsel
66,Bergstraat 71,2023-05-04,15:00:00,416,308,108,FMN GV 11 Ramsel
66,Bergstraat 71,2023-05-04,16:00:00,326,232,94,FMN GV 11 Ramsel
66,Bergstraat 71,2023-05-04,17:00:00,198,140,58,FMN GV 11 Ramsel
66,Bergstraat 71,2023-05-04,18:00:00,184,92,92,FMN GV 11 Ramsel
66,Bergstraat 71,2023-05-04,19:00:00,102,72,30,FMN GV 11 Ramsel
66,Bergstraat 71,2023-05-04,20:00:00,70,46,24,FMN GV 11 Ramsel
66,Bergstraat 71,2023-05-04,21:00:00,26,14,12,FMN GV 11 Ramsel
66,Bergstraat 71,2023-05-04,22:00:00,30,24,6,FMN GV 11 Ramsel
66,Bergstraat 71,2023-05-04,23:00:00,12,8,4,FMN GV 11 Ramsel
66,Bergstraat 71,2023-05-05,00:00:00,2,2,0,FMN GV 11 Ramsel
66,Bergstraat 71,2023-05-05,01:00:00,6,0,6,FMN GV 11 Ramsel
66,Bergstraat 71,2023-05-05,02:00:00,0,0,0,FMN GV 11 Ramsel
66,Bergstraat 71,2023-05-05,03:00:00,0,0,0,FMN GV 11 Ramsel
66,Bergstraat 71,2023-05-05,04:00:00,10,4,6,FMN GV 11 Ramsel
66,Bergstraat 71,2023-05-05,05:00:00,20,6,14,FMN GV 11 Ramsel
66,Bergstraat 71,2023-05-05,06:00:00,38,18,20,FMN GV 11 Ramsel
66,Bergstraat 71,2023-05-05,07:00:00,228,26,202,FMN GV 11 Ramsel
66,Bergstraat 71,2023-05-05,08:00:00,220,18,202,FMN GV 11 Ramsel
66,Bergstraat 71,2023-05-05,09:00:00,80,30,50,FMN GV 11 Ramsel
66,Bergstraat 71,2023-05-05,10:00:00,76,28,48,FMN GV 11 Ramsel
66,Bergstraat 71,2023-05-05,11:00:00,24,14,10,FMN GV 11 Ramsel
66,Bergstraat 71,2023-05-05,12:00:00,56,46,10,FMN GV 11 Ramsel
66,Bergstraat 71,2023-05-05,13:00:00,34,28,6,FMN GV 11 Ramsel
66,Bergstraat 71,2023-05-05,14:00:00,70,46,24,FMN GV 11 Ramsel
66,Bergstraat 71,2023-05-05,15:00:00,238,206,32,FMN GV 11 Ramsel
66,Bergstraat 71,2023-05-05,16:00:00,158,130,28,FMN GV 11 Ramsel
66,Bergstraat 71,2023-05-05,17:00:00,80,54,26,FMN GV 11 Ramsel
66,Bergstraat 71,2023-05-05,18:00:00,46,30,16,FMN GV 11 Ramsel
66,Bergstraat 71,2023-05-05,19:00:00,52,22,30,FMN GV 11 Ramsel
66,Bergstraat 71,2023-05-05,20:00:00,44,12,32,FMN GV 11 Ramsel
66,Bergstraat 71,2023-05-05,21:00:00,38,28,10,FMN GV 11 Ramsel
66,Bergstraat 71,2023-05-05,22:00:00,6,4,2,FMN GV 11 Ramsel
66,Bergstraat 71,2023-05-05,23:00:00,18,6,12,FMN GV 11 Ramsel
66,Bergstraat 71,2023-05-06,00:00:00,2,0,2,FMN GV 11 Ramsel
66,Bergstraat 71,2023-05-06,01:00:00,12,12,0,FMN GV 11 Ramsel
66,Bergstraat 71,2023-05-06,02:00:00,4,4,0,FMN GV 11 Ramsel
66,Bergstraat 71,2023-05-06,03:00:00,0,0,0,FMN GV 11 Ramsel
66,Bergstraat 71,2023-05-06,04:00:00,6,4,2,FMN GV 11 Ramsel
66,Bergstraat 71,2023-05-06,05:00:00,0,0,0,FMN GV 11 Ramsel
66,Bergstraat 71,2023-05-06,06:00:00,8,6,2,FMN GV 11 Ramsel
66,Bergstraat 71,2023-05-06,07:00:00,24,10,14,FMN GV 11 Ramsel
66,Bergstraat 71,2023-05-06,08:00:00,84,26,58,FMN GV 11 Ramsel
66,Bergstraat 71,2023-05-06,09:00:00,110,58,52,FMN GV 11 Ramsel
66,Bergstraat 71,2023-05-06,10:00:00,166,70,96,FMN GV 11 Ramsel
66,Bergstraat 71,2023-05-06,11:00:00,186,98,88,FMN GV 11 Ramsel
66,Bergstraat 71,2023-05-06,12:00:00,156,82,74,FMN GV 11 Ramsel
66,Bergstraat 71,2023-05-06,13:00:00,276,154,122,FMN GV 11 Ramsel
66,Bergstraat 71,2023-05-06,14:00:00,190,84,106,FMN GV 11 Ramsel
66,Bergstraat 71,2023-05-06,15:00:00,150,114,36,FMN GV 11 Ramsel
66,Bergstraat 71,2023-05-06,16:00:00,106,56,50,FMN GV 11 Ramsel
66,Bergstraat 71,2023-05-06,17:00:00,68,54,14,FMN GV 11 Ramsel
66,Bergstraat 71,2023-05-06,18:00:00,48,18,30,FMN GV 11 Ramsel
66,Bergstraat 71,2023-05-06,19:00:00,46,36,10,FMN GV 11 Ramsel
66,Bergstraat 71,2023-05-06,20:00:00,36,10,26,FMN GV 11 Ramsel
66,Bergstraat 71,2023-05-06,21:00:00,14,4,10,FMN GV 11 Ramsel
66,Bergstraat 71,2023-05-06,22:00:00,12,8,4,FMN GV 11 Ramsel
66,Bergstraat 71,2023-05-06,23:00:00,8,8,0,FMN GV 11 Ramsel
66,Bergstraat 71,2023-05-07,00:00:00,6,0,6,FMN GV 11 Ramsel
66,Bergstraat 71,2023-05-07,01:00:00,4,2,2,FMN GV 11 Ramsel
66,Bergstraat 71,2023-05-07,02:00:00,4,4,0,FMN GV 11 Ramsel
66,Bergstraat 71,2023-05-07,03:00:00,4,4,0,FMN GV 11 Ramsel
66,Bergstraat 71,2023-05-07,04:00:00,2,0,2,FMN GV 11 Ramsel
66,Bergstraat 71,2023-05-07,05:00:00,0,0,0,FMN GV 11 Ramsel
66,Bergstraat 71,2023-05-07,06:00:00,6,2,4,FMN GV 11 Ramsel
66,Bergstraat 71,2023-05-07,07:00:00,30,2,28,FMN GV 11 Ramsel
66,Bergstraat 71,2023-05-07,08:00:00,102,18,84,FMN GV 11 Ramsel
66,Bergstraat 71,2023-05-07,09:00:00,112,58,54,FMN GV 11 Ramsel
66,Bergstraat 71,2023-05-07,10:00:00,94,60,34,FMN GV 11 Ramsel
66,Bergstraat 71,2023-05-07,11:00:00,84,32,52,FMN GV 11 Ramsel
66,Bergstraat 71,2023-05-07,12:00:00,36,24,12,FMN GV 11 Ramsel
66,Bergstraat 71,2023-05-07,13:00:00,30,12,18,FMN GV 11 Ramsel
66,Bergstraat 71,2023-05-07,14:00:00,14,10,4,FMN GV 11 Ramsel
66,Bergstraat 71,2023-05-07,15:00:00,38,16,22,FMN GV 11 Ramsel
66,Bergstraat 71,2023-05-07,16:00:00,54,26,28,FMN GV 11 Ramsel
66,Bergstraat 71,2023-05-07,17:00:00,36,18,18,FMN GV 11 Ramsel
66,Bergstraat 71,2023-05-07,18:00:00,40,28,12,FMN GV 11 Ramsel
66,Bergstraat 71,2023-05-07,19:00:00,34,24,10,FMN GV 11 Ramsel
66,Bergstraat 71,2023-05-07,20:00:00,30,6,24,FMN GV 11 Ramsel
66,Bergstraat 71,2023-05-07,21:00:00,20,10,10,FMN GV 11 Ramsel
66,Bergstraat 71,2023-05-07,22:00:00,14,14,0,FMN GV 11 Ramsel
66,Bergstraat 71,2023-05-07,23:00:00,2,2,0,FMN GV 11 Ramsel
66,Bergstraat 71,2023-05-08,00:00:00,0,0,0,FMN GV 11 Ramsel
66,Bergstraat 71,2023-05-08,01:00:00,0,0,0,FMN GV 11 Ramsel
66,Bergstraat 71,2023-05-08,02:00:00,0,0,0,FMN GV 11 Ramsel
66,Bergstraat 71,2023-05-08,03:00:00,2,0,2,FMN GV 11 Ramsel
66,Bergstraat 71,2023-05-08,04:00:00,10,10,0,FMN GV 11 Ramsel
66,Bergstraat 71,2023-05-08,05:00:00,16,8,8,FMN GV 11 Ramsel
66,Bergstraat 71,2023-05-08,06:00:00,54,12,42,FMN GV 11 Ramsel
66,Bergstraat 71,2023-05-08,07:00:00,264,40,224,FMN GV 11 Ramsel
66,Bergstraat 71,2023-05-08,08:00:00,204,22,182,FMN GV 11 Ramsel
66,Bergstraat 71,2023-05-08,09:00:00,82,42,40,FMN GV 11 Ramsel
66,Bergstraat 71,2023-05-08,10:00:00,78,30,48,FMN GV 11 Ramsel
66,Bergstraat 71,2023-05-08,11:00:00,86,22,64,FMN GV 11 Ramsel
66,Bergstraat 71,2023-05-08,12:00:00,94,36,58,FMN GV 11 Ramsel
66,Bergstraat 71,2023-05-08,13:00:00,154,70,84,FMN GV 11 Ramsel
66,Bergstraat 71,2023-05-08,14:00:00,202,124,78,FMN GV 11 Ramsel
66,Bergstraat 71,2023-05-08,15:00:00,268,216,52,FMN GV 11 Ramsel
66,Bergstraat 71,2023-05-08,16:00:00,292,228,64,FMN GV 11 Ramsel
66,Bergstraat 71,2023-05-08,17:00:00,144,72,72,FMN GV 11 Ramsel
66,Bergstraat 71,2023-05-08,18:00:00,152,86,66,FMN GV 11 Ramsel
66,Bergstraat 71,2023-05-08,19:00:00,76,36,40,FMN GV 11 Ramsel
66,Bergstraat 71,2023-05-08,20:00:00,58,36,22,FMN GV 11 Ramsel
66,Bergstraat 71,2023-05-08,21:00:00,36,20,16,FMN GV 11 Ramsel
66,Bergstraat 71,2023-05-08,22:00:00,16,8,8,FMN GV 11 Ramsel
66,Bergstraat 71,2023-05-08,23:00:00,0,0,0,FMN GV 11 Ramsel
66,Bergstraat 71,2023-05-09,00:00:00,2,2,0,FMN GV 11 Ramsel
66,Bergstraat 71,2023-05-09,01:00:00,0,0,0,FMN GV 11 Ramsel
66,Bergstraat 71,2023-05-09,02:00:00,0,0,0,FMN GV 11 Ramsel
66,Bergstraat 71,2023-05-09,03:00:00,0,0,0,FMN GV 11 Ramsel
66,Bergstraat 71,2023-05-09,04:00:00,14,8,6,FMN GV 11 Ramsel
66,Bergstraat 71,2023-05-09,05:00:00,16,8,8,FMN GV 11 Ramsel
66,Bergstraat 71,2023-05-09,06:00:00,30,10,20,FMN GV 11 Ramsel
66,Bergstraat 71,2023-05-09,07:00:00,128,22,106,FMN GV 11 Ramsel
66,Bergstraat 71,2023-05-09,08:00:00,144,20,124,FMN GV 11 Ramsel
66,Bergstraat 71,2023-05-09,09:00:00,32,10,22,FMN GV 11 Ramsel
66,Bergstraat 71,2023-05-09,10:00:00,24,14,10,FMN GV 11 Ramsel
66,Bergstraat 71,2023-05-09,11:00:00,14,12,2,FMN GV 11 Ramsel
66,Bergstraat 71,2023-05-09,12:00:00,24,8,16,FMN GV 11 Ramsel
66,Bergstraat 71,2023-05-09,13:00:00,16,14,2,FMN GV 11 Ramsel
66,Bergstraat 71,2023-05-09,14:00:00,42,34,8,FMN GV 11 Ramsel
66,Bergstraat 71,2023-05-09,15:00:00,110,100,10,FMN GV 11 Ramsel
66,Bergstraat 71,2023-05-09,16:00:00,78,68,10,FMN GV 11 Ramsel
66,Bergstraat 71,2023-05-09,17:00:00,56,38,18,FMN GV 11 Ramsel
66,Bergstraat 71,2023-05-09,18:00:00,32,18,14,FMN GV 11 Ramsel
66,Bergstraat 71,2023-05-09,19:00:00,22,12,10,FMN GV 11 Ramsel
66,Bergstraat 71,2023-05-09,20:00:00,8,8,0,FMN GV 11 Ramsel
66,Bergstraat 71,2023-05-09,21:00:00,18,10,8,FMN GV 11 Ramsel
66,Bergstraat 71,2023-05-09,22:00:00,6,4,2,FMN GV 11 Ramsel
66,Bergstraat 71,2023-05-09,23:00:00,2,2,0,FMN GV 11 Ramsel
66,Bergstraat 71,2023-05-10,00:00:00,0,0,0,FMN GV 11 Ramsel
66,Bergstraat 71,2023-05-10,01:00:00,0,0,0,FMN GV 11 Ramsel
66,Bergstraat 71,2023-05-10,02:00:00,0,0,0,FMN GV 11 Ramsel
66,Bergstraat 71,2023-05-10,03:00:00,0,0,0,FMN GV 11 Ramsel
66,Bergstraat 71,2023-05-10,04:00:00,4,4,0,FMN GV 11 Ramsel
66,Bergstraat 71,2023-05-10,05:00:00,18,10,8,FMN GV 11 Ramsel
66,Bergstraat 71,2023-05-10,06:00:00,20,12,8,FMN GV 11 Ramsel
66,Bergstraat 71,2023-05-10,07:00:00,170,16,154,FMN GV 11 Ramsel
66,Bergstraat 71,2023-05-10,08:00:00,206,28,178,FMN GV 11 Ramsel
66,Bergstraat 71,2023-05-10,09:00:00,38,16,22,FMN GV 11 Ramsel
66,Bergstraat 71,2023-05-10,10:00:00,64,22,42,FMN GV 11 Ramsel
66,Bergstraat 71,2023-05-10,11:00:00,74,54,20,FMN GV 11 Ramsel
66,Bergstraat 71,2023-05-10,12:00:00,226,216,10,FMN GV 11 Ramsel
66,Bergstraat 71,2023-05-10,13:00:00,80,36,44,FMN GV 11 Ramsel
66,Bergstraat 71,2023-05-10,14:00:00,68,34,34,FMN GV 11 Ramsel
66,Bergstraat 71,2023-05-10,15:00:00,86,60,26,FMN GV 11 Ramsel
66,Bergstraat 71,2023-05-10,16:00:00,96,60,36,FMN GV 11 Ramsel
66,Bergstraat 71,2023-05-10,17:00:00,86,42,44,FMN GV 11 Ramsel
66,Bergstraat 71,2023-05-10,18:00:00,74,38,36,FMN GV 11 Ramsel
66,Bergstraat 71,2023-05-10,19:00:00,48,26,22,FMN GV 11 Ramsel
66,Bergstraat 71,2023-05-10,20:00:00,40,24,16,FMN GV 11 Ramsel
66,Bergstraat 71,2023-05-10,21:00:00,36,30,6,FMN GV 11 Ramsel
66,Bergstraat 71,2023-05-10,22:00:00,4,4,0,FMN GV 11 Ramsel
66,Bergstraat 71,2023-05-10,23:00:00,4,4,0,FMN GV 11 Ramsel
66,Bergstraat 71,2023-05-11,00:00:00,2,2,0,FMN GV 11 Ramsel
66,Bergstraat 71,2023-05-11,01:00:00,8,2,6,FMN GV 11 Ramsel
66,Bergstraat 71,2023-05-11,02:00:00,0,0,0,FMN GV 11 Ramsel
66,Bergstraat 71,2023-05-11,03:00:00,0,0,0,FMN GV 11 Ramsel
66,Bergstraat 71,2023-05-11,04:00:00,6,6,0,FMN GV 11 Ramsel
66,Bergstraat 71,2023-05-11,05:00:00,18,12,6,FMN GV 11 Ramsel
66,Bergstraat 71,2023-05-11,06:00:00,44,22,22,FMN GV 11 Ramsel
66,Bergstraat 71,2023-05-11,07:00:00,198,26,172,FMN GV 11 Ramsel
66,Bergstraat 71,2023-05-11,08:00:00,192,30,162,FMN GV 11 Ramsel
66,Bergstraat 71,2023-05-11,09:00:00,58,16,42,FMN GV 11 Ramsel
66,Bergstraat 71,2023-05-11,10:00:00,88,24,64,FMN GV 11 Ramsel
66,Bergstraat 71,2023-05-11,11:00:00,78,50,28,FMN GV 11 Ramsel
66,Bergstraat 71,2023-05-11,12:00:00,82,48,34,FMN GV 11 Ramsel
66,Bergstraat 71,2023-05-11,13:00:00,120,56,64,FMN GV 11 Ramsel
66,Bergstraat 71,2023-05-11,14:00:00,106,64,42,FMN GV 11 Ramsel
66,Bergstraat 71,2023-05-11,15:00:00,268,224,44,FMN GV 11 Ramsel
66,Bergstraat 71,2023-05-11,16:00:00,210,150,60,FMN GV 11 Ramsel
66,Bergstraat 71,2023-05-11,17:00:00,108,64,44,FMN GV 11 Ramsel
66,Bergstraat 71,2023-05-11,18:00:00,68,42,26,FMN GV 11 Ramsel
66,Bergstraat 71,2023-05-11,19:00:00,22,20,2,FMN GV 11 Ramsel
66,Bergstraat 71,2023-05-11,20:00:00,20,12,8,FMN GV 11 Ramsel
66,Bergstraat 71,2023-05-11,21:00:00,12,6,6,FMN GV 11 Ramsel
66,Bergstraat 71,2023-05-11,22:00:00,16,10,6,FMN GV 11 Ramsel
66,Bergstraat 71,2023-05-11,23:00:00,8,4,4,FMN GV 11 Ramsel
66,Bergstraat 71,2023-05-12,00:00:00,0,0,0,FMN GV 11 Ramsel
66,Bergstraat 71,2023-05-12,01:00:00,2,0,2,FMN GV 11 Ramsel
66,Bergstraat 71,2023-05-12,02:00:00,2,0,2,FMN GV 11 Ramsel
66,Bergstraat 71,2023-05-12,03:00:00,0,0,0,FMN GV 11 Ramsel
66,Bergstraat 71,2023-05-12,04:00:00,8,6,2,FMN GV 11 Ramsel
66,Bergstraat 71,2023-05-12,05:00:00,10,10,0,FMN GV 11 Ramsel
66,Bergstraat 71,2023-05-12,06:00:00,26,10,16,FMN GV 11 Ramsel
66,Bergstraat 71,2023-05-12,07:00:00,66,8,58,FMN GV 11 Ramsel
66,Bergstraat 71,2023-05-12,08:00:00,74,12,62,FMN GV 11 Ramsel
66,Bergstraat 71,2023-05-12,09:00:00,22,4,18,FMN GV 11 Ramsel
66,Bergstraat 71,2023-05-12,10:00:00,26,12,14,FMN GV 11 Ramsel
66,Bergstraat 71,2023-05-12,11:00:00,32,14,18,FMN GV 11 Ramsel
66,Bergstraat 71,2023-05-12,12:00:00,40,20,20,FMN GV 11 Ramsel
66,Bergstraat 71,2023-05-12,13:00:00,28,22,6,FMN GV 11 Ramsel
66,Bergstraat 71,2023-05-12,14:00:00,76,36,40,FMN GV 11 Ramsel
66,Bergstraat 71,2023-05-12,15:00:00,134,92,42,FMN GV 11 Ramsel
66,Bergstraat 71,2023-05-12,16:00:00,124,82,42,FMN GV 11 Ramsel
66,Bergstraat 71,2023-05-12,17:00:00,44,24,20,FMN GV 11 Ramsel
66,Bergstraat 71,2023-05-12,18:00:00,48,20,28,FMN GV 11 Ramsel
66,Bergstraat 71,2023-05-12,19:00:00,32,18,14,FMN GV 11 Ramsel
66,Bergstraat 71,2023-05-12,20:00:00,22,12,10,FMN GV 11 Ramsel
66,Bergstraat 71,2023-05-12,21:00:00,14,6,8,FMN GV 11 Ramsel
66,Bergstraat 71,2023-05-12,22:00:00,20,10,10,FMN GV 11 Ramsel
66,Bergstraat 71,2023-05-12,23:00:00,18,12,6,FMN GV 11 Ramsel
66,Bergstraat 71,2023-05-13,00:00:00,4,2,2,FMN GV 11 Ramsel
66,Bergstraat 71,2023-05-13,01:00:00,10,6,4,FMN GV 11 Ramsel
66,Bergstraat 71,2023-05-13,02:00:00,8,2,6,FMN GV 11 Ramsel
66,Bergstraat 71,2023-05-13,03:00:00,4,2,2,FMN GV 11 Ramsel
66,Bergstraat 71,2023-05-13,04:00:00,0,0,0,FMN GV 11 Ramsel
66,Bergstraat 71,2023-05-13,05:00:00,6,4,2,FMN GV 11 Ramsel
66,Bergstraat 71,2023-05-13,06:00:00,8,4,4,FMN GV 11 Ramsel
66,Bergstraat 71,2023-05-13,07:00:00,16,12,4,FMN GV 11 Ramsel
66,Bergstraat 71,2023-05-13,08:00:00,44,18,26,FMN GV 11 Ramsel
66,Bergstraat 71,2023-05-13,09:00:00,126,34,92,FMN GV 11 Ramsel
66,Bergstraat 71,2023-05-13,10:00:00,204,112,92,FMN GV 11 Ramsel
66,Bergstraat 71,2023-05-13,11:00:00,154,82,72,FMN GV 11 Ramsel
66,Bergstraat 71,2023-05-13,12:00:00,188,62,126,FMN GV 11 Ramsel
66,Bergstraat 71,2023-05-13,13:00:00,314,176,138,FMN GV 11 Ramsel
66,Bergstraat 71,2023-05-13,14:00:00,352,172,180,FMN GV 11 Ramsel
66,Bergstraat 71,2023-05-13,15:00:00,278,156,122,FMN GV 11 Ramsel
66,Bergstraat 71,2023-05-13,16:00:00,232,140,92,FMN GV 11 Ramsel
66,Bergstraat 71,2023-05-13,17:00:00,194,112,82,FMN GV 11 Ramsel
66,Bergstraat 71,2023-05-13,18:00:00,122,88,34,FMN GV 11 Ramsel
66,Bergstraat 71,2023-05-13,19:00:00,72,34,38,FMN GV 11 Ramsel
66,Bergstraat 71,2023-05-13,20:00:00,68,44,24,FMN GV 11 Ramsel
66,Bergstraat 71,2023-05-13,21:00:00,40,10,30,FMN GV 11 Ramsel
66,Bergstraat 71,2023-05-13,22:00:00,14,8,6,FMN GV 11 Ramsel
66,Bergstraat 71,2023-05-13,23:00:00,20,8,12,FMN GV 11 Ramsel
66,Bergstraat 71,2023-05-14,00:00:00,8,4,4,FMN GV 11 Ramsel
66,Bergstraat 71,2023-05-14,01:00:00,0,0,0,FMN GV 11 Ramsel
66,Bergstraat 71,2023-05-14,02:00:00,0,0,0,FMN GV 11 Ramsel
66,Bergstraat 71,2023-05-14,03:00:00,2,2,0,FMN GV 11 Ramsel
66,Bergstraat 71,2023-05-14,04:00:00,0,0,0,FMN GV 11 Ramsel
66,Bergstraat 71,2023-05-14,05:00:00,2,2,0,FMN GV 11 Ramsel
66,Bergstraat 71,2023-05-14,06:00:00,8,4,4,FMN GV 11 Ramsel
66,Bergstraat 71,2023-05-14,07:00:00,30,10,20,FMN GV 11 Ramsel
66,Bergstraat 71,2023-05-14,08:00:00,130,60,70,FMN GV 11 Ramsel
66,Bergstraat 71,2023-05-14,09:00:00,138,76,62,FMN GV 11 Ramsel
66,Bergstraat 71,2023-05-14,10:00:00,206,84,122,FMN GV 11 Ramsel
66,Bergstraat 71,2023-05-14,11:00:00,232,104,128,FMN GV 11 Ramsel
66,Bergstraat 71,2023-05-14,12:00:00,130,58,72,FMN GV 11 Ramsel
66,Bergstraat 71,2023-05-14,13:00:00,226,116,110,FMN GV 11 Ramsel
66,Bergstraat 71,2023-05-14,14:00:00,288,144,144,FMN GV 11 Ramsel
66,Bergstraat 71,2023-05-14,15:00:00,332,202,130,FMN GV 11 Ramsel
66,Bergstraat 71,2023-05-14,16:00:00,274,162,112,FMN GV 11 Ramsel
66,Bergstraat 71,2023-05-14,17:00:00,154,68,86,FMN GV 11 Ramsel
66,Bergstraat 71,2023-05-14,18:00:00,88,48,40,FMN GV 11 Ramsel
66,Bergstraat 71,2023-05-14,19:00:00,64,34,30,FMN GV 11 Ramsel
66,Bergstraat 71,2023-05-14,20:00:00,50,20,30,FMN GV 11 Ramsel
66,Bergstraat 71,2023-05-14,21:00:00,20,14,6,FMN GV 11 Ramsel
66,Bergstraat 71,2023-05-14,22:00:00,2,2,0,FMN GV 11 Ramsel
66,Bergstraat 71,2023-05-14,23:00:00,4,4,0,FMN GV 11 Ramsel
66,Bergstraat 71,2023-05-15,00:00:00,0,0,0,FMN GV 11 Ramsel
66,Bergstraat 71,2023-05-15,01:00:00,0,0,0,FMN GV 11 Ramsel
66,Bergstraat 71,2023-05-15,02:00:00,0,0,0,FMN GV 11 Ramsel
66,Bergstraat 71,2023-05-15,03:00:00,2,0,2,FMN GV 11 Ramsel
66,Bergstraat 71,2023-05-15,04:00:00,6,4,2,FMN GV 11 Ramsel
66,Bergstraat 71,2023-05-15,05:00:00,12,8,4,FMN GV 11 Ramsel
66,Bergstraat 71,2023-05-15,06:00:00,50,20,30,FMN GV 11 Ramsel
66,Bergstraat 71,2023-05-15,07:00:00,196,14,182,FMN GV 11 Ramsel
66,Bergstraat 71,2023-05-15,08:00:00,198,28,170,FMN GV 11 Ramsel
66,Bergstraat 71,2023-05-15,09:00:00,74,34,40,FMN GV 11 Ramsel
66,Bergstraat 71,2023-05-15,10:00:00,66,34,32,FMN GV 11 Ramsel
66,Bergstraat 71,2023-05-15,11:00:00,52,24,28,FMN GV 11 Ramsel
66,Bergstraat 71,2023-05-15,12:00:00,50,20,30,FMN GV 11 Ramsel
66,Bergstraat 71,2023-05-15,13:00:00,82,48,34,FMN GV 11 Ramsel
66,Bergstraat 71,2023-05-15,14:00:00,86,74,12,FMN GV 11 Ramsel
66,Bergstraat 71,2023-05-15,15:00:00,196,172,24,FMN GV 11 Ramsel
66,Bergstraat 71,2023-05-15,16:00:00,134,110,24,FMN GV 11 Ramsel
66,Bergstraat 71,2023-05-15,17:00:00,94,66,28,FMN GV 11 Ramsel
66,Bergstraat 71,2023-05-15,18:00:00,38,22,16,FMN GV 11 Ramsel
66,Bergstraat 71,2023-05-15,19:00:00,42,24,18,FMN GV 11 Ramsel
66,Bergstraat 71,2023-05-15,20:00:00,10,8,2,FMN GV 11 Ramsel
66,Bergstraat 71,2023-05-15,21:00:00,18,12,6,FMN GV 11 Ramsel
66,Bergstraat 71,2023-05-15,22:00:00,4,2,2,FMN GV 11 Ramsel
66,Bergstraat 71,2023-05-15,23:00:00,0,0,0,FMN GV 11 Ramsel
66,Bergstraat 71,2023-05-16,00:00:00,2,2,0,FMN GV 11 Ramsel
66,Bergstraat 71,2023-05-16,01:00:00,0,0,0,FMN GV 11 Ramsel
66,Bergstraat 71,2023-05-16,02:00:00,0,0,0,FMN GV 11 Ramsel
66,Bergstraat 71,2023-05-16,03:00:00,0,0,0,FMN GV 11 Ramsel
66,Bergstraat 71,2023-05-16,04:00:00,10,4,6,FMN GV 11 Ramsel
66,Bergstraat 71,2023-05-16,05:00:00,16,12,4,FMN GV 11 Ramsel
66,Bergstraat 71,2023-05-16,06:00:00,50,18,32,FMN GV 11 Ramsel
66,Bergstraat 71,2023-05-16,07:00:00,202,30,172,FMN GV 11 Ramsel
66,Bergstraat 71,2023-05-16,08:00:00,196,22,174,FMN GV 11 Ramsel
66,Bergstraat 71,2023-05-16,09:00:00,86,22,64,FMN GV 11 Ramsel
66,Bergstraat 71,2023-05-16,10:00:00,54,16,38,FMN GV 11 Ramsel
66,Bergstraat 71,2023-05-16,11:00:00,48,28,20,FMN GV 11 Ramsel
66,Bergstraat 71,2023-05-16,12:00:00,74,38,36,FMN GV 11 Ramsel
66,Bergstraat 71,2023-05-16,13:00:00,130,66,64,FMN GV 11 Ramsel
66,Bergstraat 71,2023-05-16,14:00:00,116,56,60,FMN GV 11 Ramsel
66,Bergstraat 71,2023-05-16,15:00:00,296,242,54,FMN GV 11 Ramsel
66,Bergstraat 71,2023-05-16,16:00:00,202,166,36,FMN GV 11 Ramsel
66,Bergstraat 71,2023-05-16,17:00:00,120,54,66,FMN GV 11 Ramsel
66,Bergstraat 71,2023-05-16,18:00:00,104,56,48,FMN GV 11 Ramsel
66,Bergstraat 71,2023-05-16,19:00:00,64,32,32,FMN GV 11 Ramsel
66,Bergstraat 71,2023-05-16,20:00:00,54,22,32,FMN GV 11 Ramsel
66,Bergstraat 71,2023-05-16,21:00:00,66,54,12,FMN GV 11 Ramsel
66,Bergstraat 71,2023-05-16,22:00:00,14,8,6,FMN GV 11 Ramsel
66,Bergstraat 71,2023-05-16,23:00:00,2,2,0,FMN GV 11 Ramsel
66,Bergstraat 71,2023-05-17,00:00:00,0,0,0,FMN GV 11 Ramsel
66,Bergstraat 71,2023-05-17,01:00:00,2,2,0,FMN GV 11 Ramsel
66,Bergstraat 71,2023-05-17,02:00:00,0,0,0,FMN GV 11 Ramsel
66,Bergstraat 71,2023-05-17,03:00:00,0,0,0,FMN GV 11 Ramsel
66,Bergstraat 71,2023-05-17,04:00:00,10,4,6,FMN GV 11 Ramsel
66,Bergstraat 71,2023-05-17,05:00:00,12,6,6,FMN GV 11 Ramsel
66,Bergstraat 71,2023-05-17,06:00:00,52,22,30,FMN GV 11 Ramsel
66,Bergstraat 71,2023-05-17,07:00:00,112,26,86,FMN GV 11 Ramsel
66,Bergstraat 71,2023-05-17,08:00:00,112,30,82,FMN GV 11 Ramsel
66,Bergstraat 71,2023-05-17,09:00:00,90,40,50,FMN GV 11 Ramsel
66,Bergstraat 71,2023-05-17,10:00:00,70,30,40,FMN GV 11 Ramsel
66,Bergstraat 71,2023-05-17,11:00:00,122,68,54,FMN GV 11 Ramsel
66,Bergstraat 71,2023-05-17,12:00:00,160,104,56,FMN GV 11 Ramsel
66,Bergstraat 71,2023-05-17,13:00:00,170,88,82,FMN GV 11 Ramsel
66,Bergstraat 71,2023-05-17,14:00:00,182,106,76,FMN GV 11 Ramsel
66,Bergstraat 71,2023-05-17,15:00:00,144,74,70,FMN GV 11 Ramsel
66,Bergstraat 71,2023-05-17,16:00:00,160,82,78,FMN GV 11 Ramsel
66,Bergstraat 71,2023-05-17,17:00:00,166,96,70,FMN GV 11 Ramsel
66,Bergstraat 71,2023-05-17,18:00:00,140,82,58,FMN GV 11 Ramsel
66,Bergstraat 71,2023-05-17,19:00:00,82,38,44,FMN GV 11 Ramsel
66,Bergstraat 71,2023-05-17,20:00:00,74,44,30,FMN GV 11 Ramsel
66,Bergstraat 71,2023-05-17,21:00:00,156,22,134,FMN GV 11 Ramsel
66,Bergstraat 71,2023-05-17,22:00:00,260,166,94,FMN GV 11 Ramsel
66,Bergstraat 71,2023-05-17,23:00:00,52,38,14,FMN GV 11 Ramsel
66,Bergstraat 71,2023-05-18,00:00:00,28,12,16,FMN GV 11 Ramsel
66,Bergstraat 71,2023-05-18,01:00:00,14,0,14,FMN GV 11 Ramsel
66,Bergstraat 71,2023-05-18,02:00:00,14,6,8,FMN GV 11 Ramsel
66,Bergstraat 71,2023-05-18,03:00:00,2,0,2,FMN GV 11 Ramsel
66,Bergstraat 71,2023-05-18,04:00:00,10,4,6,FMN GV 11 Ramsel
66,Bergstraat 71,2023-05-18,05:00:00,4,4,0,FMN GV 11 Ramsel
66,Bergstraat 71,2023-05-18,06:00:00,8,2,6,FMN GV 11 Ramsel
66,Bergstraat 71,2023-05-18,07:00:00,28,12,16,FMN GV 11 Ramsel
66,Bergstraat 71,2023-05-18,08:00:00,44,24,20,FMN GV 11 Ramsel
66,Bergstraat 71,2023-05-18,09:00:00,132,32,100,FMN GV 11 Ramsel
66,Bergstraat 71,2023-05-18,10:00:00,228,48,180,FMN GV 11 Ramsel
66,Bergstraat 71,2023-05-18,11:00:00,252,104,148,FMN GV 11 Ramsel
66,Bergstraat 71,2023-05-18,12:00:00,220,110,110,FMN GV 11 Ramsel
66,Bergstraat 71,2023-05-18,13:00:00,348,180,168,FMN GV 11 Ramsel
66,Bergstraat 71,2023-05-18,14:00:00,564,308,256,FMN GV 11 Ramsel
66,Bergstraat 71,2023-05-18,15:00:00,284,158,126,FMN GV 11 Ramsel
66,Bergstraat 71,2023-05-18,16:00:00,306,178,128,FMN GV 11 Ramsel
66,Bergstraat 71,2023-05-18,17:00:00,316,148,168,FMN GV 11 Ramsel
66,Bergstraat 71,2023-05-18,18:00:00,218,86,132,FMN GV 11 Ramsel
66,Bergstraat 71,2023-05-18,19:00:00,104,44,60,FMN GV 11 Ramsel
66,Bergstraat 71,2023-05-18,20:00:00,58,18,40,FMN GV 11 Ramsel
66,Bergstraat 71,2023-05-18,21:00:00,20,8,12,FMN GV 11 Ramsel
66,Bergstraat 71,2023-05-18,22:00:00,32,12,20,FMN GV 11 Ramsel
66,Bergstraat 71,2023-05-18,23:00:00,16,6,10,FMN GV 11 Ramsel
66,Bergstraat 71,2023-05-19,00:00:00,14,6,8,FMN GV 11 Ramsel
66,Bergstraat 71,2023-05-19,01:00:00,22,4,18,FMN GV 11 Ramsel
66,Bergstraat 71,2023-05-19,02:00:00,0,0,0,FMN GV 11 Ramsel
66,Bergstraat 71,2023-05-19,03:00:00,2,2,0,FMN GV 11 Ramsel
66,Bergstraat 71,2023-05-19,04:00:00,4,2,2,FMN GV 11 Ramsel
66,Bergstraat 71,2023-05-19,05:00:00,6,6,0,FMN GV 11 Ramsel
66,Bergstraat 71,2023-05-19,06:00:00,10,6,4,FMN GV 11 Ramsel
66,Bergstraat 71,2023-05-19,07:00:00,18,4,14,FMN GV 11 Ramsel
66,Bergstraat 71,2023-05-19,08:00:00,44,16,28,FMN GV 11 Ramsel
66,Bergstraat 71,2023-05-19,09:00:00,64,36,28,FMN GV 11 Ramsel
66,Bergstraat 71,2023-05-19,10:00:00,158,72,86,FMN GV 11 Ramsel
66,Bergstraat 71,2023-05-19,11:00:00,162,84,78,FMN GV 11 Ramsel
66,Bergstraat 71,2023-05-19,12:00:00,126,48,78,FMN GV 11 Ramsel
66,Bergstraat 71,2023-05-19,13:00:00,216,106,110,FMN GV 11 Ramsel
66,Bergstraat 71,2023-05-19,14:00:00,266,152,114,FMN GV 11 Ramsel
66,Bergstraat 71,2023-05-19,15:00:00,200,86,114,FMN GV 11 Ramsel
66,Bergstraat 71,2023-05-19,16:00:00,134,86,48,FMN GV 11 Ramsel
66,Bergstraat 71,2023-05-19,17:00:00,106,54,52,FMN GV 11 Ramsel
66,Bergstraat 71,2023-05-19,18:00:00,100,60,40,FMN GV 11 Ramsel
66,Bergstraat 71,2023-05-19,19:00:00,88,44,44,FMN GV 11 Ramsel
66,Bergstraat 71,2023-05-19,20:00:00,78,38,40,FMN GV 11 Ramsel
66,Bergstraat 71,2023-05-19,21:00:00,40,24,16,FMN GV 11 Ramsel
66,Bergstraat 71,2023-05-19,22:00:00,14,6,8,FMN GV 11 Ramsel
66,Bergstraat 71,2023-05-19,23:00:00,4,2,2,FMN GV 11 Ramsel
66,Bergstraat 71,2023-05-20,00:00:00,8,4,4,FMN GV 11 Ramsel
66,Bergstraat 71,2023-05-20,01:00:00,16,10,6,FMN GV 11 Ramsel
66,Bergstraat 71,2023-05-20,02:00:00,4,2,2,FMN GV 11 Ramsel
66,Bergstraat 71,2023-05-20,03:00:00,2,2,0,FMN GV 11 Ramsel
66,Bergstraat 71,2023-05-20,04:00:00,4,2,2,FMN GV 11 Ramsel
66,Bergstraat 71,2023-05-20,05:00:00,2,2,0,FMN GV 11 Ramsel
66,Bergstraat 71,2023-05-20,06:00:00,4,2,2,FMN GV 11 Ramsel
66,Bergstraat 71,2023-05-20,07:00:00,22,8,14,FMN GV 11 Ramsel
66,Bergstraat 71,2023-05-20,08:00:00,32,8,24,FMN GV 11 Ramsel
66,Bergstraat 71,2023-05-20,09:00:00,86,42,44,FMN GV 11 Ramsel
66,Bergstraat 71,2023-05-20,10:00:00,138,48,90,FMN GV 11 Ramsel
66,Bergstraat 71,2023-05-20,11:00:00,176,76,100,FMN GV 11 Ramsel
66,Bergstraat 71,2023-05-20,12:00:00,96,62,34,FMN GV 11 Ramsel
66,Bergstraat 71,2023-05-20,13:00:00,238,116,122,FMN GV 11 Ramsel
66,Bergstraat 71,2023-05-20,14:00:00,214,116,98,FMN GV 11 Ramsel
66,Bergstraat 71,2023-05-20,15:00:00,178,86,92,FMN GV 11 Ramsel
66,Bergstraat 71,2023-05-20,16:00:00,150,88,62,FMN GV 11 Ramsel
66,Bergstraat 71,2023-05-20,17:00:00,136,86,50,FMN GV 11 Ramsel
66,Bergstraat 71,2023-05-20,18:00:00,58,26,32,FMN GV 11 Ramsel
66,Bergstraat 71,2023-05-20,19:00:00,66,34,32,FMN GV 11 Ramsel
66,Bergstraat 71,2023-05-20,20:00:00,38,20,18,FMN GV 11 Ramsel
66,Bergstraat 71,2023-05-20,21:00:00,32,10,22,FMN GV 11 Ramsel
66,Bergstraat 71,2023-05-20,22:00:00,10,6,4,FMN GV 11 Ramsel
66,Bergstraat 71,2023-05-20,23:00:00,6,2,4,FMN GV 11 Ramsel
66,Bergstraat 71,2023-05-21,00:00:00,14,8,6,FMN GV 11 Ramsel
66,Bergstraat 71,2023-05-21,01:00:00,10,6,4,FMN GV 11 Ramsel
66,Bergstraat 71,2023-05-21,02:00:00,0,0,0,FMN GV 11 Ramsel
66,Bergstraat 71,2023-05-21,03:00:00,2,2,0,FMN GV 11 Ramsel
66,Bergstraat 71,2023-05-21,04:00:00,2,2,0,FMN GV 11 Ramsel
66,Bergstraat 71,2023-05-21,05:00:00,0,0,0,FMN GV 11 Ramsel
66,Bergstraat 71,2023-05-21,06:00:00,4,2,2,FMN GV 11 Ramsel
66,Bergstraat 71,2023-05-21,07:00:00,30,6,24,FMN GV 11 Ramsel
66,Bergstraat 71,2023-05-21,08:00:00,76,24,52,FMN GV 11 Ramsel
66,Bergstraat 71,2023-05-21,09:00:00,236,134,102,FMN GV 11 Ramsel
66,Bergstraat 71,2023-05-21,10:00:00,206,92,114,FMN GV 11 Ramsel
66,Bergstraat 71,2023-05-21,11:00:00,308,202,106,FMN GV 11 Ramsel
66,Bergstraat 71,2023-05-21,12:00:00,204,90,114,FMN GV 11 Ramsel
66,Bergstraat 71,2023-05-21,13:00:00,272,112,160,FMN GV 11 Ramsel
66,Bergstraat 71,2023-05-21,14:00:00,312,170,142,FMN GV 11 Ramsel
66,Bergstraat 71,2023-05-21,15:00:00,378,170,208,FMN GV 11 Ramsel
66,Bergstraat 71,2023-05-21,16:00:00,270,150,120,FMN GV 11 Ramsel
66,Bergstraat 71,2023-05-21,17:00:00,146,96,50,FMN GV 11 Ramsel
66,Bergstraat 71,2023-05-21,18:00:00,96,60,36,FMN GV 11 Ramsel
66,Bergstraat 71,2023-05-21,19:00:00,72,56,16,FMN GV 11 Ramsel
66,Bergstraat 71,2023-05-21,20:00:00,72,40,32,FMN GV 11 Ramsel
66,Bergstraat 71,2023-05-21,21:00:00,28,12,16,FMN GV 11 Ramsel
66,Bergstraat 71,2023-05-21,22:00:00,20,10,10,FMN GV 11 Ramsel
66,Bergstraat 71,2023-05-21,23:00:00,4,2,2,FMN GV 11 Ramsel
66,Bergstraat 71,2023-05-22,00:00:00,0,0,0,FMN GV 11 Ramsel
66,Bergstraat 71,2023-05-22,01:00:00,0,0,0,FMN GV 11 Ramsel
66,Bergstraat 71,2023-05-22,02:00:00,0,0,0,FMN GV 11 Ramsel
66,Bergstraat 71,2023-05-22,03:00:00,2,0,2,FMN GV 11 Ramsel
66,Bergstraat 71,2023-05-22,04:00:00,8,4,4,FMN GV 11 Ramsel
66,Bergstraat 71,2023-05-22,05:00:00,24,16,8,FMN GV 11 Ramsel
66,Bergstraat 71,2023-05-22,06:00:00,68,16,52,FMN GV 11 Ramsel
66,Bergstraat 71,2023-05-22,07:00:00,246,30,216,FMN GV 11 Ramsel
66,Bergstraat 71,2023-05-22,08:00:00,286,38,248,FMN GV 11 Ramsel
66,Bergstraat 71,2023-05-22,09:00:00,58,30,28,FMN GV 11 Ramsel
66,Bergstraat 71,2023-05-22,10:00:00,54,28,26,FMN GV 11 Ramsel
66,Bergstraat 71,2023-05-22,11:00:00,80,32,48,FMN GV 11 Ramsel
66,Bergstraat 71,2023-05-22,12:00:00,106,78,28,FMN GV 11 Ramsel
66,Bergstraat 71,2023-05-22,13:00:00,132,78,54,FMN GV 11 Ramsel
66,Bergstraat 71,2023-05-22,14:00:00,148,78,70,FMN GV 11 Ramsel
66,Bergstraat 71,2023-05-22,15:00:00,248,162,86,FMN GV 11 Ramsel
66,Bergstraat 71,2023-05-22,16:00:00,276,224,52,FMN GV 11 Ramsel
66,Bergstraat 71,2023-05-22,17:00:00,180,122,58,FMN GV 11 Ramsel
66,Bergstraat 71,2023-05-22,18:00:00,98,52,46,FMN GV 11 Ramsel
66,Bergstraat 71,2023-05-22,19:00:00,100,46,54,FMN GV 11 Ramsel
66,Bergstraat 71,2023-05-22,20:00:00,50,32,18,FMN GV 11 Ramsel
66,Bergstraat 71,2023-05-22,21:00:00,32,28,4,FMN GV 11 Ramsel
66,Bergstraat 71,2023-05-22,22:00:00,10,2,8,FMN GV 11 Ramsel
66,Bergstraat 71,2023-05-22,23:00:00,0,0,0,FMN GV 11 Ramsel
66,Bergstraat 71,2023-05-23,00:00:00,2,2,0,FMN GV 11 Ramsel
66,Bergstraat 71,2023-05-23,01:00:00,2,2,0,FMN GV 11 Ramsel
66,Bergstraat 71,2023-05-23,02:00:00,0,0,0,FMN GV 11 Ramsel
66,Bergstraat 71,2023-05-23,03:00:00,0,0,0,FMN GV 11 Ramsel
66,Bergstraat 71,2023-05-23,04:00:00,12,6,6,FMN GV 11 Ramsel
66,Bergstraat 71,2023-05-23,05:00:00,20,14,6,FMN GV 11 Ramsel
66,Bergstraat 71,2023-05-23,06:00:00,66,20,46,FMN GV 11 Ramsel
66,Bergstraat 71,2023-05-23,07:00:00,218,26,192,FMN GV 11 Ramsel
66,Bergstraat 71,2023-05-23,08:00:00,254,34,220,FMN GV 11 Ramsel
66,Bergstraat 71,2023-05-23,09:00:00,222,170,52,FMN GV 11 Ramsel
66,Bergstraat 71,2023-05-23,10:00:00,60,32,28,FMN GV 11 Ramsel
66,Bergstraat 71,2023-05-23,11:00:00,204,150,54,FMN GV 11 Ramsel
66,Bergstraat 71,2023-05-23,12:00:00,94,48,46,FMN GV 11 Ramsel
66,Bergstraat 71,2023-05-23,13:00:00,164,104,60,FMN GV 11 Ramsel
66,Bergstraat 71,2023-05-23,14:00:00,248,78,170,FMN GV 11 Ramsel
66,Bergstraat 71,2023-05-23,15:00:00,394,184,210,FMN GV 11 Ramsel
66,Bergstraat 71,2023-05-23,16:00:00,262,210,52,FMN GV 11 Ramsel
66,Bergstraat 71,2023-05-23,17:00:00,168,88,80,FMN GV 11 Ramsel
66,Bergstraat 71,2023-05-23,18:00:00,100,56,44,FMN GV 11 Ramsel
66,Bergstraat 71,2023-05-23,19:00:00,88,50,38,FMN GV 11 Ramsel
66,Bergstraat 71,2023-05-23,20:00:00,82,50,32,FMN GV 11 Ramsel
66,Bergstraat 71,2023-05-23,21:00:00,34,18,16,FMN GV 11 Ramsel
66,Bergstraat 71,2023-05-23,22:00:00,20,16,4,FMN GV 11 Ramsel
66,Bergstraat 71,2023-05-23,23:00:00,4,0,4,FMN GV 11 Ramsel
66,Bergstraat 71,2023-05-24,00:00:00,0,0,0,FMN GV 11 Ramsel
66,Bergstraat 71,2023-05-24,01:00:00,8,8,0,FMN GV 11 Ramsel
66,Bergstraat 71,2023-05-24,02:00:00,2,2,0,FMN GV 11 Ramsel
66,Bergstraat 71,2023-05-24,03:00:00,0,0,0,FMN GV 11 Ramsel
66,Bergstraat 71,2023-05-24,04:00:00,12,6,6,FMN GV 11 Ramsel
66,Bergstraat 71,2023-05-24,05:00:00,16,10,6,FMN GV 11 Ramsel
66,Bergstraat 71,2023-05-24,06:00:00,66,24,42,FMN GV 11 Ramsel
66,Bergstraat 71,2023-05-24,07:00:00,204,22,182,FMN GV 11 Ramsel
66,Bergstraat 71,2023-05-24,08:00:00,246,38,208,FMN GV 11 Ramsel
66,Bergstraat 71,2023-05-24,09:00:00,82,36,46,FMN GV 11 Ramsel
66,Bergstraat 71,2023-05-24,10:00:00,62,34,28,FMN GV 11 Ramsel
66,Bergstraat 71,2023-05-24,11:00:00,108,56,52,FMN GV 11 Ramsel
66,Bergstraat 71,2023-05-24,12:00:00,372,304,68,FMN GV 11 Ramsel
66,Bergstraat 71,2023-05-24,13:00:00,162,90,72,FMN GV 11 Ramsel
66,Bergstraat 71,2023-05-24,14:00:00,170,74,96,FMN GV 11 Ramsel
66,Bergstraat 71,2023-05-24,15:00:00,170,92,78,FMN GV 11 Ramsel
66,Bergstraat 71,2023-05-24,16:00:00,180,126,54,FMN GV 11 Ramsel
66,Bergstraat 71,2023-05-24,17:00:00,158,100,58,FMN GV 11 Ramsel
66,Bergstraat 71,2023-05-24,18:00:00,124,76,48,FMN GV 11 Ramsel
66,Bergstraat 71,2023-05-24,19:00:00,108,42,66,FMN GV 11 Ramsel
66,Bergstraat 71,2023-05-24,20:00:00,60,32,28,FMN GV 11 Ramsel
66,Bergstraat 71,2023-05-24,21:00:00,46,38,8,FMN GV 11 Ramsel
66,Bergstraat 71,2023-05-24,22:00:00,34,24,10,FMN GV 11 Ramsel
66,Bergstraat 71,2023-05-24,23:00:00,6,6,0,FMN GV 11 Ramsel
66,Bergstraat 71,2023-05-25,00:00:00,0,0,0,FMN GV 11 Ramsel
66,Bergstraat 71,2023-05-25,01:00:00,6,0,6,FMN GV 11 Ramsel
66,Bergstraat 71,2023-05-25,02:00:00,2,0,2,FMN GV 11 Ramsel
66,Bergstraat 71,2023-05-25,03:00:00,0,0,0,FMN GV 11 Ramsel
66,Bergstraat 71,2023-05-25,04:00:00,12,6,6,FMN GV 11 Ramsel
66,Bergstraat 71,2023-05-25,05:00:00,24,16,8,FMN GV 11 Ramsel
66,Bergstraat 71,2023-05-25,06:00:00,66,28,38,FMN GV 11 Ramsel
66,Bergstraat 71,2023-05-25,07:00:00,208,28,180,FMN GV 11 Ramsel
66,Bergstraat 71,2023-05-25,08:00:00,264,36,228,FMN GV 11 Ramsel
66,Bergstraat 71,2023-05-25,09:00:00,88,22,66,FMN GV 11 Ramsel
66,Bergstraat 71,2023-05-25,10:00:00,60,26,34,FMN GV 11 Ramsel
66,Bergstraat 71,2023-05-25,11:00:00,94,50,44,FMN GV 11 Ramsel
66,Bergstraat 71,2023-05-25,12:00:00,104,54,50,FMN GV 11 Ramsel
66,Bergstraat 71,2023-05-25,13:00:00,164,78,86,FMN GV 11 Ramsel
66,Bergstraat 71,2023-05-25,14:00:00,184,92,92,FMN GV 11 Ramsel
66,Bergstraat 71,2023-05-25,15:00:00,298,248,50,FMN GV 11 Ramsel
66,Bergstraat 71,2023-05-25,16:00:00,290,200,90,FMN GV 11 Ramsel
66,Bergstraat 71,2023-05-25,17:00:00,158,116,42,FMN GV 11 Ramsel
66,Bergstraat 71,2023-05-25,18:00:00,126,70,56,FMN GV 11 Ramsel
66,Bergstraat 71,2023-05-25,19:00:00,116,50,66,FMN GV 11 Ramsel
66,Bergstraat 71,2023-05-25,20:00:00,58,36,22,FMN GV 11 Ramsel
66,Bergstraat 71,2023-05-25,21:00:00,42,32,10,FMN GV 11 Ramsel
66,Bergstraat 71,2023-05-25,22:00:00,24,18,6,FMN GV 11 Ramsel
66,Bergstraat 71,2023-05-25,23:00:00,12,8,4,FMN GV 11 Ramsel
66,Bergstraat 71,2023-05-26,00:00:00,2,2,0,FMN GV 11 Ramsel
66,Bergstraat 71,2023-05-26,01:00:00,2,2,0,FMN GV 11 Ramsel
66,Bergstraat 71,2023-05-26,02:00:00,0,0,0,FMN GV 11 Ramsel
66,Bergstraat 71,2023-05-26,03:00:00,0,0,0,FMN GV 11 Ramsel
66,Bergstraat 71,2023-05-26,04:00:00,10,6,4,FMN GV 11 Ramsel
66,Bergstraat 71,2023-05-26,05:00:00,18,12,6,FMN GV 11 Ramsel
66,Bergstraat 71,2023-05-26,06:00:00,52,26,26,FMN GV 11 Ramsel
66,Bergstraat 71,2023-05-26,07:00:00,222,36,186,FMN GV 11 Ramsel
66,Bergstraat 71,2023-05-26,08:00:00,250,34,216,FMN GV 11 Ramsel
66,Bergstraat 71,2023-05-26,09:00:00,68,18,50,FMN GV 11 Ramsel
66,Bergstraat 71,2023-05-26,10:00:00,88,42,46,FMN GV 11 Ramsel
66,Bergstraat 71,2023-05-26,11:00:00,86,52,34,FMN GV 11 Ramsel
66,Bergstraat 71,2023-05-26,12:00:00,110,62,48,FMN GV 11 Ramsel
66,Bergstraat 71,2023-05-26,13:00:00,144,74,70,FMN GV 11 Ramsel
66,Bergstraat 71,2023-05-26,14:00:00,168,110,58,FMN GV 11 Ramsel
66,Bergstraat 71,2023-05-26,15:00:00,344,260,84,FMN GV 11 Ramsel
66,Bergstraat 71,2023-05-26,16:00:00,218,132,86,FMN GV 11 Ramsel
66,Bergstraat 71,2023-05-26,17:00:00,156,88,68,FMN GV 11 Ramsel
66,Bergstraat 71,2023-05-26,18:00:00,140,92,48,FMN GV 11 Ramsel
66,Bergstraat 71,2023-05-26,19:00:00,112,60,52,FMN GV 11 Ramsel
66,Bergstraat 71,2023-05-26,20:00:00,42,18,24,FMN GV 11 Ramsel
66,Bergstraat 71,2023-05-26,21:00:00,30,22,8,FMN GV 11 Ramsel
66,Bergstraat 71,2023-05-26,22:00:00,32,18,14,FMN GV 11 Ramsel
66,Bergstraat 71,2023-05-26,23:00:00,8,4,4,FMN GV 11 Ramsel
66,Bergstraat 71,2023-05-27,00:00:00,8,6,2,FMN GV 11 Ramsel
66,Bergstraat 71,2023-05-27,01:00:00,4,2,2,FMN GV 11 Ramsel
66,Bergstraat 71,2023-05-27,02:00:00,2,2,0,FMN GV 11 Ramsel
66,Bergstraat 71,2023-05-27,03:00:00,6,2,4,FMN GV 11 Ramsel
66,Bergstraat 71,2023-05-27,04:00:00,6,4,2,FMN GV 11 Ramsel
66,Bergstraat 71,2023-05-27,05:00:00,4,2,2,FMN GV 11 Ramsel
66,Bergstraat 71,2023-05-27,06:00:00,20,6,14,FMN GV 11 Ramsel
66,Bergstraat 71,2023-05-27,07:00:00,16,8,8,FMN GV 11 Ramsel
66,Bergstraat 71,2023-05-27,08:00:00,40,18,22,FMN GV 11 Ramsel
66,Bergstraat 71,2023-05-27,09:00:00,80,36,44,FMN GV 11 Ramsel
66,Bergstraat 71,2023-05-27,10:00:00,154,92,62,FMN GV 11 Ramsel
66,Bergstraat 71,2023-05-27,11:00:00,98,44,54,FMN GV 11 Ramsel
66,Bergstraat 71,2023-05-27,12:00:00,208,102,106,FMN GV 11 Ramsel
66,Bergstraat 71,2023-05-27,13:00:00,272,102,170,FMN GV 11 Ramsel
66,Bergstraat 71,2023-05-27,14:00:00,282,144,138,FMN GV 11 Ramsel
66,Bergstraat 71,2023-05-27,15:00:00,264,162,102,FMN GV 11 Ramsel
66,Bergstraat 71,2023-05-27,16:00:00,178,92,86,FMN GV 11 Ramsel
66,Bergstraat 71,2023-05-27,17:00:00,110,64,46,FMN GV 11 Ramsel
66,Bergstraat 71,2023-05-27,18:00:00,114,62,52,FMN GV 11 Ramsel
66,Bergstraat 71,2023-05-27,19:00:00,76,40,36,FMN GV 11 Ramsel
66,Bergstraat 71,2023-05-27,20:00:00,52,18,34,FMN GV 11 Ramsel
66,Bergstraat 71,2023-05-27,21:00:00,28,16,12,FMN GV 11 Ramsel
66,Bergstraat 71,2023-05-27,22:00:00,38,18,20,FMN GV 11 Ramsel
66,Bergstraat 71,2023-05-27,23:00:00,10,8,2,FMN GV 11 Ramsel
66,Bergstraat 71,2023-05-28,00:00:00,4,4,0,FMN GV 11 Ramsel
66,Bergstraat 71,2023-05-28,01:00:00,2,0,2,FMN GV 11 Ramsel
66,Bergstraat 71,2023-05-28,02:00:00,6,4,2,FMN GV 11 Ramsel
66,Bergstraat 71,2023-05-28,03:00:00,2,2,0,FMN GV 11 Ramsel
66,Bergstraat 71,2023-05-28,04:00:00,0,0,0,FMN GV 11 Ramsel
66,Bergstraat 71,2023-05-28,05:00:00,4,0,4,FMN GV 11 Ramsel
66,Bergstraat 71,2023-05-28,06:00:00,6,0,6,FMN GV 11 Ramsel
66,Bergstraat 71,2023-05-28,07:00:00,34,12,22,FMN GV 11 Ramsel
66,Bergstraat 71,2023-05-28,08:00:00,90,24,66,FMN GV 11 Ramsel
66,Bergstraat 71,2023-05-28,09:00:00,184,102,82,FMN GV 11 Ramsel
66,Bergstraat 71,2023-05-28,10:00:00,192,98,94,FMN GV 11 Ramsel
66,Bergstraat 71,2023-05-28,11:00:00,266,154,112,FMN GV 11 Ramsel
66,Bergstraat 71,2023-05-28,12:00:00,206,146,60,FMN GV 11 Ramsel
66,Bergstraat 71,2023-05-28,13:00:00,262,122,140,FMN GV 11 Ramsel
66,Bergstraat 71,2023-05-28,14:00:00,478,222,256,FMN GV 11 Ramsel
66,Bergstraat 71,2023-05-28,15:00:00,364,208,156,FMN GV 11 Ramsel
66,Bergstraat 71,2023-05-28,16:00:00,322,188,134,FMN GV 11 Ramsel
66,Bergstraat 71,2023-05-28,17:00:00,240,90,150,FMN GV 11 Ramsel
66,Bergstraat 71,2023-05-28,18:00:00,132,58,74,FMN GV 11 Ramsel
66,Bergstraat 71,2023-05-28,19:00:00,96,46,50,FMN GV 11 Ramsel
66,Bergstraat 71,2023-05-28,20:00:00,74,38,36,FMN GV 11 Ramsel
66,Bergstraat 71,2023-05-28,21:00:00,66,28,38,FMN GV 11 Ramsel
66,Bergstraat 71,2023-05-28,22:00:00,24,12,12,FMN GV 11 Ramsel
66,Bergstraat 71,2023-05-28,23:00:00,18,12,6,FMN GV 11 Ramsel
66,Bergstraat 71,2023-05-29,00:00:00,10,2,8,FMN GV 11 Ramsel
66,Bergstraat 71,2023-05-29,01:00:00,10,2,8,FMN GV 11 Ramsel
66,Bergstraat 71,2023-05-29,02:00:00,6,6,0,FMN GV 11 Ramsel
66,Bergstraat 71,2023-05-29,03:00:00,2,0,2,FMN GV 11 Ramsel
66,Bergstraat 71,2023-05-29,04:00:00,2,0,2,FMN GV 11 Ramsel
66,Bergstraat 71,2023-05-29,05:00:00,2,2,0,FMN GV 11 Ramsel
66,Bergstraat 71,2023-05-29,06:00:00,6,4,2,FMN GV 11 Ramsel
66,Bergstraat 71,2023-05-29,07:00:00,6,0,6,FMN GV 11 Ramsel
66,Bergstraat 71,2023-05-29,08:00:00,48,18,30,FMN GV 11 Ramsel
66,Bergstraat 71,2023-05-29,09:00:00,134,58,76,FMN GV 11 Ramsel
66,Bergstraat 71,2023-05-29,10:00:00,182,70,112,FMN GV 11 Ramsel
66,Bergstraat 71,2023-05-29,11:00:00,146,78,68,FMN GV 11 Ramsel
66,Bergstraat 71,2023-05-29,12:00:00,166,90,76,FMN GV 11 Ramsel
66,Bergstraat 71,2023-05-29,13:00:00,278,118,160,FMN GV 11 Ramsel
66,Bergstraat 71,2023-05-29,14:00:00,370,180,190,FMN GV 11 Ramsel
66,Bergstraat 71,2023-05-29,15:00:00,288,160,128,FMN GV 11 Ramsel
66,Bergstraat 71,2023-05-29,16:00:00,322,154,168,FMN GV 11 Ramsel
66,Bergstraat 71,2023-05-29,17:00:00,162,100,62,FMN GV 11 Ramsel
66,Bergstraat 71,2023-05-29,18:00:00,84,48,36,FMN GV 11 Ramsel
66,Bergstraat 71,2023-05-29,19:00:00,90,44,46,FMN GV 11 Ramsel
66,Bergstraat 71,2023-05-29,20:00:00,48,28,20,FMN GV 11 Ramsel
66,Bergstraat 71,2023-05-29,21:00:00,46,32,14,FMN GV 11 Ramsel
66,Bergstraat 71,2023-05-29,22:00:00,14,10,4,FMN GV 11 Ramsel
66,Bergstraat 71,2023-05-29,23:00:00,0,0,0,FMN GV 11 Ramsel
66,Bergstraat 71,2023-05-30,00:00:00,2,0,2,FMN GV 11 Ramsel
66,Bergstraat 71,2023-05-30,01:00:00,2,2,0,FMN GV 11 Ramsel
66,Bergstraat 71,2023-05-30,02:00:00,0,0,0,FMN GV 11 Ramsel
66,Bergstraat 71,2023-05-30,03:00:00,2,0,2,FMN GV 11 Ramsel
66,Bergstraat 71,2023-05-30,04:00:00,10,6,4,FMN GV 11 Ramsel
66,Bergstraat 71,2023-05-30,05:00:00,20,12,8,FMN GV 11 Ramsel
66,Bergstraat 71,2023-05-30,06:00:00,90,34,56,FMN GV 11 Ramsel
66,Bergstraat 71,2023-05-30,07:00:00,258,38,220,FMN GV 11 Ramsel
66,Bergstraat 71,2023-05-30,08:00:00,222,24,198,FMN GV 11 Ramsel
66,Bergstraat 71,2023-05-30,09:00:00,56,16,40,FMN GV 11 Ramsel
66,Bergstraat 71,2023-05-30,10:00:00,54,24,30,FMN GV 11 Ramsel
66,Bergstraat 71,2023-05-30,11:00:00,58,12,46,FMN GV 11 Ramsel
66,Bergstraat 71,2023-05-30,12:00:00,88,46,42,FMN GV 11 Ramsel
66,Bergstraat 71,2023-05-30,13:00:00,186,118,68,FMN GV 11 Ramsel
66,Bergstraat 71,2023-05-30,14:00:00,160,94,66,FMN GV 11 Ramsel
66,Bergstraat 71,2023-05-30,15:00:00,338,260,78,FMN GV 11 Ramsel
66,Bergstraat 71,2023-05-30,16:00:00,316,208,108,FMN GV 11 Ramsel
66,Bergstraat 71,2023-05-30,17:00:00,218,136,82,FMN GV 11 Ramsel
66,Bergstraat 71,2023-05-30,18:00:00,162,80,82,FMN GV 11 Ramsel
66,Bergstraat 71,2023-05-30,19:00:00,74,36,38,FMN GV 11 Ramsel
66,Bergstraat 71,2023-05-30,20:00:00,116,80,36,FMN GV 11 Ramsel
66,Bergstraat 71,2023-05-30,21:00:00,36,22,14,FMN GV 11 Ramsel
66,Bergstraat 71,2023-05-30,22:00:00,16,10,6,FMN GV 11 Ramsel
66,Bergstraat 71,2023-05-30,23:00:00,4,4,0,FMN GV 11 Ramsel
66,Bergstraat 71,2023-05-31,00:00:00,0,0,0,FMN GV 11 Ramsel
66,Bergstraat 71,2023-05-31,01:00:00,2,2,0,FMN GV 11 Ramsel
66,Bergstraat 71,2023-05-31,02:00:00,0,0,0,FMN GV 11 Ramsel
66,Bergstraat 71,2023-05-31,03:00:00,0,0,0,FMN GV 11 Ramsel
66,Bergstraat 71,2023-05-31,04:00:00,8,4,4,FMN GV 11 Ramsel
66,Bergstraat 71,2023-05-31,05:00:00,18,12,6,FMN GV 11 Ramsel
66,Bergstraat 71,2023-05-31,06:00:00,68,24,44,FMN GV 11 Ramsel
66,Bergstraat 71,2023-05-31,07:00:00,260,42,218,FMN GV 11 Ramsel
66,Bergstraat 71,2023-05-31,08:00:00,246,30,216,FMN GV 11 Ramsel
66,Bergstraat 71,2023-05-31,09:00:00,84,26,58,FMN GV 11 Ramsel
66,Bergstraat 71,2023-05-31,10:00:00,104,44,60,FMN GV 11 Ramsel
66,Bergstraat 71,2023-05-31,11:00:00,104,56,48,FMN GV 11 Ramsel
66,Bergstraat 71,2023-05-31,12:00:00,394,322,72,FMN GV 11 Ramsel
66,Bergstraat 71,2023-05-31,13:00:00,240,104,136,FMN GV 11 Ramsel
66,Bergstraat 71,2023-05-31,14:00:00,264,148,116,FMN GV 11 Ramsel
66,Bergstraat 71,2023-05-31,15:00:00,300,166,134,FMN GV 11 Ramsel
66,Bergstraat 71,2023-05-31,16:00:00,240,130,110,FMN GV 11 Ramsel
66,Bergstraat 71,2023-05-31,17:00:00,274,164,110,FMN GV 11 Ramsel
66,Bergstraat 71,2023-05-31,18:00:00,156,90,66,FMN GV 11 Ramsel
66,Bergstraat 71,2023-05-31,19:00:00,206,114,92,FMN GV 11 Ramsel
66,Bergstraat 71,2023-05-31,20:00:00,96,52,44,FMN GV 11 Ramsel
66,Bergstraat 71,2023-05-31,21:00:00,62,28,34,FMN GV 11 Ramsel
66,Bergstraat 71,2023-05-31,22:00:00,32,14,18,FMN GV 11 Ramsel
66,Bergstraat 71,2023-05-31,23:00:00,12,8,4,FMN GV 11 Ramsel
66,Bergstraat 71,2023-06-01,00:00:00,2,2,0,FMN GV 11 Ramsel
66,Bergstraat 71,2023-06-01,01:00:00,0,0,0,FMN GV 11 Ramsel
66,Bergstraat 71,2023-06-01,02:00:00,0,0,0,FMN GV 11 Ramsel
66,Bergstraat 71,2023-06-01,03:00:00,0,0,0,FMN GV 11 Ramsel
66,Bergstraat 71,2023-06-01,04:00:00,6,2,4,FMN GV 11 Ramsel
66,Bergstraat 71,2023-06-01,05:00:00,28,16,12,FMN GV 11 Ramsel
66,Bergstraat 71,2023-06-01,06:00:00,56,16,40,FMN GV 11 Ramsel
66,Bergstraat 71,2023-06-01,07:00:00,230,46,184,FMN GV 11 Ramsel
66,Bergstraat 71,2023-06-01,08:00:00,246,26,220,FMN GV 11 Ramsel
66,Bergstraat 71,2023-06-01,09:00:00,38,10,28,FMN GV 11 Ramsel
66,Bergstraat 71,2023-06-01,10:00:00,132,44,88,FMN GV 11 Ramsel
66,Bergstraat 71,2023-06-01,11:00:00,66,30,36,FMN GV 11 Ramsel
66,Bergstraat 71,2023-06-01,12:00:00,122,44,78,FMN GV 11 Ramsel
66,Bergstraat 71,2023-06-01,13:00:00,170,106,64,FMN GV 11 Ramsel
66,Bergstraat 71,2023-06-01,14:00:00,196,100,96,FMN GV 11 Ramsel
66,Bergstraat 71,2023-06-01,15:00:00,332,236,96,FMN GV 11 Ramsel
66,Bergstraat 71,2023-06-01,16:00:00,304,226,78,FMN GV 11 Ramsel
66,Bergstraat 71,2023-06-01,17:00:00,188,110,78,FMN GV 11 Ramsel
66,Bergstraat 71,2023-06-01,18:00:00,174,90,84,FMN GV 11 Ramsel
66,Bergstraat 71,2023-06-01,19:00:00,108,52,56,FMN GV 11 Ramsel
66,Bergstraat 71,2023-06-01,20:00:00,64,30,34,FMN GV 11 Ramsel
66,Bergstraat 71,2023-06-01,21:00:00,34,20,14,FMN GV 11 Ramsel
66,Bergstraat 71,2023-06-01,22:00:00,16,12,4,FMN GV 11 Ramsel
66,Bergstraat 71,2023-06-01,23:00:00,14,8,6,FMN GV 11 Ramsel
66,Bergstraat 71,2023-06-02,00:00:00,2,2,0,FMN GV 11 Ramsel
66,Bergstraat 71,2023-06-02,01:00:00,0,0,0,FMN GV 11 Ramsel
66,Bergstraat 71,2023-06-02,02:00:00,0,0,0,FMN GV 11 Ramsel
66,Bergstraat 71,2023-06-02,03:00:00,0,0,0,FMN GV 11 Ramsel
66,Bergstraat 71,2023-06-02,04:00:00,8,8,0,FMN GV 11 Ramsel
66,Bergstraat 71,2023-06-02,05:00:00,24,12,12,FMN GV 11 Ramsel
66,Bergstraat 71,2023-06-02,06:00:00,44,16,28,FMN GV 11 Ramsel
66,Bergstraat 71,2023-06-02,07:00:00,210,28,182,FMN GV 11 Ramsel
66,Bergstraat 71,2023-06-02,08:00:00,260,22,238,FMN GV 11 Ramsel
66,Bergstraat 71,2023-06-02,09:00:00,58,12,46,FMN GV 11 Ramsel
66,Bergstraat 71,2023-06-02,10:00:00,58,28,30,FMN GV 11 Ramsel
66,Bergstraat 71,2023-06-02,11:00:00,74,40,34,FMN GV 11 Ramsel
66,Bergstraat 71,2023-06-02,12:00:00,120,66,54,FMN GV 11 Ramsel
66,Bergstraat 71,2023-06-02,13:00:00,86,36,50,FMN GV 11 Ramsel
66,Bergstraat 71,2023-06-02,14:00:00,134,72,62,FMN GV 11 Ramsel
66,Bergstraat 71,2023-06-02,15:00:00,344,264,80,FMN GV 11 Ramsel
66,Bergstraat 71,2023-06-02,16:00:00,290,222,68,FMN GV 11 Ramsel
66,Bergstraat 71,2023-06-02,17:00:00,182,104,78,FMN GV 11 Ramsel
66,Bergstraat 71,2023-06-02,18:00:00,106,54,52,FMN GV 11 Ramsel
66,Bergstraat 71,2023-06-02,19:00:00,108,46,62,FMN GV 11 Ramsel
66,Bergstraat 71,2023-06-02,20:00:00,62,36,26,FMN GV 11 Ramsel
66,Bergstraat 71,2023-06-02,21:00:00,42,26,16,FMN GV 11 Ramsel
66,Bergstraat 71,2023-06-02,22:00:00,16,10,6,FMN GV 11 Ramsel
66,Bergstraat 71,2023-06-02,23:00:00,6,6,0,FMN GV 11 Ramsel
66,Bergstraat 71,2023-06-03,00:00:00,16,12,4,FMN GV 11 Ramsel
66,Bergstraat 71,2023-06-03,01:00:00,4,4,0,FMN GV 11 Ramsel
66,Bergstraat 71,2023-06-03,02:00:00,2,2,0,FMN GV 11 Ramsel
66,Bergstraat 71,2023-06-03,03:00:00,6,4,2,FMN GV 11 Ramsel
66,Bergstraat 71,2023-06-03,04:00:00,0,0,0,FMN GV 11 Ramsel
66,Bergstraat 71,2023-06-03,05:00:00,4,2,2,FMN GV 11 Ramsel
66,Bergstraat 71,2023-06-03,06:00:00,10,0,10,FMN GV 11 Ramsel
66,Bergstraat 71,2023-06-03,07:00:00,34,12,22,FMN GV 11 Ramsel
66,Bergstraat 71,2023-06-03,08:00:00,54,18,36,FMN GV 11 Ramsel
66,Bergstraat 71,2023-06-03,09:00:00,104,50,54,FMN GV 11 Ramsel
66,Bergstraat 71,2023-06-03,10:00:00,136,82,54,FMN GV 11 Ramsel
66,Bergstraat 71,2023-06-03,11:00:00,156,74,82,FMN GV 11 Ramsel
66,Bergstraat 71,2023-06-03,12:00:00,172,78,94,FMN GV 11 Ramsel
66,Bergstraat 71,2023-06-03,13:00:00,222,106,116,FMN GV 11 Ramsel
66,Bergstraat 71,2023-06-03,14:00:00,304,156,148,FMN GV 11 Ramsel
66,Bergstraat 71,2023-06-03,15:00:00,236,144,92,FMN GV 11 Ramsel
66,Bergstraat 71,2023-06-03,16:00:00,188,118,70,FMN GV 11 Ramsel
66,Bergstraat 71,2023-06-03,17:00:00,126,50,76,FMN GV 11 Ramsel
66,Bergstraat 71,2023-06-03,18:00:00,98,54,44,FMN GV 11 Ramsel
66,Bergstraat 71,2023-06-03,19:00:00,82,40,42,FMN GV 11 Ramsel
66,Bergstraat 71,2023-06-03,20:00:00,58,30,28,FMN GV 11 Ramsel
66,Bergstraat 71,2023-06-03,21:00:00,42,18,24,FMN GV 11 Ramsel
66,Bergstraat 71,2023-06-03,22:00:00,30,18,12,FMN GV 11 Ramsel
66,Bergstraat 71,2023-06-03,23:00:00,18,14,4,FMN GV 11 Ramsel
66,Bergstraat 71,2023-06-04,00:00:00,8,8,0,FMN GV 11 Ramsel
66,Bergstraat 71,2023-06-04,01:00:00,4,2,2,FMN GV 11 Ramsel
66,Bergstraat 71,2023-06-04,02:00:00,4,2,2,FMN GV 11 Ramsel
66,Bergstraat 71,2023-06-04,03:00:00,4,2,2,FMN GV 11 Ramsel
66,Bergstraat 71,2023-06-04,04:00:00,2,2,0,FMN GV 11 Ramsel
66,Bergstraat 71,2023-06-04,05:00:00,0,0,0,FMN GV 11 Ramsel
66,Bergstraat 71,2023-06-04,06:00:00,16,8,8,FMN GV 11 Ramsel
66,Bergstraat 71,2023-06-04,07:00:00,18,8,10,FMN GV 11 Ramsel
66,Bergstraat 71,2023-06-04,08:00:00,112,34,78,FMN GV 11 Ramsel
66,Bergstraat 71,2023-06-04,09:00:00,178,52,126,FMN GV 11 Ramsel
66,Bergstraat 71,2023-06-04,10:00:00,228,112,116,FMN GV 11 Ramsel
66,Bergstraat 71,2023-06-04,11:00:00,258,148,110,FMN GV 11 Ramsel
66,Bergstraat 71,2023-06-04,12:00:00,268,130,138,FMN GV 11 Ramsel
66,Bergstraat 71,2023-06-04,13:00:00,280,142,138,FMN GV 11 Ramsel
66,Bergstraat 71,2023-06-04,14:00:00,398,190,208,FMN GV 11 Ramsel
66,Bergstraat 71,2023-06-04,15:00:00,358,188,170,FMN GV 11 Ramsel
66,Bergstraat 71,2023-06-04,16:00:00,246,122,124,FMN GV 11 Ramsel
66,Bergstraat 71,2023-06-04,17:00:00,228,112,116,FMN GV 11 Ramsel
66,Bergstraat 71,2023-06-04,18:00:00,112,64,48,FMN GV 11 Ramsel
66,Bergstraat 71,2023-06-04,19:00:00,144,80,64,FMN GV 11 Ramsel
66,Bergstraat 71,2023-06-04,20:00:00,48,30,18,FMN GV 11 Ramsel
66,Bergstraat 71,2023-06-04,21:00:00,44,28,16,FMN GV 11 Ramsel
66,Bergstraat 71,2023-06-04,22:00:00,20,16,4,FMN GV 11 Ramsel
66,Bergstraat 71,2023-06-04,23:00:00,6,4,2,FMN GV 11 Ramsel
66,Bergstraat 71,2023-06-05,00:00:00,0,0,0,FMN GV 11 Ramsel
66,Bergstraat 71,2023-06-05,01:00:00,2,0,2,FMN GV 11 Ramsel
66,Bergstraat 71,2023-06-05,02:00:00,0,0,0,FMN GV 11 Ramsel
66,Bergstraat 71,2023-06-05,03:00:00,4,2,2,FMN GV 11 Ramsel
66,Bergstraat 71,2023-06-05,04:00:00,6,6,0,FMN GV 11 Ramsel
66,Bergstraat 71,2023-06-05,05:00:00,26,14,12,FMN GV 11 Ramsel
66,Bergstraat 71,2023-06-05,06:00:00,72,20,52,FMN GV 11 Ramsel
66,Bergstraat 71,2023-06-05,07:00:00,258,26,232,FMN GV 11 Ramsel
66,Bergstraat 71,2023-06-05,08:00:00,256,46,210,FMN GV 11 Ramsel
66,Bergstraat 71,2023-06-05,09:00:00,64,26,38,FMN GV 11 Ramsel
66,Bergstraat 71,2023-06-05,10:00:00,58,26,32,FMN GV 11 Ramsel
66,Bergstraat 71,2023-06-05,11:00:00,62,36,26,FMN GV 11 Ramsel
66,Bergstraat 71,2023-06-05,12:00:00,118,58,60,FMN GV 11 Ramsel
66,Bergstraat 71,2023-06-05,13:00:00,198,58,140,FMN GV 11 Ramsel
66,Bergstraat 71,2023-06-05,14:00:00,264,128,136,FMN GV 11 Ramsel
66,Bergstraat 71,2023-06-05,15:00:00,408,322,86,FMN GV 11 Ramsel
66,Bergstraat 71,2023-06-05,16:00:00,302,226,76,FMN GV 11 Ramsel
66,Bergstraat 71,2023-06-05,17:00:00,190,106,84,FMN GV 11 Ramsel
66,Bergstraat 71,2023-06-05,18:00:00,154,86,68,FMN GV 11 Ramsel
66,Bergstraat 71,2023-06-05,19:00:00,142,62,80,FMN GV 11 Ramsel
66,Bergstraat 71,2023-06-05,20:00:00,74,38,36,FMN GV 11 Ramsel
66,Bergstraat 71,2023-06-05,21:00:00,52,42,10,FMN GV 11 Ramsel
66,Bergstraat 71,2023-06-05,22:00:00,24,16,8,FMN GV 11 Ramsel
66,Bergstraat 71,2023-06-05,23:00:00,10,6,4,FMN GV 11 Ramsel
66,Bergstraat 71,2023-06-06,00:00:00,0,0,0,FMN GV 11 Ramsel
66,Bergstraat 71,2023-06-06,01:00:00,0,0,0,FMN GV 11 Ramsel
66,Bergstraat 71,2023-06-06,02:00:00,0,0,0,FMN GV 11 Ramsel
66,Bergstraat 71,2023-06-06,03:00:00,2,2,0,FMN GV 11 Ramsel
66,Bergstraat 71,2023-06-06,04:00:00,6,6,0,FMN GV 11 Ramsel
66,Bergstraat 71,2023-06-06,05:00:00,26,12,14,FMN GV 11 Ramsel
66,Bergstraat 71,2023-06-06,06:00:00,80,32,48,FMN GV 11 Ramsel
66,Bergstraat 71,2023-06-06,07:00:00,290,44,246,FMN GV 11 Ramsel
66,Bergstraat 71,2023-06-06,08:00:00,284,40,244,FMN GV 11 Ramsel
66,Bergstraat 71,2023-06-06,09:00:00,82,22,60,FMN GV 11 Ramsel
66,Bergstraat 71,2023-06-06,10:00:00,136,62,74,FMN GV 11 Ramsel
66,Bergstraat 71,2023-06-06,11:00:00,80,30,50,FMN GV 11 Ramsel
66,Bergstraat 71,2023-06-06,12:00:00,134,74,60,FMN GV 11 Ramsel
66,Bergstraat 71,2023-06-06,13:00:00,158,52,106,FMN GV 11 Ramsel
66,Bergstraat 71,2023-06-06,14:00:00,200,134,66,FMN GV 11 Ramsel
66,Bergstraat 71,2023-06-06,15:00:00,400,310,90,FMN GV 11 Ramsel
66,Bergstraat 71,2023-06-06,16:00:00,376,246,130,FMN GV 11 Ramsel
66,Bergstraat 71,2023-06-06,17:00:00,220,130,90,FMN GV 11 Ramsel
66,Bergstraat 71,2023-06-06,18:00:00,168,84,84,FMN GV 11 Ramsel
66,Bergstraat 71,2023-06-06,19:00:00,132,66,66,FMN GV 11 Ramsel
66,Bergstraat 71,2023-06-06,20:00:00,146,74,72,FMN GV 11 Ramsel
66,Bergstraat 71,2023-06-06,21:00:00,56,36,20,FMN GV 11 Ramsel
66,Bergstraat 71,2023-06-06,22:00:00,34,26,8,FMN GV 11 Ramsel
66,Bergstraat 71,2023-06-06,23:00:00,10,10,0,FMN GV 11 Ramsel
66,Bergstraat 71,2023-06-07,00:00:00,2,2,0,FMN GV 11 Ramsel
66,Bergstraat 71,2023-06-07,01:00:00,0,0,0,FMN GV 11 Ramsel
66,Bergstraat 71,2023-06-07,02:00:00,0,0,0,FMN GV 11 Ramsel
66,Bergstraat 71,2023-06-07,03:00:00,0,0,0,FMN GV 11 Ramsel
66,Bergstraat 71,2023-06-07,04:00:00,6,6,0,FMN GV 11 Ramsel
66,Bergstraat 71,2023-06-07,05:00:00,34,16,18,FMN GV 11 Ramsel
66,Bergstraat 71,2023-06-07,06:00:00,68,28,40,FMN GV 11 Ramsel
66,Bergstraat 71,2023-06-07,07:00:00,260,34,226,FMN GV 11 Ramsel
66,Bergstraat 71,2023-06-07,08:00:00,262,40,222,FMN GV 11 Ramsel
66,Bergstraat 71,2023-06-07,09:00:00,60,26,34,FMN GV 11 Ramsel
66,Bergstraat 71,2023-06-07,10:00:00,94,68,26,FMN GV 11 Ramsel
66,Bergstraat 71,2023-06-07,11:00:00,112,64,48,FMN GV 11 Ramsel
66,Bergstraat 71,2023-06-07,12:00:00,378,304,74,FMN GV 11 Ramsel
66,Bergstraat 71,2023-06-07,13:00:00,172,96,76,FMN GV 11 Ramsel
66,Bergstraat 71,2023-06-07,14:00:00,154,60,94,FMN GV 11 Ramsel
66,Bergstraat 71,2023-06-07,15:00:00,186,104,82,FMN GV 11 Ramsel
66,Bergstraat 71,2023-06-07,16:00:00,176,72,104,FMN GV 11 Ramsel
66,Bergstraat 71,2023-06-07,17:00:00,198,128,70,FMN GV 11 Ramsel
66,Bergstraat 71,2023-06-07,18:00:00,132,76,56,FMN GV 11 Ramsel
66,Bergstraat 71,2023-06-07,19:00:00,120,52,68,FMN GV 11 Ramsel
66,Bergstraat 71,2023-06-07,20:00:00,80,52,28,FMN GV 11 Ramsel
66,Bergstraat 71,2023-06-07,21:00:00,76,50,26,FMN GV 11 Ramsel
66,Bergstraat 71,2023-06-07,22:00:00,42,28,14,FMN GV 11 Ramsel
66,Bergstraat 71,2023-06-07,23:00:00,4,2,2,FMN GV 11 Ramsel
66,Bergstraat 71,2023-06-08,00:00:00,2,2,0,FMN GV 11 Ramsel
66,Bergstraat 71,2023-06-08,01:00:00,0,0,0,FMN GV 11 Ramsel
66,Bergstraat 71,2023-06-08,02:00:00,0,0,0,FMN GV 11 Ramsel
66,Bergstraat 71,2023-06-08,03:00:00,2,0,2,FMN GV 11 Ramsel
66,Bergstraat 71,2023-06-08,04:00:00,6,4,2,FMN GV 11 Ramsel
66,Bergstraat 71,2023-06-08,05:00:00,22,14,8,FMN GV 11 Ramsel
66,Bergstraat 71,2023-06-08,06:00:00,60,28,32,FMN GV 11 Ramsel
66,Bergstraat 71,2023-06-08,07:00:00,236,32,204,FMN GV 11 Ramsel
66,Bergstraat 71,2023-06-08,08:00:00,300,38,262,FMN GV 11 Ramsel
66,Bergstraat 71,2023-06-08,09:00:00,102,26,76,FMN GV 11 Ramsel
66,Bergstraat 71,2023-06-08,10:00:00,144,50,94,FMN GV 11 Ramsel
66,Bergstraat 71,2023-06-08,11:00:00,122,56,66,FMN GV 11 Ramsel
66,Bergstraat 71,2023-06-08,12:00:00,188,130,58,FMN GV 11 Ramsel
66,Bergstraat 71,2023-06-08,13:00:00,240,94,146,FMN GV 11 Ramsel
66,Bergstraat 71,2023-06-08,14:00:00,194,112,82,FMN GV 11 Ramsel
66,Bergstraat 71,2023-06-08,15:00:00,396,296,100,FMN GV 11 Ramsel
66,Bergstraat 71,2023-06-08,16:00:00,288,208,80,FMN GV 11 Ramsel
66,Bergstraat 71,2023-06-08,17:00:00,192,132,60,FMN GV 11 Ramsel
66,Bergstraat 71,2023-06-08,18:00:00,148,78,70,FMN GV 11 Ramsel
66,Bergstraat 71,2023-06-08,19:00:00,68,40,28,FMN GV 11 Ramsel
66,Bergstraat 71,2023-06-08,20:00:00,78,48,30,FMN GV 11 Ramsel
66,Bergstraat 71,2023-06-08,21:00:00,42,36,6,FMN GV 11 Ramsel
66,Bergstraat 71,2023-06-08,22:00:00,24,16,8,FMN GV 11 Ramsel
66,Bergstraat 71,2023-06-08,23:00:00,8,8,0,FMN GV 11 Ramsel
66,Bergstraat 71,2023-06-09,00:00:00,12,2,10,FMN GV 11 Ramsel
66,Bergstraat 71,2023-06-09,01:00:00,0,0,0,FMN GV 11 Ramsel
66,Bergstraat 71,2023-06-09,02:00:00,4,4,0,FMN GV 11 Ramsel
66,Bergstraat 71,2023-06-09,03:00:00,0,0,0,FMN GV 11 Ramsel
66,Bergstraat 71,2023-06-09,04:00:00,6,6,0,FMN GV 11 Ramsel
66,Bergstraat 71,2023-06-09,05:00:00,24,14,10,FMN GV 11 Ramsel
66,Bergstraat 71,2023-06-09,06:00:00,60,24,36,FMN GV 11 Ramsel
66,Bergstraat 71,2023-06-09,07:00:00,254,38,216,FMN GV 11 Ramsel
66,Bergstraat 71,2023-06-09,08:00:00,222,34,188,FMN GV 11 Ramsel
66,Bergstraat 71,2023-06-09,09:00:00,164,90,74,FMN GV 11 Ramsel
66,Bergstraat 71,2023-06-09,10:00:00,130,74,56,FMN GV 11 Ramsel
66,Bergstraat 71,2023-06-09,11:00:00,162,84,78,FMN GV 11 Ramsel
66,Bergstraat 71,2023-06-09,12:00:00,114,54,60,FMN GV 11 Ramsel
66,Bergstraat 71,2023-06-09,13:00:00,176,84,92,FMN GV 11 Ramsel
66,Bergstraat 71,2023-06-09,14:00:00,208,116,92,FMN GV 11 Ramsel
66,Bergstraat 71,2023-06-09,15:00:00,316,224,92,FMN GV 11 Ramsel
66,Bergstraat 71,2023-06-09,16:00:00,222,160,62,FMN GV 11 Ramsel
66,Bergstraat 71,2023-06-09,17:00:00,114,64,50,FMN GV 11 Ramsel
66,Bergstraat 71,2023-06-09,18:00:00,152,100,52,FMN GV 11 Ramsel
66,Bergstraat 71,2023-06-09,19:00:00,114,56,58,FMN GV 11 Ramsel
66,Bergstraat 71,2023-06-09,20:00:00,70,38,32,FMN GV 11 Ramsel
66,Bergstraat 71,2023-06-09,21:00:00,102,48,54,FMN GV 11 Ramsel
66,Bergstraat 71,2023-06-09,22:00:00,42,22,20,FMN GV 11 Ramsel
66,Bergstraat 71,2023-06-09,23:00:00,4,4,0,FMN GV 11 Ramsel
66,Bergstraat 71,2023-06-10,00:00:00,10,10,0,FMN GV 11 Ramsel
66,Bergstraat 71,2023-06-10,01:00:00,6,4,2,FMN GV 11 Ramsel
66,Bergstraat 71,2023-06-10,02:00:00,0,0,0,FMN GV 11 Ramsel
66,Bergstraat 71,2023-06-10,03:00:00,2,0,2,FMN GV 11 Ramsel
66,Bergstraat 71,2023-06-10,04:00:00,2,2,0,FMN GV 11 Ramsel
66,Bergstraat 71,2023-06-10,05:00:00,4,2,2,FMN GV 11 Ramsel
66,Bergstraat 71,2023-06-10,06:00:00,10,4,6,FMN GV 11 Ramsel
66,Bergstraat 71,2023-06-10,07:00:00,38,16,22,FMN GV 11 Ramsel
66,Bergstraat 71,2023-06-10,08:00:00,86,38,48,FMN GV 11 Ramsel
66,Bergstraat 71,2023-06-10,09:00:00,166,82,84,FMN GV 11 Ramsel
66,Bergstraat 71,2023-06-10,10:00:00,196,70,126,FMN GV 11 Ramsel
66,Bergstraat 71,2023-06-10,11:00:00,196,80,116,FMN GV 11 Ramsel
66,Bergstraat 71,2023-06-10,12:00:00,228,96,132,FMN GV 11 Ramsel
66,Bergstraat 71,2023-06-10,13:00:00,240,84,156,FMN GV 11 Ramsel
66,Bergstraat 71,2023-06-10,14:00:00,258,124,134,FMN GV 11 Ramsel
66,Bergstraat 71,2023-06-10,15:00:00,214,134,80,FMN GV 11 Ramsel
66,Bergstraat 71,2023-06-10,16:00:00,260,176,84,FMN GV 11 Ramsel
66,Bergstraat 71,2023-06-10,17:00:00,118,78,40,FMN GV 11 Ramsel
66,Bergstraat 71,2023-06-10,18:00:00,104,48,56,FMN GV 11 Ramsel
66,Bergstraat 71,2023-06-10,19:00:00,110,68,42,FMN GV 11 Ramsel
66,Bergstraat 71,2023-06-10,20:00:00,94,48,46,FMN GV 11 Ramsel
66,Bergstraat 71,2023-06-10,21:00:00,56,32,24,FMN GV 11 Ramsel
66,Bergstraat 71,2023-06-10,22:00:00,46,18,28,FMN GV 11 Ramsel
66,Bergstraat 71,2023-06-10,23:00:00,48,24,24,FMN GV 11 Ramsel
66,Bergstraat 71,2023-06-11,00:00:00,14,12,2,FMN GV 11 Ramsel
66,Bergstraat 71,2023-06-11,01:00:00,14,14,0,FMN GV 11 Ramsel
66,Bergstraat 71,2023-06-11,02:00:00,10,10,0,FMN GV 11 Ramsel
66,Bergstraat 71,2023-06-11,03:00:00,4,4,0,FMN GV 11 Ramsel
66,Bergstraat 71,2023-06-11,04:00:00,2,0,2,FMN GV 11 Ramsel
66,Bergstraat 71,2023-06-11,05:00:00,8,2,6,FMN GV 11 Ramsel
66,Bergstraat 71,2023-06-11,06:00:00,10,2,8,FMN GV 11 Ramsel
66,Bergstraat 71,2023-06-11,07:00:00,40,22,18,FMN GV 11 Ramsel
66,Bergstraat 71,2023-06-11,08:00:00,126,34,92,FMN GV 11 Ramsel
66,Bergstraat 71,2023-06-11,09:00:00,200,90,110,FMN GV 11 Ramsel
66,Bergstraat 71,2023-06-11,10:00:00,312,160,152,FMN GV 11 Ramsel
66,Bergstraat 71,2023-06-11,11:00:00,292,158,134,FMN GV 11 Ramsel
66,Bergstraat 71,2023-06-11,12:00:00,192,120,72,FMN GV 11 Ramsel
66,Bergstraat 71,2023-06-11,13:00:00,154,88,66,FMN GV 11 Ramsel
66,Bergstraat 71,2023-06-11,14:00:00,232,138,94,FMN GV 11 Ramsel
66,Bergstraat 71,2023-06-11,15:00:00,190,88,102,FMN GV 11 Ramsel
66,Bergstraat 71,2023-06-11,16:00:00,160,74,86,FMN GV 11 Ramsel
66,Bergstraat 71,2023-06-11,17:00:00,128,44,84,FMN GV 11 Ramsel
66,Bergstraat 71,2023-06-11,18:00:00,136,78,58,FMN GV 11 Ramsel
66,Bergstraat 71,2023-06-11,19:00:00,126,40,86,FMN GV 11 Ramsel
66,Bergstraat 71,2023-06-11,20:00:00,106,38,68,FMN GV 11 Ramsel
66,Bergstraat 71,2023-06-11,21:00:00,74,40,34,FMN GV 11 Ramsel
66,Bergstraat 71,2023-06-11,22:00:00,10,8,2,FMN GV 11 Ramsel
66,Bergstraat 71,2023-06-11,23:00:00,10,6,4,FMN GV 11 Ramsel
66,Bergstraat 71,2023-06-12,00:00:00,0,0,0,FMN GV 11 Ramsel
66,Bergstraat 71,2023-06-12,01:00:00,0,0,0,FMN GV 11 Ramsel
66,Bergstraat 71,2023-06-12,02:00:00,2,2,0,FMN GV 11 Ramsel
66,Bergstraat 71,2023-06-12,03:00:00,2,0,2,FMN GV 11 Ramsel
66,Bergstraat 71,2023-06-12,04:00:00,8,8,0,FMN GV 11 Ramsel
66,Bergstraat 71,2023-06-12,05:00:00,30,12,18,FMN GV 11 Ramsel
66,Bergstraat 71,2023-06-12,06:00:00,62,22,40,FMN GV 11 Ramsel
66,Bergstraat 71,2023-06-12,07:00:00,312,42,270,FMN GV 11 Ramsel
66,Bergstraat 71,2023-06-12,08:00:00,254,46,208,FMN GV 11 Ramsel
66,Bergstraat 71,2023-06-12,09:00:00,94,42,52,FMN GV 11 Ramsel
66,Bergstraat 71,2023-06-12,10:00:00,126,72,54,FMN GV 11 Ramsel
66,Bergstraat 71,2023-06-12,11:00:00,104,56,48,FMN GV 11 Ramsel
66,Bergstraat 71,2023-06-12,12:00:00,136,88,48,FMN GV 11 Ramsel
66,Bergstraat 71,2023-06-12,13:00:00,104,36,68,FMN GV 11 Ramsel
66,Bergstraat 71,2023-06-12,14:00:00,142,74,68,FMN GV 11 Ramsel
66,Bergstraat 71,2023-06-12,15:00:00,294,210,84,FMN GV 11 Ramsel
66,Bergstraat 71,2023-06-12,16:00:00,212,158,54,FMN GV 11 Ramsel
66,Bergstraat 71,2023-06-12,17:00:00,160,98,62,FMN GV 11 Ramsel
66,Bergstraat 71,2023-06-12,18:00:00,142,70,72,FMN GV 11 Ramsel
66,Bergstraat 71,2023-06-12,19:00:00,112,54,58,FMN GV 11 Ramsel
66,Bergstraat 71,2023-06-12,20:00:00,116,52,64,FMN GV 11 Ramsel
66,Bergstraat 71,2023-06-12,21:00:00,84,64,20,FMN GV 11 Ramsel
66,Bergstraat 71,2023-06-12,22:00:00,16,6,10,FMN GV 11 Ramsel
66,Bergstraat 71,2023-06-12,23:00:00,8,6,2,FMN GV 11 Ramsel
66,Bergstraat 71,2023-06-13,00:00:00,0,0,0,FMN GV 11 Ramsel
66,Bergstraat 71,2023-06-13,01:00:00,0,0,0,FMN GV 11 Ramsel
66,Bergstraat 71,2023-06-13,02:00:00,0,0,0,FMN GV 11 Ramsel
66,Bergstraat 71,2023-06-13,03:00:00,2,0,2,FMN GV 11 Ramsel
66,Bergstraat 71,2023-06-13,04:00:00,10,8,2,FMN GV 11 Ramsel
66,Bergstraat 71,2023-06-13,05:00:00,40,18,22,FMN GV 11 Ramsel
66,Bergstraat 71,2023-06-13,06:00:00,66,28,38,FMN GV 11 Ramsel
66,Bergstraat 71,2023-06-13,07:00:00,324,58,266,FMN GV 11 Ramsel
66,Bergstraat 71,2023-06-13,08:00:00,276,38,238,FMN GV 11 Ramsel
66,Bergstraat 71,2023-06-13,09:00:00,144,60,84,FMN GV 11 Ramsel
66,Bergstraat 71,2023-06-13,10:00:00,216,104,112,FMN GV 11 Ramsel
66,Bergstraat 71,2023-06-13,11:00:00,138,90,48,FMN GV 11 Ramsel
66,Bergstraat 71,2023-06-13,12:00:00,234,178,56,FMN GV 11 Ramsel
66,Bergstraat 71,2023-06-13,13:00:00,176,70,106,FMN GV 11 Ramsel
66,Bergstraat 71,2023-06-13,14:00:00,162,92,70,FMN GV 11 Ramsel
66,Bergstraat 71,2023-06-13,15:00:00,278,188,90,FMN GV 11 Ramsel
66,Bergstraat 71,2023-06-13,16:00:00,234,156,78,FMN GV 11 Ramsel
66,Bergstraat 71,2023-06-13,17:00:00,172,106,66,FMN GV 11 Ramsel
66,Bergstraat 71,2023-06-13,18:00:00,186,90,96,FMN GV 11 Ramsel
66,Bergstraat 71,2023-06-13,19:00:00,170,82,88,FMN GV 11 Ramsel
66,Bergstraat 71,2023-06-13,20:00:00,128,74,54,FMN GV 11 Ramsel
66,Bergstraat 71,2023-06-13,21:00:00,70,46,24,FMN GV 11 Ramsel
66,Bergstraat 71,2023-06-13,22:00:00,42,30,12,FMN GV 11 Ramsel
66,Bergstraat 71,2023-06-13,23:00:00,8,6,2,FMN GV 11 Ramsel
66,Bergstraat 71,2023-06-14,00:00:00,2,2,0,FMN GV 11 Ramsel
66,Bergstraat 71,2023-06-14,01:00:00,0,0,0,FMN GV 11 Ramsel
66,Bergstraat 71,2023-06-14,02:00:00,2,2,0,FMN GV 11 Ramsel
66,Bergstraat 71,2023-06-14,03:00:00,0,0,0,FMN GV 11 Ramsel
66,Bergstraat 71,2023-06-14,04:00:00,6,6,0,FMN GV 11 Ramsel
66,Bergstraat 71,2023-06-14,05:00:00,34,18,16,FMN GV 11 Ramsel
66,Bergstraat 71,2023-06-14,06:00:00,52,26,26,FMN GV 11 Ramsel
66,Bergstraat 71,2023-06-14,07:00:00,302,48,254,FMN GV 11 Ramsel
66,Bergstraat 71,2023-06-14,08:00:00,226,42,184,FMN GV 11 Ramsel
66,Bergstraat 71,2023-06-14,09:00:00,170,86,84,FMN GV 11 Ramsel
66,Bergstraat 71,2023-06-14,10:00:00,212,122,90,FMN GV 11 Ramsel
66,Bergstraat 71,2023-06-14,11:00:00,186,130,56,FMN GV 11 Ramsel
66,Bergstraat 71,2023-06-14,12:00:00,302,214,88,FMN GV 11 Ramsel
66,Bergstraat 71,2023-06-14,13:00:00,174,92,82,FMN GV 11 Ramsel
66,Bergstraat 71,2023-06-14,14:00:00,196,90,106,FMN GV 11 Ramsel
66,Bergstraat 71,2023-06-14,15:00:00,174,112,62,FMN GV 11 Ramsel
66,Bergstraat 71,2023-06-14,16:00:00,138,76,62,FMN GV 11 Ramsel
66,Bergstraat 71,2023-06-14,17:00:00,230,146,84,FMN GV 11 Ramsel
66,Bergstraat 71,2023-06-14,18:00:00,202,84,118,FMN GV 11 Ramsel
66,Bergstraat 71,2023-06-14,19:00:00,152,84,68,FMN GV 11 Ramsel
66,Bergstraat 71,2023-06-14,20:00:00,106,58,48,FMN GV 11 Ramsel
66,Bergstraat 71,2023-06-14,21:00:00,68,36,32,FMN GV 11 Ramsel
66,Bergstraat 71,2023-06-14,22:00:00,46,32,14,FMN GV 11 Ramsel
66,Bergstraat 71,2023-06-14,23:00:00,4,4,0,FMN GV 11 Ramsel
66,Bergstraat 71,2023-06-15,00:00:00,2,2,0,FMN GV 11 Ramsel
66,Bergstraat 71,2023-06-15,01:00:00,0,0,0,FMN GV 11 Ramsel
66,Bergstraat 71,2023-06-15,02:00:00,0,0,0,FMN GV 11 Ramsel
66,Bergstraat 71,2023-06-15,03:00:00,0,0,0,FMN GV 11 Ramsel
66,Bergstraat 71,2023-06-15,04:00:00,6,2,4,FMN GV 11 Ramsel
66,Bergstraat 71,2023-06-15,05:00:00,34,16,18,FMN GV 11 Ramsel
66,Bergstraat 71,2023-06-15,06:00:00,60,20,40,FMN GV 11 Ramsel
66,Bergstraat 71,2023-06-15,07:00:00,282,46,236,FMN GV 11 Ramsel
66,Bergstraat 71,2023-06-15,08:00:00,288,50,238,FMN GV 11 Ramsel
66,Bergstraat 71,2023-06-15,09:00:00,132,40,92,FMN GV 11 Ramsel
66,Bergstraat 71,2023-06-15,10:00:00,272,196,76,FMN GV 11 Ramsel
66,Bergstraat 71,2023-06-15,11:00:00,180,118,62,FMN GV 11 Ramsel
66,Bergstraat 71,2023-06-15,12:00:00,214,144,70,FMN GV 11 Ramsel
66,Bergstraat 71,2023-06-15,13:00:00,196,106,90,FMN GV 11 Ramsel
66,Bergstraat 71,2023-06-15,14:00:00,172,88,84,FMN GV 11 Ramsel
66,Bergstraat 71,2023-06-15,15:00:00,240,162,78,FMN GV 11 Ramsel
66,Bergstraat 71,2023-06-15,16:00:00,172,106,66,FMN GV 11 Ramsel
66,Bergstraat 71,2023-06-15,17:00:00,216,136,80,FMN GV 11 Ramsel
66,Bergstraat 71,2023-06-15,18:00:00,176,60,116,FMN GV 11 Ramsel
66,Bergstraat 71,2023-06-15,19:00:00,116,76,40,FMN GV 11 Ramsel
66,Bergstraat 71,2023-06-15,20:00:00,106,54,52,FMN GV 11 Ramsel
66,Bergstraat 71,2023-06-15,21:00:00,80,40,40,FMN GV 11 Ramsel
66,Bergstraat 71,2023-06-15,22:00:00,36,30,6,FMN GV 11 Ramsel
66,Bergstraat 71,2023-06-15,23:00:00,22,12,10,FMN GV 11 Ramsel
66,Bergstraat 71,2023-06-16,00:00:00,4,4,0,FMN GV 11 Ramsel
66,Bergstraat 71,2023-06-16,01:00:00,0,0,0,FMN GV 11 Ramsel
66,Bergstraat 71,2023-06-16,02:00:00,2,0,2,FMN GV 11 Ramsel
66,Bergstraat 71,2023-06-16,03:00:00,0,0,0,FMN GV 11 Ramsel
66,Bergstraat 71,2023-06-16,04:00:00,10,4,6,FMN GV 11 Ramsel
66,Bergstraat 71,2023-06-16,05:00:00,24,12,12,FMN GV 11 Ramsel
66,Bergstraat 71,2023-06-16,06:00:00,54,18,36,FMN GV 11 Ramsel
66,Bergstraat 71,2023-06-16,07:00:00,270,36,234,FMN GV 11 Ramsel
66,Bergstraat 71,2023-06-16,08:00:00,236,44,192,FMN GV 11 Ramsel
66,Bergstraat 71,2023-06-16,09:00:00,136,56,80,FMN GV 11 Ramsel
66,Bergstraat 71,2023-06-16,10:00:00,258,196,62,FMN GV 11 Ramsel
66,Bergstraat 71,2023-06-16,11:00:00,164,104,60,FMN GV 11 Ramsel
66,Bergstraat 71,2023-06-16,12:00:00,160,94,66,FMN GV 11 Ramsel
66,Bergstraat 71,2023-06-16,13:00:00,150,84,66,FMN GV 11 Ramsel
66,Bergstraat 71,2023-06-16,14:00:00,206,112,94,FMN GV 11 Ramsel
66,Bergstraat 71,2023-06-16,15:00:00,258,140,118,FMN GV 11 Ramsel
66,Bergstraat 71,2023-06-16,16:00:00,188,134,54,FMN GV 11 Ramsel
66,Bergstraat 71,2023-06-16,17:00:00,160,104,56,FMN GV 11 Ramsel
66,Bergstraat 71,2023-06-16,18:00:00,120,64,56,FMN GV 11 Ramsel
66,Bergstraat 71,2023-06-16,19:00:00,132,58,74,FMN GV 11 Ramsel
66,Bergstraat 71,2023-06-16,20:00:00,136,62,74,FMN GV 11 Ramsel
66,Bergstraat 71,2023-06-16,21:00:00,100,58,42,FMN GV 11 Ramsel
66,Bergstraat 71,2023-06-16,22:00:00,40,32,8,FMN GV 11 Ramsel
66,Bergstraat 71,2023-06-16,23:00:00,36,20,16,FMN GV 11 Ramsel
66,Bergstraat 71,2023-06-17,00:00:00,4,2,2,FMN GV 11 Ramsel
66,Bergstraat 71,2023-06-17,01:00:00,6,4,2,FMN GV 11 Ramsel
66,Bergstraat 71,2023-06-17,02:00:00,8,8,0,FMN GV 11 Ramsel
66,Bergstraat 71,2023-06-17,03:00:00,2,2,0,FMN GV 11 Ramsel
66,Bergstraat 71,2023-06-17,04:00:00,4,2,2,FMN GV 11 Ramsel
66,Bergstraat 71,2023-06-17,05:00:00,4,2,2,FMN GV 11 Ramsel
66,Bergstraat 71,2023-06-17,06:00:00,10,8,2,FMN GV 11 Ramsel
66,Bergstraat 71,2023-06-17,07:00:00,22,8,14,FMN GV 11 Ramsel
66,Bergstraat 71,2023-06-17,08:00:00,86,18,68,FMN GV 11 Ramsel
66,Bergstraat 71,2023-06-17,09:00:00,132,62,70,FMN GV 11 Ramsel
66,Bergstraat 71,2023-06-17,10:00:00,258,128,130,FMN GV 11 Ramsel
66,Bergstraat 71,2023-06-17,11:00:00,194,98,96,FMN GV 11 Ramsel
66,Bergstraat 71,2023-06-17,12:00:00,206,86,120,FMN GV 11 Ramsel
66,Bergstraat 71,2023-06-17,13:00:00,208,86,122,FMN GV 11 Ramsel
66,Bergstraat 71,2023-06-17,14:00:00,318,184,134,FMN GV 11 Ramsel
66,Bergstraat 71,2023-06-17,15:00:00,210,116,94,FMN GV 11 Ramsel
66,Bergstraat 71,2023-06-17,16:00:00,172,114,58,FMN GV 11 Ramsel
66,Bergstraat 71,2023-06-17,17:00:00,164,86,78,FMN GV 11 Ramsel
66,Bergstraat 71,2023-06-17,18:00:00,160,72,88,FMN GV 11 Ramsel
66,Bergstraat 71,2023-06-17,19:00:00,92,38,54,FMN GV 11 Ramsel
66,Bergstraat 71,2023-06-17,20:00:00,76,30,46,FMN GV 11 Ramsel
66,Bergstraat 71,2023-06-17,21:00:00,56,26,30,FMN GV 11 Ramsel
66,Bergstraat 71,2023-06-17,22:00:00,20,14,6,FMN GV 11 Ramsel
66,Bergstraat 71,2023-06-17,23:00:00,14,10,4,FMN GV 11 Ramsel
66,Bergstraat 71,2023-06-18,00:00:00,18,18,0,FMN GV 11 Ramsel
66,Bergstraat 71,2023-06-18,01:00:00,24,20,4,FMN GV 11 Ramsel
66,Bergstraat 71,2023-06-18,02:00:00,8,6,2,FMN GV 11 Ramsel
66,Bergstraat 71,2023-06-18,03:00:00,4,0,4,FMN GV 11 Ramsel
66,Bergstraat 71,2023-06-18,04:00:00,6,0,6,FMN GV 11 Ramsel
66,Bergstraat 71,2023-06-18,05:00:00,4,2,2,FMN GV 11 Ramsel
66,Bergstraat 71,2023-06-18,06:00:00,8,4,4,FMN GV 11 Ramsel
66,Bergstraat 71,2023-06-18,07:00:00,36,10,26,FMN GV 11 Ramsel
66,Bergstraat 71,2023-06-18,08:00:00,76,18,58,FMN GV 11 Ramsel
66,Bergstraat 71,2023-06-18,09:00:00,170,100,70,FMN GV 11 Ramsel
66,Bergstraat 71,2023-06-18,10:00:00,220,168,52,FMN GV 11 Ramsel
66,Bergstraat 71,2023-06-18,11:00:00,224,178,46,FMN GV 11 Ramsel
66,Bergstraat 71,2023-06-18,12:00:00,122,98,24,FMN GV 11 Ramsel
66,Bergstraat 71,2023-06-18,13:00:00,152,74,78,FMN GV 11 Ramsel
66,Bergstraat 71,2023-06-18,14:00:00,274,192,82,FMN GV 11 Ramsel
66,Bergstraat 71,2023-06-18,15:00:00,374,290,84,FMN GV 11 Ramsel
66,Bergstraat 71,2023-06-18,16:00:00,228,178,50,FMN GV 11 Ramsel
66,Bergstraat 71,2023-06-18,17:00:00,126,58,68,FMN GV 11 Ramsel
66,Bergstraat 71,2023-06-18,18:00:00,44,24,20,FMN GV 11 Ramsel
66,Bergstraat 71,2023-06-18,19:00:00,50,16,34,FMN GV 11 Ramsel
66,Bergstraat 71,2023-06-18,20:00:00,44,22,22,FMN GV 11 Ramsel
66,Bergstraat 71,2023-06-18,21:00:00,30,16,14,FMN GV 11 Ramsel
66,Bergstraat 71,2023-06-18,22:00:00,32,18,14,FMN GV 11 Ramsel
66,Bergstraat 71,2023-06-18,23:00:00,6,4,2,FMN GV 11 Ramsel
66,Bergstraat 71,2023-06-19,00:00:00,6,6,0,FMN GV 11 Ramsel
66,Bergstraat 71,2023-06-19,01:00:00,4,4,0,FMN GV 11 Ramsel
66,Bergstraat 71,2023-06-19,02:00:00,36,34,2,FMN GV 11 Ramsel
66,Bergstraat 71,2023-06-19,03:00:00,2,0,2,FMN GV 11 Ramsel
66,Bergstraat 71,2023-06-19,04:00:00,14,12,2,FMN GV 11 Ramsel
66,Bergstraat 71,2023-06-19,05:00:00,24,12,12,FMN GV 11 Ramsel
66,Bergstraat 71,2023-06-19,06:00:00,52,18,34,FMN GV 11 Ramsel
66,Bergstraat 71,2023-06-19,07:00:00,298,28,270,FMN GV 11 Ramsel
66,Bergstraat 71,2023-06-19,08:00:00,202,16,186,FMN GV 11 Ramsel
66,Bergstraat 71,2023-06-19,09:00:00,84,14,70,FMN GV 11 Ramsel
66,Bergstraat 71,2023-06-19,10:00:00,128,92,36,FMN GV 11 Ramsel
66,Bergstraat 71,2023-06-19,11:00:00,170,130,40,FMN GV 11 Ramsel
66,Bergstraat 71,2023-06-19,12:00:00,226,170,56,FMN GV 11 Ramsel
66,Bergstraat 71,2023-06-19,13:00:00,172,102,70,FMN GV 11 Ramsel
66,Bergstraat 71,2023-06-19,14:00:00,194,90,104,FMN GV 11 Ramsel
66,Bergstraat 71,2023-06-19,15:00:00,262,168,94,FMN GV 11 Ramsel
66,Bergstraat 71,2023-06-19,16:00:00,230,126,104,FMN GV 11 Ramsel
66,Bergstraat 71,2023-06-19,17:00:00,160,100,60,FMN GV 11 Ramsel
66,Bergstraat 71,2023-06-19,18:00:00,126,62,64,FMN GV 11 Ramsel
66,Bergstraat 71,2023-06-19,19:00:00,100,54,46,FMN GV 11 Ramsel
66,Bergstraat 71,2023-06-19,20:00:00,42,20,22,FMN GV 11 Ramsel
66,Bergstraat 71,2023-06-19,21:00:00,48,26,22,FMN GV 11 Ramsel
66,Bergstraat 71,2023-06-19,22:00:00,18,18,0,FMN GV 11 Ramsel
66,Bergstraat 71,2023-06-19,23:00:00,2,0,2,FMN GV 11 Ramsel
66,Bergstraat 71,2023-06-20,00:00:00,0,0,0,FMN GV 11 Ramsel
66,Bergstraat 71,2023-06-20,01:00:00,0,0,0,FMN GV 11 Ramsel
66,Bergstraat 71,2023-06-20,02:00:00,0,0,0,FMN GV 11 Ramsel
66,Bergstraat 71,2023-06-20,03:00:00,0,0,0,FMN GV 11 Ramsel
66,Bergstraat 71,2023-06-20,04:00:00,8,8,0,FMN GV 11 Ramsel
66,Bergstraat 71,2023-06-20,05:00:00,28,10,18,FMN GV 11 Ramsel
66,Bergstraat 71,2023-06-20,06:00:00,78,36,42,FMN GV 11 Ramsel
66,Bergstraat 71,2023-06-20,07:00:00,288,34,254,FMN GV 11 Ramsel
66,Bergstraat 71,2023-06-20,08:00:00,236,46,190,FMN GV 11 Ramsel
66,Bergstraat 71,2023-06-20,09:00:00,112,42,70,FMN GV 11 Ramsel
66,Bergstraat 71,2023-06-20,10:00:00,250,198,52,FMN GV 11 Ramsel
66,Bergstraat 71,2023-06-20,11:00:00,176,130,46,FMN GV 11 Ramsel
66,Bergstraat 71,2023-06-20,12:00:00,158,116,42,FMN GV 11 Ramsel
66,Bergstraat 71,2023-06-20,13:00:00,196,84,112,FMN GV 11 Ramsel
66,Bergstraat 71,2023-06-20,14:00:00,158,74,84,FMN GV 11 Ramsel
66,Bergstraat 71,2023-06-20,15:00:00,206,126,80,FMN GV 11 Ramsel
66,Bergstraat 71,2023-06-20,16:00:00,140,90,50,FMN GV 11 Ramsel
66,Bergstraat 71,2023-06-20,17:00:00,98,40,58,FMN GV 11 Ramsel
66,Bergstraat 71,2023-06-20,18:00:00,56,30,26,FMN GV 11 Ramsel
66,Bergstraat 71,2023-06-20,19:00:00,52,36,16,FMN GV 11 Ramsel
66,Bergstraat 71,2023-06-20,20:00:00,6,4,2,FMN GV 11 Ramsel
66,Bergstraat 71,2023-06-20,21:00:00,4,2,2,FMN GV 11 Ramsel
66,Bergstraat 71,2023-06-20,22:00:00,16,10,6,FMN GV 11 Ramsel
66,Bergstraat 71,2023-06-20,23:00:00,0,0,0,FMN GV 11 Ramsel
66,Bergstraat 71,2023-06-21,00:00:00,0,0,0,FMN GV 11 Ramsel
66,Bergstraat 71,2023-06-21,01:00:00,0,0,0,FMN GV 11 Ramsel
66,Bergstraat 71,2023-06-21,02:00:00,0,0,0,FMN GV 11 Ramsel
66,Bergstraat 71,2023-06-21,03:00:00,0,0,0,FMN GV 11 Ramsel
66,Bergstraat 71,2023-06-21,04:00:00,12,6,6,FMN GV 11 Ramsel
66,Bergstraat 71,2023-06-21,05:00:00,22,12,10,FMN GV 11 Ramsel
66,Bergstraat 71,2023-06-21,06:00:00,70,38,32,FMN GV 11 Ramsel
66,Bergstraat 71,2023-06-21,07:00:00,294,36,258,FMN GV 11 Ramsel
66,Bergstraat 71,2023-06-21,08:00:00,246,40,206,FMN GV 11 Ramsel
66,Bergstraat 71,2023-06-21,09:00:00,124,74,50,FMN GV 11 Ramsel
66,Bergstraat 71,2023-06-21,10:00:00,246,176,70,FMN GV 11 Ramsel
66,Bergstraat 71,2023-06-21,11:00:00,244,124,120,FMN GV 11 Ramsel
66,Bergstraat 71,2023-06-21,12:00:00,158,118,40,FMN GV 11 Ramsel
66,Bergstraat 71,2023-06-21,13:00:00,212,106,106,FMN GV 11 Ramsel
66,Bergstraat 71,2023-06-21,14:00:00,274,140,134,FMN GV 11 Ramsel
66,Bergstraat 71,2023-06-21,15:00:00,242,106,136,FMN GV 11 Ramsel
66,Bergstraat 71,2023-06-21,16:00:00,164,92,72,FMN GV 11 Ramsel
66,Bergstraat 71,2023-06-21,17:00:00,190,124,66,FMN GV 11 Ramsel
66,Bergstraat 71,2023-06-21,18:00:00,210,142,68,FMN GV 11 Ramsel
66,Bergstraat 71,2023-06-21,19:00:00,140,54,86,FMN GV 11 Ramsel
66,Bergstraat 71,2023-06-21,20:00:00,102,62,40,FMN GV 11 Ramsel
66,Bergstraat 71,2023-06-21,21:00:00,62,32,30,FMN GV 11 Ramsel
66,Bergstraat 71,2023-06-21,22:00:00,24,20,4,FMN GV 11 Ramsel
66,Bergstraat 71,2023-06-21,23:00:00,8,6,2,FMN GV 11 Ramsel
66,Bergstraat 71,2023-06-22,00:00:00,0,0,0,FMN GV 11 Ramsel
66,Bergstraat 71,2023-06-22,01:00:00,4,0,4,FMN GV 11 Ramsel
66,Bergstraat 71,2023-06-22,02:00:00,2,2,0,FMN GV 11 Ramsel
66,Bergstraat 71,2023-06-22,03:00:00,2,0,2,FMN GV 11 Ramsel
66,Bergstraat 71,2023-06-22,04:00:00,4,4,0,FMN GV 11 Ramsel
66,Bergstraat 71,2023-06-22,05:00:00,20,14,6,FMN GV 11 Ramsel
66,Bergstraat 71,2023-06-22,06:00:00,26,14,12,FMN GV 11 Ramsel
66,Bergstraat 71,2023-06-22,07:00:00,188,20,168,FMN GV 11 Ramsel
66,Bergstraat 71,2023-06-22,08:00:00,194,32,162,FMN GV 11 Ramsel
66,Bergstraat 71,2023-06-22,09:00:00,82,56,26,FMN GV 11 Ramsel
66,Bergstraat 71,2023-06-22,10:00:00,166,150,16,FMN GV 11 Ramsel
66,Bergstraat 71,2023-06-22,11:00:00,76,56,20,FMN GV 11 Ramsel
66,Bergstraat 71,2023-06-22,12:00:00,60,50,10,FMN GV 11 Ramsel
66,Bergstraat 71,2023-06-22,13:00:00,24,16,8,FMN GV 11 Ramsel
66,Bergstraat 71,2023-06-22,14:00:00,18,8,10,FMN GV 11 Ramsel
66,Bergstraat 71,2023-06-22,15:00:00,28,20,8,FMN GV 11 Ramsel
66,Bergstraat 71,2023-06-22,16:00:00,34,24,10,FMN GV 11 Ramsel
66,Bergstraat 71,2023-06-22,17:00:00,54,34,20,FMN GV 11 Ramsel
66,Bergstraat 71,2023-06-22,18:00:00,26,14,12,FMN GV 11 Ramsel
66,Bergstraat 71,2023-06-22,19:00:00,18,8,10,FMN GV 11 Ramsel
66,Bergstraat 71,2023-06-22,20:00:00,12,8,4,FMN GV 11 Ramsel
66,Bergstraat 71,2023-06-22,21:00:00,14,6,8,FMN GV 11 Ramsel
66,Bergstraat 71,2023-06-22,22:00:00,6,6,0,FMN GV 11 Ramsel
66,Bergstraat 71,2023-06-22,23:00:00,4,4,0,FMN GV 11 Ramsel
66,Bergstraat 71,2023-06-23,00:00:00,6,6,0,FMN GV 11 Ramsel
66,Bergstraat 71,2023-06-23,01:00:00,0,0,0,FMN GV 11 Ramsel
66,Bergstraat 71,2023-06-23,02:00:00,0,0,0,FMN GV 11 Ramsel
66,Bergstraat 71,2023-06-23,03:00:00,8,6,2,FMN GV 11 Ramsel
66,Bergstraat 71,2023-06-23,04:00:00,8,4,4,FMN GV 11 Ramsel
66,Bergstraat 71,2023-06-23,05:00:00,20,10,10,FMN GV 11 Ramsel
66,Bergstraat 71,2023-06-23,06:00:00,48,20,28,FMN GV 11 Ramsel
66,Bergstraat 71,2023-06-23,07:00:00,214,30,184,FMN GV 11 Ramsel
66,Bergstraat 71,2023-06-23,08:00:00,166,24,142,FMN GV 11 Ramsel
66,Bergstraat 71,2023-06-23,09:00:00,102,40,62,FMN GV 11 Ramsel
66,Bergstraat 71,2023-06-23,10:00:00,222,148,74,FMN GV 11 Ramsel
66,Bergstraat 71,2023-06-23,11:00:00,162,100,62,FMN GV 11 Ramsel
66,Bergstraat 71,2023-06-23,12:00:00,208,92,116,FMN GV 11 Ramsel
66,Bergstraat 71,2023-06-23,13:00:00,216,124,92,FMN GV 11 Ramsel
66,Bergstraat 71,2023-06-23,14:00:00,222,122,100,FMN GV 11 Ramsel
66,Bergstraat 71,2023-06-23,15:00:00,288,156,132,FMN GV 11 Ramsel
66,Bergstraat 71,2023-06-23,16:00:00,230,130,100,FMN GV 11 Ramsel
66,Bergstraat 71,2023-06-23,17:00:00,182,90,92,FMN GV 11 Ramsel
66,Bergstraat 71,2023-06-23,18:00:00,150,54,96,FMN GV 11 Ramsel
66,Bergstraat 71,2023-06-23,19:00:00,116,44,72,FMN GV 11 Ramsel
66,Bergstraat 71,2023-06-23,20:00:00,72,8,64,FMN GV 11 Ramsel
66,Bergstraat 71,2023-06-23,21:00:00,56,28,28,FMN GV 11 Ramsel
66,Bergstraat 71,2023-06-23,22:00:00,32,22,10,FMN GV 11 Ramsel
66,Bergstraat 71,2023-06-23,23:00:00,38,22,16,FMN GV 11 Ramsel
66,Bergstraat 71,2023-06-24,00:00:00,22,18,4,FMN GV 11 Ramsel
66,Bergstraat 71,2023-06-24,01:00:00,22,20,2,FMN GV 11 Ramsel
66,Bergstraat 71,2023-06-24,02:00:00,24,24,0,FMN GV 11 Ramsel
66,Bergstraat 71,2023-06-24,03:00:00,4,4,0,FMN GV 11 Ramsel
66,Bergstraat 71,2023-06-24,04:00:00,2,2,0,FMN GV 11 Ramsel
66,Bergstraat 71,2023-06-24,05:00:00,4,4,0,FMN GV 11 Ramsel
66,Bergstraat 71,2023-06-24,06:00:00,12,8,4,FMN GV 11 Ramsel
66,Bergstraat 71,2023-06-24,07:00:00,50,8,42,FMN GV 11 Ramsel
66,Bergstraat 71,2023-06-24,08:00:00,94,26,68,FMN GV 11 Ramsel
66,Bergstraat 71,2023-06-24,09:00:00,128,52,76,FMN GV 11 Ramsel
66,Bergstraat 71,2023-06-24,10:00:00,170,80,90,FMN GV 11 Ramsel
66,Bergstraat 71,2023-06-24,11:00:00,274,162,112,FMN GV 11 Ramsel
66,Bergstraat 71,2023-06-24,12:00:00,192,92,100,FMN GV 11 Ramsel
66,Bergstraat 71,2023-06-24,13:00:00,226,108,118,FMN GV 11 Ramsel
66,Bergstraat 71,2023-06-24,14:00:00,238,118,120,FMN GV 11 Ramsel
66,Bergstraat 71,2023-06-24,15:00:00,238,140,98,FMN GV 11 Ramsel
66,Bergstraat 71,2023-06-24,16:00:00,266,132,134,FMN GV 11 Ramsel
66,Bergstraat 71,2023-06-24,17:00:00,144,82,62,FMN GV 11 Ramsel
66,Bergstraat 71,2023-06-24,18:00:00,150,80,70,FMN GV 11 Ramsel
66,Bergstraat 71,2023-06-24,19:00:00,100,60,40,FMN GV 11 Ramsel
66,Bergstraat 71,2023-06-24,20:00:00,100,56,44,FMN GV 11 Ramsel
66,Bergstraat 71,2023-06-24,21:00:00,92,34,58,FMN GV 11 Ramsel
66,Bergstraat 71,2023-06-24,22:00:00,44,26,18,FMN GV 11 Ramsel
66,Bergstraat 71,2023-06-24,23:00:00,30,26,4,FMN GV 11 Ramsel
66,Bergstraat 71,2023-06-25,00:00:00,10,10,0,FMN GV 11 Ramsel
66,Bergstraat 71,2023-06-25,01:00:00,8,8,0,FMN GV 11 Ramsel
66,Bergstraat 71,2023-06-25,02:00:00,2,2,0,FMN GV 11 Ramsel
66,Bergstraat 71,2023-06-25,03:00:00,0,0,0,FMN GV 11 Ramsel
66,Bergstraat 71,2023-06-25,04:00:00,0,0,0,FMN GV 11 Ramsel
66,Bergstraat 71,2023-06-25,05:00:00,2,2,0,FMN GV 11 Ramsel
66,Bergstraat 71,2023-06-25,06:00:00,8,4,4,FMN GV 11 Ramsel
66,Bergstraat 71,2023-06-25,07:00:00,60,22,38,FMN GV 11 Ramsel
66,Bergstraat 71,2023-06-25,08:00:00,134,42,92,FMN GV 11 Ramsel
66,Bergstraat 71,2023-06-25,09:00:00,210,108,102,FMN GV 11 Ramsel
66,Bergstraat 71,2023-06-25,10:00:00,278,144,134,FMN GV 11 Ramsel
66,Bergstraat 71,2023-06-25,11:00:00,312,200,112,FMN GV 11 Ramsel
66,Bergstraat 71,2023-06-25,12:00:00,214,114,100,FMN GV 11 Ramsel
66,Bergstraat 71,2023-06-25,13:00:00,222,112,110,FMN GV 11 Ramsel
66,Bergstraat 71,2023-06-25,14:00:00,204,102,102,FMN GV 11 Ramsel
66,Bergstraat 71,2023-06-25,15:00:00,202,86,116,FMN GV 11 Ramsel
66,Bergstraat 71,2023-06-25,16:00:00,262,102,160,FMN GV 11 Ramsel
66,Bergstraat 71,2023-06-25,17:00:00,116,60,56,FMN GV 11 Ramsel
66,Bergstraat 71,2023-06-25,18:00:00,116,54,62,FMN GV 11 Ramsel
66,Bergstraat 71,2023-06-25,19:00:00,156,76,80,FMN GV 11 Ramsel
66,Bergstraat 71,2023-06-25,20:00:00,152,58,94,FMN GV 11 Ramsel
66,Bergstraat 71,2023-06-25,21:00:00,64,42,22,FMN GV 11 Ramsel
66,Bergstraat 71,2023-06-25,22:00:00,44,18,26,FMN GV 11 Ramsel
66,Bergstraat 71,2023-06-25,23:00:00,12,10,2,FMN GV 11 Ramsel
66,Bergstraat 71,2023-06-26,00:00:00,14,14,0,FMN GV 11 Ramsel
66,Bergstraat 71,2023-06-26,01:00:00,2,0,2,FMN GV 11 Ramsel
66,Bergstraat 71,2023-06-26,02:00:00,0,0,0,FMN GV 11 Ramsel
66,Bergstraat 71,2023-06-26,03:00:00,2,0,2,FMN GV 11 Ramsel
66,Bergstraat 71,2023-06-26,04:00:00,12,4,8,FMN GV 11 Ramsel
66,Bergstraat 71,2023-06-26,05:00:00,22,14,8,FMN GV 11 Ramsel
66,Bergstraat 71,2023-06-26,06:00:00,68,24,44,FMN GV 11 Ramsel
66,Bergstraat 71,2023-06-26,07:00:00,134,38,96,FMN GV 11 Ramsel
66,Bergstraat 71,2023-06-26,08:00:00,94,20,74,FMN GV 11 Ramsel
66,Bergstraat 71,2023-06-26,09:00:00,264,116,148,FMN GV 11 Ramsel
66,Bergstraat 71,2023-06-26,10:00:00,108,60,48,FMN GV 11 Ramsel
66,Bergstraat 71,2023-06-26,11:00:00,126,62,64,FMN GV 11 Ramsel
66,Bergstraat 71,2023-06-26,12:00:00,168,74,94,FMN GV 11 Ramsel
66,Bergstraat 71,2023-06-26,13:00:00,148,68,80,FMN GV 11 Ramsel
66,Bergstraat 71,2023-06-26,14:00:00,304,130,174,FMN GV 11 Ramsel
66,Bergstraat 71,2023-06-26,15:00:00,252,182,70,FMN GV 11 Ramsel
66,Bergstraat 71,2023-06-26,16:00:00,184,122,62,FMN GV 11 Ramsel
66,Bergstraat 71,2023-06-26,17:00:00,172,100,72,FMN GV 11 Ramsel
66,Bergstraat 71,2023-06-26,18:00:00,118,70,48,FMN GV 11 Ramsel
66,Bergstraat 71,2023-06-26,19:00:00,88,40,48,FMN GV 11 Ramsel
66,Bergstraat 71,2023-06-26,20:00:00,60,32,28,FMN GV 11 Ramsel
66,Bergstraat 71,2023-06-26,21:00:00,52,32,20,FMN GV 11 Ramsel
66,Bergstraat 71,2023-06-26,22:00:00,34,16,18,FMN GV 11 Ramsel
66,Bergstraat 71,2023-06-26,23:00:00,6,6,0,FMN GV 11 Ramsel
66,Bergstraat 71,2023-06-27,00:00:00,0,0,0,FMN GV 11 Ramsel
66,Bergstraat 71,2023-06-27,01:00:00,4,4,0,FMN GV 11 Ramsel
66,Bergstraat 71,2023-06-27,02:00:00,4,0,4,FMN GV 11 Ramsel
66,Bergstraat 71,2023-06-27,03:00:00,0,0,0,FMN GV 11 Ramsel
66,Bergstraat 71,2023-06-27,04:00:00,10,4,6,FMN GV 11 Ramsel
66,Bergstraat 71,2023-06-27,05:00:00,20,10,10,FMN GV 11 Ramsel
66,Bergstraat 71,2023-06-27,06:00:00,66,22,44,FMN GV 11 Ramsel
66,Bergstraat 71,2023-06-27,07:00:00,162,40,122,FMN GV 11 Ramsel
66,Bergstraat 71,2023-06-27,08:00:00,128,36,92,FMN GV 11 Ramsel
66,Bergstraat 71,2023-06-27,09:00:00,280,148,132,FMN GV 11 Ramsel
66,Bergstraat 71,2023-06-27,10:00:00,138,64,74,FMN GV 11 Ramsel
66,Bergstraat 71,2023-06-27,11:00:00,132,62,70,FMN GV 11 Ramsel
66,Bergstraat 71,2023-06-27,12:00:00,146,56,90,FMN GV 11 Ramsel
66,Bergstraat 71,2023-06-27,13:00:00,220,108,112,FMN GV 11 Ramsel
66,Bergstraat 71,2023-06-27,14:00:00,448,234,214,FMN GV 11 Ramsel
66,Bergstraat 71,2023-06-27,15:00:00,280,158,122,FMN GV 11 Ramsel
66,Bergstraat 71,2023-06-27,16:00:00,250,166,84,FMN GV 11 Ramsel
66,Bergstraat 71,2023-06-27,17:00:00,218,122,96,FMN GV 11 Ramsel
66,Bergstraat 71,2023-06-27,18:00:00,176,80,96,FMN GV 11 Ramsel
66,Bergstraat 71,2023-06-27,19:00:00,132,68,64,FMN GV 11 Ramsel
66,Bergstraat 71,2023-06-27,20:00:00,142,100,42,FMN GV 11 Ramsel
66,Bergstraat 71,2023-06-27,21:00:00,54,28,26,FMN GV 11 Ramsel
66,Bergstraat 71,2023-06-27,22:00:00,36,20,16,FMN GV 11 Ramsel
66,Bergstraat 71,2023-06-27,23:00:00,8,6,2,FMN GV 11 Ramsel
66,Bergstraat 71,2023-06-28,00:00:00,0,0,0,FMN GV 11 Ramsel
66,Bergstraat 71,2023-06-28,01:00:00,12,12,0,FMN GV 11 Ramsel
66,Bergstraat 71,2023-06-28,02:00:00,2,2,0,FMN GV 11 Ramsel
66,Bergstraat 71,2023-06-28,03:00:00,0,0,0,FMN GV 11 Ramsel
66,Bergstraat 71,2023-06-28,04:00:00,8,4,4,FMN GV 11 Ramsel
66,Bergstraat 71,2023-06-28,05:00:00,28,10,18,FMN GV 11 Ramsel
66,Bergstraat 71,2023-06-28,06:00:00,50,28,22,FMN GV 11 Ramsel
66,Bergstraat 71,2023-06-28,07:00:00,90,30,60,FMN GV 11 Ramsel
66,Bergstraat 71,2023-06-28,08:00:00,106,34,72,FMN GV 11 Ramsel
66,Bergstraat 71,2023-06-28,09:00:00,70,20,50,FMN GV 11 Ramsel
66,Bergstraat 71,2023-06-28,10:00:00,108,50,58,FMN GV 11 Ramsel
66,Bergstraat 71,2023-06-28,11:00:00,136,70,66,FMN GV 11 Ramsel
66,Bergstraat 71,2023-06-28,12:00:00,106,50,56,FMN GV 11 Ramsel
66,Bergstraat 71,2023-06-28,13:00:00,182,88,94,FMN GV 11 Ramsel
66,Bergstraat 71,2023-06-28,14:00:00,206,106,100,FMN GV 11 Ramsel
66,Bergstraat 71,2023-06-28,15:00:00,196,114,82,FMN GV 11 Ramsel
66,Bergstraat 71,2023-06-28,16:00:00,210,134,76,FMN GV 11 Ramsel
66,Bergstraat 71,2023-06-28,17:00:00,150,78,72,FMN GV 11 Ramsel
66,Bergstraat 71,2023-06-28,18:00:00,158,68,90,FMN GV 11 Ramsel
66,Bergstraat 71,2023-06-28,19:00:00,120,34,86,FMN GV 11 Ramsel
66,Bergstraat 71,2023-06-28,20:00:00,40,26,14,FMN GV 11 Ramsel
66,Bergstraat 71,2023-06-28,21:00:00,52,40,12,FMN GV 11 Ramsel
66,Bergstraat 71,2023-06-28,22:00:00,34,26,8,FMN GV 11 Ramsel
66,Bergstraat 71,2023-06-28,23:00:00,20,18,2,FMN GV 11 Ramsel
66,Bergstraat 71,2023-06-29,00:00:00,2,0,2,FMN GV 11 Ramsel
66,Bergstraat 71,2023-06-29,01:00:00,14,14,0,FMN GV 11 Ramsel
66,Bergstraat 71,2023-06-29,02:00:00,4,4,0,FMN GV 11 Ramsel
66,Bergstraat 71,2023-06-29,03:00:00,2,2,0,FMN GV 11 Ramsel
66,Bergstraat 71,2023-06-29,04:00:00,10,2,8,FMN GV 11 Ramsel
66,Bergstraat 71,2023-06-29,05:00:00,22,10,12,FMN GV 11 Ramsel
66,Bergstraat 71,2023-06-29,06:00:00,42,22,20,FMN GV 11 Ramsel
66,Bergstraat 71,2023-06-29,07:00:00,102,20,82,FMN GV 11 Ramsel
66,Bergstraat 71,2023-06-29,08:00:00,158,36,122,FMN GV 11 Ramsel
66,Bergstraat 71,2023-06-29,09:00:00,100,32,68,FMN GV 11 Ramsel
66,Bergstraat 71,2023-06-29,10:00:00,162,88,74,FMN GV 11 Ramsel
66,Bergstraat 71,2023-06-29,11:00:00,146,90,56,FMN GV 11 Ramsel
66,Bergstraat 71,2023-06-29,12:00:00,104,62,42,FMN GV 11 Ramsel
66,Bergstraat 71,2023-06-29,13:00:00,148,48,100,FMN GV 11 Ramsel
66,Bergstraat 71,2023-06-29,14:00:00,152,72,80,FMN GV 11 Ramsel
66,Bergstraat 71,2023-06-29,15:00:00,150,98,52,FMN GV 11 Ramsel
66,Bergstraat 71,2023-06-29,16:00:00,170,106,64,FMN GV 11 Ramsel
66,Bergstraat 71,2023-06-29,17:00:00,98,64,34,FMN GV 11 Ramsel
66,Bergstraat 71,2023-06-29,18:00:00,92,52,40,FMN GV 11 Ramsel
66,Bergstraat 71,2023-06-29,19:00:00,72,32,40,FMN GV 11 Ramsel
66,Bergstraat 71,2023-06-29,20:00:00,60,36,24,FMN GV 11 Ramsel
66,Bergstraat 71,2023-06-29,21:00:00,54,42,12,FMN GV 11 Ramsel
66,Bergstraat 71,2023-06-29,22:00:00,18,18,0,FMN GV 11 Ramsel
66,Bergstraat 71,2023-06-29,23:00:00,16,12,4,FMN GV 11 Ramsel
66,Bergstraat 71,2023-06-30,00:00:00,6,6,0,FMN GV 11 Ramsel
66,Bergstraat 71,2023-06-30,01:00:00,12,12,0,FMN GV 11 Ramsel
66,Bergstraat 71,2023-06-30,02:00:00,6,6,0,FMN GV 11 Ramsel
66,Bergstraat 71,2023-06-30,03:00:00,0,0,0,FMN GV 11 Ramsel
66,Bergstraat 71,2023-06-30,04:00:00,8,8,0,FMN GV 11 Ramsel
66,Bergstraat 71,2023-06-30,05:00:00,16,4,12,FMN GV 11 Ramsel
66,Bergstraat 71,2023-06-30,06:00:00,30,12,18,FMN GV 11 Ramsel
66,Bergstraat 71,2023-06-30,07:00:00,98,24,74,FMN GV 11 Ramsel
66,Bergstraat 71,2023-06-30,08:00:00,112,26,86,FMN GV 11 Ramsel
66,Bergstraat 71,2023-06-30,09:00:00,164,52,112,FMN GV 11 Ramsel
66,Bergstraat 71,2023-06-30,10:00:00,148,74,74,FMN GV 11 Ramsel
66,Bergstraat 71,2023-06-30,11:00:00,138,84,54,FMN GV 11 Ramsel
66,Bergstraat 71,2023-06-30,12:00:00,150,78,72,FMN GV 11 Ramsel
66,Bergstraat 71,2023-06-30,13:00:00,180,66,114,FMN GV 11 Ramsel
66,Bergstraat 71,2023-06-30,14:00:00,260,154,106,FMN GV 11 Ramsel
66,Bergstraat 71,2023-06-30,15:00:00,210,110,100,FMN GV 11 Ramsel
66,Bergstraat 71,2023-06-30,16:00:00,216,126,90,FMN GV 11 Ramsel
66,Bergstraat 71,2023-06-30,17:00:00,188,116,72,FMN GV 11 Ramsel
66,Bergstraat 71,2023-06-30,18:00:00,134,84,50,FMN GV 11 Ramsel
66,Bergstraat 71,2023-06-30,19:00:00,112,60,52,FMN GV 11 Ramsel
66,Bergstraat 71,2023-06-30,20:00:00,76,38,38,FMN GV 11 Ramsel
66,Bergstraat 71,2023-06-30,21:00:00,46,22,24,FMN GV 11 Ramsel
66,Bergstraat 71,2023-06-30,22:00:00,34,16,18,FMN GV 11 Ramsel
66,Bergstraat 71,2023-06-30,23:00:00,10,4,6,FMN GV 11 Ramsel
66,Bergstraat 71,2023-07-01,00:00:00,8,8,0,FMN GV 11 Ramsel
66,Bergstraat 71,2023-07-01,01:00:00,16,16,0,FMN GV 11 Ramsel
66,Bergstraat 71,2023-07-01,02:00:00,52,52,0,FMN GV 11 Ramsel
66,Bergstraat 71,2023-07-01,03:00:00,14,14,0,FMN GV 11 Ramsel
66,Bergstraat 71,2023-07-01,04:00:00,2,2,0,FMN GV 11 Ramsel
66,Bergstraat 71,2023-07-01,05:00:00,0,0,0,FMN GV 11 Ramsel
66,Bergstraat 71,2023-07-01,06:00:00,6,2,4,FMN GV 11 Ramsel
66,Bergstraat 71,2023-07-01,07:00:00,16,4,12,FMN GV 11 Ramsel
66,Bergstraat 71,2023-07-01,08:00:00,22,10,12,FMN GV 11 Ramsel
66,Bergstraat 71,2023-07-01,09:00:00,20,6,14,FMN GV 11 Ramsel
66,Bergstraat 71,2023-07-01,10:00:00,36,14,22,FMN GV 11 Ramsel
66,Bergstraat 71,2023-07-01,11:00:00,110,54,56,FMN GV 11 Ramsel
66,Bergstraat 71,2023-07-01,12:00:00,138,98,40,FMN GV 11 Ramsel
66,Bergstraat 71,2023-07-01,13:00:00,54,22,32,FMN GV 11 Ramsel
66,Bergstraat 71,2023-07-01,14:00:00,64,26,38,FMN GV 11 Ramsel
66,Bergstraat 71,2023-07-01,15:00:00,90,58,32,FMN GV 11 Ramsel
66,Bergstraat 71,2023-07-01,16:00:00,56,34,22,FMN GV 11 Ramsel
66,Bergstraat 71,2023-07-01,17:00:00,40,28,12,FMN GV 11 Ramsel
66,Bergstraat 71,2023-07-01,18:00:00,24,14,10,FMN GV 11 Ramsel
66,Bergstraat 71,2023-07-01,19:00:00,22,12,10,FMN GV 11 Ramsel
66,Bergstraat 71,2023-07-01,20:00:00,32,12,20,FMN GV 11 Ramsel
66,Bergstraat 71,2023-07-01,21:00:00,8,6,2,FMN GV 11 Ramsel
66,Bergstraat 71,2023-07-01,22:00:00,6,4,2,FMN GV 11 Ramsel
66,Bergstraat 71,2023-07-01,23:00:00,2,2,0,FMN GV 11 Ramsel
66,Bergstraat 71,2023-07-02,00:00:00,16,16,0,FMN GV 11 Ramsel
66,Bergstraat 71,2023-07-02,01:00:00,4,4,0,FMN GV 11 Ramsel
66,Bergstraat 71,2023-07-02,02:00:00,6,4,2,FMN GV 11 Ramsel
66,Bergstraat 71,2023-07-02,03:00:00,2,0,2,FMN GV 11 Ramsel
66,Bergstraat 71,2023-07-02,04:00:00,0,0,0,FMN GV 11 Ramsel
66,Bergstraat 71,2023-07-02,05:00:00,6,4,2,FMN GV 11 Ramsel
66,Bergstraat 71,2023-07-02,06:00:00,10,4,6,FMN GV 11 Ramsel
66,Bergstraat 71,2023-07-02,07:00:00,40,14,26,FMN GV 11 Ramsel
66,Bergstraat 71,2023-07-02,08:00:00,114,54,60,FMN GV 11 Ramsel
66,Bergstraat 71,2023-07-02,09:00:00,182,66,116,FMN GV 11 Ramsel
66,Bergstraat 71,2023-07-02,10:00:00,162,90,72,FMN GV 11 Ramsel
66,Bergstraat 71,2023-07-02,11:00:00,292,160,132,FMN GV 11 Ramsel
66,Bergstraat 71,2023-07-02,12:00:00,252,112,140,FMN GV 11 Ramsel
66,Bergstraat 71,2023-07-02,13:00:00,256,166,90,FMN GV 11 Ramsel
66,Bergstraat 71,2023-07-02,14:00:00,256,120,136,FMN GV 11 Ramsel
66,Bergstraat 71,2023-07-02,15:00:00,196,88,108,FMN GV 11 Ramsel
66,Bergstraat 71,2023-07-02,16:00:00,202,98,104,FMN GV 11 Ramsel
66,Bergstraat 71,2023-07-02,17:00:00,150,78,72,FMN GV 11 Ramsel
66,Bergstraat 71,2023-07-02,18:00:00,94,38,56,FMN GV 11 Ramsel
66,Bergstraat 71,2023-07-02,19:00:00,66,26,40,FMN GV 11 Ramsel
66,Bergstraat 71,2023-07-02,20:00:00,46,16,30,FMN GV 11 Ramsel
66,Bergstraat 71,2023-07-02,21:00:00,36,20,16,FMN GV 11 Ramsel
66,Bergstraat 71,2023-07-02,22:00:00,16,12,4,FMN GV 11 Ramsel
66,Bergstraat 71,2023-07-02,23:00:00,16,14,2,FMN GV 11 Ramsel
66,Bergstraat 71,2023-07-03,00:00:00,8,4,4,FMN GV 11 Ramsel
66,Bergstraat 71,2023-07-03,01:00:00,4,4,0,FMN GV 11 Ramsel
66,Bergstraat 71,2023-07-03,02:00:00,14,14,0,FMN GV 11 Ramsel
66,Bergstraat 71,2023-07-03,03:00:00,2,2,0,FMN GV 11 Ramsel
66,Bergstraat 71,2023-07-03,04:00:00,10,6,4,FMN GV 11 Ramsel
66,Bergstraat 71,2023-07-03,05:00:00,26,8,18,FMN GV 11 Ramsel
66,Bergstraat 71,2023-07-03,06:00:00,38,16,22,FMN GV 11 Ramsel
66,Bergstraat 71,2023-07-03,07:00:00,92,26,66,FMN GV 11 Ramsel
66,Bergstraat 71,2023-07-03,08:00:00,86,20,66,FMN GV 11 Ramsel
66,Bergstraat 71,2023-07-03,09:00:00,58,24,34,FMN GV 11 Ramsel
66,Bergstraat 71,2023-07-03,10:00:00,74,38,36,FMN GV 11 Ramsel
66,Bergstraat 71,2023-07-03,11:00:00,50,24,26,FMN GV 11 Ramsel
66,Bergstraat 71,2023-07-03,12:00:00,72,38,34,FMN GV 11 Ramsel
66,Bergstraat 71,2023-07-03,13:00:00,154,66,88,FMN GV 11 Ramsel
66,Bergstraat 71,2023-07-03,14:00:00,152,68,84,FMN GV 11 Ramsel
66,Bergstraat 71,2023-07-03,15:00:00,190,120,70,FMN GV 11 Ramsel
66,Bergstraat 71,2023-07-03,16:00:00,124,86,38,FMN GV 11 Ramsel
66,Bergstraat 71,2023-07-03,17:00:00,126,102,24,FMN GV 11 Ramsel
66,Bergstraat 71,2023-07-03,18:00:00,110,52,58,FMN GV 11 Ramsel
66,Bergstraat 71,2023-07-03,19:00:00,116,60,56,FMN GV 11 Ramsel
66,Bergstraat 71,2023-07-03,20:00:00,54,38,16,FMN GV 11 Ramsel
66,Bergstraat 71,2023-07-03,21:00:00,32,24,8,FMN GV 11 Ramsel
66,Bergstraat 71,2023-07-03,22:00:00,30,20,10,FMN GV 11 Ramsel
66,Bergstraat 71,2023-07-03,23:00:00,6,6,0,FMN GV 11 Ramsel
66,Bergstraat 71,2023-07-04,00:00:00,12,10,2,FMN GV 11 Ramsel
66,Bergstraat 71,2023-07-04,01:00:00,0,0,0,FMN GV 11 Ramsel
66,Bergstraat 71,2023-07-04,02:00:00,2,2,0,FMN GV 11 Ramsel
66,Bergstraat 71,2023-07-04,03:00:00,0,0,0,FMN GV 11 Ramsel
66,Bergstraat 71,2023-07-04,04:00:00,12,8,4,FMN GV 11 Ramsel
66,Bergstraat 71,2023-07-04,05:00:00,30,12,18,FMN GV 11 Ramsel
66,Bergstraat 71,2023-07-04,06:00:00,60,28,32,FMN GV 11 Ramsel
66,Bergstraat 71,2023-07-04,07:00:00,106,28,78,FMN GV 11 Ramsel
66,Bergstraat 71,2023-07-04,08:00:00,66,14,52,FMN GV 11 Ramsel
66,Bergstraat 71,2023-07-04,09:00:00,68,24,44,FMN GV 11 Ramsel
66,Bergstraat 71,2023-07-04,10:00:00,148,30,118,FMN GV 11 Ramsel
66,Bergstraat 71,2023-07-04,11:00:00,128,66,62,FMN GV 11 Ramsel
66,Bergstraat 71,2023-07-04,12:00:00,108,60,48,FMN GV 11 Ramsel
66,Bergstraat 71,2023-07-04,13:00:00,194,108,86,FMN GV 11 Ramsel
66,Bergstraat 71,2023-07-04,14:00:00,166,92,74,FMN GV 11 Ramsel
66,Bergstraat 71,2023-07-04,15:00:00,196,112,84,FMN GV 11 Ramsel
66,Bergstraat 71,2023-07-04,16:00:00,210,130,80,FMN GV 11 Ramsel
66,Bergstraat 71,2023-07-04,17:00:00,140,90,50,FMN GV 11 Ramsel
66,Bergstraat 71,2023-07-04,18:00:00,86,50,36,FMN GV 11 Ramsel
66,Bergstraat 71,2023-07-04,19:00:00,66,42,24,FMN GV 11 Ramsel
66,Bergstraat 71,2023-07-04,20:00:00,66,26,40,FMN GV 11 Ramsel
66,Bergstraat 71,2023-07-04,21:00:00,18,10,8,FMN GV 11 Ramsel
66,Bergstraat 71,2023-07-04,22:00:00,22,14,8,FMN GV 11 Ramsel
66,Bergstraat 71,2023-07-04,23:00:00,2,0,2,FMN GV 11 Ramsel
66,Bergstraat 71,2023-07-05,00:00:00,0,0,0,FMN GV 11 Ramsel
66,Bergstraat 71,2023-07-05,01:00:00,4,4,0,FMN GV 11 Ramsel
66,Bergstraat 71,2023-07-05,02:00:00,0,0,0,FMN GV 11 Ramsel
66,Bergstraat 71,2023-07-05,03:00:00,0,0,0,FMN GV 11 Ramsel
66,Bergstraat 71,2023-07-05,04:00:00,8,6,2,FMN GV 11 Ramsel
66,Bergstraat 71,2023-07-05,05:00:00,24,10,14,FMN GV 11 Ramsel
66,Bergstraat 71,2023-07-05,06:00:00,34,18,16,FMN GV 11 Ramsel
66,Bergstraat 71,2023-07-05,07:00:00,40,10,30,FMN GV 11 Ramsel
66,Bergstraat 71,2023-07-05,08:00:00,30,12,18,FMN GV 11 Ramsel
66,Bergstraat 71,2023-07-05,09:00:00,30,12,18,FMN GV 11 Ramsel
66,Bergstraat 71,2023-07-05,10:00:00,58,10,48,FMN GV 11 Ramsel
66,Bergstraat 71,2023-07-05,11:00:00,34,28,6,FMN GV 11 Ramsel
66,Bergstraat 71,2023-07-05,12:00:00,30,12,18,FMN GV 11 Ramsel
66,Bergstraat 71,2023-07-05,13:00:00,70,32,38,FMN GV 11 Ramsel
66,Bergstraat 71,2023-07-05,14:00:00,84,24,60,FMN GV 11 Ramsel
66,Bergstraat 71,2023-07-05,15:00:00,60,32,28,FMN GV 11 Ramsel
66,Bergstraat 71,2023-07-05,16:00:00,58,38,20,FMN GV 11 Ramsel
66,Bergstraat 71,2023-07-05,17:00:00,68,36,32,FMN GV 11 Ramsel
66,Bergstraat 71,2023-07-05,18:00:00,42,26,16,FMN GV 11 Ramsel
66,Bergstraat 71,2023-07-05,19:00:00,18,4,14,FMN GV 11 Ramsel
66,Bergstraat 71,2023-07-05,20:00:00,34,24,10,FMN GV 11 Ramsel
66,Bergstraat 71,2023-07-05,21:00:00,8,4,4,FMN GV 11 Ramsel
66,Bergstraat 71,2023-07-05,22:00:00,34,16,18,FMN GV 11 Ramsel
66,Bergstraat 71,2023-07-05,23:00:00,2,2,0,FMN GV 11 Ramsel
66,Bergstraat 71,2023-07-06,00:00:00,0,0,0,FMN GV 11 Ramsel
66,Bergstraat 71,2023-07-06,01:00:00,0,0,0,FMN GV 11 Ramsel
66,Bergstraat 71,2023-07-06,02:00:00,8,8,0,FMN GV 11 Ramsel
66,Bergstraat 71,2023-07-06,03:00:00,0,0,0,FMN GV 11 Ramsel
66,Bergstraat 71,2023-07-06,04:00:00,6,6,0,FMN GV 11 Ramsel
66,Bergstraat 71,2023-07-06,05:00:00,20,10,10,FMN GV 11 Ramsel
66,Bergstraat 71,2023-07-06,06:00:00,56,22,34,FMN GV 11 Ramsel
66,Bergstraat 71,2023-07-06,07:00:00,76,24,52,FMN GV 11 Ramsel
66,Bergstraat 71,2023-07-06,08:00:00,88,14,74,FMN GV 11 Ramsel
66,Bergstraat 71,2023-07-06,09:00:00,72,16,56,FMN GV 11 Ramsel
66,Bergstraat 71,2023-07-06,10:00:00,130,66,64,FMN GV 11 Ramsel
66,Bergstraat 71,2023-07-06,11:00:00,80,38,42,FMN GV 11 Ramsel
66,Bergstraat 71,2023-07-06,12:00:00,106,66,40,FMN GV 11 Ramsel
66,Bergstraat 71,2023-07-06,13:00:00,186,98,88,FMN GV 11 Ramsel
66,Bergstraat 71,2023-07-06,14:00:00,202,120,82,FMN GV 11 Ramsel
66,Bergstraat 71,2023-07-06,15:00:00,138,74,64,FMN GV 11 Ramsel
66,Bergstraat 71,2023-07-06,16:00:00,202,136,66,FMN GV 11 Ramsel
66,Bergstraat 71,2023-07-06,17:00:00,144,74,70,FMN GV 11 Ramsel
66,Bergstraat 71,2023-07-06,18:00:00,112,48,64,FMN GV 11 Ramsel
66,Bergstraat 71,2023-07-06,19:00:00,138,76,62,FMN GV 11 Ramsel
66,Bergstraat 71,2023-07-06,20:00:00,102,60,42,FMN GV 11 Ramsel
66,Bergstraat 71,2023-07-06,21:00:00,32,22,10,FMN GV 11 Ramsel
66,Bergstraat 71,2023-07-06,22:00:00,30,20,10,FMN GV 11 Ramsel
66,Bergstraat 71,2023-07-06,23:00:00,18,16,2,FMN GV 11 Ramsel
66,Bergstraat 71,2023-07-07,00:00:00,8,8,0,FMN GV 11 Ramsel
66,Bergstraat 71,2023-07-07,01:00:00,8,4,4,FMN GV 11 Ramsel
66,Bergstraat 71,2023-07-07,02:00:00,0,0,0,FMN GV 11 Ramsel
66,Bergstraat 71,2023-07-07,03:00:00,0,0,0,FMN GV 11 Ramsel
66,Bergstraat 71,2023-07-07,04:00:00,8,6,2,FMN GV 11 Ramsel
66,Bergstraat 71,2023-07-07,05:00:00,28,10,18,FMN GV 11 Ramsel
66,Bergstraat 71,2023-07-07,06:00:00,36,16,20,FMN GV 11 Ramsel
66,Bergstraat 71,2023-07-07,07:00:00,84,32,52,FMN GV 11 Ramsel
66,Bergstraat 71,2023-07-07,08:00:00,86,20,66,FMN GV 11 Ramsel
66,Bergstraat 71,2023-07-07,09:00:00,130,40,90,FMN GV 11 Ramsel
66,Bergstraat 71,2023-07-07,10:00:00,148,78,70,FMN GV 11 Ramsel
66,Bergstraat 71,2023-07-07,11:00:00,144,78,66,FMN GV 11 Ramsel
66,Bergstraat 71,2023-07-07,12:00:00,148,62,86,FMN GV 11 Ramsel
66,Bergstraat 71,2023-07-07,13:00:00,218,90,128,FMN GV 11 Ramsel
66,Bergstraat 71,2023-07-07,14:00:00,280,142,138,FMN GV 11 Ramsel
66,Bergstraat 71,2023-07-07,15:00:00,250,148,102,FMN GV 11 Ramsel
66,Bergstraat 71,2023-07-07,16:00:00,184,122,62,FMN GV 11 Ramsel
66,Bergstraat 71,2023-07-07,17:00:00,226,140,86,FMN GV 11 Ramsel
66,Bergstraat 71,2023-07-07,18:00:00,138,86,52,FMN GV 11 Ramsel
66,Bergstraat 71,2023-07-07,19:00:00,140,64,76,FMN GV 11 Ramsel
66,Bergstraat 71,2023-07-07,20:00:00,150,78,72,FMN GV 11 Ramsel
66,Bergstraat 71,2023-07-07,21:00:00,66,42,24,FMN GV 11 Ramsel
66,Bergstraat 71,2023-07-07,22:00:00,40,28,12,FMN GV 11 Ramsel
66,Bergstraat 71,2023-07-07,23:00:00,36,26,10,FMN GV 11 Ramsel
66,Bergstraat 71,2023-07-08,00:00:00,18,16,2,FMN GV 11 Ramsel
66,Bergstraat 71,2023-07-08,01:00:00,12,10,2,FMN GV 11 Ramsel
66,Bergstraat 71,2023-07-08,02:00:00,4,4,0,FMN GV 11 Ramsel
66,Bergstraat 71,2023-07-08,03:00:00,2,2,0,FMN GV 11 Ramsel
66,Bergstraat 71,2023-07-08,04:00:00,4,2,2,FMN GV 11 Ramsel
66,Bergstraat 71,2023-07-08,05:00:00,8,6,2,FMN GV 11 Ramsel
66,Bergstraat 71,2023-07-08,06:00:00,14,4,10,FMN GV 11 Ramsel
66,Bergstraat 71,2023-07-08,07:00:00,40,16,24,FMN GV 11 Ramsel
66,Bergstraat 71,2023-07-08,08:00:00,88,30,58,FMN GV 11 Ramsel
66,Bergstraat 71,2023-07-08,09:00:00,188,52,136,FMN GV 11 Ramsel
66,Bergstraat 71,2023-07-08,10:00:00,220,100,120,FMN GV 11 Ramsel
66,Bergstraat 71,2023-07-08,11:00:00,278,166,112,FMN GV 11 Ramsel
66,Bergstraat 71,2023-07-08,12:00:00,162,88,74,FMN GV 11 Ramsel
66,Bergstraat 71,2023-07-08,13:00:00,238,100,138,FMN GV 11 Ramsel
66,Bergstraat 71,2023-07-08,14:00:00,246,142,104,FMN GV 11 Ramsel
66,Bergstraat 71,2023-07-08,15:00:00,224,160,64,FMN GV 11 Ramsel
66,Bergstraat 71,2023-07-08,16:00:00,78,48,30,FMN GV 11 Ramsel
66,Bergstraat 71,2023-07-08,17:00:00,130,76,54,FMN GV 11 Ramsel
66,Bergstraat 71,2023-07-08,18:00:00,76,48,28,FMN GV 11 Ramsel
66,Bergstraat 71,2023-07-08,19:00:00,182,92,90,FMN GV 11 Ramsel
66,Bergstraat 71,2023-07-08,20:00:00,126,48,78,FMN GV 11 Ramsel
66,Bergstraat 71,2023-07-08,21:00:00,86,46,40,FMN GV 11 Ramsel
66,Bergstraat 71,2023-07-08,22:00:00,52,30,22,FMN GV 11 Ramsel
66,Bergstraat 71,2023-07-08,23:00:00,88,66,22,FMN GV 11 Ramsel
66,Bergstraat 71,2023-07-09,00:00:00,12,12,0,FMN GV 11 Ramsel
66,Bergstraat 71,2023-07-09,01:00:00,8,8,0,FMN GV 11 Ramsel
66,Bergstraat 71,2023-07-09,02:00:00,22,18,4,FMN GV 11 Ramsel
66,Bergstraat 71,2023-07-09,03:00:00,10,6,4,FMN GV 11 Ramsel
66,Bergstraat 71,2023-07-09,04:00:00,6,4,2,FMN GV 11 Ramsel
66,Bergstraat 71,2023-07-09,05:00:00,14,8,6,FMN GV 11 Ramsel
66,Bergstraat 71,2023-07-09,06:00:00,12,4,8,FMN GV 11 Ramsel
66,Bergstraat 71,2023-07-09,07:00:00,58,18,40,FMN GV 11 Ramsel
66,Bergstraat 71,2023-07-09,08:00:00,116,54,62,FMN GV 11 Ramsel
66,Bergstraat 71,2023-07-09,09:00:00,208,82,126,FMN GV 11 Ramsel
66,Bergstraat 71,2023-07-09,10:00:00,318,156,162,FMN GV 11 Ramsel
66,Bergstraat 71,2023-07-09,11:00:00,338,148,190,FMN GV 11 Ramsel
66,Bergstraat 71,2023-07-09,12:00:00,186,108,78,FMN GV 11 Ramsel
66,Bergstraat 71,2023-07-09,13:00:00,206,84,122,FMN GV 11 Ramsel
66,Bergstraat 71,2023-07-09,14:00:00,72,48,24,FMN GV 11 Ramsel
66,Bergstraat 71,2023-07-09,15:00:00,18,14,4,FMN GV 11 Ramsel
66,Bergstraat 71,2023-07-09,16:00:00,30,18,12,FMN GV 11 Ramsel
66,Bergstraat 71,2023-07-09,17:00:00,66,32,34,FMN GV 11 Ramsel
66,Bergstraat 71,2023-07-09,18:00:00,100,42,58,FMN GV 11 Ramsel
66,Bergstraat 71,2023-07-09,19:00:00,78,24,54,FMN GV 11 Ramsel
66,Bergstraat 71,2023-07-09,20:00:00,42,26,16,FMN GV 11 Ramsel
66,Bergstraat 71,2023-07-09,21:00:00,36,14,22,FMN GV 11 Ramsel
66,Bergstraat 71,2023-07-09,22:00:00,22,16,6,FMN GV 11 Ramsel
66,Bergstraat 71,2023-07-09,23:00:00,14,8,6,FMN GV 11 Ramsel
66,Bergstraat 71,2023-07-10,00:00:00,6,6,0,FMN GV 11 Ramsel
66,Bergstraat 71,2023-07-10,01:00:00,0,0,0,FMN GV 11 Ramsel
66,Bergstraat 71,2023-07-10,02:00:00,10,8,2,FMN GV 11 Ramsel
66,Bergstraat 71,2023-07-10,03:00:00,4,4,0,FMN GV 11 Ramsel
66,Bergstraat 71,2023-07-10,04:00:00,6,4,2,FMN GV 11 Ramsel
66,Bergstraat 71,2023-07-10,05:00:00,16,8,8,FMN GV 11 Ramsel
66,Bergstraat 71,2023-07-10,06:00:00,30,14,16,FMN GV 11 Ramsel
66,Bergstraat 71,2023-07-10,07:00:00,68,18,50,FMN GV 11 Ramsel
66,Bergstraat 71,2023-07-10,08:00:00,90,30,60,FMN GV 11 Ramsel
66,Bergstraat 71,2023-07-10,09:00:00,72,36,36,FMN GV 11 Ramsel
66,Bergstraat 71,2023-07-10,10:00:00,116,44,72,FMN GV 11 Ramsel
66,Bergstraat 71,2023-07-10,11:00:00,84,48,36,FMN GV 11 Ramsel
66,Bergstraat 71,2023-07-10,12:00:00,142,94,48,FMN GV 11 Ramsel
66,Bergstraat 71,2023-07-10,13:00:00,202,124,78,FMN GV 11 Ramsel
66,Bergstraat 71,2023-07-10,14:00:00,216,100,116,FMN GV 11 Ramsel
66,Bergstraat 71,2023-07-10,15:00:00,226,140,86,FMN GV 11 Ramsel
66,Bergstraat 71,2023-07-10,16:00:00,214,120,94,FMN GV 11 Ramsel
66,Bergstraat 71,2023-07-10,17:00:00,166,96,70,FMN GV 11 Ramsel
66,Bergstraat 71,2023-07-10,18:00:00,156,82,74,FMN GV 11 Ramsel
66,Bergstraat 71,2023-07-10,19:00:00,138,66,72,FMN GV 11 Ramsel
66,Bergstraat 71,2023-07-10,20:00:00,96,50,46,FMN GV 11 Ramsel
66,Bergstraat 71,2023-07-10,21:00:00,32,18,14,FMN GV 11 Ramsel
66,Bergstraat 71,2023-07-10,22:00:00,32,22,10,FMN GV 11 Ramsel
66,Bergstraat 71,2023-07-10,23:00:00,18,12,6,FMN GV 11 Ramsel
66,Bergstraat 71,2023-07-11,00:00:00,4,2,2,FMN GV 11 Ramsel
66,Bergstraat 71,2023-07-11,01:00:00,4,0,4,FMN GV 11 Ramsel
66,Bergstraat 71,2023-07-11,02:00:00,0,0,0,FMN GV 11 Ramsel
66,Bergstraat 71,2023-07-11,03:00:00,6,4,2,FMN GV 11 Ramsel
66,Bergstraat 71,2023-07-11,04:00:00,12,6,6,FMN GV 11 Ramsel
66,Bergstraat 71,2023-07-11,05:00:00,18,10,8,FMN GV 11 Ramsel
66,Bergstraat 71,2023-07-11,06:00:00,50,18,32,FMN GV 11 Ramsel
66,Bergstraat 71,2023-07-11,07:00:00,68,26,42,FMN GV 11 Ramsel
66,Bergstraat 71,2023-07-11,08:00:00,104,38,66,FMN GV 11 Ramsel
66,Bergstraat 71,2023-07-11,09:00:00,110,42,68,FMN GV 11 Ramsel
66,Bergstraat 71,2023-07-11,10:00:00,200,70,130,FMN GV 11 Ramsel
66,Bergstraat 71,2023-07-11,11:00:00,176,94,82,FMN GV 11 Ramsel
66,Bergstraat 71,2023-07-11,12:00:00,206,54,152,FMN GV 11 Ramsel
66,Bergstraat 71,2023-07-11,13:00:00,272,138,134,FMN GV 11 Ramsel
66,Bergstraat 71,2023-07-11,14:00:00,220,134,86,FMN GV 11 Ramsel
66,Bergstraat 71,2023-07-11,15:00:00,232,150,82,FMN GV 11 Ramsel
66,Bergstraat 71,2023-07-11,16:00:00,184,100,84,FMN GV 11 Ramsel
66,Bergstraat 71,2023-07-11,17:00:00,148,88,60,FMN GV 11 Ramsel
66,Bergstraat 71,2023-07-11,18:00:00,138,64,74,FMN GV 11 Ramsel
66,Bergstraat 71,2023-07-11,19:00:00,154,88,66,FMN GV 11 Ramsel
66,Bergstraat 71,2023-07-11,20:00:00,108,72,36,FMN GV 11 Ramsel
66,Bergstraat 71,2023-07-11,21:00:00,64,22,42,FMN GV 11 Ramsel
66,Bergstraat 71,2023-07-11,22:00:00,16,14,2,FMN GV 11 Ramsel
66,Bergstraat 71,2023-07-11,23:00:00,14,12,2,FMN GV 11 Ramsel
66,Bergstraat 71,2023-07-12,00:00:00,0,0,0,FMN GV 11 Ramsel
66,Bergstraat 71,2023-07-12,01:00:00,0,0,0,FMN GV 11 Ramsel
66,Bergstraat 71,2023-07-12,02:00:00,0,0,0,FMN GV 11 Ramsel
66,Bergstraat 71,2023-07-12,03:00:00,0,0,0,FMN GV 11 Ramsel
66,Bergstraat 71,2023-07-12,04:00:00,2,2,0,FMN GV 11 Ramsel
66,Bergstraat 71,2023-07-12,05:00:00,24,8,16,FMN GV 11 Ramsel
66,Bergstraat 71,2023-07-12,06:00:00,54,26,28,FMN GV 11 Ramsel
66,Bergstraat 71,2023-07-12,07:00:00,66,22,44,FMN GV 11 Ramsel
66,Bergstraat 71,2023-07-12,08:00:00,60,20,40,FMN GV 11 Ramsel
66,Bergstraat 71,2023-07-12,09:00:00,66,22,44,FMN GV 11 Ramsel
66,Bergstraat 71,2023-07-12,10:00:00,162,110,52,FMN GV 11 Ramsel
66,Bergstraat 71,2023-07-12,11:00:00,70,26,44,FMN GV 11 Ramsel
66,Bergstraat 71,2023-07-12,12:00:00,82,40,42,FMN GV 11 Ramsel
66,Bergstraat 71,2023-07-12,13:00:00,130,52,78,FMN GV 11 Ramsel
66,Bergstraat 71,2023-07-12,14:00:00,184,84,100,FMN GV 11 Ramsel
66,Bergstraat 71,2023-07-12,15:00:00,172,100,72,FMN GV 11 Ramsel
66,Bergstraat 71,2023-07-12,16:00:00,180,128,52,FMN GV 11 Ramsel
66,Bergstraat 71,2023-07-12,17:00:00,150,110,40,FMN GV 11 Ramsel
66,Bergstraat 71,2023-07-12,18:00:00,108,58,50,FMN GV 11 Ramsel
66,Bergstraat 71,2023-07-12,19:00:00,106,36,70,FMN GV 11 Ramsel
66,Bergstraat 71,2023-07-12,20:00:00,132,44,88,FMN GV 11 Ramsel
66,Bergstraat 71,2023-07-12,21:00:00,58,22,36,FMN GV 11 Ramsel
66,Bergstraat 71,2023-07-12,22:00:00,24,8,16,FMN GV 11 Ramsel
66,Bergstraat 71,2023-07-12,23:00:00,12,8,4,FMN GV 11 Ramsel
66,Bergstraat 71,2023-07-13,00:00:00,0,0,0,FMN GV 11 Ramsel
66,Bergstraat 71,2023-07-13,01:00:00,0,0,0,FMN GV 11 Ramsel
66,Bergstraat 71,2023-07-13,02:00:00,2,2,0,FMN GV 11 Ramsel
66,Bergstraat 71,2023-07-13,03:00:00,0,0,0,FMN GV 11 Ramsel
66,Bergstraat 71,2023-07-13,04:00:00,12,8,4,FMN GV 11 Ramsel
66,Bergstraat 71,2023-07-13,05:00:00,18,10,8,FMN GV 11 Ramsel
66,Bergstraat 71,2023-07-13,06:00:00,38,16,22,FMN GV 11 Ramsel
66,Bergstraat 71,2023-07-13,07:00:00,70,18,52,FMN GV 11 Ramsel
66,Bergstraat 71,2023-07-13,08:00:00,58,20,38,FMN GV 11 Ramsel
66,Bergstraat 71,2023-07-13,09:00:00,102,20,82,FMN GV 11 Ramsel
66,Bergstraat 71,2023-07-13,10:00:00,134,60,74,FMN GV 11 Ramsel
66,Bergstraat 71,2023-07-13,11:00:00,118,56,62,FMN GV 11 Ramsel
66,Bergstraat 71,2023-07-13,12:00:00,86,52,34,FMN GV 11 Ramsel
66,Bergstraat 71,2023-07-13,13:00:00,184,96,88,FMN GV 11 Ramsel
66,Bergstraat 71,2023-07-13,14:00:00,146,96,50,FMN GV 11 Ramsel
66,Bergstraat 71,2023-07-13,15:00:00,84,40,44,FMN GV 11 Ramsel
66,Bergstraat 71,2023-07-13,16:00:00,102,50,52,FMN GV 11 Ramsel
66,Bergstraat 71,2023-07-13,17:00:00,70,48,22,FMN GV 11 Ramsel
66,Bergstraat 71,2023-07-13,18:00:00,88,46,42,FMN GV 11 Ramsel
66,Bergstraat 71,2023-07-13,19:00:00,106,48,58,FMN GV 11 Ramsel
66,Bergstraat 71,2023-07-13,20:00:00,88,66,22,FMN GV 11 Ramsel
66,Bergstraat 71,2023-07-13,21:00:00,44,22,22,FMN GV 11 Ramsel
66,Bergstraat 71,2023-07-13,22:00:00,22,20,2,FMN GV 11 Ramsel
66,Bergstraat 71,2023-07-13,23:00:00,14,14,0,FMN GV 11 Ramsel
66,Bergstraat 71,2023-07-14,00:00:00,0,0,0,FMN GV 11 Ramsel
66,Bergstraat 71,2023-07-14,01:00:00,4,0,4,FMN GV 11 Ramsel
66,Bergstraat 71,2023-07-14,02:00:00,6,2,4,FMN GV 11 Ramsel
66,Bergstraat 71,2023-07-14,03:00:00,0,0,0,FMN GV 11 Ramsel
66,Bergstraat 71,2023-07-14,04:00:00,6,2,4,FMN GV 11 Ramsel
66,Bergstraat 71,2023-07-14,05:00:00,16,10,6,FMN GV 11 Ramsel
66,Bergstraat 71,2023-07-14,06:00:00,34,14,20,FMN GV 11 Ramsel
66,Bergstraat 71,2023-07-14,07:00:00,64,16,48,FMN GV 11 Ramsel
66,Bergstraat 71,2023-07-14,08:00:00,90,32,58,FMN GV 11 Ramsel
66,Bergstraat 71,2023-07-14,09:00:00,90,28,62,FMN GV 11 Ramsel
66,Bergstraat 71,2023-07-14,10:00:00,110,42,68,FMN GV 11 Ramsel
66,Bergstraat 71,2023-07-14,11:00:00,186,66,120,FMN GV 11 Ramsel
66,Bergstraat 71,2023-07-14,12:00:00,160,76,84,FMN GV 11 Ramsel
66,Bergstraat 71,2023-07-14,13:00:00,162,82,80,FMN GV 11 Ramsel
66,Bergstraat 71,2023-07-14,14:00:00,262,122,140,FMN GV 11 Ramsel
66,Bergstraat 71,2023-07-14,15:00:00,242,120,122,FMN GV 11 Ramsel
66,Bergstraat 71,2023-07-14,16:00:00,152,84,68,FMN GV 11 Ramsel
66,Bergstraat 71,2023-07-14,17:00:00,164,92,72,FMN GV 11 Ramsel
66,Bergstraat 71,2023-07-14,18:00:00,92,52,40,FMN GV 11 Ramsel
66,Bergstraat 71,2023-07-14,19:00:00,92,50,42,FMN GV 11 Ramsel
66,Bergstraat 71,2023-07-14,20:00:00,90,44,46,FMN GV 11 Ramsel
66,Bergstraat 71,2023-07-14,21:00:00,18,10,8,FMN GV 11 Ramsel
66,Bergstraat 71,2023-07-14,22:00:00,30,16,14,FMN GV 11 Ramsel
66,Bergstraat 71,2023-07-14,23:00:00,10,6,4,FMN GV 11 Ramsel
66,Bergstraat 71,2023-07-15,00:00:00,6,6,0,FMN GV 11 Ramsel
66,Bergstraat 71,2023-07-15,01:00:00,2,2,0,FMN GV 11 Ramsel
66,Bergstraat 71,2023-07-15,02:00:00,4,4,0,FMN GV 11 Ramsel
66,Bergstraat 71,2023-07-15,03:00:00,2,2,0,FMN GV 11 Ramsel
66,Bergstraat 71,2023-07-15,04:00:00,0,0,0,FMN GV 11 Ramsel
66,Bergstraat 71,2023-07-15,05:00:00,0,0,0,FMN GV 11 Ramsel
66,Bergstraat 71,2023-07-15,06:00:00,10,8,2,FMN GV 11 Ramsel
66,Bergstraat 71,2023-07-15,07:00:00,20,8,12,FMN GV 11 Ramsel
66,Bergstraat 71,2023-07-15,08:00:00,52,16,36,FMN GV 11 Ramsel
66,Bergstraat 71,2023-07-15,09:00:00,82,24,58,FMN GV 11 Ramsel
66,Bergstraat 71,2023-07-15,10:00:00,138,64,74,FMN GV 11 Ramsel
66,Bergstraat 71,2023-07-15,11:00:00,108,56,52,FMN GV 11 Ramsel
66,Bergstraat 71,2023-07-15,12:00:00,68,32,36,FMN GV 11 Ramsel
66,Bergstraat 71,2023-07-15,13:00:00,132,62,70,FMN GV 11 Ramsel
66,Bergstraat 71,2023-07-15,14:00:00,114,42,72,FMN GV 11 Ramsel
66,Bergstraat 71,2023-07-15,15:00:00,156,64,92,FMN GV 11 Ramsel
66,Bergstraat 71,2023-07-15,16:00:00,106,54,52,FMN GV 11 Ramsel
66,Bergstraat 71,2023-07-15,17:00:00,66,42,24,FMN GV 11 Ramsel
66,Bergstraat 71,2023-07-15,18:00:00,42,24,18,FMN GV 11 Ramsel
66,Bergstraat 71,2023-07-15,19:00:00,16,10,6,FMN GV 11 Ramsel
66,Bergstraat 71,2023-07-15,20:00:00,32,30,2,FMN GV 11 Ramsel
66,Bergstraat 71,2023-07-15,21:00:00,28,8,20,FMN GV 11 Ramsel
66,Bergstraat 71,2023-07-15,22:00:00,12,2,10,FMN GV 11 Ramsel
66,Bergstraat 71,2023-07-15,23:00:00,10,4,6,FMN GV 11 Ramsel
66,Bergstraat 71,2023-07-16,00:00:00,2,2,0,FMN GV 11 Ramsel
66,Bergstraat 71,2023-07-16,01:00:00,8,6,2,FMN GV 11 Ramsel
66,Bergstraat 71,2023-07-16,02:00:00,2,2,0,FMN GV 11 Ramsel
66,Bergstraat 71,2023-07-16,03:00:00,0,0,0,FMN GV 11 Ramsel
66,Bergstraat 71,2023-07-16,04:00:00,4,2,2,FMN GV 11 Ramsel
66,Bergstraat 71,2023-07-16,05:00:00,0,0,0,FMN GV 11 Ramsel
66,Bergstraat 71,2023-07-16,06:00:00,8,4,4,FMN GV 11 Ramsel
66,Bergstraat 71,2023-07-16,07:00:00,28,10,18,FMN GV 11 Ramsel
66,Bergstraat 71,2023-07-16,08:00:00,106,14,92,FMN GV 11 Ramsel
66,Bergstraat 71,2023-07-16,09:00:00,148,40,108,FMN GV 11 Ramsel
66,Bergstraat 71,2023-07-16,10:00:00,238,132,106,FMN GV 11 Ramsel
66,Bergstraat 71,2023-07-16,11:00:00,316,212,104,FMN GV 11 Ramsel
66,Bergstraat 71,2023-07-16,12:00:00,130,72,58,FMN GV 11 Ramsel
66,Bergstraat 71,2023-07-16,13:00:00,200,130,70,FMN GV 11 Ramsel
66,Bergstraat 71,2023-07-16,14:00:00,128,52,76,FMN GV 11 Ramsel
66,Bergstraat 71,2023-07-16,15:00:00,170,116,54,FMN GV 11 Ramsel
66,Bergstraat 71,2023-07-16,16:00:00,92,60,32,FMN GV 11 Ramsel
66,Bergstraat 71,2023-07-16,17:00:00,76,32,44,FMN GV 11 Ramsel
66,Bergstraat 71,2023-07-16,18:00:00,68,20,48,FMN GV 11 Ramsel
66,Bergstraat 71,2023-07-16,19:00:00,40,16,24,FMN GV 11 Ramsel
66,Bergstraat 71,2023-07-16,20:00:00,22,20,2,FMN GV 11 Ramsel
66,Bergstraat 71,2023-07-16,21:00:00,26,14,12,FMN GV 11 Ramsel
66,Bergstraat 71,2023-07-16,22:00:00,8,4,4,FMN GV 11 Ramsel
66,Bergstraat 71,2023-07-16,23:00:00,10,10,0,FMN GV 11 Ramsel
66,Bergstraat 71,2023-07-17,00:00:00,2,2,0,FMN GV 11 Ramsel
66,Bergstraat 71,2023-07-17,01:00:00,2,0,2,FMN GV 11 Ramsel
66,Bergstraat 71,2023-07-17,02:00:00,0,0,0,FMN GV 11 Ramsel
66,Bergstraat 71,2023-07-17,03:00:00,2,0,2,FMN GV 11 Ramsel
66,Bergstraat 71,2023-07-17,04:00:00,4,2,2,FMN GV 11 Ramsel
66,Bergstraat 71,2023-07-17,05:00:00,12,10,2,FMN GV 11 Ramsel
66,Bergstraat 71,2023-07-17,06:00:00,42,18,24,FMN GV 11 Ramsel
66,Bergstraat 71,2023-07-17,07:00:00,60,14,46,FMN GV 11 Ramsel
66,Bergstraat 71,2023-07-17,08:00:00,70,12,58,FMN GV 11 Ramsel
66,Bergstraat 71,2023-07-17,09:00:00,64,26,38,FMN GV 11 Ramsel
66,Bergstraat 71,2023-07-17,10:00:00,76,22,54,FMN GV 11 Ramsel
66,Bergstraat 71,2023-07-17,11:00:00,104,80,24,FMN GV 11 Ramsel
66,Bergstraat 71,2023-07-17,12:00:00,96,42,54,FMN GV 11 Ramsel
66,Bergstraat 71,2023-07-17,13:00:00,212,96,116,FMN GV 11 Ramsel
66,Bergstraat 71,2023-07-17,14:00:00,108,62,46,FMN GV 11 Ramsel
66,Bergstraat 71,2023-07-17,15:00:00,104,70,34,FMN GV 11 Ramsel
66,Bergstraat 71,2023-07-17,16:00:00,138,68,70,FMN GV 11 Ramsel
66,Bergstraat 71,2023-07-17,17:00:00,102,58,44,FMN GV 11 Ramsel
66,Bergstraat 71,2023-07-17,18:00:00,86,58,28,FMN GV 11 Ramsel
66,Bergstraat 71,2023-07-17,19:00:00,42,26,16,FMN GV 11 Ramsel
66,Bergstraat 71,2023-07-17,20:00:00,60,38,22,FMN GV 11 Ramsel
66,Bergstraat 71,2023-07-17,21:00:00,42,28,14,FMN GV 11 Ramsel
66,Bergstraat 71,2023-07-17,22:00:00,26,16,10,FMN GV 11 Ramsel
66,Bergstraat 71,2023-07-17,23:00:00,4,2,2,FMN GV 11 Ramsel
66,Bergstraat 71,2023-07-18,00:00:00,2,2,0,FMN GV 11 Ramsel
66,Bergstraat 71,2023-07-18,01:00:00,2,2,0,FMN GV 11 Ramsel
66,Bergstraat 71,2023-07-18,02:00:00,0,0,0,FMN GV 11 Ramsel
66,Bergstraat 71,2023-07-18,03:00:00,0,0,0,FMN GV 11 Ramsel
66,Bergstraat 71,2023-07-18,04:00:00,2,2,0,FMN GV 11 Ramsel
66,Bergstraat 71,2023-07-18,05:00:00,22,8,14,FMN GV 11 Ramsel
66,Bergstraat 71,2023-07-18,06:00:00,44,20,24,FMN GV 11 Ramsel
66,Bergstraat 71,2023-07-18,07:00:00,84,20,64,FMN GV 11 Ramsel
66,Bergstraat 71,2023-07-18,08:00:00,58,16,42,FMN GV 11 Ramsel
66,Bergstraat 71,2023-07-18,09:00:00,80,36,44,FMN GV 11 Ramsel
66,Bergstraat 71,2023-07-18,10:00:00,174,56,118,FMN GV 11 Ramsel
66,Bergstraat 71,2023-07-18,11:00:00,188,66,122,FMN GV 11 Ramsel
66,Bergstraat 71,2023-07-18,12:00:00,188,102,86,FMN GV 11 Ramsel
66,Bergstraat 71,2023-07-18,13:00:00,340,144,196,FMN GV 11 Ramsel
66,Bergstraat 71,2023-07-18,14:00:00,332,194,138,FMN GV 11 Ramsel
66,Bergstraat 71,2023-07-18,15:00:00,258,148,110,FMN GV 11 Ramsel
66,Bergstraat 71,2023-07-18,16:00:00,224,122,102,FMN GV 11 Ramsel
66,Bergstraat 71,2023-07-18,17:00:00,264,170,94,FMN GV 11 Ramsel
66,Bergstraat 71,2023-07-18,18:00:00,178,110,68,FMN GV 11 Ramsel
66,Bergstraat 71,2023-07-18,19:00:00,142,76,66,FMN GV 11 Ramsel
66,Bergstraat 71,2023-07-18,20:00:00,94,64,30,FMN GV 11 Ramsel
66,Bergstraat 71,2023-07-18,21:00:00,52,22,30,FMN GV 11 Ramsel
66,Bergstraat 71,2023-07-18,22:00:00,18,14,4,FMN GV 11 Ramsel
66,Bergstraat 71,2023-07-18,23:00:00,14,8,6,FMN GV 11 Ramsel
66,Bergstraat 71,2023-07-19,00:00:00,0,0,0,FMN GV 11 Ramsel
66,Bergstraat 71,2023-07-19,01:00:00,2,2,0,FMN GV 11 Ramsel
66,Bergstraat 71,2023-07-19,02:00:00,4,4,0,FMN GV 11 Ramsel
66,Bergstraat 71,2023-07-19,03:00:00,2,0,2,FMN GV 11 Ramsel
66,Bergstraat 71,2023-07-19,04:00:00,2,2,0,FMN GV 11 Ramsel
66,Bergstraat 71,2023-07-19,05:00:00,14,4,10,FMN GV 11 Ramsel
66,Bergstraat 71,2023-07-19,06:00:00,34,20,14,FMN GV 11 Ramsel
66,Bergstraat 71,2023-07-19,07:00:00,46,16,30,FMN GV 11 Ramsel
66,Bergstraat 71,2023-07-19,08:00:00,52,22,30,FMN GV 11 Ramsel
66,Bergstraat 71,2023-07-19,09:00:00,90,34,56,FMN GV 11 Ramsel
66,Bergstraat 71,2023-07-19,10:00:00,106,40,66,FMN GV 11 Ramsel
66,Bergstraat 71,2023-07-19,11:00:00,122,74,48,FMN GV 11 Ramsel
66,Bergstraat 71,2023-07-19,12:00:00,76,36,40,FMN GV 11 Ramsel
66,Bergstraat 71,2023-07-19,13:00:00,118,80,38,FMN GV 11 Ramsel
66,Bergstraat 71,2023-07-19,14:00:00,118,60,58,FMN GV 11 Ramsel
66,Bergstraat 71,2023-07-19,15:00:00,126,54,72,FMN GV 11 Ramsel
66,Bergstraat 71,2023-07-19,16:00:00,140,84,56,FMN GV 11 Ramsel
66,Bergstraat 71,2023-07-19,17:00:00,118,60,58,FMN GV 11 Ramsel
66,Bergstraat 71,2023-07-19,18:00:00,76,48,28,FMN GV 11 Ramsel
66,Bergstraat 71,2023-07-19,19:00:00,60,38,22,FMN GV 11 Ramsel
66,Bergstraat 71,2023-07-19,20:00:00,64,34,30,FMN GV 11 Ramsel
66,Bergstraat 71,2023-07-19,21:00:00,24,14,10,FMN GV 11 Ramsel
66,Bergstraat 71,2023-07-19,22:00:00,20,18,2,FMN GV 11 Ramsel
66,Bergstraat 71,2023-07-19,23:00:00,4,4,0,FMN GV 11 Ramsel
66,Bergstraat 71,2023-07-20,00:00:00,0,0,0,FMN GV 11 Ramsel
66,Bergstraat 71,2023-07-20,01:00:00,0,0,0,FMN GV 11 Ramsel
66,Bergstraat 71,2023-07-20,02:00:00,2,2,0,FMN GV 11 Ramsel
66,Bergstraat 71,2023-07-20,03:00:00,0,0,0,FMN GV 11 Ramsel
66,Bergstraat 71,2023-07-20,04:00:00,6,2,4,FMN GV 11 Ramsel
66,Bergstraat 71,2023-07-20,05:00:00,14,8,6,FMN GV 11 Ramsel
66,Bergstraat 71,2023-07-20,06:00:00,32,12,20,FMN GV 11 Ramsel
66,Bergstraat 71,2023-07-20,07:00:00,64,24,40,FMN GV 11 Ramsel
66,Bergstraat 71,2023-07-20,08:00:00,54,8,46,FMN GV 11 Ramsel
66,Bergstraat 71,2023-07-20,09:00:00,62,24,38,FMN GV 11 Ramsel
66,Bergstraat 71,2023-07-20,10:00:00,88,30,58,FMN GV 11 Ramsel
66,Bergstraat 71,2023-07-20,11:00:00,94,46,48,FMN GV 11 Ramsel
66,Bergstraat 71,2023-07-20,12:00:00,94,44,50,FMN GV 11 Ramsel
66,Bergstraat 71,2023-07-20,13:00:00,180,88,92,FMN GV 11 Ramsel
66,Bergstraat 71,2023-07-20,14:00:00,162,94,68,FMN GV 11 Ramsel
66,Bergstraat 71,2023-07-20,15:00:00,198,110,88,FMN GV 11 Ramsel
66,Bergstraat 71,2023-07-20,16:00:00,156,108,48,FMN GV 11 Ramsel
66,Bergstraat 71,2023-07-20,17:00:00,116,72,44,FMN GV 11 Ramsel
66,Bergstraat 71,2023-07-20,18:00:00,62,30,32,FMN GV 11 Ramsel
66,Bergstraat 71,2023-07-20,19:00:00,28,20,8,FMN GV 11 Ramsel
66,Bergstraat 71,2023-07-20,20:00:00,28,26,2,FMN GV 11 Ramsel
66,Bergstraat 71,2023-07-20,21:00:00,22,12,10,FMN GV 11 Ramsel
66,Bergstraat 71,2023-07-20,22:00:00,16,10,6,FMN GV 11 Ramsel
66,Bergstraat 71,2023-07-20,23:00:00,10,6,4,FMN GV 11 Ramsel
66,Bergstraat 71,2023-07-21,00:00:00,2,0,2,FMN GV 11 Ramsel
66,Bergstraat 71,2023-07-21,01:00:00,4,4,0,FMN GV 11 Ramsel
66,Bergstraat 71,2023-07-21,02:00:00,2,0,2,FMN GV 11 Ramsel
66,Bergstraat 71,2023-07-21,03:00:00,0,0,0,FMN GV 11 Ramsel
66,Bergstraat 71,2023-07-21,04:00:00,2,2,0,FMN GV 11 Ramsel
66,Bergstraat 71,2023-07-21,05:00:00,4,4,0,FMN GV 11 Ramsel
66,Bergstraat 71,2023-07-21,06:00:00,14,4,10,FMN GV 11 Ramsel
66,Bergstraat 71,2023-07-21,07:00:00,14,2,12,FMN GV 11 Ramsel
66,Bergstraat 71,2023-07-21,08:00:00,40,16,24,FMN GV 11 Ramsel
66,Bergstraat 71,2023-07-21,09:00:00,178,124,54,FMN GV 11 Ramsel
66,Bergstraat 71,2023-07-21,10:00:00,174,110,64,FMN GV 11 Ramsel
66,Bergstraat 71,2023-07-21,11:00:00,218,122,96,FMN GV 11 Ramsel
66,Bergstraat 71,2023-07-21,12:00:00,114,46,68,FMN GV 11 Ramsel
66,Bergstraat 71,2023-07-21,13:00:00,146,114,32,FMN GV 11 Ramsel
66,Bergstraat 71,2023-07-21,14:00:00,48,32,16,FMN GV 11 Ramsel
66,Bergstraat 71,2023-07-21,15:00:00,76,40,36,FMN GV 11 Ramsel
66,Bergstraat 71,2023-07-21,16:00:00,112,42,70,FMN GV 11 Ramsel
66,Bergstraat 71,2023-07-21,17:00:00,110,50,60,FMN GV 11 Ramsel
66,Bergstraat 71,2023-07-21,18:00:00,100,42,58,FMN GV 11 Ramsel
66,Bergstraat 71,2023-07-21,19:00:00,72,28,44,FMN GV 11 Ramsel
66,Bergstraat 71,2023-07-21,20:00:00,46,26,20,FMN GV 11 Ramsel
66,Bergstraat 71,2023-07-21,21:00:00,36,18,18,FMN GV 11 Ramsel
66,Bergstraat 71,2023-07-21,22:00:00,8,4,4,FMN GV 11 Ramsel
66,Bergstraat 71,2023-07-21,23:00:00,20,12,8,FMN GV 11 Ramsel
66,Bergstraat 71,2023-07-22,00:00:00,8,8,0,FMN GV 11 Ramsel
66,Bergstraat 71,2023-07-22,01:00:00,6,6,0,FMN GV 11 Ramsel
66,Bergstraat 71,2023-07-22,02:00:00,2,2,0,FMN GV 11 Ramsel
66,Bergstraat 71,2023-07-22,03:00:00,2,0,2,FMN GV 11 Ramsel
66,Bergstraat 71,2023-07-22,04:00:00,2,2,0,FMN GV 11 Ramsel
66,Bergstraat 71,2023-07-22,05:00:00,2,2,0,FMN GV 11 Ramsel
66,Bergstraat 71,2023-07-22,06:00:00,8,4,4,FMN GV 11 Ramsel
66,Bergstraat 71,2023-07-22,07:00:00,6,2,4,FMN GV 11 Ramsel
66,Bergstraat 71,2023-07-22,08:00:00,28,12,16,FMN GV 11 Ramsel
66,Bergstraat 71,2023-07-22,09:00:00,84,42,42,FMN GV 11 Ramsel
66,Bergstraat 71,2023-07-22,10:00:00,176,56,120,FMN GV 11 Ramsel
66,Bergstraat 71,2023-07-22,11:00:00,122,44,78,FMN GV 11 Ramsel
66,Bergstraat 71,2023-07-22,12:00:00,110,62,48,FMN GV 11 Ramsel
66,Bergstraat 71,2023-07-22,13:00:00,182,70,112,FMN GV 11 Ramsel
66,Bergstraat 71,2023-07-22,14:00:00,250,132,118,FMN GV 11 Ramsel
66,Bergstraat 71,2023-07-22,15:00:00,174,88,86,FMN GV 11 Ramsel
66,Bergstraat 71,2023-07-22,16:00:00,178,124,54,FMN GV 11 Ramsel
66,Bergstraat 71,2023-07-22,17:00:00,90,52,38,FMN GV 11 Ramsel
66,Bergstraat 71,2023-07-22,18:00:00,74,32,42,FMN GV 11 Ramsel
66,Bergstraat 71,2023-07-22,19:00:00,82,50,32,FMN GV 11 Ramsel
66,Bergstraat 71,2023-07-22,20:00:00,38,20,18,FMN GV 11 Ramsel
66,Bergstraat 71,2023-07-22,21:00:00,14,8,6,FMN GV 11 Ramsel
66,Bergstraat 71,2023-07-22,22:00:00,28,18,10,FMN GV 11 Ramsel
66,Bergstraat 71,2023-07-22,23:00:00,6,4,2,FMN GV 11 Ramsel
66,Bergstraat 71,2023-07-23,00:00:00,26,20,6,FMN GV 11 Ramsel
66,Bergstraat 71,2023-07-23,01:00:00,0,0,0,FMN GV 11 Ramsel
66,Bergstraat 71,2023-07-23,02:00:00,6,6,0,FMN GV 11 Ramsel
66,Bergstraat 71,2023-07-23,03:00:00,4,4,0,FMN GV 11 Ramsel
66,Bergstraat 71,2023-07-23,04:00:00,0,0,0,FMN GV 11 Ramsel
66,Bergstraat 71,2023-07-23,05:00:00,0,0,0,FMN GV 11 Ramsel
66,Bergstraat 71,2023-07-23,06:00:00,2,2,0,FMN GV 11 Ramsel
66,Bergstraat 71,2023-07-23,07:00:00,4,0,4,FMN GV 11 Ramsel
66,Bergstraat 71,2023-07-23,08:00:00,76,38,38,FMN GV 11 Ramsel
66,Bergstraat 71,2023-07-23,09:00:00,30,8,22,FMN GV 11 Ramsel
66,Bergstraat 71,2023-07-23,10:00:00,34,20,14,FMN GV 11 Ramsel
66,Bergstraat 71,2023-07-23,11:00:00,62,38,24,FMN GV 11 Ramsel
66,Bergstraat 71,2023-07-23,12:00:00,48,18,30,FMN GV 11 Ramsel
66,Bergstraat 71,2023-07-23,13:00:00,44,18,26,FMN GV 11 Ramsel
66,Bergstraat 71,2023-07-23,14:00:00,70,42,28,FMN GV 11 Ramsel
66,Bergstraat 71,2023-07-23,15:00:00,68,38,30,FMN GV 11 Ramsel
66,Bergstraat 71,2023-07-23,16:00:00,52,32,20,FMN GV 11 Ramsel
66,Bergstraat 71,2023-07-23,17:00:00,42,14,28,FMN GV 11 Ramsel
66,Bergstraat 71,2023-07-23,18:00:00,22,6,16,FMN GV 11 Ramsel
66,Bergstraat 71,2023-07-23,19:00:00,8,6,2,FMN GV 11 Ramsel
66,Bergstraat 71,2023-07-23,20:00:00,10,10,0,FMN GV 11 Ramsel
66,Bergstraat 71,2023-07-23,21:00:00,8,4,4,FMN GV 11 Ramsel
66,Bergstraat 71,2023-07-23,22:00:00,0,0,0,FMN GV 11 Ramsel
66,Bergstraat 71,2023-07-23,23:00:00,2,2,0,FMN GV 11 Ramsel
66,Bergstraat 71,2023-07-24,00:00:00,0,0,0,FMN GV 11 Ramsel
66,Bergstraat 71,2023-07-24,01:00:00,0,0,0,FMN GV 11 Ramsel
66,Bergstraat 71,2023-07-24,02:00:00,0,0,0,FMN GV 11 Ramsel
66,Bergstraat 71,2023-07-24,03:00:00,0,0,0,FMN GV 11 Ramsel
66,Bergstraat 71,2023-07-24,04:00:00,6,2,4,FMN GV 11 Ramsel
66,Bergstraat 71,2023-07-24,05:00:00,14,6,8,FMN GV 11 Ramsel
66,Bergstraat 71,2023-07-24,06:00:00,20,10,10,FMN GV 11 Ramsel
66,Bergstraat 71,2023-07-24,07:00:00,40,12,28,FMN GV 11 Ramsel
66,Bergstraat 71,2023-07-24,08:00:00,30,14,16,FMN GV 11 Ramsel
66,Bergstraat 71,2023-07-24,09:00:00,46,16,30,FMN GV 11 Ramsel
66,Bergstraat 71,2023-07-24,10:00:00,52,30,22,FMN GV 11 Ramsel
66,Bergstraat 71,2023-07-24,11:00:00,30,16,14,FMN GV 11 Ramsel
66,Bergstraat 71,2023-07-24,12:00:00,6,2,4,FMN GV 11 Ramsel
66,Bergstraat 71,2023-07-24,13:00:00,38,20,18,FMN GV 11 Ramsel
66,Bergstraat 71,2023-07-24,14:00:00,66,26,40,FMN GV 11 Ramsel
66,Bergstraat 71,2023-07-24,15:00:00,82,40,42,FMN GV 11 Ramsel
66,Bergstraat 71,2023-07-24,16:00:00,88,52,36,FMN GV 11 Ramsel
66,Bergstraat 71,2023-07-24,17:00:00,60,34,26,FMN GV 11 Ramsel
66,Bergstraat 71,2023-07-24,18:00:00,40,24,16,FMN GV 11 Ramsel
66,Bergstraat 71,2023-07-24,19:00:00,58,30,28,FMN GV 11 Ramsel
66,Bergstraat 71,2023-07-24,20:00:00,48,22,26,FMN GV 11 Ramsel
66,Bergstraat 71,2023-07-24,21:00:00,18,10,8,FMN GV 11 Ramsel
66,Bergstraat 71,2023-07-24,22:00:00,18,6,12,FMN GV 11 Ramsel
66,Bergstraat 71,2023-07-24,23:00:00,6,4,2,FMN GV 11 Ramsel
66,Bergstraat 71,2023-07-25,00:00:00,2,2,0,FMN GV 11 Ramsel
66,Bergstraat 71,2023-07-25,01:00:00,0,0,0,FMN GV 11 Ramsel
66,Bergstraat 71,2023-07-25,02:00:00,0,0,0,FMN GV 11 Ramsel
66,Bergstraat 71,2023-07-25,03:00:00,0,0,0,FMN GV 11 Ramsel
66,Bergstraat 71,2023-07-25,04:00:00,16,12,4,FMN GV 11 Ramsel
66,Bergstraat 71,2023-07-25,05:00:00,10,6,4,FMN GV 11 Ramsel
66,Bergstraat 71,2023-07-25,06:00:00,42,16,26,FMN GV 11 Ramsel
66,Bergstraat 71,2023-07-25,07:00:00,62,14,48,FMN GV 11 Ramsel
66,Bergstraat 71,2023-07-25,08:00:00,22,2,20,FMN GV 11 Ramsel
66,Bergstraat 71,2023-07-25,09:00:00,56,20,36,FMN GV 11 Ramsel
66,Bergstraat 71,2023-07-25,10:00:00,48,28,20,FMN GV 11 Ramsel
66,Bergstraat 71,2023-07-25,11:00:00,78,36,42,FMN GV 11 Ramsel
66,Bergstraat 71,2023-07-25,12:00:00,118,46,72,FMN GV 11 Ramsel
66,Bergstraat 71,2023-07-25,13:00:00,140,74,66,FMN GV 11 Ramsel
66,Bergstraat 71,2023-07-25,14:00:00,164,86,78,FMN GV 11 Ramsel
66,Bergstraat 71,2023-07-25,15:00:00,170,88,82,FMN GV 11 Ramsel
66,Bergstraat 71,2023-07-25,16:00:00,156,88,68,FMN GV 11 Ramsel
66,Bergstraat 71,2023-07-25,17:00:00,110,54,56,FMN GV 11 Ramsel
66,Bergstraat 71,2023-07-25,18:00:00,116,62,54,FMN GV 11 Ramsel
66,Bergstraat 71,2023-07-25,19:00:00,114,48,66,FMN GV 11 Ramsel
66,Bergstraat 71,2023-07-25,20:00:00,66,38,28,FMN GV 11 Ramsel
66,Bergstraat 71,2023-07-25,21:00:00,44,28,16,FMN GV 11 Ramsel
66,Bergstraat 71,2023-07-25,22:00:00,18,14,4,FMN GV 11 Ramsel
66,Bergstraat 71,2023-07-25,23:00:00,6,4,2,FMN GV 11 Ramsel
66,Bergstraat 71,2023-07-26,00:00:00,2,2,0,FMN GV 11 Ramsel
66,Bergstraat 71,2023-07-26,01:00:00,2,0,2,FMN GV 11 Ramsel
66,Bergstraat 71,2023-07-26,02:00:00,2,2,0,FMN GV 11 Ramsel
66,Bergstraat 71,2023-07-26,03:00:00,0,0,0,FMN GV 11 Ramsel
66,Bergstraat 71,2023-07-26,04:00:00,8,6,2,FMN GV 11 Ramsel
66,Bergstraat 71,2023-07-26,05:00:00,20,10,10,FMN GV 11 Ramsel
66,Bergstraat 71,2023-07-26,06:00:00,42,8,34,FMN GV 11 Ramsel
66,Bergstraat 71,2023-07-26,07:00:00,62,20,42,FMN GV 11 Ramsel
66,Bergstraat 71,2023-07-26,08:00:00,58,16,42,FMN GV 11 Ramsel
66,Bergstraat 71,2023-07-26,09:00:00,80,46,34,FMN GV 11 Ramsel
66,Bergstraat 71,2023-07-26,10:00:00,112,66,46,FMN GV 11 Ramsel
66,Bergstraat 71,2023-07-26,11:00:00,132,80,52,FMN GV 11 Ramsel
66,Bergstraat 71,2023-07-26,12:00:00,116,58,58,FMN GV 11 Ramsel
66,Bergstraat 71,2023-07-26,13:00:00,208,110,98,FMN GV 11 Ramsel
66,Bergstraat 71,2023-07-26,14:00:00,224,132,92,FMN GV 11 Ramsel
66,Bergstraat 71,2023-07-26,15:00:00,222,130,92,FMN GV 11 Ramsel
66,Bergstraat 71,2023-07-26,16:00:00,238,146,92,FMN GV 11 Ramsel
66,Bergstraat 71,2023-07-26,17:00:00,144,84,60,FMN GV 11 Ramsel
66,Bergstraat 71,2023-07-26,18:00:00,112,66,46,FMN GV 11 Ramsel
66,Bergstraat 71,2023-07-26,19:00:00,126,68,58,FMN GV 11 Ramsel
66,Bergstraat 71,2023-07-26,20:00:00,68,46,22,FMN GV 11 Ramsel
66,Bergstraat 71,2023-07-26,21:00:00,68,46,22,FMN GV 11 Ramsel
66,Bergstraat 71,2023-07-26,22:00:00,48,24,24,FMN GV 11 Ramsel
66,Bergstraat 71,2023-07-26,23:00:00,6,6,0,FMN GV 11 Ramsel
66,Bergstraat 71,2023-07-27,00:00:00,20,18,2,FMN GV 11 Ramsel
66,Bergstraat 71,2023-07-27,01:00:00,18,18,0,FMN GV 11 Ramsel
66,Bergstraat 71,2023-07-27,02:00:00,4,0,4,FMN GV 11 Ramsel
66,Bergstraat 71,2023-07-27,03:00:00,0,0,0,FMN GV 11 Ramsel
66,Bergstraat 71,2023-07-27,04:00:00,2,2,0,FMN GV 11 Ramsel
66,Bergstraat 71,2023-07-27,05:00:00,14,6,8,FMN GV 11 Ramsel
66,Bergstraat 71,2023-07-27,06:00:00,14,4,10,FMN GV 11 Ramsel
66,Bergstraat 71,2023-07-27,07:00:00,26,6,20,FMN GV 11 Ramsel
66,Bergstraat 71,2023-07-27,08:00:00,14,4,10,FMN GV 11 Ramsel
66,Bergstraat 71,2023-07-27,09:00:00,4,0,4,FMN GV 11 Ramsel
66,Bergstraat 71,2023-07-27,10:00:00,10,6,4,FMN GV 11 Ramsel
66,Bergstraat 71,2023-07-27,11:00:00,14,2,12,FMN GV 11 Ramsel
66,Bergstraat 71,2023-07-27,12:00:00,14,6,8,FMN GV 11 Ramsel
66,Bergstraat 71,2023-07-27,13:00:00,20,12,8,FMN GV 11 Ramsel
66,Bergstraat 71,2023-07-27,14:00:00,66,30,36,FMN GV 11 Ramsel
66,Bergstraat 71,2023-07-27,15:00:00,44,32,12,FMN GV 11 Ramsel
66,Bergstraat 71,2023-07-27,16:00:00,36,26,10,FMN GV 11 Ramsel
66,Bergstraat 71,2023-07-27,17:00:00,42,28,14,FMN GV 11 Ramsel
66,Bergstraat 71,2023-07-27,18:00:00,14,8,6,FMN GV 11 Ramsel
66,Bergstraat 71,2023-07-27,19:00:00,20,8,12,FMN GV 11 Ramsel
66,Bergstraat 71,2023-07-27,20:00:00,12,8,4,FMN GV 11 Ramsel
66,Bergstraat 71,2023-07-27,21:00:00,12,4,8,FMN GV 11 Ramsel
66,Bergstraat 71,2023-07-27,22:00:00,16,10,6,FMN GV 11 Ramsel
66,Bergstraat 71,2023-07-27,23:00:00,12,10,2,FMN GV 11 Ramsel
66,Bergstraat 71,2023-07-28,00:00:00,6,6,0,FMN GV 11 Ramsel
66,Bergstraat 71,2023-07-28,01:00:00,0,0,0,FMN GV 11 Ramsel
66,Bergstraat 71,2023-07-28,02:00:00,0,0,0,FMN GV 11 Ramsel
66,Bergstraat 71,2023-07-28,03:00:00,0,0,0,FMN GV 11 Ramsel
66,Bergstraat 71,2023-07-28,04:00:00,2,2,0,FMN GV 11 Ramsel
66,Bergstraat 71,2023-07-28,05:00:00,12,6,6,FMN GV 11 Ramsel
66,Bergstraat 71,2023-07-28,06:00:00,18,4,14,FMN GV 11 Ramsel
66,Bergstraat 71,2023-07-28,07:00:00,34,6,28,FMN GV 11 Ramsel
66,Bergstraat 71,2023-07-28,08:00:00,34,10,24,FMN GV 11 Ramsel
66,Bergstraat 71,2023-07-28,09:00:00,42,14,28,FMN GV 11 Ramsel
66,Bergstraat 71,2023-07-28,10:00:00,74,32,42,FMN GV 11 Ramsel
66,Bergstraat 71,2023-07-28,11:00:00,76,30,46,FMN GV 11 Ramsel
66,Bergstraat 71,2023-07-28,12:00:00,76,36,40,FMN GV 11 Ramsel
66,Bergstraat 71,2023-07-28,13:00:00,100,40,60,FMN GV 11 Ramsel
66,Bergstraat 71,2023-07-28,14:00:00,152,80,72,FMN GV 11 Ramsel
66,Bergstraat 71,2023-07-28,15:00:00,132,62,70,FMN GV 11 Ramsel
66,Bergstraat 71,2023-07-28,16:00:00,164,110,54,FMN GV 11 Ramsel
66,Bergstraat 71,2023-07-28,17:00:00,116,84,32,FMN GV 11 Ramsel
66,Bergstraat 71,2023-07-28,18:00:00,104,58,46,FMN GV 11 Ramsel
66,Bergstraat 71,2023-07-28,19:00:00,80,30,50,FMN GV 11 Ramsel
66,Bergstraat 71,2023-07-28,20:00:00,38,20,18,FMN GV 11 Ramsel
66,Bergstraat 71,2023-07-28,21:00:00,28,20,8,FMN GV 11 Ramsel
66,Bergstraat 71,2023-07-28,22:00:00,10,2,8,FMN GV 11 Ramsel
66,Bergstraat 71,2023-07-28,23:00:00,6,6,0,FMN GV 11 Ramsel
66,Bergstraat 71,2023-07-29,00:00:00,20,18,2,FMN GV 11 Ramsel
66,Bergstraat 71,2023-07-29,01:00:00,14,14,0,FMN GV 11 Ramsel
66,Bergstraat 71,2023-07-29,02:00:00,8,8,0,FMN GV 11 Ramsel
66,Bergstraat 71,2023-07-29,03:00:00,0,0,0,FMN GV 11 Ramsel
66,Bergstraat 71,2023-07-29,04:00:00,0,0,0,FMN GV 11 Ramsel
66,Bergstraat 71,2023-07-29,05:00:00,2,2,0,FMN GV 11 Ramsel
66,Bergstraat 71,2023-07-29,06:00:00,2,2,0,FMN GV 11 Ramsel
66,Bergstraat 71,2023-07-29,07:00:00,8,2,6,FMN GV 11 Ramsel
66,Bergstraat 71,2023-07-29,08:00:00,58,16,42,FMN GV 11 Ramsel
66,Bergstraat 71,2023-07-29,09:00:00,66,36,30,FMN GV 11 Ramsel
66,Bergstraat 71,2023-07-29,10:00:00,124,58,66,FMN GV 11 Ramsel
66,Bergstraat 71,2023-07-29,11:00:00,114,68,46,FMN GV 11 Ramsel
66,Bergstraat 71,2023-07-29,12:00:00,106,66,40,FMN GV 11 Ramsel
66,Bergstraat 71,2023-07-29,13:00:00,86,48,38,FMN GV 11 Ramsel
66,Bergstraat 71,2023-07-29,14:00:00,76,48,28,FMN GV 11 Ramsel
66,Bergstraat 71,2023-07-29,15:00:00,64,26,38,FMN GV 11 Ramsel
66,Bergstraat 71,2023-07-29,16:00:00,72,46,26,FMN GV 11 Ramsel
66,Bergstraat 71,2023-07-29,17:00:00,38,20,18,FMN GV 11 Ramsel
66,Bergstraat 71,2023-07-29,18:00:00,44,26,18,FMN GV 11 Ramsel
66,Bergstraat 71,2023-07-29,19:00:00,96,40,56,FMN GV 11 Ramsel
66,Bergstraat 71,2023-07-29,20:00:00,88,38,50,FMN GV 11 Ramsel
66,Bergstraat 71,2023-07-29,21:00:00,22,12,10,FMN GV 11 Ramsel
66,Bergstraat 71,2023-07-29,22:00:00,16,4,12,FMN GV 11 Ramsel
66,Bergstraat 71,2023-07-29,23:00:00,12,0,12,FMN GV 11 Ramsel
66,Bergstraat 71,2023-07-30,00:00:00,32,24,8,FMN GV 11 Ramsel
66,Bergstraat 71,2023-07-30,01:00:00,22,12,10,FMN GV 11 Ramsel
66,Bergstraat 71,2023-07-30,02:00:00,10,6,4,FMN GV 11 Ramsel
66,Bergstraat 71,2023-07-30,03:00:00,0,0,0,FMN GV 11 Ramsel
66,Bergstraat 71,2023-07-30,04:00:00,2,0,2,FMN GV 11 Ramsel
66,Bergstraat 71,2023-07-30,05:00:00,2,2,0,FMN GV 11 Ramsel
66,Bergstraat 71,2023-07-30,06:00:00,2,2,0,FMN GV 11 Ramsel
66,Bergstraat 71,2023-07-30,07:00:00,18,4,14,FMN GV 11 Ramsel
66,Bergstraat 71,2023-07-30,08:00:00,134,38,96,FMN GV 11 Ramsel
66,Bergstraat 71,2023-07-30,09:00:00,114,52,62,FMN GV 11 Ramsel
66,Bergstraat 71,2023-07-30,10:00:00,230,90,140,FMN GV 11 Ramsel
66,Bergstraat 71,2023-07-30,11:00:00,148,84,64,FMN GV 11 Ramsel
66,Bergstraat 71,2023-07-30,12:00:00,128,90,38,FMN GV 11 Ramsel
66,Bergstraat 71,2023-07-30,13:00:00,166,102,64,FMN GV 11 Ramsel
66,Bergstraat 71,2023-07-30,14:00:00,174,98,76,FMN GV 11 Ramsel
66,Bergstraat 71,2023-07-30,15:00:00,216,106,110,FMN GV 11 Ramsel
66,Bergstraat 71,2023-07-30,16:00:00,118,70,48,FMN GV 11 Ramsel
66,Bergstraat 71,2023-07-30,17:00:00,132,46,86,FMN GV 11 Ramsel
66,Bergstraat 71,2023-07-30,18:00:00,22,10,12,FMN GV 11 Ramsel
66,Bergstraat 71,2023-07-30,19:00:00,34,22,12,FMN GV 11 Ramsel
66,Bergstraat 71,2023-07-30,20:00:00,24,4,20,FMN GV 11 Ramsel
66,Bergstraat 71,2023-07-30,21:00:00,2,2,0,FMN GV 11 Ramsel
66,Bergstraat 71,2023-07-30,22:00:00,0,0,0,FMN GV 11 Ramsel
66,Bergstraat 71,2023-07-30,23:00:00,2,0,2,FMN GV 11 Ramsel
66,Bergstraat 71,2023-07-31,00:00:00,4,2,2,FMN GV 11 Ramsel
66,Bergstraat 71,2023-07-31,01:00:00,2,0,2,FMN GV 11 Ramsel
66,Bergstraat 71,2023-07-31,02:00:00,0,0,0,FMN GV 11 Ramsel
66,Bergstraat 71,2023-07-31,03:00:00,0,0,0,FMN GV 11 Ramsel
66,Bergstraat 71,2023-07-31,04:00:00,6,4,2,FMN GV 11 Ramsel
66,Bergstraat 71,2023-07-31,05:00:00,14,6,8,FMN GV 11 Ramsel
66,Bergstraat 71,2023-07-31,06:00:00,24,8,16,FMN GV 11 Ramsel
66,Bergstraat 71,2023-07-31,07:00:00,24,8,16,FMN GV 11 Ramsel
66,Bergstraat 71,2023-07-31,08:00:00,26,8,18,FMN GV 11 Ramsel
66,Bergstraat 71,2023-07-31,09:00:00,70,14,56,FMN GV 11 Ramsel
66,Bergstraat 71,2023-07-31,10:00:00,108,8,100,FMN GV 11 Ramsel
66,Bergstraat 71,2023-07-31,11:00:00,78,4,74,FMN GV 11 Ramsel
66,Bergstraat 71,2023-07-31,12:00:00,100,38,62,FMN GV 11 Ramsel
66,Bergstraat 71,2023-07-31,13:00:00,62,20,42,FMN GV 11 Ramsel
66,Bergstraat 71,2023-07-31,14:00:00,64,40,24,FMN GV 11 Ramsel
66,Bergstraat 71,2023-07-31,15:00:00,54,36,18,FMN GV 11 Ramsel
66,Bergstraat 71,2023-07-31,16:00:00,48,38,10,FMN GV 11 Ramsel
66,Bergstraat 71,2023-07-31,17:00:00,22,10,12,FMN GV 11 Ramsel
66,Bergstraat 71,2023-07-31,18:00:00,18,10,8,FMN GV 11 Ramsel
66,Bergstraat 71,2023-07-31,19:00:00,20,16,4,FMN GV 11 Ramsel
66,Bergstraat 71,2023-07-31,20:00:00,8,0,8,FMN GV 11 Ramsel
66,Bergstraat 71,2023-07-31,21:00:00,2,0,2,FMN GV 11 Ramsel
66,Bergstraat 71,2023-07-31,22:00:00,16,8,8,FMN GV 11 Ramsel
66,Bergstraat 71,2023-07-31,23:00:00,0,0,0,FMN GV 11 Ramsel
66,Bergstraat 71,2023-08-01,00:00:00,0,0,0,FMN GV 11 Ramsel
66,Bergstraat 71,2023-08-01,01:00:00,0,0,0,FMN GV 11 Ramsel
66,Bergstraat 71,2023-08-01,02:00:00,0,0,0,FMN GV 11 Ramsel
66,Bergstraat 71,2023-08-01,03:00:00,0,0,0,FMN GV 11 Ramsel
66,Bergstraat 71,2023-08-01,04:00:00,4,4,0,FMN GV 11 Ramsel
66,Bergstraat 71,2023-08-01,05:00:00,22,8,14,FMN GV 11 Ramsel
66,Bergstraat 71,2023-08-01,06:00:00,28,12,16,FMN GV 11 Ramsel
66,Bergstraat 71,2023-08-01,07:00:00,48,16,32,FMN GV 11 Ramsel
66,Bergstraat 71,2023-08-01,08:00:00,50,20,30,FMN GV 11 Ramsel
66,Bergstraat 71,2023-08-01,09:00:00,52,24,28,FMN GV 11 Ramsel
66,Bergstraat 71,2023-08-01,10:00:00,66,22,44,FMN GV 11 Ramsel
66,Bergstraat 71,2023-08-01,11:00:00,86,34,52,FMN GV 11 Ramsel
66,Bergstraat 71,2023-08-01,12:00:00,112,62,50,FMN GV 11 Ramsel
66,Bergstraat 71,2023-08-01,13:00:00,226,74,152,FMN GV 11 Ramsel
66,Bergstraat 71,2023-08-01,14:00:00,124,80,44,FMN GV 11 Ramsel
66,Bergstraat 71,2023-08-01,15:00:00,150,80,70,FMN GV 11 Ramsel
66,Bergstraat 71,2023-08-01,16:00:00,168,102,66,FMN GV 11 Ramsel
66,Bergstraat 71,2023-08-01,17:00:00,98,52,46,FMN GV 11 Ramsel
66,Bergstraat 71,2023-08-01,18:00:00,82,50,32,FMN GV 11 Ramsel
66,Bergstraat 71,2023-08-01,19:00:00,92,34,58,FMN GV 11 Ramsel
66,Bergstraat 71,2023-08-01,20:00:00,60,30,30,FMN GV 11 Ramsel
66,Bergstraat 71,2023-08-01,21:00:00,22,18,4,FMN GV 11 Ramsel
66,Bergstraat 71,2023-08-01,22:00:00,12,10,2,FMN GV 11 Ramsel
66,Bergstraat 71,2023-08-01,23:00:00,2,2,0,FMN GV 11 Ramsel
66,Bergstraat 71,2023-08-02,00:00:00,0,0,0,FMN GV 11 Ramsel
66,Bergstraat 71,2023-08-02,01:00:00,2,2,0,FMN GV 11 Ramsel
66,Bergstraat 71,2023-08-02,02:00:00,0,0,0,FMN GV 11 Ramsel
66,Bergstraat 71,2023-08-02,03:00:00,0,0,0,FMN GV 11 Ramsel
66,Bergstraat 71,2023-08-02,04:00:00,4,4,0,FMN GV 11 Ramsel
66,Bergstraat 71,2023-08-02,05:00:00,18,8,10,FMN GV 11 Ramsel
66,Bergstraat 71,2023-08-02,06:00:00,12,4,8,FMN GV 11 Ramsel
66,Bergstraat 71,2023-08-02,07:00:00,20,6,14,FMN GV 11 Ramsel
66,Bergstraat 71,2023-08-02,08:00:00,36,12,24,FMN GV 11 Ramsel
66,Bergstraat 71,2023-08-02,09:00:00,18,8,10,FMN GV 11 Ramsel
66,Bergstraat 71,2023-08-02,10:00:00,16,6,10,FMN GV 11 Ramsel
66,Bergstraat 71,2023-08-02,11:00:00,36,20,16,FMN GV 11 Ramsel
66,Bergstraat 71,2023-08-02,12:00:00,10,8,2,FMN GV 11 Ramsel
66,Bergstraat 71,2023-08-02,13:00:00,40,16,24,FMN GV 11 Ramsel
66,Bergstraat 71,2023-08-02,14:00:00,64,30,34,FMN GV 11 Ramsel
66,Bergstraat 71,2023-08-02,15:00:00,52,24,28,FMN GV 11 Ramsel
66,Bergstraat 71,2023-08-02,16:00:00,70,36,34,FMN GV 11 Ramsel
66,Bergstraat 71,2023-08-02,17:00:00,46,24,22,FMN GV 11 Ramsel
66,Bergstraat 71,2023-08-02,18:00:00,46,32,14,FMN GV 11 Ramsel
66,Bergstraat 71,2023-08-02,19:00:00,28,12,16,FMN GV 11 Ramsel
66,Bergstraat 71,2023-08-02,20:00:00,28,18,10,FMN GV 11 Ramsel
66,Bergstraat 71,2023-08-02,21:00:00,14,8,6,FMN GV 11 Ramsel
66,Bergstraat 71,2023-08-02,22:00:00,8,2,6,FMN GV 11 Ramsel
66,Bergstraat 71,2023-08-02,23:00:00,12,10,2,FMN GV 11 Ramsel
66,Bergstraat 71,2023-08-03,00:00:00,2,0,2,FMN GV 11 Ramsel
66,Bergstraat 71,2023-08-03,01:00:00,2,2,0,FMN GV 11 Ramsel
66,Bergstraat 71,2023-08-03,02:00:00,0,0,0,FMN GV 11 Ramsel
66,Bergstraat 71,2023-08-03,03:00:00,2,2,0,FMN GV 11 Ramsel
66,Bergstraat 71,2023-08-03,04:00:00,6,4,2,FMN GV 11 Ramsel
66,Bergstraat 71,2023-08-03,05:00:00,14,6,8,FMN GV 11 Ramsel
66,Bergstraat 71,2023-08-03,06:00:00,12,6,6,FMN GV 11 Ramsel
66,Bergstraat 71,2023-08-03,07:00:00,28,6,22,FMN GV 11 Ramsel
66,Bergstraat 71,2023-08-03,08:00:00,36,18,18,FMN GV 11 Ramsel
66,Bergstraat 71,2023-08-03,09:00:00,24,8,16,FMN GV 11 Ramsel
66,Bergstraat 71,2023-08-03,10:00:00,24,10,14,FMN GV 11 Ramsel
66,Bergstraat 71,2023-08-03,11:00:00,26,16,10,FMN GV 11 Ramsel
66,Bergstraat 71,2023-08-03,12:00:00,34,12,22,FMN GV 11 Ramsel
66,Bergstraat 71,2023-08-03,13:00:00,48,18,30,FMN GV 11 Ramsel
66,Bergstraat 71,2023-08-03,14:00:00,72,40,32,FMN GV 11 Ramsel
66,Bergstraat 71,2023-08-03,15:00:00,38,14,24,FMN GV 11 Ramsel
66,Bergstraat 71,2023-08-03,16:00:00,40,26,14,FMN GV 11 Ramsel
66,Bergstraat 71,2023-08-03,17:00:00,48,30,18,FMN GV 11 Ramsel
66,Bergstraat 71,2023-08-03,18:00:00,50,20,30,FMN GV 11 Ramsel
66,Bergstraat 71,2023-08-03,19:00:00,34,12,22,FMN GV 11 Ramsel
66,Bergstraat 71,2023-08-03,20:00:00,32,14,18,FMN GV 11 Ramsel
66,Bergstraat 71,2023-08-03,21:00:00,30,22,8,FMN GV 11 Ramsel
66,Bergstraat 71,2023-08-03,22:00:00,10,6,4,FMN GV 11 Ramsel
66,Bergstraat 71,2023-08-03,23:00:00,8,6,2,FMN GV 11 Ramsel
66,Bergstraat 71,2023-08-04,00:00:00,8,6,2,FMN GV 11 Ramsel
66,Bergstraat 71,2023-08-04,01:00:00,4,0,4,FMN GV 11 Ramsel
66,Bergstraat 71,2023-08-04,02:00:00,0,0,0,FMN GV 11 Ramsel
66,Bergstraat 71,2023-08-04,03:00:00,0,0,0,FMN GV 11 Ramsel
66,Bergstraat 71,2023-08-04,04:00:00,8,6,2,FMN GV 11 Ramsel
66,Bergstraat 71,2023-08-04,05:00:00,14,6,8,FMN GV 11 Ramsel
66,Bergstraat 71,2023-08-04,06:00:00,20,12,8,FMN GV 11 Ramsel
66,Bergstraat 71,2023-08-04,07:00:00,34,8,26,FMN GV 11 Ramsel
66,Bergstraat 71,2023-08-04,08:00:00,38,8,30,FMN GV 11 Ramsel
66,Bergstraat 71,2023-08-04,09:00:00,52,22,30,FMN GV 11 Ramsel
66,Bergstraat 71,2023-08-04,10:00:00,52,20,32,FMN GV 11 Ramsel
66,Bergstraat 71,2023-08-04,11:00:00,36,20,16,FMN GV 11 Ramsel
66,Bergstraat 71,2023-08-04,12:00:00,52,28,24,FMN GV 11 Ramsel
66,Bergstraat 71,2023-08-04,13:00:00,90,42,48,FMN GV 11 Ramsel
66,Bergstraat 71,2023-08-04,14:00:00,104,40,64,FMN GV 11 Ramsel
66,Bergstraat 71,2023-08-04,15:00:00,104,52,52,FMN GV 11 Ramsel
66,Bergstraat 71,2023-08-04,16:00:00,132,100,32,FMN GV 11 Ramsel
66,Bergstraat 71,2023-08-04,17:00:00,104,62,42,FMN GV 11 Ramsel
66,Bergstraat 71,2023-08-04,18:00:00,108,44,64,FMN GV 11 Ramsel
66,Bergstraat 71,2023-08-04,19:00:00,96,52,44,FMN GV 11 Ramsel
66,Bergstraat 71,2023-08-04,20:00:00,50,30,20,FMN GV 11 Ramsel
66,Bergstraat 71,2023-08-04,21:00:00,28,20,8,FMN GV 11 Ramsel
66,Bergstraat 71,2023-08-04,22:00:00,20,10,10,FMN GV 11 Ramsel
66,Bergstraat 71,2023-08-04,23:00:00,4,4,0,FMN GV 11 Ramsel
66,Bergstraat 71,2023-08-05,00:00:00,6,4,2,FMN GV 11 Ramsel
66,Bergstraat 71,2023-08-05,01:00:00,4,2,2,FMN GV 11 Ramsel
66,Bergstraat 71,2023-08-05,02:00:00,10,10,0,FMN GV 11 Ramsel
66,Bergstraat 71,2023-08-05,03:00:00,0,0,0,FMN GV 11 Ramsel
66,Bergstraat 71,2023-08-05,04:00:00,0,0,0,FMN GV 11 Ramsel
66,Bergstraat 71,2023-08-05,05:00:00,2,2,0,FMN GV 11 Ramsel
66,Bergstraat 71,2023-08-05,06:00:00,8,6,2,FMN GV 11 Ramsel
66,Bergstraat 71,2023-08-05,07:00:00,30,12,18,FMN GV 11 Ramsel
66,Bergstraat 71,2023-08-05,08:00:00,58,16,42,FMN GV 11 Ramsel
66,Bergstraat 71,2023-08-05,09:00:00,102,34,68,FMN GV 11 Ramsel
66,Bergstraat 71,2023-08-05,10:00:00,110,44,66,FMN GV 11 Ramsel
66,Bergstraat 71,2023-08-05,11:00:00,150,98,52,FMN GV 11 Ramsel
66,Bergstraat 71,2023-08-05,12:00:00,124,72,52,FMN GV 11 Ramsel
66,Bergstraat 71,2023-08-05,13:00:00,56,38,18,FMN GV 11 Ramsel
66,Bergstraat 71,2023-08-05,14:00:00,32,16,16,FMN GV 11 Ramsel
66,Bergstraat 71,2023-08-05,15:00:00,28,18,10,FMN GV 11 Ramsel
66,Bergstraat 71,2023-08-05,16:00:00,28,6,22,FMN GV 11 Ramsel
66,Bergstraat 71,2023-08-05,17:00:00,16,8,8,FMN GV 11 Ramsel
66,Bergstraat 71,2023-08-05,18:00:00,30,10,20,FMN GV 11 Ramsel
66,Bergstraat 71,2023-08-05,19:00:00,16,8,8,FMN GV 11 Ramsel
66,Bergstraat 71,2023-08-05,20:00:00,22,10,12,FMN GV 11 Ramsel
66,Bergstraat 71,2023-08-05,21:00:00,8,2,6,FMN GV 11 Ramsel
66,Bergstraat 71,2023-08-05,22:00:00,10,4,6,FMN GV 11 Ramsel
66,Bergstraat 71,2023-08-05,23:00:00,6,6,0,FMN GV 11 Ramsel
66,Bergstraat 71,2023-08-06,00:00:00,2,2,0,FMN GV 11 Ramsel
66,Bergstraat 71,2023-08-06,01:00:00,10,10,0,FMN GV 11 Ramsel
66,Bergstraat 71,2023-08-06,02:00:00,4,2,2,FMN GV 11 Ramsel
66,Bergstraat 71,2023-08-06,03:00:00,2,2,0,FMN GV 11 Ramsel
66,Bergstraat 71,2023-08-06,04:00:00,4,0,4,FMN GV 11 Ramsel
66,Bergstraat 71,2023-08-06,05:00:00,0,0,0,FMN GV 11 Ramsel
66,Bergstraat 71,2023-08-06,06:00:00,4,2,2,FMN GV 11 Ramsel
66,Bergstraat 71,2023-08-06,07:00:00,0,0,0,FMN GV 11 Ramsel
66,Bergstraat 71,2023-08-06,08:00:00,8,4,4,FMN GV 11 Ramsel
66,Bergstraat 71,2023-08-06,09:00:00,6,2,4,FMN GV 11 Ramsel
66,Bergstraat 71,2023-08-06,10:00:00,12,6,6,FMN GV 11 Ramsel
66,Bergstraat 71,2023-08-06,11:00:00,8,0,8,FMN GV 11 Ramsel
66,Bergstraat 71,2023-08-06,12:00:00,22,10,12,FMN GV 11 Ramsel
66,Bergstraat 71,2023-08-06,13:00:00,32,14,18,FMN GV 11 Ramsel
66,Bergstraat 71,2023-08-06,14:00:00,6,2,4,FMN GV 11 Ramsel
66,Bergstraat 71,2023-08-06,15:00:00,8,8,0,FMN GV 11 Ramsel
66,Bergstraat 71,2023-08-06,16:00:00,14,10,4,FMN GV 11 Ramsel
66,Bergstraat 71,2023-08-06,17:00:00,8,2,6,FMN GV 11 Ramsel
66,Bergstraat 71,2023-08-06,18:00:00,2,2,0,FMN GV 11 Ramsel
66,Bergstraat 71,2023-08-06,19:00:00,20,10,10,FMN GV 11 Ramsel
66,Bergstraat 71,2023-08-06,20:00:00,10,6,4,FMN GV 11 Ramsel
66,Bergstraat 71,2023-08-06,21:00:00,8,2,6,FMN GV 11 Ramsel
66,Bergstraat 71,2023-08-06,22:00:00,8,6,2,FMN GV 11 Ramsel
66,Bergstraat 71,2023-08-06,23:00:00,6,4,2,FMN GV 11 Ramsel
66,Bergstraat 71,2023-08-07,00:00:00,2,2,0,FMN GV 11 Ramsel
66,Bergstraat 71,2023-08-07,01:00:00,0,0,0,FMN GV 11 Ramsel
66,Bergstraat 71,2023-08-07,02:00:00,0,0,0,FMN GV 11 Ramsel
66,Bergstraat 71,2023-08-07,03:00:00,0,0,0,FMN GV 11 Ramsel
66,Bergstraat 71,2023-08-07,04:00:00,8,4,4,FMN GV 11 Ramsel
66,Bergstraat 71,2023-08-07,05:00:00,18,8,10,FMN GV 11 Ramsel
66,Bergstraat 71,2023-08-07,06:00:00,24,12,12,FMN GV 11 Ramsel
66,Bergstraat 71,2023-08-07,07:00:00,58,18,40,FMN GV 11 Ramsel
66,Bergstraat 71,2023-08-07,08:00:00,44,16,28,FMN GV 11 Ramsel
66,Bergstraat 71,2023-08-07,09:00:00,48,28,20,FMN GV 11 Ramsel
66,Bergstraat 71,2023-08-07,10:00:00,66,38,28,FMN GV 11 Ramsel
66,Bergstraat 71,2023-08-07,11:00:00,54,26,28,FMN GV 11 Ramsel
66,Bergstraat 71,2023-08-07,12:00:00,96,30,66,FMN GV 11 Ramsel
66,Bergstraat 71,2023-08-07,13:00:00,142,78,64,FMN GV 11 Ramsel
66,Bergstraat 71,2023-08-07,14:00:00,168,74,94,FMN GV 11 Ramsel
66,Bergstraat 71,2023-08-07,15:00:00,150,72,78,FMN GV 11 Ramsel
66,Bergstraat 71,2023-08-07,16:00:00,164,114,50,FMN GV 11 Ramsel
66,Bergstraat 71,2023-08-07,17:00:00,106,52,54,FMN GV 11 Ramsel
66,Bergstraat 71,2023-08-07,18:00:00,84,48,36,FMN GV 11 Ramsel
66,Bergstraat 71,2023-08-07,19:00:00,100,50,50,FMN GV 11 Ramsel
66,Bergstraat 71,2023-08-07,20:00:00,54,32,22,FMN GV 11 Ramsel
66,Bergstraat 71,2023-08-07,21:00:00,42,28,14,FMN GV 11 Ramsel
66,Bergstraat 71,2023-08-07,22:00:00,16,14,2,FMN GV 11 Ramsel
66,Bergstraat 71,2023-08-07,23:00:00,6,6,0,FMN GV 11 Ramsel
66,Bergstraat 71,2023-08-08,00:00:00,8,4,4,FMN GV 11 Ramsel
66,Bergstraat 71,2023-08-08,01:00:00,4,2,2,FMN GV 11 Ramsel
66,Bergstraat 71,2023-08-08,02:00:00,4,0,4,FMN GV 11 Ramsel
66,Bergstraat 71,2023-08-08,03:00:00,2,2,0,FMN GV 11 Ramsel
66,Bergstraat 71,2023-08-08,04:00:00,4,4,0,FMN GV 11 Ramsel
66,Bergstraat 71,2023-08-08,05:00:00,22,8,14,FMN GV 11 Ramsel
66,Bergstraat 71,2023-08-08,06:00:00,46,16,30,FMN GV 11 Ramsel
66,Bergstraat 71,2023-08-08,07:00:00,80,24,56,FMN GV 11 Ramsel
66,Bergstraat 71,2023-08-08,08:00:00,56,18,38,FMN GV 11 Ramsel
66,Bergstraat 71,2023-08-08,09:00:00,60,18,42,FMN GV 11 Ramsel
66,Bergstraat 71,2023-08-08,10:00:00,90,40,50,FMN GV 11 Ramsel
66,Bergstraat 71,2023-08-08,11:00:00,84,40,44,FMN GV 11 Ramsel
66,Bergstraat 71,2023-08-08,12:00:00,82,36,46,FMN GV 11 Ramsel
66,Bergstraat 71,2023-08-08,13:00:00,146,66,80,FMN GV 11 Ramsel
66,Bergstraat 71,2023-08-08,14:00:00,126,66,60,FMN GV 11 Ramsel
66,Bergstraat 71,2023-08-08,15:00:00,146,98,48,FMN GV 11 Ramsel
66,Bergstraat 71,2023-08-08,16:00:00,176,114,62,FMN GV 11 Ramsel
66,Bergstraat 71,2023-08-08,17:00:00,162,98,64,FMN GV 11 Ramsel
66,Bergstraat 71,2023-08-08,18:00:00,112,70,42,FMN GV 11 Ramsel
66,Bergstraat 71,2023-08-08,19:00:00,50,26,24,FMN GV 11 Ramsel
66,Bergstraat 71,2023-08-08,20:00:00,24,18,6,FMN GV 11 Ramsel
66,Bergstraat 71,2023-08-08,21:00:00,16,14,2,FMN GV 11 Ramsel
66,Bergstraat 71,2023-08-08,22:00:00,16,16,0,FMN GV 11 Ramsel
66,Bergstraat 71,2023-08-08,23:00:00,16,10,6,FMN GV 11 Ramsel
66,Bergstraat 71,2023-08-09,00:00:00,4,4,0,FMN GV 11 Ramsel
66,Bergstraat 71,2023-08-09,01:00:00,4,4,0,FMN GV 11 Ramsel
66,Bergstraat 71,2023-08-09,02:00:00,0,0,0,FMN GV 11 Ramsel
66,Bergstraat 71,2023-08-09,03:00:00,0,0,0,FMN GV 11 Ramsel
66,Bergstraat 71,2023-08-09,04:00:00,4,2,2,FMN GV 11 Ramsel
66,Bergstraat 71,2023-08-09,05:00:00,16,4,12,FMN GV 11 Ramsel
66,Bergstraat 71,2023-08-09,06:00:00,28,12,16,FMN GV 11 Ramsel
66,Bergstraat 71,2023-08-09,07:00:00,52,18,34,FMN GV 11 Ramsel
66,Bergstraat 71,2023-08-09,08:00:00,56,18,38,FMN GV 11 Ramsel
66,Bergstraat 71,2023-08-09,09:00:00,54,26,28,FMN GV 11 Ramsel
66,Bergstraat 71,2023-08-09,10:00:00,104,36,68,FMN GV 11 Ramsel
66,Bergstraat 71,2023-08-09,11:00:00,110,58,52,FMN GV 11 Ramsel
66,Bergstraat 71,2023-08-09,12:00:00,122,56,66,FMN GV 11 Ramsel
66,Bergstraat 71,2023-08-09,13:00:00,282,92,190,FMN GV 11 Ramsel
66,Bergstraat 71,2023-08-09,14:00:00,302,148,154,FMN GV 11 Ramsel
66,Bergstraat 71,2023-08-09,15:00:00,270,158,112,FMN GV 11 Ramsel
66,Bergstraat 71,2023-08-09,16:00:00,210,126,84,FMN GV 11 Ramsel
66,Bergstraat 71,2023-08-09,17:00:00,168,90,78,FMN GV 11 Ramsel
66,Bergstraat 71,2023-08-09,18:00:00,132,58,74,FMN GV 11 Ramsel
66,Bergstraat 71,2023-08-09,19:00:00,152,82,70,FMN GV 11 Ramsel
66,Bergstraat 71,2023-08-09,20:00:00,92,64,28,FMN GV 11 Ramsel
66,Bergstraat 71,2023-08-09,21:00:00,46,40,6,FMN GV 11 Ramsel
66,Bergstraat 71,2023-08-09,22:00:00,24,14,10,FMN GV 11 Ramsel
66,Bergstraat 71,2023-08-09,23:00:00,2,2,0,FMN GV 11 Ramsel
66,Bergstraat 71,2023-08-10,00:00:00,2,2,0,FMN GV 11 Ramsel
66,Bergstraat 71,2023-08-10,01:00:00,2,2,0,FMN GV 11 Ramsel
66,Bergstraat 71,2023-08-10,02:00:00,2,0,2,FMN GV 11 Ramsel
66,Bergstraat 71,2023-08-10,03:00:00,2,0,2,FMN GV 11 Ramsel
66,Bergstraat 71,2023-08-10,04:00:00,2,2,0,FMN GV 11 Ramsel
66,Bergstraat 71,2023-08-10,05:00:00,16,6,10,FMN GV 11 Ramsel
66,Bergstraat 71,2023-08-10,06:00:00,60,26,34,FMN GV 11 Ramsel
66,Bergstraat 71,2023-08-10,07:00:00,72,30,42,FMN GV 11 Ramsel
66,Bergstraat 71,2023-08-10,08:00:00,64,14,50,FMN GV 11 Ramsel
66,Bergstraat 71,2023-08-10,09:00:00,96,34,62,FMN GV 11 Ramsel
66,Bergstraat 71,2023-08-10,10:00:00,134,64,70,FMN GV 11 Ramsel
66,Bergstraat 71,2023-08-10,11:00:00,154,66,88,FMN GV 11 Ramsel
66,Bergstraat 71,2023-08-10,12:00:00,210,106,104,FMN GV 11 Ramsel
66,Bergstraat 71,2023-08-10,13:00:00,316,170,146,FMN GV 11 Ramsel
66,Bergstraat 71,2023-08-10,14:00:00,294,158,136,FMN GV 11 Ramsel
66,Bergstraat 71,2023-08-10,15:00:00,314,212,102,FMN GV 11 Ramsel
66,Bergstraat 71,2023-08-10,16:00:00,262,150,112,FMN GV 11 Ramsel
66,Bergstraat 71,2023-08-10,17:00:00,198,112,86,FMN GV 11 Ramsel
66,Bergstraat 71,2023-08-10,18:00:00,132,78,54,FMN GV 11 Ramsel
66,Bergstraat 71,2023-08-10,19:00:00,152,88,64,FMN GV 11 Ramsel
66,Bergstraat 71,2023-08-10,20:00:00,100,70,30,FMN GV 11 Ramsel
66,Bergstraat 71,2023-08-10,21:00:00,80,62,18,FMN GV 11 Ramsel
66,Bergstraat 71,2023-08-10,22:00:00,30,22,8,FMN GV 11 Ramsel
66,Bergstraat 71,2023-08-10,23:00:00,4,4,0,FMN GV 11 Ramsel
66,Bergstraat 71,2023-08-11,00:00:00,4,4,0,FMN GV 11 Ramsel
66,Bergstraat 71,2023-08-11,01:00:00,0,0,0,FMN GV 11 Ramsel
66,Bergstraat 71,2023-08-11,02:00:00,0,0,0,FMN GV 11 Ramsel
66,Bergstraat 71,2023-08-11,03:00:00,0,0,0,FMN GV 11 Ramsel
66,Bergstraat 71,2023-08-11,04:00:00,6,6,0,FMN GV 11 Ramsel
66,Bergstraat 71,2023-08-11,05:00:00,16,6,10,FMN GV 11 Ramsel
66,Bergstraat 71,2023-08-11,06:00:00,28,6,22,FMN GV 11 Ramsel
66,Bergstraat 71,2023-08-11,07:00:00,56,22,34,FMN GV 11 Ramsel
66,Bergstraat 71,2023-08-11,08:00:00,56,24,32,FMN GV 11 Ramsel
66,Bergstraat 71,2023-08-11,09:00:00,98,46,52,FMN GV 11 Ramsel
66,Bergstraat 71,2023-08-11,10:00:00,150,58,92,FMN GV 11 Ramsel
66,Bergstraat 71,2023-08-11,11:00:00,252,160,92,FMN GV 11 Ramsel
66,Bergstraat 71,2023-08-11,12:00:00,164,100,64,FMN GV 11 Ramsel
66,Bergstraat 71,2023-08-11,13:00:00,228,114,114,FMN GV 11 Ramsel
66,Bergstraat 71,2023-08-11,14:00:00,222,94,128,FMN GV 11 Ramsel
66,Bergstraat 71,2023-08-11,15:00:00,314,198,116,FMN GV 11 Ramsel
66,Bergstraat 71,2023-08-11,16:00:00,302,214,88,FMN GV 11 Ramsel
66,Bergstraat 71,2023-08-11,17:00:00,122,70,52,FMN GV 11 Ramsel
66,Bergstraat 71,2023-08-11,18:00:00,128,76,52,FMN GV 11 Ramsel
66,Bergstraat 71,2023-08-11,19:00:00,64,24,40,FMN GV 11 Ramsel
66,Bergstraat 71,2023-08-11,20:00:00,42,26,16,FMN GV 11 Ramsel
66,Bergstraat 71,2023-08-11,21:00:00,20,10,10,FMN GV 11 Ramsel
66,Bergstraat 71,2023-08-11,22:00:00,16,12,4,FMN GV 11 Ramsel
66,Bergstraat 71,2023-08-11,23:00:00,16,10,6,FMN GV 11 Ramsel
66,Bergstraat 71,2023-08-12,00:00:00,12,6,6,FMN GV 11 Ramsel
66,Bergstraat 71,2023-08-12,01:00:00,14,14,0,FMN GV 11 Ramsel
66,Bergstraat 71,2023-08-12,02:00:00,4,4,0,FMN GV 11 Ramsel
66,Bergstraat 71,2023-08-12,03:00:00,0,0,0,FMN GV 11 Ramsel
66,Bergstraat 71,2023-08-12,04:00:00,12,4,8,FMN GV 11 Ramsel
66,Bergstraat 71,2023-08-12,05:00:00,0,0,0,FMN GV 11 Ramsel
66,Bergstraat 71,2023-08-12,06:00:00,2,0,2,FMN GV 11 Ramsel
66,Bergstraat 71,2023-08-12,07:00:00,6,2,4,FMN GV 11 Ramsel
66,Bergstraat 71,2023-08-12,08:00:00,20,8,12,FMN GV 11 Ramsel
66,Bergstraat 71,2023-08-12,09:00:00,34,14,20,FMN GV 11 Ramsel
66,Bergstraat 71,2023-08-12,10:00:00,24,14,10,FMN GV 11 Ramsel
66,Bergstraat 71,2023-08-12,11:00:00,64,26,38,FMN GV 11 Ramsel
66,Bergstraat 71,2023-08-12,12:00:00,60,28,32,FMN GV 11 Ramsel
66,Bergstraat 71,2023-08-12,13:00:00,88,34,54,FMN GV 11 Ramsel
66,Bergstraat 71,2023-08-12,14:00:00,200,78,122,FMN GV 11 Ramsel
66,Bergstraat 71,2023-08-12,15:00:00,194,88,106,FMN GV 11 Ramsel
66,Bergstraat 71,2023-08-12,16:00:00,144,96,48,FMN GV 11 Ramsel
66,Bergstraat 71,2023-08-12,17:00:00,128,66,62,FMN GV 11 Ramsel
66,Bergstraat 71,2023-08-12,18:00:00,82,38,44,FMN GV 11 Ramsel
66,Bergstraat 71,2023-08-12,19:00:00,62,42,20,FMN GV 11 Ramsel
66,Bergstraat 71,2023-08-12,20:00:00,76,50,26,FMN GV 11 Ramsel
66,Bergstraat 71,2023-08-12,21:00:00,36,22,14,FMN GV 11 Ramsel
66,Bergstraat 71,2023-08-12,22:00:00,16,10,6,FMN GV 11 Ramsel
66,Bergstraat 71,2023-08-12,23:00:00,6,6,0,FMN GV 11 Ramsel
66,Bergstraat 71,2023-08-13,00:00:00,8,6,2,FMN GV 11 Ramsel
66,Bergstraat 71,2023-08-13,01:00:00,6,2,4,FMN GV 11 Ramsel
66,Bergstraat 71,2023-08-13,02:00:00,6,2,4,FMN GV 11 Ramsel
66,Bergstraat 71,2023-08-13,03:00:00,0,0,0,FMN GV 11 Ramsel
66,Bergstraat 71,2023-08-13,04:00:00,4,4,0,FMN GV 11 Ramsel
66,Bergstraat 71,2023-08-13,05:00:00,4,2,2,FMN GV 11 Ramsel
66,Bergstraat 71,2023-08-13,06:00:00,6,6,0,FMN GV 11 Ramsel
66,Bergstraat 71,2023-08-13,07:00:00,30,4,26,FMN GV 11 Ramsel
66,Bergstraat 71,2023-08-13,08:00:00,70,6,64,FMN GV 11 Ramsel
66,Bergstraat 71,2023-08-13,09:00:00,152,40,112,FMN GV 11 Ramsel
66,Bergstraat 71,2023-08-13,10:00:00,216,58,158,FMN GV 11 Ramsel
66,Bergstraat 71,2023-08-13,11:00:00,340,156,184,FMN GV 11 Ramsel
66,Bergstraat 71,2023-08-13,12:00:00,302,102,200,FMN GV 11 Ramsel
66,Bergstraat 71,2023-08-13,13:00:00,354,92,262,FMN GV 11 Ramsel
66,Bergstraat 71,2023-08-13,14:00:00,444,160,284,FMN GV 11 Ramsel
66,Bergstraat 71,2023-08-13,15:00:00,358,134,224,FMN GV 11 Ramsel
66,Bergstraat 71,2023-08-13,16:00:00,260,136,124,FMN GV 11 Ramsel
66,Bergstraat 71,2023-08-13,17:00:00,172,74,98,FMN GV 11 Ramsel
66,Bergstraat 71,2023-08-13,18:00:00,150,74,76,FMN GV 11 Ramsel
66,Bergstraat 71,2023-08-13,19:00:00,66,24,42,FMN GV 11 Ramsel
66,Bergstraat 71,2023-08-13,20:00:00,40,18,22,FMN GV 11 Ramsel
66,Bergstraat 71,2023-08-13,21:00:00,24,16,8,FMN GV 11 Ramsel
66,Bergstraat 71,2023-08-13,22:00:00,8,8,0,FMN GV 11 Ramsel
66,Bergstraat 71,2023-08-13,23:00:00,14,8,6,FMN GV 11 Ramsel
66,Bergstraat 71,2023-08-14,00:00:00,2,2,0,FMN GV 11 Ramsel
66,Bergstraat 71,2023-08-14,01:00:00,2,2,0,FMN GV 11 Ramsel
66,Bergstraat 71,2023-08-14,02:00:00,0,0,0,FMN GV 11 Ramsel
66,Bergstraat 71,2023-08-14,03:00:00,2,2,0,FMN GV 11 Ramsel
66,Bergstraat 71,2023-08-14,04:00:00,2,0,2,FMN GV 11 Ramsel
66,Bergstraat 71,2023-08-14,05:00:00,8,2,6,FMN GV 11 Ramsel
66,Bergstraat 71,2023-08-14,06:00:00,12,4,8,FMN GV 11 Ramsel
66,Bergstraat 71,2023-08-14,07:00:00,28,6,22,FMN GV 11 Ramsel
66,Bergstraat 71,2023-08-14,08:00:00,42,20,22,FMN GV 11 Ramsel
66,Bergstraat 71,2023-08-14,09:00:00,70,20,50,FMN GV 11 Ramsel
66,Bergstraat 71,2023-08-14,10:00:00,122,44,78,FMN GV 11 Ramsel
66,Bergstraat 71,2023-08-14,11:00:00,212,114,98,FMN GV 11 Ramsel
66,Bergstraat 71,2023-08-14,12:00:00,174,102,72,FMN GV 11 Ramsel
66,Bergstraat 71,2023-08-14,13:00:00,304,140,164,FMN GV 11 Ramsel
66,Bergstraat 71,2023-08-14,14:00:00,318,144,174,FMN GV 11 Ramsel
66,Bergstraat 71,2023-08-14,15:00:00,196,120,76,FMN GV 11 Ramsel
66,Bergstraat 71,2023-08-14,16:00:00,280,168,112,FMN GV 11 Ramsel
66,Bergstraat 71,2023-08-14,17:00:00,178,92,86,FMN GV 11 Ramsel
66,Bergstraat 71,2023-08-14,18:00:00,118,68,50,FMN GV 11 Ramsel
66,Bergstraat 71,2023-08-14,19:00:00,96,44,52,FMN GV 11 Ramsel
66,Bergstraat 71,2023-08-14,20:00:00,66,42,24,FMN GV 11 Ramsel
66,Bergstraat 71,2023-08-14,21:00:00,38,14,24,FMN GV 11 Ramsel
66,Bergstraat 71,2023-08-14,22:00:00,10,6,4,FMN GV 11 Ramsel
66,Bergstraat 71,2023-08-14,23:00:00,12,10,2,FMN GV 11 Ramsel
66,Bergstraat 71,2023-08-15,00:00:00,2,2,0,FMN GV 11 Ramsel
66,Bergstraat 71,2023-08-15,01:00:00,8,8,0,FMN GV 11 Ramsel
66,Bergstraat 71,2023-08-15,02:00:00,6,4,2,FMN GV 11 Ramsel
66,Bergstraat 71,2023-08-15,03:00:00,4,0,4,FMN GV 11 Ramsel
66,Bergstraat 71,2023-08-15,04:00:00,0,0,0,FMN GV 11 Ramsel
66,Bergstraat 71,2023-08-15,05:00:00,2,2,0,FMN GV 11 Ramsel
66,Bergstraat 71,2023-08-15,06:00:00,8,2,6,FMN GV 11 Ramsel
66,Bergstraat 71,2023-08-15,07:00:00,34,2,32,FMN GV 11 Ramsel
66,Bergstraat 71,2023-08-15,08:00:00,74,36,38,FMN GV 11 Ramsel
66,Bergstraat 71,2023-08-15,09:00:00,116,56,60,FMN GV 11 Ramsel
66,Bergstraat 71,2023-08-15,10:00:00,274,140,134,FMN GV 11 Ramsel
66,Bergstraat 71,2023-08-15,11:00:00,192,86,106,FMN GV 11 Ramsel
66,Bergstraat 71,2023-08-15,12:00:00,266,146,120,FMN GV 11 Ramsel
66,Bergstraat 71,2023-08-15,13:00:00,278,142,136,FMN GV 11 Ramsel
66,Bergstraat 71,2023-08-15,14:00:00,376,180,196,FMN GV 11 Ramsel
66,Bergstraat 71,2023-08-15,15:00:00,396,196,200,FMN GV 11 Ramsel
66,Bergstraat 71,2023-08-15,16:00:00,364,202,162,FMN GV 11 Ramsel
66,Bergstraat 71,2023-08-15,17:00:00,194,84,110,FMN GV 11 Ramsel
66,Bergstraat 71,2023-08-15,18:00:00,186,86,100,FMN GV 11 Ramsel
66,Bergstraat 71,2023-08-15,19:00:00,184,72,112,FMN GV 11 Ramsel
66,Bergstraat 71,2023-08-15,20:00:00,200,56,144,FMN GV 11 Ramsel
66,Bergstraat 71,2023-08-15,21:00:00,84,20,64,FMN GV 11 Ramsel
66,Bergstraat 71,2023-08-15,22:00:00,86,72,14,FMN GV 11 Ramsel
66,Bergstraat 71,2023-08-15,23:00:00,68,64,4,FMN GV 11 Ramsel
66,Bergstraat 71,2023-08-16,00:00:00,88,70,18,FMN GV 11 Ramsel
66,Bergstraat 71,2023-08-16,01:00:00,22,20,2,FMN GV 11 Ramsel
66,Bergstraat 71,2023-08-16,02:00:00,20,20,0,FMN GV 11 Ramsel
66,Bergstraat 71,2023-08-16,03:00:00,8,4,4,FMN GV 11 Ramsel
66,Bergstraat 71,2023-08-16,04:00:00,16,12,4,FMN GV 11 Ramsel
66,Bergstraat 71,2023-08-16,05:00:00,28,6,22,FMN GV 11 Ramsel
66,Bergstraat 71,2023-08-16,06:00:00,32,16,16,FMN GV 11 Ramsel
66,Bergstraat 71,2023-08-16,07:00:00,64,20,44,FMN GV 11 Ramsel
66,Bergstraat 71,2023-08-16,08:00:00,56,20,36,FMN GV 11 Ramsel
66,Bergstraat 71,2023-08-16,09:00:00,76,28,48,FMN GV 11 Ramsel
66,Bergstraat 71,2023-08-16,10:00:00,160,54,106,FMN GV 11 Ramsel
66,Bergstraat 71,2023-08-16,11:00:00,104,46,58,FMN GV 11 Ramsel
66,Bergstraat 71,2023-08-16,12:00:00,86,40,46,FMN GV 11 Ramsel
66,Bergstraat 71,2023-08-16,13:00:00,140,68,72,FMN GV 11 Ramsel
66,Bergstraat 71,2023-08-16,14:00:00,212,112,100,FMN GV 11 Ramsel
66,Bergstraat 71,2023-08-16,15:00:00,236,110,126,FMN GV 11 Ramsel
66,Bergstraat 71,2023-08-16,16:00:00,208,110,98,FMN GV 11 Ramsel
66,Bergstraat 71,2023-08-16,17:00:00,164,102,62,FMN GV 11 Ramsel
66,Bergstraat 71,2023-08-16,18:00:00,166,78,88,FMN GV 11 Ramsel
66,Bergstraat 71,2023-08-16,19:00:00,98,48,50,FMN GV 11 Ramsel
66,Bergstraat 71,2023-08-16,20:00:00,68,30,38,FMN GV 11 Ramsel
66,Bergstraat 71,2023-08-16,21:00:00,30,28,2,FMN GV 11 Ramsel
66,Bergstraat 71,2023-08-16,22:00:00,14,12,2,FMN GV 11 Ramsel
66,Bergstraat 71,2023-08-16,23:00:00,2,0,2,FMN GV 11 Ramsel
66,Bergstraat 71,2023-08-17,00:00:00,2,2,0,FMN GV 11 Ramsel
66,Bergstraat 71,2023-08-17,01:00:00,0,0,0,FMN GV 11 Ramsel
66,Bergstraat 71,2023-08-17,02:00:00,0,0,0,FMN GV 11 Ramsel
66,Bergstraat 71,2023-08-17,03:00:00,0,0,0,FMN GV 11 Ramsel
66,Bergstraat 71,2023-08-17,04:00:00,6,2,4,FMN GV 11 Ramsel
66,Bergstraat 71,2023-08-17,05:00:00,26,8,18,FMN GV 11 Ramsel
66,Bergstraat 71,2023-08-17,06:00:00,36,20,16,FMN GV 11 Ramsel
66,Bergstraat 71,2023-08-17,07:00:00,56,16,40,FMN GV 11 Ramsel
66,Bergstraat 71,2023-08-17,08:00:00,60,18,42,FMN GV 11 Ramsel
66,Bergstraat 71,2023-08-17,09:00:00,92,40,52,FMN GV 11 Ramsel
66,Bergstraat 71,2023-08-17,10:00:00,80,42,38,FMN GV 11 Ramsel
66,Bergstraat 71,2023-08-17,11:00:00,112,62,50,FMN GV 11 Ramsel
66,Bergstraat 71,2023-08-17,12:00:00,104,42,62,FMN GV 11 Ramsel
66,Bergstraat 71,2023-08-17,13:00:00,182,76,106,FMN GV 11 Ramsel
66,Bergstraat 71,2023-08-17,14:00:00,182,80,102,FMN GV 11 Ramsel
66,Bergstraat 71,2023-08-17,15:00:00,164,94,70,FMN GV 11 Ramsel
66,Bergstraat 71,2023-08-17,16:00:00,170,74,96,FMN GV 11 Ramsel
66,Bergstraat 71,2023-08-17,17:00:00,108,62,46,FMN GV 11 Ramsel
66,Bergstraat 71,2023-08-17,18:00:00,132,82,50,FMN GV 11 Ramsel
66,Bergstraat 71,2023-08-17,19:00:00,66,38,28,FMN GV 11 Ramsel
66,Bergstraat 71,2023-08-17,20:00:00,58,28,30,FMN GV 11 Ramsel
66,Bergstraat 71,2023-08-17,21:00:00,28,12,16,FMN GV 11 Ramsel
66,Bergstraat 71,2023-08-17,22:00:00,44,38,6,FMN GV 11 Ramsel
66,Bergstraat 71,2023-08-17,23:00:00,16,14,2,FMN GV 11 Ramsel
66,Bergstraat 71,2023-08-18,00:00:00,2,2,0,FMN GV 11 Ramsel
66,Bergstraat 71,2023-08-18,01:00:00,2,2,0,FMN GV 11 Ramsel
66,Bergstraat 71,2023-08-18,02:00:00,8,0,8,FMN GV 11 Ramsel
66,Bergstraat 71,2023-08-18,03:00:00,0,0,0,FMN GV 11 Ramsel
66,Bergstraat 71,2023-08-18,04:00:00,4,2,2,FMN GV 11 Ramsel
66,Bergstraat 71,2023-08-18,05:00:00,16,8,8,FMN GV 11 Ramsel
66,Bergstraat 71,2023-08-18,06:00:00,26,16,10,FMN GV 11 Ramsel
66,Bergstraat 71,2023-08-18,07:00:00,60,24,36,FMN GV 11 Ramsel
66,Bergstraat 71,2023-08-18,08:00:00,46,20,26,FMN GV 11 Ramsel
66,Bergstraat 71,2023-08-18,09:00:00,62,26,36,FMN GV 11 Ramsel
66,Bergstraat 71,2023-08-18,10:00:00,74,28,46,FMN GV 11 Ramsel
66,Bergstraat 71,2023-08-18,11:00:00,114,72,42,FMN GV 11 Ramsel
66,Bergstraat 71,2023-08-18,12:00:00,100,40,60,FMN GV 11 Ramsel
66,Bergstraat 71,2023-08-18,13:00:00,200,82,118,FMN GV 11 Ramsel
66,Bergstraat 71,2023-08-18,14:00:00,202,96,106,FMN GV 11 Ramsel
66,Bergstraat 71,2023-08-18,15:00:00,218,124,94,FMN GV 11 Ramsel
66,Bergstraat 71,2023-08-18,16:00:00,164,82,82,FMN GV 11 Ramsel
66,Bergstraat 71,2023-08-18,17:00:00,150,84,66,FMN GV 11 Ramsel
66,Bergstraat 71,2023-08-18,18:00:00,144,96,48,FMN GV 11 Ramsel
66,Bergstraat 71,2023-08-18,19:00:00,94,50,44,FMN GV 11 Ramsel
66,Bergstraat 71,2023-08-18,20:00:00,60,36,24,FMN GV 11 Ramsel
66,Bergstraat 71,2023-08-18,21:00:00,54,24,30,FMN GV 11 Ramsel
66,Bergstraat 71,2023-08-18,22:00:00,44,32,12,FMN GV 11 Ramsel
66,Bergstraat 71,2023-08-18,23:00:00,26,20,6,FMN GV 11 Ramsel
66,Bergstraat 71,2023-08-19,00:00:00,16,4,12,FMN GV 11 Ramsel
66,Bergstraat 71,2023-08-19,01:00:00,12,2,10,FMN GV 11 Ramsel
66,Bergstraat 71,2023-08-19,02:00:00,16,6,10,FMN GV 11 Ramsel
66,Bergstraat 71,2023-08-19,03:00:00,2,2,0,FMN GV 11 Ramsel
66,Bergstraat 71,2023-08-19,04:00:00,0,0,0,FMN GV 11 Ramsel
66,Bergstraat 71,2023-08-19,05:00:00,4,2,2,FMN GV 11 Ramsel
66,Bergstraat 71,2023-08-19,06:00:00,14,4,10,FMN GV 11 Ramsel
66,Bergstraat 71,2023-08-19,07:00:00,22,6,16,FMN GV 11 Ramsel
66,Bergstraat 71,2023-08-19,08:00:00,42,16,26,FMN GV 11 Ramsel
66,Bergstraat 71,2023-08-19,09:00:00,70,30,40,FMN GV 11 Ramsel
66,Bergstraat 71,2023-08-19,10:00:00,126,62,64,FMN GV 11 Ramsel
66,Bergstraat 71,2023-08-19,11:00:00,154,68,86,FMN GV 11 Ramsel
66,Bergstraat 71,2023-08-19,12:00:00,114,48,66,FMN GV 11 Ramsel
66,Bergstraat 71,2023-08-19,13:00:00,98,54,44,FMN GV 11 Ramsel
66,Bergstraat 71,2023-08-19,14:00:00,162,64,98,FMN GV 11 Ramsel
66,Bergstraat 71,2023-08-19,15:00:00,130,58,72,FMN GV 11 Ramsel
66,Bergstraat 71,2023-08-19,16:00:00,220,122,98,FMN GV 11 Ramsel
66,Bergstraat 71,2023-08-19,17:00:00,92,54,38,FMN GV 11 Ramsel
66,Bergstraat 71,2023-08-19,18:00:00,108,60,48,FMN GV 11 Ramsel
66,Bergstraat 71,2023-08-19,19:00:00,86,28,58,FMN GV 11 Ramsel
66,Bergstraat 71,2023-08-19,20:00:00,76,16,60,FMN GV 11 Ramsel
66,Bergstraat 71,2023-08-19,21:00:00,52,38,14,FMN GV 11 Ramsel
66,Bergstraat 71,2023-08-19,22:00:00,4,2,2,FMN GV 11 Ramsel
66,Bergstraat 71,2023-08-19,23:00:00,12,6,6,FMN GV 11 Ramsel
66,Bergstraat 71,2023-08-20,00:00:00,6,4,2,FMN GV 11 Ramsel
66,Bergstraat 71,2023-08-20,01:00:00,8,8,0,FMN GV 11 Ramsel
66,Bergstraat 71,2023-08-20,02:00:00,6,6,0,FMN GV 11 Ramsel
66,Bergstraat 71,2023-08-20,03:00:00,0,0,0,FMN GV 11 Ramsel
66,Bergstraat 71,2023-08-20,04:00:00,4,4,0,FMN GV 11 Ramsel
66,Bergstraat 71,2023-08-20,05:00:00,0,0,0,FMN GV 11 Ramsel
66,Bergstraat 71,2023-08-20,06:00:00,10,8,2,FMN GV 11 Ramsel
66,Bergstraat 71,2023-08-20,07:00:00,20,6,14,FMN GV 11 Ramsel
66,Bergstraat 71,2023-08-20,08:00:00,84,42,42,FMN GV 11 Ramsel
66,Bergstraat 71,2023-08-20,09:00:00,210,88,122,FMN GV 11 Ramsel
66,Bergstraat 71,2023-08-20,10:00:00,286,118,168,FMN GV 11 Ramsel
66,Bergstraat 71,2023-08-20,11:00:00,212,104,108,FMN GV 11 Ramsel
66,Bergstraat 71,2023-08-20,12:00:00,262,114,148,FMN GV 11 Ramsel
66,Bergstraat 71,2023-08-20,13:00:00,330,152,178,FMN GV 11 Ramsel
66,Bergstraat 71,2023-08-20,14:00:00,376,154,222,FMN GV 11 Ramsel
66,Bergstraat 71,2023-08-20,15:00:00,268,124,144,FMN GV 11 Ramsel
66,Bergstraat 71,2023-08-20,16:00:00,318,188,130,FMN GV 11 Ramsel
66,Bergstraat 71,2023-08-20,17:00:00,236,130,106,FMN GV 11 Ramsel
66,Bergstraat 71,2023-08-20,18:00:00,182,94,88,FMN GV 11 Ramsel
66,Bergstraat 71,2023-08-20,19:00:00,138,58,80,FMN GV 11 Ramsel
66,Bergstraat 71,2023-08-20,20:00:00,112,74,38,FMN GV 11 Ramsel
66,Bergstraat 71,2023-08-20,21:00:00,52,20,32,FMN GV 11 Ramsel
66,Bergstraat 71,2023-08-20,22:00:00,12,12,0,FMN GV 11 Ramsel
66,Bergstraat 71,2023-08-20,23:00:00,20,10,10,FMN GV 11 Ramsel
66,Bergstraat 71,2023-08-21,00:00:00,4,4,0,FMN GV 11 Ramsel
66,Bergstraat 71,2023-08-21,01:00:00,4,4,0,FMN GV 11 Ramsel
66,Bergstraat 71,2023-08-21,02:00:00,0,0,0,FMN GV 11 Ramsel
66,Bergstraat 71,2023-08-21,03:00:00,2,2,0,FMN GV 11 Ramsel
66,Bergstraat 71,2023-08-21,04:00:00,6,6,0,FMN GV 11 Ramsel
66,Bergstraat 71,2023-08-21,05:00:00,26,10,16,FMN GV 11 Ramsel
66,Bergstraat 71,2023-08-21,06:00:00,46,26,20,FMN GV 11 Ramsel
66,Bergstraat 71,2023-08-21,07:00:00,60,18,42,FMN GV 11 Ramsel
66,Bergstraat 71,2023-08-21,08:00:00,80,26,54,FMN GV 11 Ramsel
66,Bergstraat 71,2023-08-21,09:00:00,116,50,66,FMN GV 11 Ramsel
66,Bergstraat 71,2023-08-21,10:00:00,76,38,38,FMN GV 11 Ramsel
66,Bergstraat 71,2023-08-21,11:00:00,104,56,48,FMN GV 11 Ramsel
66,Bergstraat 71,2023-08-21,12:00:00,124,52,72,FMN GV 11 Ramsel
66,Bergstraat 71,2023-08-21,13:00:00,198,96,102,FMN GV 11 Ramsel
66,Bergstraat 71,2023-08-21,14:00:00,232,118,114,FMN GV 11 Ramsel
66,Bergstraat 71,2023-08-21,15:00:00,176,100,76,FMN GV 11 Ramsel
66,Bergstraat 71,2023-08-21,16:00:00,228,140,88,FMN GV 11 Ramsel
66,Bergstraat 71,2023-08-21,17:00:00,194,120,74,FMN GV 11 Ramsel
66,Bergstraat 71,2023-08-21,18:00:00,142,68,74,FMN GV 11 Ramsel
66,Bergstraat 71,2023-08-21,19:00:00,100,68,32,FMN GV 11 Ramsel
66,Bergstraat 71,2023-08-21,20:00:00,60,30,30,FMN GV 11 Ramsel
66,Bergstraat 71,2023-08-21,21:00:00,48,24,24,FMN GV 11 Ramsel
66,Bergstraat 71,2023-08-21,22:00:00,26,20,6,FMN GV 11 Ramsel
66,Bergstraat 71,2023-08-21,23:00:00,14,10,4,FMN GV 11 Ramsel
66,Bergstraat 71,2023-08-22,00:00:00,4,0,4,FMN GV 11 Ramsel
66,Bergstraat 71,2023-08-22,01:00:00,0,0,0,FMN GV 11 Ramsel
66,Bergstraat 71,2023-08-22,02:00:00,0,0,0,FMN GV 11 Ramsel
66,Bergstraat 71,2023-08-22,03:00:00,0,0,0,FMN GV 11 Ramsel
66,Bergstraat 71,2023-08-22,04:00:00,8,6,2,FMN GV 11 Ramsel
66,Bergstraat 71,2023-08-22,05:00:00,18,8,10,FMN GV 11 Ramsel
66,Bergstraat 71,2023-08-22,06:00:00,46,20,26,FMN GV 11 Ramsel
66,Bergstraat 71,2023-08-22,07:00:00,98,32,66,FMN GV 11 Ramsel
66,Bergstraat 71,2023-08-22,08:00:00,104,38,66,FMN GV 11 Ramsel
66,Bergstraat 71,2023-08-22,09:00:00,98,30,68,FMN GV 11 Ramsel
66,Bergstraat 71,2023-08-22,10:00:00,176,84,92,FMN GV 11 Ramsel
66,Bergstraat 71,2023-08-22,11:00:00,172,90,82,FMN GV 11 Ramsel
66,Bergstraat 71,2023-08-22,12:00:00,148,80,68,FMN GV 11 Ramsel
66,Bergstraat 71,2023-08-22,13:00:00,338,202,136,FMN GV 11 Ramsel
66,Bergstraat 71,2023-08-22,14:00:00,262,144,118,FMN GV 11 Ramsel
66,Bergstraat 71,2023-08-22,15:00:00,220,102,118,FMN GV 11 Ramsel
66,Bergstraat 71,2023-08-22,16:00:00,272,166,106,FMN GV 11 Ramsel
66,Bergstraat 71,2023-08-22,17:00:00,256,120,136,FMN GV 11 Ramsel
66,Bergstraat 71,2023-08-22,18:00:00,170,84,86,FMN GV 11 Ramsel
66,Bergstraat 71,2023-08-22,19:00:00,142,62,80,FMN GV 11 Ramsel
66,Bergstraat 71,2023-08-22,20:00:00,92,40,52,FMN GV 11 Ramsel
66,Bergstraat 71,2023-08-22,21:00:00,58,42,16,FMN GV 11 Ramsel
66,Bergstraat 71,2023-08-22,22:00:00,22,14,8,FMN GV 11 Ramsel
66,Bergstraat 71,2023-08-22,23:00:00,16,10,6,FMN GV 11 Ramsel
66,Bergstraat 71,2023-08-23,00:00:00,4,4,0,FMN GV 11 Ramsel
66,Bergstraat 71,2023-08-23,01:00:00,2,2,0,FMN GV 11 Ramsel
66,Bergstraat 71,2023-08-23,02:00:00,0,0,0,FMN GV 11 Ramsel
66,Bergstraat 71,2023-08-23,03:00:00,2,0,2,FMN GV 11 Ramsel
66,Bergstraat 71,2023-08-23,04:00:00,8,6,2,FMN GV 11 Ramsel
66,Bergstraat 71,2023-08-23,05:00:00,20,8,12,FMN GV 11 Ramsel
66,Bergstraat 71,2023-08-23,06:00:00,52,32,20,FMN GV 11 Ramsel
66,Bergstraat 71,2023-08-23,07:00:00,64,16,48,FMN GV 11 Ramsel
66,Bergstraat 71,2023-08-23,08:00:00,84,34,50,FMN GV 11 Ramsel
66,Bergstraat 71,2023-08-23,09:00:00,140,52,88,FMN GV 11 Ramsel
66,Bergstraat 71,2023-08-23,10:00:00,122,48,74,FMN GV 11 Ramsel
66,Bergstraat 71,2023-08-23,11:00:00,120,44,76,FMN GV 11 Ramsel
66,Bergstraat 71,2023-08-23,12:00:00,162,100,62,FMN GV 11 Ramsel
66,Bergstraat 71,2023-08-23,13:00:00,244,114,130,FMN GV 11 Ramsel
66,Bergstraat 71,2023-08-23,14:00:00,386,190,196,FMN GV 11 Ramsel
66,Bergstraat 71,2023-08-23,15:00:00,224,132,92,FMN GV 11 Ramsel
66,Bergstraat 71,2023-08-23,16:00:00,324,174,150,FMN GV 11 Ramsel
66,Bergstraat 71,2023-08-23,17:00:00,222,130,92,FMN GV 11 Ramsel
66,Bergstraat 71,2023-08-23,18:00:00,202,100,102,FMN GV 11 Ramsel
66,Bergstraat 71,2023-08-23,19:00:00,164,74,90,FMN GV 11 Ramsel
66,Bergstraat 71,2023-08-23,20:00:00,146,80,66,FMN GV 11 Ramsel
66,Bergstraat 71,2023-08-23,21:00:00,48,34,14,FMN GV 11 Ramsel
66,Bergstraat 71,2023-08-23,22:00:00,28,16,12,FMN GV 11 Ramsel
66,Bergstraat 71,2023-08-23,23:00:00,16,12,4,FMN GV 11 Ramsel
66,Bergstraat 71,2023-08-24,00:00:00,0,0,0,FMN GV 11 Ramsel
66,Bergstraat 71,2023-08-24,01:00:00,0,0,0,FMN GV 11 Ramsel
66,Bergstraat 71,2023-08-24,02:00:00,6,6,0,FMN GV 11 Ramsel
66,Bergstraat 71,2023-08-24,03:00:00,2,0,2,FMN GV 11 Ramsel
66,Bergstraat 71,2023-08-24,04:00:00,4,2,2,FMN GV 11 Ramsel
66,Bergstraat 71,2023-08-24,05:00:00,18,8,10,FMN GV 11 Ramsel
66,Bergstraat 71,2023-08-24,06:00:00,44,30,14,FMN GV 11 Ramsel
66,Bergstraat 71,2023-08-24,07:00:00,66,18,48,FMN GV 11 Ramsel
66,Bergstraat 71,2023-08-24,08:00:00,88,28,60,FMN GV 11 Ramsel
66,Bergstraat 71,2023-08-24,09:00:00,122,40,82,FMN GV 11 Ramsel
66,Bergstraat 71,2023-08-24,10:00:00,140,66,74,FMN GV 11 Ramsel
66,Bergstraat 71,2023-08-24,11:00:00,138,62,76,FMN GV 11 Ramsel
66,Bergstraat 71,2023-08-24,12:00:00,88,56,32,FMN GV 11 Ramsel
66,Bergstraat 71,2023-08-24,13:00:00,50,24,26,FMN GV 11 Ramsel
66,Bergstraat 71,2023-08-24,14:00:00,86,52,34,FMN GV 11 Ramsel
66,Bergstraat 71,2023-08-24,15:00:00,68,42,26,FMN GV 11 Ramsel
66,Bergstraat 71,2023-08-24,16:00:00,72,40,32,FMN GV 11 Ramsel
66,Bergstraat 71,2023-08-24,17:00:00,116,72,44,FMN GV 11 Ramsel
66,Bergstraat 71,2023-08-24,18:00:00,84,50,34,FMN GV 11 Ramsel
66,Bergstraat 71,2023-08-24,19:00:00,96,40,56,FMN GV 11 Ramsel
66,Bergstraat 71,2023-08-24,20:00:00,68,38,30,FMN GV 11 Ramsel
66,Bergstraat 71,2023-08-24,21:00:00,34,14,20,FMN GV 11 Ramsel
66,Bergstraat 71,2023-08-24,22:00:00,34,30,4,FMN GV 11 Ramsel
66,Bergstraat 71,2023-08-24,23:00:00,18,14,4,FMN GV 11 Ramsel
66,Bergstraat 71,2023-08-25,00:00:00,20,18,2,FMN GV 11 Ramsel
66,Bergstraat 71,2023-08-25,01:00:00,10,6,4,FMN GV 11 Ramsel
66,Bergstraat 71,2023-08-25,02:00:00,12,12,0,FMN GV 11 Ramsel
66,Bergstraat 71,2023-08-25,03:00:00,2,2,0,FMN GV 11 Ramsel
66,Bergstraat 71,2023-08-25,04:00:00,6,4,2,FMN GV 11 Ramsel
66,Bergstraat 71,2023-08-25,05:00:00,14,6,8,FMN GV 11 Ramsel
66,Bergstraat 71,2023-08-25,06:00:00,24,14,10,FMN GV 11 Ramsel
66,Bergstraat 71,2023-08-25,07:00:00,26,8,18,FMN GV 11 Ramsel
66,Bergstraat 71,2023-08-25,08:00:00,12,2,10,FMN GV 11 Ramsel
66,Bergstraat 71,2023-08-25,09:00:00,22,14,8,FMN GV 11 Ramsel
66,Bergstraat 71,2023-08-25,10:00:00,16,2,14,FMN GV 11 Ramsel
66,Bergstraat 71,2023-08-25,11:00:00,14,10,4,FMN GV 11 Ramsel
66,Bergstraat 71,2023-08-25,12:00:00,34,18,16,FMN GV 11 Ramsel
66,Bergstraat 71,2023-08-25,13:00:00,28,10,18,FMN GV 11 Ramsel
66,Bergstraat 71,2023-08-25,14:00:00,58,28,30,FMN GV 11 Ramsel
66,Bergstraat 71,2023-08-25,15:00:00,108,72,36,FMN GV 11 Ramsel
66,Bergstraat 71,2023-08-25,16:00:00,80,42,38,FMN GV 11 Ramsel
66,Bergstraat 71,2023-08-25,17:00:00,78,46,32,FMN GV 11 Ramsel
66,Bergstraat 71,2023-08-25,18:00:00,52,30,22,FMN GV 11 Ramsel
66,Bergstraat 71,2023-08-25,19:00:00,56,36,20,FMN GV 11 Ramsel
66,Bergstraat 71,2023-08-25,20:00:00,16,6,10,FMN GV 11 Ramsel
66,Bergstraat 71,2023-08-25,21:00:00,26,6,20,FMN GV 11 Ramsel
66,Bergstraat 71,2023-08-25,22:00:00,18,6,12,FMN GV 11 Ramsel
66,Bergstraat 71,2023-08-25,23:00:00,16,6,10,FMN GV 11 Ramsel
66,Bergstraat 71,2023-08-26,00:00:00,4,2,2,FMN GV 11 Ramsel
66,Bergstraat 71,2023-08-26,01:00:00,10,8,2,FMN GV 11 Ramsel
66,Bergstraat 71,2023-08-26,02:00:00,6,2,4,FMN GV 11 Ramsel
66,Bergstraat 71,2023-08-26,03:00:00,2,2,0,FMN GV 11 Ramsel
66,Bergstraat 71,2023-08-26,04:00:00,0,0,0,FMN GV 11 Ramsel
66,Bergstraat 71,2023-08-26,05:00:00,0,0,0,FMN GV 11 Ramsel
66,Bergstraat 71,2023-08-26,06:00:00,12,6,6,FMN GV 11 Ramsel
66,Bergstraat 71,2023-08-26,07:00:00,2,0,2,FMN GV 11 Ramsel
66,Bergstraat 71,2023-08-26,08:00:00,46,22,24,FMN GV 11 Ramsel
66,Bergstraat 71,2023-08-26,09:00:00,72,24,48,FMN GV 11 Ramsel
66,Bergstraat 71,2023-08-26,10:00:00,150,96,54,FMN GV 11 Ramsel
66,Bergstraat 71,2023-08-26,11:00:00,120,66,54,FMN GV 11 Ramsel
66,Bergstraat 71,2023-08-26,12:00:00,162,80,82,FMN GV 11 Ramsel
66,Bergstraat 71,2023-08-26,13:00:00,178,76,102,FMN GV 11 Ramsel
66,Bergstraat 71,2023-08-26,14:00:00,250,106,144,FMN GV 11 Ramsel
66,Bergstraat 71,2023-08-26,15:00:00,234,138,96,FMN GV 11 Ramsel
66,Bergstraat 71,2023-08-26,16:00:00,156,70,86,FMN GV 11 Ramsel
66,Bergstraat 71,2023-08-26,17:00:00,60,46,14,FMN GV 11 Ramsel
66,Bergstraat 71,2023-08-26,18:00:00,98,58,40,FMN GV 11 Ramsel
66,Bergstraat 71,2023-08-26,19:00:00,50,24,26,FMN GV 11 Ramsel
66,Bergstraat 71,2023-08-26,20:00:00,40,26,14,FMN GV 11 Ramsel
66,Bergstraat 71,2023-08-26,21:00:00,12,6,6,FMN GV 11 Ramsel
66,Bergstraat 71,2023-08-26,22:00:00,10,8,2,FMN GV 11 Ramsel
66,Bergstraat 71,2023-08-26,23:00:00,6,6,0,FMN GV 11 Ramsel
66,Bergstraat 71,2023-08-27,00:00:00,8,4,4,FMN GV 11 Ramsel
66,Bergstraat 71,2023-08-27,01:00:00,6,0,6,FMN GV 11 Ramsel
66,Bergstraat 71,2023-08-27,02:00:00,2,2,0,FMN GV 11 Ramsel
66,Bergstraat 71,2023-08-27,03:00:00,2,0,2,FMN GV 11 Ramsel
66,Bergstraat 71,2023-08-27,04:00:00,6,6,0,FMN GV 11 Ramsel
66,Bergstraat 71,2023-08-27,05:00:00,0,0,0,FMN GV 11 Ramsel
66,Bergstraat 71,2023-08-27,06:00:00,4,2,2,FMN GV 11 Ramsel
66,Bergstraat 71,2023-08-27,07:00:00,12,6,6,FMN GV 11 Ramsel
66,Bergstraat 71,2023-08-27,08:00:00,68,20,48,FMN GV 11 Ramsel
66,Bergstraat 71,2023-08-27,09:00:00,104,42,62,FMN GV 11 Ramsel
66,Bergstraat 71,2023-08-27,10:00:00,194,124,70,FMN GV 11 Ramsel
66,Bergstraat 71,2023-08-27,11:00:00,130,50,80,FMN GV 11 Ramsel
66,Bergstraat 71,2023-08-27,12:00:00,134,78,56,FMN GV 11 Ramsel
66,Bergstraat 71,2023-08-27,13:00:00,140,68,72,FMN GV 11 Ramsel
66,Bergstraat 71,2023-08-27,14:00:00,82,34,48,FMN GV 11 Ramsel
66,Bergstraat 71,2023-08-27,15:00:00,70,38,32,FMN GV 11 Ramsel
66,Bergstraat 71,2023-08-27,16:00:00,106,60,46,FMN GV 11 Ramsel
66,Bergstraat 71,2023-08-27,17:00:00,94,46,48,FMN GV 11 Ramsel
66,Bergstraat 71,2023-08-27,18:00:00,92,36,56,FMN GV 11 Ramsel
66,Bergstraat 71,2023-08-27,19:00:00,74,38,36,FMN GV 11 Ramsel
66,Bergstraat 71,2023-08-27,20:00:00,40,24,16,FMN GV 11 Ramsel
66,Bergstraat 71,2023-08-27,21:00:00,22,10,12,FMN GV 11 Ramsel
66,Bergstraat 71,2023-08-27,22:00:00,6,4,2,FMN GV 11 Ramsel
66,Bergstraat 71,2023-08-27,23:00:00,18,16,2,FMN GV 11 Ramsel
66,Bergstraat 71,2023-08-28,00:00:00,4,2,2,FMN GV 11 Ramsel
66,Bergstraat 71,2023-08-28,01:00:00,8,6,2,FMN GV 11 Ramsel
66,Bergstraat 71,2023-08-28,02:00:00,0,0,0,FMN GV 11 Ramsel
66,Bergstraat 71,2023-08-28,03:00:00,4,2,2,FMN GV 11 Ramsel
66,Bergstraat 71,2023-08-28,04:00:00,8,8,0,FMN GV 11 Ramsel
66,Bergstraat 71,2023-08-28,05:00:00,14,4,10,FMN GV 11 Ramsel
66,Bergstraat 71,2023-08-28,06:00:00,46,18,28,FMN GV 11 Ramsel
66,Bergstraat 71,2023-08-28,07:00:00,54,12,42,FMN GV 11 Ramsel
66,Bergstraat 71,2023-08-28,08:00:00,64,20,44,FMN GV 11 Ramsel
66,Bergstraat 71,2023-08-28,09:00:00,74,26,48,FMN GV 11 Ramsel
66,Bergstraat 71,2023-08-28,10:00:00,56,20,36,FMN GV 11 Ramsel
66,Bergstraat 71,2023-08-28,11:00:00,60,32,28,FMN GV 11 Ramsel
66,Bergstraat 71,2023-08-28,12:00:00,60,32,28,FMN GV 11 Ramsel
66,Bergstraat 71,2023-08-28,13:00:00,156,70,86,FMN GV 11 Ramsel
66,Bergstraat 71,2023-08-28,14:00:00,110,66,44,FMN GV 11 Ramsel
66,Bergstraat 71,2023-08-28,15:00:00,96,56,40,FMN GV 11 Ramsel
66,Bergstraat 71,2023-08-28,16:00:00,126,90,36,FMN GV 11 Ramsel
66,Bergstraat 71,2023-08-28,17:00:00,158,72,86,FMN GV 11 Ramsel
66,Bergstraat 71,2023-08-28,18:00:00,86,48,38,FMN GV 11 Ramsel
66,Bergstraat 71,2023-08-28,19:00:00,38,16,22,FMN GV 11 Ramsel
66,Bergstraat 71,2023-08-28,20:00:00,30,16,14,FMN GV 11 Ramsel
66,Bergstraat 71,2023-08-28,21:00:00,30,12,18,FMN GV 11 Ramsel
66,Bergstraat 71,2023-08-28,22:00:00,8,8,0,FMN GV 11 Ramsel
66,Bergstraat 71,2023-08-28,23:00:00,4,4,0,FMN GV 11 Ramsel
66,Bergstraat 71,2023-08-29,00:00:00,2,2,0,FMN GV 11 Ramsel
66,Bergstraat 71,2023-08-29,01:00:00,0,0,0,FMN GV 11 Ramsel
66,Bergstraat 71,2023-08-29,02:00:00,0,0,0,FMN GV 11 Ramsel
66,Bergstraat 71,2023-08-29,03:00:00,2,2,0,FMN GV 11 Ramsel
66,Bergstraat 71,2023-08-29,04:00:00,6,4,2,FMN GV 11 Ramsel
66,Bergstraat 71,2023-08-29,05:00:00,26,10,16,FMN GV 11 Ramsel
66,Bergstraat 71,2023-08-29,06:00:00,46,18,28,FMN GV 11 Ramsel
66,Bergstraat 71,2023-08-29,07:00:00,66,20,46,FMN GV 11 Ramsel
66,Bergstraat 71,2023-08-29,08:00:00,68,24,44,FMN GV 11 Ramsel
66,Bergstraat 71,2023-08-29,09:00:00,60,22,38,FMN GV 11 Ramsel
66,Bergstraat 71,2023-08-29,10:00:00,94,36,58,FMN GV 11 Ramsel
66,Bergstraat 71,2023-08-29,11:00:00,84,40,44,FMN GV 11 Ramsel
66,Bergstraat 71,2023-08-29,12:00:00,98,44,54,FMN GV 11 Ramsel
66,Bergstraat 71,2023-08-29,13:00:00,192,76,116,FMN GV 11 Ramsel
66,Bergstraat 71,2023-08-29,14:00:00,264,150,114,FMN GV 11 Ramsel
66,Bergstraat 71,2023-08-29,15:00:00,214,116,98,FMN GV 11 Ramsel
66,Bergstraat 71,2023-08-29,16:00:00,194,108,86,FMN GV 11 Ramsel
66,Bergstraat 71,2023-08-29,17:00:00,148,78,70,FMN GV 11 Ramsel
66,Bergstraat 71,2023-08-29,18:00:00,154,80,74,FMN GV 11 Ramsel
66,Bergstraat 71,2023-08-29,19:00:00,126,72,54,FMN GV 11 Ramsel
66,Bergstraat 71,2023-08-29,20:00:00,72,50,22,FMN GV 11 Ramsel
66,Bergstraat 71,2023-08-29,21:00:00,30,20,10,FMN GV 11 Ramsel
66,Bergstraat 71,2023-08-29,22:00:00,24,20,4,FMN GV 11 Ramsel
66,Bergstraat 71,2023-08-29,23:00:00,8,8,0,FMN GV 11 Ramsel
66,Bergstraat 71,2023-08-30,00:00:00,8,8,0,FMN GV 11 Ramsel
66,Bergstraat 71,2023-08-30,01:00:00,0,0,0,FMN GV 11 Ramsel
66,Bergstraat 71,2023-08-30,02:00:00,0,0,0,FMN GV 11 Ramsel
66,Bergstraat 71,2023-08-30,03:00:00,0,0,0,FMN GV 11 Ramsel
66,Bergstraat 71,2023-08-30,04:00:00,8,4,4,FMN GV 11 Ramsel
66,Bergstraat 71,2023-08-30,05:00:00,16,6,10,FMN GV 11 Ramsel
66,Bergstraat 71,2023-08-30,06:00:00,36,18,18,FMN GV 11 Ramsel
66,Bergstraat 71,2023-08-30,07:00:00,36,12,24,FMN GV 11 Ramsel
66,Bergstraat 71,2023-08-30,08:00:00,32,18,14,FMN GV 11 Ramsel
66,Bergstraat 71,2023-08-30,09:00:00,14,10,4,FMN GV 11 Ramsel
66,Bergstraat 71,2023-08-30,10:00:00,24,8,16,FMN GV 11 Ramsel
66,Bergstraat 71,2023-08-30,11:00:00,22,12,10,FMN GV 11 Ramsel
66,Bergstraat 71,2023-08-30,12:00:00,56,22,34,FMN GV 11 Ramsel
66,Bergstraat 71,2023-08-30,13:00:00,36,14,22,FMN GV 11 Ramsel
66,Bergstraat 71,2023-08-30,14:00:00,150,34,116,FMN GV 11 Ramsel
66,Bergstraat 71,2023-08-30,15:00:00,146,86,60,FMN GV 11 Ramsel
66,Bergstraat 71,2023-08-30,16:00:00,106,64,42,FMN GV 11 Ramsel
66,Bergstraat 71,2023-08-30,17:00:00,120,58,62,FMN GV 11 Ramsel
66,Bergstraat 71,2023-08-30,18:00:00,74,32,42,FMN GV 11 Ramsel
66,Bergstraat 71,2023-08-30,19:00:00,78,36,42,FMN GV 11 Ramsel
66,Bergstraat 71,2023-08-30,20:00:00,56,24,32,FMN GV 11 Ramsel
66,Bergstraat 71,2023-08-30,21:00:00,42,34,8,FMN GV 11 Ramsel
66,Bergstraat 71,2023-08-30,22:00:00,12,6,6,FMN GV 11 Ramsel
66,Bergstraat 71,2023-08-30,23:00:00,6,6,0,FMN GV 11 Ramsel
66,Bergstraat 71,2023-08-31,00:00:00,4,2,2,FMN GV 11 Ramsel
66,Bergstraat 71,2023-08-31,01:00:00,0,0,0,FMN GV 11 Ramsel
66,Bergstraat 71,2023-08-31,02:00:00,0,0,0,FMN GV 11 Ramsel
66,Bergstraat 71,2023-08-31,03:00:00,0,0,0,FMN GV 11 Ramsel
66,Bergstraat 71,2023-08-31,04:00:00,6,4,2,FMN GV 11 Ramsel
66,Bergstraat 71,2023-08-31,05:00:00,16,10,6,FMN GV 11 Ramsel
66,Bergstraat 71,2023-08-31,06:00:00,38,12,26,FMN GV 11 Ramsel
66,Bergstraat 71,2023-08-31,07:00:00,56,20,36,FMN GV 11 Ramsel
66,Bergstraat 71,2023-08-31,08:00:00,34,2,32,FMN GV 11 Ramsel
66,Bergstraat 71,2023-08-31,09:00:00,74,16,58,FMN GV 11 Ramsel
66,Bergstraat 71,2023-08-31,10:00:00,132,42,90,FMN GV 11 Ramsel
66,Bergstraat 71,2023-08-31,11:00:00,100,52,48,FMN GV 11 Ramsel
66,Bergstraat 71,2023-08-31,12:00:00,130,86,44,FMN GV 11 Ramsel
66,Bergstraat 71,2023-08-31,13:00:00,190,100,90,FMN GV 11 Ramsel
66,Bergstraat 71,2023-08-31,14:00:00,206,94,112,FMN GV 11 Ramsel
66,Bergstraat 71,2023-08-31,15:00:00,152,90,62,FMN GV 11 Ramsel
66,Bergstraat 71,2023-08-31,16:00:00,142,74,68,FMN GV 11 Ramsel
66,Bergstraat 71,2023-08-31,17:00:00,120,64,56,FMN GV 11 Ramsel
66,Bergstraat 71,2023-08-31,18:00:00,106,64,42,FMN GV 11 Ramsel
66,Bergstraat 71,2023-08-31,19:00:00,84,48,36,FMN GV 11 Ramsel
66,Bergstraat 71,2023-08-31,20:00:00,48,26,22,FMN GV 11 Ramsel
66,Bergstraat 71,2023-08-31,21:00:00,32,22,10,FMN GV 11 Ramsel
66,Bergstraat 71,2023-08-31,22:00:00,20,16,4,FMN GV 11 Ramsel
66,Bergstraat 71,2023-08-31,23:00:00,8,6,2,FMN GV 11 Ramsel
66,Bergstraat 71,2023-09-01,00:00:00,0,0,0,FMN GV 11 Ramsel
66,Bergstraat 71,2023-09-01,01:00:00,4,4,0,FMN GV 11 Ramsel
66,Bergstraat 71,2023-09-01,02:00:00,0,0,0,FMN GV 11 Ramsel
66,Bergstraat 71,2023-09-01,03:00:00,0,0,0,FMN GV 11 Ramsel
66,Bergstraat 71,2023-09-01,04:00:00,6,6,0,FMN GV 11 Ramsel
66,Bergstraat 71,2023-09-01,05:00:00,14,8,6,FMN GV 11 Ramsel
66,Bergstraat 71,2023-09-01,06:00:00,14,4,10,FMN GV 11 Ramsel
66,Bergstraat 71,2023-09-01,07:00:00,84,16,68,FMN GV 11 Ramsel
66,Bergstraat 71,2023-09-01,08:00:00,62,8,54,FMN GV 11 Ramsel
66,Bergstraat 71,2023-09-01,09:00:00,46,0,46,FMN GV 11 Ramsel
66,Bergstraat 71,2023-09-01,10:00:00,6,0,6,FMN GV 11 Ramsel
66,Bergstraat 71,2023-09-01,11:00:00,34,0,34,FMN GV 11 Ramsel
66,Bergstraat 71,2023-09-01,12:00:00,78,66,12,FMN GV 11 Ramsel
66,Bergstraat 71,2023-09-01,13:00:00,18,10,8,FMN GV 11 Ramsel
66,Bergstraat 71,2023-09-01,14:00:00,36,28,8,FMN GV 11 Ramsel
66,Bergstraat 71,2023-09-01,15:00:00,104,70,34,FMN GV 11 Ramsel
66,Bergstraat 71,2023-09-01,16:00:00,78,38,40,FMN GV 11 Ramsel
66,Bergstraat 71,2023-09-01,17:00:00,62,36,26,FMN GV 11 Ramsel
66,Bergstraat 71,2023-09-01,18:00:00,80,24,56,FMN GV 11 Ramsel
66,Bergstraat 71,2023-09-01,19:00:00,64,36,28,FMN GV 11 Ramsel
66,Bergstraat 71,2023-09-01,20:00:00,34,20,14,FMN GV 11 Ramsel
66,Bergstraat 71,2023-09-01,21:00:00,36,22,14,FMN GV 11 Ramsel
66,Bergstraat 71,2023-09-01,22:00:00,10,6,4,FMN GV 11 Ramsel
66,Bergstraat 71,2023-09-01,23:00:00,12,12,0,FMN GV 11 Ramsel
66,Bergstraat 71,2023-09-02,00:00:00,8,6,2,FMN GV 11 Ramsel
66,Bergstraat 71,2023-09-02,01:00:00,6,2,4,FMN GV 11 Ramsel
66,Bergstraat 71,2023-09-02,02:00:00,0,0,0,FMN GV 11 Ramsel
66,Bergstraat 71,2023-09-02,03:00:00,2,2,0,FMN GV 11 Ramsel
66,Bergstraat 71,2023-09-02,04:00:00,0,0,0,FMN GV 11 Ramsel
66,Bergstraat 71,2023-09-02,05:00:00,0,0,0,FMN GV 11 Ramsel
66,Bergstraat 71,2023-09-02,06:00:00,6,4,2,FMN GV 11 Ramsel
66,Bergstraat 71,2023-09-02,07:00:00,18,2,16,FMN GV 11 Ramsel
66,Bergstraat 71,2023-09-02,08:00:00,62,14,48,FMN GV 11 Ramsel
66,Bergstraat 71,2023-09-02,09:00:00,68,24,44,FMN GV 11 Ramsel
66,Bergstraat 71,2023-09-02,10:00:00,140,76,64,FMN GV 11 Ramsel
66,Bergstraat 71,2023-09-02,11:00:00,118,54,64,FMN GV 11 Ramsel
66,Bergstraat 71,2023-09-02,12:00:00,142,88,54,FMN GV 11 Ramsel
66,Bergstraat 71,2023-09-02,13:00:00,250,98,152,FMN GV 11 Ramsel
66,Bergstraat 71,2023-09-02,14:00:00,280,130,150,FMN GV 11 Ramsel
66,Bergstraat 71,2023-09-02,15:00:00,188,94,94,FMN GV 11 Ramsel
66,Bergstraat 71,2023-09-02,16:00:00,138,94,44,FMN GV 11 Ramsel
66,Bergstraat 71,2023-09-02,17:00:00,124,66,58,FMN GV 11 Ramsel
66,Bergstraat 71,2023-09-02,18:00:00,110,50,60,FMN GV 11 Ramsel
66,Bergstraat 71,2023-09-02,19:00:00,58,36,22,FMN GV 11 Ramsel
66,Bergstraat 71,2023-09-02,20:00:00,42,24,18,FMN GV 11 Ramsel
66,Bergstraat 71,2023-09-02,21:00:00,18,12,6,FMN GV 11 Ramsel
66,Bergstraat 71,2023-09-02,22:00:00,20,14,6,FMN GV 11 Ramsel
66,Bergstraat 71,2023-09-02,23:00:00,10,8,2,FMN GV 11 Ramsel
66,Bergstraat 71,2023-09-03,00:00:00,2,2,0,FMN GV 11 Ramsel
66,Bergstraat 71,2023-09-03,01:00:00,8,8,0,FMN GV 11 Ramsel
66,Bergstraat 71,2023-09-03,02:00:00,2,2,0,FMN GV 11 Ramsel
66,Bergstraat 71,2023-09-03,03:00:00,4,4,0,FMN GV 11 Ramsel
66,Bergstraat 71,2023-09-03,04:00:00,0,0,0,FMN GV 11 Ramsel
66,Bergstraat 71,2023-09-03,05:00:00,4,0,4,FMN GV 11 Ramsel
66,Bergstraat 71,2023-09-03,06:00:00,6,2,4,FMN GV 11 Ramsel
66,Bergstraat 71,2023-09-03,07:00:00,16,8,8,FMN GV 11 Ramsel
66,Bergstraat 71,2023-09-03,08:00:00,86,26,60,FMN GV 11 Ramsel
66,Bergstraat 71,2023-09-03,09:00:00,130,62,68,FMN GV 11 Ramsel
66,Bergstraat 71,2023-09-03,10:00:00,242,126,116,FMN GV 11 Ramsel
66,Bergstraat 71,2023-09-03,11:00:00,232,140,92,FMN GV 11 Ramsel
66,Bergstraat 71,2023-09-03,12:00:00,194,102,92,FMN GV 11 Ramsel
66,Bergstraat 71,2023-09-03,13:00:00,398,182,216,FMN GV 11 Ramsel
66,Bergstraat 71,2023-09-03,14:00:00,364,174,190,FMN GV 11 Ramsel
66,Bergstraat 71,2023-09-03,15:00:00,348,172,176,FMN GV 11 Ramsel
66,Bergstraat 71,2023-09-03,16:00:00,320,194,126,FMN GV 11 Ramsel
66,Bergstraat 71,2023-09-03,17:00:00,250,144,106,FMN GV 11 Ramsel
66,Bergstraat 71,2023-09-03,18:00:00,164,88,76,FMN GV 11 Ramsel
66,Bergstraat 71,2023-09-03,19:00:00,100,48,52,FMN GV 11 Ramsel
66,Bergstraat 71,2023-09-03,20:00:00,68,36,32,FMN GV 11 Ramsel
66,Bergstraat 71,2023-09-03,21:00:00,22,14,8,FMN GV 11 Ramsel
66,Bergstraat 71,2023-09-03,22:00:00,12,4,8,FMN GV 11 Ramsel
66,Bergstraat 71,2023-09-03,23:00:00,0,0,0,FMN GV 11 Ramsel
66,Bergstraat 71,2023-09-04,00:00:00,0,0,0,FMN GV 11 Ramsel
66,Bergstraat 71,2023-09-04,01:00:00,2,2,0,FMN GV 11 Ramsel
66,Bergstraat 71,2023-09-04,02:00:00,0,0,0,FMN GV 11 Ramsel
66,Bergstraat 71,2023-09-04,03:00:00,0,0,0,FMN GV 11 Ramsel
66,Bergstraat 71,2023-09-04,04:00:00,8,4,4,FMN GV 11 Ramsel
66,Bergstraat 71,2023-09-04,05:00:00,20,12,8,FMN GV 11 Ramsel
66,Bergstraat 71,2023-09-04,06:00:00,50,16,34,FMN GV 11 Ramsel
66,Bergstraat 71,2023-09-04,07:00:00,332,38,294,FMN GV 11 Ramsel
66,Bergstraat 71,2023-09-04,08:00:00,226,44,182,FMN GV 11 Ramsel
66,Bergstraat 71,2023-09-04,09:00:00,64,32,32,FMN GV 11 Ramsel
66,Bergstraat 71,2023-09-04,10:00:00,94,42,52,FMN GV 11 Ramsel
66,Bergstraat 71,2023-09-04,11:00:00,96,42,54,FMN GV 11 Ramsel
66,Bergstraat 71,2023-09-04,12:00:00,124,56,68,FMN GV 11 Ramsel
66,Bergstraat 71,2023-09-04,13:00:00,188,86,102,FMN GV 11 Ramsel
66,Bergstraat 71,2023-09-04,14:00:00,216,118,98,FMN GV 11 Ramsel
66,Bergstraat 71,2023-09-04,15:00:00,344,250,94,FMN GV 11 Ramsel
66,Bergstraat 71,2023-09-04,16:00:00,298,218,80,FMN GV 11 Ramsel
66,Bergstraat 71,2023-09-04,17:00:00,180,130,50,FMN GV 11 Ramsel
66,Bergstraat 71,2023-09-04,18:00:00,166,96,70,FMN GV 11 Ramsel
66,Bergstraat 71,2023-09-04,19:00:00,96,48,48,FMN GV 11 Ramsel
66,Bergstraat 71,2023-09-04,20:00:00,54,30,24,FMN GV 11 Ramsel
66,Bergstraat 71,2023-09-04,21:00:00,26,16,10,FMN GV 11 Ramsel
66,Bergstraat 71,2023-09-04,22:00:00,10,8,2,FMN GV 11 Ramsel
66,Bergstraat 71,2023-09-04,23:00:00,6,4,2,FMN GV 11 Ramsel
66,Bergstraat 71,2023-09-05,00:00:00,4,2,2,FMN GV 11 Ramsel
66,Bergstraat 71,2023-09-05,01:00:00,0,0,0,FMN GV 11 Ramsel
66,Bergstraat 71,2023-09-05,02:00:00,0,0,0,FMN GV 11 Ramsel
66,Bergstraat 71,2023-09-05,03:00:00,0,0,0,FMN GV 11 Ramsel
66,Bergstraat 71,2023-09-05,04:00:00,12,6,6,FMN GV 11 Ramsel
66,Bergstraat 71,2023-09-05,05:00:00,28,10,18,FMN GV 11 Ramsel
66,Bergstraat 71,2023-09-05,06:00:00,62,22,40,FMN GV 11 Ramsel
66,Bergstraat 71,2023-09-05,07:00:00,312,38,274,FMN GV 11 Ramsel
66,Bergstraat 71,2023-09-05,08:00:00,238,32,206,FMN GV 11 Ramsel
66,Bergstraat 71,2023-09-05,09:00:00,72,32,40,FMN GV 11 Ramsel
66,Bergstraat 71,2023-09-05,10:00:00,158,64,94,FMN GV 11 Ramsel
66,Bergstraat 71,2023-09-05,11:00:00,170,86,84,FMN GV 11 Ramsel
66,Bergstraat 71,2023-09-05,12:00:00,186,98,88,FMN GV 11 Ramsel
66,Bergstraat 71,2023-09-05,13:00:00,190,90,100,FMN GV 11 Ramsel
66,Bergstraat 71,2023-09-05,14:00:00,270,154,116,FMN GV 11 Ramsel
66,Bergstraat 71,2023-09-05,15:00:00,382,280,102,FMN GV 11 Ramsel
66,Bergstraat 71,2023-09-05,16:00:00,344,260,84,FMN GV 11 Ramsel
66,Bergstraat 71,2023-09-05,17:00:00,202,90,112,FMN GV 11 Ramsel
66,Bergstraat 71,2023-09-05,18:00:00,160,80,80,FMN GV 11 Ramsel
66,Bergstraat 71,2023-09-05,19:00:00,180,98,82,FMN GV 11 Ramsel
66,Bergstraat 71,2023-09-05,20:00:00,114,70,44,FMN GV 11 Ramsel
66,Bergstraat 71,2023-09-05,21:00:00,36,16,20,FMN GV 11 Ramsel
66,Bergstraat 71,2023-09-05,22:00:00,36,18,18,FMN GV 11 Ramsel
66,Bergstraat 71,2023-09-05,23:00:00,4,4,0,FMN GV 11 Ramsel
66,Bergstraat 71,2023-09-06,00:00:00,2,2,0,FMN GV 11 Ramsel
66,Bergstraat 71,2023-09-06,01:00:00,0,0,0,FMN GV 11 Ramsel
66,Bergstraat 71,2023-09-06,02:00:00,0,0,0,FMN GV 11 Ramsel
66,Bergstraat 71,2023-09-06,03:00:00,2,2,0,FMN GV 11 Ramsel
66,Bergstraat 71,2023-09-06,04:00:00,8,6,2,FMN GV 11 Ramsel
66,Bergstraat 71,2023-09-06,05:00:00,22,8,14,FMN GV 11 Ramsel
66,Bergstraat 71,2023-09-06,06:00:00,70,28,42,FMN GV 11 Ramsel
66,Bergstraat 71,2023-09-06,07:00:00,316,38,278,FMN GV 11 Ramsel
66,Bergstraat 71,2023-09-06,08:00:00,240,50,190,FMN GV 11 Ramsel
66,Bergstraat 71,2023-09-06,09:00:00,112,52,60,FMN GV 11 Ramsel
66,Bergstraat 71,2023-09-06,10:00:00,142,68,74,FMN GV 11 Ramsel
66,Bergstraat 71,2023-09-06,11:00:00,154,94,60,FMN GV 11 Ramsel
66,Bergstraat 71,2023-09-06,12:00:00,454,352,102,FMN GV 11 Ramsel
66,Bergstraat 71,2023-09-06,13:00:00,242,106,136,FMN GV 11 Ramsel
66,Bergstraat 71,2023-09-06,14:00:00,278,168,110,FMN GV 11 Ramsel
66,Bergstraat 71,2023-09-06,15:00:00,214,132,82,FMN GV 11 Ramsel
66,Bergstraat 71,2023-09-06,16:00:00,182,120,62,FMN GV 11 Ramsel
66,Bergstraat 71,2023-09-06,17:00:00,220,108,112,FMN GV 11 Ramsel
66,Bergstraat 71,2023-09-06,18:00:00,188,90,98,FMN GV 11 Ramsel
66,Bergstraat 71,2023-09-06,19:00:00,168,126,42,FMN GV 11 Ramsel
66,Bergstraat 71,2023-09-06,20:00:00,106,50,56,FMN GV 11 Ramsel
66,Bergstraat 71,2023-09-06,21:00:00,40,16,24,FMN GV 11 Ramsel
66,Bergstraat 71,2023-09-06,22:00:00,24,14,10,FMN GV 11 Ramsel
66,Bergstraat 71,2023-09-06,23:00:00,10,6,4,FMN GV 11 Ramsel
66,Bergstraat 71,2023-09-07,00:00:00,2,0,2,FMN GV 11 Ramsel
66,Bergstraat 71,2023-09-07,01:00:00,4,4,0,FMN GV 11 Ramsel
66,Bergstraat 71,2023-09-07,02:00:00,8,8,0,FMN GV 11 Ramsel
66,Bergstraat 71,2023-09-07,03:00:00,4,2,2,FMN GV 11 Ramsel
66,Bergstraat 71,2023-09-07,04:00:00,10,8,2,FMN GV 11 Ramsel
66,Bergstraat 71,2023-09-07,05:00:00,22,12,10,FMN GV 11 Ramsel
66,Bergstraat 71,2023-09-07,06:00:00,76,16,60,FMN GV 11 Ramsel
66,Bergstraat 71,2023-09-07,07:00:00,300,34,266,FMN GV 11 Ramsel
66,Bergstraat 71,2023-09-07,08:00:00,236,48,188,FMN GV 11 Ramsel
66,Bergstraat 71,2023-09-07,09:00:00,114,32,82,FMN GV 11 Ramsel
66,Bergstraat 71,2023-09-07,10:00:00,140,78,62,FMN GV 11 Ramsel
66,Bergstraat 71,2023-09-07,11:00:00,150,86,64,FMN GV 11 Ramsel
66,Bergstraat 71,2023-09-07,12:00:00,136,84,52,FMN GV 11 Ramsel
66,Bergstraat 71,2023-09-07,13:00:00,134,50,84,FMN GV 11 Ramsel
66,Bergstraat 71,2023-09-07,14:00:00,198,136,62,FMN GV 11 Ramsel
66,Bergstraat 71,2023-09-07,15:00:00,302,232,70,FMN GV 11 Ramsel
66,Bergstraat 71,2023-09-07,16:00:00,302,240,62,FMN GV 11 Ramsel
66,Bergstraat 71,2023-09-07,17:00:00,220,140,80,FMN GV 11 Ramsel
66,Bergstraat 71,2023-09-07,18:00:00,142,82,60,FMN GV 11 Ramsel
66,Bergstraat 71,2023-09-07,19:00:00,136,64,72,FMN GV 11 Ramsel
66,Bergstraat 71,2023-09-07,20:00:00,88,58,30,FMN GV 11 Ramsel
66,Bergstraat 71,2023-09-07,21:00:00,24,18,6,FMN GV 11 Ramsel
66,Bergstraat 71,2023-09-07,22:00:00,32,22,10,FMN GV 11 Ramsel
66,Bergstraat 71,2023-09-07,23:00:00,2,0,2,FMN GV 11 Ramsel
66,Bergstraat 71,2023-09-08,00:00:00,8,2,6,FMN GV 11 Ramsel
66,Bergstraat 71,2023-09-08,01:00:00,4,4,0,FMN GV 11 Ramsel
66,Bergstraat 71,2023-09-08,02:00:00,0,0,0,FMN GV 11 Ramsel
66,Bergstraat 71,2023-09-08,03:00:00,2,2,0,FMN GV 11 Ramsel
66,Bergstraat 71,2023-09-08,04:00:00,12,8,4,FMN GV 11 Ramsel
66,Bergstraat 71,2023-09-08,05:00:00,22,8,14,FMN GV 11 Ramsel
66,Bergstraat 71,2023-09-08,06:00:00,40,12,28,FMN GV 11 Ramsel
66,Bergstraat 71,2023-09-08,07:00:00,278,28,250,FMN GV 11 Ramsel
66,Bergstraat 71,2023-09-08,08:00:00,208,26,182,FMN GV 11 Ramsel
66,Bergstraat 71,2023-09-08,09:00:00,140,58,82,FMN GV 11 Ramsel
66,Bergstraat 71,2023-09-08,10:00:00,134,56,78,FMN GV 11 Ramsel
66,Bergstraat 71,2023-09-08,11:00:00,164,92,72,FMN GV 11 Ramsel
66,Bergstraat 71,2023-09-08,12:00:00,124,66,58,FMN GV 11 Ramsel
66,Bergstraat 71,2023-09-08,13:00:00,170,92,78,FMN GV 11 Ramsel
66,Bergstraat 71,2023-09-08,14:00:00,198,108,90,FMN GV 11 Ramsel
66,Bergstraat 71,2023-09-08,15:00:00,326,252,74,FMN GV 11 Ramsel
66,Bergstraat 71,2023-09-08,16:00:00,270,192,78,FMN GV 11 Ramsel
66,Bergstraat 71,2023-09-08,17:00:00,182,118,64,FMN GV 11 Ramsel
66,Bergstraat 71,2023-09-08,18:00:00,172,88,84,FMN GV 11 Ramsel
66,Bergstraat 71,2023-09-08,19:00:00,120,58,62,FMN GV 11 Ramsel
66,Bergstraat 71,2023-09-08,20:00:00,68,32,36,FMN GV 11 Ramsel
66,Bergstraat 71,2023-09-08,21:00:00,74,30,44,FMN GV 11 Ramsel
66,Bergstraat 71,2023-09-08,22:00:00,38,24,14,FMN GV 11 Ramsel
66,Bergstraat 71,2023-09-08,23:00:00,16,10,6,FMN GV 11 Ramsel
66,Bergstraat 71,2023-09-09,00:00:00,32,28,4,FMN GV 11 Ramsel
66,Bergstraat 71,2023-09-09,01:00:00,22,18,4,FMN GV 11 Ramsel
66,Bergstraat 71,2023-09-09,02:00:00,16,14,2,FMN GV 11 Ramsel
66,Bergstraat 71,2023-09-09,03:00:00,6,4,2,FMN GV 11 Ramsel
66,Bergstraat 71,2023-09-09,04:00:00,2,2,0,FMN GV 11 Ramsel
66,Bergstraat 71,2023-09-09,05:00:00,4,2,2,FMN GV 11 Ramsel
66,Bergstraat 71,2023-09-09,06:00:00,6,2,4,FMN GV 11 Ramsel
66,Bergstraat 71,2023-09-09,07:00:00,12,6,6,FMN GV 11 Ramsel
66,Bergstraat 71,2023-09-09,08:00:00,102,44,58,FMN GV 11 Ramsel
66,Bergstraat 71,2023-09-09,09:00:00,162,66,96,FMN GV 11 Ramsel
66,Bergstraat 71,2023-09-09,10:00:00,196,80,116,FMN GV 11 Ramsel
66,Bergstraat 71,2023-09-09,11:00:00,148,84,64,FMN GV 11 Ramsel
66,Bergstraat 71,2023-09-09,12:00:00,136,90,46,FMN GV 11 Ramsel
66,Bergstraat 71,2023-09-09,13:00:00,228,96,132,FMN GV 11 Ramsel
66,Bergstraat 71,2023-09-09,14:00:00,188,94,94,FMN GV 11 Ramsel
66,Bergstraat 71,2023-09-09,15:00:00,164,88,76,FMN GV 11 Ramsel
66,Bergstraat 71,2023-09-09,16:00:00,168,92,76,FMN GV 11 Ramsel
66,Bergstraat 71,2023-09-09,17:00:00,114,56,58,FMN GV 11 Ramsel
66,Bergstraat 71,2023-09-09,18:00:00,106,50,56,FMN GV 11 Ramsel
66,Bergstraat 71,2023-09-09,19:00:00,88,52,36,FMN GV 11 Ramsel
66,Bergstraat 71,2023-09-09,20:00:00,98,36,62,FMN GV 11 Ramsel
66,Bergstraat 71,2023-09-09,21:00:00,66,34,32,FMN GV 11 Ramsel
66,Bergstraat 71,2023-09-09,22:00:00,24,12,12,FMN GV 11 Ramsel
66,Bergstraat 71,2023-09-09,23:00:00,16,8,8,FMN GV 11 Ramsel
66,Bergstraat 71,2023-09-10,00:00:00,12,4,8,FMN GV 11 Ramsel
66,Bergstraat 71,2023-09-10,01:00:00,4,2,2,FMN GV 11 Ramsel
66,Bergstraat 71,2023-09-10,02:00:00,10,10,0,FMN GV 11 Ramsel
66,Bergstraat 71,2023-09-10,03:00:00,0,0,0,FMN GV 11 Ramsel
66,Bergstraat 71,2023-09-10,04:00:00,0,0,0,FMN GV 11 Ramsel
66,Bergstraat 71,2023-09-10,05:00:00,0,0,0,FMN GV 11 Ramsel
66,Bergstraat 71,2023-09-10,06:00:00,0,0,0,FMN GV 11 Ramsel
66,Bergstraat 71,2023-09-10,07:00:00,52,18,34,FMN GV 11 Ramsel
66,Bergstraat 71,2023-09-10,08:00:00,122,44,78,FMN GV 11 Ramsel
66,Bergstraat 71,2023-09-10,09:00:00,266,138,128,FMN GV 11 Ramsel
66,Bergstraat 71,2023-09-10,10:00:00,300,188,112,FMN GV 11 Ramsel
66,Bergstraat 71,2023-09-10,11:00:00,278,164,114,FMN GV 11 Ramsel
66,Bergstraat 71,2023-09-10,12:00:00,192,106,86,FMN GV 11 Ramsel
66,Bergstraat 71,2023-09-10,13:00:00,254,124,130,FMN GV 11 Ramsel
66,Bergstraat 71,2023-09-10,14:00:00,238,116,122,FMN GV 11 Ramsel
66,Bergstraat 71,2023-09-10,15:00:00,202,106,96,FMN GV 11 Ramsel
66,Bergstraat 71,2023-09-10,16:00:00,198,112,86,FMN GV 11 Ramsel
66,Bergstraat 71,2023-09-10,17:00:00,142,70,72,FMN GV 11 Ramsel
66,Bergstraat 71,2023-09-10,18:00:00,110,60,50,FMN GV 11 Ramsel
66,Bergstraat 71,2023-09-10,19:00:00,128,70,58,FMN GV 11 Ramsel
66,Bergstraat 71,2023-09-10,20:00:00,124,84,40,FMN GV 11 Ramsel
66,Bergstraat 71,2023-09-10,21:00:00,40,16,24,FMN GV 11 Ramsel
66,Bergstraat 71,2023-09-10,22:00:00,12,10,2,FMN GV 11 Ramsel
66,Bergstraat 71,2023-09-10,23:00:00,2,2,0,FMN GV 11 Ramsel
66,Bergstraat 71,2023-09-11,00:00:00,10,10,0,FMN GV 11 Ramsel
66,Bergstraat 71,2023-09-11,01:00:00,0,0,0,FMN GV 11 Ramsel
66,Bergstraat 71,2023-09-11,02:00:00,0,0,0,FMN GV 11 Ramsel
66,Bergstraat 71,2023-09-11,03:00:00,2,0,2,FMN GV 11 Ramsel
66,Bergstraat 71,2023-09-11,04:00:00,8,8,0,FMN GV 11 Ramsel
66,Bergstraat 71,2023-09-11,05:00:00,30,16,14,FMN GV 11 Ramsel
66,Bergstraat 71,2023-09-11,06:00:00,46,14,32,FMN GV 11 Ramsel
66,Bergstraat 71,2023-09-11,07:00:00,274,28,246,FMN GV 11 Ramsel
66,Bergstraat 71,2023-09-11,08:00:00,240,40,200,FMN GV 11 Ramsel
66,Bergstraat 71,2023-09-11,09:00:00,100,48,52,FMN GV 11 Ramsel
66,Bergstraat 71,2023-09-11,10:00:00,128,62,66,FMN GV 11 Ramsel
66,Bergstraat 71,2023-09-11,11:00:00,116,62,54,FMN GV 11 Ramsel
66,Bergstraat 71,2023-09-11,12:00:00,100,60,40,FMN GV 11 Ramsel
66,Bergstraat 71,2023-09-11,13:00:00,138,60,78,FMN GV 11 Ramsel
66,Bergstraat 71,2023-09-11,14:00:00,166,96,70,FMN GV 11 Ramsel
66,Bergstraat 71,2023-09-11,15:00:00,302,240,62,FMN GV 11 Ramsel
66,Bergstraat 71,2023-09-11,16:00:00,300,228,72,FMN GV 11 Ramsel
66,Bergstraat 71,2023-09-11,17:00:00,122,74,48,FMN GV 11 Ramsel
66,Bergstraat 71,2023-09-11,18:00:00,100,58,42,FMN GV 11 Ramsel
66,Bergstraat 71,2023-09-11,19:00:00,60,34,26,FMN GV 11 Ramsel
66,Bergstraat 71,2023-09-11,20:00:00,20,16,4,FMN GV 11 Ramsel
66,Bergstraat 71,2023-09-11,21:00:00,24,10,14,FMN GV 11 Ramsel
66,Bergstraat 71,2023-09-11,22:00:00,10,6,4,FMN GV 11 Ramsel
66,Bergstraat 71,2023-09-11,23:00:00,4,4,0,FMN GV 11 Ramsel
66,Bergstraat 71,2023-09-12,00:00:00,0,0,0,FMN GV 11 Ramsel
66,Bergstraat 71,2023-09-12,01:00:00,0,0,0,FMN GV 11 Ramsel
66,Bergstraat 71,2023-09-12,02:00:00,0,0,0,FMN GV 11 Ramsel
66,Bergstraat 71,2023-09-12,03:00:00,0,0,0,FMN GV 11 Ramsel
66,Bergstraat 71,2023-09-12,04:00:00,8,6,2,FMN GV 11 Ramsel
66,Bergstraat 71,2023-09-12,05:00:00,22,12,10,FMN GV 11 Ramsel
66,Bergstraat 71,2023-09-12,06:00:00,32,8,24,FMN GV 11 Ramsel
66,Bergstraat 71,2023-09-12,07:00:00,228,22,206,FMN GV 11 Ramsel
66,Bergstraat 71,2023-09-12,08:00:00,180,26,154,FMN GV 11 Ramsel
66,Bergstraat 71,2023-09-12,09:00:00,74,28,46,FMN GV 11 Ramsel
66,Bergstraat 71,2023-09-12,10:00:00,90,46,44,FMN GV 11 Ramsel
66,Bergstraat 71,2023-09-12,11:00:00,84,36,48,FMN GV 11 Ramsel
66,Bergstraat 71,2023-09-12,12:00:00,78,46,32,FMN GV 11 Ramsel
66,Bergstraat 71,2023-09-12,13:00:00,146,66,80,FMN GV 11 Ramsel
66,Bergstraat 71,2023-09-12,14:00:00,162,82,80,FMN GV 11 Ramsel
66,Bergstraat 71,2023-09-12,15:00:00,356,268,88,FMN GV 11 Ramsel
66,Bergstraat 71,2023-09-12,16:00:00,250,194,56,FMN GV 11 Ramsel
66,Bergstraat 71,2023-09-12,17:00:00,142,66,76,FMN GV 11 Ramsel
66,Bergstraat 71,2023-09-12,18:00:00,84,34,50,FMN GV 11 Ramsel
66,Bergstraat 71,2023-09-12,19:00:00,34,20,14,FMN GV 11 Ramsel
66,Bergstraat 71,2023-09-12,20:00:00,30,20,10,FMN GV 11 Ramsel
66,Bergstraat 71,2023-09-12,21:00:00,10,10,0,FMN GV 11 Ramsel
66,Bergstraat 71,2023-09-12,22:00:00,16,12,4,FMN GV 11 Ramsel
66,Bergstraat 71,2023-09-12,23:00:00,6,4,2,FMN GV 11 Ramsel
66,Bergstraat 71,2023-09-13,00:00:00,0,0,0,FMN GV 11 Ramsel
66,Bergstraat 71,2023-09-13,01:00:00,2,2,0,FMN GV 11 Ramsel
66,Bergstraat 71,2023-09-13,02:00:00,0,0,0,FMN GV 11 Ramsel
66,Bergstraat 71,2023-09-13,03:00:00,0,0,0,FMN GV 11 Ramsel
66,Bergstraat 71,2023-09-13,04:00:00,10,6,4,FMN GV 11 Ramsel
66,Bergstraat 71,2023-09-13,05:00:00,16,6,10,FMN GV 11 Ramsel
66,Bergstraat 71,2023-09-13,06:00:00,44,14,30,FMN GV 11 Ramsel
66,Bergstraat 71,2023-09-13,07:00:00,248,32,216,FMN GV 11 Ramsel
66,Bergstraat 71,2023-09-13,08:00:00,216,30,186,FMN GV 11 Ramsel
66,Bergstraat 71,2023-09-13,09:00:00,44,18,26,FMN GV 11 Ramsel
66,Bergstraat 71,2023-09-13,10:00:00,50,16,34,FMN GV 11 Ramsel
66,Bergstraat 71,2023-09-13,11:00:00,64,42,22,FMN GV 11 Ramsel
66,Bergstraat 71,2023-09-13,12:00:00,344,308,36,FMN GV 11 Ramsel
66,Bergstraat 71,2023-09-13,13:00:00,164,84,80,FMN GV 11 Ramsel
66,Bergstraat 71,2023-09-13,14:00:00,168,88,80,FMN GV 11 Ramsel
66,Bergstraat 71,2023-09-13,15:00:00,140,72,68,FMN GV 11 Ramsel
66,Bergstraat 71,2023-09-13,16:00:00,176,110,66,FMN GV 11 Ramsel
66,Bergstraat 71,2023-09-13,17:00:00,108,54,54,FMN GV 11 Ramsel
66,Bergstraat 71,2023-09-13,18:00:00,118,64,54,FMN GV 11 Ramsel
66,Bergstraat 71,2023-09-13,19:00:00,74,50,24,FMN GV 11 Ramsel
66,Bergstraat 71,2023-09-13,20:00:00,48,26,22,FMN GV 11 Ramsel
66,Bergstraat 71,2023-09-13,21:00:00,32,14,18,FMN GV 11 Ramsel
66,Bergstraat 71,2023-09-13,22:00:00,12,8,4,FMN GV 11 Ramsel
66,Bergstraat 71,2023-09-13,23:00:00,0,0,0,FMN GV 11 Ramsel
66,Bergstraat 71,2023-09-14,00:00:00,0,0,0,FMN GV 11 Ramsel
66,Bergstraat 71,2023-09-14,01:00:00,0,0,0,FMN GV 11 Ramsel
66,Bergstraat 71,2023-09-14,02:00:00,0,0,0,FMN GV 11 Ramsel
66,Bergstraat 71,2023-09-14,03:00:00,0,0,0,FMN GV 11 Ramsel
66,Bergstraat 71,2023-09-14,04:00:00,8,4,4,FMN GV 11 Ramsel
66,Bergstraat 71,2023-09-14,05:00:00,12,8,4,FMN GV 11 Ramsel
66,Bergstraat 71,2023-09-14,06:00:00,44,12,32,FMN GV 11 Ramsel
66,Bergstraat 71,2023-09-14,07:00:00,210,26,184,FMN GV 11 Ramsel
66,Bergstraat 71,2023-09-14,08:00:00,182,36,146,FMN GV 11 Ramsel
66,Bergstraat 71,2023-09-14,09:00:00,68,18,50,FMN GV 11 Ramsel
66,Bergstraat 71,2023-09-14,10:00:00,106,54,52,FMN GV 11 Ramsel
66,Bergstraat 71,2023-09-14,11:00:00,88,38,50,FMN GV 11 Ramsel
66,Bergstraat 71,2023-09-14,12:00:00,108,54,54,FMN GV 11 Ramsel
66,Bergstraat 71,2023-09-14,13:00:00,180,78,102,FMN GV 11 Ramsel
66,Bergstraat 71,2023-09-14,14:00:00,152,72,80,FMN GV 11 Ramsel
66,Bergstraat 71,2023-09-14,15:00:00,324,228,96,FMN GV 11 Ramsel
66,Bergstraat 71,2023-09-14,16:00:00,230,166,64,FMN GV 11 Ramsel
66,Bergstraat 71,2023-09-14,17:00:00,186,116,70,FMN GV 11 Ramsel
66,Bergstraat 71,2023-09-14,18:00:00,96,56,40,FMN GV 11 Ramsel
66,Bergstraat 71,2023-09-14,19:00:00,92,50,42,FMN GV 11 Ramsel
66,Bergstraat 71,2023-09-14,20:00:00,56,40,16,FMN GV 11 Ramsel
66,Bergstraat 71,2023-09-14,21:00:00,26,12,14,FMN GV 11 Ramsel
66,Bergstraat 71,2023-09-14,22:00:00,28,20,8,FMN GV 11 Ramsel
66,Bergstraat 71,2023-09-14,23:00:00,2,0,2,FMN GV 11 Ramsel
66,Bergstraat 71,2023-09-15,00:00:00,4,4,0,FMN GV 11 Ramsel
66,Bergstraat 71,2023-09-15,01:00:00,2,0,2,FMN GV 11 Ramsel
66,Bergstraat 71,2023-09-15,02:00:00,2,2,0,FMN GV 11 Ramsel
66,Bergstraat 71,2023-09-15,03:00:00,2,0,2,FMN GV 11 Ramsel
66,Bergstraat 71,2023-09-15,04:00:00,10,6,4,FMN GV 11 Ramsel
66,Bergstraat 71,2023-09-15,05:00:00,16,8,8,FMN GV 11 Ramsel
66,Bergstraat 71,2023-09-15,06:00:00,48,18,30,FMN GV 11 Ramsel
66,Bergstraat 71,2023-09-15,07:00:00,244,28,216,FMN GV 11 Ramsel
66,Bergstraat 71,2023-09-15,08:00:00,190,18,172,FMN GV 11 Ramsel
66,Bergstraat 71,2023-09-15,09:00:00,352,294,58,FMN GV 11 Ramsel
66,Bergstraat 71,2023-09-15,10:00:00,106,46,60,FMN GV 11 Ramsel
66,Bergstraat 71,2023-09-15,11:00:00,76,28,48,FMN GV 11 Ramsel
66,Bergstraat 71,2023-09-15,12:00:00,142,72,70,FMN GV 11 Ramsel
66,Bergstraat 71,2023-09-15,13:00:00,186,84,102,FMN GV 11 Ramsel
66,Bergstraat 71,2023-09-15,14:00:00,420,120,300,FMN GV 11 Ramsel
66,Bergstraat 71,2023-09-15,15:00:00,364,256,108,FMN GV 11 Ramsel
66,Bergstraat 71,2023-09-15,16:00:00,278,188,90,FMN GV 11 Ramsel
66,Bergstraat 71,2023-09-15,17:00:00,152,98,54,FMN GV 11 Ramsel
66,Bergstraat 71,2023-09-15,18:00:00,108,48,60,FMN GV 11 Ramsel
66,Bergstraat 71,2023-09-15,19:00:00,84,40,44,FMN GV 11 Ramsel
66,Bergstraat 71,2023-09-15,20:00:00,38,24,14,FMN GV 11 Ramsel
66,Bergstraat 71,2023-09-15,21:00:00,40,22,18,FMN GV 11 Ramsel
66,Bergstraat 71,2023-09-15,22:00:00,22,12,10,FMN GV 11 Ramsel
66,Bergstraat 71,2023-09-15,23:00:00,14,10,4,FMN GV 11 Ramsel
66,Bergstraat 71,2023-09-16,00:00:00,34,24,10,FMN GV 11 Ramsel
66,Bergstraat 71,2023-09-16,01:00:00,12,8,4,FMN GV 11 Ramsel
66,Bergstraat 71,2023-09-16,02:00:00,0,0,0,FMN GV 11 Ramsel
66,Bergstraat 71,2023-09-16,03:00:00,0,0,0,FMN GV 11 Ramsel
66,Bergstraat 71,2023-09-16,04:00:00,4,4,0,FMN GV 11 Ramsel
66,Bergstraat 71,2023-09-16,05:00:00,6,6,0,FMN GV 11 Ramsel
66,Bergstraat 71,2023-09-16,06:00:00,8,2,6,FMN GV 11 Ramsel
66,Bergstraat 71,2023-09-16,07:00:00,14,10,4,FMN GV 11 Ramsel
66,Bergstraat 71,2023-09-16,08:00:00,46,10,36,FMN GV 11 Ramsel
66,Bergstraat 71,2023-09-16,09:00:00,88,28,60,FMN GV 11 Ramsel
66,Bergstraat 71,2023-09-16,10:00:00,148,76,72,FMN GV 11 Ramsel
66,Bergstraat 71,2023-09-16,11:00:00,120,60,60,FMN GV 11 Ramsel
66,Bergstraat 71,2023-09-16,12:00:00,168,74,94,FMN GV 11 Ramsel
66,Bergstraat 71,2023-09-16,13:00:00,250,124,126,FMN GV 11 Ramsel
66,Bergstraat 71,2023-09-16,14:00:00,258,128,130,FMN GV 11 Ramsel
66,Bergstraat 71,2023-09-16,15:00:00,270,140,130,FMN GV 11 Ramsel
66,Bergstraat 71,2023-09-16,16:00:00,178,92,86,FMN GV 11 Ramsel
66,Bergstraat 71,2023-09-16,17:00:00,134,74,60,FMN GV 11 Ramsel
66,Bergstraat 71,2023-09-16,18:00:00,98,48,50,FMN GV 11 Ramsel
66,Bergstraat 71,2023-09-16,19:00:00,88,42,46,FMN GV 11 Ramsel
66,Bergstraat 71,2023-09-16,20:00:00,50,22,28,FMN GV 11 Ramsel
66,Bergstraat 71,2023-09-16,21:00:00,10,10,0,FMN GV 11 Ramsel
66,Bergstraat 71,2023-09-16,22:00:00,12,8,4,FMN GV 11 Ramsel
66,Bergstraat 71,2023-09-16,23:00:00,8,4,4,FMN GV 11 Ramsel
66,Bergstraat 71,2023-09-17,00:00:00,4,4,0,FMN GV 11 Ramsel
66,Bergstraat 71,2023-09-17,01:00:00,2,2,0,FMN GV 11 Ramsel
66,Bergstraat 71,2023-09-17,02:00:00,6,6,0,FMN GV 11 Ramsel
66,Bergstraat 71,2023-09-17,03:00:00,0,0,0,FMN GV 11 Ramsel
66,Bergstraat 71,2023-09-17,04:00:00,2,2,0,FMN GV 11 Ramsel
66,Bergstraat 71,2023-09-17,05:00:00,0,0,0,FMN GV 11 Ramsel
66,Bergstraat 71,2023-09-17,06:00:00,8,0,8,FMN GV 11 Ramsel
66,Bergstraat 71,2023-09-17,07:00:00,12,6,6,FMN GV 11 Ramsel
66,Bergstraat 71,2023-09-17,08:00:00,78,4,74,FMN GV 11 Ramsel
66,Bergstraat 71,2023-09-17,09:00:00,90,52,38,FMN GV 11 Ramsel
66,Bergstraat 71,2023-09-17,10:00:00,166,102,64,FMN GV 11 Ramsel
66,Bergstraat 71,2023-09-17,11:00:00,184,106,78,FMN GV 11 Ramsel
66,Bergstraat 71,2023-09-17,12:00:00,148,76,72,FMN GV 11 Ramsel
66,Bergstraat 71,2023-09-17,13:00:00,232,92,140,FMN GV 11 Ramsel
66,Bergstraat 71,2023-09-17,14:00:00,310,128,182,FMN GV 11 Ramsel
66,Bergstraat 71,2023-09-17,15:00:00,212,128,84,FMN GV 11 Ramsel
66,Bergstraat 71,2023-09-17,16:00:00,178,94,84,FMN GV 11 Ramsel
66,Bergstraat 71,2023-09-17,17:00:00,174,86,88,FMN GV 11 Ramsel
66,Bergstraat 71,2023-09-17,18:00:00,74,28,46,FMN GV 11 Ramsel
66,Bergstraat 71,2023-09-17,19:00:00,66,34,32,FMN GV 11 Ramsel
66,Bergstraat 71,2023-09-17,20:00:00,32,22,10,FMN GV 11 Ramsel
66,Bergstraat 71,2023-09-17,21:00:00,14,10,4,FMN GV 11 Ramsel
66,Bergstraat 71,2023-09-17,22:00:00,2,0,2,FMN GV 11 Ramsel
66,Bergstraat 71,2023-09-17,23:00:00,6,2,4,FMN GV 11 Ramsel
66,Bergstraat 71,2023-09-18,00:00:00,0,0,0,FMN GV 11 Ramsel
66,Bergstraat 71,2023-09-18,01:00:00,2,0,2,FMN GV 11 Ramsel
66,Bergstraat 71,2023-09-18,02:00:00,2,2,0,FMN GV 11 Ramsel
66,Bergstraat 71,2023-09-18,03:00:00,0,0,0,FMN GV 11 Ramsel
66,Bergstraat 71,2023-09-18,04:00:00,6,4,2,FMN GV 11 Ramsel
66,Bergstraat 71,2023-09-18,05:00:00,10,2,8,FMN GV 11 Ramsel
66,Bergstraat 71,2023-09-18,06:00:00,22,6,16,FMN GV 11 Ramsel
66,Bergstraat 71,2023-09-18,07:00:00,264,26,238,FMN GV 11 Ramsel
66,Bergstraat 71,2023-09-18,08:00:00,230,36,194,FMN GV 11 Ramsel
66,Bergstraat 71,2023-09-18,09:00:00,60,20,40,FMN GV 11 Ramsel
66,Bergstraat 71,2023-09-18,10:00:00,52,24,28,FMN GV 11 Ramsel
66,Bergstraat 71,2023-09-18,11:00:00,82,40,42,FMN GV 11 Ramsel
66,Bergstraat 71,2023-09-18,12:00:00,62,30,32,FMN GV 11 Ramsel
66,Bergstraat 71,2023-09-18,13:00:00,132,54,78,FMN GV 11 Ramsel
66,Bergstraat 71,2023-09-18,14:00:00,114,70,44,FMN GV 11 Ramsel
66,Bergstraat 71,2023-09-18,15:00:00,266,210,56,FMN GV 11 Ramsel
66,Bergstraat 71,2023-09-18,16:00:00,198,152,46,FMN GV 11 Ramsel
66,Bergstraat 71,2023-09-18,17:00:00,110,74,36,FMN GV 11 Ramsel
66,Bergstraat 71,2023-09-18,18:00:00,70,44,26,FMN GV 11 Ramsel
66,Bergstraat 71,2023-09-18,19:00:00,56,32,24,FMN GV 11 Ramsel
66,Bergstraat 71,2023-09-18,20:00:00,22,6,16,FMN GV 11 Ramsel
66,Bergstraat 71,2023-09-18,21:00:00,20,12,8,FMN GV 11 Ramsel
66,Bergstraat 71,2023-09-18,22:00:00,10,6,4,FMN GV 11 Ramsel
66,Bergstraat 71,2023-09-18,23:00:00,2,2,0,FMN GV 11 Ramsel
66,Bergstraat 71,2023-09-19,00:00:00,0,0,0,FMN GV 11 Ramsel
66,Bergstraat 71,2023-09-19,01:00:00,0,0,0,FMN GV 11 Ramsel
66,Bergstraat 71,2023-09-19,02:00:00,0,0,0,FMN GV 11 Ramsel
66,Bergstraat 71,2023-09-19,03:00:00,0,0,0,FMN GV 11 Ramsel
66,Bergstraat 71,2023-09-19,04:00:00,8,4,4,FMN GV 11 Ramsel
66,Bergstraat 71,2023-09-19,05:00:00,26,12,14,FMN GV 11 Ramsel
66,Bergstraat 71,2023-09-19,06:00:00,42,10,32,FMN GV 11 Ramsel
66,Bergstraat 71,2023-09-19,07:00:00,272,22,250,FMN GV 11 Ramsel
66,Bergstraat 71,2023-09-19,08:00:00,184,28,156,FMN GV 11 Ramsel
66,Bergstraat 71,2023-09-19,09:00:00,48,16,32,FMN GV 11 Ramsel
66,Bergstraat 71,2023-09-19,10:00:00,46,26,20,FMN GV 11 Ramsel
66,Bergstraat 71,2023-09-19,11:00:00,52,22,30,FMN GV 11 Ramsel
66,Bergstraat 71,2023-09-19,12:00:00,102,52,50,FMN GV 11 Ramsel
66,Bergstraat 71,2023-09-19,13:00:00,176,74,102,FMN GV 11 Ramsel
66,Bergstraat 71,2023-09-19,14:00:00,160,90,70,FMN GV 11 Ramsel
66,Bergstraat 71,2023-09-19,15:00:00,296,216,80,FMN GV 11 Ramsel
66,Bergstraat 71,2023-09-19,16:00:00,252,204,48,FMN GV 11 Ramsel
66,Bergstraat 71,2023-09-19,17:00:00,132,92,40,FMN GV 11 Ramsel
66,Bergstraat 71,2023-09-19,18:00:00,110,54,56,FMN GV 11 Ramsel
66,Bergstraat 71,2023-09-19,19:00:00,74,30,44,FMN GV 11 Ramsel
66,Bergstraat 71,2023-09-19,20:00:00,40,28,12,FMN GV 11 Ramsel
66,Bergstraat 71,2023-09-19,21:00:00,18,8,10,FMN GV 11 Ramsel
66,Bergstraat 71,2023-09-19,22:00:00,26,20,6,FMN GV 11 Ramsel
66,Bergstraat 71,2023-09-19,23:00:00,6,6,0,FMN GV 11 Ramsel
66,Bergstraat 71,2023-09-20,00:00:00,2,2,0,FMN GV 11 Ramsel
66,Bergstraat 71,2023-09-20,01:00:00,0,0,0,FMN GV 11 Ramsel
66,Bergstraat 71,2023-09-20,02:00:00,0,0,0,FMN GV 11 Ramsel
66,Bergstraat 71,2023-09-20,03:00:00,0,0,0,FMN GV 11 Ramsel
66,Bergstraat 71,2023-09-20,04:00:00,12,6,6,FMN GV 11 Ramsel
66,Bergstraat 71,2023-09-20,05:00:00,18,8,10,FMN GV 11 Ramsel
66,Bergstraat 71,2023-09-20,06:00:00,48,14,34,FMN GV 11 Ramsel
66,Bergstraat 71,2023-09-20,07:00:00,240,18,222,FMN GV 11 Ramsel
66,Bergstraat 71,2023-09-20,08:00:00,192,26,166,FMN GV 11 Ramsel
66,Bergstraat 71,2023-09-20,09:00:00,82,28,54,FMN GV 11 Ramsel
66,Bergstraat 71,2023-09-20,10:00:00,92,48,44,FMN GV 11 Ramsel
66,Bergstraat 71,2023-09-20,11:00:00,112,70,42,FMN GV 11 Ramsel
66,Bergstraat 71,2023-09-20,12:00:00,360,302,58,FMN GV 11 Ramsel
66,Bergstraat 71,2023-09-20,13:00:00,158,94,64,FMN GV 11 Ramsel
66,Bergstraat 71,2023-09-20,14:00:00,164,76,88,FMN GV 11 Ramsel
66,Bergstraat 71,2023-09-20,15:00:00,124,72,52,FMN GV 11 Ramsel
66,Bergstraat 71,2023-09-20,16:00:00,152,106,46,FMN GV 11 Ramsel
66,Bergstraat 71,2023-09-20,17:00:00,156,98,58,FMN GV 11 Ramsel
66,Bergstraat 71,2023-09-20,18:00:00,130,62,68,FMN GV 11 Ramsel
66,Bergstraat 71,2023-09-20,19:00:00,98,58,40,FMN GV 11 Ramsel
66,Bergstraat 71,2023-09-20,20:00:00,54,26,28,FMN GV 11 Ramsel
66,Bergstraat 71,2023-09-20,21:00:00,28,20,8,FMN GV 11 Ramsel
66,Bergstraat 71,2023-09-20,22:00:00,10,2,8,FMN GV 11 Ramsel
66,Bergstraat 71,2023-09-20,23:00:00,8,8,0,FMN GV 11 Ramsel
66,Bergstraat 71,2023-09-21,00:00:00,0,0,0,FMN GV 11 Ramsel
66,Bergstraat 71,2023-09-21,01:00:00,0,0,0,FMN GV 11 Ramsel
66,Bergstraat 71,2023-09-21,02:00:00,0,0,0,FMN GV 11 Ramsel
66,Bergstraat 71,2023-09-21,03:00:00,0,0,0,FMN GV 11 Ramsel
66,Bergstraat 71,2023-09-21,04:00:00,4,4,0,FMN GV 11 Ramsel
66,Bergstraat 71,2023-09-21,05:00:00,14,10,4,FMN GV 11 Ramsel
66,Bergstraat 71,2023-09-21,06:00:00,32,6,26,FMN GV 11 Ramsel
66,Bergstraat 71,2023-09-21,07:00:00,102,10,92,FMN GV 11 Ramsel
66,Bergstraat 71,2023-09-21,08:00:00,104,8,96,FMN GV 11 Ramsel
66,Bergstraat 71,2023-09-21,09:00:00,22,4,18,FMN GV 11 Ramsel
66,Bergstraat 71,2023-09-21,10:00:00,6,4,2,FMN GV 11 Ramsel
66,Bergstraat 71,2023-09-21,11:00:00,18,8,10,FMN GV 11 Ramsel
66,Bergstraat 71,2023-09-21,12:00:00,6,2,4,FMN GV 11 Ramsel
66,Bergstraat 71,2023-09-21,13:00:00,18,14,4,FMN GV 11 Ramsel
66,Bergstraat 71,2023-09-21,14:00:00,20,8,12,FMN GV 11 Ramsel
66,Bergstraat 71,2023-09-21,15:00:00,106,102,4,FMN GV 11 Ramsel
66,Bergstraat 71,2023-09-21,16:00:00,86,72,14,FMN GV 11 Ramsel
66,Bergstraat 71,2023-09-21,17:00:00,48,30,18,FMN GV 11 Ramsel
66,Bergstraat 71,2023-09-21,18:00:00,26,18,8,FMN GV 11 Ramsel
66,Bergstraat 71,2023-09-21,19:00:00,24,10,14,FMN GV 11 Ramsel
66,Bergstraat 71,2023-09-21,20:00:00,24,12,12,FMN GV 11 Ramsel
66,Bergstraat 71,2023-09-21,21:00:00,14,8,6,FMN GV 11 Ramsel
66,Bergstraat 71,2023-09-21,22:00:00,26,16,10,FMN GV 11 Ramsel
66,Bergstraat 71,2023-09-21,23:00:00,6,4,2,FMN GV 11 Ramsel
66,Bergstraat 71,2023-09-22,00:00:00,2,2,0,FMN GV 11 Ramsel
66,Bergstraat 71,2023-09-22,01:00:00,0,0,0,FMN GV 11 Ramsel
66,Bergstraat 71,2023-09-22,02:00:00,0,0,0,FMN GV 11 Ramsel
66,Bergstraat 71,2023-09-22,03:00:00,0,0,0,FMN GV 11 Ramsel
66,Bergstraat 71,2023-09-22,04:00:00,4,4,0,FMN GV 11 Ramsel
66,Bergstraat 71,2023-09-22,05:00:00,14,8,6,FMN GV 11 Ramsel
66,Bergstraat 71,2023-09-22,06:00:00,20,4,16,FMN GV 11 Ramsel
66,Bergstraat 71,2023-09-22,07:00:00,164,8,156,FMN GV 11 Ramsel
66,Bergstraat 71,2023-09-22,08:00:00,196,28,168,FMN GV 11 Ramsel
66,Bergstraat 71,2023-09-22,09:00:00,56,18,38,FMN GV 11 Ramsel
66,Bergstraat 71,2023-09-22,10:00:00,90,30,60,FMN GV 11 Ramsel
66,Bergstraat 71,2023-09-22,11:00:00,168,46,122,FMN GV 11 Ramsel
66,Bergstraat 71,2023-09-22,12:00:00,88,54,34,FMN GV 11 Ramsel
66,Bergstraat 71,2023-09-22,13:00:00,58,34,24,FMN GV 11 Ramsel
66,Bergstraat 71,2023-09-22,14:00:00,88,64,24,FMN GV 11 Ramsel
66,Bergstraat 71,2023-09-22,15:00:00,204,178,26,FMN GV 11 Ramsel
66,Bergstraat 71,2023-09-22,16:00:00,162,126,36,FMN GV 11 Ramsel
66,Bergstraat 71,2023-09-22,17:00:00,56,36,20,FMN GV 11 Ramsel
66,Bergstraat 71,2023-09-22,18:00:00,20,16,4,FMN GV 11 Ramsel
66,Bergstraat 71,2023-09-22,19:00:00,34,10,24,FMN GV 11 Ramsel
66,Bergstraat 71,2023-09-22,20:00:00,12,6,6,FMN GV 11 Ramsel
66,Bergstraat 71,2023-09-22,21:00:00,18,4,14,FMN GV 11 Ramsel
66,Bergstraat 71,2023-09-22,22:00:00,20,14,6,FMN GV 11 Ramsel
66,Bergstraat 71,2023-09-22,23:00:00,6,4,2,FMN GV 11 Ramsel
66,Bergstraat 71,2023-09-23,00:00:00,4,2,2,FMN GV 11 Ramsel
66,Bergstraat 71,2023-09-23,01:00:00,6,6,0,FMN GV 11 Ramsel
66,Bergstraat 71,2023-09-23,02:00:00,10,10,0,FMN GV 11 Ramsel
66,Bergstraat 71,2023-09-23,03:00:00,4,4,0,FMN GV 11 Ramsel
66,Bergstraat 71,2023-09-23,04:00:00,8,8,0,FMN GV 11 Ramsel
66,Bergstraat 71,2023-09-23,05:00:00,0,0,0,FMN GV 11 Ramsel
66,Bergstraat 71,2023-09-23,06:00:00,0,0,0,FMN GV 11 Ramsel
66,Bergstraat 71,2023-09-23,07:00:00,10,2,8,FMN GV 11 Ramsel
66,Bergstraat 71,2023-09-23,08:00:00,28,6,22,FMN GV 11 Ramsel
66,Bergstraat 71,2023-09-23,09:00:00,52,16,36,FMN GV 11 Ramsel
66,Bergstraat 71,2023-09-23,10:00:00,112,50,62,FMN GV 11 Ramsel
66,Bergstraat 71,2023-09-23,11:00:00,94,44,50,FMN GV 11 Ramsel
66,Bergstraat 71,2023-09-23,12:00:00,104,50,54,FMN GV 11 Ramsel
66,Bergstraat 71,2023-09-23,13:00:00,148,56,92,FMN GV 11 Ramsel
66,Bergstraat 71,2023-09-23,14:00:00,222,114,108,FMN GV 11 Ramsel
66,Bergstraat 71,2023-09-23,15:00:00,126,54,72,FMN GV 11 Ramsel
66,Bergstraat 71,2023-09-23,16:00:00,104,68,36,FMN GV 11 Ramsel
66,Bergstraat 71,2023-09-23,17:00:00,72,34,38,FMN GV 11 Ramsel
66,Bergstraat 71,2023-09-23,18:00:00,74,40,34,FMN GV 11 Ramsel
66,Bergstraat 71,2023-09-23,19:00:00,50,22,28,FMN GV 11 Ramsel
66,Bergstraat 71,2023-09-23,20:00:00,26,10,16,FMN GV 11 Ramsel
66,Bergstraat 71,2023-09-23,21:00:00,16,8,8,FMN GV 11 Ramsel
66,Bergstraat 71,2023-09-23,22:00:00,10,4,6,FMN GV 11 Ramsel
66,Bergstraat 71,2023-09-23,23:00:00,6,6,0,FMN GV 11 Ramsel
66,Bergstraat 71,2023-09-24,00:00:00,6,4,2,FMN GV 11 Ramsel
66,Bergstraat 71,2023-09-24,01:00:00,0,0,0,FMN GV 11 Ramsel
66,Bergstraat 71,2023-09-24,02:00:00,12,4,8,FMN GV 11 Ramsel
66,Bergstraat 71,2023-09-24,03:00:00,4,2,2,FMN GV 11 Ramsel
66,Bergstraat 71,2023-09-24,04:00:00,2,0,2,FMN GV 11 Ramsel
66,Bergstraat 71,2023-09-24,05:00:00,2,2,0,FMN GV 11 Ramsel
66,Bergstraat 71,2023-09-24,06:00:00,0,0,0,FMN GV 11 Ramsel
66,Bergstraat 71,2023-09-24,07:00:00,10,4,6,FMN GV 11 Ramsel
66,Bergstraat 71,2023-09-24,08:00:00,64,22,42,FMN GV 11 Ramsel
66,Bergstraat 71,2023-09-24,09:00:00,138,60,78,FMN GV 11 Ramsel
66,Bergstraat 71,2023-09-24,10:00:00,242,156,86,FMN GV 11 Ramsel
66,Bergstraat 71,2023-09-24,11:00:00,148,78,70,FMN GV 11 Ramsel
66,Bergstraat 71,2023-09-24,12:00:00,184,86,98,FMN GV 11 Ramsel
66,Bergstraat 71,2023-09-24,13:00:00,314,140,174,FMN GV 11 Ramsel
66,Bergstraat 71,2023-09-24,14:00:00,302,156,146,FMN GV 11 Ramsel
66,Bergstraat 71,2023-09-24,15:00:00,318,150,168,FMN GV 11 Ramsel
66,Bergstraat 71,2023-09-24,16:00:00,240,144,96,FMN GV 11 Ramsel
66,Bergstraat 71,2023-09-24,17:00:00,194,118,76,FMN GV 11 Ramsel
66,Bergstraat 71,2023-09-24,18:00:00,96,42,54,FMN GV 11 Ramsel
66,Bergstraat 71,2023-09-24,19:00:00,58,32,26,FMN GV 11 Ramsel
66,Bergstraat 71,2023-09-24,20:00:00,24,10,14,FMN GV 11 Ramsel
66,Bergstraat 71,2023-09-24,21:00:00,6,2,4,FMN GV 11 Ramsel
66,Bergstraat 71,2023-09-24,22:00:00,12,12,0,FMN GV 11 Ramsel
66,Bergstraat 71,2023-09-24,23:00:00,4,4,0,FMN GV 11 Ramsel
66,Bergstraat 71,2023-09-25,00:00:00,2,2,0,FMN GV 11 Ramsel
66,Bergstraat 71,2023-09-25,01:00:00,0,0,0,FMN GV 11 Ramsel
66,Bergstraat 71,2023-09-25,02:00:00,0,0,0,FMN GV 11 Ramsel
66,Bergstraat 71,2023-09-25,03:00:00,2,0,2,FMN GV 11 Ramsel
66,Bergstraat 71,2023-09-25,04:00:00,6,6,0,FMN GV 11 Ramsel
66,Bergstraat 71,2023-09-25,05:00:00,18,8,10,FMN GV 11 Ramsel
66,Bergstraat 71,2023-09-25,06:00:00,54,14,40,FMN GV 11 Ramsel
66,Bergstraat 71,2023-09-25,07:00:00,228,26,202,FMN GV 11 Ramsel
66,Bergstraat 71,2023-09-25,08:00:00,176,30,146,FMN GV 11 Ramsel
66,Bergstraat 71,2023-09-25,09:00:00,66,30,36,FMN GV 11 Ramsel
66,Bergstraat 71,2023-09-25,10:00:00,76,32,44,FMN GV 11 Ramsel
66,Bergstraat 71,2023-09-25,11:00:00,52,20,32,FMN GV 11 Ramsel
66,Bergstraat 71,2023-09-25,12:00:00,122,50,72,FMN GV 11 Ramsel
66,Bergstraat 71,2023-09-25,13:00:00,152,80,72,FMN GV 11 Ramsel
66,Bergstraat 71,2023-09-25,14:00:00,172,74,98,FMN GV 11 Ramsel
66,Bergstraat 71,2023-09-25,15:00:00,302,216,86,FMN GV 11 Ramsel
66,Bergstraat 71,2023-09-25,16:00:00,226,168,58,FMN GV 11 Ramsel
66,Bergstraat 71,2023-09-25,17:00:00,156,92,64,FMN GV 11 Ramsel
66,Bergstraat 71,2023-09-25,18:00:00,154,86,68,FMN GV 11 Ramsel
66,Bergstraat 71,2023-09-25,19:00:00,90,54,36,FMN GV 11 Ramsel
66,Bergstraat 71,2023-09-25,20:00:00,26,8,18,FMN GV 11 Ramsel
66,Bergstraat 71,2023-09-25,21:00:00,24,16,8,FMN GV 11 Ramsel
66,Bergstraat 71,2023-09-25,22:00:00,14,12,2,FMN GV 11 Ramsel
66,Bergstraat 71,2023-09-25,23:00:00,4,0,4,FMN GV 11 Ramsel
66,Bergstraat 71,2023-09-26,00:00:00,2,2,0,FMN GV 11 Ramsel
66,Bergstraat 71,2023-09-26,01:00:00,0,0,0,FMN GV 11 Ramsel
66,Bergstraat 71,2023-09-26,02:00:00,2,2,0,FMN GV 11 Ramsel
66,Bergstraat 71,2023-09-26,03:00:00,0,0,0,FMN GV 11 Ramsel
66,Bergstraat 71,2023-09-26,04:00:00,8,6,2,FMN GV 11 Ramsel
66,Bergstraat 71,2023-09-26,05:00:00,28,12,16,FMN GV 11 Ramsel
66,Bergstraat 71,2023-09-26,06:00:00,62,20,42,FMN GV 11 Ramsel
66,Bergstraat 71,2023-09-26,07:00:00,290,32,258,FMN GV 11 Ramsel
66,Bergstraat 71,2023-09-26,08:00:00,212,42,170,FMN GV 11 Ramsel
66,Bergstraat 71,2023-09-26,09:00:00,74,28,46,FMN GV 11 Ramsel
66,Bergstraat 71,2023-09-26,10:00:00,94,46,48,FMN GV 11 Ramsel
66,Bergstraat 71,2023-09-26,11:00:00,176,122,54,FMN GV 11 Ramsel
66,Bergstraat 71,2023-09-26,12:00:00,96,36,60,FMN GV 11 Ramsel
66,Bergstraat 71,2023-09-26,13:00:00,218,104,114,FMN GV 11 Ramsel
66,Bergstraat 71,2023-09-26,14:00:00,242,146,96,FMN GV 11 Ramsel
66,Bergstraat 71,2023-09-26,15:00:00,436,342,94,FMN GV 11 Ramsel
66,Bergstraat 71,2023-09-26,16:00:00,322,228,94,FMN GV 11 Ramsel
66,Bergstraat 71,2023-09-26,17:00:00,208,106,102,FMN GV 11 Ramsel
66,Bergstraat 71,2023-09-26,18:00:00,146,96,50,FMN GV 11 Ramsel
66,Bergstraat 71,2023-09-26,19:00:00,88,36,52,FMN GV 11 Ramsel
66,Bergstraat 71,2023-09-26,20:00:00,42,26,16,FMN GV 11 Ramsel
66,Bergstraat 71,2023-09-26,21:00:00,26,18,8,FMN GV 11 Ramsel
66,Bergstraat 71,2023-09-26,22:00:00,30,24,6,FMN GV 11 Ramsel
66,Bergstraat 71,2023-09-26,23:00:00,4,2,2,FMN GV 11 Ramsel
66,Bergstraat 71,2023-09-27,00:00:00,4,2,2,FMN GV 11 Ramsel
66,Bergstraat 71,2023-09-27,01:00:00,2,2,0,FMN GV 11 Ramsel
66,Bergstraat 71,2023-09-27,02:00:00,0,0,0,FMN GV 11 Ramsel
66,Bergstraat 71,2023-09-27,03:00:00,0,0,0,FMN GV 11 Ramsel
66,Bergstraat 71,2023-09-27,04:00:00,8,4,4,FMN GV 11 Ramsel
66,Bergstraat 71,2023-09-27,05:00:00,28,16,12,FMN GV 11 Ramsel
66,Bergstraat 71,2023-09-27,06:00:00,46,20,26,FMN GV 11 Ramsel
66,Bergstraat 71,2023-09-27,07:00:00,234,30,204,FMN GV 11 Ramsel
66,Bergstraat 71,2023-09-27,08:00:00,192,22,170,FMN GV 11 Ramsel
66,Bergstraat 71,2023-09-27,09:00:00,70,28,42,FMN GV 11 Ramsel
66,Bergstraat 71,2023-09-27,10:00:00,58,24,34,FMN GV 11 Ramsel
66,Bergstraat 71,2023-09-27,11:00:00,110,56,54,FMN GV 11 Ramsel
66,Bergstraat 71,2023-09-27,12:00:00,402,328,74,FMN GV 11 Ramsel
66,Bergstraat 71,2023-09-27,13:00:00,256,102,154,FMN GV 11 Ramsel
66,Bergstraat 71,2023-09-27,14:00:00,294,146,148,FMN GV 11 Ramsel
66,Bergstraat 71,2023-09-27,15:00:00,248,154,94,FMN GV 11 Ramsel
66,Bergstraat 71,2023-09-27,16:00:00,254,154,100,FMN GV 11 Ramsel
66,Bergstraat 71,2023-09-27,17:00:00,206,120,86,FMN GV 11 Ramsel
66,Bergstraat 71,2023-09-27,18:00:00,78,44,34,FMN GV 11 Ramsel
66,Bergstraat 71,2023-09-27,19:00:00,70,42,28,FMN GV 11 Ramsel
66,Bergstraat 71,2023-09-27,20:00:00,50,28,22,FMN GV 11 Ramsel
66,Bergstraat 71,2023-09-27,21:00:00,16,10,6,FMN GV 11 Ramsel
66,Bergstraat 71,2023-09-27,22:00:00,0,0,0,FMN GV 11 Ramsel
66,Bergstraat 71,2023-09-27,23:00:00,0,0,0,FMN GV 11 Ramsel
