Meetpunt surrogate key,Meetpunt locatie,Datum,Tijd,Aantal fietsers,Aantal fietsers van,Aantal fietsers naar,Meetpunt code
675,Schijnpoortweg,2022-08-25,00:00:00,63,31,32,FMN 08 Schijnpoortweg
675,Schijnpoortweg,2022-08-25,01:00:00,31,15,16,FMN 08 Schijnpoortweg
675,Schijnpoortweg,2022-08-25,02:00:00,17,9,8,FMN 08 Schijnpoortweg
675,Schijnpoortweg,2022-08-25,03:00:00,21,10,11,FMN 08 Schijnpoortweg
675,Schijnpoortweg,2022-08-25,04:00:00,42,26,16,FMN 08 Schijnpoortweg
675,Schijnpoortweg,2022-08-25,05:00:00,79,39,40,FMN 08 Schijnpoortweg
675,Schijnpoortweg,2022-08-25,06:00:00,137,87,50,FMN 08 Schijnpoortweg
675,Schijnpoortweg,2022-08-25,07:00:00,239,169,70,FMN 08 Schijnpoortweg
675,Schijnpoortweg,2022-08-25,08:00:00,272,215,57,FMN 08 Schijnpoortweg
675,Schijnpoortweg,2022-08-25,09:00:00,159,120,39,FMN 08 Schijnpoortweg
675,Schijnpoortweg,2022-08-25,10:00:00,130,91,39,FMN 08 Schijnpoortweg
675,Schijnpoortweg,2022-08-25,11:00:00,163,111,52,FMN 08 Schijnpoortweg
675,Schijnpoortweg,2022-08-25,12:00:00,160,118,42,FMN 08 Schijnpoortweg
675,Schijnpoortweg,2022-08-25,13:00:00,163,108,55,FMN 08 Schijnpoortweg
675,Schijnpoortweg,2022-08-25,14:00:00,124,86,38,FMN 08 Schijnpoortweg
675,Schijnpoortweg,2022-08-25,15:00:00,221,150,71,FMN 08 Schijnpoortweg
675,Schijnpoortweg,2022-08-25,16:00:00,324,234,90,FMN 08 Schijnpoortweg
675,Schijnpoortweg,2022-08-25,17:00:00,302,183,119,FMN 08 Schijnpoortweg
675,Schijnpoortweg,2022-08-25,18:00:00,282,177,105,FMN 08 Schijnpoortweg
675,Schijnpoortweg,2022-08-25,19:00:00,216,130,86,FMN 08 Schijnpoortweg
675,Schijnpoortweg,2022-08-25,20:00:00,180,89,91,FMN 08 Schijnpoortweg
675,Schijnpoortweg,2022-08-25,21:00:00,138,68,70,FMN 08 Schijnpoortweg
675,Schijnpoortweg,2022-08-25,22:00:00,141,95,46,FMN 08 Schijnpoortweg
675,Schijnpoortweg,2022-08-25,23:00:00,167,125,42,FMN 08 Schijnpoortweg
675,Schijnpoortweg,2022-08-26,00:00:00,63,45,18,FMN 08 Schijnpoortweg
675,Schijnpoortweg,2022-08-26,01:00:00,42,30,12,FMN 08 Schijnpoortweg
675,Schijnpoortweg,2022-08-26,02:00:00,24,9,15,FMN 08 Schijnpoortweg
675,Schijnpoortweg,2022-08-26,03:00:00,19,10,9,FMN 08 Schijnpoortweg
675,Schijnpoortweg,2022-08-26,04:00:00,47,28,19,FMN 08 Schijnpoortweg
675,Schijnpoortweg,2022-08-26,05:00:00,75,39,36,FMN 08 Schijnpoortweg
675,Schijnpoortweg,2022-08-26,06:00:00,119,73,46,FMN 08 Schijnpoortweg
675,Schijnpoortweg,2022-08-26,07:00:00,184,128,56,FMN 08 Schijnpoortweg
675,Schijnpoortweg,2022-08-26,08:00:00,228,172,56,FMN 08 Schijnpoortweg
675,Schijnpoortweg,2022-08-26,09:00:00,118,90,28,FMN 08 Schijnpoortweg
675,Schijnpoortweg,2022-08-26,10:00:00,126,93,33,FMN 08 Schijnpoortweg
675,Schijnpoortweg,2022-08-26,11:00:00,128,84,44,FMN 08 Schijnpoortweg
675,Schijnpoortweg,2022-08-26,12:00:00,174,121,53,FMN 08 Schijnpoortweg
675,Schijnpoortweg,2022-08-26,13:00:00,193,131,62,FMN 08 Schijnpoortweg
675,Schijnpoortweg,2022-08-26,14:00:00,219,146,73,FMN 08 Schijnpoortweg
675,Schijnpoortweg,2022-08-26,15:00:00,237,156,81,FMN 08 Schijnpoortweg
675,Schijnpoortweg,2022-08-26,16:00:00,289,195,94,FMN 08 Schijnpoortweg
675,Schijnpoortweg,2022-08-26,17:00:00,241,156,85,FMN 08 Schijnpoortweg
675,Schijnpoortweg,2022-08-26,18:00:00,247,168,79,FMN 08 Schijnpoortweg
675,Schijnpoortweg,2022-08-26,19:00:00,213,132,81,FMN 08 Schijnpoortweg
675,Schijnpoortweg,2022-08-26,20:00:00,172,105,67,FMN 08 Schijnpoortweg
675,Schijnpoortweg,2022-08-26,21:00:00,136,77,59,FMN 08 Schijnpoortweg
675,Schijnpoortweg,2022-08-26,22:00:00,111,65,46,FMN 08 Schijnpoortweg
675,Schijnpoortweg,2022-08-26,23:00:00,88,51,37,FMN 08 Schijnpoortweg
675,Schijnpoortweg,2022-08-27,00:00:00,66,38,28,FMN 08 Schijnpoortweg
675,Schijnpoortweg,2022-08-27,01:00:00,33,12,21,FMN 08 Schijnpoortweg
675,Schijnpoortweg,2022-08-27,02:00:00,25,11,14,FMN 08 Schijnpoortweg
675,Schijnpoortweg,2022-08-27,03:00:00,17,10,7,FMN 08 Schijnpoortweg
675,Schijnpoortweg,2022-08-27,04:00:00,19,9,10,FMN 08 Schijnpoortweg
675,Schijnpoortweg,2022-08-27,05:00:00,31,21,10,FMN 08 Schijnpoortweg
675,Schijnpoortweg,2022-08-27,06:00:00,55,37,18,FMN 08 Schijnpoortweg
675,Schijnpoortweg,2022-08-27,07:00:00,50,30,20,FMN 08 Schijnpoortweg
675,Schijnpoortweg,2022-08-27,08:00:00,79,55,24,FMN 08 Schijnpoortweg
675,Schijnpoortweg,2022-08-27,09:00:00,130,90,40,FMN 08 Schijnpoortweg
675,Schijnpoortweg,2022-08-27,10:00:00,145,99,46,FMN 08 Schijnpoortweg
675,Schijnpoortweg,2022-08-27,11:00:00,134,101,33,FMN 08 Schijnpoortweg
675,Schijnpoortweg,2022-08-27,12:00:00,182,120,62,FMN 08 Schijnpoortweg
675,Schijnpoortweg,2022-08-27,13:00:00,154,95,59,FMN 08 Schijnpoortweg
675,Schijnpoortweg,2022-08-27,14:00:00,183,128,55,FMN 08 Schijnpoortweg
675,Schijnpoortweg,2022-08-27,15:00:00,177,122,55,FMN 08 Schijnpoortweg
675,Schijnpoortweg,2022-08-27,16:00:00,165,108,57,FMN 08 Schijnpoortweg
675,Schijnpoortweg,2022-08-27,17:00:00,196,123,73,FMN 08 Schijnpoortweg
675,Schijnpoortweg,2022-08-27,18:00:00,175,106,69,FMN 08 Schijnpoortweg
675,Schijnpoortweg,2022-08-27,19:00:00,192,120,72,FMN 08 Schijnpoortweg
675,Schijnpoortweg,2022-08-27,20:00:00,153,87,66,FMN 08 Schijnpoortweg
675,Schijnpoortweg,2022-08-27,21:00:00,138,83,55,FMN 08 Schijnpoortweg
675,Schijnpoortweg,2022-08-27,22:00:00,107,61,46,FMN 08 Schijnpoortweg
675,Schijnpoortweg,2022-08-27,23:00:00,93,51,42,FMN 08 Schijnpoortweg
675,Schijnpoortweg,2022-08-28,00:00:00,63,26,37,FMN 08 Schijnpoortweg
675,Schijnpoortweg,2022-08-28,01:00:00,55,35,20,FMN 08 Schijnpoortweg
675,Schijnpoortweg,2022-08-28,02:00:00,38,26,12,FMN 08 Schijnpoortweg
675,Schijnpoortweg,2022-08-28,03:00:00,28,13,15,FMN 08 Schijnpoortweg
675,Schijnpoortweg,2022-08-28,04:00:00,28,19,9,FMN 08 Schijnpoortweg
675,Schijnpoortweg,2022-08-28,05:00:00,41,25,16,FMN 08 Schijnpoortweg
675,Schijnpoortweg,2022-08-28,06:00:00,30,19,11,FMN 08 Schijnpoortweg
675,Schijnpoortweg,2022-08-28,07:00:00,25,15,10,FMN 08 Schijnpoortweg
675,Schijnpoortweg,2022-08-28,08:00:00,54,36,18,FMN 08 Schijnpoortweg
675,Schijnpoortweg,2022-08-28,09:00:00,90,63,27,FMN 08 Schijnpoortweg
675,Schijnpoortweg,2022-08-28,10:00:00,121,85,36,FMN 08 Schijnpoortweg
675,Schijnpoortweg,2022-08-28,11:00:00,132,95,37,FMN 08 Schijnpoortweg
675,Schijnpoortweg,2022-08-28,12:00:00,135,90,45,FMN 08 Schijnpoortweg
675,Schijnpoortweg,2022-08-28,13:00:00,182,120,62,FMN 08 Schijnpoortweg
675,Schijnpoortweg,2022-08-28,14:00:00,198,154,44,FMN 08 Schijnpoortweg
675,Schijnpoortweg,2022-08-28,15:00:00,177,119,58,FMN 08 Schijnpoortweg
675,Schijnpoortweg,2022-08-28,16:00:00,162,100,62,FMN 08 Schijnpoortweg
675,Schijnpoortweg,2022-08-28,17:00:00,167,116,51,FMN 08 Schijnpoortweg
675,Schijnpoortweg,2022-08-28,18:00:00,183,119,64,FMN 08 Schijnpoortweg
675,Schijnpoortweg,2022-08-28,19:00:00,147,91,56,FMN 08 Schijnpoortweg
675,Schijnpoortweg,2022-08-28,20:00:00,142,80,62,FMN 08 Schijnpoortweg
675,Schijnpoortweg,2022-08-28,21:00:00,149,87,62,FMN 08 Schijnpoortweg
675,Schijnpoortweg,2022-08-28,22:00:00,99,53,46,FMN 08 Schijnpoortweg
675,Schijnpoortweg,2022-08-28,23:00:00,68,31,37,FMN 08 Schijnpoortweg
675,Schijnpoortweg,2022-08-29,00:00:00,54,23,31,FMN 08 Schijnpoortweg
675,Schijnpoortweg,2022-08-29,01:00:00,25,13,12,FMN 08 Schijnpoortweg
675,Schijnpoortweg,2022-08-29,02:00:00,19,8,11,FMN 08 Schijnpoortweg
675,Schijnpoortweg,2022-08-29,03:00:00,12,8,4,FMN 08 Schijnpoortweg
675,Schijnpoortweg,2022-08-29,04:00:00,41,25,16,FMN 08 Schijnpoortweg
675,Schijnpoortweg,2022-08-29,05:00:00,80,43,37,FMN 08 Schijnpoortweg
675,Schijnpoortweg,2022-08-29,06:00:00,152,91,61,FMN 08 Schijnpoortweg
675,Schijnpoortweg,2022-08-29,07:00:00,206,151,55,FMN 08 Schijnpoortweg
675,Schijnpoortweg,2022-08-29,08:00:00,259,197,62,FMN 08 Schijnpoortweg
675,Schijnpoortweg,2022-08-29,09:00:00,141,106,35,FMN 08 Schijnpoortweg
675,Schijnpoortweg,2022-08-29,10:00:00,117,92,25,FMN 08 Schijnpoortweg
675,Schijnpoortweg,2022-08-29,11:00:00,144,95,49,FMN 08 Schijnpoortweg
675,Schijnpoortweg,2022-08-29,12:00:00,169,117,52,FMN 08 Schijnpoortweg
675,Schijnpoortweg,2022-08-29,13:00:00,171,116,55,FMN 08 Schijnpoortweg
675,Schijnpoortweg,2022-08-29,14:00:00,212,145,67,FMN 08 Schijnpoortweg
675,Schijnpoortweg,2022-08-29,15:00:00,199,130,69,FMN 08 Schijnpoortweg
675,Schijnpoortweg,2022-08-29,16:00:00,283,194,89,FMN 08 Schijnpoortweg
675,Schijnpoortweg,2022-08-29,17:00:00,288,175,113,FMN 08 Schijnpoortweg
675,Schijnpoortweg,2022-08-29,18:00:00,223,153,70,FMN 08 Schijnpoortweg
675,Schijnpoortweg,2022-08-29,19:00:00,208,127,81,FMN 08 Schijnpoortweg
675,Schijnpoortweg,2022-08-29,20:00:00,195,115,80,FMN 08 Schijnpoortweg
675,Schijnpoortweg,2022-08-29,21:00:00,152,87,65,FMN 08 Schijnpoortweg
675,Schijnpoortweg,2022-08-29,22:00:00,126,77,49,FMN 08 Schijnpoortweg
675,Schijnpoortweg,2022-08-29,23:00:00,83,38,45,FMN 08 Schijnpoortweg
675,Schijnpoortweg,2022-08-30,00:00:00,33,9,24,FMN 08 Schijnpoortweg
675,Schijnpoortweg,2022-08-30,01:00:00,18,9,9,FMN 08 Schijnpoortweg
675,Schijnpoortweg,2022-08-30,02:00:00,19,10,9,FMN 08 Schijnpoortweg
675,Schijnpoortweg,2022-08-30,03:00:00,9,6,3,FMN 08 Schijnpoortweg
675,Schijnpoortweg,2022-08-30,04:00:00,45,35,10,FMN 08 Schijnpoortweg
675,Schijnpoortweg,2022-08-30,05:00:00,69,29,40,FMN 08 Schijnpoortweg
675,Schijnpoortweg,2022-08-30,06:00:00,147,89,58,FMN 08 Schijnpoortweg
675,Schijnpoortweg,2022-08-30,07:00:00,246,182,64,FMN 08 Schijnpoortweg
675,Schijnpoortweg,2022-08-30,08:00:00,293,231,62,FMN 08 Schijnpoortweg
675,Schijnpoortweg,2022-08-30,09:00:00,177,134,43,FMN 08 Schijnpoortweg
675,Schijnpoortweg,2022-08-30,10:00:00,48,30,18,FMN 08 Schijnpoortweg
675,Schijnpoortweg,2022-08-30,11:00:00,16,5,11,FMN 08 Schijnpoortweg
675,Schijnpoortweg,2022-08-30,12:00:00,17,9,8,FMN 08 Schijnpoortweg
675,Schijnpoortweg,2022-08-30,13:00:00,202,146,56,FMN 08 Schijnpoortweg
675,Schijnpoortweg,2022-08-30,14:00:00,205,157,48,FMN 08 Schijnpoortweg
675,Schijnpoortweg,2022-08-30,15:00:00,262,200,62,FMN 08 Schijnpoortweg
675,Schijnpoortweg,2022-08-30,16:00:00,213,132,81,FMN 08 Schijnpoortweg
675,Schijnpoortweg,2022-08-30,17:00:00,169,58,111,FMN 08 Schijnpoortweg
675,Schijnpoortweg,2022-08-30,18:00:00,165,51,114,FMN 08 Schijnpoortweg
675,Schijnpoortweg,2022-08-30,19:00:00,116,34,82,FMN 08 Schijnpoortweg
675,Schijnpoortweg,2022-08-30,20:00:00,82,27,55,FMN 08 Schijnpoortweg
675,Schijnpoortweg,2022-08-30,21:00:00,88,28,60,FMN 08 Schijnpoortweg
675,Schijnpoortweg,2022-08-30,22:00:00,67,24,43,FMN 08 Schijnpoortweg
675,Schijnpoortweg,2022-08-30,23:00:00,56,13,43,FMN 08 Schijnpoortweg
675,Schijnpoortweg,2022-08-31,00:00:00,35,8,27,FMN 08 Schijnpoortweg
675,Schijnpoortweg,2022-08-31,01:00:00,12,5,7,FMN 08 Schijnpoortweg
675,Schijnpoortweg,2022-08-31,02:00:00,9,3,6,FMN 08 Schijnpoortweg
675,Schijnpoortweg,2022-08-31,03:00:00,8,4,4,FMN 08 Schijnpoortweg
675,Schijnpoortweg,2022-08-31,04:00:00,26,7,19,FMN 08 Schijnpoortweg
675,Schijnpoortweg,2022-08-31,05:00:00,45,10,35,FMN 08 Schijnpoortweg
675,Schijnpoortweg,2022-08-31,06:00:00,73,18,55,FMN 08 Schijnpoortweg
675,Schijnpoortweg,2022-08-31,07:00:00,87,26,61,FMN 08 Schijnpoortweg
675,Schijnpoortweg,2022-08-31,08:00:00,95,44,51,FMN 08 Schijnpoortweg
675,Schijnpoortweg,2022-08-31,09:00:00,59,29,30,FMN 08 Schijnpoortweg
675,Schijnpoortweg,2022-08-31,10:00:00,74,24,50,FMN 08 Schijnpoortweg
675,Schijnpoortweg,2022-08-31,11:00:00,64,30,34,FMN 08 Schijnpoortweg
675,Schijnpoortweg,2022-08-31,12:00:00,92,32,60,FMN 08 Schijnpoortweg
675,Schijnpoortweg,2022-08-31,13:00:00,102,32,70,FMN 08 Schijnpoortweg
675,Schijnpoortweg,2022-08-31,14:00:00,99,41,58,FMN 08 Schijnpoortweg
675,Schijnpoortweg,2022-08-31,15:00:00,132,53,79,FMN 08 Schijnpoortweg
675,Schijnpoortweg,2022-08-31,16:00:00,162,68,94,FMN 08 Schijnpoortweg
675,Schijnpoortweg,2022-08-31,17:00:00,147,41,106,FMN 08 Schijnpoortweg
675,Schijnpoortweg,2022-08-31,18:00:00,149,44,105,FMN 08 Schijnpoortweg
675,Schijnpoortweg,2022-08-31,19:00:00,117,38,79,FMN 08 Schijnpoortweg
675,Schijnpoortweg,2022-08-31,20:00:00,101,29,72,FMN 08 Schijnpoortweg
675,Schijnpoortweg,2022-08-31,21:00:00,87,30,57,FMN 08 Schijnpoortweg
675,Schijnpoortweg,2022-08-31,22:00:00,79,37,42,FMN 08 Schijnpoortweg
675,Schijnpoortweg,2022-08-31,23:00:00,59,23,36,FMN 08 Schijnpoortweg
675,Schijnpoortweg,2022-09-01,00:00:00,39,18,21,FMN 08 Schijnpoortweg
675,Schijnpoortweg,2022-09-01,01:00:00,14,7,7,FMN 08 Schijnpoortweg
675,Schijnpoortweg,2022-09-01,02:00:00,9,4,5,FMN 08 Schijnpoortweg
675,Schijnpoortweg,2022-09-01,03:00:00,9,5,4,FMN 08 Schijnpoortweg
675,Schijnpoortweg,2022-09-01,04:00:00,23,10,13,FMN 08 Schijnpoortweg
675,Schijnpoortweg,2022-09-01,05:00:00,52,12,40,FMN 08 Schijnpoortweg
675,Schijnpoortweg,2022-09-01,06:00:00,79,27,52,FMN 08 Schijnpoortweg
675,Schijnpoortweg,2022-09-01,07:00:00,113,51,62,FMN 08 Schijnpoortweg
675,Schijnpoortweg,2022-09-01,08:00:00,152,76,76,FMN 08 Schijnpoortweg
675,Schijnpoortweg,2022-09-01,09:00:00,87,37,50,FMN 08 Schijnpoortweg
675,Schijnpoortweg,2022-09-01,10:00:00,67,30,37,FMN 08 Schijnpoortweg
675,Schijnpoortweg,2022-09-01,11:00:00,82,38,44,FMN 08 Schijnpoortweg
675,Schijnpoortweg,2022-09-01,12:00:00,98,37,61,FMN 08 Schijnpoortweg
675,Schijnpoortweg,2022-09-01,13:00:00,90,29,61,FMN 08 Schijnpoortweg
675,Schijnpoortweg,2022-09-01,14:00:00,90,30,60,FMN 08 Schijnpoortweg
675,Schijnpoortweg,2022-09-01,15:00:00,151,49,102,FMN 08 Schijnpoortweg
675,Schijnpoortweg,2022-09-01,16:00:00,178,61,117,FMN 08 Schijnpoortweg
675,Schijnpoortweg,2022-09-01,17:00:00,185,73,112,FMN 08 Schijnpoortweg
675,Schijnpoortweg,2022-09-01,18:00:00,156,44,112,FMN 08 Schijnpoortweg
675,Schijnpoortweg,2022-09-01,19:00:00,123,53,70,FMN 08 Schijnpoortweg
675,Schijnpoortweg,2022-09-01,20:00:00,92,26,66,FMN 08 Schijnpoortweg
675,Schijnpoortweg,2022-09-01,21:00:00,71,17,54,FMN 08 Schijnpoortweg
675,Schijnpoortweg,2022-09-01,22:00:00,73,24,49,FMN 08 Schijnpoortweg
675,Schijnpoortweg,2022-09-01,23:00:00,40,13,27,FMN 08 Schijnpoortweg
675,Schijnpoortweg,2022-09-02,00:00:00,31,9,22,FMN 08 Schijnpoortweg
675,Schijnpoortweg,2022-09-02,01:00:00,14,7,7,FMN 08 Schijnpoortweg
675,Schijnpoortweg,2022-09-02,02:00:00,13,5,8,FMN 08 Schijnpoortweg
675,Schijnpoortweg,2022-09-02,03:00:00,11,4,7,FMN 08 Schijnpoortweg
675,Schijnpoortweg,2022-09-02,04:00:00,24,12,12,FMN 08 Schijnpoortweg
675,Schijnpoortweg,2022-09-02,05:00:00,44,11,33,FMN 08 Schijnpoortweg
675,Schijnpoortweg,2022-09-02,06:00:00,68,24,44,FMN 08 Schijnpoortweg
675,Schijnpoortweg,2022-09-02,07:00:00,110,50,60,FMN 08 Schijnpoortweg
675,Schijnpoortweg,2022-09-02,08:00:00,159,76,83,FMN 08 Schijnpoortweg
675,Schijnpoortweg,2022-09-02,09:00:00,58,23,35,FMN 08 Schijnpoortweg
675,Schijnpoortweg,2022-09-02,10:00:00,63,27,36,FMN 08 Schijnpoortweg
675,Schijnpoortweg,2022-09-02,11:00:00,73,26,47,FMN 08 Schijnpoortweg
675,Schijnpoortweg,2022-09-02,12:00:00,87,43,44,FMN 08 Schijnpoortweg
675,Schijnpoortweg,2022-09-02,13:00:00,93,41,52,FMN 08 Schijnpoortweg
675,Schijnpoortweg,2022-09-02,14:00:00,113,50,63,FMN 08 Schijnpoortweg
675,Schijnpoortweg,2022-09-02,15:00:00,148,53,95,FMN 08 Schijnpoortweg
675,Schijnpoortweg,2022-09-02,16:00:00,150,71,79,FMN 08 Schijnpoortweg
675,Schijnpoortweg,2022-09-02,17:00:00,158,59,99,FMN 08 Schijnpoortweg
675,Schijnpoortweg,2022-09-02,18:00:00,148,59,89,FMN 08 Schijnpoortweg
675,Schijnpoortweg,2022-09-02,19:00:00,142,57,85,FMN 08 Schijnpoortweg
675,Schijnpoortweg,2022-09-02,20:00:00,95,25,70,FMN 08 Schijnpoortweg
675,Schijnpoortweg,2022-09-02,21:00:00,82,21,61,FMN 08 Schijnpoortweg
675,Schijnpoortweg,2022-09-02,22:00:00,88,36,52,FMN 08 Schijnpoortweg
675,Schijnpoortweg,2022-09-02,23:00:00,68,25,43,FMN 08 Schijnpoortweg
675,Schijnpoortweg,2022-09-03,00:00:00,49,17,32,FMN 08 Schijnpoortweg
675,Schijnpoortweg,2022-09-03,01:00:00,30,13,17,FMN 08 Schijnpoortweg
675,Schijnpoortweg,2022-09-03,02:00:00,15,6,9,FMN 08 Schijnpoortweg
675,Schijnpoortweg,2022-09-03,03:00:00,14,5,9,FMN 08 Schijnpoortweg
675,Schijnpoortweg,2022-09-03,04:00:00,13,6,7,FMN 08 Schijnpoortweg
675,Schijnpoortweg,2022-09-03,05:00:00,18,8,10,FMN 08 Schijnpoortweg
675,Schijnpoortweg,2022-09-03,06:00:00,24,10,14,FMN 08 Schijnpoortweg
675,Schijnpoortweg,2022-09-03,07:00:00,27,10,17,FMN 08 Schijnpoortweg
675,Schijnpoortweg,2022-09-03,08:00:00,42,20,22,FMN 08 Schijnpoortweg
675,Schijnpoortweg,2022-09-03,09:00:00,61,27,34,FMN 08 Schijnpoortweg
675,Schijnpoortweg,2022-09-03,10:00:00,59,28,31,FMN 08 Schijnpoortweg
675,Schijnpoortweg,2022-09-03,11:00:00,75,25,50,FMN 08 Schijnpoortweg
675,Schijnpoortweg,2022-09-03,12:00:00,76,33,43,FMN 08 Schijnpoortweg
675,Schijnpoortweg,2022-09-03,13:00:00,94,41,53,FMN 08 Schijnpoortweg
675,Schijnpoortweg,2022-09-03,14:00:00,95,52,43,FMN 08 Schijnpoortweg
675,Schijnpoortweg,2022-09-03,15:00:00,115,42,73,FMN 08 Schijnpoortweg
675,Schijnpoortweg,2022-09-03,16:00:00,122,52,70,FMN 08 Schijnpoortweg
675,Schijnpoortweg,2022-09-03,17:00:00,121,53,68,FMN 08 Schijnpoortweg
675,Schijnpoortweg,2022-09-03,18:00:00,127,57,70,FMN 08 Schijnpoortweg
675,Schijnpoortweg,2022-09-03,19:00:00,159,60,99,FMN 08 Schijnpoortweg
675,Schijnpoortweg,2022-09-03,20:00:00,100,43,57,FMN 08 Schijnpoortweg
675,Schijnpoortweg,2022-09-03,21:00:00,75,32,43,FMN 08 Schijnpoortweg
675,Schijnpoortweg,2022-09-03,22:00:00,73,32,41,FMN 08 Schijnpoortweg
675,Schijnpoortweg,2022-09-03,23:00:00,84,50,34,FMN 08 Schijnpoortweg
675,Schijnpoortweg,2022-09-04,00:00:00,54,21,33,FMN 08 Schijnpoortweg
675,Schijnpoortweg,2022-09-04,01:00:00,38,9,29,FMN 08 Schijnpoortweg
675,Schijnpoortweg,2022-09-04,02:00:00,20,7,13,FMN 08 Schijnpoortweg
675,Schijnpoortweg,2022-09-04,03:00:00,17,8,9,FMN 08 Schijnpoortweg
675,Schijnpoortweg,2022-09-04,04:00:00,2,1,1,FMN 08 Schijnpoortweg
675,Schijnpoortweg,2022-09-04,05:00:00,25,11,14,FMN 08 Schijnpoortweg
675,Schijnpoortweg,2022-09-04,06:00:00,15,8,7,FMN 08 Schijnpoortweg
675,Schijnpoortweg,2022-09-04,07:00:00,19,7,12,FMN 08 Schijnpoortweg
675,Schijnpoortweg,2022-09-04,08:00:00,25,11,14,FMN 08 Schijnpoortweg
675,Schijnpoortweg,2022-09-04,09:00:00,41,16,25,FMN 08 Schijnpoortweg
675,Schijnpoortweg,2022-09-04,10:00:00,59,29,30,FMN 08 Schijnpoortweg
675,Schijnpoortweg,2022-09-04,11:00:00,72,30,42,FMN 08 Schijnpoortweg
675,Schijnpoortweg,2022-09-04,12:00:00,75,31,44,FMN 08 Schijnpoortweg
675,Schijnpoortweg,2022-09-04,13:00:00,97,35,62,FMN 08 Schijnpoortweg
675,Schijnpoortweg,2022-09-04,14:00:00,128,53,75,FMN 08 Schijnpoortweg
675,Schijnpoortweg,2022-09-04,15:00:00,102,46,56,FMN 08 Schijnpoortweg
675,Schijnpoortweg,2022-09-04,16:00:00,61,53,8,FMN 08 Schijnpoortweg
675,Schijnpoortweg,2022-09-04,17:00:00,134,76,58,FMN 08 Schijnpoortweg
675,Schijnpoortweg,2022-09-04,18:00:00,159,97,62,FMN 08 Schijnpoortweg
675,Schijnpoortweg,2022-09-04,19:00:00,115,50,65,FMN 08 Schijnpoortweg
675,Schijnpoortweg,2022-09-04,20:00:00,81,39,42,FMN 08 Schijnpoortweg
675,Schijnpoortweg,2022-09-04,21:00:00,83,27,56,FMN 08 Schijnpoortweg
675,Schijnpoortweg,2022-09-04,22:00:00,71,29,42,FMN 08 Schijnpoortweg
675,Schijnpoortweg,2022-09-04,23:00:00,54,19,35,FMN 08 Schijnpoortweg
675,Schijnpoortweg,2022-09-05,00:00:00,36,9,27,FMN 08 Schijnpoortweg
675,Schijnpoortweg,2022-09-05,01:00:00,19,9,10,FMN 08 Schijnpoortweg
675,Schijnpoortweg,2022-09-05,02:00:00,15,5,10,FMN 08 Schijnpoortweg
675,Schijnpoortweg,2022-09-05,03:00:00,9,2,7,FMN 08 Schijnpoortweg
675,Schijnpoortweg,2022-09-05,04:00:00,31,12,19,FMN 08 Schijnpoortweg
675,Schijnpoortweg,2022-09-05,05:00:00,46,14,32,FMN 08 Schijnpoortweg
675,Schijnpoortweg,2022-09-05,06:00:00,69,24,45,FMN 08 Schijnpoortweg
675,Schijnpoortweg,2022-09-05,07:00:00,120,51,69,FMN 08 Schijnpoortweg
675,Schijnpoortweg,2022-09-05,08:00:00,150,80,70,FMN 08 Schijnpoortweg
675,Schijnpoortweg,2022-09-05,09:00:00,87,46,41,FMN 08 Schijnpoortweg
675,Schijnpoortweg,2022-09-05,10:00:00,44,18,26,FMN 08 Schijnpoortweg
675,Schijnpoortweg,2022-09-05,11:00:00,48,21,27,FMN 08 Schijnpoortweg
675,Schijnpoortweg,2022-09-05,12:00:00,97,45,52,FMN 08 Schijnpoortweg
675,Schijnpoortweg,2022-09-05,13:00:00,76,35,41,FMN 08 Schijnpoortweg
675,Schijnpoortweg,2022-09-05,14:00:00,92,38,54,FMN 08 Schijnpoortweg
675,Schijnpoortweg,2022-09-05,15:00:00,145,50,95,FMN 08 Schijnpoortweg
675,Schijnpoortweg,2022-09-05,16:00:00,208,83,125,FMN 08 Schijnpoortweg
675,Schijnpoortweg,2022-09-05,17:00:00,191,65,126,FMN 08 Schijnpoortweg
675,Schijnpoortweg,2022-09-05,18:00:00,154,57,97,FMN 08 Schijnpoortweg
675,Schijnpoortweg,2022-09-05,19:00:00,100,38,62,FMN 08 Schijnpoortweg
675,Schijnpoortweg,2022-09-05,20:00:00,89,31,58,FMN 08 Schijnpoortweg
675,Schijnpoortweg,2022-09-05,21:00:00,61,22,39,FMN 08 Schijnpoortweg
675,Schijnpoortweg,2022-09-05,22:00:00,39,16,23,FMN 08 Schijnpoortweg
675,Schijnpoortweg,2022-09-05,23:00:00,40,12,28,FMN 08 Schijnpoortweg
675,Schijnpoortweg,2022-09-06,00:00:00,17,7,10,FMN 08 Schijnpoortweg
675,Schijnpoortweg,2022-09-06,01:00:00,9,2,7,FMN 08 Schijnpoortweg
675,Schijnpoortweg,2022-09-06,02:00:00,9,3,6,FMN 08 Schijnpoortweg
675,Schijnpoortweg,2022-09-06,03:00:00,9,3,6,FMN 08 Schijnpoortweg
675,Schijnpoortweg,2022-09-06,04:00:00,16,12,4,FMN 08 Schijnpoortweg
675,Schijnpoortweg,2022-09-06,05:00:00,57,13,44,FMN 08 Schijnpoortweg
675,Schijnpoortweg,2022-09-06,06:00:00,73,30,43,FMN 08 Schijnpoortweg
675,Schijnpoortweg,2022-09-06,07:00:00,139,71,68,FMN 08 Schijnpoortweg
675,Schijnpoortweg,2022-09-06,08:00:00,137,65,72,FMN 08 Schijnpoortweg
675,Schijnpoortweg,2022-09-06,09:00:00,85,37,48,FMN 08 Schijnpoortweg
675,Schijnpoortweg,2022-09-06,10:00:00,73,36,37,FMN 08 Schijnpoortweg
675,Schijnpoortweg,2022-09-06,11:00:00,77,27,50,FMN 08 Schijnpoortweg
675,Schijnpoortweg,2022-09-06,12:00:00,94,46,48,FMN 08 Schijnpoortweg
675,Schijnpoortweg,2022-09-06,13:00:00,82,30,52,FMN 08 Schijnpoortweg
675,Schijnpoortweg,2022-09-06,14:00:00,85,33,52,FMN 08 Schijnpoortweg
675,Schijnpoortweg,2022-09-06,15:00:00,153,62,91,FMN 08 Schijnpoortweg
675,Schijnpoortweg,2022-09-06,16:00:00,225,79,146,FMN 08 Schijnpoortweg
675,Schijnpoortweg,2022-09-06,17:00:00,190,67,123,FMN 08 Schijnpoortweg
675,Schijnpoortweg,2022-09-06,18:00:00,150,41,109,FMN 08 Schijnpoortweg
675,Schijnpoortweg,2022-09-06,19:00:00,119,38,81,FMN 08 Schijnpoortweg
675,Schijnpoortweg,2022-09-06,20:00:00,110,31,79,FMN 08 Schijnpoortweg
675,Schijnpoortweg,2022-09-06,21:00:00,79,25,54,FMN 08 Schijnpoortweg
675,Schijnpoortweg,2022-09-06,22:00:00,60,22,38,FMN 08 Schijnpoortweg
675,Schijnpoortweg,2022-09-06,23:00:00,49,13,36,FMN 08 Schijnpoortweg
675,Schijnpoortweg,2022-09-07,00:00:00,12,4,8,FMN 08 Schijnpoortweg
675,Schijnpoortweg,2022-09-07,01:00:00,13,4,9,FMN 08 Schijnpoortweg
675,Schijnpoortweg,2022-09-07,02:00:00,9,3,6,FMN 08 Schijnpoortweg
675,Schijnpoortweg,2022-09-07,03:00:00,16,5,11,FMN 08 Schijnpoortweg
675,Schijnpoortweg,2022-09-07,04:00:00,20,6,14,FMN 08 Schijnpoortweg
675,Schijnpoortweg,2022-09-07,05:00:00,65,16,49,FMN 08 Schijnpoortweg
675,Schijnpoortweg,2022-09-07,06:00:00,105,28,77,FMN 08 Schijnpoortweg
675,Schijnpoortweg,2022-09-07,07:00:00,161,41,120,FMN 08 Schijnpoortweg
675,Schijnpoortweg,2022-09-07,08:00:00,225,57,168,FMN 08 Schijnpoortweg
675,Schijnpoortweg,2022-09-07,09:00:00,157,36,121,FMN 08 Schijnpoortweg
675,Schijnpoortweg,2022-09-07,10:00:00,132,25,107,FMN 08 Schijnpoortweg
675,Schijnpoortweg,2022-09-07,11:00:00,125,27,98,FMN 08 Schijnpoortweg
675,Schijnpoortweg,2022-09-07,12:00:00,325,44,281,FMN 08 Schijnpoortweg
675,Schijnpoortweg,2022-09-07,13:00:00,237,49,188,FMN 08 Schijnpoortweg
675,Schijnpoortweg,2022-09-07,14:00:00,221,36,185,FMN 08 Schijnpoortweg
675,Schijnpoortweg,2022-09-07,15:00:00,267,49,218,FMN 08 Schijnpoortweg
675,Schijnpoortweg,2022-09-07,16:00:00,311,70,241,FMN 08 Schijnpoortweg
675,Schijnpoortweg,2022-09-07,17:00:00,289,45,244,FMN 08 Schijnpoortweg
675,Schijnpoortweg,2022-09-07,18:00:00,230,53,177,FMN 08 Schijnpoortweg
675,Schijnpoortweg,2022-09-07,19:00:00,179,43,136,FMN 08 Schijnpoortweg
675,Schijnpoortweg,2022-09-07,20:00:00,141,26,115,FMN 08 Schijnpoortweg
675,Schijnpoortweg,2022-09-07,21:00:00,124,33,91,FMN 08 Schijnpoortweg
675,Schijnpoortweg,2022-09-07,22:00:00,107,24,83,FMN 08 Schijnpoortweg
675,Schijnpoortweg,2022-09-07,23:00:00,71,8,63,FMN 08 Schijnpoortweg
675,Schijnpoortweg,2022-09-08,00:00:00,30,8,22,FMN 08 Schijnpoortweg
675,Schijnpoortweg,2022-09-08,01:00:00,25,10,15,FMN 08 Schijnpoortweg
675,Schijnpoortweg,2022-09-08,02:00:00,23,4,19,FMN 08 Schijnpoortweg
675,Schijnpoortweg,2022-09-08,03:00:00,11,5,6,FMN 08 Schijnpoortweg
675,Schijnpoortweg,2022-09-08,04:00:00,23,7,16,FMN 08 Schijnpoortweg
675,Schijnpoortweg,2022-09-08,05:00:00,71,17,54,FMN 08 Schijnpoortweg
675,Schijnpoortweg,2022-09-08,06:00:00,103,30,73,FMN 08 Schijnpoortweg
675,Schijnpoortweg,2022-09-08,07:00:00,176,40,136,FMN 08 Schijnpoortweg
675,Schijnpoortweg,2022-09-08,08:00:00,228,59,169,FMN 08 Schijnpoortweg
675,Schijnpoortweg,2022-09-08,09:00:00,93,29,64,FMN 08 Schijnpoortweg
675,Schijnpoortweg,2022-09-08,10:00:00,96,23,73,FMN 08 Schijnpoortweg
675,Schijnpoortweg,2022-09-08,11:00:00,108,20,88,FMN 08 Schijnpoortweg
675,Schijnpoortweg,2022-09-08,12:00:00,181,39,142,FMN 08 Schijnpoortweg
675,Schijnpoortweg,2022-09-08,13:00:00,133,25,108,FMN 08 Schijnpoortweg
675,Schijnpoortweg,2022-09-08,14:00:00,170,30,140,FMN 08 Schijnpoortweg
675,Schijnpoortweg,2022-09-08,15:00:00,244,38,206,FMN 08 Schijnpoortweg
675,Schijnpoortweg,2022-09-08,16:00:00,349,55,294,FMN 08 Schijnpoortweg
675,Schijnpoortweg,2022-09-08,17:00:00,308,44,264,FMN 08 Schijnpoortweg
675,Schijnpoortweg,2022-09-08,18:00:00,185,38,147,FMN 08 Schijnpoortweg
675,Schijnpoortweg,2022-09-08,19:00:00,172,38,134,FMN 08 Schijnpoortweg
675,Schijnpoortweg,2022-09-08,20:00:00,94,24,70,FMN 08 Schijnpoortweg
675,Schijnpoortweg,2022-09-08,21:00:00,90,17,73,FMN 08 Schijnpoortweg
675,Schijnpoortweg,2022-09-08,22:00:00,80,19,61,FMN 08 Schijnpoortweg
675,Schijnpoortweg,2022-09-08,23:00:00,61,16,45,FMN 08 Schijnpoortweg
675,Schijnpoortweg,2022-09-09,00:00:00,24,6,18,FMN 08 Schijnpoortweg
675,Schijnpoortweg,2022-09-09,01:00:00,10,4,6,FMN 08 Schijnpoortweg
675,Schijnpoortweg,2022-09-09,02:00:00,16,6,10,FMN 08 Schijnpoortweg
675,Schijnpoortweg,2022-09-09,03:00:00,9,4,5,FMN 08 Schijnpoortweg
675,Schijnpoortweg,2022-09-09,04:00:00,34,16,18,FMN 08 Schijnpoortweg
675,Schijnpoortweg,2022-09-09,05:00:00,68,11,57,FMN 08 Schijnpoortweg
675,Schijnpoortweg,2022-09-09,06:00:00,84,22,62,FMN 08 Schijnpoortweg
675,Schijnpoortweg,2022-09-09,07:00:00,184,37,147,FMN 08 Schijnpoortweg
675,Schijnpoortweg,2022-09-09,08:00:00,213,60,153,FMN 08 Schijnpoortweg
675,Schijnpoortweg,2022-09-09,09:00:00,103,25,78,FMN 08 Schijnpoortweg
675,Schijnpoortweg,2022-09-09,10:00:00,107,22,85,FMN 08 Schijnpoortweg
675,Schijnpoortweg,2022-09-09,11:00:00,104,26,78,FMN 08 Schijnpoortweg
675,Schijnpoortweg,2022-09-09,12:00:00,152,32,120,FMN 08 Schijnpoortweg
675,Schijnpoortweg,2022-09-09,13:00:00,133,37,96,FMN 08 Schijnpoortweg
675,Schijnpoortweg,2022-09-09,14:00:00,151,28,123,FMN 08 Schijnpoortweg
675,Schijnpoortweg,2022-09-09,15:00:00,247,35,212,FMN 08 Schijnpoortweg
675,Schijnpoortweg,2022-09-09,16:00:00,314,53,261,FMN 08 Schijnpoortweg
675,Schijnpoortweg,2022-09-09,17:00:00,212,33,179,FMN 08 Schijnpoortweg
675,Schijnpoortweg,2022-09-09,18:00:00,166,39,127,FMN 08 Schijnpoortweg
675,Schijnpoortweg,2022-09-09,19:00:00,163,34,129,FMN 08 Schijnpoortweg
675,Schijnpoortweg,2022-09-09,20:00:00,113,26,87,FMN 08 Schijnpoortweg
675,Schijnpoortweg,2022-09-09,21:00:00,76,22,54,FMN 08 Schijnpoortweg
675,Schijnpoortweg,2022-09-09,22:00:00,88,25,63,FMN 08 Schijnpoortweg
675,Schijnpoortweg,2022-09-09,23:00:00,65,24,41,FMN 08 Schijnpoortweg
675,Schijnpoortweg,2022-09-10,00:00:00,65,16,49,FMN 08 Schijnpoortweg
675,Schijnpoortweg,2022-09-10,01:00:00,39,7,32,FMN 08 Schijnpoortweg
675,Schijnpoortweg,2022-09-10,02:00:00,23,5,18,FMN 08 Schijnpoortweg
675,Schijnpoortweg,2022-09-10,03:00:00,12,1,11,FMN 08 Schijnpoortweg
675,Schijnpoortweg,2022-09-10,04:00:00,15,5,10,FMN 08 Schijnpoortweg
675,Schijnpoortweg,2022-09-10,05:00:00,20,15,5,FMN 08 Schijnpoortweg
675,Schijnpoortweg,2022-09-10,06:00:00,27,5,22,FMN 08 Schijnpoortweg
675,Schijnpoortweg,2022-09-10,07:00:00,21,5,16,FMN 08 Schijnpoortweg
675,Schijnpoortweg,2022-09-10,08:00:00,41,8,33,FMN 08 Schijnpoortweg
675,Schijnpoortweg,2022-09-10,09:00:00,40,15,25,FMN 08 Schijnpoortweg
675,Schijnpoortweg,2022-09-10,10:00:00,53,18,35,FMN 08 Schijnpoortweg
675,Schijnpoortweg,2022-09-10,11:00:00,68,17,51,FMN 08 Schijnpoortweg
675,Schijnpoortweg,2022-09-10,12:00:00,95,23,72,FMN 08 Schijnpoortweg
675,Schijnpoortweg,2022-09-10,13:00:00,94,28,66,FMN 08 Schijnpoortweg
675,Schijnpoortweg,2022-09-10,14:00:00,100,27,73,FMN 08 Schijnpoortweg
675,Schijnpoortweg,2022-09-10,15:00:00,141,31,110,FMN 08 Schijnpoortweg
675,Schijnpoortweg,2022-09-10,16:00:00,113,29,84,FMN 08 Schijnpoortweg
675,Schijnpoortweg,2022-09-10,17:00:00,142,43,99,FMN 08 Schijnpoortweg
675,Schijnpoortweg,2022-09-10,18:00:00,159,43,116,FMN 08 Schijnpoortweg
675,Schijnpoortweg,2022-09-10,19:00:00,110,31,79,FMN 08 Schijnpoortweg
675,Schijnpoortweg,2022-09-10,20:00:00,110,33,77,FMN 08 Schijnpoortweg
675,Schijnpoortweg,2022-09-10,21:00:00,94,22,72,FMN 08 Schijnpoortweg
675,Schijnpoortweg,2022-09-10,22:00:00,86,24,62,FMN 08 Schijnpoortweg
675,Schijnpoortweg,2022-09-10,23:00:00,82,20,62,FMN 08 Schijnpoortweg
675,Schijnpoortweg,2022-09-11,00:00:00,59,12,47,FMN 08 Schijnpoortweg
675,Schijnpoortweg,2022-09-11,01:00:00,28,6,22,FMN 08 Schijnpoortweg
675,Schijnpoortweg,2022-09-11,02:00:00,37,8,29,FMN 08 Schijnpoortweg
675,Schijnpoortweg,2022-09-11,03:00:00,17,1,16,FMN 08 Schijnpoortweg
675,Schijnpoortweg,2022-09-11,04:00:00,10,1,9,FMN 08 Schijnpoortweg
675,Schijnpoortweg,2022-09-11,05:00:00,17,8,9,FMN 08 Schijnpoortweg
675,Schijnpoortweg,2022-09-11,06:00:00,24,7,17,FMN 08 Schijnpoortweg
675,Schijnpoortweg,2022-09-11,07:00:00,34,9,25,FMN 08 Schijnpoortweg
675,Schijnpoortweg,2022-09-11,08:00:00,40,23,17,FMN 08 Schijnpoortweg
675,Schijnpoortweg,2022-09-11,09:00:00,108,32,76,FMN 08 Schijnpoortweg
675,Schijnpoortweg,2022-09-11,10:00:00,93,39,54,FMN 08 Schijnpoortweg
675,Schijnpoortweg,2022-09-11,11:00:00,133,36,97,FMN 08 Schijnpoortweg
675,Schijnpoortweg,2022-09-11,12:00:00,147,28,119,FMN 08 Schijnpoortweg
675,Schijnpoortweg,2022-09-11,13:00:00,188,45,143,FMN 08 Schijnpoortweg
675,Schijnpoortweg,2022-09-11,14:00:00,169,35,134,FMN 08 Schijnpoortweg
675,Schijnpoortweg,2022-09-11,15:00:00,196,40,156,FMN 08 Schijnpoortweg
675,Schijnpoortweg,2022-09-11,16:00:00,172,41,131,FMN 08 Schijnpoortweg
675,Schijnpoortweg,2022-09-11,17:00:00,172,26,146,FMN 08 Schijnpoortweg
675,Schijnpoortweg,2022-09-11,18:00:00,168,42,126,FMN 08 Schijnpoortweg
675,Schijnpoortweg,2022-09-11,19:00:00,145,38,107,FMN 08 Schijnpoortweg
675,Schijnpoortweg,2022-09-11,20:00:00,136,22,114,FMN 08 Schijnpoortweg
675,Schijnpoortweg,2022-09-11,21:00:00,121,23,98,FMN 08 Schijnpoortweg
675,Schijnpoortweg,2022-09-11,22:00:00,83,12,71,FMN 08 Schijnpoortweg
675,Schijnpoortweg,2022-09-11,23:00:00,57,9,48,FMN 08 Schijnpoortweg
675,Schijnpoortweg,2022-09-12,00:00:00,38,4,34,FMN 08 Schijnpoortweg
675,Schijnpoortweg,2022-09-12,01:00:00,26,5,21,FMN 08 Schijnpoortweg
675,Schijnpoortweg,2022-09-12,02:00:00,14,3,11,FMN 08 Schijnpoortweg
675,Schijnpoortweg,2022-09-12,03:00:00,11,3,8,FMN 08 Schijnpoortweg
675,Schijnpoortweg,2022-09-12,04:00:00,30,9,21,FMN 08 Schijnpoortweg
675,Schijnpoortweg,2022-09-12,05:00:00,69,25,44,FMN 08 Schijnpoortweg
675,Schijnpoortweg,2022-09-12,06:00:00,106,20,86,FMN 08 Schijnpoortweg
675,Schijnpoortweg,2022-09-12,07:00:00,165,34,131,FMN 08 Schijnpoortweg
675,Schijnpoortweg,2022-09-12,08:00:00,259,64,195,FMN 08 Schijnpoortweg
675,Schijnpoortweg,2022-09-12,09:00:00,127,35,92,FMN 08 Schijnpoortweg
675,Schijnpoortweg,2022-09-12,10:00:00,104,25,79,FMN 08 Schijnpoortweg
675,Schijnpoortweg,2022-09-12,11:00:00,125,21,104,FMN 08 Schijnpoortweg
675,Schijnpoortweg,2022-09-12,12:00:00,169,36,133,FMN 08 Schijnpoortweg
675,Schijnpoortweg,2022-09-12,13:00:00,158,29,129,FMN 08 Schijnpoortweg
675,Schijnpoortweg,2022-09-12,14:00:00,202,26,176,FMN 08 Schijnpoortweg
675,Schijnpoortweg,2022-09-12,15:00:00,273,34,239,FMN 08 Schijnpoortweg
675,Schijnpoortweg,2022-09-12,16:00:00,395,52,343,FMN 08 Schijnpoortweg
675,Schijnpoortweg,2022-09-12,17:00:00,342,50,292,FMN 08 Schijnpoortweg
675,Schijnpoortweg,2022-09-12,18:00:00,328,75,253,FMN 08 Schijnpoortweg
675,Schijnpoortweg,2022-09-12,19:00:00,399,71,328,FMN 08 Schijnpoortweg
675,Schijnpoortweg,2022-09-12,20:00:00,556,68,488,FMN 08 Schijnpoortweg
675,Schijnpoortweg,2022-09-12,21:00:00,163,30,133,FMN 08 Schijnpoortweg
675,Schijnpoortweg,2022-09-12,22:00:00,120,31,89,FMN 08 Schijnpoortweg
675,Schijnpoortweg,2022-09-12,23:00:00,294,224,70,FMN 08 Schijnpoortweg
675,Schijnpoortweg,2022-09-13,00:00:00,36,9,27,FMN 08 Schijnpoortweg
675,Schijnpoortweg,2022-09-13,01:00:00,18,4,14,FMN 08 Schijnpoortweg
675,Schijnpoortweg,2022-09-13,02:00:00,21,3,18,FMN 08 Schijnpoortweg
675,Schijnpoortweg,2022-09-13,03:00:00,8,2,6,FMN 08 Schijnpoortweg
675,Schijnpoortweg,2022-09-13,04:00:00,29,11,18,FMN 08 Schijnpoortweg
675,Schijnpoortweg,2022-09-13,05:00:00,55,8,47,FMN 08 Schijnpoortweg
675,Schijnpoortweg,2022-09-13,06:00:00,114,16,98,FMN 08 Schijnpoortweg
675,Schijnpoortweg,2022-09-13,07:00:00,196,38,158,FMN 08 Schijnpoortweg
675,Schijnpoortweg,2022-09-13,08:00:00,238,61,177,FMN 08 Schijnpoortweg
675,Schijnpoortweg,2022-09-13,09:00:00,126,32,94,FMN 08 Schijnpoortweg
675,Schijnpoortweg,2022-09-13,10:00:00,107,20,87,FMN 08 Schijnpoortweg
675,Schijnpoortweg,2022-09-13,11:00:00,112,20,92,FMN 08 Schijnpoortweg
675,Schijnpoortweg,2022-09-13,12:00:00,157,43,114,FMN 08 Schijnpoortweg
675,Schijnpoortweg,2022-09-13,13:00:00,163,28,135,FMN 08 Schijnpoortweg
675,Schijnpoortweg,2022-09-13,14:00:00,195,30,165,FMN 08 Schijnpoortweg
675,Schijnpoortweg,2022-09-13,15:00:00,334,28,306,FMN 08 Schijnpoortweg
675,Schijnpoortweg,2022-09-13,16:00:00,374,38,336,FMN 08 Schijnpoortweg
675,Schijnpoortweg,2022-09-13,17:00:00,332,45,287,FMN 08 Schijnpoortweg
675,Schijnpoortweg,2022-09-13,18:00:00,235,47,188,FMN 08 Schijnpoortweg
675,Schijnpoortweg,2022-09-13,19:00:00,204,40,164,FMN 08 Schijnpoortweg
675,Schijnpoortweg,2022-09-13,20:00:00,133,26,107,FMN 08 Schijnpoortweg
675,Schijnpoortweg,2022-09-13,21:00:00,111,20,91,FMN 08 Schijnpoortweg
675,Schijnpoortweg,2022-09-13,22:00:00,75,14,61,FMN 08 Schijnpoortweg
675,Schijnpoortweg,2022-09-13,23:00:00,57,12,45,FMN 08 Schijnpoortweg
675,Schijnpoortweg,2022-09-14,00:00:00,19,7,12,FMN 08 Schijnpoortweg
675,Schijnpoortweg,2022-09-14,01:00:00,16,3,13,FMN 08 Schijnpoortweg
675,Schijnpoortweg,2022-09-14,02:00:00,12,4,8,FMN 08 Schijnpoortweg
675,Schijnpoortweg,2022-09-14,03:00:00,12,2,10,FMN 08 Schijnpoortweg
675,Schijnpoortweg,2022-09-14,04:00:00,22,8,14,FMN 08 Schijnpoortweg
675,Schijnpoortweg,2022-09-14,05:00:00,46,9,37,FMN 08 Schijnpoortweg
675,Schijnpoortweg,2022-09-14,06:00:00,81,17,64,FMN 08 Schijnpoortweg
675,Schijnpoortweg,2022-09-14,07:00:00,140,21,119,FMN 08 Schijnpoortweg
675,Schijnpoortweg,2022-09-14,08:00:00,151,31,120,FMN 08 Schijnpoortweg
675,Schijnpoortweg,2022-09-14,09:00:00,66,10,56,FMN 08 Schijnpoortweg
675,Schijnpoortweg,2022-09-14,10:00:00,49,9,40,FMN 08 Schijnpoortweg
675,Schijnpoortweg,2022-09-14,11:00:00,56,6,50,FMN 08 Schijnpoortweg
675,Schijnpoortweg,2022-09-14,12:00:00,147,13,134,FMN 08 Schijnpoortweg
675,Schijnpoortweg,2022-09-14,13:00:00,80,14,66,FMN 08 Schijnpoortweg
675,Schijnpoortweg,2022-09-14,14:00:00,75,18,57,FMN 08 Schijnpoortweg
675,Schijnpoortweg,2022-09-14,15:00:00,110,15,95,FMN 08 Schijnpoortweg
675,Schijnpoortweg,2022-09-14,16:00:00,173,28,145,FMN 08 Schijnpoortweg
675,Schijnpoortweg,2022-09-14,17:00:00,193,31,162,FMN 08 Schijnpoortweg
675,Schijnpoortweg,2022-09-14,18:00:00,152,37,115,FMN 08 Schijnpoortweg
675,Schijnpoortweg,2022-09-14,19:00:00,138,27,111,FMN 08 Schijnpoortweg
675,Schijnpoortweg,2022-09-14,20:00:00,114,13,101,FMN 08 Schijnpoortweg
675,Schijnpoortweg,2022-09-14,21:00:00,95,17,78,FMN 08 Schijnpoortweg
675,Schijnpoortweg,2022-09-14,22:00:00,77,20,57,FMN 08 Schijnpoortweg
675,Schijnpoortweg,2022-09-14,23:00:00,73,15,58,FMN 08 Schijnpoortweg
675,Schijnpoortweg,2022-09-15,00:00:00,45,7,38,FMN 08 Schijnpoortweg
675,Schijnpoortweg,2022-09-15,01:00:00,24,6,18,FMN 08 Schijnpoortweg
675,Schijnpoortweg,2022-09-15,02:00:00,19,6,13,FMN 08 Schijnpoortweg
675,Schijnpoortweg,2022-09-15,03:00:00,8,4,4,FMN 08 Schijnpoortweg
675,Schijnpoortweg,2022-09-15,04:00:00,26,8,18,FMN 08 Schijnpoortweg
675,Schijnpoortweg,2022-09-15,05:00:00,47,12,35,FMN 08 Schijnpoortweg
675,Schijnpoortweg,2022-09-15,06:00:00,93,7,86,FMN 08 Schijnpoortweg
675,Schijnpoortweg,2022-09-15,07:00:00,184,35,149,FMN 08 Schijnpoortweg
675,Schijnpoortweg,2022-09-15,08:00:00,232,52,180,FMN 08 Schijnpoortweg
675,Schijnpoortweg,2022-09-15,09:00:00,124,31,93,FMN 08 Schijnpoortweg
675,Schijnpoortweg,2022-09-15,10:00:00,121,22,99,FMN 08 Schijnpoortweg
675,Schijnpoortweg,2022-09-15,11:00:00,82,17,65,FMN 08 Schijnpoortweg
675,Schijnpoortweg,2022-09-15,12:00:00,168,22,146,FMN 08 Schijnpoortweg
675,Schijnpoortweg,2022-09-15,13:00:00,138,19,119,FMN 08 Schijnpoortweg
675,Schijnpoortweg,2022-09-15,14:00:00,140,26,114,FMN 08 Schijnpoortweg
675,Schijnpoortweg,2022-09-15,15:00:00,259,25,234,FMN 08 Schijnpoortweg
675,Schijnpoortweg,2022-09-15,16:00:00,355,34,321,FMN 08 Schijnpoortweg
675,Schijnpoortweg,2022-09-15,17:00:00,332,24,308,FMN 08 Schijnpoortweg
675,Schijnpoortweg,2022-09-15,18:00:00,236,27,209,FMN 08 Schijnpoortweg
675,Schijnpoortweg,2022-09-15,19:00:00,177,28,149,FMN 08 Schijnpoortweg
675,Schijnpoortweg,2022-09-15,20:00:00,133,18,115,FMN 08 Schijnpoortweg
675,Schijnpoortweg,2022-09-15,21:00:00,121,20,101,FMN 08 Schijnpoortweg
675,Schijnpoortweg,2022-09-15,22:00:00,100,16,84,FMN 08 Schijnpoortweg
675,Schijnpoortweg,2022-09-15,23:00:00,68,9,59,FMN 08 Schijnpoortweg
675,Schijnpoortweg,2022-09-16,00:00:00,36,6,30,FMN 08 Schijnpoortweg
675,Schijnpoortweg,2022-09-16,01:00:00,25,8,17,FMN 08 Schijnpoortweg
675,Schijnpoortweg,2022-09-16,02:00:00,16,3,13,FMN 08 Schijnpoortweg
675,Schijnpoortweg,2022-09-16,03:00:00,13,3,10,FMN 08 Schijnpoortweg
675,Schijnpoortweg,2022-09-16,04:00:00,33,10,23,FMN 08 Schijnpoortweg
675,Schijnpoortweg,2022-09-16,05:00:00,51,11,40,FMN 08 Schijnpoortweg
675,Schijnpoortweg,2022-09-16,06:00:00,104,23,81,FMN 08 Schijnpoortweg
675,Schijnpoortweg,2022-09-16,07:00:00,172,26,146,FMN 08 Schijnpoortweg
675,Schijnpoortweg,2022-09-16,08:00:00,168,38,130,FMN 08 Schijnpoortweg
675,Schijnpoortweg,2022-09-16,09:00:00,72,16,56,FMN 08 Schijnpoortweg
675,Schijnpoortweg,2022-09-16,10:00:00,79,13,66,FMN 08 Schijnpoortweg
675,Schijnpoortweg,2022-09-16,11:00:00,58,12,46,FMN 08 Schijnpoortweg
675,Schijnpoortweg,2022-09-16,12:00:00,112,17,95,FMN 08 Schijnpoortweg
675,Schijnpoortweg,2022-09-16,13:00:00,73,10,63,FMN 08 Schijnpoortweg
675,Schijnpoortweg,2022-09-16,14:00:00,123,24,99,FMN 08 Schijnpoortweg
675,Schijnpoortweg,2022-09-16,15:00:00,195,18,177,FMN 08 Schijnpoortweg
675,Schijnpoortweg,2022-09-16,16:00:00,257,25,232,FMN 08 Schijnpoortweg
675,Schijnpoortweg,2022-09-16,17:00:00,192,19,173,FMN 08 Schijnpoortweg
675,Schijnpoortweg,2022-09-16,18:00:00,168,23,145,FMN 08 Schijnpoortweg
675,Schijnpoortweg,2022-09-16,19:00:00,120,18,102,FMN 08 Schijnpoortweg
675,Schijnpoortweg,2022-09-16,20:00:00,77,8,69,FMN 08 Schijnpoortweg
675,Schijnpoortweg,2022-09-16,21:00:00,70,14,56,FMN 08 Schijnpoortweg
675,Schijnpoortweg,2022-09-16,22:00:00,68,10,58,FMN 08 Schijnpoortweg
675,Schijnpoortweg,2022-09-16,23:00:00,59,19,40,FMN 08 Schijnpoortweg
675,Schijnpoortweg,2022-09-17,00:00:00,43,12,31,FMN 08 Schijnpoortweg
675,Schijnpoortweg,2022-09-17,01:00:00,22,6,16,FMN 08 Schijnpoortweg
675,Schijnpoortweg,2022-09-17,02:00:00,25,3,22,FMN 08 Schijnpoortweg
675,Schijnpoortweg,2022-09-17,03:00:00,20,2,18,FMN 08 Schijnpoortweg
675,Schijnpoortweg,2022-09-17,04:00:00,13,6,7,FMN 08 Schijnpoortweg
675,Schijnpoortweg,2022-09-17,05:00:00,19,7,12,FMN 08 Schijnpoortweg
675,Schijnpoortweg,2022-09-17,06:00:00,27,6,21,FMN 08 Schijnpoortweg
675,Schijnpoortweg,2022-09-17,07:00:00,30,8,22,FMN 08 Schijnpoortweg
675,Schijnpoortweg,2022-09-17,08:00:00,57,11,46,FMN 08 Schijnpoortweg
675,Schijnpoortweg,2022-09-17,09:00:00,105,24,81,FMN 08 Schijnpoortweg
675,Schijnpoortweg,2022-09-17,10:00:00,98,32,66,FMN 08 Schijnpoortweg
675,Schijnpoortweg,2022-09-17,11:00:00,109,24,85,FMN 08 Schijnpoortweg
675,Schijnpoortweg,2022-09-17,12:00:00,95,17,78,FMN 08 Schijnpoortweg
675,Schijnpoortweg,2022-09-17,13:00:00,122,29,93,FMN 08 Schijnpoortweg
675,Schijnpoortweg,2022-09-17,14:00:00,165,50,115,FMN 08 Schijnpoortweg
675,Schijnpoortweg,2022-09-17,15:00:00,158,36,122,FMN 08 Schijnpoortweg
675,Schijnpoortweg,2022-09-17,16:00:00,142,28,114,FMN 08 Schijnpoortweg
675,Schijnpoortweg,2022-09-17,17:00:00,159,38,121,FMN 08 Schijnpoortweg
675,Schijnpoortweg,2022-09-17,18:00:00,168,72,96,FMN 08 Schijnpoortweg
675,Schijnpoortweg,2022-09-17,19:00:00,129,48,81,FMN 08 Schijnpoortweg
675,Schijnpoortweg,2022-09-17,20:00:00,83,15,68,FMN 08 Schijnpoortweg
675,Schijnpoortweg,2022-09-17,21:00:00,49,12,37,FMN 08 Schijnpoortweg
675,Schijnpoortweg,2022-09-17,22:00:00,83,41,42,FMN 08 Schijnpoortweg
675,Schijnpoortweg,2022-09-17,23:00:00,66,8,58,FMN 08 Schijnpoortweg
675,Schijnpoortweg,2022-09-18,00:00:00,47,10,37,FMN 08 Schijnpoortweg
675,Schijnpoortweg,2022-09-18,01:00:00,36,5,31,FMN 08 Schijnpoortweg
675,Schijnpoortweg,2022-09-18,02:00:00,22,5,17,FMN 08 Schijnpoortweg
675,Schijnpoortweg,2022-09-18,03:00:00,25,6,19,FMN 08 Schijnpoortweg
675,Schijnpoortweg,2022-09-18,04:00:00,10,4,6,FMN 08 Schijnpoortweg
675,Schijnpoortweg,2022-09-18,05:00:00,14,7,7,FMN 08 Schijnpoortweg
675,Schijnpoortweg,2022-09-18,06:00:00,12,3,9,FMN 08 Schijnpoortweg
675,Schijnpoortweg,2022-09-18,07:00:00,20,3,17,FMN 08 Schijnpoortweg
675,Schijnpoortweg,2022-09-18,08:00:00,26,8,18,FMN 08 Schijnpoortweg
675,Schijnpoortweg,2022-09-18,09:00:00,47,11,36,FMN 08 Schijnpoortweg
675,Schijnpoortweg,2022-09-18,10:00:00,56,12,44,FMN 08 Schijnpoortweg
675,Schijnpoortweg,2022-09-18,11:00:00,82,25,57,FMN 08 Schijnpoortweg
675,Schijnpoortweg,2022-09-18,12:00:00,92,21,71,FMN 08 Schijnpoortweg
675,Schijnpoortweg,2022-09-18,13:00:00,79,13,66,FMN 08 Schijnpoortweg
675,Schijnpoortweg,2022-09-18,14:00:00,115,33,82,FMN 08 Schijnpoortweg
675,Schijnpoortweg,2022-09-18,15:00:00,125,29,96,FMN 08 Schijnpoortweg
675,Schijnpoortweg,2022-09-18,16:00:00,106,16,90,FMN 08 Schijnpoortweg
675,Schijnpoortweg,2022-09-18,17:00:00,103,14,89,FMN 08 Schijnpoortweg
675,Schijnpoortweg,2022-09-18,18:00:00,68,13,55,FMN 08 Schijnpoortweg
675,Schijnpoortweg,2022-09-18,19:00:00,64,11,53,FMN 08 Schijnpoortweg
675,Schijnpoortweg,2022-09-18,20:00:00,88,18,70,FMN 08 Schijnpoortweg
675,Schijnpoortweg,2022-09-18,21:00:00,65,13,52,FMN 08 Schijnpoortweg
675,Schijnpoortweg,2022-09-18,22:00:00,51,11,40,FMN 08 Schijnpoortweg
675,Schijnpoortweg,2022-09-18,23:00:00,48,11,37,FMN 08 Schijnpoortweg
675,Schijnpoortweg,2022-09-19,00:00:00,25,10,15,FMN 08 Schijnpoortweg
675,Schijnpoortweg,2022-09-19,01:00:00,23,4,19,FMN 08 Schijnpoortweg
675,Schijnpoortweg,2022-09-19,02:00:00,15,5,10,FMN 08 Schijnpoortweg
675,Schijnpoortweg,2022-09-19,03:00:00,9,3,6,FMN 08 Schijnpoortweg
675,Schijnpoortweg,2022-09-19,04:00:00,23,7,16,FMN 08 Schijnpoortweg
675,Schijnpoortweg,2022-09-19,05:00:00,71,12,59,FMN 08 Schijnpoortweg
675,Schijnpoortweg,2022-09-19,06:00:00,90,9,81,FMN 08 Schijnpoortweg
675,Schijnpoortweg,2022-09-19,07:00:00,179,28,151,FMN 08 Schijnpoortweg
675,Schijnpoortweg,2022-09-19,08:00:00,227,47,180,FMN 08 Schijnpoortweg
675,Schijnpoortweg,2022-09-19,09:00:00,105,20,85,FMN 08 Schijnpoortweg
675,Schijnpoortweg,2022-09-19,10:00:00,105,26,79,FMN 08 Schijnpoortweg
675,Schijnpoortweg,2022-09-19,11:00:00,116,20,96,FMN 08 Schijnpoortweg
675,Schijnpoortweg,2022-09-19,12:00:00,199,31,168,FMN 08 Schijnpoortweg
675,Schijnpoortweg,2022-09-19,13:00:00,133,25,108,FMN 08 Schijnpoortweg
675,Schijnpoortweg,2022-09-19,14:00:00,145,24,121,FMN 08 Schijnpoortweg
675,Schijnpoortweg,2022-09-19,15:00:00,303,31,272,FMN 08 Schijnpoortweg
675,Schijnpoortweg,2022-09-19,16:00:00,400,40,360,FMN 08 Schijnpoortweg
675,Schijnpoortweg,2022-09-19,17:00:00,321,28,293,FMN 08 Schijnpoortweg
675,Schijnpoortweg,2022-09-19,18:00:00,237,31,206,FMN 08 Schijnpoortweg
675,Schijnpoortweg,2022-09-19,19:00:00,170,23,147,FMN 08 Schijnpoortweg
675,Schijnpoortweg,2022-09-19,20:00:00,123,26,97,FMN 08 Schijnpoortweg
675,Schijnpoortweg,2022-09-19,21:00:00,112,13,99,FMN 08 Schijnpoortweg
675,Schijnpoortweg,2022-09-19,22:00:00,113,21,92,FMN 08 Schijnpoortweg
675,Schijnpoortweg,2022-09-19,23:00:00,62,10,52,FMN 08 Schijnpoortweg
675,Schijnpoortweg,2022-09-20,00:00:00,33,7,26,FMN 08 Schijnpoortweg
675,Schijnpoortweg,2022-09-20,01:00:00,18,3,15,FMN 08 Schijnpoortweg
675,Schijnpoortweg,2022-09-20,02:00:00,16,6,10,FMN 08 Schijnpoortweg
675,Schijnpoortweg,2022-09-20,03:00:00,15,3,12,FMN 08 Schijnpoortweg
675,Schijnpoortweg,2022-09-20,04:00:00,32,11,21,FMN 08 Schijnpoortweg
675,Schijnpoortweg,2022-09-20,05:00:00,64,8,56,FMN 08 Schijnpoortweg
675,Schijnpoortweg,2022-09-20,06:00:00,107,18,89,FMN 08 Schijnpoortweg
675,Schijnpoortweg,2022-09-20,07:00:00,196,28,168,FMN 08 Schijnpoortweg
675,Schijnpoortweg,2022-09-20,08:00:00,270,64,206,FMN 08 Schijnpoortweg
675,Schijnpoortweg,2022-09-20,09:00:00,117,21,96,FMN 08 Schijnpoortweg
675,Schijnpoortweg,2022-09-20,10:00:00,91,17,74,FMN 08 Schijnpoortweg
675,Schijnpoortweg,2022-09-20,11:00:00,105,20,85,FMN 08 Schijnpoortweg
675,Schijnpoortweg,2022-09-20,12:00:00,174,28,146,FMN 08 Schijnpoortweg
675,Schijnpoortweg,2022-09-20,13:00:00,149,26,123,FMN 08 Schijnpoortweg
675,Schijnpoortweg,2022-09-20,14:00:00,179,19,160,FMN 08 Schijnpoortweg
675,Schijnpoortweg,2022-09-20,15:00:00,277,25,252,FMN 08 Schijnpoortweg
675,Schijnpoortweg,2022-09-20,16:00:00,392,30,362,FMN 08 Schijnpoortweg
675,Schijnpoortweg,2022-09-20,17:00:00,358,26,332,FMN 08 Schijnpoortweg
675,Schijnpoortweg,2022-09-20,18:00:00,264,37,227,FMN 08 Schijnpoortweg
675,Schijnpoortweg,2022-09-20,19:00:00,187,28,159,FMN 08 Schijnpoortweg
675,Schijnpoortweg,2022-09-20,20:00:00,145,18,127,FMN 08 Schijnpoortweg
675,Schijnpoortweg,2022-09-20,21:00:00,116,17,99,FMN 08 Schijnpoortweg
675,Schijnpoortweg,2022-09-20,22:00:00,93,16,77,FMN 08 Schijnpoortweg
675,Schijnpoortweg,2022-09-20,23:00:00,73,4,69,FMN 08 Schijnpoortweg
675,Schijnpoortweg,2022-09-21,00:00:00,28,0,28,FMN 08 Schijnpoortweg
675,Schijnpoortweg,2022-09-21,01:00:00,24,6,18,FMN 08 Schijnpoortweg
675,Schijnpoortweg,2022-09-21,02:00:00,18,6,12,FMN 08 Schijnpoortweg
675,Schijnpoortweg,2022-09-21,03:00:00,20,8,12,FMN 08 Schijnpoortweg
675,Schijnpoortweg,2022-09-21,04:00:00,32,12,20,FMN 08 Schijnpoortweg
675,Schijnpoortweg,2022-09-21,05:00:00,60,10,50,FMN 08 Schijnpoortweg
675,Schijnpoortweg,2022-09-21,06:00:00,110,17,93,FMN 08 Schijnpoortweg
675,Schijnpoortweg,2022-09-21,07:00:00,230,42,188,FMN 08 Schijnpoortweg
675,Schijnpoortweg,2022-09-21,08:00:00,287,73,214,FMN 08 Schijnpoortweg
675,Schijnpoortweg,2022-09-21,09:00:00,142,22,120,FMN 08 Schijnpoortweg
675,Schijnpoortweg,2022-09-21,10:00:00,119,16,103,FMN 08 Schijnpoortweg
675,Schijnpoortweg,2022-09-21,11:00:00,164,20,144,FMN 08 Schijnpoortweg
675,Schijnpoortweg,2022-09-21,12:00:00,322,34,288,FMN 08 Schijnpoortweg
675,Schijnpoortweg,2022-09-21,13:00:00,229,15,214,FMN 08 Schijnpoortweg
675,Schijnpoortweg,2022-09-21,14:00:00,251,29,222,FMN 08 Schijnpoortweg
675,Schijnpoortweg,2022-09-21,15:00:00,277,35,242,FMN 08 Schijnpoortweg
675,Schijnpoortweg,2022-09-21,16:00:00,312,38,274,FMN 08 Schijnpoortweg
675,Schijnpoortweg,2022-09-21,17:00:00,391,33,358,FMN 08 Schijnpoortweg
675,Schijnpoortweg,2022-09-21,18:00:00,273,36,237,FMN 08 Schijnpoortweg
675,Schijnpoortweg,2022-09-21,19:00:00,213,30,183,FMN 08 Schijnpoortweg
675,Schijnpoortweg,2022-09-21,20:00:00,188,28,160,FMN 08 Schijnpoortweg
675,Schijnpoortweg,2022-09-21,21:00:00,135,14,121,FMN 08 Schijnpoortweg
675,Schijnpoortweg,2022-09-21,22:00:00,94,15,79,FMN 08 Schijnpoortweg
675,Schijnpoortweg,2022-09-21,23:00:00,81,12,69,FMN 08 Schijnpoortweg
675,Schijnpoortweg,2022-09-22,00:00:00,51,8,43,FMN 08 Schijnpoortweg
675,Schijnpoortweg,2022-09-22,01:00:00,16,0,16,FMN 08 Schijnpoortweg
675,Schijnpoortweg,2022-09-22,02:00:00,15,3,12,FMN 08 Schijnpoortweg
675,Schijnpoortweg,2022-09-22,03:00:00,9,1,8,FMN 08 Schijnpoortweg
675,Schijnpoortweg,2022-09-22,04:00:00,18,5,13,FMN 08 Schijnpoortweg
675,Schijnpoortweg,2022-09-22,05:00:00,67,13,54,FMN 08 Schijnpoortweg
675,Schijnpoortweg,2022-09-22,06:00:00,112,12,100,FMN 08 Schijnpoortweg
675,Schijnpoortweg,2022-09-22,07:00:00,219,31,188,FMN 08 Schijnpoortweg
675,Schijnpoortweg,2022-09-22,08:00:00,276,59,217,FMN 08 Schijnpoortweg
675,Schijnpoortweg,2022-09-22,09:00:00,104,22,82,FMN 08 Schijnpoortweg
675,Schijnpoortweg,2022-09-22,10:00:00,97,13,84,FMN 08 Schijnpoortweg
675,Schijnpoortweg,2022-09-22,11:00:00,122,17,105,FMN 08 Schijnpoortweg
675,Schijnpoortweg,2022-09-22,12:00:00,174,29,145,FMN 08 Schijnpoortweg
675,Schijnpoortweg,2022-09-22,13:00:00,171,18,153,FMN 08 Schijnpoortweg
675,Schijnpoortweg,2022-09-22,14:00:00,182,15,167,FMN 08 Schijnpoortweg
675,Schijnpoortweg,2022-09-22,15:00:00,289,19,270,FMN 08 Schijnpoortweg
675,Schijnpoortweg,2022-09-22,16:00:00,391,31,360,FMN 08 Schijnpoortweg
675,Schijnpoortweg,2022-09-22,17:00:00,387,27,360,FMN 08 Schijnpoortweg
675,Schijnpoortweg,2022-09-22,18:00:00,258,29,229,FMN 08 Schijnpoortweg
675,Schijnpoortweg,2022-09-22,19:00:00,194,30,164,FMN 08 Schijnpoortweg
675,Schijnpoortweg,2022-09-22,20:00:00,141,22,119,FMN 08 Schijnpoortweg
675,Schijnpoortweg,2022-09-22,21:00:00,122,14,108,FMN 08 Schijnpoortweg
675,Schijnpoortweg,2022-09-22,22:00:00,123,18,105,FMN 08 Schijnpoortweg
675,Schijnpoortweg,2022-09-22,23:00:00,73,8,65,FMN 08 Schijnpoortweg
675,Schijnpoortweg,2022-09-23,00:00:00,45,3,42,FMN 08 Schijnpoortweg
675,Schijnpoortweg,2022-09-23,01:00:00,31,7,24,FMN 08 Schijnpoortweg
675,Schijnpoortweg,2022-09-23,02:00:00,19,3,16,FMN 08 Schijnpoortweg
675,Schijnpoortweg,2022-09-23,03:00:00,13,5,8,FMN 08 Schijnpoortweg
675,Schijnpoortweg,2022-09-23,04:00:00,28,11,17,FMN 08 Schijnpoortweg
675,Schijnpoortweg,2022-09-23,05:00:00,64,8,56,FMN 08 Schijnpoortweg
675,Schijnpoortweg,2022-09-23,06:00:00,103,22,81,FMN 08 Schijnpoortweg
675,Schijnpoortweg,2022-09-23,07:00:00,185,24,161,FMN 08 Schijnpoortweg
675,Schijnpoortweg,2022-09-23,08:00:00,246,48,198,FMN 08 Schijnpoortweg
675,Schijnpoortweg,2022-09-23,09:00:00,91,14,77,FMN 08 Schijnpoortweg
675,Schijnpoortweg,2022-09-23,10:00:00,94,19,75,FMN 08 Schijnpoortweg
675,Schijnpoortweg,2022-09-23,11:00:00,104,16,88,FMN 08 Schijnpoortweg
675,Schijnpoortweg,2022-09-23,12:00:00,167,20,147,FMN 08 Schijnpoortweg
675,Schijnpoortweg,2022-09-23,13:00:00,128,13,115,FMN 08 Schijnpoortweg
675,Schijnpoortweg,2022-09-23,14:00:00,167,25,142,FMN 08 Schijnpoortweg
675,Schijnpoortweg,2022-09-23,15:00:00,272,26,246,FMN 08 Schijnpoortweg
675,Schijnpoortweg,2022-09-23,16:00:00,337,25,312,FMN 08 Schijnpoortweg
675,Schijnpoortweg,2022-09-23,17:00:00,341,34,307,FMN 08 Schijnpoortweg
675,Schijnpoortweg,2022-09-23,18:00:00,225,27,198,FMN 08 Schijnpoortweg
675,Schijnpoortweg,2022-09-23,19:00:00,211,44,167,FMN 08 Schijnpoortweg
675,Schijnpoortweg,2022-09-23,20:00:00,138,24,114,FMN 08 Schijnpoortweg
675,Schijnpoortweg,2022-09-23,21:00:00,91,14,77,FMN 08 Schijnpoortweg
675,Schijnpoortweg,2022-09-23,22:00:00,92,36,56,FMN 08 Schijnpoortweg
675,Schijnpoortweg,2022-09-23,23:00:00,63,8,55,FMN 08 Schijnpoortweg
675,Schijnpoortweg,2022-09-24,00:00:00,58,12,46,FMN 08 Schijnpoortweg
675,Schijnpoortweg,2022-09-24,01:00:00,41,12,29,FMN 08 Schijnpoortweg
675,Schijnpoortweg,2022-09-24,02:00:00,28,7,21,FMN 08 Schijnpoortweg
675,Schijnpoortweg,2022-09-24,03:00:00,20,6,14,FMN 08 Schijnpoortweg
675,Schijnpoortweg,2022-09-24,04:00:00,11,3,8,FMN 08 Schijnpoortweg
675,Schijnpoortweg,2022-09-24,05:00:00,15,5,10,FMN 08 Schijnpoortweg
675,Schijnpoortweg,2022-09-24,06:00:00,17,8,9,FMN 08 Schijnpoortweg
675,Schijnpoortweg,2022-09-24,07:00:00,35,13,22,FMN 08 Schijnpoortweg
675,Schijnpoortweg,2022-09-24,08:00:00,66,12,54,FMN 08 Schijnpoortweg
675,Schijnpoortweg,2022-09-24,09:00:00,71,19,52,FMN 08 Schijnpoortweg
675,Schijnpoortweg,2022-09-24,10:00:00,66,12,54,FMN 08 Schijnpoortweg
675,Schijnpoortweg,2022-09-24,11:00:00,68,8,60,FMN 08 Schijnpoortweg
675,Schijnpoortweg,2022-09-24,12:00:00,72,11,61,FMN 08 Schijnpoortweg
675,Schijnpoortweg,2022-09-24,13:00:00,102,22,80,FMN 08 Schijnpoortweg
675,Schijnpoortweg,2022-09-24,14:00:00,126,32,94,FMN 08 Schijnpoortweg
675,Schijnpoortweg,2022-09-24,15:00:00,119,19,100,FMN 08 Schijnpoortweg
675,Schijnpoortweg,2022-09-24,16:00:00,115,17,98,FMN 08 Schijnpoortweg
675,Schijnpoortweg,2022-09-24,17:00:00,146,22,124,FMN 08 Schijnpoortweg
675,Schijnpoortweg,2022-09-24,18:00:00,111,21,90,FMN 08 Schijnpoortweg
675,Schijnpoortweg,2022-09-24,19:00:00,117,16,101,FMN 08 Schijnpoortweg
675,Schijnpoortweg,2022-09-24,20:00:00,111,23,88,FMN 08 Schijnpoortweg
675,Schijnpoortweg,2022-09-24,21:00:00,73,10,63,FMN 08 Schijnpoortweg
675,Schijnpoortweg,2022-09-24,22:00:00,64,12,52,FMN 08 Schijnpoortweg
675,Schijnpoortweg,2022-09-24,23:00:00,68,11,57,FMN 08 Schijnpoortweg
675,Schijnpoortweg,2022-09-25,00:00:00,61,7,54,FMN 08 Schijnpoortweg
675,Schijnpoortweg,2022-09-25,01:00:00,31,5,26,FMN 08 Schijnpoortweg
675,Schijnpoortweg,2022-09-25,02:00:00,26,6,20,FMN 08 Schijnpoortweg
675,Schijnpoortweg,2022-09-25,03:00:00,28,4,24,FMN 08 Schijnpoortweg
675,Schijnpoortweg,2022-09-25,04:00:00,12,6,6,FMN 08 Schijnpoortweg
675,Schijnpoortweg,2022-09-25,05:00:00,24,11,13,FMN 08 Schijnpoortweg
675,Schijnpoortweg,2022-09-25,06:00:00,23,7,16,FMN 08 Schijnpoortweg
675,Schijnpoortweg,2022-09-25,07:00:00,21,4,17,FMN 08 Schijnpoortweg
675,Schijnpoortweg,2022-09-25,08:00:00,43,11,32,FMN 08 Schijnpoortweg
675,Schijnpoortweg,2022-09-25,09:00:00,65,14,51,FMN 08 Schijnpoortweg
675,Schijnpoortweg,2022-09-25,10:00:00,89,23,66,FMN 08 Schijnpoortweg
675,Schijnpoortweg,2022-09-25,11:00:00,98,17,81,FMN 08 Schijnpoortweg
675,Schijnpoortweg,2022-09-25,12:00:00,125,21,104,FMN 08 Schijnpoortweg
675,Schijnpoortweg,2022-09-25,13:00:00,135,25,110,FMN 08 Schijnpoortweg
675,Schijnpoortweg,2022-09-25,14:00:00,146,18,128,FMN 08 Schijnpoortweg
675,Schijnpoortweg,2022-09-25,15:00:00,134,23,111,FMN 08 Schijnpoortweg
675,Schijnpoortweg,2022-09-25,16:00:00,163,39,124,FMN 08 Schijnpoortweg
675,Schijnpoortweg,2022-09-25,17:00:00,170,25,145,FMN 08 Schijnpoortweg
675,Schijnpoortweg,2022-09-25,18:00:00,143,26,117,FMN 08 Schijnpoortweg
675,Schijnpoortweg,2022-09-25,19:00:00,150,24,126,FMN 08 Schijnpoortweg
675,Schijnpoortweg,2022-09-25,20:00:00,131,16,115,FMN 08 Schijnpoortweg
675,Schijnpoortweg,2022-09-25,21:00:00,93,13,80,FMN 08 Schijnpoortweg
675,Schijnpoortweg,2022-09-25,22:00:00,76,11,65,FMN 08 Schijnpoortweg
675,Schijnpoortweg,2022-09-25,23:00:00,56,6,50,FMN 08 Schijnpoortweg
675,Schijnpoortweg,2022-09-26,00:00:00,43,12,31,FMN 08 Schijnpoortweg
675,Schijnpoortweg,2022-09-26,01:00:00,22,4,18,FMN 08 Schijnpoortweg
675,Schijnpoortweg,2022-09-26,02:00:00,13,3,10,FMN 08 Schijnpoortweg
675,Schijnpoortweg,2022-09-26,03:00:00,9,4,5,FMN 08 Schijnpoortweg
675,Schijnpoortweg,2022-09-26,04:00:00,29,7,22,FMN 08 Schijnpoortweg
675,Schijnpoortweg,2022-09-26,05:00:00,71,15,56,FMN 08 Schijnpoortweg
675,Schijnpoortweg,2022-09-26,06:00:00,97,12,85,FMN 08 Schijnpoortweg
675,Schijnpoortweg,2022-09-26,07:00:00,193,29,164,FMN 08 Schijnpoortweg
675,Schijnpoortweg,2022-09-26,08:00:00,244,46,198,FMN 08 Schijnpoortweg
675,Schijnpoortweg,2022-09-26,09:00:00,99,14,85,FMN 08 Schijnpoortweg
675,Schijnpoortweg,2022-09-26,10:00:00,90,11,79,FMN 08 Schijnpoortweg
675,Schijnpoortweg,2022-09-26,11:00:00,70,12,58,FMN 08 Schijnpoortweg
675,Schijnpoortweg,2022-09-26,12:00:00,125,22,103,FMN 08 Schijnpoortweg
675,Schijnpoortweg,2022-09-26,13:00:00,102,12,90,FMN 08 Schijnpoortweg
675,Schijnpoortweg,2022-09-26,14:00:00,109,17,92,FMN 08 Schijnpoortweg
675,Schijnpoortweg,2022-09-26,15:00:00,228,19,209,FMN 08 Schijnpoortweg
675,Schijnpoortweg,2022-09-26,16:00:00,268,26,242,FMN 08 Schijnpoortweg
675,Schijnpoortweg,2022-09-26,17:00:00,227,18,209,FMN 08 Schijnpoortweg
675,Schijnpoortweg,2022-09-26,18:00:00,144,21,123,FMN 08 Schijnpoortweg
675,Schijnpoortweg,2022-09-26,19:00:00,139,17,122,FMN 08 Schijnpoortweg
675,Schijnpoortweg,2022-09-26,20:00:00,92,12,80,FMN 08 Schijnpoortweg
675,Schijnpoortweg,2022-09-26,21:00:00,68,10,58,FMN 08 Schijnpoortweg
675,Schijnpoortweg,2022-09-26,22:00:00,56,5,51,FMN 08 Schijnpoortweg
675,Schijnpoortweg,2022-09-26,23:00:00,32,7,25,FMN 08 Schijnpoortweg
675,Schijnpoortweg,2022-09-27,00:00:00,17,1,16,FMN 08 Schijnpoortweg
675,Schijnpoortweg,2022-09-27,01:00:00,16,4,12,FMN 08 Schijnpoortweg
675,Schijnpoortweg,2022-09-27,02:00:00,10,5,5,FMN 08 Schijnpoortweg
675,Schijnpoortweg,2022-09-27,03:00:00,5,2,3,FMN 08 Schijnpoortweg
675,Schijnpoortweg,2022-09-27,04:00:00,30,10,20,FMN 08 Schijnpoortweg
675,Schijnpoortweg,2022-09-27,05:00:00,52,8,44,FMN 08 Schijnpoortweg
675,Schijnpoortweg,2022-09-27,06:00:00,75,13,62,FMN 08 Schijnpoortweg
675,Schijnpoortweg,2022-09-27,07:00:00,152,20,132,FMN 08 Schijnpoortweg
675,Schijnpoortweg,2022-09-27,08:00:00,215,36,179,FMN 08 Schijnpoortweg
675,Schijnpoortweg,2022-09-27,09:00:00,76,12,64,FMN 08 Schijnpoortweg
675,Schijnpoortweg,2022-09-27,10:00:00,70,13,57,FMN 08 Schijnpoortweg
675,Schijnpoortweg,2022-09-27,11:00:00,93,15,78,FMN 08 Schijnpoortweg
675,Schijnpoortweg,2022-09-27,12:00:00,91,11,80,FMN 08 Schijnpoortweg
675,Schijnpoortweg,2022-09-27,13:00:00,101,15,86,FMN 08 Schijnpoortweg
675,Schijnpoortweg,2022-09-27,14:00:00,120,14,106,FMN 08 Schijnpoortweg
675,Schijnpoortweg,2022-09-27,15:00:00,192,17,175,FMN 08 Schijnpoortweg
675,Schijnpoortweg,2022-09-27,16:00:00,311,27,284,FMN 08 Schijnpoortweg
675,Schijnpoortweg,2022-09-27,17:00:00,262,36,226,FMN 08 Schijnpoortweg
675,Schijnpoortweg,2022-09-27,18:00:00,211,34,177,FMN 08 Schijnpoortweg
675,Schijnpoortweg,2022-09-27,19:00:00,134,17,117,FMN 08 Schijnpoortweg
675,Schijnpoortweg,2022-09-27,20:00:00,106,14,92,FMN 08 Schijnpoortweg
675,Schijnpoortweg,2022-09-27,21:00:00,91,9,82,FMN 08 Schijnpoortweg
675,Schijnpoortweg,2022-09-27,22:00:00,78,16,62,FMN 08 Schijnpoortweg
675,Schijnpoortweg,2022-09-27,23:00:00,48,10,38,FMN 08 Schijnpoortweg
675,Schijnpoortweg,2022-09-28,00:00:00,24,2,22,FMN 08 Schijnpoortweg
675,Schijnpoortweg,2022-09-28,01:00:00,9,1,8,FMN 08 Schijnpoortweg
675,Schijnpoortweg,2022-09-28,02:00:00,14,4,10,FMN 08 Schijnpoortweg
675,Schijnpoortweg,2022-09-28,03:00:00,15,5,10,FMN 08 Schijnpoortweg
675,Schijnpoortweg,2022-09-28,04:00:00,26,5,21,FMN 08 Schijnpoortweg
675,Schijnpoortweg,2022-09-28,05:00:00,59,7,52,FMN 08 Schijnpoortweg
675,Schijnpoortweg,2022-09-28,06:00:00,86,22,64,FMN 08 Schijnpoortweg
675,Schijnpoortweg,2022-09-28,07:00:00,185,22,163,FMN 08 Schijnpoortweg
675,Schijnpoortweg,2022-09-28,08:00:00,226,45,181,FMN 08 Schijnpoortweg
675,Schijnpoortweg,2022-09-28,09:00:00,93,17,76,FMN 08 Schijnpoortweg
675,Schijnpoortweg,2022-09-28,10:00:00,101,14,87,FMN 08 Schijnpoortweg
675,Schijnpoortweg,2022-09-28,11:00:00,108,17,91,FMN 08 Schijnpoortweg
675,Schijnpoortweg,2022-09-28,12:00:00,237,26,211,FMN 08 Schijnpoortweg
675,Schijnpoortweg,2022-09-28,13:00:00,158,21,137,FMN 08 Schijnpoortweg
675,Schijnpoortweg,2022-09-28,14:00:00,156,18,138,FMN 08 Schijnpoortweg
675,Schijnpoortweg,2022-09-28,15:00:00,178,15,163,FMN 08 Schijnpoortweg
675,Schijnpoortweg,2022-09-28,16:00:00,291,32,259,FMN 08 Schijnpoortweg
675,Schijnpoortweg,2022-09-28,17:00:00,281,24,257,FMN 08 Schijnpoortweg
675,Schijnpoortweg,2022-09-28,18:00:00,220,44,176,FMN 08 Schijnpoortweg
675,Schijnpoortweg,2022-09-28,19:00:00,181,15,166,FMN 08 Schijnpoortweg
675,Schijnpoortweg,2022-09-28,20:00:00,155,29,126,FMN 08 Schijnpoortweg
675,Schijnpoortweg,2022-09-28,21:00:00,125,23,102,FMN 08 Schijnpoortweg
675,Schijnpoortweg,2022-09-28,22:00:00,95,18,77,FMN 08 Schijnpoortweg
675,Schijnpoortweg,2022-09-28,23:00:00,53,5,48,FMN 08 Schijnpoortweg
675,Schijnpoortweg,2022-09-29,00:00:00,39,4,35,FMN 08 Schijnpoortweg
675,Schijnpoortweg,2022-09-29,01:00:00,18,4,14,FMN 08 Schijnpoortweg
675,Schijnpoortweg,2022-09-29,02:00:00,14,2,12,FMN 08 Schijnpoortweg
675,Schijnpoortweg,2022-09-29,03:00:00,11,4,7,FMN 08 Schijnpoortweg
675,Schijnpoortweg,2022-09-29,04:00:00,20,4,16,FMN 08 Schijnpoortweg
675,Schijnpoortweg,2022-09-29,05:00:00,61,10,51,FMN 08 Schijnpoortweg
675,Schijnpoortweg,2022-09-29,06:00:00,93,16,77,FMN 08 Schijnpoortweg
675,Schijnpoortweg,2022-09-29,07:00:00,190,25,165,FMN 08 Schijnpoortweg
675,Schijnpoortweg,2022-09-29,08:00:00,274,55,219,FMN 08 Schijnpoortweg
675,Schijnpoortweg,2022-09-29,09:00:00,106,20,86,FMN 08 Schijnpoortweg
675,Schijnpoortweg,2022-09-29,10:00:00,97,10,87,FMN 08 Schijnpoortweg
675,Schijnpoortweg,2022-09-29,11:00:00,131,24,107,FMN 08 Schijnpoortweg
675,Schijnpoortweg,2022-09-29,12:00:00,185,20,165,FMN 08 Schijnpoortweg
675,Schijnpoortweg,2022-09-29,13:00:00,160,25,135,FMN 08 Schijnpoortweg
675,Schijnpoortweg,2022-09-29,14:00:00,152,14,138,FMN 08 Schijnpoortweg
675,Schijnpoortweg,2022-09-29,15:00:00,321,45,276,FMN 08 Schijnpoortweg
675,Schijnpoortweg,2022-09-29,16:00:00,346,63,283,FMN 08 Schijnpoortweg
675,Schijnpoortweg,2022-09-29,17:00:00,329,42,287,FMN 08 Schijnpoortweg
675,Schijnpoortweg,2022-09-29,18:00:00,247,32,215,FMN 08 Schijnpoortweg
675,Schijnpoortweg,2022-09-29,19:00:00,183,22,161,FMN 08 Schijnpoortweg
675,Schijnpoortweg,2022-09-29,20:00:00,172,13,159,FMN 08 Schijnpoortweg
675,Schijnpoortweg,2022-09-29,21:00:00,170,15,155,FMN 08 Schijnpoortweg
675,Schijnpoortweg,2022-09-29,22:00:00,174,20,154,FMN 08 Schijnpoortweg
675,Schijnpoortweg,2022-09-29,23:00:00,79,16,63,FMN 08 Schijnpoortweg
675,Schijnpoortweg,2022-09-30,00:00:00,48,4,44,FMN 08 Schijnpoortweg
675,Schijnpoortweg,2022-09-30,01:00:00,23,4,19,FMN 08 Schijnpoortweg
675,Schijnpoortweg,2022-09-30,02:00:00,23,5,18,FMN 08 Schijnpoortweg
675,Schijnpoortweg,2022-09-30,03:00:00,10,5,5,FMN 08 Schijnpoortweg
675,Schijnpoortweg,2022-09-30,04:00:00,31,11,20,FMN 08 Schijnpoortweg
675,Schijnpoortweg,2022-09-30,05:00:00,66,13,53,FMN 08 Schijnpoortweg
675,Schijnpoortweg,2022-09-30,06:00:00,84,19,65,FMN 08 Schijnpoortweg
675,Schijnpoortweg,2022-09-30,07:00:00,189,26,163,FMN 08 Schijnpoortweg
675,Schijnpoortweg,2022-09-30,08:00:00,240,38,202,FMN 08 Schijnpoortweg
675,Schijnpoortweg,2022-09-30,09:00:00,103,14,89,FMN 08 Schijnpoortweg
675,Schijnpoortweg,2022-09-30,10:00:00,96,17,79,FMN 08 Schijnpoortweg
675,Schijnpoortweg,2022-09-30,11:00:00,115,19,96,FMN 08 Schijnpoortweg
675,Schijnpoortweg,2022-09-30,12:00:00,173,30,143,FMN 08 Schijnpoortweg
675,Schijnpoortweg,2022-09-30,13:00:00,138,21,117,FMN 08 Schijnpoortweg
675,Schijnpoortweg,2022-09-30,14:00:00,184,27,157,FMN 08 Schijnpoortweg
675,Schijnpoortweg,2022-09-30,15:00:00,298,32,266,FMN 08 Schijnpoortweg
675,Schijnpoortweg,2022-09-30,16:00:00,365,41,324,FMN 08 Schijnpoortweg
675,Schijnpoortweg,2022-09-30,17:00:00,302,39,263,FMN 08 Schijnpoortweg
675,Schijnpoortweg,2022-09-30,18:00:00,236,34,202,FMN 08 Schijnpoortweg
675,Schijnpoortweg,2022-09-30,19:00:00,258,39,219,FMN 08 Schijnpoortweg
675,Schijnpoortweg,2022-09-30,20:00:00,181,30,151,FMN 08 Schijnpoortweg
675,Schijnpoortweg,2022-09-30,21:00:00,93,14,79,FMN 08 Schijnpoortweg
675,Schijnpoortweg,2022-09-30,22:00:00,131,46,85,FMN 08 Schijnpoortweg
675,Schijnpoortweg,2022-09-30,23:00:00,85,25,60,FMN 08 Schijnpoortweg
675,Schijnpoortweg,2022-10-01,00:00:00,49,10,39,FMN 08 Schijnpoortweg
675,Schijnpoortweg,2022-10-01,01:00:00,27,6,21,FMN 08 Schijnpoortweg
675,Schijnpoortweg,2022-10-01,02:00:00,27,3,24,FMN 08 Schijnpoortweg
675,Schijnpoortweg,2022-10-01,03:00:00,18,5,13,FMN 08 Schijnpoortweg
675,Schijnpoortweg,2022-10-01,04:00:00,8,1,7,FMN 08 Schijnpoortweg
675,Schijnpoortweg,2022-10-01,05:00:00,21,8,13,FMN 08 Schijnpoortweg
675,Schijnpoortweg,2022-10-01,06:00:00,37,14,23,FMN 08 Schijnpoortweg
675,Schijnpoortweg,2022-10-01,07:00:00,37,6,31,FMN 08 Schijnpoortweg
675,Schijnpoortweg,2022-10-01,08:00:00,44,7,37,FMN 08 Schijnpoortweg
675,Schijnpoortweg,2022-10-01,09:00:00,84,17,67,FMN 08 Schijnpoortweg
675,Schijnpoortweg,2022-10-01,10:00:00,87,14,73,FMN 08 Schijnpoortweg
675,Schijnpoortweg,2022-10-01,11:00:00,86,24,62,FMN 08 Schijnpoortweg
675,Schijnpoortweg,2022-10-01,12:00:00,122,16,106,FMN 08 Schijnpoortweg
675,Schijnpoortweg,2022-10-01,13:00:00,118,34,84,FMN 08 Schijnpoortweg
675,Schijnpoortweg,2022-10-01,14:00:00,140,26,114,FMN 08 Schijnpoortweg
675,Schijnpoortweg,2022-10-01,15:00:00,143,31,112,FMN 08 Schijnpoortweg
675,Schijnpoortweg,2022-10-01,16:00:00,133,22,111,FMN 08 Schijnpoortweg
675,Schijnpoortweg,2022-10-01,17:00:00,147,47,100,FMN 08 Schijnpoortweg
675,Schijnpoortweg,2022-10-01,18:00:00,149,39,110,FMN 08 Schijnpoortweg
675,Schijnpoortweg,2022-10-01,19:00:00,131,25,106,FMN 08 Schijnpoortweg
675,Schijnpoortweg,2022-10-01,20:00:00,116,15,101,FMN 08 Schijnpoortweg
675,Schijnpoortweg,2022-10-01,21:00:00,86,19,67,FMN 08 Schijnpoortweg
675,Schijnpoortweg,2022-10-01,22:00:00,86,15,71,FMN 08 Schijnpoortweg
675,Schijnpoortweg,2022-10-01,23:00:00,75,12,63,FMN 08 Schijnpoortweg
675,Schijnpoortweg,2022-10-02,00:00:00,54,7,47,FMN 08 Schijnpoortweg
675,Schijnpoortweg,2022-10-02,01:00:00,40,4,36,FMN 08 Schijnpoortweg
675,Schijnpoortweg,2022-10-02,02:00:00,34,9,25,FMN 08 Schijnpoortweg
675,Schijnpoortweg,2022-10-02,03:00:00,20,3,17,FMN 08 Schijnpoortweg
675,Schijnpoortweg,2022-10-02,04:00:00,22,2,20,FMN 08 Schijnpoortweg
675,Schijnpoortweg,2022-10-02,05:00:00,15,1,14,FMN 08 Schijnpoortweg
675,Schijnpoortweg,2022-10-02,06:00:00,19,12,7,FMN 08 Schijnpoortweg
675,Schijnpoortweg,2022-10-02,07:00:00,27,7,20,FMN 08 Schijnpoortweg
675,Schijnpoortweg,2022-10-02,08:00:00,26,12,14,FMN 08 Schijnpoortweg
675,Schijnpoortweg,2022-10-02,09:00:00,51,8,43,FMN 08 Schijnpoortweg
675,Schijnpoortweg,2022-10-02,10:00:00,95,13,82,FMN 08 Schijnpoortweg
675,Schijnpoortweg,2022-10-02,11:00:00,90,21,69,FMN 08 Schijnpoortweg
675,Schijnpoortweg,2022-10-02,12:00:00,106,19,87,FMN 08 Schijnpoortweg
675,Schijnpoortweg,2022-10-02,13:00:00,104,22,82,FMN 08 Schijnpoortweg
675,Schijnpoortweg,2022-10-02,14:00:00,109,16,93,FMN 08 Schijnpoortweg
675,Schijnpoortweg,2022-10-02,15:00:00,131,26,105,FMN 08 Schijnpoortweg
675,Schijnpoortweg,2022-10-02,16:00:00,143,20,123,FMN 08 Schijnpoortweg
675,Schijnpoortweg,2022-10-02,17:00:00,138,31,107,FMN 08 Schijnpoortweg
675,Schijnpoortweg,2022-10-02,18:00:00,147,24,123,FMN 08 Schijnpoortweg
675,Schijnpoortweg,2022-10-02,19:00:00,118,26,92,FMN 08 Schijnpoortweg
675,Schijnpoortweg,2022-10-02,20:00:00,118,26,92,FMN 08 Schijnpoortweg
675,Schijnpoortweg,2022-10-02,21:00:00,78,11,67,FMN 08 Schijnpoortweg
675,Schijnpoortweg,2022-10-02,22:00:00,78,13,65,FMN 08 Schijnpoortweg
675,Schijnpoortweg,2022-10-02,23:00:00,57,13,44,FMN 08 Schijnpoortweg
675,Schijnpoortweg,2022-10-03,00:00:00,37,8,29,FMN 08 Schijnpoortweg
675,Schijnpoortweg,2022-10-03,01:00:00,20,3,17,FMN 08 Schijnpoortweg
675,Schijnpoortweg,2022-10-03,02:00:00,17,2,15,FMN 08 Schijnpoortweg
675,Schijnpoortweg,2022-10-03,03:00:00,10,3,7,FMN 08 Schijnpoortweg
675,Schijnpoortweg,2022-10-03,04:00:00,25,12,13,FMN 08 Schijnpoortweg
675,Schijnpoortweg,2022-10-03,05:00:00,70,10,60,FMN 08 Schijnpoortweg
675,Schijnpoortweg,2022-10-03,06:00:00,94,15,79,FMN 08 Schijnpoortweg
675,Schijnpoortweg,2022-10-03,07:00:00,167,21,146,FMN 08 Schijnpoortweg
675,Schijnpoortweg,2022-10-03,08:00:00,228,40,188,FMN 08 Schijnpoortweg
675,Schijnpoortweg,2022-10-03,09:00:00,102,22,80,FMN 08 Schijnpoortweg
675,Schijnpoortweg,2022-10-03,10:00:00,95,14,81,FMN 08 Schijnpoortweg
675,Schijnpoortweg,2022-10-03,11:00:00,128,19,109,FMN 08 Schijnpoortweg
675,Schijnpoortweg,2022-10-03,12:00:00,164,26,138,FMN 08 Schijnpoortweg
675,Schijnpoortweg,2022-10-03,13:00:00,125,17,108,FMN 08 Schijnpoortweg
675,Schijnpoortweg,2022-10-03,14:00:00,184,16,168,FMN 08 Schijnpoortweg
675,Schijnpoortweg,2022-10-03,15:00:00,233,19,214,FMN 08 Schijnpoortweg
675,Schijnpoortweg,2022-10-03,16:00:00,353,24,329,FMN 08 Schijnpoortweg
675,Schijnpoortweg,2022-10-03,17:00:00,319,31,288,FMN 08 Schijnpoortweg
675,Schijnpoortweg,2022-10-03,18:00:00,233,29,204,FMN 08 Schijnpoortweg
675,Schijnpoortweg,2022-10-03,19:00:00,197,23,174,FMN 08 Schijnpoortweg
675,Schijnpoortweg,2022-10-03,20:00:00,111,15,96,FMN 08 Schijnpoortweg
675,Schijnpoortweg,2022-10-03,21:00:00,109,13,96,FMN 08 Schijnpoortweg
675,Schijnpoortweg,2022-10-03,22:00:00,109,22,87,FMN 08 Schijnpoortweg
675,Schijnpoortweg,2022-10-03,23:00:00,73,7,66,FMN 08 Schijnpoortweg
675,Schijnpoortweg,2022-10-04,00:00:00,36,8,28,FMN 08 Schijnpoortweg
675,Schijnpoortweg,2022-10-04,01:00:00,21,4,17,FMN 08 Schijnpoortweg
675,Schijnpoortweg,2022-10-04,02:00:00,18,5,13,FMN 08 Schijnpoortweg
675,Schijnpoortweg,2022-10-04,03:00:00,12,3,9,FMN 08 Schijnpoortweg
675,Schijnpoortweg,2022-10-04,04:00:00,22,9,13,FMN 08 Schijnpoortweg
675,Schijnpoortweg,2022-10-04,05:00:00,67,6,61,FMN 08 Schijnpoortweg
675,Schijnpoortweg,2022-10-04,06:00:00,85,15,70,FMN 08 Schijnpoortweg
675,Schijnpoortweg,2022-10-04,07:00:00,223,29,194,FMN 08 Schijnpoortweg
675,Schijnpoortweg,2022-10-04,08:00:00,283,51,232,FMN 08 Schijnpoortweg
675,Schijnpoortweg,2022-10-04,09:00:00,120,23,97,FMN 08 Schijnpoortweg
675,Schijnpoortweg,2022-10-04,10:00:00,119,19,100,FMN 08 Schijnpoortweg
675,Schijnpoortweg,2022-10-04,11:00:00,102,14,88,FMN 08 Schijnpoortweg
675,Schijnpoortweg,2022-10-04,12:00:00,154,31,123,FMN 08 Schijnpoortweg
675,Schijnpoortweg,2022-10-04,13:00:00,161,21,140,FMN 08 Schijnpoortweg
675,Schijnpoortweg,2022-10-04,14:00:00,161,15,146,FMN 08 Schijnpoortweg
675,Schijnpoortweg,2022-10-04,15:00:00,283,14,269,FMN 08 Schijnpoortweg
675,Schijnpoortweg,2022-10-04,16:00:00,417,40,377,FMN 08 Schijnpoortweg
675,Schijnpoortweg,2022-10-04,17:00:00,400,43,357,FMN 08 Schijnpoortweg
675,Schijnpoortweg,2022-10-04,18:00:00,294,45,249,FMN 08 Schijnpoortweg
675,Schijnpoortweg,2022-10-04,19:00:00,196,23,173,FMN 08 Schijnpoortweg
675,Schijnpoortweg,2022-10-04,20:00:00,132,20,112,FMN 08 Schijnpoortweg
675,Schijnpoortweg,2022-10-04,21:00:00,139,21,118,FMN 08 Schijnpoortweg
675,Schijnpoortweg,2022-10-04,22:00:00,115,11,104,FMN 08 Schijnpoortweg
675,Schijnpoortweg,2022-10-04,23:00:00,63,6,57,FMN 08 Schijnpoortweg
675,Schijnpoortweg,2022-10-05,00:00:00,37,4,33,FMN 08 Schijnpoortweg
675,Schijnpoortweg,2022-10-05,01:00:00,18,5,13,FMN 08 Schijnpoortweg
675,Schijnpoortweg,2022-10-05,02:00:00,13,4,9,FMN 08 Schijnpoortweg
675,Schijnpoortweg,2022-10-05,03:00:00,14,2,12,FMN 08 Schijnpoortweg
675,Schijnpoortweg,2022-10-05,04:00:00,28,8,20,FMN 08 Schijnpoortweg
675,Schijnpoortweg,2022-10-05,05:00:00,68,13,55,FMN 08 Schijnpoortweg
675,Schijnpoortweg,2022-10-05,06:00:00,81,15,66,FMN 08 Schijnpoortweg
675,Schijnpoortweg,2022-10-05,07:00:00,200,37,163,FMN 08 Schijnpoortweg
675,Schijnpoortweg,2022-10-05,08:00:00,248,37,211,FMN 08 Schijnpoortweg
675,Schijnpoortweg,2022-10-05,09:00:00,124,21,103,FMN 08 Schijnpoortweg
675,Schijnpoortweg,2022-10-05,10:00:00,110,14,96,FMN 08 Schijnpoortweg
675,Schijnpoortweg,2022-10-05,11:00:00,135,17,118,FMN 08 Schijnpoortweg
675,Schijnpoortweg,2022-10-05,12:00:00,277,32,245,FMN 08 Schijnpoortweg
675,Schijnpoortweg,2022-10-05,13:00:00,226,26,200,FMN 08 Schijnpoortweg
675,Schijnpoortweg,2022-10-05,14:00:00,171,18,153,FMN 08 Schijnpoortweg
675,Schijnpoortweg,2022-10-05,15:00:00,235,26,209,FMN 08 Schijnpoortweg
675,Schijnpoortweg,2022-10-05,16:00:00,289,28,261,FMN 08 Schijnpoortweg
675,Schijnpoortweg,2022-10-05,17:00:00,324,34,290,FMN 08 Schijnpoortweg
675,Schijnpoortweg,2022-10-05,18:00:00,240,26,214,FMN 08 Schijnpoortweg
675,Schijnpoortweg,2022-10-05,19:00:00,168,28,140,FMN 08 Schijnpoortweg
675,Schijnpoortweg,2022-10-05,20:00:00,123,12,111,FMN 08 Schijnpoortweg
675,Schijnpoortweg,2022-10-05,21:00:00,97,10,87,FMN 08 Schijnpoortweg
675,Schijnpoortweg,2022-10-05,22:00:00,100,24,76,FMN 08 Schijnpoortweg
675,Schijnpoortweg,2022-10-05,23:00:00,73,8,65,FMN 08 Schijnpoortweg
675,Schijnpoortweg,2022-10-06,00:00:00,41,14,27,FMN 08 Schijnpoortweg
675,Schijnpoortweg,2022-10-06,01:00:00,9,4,5,FMN 08 Schijnpoortweg
675,Schijnpoortweg,2022-10-06,02:00:00,18,4,14,FMN 08 Schijnpoortweg
675,Schijnpoortweg,2022-10-06,03:00:00,14,3,11,FMN 08 Schijnpoortweg
675,Schijnpoortweg,2022-10-06,04:00:00,25,9,16,FMN 08 Schijnpoortweg
675,Schijnpoortweg,2022-10-06,05:00:00,65,6,59,FMN 08 Schijnpoortweg
675,Schijnpoortweg,2022-10-06,06:00:00,97,16,81,FMN 08 Schijnpoortweg
675,Schijnpoortweg,2022-10-06,07:00:00,209,38,171,FMN 08 Schijnpoortweg
675,Schijnpoortweg,2022-10-06,08:00:00,281,56,225,FMN 08 Schijnpoortweg
675,Schijnpoortweg,2022-10-06,09:00:00,122,30,92,FMN 08 Schijnpoortweg
675,Schijnpoortweg,2022-10-06,10:00:00,95,21,74,FMN 08 Schijnpoortweg
675,Schijnpoortweg,2022-10-06,11:00:00,114,14,100,FMN 08 Schijnpoortweg
675,Schijnpoortweg,2022-10-06,12:00:00,179,24,155,FMN 08 Schijnpoortweg
675,Schijnpoortweg,2022-10-06,13:00:00,150,30,120,FMN 08 Schijnpoortweg
675,Schijnpoortweg,2022-10-06,14:00:00,191,18,173,FMN 08 Schijnpoortweg
675,Schijnpoortweg,2022-10-06,15:00:00,303,31,272,FMN 08 Schijnpoortweg
675,Schijnpoortweg,2022-10-06,16:00:00,423,32,391,FMN 08 Schijnpoortweg
675,Schijnpoortweg,2022-10-06,17:00:00,370,39,331,FMN 08 Schijnpoortweg
675,Schijnpoortweg,2022-10-06,18:00:00,325,46,279,FMN 08 Schijnpoortweg
675,Schijnpoortweg,2022-10-06,19:00:00,218,38,180,FMN 08 Schijnpoortweg
675,Schijnpoortweg,2022-10-06,20:00:00,179,50,129,FMN 08 Schijnpoortweg
675,Schijnpoortweg,2022-10-06,21:00:00,166,46,120,FMN 08 Schijnpoortweg
675,Schijnpoortweg,2022-10-06,22:00:00,123,22,101,FMN 08 Schijnpoortweg
675,Schijnpoortweg,2022-10-06,23:00:00,90,8,82,FMN 08 Schijnpoortweg
675,Schijnpoortweg,2022-10-07,00:00:00,50,6,44,FMN 08 Schijnpoortweg
675,Schijnpoortweg,2022-10-07,01:00:00,33,6,27,FMN 08 Schijnpoortweg
675,Schijnpoortweg,2022-10-07,02:00:00,19,5,14,FMN 08 Schijnpoortweg
675,Schijnpoortweg,2022-10-07,03:00:00,16,5,11,FMN 08 Schijnpoortweg
675,Schijnpoortweg,2022-10-07,04:00:00,35,12,23,FMN 08 Schijnpoortweg
675,Schijnpoortweg,2022-10-07,05:00:00,69,7,62,FMN 08 Schijnpoortweg
675,Schijnpoortweg,2022-10-07,06:00:00,76,14,62,FMN 08 Schijnpoortweg
675,Schijnpoortweg,2022-10-07,07:00:00,178,26,152,FMN 08 Schijnpoortweg
675,Schijnpoortweg,2022-10-07,08:00:00,225,39,186,FMN 08 Schijnpoortweg
675,Schijnpoortweg,2022-10-07,09:00:00,126,20,106,FMN 08 Schijnpoortweg
675,Schijnpoortweg,2022-10-07,10:00:00,118,25,93,FMN 08 Schijnpoortweg
675,Schijnpoortweg,2022-10-07,11:00:00,121,18,103,FMN 08 Schijnpoortweg
675,Schijnpoortweg,2022-10-07,12:00:00,147,18,129,FMN 08 Schijnpoortweg
675,Schijnpoortweg,2022-10-07,13:00:00,155,20,135,FMN 08 Schijnpoortweg
675,Schijnpoortweg,2022-10-07,14:00:00,171,23,148,FMN 08 Schijnpoortweg
675,Schijnpoortweg,2022-10-07,15:00:00,298,23,275,FMN 08 Schijnpoortweg
675,Schijnpoortweg,2022-10-07,16:00:00,361,31,330,FMN 08 Schijnpoortweg
675,Schijnpoortweg,2022-10-07,17:00:00,311,32,279,FMN 08 Schijnpoortweg
675,Schijnpoortweg,2022-10-07,18:00:00,240,33,207,FMN 08 Schijnpoortweg
675,Schijnpoortweg,2022-10-07,19:00:00,296,34,262,FMN 08 Schijnpoortweg
675,Schijnpoortweg,2022-10-07,20:00:00,184,37,147,FMN 08 Schijnpoortweg
675,Schijnpoortweg,2022-10-07,21:00:00,177,35,142,FMN 08 Schijnpoortweg
675,Schijnpoortweg,2022-10-07,22:00:00,188,51,137,FMN 08 Schijnpoortweg
675,Schijnpoortweg,2022-10-07,23:00:00,135,26,109,FMN 08 Schijnpoortweg
675,Schijnpoortweg,2022-10-08,00:00:00,89,21,68,FMN 08 Schijnpoortweg
675,Schijnpoortweg,2022-10-08,01:00:00,50,7,43,FMN 08 Schijnpoortweg
675,Schijnpoortweg,2022-10-08,02:00:00,43,16,27,FMN 08 Schijnpoortweg
675,Schijnpoortweg,2022-10-08,03:00:00,27,15,12,FMN 08 Schijnpoortweg
675,Schijnpoortweg,2022-10-08,04:00:00,30,16,14,FMN 08 Schijnpoortweg
675,Schijnpoortweg,2022-10-08,05:00:00,40,26,14,FMN 08 Schijnpoortweg
675,Schijnpoortweg,2022-10-08,06:00:00,64,39,25,FMN 08 Schijnpoortweg
675,Schijnpoortweg,2022-10-08,07:00:00,44,7,37,FMN 08 Schijnpoortweg
675,Schijnpoortweg,2022-10-08,08:00:00,68,16,52,FMN 08 Schijnpoortweg
675,Schijnpoortweg,2022-10-08,09:00:00,95,16,79,FMN 08 Schijnpoortweg
675,Schijnpoortweg,2022-10-08,10:00:00,114,21,93,FMN 08 Schijnpoortweg
675,Schijnpoortweg,2022-10-08,11:00:00,133,18,115,FMN 08 Schijnpoortweg
675,Schijnpoortweg,2022-10-08,12:00:00,130,25,105,FMN 08 Schijnpoortweg
675,Schijnpoortweg,2022-10-08,13:00:00,144,27,117,FMN 08 Schijnpoortweg
675,Schijnpoortweg,2022-10-08,14:00:00,141,18,123,FMN 08 Schijnpoortweg
675,Schijnpoortweg,2022-10-08,15:00:00,164,32,132,FMN 08 Schijnpoortweg
675,Schijnpoortweg,2022-10-08,16:00:00,180,29,151,FMN 08 Schijnpoortweg
675,Schijnpoortweg,2022-10-08,17:00:00,191,27,164,FMN 08 Schijnpoortweg
675,Schijnpoortweg,2022-10-08,18:00:00,199,37,162,FMN 08 Schijnpoortweg
675,Schijnpoortweg,2022-10-08,19:00:00,282,64,218,FMN 08 Schijnpoortweg
675,Schijnpoortweg,2022-10-08,20:00:00,168,55,113,FMN 08 Schijnpoortweg
675,Schijnpoortweg,2022-10-08,21:00:00,137,28,109,FMN 08 Schijnpoortweg
675,Schijnpoortweg,2022-10-08,22:00:00,253,139,114,FMN 08 Schijnpoortweg
675,Schijnpoortweg,2022-10-08,23:00:00,125,11,114,FMN 08 Schijnpoortweg
675,Schijnpoortweg,2022-10-09,00:00:00,85,9,76,FMN 08 Schijnpoortweg
675,Schijnpoortweg,2022-10-09,01:00:00,40,7,33,FMN 08 Schijnpoortweg
675,Schijnpoortweg,2022-10-09,02:00:00,36,9,27,FMN 08 Schijnpoortweg
675,Schijnpoortweg,2022-10-09,03:00:00,39,21,18,FMN 08 Schijnpoortweg
675,Schijnpoortweg,2022-10-09,04:00:00,20,6,14,FMN 08 Schijnpoortweg
675,Schijnpoortweg,2022-10-09,05:00:00,27,9,18,FMN 08 Schijnpoortweg
675,Schijnpoortweg,2022-10-09,06:00:00,51,31,20,FMN 08 Schijnpoortweg
675,Schijnpoortweg,2022-10-09,07:00:00,29,5,24,FMN 08 Schijnpoortweg
675,Schijnpoortweg,2022-10-09,08:00:00,34,5,29,FMN 08 Schijnpoortweg
675,Schijnpoortweg,2022-10-09,09:00:00,74,19,55,FMN 08 Schijnpoortweg
675,Schijnpoortweg,2022-10-09,10:00:00,92,11,81,FMN 08 Schijnpoortweg
675,Schijnpoortweg,2022-10-09,11:00:00,112,28,84,FMN 08 Schijnpoortweg
675,Schijnpoortweg,2022-10-09,12:00:00,104,16,88,FMN 08 Schijnpoortweg
675,Schijnpoortweg,2022-10-09,13:00:00,137,20,117,FMN 08 Schijnpoortweg
675,Schijnpoortweg,2022-10-09,14:00:00,168,32,136,FMN 08 Schijnpoortweg
675,Schijnpoortweg,2022-10-09,15:00:00,183,26,157,FMN 08 Schijnpoortweg
675,Schijnpoortweg,2022-10-09,16:00:00,148,29,119,FMN 08 Schijnpoortweg
675,Schijnpoortweg,2022-10-09,17:00:00,165,32,133,FMN 08 Schijnpoortweg
675,Schijnpoortweg,2022-10-09,18:00:00,165,37,128,FMN 08 Schijnpoortweg
675,Schijnpoortweg,2022-10-09,19:00:00,150,20,130,FMN 08 Schijnpoortweg
675,Schijnpoortweg,2022-10-09,20:00:00,125,15,110,FMN 08 Schijnpoortweg
675,Schijnpoortweg,2022-10-09,21:00:00,91,7,84,FMN 08 Schijnpoortweg
675,Schijnpoortweg,2022-10-09,22:00:00,82,16,66,FMN 08 Schijnpoortweg
675,Schijnpoortweg,2022-10-09,23:00:00,42,6,36,FMN 08 Schijnpoortweg
675,Schijnpoortweg,2022-10-10,00:00:00,24,5,19,FMN 08 Schijnpoortweg
675,Schijnpoortweg,2022-10-10,01:00:00,18,8,10,FMN 08 Schijnpoortweg
675,Schijnpoortweg,2022-10-10,02:00:00,20,4,16,FMN 08 Schijnpoortweg
675,Schijnpoortweg,2022-10-10,03:00:00,11,1,10,FMN 08 Schijnpoortweg
675,Schijnpoortweg,2022-10-10,04:00:00,35,13,22,FMN 08 Schijnpoortweg
675,Schijnpoortweg,2022-10-10,05:00:00,60,8,52,FMN 08 Schijnpoortweg
675,Schijnpoortweg,2022-10-10,06:00:00,91,16,75,FMN 08 Schijnpoortweg
675,Schijnpoortweg,2022-10-10,07:00:00,208,32,176,FMN 08 Schijnpoortweg
675,Schijnpoortweg,2022-10-10,08:00:00,233,43,190,FMN 08 Schijnpoortweg
675,Schijnpoortweg,2022-10-10,09:00:00,124,22,102,FMN 08 Schijnpoortweg
675,Schijnpoortweg,2022-10-10,10:00:00,114,18,96,FMN 08 Schijnpoortweg
675,Schijnpoortweg,2022-10-10,11:00:00,112,20,92,FMN 08 Schijnpoortweg
675,Schijnpoortweg,2022-10-10,12:00:00,196,35,161,FMN 08 Schijnpoortweg
675,Schijnpoortweg,2022-10-10,13:00:00,131,14,117,FMN 08 Schijnpoortweg
675,Schijnpoortweg,2022-10-10,14:00:00,186,25,161,FMN 08 Schijnpoortweg
675,Schijnpoortweg,2022-10-10,15:00:00,272,20,252,FMN 08 Schijnpoortweg
675,Schijnpoortweg,2022-10-10,16:00:00,364,28,336,FMN 08 Schijnpoortweg
675,Schijnpoortweg,2022-10-10,17:00:00,326,17,309,FMN 08 Schijnpoortweg
675,Schijnpoortweg,2022-10-10,18:00:00,224,33,191,FMN 08 Schijnpoortweg
675,Schijnpoortweg,2022-10-10,19:00:00,179,28,151,FMN 08 Schijnpoortweg
675,Schijnpoortweg,2022-10-10,20:00:00,119,16,103,FMN 08 Schijnpoortweg
675,Schijnpoortweg,2022-10-10,21:00:00,129,16,113,FMN 08 Schijnpoortweg
675,Schijnpoortweg,2022-10-10,22:00:00,115,24,91,FMN 08 Schijnpoortweg
675,Schijnpoortweg,2022-10-10,23:00:00,76,14,62,FMN 08 Schijnpoortweg
675,Schijnpoortweg,2022-10-11,00:00:00,24,4,20,FMN 08 Schijnpoortweg
675,Schijnpoortweg,2022-10-11,01:00:00,24,5,19,FMN 08 Schijnpoortweg
675,Schijnpoortweg,2022-10-11,02:00:00,18,4,14,FMN 08 Schijnpoortweg
675,Schijnpoortweg,2022-10-11,03:00:00,12,3,9,FMN 08 Schijnpoortweg
675,Schijnpoortweg,2022-10-11,04:00:00,25,7,18,FMN 08 Schijnpoortweg
675,Schijnpoortweg,2022-10-11,05:00:00,58,10,48,FMN 08 Schijnpoortweg
675,Schijnpoortweg,2022-10-11,06:00:00,100,21,79,FMN 08 Schijnpoortweg
675,Schijnpoortweg,2022-10-11,07:00:00,208,32,176,FMN 08 Schijnpoortweg
675,Schijnpoortweg,2022-10-11,08:00:00,257,47,210,FMN 08 Schijnpoortweg
675,Schijnpoortweg,2022-10-11,09:00:00,148,23,125,FMN 08 Schijnpoortweg
675,Schijnpoortweg,2022-10-11,10:00:00,118,17,101,FMN 08 Schijnpoortweg
675,Schijnpoortweg,2022-10-11,11:00:00,121,14,107,FMN 08 Schijnpoortweg
675,Schijnpoortweg,2022-10-11,12:00:00,158,25,133,FMN 08 Schijnpoortweg
675,Schijnpoortweg,2022-10-11,13:00:00,164,16,148,FMN 08 Schijnpoortweg
675,Schijnpoortweg,2022-10-11,14:00:00,187,17,170,FMN 08 Schijnpoortweg
675,Schijnpoortweg,2022-10-11,15:00:00,288,22,266,FMN 08 Schijnpoortweg
675,Schijnpoortweg,2022-10-11,16:00:00,427,40,387,FMN 08 Schijnpoortweg
675,Schijnpoortweg,2022-10-11,17:00:00,384,32,352,FMN 08 Schijnpoortweg
675,Schijnpoortweg,2022-10-11,18:00:00,292,25,267,FMN 08 Schijnpoortweg
675,Schijnpoortweg,2022-10-11,19:00:00,212,27,185,FMN 08 Schijnpoortweg
675,Schijnpoortweg,2022-10-11,20:00:00,151,22,129,FMN 08 Schijnpoortweg
675,Schijnpoortweg,2022-10-11,21:00:00,126,19,107,FMN 08 Schijnpoortweg
675,Schijnpoortweg,2022-10-11,22:00:00,122,18,104,FMN 08 Schijnpoortweg
675,Schijnpoortweg,2022-10-11,23:00:00,74,12,62,FMN 08 Schijnpoortweg
675,Schijnpoortweg,2022-10-12,00:00:00,38,4,34,FMN 08 Schijnpoortweg
675,Schijnpoortweg,2022-10-12,01:00:00,22,1,21,FMN 08 Schijnpoortweg
675,Schijnpoortweg,2022-10-12,02:00:00,17,4,13,FMN 08 Schijnpoortweg
675,Schijnpoortweg,2022-10-12,03:00:00,13,2,11,FMN 08 Schijnpoortweg
675,Schijnpoortweg,2022-10-12,04:00:00,30,11,19,FMN 08 Schijnpoortweg
675,Schijnpoortweg,2022-10-12,05:00:00,61,15,46,FMN 08 Schijnpoortweg
675,Schijnpoortweg,2022-10-12,06:00:00,91,13,78,FMN 08 Schijnpoortweg
675,Schijnpoortweg,2022-10-12,07:00:00,204,21,183,FMN 08 Schijnpoortweg
675,Schijnpoortweg,2022-10-12,08:00:00,236,38,198,FMN 08 Schijnpoortweg
675,Schijnpoortweg,2022-10-12,09:00:00,119,12,107,FMN 08 Schijnpoortweg
675,Schijnpoortweg,2022-10-12,10:00:00,100,17,83,FMN 08 Schijnpoortweg
675,Schijnpoortweg,2022-10-12,11:00:00,133,21,112,FMN 08 Schijnpoortweg
675,Schijnpoortweg,2022-10-12,12:00:00,268,23,245,FMN 08 Schijnpoortweg
675,Schijnpoortweg,2022-10-12,13:00:00,207,27,180,FMN 08 Schijnpoortweg
675,Schijnpoortweg,2022-10-12,14:00:00,204,22,182,FMN 08 Schijnpoortweg
675,Schijnpoortweg,2022-10-12,15:00:00,232,28,204,FMN 08 Schijnpoortweg
675,Schijnpoortweg,2022-10-12,16:00:00,300,30,270,FMN 08 Schijnpoortweg
675,Schijnpoortweg,2022-10-12,17:00:00,351,36,315,FMN 08 Schijnpoortweg
675,Schijnpoortweg,2022-10-12,18:00:00,246,30,216,FMN 08 Schijnpoortweg
675,Schijnpoortweg,2022-10-12,19:00:00,206,25,181,FMN 08 Schijnpoortweg
675,Schijnpoortweg,2022-10-12,20:00:00,138,17,121,FMN 08 Schijnpoortweg
675,Schijnpoortweg,2022-10-12,21:00:00,123,20,103,FMN 08 Schijnpoortweg
675,Schijnpoortweg,2022-10-12,22:00:00,126,23,103,FMN 08 Schijnpoortweg
675,Schijnpoortweg,2022-10-12,23:00:00,80,7,73,FMN 08 Schijnpoortweg
675,Schijnpoortweg,2022-10-13,00:00:00,51,6,45,FMN 08 Schijnpoortweg
675,Schijnpoortweg,2022-10-13,01:00:00,16,3,13,FMN 08 Schijnpoortweg
675,Schijnpoortweg,2022-10-13,02:00:00,16,5,11,FMN 08 Schijnpoortweg
675,Schijnpoortweg,2022-10-13,03:00:00,6,2,4,FMN 08 Schijnpoortweg
675,Schijnpoortweg,2022-10-13,04:00:00,28,12,16,FMN 08 Schijnpoortweg
675,Schijnpoortweg,2022-10-13,05:00:00,59,8,51,FMN 08 Schijnpoortweg
675,Schijnpoortweg,2022-10-13,06:00:00,84,13,71,FMN 08 Schijnpoortweg
675,Schijnpoortweg,2022-10-13,07:00:00,216,27,189,FMN 08 Schijnpoortweg
675,Schijnpoortweg,2022-10-13,08:00:00,262,45,217,FMN 08 Schijnpoortweg
675,Schijnpoortweg,2022-10-13,09:00:00,113,16,97,FMN 08 Schijnpoortweg
675,Schijnpoortweg,2022-10-13,10:00:00,92,20,72,FMN 08 Schijnpoortweg
675,Schijnpoortweg,2022-10-13,11:00:00,80,16,64,FMN 08 Schijnpoortweg
675,Schijnpoortweg,2022-10-13,12:00:00,163,23,140,FMN 08 Schijnpoortweg
675,Schijnpoortweg,2022-10-13,13:00:00,156,14,142,FMN 08 Schijnpoortweg
675,Schijnpoortweg,2022-10-13,14:00:00,140,13,127,FMN 08 Schijnpoortweg
675,Schijnpoortweg,2022-10-13,15:00:00,271,22,249,FMN 08 Schijnpoortweg
675,Schijnpoortweg,2022-10-13,16:00:00,350,34,316,FMN 08 Schijnpoortweg
675,Schijnpoortweg,2022-10-13,17:00:00,311,30,281,FMN 08 Schijnpoortweg
675,Schijnpoortweg,2022-10-13,18:00:00,214,23,191,FMN 08 Schijnpoortweg
675,Schijnpoortweg,2022-10-13,19:00:00,162,19,143,FMN 08 Schijnpoortweg
675,Schijnpoortweg,2022-10-13,20:00:00,126,14,112,FMN 08 Schijnpoortweg
675,Schijnpoortweg,2022-10-13,21:00:00,108,14,94,FMN 08 Schijnpoortweg
675,Schijnpoortweg,2022-10-13,22:00:00,88,10,78,FMN 08 Schijnpoortweg
675,Schijnpoortweg,2022-10-13,23:00:00,73,9,64,FMN 08 Schijnpoortweg
675,Schijnpoortweg,2022-10-14,00:00:00,46,10,36,FMN 08 Schijnpoortweg
675,Schijnpoortweg,2022-10-14,01:00:00,21,2,19,FMN 08 Schijnpoortweg
675,Schijnpoortweg,2022-10-14,02:00:00,15,5,10,FMN 08 Schijnpoortweg
675,Schijnpoortweg,2022-10-14,03:00:00,20,4,16,FMN 08 Schijnpoortweg
675,Schijnpoortweg,2022-10-14,04:00:00,22,11,11,FMN 08 Schijnpoortweg
675,Schijnpoortweg,2022-10-14,05:00:00,61,6,55,FMN 08 Schijnpoortweg
675,Schijnpoortweg,2022-10-14,06:00:00,89,18,71,FMN 08 Schijnpoortweg
675,Schijnpoortweg,2022-10-14,07:00:00,182,24,158,FMN 08 Schijnpoortweg
675,Schijnpoortweg,2022-10-14,08:00:00,216,34,182,FMN 08 Schijnpoortweg
675,Schijnpoortweg,2022-10-14,09:00:00,96,18,78,FMN 08 Schijnpoortweg
675,Schijnpoortweg,2022-10-14,10:00:00,82,12,70,FMN 08 Schijnpoortweg
675,Schijnpoortweg,2022-10-14,11:00:00,99,7,92,FMN 08 Schijnpoortweg
675,Schijnpoortweg,2022-10-14,12:00:00,154,25,129,FMN 08 Schijnpoortweg
675,Schijnpoortweg,2022-10-14,13:00:00,134,10,124,FMN 08 Schijnpoortweg
675,Schijnpoortweg,2022-10-14,14:00:00,161,16,145,FMN 08 Schijnpoortweg
675,Schijnpoortweg,2022-10-14,15:00:00,260,27,233,FMN 08 Schijnpoortweg
675,Schijnpoortweg,2022-10-14,16:00:00,347,29,318,FMN 08 Schijnpoortweg
675,Schijnpoortweg,2022-10-14,17:00:00,274,24,250,FMN 08 Schijnpoortweg
675,Schijnpoortweg,2022-10-14,18:00:00,212,23,189,FMN 08 Schijnpoortweg
675,Schijnpoortweg,2022-10-14,19:00:00,190,21,169,FMN 08 Schijnpoortweg
675,Schijnpoortweg,2022-10-14,20:00:00,121,18,103,FMN 08 Schijnpoortweg
675,Schijnpoortweg,2022-10-14,21:00:00,102,24,78,FMN 08 Schijnpoortweg
675,Schijnpoortweg,2022-10-14,22:00:00,96,18,78,FMN 08 Schijnpoortweg
675,Schijnpoortweg,2022-10-14,23:00:00,100,12,88,FMN 08 Schijnpoortweg
675,Schijnpoortweg,2022-10-15,00:00:00,82,16,66,FMN 08 Schijnpoortweg
675,Schijnpoortweg,2022-10-15,01:00:00,40,8,32,FMN 08 Schijnpoortweg
675,Schijnpoortweg,2022-10-15,02:00:00,30,4,26,FMN 08 Schijnpoortweg
675,Schijnpoortweg,2022-10-15,03:00:00,33,5,28,FMN 08 Schijnpoortweg
675,Schijnpoortweg,2022-10-15,04:00:00,14,2,12,FMN 08 Schijnpoortweg
675,Schijnpoortweg,2022-10-15,05:00:00,27,4,23,FMN 08 Schijnpoortweg
675,Schijnpoortweg,2022-10-15,06:00:00,28,10,18,FMN 08 Schijnpoortweg
675,Schijnpoortweg,2022-10-15,07:00:00,40,5,35,FMN 08 Schijnpoortweg
675,Schijnpoortweg,2022-10-15,08:00:00,74,8,66,FMN 08 Schijnpoortweg
675,Schijnpoortweg,2022-10-15,09:00:00,96,17,79,FMN 08 Schijnpoortweg
675,Schijnpoortweg,2022-10-15,10:00:00,115,15,100,FMN 08 Schijnpoortweg
675,Schijnpoortweg,2022-10-15,11:00:00,99,13,86,FMN 08 Schijnpoortweg
675,Schijnpoortweg,2022-10-15,12:00:00,122,24,98,FMN 08 Schijnpoortweg
675,Schijnpoortweg,2022-10-15,13:00:00,140,18,122,FMN 08 Schijnpoortweg
675,Schijnpoortweg,2022-10-15,14:00:00,119,23,96,FMN 08 Schijnpoortweg
675,Schijnpoortweg,2022-10-15,15:00:00,160,32,128,FMN 08 Schijnpoortweg
675,Schijnpoortweg,2022-10-15,16:00:00,158,32,126,FMN 08 Schijnpoortweg
675,Schijnpoortweg,2022-10-15,17:00:00,191,38,153,FMN 08 Schijnpoortweg
675,Schijnpoortweg,2022-10-15,18:00:00,182,36,146,FMN 08 Schijnpoortweg
675,Schijnpoortweg,2022-10-15,19:00:00,149,25,124,FMN 08 Schijnpoortweg
675,Schijnpoortweg,2022-10-15,20:00:00,137,21,116,FMN 08 Schijnpoortweg
675,Schijnpoortweg,2022-10-15,21:00:00,107,18,89,FMN 08 Schijnpoortweg
675,Schijnpoortweg,2022-10-15,22:00:00,108,18,90,FMN 08 Schijnpoortweg
675,Schijnpoortweg,2022-10-15,23:00:00,93,12,81,FMN 08 Schijnpoortweg
675,Schijnpoortweg,2022-10-16,00:00:00,76,13,63,FMN 08 Schijnpoortweg
675,Schijnpoortweg,2022-10-16,01:00:00,50,5,45,FMN 08 Schijnpoortweg
675,Schijnpoortweg,2022-10-16,02:00:00,30,2,28,FMN 08 Schijnpoortweg
675,Schijnpoortweg,2022-10-16,03:00:00,30,11,19,FMN 08 Schijnpoortweg
675,Schijnpoortweg,2022-10-16,04:00:00,26,5,21,FMN 08 Schijnpoortweg
675,Schijnpoortweg,2022-10-16,05:00:00,18,6,12,FMN 08 Schijnpoortweg
675,Schijnpoortweg,2022-10-16,06:00:00,23,5,18,FMN 08 Schijnpoortweg
675,Schijnpoortweg,2022-10-16,07:00:00,25,4,21,FMN 08 Schijnpoortweg
675,Schijnpoortweg,2022-10-16,08:00:00,36,6,30,FMN 08 Schijnpoortweg
675,Schijnpoortweg,2022-10-16,09:00:00,79,15,64,FMN 08 Schijnpoortweg
675,Schijnpoortweg,2022-10-16,10:00:00,98,21,77,FMN 08 Schijnpoortweg
675,Schijnpoortweg,2022-10-16,11:00:00,131,30,101,FMN 08 Schijnpoortweg
675,Schijnpoortweg,2022-10-16,12:00:00,119,21,98,FMN 08 Schijnpoortweg
675,Schijnpoortweg,2022-10-16,13:00:00,150,27,123,FMN 08 Schijnpoortweg
675,Schijnpoortweg,2022-10-16,14:00:00,158,35,123,FMN 08 Schijnpoortweg
675,Schijnpoortweg,2022-10-16,15:00:00,172,12,160,FMN 08 Schijnpoortweg
675,Schijnpoortweg,2022-10-16,16:00:00,163,13,150,FMN 08 Schijnpoortweg
675,Schijnpoortweg,2022-10-16,17:00:00,145,21,124,FMN 08 Schijnpoortweg
675,Schijnpoortweg,2022-10-16,18:00:00,144,25,119,FMN 08 Schijnpoortweg
675,Schijnpoortweg,2022-10-16,19:00:00,125,12,113,FMN 08 Schijnpoortweg
675,Schijnpoortweg,2022-10-16,20:00:00,111,10,101,FMN 08 Schijnpoortweg
675,Schijnpoortweg,2022-10-16,21:00:00,88,11,77,FMN 08 Schijnpoortweg
675,Schijnpoortweg,2022-10-16,22:00:00,76,9,67,FMN 08 Schijnpoortweg
675,Schijnpoortweg,2022-10-16,23:00:00,52,9,43,FMN 08 Schijnpoortweg
675,Schijnpoortweg,2022-10-17,00:00:00,35,6,29,FMN 08 Schijnpoortweg
675,Schijnpoortweg,2022-10-17,01:00:00,22,6,16,FMN 08 Schijnpoortweg
675,Schijnpoortweg,2022-10-17,02:00:00,21,5,16,FMN 08 Schijnpoortweg
675,Schijnpoortweg,2022-10-17,03:00:00,15,6,9,FMN 08 Schijnpoortweg
675,Schijnpoortweg,2022-10-17,04:00:00,37,12,25,FMN 08 Schijnpoortweg
675,Schijnpoortweg,2022-10-17,05:00:00,65,5,60,FMN 08 Schijnpoortweg
675,Schijnpoortweg,2022-10-17,06:00:00,87,17,70,FMN 08 Schijnpoortweg
675,Schijnpoortweg,2022-10-17,07:00:00,198,31,167,FMN 08 Schijnpoortweg
675,Schijnpoortweg,2022-10-17,08:00:00,224,42,182,FMN 08 Schijnpoortweg
675,Schijnpoortweg,2022-10-17,09:00:00,69,12,57,FMN 08 Schijnpoortweg
675,Schijnpoortweg,2022-10-17,10:00:00,51,5,46,FMN 08 Schijnpoortweg
675,Schijnpoortweg,2022-10-17,11:00:00,76,14,62,FMN 08 Schijnpoortweg
675,Schijnpoortweg,2022-10-17,12:00:00,119,18,101,FMN 08 Schijnpoortweg
675,Schijnpoortweg,2022-10-17,13:00:00,119,16,103,FMN 08 Schijnpoortweg
675,Schijnpoortweg,2022-10-17,14:00:00,149,21,128,FMN 08 Schijnpoortweg
675,Schijnpoortweg,2022-10-17,15:00:00,248,25,223,FMN 08 Schijnpoortweg
675,Schijnpoortweg,2022-10-17,16:00:00,354,37,317,FMN 08 Schijnpoortweg
675,Schijnpoortweg,2022-10-17,17:00:00,326,35,291,FMN 08 Schijnpoortweg
675,Schijnpoortweg,2022-10-17,18:00:00,243,25,218,FMN 08 Schijnpoortweg
675,Schijnpoortweg,2022-10-17,19:00:00,163,28,135,FMN 08 Schijnpoortweg
675,Schijnpoortweg,2022-10-17,20:00:00,114,10,104,FMN 08 Schijnpoortweg
675,Schijnpoortweg,2022-10-17,21:00:00,103,18,85,FMN 08 Schijnpoortweg
675,Schijnpoortweg,2022-10-17,22:00:00,114,23,91,FMN 08 Schijnpoortweg
675,Schijnpoortweg,2022-10-17,23:00:00,51,5,46,FMN 08 Schijnpoortweg
675,Schijnpoortweg,2022-10-18,00:00:00,48,4,44,FMN 08 Schijnpoortweg
675,Schijnpoortweg,2022-10-18,01:00:00,20,2,18,FMN 08 Schijnpoortweg
675,Schijnpoortweg,2022-10-18,02:00:00,19,3,16,FMN 08 Schijnpoortweg
675,Schijnpoortweg,2022-10-18,03:00:00,12,4,8,FMN 08 Schijnpoortweg
675,Schijnpoortweg,2022-10-18,04:00:00,26,11,15,FMN 08 Schijnpoortweg
675,Schijnpoortweg,2022-10-18,05:00:00,73,8,65,FMN 08 Schijnpoortweg
675,Schijnpoortweg,2022-10-18,06:00:00,104,22,82,FMN 08 Schijnpoortweg
675,Schijnpoortweg,2022-10-18,07:00:00,187,19,168,FMN 08 Schijnpoortweg
675,Schijnpoortweg,2022-10-18,08:00:00,255,44,211,FMN 08 Schijnpoortweg
675,Schijnpoortweg,2022-10-18,09:00:00,137,26,111,FMN 08 Schijnpoortweg
675,Schijnpoortweg,2022-10-18,10:00:00,104,15,89,FMN 08 Schijnpoortweg
675,Schijnpoortweg,2022-10-18,11:00:00,118,14,104,FMN 08 Schijnpoortweg
675,Schijnpoortweg,2022-10-18,12:00:00,194,30,164,FMN 08 Schijnpoortweg
675,Schijnpoortweg,2022-10-18,13:00:00,193,28,165,FMN 08 Schijnpoortweg
675,Schijnpoortweg,2022-10-18,14:00:00,194,19,175,FMN 08 Schijnpoortweg
675,Schijnpoortweg,2022-10-18,15:00:00,332,31,301,FMN 08 Schijnpoortweg
675,Schijnpoortweg,2022-10-18,16:00:00,444,59,385,FMN 08 Schijnpoortweg
675,Schijnpoortweg,2022-10-18,17:00:00,414,34,380,FMN 08 Schijnpoortweg
675,Schijnpoortweg,2022-10-18,18:00:00,283,26,257,FMN 08 Schijnpoortweg
675,Schijnpoortweg,2022-10-18,19:00:00,221,24,197,FMN 08 Schijnpoortweg
675,Schijnpoortweg,2022-10-18,20:00:00,154,11,143,FMN 08 Schijnpoortweg
675,Schijnpoortweg,2022-10-18,21:00:00,109,18,91,FMN 08 Schijnpoortweg
675,Schijnpoortweg,2022-10-18,22:00:00,123,20,103,FMN 08 Schijnpoortweg
675,Schijnpoortweg,2022-10-18,23:00:00,79,15,64,FMN 08 Schijnpoortweg
675,Schijnpoortweg,2022-10-19,00:00:00,53,8,45,FMN 08 Schijnpoortweg
675,Schijnpoortweg,2022-10-19,01:00:00,24,7,17,FMN 08 Schijnpoortweg
675,Schijnpoortweg,2022-10-19,02:00:00,19,3,16,FMN 08 Schijnpoortweg
675,Schijnpoortweg,2022-10-19,03:00:00,16,4,12,FMN 08 Schijnpoortweg
675,Schijnpoortweg,2022-10-19,04:00:00,28,7,21,FMN 08 Schijnpoortweg
675,Schijnpoortweg,2022-10-19,05:00:00,61,6,55,FMN 08 Schijnpoortweg
675,Schijnpoortweg,2022-10-19,06:00:00,104,14,90,FMN 08 Schijnpoortweg
675,Schijnpoortweg,2022-10-19,07:00:00,204,17,187,FMN 08 Schijnpoortweg
675,Schijnpoortweg,2022-10-19,08:00:00,250,25,225,FMN 08 Schijnpoortweg
675,Schijnpoortweg,2022-10-19,09:00:00,114,17,97,FMN 08 Schijnpoortweg
675,Schijnpoortweg,2022-10-19,10:00:00,113,15,98,FMN 08 Schijnpoortweg
675,Schijnpoortweg,2022-10-19,11:00:00,148,21,127,FMN 08 Schijnpoortweg
675,Schijnpoortweg,2022-10-19,12:00:00,283,26,257,FMN 08 Schijnpoortweg
675,Schijnpoortweg,2022-10-19,13:00:00,216,13,203,FMN 08 Schijnpoortweg
675,Schijnpoortweg,2022-10-19,14:00:00,194,21,173,FMN 08 Schijnpoortweg
675,Schijnpoortweg,2022-10-19,15:00:00,258,27,231,FMN 08 Schijnpoortweg
675,Schijnpoortweg,2022-10-19,16:00:00,320,33,287,FMN 08 Schijnpoortweg
675,Schijnpoortweg,2022-10-19,17:00:00,337,25,312,FMN 08 Schijnpoortweg
675,Schijnpoortweg,2022-10-19,18:00:00,279,23,256,FMN 08 Schijnpoortweg
675,Schijnpoortweg,2022-10-19,19:00:00,201,32,169,FMN 08 Schijnpoortweg
675,Schijnpoortweg,2022-10-19,20:00:00,129,15,114,FMN 08 Schijnpoortweg
675,Schijnpoortweg,2022-10-19,21:00:00,124,17,107,FMN 08 Schijnpoortweg
675,Schijnpoortweg,2022-10-19,22:00:00,111,23,88,FMN 08 Schijnpoortweg
675,Schijnpoortweg,2022-10-19,23:00:00,90,16,74,FMN 08 Schijnpoortweg
675,Schijnpoortweg,2022-10-20,00:00:00,42,3,39,FMN 08 Schijnpoortweg
675,Schijnpoortweg,2022-10-20,01:00:00,20,2,18,FMN 08 Schijnpoortweg
675,Schijnpoortweg,2022-10-20,02:00:00,13,6,7,FMN 08 Schijnpoortweg
675,Schijnpoortweg,2022-10-20,03:00:00,13,5,8,FMN 08 Schijnpoortweg
675,Schijnpoortweg,2022-10-20,04:00:00,33,6,27,FMN 08 Schijnpoortweg
675,Schijnpoortweg,2022-10-20,05:00:00,68,5,63,FMN 08 Schijnpoortweg
675,Schijnpoortweg,2022-10-20,06:00:00,107,18,89,FMN 08 Schijnpoortweg
675,Schijnpoortweg,2022-10-20,07:00:00,194,23,171,FMN 08 Schijnpoortweg
675,Schijnpoortweg,2022-10-20,08:00:00,291,46,245,FMN 08 Schijnpoortweg
675,Schijnpoortweg,2022-10-20,09:00:00,114,25,89,FMN 08 Schijnpoortweg
675,Schijnpoortweg,2022-10-20,10:00:00,120,11,109,FMN 08 Schijnpoortweg
675,Schijnpoortweg,2022-10-20,11:00:00,74,9,65,FMN 08 Schijnpoortweg
675,Schijnpoortweg,2022-10-20,12:00:00,148,19,129,FMN 08 Schijnpoortweg
675,Schijnpoortweg,2022-10-20,13:00:00,130,13,117,FMN 08 Schijnpoortweg
675,Schijnpoortweg,2022-10-20,14:00:00,166,17,149,FMN 08 Schijnpoortweg
675,Schijnpoortweg,2022-10-20,15:00:00,279,20,259,FMN 08 Schijnpoortweg
675,Schijnpoortweg,2022-10-20,16:00:00,396,34,362,FMN 08 Schijnpoortweg
675,Schijnpoortweg,2022-10-20,17:00:00,435,33,402,FMN 08 Schijnpoortweg
675,Schijnpoortweg,2022-10-20,18:00:00,328,37,291,FMN 08 Schijnpoortweg
675,Schijnpoortweg,2022-10-20,19:00:00,220,31,189,FMN 08 Schijnpoortweg
675,Schijnpoortweg,2022-10-20,20:00:00,144,22,122,FMN 08 Schijnpoortweg
675,Schijnpoortweg,2022-10-20,21:00:00,149,39,110,FMN 08 Schijnpoortweg
675,Schijnpoortweg,2022-10-20,22:00:00,120,22,98,FMN 08 Schijnpoortweg
675,Schijnpoortweg,2022-10-20,23:00:00,83,17,66,FMN 08 Schijnpoortweg
675,Schijnpoortweg,2022-10-21,00:00:00,56,7,49,FMN 08 Schijnpoortweg
675,Schijnpoortweg,2022-10-21,01:00:00,35,15,20,FMN 08 Schijnpoortweg
675,Schijnpoortweg,2022-10-21,02:00:00,24,7,17,FMN 08 Schijnpoortweg
675,Schijnpoortweg,2022-10-21,03:00:00,22,6,16,FMN 08 Schijnpoortweg
675,Schijnpoortweg,2022-10-21,04:00:00,32,7,25,FMN 08 Schijnpoortweg
675,Schijnpoortweg,2022-10-21,05:00:00,81,13,68,FMN 08 Schijnpoortweg
675,Schijnpoortweg,2022-10-21,06:00:00,100,22,78,FMN 08 Schijnpoortweg
675,Schijnpoortweg,2022-10-21,07:00:00,191,29,162,FMN 08 Schijnpoortweg
675,Schijnpoortweg,2022-10-21,08:00:00,211,25,186,FMN 08 Schijnpoortweg
675,Schijnpoortweg,2022-10-21,09:00:00,109,20,89,FMN 08 Schijnpoortweg
675,Schijnpoortweg,2022-10-21,10:00:00,99,13,86,FMN 08 Schijnpoortweg
675,Schijnpoortweg,2022-10-21,11:00:00,137,25,112,FMN 08 Schijnpoortweg
675,Schijnpoortweg,2022-10-21,12:00:00,195,30,165,FMN 08 Schijnpoortweg
675,Schijnpoortweg,2022-10-21,13:00:00,182,18,164,FMN 08 Schijnpoortweg
675,Schijnpoortweg,2022-10-21,14:00:00,192,30,162,FMN 08 Schijnpoortweg
675,Schijnpoortweg,2022-10-21,15:00:00,292,27,265,FMN 08 Schijnpoortweg
675,Schijnpoortweg,2022-10-21,16:00:00,383,38,345,FMN 08 Schijnpoortweg
675,Schijnpoortweg,2022-10-21,17:00:00,356,46,310,FMN 08 Schijnpoortweg
675,Schijnpoortweg,2022-10-21,18:00:00,285,34,251,FMN 08 Schijnpoortweg
675,Schijnpoortweg,2022-10-21,19:00:00,239,20,219,FMN 08 Schijnpoortweg
675,Schijnpoortweg,2022-10-21,20:00:00,132,22,110,FMN 08 Schijnpoortweg
675,Schijnpoortweg,2022-10-21,21:00:00,152,27,125,FMN 08 Schijnpoortweg
675,Schijnpoortweg,2022-10-21,22:00:00,130,31,99,FMN 08 Schijnpoortweg
675,Schijnpoortweg,2022-10-21,23:00:00,109,18,91,FMN 08 Schijnpoortweg
675,Schijnpoortweg,2022-10-22,00:00:00,107,26,81,FMN 08 Schijnpoortweg
675,Schijnpoortweg,2022-10-22,01:00:00,59,12,47,FMN 08 Schijnpoortweg
675,Schijnpoortweg,2022-10-22,02:00:00,35,4,31,FMN 08 Schijnpoortweg
675,Schijnpoortweg,2022-10-22,03:00:00,29,8,21,FMN 08 Schijnpoortweg
675,Schijnpoortweg,2022-10-22,04:00:00,30,4,26,FMN 08 Schijnpoortweg
675,Schijnpoortweg,2022-10-22,05:00:00,22,6,16,FMN 08 Schijnpoortweg
675,Schijnpoortweg,2022-10-22,06:00:00,39,13,26,FMN 08 Schijnpoortweg
675,Schijnpoortweg,2022-10-22,07:00:00,51,11,40,FMN 08 Schijnpoortweg
675,Schijnpoortweg,2022-10-22,08:00:00,63,9,54,FMN 08 Schijnpoortweg
675,Schijnpoortweg,2022-10-22,09:00:00,95,8,87,FMN 08 Schijnpoortweg
675,Schijnpoortweg,2022-10-22,10:00:00,119,15,104,FMN 08 Schijnpoortweg
675,Schijnpoortweg,2022-10-22,11:00:00,132,27,105,FMN 08 Schijnpoortweg
675,Schijnpoortweg,2022-10-22,12:00:00,165,39,126,FMN 08 Schijnpoortweg
675,Schijnpoortweg,2022-10-22,13:00:00,194,36,158,FMN 08 Schijnpoortweg
675,Schijnpoortweg,2022-10-22,14:00:00,185,33,152,FMN 08 Schijnpoortweg
675,Schijnpoortweg,2022-10-22,15:00:00,218,35,183,FMN 08 Schijnpoortweg
675,Schijnpoortweg,2022-10-22,16:00:00,187,43,144,FMN 08 Schijnpoortweg
675,Schijnpoortweg,2022-10-22,17:00:00,217,52,165,FMN 08 Schijnpoortweg
675,Schijnpoortweg,2022-10-22,18:00:00,253,99,154,FMN 08 Schijnpoortweg
675,Schijnpoortweg,2022-10-22,19:00:00,331,116,215,FMN 08 Schijnpoortweg
675,Schijnpoortweg,2022-10-22,20:00:00,183,68,115,FMN 08 Schijnpoortweg
675,Schijnpoortweg,2022-10-22,21:00:00,155,41,114,FMN 08 Schijnpoortweg
675,Schijnpoortweg,2022-10-22,22:00:00,110,13,97,FMN 08 Schijnpoortweg
675,Schijnpoortweg,2022-10-22,23:00:00,153,70,83,FMN 08 Schijnpoortweg
675,Schijnpoortweg,2022-10-23,00:00:00,124,56,68,FMN 08 Schijnpoortweg
675,Schijnpoortweg,2022-10-23,01:00:00,55,8,47,FMN 08 Schijnpoortweg
675,Schijnpoortweg,2022-10-23,02:00:00,40,6,34,FMN 08 Schijnpoortweg
675,Schijnpoortweg,2022-10-23,03:00:00,31,8,23,FMN 08 Schijnpoortweg
675,Schijnpoortweg,2022-10-23,04:00:00,23,5,18,FMN 08 Schijnpoortweg
675,Schijnpoortweg,2022-10-23,05:00:00,24,11,13,FMN 08 Schijnpoortweg
675,Schijnpoortweg,2022-10-23,06:00:00,36,11,25,FMN 08 Schijnpoortweg
675,Schijnpoortweg,2022-10-23,07:00:00,22,3,19,FMN 08 Schijnpoortweg
675,Schijnpoortweg,2022-10-23,08:00:00,41,8,33,FMN 08 Schijnpoortweg
675,Schijnpoortweg,2022-10-23,09:00:00,66,10,56,FMN 08 Schijnpoortweg
675,Schijnpoortweg,2022-10-23,10:00:00,91,19,72,FMN 08 Schijnpoortweg
675,Schijnpoortweg,2022-10-23,11:00:00,128,16,112,FMN 08 Schijnpoortweg
675,Schijnpoortweg,2022-10-23,12:00:00,200,29,171,FMN 08 Schijnpoortweg
675,Schijnpoortweg,2022-10-23,13:00:00,163,21,142,FMN 08 Schijnpoortweg
675,Schijnpoortweg,2022-10-23,14:00:00,148,34,114,FMN 08 Schijnpoortweg
675,Schijnpoortweg,2022-10-23,15:00:00,195,33,162,FMN 08 Schijnpoortweg
675,Schijnpoortweg,2022-10-23,16:00:00,150,27,123,FMN 08 Schijnpoortweg
675,Schijnpoortweg,2022-10-23,17:00:00,174,59,115,FMN 08 Schijnpoortweg
675,Schijnpoortweg,2022-10-23,18:00:00,184,53,131,FMN 08 Schijnpoortweg
675,Schijnpoortweg,2022-10-23,19:00:00,143,26,117,FMN 08 Schijnpoortweg
675,Schijnpoortweg,2022-10-23,20:00:00,93,15,78,FMN 08 Schijnpoortweg
675,Schijnpoortweg,2022-10-23,21:00:00,81,14,67,FMN 08 Schijnpoortweg
675,Schijnpoortweg,2022-10-23,22:00:00,60,12,48,FMN 08 Schijnpoortweg
675,Schijnpoortweg,2022-10-23,23:00:00,62,12,50,FMN 08 Schijnpoortweg
675,Schijnpoortweg,2022-10-24,00:00:00,30,5,25,FMN 08 Schijnpoortweg
675,Schijnpoortweg,2022-10-24,01:00:00,21,4,17,FMN 08 Schijnpoortweg
675,Schijnpoortweg,2022-10-24,02:00:00,18,8,10,FMN 08 Schijnpoortweg
675,Schijnpoortweg,2022-10-24,03:00:00,14,2,12,FMN 08 Schijnpoortweg
675,Schijnpoortweg,2022-10-24,04:00:00,29,9,20,FMN 08 Schijnpoortweg
675,Schijnpoortweg,2022-10-24,05:00:00,70,7,63,FMN 08 Schijnpoortweg
675,Schijnpoortweg,2022-10-24,06:00:00,90,18,72,FMN 08 Schijnpoortweg
675,Schijnpoortweg,2022-10-24,07:00:00,205,26,179,FMN 08 Schijnpoortweg
675,Schijnpoortweg,2022-10-24,08:00:00,211,38,173,FMN 08 Schijnpoortweg
675,Schijnpoortweg,2022-10-24,09:00:00,113,15,98,FMN 08 Schijnpoortweg
675,Schijnpoortweg,2022-10-24,10:00:00,99,7,92,FMN 08 Schijnpoortweg
675,Schijnpoortweg,2022-10-24,11:00:00,129,33,96,FMN 08 Schijnpoortweg
675,Schijnpoortweg,2022-10-24,12:00:00,206,59,147,FMN 08 Schijnpoortweg
675,Schijnpoortweg,2022-10-24,13:00:00,162,38,124,FMN 08 Schijnpoortweg
675,Schijnpoortweg,2022-10-24,14:00:00,201,37,164,FMN 08 Schijnpoortweg
675,Schijnpoortweg,2022-10-24,15:00:00,270,59,211,FMN 08 Schijnpoortweg
675,Schijnpoortweg,2022-10-24,16:00:00,396,88,308,FMN 08 Schijnpoortweg
675,Schijnpoortweg,2022-10-24,17:00:00,381,79,302,FMN 08 Schijnpoortweg
675,Schijnpoortweg,2022-10-24,18:00:00,261,49,212,FMN 08 Schijnpoortweg
675,Schijnpoortweg,2022-10-24,19:00:00,203,49,154,FMN 08 Schijnpoortweg
675,Schijnpoortweg,2022-10-24,20:00:00,113,34,79,FMN 08 Schijnpoortweg
675,Schijnpoortweg,2022-10-24,21:00:00,126,36,90,FMN 08 Schijnpoortweg
675,Schijnpoortweg,2022-10-24,22:00:00,114,33,81,FMN 08 Schijnpoortweg
675,Schijnpoortweg,2022-10-24,23:00:00,64,21,43,FMN 08 Schijnpoortweg
675,Schijnpoortweg,2022-10-25,00:00:00,40,16,24,FMN 08 Schijnpoortweg
675,Schijnpoortweg,2022-10-25,01:00:00,34,9,25,FMN 08 Schijnpoortweg
675,Schijnpoortweg,2022-10-25,02:00:00,15,6,9,FMN 08 Schijnpoortweg
675,Schijnpoortweg,2022-10-25,03:00:00,18,7,11,FMN 08 Schijnpoortweg
675,Schijnpoortweg,2022-10-25,04:00:00,29,16,13,FMN 08 Schijnpoortweg
675,Schijnpoortweg,2022-10-25,05:00:00,88,22,66,FMN 08 Schijnpoortweg
675,Schijnpoortweg,2022-10-25,06:00:00,135,38,97,FMN 08 Schijnpoortweg
675,Schijnpoortweg,2022-10-25,07:00:00,264,83,181,FMN 08 Schijnpoortweg
675,Schijnpoortweg,2022-10-25,08:00:00,290,81,209,FMN 08 Schijnpoortweg
675,Schijnpoortweg,2022-10-25,09:00:00,173,71,102,FMN 08 Schijnpoortweg
675,Schijnpoortweg,2022-10-25,10:00:00,159,34,125,FMN 08 Schijnpoortweg
675,Schijnpoortweg,2022-10-25,11:00:00,146,38,108,FMN 08 Schijnpoortweg
675,Schijnpoortweg,2022-10-25,12:00:00,203,59,144,FMN 08 Schijnpoortweg
675,Schijnpoortweg,2022-10-25,13:00:00,199,57,142,FMN 08 Schijnpoortweg
675,Schijnpoortweg,2022-10-25,14:00:00,197,37,160,FMN 08 Schijnpoortweg
675,Schijnpoortweg,2022-10-25,15:00:00,353,71,282,FMN 08 Schijnpoortweg
675,Schijnpoortweg,2022-10-25,16:00:00,408,82,326,FMN 08 Schijnpoortweg
675,Schijnpoortweg,2022-10-25,17:00:00,455,75,380,FMN 08 Schijnpoortweg
675,Schijnpoortweg,2022-10-25,18:00:00,327,75,252,FMN 08 Schijnpoortweg
675,Schijnpoortweg,2022-10-25,19:00:00,263,66,197,FMN 08 Schijnpoortweg
675,Schijnpoortweg,2022-10-25,20:00:00,147,36,111,FMN 08 Schijnpoortweg
675,Schijnpoortweg,2022-10-25,21:00:00,142,36,106,FMN 08 Schijnpoortweg
675,Schijnpoortweg,2022-10-25,22:00:00,116,28,88,FMN 08 Schijnpoortweg
675,Schijnpoortweg,2022-10-25,23:00:00,83,16,67,FMN 08 Schijnpoortweg
675,Schijnpoortweg,2022-10-26,00:00:00,53,15,38,FMN 08 Schijnpoortweg
675,Schijnpoortweg,2022-10-26,01:00:00,21,3,18,FMN 08 Schijnpoortweg
675,Schijnpoortweg,2022-10-26,02:00:00,16,3,13,FMN 08 Schijnpoortweg
675,Schijnpoortweg,2022-10-26,03:00:00,17,4,13,FMN 08 Schijnpoortweg
675,Schijnpoortweg,2022-10-26,04:00:00,48,23,25,FMN 08 Schijnpoortweg
675,Schijnpoortweg,2022-10-26,05:00:00,85,20,65,FMN 08 Schijnpoortweg
675,Schijnpoortweg,2022-10-26,06:00:00,134,33,101,FMN 08 Schijnpoortweg
675,Schijnpoortweg,2022-10-26,07:00:00,257,77,180,FMN 08 Schijnpoortweg
675,Schijnpoortweg,2022-10-26,08:00:00,284,97,187,FMN 08 Schijnpoortweg
675,Schijnpoortweg,2022-10-26,09:00:00,166,43,123,FMN 08 Schijnpoortweg
675,Schijnpoortweg,2022-10-26,10:00:00,159,41,118,FMN 08 Schijnpoortweg
675,Schijnpoortweg,2022-10-26,11:00:00,205,48,157,FMN 08 Schijnpoortweg
675,Schijnpoortweg,2022-10-26,12:00:00,321,58,263,FMN 08 Schijnpoortweg
675,Schijnpoortweg,2022-10-26,13:00:00,220,42,178,FMN 08 Schijnpoortweg
675,Schijnpoortweg,2022-10-26,14:00:00,225,47,178,FMN 08 Schijnpoortweg
675,Schijnpoortweg,2022-10-26,15:00:00,314,75,239,FMN 08 Schijnpoortweg
675,Schijnpoortweg,2022-10-26,16:00:00,397,78,319,FMN 08 Schijnpoortweg
675,Schijnpoortweg,2022-10-26,17:00:00,438,84,354,FMN 08 Schijnpoortweg
675,Schijnpoortweg,2022-10-26,18:00:00,297,49,248,FMN 08 Schijnpoortweg
675,Schijnpoortweg,2022-10-26,19:00:00,266,58,208,FMN 08 Schijnpoortweg
675,Schijnpoortweg,2022-10-26,20:00:00,158,27,131,FMN 08 Schijnpoortweg
675,Schijnpoortweg,2022-10-26,21:00:00,150,26,124,FMN 08 Schijnpoortweg
675,Schijnpoortweg,2022-10-26,22:00:00,125,32,93,FMN 08 Schijnpoortweg
675,Schijnpoortweg,2022-10-26,23:00:00,106,21,85,FMN 08 Schijnpoortweg
675,Schijnpoortweg,2022-10-27,00:00:00,55,7,48,FMN 08 Schijnpoortweg
675,Schijnpoortweg,2022-10-27,01:00:00,36,9,27,FMN 08 Schijnpoortweg
675,Schijnpoortweg,2022-10-27,02:00:00,21,5,16,FMN 08 Schijnpoortweg
675,Schijnpoortweg,2022-10-27,03:00:00,14,3,11,FMN 08 Schijnpoortweg
675,Schijnpoortweg,2022-10-27,04:00:00,31,13,18,FMN 08 Schijnpoortweg
675,Schijnpoortweg,2022-10-27,05:00:00,80,12,68,FMN 08 Schijnpoortweg
675,Schijnpoortweg,2022-10-27,06:00:00,116,18,98,FMN 08 Schijnpoortweg
675,Schijnpoortweg,2022-10-27,07:00:00,226,39,187,FMN 08 Schijnpoortweg
675,Schijnpoortweg,2022-10-27,08:00:00,295,45,250,FMN 08 Schijnpoortweg
675,Schijnpoortweg,2022-10-27,09:00:00,117,24,93,FMN 08 Schijnpoortweg
675,Schijnpoortweg,2022-10-27,10:00:00,102,17,85,FMN 08 Schijnpoortweg
675,Schijnpoortweg,2022-10-27,11:00:00,117,19,98,FMN 08 Schijnpoortweg
675,Schijnpoortweg,2022-10-27,12:00:00,189,26,163,FMN 08 Schijnpoortweg
675,Schijnpoortweg,2022-10-27,13:00:00,161,24,137,FMN 08 Schijnpoortweg
675,Schijnpoortweg,2022-10-27,14:00:00,190,26,164,FMN 08 Schijnpoortweg
675,Schijnpoortweg,2022-10-27,15:00:00,317,44,273,FMN 08 Schijnpoortweg
675,Schijnpoortweg,2022-10-27,16:00:00,392,58,334,FMN 08 Schijnpoortweg
675,Schijnpoortweg,2022-10-27,17:00:00,395,51,344,FMN 08 Schijnpoortweg
675,Schijnpoortweg,2022-10-27,18:00:00,287,42,245,FMN 08 Schijnpoortweg
675,Schijnpoortweg,2022-10-27,19:00:00,234,37,197,FMN 08 Schijnpoortweg
675,Schijnpoortweg,2022-10-27,20:00:00,181,33,148,FMN 08 Schijnpoortweg
675,Schijnpoortweg,2022-10-27,21:00:00,132,19,113,FMN 08 Schijnpoortweg
675,Schijnpoortweg,2022-10-27,22:00:00,122,15,107,FMN 08 Schijnpoortweg
675,Schijnpoortweg,2022-10-27,23:00:00,72,6,66,FMN 08 Schijnpoortweg
675,Schijnpoortweg,2022-10-28,00:00:00,47,6,41,FMN 08 Schijnpoortweg
675,Schijnpoortweg,2022-10-28,01:00:00,34,3,31,FMN 08 Schijnpoortweg
675,Schijnpoortweg,2022-10-28,02:00:00,29,7,22,FMN 08 Schijnpoortweg
675,Schijnpoortweg,2022-10-28,03:00:00,19,5,14,FMN 08 Schijnpoortweg
675,Schijnpoortweg,2022-10-28,04:00:00,30,13,17,FMN 08 Schijnpoortweg
675,Schijnpoortweg,2022-10-28,05:00:00,68,8,60,FMN 08 Schijnpoortweg
675,Schijnpoortweg,2022-10-28,06:00:00,109,22,87,FMN 08 Schijnpoortweg
675,Schijnpoortweg,2022-10-28,07:00:00,196,20,176,FMN 08 Schijnpoortweg
675,Schijnpoortweg,2022-10-28,08:00:00,262,61,201,FMN 08 Schijnpoortweg
675,Schijnpoortweg,2022-10-28,09:00:00,143,22,121,FMN 08 Schijnpoortweg
675,Schijnpoortweg,2022-10-28,10:00:00,125,25,100,FMN 08 Schijnpoortweg
675,Schijnpoortweg,2022-10-28,11:00:00,131,17,114,FMN 08 Schijnpoortweg
675,Schijnpoortweg,2022-10-28,12:00:00,197,20,177,FMN 08 Schijnpoortweg
675,Schijnpoortweg,2022-10-28,13:00:00,204,28,176,FMN 08 Schijnpoortweg
675,Schijnpoortweg,2022-10-28,14:00:00,199,32,167,FMN 08 Schijnpoortweg
675,Schijnpoortweg,2022-10-28,15:00:00,364,54,310,FMN 08 Schijnpoortweg
675,Schijnpoortweg,2022-10-28,16:00:00,396,57,339,FMN 08 Schijnpoortweg
675,Schijnpoortweg,2022-10-28,17:00:00,434,74,360,FMN 08 Schijnpoortweg
675,Schijnpoortweg,2022-10-28,18:00:00,472,119,353,FMN 08 Schijnpoortweg
675,Schijnpoortweg,2022-10-28,19:00:00,567,118,449,FMN 08 Schijnpoortweg
675,Schijnpoortweg,2022-10-28,20:00:00,760,205,555,FMN 08 Schijnpoortweg
675,Schijnpoortweg,2022-10-28,21:00:00,335,106,229,FMN 08 Schijnpoortweg
675,Schijnpoortweg,2022-10-28,22:00:00,236,100,136,FMN 08 Schijnpoortweg
675,Schijnpoortweg,2022-10-28,23:00:00,459,329,130,FMN 08 Schijnpoortweg
675,Schijnpoortweg,2022-10-29,00:00:00,166,39,127,FMN 08 Schijnpoortweg
675,Schijnpoortweg,2022-10-29,01:00:00,95,17,78,FMN 08 Schijnpoortweg
675,Schijnpoortweg,2022-10-29,02:00:00,54,10,44,FMN 08 Schijnpoortweg
675,Schijnpoortweg,2022-10-29,03:00:00,42,8,34,FMN 08 Schijnpoortweg
675,Schijnpoortweg,2022-10-29,04:00:00,29,4,25,FMN 08 Schijnpoortweg
675,Schijnpoortweg,2022-10-29,05:00:00,38,10,28,FMN 08 Schijnpoortweg
675,Schijnpoortweg,2022-10-29,06:00:00,49,10,39,FMN 08 Schijnpoortweg
675,Schijnpoortweg,2022-10-29,07:00:00,63,5,58,FMN 08 Schijnpoortweg
675,Schijnpoortweg,2022-10-29,08:00:00,93,10,83,FMN 08 Schijnpoortweg
675,Schijnpoortweg,2022-10-29,09:00:00,133,15,118,FMN 08 Schijnpoortweg
675,Schijnpoortweg,2022-10-29,10:00:00,137,29,108,FMN 08 Schijnpoortweg
675,Schijnpoortweg,2022-10-29,11:00:00,156,27,129,FMN 08 Schijnpoortweg
675,Schijnpoortweg,2022-10-29,12:00:00,184,36,148,FMN 08 Schijnpoortweg
675,Schijnpoortweg,2022-10-29,13:00:00,213,43,170,FMN 08 Schijnpoortweg
675,Schijnpoortweg,2022-10-29,14:00:00,262,31,231,FMN 08 Schijnpoortweg
675,Schijnpoortweg,2022-10-29,15:00:00,269,59,210,FMN 08 Schijnpoortweg
675,Schijnpoortweg,2022-10-29,16:00:00,279,33,246,FMN 08 Schijnpoortweg
675,Schijnpoortweg,2022-10-29,17:00:00,329,80,249,FMN 08 Schijnpoortweg
675,Schijnpoortweg,2022-10-29,18:00:00,356,108,248,FMN 08 Schijnpoortweg
675,Schijnpoortweg,2022-10-29,19:00:00,301,78,223,FMN 08 Schijnpoortweg
675,Schijnpoortweg,2022-10-29,20:00:00,304,76,228,FMN 08 Schijnpoortweg
675,Schijnpoortweg,2022-10-29,21:00:00,176,32,144,FMN 08 Schijnpoortweg
675,Schijnpoortweg,2022-10-29,22:00:00,176,51,125,FMN 08 Schijnpoortweg
675,Schijnpoortweg,2022-10-29,23:00:00,305,180,125,FMN 08 Schijnpoortweg
675,Schijnpoortweg,2022-10-30,00:00:00,112,16,96,FMN 08 Schijnpoortweg
675,Schijnpoortweg,2022-10-30,01:00:00,60,9,51,FMN 08 Schijnpoortweg
675,Schijnpoortweg,2022-10-30,02:00:00,97,21,76,FMN 08 Schijnpoortweg
675,Schijnpoortweg,2022-10-30,03:00:00,24,6,18,FMN 08 Schijnpoortweg
675,Schijnpoortweg,2022-10-30,04:00:00,21,3,18,FMN 08 Schijnpoortweg
675,Schijnpoortweg,2022-10-30,05:00:00,24,6,18,FMN 08 Schijnpoortweg
675,Schijnpoortweg,2022-10-30,06:00:00,26,10,16,FMN 08 Schijnpoortweg
675,Schijnpoortweg,2022-10-30,07:00:00,33,6,27,FMN 08 Schijnpoortweg
675,Schijnpoortweg,2022-10-30,08:00:00,62,10,52,FMN 08 Schijnpoortweg
675,Schijnpoortweg,2022-10-30,09:00:00,115,18,97,FMN 08 Schijnpoortweg
675,Schijnpoortweg,2022-10-30,10:00:00,136,29,107,FMN 08 Schijnpoortweg
675,Schijnpoortweg,2022-10-30,11:00:00,174,30,144,FMN 08 Schijnpoortweg
675,Schijnpoortweg,2022-10-30,12:00:00,150,25,125,FMN 08 Schijnpoortweg
675,Schijnpoortweg,2022-10-30,13:00:00,184,32,152,FMN 08 Schijnpoortweg
675,Schijnpoortweg,2022-10-30,14:00:00,228,39,189,FMN 08 Schijnpoortweg
675,Schijnpoortweg,2022-10-30,15:00:00,234,28,206,FMN 08 Schijnpoortweg
675,Schijnpoortweg,2022-10-30,16:00:00,277,54,223,FMN 08 Schijnpoortweg
675,Schijnpoortweg,2022-10-30,17:00:00,249,47,202,FMN 08 Schijnpoortweg
675,Schijnpoortweg,2022-10-30,18:00:00,224,57,167,FMN 08 Schijnpoortweg
675,Schijnpoortweg,2022-10-30,19:00:00,211,54,157,FMN 08 Schijnpoortweg
675,Schijnpoortweg,2022-10-30,20:00:00,164,38,126,FMN 08 Schijnpoortweg
675,Schijnpoortweg,2022-10-30,21:00:00,111,22,89,FMN 08 Schijnpoortweg
675,Schijnpoortweg,2022-10-30,22:00:00,105,28,77,FMN 08 Schijnpoortweg
675,Schijnpoortweg,2022-10-30,23:00:00,114,56,58,FMN 08 Schijnpoortweg
675,Schijnpoortweg,2022-10-31,00:00:00,51,8,43,FMN 08 Schijnpoortweg
675,Schijnpoortweg,2022-10-31,01:00:00,43,15,28,FMN 08 Schijnpoortweg
675,Schijnpoortweg,2022-10-31,02:00:00,36,10,26,FMN 08 Schijnpoortweg
675,Schijnpoortweg,2022-10-31,03:00:00,19,6,13,FMN 08 Schijnpoortweg
675,Schijnpoortweg,2022-10-31,04:00:00,32,14,18,FMN 08 Schijnpoortweg
675,Schijnpoortweg,2022-10-31,05:00:00,56,12,44,FMN 08 Schijnpoortweg
675,Schijnpoortweg,2022-10-31,06:00:00,82,17,65,FMN 08 Schijnpoortweg
675,Schijnpoortweg,2022-10-31,07:00:00,146,15,131,FMN 08 Schijnpoortweg
675,Schijnpoortweg,2022-10-31,08:00:00,145,16,129,FMN 08 Schijnpoortweg
675,Schijnpoortweg,2022-10-31,09:00:00,100,12,88,FMN 08 Schijnpoortweg
675,Schijnpoortweg,2022-10-31,10:00:00,118,23,95,FMN 08 Schijnpoortweg
675,Schijnpoortweg,2022-10-31,11:00:00,130,21,109,FMN 08 Schijnpoortweg
675,Schijnpoortweg,2022-10-31,12:00:00,151,35,116,FMN 08 Schijnpoortweg
675,Schijnpoortweg,2022-10-31,13:00:00,167,26,141,FMN 08 Schijnpoortweg
675,Schijnpoortweg,2022-10-31,14:00:00,215,40,175,FMN 08 Schijnpoortweg
675,Schijnpoortweg,2022-10-31,15:00:00,238,31,207,FMN 08 Schijnpoortweg
675,Schijnpoortweg,2022-10-31,16:00:00,331,36,295,FMN 08 Schijnpoortweg
675,Schijnpoortweg,2022-10-31,17:00:00,377,42,335,FMN 08 Schijnpoortweg
675,Schijnpoortweg,2022-10-31,18:00:00,266,53,213,FMN 08 Schijnpoortweg
675,Schijnpoortweg,2022-10-31,19:00:00,213,42,171,FMN 08 Schijnpoortweg
675,Schijnpoortweg,2022-10-31,20:00:00,189,55,134,FMN 08 Schijnpoortweg
675,Schijnpoortweg,2022-10-31,21:00:00,160,27,133,FMN 08 Schijnpoortweg
675,Schijnpoortweg,2022-10-31,22:00:00,140,23,117,FMN 08 Schijnpoortweg
675,Schijnpoortweg,2022-10-31,23:00:00,129,35,94,FMN 08 Schijnpoortweg
675,Schijnpoortweg,2022-11-01,00:00:00,67,9,58,FMN 08 Schijnpoortweg
675,Schijnpoortweg,2022-11-01,01:00:00,59,14,45,FMN 08 Schijnpoortweg
675,Schijnpoortweg,2022-11-01,02:00:00,41,14,27,FMN 08 Schijnpoortweg
675,Schijnpoortweg,2022-11-01,03:00:00,43,15,28,FMN 08 Schijnpoortweg
675,Schijnpoortweg,2022-11-01,04:00:00,42,14,28,FMN 08 Schijnpoortweg
675,Schijnpoortweg,2022-11-01,05:00:00,28,9,19,FMN 08 Schijnpoortweg
675,Schijnpoortweg,2022-11-01,06:00:00,45,11,34,FMN 08 Schijnpoortweg
675,Schijnpoortweg,2022-11-01,07:00:00,43,7,36,FMN 08 Schijnpoortweg
675,Schijnpoortweg,2022-11-01,08:00:00,56,7,49,FMN 08 Schijnpoortweg
675,Schijnpoortweg,2022-11-01,09:00:00,82,7,75,FMN 08 Schijnpoortweg
675,Schijnpoortweg,2022-11-01,10:00:00,105,24,81,FMN 08 Schijnpoortweg
675,Schijnpoortweg,2022-11-01,11:00:00,141,30,111,FMN 08 Schijnpoortweg
675,Schijnpoortweg,2022-11-01,12:00:00,159,26,133,FMN 08 Schijnpoortweg
675,Schijnpoortweg,2022-11-01,13:00:00,146,21,125,FMN 08 Schijnpoortweg
675,Schijnpoortweg,2022-11-01,14:00:00,174,27,147,FMN 08 Schijnpoortweg
675,Schijnpoortweg,2022-11-01,15:00:00,173,23,150,FMN 08 Schijnpoortweg
675,Schijnpoortweg,2022-11-01,16:00:00,201,30,171,FMN 08 Schijnpoortweg
675,Schijnpoortweg,2022-11-01,17:00:00,202,40,162,FMN 08 Schijnpoortweg
675,Schijnpoortweg,2022-11-01,18:00:00,176,26,150,FMN 08 Schijnpoortweg
675,Schijnpoortweg,2022-11-01,19:00:00,150,22,128,FMN 08 Schijnpoortweg
675,Schijnpoortweg,2022-11-01,20:00:00,116,12,104,FMN 08 Schijnpoortweg
675,Schijnpoortweg,2022-11-01,21:00:00,83,13,70,FMN 08 Schijnpoortweg
675,Schijnpoortweg,2022-11-01,22:00:00,106,27,79,FMN 08 Schijnpoortweg
675,Schijnpoortweg,2022-11-01,23:00:00,71,10,61,FMN 08 Schijnpoortweg
675,Schijnpoortweg,2022-11-02,00:00:00,41,8,33,FMN 08 Schijnpoortweg
675,Schijnpoortweg,2022-11-02,01:00:00,32,9,23,FMN 08 Schijnpoortweg
675,Schijnpoortweg,2022-11-02,02:00:00,14,4,10,FMN 08 Schijnpoortweg
675,Schijnpoortweg,2022-11-02,03:00:00,23,5,18,FMN 08 Schijnpoortweg
675,Schijnpoortweg,2022-11-02,04:00:00,34,15,19,FMN 08 Schijnpoortweg
675,Schijnpoortweg,2022-11-02,05:00:00,71,15,56,FMN 08 Schijnpoortweg
675,Schijnpoortweg,2022-11-02,06:00:00,87,12,75,FMN 08 Schijnpoortweg
675,Schijnpoortweg,2022-11-02,07:00:00,175,17,158,FMN 08 Schijnpoortweg
675,Schijnpoortweg,2022-11-02,08:00:00,177,27,150,FMN 08 Schijnpoortweg
675,Schijnpoortweg,2022-11-02,09:00:00,113,21,92,FMN 08 Schijnpoortweg
675,Schijnpoortweg,2022-11-02,10:00:00,97,22,75,FMN 08 Schijnpoortweg
675,Schijnpoortweg,2022-11-02,11:00:00,130,14,116,FMN 08 Schijnpoortweg
675,Schijnpoortweg,2022-11-02,12:00:00,153,14,139,FMN 08 Schijnpoortweg
675,Schijnpoortweg,2022-11-02,13:00:00,165,25,140,FMN 08 Schijnpoortweg
675,Schijnpoortweg,2022-11-02,14:00:00,199,23,176,FMN 08 Schijnpoortweg
675,Schijnpoortweg,2022-11-02,15:00:00,196,28,168,FMN 08 Schijnpoortweg
675,Schijnpoortweg,2022-11-02,16:00:00,306,44,262,FMN 08 Schijnpoortweg
675,Schijnpoortweg,2022-11-02,17:00:00,315,19,296,FMN 08 Schijnpoortweg
675,Schijnpoortweg,2022-11-02,18:00:00,258,30,228,FMN 08 Schijnpoortweg
675,Schijnpoortweg,2022-11-02,19:00:00,168,25,143,FMN 08 Schijnpoortweg
675,Schijnpoortweg,2022-11-02,20:00:00,134,18,116,FMN 08 Schijnpoortweg
675,Schijnpoortweg,2022-11-02,21:00:00,97,9,88,FMN 08 Schijnpoortweg
675,Schijnpoortweg,2022-11-02,22:00:00,105,22,83,FMN 08 Schijnpoortweg
675,Schijnpoortweg,2022-11-02,23:00:00,80,18,62,FMN 08 Schijnpoortweg
675,Schijnpoortweg,2022-11-03,00:00:00,47,7,40,FMN 08 Schijnpoortweg
675,Schijnpoortweg,2022-11-03,01:00:00,23,6,17,FMN 08 Schijnpoortweg
675,Schijnpoortweg,2022-11-03,02:00:00,22,5,17,FMN 08 Schijnpoortweg
675,Schijnpoortweg,2022-11-03,03:00:00,14,4,10,FMN 08 Schijnpoortweg
675,Schijnpoortweg,2022-11-03,04:00:00,24,13,11,FMN 08 Schijnpoortweg
675,Schijnpoortweg,2022-11-03,05:00:00,76,6,70,FMN 08 Schijnpoortweg
675,Schijnpoortweg,2022-11-03,06:00:00,94,12,82,FMN 08 Schijnpoortweg
675,Schijnpoortweg,2022-11-03,07:00:00,156,15,141,FMN 08 Schijnpoortweg
675,Schijnpoortweg,2022-11-03,08:00:00,146,18,128,FMN 08 Schijnpoortweg
675,Schijnpoortweg,2022-11-03,09:00:00,100,15,85,FMN 08 Schijnpoortweg
675,Schijnpoortweg,2022-11-03,10:00:00,97,11,86,FMN 08 Schijnpoortweg
675,Schijnpoortweg,2022-11-03,11:00:00,122,12,110,FMN 08 Schijnpoortweg
675,Schijnpoortweg,2022-11-03,12:00:00,141,26,115,FMN 08 Schijnpoortweg
675,Schijnpoortweg,2022-11-03,13:00:00,113,16,97,FMN 08 Schijnpoortweg
675,Schijnpoortweg,2022-11-03,14:00:00,169,20,149,FMN 08 Schijnpoortweg
675,Schijnpoortweg,2022-11-03,15:00:00,180,21,159,FMN 08 Schijnpoortweg
675,Schijnpoortweg,2022-11-03,16:00:00,252,17,235,FMN 08 Schijnpoortweg
675,Schijnpoortweg,2022-11-03,17:00:00,269,27,242,FMN 08 Schijnpoortweg
675,Schijnpoortweg,2022-11-03,18:00:00,195,24,171,FMN 08 Schijnpoortweg
675,Schijnpoortweg,2022-11-03,19:00:00,362,44,318,FMN 08 Schijnpoortweg
675,Schijnpoortweg,2022-11-03,20:00:00,513,46,467,FMN 08 Schijnpoortweg
675,Schijnpoortweg,2022-11-03,21:00:00,100,11,89,FMN 08 Schijnpoortweg
675,Schijnpoortweg,2022-11-03,22:00:00,82,26,56,FMN 08 Schijnpoortweg
675,Schijnpoortweg,2022-11-03,23:00:00,402,318,84,FMN 08 Schijnpoortweg
675,Schijnpoortweg,2022-11-04,00:00:00,44,9,35,FMN 08 Schijnpoortweg
675,Schijnpoortweg,2022-11-04,01:00:00,29,5,24,FMN 08 Schijnpoortweg
675,Schijnpoortweg,2022-11-04,02:00:00,19,8,11,FMN 08 Schijnpoortweg
675,Schijnpoortweg,2022-11-04,03:00:00,23,5,18,FMN 08 Schijnpoortweg
675,Schijnpoortweg,2022-11-04,04:00:00,34,14,20,FMN 08 Schijnpoortweg
675,Schijnpoortweg,2022-11-04,05:00:00,68,7,61,FMN 08 Schijnpoortweg
675,Schijnpoortweg,2022-11-04,06:00:00,79,17,62,FMN 08 Schijnpoortweg
675,Schijnpoortweg,2022-11-04,07:00:00,152,16,136,FMN 08 Schijnpoortweg
675,Schijnpoortweg,2022-11-04,08:00:00,104,18,86,FMN 08 Schijnpoortweg
675,Schijnpoortweg,2022-11-04,09:00:00,97,17,80,FMN 08 Schijnpoortweg
675,Schijnpoortweg,2022-11-04,10:00:00,103,25,78,FMN 08 Schijnpoortweg
675,Schijnpoortweg,2022-11-04,11:00:00,93,14,79,FMN 08 Schijnpoortweg
675,Schijnpoortweg,2022-11-04,12:00:00,117,19,98,FMN 08 Schijnpoortweg
675,Schijnpoortweg,2022-11-04,13:00:00,140,32,108,FMN 08 Schijnpoortweg
675,Schijnpoortweg,2022-11-04,14:00:00,202,20,182,FMN 08 Schijnpoortweg
675,Schijnpoortweg,2022-11-04,15:00:00,215,25,190,FMN 08 Schijnpoortweg
675,Schijnpoortweg,2022-11-04,16:00:00,228,30,198,FMN 08 Schijnpoortweg
675,Schijnpoortweg,2022-11-04,17:00:00,256,32,224,FMN 08 Schijnpoortweg
675,Schijnpoortweg,2022-11-04,18:00:00,231,53,178,FMN 08 Schijnpoortweg
675,Schijnpoortweg,2022-11-04,19:00:00,213,46,167,FMN 08 Schijnpoortweg
675,Schijnpoortweg,2022-11-04,20:00:00,141,16,125,FMN 08 Schijnpoortweg
675,Schijnpoortweg,2022-11-04,21:00:00,154,51,103,FMN 08 Schijnpoortweg
675,Schijnpoortweg,2022-11-04,22:00:00,119,21,98,FMN 08 Schijnpoortweg
675,Schijnpoortweg,2022-11-04,23:00:00,86,14,72,FMN 08 Schijnpoortweg
675,Schijnpoortweg,2022-11-05,00:00:00,68,14,54,FMN 08 Schijnpoortweg
675,Schijnpoortweg,2022-11-05,01:00:00,44,7,37,FMN 08 Schijnpoortweg
675,Schijnpoortweg,2022-11-05,02:00:00,38,3,35,FMN 08 Schijnpoortweg
675,Schijnpoortweg,2022-11-05,03:00:00,16,6,10,FMN 08 Schijnpoortweg
675,Schijnpoortweg,2022-11-05,04:00:00,31,9,22,FMN 08 Schijnpoortweg
675,Schijnpoortweg,2022-11-05,05:00:00,21,3,18,FMN 08 Schijnpoortweg
675,Schijnpoortweg,2022-11-05,06:00:00,30,4,26,FMN 08 Schijnpoortweg
675,Schijnpoortweg,2022-11-05,07:00:00,49,8,41,FMN 08 Schijnpoortweg
675,Schijnpoortweg,2022-11-05,08:00:00,56,15,41,FMN 08 Schijnpoortweg
675,Schijnpoortweg,2022-11-05,09:00:00,79,16,63,FMN 08 Schijnpoortweg
675,Schijnpoortweg,2022-11-05,10:00:00,86,18,68,FMN 08 Schijnpoortweg
675,Schijnpoortweg,2022-11-05,11:00:00,131,25,106,FMN 08 Schijnpoortweg
675,Schijnpoortweg,2022-11-05,12:00:00,159,42,117,FMN 08 Schijnpoortweg
675,Schijnpoortweg,2022-11-05,13:00:00,222,42,180,FMN 08 Schijnpoortweg
675,Schijnpoortweg,2022-11-05,14:00:00,128,21,107,FMN 08 Schijnpoortweg
675,Schijnpoortweg,2022-11-05,15:00:00,216,91,125,FMN 08 Schijnpoortweg
675,Schijnpoortweg,2022-11-05,16:00:00,196,43,153,FMN 08 Schijnpoortweg
675,Schijnpoortweg,2022-11-05,17:00:00,193,43,150,FMN 08 Schijnpoortweg
675,Schijnpoortweg,2022-11-05,18:00:00,166,27,139,FMN 08 Schijnpoortweg
675,Schijnpoortweg,2022-11-05,19:00:00,148,59,89,FMN 08 Schijnpoortweg
675,Schijnpoortweg,2022-11-05,20:00:00,96,10,86,FMN 08 Schijnpoortweg
675,Schijnpoortweg,2022-11-05,21:00:00,68,6,62,FMN 08 Schijnpoortweg
675,Schijnpoortweg,2022-11-05,22:00:00,76,14,62,FMN 08 Schijnpoortweg
675,Schijnpoortweg,2022-11-05,23:00:00,84,9,75,FMN 08 Schijnpoortweg
675,Schijnpoortweg,2022-11-06,00:00:00,56,7,49,FMN 08 Schijnpoortweg
675,Schijnpoortweg,2022-11-06,01:00:00,47,3,44,FMN 08 Schijnpoortweg
675,Schijnpoortweg,2022-11-06,02:00:00,29,4,25,FMN 08 Schijnpoortweg
675,Schijnpoortweg,2022-11-06,03:00:00,28,7,21,FMN 08 Schijnpoortweg
675,Schijnpoortweg,2022-11-06,04:00:00,24,3,21,FMN 08 Schijnpoortweg
675,Schijnpoortweg,2022-11-06,05:00:00,15,3,12,FMN 08 Schijnpoortweg
675,Schijnpoortweg,2022-11-06,06:00:00,17,2,15,FMN 08 Schijnpoortweg
675,Schijnpoortweg,2022-11-06,07:00:00,20,1,19,FMN 08 Schijnpoortweg
675,Schijnpoortweg,2022-11-06,08:00:00,42,4,38,FMN 08 Schijnpoortweg
675,Schijnpoortweg,2022-11-06,09:00:00,90,18,72,FMN 08 Schijnpoortweg
675,Schijnpoortweg,2022-11-06,10:00:00,109,19,90,FMN 08 Schijnpoortweg
675,Schijnpoortweg,2022-11-06,11:00:00,96,17,79,FMN 08 Schijnpoortweg
675,Schijnpoortweg,2022-11-06,12:00:00,139,47,92,FMN 08 Schijnpoortweg
675,Schijnpoortweg,2022-11-06,13:00:00,159,37,122,FMN 08 Schijnpoortweg
675,Schijnpoortweg,2022-11-06,14:00:00,74,9,65,FMN 08 Schijnpoortweg
675,Schijnpoortweg,2022-11-06,15:00:00,95,42,53,FMN 08 Schijnpoortweg
675,Schijnpoortweg,2022-11-06,16:00:00,94,12,82,FMN 08 Schijnpoortweg
675,Schijnpoortweg,2022-11-06,17:00:00,118,14,104,FMN 08 Schijnpoortweg
675,Schijnpoortweg,2022-11-06,18:00:00,101,20,81,FMN 08 Schijnpoortweg
675,Schijnpoortweg,2022-11-06,19:00:00,90,13,77,FMN 08 Schijnpoortweg
675,Schijnpoortweg,2022-11-06,20:00:00,91,28,63,FMN 08 Schijnpoortweg
675,Schijnpoortweg,2022-11-06,21:00:00,64,14,50,FMN 08 Schijnpoortweg
675,Schijnpoortweg,2022-11-06,22:00:00,64,9,55,FMN 08 Schijnpoortweg
675,Schijnpoortweg,2022-11-06,23:00:00,47,8,39,FMN 08 Schijnpoortweg
675,Schijnpoortweg,2022-11-07,00:00:00,25,5,20,FMN 08 Schijnpoortweg
675,Schijnpoortweg,2022-11-07,01:00:00,25,7,18,FMN 08 Schijnpoortweg
675,Schijnpoortweg,2022-11-07,02:00:00,19,4,15,FMN 08 Schijnpoortweg
675,Schijnpoortweg,2022-11-07,03:00:00,10,2,8,FMN 08 Schijnpoortweg
675,Schijnpoortweg,2022-11-07,04:00:00,29,13,16,FMN 08 Schijnpoortweg
675,Schijnpoortweg,2022-11-07,05:00:00,70,6,64,FMN 08 Schijnpoortweg
675,Schijnpoortweg,2022-11-07,06:00:00,91,13,78,FMN 08 Schijnpoortweg
675,Schijnpoortweg,2022-11-07,07:00:00,185,29,156,FMN 08 Schijnpoortweg
675,Schijnpoortweg,2022-11-07,08:00:00,228,49,179,FMN 08 Schijnpoortweg
675,Schijnpoortweg,2022-11-07,09:00:00,124,22,102,FMN 08 Schijnpoortweg
675,Schijnpoortweg,2022-11-07,10:00:00,86,13,73,FMN 08 Schijnpoortweg
675,Schijnpoortweg,2022-11-07,11:00:00,106,19,87,FMN 08 Schijnpoortweg
675,Schijnpoortweg,2022-11-07,12:00:00,141,21,120,FMN 08 Schijnpoortweg
675,Schijnpoortweg,2022-11-07,13:00:00,147,20,127,FMN 08 Schijnpoortweg
675,Schijnpoortweg,2022-11-07,14:00:00,121,19,102,FMN 08 Schijnpoortweg
675,Schijnpoortweg,2022-11-07,15:00:00,249,21,228,FMN 08 Schijnpoortweg
675,Schijnpoortweg,2022-11-07,16:00:00,333,41,292,FMN 08 Schijnpoortweg
675,Schijnpoortweg,2022-11-07,17:00:00,339,22,317,FMN 08 Schijnpoortweg
675,Schijnpoortweg,2022-11-07,18:00:00,205,20,185,FMN 08 Schijnpoortweg
675,Schijnpoortweg,2022-11-07,19:00:00,170,16,154,FMN 08 Schijnpoortweg
675,Schijnpoortweg,2022-11-07,20:00:00,115,16,99,FMN 08 Schijnpoortweg
675,Schijnpoortweg,2022-11-07,21:00:00,137,20,117,FMN 08 Schijnpoortweg
675,Schijnpoortweg,2022-11-07,22:00:00,87,16,71,FMN 08 Schijnpoortweg
675,Schijnpoortweg,2022-11-07,23:00:00,69,11,58,FMN 08 Schijnpoortweg
675,Schijnpoortweg,2022-11-08,00:00:00,38,10,28,FMN 08 Schijnpoortweg
675,Schijnpoortweg,2022-11-08,01:00:00,22,4,18,FMN 08 Schijnpoortweg
675,Schijnpoortweg,2022-11-08,02:00:00,11,2,9,FMN 08 Schijnpoortweg
675,Schijnpoortweg,2022-11-08,03:00:00,15,3,12,FMN 08 Schijnpoortweg
675,Schijnpoortweg,2022-11-08,04:00:00,32,8,24,FMN 08 Schijnpoortweg
675,Schijnpoortweg,2022-11-08,05:00:00,60,6,54,FMN 08 Schijnpoortweg
675,Schijnpoortweg,2022-11-08,06:00:00,104,16,88,FMN 08 Schijnpoortweg
675,Schijnpoortweg,2022-11-08,07:00:00,234,42,192,FMN 08 Schijnpoortweg
675,Schijnpoortweg,2022-11-08,08:00:00,240,45,195,FMN 08 Schijnpoortweg
675,Schijnpoortweg,2022-11-08,09:00:00,138,10,128,FMN 08 Schijnpoortweg
675,Schijnpoortweg,2022-11-08,10:00:00,100,12,88,FMN 08 Schijnpoortweg
675,Schijnpoortweg,2022-11-08,11:00:00,115,10,105,FMN 08 Schijnpoortweg
675,Schijnpoortweg,2022-11-08,12:00:00,160,17,143,FMN 08 Schijnpoortweg
675,Schijnpoortweg,2022-11-08,13:00:00,146,12,134,FMN 08 Schijnpoortweg
675,Schijnpoortweg,2022-11-08,14:00:00,171,21,150,FMN 08 Schijnpoortweg
675,Schijnpoortweg,2022-11-08,15:00:00,294,29,265,FMN 08 Schijnpoortweg
675,Schijnpoortweg,2022-11-08,16:00:00,422,35,387,FMN 08 Schijnpoortweg
675,Schijnpoortweg,2022-11-08,17:00:00,415,46,369,FMN 08 Schijnpoortweg
675,Schijnpoortweg,2022-11-08,18:00:00,272,27,245,FMN 08 Schijnpoortweg
675,Schijnpoortweg,2022-11-08,19:00:00,274,34,240,FMN 08 Schijnpoortweg
675,Schijnpoortweg,2022-11-08,20:00:00,214,22,192,FMN 08 Schijnpoortweg
675,Schijnpoortweg,2022-11-08,21:00:00,133,22,111,FMN 08 Schijnpoortweg
675,Schijnpoortweg,2022-11-08,22:00:00,169,85,84,FMN 08 Schijnpoortweg
675,Schijnpoortweg,2022-11-08,23:00:00,127,41,86,FMN 08 Schijnpoortweg
675,Schijnpoortweg,2022-11-09,00:00:00,37,6,31,FMN 08 Schijnpoortweg
675,Schijnpoortweg,2022-11-09,01:00:00,21,3,18,FMN 08 Schijnpoortweg
675,Schijnpoortweg,2022-11-09,02:00:00,18,5,13,FMN 08 Schijnpoortweg
675,Schijnpoortweg,2022-11-09,03:00:00,9,0,9,FMN 08 Schijnpoortweg
675,Schijnpoortweg,2022-11-09,04:00:00,24,4,20,FMN 08 Schijnpoortweg
675,Schijnpoortweg,2022-11-09,05:00:00,65,14,51,FMN 08 Schijnpoortweg
675,Schijnpoortweg,2022-11-09,06:00:00,107,13,94,FMN 08 Schijnpoortweg
675,Schijnpoortweg,2022-11-09,07:00:00,230,30,200,FMN 08 Schijnpoortweg
675,Schijnpoortweg,2022-11-09,08:00:00,285,42,243,FMN 08 Schijnpoortweg
675,Schijnpoortweg,2022-11-09,09:00:00,156,19,137,FMN 08 Schijnpoortweg
675,Schijnpoortweg,2022-11-09,10:00:00,126,20,106,FMN 08 Schijnpoortweg
675,Schijnpoortweg,2022-11-09,11:00:00,194,29,165,FMN 08 Schijnpoortweg
675,Schijnpoortweg,2022-11-09,12:00:00,264,27,237,FMN 08 Schijnpoortweg
675,Schijnpoortweg,2022-11-09,13:00:00,229,29,200,FMN 08 Schijnpoortweg
675,Schijnpoortweg,2022-11-09,14:00:00,197,29,168,FMN 08 Schijnpoortweg
675,Schijnpoortweg,2022-11-09,15:00:00,252,23,229,FMN 08 Schijnpoortweg
675,Schijnpoortweg,2022-11-09,16:00:00,350,36,314,FMN 08 Schijnpoortweg
675,Schijnpoortweg,2022-11-09,17:00:00,366,37,329,FMN 08 Schijnpoortweg
675,Schijnpoortweg,2022-11-09,18:00:00,279,34,245,FMN 08 Schijnpoortweg
675,Schijnpoortweg,2022-11-09,19:00:00,302,24,278,FMN 08 Schijnpoortweg
675,Schijnpoortweg,2022-11-09,20:00:00,167,21,146,FMN 08 Schijnpoortweg
675,Schijnpoortweg,2022-11-09,21:00:00,126,27,99,FMN 08 Schijnpoortweg
675,Schijnpoortweg,2022-11-09,22:00:00,174,75,99,FMN 08 Schijnpoortweg
675,Schijnpoortweg,2022-11-09,23:00:00,75,6,69,FMN 08 Schijnpoortweg
675,Schijnpoortweg,2022-11-10,00:00:00,38,3,35,FMN 08 Schijnpoortweg
675,Schijnpoortweg,2022-11-10,01:00:00,20,1,19,FMN 08 Schijnpoortweg
675,Schijnpoortweg,2022-11-10,02:00:00,11,4,7,FMN 08 Schijnpoortweg
675,Schijnpoortweg,2022-11-10,03:00:00,15,3,12,FMN 08 Schijnpoortweg
675,Schijnpoortweg,2022-11-10,04:00:00,26,8,18,FMN 08 Schijnpoortweg
675,Schijnpoortweg,2022-11-10,05:00:00,72,7,65,FMN 08 Schijnpoortweg
675,Schijnpoortweg,2022-11-10,06:00:00,95,19,76,FMN 08 Schijnpoortweg
675,Schijnpoortweg,2022-11-10,07:00:00,205,19,186,FMN 08 Schijnpoortweg
675,Schijnpoortweg,2022-11-10,08:00:00,289,48,241,FMN 08 Schijnpoortweg
675,Schijnpoortweg,2022-11-10,09:00:00,131,20,111,FMN 08 Schijnpoortweg
675,Schijnpoortweg,2022-11-10,10:00:00,122,19,103,FMN 08 Schijnpoortweg
675,Schijnpoortweg,2022-11-10,11:00:00,125,9,116,FMN 08 Schijnpoortweg
675,Schijnpoortweg,2022-11-10,12:00:00,169,24,145,FMN 08 Schijnpoortweg
675,Schijnpoortweg,2022-11-10,13:00:00,165,27,138,FMN 08 Schijnpoortweg
675,Schijnpoortweg,2022-11-10,14:00:00,177,19,158,FMN 08 Schijnpoortweg
675,Schijnpoortweg,2022-11-10,15:00:00,299,29,270,FMN 08 Schijnpoortweg
675,Schijnpoortweg,2022-11-10,16:00:00,370,45,325,FMN 08 Schijnpoortweg
675,Schijnpoortweg,2022-11-10,17:00:00,408,53,355,FMN 08 Schijnpoortweg
675,Schijnpoortweg,2022-11-10,18:00:00,318,73,245,FMN 08 Schijnpoortweg
675,Schijnpoortweg,2022-11-10,19:00:00,291,72,219,FMN 08 Schijnpoortweg
675,Schijnpoortweg,2022-11-10,20:00:00,199,41,158,FMN 08 Schijnpoortweg
675,Schijnpoortweg,2022-11-10,21:00:00,124,15,109,FMN 08 Schijnpoortweg
675,Schijnpoortweg,2022-11-10,22:00:00,128,21,107,FMN 08 Schijnpoortweg
675,Schijnpoortweg,2022-11-10,23:00:00,214,129,85,FMN 08 Schijnpoortweg
675,Schijnpoortweg,2022-11-11,00:00:00,75,10,65,FMN 08 Schijnpoortweg
675,Schijnpoortweg,2022-11-11,01:00:00,39,4,35,FMN 08 Schijnpoortweg
675,Schijnpoortweg,2022-11-11,02:00:00,24,2,22,FMN 08 Schijnpoortweg
675,Schijnpoortweg,2022-11-11,03:00:00,30,4,26,FMN 08 Schijnpoortweg
675,Schijnpoortweg,2022-11-11,04:00:00,23,0,23,FMN 08 Schijnpoortweg
675,Schijnpoortweg,2022-11-11,05:00:00,28,4,24,FMN 08 Schijnpoortweg
675,Schijnpoortweg,2022-11-11,06:00:00,39,11,28,FMN 08 Schijnpoortweg
675,Schijnpoortweg,2022-11-11,07:00:00,52,4,48,FMN 08 Schijnpoortweg
675,Schijnpoortweg,2022-11-11,08:00:00,52,10,42,FMN 08 Schijnpoortweg
675,Schijnpoortweg,2022-11-11,09:00:00,76,14,62,FMN 08 Schijnpoortweg
675,Schijnpoortweg,2022-11-11,10:00:00,99,18,81,FMN 08 Schijnpoortweg
675,Schijnpoortweg,2022-11-11,11:00:00,110,14,96,FMN 08 Schijnpoortweg
675,Schijnpoortweg,2022-11-11,12:00:00,119,26,93,FMN 08 Schijnpoortweg
675,Schijnpoortweg,2022-11-11,13:00:00,138,24,114,FMN 08 Schijnpoortweg
675,Schijnpoortweg,2022-11-11,14:00:00,177,32,145,FMN 08 Schijnpoortweg
675,Schijnpoortweg,2022-11-11,15:00:00,203,14,189,FMN 08 Schijnpoortweg
675,Schijnpoortweg,2022-11-11,16:00:00,171,24,147,FMN 08 Schijnpoortweg
675,Schijnpoortweg,2022-11-11,17:00:00,204,28,176,FMN 08 Schijnpoortweg
675,Schijnpoortweg,2022-11-11,18:00:00,146,28,118,FMN 08 Schijnpoortweg
675,Schijnpoortweg,2022-11-11,19:00:00,142,14,128,FMN 08 Schijnpoortweg
675,Schijnpoortweg,2022-11-11,20:00:00,99,20,79,FMN 08 Schijnpoortweg
675,Schijnpoortweg,2022-11-11,21:00:00,96,10,86,FMN 08 Schijnpoortweg
675,Schijnpoortweg,2022-11-11,22:00:00,94,12,82,FMN 08 Schijnpoortweg
675,Schijnpoortweg,2022-11-11,23:00:00,91,13,78,FMN 08 Schijnpoortweg
675,Schijnpoortweg,2022-11-12,00:00:00,51,8,43,FMN 08 Schijnpoortweg
675,Schijnpoortweg,2022-11-12,01:00:00,35,5,30,FMN 08 Schijnpoortweg
675,Schijnpoortweg,2022-11-12,02:00:00,37,9,28,FMN 08 Schijnpoortweg
675,Schijnpoortweg,2022-11-12,03:00:00,18,2,16,FMN 08 Schijnpoortweg
675,Schijnpoortweg,2022-11-12,04:00:00,15,4,11,FMN 08 Schijnpoortweg
675,Schijnpoortweg,2022-11-12,05:00:00,26,7,19,FMN 08 Schijnpoortweg
675,Schijnpoortweg,2022-11-12,06:00:00,27,7,20,FMN 08 Schijnpoortweg
675,Schijnpoortweg,2022-11-12,07:00:00,39,8,31,FMN 08 Schijnpoortweg
675,Schijnpoortweg,2022-11-12,08:00:00,59,2,57,FMN 08 Schijnpoortweg
675,Schijnpoortweg,2022-11-12,09:00:00,90,12,78,FMN 08 Schijnpoortweg
675,Schijnpoortweg,2022-11-12,10:00:00,99,16,83,FMN 08 Schijnpoortweg
675,Schijnpoortweg,2022-11-12,11:00:00,122,26,96,FMN 08 Schijnpoortweg
675,Schijnpoortweg,2022-11-12,12:00:00,132,31,101,FMN 08 Schijnpoortweg
675,Schijnpoortweg,2022-11-12,13:00:00,147,17,130,FMN 08 Schijnpoortweg
675,Schijnpoortweg,2022-11-12,14:00:00,149,25,124,FMN 08 Schijnpoortweg
675,Schijnpoortweg,2022-11-12,15:00:00,185,18,167,FMN 08 Schijnpoortweg
675,Schijnpoortweg,2022-11-12,16:00:00,197,37,160,FMN 08 Schijnpoortweg
675,Schijnpoortweg,2022-11-12,17:00:00,255,43,212,FMN 08 Schijnpoortweg
675,Schijnpoortweg,2022-11-12,18:00:00,265,51,214,FMN 08 Schijnpoortweg
675,Schijnpoortweg,2022-11-12,19:00:00,361,65,296,FMN 08 Schijnpoortweg
675,Schijnpoortweg,2022-11-12,20:00:00,313,54,259,FMN 08 Schijnpoortweg
675,Schijnpoortweg,2022-11-12,21:00:00,124,26,98,FMN 08 Schijnpoortweg
675,Schijnpoortweg,2022-11-12,22:00:00,143,51,92,FMN 08 Schijnpoortweg
675,Schijnpoortweg,2022-11-12,23:00:00,275,186,89,FMN 08 Schijnpoortweg
675,Schijnpoortweg,2022-11-13,00:00:00,72,23,49,FMN 08 Schijnpoortweg
675,Schijnpoortweg,2022-11-13,01:00:00,46,10,36,FMN 08 Schijnpoortweg
675,Schijnpoortweg,2022-11-13,02:00:00,28,8,20,FMN 08 Schijnpoortweg
675,Schijnpoortweg,2022-11-13,03:00:00,30,6,24,FMN 08 Schijnpoortweg
675,Schijnpoortweg,2022-11-13,04:00:00,21,1,20,FMN 08 Schijnpoortweg
675,Schijnpoortweg,2022-11-13,05:00:00,19,4,15,FMN 08 Schijnpoortweg
675,Schijnpoortweg,2022-11-13,06:00:00,21,6,15,FMN 08 Schijnpoortweg
675,Schijnpoortweg,2022-11-13,07:00:00,23,1,22,FMN 08 Schijnpoortweg
675,Schijnpoortweg,2022-11-13,08:00:00,39,6,33,FMN 08 Schijnpoortweg
675,Schijnpoortweg,2022-11-13,09:00:00,68,14,54,FMN 08 Schijnpoortweg
675,Schijnpoortweg,2022-11-13,10:00:00,95,14,81,FMN 08 Schijnpoortweg
675,Schijnpoortweg,2022-11-13,11:00:00,108,23,85,FMN 08 Schijnpoortweg
675,Schijnpoortweg,2022-11-13,12:00:00,115,18,97,FMN 08 Schijnpoortweg
675,Schijnpoortweg,2022-11-13,13:00:00,170,20,150,FMN 08 Schijnpoortweg
675,Schijnpoortweg,2022-11-13,14:00:00,137,21,116,FMN 08 Schijnpoortweg
675,Schijnpoortweg,2022-11-13,15:00:00,142,13,129,FMN 08 Schijnpoortweg
675,Schijnpoortweg,2022-11-13,16:00:00,170,26,144,FMN 08 Schijnpoortweg
675,Schijnpoortweg,2022-11-13,17:00:00,155,31,124,FMN 08 Schijnpoortweg
675,Schijnpoortweg,2022-11-13,18:00:00,104,18,86,FMN 08 Schijnpoortweg
675,Schijnpoortweg,2022-11-13,19:00:00,115,18,97,FMN 08 Schijnpoortweg
675,Schijnpoortweg,2022-11-13,20:00:00,101,17,84,FMN 08 Schijnpoortweg
675,Schijnpoortweg,2022-11-13,21:00:00,88,14,74,FMN 08 Schijnpoortweg
675,Schijnpoortweg,2022-11-13,22:00:00,74,8,66,FMN 08 Schijnpoortweg
675,Schijnpoortweg,2022-11-13,23:00:00,55,6,49,FMN 08 Schijnpoortweg
675,Schijnpoortweg,2022-11-14,00:00:00,27,1,26,FMN 08 Schijnpoortweg
675,Schijnpoortweg,2022-11-14,01:00:00,16,3,13,FMN 08 Schijnpoortweg
675,Schijnpoortweg,2022-11-14,02:00:00,13,5,8,FMN 08 Schijnpoortweg
675,Schijnpoortweg,2022-11-14,03:00:00,10,3,7,FMN 08 Schijnpoortweg
675,Schijnpoortweg,2022-11-14,04:00:00,20,11,9,FMN 08 Schijnpoortweg
675,Schijnpoortweg,2022-11-14,05:00:00,69,9,60,FMN 08 Schijnpoortweg
675,Schijnpoortweg,2022-11-14,06:00:00,103,17,86,FMN 08 Schijnpoortweg
675,Schijnpoortweg,2022-11-14,07:00:00,191,18,173,FMN 08 Schijnpoortweg
675,Schijnpoortweg,2022-11-14,08:00:00,233,43,190,FMN 08 Schijnpoortweg
675,Schijnpoortweg,2022-11-14,09:00:00,122,18,104,FMN 08 Schijnpoortweg
675,Schijnpoortweg,2022-11-14,10:00:00,78,11,67,FMN 08 Schijnpoortweg
675,Schijnpoortweg,2022-11-14,11:00:00,116,12,104,FMN 08 Schijnpoortweg
675,Schijnpoortweg,2022-11-14,12:00:00,164,16,148,FMN 08 Schijnpoortweg
675,Schijnpoortweg,2022-11-14,13:00:00,158,15,143,FMN 08 Schijnpoortweg
675,Schijnpoortweg,2022-11-14,14:00:00,167,9,158,FMN 08 Schijnpoortweg
675,Schijnpoortweg,2022-11-14,15:00:00,287,17,270,FMN 08 Schijnpoortweg
675,Schijnpoortweg,2022-11-14,16:00:00,430,40,390,FMN 08 Schijnpoortweg
675,Schijnpoortweg,2022-11-14,17:00:00,340,33,307,FMN 08 Schijnpoortweg
675,Schijnpoortweg,2022-11-14,18:00:00,229,24,205,FMN 08 Schijnpoortweg
675,Schijnpoortweg,2022-11-14,19:00:00,154,13,141,FMN 08 Schijnpoortweg
675,Schijnpoortweg,2022-11-14,20:00:00,123,15,108,FMN 08 Schijnpoortweg
675,Schijnpoortweg,2022-11-14,21:00:00,101,12,89,FMN 08 Schijnpoortweg
675,Schijnpoortweg,2022-11-14,22:00:00,95,15,80,FMN 08 Schijnpoortweg
675,Schijnpoortweg,2022-11-14,23:00:00,44,5,39,FMN 08 Schijnpoortweg
675,Schijnpoortweg,2022-11-15,00:00:00,36,7,29,FMN 08 Schijnpoortweg
675,Schijnpoortweg,2022-11-15,01:00:00,22,2,20,FMN 08 Schijnpoortweg
675,Schijnpoortweg,2022-11-15,02:00:00,14,2,12,FMN 08 Schijnpoortweg
675,Schijnpoortweg,2022-11-15,03:00:00,9,4,5,FMN 08 Schijnpoortweg
675,Schijnpoortweg,2022-11-15,04:00:00,28,12,16,FMN 08 Schijnpoortweg
675,Schijnpoortweg,2022-11-15,05:00:00,76,12,64,FMN 08 Schijnpoortweg
675,Schijnpoortweg,2022-11-15,06:00:00,106,13,93,FMN 08 Schijnpoortweg
675,Schijnpoortweg,2022-11-15,07:00:00,199,26,173,FMN 08 Schijnpoortweg
675,Schijnpoortweg,2022-11-15,08:00:00,253,45,208,FMN 08 Schijnpoortweg
675,Schijnpoortweg,2022-11-15,09:00:00,114,10,104,FMN 08 Schijnpoortweg
675,Schijnpoortweg,2022-11-15,10:00:00,116,22,94,FMN 08 Schijnpoortweg
675,Schijnpoortweg,2022-11-15,11:00:00,95,14,81,FMN 08 Schijnpoortweg
675,Schijnpoortweg,2022-11-15,12:00:00,172,17,155,FMN 08 Schijnpoortweg
675,Schijnpoortweg,2022-11-15,13:00:00,134,10,124,FMN 08 Schijnpoortweg
675,Schijnpoortweg,2022-11-15,14:00:00,169,13,156,FMN 08 Schijnpoortweg
675,Schijnpoortweg,2022-11-15,15:00:00,264,27,237,FMN 08 Schijnpoortweg
675,Schijnpoortweg,2022-11-15,16:00:00,331,15,316,FMN 08 Schijnpoortweg
675,Schijnpoortweg,2022-11-15,17:00:00,305,25,280,FMN 08 Schijnpoortweg
675,Schijnpoortweg,2022-11-15,18:00:00,224,24,200,FMN 08 Schijnpoortweg
675,Schijnpoortweg,2022-11-15,19:00:00,120,14,106,FMN 08 Schijnpoortweg
675,Schijnpoortweg,2022-11-15,20:00:00,96,9,87,FMN 08 Schijnpoortweg
675,Schijnpoortweg,2022-11-15,21:00:00,97,11,86,FMN 08 Schijnpoortweg
675,Schijnpoortweg,2022-11-15,22:00:00,93,17,76,FMN 08 Schijnpoortweg
675,Schijnpoortweg,2022-11-15,23:00:00,65,7,58,FMN 08 Schijnpoortweg
675,Schijnpoortweg,2022-11-16,00:00:00,29,9,20,FMN 08 Schijnpoortweg
675,Schijnpoortweg,2022-11-16,01:00:00,19,0,19,FMN 08 Schijnpoortweg
675,Schijnpoortweg,2022-11-16,02:00:00,19,1,18,FMN 08 Schijnpoortweg
675,Schijnpoortweg,2022-11-16,03:00:00,10,4,6,FMN 08 Schijnpoortweg
675,Schijnpoortweg,2022-11-16,04:00:00,39,17,22,FMN 08 Schijnpoortweg
675,Schijnpoortweg,2022-11-16,05:00:00,75,14,61,FMN 08 Schijnpoortweg
675,Schijnpoortweg,2022-11-16,06:00:00,104,15,89,FMN 08 Schijnpoortweg
675,Schijnpoortweg,2022-11-16,07:00:00,185,22,163,FMN 08 Schijnpoortweg
675,Schijnpoortweg,2022-11-16,08:00:00,256,45,211,FMN 08 Schijnpoortweg
675,Schijnpoortweg,2022-11-16,09:00:00,132,24,108,FMN 08 Schijnpoortweg
675,Schijnpoortweg,2022-11-16,10:00:00,106,19,87,FMN 08 Schijnpoortweg
675,Schijnpoortweg,2022-11-16,11:00:00,123,16,107,FMN 08 Schijnpoortweg
675,Schijnpoortweg,2022-11-16,12:00:00,252,27,225,FMN 08 Schijnpoortweg
675,Schijnpoortweg,2022-11-16,13:00:00,210,15,195,FMN 08 Schijnpoortweg
675,Schijnpoortweg,2022-11-16,14:00:00,150,15,135,FMN 08 Schijnpoortweg
675,Schijnpoortweg,2022-11-16,15:00:00,216,22,194,FMN 08 Schijnpoortweg
675,Schijnpoortweg,2022-11-16,16:00:00,322,41,281,FMN 08 Schijnpoortweg
675,Schijnpoortweg,2022-11-16,17:00:00,314,22,292,FMN 08 Schijnpoortweg
675,Schijnpoortweg,2022-11-16,18:00:00,225,30,195,FMN 08 Schijnpoortweg
675,Schijnpoortweg,2022-11-16,19:00:00,145,17,128,FMN 08 Schijnpoortweg
675,Schijnpoortweg,2022-11-16,20:00:00,141,16,125,FMN 08 Schijnpoortweg
675,Schijnpoortweg,2022-11-16,21:00:00,92,8,84,FMN 08 Schijnpoortweg
675,Schijnpoortweg,2022-11-16,22:00:00,84,11,73,FMN 08 Schijnpoortweg
675,Schijnpoortweg,2022-11-16,23:00:00,57,7,50,FMN 08 Schijnpoortweg
675,Schijnpoortweg,2022-11-17,00:00:00,16,1,15,FMN 08 Schijnpoortweg
675,Schijnpoortweg,2022-11-17,01:00:00,14,4,10,FMN 08 Schijnpoortweg
675,Schijnpoortweg,2022-11-17,02:00:00,20,2,18,FMN 08 Schijnpoortweg
675,Schijnpoortweg,2022-11-17,03:00:00,9,1,8,FMN 08 Schijnpoortweg
675,Schijnpoortweg,2022-11-17,04:00:00,21,4,17,FMN 08 Schijnpoortweg
675,Schijnpoortweg,2022-11-17,05:00:00,61,10,51,FMN 08 Schijnpoortweg
675,Schijnpoortweg,2022-11-17,06:00:00,101,18,83,FMN 08 Schijnpoortweg
675,Schijnpoortweg,2022-11-17,07:00:00,180,20,160,FMN 08 Schijnpoortweg
675,Schijnpoortweg,2022-11-17,08:00:00,216,32,184,FMN 08 Schijnpoortweg
675,Schijnpoortweg,2022-11-17,09:00:00,85,12,73,FMN 08 Schijnpoortweg
675,Schijnpoortweg,2022-11-17,10:00:00,83,11,72,FMN 08 Schijnpoortweg
675,Schijnpoortweg,2022-11-17,11:00:00,86,7,79,FMN 08 Schijnpoortweg
675,Schijnpoortweg,2022-11-17,12:00:00,133,17,116,FMN 08 Schijnpoortweg
675,Schijnpoortweg,2022-11-17,13:00:00,115,5,110,FMN 08 Schijnpoortweg
675,Schijnpoortweg,2022-11-17,14:00:00,116,11,105,FMN 08 Schijnpoortweg
675,Schijnpoortweg,2022-11-17,15:00:00,270,22,248,FMN 08 Schijnpoortweg
675,Schijnpoortweg,2022-11-17,16:00:00,325,30,295,FMN 08 Schijnpoortweg
675,Schijnpoortweg,2022-11-17,17:00:00,332,21,311,FMN 08 Schijnpoortweg
675,Schijnpoortweg,2022-11-17,18:00:00,239,29,210,FMN 08 Schijnpoortweg
675,Schijnpoortweg,2022-11-17,19:00:00,164,10,154,FMN 08 Schijnpoortweg
675,Schijnpoortweg,2022-11-17,20:00:00,132,10,122,FMN 08 Schijnpoortweg
675,Schijnpoortweg,2022-11-17,21:00:00,110,10,100,FMN 08 Schijnpoortweg
675,Schijnpoortweg,2022-11-17,22:00:00,121,26,95,FMN 08 Schijnpoortweg
675,Schijnpoortweg,2022-11-17,23:00:00,75,7,68,FMN 08 Schijnpoortweg
675,Schijnpoortweg,2022-11-18,00:00:00,42,8,34,FMN 08 Schijnpoortweg
675,Schijnpoortweg,2022-11-18,01:00:00,33,6,27,FMN 08 Schijnpoortweg
675,Schijnpoortweg,2022-11-18,02:00:00,15,3,12,FMN 08 Schijnpoortweg
675,Schijnpoortweg,2022-11-18,03:00:00,20,3,17,FMN 08 Schijnpoortweg
675,Schijnpoortweg,2022-11-18,04:00:00,19,6,13,FMN 08 Schijnpoortweg
675,Schijnpoortweg,2022-11-18,05:00:00,67,9,58,FMN 08 Schijnpoortweg
675,Schijnpoortweg,2022-11-18,06:00:00,92,11,81,FMN 08 Schijnpoortweg
675,Schijnpoortweg,2022-11-18,07:00:00,179,25,154,FMN 08 Schijnpoortweg
675,Schijnpoortweg,2022-11-18,08:00:00,216,30,186,FMN 08 Schijnpoortweg
675,Schijnpoortweg,2022-11-18,09:00:00,116,18,98,FMN 08 Schijnpoortweg
675,Schijnpoortweg,2022-11-18,10:00:00,121,19,102,FMN 08 Schijnpoortweg
675,Schijnpoortweg,2022-11-18,11:00:00,92,9,83,FMN 08 Schijnpoortweg
675,Schijnpoortweg,2022-11-18,12:00:00,157,17,140,FMN 08 Schijnpoortweg
675,Schijnpoortweg,2022-11-18,13:00:00,128,6,122,FMN 08 Schijnpoortweg
675,Schijnpoortweg,2022-11-18,14:00:00,175,15,160,FMN 08 Schijnpoortweg
675,Schijnpoortweg,2022-11-18,15:00:00,234,21,213,FMN 08 Schijnpoortweg
675,Schijnpoortweg,2022-11-18,16:00:00,314,29,285,FMN 08 Schijnpoortweg
675,Schijnpoortweg,2022-11-18,17:00:00,251,20,231,FMN 08 Schijnpoortweg
675,Schijnpoortweg,2022-11-18,18:00:00,170,25,145,FMN 08 Schijnpoortweg
675,Schijnpoortweg,2022-11-18,19:00:00,181,40,141,FMN 08 Schijnpoortweg
675,Schijnpoortweg,2022-11-18,20:00:00,146,33,113,FMN 08 Schijnpoortweg
675,Schijnpoortweg,2022-11-18,21:00:00,76,9,67,FMN 08 Schijnpoortweg
675,Schijnpoortweg,2022-11-18,22:00:00,77,18,59,FMN 08 Schijnpoortweg
675,Schijnpoortweg,2022-11-18,23:00:00,115,38,77,FMN 08 Schijnpoortweg
675,Schijnpoortweg,2022-11-19,00:00:00,60,8,52,FMN 08 Schijnpoortweg
675,Schijnpoortweg,2022-11-19,01:00:00,36,2,34,FMN 08 Schijnpoortweg
675,Schijnpoortweg,2022-11-19,02:00:00,15,5,10,FMN 08 Schijnpoortweg
675,Schijnpoortweg,2022-11-19,03:00:00,15,2,13,FMN 08 Schijnpoortweg
675,Schijnpoortweg,2022-11-19,04:00:00,16,5,11,FMN 08 Schijnpoortweg
675,Schijnpoortweg,2022-11-19,05:00:00,22,6,16,FMN 08 Schijnpoortweg
675,Schijnpoortweg,2022-11-19,06:00:00,29,5,24,FMN 08 Schijnpoortweg
675,Schijnpoortweg,2022-11-19,07:00:00,33,4,29,FMN 08 Schijnpoortweg
675,Schijnpoortweg,2022-11-19,08:00:00,49,2,47,FMN 08 Schijnpoortweg
675,Schijnpoortweg,2022-11-19,09:00:00,50,7,43,FMN 08 Schijnpoortweg
675,Schijnpoortweg,2022-11-19,10:00:00,77,10,67,FMN 08 Schijnpoortweg
675,Schijnpoortweg,2022-11-19,11:00:00,93,14,79,FMN 08 Schijnpoortweg
675,Schijnpoortweg,2022-11-19,12:00:00,96,15,81,FMN 08 Schijnpoortweg
675,Schijnpoortweg,2022-11-19,13:00:00,104,11,93,FMN 08 Schijnpoortweg
675,Schijnpoortweg,2022-11-19,14:00:00,112,15,97,FMN 08 Schijnpoortweg
675,Schijnpoortweg,2022-11-19,15:00:00,119,12,107,FMN 08 Schijnpoortweg
675,Schijnpoortweg,2022-11-19,16:00:00,157,10,147,FMN 08 Schijnpoortweg
675,Schijnpoortweg,2022-11-19,17:00:00,164,19,145,FMN 08 Schijnpoortweg
675,Schijnpoortweg,2022-11-19,18:00:00,128,32,96,FMN 08 Schijnpoortweg
675,Schijnpoortweg,2022-11-19,19:00:00,190,54,136,FMN 08 Schijnpoortweg
675,Schijnpoortweg,2022-11-19,20:00:00,104,28,76,FMN 08 Schijnpoortweg
675,Schijnpoortweg,2022-11-19,21:00:00,81,19,62,FMN 08 Schijnpoortweg
675,Schijnpoortweg,2022-11-19,22:00:00,75,11,64,FMN 08 Schijnpoortweg
675,Schijnpoortweg,2022-11-19,23:00:00,140,84,56,FMN 08 Schijnpoortweg
675,Schijnpoortweg,2022-11-20,00:00:00,60,7,53,FMN 08 Schijnpoortweg
675,Schijnpoortweg,2022-11-20,01:00:00,41,10,31,FMN 08 Schijnpoortweg
675,Schijnpoortweg,2022-11-20,02:00:00,31,2,29,FMN 08 Schijnpoortweg
675,Schijnpoortweg,2022-11-20,03:00:00,32,4,28,FMN 08 Schijnpoortweg
675,Schijnpoortweg,2022-11-20,04:00:00,16,1,15,FMN 08 Schijnpoortweg
675,Schijnpoortweg,2022-11-20,05:00:00,20,1,19,FMN 08 Schijnpoortweg
675,Schijnpoortweg,2022-11-20,06:00:00,21,7,14,FMN 08 Schijnpoortweg
675,Schijnpoortweg,2022-11-20,07:00:00,19,3,16,FMN 08 Schijnpoortweg
675,Schijnpoortweg,2022-11-20,08:00:00,35,11,24,FMN 08 Schijnpoortweg
675,Schijnpoortweg,2022-11-20,09:00:00,47,5,42,FMN 08 Schijnpoortweg
675,Schijnpoortweg,2022-11-20,10:00:00,82,15,67,FMN 08 Schijnpoortweg
675,Schijnpoortweg,2022-11-20,11:00:00,88,10,78,FMN 08 Schijnpoortweg
675,Schijnpoortweg,2022-11-20,12:00:00,92,11,81,FMN 08 Schijnpoortweg
675,Schijnpoortweg,2022-11-20,13:00:00,105,15,90,FMN 08 Schijnpoortweg
675,Schijnpoortweg,2022-11-20,14:00:00,71,9,62,FMN 08 Schijnpoortweg
675,Schijnpoortweg,2022-11-20,15:00:00,68,11,57,FMN 08 Schijnpoortweg
675,Schijnpoortweg,2022-11-20,16:00:00,88,18,70,FMN 08 Schijnpoortweg
675,Schijnpoortweg,2022-11-20,17:00:00,130,28,102,FMN 08 Schijnpoortweg
675,Schijnpoortweg,2022-11-20,18:00:00,141,49,92,FMN 08 Schijnpoortweg
675,Schijnpoortweg,2022-11-20,19:00:00,126,22,104,FMN 08 Schijnpoortweg
675,Schijnpoortweg,2022-11-20,20:00:00,93,18,75,FMN 08 Schijnpoortweg
675,Schijnpoortweg,2022-11-20,21:00:00,57,8,49,FMN 08 Schijnpoortweg
675,Schijnpoortweg,2022-11-20,22:00:00,110,45,65,FMN 08 Schijnpoortweg
675,Schijnpoortweg,2022-11-20,23:00:00,46,16,30,FMN 08 Schijnpoortweg
675,Schijnpoortweg,2022-11-21,00:00:00,27,1,26,FMN 08 Schijnpoortweg
675,Schijnpoortweg,2022-11-21,01:00:00,20,4,16,FMN 08 Schijnpoortweg
675,Schijnpoortweg,2022-11-21,02:00:00,15,3,12,FMN 08 Schijnpoortweg
675,Schijnpoortweg,2022-11-21,03:00:00,12,5,7,FMN 08 Schijnpoortweg
675,Schijnpoortweg,2022-11-21,04:00:00,32,14,18,FMN 08 Schijnpoortweg
675,Schijnpoortweg,2022-11-21,05:00:00,60,9,51,FMN 08 Schijnpoortweg
675,Schijnpoortweg,2022-11-21,06:00:00,90,17,73,FMN 08 Schijnpoortweg
675,Schijnpoortweg,2022-11-21,07:00:00,169,17,152,FMN 08 Schijnpoortweg
675,Schijnpoortweg,2022-11-21,08:00:00,234,48,186,FMN 08 Schijnpoortweg
675,Schijnpoortweg,2022-11-21,09:00:00,103,18,85,FMN 08 Schijnpoortweg
675,Schijnpoortweg,2022-11-21,10:00:00,84,10,74,FMN 08 Schijnpoortweg
675,Schijnpoortweg,2022-11-21,11:00:00,100,7,93,FMN 08 Schijnpoortweg
675,Schijnpoortweg,2022-11-21,12:00:00,139,19,120,FMN 08 Schijnpoortweg
675,Schijnpoortweg,2022-11-21,13:00:00,162,14,148,FMN 08 Schijnpoortweg
675,Schijnpoortweg,2022-11-21,14:00:00,145,22,123,FMN 08 Schijnpoortweg
675,Schijnpoortweg,2022-11-21,15:00:00,242,22,220,FMN 08 Schijnpoortweg
675,Schijnpoortweg,2022-11-21,16:00:00,359,22,337,FMN 08 Schijnpoortweg
675,Schijnpoortweg,2022-11-21,17:00:00,317,21,296,FMN 08 Schijnpoortweg
675,Schijnpoortweg,2022-11-21,18:00:00,169,8,161,FMN 08 Schijnpoortweg
675,Schijnpoortweg,2022-11-21,19:00:00,107,10,97,FMN 08 Schijnpoortweg
675,Schijnpoortweg,2022-11-21,20:00:00,90,9,81,FMN 08 Schijnpoortweg
675,Schijnpoortweg,2022-11-21,21:00:00,71,7,64,FMN 08 Schijnpoortweg
675,Schijnpoortweg,2022-11-21,22:00:00,84,18,66,FMN 08 Schijnpoortweg
675,Schijnpoortweg,2022-11-21,23:00:00,42,6,36,FMN 08 Schijnpoortweg
675,Schijnpoortweg,2022-11-22,00:00:00,36,7,29,FMN 08 Schijnpoortweg
675,Schijnpoortweg,2022-11-22,01:00:00,19,8,11,FMN 08 Schijnpoortweg
675,Schijnpoortweg,2022-11-22,02:00:00,19,2,17,FMN 08 Schijnpoortweg
675,Schijnpoortweg,2022-11-22,03:00:00,11,2,9,FMN 08 Schijnpoortweg
675,Schijnpoortweg,2022-11-22,04:00:00,31,18,13,FMN 08 Schijnpoortweg
675,Schijnpoortweg,2022-11-22,05:00:00,61,7,54,FMN 08 Schijnpoortweg
675,Schijnpoortweg,2022-11-22,06:00:00,102,16,86,FMN 08 Schijnpoortweg
675,Schijnpoortweg,2022-11-22,07:00:00,190,20,170,FMN 08 Schijnpoortweg
675,Schijnpoortweg,2022-11-22,08:00:00,235,25,210,FMN 08 Schijnpoortweg
675,Schijnpoortweg,2022-11-22,09:00:00,107,15,92,FMN 08 Schijnpoortweg
675,Schijnpoortweg,2022-11-22,10:00:00,81,14,67,FMN 08 Schijnpoortweg
675,Schijnpoortweg,2022-11-22,11:00:00,101,7,94,FMN 08 Schijnpoortweg
675,Schijnpoortweg,2022-11-22,12:00:00,145,15,130,FMN 08 Schijnpoortweg
675,Schijnpoortweg,2022-11-22,13:00:00,134,11,123,FMN 08 Schijnpoortweg
675,Schijnpoortweg,2022-11-22,14:00:00,140,10,130,FMN 08 Schijnpoortweg
675,Schijnpoortweg,2022-11-22,15:00:00,260,13,247,FMN 08 Schijnpoortweg
675,Schijnpoortweg,2022-11-22,16:00:00,360,32,328,FMN 08 Schijnpoortweg
675,Schijnpoortweg,2022-11-22,17:00:00,323,27,296,FMN 08 Schijnpoortweg
675,Schijnpoortweg,2022-11-22,18:00:00,229,17,212,FMN 08 Schijnpoortweg
675,Schijnpoortweg,2022-11-22,19:00:00,154,17,137,FMN 08 Schijnpoortweg
675,Schijnpoortweg,2022-11-22,20:00:00,116,18,98,FMN 08 Schijnpoortweg
675,Schijnpoortweg,2022-11-22,21:00:00,102,13,89,FMN 08 Schijnpoortweg
675,Schijnpoortweg,2022-11-22,22:00:00,100,9,91,FMN 08 Schijnpoortweg
675,Schijnpoortweg,2022-11-22,23:00:00,60,3,57,FMN 08 Schijnpoortweg
675,Schijnpoortweg,2022-11-23,00:00:00,34,4,30,FMN 08 Schijnpoortweg
675,Schijnpoortweg,2022-11-23,01:00:00,21,3,18,FMN 08 Schijnpoortweg
675,Schijnpoortweg,2022-11-23,02:00:00,18,2,16,FMN 08 Schijnpoortweg
675,Schijnpoortweg,2022-11-23,03:00:00,15,6,9,FMN 08 Schijnpoortweg
675,Schijnpoortweg,2022-11-23,04:00:00,35,18,17,FMN 08 Schijnpoortweg
675,Schijnpoortweg,2022-11-23,05:00:00,55,8,47,FMN 08 Schijnpoortweg
675,Schijnpoortweg,2022-11-23,06:00:00,87,16,71,FMN 08 Schijnpoortweg
675,Schijnpoortweg,2022-11-23,07:00:00,172,12,160,FMN 08 Schijnpoortweg
675,Schijnpoortweg,2022-11-23,08:00:00,216,32,184,FMN 08 Schijnpoortweg
675,Schijnpoortweg,2022-11-23,09:00:00,116,10,106,FMN 08 Schijnpoortweg
675,Schijnpoortweg,2022-11-23,10:00:00,101,9,92,FMN 08 Schijnpoortweg
675,Schijnpoortweg,2022-11-23,11:00:00,106,15,91,FMN 08 Schijnpoortweg
675,Schijnpoortweg,2022-11-23,12:00:00,212,13,199,FMN 08 Schijnpoortweg
675,Schijnpoortweg,2022-11-23,13:00:00,175,11,164,FMN 08 Schijnpoortweg
675,Schijnpoortweg,2022-11-23,14:00:00,108,10,98,FMN 08 Schijnpoortweg
675,Schijnpoortweg,2022-11-23,15:00:00,166,13,153,FMN 08 Schijnpoortweg
675,Schijnpoortweg,2022-11-23,16:00:00,274,37,237,FMN 08 Schijnpoortweg
675,Schijnpoortweg,2022-11-23,17:00:00,277,31,246,FMN 08 Schijnpoortweg
675,Schijnpoortweg,2022-11-23,18:00:00,254,33,221,FMN 08 Schijnpoortweg
675,Schijnpoortweg,2022-11-23,19:00:00,333,69,264,FMN 08 Schijnpoortweg
675,Schijnpoortweg,2022-11-23,20:00:00,262,35,227,FMN 08 Schijnpoortweg
675,Schijnpoortweg,2022-11-23,21:00:00,84,14,70,FMN 08 Schijnpoortweg
675,Schijnpoortweg,2022-11-23,22:00:00,109,16,93,FMN 08 Schijnpoortweg
675,Schijnpoortweg,2022-11-23,23:00:00,246,172,74,FMN 08 Schijnpoortweg
675,Schijnpoortweg,2022-11-24,00:00:00,57,23,34,FMN 08 Schijnpoortweg
675,Schijnpoortweg,2022-11-24,01:00:00,17,1,16,FMN 08 Schijnpoortweg
675,Schijnpoortweg,2022-11-24,02:00:00,23,5,18,FMN 08 Schijnpoortweg
675,Schijnpoortweg,2022-11-24,03:00:00,6,2,4,FMN 08 Schijnpoortweg
675,Schijnpoortweg,2022-11-24,04:00:00,28,13,15,FMN 08 Schijnpoortweg
675,Schijnpoortweg,2022-11-24,05:00:00,68,8,60,FMN 08 Schijnpoortweg
675,Schijnpoortweg,2022-11-24,06:00:00,92,20,72,FMN 08 Schijnpoortweg
675,Schijnpoortweg,2022-11-24,07:00:00,196,21,175,FMN 08 Schijnpoortweg
675,Schijnpoortweg,2022-11-24,08:00:00,251,46,205,FMN 08 Schijnpoortweg
675,Schijnpoortweg,2022-11-24,09:00:00,116,17,99,FMN 08 Schijnpoortweg
675,Schijnpoortweg,2022-11-24,10:00:00,75,15,60,FMN 08 Schijnpoortweg
675,Schijnpoortweg,2022-11-24,11:00:00,113,11,102,FMN 08 Schijnpoortweg
675,Schijnpoortweg,2022-11-24,12:00:00,175,29,146,FMN 08 Schijnpoortweg
675,Schijnpoortweg,2022-11-24,13:00:00,138,14,124,FMN 08 Schijnpoortweg
675,Schijnpoortweg,2022-11-24,14:00:00,163,21,142,FMN 08 Schijnpoortweg
675,Schijnpoortweg,2022-11-24,15:00:00,270,16,254,FMN 08 Schijnpoortweg
675,Schijnpoortweg,2022-11-24,16:00:00,382,25,357,FMN 08 Schijnpoortweg
675,Schijnpoortweg,2022-11-24,17:00:00,355,24,331,FMN 08 Schijnpoortweg
675,Schijnpoortweg,2022-11-24,18:00:00,280,45,235,FMN 08 Schijnpoortweg
675,Schijnpoortweg,2022-11-24,19:00:00,180,23,157,FMN 08 Schijnpoortweg
675,Schijnpoortweg,2022-11-24,20:00:00,139,15,124,FMN 08 Schijnpoortweg
675,Schijnpoortweg,2022-11-24,21:00:00,87,10,77,FMN 08 Schijnpoortweg
675,Schijnpoortweg,2022-11-24,22:00:00,155,55,100,FMN 08 Schijnpoortweg
675,Schijnpoortweg,2022-11-24,23:00:00,79,10,69,FMN 08 Schijnpoortweg
675,Schijnpoortweg,2022-11-25,00:00:00,48,4,44,FMN 08 Schijnpoortweg
675,Schijnpoortweg,2022-11-25,01:00:00,20,3,17,FMN 08 Schijnpoortweg
675,Schijnpoortweg,2022-11-25,02:00:00,22,4,18,FMN 08 Schijnpoortweg
675,Schijnpoortweg,2022-11-25,03:00:00,17,5,12,FMN 08 Schijnpoortweg
675,Schijnpoortweg,2022-11-25,04:00:00,27,8,19,FMN 08 Schijnpoortweg
675,Schijnpoortweg,2022-11-25,05:00:00,57,8,49,FMN 08 Schijnpoortweg
675,Schijnpoortweg,2022-11-25,06:00:00,84,21,63,FMN 08 Schijnpoortweg
675,Schijnpoortweg,2022-11-25,07:00:00,184,24,160,FMN 08 Schijnpoortweg
675,Schijnpoortweg,2022-11-25,08:00:00,220,39,181,FMN 08 Schijnpoortweg
675,Schijnpoortweg,2022-11-25,09:00:00,96,16,80,FMN 08 Schijnpoortweg
675,Schijnpoortweg,2022-11-25,10:00:00,101,17,84,FMN 08 Schijnpoortweg
675,Schijnpoortweg,2022-11-25,11:00:00,128,17,111,FMN 08 Schijnpoortweg
675,Schijnpoortweg,2022-11-25,12:00:00,145,23,122,FMN 08 Schijnpoortweg
675,Schijnpoortweg,2022-11-25,13:00:00,155,14,141,FMN 08 Schijnpoortweg
675,Schijnpoortweg,2022-11-25,14:00:00,176,19,157,FMN 08 Schijnpoortweg
675,Schijnpoortweg,2022-11-25,15:00:00,289,18,271,FMN 08 Schijnpoortweg
675,Schijnpoortweg,2022-11-25,16:00:00,347,27,320,FMN 08 Schijnpoortweg
675,Schijnpoortweg,2022-11-25,17:00:00,287,30,257,FMN 08 Schijnpoortweg
675,Schijnpoortweg,2022-11-25,18:00:00,184,21,163,FMN 08 Schijnpoortweg
675,Schijnpoortweg,2022-11-25,19:00:00,182,24,158,FMN 08 Schijnpoortweg
675,Schijnpoortweg,2022-11-25,20:00:00,116,13,103,FMN 08 Schijnpoortweg
675,Schijnpoortweg,2022-11-25,21:00:00,98,10,88,FMN 08 Schijnpoortweg
675,Schijnpoortweg,2022-11-25,22:00:00,108,17,91,FMN 08 Schijnpoortweg
675,Schijnpoortweg,2022-11-25,23:00:00,92,15,77,FMN 08 Schijnpoortweg
675,Schijnpoortweg,2022-11-26,00:00:00,75,13,62,FMN 08 Schijnpoortweg
675,Schijnpoortweg,2022-11-26,01:00:00,39,6,33,FMN 08 Schijnpoortweg
675,Schijnpoortweg,2022-11-26,02:00:00,37,3,34,FMN 08 Schijnpoortweg
675,Schijnpoortweg,2022-11-26,03:00:00,24,4,20,FMN 08 Schijnpoortweg
675,Schijnpoortweg,2022-11-26,04:00:00,20,5,15,FMN 08 Schijnpoortweg
675,Schijnpoortweg,2022-11-26,05:00:00,27,8,19,FMN 08 Schijnpoortweg
675,Schijnpoortweg,2022-11-26,06:00:00,32,12,20,FMN 08 Schijnpoortweg
675,Schijnpoortweg,2022-11-26,07:00:00,44,2,42,FMN 08 Schijnpoortweg
675,Schijnpoortweg,2022-11-26,08:00:00,73,8,65,FMN 08 Schijnpoortweg
675,Schijnpoortweg,2022-11-26,09:00:00,80,8,72,FMN 08 Schijnpoortweg
675,Schijnpoortweg,2022-11-26,10:00:00,106,18,88,FMN 08 Schijnpoortweg
675,Schijnpoortweg,2022-11-26,11:00:00,115,21,94,FMN 08 Schijnpoortweg
675,Schijnpoortweg,2022-11-26,12:00:00,125,20,105,FMN 08 Schijnpoortweg
675,Schijnpoortweg,2022-11-26,13:00:00,244,32,212,FMN 08 Schijnpoortweg
675,Schijnpoortweg,2022-11-26,14:00:00,162,22,140,FMN 08 Schijnpoortweg
675,Schijnpoortweg,2022-11-26,15:00:00,169,29,140,FMN 08 Schijnpoortweg
675,Schijnpoortweg,2022-11-26,16:00:00,303,112,191,FMN 08 Schijnpoortweg
675,Schijnpoortweg,2022-11-26,17:00:00,190,32,158,FMN 08 Schijnpoortweg
675,Schijnpoortweg,2022-11-26,18:00:00,142,28,114,FMN 08 Schijnpoortweg
675,Schijnpoortweg,2022-11-26,19:00:00,228,78,150,FMN 08 Schijnpoortweg
675,Schijnpoortweg,2022-11-26,20:00:00,118,19,99,FMN 08 Schijnpoortweg
675,Schijnpoortweg,2022-11-26,21:00:00,74,11,63,FMN 08 Schijnpoortweg
675,Schijnpoortweg,2022-11-26,22:00:00,84,9,75,FMN 08 Schijnpoortweg
675,Schijnpoortweg,2022-11-26,23:00:00,141,58,83,FMN 08 Schijnpoortweg
675,Schijnpoortweg,2022-11-27,00:00:00,71,14,57,FMN 08 Schijnpoortweg
675,Schijnpoortweg,2022-11-27,01:00:00,41,4,37,FMN 08 Schijnpoortweg
675,Schijnpoortweg,2022-11-27,02:00:00,38,5,33,FMN 08 Schijnpoortweg
675,Schijnpoortweg,2022-11-27,03:00:00,25,7,18,FMN 08 Schijnpoortweg
675,Schijnpoortweg,2022-11-27,04:00:00,20,2,18,FMN 08 Schijnpoortweg
675,Schijnpoortweg,2022-11-27,05:00:00,24,3,21,FMN 08 Schijnpoortweg
675,Schijnpoortweg,2022-11-27,06:00:00,18,5,13,FMN 08 Schijnpoortweg
675,Schijnpoortweg,2022-11-27,07:00:00,23,1,22,FMN 08 Schijnpoortweg
675,Schijnpoortweg,2022-11-27,08:00:00,32,5,27,FMN 08 Schijnpoortweg
675,Schijnpoortweg,2022-11-27,09:00:00,41,7,34,FMN 08 Schijnpoortweg
675,Schijnpoortweg,2022-11-27,10:00:00,59,11,48,FMN 08 Schijnpoortweg
675,Schijnpoortweg,2022-11-27,11:00:00,63,9,54,FMN 08 Schijnpoortweg
675,Schijnpoortweg,2022-11-27,12:00:00,93,29,64,FMN 08 Schijnpoortweg
675,Schijnpoortweg,2022-11-27,13:00:00,121,19,102,FMN 08 Schijnpoortweg
675,Schijnpoortweg,2022-11-27,14:00:00,88,16,72,FMN 08 Schijnpoortweg
675,Schijnpoortweg,2022-11-27,15:00:00,65,7,58,FMN 08 Schijnpoortweg
675,Schijnpoortweg,2022-11-27,16:00:00,116,22,94,FMN 08 Schijnpoortweg
675,Schijnpoortweg,2022-11-27,17:00:00,128,17,111,FMN 08 Schijnpoortweg
675,Schijnpoortweg,2022-11-27,18:00:00,91,11,80,FMN 08 Schijnpoortweg
675,Schijnpoortweg,2022-11-27,19:00:00,71,11,60,FMN 08 Schijnpoortweg
675,Schijnpoortweg,2022-11-27,20:00:00,50,8,42,FMN 08 Schijnpoortweg
675,Schijnpoortweg,2022-11-27,21:00:00,46,6,40,FMN 08 Schijnpoortweg
675,Schijnpoortweg,2022-11-27,22:00:00,55,10,45,FMN 08 Schijnpoortweg
675,Schijnpoortweg,2022-11-27,23:00:00,35,3,32,FMN 08 Schijnpoortweg
675,Schijnpoortweg,2022-11-28,00:00:00,20,4,16,FMN 08 Schijnpoortweg
675,Schijnpoortweg,2022-11-28,01:00:00,20,1,19,FMN 08 Schijnpoortweg
675,Schijnpoortweg,2022-11-28,02:00:00,17,3,14,FMN 08 Schijnpoortweg
675,Schijnpoortweg,2022-11-28,03:00:00,11,3,8,FMN 08 Schijnpoortweg
675,Schijnpoortweg,2022-11-28,04:00:00,17,7,10,FMN 08 Schijnpoortweg
675,Schijnpoortweg,2022-11-28,05:00:00,56,7,49,FMN 08 Schijnpoortweg
675,Schijnpoortweg,2022-11-28,06:00:00,77,13,64,FMN 08 Schijnpoortweg
675,Schijnpoortweg,2022-11-28,07:00:00,182,21,161,FMN 08 Schijnpoortweg
675,Schijnpoortweg,2022-11-28,08:00:00,213,29,184,FMN 08 Schijnpoortweg
675,Schijnpoortweg,2022-11-28,09:00:00,98,9,89,FMN 08 Schijnpoortweg
675,Schijnpoortweg,2022-11-28,10:00:00,67,14,53,FMN 08 Schijnpoortweg
675,Schijnpoortweg,2022-11-28,11:00:00,97,24,73,FMN 08 Schijnpoortweg
675,Schijnpoortweg,2022-11-28,12:00:00,133,17,116,FMN 08 Schijnpoortweg
675,Schijnpoortweg,2022-11-28,13:00:00,125,17,108,FMN 08 Schijnpoortweg
675,Schijnpoortweg,2022-11-28,14:00:00,136,14,122,FMN 08 Schijnpoortweg
675,Schijnpoortweg,2022-11-28,15:00:00,239,19,220,FMN 08 Schijnpoortweg
675,Schijnpoortweg,2022-11-28,16:00:00,361,32,329,FMN 08 Schijnpoortweg
675,Schijnpoortweg,2022-11-28,17:00:00,281,21,260,FMN 08 Schijnpoortweg
675,Schijnpoortweg,2022-11-28,18:00:00,195,19,176,FMN 08 Schijnpoortweg
675,Schijnpoortweg,2022-11-28,19:00:00,141,14,127,FMN 08 Schijnpoortweg
675,Schijnpoortweg,2022-11-28,20:00:00,106,7,99,FMN 08 Schijnpoortweg
675,Schijnpoortweg,2022-11-28,21:00:00,95,10,85,FMN 08 Schijnpoortweg
675,Schijnpoortweg,2022-11-28,22:00:00,84,14,70,FMN 08 Schijnpoortweg
675,Schijnpoortweg,2022-11-28,23:00:00,43,5,38,FMN 08 Schijnpoortweg
675,Schijnpoortweg,2022-11-29,00:00:00,37,4,33,FMN 08 Schijnpoortweg
675,Schijnpoortweg,2022-11-29,01:00:00,16,1,15,FMN 08 Schijnpoortweg
675,Schijnpoortweg,2022-11-29,02:00:00,16,3,13,FMN 08 Schijnpoortweg
675,Schijnpoortweg,2022-11-29,03:00:00,17,6,11,FMN 08 Schijnpoortweg
675,Schijnpoortweg,2022-11-29,04:00:00,19,7,12,FMN 08 Schijnpoortweg
675,Schijnpoortweg,2022-11-29,05:00:00,54,8,46,FMN 08 Schijnpoortweg
675,Schijnpoortweg,2022-11-29,06:00:00,95,16,79,FMN 08 Schijnpoortweg
675,Schijnpoortweg,2022-11-29,07:00:00,207,19,188,FMN 08 Schijnpoortweg
675,Schijnpoortweg,2022-11-29,08:00:00,248,36,212,FMN 08 Schijnpoortweg
675,Schijnpoortweg,2022-11-29,09:00:00,113,16,97,FMN 08 Schijnpoortweg
675,Schijnpoortweg,2022-11-29,10:00:00,99,17,82,FMN 08 Schijnpoortweg
675,Schijnpoortweg,2022-11-29,11:00:00,109,15,94,FMN 08 Schijnpoortweg
675,Schijnpoortweg,2022-11-29,12:00:00,133,20,113,FMN 08 Schijnpoortweg
675,Schijnpoortweg,2022-11-29,13:00:00,133,7,126,FMN 08 Schijnpoortweg
675,Schijnpoortweg,2022-11-29,14:00:00,160,20,140,FMN 08 Schijnpoortweg
675,Schijnpoortweg,2022-11-29,15:00:00,253,26,227,FMN 08 Schijnpoortweg
675,Schijnpoortweg,2022-11-29,16:00:00,365,36,329,FMN 08 Schijnpoortweg
675,Schijnpoortweg,2022-11-29,17:00:00,330,28,302,FMN 08 Schijnpoortweg
675,Schijnpoortweg,2022-11-29,18:00:00,220,20,200,FMN 08 Schijnpoortweg
675,Schijnpoortweg,2022-11-29,19:00:00,138,8,130,FMN 08 Schijnpoortweg
675,Schijnpoortweg,2022-11-29,20:00:00,112,13,99,FMN 08 Schijnpoortweg
675,Schijnpoortweg,2022-11-29,21:00:00,99,12,87,FMN 08 Schijnpoortweg
675,Schijnpoortweg,2022-11-29,22:00:00,95,18,77,FMN 08 Schijnpoortweg
675,Schijnpoortweg,2022-11-29,23:00:00,61,7,54,FMN 08 Schijnpoortweg
675,Schijnpoortweg,2022-11-30,00:00:00,21,2,19,FMN 08 Schijnpoortweg
675,Schijnpoortweg,2022-11-30,01:00:00,13,1,12,FMN 08 Schijnpoortweg
675,Schijnpoortweg,2022-11-30,02:00:00,20,2,18,FMN 08 Schijnpoortweg
675,Schijnpoortweg,2022-11-30,03:00:00,8,3,5,FMN 08 Schijnpoortweg
675,Schijnpoortweg,2022-11-30,04:00:00,25,10,15,FMN 08 Schijnpoortweg
675,Schijnpoortweg,2022-11-30,05:00:00,55,7,48,FMN 08 Schijnpoortweg
675,Schijnpoortweg,2022-11-30,06:00:00,80,11,69,FMN 08 Schijnpoortweg
675,Schijnpoortweg,2022-11-30,07:00:00,187,12,175,FMN 08 Schijnpoortweg
675,Schijnpoortweg,2022-11-30,08:00:00,225,32,193,FMN 08 Schijnpoortweg
675,Schijnpoortweg,2022-11-30,09:00:00,111,10,101,FMN 08 Schijnpoortweg
675,Schijnpoortweg,2022-11-30,10:00:00,109,14,95,FMN 08 Schijnpoortweg
675,Schijnpoortweg,2022-11-30,11:00:00,130,14,116,FMN 08 Schijnpoortweg
675,Schijnpoortweg,2022-11-30,12:00:00,228,17,211,FMN 08 Schijnpoortweg
675,Schijnpoortweg,2022-11-30,13:00:00,176,22,154,FMN 08 Schijnpoortweg
675,Schijnpoortweg,2022-11-30,14:00:00,159,18,141,FMN 08 Schijnpoortweg
675,Schijnpoortweg,2022-11-30,15:00:00,228,17,211,FMN 08 Schijnpoortweg
675,Schijnpoortweg,2022-11-30,16:00:00,255,31,224,FMN 08 Schijnpoortweg
675,Schijnpoortweg,2022-11-30,17:00:00,295,16,279,FMN 08 Schijnpoortweg
675,Schijnpoortweg,2022-11-30,18:00:00,187,13,174,FMN 08 Schijnpoortweg
675,Schijnpoortweg,2022-11-30,19:00:00,158,18,140,FMN 08 Schijnpoortweg
675,Schijnpoortweg,2022-11-30,20:00:00,134,15,119,FMN 08 Schijnpoortweg
675,Schijnpoortweg,2022-11-30,21:00:00,99,8,91,FMN 08 Schijnpoortweg
675,Schijnpoortweg,2022-11-30,22:00:00,110,20,90,FMN 08 Schijnpoortweg
675,Schijnpoortweg,2022-11-30,23:00:00,65,4,61,FMN 08 Schijnpoortweg
675,Schijnpoortweg,2022-12-01,00:00:00,28,3,25,FMN 08 Schijnpoortweg
675,Schijnpoortweg,2022-12-01,01:00:00,10,1,9,FMN 08 Schijnpoortweg
675,Schijnpoortweg,2022-12-01,02:00:00,20,3,17,FMN 08 Schijnpoortweg
675,Schijnpoortweg,2022-12-01,03:00:00,12,5,7,FMN 08 Schijnpoortweg
675,Schijnpoortweg,2022-12-01,04:00:00,27,12,15,FMN 08 Schijnpoortweg
675,Schijnpoortweg,2022-12-01,05:00:00,59,4,55,FMN 08 Schijnpoortweg
675,Schijnpoortweg,2022-12-01,06:00:00,90,15,75,FMN 08 Schijnpoortweg
675,Schijnpoortweg,2022-12-01,07:00:00,190,23,167,FMN 08 Schijnpoortweg
675,Schijnpoortweg,2022-12-01,08:00:00,237,26,211,FMN 08 Schijnpoortweg
675,Schijnpoortweg,2022-12-01,09:00:00,102,11,91,FMN 08 Schijnpoortweg
675,Schijnpoortweg,2022-12-01,10:00:00,92,13,79,FMN 08 Schijnpoortweg
675,Schijnpoortweg,2022-12-01,11:00:00,101,7,94,FMN 08 Schijnpoortweg
675,Schijnpoortweg,2022-12-01,12:00:00,158,14,144,FMN 08 Schijnpoortweg
675,Schijnpoortweg,2022-12-01,13:00:00,118,7,111,FMN 08 Schijnpoortweg
675,Schijnpoortweg,2022-12-01,14:00:00,159,12,147,FMN 08 Schijnpoortweg
675,Schijnpoortweg,2022-12-01,15:00:00,286,23,263,FMN 08 Schijnpoortweg
675,Schijnpoortweg,2022-12-01,16:00:00,355,32,323,FMN 08 Schijnpoortweg
675,Schijnpoortweg,2022-12-01,17:00:00,291,32,259,FMN 08 Schijnpoortweg
675,Schijnpoortweg,2022-12-01,18:00:00,276,43,233,FMN 08 Schijnpoortweg
675,Schijnpoortweg,2022-12-01,19:00:00,437,69,368,FMN 08 Schijnpoortweg
675,Schijnpoortweg,2022-12-01,20:00:00,132,17,115,FMN 08 Schijnpoortweg
675,Schijnpoortweg,2022-12-01,21:00:00,111,7,104,FMN 08 Schijnpoortweg
675,Schijnpoortweg,2022-12-01,22:00:00,116,18,98,FMN 08 Schijnpoortweg
675,Schijnpoortweg,2022-12-01,23:00:00,168,122,46,FMN 08 Schijnpoortweg
675,Schijnpoortweg,2022-12-02,00:00:00,82,48,34,FMN 08 Schijnpoortweg
675,Schijnpoortweg,2022-12-02,01:00:00,34,20,14,FMN 08 Schijnpoortweg
675,Schijnpoortweg,2022-12-02,02:00:00,19,2,17,FMN 08 Schijnpoortweg
675,Schijnpoortweg,2022-12-02,03:00:00,13,3,10,FMN 08 Schijnpoortweg
675,Schijnpoortweg,2022-12-02,04:00:00,24,12,12,FMN 08 Schijnpoortweg
675,Schijnpoortweg,2022-12-02,05:00:00,53,6,47,FMN 08 Schijnpoortweg
675,Schijnpoortweg,2022-12-02,06:00:00,83,10,73,FMN 08 Schijnpoortweg
675,Schijnpoortweg,2022-12-02,07:00:00,163,15,148,FMN 08 Schijnpoortweg
675,Schijnpoortweg,2022-12-02,08:00:00,207,28,179,FMN 08 Schijnpoortweg
675,Schijnpoortweg,2022-12-02,09:00:00,91,8,83,FMN 08 Schijnpoortweg
675,Schijnpoortweg,2022-12-02,10:00:00,86,12,74,FMN 08 Schijnpoortweg
675,Schijnpoortweg,2022-12-02,11:00:00,94,6,88,FMN 08 Schijnpoortweg
675,Schijnpoortweg,2022-12-02,12:00:00,140,9,131,FMN 08 Schijnpoortweg
675,Schijnpoortweg,2022-12-02,13:00:00,124,13,111,FMN 08 Schijnpoortweg
675,Schijnpoortweg,2022-12-02,14:00:00,175,15,160,FMN 08 Schijnpoortweg
675,Schijnpoortweg,2022-12-02,15:00:00,253,13,240,FMN 08 Schijnpoortweg
675,Schijnpoortweg,2022-12-02,16:00:00,295,18,277,FMN 08 Schijnpoortweg
675,Schijnpoortweg,2022-12-02,17:00:00,267,19,248,FMN 08 Schijnpoortweg
675,Schijnpoortweg,2022-12-02,18:00:00,218,36,182,FMN 08 Schijnpoortweg
675,Schijnpoortweg,2022-12-02,19:00:00,355,70,285,FMN 08 Schijnpoortweg
675,Schijnpoortweg,2022-12-02,20:00:00,117,19,98,FMN 08 Schijnpoortweg
675,Schijnpoortweg,2022-12-02,21:00:00,97,12,85,FMN 08 Schijnpoortweg
675,Schijnpoortweg,2022-12-02,22:00:00,87,15,72,FMN 08 Schijnpoortweg
675,Schijnpoortweg,2022-12-02,23:00:00,109,44,65,FMN 08 Schijnpoortweg
675,Schijnpoortweg,2022-12-03,00:00:00,94,49,45,FMN 08 Schijnpoortweg
675,Schijnpoortweg,2022-12-03,01:00:00,68,30,38,FMN 08 Schijnpoortweg
675,Schijnpoortweg,2022-12-03,02:00:00,19,3,16,FMN 08 Schijnpoortweg
675,Schijnpoortweg,2022-12-03,03:00:00,17,2,15,FMN 08 Schijnpoortweg
675,Schijnpoortweg,2022-12-03,04:00:00,18,3,15,FMN 08 Schijnpoortweg
675,Schijnpoortweg,2022-12-03,05:00:00,19,6,13,FMN 08 Schijnpoortweg
675,Schijnpoortweg,2022-12-03,06:00:00,33,4,29,FMN 08 Schijnpoortweg
675,Schijnpoortweg,2022-12-03,07:00:00,60,4,56,FMN 08 Schijnpoortweg
675,Schijnpoortweg,2022-12-03,08:00:00,64,8,56,FMN 08 Schijnpoortweg
675,Schijnpoortweg,2022-12-03,09:00:00,107,16,91,FMN 08 Schijnpoortweg
675,Schijnpoortweg,2022-12-03,10:00:00,151,34,117,FMN 08 Schijnpoortweg
675,Schijnpoortweg,2022-12-03,11:00:00,87,11,76,FMN 08 Schijnpoortweg
675,Schijnpoortweg,2022-12-03,12:00:00,174,98,76,FMN 08 Schijnpoortweg
675,Schijnpoortweg,2022-12-03,13:00:00,113,15,98,FMN 08 Schijnpoortweg
675,Schijnpoortweg,2022-12-03,14:00:00,163,53,110,FMN 08 Schijnpoortweg
675,Schijnpoortweg,2022-12-03,15:00:00,124,16,108,FMN 08 Schijnpoortweg
675,Schijnpoortweg,2022-12-03,16:00:00,149,39,110,FMN 08 Schijnpoortweg
675,Schijnpoortweg,2022-12-03,17:00:00,203,78,125,FMN 08 Schijnpoortweg
675,Schijnpoortweg,2022-12-03,18:00:00,176,44,132,FMN 08 Schijnpoortweg
675,Schijnpoortweg,2022-12-03,19:00:00,360,71,289,FMN 08 Schijnpoortweg
675,Schijnpoortweg,2022-12-03,20:00:00,99,17,82,FMN 08 Schijnpoortweg
675,Schijnpoortweg,2022-12-03,21:00:00,54,14,40,FMN 08 Schijnpoortweg
675,Schijnpoortweg,2022-12-03,22:00:00,79,34,45,FMN 08 Schijnpoortweg
675,Schijnpoortweg,2022-12-03,23:00:00,108,49,59,FMN 08 Schijnpoortweg
675,Schijnpoortweg,2022-12-04,00:00:00,68,24,44,FMN 08 Schijnpoortweg
675,Schijnpoortweg,2022-12-04,01:00:00,74,49,25,FMN 08 Schijnpoortweg
675,Schijnpoortweg,2022-12-04,02:00:00,24,4,20,FMN 08 Schijnpoortweg
675,Schijnpoortweg,2022-12-04,03:00:00,18,2,16,FMN 08 Schijnpoortweg
675,Schijnpoortweg,2022-12-04,04:00:00,7,3,4,FMN 08 Schijnpoortweg
675,Schijnpoortweg,2022-12-04,05:00:00,12,0,12,FMN 08 Schijnpoortweg
675,Schijnpoortweg,2022-12-04,06:00:00,14,4,10,FMN 08 Schijnpoortweg
675,Schijnpoortweg,2022-12-04,07:00:00,18,1,17,FMN 08 Schijnpoortweg
675,Schijnpoortweg,2022-12-04,08:00:00,38,8,30,FMN 08 Schijnpoortweg
675,Schijnpoortweg,2022-12-04,09:00:00,144,37,107,FMN 08 Schijnpoortweg
675,Schijnpoortweg,2022-12-04,10:00:00,74,9,65,FMN 08 Schijnpoortweg
675,Schijnpoortweg,2022-12-04,11:00:00,91,36,55,FMN 08 Schijnpoortweg
675,Schijnpoortweg,2022-12-04,12:00:00,151,75,76,FMN 08 Schijnpoortweg
675,Schijnpoortweg,2022-12-04,13:00:00,155,37,118,FMN 08 Schijnpoortweg
675,Schijnpoortweg,2022-12-04,14:00:00,95,11,84,FMN 08 Schijnpoortweg
675,Schijnpoortweg,2022-12-04,15:00:00,107,10,97,FMN 08 Schijnpoortweg
675,Schijnpoortweg,2022-12-04,16:00:00,175,84,91,FMN 08 Schijnpoortweg
675,Schijnpoortweg,2022-12-04,17:00:00,125,15,110,FMN 08 Schijnpoortweg
675,Schijnpoortweg,2022-12-04,18:00:00,113,22,91,FMN 08 Schijnpoortweg
675,Schijnpoortweg,2022-12-04,19:00:00,92,17,75,FMN 08 Schijnpoortweg
675,Schijnpoortweg,2022-12-04,20:00:00,81,7,74,FMN 08 Schijnpoortweg
675,Schijnpoortweg,2022-12-04,21:00:00,59,5,54,FMN 08 Schijnpoortweg
675,Schijnpoortweg,2022-12-04,22:00:00,68,23,45,FMN 08 Schijnpoortweg
675,Schijnpoortweg,2022-12-04,23:00:00,30,6,24,FMN 08 Schijnpoortweg
675,Schijnpoortweg,2022-12-05,00:00:00,22,2,20,FMN 08 Schijnpoortweg
675,Schijnpoortweg,2022-12-05,01:00:00,19,3,16,FMN 08 Schijnpoortweg
675,Schijnpoortweg,2022-12-05,02:00:00,17,3,14,FMN 08 Schijnpoortweg
675,Schijnpoortweg,2022-12-05,03:00:00,9,3,6,FMN 08 Schijnpoortweg
675,Schijnpoortweg,2022-12-05,04:00:00,21,7,14,FMN 08 Schijnpoortweg
675,Schijnpoortweg,2022-12-05,05:00:00,59,6,53,FMN 08 Schijnpoortweg
675,Schijnpoortweg,2022-12-05,06:00:00,77,14,63,FMN 08 Schijnpoortweg
675,Schijnpoortweg,2022-12-05,07:00:00,158,18,140,FMN 08 Schijnpoortweg
675,Schijnpoortweg,2022-12-05,08:00:00,206,31,175,FMN 08 Schijnpoortweg
675,Schijnpoortweg,2022-12-05,09:00:00,80,6,74,FMN 08 Schijnpoortweg
675,Schijnpoortweg,2022-12-05,10:00:00,59,8,51,FMN 08 Schijnpoortweg
675,Schijnpoortweg,2022-12-05,11:00:00,75,13,62,FMN 08 Schijnpoortweg
675,Schijnpoortweg,2022-12-05,12:00:00,114,16,98,FMN 08 Schijnpoortweg
675,Schijnpoortweg,2022-12-05,13:00:00,99,9,90,FMN 08 Schijnpoortweg
675,Schijnpoortweg,2022-12-05,14:00:00,123,20,103,FMN 08 Schijnpoortweg
675,Schijnpoortweg,2022-12-05,15:00:00,208,11,197,FMN 08 Schijnpoortweg
675,Schijnpoortweg,2022-12-05,16:00:00,302,33,269,FMN 08 Schijnpoortweg
675,Schijnpoortweg,2022-12-05,17:00:00,272,14,258,FMN 08 Schijnpoortweg
675,Schijnpoortweg,2022-12-05,18:00:00,180,27,153,FMN 08 Schijnpoortweg
675,Schijnpoortweg,2022-12-05,19:00:00,143,18,125,FMN 08 Schijnpoortweg
675,Schijnpoortweg,2022-12-05,20:00:00,92,15,77,FMN 08 Schijnpoortweg
675,Schijnpoortweg,2022-12-05,21:00:00,79,5,74,FMN 08 Schijnpoortweg
675,Schijnpoortweg,2022-12-05,22:00:00,73,10,63,FMN 08 Schijnpoortweg
675,Schijnpoortweg,2022-12-05,23:00:00,36,3,33,FMN 08 Schijnpoortweg
675,Schijnpoortweg,2022-12-06,00:00:00,33,5,28,FMN 08 Schijnpoortweg
675,Schijnpoortweg,2022-12-06,01:00:00,14,5,9,FMN 08 Schijnpoortweg
675,Schijnpoortweg,2022-12-06,02:00:00,11,0,11,FMN 08 Schijnpoortweg
675,Schijnpoortweg,2022-12-06,03:00:00,13,3,10,FMN 08 Schijnpoortweg
675,Schijnpoortweg,2022-12-06,04:00:00,18,12,6,FMN 08 Schijnpoortweg
675,Schijnpoortweg,2022-12-06,05:00:00,72,8,64,FMN 08 Schijnpoortweg
675,Schijnpoortweg,2022-12-06,06:00:00,84,13,71,FMN 08 Schijnpoortweg
675,Schijnpoortweg,2022-12-06,07:00:00,176,13,163,FMN 08 Schijnpoortweg
675,Schijnpoortweg,2022-12-06,08:00:00,203,35,168,FMN 08 Schijnpoortweg
675,Schijnpoortweg,2022-12-06,09:00:00,105,12,93,FMN 08 Schijnpoortweg
675,Schijnpoortweg,2022-12-06,10:00:00,85,12,73,FMN 08 Schijnpoortweg
675,Schijnpoortweg,2022-12-06,11:00:00,89,17,72,FMN 08 Schijnpoortweg
675,Schijnpoortweg,2022-12-06,12:00:00,177,21,156,FMN 08 Schijnpoortweg
675,Schijnpoortweg,2022-12-06,13:00:00,132,13,119,FMN 08 Schijnpoortweg
675,Schijnpoortweg,2022-12-06,14:00:00,149,8,141,FMN 08 Schijnpoortweg
675,Schijnpoortweg,2022-12-06,15:00:00,296,28,268,FMN 08 Schijnpoortweg
675,Schijnpoortweg,2022-12-06,16:00:00,321,25,296,FMN 08 Schijnpoortweg
675,Schijnpoortweg,2022-12-06,17:00:00,274,19,255,FMN 08 Schijnpoortweg
675,Schijnpoortweg,2022-12-06,18:00:00,198,16,182,FMN 08 Schijnpoortweg
675,Schijnpoortweg,2022-12-06,19:00:00,180,17,163,FMN 08 Schijnpoortweg
675,Schijnpoortweg,2022-12-06,20:00:00,138,20,118,FMN 08 Schijnpoortweg
675,Schijnpoortweg,2022-12-06,21:00:00,97,8,89,FMN 08 Schijnpoortweg
675,Schijnpoortweg,2022-12-06,22:00:00,91,11,80,FMN 08 Schijnpoortweg
675,Schijnpoortweg,2022-12-06,23:00:00,53,7,46,FMN 08 Schijnpoortweg
675,Schijnpoortweg,2022-12-07,00:00:00,32,4,28,FMN 08 Schijnpoortweg
675,Schijnpoortweg,2022-12-07,01:00:00,21,5,16,FMN 08 Schijnpoortweg
675,Schijnpoortweg,2022-12-07,02:00:00,13,2,11,FMN 08 Schijnpoortweg
675,Schijnpoortweg,2022-12-07,03:00:00,16,2,14,FMN 08 Schijnpoortweg
675,Schijnpoortweg,2022-12-07,04:00:00,30,18,12,FMN 08 Schijnpoortweg
675,Schijnpoortweg,2022-12-07,05:00:00,63,9,54,FMN 08 Schijnpoortweg
675,Schijnpoortweg,2022-12-07,06:00:00,81,13,68,FMN 08 Schijnpoortweg
675,Schijnpoortweg,2022-12-07,07:00:00,175,13,162,FMN 08 Schijnpoortweg
675,Schijnpoortweg,2022-12-07,08:00:00,215,41,174,FMN 08 Schijnpoortweg
675,Schijnpoortweg,2022-12-07,09:00:00,107,10,97,FMN 08 Schijnpoortweg
675,Schijnpoortweg,2022-12-07,10:00:00,101,19,82,FMN 08 Schijnpoortweg
675,Schijnpoortweg,2022-12-07,11:00:00,125,11,114,FMN 08 Schijnpoortweg
675,Schijnpoortweg,2022-12-07,12:00:00,231,14,217,FMN 08 Schijnpoortweg
675,Schijnpoortweg,2022-12-07,13:00:00,170,18,152,FMN 08 Schijnpoortweg
675,Schijnpoortweg,2022-12-07,14:00:00,125,15,110,FMN 08 Schijnpoortweg
675,Schijnpoortweg,2022-12-07,15:00:00,187,20,167,FMN 08 Schijnpoortweg
675,Schijnpoortweg,2022-12-07,16:00:00,252,29,223,FMN 08 Schijnpoortweg
675,Schijnpoortweg,2022-12-07,17:00:00,246,26,220,FMN 08 Schijnpoortweg
675,Schijnpoortweg,2022-12-07,18:00:00,185,22,163,FMN 08 Schijnpoortweg
675,Schijnpoortweg,2022-12-07,19:00:00,129,13,116,FMN 08 Schijnpoortweg
675,Schijnpoortweg,2022-12-07,20:00:00,93,9,84,FMN 08 Schijnpoortweg
675,Schijnpoortweg,2022-12-07,21:00:00,88,5,83,FMN 08 Schijnpoortweg
675,Schijnpoortweg,2022-12-07,22:00:00,80,12,68,FMN 08 Schijnpoortweg
675,Schijnpoortweg,2022-12-07,23:00:00,39,3,36,FMN 08 Schijnpoortweg
675,Schijnpoortweg,2022-12-08,00:00:00,39,4,35,FMN 08 Schijnpoortweg
675,Schijnpoortweg,2022-12-08,01:00:00,12,3,9,FMN 08 Schijnpoortweg
675,Schijnpoortweg,2022-12-08,02:00:00,14,1,13,FMN 08 Schijnpoortweg
675,Schijnpoortweg,2022-12-08,03:00:00,9,2,7,FMN 08 Schijnpoortweg
675,Schijnpoortweg,2022-12-08,04:00:00,25,12,13,FMN 08 Schijnpoortweg
675,Schijnpoortweg,2022-12-08,05:00:00,57,6,51,FMN 08 Schijnpoortweg
675,Schijnpoortweg,2022-12-08,06:00:00,79,13,66,FMN 08 Schijnpoortweg
675,Schijnpoortweg,2022-12-08,07:00:00,199,19,180,FMN 08 Schijnpoortweg
675,Schijnpoortweg,2022-12-08,08:00:00,225,52,173,FMN 08 Schijnpoortweg
675,Schijnpoortweg,2022-12-08,09:00:00,95,20,75,FMN 08 Schijnpoortweg
675,Schijnpoortweg,2022-12-08,10:00:00,104,20,84,FMN 08 Schijnpoortweg
675,Schijnpoortweg,2022-12-08,11:00:00,102,9,93,FMN 08 Schijnpoortweg
675,Schijnpoortweg,2022-12-08,12:00:00,136,10,126,FMN 08 Schijnpoortweg
675,Schijnpoortweg,2022-12-08,13:00:00,114,7,107,FMN 08 Schijnpoortweg
675,Schijnpoortweg,2022-12-08,14:00:00,104,8,96,FMN 08 Schijnpoortweg
675,Schijnpoortweg,2022-12-08,15:00:00,241,23,218,FMN 08 Schijnpoortweg
675,Schijnpoortweg,2022-12-08,16:00:00,286,28,258,FMN 08 Schijnpoortweg
675,Schijnpoortweg,2022-12-08,17:00:00,301,30,271,FMN 08 Schijnpoortweg
675,Schijnpoortweg,2022-12-08,18:00:00,198,24,174,FMN 08 Schijnpoortweg
675,Schijnpoortweg,2022-12-08,19:00:00,185,38,147,FMN 08 Schijnpoortweg
675,Schijnpoortweg,2022-12-08,20:00:00,129,14,115,FMN 08 Schijnpoortweg
675,Schijnpoortweg,2022-12-08,21:00:00,103,12,91,FMN 08 Schijnpoortweg
675,Schijnpoortweg,2022-12-08,22:00:00,64,11,53,FMN 08 Schijnpoortweg
675,Schijnpoortweg,2022-12-08,23:00:00,103,46,57,FMN 08 Schijnpoortweg
675,Schijnpoortweg,2022-12-09,00:00:00,24,4,20,FMN 08 Schijnpoortweg
675,Schijnpoortweg,2022-12-09,01:00:00,15,3,12,FMN 08 Schijnpoortweg
675,Schijnpoortweg,2022-12-09,02:00:00,18,4,14,FMN 08 Schijnpoortweg
675,Schijnpoortweg,2022-12-09,03:00:00,13,3,10,FMN 08 Schijnpoortweg
675,Schijnpoortweg,2022-12-09,04:00:00,27,11,16,FMN 08 Schijnpoortweg
675,Schijnpoortweg,2022-12-09,05:00:00,47,3,44,FMN 08 Schijnpoortweg
675,Schijnpoortweg,2022-12-09,06:00:00,76,13,63,FMN 08 Schijnpoortweg
675,Schijnpoortweg,2022-12-09,07:00:00,160,14,146,FMN 08 Schijnpoortweg
675,Schijnpoortweg,2022-12-09,08:00:00,185,27,158,FMN 08 Schijnpoortweg
675,Schijnpoortweg,2022-12-09,09:00:00,84,11,73,FMN 08 Schijnpoortweg
675,Schijnpoortweg,2022-12-09,10:00:00,97,13,84,FMN 08 Schijnpoortweg
675,Schijnpoortweg,2022-12-09,11:00:00,121,10,111,FMN 08 Schijnpoortweg
675,Schijnpoortweg,2022-12-09,12:00:00,144,19,125,FMN 08 Schijnpoortweg
675,Schijnpoortweg,2022-12-09,13:00:00,126,17,109,FMN 08 Schijnpoortweg
675,Schijnpoortweg,2022-12-09,14:00:00,135,14,121,FMN 08 Schijnpoortweg
675,Schijnpoortweg,2022-12-09,15:00:00,225,12,213,FMN 08 Schijnpoortweg
675,Schijnpoortweg,2022-12-09,16:00:00,255,19,236,FMN 08 Schijnpoortweg
675,Schijnpoortweg,2022-12-09,17:00:00,236,19,217,FMN 08 Schijnpoortweg
675,Schijnpoortweg,2022-12-09,18:00:00,175,21,154,FMN 08 Schijnpoortweg
675,Schijnpoortweg,2022-12-09,19:00:00,162,38,124,FMN 08 Schijnpoortweg
675,Schijnpoortweg,2022-12-09,20:00:00,138,18,120,FMN 08 Schijnpoortweg
675,Schijnpoortweg,2022-12-09,21:00:00,81,8,73,FMN 08 Schijnpoortweg
675,Schijnpoortweg,2022-12-09,22:00:00,77,25,52,FMN 08 Schijnpoortweg
675,Schijnpoortweg,2022-12-09,23:00:00,125,53,72,FMN 08 Schijnpoortweg
675,Schijnpoortweg,2022-12-10,00:00:00,59,10,49,FMN 08 Schijnpoortweg
675,Schijnpoortweg,2022-12-10,01:00:00,32,3,29,FMN 08 Schijnpoortweg
675,Schijnpoortweg,2022-12-10,02:00:00,21,4,17,FMN 08 Schijnpoortweg
675,Schijnpoortweg,2022-12-10,03:00:00,13,2,11,FMN 08 Schijnpoortweg
675,Schijnpoortweg,2022-12-10,04:00:00,14,3,11,FMN 08 Schijnpoortweg
675,Schijnpoortweg,2022-12-10,05:00:00,14,3,11,FMN 08 Schijnpoortweg
675,Schijnpoortweg,2022-12-10,06:00:00,31,12,19,FMN 08 Schijnpoortweg
675,Schijnpoortweg,2022-12-10,07:00:00,32,4,28,FMN 08 Schijnpoortweg
675,Schijnpoortweg,2022-12-10,08:00:00,46,4,42,FMN 08 Schijnpoortweg
675,Schijnpoortweg,2022-12-10,09:00:00,54,9,45,FMN 08 Schijnpoortweg
675,Schijnpoortweg,2022-12-10,10:00:00,65,10,55,FMN 08 Schijnpoortweg
675,Schijnpoortweg,2022-12-10,11:00:00,72,14,58,FMN 08 Schijnpoortweg
675,Schijnpoortweg,2022-12-10,12:00:00,94,9,85,FMN 08 Schijnpoortweg
675,Schijnpoortweg,2022-12-10,13:00:00,85,11,74,FMN 08 Schijnpoortweg
675,Schijnpoortweg,2022-12-10,14:00:00,107,12,95,FMN 08 Schijnpoortweg
675,Schijnpoortweg,2022-12-10,15:00:00,140,13,127,FMN 08 Schijnpoortweg
675,Schijnpoortweg,2022-12-10,16:00:00,84,12,72,FMN 08 Schijnpoortweg
675,Schijnpoortweg,2022-12-10,17:00:00,101,21,80,FMN 08 Schijnpoortweg
675,Schijnpoortweg,2022-12-10,18:00:00,147,29,118,FMN 08 Schijnpoortweg
675,Schijnpoortweg,2022-12-10,19:00:00,211,21,190,FMN 08 Schijnpoortweg
675,Schijnpoortweg,2022-12-10,20:00:00,365,33,332,FMN 08 Schijnpoortweg
675,Schijnpoortweg,2022-12-10,21:00:00,59,7,52,FMN 08 Schijnpoortweg
675,Schijnpoortweg,2022-12-10,22:00:00,70,17,53,FMN 08 Schijnpoortweg
675,Schijnpoortweg,2022-12-10,23:00:00,299,231,68,FMN 08 Schijnpoortweg
675,Schijnpoortweg,2022-12-11,00:00:00,47,5,42,FMN 08 Schijnpoortweg
675,Schijnpoortweg,2022-12-11,01:00:00,30,2,28,FMN 08 Schijnpoortweg
675,Schijnpoortweg,2022-12-11,02:00:00,27,7,20,FMN 08 Schijnpoortweg
675,Schijnpoortweg,2022-12-11,03:00:00,17,5,12,FMN 08 Schijnpoortweg
675,Schijnpoortweg,2022-12-11,04:00:00,10,3,7,FMN 08 Schijnpoortweg
675,Schijnpoortweg,2022-12-11,05:00:00,12,3,9,FMN 08 Schijnpoortweg
675,Schijnpoortweg,2022-12-11,06:00:00,20,4,16,FMN 08 Schijnpoortweg
675,Schijnpoortweg,2022-12-11,07:00:00,14,2,12,FMN 08 Schijnpoortweg
675,Schijnpoortweg,2022-12-11,08:00:00,25,6,19,FMN 08 Schijnpoortweg
675,Schijnpoortweg,2022-12-11,09:00:00,36,3,33,FMN 08 Schijnpoortweg
675,Schijnpoortweg,2022-12-11,10:00:00,76,14,62,FMN 08 Schijnpoortweg
675,Schijnpoortweg,2022-12-11,11:00:00,59,6,53,FMN 08 Schijnpoortweg
675,Schijnpoortweg,2022-12-11,12:00:00,61,10,51,FMN 08 Schijnpoortweg
675,Schijnpoortweg,2022-12-11,13:00:00,101,13,88,FMN 08 Schijnpoortweg
675,Schijnpoortweg,2022-12-11,14:00:00,74,6,68,FMN 08 Schijnpoortweg
675,Schijnpoortweg,2022-12-11,15:00:00,91,16,75,FMN 08 Schijnpoortweg
675,Schijnpoortweg,2022-12-11,16:00:00,78,12,66,FMN 08 Schijnpoortweg
675,Schijnpoortweg,2022-12-11,17:00:00,103,13,90,FMN 08 Schijnpoortweg
675,Schijnpoortweg,2022-12-11,18:00:00,78,12,66,FMN 08 Schijnpoortweg
675,Schijnpoortweg,2022-12-11,19:00:00,66,13,53,FMN 08 Schijnpoortweg
675,Schijnpoortweg,2022-12-11,20:00:00,59,4,55,FMN 08 Schijnpoortweg
675,Schijnpoortweg,2022-12-11,21:00:00,64,13,51,FMN 08 Schijnpoortweg
675,Schijnpoortweg,2022-12-11,22:00:00,59,6,53,FMN 08 Schijnpoortweg
675,Schijnpoortweg,2022-12-11,23:00:00,38,3,35,FMN 08 Schijnpoortweg
675,Schijnpoortweg,2022-12-12,00:00:00,18,2,16,FMN 08 Schijnpoortweg
675,Schijnpoortweg,2022-12-12,01:00:00,14,1,13,FMN 08 Schijnpoortweg
675,Schijnpoortweg,2022-12-12,02:00:00,12,2,10,FMN 08 Schijnpoortweg
675,Schijnpoortweg,2022-12-12,03:00:00,9,3,6,FMN 08 Schijnpoortweg
675,Schijnpoortweg,2022-12-12,04:00:00,17,6,11,FMN 08 Schijnpoortweg
675,Schijnpoortweg,2022-12-12,05:00:00,37,4,33,FMN 08 Schijnpoortweg
675,Schijnpoortweg,2022-12-12,06:00:00,52,12,40,FMN 08 Schijnpoortweg
675,Schijnpoortweg,2022-12-12,07:00:00,51,4,47,FMN 08 Schijnpoortweg
675,Schijnpoortweg,2022-12-12,08:00:00,27,1,26,FMN 08 Schijnpoortweg
675,Schijnpoortweg,2022-12-12,09:00:00,31,11,20,FMN 08 Schijnpoortweg
675,Schijnpoortweg,2022-12-12,10:00:00,76,13,63,FMN 08 Schijnpoortweg
675,Schijnpoortweg,2022-12-12,11:00:00,99,15,84,FMN 08 Schijnpoortweg
675,Schijnpoortweg,2022-12-12,12:00:00,142,22,120,FMN 08 Schijnpoortweg
675,Schijnpoortweg,2022-12-12,13:00:00,113,9,104,FMN 08 Schijnpoortweg
675,Schijnpoortweg,2022-12-12,14:00:00,133,10,123,FMN 08 Schijnpoortweg
675,Schijnpoortweg,2022-12-12,15:00:00,200,12,188,FMN 08 Schijnpoortweg
675,Schijnpoortweg,2022-12-12,16:00:00,256,26,230,FMN 08 Schijnpoortweg
675,Schijnpoortweg,2022-12-12,17:00:00,257,16,241,FMN 08 Schijnpoortweg
675,Schijnpoortweg,2022-12-12,18:00:00,169,19,150,FMN 08 Schijnpoortweg
675,Schijnpoortweg,2022-12-12,19:00:00,123,7,116,FMN 08 Schijnpoortweg
675,Schijnpoortweg,2022-12-12,20:00:00,68,6,62,FMN 08 Schijnpoortweg
675,Schijnpoortweg,2022-12-12,21:00:00,67,5,62,FMN 08 Schijnpoortweg
675,Schijnpoortweg,2022-12-12,22:00:00,62,13,49,FMN 08 Schijnpoortweg
675,Schijnpoortweg,2022-12-12,23:00:00,36,3,33,FMN 08 Schijnpoortweg
675,Schijnpoortweg,2022-12-13,00:00:00,13,2,11,FMN 08 Schijnpoortweg
675,Schijnpoortweg,2022-12-13,01:00:00,7,4,3,FMN 08 Schijnpoortweg
675,Schijnpoortweg,2022-12-13,02:00:00,9,1,8,FMN 08 Schijnpoortweg
675,Schijnpoortweg,2022-12-13,03:00:00,7,1,6,FMN 08 Schijnpoortweg
675,Schijnpoortweg,2022-12-13,04:00:00,20,10,10,FMN 08 Schijnpoortweg
675,Schijnpoortweg,2022-12-13,05:00:00,51,6,45,FMN 08 Schijnpoortweg
675,Schijnpoortweg,2022-12-13,06:00:00,81,17,64,FMN 08 Schijnpoortweg
675,Schijnpoortweg,2022-12-13,07:00:00,170,16,154,FMN 08 Schijnpoortweg
675,Schijnpoortweg,2022-12-13,08:00:00,221,30,191,FMN 08 Schijnpoortweg
675,Schijnpoortweg,2022-12-13,09:00:00,92,13,79,FMN 08 Schijnpoortweg
675,Schijnpoortweg,2022-12-13,10:00:00,83,16,67,FMN 08 Schijnpoortweg
675,Schijnpoortweg,2022-12-13,11:00:00,84,9,75,FMN 08 Schijnpoortweg
675,Schijnpoortweg,2022-12-13,12:00:00,112,11,101,FMN 08 Schijnpoortweg
675,Schijnpoortweg,2022-12-13,13:00:00,108,13,95,FMN 08 Schijnpoortweg
675,Schijnpoortweg,2022-12-13,14:00:00,135,13,122,FMN 08 Schijnpoortweg
675,Schijnpoortweg,2022-12-13,15:00:00,204,9,195,FMN 08 Schijnpoortweg
675,Schijnpoortweg,2022-12-13,16:00:00,263,18,245,FMN 08 Schijnpoortweg
675,Schijnpoortweg,2022-12-13,17:00:00,258,22,236,FMN 08 Schijnpoortweg
675,Schijnpoortweg,2022-12-13,18:00:00,165,16,149,FMN 08 Schijnpoortweg
675,Schijnpoortweg,2022-12-13,19:00:00,125,15,110,FMN 08 Schijnpoortweg
675,Schijnpoortweg,2022-12-13,20:00:00,65,5,60,FMN 08 Schijnpoortweg
675,Schijnpoortweg,2022-12-13,21:00:00,58,5,53,FMN 08 Schijnpoortweg
675,Schijnpoortweg,2022-12-13,22:00:00,82,21,61,FMN 08 Schijnpoortweg
675,Schijnpoortweg,2022-12-13,23:00:00,43,6,37,FMN 08 Schijnpoortweg
675,Schijnpoortweg,2022-12-14,00:00:00,18,0,18,FMN 08 Schijnpoortweg
675,Schijnpoortweg,2022-12-14,01:00:00,14,3,11,FMN 08 Schijnpoortweg
675,Schijnpoortweg,2022-12-14,02:00:00,15,1,14,FMN 08 Schijnpoortweg
675,Schijnpoortweg,2022-12-14,03:00:00,8,1,7,FMN 08 Schijnpoortweg
675,Schijnpoortweg,2022-12-14,04:00:00,24,8,16,FMN 08 Schijnpoortweg
675,Schijnpoortweg,2022-12-14,05:00:00,46,10,36,FMN 08 Schijnpoortweg
675,Schijnpoortweg,2022-12-14,06:00:00,71,8,63,FMN 08 Schijnpoortweg
675,Schijnpoortweg,2022-12-14,07:00:00,148,10,138,FMN 08 Schijnpoortweg
675,Schijnpoortweg,2022-12-14,08:00:00,181,31,150,FMN 08 Schijnpoortweg
675,Schijnpoortweg,2022-12-14,09:00:00,87,7,80,FMN 08 Schijnpoortweg
675,Schijnpoortweg,2022-12-14,10:00:00,108,11,97,FMN 08 Schijnpoortweg
675,Schijnpoortweg,2022-12-14,11:00:00,94,8,86,FMN 08 Schijnpoortweg
675,Schijnpoortweg,2022-12-14,12:00:00,182,16,166,FMN 08 Schijnpoortweg
675,Schijnpoortweg,2022-12-14,13:00:00,134,8,126,FMN 08 Schijnpoortweg
675,Schijnpoortweg,2022-12-14,14:00:00,117,10,107,FMN 08 Schijnpoortweg
675,Schijnpoortweg,2022-12-14,15:00:00,171,24,147,FMN 08 Schijnpoortweg
675,Schijnpoortweg,2022-12-14,16:00:00,211,33,178,FMN 08 Schijnpoortweg
675,Schijnpoortweg,2022-12-14,17:00:00,219,20,199,FMN 08 Schijnpoortweg
675,Schijnpoortweg,2022-12-14,18:00:00,160,28,132,FMN 08 Schijnpoortweg
675,Schijnpoortweg,2022-12-14,19:00:00,124,20,104,FMN 08 Schijnpoortweg
675,Schijnpoortweg,2022-12-14,20:00:00,72,10,62,FMN 08 Schijnpoortweg
675,Schijnpoortweg,2022-12-14,21:00:00,80,7,73,FMN 08 Schijnpoortweg
675,Schijnpoortweg,2022-12-14,22:00:00,90,23,67,FMN 08 Schijnpoortweg
675,Schijnpoortweg,2022-12-14,23:00:00,34,3,31,FMN 08 Schijnpoortweg
675,Schijnpoortweg,2022-12-15,00:00:00,33,3,30,FMN 08 Schijnpoortweg
675,Schijnpoortweg,2022-12-15,01:00:00,15,3,12,FMN 08 Schijnpoortweg
675,Schijnpoortweg,2022-12-15,02:00:00,14,2,12,FMN 08 Schijnpoortweg
675,Schijnpoortweg,2022-12-15,03:00:00,5,2,3,FMN 08 Schijnpoortweg
675,Schijnpoortweg,2022-12-15,04:00:00,22,13,9,FMN 08 Schijnpoortweg
675,Schijnpoortweg,2022-12-15,05:00:00,43,4,39,FMN 08 Schijnpoortweg
675,Schijnpoortweg,2022-12-15,06:00:00,84,18,66,FMN 08 Schijnpoortweg
675,Schijnpoortweg,2022-12-15,07:00:00,149,16,133,FMN 08 Schijnpoortweg
675,Schijnpoortweg,2022-12-15,08:00:00,201,38,163,FMN 08 Schijnpoortweg
675,Schijnpoortweg,2022-12-15,09:00:00,100,13,87,FMN 08 Schijnpoortweg
675,Schijnpoortweg,2022-12-15,10:00:00,79,15,64,FMN 08 Schijnpoortweg
675,Schijnpoortweg,2022-12-15,11:00:00,105,21,84,FMN 08 Schijnpoortweg
675,Schijnpoortweg,2022-12-15,12:00:00,123,25,98,FMN 08 Schijnpoortweg
675,Schijnpoortweg,2022-12-15,13:00:00,134,16,118,FMN 08 Schijnpoortweg
675,Schijnpoortweg,2022-12-15,14:00:00,115,11,104,FMN 08 Schijnpoortweg
675,Schijnpoortweg,2022-12-15,15:00:00,206,19,187,FMN 08 Schijnpoortweg
675,Schijnpoortweg,2022-12-15,16:00:00,263,25,238,FMN 08 Schijnpoortweg
675,Schijnpoortweg,2022-12-15,17:00:00,266,22,244,FMN 08 Schijnpoortweg
675,Schijnpoortweg,2022-12-15,18:00:00,235,41,194,FMN 08 Schijnpoortweg
675,Schijnpoortweg,2022-12-15,19:00:00,182,46,136,FMN 08 Schijnpoortweg
675,Schijnpoortweg,2022-12-15,20:00:00,101,8,93,FMN 08 Schijnpoortweg
675,Schijnpoortweg,2022-12-15,21:00:00,90,17,73,FMN 08 Schijnpoortweg
675,Schijnpoortweg,2022-12-15,22:00:00,88,21,67,FMN 08 Schijnpoortweg
675,Schijnpoortweg,2022-12-15,23:00:00,69,22,47,FMN 08 Schijnpoortweg
675,Schijnpoortweg,2022-12-16,00:00:00,74,38,36,FMN 08 Schijnpoortweg
675,Schijnpoortweg,2022-12-16,01:00:00,39,21,18,FMN 08 Schijnpoortweg
675,Schijnpoortweg,2022-12-16,02:00:00,17,4,13,FMN 08 Schijnpoortweg
675,Schijnpoortweg,2022-12-16,03:00:00,13,5,8,FMN 08 Schijnpoortweg
675,Schijnpoortweg,2022-12-16,04:00:00,20,14,6,FMN 08 Schijnpoortweg
675,Schijnpoortweg,2022-12-16,05:00:00,48,7,41,FMN 08 Schijnpoortweg
675,Schijnpoortweg,2022-12-16,06:00:00,88,19,69,FMN 08 Schijnpoortweg
675,Schijnpoortweg,2022-12-16,07:00:00,157,26,131,FMN 08 Schijnpoortweg
675,Schijnpoortweg,2022-12-16,08:00:00,207,39,168,FMN 08 Schijnpoortweg
675,Schijnpoortweg,2022-12-16,09:00:00,95,10,85,FMN 08 Schijnpoortweg
675,Schijnpoortweg,2022-12-16,10:00:00,110,18,92,FMN 08 Schijnpoortweg
675,Schijnpoortweg,2022-12-16,11:00:00,126,18,108,FMN 08 Schijnpoortweg
675,Schijnpoortweg,2022-12-16,12:00:00,153,27,126,FMN 08 Schijnpoortweg
675,Schijnpoortweg,2022-12-16,13:00:00,137,12,125,FMN 08 Schijnpoortweg
675,Schijnpoortweg,2022-12-16,14:00:00,174,17,157,FMN 08 Schijnpoortweg
675,Schijnpoortweg,2022-12-16,15:00:00,258,32,226,FMN 08 Schijnpoortweg
675,Schijnpoortweg,2022-12-16,16:00:00,259,32,227,FMN 08 Schijnpoortweg
675,Schijnpoortweg,2022-12-16,17:00:00,247,30,217,FMN 08 Schijnpoortweg
675,Schijnpoortweg,2022-12-16,18:00:00,232,57,175,FMN 08 Schijnpoortweg
675,Schijnpoortweg,2022-12-16,19:00:00,202,53,149,FMN 08 Schijnpoortweg
675,Schijnpoortweg,2022-12-16,20:00:00,119,29,90,FMN 08 Schijnpoortweg
675,Schijnpoortweg,2022-12-16,21:00:00,112,22,90,FMN 08 Schijnpoortweg
675,Schijnpoortweg,2022-12-16,22:00:00,93,18,75,FMN 08 Schijnpoortweg
675,Schijnpoortweg,2022-12-16,23:00:00,103,29,74,FMN 08 Schijnpoortweg
675,Schijnpoortweg,2022-12-17,00:00:00,108,58,50,FMN 08 Schijnpoortweg
675,Schijnpoortweg,2022-12-17,01:00:00,33,3,30,FMN 08 Schijnpoortweg
675,Schijnpoortweg,2022-12-17,02:00:00,24,6,18,FMN 08 Schijnpoortweg
675,Schijnpoortweg,2022-12-17,03:00:00,24,6,18,FMN 08 Schijnpoortweg
675,Schijnpoortweg,2022-12-17,04:00:00,13,5,8,FMN 08 Schijnpoortweg
675,Schijnpoortweg,2022-12-17,05:00:00,22,5,17,FMN 08 Schijnpoortweg
675,Schijnpoortweg,2022-12-17,06:00:00,26,7,19,FMN 08 Schijnpoortweg
675,Schijnpoortweg,2022-12-17,07:00:00,30,3,27,FMN 08 Schijnpoortweg
675,Schijnpoortweg,2022-12-17,08:00:00,45,8,37,FMN 08 Schijnpoortweg
675,Schijnpoortweg,2022-12-17,09:00:00,61,15,46,FMN 08 Schijnpoortweg
675,Schijnpoortweg,2022-12-17,10:00:00,71,17,54,FMN 08 Schijnpoortweg
675,Schijnpoortweg,2022-12-17,11:00:00,73,22,51,FMN 08 Schijnpoortweg
675,Schijnpoortweg,2022-12-17,12:00:00,92,28,64,FMN 08 Schijnpoortweg
675,Schijnpoortweg,2022-12-17,13:00:00,101,23,78,FMN 08 Schijnpoortweg
675,Schijnpoortweg,2022-12-17,14:00:00,99,20,79,FMN 08 Schijnpoortweg
675,Schijnpoortweg,2022-12-17,15:00:00,114,22,92,FMN 08 Schijnpoortweg
675,Schijnpoortweg,2022-12-17,16:00:00,101,16,85,FMN 08 Schijnpoortweg
675,Schijnpoortweg,2022-12-17,17:00:00,113,25,88,FMN 08 Schijnpoortweg
675,Schijnpoortweg,2022-12-17,18:00:00,154,65,89,FMN 08 Schijnpoortweg
675,Schijnpoortweg,2022-12-17,19:00:00,153,36,117,FMN 08 Schijnpoortweg
675,Schijnpoortweg,2022-12-17,20:00:00,98,17,81,FMN 08 Schijnpoortweg
675,Schijnpoortweg,2022-12-17,21:00:00,66,13,53,FMN 08 Schijnpoortweg
675,Schijnpoortweg,2022-12-17,22:00:00,84,29,55,FMN 08 Schijnpoortweg
675,Schijnpoortweg,2022-12-17,23:00:00,82,32,50,FMN 08 Schijnpoortweg
675,Schijnpoortweg,2022-12-18,00:00:00,53,31,22,FMN 08 Schijnpoortweg
675,Schijnpoortweg,2022-12-18,01:00:00,23,5,18,FMN 08 Schijnpoortweg
675,Schijnpoortweg,2022-12-18,02:00:00,25,2,23,FMN 08 Schijnpoortweg
675,Schijnpoortweg,2022-12-18,03:00:00,11,5,6,FMN 08 Schijnpoortweg
675,Schijnpoortweg,2022-12-18,04:00:00,16,2,14,FMN 08 Schijnpoortweg
675,Schijnpoortweg,2022-12-18,05:00:00,4,3,1,FMN 08 Schijnpoortweg
675,Schijnpoortweg,2022-12-18,06:00:00,15,2,13,FMN 08 Schijnpoortweg
675,Schijnpoortweg,2022-12-18,07:00:00,15,3,12,FMN 08 Schijnpoortweg
675,Schijnpoortweg,2022-12-18,08:00:00,26,2,24,FMN 08 Schijnpoortweg
675,Schijnpoortweg,2022-12-18,09:00:00,49,15,34,FMN 08 Schijnpoortweg
675,Schijnpoortweg,2022-12-18,10:00:00,67,12,55,FMN 08 Schijnpoortweg
675,Schijnpoortweg,2022-12-18,11:00:00,50,9,41,FMN 08 Schijnpoortweg
675,Schijnpoortweg,2022-12-18,12:00:00,62,9,53,FMN 08 Schijnpoortweg
675,Schijnpoortweg,2022-12-18,13:00:00,89,38,51,FMN 08 Schijnpoortweg
675,Schijnpoortweg,2022-12-18,14:00:00,90,14,76,FMN 08 Schijnpoortweg
675,Schijnpoortweg,2022-12-18,15:00:00,77,11,66,FMN 08 Schijnpoortweg
675,Schijnpoortweg,2022-12-18,16:00:00,69,16,53,FMN 08 Schijnpoortweg
675,Schijnpoortweg,2022-12-18,17:00:00,75,16,59,FMN 08 Schijnpoortweg
675,Schijnpoortweg,2022-12-18,18:00:00,49,10,39,FMN 08 Schijnpoortweg
675,Schijnpoortweg,2022-12-18,19:00:00,58,11,47,FMN 08 Schijnpoortweg
675,Schijnpoortweg,2022-12-18,20:00:00,61,9,52,FMN 08 Schijnpoortweg
675,Schijnpoortweg,2022-12-18,21:00:00,28,4,24,FMN 08 Schijnpoortweg
675,Schijnpoortweg,2022-12-18,22:00:00,40,2,38,FMN 08 Schijnpoortweg
675,Schijnpoortweg,2022-12-18,23:00:00,18,1,17,FMN 08 Schijnpoortweg
675,Schijnpoortweg,2022-12-19,00:00:00,20,3,17,FMN 08 Schijnpoortweg
675,Schijnpoortweg,2022-12-19,01:00:00,11,4,7,FMN 08 Schijnpoortweg
675,Schijnpoortweg,2022-12-19,02:00:00,21,5,16,FMN 08 Schijnpoortweg
675,Schijnpoortweg,2022-12-19,03:00:00,10,3,7,FMN 08 Schijnpoortweg
675,Schijnpoortweg,2022-12-19,04:00:00,22,8,14,FMN 08 Schijnpoortweg
675,Schijnpoortweg,2022-12-19,05:00:00,41,5,36,FMN 08 Schijnpoortweg
675,Schijnpoortweg,2022-12-19,06:00:00,75,12,63,FMN 08 Schijnpoortweg
675,Schijnpoortweg,2022-12-19,07:00:00,150,27,123,FMN 08 Schijnpoortweg
675,Schijnpoortweg,2022-12-19,08:00:00,177,26,151,FMN 08 Schijnpoortweg
675,Schijnpoortweg,2022-12-19,09:00:00,82,14,68,FMN 08 Schijnpoortweg
675,Schijnpoortweg,2022-12-19,10:00:00,72,7,65,FMN 08 Schijnpoortweg
675,Schijnpoortweg,2022-12-19,11:00:00,72,9,63,FMN 08 Schijnpoortweg
675,Schijnpoortweg,2022-12-19,12:00:00,108,13,95,FMN 08 Schijnpoortweg
675,Schijnpoortweg,2022-12-19,13:00:00,96,9,87,FMN 08 Schijnpoortweg
675,Schijnpoortweg,2022-12-19,14:00:00,111,20,91,FMN 08 Schijnpoortweg
675,Schijnpoortweg,2022-12-19,15:00:00,197,13,184,FMN 08 Schijnpoortweg
675,Schijnpoortweg,2022-12-19,16:00:00,248,25,223,FMN 08 Schijnpoortweg
675,Schijnpoortweg,2022-12-19,17:00:00,206,21,185,FMN 08 Schijnpoortweg
675,Schijnpoortweg,2022-12-19,18:00:00,182,13,169,FMN 08 Schijnpoortweg
675,Schijnpoortweg,2022-12-19,19:00:00,122,10,112,FMN 08 Schijnpoortweg
675,Schijnpoortweg,2022-12-19,20:00:00,78,9,69,FMN 08 Schijnpoortweg
675,Schijnpoortweg,2022-12-19,21:00:00,84,7,77,FMN 08 Schijnpoortweg
675,Schijnpoortweg,2022-12-19,22:00:00,71,8,63,FMN 08 Schijnpoortweg
675,Schijnpoortweg,2022-12-19,23:00:00,49,10,39,FMN 08 Schijnpoortweg
675,Schijnpoortweg,2022-12-20,00:00:00,16,2,14,FMN 08 Schijnpoortweg
675,Schijnpoortweg,2022-12-20,01:00:00,23,8,15,FMN 08 Schijnpoortweg
675,Schijnpoortweg,2022-12-20,02:00:00,11,0,11,FMN 08 Schijnpoortweg
675,Schijnpoortweg,2022-12-20,03:00:00,7,4,3,FMN 08 Schijnpoortweg
675,Schijnpoortweg,2022-12-20,04:00:00,21,10,11,FMN 08 Schijnpoortweg
675,Schijnpoortweg,2022-12-20,05:00:00,57,6,51,FMN 08 Schijnpoortweg
675,Schijnpoortweg,2022-12-20,06:00:00,84,10,74,FMN 08 Schijnpoortweg
675,Schijnpoortweg,2022-12-20,07:00:00,156,16,140,FMN 08 Schijnpoortweg
675,Schijnpoortweg,2022-12-20,08:00:00,160,23,137,FMN 08 Schijnpoortweg
675,Schijnpoortweg,2022-12-20,09:00:00,70,8,62,FMN 08 Schijnpoortweg
675,Schijnpoortweg,2022-12-20,10:00:00,63,6,57,FMN 08 Schijnpoortweg
675,Schijnpoortweg,2022-12-20,11:00:00,71,9,62,FMN 08 Schijnpoortweg
675,Schijnpoortweg,2022-12-20,12:00:00,97,8,89,FMN 08 Schijnpoortweg
675,Schijnpoortweg,2022-12-20,13:00:00,76,5,71,FMN 08 Schijnpoortweg
675,Schijnpoortweg,2022-12-20,14:00:00,89,12,77,FMN 08 Schijnpoortweg
675,Schijnpoortweg,2022-12-20,15:00:00,174,9,165,FMN 08 Schijnpoortweg
675,Schijnpoortweg,2022-12-20,16:00:00,211,20,191,FMN 08 Schijnpoortweg
675,Schijnpoortweg,2022-12-20,17:00:00,190,19,171,FMN 08 Schijnpoortweg
675,Schijnpoortweg,2022-12-20,18:00:00,161,13,148,FMN 08 Schijnpoortweg
675,Schijnpoortweg,2022-12-20,19:00:00,143,15,128,FMN 08 Schijnpoortweg
675,Schijnpoortweg,2022-12-20,20:00:00,78,8,70,FMN 08 Schijnpoortweg
675,Schijnpoortweg,2022-12-20,21:00:00,62,7,55,FMN 08 Schijnpoortweg
675,Schijnpoortweg,2022-12-20,22:00:00,70,7,63,FMN 08 Schijnpoortweg
675,Schijnpoortweg,2022-12-20,23:00:00,42,17,25,FMN 08 Schijnpoortweg
675,Schijnpoortweg,2022-12-21,00:00:00,28,7,21,FMN 08 Schijnpoortweg
675,Schijnpoortweg,2022-12-21,01:00:00,14,1,13,FMN 08 Schijnpoortweg
675,Schijnpoortweg,2022-12-21,02:00:00,13,2,11,FMN 08 Schijnpoortweg
675,Schijnpoortweg,2022-12-21,03:00:00,12,5,7,FMN 08 Schijnpoortweg
675,Schijnpoortweg,2022-12-21,04:00:00,24,9,15,FMN 08 Schijnpoortweg
675,Schijnpoortweg,2022-12-21,05:00:00,56,8,48,FMN 08 Schijnpoortweg
675,Schijnpoortweg,2022-12-21,06:00:00,86,17,69,FMN 08 Schijnpoortweg
675,Schijnpoortweg,2022-12-21,07:00:00,142,16,126,FMN 08 Schijnpoortweg
675,Schijnpoortweg,2022-12-21,08:00:00,164,23,141,FMN 08 Schijnpoortweg
675,Schijnpoortweg,2022-12-21,09:00:00,77,5,72,FMN 08 Schijnpoortweg
675,Schijnpoortweg,2022-12-21,10:00:00,96,11,85,FMN 08 Schijnpoortweg
675,Schijnpoortweg,2022-12-21,11:00:00,111,14,97,FMN 08 Schijnpoortweg
675,Schijnpoortweg,2022-12-21,12:00:00,156,19,137,FMN 08 Schijnpoortweg
675,Schijnpoortweg,2022-12-21,13:00:00,139,19,120,FMN 08 Schijnpoortweg
675,Schijnpoortweg,2022-12-21,14:00:00,121,20,101,FMN 08 Schijnpoortweg
675,Schijnpoortweg,2022-12-21,15:00:00,168,17,151,FMN 08 Schijnpoortweg
675,Schijnpoortweg,2022-12-21,16:00:00,216,26,190,FMN 08 Schijnpoortweg
675,Schijnpoortweg,2022-12-21,17:00:00,185,18,167,FMN 08 Schijnpoortweg
675,Schijnpoortweg,2022-12-21,18:00:00,155,20,135,FMN 08 Schijnpoortweg
675,Schijnpoortweg,2022-12-21,19:00:00,95,11,84,FMN 08 Schijnpoortweg
675,Schijnpoortweg,2022-12-21,20:00:00,78,6,72,FMN 08 Schijnpoortweg
675,Schijnpoortweg,2022-12-21,21:00:00,95,13,82,FMN 08 Schijnpoortweg
675,Schijnpoortweg,2022-12-21,22:00:00,83,10,73,FMN 08 Schijnpoortweg
675,Schijnpoortweg,2022-12-21,23:00:00,49,6,43,FMN 08 Schijnpoortweg
675,Schijnpoortweg,2022-12-22,00:00:00,30,4,26,FMN 08 Schijnpoortweg
675,Schijnpoortweg,2022-12-22,01:00:00,24,3,21,FMN 08 Schijnpoortweg
675,Schijnpoortweg,2022-12-22,02:00:00,11,1,10,FMN 08 Schijnpoortweg
675,Schijnpoortweg,2022-12-22,03:00:00,9,2,7,FMN 08 Schijnpoortweg
675,Schijnpoortweg,2022-12-22,04:00:00,17,6,11,FMN 08 Schijnpoortweg
675,Schijnpoortweg,2022-12-22,05:00:00,40,8,32,FMN 08 Schijnpoortweg
675,Schijnpoortweg,2022-12-22,06:00:00,63,11,52,FMN 08 Schijnpoortweg
675,Schijnpoortweg,2022-12-22,07:00:00,128,12,116,FMN 08 Schijnpoortweg
675,Schijnpoortweg,2022-12-22,08:00:00,162,27,135,FMN 08 Schijnpoortweg
675,Schijnpoortweg,2022-12-22,09:00:00,97,16,81,FMN 08 Schijnpoortweg
675,Schijnpoortweg,2022-12-22,10:00:00,99,17,82,FMN 08 Schijnpoortweg
675,Schijnpoortweg,2022-12-22,11:00:00,85,9,76,FMN 08 Schijnpoortweg
675,Schijnpoortweg,2022-12-22,12:00:00,133,17,116,FMN 08 Schijnpoortweg
675,Schijnpoortweg,2022-12-22,13:00:00,120,12,108,FMN 08 Schijnpoortweg
675,Schijnpoortweg,2022-12-22,14:00:00,124,14,110,FMN 08 Schijnpoortweg
675,Schijnpoortweg,2022-12-22,15:00:00,169,10,159,FMN 08 Schijnpoortweg
675,Schijnpoortweg,2022-12-22,16:00:00,212,19,193,FMN 08 Schijnpoortweg
675,Schijnpoortweg,2022-12-22,17:00:00,248,22,226,FMN 08 Schijnpoortweg
675,Schijnpoortweg,2022-12-22,18:00:00,135,22,113,FMN 08 Schijnpoortweg
675,Schijnpoortweg,2022-12-22,19:00:00,140,21,119,FMN 08 Schijnpoortweg
675,Schijnpoortweg,2022-12-22,20:00:00,91,9,82,FMN 08 Schijnpoortweg
675,Schijnpoortweg,2022-12-22,21:00:00,84,12,72,FMN 08 Schijnpoortweg
675,Schijnpoortweg,2022-12-22,22:00:00,87,17,70,FMN 08 Schijnpoortweg
675,Schijnpoortweg,2022-12-22,23:00:00,56,8,48,FMN 08 Schijnpoortweg
675,Schijnpoortweg,2022-12-23,00:00:00,43,8,35,FMN 08 Schijnpoortweg
675,Schijnpoortweg,2022-12-23,01:00:00,29,5,24,FMN 08 Schijnpoortweg
675,Schijnpoortweg,2022-12-23,02:00:00,20,1,19,FMN 08 Schijnpoortweg
675,Schijnpoortweg,2022-12-23,03:00:00,18,6,12,FMN 08 Schijnpoortweg
675,Schijnpoortweg,2022-12-23,04:00:00,19,5,14,FMN 08 Schijnpoortweg
675,Schijnpoortweg,2022-12-23,05:00:00,47,9,38,FMN 08 Schijnpoortweg
675,Schijnpoortweg,2022-12-23,06:00:00,67,15,52,FMN 08 Schijnpoortweg
675,Schijnpoortweg,2022-12-23,07:00:00,119,15,104,FMN 08 Schijnpoortweg
675,Schijnpoortweg,2022-12-23,08:00:00,126,17,109,FMN 08 Schijnpoortweg
675,Schijnpoortweg,2022-12-23,09:00:00,70,9,61,FMN 08 Schijnpoortweg
675,Schijnpoortweg,2022-12-23,10:00:00,75,11,64,FMN 08 Schijnpoortweg
675,Schijnpoortweg,2022-12-23,11:00:00,87,10,77,FMN 08 Schijnpoortweg
675,Schijnpoortweg,2022-12-23,12:00:00,94,9,85,FMN 08 Schijnpoortweg
675,Schijnpoortweg,2022-12-23,13:00:00,72,9,63,FMN 08 Schijnpoortweg
675,Schijnpoortweg,2022-12-23,14:00:00,114,22,92,FMN 08 Schijnpoortweg
675,Schijnpoortweg,2022-12-23,15:00:00,160,30,130,FMN 08 Schijnpoortweg
675,Schijnpoortweg,2022-12-23,16:00:00,174,15,159,FMN 08 Schijnpoortweg
675,Schijnpoortweg,2022-12-23,17:00:00,168,20,148,FMN 08 Schijnpoortweg
675,Schijnpoortweg,2022-12-23,18:00:00,144,24,120,FMN 08 Schijnpoortweg
675,Schijnpoortweg,2022-12-23,19:00:00,123,19,104,FMN 08 Schijnpoortweg
675,Schijnpoortweg,2022-12-23,20:00:00,95,14,81,FMN 08 Schijnpoortweg
675,Schijnpoortweg,2022-12-23,21:00:00,75,17,58,FMN 08 Schijnpoortweg
675,Schijnpoortweg,2022-12-23,22:00:00,88,18,70,FMN 08 Schijnpoortweg
675,Schijnpoortweg,2022-12-23,23:00:00,64,13,51,FMN 08 Schijnpoortweg
675,Schijnpoortweg,2022-12-24,00:00:00,57,10,47,FMN 08 Schijnpoortweg
675,Schijnpoortweg,2022-12-24,01:00:00,36,4,32,FMN 08 Schijnpoortweg
675,Schijnpoortweg,2022-12-24,02:00:00,26,5,21,FMN 08 Schijnpoortweg
675,Schijnpoortweg,2022-12-24,03:00:00,25,10,15,FMN 08 Schijnpoortweg
675,Schijnpoortweg,2022-12-24,04:00:00,16,6,10,FMN 08 Schijnpoortweg
675,Schijnpoortweg,2022-12-24,05:00:00,21,10,11,FMN 08 Schijnpoortweg
675,Schijnpoortweg,2022-12-24,06:00:00,23,11,12,FMN 08 Schijnpoortweg
675,Schijnpoortweg,2022-12-24,07:00:00,21,8,13,FMN 08 Schijnpoortweg
675,Schijnpoortweg,2022-12-24,08:00:00,40,9,31,FMN 08 Schijnpoortweg
675,Schijnpoortweg,2022-12-24,09:00:00,51,11,40,FMN 08 Schijnpoortweg
675,Schijnpoortweg,2022-12-24,10:00:00,76,23,53,FMN 08 Schijnpoortweg
675,Schijnpoortweg,2022-12-24,11:00:00,94,14,80,FMN 08 Schijnpoortweg
675,Schijnpoortweg,2022-12-24,12:00:00,88,23,65,FMN 08 Schijnpoortweg
675,Schijnpoortweg,2022-12-24,13:00:00,119,23,96,FMN 08 Schijnpoortweg
675,Schijnpoortweg,2022-12-24,14:00:00,128,18,110,FMN 08 Schijnpoortweg
675,Schijnpoortweg,2022-12-24,15:00:00,140,25,115,FMN 08 Schijnpoortweg
675,Schijnpoortweg,2022-12-24,16:00:00,119,13,106,FMN 08 Schijnpoortweg
675,Schijnpoortweg,2022-12-24,17:00:00,134,25,109,FMN 08 Schijnpoortweg
675,Schijnpoortweg,2022-12-24,18:00:00,88,23,65,FMN 08 Schijnpoortweg
675,Schijnpoortweg,2022-12-24,19:00:00,86,14,72,FMN 08 Schijnpoortweg
675,Schijnpoortweg,2022-12-24,20:00:00,77,17,60,FMN 08 Schijnpoortweg
675,Schijnpoortweg,2022-12-24,21:00:00,59,19,40,FMN 08 Schijnpoortweg
675,Schijnpoortweg,2022-12-24,22:00:00,53,14,39,FMN 08 Schijnpoortweg
675,Schijnpoortweg,2022-12-24,23:00:00,51,13,38,FMN 08 Schijnpoortweg
675,Schijnpoortweg,2022-12-25,00:00:00,30,9,21,FMN 08 Schijnpoortweg
675,Schijnpoortweg,2022-12-25,01:00:00,25,8,17,FMN 08 Schijnpoortweg
675,Schijnpoortweg,2022-12-25,02:00:00,20,8,12,FMN 08 Schijnpoortweg
675,Schijnpoortweg,2022-12-25,03:00:00,16,5,11,FMN 08 Schijnpoortweg
675,Schijnpoortweg,2022-12-25,04:00:00,13,4,9,FMN 08 Schijnpoortweg
675,Schijnpoortweg,2022-12-25,05:00:00,12,6,6,FMN 08 Schijnpoortweg
675,Schijnpoortweg,2022-12-25,06:00:00,10,6,4,FMN 08 Schijnpoortweg
675,Schijnpoortweg,2022-12-25,07:00:00,12,2,10,FMN 08 Schijnpoortweg
675,Schijnpoortweg,2022-12-25,08:00:00,25,8,17,FMN 08 Schijnpoortweg
675,Schijnpoortweg,2022-12-25,09:00:00,26,5,21,FMN 08 Schijnpoortweg
675,Schijnpoortweg,2022-12-25,10:00:00,29,6,23,FMN 08 Schijnpoortweg
675,Schijnpoortweg,2022-12-25,11:00:00,33,2,31,FMN 08 Schijnpoortweg
675,Schijnpoortweg,2022-12-25,12:00:00,24,7,17,FMN 08 Schijnpoortweg
675,Schijnpoortweg,2022-12-25,13:00:00,41,15,26,FMN 08 Schijnpoortweg
675,Schijnpoortweg,2022-12-25,14:00:00,57,13,44,FMN 08 Schijnpoortweg
675,Schijnpoortweg,2022-12-25,15:00:00,48,2,46,FMN 08 Schijnpoortweg
675,Schijnpoortweg,2022-12-25,16:00:00,40,7,33,FMN 08 Schijnpoortweg
675,Schijnpoortweg,2022-12-25,17:00:00,54,15,39,FMN 08 Schijnpoortweg
675,Schijnpoortweg,2022-12-25,18:00:00,62,15,47,FMN 08 Schijnpoortweg
675,Schijnpoortweg,2022-12-25,19:00:00,71,13,58,FMN 08 Schijnpoortweg
675,Schijnpoortweg,2022-12-25,20:00:00,44,9,35,FMN 08 Schijnpoortweg
675,Schijnpoortweg,2022-12-25,21:00:00,42,10,32,FMN 08 Schijnpoortweg
675,Schijnpoortweg,2022-12-25,22:00:00,42,12,30,FMN 08 Schijnpoortweg
675,Schijnpoortweg,2022-12-25,23:00:00,41,10,31,FMN 08 Schijnpoortweg
675,Schijnpoortweg,2022-12-26,00:00:00,26,7,19,FMN 08 Schijnpoortweg
675,Schijnpoortweg,2022-12-26,01:00:00,15,6,9,FMN 08 Schijnpoortweg
675,Schijnpoortweg,2022-12-26,02:00:00,20,10,10,FMN 08 Schijnpoortweg
675,Schijnpoortweg,2022-12-26,03:00:00,16,6,10,FMN 08 Schijnpoortweg
675,Schijnpoortweg,2022-12-26,04:00:00,22,8,14,FMN 08 Schijnpoortweg
675,Schijnpoortweg,2022-12-26,05:00:00,37,13,24,FMN 08 Schijnpoortweg
675,Schijnpoortweg,2022-12-26,06:00:00,42,17,25,FMN 08 Schijnpoortweg
675,Schijnpoortweg,2022-12-26,07:00:00,51,8,43,FMN 08 Schijnpoortweg
675,Schijnpoortweg,2022-12-26,08:00:00,79,15,64,FMN 08 Schijnpoortweg
675,Schijnpoortweg,2022-12-26,09:00:00,53,10,43,FMN 08 Schijnpoortweg
675,Schijnpoortweg,2022-12-26,10:00:00,52,8,44,FMN 08 Schijnpoortweg
675,Schijnpoortweg,2022-12-26,11:00:00,64,14,50,FMN 08 Schijnpoortweg
675,Schijnpoortweg,2022-12-26,12:00:00,84,20,64,FMN 08 Schijnpoortweg
675,Schijnpoortweg,2022-12-26,13:00:00,81,20,61,FMN 08 Schijnpoortweg
675,Schijnpoortweg,2022-12-26,14:00:00,102,15,87,FMN 08 Schijnpoortweg
675,Schijnpoortweg,2022-12-26,15:00:00,129,30,99,FMN 08 Schijnpoortweg
675,Schijnpoortweg,2022-12-26,16:00:00,181,50,131,FMN 08 Schijnpoortweg
675,Schijnpoortweg,2022-12-26,17:00:00,166,45,121,FMN 08 Schijnpoortweg
675,Schijnpoortweg,2022-12-26,18:00:00,128,31,97,FMN 08 Schijnpoortweg
675,Schijnpoortweg,2022-12-26,19:00:00,159,40,119,FMN 08 Schijnpoortweg
675,Schijnpoortweg,2022-12-26,20:00:00,80,15,65,FMN 08 Schijnpoortweg
675,Schijnpoortweg,2022-12-26,21:00:00,87,38,49,FMN 08 Schijnpoortweg
675,Schijnpoortweg,2022-12-26,22:00:00,77,16,61,FMN 08 Schijnpoortweg
675,Schijnpoortweg,2022-12-26,23:00:00,42,8,34,FMN 08 Schijnpoortweg
675,Schijnpoortweg,2022-12-27,00:00:00,39,4,35,FMN 08 Schijnpoortweg
675,Schijnpoortweg,2022-12-27,01:00:00,14,3,11,FMN 08 Schijnpoortweg
675,Schijnpoortweg,2022-12-27,02:00:00,23,5,18,FMN 08 Schijnpoortweg
675,Schijnpoortweg,2022-12-27,03:00:00,12,2,10,FMN 08 Schijnpoortweg
675,Schijnpoortweg,2022-12-27,04:00:00,23,9,14,FMN 08 Schijnpoortweg
675,Schijnpoortweg,2022-12-27,05:00:00,32,8,24,FMN 08 Schijnpoortweg
675,Schijnpoortweg,2022-12-27,06:00:00,44,5,39,FMN 08 Schijnpoortweg
675,Schijnpoortweg,2022-12-27,07:00:00,97,15,82,FMN 08 Schijnpoortweg
675,Schijnpoortweg,2022-12-27,08:00:00,85,15,70,FMN 08 Schijnpoortweg
675,Schijnpoortweg,2022-12-27,09:00:00,60,10,50,FMN 08 Schijnpoortweg
675,Schijnpoortweg,2022-12-27,10:00:00,56,6,50,FMN 08 Schijnpoortweg
675,Schijnpoortweg,2022-12-27,11:00:00,73,5,68,FMN 08 Schijnpoortweg
675,Schijnpoortweg,2022-12-27,12:00:00,88,15,73,FMN 08 Schijnpoortweg
675,Schijnpoortweg,2022-12-27,13:00:00,97,13,84,FMN 08 Schijnpoortweg
675,Schijnpoortweg,2022-12-27,14:00:00,107,20,87,FMN 08 Schijnpoortweg
675,Schijnpoortweg,2022-12-27,15:00:00,135,22,113,FMN 08 Schijnpoortweg
675,Schijnpoortweg,2022-12-27,16:00:00,169,31,138,FMN 08 Schijnpoortweg
675,Schijnpoortweg,2022-12-27,17:00:00,189,27,162,FMN 08 Schijnpoortweg
675,Schijnpoortweg,2022-12-27,18:00:00,144,21,123,FMN 08 Schijnpoortweg
675,Schijnpoortweg,2022-12-27,19:00:00,133,15,118,FMN 08 Schijnpoortweg
675,Schijnpoortweg,2022-12-27,20:00:00,79,10,69,FMN 08 Schijnpoortweg
675,Schijnpoortweg,2022-12-27,21:00:00,55,6,49,FMN 08 Schijnpoortweg
675,Schijnpoortweg,2022-12-27,22:00:00,83,13,70,FMN 08 Schijnpoortweg
675,Schijnpoortweg,2022-12-27,23:00:00,50,3,47,FMN 08 Schijnpoortweg
675,Schijnpoortweg,2022-12-28,00:00:00,34,5,29,FMN 08 Schijnpoortweg
675,Schijnpoortweg,2022-12-28,01:00:00,17,5,12,FMN 08 Schijnpoortweg
675,Schijnpoortweg,2022-12-28,02:00:00,13,1,12,FMN 08 Schijnpoortweg
675,Schijnpoortweg,2022-12-28,03:00:00,16,2,14,FMN 08 Schijnpoortweg
675,Schijnpoortweg,2022-12-28,04:00:00,21,10,11,FMN 08 Schijnpoortweg
675,Schijnpoortweg,2022-12-28,05:00:00,36,9,27,FMN 08 Schijnpoortweg
675,Schijnpoortweg,2022-12-28,06:00:00,47,12,35,FMN 08 Schijnpoortweg
675,Schijnpoortweg,2022-12-28,07:00:00,84,11,73,FMN 08 Schijnpoortweg
675,Schijnpoortweg,2022-12-28,08:00:00,80,10,70,FMN 08 Schijnpoortweg
675,Schijnpoortweg,2022-12-28,09:00:00,62,12,50,FMN 08 Schijnpoortweg
675,Schijnpoortweg,2022-12-28,10:00:00,52,6,46,FMN 08 Schijnpoortweg
675,Schijnpoortweg,2022-12-28,11:00:00,52,13,39,FMN 08 Schijnpoortweg
675,Schijnpoortweg,2022-12-28,12:00:00,69,16,53,FMN 08 Schijnpoortweg
675,Schijnpoortweg,2022-12-28,13:00:00,80,10,70,FMN 08 Schijnpoortweg
675,Schijnpoortweg,2022-12-28,14:00:00,87,12,75,FMN 08 Schijnpoortweg
675,Schijnpoortweg,2022-12-28,15:00:00,95,11,84,FMN 08 Schijnpoortweg
675,Schijnpoortweg,2022-12-28,16:00:00,146,28,118,FMN 08 Schijnpoortweg
675,Schijnpoortweg,2022-12-28,17:00:00,109,11,98,FMN 08 Schijnpoortweg
675,Schijnpoortweg,2022-12-28,18:00:00,91,9,82,FMN 08 Schijnpoortweg
675,Schijnpoortweg,2022-12-28,19:00:00,80,16,64,FMN 08 Schijnpoortweg
675,Schijnpoortweg,2022-12-28,20:00:00,76,8,68,FMN 08 Schijnpoortweg
675,Schijnpoortweg,2022-12-28,21:00:00,62,10,52,FMN 08 Schijnpoortweg
675,Schijnpoortweg,2022-12-28,22:00:00,76,12,64,FMN 08 Schijnpoortweg
675,Schijnpoortweg,2022-12-28,23:00:00,32,1,31,FMN 08 Schijnpoortweg
675,Schijnpoortweg,2022-12-29,00:00:00,33,4,29,FMN 08 Schijnpoortweg
675,Schijnpoortweg,2022-12-29,01:00:00,24,4,20,FMN 08 Schijnpoortweg
675,Schijnpoortweg,2022-12-29,02:00:00,8,1,7,FMN 08 Schijnpoortweg
675,Schijnpoortweg,2022-12-29,03:00:00,14,2,12,FMN 08 Schijnpoortweg
675,Schijnpoortweg,2022-12-29,04:00:00,17,5,12,FMN 08 Schijnpoortweg
675,Schijnpoortweg,2022-12-29,05:00:00,28,7,21,FMN 08 Schijnpoortweg
675,Schijnpoortweg,2022-12-29,06:00:00,44,13,31,FMN 08 Schijnpoortweg
675,Schijnpoortweg,2022-12-29,07:00:00,82,9,73,FMN 08 Schijnpoortweg
675,Schijnpoortweg,2022-12-29,08:00:00,80,15,65,FMN 08 Schijnpoortweg
675,Schijnpoortweg,2022-12-29,09:00:00,50,12,38,FMN 08 Schijnpoortweg
675,Schijnpoortweg,2022-12-29,10:00:00,46,7,39,FMN 08 Schijnpoortweg
675,Schijnpoortweg,2022-12-29,11:00:00,69,8,61,FMN 08 Schijnpoortweg
675,Schijnpoortweg,2022-12-29,12:00:00,80,14,66,FMN 08 Schijnpoortweg
675,Schijnpoortweg,2022-12-29,13:00:00,91,14,77,FMN 08 Schijnpoortweg
675,Schijnpoortweg,2022-12-29,14:00:00,93,19,74,FMN 08 Schijnpoortweg
675,Schijnpoortweg,2022-12-29,15:00:00,108,14,94,FMN 08 Schijnpoortweg
675,Schijnpoortweg,2022-12-29,16:00:00,155,25,130,FMN 08 Schijnpoortweg
675,Schijnpoortweg,2022-12-29,17:00:00,142,25,117,FMN 08 Schijnpoortweg
675,Schijnpoortweg,2022-12-29,18:00:00,142,20,122,FMN 08 Schijnpoortweg
675,Schijnpoortweg,2022-12-29,19:00:00,92,6,86,FMN 08 Schijnpoortweg
675,Schijnpoortweg,2022-12-29,20:00:00,70,8,62,FMN 08 Schijnpoortweg
675,Schijnpoortweg,2022-12-29,21:00:00,67,9,58,FMN 08 Schijnpoortweg
675,Schijnpoortweg,2022-12-29,22:00:00,83,10,73,FMN 08 Schijnpoortweg
675,Schijnpoortweg,2022-12-29,23:00:00,50,9,41,FMN 08 Schijnpoortweg
675,Schijnpoortweg,2022-12-30,00:00:00,36,3,33,FMN 08 Schijnpoortweg
675,Schijnpoortweg,2022-12-30,01:00:00,25,1,24,FMN 08 Schijnpoortweg
675,Schijnpoortweg,2022-12-30,02:00:00,23,4,19,FMN 08 Schijnpoortweg
675,Schijnpoortweg,2022-12-30,03:00:00,20,6,14,FMN 08 Schijnpoortweg
675,Schijnpoortweg,2022-12-30,04:00:00,17,6,11,FMN 08 Schijnpoortweg
675,Schijnpoortweg,2022-12-30,05:00:00,27,9,18,FMN 08 Schijnpoortweg
675,Schijnpoortweg,2022-12-30,06:00:00,40,9,31,FMN 08 Schijnpoortweg
675,Schijnpoortweg,2022-12-30,07:00:00,77,10,67,FMN 08 Schijnpoortweg
675,Schijnpoortweg,2022-12-30,08:00:00,63,8,55,FMN 08 Schijnpoortweg
675,Schijnpoortweg,2022-12-30,09:00:00,58,5,53,FMN 08 Schijnpoortweg
675,Schijnpoortweg,2022-12-30,10:00:00,62,10,52,FMN 08 Schijnpoortweg
675,Schijnpoortweg,2022-12-30,11:00:00,82,14,68,FMN 08 Schijnpoortweg
675,Schijnpoortweg,2022-12-30,12:00:00,77,8,69,FMN 08 Schijnpoortweg
675,Schijnpoortweg,2022-12-30,13:00:00,60,8,52,FMN 08 Schijnpoortweg
675,Schijnpoortweg,2022-12-30,14:00:00,74,10,64,FMN 08 Schijnpoortweg
675,Schijnpoortweg,2022-12-30,15:00:00,105,20,85,FMN 08 Schijnpoortweg
675,Schijnpoortweg,2022-12-30,16:00:00,126,9,117,FMN 08 Schijnpoortweg
675,Schijnpoortweg,2022-12-30,17:00:00,136,25,111,FMN 08 Schijnpoortweg
675,Schijnpoortweg,2022-12-30,18:00:00,112,23,89,FMN 08 Schijnpoortweg
675,Schijnpoortweg,2022-12-30,19:00:00,107,19,88,FMN 08 Schijnpoortweg
675,Schijnpoortweg,2022-12-30,20:00:00,77,19,58,FMN 08 Schijnpoortweg
675,Schijnpoortweg,2022-12-30,21:00:00,78,13,65,FMN 08 Schijnpoortweg
675,Schijnpoortweg,2022-12-30,22:00:00,59,9,50,FMN 08 Schijnpoortweg
675,Schijnpoortweg,2022-12-30,23:00:00,57,6,51,FMN 08 Schijnpoortweg
675,Schijnpoortweg,2022-12-31,00:00:00,54,8,46,FMN 08 Schijnpoortweg
675,Schijnpoortweg,2022-12-31,01:00:00,19,2,17,FMN 08 Schijnpoortweg
675,Schijnpoortweg,2022-12-31,02:00:00,19,5,14,FMN 08 Schijnpoortweg
675,Schijnpoortweg,2022-12-31,03:00:00,15,5,10,FMN 08 Schijnpoortweg
675,Schijnpoortweg,2022-12-31,04:00:00,8,3,5,FMN 08 Schijnpoortweg
675,Schijnpoortweg,2022-12-31,05:00:00,17,5,12,FMN 08 Schijnpoortweg
675,Schijnpoortweg,2022-12-31,06:00:00,25,10,15,FMN 08 Schijnpoortweg
675,Schijnpoortweg,2022-12-31,07:00:00,24,4,20,FMN 08 Schijnpoortweg
675,Schijnpoortweg,2022-12-31,08:00:00,30,6,24,FMN 08 Schijnpoortweg
675,Schijnpoortweg,2022-12-31,09:00:00,35,11,24,FMN 08 Schijnpoortweg
675,Schijnpoortweg,2022-12-31,10:00:00,44,14,30,FMN 08 Schijnpoortweg
675,Schijnpoortweg,2022-12-31,11:00:00,57,14,43,FMN 08 Schijnpoortweg
675,Schijnpoortweg,2022-12-31,12:00:00,69,13,56,FMN 08 Schijnpoortweg
675,Schijnpoortweg,2022-12-31,13:00:00,92,19,73,FMN 08 Schijnpoortweg
675,Schijnpoortweg,2022-12-31,14:00:00,96,28,68,FMN 08 Schijnpoortweg
675,Schijnpoortweg,2022-12-31,15:00:00,98,22,76,FMN 08 Schijnpoortweg
675,Schijnpoortweg,2022-12-31,16:00:00,118,15,103,FMN 08 Schijnpoortweg
675,Schijnpoortweg,2022-12-31,17:00:00,125,19,106,FMN 08 Schijnpoortweg
675,Schijnpoortweg,2022-12-31,18:00:00,110,18,92,FMN 08 Schijnpoortweg
675,Schijnpoortweg,2022-12-31,19:00:00,96,14,82,FMN 08 Schijnpoortweg
675,Schijnpoortweg,2022-12-31,20:00:00,63,12,51,FMN 08 Schijnpoortweg
675,Schijnpoortweg,2022-12-31,21:00:00,40,10,30,FMN 08 Schijnpoortweg
675,Schijnpoortweg,2022-12-31,22:00:00,40,11,29,FMN 08 Schijnpoortweg
675,Schijnpoortweg,2022-12-31,23:00:00,40,13,27,FMN 08 Schijnpoortweg
675,Schijnpoortweg,2023-01-01,00:00:00,54,8,46,FMN 08 Schijnpoortweg
675,Schijnpoortweg,2023-01-01,01:00:00,87,15,72,FMN 08 Schijnpoortweg
675,Schijnpoortweg,2023-01-01,02:00:00,52,6,46,FMN 08 Schijnpoortweg
675,Schijnpoortweg,2023-01-01,03:00:00,40,8,32,FMN 08 Schijnpoortweg
675,Schijnpoortweg,2023-01-01,04:00:00,21,4,17,FMN 08 Schijnpoortweg
675,Schijnpoortweg,2023-01-01,05:00:00,26,3,23,FMN 08 Schijnpoortweg
675,Schijnpoortweg,2023-01-01,06:00:00,27,2,25,FMN 08 Schijnpoortweg
675,Schijnpoortweg,2023-01-01,07:00:00,18,2,16,FMN 08 Schijnpoortweg
675,Schijnpoortweg,2023-01-01,08:00:00,13,2,11,FMN 08 Schijnpoortweg
675,Schijnpoortweg,2023-01-01,09:00:00,31,11,20,FMN 08 Schijnpoortweg
675,Schijnpoortweg,2023-01-01,10:00:00,32,8,24,FMN 08 Schijnpoortweg
675,Schijnpoortweg,2023-01-01,11:00:00,46,11,35,FMN 08 Schijnpoortweg
675,Schijnpoortweg,2023-01-01,12:00:00,55,14,41,FMN 08 Schijnpoortweg
675,Schijnpoortweg,2023-01-01,13:00:00,67,17,50,FMN 08 Schijnpoortweg
675,Schijnpoortweg,2023-01-01,14:00:00,78,16,62,FMN 08 Schijnpoortweg
675,Schijnpoortweg,2023-01-01,15:00:00,97,18,79,FMN 08 Schijnpoortweg
675,Schijnpoortweg,2023-01-01,16:00:00,84,11,73,FMN 08 Schijnpoortweg
675,Schijnpoortweg,2023-01-01,17:00:00,74,19,55,FMN 08 Schijnpoortweg
675,Schijnpoortweg,2023-01-01,18:00:00,62,14,48,FMN 08 Schijnpoortweg
675,Schijnpoortweg,2023-01-01,19:00:00,63,12,51,FMN 08 Schijnpoortweg
675,Schijnpoortweg,2023-01-01,20:00:00,50,13,37,FMN 08 Schijnpoortweg
675,Schijnpoortweg,2023-01-01,21:00:00,40,5,35,FMN 08 Schijnpoortweg
675,Schijnpoortweg,2023-01-01,22:00:00,48,12,36,FMN 08 Schijnpoortweg
675,Schijnpoortweg,2023-01-01,23:00:00,41,9,32,FMN 08 Schijnpoortweg
675,Schijnpoortweg,2023-01-02,00:00:00,19,5,14,FMN 08 Schijnpoortweg
675,Schijnpoortweg,2023-01-02,01:00:00,9,0,9,FMN 08 Schijnpoortweg
675,Schijnpoortweg,2023-01-02,02:00:00,24,5,19,FMN 08 Schijnpoortweg
675,Schijnpoortweg,2023-01-02,03:00:00,14,2,12,FMN 08 Schijnpoortweg
675,Schijnpoortweg,2023-01-02,04:00:00,19,10,9,FMN 08 Schijnpoortweg
675,Schijnpoortweg,2023-01-02,05:00:00,35,8,27,FMN 08 Schijnpoortweg
675,Schijnpoortweg,2023-01-02,06:00:00,39,11,28,FMN 08 Schijnpoortweg
675,Schijnpoortweg,2023-01-02,07:00:00,70,8,62,FMN 08 Schijnpoortweg
675,Schijnpoortweg,2023-01-02,08:00:00,74,9,65,FMN 08 Schijnpoortweg
675,Schijnpoortweg,2023-01-02,09:00:00,39,10,29,FMN 08 Schijnpoortweg
675,Schijnpoortweg,2023-01-02,10:00:00,46,15,31,FMN 08 Schijnpoortweg
675,Schijnpoortweg,2023-01-02,11:00:00,67,17,50,FMN 08 Schijnpoortweg
675,Schijnpoortweg,2023-01-02,12:00:00,70,15,55,FMN 08 Schijnpoortweg
675,Schijnpoortweg,2023-01-02,13:00:00,87,14,73,FMN 08 Schijnpoortweg
675,Schijnpoortweg,2023-01-02,14:00:00,82,12,70,FMN 08 Schijnpoortweg
675,Schijnpoortweg,2023-01-02,15:00:00,106,17,89,FMN 08 Schijnpoortweg
675,Schijnpoortweg,2023-01-02,16:00:00,125,18,107,FMN 08 Schijnpoortweg
675,Schijnpoortweg,2023-01-02,17:00:00,142,23,119,FMN 08 Schijnpoortweg
675,Schijnpoortweg,2023-01-02,18:00:00,113,17,96,FMN 08 Schijnpoortweg
675,Schijnpoortweg,2023-01-02,19:00:00,87,15,72,FMN 08 Schijnpoortweg
675,Schijnpoortweg,2023-01-02,20:00:00,75,12,63,FMN 08 Schijnpoortweg
675,Schijnpoortweg,2023-01-02,21:00:00,77,19,58,FMN 08 Schijnpoortweg
675,Schijnpoortweg,2023-01-02,22:00:00,61,11,50,FMN 08 Schijnpoortweg
675,Schijnpoortweg,2023-01-02,23:00:00,49,7,42,FMN 08 Schijnpoortweg
675,Schijnpoortweg,2023-01-03,00:00:00,25,2,23,FMN 08 Schijnpoortweg
675,Schijnpoortweg,2023-01-03,01:00:00,16,2,14,FMN 08 Schijnpoortweg
675,Schijnpoortweg,2023-01-03,02:00:00,10,1,9,FMN 08 Schijnpoortweg
675,Schijnpoortweg,2023-01-03,03:00:00,14,5,9,FMN 08 Schijnpoortweg
675,Schijnpoortweg,2023-01-03,04:00:00,21,9,12,FMN 08 Schijnpoortweg
675,Schijnpoortweg,2023-01-03,05:00:00,44,9,35,FMN 08 Schijnpoortweg
675,Schijnpoortweg,2023-01-03,06:00:00,56,13,43,FMN 08 Schijnpoortweg
675,Schijnpoortweg,2023-01-03,07:00:00,114,13,101,FMN 08 Schijnpoortweg
675,Schijnpoortweg,2023-01-03,08:00:00,110,12,98,FMN 08 Schijnpoortweg
675,Schijnpoortweg,2023-01-03,09:00:00,59,11,48,FMN 08 Schijnpoortweg
675,Schijnpoortweg,2023-01-03,10:00:00,83,8,75,FMN 08 Schijnpoortweg
675,Schijnpoortweg,2023-01-03,11:00:00,63,8,55,FMN 08 Schijnpoortweg
675,Schijnpoortweg,2023-01-03,12:00:00,78,12,66,FMN 08 Schijnpoortweg
675,Schijnpoortweg,2023-01-03,13:00:00,101,8,93,FMN 08 Schijnpoortweg
675,Schijnpoortweg,2023-01-03,14:00:00,117,13,104,FMN 08 Schijnpoortweg
675,Schijnpoortweg,2023-01-03,15:00:00,144,10,134,FMN 08 Schijnpoortweg
675,Schijnpoortweg,2023-01-03,16:00:00,212,23,189,FMN 08 Schijnpoortweg
675,Schijnpoortweg,2023-01-03,17:00:00,236,29,207,FMN 08 Schijnpoortweg
675,Schijnpoortweg,2023-01-03,18:00:00,132,11,121,FMN 08 Schijnpoortweg
675,Schijnpoortweg,2023-01-03,19:00:00,142,12,130,FMN 08 Schijnpoortweg
675,Schijnpoortweg,2023-01-03,20:00:00,99,16,83,FMN 08 Schijnpoortweg
675,Schijnpoortweg,2023-01-03,21:00:00,76,8,68,FMN 08 Schijnpoortweg
675,Schijnpoortweg,2023-01-03,22:00:00,82,16,66,FMN 08 Schijnpoortweg
675,Schijnpoortweg,2023-01-03,23:00:00,58,7,51,FMN 08 Schijnpoortweg
675,Schijnpoortweg,2023-01-04,00:00:00,30,5,25,FMN 08 Schijnpoortweg
675,Schijnpoortweg,2023-01-04,01:00:00,12,0,12,FMN 08 Schijnpoortweg
675,Schijnpoortweg,2023-01-04,02:00:00,16,4,12,FMN 08 Schijnpoortweg
675,Schijnpoortweg,2023-01-04,03:00:00,10,2,8,FMN 08 Schijnpoortweg
675,Schijnpoortweg,2023-01-04,04:00:00,17,9,8,FMN 08 Schijnpoortweg
675,Schijnpoortweg,2023-01-04,05:00:00,51,16,35,FMN 08 Schijnpoortweg
675,Schijnpoortweg,2023-01-04,06:00:00,58,13,45,FMN 08 Schijnpoortweg
675,Schijnpoortweg,2023-01-04,07:00:00,108,10,98,FMN 08 Schijnpoortweg
675,Schijnpoortweg,2023-01-04,08:00:00,119,10,109,FMN 08 Schijnpoortweg
675,Schijnpoortweg,2023-01-04,09:00:00,71,10,61,FMN 08 Schijnpoortweg
675,Schijnpoortweg,2023-01-04,10:00:00,45,8,37,FMN 08 Schijnpoortweg
675,Schijnpoortweg,2023-01-04,11:00:00,60,4,56,FMN 08 Schijnpoortweg
675,Schijnpoortweg,2023-01-04,12:00:00,60,8,52,FMN 08 Schijnpoortweg
675,Schijnpoortweg,2023-01-04,13:00:00,85,6,79,FMN 08 Schijnpoortweg
675,Schijnpoortweg,2023-01-04,14:00:00,111,13,98,FMN 08 Schijnpoortweg
675,Schijnpoortweg,2023-01-04,15:00:00,137,12,125,FMN 08 Schijnpoortweg
675,Schijnpoortweg,2023-01-04,16:00:00,146,11,135,FMN 08 Schijnpoortweg
675,Schijnpoortweg,2023-01-04,17:00:00,189,28,161,FMN 08 Schijnpoortweg
675,Schijnpoortweg,2023-01-04,18:00:00,151,31,120,FMN 08 Schijnpoortweg
675,Schijnpoortweg,2023-01-04,19:00:00,100,10,90,FMN 08 Schijnpoortweg
675,Schijnpoortweg,2023-01-04,20:00:00,95,17,78,FMN 08 Schijnpoortweg
675,Schijnpoortweg,2023-01-04,21:00:00,62,13,49,FMN 08 Schijnpoortweg
675,Schijnpoortweg,2023-01-04,22:00:00,84,15,69,FMN 08 Schijnpoortweg
675,Schijnpoortweg,2023-01-04,23:00:00,48,8,40,FMN 08 Schijnpoortweg
675,Schijnpoortweg,2023-01-05,00:00:00,38,6,32,FMN 08 Schijnpoortweg
675,Schijnpoortweg,2023-01-05,01:00:00,12,2,10,FMN 08 Schijnpoortweg
675,Schijnpoortweg,2023-01-05,02:00:00,15,4,11,FMN 08 Schijnpoortweg
675,Schijnpoortweg,2023-01-05,03:00:00,15,1,14,FMN 08 Schijnpoortweg
675,Schijnpoortweg,2023-01-05,04:00:00,27,13,14,FMN 08 Schijnpoortweg
675,Schijnpoortweg,2023-01-05,05:00:00,45,11,34,FMN 08 Schijnpoortweg
675,Schijnpoortweg,2023-01-05,06:00:00,63,10,53,FMN 08 Schijnpoortweg
675,Schijnpoortweg,2023-01-05,07:00:00,115,11,104,FMN 08 Schijnpoortweg
675,Schijnpoortweg,2023-01-05,08:00:00,128,20,108,FMN 08 Schijnpoortweg
675,Schijnpoortweg,2023-01-05,09:00:00,81,8,73,FMN 08 Schijnpoortweg
675,Schijnpoortweg,2023-01-05,10:00:00,76,12,64,FMN 08 Schijnpoortweg
675,Schijnpoortweg,2023-01-05,11:00:00,84,9,75,FMN 08 Schijnpoortweg
675,Schijnpoortweg,2023-01-05,12:00:00,111,20,91,FMN 08 Schijnpoortweg
675,Schijnpoortweg,2023-01-05,13:00:00,118,13,105,FMN 08 Schijnpoortweg
675,Schijnpoortweg,2023-01-05,14:00:00,126,23,103,FMN 08 Schijnpoortweg
675,Schijnpoortweg,2023-01-05,15:00:00,136,10,126,FMN 08 Schijnpoortweg
675,Schijnpoortweg,2023-01-05,16:00:00,201,19,182,FMN 08 Schijnpoortweg
675,Schijnpoortweg,2023-01-05,17:00:00,239,16,223,FMN 08 Schijnpoortweg
675,Schijnpoortweg,2023-01-05,18:00:00,147,19,128,FMN 08 Schijnpoortweg
675,Schijnpoortweg,2023-01-05,19:00:00,113,16,97,FMN 08 Schijnpoortweg
675,Schijnpoortweg,2023-01-05,20:00:00,96,15,81,FMN 08 Schijnpoortweg
675,Schijnpoortweg,2023-01-05,21:00:00,77,10,67,FMN 08 Schijnpoortweg
675,Schijnpoortweg,2023-01-05,22:00:00,69,14,55,FMN 08 Schijnpoortweg
675,Schijnpoortweg,2023-01-05,23:00:00,62,8,54,FMN 08 Schijnpoortweg
675,Schijnpoortweg,2023-01-06,00:00:00,43,8,35,FMN 08 Schijnpoortweg
675,Schijnpoortweg,2023-01-06,01:00:00,29,9,20,FMN 08 Schijnpoortweg
675,Schijnpoortweg,2023-01-06,02:00:00,28,5,23,FMN 08 Schijnpoortweg
675,Schijnpoortweg,2023-01-06,03:00:00,11,1,10,FMN 08 Schijnpoortweg
675,Schijnpoortweg,2023-01-06,04:00:00,35,15,20,FMN 08 Schijnpoortweg
675,Schijnpoortweg,2023-01-06,05:00:00,54,12,42,FMN 08 Schijnpoortweg
675,Schijnpoortweg,2023-01-06,06:00:00,59,11,48,FMN 08 Schijnpoortweg
675,Schijnpoortweg,2023-01-06,07:00:00,114,11,103,FMN 08 Schijnpoortweg
675,Schijnpoortweg,2023-01-06,08:00:00,108,16,92,FMN 08 Schijnpoortweg
675,Schijnpoortweg,2023-01-06,09:00:00,71,13,58,FMN 08 Schijnpoortweg
675,Schijnpoortweg,2023-01-06,10:00:00,75,11,64,FMN 08 Schijnpoortweg
675,Schijnpoortweg,2023-01-06,11:00:00,92,18,74,FMN 08 Schijnpoortweg
675,Schijnpoortweg,2023-01-06,12:00:00,92,9,83,FMN 08 Schijnpoortweg
675,Schijnpoortweg,2023-01-06,13:00:00,110,12,98,FMN 08 Schijnpoortweg
675,Schijnpoortweg,2023-01-06,14:00:00,160,20,140,FMN 08 Schijnpoortweg
675,Schijnpoortweg,2023-01-06,15:00:00,157,16,141,FMN 08 Schijnpoortweg
675,Schijnpoortweg,2023-01-06,16:00:00,195,18,177,FMN 08 Schijnpoortweg
675,Schijnpoortweg,2023-01-06,17:00:00,192,16,176,FMN 08 Schijnpoortweg
675,Schijnpoortweg,2023-01-06,18:00:00,137,22,115,FMN 08 Schijnpoortweg
675,Schijnpoortweg,2023-01-06,19:00:00,131,21,110,FMN 08 Schijnpoortweg
675,Schijnpoortweg,2023-01-06,20:00:00,75,10,65,FMN 08 Schijnpoortweg
675,Schijnpoortweg,2023-01-06,21:00:00,76,8,68,FMN 08 Schijnpoortweg
675,Schijnpoortweg,2023-01-06,22:00:00,85,20,65,FMN 08 Schijnpoortweg
675,Schijnpoortweg,2023-01-06,23:00:00,83,9,74,FMN 08 Schijnpoortweg
675,Schijnpoortweg,2023-01-07,00:00:00,45,6,39,FMN 08 Schijnpoortweg
675,Schijnpoortweg,2023-01-07,01:00:00,26,1,25,FMN 08 Schijnpoortweg
675,Schijnpoortweg,2023-01-07,02:00:00,20,6,14,FMN 08 Schijnpoortweg
675,Schijnpoortweg,2023-01-07,03:00:00,20,5,15,FMN 08 Schijnpoortweg
675,Schijnpoortweg,2023-01-07,04:00:00,13,3,10,FMN 08 Schijnpoortweg
675,Schijnpoortweg,2023-01-07,05:00:00,18,6,12,FMN 08 Schijnpoortweg
675,Schijnpoortweg,2023-01-07,06:00:00,28,9,19,FMN 08 Schijnpoortweg
675,Schijnpoortweg,2023-01-07,07:00:00,33,8,25,FMN 08 Schijnpoortweg
675,Schijnpoortweg,2023-01-07,08:00:00,32,4,28,FMN 08 Schijnpoortweg
675,Schijnpoortweg,2023-01-07,09:00:00,58,6,52,FMN 08 Schijnpoortweg
675,Schijnpoortweg,2023-01-07,10:00:00,73,10,63,FMN 08 Schijnpoortweg
675,Schijnpoortweg,2023-01-07,11:00:00,73,13,60,FMN 08 Schijnpoortweg
675,Schijnpoortweg,2023-01-07,12:00:00,89,14,75,FMN 08 Schijnpoortweg
675,Schijnpoortweg,2023-01-07,13:00:00,83,10,73,FMN 08 Schijnpoortweg
675,Schijnpoortweg,2023-01-07,14:00:00,95,10,85,FMN 08 Schijnpoortweg
675,Schijnpoortweg,2023-01-07,15:00:00,101,9,92,FMN 08 Schijnpoortweg
675,Schijnpoortweg,2023-01-07,16:00:00,98,13,85,FMN 08 Schijnpoortweg
675,Schijnpoortweg,2023-01-07,17:00:00,110,20,90,FMN 08 Schijnpoortweg
675,Schijnpoortweg,2023-01-07,18:00:00,114,14,100,FMN 08 Schijnpoortweg
675,Schijnpoortweg,2023-01-07,19:00:00,117,11,106,FMN 08 Schijnpoortweg
675,Schijnpoortweg,2023-01-07,20:00:00,90,7,83,FMN 08 Schijnpoortweg
675,Schijnpoortweg,2023-01-07,21:00:00,64,13,51,FMN 08 Schijnpoortweg
675,Schijnpoortweg,2023-01-07,22:00:00,58,12,46,FMN 08 Schijnpoortweg
675,Schijnpoortweg,2023-01-07,23:00:00,60,16,44,FMN 08 Schijnpoortweg
675,Schijnpoortweg,2023-01-08,00:00:00,31,6,25,FMN 08 Schijnpoortweg
675,Schijnpoortweg,2023-01-08,01:00:00,34,7,27,FMN 08 Schijnpoortweg
675,Schijnpoortweg,2023-01-08,02:00:00,28,6,22,FMN 08 Schijnpoortweg
675,Schijnpoortweg,2023-01-08,03:00:00,15,2,13,FMN 08 Schijnpoortweg
675,Schijnpoortweg,2023-01-08,04:00:00,10,4,6,FMN 08 Schijnpoortweg
675,Schijnpoortweg,2023-01-08,05:00:00,3,0,3,FMN 08 Schijnpoortweg
675,Schijnpoortweg,2023-01-08,06:00:00,18,7,11,FMN 08 Schijnpoortweg
675,Schijnpoortweg,2023-01-08,07:00:00,19,4,15,FMN 08 Schijnpoortweg
675,Schijnpoortweg,2023-01-08,08:00:00,24,4,20,FMN 08 Schijnpoortweg
675,Schijnpoortweg,2023-01-08,09:00:00,28,5,23,FMN 08 Schijnpoortweg
675,Schijnpoortweg,2023-01-08,10:00:00,74,25,49,FMN 08 Schijnpoortweg
675,Schijnpoortweg,2023-01-08,11:00:00,76,9,67,FMN 08 Schijnpoortweg
675,Schijnpoortweg,2023-01-08,12:00:00,73,13,60,FMN 08 Schijnpoortweg
675,Schijnpoortweg,2023-01-08,13:00:00,92,14,78,FMN 08 Schijnpoortweg
675,Schijnpoortweg,2023-01-08,14:00:00,91,18,73,FMN 08 Schijnpoortweg
675,Schijnpoortweg,2023-01-08,15:00:00,109,16,93,FMN 08 Schijnpoortweg
675,Schijnpoortweg,2023-01-08,16:00:00,137,27,110,FMN 08 Schijnpoortweg
675,Schijnpoortweg,2023-01-08,17:00:00,147,42,105,FMN 08 Schijnpoortweg
675,Schijnpoortweg,2023-01-08,18:00:00,177,78,99,FMN 08 Schijnpoortweg
675,Schijnpoortweg,2023-01-08,19:00:00,95,15,80,FMN 08 Schijnpoortweg
675,Schijnpoortweg,2023-01-08,20:00:00,86,14,72,FMN 08 Schijnpoortweg
675,Schijnpoortweg,2023-01-08,21:00:00,97,42,55,FMN 08 Schijnpoortweg
675,Schijnpoortweg,2023-01-08,22:00:00,70,33,37,FMN 08 Schijnpoortweg
675,Schijnpoortweg,2023-01-08,23:00:00,40,6,34,FMN 08 Schijnpoortweg
675,Schijnpoortweg,2023-01-09,00:00:00,18,4,14,FMN 08 Schijnpoortweg
675,Schijnpoortweg,2023-01-09,01:00:00,13,9,4,FMN 08 Schijnpoortweg
675,Schijnpoortweg,2023-01-09,02:00:00,9,2,7,FMN 08 Schijnpoortweg
675,Schijnpoortweg,2023-01-09,03:00:00,12,3,9,FMN 08 Schijnpoortweg
675,Schijnpoortweg,2023-01-09,04:00:00,29,9,20,FMN 08 Schijnpoortweg
675,Schijnpoortweg,2023-01-09,05:00:00,48,7,41,FMN 08 Schijnpoortweg
675,Schijnpoortweg,2023-01-09,06:00:00,87,24,63,FMN 08 Schijnpoortweg
675,Schijnpoortweg,2023-01-09,07:00:00,180,24,156,FMN 08 Schijnpoortweg
675,Schijnpoortweg,2023-01-09,08:00:00,213,45,168,FMN 08 Schijnpoortweg
675,Schijnpoortweg,2023-01-09,09:00:00,82,15,67,FMN 08 Schijnpoortweg
675,Schijnpoortweg,2023-01-09,10:00:00,77,15,62,FMN 08 Schijnpoortweg
675,Schijnpoortweg,2023-01-09,11:00:00,67,16,51,FMN 08 Schijnpoortweg
675,Schijnpoortweg,2023-01-09,12:00:00,110,24,86,FMN 08 Schijnpoortweg
675,Schijnpoortweg,2023-01-09,13:00:00,106,5,101,FMN 08 Schijnpoortweg
675,Schijnpoortweg,2023-01-09,14:00:00,126,18,108,FMN 08 Schijnpoortweg
675,Schijnpoortweg,2023-01-09,15:00:00,219,36,183,FMN 08 Schijnpoortweg
675,Schijnpoortweg,2023-01-09,16:00:00,320,29,291,FMN 08 Schijnpoortweg
675,Schijnpoortweg,2023-01-09,17:00:00,252,28,224,FMN 08 Schijnpoortweg
675,Schijnpoortweg,2023-01-09,18:00:00,154,25,129,FMN 08 Schijnpoortweg
675,Schijnpoortweg,2023-01-09,19:00:00,127,20,107,FMN 08 Schijnpoortweg
675,Schijnpoortweg,2023-01-09,20:00:00,121,32,89,FMN 08 Schijnpoortweg
675,Schijnpoortweg,2023-01-09,21:00:00,73,5,68,FMN 08 Schijnpoortweg
675,Schijnpoortweg,2023-01-09,22:00:00,85,16,69,FMN 08 Schijnpoortweg
675,Schijnpoortweg,2023-01-09,23:00:00,35,7,28,FMN 08 Schijnpoortweg
675,Schijnpoortweg,2023-01-10,00:00:00,34,8,26,FMN 08 Schijnpoortweg
675,Schijnpoortweg,2023-01-10,01:00:00,12,2,10,FMN 08 Schijnpoortweg
675,Schijnpoortweg,2023-01-10,02:00:00,11,1,10,FMN 08 Schijnpoortweg
675,Schijnpoortweg,2023-01-10,03:00:00,7,2,5,FMN 08 Schijnpoortweg
675,Schijnpoortweg,2023-01-10,04:00:00,26,9,17,FMN 08 Schijnpoortweg
675,Schijnpoortweg,2023-01-10,05:00:00,55,7,48,FMN 08 Schijnpoortweg
675,Schijnpoortweg,2023-01-10,06:00:00,92,15,77,FMN 08 Schijnpoortweg
675,Schijnpoortweg,2023-01-10,07:00:00,182,27,155,FMN 08 Schijnpoortweg
675,Schijnpoortweg,2023-01-10,08:00:00,224,44,180,FMN 08 Schijnpoortweg
675,Schijnpoortweg,2023-01-10,09:00:00,108,19,89,FMN 08 Schijnpoortweg
675,Schijnpoortweg,2023-01-10,10:00:00,77,21,56,FMN 08 Schijnpoortweg
675,Schijnpoortweg,2023-01-10,11:00:00,98,13,85,FMN 08 Schijnpoortweg
675,Schijnpoortweg,2023-01-10,12:00:00,115,19,96,FMN 08 Schijnpoortweg
675,Schijnpoortweg,2023-01-10,13:00:00,113,9,104,FMN 08 Schijnpoortweg
675,Schijnpoortweg,2023-01-10,14:00:00,100,9,91,FMN 08 Schijnpoortweg
675,Schijnpoortweg,2023-01-10,15:00:00,180,25,155,FMN 08 Schijnpoortweg
675,Schijnpoortweg,2023-01-10,16:00:00,279,29,250,FMN 08 Schijnpoortweg
675,Schijnpoortweg,2023-01-10,17:00:00,249,18,231,FMN 08 Schijnpoortweg
675,Schijnpoortweg,2023-01-10,18:00:00,166,17,149,FMN 08 Schijnpoortweg
675,Schijnpoortweg,2023-01-10,19:00:00,146,13,133,FMN 08 Schijnpoortweg
675,Schijnpoortweg,2023-01-10,20:00:00,83,12,71,FMN 08 Schijnpoortweg
675,Schijnpoortweg,2023-01-10,21:00:00,66,11,55,FMN 08 Schijnpoortweg
675,Schijnpoortweg,2023-01-10,22:00:00,80,8,72,FMN 08 Schijnpoortweg
675,Schijnpoortweg,2023-01-10,23:00:00,34,7,27,FMN 08 Schijnpoortweg
675,Schijnpoortweg,2023-01-11,00:00:00,22,2,20,FMN 08 Schijnpoortweg
675,Schijnpoortweg,2023-01-11,01:00:00,12,5,7,FMN 08 Schijnpoortweg
675,Schijnpoortweg,2023-01-11,02:00:00,18,4,14,FMN 08 Schijnpoortweg
675,Schijnpoortweg,2023-01-11,03:00:00,9,1,8,FMN 08 Schijnpoortweg
675,Schijnpoortweg,2023-01-11,04:00:00,24,10,14,FMN 08 Schijnpoortweg
675,Schijnpoortweg,2023-01-11,05:00:00,46,5,41,FMN 08 Schijnpoortweg
675,Schijnpoortweg,2023-01-11,06:00:00,85,24,61,FMN 08 Schijnpoortweg
675,Schijnpoortweg,2023-01-11,07:00:00,180,25,155,FMN 08 Schijnpoortweg
675,Schijnpoortweg,2023-01-11,08:00:00,271,92,179,FMN 08 Schijnpoortweg
675,Schijnpoortweg,2023-01-11,09:00:00,115,42,73,FMN 08 Schijnpoortweg
675,Schijnpoortweg,2023-01-11,10:00:00,118,34,84,FMN 08 Schijnpoortweg
675,Schijnpoortweg,2023-01-11,11:00:00,138,38,100,FMN 08 Schijnpoortweg
675,Schijnpoortweg,2023-01-11,12:00:00,283,89,194,FMN 08 Schijnpoortweg
675,Schijnpoortweg,2023-01-11,13:00:00,203,54,149,FMN 08 Schijnpoortweg
675,Schijnpoortweg,2023-01-11,14:00:00,201,74,127,FMN 08 Schijnpoortweg
675,Schijnpoortweg,2023-01-11,15:00:00,233,51,182,FMN 08 Schijnpoortweg
675,Schijnpoortweg,2023-01-11,16:00:00,311,69,242,FMN 08 Schijnpoortweg
675,Schijnpoortweg,2023-01-11,17:00:00,313,65,248,FMN 08 Schijnpoortweg
675,Schijnpoortweg,2023-01-11,18:00:00,222,45,177,FMN 08 Schijnpoortweg
675,Schijnpoortweg,2023-01-11,19:00:00,168,36,132,FMN 08 Schijnpoortweg
675,Schijnpoortweg,2023-01-11,20:00:00,141,25,116,FMN 08 Schijnpoortweg
675,Schijnpoortweg,2023-01-11,21:00:00,88,21,67,FMN 08 Schijnpoortweg
675,Schijnpoortweg,2023-01-11,22:00:00,94,34,60,FMN 08 Schijnpoortweg
675,Schijnpoortweg,2023-01-11,23:00:00,52,11,41,FMN 08 Schijnpoortweg
675,Schijnpoortweg,2023-01-12,00:00:00,25,4,21,FMN 08 Schijnpoortweg
675,Schijnpoortweg,2023-01-12,01:00:00,24,11,13,FMN 08 Schijnpoortweg
675,Schijnpoortweg,2023-01-12,02:00:00,13,3,10,FMN 08 Schijnpoortweg
675,Schijnpoortweg,2023-01-12,03:00:00,8,2,6,FMN 08 Schijnpoortweg
675,Schijnpoortweg,2023-01-12,04:00:00,29,18,11,FMN 08 Schijnpoortweg
675,Schijnpoortweg,2023-01-12,05:00:00,49,17,32,FMN 08 Schijnpoortweg
675,Schijnpoortweg,2023-01-12,06:00:00,101,44,57,FMN 08 Schijnpoortweg
675,Schijnpoortweg,2023-01-12,07:00:00,192,64,128,FMN 08 Schijnpoortweg
675,Schijnpoortweg,2023-01-12,08:00:00,215,90,125,FMN 08 Schijnpoortweg
675,Schijnpoortweg,2023-01-12,09:00:00,90,37,53,FMN 08 Schijnpoortweg
675,Schijnpoortweg,2023-01-12,10:00:00,77,35,42,FMN 08 Schijnpoortweg
675,Schijnpoortweg,2023-01-12,11:00:00,68,20,48,FMN 08 Schijnpoortweg
675,Schijnpoortweg,2023-01-12,12:00:00,113,47,66,FMN 08 Schijnpoortweg
675,Schijnpoortweg,2023-01-12,13:00:00,85,20,65,FMN 08 Schijnpoortweg
675,Schijnpoortweg,2023-01-12,14:00:00,84,23,61,FMN 08 Schijnpoortweg
675,Schijnpoortweg,2023-01-12,15:00:00,168,42,126,FMN 08 Schijnpoortweg
675,Schijnpoortweg,2023-01-12,16:00:00,246,70,176,FMN 08 Schijnpoortweg
675,Schijnpoortweg,2023-01-12,17:00:00,278,83,195,FMN 08 Schijnpoortweg
675,Schijnpoortweg,2023-01-12,18:00:00,194,48,146,FMN 08 Schijnpoortweg
675,Schijnpoortweg,2023-01-12,19:00:00,154,46,108,FMN 08 Schijnpoortweg
675,Schijnpoortweg,2023-01-12,20:00:00,115,27,88,FMN 08 Schijnpoortweg
675,Schijnpoortweg,2023-01-12,21:00:00,87,31,56,FMN 08 Schijnpoortweg
675,Schijnpoortweg,2023-01-12,22:00:00,109,48,61,FMN 08 Schijnpoortweg
675,Schijnpoortweg,2023-01-12,23:00:00,81,39,42,FMN 08 Schijnpoortweg
675,Schijnpoortweg,2023-01-13,00:00:00,47,27,20,FMN 08 Schijnpoortweg
675,Schijnpoortweg,2023-01-13,01:00:00,33,16,17,FMN 08 Schijnpoortweg
675,Schijnpoortweg,2023-01-13,02:00:00,22,6,16,FMN 08 Schijnpoortweg
675,Schijnpoortweg,2023-01-13,03:00:00,15,6,9,FMN 08 Schijnpoortweg
675,Schijnpoortweg,2023-01-13,04:00:00,30,18,12,FMN 08 Schijnpoortweg
675,Schijnpoortweg,2023-01-13,05:00:00,65,18,47,FMN 08 Schijnpoortweg
675,Schijnpoortweg,2023-01-13,06:00:00,110,48,62,FMN 08 Schijnpoortweg
675,Schijnpoortweg,2023-01-13,07:00:00,219,73,146,FMN 08 Schijnpoortweg
675,Schijnpoortweg,2023-01-13,08:00:00,289,109,180,FMN 08 Schijnpoortweg
675,Schijnpoortweg,2023-01-13,09:00:00,130,55,75,FMN 08 Schijnpoortweg
675,Schijnpoortweg,2023-01-13,10:00:00,105,41,64,FMN 08 Schijnpoortweg
675,Schijnpoortweg,2023-01-13,11:00:00,145,50,95,FMN 08 Schijnpoortweg
675,Schijnpoortweg,2023-01-13,12:00:00,197,67,130,FMN 08 Schijnpoortweg
675,Schijnpoortweg,2023-01-13,13:00:00,147,40,107,FMN 08 Schijnpoortweg
675,Schijnpoortweg,2023-01-13,14:00:00,192,57,135,FMN 08 Schijnpoortweg
675,Schijnpoortweg,2023-01-13,15:00:00,267,69,198,FMN 08 Schijnpoortweg
675,Schijnpoortweg,2023-01-13,16:00:00,308,76,232,FMN 08 Schijnpoortweg
675,Schijnpoortweg,2023-01-13,17:00:00,263,61,202,FMN 08 Schijnpoortweg
675,Schijnpoortweg,2023-01-13,18:00:00,205,66,139,FMN 08 Schijnpoortweg
675,Schijnpoortweg,2023-01-13,19:00:00,228,71,157,FMN 08 Schijnpoortweg
675,Schijnpoortweg,2023-01-13,20:00:00,204,70,134,FMN 08 Schijnpoortweg
675,Schijnpoortweg,2023-01-13,21:00:00,120,36,84,FMN 08 Schijnpoortweg
675,Schijnpoortweg,2023-01-13,22:00:00,194,116,78,FMN 08 Schijnpoortweg
675,Schijnpoortweg,2023-01-13,23:00:00,87,29,58,FMN 08 Schijnpoortweg
675,Schijnpoortweg,2023-01-14,00:00:00,50,15,35,FMN 08 Schijnpoortweg
675,Schijnpoortweg,2023-01-14,01:00:00,43,9,34,FMN 08 Schijnpoortweg
675,Schijnpoortweg,2023-01-14,02:00:00,26,6,20,FMN 08 Schijnpoortweg
675,Schijnpoortweg,2023-01-14,03:00:00,41,19,22,FMN 08 Schijnpoortweg
675,Schijnpoortweg,2023-01-14,04:00:00,25,11,14,FMN 08 Schijnpoortweg
675,Schijnpoortweg,2023-01-14,05:00:00,24,12,12,FMN 08 Schijnpoortweg
675,Schijnpoortweg,2023-01-14,06:00:00,28,11,17,FMN 08 Schijnpoortweg
675,Schijnpoortweg,2023-01-14,07:00:00,39,10,29,FMN 08 Schijnpoortweg
675,Schijnpoortweg,2023-01-14,08:00:00,48,17,31,FMN 08 Schijnpoortweg
675,Schijnpoortweg,2023-01-14,09:00:00,68,27,41,FMN 08 Schijnpoortweg
675,Schijnpoortweg,2023-01-14,10:00:00,59,18,41,FMN 08 Schijnpoortweg
675,Schijnpoortweg,2023-01-14,11:00:00,81,29,52,FMN 08 Schijnpoortweg
675,Schijnpoortweg,2023-01-14,12:00:00,92,39,53,FMN 08 Schijnpoortweg
675,Schijnpoortweg,2023-01-14,13:00:00,87,33,54,FMN 08 Schijnpoortweg
675,Schijnpoortweg,2023-01-14,14:00:00,113,51,62,FMN 08 Schijnpoortweg
675,Schijnpoortweg,2023-01-14,15:00:00,95,44,51,FMN 08 Schijnpoortweg
675,Schijnpoortweg,2023-01-14,16:00:00,146,59,87,FMN 08 Schijnpoortweg
675,Schijnpoortweg,2023-01-14,17:00:00,123,44,79,FMN 08 Schijnpoortweg
675,Schijnpoortweg,2023-01-14,18:00:00,155,70,85,FMN 08 Schijnpoortweg
675,Schijnpoortweg,2023-01-14,19:00:00,154,68,86,FMN 08 Schijnpoortweg
675,Schijnpoortweg,2023-01-14,20:00:00,117,48,69,FMN 08 Schijnpoortweg
675,Schijnpoortweg,2023-01-14,21:00:00,94,36,58,FMN 08 Schijnpoortweg
675,Schijnpoortweg,2023-01-14,22:00:00,105,49,56,FMN 08 Schijnpoortweg
675,Schijnpoortweg,2023-01-14,23:00:00,67,23,44,FMN 08 Schijnpoortweg
675,Schijnpoortweg,2023-01-15,00:00:00,45,15,30,FMN 08 Schijnpoortweg
675,Schijnpoortweg,2023-01-15,01:00:00,49,22,27,FMN 08 Schijnpoortweg
675,Schijnpoortweg,2023-01-15,02:00:00,25,9,16,FMN 08 Schijnpoortweg
675,Schijnpoortweg,2023-01-15,03:00:00,22,8,14,FMN 08 Schijnpoortweg
675,Schijnpoortweg,2023-01-15,04:00:00,17,8,9,FMN 08 Schijnpoortweg
675,Schijnpoortweg,2023-01-15,05:00:00,22,11,11,FMN 08 Schijnpoortweg
675,Schijnpoortweg,2023-01-15,06:00:00,20,9,11,FMN 08 Schijnpoortweg
675,Schijnpoortweg,2023-01-15,07:00:00,27,7,20,FMN 08 Schijnpoortweg
675,Schijnpoortweg,2023-01-15,08:00:00,35,18,17,FMN 08 Schijnpoortweg
675,Schijnpoortweg,2023-01-15,09:00:00,77,29,48,FMN 08 Schijnpoortweg
675,Schijnpoortweg,2023-01-15,10:00:00,82,37,45,FMN 08 Schijnpoortweg
675,Schijnpoortweg,2023-01-15,11:00:00,141,63,78,FMN 08 Schijnpoortweg
675,Schijnpoortweg,2023-01-15,12:00:00,118,46,72,FMN 08 Schijnpoortweg
675,Schijnpoortweg,2023-01-15,13:00:00,152,60,92,FMN 08 Schijnpoortweg
675,Schijnpoortweg,2023-01-15,14:00:00,151,68,83,FMN 08 Schijnpoortweg
675,Schijnpoortweg,2023-01-15,15:00:00,145,54,91,FMN 08 Schijnpoortweg
675,Schijnpoortweg,2023-01-15,16:00:00,120,38,82,FMN 08 Schijnpoortweg
675,Schijnpoortweg,2023-01-15,17:00:00,127,47,80,FMN 08 Schijnpoortweg
675,Schijnpoortweg,2023-01-15,18:00:00,91,40,51,FMN 08 Schijnpoortweg
675,Schijnpoortweg,2023-01-15,19:00:00,91,23,68,FMN 08 Schijnpoortweg
675,Schijnpoortweg,2023-01-15,20:00:00,80,29,51,FMN 08 Schijnpoortweg
675,Schijnpoortweg,2023-01-15,21:00:00,83,27,56,FMN 08 Schijnpoortweg
675,Schijnpoortweg,2023-01-15,22:00:00,63,24,39,FMN 08 Schijnpoortweg
675,Schijnpoortweg,2023-01-15,23:00:00,31,9,22,FMN 08 Schijnpoortweg
675,Schijnpoortweg,2023-01-16,00:00:00,20,9,11,FMN 08 Schijnpoortweg
675,Schijnpoortweg,2023-01-16,01:00:00,14,7,7,FMN 08 Schijnpoortweg
675,Schijnpoortweg,2023-01-16,02:00:00,19,5,14,FMN 08 Schijnpoortweg
675,Schijnpoortweg,2023-01-16,03:00:00,20,9,11,FMN 08 Schijnpoortweg
675,Schijnpoortweg,2023-01-16,04:00:00,30,17,13,FMN 08 Schijnpoortweg
675,Schijnpoortweg,2023-01-16,05:00:00,49,16,33,FMN 08 Schijnpoortweg
675,Schijnpoortweg,2023-01-16,06:00:00,85,30,55,FMN 08 Schijnpoortweg
675,Schijnpoortweg,2023-01-16,07:00:00,166,41,125,FMN 08 Schijnpoortweg
675,Schijnpoortweg,2023-01-16,08:00:00,217,81,136,FMN 08 Schijnpoortweg
675,Schijnpoortweg,2023-01-16,09:00:00,119,61,58,FMN 08 Schijnpoortweg
675,Schijnpoortweg,2023-01-16,10:00:00,90,30,60,FMN 08 Schijnpoortweg
675,Schijnpoortweg,2023-01-16,11:00:00,85,35,50,FMN 08 Schijnpoortweg
675,Schijnpoortweg,2023-01-16,12:00:00,142,45,97,FMN 08 Schijnpoortweg
675,Schijnpoortweg,2023-01-16,13:00:00,129,47,82,FMN 08 Schijnpoortweg
675,Schijnpoortweg,2023-01-16,14:00:00,142,50,92,FMN 08 Schijnpoortweg
675,Schijnpoortweg,2023-01-16,15:00:00,221,54,167,FMN 08 Schijnpoortweg
675,Schijnpoortweg,2023-01-16,16:00:00,262,70,192,FMN 08 Schijnpoortweg
675,Schijnpoortweg,2023-01-16,17:00:00,256,87,169,FMN 08 Schijnpoortweg
675,Schijnpoortweg,2023-01-16,18:00:00,192,67,125,FMN 08 Schijnpoortweg
675,Schijnpoortweg,2023-01-16,19:00:00,127,43,84,FMN 08 Schijnpoortweg
675,Schijnpoortweg,2023-01-16,20:00:00,98,36,62,FMN 08 Schijnpoortweg
675,Schijnpoortweg,2023-01-16,21:00:00,89,26,63,FMN 08 Schijnpoortweg
675,Schijnpoortweg,2023-01-16,22:00:00,95,40,55,FMN 08 Schijnpoortweg
675,Schijnpoortweg,2023-01-16,23:00:00,30,11,19,FMN 08 Schijnpoortweg
675,Schijnpoortweg,2023-01-17,00:00:00,32,13,19,FMN 08 Schijnpoortweg
675,Schijnpoortweg,2023-01-17,01:00:00,16,9,7,FMN 08 Schijnpoortweg
675,Schijnpoortweg,2023-01-17,02:00:00,14,3,11,FMN 08 Schijnpoortweg
675,Schijnpoortweg,2023-01-17,03:00:00,17,7,10,FMN 08 Schijnpoortweg
675,Schijnpoortweg,2023-01-17,04:00:00,35,18,17,FMN 08 Schijnpoortweg
675,Schijnpoortweg,2023-01-17,05:00:00,61,24,37,FMN 08 Schijnpoortweg
675,Schijnpoortweg,2023-01-17,06:00:00,124,62,62,FMN 08 Schijnpoortweg
675,Schijnpoortweg,2023-01-17,07:00:00,214,72,142,FMN 08 Schijnpoortweg
675,Schijnpoortweg,2023-01-17,08:00:00,285,120,165,FMN 08 Schijnpoortweg
675,Schijnpoortweg,2023-01-17,09:00:00,158,62,96,FMN 08 Schijnpoortweg
675,Schijnpoortweg,2023-01-17,10:00:00,107,51,56,FMN 08 Schijnpoortweg
675,Schijnpoortweg,2023-01-17,11:00:00,126,55,71,FMN 08 Schijnpoortweg
675,Schijnpoortweg,2023-01-17,12:00:00,183,89,94,FMN 08 Schijnpoortweg
675,Schijnpoortweg,2023-01-17,13:00:00,169,62,107,FMN 08 Schijnpoortweg
675,Schijnpoortweg,2023-01-17,14:00:00,187,67,120,FMN 08 Schijnpoortweg
675,Schijnpoortweg,2023-01-17,15:00:00,300,87,213,FMN 08 Schijnpoortweg
675,Schijnpoortweg,2023-01-17,16:00:00,383,121,262,FMN 08 Schijnpoortweg
675,Schijnpoortweg,2023-01-17,17:00:00,365,103,262,FMN 08 Schijnpoortweg
675,Schijnpoortweg,2023-01-17,18:00:00,234,63,171,FMN 08 Schijnpoortweg
675,Schijnpoortweg,2023-01-17,19:00:00,213,62,151,FMN 08 Schijnpoortweg
675,Schijnpoortweg,2023-01-17,20:00:00,117,42,75,FMN 08 Schijnpoortweg
675,Schijnpoortweg,2023-01-17,21:00:00,126,48,78,FMN 08 Schijnpoortweg
675,Schijnpoortweg,2023-01-17,22:00:00,103,35,68,FMN 08 Schijnpoortweg
675,Schijnpoortweg,2023-01-17,23:00:00,57,14,43,FMN 08 Schijnpoortweg
675,Schijnpoortweg,2023-01-18,00:00:00,32,10,22,FMN 08 Schijnpoortweg
675,Schijnpoortweg,2023-01-18,01:00:00,15,5,10,FMN 08 Schijnpoortweg
675,Schijnpoortweg,2023-01-18,02:00:00,21,5,16,FMN 08 Schijnpoortweg
675,Schijnpoortweg,2023-01-18,03:00:00,14,8,6,FMN 08 Schijnpoortweg
675,Schijnpoortweg,2023-01-18,04:00:00,36,18,18,FMN 08 Schijnpoortweg
675,Schijnpoortweg,2023-01-18,05:00:00,82,29,53,FMN 08 Schijnpoortweg
675,Schijnpoortweg,2023-01-18,06:00:00,118,53,65,FMN 08 Schijnpoortweg
675,Schijnpoortweg,2023-01-18,07:00:00,203,67,136,FMN 08 Schijnpoortweg
675,Schijnpoortweg,2023-01-18,08:00:00,290,120,170,FMN 08 Schijnpoortweg
675,Schijnpoortweg,2023-01-18,09:00:00,143,64,79,FMN 08 Schijnpoortweg
675,Schijnpoortweg,2023-01-18,10:00:00,127,56,71,FMN 08 Schijnpoortweg
675,Schijnpoortweg,2023-01-18,11:00:00,161,69,92,FMN 08 Schijnpoortweg
675,Schijnpoortweg,2023-01-18,12:00:00,333,152,181,FMN 08 Schijnpoortweg
675,Schijnpoortweg,2023-01-18,13:00:00,249,121,128,FMN 08 Schijnpoortweg
675,Schijnpoortweg,2023-01-18,14:00:00,226,107,119,FMN 08 Schijnpoortweg
675,Schijnpoortweg,2023-01-18,15:00:00,246,91,155,FMN 08 Schijnpoortweg
675,Schijnpoortweg,2023-01-18,16:00:00,328,100,228,FMN 08 Schijnpoortweg
675,Schijnpoortweg,2023-01-18,17:00:00,328,108,220,FMN 08 Schijnpoortweg
675,Schijnpoortweg,2023-01-18,18:00:00,252,76,176,FMN 08 Schijnpoortweg
675,Schijnpoortweg,2023-01-18,19:00:00,192,58,134,FMN 08 Schijnpoortweg
675,Schijnpoortweg,2023-01-18,20:00:00,134,36,98,FMN 08 Schijnpoortweg
675,Schijnpoortweg,2023-01-18,21:00:00,88,24,64,FMN 08 Schijnpoortweg
675,Schijnpoortweg,2023-01-18,22:00:00,92,35,57,FMN 08 Schijnpoortweg
675,Schijnpoortweg,2023-01-18,23:00:00,66,13,53,FMN 08 Schijnpoortweg
675,Schijnpoortweg,2023-01-19,00:00:00,28,9,19,FMN 08 Schijnpoortweg
675,Schijnpoortweg,2023-01-19,01:00:00,24,7,17,FMN 08 Schijnpoortweg
675,Schijnpoortweg,2023-01-19,02:00:00,18,6,12,FMN 08 Schijnpoortweg
675,Schijnpoortweg,2023-01-19,03:00:00,11,3,8,FMN 08 Schijnpoortweg
675,Schijnpoortweg,2023-01-19,04:00:00,36,21,15,FMN 08 Schijnpoortweg
675,Schijnpoortweg,2023-01-19,05:00:00,68,22,46,FMN 08 Schijnpoortweg
675,Schijnpoortweg,2023-01-19,06:00:00,119,49,70,FMN 08 Schijnpoortweg
675,Schijnpoortweg,2023-01-19,07:00:00,207,77,130,FMN 08 Schijnpoortweg
675,Schijnpoortweg,2023-01-19,08:00:00,322,125,197,FMN 08 Schijnpoortweg
675,Schijnpoortweg,2023-01-19,09:00:00,164,80,84,FMN 08 Schijnpoortweg
675,Schijnpoortweg,2023-01-19,10:00:00,106,41,65,FMN 08 Schijnpoortweg
675,Schijnpoortweg,2023-01-19,11:00:00,131,54,77,FMN 08 Schijnpoortweg
675,Schijnpoortweg,2023-01-19,12:00:00,158,68,90,FMN 08 Schijnpoortweg
675,Schijnpoortweg,2023-01-19,13:00:00,138,50,88,FMN 08 Schijnpoortweg
675,Schijnpoortweg,2023-01-19,14:00:00,161,54,107,FMN 08 Schijnpoortweg
675,Schijnpoortweg,2023-01-19,15:00:00,256,65,191,FMN 08 Schijnpoortweg
675,Schijnpoortweg,2023-01-19,16:00:00,326,98,228,FMN 08 Schijnpoortweg
675,Schijnpoortweg,2023-01-19,17:00:00,319,78,241,FMN 08 Schijnpoortweg
675,Schijnpoortweg,2023-01-19,18:00:00,199,55,144,FMN 08 Schijnpoortweg
675,Schijnpoortweg,2023-01-19,19:00:00,175,43,132,FMN 08 Schijnpoortweg
675,Schijnpoortweg,2023-01-19,20:00:00,118,30,88,FMN 08 Schijnpoortweg
675,Schijnpoortweg,2023-01-19,21:00:00,107,29,78,FMN 08 Schijnpoortweg
675,Schijnpoortweg,2023-01-19,22:00:00,95,27,68,FMN 08 Schijnpoortweg
675,Schijnpoortweg,2023-01-19,23:00:00,55,12,43,FMN 08 Schijnpoortweg
675,Schijnpoortweg,2023-01-20,00:00:00,34,10,24,FMN 08 Schijnpoortweg
675,Schijnpoortweg,2023-01-20,01:00:00,28,9,19,FMN 08 Schijnpoortweg
675,Schijnpoortweg,2023-01-20,02:00:00,16,4,12,FMN 08 Schijnpoortweg
675,Schijnpoortweg,2023-01-20,03:00:00,17,7,10,FMN 08 Schijnpoortweg
675,Schijnpoortweg,2023-01-20,04:00:00,37,22,15,FMN 08 Schijnpoortweg
675,Schijnpoortweg,2023-01-20,05:00:00,57,17,40,FMN 08 Schijnpoortweg
675,Schijnpoortweg,2023-01-20,06:00:00,100,36,64,FMN 08 Schijnpoortweg
675,Schijnpoortweg,2023-01-20,07:00:00,177,57,120,FMN 08 Schijnpoortweg
675,Schijnpoortweg,2023-01-20,08:00:00,255,124,131,FMN 08 Schijnpoortweg
675,Schijnpoortweg,2023-01-20,09:00:00,85,33,52,FMN 08 Schijnpoortweg
675,Schijnpoortweg,2023-01-20,10:00:00,76,39,37,FMN 08 Schijnpoortweg
675,Schijnpoortweg,2023-01-20,11:00:00,90,41,49,FMN 08 Schijnpoortweg
675,Schijnpoortweg,2023-01-20,12:00:00,92,39,53,FMN 08 Schijnpoortweg
675,Schijnpoortweg,2023-01-20,13:00:00,85,42,43,FMN 08 Schijnpoortweg
675,Schijnpoortweg,2023-01-20,14:00:00,142,62,80,FMN 08 Schijnpoortweg
675,Schijnpoortweg,2023-01-20,15:00:00,186,51,135,FMN 08 Schijnpoortweg
675,Schijnpoortweg,2023-01-20,16:00:00,212,66,146,FMN 08 Schijnpoortweg
675,Schijnpoortweg,2023-01-20,17:00:00,179,50,129,FMN 08 Schijnpoortweg
675,Schijnpoortweg,2023-01-20,18:00:00,150,57,93,FMN 08 Schijnpoortweg
675,Schijnpoortweg,2023-01-20,19:00:00,133,32,101,FMN 08 Schijnpoortweg
675,Schijnpoortweg,2023-01-20,20:00:00,88,29,59,FMN 08 Schijnpoortweg
675,Schijnpoortweg,2023-01-20,21:00:00,82,19,63,FMN 08 Schijnpoortweg
675,Schijnpoortweg,2023-01-20,22:00:00,80,21,59,FMN 08 Schijnpoortweg
675,Schijnpoortweg,2023-01-20,23:00:00,68,23,45,FMN 08 Schijnpoortweg
675,Schijnpoortweg,2023-01-21,00:00:00,40,16,24,FMN 08 Schijnpoortweg
675,Schijnpoortweg,2023-01-21,01:00:00,24,7,17,FMN 08 Schijnpoortweg
675,Schijnpoortweg,2023-01-21,02:00:00,22,5,17,FMN 08 Schijnpoortweg
675,Schijnpoortweg,2023-01-21,03:00:00,19,10,9,FMN 08 Schijnpoortweg
675,Schijnpoortweg,2023-01-21,04:00:00,17,8,9,FMN 08 Schijnpoortweg
675,Schijnpoortweg,2023-01-21,05:00:00,18,8,10,FMN 08 Schijnpoortweg
675,Schijnpoortweg,2023-01-21,06:00:00,27,12,15,FMN 08 Schijnpoortweg
675,Schijnpoortweg,2023-01-21,07:00:00,35,14,21,FMN 08 Schijnpoortweg
675,Schijnpoortweg,2023-01-21,08:00:00,56,22,34,FMN 08 Schijnpoortweg
675,Schijnpoortweg,2023-01-21,09:00:00,69,30,39,FMN 08 Schijnpoortweg
675,Schijnpoortweg,2023-01-21,10:00:00,110,41,69,FMN 08 Schijnpoortweg
675,Schijnpoortweg,2023-01-21,11:00:00,117,56,61,FMN 08 Schijnpoortweg
675,Schijnpoortweg,2023-01-21,12:00:00,118,52,66,FMN 08 Schijnpoortweg
675,Schijnpoortweg,2023-01-21,13:00:00,129,46,83,FMN 08 Schijnpoortweg
675,Schijnpoortweg,2023-01-21,14:00:00,137,56,81,FMN 08 Schijnpoortweg
675,Schijnpoortweg,2023-01-21,15:00:00,155,50,105,FMN 08 Schijnpoortweg
675,Schijnpoortweg,2023-01-21,16:00:00,158,56,102,FMN 08 Schijnpoortweg
675,Schijnpoortweg,2023-01-21,17:00:00,183,60,123,FMN 08 Schijnpoortweg
675,Schijnpoortweg,2023-01-21,18:00:00,132,55,77,FMN 08 Schijnpoortweg
675,Schijnpoortweg,2023-01-21,19:00:00,92,32,60,FMN 08 Schijnpoortweg
675,Schijnpoortweg,2023-01-21,20:00:00,101,27,74,FMN 08 Schijnpoortweg
675,Schijnpoortweg,2023-01-21,21:00:00,73,23,50,FMN 08 Schijnpoortweg
675,Schijnpoortweg,2023-01-21,22:00:00,59,24,35,FMN 08 Schijnpoortweg
675,Schijnpoortweg,2023-01-21,23:00:00,53,12,41,FMN 08 Schijnpoortweg
675,Schijnpoortweg,2023-01-22,00:00:00,45,8,37,FMN 08 Schijnpoortweg
675,Schijnpoortweg,2023-01-22,01:00:00,36,15,21,FMN 08 Schijnpoortweg
675,Schijnpoortweg,2023-01-22,02:00:00,24,7,17,FMN 08 Schijnpoortweg
675,Schijnpoortweg,2023-01-22,03:00:00,25,10,15,FMN 08 Schijnpoortweg
675,Schijnpoortweg,2023-01-22,04:00:00,17,3,14,FMN 08 Schijnpoortweg
675,Schijnpoortweg,2023-01-22,05:00:00,15,7,8,FMN 08 Schijnpoortweg
675,Schijnpoortweg,2023-01-22,06:00:00,16,8,8,FMN 08 Schijnpoortweg
675,Schijnpoortweg,2023-01-22,07:00:00,11,5,6,FMN 08 Schijnpoortweg
675,Schijnpoortweg,2023-01-22,08:00:00,29,10,19,FMN 08 Schijnpoortweg
675,Schijnpoortweg,2023-01-22,09:00:00,61,29,32,FMN 08 Schijnpoortweg
675,Schijnpoortweg,2023-01-22,10:00:00,86,30,56,FMN 08 Schijnpoortweg
675,Schijnpoortweg,2023-01-22,11:00:00,98,36,62,FMN 08 Schijnpoortweg
675,Schijnpoortweg,2023-01-22,12:00:00,133,25,108,FMN 08 Schijnpoortweg
675,Schijnpoortweg,2023-01-22,13:00:00,121,33,88,FMN 08 Schijnpoortweg
675,Schijnpoortweg,2023-01-22,14:00:00,115,46,69,FMN 08 Schijnpoortweg
675,Schijnpoortweg,2023-01-22,15:00:00,123,57,66,FMN 08 Schijnpoortweg
675,Schijnpoortweg,2023-01-22,16:00:00,141,70,71,FMN 08 Schijnpoortweg
675,Schijnpoortweg,2023-01-22,17:00:00,145,63,82,FMN 08 Schijnpoortweg
675,Schijnpoortweg,2023-01-22,18:00:00,115,49,66,FMN 08 Schijnpoortweg
675,Schijnpoortweg,2023-01-22,19:00:00,155,40,115,FMN 08 Schijnpoortweg
675,Schijnpoortweg,2023-01-22,20:00:00,75,18,57,FMN 08 Schijnpoortweg
675,Schijnpoortweg,2023-01-22,21:00:00,125,70,55,FMN 08 Schijnpoortweg
675,Schijnpoortweg,2023-01-22,22:00:00,44,18,26,FMN 08 Schijnpoortweg
675,Schijnpoortweg,2023-01-22,23:00:00,37,8,29,FMN 08 Schijnpoortweg
675,Schijnpoortweg,2023-01-23,00:00:00,26,5,21,FMN 08 Schijnpoortweg
675,Schijnpoortweg,2023-01-23,01:00:00,15,6,9,FMN 08 Schijnpoortweg
675,Schijnpoortweg,2023-01-23,02:00:00,17,3,14,FMN 08 Schijnpoortweg
675,Schijnpoortweg,2023-01-23,03:00:00,12,6,6,FMN 08 Schijnpoortweg
675,Schijnpoortweg,2023-01-23,04:00:00,32,19,13,FMN 08 Schijnpoortweg
675,Schijnpoortweg,2023-01-23,05:00:00,65,18,47,FMN 08 Schijnpoortweg
675,Schijnpoortweg,2023-01-23,06:00:00,118,51,67,FMN 08 Schijnpoortweg
675,Schijnpoortweg,2023-01-23,07:00:00,197,49,148,FMN 08 Schijnpoortweg
675,Schijnpoortweg,2023-01-23,08:00:00,268,94,174,FMN 08 Schijnpoortweg
675,Schijnpoortweg,2023-01-23,09:00:00,128,50,78,FMN 08 Schijnpoortweg
675,Schijnpoortweg,2023-01-23,10:00:00,94,40,54,FMN 08 Schijnpoortweg
675,Schijnpoortweg,2023-01-23,11:00:00,131,66,65,FMN 08 Schijnpoortweg
675,Schijnpoortweg,2023-01-23,12:00:00,215,91,124,FMN 08 Schijnpoortweg
675,Schijnpoortweg,2023-01-23,13:00:00,186,85,101,FMN 08 Schijnpoortweg
675,Schijnpoortweg,2023-01-23,14:00:00,225,115,110,FMN 08 Schijnpoortweg
675,Schijnpoortweg,2023-01-23,15:00:00,300,114,186,FMN 08 Schijnpoortweg
675,Schijnpoortweg,2023-01-23,16:00:00,412,133,279,FMN 08 Schijnpoortweg
675,Schijnpoortweg,2023-01-23,17:00:00,362,126,236,FMN 08 Schijnpoortweg
675,Schijnpoortweg,2023-01-23,18:00:00,224,68,156,FMN 08 Schijnpoortweg
675,Schijnpoortweg,2023-01-23,19:00:00,174,59,115,FMN 08 Schijnpoortweg
675,Schijnpoortweg,2023-01-23,20:00:00,136,48,88,FMN 08 Schijnpoortweg
675,Schijnpoortweg,2023-01-23,21:00:00,123,37,86,FMN 08 Schijnpoortweg
675,Schijnpoortweg,2023-01-23,22:00:00,106,48,58,FMN 08 Schijnpoortweg
675,Schijnpoortweg,2023-01-23,23:00:00,60,12,48,FMN 08 Schijnpoortweg
675,Schijnpoortweg,2023-01-24,00:00:00,28,9,19,FMN 08 Schijnpoortweg
675,Schijnpoortweg,2023-01-24,01:00:00,15,6,9,FMN 08 Schijnpoortweg
675,Schijnpoortweg,2023-01-24,02:00:00,15,5,10,FMN 08 Schijnpoortweg
675,Schijnpoortweg,2023-01-24,03:00:00,12,8,4,FMN 08 Schijnpoortweg
675,Schijnpoortweg,2023-01-24,04:00:00,40,24,16,FMN 08 Schijnpoortweg
675,Schijnpoortweg,2023-01-24,05:00:00,78,34,44,FMN 08 Schijnpoortweg
675,Schijnpoortweg,2023-01-24,06:00:00,139,61,78,FMN 08 Schijnpoortweg
675,Schijnpoortweg,2023-01-24,07:00:00,280,126,154,FMN 08 Schijnpoortweg
675,Schijnpoortweg,2023-01-24,08:00:00,384,194,190,FMN 08 Schijnpoortweg
675,Schijnpoortweg,2023-01-24,09:00:00,139,59,80,FMN 08 Schijnpoortweg
675,Schijnpoortweg,2023-01-24,10:00:00,120,57,63,FMN 08 Schijnpoortweg
675,Schijnpoortweg,2023-01-24,11:00:00,139,74,65,FMN 08 Schijnpoortweg
675,Schijnpoortweg,2023-01-24,12:00:00,201,90,111,FMN 08 Schijnpoortweg
675,Schijnpoortweg,2023-01-24,13:00:00,147,58,89,FMN 08 Schijnpoortweg
675,Schijnpoortweg,2023-01-24,14:00:00,189,57,132,FMN 08 Schijnpoortweg
675,Schijnpoortweg,2023-01-24,15:00:00,254,36,218,FMN 08 Schijnpoortweg
675,Schijnpoortweg,2023-01-24,16:00:00,344,76,268,FMN 08 Schijnpoortweg
675,Schijnpoortweg,2023-01-24,17:00:00,323,45,278,FMN 08 Schijnpoortweg
675,Schijnpoortweg,2023-01-24,18:00:00,205,56,149,FMN 08 Schijnpoortweg
675,Schijnpoortweg,2023-01-24,19:00:00,150,36,114,FMN 08 Schijnpoortweg
675,Schijnpoortweg,2023-01-24,20:00:00,110,32,78,FMN 08 Schijnpoortweg
675,Schijnpoortweg,2023-01-24,21:00:00,107,26,81,FMN 08 Schijnpoortweg
675,Schijnpoortweg,2023-01-24,22:00:00,114,32,82,FMN 08 Schijnpoortweg
675,Schijnpoortweg,2023-01-24,23:00:00,45,12,33,FMN 08 Schijnpoortweg
675,Schijnpoortweg,2023-01-25,00:00:00,32,7,25,FMN 08 Schijnpoortweg
675,Schijnpoortweg,2023-01-25,01:00:00,20,8,12,FMN 08 Schijnpoortweg
675,Schijnpoortweg,2023-01-25,02:00:00,12,5,7,FMN 08 Schijnpoortweg
675,Schijnpoortweg,2023-01-25,03:00:00,11,1,10,FMN 08 Schijnpoortweg
675,Schijnpoortweg,2023-01-25,04:00:00,30,15,15,FMN 08 Schijnpoortweg
675,Schijnpoortweg,2023-01-25,05:00:00,73,22,51,FMN 08 Schijnpoortweg
675,Schijnpoortweg,2023-01-25,06:00:00,100,38,62,FMN 08 Schijnpoortweg
675,Schijnpoortweg,2023-01-25,07:00:00,199,46,153,FMN 08 Schijnpoortweg
675,Schijnpoortweg,2023-01-25,08:00:00,272,84,188,FMN 08 Schijnpoortweg
675,Schijnpoortweg,2023-01-25,09:00:00,138,54,84,FMN 08 Schijnpoortweg
675,Schijnpoortweg,2023-01-25,10:00:00,109,49,60,FMN 08 Schijnpoortweg
675,Schijnpoortweg,2023-01-25,11:00:00,137,39,98,FMN 08 Schijnpoortweg
675,Schijnpoortweg,2023-01-25,12:00:00,206,63,143,FMN 08 Schijnpoortweg
675,Schijnpoortweg,2023-01-25,13:00:00,180,57,123,FMN 08 Schijnpoortweg
675,Schijnpoortweg,2023-01-25,14:00:00,191,63,128,FMN 08 Schijnpoortweg
675,Schijnpoortweg,2023-01-25,15:00:00,232,75,157,FMN 08 Schijnpoortweg
675,Schijnpoortweg,2023-01-25,16:00:00,267,79,188,FMN 08 Schijnpoortweg
675,Schijnpoortweg,2023-01-25,17:00:00,286,73,213,FMN 08 Schijnpoortweg
675,Schijnpoortweg,2023-01-25,18:00:00,210,64,146,FMN 08 Schijnpoortweg
675,Schijnpoortweg,2023-01-25,19:00:00,188,52,136,FMN 08 Schijnpoortweg
675,Schijnpoortweg,2023-01-25,20:00:00,130,34,96,FMN 08 Schijnpoortweg
675,Schijnpoortweg,2023-01-25,21:00:00,118,37,81,FMN 08 Schijnpoortweg
675,Schijnpoortweg,2023-01-25,22:00:00,105,46,59,FMN 08 Schijnpoortweg
675,Schijnpoortweg,2023-01-25,23:00:00,46,10,36,FMN 08 Schijnpoortweg
675,Schijnpoortweg,2023-01-26,00:00:00,19,8,11,FMN 08 Schijnpoortweg
675,Schijnpoortweg,2023-01-26,01:00:00,21,10,11,FMN 08 Schijnpoortweg
675,Schijnpoortweg,2023-01-26,02:00:00,14,5,9,FMN 08 Schijnpoortweg
675,Schijnpoortweg,2023-01-26,03:00:00,14,2,12,FMN 08 Schijnpoortweg
675,Schijnpoortweg,2023-01-26,04:00:00,34,21,13,FMN 08 Schijnpoortweg
675,Schijnpoortweg,2023-01-26,05:00:00,69,25,44,FMN 08 Schijnpoortweg
675,Schijnpoortweg,2023-01-26,06:00:00,107,37,70,FMN 08 Schijnpoortweg
675,Schijnpoortweg,2023-01-26,07:00:00,191,64,127,FMN 08 Schijnpoortweg
675,Schijnpoortweg,2023-01-26,08:00:00,273,102,171,FMN 08 Schijnpoortweg
675,Schijnpoortweg,2023-01-26,09:00:00,149,66,83,FMN 08 Schijnpoortweg
675,Schijnpoortweg,2023-01-26,10:00:00,104,42,62,FMN 08 Schijnpoortweg
675,Schijnpoortweg,2023-01-26,11:00:00,117,43,74,FMN 08 Schijnpoortweg
675,Schijnpoortweg,2023-01-26,12:00:00,152,76,76,FMN 08 Schijnpoortweg
675,Schijnpoortweg,2023-01-26,13:00:00,123,28,95,FMN 08 Schijnpoortweg
675,Schijnpoortweg,2023-01-26,14:00:00,138,34,104,FMN 08 Schijnpoortweg
675,Schijnpoortweg,2023-01-26,15:00:00,222,24,198,FMN 08 Schijnpoortweg
675,Schijnpoortweg,2023-01-26,16:00:00,264,32,232,FMN 08 Schijnpoortweg
675,Schijnpoortweg,2023-01-26,17:00:00,299,37,262,FMN 08 Schijnpoortweg
675,Schijnpoortweg,2023-01-26,18:00:00,233,56,177,FMN 08 Schijnpoortweg
675,Schijnpoortweg,2023-01-26,19:00:00,229,62,167,FMN 08 Schijnpoortweg
675,Schijnpoortweg,2023-01-26,20:00:00,187,44,143,FMN 08 Schijnpoortweg
675,Schijnpoortweg,2023-01-26,21:00:00,94,16,78,FMN 08 Schijnpoortweg
675,Schijnpoortweg,2023-01-26,22:00:00,98,22,76,FMN 08 Schijnpoortweg
675,Schijnpoortweg,2023-01-26,23:00:00,125,62,63,FMN 08 Schijnpoortweg
675,Schijnpoortweg,2023-01-27,00:00:00,53,32,21,FMN 08 Schijnpoortweg
675,Schijnpoortweg,2023-01-27,01:00:00,17,6,11,FMN 08 Schijnpoortweg
675,Schijnpoortweg,2023-01-27,02:00:00,13,1,12,FMN 08 Schijnpoortweg
675,Schijnpoortweg,2023-01-27,03:00:00,19,5,14,FMN 08 Schijnpoortweg
675,Schijnpoortweg,2023-01-27,04:00:00,19,9,10,FMN 08 Schijnpoortweg
675,Schijnpoortweg,2023-01-27,05:00:00,55,11,44,FMN 08 Schijnpoortweg
675,Schijnpoortweg,2023-01-27,06:00:00,83,13,70,FMN 08 Schijnpoortweg
675,Schijnpoortweg,2023-01-27,07:00:00,134,20,114,FMN 08 Schijnpoortweg
675,Schijnpoortweg,2023-01-27,08:00:00,188,23,165,FMN 08 Schijnpoortweg
675,Schijnpoortweg,2023-01-27,09:00:00,92,14,78,FMN 08 Schijnpoortweg
675,Schijnpoortweg,2023-01-27,10:00:00,81,15,66,FMN 08 Schijnpoortweg
675,Schijnpoortweg,2023-01-27,11:00:00,85,3,82,FMN 08 Schijnpoortweg
675,Schijnpoortweg,2023-01-27,12:00:00,130,22,108,FMN 08 Schijnpoortweg
675,Schijnpoortweg,2023-01-27,13:00:00,128,21,107,FMN 08 Schijnpoortweg
675,Schijnpoortweg,2023-01-27,14:00:00,149,23,126,FMN 08 Schijnpoortweg
675,Schijnpoortweg,2023-01-27,15:00:00,212,11,201,FMN 08 Schijnpoortweg
675,Schijnpoortweg,2023-01-27,16:00:00,286,21,265,FMN 08 Schijnpoortweg
675,Schijnpoortweg,2023-01-27,17:00:00,264,18,246,FMN 08 Schijnpoortweg
675,Schijnpoortweg,2023-01-27,18:00:00,184,18,166,FMN 08 Schijnpoortweg
675,Schijnpoortweg,2023-01-27,19:00:00,107,15,92,FMN 08 Schijnpoortweg
675,Schijnpoortweg,2023-01-27,20:00:00,87,15,72,FMN 08 Schijnpoortweg
675,Schijnpoortweg,2023-01-27,21:00:00,92,11,81,FMN 08 Schijnpoortweg
675,Schijnpoortweg,2023-01-27,22:00:00,79,10,69,FMN 08 Schijnpoortweg
675,Schijnpoortweg,2023-01-27,23:00:00,58,3,55,FMN 08 Schijnpoortweg
675,Schijnpoortweg,2023-01-28,00:00:00,56,11,45,FMN 08 Schijnpoortweg
675,Schijnpoortweg,2023-01-28,01:00:00,45,18,27,FMN 08 Schijnpoortweg
675,Schijnpoortweg,2023-01-28,02:00:00,33,6,27,FMN 08 Schijnpoortweg
675,Schijnpoortweg,2023-01-28,03:00:00,17,3,14,FMN 08 Schijnpoortweg
675,Schijnpoortweg,2023-01-28,04:00:00,15,3,12,FMN 08 Schijnpoortweg
675,Schijnpoortweg,2023-01-28,05:00:00,13,1,12,FMN 08 Schijnpoortweg
675,Schijnpoortweg,2023-01-28,06:00:00,20,7,13,FMN 08 Schijnpoortweg
675,Schijnpoortweg,2023-01-28,07:00:00,26,3,23,FMN 08 Schijnpoortweg
675,Schijnpoortweg,2023-01-28,08:00:00,51,6,45,FMN 08 Schijnpoortweg
675,Schijnpoortweg,2023-01-28,09:00:00,53,10,43,FMN 08 Schijnpoortweg
675,Schijnpoortweg,2023-01-28,10:00:00,92,21,71,FMN 08 Schijnpoortweg
675,Schijnpoortweg,2023-01-28,11:00:00,89,16,73,FMN 08 Schijnpoortweg
675,Schijnpoortweg,2023-01-28,12:00:00,115,19,96,FMN 08 Schijnpoortweg
675,Schijnpoortweg,2023-01-28,13:00:00,93,13,80,FMN 08 Schijnpoortweg
675,Schijnpoortweg,2023-01-28,14:00:00,147,21,126,FMN 08 Schijnpoortweg
675,Schijnpoortweg,2023-01-28,15:00:00,136,17,119,FMN 08 Schijnpoortweg
675,Schijnpoortweg,2023-01-28,16:00:00,117,20,97,FMN 08 Schijnpoortweg
675,Schijnpoortweg,2023-01-28,17:00:00,138,15,123,FMN 08 Schijnpoortweg
675,Schijnpoortweg,2023-01-28,18:00:00,142,28,114,FMN 08 Schijnpoortweg
675,Schijnpoortweg,2023-01-28,19:00:00,113,19,94,FMN 08 Schijnpoortweg
675,Schijnpoortweg,2023-01-28,20:00:00,105,22,83,FMN 08 Schijnpoortweg
675,Schijnpoortweg,2023-01-28,21:00:00,96,22,74,FMN 08 Schijnpoortweg
675,Schijnpoortweg,2023-01-28,22:00:00,77,13,64,FMN 08 Schijnpoortweg
675,Schijnpoortweg,2023-01-28,23:00:00,63,11,52,FMN 08 Schijnpoortweg
675,Schijnpoortweg,2023-01-29,00:00:00,48,6,42,FMN 08 Schijnpoortweg
675,Schijnpoortweg,2023-01-29,01:00:00,50,7,43,FMN 08 Schijnpoortweg
675,Schijnpoortweg,2023-01-29,02:00:00,22,2,20,FMN 08 Schijnpoortweg
675,Schijnpoortweg,2023-01-29,03:00:00,23,4,19,FMN 08 Schijnpoortweg
675,Schijnpoortweg,2023-01-29,04:00:00,14,2,12,FMN 08 Schijnpoortweg
675,Schijnpoortweg,2023-01-29,05:00:00,14,3,11,FMN 08 Schijnpoortweg
675,Schijnpoortweg,2023-01-29,06:00:00,21,7,14,FMN 08 Schijnpoortweg
675,Schijnpoortweg,2023-01-29,07:00:00,16,5,11,FMN 08 Schijnpoortweg
675,Schijnpoortweg,2023-01-29,08:00:00,31,10,21,FMN 08 Schijnpoortweg
675,Schijnpoortweg,2023-01-29,09:00:00,34,4,30,FMN 08 Schijnpoortweg
675,Schijnpoortweg,2023-01-29,10:00:00,63,13,50,FMN 08 Schijnpoortweg
675,Schijnpoortweg,2023-01-29,11:00:00,70,7,63,FMN 08 Schijnpoortweg
675,Schijnpoortweg,2023-01-29,12:00:00,70,18,52,FMN 08 Schijnpoortweg
675,Schijnpoortweg,2023-01-29,13:00:00,89,11,78,FMN 08 Schijnpoortweg
675,Schijnpoortweg,2023-01-29,14:00:00,72,9,63,FMN 08 Schijnpoortweg
675,Schijnpoortweg,2023-01-29,15:00:00,94,10,84,FMN 08 Schijnpoortweg
675,Schijnpoortweg,2023-01-29,16:00:00,86,13,73,FMN 08 Schijnpoortweg
675,Schijnpoortweg,2023-01-29,17:00:00,97,12,85,FMN 08 Schijnpoortweg
675,Schijnpoortweg,2023-01-29,18:00:00,82,22,60,FMN 08 Schijnpoortweg
675,Schijnpoortweg,2023-01-29,19:00:00,86,12,74,FMN 08 Schijnpoortweg
675,Schijnpoortweg,2023-01-29,20:00:00,78,10,68,FMN 08 Schijnpoortweg
675,Schijnpoortweg,2023-01-29,21:00:00,72,11,61,FMN 08 Schijnpoortweg
675,Schijnpoortweg,2023-01-29,22:00:00,45,7,38,FMN 08 Schijnpoortweg
675,Schijnpoortweg,2023-01-29,23:00:00,34,4,30,FMN 08 Schijnpoortweg
675,Schijnpoortweg,2023-01-30,00:00:00,29,8,21,FMN 08 Schijnpoortweg
675,Schijnpoortweg,2023-01-30,01:00:00,18,6,12,FMN 08 Schijnpoortweg
675,Schijnpoortweg,2023-01-30,02:00:00,12,2,10,FMN 08 Schijnpoortweg
675,Schijnpoortweg,2023-01-30,03:00:00,18,7,11,FMN 08 Schijnpoortweg
675,Schijnpoortweg,2023-01-30,04:00:00,19,12,7,FMN 08 Schijnpoortweg
675,Schijnpoortweg,2023-01-30,05:00:00,61,8,53,FMN 08 Schijnpoortweg
675,Schijnpoortweg,2023-01-30,06:00:00,83,15,68,FMN 08 Schijnpoortweg
675,Schijnpoortweg,2023-01-30,07:00:00,148,10,138,FMN 08 Schijnpoortweg
675,Schijnpoortweg,2023-01-30,08:00:00,213,38,175,FMN 08 Schijnpoortweg
675,Schijnpoortweg,2023-01-30,09:00:00,85,15,70,FMN 08 Schijnpoortweg
675,Schijnpoortweg,2023-01-30,10:00:00,77,20,57,FMN 08 Schijnpoortweg
675,Schijnpoortweg,2023-01-30,11:00:00,91,15,76,FMN 08 Schijnpoortweg
675,Schijnpoortweg,2023-01-30,12:00:00,132,22,110,FMN 08 Schijnpoortweg
675,Schijnpoortweg,2023-01-30,13:00:00,126,11,115,FMN 08 Schijnpoortweg
675,Schijnpoortweg,2023-01-30,14:00:00,113,15,98,FMN 08 Schijnpoortweg
675,Schijnpoortweg,2023-01-30,15:00:00,197,15,182,FMN 08 Schijnpoortweg
675,Schijnpoortweg,2023-01-30,16:00:00,272,26,246,FMN 08 Schijnpoortweg
675,Schijnpoortweg,2023-01-30,17:00:00,267,21,246,FMN 08 Schijnpoortweg
675,Schijnpoortweg,2023-01-30,18:00:00,167,13,154,FMN 08 Schijnpoortweg
675,Schijnpoortweg,2023-01-30,19:00:00,142,15,127,FMN 08 Schijnpoortweg
675,Schijnpoortweg,2023-01-30,20:00:00,112,11,101,FMN 08 Schijnpoortweg
675,Schijnpoortweg,2023-01-30,21:00:00,74,8,66,FMN 08 Schijnpoortweg
675,Schijnpoortweg,2023-01-30,22:00:00,91,18,73,FMN 08 Schijnpoortweg
675,Schijnpoortweg,2023-01-30,23:00:00,44,12,32,FMN 08 Schijnpoortweg
675,Schijnpoortweg,2023-01-31,00:00:00,22,3,19,FMN 08 Schijnpoortweg
675,Schijnpoortweg,2023-01-31,01:00:00,26,5,21,FMN 08 Schijnpoortweg
675,Schijnpoortweg,2023-01-31,02:00:00,11,0,11,FMN 08 Schijnpoortweg
675,Schijnpoortweg,2023-01-31,03:00:00,13,3,10,FMN 08 Schijnpoortweg
675,Schijnpoortweg,2023-01-31,04:00:00,16,8,8,FMN 08 Schijnpoortweg
675,Schijnpoortweg,2023-01-31,05:00:00,59,10,49,FMN 08 Schijnpoortweg
675,Schijnpoortweg,2023-01-31,06:00:00,96,18,78,FMN 08 Schijnpoortweg
675,Schijnpoortweg,2023-01-31,07:00:00,187,32,155,FMN 08 Schijnpoortweg
675,Schijnpoortweg,2023-01-31,08:00:00,209,35,174,FMN 08 Schijnpoortweg
675,Schijnpoortweg,2023-01-31,09:00:00,105,17,88,FMN 08 Schijnpoortweg
675,Schijnpoortweg,2023-01-31,10:00:00,84,18,66,FMN 08 Schijnpoortweg
675,Schijnpoortweg,2023-01-31,11:00:00,81,11,70,FMN 08 Schijnpoortweg
675,Schijnpoortweg,2023-01-31,12:00:00,118,22,96,FMN 08 Schijnpoortweg
675,Schijnpoortweg,2023-01-31,13:00:00,114,14,100,FMN 08 Schijnpoortweg
675,Schijnpoortweg,2023-01-31,14:00:00,114,11,103,FMN 08 Schijnpoortweg
675,Schijnpoortweg,2023-01-31,15:00:00,219,22,197,FMN 08 Schijnpoortweg
675,Schijnpoortweg,2023-01-31,16:00:00,256,26,230,FMN 08 Schijnpoortweg
675,Schijnpoortweg,2023-01-31,17:00:00,285,23,262,FMN 08 Schijnpoortweg
675,Schijnpoortweg,2023-01-31,18:00:00,170,19,151,FMN 08 Schijnpoortweg
675,Schijnpoortweg,2023-01-31,19:00:00,154,13,141,FMN 08 Schijnpoortweg
675,Schijnpoortweg,2023-01-31,20:00:00,95,8,87,FMN 08 Schijnpoortweg
675,Schijnpoortweg,2023-01-31,21:00:00,86,15,71,FMN 08 Schijnpoortweg
675,Schijnpoortweg,2023-01-31,22:00:00,95,16,79,FMN 08 Schijnpoortweg
675,Schijnpoortweg,2023-01-31,23:00:00,57,11,46,FMN 08 Schijnpoortweg
675,Schijnpoortweg,2023-02-01,00:00:00,24,2,22,FMN 08 Schijnpoortweg
675,Schijnpoortweg,2023-02-01,01:00:00,12,2,10,FMN 08 Schijnpoortweg
675,Schijnpoortweg,2023-02-01,02:00:00,15,2,13,FMN 08 Schijnpoortweg
675,Schijnpoortweg,2023-02-01,03:00:00,9,3,6,FMN 08 Schijnpoortweg
675,Schijnpoortweg,2023-02-01,04:00:00,19,12,7,FMN 08 Schijnpoortweg
675,Schijnpoortweg,2023-02-01,05:00:00,55,12,43,FMN 08 Schijnpoortweg
675,Schijnpoortweg,2023-02-01,06:00:00,94,14,80,FMN 08 Schijnpoortweg
675,Schijnpoortweg,2023-02-01,07:00:00,185,17,168,FMN 08 Schijnpoortweg
675,Schijnpoortweg,2023-02-01,08:00:00,217,31,186,FMN 08 Schijnpoortweg
675,Schijnpoortweg,2023-02-01,09:00:00,106,15,91,FMN 08 Schijnpoortweg
675,Schijnpoortweg,2023-02-01,10:00:00,82,6,76,FMN 08 Schijnpoortweg
675,Schijnpoortweg,2023-02-01,11:00:00,110,15,95,FMN 08 Schijnpoortweg
675,Schijnpoortweg,2023-02-01,12:00:00,213,18,195,FMN 08 Schijnpoortweg
675,Schijnpoortweg,2023-02-01,13:00:00,136,16,120,FMN 08 Schijnpoortweg
675,Schijnpoortweg,2023-02-01,14:00:00,137,25,112,FMN 08 Schijnpoortweg
675,Schijnpoortweg,2023-02-01,15:00:00,167,15,152,FMN 08 Schijnpoortweg
675,Schijnpoortweg,2023-02-01,16:00:00,265,35,230,FMN 08 Schijnpoortweg
675,Schijnpoortweg,2023-02-01,17:00:00,257,25,232,FMN 08 Schijnpoortweg
675,Schijnpoortweg,2023-02-01,18:00:00,165,24,141,FMN 08 Schijnpoortweg
675,Schijnpoortweg,2023-02-01,19:00:00,142,23,119,FMN 08 Schijnpoortweg
675,Schijnpoortweg,2023-02-01,20:00:00,108,9,99,FMN 08 Schijnpoortweg
675,Schijnpoortweg,2023-02-01,21:00:00,82,7,75,FMN 08 Schijnpoortweg
675,Schijnpoortweg,2023-02-01,22:00:00,88,10,78,FMN 08 Schijnpoortweg
675,Schijnpoortweg,2023-02-01,23:00:00,57,12,45,FMN 08 Schijnpoortweg
675,Schijnpoortweg,2023-02-02,00:00:00,30,5,25,FMN 08 Schijnpoortweg
675,Schijnpoortweg,2023-02-02,01:00:00,12,2,10,FMN 08 Schijnpoortweg
675,Schijnpoortweg,2023-02-02,02:00:00,9,1,8,FMN 08 Schijnpoortweg
675,Schijnpoortweg,2023-02-02,03:00:00,14,5,9,FMN 08 Schijnpoortweg
675,Schijnpoortweg,2023-02-02,04:00:00,23,10,13,FMN 08 Schijnpoortweg
675,Schijnpoortweg,2023-02-02,05:00:00,55,9,46,FMN 08 Schijnpoortweg
675,Schijnpoortweg,2023-02-02,06:00:00,86,11,75,FMN 08 Schijnpoortweg
675,Schijnpoortweg,2023-02-02,07:00:00,161,30,131,FMN 08 Schijnpoortweg
675,Schijnpoortweg,2023-02-02,08:00:00,224,33,191,FMN 08 Schijnpoortweg
675,Schijnpoortweg,2023-02-02,09:00:00,115,11,104,FMN 08 Schijnpoortweg
675,Schijnpoortweg,2023-02-02,10:00:00,84,14,70,FMN 08 Schijnpoortweg
675,Schijnpoortweg,2023-02-02,11:00:00,97,13,84,FMN 08 Schijnpoortweg
675,Schijnpoortweg,2023-02-02,12:00:00,136,17,119,FMN 08 Schijnpoortweg
675,Schijnpoortweg,2023-02-02,13:00:00,109,6,103,FMN 08 Schijnpoortweg
675,Schijnpoortweg,2023-02-02,14:00:00,145,12,133,FMN 08 Schijnpoortweg
675,Schijnpoortweg,2023-02-02,15:00:00,215,14,201,FMN 08 Schijnpoortweg
675,Schijnpoortweg,2023-02-02,16:00:00,285,31,254,FMN 08 Schijnpoortweg
675,Schijnpoortweg,2023-02-02,17:00:00,284,13,271,FMN 08 Schijnpoortweg
675,Schijnpoortweg,2023-02-02,18:00:00,197,19,178,FMN 08 Schijnpoortweg
675,Schijnpoortweg,2023-02-02,19:00:00,145,10,135,FMN 08 Schijnpoortweg
675,Schijnpoortweg,2023-02-02,20:00:00,86,4,82,FMN 08 Schijnpoortweg
675,Schijnpoortweg,2023-02-02,21:00:00,84,7,77,FMN 08 Schijnpoortweg
675,Schijnpoortweg,2023-02-02,22:00:00,90,15,75,FMN 08 Schijnpoortweg
675,Schijnpoortweg,2023-02-02,23:00:00,70,7,63,FMN 08 Schijnpoortweg
675,Schijnpoortweg,2023-02-03,00:00:00,30,6,24,FMN 08 Schijnpoortweg
675,Schijnpoortweg,2023-02-03,01:00:00,31,2,29,FMN 08 Schijnpoortweg
675,Schijnpoortweg,2023-02-03,02:00:00,10,2,8,FMN 08 Schijnpoortweg
675,Schijnpoortweg,2023-02-03,03:00:00,14,4,10,FMN 08 Schijnpoortweg
675,Schijnpoortweg,2023-02-03,04:00:00,16,7,9,FMN 08 Schijnpoortweg
675,Schijnpoortweg,2023-02-03,05:00:00,56,6,50,FMN 08 Schijnpoortweg
675,Schijnpoortweg,2023-02-03,06:00:00,86,18,68,FMN 08 Schijnpoortweg
675,Schijnpoortweg,2023-02-03,07:00:00,156,18,138,FMN 08 Schijnpoortweg
675,Schijnpoortweg,2023-02-03,08:00:00,187,23,164,FMN 08 Schijnpoortweg
675,Schijnpoortweg,2023-02-03,09:00:00,73,9,64,FMN 08 Schijnpoortweg
675,Schijnpoortweg,2023-02-03,10:00:00,89,18,71,FMN 08 Schijnpoortweg
675,Schijnpoortweg,2023-02-03,11:00:00,90,10,80,FMN 08 Schijnpoortweg
675,Schijnpoortweg,2023-02-03,12:00:00,144,16,128,FMN 08 Schijnpoortweg
675,Schijnpoortweg,2023-02-03,13:00:00,111,16,95,FMN 08 Schijnpoortweg
675,Schijnpoortweg,2023-02-03,14:00:00,163,16,147,FMN 08 Schijnpoortweg
675,Schijnpoortweg,2023-02-03,15:00:00,243,23,220,FMN 08 Schijnpoortweg
675,Schijnpoortweg,2023-02-03,16:00:00,254,26,228,FMN 08 Schijnpoortweg
675,Schijnpoortweg,2023-02-03,17:00:00,231,24,207,FMN 08 Schijnpoortweg
675,Schijnpoortweg,2023-02-03,18:00:00,182,32,150,FMN 08 Schijnpoortweg
675,Schijnpoortweg,2023-02-03,19:00:00,167,23,144,FMN 08 Schijnpoortweg
675,Schijnpoortweg,2023-02-03,20:00:00,121,21,100,FMN 08 Schijnpoortweg
675,Schijnpoortweg,2023-02-03,21:00:00,96,15,81,FMN 08 Schijnpoortweg
675,Schijnpoortweg,2023-02-03,22:00:00,93,25,68,FMN 08 Schijnpoortweg
675,Schijnpoortweg,2023-02-03,23:00:00,66,7,59,FMN 08 Schijnpoortweg
675,Schijnpoortweg,2023-02-04,00:00:00,53,8,45,FMN 08 Schijnpoortweg
675,Schijnpoortweg,2023-02-04,01:00:00,34,4,30,FMN 08 Schijnpoortweg
675,Schijnpoortweg,2023-02-04,02:00:00,31,5,26,FMN 08 Schijnpoortweg
675,Schijnpoortweg,2023-02-04,03:00:00,18,6,12,FMN 08 Schijnpoortweg
675,Schijnpoortweg,2023-02-04,04:00:00,19,6,13,FMN 08 Schijnpoortweg
675,Schijnpoortweg,2023-02-04,05:00:00,21,10,11,FMN 08 Schijnpoortweg
675,Schijnpoortweg,2023-02-04,06:00:00,28,9,19,FMN 08 Schijnpoortweg
675,Schijnpoortweg,2023-02-04,07:00:00,32,5,27,FMN 08 Schijnpoortweg
675,Schijnpoortweg,2023-02-04,08:00:00,64,10,54,FMN 08 Schijnpoortweg
675,Schijnpoortweg,2023-02-04,09:00:00,76,9,67,FMN 08 Schijnpoortweg
675,Schijnpoortweg,2023-02-04,10:00:00,85,29,56,FMN 08 Schijnpoortweg
675,Schijnpoortweg,2023-02-04,11:00:00,109,24,85,FMN 08 Schijnpoortweg
675,Schijnpoortweg,2023-02-04,12:00:00,57,8,49,FMN 08 Schijnpoortweg
675,Schijnpoortweg,2023-02-04,13:00:00,134,65,69,FMN 08 Schijnpoortweg
675,Schijnpoortweg,2023-02-04,14:00:00,116,44,72,FMN 08 Schijnpoortweg
675,Schijnpoortweg,2023-02-04,15:00:00,162,44,118,FMN 08 Schijnpoortweg
675,Schijnpoortweg,2023-02-04,16:00:00,128,34,94,FMN 08 Schijnpoortweg
675,Schijnpoortweg,2023-02-04,17:00:00,182,54,128,FMN 08 Schijnpoortweg
675,Schijnpoortweg,2023-02-04,18:00:00,186,82,104,FMN 08 Schijnpoortweg
675,Schijnpoortweg,2023-02-04,19:00:00,139,46,93,FMN 08 Schijnpoortweg
675,Schijnpoortweg,2023-02-04,20:00:00,140,58,82,FMN 08 Schijnpoortweg
675,Schijnpoortweg,2023-02-04,21:00:00,47,8,39,FMN 08 Schijnpoortweg
675,Schijnpoortweg,2023-02-04,22:00:00,96,36,60,FMN 08 Schijnpoortweg
675,Schijnpoortweg,2023-02-04,23:00:00,85,21,64,FMN 08 Schijnpoortweg
675,Schijnpoortweg,2023-02-05,00:00:00,48,5,43,FMN 08 Schijnpoortweg
675,Schijnpoortweg,2023-02-05,01:00:00,45,5,40,FMN 08 Schijnpoortweg
675,Schijnpoortweg,2023-02-05,02:00:00,24,5,19,FMN 08 Schijnpoortweg
675,Schijnpoortweg,2023-02-05,03:00:00,24,10,14,FMN 08 Schijnpoortweg
675,Schijnpoortweg,2023-02-05,04:00:00,24,6,18,FMN 08 Schijnpoortweg
675,Schijnpoortweg,2023-02-05,05:00:00,11,4,7,FMN 08 Schijnpoortweg
675,Schijnpoortweg,2023-02-05,06:00:00,17,4,13,FMN 08 Schijnpoortweg
675,Schijnpoortweg,2023-02-05,07:00:00,19,1,18,FMN 08 Schijnpoortweg
675,Schijnpoortweg,2023-02-05,08:00:00,35,14,21,FMN 08 Schijnpoortweg
675,Schijnpoortweg,2023-02-05,09:00:00,65,18,47,FMN 08 Schijnpoortweg
675,Schijnpoortweg,2023-02-05,10:00:00,134,42,92,FMN 08 Schijnpoortweg
675,Schijnpoortweg,2023-02-05,11:00:00,109,27,82,FMN 08 Schijnpoortweg
675,Schijnpoortweg,2023-02-05,12:00:00,146,17,129,FMN 08 Schijnpoortweg
675,Schijnpoortweg,2023-02-05,13:00:00,165,68,97,FMN 08 Schijnpoortweg
675,Schijnpoortweg,2023-02-05,14:00:00,101,19,82,FMN 08 Schijnpoortweg
675,Schijnpoortweg,2023-02-05,15:00:00,106,33,73,FMN 08 Schijnpoortweg
675,Schijnpoortweg,2023-02-05,16:00:00,119,34,85,FMN 08 Schijnpoortweg
675,Schijnpoortweg,2023-02-05,17:00:00,101,19,82,FMN 08 Schijnpoortweg
675,Schijnpoortweg,2023-02-05,18:00:00,115,21,94,FMN 08 Schijnpoortweg
675,Schijnpoortweg,2023-02-05,19:00:00,109,29,80,FMN 08 Schijnpoortweg
675,Schijnpoortweg,2023-02-05,20:00:00,97,8,89,FMN 08 Schijnpoortweg
675,Schijnpoortweg,2023-02-05,21:00:00,70,6,64,FMN 08 Schijnpoortweg
675,Schijnpoortweg,2023-02-05,22:00:00,55,11,44,FMN 08 Schijnpoortweg
675,Schijnpoortweg,2023-02-05,23:00:00,42,4,38,FMN 08 Schijnpoortweg
675,Schijnpoortweg,2023-02-06,00:00:00,28,4,24,FMN 08 Schijnpoortweg
675,Schijnpoortweg,2023-02-06,01:00:00,16,1,15,FMN 08 Schijnpoortweg
675,Schijnpoortweg,2023-02-06,02:00:00,11,1,10,FMN 08 Schijnpoortweg
675,Schijnpoortweg,2023-02-06,03:00:00,12,5,7,FMN 08 Schijnpoortweg
675,Schijnpoortweg,2023-02-06,04:00:00,18,8,10,FMN 08 Schijnpoortweg
675,Schijnpoortweg,2023-02-06,05:00:00,53,8,45,FMN 08 Schijnpoortweg
675,Schijnpoortweg,2023-02-06,06:00:00,75,16,59,FMN 08 Schijnpoortweg
675,Schijnpoortweg,2023-02-06,07:00:00,163,18,145,FMN 08 Schijnpoortweg
675,Schijnpoortweg,2023-02-06,08:00:00,224,42,182,FMN 08 Schijnpoortweg
675,Schijnpoortweg,2023-02-06,09:00:00,92,10,82,FMN 08 Schijnpoortweg
675,Schijnpoortweg,2023-02-06,10:00:00,65,12,53,FMN 08 Schijnpoortweg
675,Schijnpoortweg,2023-02-06,11:00:00,87,16,71,FMN 08 Schijnpoortweg
675,Schijnpoortweg,2023-02-06,12:00:00,135,17,118,FMN 08 Schijnpoortweg
675,Schijnpoortweg,2023-02-06,13:00:00,98,10,88,FMN 08 Schijnpoortweg
675,Schijnpoortweg,2023-02-06,14:00:00,158,11,147,FMN 08 Schijnpoortweg
675,Schijnpoortweg,2023-02-06,15:00:00,226,11,215,FMN 08 Schijnpoortweg
675,Schijnpoortweg,2023-02-06,16:00:00,303,35,268,FMN 08 Schijnpoortweg
675,Schijnpoortweg,2023-02-06,17:00:00,303,21,282,FMN 08 Schijnpoortweg
675,Schijnpoortweg,2023-02-06,18:00:00,176,20,156,FMN 08 Schijnpoortweg
675,Schijnpoortweg,2023-02-06,19:00:00,134,13,121,FMN 08 Schijnpoortweg
675,Schijnpoortweg,2023-02-06,20:00:00,110,15,95,FMN 08 Schijnpoortweg
675,Schijnpoortweg,2023-02-06,21:00:00,115,17,98,FMN 08 Schijnpoortweg
675,Schijnpoortweg,2023-02-06,22:00:00,90,16,74,FMN 08 Schijnpoortweg
675,Schijnpoortweg,2023-02-06,23:00:00,52,8,44,FMN 08 Schijnpoortweg
675,Schijnpoortweg,2023-02-07,00:00:00,28,5,23,FMN 08 Schijnpoortweg
675,Schijnpoortweg,2023-02-07,01:00:00,9,1,8,FMN 08 Schijnpoortweg
675,Schijnpoortweg,2023-02-07,02:00:00,9,1,8,FMN 08 Schijnpoortweg
675,Schijnpoortweg,2023-02-07,03:00:00,13,4,9,FMN 08 Schijnpoortweg
675,Schijnpoortweg,2023-02-07,04:00:00,19,9,10,FMN 08 Schijnpoortweg
675,Schijnpoortweg,2023-02-07,05:00:00,57,9,48,FMN 08 Schijnpoortweg
675,Schijnpoortweg,2023-02-07,06:00:00,98,20,78,FMN 08 Schijnpoortweg
675,Schijnpoortweg,2023-02-07,07:00:00,175,21,154,FMN 08 Schijnpoortweg
675,Schijnpoortweg,2023-02-07,08:00:00,214,32,182,FMN 08 Schijnpoortweg
675,Schijnpoortweg,2023-02-07,09:00:00,107,24,83,FMN 08 Schijnpoortweg
675,Schijnpoortweg,2023-02-07,10:00:00,76,18,58,FMN 08 Schijnpoortweg
675,Schijnpoortweg,2023-02-07,11:00:00,84,14,70,FMN 08 Schijnpoortweg
675,Schijnpoortweg,2023-02-07,12:00:00,126,21,105,FMN 08 Schijnpoortweg
675,Schijnpoortweg,2023-02-07,13:00:00,104,21,83,FMN 08 Schijnpoortweg
675,Schijnpoortweg,2023-02-07,14:00:00,153,19,134,FMN 08 Schijnpoortweg
675,Schijnpoortweg,2023-02-07,15:00:00,231,15,216,FMN 08 Schijnpoortweg
675,Schijnpoortweg,2023-02-07,16:00:00,318,25,293,FMN 08 Schijnpoortweg
675,Schijnpoortweg,2023-02-07,17:00:00,298,20,278,FMN 08 Schijnpoortweg
675,Schijnpoortweg,2023-02-07,18:00:00,193,18,175,FMN 08 Schijnpoortweg
675,Schijnpoortweg,2023-02-07,19:00:00,146,12,134,FMN 08 Schijnpoortweg
675,Schijnpoortweg,2023-02-07,20:00:00,110,18,92,FMN 08 Schijnpoortweg
675,Schijnpoortweg,2023-02-07,21:00:00,101,13,88,FMN 08 Schijnpoortweg
675,Schijnpoortweg,2023-02-07,22:00:00,91,15,76,FMN 08 Schijnpoortweg
675,Schijnpoortweg,2023-02-07,23:00:00,58,6,52,FMN 08 Schijnpoortweg
675,Schijnpoortweg,2023-02-08,00:00:00,25,4,21,FMN 08 Schijnpoortweg
675,Schijnpoortweg,2023-02-08,01:00:00,15,3,12,FMN 08 Schijnpoortweg
675,Schijnpoortweg,2023-02-08,02:00:00,9,1,8,FMN 08 Schijnpoortweg
675,Schijnpoortweg,2023-02-08,03:00:00,10,3,7,FMN 08 Schijnpoortweg
675,Schijnpoortweg,2023-02-08,04:00:00,20,10,10,FMN 08 Schijnpoortweg
675,Schijnpoortweg,2023-02-08,05:00:00,55,8,47,FMN 08 Schijnpoortweg
675,Schijnpoortweg,2023-02-08,06:00:00,102,21,81,FMN 08 Schijnpoortweg
675,Schijnpoortweg,2023-02-08,07:00:00,153,13,140,FMN 08 Schijnpoortweg
675,Schijnpoortweg,2023-02-08,08:00:00,204,28,176,FMN 08 Schijnpoortweg
675,Schijnpoortweg,2023-02-08,09:00:00,96,17,79,FMN 08 Schijnpoortweg
675,Schijnpoortweg,2023-02-08,10:00:00,75,13,62,FMN 08 Schijnpoortweg
675,Schijnpoortweg,2023-02-08,11:00:00,95,11,84,FMN 08 Schijnpoortweg
675,Schijnpoortweg,2023-02-08,12:00:00,197,21,176,FMN 08 Schijnpoortweg
675,Schijnpoortweg,2023-02-08,13:00:00,131,15,116,FMN 08 Schijnpoortweg
675,Schijnpoortweg,2023-02-08,14:00:00,174,20,154,FMN 08 Schijnpoortweg
675,Schijnpoortweg,2023-02-08,15:00:00,201,19,182,FMN 08 Schijnpoortweg
675,Schijnpoortweg,2023-02-08,16:00:00,239,20,219,FMN 08 Schijnpoortweg
675,Schijnpoortweg,2023-02-08,17:00:00,253,17,236,FMN 08 Schijnpoortweg
675,Schijnpoortweg,2023-02-08,18:00:00,188,21,167,FMN 08 Schijnpoortweg
675,Schijnpoortweg,2023-02-08,19:00:00,137,21,116,FMN 08 Schijnpoortweg
675,Schijnpoortweg,2023-02-08,20:00:00,126,9,117,FMN 08 Schijnpoortweg
675,Schijnpoortweg,2023-02-08,21:00:00,97,13,84,FMN 08 Schijnpoortweg
675,Schijnpoortweg,2023-02-08,22:00:00,87,17,70,FMN 08 Schijnpoortweg
675,Schijnpoortweg,2023-02-08,23:00:00,46,5,41,FMN 08 Schijnpoortweg
675,Schijnpoortweg,2023-02-09,00:00:00,29,8,21,FMN 08 Schijnpoortweg
675,Schijnpoortweg,2023-02-09,01:00:00,14,1,13,FMN 08 Schijnpoortweg
675,Schijnpoortweg,2023-02-09,02:00:00,11,3,8,FMN 08 Schijnpoortweg
675,Schijnpoortweg,2023-02-09,03:00:00,10,3,7,FMN 08 Schijnpoortweg
675,Schijnpoortweg,2023-02-09,04:00:00,20,13,7,FMN 08 Schijnpoortweg
675,Schijnpoortweg,2023-02-09,05:00:00,56,11,45,FMN 08 Schijnpoortweg
675,Schijnpoortweg,2023-02-09,06:00:00,89,12,77,FMN 08 Schijnpoortweg
675,Schijnpoortweg,2023-02-09,07:00:00,167,25,142,FMN 08 Schijnpoortweg
675,Schijnpoortweg,2023-02-09,08:00:00,220,37,183,FMN 08 Schijnpoortweg
675,Schijnpoortweg,2023-02-09,09:00:00,107,20,87,FMN 08 Schijnpoortweg
675,Schijnpoortweg,2023-02-09,10:00:00,87,15,72,FMN 08 Schijnpoortweg
675,Schijnpoortweg,2023-02-09,11:00:00,79,11,68,FMN 08 Schijnpoortweg
675,Schijnpoortweg,2023-02-09,12:00:00,145,18,127,FMN 08 Schijnpoortweg
675,Schijnpoortweg,2023-02-09,13:00:00,120,18,102,FMN 08 Schijnpoortweg
675,Schijnpoortweg,2023-02-09,14:00:00,143,9,134,FMN 08 Schijnpoortweg
675,Schijnpoortweg,2023-02-09,15:00:00,236,17,219,FMN 08 Schijnpoortweg
675,Schijnpoortweg,2023-02-09,16:00:00,293,29,264,FMN 08 Schijnpoortweg
675,Schijnpoortweg,2023-02-09,17:00:00,295,32,263,FMN 08 Schijnpoortweg
675,Schijnpoortweg,2023-02-09,18:00:00,187,24,163,FMN 08 Schijnpoortweg
675,Schijnpoortweg,2023-02-09,19:00:00,123,22,101,FMN 08 Schijnpoortweg
675,Schijnpoortweg,2023-02-09,20:00:00,94,13,81,FMN 08 Schijnpoortweg
675,Schijnpoortweg,2023-02-09,21:00:00,91,11,80,FMN 08 Schijnpoortweg
675,Schijnpoortweg,2023-02-09,22:00:00,95,12,83,FMN 08 Schijnpoortweg
675,Schijnpoortweg,2023-02-09,23:00:00,61,11,50,FMN 08 Schijnpoortweg
675,Schijnpoortweg,2023-02-10,00:00:00,34,3,31,FMN 08 Schijnpoortweg
675,Schijnpoortweg,2023-02-10,01:00:00,15,3,12,FMN 08 Schijnpoortweg
675,Schijnpoortweg,2023-02-10,02:00:00,16,2,14,FMN 08 Schijnpoortweg
675,Schijnpoortweg,2023-02-10,03:00:00,17,7,10,FMN 08 Schijnpoortweg
675,Schijnpoortweg,2023-02-10,04:00:00,26,14,12,FMN 08 Schijnpoortweg
675,Schijnpoortweg,2023-02-10,05:00:00,56,9,47,FMN 08 Schijnpoortweg
675,Schijnpoortweg,2023-02-10,06:00:00,96,22,74,FMN 08 Schijnpoortweg
675,Schijnpoortweg,2023-02-10,07:00:00,156,16,140,FMN 08 Schijnpoortweg
675,Schijnpoortweg,2023-02-10,08:00:00,209,30,179,FMN 08 Schijnpoortweg
675,Schijnpoortweg,2023-02-10,09:00:00,105,24,81,FMN 08 Schijnpoortweg
675,Schijnpoortweg,2023-02-10,10:00:00,80,16,64,FMN 08 Schijnpoortweg
675,Schijnpoortweg,2023-02-10,11:00:00,83,6,77,FMN 08 Schijnpoortweg
675,Schijnpoortweg,2023-02-10,12:00:00,127,12,115,FMN 08 Schijnpoortweg
675,Schijnpoortweg,2023-02-10,13:00:00,112,11,101,FMN 08 Schijnpoortweg
675,Schijnpoortweg,2023-02-10,14:00:00,150,19,131,FMN 08 Schijnpoortweg
675,Schijnpoortweg,2023-02-10,15:00:00,210,25,185,FMN 08 Schijnpoortweg
675,Schijnpoortweg,2023-02-10,16:00:00,297,38,259,FMN 08 Schijnpoortweg
675,Schijnpoortweg,2023-02-10,17:00:00,239,21,218,FMN 08 Schijnpoortweg
675,Schijnpoortweg,2023-02-10,18:00:00,189,18,171,FMN 08 Schijnpoortweg
675,Schijnpoortweg,2023-02-10,19:00:00,147,31,116,FMN 08 Schijnpoortweg
675,Schijnpoortweg,2023-02-10,20:00:00,124,26,98,FMN 08 Schijnpoortweg
675,Schijnpoortweg,2023-02-10,21:00:00,128,21,107,FMN 08 Schijnpoortweg
675,Schijnpoortweg,2023-02-10,22:00:00,132,24,108,FMN 08 Schijnpoortweg
675,Schijnpoortweg,2023-02-10,23:00:00,116,11,105,FMN 08 Schijnpoortweg
675,Schijnpoortweg,2023-02-11,00:00:00,57,7,50,FMN 08 Schijnpoortweg
675,Schijnpoortweg,2023-02-11,01:00:00,48,6,42,FMN 08 Schijnpoortweg
675,Schijnpoortweg,2023-02-11,02:00:00,36,17,19,FMN 08 Schijnpoortweg
675,Schijnpoortweg,2023-02-11,03:00:00,41,21,20,FMN 08 Schijnpoortweg
675,Schijnpoortweg,2023-02-11,04:00:00,38,27,11,FMN 08 Schijnpoortweg
675,Schijnpoortweg,2023-02-11,05:00:00,37,27,10,FMN 08 Schijnpoortweg
675,Schijnpoortweg,2023-02-11,06:00:00,30,11,19,FMN 08 Schijnpoortweg
675,Schijnpoortweg,2023-02-11,07:00:00,34,2,32,FMN 08 Schijnpoortweg
675,Schijnpoortweg,2023-02-11,08:00:00,52,6,46,FMN 08 Schijnpoortweg
675,Schijnpoortweg,2023-02-11,09:00:00,66,12,54,FMN 08 Schijnpoortweg
675,Schijnpoortweg,2023-02-11,10:00:00,88,13,75,FMN 08 Schijnpoortweg
675,Schijnpoortweg,2023-02-11,11:00:00,101,17,84,FMN 08 Schijnpoortweg
675,Schijnpoortweg,2023-02-11,12:00:00,90,17,73,FMN 08 Schijnpoortweg
675,Schijnpoortweg,2023-02-11,13:00:00,117,12,105,FMN 08 Schijnpoortweg
675,Schijnpoortweg,2023-02-11,14:00:00,123,10,113,FMN 08 Schijnpoortweg
675,Schijnpoortweg,2023-02-11,15:00:00,113,15,98,FMN 08 Schijnpoortweg
675,Schijnpoortweg,2023-02-11,16:00:00,123,23,100,FMN 08 Schijnpoortweg
675,Schijnpoortweg,2023-02-11,17:00:00,143,24,119,FMN 08 Schijnpoortweg
675,Schijnpoortweg,2023-02-11,18:00:00,140,32,108,FMN 08 Schijnpoortweg
675,Schijnpoortweg,2023-02-11,19:00:00,131,26,105,FMN 08 Schijnpoortweg
675,Schijnpoortweg,2023-02-11,20:00:00,133,34,99,FMN 08 Schijnpoortweg
675,Schijnpoortweg,2023-02-11,21:00:00,108,35,73,FMN 08 Schijnpoortweg
675,Schijnpoortweg,2023-02-11,22:00:00,119,28,91,FMN 08 Schijnpoortweg
675,Schijnpoortweg,2023-02-11,23:00:00,65,10,55,FMN 08 Schijnpoortweg
675,Schijnpoortweg,2023-02-12,00:00:00,68,17,51,FMN 08 Schijnpoortweg
675,Schijnpoortweg,2023-02-12,01:00:00,43,16,27,FMN 08 Schijnpoortweg
675,Schijnpoortweg,2023-02-12,02:00:00,40,21,19,FMN 08 Schijnpoortweg
675,Schijnpoortweg,2023-02-12,03:00:00,46,29,17,FMN 08 Schijnpoortweg
675,Schijnpoortweg,2023-02-12,04:00:00,35,21,14,FMN 08 Schijnpoortweg
675,Schijnpoortweg,2023-02-12,05:00:00,34,15,19,FMN 08 Schijnpoortweg
675,Schijnpoortweg,2023-02-12,06:00:00,20,7,13,FMN 08 Schijnpoortweg
675,Schijnpoortweg,2023-02-12,07:00:00,15,1,14,FMN 08 Schijnpoortweg
675,Schijnpoortweg,2023-02-12,08:00:00,25,9,16,FMN 08 Schijnpoortweg
675,Schijnpoortweg,2023-02-12,09:00:00,51,11,40,FMN 08 Schijnpoortweg
675,Schijnpoortweg,2023-02-12,10:00:00,82,17,65,FMN 08 Schijnpoortweg
675,Schijnpoortweg,2023-02-12,11:00:00,95,14,81,FMN 08 Schijnpoortweg
675,Schijnpoortweg,2023-02-12,12:00:00,97,20,77,FMN 08 Schijnpoortweg
675,Schijnpoortweg,2023-02-12,13:00:00,87,12,75,FMN 08 Schijnpoortweg
675,Schijnpoortweg,2023-02-12,14:00:00,112,8,104,FMN 08 Schijnpoortweg
675,Schijnpoortweg,2023-02-12,15:00:00,107,21,86,FMN 08 Schijnpoortweg
675,Schijnpoortweg,2023-02-12,16:00:00,109,23,86,FMN 08 Schijnpoortweg
675,Schijnpoortweg,2023-02-12,17:00:00,108,15,93,FMN 08 Schijnpoortweg
675,Schijnpoortweg,2023-02-12,18:00:00,115,19,96,FMN 08 Schijnpoortweg
675,Schijnpoortweg,2023-02-12,19:00:00,99,20,79,FMN 08 Schijnpoortweg
675,Schijnpoortweg,2023-02-12,20:00:00,94,9,85,FMN 08 Schijnpoortweg
675,Schijnpoortweg,2023-02-12,21:00:00,64,7,57,FMN 08 Schijnpoortweg
675,Schijnpoortweg,2023-02-12,22:00:00,54,5,49,FMN 08 Schijnpoortweg
675,Schijnpoortweg,2023-02-12,23:00:00,31,3,28,FMN 08 Schijnpoortweg
675,Schijnpoortweg,2023-02-13,00:00:00,30,5,25,FMN 08 Schijnpoortweg
675,Schijnpoortweg,2023-02-13,01:00:00,17,3,14,FMN 08 Schijnpoortweg
675,Schijnpoortweg,2023-02-13,02:00:00,8,3,5,FMN 08 Schijnpoortweg
675,Schijnpoortweg,2023-02-13,03:00:00,15,5,10,FMN 08 Schijnpoortweg
675,Schijnpoortweg,2023-02-13,04:00:00,27,7,20,FMN 08 Schijnpoortweg
675,Schijnpoortweg,2023-02-13,05:00:00,52,9,43,FMN 08 Schijnpoortweg
675,Schijnpoortweg,2023-02-13,06:00:00,91,15,76,FMN 08 Schijnpoortweg
675,Schijnpoortweg,2023-02-13,07:00:00,170,17,153,FMN 08 Schijnpoortweg
675,Schijnpoortweg,2023-02-13,08:00:00,220,29,191,FMN 08 Schijnpoortweg
675,Schijnpoortweg,2023-02-13,09:00:00,86,13,73,FMN 08 Schijnpoortweg
675,Schijnpoortweg,2023-02-13,10:00:00,90,17,73,FMN 08 Schijnpoortweg
675,Schijnpoortweg,2023-02-13,11:00:00,92,15,77,FMN 08 Schijnpoortweg
675,Schijnpoortweg,2023-02-13,12:00:00,139,17,122,FMN 08 Schijnpoortweg
675,Schijnpoortweg,2023-02-13,13:00:00,110,10,100,FMN 08 Schijnpoortweg
675,Schijnpoortweg,2023-02-13,14:00:00,131,11,120,FMN 08 Schijnpoortweg
675,Schijnpoortweg,2023-02-13,15:00:00,262,18,244,FMN 08 Schijnpoortweg
675,Schijnpoortweg,2023-02-13,16:00:00,329,35,294,FMN 08 Schijnpoortweg
675,Schijnpoortweg,2023-02-13,17:00:00,334,23,311,FMN 08 Schijnpoortweg
675,Schijnpoortweg,2023-02-13,18:00:00,215,16,199,FMN 08 Schijnpoortweg
675,Schijnpoortweg,2023-02-13,19:00:00,120,6,114,FMN 08 Schijnpoortweg
675,Schijnpoortweg,2023-02-13,20:00:00,112,14,98,FMN 08 Schijnpoortweg
675,Schijnpoortweg,2023-02-13,21:00:00,79,10,69,FMN 08 Schijnpoortweg
675,Schijnpoortweg,2023-02-13,22:00:00,74,17,57,FMN 08 Schijnpoortweg
675,Schijnpoortweg,2023-02-13,23:00:00,51,3,48,FMN 08 Schijnpoortweg
675,Schijnpoortweg,2023-02-14,00:00:00,31,4,27,FMN 08 Schijnpoortweg
675,Schijnpoortweg,2023-02-14,01:00:00,19,6,13,FMN 08 Schijnpoortweg
675,Schijnpoortweg,2023-02-14,02:00:00,23,2,21,FMN 08 Schijnpoortweg
675,Schijnpoortweg,2023-02-14,03:00:00,13,4,9,FMN 08 Schijnpoortweg
675,Schijnpoortweg,2023-02-14,04:00:00,24,11,13,FMN 08 Schijnpoortweg
675,Schijnpoortweg,2023-02-14,05:00:00,65,10,55,FMN 08 Schijnpoortweg
675,Schijnpoortweg,2023-02-14,06:00:00,106,23,83,FMN 08 Schijnpoortweg
675,Schijnpoortweg,2023-02-14,07:00:00,196,29,167,FMN 08 Schijnpoortweg
675,Schijnpoortweg,2023-02-14,08:00:00,250,48,202,FMN 08 Schijnpoortweg
675,Schijnpoortweg,2023-02-14,09:00:00,111,25,86,FMN 08 Schijnpoortweg
675,Schijnpoortweg,2023-02-14,10:00:00,85,16,69,FMN 08 Schijnpoortweg
675,Schijnpoortweg,2023-02-14,11:00:00,116,13,103,FMN 08 Schijnpoortweg
675,Schijnpoortweg,2023-02-14,12:00:00,168,26,142,FMN 08 Schijnpoortweg
675,Schijnpoortweg,2023-02-14,13:00:00,148,7,141,FMN 08 Schijnpoortweg
675,Schijnpoortweg,2023-02-14,14:00:00,174,18,156,FMN 08 Schijnpoortweg
675,Schijnpoortweg,2023-02-14,15:00:00,313,21,292,FMN 08 Schijnpoortweg
675,Schijnpoortweg,2023-02-14,16:00:00,396,44,352,FMN 08 Schijnpoortweg
675,Schijnpoortweg,2023-02-14,17:00:00,412,38,374,FMN 08 Schijnpoortweg
675,Schijnpoortweg,2023-02-14,18:00:00,260,18,242,FMN 08 Schijnpoortweg
675,Schijnpoortweg,2023-02-14,19:00:00,173,17,156,FMN 08 Schijnpoortweg
675,Schijnpoortweg,2023-02-14,20:00:00,118,10,108,FMN 08 Schijnpoortweg
675,Schijnpoortweg,2023-02-14,21:00:00,105,14,91,FMN 08 Schijnpoortweg
675,Schijnpoortweg,2023-02-14,22:00:00,96,14,82,FMN 08 Schijnpoortweg
675,Schijnpoortweg,2023-02-14,23:00:00,71,6,65,FMN 08 Schijnpoortweg
675,Schijnpoortweg,2023-02-15,00:00:00,47,6,41,FMN 08 Schijnpoortweg
675,Schijnpoortweg,2023-02-15,01:00:00,16,2,14,FMN 08 Schijnpoortweg
675,Schijnpoortweg,2023-02-15,02:00:00,12,1,11,FMN 08 Schijnpoortweg
675,Schijnpoortweg,2023-02-15,03:00:00,15,5,10,FMN 08 Schijnpoortweg
675,Schijnpoortweg,2023-02-15,04:00:00,31,17,14,FMN 08 Schijnpoortweg
675,Schijnpoortweg,2023-02-15,05:00:00,58,9,49,FMN 08 Schijnpoortweg
675,Schijnpoortweg,2023-02-15,06:00:00,104,14,90,FMN 08 Schijnpoortweg
675,Schijnpoortweg,2023-02-15,07:00:00,174,14,160,FMN 08 Schijnpoortweg
675,Schijnpoortweg,2023-02-15,08:00:00,205,36,169,FMN 08 Schijnpoortweg
675,Schijnpoortweg,2023-02-15,09:00:00,131,24,107,FMN 08 Schijnpoortweg
675,Schijnpoortweg,2023-02-15,10:00:00,100,14,86,FMN 08 Schijnpoortweg
675,Schijnpoortweg,2023-02-15,11:00:00,113,16,97,FMN 08 Schijnpoortweg
675,Schijnpoortweg,2023-02-15,12:00:00,224,29,195,FMN 08 Schijnpoortweg
675,Schijnpoortweg,2023-02-15,13:00:00,175,23,152,FMN 08 Schijnpoortweg
675,Schijnpoortweg,2023-02-15,14:00:00,173,29,144,FMN 08 Schijnpoortweg
675,Schijnpoortweg,2023-02-15,15:00:00,219,17,202,FMN 08 Schijnpoortweg
675,Schijnpoortweg,2023-02-15,16:00:00,326,33,293,FMN 08 Schijnpoortweg
675,Schijnpoortweg,2023-02-15,17:00:00,317,34,283,FMN 08 Schijnpoortweg
675,Schijnpoortweg,2023-02-15,18:00:00,215,21,194,FMN 08 Schijnpoortweg
675,Schijnpoortweg,2023-02-15,19:00:00,181,17,164,FMN 08 Schijnpoortweg
675,Schijnpoortweg,2023-02-15,20:00:00,106,17,89,FMN 08 Schijnpoortweg
675,Schijnpoortweg,2023-02-15,21:00:00,118,29,89,FMN 08 Schijnpoortweg
675,Schijnpoortweg,2023-02-15,22:00:00,95,9,86,FMN 08 Schijnpoortweg
675,Schijnpoortweg,2023-02-15,23:00:00,63,11,52,FMN 08 Schijnpoortweg
675,Schijnpoortweg,2023-02-16,00:00:00,32,6,26,FMN 08 Schijnpoortweg
675,Schijnpoortweg,2023-02-16,01:00:00,12,4,8,FMN 08 Schijnpoortweg
675,Schijnpoortweg,2023-02-16,02:00:00,12,2,10,FMN 08 Schijnpoortweg
675,Schijnpoortweg,2023-02-16,03:00:00,17,5,12,FMN 08 Schijnpoortweg
675,Schijnpoortweg,2023-02-16,04:00:00,21,10,11,FMN 08 Schijnpoortweg
675,Schijnpoortweg,2023-02-16,05:00:00,54,11,43,FMN 08 Schijnpoortweg
675,Schijnpoortweg,2023-02-16,06:00:00,91,12,79,FMN 08 Schijnpoortweg
675,Schijnpoortweg,2023-02-16,07:00:00,196,33,163,FMN 08 Schijnpoortweg
675,Schijnpoortweg,2023-02-16,08:00:00,231,46,185,FMN 08 Schijnpoortweg
675,Schijnpoortweg,2023-02-16,09:00:00,134,26,108,FMN 08 Schijnpoortweg
675,Schijnpoortweg,2023-02-16,10:00:00,74,22,52,FMN 08 Schijnpoortweg
675,Schijnpoortweg,2023-02-16,11:00:00,85,15,70,FMN 08 Schijnpoortweg
675,Schijnpoortweg,2023-02-16,12:00:00,141,16,125,FMN 08 Schijnpoortweg
675,Schijnpoortweg,2023-02-16,13:00:00,101,10,91,FMN 08 Schijnpoortweg
675,Schijnpoortweg,2023-02-16,14:00:00,146,14,132,FMN 08 Schijnpoortweg
675,Schijnpoortweg,2023-02-16,15:00:00,278,23,255,FMN 08 Schijnpoortweg
675,Schijnpoortweg,2023-02-16,16:00:00,300,21,279,FMN 08 Schijnpoortweg
675,Schijnpoortweg,2023-02-16,17:00:00,307,20,287,FMN 08 Schijnpoortweg
675,Schijnpoortweg,2023-02-16,18:00:00,183,14,169,FMN 08 Schijnpoortweg
675,Schijnpoortweg,2023-02-16,19:00:00,162,18,144,FMN 08 Schijnpoortweg
675,Schijnpoortweg,2023-02-16,20:00:00,105,10,95,FMN 08 Schijnpoortweg
675,Schijnpoortweg,2023-02-16,21:00:00,99,9,90,FMN 08 Schijnpoortweg
675,Schijnpoortweg,2023-02-16,22:00:00,110,15,95,FMN 08 Schijnpoortweg
675,Schijnpoortweg,2023-02-16,23:00:00,51,10,41,FMN 08 Schijnpoortweg
675,Schijnpoortweg,2023-02-17,00:00:00,39,7,32,FMN 08 Schijnpoortweg
675,Schijnpoortweg,2023-02-17,01:00:00,18,4,14,FMN 08 Schijnpoortweg
675,Schijnpoortweg,2023-02-17,02:00:00,15,3,12,FMN 08 Schijnpoortweg
675,Schijnpoortweg,2023-02-17,03:00:00,14,6,8,FMN 08 Schijnpoortweg
675,Schijnpoortweg,2023-02-17,04:00:00,25,9,16,FMN 08 Schijnpoortweg
675,Schijnpoortweg,2023-02-17,05:00:00,58,11,47,FMN 08 Schijnpoortweg
675,Schijnpoortweg,2023-02-17,06:00:00,100,16,84,FMN 08 Schijnpoortweg
675,Schijnpoortweg,2023-02-17,07:00:00,163,22,141,FMN 08 Schijnpoortweg
675,Schijnpoortweg,2023-02-17,08:00:00,194,29,165,FMN 08 Schijnpoortweg
675,Schijnpoortweg,2023-02-17,09:00:00,100,16,84,FMN 08 Schijnpoortweg
675,Schijnpoortweg,2023-02-17,10:00:00,86,19,67,FMN 08 Schijnpoortweg
675,Schijnpoortweg,2023-02-17,11:00:00,103,15,88,FMN 08 Schijnpoortweg
675,Schijnpoortweg,2023-02-17,12:00:00,139,17,122,FMN 08 Schijnpoortweg
675,Schijnpoortweg,2023-02-17,13:00:00,146,26,120,FMN 08 Schijnpoortweg
675,Schijnpoortweg,2023-02-17,14:00:00,144,15,129,FMN 08 Schijnpoortweg
675,Schijnpoortweg,2023-02-17,15:00:00,264,28,236,FMN 08 Schijnpoortweg
675,Schijnpoortweg,2023-02-17,16:00:00,290,19,271,FMN 08 Schijnpoortweg
675,Schijnpoortweg,2023-02-17,17:00:00,270,30,240,FMN 08 Schijnpoortweg
675,Schijnpoortweg,2023-02-17,18:00:00,181,24,157,FMN 08 Schijnpoortweg
675,Schijnpoortweg,2023-02-17,19:00:00,211,21,190,FMN 08 Schijnpoortweg
675,Schijnpoortweg,2023-02-17,20:00:00,108,21,87,FMN 08 Schijnpoortweg
675,Schijnpoortweg,2023-02-17,21:00:00,86,6,80,FMN 08 Schijnpoortweg
675,Schijnpoortweg,2023-02-17,22:00:00,132,57,75,FMN 08 Schijnpoortweg
675,Schijnpoortweg,2023-02-17,23:00:00,64,8,56,FMN 08 Schijnpoortweg
675,Schijnpoortweg,2023-02-18,00:00:00,66,13,53,FMN 08 Schijnpoortweg
675,Schijnpoortweg,2023-02-18,01:00:00,32,7,25,FMN 08 Schijnpoortweg
675,Schijnpoortweg,2023-02-18,02:00:00,27,3,24,FMN 08 Schijnpoortweg
675,Schijnpoortweg,2023-02-18,03:00:00,16,6,10,FMN 08 Schijnpoortweg
675,Schijnpoortweg,2023-02-18,04:00:00,11,1,10,FMN 08 Schijnpoortweg
675,Schijnpoortweg,2023-02-18,05:00:00,24,14,10,FMN 08 Schijnpoortweg
675,Schijnpoortweg,2023-02-18,06:00:00,31,6,25,FMN 08 Schijnpoortweg
675,Schijnpoortweg,2023-02-18,07:00:00,20,4,16,FMN 08 Schijnpoortweg
675,Schijnpoortweg,2023-02-18,08:00:00,38,4,34,FMN 08 Schijnpoortweg
675,Schijnpoortweg,2023-02-18,09:00:00,81,15,66,FMN 08 Schijnpoortweg
675,Schijnpoortweg,2023-02-18,10:00:00,83,9,74,FMN 08 Schijnpoortweg
675,Schijnpoortweg,2023-02-18,11:00:00,95,13,82,FMN 08 Schijnpoortweg
675,Schijnpoortweg,2023-02-18,12:00:00,120,18,102,FMN 08 Schijnpoortweg
675,Schijnpoortweg,2023-02-18,13:00:00,121,25,96,FMN 08 Schijnpoortweg
675,Schijnpoortweg,2023-02-18,14:00:00,169,28,141,FMN 08 Schijnpoortweg
675,Schijnpoortweg,2023-02-18,15:00:00,200,38,162,FMN 08 Schijnpoortweg
675,Schijnpoortweg,2023-02-18,16:00:00,135,25,110,FMN 08 Schijnpoortweg
675,Schijnpoortweg,2023-02-18,17:00:00,142,27,115,FMN 08 Schijnpoortweg
675,Schijnpoortweg,2023-02-18,18:00:00,226,108,118,FMN 08 Schijnpoortweg
675,Schijnpoortweg,2023-02-18,19:00:00,225,29,196,FMN 08 Schijnpoortweg
675,Schijnpoortweg,2023-02-18,20:00:00,117,10,107,FMN 08 Schijnpoortweg
675,Schijnpoortweg,2023-02-18,21:00:00,74,14,60,FMN 08 Schijnpoortweg
675,Schijnpoortweg,2023-02-18,22:00:00,133,81,52,FMN 08 Schijnpoortweg
675,Schijnpoortweg,2023-02-18,23:00:00,80,11,69,FMN 08 Schijnpoortweg
675,Schijnpoortweg,2023-02-19,00:00:00,55,9,46,FMN 08 Schijnpoortweg
675,Schijnpoortweg,2023-02-19,01:00:00,32,6,26,FMN 08 Schijnpoortweg
675,Schijnpoortweg,2023-02-19,02:00:00,34,6,28,FMN 08 Schijnpoortweg
675,Schijnpoortweg,2023-02-19,03:00:00,19,6,13,FMN 08 Schijnpoortweg
675,Schijnpoortweg,2023-02-19,04:00:00,16,3,13,FMN 08 Schijnpoortweg
675,Schijnpoortweg,2023-02-19,05:00:00,23,4,19,FMN 08 Schijnpoortweg
675,Schijnpoortweg,2023-02-19,06:00:00,16,2,14,FMN 08 Schijnpoortweg
675,Schijnpoortweg,2023-02-19,07:00:00,20,2,18,FMN 08 Schijnpoortweg
675,Schijnpoortweg,2023-02-19,08:00:00,37,9,28,FMN 08 Schijnpoortweg
675,Schijnpoortweg,2023-02-19,09:00:00,52,13,39,FMN 08 Schijnpoortweg
675,Schijnpoortweg,2023-02-19,10:00:00,74,12,62,FMN 08 Schijnpoortweg
675,Schijnpoortweg,2023-02-19,11:00:00,83,22,61,FMN 08 Schijnpoortweg
675,Schijnpoortweg,2023-02-19,12:00:00,126,17,109,FMN 08 Schijnpoortweg
675,Schijnpoortweg,2023-02-19,13:00:00,104,12,92,FMN 08 Schijnpoortweg
675,Schijnpoortweg,2023-02-19,14:00:00,118,17,101,FMN 08 Schijnpoortweg
675,Schijnpoortweg,2023-02-19,15:00:00,189,73,116,FMN 08 Schijnpoortweg
675,Schijnpoortweg,2023-02-19,16:00:00,202,40,162,FMN 08 Schijnpoortweg
675,Schijnpoortweg,2023-02-19,17:00:00,142,22,120,FMN 08 Schijnpoortweg
675,Schijnpoortweg,2023-02-19,18:00:00,103,26,77,FMN 08 Schijnpoortweg
675,Schijnpoortweg,2023-02-19,19:00:00,172,84,88,FMN 08 Schijnpoortweg
675,Schijnpoortweg,2023-02-19,20:00:00,86,13,73,FMN 08 Schijnpoortweg
675,Schijnpoortweg,2023-02-19,21:00:00,82,13,69,FMN 08 Schijnpoortweg
675,Schijnpoortweg,2023-02-19,22:00:00,60,6,54,FMN 08 Schijnpoortweg
675,Schijnpoortweg,2023-02-19,23:00:00,48,9,39,FMN 08 Schijnpoortweg
675,Schijnpoortweg,2023-02-20,00:00:00,28,4,24,FMN 08 Schijnpoortweg
675,Schijnpoortweg,2023-02-20,01:00:00,18,4,14,FMN 08 Schijnpoortweg
675,Schijnpoortweg,2023-02-20,02:00:00,16,4,12,FMN 08 Schijnpoortweg
675,Schijnpoortweg,2023-02-20,03:00:00,12,4,8,FMN 08 Schijnpoortweg
675,Schijnpoortweg,2023-02-20,04:00:00,27,17,10,FMN 08 Schijnpoortweg
675,Schijnpoortweg,2023-02-20,05:00:00,73,12,61,FMN 08 Schijnpoortweg
675,Schijnpoortweg,2023-02-20,06:00:00,91,17,74,FMN 08 Schijnpoortweg
675,Schijnpoortweg,2023-02-20,07:00:00,151,13,138,FMN 08 Schijnpoortweg
675,Schijnpoortweg,2023-02-20,08:00:00,129,12,117,FMN 08 Schijnpoortweg
675,Schijnpoortweg,2023-02-20,09:00:00,76,9,67,FMN 08 Schijnpoortweg
675,Schijnpoortweg,2023-02-20,10:00:00,76,13,63,FMN 08 Schijnpoortweg
675,Schijnpoortweg,2023-02-20,11:00:00,85,7,78,FMN 08 Schijnpoortweg
675,Schijnpoortweg,2023-02-20,12:00:00,105,13,92,FMN 08 Schijnpoortweg
675,Schijnpoortweg,2023-02-20,13:00:00,97,11,86,FMN 08 Schijnpoortweg
675,Schijnpoortweg,2023-02-20,14:00:00,141,15,126,FMN 08 Schijnpoortweg
675,Schijnpoortweg,2023-02-20,15:00:00,161,23,138,FMN 08 Schijnpoortweg
675,Schijnpoortweg,2023-02-20,16:00:00,273,33,240,FMN 08 Schijnpoortweg
675,Schijnpoortweg,2023-02-20,17:00:00,280,27,253,FMN 08 Schijnpoortweg
675,Schijnpoortweg,2023-02-20,18:00:00,191,19,172,FMN 08 Schijnpoortweg
675,Schijnpoortweg,2023-02-20,19:00:00,128,16,112,FMN 08 Schijnpoortweg
675,Schijnpoortweg,2023-02-20,20:00:00,93,13,80,FMN 08 Schijnpoortweg
675,Schijnpoortweg,2023-02-20,21:00:00,88,10,78,FMN 08 Schijnpoortweg
675,Schijnpoortweg,2023-02-20,22:00:00,89,15,74,FMN 08 Schijnpoortweg
675,Schijnpoortweg,2023-02-20,23:00:00,58,7,51,FMN 08 Schijnpoortweg
675,Schijnpoortweg,2023-02-21,00:00:00,28,4,24,FMN 08 Schijnpoortweg
675,Schijnpoortweg,2023-02-21,01:00:00,19,4,15,FMN 08 Schijnpoortweg
675,Schijnpoortweg,2023-02-21,02:00:00,19,2,17,FMN 08 Schijnpoortweg
675,Schijnpoortweg,2023-02-21,03:00:00,14,5,9,FMN 08 Schijnpoortweg
675,Schijnpoortweg,2023-02-21,04:00:00,20,12,8,FMN 08 Schijnpoortweg
675,Schijnpoortweg,2023-02-21,05:00:00,53,11,42,FMN 08 Schijnpoortweg
675,Schijnpoortweg,2023-02-21,06:00:00,104,23,81,FMN 08 Schijnpoortweg
675,Schijnpoortweg,2023-02-21,07:00:00,154,18,136,FMN 08 Schijnpoortweg
675,Schijnpoortweg,2023-02-21,08:00:00,128,21,107,FMN 08 Schijnpoortweg
675,Schijnpoortweg,2023-02-21,09:00:00,98,17,81,FMN 08 Schijnpoortweg
675,Schijnpoortweg,2023-02-21,10:00:00,94,20,74,FMN 08 Schijnpoortweg
675,Schijnpoortweg,2023-02-21,11:00:00,86,11,75,FMN 08 Schijnpoortweg
675,Schijnpoortweg,2023-02-21,12:00:00,125,25,100,FMN 08 Schijnpoortweg
675,Schijnpoortweg,2023-02-21,13:00:00,124,16,108,FMN 08 Schijnpoortweg
675,Schijnpoortweg,2023-02-21,14:00:00,135,28,107,FMN 08 Schijnpoortweg
675,Schijnpoortweg,2023-02-21,15:00:00,173,16,157,FMN 08 Schijnpoortweg
675,Schijnpoortweg,2023-02-21,16:00:00,230,27,203,FMN 08 Schijnpoortweg
675,Schijnpoortweg,2023-02-21,17:00:00,256,20,236,FMN 08 Schijnpoortweg
675,Schijnpoortweg,2023-02-21,18:00:00,202,33,169,FMN 08 Schijnpoortweg
675,Schijnpoortweg,2023-02-21,19:00:00,148,7,141,FMN 08 Schijnpoortweg
675,Schijnpoortweg,2023-02-21,20:00:00,109,14,95,FMN 08 Schijnpoortweg
675,Schijnpoortweg,2023-02-21,21:00:00,77,12,65,FMN 08 Schijnpoortweg
675,Schijnpoortweg,2023-02-21,22:00:00,99,14,85,FMN 08 Schijnpoortweg
675,Schijnpoortweg,2023-02-21,23:00:00,73,7,66,FMN 08 Schijnpoortweg
675,Schijnpoortweg,2023-02-22,00:00:00,36,7,29,FMN 08 Schijnpoortweg
675,Schijnpoortweg,2023-02-22,01:00:00,20,5,15,FMN 08 Schijnpoortweg
675,Schijnpoortweg,2023-02-22,02:00:00,12,4,8,FMN 08 Schijnpoortweg
675,Schijnpoortweg,2023-02-22,03:00:00,15,4,11,FMN 08 Schijnpoortweg
675,Schijnpoortweg,2023-02-22,04:00:00,17,11,6,FMN 08 Schijnpoortweg
675,Schijnpoortweg,2023-02-22,05:00:00,52,8,44,FMN 08 Schijnpoortweg
675,Schijnpoortweg,2023-02-22,06:00:00,91,14,77,FMN 08 Schijnpoortweg
675,Schijnpoortweg,2023-02-22,07:00:00,131,12,119,FMN 08 Schijnpoortweg
675,Schijnpoortweg,2023-02-22,08:00:00,135,19,116,FMN 08 Schijnpoortweg
675,Schijnpoortweg,2023-02-22,09:00:00,83,8,75,FMN 08 Schijnpoortweg
675,Schijnpoortweg,2023-02-22,10:00:00,69,14,55,FMN 08 Schijnpoortweg
675,Schijnpoortweg,2023-02-22,11:00:00,81,19,62,FMN 08 Schijnpoortweg
675,Schijnpoortweg,2023-02-22,12:00:00,137,19,118,FMN 08 Schijnpoortweg
675,Schijnpoortweg,2023-02-22,13:00:00,144,21,123,FMN 08 Schijnpoortweg
675,Schijnpoortweg,2023-02-22,14:00:00,112,21,91,FMN 08 Schijnpoortweg
675,Schijnpoortweg,2023-02-22,15:00:00,177,20,157,FMN 08 Schijnpoortweg
675,Schijnpoortweg,2023-02-22,16:00:00,284,74,210,FMN 08 Schijnpoortweg
675,Schijnpoortweg,2023-02-22,17:00:00,246,29,217,FMN 08 Schijnpoortweg
675,Schijnpoortweg,2023-02-22,18:00:00,173,17,156,FMN 08 Schijnpoortweg
675,Schijnpoortweg,2023-02-22,19:00:00,136,10,126,FMN 08 Schijnpoortweg
675,Schijnpoortweg,2023-02-22,20:00:00,129,10,119,FMN 08 Schijnpoortweg
675,Schijnpoortweg,2023-02-22,21:00:00,96,13,83,FMN 08 Schijnpoortweg
675,Schijnpoortweg,2023-02-22,22:00:00,118,17,101,FMN 08 Schijnpoortweg
675,Schijnpoortweg,2023-02-22,23:00:00,59,9,50,FMN 08 Schijnpoortweg
675,Schijnpoortweg,2023-02-23,00:00:00,32,4,28,FMN 08 Schijnpoortweg
675,Schijnpoortweg,2023-02-23,01:00:00,14,2,12,FMN 08 Schijnpoortweg
675,Schijnpoortweg,2023-02-23,02:00:00,9,2,7,FMN 08 Schijnpoortweg
675,Schijnpoortweg,2023-02-23,03:00:00,22,7,15,FMN 08 Schijnpoortweg
675,Schijnpoortweg,2023-02-23,04:00:00,21,8,13,FMN 08 Schijnpoortweg
675,Schijnpoortweg,2023-02-23,05:00:00,53,11,42,FMN 08 Schijnpoortweg
675,Schijnpoortweg,2023-02-23,06:00:00,95,18,77,FMN 08 Schijnpoortweg
675,Schijnpoortweg,2023-02-23,07:00:00,129,12,117,FMN 08 Schijnpoortweg
675,Schijnpoortweg,2023-02-23,08:00:00,163,23,140,FMN 08 Schijnpoortweg
675,Schijnpoortweg,2023-02-23,09:00:00,92,9,83,FMN 08 Schijnpoortweg
675,Schijnpoortweg,2023-02-23,10:00:00,57,11,46,FMN 08 Schijnpoortweg
675,Schijnpoortweg,2023-02-23,11:00:00,86,11,75,FMN 08 Schijnpoortweg
675,Schijnpoortweg,2023-02-23,12:00:00,110,10,100,FMN 08 Schijnpoortweg
675,Schijnpoortweg,2023-02-23,13:00:00,134,23,111,FMN 08 Schijnpoortweg
675,Schijnpoortweg,2023-02-23,14:00:00,123,14,109,FMN 08 Schijnpoortweg
675,Schijnpoortweg,2023-02-23,15:00:00,177,15,162,FMN 08 Schijnpoortweg
675,Schijnpoortweg,2023-02-23,16:00:00,267,36,231,FMN 08 Schijnpoortweg
675,Schijnpoortweg,2023-02-23,17:00:00,293,36,257,FMN 08 Schijnpoortweg
675,Schijnpoortweg,2023-02-23,18:00:00,314,73,241,FMN 08 Schijnpoortweg
675,Schijnpoortweg,2023-02-23,19:00:00,259,29,230,FMN 08 Schijnpoortweg
675,Schijnpoortweg,2023-02-23,20:00:00,187,25,162,FMN 08 Schijnpoortweg
675,Schijnpoortweg,2023-02-23,21:00:00,78,11,67,FMN 08 Schijnpoortweg
675,Schijnpoortweg,2023-02-23,22:00:00,288,175,113,FMN 08 Schijnpoortweg
675,Schijnpoortweg,2023-02-23,23:00:00,69,11,58,FMN 08 Schijnpoortweg
675,Schijnpoortweg,2023-02-24,00:00:00,44,1,43,FMN 08 Schijnpoortweg
675,Schijnpoortweg,2023-02-24,01:00:00,33,6,27,FMN 08 Schijnpoortweg
675,Schijnpoortweg,2023-02-24,02:00:00,21,3,18,FMN 08 Schijnpoortweg
675,Schijnpoortweg,2023-02-24,03:00:00,25,10,15,FMN 08 Schijnpoortweg
675,Schijnpoortweg,2023-02-24,04:00:00,32,10,22,FMN 08 Schijnpoortweg
675,Schijnpoortweg,2023-02-24,05:00:00,57,9,48,FMN 08 Schijnpoortweg
675,Schijnpoortweg,2023-02-24,06:00:00,85,10,75,FMN 08 Schijnpoortweg
675,Schijnpoortweg,2023-02-24,07:00:00,126,12,114,FMN 08 Schijnpoortweg
675,Schijnpoortweg,2023-02-24,08:00:00,98,14,84,FMN 08 Schijnpoortweg
675,Schijnpoortweg,2023-02-24,09:00:00,77,10,67,FMN 08 Schijnpoortweg
675,Schijnpoortweg,2023-02-24,10:00:00,89,9,80,FMN 08 Schijnpoortweg
675,Schijnpoortweg,2023-02-24,11:00:00,103,21,82,FMN 08 Schijnpoortweg
675,Schijnpoortweg,2023-02-24,12:00:00,123,16,107,FMN 08 Schijnpoortweg
675,Schijnpoortweg,2023-02-24,13:00:00,128,16,112,FMN 08 Schijnpoortweg
675,Schijnpoortweg,2023-02-24,14:00:00,163,40,123,FMN 08 Schijnpoortweg
675,Schijnpoortweg,2023-02-24,15:00:00,164,22,142,FMN 08 Schijnpoortweg
675,Schijnpoortweg,2023-02-24,16:00:00,248,70,178,FMN 08 Schijnpoortweg
675,Schijnpoortweg,2023-02-24,17:00:00,248,42,206,FMN 08 Schijnpoortweg
675,Schijnpoortweg,2023-02-24,18:00:00,235,69,166,FMN 08 Schijnpoortweg
675,Schijnpoortweg,2023-02-24,19:00:00,230,29,201,FMN 08 Schijnpoortweg
675,Schijnpoortweg,2023-02-24,20:00:00,206,17,189,FMN 08 Schijnpoortweg
675,Schijnpoortweg,2023-02-24,21:00:00,92,16,76,FMN 08 Schijnpoortweg
675,Schijnpoortweg,2023-02-24,22:00:00,85,9,76,FMN 08 Schijnpoortweg
675,Schijnpoortweg,2023-02-24,23:00:00,192,113,79,FMN 08 Schijnpoortweg
675,Schijnpoortweg,2023-02-25,00:00:00,55,5,50,FMN 08 Schijnpoortweg
675,Schijnpoortweg,2023-02-25,01:00:00,36,4,32,FMN 08 Schijnpoortweg
675,Schijnpoortweg,2023-02-25,02:00:00,27,1,26,FMN 08 Schijnpoortweg
675,Schijnpoortweg,2023-02-25,03:00:00,19,4,15,FMN 08 Schijnpoortweg
675,Schijnpoortweg,2023-02-25,04:00:00,20,7,13,FMN 08 Schijnpoortweg
675,Schijnpoortweg,2023-02-25,05:00:00,23,4,19,FMN 08 Schijnpoortweg
675,Schijnpoortweg,2023-02-25,06:00:00,24,5,19,FMN 08 Schijnpoortweg
675,Schijnpoortweg,2023-02-25,07:00:00,34,7,27,FMN 08 Schijnpoortweg
675,Schijnpoortweg,2023-02-25,08:00:00,40,4,36,FMN 08 Schijnpoortweg
675,Schijnpoortweg,2023-02-25,09:00:00,78,18,60,FMN 08 Schijnpoortweg
675,Schijnpoortweg,2023-02-25,10:00:00,97,20,77,FMN 08 Schijnpoortweg
675,Schijnpoortweg,2023-02-25,11:00:00,110,16,94,FMN 08 Schijnpoortweg
675,Schijnpoortweg,2023-02-25,12:00:00,129,41,88,FMN 08 Schijnpoortweg
675,Schijnpoortweg,2023-02-25,13:00:00,120,28,92,FMN 08 Schijnpoortweg
675,Schijnpoortweg,2023-02-25,14:00:00,146,23,123,FMN 08 Schijnpoortweg
675,Schijnpoortweg,2023-02-25,15:00:00,118,17,101,FMN 08 Schijnpoortweg
675,Schijnpoortweg,2023-02-25,16:00:00,156,53,103,FMN 08 Schijnpoortweg
675,Schijnpoortweg,2023-02-25,17:00:00,170,29,141,FMN 08 Schijnpoortweg
675,Schijnpoortweg,2023-02-25,18:00:00,130,18,112,FMN 08 Schijnpoortweg
675,Schijnpoortweg,2023-02-25,19:00:00,122,15,107,FMN 08 Schijnpoortweg
675,Schijnpoortweg,2023-02-25,20:00:00,139,45,94,FMN 08 Schijnpoortweg
675,Schijnpoortweg,2023-02-25,21:00:00,70,8,62,FMN 08 Schijnpoortweg
675,Schijnpoortweg,2023-02-25,22:00:00,93,14,79,FMN 08 Schijnpoortweg
675,Schijnpoortweg,2023-02-25,23:00:00,65,9,56,FMN 08 Schijnpoortweg
675,Schijnpoortweg,2023-02-26,00:00:00,58,4,54,FMN 08 Schijnpoortweg
675,Schijnpoortweg,2023-02-26,01:00:00,31,3,28,FMN 08 Schijnpoortweg
675,Schijnpoortweg,2023-02-26,02:00:00,29,5,24,FMN 08 Schijnpoortweg
675,Schijnpoortweg,2023-02-26,03:00:00,18,6,12,FMN 08 Schijnpoortweg
675,Schijnpoortweg,2023-02-26,04:00:00,16,4,12,FMN 08 Schijnpoortweg
675,Schijnpoortweg,2023-02-26,05:00:00,21,3,18,FMN 08 Schijnpoortweg
675,Schijnpoortweg,2023-02-26,06:00:00,14,2,12,FMN 08 Schijnpoortweg
675,Schijnpoortweg,2023-02-26,07:00:00,20,7,13,FMN 08 Schijnpoortweg
675,Schijnpoortweg,2023-02-26,08:00:00,39,10,29,FMN 08 Schijnpoortweg
675,Schijnpoortweg,2023-02-26,09:00:00,69,11,58,FMN 08 Schijnpoortweg
675,Schijnpoortweg,2023-02-26,10:00:00,93,28,65,FMN 08 Schijnpoortweg
675,Schijnpoortweg,2023-02-26,11:00:00,96,15,81,FMN 08 Schijnpoortweg
675,Schijnpoortweg,2023-02-26,12:00:00,171,88,83,FMN 08 Schijnpoortweg
675,Schijnpoortweg,2023-02-26,13:00:00,173,71,102,FMN 08 Schijnpoortweg
675,Schijnpoortweg,2023-02-26,14:00:00,144,29,115,FMN 08 Schijnpoortweg
675,Schijnpoortweg,2023-02-26,15:00:00,111,14,97,FMN 08 Schijnpoortweg
675,Schijnpoortweg,2023-02-26,16:00:00,158,67,91,FMN 08 Schijnpoortweg
675,Schijnpoortweg,2023-02-26,17:00:00,121,20,101,FMN 08 Schijnpoortweg
675,Schijnpoortweg,2023-02-26,18:00:00,107,14,93,FMN 08 Schijnpoortweg
675,Schijnpoortweg,2023-02-26,19:00:00,115,19,96,FMN 08 Schijnpoortweg
675,Schijnpoortweg,2023-02-26,20:00:00,111,36,75,FMN 08 Schijnpoortweg
675,Schijnpoortweg,2023-02-26,21:00:00,86,15,71,FMN 08 Schijnpoortweg
675,Schijnpoortweg,2023-02-26,22:00:00,53,8,45,FMN 08 Schijnpoortweg
675,Schijnpoortweg,2023-02-26,23:00:00,31,4,27,FMN 08 Schijnpoortweg
675,Schijnpoortweg,2023-02-27,00:00:00,23,3,20,FMN 08 Schijnpoortweg
675,Schijnpoortweg,2023-02-27,01:00:00,12,3,9,FMN 08 Schijnpoortweg
675,Schijnpoortweg,2023-02-27,02:00:00,15,5,10,FMN 08 Schijnpoortweg
675,Schijnpoortweg,2023-02-27,03:00:00,9,2,7,FMN 08 Schijnpoortweg
675,Schijnpoortweg,2023-02-27,04:00:00,19,6,13,FMN 08 Schijnpoortweg
675,Schijnpoortweg,2023-02-27,05:00:00,48,4,44,FMN 08 Schijnpoortweg
675,Schijnpoortweg,2023-02-27,06:00:00,99,13,86,FMN 08 Schijnpoortweg
675,Schijnpoortweg,2023-02-27,07:00:00,179,25,154,FMN 08 Schijnpoortweg
675,Schijnpoortweg,2023-02-27,08:00:00,234,53,181,FMN 08 Schijnpoortweg
675,Schijnpoortweg,2023-02-27,09:00:00,113,13,100,FMN 08 Schijnpoortweg
675,Schijnpoortweg,2023-02-27,10:00:00,75,17,58,FMN 08 Schijnpoortweg
675,Schijnpoortweg,2023-02-27,11:00:00,89,14,75,FMN 08 Schijnpoortweg
675,Schijnpoortweg,2023-02-27,12:00:00,113,12,101,FMN 08 Schijnpoortweg
675,Schijnpoortweg,2023-02-27,13:00:00,116,6,110,FMN 08 Schijnpoortweg
675,Schijnpoortweg,2023-02-27,14:00:00,112,11,101,FMN 08 Schijnpoortweg
675,Schijnpoortweg,2023-02-27,15:00:00,246,20,226,FMN 08 Schijnpoortweg
675,Schijnpoortweg,2023-02-27,16:00:00,331,28,303,FMN 08 Schijnpoortweg
675,Schijnpoortweg,2023-02-27,17:00:00,326,25,301,FMN 08 Schijnpoortweg
675,Schijnpoortweg,2023-02-27,18:00:00,201,26,175,FMN 08 Schijnpoortweg
675,Schijnpoortweg,2023-02-27,19:00:00,138,9,129,FMN 08 Schijnpoortweg
675,Schijnpoortweg,2023-02-27,20:00:00,123,19,104,FMN 08 Schijnpoortweg
675,Schijnpoortweg,2023-02-27,21:00:00,98,12,86,FMN 08 Schijnpoortweg
675,Schijnpoortweg,2023-02-27,22:00:00,88,17,71,FMN 08 Schijnpoortweg
675,Schijnpoortweg,2023-02-27,23:00:00,41,4,37,FMN 08 Schijnpoortweg
675,Schijnpoortweg,2023-02-28,00:00:00,21,4,17,FMN 08 Schijnpoortweg
675,Schijnpoortweg,2023-02-28,01:00:00,22,8,14,FMN 08 Schijnpoortweg
675,Schijnpoortweg,2023-02-28,02:00:00,20,3,17,FMN 08 Schijnpoortweg
675,Schijnpoortweg,2023-02-28,03:00:00,9,1,8,FMN 08 Schijnpoortweg
675,Schijnpoortweg,2023-02-28,04:00:00,26,13,13,FMN 08 Schijnpoortweg
675,Schijnpoortweg,2023-02-28,05:00:00,54,8,46,FMN 08 Schijnpoortweg
675,Schijnpoortweg,2023-02-28,06:00:00,94,15,79,FMN 08 Schijnpoortweg
675,Schijnpoortweg,2023-02-28,07:00:00,191,27,164,FMN 08 Schijnpoortweg
675,Schijnpoortweg,2023-02-28,08:00:00,237,37,200,FMN 08 Schijnpoortweg
675,Schijnpoortweg,2023-02-28,09:00:00,103,13,90,FMN 08 Schijnpoortweg
675,Schijnpoortweg,2023-02-28,10:00:00,95,10,85,FMN 08 Schijnpoortweg
675,Schijnpoortweg,2023-02-28,11:00:00,94,10,84,FMN 08 Schijnpoortweg
675,Schijnpoortweg,2023-02-28,12:00:00,139,14,125,FMN 08 Schijnpoortweg
675,Schijnpoortweg,2023-02-28,13:00:00,132,9,123,FMN 08 Schijnpoortweg
675,Schijnpoortweg,2023-02-28,14:00:00,159,18,141,FMN 08 Schijnpoortweg
675,Schijnpoortweg,2023-02-28,15:00:00,270,22,248,FMN 08 Schijnpoortweg
675,Schijnpoortweg,2023-02-28,16:00:00,365,35,330,FMN 08 Schijnpoortweg
675,Schijnpoortweg,2023-02-28,17:00:00,362,44,318,FMN 08 Schijnpoortweg
675,Schijnpoortweg,2023-02-28,18:00:00,283,30,253,FMN 08 Schijnpoortweg
675,Schijnpoortweg,2023-02-28,19:00:00,298,63,235,FMN 08 Schijnpoortweg
675,Schijnpoortweg,2023-02-28,20:00:00,165,26,139,FMN 08 Schijnpoortweg
675,Schijnpoortweg,2023-02-28,21:00:00,120,14,106,FMN 08 Schijnpoortweg
675,Schijnpoortweg,2023-02-28,22:00:00,71,3,68,FMN 08 Schijnpoortweg
675,Schijnpoortweg,2023-02-28,23:00:00,152,104,48,FMN 08 Schijnpoortweg
675,Schijnpoortweg,2023-03-01,00:00:00,38,8,30,FMN 08 Schijnpoortweg
675,Schijnpoortweg,2023-03-01,01:00:00,17,0,17,FMN 08 Schijnpoortweg
675,Schijnpoortweg,2023-03-01,02:00:00,9,1,8,FMN 08 Schijnpoortweg
675,Schijnpoortweg,2023-03-01,03:00:00,13,2,11,FMN 08 Schijnpoortweg
675,Schijnpoortweg,2023-03-01,04:00:00,32,11,21,FMN 08 Schijnpoortweg
675,Schijnpoortweg,2023-03-01,05:00:00,64,9,55,FMN 08 Schijnpoortweg
675,Schijnpoortweg,2023-03-01,06:00:00,87,16,71,FMN 08 Schijnpoortweg
675,Schijnpoortweg,2023-03-01,07:00:00,186,13,173,FMN 08 Schijnpoortweg
675,Schijnpoortweg,2023-03-01,08:00:00,219,47,172,FMN 08 Schijnpoortweg
675,Schijnpoortweg,2023-03-01,09:00:00,109,14,95,FMN 08 Schijnpoortweg
675,Schijnpoortweg,2023-03-01,10:00:00,97,17,80,FMN 08 Schijnpoortweg
675,Schijnpoortweg,2023-03-01,11:00:00,96,10,86,FMN 08 Schijnpoortweg
675,Schijnpoortweg,2023-03-01,12:00:00,222,13,209,FMN 08 Schijnpoortweg
675,Schijnpoortweg,2023-03-01,13:00:00,149,9,140,FMN 08 Schijnpoortweg
675,Schijnpoortweg,2023-03-01,14:00:00,154,15,139,FMN 08 Schijnpoortweg
675,Schijnpoortweg,2023-03-01,15:00:00,197,19,178,FMN 08 Schijnpoortweg
675,Schijnpoortweg,2023-03-01,16:00:00,276,30,246,FMN 08 Schijnpoortweg
675,Schijnpoortweg,2023-03-01,17:00:00,256,18,238,FMN 08 Schijnpoortweg
675,Schijnpoortweg,2023-03-01,18:00:00,180,26,154,FMN 08 Schijnpoortweg
675,Schijnpoortweg,2023-03-01,19:00:00,169,18,151,FMN 08 Schijnpoortweg
675,Schijnpoortweg,2023-03-01,20:00:00,129,10,119,FMN 08 Schijnpoortweg
675,Schijnpoortweg,2023-03-01,21:00:00,100,9,91,FMN 08 Schijnpoortweg
675,Schijnpoortweg,2023-03-01,22:00:00,96,11,85,FMN 08 Schijnpoortweg
675,Schijnpoortweg,2023-03-01,23:00:00,60,4,56,FMN 08 Schijnpoortweg
675,Schijnpoortweg,2023-03-02,00:00:00,23,1,22,FMN 08 Schijnpoortweg
675,Schijnpoortweg,2023-03-02,01:00:00,15,2,13,FMN 08 Schijnpoortweg
675,Schijnpoortweg,2023-03-02,02:00:00,22,6,16,FMN 08 Schijnpoortweg
675,Schijnpoortweg,2023-03-02,03:00:00,11,3,8,FMN 08 Schijnpoortweg
675,Schijnpoortweg,2023-03-02,04:00:00,24,9,15,FMN 08 Schijnpoortweg
675,Schijnpoortweg,2023-03-02,05:00:00,62,13,49,FMN 08 Schijnpoortweg
675,Schijnpoortweg,2023-03-02,06:00:00,93,15,78,FMN 08 Schijnpoortweg
675,Schijnpoortweg,2023-03-02,07:00:00,192,24,168,FMN 08 Schijnpoortweg
675,Schijnpoortweg,2023-03-02,08:00:00,251,46,205,FMN 08 Schijnpoortweg
675,Schijnpoortweg,2023-03-02,09:00:00,122,15,107,FMN 08 Schijnpoortweg
675,Schijnpoortweg,2023-03-02,10:00:00,94,23,71,FMN 08 Schijnpoortweg
675,Schijnpoortweg,2023-03-02,11:00:00,82,9,73,FMN 08 Schijnpoortweg
675,Schijnpoortweg,2023-03-02,12:00:00,136,15,121,FMN 08 Schijnpoortweg
675,Schijnpoortweg,2023-03-02,13:00:00,133,17,116,FMN 08 Schijnpoortweg
675,Schijnpoortweg,2023-03-02,14:00:00,148,21,127,FMN 08 Schijnpoortweg
675,Schijnpoortweg,2023-03-02,15:00:00,250,20,230,FMN 08 Schijnpoortweg
675,Schijnpoortweg,2023-03-02,16:00:00,319,40,279,FMN 08 Schijnpoortweg
675,Schijnpoortweg,2023-03-02,17:00:00,350,26,324,FMN 08 Schijnpoortweg
675,Schijnpoortweg,2023-03-02,18:00:00,291,36,255,FMN 08 Schijnpoortweg
675,Schijnpoortweg,2023-03-02,19:00:00,309,42,267,FMN 08 Schijnpoortweg
675,Schijnpoortweg,2023-03-02,20:00:00,212,20,192,FMN 08 Schijnpoortweg
675,Schijnpoortweg,2023-03-02,21:00:00,110,17,93,FMN 08 Schijnpoortweg
675,Schijnpoortweg,2023-03-02,22:00:00,166,57,109,FMN 08 Schijnpoortweg
675,Schijnpoortweg,2023-03-02,23:00:00,121,34,87,FMN 08 Schijnpoortweg
675,Schijnpoortweg,2023-03-03,00:00:00,78,39,39,FMN 08 Schijnpoortweg
675,Schijnpoortweg,2023-03-03,01:00:00,16,5,11,FMN 08 Schijnpoortweg
675,Schijnpoortweg,2023-03-03,02:00:00,22,5,17,FMN 08 Schijnpoortweg
675,Schijnpoortweg,2023-03-03,03:00:00,13,3,10,FMN 08 Schijnpoortweg
675,Schijnpoortweg,2023-03-03,04:00:00,25,10,15,FMN 08 Schijnpoortweg
675,Schijnpoortweg,2023-03-03,05:00:00,62,10,52,FMN 08 Schijnpoortweg
675,Schijnpoortweg,2023-03-03,06:00:00,97,13,84,FMN 08 Schijnpoortweg
675,Schijnpoortweg,2023-03-03,07:00:00,167,23,144,FMN 08 Schijnpoortweg
675,Schijnpoortweg,2023-03-03,08:00:00,210,35,175,FMN 08 Schijnpoortweg
675,Schijnpoortweg,2023-03-03,09:00:00,109,19,90,FMN 08 Schijnpoortweg
675,Schijnpoortweg,2023-03-03,10:00:00,92,23,69,FMN 08 Schijnpoortweg
675,Schijnpoortweg,2023-03-03,11:00:00,87,12,75,FMN 08 Schijnpoortweg
675,Schijnpoortweg,2023-03-03,12:00:00,152,26,126,FMN 08 Schijnpoortweg
675,Schijnpoortweg,2023-03-03,13:00:00,131,14,117,FMN 08 Schijnpoortweg
675,Schijnpoortweg,2023-03-03,14:00:00,152,15,137,FMN 08 Schijnpoortweg
675,Schijnpoortweg,2023-03-03,15:00:00,244,21,223,FMN 08 Schijnpoortweg
675,Schijnpoortweg,2023-03-03,16:00:00,307,16,291,FMN 08 Schijnpoortweg
675,Schijnpoortweg,2023-03-03,17:00:00,270,35,235,FMN 08 Schijnpoortweg
675,Schijnpoortweg,2023-03-03,18:00:00,191,27,164,FMN 08 Schijnpoortweg
675,Schijnpoortweg,2023-03-03,19:00:00,192,14,178,FMN 08 Schijnpoortweg
675,Schijnpoortweg,2023-03-03,20:00:00,118,12,106,FMN 08 Schijnpoortweg
675,Schijnpoortweg,2023-03-03,21:00:00,97,15,82,FMN 08 Schijnpoortweg
675,Schijnpoortweg,2023-03-03,22:00:00,107,26,81,FMN 08 Schijnpoortweg
675,Schijnpoortweg,2023-03-03,23:00:00,84,14,70,FMN 08 Schijnpoortweg
675,Schijnpoortweg,2023-03-04,00:00:00,67,6,61,FMN 08 Schijnpoortweg
675,Schijnpoortweg,2023-03-04,01:00:00,48,5,43,FMN 08 Schijnpoortweg
675,Schijnpoortweg,2023-03-04,02:00:00,26,5,21,FMN 08 Schijnpoortweg
675,Schijnpoortweg,2023-03-04,03:00:00,21,5,16,FMN 08 Schijnpoortweg
675,Schijnpoortweg,2023-03-04,04:00:00,17,5,12,FMN 08 Schijnpoortweg
675,Schijnpoortweg,2023-03-04,05:00:00,13,2,11,FMN 08 Schijnpoortweg
675,Schijnpoortweg,2023-03-04,06:00:00,30,4,26,FMN 08 Schijnpoortweg
675,Schijnpoortweg,2023-03-04,07:00:00,37,5,32,FMN 08 Schijnpoortweg
675,Schijnpoortweg,2023-03-04,08:00:00,61,12,49,FMN 08 Schijnpoortweg
675,Schijnpoortweg,2023-03-04,09:00:00,76,8,68,FMN 08 Schijnpoortweg
675,Schijnpoortweg,2023-03-04,10:00:00,115,14,101,FMN 08 Schijnpoortweg
675,Schijnpoortweg,2023-03-04,11:00:00,111,22,89,FMN 08 Schijnpoortweg
675,Schijnpoortweg,2023-03-04,12:00:00,107,17,90,FMN 08 Schijnpoortweg
675,Schijnpoortweg,2023-03-04,13:00:00,121,17,104,FMN 08 Schijnpoortweg
675,Schijnpoortweg,2023-03-04,14:00:00,147,21,126,FMN 08 Schijnpoortweg
675,Schijnpoortweg,2023-03-04,15:00:00,125,14,111,FMN 08 Schijnpoortweg
675,Schijnpoortweg,2023-03-04,16:00:00,147,34,113,FMN 08 Schijnpoortweg
675,Schijnpoortweg,2023-03-04,17:00:00,142,30,112,FMN 08 Schijnpoortweg
675,Schijnpoortweg,2023-03-04,18:00:00,172,63,109,FMN 08 Schijnpoortweg
675,Schijnpoortweg,2023-03-04,19:00:00,192,75,117,FMN 08 Schijnpoortweg
675,Schijnpoortweg,2023-03-04,20:00:00,155,62,93,FMN 08 Schijnpoortweg
675,Schijnpoortweg,2023-03-04,21:00:00,138,58,80,FMN 08 Schijnpoortweg
675,Schijnpoortweg,2023-03-04,22:00:00,144,42,102,FMN 08 Schijnpoortweg
675,Schijnpoortweg,2023-03-04,23:00:00,115,27,88,FMN 08 Schijnpoortweg
675,Schijnpoortweg,2023-03-05,00:00:00,59,8,51,FMN 08 Schijnpoortweg
675,Schijnpoortweg,2023-03-05,01:00:00,41,5,36,FMN 08 Schijnpoortweg
675,Schijnpoortweg,2023-03-05,02:00:00,22,3,19,FMN 08 Schijnpoortweg
675,Schijnpoortweg,2023-03-05,03:00:00,24,8,16,FMN 08 Schijnpoortweg
675,Schijnpoortweg,2023-03-05,04:00:00,49,33,16,FMN 08 Schijnpoortweg
675,Schijnpoortweg,2023-03-05,05:00:00,25,11,14,FMN 08 Schijnpoortweg
675,Schijnpoortweg,2023-03-05,06:00:00,40,28,12,FMN 08 Schijnpoortweg
675,Schijnpoortweg,2023-03-05,07:00:00,48,27,21,FMN 08 Schijnpoortweg
675,Schijnpoortweg,2023-03-05,08:00:00,45,14,31,FMN 08 Schijnpoortweg
675,Schijnpoortweg,2023-03-05,09:00:00,53,13,40,FMN 08 Schijnpoortweg
675,Schijnpoortweg,2023-03-05,10:00:00,78,17,61,FMN 08 Schijnpoortweg
675,Schijnpoortweg,2023-03-05,11:00:00,77,12,65,FMN 08 Schijnpoortweg
675,Schijnpoortweg,2023-03-05,12:00:00,92,25,67,FMN 08 Schijnpoortweg
675,Schijnpoortweg,2023-03-05,13:00:00,102,26,76,FMN 08 Schijnpoortweg
675,Schijnpoortweg,2023-03-05,14:00:00,113,11,102,FMN 08 Schijnpoortweg
675,Schijnpoortweg,2023-03-05,15:00:00,157,23,134,FMN 08 Schijnpoortweg
675,Schijnpoortweg,2023-03-05,16:00:00,92,13,79,FMN 08 Schijnpoortweg
675,Schijnpoortweg,2023-03-05,17:00:00,112,21,91,FMN 08 Schijnpoortweg
675,Schijnpoortweg,2023-03-05,18:00:00,112,34,78,FMN 08 Schijnpoortweg
675,Schijnpoortweg,2023-03-05,19:00:00,106,22,84,FMN 08 Schijnpoortweg
675,Schijnpoortweg,2023-03-05,20:00:00,86,12,74,FMN 08 Schijnpoortweg
675,Schijnpoortweg,2023-03-05,21:00:00,66,9,57,FMN 08 Schijnpoortweg
675,Schijnpoortweg,2023-03-05,22:00:00,53,6,47,FMN 08 Schijnpoortweg
675,Schijnpoortweg,2023-03-05,23:00:00,40,6,34,FMN 08 Schijnpoortweg
675,Schijnpoortweg,2023-03-06,00:00:00,27,1,26,FMN 08 Schijnpoortweg
675,Schijnpoortweg,2023-03-06,01:00:00,17,2,15,FMN 08 Schijnpoortweg
675,Schijnpoortweg,2023-03-06,02:00:00,14,4,10,FMN 08 Schijnpoortweg
675,Schijnpoortweg,2023-03-06,03:00:00,12,5,7,FMN 08 Schijnpoortweg
675,Schijnpoortweg,2023-03-06,04:00:00,29,13,16,FMN 08 Schijnpoortweg
675,Schijnpoortweg,2023-03-06,05:00:00,59,12,47,FMN 08 Schijnpoortweg
675,Schijnpoortweg,2023-03-06,06:00:00,91,17,74,FMN 08 Schijnpoortweg
675,Schijnpoortweg,2023-03-06,07:00:00,178,20,158,FMN 08 Schijnpoortweg
675,Schijnpoortweg,2023-03-06,08:00:00,212,32,180,FMN 08 Schijnpoortweg
675,Schijnpoortweg,2023-03-06,09:00:00,112,17,95,FMN 08 Schijnpoortweg
675,Schijnpoortweg,2023-03-06,10:00:00,75,13,62,FMN 08 Schijnpoortweg
675,Schijnpoortweg,2023-03-06,11:00:00,95,10,85,FMN 08 Schijnpoortweg
675,Schijnpoortweg,2023-03-06,12:00:00,122,23,99,FMN 08 Schijnpoortweg
675,Schijnpoortweg,2023-03-06,13:00:00,107,9,98,FMN 08 Schijnpoortweg
675,Schijnpoortweg,2023-03-06,14:00:00,134,10,124,FMN 08 Schijnpoortweg
675,Schijnpoortweg,2023-03-06,15:00:00,228,12,216,FMN 08 Schijnpoortweg
675,Schijnpoortweg,2023-03-06,16:00:00,331,29,302,FMN 08 Schijnpoortweg
675,Schijnpoortweg,2023-03-06,17:00:00,298,12,286,FMN 08 Schijnpoortweg
675,Schijnpoortweg,2023-03-06,18:00:00,182,12,170,FMN 08 Schijnpoortweg
675,Schijnpoortweg,2023-03-06,19:00:00,143,14,129,FMN 08 Schijnpoortweg
675,Schijnpoortweg,2023-03-06,20:00:00,95,11,84,FMN 08 Schijnpoortweg
675,Schijnpoortweg,2023-03-06,21:00:00,89,10,79,FMN 08 Schijnpoortweg
675,Schijnpoortweg,2023-03-06,22:00:00,77,8,69,FMN 08 Schijnpoortweg
675,Schijnpoortweg,2023-03-06,23:00:00,38,9,29,FMN 08 Schijnpoortweg
675,Schijnpoortweg,2023-03-07,00:00:00,28,4,24,FMN 08 Schijnpoortweg
675,Schijnpoortweg,2023-03-07,01:00:00,14,2,12,FMN 08 Schijnpoortweg
675,Schijnpoortweg,2023-03-07,02:00:00,24,4,20,FMN 08 Schijnpoortweg
675,Schijnpoortweg,2023-03-07,03:00:00,11,5,6,FMN 08 Schijnpoortweg
675,Schijnpoortweg,2023-03-07,04:00:00,17,9,8,FMN 08 Schijnpoortweg
675,Schijnpoortweg,2023-03-07,05:00:00,51,7,44,FMN 08 Schijnpoortweg
675,Schijnpoortweg,2023-03-07,06:00:00,92,12,80,FMN 08 Schijnpoortweg
675,Schijnpoortweg,2023-03-07,07:00:00,185,27,158,FMN 08 Schijnpoortweg
675,Schijnpoortweg,2023-03-07,08:00:00,192,34,158,FMN 08 Schijnpoortweg
675,Schijnpoortweg,2023-03-07,09:00:00,80,10,70,FMN 08 Schijnpoortweg
675,Schijnpoortweg,2023-03-07,10:00:00,60,9,51,FMN 08 Schijnpoortweg
675,Schijnpoortweg,2023-03-07,11:00:00,56,6,50,FMN 08 Schijnpoortweg
675,Schijnpoortweg,2023-03-07,12:00:00,97,15,82,FMN 08 Schijnpoortweg
675,Schijnpoortweg,2023-03-07,13:00:00,120,15,105,FMN 08 Schijnpoortweg
675,Schijnpoortweg,2023-03-07,14:00:00,98,10,88,FMN 08 Schijnpoortweg
675,Schijnpoortweg,2023-03-07,15:00:00,198,21,177,FMN 08 Schijnpoortweg
675,Schijnpoortweg,2023-03-07,16:00:00,262,21,241,FMN 08 Schijnpoortweg
675,Schijnpoortweg,2023-03-07,17:00:00,227,18,209,FMN 08 Schijnpoortweg
675,Schijnpoortweg,2023-03-07,18:00:00,172,11,161,FMN 08 Schijnpoortweg
675,Schijnpoortweg,2023-03-07,19:00:00,126,8,118,FMN 08 Schijnpoortweg
675,Schijnpoortweg,2023-03-07,20:00:00,91,12,79,FMN 08 Schijnpoortweg
675,Schijnpoortweg,2023-03-07,21:00:00,77,12,65,FMN 08 Schijnpoortweg
675,Schijnpoortweg,2023-03-07,22:00:00,68,11,57,FMN 08 Schijnpoortweg
675,Schijnpoortweg,2023-03-07,23:00:00,47,6,41,FMN 08 Schijnpoortweg
675,Schijnpoortweg,2023-03-08,00:00:00,21,5,16,FMN 08 Schijnpoortweg
675,Schijnpoortweg,2023-03-08,01:00:00,19,5,14,FMN 08 Schijnpoortweg
675,Schijnpoortweg,2023-03-08,02:00:00,13,1,12,FMN 08 Schijnpoortweg
675,Schijnpoortweg,2023-03-08,03:00:00,12,1,11,FMN 08 Schijnpoortweg
675,Schijnpoortweg,2023-03-08,04:00:00,18,9,9,FMN 08 Schijnpoortweg
675,Schijnpoortweg,2023-03-08,05:00:00,49,5,44,FMN 08 Schijnpoortweg
675,Schijnpoortweg,2023-03-08,06:00:00,78,16,62,FMN 08 Schijnpoortweg
675,Schijnpoortweg,2023-03-08,07:00:00,153,8,145,FMN 08 Schijnpoortweg
675,Schijnpoortweg,2023-03-08,08:00:00,122,20,102,FMN 08 Schijnpoortweg
675,Schijnpoortweg,2023-03-08,09:00:00,53,11,42,FMN 08 Schijnpoortweg
675,Schijnpoortweg,2023-03-08,10:00:00,42,7,35,FMN 08 Schijnpoortweg
675,Schijnpoortweg,2023-03-08,11:00:00,74,11,63,FMN 08 Schijnpoortweg
675,Schijnpoortweg,2023-03-08,12:00:00,137,16,121,FMN 08 Schijnpoortweg
675,Schijnpoortweg,2023-03-08,13:00:00,115,12,103,FMN 08 Schijnpoortweg
675,Schijnpoortweg,2023-03-08,14:00:00,134,14,120,FMN 08 Schijnpoortweg
675,Schijnpoortweg,2023-03-08,15:00:00,130,12,118,FMN 08 Schijnpoortweg
675,Schijnpoortweg,2023-03-08,16:00:00,169,14,155,FMN 08 Schijnpoortweg
675,Schijnpoortweg,2023-03-08,17:00:00,176,15,161,FMN 08 Schijnpoortweg
675,Schijnpoortweg,2023-03-08,18:00:00,130,6,124,FMN 08 Schijnpoortweg
675,Schijnpoortweg,2023-03-08,19:00:00,80,8,72,FMN 08 Schijnpoortweg
675,Schijnpoortweg,2023-03-08,20:00:00,74,8,66,FMN 08 Schijnpoortweg
675,Schijnpoortweg,2023-03-08,21:00:00,67,4,63,FMN 08 Schijnpoortweg
675,Schijnpoortweg,2023-03-08,22:00:00,62,11,51,FMN 08 Schijnpoortweg
675,Schijnpoortweg,2023-03-08,23:00:00,46,5,41,FMN 08 Schijnpoortweg
675,Schijnpoortweg,2023-03-09,00:00:00,15,3,12,FMN 08 Schijnpoortweg
675,Schijnpoortweg,2023-03-09,01:00:00,11,2,9,FMN 08 Schijnpoortweg
675,Schijnpoortweg,2023-03-09,02:00:00,13,4,9,FMN 08 Schijnpoortweg
675,Schijnpoortweg,2023-03-09,03:00:00,13,3,10,FMN 08 Schijnpoortweg
675,Schijnpoortweg,2023-03-09,04:00:00,19,6,13,FMN 08 Schijnpoortweg
675,Schijnpoortweg,2023-03-09,05:00:00,49,12,37,FMN 08 Schijnpoortweg
675,Schijnpoortweg,2023-03-09,06:00:00,83,10,73,FMN 08 Schijnpoortweg
675,Schijnpoortweg,2023-03-09,07:00:00,161,10,151,FMN 08 Schijnpoortweg
675,Schijnpoortweg,2023-03-09,08:00:00,177,23,154,FMN 08 Schijnpoortweg
675,Schijnpoortweg,2023-03-09,09:00:00,67,12,55,FMN 08 Schijnpoortweg
675,Schijnpoortweg,2023-03-09,10:00:00,92,19,73,FMN 08 Schijnpoortweg
675,Schijnpoortweg,2023-03-09,11:00:00,79,11,68,FMN 08 Schijnpoortweg
675,Schijnpoortweg,2023-03-09,12:00:00,114,12,102,FMN 08 Schijnpoortweg
675,Schijnpoortweg,2023-03-09,13:00:00,97,11,86,FMN 08 Schijnpoortweg
675,Schijnpoortweg,2023-03-09,14:00:00,101,11,90,FMN 08 Schijnpoortweg
675,Schijnpoortweg,2023-03-09,15:00:00,193,16,177,FMN 08 Schijnpoortweg
675,Schijnpoortweg,2023-03-09,16:00:00,246,20,226,FMN 08 Schijnpoortweg
675,Schijnpoortweg,2023-03-09,17:00:00,277,16,261,FMN 08 Schijnpoortweg
675,Schijnpoortweg,2023-03-09,18:00:00,161,17,144,FMN 08 Schijnpoortweg
675,Schijnpoortweg,2023-03-09,19:00:00,115,12,103,FMN 08 Schijnpoortweg
675,Schijnpoortweg,2023-03-09,20:00:00,79,15,64,FMN 08 Schijnpoortweg
675,Schijnpoortweg,2023-03-09,21:00:00,68,8,60,FMN 08 Schijnpoortweg
675,Schijnpoortweg,2023-03-09,22:00:00,76,12,64,FMN 08 Schijnpoortweg
675,Schijnpoortweg,2023-03-09,23:00:00,40,3,37,FMN 08 Schijnpoortweg
675,Schijnpoortweg,2023-03-10,00:00:00,22,3,19,FMN 08 Schijnpoortweg
675,Schijnpoortweg,2023-03-10,01:00:00,17,5,12,FMN 08 Schijnpoortweg
675,Schijnpoortweg,2023-03-10,02:00:00,18,6,12,FMN 08 Schijnpoortweg
675,Schijnpoortweg,2023-03-10,03:00:00,17,5,12,FMN 08 Schijnpoortweg
675,Schijnpoortweg,2023-03-10,04:00:00,24,11,13,FMN 08 Schijnpoortweg
675,Schijnpoortweg,2023-03-10,05:00:00,46,8,38,FMN 08 Schijnpoortweg
675,Schijnpoortweg,2023-03-10,06:00:00,80,9,71,FMN 08 Schijnpoortweg
675,Schijnpoortweg,2023-03-10,07:00:00,189,16,173,FMN 08 Schijnpoortweg
675,Schijnpoortweg,2023-03-10,08:00:00,188,22,166,FMN 08 Schijnpoortweg
675,Schijnpoortweg,2023-03-10,09:00:00,73,8,65,FMN 08 Schijnpoortweg
675,Schijnpoortweg,2023-03-10,10:00:00,69,9,60,FMN 08 Schijnpoortweg
675,Schijnpoortweg,2023-03-10,11:00:00,88,16,72,FMN 08 Schijnpoortweg
675,Schijnpoortweg,2023-03-10,12:00:00,130,15,115,FMN 08 Schijnpoortweg
675,Schijnpoortweg,2023-03-10,13:00:00,111,14,97,FMN 08 Schijnpoortweg
675,Schijnpoortweg,2023-03-10,14:00:00,160,16,144,FMN 08 Schijnpoortweg
675,Schijnpoortweg,2023-03-10,15:00:00,206,17,189,FMN 08 Schijnpoortweg
675,Schijnpoortweg,2023-03-10,16:00:00,280,17,263,FMN 08 Schijnpoortweg
675,Schijnpoortweg,2023-03-10,17:00:00,222,28,194,FMN 08 Schijnpoortweg
675,Schijnpoortweg,2023-03-10,18:00:00,200,25,175,FMN 08 Schijnpoortweg
675,Schijnpoortweg,2023-03-10,19:00:00,218,33,185,FMN 08 Schijnpoortweg
675,Schijnpoortweg,2023-03-10,20:00:00,215,23,192,FMN 08 Schijnpoortweg
675,Schijnpoortweg,2023-03-10,21:00:00,91,10,81,FMN 08 Schijnpoortweg
675,Schijnpoortweg,2023-03-10,22:00:00,128,58,70,FMN 08 Schijnpoortweg
675,Schijnpoortweg,2023-03-10,23:00:00,124,74,50,FMN 08 Schijnpoortweg
675,Schijnpoortweg,2023-03-11,00:00:00,62,13,49,FMN 08 Schijnpoortweg
675,Schijnpoortweg,2023-03-11,01:00:00,31,3,28,FMN 08 Schijnpoortweg
675,Schijnpoortweg,2023-03-11,02:00:00,25,4,21,FMN 08 Schijnpoortweg
675,Schijnpoortweg,2023-03-11,03:00:00,19,3,16,FMN 08 Schijnpoortweg
675,Schijnpoortweg,2023-03-11,04:00:00,30,7,23,FMN 08 Schijnpoortweg
675,Schijnpoortweg,2023-03-11,05:00:00,22,6,16,FMN 08 Schijnpoortweg
675,Schijnpoortweg,2023-03-11,06:00:00,16,3,13,FMN 08 Schijnpoortweg
675,Schijnpoortweg,2023-03-11,07:00:00,34,10,24,FMN 08 Schijnpoortweg
675,Schijnpoortweg,2023-03-11,08:00:00,51,8,43,FMN 08 Schijnpoortweg
675,Schijnpoortweg,2023-03-11,09:00:00,82,14,68,FMN 08 Schijnpoortweg
675,Schijnpoortweg,2023-03-11,10:00:00,101,10,91,FMN 08 Schijnpoortweg
675,Schijnpoortweg,2023-03-11,11:00:00,104,15,89,FMN 08 Schijnpoortweg
675,Schijnpoortweg,2023-03-11,12:00:00,125,19,106,FMN 08 Schijnpoortweg
675,Schijnpoortweg,2023-03-11,13:00:00,128,22,106,FMN 08 Schijnpoortweg
675,Schijnpoortweg,2023-03-11,14:00:00,125,15,110,FMN 08 Schijnpoortweg
675,Schijnpoortweg,2023-03-11,15:00:00,132,13,119,FMN 08 Schijnpoortweg
675,Schijnpoortweg,2023-03-11,16:00:00,158,23,135,FMN 08 Schijnpoortweg
675,Schijnpoortweg,2023-03-11,17:00:00,169,16,153,FMN 08 Schijnpoortweg
675,Schijnpoortweg,2023-03-11,18:00:00,147,30,117,FMN 08 Schijnpoortweg
675,Schijnpoortweg,2023-03-11,19:00:00,254,35,219,FMN 08 Schijnpoortweg
675,Schijnpoortweg,2023-03-11,20:00:00,213,37,176,FMN 08 Schijnpoortweg
675,Schijnpoortweg,2023-03-11,21:00:00,128,28,100,FMN 08 Schijnpoortweg
675,Schijnpoortweg,2023-03-11,22:00:00,181,46,135,FMN 08 Schijnpoortweg
675,Schijnpoortweg,2023-03-11,23:00:00,290,153,137,FMN 08 Schijnpoortweg
675,Schijnpoortweg,2023-03-12,00:00:00,80,9,71,FMN 08 Schijnpoortweg
675,Schijnpoortweg,2023-03-12,01:00:00,29,4,25,FMN 08 Schijnpoortweg
675,Schijnpoortweg,2023-03-12,02:00:00,31,6,25,FMN 08 Schijnpoortweg
675,Schijnpoortweg,2023-03-12,03:00:00,26,8,18,FMN 08 Schijnpoortweg
675,Schijnpoortweg,2023-03-12,04:00:00,34,20,14,FMN 08 Schijnpoortweg
675,Schijnpoortweg,2023-03-12,05:00:00,26,17,9,FMN 08 Schijnpoortweg
675,Schijnpoortweg,2023-03-12,06:00:00,46,24,22,FMN 08 Schijnpoortweg
675,Schijnpoortweg,2023-03-12,07:00:00,16,0,16,FMN 08 Schijnpoortweg
675,Schijnpoortweg,2023-03-12,08:00:00,29,10,19,FMN 08 Schijnpoortweg
675,Schijnpoortweg,2023-03-12,09:00:00,43,12,31,FMN 08 Schijnpoortweg
675,Schijnpoortweg,2023-03-12,10:00:00,56,4,52,FMN 08 Schijnpoortweg
675,Schijnpoortweg,2023-03-12,11:00:00,79,15,64,FMN 08 Schijnpoortweg
675,Schijnpoortweg,2023-03-12,12:00:00,91,15,76,FMN 08 Schijnpoortweg
675,Schijnpoortweg,2023-03-12,13:00:00,101,15,86,FMN 08 Schijnpoortweg
675,Schijnpoortweg,2023-03-12,14:00:00,108,24,84,FMN 08 Schijnpoortweg
675,Schijnpoortweg,2023-03-12,15:00:00,111,20,91,FMN 08 Schijnpoortweg
675,Schijnpoortweg,2023-03-12,16:00:00,102,19,83,FMN 08 Schijnpoortweg
675,Schijnpoortweg,2023-03-12,17:00:00,130,15,115,FMN 08 Schijnpoortweg
675,Schijnpoortweg,2023-03-12,18:00:00,117,19,98,FMN 08 Schijnpoortweg
675,Schijnpoortweg,2023-03-12,19:00:00,117,10,107,FMN 08 Schijnpoortweg
675,Schijnpoortweg,2023-03-12,20:00:00,78,5,73,FMN 08 Schijnpoortweg
675,Schijnpoortweg,2023-03-12,21:00:00,67,7,60,FMN 08 Schijnpoortweg
675,Schijnpoortweg,2023-03-12,22:00:00,71,7,64,FMN 08 Schijnpoortweg
675,Schijnpoortweg,2023-03-12,23:00:00,45,6,39,FMN 08 Schijnpoortweg
675,Schijnpoortweg,2023-03-13,00:00:00,26,2,24,FMN 08 Schijnpoortweg
675,Schijnpoortweg,2023-03-13,01:00:00,14,6,8,FMN 08 Schijnpoortweg
675,Schijnpoortweg,2023-03-13,02:00:00,9,1,8,FMN 08 Schijnpoortweg
675,Schijnpoortweg,2023-03-13,03:00:00,10,1,9,FMN 08 Schijnpoortweg
675,Schijnpoortweg,2023-03-13,04:00:00,21,9,12,FMN 08 Schijnpoortweg
675,Schijnpoortweg,2023-03-13,05:00:00,67,13,54,FMN 08 Schijnpoortweg
675,Schijnpoortweg,2023-03-13,06:00:00,78,19,59,FMN 08 Schijnpoortweg
675,Schijnpoortweg,2023-03-13,07:00:00,180,17,163,FMN 08 Schijnpoortweg
675,Schijnpoortweg,2023-03-13,08:00:00,194,25,169,FMN 08 Schijnpoortweg
675,Schijnpoortweg,2023-03-13,09:00:00,92,20,72,FMN 08 Schijnpoortweg
675,Schijnpoortweg,2023-03-13,10:00:00,88,18,70,FMN 08 Schijnpoortweg
675,Schijnpoortweg,2023-03-13,11:00:00,79,11,68,FMN 08 Schijnpoortweg
675,Schijnpoortweg,2023-03-13,12:00:00,123,10,113,FMN 08 Schijnpoortweg
675,Schijnpoortweg,2023-03-13,13:00:00,108,16,92,FMN 08 Schijnpoortweg
675,Schijnpoortweg,2023-03-13,14:00:00,125,18,107,FMN 08 Schijnpoortweg
675,Schijnpoortweg,2023-03-13,15:00:00,191,18,173,FMN 08 Schijnpoortweg
675,Schijnpoortweg,2023-03-13,16:00:00,314,24,290,FMN 08 Schijnpoortweg
675,Schijnpoortweg,2023-03-13,17:00:00,309,17,292,FMN 08 Schijnpoortweg
675,Schijnpoortweg,2023-03-13,18:00:00,194,15,179,FMN 08 Schijnpoortweg
675,Schijnpoortweg,2023-03-13,19:00:00,163,16,147,FMN 08 Schijnpoortweg
675,Schijnpoortweg,2023-03-13,20:00:00,115,13,102,FMN 08 Schijnpoortweg
675,Schijnpoortweg,2023-03-13,21:00:00,137,25,112,FMN 08 Schijnpoortweg
675,Schijnpoortweg,2023-03-13,22:00:00,88,8,80,FMN 08 Schijnpoortweg
675,Schijnpoortweg,2023-03-13,23:00:00,49,5,44,FMN 08 Schijnpoortweg
675,Schijnpoortweg,2023-03-14,00:00:00,25,5,20,FMN 08 Schijnpoortweg
675,Schijnpoortweg,2023-03-14,01:00:00,20,7,13,FMN 08 Schijnpoortweg
675,Schijnpoortweg,2023-03-14,02:00:00,14,5,9,FMN 08 Schijnpoortweg
675,Schijnpoortweg,2023-03-14,03:00:00,8,1,7,FMN 08 Schijnpoortweg
675,Schijnpoortweg,2023-03-14,04:00:00,22,8,14,FMN 08 Schijnpoortweg
675,Schijnpoortweg,2023-03-14,05:00:00,45,5,40,FMN 08 Schijnpoortweg
675,Schijnpoortweg,2023-03-14,06:00:00,89,17,72,FMN 08 Schijnpoortweg
675,Schijnpoortweg,2023-03-14,07:00:00,171,17,154,FMN 08 Schijnpoortweg
675,Schijnpoortweg,2023-03-14,08:00:00,160,33,127,FMN 08 Schijnpoortweg
675,Schijnpoortweg,2023-03-14,09:00:00,99,23,76,FMN 08 Schijnpoortweg
675,Schijnpoortweg,2023-03-14,10:00:00,48,11,37,FMN 08 Schijnpoortweg
675,Schijnpoortweg,2023-03-14,11:00:00,67,10,57,FMN 08 Schijnpoortweg
675,Schijnpoortweg,2023-03-14,12:00:00,104,9,95,FMN 08 Schijnpoortweg
675,Schijnpoortweg,2023-03-14,13:00:00,92,15,77,FMN 08 Schijnpoortweg
675,Schijnpoortweg,2023-03-14,14:00:00,121,13,108,FMN 08 Schijnpoortweg
675,Schijnpoortweg,2023-03-14,15:00:00,195,20,175,FMN 08 Schijnpoortweg
675,Schijnpoortweg,2023-03-14,16:00:00,286,28,258,FMN 08 Schijnpoortweg
675,Schijnpoortweg,2023-03-14,17:00:00,296,27,269,FMN 08 Schijnpoortweg
675,Schijnpoortweg,2023-03-14,18:00:00,204,15,189,FMN 08 Schijnpoortweg
675,Schijnpoortweg,2023-03-14,19:00:00,162,14,148,FMN 08 Schijnpoortweg
675,Schijnpoortweg,2023-03-14,20:00:00,109,9,100,FMN 08 Schijnpoortweg
675,Schijnpoortweg,2023-03-14,21:00:00,90,8,82,FMN 08 Schijnpoortweg
675,Schijnpoortweg,2023-03-14,22:00:00,101,11,90,FMN 08 Schijnpoortweg
675,Schijnpoortweg,2023-03-14,23:00:00,66,8,58,FMN 08 Schijnpoortweg
675,Schijnpoortweg,2023-03-15,00:00:00,24,4,20,FMN 08 Schijnpoortweg
675,Schijnpoortweg,2023-03-15,01:00:00,13,3,10,FMN 08 Schijnpoortweg
675,Schijnpoortweg,2023-03-15,02:00:00,10,3,7,FMN 08 Schijnpoortweg
675,Schijnpoortweg,2023-03-15,03:00:00,9,2,7,FMN 08 Schijnpoortweg
675,Schijnpoortweg,2023-03-15,04:00:00,28,13,15,FMN 08 Schijnpoortweg
675,Schijnpoortweg,2023-03-15,05:00:00,60,10,50,FMN 08 Schijnpoortweg
675,Schijnpoortweg,2023-03-15,06:00:00,73,10,63,FMN 08 Schijnpoortweg
675,Schijnpoortweg,2023-03-15,07:00:00,177,18,159,FMN 08 Schijnpoortweg
675,Schijnpoortweg,2023-03-15,08:00:00,218,28,190,FMN 08 Schijnpoortweg
675,Schijnpoortweg,2023-03-15,09:00:00,97,14,83,FMN 08 Schijnpoortweg
675,Schijnpoortweg,2023-03-15,10:00:00,95,8,87,FMN 08 Schijnpoortweg
675,Schijnpoortweg,2023-03-15,11:00:00,88,7,81,FMN 08 Schijnpoortweg
675,Schijnpoortweg,2023-03-15,12:00:00,218,14,204,FMN 08 Schijnpoortweg
675,Schijnpoortweg,2023-03-15,13:00:00,154,14,140,FMN 08 Schijnpoortweg
675,Schijnpoortweg,2023-03-15,14:00:00,163,24,139,FMN 08 Schijnpoortweg
675,Schijnpoortweg,2023-03-15,15:00:00,198,22,176,FMN 08 Schijnpoortweg
675,Schijnpoortweg,2023-03-15,16:00:00,244,16,228,FMN 08 Schijnpoortweg
675,Schijnpoortweg,2023-03-15,17:00:00,279,17,262,FMN 08 Schijnpoortweg
675,Schijnpoortweg,2023-03-15,18:00:00,193,23,170,FMN 08 Schijnpoortweg
675,Schijnpoortweg,2023-03-15,19:00:00,144,12,132,FMN 08 Schijnpoortweg
675,Schijnpoortweg,2023-03-15,20:00:00,114,7,107,FMN 08 Schijnpoortweg
675,Schijnpoortweg,2023-03-15,21:00:00,108,7,101,FMN 08 Schijnpoortweg
675,Schijnpoortweg,2023-03-15,22:00:00,94,10,84,FMN 08 Schijnpoortweg
675,Schijnpoortweg,2023-03-15,23:00:00,71,7,64,FMN 08 Schijnpoortweg
675,Schijnpoortweg,2023-03-16,00:00:00,27,3,24,FMN 08 Schijnpoortweg
675,Schijnpoortweg,2023-03-16,01:00:00,17,3,14,FMN 08 Schijnpoortweg
675,Schijnpoortweg,2023-03-16,02:00:00,16,3,13,FMN 08 Schijnpoortweg
675,Schijnpoortweg,2023-03-16,03:00:00,13,5,8,FMN 08 Schijnpoortweg
675,Schijnpoortweg,2023-03-16,04:00:00,26,10,16,FMN 08 Schijnpoortweg
675,Schijnpoortweg,2023-03-16,05:00:00,51,9,42,FMN 08 Schijnpoortweg
675,Schijnpoortweg,2023-03-16,06:00:00,70,6,64,FMN 08 Schijnpoortweg
675,Schijnpoortweg,2023-03-16,07:00:00,174,20,154,FMN 08 Schijnpoortweg
675,Schijnpoortweg,2023-03-16,08:00:00,228,28,200,FMN 08 Schijnpoortweg
675,Schijnpoortweg,2023-03-16,09:00:00,114,17,97,FMN 08 Schijnpoortweg
675,Schijnpoortweg,2023-03-16,10:00:00,75,17,58,FMN 08 Schijnpoortweg
675,Schijnpoortweg,2023-03-16,11:00:00,88,7,81,FMN 08 Schijnpoortweg
675,Schijnpoortweg,2023-03-16,12:00:00,148,14,134,FMN 08 Schijnpoortweg
675,Schijnpoortweg,2023-03-16,13:00:00,112,17,95,FMN 08 Schijnpoortweg
675,Schijnpoortweg,2023-03-16,14:00:00,156,16,140,FMN 08 Schijnpoortweg
675,Schijnpoortweg,2023-03-16,15:00:00,246,12,234,FMN 08 Schijnpoortweg
675,Schijnpoortweg,2023-03-16,16:00:00,316,26,290,FMN 08 Schijnpoortweg
675,Schijnpoortweg,2023-03-16,17:00:00,333,27,306,FMN 08 Schijnpoortweg
675,Schijnpoortweg,2023-03-16,18:00:00,213,22,191,FMN 08 Schijnpoortweg
675,Schijnpoortweg,2023-03-16,19:00:00,183,10,173,FMN 08 Schijnpoortweg
675,Schijnpoortweg,2023-03-16,20:00:00,131,17,114,FMN 08 Schijnpoortweg
675,Schijnpoortweg,2023-03-16,21:00:00,110,10,100,FMN 08 Schijnpoortweg
675,Schijnpoortweg,2023-03-16,22:00:00,116,8,108,FMN 08 Schijnpoortweg
675,Schijnpoortweg,2023-03-16,23:00:00,70,6,64,FMN 08 Schijnpoortweg
675,Schijnpoortweg,2023-03-17,00:00:00,38,4,34,FMN 08 Schijnpoortweg
675,Schijnpoortweg,2023-03-17,01:00:00,18,6,12,FMN 08 Schijnpoortweg
675,Schijnpoortweg,2023-03-17,02:00:00,22,4,18,FMN 08 Schijnpoortweg
675,Schijnpoortweg,2023-03-17,03:00:00,11,4,7,FMN 08 Schijnpoortweg
675,Schijnpoortweg,2023-03-17,04:00:00,21,9,12,FMN 08 Schijnpoortweg
675,Schijnpoortweg,2023-03-17,05:00:00,46,4,42,FMN 08 Schijnpoortweg
675,Schijnpoortweg,2023-03-17,06:00:00,79,10,69,FMN 08 Schijnpoortweg
675,Schijnpoortweg,2023-03-17,07:00:00,169,11,158,FMN 08 Schijnpoortweg
675,Schijnpoortweg,2023-03-17,08:00:00,208,28,180,FMN 08 Schijnpoortweg
675,Schijnpoortweg,2023-03-17,09:00:00,78,10,68,FMN 08 Schijnpoortweg
675,Schijnpoortweg,2023-03-17,10:00:00,100,10,90,FMN 08 Schijnpoortweg
675,Schijnpoortweg,2023-03-17,11:00:00,97,14,83,FMN 08 Schijnpoortweg
675,Schijnpoortweg,2023-03-17,12:00:00,158,23,135,FMN 08 Schijnpoortweg
675,Schijnpoortweg,2023-03-17,13:00:00,132,19,113,FMN 08 Schijnpoortweg
675,Schijnpoortweg,2023-03-17,14:00:00,188,20,168,FMN 08 Schijnpoortweg
675,Schijnpoortweg,2023-03-17,15:00:00,252,23,229,FMN 08 Schijnpoortweg
675,Schijnpoortweg,2023-03-17,16:00:00,318,26,292,FMN 08 Schijnpoortweg
675,Schijnpoortweg,2023-03-17,17:00:00,291,31,260,FMN 08 Schijnpoortweg
675,Schijnpoortweg,2023-03-17,18:00:00,214,27,187,FMN 08 Schijnpoortweg
675,Schijnpoortweg,2023-03-17,19:00:00,161,16,145,FMN 08 Schijnpoortweg
675,Schijnpoortweg,2023-03-17,20:00:00,117,21,96,FMN 08 Schijnpoortweg
675,Schijnpoortweg,2023-03-17,21:00:00,122,13,109,FMN 08 Schijnpoortweg
675,Schijnpoortweg,2023-03-17,22:00:00,100,13,87,FMN 08 Schijnpoortweg
675,Schijnpoortweg,2023-03-17,23:00:00,86,14,72,FMN 08 Schijnpoortweg
675,Schijnpoortweg,2023-03-18,00:00:00,72,11,61,FMN 08 Schijnpoortweg
675,Schijnpoortweg,2023-03-18,01:00:00,35,2,33,FMN 08 Schijnpoortweg
675,Schijnpoortweg,2023-03-18,02:00:00,18,1,17,FMN 08 Schijnpoortweg
675,Schijnpoortweg,2023-03-18,03:00:00,22,2,20,FMN 08 Schijnpoortweg
675,Schijnpoortweg,2023-03-18,04:00:00,24,8,16,FMN 08 Schijnpoortweg
675,Schijnpoortweg,2023-03-18,05:00:00,27,9,18,FMN 08 Schijnpoortweg
675,Schijnpoortweg,2023-03-18,06:00:00,21,3,18,FMN 08 Schijnpoortweg
675,Schijnpoortweg,2023-03-18,07:00:00,28,2,26,FMN 08 Schijnpoortweg
675,Schijnpoortweg,2023-03-18,08:00:00,65,8,57,FMN 08 Schijnpoortweg
675,Schijnpoortweg,2023-03-18,09:00:00,91,9,82,FMN 08 Schijnpoortweg
675,Schijnpoortweg,2023-03-18,10:00:00,97,10,87,FMN 08 Schijnpoortweg
675,Schijnpoortweg,2023-03-18,11:00:00,112,15,97,FMN 08 Schijnpoortweg
675,Schijnpoortweg,2023-03-18,12:00:00,140,10,130,FMN 08 Schijnpoortweg
675,Schijnpoortweg,2023-03-18,13:00:00,128,8,120,FMN 08 Schijnpoortweg
675,Schijnpoortweg,2023-03-18,14:00:00,122,14,108,FMN 08 Schijnpoortweg
675,Schijnpoortweg,2023-03-18,15:00:00,147,9,138,FMN 08 Schijnpoortweg
675,Schijnpoortweg,2023-03-18,16:00:00,156,16,140,FMN 08 Schijnpoortweg
675,Schijnpoortweg,2023-03-18,17:00:00,175,24,151,FMN 08 Schijnpoortweg
675,Schijnpoortweg,2023-03-18,18:00:00,125,18,107,FMN 08 Schijnpoortweg
675,Schijnpoortweg,2023-03-18,19:00:00,90,4,86,FMN 08 Schijnpoortweg
675,Schijnpoortweg,2023-03-18,20:00:00,78,13,65,FMN 08 Schijnpoortweg
675,Schijnpoortweg,2023-03-18,21:00:00,70,10,60,FMN 08 Schijnpoortweg
675,Schijnpoortweg,2023-03-18,22:00:00,55,11,44,FMN 08 Schijnpoortweg
675,Schijnpoortweg,2023-03-18,23:00:00,66,5,61,FMN 08 Schijnpoortweg
675,Schijnpoortweg,2023-03-19,00:00:00,59,6,53,FMN 08 Schijnpoortweg
675,Schijnpoortweg,2023-03-19,01:00:00,30,4,26,FMN 08 Schijnpoortweg
675,Schijnpoortweg,2023-03-19,02:00:00,30,7,23,FMN 08 Schijnpoortweg
675,Schijnpoortweg,2023-03-19,03:00:00,16,2,14,FMN 08 Schijnpoortweg
675,Schijnpoortweg,2023-03-19,04:00:00,21,8,13,FMN 08 Schijnpoortweg
675,Schijnpoortweg,2023-03-19,05:00:00,12,3,9,FMN 08 Schijnpoortweg
675,Schijnpoortweg,2023-03-19,06:00:00,24,5,19,FMN 08 Schijnpoortweg
675,Schijnpoortweg,2023-03-19,07:00:00,20,2,18,FMN 08 Schijnpoortweg
675,Schijnpoortweg,2023-03-19,08:00:00,40,8,32,FMN 08 Schijnpoortweg
675,Schijnpoortweg,2023-03-19,09:00:00,79,11,68,FMN 08 Schijnpoortweg
675,Schijnpoortweg,2023-03-19,10:00:00,106,18,88,FMN 08 Schijnpoortweg
675,Schijnpoortweg,2023-03-19,11:00:00,121,18,103,FMN 08 Schijnpoortweg
675,Schijnpoortweg,2023-03-19,12:00:00,184,18,166,FMN 08 Schijnpoortweg
675,Schijnpoortweg,2023-03-19,13:00:00,193,33,160,FMN 08 Schijnpoortweg
675,Schijnpoortweg,2023-03-19,14:00:00,137,19,118,FMN 08 Schijnpoortweg
675,Schijnpoortweg,2023-03-19,15:00:00,137,29,108,FMN 08 Schijnpoortweg
675,Schijnpoortweg,2023-03-19,16:00:00,166,23,143,FMN 08 Schijnpoortweg
675,Schijnpoortweg,2023-03-19,17:00:00,264,111,153,FMN 08 Schijnpoortweg
675,Schijnpoortweg,2023-03-19,18:00:00,171,45,126,FMN 08 Schijnpoortweg
675,Schijnpoortweg,2023-03-19,19:00:00,298,45,253,FMN 08 Schijnpoortweg
675,Schijnpoortweg,2023-03-19,20:00:00,177,36,141,FMN 08 Schijnpoortweg
675,Schijnpoortweg,2023-03-19,21:00:00,77,12,65,FMN 08 Schijnpoortweg
675,Schijnpoortweg,2023-03-19,22:00:00,116,47,69,FMN 08 Schijnpoortweg
675,Schijnpoortweg,2023-03-19,23:00:00,141,91,50,FMN 08 Schijnpoortweg
675,Schijnpoortweg,2023-03-20,00:00:00,23,5,18,FMN 08 Schijnpoortweg
675,Schijnpoortweg,2023-03-20,01:00:00,24,5,19,FMN 08 Schijnpoortweg
675,Schijnpoortweg,2023-03-20,02:00:00,15,4,11,FMN 08 Schijnpoortweg
675,Schijnpoortweg,2023-03-20,03:00:00,17,6,11,FMN 08 Schijnpoortweg
675,Schijnpoortweg,2023-03-20,04:00:00,26,7,19,FMN 08 Schijnpoortweg
675,Schijnpoortweg,2023-03-20,05:00:00,67,12,55,FMN 08 Schijnpoortweg
675,Schijnpoortweg,2023-03-20,06:00:00,76,11,65,FMN 08 Schijnpoortweg
675,Schijnpoortweg,2023-03-20,07:00:00,184,18,166,FMN 08 Schijnpoortweg
675,Schijnpoortweg,2023-03-20,08:00:00,241,35,206,FMN 08 Schijnpoortweg
675,Schijnpoortweg,2023-03-20,09:00:00,84,12,72,FMN 08 Schijnpoortweg
675,Schijnpoortweg,2023-03-20,10:00:00,57,10,47,FMN 08 Schijnpoortweg
675,Schijnpoortweg,2023-03-20,11:00:00,77,9,68,FMN 08 Schijnpoortweg
675,Schijnpoortweg,2023-03-20,12:00:00,135,18,117,FMN 08 Schijnpoortweg
675,Schijnpoortweg,2023-03-20,13:00:00,114,11,103,FMN 08 Schijnpoortweg
675,Schijnpoortweg,2023-03-20,14:00:00,130,9,121,FMN 08 Schijnpoortweg
675,Schijnpoortweg,2023-03-20,15:00:00,235,12,223,FMN 08 Schijnpoortweg
675,Schijnpoortweg,2023-03-20,16:00:00,287,33,254,FMN 08 Schijnpoortweg
675,Schijnpoortweg,2023-03-20,17:00:00,316,34,282,FMN 08 Schijnpoortweg
675,Schijnpoortweg,2023-03-20,18:00:00,188,13,175,FMN 08 Schijnpoortweg
675,Schijnpoortweg,2023-03-20,19:00:00,145,12,133,FMN 08 Schijnpoortweg
675,Schijnpoortweg,2023-03-20,20:00:00,98,14,84,FMN 08 Schijnpoortweg
675,Schijnpoortweg,2023-03-20,21:00:00,104,16,88,FMN 08 Schijnpoortweg
675,Schijnpoortweg,2023-03-20,22:00:00,106,8,98,FMN 08 Schijnpoortweg
675,Schijnpoortweg,2023-03-20,23:00:00,35,4,31,FMN 08 Schijnpoortweg
675,Schijnpoortweg,2023-03-21,00:00:00,33,7,26,FMN 08 Schijnpoortweg
675,Schijnpoortweg,2023-03-21,01:00:00,17,1,16,FMN 08 Schijnpoortweg
675,Schijnpoortweg,2023-03-21,02:00:00,16,3,13,FMN 08 Schijnpoortweg
675,Schijnpoortweg,2023-03-21,03:00:00,12,4,8,FMN 08 Schijnpoortweg
675,Schijnpoortweg,2023-03-21,04:00:00,32,18,14,FMN 08 Schijnpoortweg
675,Schijnpoortweg,2023-03-21,05:00:00,62,11,51,FMN 08 Schijnpoortweg
675,Schijnpoortweg,2023-03-21,06:00:00,80,15,65,FMN 08 Schijnpoortweg
675,Schijnpoortweg,2023-03-21,07:00:00,170,16,154,FMN 08 Schijnpoortweg
675,Schijnpoortweg,2023-03-21,08:00:00,219,24,195,FMN 08 Schijnpoortweg
675,Schijnpoortweg,2023-03-21,09:00:00,103,15,88,FMN 08 Schijnpoortweg
675,Schijnpoortweg,2023-03-21,10:00:00,94,31,63,FMN 08 Schijnpoortweg
675,Schijnpoortweg,2023-03-21,11:00:00,95,9,86,FMN 08 Schijnpoortweg
675,Schijnpoortweg,2023-03-21,12:00:00,123,13,110,FMN 08 Schijnpoortweg
675,Schijnpoortweg,2023-03-21,13:00:00,121,14,107,FMN 08 Schijnpoortweg
675,Schijnpoortweg,2023-03-21,14:00:00,163,20,143,FMN 08 Schijnpoortweg
675,Schijnpoortweg,2023-03-21,15:00:00,233,19,214,FMN 08 Schijnpoortweg
675,Schijnpoortweg,2023-03-21,16:00:00,319,25,294,FMN 08 Schijnpoortweg
675,Schijnpoortweg,2023-03-21,17:00:00,291,19,272,FMN 08 Schijnpoortweg
675,Schijnpoortweg,2023-03-21,18:00:00,219,18,201,FMN 08 Schijnpoortweg
675,Schijnpoortweg,2023-03-21,19:00:00,190,18,172,FMN 08 Schijnpoortweg
675,Schijnpoortweg,2023-03-21,20:00:00,131,13,118,FMN 08 Schijnpoortweg
675,Schijnpoortweg,2023-03-21,21:00:00,101,16,85,FMN 08 Schijnpoortweg
675,Schijnpoortweg,2023-03-21,22:00:00,99,11,88,FMN 08 Schijnpoortweg
675,Schijnpoortweg,2023-03-21,23:00:00,60,2,58,FMN 08 Schijnpoortweg
675,Schijnpoortweg,2023-03-22,00:00:00,33,4,29,FMN 08 Schijnpoortweg
675,Schijnpoortweg,2023-03-22,01:00:00,10,2,8,FMN 08 Schijnpoortweg
675,Schijnpoortweg,2023-03-22,02:00:00,17,3,14,FMN 08 Schijnpoortweg
675,Schijnpoortweg,2023-03-22,03:00:00,15,5,10,FMN 08 Schijnpoortweg
675,Schijnpoortweg,2023-03-22,04:00:00,28,12,16,FMN 08 Schijnpoortweg
675,Schijnpoortweg,2023-03-22,05:00:00,57,11,46,FMN 08 Schijnpoortweg
675,Schijnpoortweg,2023-03-22,06:00:00,83,14,69,FMN 08 Schijnpoortweg
675,Schijnpoortweg,2023-03-22,07:00:00,182,18,164,FMN 08 Schijnpoortweg
675,Schijnpoortweg,2023-03-22,08:00:00,251,37,214,FMN 08 Schijnpoortweg
675,Schijnpoortweg,2023-03-22,09:00:00,101,12,89,FMN 08 Schijnpoortweg
675,Schijnpoortweg,2023-03-22,10:00:00,72,11,61,FMN 08 Schijnpoortweg
675,Schijnpoortweg,2023-03-22,11:00:00,98,12,86,FMN 08 Schijnpoortweg
675,Schijnpoortweg,2023-03-22,12:00:00,230,16,214,FMN 08 Schijnpoortweg
675,Schijnpoortweg,2023-03-22,13:00:00,137,8,129,FMN 08 Schijnpoortweg
675,Schijnpoortweg,2023-03-22,14:00:00,142,12,130,FMN 08 Schijnpoortweg
675,Schijnpoortweg,2023-03-22,15:00:00,178,16,162,FMN 08 Schijnpoortweg
675,Schijnpoortweg,2023-03-22,16:00:00,242,21,221,FMN 08 Schijnpoortweg
675,Schijnpoortweg,2023-03-22,17:00:00,222,15,207,FMN 08 Schijnpoortweg
675,Schijnpoortweg,2023-03-22,18:00:00,181,28,153,FMN 08 Schijnpoortweg
675,Schijnpoortweg,2023-03-22,19:00:00,126,12,114,FMN 08 Schijnpoortweg
675,Schijnpoortweg,2023-03-22,20:00:00,123,5,118,FMN 08 Schijnpoortweg
675,Schijnpoortweg,2023-03-22,21:00:00,95,9,86,FMN 08 Schijnpoortweg
675,Schijnpoortweg,2023-03-22,22:00:00,99,11,88,FMN 08 Schijnpoortweg
675,Schijnpoortweg,2023-03-22,23:00:00,60,12,48,FMN 08 Schijnpoortweg
675,Schijnpoortweg,2023-03-23,00:00:00,20,1,19,FMN 08 Schijnpoortweg
675,Schijnpoortweg,2023-03-23,01:00:00,20,5,15,FMN 08 Schijnpoortweg
675,Schijnpoortweg,2023-03-23,02:00:00,14,2,12,FMN 08 Schijnpoortweg
675,Schijnpoortweg,2023-03-23,03:00:00,19,7,12,FMN 08 Schijnpoortweg
675,Schijnpoortweg,2023-03-23,04:00:00,24,11,13,FMN 08 Schijnpoortweg
675,Schijnpoortweg,2023-03-23,05:00:00,63,13,50,FMN 08 Schijnpoortweg
675,Schijnpoortweg,2023-03-23,06:00:00,77,14,63,FMN 08 Schijnpoortweg
675,Schijnpoortweg,2023-03-23,07:00:00,161,10,151,FMN 08 Schijnpoortweg
675,Schijnpoortweg,2023-03-23,08:00:00,184,17,167,FMN 08 Schijnpoortweg
675,Schijnpoortweg,2023-03-23,09:00:00,69,8,61,FMN 08 Schijnpoortweg
675,Schijnpoortweg,2023-03-23,10:00:00,68,14,54,FMN 08 Schijnpoortweg
675,Schijnpoortweg,2023-03-23,11:00:00,94,10,84,FMN 08 Schijnpoortweg
675,Schijnpoortweg,2023-03-23,12:00:00,128,12,116,FMN 08 Schijnpoortweg
675,Schijnpoortweg,2023-03-23,13:00:00,93,12,81,FMN 08 Schijnpoortweg
675,Schijnpoortweg,2023-03-23,14:00:00,134,15,119,FMN 08 Schijnpoortweg
675,Schijnpoortweg,2023-03-23,15:00:00,228,20,208,FMN 08 Schijnpoortweg
675,Schijnpoortweg,2023-03-23,16:00:00,291,41,250,FMN 08 Schijnpoortweg
675,Schijnpoortweg,2023-03-23,17:00:00,328,29,299,FMN 08 Schijnpoortweg
675,Schijnpoortweg,2023-03-23,18:00:00,304,56,248,FMN 08 Schijnpoortweg
675,Schijnpoortweg,2023-03-23,19:00:00,207,33,174,FMN 08 Schijnpoortweg
675,Schijnpoortweg,2023-03-23,20:00:00,109,18,91,FMN 08 Schijnpoortweg
675,Schijnpoortweg,2023-03-23,21:00:00,82,9,73,FMN 08 Schijnpoortweg
675,Schijnpoortweg,2023-03-23,22:00:00,157,68,89,FMN 08 Schijnpoortweg
675,Schijnpoortweg,2023-03-23,23:00:00,63,9,54,FMN 08 Schijnpoortweg
675,Schijnpoortweg,2023-03-24,00:00:00,36,5,31,FMN 08 Schijnpoortweg
675,Schijnpoortweg,2023-03-24,01:00:00,27,6,21,FMN 08 Schijnpoortweg
675,Schijnpoortweg,2023-03-24,02:00:00,24,6,18,FMN 08 Schijnpoortweg
675,Schijnpoortweg,2023-03-24,03:00:00,19,3,16,FMN 08 Schijnpoortweg
675,Schijnpoortweg,2023-03-24,04:00:00,31,16,15,FMN 08 Schijnpoortweg
675,Schijnpoortweg,2023-03-24,05:00:00,69,18,51,FMN 08 Schijnpoortweg
675,Schijnpoortweg,2023-03-24,06:00:00,85,20,65,FMN 08 Schijnpoortweg
675,Schijnpoortweg,2023-03-24,07:00:00,173,24,149,FMN 08 Schijnpoortweg
675,Schijnpoortweg,2023-03-24,08:00:00,210,36,174,FMN 08 Schijnpoortweg
675,Schijnpoortweg,2023-03-24,09:00:00,97,16,81,FMN 08 Schijnpoortweg
675,Schijnpoortweg,2023-03-24,10:00:00,105,16,89,FMN 08 Schijnpoortweg
675,Schijnpoortweg,2023-03-24,11:00:00,96,10,86,FMN 08 Schijnpoortweg
675,Schijnpoortweg,2023-03-24,12:00:00,125,15,110,FMN 08 Schijnpoortweg
675,Schijnpoortweg,2023-03-24,13:00:00,143,20,123,FMN 08 Schijnpoortweg
675,Schijnpoortweg,2023-03-24,14:00:00,154,33,121,FMN 08 Schijnpoortweg
675,Schijnpoortweg,2023-03-24,15:00:00,232,39,193,FMN 08 Schijnpoortweg
675,Schijnpoortweg,2023-03-24,16:00:00,292,45,247,FMN 08 Schijnpoortweg
675,Schijnpoortweg,2023-03-24,17:00:00,277,35,242,FMN 08 Schijnpoortweg
675,Schijnpoortweg,2023-03-24,18:00:00,241,32,209,FMN 08 Schijnpoortweg
675,Schijnpoortweg,2023-03-24,19:00:00,141,26,115,FMN 08 Schijnpoortweg
675,Schijnpoortweg,2023-03-24,20:00:00,123,31,92,FMN 08 Schijnpoortweg
675,Schijnpoortweg,2023-03-24,21:00:00,91,13,78,FMN 08 Schijnpoortweg
675,Schijnpoortweg,2023-03-24,22:00:00,83,21,62,FMN 08 Schijnpoortweg
675,Schijnpoortweg,2023-03-24,23:00:00,73,12,61,FMN 08 Schijnpoortweg
675,Schijnpoortweg,2023-03-25,00:00:00,48,10,38,FMN 08 Schijnpoortweg
675,Schijnpoortweg,2023-03-25,01:00:00,37,11,26,FMN 08 Schijnpoortweg
675,Schijnpoortweg,2023-03-25,02:00:00,41,5,36,FMN 08 Schijnpoortweg
675,Schijnpoortweg,2023-03-25,03:00:00,22,4,18,FMN 08 Schijnpoortweg
675,Schijnpoortweg,2023-03-25,04:00:00,15,8,7,FMN 08 Schijnpoortweg
675,Schijnpoortweg,2023-03-25,05:00:00,19,7,12,FMN 08 Schijnpoortweg
675,Schijnpoortweg,2023-03-25,06:00:00,33,10,23,FMN 08 Schijnpoortweg
675,Schijnpoortweg,2023-03-25,07:00:00,38,3,35,FMN 08 Schijnpoortweg
675,Schijnpoortweg,2023-03-25,08:00:00,50,16,34,FMN 08 Schijnpoortweg
675,Schijnpoortweg,2023-03-25,09:00:00,87,16,71,FMN 08 Schijnpoortweg
675,Schijnpoortweg,2023-03-25,10:00:00,101,25,76,FMN 08 Schijnpoortweg
675,Schijnpoortweg,2023-03-25,11:00:00,111,17,94,FMN 08 Schijnpoortweg
675,Schijnpoortweg,2023-03-25,12:00:00,125,29,96,FMN 08 Schijnpoortweg
675,Schijnpoortweg,2023-03-25,13:00:00,154,42,112,FMN 08 Schijnpoortweg
675,Schijnpoortweg,2023-03-25,14:00:00,101,20,81,FMN 08 Schijnpoortweg
675,Schijnpoortweg,2023-03-25,15:00:00,141,35,106,FMN 08 Schijnpoortweg
675,Schijnpoortweg,2023-03-25,16:00:00,159,44,115,FMN 08 Schijnpoortweg
675,Schijnpoortweg,2023-03-25,17:00:00,193,61,132,FMN 08 Schijnpoortweg
675,Schijnpoortweg,2023-03-25,18:00:00,186,35,151,FMN 08 Schijnpoortweg
675,Schijnpoortweg,2023-03-25,19:00:00,149,29,120,FMN 08 Schijnpoortweg
675,Schijnpoortweg,2023-03-25,20:00:00,111,20,91,FMN 08 Schijnpoortweg
675,Schijnpoortweg,2023-03-25,21:00:00,121,41,80,FMN 08 Schijnpoortweg
675,Schijnpoortweg,2023-03-25,22:00:00,101,34,67,FMN 08 Schijnpoortweg
675,Schijnpoortweg,2023-03-25,23:00:00,74,15,59,FMN 08 Schijnpoortweg
675,Schijnpoortweg,2023-03-26,00:00:00,59,7,52,FMN 08 Schijnpoortweg
675,Schijnpoortweg,2023-03-26,01:00:00,55,3,52,FMN 08 Schijnpoortweg
675,Schijnpoortweg,2023-03-26,02:00:00,0,0,0,FMN 08 Schijnpoortweg
675,Schijnpoortweg,2023-03-26,03:00:00,51,6,45,FMN 08 Schijnpoortweg
675,Schijnpoortweg,2023-03-26,04:00:00,25,5,20,FMN 08 Schijnpoortweg
675,Schijnpoortweg,2023-03-26,05:00:00,15,4,11,FMN 08 Schijnpoortweg
675,Schijnpoortweg,2023-03-26,06:00:00,18,4,14,FMN 08 Schijnpoortweg
675,Schijnpoortweg,2023-03-26,07:00:00,15,2,13,FMN 08 Schijnpoortweg
675,Schijnpoortweg,2023-03-26,08:00:00,22,8,14,FMN 08 Schijnpoortweg
675,Schijnpoortweg,2023-03-26,09:00:00,22,5,17,FMN 08 Schijnpoortweg
675,Schijnpoortweg,2023-03-26,10:00:00,38,10,28,FMN 08 Schijnpoortweg
675,Schijnpoortweg,2023-03-26,11:00:00,42,10,32,FMN 08 Schijnpoortweg
675,Schijnpoortweg,2023-03-26,12:00:00,54,18,36,FMN 08 Schijnpoortweg
675,Schijnpoortweg,2023-03-26,13:00:00,91,24,67,FMN 08 Schijnpoortweg
675,Schijnpoortweg,2023-03-26,14:00:00,129,29,100,FMN 08 Schijnpoortweg
675,Schijnpoortweg,2023-03-26,15:00:00,85,10,75,FMN 08 Schijnpoortweg
675,Schijnpoortweg,2023-03-26,16:00:00,81,15,66,FMN 08 Schijnpoortweg
675,Schijnpoortweg,2023-03-26,17:00:00,157,54,103,FMN 08 Schijnpoortweg
675,Schijnpoortweg,2023-03-26,18:00:00,129,38,91,FMN 08 Schijnpoortweg
675,Schijnpoortweg,2023-03-26,19:00:00,105,9,96,FMN 08 Schijnpoortweg
675,Schijnpoortweg,2023-03-26,20:00:00,63,6,57,FMN 08 Schijnpoortweg
675,Schijnpoortweg,2023-03-26,21:00:00,87,20,67,FMN 08 Schijnpoortweg
675,Schijnpoortweg,2023-03-26,22:00:00,74,14,60,FMN 08 Schijnpoortweg
675,Schijnpoortweg,2023-03-26,23:00:00,71,8,63,FMN 08 Schijnpoortweg
675,Schijnpoortweg,2023-03-27,00:00:00,35,4,31,FMN 08 Schijnpoortweg
675,Schijnpoortweg,2023-03-27,01:00:00,30,6,24,FMN 08 Schijnpoortweg
675,Schijnpoortweg,2023-03-27,02:00:00,21,5,16,FMN 08 Schijnpoortweg
675,Schijnpoortweg,2023-03-27,03:00:00,11,5,6,FMN 08 Schijnpoortweg
675,Schijnpoortweg,2023-03-27,04:00:00,28,10,18,FMN 08 Schijnpoortweg
675,Schijnpoortweg,2023-03-27,05:00:00,59,11,48,FMN 08 Schijnpoortweg
675,Schijnpoortweg,2023-03-27,06:00:00,80,14,66,FMN 08 Schijnpoortweg
675,Schijnpoortweg,2023-03-27,07:00:00,157,6,151,FMN 08 Schijnpoortweg
675,Schijnpoortweg,2023-03-27,08:00:00,223,22,201,FMN 08 Schijnpoortweg
675,Schijnpoortweg,2023-03-27,09:00:00,92,14,78,FMN 08 Schijnpoortweg
675,Schijnpoortweg,2023-03-27,10:00:00,73,18,55,FMN 08 Schijnpoortweg
675,Schijnpoortweg,2023-03-27,11:00:00,81,9,72,FMN 08 Schijnpoortweg
675,Schijnpoortweg,2023-03-27,12:00:00,121,14,107,FMN 08 Schijnpoortweg
675,Schijnpoortweg,2023-03-27,13:00:00,112,10,102,FMN 08 Schijnpoortweg
675,Schijnpoortweg,2023-03-27,14:00:00,121,9,112,FMN 08 Schijnpoortweg
675,Schijnpoortweg,2023-03-27,15:00:00,235,15,220,FMN 08 Schijnpoortweg
675,Schijnpoortweg,2023-03-27,16:00:00,292,29,263,FMN 08 Schijnpoortweg
675,Schijnpoortweg,2023-03-27,17:00:00,304,26,278,FMN 08 Schijnpoortweg
675,Schijnpoortweg,2023-03-27,18:00:00,231,28,203,FMN 08 Schijnpoortweg
675,Schijnpoortweg,2023-03-27,19:00:00,175,18,157,FMN 08 Schijnpoortweg
675,Schijnpoortweg,2023-03-27,20:00:00,96,15,81,FMN 08 Schijnpoortweg
675,Schijnpoortweg,2023-03-27,21:00:00,117,17,100,FMN 08 Schijnpoortweg
675,Schijnpoortweg,2023-03-27,22:00:00,88,8,80,FMN 08 Schijnpoortweg
675,Schijnpoortweg,2023-03-27,23:00:00,78,12,66,FMN 08 Schijnpoortweg
675,Schijnpoortweg,2023-03-28,00:00:00,36,5,31,FMN 08 Schijnpoortweg
675,Schijnpoortweg,2023-03-28,01:00:00,22,2,20,FMN 08 Schijnpoortweg
675,Schijnpoortweg,2023-03-28,02:00:00,17,5,12,FMN 08 Schijnpoortweg
675,Schijnpoortweg,2023-03-28,03:00:00,9,0,9,FMN 08 Schijnpoortweg
675,Schijnpoortweg,2023-03-28,04:00:00,17,6,11,FMN 08 Schijnpoortweg
675,Schijnpoortweg,2023-03-28,05:00:00,55,9,46,FMN 08 Schijnpoortweg
675,Schijnpoortweg,2023-03-28,06:00:00,79,10,69,FMN 08 Schijnpoortweg
675,Schijnpoortweg,2023-03-28,07:00:00,186,24,162,FMN 08 Schijnpoortweg
675,Schijnpoortweg,2023-03-28,08:00:00,236,44,192,FMN 08 Schijnpoortweg
675,Schijnpoortweg,2023-03-28,09:00:00,83,13,70,FMN 08 Schijnpoortweg
675,Schijnpoortweg,2023-03-28,10:00:00,79,6,73,FMN 08 Schijnpoortweg
675,Schijnpoortweg,2023-03-28,11:00:00,83,11,72,FMN 08 Schijnpoortweg
675,Schijnpoortweg,2023-03-28,12:00:00,137,16,121,FMN 08 Schijnpoortweg
675,Schijnpoortweg,2023-03-28,13:00:00,98,10,88,FMN 08 Schijnpoortweg
675,Schijnpoortweg,2023-03-28,14:00:00,131,12,119,FMN 08 Schijnpoortweg
675,Schijnpoortweg,2023-03-28,15:00:00,220,16,204,FMN 08 Schijnpoortweg
675,Schijnpoortweg,2023-03-28,16:00:00,319,13,306,FMN 08 Schijnpoortweg
675,Schijnpoortweg,2023-03-28,17:00:00,278,24,254,FMN 08 Schijnpoortweg
675,Schijnpoortweg,2023-03-28,18:00:00,209,14,195,FMN 08 Schijnpoortweg
675,Schijnpoortweg,2023-03-28,19:00:00,156,10,146,FMN 08 Schijnpoortweg
675,Schijnpoortweg,2023-03-28,20:00:00,83,10,73,FMN 08 Schijnpoortweg
675,Schijnpoortweg,2023-03-28,21:00:00,102,24,78,FMN 08 Schijnpoortweg
675,Schijnpoortweg,2023-03-28,22:00:00,79,8,71,FMN 08 Schijnpoortweg
675,Schijnpoortweg,2023-03-28,23:00:00,81,5,76,FMN 08 Schijnpoortweg
675,Schijnpoortweg,2023-03-29,00:00:00,18,5,13,FMN 08 Schijnpoortweg
675,Schijnpoortweg,2023-03-29,01:00:00,16,6,10,FMN 08 Schijnpoortweg
675,Schijnpoortweg,2023-03-29,02:00:00,11,5,6,FMN 08 Schijnpoortweg
675,Schijnpoortweg,2023-03-29,03:00:00,8,4,4,FMN 08 Schijnpoortweg
675,Schijnpoortweg,2023-03-29,04:00:00,33,24,9,FMN 08 Schijnpoortweg
675,Schijnpoortweg,2023-03-29,05:00:00,57,28,29,FMN 08 Schijnpoortweg
675,Schijnpoortweg,2023-03-29,06:00:00,133,87,46,FMN 08 Schijnpoortweg
675,Schijnpoortweg,2023-03-29,07:00:00,246,167,79,FMN 08 Schijnpoortweg
675,Schijnpoortweg,2023-03-29,08:00:00,305,214,91,FMN 08 Schijnpoortweg
675,Schijnpoortweg,2023-03-29,09:00:00,158,113,45,FMN 08 Schijnpoortweg
675,Schijnpoortweg,2023-03-29,10:00:00,117,78,39,FMN 08 Schijnpoortweg
675,Schijnpoortweg,2023-03-29,11:00:00,126,79,47,FMN 08 Schijnpoortweg
675,Schijnpoortweg,2023-03-29,12:00:00,218,126,92,FMN 08 Schijnpoortweg
675,Schijnpoortweg,2023-03-29,13:00:00,175,105,70,FMN 08 Schijnpoortweg
675,Schijnpoortweg,2023-03-29,14:00:00,168,106,62,FMN 08 Schijnpoortweg
675,Schijnpoortweg,2023-03-29,15:00:00,204,120,84,FMN 08 Schijnpoortweg
675,Schijnpoortweg,2023-03-29,16:00:00,311,191,120,FMN 08 Schijnpoortweg
675,Schijnpoortweg,2023-03-29,17:00:00,292,171,121,FMN 08 Schijnpoortweg
675,Schijnpoortweg,2023-03-29,18:00:00,223,127,96,FMN 08 Schijnpoortweg
675,Schijnpoortweg,2023-03-29,19:00:00,165,89,76,FMN 08 Schijnpoortweg
675,Schijnpoortweg,2023-03-29,20:00:00,128,70,58,FMN 08 Schijnpoortweg
675,Schijnpoortweg,2023-03-29,21:00:00,90,46,44,FMN 08 Schijnpoortweg
675,Schijnpoortweg,2023-03-29,22:00:00,104,59,45,FMN 08 Schijnpoortweg
675,Schijnpoortweg,2023-03-29,23:00:00,61,27,34,FMN 08 Schijnpoortweg
675,Schijnpoortweg,2023-03-30,00:00:00,30,15,15,FMN 08 Schijnpoortweg
675,Schijnpoortweg,2023-03-30,01:00:00,20,11,9,FMN 08 Schijnpoortweg
675,Schijnpoortweg,2023-03-30,02:00:00,7,3,4,FMN 08 Schijnpoortweg
675,Schijnpoortweg,2023-03-30,03:00:00,11,5,6,FMN 08 Schijnpoortweg
675,Schijnpoortweg,2023-03-30,04:00:00,26,14,12,FMN 08 Schijnpoortweg
675,Schijnpoortweg,2023-03-30,05:00:00,53,29,24,FMN 08 Schijnpoortweg
675,Schijnpoortweg,2023-03-30,06:00:00,105,70,35,FMN 08 Schijnpoortweg
675,Schijnpoortweg,2023-03-30,07:00:00,246,181,65,FMN 08 Schijnpoortweg
675,Schijnpoortweg,2023-03-30,08:00:00,337,255,82,FMN 08 Schijnpoortweg
675,Schijnpoortweg,2023-03-30,09:00:00,146,108,38,FMN 08 Schijnpoortweg
675,Schijnpoortweg,2023-03-30,10:00:00,118,81,37,FMN 08 Schijnpoortweg
675,Schijnpoortweg,2023-03-30,11:00:00,122,81,41,FMN 08 Schijnpoortweg
675,Schijnpoortweg,2023-03-30,12:00:00,160,108,52,FMN 08 Schijnpoortweg
675,Schijnpoortweg,2023-03-30,13:00:00,138,86,52,FMN 08 Schijnpoortweg
675,Schijnpoortweg,2023-03-30,14:00:00,147,94,53,FMN 08 Schijnpoortweg
675,Schijnpoortweg,2023-03-30,15:00:00,219,123,96,FMN 08 Schijnpoortweg
675,Schijnpoortweg,2023-03-30,16:00:00,312,187,125,FMN 08 Schijnpoortweg
675,Schijnpoortweg,2023-03-30,17:00:00,308,168,140,FMN 08 Schijnpoortweg
675,Schijnpoortweg,2023-03-30,18:00:00,209,122,87,FMN 08 Schijnpoortweg
675,Schijnpoortweg,2023-03-30,19:00:00,175,96,79,FMN 08 Schijnpoortweg
675,Schijnpoortweg,2023-03-30,20:00:00,137,72,65,FMN 08 Schijnpoortweg
675,Schijnpoortweg,2023-03-30,21:00:00,105,51,54,FMN 08 Schijnpoortweg
675,Schijnpoortweg,2023-03-30,22:00:00,94,57,37,FMN 08 Schijnpoortweg
675,Schijnpoortweg,2023-03-30,23:00:00,73,30,43,FMN 08 Schijnpoortweg
675,Schijnpoortweg,2023-03-31,00:00:00,23,11,12,FMN 08 Schijnpoortweg
675,Schijnpoortweg,2023-03-31,01:00:00,13,5,8,FMN 08 Schijnpoortweg
675,Schijnpoortweg,2023-03-31,02:00:00,9,4,5,FMN 08 Schijnpoortweg
675,Schijnpoortweg,2023-03-31,03:00:00,16,9,7,FMN 08 Schijnpoortweg
675,Schijnpoortweg,2023-03-31,04:00:00,27,13,14,FMN 08 Schijnpoortweg
675,Schijnpoortweg,2023-03-31,05:00:00,46,28,18,FMN 08 Schijnpoortweg
675,Schijnpoortweg,2023-03-31,06:00:00,89,58,31,FMN 08 Schijnpoortweg
675,Schijnpoortweg,2023-03-31,07:00:00,165,117,48,FMN 08 Schijnpoortweg
675,Schijnpoortweg,2023-03-31,08:00:00,208,157,51,FMN 08 Schijnpoortweg
675,Schijnpoortweg,2023-03-31,09:00:00,97,69,28,FMN 08 Schijnpoortweg
675,Schijnpoortweg,2023-03-31,10:00:00,83,55,28,FMN 08 Schijnpoortweg
675,Schijnpoortweg,2023-03-31,11:00:00,96,64,32,FMN 08 Schijnpoortweg
675,Schijnpoortweg,2023-03-31,12:00:00,118,78,40,FMN 08 Schijnpoortweg
675,Schijnpoortweg,2023-03-31,13:00:00,125,80,45,FMN 08 Schijnpoortweg
675,Schijnpoortweg,2023-03-31,14:00:00,141,81,60,FMN 08 Schijnpoortweg
675,Schijnpoortweg,2023-03-31,15:00:00,169,91,78,FMN 08 Schijnpoortweg
675,Schijnpoortweg,2023-03-31,16:00:00,207,120,87,FMN 08 Schijnpoortweg
675,Schijnpoortweg,2023-03-31,17:00:00,206,116,90,FMN 08 Schijnpoortweg
675,Schijnpoortweg,2023-03-31,18:00:00,163,95,68,FMN 08 Schijnpoortweg
675,Schijnpoortweg,2023-03-31,19:00:00,147,73,74,FMN 08 Schijnpoortweg
675,Schijnpoortweg,2023-03-31,20:00:00,100,51,49,FMN 08 Schijnpoortweg
675,Schijnpoortweg,2023-03-31,21:00:00,86,50,36,FMN 08 Schijnpoortweg
675,Schijnpoortweg,2023-03-31,22:00:00,84,47,37,FMN 08 Schijnpoortweg
675,Schijnpoortweg,2023-03-31,23:00:00,84,56,28,FMN 08 Schijnpoortweg
675,Schijnpoortweg,2023-04-01,00:00:00,33,17,16,FMN 08 Schijnpoortweg
675,Schijnpoortweg,2023-04-01,01:00:00,9,3,6,FMN 08 Schijnpoortweg
675,Schijnpoortweg,2023-04-01,02:00:00,14,7,7,FMN 08 Schijnpoortweg
675,Schijnpoortweg,2023-04-01,03:00:00,10,5,5,FMN 08 Schijnpoortweg
675,Schijnpoortweg,2023-04-01,04:00:00,6,4,2,FMN 08 Schijnpoortweg
675,Schijnpoortweg,2023-04-01,05:00:00,12,7,5,FMN 08 Schijnpoortweg
675,Schijnpoortweg,2023-04-01,06:00:00,27,20,7,FMN 08 Schijnpoortweg
675,Schijnpoortweg,2023-04-01,07:00:00,14,8,6,FMN 08 Schijnpoortweg
675,Schijnpoortweg,2023-04-01,08:00:00,33,19,14,FMN 08 Schijnpoortweg
675,Schijnpoortweg,2023-04-01,09:00:00,43,31,12,FMN 08 Schijnpoortweg
675,Schijnpoortweg,2023-04-01,10:00:00,58,36,22,FMN 08 Schijnpoortweg
675,Schijnpoortweg,2023-04-01,11:00:00,53,35,18,FMN 08 Schijnpoortweg
675,Schijnpoortweg,2023-04-01,12:00:00,53,40,13,FMN 08 Schijnpoortweg
675,Schijnpoortweg,2023-04-01,13:00:00,64,42,22,FMN 08 Schijnpoortweg
675,Schijnpoortweg,2023-04-01,14:00:00,67,45,22,FMN 08 Schijnpoortweg
675,Schijnpoortweg,2023-04-01,15:00:00,68,37,31,FMN 08 Schijnpoortweg
675,Schijnpoortweg,2023-04-01,16:00:00,63,39,24,FMN 08 Schijnpoortweg
675,Schijnpoortweg,2023-04-01,17:00:00,77,45,32,FMN 08 Schijnpoortweg
675,Schijnpoortweg,2023-04-01,18:00:00,73,47,26,FMN 08 Schijnpoortweg
675,Schijnpoortweg,2023-04-01,19:00:00,105,57,48,FMN 08 Schijnpoortweg
675,Schijnpoortweg,2023-04-01,20:00:00,57,34,23,FMN 08 Schijnpoortweg
675,Schijnpoortweg,2023-04-01,21:00:00,53,36,17,FMN 08 Schijnpoortweg
675,Schijnpoortweg,2023-04-01,22:00:00,51,33,18,FMN 08 Schijnpoortweg
675,Schijnpoortweg,2023-04-01,23:00:00,41,24,17,FMN 08 Schijnpoortweg
675,Schijnpoortweg,2023-04-02,00:00:00,31,14,17,FMN 08 Schijnpoortweg
675,Schijnpoortweg,2023-04-02,01:00:00,27,14,13,FMN 08 Schijnpoortweg
675,Schijnpoortweg,2023-04-02,02:00:00,13,8,5,FMN 08 Schijnpoortweg
675,Schijnpoortweg,2023-04-02,03:00:00,13,8,5,FMN 08 Schijnpoortweg
675,Schijnpoortweg,2023-04-02,04:00:00,13,8,5,FMN 08 Schijnpoortweg
675,Schijnpoortweg,2023-04-02,05:00:00,7,6,1,FMN 08 Schijnpoortweg
675,Schijnpoortweg,2023-04-02,06:00:00,25,14,11,FMN 08 Schijnpoortweg
675,Schijnpoortweg,2023-04-02,07:00:00,15,10,5,FMN 08 Schijnpoortweg
675,Schijnpoortweg,2023-04-02,08:00:00,21,9,12,FMN 08 Schijnpoortweg
675,Schijnpoortweg,2023-04-02,09:00:00,51,37,14,FMN 08 Schijnpoortweg
675,Schijnpoortweg,2023-04-02,10:00:00,46,32,14,FMN 08 Schijnpoortweg
675,Schijnpoortweg,2023-04-02,11:00:00,67,42,25,FMN 08 Schijnpoortweg
675,Schijnpoortweg,2023-04-02,12:00:00,79,54,25,FMN 08 Schijnpoortweg
675,Schijnpoortweg,2023-04-02,13:00:00,85,54,31,FMN 08 Schijnpoortweg
675,Schijnpoortweg,2023-04-02,14:00:00,96,62,34,FMN 08 Schijnpoortweg
675,Schijnpoortweg,2023-04-02,15:00:00,84,57,27,FMN 08 Schijnpoortweg
675,Schijnpoortweg,2023-04-02,16:00:00,98,62,36,FMN 08 Schijnpoortweg
675,Schijnpoortweg,2023-04-02,17:00:00,110,62,48,FMN 08 Schijnpoortweg
675,Schijnpoortweg,2023-04-02,18:00:00,86,54,32,FMN 08 Schijnpoortweg
675,Schijnpoortweg,2023-04-02,19:00:00,68,34,34,FMN 08 Schijnpoortweg
675,Schijnpoortweg,2023-04-02,20:00:00,69,43,26,FMN 08 Schijnpoortweg
675,Schijnpoortweg,2023-04-02,21:00:00,51,31,20,FMN 08 Schijnpoortweg
675,Schijnpoortweg,2023-04-02,22:00:00,48,30,18,FMN 08 Schijnpoortweg
675,Schijnpoortweg,2023-04-02,23:00:00,28,17,11,FMN 08 Schijnpoortweg
675,Schijnpoortweg,2023-04-03,00:00:00,25,8,17,FMN 08 Schijnpoortweg
675,Schijnpoortweg,2023-04-03,01:00:00,12,7,5,FMN 08 Schijnpoortweg
675,Schijnpoortweg,2023-04-03,02:00:00,8,3,5,FMN 08 Schijnpoortweg
675,Schijnpoortweg,2023-04-03,03:00:00,12,9,3,FMN 08 Schijnpoortweg
675,Schijnpoortweg,2023-04-03,04:00:00,18,10,8,FMN 08 Schijnpoortweg
675,Schijnpoortweg,2023-04-03,05:00:00,41,18,23,FMN 08 Schijnpoortweg
675,Schijnpoortweg,2023-04-03,06:00:00,88,58,30,FMN 08 Schijnpoortweg
675,Schijnpoortweg,2023-04-03,07:00:00,179,127,52,FMN 08 Schijnpoortweg
675,Schijnpoortweg,2023-04-03,08:00:00,224,167,57,FMN 08 Schijnpoortweg
675,Schijnpoortweg,2023-04-03,09:00:00,94,66,28,FMN 08 Schijnpoortweg
675,Schijnpoortweg,2023-04-03,10:00:00,91,65,26,FMN 08 Schijnpoortweg
675,Schijnpoortweg,2023-04-03,11:00:00,86,54,32,FMN 08 Schijnpoortweg
675,Schijnpoortweg,2023-04-03,12:00:00,125,80,45,FMN 08 Schijnpoortweg
675,Schijnpoortweg,2023-04-03,13:00:00,102,56,46,FMN 08 Schijnpoortweg
675,Schijnpoortweg,2023-04-03,14:00:00,116,70,46,FMN 08 Schijnpoortweg
675,Schijnpoortweg,2023-04-03,15:00:00,178,97,81,FMN 08 Schijnpoortweg
675,Schijnpoortweg,2023-04-03,16:00:00,222,132,90,FMN 08 Schijnpoortweg
675,Schijnpoortweg,2023-04-03,17:00:00,205,121,84,FMN 08 Schijnpoortweg
675,Schijnpoortweg,2023-04-03,18:00:00,163,97,66,FMN 08 Schijnpoortweg
675,Schijnpoortweg,2023-04-03,19:00:00,120,65,55,FMN 08 Schijnpoortweg
675,Schijnpoortweg,2023-04-03,20:00:00,95,52,43,FMN 08 Schijnpoortweg
675,Schijnpoortweg,2023-04-03,21:00:00,69,40,29,FMN 08 Schijnpoortweg
675,Schijnpoortweg,2023-04-03,22:00:00,68,39,29,FMN 08 Schijnpoortweg
675,Schijnpoortweg,2023-04-03,23:00:00,41,22,19,FMN 08 Schijnpoortweg
675,Schijnpoortweg,2023-04-04,00:00:00,20,11,9,FMN 08 Schijnpoortweg
675,Schijnpoortweg,2023-04-04,01:00:00,8,4,4,FMN 08 Schijnpoortweg
675,Schijnpoortweg,2023-04-04,02:00:00,10,2,8,FMN 08 Schijnpoortweg
675,Schijnpoortweg,2023-04-04,03:00:00,9,5,4,FMN 08 Schijnpoortweg
675,Schijnpoortweg,2023-04-04,04:00:00,18,9,9,FMN 08 Schijnpoortweg
675,Schijnpoortweg,2023-04-04,05:00:00,46,25,21,FMN 08 Schijnpoortweg
675,Schijnpoortweg,2023-04-04,06:00:00,100,59,41,FMN 08 Schijnpoortweg
675,Schijnpoortweg,2023-04-04,07:00:00,201,147,54,FMN 08 Schijnpoortweg
675,Schijnpoortweg,2023-04-04,08:00:00,259,193,66,FMN 08 Schijnpoortweg
675,Schijnpoortweg,2023-04-04,09:00:00,120,86,34,FMN 08 Schijnpoortweg
675,Schijnpoortweg,2023-04-04,10:00:00,89,65,24,FMN 08 Schijnpoortweg
675,Schijnpoortweg,2023-04-04,11:00:00,91,59,32,FMN 08 Schijnpoortweg
675,Schijnpoortweg,2023-04-04,12:00:00,123,85,38,FMN 08 Schijnpoortweg
675,Schijnpoortweg,2023-04-04,13:00:00,121,80,41,FMN 08 Schijnpoortweg
675,Schijnpoortweg,2023-04-04,14:00:00,124,75,49,FMN 08 Schijnpoortweg
675,Schijnpoortweg,2023-04-04,15:00:00,160,91,69,FMN 08 Schijnpoortweg
675,Schijnpoortweg,2023-04-04,16:00:00,235,149,86,FMN 08 Schijnpoortweg
675,Schijnpoortweg,2023-04-04,17:00:00,227,133,94,FMN 08 Schijnpoortweg
675,Schijnpoortweg,2023-04-04,18:00:00,170,92,78,FMN 08 Schijnpoortweg
675,Schijnpoortweg,2023-04-04,19:00:00,140,77,63,FMN 08 Schijnpoortweg
675,Schijnpoortweg,2023-04-04,20:00:00,104,59,45,FMN 08 Schijnpoortweg
675,Schijnpoortweg,2023-04-04,21:00:00,75,40,35,FMN 08 Schijnpoortweg
675,Schijnpoortweg,2023-04-04,22:00:00,87,45,42,FMN 08 Schijnpoortweg
675,Schijnpoortweg,2023-04-04,23:00:00,33,18,15,FMN 08 Schijnpoortweg
675,Schijnpoortweg,2023-04-05,00:00:00,30,14,16,FMN 08 Schijnpoortweg
675,Schijnpoortweg,2023-04-05,01:00:00,10,5,5,FMN 08 Schijnpoortweg
675,Schijnpoortweg,2023-04-05,02:00:00,8,3,5,FMN 08 Schijnpoortweg
675,Schijnpoortweg,2023-04-05,03:00:00,6,4,2,FMN 08 Schijnpoortweg
675,Schijnpoortweg,2023-04-05,04:00:00,29,17,12,FMN 08 Schijnpoortweg
675,Schijnpoortweg,2023-04-05,05:00:00,50,26,24,FMN 08 Schijnpoortweg
675,Schijnpoortweg,2023-04-05,06:00:00,96,64,32,FMN 08 Schijnpoortweg
675,Schijnpoortweg,2023-04-05,07:00:00,186,129,57,FMN 08 Schijnpoortweg
675,Schijnpoortweg,2023-04-05,08:00:00,220,152,68,FMN 08 Schijnpoortweg
675,Schijnpoortweg,2023-04-05,09:00:00,103,71,32,FMN 08 Schijnpoortweg
675,Schijnpoortweg,2023-04-05,10:00:00,88,57,31,FMN 08 Schijnpoortweg
675,Schijnpoortweg,2023-04-05,11:00:00,94,63,31,FMN 08 Schijnpoortweg
675,Schijnpoortweg,2023-04-05,12:00:00,164,97,67,FMN 08 Schijnpoortweg
675,Schijnpoortweg,2023-04-05,13:00:00,128,75,53,FMN 08 Schijnpoortweg
675,Schijnpoortweg,2023-04-05,14:00:00,148,92,56,FMN 08 Schijnpoortweg
675,Schijnpoortweg,2023-04-05,15:00:00,158,91,67,FMN 08 Schijnpoortweg
675,Schijnpoortweg,2023-04-05,16:00:00,214,132,82,FMN 08 Schijnpoortweg
675,Schijnpoortweg,2023-04-05,17:00:00,236,130,106,FMN 08 Schijnpoortweg
675,Schijnpoortweg,2023-04-05,18:00:00,173,101,72,FMN 08 Schijnpoortweg
675,Schijnpoortweg,2023-04-05,19:00:00,132,72,60,FMN 08 Schijnpoortweg
675,Schijnpoortweg,2023-04-05,20:00:00,95,44,51,FMN 08 Schijnpoortweg
675,Schijnpoortweg,2023-04-05,21:00:00,81,53,28,FMN 08 Schijnpoortweg
675,Schijnpoortweg,2023-04-05,22:00:00,73,44,29,FMN 08 Schijnpoortweg
675,Schijnpoortweg,2023-04-05,23:00:00,53,27,26,FMN 08 Schijnpoortweg
675,Schijnpoortweg,2023-04-06,00:00:00,12,5,7,FMN 08 Schijnpoortweg
675,Schijnpoortweg,2023-04-06,01:00:00,10,3,7,FMN 08 Schijnpoortweg
675,Schijnpoortweg,2023-04-06,02:00:00,4,2,2,FMN 08 Schijnpoortweg
675,Schijnpoortweg,2023-04-06,03:00:00,8,5,3,FMN 08 Schijnpoortweg
675,Schijnpoortweg,2023-04-06,04:00:00,18,9,9,FMN 08 Schijnpoortweg
675,Schijnpoortweg,2023-04-06,05:00:00,30,17,13,FMN 08 Schijnpoortweg
675,Schijnpoortweg,2023-04-06,06:00:00,79,53,26,FMN 08 Schijnpoortweg
675,Schijnpoortweg,2023-04-06,07:00:00,136,92,44,FMN 08 Schijnpoortweg
675,Schijnpoortweg,2023-04-06,08:00:00,175,134,41,FMN 08 Schijnpoortweg
675,Schijnpoortweg,2023-04-06,09:00:00,77,59,18,FMN 08 Schijnpoortweg
675,Schijnpoortweg,2023-04-06,10:00:00,59,41,18,FMN 08 Schijnpoortweg
675,Schijnpoortweg,2023-04-06,11:00:00,65,42,23,FMN 08 Schijnpoortweg
675,Schijnpoortweg,2023-04-06,12:00:00,87,54,33,FMN 08 Schijnpoortweg
675,Schijnpoortweg,2023-04-06,13:00:00,79,51,28,FMN 08 Schijnpoortweg
675,Schijnpoortweg,2023-04-06,14:00:00,92,52,40,FMN 08 Schijnpoortweg
675,Schijnpoortweg,2023-04-06,15:00:00,107,64,43,FMN 08 Schijnpoortweg
675,Schijnpoortweg,2023-04-06,16:00:00,173,104,69,FMN 08 Schijnpoortweg
675,Schijnpoortweg,2023-04-06,17:00:00,159,94,65,FMN 08 Schijnpoortweg
675,Schijnpoortweg,2023-04-06,18:00:00,137,82,55,FMN 08 Schijnpoortweg
675,Schijnpoortweg,2023-04-06,19:00:00,94,46,48,FMN 08 Schijnpoortweg
675,Schijnpoortweg,2023-04-06,20:00:00,86,51,35,FMN 08 Schijnpoortweg
675,Schijnpoortweg,2023-04-06,21:00:00,51,29,22,FMN 08 Schijnpoortweg
675,Schijnpoortweg,2023-04-06,22:00:00,53,35,18,FMN 08 Schijnpoortweg
675,Schijnpoortweg,2023-04-06,23:00:00,37,20,17,FMN 08 Schijnpoortweg
675,Schijnpoortweg,2023-04-07,00:00:00,23,11,12,FMN 08 Schijnpoortweg
675,Schijnpoortweg,2023-04-07,01:00:00,18,8,10,FMN 08 Schijnpoortweg
675,Schijnpoortweg,2023-04-07,02:00:00,15,5,10,FMN 08 Schijnpoortweg
675,Schijnpoortweg,2023-04-07,03:00:00,9,5,4,FMN 08 Schijnpoortweg
675,Schijnpoortweg,2023-04-07,04:00:00,19,9,10,FMN 08 Schijnpoortweg
675,Schijnpoortweg,2023-04-07,05:00:00,30,14,16,FMN 08 Schijnpoortweg
675,Schijnpoortweg,2023-04-07,06:00:00,64,44,20,FMN 08 Schijnpoortweg
675,Schijnpoortweg,2023-04-07,07:00:00,161,115,46,FMN 08 Schijnpoortweg
675,Schijnpoortweg,2023-04-07,08:00:00,177,131,46,FMN 08 Schijnpoortweg
675,Schijnpoortweg,2023-04-07,09:00:00,91,64,27,FMN 08 Schijnpoortweg
675,Schijnpoortweg,2023-04-07,10:00:00,83,58,25,FMN 08 Schijnpoortweg
675,Schijnpoortweg,2023-04-07,11:00:00,83,51,32,FMN 08 Schijnpoortweg
675,Schijnpoortweg,2023-04-07,12:00:00,118,83,35,FMN 08 Schijnpoortweg
675,Schijnpoortweg,2023-04-07,13:00:00,106,70,36,FMN 08 Schijnpoortweg
675,Schijnpoortweg,2023-04-07,14:00:00,125,77,48,FMN 08 Schijnpoortweg
675,Schijnpoortweg,2023-04-07,15:00:00,138,76,62,FMN 08 Schijnpoortweg
675,Schijnpoortweg,2023-04-07,16:00:00,179,106,73,FMN 08 Schijnpoortweg
675,Schijnpoortweg,2023-04-07,17:00:00,172,103,69,FMN 08 Schijnpoortweg
675,Schijnpoortweg,2023-04-07,18:00:00,157,93,64,FMN 08 Schijnpoortweg
675,Schijnpoortweg,2023-04-07,19:00:00,129,68,61,FMN 08 Schijnpoortweg
675,Schijnpoortweg,2023-04-07,20:00:00,102,51,51,FMN 08 Schijnpoortweg
675,Schijnpoortweg,2023-04-07,21:00:00,78,42,36,FMN 08 Schijnpoortweg
675,Schijnpoortweg,2023-04-07,22:00:00,77,47,30,FMN 08 Schijnpoortweg
675,Schijnpoortweg,2023-04-07,23:00:00,57,34,23,FMN 08 Schijnpoortweg
675,Schijnpoortweg,2023-04-08,00:00:00,36,19,17,FMN 08 Schijnpoortweg
675,Schijnpoortweg,2023-04-08,01:00:00,23,8,15,FMN 08 Schijnpoortweg
675,Schijnpoortweg,2023-04-08,02:00:00,24,16,8,FMN 08 Schijnpoortweg
675,Schijnpoortweg,2023-04-08,03:00:00,18,11,7,FMN 08 Schijnpoortweg
675,Schijnpoortweg,2023-04-08,04:00:00,16,8,8,FMN 08 Schijnpoortweg
675,Schijnpoortweg,2023-04-08,05:00:00,24,13,11,FMN 08 Schijnpoortweg
675,Schijnpoortweg,2023-04-08,06:00:00,24,16,8,FMN 08 Schijnpoortweg
675,Schijnpoortweg,2023-04-08,07:00:00,26,12,14,FMN 08 Schijnpoortweg
675,Schijnpoortweg,2023-04-08,08:00:00,41,25,16,FMN 08 Schijnpoortweg
675,Schijnpoortweg,2023-04-08,09:00:00,76,52,24,FMN 08 Schijnpoortweg
675,Schijnpoortweg,2023-04-08,10:00:00,85,57,28,FMN 08 Schijnpoortweg
675,Schijnpoortweg,2023-04-08,11:00:00,95,58,37,FMN 08 Schijnpoortweg
675,Schijnpoortweg,2023-04-08,12:00:00,97,67,30,FMN 08 Schijnpoortweg
675,Schijnpoortweg,2023-04-08,13:00:00,111,66,45,FMN 08 Schijnpoortweg
675,Schijnpoortweg,2023-04-08,14:00:00,118,73,45,FMN 08 Schijnpoortweg
675,Schijnpoortweg,2023-04-08,15:00:00,111,68,43,FMN 08 Schijnpoortweg
675,Schijnpoortweg,2023-04-08,16:00:00,125,74,51,FMN 08 Schijnpoortweg
675,Schijnpoortweg,2023-04-08,17:00:00,132,83,49,FMN 08 Schijnpoortweg
675,Schijnpoortweg,2023-04-08,18:00:00,136,84,52,FMN 08 Schijnpoortweg
675,Schijnpoortweg,2023-04-08,19:00:00,131,78,53,FMN 08 Schijnpoortweg
675,Schijnpoortweg,2023-04-08,20:00:00,101,53,48,FMN 08 Schijnpoortweg
675,Schijnpoortweg,2023-04-08,21:00:00,74,42,32,FMN 08 Schijnpoortweg
675,Schijnpoortweg,2023-04-08,22:00:00,75,48,27,FMN 08 Schijnpoortweg
675,Schijnpoortweg,2023-04-08,23:00:00,79,52,27,FMN 08 Schijnpoortweg
675,Schijnpoortweg,2023-04-09,00:00:00,29,17,12,FMN 08 Schijnpoortweg
675,Schijnpoortweg,2023-04-09,01:00:00,19,9,10,FMN 08 Schijnpoortweg
675,Schijnpoortweg,2023-04-09,02:00:00,16,9,7,FMN 08 Schijnpoortweg
675,Schijnpoortweg,2023-04-09,03:00:00,18,11,7,FMN 08 Schijnpoortweg
675,Schijnpoortweg,2023-04-09,04:00:00,7,3,4,FMN 08 Schijnpoortweg
675,Schijnpoortweg,2023-04-09,05:00:00,15,9,6,FMN 08 Schijnpoortweg
675,Schijnpoortweg,2023-04-09,06:00:00,24,15,9,FMN 08 Schijnpoortweg
675,Schijnpoortweg,2023-04-09,07:00:00,10,5,5,FMN 08 Schijnpoortweg
675,Schijnpoortweg,2023-04-09,08:00:00,31,20,11,FMN 08 Schijnpoortweg
675,Schijnpoortweg,2023-04-09,09:00:00,55,39,16,FMN 08 Schijnpoortweg
675,Schijnpoortweg,2023-04-09,10:00:00,64,48,16,FMN 08 Schijnpoortweg
675,Schijnpoortweg,2023-04-09,11:00:00,83,54,29,FMN 08 Schijnpoortweg
675,Schijnpoortweg,2023-04-09,12:00:00,85,58,27,FMN 08 Schijnpoortweg
675,Schijnpoortweg,2023-04-09,13:00:00,95,57,38,FMN 08 Schijnpoortweg
675,Schijnpoortweg,2023-04-09,14:00:00,97,65,32,FMN 08 Schijnpoortweg
675,Schijnpoortweg,2023-04-09,15:00:00,103,66,37,FMN 08 Schijnpoortweg
675,Schijnpoortweg,2023-04-09,16:00:00,96,59,37,FMN 08 Schijnpoortweg
675,Schijnpoortweg,2023-04-09,17:00:00,109,69,40,FMN 08 Schijnpoortweg
675,Schijnpoortweg,2023-04-09,18:00:00,92,51,41,FMN 08 Schijnpoortweg
675,Schijnpoortweg,2023-04-09,19:00:00,87,51,36,FMN 08 Schijnpoortweg
675,Schijnpoortweg,2023-04-09,20:00:00,59,33,26,FMN 08 Schijnpoortweg
675,Schijnpoortweg,2023-04-09,21:00:00,45,22,23,FMN 08 Schijnpoortweg
675,Schijnpoortweg,2023-04-09,22:00:00,54,30,24,FMN 08 Schijnpoortweg
675,Schijnpoortweg,2023-04-09,23:00:00,34,18,16,FMN 08 Schijnpoortweg
675,Schijnpoortweg,2023-04-10,00:00:00,4,2,2,FMN 08 Schijnpoortweg
675,Schijnpoortweg,2023-04-10,01:00:00,5,0,5,FMN 08 Schijnpoortweg
675,Schijnpoortweg,2023-04-10,02:00:00,2,1,1,FMN 08 Schijnpoortweg
675,Schijnpoortweg,2023-04-10,03:00:00,5,2,3,FMN 08 Schijnpoortweg
675,Schijnpoortweg,2023-04-10,04:00:00,8,5,3,FMN 08 Schijnpoortweg
675,Schijnpoortweg,2023-04-10,05:00:00,21,15,6,FMN 08 Schijnpoortweg
675,Schijnpoortweg,2023-04-10,06:00:00,27,17,10,FMN 08 Schijnpoortweg
675,Schijnpoortweg,2023-04-10,07:00:00,71,48,23,FMN 08 Schijnpoortweg
675,Schijnpoortweg,2023-04-10,08:00:00,88,67,21,FMN 08 Schijnpoortweg
675,Schijnpoortweg,2023-04-10,09:00:00,36,26,10,FMN 08 Schijnpoortweg
675,Schijnpoortweg,2023-04-10,10:00:00,44,31,13,FMN 08 Schijnpoortweg
675,Schijnpoortweg,2023-04-10,11:00:00,33,24,9,FMN 08 Schijnpoortweg
675,Schijnpoortweg,2023-04-10,12:00:00,49,33,16,FMN 08 Schijnpoortweg
675,Schijnpoortweg,2023-04-10,13:00:00,33,20,13,FMN 08 Schijnpoortweg
675,Schijnpoortweg,2023-04-10,14:00:00,49,30,19,FMN 08 Schijnpoortweg
675,Schijnpoortweg,2023-04-10,15:00:00,59,31,28,FMN 08 Schijnpoortweg
675,Schijnpoortweg,2023-04-10,16:00:00,82,52,30,FMN 08 Schijnpoortweg
675,Schijnpoortweg,2023-04-10,17:00:00,87,47,40,FMN 08 Schijnpoortweg
675,Schijnpoortweg,2023-04-10,18:00:00,58,30,28,FMN 08 Schijnpoortweg
675,Schijnpoortweg,2023-04-10,19:00:00,29,17,12,FMN 08 Schijnpoortweg
675,Schijnpoortweg,2023-04-10,20:00:00,33,20,13,FMN 08 Schijnpoortweg
675,Schijnpoortweg,2023-04-10,21:00:00,23,12,11,FMN 08 Schijnpoortweg
675,Schijnpoortweg,2023-04-10,22:00:00,30,11,19,FMN 08 Schijnpoortweg
675,Schijnpoortweg,2023-04-10,23:00:00,17,7,10,FMN 08 Schijnpoortweg
675,Schijnpoortweg,2023-04-11,00:00:00,19,5,14,FMN 08 Schijnpoortweg
675,Schijnpoortweg,2023-04-11,01:00:00,6,2,4,FMN 08 Schijnpoortweg
675,Schijnpoortweg,2023-04-11,02:00:00,5,2,3,FMN 08 Schijnpoortweg
675,Schijnpoortweg,2023-04-11,03:00:00,9,6,3,FMN 08 Schijnpoortweg
675,Schijnpoortweg,2023-04-11,04:00:00,22,11,11,FMN 08 Schijnpoortweg
675,Schijnpoortweg,2023-04-11,05:00:00,38,21,17,FMN 08 Schijnpoortweg
675,Schijnpoortweg,2023-04-11,06:00:00,85,56,29,FMN 08 Schijnpoortweg
675,Schijnpoortweg,2023-04-11,07:00:00,170,127,43,FMN 08 Schijnpoortweg
675,Schijnpoortweg,2023-04-11,08:00:00,220,166,54,FMN 08 Schijnpoortweg
675,Schijnpoortweg,2023-04-11,09:00:00,107,70,37,FMN 08 Schijnpoortweg
675,Schijnpoortweg,2023-04-11,10:00:00,68,44,24,FMN 08 Schijnpoortweg
675,Schijnpoortweg,2023-04-11,11:00:00,88,57,31,FMN 08 Schijnpoortweg
675,Schijnpoortweg,2023-04-11,12:00:00,102,69,33,FMN 08 Schijnpoortweg
675,Schijnpoortweg,2023-04-11,13:00:00,99,64,35,FMN 08 Schijnpoortweg
675,Schijnpoortweg,2023-04-11,14:00:00,97,60,37,FMN 08 Schijnpoortweg
675,Schijnpoortweg,2023-04-11,15:00:00,138,78,60,FMN 08 Schijnpoortweg
675,Schijnpoortweg,2023-04-11,16:00:00,210,128,82,FMN 08 Schijnpoortweg
675,Schijnpoortweg,2023-04-11,17:00:00,207,112,95,FMN 08 Schijnpoortweg
675,Schijnpoortweg,2023-04-11,18:00:00,155,91,64,FMN 08 Schijnpoortweg
675,Schijnpoortweg,2023-04-11,19:00:00,106,57,49,FMN 08 Schijnpoortweg
675,Schijnpoortweg,2023-04-11,20:00:00,81,45,36,FMN 08 Schijnpoortweg
675,Schijnpoortweg,2023-04-11,21:00:00,61,36,25,FMN 08 Schijnpoortweg
675,Schijnpoortweg,2023-04-11,22:00:00,69,40,29,FMN 08 Schijnpoortweg
675,Schijnpoortweg,2023-04-11,23:00:00,50,25,25,FMN 08 Schijnpoortweg
675,Schijnpoortweg,2023-04-12,00:00:00,15,5,10,FMN 08 Schijnpoortweg
675,Schijnpoortweg,2023-04-12,01:00:00,5,1,4,FMN 08 Schijnpoortweg
675,Schijnpoortweg,2023-04-12,02:00:00,4,3,1,FMN 08 Schijnpoortweg
675,Schijnpoortweg,2023-04-12,03:00:00,4,2,2,FMN 08 Schijnpoortweg
675,Schijnpoortweg,2023-04-12,04:00:00,20,11,9,FMN 08 Schijnpoortweg
675,Schijnpoortweg,2023-04-12,05:00:00,41,28,13,FMN 08 Schijnpoortweg
675,Schijnpoortweg,2023-04-12,06:00:00,75,51,24,FMN 08 Schijnpoortweg
675,Schijnpoortweg,2023-04-12,07:00:00,138,104,34,FMN 08 Schijnpoortweg
675,Schijnpoortweg,2023-04-12,08:00:00,187,135,52,FMN 08 Schijnpoortweg
675,Schijnpoortweg,2023-04-12,09:00:00,84,60,24,FMN 08 Schijnpoortweg
675,Schijnpoortweg,2023-04-12,10:00:00,65,54,11,FMN 08 Schijnpoortweg
675,Schijnpoortweg,2023-04-12,11:00:00,71,50,21,FMN 08 Schijnpoortweg
675,Schijnpoortweg,2023-04-12,12:00:00,132,81,51,FMN 08 Schijnpoortweg
675,Schijnpoortweg,2023-04-12,13:00:00,122,79,43,FMN 08 Schijnpoortweg
675,Schijnpoortweg,2023-04-12,14:00:00,100,61,39,FMN 08 Schijnpoortweg
675,Schijnpoortweg,2023-04-12,15:00:00,119,67,52,FMN 08 Schijnpoortweg
675,Schijnpoortweg,2023-04-12,16:00:00,172,105,67,FMN 08 Schijnpoortweg
675,Schijnpoortweg,2023-04-12,17:00:00,170,102,68,FMN 08 Schijnpoortweg
675,Schijnpoortweg,2023-04-12,18:00:00,135,84,51,FMN 08 Schijnpoortweg
675,Schijnpoortweg,2023-04-12,19:00:00,110,57,53,FMN 08 Schijnpoortweg
675,Schijnpoortweg,2023-04-12,20:00:00,78,44,34,FMN 08 Schijnpoortweg
675,Schijnpoortweg,2023-04-12,21:00:00,64,32,32,FMN 08 Schijnpoortweg
675,Schijnpoortweg,2023-04-12,22:00:00,53,29,24,FMN 08 Schijnpoortweg
675,Schijnpoortweg,2023-04-12,23:00:00,35,22,13,FMN 08 Schijnpoortweg
675,Schijnpoortweg,2023-04-13,00:00:00,24,10,14,FMN 08 Schijnpoortweg
675,Schijnpoortweg,2023-04-13,01:00:00,19,13,6,FMN 08 Schijnpoortweg
675,Schijnpoortweg,2023-04-13,02:00:00,7,3,4,FMN 08 Schijnpoortweg
675,Schijnpoortweg,2023-04-13,03:00:00,7,3,4,FMN 08 Schijnpoortweg
675,Schijnpoortweg,2023-04-13,04:00:00,24,11,13,FMN 08 Schijnpoortweg
675,Schijnpoortweg,2023-04-13,05:00:00,46,20,26,FMN 08 Schijnpoortweg
675,Schijnpoortweg,2023-04-13,06:00:00,82,55,27,FMN 08 Schijnpoortweg
675,Schijnpoortweg,2023-04-13,07:00:00,171,125,46,FMN 08 Schijnpoortweg
675,Schijnpoortweg,2023-04-13,08:00:00,230,170,60,FMN 08 Schijnpoortweg
675,Schijnpoortweg,2023-04-13,09:00:00,108,75,33,FMN 08 Schijnpoortweg
675,Schijnpoortweg,2023-04-13,10:00:00,84,55,29,FMN 08 Schijnpoortweg
675,Schijnpoortweg,2023-04-13,11:00:00,91,57,34,FMN 08 Schijnpoortweg
675,Schijnpoortweg,2023-04-13,12:00:00,115,74,41,FMN 08 Schijnpoortweg
675,Schijnpoortweg,2023-04-13,13:00:00,109,66,43,FMN 08 Schijnpoortweg
675,Schijnpoortweg,2023-04-13,14:00:00,110,70,40,FMN 08 Schijnpoortweg
675,Schijnpoortweg,2023-04-13,15:00:00,152,82,70,FMN 08 Schijnpoortweg
675,Schijnpoortweg,2023-04-13,16:00:00,228,129,99,FMN 08 Schijnpoortweg
675,Schijnpoortweg,2023-04-13,17:00:00,208,116,92,FMN 08 Schijnpoortweg
675,Schijnpoortweg,2023-04-13,18:00:00,155,84,71,FMN 08 Schijnpoortweg
675,Schijnpoortweg,2023-04-13,19:00:00,127,66,61,FMN 08 Schijnpoortweg
675,Schijnpoortweg,2023-04-13,20:00:00,94,48,46,FMN 08 Schijnpoortweg
675,Schijnpoortweg,2023-04-13,21:00:00,69,32,37,FMN 08 Schijnpoortweg
675,Schijnpoortweg,2023-04-13,22:00:00,60,37,23,FMN 08 Schijnpoortweg
675,Schijnpoortweg,2023-04-13,23:00:00,60,38,22,FMN 08 Schijnpoortweg
675,Schijnpoortweg,2023-04-14,00:00:00,20,13,7,FMN 08 Schijnpoortweg
675,Schijnpoortweg,2023-04-14,01:00:00,9,3,6,FMN 08 Schijnpoortweg
675,Schijnpoortweg,2023-04-14,02:00:00,13,7,6,FMN 08 Schijnpoortweg
675,Schijnpoortweg,2023-04-14,03:00:00,12,2,10,FMN 08 Schijnpoortweg
675,Schijnpoortweg,2023-04-14,04:00:00,17,8,9,FMN 08 Schijnpoortweg
675,Schijnpoortweg,2023-04-14,05:00:00,38,18,20,FMN 08 Schijnpoortweg
675,Schijnpoortweg,2023-04-14,06:00:00,90,57,33,FMN 08 Schijnpoortweg
675,Schijnpoortweg,2023-04-14,07:00:00,169,121,48,FMN 08 Schijnpoortweg
675,Schijnpoortweg,2023-04-14,08:00:00,208,160,48,FMN 08 Schijnpoortweg
675,Schijnpoortweg,2023-04-14,09:00:00,93,69,24,FMN 08 Schijnpoortweg
675,Schijnpoortweg,2023-04-14,10:00:00,95,67,28,FMN 08 Schijnpoortweg
675,Schijnpoortweg,2023-04-14,11:00:00,87,63,24,FMN 08 Schijnpoortweg
675,Schijnpoortweg,2023-04-14,12:00:00,123,73,50,FMN 08 Schijnpoortweg
675,Schijnpoortweg,2023-04-14,13:00:00,122,81,41,FMN 08 Schijnpoortweg
675,Schijnpoortweg,2023-04-14,14:00:00,131,78,53,FMN 08 Schijnpoortweg
675,Schijnpoortweg,2023-04-14,15:00:00,165,88,77,FMN 08 Schijnpoortweg
675,Schijnpoortweg,2023-04-14,16:00:00,210,118,92,FMN 08 Schijnpoortweg
675,Schijnpoortweg,2023-04-14,17:00:00,196,116,80,FMN 08 Schijnpoortweg
675,Schijnpoortweg,2023-04-14,18:00:00,155,99,56,FMN 08 Schijnpoortweg
675,Schijnpoortweg,2023-04-14,19:00:00,137,65,72,FMN 08 Schijnpoortweg
675,Schijnpoortweg,2023-04-14,20:00:00,103,48,55,FMN 08 Schijnpoortweg
675,Schijnpoortweg,2023-04-14,21:00:00,76,44,32,FMN 08 Schijnpoortweg
675,Schijnpoortweg,2023-04-14,22:00:00,74,42,32,FMN 08 Schijnpoortweg
675,Schijnpoortweg,2023-04-14,23:00:00,79,36,43,FMN 08 Schijnpoortweg
675,Schijnpoortweg,2023-04-15,00:00:00,48,21,27,FMN 08 Schijnpoortweg
675,Schijnpoortweg,2023-04-15,01:00:00,27,14,13,FMN 08 Schijnpoortweg
675,Schijnpoortweg,2023-04-15,02:00:00,22,8,14,FMN 08 Schijnpoortweg
675,Schijnpoortweg,2023-04-15,03:00:00,20,15,5,FMN 08 Schijnpoortweg
675,Schijnpoortweg,2023-04-15,04:00:00,19,11,8,FMN 08 Schijnpoortweg
675,Schijnpoortweg,2023-04-15,05:00:00,22,12,10,FMN 08 Schijnpoortweg
675,Schijnpoortweg,2023-04-15,06:00:00,29,23,6,FMN 08 Schijnpoortweg
675,Schijnpoortweg,2023-04-15,07:00:00,43,20,23,FMN 08 Schijnpoortweg
675,Schijnpoortweg,2023-04-15,08:00:00,58,31,27,FMN 08 Schijnpoortweg
675,Schijnpoortweg,2023-04-15,09:00:00,94,66,28,FMN 08 Schijnpoortweg
675,Schijnpoortweg,2023-04-15,10:00:00,99,64,35,FMN 08 Schijnpoortweg
675,Schijnpoortweg,2023-04-15,11:00:00,112,78,34,FMN 08 Schijnpoortweg
675,Schijnpoortweg,2023-04-15,12:00:00,131,84,47,FMN 08 Schijnpoortweg
675,Schijnpoortweg,2023-04-15,13:00:00,156,98,58,FMN 08 Schijnpoortweg
675,Schijnpoortweg,2023-04-15,14:00:00,146,93,53,FMN 08 Schijnpoortweg
675,Schijnpoortweg,2023-04-15,15:00:00,140,84,56,FMN 08 Schijnpoortweg
675,Schijnpoortweg,2023-04-15,16:00:00,161,94,67,FMN 08 Schijnpoortweg
675,Schijnpoortweg,2023-04-15,17:00:00,151,99,52,FMN 08 Schijnpoortweg
675,Schijnpoortweg,2023-04-15,18:00:00,171,101,70,FMN 08 Schijnpoortweg
675,Schijnpoortweg,2023-04-15,19:00:00,144,78,66,FMN 08 Schijnpoortweg
675,Schijnpoortweg,2023-04-15,20:00:00,127,67,60,FMN 08 Schijnpoortweg
675,Schijnpoortweg,2023-04-15,21:00:00,79,47,32,FMN 08 Schijnpoortweg
675,Schijnpoortweg,2023-04-15,22:00:00,92,58,34,FMN 08 Schijnpoortweg
675,Schijnpoortweg,2023-04-15,23:00:00,83,49,34,FMN 08 Schijnpoortweg
675,Schijnpoortweg,2023-04-16,00:00:00,31,16,15,FMN 08 Schijnpoortweg
675,Schijnpoortweg,2023-04-16,01:00:00,20,8,12,FMN 08 Schijnpoortweg
675,Schijnpoortweg,2023-04-16,02:00:00,17,9,8,FMN 08 Schijnpoortweg
675,Schijnpoortweg,2023-04-16,03:00:00,18,10,8,FMN 08 Schijnpoortweg
675,Schijnpoortweg,2023-04-16,04:00:00,12,6,6,FMN 08 Schijnpoortweg
675,Schijnpoortweg,2023-04-16,05:00:00,17,14,3,FMN 08 Schijnpoortweg
675,Schijnpoortweg,2023-04-16,06:00:00,18,13,5,FMN 08 Schijnpoortweg
675,Schijnpoortweg,2023-04-16,07:00:00,20,12,8,FMN 08 Schijnpoortweg
675,Schijnpoortweg,2023-04-16,08:00:00,30,19,11,FMN 08 Schijnpoortweg
675,Schijnpoortweg,2023-04-16,09:00:00,50,32,18,FMN 08 Schijnpoortweg
675,Schijnpoortweg,2023-04-16,10:00:00,65,45,20,FMN 08 Schijnpoortweg
675,Schijnpoortweg,2023-04-16,11:00:00,100,61,39,FMN 08 Schijnpoortweg
675,Schijnpoortweg,2023-04-16,12:00:00,83,54,29,FMN 08 Schijnpoortweg
675,Schijnpoortweg,2023-04-16,13:00:00,93,57,36,FMN 08 Schijnpoortweg
675,Schijnpoortweg,2023-04-16,14:00:00,116,76,40,FMN 08 Schijnpoortweg
675,Schijnpoortweg,2023-04-16,15:00:00,99,59,40,FMN 08 Schijnpoortweg
675,Schijnpoortweg,2023-04-16,16:00:00,98,64,34,FMN 08 Schijnpoortweg
675,Schijnpoortweg,2023-04-16,17:00:00,98,58,40,FMN 08 Schijnpoortweg
675,Schijnpoortweg,2023-04-16,18:00:00,103,59,44,FMN 08 Schijnpoortweg
675,Schijnpoortweg,2023-04-16,19:00:00,72,38,34,FMN 08 Schijnpoortweg
675,Schijnpoortweg,2023-04-16,20:00:00,69,34,35,FMN 08 Schijnpoortweg
675,Schijnpoortweg,2023-04-16,21:00:00,62,36,26,FMN 08 Schijnpoortweg
675,Schijnpoortweg,2023-04-16,22:00:00,60,39,21,FMN 08 Schijnpoortweg
675,Schijnpoortweg,2023-04-16,23:00:00,34,20,14,FMN 08 Schijnpoortweg
675,Schijnpoortweg,2023-04-17,00:00:00,24,8,16,FMN 08 Schijnpoortweg
675,Schijnpoortweg,2023-04-17,01:00:00,17,8,9,FMN 08 Schijnpoortweg
675,Schijnpoortweg,2023-04-17,02:00:00,14,9,5,FMN 08 Schijnpoortweg
675,Schijnpoortweg,2023-04-17,03:00:00,17,8,9,FMN 08 Schijnpoortweg
675,Schijnpoortweg,2023-04-17,04:00:00,29,18,11,FMN 08 Schijnpoortweg
675,Schijnpoortweg,2023-04-17,05:00:00,70,32,38,FMN 08 Schijnpoortweg
675,Schijnpoortweg,2023-04-17,06:00:00,143,97,46,FMN 08 Schijnpoortweg
675,Schijnpoortweg,2023-04-17,07:00:00,289,207,82,FMN 08 Schijnpoortweg
675,Schijnpoortweg,2023-04-17,08:00:00,343,259,84,FMN 08 Schijnpoortweg
675,Schijnpoortweg,2023-04-17,09:00:00,160,118,42,FMN 08 Schijnpoortweg
675,Schijnpoortweg,2023-04-17,10:00:00,132,91,41,FMN 08 Schijnpoortweg
675,Schijnpoortweg,2023-04-17,11:00:00,132,83,49,FMN 08 Schijnpoortweg
675,Schijnpoortweg,2023-04-17,12:00:00,181,113,68,FMN 08 Schijnpoortweg
675,Schijnpoortweg,2023-04-17,13:00:00,167,101,66,FMN 08 Schijnpoortweg
675,Schijnpoortweg,2023-04-17,14:00:00,180,115,65,FMN 08 Schijnpoortweg
675,Schijnpoortweg,2023-04-17,15:00:00,238,135,103,FMN 08 Schijnpoortweg
675,Schijnpoortweg,2023-04-17,16:00:00,352,222,130,FMN 08 Schijnpoortweg
675,Schijnpoortweg,2023-04-17,17:00:00,331,188,143,FMN 08 Schijnpoortweg
675,Schijnpoortweg,2023-04-17,18:00:00,248,138,110,FMN 08 Schijnpoortweg
675,Schijnpoortweg,2023-04-17,19:00:00,187,110,77,FMN 08 Schijnpoortweg
675,Schijnpoortweg,2023-04-17,20:00:00,140,76,64,FMN 08 Schijnpoortweg
675,Schijnpoortweg,2023-04-17,21:00:00,116,58,58,FMN 08 Schijnpoortweg
675,Schijnpoortweg,2023-04-17,22:00:00,110,54,56,FMN 08 Schijnpoortweg
675,Schijnpoortweg,2023-04-17,23:00:00,69,40,29,FMN 08 Schijnpoortweg
675,Schijnpoortweg,2023-04-18,00:00:00,30,13,17,FMN 08 Schijnpoortweg
675,Schijnpoortweg,2023-04-18,01:00:00,15,7,8,FMN 08 Schijnpoortweg
675,Schijnpoortweg,2023-04-18,02:00:00,12,3,9,FMN 08 Schijnpoortweg
675,Schijnpoortweg,2023-04-18,03:00:00,18,11,7,FMN 08 Schijnpoortweg
675,Schijnpoortweg,2023-04-18,04:00:00,33,19,14,FMN 08 Schijnpoortweg
675,Schijnpoortweg,2023-04-18,05:00:00,67,31,36,FMN 08 Schijnpoortweg
675,Schijnpoortweg,2023-04-18,06:00:00,141,103,38,FMN 08 Schijnpoortweg
675,Schijnpoortweg,2023-04-18,07:00:00,302,219,83,FMN 08 Schijnpoortweg
675,Schijnpoortweg,2023-04-18,08:00:00,389,290,99,FMN 08 Schijnpoortweg
675,Schijnpoortweg,2023-04-18,09:00:00,170,125,45,FMN 08 Schijnpoortweg
675,Schijnpoortweg,2023-04-18,10:00:00,138,89,49,FMN 08 Schijnpoortweg
675,Schijnpoortweg,2023-04-18,11:00:00,145,92,53,FMN 08 Schijnpoortweg
675,Schijnpoortweg,2023-04-18,12:00:00,184,122,62,FMN 08 Schijnpoortweg
675,Schijnpoortweg,2023-04-18,13:00:00,182,117,65,FMN 08 Schijnpoortweg
675,Schijnpoortweg,2023-04-18,14:00:00,200,127,73,FMN 08 Schijnpoortweg
675,Schijnpoortweg,2023-04-18,15:00:00,255,142,113,FMN 08 Schijnpoortweg
675,Schijnpoortweg,2023-04-18,16:00:00,358,221,137,FMN 08 Schijnpoortweg
675,Schijnpoortweg,2023-04-18,17:00:00,357,211,146,FMN 08 Schijnpoortweg
675,Schijnpoortweg,2023-04-18,18:00:00,266,155,111,FMN 08 Schijnpoortweg
675,Schijnpoortweg,2023-04-18,19:00:00,191,99,92,FMN 08 Schijnpoortweg
675,Schijnpoortweg,2023-04-18,20:00:00,144,80,64,FMN 08 Schijnpoortweg
675,Schijnpoortweg,2023-04-18,21:00:00,109,65,44,FMN 08 Schijnpoortweg
675,Schijnpoortweg,2023-04-18,22:00:00,115,67,48,FMN 08 Schijnpoortweg
675,Schijnpoortweg,2023-04-18,23:00:00,56,34,22,FMN 08 Schijnpoortweg
675,Schijnpoortweg,2023-04-19,00:00:00,33,18,15,FMN 08 Schijnpoortweg
675,Schijnpoortweg,2023-04-19,01:00:00,17,7,10,FMN 08 Schijnpoortweg
675,Schijnpoortweg,2023-04-19,02:00:00,13,4,9,FMN 08 Schijnpoortweg
675,Schijnpoortweg,2023-04-19,03:00:00,12,9,3,FMN 08 Schijnpoortweg
675,Schijnpoortweg,2023-04-19,04:00:00,34,22,12,FMN 08 Schijnpoortweg
675,Schijnpoortweg,2023-04-19,05:00:00,71,36,35,FMN 08 Schijnpoortweg
675,Schijnpoortweg,2023-04-19,06:00:00,139,95,44,FMN 08 Schijnpoortweg
675,Schijnpoortweg,2023-04-19,07:00:00,265,184,81,FMN 08 Schijnpoortweg
675,Schijnpoortweg,2023-04-19,08:00:00,353,254,99,FMN 08 Schijnpoortweg
675,Schijnpoortweg,2023-04-19,09:00:00,170,119,51,FMN 08 Schijnpoortweg
675,Schijnpoortweg,2023-04-19,10:00:00,142,94,48,FMN 08 Schijnpoortweg
675,Schijnpoortweg,2023-04-19,11:00:00,150,96,54,FMN 08 Schijnpoortweg
675,Schijnpoortweg,2023-04-19,12:00:00,239,138,101,FMN 08 Schijnpoortweg
675,Schijnpoortweg,2023-04-19,13:00:00,190,114,76,FMN 08 Schijnpoortweg
675,Schijnpoortweg,2023-04-19,14:00:00,215,132,83,FMN 08 Schijnpoortweg
675,Schijnpoortweg,2023-04-19,15:00:00,235,138,97,FMN 08 Schijnpoortweg
675,Schijnpoortweg,2023-04-19,16:00:00,336,211,125,FMN 08 Schijnpoortweg
675,Schijnpoortweg,2023-04-19,17:00:00,327,196,131,FMN 08 Schijnpoortweg
675,Schijnpoortweg,2023-04-19,18:00:00,244,141,103,FMN 08 Schijnpoortweg
675,Schijnpoortweg,2023-04-19,19:00:00,186,101,85,FMN 08 Schijnpoortweg
675,Schijnpoortweg,2023-04-19,20:00:00,146,80,66,FMN 08 Schijnpoortweg
675,Schijnpoortweg,2023-04-19,21:00:00,110,57,53,FMN 08 Schijnpoortweg
675,Schijnpoortweg,2023-04-19,22:00:00,103,63,40,FMN 08 Schijnpoortweg
675,Schijnpoortweg,2023-04-19,23:00:00,71,39,32,FMN 08 Schijnpoortweg
675,Schijnpoortweg,2023-04-20,00:00:00,27,12,15,FMN 08 Schijnpoortweg
675,Schijnpoortweg,2023-04-20,01:00:00,18,10,8,FMN 08 Schijnpoortweg
675,Schijnpoortweg,2023-04-20,02:00:00,12,5,7,FMN 08 Schijnpoortweg
675,Schijnpoortweg,2023-04-20,03:00:00,21,14,7,FMN 08 Schijnpoortweg
675,Schijnpoortweg,2023-04-20,04:00:00,36,20,16,FMN 08 Schijnpoortweg
675,Schijnpoortweg,2023-04-20,05:00:00,66,35,31,FMN 08 Schijnpoortweg
675,Schijnpoortweg,2023-04-20,06:00:00,109,70,39,FMN 08 Schijnpoortweg
675,Schijnpoortweg,2023-04-20,07:00:00,251,180,71,FMN 08 Schijnpoortweg
675,Schijnpoortweg,2023-04-20,08:00:00,332,255,77,FMN 08 Schijnpoortweg
675,Schijnpoortweg,2023-04-20,09:00:00,154,106,48,FMN 08 Schijnpoortweg
675,Schijnpoortweg,2023-04-20,10:00:00,137,88,49,FMN 08 Schijnpoortweg
675,Schijnpoortweg,2023-04-20,11:00:00,128,87,41,FMN 08 Schijnpoortweg
675,Schijnpoortweg,2023-04-20,12:00:00,155,105,50,FMN 08 Schijnpoortweg
675,Schijnpoortweg,2023-04-20,13:00:00,157,94,63,FMN 08 Schijnpoortweg
675,Schijnpoortweg,2023-04-20,14:00:00,174,101,73,FMN 08 Schijnpoortweg
675,Schijnpoortweg,2023-04-20,15:00:00,224,121,103,FMN 08 Schijnpoortweg
675,Schijnpoortweg,2023-04-20,16:00:00,310,193,117,FMN 08 Schijnpoortweg
675,Schijnpoortweg,2023-04-20,17:00:00,309,168,141,FMN 08 Schijnpoortweg
675,Schijnpoortweg,2023-04-20,18:00:00,241,139,102,FMN 08 Schijnpoortweg
675,Schijnpoortweg,2023-04-20,19:00:00,193,105,88,FMN 08 Schijnpoortweg
675,Schijnpoortweg,2023-04-20,20:00:00,138,67,71,FMN 08 Schijnpoortweg
675,Schijnpoortweg,2023-04-20,21:00:00,105,55,50,FMN 08 Schijnpoortweg
675,Schijnpoortweg,2023-04-20,22:00:00,108,62,46,FMN 08 Schijnpoortweg
675,Schijnpoortweg,2023-04-20,23:00:00,83,45,38,FMN 08 Schijnpoortweg
675,Schijnpoortweg,2023-04-21,00:00:00,30,14,16,FMN 08 Schijnpoortweg
675,Schijnpoortweg,2023-04-21,01:00:00,27,11,16,FMN 08 Schijnpoortweg
675,Schijnpoortweg,2023-04-21,02:00:00,17,7,10,FMN 08 Schijnpoortweg
675,Schijnpoortweg,2023-04-21,03:00:00,17,8,9,FMN 08 Schijnpoortweg
675,Schijnpoortweg,2023-04-21,04:00:00,27,17,10,FMN 08 Schijnpoortweg
675,Schijnpoortweg,2023-04-21,05:00:00,51,26,25,FMN 08 Schijnpoortweg
675,Schijnpoortweg,2023-04-21,06:00:00,118,74,44,FMN 08 Schijnpoortweg
675,Schijnpoortweg,2023-04-21,07:00:00,229,151,78,FMN 08 Schijnpoortweg
675,Schijnpoortweg,2023-04-21,08:00:00,273,203,70,FMN 08 Schijnpoortweg
675,Schijnpoortweg,2023-04-21,09:00:00,140,100,40,FMN 08 Schijnpoortweg
675,Schijnpoortweg,2023-04-21,10:00:00,130,90,40,FMN 08 Schijnpoortweg
675,Schijnpoortweg,2023-04-21,11:00:00,133,89,44,FMN 08 Schijnpoortweg
675,Schijnpoortweg,2023-04-21,12:00:00,172,110,62,FMN 08 Schijnpoortweg
675,Schijnpoortweg,2023-04-21,13:00:00,173,109,64,FMN 08 Schijnpoortweg
675,Schijnpoortweg,2023-04-21,14:00:00,196,126,70,FMN 08 Schijnpoortweg
675,Schijnpoortweg,2023-04-21,15:00:00,234,134,100,FMN 08 Schijnpoortweg
675,Schijnpoortweg,2023-04-21,16:00:00,299,169,130,FMN 08 Schijnpoortweg
675,Schijnpoortweg,2023-04-21,17:00:00,257,157,100,FMN 08 Schijnpoortweg
675,Schijnpoortweg,2023-04-21,18:00:00,227,134,93,FMN 08 Schijnpoortweg
675,Schijnpoortweg,2023-04-21,19:00:00,201,102,99,FMN 08 Schijnpoortweg
675,Schijnpoortweg,2023-04-21,20:00:00,150,78,72,FMN 08 Schijnpoortweg
675,Schijnpoortweg,2023-04-21,21:00:00,114,66,48,FMN 08 Schijnpoortweg
675,Schijnpoortweg,2023-04-21,22:00:00,120,73,47,FMN 08 Schijnpoortweg
675,Schijnpoortweg,2023-04-21,23:00:00,123,75,48,FMN 08 Schijnpoortweg
675,Schijnpoortweg,2023-04-22,00:00:00,50,23,27,FMN 08 Schijnpoortweg
675,Schijnpoortweg,2023-04-22,01:00:00,27,12,15,FMN 08 Schijnpoortweg
675,Schijnpoortweg,2023-04-22,02:00:00,22,8,14,FMN 08 Schijnpoortweg
675,Schijnpoortweg,2023-04-22,03:00:00,14,7,7,FMN 08 Schijnpoortweg
675,Schijnpoortweg,2023-04-22,04:00:00,20,11,9,FMN 08 Schijnpoortweg
675,Schijnpoortweg,2023-04-22,05:00:00,14,6,8,FMN 08 Schijnpoortweg
675,Schijnpoortweg,2023-04-22,06:00:00,27,20,7,FMN 08 Schijnpoortweg
675,Schijnpoortweg,2023-04-22,07:00:00,25,13,12,FMN 08 Schijnpoortweg
675,Schijnpoortweg,2023-04-22,08:00:00,47,30,17,FMN 08 Schijnpoortweg
675,Schijnpoortweg,2023-04-22,09:00:00,64,44,20,FMN 08 Schijnpoortweg
675,Schijnpoortweg,2023-04-22,10:00:00,86,59,27,FMN 08 Schijnpoortweg
675,Schijnpoortweg,2023-04-22,11:00:00,99,63,36,FMN 08 Schijnpoortweg
675,Schijnpoortweg,2023-04-22,12:00:00,87,60,27,FMN 08 Schijnpoortweg
675,Schijnpoortweg,2023-04-22,13:00:00,129,85,44,FMN 08 Schijnpoortweg
675,Schijnpoortweg,2023-04-22,14:00:00,123,73,50,FMN 08 Schijnpoortweg
675,Schijnpoortweg,2023-04-22,15:00:00,109,58,51,FMN 08 Schijnpoortweg
675,Schijnpoortweg,2023-04-22,16:00:00,117,72,45,FMN 08 Schijnpoortweg
675,Schijnpoortweg,2023-04-22,17:00:00,131,77,54,FMN 08 Schijnpoortweg
675,Schijnpoortweg,2023-04-22,18:00:00,118,77,41,FMN 08 Schijnpoortweg
675,Schijnpoortweg,2023-04-22,19:00:00,129,72,57,FMN 08 Schijnpoortweg
675,Schijnpoortweg,2023-04-22,20:00:00,106,55,51,FMN 08 Schijnpoortweg
675,Schijnpoortweg,2023-04-22,21:00:00,76,42,34,FMN 08 Schijnpoortweg
675,Schijnpoortweg,2023-04-22,22:00:00,65,40,25,FMN 08 Schijnpoortweg
675,Schijnpoortweg,2023-04-22,23:00:00,79,47,32,FMN 08 Schijnpoortweg
675,Schijnpoortweg,2023-04-23,00:00:00,33,18,15,FMN 08 Schijnpoortweg
675,Schijnpoortweg,2023-04-23,01:00:00,26,13,13,FMN 08 Schijnpoortweg
675,Schijnpoortweg,2023-04-23,02:00:00,19,7,12,FMN 08 Schijnpoortweg
675,Schijnpoortweg,2023-04-23,03:00:00,11,5,6,FMN 08 Schijnpoortweg
675,Schijnpoortweg,2023-04-23,04:00:00,6,4,2,FMN 08 Schijnpoortweg
675,Schijnpoortweg,2023-04-23,05:00:00,10,6,4,FMN 08 Schijnpoortweg
675,Schijnpoortweg,2023-04-23,06:00:00,16,11,5,FMN 08 Schijnpoortweg
675,Schijnpoortweg,2023-04-23,07:00:00,15,9,6,FMN 08 Schijnpoortweg
675,Schijnpoortweg,2023-04-23,08:00:00,20,14,6,FMN 08 Schijnpoortweg
675,Schijnpoortweg,2023-04-23,09:00:00,52,37,15,FMN 08 Schijnpoortweg
675,Schijnpoortweg,2023-04-23,10:00:00,61,41,20,FMN 08 Schijnpoortweg
675,Schijnpoortweg,2023-04-23,11:00:00,84,52,32,FMN 08 Schijnpoortweg
675,Schijnpoortweg,2023-04-23,12:00:00,77,48,29,FMN 08 Schijnpoortweg
675,Schijnpoortweg,2023-04-23,13:00:00,94,56,38,FMN 08 Schijnpoortweg
675,Schijnpoortweg,2023-04-23,14:00:00,102,61,41,FMN 08 Schijnpoortweg
675,Schijnpoortweg,2023-04-23,15:00:00,110,66,44,FMN 08 Schijnpoortweg
675,Schijnpoortweg,2023-04-23,16:00:00,97,57,40,FMN 08 Schijnpoortweg
675,Schijnpoortweg,2023-04-23,17:00:00,102,60,42,FMN 08 Schijnpoortweg
675,Schijnpoortweg,2023-04-23,18:00:00,100,65,35,FMN 08 Schijnpoortweg
675,Schijnpoortweg,2023-04-23,19:00:00,68,38,30,FMN 08 Schijnpoortweg
675,Schijnpoortweg,2023-04-23,20:00:00,83,46,37,FMN 08 Schijnpoortweg
675,Schijnpoortweg,2023-04-23,21:00:00,59,33,26,FMN 08 Schijnpoortweg
675,Schijnpoortweg,2023-04-23,22:00:00,49,28,21,FMN 08 Schijnpoortweg
675,Schijnpoortweg,2023-04-23,23:00:00,34,21,13,FMN 08 Schijnpoortweg
675,Schijnpoortweg,2023-04-24,00:00:00,24,10,14,FMN 08 Schijnpoortweg
675,Schijnpoortweg,2023-04-24,01:00:00,11,6,5,FMN 08 Schijnpoortweg
675,Schijnpoortweg,2023-04-24,02:00:00,14,9,5,FMN 08 Schijnpoortweg
675,Schijnpoortweg,2023-04-24,03:00:00,14,7,7,FMN 08 Schijnpoortweg
675,Schijnpoortweg,2023-04-24,04:00:00,32,17,15,FMN 08 Schijnpoortweg
675,Schijnpoortweg,2023-04-24,05:00:00,53,31,22,FMN 08 Schijnpoortweg
675,Schijnpoortweg,2023-04-24,06:00:00,105,73,32,FMN 08 Schijnpoortweg
675,Schijnpoortweg,2023-04-24,07:00:00,226,159,67,FMN 08 Schijnpoortweg
675,Schijnpoortweg,2023-04-24,08:00:00,303,233,70,FMN 08 Schijnpoortweg
675,Schijnpoortweg,2023-04-24,09:00:00,139,96,43,FMN 08 Schijnpoortweg
675,Schijnpoortweg,2023-04-24,10:00:00,120,78,42,FMN 08 Schijnpoortweg
675,Schijnpoortweg,2023-04-24,11:00:00,111,70,41,FMN 08 Schijnpoortweg
675,Schijnpoortweg,2023-04-24,12:00:00,148,94,54,FMN 08 Schijnpoortweg
675,Schijnpoortweg,2023-04-24,13:00:00,119,76,43,FMN 08 Schijnpoortweg
675,Schijnpoortweg,2023-04-24,14:00:00,159,94,65,FMN 08 Schijnpoortweg
675,Schijnpoortweg,2023-04-24,15:00:00,207,113,94,FMN 08 Schijnpoortweg
675,Schijnpoortweg,2023-04-24,16:00:00,311,189,122,FMN 08 Schijnpoortweg
675,Schijnpoortweg,2023-04-24,17:00:00,272,147,125,FMN 08 Schijnpoortweg
675,Schijnpoortweg,2023-04-24,18:00:00,200,120,80,FMN 08 Schijnpoortweg
675,Schijnpoortweg,2023-04-24,19:00:00,158,90,68,FMN 08 Schijnpoortweg
675,Schijnpoortweg,2023-04-24,20:00:00,132,78,54,FMN 08 Schijnpoortweg
675,Schijnpoortweg,2023-04-24,21:00:00,89,51,38,FMN 08 Schijnpoortweg
675,Schijnpoortweg,2023-04-24,22:00:00,89,51,38,FMN 08 Schijnpoortweg
675,Schijnpoortweg,2023-04-24,23:00:00,61,32,29,FMN 08 Schijnpoortweg
675,Schijnpoortweg,2023-04-25,00:00:00,23,8,15,FMN 08 Schijnpoortweg
675,Schijnpoortweg,2023-04-25,01:00:00,20,11,9,FMN 08 Schijnpoortweg
675,Schijnpoortweg,2023-04-25,02:00:00,12,7,5,FMN 08 Schijnpoortweg
675,Schijnpoortweg,2023-04-25,03:00:00,8,6,2,FMN 08 Schijnpoortweg
675,Schijnpoortweg,2023-04-25,04:00:00,26,14,12,FMN 08 Schijnpoortweg
675,Schijnpoortweg,2023-04-25,05:00:00,56,27,29,FMN 08 Schijnpoortweg
675,Schijnpoortweg,2023-04-25,06:00:00,133,87,46,FMN 08 Schijnpoortweg
675,Schijnpoortweg,2023-04-25,07:00:00,282,199,83,FMN 08 Schijnpoortweg
675,Schijnpoortweg,2023-04-25,08:00:00,370,278,92,FMN 08 Schijnpoortweg
675,Schijnpoortweg,2023-04-25,09:00:00,161,114,47,FMN 08 Schijnpoortweg
675,Schijnpoortweg,2023-04-25,10:00:00,118,85,33,FMN 08 Schijnpoortweg
675,Schijnpoortweg,2023-04-25,11:00:00,139,90,49,FMN 08 Schijnpoortweg
675,Schijnpoortweg,2023-04-25,12:00:00,167,106,61,FMN 08 Schijnpoortweg
675,Schijnpoortweg,2023-04-25,13:00:00,173,111,62,FMN 08 Schijnpoortweg
675,Schijnpoortweg,2023-04-25,14:00:00,168,101,67,FMN 08 Schijnpoortweg
675,Schijnpoortweg,2023-04-25,15:00:00,237,129,108,FMN 08 Schijnpoortweg
675,Schijnpoortweg,2023-04-25,16:00:00,362,220,142,FMN 08 Schijnpoortweg
675,Schijnpoortweg,2023-04-25,17:00:00,351,198,153,FMN 08 Schijnpoortweg
675,Schijnpoortweg,2023-04-25,18:00:00,262,145,117,FMN 08 Schijnpoortweg
675,Schijnpoortweg,2023-04-25,19:00:00,184,99,85,FMN 08 Schijnpoortweg
675,Schijnpoortweg,2023-04-25,20:00:00,142,78,64,FMN 08 Schijnpoortweg
675,Schijnpoortweg,2023-04-25,21:00:00,114,59,55,FMN 08 Schijnpoortweg
675,Schijnpoortweg,2023-04-25,22:00:00,117,67,50,FMN 08 Schijnpoortweg
675,Schijnpoortweg,2023-04-25,23:00:00,72,37,35,FMN 08 Schijnpoortweg
675,Schijnpoortweg,2023-04-26,00:00:00,26,9,17,FMN 08 Schijnpoortweg
675,Schijnpoortweg,2023-04-26,01:00:00,13,8,5,FMN 08 Schijnpoortweg
675,Schijnpoortweg,2023-04-26,02:00:00,17,10,7,FMN 08 Schijnpoortweg
675,Schijnpoortweg,2023-04-26,03:00:00,10,8,2,FMN 08 Schijnpoortweg
675,Schijnpoortweg,2023-04-26,04:00:00,37,24,13,FMN 08 Schijnpoortweg
675,Schijnpoortweg,2023-04-26,05:00:00,81,41,40,FMN 08 Schijnpoortweg
675,Schijnpoortweg,2023-04-26,06:00:00,125,89,36,FMN 08 Schijnpoortweg
675,Schijnpoortweg,2023-04-26,07:00:00,272,195,77,FMN 08 Schijnpoortweg
675,Schijnpoortweg,2023-04-26,08:00:00,325,239,86,FMN 08 Schijnpoortweg
675,Schijnpoortweg,2023-04-26,09:00:00,142,103,39,FMN 08 Schijnpoortweg
675,Schijnpoortweg,2023-04-26,10:00:00,139,99,40,FMN 08 Schijnpoortweg
675,Schijnpoortweg,2023-04-26,11:00:00,146,92,54,FMN 08 Schijnpoortweg
675,Schijnpoortweg,2023-04-26,12:00:00,242,150,92,FMN 08 Schijnpoortweg
675,Schijnpoortweg,2023-04-26,13:00:00,200,113,87,FMN 08 Schijnpoortweg
675,Schijnpoortweg,2023-04-26,14:00:00,199,115,84,FMN 08 Schijnpoortweg
675,Schijnpoortweg,2023-04-26,15:00:00,221,126,95,FMN 08 Schijnpoortweg
675,Schijnpoortweg,2023-04-26,16:00:00,321,200,121,FMN 08 Schijnpoortweg
675,Schijnpoortweg,2023-04-26,17:00:00,320,186,134,FMN 08 Schijnpoortweg
675,Schijnpoortweg,2023-04-26,18:00:00,245,150,95,FMN 08 Schijnpoortweg
675,Schijnpoortweg,2023-04-26,19:00:00,191,103,88,FMN 08 Schijnpoortweg
675,Schijnpoortweg,2023-04-26,20:00:00,144,84,60,FMN 08 Schijnpoortweg
675,Schijnpoortweg,2023-04-26,21:00:00,110,51,59,FMN 08 Schijnpoortweg
675,Schijnpoortweg,2023-04-26,22:00:00,119,67,52,FMN 08 Schijnpoortweg
675,Schijnpoortweg,2023-04-26,23:00:00,78,37,41,FMN 08 Schijnpoortweg
675,Schijnpoortweg,2023-04-27,00:00:00,52,27,25,FMN 08 Schijnpoortweg
675,Schijnpoortweg,2023-04-27,01:00:00,26,11,15,FMN 08 Schijnpoortweg
675,Schijnpoortweg,2023-04-27,02:00:00,13,5,8,FMN 08 Schijnpoortweg
675,Schijnpoortweg,2023-04-27,03:00:00,15,9,6,FMN 08 Schijnpoortweg
675,Schijnpoortweg,2023-04-27,04:00:00,22,15,7,FMN 08 Schijnpoortweg
675,Schijnpoortweg,2023-04-27,05:00:00,70,37,33,FMN 08 Schijnpoortweg
675,Schijnpoortweg,2023-04-27,06:00:00,141,93,48,FMN 08 Schijnpoortweg
675,Schijnpoortweg,2023-04-27,07:00:00,287,206,81,FMN 08 Schijnpoortweg
675,Schijnpoortweg,2023-04-27,08:00:00,377,277,100,FMN 08 Schijnpoortweg
675,Schijnpoortweg,2023-04-27,09:00:00,155,107,48,FMN 08 Schijnpoortweg
675,Schijnpoortweg,2023-04-27,10:00:00,133,93,40,FMN 08 Schijnpoortweg
675,Schijnpoortweg,2023-04-27,11:00:00,144,93,51,FMN 08 Schijnpoortweg
675,Schijnpoortweg,2023-04-27,12:00:00,200,132,68,FMN 08 Schijnpoortweg
675,Schijnpoortweg,2023-04-27,13:00:00,178,111,67,FMN 08 Schijnpoortweg
675,Schijnpoortweg,2023-04-27,14:00:00,197,118,79,FMN 08 Schijnpoortweg
675,Schijnpoortweg,2023-04-27,15:00:00,246,137,109,FMN 08 Schijnpoortweg
675,Schijnpoortweg,2023-04-27,16:00:00,368,222,146,FMN 08 Schijnpoortweg
675,Schijnpoortweg,2023-04-27,17:00:00,350,191,159,FMN 08 Schijnpoortweg
675,Schijnpoortweg,2023-04-27,18:00:00,275,162,113,FMN 08 Schijnpoortweg
675,Schijnpoortweg,2023-04-27,19:00:00,210,107,103,FMN 08 Schijnpoortweg
675,Schijnpoortweg,2023-04-27,20:00:00,168,84,84,FMN 08 Schijnpoortweg
675,Schijnpoortweg,2023-04-27,21:00:00,122,64,58,FMN 08 Schijnpoortweg
675,Schijnpoortweg,2023-04-27,22:00:00,120,70,50,FMN 08 Schijnpoortweg
675,Schijnpoortweg,2023-04-27,23:00:00,89,53,36,FMN 08 Schijnpoortweg
675,Schijnpoortweg,2023-04-28,00:00:00,39,20,19,FMN 08 Schijnpoortweg
675,Schijnpoortweg,2023-04-28,01:00:00,14,7,7,FMN 08 Schijnpoortweg
675,Schijnpoortweg,2023-04-28,02:00:00,12,6,6,FMN 08 Schijnpoortweg
675,Schijnpoortweg,2023-04-28,03:00:00,12,5,7,FMN 08 Schijnpoortweg
675,Schijnpoortweg,2023-04-28,04:00:00,28,9,19,FMN 08 Schijnpoortweg
675,Schijnpoortweg,2023-04-28,05:00:00,63,32,31,FMN 08 Schijnpoortweg
675,Schijnpoortweg,2023-04-28,06:00:00,118,74,44,FMN 08 Schijnpoortweg
675,Schijnpoortweg,2023-04-28,07:00:00,232,157,75,FMN 08 Schijnpoortweg
675,Schijnpoortweg,2023-04-28,08:00:00,293,210,83,FMN 08 Schijnpoortweg
675,Schijnpoortweg,2023-04-28,09:00:00,144,104,40,FMN 08 Schijnpoortweg
675,Schijnpoortweg,2023-04-28,10:00:00,126,90,36,FMN 08 Schijnpoortweg
675,Schijnpoortweg,2023-04-28,11:00:00,140,94,46,FMN 08 Schijnpoortweg
675,Schijnpoortweg,2023-04-28,12:00:00,177,113,64,FMN 08 Schijnpoortweg
675,Schijnpoortweg,2023-04-28,13:00:00,167,110,57,FMN 08 Schijnpoortweg
675,Schijnpoortweg,2023-04-28,14:00:00,201,126,75,FMN 08 Schijnpoortweg
675,Schijnpoortweg,2023-04-28,15:00:00,233,128,105,FMN 08 Schijnpoortweg
675,Schijnpoortweg,2023-04-28,16:00:00,288,166,122,FMN 08 Schijnpoortweg
675,Schijnpoortweg,2023-04-28,17:00:00,256,151,105,FMN 08 Schijnpoortweg
675,Schijnpoortweg,2023-04-28,18:00:00,239,145,94,FMN 08 Schijnpoortweg
675,Schijnpoortweg,2023-04-28,19:00:00,210,108,102,FMN 08 Schijnpoortweg
675,Schijnpoortweg,2023-04-28,20:00:00,155,78,77,FMN 08 Schijnpoortweg
675,Schijnpoortweg,2023-04-28,21:00:00,112,56,56,FMN 08 Schijnpoortweg
675,Schijnpoortweg,2023-04-28,22:00:00,120,67,53,FMN 08 Schijnpoortweg
675,Schijnpoortweg,2023-04-28,23:00:00,106,60,46,FMN 08 Schijnpoortweg
675,Schijnpoortweg,2023-04-29,00:00:00,43,26,17,FMN 08 Schijnpoortweg
675,Schijnpoortweg,2023-04-29,01:00:00,34,13,21,FMN 08 Schijnpoortweg
675,Schijnpoortweg,2023-04-29,02:00:00,18,6,12,FMN 08 Schijnpoortweg
675,Schijnpoortweg,2023-04-29,03:00:00,29,14,15,FMN 08 Schijnpoortweg
675,Schijnpoortweg,2023-04-29,04:00:00,16,7,9,FMN 08 Schijnpoortweg
675,Schijnpoortweg,2023-04-29,05:00:00,23,16,7,FMN 08 Schijnpoortweg
675,Schijnpoortweg,2023-04-29,06:00:00,30,17,13,FMN 08 Schijnpoortweg
675,Schijnpoortweg,2023-04-29,07:00:00,32,18,14,FMN 08 Schijnpoortweg
675,Schijnpoortweg,2023-04-29,08:00:00,66,44,22,FMN 08 Schijnpoortweg
675,Schijnpoortweg,2023-04-29,09:00:00,92,63,29,FMN 08 Schijnpoortweg
675,Schijnpoortweg,2023-04-29,10:00:00,104,73,31,FMN 08 Schijnpoortweg
675,Schijnpoortweg,2023-04-29,11:00:00,120,70,50,FMN 08 Schijnpoortweg
675,Schijnpoortweg,2023-04-29,12:00:00,131,83,48,FMN 08 Schijnpoortweg
675,Schijnpoortweg,2023-04-29,13:00:00,166,105,61,FMN 08 Schijnpoortweg
675,Schijnpoortweg,2023-04-29,14:00:00,162,101,61,FMN 08 Schijnpoortweg
675,Schijnpoortweg,2023-04-29,15:00:00,147,91,56,FMN 08 Schijnpoortweg
675,Schijnpoortweg,2023-04-29,16:00:00,150,91,59,FMN 08 Schijnpoortweg
675,Schijnpoortweg,2023-04-29,17:00:00,158,96,62,FMN 08 Schijnpoortweg
675,Schijnpoortweg,2023-04-29,18:00:00,156,96,60,FMN 08 Schijnpoortweg
675,Schijnpoortweg,2023-04-29,19:00:00,149,75,74,FMN 08 Schijnpoortweg
675,Schijnpoortweg,2023-04-29,20:00:00,114,70,44,FMN 08 Schijnpoortweg
675,Schijnpoortweg,2023-04-29,21:00:00,84,44,40,FMN 08 Schijnpoortweg
675,Schijnpoortweg,2023-04-29,22:00:00,98,56,42,FMN 08 Schijnpoortweg
675,Schijnpoortweg,2023-04-29,23:00:00,87,50,37,FMN 08 Schijnpoortweg
675,Schijnpoortweg,2023-04-30,00:00:00,48,18,30,FMN 08 Schijnpoortweg
675,Schijnpoortweg,2023-04-30,01:00:00,27,10,17,FMN 08 Schijnpoortweg
675,Schijnpoortweg,2023-04-30,02:00:00,21,8,13,FMN 08 Schijnpoortweg
675,Schijnpoortweg,2023-04-30,03:00:00,21,11,10,FMN 08 Schijnpoortweg
675,Schijnpoortweg,2023-04-30,04:00:00,12,7,5,FMN 08 Schijnpoortweg
675,Schijnpoortweg,2023-04-30,05:00:00,17,12,5,FMN 08 Schijnpoortweg
675,Schijnpoortweg,2023-04-30,06:00:00,17,13,4,FMN 08 Schijnpoortweg
675,Schijnpoortweg,2023-04-30,07:00:00,18,15,3,FMN 08 Schijnpoortweg
675,Schijnpoortweg,2023-04-30,08:00:00,29,18,11,FMN 08 Schijnpoortweg
675,Schijnpoortweg,2023-04-30,09:00:00,65,47,18,FMN 08 Schijnpoortweg
675,Schijnpoortweg,2023-04-30,10:00:00,99,67,32,FMN 08 Schijnpoortweg
675,Schijnpoortweg,2023-04-30,11:00:00,105,71,34,FMN 08 Schijnpoortweg
675,Schijnpoortweg,2023-04-30,12:00:00,107,68,39,FMN 08 Schijnpoortweg
675,Schijnpoortweg,2023-04-30,13:00:00,135,85,50,FMN 08 Schijnpoortweg
675,Schijnpoortweg,2023-04-30,14:00:00,145,91,54,FMN 08 Schijnpoortweg
675,Schijnpoortweg,2023-04-30,15:00:00,128,80,48,FMN 08 Schijnpoortweg
675,Schijnpoortweg,2023-04-30,16:00:00,144,88,56,FMN 08 Schijnpoortweg
675,Schijnpoortweg,2023-04-30,17:00:00,137,76,61,FMN 08 Schijnpoortweg
675,Schijnpoortweg,2023-04-30,18:00:00,121,75,46,FMN 08 Schijnpoortweg
675,Schijnpoortweg,2023-04-30,19:00:00,112,61,51,FMN 08 Schijnpoortweg
675,Schijnpoortweg,2023-04-30,20:00:00,90,53,37,FMN 08 Schijnpoortweg
675,Schijnpoortweg,2023-04-30,21:00:00,66,42,24,FMN 08 Schijnpoortweg
675,Schijnpoortweg,2023-04-30,22:00:00,75,43,32,FMN 08 Schijnpoortweg
675,Schijnpoortweg,2023-04-30,23:00:00,46,25,21,FMN 08 Schijnpoortweg
675,Schijnpoortweg,2023-05-01,00:00:00,16,11,5,FMN 08 Schijnpoortweg
675,Schijnpoortweg,2023-05-01,01:00:00,10,3,7,FMN 08 Schijnpoortweg
675,Schijnpoortweg,2023-05-01,02:00:00,14,6,8,FMN 08 Schijnpoortweg
675,Schijnpoortweg,2023-05-01,03:00:00,7,4,3,FMN 08 Schijnpoortweg
675,Schijnpoortweg,2023-05-01,04:00:00,15,9,6,FMN 08 Schijnpoortweg
675,Schijnpoortweg,2023-05-01,05:00:00,36,15,21,FMN 08 Schijnpoortweg
675,Schijnpoortweg,2023-05-01,06:00:00,61,41,20,FMN 08 Schijnpoortweg
675,Schijnpoortweg,2023-05-01,07:00:00,153,109,44,FMN 08 Schijnpoortweg
675,Schijnpoortweg,2023-05-01,08:00:00,195,145,50,FMN 08 Schijnpoortweg
675,Schijnpoortweg,2023-05-01,09:00:00,89,68,21,FMN 08 Schijnpoortweg
675,Schijnpoortweg,2023-05-01,10:00:00,76,53,23,FMN 08 Schijnpoortweg
675,Schijnpoortweg,2023-05-01,11:00:00,66,41,25,FMN 08 Schijnpoortweg
675,Schijnpoortweg,2023-05-01,12:00:00,93,57,36,FMN 08 Schijnpoortweg
675,Schijnpoortweg,2023-05-01,13:00:00,87,51,36,FMN 08 Schijnpoortweg
675,Schijnpoortweg,2023-05-01,14:00:00,108,67,41,FMN 08 Schijnpoortweg
675,Schijnpoortweg,2023-05-01,15:00:00,125,74,51,FMN 08 Schijnpoortweg
675,Schijnpoortweg,2023-05-01,16:00:00,186,113,73,FMN 08 Schijnpoortweg
675,Schijnpoortweg,2023-05-01,17:00:00,169,90,79,FMN 08 Schijnpoortweg
675,Schijnpoortweg,2023-05-01,18:00:00,145,91,54,FMN 08 Schijnpoortweg
675,Schijnpoortweg,2023-05-01,19:00:00,111,65,46,FMN 08 Schijnpoortweg
675,Schijnpoortweg,2023-05-01,20:00:00,89,59,30,FMN 08 Schijnpoortweg
675,Schijnpoortweg,2023-05-01,21:00:00,59,34,25,FMN 08 Schijnpoortweg
675,Schijnpoortweg,2023-05-01,22:00:00,53,33,20,FMN 08 Schijnpoortweg
675,Schijnpoortweg,2023-05-01,23:00:00,31,19,12,FMN 08 Schijnpoortweg
675,Schijnpoortweg,2023-05-02,00:00:00,25,12,13,FMN 08 Schijnpoortweg
675,Schijnpoortweg,2023-05-02,01:00:00,15,6,9,FMN 08 Schijnpoortweg
675,Schijnpoortweg,2023-05-02,02:00:00,12,5,7,FMN 08 Schijnpoortweg
675,Schijnpoortweg,2023-05-02,03:00:00,16,9,7,FMN 08 Schijnpoortweg
675,Schijnpoortweg,2023-05-02,04:00:00,45,30,15,FMN 08 Schijnpoortweg
675,Schijnpoortweg,2023-05-02,05:00:00,88,44,44,FMN 08 Schijnpoortweg
675,Schijnpoortweg,2023-05-02,06:00:00,140,100,40,FMN 08 Schijnpoortweg
675,Schijnpoortweg,2023-05-02,07:00:00,302,219,83,FMN 08 Schijnpoortweg
675,Schijnpoortweg,2023-05-02,08:00:00,388,294,94,FMN 08 Schijnpoortweg
675,Schijnpoortweg,2023-05-02,09:00:00,170,124,46,FMN 08 Schijnpoortweg
675,Schijnpoortweg,2023-05-02,10:00:00,134,90,44,FMN 08 Schijnpoortweg
675,Schijnpoortweg,2023-05-02,11:00:00,136,90,46,FMN 08 Schijnpoortweg
675,Schijnpoortweg,2023-05-02,12:00:00,196,130,66,FMN 08 Schijnpoortweg
675,Schijnpoortweg,2023-05-02,13:00:00,179,113,66,FMN 08 Schijnpoortweg
675,Schijnpoortweg,2023-05-02,14:00:00,197,120,77,FMN 08 Schijnpoortweg
675,Schijnpoortweg,2023-05-02,15:00:00,235,128,107,FMN 08 Schijnpoortweg
675,Schijnpoortweg,2023-05-02,16:00:00,382,233,149,FMN 08 Schijnpoortweg
675,Schijnpoortweg,2023-05-02,17:00:00,354,195,159,FMN 08 Schijnpoortweg
675,Schijnpoortweg,2023-05-02,18:00:00,253,148,105,FMN 08 Schijnpoortweg
675,Schijnpoortweg,2023-05-02,19:00:00,208,114,94,FMN 08 Schijnpoortweg
675,Schijnpoortweg,2023-05-02,20:00:00,152,82,70,FMN 08 Schijnpoortweg
675,Schijnpoortweg,2023-05-02,21:00:00,122,69,53,FMN 08 Schijnpoortweg
675,Schijnpoortweg,2023-05-02,22:00:00,119,65,54,FMN 08 Schijnpoortweg
675,Schijnpoortweg,2023-05-02,23:00:00,75,41,34,FMN 08 Schijnpoortweg
675,Schijnpoortweg,2023-05-03,00:00:00,33,12,21,FMN 08 Schijnpoortweg
675,Schijnpoortweg,2023-05-03,01:00:00,23,10,13,FMN 08 Schijnpoortweg
675,Schijnpoortweg,2023-05-03,02:00:00,17,5,12,FMN 08 Schijnpoortweg
675,Schijnpoortweg,2023-05-03,03:00:00,10,5,5,FMN 08 Schijnpoortweg
675,Schijnpoortweg,2023-05-03,04:00:00,41,20,21,FMN 08 Schijnpoortweg
675,Schijnpoortweg,2023-05-03,05:00:00,69,40,29,FMN 08 Schijnpoortweg
675,Schijnpoortweg,2023-05-03,06:00:00,143,93,50,FMN 08 Schijnpoortweg
675,Schijnpoortweg,2023-05-03,07:00:00,276,198,78,FMN 08 Schijnpoortweg
675,Schijnpoortweg,2023-05-03,08:00:00,356,257,99,FMN 08 Schijnpoortweg
675,Schijnpoortweg,2023-05-03,09:00:00,162,107,55,FMN 08 Schijnpoortweg
675,Schijnpoortweg,2023-05-03,10:00:00,125,87,38,FMN 08 Schijnpoortweg
675,Schijnpoortweg,2023-05-03,11:00:00,145,96,49,FMN 08 Schijnpoortweg
675,Schijnpoortweg,2023-05-03,12:00:00,240,141,99,FMN 08 Schijnpoortweg
675,Schijnpoortweg,2023-05-03,13:00:00,207,129,78,FMN 08 Schijnpoortweg
675,Schijnpoortweg,2023-05-03,14:00:00,199,122,77,FMN 08 Schijnpoortweg
675,Schijnpoortweg,2023-05-03,15:00:00,228,128,100,FMN 08 Schijnpoortweg
675,Schijnpoortweg,2023-05-03,16:00:00,335,212,123,FMN 08 Schijnpoortweg
675,Schijnpoortweg,2023-05-03,17:00:00,326,189,137,FMN 08 Schijnpoortweg
675,Schijnpoortweg,2023-05-03,18:00:00,244,142,102,FMN 08 Schijnpoortweg
675,Schijnpoortweg,2023-05-03,19:00:00,188,106,82,FMN 08 Schijnpoortweg
675,Schijnpoortweg,2023-05-03,20:00:00,151,80,71,FMN 08 Schijnpoortweg
675,Schijnpoortweg,2023-05-03,21:00:00,118,54,64,FMN 08 Schijnpoortweg
675,Schijnpoortweg,2023-05-03,22:00:00,109,63,46,FMN 08 Schijnpoortweg
675,Schijnpoortweg,2023-05-03,23:00:00,81,39,42,FMN 08 Schijnpoortweg
675,Schijnpoortweg,2023-05-04,00:00:00,38,15,23,FMN 08 Schijnpoortweg
675,Schijnpoortweg,2023-05-04,01:00:00,24,12,12,FMN 08 Schijnpoortweg
675,Schijnpoortweg,2023-05-04,02:00:00,17,7,10,FMN 08 Schijnpoortweg
675,Schijnpoortweg,2023-05-04,03:00:00,16,9,7,FMN 08 Schijnpoortweg
675,Schijnpoortweg,2023-05-04,04:00:00,38,25,13,FMN 08 Schijnpoortweg
675,Schijnpoortweg,2023-05-04,05:00:00,74,40,34,FMN 08 Schijnpoortweg
675,Schijnpoortweg,2023-05-04,06:00:00,153,98,55,FMN 08 Schijnpoortweg
675,Schijnpoortweg,2023-05-04,07:00:00,327,233,94,FMN 08 Schijnpoortweg
675,Schijnpoortweg,2023-05-04,08:00:00,438,329,109,FMN 08 Schijnpoortweg
675,Schijnpoortweg,2023-05-04,09:00:00,186,133,53,FMN 08 Schijnpoortweg
675,Schijnpoortweg,2023-05-04,10:00:00,154,105,49,FMN 08 Schijnpoortweg
675,Schijnpoortweg,2023-05-04,11:00:00,165,111,54,FMN 08 Schijnpoortweg
675,Schijnpoortweg,2023-05-04,12:00:00,209,131,78,FMN 08 Schijnpoortweg
675,Schijnpoortweg,2023-05-04,13:00:00,198,124,74,FMN 08 Schijnpoortweg
675,Schijnpoortweg,2023-05-04,14:00:00,204,124,80,FMN 08 Schijnpoortweg
675,Schijnpoortweg,2023-05-04,15:00:00,285,153,132,FMN 08 Schijnpoortweg
675,Schijnpoortweg,2023-05-04,16:00:00,411,247,164,FMN 08 Schijnpoortweg
675,Schijnpoortweg,2023-05-04,17:00:00,397,232,165,FMN 08 Schijnpoortweg
675,Schijnpoortweg,2023-05-04,18:00:00,295,169,126,FMN 08 Schijnpoortweg
675,Schijnpoortweg,2023-05-04,19:00:00,254,139,115,FMN 08 Schijnpoortweg
675,Schijnpoortweg,2023-05-04,20:00:00,189,97,92,FMN 08 Schijnpoortweg
675,Schijnpoortweg,2023-05-04,21:00:00,131,67,64,FMN 08 Schijnpoortweg
675,Schijnpoortweg,2023-05-04,22:00:00,141,84,57,FMN 08 Schijnpoortweg
675,Schijnpoortweg,2023-05-04,23:00:00,95,49,46,FMN 08 Schijnpoortweg
675,Schijnpoortweg,2023-05-05,00:00:00,44,19,25,FMN 08 Schijnpoortweg
675,Schijnpoortweg,2023-05-05,01:00:00,23,9,14,FMN 08 Schijnpoortweg
675,Schijnpoortweg,2023-05-05,02:00:00,14,4,10,FMN 08 Schijnpoortweg
675,Schijnpoortweg,2023-05-05,03:00:00,9,5,4,FMN 08 Schijnpoortweg
675,Schijnpoortweg,2023-05-05,04:00:00,38,21,17,FMN 08 Schijnpoortweg
675,Schijnpoortweg,2023-05-05,05:00:00,61,33,28,FMN 08 Schijnpoortweg
675,Schijnpoortweg,2023-05-05,06:00:00,135,100,35,FMN 08 Schijnpoortweg
675,Schijnpoortweg,2023-05-05,07:00:00,237,171,66,FMN 08 Schijnpoortweg
675,Schijnpoortweg,2023-05-05,08:00:00,309,230,79,FMN 08 Schijnpoortweg
675,Schijnpoortweg,2023-05-05,09:00:00,150,110,40,FMN 08 Schijnpoortweg
675,Schijnpoortweg,2023-05-05,10:00:00,132,92,40,FMN 08 Schijnpoortweg
675,Schijnpoortweg,2023-05-05,11:00:00,160,103,57,FMN 08 Schijnpoortweg
675,Schijnpoortweg,2023-05-05,12:00:00,186,116,70,FMN 08 Schijnpoortweg
675,Schijnpoortweg,2023-05-05,13:00:00,174,107,67,FMN 08 Schijnpoortweg
675,Schijnpoortweg,2023-05-05,14:00:00,198,122,76,FMN 08 Schijnpoortweg
675,Schijnpoortweg,2023-05-05,15:00:00,266,144,122,FMN 08 Schijnpoortweg
675,Schijnpoortweg,2023-05-05,16:00:00,294,177,117,FMN 08 Schijnpoortweg
675,Schijnpoortweg,2023-05-05,17:00:00,293,172,121,FMN 08 Schijnpoortweg
675,Schijnpoortweg,2023-05-05,18:00:00,242,143,99,FMN 08 Schijnpoortweg
675,Schijnpoortweg,2023-05-05,19:00:00,223,111,112,FMN 08 Schijnpoortweg
675,Schijnpoortweg,2023-05-05,20:00:00,163,87,76,FMN 08 Schijnpoortweg
675,Schijnpoortweg,2023-05-05,21:00:00,111,63,48,FMN 08 Schijnpoortweg
675,Schijnpoortweg,2023-05-05,22:00:00,118,70,48,FMN 08 Schijnpoortweg
675,Schijnpoortweg,2023-05-05,23:00:00,152,95,57,FMN 08 Schijnpoortweg
675,Schijnpoortweg,2023-05-06,00:00:00,69,36,33,FMN 08 Schijnpoortweg
675,Schijnpoortweg,2023-05-06,01:00:00,31,11,20,FMN 08 Schijnpoortweg
675,Schijnpoortweg,2023-05-06,02:00:00,30,12,18,FMN 08 Schijnpoortweg
675,Schijnpoortweg,2023-05-06,03:00:00,19,11,8,FMN 08 Schijnpoortweg
675,Schijnpoortweg,2023-05-06,04:00:00,18,10,8,FMN 08 Schijnpoortweg
675,Schijnpoortweg,2023-05-06,05:00:00,29,16,13,FMN 08 Schijnpoortweg
675,Schijnpoortweg,2023-05-06,06:00:00,41,23,18,FMN 08 Schijnpoortweg
675,Schijnpoortweg,2023-05-06,07:00:00,36,22,14,FMN 08 Schijnpoortweg
675,Schijnpoortweg,2023-05-06,08:00:00,74,42,32,FMN 08 Schijnpoortweg
675,Schijnpoortweg,2023-05-06,09:00:00,104,72,32,FMN 08 Schijnpoortweg
675,Schijnpoortweg,2023-05-06,10:00:00,122,82,40,FMN 08 Schijnpoortweg
675,Schijnpoortweg,2023-05-06,11:00:00,147,89,58,FMN 08 Schijnpoortweg
675,Schijnpoortweg,2023-05-06,12:00:00,148,94,54,FMN 08 Schijnpoortweg
675,Schijnpoortweg,2023-05-06,13:00:00,179,118,61,FMN 08 Schijnpoortweg
675,Schijnpoortweg,2023-05-06,14:00:00,167,107,60,FMN 08 Schijnpoortweg
675,Schijnpoortweg,2023-05-06,15:00:00,183,116,67,FMN 08 Schijnpoortweg
675,Schijnpoortweg,2023-05-06,16:00:00,191,114,77,FMN 08 Schijnpoortweg
675,Schijnpoortweg,2023-05-06,17:00:00,194,112,82,FMN 08 Schijnpoortweg
675,Schijnpoortweg,2023-05-06,18:00:00,207,130,77,FMN 08 Schijnpoortweg
675,Schijnpoortweg,2023-05-06,19:00:00,173,97,76,FMN 08 Schijnpoortweg
675,Schijnpoortweg,2023-05-06,20:00:00,152,84,68,FMN 08 Schijnpoortweg
675,Schijnpoortweg,2023-05-06,21:00:00,99,59,40,FMN 08 Schijnpoortweg
675,Schijnpoortweg,2023-05-06,22:00:00,119,66,53,FMN 08 Schijnpoortweg
675,Schijnpoortweg,2023-05-06,23:00:00,101,61,40,FMN 08 Schijnpoortweg
675,Schijnpoortweg,2023-05-07,00:00:00,39,20,19,FMN 08 Schijnpoortweg
675,Schijnpoortweg,2023-05-07,01:00:00,16,8,8,FMN 08 Schijnpoortweg
675,Schijnpoortweg,2023-05-07,02:00:00,16,10,6,FMN 08 Schijnpoortweg
675,Schijnpoortweg,2023-05-07,03:00:00,15,6,9,FMN 08 Schijnpoortweg
675,Schijnpoortweg,2023-05-07,04:00:00,6,4,2,FMN 08 Schijnpoortweg
675,Schijnpoortweg,2023-05-07,05:00:00,13,7,6,FMN 08 Schijnpoortweg
675,Schijnpoortweg,2023-05-07,06:00:00,16,9,7,FMN 08 Schijnpoortweg
675,Schijnpoortweg,2023-05-07,07:00:00,21,13,8,FMN 08 Schijnpoortweg
675,Schijnpoortweg,2023-05-07,08:00:00,27,20,7,FMN 08 Schijnpoortweg
675,Schijnpoortweg,2023-05-07,09:00:00,40,25,15,FMN 08 Schijnpoortweg
675,Schijnpoortweg,2023-05-07,10:00:00,63,39,24,FMN 08 Schijnpoortweg
675,Schijnpoortweg,2023-05-07,11:00:00,71,43,28,FMN 08 Schijnpoortweg
675,Schijnpoortweg,2023-05-07,12:00:00,92,60,32,FMN 08 Schijnpoortweg
675,Schijnpoortweg,2023-05-07,13:00:00,98,70,28,FMN 08 Schijnpoortweg
675,Schijnpoortweg,2023-05-07,14:00:00,95,63,32,FMN 08 Schijnpoortweg
675,Schijnpoortweg,2023-05-07,15:00:00,83,53,30,FMN 08 Schijnpoortweg
675,Schijnpoortweg,2023-05-07,16:00:00,114,68,46,FMN 08 Schijnpoortweg
675,Schijnpoortweg,2023-05-07,17:00:00,100,62,38,FMN 08 Schijnpoortweg
675,Schijnpoortweg,2023-05-07,18:00:00,85,53,32,FMN 08 Schijnpoortweg
675,Schijnpoortweg,2023-05-07,19:00:00,78,43,35,FMN 08 Schijnpoortweg
675,Schijnpoortweg,2023-05-07,20:00:00,70,35,35,FMN 08 Schijnpoortweg
675,Schijnpoortweg,2023-05-07,21:00:00,58,31,27,FMN 08 Schijnpoortweg
675,Schijnpoortweg,2023-05-07,22:00:00,44,24,20,FMN 08 Schijnpoortweg
675,Schijnpoortweg,2023-05-07,23:00:00,30,16,14,FMN 08 Schijnpoortweg
675,Schijnpoortweg,2023-05-08,00:00:00,33,19,14,FMN 08 Schijnpoortweg
675,Schijnpoortweg,2023-05-08,01:00:00,19,14,5,FMN 08 Schijnpoortweg
675,Schijnpoortweg,2023-05-08,02:00:00,15,2,13,FMN 08 Schijnpoortweg
675,Schijnpoortweg,2023-05-08,03:00:00,14,7,7,FMN 08 Schijnpoortweg
675,Schijnpoortweg,2023-05-08,04:00:00,40,23,17,FMN 08 Schijnpoortweg
675,Schijnpoortweg,2023-05-08,05:00:00,62,36,26,FMN 08 Schijnpoortweg
675,Schijnpoortweg,2023-05-08,06:00:00,122,80,42,FMN 08 Schijnpoortweg
675,Schijnpoortweg,2023-05-08,07:00:00,269,194,75,FMN 08 Schijnpoortweg
675,Schijnpoortweg,2023-05-08,08:00:00,361,273,88,FMN 08 Schijnpoortweg
675,Schijnpoortweg,2023-05-08,09:00:00,155,111,44,FMN 08 Schijnpoortweg
675,Schijnpoortweg,2023-05-08,10:00:00,128,87,41,FMN 08 Schijnpoortweg
675,Schijnpoortweg,2023-05-08,11:00:00,136,91,45,FMN 08 Schijnpoortweg
675,Schijnpoortweg,2023-05-08,12:00:00,182,120,62,FMN 08 Schijnpoortweg
675,Schijnpoortweg,2023-05-08,13:00:00,162,96,66,FMN 08 Schijnpoortweg
675,Schijnpoortweg,2023-05-08,14:00:00,173,102,71,FMN 08 Schijnpoortweg
675,Schijnpoortweg,2023-05-08,15:00:00,248,130,118,FMN 08 Schijnpoortweg
675,Schijnpoortweg,2023-05-08,16:00:00,364,224,140,FMN 08 Schijnpoortweg
675,Schijnpoortweg,2023-05-08,17:00:00,322,186,136,FMN 08 Schijnpoortweg
675,Schijnpoortweg,2023-05-08,18:00:00,255,149,106,FMN 08 Schijnpoortweg
675,Schijnpoortweg,2023-05-08,19:00:00,183,100,83,FMN 08 Schijnpoortweg
675,Schijnpoortweg,2023-05-08,20:00:00,134,74,60,FMN 08 Schijnpoortweg
675,Schijnpoortweg,2023-05-08,21:00:00,105,57,48,FMN 08 Schijnpoortweg
675,Schijnpoortweg,2023-05-08,22:00:00,105,57,48,FMN 08 Schijnpoortweg
675,Schijnpoortweg,2023-05-08,23:00:00,66,32,34,FMN 08 Schijnpoortweg
675,Schijnpoortweg,2023-05-09,00:00:00,28,13,15,FMN 08 Schijnpoortweg
675,Schijnpoortweg,2023-05-09,01:00:00,10,5,5,FMN 08 Schijnpoortweg
675,Schijnpoortweg,2023-05-09,02:00:00,10,3,7,FMN 08 Schijnpoortweg
675,Schijnpoortweg,2023-05-09,03:00:00,8,7,1,FMN 08 Schijnpoortweg
675,Schijnpoortweg,2023-05-09,04:00:00,27,16,11,FMN 08 Schijnpoortweg
675,Schijnpoortweg,2023-05-09,05:00:00,47,24,23,FMN 08 Schijnpoortweg
675,Schijnpoortweg,2023-05-09,06:00:00,90,63,27,FMN 08 Schijnpoortweg
675,Schijnpoortweg,2023-05-09,07:00:00,205,150,55,FMN 08 Schijnpoortweg
675,Schijnpoortweg,2023-05-09,08:00:00,274,202,72,FMN 08 Schijnpoortweg
675,Schijnpoortweg,2023-05-09,09:00:00,124,84,40,FMN 08 Schijnpoortweg
675,Schijnpoortweg,2023-05-09,10:00:00,104,73,31,FMN 08 Schijnpoortweg
675,Schijnpoortweg,2023-05-09,11:00:00,105,63,42,FMN 08 Schijnpoortweg
675,Schijnpoortweg,2023-05-09,12:00:00,143,97,46,FMN 08 Schijnpoortweg
675,Schijnpoortweg,2023-05-09,13:00:00,113,75,38,FMN 08 Schijnpoortweg
675,Schijnpoortweg,2023-05-09,14:00:00,147,97,50,FMN 08 Schijnpoortweg
675,Schijnpoortweg,2023-05-09,15:00:00,175,94,81,FMN 08 Schijnpoortweg
675,Schijnpoortweg,2023-05-09,16:00:00,279,164,115,FMN 08 Schijnpoortweg
675,Schijnpoortweg,2023-05-09,17:00:00,265,157,108,FMN 08 Schijnpoortweg
675,Schijnpoortweg,2023-05-09,18:00:00,194,115,79,FMN 08 Schijnpoortweg
675,Schijnpoortweg,2023-05-09,19:00:00,154,82,72,FMN 08 Schijnpoortweg
675,Schijnpoortweg,2023-05-09,20:00:00,93,54,39,FMN 08 Schijnpoortweg
675,Schijnpoortweg,2023-05-09,21:00:00,98,52,46,FMN 08 Schijnpoortweg
675,Schijnpoortweg,2023-05-09,22:00:00,84,55,29,FMN 08 Schijnpoortweg
675,Schijnpoortweg,2023-05-09,23:00:00,53,27,26,FMN 08 Schijnpoortweg
675,Schijnpoortweg,2023-05-10,00:00:00,33,12,21,FMN 08 Schijnpoortweg
675,Schijnpoortweg,2023-05-10,01:00:00,16,9,7,FMN 08 Schijnpoortweg
675,Schijnpoortweg,2023-05-10,02:00:00,10,5,5,FMN 08 Schijnpoortweg
675,Schijnpoortweg,2023-05-10,03:00:00,9,6,3,FMN 08 Schijnpoortweg
675,Schijnpoortweg,2023-05-10,04:00:00,28,10,18,FMN 08 Schijnpoortweg
675,Schijnpoortweg,2023-05-10,05:00:00,63,37,26,FMN 08 Schijnpoortweg
675,Schijnpoortweg,2023-05-10,06:00:00,117,79,38,FMN 08 Schijnpoortweg
675,Schijnpoortweg,2023-05-10,07:00:00,244,177,67,FMN 08 Schijnpoortweg
675,Schijnpoortweg,2023-05-10,08:00:00,294,214,80,FMN 08 Schijnpoortweg
675,Schijnpoortweg,2023-05-10,09:00:00,140,92,48,FMN 08 Schijnpoortweg
675,Schijnpoortweg,2023-05-10,10:00:00,116,78,38,FMN 08 Schijnpoortweg
675,Schijnpoortweg,2023-05-10,11:00:00,129,84,45,FMN 08 Schijnpoortweg
675,Schijnpoortweg,2023-05-10,12:00:00,206,126,80,FMN 08 Schijnpoortweg
675,Schijnpoortweg,2023-05-10,13:00:00,175,105,70,FMN 08 Schijnpoortweg
675,Schijnpoortweg,2023-05-10,14:00:00,177,111,66,FMN 08 Schijnpoortweg
675,Schijnpoortweg,2023-05-10,15:00:00,190,108,82,FMN 08 Schijnpoortweg
675,Schijnpoortweg,2023-05-10,16:00:00,286,176,110,FMN 08 Schijnpoortweg
675,Schijnpoortweg,2023-05-10,17:00:00,275,161,114,FMN 08 Schijnpoortweg
675,Schijnpoortweg,2023-05-10,18:00:00,217,127,90,FMN 08 Schijnpoortweg
675,Schijnpoortweg,2023-05-10,19:00:00,165,86,79,FMN 08 Schijnpoortweg
675,Schijnpoortweg,2023-05-10,20:00:00,123,68,55,FMN 08 Schijnpoortweg
675,Schijnpoortweg,2023-05-10,21:00:00,102,56,46,FMN 08 Schijnpoortweg
675,Schijnpoortweg,2023-05-10,22:00:00,85,46,39,FMN 08 Schijnpoortweg
675,Schijnpoortweg,2023-05-10,23:00:00,59,33,26,FMN 08 Schijnpoortweg
675,Schijnpoortweg,2023-05-11,00:00:00,42,19,23,FMN 08 Schijnpoortweg
675,Schijnpoortweg,2023-05-11,01:00:00,20,6,14,FMN 08 Schijnpoortweg
675,Schijnpoortweg,2023-05-11,02:00:00,11,7,4,FMN 08 Schijnpoortweg
675,Schijnpoortweg,2023-05-11,03:00:00,11,4,7,FMN 08 Schijnpoortweg
675,Schijnpoortweg,2023-05-11,04:00:00,35,25,10,FMN 08 Schijnpoortweg
675,Schijnpoortweg,2023-05-11,05:00:00,64,27,37,FMN 08 Schijnpoortweg
675,Schijnpoortweg,2023-05-11,06:00:00,127,84,43,FMN 08 Schijnpoortweg
675,Schijnpoortweg,2023-05-11,07:00:00,266,188,78,FMN 08 Schijnpoortweg
675,Schijnpoortweg,2023-05-11,08:00:00,361,265,96,FMN 08 Schijnpoortweg
675,Schijnpoortweg,2023-05-11,09:00:00,157,110,47,FMN 08 Schijnpoortweg
675,Schijnpoortweg,2023-05-11,10:00:00,134,86,48,FMN 08 Schijnpoortweg
675,Schijnpoortweg,2023-05-11,11:00:00,128,82,46,FMN 08 Schijnpoortweg
675,Schijnpoortweg,2023-05-11,12:00:00,169,109,60,FMN 08 Schijnpoortweg
675,Schijnpoortweg,2023-05-11,13:00:00,145,82,63,FMN 08 Schijnpoortweg
675,Schijnpoortweg,2023-05-11,14:00:00,176,112,64,FMN 08 Schijnpoortweg
675,Schijnpoortweg,2023-05-11,15:00:00,236,134,102,FMN 08 Schijnpoortweg
675,Schijnpoortweg,2023-05-11,16:00:00,340,207,133,FMN 08 Schijnpoortweg
675,Schijnpoortweg,2023-05-11,17:00:00,328,197,131,FMN 08 Schijnpoortweg
675,Schijnpoortweg,2023-05-11,18:00:00,245,143,102,FMN 08 Schijnpoortweg
675,Schijnpoortweg,2023-05-11,19:00:00,198,114,84,FMN 08 Schijnpoortweg
675,Schijnpoortweg,2023-05-11,20:00:00,143,83,60,FMN 08 Schijnpoortweg
675,Schijnpoortweg,2023-05-11,21:00:00,103,55,48,FMN 08 Schijnpoortweg
675,Schijnpoortweg,2023-05-11,22:00:00,118,71,47,FMN 08 Schijnpoortweg
675,Schijnpoortweg,2023-05-11,23:00:00,88,53,35,FMN 08 Schijnpoortweg
675,Schijnpoortweg,2023-05-12,00:00:00,37,12,25,FMN 08 Schijnpoortweg
675,Schijnpoortweg,2023-05-12,01:00:00,20,9,11,FMN 08 Schijnpoortweg
675,Schijnpoortweg,2023-05-12,02:00:00,12,2,10,FMN 08 Schijnpoortweg
675,Schijnpoortweg,2023-05-12,03:00:00,13,7,6,FMN 08 Schijnpoortweg
675,Schijnpoortweg,2023-05-12,04:00:00,26,16,10,FMN 08 Schijnpoortweg
675,Schijnpoortweg,2023-05-12,05:00:00,58,32,26,FMN 08 Schijnpoortweg
675,Schijnpoortweg,2023-05-12,06:00:00,99,65,34,FMN 08 Schijnpoortweg
675,Schijnpoortweg,2023-05-12,07:00:00,210,142,68,FMN 08 Schijnpoortweg
675,Schijnpoortweg,2023-05-12,08:00:00,255,185,70,FMN 08 Schijnpoortweg
675,Schijnpoortweg,2023-05-12,09:00:00,151,102,49,FMN 08 Schijnpoortweg
675,Schijnpoortweg,2023-05-12,10:00:00,118,76,42,FMN 08 Schijnpoortweg
675,Schijnpoortweg,2023-05-12,11:00:00,119,83,36,FMN 08 Schijnpoortweg
675,Schijnpoortweg,2023-05-12,12:00:00,163,108,55,FMN 08 Schijnpoortweg
675,Schijnpoortweg,2023-05-12,13:00:00,136,93,43,FMN 08 Schijnpoortweg
675,Schijnpoortweg,2023-05-12,14:00:00,161,105,56,FMN 08 Schijnpoortweg
675,Schijnpoortweg,2023-05-12,15:00:00,217,125,92,FMN 08 Schijnpoortweg
675,Schijnpoortweg,2023-05-12,16:00:00,247,144,103,FMN 08 Schijnpoortweg
675,Schijnpoortweg,2023-05-12,17:00:00,253,146,107,FMN 08 Schijnpoortweg
675,Schijnpoortweg,2023-05-12,18:00:00,211,124,87,FMN 08 Schijnpoortweg
675,Schijnpoortweg,2023-05-12,19:00:00,173,88,85,FMN 08 Schijnpoortweg
675,Schijnpoortweg,2023-05-12,20:00:00,144,76,68,FMN 08 Schijnpoortweg
675,Schijnpoortweg,2023-05-12,21:00:00,116,68,48,FMN 08 Schijnpoortweg
675,Schijnpoortweg,2023-05-12,22:00:00,105,56,49,FMN 08 Schijnpoortweg
675,Schijnpoortweg,2023-05-12,23:00:00,91,59,32,FMN 08 Schijnpoortweg
675,Schijnpoortweg,2023-05-13,00:00:00,73,36,37,FMN 08 Schijnpoortweg
675,Schijnpoortweg,2023-05-13,01:00:00,34,21,13,FMN 08 Schijnpoortweg
675,Schijnpoortweg,2023-05-13,02:00:00,26,13,13,FMN 08 Schijnpoortweg
675,Schijnpoortweg,2023-05-13,03:00:00,26,17,9,FMN 08 Schijnpoortweg
675,Schijnpoortweg,2023-05-13,04:00:00,22,9,13,FMN 08 Schijnpoortweg
675,Schijnpoortweg,2023-05-13,05:00:00,23,15,8,FMN 08 Schijnpoortweg
675,Schijnpoortweg,2023-05-13,06:00:00,47,30,17,FMN 08 Schijnpoortweg
675,Schijnpoortweg,2023-05-13,07:00:00,56,38,18,FMN 08 Schijnpoortweg
675,Schijnpoortweg,2023-05-13,08:00:00,79,52,27,FMN 08 Schijnpoortweg
675,Schijnpoortweg,2023-05-13,09:00:00,117,80,37,FMN 08 Schijnpoortweg
675,Schijnpoortweg,2023-05-13,10:00:00,115,79,36,FMN 08 Schijnpoortweg
675,Schijnpoortweg,2023-05-13,11:00:00,153,100,53,FMN 08 Schijnpoortweg
675,Schijnpoortweg,2023-05-13,12:00:00,165,106,59,FMN 08 Schijnpoortweg
675,Schijnpoortweg,2023-05-13,13:00:00,172,115,57,FMN 08 Schijnpoortweg
675,Schijnpoortweg,2023-05-13,14:00:00,172,105,67,FMN 08 Schijnpoortweg
675,Schijnpoortweg,2023-05-13,15:00:00,181,110,71,FMN 08 Schijnpoortweg
675,Schijnpoortweg,2023-05-13,16:00:00,191,116,75,FMN 08 Schijnpoortweg
675,Schijnpoortweg,2023-05-13,17:00:00,191,121,70,FMN 08 Schijnpoortweg
675,Schijnpoortweg,2023-05-13,18:00:00,183,111,72,FMN 08 Schijnpoortweg
675,Schijnpoortweg,2023-05-13,19:00:00,173,91,82,FMN 08 Schijnpoortweg
675,Schijnpoortweg,2023-05-13,20:00:00,148,85,63,FMN 08 Schijnpoortweg
675,Schijnpoortweg,2023-05-13,21:00:00,116,67,49,FMN 08 Schijnpoortweg
675,Schijnpoortweg,2023-05-13,22:00:00,108,70,38,FMN 08 Schijnpoortweg
675,Schijnpoortweg,2023-05-13,23:00:00,103,54,49,FMN 08 Schijnpoortweg
675,Schijnpoortweg,2023-05-14,00:00:00,59,28,31,FMN 08 Schijnpoortweg
675,Schijnpoortweg,2023-05-14,01:00:00,31,12,19,FMN 08 Schijnpoortweg
675,Schijnpoortweg,2023-05-14,02:00:00,25,15,10,FMN 08 Schijnpoortweg
675,Schijnpoortweg,2023-05-14,03:00:00,20,9,11,FMN 08 Schijnpoortweg
675,Schijnpoortweg,2023-05-14,04:00:00,21,10,11,FMN 08 Schijnpoortweg
675,Schijnpoortweg,2023-05-14,05:00:00,20,10,10,FMN 08 Schijnpoortweg
675,Schijnpoortweg,2023-05-14,06:00:00,23,16,7,FMN 08 Schijnpoortweg
675,Schijnpoortweg,2023-05-14,07:00:00,22,11,11,FMN 08 Schijnpoortweg
675,Schijnpoortweg,2023-05-14,08:00:00,41,30,11,FMN 08 Schijnpoortweg
675,Schijnpoortweg,2023-05-14,09:00:00,64,43,21,FMN 08 Schijnpoortweg
675,Schijnpoortweg,2023-05-14,10:00:00,85,59,26,FMN 08 Schijnpoortweg
675,Schijnpoortweg,2023-05-14,11:00:00,110,78,32,FMN 08 Schijnpoortweg
675,Schijnpoortweg,2023-05-14,12:00:00,114,76,38,FMN 08 Schijnpoortweg
675,Schijnpoortweg,2023-05-14,13:00:00,144,90,54,FMN 08 Schijnpoortweg
675,Schijnpoortweg,2023-05-14,14:00:00,143,92,51,FMN 08 Schijnpoortweg
675,Schijnpoortweg,2023-05-14,15:00:00,144,93,51,FMN 08 Schijnpoortweg
675,Schijnpoortweg,2023-05-14,16:00:00,146,92,54,FMN 08 Schijnpoortweg
675,Schijnpoortweg,2023-05-14,17:00:00,142,86,56,FMN 08 Schijnpoortweg
675,Schijnpoortweg,2023-05-14,18:00:00,137,90,47,FMN 08 Schijnpoortweg
675,Schijnpoortweg,2023-05-14,19:00:00,128,70,58,FMN 08 Schijnpoortweg
675,Schijnpoortweg,2023-05-14,20:00:00,102,53,49,FMN 08 Schijnpoortweg
675,Schijnpoortweg,2023-05-14,21:00:00,84,49,35,FMN 08 Schijnpoortweg
675,Schijnpoortweg,2023-05-14,22:00:00,69,34,35,FMN 08 Schijnpoortweg
675,Schijnpoortweg,2023-05-14,23:00:00,61,35,26,FMN 08 Schijnpoortweg
675,Schijnpoortweg,2023-05-15,00:00:00,25,13,12,FMN 08 Schijnpoortweg
675,Schijnpoortweg,2023-05-15,01:00:00,17,9,8,FMN 08 Schijnpoortweg
675,Schijnpoortweg,2023-05-15,02:00:00,12,3,9,FMN 08 Schijnpoortweg
675,Schijnpoortweg,2023-05-15,03:00:00,13,7,6,FMN 08 Schijnpoortweg
675,Schijnpoortweg,2023-05-15,04:00:00,23,13,10,FMN 08 Schijnpoortweg
675,Schijnpoortweg,2023-05-15,05:00:00,54,31,23,FMN 08 Schijnpoortweg
675,Schijnpoortweg,2023-05-15,06:00:00,111,72,39,FMN 08 Schijnpoortweg
675,Schijnpoortweg,2023-05-15,07:00:00,222,161,61,FMN 08 Schijnpoortweg
675,Schijnpoortweg,2023-05-15,08:00:00,307,223,84,FMN 08 Schijnpoortweg
675,Schijnpoortweg,2023-05-15,09:00:00,136,93,43,FMN 08 Schijnpoortweg
675,Schijnpoortweg,2023-05-15,10:00:00,112,75,37,FMN 08 Schijnpoortweg
675,Schijnpoortweg,2023-05-15,11:00:00,115,81,34,FMN 08 Schijnpoortweg
675,Schijnpoortweg,2023-05-15,12:00:00,156,96,60,FMN 08 Schijnpoortweg
675,Schijnpoortweg,2023-05-15,13:00:00,135,80,55,FMN 08 Schijnpoortweg
675,Schijnpoortweg,2023-05-15,14:00:00,147,91,56,FMN 08 Schijnpoortweg
675,Schijnpoortweg,2023-05-15,15:00:00,205,104,101,FMN 08 Schijnpoortweg
675,Schijnpoortweg,2023-05-15,16:00:00,320,191,129,FMN 08 Schijnpoortweg
675,Schijnpoortweg,2023-05-15,17:00:00,288,165,123,FMN 08 Schijnpoortweg
675,Schijnpoortweg,2023-05-15,18:00:00,199,116,83,FMN 08 Schijnpoortweg
675,Schijnpoortweg,2023-05-15,19:00:00,147,79,68,FMN 08 Schijnpoortweg
675,Schijnpoortweg,2023-05-15,20:00:00,118,60,58,FMN 08 Schijnpoortweg
675,Schijnpoortweg,2023-05-15,21:00:00,105,52,53,FMN 08 Schijnpoortweg
675,Schijnpoortweg,2023-05-15,22:00:00,94,53,41,FMN 08 Schijnpoortweg
675,Schijnpoortweg,2023-05-15,23:00:00,55,29,26,FMN 08 Schijnpoortweg
675,Schijnpoortweg,2023-05-16,00:00:00,21,6,15,FMN 08 Schijnpoortweg
675,Schijnpoortweg,2023-05-16,01:00:00,19,6,13,FMN 08 Schijnpoortweg
675,Schijnpoortweg,2023-05-16,02:00:00,11,4,7,FMN 08 Schijnpoortweg
675,Schijnpoortweg,2023-05-16,03:00:00,11,3,8,FMN 08 Schijnpoortweg
675,Schijnpoortweg,2023-05-16,04:00:00,36,18,18,FMN 08 Schijnpoortweg
675,Schijnpoortweg,2023-05-16,05:00:00,62,25,37,FMN 08 Schijnpoortweg
675,Schijnpoortweg,2023-05-16,06:00:00,101,71,30,FMN 08 Schijnpoortweg
675,Schijnpoortweg,2023-05-16,07:00:00,240,172,68,FMN 08 Schijnpoortweg
675,Schijnpoortweg,2023-05-16,08:00:00,322,251,71,FMN 08 Schijnpoortweg
675,Schijnpoortweg,2023-05-16,09:00:00,140,95,45,FMN 08 Schijnpoortweg
675,Schijnpoortweg,2023-05-16,10:00:00,109,74,35,FMN 08 Schijnpoortweg
675,Schijnpoortweg,2023-05-16,11:00:00,104,64,40,FMN 08 Schijnpoortweg
675,Schijnpoortweg,2023-05-16,12:00:00,152,95,57,FMN 08 Schijnpoortweg
675,Schijnpoortweg,2023-05-16,13:00:00,155,93,62,FMN 08 Schijnpoortweg
675,Schijnpoortweg,2023-05-16,14:00:00,139,91,48,FMN 08 Schijnpoortweg
675,Schijnpoortweg,2023-05-16,15:00:00,191,102,89,FMN 08 Schijnpoortweg
675,Schijnpoortweg,2023-05-16,16:00:00,299,182,117,FMN 08 Schijnpoortweg
675,Schijnpoortweg,2023-05-16,17:00:00,272,158,114,FMN 08 Schijnpoortweg
675,Schijnpoortweg,2023-05-16,18:00:00,212,114,98,FMN 08 Schijnpoortweg
675,Schijnpoortweg,2023-05-16,19:00:00,152,85,67,FMN 08 Schijnpoortweg
675,Schijnpoortweg,2023-05-16,20:00:00,129,67,62,FMN 08 Schijnpoortweg
675,Schijnpoortweg,2023-05-16,21:00:00,94,52,42,FMN 08 Schijnpoortweg
675,Schijnpoortweg,2023-05-16,22:00:00,96,56,40,FMN 08 Schijnpoortweg
675,Schijnpoortweg,2023-05-16,23:00:00,59,25,34,FMN 08 Schijnpoortweg
675,Schijnpoortweg,2023-05-17,00:00:00,12,5,7,FMN 08 Schijnpoortweg
675,Schijnpoortweg,2023-05-17,01:00:00,11,7,4,FMN 08 Schijnpoortweg
675,Schijnpoortweg,2023-05-17,02:00:00,6,4,2,FMN 08 Schijnpoortweg
675,Schijnpoortweg,2023-05-17,03:00:00,14,6,8,FMN 08 Schijnpoortweg
675,Schijnpoortweg,2023-05-17,04:00:00,24,15,9,FMN 08 Schijnpoortweg
675,Schijnpoortweg,2023-05-17,05:00:00,39,21,18,FMN 08 Schijnpoortweg
675,Schijnpoortweg,2023-05-17,06:00:00,76,46,30,FMN 08 Schijnpoortweg
675,Schijnpoortweg,2023-05-17,07:00:00,147,103,44,FMN 08 Schijnpoortweg
675,Schijnpoortweg,2023-05-17,08:00:00,174,123,51,FMN 08 Schijnpoortweg
675,Schijnpoortweg,2023-05-17,09:00:00,80,61,19,FMN 08 Schijnpoortweg
675,Schijnpoortweg,2023-05-17,10:00:00,73,54,19,FMN 08 Schijnpoortweg
675,Schijnpoortweg,2023-05-17,11:00:00,77,48,29,FMN 08 Schijnpoortweg
675,Schijnpoortweg,2023-05-17,12:00:00,123,69,54,FMN 08 Schijnpoortweg
675,Schijnpoortweg,2023-05-17,13:00:00,114,68,46,FMN 08 Schijnpoortweg
675,Schijnpoortweg,2023-05-17,14:00:00,120,75,45,FMN 08 Schijnpoortweg
675,Schijnpoortweg,2023-05-17,15:00:00,129,71,58,FMN 08 Schijnpoortweg
675,Schijnpoortweg,2023-05-17,16:00:00,191,117,74,FMN 08 Schijnpoortweg
675,Schijnpoortweg,2023-05-17,17:00:00,184,100,84,FMN 08 Schijnpoortweg
675,Schijnpoortweg,2023-05-17,18:00:00,117,71,46,FMN 08 Schijnpoortweg
675,Schijnpoortweg,2023-05-17,19:00:00,109,61,48,FMN 08 Schijnpoortweg
675,Schijnpoortweg,2023-05-17,20:00:00,77,45,32,FMN 08 Schijnpoortweg
675,Schijnpoortweg,2023-05-17,21:00:00,60,31,29,FMN 08 Schijnpoortweg
675,Schijnpoortweg,2023-05-17,22:00:00,56,33,23,FMN 08 Schijnpoortweg
675,Schijnpoortweg,2023-05-17,23:00:00,47,26,21,FMN 08 Schijnpoortweg
675,Schijnpoortweg,2023-05-18,00:00:00,2,0,2,FMN 08 Schijnpoortweg
675,Schijnpoortweg,2023-05-18,01:00:00,1,1,0,FMN 08 Schijnpoortweg
675,Schijnpoortweg,2023-05-18,02:00:00,0,0,0,FMN 08 Schijnpoortweg
675,Schijnpoortweg,2023-05-18,03:00:00,0,0,0,FMN 08 Schijnpoortweg
675,Schijnpoortweg,2023-05-18,04:00:00,0,0,0,FMN 08 Schijnpoortweg
675,Schijnpoortweg,2023-05-18,05:00:00,0,0,0,FMN 08 Schijnpoortweg
675,Schijnpoortweg,2023-05-18,06:00:00,1,0,1,FMN 08 Schijnpoortweg
675,Schijnpoortweg,2023-05-18,07:00:00,1,1,0,FMN 08 Schijnpoortweg
675,Schijnpoortweg,2023-05-18,08:00:00,0,0,0,FMN 08 Schijnpoortweg
675,Schijnpoortweg,2023-05-18,09:00:00,1,0,1,FMN 08 Schijnpoortweg
675,Schijnpoortweg,2023-05-18,10:00:00,1,1,0,FMN 08 Schijnpoortweg
675,Schijnpoortweg,2023-05-18,11:00:00,0,0,0,FMN 08 Schijnpoortweg
675,Schijnpoortweg,2023-05-18,12:00:00,1,1,0,FMN 08 Schijnpoortweg
675,Schijnpoortweg,2023-05-18,13:00:00,1,0,1,FMN 08 Schijnpoortweg
675,Schijnpoortweg,2023-05-18,14:00:00,0,0,0,FMN 08 Schijnpoortweg
675,Schijnpoortweg,2023-05-18,15:00:00,1,0,1,FMN 08 Schijnpoortweg
675,Schijnpoortweg,2023-05-18,16:00:00,2,2,0,FMN 08 Schijnpoortweg
675,Schijnpoortweg,2023-05-18,17:00:00,2,0,2,FMN 08 Schijnpoortweg
675,Schijnpoortweg,2023-05-18,18:00:00,6,2,4,FMN 08 Schijnpoortweg
675,Schijnpoortweg,2023-05-18,19:00:00,1,1,0,FMN 08 Schijnpoortweg
675,Schijnpoortweg,2023-05-18,20:00:00,3,2,1,FMN 08 Schijnpoortweg
675,Schijnpoortweg,2023-05-18,21:00:00,2,2,0,FMN 08 Schijnpoortweg
675,Schijnpoortweg,2023-05-18,22:00:00,1,1,0,FMN 08 Schijnpoortweg
675,Schijnpoortweg,2023-05-18,23:00:00,1,0,1,FMN 08 Schijnpoortweg
675,Schijnpoortweg,2023-05-19,00:00:00,0,0,0,FMN 08 Schijnpoortweg
675,Schijnpoortweg,2023-05-19,01:00:00,1,0,1,FMN 08 Schijnpoortweg
675,Schijnpoortweg,2023-05-19,02:00:00,0,0,0,FMN 08 Schijnpoortweg
675,Schijnpoortweg,2023-05-19,03:00:00,0,0,0,FMN 08 Schijnpoortweg
675,Schijnpoortweg,2023-05-19,04:00:00,1,1,0,FMN 08 Schijnpoortweg
675,Schijnpoortweg,2023-05-19,05:00:00,2,0,2,FMN 08 Schijnpoortweg
675,Schijnpoortweg,2023-05-19,06:00:00,2,1,1,FMN 08 Schijnpoortweg
675,Schijnpoortweg,2023-05-19,07:00:00,0,0,0,FMN 08 Schijnpoortweg
675,Schijnpoortweg,2023-05-19,08:00:00,0,0,0,FMN 08 Schijnpoortweg
675,Schijnpoortweg,2023-05-19,09:00:00,0,0,0,FMN 08 Schijnpoortweg
675,Schijnpoortweg,2023-05-19,10:00:00,3,1,2,FMN 08 Schijnpoortweg
675,Schijnpoortweg,2023-05-19,11:00:00,0,0,0,FMN 08 Schijnpoortweg
675,Schijnpoortweg,2023-05-19,12:00:00,1,0,1,FMN 08 Schijnpoortweg
675,Schijnpoortweg,2023-05-19,13:00:00,1,1,0,FMN 08 Schijnpoortweg
675,Schijnpoortweg,2023-05-19,14:00:00,4,1,3,FMN 08 Schijnpoortweg
675,Schijnpoortweg,2023-05-19,15:00:00,1,0,1,FMN 08 Schijnpoortweg
675,Schijnpoortweg,2023-05-19,16:00:00,2,1,1,FMN 08 Schijnpoortweg
675,Schijnpoortweg,2023-05-19,17:00:00,3,0,3,FMN 08 Schijnpoortweg
675,Schijnpoortweg,2023-05-19,18:00:00,1,1,0,FMN 08 Schijnpoortweg
675,Schijnpoortweg,2023-05-19,19:00:00,1,0,1,FMN 08 Schijnpoortweg
675,Schijnpoortweg,2023-05-19,20:00:00,1,1,0,FMN 08 Schijnpoortweg
675,Schijnpoortweg,2023-05-19,21:00:00,1,1,0,FMN 08 Schijnpoortweg
675,Schijnpoortweg,2023-05-19,22:00:00,1,0,1,FMN 08 Schijnpoortweg
675,Schijnpoortweg,2023-05-19,23:00:00,0,0,0,FMN 08 Schijnpoortweg
675,Schijnpoortweg,2023-05-20,00:00:00,0,0,0,FMN 08 Schijnpoortweg
675,Schijnpoortweg,2023-05-20,01:00:00,1,0,1,FMN 08 Schijnpoortweg
675,Schijnpoortweg,2023-05-20,02:00:00,1,1,0,FMN 08 Schijnpoortweg
675,Schijnpoortweg,2023-05-20,03:00:00,0,0,0,FMN 08 Schijnpoortweg
675,Schijnpoortweg,2023-05-20,04:00:00,1,0,1,FMN 08 Schijnpoortweg
675,Schijnpoortweg,2023-05-20,05:00:00,0,0,0,FMN 08 Schijnpoortweg
675,Schijnpoortweg,2023-05-20,06:00:00,0,0,0,FMN 08 Schijnpoortweg
675,Schijnpoortweg,2023-05-20,07:00:00,1,1,0,FMN 08 Schijnpoortweg
675,Schijnpoortweg,2023-05-20,08:00:00,2,1,1,FMN 08 Schijnpoortweg
675,Schijnpoortweg,2023-05-20,09:00:00,0,0,0,FMN 08 Schijnpoortweg
675,Schijnpoortweg,2023-05-20,10:00:00,0,0,0,FMN 08 Schijnpoortweg
675,Schijnpoortweg,2023-05-20,11:00:00,0,0,0,FMN 08 Schijnpoortweg
675,Schijnpoortweg,2023-05-20,12:00:00,2,1,1,FMN 08 Schijnpoortweg
675,Schijnpoortweg,2023-05-20,13:00:00,2,0,2,FMN 08 Schijnpoortweg
675,Schijnpoortweg,2023-05-20,14:00:00,1,1,0,FMN 08 Schijnpoortweg
675,Schijnpoortweg,2023-05-20,15:00:00,4,1,3,FMN 08 Schijnpoortweg
675,Schijnpoortweg,2023-05-20,16:00:00,4,2,2,FMN 08 Schijnpoortweg
675,Schijnpoortweg,2023-05-20,17:00:00,22,7,15,FMN 08 Schijnpoortweg
675,Schijnpoortweg,2023-05-20,18:00:00,3,1,2,FMN 08 Schijnpoortweg
675,Schijnpoortweg,2023-05-20,19:00:00,14,1,13,FMN 08 Schijnpoortweg
675,Schijnpoortweg,2023-05-20,20:00:00,10,1,9,FMN 08 Schijnpoortweg
675,Schijnpoortweg,2023-05-20,21:00:00,3,2,1,FMN 08 Schijnpoortweg
675,Schijnpoortweg,2023-05-20,22:00:00,4,2,2,FMN 08 Schijnpoortweg
675,Schijnpoortweg,2023-05-20,23:00:00,33,30,3,FMN 08 Schijnpoortweg
675,Schijnpoortweg,2023-05-21,00:00:00,0,0,0,FMN 08 Schijnpoortweg
675,Schijnpoortweg,2023-05-21,01:00:00,1,1,0,FMN 08 Schijnpoortweg
675,Schijnpoortweg,2023-05-21,02:00:00,1,0,1,FMN 08 Schijnpoortweg
675,Schijnpoortweg,2023-05-21,03:00:00,1,1,0,FMN 08 Schijnpoortweg
675,Schijnpoortweg,2023-05-21,04:00:00,0,0,0,FMN 08 Schijnpoortweg
675,Schijnpoortweg,2023-05-21,05:00:00,0,0,0,FMN 08 Schijnpoortweg
675,Schijnpoortweg,2023-05-21,06:00:00,0,0,0,FMN 08 Schijnpoortweg
675,Schijnpoortweg,2023-05-21,07:00:00,0,0,0,FMN 08 Schijnpoortweg
675,Schijnpoortweg,2023-05-21,08:00:00,1,0,1,FMN 08 Schijnpoortweg
675,Schijnpoortweg,2023-05-21,09:00:00,0,0,0,FMN 08 Schijnpoortweg
675,Schijnpoortweg,2023-05-21,10:00:00,1,0,1,FMN 08 Schijnpoortweg
675,Schijnpoortweg,2023-05-21,11:00:00,1,0,1,FMN 08 Schijnpoortweg
675,Schijnpoortweg,2023-05-21,12:00:00,0,0,0,FMN 08 Schijnpoortweg
675,Schijnpoortweg,2023-05-21,13:00:00,0,0,0,FMN 08 Schijnpoortweg
675,Schijnpoortweg,2023-05-21,14:00:00,5,3,2,FMN 08 Schijnpoortweg
675,Schijnpoortweg,2023-05-21,15:00:00,3,0,3,FMN 08 Schijnpoortweg
675,Schijnpoortweg,2023-05-21,16:00:00,1,0,1,FMN 08 Schijnpoortweg
675,Schijnpoortweg,2023-05-21,17:00:00,4,1,3,FMN 08 Schijnpoortweg
675,Schijnpoortweg,2023-05-21,18:00:00,4,0,4,FMN 08 Schijnpoortweg
675,Schijnpoortweg,2023-05-21,19:00:00,5,0,5,FMN 08 Schijnpoortweg
675,Schijnpoortweg,2023-05-21,20:00:00,1,0,1,FMN 08 Schijnpoortweg
675,Schijnpoortweg,2023-05-21,21:00:00,1,0,1,FMN 08 Schijnpoortweg
675,Schijnpoortweg,2023-05-21,22:00:00,8,8,0,FMN 08 Schijnpoortweg
675,Schijnpoortweg,2023-05-21,23:00:00,0,0,0,FMN 08 Schijnpoortweg
675,Schijnpoortweg,2023-05-22,00:00:00,0,0,0,FMN 08 Schijnpoortweg
675,Schijnpoortweg,2023-05-22,01:00:00,1,1,0,FMN 08 Schijnpoortweg
675,Schijnpoortweg,2023-05-22,02:00:00,0,0,0,FMN 08 Schijnpoortweg
675,Schijnpoortweg,2023-05-22,03:00:00,0,0,0,FMN 08 Schijnpoortweg
675,Schijnpoortweg,2023-05-22,04:00:00,0,0,0,FMN 08 Schijnpoortweg
675,Schijnpoortweg,2023-05-22,05:00:00,1,0,1,FMN 08 Schijnpoortweg
675,Schijnpoortweg,2023-05-22,06:00:00,3,2,1,FMN 08 Schijnpoortweg
675,Schijnpoortweg,2023-05-22,07:00:00,2,1,1,FMN 08 Schijnpoortweg
675,Schijnpoortweg,2023-05-22,08:00:00,2,0,2,FMN 08 Schijnpoortweg
675,Schijnpoortweg,2023-05-22,09:00:00,1,0,1,FMN 08 Schijnpoortweg
675,Schijnpoortweg,2023-05-22,10:00:00,0,0,0,FMN 08 Schijnpoortweg
675,Schijnpoortweg,2023-05-22,11:00:00,0,0,0,FMN 08 Schijnpoortweg
675,Schijnpoortweg,2023-05-22,12:00:00,2,1,1,FMN 08 Schijnpoortweg
675,Schijnpoortweg,2023-05-22,13:00:00,0,0,0,FMN 08 Schijnpoortweg
675,Schijnpoortweg,2023-05-22,14:00:00,0,0,0,FMN 08 Schijnpoortweg
675,Schijnpoortweg,2023-05-22,15:00:00,3,1,2,FMN 08 Schijnpoortweg
675,Schijnpoortweg,2023-05-22,16:00:00,3,1,2,FMN 08 Schijnpoortweg
675,Schijnpoortweg,2023-05-22,17:00:00,3,1,2,FMN 08 Schijnpoortweg
675,Schijnpoortweg,2023-05-22,18:00:00,3,0,3,FMN 08 Schijnpoortweg
675,Schijnpoortweg,2023-05-22,19:00:00,1,0,1,FMN 08 Schijnpoortweg
675,Schijnpoortweg,2023-05-22,20:00:00,1,0,1,FMN 08 Schijnpoortweg
675,Schijnpoortweg,2023-05-22,21:00:00,4,1,3,FMN 08 Schijnpoortweg
675,Schijnpoortweg,2023-05-22,22:00:00,3,0,3,FMN 08 Schijnpoortweg
675,Schijnpoortweg,2023-05-22,23:00:00,1,0,1,FMN 08 Schijnpoortweg
675,Schijnpoortweg,2023-05-23,00:00:00,0,0,0,FMN 08 Schijnpoortweg
675,Schijnpoortweg,2023-05-23,01:00:00,0,0,0,FMN 08 Schijnpoortweg
675,Schijnpoortweg,2023-05-23,02:00:00,0,0,0,FMN 08 Schijnpoortweg
675,Schijnpoortweg,2023-05-23,03:00:00,1,0,1,FMN 08 Schijnpoortweg
675,Schijnpoortweg,2023-05-23,04:00:00,1,0,1,FMN 08 Schijnpoortweg
675,Schijnpoortweg,2023-05-23,05:00:00,5,0,5,FMN 08 Schijnpoortweg
675,Schijnpoortweg,2023-05-23,06:00:00,0,0,0,FMN 08 Schijnpoortweg
675,Schijnpoortweg,2023-05-23,07:00:00,1,0,1,FMN 08 Schijnpoortweg
675,Schijnpoortweg,2023-05-23,08:00:00,1,0,1,FMN 08 Schijnpoortweg
675,Schijnpoortweg,2023-05-23,09:00:00,2,0,2,FMN 08 Schijnpoortweg
675,Schijnpoortweg,2023-05-23,10:00:00,0,0,0,FMN 08 Schijnpoortweg
675,Schijnpoortweg,2023-05-23,11:00:00,1,0,1,FMN 08 Schijnpoortweg
675,Schijnpoortweg,2023-05-23,12:00:00,2,0,2,FMN 08 Schijnpoortweg
675,Schijnpoortweg,2023-05-23,13:00:00,0,0,0,FMN 08 Schijnpoortweg
675,Schijnpoortweg,2023-05-23,14:00:00,1,0,1,FMN 08 Schijnpoortweg
675,Schijnpoortweg,2023-05-23,15:00:00,1,1,0,FMN 08 Schijnpoortweg
675,Schijnpoortweg,2023-05-23,16:00:00,4,0,4,FMN 08 Schijnpoortweg
675,Schijnpoortweg,2023-05-23,17:00:00,0,0,0,FMN 08 Schijnpoortweg
675,Schijnpoortweg,2023-05-23,18:00:00,3,2,1,FMN 08 Schijnpoortweg
675,Schijnpoortweg,2023-05-23,19:00:00,0,0,0,FMN 08 Schijnpoortweg
675,Schijnpoortweg,2023-05-23,20:00:00,2,0,2,FMN 08 Schijnpoortweg
675,Schijnpoortweg,2023-05-23,21:00:00,1,0,1,FMN 08 Schijnpoortweg
675,Schijnpoortweg,2023-05-23,22:00:00,1,1,0,FMN 08 Schijnpoortweg
675,Schijnpoortweg,2023-05-23,23:00:00,0,0,0,FMN 08 Schijnpoortweg
675,Schijnpoortweg,2023-05-24,00:00:00,1,0,1,FMN 08 Schijnpoortweg
675,Schijnpoortweg,2023-05-24,01:00:00,2,0,2,FMN 08 Schijnpoortweg
675,Schijnpoortweg,2023-05-24,02:00:00,1,0,1,FMN 08 Schijnpoortweg
675,Schijnpoortweg,2023-05-24,03:00:00,0,0,0,FMN 08 Schijnpoortweg
675,Schijnpoortweg,2023-05-24,04:00:00,0,0,0,FMN 08 Schijnpoortweg
675,Schijnpoortweg,2023-05-24,05:00:00,2,0,2,FMN 08 Schijnpoortweg
675,Schijnpoortweg,2023-05-24,06:00:00,0,0,0,FMN 08 Schijnpoortweg
675,Schijnpoortweg,2023-05-24,07:00:00,2,0,2,FMN 08 Schijnpoortweg
675,Schijnpoortweg,2023-05-24,08:00:00,4,2,2,FMN 08 Schijnpoortweg
675,Schijnpoortweg,2023-05-24,09:00:00,2,0,2,FMN 08 Schijnpoortweg
675,Schijnpoortweg,2023-05-24,10:00:00,0,0,0,FMN 08 Schijnpoortweg
675,Schijnpoortweg,2023-05-24,11:00:00,1,0,1,FMN 08 Schijnpoortweg
675,Schijnpoortweg,2023-05-24,12:00:00,1,1,0,FMN 08 Schijnpoortweg
675,Schijnpoortweg,2023-05-24,13:00:00,0,0,0,FMN 08 Schijnpoortweg
675,Schijnpoortweg,2023-05-24,14:00:00,3,1,2,FMN 08 Schijnpoortweg
675,Schijnpoortweg,2023-05-24,15:00:00,1,0,1,FMN 08 Schijnpoortweg
675,Schijnpoortweg,2023-05-24,16:00:00,1,0,1,FMN 08 Schijnpoortweg
675,Schijnpoortweg,2023-05-24,17:00:00,1,1,0,FMN 08 Schijnpoortweg
675,Schijnpoortweg,2023-05-24,18:00:00,2,0,2,FMN 08 Schijnpoortweg
675,Schijnpoortweg,2023-05-24,19:00:00,1,1,0,FMN 08 Schijnpoortweg
675,Schijnpoortweg,2023-05-24,20:00:00,0,0,0,FMN 08 Schijnpoortweg
675,Schijnpoortweg,2023-05-24,21:00:00,0,0,0,FMN 08 Schijnpoortweg
675,Schijnpoortweg,2023-05-24,22:00:00,1,0,1,FMN 08 Schijnpoortweg
675,Schijnpoortweg,2023-05-24,23:00:00,2,1,1,FMN 08 Schijnpoortweg
675,Schijnpoortweg,2023-05-25,00:00:00,1,0,1,FMN 08 Schijnpoortweg
675,Schijnpoortweg,2023-05-25,01:00:00,2,1,1,FMN 08 Schijnpoortweg
675,Schijnpoortweg,2023-05-25,02:00:00,0,0,0,FMN 08 Schijnpoortweg
675,Schijnpoortweg,2023-05-25,03:00:00,1,1,0,FMN 08 Schijnpoortweg
675,Schijnpoortweg,2023-05-25,04:00:00,1,1,0,FMN 08 Schijnpoortweg
675,Schijnpoortweg,2023-05-25,05:00:00,1,0,1,FMN 08 Schijnpoortweg
675,Schijnpoortweg,2023-05-25,06:00:00,0,0,0,FMN 08 Schijnpoortweg
675,Schijnpoortweg,2023-05-25,07:00:00,4,4,0,FMN 08 Schijnpoortweg
675,Schijnpoortweg,2023-05-25,08:00:00,2,0,2,FMN 08 Schijnpoortweg
675,Schijnpoortweg,2023-05-25,09:00:00,2,0,2,FMN 08 Schijnpoortweg
675,Schijnpoortweg,2023-05-25,10:00:00,0,0,0,FMN 08 Schijnpoortweg
675,Schijnpoortweg,2023-05-25,11:00:00,1,1,0,FMN 08 Schijnpoortweg
675,Schijnpoortweg,2023-05-25,12:00:00,0,0,0,FMN 08 Schijnpoortweg
675,Schijnpoortweg,2023-05-25,13:00:00,0,0,0,FMN 08 Schijnpoortweg
675,Schijnpoortweg,2023-05-25,14:00:00,2,0,2,FMN 08 Schijnpoortweg
675,Schijnpoortweg,2023-05-25,15:00:00,0,0,0,FMN 08 Schijnpoortweg
675,Schijnpoortweg,2023-05-25,16:00:00,3,3,0,FMN 08 Schijnpoortweg
675,Schijnpoortweg,2023-05-25,17:00:00,1,0,1,FMN 08 Schijnpoortweg
675,Schijnpoortweg,2023-05-25,18:00:00,3,1,2,FMN 08 Schijnpoortweg
675,Schijnpoortweg,2023-05-25,19:00:00,3,1,2,FMN 08 Schijnpoortweg
675,Schijnpoortweg,2023-05-25,20:00:00,22,2,20,FMN 08 Schijnpoortweg
675,Schijnpoortweg,2023-05-25,21:00:00,2,0,2,FMN 08 Schijnpoortweg
675,Schijnpoortweg,2023-05-25,22:00:00,47,45,2,FMN 08 Schijnpoortweg
675,Schijnpoortweg,2023-05-25,23:00:00,3,0,3,FMN 08 Schijnpoortweg
675,Schijnpoortweg,2023-05-26,00:00:00,0,0,0,FMN 08 Schijnpoortweg
675,Schijnpoortweg,2023-05-26,01:00:00,0,0,0,FMN 08 Schijnpoortweg
675,Schijnpoortweg,2023-05-26,02:00:00,2,0,2,FMN 08 Schijnpoortweg
675,Schijnpoortweg,2023-05-26,03:00:00,1,0,1,FMN 08 Schijnpoortweg
675,Schijnpoortweg,2023-05-26,04:00:00,1,0,1,FMN 08 Schijnpoortweg
675,Schijnpoortweg,2023-05-26,05:00:00,2,0,2,FMN 08 Schijnpoortweg
675,Schijnpoortweg,2023-05-26,06:00:00,1,1,0,FMN 08 Schijnpoortweg
675,Schijnpoortweg,2023-05-26,07:00:00,0,0,0,FMN 08 Schijnpoortweg
675,Schijnpoortweg,2023-05-26,08:00:00,2,1,1,FMN 08 Schijnpoortweg
675,Schijnpoortweg,2023-05-26,09:00:00,1,1,0,FMN 08 Schijnpoortweg
675,Schijnpoortweg,2023-05-26,10:00:00,1,0,1,FMN 08 Schijnpoortweg
675,Schijnpoortweg,2023-05-26,11:00:00,1,1,0,FMN 08 Schijnpoortweg
675,Schijnpoortweg,2023-05-26,12:00:00,1,1,0,FMN 08 Schijnpoortweg
675,Schijnpoortweg,2023-05-26,13:00:00,2,2,0,FMN 08 Schijnpoortweg
675,Schijnpoortweg,2023-05-26,14:00:00,3,1,2,FMN 08 Schijnpoortweg
675,Schijnpoortweg,2023-05-26,15:00:00,3,1,2,FMN 08 Schijnpoortweg
675,Schijnpoortweg,2023-05-26,16:00:00,1,1,0,FMN 08 Schijnpoortweg
675,Schijnpoortweg,2023-05-26,17:00:00,1,1,0,FMN 08 Schijnpoortweg
675,Schijnpoortweg,2023-05-26,18:00:00,3,2,1,FMN 08 Schijnpoortweg
675,Schijnpoortweg,2023-05-26,19:00:00,4,2,2,FMN 08 Schijnpoortweg
675,Schijnpoortweg,2023-05-26,20:00:00,2,1,1,FMN 08 Schijnpoortweg
675,Schijnpoortweg,2023-05-26,21:00:00,0,0,0,FMN 08 Schijnpoortweg
675,Schijnpoortweg,2023-05-26,22:00:00,2,1,1,FMN 08 Schijnpoortweg
675,Schijnpoortweg,2023-05-26,23:00:00,2,1,1,FMN 08 Schijnpoortweg
675,Schijnpoortweg,2023-05-27,00:00:00,1,1,0,FMN 08 Schijnpoortweg
675,Schijnpoortweg,2023-05-27,01:00:00,0,0,0,FMN 08 Schijnpoortweg
675,Schijnpoortweg,2023-05-27,02:00:00,0,0,0,FMN 08 Schijnpoortweg
675,Schijnpoortweg,2023-05-27,03:00:00,2,2,0,FMN 08 Schijnpoortweg
675,Schijnpoortweg,2023-05-27,04:00:00,0,0,0,FMN 08 Schijnpoortweg
675,Schijnpoortweg,2023-05-27,05:00:00,1,0,1,FMN 08 Schijnpoortweg
675,Schijnpoortweg,2023-05-27,06:00:00,0,0,0,FMN 08 Schijnpoortweg
675,Schijnpoortweg,2023-05-27,07:00:00,0,0,0,FMN 08 Schijnpoortweg
675,Schijnpoortweg,2023-05-27,08:00:00,0,0,0,FMN 08 Schijnpoortweg
675,Schijnpoortweg,2023-05-27,09:00:00,1,0,1,FMN 08 Schijnpoortweg
675,Schijnpoortweg,2023-05-27,10:00:00,0,0,0,FMN 08 Schijnpoortweg
675,Schijnpoortweg,2023-05-27,11:00:00,2,0,2,FMN 08 Schijnpoortweg
675,Schijnpoortweg,2023-05-27,12:00:00,1,0,1,FMN 08 Schijnpoortweg
675,Schijnpoortweg,2023-05-27,13:00:00,1,1,0,FMN 08 Schijnpoortweg
675,Schijnpoortweg,2023-05-27,14:00:00,1,0,1,FMN 08 Schijnpoortweg
675,Schijnpoortweg,2023-05-27,15:00:00,6,3,3,FMN 08 Schijnpoortweg
675,Schijnpoortweg,2023-05-27,16:00:00,0,0,0,FMN 08 Schijnpoortweg
675,Schijnpoortweg,2023-05-27,17:00:00,5,1,4,FMN 08 Schijnpoortweg
675,Schijnpoortweg,2023-05-27,18:00:00,15,1,14,FMN 08 Schijnpoortweg
675,Schijnpoortweg,2023-05-27,19:00:00,19,4,15,FMN 08 Schijnpoortweg
675,Schijnpoortweg,2023-05-27,20:00:00,0,0,0,FMN 08 Schijnpoortweg
675,Schijnpoortweg,2023-05-27,21:00:00,7,5,2,FMN 08 Schijnpoortweg
675,Schijnpoortweg,2023-05-27,22:00:00,41,33,8,FMN 08 Schijnpoortweg
675,Schijnpoortweg,2023-05-27,23:00:00,2,1,1,FMN 08 Schijnpoortweg
675,Schijnpoortweg,2023-05-28,00:00:00,1,0,1,FMN 08 Schijnpoortweg
675,Schijnpoortweg,2023-05-28,01:00:00,0,0,0,FMN 08 Schijnpoortweg
675,Schijnpoortweg,2023-05-28,02:00:00,0,0,0,FMN 08 Schijnpoortweg
675,Schijnpoortweg,2023-05-28,03:00:00,1,0,1,FMN 08 Schijnpoortweg
675,Schijnpoortweg,2023-05-28,04:00:00,0,0,0,FMN 08 Schijnpoortweg
675,Schijnpoortweg,2023-05-28,05:00:00,0,0,0,FMN 08 Schijnpoortweg
675,Schijnpoortweg,2023-05-28,06:00:00,2,2,0,FMN 08 Schijnpoortweg
675,Schijnpoortweg,2023-05-28,07:00:00,0,0,0,FMN 08 Schijnpoortweg
675,Schijnpoortweg,2023-05-28,08:00:00,1,0,1,FMN 08 Schijnpoortweg
675,Schijnpoortweg,2023-05-28,09:00:00,1,0,1,FMN 08 Schijnpoortweg
675,Schijnpoortweg,2023-05-28,10:00:00,0,0,0,FMN 08 Schijnpoortweg
675,Schijnpoortweg,2023-05-28,11:00:00,1,0,1,FMN 08 Schijnpoortweg
675,Schijnpoortweg,2023-05-28,12:00:00,0,0,0,FMN 08 Schijnpoortweg
675,Schijnpoortweg,2023-05-28,13:00:00,4,1,3,FMN 08 Schijnpoortweg
675,Schijnpoortweg,2023-05-28,14:00:00,6,1,5,FMN 08 Schijnpoortweg
675,Schijnpoortweg,2023-05-28,15:00:00,1,0,1,FMN 08 Schijnpoortweg
675,Schijnpoortweg,2023-05-28,16:00:00,6,1,5,FMN 08 Schijnpoortweg
675,Schijnpoortweg,2023-05-28,17:00:00,6,3,3,FMN 08 Schijnpoortweg
675,Schijnpoortweg,2023-05-28,18:00:00,22,1,21,FMN 08 Schijnpoortweg
675,Schijnpoortweg,2023-05-28,19:00:00,10,1,9,FMN 08 Schijnpoortweg
675,Schijnpoortweg,2023-05-28,20:00:00,3,1,2,FMN 08 Schijnpoortweg
675,Schijnpoortweg,2023-05-28,21:00:00,8,3,5,FMN 08 Schijnpoortweg
675,Schijnpoortweg,2023-05-28,22:00:00,52,44,8,FMN 08 Schijnpoortweg
675,Schijnpoortweg,2023-05-28,23:00:00,8,4,4,FMN 08 Schijnpoortweg
675,Schijnpoortweg,2023-05-29,00:00:00,1,0,1,FMN 08 Schijnpoortweg
675,Schijnpoortweg,2023-05-29,01:00:00,0,0,0,FMN 08 Schijnpoortweg
675,Schijnpoortweg,2023-05-29,02:00:00,0,0,0,FMN 08 Schijnpoortweg
675,Schijnpoortweg,2023-05-29,03:00:00,0,0,0,FMN 08 Schijnpoortweg
675,Schijnpoortweg,2023-05-29,04:00:00,2,0,2,FMN 08 Schijnpoortweg
675,Schijnpoortweg,2023-05-29,05:00:00,0,0,0,FMN 08 Schijnpoortweg
675,Schijnpoortweg,2023-05-29,06:00:00,1,0,1,FMN 08 Schijnpoortweg
675,Schijnpoortweg,2023-05-29,07:00:00,1,0,1,FMN 08 Schijnpoortweg
675,Schijnpoortweg,2023-05-29,08:00:00,1,1,0,FMN 08 Schijnpoortweg
675,Schijnpoortweg,2023-05-29,09:00:00,1,0,1,FMN 08 Schijnpoortweg
675,Schijnpoortweg,2023-05-29,10:00:00,0,0,0,FMN 08 Schijnpoortweg
675,Schijnpoortweg,2023-05-29,11:00:00,0,0,0,FMN 08 Schijnpoortweg
675,Schijnpoortweg,2023-05-29,12:00:00,2,1,1,FMN 08 Schijnpoortweg
675,Schijnpoortweg,2023-05-29,13:00:00,0,0,0,FMN 08 Schijnpoortweg
675,Schijnpoortweg,2023-05-29,14:00:00,5,0,5,FMN 08 Schijnpoortweg
675,Schijnpoortweg,2023-05-29,15:00:00,2,0,2,FMN 08 Schijnpoortweg
675,Schijnpoortweg,2023-05-29,16:00:00,2,0,2,FMN 08 Schijnpoortweg
675,Schijnpoortweg,2023-05-29,17:00:00,4,2,2,FMN 08 Schijnpoortweg
675,Schijnpoortweg,2023-05-29,18:00:00,6,2,4,FMN 08 Schijnpoortweg
675,Schijnpoortweg,2023-05-29,19:00:00,5,3,2,FMN 08 Schijnpoortweg
675,Schijnpoortweg,2023-05-29,20:00:00,4,2,2,FMN 08 Schijnpoortweg
675,Schijnpoortweg,2023-05-29,21:00:00,3,1,2,FMN 08 Schijnpoortweg
675,Schijnpoortweg,2023-05-29,22:00:00,2,2,0,FMN 08 Schijnpoortweg
675,Schijnpoortweg,2023-05-29,23:00:00,1,1,0,FMN 08 Schijnpoortweg
675,Schijnpoortweg,2023-05-30,00:00:00,0,0,0,FMN 08 Schijnpoortweg
675,Schijnpoortweg,2023-05-30,01:00:00,0,0,0,FMN 08 Schijnpoortweg
675,Schijnpoortweg,2023-05-30,02:00:00,0,0,0,FMN 08 Schijnpoortweg
675,Schijnpoortweg,2023-05-30,03:00:00,0,0,0,FMN 08 Schijnpoortweg
675,Schijnpoortweg,2023-05-30,04:00:00,2,0,2,FMN 08 Schijnpoortweg
675,Schijnpoortweg,2023-05-30,05:00:00,2,0,2,FMN 08 Schijnpoortweg
675,Schijnpoortweg,2023-05-30,06:00:00,2,2,0,FMN 08 Schijnpoortweg
675,Schijnpoortweg,2023-05-30,07:00:00,0,0,0,FMN 08 Schijnpoortweg
675,Schijnpoortweg,2023-05-30,08:00:00,0,0,0,FMN 08 Schijnpoortweg
675,Schijnpoortweg,2023-05-30,09:00:00,0,0,0,FMN 08 Schijnpoortweg
675,Schijnpoortweg,2023-05-30,10:00:00,1,1,0,FMN 08 Schijnpoortweg
675,Schijnpoortweg,2023-05-30,11:00:00,2,0,2,FMN 08 Schijnpoortweg
675,Schijnpoortweg,2023-05-30,12:00:00,0,0,0,FMN 08 Schijnpoortweg
675,Schijnpoortweg,2023-05-30,13:00:00,2,2,0,FMN 08 Schijnpoortweg
675,Schijnpoortweg,2023-05-30,14:00:00,2,1,1,FMN 08 Schijnpoortweg
675,Schijnpoortweg,2023-05-30,15:00:00,1,0,1,FMN 08 Schijnpoortweg
675,Schijnpoortweg,2023-05-30,16:00:00,1,0,1,FMN 08 Schijnpoortweg
675,Schijnpoortweg,2023-05-30,17:00:00,5,2,3,FMN 08 Schijnpoortweg
675,Schijnpoortweg,2023-05-30,18:00:00,3,1,2,FMN 08 Schijnpoortweg
675,Schijnpoortweg,2023-05-30,19:00:00,5,1,4,FMN 08 Schijnpoortweg
675,Schijnpoortweg,2023-05-30,20:00:00,2,0,2,FMN 08 Schijnpoortweg
675,Schijnpoortweg,2023-05-30,21:00:00,1,0,1,FMN 08 Schijnpoortweg
675,Schijnpoortweg,2023-05-30,22:00:00,1,0,1,FMN 08 Schijnpoortweg
675,Schijnpoortweg,2023-05-30,23:00:00,0,0,0,FMN 08 Schijnpoortweg
675,Schijnpoortweg,2023-05-31,00:00:00,1,0,1,FMN 08 Schijnpoortweg
675,Schijnpoortweg,2023-05-31,01:00:00,1,1,0,FMN 08 Schijnpoortweg
675,Schijnpoortweg,2023-05-31,02:00:00,0,0,0,FMN 08 Schijnpoortweg
675,Schijnpoortweg,2023-05-31,03:00:00,1,1,0,FMN 08 Schijnpoortweg
675,Schijnpoortweg,2023-05-31,04:00:00,1,0,1,FMN 08 Schijnpoortweg
675,Schijnpoortweg,2023-05-31,05:00:00,2,0,2,FMN 08 Schijnpoortweg
675,Schijnpoortweg,2023-05-31,06:00:00,3,1,2,FMN 08 Schijnpoortweg
675,Schijnpoortweg,2023-05-31,07:00:00,1,1,0,FMN 08 Schijnpoortweg
675,Schijnpoortweg,2023-05-31,08:00:00,3,0,3,FMN 08 Schijnpoortweg
675,Schijnpoortweg,2023-05-31,09:00:00,3,1,2,FMN 08 Schijnpoortweg
675,Schijnpoortweg,2023-05-31,10:00:00,2,1,1,FMN 08 Schijnpoortweg
675,Schijnpoortweg,2023-05-31,11:00:00,1,1,0,FMN 08 Schijnpoortweg
675,Schijnpoortweg,2023-05-31,12:00:00,2,0,2,FMN 08 Schijnpoortweg
675,Schijnpoortweg,2023-05-31,13:00:00,2,0,2,FMN 08 Schijnpoortweg
675,Schijnpoortweg,2023-05-31,14:00:00,3,0,3,FMN 08 Schijnpoortweg
675,Schijnpoortweg,2023-05-31,15:00:00,3,0,3,FMN 08 Schijnpoortweg
675,Schijnpoortweg,2023-05-31,16:00:00,3,1,2,FMN 08 Schijnpoortweg
675,Schijnpoortweg,2023-05-31,17:00:00,4,1,3,FMN 08 Schijnpoortweg
675,Schijnpoortweg,2023-05-31,18:00:00,5,1,4,FMN 08 Schijnpoortweg
675,Schijnpoortweg,2023-05-31,19:00:00,2,1,1,FMN 08 Schijnpoortweg
675,Schijnpoortweg,2023-05-31,20:00:00,4,1,3,FMN 08 Schijnpoortweg
675,Schijnpoortweg,2023-05-31,21:00:00,3,1,2,FMN 08 Schijnpoortweg
675,Schijnpoortweg,2023-05-31,22:00:00,0,0,0,FMN 08 Schijnpoortweg
675,Schijnpoortweg,2023-05-31,23:00:00,2,0,2,FMN 08 Schijnpoortweg
675,Schijnpoortweg,2023-06-01,00:00:00,3,2,1,FMN 08 Schijnpoortweg
675,Schijnpoortweg,2023-06-01,01:00:00,0,0,0,FMN 08 Schijnpoortweg
675,Schijnpoortweg,2023-06-01,02:00:00,1,1,0,FMN 08 Schijnpoortweg
675,Schijnpoortweg,2023-06-01,03:00:00,0,0,0,FMN 08 Schijnpoortweg
675,Schijnpoortweg,2023-06-01,04:00:00,0,0,0,FMN 08 Schijnpoortweg
675,Schijnpoortweg,2023-06-01,05:00:00,1,0,1,FMN 08 Schijnpoortweg
675,Schijnpoortweg,2023-06-01,06:00:00,2,2,0,FMN 08 Schijnpoortweg
675,Schijnpoortweg,2023-06-01,07:00:00,1,1,0,FMN 08 Schijnpoortweg
675,Schijnpoortweg,2023-06-01,08:00:00,0,0,0,FMN 08 Schijnpoortweg
675,Schijnpoortweg,2023-06-01,09:00:00,2,0,2,FMN 08 Schijnpoortweg
675,Schijnpoortweg,2023-06-01,10:00:00,2,1,1,FMN 08 Schijnpoortweg
675,Schijnpoortweg,2023-06-01,11:00:00,2,1,1,FMN 08 Schijnpoortweg
675,Schijnpoortweg,2023-06-01,12:00:00,0,0,0,FMN 08 Schijnpoortweg
675,Schijnpoortweg,2023-06-01,13:00:00,0,0,0,FMN 08 Schijnpoortweg
675,Schijnpoortweg,2023-06-01,14:00:00,1,0,1,FMN 08 Schijnpoortweg
675,Schijnpoortweg,2023-06-01,15:00:00,4,1,3,FMN 08 Schijnpoortweg
675,Schijnpoortweg,2023-06-01,16:00:00,1,0,1,FMN 08 Schijnpoortweg
675,Schijnpoortweg,2023-06-01,17:00:00,2,1,1,FMN 08 Schijnpoortweg
675,Schijnpoortweg,2023-06-01,18:00:00,3,2,1,FMN 08 Schijnpoortweg
675,Schijnpoortweg,2023-06-01,19:00:00,1,0,1,FMN 08 Schijnpoortweg
675,Schijnpoortweg,2023-06-01,20:00:00,2,0,2,FMN 08 Schijnpoortweg
675,Schijnpoortweg,2023-06-01,21:00:00,3,1,2,FMN 08 Schijnpoortweg
675,Schijnpoortweg,2023-06-01,22:00:00,1,0,1,FMN 08 Schijnpoortweg
675,Schijnpoortweg,2023-06-01,23:00:00,2,0,2,FMN 08 Schijnpoortweg
675,Schijnpoortweg,2023-06-02,00:00:00,0,0,0,FMN 08 Schijnpoortweg
675,Schijnpoortweg,2023-06-02,01:00:00,1,1,0,FMN 08 Schijnpoortweg
675,Schijnpoortweg,2023-06-02,02:00:00,0,0,0,FMN 08 Schijnpoortweg
675,Schijnpoortweg,2023-06-02,03:00:00,0,0,0,FMN 08 Schijnpoortweg
675,Schijnpoortweg,2023-06-02,04:00:00,1,0,1,FMN 08 Schijnpoortweg
675,Schijnpoortweg,2023-06-02,05:00:00,1,0,1,FMN 08 Schijnpoortweg
675,Schijnpoortweg,2023-06-02,06:00:00,1,1,0,FMN 08 Schijnpoortweg
675,Schijnpoortweg,2023-06-02,07:00:00,3,2,1,FMN 08 Schijnpoortweg
675,Schijnpoortweg,2023-06-02,08:00:00,1,0,1,FMN 08 Schijnpoortweg
675,Schijnpoortweg,2023-06-02,09:00:00,5,1,4,FMN 08 Schijnpoortweg
675,Schijnpoortweg,2023-06-02,10:00:00,2,1,1,FMN 08 Schijnpoortweg
675,Schijnpoortweg,2023-06-02,11:00:00,1,0,1,FMN 08 Schijnpoortweg
675,Schijnpoortweg,2023-06-02,12:00:00,2,0,2,FMN 08 Schijnpoortweg
675,Schijnpoortweg,2023-06-02,13:00:00,1,0,1,FMN 08 Schijnpoortweg
675,Schijnpoortweg,2023-06-02,14:00:00,5,1,4,FMN 08 Schijnpoortweg
675,Schijnpoortweg,2023-06-02,15:00:00,2,0,2,FMN 08 Schijnpoortweg
675,Schijnpoortweg,2023-06-02,16:00:00,3,1,2,FMN 08 Schijnpoortweg
675,Schijnpoortweg,2023-06-02,17:00:00,2,0,2,FMN 08 Schijnpoortweg
675,Schijnpoortweg,2023-06-02,18:00:00,5,1,4,FMN 08 Schijnpoortweg
675,Schijnpoortweg,2023-06-02,19:00:00,2,0,2,FMN 08 Schijnpoortweg
675,Schijnpoortweg,2023-06-02,20:00:00,3,1,2,FMN 08 Schijnpoortweg
675,Schijnpoortweg,2023-06-02,21:00:00,2,0,2,FMN 08 Schijnpoortweg
675,Schijnpoortweg,2023-06-02,22:00:00,6,3,3,FMN 08 Schijnpoortweg
675,Schijnpoortweg,2023-06-02,23:00:00,1,1,0,FMN 08 Schijnpoortweg
675,Schijnpoortweg,2023-06-03,00:00:00,1,0,1,FMN 08 Schijnpoortweg
675,Schijnpoortweg,2023-06-03,01:00:00,1,0,1,FMN 08 Schijnpoortweg
675,Schijnpoortweg,2023-06-03,02:00:00,0,0,0,FMN 08 Schijnpoortweg
675,Schijnpoortweg,2023-06-03,03:00:00,0,0,0,FMN 08 Schijnpoortweg
675,Schijnpoortweg,2023-06-03,04:00:00,0,0,0,FMN 08 Schijnpoortweg
675,Schijnpoortweg,2023-06-03,05:00:00,0,0,0,FMN 08 Schijnpoortweg
675,Schijnpoortweg,2023-06-03,06:00:00,3,1,2,FMN 08 Schijnpoortweg
675,Schijnpoortweg,2023-06-03,07:00:00,0,0,0,FMN 08 Schijnpoortweg
675,Schijnpoortweg,2023-06-03,08:00:00,1,1,0,FMN 08 Schijnpoortweg
675,Schijnpoortweg,2023-06-03,09:00:00,0,0,0,FMN 08 Schijnpoortweg
675,Schijnpoortweg,2023-06-03,10:00:00,0,0,0,FMN 08 Schijnpoortweg
675,Schijnpoortweg,2023-06-03,11:00:00,2,1,1,FMN 08 Schijnpoortweg
675,Schijnpoortweg,2023-06-03,12:00:00,1,0,1,FMN 08 Schijnpoortweg
675,Schijnpoortweg,2023-06-03,13:00:00,1,0,1,FMN 08 Schijnpoortweg
675,Schijnpoortweg,2023-06-03,14:00:00,1,1,0,FMN 08 Schijnpoortweg
675,Schijnpoortweg,2023-06-03,15:00:00,3,0,3,FMN 08 Schijnpoortweg
675,Schijnpoortweg,2023-06-03,16:00:00,1,0,1,FMN 08 Schijnpoortweg
675,Schijnpoortweg,2023-06-03,17:00:00,7,2,5,FMN 08 Schijnpoortweg
675,Schijnpoortweg,2023-06-03,18:00:00,1,0,1,FMN 08 Schijnpoortweg
675,Schijnpoortweg,2023-06-03,19:00:00,7,6,1,FMN 08 Schijnpoortweg
675,Schijnpoortweg,2023-06-03,20:00:00,3,3,0,FMN 08 Schijnpoortweg
675,Schijnpoortweg,2023-06-03,21:00:00,7,3,4,FMN 08 Schijnpoortweg
675,Schijnpoortweg,2023-06-03,22:00:00,0,0,0,FMN 08 Schijnpoortweg
675,Schijnpoortweg,2023-06-03,23:00:00,2,2,0,FMN 08 Schijnpoortweg
675,Schijnpoortweg,2023-06-04,00:00:00,1,0,1,FMN 08 Schijnpoortweg
675,Schijnpoortweg,2023-06-04,01:00:00,2,1,1,FMN 08 Schijnpoortweg
675,Schijnpoortweg,2023-06-04,02:00:00,0,0,0,FMN 08 Schijnpoortweg
675,Schijnpoortweg,2023-06-04,03:00:00,0,0,0,FMN 08 Schijnpoortweg
675,Schijnpoortweg,2023-06-04,04:00:00,1,0,1,FMN 08 Schijnpoortweg
675,Schijnpoortweg,2023-06-04,05:00:00,0,0,0,FMN 08 Schijnpoortweg
675,Schijnpoortweg,2023-06-04,06:00:00,2,1,1,FMN 08 Schijnpoortweg
675,Schijnpoortweg,2023-06-04,07:00:00,1,0,1,FMN 08 Schijnpoortweg
675,Schijnpoortweg,2023-06-04,08:00:00,1,1,0,FMN 08 Schijnpoortweg
675,Schijnpoortweg,2023-06-04,09:00:00,1,0,1,FMN 08 Schijnpoortweg
675,Schijnpoortweg,2023-06-04,10:00:00,2,1,1,FMN 08 Schijnpoortweg
675,Schijnpoortweg,2023-06-04,11:00:00,1,0,1,FMN 08 Schijnpoortweg
675,Schijnpoortweg,2023-06-04,12:00:00,0,0,0,FMN 08 Schijnpoortweg
675,Schijnpoortweg,2023-06-04,13:00:00,0,0,0,FMN 08 Schijnpoortweg
675,Schijnpoortweg,2023-06-04,14:00:00,1,0,1,FMN 08 Schijnpoortweg
675,Schijnpoortweg,2023-06-04,15:00:00,2,0,2,FMN 08 Schijnpoortweg
675,Schijnpoortweg,2023-06-04,16:00:00,2,2,0,FMN 08 Schijnpoortweg
675,Schijnpoortweg,2023-06-04,17:00:00,2,1,1,FMN 08 Schijnpoortweg
675,Schijnpoortweg,2023-06-04,18:00:00,5,1,4,FMN 08 Schijnpoortweg
675,Schijnpoortweg,2023-06-04,19:00:00,3,1,2,FMN 08 Schijnpoortweg
675,Schijnpoortweg,2023-06-04,20:00:00,7,3,4,FMN 08 Schijnpoortweg
675,Schijnpoortweg,2023-06-04,21:00:00,2,1,1,FMN 08 Schijnpoortweg
675,Schijnpoortweg,2023-06-04,22:00:00,4,4,0,FMN 08 Schijnpoortweg
675,Schijnpoortweg,2023-06-04,23:00:00,2,2,0,FMN 08 Schijnpoortweg
675,Schijnpoortweg,2023-06-05,00:00:00,2,1,1,FMN 08 Schijnpoortweg
675,Schijnpoortweg,2023-06-05,01:00:00,0,0,0,FMN 08 Schijnpoortweg
675,Schijnpoortweg,2023-06-05,02:00:00,1,1,0,FMN 08 Schijnpoortweg
675,Schijnpoortweg,2023-06-05,03:00:00,0,0,0,FMN 08 Schijnpoortweg
675,Schijnpoortweg,2023-06-05,04:00:00,2,2,0,FMN 08 Schijnpoortweg
675,Schijnpoortweg,2023-06-05,05:00:00,2,0,2,FMN 08 Schijnpoortweg
675,Schijnpoortweg,2023-06-05,06:00:00,3,3,0,FMN 08 Schijnpoortweg
675,Schijnpoortweg,2023-06-05,07:00:00,3,3,0,FMN 08 Schijnpoortweg
675,Schijnpoortweg,2023-06-05,08:00:00,1,0,1,FMN 08 Schijnpoortweg
675,Schijnpoortweg,2023-06-05,09:00:00,3,1,2,FMN 08 Schijnpoortweg
675,Schijnpoortweg,2023-06-05,10:00:00,2,2,0,FMN 08 Schijnpoortweg
675,Schijnpoortweg,2023-06-05,11:00:00,0,0,0,FMN 08 Schijnpoortweg
675,Schijnpoortweg,2023-06-05,12:00:00,1,1,0,FMN 08 Schijnpoortweg
675,Schijnpoortweg,2023-06-05,13:00:00,0,0,0,FMN 08 Schijnpoortweg
675,Schijnpoortweg,2023-06-05,14:00:00,0,0,0,FMN 08 Schijnpoortweg
675,Schijnpoortweg,2023-06-05,15:00:00,2,0,2,FMN 08 Schijnpoortweg
675,Schijnpoortweg,2023-06-05,16:00:00,5,2,3,FMN 08 Schijnpoortweg
675,Schijnpoortweg,2023-06-05,17:00:00,6,5,1,FMN 08 Schijnpoortweg
675,Schijnpoortweg,2023-06-05,18:00:00,3,0,3,FMN 08 Schijnpoortweg
675,Schijnpoortweg,2023-06-05,19:00:00,0,0,0,FMN 08 Schijnpoortweg
675,Schijnpoortweg,2023-06-05,20:00:00,4,1,3,FMN 08 Schijnpoortweg
675,Schijnpoortweg,2023-06-05,21:00:00,3,1,2,FMN 08 Schijnpoortweg
675,Schijnpoortweg,2023-06-05,22:00:00,3,1,2,FMN 08 Schijnpoortweg
675,Schijnpoortweg,2023-06-05,23:00:00,2,1,1,FMN 08 Schijnpoortweg
675,Schijnpoortweg,2023-06-06,00:00:00,2,0,2,FMN 08 Schijnpoortweg
675,Schijnpoortweg,2023-06-06,01:00:00,0,0,0,FMN 08 Schijnpoortweg
675,Schijnpoortweg,2023-06-06,02:00:00,0,0,0,FMN 08 Schijnpoortweg
675,Schijnpoortweg,2023-06-06,03:00:00,0,0,0,FMN 08 Schijnpoortweg
675,Schijnpoortweg,2023-06-06,04:00:00,1,0,1,FMN 08 Schijnpoortweg
675,Schijnpoortweg,2023-06-06,05:00:00,2,0,2,FMN 08 Schijnpoortweg
675,Schijnpoortweg,2023-06-06,06:00:00,1,1,0,FMN 08 Schijnpoortweg
675,Schijnpoortweg,2023-06-06,07:00:00,0,0,0,FMN 08 Schijnpoortweg
675,Schijnpoortweg,2023-06-06,08:00:00,2,1,1,FMN 08 Schijnpoortweg
675,Schijnpoortweg,2023-06-06,09:00:00,0,0,0,FMN 08 Schijnpoortweg
675,Schijnpoortweg,2023-06-06,10:00:00,1,1,0,FMN 08 Schijnpoortweg
675,Schijnpoortweg,2023-06-06,11:00:00,0,0,0,FMN 08 Schijnpoortweg
675,Schijnpoortweg,2023-06-06,12:00:00,2,1,1,FMN 08 Schijnpoortweg
675,Schijnpoortweg,2023-06-06,13:00:00,1,0,1,FMN 08 Schijnpoortweg
675,Schijnpoortweg,2023-06-06,14:00:00,3,1,2,FMN 08 Schijnpoortweg
675,Schijnpoortweg,2023-06-06,15:00:00,4,2,2,FMN 08 Schijnpoortweg
675,Schijnpoortweg,2023-06-06,16:00:00,3,2,1,FMN 08 Schijnpoortweg
675,Schijnpoortweg,2023-06-06,17:00:00,2,1,1,FMN 08 Schijnpoortweg
675,Schijnpoortweg,2023-06-06,18:00:00,6,1,5,FMN 08 Schijnpoortweg
675,Schijnpoortweg,2023-06-06,19:00:00,21,0,21,FMN 08 Schijnpoortweg
675,Schijnpoortweg,2023-06-06,20:00:00,1,0,1,FMN 08 Schijnpoortweg
675,Schijnpoortweg,2023-06-06,21:00:00,0,0,0,FMN 08 Schijnpoortweg
675,Schijnpoortweg,2023-06-06,22:00:00,12,10,2,FMN 08 Schijnpoortweg
675,Schijnpoortweg,2023-06-06,23:00:00,16,14,2,FMN 08 Schijnpoortweg
675,Schijnpoortweg,2023-06-07,00:00:00,0,0,0,FMN 08 Schijnpoortweg
675,Schijnpoortweg,2023-06-07,01:00:00,0,0,0,FMN 08 Schijnpoortweg
675,Schijnpoortweg,2023-06-07,02:00:00,1,0,1,FMN 08 Schijnpoortweg
675,Schijnpoortweg,2023-06-07,03:00:00,0,0,0,FMN 08 Schijnpoortweg
675,Schijnpoortweg,2023-06-07,04:00:00,1,1,0,FMN 08 Schijnpoortweg
675,Schijnpoortweg,2023-06-07,05:00:00,1,0,1,FMN 08 Schijnpoortweg
675,Schijnpoortweg,2023-06-07,06:00:00,1,1,0,FMN 08 Schijnpoortweg
675,Schijnpoortweg,2023-06-07,07:00:00,0,0,0,FMN 08 Schijnpoortweg
675,Schijnpoortweg,2023-06-07,08:00:00,4,1,3,FMN 08 Schijnpoortweg
675,Schijnpoortweg,2023-06-07,09:00:00,0,0,0,FMN 08 Schijnpoortweg
675,Schijnpoortweg,2023-06-07,10:00:00,1,1,0,FMN 08 Schijnpoortweg
675,Schijnpoortweg,2023-06-07,11:00:00,1,0,1,FMN 08 Schijnpoortweg
675,Schijnpoortweg,2023-06-07,12:00:00,2,1,1,FMN 08 Schijnpoortweg
675,Schijnpoortweg,2023-06-07,13:00:00,1,0,1,FMN 08 Schijnpoortweg
675,Schijnpoortweg,2023-06-07,14:00:00,1,0,1,FMN 08 Schijnpoortweg
675,Schijnpoortweg,2023-06-07,15:00:00,1,0,1,FMN 08 Schijnpoortweg
675,Schijnpoortweg,2023-06-07,16:00:00,2,0,2,FMN 08 Schijnpoortweg
675,Schijnpoortweg,2023-06-07,17:00:00,1,1,0,FMN 08 Schijnpoortweg
675,Schijnpoortweg,2023-06-07,18:00:00,0,0,0,FMN 08 Schijnpoortweg
675,Schijnpoortweg,2023-06-07,19:00:00,2,1,1,FMN 08 Schijnpoortweg
675,Schijnpoortweg,2023-06-07,20:00:00,5,1,4,FMN 08 Schijnpoortweg
675,Schijnpoortweg,2023-06-07,21:00:00,5,3,2,FMN 08 Schijnpoortweg
675,Schijnpoortweg,2023-06-07,22:00:00,2,1,1,FMN 08 Schijnpoortweg
675,Schijnpoortweg,2023-06-07,23:00:00,2,1,1,FMN 08 Schijnpoortweg
675,Schijnpoortweg,2023-06-08,00:00:00,0,0,0,FMN 08 Schijnpoortweg
675,Schijnpoortweg,2023-06-08,01:00:00,0,0,0,FMN 08 Schijnpoortweg
675,Schijnpoortweg,2023-06-08,02:00:00,0,0,0,FMN 08 Schijnpoortweg
675,Schijnpoortweg,2023-06-08,03:00:00,0,0,0,FMN 08 Schijnpoortweg
675,Schijnpoortweg,2023-06-08,04:00:00,0,0,0,FMN 08 Schijnpoortweg
675,Schijnpoortweg,2023-06-08,05:00:00,2,0,2,FMN 08 Schijnpoortweg
675,Schijnpoortweg,2023-06-08,06:00:00,0,0,0,FMN 08 Schijnpoortweg
675,Schijnpoortweg,2023-06-08,07:00:00,1,1,0,FMN 08 Schijnpoortweg
675,Schijnpoortweg,2023-06-08,08:00:00,4,1,3,FMN 08 Schijnpoortweg
675,Schijnpoortweg,2023-06-08,09:00:00,1,0,1,FMN 08 Schijnpoortweg
675,Schijnpoortweg,2023-06-08,10:00:00,0,0,0,FMN 08 Schijnpoortweg
675,Schijnpoortweg,2023-06-08,11:00:00,0,0,0,FMN 08 Schijnpoortweg
675,Schijnpoortweg,2023-06-08,12:00:00,2,1,1,FMN 08 Schijnpoortweg
675,Schijnpoortweg,2023-06-08,13:00:00,1,0,1,FMN 08 Schijnpoortweg
675,Schijnpoortweg,2023-06-08,14:00:00,0,0,0,FMN 08 Schijnpoortweg
675,Schijnpoortweg,2023-06-08,15:00:00,3,1,2,FMN 08 Schijnpoortweg
675,Schijnpoortweg,2023-06-08,16:00:00,5,2,3,FMN 08 Schijnpoortweg
675,Schijnpoortweg,2023-06-08,17:00:00,4,1,3,FMN 08 Schijnpoortweg
675,Schijnpoortweg,2023-06-08,18:00:00,4,0,4,FMN 08 Schijnpoortweg
675,Schijnpoortweg,2023-06-08,19:00:00,4,0,4,FMN 08 Schijnpoortweg
675,Schijnpoortweg,2023-06-08,20:00:00,3,1,2,FMN 08 Schijnpoortweg
675,Schijnpoortweg,2023-06-08,21:00:00,1,0,1,FMN 08 Schijnpoortweg
675,Schijnpoortweg,2023-06-08,22:00:00,31,28,3,FMN 08 Schijnpoortweg
675,Schijnpoortweg,2023-06-08,23:00:00,2,2,0,FMN 08 Schijnpoortweg
675,Schijnpoortweg,2023-06-09,00:00:00,1,0,1,FMN 08 Schijnpoortweg
675,Schijnpoortweg,2023-06-09,01:00:00,1,0,1,FMN 08 Schijnpoortweg
675,Schijnpoortweg,2023-06-09,02:00:00,0,0,0,FMN 08 Schijnpoortweg
675,Schijnpoortweg,2023-06-09,03:00:00,1,1,0,FMN 08 Schijnpoortweg
675,Schijnpoortweg,2023-06-09,04:00:00,1,0,1,FMN 08 Schijnpoortweg
675,Schijnpoortweg,2023-06-09,05:00:00,1,0,1,FMN 08 Schijnpoortweg
675,Schijnpoortweg,2023-06-09,06:00:00,0,0,0,FMN 08 Schijnpoortweg
675,Schijnpoortweg,2023-06-09,07:00:00,3,3,0,FMN 08 Schijnpoortweg
675,Schijnpoortweg,2023-06-09,08:00:00,4,1,3,FMN 08 Schijnpoortweg
675,Schijnpoortweg,2023-06-09,09:00:00,1,0,1,FMN 08 Schijnpoortweg
675,Schijnpoortweg,2023-06-09,10:00:00,1,1,0,FMN 08 Schijnpoortweg
675,Schijnpoortweg,2023-06-09,11:00:00,0,0,0,FMN 08 Schijnpoortweg
675,Schijnpoortweg,2023-06-09,12:00:00,1,0,1,FMN 08 Schijnpoortweg
675,Schijnpoortweg,2023-06-09,13:00:00,2,1,1,FMN 08 Schijnpoortweg
675,Schijnpoortweg,2023-06-09,14:00:00,4,1,3,FMN 08 Schijnpoortweg
675,Schijnpoortweg,2023-06-09,15:00:00,3,3,0,FMN 08 Schijnpoortweg
675,Schijnpoortweg,2023-06-09,16:00:00,2,0,2,FMN 08 Schijnpoortweg
675,Schijnpoortweg,2023-06-09,17:00:00,2,1,1,FMN 08 Schijnpoortweg
675,Schijnpoortweg,2023-06-09,18:00:00,5,2,3,FMN 08 Schijnpoortweg
675,Schijnpoortweg,2023-06-09,19:00:00,5,1,4,FMN 08 Schijnpoortweg
675,Schijnpoortweg,2023-06-09,20:00:00,1,0,1,FMN 08 Schijnpoortweg
675,Schijnpoortweg,2023-06-09,21:00:00,4,1,3,FMN 08 Schijnpoortweg
675,Schijnpoortweg,2023-06-09,22:00:00,2,1,1,FMN 08 Schijnpoortweg
675,Schijnpoortweg,2023-06-09,23:00:00,0,0,0,FMN 08 Schijnpoortweg
675,Schijnpoortweg,2023-06-10,00:00:00,2,1,1,FMN 08 Schijnpoortweg
675,Schijnpoortweg,2023-06-10,01:00:00,0,0,0,FMN 08 Schijnpoortweg
675,Schijnpoortweg,2023-06-10,02:00:00,1,0,1,FMN 08 Schijnpoortweg
675,Schijnpoortweg,2023-06-10,03:00:00,0,0,0,FMN 08 Schijnpoortweg
675,Schijnpoortweg,2023-06-10,04:00:00,1,1,0,FMN 08 Schijnpoortweg
675,Schijnpoortweg,2023-06-10,05:00:00,1,0,1,FMN 08 Schijnpoortweg
675,Schijnpoortweg,2023-06-10,06:00:00,3,3,0,FMN 08 Schijnpoortweg
675,Schijnpoortweg,2023-06-10,07:00:00,0,0,0,FMN 08 Schijnpoortweg
675,Schijnpoortweg,2023-06-10,08:00:00,0,0,0,FMN 08 Schijnpoortweg
675,Schijnpoortweg,2023-06-10,09:00:00,0,0,0,FMN 08 Schijnpoortweg
675,Schijnpoortweg,2023-06-10,10:00:00,0,0,0,FMN 08 Schijnpoortweg
675,Schijnpoortweg,2023-06-10,11:00:00,1,0,1,FMN 08 Schijnpoortweg
675,Schijnpoortweg,2023-06-10,12:00:00,1,1,0,FMN 08 Schijnpoortweg
675,Schijnpoortweg,2023-06-10,13:00:00,0,0,0,FMN 08 Schijnpoortweg
675,Schijnpoortweg,2023-06-10,14:00:00,3,2,1,FMN 08 Schijnpoortweg
675,Schijnpoortweg,2023-06-10,15:00:00,1,0,1,FMN 08 Schijnpoortweg
675,Schijnpoortweg,2023-06-10,16:00:00,2,1,1,FMN 08 Schijnpoortweg
675,Schijnpoortweg,2023-06-10,17:00:00,1,0,1,FMN 08 Schijnpoortweg
675,Schijnpoortweg,2023-06-10,18:00:00,6,4,2,FMN 08 Schijnpoortweg
675,Schijnpoortweg,2023-06-10,19:00:00,5,2,3,FMN 08 Schijnpoortweg
675,Schijnpoortweg,2023-06-10,20:00:00,1,0,1,FMN 08 Schijnpoortweg
675,Schijnpoortweg,2023-06-10,21:00:00,4,2,2,FMN 08 Schijnpoortweg
675,Schijnpoortweg,2023-06-10,22:00:00,5,4,1,FMN 08 Schijnpoortweg
675,Schijnpoortweg,2023-06-10,23:00:00,1,0,1,FMN 08 Schijnpoortweg
675,Schijnpoortweg,2023-06-11,00:00:00,2,0,2,FMN 08 Schijnpoortweg
675,Schijnpoortweg,2023-06-11,01:00:00,0,0,0,FMN 08 Schijnpoortweg
675,Schijnpoortweg,2023-06-11,02:00:00,0,0,0,FMN 08 Schijnpoortweg
675,Schijnpoortweg,2023-06-11,03:00:00,0,0,0,FMN 08 Schijnpoortweg
675,Schijnpoortweg,2023-06-11,04:00:00,0,0,0,FMN 08 Schijnpoortweg
675,Schijnpoortweg,2023-06-11,05:00:00,0,0,0,FMN 08 Schijnpoortweg
675,Schijnpoortweg,2023-06-11,06:00:00,2,1,1,FMN 08 Schijnpoortweg
675,Schijnpoortweg,2023-06-11,07:00:00,1,1,0,FMN 08 Schijnpoortweg
675,Schijnpoortweg,2023-06-11,08:00:00,4,1,3,FMN 08 Schijnpoortweg
675,Schijnpoortweg,2023-06-11,09:00:00,1,0,1,FMN 08 Schijnpoortweg
675,Schijnpoortweg,2023-06-11,10:00:00,2,2,0,FMN 08 Schijnpoortweg
675,Schijnpoortweg,2023-06-11,11:00:00,0,0,0,FMN 08 Schijnpoortweg
675,Schijnpoortweg,2023-06-11,12:00:00,1,0,1,FMN 08 Schijnpoortweg
675,Schijnpoortweg,2023-06-11,13:00:00,1,0,1,FMN 08 Schijnpoortweg
675,Schijnpoortweg,2023-06-11,14:00:00,0,0,0,FMN 08 Schijnpoortweg
675,Schijnpoortweg,2023-06-11,15:00:00,2,0,2,FMN 08 Schijnpoortweg
675,Schijnpoortweg,2023-06-11,16:00:00,1,1,0,FMN 08 Schijnpoortweg
675,Schijnpoortweg,2023-06-11,17:00:00,3,2,1,FMN 08 Schijnpoortweg
675,Schijnpoortweg,2023-06-11,18:00:00,4,1,3,FMN 08 Schijnpoortweg
675,Schijnpoortweg,2023-06-11,19:00:00,3,1,2,FMN 08 Schijnpoortweg
675,Schijnpoortweg,2023-06-11,20:00:00,5,3,2,FMN 08 Schijnpoortweg
675,Schijnpoortweg,2023-06-11,21:00:00,1,0,1,FMN 08 Schijnpoortweg
675,Schijnpoortweg,2023-06-11,22:00:00,3,1,2,FMN 08 Schijnpoortweg
675,Schijnpoortweg,2023-06-11,23:00:00,3,0,3,FMN 08 Schijnpoortweg
675,Schijnpoortweg,2023-06-12,00:00:00,2,0,2,FMN 08 Schijnpoortweg
675,Schijnpoortweg,2023-06-12,01:00:00,0,0,0,FMN 08 Schijnpoortweg
675,Schijnpoortweg,2023-06-12,02:00:00,0,0,0,FMN 08 Schijnpoortweg
675,Schijnpoortweg,2023-06-12,03:00:00,0,0,0,FMN 08 Schijnpoortweg
675,Schijnpoortweg,2023-06-12,04:00:00,1,0,1,FMN 08 Schijnpoortweg
675,Schijnpoortweg,2023-06-12,05:00:00,2,0,2,FMN 08 Schijnpoortweg
675,Schijnpoortweg,2023-06-12,06:00:00,1,1,0,FMN 08 Schijnpoortweg
675,Schijnpoortweg,2023-06-12,07:00:00,0,0,0,FMN 08 Schijnpoortweg
675,Schijnpoortweg,2023-06-12,08:00:00,0,0,0,FMN 08 Schijnpoortweg
675,Schijnpoortweg,2023-06-12,09:00:00,2,0,2,FMN 08 Schijnpoortweg
675,Schijnpoortweg,2023-06-12,10:00:00,0,0,0,FMN 08 Schijnpoortweg
675,Schijnpoortweg,2023-06-12,11:00:00,0,0,0,FMN 08 Schijnpoortweg
675,Schijnpoortweg,2023-06-12,12:00:00,0,0,0,FMN 08 Schijnpoortweg
675,Schijnpoortweg,2023-06-12,13:00:00,1,0,1,FMN 08 Schijnpoortweg
675,Schijnpoortweg,2023-06-12,14:00:00,0,0,0,FMN 08 Schijnpoortweg
675,Schijnpoortweg,2023-06-12,15:00:00,2,1,1,FMN 08 Schijnpoortweg
675,Schijnpoortweg,2023-06-12,16:00:00,2,1,1,FMN 08 Schijnpoortweg
675,Schijnpoortweg,2023-06-12,17:00:00,0,0,0,FMN 08 Schijnpoortweg
675,Schijnpoortweg,2023-06-12,18:00:00,2,0,2,FMN 08 Schijnpoortweg
675,Schijnpoortweg,2023-06-12,19:00:00,1,0,1,FMN 08 Schijnpoortweg
675,Schijnpoortweg,2023-06-12,20:00:00,1,0,1,FMN 08 Schijnpoortweg
675,Schijnpoortweg,2023-06-12,21:00:00,2,1,1,FMN 08 Schijnpoortweg
675,Schijnpoortweg,2023-06-12,22:00:00,3,2,1,FMN 08 Schijnpoortweg
675,Schijnpoortweg,2023-06-12,23:00:00,3,1,2,FMN 08 Schijnpoortweg
675,Schijnpoortweg,2023-06-13,00:00:00,1,0,1,FMN 08 Schijnpoortweg
675,Schijnpoortweg,2023-06-13,01:00:00,1,0,1,FMN 08 Schijnpoortweg
675,Schijnpoortweg,2023-06-13,02:00:00,0,0,0,FMN 08 Schijnpoortweg
675,Schijnpoortweg,2023-06-13,03:00:00,1,0,1,FMN 08 Schijnpoortweg
675,Schijnpoortweg,2023-06-13,04:00:00,1,1,0,FMN 08 Schijnpoortweg
675,Schijnpoortweg,2023-06-13,05:00:00,3,0,3,FMN 08 Schijnpoortweg
675,Schijnpoortweg,2023-06-13,06:00:00,2,2,0,FMN 08 Schijnpoortweg
675,Schijnpoortweg,2023-06-13,07:00:00,5,3,2,FMN 08 Schijnpoortweg
675,Schijnpoortweg,2023-06-13,08:00:00,0,0,0,FMN 08 Schijnpoortweg
675,Schijnpoortweg,2023-06-13,09:00:00,2,0,2,FMN 08 Schijnpoortweg
675,Schijnpoortweg,2023-06-13,10:00:00,2,2,0,FMN 08 Schijnpoortweg
675,Schijnpoortweg,2023-06-13,11:00:00,0,0,0,FMN 08 Schijnpoortweg
675,Schijnpoortweg,2023-06-13,12:00:00,0,0,0,FMN 08 Schijnpoortweg
675,Schijnpoortweg,2023-06-13,13:00:00,2,0,2,FMN 08 Schijnpoortweg
675,Schijnpoortweg,2023-06-13,14:00:00,1,0,1,FMN 08 Schijnpoortweg
675,Schijnpoortweg,2023-06-13,15:00:00,2,0,2,FMN 08 Schijnpoortweg
675,Schijnpoortweg,2023-06-13,16:00:00,2,1,1,FMN 08 Schijnpoortweg
675,Schijnpoortweg,2023-06-13,17:00:00,2,2,0,FMN 08 Schijnpoortweg
675,Schijnpoortweg,2023-06-13,18:00:00,3,2,1,FMN 08 Schijnpoortweg
675,Schijnpoortweg,2023-06-13,19:00:00,2,1,1,FMN 08 Schijnpoortweg
675,Schijnpoortweg,2023-06-13,20:00:00,3,0,3,FMN 08 Schijnpoortweg
675,Schijnpoortweg,2023-06-13,21:00:00,3,1,2,FMN 08 Schijnpoortweg
675,Schijnpoortweg,2023-06-13,22:00:00,3,2,1,FMN 08 Schijnpoortweg
675,Schijnpoortweg,2023-06-13,23:00:00,0,0,0,FMN 08 Schijnpoortweg
675,Schijnpoortweg,2023-06-14,00:00:00,2,1,1,FMN 08 Schijnpoortweg
675,Schijnpoortweg,2023-06-14,01:00:00,0,0,0,FMN 08 Schijnpoortweg
675,Schijnpoortweg,2023-06-14,02:00:00,0,0,0,FMN 08 Schijnpoortweg
675,Schijnpoortweg,2023-06-14,03:00:00,0,0,0,FMN 08 Schijnpoortweg
675,Schijnpoortweg,2023-06-14,04:00:00,1,1,0,FMN 08 Schijnpoortweg
675,Schijnpoortweg,2023-06-14,05:00:00,2,0,2,FMN 08 Schijnpoortweg
675,Schijnpoortweg,2023-06-14,06:00:00,1,1,0,FMN 08 Schijnpoortweg
675,Schijnpoortweg,2023-06-14,07:00:00,1,0,1,FMN 08 Schijnpoortweg
675,Schijnpoortweg,2023-06-14,08:00:00,3,2,1,FMN 08 Schijnpoortweg
675,Schijnpoortweg,2023-06-14,09:00:00,1,0,1,FMN 08 Schijnpoortweg
675,Schijnpoortweg,2023-06-14,10:00:00,2,0,2,FMN 08 Schijnpoortweg
675,Schijnpoortweg,2023-06-14,11:00:00,0,0,0,FMN 08 Schijnpoortweg
675,Schijnpoortweg,2023-06-14,12:00:00,0,0,0,FMN 08 Schijnpoortweg
675,Schijnpoortweg,2023-06-14,13:00:00,0,0,0,FMN 08 Schijnpoortweg
675,Schijnpoortweg,2023-06-14,14:00:00,0,0,0,FMN 08 Schijnpoortweg
675,Schijnpoortweg,2023-06-14,15:00:00,0,0,0,FMN 08 Schijnpoortweg
675,Schijnpoortweg,2023-06-14,16:00:00,0,0,0,FMN 08 Schijnpoortweg
675,Schijnpoortweg,2023-06-14,17:00:00,0,0,0,FMN 08 Schijnpoortweg
675,Schijnpoortweg,2023-06-14,18:00:00,0,0,0,FMN 08 Schijnpoortweg
675,Schijnpoortweg,2023-06-14,19:00:00,2,1,1,FMN 08 Schijnpoortweg
675,Schijnpoortweg,2023-06-14,20:00:00,4,2,2,FMN 08 Schijnpoortweg
675,Schijnpoortweg,2023-06-14,21:00:00,2,0,2,FMN 08 Schijnpoortweg
675,Schijnpoortweg,2023-06-14,22:00:00,4,1,3,FMN 08 Schijnpoortweg
675,Schijnpoortweg,2023-06-14,23:00:00,2,1,1,FMN 08 Schijnpoortweg
675,Schijnpoortweg,2023-06-15,00:00:00,1,0,1,FMN 08 Schijnpoortweg
675,Schijnpoortweg,2023-06-15,01:00:00,0,0,0,FMN 08 Schijnpoortweg
675,Schijnpoortweg,2023-06-15,02:00:00,0,0,0,FMN 08 Schijnpoortweg
675,Schijnpoortweg,2023-06-15,03:00:00,1,1,0,FMN 08 Schijnpoortweg
675,Schijnpoortweg,2023-06-15,04:00:00,1,1,0,FMN 08 Schijnpoortweg
675,Schijnpoortweg,2023-06-15,05:00:00,2,1,1,FMN 08 Schijnpoortweg
675,Schijnpoortweg,2023-06-15,06:00:00,2,2,0,FMN 08 Schijnpoortweg
675,Schijnpoortweg,2023-06-15,07:00:00,2,1,1,FMN 08 Schijnpoortweg
675,Schijnpoortweg,2023-06-15,08:00:00,1,1,0,FMN 08 Schijnpoortweg
675,Schijnpoortweg,2023-06-15,09:00:00,3,1,2,FMN 08 Schijnpoortweg
675,Schijnpoortweg,2023-06-15,10:00:00,2,1,1,FMN 08 Schijnpoortweg
675,Schijnpoortweg,2023-06-15,11:00:00,1,1,0,FMN 08 Schijnpoortweg
675,Schijnpoortweg,2023-06-15,12:00:00,0,0,0,FMN 08 Schijnpoortweg
675,Schijnpoortweg,2023-06-15,13:00:00,0,0,0,FMN 08 Schijnpoortweg
675,Schijnpoortweg,2023-06-15,14:00:00,0,0,0,FMN 08 Schijnpoortweg
675,Schijnpoortweg,2023-06-15,15:00:00,0,0,0,FMN 08 Schijnpoortweg
675,Schijnpoortweg,2023-06-15,16:00:00,1,0,1,FMN 08 Schijnpoortweg
675,Schijnpoortweg,2023-06-15,17:00:00,0,0,0,FMN 08 Schijnpoortweg
675,Schijnpoortweg,2023-06-15,18:00:00,4,2,2,FMN 08 Schijnpoortweg
675,Schijnpoortweg,2023-06-15,19:00:00,1,1,0,FMN 08 Schijnpoortweg
675,Schijnpoortweg,2023-06-15,20:00:00,0,0,0,FMN 08 Schijnpoortweg
675,Schijnpoortweg,2023-06-15,21:00:00,2,1,1,FMN 08 Schijnpoortweg
675,Schijnpoortweg,2023-06-15,22:00:00,3,2,1,FMN 08 Schijnpoortweg
675,Schijnpoortweg,2023-06-15,23:00:00,3,1,2,FMN 08 Schijnpoortweg
675,Schijnpoortweg,2023-06-16,00:00:00,0,0,0,FMN 08 Schijnpoortweg
675,Schijnpoortweg,2023-06-16,01:00:00,1,0,1,FMN 08 Schijnpoortweg
675,Schijnpoortweg,2023-06-16,02:00:00,1,1,0,FMN 08 Schijnpoortweg
675,Schijnpoortweg,2023-06-16,03:00:00,0,0,0,FMN 08 Schijnpoortweg
675,Schijnpoortweg,2023-06-16,04:00:00,1,1,0,FMN 08 Schijnpoortweg
675,Schijnpoortweg,2023-06-16,05:00:00,2,0,2,FMN 08 Schijnpoortweg
675,Schijnpoortweg,2023-06-16,06:00:00,1,1,0,FMN 08 Schijnpoortweg
675,Schijnpoortweg,2023-06-16,07:00:00,1,0,1,FMN 08 Schijnpoortweg
675,Schijnpoortweg,2023-06-16,08:00:00,0,0,0,FMN 08 Schijnpoortweg
675,Schijnpoortweg,2023-06-16,09:00:00,4,1,3,FMN 08 Schijnpoortweg
675,Schijnpoortweg,2023-06-16,10:00:00,0,0,0,FMN 08 Schijnpoortweg
675,Schijnpoortweg,2023-06-16,11:00:00,0,0,0,FMN 08 Schijnpoortweg
675,Schijnpoortweg,2023-06-16,12:00:00,1,0,1,FMN 08 Schijnpoortweg
675,Schijnpoortweg,2023-06-16,13:00:00,1,0,1,FMN 08 Schijnpoortweg
675,Schijnpoortweg,2023-06-16,14:00:00,0,0,0,FMN 08 Schijnpoortweg
675,Schijnpoortweg,2023-06-16,15:00:00,0,0,0,FMN 08 Schijnpoortweg
675,Schijnpoortweg,2023-06-16,16:00:00,0,0,0,FMN 08 Schijnpoortweg
675,Schijnpoortweg,2023-06-16,17:00:00,0,0,0,FMN 08 Schijnpoortweg
675,Schijnpoortweg,2023-06-16,18:00:00,0,0,0,FMN 08 Schijnpoortweg
675,Schijnpoortweg,2023-06-16,19:00:00,5,4,1,FMN 08 Schijnpoortweg
675,Schijnpoortweg,2023-06-16,20:00:00,1,0,1,FMN 08 Schijnpoortweg
675,Schijnpoortweg,2023-06-16,21:00:00,5,3,2,FMN 08 Schijnpoortweg
675,Schijnpoortweg,2023-06-16,22:00:00,2,1,1,FMN 08 Schijnpoortweg
675,Schijnpoortweg,2023-06-16,23:00:00,3,3,0,FMN 08 Schijnpoortweg
675,Schijnpoortweg,2023-06-17,00:00:00,4,2,2,FMN 08 Schijnpoortweg
675,Schijnpoortweg,2023-06-17,01:00:00,0,0,0,FMN 08 Schijnpoortweg
675,Schijnpoortweg,2023-06-17,02:00:00,0,0,0,FMN 08 Schijnpoortweg
675,Schijnpoortweg,2023-06-17,03:00:00,0,0,0,FMN 08 Schijnpoortweg
675,Schijnpoortweg,2023-06-17,04:00:00,0,0,0,FMN 08 Schijnpoortweg
675,Schijnpoortweg,2023-06-17,05:00:00,0,0,0,FMN 08 Schijnpoortweg
675,Schijnpoortweg,2023-06-17,06:00:00,1,0,1,FMN 08 Schijnpoortweg
675,Schijnpoortweg,2023-06-17,07:00:00,1,1,0,FMN 08 Schijnpoortweg
675,Schijnpoortweg,2023-06-17,08:00:00,0,0,0,FMN 08 Schijnpoortweg
675,Schijnpoortweg,2023-06-17,09:00:00,1,1,0,FMN 08 Schijnpoortweg
675,Schijnpoortweg,2023-06-17,10:00:00,1,0,1,FMN 08 Schijnpoortweg
675,Schijnpoortweg,2023-06-17,11:00:00,1,1,0,FMN 08 Schijnpoortweg
675,Schijnpoortweg,2023-06-17,12:00:00,2,0,2,FMN 08 Schijnpoortweg
675,Schijnpoortweg,2023-06-17,13:00:00,1,0,1,FMN 08 Schijnpoortweg
675,Schijnpoortweg,2023-06-17,14:00:00,0,0,0,FMN 08 Schijnpoortweg
675,Schijnpoortweg,2023-06-17,15:00:00,1,0,1,FMN 08 Schijnpoortweg
675,Schijnpoortweg,2023-06-17,16:00:00,1,0,1,FMN 08 Schijnpoortweg
675,Schijnpoortweg,2023-06-17,17:00:00,2,1,1,FMN 08 Schijnpoortweg
675,Schijnpoortweg,2023-06-17,18:00:00,4,0,4,FMN 08 Schijnpoortweg
675,Schijnpoortweg,2023-06-17,19:00:00,4,3,1,FMN 08 Schijnpoortweg
675,Schijnpoortweg,2023-06-17,20:00:00,2,1,1,FMN 08 Schijnpoortweg
675,Schijnpoortweg,2023-06-17,21:00:00,2,1,1,FMN 08 Schijnpoortweg
675,Schijnpoortweg,2023-06-17,22:00:00,5,0,5,FMN 08 Schijnpoortweg
675,Schijnpoortweg,2023-06-17,23:00:00,1,1,0,FMN 08 Schijnpoortweg
675,Schijnpoortweg,2023-06-18,00:00:00,0,0,0,FMN 08 Schijnpoortweg
675,Schijnpoortweg,2023-06-18,01:00:00,2,1,1,FMN 08 Schijnpoortweg
675,Schijnpoortweg,2023-06-18,02:00:00,1,1,0,FMN 08 Schijnpoortweg
675,Schijnpoortweg,2023-06-18,03:00:00,0,0,0,FMN 08 Schijnpoortweg
675,Schijnpoortweg,2023-06-18,04:00:00,0,0,0,FMN 08 Schijnpoortweg
675,Schijnpoortweg,2023-06-18,05:00:00,0,0,0,FMN 08 Schijnpoortweg
675,Schijnpoortweg,2023-06-18,06:00:00,0,0,0,FMN 08 Schijnpoortweg
675,Schijnpoortweg,2023-06-18,07:00:00,0,0,0,FMN 08 Schijnpoortweg
675,Schijnpoortweg,2023-06-18,08:00:00,1,1,0,FMN 08 Schijnpoortweg
675,Schijnpoortweg,2023-06-18,09:00:00,1,1,0,FMN 08 Schijnpoortweg
675,Schijnpoortweg,2023-06-18,10:00:00,0,0,0,FMN 08 Schijnpoortweg
675,Schijnpoortweg,2023-06-18,11:00:00,2,0,2,FMN 08 Schijnpoortweg
675,Schijnpoortweg,2023-06-18,12:00:00,0,0,0,FMN 08 Schijnpoortweg
675,Schijnpoortweg,2023-06-18,13:00:00,2,2,0,FMN 08 Schijnpoortweg
675,Schijnpoortweg,2023-06-18,14:00:00,5,1,4,FMN 08 Schijnpoortweg
675,Schijnpoortweg,2023-06-18,15:00:00,3,2,1,FMN 08 Schijnpoortweg
675,Schijnpoortweg,2023-06-18,16:00:00,2,1,1,FMN 08 Schijnpoortweg
675,Schijnpoortweg,2023-06-18,17:00:00,2,2,0,FMN 08 Schijnpoortweg
675,Schijnpoortweg,2023-06-18,18:00:00,3,2,1,FMN 08 Schijnpoortweg
675,Schijnpoortweg,2023-06-18,19:00:00,1,1,0,FMN 08 Schijnpoortweg
675,Schijnpoortweg,2023-06-18,20:00:00,2,1,1,FMN 08 Schijnpoortweg
675,Schijnpoortweg,2023-06-18,21:00:00,3,1,2,FMN 08 Schijnpoortweg
675,Schijnpoortweg,2023-06-18,22:00:00,3,1,2,FMN 08 Schijnpoortweg
675,Schijnpoortweg,2023-06-18,23:00:00,2,0,2,FMN 08 Schijnpoortweg
675,Schijnpoortweg,2023-06-19,00:00:00,1,1,0,FMN 08 Schijnpoortweg
675,Schijnpoortweg,2023-06-19,01:00:00,1,1,0,FMN 08 Schijnpoortweg
675,Schijnpoortweg,2023-06-19,02:00:00,0,0,0,FMN 08 Schijnpoortweg
675,Schijnpoortweg,2023-06-19,03:00:00,0,0,0,FMN 08 Schijnpoortweg
675,Schijnpoortweg,2023-06-19,04:00:00,0,0,0,FMN 08 Schijnpoortweg
675,Schijnpoortweg,2023-06-19,05:00:00,2,1,1,FMN 08 Schijnpoortweg
675,Schijnpoortweg,2023-06-19,06:00:00,0,0,0,FMN 08 Schijnpoortweg
675,Schijnpoortweg,2023-06-19,07:00:00,1,0,1,FMN 08 Schijnpoortweg
675,Schijnpoortweg,2023-06-19,08:00:00,1,0,1,FMN 08 Schijnpoortweg
675,Schijnpoortweg,2023-06-19,09:00:00,1,0,1,FMN 08 Schijnpoortweg
675,Schijnpoortweg,2023-06-19,10:00:00,1,1,0,FMN 08 Schijnpoortweg
675,Schijnpoortweg,2023-06-19,11:00:00,1,0,1,FMN 08 Schijnpoortweg
675,Schijnpoortweg,2023-06-19,12:00:00,2,0,2,FMN 08 Schijnpoortweg
675,Schijnpoortweg,2023-06-19,13:00:00,1,1,0,FMN 08 Schijnpoortweg
675,Schijnpoortweg,2023-06-19,14:00:00,1,0,1,FMN 08 Schijnpoortweg
675,Schijnpoortweg,2023-06-19,15:00:00,2,1,1,FMN 08 Schijnpoortweg
675,Schijnpoortweg,2023-06-19,16:00:00,3,2,1,FMN 08 Schijnpoortweg
675,Schijnpoortweg,2023-06-19,17:00:00,3,2,1,FMN 08 Schijnpoortweg
675,Schijnpoortweg,2023-06-19,18:00:00,4,3,1,FMN 08 Schijnpoortweg
675,Schijnpoortweg,2023-06-19,19:00:00,1,0,1,FMN 08 Schijnpoortweg
675,Schijnpoortweg,2023-06-19,20:00:00,2,0,2,FMN 08 Schijnpoortweg
675,Schijnpoortweg,2023-06-19,21:00:00,1,0,1,FMN 08 Schijnpoortweg
675,Schijnpoortweg,2023-06-19,22:00:00,1,1,0,FMN 08 Schijnpoortweg
675,Schijnpoortweg,2023-06-19,23:00:00,5,2,3,FMN 08 Schijnpoortweg
675,Schijnpoortweg,2023-06-20,00:00:00,2,1,1,FMN 08 Schijnpoortweg
675,Schijnpoortweg,2023-06-20,01:00:00,0,0,0,FMN 08 Schijnpoortweg
675,Schijnpoortweg,2023-06-20,02:00:00,0,0,0,FMN 08 Schijnpoortweg
675,Schijnpoortweg,2023-06-20,03:00:00,0,0,0,FMN 08 Schijnpoortweg
675,Schijnpoortweg,2023-06-20,04:00:00,0,0,0,FMN 08 Schijnpoortweg
675,Schijnpoortweg,2023-06-20,05:00:00,4,0,4,FMN 08 Schijnpoortweg
675,Schijnpoortweg,2023-06-20,06:00:00,1,1,0,FMN 08 Schijnpoortweg
675,Schijnpoortweg,2023-06-20,07:00:00,1,1,0,FMN 08 Schijnpoortweg
675,Schijnpoortweg,2023-06-20,08:00:00,1,1,0,FMN 08 Schijnpoortweg
675,Schijnpoortweg,2023-06-20,09:00:00,1,0,1,FMN 08 Schijnpoortweg
675,Schijnpoortweg,2023-06-20,10:00:00,2,1,1,FMN 08 Schijnpoortweg
675,Schijnpoortweg,2023-06-20,11:00:00,1,1,0,FMN 08 Schijnpoortweg
675,Schijnpoortweg,2023-06-20,12:00:00,3,1,2,FMN 08 Schijnpoortweg
675,Schijnpoortweg,2023-06-20,13:00:00,0,0,0,FMN 08 Schijnpoortweg
675,Schijnpoortweg,2023-06-20,14:00:00,2,2,0,FMN 08 Schijnpoortweg
675,Schijnpoortweg,2023-06-20,15:00:00,6,2,4,FMN 08 Schijnpoortweg
675,Schijnpoortweg,2023-06-20,16:00:00,4,2,2,FMN 08 Schijnpoortweg
675,Schijnpoortweg,2023-06-20,17:00:00,2,1,1,FMN 08 Schijnpoortweg
675,Schijnpoortweg,2023-06-20,18:00:00,4,2,2,FMN 08 Schijnpoortweg
675,Schijnpoortweg,2023-06-20,19:00:00,2,1,1,FMN 08 Schijnpoortweg
675,Schijnpoortweg,2023-06-20,20:00:00,0,0,0,FMN 08 Schijnpoortweg
675,Schijnpoortweg,2023-06-20,21:00:00,1,0,1,FMN 08 Schijnpoortweg
675,Schijnpoortweg,2023-06-20,22:00:00,3,2,1,FMN 08 Schijnpoortweg
675,Schijnpoortweg,2023-06-20,23:00:00,4,0,4,FMN 08 Schijnpoortweg
675,Schijnpoortweg,2023-06-21,00:00:00,1,0,1,FMN 08 Schijnpoortweg
675,Schijnpoortweg,2023-06-21,01:00:00,0,0,0,FMN 08 Schijnpoortweg
675,Schijnpoortweg,2023-06-21,02:00:00,0,0,0,FMN 08 Schijnpoortweg
675,Schijnpoortweg,2023-06-21,03:00:00,0,0,0,FMN 08 Schijnpoortweg
675,Schijnpoortweg,2023-06-21,04:00:00,2,0,2,FMN 08 Schijnpoortweg
675,Schijnpoortweg,2023-06-21,05:00:00,1,0,1,FMN 08 Schijnpoortweg
675,Schijnpoortweg,2023-06-21,06:00:00,0,0,0,FMN 08 Schijnpoortweg
675,Schijnpoortweg,2023-06-21,07:00:00,2,1,1,FMN 08 Schijnpoortweg
675,Schijnpoortweg,2023-06-21,08:00:00,2,2,0,FMN 08 Schijnpoortweg
675,Schijnpoortweg,2023-06-21,09:00:00,1,0,1,FMN 08 Schijnpoortweg
675,Schijnpoortweg,2023-06-21,10:00:00,1,1,0,FMN 08 Schijnpoortweg
675,Schijnpoortweg,2023-06-21,11:00:00,2,2,0,FMN 08 Schijnpoortweg
675,Schijnpoortweg,2023-06-21,12:00:00,1,0,1,FMN 08 Schijnpoortweg
675,Schijnpoortweg,2023-06-21,13:00:00,2,1,1,FMN 08 Schijnpoortweg
675,Schijnpoortweg,2023-06-21,14:00:00,3,1,2,FMN 08 Schijnpoortweg
675,Schijnpoortweg,2023-06-21,15:00:00,3,1,2,FMN 08 Schijnpoortweg
675,Schijnpoortweg,2023-06-21,16:00:00,3,2,1,FMN 08 Schijnpoortweg
675,Schijnpoortweg,2023-06-21,17:00:00,6,3,3,FMN 08 Schijnpoortweg
675,Schijnpoortweg,2023-06-21,18:00:00,3,1,2,FMN 08 Schijnpoortweg
675,Schijnpoortweg,2023-06-21,19:00:00,3,1,2,FMN 08 Schijnpoortweg
675,Schijnpoortweg,2023-06-21,20:00:00,2,0,2,FMN 08 Schijnpoortweg
675,Schijnpoortweg,2023-06-21,21:00:00,3,1,2,FMN 08 Schijnpoortweg
675,Schijnpoortweg,2023-06-21,22:00:00,1,0,1,FMN 08 Schijnpoortweg
675,Schijnpoortweg,2023-06-21,23:00:00,1,0,1,FMN 08 Schijnpoortweg
675,Schijnpoortweg,2023-06-22,00:00:00,1,0,1,FMN 08 Schijnpoortweg
675,Schijnpoortweg,2023-06-22,01:00:00,0,0,0,FMN 08 Schijnpoortweg
675,Schijnpoortweg,2023-06-22,02:00:00,0,0,0,FMN 08 Schijnpoortweg
675,Schijnpoortweg,2023-06-22,03:00:00,1,1,0,FMN 08 Schijnpoortweg
675,Schijnpoortweg,2023-06-22,04:00:00,1,0,1,FMN 08 Schijnpoortweg
675,Schijnpoortweg,2023-06-22,05:00:00,1,0,1,FMN 08 Schijnpoortweg
675,Schijnpoortweg,2023-06-22,06:00:00,0,0,0,FMN 08 Schijnpoortweg
675,Schijnpoortweg,2023-06-22,07:00:00,1,1,0,FMN 08 Schijnpoortweg
675,Schijnpoortweg,2023-06-22,08:00:00,2,1,1,FMN 08 Schijnpoortweg
675,Schijnpoortweg,2023-06-22,09:00:00,1,1,0,FMN 08 Schijnpoortweg
675,Schijnpoortweg,2023-06-22,10:00:00,2,1,1,FMN 08 Schijnpoortweg
675,Schijnpoortweg,2023-06-22,11:00:00,1,1,0,FMN 08 Schijnpoortweg
675,Schijnpoortweg,2023-06-22,12:00:00,3,0,3,FMN 08 Schijnpoortweg
675,Schijnpoortweg,2023-06-22,13:00:00,1,0,1,FMN 08 Schijnpoortweg
675,Schijnpoortweg,2023-06-22,14:00:00,0,0,0,FMN 08 Schijnpoortweg
675,Schijnpoortweg,2023-06-22,15:00:00,2,1,1,FMN 08 Schijnpoortweg
675,Schijnpoortweg,2023-06-22,16:00:00,2,1,1,FMN 08 Schijnpoortweg
675,Schijnpoortweg,2023-06-22,17:00:00,2,0,2,FMN 08 Schijnpoortweg
675,Schijnpoortweg,2023-06-22,18:00:00,0,0,0,FMN 08 Schijnpoortweg
675,Schijnpoortweg,2023-06-22,19:00:00,0,0,0,FMN 08 Schijnpoortweg
675,Schijnpoortweg,2023-06-22,20:00:00,6,2,4,FMN 08 Schijnpoortweg
675,Schijnpoortweg,2023-06-22,21:00:00,3,1,2,FMN 08 Schijnpoortweg
675,Schijnpoortweg,2023-06-22,22:00:00,1,0,1,FMN 08 Schijnpoortweg
675,Schijnpoortweg,2023-06-22,23:00:00,4,1,3,FMN 08 Schijnpoortweg
675,Schijnpoortweg,2023-06-23,00:00:00,2,0,2,FMN 08 Schijnpoortweg
675,Schijnpoortweg,2023-06-23,01:00:00,0,0,0,FMN 08 Schijnpoortweg
675,Schijnpoortweg,2023-06-23,02:00:00,0,0,0,FMN 08 Schijnpoortweg
675,Schijnpoortweg,2023-06-23,03:00:00,0,0,0,FMN 08 Schijnpoortweg
675,Schijnpoortweg,2023-06-23,04:00:00,0,0,0,FMN 08 Schijnpoortweg
675,Schijnpoortweg,2023-06-23,05:00:00,3,0,3,FMN 08 Schijnpoortweg
675,Schijnpoortweg,2023-06-23,06:00:00,1,1,0,FMN 08 Schijnpoortweg
675,Schijnpoortweg,2023-06-23,07:00:00,3,2,1,FMN 08 Schijnpoortweg
675,Schijnpoortweg,2023-06-23,08:00:00,2,1,1,FMN 08 Schijnpoortweg
675,Schijnpoortweg,2023-06-23,09:00:00,4,2,2,FMN 08 Schijnpoortweg
675,Schijnpoortweg,2023-06-23,10:00:00,1,1,0,FMN 08 Schijnpoortweg
675,Schijnpoortweg,2023-06-23,11:00:00,2,1,1,FMN 08 Schijnpoortweg
675,Schijnpoortweg,2023-06-23,12:00:00,3,1,2,FMN 08 Schijnpoortweg
675,Schijnpoortweg,2023-06-23,13:00:00,7,3,4,FMN 08 Schijnpoortweg
675,Schijnpoortweg,2023-06-23,14:00:00,2,2,0,FMN 08 Schijnpoortweg
675,Schijnpoortweg,2023-06-23,15:00:00,4,1,3,FMN 08 Schijnpoortweg
675,Schijnpoortweg,2023-06-23,16:00:00,7,5,2,FMN 08 Schijnpoortweg
675,Schijnpoortweg,2023-06-23,17:00:00,4,2,2,FMN 08 Schijnpoortweg
675,Schijnpoortweg,2023-06-23,18:00:00,8,4,4,FMN 08 Schijnpoortweg
675,Schijnpoortweg,2023-06-23,19:00:00,3,2,1,FMN 08 Schijnpoortweg
675,Schijnpoortweg,2023-06-23,20:00:00,4,2,2,FMN 08 Schijnpoortweg
675,Schijnpoortweg,2023-06-23,21:00:00,8,3,5,FMN 08 Schijnpoortweg
675,Schijnpoortweg,2023-06-23,22:00:00,3,2,1,FMN 08 Schijnpoortweg
675,Schijnpoortweg,2023-06-23,23:00:00,5,0,5,FMN 08 Schijnpoortweg
675,Schijnpoortweg,2023-06-24,00:00:00,1,0,1,FMN 08 Schijnpoortweg
675,Schijnpoortweg,2023-06-24,01:00:00,2,0,2,FMN 08 Schijnpoortweg
675,Schijnpoortweg,2023-06-24,02:00:00,0,0,0,FMN 08 Schijnpoortweg
675,Schijnpoortweg,2023-06-24,03:00:00,1,0,1,FMN 08 Schijnpoortweg
675,Schijnpoortweg,2023-06-24,04:00:00,0,0,0,FMN 08 Schijnpoortweg
675,Schijnpoortweg,2023-06-24,05:00:00,3,2,1,FMN 08 Schijnpoortweg
675,Schijnpoortweg,2023-06-24,06:00:00,0,0,0,FMN 08 Schijnpoortweg
675,Schijnpoortweg,2023-06-24,07:00:00,0,0,0,FMN 08 Schijnpoortweg
675,Schijnpoortweg,2023-06-24,08:00:00,0,0,0,FMN 08 Schijnpoortweg
675,Schijnpoortweg,2023-06-24,09:00:00,0,0,0,FMN 08 Schijnpoortweg
675,Schijnpoortweg,2023-06-24,10:00:00,1,0,1,FMN 08 Schijnpoortweg
675,Schijnpoortweg,2023-06-24,11:00:00,1,1,0,FMN 08 Schijnpoortweg
675,Schijnpoortweg,2023-06-24,12:00:00,2,1,1,FMN 08 Schijnpoortweg
675,Schijnpoortweg,2023-06-24,13:00:00,0,0,0,FMN 08 Schijnpoortweg
675,Schijnpoortweg,2023-06-24,14:00:00,0,0,0,FMN 08 Schijnpoortweg
675,Schijnpoortweg,2023-06-24,15:00:00,0,0,0,FMN 08 Schijnpoortweg
675,Schijnpoortweg,2023-06-24,16:00:00,0,0,0,FMN 08 Schijnpoortweg
675,Schijnpoortweg,2023-06-24,17:00:00,1,1,0,FMN 08 Schijnpoortweg
675,Schijnpoortweg,2023-06-24,18:00:00,5,1,4,FMN 08 Schijnpoortweg
675,Schijnpoortweg,2023-06-24,19:00:00,5,2,3,FMN 08 Schijnpoortweg
675,Schijnpoortweg,2023-06-24,20:00:00,2,0,2,FMN 08 Schijnpoortweg
675,Schijnpoortweg,2023-06-24,21:00:00,6,4,2,FMN 08 Schijnpoortweg
675,Schijnpoortweg,2023-06-24,22:00:00,7,1,6,FMN 08 Schijnpoortweg
675,Schijnpoortweg,2023-06-24,23:00:00,2,1,1,FMN 08 Schijnpoortweg
675,Schijnpoortweg,2023-06-25,00:00:00,4,1,3,FMN 08 Schijnpoortweg
675,Schijnpoortweg,2023-06-25,01:00:00,4,0,4,FMN 08 Schijnpoortweg
675,Schijnpoortweg,2023-06-25,02:00:00,0,0,0,FMN 08 Schijnpoortweg
675,Schijnpoortweg,2023-06-25,03:00:00,1,0,1,FMN 08 Schijnpoortweg
675,Schijnpoortweg,2023-06-25,04:00:00,1,0,1,FMN 08 Schijnpoortweg
675,Schijnpoortweg,2023-06-25,05:00:00,1,1,0,FMN 08 Schijnpoortweg
675,Schijnpoortweg,2023-06-25,06:00:00,1,0,1,FMN 08 Schijnpoortweg
675,Schijnpoortweg,2023-06-25,07:00:00,0,0,0,FMN 08 Schijnpoortweg
675,Schijnpoortweg,2023-06-25,08:00:00,0,0,0,FMN 08 Schijnpoortweg
675,Schijnpoortweg,2023-06-25,09:00:00,3,3,0,FMN 08 Schijnpoortweg
675,Schijnpoortweg,2023-06-25,10:00:00,0,0,0,FMN 08 Schijnpoortweg
675,Schijnpoortweg,2023-06-25,11:00:00,0,0,0,FMN 08 Schijnpoortweg
675,Schijnpoortweg,2023-06-25,12:00:00,0,0,0,FMN 08 Schijnpoortweg
675,Schijnpoortweg,2023-06-25,13:00:00,1,1,0,FMN 08 Schijnpoortweg
675,Schijnpoortweg,2023-06-25,14:00:00,2,0,2,FMN 08 Schijnpoortweg
675,Schijnpoortweg,2023-06-25,15:00:00,0,0,0,FMN 08 Schijnpoortweg
675,Schijnpoortweg,2023-06-25,16:00:00,0,0,0,FMN 08 Schijnpoortweg
675,Schijnpoortweg,2023-06-25,17:00:00,0,0,0,FMN 08 Schijnpoortweg
675,Schijnpoortweg,2023-06-25,18:00:00,3,2,1,FMN 08 Schijnpoortweg
675,Schijnpoortweg,2023-06-25,19:00:00,3,1,2,FMN 08 Schijnpoortweg
675,Schijnpoortweg,2023-06-25,20:00:00,3,1,2,FMN 08 Schijnpoortweg
675,Schijnpoortweg,2023-06-25,21:00:00,7,3,4,FMN 08 Schijnpoortweg
675,Schijnpoortweg,2023-06-25,22:00:00,5,2,3,FMN 08 Schijnpoortweg
675,Schijnpoortweg,2023-06-25,23:00:00,1,1,0,FMN 08 Schijnpoortweg
675,Schijnpoortweg,2023-06-26,00:00:00,0,0,0,FMN 08 Schijnpoortweg
675,Schijnpoortweg,2023-06-26,01:00:00,3,1,2,FMN 08 Schijnpoortweg
675,Schijnpoortweg,2023-06-26,02:00:00,1,0,1,FMN 08 Schijnpoortweg
675,Schijnpoortweg,2023-06-26,03:00:00,1,0,1,FMN 08 Schijnpoortweg
675,Schijnpoortweg,2023-06-26,04:00:00,1,0,1,FMN 08 Schijnpoortweg
675,Schijnpoortweg,2023-06-26,05:00:00,3,1,2,FMN 08 Schijnpoortweg
675,Schijnpoortweg,2023-06-26,06:00:00,1,0,1,FMN 08 Schijnpoortweg
675,Schijnpoortweg,2023-06-26,07:00:00,2,1,1,FMN 08 Schijnpoortweg
675,Schijnpoortweg,2023-06-26,08:00:00,1,1,0,FMN 08 Schijnpoortweg
675,Schijnpoortweg,2023-06-26,09:00:00,0,0,0,FMN 08 Schijnpoortweg
675,Schijnpoortweg,2023-06-26,10:00:00,1,1,0,FMN 08 Schijnpoortweg
675,Schijnpoortweg,2023-06-26,11:00:00,0,0,0,FMN 08 Schijnpoortweg
675,Schijnpoortweg,2023-06-26,12:00:00,1,1,0,FMN 08 Schijnpoortweg
675,Schijnpoortweg,2023-06-26,13:00:00,1,1,0,FMN 08 Schijnpoortweg
675,Schijnpoortweg,2023-06-26,14:00:00,1,1,0,FMN 08 Schijnpoortweg
675,Schijnpoortweg,2023-06-26,15:00:00,0,0,0,FMN 08 Schijnpoortweg
675,Schijnpoortweg,2023-06-26,16:00:00,1,1,0,FMN 08 Schijnpoortweg
675,Schijnpoortweg,2023-06-26,17:00:00,2,2,0,FMN 08 Schijnpoortweg
675,Schijnpoortweg,2023-06-26,18:00:00,0,0,0,FMN 08 Schijnpoortweg
675,Schijnpoortweg,2023-06-26,19:00:00,0,0,0,FMN 08 Schijnpoortweg
675,Schijnpoortweg,2023-06-26,20:00:00,0,0,0,FMN 08 Schijnpoortweg
675,Schijnpoortweg,2023-06-26,21:00:00,1,1,0,FMN 08 Schijnpoortweg
675,Schijnpoortweg,2023-06-26,22:00:00,0,0,0,FMN 08 Schijnpoortweg
675,Schijnpoortweg,2023-06-26,23:00:00,1,1,0,FMN 08 Schijnpoortweg
675,Schijnpoortweg,2023-06-27,00:00:00,1,1,0,FMN 08 Schijnpoortweg
675,Schijnpoortweg,2023-06-27,01:00:00,0,0,0,FMN 08 Schijnpoortweg
675,Schijnpoortweg,2023-06-27,02:00:00,0,0,0,FMN 08 Schijnpoortweg
675,Schijnpoortweg,2023-06-27,03:00:00,0,0,0,FMN 08 Schijnpoortweg
675,Schijnpoortweg,2023-06-27,04:00:00,0,0,0,FMN 08 Schijnpoortweg
675,Schijnpoortweg,2023-06-27,05:00:00,0,0,0,FMN 08 Schijnpoortweg
675,Schijnpoortweg,2023-06-27,06:00:00,2,2,0,FMN 08 Schijnpoortweg
675,Schijnpoortweg,2023-06-27,07:00:00,1,1,0,FMN 08 Schijnpoortweg
675,Schijnpoortweg,2023-06-27,08:00:00,1,0,1,FMN 08 Schijnpoortweg
675,Schijnpoortweg,2023-06-27,09:00:00,1,1,0,FMN 08 Schijnpoortweg
675,Schijnpoortweg,2023-06-27,10:00:00,0,0,0,FMN 08 Schijnpoortweg
675,Schijnpoortweg,2023-06-27,11:00:00,0,0,0,FMN 08 Schijnpoortweg
675,Schijnpoortweg,2023-06-27,12:00:00,0,0,0,FMN 08 Schijnpoortweg
675,Schijnpoortweg,2023-06-27,13:00:00,0,0,0,FMN 08 Schijnpoortweg
675,Schijnpoortweg,2023-06-27,14:00:00,0,0,0,FMN 08 Schijnpoortweg
675,Schijnpoortweg,2023-06-27,15:00:00,0,0,0,FMN 08 Schijnpoortweg
675,Schijnpoortweg,2023-06-27,16:00:00,0,0,0,FMN 08 Schijnpoortweg
675,Schijnpoortweg,2023-06-27,17:00:00,0,0,0,FMN 08 Schijnpoortweg
675,Schijnpoortweg,2023-06-27,18:00:00,0,0,0,FMN 08 Schijnpoortweg
675,Schijnpoortweg,2023-06-27,19:00:00,0,0,0,FMN 08 Schijnpoortweg
675,Schijnpoortweg,2023-06-27,20:00:00,0,0,0,FMN 08 Schijnpoortweg
675,Schijnpoortweg,2023-06-27,21:00:00,0,0,0,FMN 08 Schijnpoortweg
675,Schijnpoortweg,2023-06-27,22:00:00,0,0,0,FMN 08 Schijnpoortweg
675,Schijnpoortweg,2023-06-27,23:00:00,0,0,0,FMN 08 Schijnpoortweg
675,Schijnpoortweg,2023-06-28,00:00:00,0,0,0,FMN 08 Schijnpoortweg
675,Schijnpoortweg,2023-06-28,01:00:00,0,0,0,FMN 08 Schijnpoortweg
675,Schijnpoortweg,2023-06-28,02:00:00,0,0,0,FMN 08 Schijnpoortweg
675,Schijnpoortweg,2023-06-28,03:00:00,0,0,0,FMN 08 Schijnpoortweg
675,Schijnpoortweg,2023-06-28,04:00:00,0,0,0,FMN 08 Schijnpoortweg
675,Schijnpoortweg,2023-06-28,05:00:00,0,0,0,FMN 08 Schijnpoortweg
675,Schijnpoortweg,2023-06-28,06:00:00,0,0,0,FMN 08 Schijnpoortweg
675,Schijnpoortweg,2023-06-28,07:00:00,0,0,0,FMN 08 Schijnpoortweg
675,Schijnpoortweg,2023-06-28,08:00:00,0,0,0,FMN 08 Schijnpoortweg
675,Schijnpoortweg,2023-06-28,09:00:00,0,0,0,FMN 08 Schijnpoortweg
675,Schijnpoortweg,2023-06-28,10:00:00,0,0,0,FMN 08 Schijnpoortweg
675,Schijnpoortweg,2023-06-28,11:00:00,0,0,0,FMN 08 Schijnpoortweg
675,Schijnpoortweg,2023-06-28,12:00:00,0,0,0,FMN 08 Schijnpoortweg
675,Schijnpoortweg,2023-06-28,13:00:00,0,0,0,FMN 08 Schijnpoortweg
675,Schijnpoortweg,2023-06-28,14:00:00,0,0,0,FMN 08 Schijnpoortweg
675,Schijnpoortweg,2023-06-28,15:00:00,0,0,0,FMN 08 Schijnpoortweg
675,Schijnpoortweg,2023-06-28,16:00:00,0,0,0,FMN 08 Schijnpoortweg
675,Schijnpoortweg,2023-06-28,17:00:00,0,0,0,FMN 08 Schijnpoortweg
675,Schijnpoortweg,2023-06-28,18:00:00,0,0,0,FMN 08 Schijnpoortweg
675,Schijnpoortweg,2023-06-28,19:00:00,2,1,1,FMN 08 Schijnpoortweg
675,Schijnpoortweg,2023-06-28,20:00:00,0,0,0,FMN 08 Schijnpoortweg
675,Schijnpoortweg,2023-06-28,21:00:00,0,0,0,FMN 08 Schijnpoortweg
675,Schijnpoortweg,2023-06-28,22:00:00,0,0,0,FMN 08 Schijnpoortweg
675,Schijnpoortweg,2023-06-28,23:00:00,2,1,1,FMN 08 Schijnpoortweg
675,Schijnpoortweg,2023-06-29,00:00:00,0,0,0,FMN 08 Schijnpoortweg
675,Schijnpoortweg,2023-06-29,01:00:00,2,1,1,FMN 08 Schijnpoortweg
675,Schijnpoortweg,2023-06-29,02:00:00,0,0,0,FMN 08 Schijnpoortweg
675,Schijnpoortweg,2023-06-29,03:00:00,0,0,0,FMN 08 Schijnpoortweg
675,Schijnpoortweg,2023-06-29,04:00:00,0,0,0,FMN 08 Schijnpoortweg
675,Schijnpoortweg,2023-06-29,05:00:00,3,1,2,FMN 08 Schijnpoortweg
675,Schijnpoortweg,2023-06-29,06:00:00,1,1,0,FMN 08 Schijnpoortweg
675,Schijnpoortweg,2023-06-29,07:00:00,0,0,0,FMN 08 Schijnpoortweg
675,Schijnpoortweg,2023-06-29,08:00:00,1,1,0,FMN 08 Schijnpoortweg
675,Schijnpoortweg,2023-06-29,09:00:00,0,0,0,FMN 08 Schijnpoortweg
675,Schijnpoortweg,2023-06-29,10:00:00,2,1,1,FMN 08 Schijnpoortweg
675,Schijnpoortweg,2023-06-29,11:00:00,0,0,0,FMN 08 Schijnpoortweg
675,Schijnpoortweg,2023-06-29,12:00:00,0,0,0,FMN 08 Schijnpoortweg
675,Schijnpoortweg,2023-06-29,13:00:00,0,0,0,FMN 08 Schijnpoortweg
675,Schijnpoortweg,2023-06-29,14:00:00,0,0,0,FMN 08 Schijnpoortweg
675,Schijnpoortweg,2023-06-29,15:00:00,1,1,0,FMN 08 Schijnpoortweg
675,Schijnpoortweg,2023-06-29,16:00:00,2,1,1,FMN 08 Schijnpoortweg
675,Schijnpoortweg,2023-06-29,17:00:00,3,0,3,FMN 08 Schijnpoortweg
675,Schijnpoortweg,2023-06-29,18:00:00,0,0,0,FMN 08 Schijnpoortweg
675,Schijnpoortweg,2023-06-29,19:00:00,1,0,1,FMN 08 Schijnpoortweg
675,Schijnpoortweg,2023-06-29,20:00:00,0,0,0,FMN 08 Schijnpoortweg
675,Schijnpoortweg,2023-06-29,21:00:00,3,2,1,FMN 08 Schijnpoortweg
675,Schijnpoortweg,2023-06-29,22:00:00,0,0,0,FMN 08 Schijnpoortweg
675,Schijnpoortweg,2023-06-29,23:00:00,1,0,1,FMN 08 Schijnpoortweg
675,Schijnpoortweg,2023-06-30,00:00:00,1,1,0,FMN 08 Schijnpoortweg
675,Schijnpoortweg,2023-06-30,01:00:00,0,0,0,FMN 08 Schijnpoortweg
675,Schijnpoortweg,2023-06-30,02:00:00,0,0,0,FMN 08 Schijnpoortweg
675,Schijnpoortweg,2023-06-30,03:00:00,0,0,0,FMN 08 Schijnpoortweg
675,Schijnpoortweg,2023-06-30,04:00:00,1,0,1,FMN 08 Schijnpoortweg
675,Schijnpoortweg,2023-06-30,05:00:00,2,1,1,FMN 08 Schijnpoortweg
675,Schijnpoortweg,2023-06-30,06:00:00,0,0,0,FMN 08 Schijnpoortweg
675,Schijnpoortweg,2023-06-30,07:00:00,0,0,0,FMN 08 Schijnpoortweg
675,Schijnpoortweg,2023-06-30,08:00:00,0,0,0,FMN 08 Schijnpoortweg
675,Schijnpoortweg,2023-06-30,09:00:00,1,1,0,FMN 08 Schijnpoortweg
675,Schijnpoortweg,2023-06-30,10:00:00,2,1,1,FMN 08 Schijnpoortweg
675,Schijnpoortweg,2023-06-30,11:00:00,1,0,1,FMN 08 Schijnpoortweg
675,Schijnpoortweg,2023-06-30,12:00:00,1,1,0,FMN 08 Schijnpoortweg
675,Schijnpoortweg,2023-06-30,13:00:00,1,0,1,FMN 08 Schijnpoortweg
675,Schijnpoortweg,2023-06-30,14:00:00,4,2,2,FMN 08 Schijnpoortweg
675,Schijnpoortweg,2023-06-30,15:00:00,2,2,0,FMN 08 Schijnpoortweg
675,Schijnpoortweg,2023-06-30,16:00:00,4,0,4,FMN 08 Schijnpoortweg
675,Schijnpoortweg,2023-06-30,17:00:00,1,0,1,FMN 08 Schijnpoortweg
675,Schijnpoortweg,2023-06-30,18:00:00,1,0,1,FMN 08 Schijnpoortweg
675,Schijnpoortweg,2023-06-30,19:00:00,3,2,1,FMN 08 Schijnpoortweg
675,Schijnpoortweg,2023-06-30,20:00:00,0,0,0,FMN 08 Schijnpoortweg
675,Schijnpoortweg,2023-06-30,21:00:00,2,1,1,FMN 08 Schijnpoortweg
675,Schijnpoortweg,2023-06-30,22:00:00,2,1,1,FMN 08 Schijnpoortweg
675,Schijnpoortweg,2023-06-30,23:00:00,1,0,1,FMN 08 Schijnpoortweg
675,Schijnpoortweg,2023-07-01,00:00:00,1,0,1,FMN 08 Schijnpoortweg
675,Schijnpoortweg,2023-07-01,01:00:00,0,0,0,FMN 08 Schijnpoortweg
675,Schijnpoortweg,2023-07-01,02:00:00,1,1,0,FMN 08 Schijnpoortweg
675,Schijnpoortweg,2023-07-01,03:00:00,0,0,0,FMN 08 Schijnpoortweg
675,Schijnpoortweg,2023-07-01,04:00:00,0,0,0,FMN 08 Schijnpoortweg
675,Schijnpoortweg,2023-07-01,05:00:00,0,0,0,FMN 08 Schijnpoortweg
675,Schijnpoortweg,2023-07-01,06:00:00,1,1,0,FMN 08 Schijnpoortweg
675,Schijnpoortweg,2023-07-01,07:00:00,2,1,1,FMN 08 Schijnpoortweg
675,Schijnpoortweg,2023-07-01,08:00:00,0,0,0,FMN 08 Schijnpoortweg
675,Schijnpoortweg,2023-07-01,09:00:00,2,1,1,FMN 08 Schijnpoortweg
675,Schijnpoortweg,2023-07-01,10:00:00,0,0,0,FMN 08 Schijnpoortweg
675,Schijnpoortweg,2023-07-01,11:00:00,1,1,0,FMN 08 Schijnpoortweg
675,Schijnpoortweg,2023-07-01,12:00:00,0,0,0,FMN 08 Schijnpoortweg
675,Schijnpoortweg,2023-07-01,13:00:00,0,0,0,FMN 08 Schijnpoortweg
675,Schijnpoortweg,2023-07-01,14:00:00,0,0,0,FMN 08 Schijnpoortweg
675,Schijnpoortweg,2023-07-01,15:00:00,2,1,1,FMN 08 Schijnpoortweg
675,Schijnpoortweg,2023-07-01,16:00:00,0,0,0,FMN 08 Schijnpoortweg
675,Schijnpoortweg,2023-07-01,17:00:00,2,2,0,FMN 08 Schijnpoortweg
675,Schijnpoortweg,2023-07-01,18:00:00,2,2,0,FMN 08 Schijnpoortweg
675,Schijnpoortweg,2023-07-01,19:00:00,0,0,0,FMN 08 Schijnpoortweg
675,Schijnpoortweg,2023-07-01,20:00:00,4,2,2,FMN 08 Schijnpoortweg
675,Schijnpoortweg,2023-07-01,21:00:00,2,0,2,FMN 08 Schijnpoortweg
675,Schijnpoortweg,2023-07-01,22:00:00,0,0,0,FMN 08 Schijnpoortweg
675,Schijnpoortweg,2023-07-01,23:00:00,1,1,0,FMN 08 Schijnpoortweg
675,Schijnpoortweg,2023-07-02,00:00:00,5,1,4,FMN 08 Schijnpoortweg
675,Schijnpoortweg,2023-07-02,01:00:00,1,1,0,FMN 08 Schijnpoortweg
675,Schijnpoortweg,2023-07-02,02:00:00,0,0,0,FMN 08 Schijnpoortweg
675,Schijnpoortweg,2023-07-02,03:00:00,1,1,0,FMN 08 Schijnpoortweg
675,Schijnpoortweg,2023-07-02,04:00:00,1,1,0,FMN 08 Schijnpoortweg
675,Schijnpoortweg,2023-07-02,05:00:00,0,0,0,FMN 08 Schijnpoortweg
675,Schijnpoortweg,2023-07-02,06:00:00,0,0,0,FMN 08 Schijnpoortweg
675,Schijnpoortweg,2023-07-02,07:00:00,0,0,0,FMN 08 Schijnpoortweg
675,Schijnpoortweg,2023-07-02,08:00:00,0,0,0,FMN 08 Schijnpoortweg
675,Schijnpoortweg,2023-07-02,09:00:00,0,0,0,FMN 08 Schijnpoortweg
675,Schijnpoortweg,2023-07-02,10:00:00,1,0,1,FMN 08 Schijnpoortweg
675,Schijnpoortweg,2023-07-02,11:00:00,0,0,0,FMN 08 Schijnpoortweg
675,Schijnpoortweg,2023-07-02,12:00:00,1,0,1,FMN 08 Schijnpoortweg
675,Schijnpoortweg,2023-07-02,13:00:00,0,0,0,FMN 08 Schijnpoortweg
675,Schijnpoortweg,2023-07-02,14:00:00,0,0,0,FMN 08 Schijnpoortweg
675,Schijnpoortweg,2023-07-02,15:00:00,3,0,3,FMN 08 Schijnpoortweg
675,Schijnpoortweg,2023-07-02,16:00:00,1,1,0,FMN 08 Schijnpoortweg
675,Schijnpoortweg,2023-07-02,17:00:00,1,1,0,FMN 08 Schijnpoortweg
675,Schijnpoortweg,2023-07-02,18:00:00,4,2,2,FMN 08 Schijnpoortweg
675,Schijnpoortweg,2023-07-02,19:00:00,4,3,1,FMN 08 Schijnpoortweg
675,Schijnpoortweg,2023-07-02,20:00:00,1,0,1,FMN 08 Schijnpoortweg
675,Schijnpoortweg,2023-07-02,21:00:00,1,1,0,FMN 08 Schijnpoortweg
675,Schijnpoortweg,2023-07-02,22:00:00,3,2,1,FMN 08 Schijnpoortweg
675,Schijnpoortweg,2023-07-02,23:00:00,3,2,1,FMN 08 Schijnpoortweg
675,Schijnpoortweg,2023-07-03,00:00:00,2,2,0,FMN 08 Schijnpoortweg
675,Schijnpoortweg,2023-07-03,01:00:00,1,0,1,FMN 08 Schijnpoortweg
675,Schijnpoortweg,2023-07-03,02:00:00,0,0,0,FMN 08 Schijnpoortweg
675,Schijnpoortweg,2023-07-03,03:00:00,1,0,1,FMN 08 Schijnpoortweg
675,Schijnpoortweg,2023-07-03,04:00:00,1,0,1,FMN 08 Schijnpoortweg
675,Schijnpoortweg,2023-07-03,05:00:00,2,0,2,FMN 08 Schijnpoortweg
675,Schijnpoortweg,2023-07-03,06:00:00,2,1,1,FMN 08 Schijnpoortweg
675,Schijnpoortweg,2023-07-03,07:00:00,0,0,0,FMN 08 Schijnpoortweg
675,Schijnpoortweg,2023-07-03,08:00:00,0,0,0,FMN 08 Schijnpoortweg
675,Schijnpoortweg,2023-07-03,09:00:00,0,0,0,FMN 08 Schijnpoortweg
675,Schijnpoortweg,2023-07-03,10:00:00,1,1,0,FMN 08 Schijnpoortweg
675,Schijnpoortweg,2023-07-03,11:00:00,0,0,0,FMN 08 Schijnpoortweg
675,Schijnpoortweg,2023-07-03,12:00:00,0,0,0,FMN 08 Schijnpoortweg
675,Schijnpoortweg,2023-07-03,13:00:00,1,0,1,FMN 08 Schijnpoortweg
675,Schijnpoortweg,2023-07-03,14:00:00,0,0,0,FMN 08 Schijnpoortweg
675,Schijnpoortweg,2023-07-03,15:00:00,2,1,1,FMN 08 Schijnpoortweg
675,Schijnpoortweg,2023-07-03,16:00:00,6,4,2,FMN 08 Schijnpoortweg
675,Schijnpoortweg,2023-07-03,17:00:00,2,0,2,FMN 08 Schijnpoortweg
675,Schijnpoortweg,2023-07-03,18:00:00,3,3,0,FMN 08 Schijnpoortweg
675,Schijnpoortweg,2023-07-03,19:00:00,4,1,3,FMN 08 Schijnpoortweg
675,Schijnpoortweg,2023-07-03,20:00:00,1,1,0,FMN 08 Schijnpoortweg
675,Schijnpoortweg,2023-07-03,21:00:00,2,1,1,FMN 08 Schijnpoortweg
675,Schijnpoortweg,2023-07-03,22:00:00,1,0,1,FMN 08 Schijnpoortweg
675,Schijnpoortweg,2023-07-03,23:00:00,1,1,0,FMN 08 Schijnpoortweg
675,Schijnpoortweg,2023-07-04,00:00:00,1,1,0,FMN 08 Schijnpoortweg
675,Schijnpoortweg,2023-07-04,01:00:00,0,0,0,FMN 08 Schijnpoortweg
675,Schijnpoortweg,2023-07-04,02:00:00,0,0,0,FMN 08 Schijnpoortweg
675,Schijnpoortweg,2023-07-04,03:00:00,0,0,0,FMN 08 Schijnpoortweg
675,Schijnpoortweg,2023-07-04,04:00:00,0,0,0,FMN 08 Schijnpoortweg
675,Schijnpoortweg,2023-07-04,05:00:00,3,0,3,FMN 08 Schijnpoortweg
675,Schijnpoortweg,2023-07-04,06:00:00,2,2,0,FMN 08 Schijnpoortweg
675,Schijnpoortweg,2023-07-04,07:00:00,0,0,0,FMN 08 Schijnpoortweg
675,Schijnpoortweg,2023-07-04,08:00:00,0,0,0,FMN 08 Schijnpoortweg
675,Schijnpoortweg,2023-07-04,09:00:00,0,0,0,FMN 08 Schijnpoortweg
675,Schijnpoortweg,2023-07-04,10:00:00,0,0,0,FMN 08 Schijnpoortweg
675,Schijnpoortweg,2023-07-04,11:00:00,1,1,0,FMN 08 Schijnpoortweg
675,Schijnpoortweg,2023-07-04,12:00:00,3,3,0,FMN 08 Schijnpoortweg
675,Schijnpoortweg,2023-07-04,13:00:00,2,2,0,FMN 08 Schijnpoortweg
675,Schijnpoortweg,2023-07-04,14:00:00,1,1,0,FMN 08 Schijnpoortweg
675,Schijnpoortweg,2023-07-04,15:00:00,0,0,0,FMN 08 Schijnpoortweg
675,Schijnpoortweg,2023-07-04,16:00:00,2,2,0,FMN 08 Schijnpoortweg
675,Schijnpoortweg,2023-07-04,17:00:00,6,3,3,FMN 08 Schijnpoortweg
675,Schijnpoortweg,2023-07-04,18:00:00,1,1,0,FMN 08 Schijnpoortweg
675,Schijnpoortweg,2023-07-04,19:00:00,2,1,1,FMN 08 Schijnpoortweg
675,Schijnpoortweg,2023-07-04,20:00:00,2,1,1,FMN 08 Schijnpoortweg
675,Schijnpoortweg,2023-07-04,21:00:00,2,1,1,FMN 08 Schijnpoortweg
675,Schijnpoortweg,2023-07-04,22:00:00,0,0,0,FMN 08 Schijnpoortweg
675,Schijnpoortweg,2023-07-04,23:00:00,1,1,0,FMN 08 Schijnpoortweg
675,Schijnpoortweg,2023-07-05,00:00:00,1,0,1,FMN 08 Schijnpoortweg
675,Schijnpoortweg,2023-07-05,01:00:00,0,0,0,FMN 08 Schijnpoortweg
675,Schijnpoortweg,2023-07-05,02:00:00,0,0,0,FMN 08 Schijnpoortweg
675,Schijnpoortweg,2023-07-05,03:00:00,0,0,0,FMN 08 Schijnpoortweg
675,Schijnpoortweg,2023-07-05,04:00:00,2,1,1,FMN 08 Schijnpoortweg
675,Schijnpoortweg,2023-07-05,05:00:00,5,1,4,FMN 08 Schijnpoortweg
675,Schijnpoortweg,2023-07-05,06:00:00,1,1,0,FMN 08 Schijnpoortweg
675,Schijnpoortweg,2023-07-05,07:00:00,2,1,1,FMN 08 Schijnpoortweg
675,Schijnpoortweg,2023-07-05,08:00:00,1,0,1,FMN 08 Schijnpoortweg
675,Schijnpoortweg,2023-07-05,09:00:00,0,0,0,FMN 08 Schijnpoortweg
675,Schijnpoortweg,2023-07-05,10:00:00,1,1,0,FMN 08 Schijnpoortweg
675,Schijnpoortweg,2023-07-05,11:00:00,0,0,0,FMN 08 Schijnpoortweg
675,Schijnpoortweg,2023-07-05,12:00:00,0,0,0,FMN 08 Schijnpoortweg
675,Schijnpoortweg,2023-07-05,13:00:00,1,1,0,FMN 08 Schijnpoortweg
675,Schijnpoortweg,2023-07-05,14:00:00,1,1,0,FMN 08 Schijnpoortweg
675,Schijnpoortweg,2023-07-05,15:00:00,1,0,1,FMN 08 Schijnpoortweg
675,Schijnpoortweg,2023-07-05,16:00:00,1,1,0,FMN 08 Schijnpoortweg
675,Schijnpoortweg,2023-07-05,17:00:00,3,2,1,FMN 08 Schijnpoortweg
675,Schijnpoortweg,2023-07-05,18:00:00,0,0,0,FMN 08 Schijnpoortweg
675,Schijnpoortweg,2023-07-05,19:00:00,3,2,1,FMN 08 Schijnpoortweg
675,Schijnpoortweg,2023-07-05,20:00:00,2,0,2,FMN 08 Schijnpoortweg
675,Schijnpoortweg,2023-07-05,21:00:00,0,0,0,FMN 08 Schijnpoortweg
675,Schijnpoortweg,2023-07-05,22:00:00,1,0,1,FMN 08 Schijnpoortweg
675,Schijnpoortweg,2023-07-05,23:00:00,2,1,1,FMN 08 Schijnpoortweg
675,Schijnpoortweg,2023-07-06,00:00:00,0,0,0,FMN 08 Schijnpoortweg
675,Schijnpoortweg,2023-07-06,01:00:00,2,0,2,FMN 08 Schijnpoortweg
675,Schijnpoortweg,2023-07-06,02:00:00,0,0,0,FMN 08 Schijnpoortweg
675,Schijnpoortweg,2023-07-06,03:00:00,1,1,0,FMN 08 Schijnpoortweg
675,Schijnpoortweg,2023-07-06,04:00:00,2,1,1,FMN 08 Schijnpoortweg
675,Schijnpoortweg,2023-07-06,05:00:00,4,0,4,FMN 08 Schijnpoortweg
675,Schijnpoortweg,2023-07-06,06:00:00,1,0,1,FMN 08 Schijnpoortweg
675,Schijnpoortweg,2023-07-06,07:00:00,0,0,0,FMN 08 Schijnpoortweg
675,Schijnpoortweg,2023-07-06,08:00:00,0,0,0,FMN 08 Schijnpoortweg
675,Schijnpoortweg,2023-07-06,09:00:00,2,2,0,FMN 08 Schijnpoortweg
675,Schijnpoortweg,2023-07-06,10:00:00,1,0,1,FMN 08 Schijnpoortweg
675,Schijnpoortweg,2023-07-06,11:00:00,1,1,0,FMN 08 Schijnpoortweg
675,Schijnpoortweg,2023-07-06,12:00:00,0,0,0,FMN 08 Schijnpoortweg
675,Schijnpoortweg,2023-07-06,13:00:00,1,1,0,FMN 08 Schijnpoortweg
675,Schijnpoortweg,2023-07-06,14:00:00,5,3,2,FMN 08 Schijnpoortweg
675,Schijnpoortweg,2023-07-06,15:00:00,2,2,0,FMN 08 Schijnpoortweg
675,Schijnpoortweg,2023-07-06,16:00:00,2,0,2,FMN 08 Schijnpoortweg
675,Schijnpoortweg,2023-07-06,17:00:00,6,1,5,FMN 08 Schijnpoortweg
675,Schijnpoortweg,2023-07-06,18:00:00,4,1,3,FMN 08 Schijnpoortweg
675,Schijnpoortweg,2023-07-06,19:00:00,4,2,2,FMN 08 Schijnpoortweg
675,Schijnpoortweg,2023-07-06,20:00:00,0,0,0,FMN 08 Schijnpoortweg
675,Schijnpoortweg,2023-07-06,21:00:00,0,0,0,FMN 08 Schijnpoortweg
675,Schijnpoortweg,2023-07-06,22:00:00,2,0,2,FMN 08 Schijnpoortweg
675,Schijnpoortweg,2023-07-06,23:00:00,3,1,2,FMN 08 Schijnpoortweg
675,Schijnpoortweg,2023-07-07,00:00:00,2,2,0,FMN 08 Schijnpoortweg
675,Schijnpoortweg,2023-07-07,01:00:00,2,0,2,FMN 08 Schijnpoortweg
675,Schijnpoortweg,2023-07-07,02:00:00,1,0,1,FMN 08 Schijnpoortweg
675,Schijnpoortweg,2023-07-07,03:00:00,0,0,0,FMN 08 Schijnpoortweg
675,Schijnpoortweg,2023-07-07,04:00:00,0,0,0,FMN 08 Schijnpoortweg
675,Schijnpoortweg,2023-07-07,05:00:00,2,0,2,FMN 08 Schijnpoortweg
675,Schijnpoortweg,2023-07-07,06:00:00,0,0,0,FMN 08 Schijnpoortweg
675,Schijnpoortweg,2023-07-07,07:00:00,0,0,0,FMN 08 Schijnpoortweg
675,Schijnpoortweg,2023-07-07,08:00:00,0,0,0,FMN 08 Schijnpoortweg
675,Schijnpoortweg,2023-07-07,09:00:00,1,1,0,FMN 08 Schijnpoortweg
675,Schijnpoortweg,2023-07-07,10:00:00,0,0,0,FMN 08 Schijnpoortweg
675,Schijnpoortweg,2023-07-07,11:00:00,1,1,0,FMN 08 Schijnpoortweg
675,Schijnpoortweg,2023-07-07,12:00:00,1,0,1,FMN 08 Schijnpoortweg
675,Schijnpoortweg,2023-07-07,13:00:00,0,0,0,FMN 08 Schijnpoortweg
675,Schijnpoortweg,2023-07-07,14:00:00,1,0,1,FMN 08 Schijnpoortweg
675,Schijnpoortweg,2023-07-07,15:00:00,0,0,0,FMN 08 Schijnpoortweg
675,Schijnpoortweg,2023-07-07,16:00:00,2,1,1,FMN 08 Schijnpoortweg
675,Schijnpoortweg,2023-07-07,17:00:00,2,0,2,FMN 08 Schijnpoortweg
675,Schijnpoortweg,2023-07-07,18:00:00,2,2,0,FMN 08 Schijnpoortweg
675,Schijnpoortweg,2023-07-07,19:00:00,4,2,2,FMN 08 Schijnpoortweg
675,Schijnpoortweg,2023-07-07,20:00:00,0,0,0,FMN 08 Schijnpoortweg
675,Schijnpoortweg,2023-07-07,21:00:00,4,2,2,FMN 08 Schijnpoortweg
675,Schijnpoortweg,2023-07-07,22:00:00,4,1,3,FMN 08 Schijnpoortweg
675,Schijnpoortweg,2023-07-07,23:00:00,2,1,1,FMN 08 Schijnpoortweg
675,Schijnpoortweg,2023-07-08,00:00:00,1,1,0,FMN 08 Schijnpoortweg
675,Schijnpoortweg,2023-07-08,01:00:00,0,0,0,FMN 08 Schijnpoortweg
675,Schijnpoortweg,2023-07-08,02:00:00,2,1,1,FMN 08 Schijnpoortweg
675,Schijnpoortweg,2023-07-08,03:00:00,3,0,3,FMN 08 Schijnpoortweg
675,Schijnpoortweg,2023-07-08,04:00:00,0,0,0,FMN 08 Schijnpoortweg
675,Schijnpoortweg,2023-07-08,05:00:00,0,0,0,FMN 08 Schijnpoortweg
675,Schijnpoortweg,2023-07-08,06:00:00,0,0,0,FMN 08 Schijnpoortweg
675,Schijnpoortweg,2023-07-08,07:00:00,0,0,0,FMN 08 Schijnpoortweg
675,Schijnpoortweg,2023-07-08,08:00:00,3,0,3,FMN 08 Schijnpoortweg
675,Schijnpoortweg,2023-07-08,09:00:00,0,0,0,FMN 08 Schijnpoortweg
675,Schijnpoortweg,2023-07-08,10:00:00,0,0,0,FMN 08 Schijnpoortweg
675,Schijnpoortweg,2023-07-08,11:00:00,0,0,0,FMN 08 Schijnpoortweg
675,Schijnpoortweg,2023-07-08,12:00:00,1,1,0,FMN 08 Schijnpoortweg
675,Schijnpoortweg,2023-07-08,13:00:00,0,0,0,FMN 08 Schijnpoortweg
675,Schijnpoortweg,2023-07-08,14:00:00,1,0,1,FMN 08 Schijnpoortweg
675,Schijnpoortweg,2023-07-08,15:00:00,0,0,0,FMN 08 Schijnpoortweg
675,Schijnpoortweg,2023-07-08,16:00:00,2,2,0,FMN 08 Schijnpoortweg
675,Schijnpoortweg,2023-07-08,17:00:00,0,0,0,FMN 08 Schijnpoortweg
675,Schijnpoortweg,2023-07-08,18:00:00,1,0,1,FMN 08 Schijnpoortweg
675,Schijnpoortweg,2023-07-08,19:00:00,1,0,1,FMN 08 Schijnpoortweg
675,Schijnpoortweg,2023-07-08,20:00:00,2,0,2,FMN 08 Schijnpoortweg
675,Schijnpoortweg,2023-07-08,21:00:00,2,0,2,FMN 08 Schijnpoortweg
675,Schijnpoortweg,2023-07-08,22:00:00,4,2,2,FMN 08 Schijnpoortweg
675,Schijnpoortweg,2023-07-08,23:00:00,1,1,0,FMN 08 Schijnpoortweg
675,Schijnpoortweg,2023-07-09,00:00:00,0,0,0,FMN 08 Schijnpoortweg
675,Schijnpoortweg,2023-07-09,01:00:00,0,0,0,FMN 08 Schijnpoortweg
675,Schijnpoortweg,2023-07-09,02:00:00,1,0,1,FMN 08 Schijnpoortweg
675,Schijnpoortweg,2023-07-09,03:00:00,1,1,0,FMN 08 Schijnpoortweg
675,Schijnpoortweg,2023-07-09,04:00:00,1,1,0,FMN 08 Schijnpoortweg
675,Schijnpoortweg,2023-07-09,05:00:00,1,1,0,FMN 08 Schijnpoortweg
675,Schijnpoortweg,2023-07-09,06:00:00,0,0,0,FMN 08 Schijnpoortweg
675,Schijnpoortweg,2023-07-09,07:00:00,0,0,0,FMN 08 Schijnpoortweg
675,Schijnpoortweg,2023-07-09,08:00:00,1,1,0,FMN 08 Schijnpoortweg
675,Schijnpoortweg,2023-07-09,09:00:00,2,1,1,FMN 08 Schijnpoortweg
675,Schijnpoortweg,2023-07-09,10:00:00,1,1,0,FMN 08 Schijnpoortweg
675,Schijnpoortweg,2023-07-09,11:00:00,1,1,0,FMN 08 Schijnpoortweg
675,Schijnpoortweg,2023-07-09,12:00:00,1,0,1,FMN 08 Schijnpoortweg
675,Schijnpoortweg,2023-07-09,13:00:00,1,0,1,FMN 08 Schijnpoortweg
675,Schijnpoortweg,2023-07-09,14:00:00,0,0,0,FMN 08 Schijnpoortweg
675,Schijnpoortweg,2023-07-09,15:00:00,0,0,0,FMN 08 Schijnpoortweg
675,Schijnpoortweg,2023-07-09,16:00:00,0,0,0,FMN 08 Schijnpoortweg
675,Schijnpoortweg,2023-07-09,17:00:00,1,0,1,FMN 08 Schijnpoortweg
675,Schijnpoortweg,2023-07-09,18:00:00,0,0,0,FMN 08 Schijnpoortweg
675,Schijnpoortweg,2023-07-09,19:00:00,1,0,1,FMN 08 Schijnpoortweg
675,Schijnpoortweg,2023-07-09,20:00:00,2,1,1,FMN 08 Schijnpoortweg
675,Schijnpoortweg,2023-07-09,21:00:00,2,0,2,FMN 08 Schijnpoortweg
675,Schijnpoortweg,2023-07-09,22:00:00,3,2,1,FMN 08 Schijnpoortweg
675,Schijnpoortweg,2023-07-09,23:00:00,1,0,1,FMN 08 Schijnpoortweg
675,Schijnpoortweg,2023-07-10,00:00:00,3,1,2,FMN 08 Schijnpoortweg
675,Schijnpoortweg,2023-07-10,01:00:00,1,0,1,FMN 08 Schijnpoortweg
675,Schijnpoortweg,2023-07-10,02:00:00,1,0,1,FMN 08 Schijnpoortweg
675,Schijnpoortweg,2023-07-10,03:00:00,0,0,0,FMN 08 Schijnpoortweg
675,Schijnpoortweg,2023-07-10,04:00:00,0,0,0,FMN 08 Schijnpoortweg
675,Schijnpoortweg,2023-07-10,05:00:00,0,0,0,FMN 08 Schijnpoortweg
675,Schijnpoortweg,2023-07-10,06:00:00,3,0,3,FMN 08 Schijnpoortweg
675,Schijnpoortweg,2023-07-10,07:00:00,1,0,1,FMN 08 Schijnpoortweg
675,Schijnpoortweg,2023-07-10,08:00:00,0,0,0,FMN 08 Schijnpoortweg
675,Schijnpoortweg,2023-07-10,09:00:00,0,0,0,FMN 08 Schijnpoortweg
675,Schijnpoortweg,2023-07-10,10:00:00,0,0,0,FMN 08 Schijnpoortweg
675,Schijnpoortweg,2023-07-10,11:00:00,1,0,1,FMN 08 Schijnpoortweg
675,Schijnpoortweg,2023-07-10,12:00:00,0,0,0,FMN 08 Schijnpoortweg
675,Schijnpoortweg,2023-07-10,13:00:00,0,0,0,FMN 08 Schijnpoortweg
675,Schijnpoortweg,2023-07-10,14:00:00,0,0,0,FMN 08 Schijnpoortweg
675,Schijnpoortweg,2023-07-10,15:00:00,1,0,1,FMN 08 Schijnpoortweg
675,Schijnpoortweg,2023-07-10,16:00:00,1,0,1,FMN 08 Schijnpoortweg
675,Schijnpoortweg,2023-07-10,17:00:00,2,0,2,FMN 08 Schijnpoortweg
675,Schijnpoortweg,2023-07-10,18:00:00,1,0,1,FMN 08 Schijnpoortweg
675,Schijnpoortweg,2023-07-10,19:00:00,0,0,0,FMN 08 Schijnpoortweg
675,Schijnpoortweg,2023-07-10,20:00:00,1,0,1,FMN 08 Schijnpoortweg
675,Schijnpoortweg,2023-07-10,21:00:00,4,0,4,FMN 08 Schijnpoortweg
675,Schijnpoortweg,2023-07-10,22:00:00,2,2,0,FMN 08 Schijnpoortweg
675,Schijnpoortweg,2023-07-10,23:00:00,2,1,1,FMN 08 Schijnpoortweg
675,Schijnpoortweg,2023-07-11,00:00:00,1,0,1,FMN 08 Schijnpoortweg
675,Schijnpoortweg,2023-07-11,01:00:00,4,2,2,FMN 08 Schijnpoortweg
675,Schijnpoortweg,2023-07-11,02:00:00,1,0,1,FMN 08 Schijnpoortweg
675,Schijnpoortweg,2023-07-11,03:00:00,0,0,0,FMN 08 Schijnpoortweg
675,Schijnpoortweg,2023-07-11,04:00:00,0,0,0,FMN 08 Schijnpoortweg
675,Schijnpoortweg,2023-07-11,05:00:00,1,0,1,FMN 08 Schijnpoortweg
675,Schijnpoortweg,2023-07-11,06:00:00,0,0,0,FMN 08 Schijnpoortweg
675,Schijnpoortweg,2023-07-11,07:00:00,0,0,0,FMN 08 Schijnpoortweg
675,Schijnpoortweg,2023-07-11,08:00:00,1,1,0,FMN 08 Schijnpoortweg
675,Schijnpoortweg,2023-07-11,09:00:00,1,0,1,FMN 08 Schijnpoortweg
675,Schijnpoortweg,2023-07-11,10:00:00,0,0,0,FMN 08 Schijnpoortweg
675,Schijnpoortweg,2023-07-11,11:00:00,0,0,0,FMN 08 Schijnpoortweg
675,Schijnpoortweg,2023-07-11,12:00:00,1,1,0,FMN 08 Schijnpoortweg
675,Schijnpoortweg,2023-07-11,13:00:00,1,0,1,FMN 08 Schijnpoortweg
675,Schijnpoortweg,2023-07-11,14:00:00,2,1,1,FMN 08 Schijnpoortweg
675,Schijnpoortweg,2023-07-11,15:00:00,1,0,1,FMN 08 Schijnpoortweg
675,Schijnpoortweg,2023-07-11,16:00:00,3,1,2,FMN 08 Schijnpoortweg
675,Schijnpoortweg,2023-07-11,17:00:00,2,0,2,FMN 08 Schijnpoortweg
675,Schijnpoortweg,2023-07-11,18:00:00,6,3,3,FMN 08 Schijnpoortweg
675,Schijnpoortweg,2023-07-11,19:00:00,4,2,2,FMN 08 Schijnpoortweg
675,Schijnpoortweg,2023-07-11,20:00:00,2,2,0,FMN 08 Schijnpoortweg
675,Schijnpoortweg,2023-07-11,21:00:00,1,0,1,FMN 08 Schijnpoortweg
675,Schijnpoortweg,2023-07-11,22:00:00,2,2,0,FMN 08 Schijnpoortweg
675,Schijnpoortweg,2023-07-11,23:00:00,1,1,0,FMN 08 Schijnpoortweg
675,Schijnpoortweg,2023-07-12,00:00:00,2,0,2,FMN 08 Schijnpoortweg
675,Schijnpoortweg,2023-07-12,01:00:00,1,1,0,FMN 08 Schijnpoortweg
675,Schijnpoortweg,2023-07-12,02:00:00,0,0,0,FMN 08 Schijnpoortweg
675,Schijnpoortweg,2023-07-12,03:00:00,0,0,0,FMN 08 Schijnpoortweg
675,Schijnpoortweg,2023-07-12,04:00:00,1,0,1,FMN 08 Schijnpoortweg
675,Schijnpoortweg,2023-07-12,05:00:00,2,0,2,FMN 08 Schijnpoortweg
675,Schijnpoortweg,2023-07-12,06:00:00,1,0,1,FMN 08 Schijnpoortweg
675,Schijnpoortweg,2023-07-12,07:00:00,1,0,1,FMN 08 Schijnpoortweg
675,Schijnpoortweg,2023-07-12,08:00:00,1,0,1,FMN 08 Schijnpoortweg
675,Schijnpoortweg,2023-07-12,09:00:00,3,0,3,FMN 08 Schijnpoortweg
675,Schijnpoortweg,2023-07-12,10:00:00,2,0,2,FMN 08 Schijnpoortweg
675,Schijnpoortweg,2023-07-12,11:00:00,2,1,1,FMN 08 Schijnpoortweg
675,Schijnpoortweg,2023-07-12,12:00:00,0,0,0,FMN 08 Schijnpoortweg
675,Schijnpoortweg,2023-07-12,13:00:00,4,0,4,FMN 08 Schijnpoortweg
675,Schijnpoortweg,2023-07-12,14:00:00,4,1,3,FMN 08 Schijnpoortweg
675,Schijnpoortweg,2023-07-12,15:00:00,1,0,1,FMN 08 Schijnpoortweg
675,Schijnpoortweg,2023-07-12,16:00:00,3,1,2,FMN 08 Schijnpoortweg
675,Schijnpoortweg,2023-07-12,17:00:00,4,1,3,FMN 08 Schijnpoortweg
675,Schijnpoortweg,2023-07-12,18:00:00,2,1,1,FMN 08 Schijnpoortweg
675,Schijnpoortweg,2023-07-12,19:00:00,1,1,0,FMN 08 Schijnpoortweg
675,Schijnpoortweg,2023-07-12,20:00:00,7,3,4,FMN 08 Schijnpoortweg
675,Schijnpoortweg,2023-07-12,21:00:00,1,0,1,FMN 08 Schijnpoortweg
675,Schijnpoortweg,2023-07-12,22:00:00,4,2,2,FMN 08 Schijnpoortweg
675,Schijnpoortweg,2023-07-12,23:00:00,2,2,0,FMN 08 Schijnpoortweg
675,Schijnpoortweg,2023-07-13,00:00:00,5,3,2,FMN 08 Schijnpoortweg
675,Schijnpoortweg,2023-07-13,01:00:00,0,0,0,FMN 08 Schijnpoortweg
675,Schijnpoortweg,2023-07-13,02:00:00,1,0,1,FMN 08 Schijnpoortweg
675,Schijnpoortweg,2023-07-13,03:00:00,0,0,0,FMN 08 Schijnpoortweg
675,Schijnpoortweg,2023-07-13,04:00:00,2,1,1,FMN 08 Schijnpoortweg
675,Schijnpoortweg,2023-07-13,05:00:00,2,0,2,FMN 08 Schijnpoortweg
675,Schijnpoortweg,2023-07-13,06:00:00,2,2,0,FMN 08 Schijnpoortweg
675,Schijnpoortweg,2023-07-13,07:00:00,0,0,0,FMN 08 Schijnpoortweg
675,Schijnpoortweg,2023-07-13,08:00:00,0,0,0,FMN 08 Schijnpoortweg
675,Schijnpoortweg,2023-07-13,09:00:00,0,0,0,FMN 08 Schijnpoortweg
675,Schijnpoortweg,2023-07-13,10:00:00,0,0,0,FMN 08 Schijnpoortweg
675,Schijnpoortweg,2023-07-13,11:00:00,0,0,0,FMN 08 Schijnpoortweg
675,Schijnpoortweg,2023-07-13,12:00:00,1,1,0,FMN 08 Schijnpoortweg
675,Schijnpoortweg,2023-07-13,13:00:00,6,1,5,FMN 08 Schijnpoortweg
675,Schijnpoortweg,2023-07-13,14:00:00,0,0,0,FMN 08 Schijnpoortweg
675,Schijnpoortweg,2023-07-13,15:00:00,6,4,2,FMN 08 Schijnpoortweg
675,Schijnpoortweg,2023-07-13,16:00:00,8,5,3,FMN 08 Schijnpoortweg
675,Schijnpoortweg,2023-07-13,17:00:00,2,1,1,FMN 08 Schijnpoortweg
675,Schijnpoortweg,2023-07-13,18:00:00,14,1,13,FMN 08 Schijnpoortweg
675,Schijnpoortweg,2023-07-13,19:00:00,18,1,17,FMN 08 Schijnpoortweg
675,Schijnpoortweg,2023-07-13,20:00:00,15,0,15,FMN 08 Schijnpoortweg
675,Schijnpoortweg,2023-07-13,21:00:00,0,0,0,FMN 08 Schijnpoortweg
675,Schijnpoortweg,2023-07-13,22:00:00,27,13,14,FMN 08 Schijnpoortweg
675,Schijnpoortweg,2023-07-13,23:00:00,40,35,5,FMN 08 Schijnpoortweg
675,Schijnpoortweg,2023-07-14,00:00:00,5,3,2,FMN 08 Schijnpoortweg
675,Schijnpoortweg,2023-07-14,01:00:00,1,0,1,FMN 08 Schijnpoortweg
675,Schijnpoortweg,2023-07-14,02:00:00,0,0,0,FMN 08 Schijnpoortweg
675,Schijnpoortweg,2023-07-14,03:00:00,0,0,0,FMN 08 Schijnpoortweg
675,Schijnpoortweg,2023-07-14,04:00:00,0,0,0,FMN 08 Schijnpoortweg
675,Schijnpoortweg,2023-07-14,05:00:00,2,0,2,FMN 08 Schijnpoortweg
675,Schijnpoortweg,2023-07-14,06:00:00,2,1,1,FMN 08 Schijnpoortweg
675,Schijnpoortweg,2023-07-14,07:00:00,1,0,1,FMN 08 Schijnpoortweg
675,Schijnpoortweg,2023-07-14,08:00:00,1,0,1,FMN 08 Schijnpoortweg
675,Schijnpoortweg,2023-07-14,09:00:00,0,0,0,FMN 08 Schijnpoortweg
675,Schijnpoortweg,2023-07-14,10:00:00,2,2,0,FMN 08 Schijnpoortweg
675,Schijnpoortweg,2023-07-14,11:00:00,0,0,0,FMN 08 Schijnpoortweg
675,Schijnpoortweg,2023-07-14,12:00:00,0,0,0,FMN 08 Schijnpoortweg
675,Schijnpoortweg,2023-07-14,13:00:00,3,1,2,FMN 08 Schijnpoortweg
675,Schijnpoortweg,2023-07-14,14:00:00,0,0,0,FMN 08 Schijnpoortweg
675,Schijnpoortweg,2023-07-14,15:00:00,2,0,2,FMN 08 Schijnpoortweg
675,Schijnpoortweg,2023-07-14,16:00:00,2,1,1,FMN 08 Schijnpoortweg
675,Schijnpoortweg,2023-07-14,17:00:00,1,0,1,FMN 08 Schijnpoortweg
675,Schijnpoortweg,2023-07-14,18:00:00,1,0,1,FMN 08 Schijnpoortweg
675,Schijnpoortweg,2023-07-14,19:00:00,3,3,0,FMN 08 Schijnpoortweg
675,Schijnpoortweg,2023-07-14,20:00:00,0,0,0,FMN 08 Schijnpoortweg
675,Schijnpoortweg,2023-07-14,21:00:00,2,0,2,FMN 08 Schijnpoortweg
675,Schijnpoortweg,2023-07-14,22:00:00,2,0,2,FMN 08 Schijnpoortweg
675,Schijnpoortweg,2023-07-14,23:00:00,2,2,0,FMN 08 Schijnpoortweg
675,Schijnpoortweg,2023-07-15,00:00:00,0,0,0,FMN 08 Schijnpoortweg
675,Schijnpoortweg,2023-07-15,01:00:00,1,0,1,FMN 08 Schijnpoortweg
675,Schijnpoortweg,2023-07-15,02:00:00,2,0,2,FMN 08 Schijnpoortweg
675,Schijnpoortweg,2023-07-15,03:00:00,1,0,1,FMN 08 Schijnpoortweg
675,Schijnpoortweg,2023-07-15,04:00:00,0,0,0,FMN 08 Schijnpoortweg
675,Schijnpoortweg,2023-07-15,05:00:00,1,1,0,FMN 08 Schijnpoortweg
675,Schijnpoortweg,2023-07-15,06:00:00,0,0,0,FMN 08 Schijnpoortweg
675,Schijnpoortweg,2023-07-15,07:00:00,1,1,0,FMN 08 Schijnpoortweg
675,Schijnpoortweg,2023-07-15,08:00:00,0,0,0,FMN 08 Schijnpoortweg
675,Schijnpoortweg,2023-07-15,09:00:00,2,2,0,FMN 08 Schijnpoortweg
675,Schijnpoortweg,2023-07-15,10:00:00,2,2,0,FMN 08 Schijnpoortweg
675,Schijnpoortweg,2023-07-15,11:00:00,0,0,0,FMN 08 Schijnpoortweg
675,Schijnpoortweg,2023-07-15,12:00:00,1,1,0,FMN 08 Schijnpoortweg
675,Schijnpoortweg,2023-07-15,13:00:00,1,1,0,FMN 08 Schijnpoortweg
675,Schijnpoortweg,2023-07-15,14:00:00,0,0,0,FMN 08 Schijnpoortweg
675,Schijnpoortweg,2023-07-15,15:00:00,1,0,1,FMN 08 Schijnpoortweg
675,Schijnpoortweg,2023-07-15,16:00:00,1,0,1,FMN 08 Schijnpoortweg
675,Schijnpoortweg,2023-07-15,17:00:00,3,0,3,FMN 08 Schijnpoortweg
675,Schijnpoortweg,2023-07-15,18:00:00,1,0,1,FMN 08 Schijnpoortweg
675,Schijnpoortweg,2023-07-15,19:00:00,4,1,3,FMN 08 Schijnpoortweg
675,Schijnpoortweg,2023-07-15,20:00:00,2,1,1,FMN 08 Schijnpoortweg
675,Schijnpoortweg,2023-07-15,21:00:00,3,1,2,FMN 08 Schijnpoortweg
675,Schijnpoortweg,2023-07-15,22:00:00,1,1,0,FMN 08 Schijnpoortweg
675,Schijnpoortweg,2023-07-15,23:00:00,2,0,2,FMN 08 Schijnpoortweg
675,Schijnpoortweg,2023-07-16,00:00:00,1,1,0,FMN 08 Schijnpoortweg
675,Schijnpoortweg,2023-07-16,01:00:00,1,0,1,FMN 08 Schijnpoortweg
675,Schijnpoortweg,2023-07-16,02:00:00,1,0,1,FMN 08 Schijnpoortweg
675,Schijnpoortweg,2023-07-16,03:00:00,0,0,0,FMN 08 Schijnpoortweg
675,Schijnpoortweg,2023-07-16,04:00:00,0,0,0,FMN 08 Schijnpoortweg
675,Schijnpoortweg,2023-07-16,05:00:00,0,0,0,FMN 08 Schijnpoortweg
675,Schijnpoortweg,2023-07-16,06:00:00,0,0,0,FMN 08 Schijnpoortweg
675,Schijnpoortweg,2023-07-16,07:00:00,0,0,0,FMN 08 Schijnpoortweg
675,Schijnpoortweg,2023-07-16,08:00:00,2,2,0,FMN 08 Schijnpoortweg
675,Schijnpoortweg,2023-07-16,09:00:00,0,0,0,FMN 08 Schijnpoortweg
675,Schijnpoortweg,2023-07-16,10:00:00,2,1,1,FMN 08 Schijnpoortweg
675,Schijnpoortweg,2023-07-16,11:00:00,1,1,0,FMN 08 Schijnpoortweg
675,Schijnpoortweg,2023-07-16,12:00:00,0,0,0,FMN 08 Schijnpoortweg
675,Schijnpoortweg,2023-07-16,13:00:00,2,1,1,FMN 08 Schijnpoortweg
675,Schijnpoortweg,2023-07-16,14:00:00,1,0,1,FMN 08 Schijnpoortweg
675,Schijnpoortweg,2023-07-16,15:00:00,1,0,1,FMN 08 Schijnpoortweg
675,Schijnpoortweg,2023-07-16,16:00:00,5,3,2,FMN 08 Schijnpoortweg
675,Schijnpoortweg,2023-07-16,17:00:00,1,0,1,FMN 08 Schijnpoortweg
675,Schijnpoortweg,2023-07-16,18:00:00,5,3,2,FMN 08 Schijnpoortweg
675,Schijnpoortweg,2023-07-16,19:00:00,5,1,4,FMN 08 Schijnpoortweg
675,Schijnpoortweg,2023-07-16,20:00:00,1,0,1,FMN 08 Schijnpoortweg
675,Schijnpoortweg,2023-07-16,21:00:00,1,1,0,FMN 08 Schijnpoortweg
675,Schijnpoortweg,2023-07-16,22:00:00,6,3,3,FMN 08 Schijnpoortweg
675,Schijnpoortweg,2023-07-16,23:00:00,1,1,0,FMN 08 Schijnpoortweg
675,Schijnpoortweg,2023-07-17,00:00:00,1,0,1,FMN 08 Schijnpoortweg
675,Schijnpoortweg,2023-07-17,01:00:00,1,0,1,FMN 08 Schijnpoortweg
675,Schijnpoortweg,2023-07-17,02:00:00,1,1,0,FMN 08 Schijnpoortweg
675,Schijnpoortweg,2023-07-17,03:00:00,0,0,0,FMN 08 Schijnpoortweg
675,Schijnpoortweg,2023-07-17,04:00:00,1,0,1,FMN 08 Schijnpoortweg
675,Schijnpoortweg,2023-07-17,05:00:00,2,0,2,FMN 08 Schijnpoortweg
675,Schijnpoortweg,2023-07-17,06:00:00,2,1,1,FMN 08 Schijnpoortweg
675,Schijnpoortweg,2023-07-17,07:00:00,0,0,0,FMN 08 Schijnpoortweg
675,Schijnpoortweg,2023-07-17,08:00:00,0,0,0,FMN 08 Schijnpoortweg
675,Schijnpoortweg,2023-07-17,09:00:00,1,1,0,FMN 08 Schijnpoortweg
675,Schijnpoortweg,2023-07-17,10:00:00,2,1,1,FMN 08 Schijnpoortweg
675,Schijnpoortweg,2023-07-17,11:00:00,0,0,0,FMN 08 Schijnpoortweg
675,Schijnpoortweg,2023-07-17,12:00:00,1,1,0,FMN 08 Schijnpoortweg
675,Schijnpoortweg,2023-07-17,13:00:00,1,0,1,FMN 08 Schijnpoortweg
675,Schijnpoortweg,2023-07-17,14:00:00,2,2,0,FMN 08 Schijnpoortweg
675,Schijnpoortweg,2023-07-17,15:00:00,1,1,0,FMN 08 Schijnpoortweg
675,Schijnpoortweg,2023-07-17,16:00:00,5,1,4,FMN 08 Schijnpoortweg
675,Schijnpoortweg,2023-07-17,17:00:00,3,1,2,FMN 08 Schijnpoortweg
675,Schijnpoortweg,2023-07-17,18:00:00,4,2,2,FMN 08 Schijnpoortweg
675,Schijnpoortweg,2023-07-17,19:00:00,0,0,0,FMN 08 Schijnpoortweg
675,Schijnpoortweg,2023-07-17,20:00:00,4,3,1,FMN 08 Schijnpoortweg
675,Schijnpoortweg,2023-07-17,21:00:00,5,1,4,FMN 08 Schijnpoortweg
675,Schijnpoortweg,2023-07-17,22:00:00,2,1,1,FMN 08 Schijnpoortweg
675,Schijnpoortweg,2023-07-17,23:00:00,0,0,0,FMN 08 Schijnpoortweg
675,Schijnpoortweg,2023-07-18,00:00:00,0,0,0,FMN 08 Schijnpoortweg
675,Schijnpoortweg,2023-07-18,01:00:00,3,0,3,FMN 08 Schijnpoortweg
675,Schijnpoortweg,2023-07-18,02:00:00,1,0,1,FMN 08 Schijnpoortweg
675,Schijnpoortweg,2023-07-18,03:00:00,0,0,0,FMN 08 Schijnpoortweg
675,Schijnpoortweg,2023-07-18,04:00:00,1,1,0,FMN 08 Schijnpoortweg
675,Schijnpoortweg,2023-07-18,05:00:00,3,0,3,FMN 08 Schijnpoortweg
675,Schijnpoortweg,2023-07-18,06:00:00,1,1,0,FMN 08 Schijnpoortweg
675,Schijnpoortweg,2023-07-18,07:00:00,0,0,0,FMN 08 Schijnpoortweg
675,Schijnpoortweg,2023-07-18,08:00:00,0,0,0,FMN 08 Schijnpoortweg
675,Schijnpoortweg,2023-07-18,09:00:00,2,1,1,FMN 08 Schijnpoortweg
675,Schijnpoortweg,2023-07-18,10:00:00,0,0,0,FMN 08 Schijnpoortweg
675,Schijnpoortweg,2023-07-18,11:00:00,0,0,0,FMN 08 Schijnpoortweg
675,Schijnpoortweg,2023-07-18,12:00:00,1,0,1,FMN 08 Schijnpoortweg
675,Schijnpoortweg,2023-07-18,13:00:00,1,0,1,FMN 08 Schijnpoortweg
675,Schijnpoortweg,2023-07-18,14:00:00,3,1,2,FMN 08 Schijnpoortweg
675,Schijnpoortweg,2023-07-18,15:00:00,1,0,1,FMN 08 Schijnpoortweg
675,Schijnpoortweg,2023-07-18,16:00:00,2,1,1,FMN 08 Schijnpoortweg
675,Schijnpoortweg,2023-07-18,17:00:00,0,0,0,FMN 08 Schijnpoortweg
675,Schijnpoortweg,2023-07-18,18:00:00,5,0,5,FMN 08 Schijnpoortweg
675,Schijnpoortweg,2023-07-18,19:00:00,3,1,2,FMN 08 Schijnpoortweg
675,Schijnpoortweg,2023-07-18,20:00:00,0,0,0,FMN 08 Schijnpoortweg
675,Schijnpoortweg,2023-07-18,21:00:00,2,0,2,FMN 08 Schijnpoortweg
675,Schijnpoortweg,2023-07-18,22:00:00,2,1,1,FMN 08 Schijnpoortweg
675,Schijnpoortweg,2023-07-18,23:00:00,3,1,2,FMN 08 Schijnpoortweg
675,Schijnpoortweg,2023-07-19,00:00:00,2,1,1,FMN 08 Schijnpoortweg
675,Schijnpoortweg,2023-07-19,01:00:00,1,0,1,FMN 08 Schijnpoortweg
675,Schijnpoortweg,2023-07-19,02:00:00,0,0,0,FMN 08 Schijnpoortweg
675,Schijnpoortweg,2023-07-19,03:00:00,0,0,0,FMN 08 Schijnpoortweg
675,Schijnpoortweg,2023-07-19,04:00:00,3,1,2,FMN 08 Schijnpoortweg
675,Schijnpoortweg,2023-07-19,05:00:00,2,0,2,FMN 08 Schijnpoortweg
675,Schijnpoortweg,2023-07-19,06:00:00,1,0,1,FMN 08 Schijnpoortweg
675,Schijnpoortweg,2023-07-19,07:00:00,0,0,0,FMN 08 Schijnpoortweg
675,Schijnpoortweg,2023-07-19,08:00:00,0,0,0,FMN 08 Schijnpoortweg
675,Schijnpoortweg,2023-07-19,09:00:00,1,0,1,FMN 08 Schijnpoortweg
675,Schijnpoortweg,2023-07-19,10:00:00,1,1,0,FMN 08 Schijnpoortweg
675,Schijnpoortweg,2023-07-19,11:00:00,1,0,1,FMN 08 Schijnpoortweg
675,Schijnpoortweg,2023-07-19,12:00:00,2,1,1,FMN 08 Schijnpoortweg
675,Schijnpoortweg,2023-07-19,13:00:00,2,2,0,FMN 08 Schijnpoortweg
675,Schijnpoortweg,2023-07-19,14:00:00,1,0,1,FMN 08 Schijnpoortweg
675,Schijnpoortweg,2023-07-19,15:00:00,3,1,2,FMN 08 Schijnpoortweg
675,Schijnpoortweg,2023-07-19,16:00:00,4,1,3,FMN 08 Schijnpoortweg
675,Schijnpoortweg,2023-07-19,17:00:00,1,0,1,FMN 08 Schijnpoortweg
675,Schijnpoortweg,2023-07-19,18:00:00,4,0,4,FMN 08 Schijnpoortweg
675,Schijnpoortweg,2023-07-19,19:00:00,3,1,2,FMN 08 Schijnpoortweg
675,Schijnpoortweg,2023-07-19,20:00:00,1,0,1,FMN 08 Schijnpoortweg
675,Schijnpoortweg,2023-07-19,21:00:00,4,1,3,FMN 08 Schijnpoortweg
675,Schijnpoortweg,2023-07-19,22:00:00,3,2,1,FMN 08 Schijnpoortweg
675,Schijnpoortweg,2023-07-19,23:00:00,2,0,2,FMN 08 Schijnpoortweg
675,Schijnpoortweg,2023-07-20,00:00:00,0,0,0,FMN 08 Schijnpoortweg
675,Schijnpoortweg,2023-07-20,01:00:00,0,0,0,FMN 08 Schijnpoortweg
675,Schijnpoortweg,2023-07-20,02:00:00,0,0,0,FMN 08 Schijnpoortweg
675,Schijnpoortweg,2023-07-20,03:00:00,0,0,0,FMN 08 Schijnpoortweg
675,Schijnpoortweg,2023-07-20,04:00:00,2,1,1,FMN 08 Schijnpoortweg
675,Schijnpoortweg,2023-07-20,05:00:00,0,0,0,FMN 08 Schijnpoortweg
675,Schijnpoortweg,2023-07-20,06:00:00,2,0,2,FMN 08 Schijnpoortweg
675,Schijnpoortweg,2023-07-20,07:00:00,1,1,0,FMN 08 Schijnpoortweg
675,Schijnpoortweg,2023-07-20,08:00:00,0,0,0,FMN 08 Schijnpoortweg
675,Schijnpoortweg,2023-07-20,09:00:00,1,1,0,FMN 08 Schijnpoortweg
675,Schijnpoortweg,2023-07-20,10:00:00,1,1,0,FMN 08 Schijnpoortweg
675,Schijnpoortweg,2023-07-20,11:00:00,1,1,0,FMN 08 Schijnpoortweg
675,Schijnpoortweg,2023-07-20,12:00:00,1,1,0,FMN 08 Schijnpoortweg
675,Schijnpoortweg,2023-07-20,13:00:00,2,1,1,FMN 08 Schijnpoortweg
675,Schijnpoortweg,2023-07-20,14:00:00,2,0,2,FMN 08 Schijnpoortweg
675,Schijnpoortweg,2023-07-20,15:00:00,2,1,1,FMN 08 Schijnpoortweg
675,Schijnpoortweg,2023-07-20,16:00:00,2,1,1,FMN 08 Schijnpoortweg
675,Schijnpoortweg,2023-07-20,17:00:00,6,1,5,FMN 08 Schijnpoortweg
675,Schijnpoortweg,2023-07-20,18:00:00,5,0,5,FMN 08 Schijnpoortweg
675,Schijnpoortweg,2023-07-20,19:00:00,1,1,0,FMN 08 Schijnpoortweg
675,Schijnpoortweg,2023-07-20,20:00:00,0,0,0,FMN 08 Schijnpoortweg
675,Schijnpoortweg,2023-07-20,21:00:00,2,2,0,FMN 08 Schijnpoortweg
675,Schijnpoortweg,2023-07-20,22:00:00,5,2,3,FMN 08 Schijnpoortweg
675,Schijnpoortweg,2023-07-20,23:00:00,1,1,0,FMN 08 Schijnpoortweg
675,Schijnpoortweg,2023-07-21,00:00:00,0,0,0,FMN 08 Schijnpoortweg
675,Schijnpoortweg,2023-07-21,01:00:00,1,1,0,FMN 08 Schijnpoortweg
675,Schijnpoortweg,2023-07-21,02:00:00,2,1,1,FMN 08 Schijnpoortweg
675,Schijnpoortweg,2023-07-21,03:00:00,0,0,0,FMN 08 Schijnpoortweg
675,Schijnpoortweg,2023-07-21,04:00:00,0,0,0,FMN 08 Schijnpoortweg
675,Schijnpoortweg,2023-07-21,05:00:00,0,0,0,FMN 08 Schijnpoortweg
675,Schijnpoortweg,2023-07-21,06:00:00,2,2,0,FMN 08 Schijnpoortweg
675,Schijnpoortweg,2023-07-21,07:00:00,0,0,0,FMN 08 Schijnpoortweg
675,Schijnpoortweg,2023-07-21,08:00:00,1,0,1,FMN 08 Schijnpoortweg
675,Schijnpoortweg,2023-07-21,09:00:00,0,0,0,FMN 08 Schijnpoortweg
675,Schijnpoortweg,2023-07-21,10:00:00,0,0,0,FMN 08 Schijnpoortweg
675,Schijnpoortweg,2023-07-21,11:00:00,2,1,1,FMN 08 Schijnpoortweg
675,Schijnpoortweg,2023-07-21,12:00:00,1,1,0,FMN 08 Schijnpoortweg
675,Schijnpoortweg,2023-07-21,13:00:00,0,0,0,FMN 08 Schijnpoortweg
675,Schijnpoortweg,2023-07-21,14:00:00,2,2,0,FMN 08 Schijnpoortweg
675,Schijnpoortweg,2023-07-21,15:00:00,2,1,1,FMN 08 Schijnpoortweg
675,Schijnpoortweg,2023-07-21,16:00:00,3,2,1,FMN 08 Schijnpoortweg
675,Schijnpoortweg,2023-07-21,17:00:00,1,0,1,FMN 08 Schijnpoortweg
675,Schijnpoortweg,2023-07-21,18:00:00,3,0,3,FMN 08 Schijnpoortweg
675,Schijnpoortweg,2023-07-21,19:00:00,4,1,3,FMN 08 Schijnpoortweg
675,Schijnpoortweg,2023-07-21,20:00:00,1,1,0,FMN 08 Schijnpoortweg
675,Schijnpoortweg,2023-07-21,21:00:00,2,1,1,FMN 08 Schijnpoortweg
675,Schijnpoortweg,2023-07-21,22:00:00,4,1,3,FMN 08 Schijnpoortweg
675,Schijnpoortweg,2023-07-21,23:00:00,0,0,0,FMN 08 Schijnpoortweg
675,Schijnpoortweg,2023-07-22,00:00:00,1,1,0,FMN 08 Schijnpoortweg
675,Schijnpoortweg,2023-07-22,01:00:00,0,0,0,FMN 08 Schijnpoortweg
675,Schijnpoortweg,2023-07-22,02:00:00,1,0,1,FMN 08 Schijnpoortweg
675,Schijnpoortweg,2023-07-22,03:00:00,0,0,0,FMN 08 Schijnpoortweg
675,Schijnpoortweg,2023-07-22,04:00:00,2,1,1,FMN 08 Schijnpoortweg
675,Schijnpoortweg,2023-07-22,05:00:00,0,0,0,FMN 08 Schijnpoortweg
675,Schijnpoortweg,2023-07-22,06:00:00,3,2,1,FMN 08 Schijnpoortweg
675,Schijnpoortweg,2023-07-22,07:00:00,1,0,1,FMN 08 Schijnpoortweg
675,Schijnpoortweg,2023-07-22,08:00:00,1,1,0,FMN 08 Schijnpoortweg
675,Schijnpoortweg,2023-07-22,09:00:00,1,0,1,FMN 08 Schijnpoortweg
675,Schijnpoortweg,2023-07-22,10:00:00,2,1,1,FMN 08 Schijnpoortweg
675,Schijnpoortweg,2023-07-22,11:00:00,1,1,0,FMN 08 Schijnpoortweg
675,Schijnpoortweg,2023-07-22,12:00:00,2,2,0,FMN 08 Schijnpoortweg
675,Schijnpoortweg,2023-07-22,13:00:00,1,1,0,FMN 08 Schijnpoortweg
675,Schijnpoortweg,2023-07-22,14:00:00,1,1,0,FMN 08 Schijnpoortweg
675,Schijnpoortweg,2023-07-22,15:00:00,2,1,1,FMN 08 Schijnpoortweg
675,Schijnpoortweg,2023-07-22,16:00:00,3,2,1,FMN 08 Schijnpoortweg
675,Schijnpoortweg,2023-07-22,17:00:00,5,3,2,FMN 08 Schijnpoortweg
675,Schijnpoortweg,2023-07-22,18:00:00,4,0,4,FMN 08 Schijnpoortweg
675,Schijnpoortweg,2023-07-22,19:00:00,5,1,4,FMN 08 Schijnpoortweg
675,Schijnpoortweg,2023-07-22,20:00:00,0,0,0,FMN 08 Schijnpoortweg
675,Schijnpoortweg,2023-07-22,21:00:00,2,0,2,FMN 08 Schijnpoortweg
675,Schijnpoortweg,2023-07-22,22:00:00,2,2,0,FMN 08 Schijnpoortweg
675,Schijnpoortweg,2023-07-22,23:00:00,1,1,0,FMN 08 Schijnpoortweg
675,Schijnpoortweg,2023-07-23,00:00:00,3,0,3,FMN 08 Schijnpoortweg
675,Schijnpoortweg,2023-07-23,01:00:00,1,1,0,FMN 08 Schijnpoortweg
675,Schijnpoortweg,2023-07-23,02:00:00,1,0,1,FMN 08 Schijnpoortweg
675,Schijnpoortweg,2023-07-23,03:00:00,0,0,0,FMN 08 Schijnpoortweg
675,Schijnpoortweg,2023-07-23,04:00:00,0,0,0,FMN 08 Schijnpoortweg
675,Schijnpoortweg,2023-07-23,05:00:00,1,1,0,FMN 08 Schijnpoortweg
675,Schijnpoortweg,2023-07-23,06:00:00,1,1,0,FMN 08 Schijnpoortweg
675,Schijnpoortweg,2023-07-23,07:00:00,1,0,1,FMN 08 Schijnpoortweg
675,Schijnpoortweg,2023-07-23,08:00:00,1,1,0,FMN 08 Schijnpoortweg
675,Schijnpoortweg,2023-07-23,09:00:00,1,0,1,FMN 08 Schijnpoortweg
675,Schijnpoortweg,2023-07-23,10:00:00,1,1,0,FMN 08 Schijnpoortweg
675,Schijnpoortweg,2023-07-23,11:00:00,0,0,0,FMN 08 Schijnpoortweg
675,Schijnpoortweg,2023-07-23,12:00:00,1,0,1,FMN 08 Schijnpoortweg
675,Schijnpoortweg,2023-07-23,13:00:00,0,0,0,FMN 08 Schijnpoortweg
675,Schijnpoortweg,2023-07-23,14:00:00,2,1,1,FMN 08 Schijnpoortweg
675,Schijnpoortweg,2023-07-23,15:00:00,3,2,1,FMN 08 Schijnpoortweg
675,Schijnpoortweg,2023-07-23,16:00:00,4,1,3,FMN 08 Schijnpoortweg
675,Schijnpoortweg,2023-07-23,17:00:00,0,0,0,FMN 08 Schijnpoortweg
675,Schijnpoortweg,2023-07-23,18:00:00,1,0,1,FMN 08 Schijnpoortweg
675,Schijnpoortweg,2023-07-23,19:00:00,0,0,0,FMN 08 Schijnpoortweg
675,Schijnpoortweg,2023-07-23,20:00:00,1,0,1,FMN 08 Schijnpoortweg
675,Schijnpoortweg,2023-07-23,21:00:00,1,0,1,FMN 08 Schijnpoortweg
675,Schijnpoortweg,2023-07-23,22:00:00,1,0,1,FMN 08 Schijnpoortweg
675,Schijnpoortweg,2023-07-23,23:00:00,0,0,0,FMN 08 Schijnpoortweg
675,Schijnpoortweg,2023-07-24,00:00:00,1,1,0,FMN 08 Schijnpoortweg
675,Schijnpoortweg,2023-07-24,01:00:00,0,0,0,FMN 08 Schijnpoortweg
675,Schijnpoortweg,2023-07-24,02:00:00,0,0,0,FMN 08 Schijnpoortweg
675,Schijnpoortweg,2023-07-24,03:00:00,0,0,0,FMN 08 Schijnpoortweg
675,Schijnpoortweg,2023-07-24,04:00:00,1,0,1,FMN 08 Schijnpoortweg
675,Schijnpoortweg,2023-07-24,05:00:00,0,0,0,FMN 08 Schijnpoortweg
675,Schijnpoortweg,2023-07-24,06:00:00,2,1,1,FMN 08 Schijnpoortweg
675,Schijnpoortweg,2023-07-24,07:00:00,0,0,0,FMN 08 Schijnpoortweg
675,Schijnpoortweg,2023-07-24,08:00:00,0,0,0,FMN 08 Schijnpoortweg
675,Schijnpoortweg,2023-07-24,09:00:00,3,1,2,FMN 08 Schijnpoortweg
675,Schijnpoortweg,2023-07-24,10:00:00,0,0,0,FMN 08 Schijnpoortweg
675,Schijnpoortweg,2023-07-24,11:00:00,3,1,2,FMN 08 Schijnpoortweg
675,Schijnpoortweg,2023-07-24,12:00:00,2,1,1,FMN 08 Schijnpoortweg
675,Schijnpoortweg,2023-07-24,13:00:00,4,3,1,FMN 08 Schijnpoortweg
675,Schijnpoortweg,2023-07-24,14:00:00,3,0,3,FMN 08 Schijnpoortweg
675,Schijnpoortweg,2023-07-24,15:00:00,2,1,1,FMN 08 Schijnpoortweg
675,Schijnpoortweg,2023-07-24,16:00:00,0,0,0,FMN 08 Schijnpoortweg
675,Schijnpoortweg,2023-07-24,17:00:00,2,1,1,FMN 08 Schijnpoortweg
675,Schijnpoortweg,2023-07-24,18:00:00,2,1,1,FMN 08 Schijnpoortweg
675,Schijnpoortweg,2023-07-24,19:00:00,1,0,1,FMN 08 Schijnpoortweg
675,Schijnpoortweg,2023-07-24,20:00:00,4,1,3,FMN 08 Schijnpoortweg
675,Schijnpoortweg,2023-07-24,21:00:00,1,0,1,FMN 08 Schijnpoortweg
675,Schijnpoortweg,2023-07-24,22:00:00,3,1,2,FMN 08 Schijnpoortweg
675,Schijnpoortweg,2023-07-24,23:00:00,1,0,1,FMN 08 Schijnpoortweg
675,Schijnpoortweg,2023-07-25,00:00:00,1,0,1,FMN 08 Schijnpoortweg
675,Schijnpoortweg,2023-07-25,01:00:00,2,1,1,FMN 08 Schijnpoortweg
675,Schijnpoortweg,2023-07-25,02:00:00,0,0,0,FMN 08 Schijnpoortweg
675,Schijnpoortweg,2023-07-25,03:00:00,0,0,0,FMN 08 Schijnpoortweg
675,Schijnpoortweg,2023-07-25,04:00:00,3,1,2,FMN 08 Schijnpoortweg
675,Schijnpoortweg,2023-07-25,05:00:00,4,0,4,FMN 08 Schijnpoortweg
675,Schijnpoortweg,2023-07-25,06:00:00,1,1,0,FMN 08 Schijnpoortweg
675,Schijnpoortweg,2023-07-25,07:00:00,0,0,0,FMN 08 Schijnpoortweg
675,Schijnpoortweg,2023-07-25,08:00:00,2,2,0,FMN 08 Schijnpoortweg
675,Schijnpoortweg,2023-07-25,09:00:00,1,1,0,FMN 08 Schijnpoortweg
675,Schijnpoortweg,2023-07-25,10:00:00,2,1,1,FMN 08 Schijnpoortweg
675,Schijnpoortweg,2023-07-25,11:00:00,1,0,1,FMN 08 Schijnpoortweg
675,Schijnpoortweg,2023-07-25,12:00:00,1,1,0,FMN 08 Schijnpoortweg
675,Schijnpoortweg,2023-07-25,13:00:00,3,0,3,FMN 08 Schijnpoortweg
675,Schijnpoortweg,2023-07-25,14:00:00,4,1,3,FMN 08 Schijnpoortweg
675,Schijnpoortweg,2023-07-25,15:00:00,3,1,2,FMN 08 Schijnpoortweg
675,Schijnpoortweg,2023-07-25,16:00:00,2,0,2,FMN 08 Schijnpoortweg
675,Schijnpoortweg,2023-07-25,17:00:00,4,1,3,FMN 08 Schijnpoortweg
675,Schijnpoortweg,2023-07-25,18:00:00,5,2,3,FMN 08 Schijnpoortweg
675,Schijnpoortweg,2023-07-25,19:00:00,6,0,6,FMN 08 Schijnpoortweg
675,Schijnpoortweg,2023-07-25,20:00:00,4,3,1,FMN 08 Schijnpoortweg
675,Schijnpoortweg,2023-07-25,21:00:00,3,1,2,FMN 08 Schijnpoortweg
675,Schijnpoortweg,2023-07-25,22:00:00,4,1,3,FMN 08 Schijnpoortweg
675,Schijnpoortweg,2023-07-25,23:00:00,1,1,0,FMN 08 Schijnpoortweg
675,Schijnpoortweg,2023-07-26,00:00:00,0,0,0,FMN 08 Schijnpoortweg
675,Schijnpoortweg,2023-07-26,01:00:00,1,0,1,FMN 08 Schijnpoortweg
675,Schijnpoortweg,2023-07-26,02:00:00,1,0,1,FMN 08 Schijnpoortweg
675,Schijnpoortweg,2023-07-26,03:00:00,2,2,0,FMN 08 Schijnpoortweg
675,Schijnpoortweg,2023-07-26,04:00:00,2,1,1,FMN 08 Schijnpoortweg
675,Schijnpoortweg,2023-07-26,05:00:00,0,0,0,FMN 08 Schijnpoortweg
675,Schijnpoortweg,2023-07-26,06:00:00,4,2,2,FMN 08 Schijnpoortweg
675,Schijnpoortweg,2023-07-26,07:00:00,1,0,1,FMN 08 Schijnpoortweg
675,Schijnpoortweg,2023-07-26,08:00:00,0,0,0,FMN 08 Schijnpoortweg
675,Schijnpoortweg,2023-07-26,09:00:00,0,0,0,FMN 08 Schijnpoortweg
675,Schijnpoortweg,2023-07-26,10:00:00,0,0,0,FMN 08 Schijnpoortweg
675,Schijnpoortweg,2023-07-26,11:00:00,0,0,0,FMN 08 Schijnpoortweg
675,Schijnpoortweg,2023-07-26,12:00:00,1,0,1,FMN 08 Schijnpoortweg
675,Schijnpoortweg,2023-07-26,13:00:00,4,3,1,FMN 08 Schijnpoortweg
675,Schijnpoortweg,2023-07-26,14:00:00,4,1,3,FMN 08 Schijnpoortweg
675,Schijnpoortweg,2023-07-26,15:00:00,2,2,0,FMN 08 Schijnpoortweg
675,Schijnpoortweg,2023-07-26,16:00:00,2,2,0,FMN 08 Schijnpoortweg
675,Schijnpoortweg,2023-07-26,17:00:00,1,0,1,FMN 08 Schijnpoortweg
675,Schijnpoortweg,2023-07-26,18:00:00,4,2,2,FMN 08 Schijnpoortweg
675,Schijnpoortweg,2023-07-26,19:00:00,5,2,3,FMN 08 Schijnpoortweg
675,Schijnpoortweg,2023-07-26,20:00:00,1,1,0,FMN 08 Schijnpoortweg
675,Schijnpoortweg,2023-07-26,21:00:00,2,1,1,FMN 08 Schijnpoortweg
675,Schijnpoortweg,2023-07-26,22:00:00,3,1,2,FMN 08 Schijnpoortweg
675,Schijnpoortweg,2023-07-26,23:00:00,0,0,0,FMN 08 Schijnpoortweg
675,Schijnpoortweg,2023-07-27,00:00:00,0,0,0,FMN 08 Schijnpoortweg
675,Schijnpoortweg,2023-07-27,01:00:00,1,0,1,FMN 08 Schijnpoortweg
675,Schijnpoortweg,2023-07-27,02:00:00,1,1,0,FMN 08 Schijnpoortweg
675,Schijnpoortweg,2023-07-27,03:00:00,0,0,0,FMN 08 Schijnpoortweg
675,Schijnpoortweg,2023-07-27,04:00:00,1,1,0,FMN 08 Schijnpoortweg
675,Schijnpoortweg,2023-07-27,05:00:00,0,0,0,FMN 08 Schijnpoortweg
675,Schijnpoortweg,2023-07-27,06:00:00,1,0,1,FMN 08 Schijnpoortweg
675,Schijnpoortweg,2023-07-27,07:00:00,0,0,0,FMN 08 Schijnpoortweg
675,Schijnpoortweg,2023-07-27,08:00:00,1,1,0,FMN 08 Schijnpoortweg
675,Schijnpoortweg,2023-07-27,09:00:00,0,0,0,FMN 08 Schijnpoortweg
675,Schijnpoortweg,2023-07-27,10:00:00,0,0,0,FMN 08 Schijnpoortweg
675,Schijnpoortweg,2023-07-27,11:00:00,0,0,0,FMN 08 Schijnpoortweg
675,Schijnpoortweg,2023-07-27,12:00:00,1,0,1,FMN 08 Schijnpoortweg
675,Schijnpoortweg,2023-07-27,13:00:00,1,0,1,FMN 08 Schijnpoortweg
675,Schijnpoortweg,2023-07-27,14:00:00,0,0,0,FMN 08 Schijnpoortweg
675,Schijnpoortweg,2023-07-27,15:00:00,0,0,0,FMN 08 Schijnpoortweg
675,Schijnpoortweg,2023-07-27,16:00:00,1,1,0,FMN 08 Schijnpoortweg
675,Schijnpoortweg,2023-07-27,17:00:00,0,0,0,FMN 08 Schijnpoortweg
675,Schijnpoortweg,2023-07-27,18:00:00,3,0,3,FMN 08 Schijnpoortweg
675,Schijnpoortweg,2023-07-27,19:00:00,5,4,1,FMN 08 Schijnpoortweg
675,Schijnpoortweg,2023-07-27,20:00:00,3,1,2,FMN 08 Schijnpoortweg
675,Schijnpoortweg,2023-07-27,21:00:00,2,1,1,FMN 08 Schijnpoortweg
675,Schijnpoortweg,2023-07-27,22:00:00,1,0,1,FMN 08 Schijnpoortweg
675,Schijnpoortweg,2023-07-27,23:00:00,0,0,0,FMN 08 Schijnpoortweg
675,Schijnpoortweg,2023-07-28,00:00:00,0,0,0,FMN 08 Schijnpoortweg
675,Schijnpoortweg,2023-07-28,01:00:00,0,0,0,FMN 08 Schijnpoortweg
675,Schijnpoortweg,2023-07-28,02:00:00,1,1,0,FMN 08 Schijnpoortweg
675,Schijnpoortweg,2023-07-28,03:00:00,0,0,0,FMN 08 Schijnpoortweg
675,Schijnpoortweg,2023-07-28,04:00:00,2,2,0,FMN 08 Schijnpoortweg
675,Schijnpoortweg,2023-07-28,05:00:00,1,0,1,FMN 08 Schijnpoortweg
675,Schijnpoortweg,2023-07-28,06:00:00,3,1,2,FMN 08 Schijnpoortweg
675,Schijnpoortweg,2023-07-28,07:00:00,0,0,0,FMN 08 Schijnpoortweg
675,Schijnpoortweg,2023-07-28,08:00:00,1,1,0,FMN 08 Schijnpoortweg
675,Schijnpoortweg,2023-07-28,09:00:00,1,1,0,FMN 08 Schijnpoortweg
675,Schijnpoortweg,2023-07-28,10:00:00,2,0,2,FMN 08 Schijnpoortweg
675,Schijnpoortweg,2023-07-28,11:00:00,2,1,1,FMN 08 Schijnpoortweg
675,Schijnpoortweg,2023-07-28,12:00:00,1,0,1,FMN 08 Schijnpoortweg
675,Schijnpoortweg,2023-07-28,13:00:00,4,2,2,FMN 08 Schijnpoortweg
675,Schijnpoortweg,2023-07-28,14:00:00,4,3,1,FMN 08 Schijnpoortweg
675,Schijnpoortweg,2023-07-28,15:00:00,3,0,3,FMN 08 Schijnpoortweg
675,Schijnpoortweg,2023-07-28,16:00:00,9,3,6,FMN 08 Schijnpoortweg
675,Schijnpoortweg,2023-07-28,17:00:00,4,3,1,FMN 08 Schijnpoortweg
675,Schijnpoortweg,2023-07-28,18:00:00,3,1,2,FMN 08 Schijnpoortweg
675,Schijnpoortweg,2023-07-28,19:00:00,4,1,3,FMN 08 Schijnpoortweg
675,Schijnpoortweg,2023-07-28,20:00:00,4,3,1,FMN 08 Schijnpoortweg
675,Schijnpoortweg,2023-07-28,21:00:00,2,0,2,FMN 08 Schijnpoortweg
675,Schijnpoortweg,2023-07-28,22:00:00,3,2,1,FMN 08 Schijnpoortweg
675,Schijnpoortweg,2023-07-28,23:00:00,2,1,1,FMN 08 Schijnpoortweg
675,Schijnpoortweg,2023-07-29,00:00:00,2,1,1,FMN 08 Schijnpoortweg
675,Schijnpoortweg,2023-07-29,01:00:00,0,0,0,FMN 08 Schijnpoortweg
675,Schijnpoortweg,2023-07-29,02:00:00,1,1,0,FMN 08 Schijnpoortweg
675,Schijnpoortweg,2023-07-29,03:00:00,2,0,2,FMN 08 Schijnpoortweg
675,Schijnpoortweg,2023-07-29,04:00:00,1,0,1,FMN 08 Schijnpoortweg
675,Schijnpoortweg,2023-07-29,05:00:00,2,2,0,FMN 08 Schijnpoortweg
675,Schijnpoortweg,2023-07-29,06:00:00,1,0,1,FMN 08 Schijnpoortweg
675,Schijnpoortweg,2023-07-29,07:00:00,1,1,0,FMN 08 Schijnpoortweg
675,Schijnpoortweg,2023-07-29,08:00:00,1,0,1,FMN 08 Schijnpoortweg
675,Schijnpoortweg,2023-07-29,09:00:00,0,0,0,FMN 08 Schijnpoortweg
675,Schijnpoortweg,2023-07-29,10:00:00,2,1,1,FMN 08 Schijnpoortweg
675,Schijnpoortweg,2023-07-29,11:00:00,3,0,3,FMN 08 Schijnpoortweg
675,Schijnpoortweg,2023-07-29,12:00:00,0,0,0,FMN 08 Schijnpoortweg
675,Schijnpoortweg,2023-07-29,13:00:00,1,0,1,FMN 08 Schijnpoortweg
675,Schijnpoortweg,2023-07-29,14:00:00,0,0,0,FMN 08 Schijnpoortweg
675,Schijnpoortweg,2023-07-29,15:00:00,1,1,0,FMN 08 Schijnpoortweg
675,Schijnpoortweg,2023-07-29,16:00:00,3,1,2,FMN 08 Schijnpoortweg
675,Schijnpoortweg,2023-07-29,17:00:00,3,1,2,FMN 08 Schijnpoortweg
675,Schijnpoortweg,2023-07-29,18:00:00,6,2,4,FMN 08 Schijnpoortweg
675,Schijnpoortweg,2023-07-29,19:00:00,3,1,2,FMN 08 Schijnpoortweg
675,Schijnpoortweg,2023-07-29,20:00:00,1,0,1,FMN 08 Schijnpoortweg
675,Schijnpoortweg,2023-07-29,21:00:00,6,2,4,FMN 08 Schijnpoortweg
675,Schijnpoortweg,2023-07-29,22:00:00,2,0,2,FMN 08 Schijnpoortweg
675,Schijnpoortweg,2023-07-29,23:00:00,2,1,1,FMN 08 Schijnpoortweg
675,Schijnpoortweg,2023-07-30,00:00:00,2,2,0,FMN 08 Schijnpoortweg
675,Schijnpoortweg,2023-07-30,01:00:00,1,0,1,FMN 08 Schijnpoortweg
675,Schijnpoortweg,2023-07-30,02:00:00,1,1,0,FMN 08 Schijnpoortweg
675,Schijnpoortweg,2023-07-30,03:00:00,0,0,0,FMN 08 Schijnpoortweg
675,Schijnpoortweg,2023-07-30,04:00:00,1,1,0,FMN 08 Schijnpoortweg
675,Schijnpoortweg,2023-07-30,05:00:00,0,0,0,FMN 08 Schijnpoortweg
675,Schijnpoortweg,2023-07-30,06:00:00,2,1,1,FMN 08 Schijnpoortweg
675,Schijnpoortweg,2023-07-30,07:00:00,0,0,0,FMN 08 Schijnpoortweg
675,Schijnpoortweg,2023-07-30,08:00:00,1,1,0,FMN 08 Schijnpoortweg
675,Schijnpoortweg,2023-07-30,09:00:00,1,0,1,FMN 08 Schijnpoortweg
675,Schijnpoortweg,2023-07-30,10:00:00,2,1,1,FMN 08 Schijnpoortweg
675,Schijnpoortweg,2023-07-30,11:00:00,2,1,1,FMN 08 Schijnpoortweg
675,Schijnpoortweg,2023-07-30,12:00:00,1,1,0,FMN 08 Schijnpoortweg
675,Schijnpoortweg,2023-07-30,13:00:00,4,1,3,FMN 08 Schijnpoortweg
675,Schijnpoortweg,2023-07-30,14:00:00,4,3,1,FMN 08 Schijnpoortweg
675,Schijnpoortweg,2023-07-30,15:00:00,2,0,2,FMN 08 Schijnpoortweg
675,Schijnpoortweg,2023-07-30,16:00:00,2,0,2,FMN 08 Schijnpoortweg
675,Schijnpoortweg,2023-07-30,17:00:00,6,3,3,FMN 08 Schijnpoortweg
675,Schijnpoortweg,2023-07-30,18:00:00,3,1,2,FMN 08 Schijnpoortweg
675,Schijnpoortweg,2023-07-30,19:00:00,2,2,0,FMN 08 Schijnpoortweg
675,Schijnpoortweg,2023-07-30,20:00:00,1,0,1,FMN 08 Schijnpoortweg
675,Schijnpoortweg,2023-07-30,21:00:00,1,0,1,FMN 08 Schijnpoortweg
675,Schijnpoortweg,2023-07-30,22:00:00,2,2,0,FMN 08 Schijnpoortweg
675,Schijnpoortweg,2023-07-30,23:00:00,0,0,0,FMN 08 Schijnpoortweg
675,Schijnpoortweg,2023-07-31,00:00:00,1,1,0,FMN 08 Schijnpoortweg
675,Schijnpoortweg,2023-07-31,01:00:00,1,0,1,FMN 08 Schijnpoortweg
675,Schijnpoortweg,2023-07-31,02:00:00,0,0,0,FMN 08 Schijnpoortweg
675,Schijnpoortweg,2023-07-31,03:00:00,2,1,1,FMN 08 Schijnpoortweg
675,Schijnpoortweg,2023-07-31,04:00:00,0,0,0,FMN 08 Schijnpoortweg
675,Schijnpoortweg,2023-07-31,05:00:00,1,0,1,FMN 08 Schijnpoortweg
675,Schijnpoortweg,2023-07-31,06:00:00,0,0,0,FMN 08 Schijnpoortweg
675,Schijnpoortweg,2023-07-31,07:00:00,0,0,0,FMN 08 Schijnpoortweg
675,Schijnpoortweg,2023-07-31,08:00:00,2,2,0,FMN 08 Schijnpoortweg
675,Schijnpoortweg,2023-07-31,09:00:00,1,0,1,FMN 08 Schijnpoortweg
675,Schijnpoortweg,2023-07-31,10:00:00,4,3,1,FMN 08 Schijnpoortweg
675,Schijnpoortweg,2023-07-31,11:00:00,0,0,0,FMN 08 Schijnpoortweg
675,Schijnpoortweg,2023-07-31,12:00:00,1,0,1,FMN 08 Schijnpoortweg
675,Schijnpoortweg,2023-07-31,13:00:00,2,0,2,FMN 08 Schijnpoortweg
675,Schijnpoortweg,2023-07-31,14:00:00,2,1,1,FMN 08 Schijnpoortweg
675,Schijnpoortweg,2023-07-31,15:00:00,1,1,0,FMN 08 Schijnpoortweg
675,Schijnpoortweg,2023-07-31,16:00:00,1,0,1,FMN 08 Schijnpoortweg
675,Schijnpoortweg,2023-07-31,17:00:00,2,1,1,FMN 08 Schijnpoortweg
675,Schijnpoortweg,2023-07-31,18:00:00,1,1,0,FMN 08 Schijnpoortweg
675,Schijnpoortweg,2023-07-31,19:00:00,0,0,0,FMN 08 Schijnpoortweg
675,Schijnpoortweg,2023-07-31,20:00:00,1,1,0,FMN 08 Schijnpoortweg
675,Schijnpoortweg,2023-07-31,21:00:00,1,0,1,FMN 08 Schijnpoortweg
675,Schijnpoortweg,2023-07-31,22:00:00,0,0,0,FMN 08 Schijnpoortweg
675,Schijnpoortweg,2023-07-31,23:00:00,0,0,0,FMN 08 Schijnpoortweg
675,Schijnpoortweg,2023-08-01,00:00:00,0,0,0,FMN 08 Schijnpoortweg
675,Schijnpoortweg,2023-08-01,01:00:00,0,0,0,FMN 08 Schijnpoortweg
675,Schijnpoortweg,2023-08-01,02:00:00,0,0,0,FMN 08 Schijnpoortweg
675,Schijnpoortweg,2023-08-01,03:00:00,0,0,0,FMN 08 Schijnpoortweg
675,Schijnpoortweg,2023-08-01,04:00:00,0,0,0,FMN 08 Schijnpoortweg
675,Schijnpoortweg,2023-08-01,05:00:00,1,0,1,FMN 08 Schijnpoortweg
675,Schijnpoortweg,2023-08-01,06:00:00,2,1,1,FMN 08 Schijnpoortweg
675,Schijnpoortweg,2023-08-01,07:00:00,0,0,0,FMN 08 Schijnpoortweg
675,Schijnpoortweg,2023-08-01,08:00:00,1,1,0,FMN 08 Schijnpoortweg
675,Schijnpoortweg,2023-08-01,09:00:00,0,0,0,FMN 08 Schijnpoortweg
675,Schijnpoortweg,2023-08-01,10:00:00,1,0,1,FMN 08 Schijnpoortweg
675,Schijnpoortweg,2023-08-01,11:00:00,1,0,1,FMN 08 Schijnpoortweg
675,Schijnpoortweg,2023-08-01,12:00:00,2,1,1,FMN 08 Schijnpoortweg
675,Schijnpoortweg,2023-08-01,13:00:00,2,1,1,FMN 08 Schijnpoortweg
675,Schijnpoortweg,2023-08-01,14:00:00,2,1,1,FMN 08 Schijnpoortweg
675,Schijnpoortweg,2023-08-01,15:00:00,2,1,1,FMN 08 Schijnpoortweg
675,Schijnpoortweg,2023-08-01,16:00:00,3,1,2,FMN 08 Schijnpoortweg
675,Schijnpoortweg,2023-08-01,17:00:00,2,1,1,FMN 08 Schijnpoortweg
675,Schijnpoortweg,2023-08-01,18:00:00,2,2,0,FMN 08 Schijnpoortweg
675,Schijnpoortweg,2023-08-01,19:00:00,3,1,2,FMN 08 Schijnpoortweg
675,Schijnpoortweg,2023-08-01,20:00:00,4,1,3,FMN 08 Schijnpoortweg
675,Schijnpoortweg,2023-08-01,21:00:00,2,1,1,FMN 08 Schijnpoortweg
675,Schijnpoortweg,2023-08-01,22:00:00,3,0,3,FMN 08 Schijnpoortweg
675,Schijnpoortweg,2023-08-01,23:00:00,0,0,0,FMN 08 Schijnpoortweg
675,Schijnpoortweg,2023-08-02,00:00:00,0,0,0,FMN 08 Schijnpoortweg
675,Schijnpoortweg,2023-08-02,01:00:00,3,1,2,FMN 08 Schijnpoortweg
675,Schijnpoortweg,2023-08-02,02:00:00,0,0,0,FMN 08 Schijnpoortweg
675,Schijnpoortweg,2023-08-02,03:00:00,2,0,2,FMN 08 Schijnpoortweg
675,Schijnpoortweg,2023-08-02,04:00:00,2,1,1,FMN 08 Schijnpoortweg
675,Schijnpoortweg,2023-08-02,05:00:00,1,1,0,FMN 08 Schijnpoortweg
675,Schijnpoortweg,2023-08-02,06:00:00,1,1,0,FMN 08 Schijnpoortweg
675,Schijnpoortweg,2023-08-02,07:00:00,0,0,0,FMN 08 Schijnpoortweg
675,Schijnpoortweg,2023-08-02,08:00:00,0,0,0,FMN 08 Schijnpoortweg
675,Schijnpoortweg,2023-08-02,09:00:00,1,1,0,FMN 08 Schijnpoortweg
675,Schijnpoortweg,2023-08-02,10:00:00,2,1,1,FMN 08 Schijnpoortweg
675,Schijnpoortweg,2023-08-02,11:00:00,1,0,1,FMN 08 Schijnpoortweg
675,Schijnpoortweg,2023-08-02,12:00:00,0,0,0,FMN 08 Schijnpoortweg
675,Schijnpoortweg,2023-08-02,13:00:00,1,1,0,FMN 08 Schijnpoortweg
675,Schijnpoortweg,2023-08-02,14:00:00,3,1,2,FMN 08 Schijnpoortweg
675,Schijnpoortweg,2023-08-02,15:00:00,4,2,2,FMN 08 Schijnpoortweg
675,Schijnpoortweg,2023-08-02,16:00:00,1,1,0,FMN 08 Schijnpoortweg
675,Schijnpoortweg,2023-08-02,17:00:00,3,0,3,FMN 08 Schijnpoortweg
675,Schijnpoortweg,2023-08-02,18:00:00,3,0,3,FMN 08 Schijnpoortweg
675,Schijnpoortweg,2023-08-02,19:00:00,2,0,2,FMN 08 Schijnpoortweg
675,Schijnpoortweg,2023-08-02,20:00:00,2,1,1,FMN 08 Schijnpoortweg
675,Schijnpoortweg,2023-08-02,21:00:00,1,0,1,FMN 08 Schijnpoortweg
675,Schijnpoortweg,2023-08-02,22:00:00,1,1,0,FMN 08 Schijnpoortweg
675,Schijnpoortweg,2023-08-02,23:00:00,1,0,1,FMN 08 Schijnpoortweg
675,Schijnpoortweg,2023-08-03,00:00:00,1,0,1,FMN 08 Schijnpoortweg
675,Schijnpoortweg,2023-08-03,01:00:00,0,0,0,FMN 08 Schijnpoortweg
675,Schijnpoortweg,2023-08-03,02:00:00,0,0,0,FMN 08 Schijnpoortweg
675,Schijnpoortweg,2023-08-03,03:00:00,0,0,0,FMN 08 Schijnpoortweg
675,Schijnpoortweg,2023-08-03,04:00:00,1,0,1,FMN 08 Schijnpoortweg
675,Schijnpoortweg,2023-08-03,05:00:00,1,0,1,FMN 08 Schijnpoortweg
675,Schijnpoortweg,2023-08-03,06:00:00,0,0,0,FMN 08 Schijnpoortweg
675,Schijnpoortweg,2023-08-03,07:00:00,1,0,1,FMN 08 Schijnpoortweg
675,Schijnpoortweg,2023-08-03,08:00:00,1,1,0,FMN 08 Schijnpoortweg
675,Schijnpoortweg,2023-08-03,09:00:00,2,0,2,FMN 08 Schijnpoortweg
675,Schijnpoortweg,2023-08-03,10:00:00,2,0,2,FMN 08 Schijnpoortweg
675,Schijnpoortweg,2023-08-03,11:00:00,0,0,0,FMN 08 Schijnpoortweg
675,Schijnpoortweg,2023-08-03,12:00:00,0,0,0,FMN 08 Schijnpoortweg
675,Schijnpoortweg,2023-08-03,13:00:00,1,1,0,FMN 08 Schijnpoortweg
675,Schijnpoortweg,2023-08-03,14:00:00,1,0,1,FMN 08 Schijnpoortweg
675,Schijnpoortweg,2023-08-03,15:00:00,4,1,3,FMN 08 Schijnpoortweg
675,Schijnpoortweg,2023-08-03,16:00:00,1,1,0,FMN 08 Schijnpoortweg
675,Schijnpoortweg,2023-08-03,17:00:00,1,0,1,FMN 08 Schijnpoortweg
675,Schijnpoortweg,2023-08-03,18:00:00,5,1,4,FMN 08 Schijnpoortweg
675,Schijnpoortweg,2023-08-03,19:00:00,6,1,5,FMN 08 Schijnpoortweg
675,Schijnpoortweg,2023-08-03,20:00:00,1,0,1,FMN 08 Schijnpoortweg
675,Schijnpoortweg,2023-08-03,21:00:00,3,1,2,FMN 08 Schijnpoortweg
675,Schijnpoortweg,2023-08-03,22:00:00,4,1,3,FMN 08 Schijnpoortweg
675,Schijnpoortweg,2023-08-03,23:00:00,0,0,0,FMN 08 Schijnpoortweg
675,Schijnpoortweg,2023-08-04,00:00:00,0,0,0,FMN 08 Schijnpoortweg
675,Schijnpoortweg,2023-08-04,01:00:00,0,0,0,FMN 08 Schijnpoortweg
675,Schijnpoortweg,2023-08-04,02:00:00,0,0,0,FMN 08 Schijnpoortweg
675,Schijnpoortweg,2023-08-04,03:00:00,0,0,0,FMN 08 Schijnpoortweg
675,Schijnpoortweg,2023-08-04,04:00:00,0,0,0,FMN 08 Schijnpoortweg
675,Schijnpoortweg,2023-08-04,05:00:00,3,1,2,FMN 08 Schijnpoortweg
675,Schijnpoortweg,2023-08-04,06:00:00,3,1,2,FMN 08 Schijnpoortweg
675,Schijnpoortweg,2023-08-04,07:00:00,0,0,0,FMN 08 Schijnpoortweg
675,Schijnpoortweg,2023-08-04,08:00:00,1,1,0,FMN 08 Schijnpoortweg
675,Schijnpoortweg,2023-08-04,09:00:00,1,1,0,FMN 08 Schijnpoortweg
675,Schijnpoortweg,2023-08-04,10:00:00,1,0,1,FMN 08 Schijnpoortweg
675,Schijnpoortweg,2023-08-04,11:00:00,2,2,0,FMN 08 Schijnpoortweg
675,Schijnpoortweg,2023-08-04,12:00:00,4,0,4,FMN 08 Schijnpoortweg
675,Schijnpoortweg,2023-08-04,13:00:00,2,1,1,FMN 08 Schijnpoortweg
675,Schijnpoortweg,2023-08-04,14:00:00,7,3,4,FMN 08 Schijnpoortweg
675,Schijnpoortweg,2023-08-04,15:00:00,5,0,5,FMN 08 Schijnpoortweg
675,Schijnpoortweg,2023-08-04,16:00:00,7,1,6,FMN 08 Schijnpoortweg
675,Schijnpoortweg,2023-08-04,17:00:00,13,4,9,FMN 08 Schijnpoortweg
675,Schijnpoortweg,2023-08-04,18:00:00,10,3,7,FMN 08 Schijnpoortweg
675,Schijnpoortweg,2023-08-04,19:00:00,12,3,9,FMN 08 Schijnpoortweg
675,Schijnpoortweg,2023-08-04,20:00:00,7,2,5,FMN 08 Schijnpoortweg
675,Schijnpoortweg,2023-08-04,21:00:00,1,0,1,FMN 08 Schijnpoortweg
675,Schijnpoortweg,2023-08-04,22:00:00,4,1,3,FMN 08 Schijnpoortweg
675,Schijnpoortweg,2023-08-04,23:00:00,2,2,0,FMN 08 Schijnpoortweg
675,Schijnpoortweg,2023-08-05,00:00:00,0,0,0,FMN 08 Schijnpoortweg
675,Schijnpoortweg,2023-08-05,01:00:00,0,0,0,FMN 08 Schijnpoortweg
675,Schijnpoortweg,2023-08-05,02:00:00,2,1,1,FMN 08 Schijnpoortweg
675,Schijnpoortweg,2023-08-05,03:00:00,0,0,0,FMN 08 Schijnpoortweg
675,Schijnpoortweg,2023-08-05,04:00:00,3,1,2,FMN 08 Schijnpoortweg
675,Schijnpoortweg,2023-08-05,05:00:00,0,0,0,FMN 08 Schijnpoortweg
675,Schijnpoortweg,2023-08-05,06:00:00,2,1,1,FMN 08 Schijnpoortweg
675,Schijnpoortweg,2023-08-05,07:00:00,0,0,0,FMN 08 Schijnpoortweg
675,Schijnpoortweg,2023-08-05,08:00:00,3,1,2,FMN 08 Schijnpoortweg
675,Schijnpoortweg,2023-08-05,09:00:00,0,0,0,FMN 08 Schijnpoortweg
675,Schijnpoortweg,2023-08-05,10:00:00,3,1,2,FMN 08 Schijnpoortweg
675,Schijnpoortweg,2023-08-05,11:00:00,1,0,1,FMN 08 Schijnpoortweg
675,Schijnpoortweg,2023-08-05,12:00:00,4,1,3,FMN 08 Schijnpoortweg
675,Schijnpoortweg,2023-08-05,13:00:00,2,0,2,FMN 08 Schijnpoortweg
675,Schijnpoortweg,2023-08-05,14:00:00,1,1,0,FMN 08 Schijnpoortweg
675,Schijnpoortweg,2023-08-05,15:00:00,0,0,0,FMN 08 Schijnpoortweg
675,Schijnpoortweg,2023-08-05,16:00:00,1,1,0,FMN 08 Schijnpoortweg
675,Schijnpoortweg,2023-08-05,17:00:00,0,0,0,FMN 08 Schijnpoortweg
675,Schijnpoortweg,2023-08-05,18:00:00,2,1,1,FMN 08 Schijnpoortweg
675,Schijnpoortweg,2023-08-05,19:00:00,1,1,0,FMN 08 Schijnpoortweg
675,Schijnpoortweg,2023-08-05,20:00:00,2,2,0,FMN 08 Schijnpoortweg
675,Schijnpoortweg,2023-08-05,21:00:00,0,0,0,FMN 08 Schijnpoortweg
675,Schijnpoortweg,2023-08-05,22:00:00,0,0,0,FMN 08 Schijnpoortweg
675,Schijnpoortweg,2023-08-05,23:00:00,0,0,0,FMN 08 Schijnpoortweg
675,Schijnpoortweg,2023-08-06,00:00:00,0,0,0,FMN 08 Schijnpoortweg
675,Schijnpoortweg,2023-08-06,01:00:00,2,0,2,FMN 08 Schijnpoortweg
675,Schijnpoortweg,2023-08-06,02:00:00,0,0,0,FMN 08 Schijnpoortweg
675,Schijnpoortweg,2023-08-06,03:00:00,1,0,1,FMN 08 Schijnpoortweg
675,Schijnpoortweg,2023-08-06,04:00:00,0,0,0,FMN 08 Schijnpoortweg
675,Schijnpoortweg,2023-08-06,05:00:00,0,0,0,FMN 08 Schijnpoortweg
675,Schijnpoortweg,2023-08-06,06:00:00,1,1,0,FMN 08 Schijnpoortweg
675,Schijnpoortweg,2023-08-06,07:00:00,0,0,0,FMN 08 Schijnpoortweg
675,Schijnpoortweg,2023-08-06,08:00:00,1,1,0,FMN 08 Schijnpoortweg
675,Schijnpoortweg,2023-08-06,09:00:00,0,0,0,FMN 08 Schijnpoortweg
675,Schijnpoortweg,2023-08-06,10:00:00,0,0,0,FMN 08 Schijnpoortweg
675,Schijnpoortweg,2023-08-06,11:00:00,0,0,0,FMN 08 Schijnpoortweg
675,Schijnpoortweg,2023-08-06,12:00:00,0,0,0,FMN 08 Schijnpoortweg
675,Schijnpoortweg,2023-08-06,13:00:00,2,1,1,FMN 08 Schijnpoortweg
675,Schijnpoortweg,2023-08-06,14:00:00,0,0,0,FMN 08 Schijnpoortweg
675,Schijnpoortweg,2023-08-06,15:00:00,2,0,2,FMN 08 Schijnpoortweg
675,Schijnpoortweg,2023-08-06,16:00:00,1,1,0,FMN 08 Schijnpoortweg
675,Schijnpoortweg,2023-08-06,17:00:00,0,0,0,FMN 08 Schijnpoortweg
675,Schijnpoortweg,2023-08-06,18:00:00,3,1,2,FMN 08 Schijnpoortweg
675,Schijnpoortweg,2023-08-06,19:00:00,1,0,1,FMN 08 Schijnpoortweg
675,Schijnpoortweg,2023-08-06,20:00:00,4,1,3,FMN 08 Schijnpoortweg
675,Schijnpoortweg,2023-08-06,21:00:00,3,2,1,FMN 08 Schijnpoortweg
675,Schijnpoortweg,2023-08-06,22:00:00,2,0,2,FMN 08 Schijnpoortweg
675,Schijnpoortweg,2023-08-06,23:00:00,2,1,1,FMN 08 Schijnpoortweg
675,Schijnpoortweg,2023-08-07,00:00:00,1,0,1,FMN 08 Schijnpoortweg
675,Schijnpoortweg,2023-08-07,01:00:00,1,0,1,FMN 08 Schijnpoortweg
675,Schijnpoortweg,2023-08-07,02:00:00,0,0,0,FMN 08 Schijnpoortweg
675,Schijnpoortweg,2023-08-07,03:00:00,1,0,1,FMN 08 Schijnpoortweg
675,Schijnpoortweg,2023-08-07,04:00:00,0,0,0,FMN 08 Schijnpoortweg
675,Schijnpoortweg,2023-08-07,05:00:00,3,1,2,FMN 08 Schijnpoortweg
675,Schijnpoortweg,2023-08-07,06:00:00,1,0,1,FMN 08 Schijnpoortweg
675,Schijnpoortweg,2023-08-07,07:00:00,4,1,3,FMN 08 Schijnpoortweg
675,Schijnpoortweg,2023-08-07,08:00:00,5,1,4,FMN 08 Schijnpoortweg
675,Schijnpoortweg,2023-08-07,09:00:00,0,0,0,FMN 08 Schijnpoortweg
675,Schijnpoortweg,2023-08-07,10:00:00,3,1,2,FMN 08 Schijnpoortweg
675,Schijnpoortweg,2023-08-07,11:00:00,4,3,1,FMN 08 Schijnpoortweg
675,Schijnpoortweg,2023-08-07,12:00:00,0,0,0,FMN 08 Schijnpoortweg
675,Schijnpoortweg,2023-08-07,13:00:00,4,0,4,FMN 08 Schijnpoortweg
675,Schijnpoortweg,2023-08-07,14:00:00,2,0,2,FMN 08 Schijnpoortweg
675,Schijnpoortweg,2023-08-07,15:00:00,3,1,2,FMN 08 Schijnpoortweg
675,Schijnpoortweg,2023-08-07,16:00:00,4,0,4,FMN 08 Schijnpoortweg
675,Schijnpoortweg,2023-08-07,17:00:00,4,3,1,FMN 08 Schijnpoortweg
675,Schijnpoortweg,2023-08-07,18:00:00,4,1,3,FMN 08 Schijnpoortweg
675,Schijnpoortweg,2023-08-07,19:00:00,8,2,6,FMN 08 Schijnpoortweg
675,Schijnpoortweg,2023-08-07,20:00:00,4,3,1,FMN 08 Schijnpoortweg
675,Schijnpoortweg,2023-08-07,21:00:00,2,0,2,FMN 08 Schijnpoortweg
675,Schijnpoortweg,2023-08-07,22:00:00,3,2,1,FMN 08 Schijnpoortweg
675,Schijnpoortweg,2023-08-07,23:00:00,1,1,0,FMN 08 Schijnpoortweg
675,Schijnpoortweg,2023-08-08,00:00:00,1,0,1,FMN 08 Schijnpoortweg
675,Schijnpoortweg,2023-08-08,01:00:00,0,0,0,FMN 08 Schijnpoortweg
675,Schijnpoortweg,2023-08-08,02:00:00,1,0,1,FMN 08 Schijnpoortweg
675,Schijnpoortweg,2023-08-08,03:00:00,1,1,0,FMN 08 Schijnpoortweg
675,Schijnpoortweg,2023-08-08,04:00:00,1,0,1,FMN 08 Schijnpoortweg
675,Schijnpoortweg,2023-08-08,05:00:00,2,0,2,FMN 08 Schijnpoortweg
675,Schijnpoortweg,2023-08-08,06:00:00,4,2,2,FMN 08 Schijnpoortweg
675,Schijnpoortweg,2023-08-08,07:00:00,0,0,0,FMN 08 Schijnpoortweg
675,Schijnpoortweg,2023-08-08,08:00:00,0,0,0,FMN 08 Schijnpoortweg
675,Schijnpoortweg,2023-08-08,09:00:00,0,0,0,FMN 08 Schijnpoortweg
675,Schijnpoortweg,2023-08-08,10:00:00,3,1,2,FMN 08 Schijnpoortweg
675,Schijnpoortweg,2023-08-08,11:00:00,0,0,0,FMN 08 Schijnpoortweg
675,Schijnpoortweg,2023-08-08,12:00:00,1,0,1,FMN 08 Schijnpoortweg
675,Schijnpoortweg,2023-08-08,13:00:00,2,0,2,FMN 08 Schijnpoortweg
675,Schijnpoortweg,2023-08-08,14:00:00,2,1,1,FMN 08 Schijnpoortweg
675,Schijnpoortweg,2023-08-08,15:00:00,2,1,1,FMN 08 Schijnpoortweg
675,Schijnpoortweg,2023-08-08,16:00:00,7,4,3,FMN 08 Schijnpoortweg
675,Schijnpoortweg,2023-08-08,17:00:00,1,0,1,FMN 08 Schijnpoortweg
675,Schijnpoortweg,2023-08-08,18:00:00,5,0,5,FMN 08 Schijnpoortweg
675,Schijnpoortweg,2023-08-08,19:00:00,4,2,2,FMN 08 Schijnpoortweg
675,Schijnpoortweg,2023-08-08,20:00:00,2,1,1,FMN 08 Schijnpoortweg
675,Schijnpoortweg,2023-08-08,21:00:00,4,2,2,FMN 08 Schijnpoortweg
675,Schijnpoortweg,2023-08-08,22:00:00,2,0,2,FMN 08 Schijnpoortweg
675,Schijnpoortweg,2023-08-08,23:00:00,1,0,1,FMN 08 Schijnpoortweg
675,Schijnpoortweg,2023-08-09,00:00:00,2,0,2,FMN 08 Schijnpoortweg
675,Schijnpoortweg,2023-08-09,01:00:00,0,0,0,FMN 08 Schijnpoortweg
675,Schijnpoortweg,2023-08-09,02:00:00,0,0,0,FMN 08 Schijnpoortweg
675,Schijnpoortweg,2023-08-09,03:00:00,0,0,0,FMN 08 Schijnpoortweg
675,Schijnpoortweg,2023-08-09,04:00:00,0,0,0,FMN 08 Schijnpoortweg
675,Schijnpoortweg,2023-08-09,05:00:00,1,1,0,FMN 08 Schijnpoortweg
675,Schijnpoortweg,2023-08-09,06:00:00,1,0,1,FMN 08 Schijnpoortweg
675,Schijnpoortweg,2023-08-09,07:00:00,0,0,0,FMN 08 Schijnpoortweg
675,Schijnpoortweg,2023-08-09,08:00:00,1,1,0,FMN 08 Schijnpoortweg
675,Schijnpoortweg,2023-08-09,09:00:00,2,1,1,FMN 08 Schijnpoortweg
675,Schijnpoortweg,2023-08-09,10:00:00,1,1,0,FMN 08 Schijnpoortweg
675,Schijnpoortweg,2023-08-09,11:00:00,3,1,2,FMN 08 Schijnpoortweg
675,Schijnpoortweg,2023-08-09,12:00:00,3,1,2,FMN 08 Schijnpoortweg
675,Schijnpoortweg,2023-08-09,13:00:00,4,3,1,FMN 08 Schijnpoortweg
675,Schijnpoortweg,2023-08-09,14:00:00,3,2,1,FMN 08 Schijnpoortweg
675,Schijnpoortweg,2023-08-09,15:00:00,4,1,3,FMN 08 Schijnpoortweg
675,Schijnpoortweg,2023-08-09,16:00:00,4,0,4,FMN 08 Schijnpoortweg
675,Schijnpoortweg,2023-08-09,17:00:00,3,2,1,FMN 08 Schijnpoortweg
675,Schijnpoortweg,2023-08-09,18:00:00,9,5,4,FMN 08 Schijnpoortweg
675,Schijnpoortweg,2023-08-09,19:00:00,5,1,4,FMN 08 Schijnpoortweg
675,Schijnpoortweg,2023-08-09,20:00:00,4,1,3,FMN 08 Schijnpoortweg
675,Schijnpoortweg,2023-08-09,21:00:00,3,0,3,FMN 08 Schijnpoortweg
675,Schijnpoortweg,2023-08-09,22:00:00,5,3,2,FMN 08 Schijnpoortweg
675,Schijnpoortweg,2023-08-09,23:00:00,2,1,1,FMN 08 Schijnpoortweg
675,Schijnpoortweg,2023-08-10,00:00:00,1,1,0,FMN 08 Schijnpoortweg
675,Schijnpoortweg,2023-08-10,01:00:00,2,1,1,FMN 08 Schijnpoortweg
675,Schijnpoortweg,2023-08-10,02:00:00,1,0,1,FMN 08 Schijnpoortweg
675,Schijnpoortweg,2023-08-10,03:00:00,1,0,1,FMN 08 Schijnpoortweg
675,Schijnpoortweg,2023-08-10,04:00:00,0,0,0,FMN 08 Schijnpoortweg
675,Schijnpoortweg,2023-08-10,05:00:00,2,2,0,FMN 08 Schijnpoortweg
675,Schijnpoortweg,2023-08-10,06:00:00,3,1,2,FMN 08 Schijnpoortweg
675,Schijnpoortweg,2023-08-10,07:00:00,0,0,0,FMN 08 Schijnpoortweg
675,Schijnpoortweg,2023-08-10,08:00:00,3,1,2,FMN 08 Schijnpoortweg
675,Schijnpoortweg,2023-08-10,09:00:00,1,1,0,FMN 08 Schijnpoortweg
675,Schijnpoortweg,2023-08-10,10:00:00,2,0,2,FMN 08 Schijnpoortweg
675,Schijnpoortweg,2023-08-10,11:00:00,2,0,2,FMN 08 Schijnpoortweg
675,Schijnpoortweg,2023-08-10,12:00:00,0,0,0,FMN 08 Schijnpoortweg
675,Schijnpoortweg,2023-08-10,13:00:00,3,3,0,FMN 08 Schijnpoortweg
675,Schijnpoortweg,2023-08-10,14:00:00,3,1,2,FMN 08 Schijnpoortweg
675,Schijnpoortweg,2023-08-10,15:00:00,1,0,1,FMN 08 Schijnpoortweg
675,Schijnpoortweg,2023-08-10,16:00:00,1,0,1,FMN 08 Schijnpoortweg
675,Schijnpoortweg,2023-08-10,17:00:00,3,0,3,FMN 08 Schijnpoortweg
675,Schijnpoortweg,2023-08-10,18:00:00,3,1,2,FMN 08 Schijnpoortweg
675,Schijnpoortweg,2023-08-10,19:00:00,3,0,3,FMN 08 Schijnpoortweg
675,Schijnpoortweg,2023-08-10,20:00:00,6,4,2,FMN 08 Schijnpoortweg
675,Schijnpoortweg,2023-08-10,21:00:00,3,1,2,FMN 08 Schijnpoortweg
675,Schijnpoortweg,2023-08-10,22:00:00,6,3,3,FMN 08 Schijnpoortweg
675,Schijnpoortweg,2023-08-10,23:00:00,1,0,1,FMN 08 Schijnpoortweg
675,Schijnpoortweg,2023-08-11,00:00:00,0,0,0,FMN 08 Schijnpoortweg
675,Schijnpoortweg,2023-08-11,01:00:00,1,1,0,FMN 08 Schijnpoortweg
675,Schijnpoortweg,2023-08-11,02:00:00,0,0,0,FMN 08 Schijnpoortweg
675,Schijnpoortweg,2023-08-11,03:00:00,1,1,0,FMN 08 Schijnpoortweg
675,Schijnpoortweg,2023-08-11,04:00:00,1,1,0,FMN 08 Schijnpoortweg
675,Schijnpoortweg,2023-08-11,05:00:00,2,0,2,FMN 08 Schijnpoortweg
675,Schijnpoortweg,2023-08-11,06:00:00,1,0,1,FMN 08 Schijnpoortweg
675,Schijnpoortweg,2023-08-11,07:00:00,0,0,0,FMN 08 Schijnpoortweg
675,Schijnpoortweg,2023-08-11,08:00:00,1,1,0,FMN 08 Schijnpoortweg
675,Schijnpoortweg,2023-08-11,09:00:00,0,0,0,FMN 08 Schijnpoortweg
675,Schijnpoortweg,2023-08-11,10:00:00,2,1,1,FMN 08 Schijnpoortweg
675,Schijnpoortweg,2023-08-11,11:00:00,1,1,0,FMN 08 Schijnpoortweg
675,Schijnpoortweg,2023-08-11,12:00:00,3,1,2,FMN 08 Schijnpoortweg
675,Schijnpoortweg,2023-08-11,13:00:00,2,1,1,FMN 08 Schijnpoortweg
675,Schijnpoortweg,2023-08-11,14:00:00,2,1,1,FMN 08 Schijnpoortweg
675,Schijnpoortweg,2023-08-11,15:00:00,4,2,2,FMN 08 Schijnpoortweg
675,Schijnpoortweg,2023-08-11,16:00:00,6,3,3,FMN 08 Schijnpoortweg
675,Schijnpoortweg,2023-08-11,17:00:00,3,1,2,FMN 08 Schijnpoortweg
675,Schijnpoortweg,2023-08-11,18:00:00,6,1,5,FMN 08 Schijnpoortweg
675,Schijnpoortweg,2023-08-11,19:00:00,7,1,6,FMN 08 Schijnpoortweg
675,Schijnpoortweg,2023-08-11,20:00:00,1,0,1,FMN 08 Schijnpoortweg
675,Schijnpoortweg,2023-08-11,21:00:00,6,2,4,FMN 08 Schijnpoortweg
675,Schijnpoortweg,2023-08-11,22:00:00,1,0,1,FMN 08 Schijnpoortweg
675,Schijnpoortweg,2023-08-11,23:00:00,0,0,0,FMN 08 Schijnpoortweg
675,Schijnpoortweg,2023-08-12,00:00:00,3,0,3,FMN 08 Schijnpoortweg
675,Schijnpoortweg,2023-08-12,01:00:00,2,0,2,FMN 08 Schijnpoortweg
675,Schijnpoortweg,2023-08-12,02:00:00,4,1,3,FMN 08 Schijnpoortweg
675,Schijnpoortweg,2023-08-12,03:00:00,0,0,0,FMN 08 Schijnpoortweg
675,Schijnpoortweg,2023-08-12,04:00:00,1,1,0,FMN 08 Schijnpoortweg
675,Schijnpoortweg,2023-08-12,05:00:00,1,1,0,FMN 08 Schijnpoortweg
675,Schijnpoortweg,2023-08-12,06:00:00,1,1,0,FMN 08 Schijnpoortweg
675,Schijnpoortweg,2023-08-12,07:00:00,1,0,1,FMN 08 Schijnpoortweg
675,Schijnpoortweg,2023-08-12,08:00:00,0,0,0,FMN 08 Schijnpoortweg
675,Schijnpoortweg,2023-08-12,09:00:00,3,1,2,FMN 08 Schijnpoortweg
675,Schijnpoortweg,2023-08-12,10:00:00,1,1,0,FMN 08 Schijnpoortweg
675,Schijnpoortweg,2023-08-12,11:00:00,4,1,3,FMN 08 Schijnpoortweg
675,Schijnpoortweg,2023-08-12,12:00:00,0,0,0,FMN 08 Schijnpoortweg
675,Schijnpoortweg,2023-08-12,13:00:00,0,0,0,FMN 08 Schijnpoortweg
675,Schijnpoortweg,2023-08-12,14:00:00,3,0,3,FMN 08 Schijnpoortweg
675,Schijnpoortweg,2023-08-12,15:00:00,3,2,1,FMN 08 Schijnpoortweg
675,Schijnpoortweg,2023-08-12,16:00:00,1,1,0,FMN 08 Schijnpoortweg
675,Schijnpoortweg,2023-08-12,17:00:00,1,1,0,FMN 08 Schijnpoortweg
675,Schijnpoortweg,2023-08-12,18:00:00,2,1,1,FMN 08 Schijnpoortweg
675,Schijnpoortweg,2023-08-12,19:00:00,3,2,1,FMN 08 Schijnpoortweg
675,Schijnpoortweg,2023-08-12,20:00:00,7,2,5,FMN 08 Schijnpoortweg
675,Schijnpoortweg,2023-08-12,21:00:00,5,1,4,FMN 08 Schijnpoortweg
675,Schijnpoortweg,2023-08-12,22:00:00,6,3,3,FMN 08 Schijnpoortweg
675,Schijnpoortweg,2023-08-12,23:00:00,5,2,3,FMN 08 Schijnpoortweg
675,Schijnpoortweg,2023-08-13,00:00:00,1,0,1,FMN 08 Schijnpoortweg
675,Schijnpoortweg,2023-08-13,01:00:00,0,0,0,FMN 08 Schijnpoortweg
675,Schijnpoortweg,2023-08-13,02:00:00,0,0,0,FMN 08 Schijnpoortweg
675,Schijnpoortweg,2023-08-13,03:00:00,1,1,0,FMN 08 Schijnpoortweg
675,Schijnpoortweg,2023-08-13,04:00:00,2,2,0,FMN 08 Schijnpoortweg
675,Schijnpoortweg,2023-08-13,05:00:00,1,1,0,FMN 08 Schijnpoortweg
675,Schijnpoortweg,2023-08-13,06:00:00,1,0,1,FMN 08 Schijnpoortweg
675,Schijnpoortweg,2023-08-13,07:00:00,0,0,0,FMN 08 Schijnpoortweg
675,Schijnpoortweg,2023-08-13,08:00:00,4,2,2,FMN 08 Schijnpoortweg
675,Schijnpoortweg,2023-08-13,09:00:00,1,0,1,FMN 08 Schijnpoortweg
675,Schijnpoortweg,2023-08-13,10:00:00,3,1,2,FMN 08 Schijnpoortweg
675,Schijnpoortweg,2023-08-13,11:00:00,0,0,0,FMN 08 Schijnpoortweg
675,Schijnpoortweg,2023-08-13,12:00:00,0,0,0,FMN 08 Schijnpoortweg
675,Schijnpoortweg,2023-08-13,13:00:00,1,0,1,FMN 08 Schijnpoortweg
675,Schijnpoortweg,2023-08-13,14:00:00,1,0,1,FMN 08 Schijnpoortweg
675,Schijnpoortweg,2023-08-13,15:00:00,1,1,0,FMN 08 Schijnpoortweg
675,Schijnpoortweg,2023-08-13,16:00:00,6,1,5,FMN 08 Schijnpoortweg
675,Schijnpoortweg,2023-08-13,17:00:00,4,1,3,FMN 08 Schijnpoortweg
675,Schijnpoortweg,2023-08-13,18:00:00,10,4,6,FMN 08 Schijnpoortweg
675,Schijnpoortweg,2023-08-13,19:00:00,1,1,0,FMN 08 Schijnpoortweg
675,Schijnpoortweg,2023-08-13,20:00:00,3,1,2,FMN 08 Schijnpoortweg
675,Schijnpoortweg,2023-08-13,21:00:00,4,1,3,FMN 08 Schijnpoortweg
675,Schijnpoortweg,2023-08-13,22:00:00,0,0,0,FMN 08 Schijnpoortweg
675,Schijnpoortweg,2023-08-13,23:00:00,3,2,1,FMN 08 Schijnpoortweg
675,Schijnpoortweg,2023-08-14,00:00:00,2,1,1,FMN 08 Schijnpoortweg
675,Schijnpoortweg,2023-08-14,01:00:00,2,0,2,FMN 08 Schijnpoortweg
675,Schijnpoortweg,2023-08-14,02:00:00,0,0,0,FMN 08 Schijnpoortweg
675,Schijnpoortweg,2023-08-14,03:00:00,1,1,0,FMN 08 Schijnpoortweg
675,Schijnpoortweg,2023-08-14,04:00:00,1,0,1,FMN 08 Schijnpoortweg
675,Schijnpoortweg,2023-08-14,05:00:00,2,1,1,FMN 08 Schijnpoortweg
675,Schijnpoortweg,2023-08-14,06:00:00,1,1,0,FMN 08 Schijnpoortweg
675,Schijnpoortweg,2023-08-14,07:00:00,0,0,0,FMN 08 Schijnpoortweg
675,Schijnpoortweg,2023-08-14,08:00:00,1,0,1,FMN 08 Schijnpoortweg
675,Schijnpoortweg,2023-08-14,09:00:00,1,0,1,FMN 08 Schijnpoortweg
675,Schijnpoortweg,2023-08-14,10:00:00,1,0,1,FMN 08 Schijnpoortweg
675,Schijnpoortweg,2023-08-14,11:00:00,2,1,1,FMN 08 Schijnpoortweg
675,Schijnpoortweg,2023-08-14,12:00:00,3,0,3,FMN 08 Schijnpoortweg
675,Schijnpoortweg,2023-08-14,13:00:00,4,3,1,FMN 08 Schijnpoortweg
675,Schijnpoortweg,2023-08-14,14:00:00,3,0,3,FMN 08 Schijnpoortweg
675,Schijnpoortweg,2023-08-14,15:00:00,3,2,1,FMN 08 Schijnpoortweg
675,Schijnpoortweg,2023-08-14,16:00:00,6,3,3,FMN 08 Schijnpoortweg
675,Schijnpoortweg,2023-08-14,17:00:00,3,2,1,FMN 08 Schijnpoortweg
675,Schijnpoortweg,2023-08-14,18:00:00,10,2,8,FMN 08 Schijnpoortweg
675,Schijnpoortweg,2023-08-14,19:00:00,7,3,4,FMN 08 Schijnpoortweg
675,Schijnpoortweg,2023-08-14,20:00:00,4,1,3,FMN 08 Schijnpoortweg
675,Schijnpoortweg,2023-08-14,21:00:00,5,3,2,FMN 08 Schijnpoortweg
675,Schijnpoortweg,2023-08-14,22:00:00,1,0,1,FMN 08 Schijnpoortweg
675,Schijnpoortweg,2023-08-14,23:00:00,1,1,0,FMN 08 Schijnpoortweg
675,Schijnpoortweg,2023-08-15,00:00:00,3,1,2,FMN 08 Schijnpoortweg
675,Schijnpoortweg,2023-08-15,01:00:00,1,0,1,FMN 08 Schijnpoortweg
675,Schijnpoortweg,2023-08-15,02:00:00,0,0,0,FMN 08 Schijnpoortweg
675,Schijnpoortweg,2023-08-15,03:00:00,0,0,0,FMN 08 Schijnpoortweg
675,Schijnpoortweg,2023-08-15,04:00:00,0,0,0,FMN 08 Schijnpoortweg
675,Schijnpoortweg,2023-08-15,05:00:00,1,1,0,FMN 08 Schijnpoortweg
675,Schijnpoortweg,2023-08-15,06:00:00,0,0,0,FMN 08 Schijnpoortweg
675,Schijnpoortweg,2023-08-15,07:00:00,0,0,0,FMN 08 Schijnpoortweg
675,Schijnpoortweg,2023-08-15,08:00:00,2,1,1,FMN 08 Schijnpoortweg
675,Schijnpoortweg,2023-08-15,09:00:00,1,0,1,FMN 08 Schijnpoortweg
675,Schijnpoortweg,2023-08-15,10:00:00,3,3,0,FMN 08 Schijnpoortweg
675,Schijnpoortweg,2023-08-15,11:00:00,0,0,0,FMN 08 Schijnpoortweg
675,Schijnpoortweg,2023-08-15,12:00:00,1,1,0,FMN 08 Schijnpoortweg
675,Schijnpoortweg,2023-08-15,13:00:00,3,1,2,FMN 08 Schijnpoortweg
675,Schijnpoortweg,2023-08-15,14:00:00,1,0,1,FMN 08 Schijnpoortweg
675,Schijnpoortweg,2023-08-15,15:00:00,3,1,2,FMN 08 Schijnpoortweg
675,Schijnpoortweg,2023-08-15,16:00:00,2,0,2,FMN 08 Schijnpoortweg
675,Schijnpoortweg,2023-08-15,17:00:00,5,0,5,FMN 08 Schijnpoortweg
675,Schijnpoortweg,2023-08-15,18:00:00,6,3,3,FMN 08 Schijnpoortweg
675,Schijnpoortweg,2023-08-15,19:00:00,3,2,1,FMN 08 Schijnpoortweg
675,Schijnpoortweg,2023-08-15,20:00:00,0,0,0,FMN 08 Schijnpoortweg
675,Schijnpoortweg,2023-08-15,21:00:00,7,4,3,FMN 08 Schijnpoortweg
675,Schijnpoortweg,2023-08-15,22:00:00,4,1,3,FMN 08 Schijnpoortweg
675,Schijnpoortweg,2023-08-15,23:00:00,3,0,3,FMN 08 Schijnpoortweg
675,Schijnpoortweg,2023-08-16,00:00:00,3,1,2,FMN 08 Schijnpoortweg
675,Schijnpoortweg,2023-08-16,01:00:00,1,0,1,FMN 08 Schijnpoortweg
675,Schijnpoortweg,2023-08-16,02:00:00,0,0,0,FMN 08 Schijnpoortweg
675,Schijnpoortweg,2023-08-16,03:00:00,0,0,0,FMN 08 Schijnpoortweg
675,Schijnpoortweg,2023-08-16,04:00:00,2,1,1,FMN 08 Schijnpoortweg
675,Schijnpoortweg,2023-08-16,05:00:00,5,2,3,FMN 08 Schijnpoortweg
675,Schijnpoortweg,2023-08-16,06:00:00,1,1,0,FMN 08 Schijnpoortweg
675,Schijnpoortweg,2023-08-16,07:00:00,0,0,0,FMN 08 Schijnpoortweg
675,Schijnpoortweg,2023-08-16,08:00:00,1,0,1,FMN 08 Schijnpoortweg
675,Schijnpoortweg,2023-08-16,09:00:00,3,2,1,FMN 08 Schijnpoortweg
675,Schijnpoortweg,2023-08-16,10:00:00,3,2,1,FMN 08 Schijnpoortweg
675,Schijnpoortweg,2023-08-16,11:00:00,2,0,2,FMN 08 Schijnpoortweg
675,Schijnpoortweg,2023-08-16,12:00:00,2,1,1,FMN 08 Schijnpoortweg
675,Schijnpoortweg,2023-08-16,13:00:00,1,1,0,FMN 08 Schijnpoortweg
675,Schijnpoortweg,2023-08-16,14:00:00,1,0,1,FMN 08 Schijnpoortweg
675,Schijnpoortweg,2023-08-16,15:00:00,1,0,1,FMN 08 Schijnpoortweg
675,Schijnpoortweg,2023-08-16,16:00:00,4,1,3,FMN 08 Schijnpoortweg
675,Schijnpoortweg,2023-08-16,17:00:00,5,1,4,FMN 08 Schijnpoortweg
675,Schijnpoortweg,2023-08-16,18:00:00,6,2,4,FMN 08 Schijnpoortweg
675,Schijnpoortweg,2023-08-16,19:00:00,9,5,4,FMN 08 Schijnpoortweg
675,Schijnpoortweg,2023-08-16,20:00:00,1,1,0,FMN 08 Schijnpoortweg
675,Schijnpoortweg,2023-08-16,21:00:00,6,3,3,FMN 08 Schijnpoortweg
675,Schijnpoortweg,2023-08-16,22:00:00,6,3,3,FMN 08 Schijnpoortweg
675,Schijnpoortweg,2023-08-16,23:00:00,4,0,4,FMN 08 Schijnpoortweg
675,Schijnpoortweg,2023-08-17,00:00:00,0,0,0,FMN 08 Schijnpoortweg
675,Schijnpoortweg,2023-08-17,01:00:00,1,1,0,FMN 08 Schijnpoortweg
675,Schijnpoortweg,2023-08-17,02:00:00,0,0,0,FMN 08 Schijnpoortweg
675,Schijnpoortweg,2023-08-17,03:00:00,0,0,0,FMN 08 Schijnpoortweg
675,Schijnpoortweg,2023-08-17,04:00:00,4,1,3,FMN 08 Schijnpoortweg
675,Schijnpoortweg,2023-08-17,05:00:00,4,1,3,FMN 08 Schijnpoortweg
675,Schijnpoortweg,2023-08-17,06:00:00,1,0,1,FMN 08 Schijnpoortweg
675,Schijnpoortweg,2023-08-17,07:00:00,3,2,1,FMN 08 Schijnpoortweg
675,Schijnpoortweg,2023-08-17,08:00:00,1,1,0,FMN 08 Schijnpoortweg
675,Schijnpoortweg,2023-08-17,09:00:00,1,1,0,FMN 08 Schijnpoortweg
675,Schijnpoortweg,2023-08-17,10:00:00,2,1,1,FMN 08 Schijnpoortweg
675,Schijnpoortweg,2023-08-17,11:00:00,1,0,1,FMN 08 Schijnpoortweg
675,Schijnpoortweg,2023-08-17,12:00:00,1,0,1,FMN 08 Schijnpoortweg
675,Schijnpoortweg,2023-08-17,13:00:00,0,0,0,FMN 08 Schijnpoortweg
675,Schijnpoortweg,2023-08-17,14:00:00,2,0,2,FMN 08 Schijnpoortweg
675,Schijnpoortweg,2023-08-17,15:00:00,5,2,3,FMN 08 Schijnpoortweg
675,Schijnpoortweg,2023-08-17,16:00:00,4,1,3,FMN 08 Schijnpoortweg
675,Schijnpoortweg,2023-08-17,17:00:00,4,2,2,FMN 08 Schijnpoortweg
675,Schijnpoortweg,2023-08-17,18:00:00,5,1,4,FMN 08 Schijnpoortweg
675,Schijnpoortweg,2023-08-17,19:00:00,2,1,1,FMN 08 Schijnpoortweg
675,Schijnpoortweg,2023-08-17,20:00:00,5,3,2,FMN 08 Schijnpoortweg
675,Schijnpoortweg,2023-08-17,21:00:00,6,1,5,FMN 08 Schijnpoortweg
675,Schijnpoortweg,2023-08-17,22:00:00,5,2,3,FMN 08 Schijnpoortweg
675,Schijnpoortweg,2023-08-17,23:00:00,0,0,0,FMN 08 Schijnpoortweg
675,Schijnpoortweg,2023-08-18,00:00:00,2,0,2,FMN 08 Schijnpoortweg
675,Schijnpoortweg,2023-08-18,01:00:00,1,0,1,FMN 08 Schijnpoortweg
675,Schijnpoortweg,2023-08-18,02:00:00,0,0,0,FMN 08 Schijnpoortweg
675,Schijnpoortweg,2023-08-18,03:00:00,0,0,0,FMN 08 Schijnpoortweg
675,Schijnpoortweg,2023-08-18,04:00:00,1,0,1,FMN 08 Schijnpoortweg
675,Schijnpoortweg,2023-08-18,05:00:00,2,0,2,FMN 08 Schijnpoortweg
675,Schijnpoortweg,2023-08-18,06:00:00,3,2,1,FMN 08 Schijnpoortweg
675,Schijnpoortweg,2023-08-18,07:00:00,2,1,1,FMN 08 Schijnpoortweg
675,Schijnpoortweg,2023-08-18,08:00:00,1,1,0,FMN 08 Schijnpoortweg
675,Schijnpoortweg,2023-08-18,09:00:00,2,0,2,FMN 08 Schijnpoortweg
675,Schijnpoortweg,2023-08-18,10:00:00,1,0,1,FMN 08 Schijnpoortweg
675,Schijnpoortweg,2023-08-18,11:00:00,0,0,0,FMN 08 Schijnpoortweg
675,Schijnpoortweg,2023-08-18,12:00:00,3,1,2,FMN 08 Schijnpoortweg
675,Schijnpoortweg,2023-08-18,13:00:00,4,1,3,FMN 08 Schijnpoortweg
675,Schijnpoortweg,2023-08-18,14:00:00,5,1,4,FMN 08 Schijnpoortweg
675,Schijnpoortweg,2023-08-18,15:00:00,6,4,2,FMN 08 Schijnpoortweg
675,Schijnpoortweg,2023-08-18,16:00:00,4,2,2,FMN 08 Schijnpoortweg
675,Schijnpoortweg,2023-08-18,17:00:00,8,2,6,FMN 08 Schijnpoortweg
675,Schijnpoortweg,2023-08-18,18:00:00,11,2,9,FMN 08 Schijnpoortweg
675,Schijnpoortweg,2023-08-18,19:00:00,8,5,3,FMN 08 Schijnpoortweg
675,Schijnpoortweg,2023-08-18,20:00:00,3,2,1,FMN 08 Schijnpoortweg
675,Schijnpoortweg,2023-08-18,21:00:00,8,1,7,FMN 08 Schijnpoortweg
675,Schijnpoortweg,2023-08-18,22:00:00,4,1,3,FMN 08 Schijnpoortweg
675,Schijnpoortweg,2023-08-18,23:00:00,4,2,2,FMN 08 Schijnpoortweg
675,Schijnpoortweg,2023-08-19,00:00:00,1,0,1,FMN 08 Schijnpoortweg
675,Schijnpoortweg,2023-08-19,01:00:00,2,1,1,FMN 08 Schijnpoortweg
675,Schijnpoortweg,2023-08-19,02:00:00,1,0,1,FMN 08 Schijnpoortweg
675,Schijnpoortweg,2023-08-19,03:00:00,0,0,0,FMN 08 Schijnpoortweg
675,Schijnpoortweg,2023-08-19,04:00:00,2,1,1,FMN 08 Schijnpoortweg
675,Schijnpoortweg,2023-08-19,05:00:00,2,1,1,FMN 08 Schijnpoortweg
675,Schijnpoortweg,2023-08-19,06:00:00,1,0,1,FMN 08 Schijnpoortweg
675,Schijnpoortweg,2023-08-19,07:00:00,1,1,0,FMN 08 Schijnpoortweg
675,Schijnpoortweg,2023-08-19,08:00:00,0,0,0,FMN 08 Schijnpoortweg
675,Schijnpoortweg,2023-08-19,09:00:00,2,1,1,FMN 08 Schijnpoortweg
675,Schijnpoortweg,2023-08-19,10:00:00,1,1,0,FMN 08 Schijnpoortweg
675,Schijnpoortweg,2023-08-19,11:00:00,3,0,3,FMN 08 Schijnpoortweg
675,Schijnpoortweg,2023-08-19,12:00:00,4,2,2,FMN 08 Schijnpoortweg
675,Schijnpoortweg,2023-08-19,13:00:00,3,0,3,FMN 08 Schijnpoortweg
675,Schijnpoortweg,2023-08-19,14:00:00,0,0,0,FMN 08 Schijnpoortweg
675,Schijnpoortweg,2023-08-19,15:00:00,0,0,0,FMN 08 Schijnpoortweg
675,Schijnpoortweg,2023-08-19,16:00:00,7,3,4,FMN 08 Schijnpoortweg
675,Schijnpoortweg,2023-08-19,17:00:00,3,0,3,FMN 08 Schijnpoortweg
675,Schijnpoortweg,2023-08-19,18:00:00,8,4,4,FMN 08 Schijnpoortweg
675,Schijnpoortweg,2023-08-19,19:00:00,1,1,0,FMN 08 Schijnpoortweg
675,Schijnpoortweg,2023-08-19,20:00:00,4,0,4,FMN 08 Schijnpoortweg
675,Schijnpoortweg,2023-08-19,21:00:00,2,1,1,FMN 08 Schijnpoortweg
675,Schijnpoortweg,2023-08-19,22:00:00,3,1,2,FMN 08 Schijnpoortweg
675,Schijnpoortweg,2023-08-19,23:00:00,4,2,2,FMN 08 Schijnpoortweg
675,Schijnpoortweg,2023-08-20,00:00:00,3,1,2,FMN 08 Schijnpoortweg
675,Schijnpoortweg,2023-08-20,01:00:00,5,1,4,FMN 08 Schijnpoortweg
675,Schijnpoortweg,2023-08-20,02:00:00,0,0,0,FMN 08 Schijnpoortweg
675,Schijnpoortweg,2023-08-20,03:00:00,2,0,2,FMN 08 Schijnpoortweg
675,Schijnpoortweg,2023-08-20,04:00:00,1,1,0,FMN 08 Schijnpoortweg
675,Schijnpoortweg,2023-08-20,05:00:00,0,0,0,FMN 08 Schijnpoortweg
675,Schijnpoortweg,2023-08-20,06:00:00,0,0,0,FMN 08 Schijnpoortweg
675,Schijnpoortweg,2023-08-20,07:00:00,0,0,0,FMN 08 Schijnpoortweg
675,Schijnpoortweg,2023-08-20,08:00:00,0,0,0,FMN 08 Schijnpoortweg
675,Schijnpoortweg,2023-08-20,09:00:00,1,1,0,FMN 08 Schijnpoortweg
675,Schijnpoortweg,2023-08-20,10:00:00,1,0,1,FMN 08 Schijnpoortweg
675,Schijnpoortweg,2023-08-20,11:00:00,2,1,1,FMN 08 Schijnpoortweg
675,Schijnpoortweg,2023-08-20,12:00:00,1,0,1,FMN 08 Schijnpoortweg
675,Schijnpoortweg,2023-08-20,13:00:00,3,1,2,FMN 08 Schijnpoortweg
675,Schijnpoortweg,2023-08-20,14:00:00,4,2,2,FMN 08 Schijnpoortweg
675,Schijnpoortweg,2023-08-20,15:00:00,0,0,0,FMN 08 Schijnpoortweg
675,Schijnpoortweg,2023-08-20,16:00:00,7,1,6,FMN 08 Schijnpoortweg
675,Schijnpoortweg,2023-08-20,17:00:00,4,2,2,FMN 08 Schijnpoortweg
675,Schijnpoortweg,2023-08-20,18:00:00,2,0,2,FMN 08 Schijnpoortweg
675,Schijnpoortweg,2023-08-20,19:00:00,5,3,2,FMN 08 Schijnpoortweg
675,Schijnpoortweg,2023-08-20,20:00:00,6,1,5,FMN 08 Schijnpoortweg
675,Schijnpoortweg,2023-08-20,21:00:00,3,1,2,FMN 08 Schijnpoortweg
675,Schijnpoortweg,2023-08-20,22:00:00,5,2,3,FMN 08 Schijnpoortweg
675,Schijnpoortweg,2023-08-20,23:00:00,1,0,1,FMN 08 Schijnpoortweg
675,Schijnpoortweg,2023-08-21,00:00:00,1,0,1,FMN 08 Schijnpoortweg
675,Schijnpoortweg,2023-08-21,01:00:00,1,0,1,FMN 08 Schijnpoortweg
675,Schijnpoortweg,2023-08-21,02:00:00,0,0,0,FMN 08 Schijnpoortweg
675,Schijnpoortweg,2023-08-21,03:00:00,1,1,0,FMN 08 Schijnpoortweg
675,Schijnpoortweg,2023-08-21,04:00:00,3,0,3,FMN 08 Schijnpoortweg
675,Schijnpoortweg,2023-08-21,05:00:00,1,0,1,FMN 08 Schijnpoortweg
675,Schijnpoortweg,2023-08-21,06:00:00,2,1,1,FMN 08 Schijnpoortweg
675,Schijnpoortweg,2023-08-21,07:00:00,2,1,1,FMN 08 Schijnpoortweg
675,Schijnpoortweg,2023-08-21,08:00:00,0,0,0,FMN 08 Schijnpoortweg
675,Schijnpoortweg,2023-08-21,09:00:00,6,1,5,FMN 08 Schijnpoortweg
675,Schijnpoortweg,2023-08-21,10:00:00,2,1,1,FMN 08 Schijnpoortweg
675,Schijnpoortweg,2023-08-21,11:00:00,0,0,0,FMN 08 Schijnpoortweg
675,Schijnpoortweg,2023-08-21,12:00:00,3,1,2,FMN 08 Schijnpoortweg
675,Schijnpoortweg,2023-08-21,13:00:00,1,0,1,FMN 08 Schijnpoortweg
675,Schijnpoortweg,2023-08-21,14:00:00,1,0,1,FMN 08 Schijnpoortweg
675,Schijnpoortweg,2023-08-21,15:00:00,3,2,1,FMN 08 Schijnpoortweg
675,Schijnpoortweg,2023-08-21,16:00:00,5,3,2,FMN 08 Schijnpoortweg
675,Schijnpoortweg,2023-08-21,17:00:00,10,3,7,FMN 08 Schijnpoortweg
675,Schijnpoortweg,2023-08-21,18:00:00,10,5,5,FMN 08 Schijnpoortweg
675,Schijnpoortweg,2023-08-21,19:00:00,3,1,2,FMN 08 Schijnpoortweg
675,Schijnpoortweg,2023-08-21,20:00:00,1,1,0,FMN 08 Schijnpoortweg
675,Schijnpoortweg,2023-08-21,21:00:00,4,1,3,FMN 08 Schijnpoortweg
675,Schijnpoortweg,2023-08-21,22:00:00,3,2,1,FMN 08 Schijnpoortweg
675,Schijnpoortweg,2023-08-21,23:00:00,2,0,2,FMN 08 Schijnpoortweg
675,Schijnpoortweg,2023-08-22,00:00:00,4,2,2,FMN 08 Schijnpoortweg
675,Schijnpoortweg,2023-08-22,01:00:00,1,0,1,FMN 08 Schijnpoortweg
675,Schijnpoortweg,2023-08-22,02:00:00,0,0,0,FMN 08 Schijnpoortweg
675,Schijnpoortweg,2023-08-22,03:00:00,1,0,1,FMN 08 Schijnpoortweg
675,Schijnpoortweg,2023-08-22,04:00:00,0,0,0,FMN 08 Schijnpoortweg
675,Schijnpoortweg,2023-08-22,05:00:00,1,0,1,FMN 08 Schijnpoortweg
675,Schijnpoortweg,2023-08-22,06:00:00,1,0,1,FMN 08 Schijnpoortweg
675,Schijnpoortweg,2023-08-22,07:00:00,2,0,2,FMN 08 Schijnpoortweg
675,Schijnpoortweg,2023-08-22,08:00:00,1,1,0,FMN 08 Schijnpoortweg
675,Schijnpoortweg,2023-08-22,09:00:00,3,0,3,FMN 08 Schijnpoortweg
675,Schijnpoortweg,2023-08-22,10:00:00,2,0,2,FMN 08 Schijnpoortweg
675,Schijnpoortweg,2023-08-22,11:00:00,1,1,0,FMN 08 Schijnpoortweg
675,Schijnpoortweg,2023-08-22,12:00:00,6,0,6,FMN 08 Schijnpoortweg
675,Schijnpoortweg,2023-08-22,13:00:00,3,0,3,FMN 08 Schijnpoortweg
675,Schijnpoortweg,2023-08-22,14:00:00,0,0,0,FMN 08 Schijnpoortweg
675,Schijnpoortweg,2023-08-22,15:00:00,2,0,2,FMN 08 Schijnpoortweg
675,Schijnpoortweg,2023-08-22,16:00:00,7,3,4,FMN 08 Schijnpoortweg
675,Schijnpoortweg,2023-08-22,17:00:00,6,1,5,FMN 08 Schijnpoortweg
675,Schijnpoortweg,2023-08-22,18:00:00,7,2,5,FMN 08 Schijnpoortweg
675,Schijnpoortweg,2023-08-22,19:00:00,5,1,4,FMN 08 Schijnpoortweg
675,Schijnpoortweg,2023-08-22,20:00:00,3,0,3,FMN 08 Schijnpoortweg
675,Schijnpoortweg,2023-08-22,21:00:00,5,1,4,FMN 08 Schijnpoortweg
675,Schijnpoortweg,2023-08-22,22:00:00,3,2,1,FMN 08 Schijnpoortweg
675,Schijnpoortweg,2023-08-22,23:00:00,4,0,4,FMN 08 Schijnpoortweg
675,Schijnpoortweg,2023-08-23,00:00:00,2,1,1,FMN 08 Schijnpoortweg
675,Schijnpoortweg,2023-08-23,01:00:00,2,1,1,FMN 08 Schijnpoortweg
675,Schijnpoortweg,2023-08-23,02:00:00,0,0,0,FMN 08 Schijnpoortweg
675,Schijnpoortweg,2023-08-23,03:00:00,2,0,2,FMN 08 Schijnpoortweg
675,Schijnpoortweg,2023-08-23,04:00:00,1,1,0,FMN 08 Schijnpoortweg
675,Schijnpoortweg,2023-08-23,05:00:00,4,2,2,FMN 08 Schijnpoortweg
675,Schijnpoortweg,2023-08-23,06:00:00,2,1,1,FMN 08 Schijnpoortweg
675,Schijnpoortweg,2023-08-23,07:00:00,1,1,0,FMN 08 Schijnpoortweg
675,Schijnpoortweg,2023-08-23,08:00:00,0,0,0,FMN 08 Schijnpoortweg
675,Schijnpoortweg,2023-08-23,09:00:00,2,0,2,FMN 08 Schijnpoortweg
675,Schijnpoortweg,2023-08-23,10:00:00,3,2,1,FMN 08 Schijnpoortweg
675,Schijnpoortweg,2023-08-23,11:00:00,1,0,1,FMN 08 Schijnpoortweg
675,Schijnpoortweg,2023-08-23,12:00:00,2,0,2,FMN 08 Schijnpoortweg
675,Schijnpoortweg,2023-08-23,13:00:00,3,1,2,FMN 08 Schijnpoortweg
675,Schijnpoortweg,2023-08-23,14:00:00,4,2,2,FMN 08 Schijnpoortweg
675,Schijnpoortweg,2023-08-23,15:00:00,5,1,4,FMN 08 Schijnpoortweg
675,Schijnpoortweg,2023-08-23,16:00:00,5,1,4,FMN 08 Schijnpoortweg
675,Schijnpoortweg,2023-08-23,17:00:00,5,2,3,FMN 08 Schijnpoortweg
675,Schijnpoortweg,2023-08-23,18:00:00,8,1,7,FMN 08 Schijnpoortweg
675,Schijnpoortweg,2023-08-23,19:00:00,5,1,4,FMN 08 Schijnpoortweg
675,Schijnpoortweg,2023-08-23,20:00:00,4,2,2,FMN 08 Schijnpoortweg
675,Schijnpoortweg,2023-08-23,21:00:00,10,6,4,FMN 08 Schijnpoortweg
675,Schijnpoortweg,2023-08-23,22:00:00,5,2,3,FMN 08 Schijnpoortweg
675,Schijnpoortweg,2023-08-23,23:00:00,3,0,3,FMN 08 Schijnpoortweg
675,Schijnpoortweg,2023-08-24,00:00:00,1,1,0,FMN 08 Schijnpoortweg
675,Schijnpoortweg,2023-08-24,01:00:00,0,0,0,FMN 08 Schijnpoortweg
675,Schijnpoortweg,2023-08-24,02:00:00,1,0,1,FMN 08 Schijnpoortweg
675,Schijnpoortweg,2023-08-24,03:00:00,1,0,1,FMN 08 Schijnpoortweg
675,Schijnpoortweg,2023-08-24,04:00:00,1,1,0,FMN 08 Schijnpoortweg
675,Schijnpoortweg,2023-08-24,05:00:00,2,2,0,FMN 08 Schijnpoortweg
675,Schijnpoortweg,2023-08-24,06:00:00,2,0,2,FMN 08 Schijnpoortweg
675,Schijnpoortweg,2023-08-24,07:00:00,0,0,0,FMN 08 Schijnpoortweg
675,Schijnpoortweg,2023-08-24,08:00:00,2,1,1,FMN 08 Schijnpoortweg
675,Schijnpoortweg,2023-08-24,09:00:00,2,0,2,FMN 08 Schijnpoortweg
675,Schijnpoortweg,2023-08-24,10:00:00,3,1,2,FMN 08 Schijnpoortweg
675,Schijnpoortweg,2023-08-24,11:00:00,2,0,2,FMN 08 Schijnpoortweg
675,Schijnpoortweg,2023-08-24,12:00:00,0,0,0,FMN 08 Schijnpoortweg
675,Schijnpoortweg,2023-08-24,13:00:00,2,0,2,FMN 08 Schijnpoortweg
675,Schijnpoortweg,2023-08-24,14:00:00,0,0,0,FMN 08 Schijnpoortweg
675,Schijnpoortweg,2023-08-24,15:00:00,4,2,2,FMN 08 Schijnpoortweg
675,Schijnpoortweg,2023-08-24,16:00:00,6,1,5,FMN 08 Schijnpoortweg
675,Schijnpoortweg,2023-08-24,17:00:00,3,1,2,FMN 08 Schijnpoortweg
675,Schijnpoortweg,2023-08-24,18:00:00,8,3,5,FMN 08 Schijnpoortweg
675,Schijnpoortweg,2023-08-24,19:00:00,10,2,8,FMN 08 Schijnpoortweg
675,Schijnpoortweg,2023-08-24,20:00:00,4,1,3,FMN 08 Schijnpoortweg
675,Schijnpoortweg,2023-08-24,21:00:00,4,3,1,FMN 08 Schijnpoortweg
675,Schijnpoortweg,2023-08-24,22:00:00,1,1,0,FMN 08 Schijnpoortweg
675,Schijnpoortweg,2023-08-24,23:00:00,3,0,3,FMN 08 Schijnpoortweg
675,Schijnpoortweg,2023-08-25,00:00:00,2,0,2,FMN 08 Schijnpoortweg
675,Schijnpoortweg,2023-08-25,01:00:00,0,0,0,FMN 08 Schijnpoortweg
675,Schijnpoortweg,2023-08-25,02:00:00,0,0,0,FMN 08 Schijnpoortweg
675,Schijnpoortweg,2023-08-25,03:00:00,0,0,0,FMN 08 Schijnpoortweg
675,Schijnpoortweg,2023-08-25,04:00:00,1,1,0,FMN 08 Schijnpoortweg
675,Schijnpoortweg,2023-08-25,05:00:00,1,1,0,FMN 08 Schijnpoortweg
675,Schijnpoortweg,2023-08-25,06:00:00,6,2,4,FMN 08 Schijnpoortweg
675,Schijnpoortweg,2023-08-25,07:00:00,3,1,2,FMN 08 Schijnpoortweg
675,Schijnpoortweg,2023-08-25,08:00:00,2,2,0,FMN 08 Schijnpoortweg
675,Schijnpoortweg,2023-08-25,09:00:00,1,0,1,FMN 08 Schijnpoortweg
675,Schijnpoortweg,2023-08-25,10:00:00,3,0,3,FMN 08 Schijnpoortweg
675,Schijnpoortweg,2023-08-25,11:00:00,6,3,3,FMN 08 Schijnpoortweg
675,Schijnpoortweg,2023-08-25,12:00:00,0,0,0,FMN 08 Schijnpoortweg
675,Schijnpoortweg,2023-08-25,13:00:00,3,0,3,FMN 08 Schijnpoortweg
675,Schijnpoortweg,2023-08-25,14:00:00,4,2,2,FMN 08 Schijnpoortweg
675,Schijnpoortweg,2023-08-25,15:00:00,2,0,2,FMN 08 Schijnpoortweg
675,Schijnpoortweg,2023-08-25,16:00:00,4,1,3,FMN 08 Schijnpoortweg
675,Schijnpoortweg,2023-08-25,17:00:00,4,0,4,FMN 08 Schijnpoortweg
675,Schijnpoortweg,2023-08-25,18:00:00,8,2,6,FMN 08 Schijnpoortweg
675,Schijnpoortweg,2023-08-25,19:00:00,5,1,4,FMN 08 Schijnpoortweg
675,Schijnpoortweg,2023-08-25,20:00:00,3,0,3,FMN 08 Schijnpoortweg
675,Schijnpoortweg,2023-08-25,21:00:00,2,1,1,FMN 08 Schijnpoortweg
675,Schijnpoortweg,2023-08-25,22:00:00,1,1,0,FMN 08 Schijnpoortweg
675,Schijnpoortweg,2023-08-25,23:00:00,3,0,3,FMN 08 Schijnpoortweg
675,Schijnpoortweg,2023-08-26,00:00:00,2,0,2,FMN 08 Schijnpoortweg
675,Schijnpoortweg,2023-08-26,01:00:00,0,0,0,FMN 08 Schijnpoortweg
675,Schijnpoortweg,2023-08-26,02:00:00,2,0,2,FMN 08 Schijnpoortweg
675,Schijnpoortweg,2023-08-26,03:00:00,1,0,1,FMN 08 Schijnpoortweg
675,Schijnpoortweg,2023-08-26,04:00:00,1,1,0,FMN 08 Schijnpoortweg
675,Schijnpoortweg,2023-08-26,05:00:00,2,2,0,FMN 08 Schijnpoortweg
675,Schijnpoortweg,2023-08-26,06:00:00,1,1,0,FMN 08 Schijnpoortweg
675,Schijnpoortweg,2023-08-26,07:00:00,3,2,1,FMN 08 Schijnpoortweg
675,Schijnpoortweg,2023-08-26,08:00:00,1,1,0,FMN 08 Schijnpoortweg
675,Schijnpoortweg,2023-08-26,09:00:00,1,1,0,FMN 08 Schijnpoortweg
675,Schijnpoortweg,2023-08-26,10:00:00,4,0,4,FMN 08 Schijnpoortweg
675,Schijnpoortweg,2023-08-26,11:00:00,1,0,1,FMN 08 Schijnpoortweg
675,Schijnpoortweg,2023-08-26,12:00:00,2,2,0,FMN 08 Schijnpoortweg
675,Schijnpoortweg,2023-08-26,13:00:00,3,2,1,FMN 08 Schijnpoortweg
675,Schijnpoortweg,2023-08-26,14:00:00,3,0,3,FMN 08 Schijnpoortweg
675,Schijnpoortweg,2023-08-26,15:00:00,2,0,2,FMN 08 Schijnpoortweg
675,Schijnpoortweg,2023-08-26,16:00:00,2,1,1,FMN 08 Schijnpoortweg
675,Schijnpoortweg,2023-08-26,17:00:00,6,3,3,FMN 08 Schijnpoortweg
675,Schijnpoortweg,2023-08-26,18:00:00,2,1,1,FMN 08 Schijnpoortweg
675,Schijnpoortweg,2023-08-26,19:00:00,1,0,1,FMN 08 Schijnpoortweg
675,Schijnpoortweg,2023-08-26,20:00:00,1,1,0,FMN 08 Schijnpoortweg
675,Schijnpoortweg,2023-08-26,21:00:00,5,5,0,FMN 08 Schijnpoortweg
675,Schijnpoortweg,2023-08-26,22:00:00,2,2,0,FMN 08 Schijnpoortweg
675,Schijnpoortweg,2023-08-26,23:00:00,4,0,4,FMN 08 Schijnpoortweg
675,Schijnpoortweg,2023-08-27,00:00:00,3,0,3,FMN 08 Schijnpoortweg
675,Schijnpoortweg,2023-08-27,01:00:00,2,1,1,FMN 08 Schijnpoortweg
675,Schijnpoortweg,2023-08-27,02:00:00,0,0,0,FMN 08 Schijnpoortweg
675,Schijnpoortweg,2023-08-27,03:00:00,0,0,0,FMN 08 Schijnpoortweg
675,Schijnpoortweg,2023-08-27,04:00:00,1,1,0,FMN 08 Schijnpoortweg
675,Schijnpoortweg,2023-08-27,05:00:00,1,1,0,FMN 08 Schijnpoortweg
675,Schijnpoortweg,2023-08-27,06:00:00,0,0,0,FMN 08 Schijnpoortweg
675,Schijnpoortweg,2023-08-27,07:00:00,0,0,0,FMN 08 Schijnpoortweg
675,Schijnpoortweg,2023-08-27,08:00:00,0,0,0,FMN 08 Schijnpoortweg
675,Schijnpoortweg,2023-08-27,09:00:00,2,2,0,FMN 08 Schijnpoortweg
675,Schijnpoortweg,2023-08-27,10:00:00,0,0,0,FMN 08 Schijnpoortweg
675,Schijnpoortweg,2023-08-27,11:00:00,1,1,0,FMN 08 Schijnpoortweg
675,Schijnpoortweg,2023-08-27,12:00:00,2,0,2,FMN 08 Schijnpoortweg
675,Schijnpoortweg,2023-08-27,13:00:00,3,0,3,FMN 08 Schijnpoortweg
675,Schijnpoortweg,2023-08-27,14:00:00,4,1,3,FMN 08 Schijnpoortweg
675,Schijnpoortweg,2023-08-27,15:00:00,3,3,0,FMN 08 Schijnpoortweg
675,Schijnpoortweg,2023-08-27,16:00:00,3,1,2,FMN 08 Schijnpoortweg
675,Schijnpoortweg,2023-08-27,17:00:00,5,2,3,FMN 08 Schijnpoortweg
675,Schijnpoortweg,2023-08-27,18:00:00,4,2,2,FMN 08 Schijnpoortweg
675,Schijnpoortweg,2023-08-27,19:00:00,7,1,6,FMN 08 Schijnpoortweg
675,Schijnpoortweg,2023-08-27,20:00:00,5,1,4,FMN 08 Schijnpoortweg
675,Schijnpoortweg,2023-08-27,21:00:00,8,0,8,FMN 08 Schijnpoortweg
675,Schijnpoortweg,2023-08-27,22:00:00,3,1,2,FMN 08 Schijnpoortweg
675,Schijnpoortweg,2023-08-27,23:00:00,1,0,1,FMN 08 Schijnpoortweg
675,Schijnpoortweg,2023-08-28,00:00:00,2,0,2,FMN 08 Schijnpoortweg
675,Schijnpoortweg,2023-08-28,01:00:00,1,1,0,FMN 08 Schijnpoortweg
675,Schijnpoortweg,2023-08-28,02:00:00,1,0,1,FMN 08 Schijnpoortweg
675,Schijnpoortweg,2023-08-28,03:00:00,1,1,0,FMN 08 Schijnpoortweg
675,Schijnpoortweg,2023-08-28,04:00:00,1,0,1,FMN 08 Schijnpoortweg
675,Schijnpoortweg,2023-08-28,05:00:00,3,0,3,FMN 08 Schijnpoortweg
675,Schijnpoortweg,2023-08-28,06:00:00,5,3,2,FMN 08 Schijnpoortweg
675,Schijnpoortweg,2023-08-28,07:00:00,3,1,2,FMN 08 Schijnpoortweg
675,Schijnpoortweg,2023-08-28,08:00:00,3,2,1,FMN 08 Schijnpoortweg
675,Schijnpoortweg,2023-08-28,09:00:00,0,0,0,FMN 08 Schijnpoortweg
675,Schijnpoortweg,2023-08-28,10:00:00,3,2,1,FMN 08 Schijnpoortweg
675,Schijnpoortweg,2023-08-28,11:00:00,3,2,1,FMN 08 Schijnpoortweg
675,Schijnpoortweg,2023-08-28,12:00:00,1,1,0,FMN 08 Schijnpoortweg
675,Schijnpoortweg,2023-08-28,13:00:00,3,0,3,FMN 08 Schijnpoortweg
675,Schijnpoortweg,2023-08-28,14:00:00,1,1,0,FMN 08 Schijnpoortweg
675,Schijnpoortweg,2023-08-28,15:00:00,5,1,4,FMN 08 Schijnpoortweg
675,Schijnpoortweg,2023-08-28,16:00:00,6,1,5,FMN 08 Schijnpoortweg
675,Schijnpoortweg,2023-08-28,17:00:00,9,3,6,FMN 08 Schijnpoortweg
675,Schijnpoortweg,2023-08-28,18:00:00,1,0,1,FMN 08 Schijnpoortweg
675,Schijnpoortweg,2023-08-28,19:00:00,4,1,3,FMN 08 Schijnpoortweg
675,Schijnpoortweg,2023-08-28,20:00:00,1,0,1,FMN 08 Schijnpoortweg
675,Schijnpoortweg,2023-08-28,21:00:00,4,1,3,FMN 08 Schijnpoortweg
675,Schijnpoortweg,2023-08-28,22:00:00,3,0,3,FMN 08 Schijnpoortweg
675,Schijnpoortweg,2023-08-28,23:00:00,1,0,1,FMN 08 Schijnpoortweg
675,Schijnpoortweg,2023-08-29,00:00:00,0,0,0,FMN 08 Schijnpoortweg
675,Schijnpoortweg,2023-08-29,01:00:00,1,0,1,FMN 08 Schijnpoortweg
675,Schijnpoortweg,2023-08-29,02:00:00,0,0,0,FMN 08 Schijnpoortweg
675,Schijnpoortweg,2023-08-29,03:00:00,0,0,0,FMN 08 Schijnpoortweg
675,Schijnpoortweg,2023-08-29,04:00:00,1,1,0,FMN 08 Schijnpoortweg
675,Schijnpoortweg,2023-08-29,05:00:00,6,1,5,FMN 08 Schijnpoortweg
675,Schijnpoortweg,2023-08-29,06:00:00,2,1,1,FMN 08 Schijnpoortweg
675,Schijnpoortweg,2023-08-29,07:00:00,2,0,2,FMN 08 Schijnpoortweg
675,Schijnpoortweg,2023-08-29,08:00:00,4,3,1,FMN 08 Schijnpoortweg
675,Schijnpoortweg,2023-08-29,09:00:00,1,0,1,FMN 08 Schijnpoortweg
675,Schijnpoortweg,2023-08-29,10:00:00,5,2,3,FMN 08 Schijnpoortweg
675,Schijnpoortweg,2023-08-29,11:00:00,1,0,1,FMN 08 Schijnpoortweg
675,Schijnpoortweg,2023-08-29,12:00:00,3,2,1,FMN 08 Schijnpoortweg
675,Schijnpoortweg,2023-08-29,13:00:00,1,1,0,FMN 08 Schijnpoortweg
675,Schijnpoortweg,2023-08-29,14:00:00,6,1,5,FMN 08 Schijnpoortweg
675,Schijnpoortweg,2023-08-29,15:00:00,5,1,4,FMN 08 Schijnpoortweg
675,Schijnpoortweg,2023-08-29,16:00:00,4,0,4,FMN 08 Schijnpoortweg
675,Schijnpoortweg,2023-08-29,17:00:00,7,4,3,FMN 08 Schijnpoortweg
675,Schijnpoortweg,2023-08-29,18:00:00,7,3,4,FMN 08 Schijnpoortweg
675,Schijnpoortweg,2023-08-29,19:00:00,4,1,3,FMN 08 Schijnpoortweg
675,Schijnpoortweg,2023-08-29,20:00:00,5,2,3,FMN 08 Schijnpoortweg
675,Schijnpoortweg,2023-08-29,21:00:00,3,0,3,FMN 08 Schijnpoortweg
675,Schijnpoortweg,2023-08-29,22:00:00,5,2,3,FMN 08 Schijnpoortweg
675,Schijnpoortweg,2023-08-29,23:00:00,2,1,1,FMN 08 Schijnpoortweg
675,Schijnpoortweg,2023-08-30,00:00:00,2,0,2,FMN 08 Schijnpoortweg
675,Schijnpoortweg,2023-08-30,01:00:00,2,1,1,FMN 08 Schijnpoortweg
675,Schijnpoortweg,2023-08-30,02:00:00,0,0,0,FMN 08 Schijnpoortweg
675,Schijnpoortweg,2023-08-30,03:00:00,2,1,1,FMN 08 Schijnpoortweg
675,Schijnpoortweg,2023-08-30,04:00:00,4,1,3,FMN 08 Schijnpoortweg
675,Schijnpoortweg,2023-08-30,05:00:00,4,2,2,FMN 08 Schijnpoortweg
675,Schijnpoortweg,2023-08-30,06:00:00,1,0,1,FMN 08 Schijnpoortweg
675,Schijnpoortweg,2023-08-30,07:00:00,2,2,0,FMN 08 Schijnpoortweg
675,Schijnpoortweg,2023-08-30,08:00:00,2,0,2,FMN 08 Schijnpoortweg
675,Schijnpoortweg,2023-08-30,09:00:00,2,1,1,FMN 08 Schijnpoortweg
675,Schijnpoortweg,2023-08-30,10:00:00,2,1,1,FMN 08 Schijnpoortweg
675,Schijnpoortweg,2023-08-30,11:00:00,2,0,2,FMN 08 Schijnpoortweg
675,Schijnpoortweg,2023-08-30,12:00:00,1,0,1,FMN 08 Schijnpoortweg
675,Schijnpoortweg,2023-08-30,13:00:00,4,3,1,FMN 08 Schijnpoortweg
675,Schijnpoortweg,2023-08-30,14:00:00,2,0,2,FMN 08 Schijnpoortweg
675,Schijnpoortweg,2023-08-30,15:00:00,6,1,5,FMN 08 Schijnpoortweg
675,Schijnpoortweg,2023-08-30,16:00:00,2,2,0,FMN 08 Schijnpoortweg
675,Schijnpoortweg,2023-08-30,17:00:00,8,2,6,FMN 08 Schijnpoortweg
675,Schijnpoortweg,2023-08-30,18:00:00,7,1,6,FMN 08 Schijnpoortweg
675,Schijnpoortweg,2023-08-30,19:00:00,6,4,2,FMN 08 Schijnpoortweg
675,Schijnpoortweg,2023-08-30,20:00:00,3,1,2,FMN 08 Schijnpoortweg
675,Schijnpoortweg,2023-08-30,21:00:00,3,2,1,FMN 08 Schijnpoortweg
675,Schijnpoortweg,2023-08-30,22:00:00,2,0,2,FMN 08 Schijnpoortweg
675,Schijnpoortweg,2023-08-30,23:00:00,0,0,0,FMN 08 Schijnpoortweg
675,Schijnpoortweg,2023-08-31,00:00:00,1,0,1,FMN 08 Schijnpoortweg
675,Schijnpoortweg,2023-08-31,01:00:00,1,0,1,FMN 08 Schijnpoortweg
675,Schijnpoortweg,2023-08-31,02:00:00,2,0,2,FMN 08 Schijnpoortweg
675,Schijnpoortweg,2023-08-31,03:00:00,0,0,0,FMN 08 Schijnpoortweg
675,Schijnpoortweg,2023-08-31,04:00:00,1,1,0,FMN 08 Schijnpoortweg
675,Schijnpoortweg,2023-08-31,05:00:00,3,0,3,FMN 08 Schijnpoortweg
675,Schijnpoortweg,2023-08-31,06:00:00,2,0,2,FMN 08 Schijnpoortweg
675,Schijnpoortweg,2023-08-31,07:00:00,2,1,1,FMN 08 Schijnpoortweg
675,Schijnpoortweg,2023-08-31,08:00:00,6,4,2,FMN 08 Schijnpoortweg
675,Schijnpoortweg,2023-08-31,09:00:00,2,1,1,FMN 08 Schijnpoortweg
675,Schijnpoortweg,2023-08-31,10:00:00,2,0,2,FMN 08 Schijnpoortweg
675,Schijnpoortweg,2023-08-31,11:00:00,0,0,0,FMN 08 Schijnpoortweg
675,Schijnpoortweg,2023-08-31,12:00:00,0,0,0,FMN 08 Schijnpoortweg
675,Schijnpoortweg,2023-08-31,13:00:00,3,1,2,FMN 08 Schijnpoortweg
675,Schijnpoortweg,2023-08-31,14:00:00,4,2,2,FMN 08 Schijnpoortweg
675,Schijnpoortweg,2023-08-31,15:00:00,7,1,6,FMN 08 Schijnpoortweg
675,Schijnpoortweg,2023-08-31,16:00:00,7,3,4,FMN 08 Schijnpoortweg
675,Schijnpoortweg,2023-08-31,17:00:00,8,1,7,FMN 08 Schijnpoortweg
675,Schijnpoortweg,2023-08-31,18:00:00,7,5,2,FMN 08 Schijnpoortweg
675,Schijnpoortweg,2023-08-31,19:00:00,10,4,6,FMN 08 Schijnpoortweg
675,Schijnpoortweg,2023-08-31,20:00:00,4,1,3,FMN 08 Schijnpoortweg
675,Schijnpoortweg,2023-08-31,21:00:00,5,1,4,FMN 08 Schijnpoortweg
675,Schijnpoortweg,2023-08-31,22:00:00,1,0,1,FMN 08 Schijnpoortweg
675,Schijnpoortweg,2023-08-31,23:00:00,1,0,1,FMN 08 Schijnpoortweg
675,Schijnpoortweg,2023-09-01,00:00:00,1,0,1,FMN 08 Schijnpoortweg
675,Schijnpoortweg,2023-09-01,01:00:00,0,0,0,FMN 08 Schijnpoortweg
675,Schijnpoortweg,2023-09-01,02:00:00,1,1,0,FMN 08 Schijnpoortweg
675,Schijnpoortweg,2023-09-01,03:00:00,0,0,0,FMN 08 Schijnpoortweg
675,Schijnpoortweg,2023-09-01,04:00:00,3,1,2,FMN 08 Schijnpoortweg
675,Schijnpoortweg,2023-09-01,05:00:00,1,0,1,FMN 08 Schijnpoortweg
675,Schijnpoortweg,2023-09-01,06:00:00,3,0,3,FMN 08 Schijnpoortweg
675,Schijnpoortweg,2023-09-01,07:00:00,2,1,1,FMN 08 Schijnpoortweg
675,Schijnpoortweg,2023-09-01,08:00:00,2,1,1,FMN 08 Schijnpoortweg
675,Schijnpoortweg,2023-09-01,09:00:00,4,1,3,FMN 08 Schijnpoortweg
675,Schijnpoortweg,2023-09-01,10:00:00,3,1,2,FMN 08 Schijnpoortweg
675,Schijnpoortweg,2023-09-01,11:00:00,2,0,2,FMN 08 Schijnpoortweg
675,Schijnpoortweg,2023-09-01,12:00:00,1,0,1,FMN 08 Schijnpoortweg
675,Schijnpoortweg,2023-09-01,13:00:00,1,0,1,FMN 08 Schijnpoortweg
675,Schijnpoortweg,2023-09-01,14:00:00,3,3,0,FMN 08 Schijnpoortweg
675,Schijnpoortweg,2023-09-01,15:00:00,1,1,0,FMN 08 Schijnpoortweg
675,Schijnpoortweg,2023-09-01,16:00:00,4,1,3,FMN 08 Schijnpoortweg
675,Schijnpoortweg,2023-09-01,17:00:00,7,3,4,FMN 08 Schijnpoortweg
675,Schijnpoortweg,2023-09-01,18:00:00,7,3,4,FMN 08 Schijnpoortweg
675,Schijnpoortweg,2023-09-01,19:00:00,4,0,4,FMN 08 Schijnpoortweg
675,Schijnpoortweg,2023-09-01,20:00:00,9,2,7,FMN 08 Schijnpoortweg
675,Schijnpoortweg,2023-09-01,21:00:00,6,0,6,FMN 08 Schijnpoortweg
675,Schijnpoortweg,2023-09-01,22:00:00,6,1,5,FMN 08 Schijnpoortweg
675,Schijnpoortweg,2023-09-01,23:00:00,3,0,3,FMN 08 Schijnpoortweg
675,Schijnpoortweg,2023-09-02,00:00:00,2,1,1,FMN 08 Schijnpoortweg
675,Schijnpoortweg,2023-09-02,01:00:00,1,0,1,FMN 08 Schijnpoortweg
675,Schijnpoortweg,2023-09-02,02:00:00,1,0,1,FMN 08 Schijnpoortweg
675,Schijnpoortweg,2023-09-02,03:00:00,0,0,0,FMN 08 Schijnpoortweg
675,Schijnpoortweg,2023-09-02,04:00:00,0,0,0,FMN 08 Schijnpoortweg
675,Schijnpoortweg,2023-09-02,05:00:00,1,1,0,FMN 08 Schijnpoortweg
675,Schijnpoortweg,2023-09-02,06:00:00,3,2,1,FMN 08 Schijnpoortweg
675,Schijnpoortweg,2023-09-02,07:00:00,2,1,1,FMN 08 Schijnpoortweg
675,Schijnpoortweg,2023-09-02,08:00:00,1,1,0,FMN 08 Schijnpoortweg
675,Schijnpoortweg,2023-09-02,09:00:00,1,1,0,FMN 08 Schijnpoortweg
675,Schijnpoortweg,2023-09-02,10:00:00,0,0,0,FMN 08 Schijnpoortweg
675,Schijnpoortweg,2023-09-02,11:00:00,3,2,1,FMN 08 Schijnpoortweg
675,Schijnpoortweg,2023-09-02,12:00:00,1,0,1,FMN 08 Schijnpoortweg
675,Schijnpoortweg,2023-09-02,13:00:00,1,0,1,FMN 08 Schijnpoortweg
675,Schijnpoortweg,2023-09-02,14:00:00,6,1,5,FMN 08 Schijnpoortweg
675,Schijnpoortweg,2023-09-02,15:00:00,2,1,1,FMN 08 Schijnpoortweg
675,Schijnpoortweg,2023-09-02,16:00:00,12,4,8,FMN 08 Schijnpoortweg
675,Schijnpoortweg,2023-09-02,17:00:00,5,2,3,FMN 08 Schijnpoortweg
675,Schijnpoortweg,2023-09-02,18:00:00,9,3,6,FMN 08 Schijnpoortweg
675,Schijnpoortweg,2023-09-02,19:00:00,6,4,2,FMN 08 Schijnpoortweg
675,Schijnpoortweg,2023-09-02,20:00:00,1,1,0,FMN 08 Schijnpoortweg
675,Schijnpoortweg,2023-09-02,21:00:00,8,2,6,FMN 08 Schijnpoortweg
675,Schijnpoortweg,2023-09-02,22:00:00,3,1,2,FMN 08 Schijnpoortweg
675,Schijnpoortweg,2023-09-02,23:00:00,4,1,3,FMN 08 Schijnpoortweg
675,Schijnpoortweg,2023-09-03,00:00:00,4,2,2,FMN 08 Schijnpoortweg
675,Schijnpoortweg,2023-09-03,01:00:00,1,0,1,FMN 08 Schijnpoortweg
675,Schijnpoortweg,2023-09-03,02:00:00,3,1,2,FMN 08 Schijnpoortweg
675,Schijnpoortweg,2023-09-03,03:00:00,2,0,2,FMN 08 Schijnpoortweg
675,Schijnpoortweg,2023-09-03,04:00:00,2,1,1,FMN 08 Schijnpoortweg
675,Schijnpoortweg,2023-09-03,05:00:00,0,0,0,FMN 08 Schijnpoortweg
675,Schijnpoortweg,2023-09-03,06:00:00,1,1,0,FMN 08 Schijnpoortweg
675,Schijnpoortweg,2023-09-03,07:00:00,1,0,1,FMN 08 Schijnpoortweg
675,Schijnpoortweg,2023-09-03,08:00:00,2,0,2,FMN 08 Schijnpoortweg
675,Schijnpoortweg,2023-09-03,09:00:00,2,1,1,FMN 08 Schijnpoortweg
675,Schijnpoortweg,2023-09-03,10:00:00,2,0,2,FMN 08 Schijnpoortweg
675,Schijnpoortweg,2023-09-03,11:00:00,3,1,2,FMN 08 Schijnpoortweg
675,Schijnpoortweg,2023-09-03,12:00:00,1,0,1,FMN 08 Schijnpoortweg
675,Schijnpoortweg,2023-09-03,13:00:00,4,3,1,FMN 08 Schijnpoortweg
675,Schijnpoortweg,2023-09-03,14:00:00,4,0,4,FMN 08 Schijnpoortweg
675,Schijnpoortweg,2023-09-03,15:00:00,6,3,3,FMN 08 Schijnpoortweg
675,Schijnpoortweg,2023-09-03,16:00:00,5,3,2,FMN 08 Schijnpoortweg
675,Schijnpoortweg,2023-09-03,17:00:00,7,0,7,FMN 08 Schijnpoortweg
675,Schijnpoortweg,2023-09-03,18:00:00,3,1,2,FMN 08 Schijnpoortweg
675,Schijnpoortweg,2023-09-03,19:00:00,4,2,2,FMN 08 Schijnpoortweg
675,Schijnpoortweg,2023-09-03,20:00:00,7,4,3,FMN 08 Schijnpoortweg
675,Schijnpoortweg,2023-09-03,21:00:00,4,1,3,FMN 08 Schijnpoortweg
675,Schijnpoortweg,2023-09-03,22:00:00,7,2,5,FMN 08 Schijnpoortweg
675,Schijnpoortweg,2023-09-03,23:00:00,1,0,1,FMN 08 Schijnpoortweg
675,Schijnpoortweg,2023-09-04,00:00:00,1,1,0,FMN 08 Schijnpoortweg
675,Schijnpoortweg,2023-09-04,01:00:00,1,0,1,FMN 08 Schijnpoortweg
675,Schijnpoortweg,2023-09-04,02:00:00,0,0,0,FMN 08 Schijnpoortweg
675,Schijnpoortweg,2023-09-04,03:00:00,1,1,0,FMN 08 Schijnpoortweg
675,Schijnpoortweg,2023-09-04,04:00:00,2,0,2,FMN 08 Schijnpoortweg
675,Schijnpoortweg,2023-09-04,05:00:00,4,1,3,FMN 08 Schijnpoortweg
675,Schijnpoortweg,2023-09-04,06:00:00,3,2,1,FMN 08 Schijnpoortweg
675,Schijnpoortweg,2023-09-04,07:00:00,1,1,0,FMN 08 Schijnpoortweg
675,Schijnpoortweg,2023-09-04,08:00:00,5,3,2,FMN 08 Schijnpoortweg
675,Schijnpoortweg,2023-09-04,09:00:00,3,1,2,FMN 08 Schijnpoortweg
675,Schijnpoortweg,2023-09-04,10:00:00,1,0,1,FMN 08 Schijnpoortweg
675,Schijnpoortweg,2023-09-04,11:00:00,2,1,1,FMN 08 Schijnpoortweg
675,Schijnpoortweg,2023-09-04,12:00:00,4,0,4,FMN 08 Schijnpoortweg
675,Schijnpoortweg,2023-09-04,13:00:00,6,1,5,FMN 08 Schijnpoortweg
675,Schijnpoortweg,2023-09-04,14:00:00,7,3,4,FMN 08 Schijnpoortweg
675,Schijnpoortweg,2023-09-04,15:00:00,4,2,2,FMN 08 Schijnpoortweg
675,Schijnpoortweg,2023-09-04,16:00:00,6,2,4,FMN 08 Schijnpoortweg
675,Schijnpoortweg,2023-09-04,17:00:00,8,0,8,FMN 08 Schijnpoortweg
675,Schijnpoortweg,2023-09-04,18:00:00,13,3,10,FMN 08 Schijnpoortweg
675,Schijnpoortweg,2023-09-04,19:00:00,13,3,10,FMN 08 Schijnpoortweg
675,Schijnpoortweg,2023-09-04,20:00:00,7,3,4,FMN 08 Schijnpoortweg
675,Schijnpoortweg,2023-09-04,21:00:00,4,0,4,FMN 08 Schijnpoortweg
675,Schijnpoortweg,2023-09-04,22:00:00,1,0,1,FMN 08 Schijnpoortweg
675,Schijnpoortweg,2023-09-04,23:00:00,3,0,3,FMN 08 Schijnpoortweg
675,Schijnpoortweg,2023-09-05,00:00:00,3,1,2,FMN 08 Schijnpoortweg
675,Schijnpoortweg,2023-09-05,01:00:00,3,0,3,FMN 08 Schijnpoortweg
675,Schijnpoortweg,2023-09-05,02:00:00,0,0,0,FMN 08 Schijnpoortweg
675,Schijnpoortweg,2023-09-05,03:00:00,3,0,3,FMN 08 Schijnpoortweg
675,Schijnpoortweg,2023-09-05,04:00:00,0,0,0,FMN 08 Schijnpoortweg
675,Schijnpoortweg,2023-09-05,05:00:00,3,2,1,FMN 08 Schijnpoortweg
675,Schijnpoortweg,2023-09-05,06:00:00,5,2,3,FMN 08 Schijnpoortweg
675,Schijnpoortweg,2023-09-05,07:00:00,2,2,0,FMN 08 Schijnpoortweg
675,Schijnpoortweg,2023-09-05,08:00:00,7,4,3,FMN 08 Schijnpoortweg
675,Schijnpoortweg,2023-09-05,09:00:00,4,1,3,FMN 08 Schijnpoortweg
675,Schijnpoortweg,2023-09-05,10:00:00,2,2,0,FMN 08 Schijnpoortweg
675,Schijnpoortweg,2023-09-05,11:00:00,0,0,0,FMN 08 Schijnpoortweg
675,Schijnpoortweg,2023-09-05,12:00:00,1,1,0,FMN 08 Schijnpoortweg
675,Schijnpoortweg,2023-09-05,13:00:00,4,0,4,FMN 08 Schijnpoortweg
675,Schijnpoortweg,2023-09-05,14:00:00,2,0,2,FMN 08 Schijnpoortweg
675,Schijnpoortweg,2023-09-05,15:00:00,3,1,2,FMN 08 Schijnpoortweg
675,Schijnpoortweg,2023-09-05,16:00:00,5,1,4,FMN 08 Schijnpoortweg
675,Schijnpoortweg,2023-09-05,17:00:00,9,3,6,FMN 08 Schijnpoortweg
675,Schijnpoortweg,2023-09-05,18:00:00,10,2,8,FMN 08 Schijnpoortweg
675,Schijnpoortweg,2023-09-05,19:00:00,7,2,5,FMN 08 Schijnpoortweg
675,Schijnpoortweg,2023-09-05,20:00:00,6,2,4,FMN 08 Schijnpoortweg
675,Schijnpoortweg,2023-09-05,21:00:00,7,1,6,FMN 08 Schijnpoortweg
675,Schijnpoortweg,2023-09-05,22:00:00,7,2,5,FMN 08 Schijnpoortweg
675,Schijnpoortweg,2023-09-05,23:00:00,4,0,4,FMN 08 Schijnpoortweg
675,Schijnpoortweg,2023-09-06,00:00:00,4,1,3,FMN 08 Schijnpoortweg
675,Schijnpoortweg,2023-09-06,01:00:00,2,1,1,FMN 08 Schijnpoortweg
675,Schijnpoortweg,2023-09-06,02:00:00,2,0,2,FMN 08 Schijnpoortweg
675,Schijnpoortweg,2023-09-06,03:00:00,1,0,1,FMN 08 Schijnpoortweg
675,Schijnpoortweg,2023-09-06,04:00:00,2,1,1,FMN 08 Schijnpoortweg
675,Schijnpoortweg,2023-09-06,05:00:00,5,2,3,FMN 08 Schijnpoortweg
675,Schijnpoortweg,2023-09-06,06:00:00,4,1,3,FMN 08 Schijnpoortweg
675,Schijnpoortweg,2023-09-06,07:00:00,4,3,1,FMN 08 Schijnpoortweg
675,Schijnpoortweg,2023-09-06,08:00:00,2,2,0,FMN 08 Schijnpoortweg
675,Schijnpoortweg,2023-09-06,09:00:00,4,3,1,FMN 08 Schijnpoortweg
675,Schijnpoortweg,2023-09-06,10:00:00,2,1,1,FMN 08 Schijnpoortweg
675,Schijnpoortweg,2023-09-06,11:00:00,4,1,3,FMN 08 Schijnpoortweg
675,Schijnpoortweg,2023-09-06,12:00:00,5,2,3,FMN 08 Schijnpoortweg
675,Schijnpoortweg,2023-09-06,13:00:00,8,2,6,FMN 08 Schijnpoortweg
675,Schijnpoortweg,2023-09-06,14:00:00,4,0,4,FMN 08 Schijnpoortweg
675,Schijnpoortweg,2023-09-06,15:00:00,4,2,2,FMN 08 Schijnpoortweg
675,Schijnpoortweg,2023-09-06,16:00:00,8,2,6,FMN 08 Schijnpoortweg
675,Schijnpoortweg,2023-09-06,17:00:00,5,1,4,FMN 08 Schijnpoortweg
675,Schijnpoortweg,2023-09-06,18:00:00,9,1,8,FMN 08 Schijnpoortweg
675,Schijnpoortweg,2023-09-06,19:00:00,14,3,11,FMN 08 Schijnpoortweg
675,Schijnpoortweg,2023-09-06,20:00:00,10,5,5,FMN 08 Schijnpoortweg
675,Schijnpoortweg,2023-09-06,21:00:00,11,4,7,FMN 08 Schijnpoortweg
675,Schijnpoortweg,2023-09-06,22:00:00,8,2,6,FMN 08 Schijnpoortweg
675,Schijnpoortweg,2023-09-06,23:00:00,2,0,2,FMN 08 Schijnpoortweg
675,Schijnpoortweg,2023-09-07,00:00:00,0,0,0,FMN 08 Schijnpoortweg
675,Schijnpoortweg,2023-09-07,01:00:00,0,0,0,FMN 08 Schijnpoortweg
675,Schijnpoortweg,2023-09-07,02:00:00,3,2,1,FMN 08 Schijnpoortweg
675,Schijnpoortweg,2023-09-07,03:00:00,1,1,0,FMN 08 Schijnpoortweg
675,Schijnpoortweg,2023-09-07,04:00:00,1,0,1,FMN 08 Schijnpoortweg
675,Schijnpoortweg,2023-09-07,05:00:00,6,1,5,FMN 08 Schijnpoortweg
675,Schijnpoortweg,2023-09-07,06:00:00,2,1,1,FMN 08 Schijnpoortweg
675,Schijnpoortweg,2023-09-07,07:00:00,4,3,1,FMN 08 Schijnpoortweg
675,Schijnpoortweg,2023-09-07,08:00:00,4,1,3,FMN 08 Schijnpoortweg
675,Schijnpoortweg,2023-09-07,09:00:00,0,0,0,FMN 08 Schijnpoortweg
675,Schijnpoortweg,2023-09-07,10:00:00,3,0,3,FMN 08 Schijnpoortweg
675,Schijnpoortweg,2023-09-07,11:00:00,2,0,2,FMN 08 Schijnpoortweg
675,Schijnpoortweg,2023-09-07,12:00:00,1,0,1,FMN 08 Schijnpoortweg
675,Schijnpoortweg,2023-09-07,13:00:00,4,1,3,FMN 08 Schijnpoortweg
675,Schijnpoortweg,2023-09-07,14:00:00,3,1,2,FMN 08 Schijnpoortweg
675,Schijnpoortweg,2023-09-07,15:00:00,10,3,7,FMN 08 Schijnpoortweg
675,Schijnpoortweg,2023-09-07,16:00:00,5,2,3,FMN 08 Schijnpoortweg
675,Schijnpoortweg,2023-09-07,17:00:00,5,1,4,FMN 08 Schijnpoortweg
675,Schijnpoortweg,2023-09-07,18:00:00,12,2,10,FMN 08 Schijnpoortweg
675,Schijnpoortweg,2023-09-07,19:00:00,5,1,4,FMN 08 Schijnpoortweg
675,Schijnpoortweg,2023-09-07,20:00:00,6,3,3,FMN 08 Schijnpoortweg
675,Schijnpoortweg,2023-09-07,21:00:00,4,2,2,FMN 08 Schijnpoortweg
675,Schijnpoortweg,2023-09-07,22:00:00,5,1,4,FMN 08 Schijnpoortweg
675,Schijnpoortweg,2023-09-07,23:00:00,4,0,4,FMN 08 Schijnpoortweg
675,Schijnpoortweg,2023-09-08,00:00:00,2,0,2,FMN 08 Schijnpoortweg
675,Schijnpoortweg,2023-09-08,01:00:00,1,1,0,FMN 08 Schijnpoortweg
675,Schijnpoortweg,2023-09-08,02:00:00,2,1,1,FMN 08 Schijnpoortweg
675,Schijnpoortweg,2023-09-08,03:00:00,1,0,1,FMN 08 Schijnpoortweg
675,Schijnpoortweg,2023-09-08,04:00:00,2,0,2,FMN 08 Schijnpoortweg
675,Schijnpoortweg,2023-09-08,05:00:00,3,2,1,FMN 08 Schijnpoortweg
675,Schijnpoortweg,2023-09-08,06:00:00,4,2,2,FMN 08 Schijnpoortweg
675,Schijnpoortweg,2023-09-08,07:00:00,7,3,4,FMN 08 Schijnpoortweg
675,Schijnpoortweg,2023-09-08,08:00:00,7,2,5,FMN 08 Schijnpoortweg
675,Schijnpoortweg,2023-09-08,09:00:00,1,0,1,FMN 08 Schijnpoortweg
675,Schijnpoortweg,2023-09-08,10:00:00,4,2,2,FMN 08 Schijnpoortweg
675,Schijnpoortweg,2023-09-08,11:00:00,3,0,3,FMN 08 Schijnpoortweg
675,Schijnpoortweg,2023-09-08,12:00:00,6,1,5,FMN 08 Schijnpoortweg
675,Schijnpoortweg,2023-09-08,13:00:00,1,0,1,FMN 08 Schijnpoortweg
675,Schijnpoortweg,2023-09-08,14:00:00,4,0,4,FMN 08 Schijnpoortweg
675,Schijnpoortweg,2023-09-08,15:00:00,12,3,9,FMN 08 Schijnpoortweg
675,Schijnpoortweg,2023-09-08,16:00:00,9,3,6,FMN 08 Schijnpoortweg
675,Schijnpoortweg,2023-09-08,17:00:00,11,5,6,FMN 08 Schijnpoortweg
675,Schijnpoortweg,2023-09-08,18:00:00,16,6,10,FMN 08 Schijnpoortweg
675,Schijnpoortweg,2023-09-08,19:00:00,85,7,78,FMN 08 Schijnpoortweg
675,Schijnpoortweg,2023-09-08,20:00:00,60,3,57,FMN 08 Schijnpoortweg
675,Schijnpoortweg,2023-09-08,21:00:00,5,1,4,FMN 08 Schijnpoortweg
675,Schijnpoortweg,2023-09-08,22:00:00,95,71,24,FMN 08 Schijnpoortweg
675,Schijnpoortweg,2023-09-08,23:00:00,18,14,4,FMN 08 Schijnpoortweg
675,Schijnpoortweg,2023-09-09,00:00:00,2,1,1,FMN 08 Schijnpoortweg
675,Schijnpoortweg,2023-09-09,01:00:00,4,2,2,FMN 08 Schijnpoortweg
675,Schijnpoortweg,2023-09-09,02:00:00,0,0,0,FMN 08 Schijnpoortweg
675,Schijnpoortweg,2023-09-09,03:00:00,1,0,1,FMN 08 Schijnpoortweg
675,Schijnpoortweg,2023-09-09,04:00:00,2,1,1,FMN 08 Schijnpoortweg
675,Schijnpoortweg,2023-09-09,05:00:00,4,3,1,FMN 08 Schijnpoortweg
675,Schijnpoortweg,2023-09-09,06:00:00,4,1,3,FMN 08 Schijnpoortweg
675,Schijnpoortweg,2023-09-09,07:00:00,0,0,0,FMN 08 Schijnpoortweg
675,Schijnpoortweg,2023-09-09,08:00:00,5,2,3,FMN 08 Schijnpoortweg
675,Schijnpoortweg,2023-09-09,09:00:00,1,1,0,FMN 08 Schijnpoortweg
675,Schijnpoortweg,2023-09-09,10:00:00,3,1,2,FMN 08 Schijnpoortweg
675,Schijnpoortweg,2023-09-09,11:00:00,7,2,5,FMN 08 Schijnpoortweg
675,Schijnpoortweg,2023-09-09,12:00:00,5,3,2,FMN 08 Schijnpoortweg
675,Schijnpoortweg,2023-09-09,13:00:00,6,2,4,FMN 08 Schijnpoortweg
675,Schijnpoortweg,2023-09-09,14:00:00,4,1,3,FMN 08 Schijnpoortweg
675,Schijnpoortweg,2023-09-09,15:00:00,5,1,4,FMN 08 Schijnpoortweg
675,Schijnpoortweg,2023-09-09,16:00:00,5,2,3,FMN 08 Schijnpoortweg
675,Schijnpoortweg,2023-09-09,17:00:00,9,3,6,FMN 08 Schijnpoortweg
675,Schijnpoortweg,2023-09-09,18:00:00,9,2,7,FMN 08 Schijnpoortweg
675,Schijnpoortweg,2023-09-09,19:00:00,9,3,6,FMN 08 Schijnpoortweg
675,Schijnpoortweg,2023-09-09,20:00:00,3,1,2,FMN 08 Schijnpoortweg
675,Schijnpoortweg,2023-09-09,21:00:00,6,0,6,FMN 08 Schijnpoortweg
675,Schijnpoortweg,2023-09-09,22:00:00,2,0,2,FMN 08 Schijnpoortweg
675,Schijnpoortweg,2023-09-09,23:00:00,6,0,6,FMN 08 Schijnpoortweg
675,Schijnpoortweg,2023-09-10,00:00:00,3,2,1,FMN 08 Schijnpoortweg
675,Schijnpoortweg,2023-09-10,01:00:00,2,1,1,FMN 08 Schijnpoortweg
675,Schijnpoortweg,2023-09-10,02:00:00,1,1,0,FMN 08 Schijnpoortweg
675,Schijnpoortweg,2023-09-10,03:00:00,5,0,5,FMN 08 Schijnpoortweg
675,Schijnpoortweg,2023-09-10,04:00:00,2,1,1,FMN 08 Schijnpoortweg
675,Schijnpoortweg,2023-09-10,05:00:00,3,0,3,FMN 08 Schijnpoortweg
675,Schijnpoortweg,2023-09-10,06:00:00,0,0,0,FMN 08 Schijnpoortweg
675,Schijnpoortweg,2023-09-10,07:00:00,0,0,0,FMN 08 Schijnpoortweg
675,Schijnpoortweg,2023-09-10,08:00:00,5,2,3,FMN 08 Schijnpoortweg
675,Schijnpoortweg,2023-09-10,09:00:00,5,2,3,FMN 08 Schijnpoortweg
675,Schijnpoortweg,2023-09-10,10:00:00,4,0,4,FMN 08 Schijnpoortweg
675,Schijnpoortweg,2023-09-10,11:00:00,2,0,2,FMN 08 Schijnpoortweg
675,Schijnpoortweg,2023-09-10,12:00:00,3,0,3,FMN 08 Schijnpoortweg
675,Schijnpoortweg,2023-09-10,13:00:00,2,0,2,FMN 08 Schijnpoortweg
675,Schijnpoortweg,2023-09-10,14:00:00,4,1,3,FMN 08 Schijnpoortweg
675,Schijnpoortweg,2023-09-10,15:00:00,7,4,3,FMN 08 Schijnpoortweg
675,Schijnpoortweg,2023-09-10,16:00:00,8,0,8,FMN 08 Schijnpoortweg
675,Schijnpoortweg,2023-09-10,17:00:00,4,1,3,FMN 08 Schijnpoortweg
675,Schijnpoortweg,2023-09-10,18:00:00,5,2,3,FMN 08 Schijnpoortweg
675,Schijnpoortweg,2023-09-10,19:00:00,5,2,3,FMN 08 Schijnpoortweg
675,Schijnpoortweg,2023-09-10,20:00:00,2,1,1,FMN 08 Schijnpoortweg
675,Schijnpoortweg,2023-09-10,21:00:00,7,4,3,FMN 08 Schijnpoortweg
675,Schijnpoortweg,2023-09-10,22:00:00,6,3,3,FMN 08 Schijnpoortweg
675,Schijnpoortweg,2023-09-10,23:00:00,2,0,2,FMN 08 Schijnpoortweg
675,Schijnpoortweg,2023-09-11,00:00:00,5,0,5,FMN 08 Schijnpoortweg
675,Schijnpoortweg,2023-09-11,01:00:00,1,0,1,FMN 08 Schijnpoortweg
675,Schijnpoortweg,2023-09-11,02:00:00,1,1,0,FMN 08 Schijnpoortweg
675,Schijnpoortweg,2023-09-11,03:00:00,1,0,1,FMN 08 Schijnpoortweg
675,Schijnpoortweg,2023-09-11,04:00:00,3,0,3,FMN 08 Schijnpoortweg
675,Schijnpoortweg,2023-09-11,05:00:00,5,2,3,FMN 08 Schijnpoortweg
675,Schijnpoortweg,2023-09-11,06:00:00,6,3,3,FMN 08 Schijnpoortweg
675,Schijnpoortweg,2023-09-11,07:00:00,4,2,2,FMN 08 Schijnpoortweg
675,Schijnpoortweg,2023-09-11,08:00:00,10,1,9,FMN 08 Schijnpoortweg
675,Schijnpoortweg,2023-09-11,09:00:00,7,3,4,FMN 08 Schijnpoortweg
675,Schijnpoortweg,2023-09-11,10:00:00,2,0,2,FMN 08 Schijnpoortweg
675,Schijnpoortweg,2023-09-11,11:00:00,2,1,1,FMN 08 Schijnpoortweg
675,Schijnpoortweg,2023-09-11,12:00:00,2,0,2,FMN 08 Schijnpoortweg
675,Schijnpoortweg,2023-09-11,13:00:00,7,1,6,FMN 08 Schijnpoortweg
675,Schijnpoortweg,2023-09-11,14:00:00,6,1,5,FMN 08 Schijnpoortweg
675,Schijnpoortweg,2023-09-11,15:00:00,9,3,6,FMN 08 Schijnpoortweg
675,Schijnpoortweg,2023-09-11,16:00:00,15,4,11,FMN 08 Schijnpoortweg
675,Schijnpoortweg,2023-09-11,17:00:00,10,3,7,FMN 08 Schijnpoortweg
675,Schijnpoortweg,2023-09-11,18:00:00,10,3,7,FMN 08 Schijnpoortweg
675,Schijnpoortweg,2023-09-11,19:00:00,12,2,10,FMN 08 Schijnpoortweg
675,Schijnpoortweg,2023-09-11,20:00:00,8,1,7,FMN 08 Schijnpoortweg
675,Schijnpoortweg,2023-09-11,21:00:00,7,0,7,FMN 08 Schijnpoortweg
675,Schijnpoortweg,2023-09-11,22:00:00,7,3,4,FMN 08 Schijnpoortweg
675,Schijnpoortweg,2023-09-11,23:00:00,1,0,1,FMN 08 Schijnpoortweg
675,Schijnpoortweg,2023-09-12,00:00:00,1,0,1,FMN 08 Schijnpoortweg
675,Schijnpoortweg,2023-09-12,01:00:00,1,0,1,FMN 08 Schijnpoortweg
675,Schijnpoortweg,2023-09-12,02:00:00,3,1,2,FMN 08 Schijnpoortweg
675,Schijnpoortweg,2023-09-12,03:00:00,2,0,2,FMN 08 Schijnpoortweg
675,Schijnpoortweg,2023-09-12,04:00:00,3,1,2,FMN 08 Schijnpoortweg
675,Schijnpoortweg,2023-09-12,05:00:00,5,0,5,FMN 08 Schijnpoortweg
675,Schijnpoortweg,2023-09-12,06:00:00,4,1,3,FMN 08 Schijnpoortweg
675,Schijnpoortweg,2023-09-12,07:00:00,3,3,0,FMN 08 Schijnpoortweg
675,Schijnpoortweg,2023-09-12,08:00:00,5,0,5,FMN 08 Schijnpoortweg
675,Schijnpoortweg,2023-09-12,09:00:00,2,1,1,FMN 08 Schijnpoortweg
675,Schijnpoortweg,2023-09-12,10:00:00,2,1,1,FMN 08 Schijnpoortweg
675,Schijnpoortweg,2023-09-12,11:00:00,3,1,2,FMN 08 Schijnpoortweg
675,Schijnpoortweg,2023-09-12,12:00:00,2,0,2,FMN 08 Schijnpoortweg
675,Schijnpoortweg,2023-09-12,13:00:00,4,0,4,FMN 08 Schijnpoortweg
675,Schijnpoortweg,2023-09-12,14:00:00,1,1,0,FMN 08 Schijnpoortweg
675,Schijnpoortweg,2023-09-12,15:00:00,10,2,8,FMN 08 Schijnpoortweg
675,Schijnpoortweg,2023-09-12,16:00:00,7,2,5,FMN 08 Schijnpoortweg
675,Schijnpoortweg,2023-09-12,17:00:00,9,0,9,FMN 08 Schijnpoortweg
675,Schijnpoortweg,2023-09-12,18:00:00,11,6,5,FMN 08 Schijnpoortweg
675,Schijnpoortweg,2023-09-12,19:00:00,6,1,5,FMN 08 Schijnpoortweg
675,Schijnpoortweg,2023-09-12,20:00:00,8,1,7,FMN 08 Schijnpoortweg
675,Schijnpoortweg,2023-09-12,21:00:00,9,1,8,FMN 08 Schijnpoortweg
675,Schijnpoortweg,2023-09-12,22:00:00,0,0,0,FMN 08 Schijnpoortweg
675,Schijnpoortweg,2023-09-12,23:00:00,1,0,1,FMN 08 Schijnpoortweg
675,Schijnpoortweg,2023-09-13,00:00:00,3,1,2,FMN 08 Schijnpoortweg
675,Schijnpoortweg,2023-09-13,01:00:00,0,0,0,FMN 08 Schijnpoortweg
675,Schijnpoortweg,2023-09-13,02:00:00,2,0,2,FMN 08 Schijnpoortweg
675,Schijnpoortweg,2023-09-13,03:00:00,0,0,0,FMN 08 Schijnpoortweg
675,Schijnpoortweg,2023-09-13,04:00:00,2,1,1,FMN 08 Schijnpoortweg
675,Schijnpoortweg,2023-09-13,05:00:00,3,2,1,FMN 08 Schijnpoortweg
675,Schijnpoortweg,2023-09-13,06:00:00,6,1,5,FMN 08 Schijnpoortweg
675,Schijnpoortweg,2023-09-13,07:00:00,1,1,0,FMN 08 Schijnpoortweg
675,Schijnpoortweg,2023-09-13,08:00:00,9,1,8,FMN 08 Schijnpoortweg
675,Schijnpoortweg,2023-09-13,09:00:00,1,1,0,FMN 08 Schijnpoortweg
675,Schijnpoortweg,2023-09-13,10:00:00,2,1,1,FMN 08 Schijnpoortweg
675,Schijnpoortweg,2023-09-13,11:00:00,1,0,1,FMN 08 Schijnpoortweg
675,Schijnpoortweg,2023-09-13,12:00:00,3,1,2,FMN 08 Schijnpoortweg
675,Schijnpoortweg,2023-09-13,13:00:00,4,1,3,FMN 08 Schijnpoortweg
675,Schijnpoortweg,2023-09-13,14:00:00,6,2,4,FMN 08 Schijnpoortweg
675,Schijnpoortweg,2023-09-13,15:00:00,12,3,9,FMN 08 Schijnpoortweg
675,Schijnpoortweg,2023-09-13,16:00:00,7,0,7,FMN 08 Schijnpoortweg
675,Schijnpoortweg,2023-09-13,17:00:00,13,5,8,FMN 08 Schijnpoortweg
675,Schijnpoortweg,2023-09-13,18:00:00,12,2,10,FMN 08 Schijnpoortweg
675,Schijnpoortweg,2023-09-13,19:00:00,9,3,6,FMN 08 Schijnpoortweg
675,Schijnpoortweg,2023-09-13,20:00:00,16,2,14,FMN 08 Schijnpoortweg
675,Schijnpoortweg,2023-09-13,21:00:00,19,2,17,FMN 08 Schijnpoortweg
675,Schijnpoortweg,2023-09-13,22:00:00,10,2,8,FMN 08 Schijnpoortweg
675,Schijnpoortweg,2023-09-13,23:00:00,2,1,1,FMN 08 Schijnpoortweg
675,Schijnpoortweg,2023-09-14,00:00:00,2,0,2,FMN 08 Schijnpoortweg
675,Schijnpoortweg,2023-09-14,01:00:00,0,0,0,FMN 08 Schijnpoortweg
675,Schijnpoortweg,2023-09-14,02:00:00,1,1,0,FMN 08 Schijnpoortweg
675,Schijnpoortweg,2023-09-14,03:00:00,0,0,0,FMN 08 Schijnpoortweg
675,Schijnpoortweg,2023-09-14,04:00:00,0,0,0,FMN 08 Schijnpoortweg
675,Schijnpoortweg,2023-09-14,05:00:00,1,0,1,FMN 08 Schijnpoortweg
675,Schijnpoortweg,2023-09-14,06:00:00,5,3,2,FMN 08 Schijnpoortweg
675,Schijnpoortweg,2023-09-14,07:00:00,5,4,1,FMN 08 Schijnpoortweg
675,Schijnpoortweg,2023-09-14,08:00:00,1,0,1,FMN 08 Schijnpoortweg
675,Schijnpoortweg,2023-09-14,09:00:00,2,1,1,FMN 08 Schijnpoortweg
675,Schijnpoortweg,2023-09-14,10:00:00,1,0,1,FMN 08 Schijnpoortweg
675,Schijnpoortweg,2023-09-14,11:00:00,3,2,1,FMN 08 Schijnpoortweg
675,Schijnpoortweg,2023-09-14,12:00:00,5,1,4,FMN 08 Schijnpoortweg
675,Schijnpoortweg,2023-09-14,13:00:00,1,1,0,FMN 08 Schijnpoortweg
675,Schijnpoortweg,2023-09-14,14:00:00,3,1,2,FMN 08 Schijnpoortweg
675,Schijnpoortweg,2023-09-14,15:00:00,5,1,4,FMN 08 Schijnpoortweg
675,Schijnpoortweg,2023-09-14,16:00:00,6,1,5,FMN 08 Schijnpoortweg
675,Schijnpoortweg,2023-09-14,17:00:00,10,4,6,FMN 08 Schijnpoortweg
675,Schijnpoortweg,2023-09-14,18:00:00,13,5,8,FMN 08 Schijnpoortweg
675,Schijnpoortweg,2023-09-14,19:00:00,10,0,10,FMN 08 Schijnpoortweg
675,Schijnpoortweg,2023-09-14,20:00:00,20,3,17,FMN 08 Schijnpoortweg
675,Schijnpoortweg,2023-09-14,21:00:00,16,1,15,FMN 08 Schijnpoortweg
675,Schijnpoortweg,2023-09-14,22:00:00,11,0,11,FMN 08 Schijnpoortweg
675,Schijnpoortweg,2023-09-14,23:00:00,10,0,10,FMN 08 Schijnpoortweg
675,Schijnpoortweg,2023-09-15,00:00:00,5,1,4,FMN 08 Schijnpoortweg
675,Schijnpoortweg,2023-09-15,01:00:00,3,1,2,FMN 08 Schijnpoortweg
675,Schijnpoortweg,2023-09-15,02:00:00,0,0,0,FMN 08 Schijnpoortweg
675,Schijnpoortweg,2023-09-15,03:00:00,3,2,1,FMN 08 Schijnpoortweg
675,Schijnpoortweg,2023-09-15,04:00:00,1,0,1,FMN 08 Schijnpoortweg
675,Schijnpoortweg,2023-09-15,05:00:00,3,0,3,FMN 08 Schijnpoortweg
675,Schijnpoortweg,2023-09-15,06:00:00,5,3,2,FMN 08 Schijnpoortweg
675,Schijnpoortweg,2023-09-15,07:00:00,5,2,3,FMN 08 Schijnpoortweg
675,Schijnpoortweg,2023-09-15,08:00:00,7,0,7,FMN 08 Schijnpoortweg
675,Schijnpoortweg,2023-09-15,09:00:00,3,1,2,FMN 08 Schijnpoortweg
675,Schijnpoortweg,2023-09-15,10:00:00,4,1,3,FMN 08 Schijnpoortweg
675,Schijnpoortweg,2023-09-15,11:00:00,4,1,3,FMN 08 Schijnpoortweg
675,Schijnpoortweg,2023-09-15,12:00:00,10,4,6,FMN 08 Schijnpoortweg
675,Schijnpoortweg,2023-09-15,13:00:00,4,3,1,FMN 08 Schijnpoortweg
675,Schijnpoortweg,2023-09-15,14:00:00,3,1,2,FMN 08 Schijnpoortweg
675,Schijnpoortweg,2023-09-15,15:00:00,8,3,5,FMN 08 Schijnpoortweg
675,Schijnpoortweg,2023-09-15,16:00:00,10,3,7,FMN 08 Schijnpoortweg
675,Schijnpoortweg,2023-09-15,17:00:00,8,1,7,FMN 08 Schijnpoortweg
675,Schijnpoortweg,2023-09-15,18:00:00,6,2,4,FMN 08 Schijnpoortweg
675,Schijnpoortweg,2023-09-15,19:00:00,2,0,2,FMN 08 Schijnpoortweg
675,Schijnpoortweg,2023-09-15,20:00:00,9,2,7,FMN 08 Schijnpoortweg
675,Schijnpoortweg,2023-09-15,21:00:00,6,2,4,FMN 08 Schijnpoortweg
675,Schijnpoortweg,2023-09-15,22:00:00,5,1,4,FMN 08 Schijnpoortweg
675,Schijnpoortweg,2023-09-15,23:00:00,8,2,6,FMN 08 Schijnpoortweg
675,Schijnpoortweg,2023-09-16,00:00:00,0,0,0,FMN 08 Schijnpoortweg
675,Schijnpoortweg,2023-09-16,01:00:00,2,1,1,FMN 08 Schijnpoortweg
675,Schijnpoortweg,2023-09-16,02:00:00,2,0,2,FMN 08 Schijnpoortweg
675,Schijnpoortweg,2023-09-16,03:00:00,2,0,2,FMN 08 Schijnpoortweg
675,Schijnpoortweg,2023-09-16,04:00:00,1,1,0,FMN 08 Schijnpoortweg
675,Schijnpoortweg,2023-09-16,05:00:00,2,0,2,FMN 08 Schijnpoortweg
675,Schijnpoortweg,2023-09-16,06:00:00,3,3,0,FMN 08 Schijnpoortweg
675,Schijnpoortweg,2023-09-16,07:00:00,1,1,0,FMN 08 Schijnpoortweg
675,Schijnpoortweg,2023-09-16,08:00:00,4,1,3,FMN 08 Schijnpoortweg
675,Schijnpoortweg,2023-09-16,09:00:00,4,0,4,FMN 08 Schijnpoortweg
675,Schijnpoortweg,2023-09-16,10:00:00,3,1,2,FMN 08 Schijnpoortweg
675,Schijnpoortweg,2023-09-16,11:00:00,4,3,1,FMN 08 Schijnpoortweg
675,Schijnpoortweg,2023-09-16,12:00:00,5,3,2,FMN 08 Schijnpoortweg
675,Schijnpoortweg,2023-09-16,13:00:00,2,1,1,FMN 08 Schijnpoortweg
675,Schijnpoortweg,2023-09-16,14:00:00,6,0,6,FMN 08 Schijnpoortweg
675,Schijnpoortweg,2023-09-16,15:00:00,4,1,3,FMN 08 Schijnpoortweg
675,Schijnpoortweg,2023-09-16,16:00:00,1,0,1,FMN 08 Schijnpoortweg
675,Schijnpoortweg,2023-09-16,17:00:00,7,1,6,FMN 08 Schijnpoortweg
675,Schijnpoortweg,2023-09-16,18:00:00,5,1,4,FMN 08 Schijnpoortweg
675,Schijnpoortweg,2023-09-16,19:00:00,8,2,6,FMN 08 Schijnpoortweg
675,Schijnpoortweg,2023-09-16,20:00:00,7,1,6,FMN 08 Schijnpoortweg
675,Schijnpoortweg,2023-09-16,21:00:00,2,0,2,FMN 08 Schijnpoortweg
675,Schijnpoortweg,2023-09-16,22:00:00,4,1,3,FMN 08 Schijnpoortweg
675,Schijnpoortweg,2023-09-16,23:00:00,1,0,1,FMN 08 Schijnpoortweg
675,Schijnpoortweg,2023-09-17,00:00:00,3,2,1,FMN 08 Schijnpoortweg
675,Schijnpoortweg,2023-09-17,01:00:00,1,0,1,FMN 08 Schijnpoortweg
675,Schijnpoortweg,2023-09-17,02:00:00,4,0,4,FMN 08 Schijnpoortweg
675,Schijnpoortweg,2023-09-17,03:00:00,0,0,0,FMN 08 Schijnpoortweg
675,Schijnpoortweg,2023-09-17,04:00:00,1,1,0,FMN 08 Schijnpoortweg
675,Schijnpoortweg,2023-09-17,05:00:00,0,0,0,FMN 08 Schijnpoortweg
675,Schijnpoortweg,2023-09-17,06:00:00,2,1,1,FMN 08 Schijnpoortweg
675,Schijnpoortweg,2023-09-17,07:00:00,0,0,0,FMN 08 Schijnpoortweg
675,Schijnpoortweg,2023-09-17,08:00:00,2,1,1,FMN 08 Schijnpoortweg
675,Schijnpoortweg,2023-09-17,09:00:00,1,0,1,FMN 08 Schijnpoortweg
675,Schijnpoortweg,2023-09-17,10:00:00,8,3,5,FMN 08 Schijnpoortweg
675,Schijnpoortweg,2023-09-17,11:00:00,1,0,1,FMN 08 Schijnpoortweg
675,Schijnpoortweg,2023-09-17,12:00:00,2,2,0,FMN 08 Schijnpoortweg
675,Schijnpoortweg,2023-09-17,13:00:00,3,2,1,FMN 08 Schijnpoortweg
675,Schijnpoortweg,2023-09-17,14:00:00,5,0,5,FMN 08 Schijnpoortweg
675,Schijnpoortweg,2023-09-17,15:00:00,6,2,4,FMN 08 Schijnpoortweg
675,Schijnpoortweg,2023-09-17,16:00:00,5,1,4,FMN 08 Schijnpoortweg
675,Schijnpoortweg,2023-09-17,17:00:00,6,1,5,FMN 08 Schijnpoortweg
675,Schijnpoortweg,2023-09-17,18:00:00,5,2,3,FMN 08 Schijnpoortweg
675,Schijnpoortweg,2023-09-17,19:00:00,6,0,6,FMN 08 Schijnpoortweg
675,Schijnpoortweg,2023-09-17,20:00:00,7,4,3,FMN 08 Schijnpoortweg
675,Schijnpoortweg,2023-09-17,21:00:00,3,0,3,FMN 08 Schijnpoortweg
675,Schijnpoortweg,2023-09-17,22:00:00,5,2,3,FMN 08 Schijnpoortweg
675,Schijnpoortweg,2023-09-17,23:00:00,0,0,0,FMN 08 Schijnpoortweg
675,Schijnpoortweg,2023-09-18,00:00:00,3,1,2,FMN 08 Schijnpoortweg
675,Schijnpoortweg,2023-09-18,01:00:00,0,0,0,FMN 08 Schijnpoortweg
675,Schijnpoortweg,2023-09-18,02:00:00,1,1,0,FMN 08 Schijnpoortweg
675,Schijnpoortweg,2023-09-18,03:00:00,1,0,1,FMN 08 Schijnpoortweg
675,Schijnpoortweg,2023-09-18,04:00:00,2,2,0,FMN 08 Schijnpoortweg
675,Schijnpoortweg,2023-09-18,05:00:00,0,0,0,FMN 08 Schijnpoortweg
675,Schijnpoortweg,2023-09-18,06:00:00,5,3,2,FMN 08 Schijnpoortweg
675,Schijnpoortweg,2023-09-18,07:00:00,7,6,1,FMN 08 Schijnpoortweg
675,Schijnpoortweg,2023-09-18,08:00:00,5,3,2,FMN 08 Schijnpoortweg
675,Schijnpoortweg,2023-09-18,09:00:00,3,1,2,FMN 08 Schijnpoortweg
675,Schijnpoortweg,2023-09-18,10:00:00,2,1,1,FMN 08 Schijnpoortweg
675,Schijnpoortweg,2023-09-18,11:00:00,0,0,0,FMN 08 Schijnpoortweg
675,Schijnpoortweg,2023-09-18,12:00:00,4,0,4,FMN 08 Schijnpoortweg
675,Schijnpoortweg,2023-09-18,13:00:00,7,2,5,FMN 08 Schijnpoortweg
675,Schijnpoortweg,2023-09-18,14:00:00,3,1,2,FMN 08 Schijnpoortweg
675,Schijnpoortweg,2023-09-18,15:00:00,12,6,6,FMN 08 Schijnpoortweg
675,Schijnpoortweg,2023-09-18,16:00:00,6,0,6,FMN 08 Schijnpoortweg
675,Schijnpoortweg,2023-09-18,17:00:00,12,3,9,FMN 08 Schijnpoortweg
675,Schijnpoortweg,2023-09-18,18:00:00,9,1,8,FMN 08 Schijnpoortweg
675,Schijnpoortweg,2023-09-18,19:00:00,4,1,3,FMN 08 Schijnpoortweg
675,Schijnpoortweg,2023-09-18,20:00:00,9,1,8,FMN 08 Schijnpoortweg
675,Schijnpoortweg,2023-09-18,21:00:00,5,1,4,FMN 08 Schijnpoortweg
675,Schijnpoortweg,2023-09-18,22:00:00,5,1,4,FMN 08 Schijnpoortweg
675,Schijnpoortweg,2023-09-18,23:00:00,2,0,2,FMN 08 Schijnpoortweg
675,Schijnpoortweg,2023-09-19,00:00:00,1,0,1,FMN 08 Schijnpoortweg
675,Schijnpoortweg,2023-09-19,01:00:00,1,0,1,FMN 08 Schijnpoortweg
675,Schijnpoortweg,2023-09-19,02:00:00,1,0,1,FMN 08 Schijnpoortweg
675,Schijnpoortweg,2023-09-19,03:00:00,0,0,0,FMN 08 Schijnpoortweg
675,Schijnpoortweg,2023-09-19,04:00:00,2,2,0,FMN 08 Schijnpoortweg
675,Schijnpoortweg,2023-09-19,05:00:00,8,1,7,FMN 08 Schijnpoortweg
675,Schijnpoortweg,2023-09-19,06:00:00,4,3,1,FMN 08 Schijnpoortweg
675,Schijnpoortweg,2023-09-19,07:00:00,5,5,0,FMN 08 Schijnpoortweg
675,Schijnpoortweg,2023-09-19,08:00:00,5,1,4,FMN 08 Schijnpoortweg
675,Schijnpoortweg,2023-09-19,09:00:00,5,3,2,FMN 08 Schijnpoortweg
675,Schijnpoortweg,2023-09-19,10:00:00,3,1,2,FMN 08 Schijnpoortweg
675,Schijnpoortweg,2023-09-19,11:00:00,5,1,4,FMN 08 Schijnpoortweg
675,Schijnpoortweg,2023-09-19,12:00:00,6,3,3,FMN 08 Schijnpoortweg
675,Schijnpoortweg,2023-09-19,13:00:00,2,1,1,FMN 08 Schijnpoortweg
675,Schijnpoortweg,2023-09-19,14:00:00,3,1,2,FMN 08 Schijnpoortweg
675,Schijnpoortweg,2023-09-19,15:00:00,13,4,9,FMN 08 Schijnpoortweg
675,Schijnpoortweg,2023-09-19,16:00:00,10,5,5,FMN 08 Schijnpoortweg
675,Schijnpoortweg,2023-09-19,17:00:00,14,5,9,FMN 08 Schijnpoortweg
675,Schijnpoortweg,2023-09-19,18:00:00,7,2,5,FMN 08 Schijnpoortweg
675,Schijnpoortweg,2023-09-19,19:00:00,9,1,8,FMN 08 Schijnpoortweg
675,Schijnpoortweg,2023-09-19,20:00:00,5,1,4,FMN 08 Schijnpoortweg
675,Schijnpoortweg,2023-09-19,21:00:00,10,2,8,FMN 08 Schijnpoortweg
675,Schijnpoortweg,2023-09-19,22:00:00,2,1,1,FMN 08 Schijnpoortweg
675,Schijnpoortweg,2023-09-19,23:00:00,6,1,5,FMN 08 Schijnpoortweg
675,Schijnpoortweg,2023-09-20,00:00:00,1,1,0,FMN 08 Schijnpoortweg
675,Schijnpoortweg,2023-09-20,01:00:00,1,1,0,FMN 08 Schijnpoortweg
675,Schijnpoortweg,2023-09-20,02:00:00,1,0,1,FMN 08 Schijnpoortweg
675,Schijnpoortweg,2023-09-20,03:00:00,1,0,1,FMN 08 Schijnpoortweg
675,Schijnpoortweg,2023-09-20,04:00:00,1,0,1,FMN 08 Schijnpoortweg
675,Schijnpoortweg,2023-09-20,05:00:00,3,1,2,FMN 08 Schijnpoortweg
675,Schijnpoortweg,2023-09-20,06:00:00,4,1,3,FMN 08 Schijnpoortweg
675,Schijnpoortweg,2023-09-20,07:00:00,7,4,3,FMN 08 Schijnpoortweg
675,Schijnpoortweg,2023-09-20,08:00:00,6,1,5,FMN 08 Schijnpoortweg
675,Schijnpoortweg,2023-09-20,09:00:00,5,1,4,FMN 08 Schijnpoortweg
675,Schijnpoortweg,2023-09-20,10:00:00,1,0,1,FMN 08 Schijnpoortweg
675,Schijnpoortweg,2023-09-20,11:00:00,3,1,2,FMN 08 Schijnpoortweg
675,Schijnpoortweg,2023-09-20,12:00:00,7,3,4,FMN 08 Schijnpoortweg
675,Schijnpoortweg,2023-09-20,13:00:00,7,3,4,FMN 08 Schijnpoortweg
675,Schijnpoortweg,2023-09-20,14:00:00,3,0,3,FMN 08 Schijnpoortweg
675,Schijnpoortweg,2023-09-20,15:00:00,6,0,6,FMN 08 Schijnpoortweg
675,Schijnpoortweg,2023-09-20,16:00:00,9,4,5,FMN 08 Schijnpoortweg
675,Schijnpoortweg,2023-09-20,17:00:00,10,1,9,FMN 08 Schijnpoortweg
675,Schijnpoortweg,2023-09-20,18:00:00,7,3,4,FMN 08 Schijnpoortweg
675,Schijnpoortweg,2023-09-20,19:00:00,9,1,8,FMN 08 Schijnpoortweg
675,Schijnpoortweg,2023-09-20,20:00:00,9,3,6,FMN 08 Schijnpoortweg
675,Schijnpoortweg,2023-09-20,21:00:00,6,0,6,FMN 08 Schijnpoortweg
675,Schijnpoortweg,2023-09-20,22:00:00,5,2,3,FMN 08 Schijnpoortweg
675,Schijnpoortweg,2023-09-20,23:00:00,5,1,4,FMN 08 Schijnpoortweg
675,Schijnpoortweg,2023-09-21,00:00:00,2,0,2,FMN 08 Schijnpoortweg
675,Schijnpoortweg,2023-09-21,01:00:00,1,0,1,FMN 08 Schijnpoortweg
675,Schijnpoortweg,2023-09-21,02:00:00,0,0,0,FMN 08 Schijnpoortweg
675,Schijnpoortweg,2023-09-21,03:00:00,3,0,3,FMN 08 Schijnpoortweg
675,Schijnpoortweg,2023-09-21,04:00:00,3,2,1,FMN 08 Schijnpoortweg
675,Schijnpoortweg,2023-09-21,05:00:00,0,0,0,FMN 08 Schijnpoortweg
675,Schijnpoortweg,2023-09-21,06:00:00,3,1,2,FMN 08 Schijnpoortweg
675,Schijnpoortweg,2023-09-21,07:00:00,2,1,1,FMN 08 Schijnpoortweg
675,Schijnpoortweg,2023-09-21,08:00:00,6,1,5,FMN 08 Schijnpoortweg
675,Schijnpoortweg,2023-09-21,09:00:00,1,1,0,FMN 08 Schijnpoortweg
675,Schijnpoortweg,2023-09-21,10:00:00,1,1,0,FMN 08 Schijnpoortweg
675,Schijnpoortweg,2023-09-21,11:00:00,3,1,2,FMN 08 Schijnpoortweg
675,Schijnpoortweg,2023-09-21,12:00:00,0,0,0,FMN 08 Schijnpoortweg
675,Schijnpoortweg,2023-09-21,13:00:00,3,1,2,FMN 08 Schijnpoortweg
675,Schijnpoortweg,2023-09-21,14:00:00,0,0,0,FMN 08 Schijnpoortweg
675,Schijnpoortweg,2023-09-21,15:00:00,3,1,2,FMN 08 Schijnpoortweg
675,Schijnpoortweg,2023-09-21,16:00:00,2,0,2,FMN 08 Schijnpoortweg
675,Schijnpoortweg,2023-09-21,17:00:00,5,0,5,FMN 08 Schijnpoortweg
675,Schijnpoortweg,2023-09-21,18:00:00,3,1,2,FMN 08 Schijnpoortweg
675,Schijnpoortweg,2023-09-21,19:00:00,5,1,4,FMN 08 Schijnpoortweg
675,Schijnpoortweg,2023-09-21,20:00:00,4,1,3,FMN 08 Schijnpoortweg
675,Schijnpoortweg,2023-09-21,21:00:00,4,3,1,FMN 08 Schijnpoortweg
675,Schijnpoortweg,2023-09-21,22:00:00,1,1,0,FMN 08 Schijnpoortweg
675,Schijnpoortweg,2023-09-21,23:00:00,1,0,1,FMN 08 Schijnpoortweg
675,Schijnpoortweg,2023-09-22,00:00:00,0,0,0,FMN 08 Schijnpoortweg
675,Schijnpoortweg,2023-09-22,01:00:00,1,0,1,FMN 08 Schijnpoortweg
675,Schijnpoortweg,2023-09-22,02:00:00,0,0,0,FMN 08 Schijnpoortweg
675,Schijnpoortweg,2023-09-22,03:00:00,1,0,1,FMN 08 Schijnpoortweg
675,Schijnpoortweg,2023-09-22,04:00:00,0,0,0,FMN 08 Schijnpoortweg
675,Schijnpoortweg,2023-09-22,05:00:00,2,0,2,FMN 08 Schijnpoortweg
675,Schijnpoortweg,2023-09-22,06:00:00,9,4,5,FMN 08 Schijnpoortweg
675,Schijnpoortweg,2023-09-22,07:00:00,5,1,4,FMN 08 Schijnpoortweg
675,Schijnpoortweg,2023-09-22,08:00:00,4,1,3,FMN 08 Schijnpoortweg
675,Schijnpoortweg,2023-09-22,09:00:00,1,1,0,FMN 08 Schijnpoortweg
675,Schijnpoortweg,2023-09-22,10:00:00,1,1,0,FMN 08 Schijnpoortweg
675,Schijnpoortweg,2023-09-22,11:00:00,2,0,2,FMN 08 Schijnpoortweg
675,Schijnpoortweg,2023-09-22,12:00:00,2,0,2,FMN 08 Schijnpoortweg
675,Schijnpoortweg,2023-09-22,13:00:00,5,2,3,FMN 08 Schijnpoortweg
675,Schijnpoortweg,2023-09-22,14:00:00,5,1,4,FMN 08 Schijnpoortweg
675,Schijnpoortweg,2023-09-22,15:00:00,6,1,5,FMN 08 Schijnpoortweg
675,Schijnpoortweg,2023-09-22,16:00:00,5,0,5,FMN 08 Schijnpoortweg
675,Schijnpoortweg,2023-09-22,17:00:00,2,1,1,FMN 08 Schijnpoortweg
675,Schijnpoortweg,2023-09-22,18:00:00,5,3,2,FMN 08 Schijnpoortweg
675,Schijnpoortweg,2023-09-22,19:00:00,5,1,4,FMN 08 Schijnpoortweg
675,Schijnpoortweg,2023-09-22,20:00:00,1,1,0,FMN 08 Schijnpoortweg
675,Schijnpoortweg,2023-09-22,21:00:00,1,0,1,FMN 08 Schijnpoortweg
675,Schijnpoortweg,2023-09-22,22:00:00,0,0,0,FMN 08 Schijnpoortweg
675,Schijnpoortweg,2023-09-22,23:00:00,1,0,1,FMN 08 Schijnpoortweg
675,Schijnpoortweg,2023-09-23,00:00:00,0,0,0,FMN 08 Schijnpoortweg
675,Schijnpoortweg,2023-09-23,01:00:00,0,0,0,FMN 08 Schijnpoortweg
675,Schijnpoortweg,2023-09-23,02:00:00,0,0,0,FMN 08 Schijnpoortweg
675,Schijnpoortweg,2023-09-23,03:00:00,0,0,0,FMN 08 Schijnpoortweg
675,Schijnpoortweg,2023-09-23,04:00:00,1,0,1,FMN 08 Schijnpoortweg
675,Schijnpoortweg,2023-09-23,05:00:00,2,1,1,FMN 08 Schijnpoortweg
675,Schijnpoortweg,2023-09-23,06:00:00,1,1,0,FMN 08 Schijnpoortweg
675,Schijnpoortweg,2023-09-23,07:00:00,2,1,1,FMN 08 Schijnpoortweg
675,Schijnpoortweg,2023-09-23,08:00:00,5,3,2,FMN 08 Schijnpoortweg
675,Schijnpoortweg,2023-09-23,09:00:00,2,0,2,FMN 08 Schijnpoortweg
675,Schijnpoortweg,2023-09-23,10:00:00,2,1,1,FMN 08 Schijnpoortweg
675,Schijnpoortweg,2023-09-23,11:00:00,0,0,0,FMN 08 Schijnpoortweg
675,Schijnpoortweg,2023-09-23,12:00:00,1,0,1,FMN 08 Schijnpoortweg
675,Schijnpoortweg,2023-09-23,13:00:00,3,0,3,FMN 08 Schijnpoortweg
675,Schijnpoortweg,2023-09-23,14:00:00,2,1,1,FMN 08 Schijnpoortweg
675,Schijnpoortweg,2023-09-23,15:00:00,0,0,0,FMN 08 Schijnpoortweg
675,Schijnpoortweg,2023-09-23,16:00:00,1,0,1,FMN 08 Schijnpoortweg
675,Schijnpoortweg,2023-09-23,17:00:00,10,4,6,FMN 08 Schijnpoortweg
675,Schijnpoortweg,2023-09-23,18:00:00,3,0,3,FMN 08 Schijnpoortweg
675,Schijnpoortweg,2023-09-23,19:00:00,11,1,10,FMN 08 Schijnpoortweg
675,Schijnpoortweg,2023-09-23,20:00:00,6,2,4,FMN 08 Schijnpoortweg
675,Schijnpoortweg,2023-09-23,21:00:00,7,1,6,FMN 08 Schijnpoortweg
675,Schijnpoortweg,2023-09-23,22:00:00,4,2,2,FMN 08 Schijnpoortweg
675,Schijnpoortweg,2023-09-23,23:00:00,3,0,3,FMN 08 Schijnpoortweg
675,Schijnpoortweg,2023-09-24,00:00:00,0,0,0,FMN 08 Schijnpoortweg
675,Schijnpoortweg,2023-09-24,01:00:00,3,1,2,FMN 08 Schijnpoortweg
675,Schijnpoortweg,2023-09-24,02:00:00,0,0,0,FMN 08 Schijnpoortweg
675,Schijnpoortweg,2023-09-24,03:00:00,0,0,0,FMN 08 Schijnpoortweg
675,Schijnpoortweg,2023-09-24,04:00:00,1,1,0,FMN 08 Schijnpoortweg
675,Schijnpoortweg,2023-09-24,05:00:00,1,0,1,FMN 08 Schijnpoortweg
675,Schijnpoortweg,2023-09-24,06:00:00,0,0,0,FMN 08 Schijnpoortweg
675,Schijnpoortweg,2023-09-24,07:00:00,0,0,0,FMN 08 Schijnpoortweg
675,Schijnpoortweg,2023-09-24,08:00:00,1,0,1,FMN 08 Schijnpoortweg
675,Schijnpoortweg,2023-09-24,09:00:00,4,2,2,FMN 08 Schijnpoortweg
675,Schijnpoortweg,2023-09-24,10:00:00,2,0,2,FMN 08 Schijnpoortweg
675,Schijnpoortweg,2023-09-24,11:00:00,0,0,0,FMN 08 Schijnpoortweg
675,Schijnpoortweg,2023-09-24,12:00:00,2,2,0,FMN 08 Schijnpoortweg
675,Schijnpoortweg,2023-09-24,13:00:00,4,2,2,FMN 08 Schijnpoortweg
675,Schijnpoortweg,2023-09-24,14:00:00,0,0,0,FMN 08 Schijnpoortweg
675,Schijnpoortweg,2023-09-24,15:00:00,5,2,3,FMN 08 Schijnpoortweg
675,Schijnpoortweg,2023-09-24,16:00:00,8,2,6,FMN 08 Schijnpoortweg
675,Schijnpoortweg,2023-09-24,17:00:00,8,2,6,FMN 08 Schijnpoortweg
675,Schijnpoortweg,2023-09-24,18:00:00,7,1,6,FMN 08 Schijnpoortweg
675,Schijnpoortweg,2023-09-24,19:00:00,8,1,7,FMN 08 Schijnpoortweg
675,Schijnpoortweg,2023-09-24,20:00:00,5,3,2,FMN 08 Schijnpoortweg
675,Schijnpoortweg,2023-09-24,21:00:00,3,1,2,FMN 08 Schijnpoortweg
675,Schijnpoortweg,2023-09-24,22:00:00,2,1,1,FMN 08 Schijnpoortweg
675,Schijnpoortweg,2023-09-24,23:00:00,0,0,0,FMN 08 Schijnpoortweg
675,Schijnpoortweg,2023-09-25,00:00:00,0,0,0,FMN 08 Schijnpoortweg
675,Schijnpoortweg,2023-09-25,01:00:00,0,0,0,FMN 08 Schijnpoortweg
675,Schijnpoortweg,2023-09-25,02:00:00,1,0,1,FMN 08 Schijnpoortweg
675,Schijnpoortweg,2023-09-25,03:00:00,1,1,0,FMN 08 Schijnpoortweg
675,Schijnpoortweg,2023-09-25,04:00:00,0,0,0,FMN 08 Schijnpoortweg
675,Schijnpoortweg,2023-09-25,05:00:00,4,0,4,FMN 08 Schijnpoortweg
675,Schijnpoortweg,2023-09-25,06:00:00,6,1,5,FMN 08 Schijnpoortweg
675,Schijnpoortweg,2023-09-25,07:00:00,1,1,0,FMN 08 Schijnpoortweg
675,Schijnpoortweg,2023-09-25,08:00:00,2,1,1,FMN 08 Schijnpoortweg
675,Schijnpoortweg,2023-09-25,09:00:00,1,0,1,FMN 08 Schijnpoortweg
675,Schijnpoortweg,2023-09-25,10:00:00,1,0,1,FMN 08 Schijnpoortweg
675,Schijnpoortweg,2023-09-25,11:00:00,2,0,2,FMN 08 Schijnpoortweg
675,Schijnpoortweg,2023-09-25,12:00:00,1,0,1,FMN 08 Schijnpoortweg
675,Schijnpoortweg,2023-09-25,13:00:00,0,0,0,FMN 08 Schijnpoortweg
675,Schijnpoortweg,2023-09-25,14:00:00,2,1,1,FMN 08 Schijnpoortweg
675,Schijnpoortweg,2023-09-25,15:00:00,6,4,2,FMN 08 Schijnpoortweg
675,Schijnpoortweg,2023-09-25,16:00:00,13,3,10,FMN 08 Schijnpoortweg
675,Schijnpoortweg,2023-09-25,17:00:00,8,2,6,FMN 08 Schijnpoortweg
675,Schijnpoortweg,2023-09-25,18:00:00,7,3,4,FMN 08 Schijnpoortweg
675,Schijnpoortweg,2023-09-25,19:00:00,2,0,2,FMN 08 Schijnpoortweg
675,Schijnpoortweg,2023-09-25,20:00:00,9,4,5,FMN 08 Schijnpoortweg
675,Schijnpoortweg,2023-09-25,21:00:00,4,2,2,FMN 08 Schijnpoortweg
675,Schijnpoortweg,2023-09-25,22:00:00,1,1,0,FMN 08 Schijnpoortweg
675,Schijnpoortweg,2023-09-25,23:00:00,1,0,1,FMN 08 Schijnpoortweg
675,Schijnpoortweg,2023-09-26,00:00:00,3,0,3,FMN 08 Schijnpoortweg
675,Schijnpoortweg,2023-09-26,01:00:00,1,1,0,FMN 08 Schijnpoortweg
675,Schijnpoortweg,2023-09-26,02:00:00,2,1,1,FMN 08 Schijnpoortweg
675,Schijnpoortweg,2023-09-26,03:00:00,0,0,0,FMN 08 Schijnpoortweg
675,Schijnpoortweg,2023-09-26,04:00:00,2,1,1,FMN 08 Schijnpoortweg
675,Schijnpoortweg,2023-09-26,05:00:00,2,0,2,FMN 08 Schijnpoortweg
675,Schijnpoortweg,2023-09-26,06:00:00,7,2,5,FMN 08 Schijnpoortweg
675,Schijnpoortweg,2023-09-26,07:00:00,4,2,2,FMN 08 Schijnpoortweg
675,Schijnpoortweg,2023-09-26,08:00:00,2,1,1,FMN 08 Schijnpoortweg
675,Schijnpoortweg,2023-09-26,09:00:00,3,2,1,FMN 08 Schijnpoortweg
675,Schijnpoortweg,2023-09-26,10:00:00,2,0,2,FMN 08 Schijnpoortweg
675,Schijnpoortweg,2023-09-26,11:00:00,0,0,0,FMN 08 Schijnpoortweg
675,Schijnpoortweg,2023-09-26,12:00:00,4,1,3,FMN 08 Schijnpoortweg
675,Schijnpoortweg,2023-09-26,13:00:00,2,1,1,FMN 08 Schijnpoortweg
675,Schijnpoortweg,2023-09-26,14:00:00,4,0,4,FMN 08 Schijnpoortweg
675,Schijnpoortweg,2023-09-26,15:00:00,6,1,5,FMN 08 Schijnpoortweg
675,Schijnpoortweg,2023-09-26,16:00:00,5,3,2,FMN 08 Schijnpoortweg
675,Schijnpoortweg,2023-09-26,17:00:00,10,6,4,FMN 08 Schijnpoortweg
675,Schijnpoortweg,2023-09-26,18:00:00,7,4,3,FMN 08 Schijnpoortweg
675,Schijnpoortweg,2023-09-26,19:00:00,10,1,9,FMN 08 Schijnpoortweg
675,Schijnpoortweg,2023-09-26,20:00:00,5,0,5,FMN 08 Schijnpoortweg
675,Schijnpoortweg,2023-09-26,21:00:00,6,0,6,FMN 08 Schijnpoortweg
675,Schijnpoortweg,2023-09-26,22:00:00,6,1,5,FMN 08 Schijnpoortweg
675,Schijnpoortweg,2023-09-26,23:00:00,4,2,2,FMN 08 Schijnpoortweg
675,Schijnpoortweg,2023-09-27,00:00:00,2,0,2,FMN 08 Schijnpoortweg
675,Schijnpoortweg,2023-09-27,01:00:00,0,0,0,FMN 08 Schijnpoortweg
675,Schijnpoortweg,2023-09-27,02:00:00,1,0,1,FMN 08 Schijnpoortweg
675,Schijnpoortweg,2023-09-27,03:00:00,1,0,1,FMN 08 Schijnpoortweg
675,Schijnpoortweg,2023-09-27,04:00:00,1,1,0,FMN 08 Schijnpoortweg
675,Schijnpoortweg,2023-09-27,05:00:00,3,1,2,FMN 08 Schijnpoortweg
675,Schijnpoortweg,2023-09-27,06:00:00,4,1,3,FMN 08 Schijnpoortweg
675,Schijnpoortweg,2023-09-27,07:00:00,2,2,0,FMN 08 Schijnpoortweg
675,Schijnpoortweg,2023-09-27,08:00:00,0,0,0,FMN 08 Schijnpoortweg
675,Schijnpoortweg,2023-09-27,09:00:00,6,3,3,FMN 08 Schijnpoortweg
675,Schijnpoortweg,2023-09-27,10:00:00,1,0,1,FMN 08 Schijnpoortweg
675,Schijnpoortweg,2023-09-27,11:00:00,6,1,5,FMN 08 Schijnpoortweg
675,Schijnpoortweg,2023-09-27,12:00:00,10,2,8,FMN 08 Schijnpoortweg
675,Schijnpoortweg,2023-09-27,13:00:00,2,0,2,FMN 08 Schijnpoortweg
675,Schijnpoortweg,2023-09-27,14:00:00,5,0,5,FMN 08 Schijnpoortweg
675,Schijnpoortweg,2023-09-27,15:00:00,10,2,8,FMN 08 Schijnpoortweg
675,Schijnpoortweg,2023-09-27,16:00:00,11,0,11,FMN 08 Schijnpoortweg
675,Schijnpoortweg,2023-09-27,17:00:00,7,2,5,FMN 08 Schijnpoortweg
675,Schijnpoortweg,2023-09-27,18:00:00,12,0,12,FMN 08 Schijnpoortweg
675,Schijnpoortweg,2023-09-27,19:00:00,3,0,3,FMN 08 Schijnpoortweg
675,Schijnpoortweg,2023-09-27,20:00:00,5,1,4,FMN 08 Schijnpoortweg
675,Schijnpoortweg,2023-09-27,21:00:00,4,0,4,FMN 08 Schijnpoortweg
675,Schijnpoortweg,2023-09-27,22:00:00,2,0,2,FMN 08 Schijnpoortweg
675,Schijnpoortweg,2023-09-27,23:00:00,0,0,0,FMN 08 Schijnpoortweg
