Meetpunt surrogate key,Meetpunt locatie,Datum,Tijd,Aantal fietsers,Aantal fietsers van,Aantal fietsers naar,Meetpunt code
665,Uitbreidingstraat 390,2022-11-10,00:00:00,16,8,8,FMN 18 Binnensingel Westkant
665,Uitbreidingstraat 390,2022-11-10,01:00:00,5,2,3,FMN 18 Binnensingel Westkant
665,Uitbreidingstraat 390,2022-11-10,02:00:00,4,0,4,FMN 18 Binnensingel Westkant
665,Uitbreidingstraat 390,2022-11-10,03:00:00,3,0,3,FMN 18 Binnensingel Westkant
665,Uitbreidingstraat 390,2022-11-10,04:00:00,10,1,9,FMN 18 Binnensingel Westkant
665,Uitbreidingstraat 390,2022-11-10,05:00:00,30,4,26,FMN 18 Binnensingel Westkant
665,Uitbreidingstraat 390,2022-11-10,06:00:00,73,20,53,FMN 18 Binnensingel Westkant
665,Uitbreidingstraat 390,2022-11-10,07:00:00,302,50,252,FMN 18 Binnensingel Westkant
665,Uitbreidingstraat 390,2022-11-10,08:00:00,537,88,449,FMN 18 Binnensingel Westkant
665,Uitbreidingstraat 390,2022-11-10,09:00:00,192,28,164,FMN 18 Binnensingel Westkant
665,Uitbreidingstraat 390,2022-11-10,10:00:00,139,35,104,FMN 18 Binnensingel Westkant
665,Uitbreidingstraat 390,2022-11-10,11:00:00,125,41,84,FMN 18 Binnensingel Westkant
665,Uitbreidingstraat 390,2022-11-10,12:00:00,146,56,90,FMN 18 Binnensingel Westkant
665,Uitbreidingstraat 390,2022-11-10,13:00:00,149,35,114,FMN 18 Binnensingel Westkant
665,Uitbreidingstraat 390,2022-11-10,14:00:00,132,54,78,FMN 18 Binnensingel Westkant
665,Uitbreidingstraat 390,2022-11-10,15:00:00,218,108,110,FMN 18 Binnensingel Westkant
665,Uitbreidingstraat 390,2022-11-10,16:00:00,385,239,146,FMN 18 Binnensingel Westkant
665,Uitbreidingstraat 390,2022-11-10,17:00:00,299,154,145,FMN 18 Binnensingel Westkant
665,Uitbreidingstraat 390,2022-11-10,18:00:00,289,97,192,FMN 18 Binnensingel Westkant
665,Uitbreidingstraat 390,2022-11-10,19:00:00,163,47,116,FMN 18 Binnensingel Westkant
665,Uitbreidingstraat 390,2022-11-10,20:00:00,108,33,75,FMN 18 Binnensingel Westkant
665,Uitbreidingstraat 390,2022-11-10,21:00:00,96,37,59,FMN 18 Binnensingel Westkant
665,Uitbreidingstraat 390,2022-11-10,22:00:00,108,39,69,FMN 18 Binnensingel Westkant
665,Uitbreidingstraat 390,2022-11-10,23:00:00,90,17,73,FMN 18 Binnensingel Westkant
665,Uitbreidingstraat 390,2022-11-11,00:00:00,66,18,48,FMN 18 Binnensingel Westkant
665,Uitbreidingstraat 390,2022-11-11,01:00:00,57,5,52,FMN 18 Binnensingel Westkant
665,Uitbreidingstraat 390,2022-11-11,02:00:00,36,6,30,FMN 18 Binnensingel Westkant
665,Uitbreidingstraat 390,2022-11-11,03:00:00,42,9,33,FMN 18 Binnensingel Westkant
665,Uitbreidingstraat 390,2022-11-11,04:00:00,23,5,18,FMN 18 Binnensingel Westkant
665,Uitbreidingstraat 390,2022-11-11,05:00:00,34,8,26,FMN 18 Binnensingel Westkant
665,Uitbreidingstraat 390,2022-11-11,06:00:00,42,13,29,FMN 18 Binnensingel Westkant
665,Uitbreidingstraat 390,2022-11-11,07:00:00,33,5,28,FMN 18 Binnensingel Westkant
665,Uitbreidingstraat 390,2022-11-11,08:00:00,38,14,24,FMN 18 Binnensingel Westkant
665,Uitbreidingstraat 390,2022-11-11,09:00:00,52,18,34,FMN 18 Binnensingel Westkant
665,Uitbreidingstraat 390,2022-11-11,10:00:00,88,23,65,FMN 18 Binnensingel Westkant
665,Uitbreidingstraat 390,2022-11-11,11:00:00,71,21,50,FMN 18 Binnensingel Westkant
665,Uitbreidingstraat 390,2022-11-11,12:00:00,102,34,68,FMN 18 Binnensingel Westkant
665,Uitbreidingstraat 390,2022-11-11,13:00:00,78,22,56,FMN 18 Binnensingel Westkant
665,Uitbreidingstraat 390,2022-11-11,14:00:00,107,33,74,FMN 18 Binnensingel Westkant
665,Uitbreidingstraat 390,2022-11-11,15:00:00,85,31,54,FMN 18 Binnensingel Westkant
665,Uitbreidingstraat 390,2022-11-11,16:00:00,82,21,61,FMN 18 Binnensingel Westkant
665,Uitbreidingstraat 390,2022-11-11,17:00:00,99,35,64,FMN 18 Binnensingel Westkant
665,Uitbreidingstraat 390,2022-11-11,18:00:00,113,24,89,FMN 18 Binnensingel Westkant
665,Uitbreidingstraat 390,2022-11-11,19:00:00,109,26,83,FMN 18 Binnensingel Westkant
665,Uitbreidingstraat 390,2022-11-11,20:00:00,68,26,42,FMN 18 Binnensingel Westkant
665,Uitbreidingstraat 390,2022-11-11,21:00:00,54,21,33,FMN 18 Binnensingel Westkant
665,Uitbreidingstraat 390,2022-11-11,22:00:00,62,18,44,FMN 18 Binnensingel Westkant
665,Uitbreidingstraat 390,2022-11-11,23:00:00,50,7,43,FMN 18 Binnensingel Westkant
665,Uitbreidingstraat 390,2022-11-12,00:00:00,34,8,26,FMN 18 Binnensingel Westkant
665,Uitbreidingstraat 390,2022-11-12,01:00:00,43,7,36,FMN 18 Binnensingel Westkant
665,Uitbreidingstraat 390,2022-11-12,02:00:00,18,2,16,FMN 18 Binnensingel Westkant
665,Uitbreidingstraat 390,2022-11-12,03:00:00,8,1,7,FMN 18 Binnensingel Westkant
665,Uitbreidingstraat 390,2022-11-12,04:00:00,8,4,4,FMN 18 Binnensingel Westkant
665,Uitbreidingstraat 390,2022-11-12,05:00:00,27,3,24,FMN 18 Binnensingel Westkant
665,Uitbreidingstraat 390,2022-11-12,06:00:00,31,8,23,FMN 18 Binnensingel Westkant
665,Uitbreidingstraat 390,2022-11-12,07:00:00,19,5,14,FMN 18 Binnensingel Westkant
665,Uitbreidingstraat 390,2022-11-12,08:00:00,45,16,29,FMN 18 Binnensingel Westkant
665,Uitbreidingstraat 390,2022-11-12,09:00:00,80,20,60,FMN 18 Binnensingel Westkant
665,Uitbreidingstraat 390,2022-11-12,10:00:00,128,37,91,FMN 18 Binnensingel Westkant
665,Uitbreidingstraat 390,2022-11-12,11:00:00,85,29,56,FMN 18 Binnensingel Westkant
665,Uitbreidingstraat 390,2022-11-12,12:00:00,85,29,56,FMN 18 Binnensingel Westkant
665,Uitbreidingstraat 390,2022-11-12,13:00:00,106,32,74,FMN 18 Binnensingel Westkant
665,Uitbreidingstraat 390,2022-11-12,14:00:00,100,27,73,FMN 18 Binnensingel Westkant
665,Uitbreidingstraat 390,2022-11-12,15:00:00,133,30,103,FMN 18 Binnensingel Westkant
665,Uitbreidingstraat 390,2022-11-12,16:00:00,87,31,56,FMN 18 Binnensingel Westkant
665,Uitbreidingstraat 390,2022-11-12,17:00:00,111,35,76,FMN 18 Binnensingel Westkant
665,Uitbreidingstraat 390,2022-11-12,18:00:00,98,36,62,FMN 18 Binnensingel Westkant
665,Uitbreidingstraat 390,2022-11-12,19:00:00,106,19,87,FMN 18 Binnensingel Westkant
665,Uitbreidingstraat 390,2022-11-12,20:00:00,63,17,46,FMN 18 Binnensingel Westkant
665,Uitbreidingstraat 390,2022-11-12,21:00:00,56,17,39,FMN 18 Binnensingel Westkant
665,Uitbreidingstraat 390,2022-11-12,22:00:00,56,20,36,FMN 18 Binnensingel Westkant
665,Uitbreidingstraat 390,2022-11-12,23:00:00,87,26,61,FMN 18 Binnensingel Westkant
665,Uitbreidingstraat 390,2022-11-13,00:00:00,42,11,31,FMN 18 Binnensingel Westkant
665,Uitbreidingstraat 390,2022-11-13,01:00:00,26,1,25,FMN 18 Binnensingel Westkant
665,Uitbreidingstraat 390,2022-11-13,02:00:00,34,8,26,FMN 18 Binnensingel Westkant
665,Uitbreidingstraat 390,2022-11-13,03:00:00,15,1,14,FMN 18 Binnensingel Westkant
665,Uitbreidingstraat 390,2022-11-13,04:00:00,25,4,21,FMN 18 Binnensingel Westkant
665,Uitbreidingstraat 390,2022-11-13,05:00:00,19,1,18,FMN 18 Binnensingel Westkant
665,Uitbreidingstraat 390,2022-11-13,06:00:00,18,5,13,FMN 18 Binnensingel Westkant
665,Uitbreidingstraat 390,2022-11-13,07:00:00,14,0,14,FMN 18 Binnensingel Westkant
665,Uitbreidingstraat 390,2022-11-13,08:00:00,17,7,10,FMN 18 Binnensingel Westkant
665,Uitbreidingstraat 390,2022-11-13,09:00:00,65,23,42,FMN 18 Binnensingel Westkant
665,Uitbreidingstraat 390,2022-11-13,10:00:00,64,17,47,FMN 18 Binnensingel Westkant
665,Uitbreidingstraat 390,2022-11-13,11:00:00,94,33,61,FMN 18 Binnensingel Westkant
665,Uitbreidingstraat 390,2022-11-13,12:00:00,102,38,64,FMN 18 Binnensingel Westkant
665,Uitbreidingstraat 390,2022-11-13,13:00:00,94,17,77,FMN 18 Binnensingel Westkant
665,Uitbreidingstraat 390,2022-11-13,14:00:00,112,21,91,FMN 18 Binnensingel Westkant
665,Uitbreidingstraat 390,2022-11-13,15:00:00,102,28,74,FMN 18 Binnensingel Westkant
665,Uitbreidingstraat 390,2022-11-13,16:00:00,86,21,65,FMN 18 Binnensingel Westkant
665,Uitbreidingstraat 390,2022-11-13,17:00:00,113,36,77,FMN 18 Binnensingel Westkant
665,Uitbreidingstraat 390,2022-11-13,18:00:00,76,17,59,FMN 18 Binnensingel Westkant
665,Uitbreidingstraat 390,2022-11-13,19:00:00,69,8,61,FMN 18 Binnensingel Westkant
665,Uitbreidingstraat 390,2022-11-13,20:00:00,67,16,51,FMN 18 Binnensingel Westkant
665,Uitbreidingstraat 390,2022-11-13,21:00:00,34,6,28,FMN 18 Binnensingel Westkant
665,Uitbreidingstraat 390,2022-11-13,22:00:00,46,9,37,FMN 18 Binnensingel Westkant
665,Uitbreidingstraat 390,2022-11-13,23:00:00,19,4,15,FMN 18 Binnensingel Westkant
665,Uitbreidingstraat 390,2022-11-14,00:00:00,9,6,3,FMN 18 Binnensingel Westkant
665,Uitbreidingstraat 390,2022-11-14,01:00:00,5,0,5,FMN 18 Binnensingel Westkant
665,Uitbreidingstraat 390,2022-11-14,02:00:00,0,0,0,FMN 18 Binnensingel Westkant
665,Uitbreidingstraat 390,2022-11-14,03:00:00,2,0,2,FMN 18 Binnensingel Westkant
665,Uitbreidingstraat 390,2022-11-14,04:00:00,7,2,5,FMN 18 Binnensingel Westkant
665,Uitbreidingstraat 390,2022-11-14,05:00:00,30,6,24,FMN 18 Binnensingel Westkant
665,Uitbreidingstraat 390,2022-11-14,06:00:00,72,11,61,FMN 18 Binnensingel Westkant
665,Uitbreidingstraat 390,2022-11-14,07:00:00,300,49,251,FMN 18 Binnensingel Westkant
665,Uitbreidingstraat 390,2022-11-14,08:00:00,531,85,446,FMN 18 Binnensingel Westkant
665,Uitbreidingstraat 390,2022-11-14,09:00:00,179,21,158,FMN 18 Binnensingel Westkant
665,Uitbreidingstraat 390,2022-11-14,10:00:00,145,23,122,FMN 18 Binnensingel Westkant
665,Uitbreidingstraat 390,2022-11-14,11:00:00,81,22,59,FMN 18 Binnensingel Westkant
665,Uitbreidingstraat 390,2022-11-14,12:00:00,144,56,88,FMN 18 Binnensingel Westkant
665,Uitbreidingstraat 390,2022-11-14,13:00:00,135,31,104,FMN 18 Binnensingel Westkant
665,Uitbreidingstraat 390,2022-11-14,14:00:00,146,63,83,FMN 18 Binnensingel Westkant
665,Uitbreidingstraat 390,2022-11-14,15:00:00,186,109,77,FMN 18 Binnensingel Westkant
665,Uitbreidingstraat 390,2022-11-14,16:00:00,395,241,154,FMN 18 Binnensingel Westkant
665,Uitbreidingstraat 390,2022-11-14,17:00:00,306,135,171,FMN 18 Binnensingel Westkant
665,Uitbreidingstraat 390,2022-11-14,18:00:00,237,98,139,FMN 18 Binnensingel Westkant
665,Uitbreidingstraat 390,2022-11-14,19:00:00,147,33,114,FMN 18 Binnensingel Westkant
665,Uitbreidingstraat 390,2022-11-14,20:00:00,60,25,35,FMN 18 Binnensingel Westkant
665,Uitbreidingstraat 390,2022-11-14,21:00:00,72,35,37,FMN 18 Binnensingel Westkant
665,Uitbreidingstraat 390,2022-11-14,22:00:00,58,16,42,FMN 18 Binnensingel Westkant
665,Uitbreidingstraat 390,2022-11-14,23:00:00,21,5,16,FMN 18 Binnensingel Westkant
665,Uitbreidingstraat 390,2022-11-15,00:00:00,7,3,4,FMN 18 Binnensingel Westkant
665,Uitbreidingstraat 390,2022-11-15,01:00:00,11,1,10,FMN 18 Binnensingel Westkant
665,Uitbreidingstraat 390,2022-11-15,02:00:00,3,0,3,FMN 18 Binnensingel Westkant
665,Uitbreidingstraat 390,2022-11-15,03:00:00,4,0,4,FMN 18 Binnensingel Westkant
665,Uitbreidingstraat 390,2022-11-15,04:00:00,7,2,5,FMN 18 Binnensingel Westkant
665,Uitbreidingstraat 390,2022-11-15,05:00:00,27,4,23,FMN 18 Binnensingel Westkant
665,Uitbreidingstraat 390,2022-11-15,06:00:00,82,23,59,FMN 18 Binnensingel Westkant
665,Uitbreidingstraat 390,2022-11-15,07:00:00,294,46,248,FMN 18 Binnensingel Westkant
665,Uitbreidingstraat 390,2022-11-15,08:00:00,574,72,502,FMN 18 Binnensingel Westkant
665,Uitbreidingstraat 390,2022-11-15,09:00:00,209,37,172,FMN 18 Binnensingel Westkant
665,Uitbreidingstraat 390,2022-11-15,10:00:00,136,33,103,FMN 18 Binnensingel Westkant
665,Uitbreidingstraat 390,2022-11-15,11:00:00,94,26,68,FMN 18 Binnensingel Westkant
665,Uitbreidingstraat 390,2022-11-15,12:00:00,155,54,101,FMN 18 Binnensingel Westkant
665,Uitbreidingstraat 390,2022-11-15,13:00:00,129,38,91,FMN 18 Binnensingel Westkant
665,Uitbreidingstraat 390,2022-11-15,14:00:00,112,43,69,FMN 18 Binnensingel Westkant
665,Uitbreidingstraat 390,2022-11-15,15:00:00,214,129,85,FMN 18 Binnensingel Westkant
665,Uitbreidingstraat 390,2022-11-15,16:00:00,366,237,129,FMN 18 Binnensingel Westkant
665,Uitbreidingstraat 390,2022-11-15,17:00:00,292,164,128,FMN 18 Binnensingel Westkant
665,Uitbreidingstraat 390,2022-11-15,18:00:00,201,77,124,FMN 18 Binnensingel Westkant
665,Uitbreidingstraat 390,2022-11-15,19:00:00,123,45,78,FMN 18 Binnensingel Westkant
665,Uitbreidingstraat 390,2022-11-15,20:00:00,68,20,48,FMN 18 Binnensingel Westkant
665,Uitbreidingstraat 390,2022-11-15,21:00:00,57,15,42,FMN 18 Binnensingel Westkant
665,Uitbreidingstraat 390,2022-11-15,22:00:00,67,29,38,FMN 18 Binnensingel Westkant
665,Uitbreidingstraat 390,2022-11-15,23:00:00,31,8,23,FMN 18 Binnensingel Westkant
665,Uitbreidingstraat 390,2022-11-16,00:00:00,11,1,10,FMN 18 Binnensingel Westkant
665,Uitbreidingstraat 390,2022-11-16,01:00:00,4,0,4,FMN 18 Binnensingel Westkant
665,Uitbreidingstraat 390,2022-11-16,02:00:00,1,0,1,FMN 18 Binnensingel Westkant
665,Uitbreidingstraat 390,2022-11-16,03:00:00,2,0,2,FMN 18 Binnensingel Westkant
665,Uitbreidingstraat 390,2022-11-16,04:00:00,8,3,5,FMN 18 Binnensingel Westkant
665,Uitbreidingstraat 390,2022-11-16,05:00:00,33,3,30,FMN 18 Binnensingel Westkant
665,Uitbreidingstraat 390,2022-11-16,06:00:00,79,17,62,FMN 18 Binnensingel Westkant
665,Uitbreidingstraat 390,2022-11-16,07:00:00,281,51,230,FMN 18 Binnensingel Westkant
665,Uitbreidingstraat 390,2022-11-16,08:00:00,487,88,399,FMN 18 Binnensingel Westkant
665,Uitbreidingstraat 390,2022-11-16,09:00:00,160,27,133,FMN 18 Binnensingel Westkant
665,Uitbreidingstraat 390,2022-11-16,10:00:00,136,29,107,FMN 18 Binnensingel Westkant
665,Uitbreidingstraat 390,2022-11-16,11:00:00,111,61,50,FMN 18 Binnensingel Westkant
665,Uitbreidingstraat 390,2022-11-16,12:00:00,265,159,106,FMN 18 Binnensingel Westkant
665,Uitbreidingstraat 390,2022-11-16,13:00:00,217,103,114,FMN 18 Binnensingel Westkant
665,Uitbreidingstraat 390,2022-11-16,14:00:00,104,37,67,FMN 18 Binnensingel Westkant
665,Uitbreidingstraat 390,2022-11-16,15:00:00,168,71,97,FMN 18 Binnensingel Westkant
665,Uitbreidingstraat 390,2022-11-16,16:00:00,214,102,112,FMN 18 Binnensingel Westkant
665,Uitbreidingstraat 390,2022-11-16,17:00:00,286,133,153,FMN 18 Binnensingel Westkant
665,Uitbreidingstraat 390,2022-11-16,18:00:00,225,78,147,FMN 18 Binnensingel Westkant
665,Uitbreidingstraat 390,2022-11-16,19:00:00,126,37,89,FMN 18 Binnensingel Westkant
665,Uitbreidingstraat 390,2022-11-16,20:00:00,88,36,52,FMN 18 Binnensingel Westkant
665,Uitbreidingstraat 390,2022-11-16,21:00:00,64,20,44,FMN 18 Binnensingel Westkant
665,Uitbreidingstraat 390,2022-11-16,22:00:00,66,32,34,FMN 18 Binnensingel Westkant
665,Uitbreidingstraat 390,2022-11-16,23:00:00,45,9,36,FMN 18 Binnensingel Westkant
665,Uitbreidingstraat 390,2022-11-17,00:00:00,14,4,10,FMN 18 Binnensingel Westkant
665,Uitbreidingstraat 390,2022-11-17,01:00:00,7,4,3,FMN 18 Binnensingel Westkant
665,Uitbreidingstraat 390,2022-11-17,02:00:00,7,4,3,FMN 18 Binnensingel Westkant
665,Uitbreidingstraat 390,2022-11-17,03:00:00,6,1,5,FMN 18 Binnensingel Westkant
665,Uitbreidingstraat 390,2022-11-17,04:00:00,10,4,6,FMN 18 Binnensingel Westkant
665,Uitbreidingstraat 390,2022-11-17,05:00:00,30,6,24,FMN 18 Binnensingel Westkant
665,Uitbreidingstraat 390,2022-11-17,06:00:00,60,17,43,FMN 18 Binnensingel Westkant
665,Uitbreidingstraat 390,2022-11-17,07:00:00,224,33,191,FMN 18 Binnensingel Westkant
665,Uitbreidingstraat 390,2022-11-17,08:00:00,440,78,362,FMN 18 Binnensingel Westkant
665,Uitbreidingstraat 390,2022-11-17,09:00:00,154,23,131,FMN 18 Binnensingel Westkant
665,Uitbreidingstraat 390,2022-11-17,10:00:00,104,26,78,FMN 18 Binnensingel Westkant
665,Uitbreidingstraat 390,2022-11-17,11:00:00,53,19,34,FMN 18 Binnensingel Westkant
665,Uitbreidingstraat 390,2022-11-17,12:00:00,124,44,80,FMN 18 Binnensingel Westkant
665,Uitbreidingstraat 390,2022-11-17,13:00:00,97,29,68,FMN 18 Binnensingel Westkant
665,Uitbreidingstraat 390,2022-11-17,14:00:00,91,33,58,FMN 18 Binnensingel Westkant
665,Uitbreidingstraat 390,2022-11-17,15:00:00,182,95,87,FMN 18 Binnensingel Westkant
665,Uitbreidingstraat 390,2022-11-17,16:00:00,280,167,113,FMN 18 Binnensingel Westkant
665,Uitbreidingstraat 390,2022-11-17,17:00:00,288,129,159,FMN 18 Binnensingel Westkant
665,Uitbreidingstraat 390,2022-11-17,18:00:00,243,86,157,FMN 18 Binnensingel Westkant
665,Uitbreidingstraat 390,2022-11-17,19:00:00,117,35,82,FMN 18 Binnensingel Westkant
665,Uitbreidingstraat 390,2022-11-17,20:00:00,82,20,62,FMN 18 Binnensingel Westkant
665,Uitbreidingstraat 390,2022-11-17,21:00:00,70,26,44,FMN 18 Binnensingel Westkant
665,Uitbreidingstraat 390,2022-11-17,22:00:00,75,24,51,FMN 18 Binnensingel Westkant
665,Uitbreidingstraat 390,2022-11-17,23:00:00,42,11,31,FMN 18 Binnensingel Westkant
665,Uitbreidingstraat 390,2022-11-18,00:00:00,29,10,19,FMN 18 Binnensingel Westkant
665,Uitbreidingstraat 390,2022-11-18,01:00:00,5,2,3,FMN 18 Binnensingel Westkant
665,Uitbreidingstraat 390,2022-11-18,02:00:00,10,3,7,FMN 18 Binnensingel Westkant
665,Uitbreidingstraat 390,2022-11-18,03:00:00,9,0,9,FMN 18 Binnensingel Westkant
665,Uitbreidingstraat 390,2022-11-18,04:00:00,11,2,9,FMN 18 Binnensingel Westkant
665,Uitbreidingstraat 390,2022-11-18,05:00:00,22,5,17,FMN 18 Binnensingel Westkant
665,Uitbreidingstraat 390,2022-11-18,06:00:00,76,15,61,FMN 18 Binnensingel Westkant
665,Uitbreidingstraat 390,2022-11-18,07:00:00,227,32,195,FMN 18 Binnensingel Westkant
665,Uitbreidingstraat 390,2022-11-18,08:00:00,466,90,376,FMN 18 Binnensingel Westkant
665,Uitbreidingstraat 390,2022-11-18,09:00:00,167,36,131,FMN 18 Binnensingel Westkant
665,Uitbreidingstraat 390,2022-11-18,10:00:00,129,26,103,FMN 18 Binnensingel Westkant
665,Uitbreidingstraat 390,2022-11-18,11:00:00,98,28,70,FMN 18 Binnensingel Westkant
665,Uitbreidingstraat 390,2022-11-18,12:00:00,159,56,103,FMN 18 Binnensingel Westkant
665,Uitbreidingstraat 390,2022-11-18,13:00:00,119,38,81,FMN 18 Binnensingel Westkant
665,Uitbreidingstraat 390,2022-11-18,14:00:00,104,52,52,FMN 18 Binnensingel Westkant
665,Uitbreidingstraat 390,2022-11-18,15:00:00,179,78,101,FMN 18 Binnensingel Westkant
665,Uitbreidingstraat 390,2022-11-18,16:00:00,352,233,119,FMN 18 Binnensingel Westkant
665,Uitbreidingstraat 390,2022-11-18,17:00:00,250,122,128,FMN 18 Binnensingel Westkant
665,Uitbreidingstraat 390,2022-11-18,18:00:00,138,51,87,FMN 18 Binnensingel Westkant
665,Uitbreidingstraat 390,2022-11-18,19:00:00,94,28,66,FMN 18 Binnensingel Westkant
665,Uitbreidingstraat 390,2022-11-18,20:00:00,58,18,40,FMN 18 Binnensingel Westkant
665,Uitbreidingstraat 390,2022-11-18,21:00:00,56,27,29,FMN 18 Binnensingel Westkant
665,Uitbreidingstraat 390,2022-11-18,22:00:00,48,16,32,FMN 18 Binnensingel Westkant
665,Uitbreidingstraat 390,2022-11-18,23:00:00,39,13,26,FMN 18 Binnensingel Westkant
665,Uitbreidingstraat 390,2022-11-19,00:00:00,33,7,26,FMN 18 Binnensingel Westkant
665,Uitbreidingstraat 390,2022-11-19,01:00:00,28,7,21,FMN 18 Binnensingel Westkant
665,Uitbreidingstraat 390,2022-11-19,02:00:00,16,7,9,FMN 18 Binnensingel Westkant
665,Uitbreidingstraat 390,2022-11-19,03:00:00,15,9,6,FMN 18 Binnensingel Westkant
665,Uitbreidingstraat 390,2022-11-19,04:00:00,14,3,11,FMN 18 Binnensingel Westkant
665,Uitbreidingstraat 390,2022-11-19,05:00:00,12,5,7,FMN 18 Binnensingel Westkant
665,Uitbreidingstraat 390,2022-11-19,06:00:00,30,8,22,FMN 18 Binnensingel Westkant
665,Uitbreidingstraat 390,2022-11-19,07:00:00,10,1,9,FMN 18 Binnensingel Westkant
665,Uitbreidingstraat 390,2022-11-19,08:00:00,31,7,24,FMN 18 Binnensingel Westkant
665,Uitbreidingstraat 390,2022-11-19,09:00:00,42,8,34,FMN 18 Binnensingel Westkant
665,Uitbreidingstraat 390,2022-11-19,10:00:00,46,12,34,FMN 18 Binnensingel Westkant
665,Uitbreidingstraat 390,2022-11-19,11:00:00,62,27,35,FMN 18 Binnensingel Westkant
665,Uitbreidingstraat 390,2022-11-19,12:00:00,101,24,77,FMN 18 Binnensingel Westkant
665,Uitbreidingstraat 390,2022-11-19,13:00:00,99,31,68,FMN 18 Binnensingel Westkant
665,Uitbreidingstraat 390,2022-11-19,14:00:00,97,28,69,FMN 18 Binnensingel Westkant
665,Uitbreidingstraat 390,2022-11-19,15:00:00,79,28,51,FMN 18 Binnensingel Westkant
665,Uitbreidingstraat 390,2022-11-19,16:00:00,76,32,44,FMN 18 Binnensingel Westkant
665,Uitbreidingstraat 390,2022-11-19,17:00:00,79,22,57,FMN 18 Binnensingel Westkant
665,Uitbreidingstraat 390,2022-11-19,18:00:00,79,29,50,FMN 18 Binnensingel Westkant
665,Uitbreidingstraat 390,2022-11-19,19:00:00,88,18,70,FMN 18 Binnensingel Westkant
665,Uitbreidingstraat 390,2022-11-19,20:00:00,32,10,22,FMN 18 Binnensingel Westkant
665,Uitbreidingstraat 390,2022-11-19,21:00:00,55,18,37,FMN 18 Binnensingel Westkant
665,Uitbreidingstraat 390,2022-11-19,22:00:00,29,10,19,FMN 18 Binnensingel Westkant
665,Uitbreidingstraat 390,2022-11-19,23:00:00,46,9,37,FMN 18 Binnensingel Westkant
665,Uitbreidingstraat 390,2022-11-20,00:00:00,26,4,22,FMN 18 Binnensingel Westkant
665,Uitbreidingstraat 390,2022-11-20,01:00:00,32,11,21,FMN 18 Binnensingel Westkant
665,Uitbreidingstraat 390,2022-11-20,02:00:00,15,4,11,FMN 18 Binnensingel Westkant
665,Uitbreidingstraat 390,2022-11-20,03:00:00,15,5,10,FMN 18 Binnensingel Westkant
665,Uitbreidingstraat 390,2022-11-20,04:00:00,15,1,14,FMN 18 Binnensingel Westkant
665,Uitbreidingstraat 390,2022-11-20,05:00:00,25,1,24,FMN 18 Binnensingel Westkant
665,Uitbreidingstraat 390,2022-11-20,06:00:00,18,2,16,FMN 18 Binnensingel Westkant
665,Uitbreidingstraat 390,2022-11-20,07:00:00,9,2,7,FMN 18 Binnensingel Westkant
665,Uitbreidingstraat 390,2022-11-20,08:00:00,34,2,32,FMN 18 Binnensingel Westkant
665,Uitbreidingstraat 390,2022-11-20,09:00:00,68,23,45,FMN 18 Binnensingel Westkant
665,Uitbreidingstraat 390,2022-11-20,10:00:00,64,14,50,FMN 18 Binnensingel Westkant
665,Uitbreidingstraat 390,2022-11-20,11:00:00,73,29,44,FMN 18 Binnensingel Westkant
665,Uitbreidingstraat 390,2022-11-20,12:00:00,105,33,72,FMN 18 Binnensingel Westkant
665,Uitbreidingstraat 390,2022-11-20,13:00:00,78,19,59,FMN 18 Binnensingel Westkant
665,Uitbreidingstraat 390,2022-11-20,14:00:00,50,11,39,FMN 18 Binnensingel Westkant
665,Uitbreidingstraat 390,2022-11-20,15:00:00,67,26,41,FMN 18 Binnensingel Westkant
665,Uitbreidingstraat 390,2022-11-20,16:00:00,55,21,34,FMN 18 Binnensingel Westkant
665,Uitbreidingstraat 390,2022-11-20,17:00:00,66,24,42,FMN 18 Binnensingel Westkant
665,Uitbreidingstraat 390,2022-11-20,18:00:00,51,15,36,FMN 18 Binnensingel Westkant
665,Uitbreidingstraat 390,2022-11-20,19:00:00,62,21,41,FMN 18 Binnensingel Westkant
665,Uitbreidingstraat 390,2022-11-20,20:00:00,47,11,36,FMN 18 Binnensingel Westkant
665,Uitbreidingstraat 390,2022-11-20,21:00:00,56,16,40,FMN 18 Binnensingel Westkant
665,Uitbreidingstraat 390,2022-11-20,22:00:00,31,4,27,FMN 18 Binnensingel Westkant
665,Uitbreidingstraat 390,2022-11-20,23:00:00,16,2,14,FMN 18 Binnensingel Westkant
665,Uitbreidingstraat 390,2022-11-21,00:00:00,18,2,16,FMN 18 Binnensingel Westkant
665,Uitbreidingstraat 390,2022-11-21,01:00:00,6,2,4,FMN 18 Binnensingel Westkant
665,Uitbreidingstraat 390,2022-11-21,02:00:00,1,0,1,FMN 18 Binnensingel Westkant
665,Uitbreidingstraat 390,2022-11-21,03:00:00,2,1,1,FMN 18 Binnensingel Westkant
665,Uitbreidingstraat 390,2022-11-21,04:00:00,14,3,11,FMN 18 Binnensingel Westkant
665,Uitbreidingstraat 390,2022-11-21,05:00:00,19,3,16,FMN 18 Binnensingel Westkant
665,Uitbreidingstraat 390,2022-11-21,06:00:00,66,13,53,FMN 18 Binnensingel Westkant
665,Uitbreidingstraat 390,2022-11-21,07:00:00,282,49,233,FMN 18 Binnensingel Westkant
665,Uitbreidingstraat 390,2022-11-21,08:00:00,516,86,430,FMN 18 Binnensingel Westkant
665,Uitbreidingstraat 390,2022-11-21,09:00:00,179,13,166,FMN 18 Binnensingel Westkant
665,Uitbreidingstraat 390,2022-11-21,10:00:00,123,26,97,FMN 18 Binnensingel Westkant
665,Uitbreidingstraat 390,2022-11-21,11:00:00,94,28,66,FMN 18 Binnensingel Westkant
665,Uitbreidingstraat 390,2022-11-21,12:00:00,142,51,91,FMN 18 Binnensingel Westkant
665,Uitbreidingstraat 390,2022-11-21,13:00:00,148,38,110,FMN 18 Binnensingel Westkant
665,Uitbreidingstraat 390,2022-11-21,14:00:00,108,48,60,FMN 18 Binnensingel Westkant
665,Uitbreidingstraat 390,2022-11-21,15:00:00,191,110,81,FMN 18 Binnensingel Westkant
665,Uitbreidingstraat 390,2022-11-21,16:00:00,366,219,147,FMN 18 Binnensingel Westkant
665,Uitbreidingstraat 390,2022-11-21,17:00:00,322,170,152,FMN 18 Binnensingel Westkant
665,Uitbreidingstraat 390,2022-11-21,18:00:00,196,70,126,FMN 18 Binnensingel Westkant
665,Uitbreidingstraat 390,2022-11-21,19:00:00,89,21,68,FMN 18 Binnensingel Westkant
665,Uitbreidingstraat 390,2022-11-21,20:00:00,56,19,37,FMN 18 Binnensingel Westkant
665,Uitbreidingstraat 390,2022-11-21,21:00:00,64,25,39,FMN 18 Binnensingel Westkant
665,Uitbreidingstraat 390,2022-11-21,22:00:00,41,10,31,FMN 18 Binnensingel Westkant
665,Uitbreidingstraat 390,2022-11-21,23:00:00,20,3,17,FMN 18 Binnensingel Westkant
665,Uitbreidingstraat 390,2022-11-22,00:00:00,10,1,9,FMN 18 Binnensingel Westkant
665,Uitbreidingstraat 390,2022-11-22,01:00:00,2,0,2,FMN 18 Binnensingel Westkant
665,Uitbreidingstraat 390,2022-11-22,02:00:00,0,0,0,FMN 18 Binnensingel Westkant
665,Uitbreidingstraat 390,2022-11-22,03:00:00,3,0,3,FMN 18 Binnensingel Westkant
665,Uitbreidingstraat 390,2022-11-22,04:00:00,8,0,8,FMN 18 Binnensingel Westkant
665,Uitbreidingstraat 390,2022-11-22,05:00:00,18,5,13,FMN 18 Binnensingel Westkant
665,Uitbreidingstraat 390,2022-11-22,06:00:00,60,7,53,FMN 18 Binnensingel Westkant
665,Uitbreidingstraat 390,2022-11-22,07:00:00,304,63,241,FMN 18 Binnensingel Westkant
665,Uitbreidingstraat 390,2022-11-22,08:00:00,506,76,430,FMN 18 Binnensingel Westkant
665,Uitbreidingstraat 390,2022-11-22,09:00:00,166,26,140,FMN 18 Binnensingel Westkant
665,Uitbreidingstraat 390,2022-11-22,10:00:00,110,38,72,FMN 18 Binnensingel Westkant
665,Uitbreidingstraat 390,2022-11-22,11:00:00,81,22,59,FMN 18 Binnensingel Westkant
665,Uitbreidingstraat 390,2022-11-22,12:00:00,142,55,87,FMN 18 Binnensingel Westkant
665,Uitbreidingstraat 390,2022-11-22,13:00:00,141,42,99,FMN 18 Binnensingel Westkant
665,Uitbreidingstraat 390,2022-11-22,14:00:00,101,45,56,FMN 18 Binnensingel Westkant
665,Uitbreidingstraat 390,2022-11-22,15:00:00,194,116,78,FMN 18 Binnensingel Westkant
665,Uitbreidingstraat 390,2022-11-22,16:00:00,342,203,139,FMN 18 Binnensingel Westkant
665,Uitbreidingstraat 390,2022-11-22,17:00:00,328,136,192,FMN 18 Binnensingel Westkant
665,Uitbreidingstraat 390,2022-11-22,18:00:00,228,80,148,FMN 18 Binnensingel Westkant
665,Uitbreidingstraat 390,2022-11-22,19:00:00,137,53,84,FMN 18 Binnensingel Westkant
665,Uitbreidingstraat 390,2022-11-22,20:00:00,79,25,54,FMN 18 Binnensingel Westkant
665,Uitbreidingstraat 390,2022-11-22,21:00:00,57,31,26,FMN 18 Binnensingel Westkant
665,Uitbreidingstraat 390,2022-11-22,22:00:00,61,20,41,FMN 18 Binnensingel Westkant
665,Uitbreidingstraat 390,2022-11-22,23:00:00,26,7,19,FMN 18 Binnensingel Westkant
665,Uitbreidingstraat 390,2022-11-23,00:00:00,15,4,11,FMN 18 Binnensingel Westkant
665,Uitbreidingstraat 390,2022-11-23,01:00:00,4,0,4,FMN 18 Binnensingel Westkant
665,Uitbreidingstraat 390,2022-11-23,02:00:00,2,0,2,FMN 18 Binnensingel Westkant
665,Uitbreidingstraat 390,2022-11-23,03:00:00,3,0,3,FMN 18 Binnensingel Westkant
665,Uitbreidingstraat 390,2022-11-23,04:00:00,7,2,5,FMN 18 Binnensingel Westkant
665,Uitbreidingstraat 390,2022-11-23,05:00:00,33,8,25,FMN 18 Binnensingel Westkant
665,Uitbreidingstraat 390,2022-11-23,06:00:00,64,15,49,FMN 18 Binnensingel Westkant
665,Uitbreidingstraat 390,2022-11-23,07:00:00,274,42,232,FMN 18 Binnensingel Westkant
665,Uitbreidingstraat 390,2022-11-23,08:00:00,434,63,371,FMN 18 Binnensingel Westkant
665,Uitbreidingstraat 390,2022-11-23,09:00:00,158,28,130,FMN 18 Binnensingel Westkant
665,Uitbreidingstraat 390,2022-11-23,10:00:00,150,49,101,FMN 18 Binnensingel Westkant
665,Uitbreidingstraat 390,2022-11-23,11:00:00,110,40,70,FMN 18 Binnensingel Westkant
665,Uitbreidingstraat 390,2022-11-23,12:00:00,297,170,127,FMN 18 Binnensingel Westkant
665,Uitbreidingstraat 390,2022-11-23,13:00:00,205,112,93,FMN 18 Binnensingel Westkant
665,Uitbreidingstraat 390,2022-11-23,14:00:00,82,36,46,FMN 18 Binnensingel Westkant
665,Uitbreidingstraat 390,2022-11-23,15:00:00,110,47,63,FMN 18 Binnensingel Westkant
665,Uitbreidingstraat 390,2022-11-23,16:00:00,191,89,102,FMN 18 Binnensingel Westkant
665,Uitbreidingstraat 390,2022-11-23,17:00:00,285,145,140,FMN 18 Binnensingel Westkant
665,Uitbreidingstraat 390,2022-11-23,18:00:00,192,65,127,FMN 18 Binnensingel Westkant
665,Uitbreidingstraat 390,2022-11-23,19:00:00,146,47,99,FMN 18 Binnensingel Westkant
665,Uitbreidingstraat 390,2022-11-23,20:00:00,76,29,47,FMN 18 Binnensingel Westkant
665,Uitbreidingstraat 390,2022-11-23,21:00:00,52,16,36,FMN 18 Binnensingel Westkant
665,Uitbreidingstraat 390,2022-11-23,22:00:00,82,30,52,FMN 18 Binnensingel Westkant
665,Uitbreidingstraat 390,2022-11-23,23:00:00,60,15,45,FMN 18 Binnensingel Westkant
665,Uitbreidingstraat 390,2022-11-24,00:00:00,45,12,33,FMN 18 Binnensingel Westkant
665,Uitbreidingstraat 390,2022-11-24,01:00:00,1,0,1,FMN 18 Binnensingel Westkant
665,Uitbreidingstraat 390,2022-11-24,02:00:00,5,1,4,FMN 18 Binnensingel Westkant
665,Uitbreidingstraat 390,2022-11-24,03:00:00,4,1,3,FMN 18 Binnensingel Westkant
665,Uitbreidingstraat 390,2022-11-24,04:00:00,6,1,5,FMN 18 Binnensingel Westkant
665,Uitbreidingstraat 390,2022-11-24,05:00:00,31,5,26,FMN 18 Binnensingel Westkant
665,Uitbreidingstraat 390,2022-11-24,06:00:00,72,20,52,FMN 18 Binnensingel Westkant
665,Uitbreidingstraat 390,2022-11-24,07:00:00,304,53,251,FMN 18 Binnensingel Westkant
665,Uitbreidingstraat 390,2022-11-24,08:00:00,500,98,402,FMN 18 Binnensingel Westkant
665,Uitbreidingstraat 390,2022-11-24,09:00:00,183,35,148,FMN 18 Binnensingel Westkant
665,Uitbreidingstraat 390,2022-11-24,10:00:00,141,24,117,FMN 18 Binnensingel Westkant
665,Uitbreidingstraat 390,2022-11-24,11:00:00,85,25,60,FMN 18 Binnensingel Westkant
665,Uitbreidingstraat 390,2022-11-24,12:00:00,156,54,102,FMN 18 Binnensingel Westkant
665,Uitbreidingstraat 390,2022-11-24,13:00:00,144,34,110,FMN 18 Binnensingel Westkant
665,Uitbreidingstraat 390,2022-11-24,14:00:00,94,32,62,FMN 18 Binnensingel Westkant
665,Uitbreidingstraat 390,2022-11-24,15:00:00,207,115,92,FMN 18 Binnensingel Westkant
665,Uitbreidingstraat 390,2022-11-24,16:00:00,363,211,152,FMN 18 Binnensingel Westkant
665,Uitbreidingstraat 390,2022-11-24,17:00:00,293,132,161,FMN 18 Binnensingel Westkant
665,Uitbreidingstraat 390,2022-11-24,18:00:00,221,84,137,FMN 18 Binnensingel Westkant
665,Uitbreidingstraat 390,2022-11-24,19:00:00,140,51,89,FMN 18 Binnensingel Westkant
665,Uitbreidingstraat 390,2022-11-24,20:00:00,88,40,48,FMN 18 Binnensingel Westkant
665,Uitbreidingstraat 390,2022-11-24,21:00:00,85,27,58,FMN 18 Binnensingel Westkant
665,Uitbreidingstraat 390,2022-11-24,22:00:00,86,19,67,FMN 18 Binnensingel Westkant
665,Uitbreidingstraat 390,2022-11-24,23:00:00,78,7,71,FMN 18 Binnensingel Westkant
665,Uitbreidingstraat 390,2022-11-25,00:00:00,28,4,24,FMN 18 Binnensingel Westkant
665,Uitbreidingstraat 390,2022-11-25,01:00:00,18,2,16,FMN 18 Binnensingel Westkant
665,Uitbreidingstraat 390,2022-11-25,02:00:00,18,3,15,FMN 18 Binnensingel Westkant
665,Uitbreidingstraat 390,2022-11-25,03:00:00,10,1,9,FMN 18 Binnensingel Westkant
665,Uitbreidingstraat 390,2022-11-25,04:00:00,29,3,26,FMN 18 Binnensingel Westkant
665,Uitbreidingstraat 390,2022-11-25,05:00:00,52,5,47,FMN 18 Binnensingel Westkant
665,Uitbreidingstraat 390,2022-11-25,06:00:00,57,11,46,FMN 18 Binnensingel Westkant
665,Uitbreidingstraat 390,2022-11-25,07:00:00,250,42,208,FMN 18 Binnensingel Westkant
665,Uitbreidingstraat 390,2022-11-25,08:00:00,453,66,387,FMN 18 Binnensingel Westkant
665,Uitbreidingstraat 390,2022-11-25,09:00:00,162,29,133,FMN 18 Binnensingel Westkant
665,Uitbreidingstraat 390,2022-11-25,10:00:00,128,29,99,FMN 18 Binnensingel Westkant
665,Uitbreidingstraat 390,2022-11-25,11:00:00,99,29,70,FMN 18 Binnensingel Westkant
665,Uitbreidingstraat 390,2022-11-25,12:00:00,154,72,82,FMN 18 Binnensingel Westkant
665,Uitbreidingstraat 390,2022-11-25,13:00:00,155,45,110,FMN 18 Binnensingel Westkant
665,Uitbreidingstraat 390,2022-11-25,14:00:00,121,34,87,FMN 18 Binnensingel Westkant
665,Uitbreidingstraat 390,2022-11-25,15:00:00,165,92,73,FMN 18 Binnensingel Westkant
665,Uitbreidingstraat 390,2022-11-25,16:00:00,301,184,117,FMN 18 Binnensingel Westkant
665,Uitbreidingstraat 390,2022-11-25,17:00:00,249,117,132,FMN 18 Binnensingel Westkant
665,Uitbreidingstraat 390,2022-11-25,18:00:00,198,73,125,FMN 18 Binnensingel Westkant
665,Uitbreidingstraat 390,2022-11-25,19:00:00,154,38,116,FMN 18 Binnensingel Westkant
665,Uitbreidingstraat 390,2022-11-25,20:00:00,94,37,57,FMN 18 Binnensingel Westkant
665,Uitbreidingstraat 390,2022-11-25,21:00:00,67,32,35,FMN 18 Binnensingel Westkant
665,Uitbreidingstraat 390,2022-11-25,22:00:00,57,23,34,FMN 18 Binnensingel Westkant
665,Uitbreidingstraat 390,2022-11-25,23:00:00,66,18,48,FMN 18 Binnensingel Westkant
665,Uitbreidingstraat 390,2022-11-26,00:00:00,79,21,58,FMN 18 Binnensingel Westkant
665,Uitbreidingstraat 390,2022-11-26,01:00:00,29,9,20,FMN 18 Binnensingel Westkant
665,Uitbreidingstraat 390,2022-11-26,02:00:00,31,4,27,FMN 18 Binnensingel Westkant
665,Uitbreidingstraat 390,2022-11-26,03:00:00,22,1,21,FMN 18 Binnensingel Westkant
665,Uitbreidingstraat 390,2022-11-26,04:00:00,26,5,21,FMN 18 Binnensingel Westkant
665,Uitbreidingstraat 390,2022-11-26,05:00:00,16,2,14,FMN 18 Binnensingel Westkant
665,Uitbreidingstraat 390,2022-11-26,06:00:00,29,7,22,FMN 18 Binnensingel Westkant
665,Uitbreidingstraat 390,2022-11-26,07:00:00,30,8,22,FMN 18 Binnensingel Westkant
665,Uitbreidingstraat 390,2022-11-26,08:00:00,40,10,30,FMN 18 Binnensingel Westkant
665,Uitbreidingstraat 390,2022-11-26,09:00:00,70,21,49,FMN 18 Binnensingel Westkant
665,Uitbreidingstraat 390,2022-11-26,10:00:00,86,27,59,FMN 18 Binnensingel Westkant
665,Uitbreidingstraat 390,2022-11-26,11:00:00,61,22,39,FMN 18 Binnensingel Westkant
665,Uitbreidingstraat 390,2022-11-26,12:00:00,83,29,54,FMN 18 Binnensingel Westkant
665,Uitbreidingstraat 390,2022-11-26,13:00:00,95,37,58,FMN 18 Binnensingel Westkant
665,Uitbreidingstraat 390,2022-11-26,14:00:00,110,27,83,FMN 18 Binnensingel Westkant
665,Uitbreidingstraat 390,2022-11-26,15:00:00,90,26,64,FMN 18 Binnensingel Westkant
665,Uitbreidingstraat 390,2022-11-26,16:00:00,82,19,63,FMN 18 Binnensingel Westkant
665,Uitbreidingstraat 390,2022-11-26,17:00:00,104,31,73,FMN 18 Binnensingel Westkant
665,Uitbreidingstraat 390,2022-11-26,18:00:00,100,31,69,FMN 18 Binnensingel Westkant
665,Uitbreidingstraat 390,2022-11-26,19:00:00,117,35,82,FMN 18 Binnensingel Westkant
665,Uitbreidingstraat 390,2022-11-26,20:00:00,50,16,34,FMN 18 Binnensingel Westkant
665,Uitbreidingstraat 390,2022-11-26,21:00:00,54,18,36,FMN 18 Binnensingel Westkant
665,Uitbreidingstraat 390,2022-11-26,22:00:00,59,4,55,FMN 18 Binnensingel Westkant
665,Uitbreidingstraat 390,2022-11-26,23:00:00,44,16,28,FMN 18 Binnensingel Westkant
665,Uitbreidingstraat 390,2022-11-27,00:00:00,32,6,26,FMN 18 Binnensingel Westkant
665,Uitbreidingstraat 390,2022-11-27,01:00:00,23,6,17,FMN 18 Binnensingel Westkant
665,Uitbreidingstraat 390,2022-11-27,02:00:00,25,9,16,FMN 18 Binnensingel Westkant
665,Uitbreidingstraat 390,2022-11-27,03:00:00,14,3,11,FMN 18 Binnensingel Westkant
665,Uitbreidingstraat 390,2022-11-27,04:00:00,21,2,19,FMN 18 Binnensingel Westkant
665,Uitbreidingstraat 390,2022-11-27,05:00:00,15,5,10,FMN 18 Binnensingel Westkant
665,Uitbreidingstraat 390,2022-11-27,06:00:00,14,2,12,FMN 18 Binnensingel Westkant
665,Uitbreidingstraat 390,2022-11-27,07:00:00,5,2,3,FMN 18 Binnensingel Westkant
665,Uitbreidingstraat 390,2022-11-27,08:00:00,21,10,11,FMN 18 Binnensingel Westkant
665,Uitbreidingstraat 390,2022-11-27,09:00:00,52,17,35,FMN 18 Binnensingel Westkant
665,Uitbreidingstraat 390,2022-11-27,10:00:00,56,15,41,FMN 18 Binnensingel Westkant
665,Uitbreidingstraat 390,2022-11-27,11:00:00,51,22,29,FMN 18 Binnensingel Westkant
665,Uitbreidingstraat 390,2022-11-27,12:00:00,96,40,56,FMN 18 Binnensingel Westkant
665,Uitbreidingstraat 390,2022-11-27,13:00:00,78,25,53,FMN 18 Binnensingel Westkant
665,Uitbreidingstraat 390,2022-11-27,14:00:00,60,17,43,FMN 18 Binnensingel Westkant
665,Uitbreidingstraat 390,2022-11-27,15:00:00,43,11,32,FMN 18 Binnensingel Westkant
665,Uitbreidingstraat 390,2022-11-27,16:00:00,66,23,43,FMN 18 Binnensingel Westkant
665,Uitbreidingstraat 390,2022-11-27,17:00:00,69,17,52,FMN 18 Binnensingel Westkant
665,Uitbreidingstraat 390,2022-11-27,18:00:00,67,20,47,FMN 18 Binnensingel Westkant
665,Uitbreidingstraat 390,2022-11-27,19:00:00,52,15,37,FMN 18 Binnensingel Westkant
665,Uitbreidingstraat 390,2022-11-27,20:00:00,37,8,29,FMN 18 Binnensingel Westkant
665,Uitbreidingstraat 390,2022-11-27,21:00:00,30,7,23,FMN 18 Binnensingel Westkant
665,Uitbreidingstraat 390,2022-11-27,22:00:00,30,7,23,FMN 18 Binnensingel Westkant
665,Uitbreidingstraat 390,2022-11-27,23:00:00,39,11,28,FMN 18 Binnensingel Westkant
665,Uitbreidingstraat 390,2022-11-28,00:00:00,7,0,7,FMN 18 Binnensingel Westkant
665,Uitbreidingstraat 390,2022-11-28,01:00:00,4,2,2,FMN 18 Binnensingel Westkant
665,Uitbreidingstraat 390,2022-11-28,02:00:00,2,0,2,FMN 18 Binnensingel Westkant
665,Uitbreidingstraat 390,2022-11-28,03:00:00,2,0,2,FMN 18 Binnensingel Westkant
665,Uitbreidingstraat 390,2022-11-28,04:00:00,10,4,6,FMN 18 Binnensingel Westkant
665,Uitbreidingstraat 390,2022-11-28,05:00:00,31,3,28,FMN 18 Binnensingel Westkant
665,Uitbreidingstraat 390,2022-11-28,06:00:00,51,13,38,FMN 18 Binnensingel Westkant
665,Uitbreidingstraat 390,2022-11-28,07:00:00,247,47,200,FMN 18 Binnensingel Westkant
665,Uitbreidingstraat 390,2022-11-28,08:00:00,472,70,402,FMN 18 Binnensingel Westkant
665,Uitbreidingstraat 390,2022-11-28,09:00:00,168,24,144,FMN 18 Binnensingel Westkant
665,Uitbreidingstraat 390,2022-11-28,10:00:00,118,22,96,FMN 18 Binnensingel Westkant
665,Uitbreidingstraat 390,2022-11-28,11:00:00,76,23,53,FMN 18 Binnensingel Westkant
665,Uitbreidingstraat 390,2022-11-28,12:00:00,148,53,95,FMN 18 Binnensingel Westkant
665,Uitbreidingstraat 390,2022-11-28,13:00:00,135,35,100,FMN 18 Binnensingel Westkant
665,Uitbreidingstraat 390,2022-11-28,14:00:00,90,35,55,FMN 18 Binnensingel Westkant
665,Uitbreidingstraat 390,2022-11-28,15:00:00,201,91,110,FMN 18 Binnensingel Westkant
665,Uitbreidingstraat 390,2022-11-28,16:00:00,312,188,124,FMN 18 Binnensingel Westkant
665,Uitbreidingstraat 390,2022-11-28,17:00:00,312,162,150,FMN 18 Binnensingel Westkant
665,Uitbreidingstraat 390,2022-11-28,18:00:00,218,70,148,FMN 18 Binnensingel Westkant
665,Uitbreidingstraat 390,2022-11-28,19:00:00,106,41,65,FMN 18 Binnensingel Westkant
665,Uitbreidingstraat 390,2022-11-28,20:00:00,67,26,41,FMN 18 Binnensingel Westkant
665,Uitbreidingstraat 390,2022-11-28,21:00:00,60,26,34,FMN 18 Binnensingel Westkant
665,Uitbreidingstraat 390,2022-11-28,22:00:00,43,14,29,FMN 18 Binnensingel Westkant
665,Uitbreidingstraat 390,2022-11-28,23:00:00,32,5,27,FMN 18 Binnensingel Westkant
665,Uitbreidingstraat 390,2022-11-29,00:00:00,14,4,10,FMN 18 Binnensingel Westkant
665,Uitbreidingstraat 390,2022-11-29,01:00:00,2,0,2,FMN 18 Binnensingel Westkant
665,Uitbreidingstraat 390,2022-11-29,02:00:00,2,1,1,FMN 18 Binnensingel Westkant
665,Uitbreidingstraat 390,2022-11-29,03:00:00,4,0,4,FMN 18 Binnensingel Westkant
665,Uitbreidingstraat 390,2022-11-29,04:00:00,8,3,5,FMN 18 Binnensingel Westkant
665,Uitbreidingstraat 390,2022-11-29,05:00:00,33,3,30,FMN 18 Binnensingel Westkant
665,Uitbreidingstraat 390,2022-11-29,06:00:00,53,15,38,FMN 18 Binnensingel Westkant
665,Uitbreidingstraat 390,2022-11-29,07:00:00,239,34,205,FMN 18 Binnensingel Westkant
665,Uitbreidingstraat 390,2022-11-29,08:00:00,395,77,318,FMN 18 Binnensingel Westkant
665,Uitbreidingstraat 390,2022-11-29,09:00:00,176,26,150,FMN 18 Binnensingel Westkant
665,Uitbreidingstraat 390,2022-11-29,10:00:00,127,29,98,FMN 18 Binnensingel Westkant
665,Uitbreidingstraat 390,2022-11-29,11:00:00,62,23,39,FMN 18 Binnensingel Westkant
665,Uitbreidingstraat 390,2022-11-29,12:00:00,155,62,93,FMN 18 Binnensingel Westkant
665,Uitbreidingstraat 390,2022-11-29,13:00:00,128,30,98,FMN 18 Binnensingel Westkant
665,Uitbreidingstraat 390,2022-11-29,14:00:00,96,38,58,FMN 18 Binnensingel Westkant
665,Uitbreidingstraat 390,2022-11-29,15:00:00,155,81,74,FMN 18 Binnensingel Westkant
665,Uitbreidingstraat 390,2022-11-29,16:00:00,331,205,126,FMN 18 Binnensingel Westkant
665,Uitbreidingstraat 390,2022-11-29,17:00:00,261,120,141,FMN 18 Binnensingel Westkant
665,Uitbreidingstraat 390,2022-11-29,18:00:00,216,87,129,FMN 18 Binnensingel Westkant
665,Uitbreidingstraat 390,2022-11-29,19:00:00,136,40,96,FMN 18 Binnensingel Westkant
665,Uitbreidingstraat 390,2022-11-29,20:00:00,60,24,36,FMN 18 Binnensingel Westkant
665,Uitbreidingstraat 390,2022-11-29,21:00:00,59,23,36,FMN 18 Binnensingel Westkant
665,Uitbreidingstraat 390,2022-11-29,22:00:00,74,25,49,FMN 18 Binnensingel Westkant
665,Uitbreidingstraat 390,2022-11-29,23:00:00,25,5,20,FMN 18 Binnensingel Westkant
665,Uitbreidingstraat 390,2022-11-30,00:00:00,17,12,5,FMN 18 Binnensingel Westkant
665,Uitbreidingstraat 390,2022-11-30,01:00:00,3,1,2,FMN 18 Binnensingel Westkant
665,Uitbreidingstraat 390,2022-11-30,02:00:00,4,0,4,FMN 18 Binnensingel Westkant
665,Uitbreidingstraat 390,2022-11-30,03:00:00,4,1,3,FMN 18 Binnensingel Westkant
665,Uitbreidingstraat 390,2022-11-30,04:00:00,10,1,9,FMN 18 Binnensingel Westkant
665,Uitbreidingstraat 390,2022-11-30,05:00:00,26,4,22,FMN 18 Binnensingel Westkant
665,Uitbreidingstraat 390,2022-11-30,06:00:00,66,12,54,FMN 18 Binnensingel Westkant
665,Uitbreidingstraat 390,2022-11-30,07:00:00,198,26,172,FMN 18 Binnensingel Westkant
665,Uitbreidingstraat 390,2022-11-30,08:00:00,417,68,349,FMN 18 Binnensingel Westkant
665,Uitbreidingstraat 390,2022-11-30,09:00:00,159,30,129,FMN 18 Binnensingel Westkant
665,Uitbreidingstraat 390,2022-11-30,10:00:00,102,33,69,FMN 18 Binnensingel Westkant
665,Uitbreidingstraat 390,2022-11-30,11:00:00,93,43,50,FMN 18 Binnensingel Westkant
665,Uitbreidingstraat 390,2022-11-30,12:00:00,253,140,113,FMN 18 Binnensingel Westkant
665,Uitbreidingstraat 390,2022-11-30,13:00:00,206,106,100,FMN 18 Binnensingel Westkant
665,Uitbreidingstraat 390,2022-11-30,14:00:00,115,33,82,FMN 18 Binnensingel Westkant
665,Uitbreidingstraat 390,2022-11-30,15:00:00,136,42,94,FMN 18 Binnensingel Westkant
665,Uitbreidingstraat 390,2022-11-30,16:00:00,190,86,104,FMN 18 Binnensingel Westkant
665,Uitbreidingstraat 390,2022-11-30,17:00:00,260,122,138,FMN 18 Binnensingel Westkant
665,Uitbreidingstraat 390,2022-11-30,18:00:00,215,82,133,FMN 18 Binnensingel Westkant
665,Uitbreidingstraat 390,2022-11-30,19:00:00,102,25,77,FMN 18 Binnensingel Westkant
665,Uitbreidingstraat 390,2022-11-30,20:00:00,62,20,42,FMN 18 Binnensingel Westkant
665,Uitbreidingstraat 390,2022-11-30,21:00:00,66,26,40,FMN 18 Binnensingel Westkant
665,Uitbreidingstraat 390,2022-11-30,22:00:00,55,22,33,FMN 18 Binnensingel Westkant
665,Uitbreidingstraat 390,2022-11-30,23:00:00,32,8,24,FMN 18 Binnensingel Westkant
665,Uitbreidingstraat 390,2022-12-01,00:00:00,13,7,6,FMN 18 Binnensingel Westkant
665,Uitbreidingstraat 390,2022-12-01,01:00:00,8,2,6,FMN 18 Binnensingel Westkant
665,Uitbreidingstraat 390,2022-12-01,02:00:00,4,1,3,FMN 18 Binnensingel Westkant
665,Uitbreidingstraat 390,2022-12-01,03:00:00,8,2,6,FMN 18 Binnensingel Westkant
665,Uitbreidingstraat 390,2022-12-01,04:00:00,10,1,9,FMN 18 Binnensingel Westkant
665,Uitbreidingstraat 390,2022-12-01,05:00:00,31,4,27,FMN 18 Binnensingel Westkant
665,Uitbreidingstraat 390,2022-12-01,06:00:00,56,11,45,FMN 18 Binnensingel Westkant
665,Uitbreidingstraat 390,2022-12-01,07:00:00,237,37,200,FMN 18 Binnensingel Westkant
665,Uitbreidingstraat 390,2022-12-01,08:00:00,471,80,391,FMN 18 Binnensingel Westkant
665,Uitbreidingstraat 390,2022-12-01,09:00:00,171,33,138,FMN 18 Binnensingel Westkant
665,Uitbreidingstraat 390,2022-12-01,10:00:00,92,17,75,FMN 18 Binnensingel Westkant
665,Uitbreidingstraat 390,2022-12-01,11:00:00,78,18,60,FMN 18 Binnensingel Westkant
665,Uitbreidingstraat 390,2022-12-01,12:00:00,158,70,88,FMN 18 Binnensingel Westkant
665,Uitbreidingstraat 390,2022-12-01,13:00:00,117,35,82,FMN 18 Binnensingel Westkant
665,Uitbreidingstraat 390,2022-12-01,14:00:00,106,40,66,FMN 18 Binnensingel Westkant
665,Uitbreidingstraat 390,2022-12-01,15:00:00,215,124,91,FMN 18 Binnensingel Westkant
665,Uitbreidingstraat 390,2022-12-01,16:00:00,283,162,121,FMN 18 Binnensingel Westkant
665,Uitbreidingstraat 390,2022-12-01,17:00:00,235,126,109,FMN 18 Binnensingel Westkant
665,Uitbreidingstraat 390,2022-12-01,18:00:00,246,121,125,FMN 18 Binnensingel Westkant
665,Uitbreidingstraat 390,2022-12-01,19:00:00,154,41,113,FMN 18 Binnensingel Westkant
665,Uitbreidingstraat 390,2022-12-01,20:00:00,72,28,44,FMN 18 Binnensingel Westkant
665,Uitbreidingstraat 390,2022-12-01,21:00:00,64,15,49,FMN 18 Binnensingel Westkant
665,Uitbreidingstraat 390,2022-12-01,22:00:00,75,28,47,FMN 18 Binnensingel Westkant
665,Uitbreidingstraat 390,2022-12-01,23:00:00,40,8,32,FMN 18 Binnensingel Westkant
665,Uitbreidingstraat 390,2022-12-02,00:00:00,28,7,21,FMN 18 Binnensingel Westkant
665,Uitbreidingstraat 390,2022-12-02,01:00:00,10,3,7,FMN 18 Binnensingel Westkant
665,Uitbreidingstraat 390,2022-12-02,02:00:00,8,6,2,FMN 18 Binnensingel Westkant
665,Uitbreidingstraat 390,2022-12-02,03:00:00,5,0,5,FMN 18 Binnensingel Westkant
665,Uitbreidingstraat 390,2022-12-02,04:00:00,9,0,9,FMN 18 Binnensingel Westkant
665,Uitbreidingstraat 390,2022-12-02,05:00:00,35,5,30,FMN 18 Binnensingel Westkant
665,Uitbreidingstraat 390,2022-12-02,06:00:00,64,12,52,FMN 18 Binnensingel Westkant
665,Uitbreidingstraat 390,2022-12-02,07:00:00,210,37,173,FMN 18 Binnensingel Westkant
665,Uitbreidingstraat 390,2022-12-02,08:00:00,386,67,319,FMN 18 Binnensingel Westkant
665,Uitbreidingstraat 390,2022-12-02,09:00:00,132,19,113,FMN 18 Binnensingel Westkant
665,Uitbreidingstraat 390,2022-12-02,10:00:00,123,31,92,FMN 18 Binnensingel Westkant
665,Uitbreidingstraat 390,2022-12-02,11:00:00,76,26,50,FMN 18 Binnensingel Westkant
665,Uitbreidingstraat 390,2022-12-02,12:00:00,140,59,81,FMN 18 Binnensingel Westkant
665,Uitbreidingstraat 390,2022-12-02,13:00:00,126,48,78,FMN 18 Binnensingel Westkant
665,Uitbreidingstraat 390,2022-12-02,14:00:00,123,44,79,FMN 18 Binnensingel Westkant
665,Uitbreidingstraat 390,2022-12-02,15:00:00,169,105,64,FMN 18 Binnensingel Westkant
665,Uitbreidingstraat 390,2022-12-02,16:00:00,330,218,112,FMN 18 Binnensingel Westkant
665,Uitbreidingstraat 390,2022-12-02,17:00:00,238,126,112,FMN 18 Binnensingel Westkant
665,Uitbreidingstraat 390,2022-12-02,18:00:00,152,57,95,FMN 18 Binnensingel Westkant
665,Uitbreidingstraat 390,2022-12-02,19:00:00,90,28,62,FMN 18 Binnensingel Westkant
665,Uitbreidingstraat 390,2022-12-02,20:00:00,67,25,42,FMN 18 Binnensingel Westkant
665,Uitbreidingstraat 390,2022-12-02,21:00:00,60,26,34,FMN 18 Binnensingel Westkant
665,Uitbreidingstraat 390,2022-12-02,22:00:00,59,19,40,FMN 18 Binnensingel Westkant
665,Uitbreidingstraat 390,2022-12-02,23:00:00,62,14,48,FMN 18 Binnensingel Westkant
665,Uitbreidingstraat 390,2022-12-03,00:00:00,45,10,35,FMN 18 Binnensingel Westkant
665,Uitbreidingstraat 390,2022-12-03,01:00:00,34,9,25,FMN 18 Binnensingel Westkant
665,Uitbreidingstraat 390,2022-12-03,02:00:00,15,4,11,FMN 18 Binnensingel Westkant
665,Uitbreidingstraat 390,2022-12-03,03:00:00,15,4,11,FMN 18 Binnensingel Westkant
665,Uitbreidingstraat 390,2022-12-03,04:00:00,9,0,9,FMN 18 Binnensingel Westkant
665,Uitbreidingstraat 390,2022-12-03,05:00:00,21,5,16,FMN 18 Binnensingel Westkant
665,Uitbreidingstraat 390,2022-12-03,06:00:00,27,6,21,FMN 18 Binnensingel Westkant
665,Uitbreidingstraat 390,2022-12-03,07:00:00,12,4,8,FMN 18 Binnensingel Westkant
665,Uitbreidingstraat 390,2022-12-03,08:00:00,31,10,21,FMN 18 Binnensingel Westkant
665,Uitbreidingstraat 390,2022-12-03,09:00:00,61,18,43,FMN 18 Binnensingel Westkant
665,Uitbreidingstraat 390,2022-12-03,10:00:00,54,17,37,FMN 18 Binnensingel Westkant
665,Uitbreidingstraat 390,2022-12-03,11:00:00,78,24,54,FMN 18 Binnensingel Westkant
665,Uitbreidingstraat 390,2022-12-03,12:00:00,62,22,40,FMN 18 Binnensingel Westkant
665,Uitbreidingstraat 390,2022-12-03,13:00:00,84,32,52,FMN 18 Binnensingel Westkant
665,Uitbreidingstraat 390,2022-12-03,14:00:00,71,22,49,FMN 18 Binnensingel Westkant
665,Uitbreidingstraat 390,2022-12-03,15:00:00,50,16,34,FMN 18 Binnensingel Westkant
665,Uitbreidingstraat 390,2022-12-03,16:00:00,67,28,39,FMN 18 Binnensingel Westkant
665,Uitbreidingstraat 390,2022-12-03,17:00:00,66,20,46,FMN 18 Binnensingel Westkant
665,Uitbreidingstraat 390,2022-12-03,18:00:00,68,24,44,FMN 18 Binnensingel Westkant
665,Uitbreidingstraat 390,2022-12-03,19:00:00,56,15,41,FMN 18 Binnensingel Westkant
665,Uitbreidingstraat 390,2022-12-03,20:00:00,45,8,37,FMN 18 Binnensingel Westkant
665,Uitbreidingstraat 390,2022-12-03,21:00:00,39,14,25,FMN 18 Binnensingel Westkant
665,Uitbreidingstraat 390,2022-12-03,22:00:00,26,8,18,FMN 18 Binnensingel Westkant
665,Uitbreidingstraat 390,2022-12-03,23:00:00,36,8,28,FMN 18 Binnensingel Westkant
665,Uitbreidingstraat 390,2022-12-04,00:00:00,36,12,24,FMN 18 Binnensingel Westkant
665,Uitbreidingstraat 390,2022-12-04,01:00:00,39,10,29,FMN 18 Binnensingel Westkant
665,Uitbreidingstraat 390,2022-12-04,02:00:00,16,3,13,FMN 18 Binnensingel Westkant
665,Uitbreidingstraat 390,2022-12-04,03:00:00,7,2,5,FMN 18 Binnensingel Westkant
665,Uitbreidingstraat 390,2022-12-04,04:00:00,7,1,6,FMN 18 Binnensingel Westkant
665,Uitbreidingstraat 390,2022-12-04,05:00:00,13,2,11,FMN 18 Binnensingel Westkant
665,Uitbreidingstraat 390,2022-12-04,06:00:00,25,5,20,FMN 18 Binnensingel Westkant
665,Uitbreidingstraat 390,2022-12-04,07:00:00,9,4,5,FMN 18 Binnensingel Westkant
665,Uitbreidingstraat 390,2022-12-04,08:00:00,14,2,12,FMN 18 Binnensingel Westkant
665,Uitbreidingstraat 390,2022-12-04,09:00:00,26,9,17,FMN 18 Binnensingel Westkant
665,Uitbreidingstraat 390,2022-12-04,10:00:00,47,12,35,FMN 18 Binnensingel Westkant
665,Uitbreidingstraat 390,2022-12-04,11:00:00,57,24,33,FMN 18 Binnensingel Westkant
665,Uitbreidingstraat 390,2022-12-04,12:00:00,61,17,44,FMN 18 Binnensingel Westkant
665,Uitbreidingstraat 390,2022-12-04,13:00:00,49,21,28,FMN 18 Binnensingel Westkant
665,Uitbreidingstraat 390,2022-12-04,14:00:00,40,9,31,FMN 18 Binnensingel Westkant
665,Uitbreidingstraat 390,2022-12-04,15:00:00,43,14,29,FMN 18 Binnensingel Westkant
665,Uitbreidingstraat 390,2022-12-04,16:00:00,51,16,35,FMN 18 Binnensingel Westkant
665,Uitbreidingstraat 390,2022-12-04,17:00:00,71,26,45,FMN 18 Binnensingel Westkant
665,Uitbreidingstraat 390,2022-12-04,18:00:00,53,17,36,FMN 18 Binnensingel Westkant
665,Uitbreidingstraat 390,2022-12-04,19:00:00,42,8,34,FMN 18 Binnensingel Westkant
665,Uitbreidingstraat 390,2022-12-04,20:00:00,46,18,28,FMN 18 Binnensingel Westkant
665,Uitbreidingstraat 390,2022-12-04,21:00:00,33,7,26,FMN 18 Binnensingel Westkant
665,Uitbreidingstraat 390,2022-12-04,22:00:00,24,10,14,FMN 18 Binnensingel Westkant
665,Uitbreidingstraat 390,2022-12-04,23:00:00,19,3,16,FMN 18 Binnensingel Westkant
665,Uitbreidingstraat 390,2022-12-05,00:00:00,6,2,4,FMN 18 Binnensingel Westkant
665,Uitbreidingstraat 390,2022-12-05,01:00:00,1,0,1,FMN 18 Binnensingel Westkant
665,Uitbreidingstraat 390,2022-12-05,02:00:00,0,0,0,FMN 18 Binnensingel Westkant
665,Uitbreidingstraat 390,2022-12-05,03:00:00,2,0,2,FMN 18 Binnensingel Westkant
665,Uitbreidingstraat 390,2022-12-05,04:00:00,8,0,8,FMN 18 Binnensingel Westkant
665,Uitbreidingstraat 390,2022-12-05,05:00:00,18,2,16,FMN 18 Binnensingel Westkant
665,Uitbreidingstraat 390,2022-12-05,06:00:00,63,10,53,FMN 18 Binnensingel Westkant
665,Uitbreidingstraat 390,2022-12-05,07:00:00,259,40,219,FMN 18 Binnensingel Westkant
665,Uitbreidingstraat 390,2022-12-05,08:00:00,417,79,338,FMN 18 Binnensingel Westkant
665,Uitbreidingstraat 390,2022-12-05,09:00:00,159,21,138,FMN 18 Binnensingel Westkant
665,Uitbreidingstraat 390,2022-12-05,10:00:00,94,20,74,FMN 18 Binnensingel Westkant
665,Uitbreidingstraat 390,2022-12-05,11:00:00,62,23,39,FMN 18 Binnensingel Westkant
665,Uitbreidingstraat 390,2022-12-05,12:00:00,189,108,81,FMN 18 Binnensingel Westkant
665,Uitbreidingstraat 390,2022-12-05,13:00:00,120,43,77,FMN 18 Binnensingel Westkant
665,Uitbreidingstraat 390,2022-12-05,14:00:00,108,40,68,FMN 18 Binnensingel Westkant
665,Uitbreidingstraat 390,2022-12-05,15:00:00,163,88,75,FMN 18 Binnensingel Westkant
665,Uitbreidingstraat 390,2022-12-05,16:00:00,242,147,95,FMN 18 Binnensingel Westkant
665,Uitbreidingstraat 390,2022-12-05,17:00:00,208,85,123,FMN 18 Binnensingel Westkant
665,Uitbreidingstraat 390,2022-12-05,18:00:00,174,91,83,FMN 18 Binnensingel Westkant
665,Uitbreidingstraat 390,2022-12-05,19:00:00,112,31,81,FMN 18 Binnensingel Westkant
665,Uitbreidingstraat 390,2022-12-05,20:00:00,46,15,31,FMN 18 Binnensingel Westkant
665,Uitbreidingstraat 390,2022-12-05,21:00:00,58,27,31,FMN 18 Binnensingel Westkant
665,Uitbreidingstraat 390,2022-12-05,22:00:00,47,18,29,FMN 18 Binnensingel Westkant
665,Uitbreidingstraat 390,2022-12-05,23:00:00,24,8,16,FMN 18 Binnensingel Westkant
665,Uitbreidingstraat 390,2022-12-06,00:00:00,7,3,4,FMN 18 Binnensingel Westkant
665,Uitbreidingstraat 390,2022-12-06,01:00:00,2,1,1,FMN 18 Binnensingel Westkant
665,Uitbreidingstraat 390,2022-12-06,02:00:00,1,0,1,FMN 18 Binnensingel Westkant
665,Uitbreidingstraat 390,2022-12-06,03:00:00,0,0,0,FMN 18 Binnensingel Westkant
665,Uitbreidingstraat 390,2022-12-06,04:00:00,6,1,5,FMN 18 Binnensingel Westkant
665,Uitbreidingstraat 390,2022-12-06,05:00:00,25,6,19,FMN 18 Binnensingel Westkant
665,Uitbreidingstraat 390,2022-12-06,06:00:00,53,14,39,FMN 18 Binnensingel Westkant
665,Uitbreidingstraat 390,2022-12-06,07:00:00,236,44,192,FMN 18 Binnensingel Westkant
665,Uitbreidingstraat 390,2022-12-06,08:00:00,481,89,392,FMN 18 Binnensingel Westkant
665,Uitbreidingstraat 390,2022-12-06,09:00:00,180,27,153,FMN 18 Binnensingel Westkant
665,Uitbreidingstraat 390,2022-12-06,10:00:00,112,37,75,FMN 18 Binnensingel Westkant
665,Uitbreidingstraat 390,2022-12-06,11:00:00,154,74,80,FMN 18 Binnensingel Westkant
665,Uitbreidingstraat 390,2022-12-06,12:00:00,147,53,94,FMN 18 Binnensingel Westkant
665,Uitbreidingstraat 390,2022-12-06,13:00:00,164,43,121,FMN 18 Binnensingel Westkant
665,Uitbreidingstraat 390,2022-12-06,14:00:00,112,38,74,FMN 18 Binnensingel Westkant
665,Uitbreidingstraat 390,2022-12-06,15:00:00,200,88,112,FMN 18 Binnensingel Westkant
665,Uitbreidingstraat 390,2022-12-06,16:00:00,283,150,133,FMN 18 Binnensingel Westkant
665,Uitbreidingstraat 390,2022-12-06,17:00:00,279,106,173,FMN 18 Binnensingel Westkant
665,Uitbreidingstraat 390,2022-12-06,18:00:00,227,94,133,FMN 18 Binnensingel Westkant
665,Uitbreidingstraat 390,2022-12-06,19:00:00,107,43,64,FMN 18 Binnensingel Westkant
665,Uitbreidingstraat 390,2022-12-06,20:00:00,54,17,37,FMN 18 Binnensingel Westkant
665,Uitbreidingstraat 390,2022-12-06,21:00:00,52,27,25,FMN 18 Binnensingel Westkant
665,Uitbreidingstraat 390,2022-12-06,22:00:00,71,31,40,FMN 18 Binnensingel Westkant
665,Uitbreidingstraat 390,2022-12-06,23:00:00,31,8,23,FMN 18 Binnensingel Westkant
665,Uitbreidingstraat 390,2022-12-07,00:00:00,6,2,4,FMN 18 Binnensingel Westkant
665,Uitbreidingstraat 390,2022-12-07,01:00:00,8,2,6,FMN 18 Binnensingel Westkant
665,Uitbreidingstraat 390,2022-12-07,02:00:00,1,0,1,FMN 18 Binnensingel Westkant
665,Uitbreidingstraat 390,2022-12-07,03:00:00,3,1,2,FMN 18 Binnensingel Westkant
665,Uitbreidingstraat 390,2022-12-07,04:00:00,8,2,6,FMN 18 Binnensingel Westkant
665,Uitbreidingstraat 390,2022-12-07,05:00:00,20,3,17,FMN 18 Binnensingel Westkant
665,Uitbreidingstraat 390,2022-12-07,06:00:00,69,7,62,FMN 18 Binnensingel Westkant
665,Uitbreidingstraat 390,2022-12-07,07:00:00,241,41,200,FMN 18 Binnensingel Westkant
665,Uitbreidingstraat 390,2022-12-07,08:00:00,484,76,408,FMN 18 Binnensingel Westkant
665,Uitbreidingstraat 390,2022-12-07,09:00:00,164,37,127,FMN 18 Binnensingel Westkant
665,Uitbreidingstraat 390,2022-12-07,10:00:00,189,81,108,FMN 18 Binnensingel Westkant
665,Uitbreidingstraat 390,2022-12-07,11:00:00,99,41,58,FMN 18 Binnensingel Westkant
665,Uitbreidingstraat 390,2022-12-07,12:00:00,228,119,109,FMN 18 Binnensingel Westkant
665,Uitbreidingstraat 390,2022-12-07,13:00:00,183,84,99,FMN 18 Binnensingel Westkant
665,Uitbreidingstraat 390,2022-12-07,14:00:00,103,36,67,FMN 18 Binnensingel Westkant
665,Uitbreidingstraat 390,2022-12-07,15:00:00,143,59,84,FMN 18 Binnensingel Westkant
665,Uitbreidingstraat 390,2022-12-07,16:00:00,174,80,94,FMN 18 Binnensingel Westkant
665,Uitbreidingstraat 390,2022-12-07,17:00:00,231,108,123,FMN 18 Binnensingel Westkant
665,Uitbreidingstraat 390,2022-12-07,18:00:00,177,71,106,FMN 18 Binnensingel Westkant
665,Uitbreidingstraat 390,2022-12-07,19:00:00,109,38,71,FMN 18 Binnensingel Westkant
665,Uitbreidingstraat 390,2022-12-07,20:00:00,87,27,60,FMN 18 Binnensingel Westkant
665,Uitbreidingstraat 390,2022-12-07,21:00:00,46,20,26,FMN 18 Binnensingel Westkant
665,Uitbreidingstraat 390,2022-12-07,22:00:00,49,22,27,FMN 18 Binnensingel Westkant
665,Uitbreidingstraat 390,2022-12-07,23:00:00,50,18,32,FMN 18 Binnensingel Westkant
665,Uitbreidingstraat 390,2022-12-08,00:00:00,15,2,13,FMN 18 Binnensingel Westkant
665,Uitbreidingstraat 390,2022-12-08,01:00:00,6,0,6,FMN 18 Binnensingel Westkant
665,Uitbreidingstraat 390,2022-12-08,02:00:00,1,1,0,FMN 18 Binnensingel Westkant
665,Uitbreidingstraat 390,2022-12-08,03:00:00,6,1,5,FMN 18 Binnensingel Westkant
665,Uitbreidingstraat 390,2022-12-08,04:00:00,7,0,7,FMN 18 Binnensingel Westkant
665,Uitbreidingstraat 390,2022-12-08,05:00:00,19,2,17,FMN 18 Binnensingel Westkant
665,Uitbreidingstraat 390,2022-12-08,06:00:00,61,20,41,FMN 18 Binnensingel Westkant
665,Uitbreidingstraat 390,2022-12-08,07:00:00,216,43,173,FMN 18 Binnensingel Westkant
665,Uitbreidingstraat 390,2022-12-08,08:00:00,476,80,396,FMN 18 Binnensingel Westkant
665,Uitbreidingstraat 390,2022-12-08,09:00:00,176,39,137,FMN 18 Binnensingel Westkant
665,Uitbreidingstraat 390,2022-12-08,10:00:00,171,75,96,FMN 18 Binnensingel Westkant
665,Uitbreidingstraat 390,2022-12-08,11:00:00,112,56,56,FMN 18 Binnensingel Westkant
665,Uitbreidingstraat 390,2022-12-08,12:00:00,130,53,77,FMN 18 Binnensingel Westkant
665,Uitbreidingstraat 390,2022-12-08,13:00:00,99,19,80,FMN 18 Binnensingel Westkant
665,Uitbreidingstraat 390,2022-12-08,14:00:00,72,31,41,FMN 18 Binnensingel Westkant
665,Uitbreidingstraat 390,2022-12-08,15:00:00,164,85,79,FMN 18 Binnensingel Westkant
665,Uitbreidingstraat 390,2022-12-08,16:00:00,236,137,99,FMN 18 Binnensingel Westkant
665,Uitbreidingstraat 390,2022-12-08,17:00:00,215,99,116,FMN 18 Binnensingel Westkant
665,Uitbreidingstraat 390,2022-12-08,18:00:00,178,63,115,FMN 18 Binnensingel Westkant
665,Uitbreidingstraat 390,2022-12-08,19:00:00,110,36,74,FMN 18 Binnensingel Westkant
665,Uitbreidingstraat 390,2022-12-08,20:00:00,59,23,36,FMN 18 Binnensingel Westkant
665,Uitbreidingstraat 390,2022-12-08,21:00:00,55,20,35,FMN 18 Binnensingel Westkant
665,Uitbreidingstraat 390,2022-12-08,22:00:00,54,19,35,FMN 18 Binnensingel Westkant
665,Uitbreidingstraat 390,2022-12-08,23:00:00,59,14,45,FMN 18 Binnensingel Westkant
665,Uitbreidingstraat 390,2022-12-09,00:00:00,27,6,21,FMN 18 Binnensingel Westkant
665,Uitbreidingstraat 390,2022-12-09,01:00:00,9,3,6,FMN 18 Binnensingel Westkant
665,Uitbreidingstraat 390,2022-12-09,02:00:00,4,0,4,FMN 18 Binnensingel Westkant
665,Uitbreidingstraat 390,2022-12-09,03:00:00,4,2,2,FMN 18 Binnensingel Westkant
665,Uitbreidingstraat 390,2022-12-09,04:00:00,7,0,7,FMN 18 Binnensingel Westkant
665,Uitbreidingstraat 390,2022-12-09,05:00:00,21,3,18,FMN 18 Binnensingel Westkant
665,Uitbreidingstraat 390,2022-12-09,06:00:00,46,7,39,FMN 18 Binnensingel Westkant
665,Uitbreidingstraat 390,2022-12-09,07:00:00,201,41,160,FMN 18 Binnensingel Westkant
665,Uitbreidingstraat 390,2022-12-09,08:00:00,327,61,266,FMN 18 Binnensingel Westkant
665,Uitbreidingstraat 390,2022-12-09,09:00:00,120,20,100,FMN 18 Binnensingel Westkant
665,Uitbreidingstraat 390,2022-12-09,10:00:00,153,66,87,FMN 18 Binnensingel Westkant
665,Uitbreidingstraat 390,2022-12-09,11:00:00,97,50,47,FMN 18 Binnensingel Westkant
665,Uitbreidingstraat 390,2022-12-09,12:00:00,144,58,86,FMN 18 Binnensingel Westkant
665,Uitbreidingstraat 390,2022-12-09,13:00:00,118,44,74,FMN 18 Binnensingel Westkant
665,Uitbreidingstraat 390,2022-12-09,14:00:00,104,39,65,FMN 18 Binnensingel Westkant
665,Uitbreidingstraat 390,2022-12-09,15:00:00,104,52,52,FMN 18 Binnensingel Westkant
665,Uitbreidingstraat 390,2022-12-09,16:00:00,196,107,89,FMN 18 Binnensingel Westkant
665,Uitbreidingstraat 390,2022-12-09,17:00:00,155,63,92,FMN 18 Binnensingel Westkant
665,Uitbreidingstraat 390,2022-12-09,18:00:00,99,36,63,FMN 18 Binnensingel Westkant
665,Uitbreidingstraat 390,2022-12-09,19:00:00,88,25,63,FMN 18 Binnensingel Westkant
665,Uitbreidingstraat 390,2022-12-09,20:00:00,51,20,31,FMN 18 Binnensingel Westkant
665,Uitbreidingstraat 390,2022-12-09,21:00:00,30,10,20,FMN 18 Binnensingel Westkant
665,Uitbreidingstraat 390,2022-12-09,22:00:00,21,6,15,FMN 18 Binnensingel Westkant
665,Uitbreidingstraat 390,2022-12-09,23:00:00,46,11,35,FMN 18 Binnensingel Westkant
665,Uitbreidingstraat 390,2022-12-10,00:00:00,24,4,20,FMN 18 Binnensingel Westkant
665,Uitbreidingstraat 390,2022-12-10,01:00:00,23,9,14,FMN 18 Binnensingel Westkant
665,Uitbreidingstraat 390,2022-12-10,02:00:00,11,1,10,FMN 18 Binnensingel Westkant
665,Uitbreidingstraat 390,2022-12-10,03:00:00,9,2,7,FMN 18 Binnensingel Westkant
665,Uitbreidingstraat 390,2022-12-10,04:00:00,14,4,10,FMN 18 Binnensingel Westkant
665,Uitbreidingstraat 390,2022-12-10,05:00:00,10,2,8,FMN 18 Binnensingel Westkant
665,Uitbreidingstraat 390,2022-12-10,06:00:00,13,2,11,FMN 18 Binnensingel Westkant
665,Uitbreidingstraat 390,2022-12-10,07:00:00,13,6,7,FMN 18 Binnensingel Westkant
665,Uitbreidingstraat 390,2022-12-10,08:00:00,13,0,13,FMN 18 Binnensingel Westkant
665,Uitbreidingstraat 390,2022-12-10,09:00:00,36,13,23,FMN 18 Binnensingel Westkant
665,Uitbreidingstraat 390,2022-12-10,10:00:00,43,15,28,FMN 18 Binnensingel Westkant
665,Uitbreidingstraat 390,2022-12-10,11:00:00,49,19,30,FMN 18 Binnensingel Westkant
665,Uitbreidingstraat 390,2022-12-10,12:00:00,46,19,27,FMN 18 Binnensingel Westkant
665,Uitbreidingstraat 390,2022-12-10,13:00:00,63,23,40,FMN 18 Binnensingel Westkant
665,Uitbreidingstraat 390,2022-12-10,14:00:00,55,20,35,FMN 18 Binnensingel Westkant
665,Uitbreidingstraat 390,2022-12-10,15:00:00,64,18,46,FMN 18 Binnensingel Westkant
665,Uitbreidingstraat 390,2022-12-10,16:00:00,46,20,26,FMN 18 Binnensingel Westkant
665,Uitbreidingstraat 390,2022-12-10,17:00:00,55,19,36,FMN 18 Binnensingel Westkant
665,Uitbreidingstraat 390,2022-12-10,18:00:00,69,20,49,FMN 18 Binnensingel Westkant
665,Uitbreidingstraat 390,2022-12-10,19:00:00,68,25,43,FMN 18 Binnensingel Westkant
665,Uitbreidingstraat 390,2022-12-10,20:00:00,43,14,29,FMN 18 Binnensingel Westkant
665,Uitbreidingstraat 390,2022-12-10,21:00:00,44,13,31,FMN 18 Binnensingel Westkant
665,Uitbreidingstraat 390,2022-12-10,22:00:00,31,7,24,FMN 18 Binnensingel Westkant
665,Uitbreidingstraat 390,2022-12-10,23:00:00,93,17,76,FMN 18 Binnensingel Westkant
665,Uitbreidingstraat 390,2022-12-11,00:00:00,39,7,32,FMN 18 Binnensingel Westkant
665,Uitbreidingstraat 390,2022-12-11,01:00:00,18,5,13,FMN 18 Binnensingel Westkant
665,Uitbreidingstraat 390,2022-12-11,02:00:00,9,3,6,FMN 18 Binnensingel Westkant
665,Uitbreidingstraat 390,2022-12-11,03:00:00,17,5,12,FMN 18 Binnensingel Westkant
665,Uitbreidingstraat 390,2022-12-11,04:00:00,11,5,6,FMN 18 Binnensingel Westkant
665,Uitbreidingstraat 390,2022-12-11,05:00:00,8,0,8,FMN 18 Binnensingel Westkant
665,Uitbreidingstraat 390,2022-12-11,06:00:00,15,3,12,FMN 18 Binnensingel Westkant
665,Uitbreidingstraat 390,2022-12-11,07:00:00,8,3,5,FMN 18 Binnensingel Westkant
665,Uitbreidingstraat 390,2022-12-11,08:00:00,13,1,12,FMN 18 Binnensingel Westkant
665,Uitbreidingstraat 390,2022-12-11,09:00:00,33,9,24,FMN 18 Binnensingel Westkant
665,Uitbreidingstraat 390,2022-12-11,10:00:00,38,10,28,FMN 18 Binnensingel Westkant
665,Uitbreidingstraat 390,2022-12-11,11:00:00,44,16,28,FMN 18 Binnensingel Westkant
665,Uitbreidingstraat 390,2022-12-11,12:00:00,67,20,47,FMN 18 Binnensingel Westkant
665,Uitbreidingstraat 390,2022-12-11,13:00:00,45,13,32,FMN 18 Binnensingel Westkant
665,Uitbreidingstraat 390,2022-12-11,14:00:00,60,21,39,FMN 18 Binnensingel Westkant
665,Uitbreidingstraat 390,2022-12-11,15:00:00,48,16,32,FMN 18 Binnensingel Westkant
665,Uitbreidingstraat 390,2022-12-11,16:00:00,49,17,32,FMN 18 Binnensingel Westkant
665,Uitbreidingstraat 390,2022-12-11,17:00:00,48,20,28,FMN 18 Binnensingel Westkant
665,Uitbreidingstraat 390,2022-12-11,18:00:00,50,19,31,FMN 18 Binnensingel Westkant
665,Uitbreidingstraat 390,2022-12-11,19:00:00,36,11,25,FMN 18 Binnensingel Westkant
665,Uitbreidingstraat 390,2022-12-11,20:00:00,41,9,32,FMN 18 Binnensingel Westkant
665,Uitbreidingstraat 390,2022-12-11,21:00:00,32,6,26,FMN 18 Binnensingel Westkant
665,Uitbreidingstraat 390,2022-12-11,22:00:00,27,4,23,FMN 18 Binnensingel Westkant
665,Uitbreidingstraat 390,2022-12-11,23:00:00,9,3,6,FMN 18 Binnensingel Westkant
665,Uitbreidingstraat 390,2022-12-12,00:00:00,7,2,5,FMN 18 Binnensingel Westkant
665,Uitbreidingstraat 390,2022-12-12,01:00:00,5,0,5,FMN 18 Binnensingel Westkant
665,Uitbreidingstraat 390,2022-12-12,02:00:00,0,0,0,FMN 18 Binnensingel Westkant
665,Uitbreidingstraat 390,2022-12-12,03:00:00,2,1,1,FMN 18 Binnensingel Westkant
665,Uitbreidingstraat 390,2022-12-12,04:00:00,1,1,0,FMN 18 Binnensingel Westkant
665,Uitbreidingstraat 390,2022-12-12,05:00:00,21,3,18,FMN 18 Binnensingel Westkant
665,Uitbreidingstraat 390,2022-12-12,06:00:00,31,6,25,FMN 18 Binnensingel Westkant
665,Uitbreidingstraat 390,2022-12-12,07:00:00,120,24,96,FMN 18 Binnensingel Westkant
665,Uitbreidingstraat 390,2022-12-12,08:00:00,221,44,177,FMN 18 Binnensingel Westkant
665,Uitbreidingstraat 390,2022-12-12,09:00:00,84,14,70,FMN 18 Binnensingel Westkant
665,Uitbreidingstraat 390,2022-12-12,10:00:00,70,27,43,FMN 18 Binnensingel Westkant
665,Uitbreidingstraat 390,2022-12-12,11:00:00,84,52,32,FMN 18 Binnensingel Westkant
665,Uitbreidingstraat 390,2022-12-12,12:00:00,174,82,92,FMN 18 Binnensingel Westkant
665,Uitbreidingstraat 390,2022-12-12,13:00:00,143,56,87,FMN 18 Binnensingel Westkant
665,Uitbreidingstraat 390,2022-12-12,14:00:00,78,38,40,FMN 18 Binnensingel Westkant
665,Uitbreidingstraat 390,2022-12-12,15:00:00,126,61,65,FMN 18 Binnensingel Westkant
665,Uitbreidingstraat 390,2022-12-12,16:00:00,142,73,69,FMN 18 Binnensingel Westkant
665,Uitbreidingstraat 390,2022-12-12,17:00:00,198,95,103,FMN 18 Binnensingel Westkant
665,Uitbreidingstraat 390,2022-12-12,18:00:00,122,44,78,FMN 18 Binnensingel Westkant
665,Uitbreidingstraat 390,2022-12-12,19:00:00,75,27,48,FMN 18 Binnensingel Westkant
665,Uitbreidingstraat 390,2022-12-12,20:00:00,41,14,27,FMN 18 Binnensingel Westkant
665,Uitbreidingstraat 390,2022-12-12,21:00:00,41,23,18,FMN 18 Binnensingel Westkant
665,Uitbreidingstraat 390,2022-12-12,22:00:00,22,7,15,FMN 18 Binnensingel Westkant
665,Uitbreidingstraat 390,2022-12-12,23:00:00,14,4,10,FMN 18 Binnensingel Westkant
665,Uitbreidingstraat 390,2022-12-13,00:00:00,4,1,3,FMN 18 Binnensingel Westkant
665,Uitbreidingstraat 390,2022-12-13,01:00:00,5,0,5,FMN 18 Binnensingel Westkant
665,Uitbreidingstraat 390,2022-12-13,02:00:00,1,1,0,FMN 18 Binnensingel Westkant
665,Uitbreidingstraat 390,2022-12-13,03:00:00,1,0,1,FMN 18 Binnensingel Westkant
665,Uitbreidingstraat 390,2022-12-13,04:00:00,2,0,2,FMN 18 Binnensingel Westkant
665,Uitbreidingstraat 390,2022-12-13,05:00:00,16,2,14,FMN 18 Binnensingel Westkant
665,Uitbreidingstraat 390,2022-12-13,06:00:00,32,10,22,FMN 18 Binnensingel Westkant
665,Uitbreidingstraat 390,2022-12-13,07:00:00,107,23,84,FMN 18 Binnensingel Westkant
665,Uitbreidingstraat 390,2022-12-13,08:00:00,183,42,141,FMN 18 Binnensingel Westkant
665,Uitbreidingstraat 390,2022-12-13,09:00:00,91,32,59,FMN 18 Binnensingel Westkant
665,Uitbreidingstraat 390,2022-12-13,10:00:00,88,47,41,FMN 18 Binnensingel Westkant
665,Uitbreidingstraat 390,2022-12-13,11:00:00,62,26,36,FMN 18 Binnensingel Westkant
665,Uitbreidingstraat 390,2022-12-13,12:00:00,110,37,73,FMN 18 Binnensingel Westkant
665,Uitbreidingstraat 390,2022-12-13,13:00:00,95,37,58,FMN 18 Binnensingel Westkant
665,Uitbreidingstraat 390,2022-12-13,14:00:00,65,21,44,FMN 18 Binnensingel Westkant
665,Uitbreidingstraat 390,2022-12-13,15:00:00,93,53,40,FMN 18 Binnensingel Westkant
665,Uitbreidingstraat 390,2022-12-13,16:00:00,144,84,60,FMN 18 Binnensingel Westkant
665,Uitbreidingstraat 390,2022-12-13,17:00:00,199,92,107,FMN 18 Binnensingel Westkant
665,Uitbreidingstraat 390,2022-12-13,18:00:00,135,62,73,FMN 18 Binnensingel Westkant
665,Uitbreidingstraat 390,2022-12-13,19:00:00,70,27,43,FMN 18 Binnensingel Westkant
665,Uitbreidingstraat 390,2022-12-13,20:00:00,37,16,21,FMN 18 Binnensingel Westkant
665,Uitbreidingstraat 390,2022-12-13,21:00:00,38,19,19,FMN 18 Binnensingel Westkant
665,Uitbreidingstraat 390,2022-12-13,22:00:00,39,16,23,FMN 18 Binnensingel Westkant
665,Uitbreidingstraat 390,2022-12-13,23:00:00,20,5,15,FMN 18 Binnensingel Westkant
665,Uitbreidingstraat 390,2022-12-14,00:00:00,10,3,7,FMN 18 Binnensingel Westkant
665,Uitbreidingstraat 390,2022-12-14,01:00:00,2,0,2,FMN 18 Binnensingel Westkant
665,Uitbreidingstraat 390,2022-12-14,02:00:00,4,0,4,FMN 18 Binnensingel Westkant
665,Uitbreidingstraat 390,2022-12-14,03:00:00,0,0,0,FMN 18 Binnensingel Westkant
665,Uitbreidingstraat 390,2022-12-14,04:00:00,4,2,2,FMN 18 Binnensingel Westkant
665,Uitbreidingstraat 390,2022-12-14,05:00:00,27,7,20,FMN 18 Binnensingel Westkant
665,Uitbreidingstraat 390,2022-12-14,06:00:00,36,5,31,FMN 18 Binnensingel Westkant
665,Uitbreidingstraat 390,2022-12-14,07:00:00,119,16,103,FMN 18 Binnensingel Westkant
665,Uitbreidingstraat 390,2022-12-14,08:00:00,222,46,176,FMN 18 Binnensingel Westkant
665,Uitbreidingstraat 390,2022-12-14,09:00:00,89,11,78,FMN 18 Binnensingel Westkant
665,Uitbreidingstraat 390,2022-12-14,10:00:00,94,50,44,FMN 18 Binnensingel Westkant
665,Uitbreidingstraat 390,2022-12-14,11:00:00,114,72,42,FMN 18 Binnensingel Westkant
665,Uitbreidingstraat 390,2022-12-14,12:00:00,148,58,90,FMN 18 Binnensingel Westkant
665,Uitbreidingstraat 390,2022-12-14,13:00:00,127,54,73,FMN 18 Binnensingel Westkant
665,Uitbreidingstraat 390,2022-12-14,14:00:00,88,35,53,FMN 18 Binnensingel Westkant
665,Uitbreidingstraat 390,2022-12-14,15:00:00,108,49,59,FMN 18 Binnensingel Westkant
665,Uitbreidingstraat 390,2022-12-14,16:00:00,116,61,55,FMN 18 Binnensingel Westkant
665,Uitbreidingstraat 390,2022-12-14,17:00:00,151,64,87,FMN 18 Binnensingel Westkant
665,Uitbreidingstraat 390,2022-12-14,18:00:00,126,42,84,FMN 18 Binnensingel Westkant
665,Uitbreidingstraat 390,2022-12-14,19:00:00,53,14,39,FMN 18 Binnensingel Westkant
665,Uitbreidingstraat 390,2022-12-14,20:00:00,29,7,22,FMN 18 Binnensingel Westkant
665,Uitbreidingstraat 390,2022-12-14,21:00:00,32,13,19,FMN 18 Binnensingel Westkant
665,Uitbreidingstraat 390,2022-12-14,22:00:00,41,19,22,FMN 18 Binnensingel Westkant
665,Uitbreidingstraat 390,2022-12-14,23:00:00,23,6,17,FMN 18 Binnensingel Westkant
665,Uitbreidingstraat 390,2022-12-15,00:00:00,3,2,1,FMN 18 Binnensingel Westkant
665,Uitbreidingstraat 390,2022-12-15,01:00:00,2,0,2,FMN 18 Binnensingel Westkant
665,Uitbreidingstraat 390,2022-12-15,02:00:00,4,1,3,FMN 18 Binnensingel Westkant
665,Uitbreidingstraat 390,2022-12-15,03:00:00,1,0,1,FMN 18 Binnensingel Westkant
665,Uitbreidingstraat 390,2022-12-15,04:00:00,1,1,0,FMN 18 Binnensingel Westkant
665,Uitbreidingstraat 390,2022-12-15,05:00:00,15,6,9,FMN 18 Binnensingel Westkant
665,Uitbreidingstraat 390,2022-12-15,06:00:00,32,6,26,FMN 18 Binnensingel Westkant
665,Uitbreidingstraat 390,2022-12-15,07:00:00,83,12,71,FMN 18 Binnensingel Westkant
665,Uitbreidingstraat 390,2022-12-15,08:00:00,176,34,142,FMN 18 Binnensingel Westkant
665,Uitbreidingstraat 390,2022-12-15,09:00:00,108,27,81,FMN 18 Binnensingel Westkant
665,Uitbreidingstraat 390,2022-12-15,10:00:00,97,47,50,FMN 18 Binnensingel Westkant
665,Uitbreidingstraat 390,2022-12-15,11:00:00,54,23,31,FMN 18 Binnensingel Westkant
665,Uitbreidingstraat 390,2022-12-15,12:00:00,116,40,76,FMN 18 Binnensingel Westkant
665,Uitbreidingstraat 390,2022-12-15,13:00:00,106,36,70,FMN 18 Binnensingel Westkant
665,Uitbreidingstraat 390,2022-12-15,14:00:00,97,30,67,FMN 18 Binnensingel Westkant
665,Uitbreidingstraat 390,2022-12-15,15:00:00,112,58,54,FMN 18 Binnensingel Westkant
665,Uitbreidingstraat 390,2022-12-15,16:00:00,157,82,75,FMN 18 Binnensingel Westkant
665,Uitbreidingstraat 390,2022-12-15,17:00:00,151,73,78,FMN 18 Binnensingel Westkant
665,Uitbreidingstraat 390,2022-12-15,18:00:00,133,48,85,FMN 18 Binnensingel Westkant
665,Uitbreidingstraat 390,2022-12-15,19:00:00,116,39,77,FMN 18 Binnensingel Westkant
665,Uitbreidingstraat 390,2022-12-15,20:00:00,47,14,33,FMN 18 Binnensingel Westkant
665,Uitbreidingstraat 390,2022-12-15,21:00:00,43,18,25,FMN 18 Binnensingel Westkant
665,Uitbreidingstraat 390,2022-12-15,22:00:00,42,15,27,FMN 18 Binnensingel Westkant
665,Uitbreidingstraat 390,2022-12-15,23:00:00,25,7,18,FMN 18 Binnensingel Westkant
665,Uitbreidingstraat 390,2022-12-16,00:00:00,20,6,14,FMN 18 Binnensingel Westkant
665,Uitbreidingstraat 390,2022-12-16,01:00:00,9,3,6,FMN 18 Binnensingel Westkant
665,Uitbreidingstraat 390,2022-12-16,02:00:00,6,0,6,FMN 18 Binnensingel Westkant
665,Uitbreidingstraat 390,2022-12-16,03:00:00,1,1,0,FMN 18 Binnensingel Westkant
665,Uitbreidingstraat 390,2022-12-16,04:00:00,4,2,2,FMN 18 Binnensingel Westkant
665,Uitbreidingstraat 390,2022-12-16,05:00:00,21,4,17,FMN 18 Binnensingel Westkant
665,Uitbreidingstraat 390,2022-12-16,06:00:00,45,6,39,FMN 18 Binnensingel Westkant
665,Uitbreidingstraat 390,2022-12-16,07:00:00,140,13,127,FMN 18 Binnensingel Westkant
665,Uitbreidingstraat 390,2022-12-16,08:00:00,230,36,194,FMN 18 Binnensingel Westkant
665,Uitbreidingstraat 390,2022-12-16,09:00:00,134,42,92,FMN 18 Binnensingel Westkant
665,Uitbreidingstraat 390,2022-12-16,10:00:00,108,33,75,FMN 18 Binnensingel Westkant
665,Uitbreidingstraat 390,2022-12-16,11:00:00,87,36,51,FMN 18 Binnensingel Westkant
665,Uitbreidingstraat 390,2022-12-16,12:00:00,128,40,88,FMN 18 Binnensingel Westkant
665,Uitbreidingstraat 390,2022-12-16,13:00:00,140,47,93,FMN 18 Binnensingel Westkant
665,Uitbreidingstraat 390,2022-12-16,14:00:00,111,33,78,FMN 18 Binnensingel Westkant
665,Uitbreidingstraat 390,2022-12-16,15:00:00,136,52,84,FMN 18 Binnensingel Westkant
665,Uitbreidingstraat 390,2022-12-16,16:00:00,165,76,89,FMN 18 Binnensingel Westkant
665,Uitbreidingstraat 390,2022-12-16,17:00:00,159,65,94,FMN 18 Binnensingel Westkant
665,Uitbreidingstraat 390,2022-12-16,18:00:00,136,56,80,FMN 18 Binnensingel Westkant
665,Uitbreidingstraat 390,2022-12-16,19:00:00,76,22,54,FMN 18 Binnensingel Westkant
665,Uitbreidingstraat 390,2022-12-16,20:00:00,61,22,39,FMN 18 Binnensingel Westkant
665,Uitbreidingstraat 390,2022-12-16,21:00:00,30,11,19,FMN 18 Binnensingel Westkant
665,Uitbreidingstraat 390,2022-12-16,22:00:00,32,18,14,FMN 18 Binnensingel Westkant
665,Uitbreidingstraat 390,2022-12-16,23:00:00,33,7,26,FMN 18 Binnensingel Westkant
665,Uitbreidingstraat 390,2022-12-17,00:00:00,24,12,12,FMN 18 Binnensingel Westkant
665,Uitbreidingstraat 390,2022-12-17,01:00:00,15,2,13,FMN 18 Binnensingel Westkant
665,Uitbreidingstraat 390,2022-12-17,02:00:00,8,1,7,FMN 18 Binnensingel Westkant
665,Uitbreidingstraat 390,2022-12-17,03:00:00,4,0,4,FMN 18 Binnensingel Westkant
665,Uitbreidingstraat 390,2022-12-17,04:00:00,7,1,6,FMN 18 Binnensingel Westkant
665,Uitbreidingstraat 390,2022-12-17,05:00:00,7,2,5,FMN 18 Binnensingel Westkant
665,Uitbreidingstraat 390,2022-12-17,06:00:00,10,1,9,FMN 18 Binnensingel Westkant
665,Uitbreidingstraat 390,2022-12-17,07:00:00,11,3,8,FMN 18 Binnensingel Westkant
665,Uitbreidingstraat 390,2022-12-17,08:00:00,12,5,7,FMN 18 Binnensingel Westkant
665,Uitbreidingstraat 390,2022-12-17,09:00:00,25,13,12,FMN 18 Binnensingel Westkant
665,Uitbreidingstraat 390,2022-12-17,10:00:00,29,8,21,FMN 18 Binnensingel Westkant
665,Uitbreidingstraat 390,2022-12-17,11:00:00,41,16,25,FMN 18 Binnensingel Westkant
665,Uitbreidingstraat 390,2022-12-17,12:00:00,65,29,36,FMN 18 Binnensingel Westkant
665,Uitbreidingstraat 390,2022-12-17,13:00:00,63,24,39,FMN 18 Binnensingel Westkant
665,Uitbreidingstraat 390,2022-12-17,14:00:00,47,14,33,FMN 18 Binnensingel Westkant
665,Uitbreidingstraat 390,2022-12-17,15:00:00,42,17,25,FMN 18 Binnensingel Westkant
665,Uitbreidingstraat 390,2022-12-17,16:00:00,54,20,34,FMN 18 Binnensingel Westkant
665,Uitbreidingstraat 390,2022-12-17,17:00:00,49,12,37,FMN 18 Binnensingel Westkant
665,Uitbreidingstraat 390,2022-12-17,18:00:00,39,17,22,FMN 18 Binnensingel Westkant
665,Uitbreidingstraat 390,2022-12-17,19:00:00,53,14,39,FMN 18 Binnensingel Westkant
665,Uitbreidingstraat 390,2022-12-17,20:00:00,35,13,22,FMN 18 Binnensingel Westkant
665,Uitbreidingstraat 390,2022-12-17,21:00:00,19,4,15,FMN 18 Binnensingel Westkant
665,Uitbreidingstraat 390,2022-12-17,22:00:00,12,2,10,FMN 18 Binnensingel Westkant
665,Uitbreidingstraat 390,2022-12-17,23:00:00,36,7,29,FMN 18 Binnensingel Westkant
665,Uitbreidingstraat 390,2022-12-18,00:00:00,14,5,9,FMN 18 Binnensingel Westkant
665,Uitbreidingstraat 390,2022-12-18,01:00:00,11,8,3,FMN 18 Binnensingel Westkant
665,Uitbreidingstraat 390,2022-12-18,02:00:00,6,1,5,FMN 18 Binnensingel Westkant
665,Uitbreidingstraat 390,2022-12-18,03:00:00,3,0,3,FMN 18 Binnensingel Westkant
665,Uitbreidingstraat 390,2022-12-18,04:00:00,5,1,4,FMN 18 Binnensingel Westkant
665,Uitbreidingstraat 390,2022-12-18,05:00:00,2,0,2,FMN 18 Binnensingel Westkant
665,Uitbreidingstraat 390,2022-12-18,06:00:00,6,0,6,FMN 18 Binnensingel Westkant
665,Uitbreidingstraat 390,2022-12-18,07:00:00,0,0,0,FMN 18 Binnensingel Westkant
665,Uitbreidingstraat 390,2022-12-18,08:00:00,1,0,1,FMN 18 Binnensingel Westkant
665,Uitbreidingstraat 390,2022-12-18,09:00:00,11,4,7,FMN 18 Binnensingel Westkant
665,Uitbreidingstraat 390,2022-12-18,10:00:00,23,4,19,FMN 18 Binnensingel Westkant
665,Uitbreidingstraat 390,2022-12-18,11:00:00,25,6,19,FMN 18 Binnensingel Westkant
665,Uitbreidingstraat 390,2022-12-18,12:00:00,29,10,19,FMN 18 Binnensingel Westkant
665,Uitbreidingstraat 390,2022-12-18,13:00:00,31,8,23,FMN 18 Binnensingel Westkant
665,Uitbreidingstraat 390,2022-12-18,14:00:00,42,11,31,FMN 18 Binnensingel Westkant
665,Uitbreidingstraat 390,2022-12-18,15:00:00,27,5,22,FMN 18 Binnensingel Westkant
665,Uitbreidingstraat 390,2022-12-18,16:00:00,19,7,12,FMN 18 Binnensingel Westkant
665,Uitbreidingstraat 390,2022-12-18,17:00:00,47,16,31,FMN 18 Binnensingel Westkant
665,Uitbreidingstraat 390,2022-12-18,18:00:00,29,12,17,FMN 18 Binnensingel Westkant
665,Uitbreidingstraat 390,2022-12-18,19:00:00,24,5,19,FMN 18 Binnensingel Westkant
665,Uitbreidingstraat 390,2022-12-18,20:00:00,35,4,31,FMN 18 Binnensingel Westkant
665,Uitbreidingstraat 390,2022-12-18,21:00:00,15,4,11,FMN 18 Binnensingel Westkant
665,Uitbreidingstraat 390,2022-12-18,22:00:00,21,7,14,FMN 18 Binnensingel Westkant
665,Uitbreidingstraat 390,2022-12-18,23:00:00,4,0,4,FMN 18 Binnensingel Westkant
665,Uitbreidingstraat 390,2022-12-19,00:00:00,4,2,2,FMN 18 Binnensingel Westkant
665,Uitbreidingstraat 390,2022-12-19,01:00:00,7,2,5,FMN 18 Binnensingel Westkant
665,Uitbreidingstraat 390,2022-12-19,02:00:00,2,1,1,FMN 18 Binnensingel Westkant
665,Uitbreidingstraat 390,2022-12-19,03:00:00,0,0,0,FMN 18 Binnensingel Westkant
665,Uitbreidingstraat 390,2022-12-19,04:00:00,8,3,5,FMN 18 Binnensingel Westkant
665,Uitbreidingstraat 390,2022-12-19,05:00:00,18,3,15,FMN 18 Binnensingel Westkant
665,Uitbreidingstraat 390,2022-12-19,06:00:00,48,7,41,FMN 18 Binnensingel Westkant
665,Uitbreidingstraat 390,2022-12-19,07:00:00,163,35,128,FMN 18 Binnensingel Westkant
665,Uitbreidingstraat 390,2022-12-19,08:00:00,364,54,310,FMN 18 Binnensingel Westkant
665,Uitbreidingstraat 390,2022-12-19,09:00:00,133,17,116,FMN 18 Binnensingel Westkant
665,Uitbreidingstraat 390,2022-12-19,10:00:00,127,28,99,FMN 18 Binnensingel Westkant
665,Uitbreidingstraat 390,2022-12-19,11:00:00,67,23,44,FMN 18 Binnensingel Westkant
665,Uitbreidingstraat 390,2022-12-19,12:00:00,96,41,55,FMN 18 Binnensingel Westkant
665,Uitbreidingstraat 390,2022-12-19,13:00:00,105,32,73,FMN 18 Binnensingel Westkant
665,Uitbreidingstraat 390,2022-12-19,14:00:00,99,50,49,FMN 18 Binnensingel Westkant
665,Uitbreidingstraat 390,2022-12-19,15:00:00,114,58,56,FMN 18 Binnensingel Westkant
665,Uitbreidingstraat 390,2022-12-19,16:00:00,166,75,91,FMN 18 Binnensingel Westkant
665,Uitbreidingstraat 390,2022-12-19,17:00:00,204,101,103,FMN 18 Binnensingel Westkant
665,Uitbreidingstraat 390,2022-12-19,18:00:00,157,54,103,FMN 18 Binnensingel Westkant
665,Uitbreidingstraat 390,2022-12-19,19:00:00,107,33,74,FMN 18 Binnensingel Westkant
665,Uitbreidingstraat 390,2022-12-19,20:00:00,60,23,37,FMN 18 Binnensingel Westkant
665,Uitbreidingstraat 390,2022-12-19,21:00:00,62,26,36,FMN 18 Binnensingel Westkant
665,Uitbreidingstraat 390,2022-12-19,22:00:00,45,14,31,FMN 18 Binnensingel Westkant
665,Uitbreidingstraat 390,2022-12-19,23:00:00,37,8,29,FMN 18 Binnensingel Westkant
665,Uitbreidingstraat 390,2022-12-20,00:00:00,15,7,8,FMN 18 Binnensingel Westkant
665,Uitbreidingstraat 390,2022-12-20,01:00:00,6,0,6,FMN 18 Binnensingel Westkant
665,Uitbreidingstraat 390,2022-12-20,02:00:00,1,0,1,FMN 18 Binnensingel Westkant
665,Uitbreidingstraat 390,2022-12-20,03:00:00,5,1,4,FMN 18 Binnensingel Westkant
665,Uitbreidingstraat 390,2022-12-20,04:00:00,8,0,8,FMN 18 Binnensingel Westkant
665,Uitbreidingstraat 390,2022-12-20,05:00:00,29,6,23,FMN 18 Binnensingel Westkant
665,Uitbreidingstraat 390,2022-12-20,06:00:00,51,12,39,FMN 18 Binnensingel Westkant
665,Uitbreidingstraat 390,2022-12-20,07:00:00,190,28,162,FMN 18 Binnensingel Westkant
665,Uitbreidingstraat 390,2022-12-20,08:00:00,307,54,253,FMN 18 Binnensingel Westkant
665,Uitbreidingstraat 390,2022-12-20,09:00:00,138,20,118,FMN 18 Binnensingel Westkant
665,Uitbreidingstraat 390,2022-12-20,10:00:00,81,20,61,FMN 18 Binnensingel Westkant
665,Uitbreidingstraat 390,2022-12-20,11:00:00,62,20,42,FMN 18 Binnensingel Westkant
665,Uitbreidingstraat 390,2022-12-20,12:00:00,86,34,52,FMN 18 Binnensingel Westkant
665,Uitbreidingstraat 390,2022-12-20,13:00:00,106,22,84,FMN 18 Binnensingel Westkant
665,Uitbreidingstraat 390,2022-12-20,14:00:00,58,21,37,FMN 18 Binnensingel Westkant
665,Uitbreidingstraat 390,2022-12-20,15:00:00,132,74,58,FMN 18 Binnensingel Westkant
665,Uitbreidingstraat 390,2022-12-20,16:00:00,174,82,92,FMN 18 Binnensingel Westkant
665,Uitbreidingstraat 390,2022-12-20,17:00:00,210,88,122,FMN 18 Binnensingel Westkant
665,Uitbreidingstraat 390,2022-12-20,18:00:00,152,59,93,FMN 18 Binnensingel Westkant
665,Uitbreidingstraat 390,2022-12-20,19:00:00,92,33,59,FMN 18 Binnensingel Westkant
665,Uitbreidingstraat 390,2022-12-20,20:00:00,50,24,26,FMN 18 Binnensingel Westkant
665,Uitbreidingstraat 390,2022-12-20,21:00:00,40,12,28,FMN 18 Binnensingel Westkant
665,Uitbreidingstraat 390,2022-12-20,22:00:00,60,12,48,FMN 18 Binnensingel Westkant
665,Uitbreidingstraat 390,2022-12-20,23:00:00,35,10,25,FMN 18 Binnensingel Westkant
665,Uitbreidingstraat 390,2022-12-21,00:00:00,15,5,10,FMN 18 Binnensingel Westkant
665,Uitbreidingstraat 390,2022-12-21,01:00:00,11,1,10,FMN 18 Binnensingel Westkant
665,Uitbreidingstraat 390,2022-12-21,02:00:00,4,0,4,FMN 18 Binnensingel Westkant
665,Uitbreidingstraat 390,2022-12-21,03:00:00,6,0,6,FMN 18 Binnensingel Westkant
665,Uitbreidingstraat 390,2022-12-21,04:00:00,12,3,9,FMN 18 Binnensingel Westkant
665,Uitbreidingstraat 390,2022-12-21,05:00:00,33,3,30,FMN 18 Binnensingel Westkant
665,Uitbreidingstraat 390,2022-12-21,06:00:00,61,11,50,FMN 18 Binnensingel Westkant
665,Uitbreidingstraat 390,2022-12-21,07:00:00,176,28,148,FMN 18 Binnensingel Westkant
665,Uitbreidingstraat 390,2022-12-21,08:00:00,299,61,238,FMN 18 Binnensingel Westkant
665,Uitbreidingstraat 390,2022-12-21,09:00:00,146,31,115,FMN 18 Binnensingel Westkant
665,Uitbreidingstraat 390,2022-12-21,10:00:00,92,20,72,FMN 18 Binnensingel Westkant
665,Uitbreidingstraat 390,2022-12-21,11:00:00,94,32,62,FMN 18 Binnensingel Westkant
665,Uitbreidingstraat 390,2022-12-21,12:00:00,163,63,100,FMN 18 Binnensingel Westkant
665,Uitbreidingstraat 390,2022-12-21,13:00:00,141,40,101,FMN 18 Binnensingel Westkant
665,Uitbreidingstraat 390,2022-12-21,14:00:00,82,33,49,FMN 18 Binnensingel Westkant
665,Uitbreidingstraat 390,2022-12-21,15:00:00,146,58,88,FMN 18 Binnensingel Westkant
665,Uitbreidingstraat 390,2022-12-21,16:00:00,160,61,99,FMN 18 Binnensingel Westkant
665,Uitbreidingstraat 390,2022-12-21,17:00:00,180,76,104,FMN 18 Binnensingel Westkant
665,Uitbreidingstraat 390,2022-12-21,18:00:00,168,62,106,FMN 18 Binnensingel Westkant
665,Uitbreidingstraat 390,2022-12-21,19:00:00,93,29,64,FMN 18 Binnensingel Westkant
665,Uitbreidingstraat 390,2022-12-21,20:00:00,59,23,36,FMN 18 Binnensingel Westkant
665,Uitbreidingstraat 390,2022-12-21,21:00:00,53,19,34,FMN 18 Binnensingel Westkant
665,Uitbreidingstraat 390,2022-12-21,22:00:00,38,14,24,FMN 18 Binnensingel Westkant
665,Uitbreidingstraat 390,2022-12-21,23:00:00,43,5,38,FMN 18 Binnensingel Westkant
665,Uitbreidingstraat 390,2022-12-22,00:00:00,14,5,9,FMN 18 Binnensingel Westkant
665,Uitbreidingstraat 390,2022-12-22,01:00:00,11,2,9,FMN 18 Binnensingel Westkant
665,Uitbreidingstraat 390,2022-12-22,02:00:00,3,1,2,FMN 18 Binnensingel Westkant
665,Uitbreidingstraat 390,2022-12-22,03:00:00,4,0,4,FMN 18 Binnensingel Westkant
665,Uitbreidingstraat 390,2022-12-22,04:00:00,3,1,2,FMN 18 Binnensingel Westkant
665,Uitbreidingstraat 390,2022-12-22,05:00:00,23,4,19,FMN 18 Binnensingel Westkant
665,Uitbreidingstraat 390,2022-12-22,06:00:00,33,6,27,FMN 18 Binnensingel Westkant
665,Uitbreidingstraat 390,2022-12-22,07:00:00,150,27,123,FMN 18 Binnensingel Westkant
665,Uitbreidingstraat 390,2022-12-22,08:00:00,295,76,219,FMN 18 Binnensingel Westkant
665,Uitbreidingstraat 390,2022-12-22,09:00:00,138,20,118,FMN 18 Binnensingel Westkant
665,Uitbreidingstraat 390,2022-12-22,10:00:00,96,22,74,FMN 18 Binnensingel Westkant
665,Uitbreidingstraat 390,2022-12-22,11:00:00,71,23,48,FMN 18 Binnensingel Westkant
665,Uitbreidingstraat 390,2022-12-22,12:00:00,119,36,83,FMN 18 Binnensingel Westkant
665,Uitbreidingstraat 390,2022-12-22,13:00:00,128,29,99,FMN 18 Binnensingel Westkant
665,Uitbreidingstraat 390,2022-12-22,14:00:00,69,28,41,FMN 18 Binnensingel Westkant
665,Uitbreidingstraat 390,2022-12-22,15:00:00,134,68,66,FMN 18 Binnensingel Westkant
665,Uitbreidingstraat 390,2022-12-22,16:00:00,156,73,83,FMN 18 Binnensingel Westkant
665,Uitbreidingstraat 390,2022-12-22,17:00:00,210,97,113,FMN 18 Binnensingel Westkant
665,Uitbreidingstraat 390,2022-12-22,18:00:00,205,67,138,FMN 18 Binnensingel Westkant
665,Uitbreidingstraat 390,2022-12-22,19:00:00,179,88,91,FMN 18 Binnensingel Westkant
665,Uitbreidingstraat 390,2022-12-22,20:00:00,97,54,43,FMN 18 Binnensingel Westkant
665,Uitbreidingstraat 390,2022-12-22,21:00:00,65,28,37,FMN 18 Binnensingel Westkant
665,Uitbreidingstraat 390,2022-12-22,22:00:00,71,15,56,FMN 18 Binnensingel Westkant
665,Uitbreidingstraat 390,2022-12-22,23:00:00,57,12,45,FMN 18 Binnensingel Westkant
665,Uitbreidingstraat 390,2022-12-23,00:00:00,28,5,23,FMN 18 Binnensingel Westkant
665,Uitbreidingstraat 390,2022-12-23,01:00:00,14,2,12,FMN 18 Binnensingel Westkant
665,Uitbreidingstraat 390,2022-12-23,02:00:00,11,6,5,FMN 18 Binnensingel Westkant
665,Uitbreidingstraat 390,2022-12-23,03:00:00,8,0,8,FMN 18 Binnensingel Westkant
665,Uitbreidingstraat 390,2022-12-23,04:00:00,4,0,4,FMN 18 Binnensingel Westkant
665,Uitbreidingstraat 390,2022-12-23,05:00:00,26,5,21,FMN 18 Binnensingel Westkant
665,Uitbreidingstraat 390,2022-12-23,06:00:00,37,6,31,FMN 18 Binnensingel Westkant
665,Uitbreidingstraat 390,2022-12-23,07:00:00,97,19,78,FMN 18 Binnensingel Westkant
665,Uitbreidingstraat 390,2022-12-23,08:00:00,267,48,219,FMN 18 Binnensingel Westkant
665,Uitbreidingstraat 390,2022-12-23,09:00:00,139,25,114,FMN 18 Binnensingel Westkant
665,Uitbreidingstraat 390,2022-12-23,10:00:00,183,104,79,FMN 18 Binnensingel Westkant
665,Uitbreidingstraat 390,2022-12-23,11:00:00,104,57,47,FMN 18 Binnensingel Westkant
665,Uitbreidingstraat 390,2022-12-23,12:00:00,74,31,43,FMN 18 Binnensingel Westkant
665,Uitbreidingstraat 390,2022-12-23,13:00:00,87,31,56,FMN 18 Binnensingel Westkant
665,Uitbreidingstraat 390,2022-12-23,14:00:00,71,23,48,FMN 18 Binnensingel Westkant
665,Uitbreidingstraat 390,2022-12-23,15:00:00,137,71,66,FMN 18 Binnensingel Westkant
665,Uitbreidingstraat 390,2022-12-23,16:00:00,130,50,80,FMN 18 Binnensingel Westkant
665,Uitbreidingstraat 390,2022-12-23,17:00:00,134,54,80,FMN 18 Binnensingel Westkant
665,Uitbreidingstraat 390,2022-12-23,18:00:00,108,47,61,FMN 18 Binnensingel Westkant
665,Uitbreidingstraat 390,2022-12-23,19:00:00,67,18,49,FMN 18 Binnensingel Westkant
665,Uitbreidingstraat 390,2022-12-23,20:00:00,50,21,29,FMN 18 Binnensingel Westkant
665,Uitbreidingstraat 390,2022-12-23,21:00:00,38,14,24,FMN 18 Binnensingel Westkant
665,Uitbreidingstraat 390,2022-12-23,22:00:00,37,12,25,FMN 18 Binnensingel Westkant
665,Uitbreidingstraat 390,2022-12-23,23:00:00,37,7,30,FMN 18 Binnensingel Westkant
665,Uitbreidingstraat 390,2022-12-24,00:00:00,38,10,28,FMN 18 Binnensingel Westkant
665,Uitbreidingstraat 390,2022-12-24,01:00:00,27,4,23,FMN 18 Binnensingel Westkant
665,Uitbreidingstraat 390,2022-12-24,02:00:00,18,4,14,FMN 18 Binnensingel Westkant
665,Uitbreidingstraat 390,2022-12-24,03:00:00,14,3,11,FMN 18 Binnensingel Westkant
665,Uitbreidingstraat 390,2022-12-24,04:00:00,7,2,5,FMN 18 Binnensingel Westkant
665,Uitbreidingstraat 390,2022-12-24,05:00:00,16,3,13,FMN 18 Binnensingel Westkant
665,Uitbreidingstraat 390,2022-12-24,06:00:00,14,2,12,FMN 18 Binnensingel Westkant
665,Uitbreidingstraat 390,2022-12-24,07:00:00,14,1,13,FMN 18 Binnensingel Westkant
665,Uitbreidingstraat 390,2022-12-24,08:00:00,25,4,21,FMN 18 Binnensingel Westkant
665,Uitbreidingstraat 390,2022-12-24,09:00:00,51,17,34,FMN 18 Binnensingel Westkant
665,Uitbreidingstraat 390,2022-12-24,10:00:00,65,26,39,FMN 18 Binnensingel Westkant
665,Uitbreidingstraat 390,2022-12-24,11:00:00,69,26,43,FMN 18 Binnensingel Westkant
665,Uitbreidingstraat 390,2022-12-24,12:00:00,80,30,50,FMN 18 Binnensingel Westkant
665,Uitbreidingstraat 390,2022-12-24,13:00:00,57,17,40,FMN 18 Binnensingel Westkant
665,Uitbreidingstraat 390,2022-12-24,14:00:00,54,20,34,FMN 18 Binnensingel Westkant
665,Uitbreidingstraat 390,2022-12-24,15:00:00,52,16,36,FMN 18 Binnensingel Westkant
665,Uitbreidingstraat 390,2022-12-24,16:00:00,41,11,30,FMN 18 Binnensingel Westkant
665,Uitbreidingstraat 390,2022-12-24,17:00:00,43,11,32,FMN 18 Binnensingel Westkant
665,Uitbreidingstraat 390,2022-12-24,18:00:00,38,13,25,FMN 18 Binnensingel Westkant
665,Uitbreidingstraat 390,2022-12-24,19:00:00,25,6,19,FMN 18 Binnensingel Westkant
665,Uitbreidingstraat 390,2022-12-24,20:00:00,26,9,17,FMN 18 Binnensingel Westkant
665,Uitbreidingstraat 390,2022-12-24,21:00:00,13,2,11,FMN 18 Binnensingel Westkant
665,Uitbreidingstraat 390,2022-12-24,22:00:00,25,4,21,FMN 18 Binnensingel Westkant
665,Uitbreidingstraat 390,2022-12-24,23:00:00,28,8,20,FMN 18 Binnensingel Westkant
665,Uitbreidingstraat 390,2022-12-25,00:00:00,9,3,6,FMN 18 Binnensingel Westkant
665,Uitbreidingstraat 390,2022-12-25,01:00:00,11,5,6,FMN 18 Binnensingel Westkant
665,Uitbreidingstraat 390,2022-12-25,02:00:00,13,4,9,FMN 18 Binnensingel Westkant
665,Uitbreidingstraat 390,2022-12-25,03:00:00,10,0,10,FMN 18 Binnensingel Westkant
665,Uitbreidingstraat 390,2022-12-25,04:00:00,6,2,4,FMN 18 Binnensingel Westkant
665,Uitbreidingstraat 390,2022-12-25,05:00:00,3,1,2,FMN 18 Binnensingel Westkant
665,Uitbreidingstraat 390,2022-12-25,06:00:00,12,3,9,FMN 18 Binnensingel Westkant
665,Uitbreidingstraat 390,2022-12-25,07:00:00,5,4,1,FMN 18 Binnensingel Westkant
665,Uitbreidingstraat 390,2022-12-25,08:00:00,10,2,8,FMN 18 Binnensingel Westkant
665,Uitbreidingstraat 390,2022-12-25,09:00:00,10,7,3,FMN 18 Binnensingel Westkant
665,Uitbreidingstraat 390,2022-12-25,10:00:00,9,4,5,FMN 18 Binnensingel Westkant
665,Uitbreidingstraat 390,2022-12-25,11:00:00,15,5,10,FMN 18 Binnensingel Westkant
665,Uitbreidingstraat 390,2022-12-25,12:00:00,13,5,8,FMN 18 Binnensingel Westkant
665,Uitbreidingstraat 390,2022-12-25,13:00:00,18,8,10,FMN 18 Binnensingel Westkant
665,Uitbreidingstraat 390,2022-12-25,14:00:00,32,6,26,FMN 18 Binnensingel Westkant
665,Uitbreidingstraat 390,2022-12-25,15:00:00,19,11,8,FMN 18 Binnensingel Westkant
665,Uitbreidingstraat 390,2022-12-25,16:00:00,19,5,14,FMN 18 Binnensingel Westkant
665,Uitbreidingstraat 390,2022-12-25,17:00:00,16,4,12,FMN 18 Binnensingel Westkant
665,Uitbreidingstraat 390,2022-12-25,18:00:00,21,5,16,FMN 18 Binnensingel Westkant
665,Uitbreidingstraat 390,2022-12-25,19:00:00,28,2,26,FMN 18 Binnensingel Westkant
665,Uitbreidingstraat 390,2022-12-25,20:00:00,21,6,15,FMN 18 Binnensingel Westkant
665,Uitbreidingstraat 390,2022-12-25,21:00:00,16,2,14,FMN 18 Binnensingel Westkant
665,Uitbreidingstraat 390,2022-12-25,22:00:00,13,3,10,FMN 18 Binnensingel Westkant
665,Uitbreidingstraat 390,2022-12-25,23:00:00,12,3,9,FMN 18 Binnensingel Westkant
665,Uitbreidingstraat 390,2022-12-26,00:00:00,6,1,5,FMN 18 Binnensingel Westkant
665,Uitbreidingstraat 390,2022-12-26,01:00:00,7,0,7,FMN 18 Binnensingel Westkant
665,Uitbreidingstraat 390,2022-12-26,02:00:00,4,2,2,FMN 18 Binnensingel Westkant
665,Uitbreidingstraat 390,2022-12-26,03:00:00,2,0,2,FMN 18 Binnensingel Westkant
665,Uitbreidingstraat 390,2022-12-26,04:00:00,8,3,5,FMN 18 Binnensingel Westkant
665,Uitbreidingstraat 390,2022-12-26,05:00:00,19,3,16,FMN 18 Binnensingel Westkant
665,Uitbreidingstraat 390,2022-12-26,06:00:00,29,5,24,FMN 18 Binnensingel Westkant
665,Uitbreidingstraat 390,2022-12-26,07:00:00,48,6,42,FMN 18 Binnensingel Westkant
665,Uitbreidingstraat 390,2022-12-26,08:00:00,62,14,48,FMN 18 Binnensingel Westkant
665,Uitbreidingstraat 390,2022-12-26,09:00:00,28,8,20,FMN 18 Binnensingel Westkant
665,Uitbreidingstraat 390,2022-12-26,10:00:00,31,14,17,FMN 18 Binnensingel Westkant
665,Uitbreidingstraat 390,2022-12-26,11:00:00,31,9,22,FMN 18 Binnensingel Westkant
665,Uitbreidingstraat 390,2022-12-26,12:00:00,34,11,23,FMN 18 Binnensingel Westkant
665,Uitbreidingstraat 390,2022-12-26,13:00:00,69,20,49,FMN 18 Binnensingel Westkant
665,Uitbreidingstraat 390,2022-12-26,14:00:00,60,29,31,FMN 18 Binnensingel Westkant
665,Uitbreidingstraat 390,2022-12-26,15:00:00,68,35,33,FMN 18 Binnensingel Westkant
665,Uitbreidingstraat 390,2022-12-26,16:00:00,70,27,43,FMN 18 Binnensingel Westkant
665,Uitbreidingstraat 390,2022-12-26,17:00:00,71,16,55,FMN 18 Binnensingel Westkant
665,Uitbreidingstraat 390,2022-12-26,18:00:00,48,16,32,FMN 18 Binnensingel Westkant
665,Uitbreidingstraat 390,2022-12-26,19:00:00,39,15,24,FMN 18 Binnensingel Westkant
665,Uitbreidingstraat 390,2022-12-26,20:00:00,55,25,30,FMN 18 Binnensingel Westkant
665,Uitbreidingstraat 390,2022-12-26,21:00:00,28,9,19,FMN 18 Binnensingel Westkant
665,Uitbreidingstraat 390,2022-12-26,22:00:00,47,11,36,FMN 18 Binnensingel Westkant
665,Uitbreidingstraat 390,2022-12-26,23:00:00,18,1,17,FMN 18 Binnensingel Westkant
665,Uitbreidingstraat 390,2022-12-27,00:00:00,15,1,14,FMN 18 Binnensingel Westkant
665,Uitbreidingstraat 390,2022-12-27,01:00:00,6,0,6,FMN 18 Binnensingel Westkant
665,Uitbreidingstraat 390,2022-12-27,02:00:00,2,0,2,FMN 18 Binnensingel Westkant
665,Uitbreidingstraat 390,2022-12-27,03:00:00,8,0,8,FMN 18 Binnensingel Westkant
665,Uitbreidingstraat 390,2022-12-27,04:00:00,7,1,6,FMN 18 Binnensingel Westkant
665,Uitbreidingstraat 390,2022-12-27,05:00:00,20,3,17,FMN 18 Binnensingel Westkant
665,Uitbreidingstraat 390,2022-12-27,06:00:00,42,5,37,FMN 18 Binnensingel Westkant
665,Uitbreidingstraat 390,2022-12-27,07:00:00,75,16,59,FMN 18 Binnensingel Westkant
665,Uitbreidingstraat 390,2022-12-27,08:00:00,74,16,58,FMN 18 Binnensingel Westkant
665,Uitbreidingstraat 390,2022-12-27,09:00:00,45,6,39,FMN 18 Binnensingel Westkant
665,Uitbreidingstraat 390,2022-12-27,10:00:00,37,16,21,FMN 18 Binnensingel Westkant
665,Uitbreidingstraat 390,2022-12-27,11:00:00,61,18,43,FMN 18 Binnensingel Westkant
665,Uitbreidingstraat 390,2022-12-27,12:00:00,76,21,55,FMN 18 Binnensingel Westkant
665,Uitbreidingstraat 390,2022-12-27,13:00:00,71,26,45,FMN 18 Binnensingel Westkant
665,Uitbreidingstraat 390,2022-12-27,14:00:00,75,22,53,FMN 18 Binnensingel Westkant
665,Uitbreidingstraat 390,2022-12-27,15:00:00,89,37,52,FMN 18 Binnensingel Westkant
665,Uitbreidingstraat 390,2022-12-27,16:00:00,105,42,63,FMN 18 Binnensingel Westkant
665,Uitbreidingstraat 390,2022-12-27,17:00:00,116,43,73,FMN 18 Binnensingel Westkant
665,Uitbreidingstraat 390,2022-12-27,18:00:00,83,32,51,FMN 18 Binnensingel Westkant
665,Uitbreidingstraat 390,2022-12-27,19:00:00,74,23,51,FMN 18 Binnensingel Westkant
665,Uitbreidingstraat 390,2022-12-27,20:00:00,37,15,22,FMN 18 Binnensingel Westkant
665,Uitbreidingstraat 390,2022-12-27,21:00:00,46,17,29,FMN 18 Binnensingel Westkant
665,Uitbreidingstraat 390,2022-12-27,22:00:00,41,12,29,FMN 18 Binnensingel Westkant
665,Uitbreidingstraat 390,2022-12-27,23:00:00,33,11,22,FMN 18 Binnensingel Westkant
665,Uitbreidingstraat 390,2022-12-28,00:00:00,14,2,12,FMN 18 Binnensingel Westkant
665,Uitbreidingstraat 390,2022-12-28,01:00:00,8,1,7,FMN 18 Binnensingel Westkant
665,Uitbreidingstraat 390,2022-12-28,02:00:00,4,1,3,FMN 18 Binnensingel Westkant
665,Uitbreidingstraat 390,2022-12-28,03:00:00,13,2,11,FMN 18 Binnensingel Westkant
665,Uitbreidingstraat 390,2022-12-28,04:00:00,5,2,3,FMN 18 Binnensingel Westkant
665,Uitbreidingstraat 390,2022-12-28,05:00:00,17,1,16,FMN 18 Binnensingel Westkant
665,Uitbreidingstraat 390,2022-12-28,06:00:00,32,1,31,FMN 18 Binnensingel Westkant
665,Uitbreidingstraat 390,2022-12-28,07:00:00,71,6,65,FMN 18 Binnensingel Westkant
665,Uitbreidingstraat 390,2022-12-28,08:00:00,96,25,71,FMN 18 Binnensingel Westkant
665,Uitbreidingstraat 390,2022-12-28,09:00:00,64,12,52,FMN 18 Binnensingel Westkant
665,Uitbreidingstraat 390,2022-12-28,10:00:00,40,14,26,FMN 18 Binnensingel Westkant
665,Uitbreidingstraat 390,2022-12-28,11:00:00,53,19,34,FMN 18 Binnensingel Westkant
665,Uitbreidingstraat 390,2022-12-28,12:00:00,52,19,33,FMN 18 Binnensingel Westkant
665,Uitbreidingstraat 390,2022-12-28,13:00:00,65,18,47,FMN 18 Binnensingel Westkant
665,Uitbreidingstraat 390,2022-12-28,14:00:00,70,21,49,FMN 18 Binnensingel Westkant
665,Uitbreidingstraat 390,2022-12-28,15:00:00,74,38,36,FMN 18 Binnensingel Westkant
665,Uitbreidingstraat 390,2022-12-28,16:00:00,84,38,46,FMN 18 Binnensingel Westkant
665,Uitbreidingstraat 390,2022-12-28,17:00:00,107,42,65,FMN 18 Binnensingel Westkant
665,Uitbreidingstraat 390,2022-12-28,18:00:00,73,24,49,FMN 18 Binnensingel Westkant
665,Uitbreidingstraat 390,2022-12-28,19:00:00,58,13,45,FMN 18 Binnensingel Westkant
665,Uitbreidingstraat 390,2022-12-28,20:00:00,31,11,20,FMN 18 Binnensingel Westkant
665,Uitbreidingstraat 390,2022-12-28,21:00:00,27,12,15,FMN 18 Binnensingel Westkant
665,Uitbreidingstraat 390,2022-12-28,22:00:00,27,5,22,FMN 18 Binnensingel Westkant
665,Uitbreidingstraat 390,2022-12-28,23:00:00,37,9,28,FMN 18 Binnensingel Westkant
665,Uitbreidingstraat 390,2022-12-29,00:00:00,26,8,18,FMN 18 Binnensingel Westkant
665,Uitbreidingstraat 390,2022-12-29,01:00:00,15,1,14,FMN 18 Binnensingel Westkant
665,Uitbreidingstraat 390,2022-12-29,02:00:00,7,0,7,FMN 18 Binnensingel Westkant
665,Uitbreidingstraat 390,2022-12-29,03:00:00,6,2,4,FMN 18 Binnensingel Westkant
665,Uitbreidingstraat 390,2022-12-29,04:00:00,4,2,2,FMN 18 Binnensingel Westkant
665,Uitbreidingstraat 390,2022-12-29,05:00:00,22,4,18,FMN 18 Binnensingel Westkant
665,Uitbreidingstraat 390,2022-12-29,06:00:00,27,3,24,FMN 18 Binnensingel Westkant
665,Uitbreidingstraat 390,2022-12-29,07:00:00,56,9,47,FMN 18 Binnensingel Westkant
665,Uitbreidingstraat 390,2022-12-29,08:00:00,78,16,62,FMN 18 Binnensingel Westkant
665,Uitbreidingstraat 390,2022-12-29,09:00:00,64,17,47,FMN 18 Binnensingel Westkant
665,Uitbreidingstraat 390,2022-12-29,10:00:00,43,4,39,FMN 18 Binnensingel Westkant
665,Uitbreidingstraat 390,2022-12-29,11:00:00,48,16,32,FMN 18 Binnensingel Westkant
665,Uitbreidingstraat 390,2022-12-29,12:00:00,68,25,43,FMN 18 Binnensingel Westkant
665,Uitbreidingstraat 390,2022-12-29,13:00:00,41,13,28,FMN 18 Binnensingel Westkant
665,Uitbreidingstraat 390,2022-12-29,14:00:00,53,18,35,FMN 18 Binnensingel Westkant
665,Uitbreidingstraat 390,2022-12-29,15:00:00,64,31,33,FMN 18 Binnensingel Westkant
665,Uitbreidingstraat 390,2022-12-29,16:00:00,67,25,42,FMN 18 Binnensingel Westkant
665,Uitbreidingstraat 390,2022-12-29,17:00:00,117,49,68,FMN 18 Binnensingel Westkant
665,Uitbreidingstraat 390,2022-12-29,18:00:00,108,36,72,FMN 18 Binnensingel Westkant
665,Uitbreidingstraat 390,2022-12-29,19:00:00,62,21,41,FMN 18 Binnensingel Westkant
665,Uitbreidingstraat 390,2022-12-29,20:00:00,50,15,35,FMN 18 Binnensingel Westkant
665,Uitbreidingstraat 390,2022-12-29,21:00:00,42,18,24,FMN 18 Binnensingel Westkant
665,Uitbreidingstraat 390,2022-12-29,22:00:00,35,13,22,FMN 18 Binnensingel Westkant
665,Uitbreidingstraat 390,2022-12-29,23:00:00,30,4,26,FMN 18 Binnensingel Westkant
665,Uitbreidingstraat 390,2022-12-30,00:00:00,24,7,17,FMN 18 Binnensingel Westkant
665,Uitbreidingstraat 390,2022-12-30,01:00:00,20,6,14,FMN 18 Binnensingel Westkant
665,Uitbreidingstraat 390,2022-12-30,02:00:00,10,4,6,FMN 18 Binnensingel Westkant
665,Uitbreidingstraat 390,2022-12-30,03:00:00,6,0,6,FMN 18 Binnensingel Westkant
665,Uitbreidingstraat 390,2022-12-30,04:00:00,5,2,3,FMN 18 Binnensingel Westkant
665,Uitbreidingstraat 390,2022-12-30,05:00:00,17,5,12,FMN 18 Binnensingel Westkant
665,Uitbreidingstraat 390,2022-12-30,06:00:00,27,5,22,FMN 18 Binnensingel Westkant
665,Uitbreidingstraat 390,2022-12-30,07:00:00,38,6,32,FMN 18 Binnensingel Westkant
665,Uitbreidingstraat 390,2022-12-30,08:00:00,60,19,41,FMN 18 Binnensingel Westkant
665,Uitbreidingstraat 390,2022-12-30,09:00:00,59,19,40,FMN 18 Binnensingel Westkant
665,Uitbreidingstraat 390,2022-12-30,10:00:00,58,10,48,FMN 18 Binnensingel Westkant
665,Uitbreidingstraat 390,2022-12-30,11:00:00,56,22,34,FMN 18 Binnensingel Westkant
665,Uitbreidingstraat 390,2022-12-30,12:00:00,59,21,38,FMN 18 Binnensingel Westkant
665,Uitbreidingstraat 390,2022-12-30,13:00:00,46,18,28,FMN 18 Binnensingel Westkant
665,Uitbreidingstraat 390,2022-12-30,14:00:00,50,12,38,FMN 18 Binnensingel Westkant
665,Uitbreidingstraat 390,2022-12-30,15:00:00,57,20,37,FMN 18 Binnensingel Westkant
665,Uitbreidingstraat 390,2022-12-30,16:00:00,61,23,38,FMN 18 Binnensingel Westkant
665,Uitbreidingstraat 390,2022-12-30,17:00:00,82,34,48,FMN 18 Binnensingel Westkant
665,Uitbreidingstraat 390,2022-12-30,18:00:00,63,10,53,FMN 18 Binnensingel Westkant
665,Uitbreidingstraat 390,2022-12-30,19:00:00,57,19,38,FMN 18 Binnensingel Westkant
665,Uitbreidingstraat 390,2022-12-30,20:00:00,46,8,38,FMN 18 Binnensingel Westkant
665,Uitbreidingstraat 390,2022-12-30,21:00:00,31,4,27,FMN 18 Binnensingel Westkant
665,Uitbreidingstraat 390,2022-12-30,22:00:00,42,13,29,FMN 18 Binnensingel Westkant
665,Uitbreidingstraat 390,2022-12-30,23:00:00,29,7,22,FMN 18 Binnensingel Westkant
665,Uitbreidingstraat 390,2022-12-31,00:00:00,15,3,12,FMN 18 Binnensingel Westkant
665,Uitbreidingstraat 390,2022-12-31,01:00:00,13,3,10,FMN 18 Binnensingel Westkant
665,Uitbreidingstraat 390,2022-12-31,02:00:00,3,2,1,FMN 18 Binnensingel Westkant
665,Uitbreidingstraat 390,2022-12-31,03:00:00,1,0,1,FMN 18 Binnensingel Westkant
665,Uitbreidingstraat 390,2022-12-31,04:00:00,5,1,4,FMN 18 Binnensingel Westkant
665,Uitbreidingstraat 390,2022-12-31,05:00:00,10,3,7,FMN 18 Binnensingel Westkant
665,Uitbreidingstraat 390,2022-12-31,06:00:00,14,3,11,FMN 18 Binnensingel Westkant
665,Uitbreidingstraat 390,2022-12-31,07:00:00,3,1,2,FMN 18 Binnensingel Westkant
665,Uitbreidingstraat 390,2022-12-31,08:00:00,10,2,8,FMN 18 Binnensingel Westkant
665,Uitbreidingstraat 390,2022-12-31,09:00:00,18,6,12,FMN 18 Binnensingel Westkant
665,Uitbreidingstraat 390,2022-12-31,10:00:00,35,13,22,FMN 18 Binnensingel Westkant
665,Uitbreidingstraat 390,2022-12-31,11:00:00,52,16,36,FMN 18 Binnensingel Westkant
665,Uitbreidingstraat 390,2022-12-31,12:00:00,42,18,24,FMN 18 Binnensingel Westkant
665,Uitbreidingstraat 390,2022-12-31,13:00:00,49,19,30,FMN 18 Binnensingel Westkant
665,Uitbreidingstraat 390,2022-12-31,14:00:00,32,11,21,FMN 18 Binnensingel Westkant
665,Uitbreidingstraat 390,2022-12-31,15:00:00,53,14,39,FMN 18 Binnensingel Westkant
665,Uitbreidingstraat 390,2022-12-31,16:00:00,57,20,37,FMN 18 Binnensingel Westkant
665,Uitbreidingstraat 390,2022-12-31,17:00:00,99,42,57,FMN 18 Binnensingel Westkant
665,Uitbreidingstraat 390,2022-12-31,18:00:00,99,27,72,FMN 18 Binnensingel Westkant
665,Uitbreidingstraat 390,2022-12-31,19:00:00,63,12,51,FMN 18 Binnensingel Westkant
665,Uitbreidingstraat 390,2022-12-31,20:00:00,30,5,25,FMN 18 Binnensingel Westkant
665,Uitbreidingstraat 390,2022-12-31,21:00:00,27,8,19,FMN 18 Binnensingel Westkant
665,Uitbreidingstraat 390,2022-12-31,22:00:00,30,8,22,FMN 18 Binnensingel Westkant
665,Uitbreidingstraat 390,2022-12-31,23:00:00,49,11,38,FMN 18 Binnensingel Westkant
665,Uitbreidingstraat 390,2023-01-01,00:00:00,22,8,14,FMN 18 Binnensingel Westkant
665,Uitbreidingstraat 390,2023-01-01,01:00:00,70,26,44,FMN 18 Binnensingel Westkant
665,Uitbreidingstraat 390,2023-01-01,02:00:00,81,18,63,FMN 18 Binnensingel Westkant
665,Uitbreidingstraat 390,2023-01-01,03:00:00,65,15,50,FMN 18 Binnensingel Westkant
665,Uitbreidingstraat 390,2023-01-01,04:00:00,68,11,57,FMN 18 Binnensingel Westkant
665,Uitbreidingstraat 390,2023-01-01,05:00:00,26,5,21,FMN 18 Binnensingel Westkant
665,Uitbreidingstraat 390,2023-01-01,06:00:00,45,8,37,FMN 18 Binnensingel Westkant
665,Uitbreidingstraat 390,2023-01-01,07:00:00,23,4,19,FMN 18 Binnensingel Westkant
665,Uitbreidingstraat 390,2023-01-01,08:00:00,15,0,15,FMN 18 Binnensingel Westkant
665,Uitbreidingstraat 390,2023-01-01,09:00:00,9,1,8,FMN 18 Binnensingel Westkant
665,Uitbreidingstraat 390,2023-01-01,10:00:00,13,5,8,FMN 18 Binnensingel Westkant
665,Uitbreidingstraat 390,2023-01-01,11:00:00,17,6,11,FMN 18 Binnensingel Westkant
665,Uitbreidingstraat 390,2023-01-01,12:00:00,27,4,23,FMN 18 Binnensingel Westkant
665,Uitbreidingstraat 390,2023-01-01,13:00:00,45,7,38,FMN 18 Binnensingel Westkant
665,Uitbreidingstraat 390,2023-01-01,14:00:00,49,17,32,FMN 18 Binnensingel Westkant
665,Uitbreidingstraat 390,2023-01-01,15:00:00,39,13,26,FMN 18 Binnensingel Westkant
665,Uitbreidingstraat 390,2023-01-01,16:00:00,37,10,27,FMN 18 Binnensingel Westkant
665,Uitbreidingstraat 390,2023-01-01,17:00:00,29,8,21,FMN 18 Binnensingel Westkant
665,Uitbreidingstraat 390,2023-01-01,18:00:00,29,10,19,FMN 18 Binnensingel Westkant
665,Uitbreidingstraat 390,2023-01-01,19:00:00,29,7,22,FMN 18 Binnensingel Westkant
665,Uitbreidingstraat 390,2023-01-01,20:00:00,31,5,26,FMN 18 Binnensingel Westkant
665,Uitbreidingstraat 390,2023-01-01,21:00:00,23,6,17,FMN 18 Binnensingel Westkant
665,Uitbreidingstraat 390,2023-01-01,22:00:00,15,8,7,FMN 18 Binnensingel Westkant
665,Uitbreidingstraat 390,2023-01-01,23:00:00,10,2,8,FMN 18 Binnensingel Westkant
665,Uitbreidingstraat 390,2023-01-02,00:00:00,3,1,2,FMN 18 Binnensingel Westkant
665,Uitbreidingstraat 390,2023-01-02,01:00:00,1,1,0,FMN 18 Binnensingel Westkant
665,Uitbreidingstraat 390,2023-01-02,02:00:00,3,0,3,FMN 18 Binnensingel Westkant
665,Uitbreidingstraat 390,2023-01-02,03:00:00,3,0,3,FMN 18 Binnensingel Westkant
665,Uitbreidingstraat 390,2023-01-02,04:00:00,6,2,4,FMN 18 Binnensingel Westkant
665,Uitbreidingstraat 390,2023-01-02,05:00:00,9,2,7,FMN 18 Binnensingel Westkant
665,Uitbreidingstraat 390,2023-01-02,06:00:00,43,5,38,FMN 18 Binnensingel Westkant
665,Uitbreidingstraat 390,2023-01-02,07:00:00,56,4,52,FMN 18 Binnensingel Westkant
665,Uitbreidingstraat 390,2023-01-02,08:00:00,107,17,90,FMN 18 Binnensingel Westkant
665,Uitbreidingstraat 390,2023-01-02,09:00:00,42,15,27,FMN 18 Binnensingel Westkant
665,Uitbreidingstraat 390,2023-01-02,10:00:00,55,20,35,FMN 18 Binnensingel Westkant
665,Uitbreidingstraat 390,2023-01-02,11:00:00,32,11,21,FMN 18 Binnensingel Westkant
665,Uitbreidingstraat 390,2023-01-02,12:00:00,56,18,38,FMN 18 Binnensingel Westkant
665,Uitbreidingstraat 390,2023-01-02,13:00:00,57,9,48,FMN 18 Binnensingel Westkant
665,Uitbreidingstraat 390,2023-01-02,14:00:00,55,22,33,FMN 18 Binnensingel Westkant
665,Uitbreidingstraat 390,2023-01-02,15:00:00,73,24,49,FMN 18 Binnensingel Westkant
665,Uitbreidingstraat 390,2023-01-02,16:00:00,98,54,44,FMN 18 Binnensingel Westkant
665,Uitbreidingstraat 390,2023-01-02,17:00:00,98,40,58,FMN 18 Binnensingel Westkant
665,Uitbreidingstraat 390,2023-01-02,18:00:00,70,24,46,FMN 18 Binnensingel Westkant
665,Uitbreidingstraat 390,2023-01-02,19:00:00,48,16,32,FMN 18 Binnensingel Westkant
665,Uitbreidingstraat 390,2023-01-02,20:00:00,34,9,25,FMN 18 Binnensingel Westkant
665,Uitbreidingstraat 390,2023-01-02,21:00:00,25,9,16,FMN 18 Binnensingel Westkant
665,Uitbreidingstraat 390,2023-01-02,22:00:00,20,9,11,FMN 18 Binnensingel Westkant
665,Uitbreidingstraat 390,2023-01-02,23:00:00,16,4,12,FMN 18 Binnensingel Westkant
665,Uitbreidingstraat 390,2023-01-03,00:00:00,3,1,2,FMN 18 Binnensingel Westkant
665,Uitbreidingstraat 390,2023-01-03,01:00:00,7,1,6,FMN 18 Binnensingel Westkant
665,Uitbreidingstraat 390,2023-01-03,02:00:00,3,0,3,FMN 18 Binnensingel Westkant
665,Uitbreidingstraat 390,2023-01-03,03:00:00,6,0,6,FMN 18 Binnensingel Westkant
665,Uitbreidingstraat 390,2023-01-03,04:00:00,7,1,6,FMN 18 Binnensingel Westkant
665,Uitbreidingstraat 390,2023-01-03,05:00:00,21,3,18,FMN 18 Binnensingel Westkant
665,Uitbreidingstraat 390,2023-01-03,06:00:00,49,8,41,FMN 18 Binnensingel Westkant
665,Uitbreidingstraat 390,2023-01-03,07:00:00,127,26,101,FMN 18 Binnensingel Westkant
665,Uitbreidingstraat 390,2023-01-03,08:00:00,192,29,163,FMN 18 Binnensingel Westkant
665,Uitbreidingstraat 390,2023-01-03,09:00:00,99,33,66,FMN 18 Binnensingel Westkant
665,Uitbreidingstraat 390,2023-01-03,10:00:00,60,19,41,FMN 18 Binnensingel Westkant
665,Uitbreidingstraat 390,2023-01-03,11:00:00,55,17,38,FMN 18 Binnensingel Westkant
665,Uitbreidingstraat 390,2023-01-03,12:00:00,64,26,38,FMN 18 Binnensingel Westkant
665,Uitbreidingstraat 390,2023-01-03,13:00:00,62,24,38,FMN 18 Binnensingel Westkant
665,Uitbreidingstraat 390,2023-01-03,14:00:00,72,21,51,FMN 18 Binnensingel Westkant
665,Uitbreidingstraat 390,2023-01-03,15:00:00,85,35,50,FMN 18 Binnensingel Westkant
665,Uitbreidingstraat 390,2023-01-03,16:00:00,149,69,80,FMN 18 Binnensingel Westkant
665,Uitbreidingstraat 390,2023-01-03,17:00:00,182,74,108,FMN 18 Binnensingel Westkant
665,Uitbreidingstraat 390,2023-01-03,18:00:00,141,42,99,FMN 18 Binnensingel Westkant
665,Uitbreidingstraat 390,2023-01-03,19:00:00,85,26,59,FMN 18 Binnensingel Westkant
665,Uitbreidingstraat 390,2023-01-03,20:00:00,72,18,54,FMN 18 Binnensingel Westkant
665,Uitbreidingstraat 390,2023-01-03,21:00:00,43,15,28,FMN 18 Binnensingel Westkant
665,Uitbreidingstraat 390,2023-01-03,22:00:00,28,16,12,FMN 18 Binnensingel Westkant
665,Uitbreidingstraat 390,2023-01-03,23:00:00,27,3,24,FMN 18 Binnensingel Westkant
665,Uitbreidingstraat 390,2023-01-04,00:00:00,16,6,10,FMN 18 Binnensingel Westkant
665,Uitbreidingstraat 390,2023-01-04,01:00:00,11,3,8,FMN 18 Binnensingel Westkant
665,Uitbreidingstraat 390,2023-01-04,02:00:00,2,2,0,FMN 18 Binnensingel Westkant
665,Uitbreidingstraat 390,2023-01-04,03:00:00,4,1,3,FMN 18 Binnensingel Westkant
665,Uitbreidingstraat 390,2023-01-04,04:00:00,7,2,5,FMN 18 Binnensingel Westkant
665,Uitbreidingstraat 390,2023-01-04,05:00:00,16,3,13,FMN 18 Binnensingel Westkant
665,Uitbreidingstraat 390,2023-01-04,06:00:00,40,6,34,FMN 18 Binnensingel Westkant
665,Uitbreidingstraat 390,2023-01-04,07:00:00,93,26,67,FMN 18 Binnensingel Westkant
665,Uitbreidingstraat 390,2023-01-04,08:00:00,147,32,115,FMN 18 Binnensingel Westkant
665,Uitbreidingstraat 390,2023-01-04,09:00:00,75,19,56,FMN 18 Binnensingel Westkant
665,Uitbreidingstraat 390,2023-01-04,10:00:00,37,9,28,FMN 18 Binnensingel Westkant
665,Uitbreidingstraat 390,2023-01-04,11:00:00,39,8,31,FMN 18 Binnensingel Westkant
665,Uitbreidingstraat 390,2023-01-04,12:00:00,44,13,31,FMN 18 Binnensingel Westkant
665,Uitbreidingstraat 390,2023-01-04,13:00:00,54,10,44,FMN 18 Binnensingel Westkant
665,Uitbreidingstraat 390,2023-01-04,14:00:00,41,14,27,FMN 18 Binnensingel Westkant
665,Uitbreidingstraat 390,2023-01-04,15:00:00,72,34,38,FMN 18 Binnensingel Westkant
665,Uitbreidingstraat 390,2023-01-04,16:00:00,106,54,52,FMN 18 Binnensingel Westkant
665,Uitbreidingstraat 390,2023-01-04,17:00:00,170,76,94,FMN 18 Binnensingel Westkant
665,Uitbreidingstraat 390,2023-01-04,18:00:00,122,43,79,FMN 18 Binnensingel Westkant
665,Uitbreidingstraat 390,2023-01-04,19:00:00,71,24,47,FMN 18 Binnensingel Westkant
665,Uitbreidingstraat 390,2023-01-04,20:00:00,47,16,31,FMN 18 Binnensingel Westkant
665,Uitbreidingstraat 390,2023-01-04,21:00:00,28,17,11,FMN 18 Binnensingel Westkant
665,Uitbreidingstraat 390,2023-01-04,22:00:00,45,14,31,FMN 18 Binnensingel Westkant
665,Uitbreidingstraat 390,2023-01-04,23:00:00,31,8,23,FMN 18 Binnensingel Westkant
665,Uitbreidingstraat 390,2023-01-05,00:00:00,11,1,10,FMN 18 Binnensingel Westkant
665,Uitbreidingstraat 390,2023-01-05,01:00:00,6,2,4,FMN 18 Binnensingel Westkant
665,Uitbreidingstraat 390,2023-01-05,02:00:00,6,2,4,FMN 18 Binnensingel Westkant
665,Uitbreidingstraat 390,2023-01-05,03:00:00,5,0,5,FMN 18 Binnensingel Westkant
665,Uitbreidingstraat 390,2023-01-05,04:00:00,7,0,7,FMN 18 Binnensingel Westkant
665,Uitbreidingstraat 390,2023-01-05,05:00:00,20,3,17,FMN 18 Binnensingel Westkant
665,Uitbreidingstraat 390,2023-01-05,06:00:00,56,12,44,FMN 18 Binnensingel Westkant
665,Uitbreidingstraat 390,2023-01-05,07:00:00,112,21,91,FMN 18 Binnensingel Westkant
665,Uitbreidingstraat 390,2023-01-05,08:00:00,201,45,156,FMN 18 Binnensingel Westkant
665,Uitbreidingstraat 390,2023-01-05,09:00:00,95,24,71,FMN 18 Binnensingel Westkant
665,Uitbreidingstraat 390,2023-01-05,10:00:00,60,16,44,FMN 18 Binnensingel Westkant
665,Uitbreidingstraat 390,2023-01-05,11:00:00,57,25,32,FMN 18 Binnensingel Westkant
665,Uitbreidingstraat 390,2023-01-05,12:00:00,73,28,45,FMN 18 Binnensingel Westkant
665,Uitbreidingstraat 390,2023-01-05,13:00:00,68,35,33,FMN 18 Binnensingel Westkant
665,Uitbreidingstraat 390,2023-01-05,14:00:00,70,17,53,FMN 18 Binnensingel Westkant
665,Uitbreidingstraat 390,2023-01-05,15:00:00,78,25,53,FMN 18 Binnensingel Westkant
665,Uitbreidingstraat 390,2023-01-05,16:00:00,123,56,67,FMN 18 Binnensingel Westkant
665,Uitbreidingstraat 390,2023-01-05,17:00:00,183,80,103,FMN 18 Binnensingel Westkant
665,Uitbreidingstraat 390,2023-01-05,18:00:00,142,43,99,FMN 18 Binnensingel Westkant
665,Uitbreidingstraat 390,2023-01-05,19:00:00,84,24,60,FMN 18 Binnensingel Westkant
665,Uitbreidingstraat 390,2023-01-05,20:00:00,52,10,42,FMN 18 Binnensingel Westkant
665,Uitbreidingstraat 390,2023-01-05,21:00:00,44,18,26,FMN 18 Binnensingel Westkant
665,Uitbreidingstraat 390,2023-01-05,22:00:00,22,9,13,FMN 18 Binnensingel Westkant
665,Uitbreidingstraat 390,2023-01-05,23:00:00,32,7,25,FMN 18 Binnensingel Westkant
665,Uitbreidingstraat 390,2023-01-06,00:00:00,9,2,7,FMN 18 Binnensingel Westkant
665,Uitbreidingstraat 390,2023-01-06,01:00:00,9,1,8,FMN 18 Binnensingel Westkant
665,Uitbreidingstraat 390,2023-01-06,02:00:00,3,0,3,FMN 18 Binnensingel Westkant
665,Uitbreidingstraat 390,2023-01-06,03:00:00,5,2,3,FMN 18 Binnensingel Westkant
665,Uitbreidingstraat 390,2023-01-06,04:00:00,8,1,7,FMN 18 Binnensingel Westkant
665,Uitbreidingstraat 390,2023-01-06,05:00:00,18,0,18,FMN 18 Binnensingel Westkant
665,Uitbreidingstraat 390,2023-01-06,06:00:00,42,8,34,FMN 18 Binnensingel Westkant
665,Uitbreidingstraat 390,2023-01-06,07:00:00,85,13,72,FMN 18 Binnensingel Westkant
665,Uitbreidingstraat 390,2023-01-06,08:00:00,152,20,132,FMN 18 Binnensingel Westkant
665,Uitbreidingstraat 390,2023-01-06,09:00:00,80,19,61,FMN 18 Binnensingel Westkant
665,Uitbreidingstraat 390,2023-01-06,10:00:00,45,10,35,FMN 18 Binnensingel Westkant
665,Uitbreidingstraat 390,2023-01-06,11:00:00,80,32,48,FMN 18 Binnensingel Westkant
665,Uitbreidingstraat 390,2023-01-06,12:00:00,94,39,55,FMN 18 Binnensingel Westkant
665,Uitbreidingstraat 390,2023-01-06,13:00:00,76,21,55,FMN 18 Binnensingel Westkant
665,Uitbreidingstraat 390,2023-01-06,14:00:00,82,34,48,FMN 18 Binnensingel Westkant
665,Uitbreidingstraat 390,2023-01-06,15:00:00,93,33,60,FMN 18 Binnensingel Westkant
665,Uitbreidingstraat 390,2023-01-06,16:00:00,115,48,67,FMN 18 Binnensingel Westkant
665,Uitbreidingstraat 390,2023-01-06,17:00:00,120,48,72,FMN 18 Binnensingel Westkant
665,Uitbreidingstraat 390,2023-01-06,18:00:00,114,35,79,FMN 18 Binnensingel Westkant
665,Uitbreidingstraat 390,2023-01-06,19:00:00,79,30,49,FMN 18 Binnensingel Westkant
665,Uitbreidingstraat 390,2023-01-06,20:00:00,60,12,48,FMN 18 Binnensingel Westkant
665,Uitbreidingstraat 390,2023-01-06,21:00:00,38,13,25,FMN 18 Binnensingel Westkant
665,Uitbreidingstraat 390,2023-01-06,22:00:00,44,13,31,FMN 18 Binnensingel Westkant
665,Uitbreidingstraat 390,2023-01-06,23:00:00,52,14,38,FMN 18 Binnensingel Westkant
665,Uitbreidingstraat 390,2023-01-07,00:00:00,23,5,18,FMN 18 Binnensingel Westkant
665,Uitbreidingstraat 390,2023-01-07,01:00:00,27,8,19,FMN 18 Binnensingel Westkant
665,Uitbreidingstraat 390,2023-01-07,02:00:00,20,5,15,FMN 18 Binnensingel Westkant
665,Uitbreidingstraat 390,2023-01-07,03:00:00,12,5,7,FMN 18 Binnensingel Westkant
665,Uitbreidingstraat 390,2023-01-07,04:00:00,8,2,6,FMN 18 Binnensingel Westkant
665,Uitbreidingstraat 390,2023-01-07,05:00:00,5,0,5,FMN 18 Binnensingel Westkant
665,Uitbreidingstraat 390,2023-01-07,06:00:00,16,2,14,FMN 18 Binnensingel Westkant
665,Uitbreidingstraat 390,2023-01-07,07:00:00,6,1,5,FMN 18 Binnensingel Westkant
665,Uitbreidingstraat 390,2023-01-07,08:00:00,22,5,17,FMN 18 Binnensingel Westkant
665,Uitbreidingstraat 390,2023-01-07,09:00:00,39,13,26,FMN 18 Binnensingel Westkant
665,Uitbreidingstraat 390,2023-01-07,10:00:00,63,23,40,FMN 18 Binnensingel Westkant
665,Uitbreidingstraat 390,2023-01-07,11:00:00,75,28,47,FMN 18 Binnensingel Westkant
665,Uitbreidingstraat 390,2023-01-07,12:00:00,63,26,37,FMN 18 Binnensingel Westkant
665,Uitbreidingstraat 390,2023-01-07,13:00:00,59,16,43,FMN 18 Binnensingel Westkant
665,Uitbreidingstraat 390,2023-01-07,14:00:00,67,28,39,FMN 18 Binnensingel Westkant
665,Uitbreidingstraat 390,2023-01-07,15:00:00,62,28,34,FMN 18 Binnensingel Westkant
665,Uitbreidingstraat 390,2023-01-07,16:00:00,55,17,38,FMN 18 Binnensingel Westkant
665,Uitbreidingstraat 390,2023-01-07,17:00:00,59,15,44,FMN 18 Binnensingel Westkant
665,Uitbreidingstraat 390,2023-01-07,18:00:00,50,23,27,FMN 18 Binnensingel Westkant
665,Uitbreidingstraat 390,2023-01-07,19:00:00,37,12,25,FMN 18 Binnensingel Westkant
665,Uitbreidingstraat 390,2023-01-07,20:00:00,48,15,33,FMN 18 Binnensingel Westkant
665,Uitbreidingstraat 390,2023-01-07,21:00:00,27,12,15,FMN 18 Binnensingel Westkant
665,Uitbreidingstraat 390,2023-01-07,22:00:00,32,6,26,FMN 18 Binnensingel Westkant
665,Uitbreidingstraat 390,2023-01-07,23:00:00,47,8,39,FMN 18 Binnensingel Westkant
665,Uitbreidingstraat 390,2023-01-08,00:00:00,27,6,21,FMN 18 Binnensingel Westkant
665,Uitbreidingstraat 390,2023-01-08,01:00:00,24,2,22,FMN 18 Binnensingel Westkant
665,Uitbreidingstraat 390,2023-01-08,02:00:00,10,2,8,FMN 18 Binnensingel Westkant
665,Uitbreidingstraat 390,2023-01-08,03:00:00,5,1,4,FMN 18 Binnensingel Westkant
665,Uitbreidingstraat 390,2023-01-08,04:00:00,5,2,3,FMN 18 Binnensingel Westkant
665,Uitbreidingstraat 390,2023-01-08,05:00:00,3,0,3,FMN 18 Binnensingel Westkant
665,Uitbreidingstraat 390,2023-01-08,06:00:00,12,3,9,FMN 18 Binnensingel Westkant
665,Uitbreidingstraat 390,2023-01-08,07:00:00,7,2,5,FMN 18 Binnensingel Westkant
665,Uitbreidingstraat 390,2023-01-08,08:00:00,16,5,11,FMN 18 Binnensingel Westkant
665,Uitbreidingstraat 390,2023-01-08,09:00:00,42,14,28,FMN 18 Binnensingel Westkant
665,Uitbreidingstraat 390,2023-01-08,10:00:00,42,10,32,FMN 18 Binnensingel Westkant
665,Uitbreidingstraat 390,2023-01-08,11:00:00,44,17,27,FMN 18 Binnensingel Westkant
665,Uitbreidingstraat 390,2023-01-08,12:00:00,82,36,46,FMN 18 Binnensingel Westkant
665,Uitbreidingstraat 390,2023-01-08,13:00:00,57,13,44,FMN 18 Binnensingel Westkant
665,Uitbreidingstraat 390,2023-01-08,14:00:00,58,17,41,FMN 18 Binnensingel Westkant
665,Uitbreidingstraat 390,2023-01-08,15:00:00,48,10,38,FMN 18 Binnensingel Westkant
665,Uitbreidingstraat 390,2023-01-08,16:00:00,66,15,51,FMN 18 Binnensingel Westkant
665,Uitbreidingstraat 390,2023-01-08,17:00:00,52,18,34,FMN 18 Binnensingel Westkant
665,Uitbreidingstraat 390,2023-01-08,18:00:00,64,18,46,FMN 18 Binnensingel Westkant
665,Uitbreidingstraat 390,2023-01-08,19:00:00,47,13,34,FMN 18 Binnensingel Westkant
665,Uitbreidingstraat 390,2023-01-08,20:00:00,47,12,35,FMN 18 Binnensingel Westkant
665,Uitbreidingstraat 390,2023-01-08,21:00:00,40,5,35,FMN 18 Binnensingel Westkant
665,Uitbreidingstraat 390,2023-01-08,22:00:00,27,3,24,FMN 18 Binnensingel Westkant
665,Uitbreidingstraat 390,2023-01-08,23:00:00,13,4,9,FMN 18 Binnensingel Westkant
665,Uitbreidingstraat 390,2023-01-09,00:00:00,6,1,5,FMN 18 Binnensingel Westkant
665,Uitbreidingstraat 390,2023-01-09,01:00:00,7,1,6,FMN 18 Binnensingel Westkant
665,Uitbreidingstraat 390,2023-01-09,02:00:00,3,0,3,FMN 18 Binnensingel Westkant
665,Uitbreidingstraat 390,2023-01-09,03:00:00,5,1,4,FMN 18 Binnensingel Westkant
665,Uitbreidingstraat 390,2023-01-09,04:00:00,6,1,5,FMN 18 Binnensingel Westkant
665,Uitbreidingstraat 390,2023-01-09,05:00:00,33,5,28,FMN 18 Binnensingel Westkant
665,Uitbreidingstraat 390,2023-01-09,06:00:00,66,14,52,FMN 18 Binnensingel Westkant
665,Uitbreidingstraat 390,2023-01-09,07:00:00,216,34,182,FMN 18 Binnensingel Westkant
665,Uitbreidingstraat 390,2023-01-09,08:00:00,426,79,347,FMN 18 Binnensingel Westkant
665,Uitbreidingstraat 390,2023-01-09,09:00:00,136,21,115,FMN 18 Binnensingel Westkant
665,Uitbreidingstraat 390,2023-01-09,10:00:00,69,18,51,FMN 18 Binnensingel Westkant
665,Uitbreidingstraat 390,2023-01-09,11:00:00,82,24,58,FMN 18 Binnensingel Westkant
665,Uitbreidingstraat 390,2023-01-09,12:00:00,158,67,91,FMN 18 Binnensingel Westkant
665,Uitbreidingstraat 390,2023-01-09,13:00:00,101,22,79,FMN 18 Binnensingel Westkant
665,Uitbreidingstraat 390,2023-01-09,14:00:00,90,37,53,FMN 18 Binnensingel Westkant
665,Uitbreidingstraat 390,2023-01-09,15:00:00,160,105,55,FMN 18 Binnensingel Westkant
665,Uitbreidingstraat 390,2023-01-09,16:00:00,269,165,104,FMN 18 Binnensingel Westkant
665,Uitbreidingstraat 390,2023-01-09,17:00:00,259,128,131,FMN 18 Binnensingel Westkant
665,Uitbreidingstraat 390,2023-01-09,18:00:00,177,66,111,FMN 18 Binnensingel Westkant
665,Uitbreidingstraat 390,2023-01-09,19:00:00,90,25,65,FMN 18 Binnensingel Westkant
665,Uitbreidingstraat 390,2023-01-09,20:00:00,45,13,32,FMN 18 Binnensingel Westkant
665,Uitbreidingstraat 390,2023-01-09,21:00:00,49,27,22,FMN 18 Binnensingel Westkant
665,Uitbreidingstraat 390,2023-01-09,22:00:00,43,13,30,FMN 18 Binnensingel Westkant
665,Uitbreidingstraat 390,2023-01-09,23:00:00,17,3,14,FMN 18 Binnensingel Westkant
665,Uitbreidingstraat 390,2023-01-10,00:00:00,6,0,6,FMN 18 Binnensingel Westkant
665,Uitbreidingstraat 390,2023-01-10,01:00:00,6,1,5,FMN 18 Binnensingel Westkant
665,Uitbreidingstraat 390,2023-01-10,02:00:00,1,0,1,FMN 18 Binnensingel Westkant
665,Uitbreidingstraat 390,2023-01-10,03:00:00,4,1,3,FMN 18 Binnensingel Westkant
665,Uitbreidingstraat 390,2023-01-10,04:00:00,11,3,8,FMN 18 Binnensingel Westkant
665,Uitbreidingstraat 390,2023-01-10,05:00:00,27,1,26,FMN 18 Binnensingel Westkant
665,Uitbreidingstraat 390,2023-01-10,06:00:00,63,12,51,FMN 18 Binnensingel Westkant
665,Uitbreidingstraat 390,2023-01-10,07:00:00,250,49,201,FMN 18 Binnensingel Westkant
665,Uitbreidingstraat 390,2023-01-10,08:00:00,403,51,352,FMN 18 Binnensingel Westkant
665,Uitbreidingstraat 390,2023-01-10,09:00:00,136,28,108,FMN 18 Binnensingel Westkant
665,Uitbreidingstraat 390,2023-01-10,10:00:00,65,17,48,FMN 18 Binnensingel Westkant
665,Uitbreidingstraat 390,2023-01-10,11:00:00,95,27,68,FMN 18 Binnensingel Westkant
665,Uitbreidingstraat 390,2023-01-10,12:00:00,163,64,99,FMN 18 Binnensingel Westkant
665,Uitbreidingstraat 390,2023-01-10,13:00:00,102,28,74,FMN 18 Binnensingel Westkant
665,Uitbreidingstraat 390,2023-01-10,14:00:00,68,34,34,FMN 18 Binnensingel Westkant
665,Uitbreidingstraat 390,2023-01-10,15:00:00,142,83,59,FMN 18 Binnensingel Westkant
665,Uitbreidingstraat 390,2023-01-10,16:00:00,300,203,97,FMN 18 Binnensingel Westkant
665,Uitbreidingstraat 390,2023-01-10,17:00:00,313,164,149,FMN 18 Binnensingel Westkant
665,Uitbreidingstraat 390,2023-01-10,18:00:00,202,76,126,FMN 18 Binnensingel Westkant
665,Uitbreidingstraat 390,2023-01-10,19:00:00,140,71,69,FMN 18 Binnensingel Westkant
665,Uitbreidingstraat 390,2023-01-10,20:00:00,81,39,42,FMN 18 Binnensingel Westkant
665,Uitbreidingstraat 390,2023-01-10,21:00:00,52,22,30,FMN 18 Binnensingel Westkant
665,Uitbreidingstraat 390,2023-01-10,22:00:00,44,13,31,FMN 18 Binnensingel Westkant
665,Uitbreidingstraat 390,2023-01-10,23:00:00,29,9,20,FMN 18 Binnensingel Westkant
665,Uitbreidingstraat 390,2023-01-11,00:00:00,6,1,5,FMN 18 Binnensingel Westkant
665,Uitbreidingstraat 390,2023-01-11,01:00:00,5,1,4,FMN 18 Binnensingel Westkant
665,Uitbreidingstraat 390,2023-01-11,02:00:00,0,0,0,FMN 18 Binnensingel Westkant
665,Uitbreidingstraat 390,2023-01-11,03:00:00,5,0,5,FMN 18 Binnensingel Westkant
665,Uitbreidingstraat 390,2023-01-11,04:00:00,8,2,6,FMN 18 Binnensingel Westkant
665,Uitbreidingstraat 390,2023-01-11,05:00:00,28,5,23,FMN 18 Binnensingel Westkant
665,Uitbreidingstraat 390,2023-01-11,06:00:00,50,6,44,FMN 18 Binnensingel Westkant
665,Uitbreidingstraat 390,2023-01-11,07:00:00,218,42,176,FMN 18 Binnensingel Westkant
665,Uitbreidingstraat 390,2023-01-11,08:00:00,365,64,301,FMN 18 Binnensingel Westkant
665,Uitbreidingstraat 390,2023-01-11,09:00:00,152,28,124,FMN 18 Binnensingel Westkant
665,Uitbreidingstraat 390,2023-01-11,10:00:00,94,27,67,FMN 18 Binnensingel Westkant
665,Uitbreidingstraat 390,2023-01-11,11:00:00,82,38,44,FMN 18 Binnensingel Westkant
665,Uitbreidingstraat 390,2023-01-11,12:00:00,218,140,78,FMN 18 Binnensingel Westkant
665,Uitbreidingstraat 390,2023-01-11,13:00:00,164,91,73,FMN 18 Binnensingel Westkant
665,Uitbreidingstraat 390,2023-01-11,14:00:00,113,46,67,FMN 18 Binnensingel Westkant
665,Uitbreidingstraat 390,2023-01-11,15:00:00,129,71,58,FMN 18 Binnensingel Westkant
665,Uitbreidingstraat 390,2023-01-11,16:00:00,182,83,99,FMN 18 Binnensingel Westkant
665,Uitbreidingstraat 390,2023-01-11,17:00:00,248,104,144,FMN 18 Binnensingel Westkant
665,Uitbreidingstraat 390,2023-01-11,18:00:00,174,54,120,FMN 18 Binnensingel Westkant
665,Uitbreidingstraat 390,2023-01-11,19:00:00,98,31,67,FMN 18 Binnensingel Westkant
665,Uitbreidingstraat 390,2023-01-11,20:00:00,61,26,35,FMN 18 Binnensingel Westkant
665,Uitbreidingstraat 390,2023-01-11,21:00:00,56,26,30,FMN 18 Binnensingel Westkant
665,Uitbreidingstraat 390,2023-01-11,22:00:00,38,16,22,FMN 18 Binnensingel Westkant
665,Uitbreidingstraat 390,2023-01-11,23:00:00,14,3,11,FMN 18 Binnensingel Westkant
665,Uitbreidingstraat 390,2023-01-12,00:00:00,16,5,11,FMN 18 Binnensingel Westkant
665,Uitbreidingstraat 390,2023-01-12,01:00:00,7,2,5,FMN 18 Binnensingel Westkant
665,Uitbreidingstraat 390,2023-01-12,02:00:00,1,1,0,FMN 18 Binnensingel Westkant
665,Uitbreidingstraat 390,2023-01-12,03:00:00,4,2,2,FMN 18 Binnensingel Westkant
665,Uitbreidingstraat 390,2023-01-12,04:00:00,9,2,7,FMN 18 Binnensingel Westkant
665,Uitbreidingstraat 390,2023-01-12,05:00:00,14,1,13,FMN 18 Binnensingel Westkant
665,Uitbreidingstraat 390,2023-01-12,06:00:00,39,9,30,FMN 18 Binnensingel Westkant
665,Uitbreidingstraat 390,2023-01-12,07:00:00,161,27,134,FMN 18 Binnensingel Westkant
665,Uitbreidingstraat 390,2023-01-12,08:00:00,286,45,241,FMN 18 Binnensingel Westkant
665,Uitbreidingstraat 390,2023-01-12,09:00:00,121,27,94,FMN 18 Binnensingel Westkant
665,Uitbreidingstraat 390,2023-01-12,10:00:00,66,15,51,FMN 18 Binnensingel Westkant
665,Uitbreidingstraat 390,2023-01-12,11:00:00,64,21,43,FMN 18 Binnensingel Westkant
665,Uitbreidingstraat 390,2023-01-12,12:00:00,90,34,56,FMN 18 Binnensingel Westkant
665,Uitbreidingstraat 390,2023-01-12,13:00:00,63,16,47,FMN 18 Binnensingel Westkant
665,Uitbreidingstraat 390,2023-01-12,14:00:00,49,25,24,FMN 18 Binnensingel Westkant
665,Uitbreidingstraat 390,2023-01-12,15:00:00,135,90,45,FMN 18 Binnensingel Westkant
665,Uitbreidingstraat 390,2023-01-12,16:00:00,193,136,57,FMN 18 Binnensingel Westkant
665,Uitbreidingstraat 390,2023-01-12,17:00:00,199,108,91,FMN 18 Binnensingel Westkant
665,Uitbreidingstraat 390,2023-01-12,18:00:00,144,54,90,FMN 18 Binnensingel Westkant
665,Uitbreidingstraat 390,2023-01-12,19:00:00,72,24,48,FMN 18 Binnensingel Westkant
665,Uitbreidingstraat 390,2023-01-12,20:00:00,54,17,37,FMN 18 Binnensingel Westkant
665,Uitbreidingstraat 390,2023-01-12,21:00:00,43,15,28,FMN 18 Binnensingel Westkant
665,Uitbreidingstraat 390,2023-01-12,22:00:00,40,11,29,FMN 18 Binnensingel Westkant
665,Uitbreidingstraat 390,2023-01-12,23:00:00,23,7,16,FMN 18 Binnensingel Westkant
665,Uitbreidingstraat 390,2023-01-13,00:00:00,21,4,17,FMN 18 Binnensingel Westkant
665,Uitbreidingstraat 390,2023-01-13,01:00:00,13,2,11,FMN 18 Binnensingel Westkant
665,Uitbreidingstraat 390,2023-01-13,02:00:00,3,0,3,FMN 18 Binnensingel Westkant
665,Uitbreidingstraat 390,2023-01-13,03:00:00,4,1,3,FMN 18 Binnensingel Westkant
665,Uitbreidingstraat 390,2023-01-13,04:00:00,12,3,9,FMN 18 Binnensingel Westkant
665,Uitbreidingstraat 390,2023-01-13,05:00:00,26,2,24,FMN 18 Binnensingel Westkant
665,Uitbreidingstraat 390,2023-01-13,06:00:00,48,11,37,FMN 18 Binnensingel Westkant
665,Uitbreidingstraat 390,2023-01-13,07:00:00,202,22,180,FMN 18 Binnensingel Westkant
665,Uitbreidingstraat 390,2023-01-13,08:00:00,413,70,343,FMN 18 Binnensingel Westkant
665,Uitbreidingstraat 390,2023-01-13,09:00:00,134,28,106,FMN 18 Binnensingel Westkant
665,Uitbreidingstraat 390,2023-01-13,10:00:00,65,14,51,FMN 18 Binnensingel Westkant
665,Uitbreidingstraat 390,2023-01-13,11:00:00,75,35,40,FMN 18 Binnensingel Westkant
665,Uitbreidingstraat 390,2023-01-13,12:00:00,106,46,60,FMN 18 Binnensingel Westkant
665,Uitbreidingstraat 390,2023-01-13,13:00:00,103,30,73,FMN 18 Binnensingel Westkant
665,Uitbreidingstraat 390,2023-01-13,14:00:00,97,46,51,FMN 18 Binnensingel Westkant
665,Uitbreidingstraat 390,2023-01-13,15:00:00,148,78,70,FMN 18 Binnensingel Westkant
665,Uitbreidingstraat 390,2023-01-13,16:00:00,299,187,112,FMN 18 Binnensingel Westkant
665,Uitbreidingstraat 390,2023-01-13,17:00:00,202,95,107,FMN 18 Binnensingel Westkant
665,Uitbreidingstraat 390,2023-01-13,18:00:00,146,61,85,FMN 18 Binnensingel Westkant
665,Uitbreidingstraat 390,2023-01-13,19:00:00,103,37,66,FMN 18 Binnensingel Westkant
665,Uitbreidingstraat 390,2023-01-13,20:00:00,90,22,68,FMN 18 Binnensingel Westkant
665,Uitbreidingstraat 390,2023-01-13,21:00:00,49,22,27,FMN 18 Binnensingel Westkant
665,Uitbreidingstraat 390,2023-01-13,22:00:00,55,15,40,FMN 18 Binnensingel Westkant
665,Uitbreidingstraat 390,2023-01-13,23:00:00,44,11,33,FMN 18 Binnensingel Westkant
665,Uitbreidingstraat 390,2023-01-14,00:00:00,36,9,27,FMN 18 Binnensingel Westkant
665,Uitbreidingstraat 390,2023-01-14,01:00:00,31,10,21,FMN 18 Binnensingel Westkant
665,Uitbreidingstraat 390,2023-01-14,02:00:00,17,6,11,FMN 18 Binnensingel Westkant
665,Uitbreidingstraat 390,2023-01-14,03:00:00,12,1,11,FMN 18 Binnensingel Westkant
665,Uitbreidingstraat 390,2023-01-14,04:00:00,7,1,6,FMN 18 Binnensingel Westkant
665,Uitbreidingstraat 390,2023-01-14,05:00:00,15,6,9,FMN 18 Binnensingel Westkant
665,Uitbreidingstraat 390,2023-01-14,06:00:00,21,3,18,FMN 18 Binnensingel Westkant
665,Uitbreidingstraat 390,2023-01-14,07:00:00,17,6,11,FMN 18 Binnensingel Westkant
665,Uitbreidingstraat 390,2023-01-14,08:00:00,27,11,16,FMN 18 Binnensingel Westkant
665,Uitbreidingstraat 390,2023-01-14,09:00:00,33,8,25,FMN 18 Binnensingel Westkant
665,Uitbreidingstraat 390,2023-01-14,10:00:00,35,13,22,FMN 18 Binnensingel Westkant
665,Uitbreidingstraat 390,2023-01-14,11:00:00,43,19,24,FMN 18 Binnensingel Westkant
665,Uitbreidingstraat 390,2023-01-14,12:00:00,58,22,36,FMN 18 Binnensingel Westkant
665,Uitbreidingstraat 390,2023-01-14,13:00:00,37,17,20,FMN 18 Binnensingel Westkant
665,Uitbreidingstraat 390,2023-01-14,14:00:00,34,10,24,FMN 18 Binnensingel Westkant
665,Uitbreidingstraat 390,2023-01-14,15:00:00,56,25,31,FMN 18 Binnensingel Westkant
665,Uitbreidingstraat 390,2023-01-14,16:00:00,30,13,17,FMN 18 Binnensingel Westkant
665,Uitbreidingstraat 390,2023-01-14,17:00:00,71,22,49,FMN 18 Binnensingel Westkant
665,Uitbreidingstraat 390,2023-01-14,18:00:00,45,9,36,FMN 18 Binnensingel Westkant
665,Uitbreidingstraat 390,2023-01-14,19:00:00,48,13,35,FMN 18 Binnensingel Westkant
665,Uitbreidingstraat 390,2023-01-14,20:00:00,34,8,26,FMN 18 Binnensingel Westkant
665,Uitbreidingstraat 390,2023-01-14,21:00:00,33,10,23,FMN 18 Binnensingel Westkant
665,Uitbreidingstraat 390,2023-01-14,22:00:00,33,3,30,FMN 18 Binnensingel Westkant
665,Uitbreidingstraat 390,2023-01-14,23:00:00,45,6,39,FMN 18 Binnensingel Westkant
665,Uitbreidingstraat 390,2023-01-15,00:00:00,13,4,9,FMN 18 Binnensingel Westkant
665,Uitbreidingstraat 390,2023-01-15,01:00:00,7,1,6,FMN 18 Binnensingel Westkant
665,Uitbreidingstraat 390,2023-01-15,02:00:00,11,3,8,FMN 18 Binnensingel Westkant
665,Uitbreidingstraat 390,2023-01-15,03:00:00,6,3,3,FMN 18 Binnensingel Westkant
665,Uitbreidingstraat 390,2023-01-15,04:00:00,3,2,1,FMN 18 Binnensingel Westkant
665,Uitbreidingstraat 390,2023-01-15,05:00:00,9,2,7,FMN 18 Binnensingel Westkant
665,Uitbreidingstraat 390,2023-01-15,06:00:00,12,4,8,FMN 18 Binnensingel Westkant
665,Uitbreidingstraat 390,2023-01-15,07:00:00,13,4,9,FMN 18 Binnensingel Westkant
665,Uitbreidingstraat 390,2023-01-15,08:00:00,9,3,6,FMN 18 Binnensingel Westkant
665,Uitbreidingstraat 390,2023-01-15,09:00:00,23,7,16,FMN 18 Binnensingel Westkant
665,Uitbreidingstraat 390,2023-01-15,10:00:00,34,10,24,FMN 18 Binnensingel Westkant
665,Uitbreidingstraat 390,2023-01-15,11:00:00,54,17,37,FMN 18 Binnensingel Westkant
665,Uitbreidingstraat 390,2023-01-15,12:00:00,54,21,33,FMN 18 Binnensingel Westkant
665,Uitbreidingstraat 390,2023-01-15,13:00:00,38,16,22,FMN 18 Binnensingel Westkant
665,Uitbreidingstraat 390,2023-01-15,14:00:00,27,5,22,FMN 18 Binnensingel Westkant
665,Uitbreidingstraat 390,2023-01-15,15:00:00,46,11,35,FMN 18 Binnensingel Westkant
665,Uitbreidingstraat 390,2023-01-15,16:00:00,36,13,23,FMN 18 Binnensingel Westkant
665,Uitbreidingstraat 390,2023-01-15,17:00:00,46,14,32,FMN 18 Binnensingel Westkant
665,Uitbreidingstraat 390,2023-01-15,18:00:00,34,7,27,FMN 18 Binnensingel Westkant
665,Uitbreidingstraat 390,2023-01-15,19:00:00,29,4,25,FMN 18 Binnensingel Westkant
665,Uitbreidingstraat 390,2023-01-15,20:00:00,30,9,21,FMN 18 Binnensingel Westkant
665,Uitbreidingstraat 390,2023-01-15,21:00:00,22,9,13,FMN 18 Binnensingel Westkant
665,Uitbreidingstraat 390,2023-01-15,22:00:00,10,3,7,FMN 18 Binnensingel Westkant
665,Uitbreidingstraat 390,2023-01-15,23:00:00,5,0,5,FMN 18 Binnensingel Westkant
665,Uitbreidingstraat 390,2023-01-16,00:00:00,6,0,6,FMN 18 Binnensingel Westkant
665,Uitbreidingstraat 390,2023-01-16,01:00:00,2,0,2,FMN 18 Binnensingel Westkant
665,Uitbreidingstraat 390,2023-01-16,02:00:00,0,0,0,FMN 18 Binnensingel Westkant
665,Uitbreidingstraat 390,2023-01-16,03:00:00,1,0,1,FMN 18 Binnensingel Westkant
665,Uitbreidingstraat 390,2023-01-16,04:00:00,9,2,7,FMN 18 Binnensingel Westkant
665,Uitbreidingstraat 390,2023-01-16,05:00:00,14,1,13,FMN 18 Binnensingel Westkant
665,Uitbreidingstraat 390,2023-01-16,06:00:00,33,3,30,FMN 18 Binnensingel Westkant
665,Uitbreidingstraat 390,2023-01-16,07:00:00,128,14,114,FMN 18 Binnensingel Westkant
665,Uitbreidingstraat 390,2023-01-16,08:00:00,227,37,190,FMN 18 Binnensingel Westkant
665,Uitbreidingstraat 390,2023-01-16,09:00:00,85,16,69,FMN 18 Binnensingel Westkant
665,Uitbreidingstraat 390,2023-01-16,10:00:00,57,15,42,FMN 18 Binnensingel Westkant
665,Uitbreidingstraat 390,2023-01-16,11:00:00,49,23,26,FMN 18 Binnensingel Westkant
665,Uitbreidingstraat 390,2023-01-16,12:00:00,82,28,54,FMN 18 Binnensingel Westkant
665,Uitbreidingstraat 390,2023-01-16,13:00:00,56,13,43,FMN 18 Binnensingel Westkant
665,Uitbreidingstraat 390,2023-01-16,14:00:00,69,26,43,FMN 18 Binnensingel Westkant
665,Uitbreidingstraat 390,2023-01-16,15:00:00,91,51,40,FMN 18 Binnensingel Westkant
665,Uitbreidingstraat 390,2023-01-16,16:00:00,153,93,60,FMN 18 Binnensingel Westkant
665,Uitbreidingstraat 390,2023-01-16,17:00:00,143,79,64,FMN 18 Binnensingel Westkant
665,Uitbreidingstraat 390,2023-01-16,18:00:00,121,32,89,FMN 18 Binnensingel Westkant
665,Uitbreidingstraat 390,2023-01-16,19:00:00,44,11,33,FMN 18 Binnensingel Westkant
665,Uitbreidingstraat 390,2023-01-16,20:00:00,38,16,22,FMN 18 Binnensingel Westkant
665,Uitbreidingstraat 390,2023-01-16,21:00:00,24,10,14,FMN 18 Binnensingel Westkant
665,Uitbreidingstraat 390,2023-01-16,22:00:00,15,7,8,FMN 18 Binnensingel Westkant
665,Uitbreidingstraat 390,2023-01-16,23:00:00,11,2,9,FMN 18 Binnensingel Westkant
665,Uitbreidingstraat 390,2023-01-17,00:00:00,3,0,3,FMN 18 Binnensingel Westkant
665,Uitbreidingstraat 390,2023-01-17,01:00:00,2,0,2,FMN 18 Binnensingel Westkant
665,Uitbreidingstraat 390,2023-01-17,02:00:00,0,0,0,FMN 18 Binnensingel Westkant
665,Uitbreidingstraat 390,2023-01-17,03:00:00,8,2,6,FMN 18 Binnensingel Westkant
665,Uitbreidingstraat 390,2023-01-17,04:00:00,7,2,5,FMN 18 Binnensingel Westkant
665,Uitbreidingstraat 390,2023-01-17,05:00:00,18,4,14,FMN 18 Binnensingel Westkant
665,Uitbreidingstraat 390,2023-01-17,06:00:00,33,6,27,FMN 18 Binnensingel Westkant
665,Uitbreidingstraat 390,2023-01-17,07:00:00,114,16,98,FMN 18 Binnensingel Westkant
665,Uitbreidingstraat 390,2023-01-17,08:00:00,142,24,118,FMN 18 Binnensingel Westkant
665,Uitbreidingstraat 390,2023-01-17,09:00:00,55,7,48,FMN 18 Binnensingel Westkant
665,Uitbreidingstraat 390,2023-01-17,10:00:00,36,9,27,FMN 18 Binnensingel Westkant
665,Uitbreidingstraat 390,2023-01-17,11:00:00,40,6,34,FMN 18 Binnensingel Westkant
665,Uitbreidingstraat 390,2023-01-17,12:00:00,114,33,81,FMN 18 Binnensingel Westkant
665,Uitbreidingstraat 390,2023-01-17,13:00:00,88,25,63,FMN 18 Binnensingel Westkant
665,Uitbreidingstraat 390,2023-01-17,14:00:00,78,26,52,FMN 18 Binnensingel Westkant
665,Uitbreidingstraat 390,2023-01-17,15:00:00,160,87,73,FMN 18 Binnensingel Westkant
665,Uitbreidingstraat 390,2023-01-17,16:00:00,174,92,82,FMN 18 Binnensingel Westkant
665,Uitbreidingstraat 390,2023-01-17,17:00:00,166,60,106,FMN 18 Binnensingel Westkant
665,Uitbreidingstraat 390,2023-01-17,18:00:00,106,33,73,FMN 18 Binnensingel Westkant
665,Uitbreidingstraat 390,2023-01-17,19:00:00,56,16,40,FMN 18 Binnensingel Westkant
665,Uitbreidingstraat 390,2023-01-17,20:00:00,32,12,20,FMN 18 Binnensingel Westkant
665,Uitbreidingstraat 390,2023-01-17,21:00:00,23,10,13,FMN 18 Binnensingel Westkant
665,Uitbreidingstraat 390,2023-01-17,22:00:00,27,11,16,FMN 18 Binnensingel Westkant
665,Uitbreidingstraat 390,2023-01-17,23:00:00,15,2,13,FMN 18 Binnensingel Westkant
665,Uitbreidingstraat 390,2023-01-18,00:00:00,1,0,1,FMN 18 Binnensingel Westkant
665,Uitbreidingstraat 390,2023-01-18,01:00:00,2,1,1,FMN 18 Binnensingel Westkant
665,Uitbreidingstraat 390,2023-01-18,02:00:00,1,0,1,FMN 18 Binnensingel Westkant
665,Uitbreidingstraat 390,2023-01-18,03:00:00,0,0,0,FMN 18 Binnensingel Westkant
665,Uitbreidingstraat 390,2023-01-18,04:00:00,3,1,2,FMN 18 Binnensingel Westkant
665,Uitbreidingstraat 390,2023-01-18,05:00:00,12,2,10,FMN 18 Binnensingel Westkant
665,Uitbreidingstraat 390,2023-01-18,06:00:00,23,4,19,FMN 18 Binnensingel Westkant
665,Uitbreidingstraat 390,2023-01-18,07:00:00,56,5,51,FMN 18 Binnensingel Westkant
665,Uitbreidingstraat 390,2023-01-18,08:00:00,99,14,85,FMN 18 Binnensingel Westkant
665,Uitbreidingstraat 390,2023-01-18,09:00:00,31,3,28,FMN 18 Binnensingel Westkant
665,Uitbreidingstraat 390,2023-01-18,10:00:00,30,5,25,FMN 18 Binnensingel Westkant
665,Uitbreidingstraat 390,2023-01-18,11:00:00,57,21,36,FMN 18 Binnensingel Westkant
665,Uitbreidingstraat 390,2023-01-18,12:00:00,158,75,83,FMN 18 Binnensingel Westkant
665,Uitbreidingstraat 390,2023-01-18,13:00:00,137,65,72,FMN 18 Binnensingel Westkant
665,Uitbreidingstraat 390,2023-01-18,14:00:00,99,31,68,FMN 18 Binnensingel Westkant
665,Uitbreidingstraat 390,2023-01-18,15:00:00,94,39,55,FMN 18 Binnensingel Westkant
665,Uitbreidingstraat 390,2023-01-18,16:00:00,109,56,53,FMN 18 Binnensingel Westkant
665,Uitbreidingstraat 390,2023-01-18,17:00:00,149,66,83,FMN 18 Binnensingel Westkant
665,Uitbreidingstraat 390,2023-01-18,18:00:00,88,22,66,FMN 18 Binnensingel Westkant
665,Uitbreidingstraat 390,2023-01-18,19:00:00,52,18,34,FMN 18 Binnensingel Westkant
665,Uitbreidingstraat 390,2023-01-18,20:00:00,46,14,32,FMN 18 Binnensingel Westkant
665,Uitbreidingstraat 390,2023-01-18,21:00:00,32,12,20,FMN 18 Binnensingel Westkant
665,Uitbreidingstraat 390,2023-01-18,22:00:00,21,8,13,FMN 18 Binnensingel Westkant
665,Uitbreidingstraat 390,2023-01-18,23:00:00,17,5,12,FMN 18 Binnensingel Westkant
665,Uitbreidingstraat 390,2023-01-19,00:00:00,15,5,10,FMN 18 Binnensingel Westkant
665,Uitbreidingstraat 390,2023-01-19,01:00:00,6,1,5,FMN 18 Binnensingel Westkant
665,Uitbreidingstraat 390,2023-01-19,02:00:00,3,1,2,FMN 18 Binnensingel Westkant
665,Uitbreidingstraat 390,2023-01-19,03:00:00,5,2,3,FMN 18 Binnensingel Westkant
665,Uitbreidingstraat 390,2023-01-19,04:00:00,7,2,5,FMN 18 Binnensingel Westkant
665,Uitbreidingstraat 390,2023-01-19,05:00:00,21,4,17,FMN 18 Binnensingel Westkant
665,Uitbreidingstraat 390,2023-01-19,06:00:00,46,13,33,FMN 18 Binnensingel Westkant
665,Uitbreidingstraat 390,2023-01-19,07:00:00,167,36,131,FMN 18 Binnensingel Westkant
665,Uitbreidingstraat 390,2023-01-19,08:00:00,316,75,241,FMN 18 Binnensingel Westkant
665,Uitbreidingstraat 390,2023-01-19,09:00:00,126,30,96,FMN 18 Binnensingel Westkant
665,Uitbreidingstraat 390,2023-01-19,10:00:00,89,26,63,FMN 18 Binnensingel Westkant
665,Uitbreidingstraat 390,2023-01-19,11:00:00,65,23,42,FMN 18 Binnensingel Westkant
665,Uitbreidingstraat 390,2023-01-19,12:00:00,106,41,65,FMN 18 Binnensingel Westkant
665,Uitbreidingstraat 390,2023-01-19,13:00:00,91,28,63,FMN 18 Binnensingel Westkant
665,Uitbreidingstraat 390,2023-01-19,14:00:00,75,28,47,FMN 18 Binnensingel Westkant
665,Uitbreidingstraat 390,2023-01-19,15:00:00,133,65,68,FMN 18 Binnensingel Westkant
665,Uitbreidingstraat 390,2023-01-19,16:00:00,186,100,86,FMN 18 Binnensingel Westkant
665,Uitbreidingstraat 390,2023-01-19,17:00:00,175,79,96,FMN 18 Binnensingel Westkant
665,Uitbreidingstraat 390,2023-01-19,18:00:00,154,53,101,FMN 18 Binnensingel Westkant
665,Uitbreidingstraat 390,2023-01-19,19:00:00,97,31,66,FMN 18 Binnensingel Westkant
665,Uitbreidingstraat 390,2023-01-19,20:00:00,57,19,38,FMN 18 Binnensingel Westkant
665,Uitbreidingstraat 390,2023-01-19,21:00:00,49,17,32,FMN 18 Binnensingel Westkant
665,Uitbreidingstraat 390,2023-01-19,22:00:00,50,15,35,FMN 18 Binnensingel Westkant
665,Uitbreidingstraat 390,2023-01-19,23:00:00,39,7,32,FMN 18 Binnensingel Westkant
665,Uitbreidingstraat 390,2023-01-20,00:00:00,27,8,19,FMN 18 Binnensingel Westkant
665,Uitbreidingstraat 390,2023-01-20,01:00:00,15,3,12,FMN 18 Binnensingel Westkant
665,Uitbreidingstraat 390,2023-01-20,02:00:00,11,3,8,FMN 18 Binnensingel Westkant
665,Uitbreidingstraat 390,2023-01-20,03:00:00,9,2,7,FMN 18 Binnensingel Westkant
665,Uitbreidingstraat 390,2023-01-20,04:00:00,11,2,9,FMN 18 Binnensingel Westkant
665,Uitbreidingstraat 390,2023-01-20,05:00:00,26,6,20,FMN 18 Binnensingel Westkant
665,Uitbreidingstraat 390,2023-01-20,06:00:00,49,13,36,FMN 18 Binnensingel Westkant
665,Uitbreidingstraat 390,2023-01-20,07:00:00,152,36,116,FMN 18 Binnensingel Westkant
665,Uitbreidingstraat 390,2023-01-20,08:00:00,283,71,212,FMN 18 Binnensingel Westkant
665,Uitbreidingstraat 390,2023-01-20,09:00:00,116,30,86,FMN 18 Binnensingel Westkant
665,Uitbreidingstraat 390,2023-01-20,10:00:00,106,37,69,FMN 18 Binnensingel Westkant
665,Uitbreidingstraat 390,2023-01-20,11:00:00,85,37,48,FMN 18 Binnensingel Westkant
665,Uitbreidingstraat 390,2023-01-20,12:00:00,116,48,68,FMN 18 Binnensingel Westkant
665,Uitbreidingstraat 390,2023-01-20,13:00:00,104,38,66,FMN 18 Binnensingel Westkant
665,Uitbreidingstraat 390,2023-01-20,14:00:00,96,37,59,FMN 18 Binnensingel Westkant
665,Uitbreidingstraat 390,2023-01-20,15:00:00,129,62,67,FMN 18 Binnensingel Westkant
665,Uitbreidingstraat 390,2023-01-20,16:00:00,206,112,94,FMN 18 Binnensingel Westkant
665,Uitbreidingstraat 390,2023-01-20,17:00:00,172,79,93,FMN 18 Binnensingel Westkant
665,Uitbreidingstraat 390,2023-01-20,18:00:00,129,51,78,FMN 18 Binnensingel Westkant
665,Uitbreidingstraat 390,2023-01-20,19:00:00,93,32,61,FMN 18 Binnensingel Westkant
665,Uitbreidingstraat 390,2023-01-20,20:00:00,64,23,41,FMN 18 Binnensingel Westkant
665,Uitbreidingstraat 390,2023-01-20,21:00:00,46,19,27,FMN 18 Binnensingel Westkant
665,Uitbreidingstraat 390,2023-01-20,22:00:00,46,18,28,FMN 18 Binnensingel Westkant
665,Uitbreidingstraat 390,2023-01-20,23:00:00,47,14,33,FMN 18 Binnensingel Westkant
665,Uitbreidingstraat 390,2023-01-21,00:00:00,37,12,25,FMN 18 Binnensingel Westkant
665,Uitbreidingstraat 390,2023-01-21,01:00:00,26,7,19,FMN 18 Binnensingel Westkant
665,Uitbreidingstraat 390,2023-01-21,02:00:00,17,5,12,FMN 18 Binnensingel Westkant
665,Uitbreidingstraat 390,2023-01-21,03:00:00,12,4,8,FMN 18 Binnensingel Westkant
665,Uitbreidingstraat 390,2023-01-21,04:00:00,11,3,8,FMN 18 Binnensingel Westkant
665,Uitbreidingstraat 390,2023-01-21,05:00:00,14,4,10,FMN 18 Binnensingel Westkant
665,Uitbreidingstraat 390,2023-01-21,06:00:00,21,6,15,FMN 18 Binnensingel Westkant
665,Uitbreidingstraat 390,2023-01-21,07:00:00,14,5,9,FMN 18 Binnensingel Westkant
665,Uitbreidingstraat 390,2023-01-21,08:00:00,29,10,19,FMN 18 Binnensingel Westkant
665,Uitbreidingstraat 390,2023-01-21,09:00:00,52,21,31,FMN 18 Binnensingel Westkant
665,Uitbreidingstraat 390,2023-01-21,10:00:00,61,23,38,FMN 18 Binnensingel Westkant
665,Uitbreidingstraat 390,2023-01-21,11:00:00,68,26,42,FMN 18 Binnensingel Westkant
665,Uitbreidingstraat 390,2023-01-21,12:00:00,76,33,43,FMN 18 Binnensingel Westkant
665,Uitbreidingstraat 390,2023-01-21,13:00:00,77,32,45,FMN 18 Binnensingel Westkant
665,Uitbreidingstraat 390,2023-01-21,14:00:00,71,25,46,FMN 18 Binnensingel Westkant
665,Uitbreidingstraat 390,2023-01-21,15:00:00,73,25,48,FMN 18 Binnensingel Westkant
665,Uitbreidingstraat 390,2023-01-21,16:00:00,63,25,38,FMN 18 Binnensingel Westkant
665,Uitbreidingstraat 390,2023-01-21,17:00:00,76,26,50,FMN 18 Binnensingel Westkant
665,Uitbreidingstraat 390,2023-01-21,18:00:00,70,26,44,FMN 18 Binnensingel Westkant
665,Uitbreidingstraat 390,2023-01-21,19:00:00,68,21,47,FMN 18 Binnensingel Westkant
665,Uitbreidingstraat 390,2023-01-21,20:00:00,43,14,29,FMN 18 Binnensingel Westkant
665,Uitbreidingstraat 390,2023-01-21,21:00:00,38,14,24,FMN 18 Binnensingel Westkant
665,Uitbreidingstraat 390,2023-01-21,22:00:00,33,9,24,FMN 18 Binnensingel Westkant
665,Uitbreidingstraat 390,2023-01-21,23:00:00,51,13,38,FMN 18 Binnensingel Westkant
665,Uitbreidingstraat 390,2023-01-22,00:00:00,29,8,21,FMN 18 Binnensingel Westkant
665,Uitbreidingstraat 390,2023-01-22,01:00:00,28,8,20,FMN 18 Binnensingel Westkant
665,Uitbreidingstraat 390,2023-01-22,02:00:00,23,5,18,FMN 18 Binnensingel Westkant
665,Uitbreidingstraat 390,2023-01-22,03:00:00,18,5,13,FMN 18 Binnensingel Westkant
665,Uitbreidingstraat 390,2023-01-22,04:00:00,17,3,14,FMN 18 Binnensingel Westkant
665,Uitbreidingstraat 390,2023-01-22,05:00:00,13,2,11,FMN 18 Binnensingel Westkant
665,Uitbreidingstraat 390,2023-01-22,06:00:00,21,5,16,FMN 18 Binnensingel Westkant
665,Uitbreidingstraat 390,2023-01-22,07:00:00,9,2,7,FMN 18 Binnensingel Westkant
665,Uitbreidingstraat 390,2023-01-22,08:00:00,18,5,13,FMN 18 Binnensingel Westkant
665,Uitbreidingstraat 390,2023-01-22,09:00:00,38,13,25,FMN 18 Binnensingel Westkant
665,Uitbreidingstraat 390,2023-01-22,10:00:00,45,13,32,FMN 18 Binnensingel Westkant
665,Uitbreidingstraat 390,2023-01-22,11:00:00,53,19,34,FMN 18 Binnensingel Westkant
665,Uitbreidingstraat 390,2023-01-22,12:00:00,71,25,46,FMN 18 Binnensingel Westkant
665,Uitbreidingstraat 390,2023-01-22,13:00:00,58,16,42,FMN 18 Binnensingel Westkant
665,Uitbreidingstraat 390,2023-01-22,14:00:00,61,18,43,FMN 18 Binnensingel Westkant
665,Uitbreidingstraat 390,2023-01-22,15:00:00,53,15,38,FMN 18 Binnensingel Westkant
665,Uitbreidingstraat 390,2023-01-22,16:00:00,56,18,38,FMN 18 Binnensingel Westkant
665,Uitbreidingstraat 390,2023-01-22,17:00:00,61,21,40,FMN 18 Binnensingel Westkant
665,Uitbreidingstraat 390,2023-01-22,18:00:00,54,17,37,FMN 18 Binnensingel Westkant
665,Uitbreidingstraat 390,2023-01-22,19:00:00,46,11,35,FMN 18 Binnensingel Westkant
665,Uitbreidingstraat 390,2023-01-22,20:00:00,45,12,33,FMN 18 Binnensingel Westkant
665,Uitbreidingstraat 390,2023-01-22,21:00:00,32,7,25,FMN 18 Binnensingel Westkant
665,Uitbreidingstraat 390,2023-01-22,22:00:00,29,8,21,FMN 18 Binnensingel Westkant
665,Uitbreidingstraat 390,2023-01-22,23:00:00,15,3,12,FMN 18 Binnensingel Westkant
665,Uitbreidingstraat 390,2023-01-23,00:00:00,6,2,4,FMN 18 Binnensingel Westkant
665,Uitbreidingstraat 390,2023-01-23,01:00:00,5,1,4,FMN 18 Binnensingel Westkant
665,Uitbreidingstraat 390,2023-01-23,02:00:00,0,0,0,FMN 18 Binnensingel Westkant
665,Uitbreidingstraat 390,2023-01-23,03:00:00,2,0,2,FMN 18 Binnensingel Westkant
665,Uitbreidingstraat 390,2023-01-23,04:00:00,7,3,4,FMN 18 Binnensingel Westkant
665,Uitbreidingstraat 390,2023-01-23,05:00:00,19,4,15,FMN 18 Binnensingel Westkant
665,Uitbreidingstraat 390,2023-01-23,06:00:00,46,11,35,FMN 18 Binnensingel Westkant
665,Uitbreidingstraat 390,2023-01-23,07:00:00,165,42,123,FMN 18 Binnensingel Westkant
665,Uitbreidingstraat 390,2023-01-23,08:00:00,303,76,227,FMN 18 Binnensingel Westkant
665,Uitbreidingstraat 390,2023-01-23,09:00:00,108,25,83,FMN 18 Binnensingel Westkant
665,Uitbreidingstraat 390,2023-01-23,10:00:00,77,22,55,FMN 18 Binnensingel Westkant
665,Uitbreidingstraat 390,2023-01-23,11:00:00,60,23,37,FMN 18 Binnensingel Westkant
665,Uitbreidingstraat 390,2023-01-23,12:00:00,118,51,67,FMN 18 Binnensingel Westkant
665,Uitbreidingstraat 390,2023-01-23,13:00:00,95,31,64,FMN 18 Binnensingel Westkant
665,Uitbreidingstraat 390,2023-01-23,14:00:00,81,38,43,FMN 18 Binnensingel Westkant
665,Uitbreidingstraat 390,2023-01-23,15:00:00,125,69,56,FMN 18 Binnensingel Westkant
665,Uitbreidingstraat 390,2023-01-23,16:00:00,200,118,82,FMN 18 Binnensingel Westkant
665,Uitbreidingstraat 390,2023-01-23,17:00:00,195,98,97,FMN 18 Binnensingel Westkant
665,Uitbreidingstraat 390,2023-01-23,18:00:00,140,59,81,FMN 18 Binnensingel Westkant
665,Uitbreidingstraat 390,2023-01-23,19:00:00,79,28,51,FMN 18 Binnensingel Westkant
665,Uitbreidingstraat 390,2023-01-23,20:00:00,46,19,27,FMN 18 Binnensingel Westkant
665,Uitbreidingstraat 390,2023-01-23,21:00:00,44,21,23,FMN 18 Binnensingel Westkant
665,Uitbreidingstraat 390,2023-01-23,22:00:00,34,13,21,FMN 18 Binnensingel Westkant
665,Uitbreidingstraat 390,2023-01-23,23:00:00,18,4,14,FMN 18 Binnensingel Westkant
665,Uitbreidingstraat 390,2023-01-24,00:00:00,10,2,8,FMN 18 Binnensingel Westkant
665,Uitbreidingstraat 390,2023-01-24,01:00:00,6,1,5,FMN 18 Binnensingel Westkant
665,Uitbreidingstraat 390,2023-01-24,02:00:00,1,0,1,FMN 18 Binnensingel Westkant
665,Uitbreidingstraat 390,2023-01-24,03:00:00,6,1,5,FMN 18 Binnensingel Westkant
665,Uitbreidingstraat 390,2023-01-24,04:00:00,9,2,7,FMN 18 Binnensingel Westkant
665,Uitbreidingstraat 390,2023-01-24,05:00:00,29,6,23,FMN 18 Binnensingel Westkant
665,Uitbreidingstraat 390,2023-01-24,06:00:00,65,16,49,FMN 18 Binnensingel Westkant
665,Uitbreidingstraat 390,2023-01-24,07:00:00,242,53,189,FMN 18 Binnensingel Westkant
665,Uitbreidingstraat 390,2023-01-24,08:00:00,409,86,323,FMN 18 Binnensingel Westkant
665,Uitbreidingstraat 390,2023-01-24,09:00:00,159,33,126,FMN 18 Binnensingel Westkant
665,Uitbreidingstraat 390,2023-01-24,10:00:00,102,32,70,FMN 18 Binnensingel Westkant
665,Uitbreidingstraat 390,2023-01-24,11:00:00,92,31,61,FMN 18 Binnensingel Westkant
665,Uitbreidingstraat 390,2023-01-24,12:00:00,146,51,95,FMN 18 Binnensingel Westkant
665,Uitbreidingstraat 390,2023-01-24,13:00:00,132,39,93,FMN 18 Binnensingel Westkant
665,Uitbreidingstraat 390,2023-01-24,14:00:00,99,35,64,FMN 18 Binnensingel Westkant
665,Uitbreidingstraat 390,2023-01-24,15:00:00,176,86,90,FMN 18 Binnensingel Westkant
665,Uitbreidingstraat 390,2023-01-24,16:00:00,283,148,135,FMN 18 Binnensingel Westkant
665,Uitbreidingstraat 390,2023-01-24,17:00:00,286,118,168,FMN 18 Binnensingel Westkant
665,Uitbreidingstraat 390,2023-01-24,18:00:00,205,76,129,FMN 18 Binnensingel Westkant
665,Uitbreidingstraat 390,2023-01-24,19:00:00,122,43,79,FMN 18 Binnensingel Westkant
665,Uitbreidingstraat 390,2023-01-24,20:00:00,72,27,45,FMN 18 Binnensingel Westkant
665,Uitbreidingstraat 390,2023-01-24,21:00:00,58,24,34,FMN 18 Binnensingel Westkant
665,Uitbreidingstraat 390,2023-01-24,22:00:00,62,22,40,FMN 18 Binnensingel Westkant
665,Uitbreidingstraat 390,2023-01-24,23:00:00,33,9,24,FMN 18 Binnensingel Westkant
665,Uitbreidingstraat 390,2023-01-25,00:00:00,17,5,12,FMN 18 Binnensingel Westkant
665,Uitbreidingstraat 390,2023-01-25,01:00:00,9,2,7,FMN 18 Binnensingel Westkant
665,Uitbreidingstraat 390,2023-01-25,02:00:00,3,0,3,FMN 18 Binnensingel Westkant
665,Uitbreidingstraat 390,2023-01-25,03:00:00,7,2,5,FMN 18 Binnensingel Westkant
665,Uitbreidingstraat 390,2023-01-25,04:00:00,12,3,9,FMN 18 Binnensingel Westkant
665,Uitbreidingstraat 390,2023-01-25,05:00:00,37,6,31,FMN 18 Binnensingel Westkant
665,Uitbreidingstraat 390,2023-01-25,06:00:00,83,14,69,FMN 18 Binnensingel Westkant
665,Uitbreidingstraat 390,2023-01-25,07:00:00,272,44,228,FMN 18 Binnensingel Westkant
665,Uitbreidingstraat 390,2023-01-25,08:00:00,478,83,395,FMN 18 Binnensingel Westkant
665,Uitbreidingstraat 390,2023-01-25,09:00:00,188,34,154,FMN 18 Binnensingel Westkant
665,Uitbreidingstraat 390,2023-01-25,10:00:00,142,39,103,FMN 18 Binnensingel Westkant
665,Uitbreidingstraat 390,2023-01-25,11:00:00,124,43,81,FMN 18 Binnensingel Westkant
665,Uitbreidingstraat 390,2023-01-25,12:00:00,257,107,150,FMN 18 Binnensingel Westkant
665,Uitbreidingstraat 390,2023-01-25,13:00:00,215,77,138,FMN 18 Binnensingel Westkant
665,Uitbreidingstraat 390,2023-01-25,14:00:00,135,40,95,FMN 18 Binnensingel Westkant
665,Uitbreidingstraat 390,2023-01-25,15:00:00,170,57,113,FMN 18 Binnensingel Westkant
665,Uitbreidingstraat 390,2023-01-25,16:00:00,219,82,137,FMN 18 Binnensingel Westkant
665,Uitbreidingstraat 390,2023-01-25,17:00:00,301,110,191,FMN 18 Binnensingel Westkant
665,Uitbreidingstraat 390,2023-01-25,18:00:00,232,67,165,FMN 18 Binnensingel Westkant
665,Uitbreidingstraat 390,2023-01-25,19:00:00,137,35,102,FMN 18 Binnensingel Westkant
665,Uitbreidingstraat 390,2023-01-25,20:00:00,84,25,59,FMN 18 Binnensingel Westkant
665,Uitbreidingstraat 390,2023-01-25,21:00:00,67,21,46,FMN 18 Binnensingel Westkant
665,Uitbreidingstraat 390,2023-01-25,22:00:00,68,22,46,FMN 18 Binnensingel Westkant
665,Uitbreidingstraat 390,2023-01-25,23:00:00,52,10,42,FMN 18 Binnensingel Westkant
665,Uitbreidingstraat 390,2023-01-26,00:00:00,13,4,9,FMN 18 Binnensingel Westkant
665,Uitbreidingstraat 390,2023-01-26,01:00:00,6,2,4,FMN 18 Binnensingel Westkant
665,Uitbreidingstraat 390,2023-01-26,02:00:00,3,1,2,FMN 18 Binnensingel Westkant
665,Uitbreidingstraat 390,2023-01-26,03:00:00,4,1,3,FMN 18 Binnensingel Westkant
665,Uitbreidingstraat 390,2023-01-26,04:00:00,5,1,4,FMN 18 Binnensingel Westkant
665,Uitbreidingstraat 390,2023-01-26,05:00:00,18,4,14,FMN 18 Binnensingel Westkant
665,Uitbreidingstraat 390,2023-01-26,06:00:00,40,11,29,FMN 18 Binnensingel Westkant
665,Uitbreidingstraat 390,2023-01-26,07:00:00,146,32,114,FMN 18 Binnensingel Westkant
665,Uitbreidingstraat 390,2023-01-26,08:00:00,276,66,210,FMN 18 Binnensingel Westkant
665,Uitbreidingstraat 390,2023-01-26,09:00:00,110,27,83,FMN 18 Binnensingel Westkant
665,Uitbreidingstraat 390,2023-01-26,10:00:00,77,22,55,FMN 18 Binnensingel Westkant
665,Uitbreidingstraat 390,2023-01-26,11:00:00,57,21,36,FMN 18 Binnensingel Westkant
665,Uitbreidingstraat 390,2023-01-26,12:00:00,93,36,57,FMN 18 Binnensingel Westkant
665,Uitbreidingstraat 390,2023-01-26,13:00:00,79,24,55,FMN 18 Binnensingel Westkant
665,Uitbreidingstraat 390,2023-01-26,14:00:00,65,25,40,FMN 18 Binnensingel Westkant
665,Uitbreidingstraat 390,2023-01-26,15:00:00,117,57,60,FMN 18 Binnensingel Westkant
665,Uitbreidingstraat 390,2023-01-26,16:00:00,163,88,75,FMN 18 Binnensingel Westkant
665,Uitbreidingstraat 390,2023-01-26,17:00:00,152,69,83,FMN 18 Binnensingel Westkant
665,Uitbreidingstraat 390,2023-01-26,18:00:00,135,47,88,FMN 18 Binnensingel Westkant
665,Uitbreidingstraat 390,2023-01-26,19:00:00,84,27,57,FMN 18 Binnensingel Westkant
665,Uitbreidingstraat 390,2023-01-26,20:00:00,50,17,33,FMN 18 Binnensingel Westkant
665,Uitbreidingstraat 390,2023-01-26,21:00:00,43,15,28,FMN 18 Binnensingel Westkant
665,Uitbreidingstraat 390,2023-01-26,22:00:00,43,13,30,FMN 18 Binnensingel Westkant
665,Uitbreidingstraat 390,2023-01-26,23:00:00,34,6,28,FMN 18 Binnensingel Westkant
665,Uitbreidingstraat 390,2023-01-27,00:00:00,16,16,0,FMN 18 Binnensingel Westkant
665,Uitbreidingstraat 390,2023-01-27,01:00:00,7,6,1,FMN 18 Binnensingel Westkant
665,Uitbreidingstraat 390,2023-01-27,02:00:00,5,5,0,FMN 18 Binnensingel Westkant
665,Uitbreidingstraat 390,2023-01-27,03:00:00,6,5,1,FMN 18 Binnensingel Westkant
665,Uitbreidingstraat 390,2023-01-27,04:00:00,7,6,1,FMN 18 Binnensingel Westkant
665,Uitbreidingstraat 390,2023-01-27,05:00:00,26,25,1,FMN 18 Binnensingel Westkant
665,Uitbreidingstraat 390,2023-01-27,06:00:00,56,49,7,FMN 18 Binnensingel Westkant
665,Uitbreidingstraat 390,2023-01-27,07:00:00,186,166,20,FMN 18 Binnensingel Westkant
665,Uitbreidingstraat 390,2023-01-27,08:00:00,323,283,40,FMN 18 Binnensingel Westkant
665,Uitbreidingstraat 390,2023-01-27,09:00:00,105,80,25,FMN 18 Binnensingel Westkant
665,Uitbreidingstraat 390,2023-01-27,10:00:00,90,62,28,FMN 18 Binnensingel Westkant
665,Uitbreidingstraat 390,2023-01-27,11:00:00,88,64,24,FMN 18 Binnensingel Westkant
665,Uitbreidingstraat 390,2023-01-27,12:00:00,110,69,41,FMN 18 Binnensingel Westkant
665,Uitbreidingstraat 390,2023-01-27,13:00:00,103,73,30,FMN 18 Binnensingel Westkant
665,Uitbreidingstraat 390,2023-01-27,14:00:00,91,58,33,FMN 18 Binnensingel Westkant
665,Uitbreidingstraat 390,2023-01-27,15:00:00,150,72,78,FMN 18 Binnensingel Westkant
665,Uitbreidingstraat 390,2023-01-27,16:00:00,236,88,148,FMN 18 Binnensingel Westkant
665,Uitbreidingstraat 390,2023-01-27,17:00:00,199,103,96,FMN 18 Binnensingel Westkant
665,Uitbreidingstraat 390,2023-01-27,18:00:00,165,112,53,FMN 18 Binnensingel Westkant
665,Uitbreidingstraat 390,2023-01-27,19:00:00,107,81,26,FMN 18 Binnensingel Westkant
665,Uitbreidingstraat 390,2023-01-27,20:00:00,61,41,20,FMN 18 Binnensingel Westkant
665,Uitbreidingstraat 390,2023-01-27,21:00:00,47,31,16,FMN 18 Binnensingel Westkant
665,Uitbreidingstraat 390,2023-01-27,22:00:00,55,43,12,FMN 18 Binnensingel Westkant
665,Uitbreidingstraat 390,2023-01-27,23:00:00,54,42,12,FMN 18 Binnensingel Westkant
665,Uitbreidingstraat 390,2023-01-28,00:00:00,39,34,5,FMN 18 Binnensingel Westkant
665,Uitbreidingstraat 390,2023-01-28,01:00:00,26,15,11,FMN 18 Binnensingel Westkant
665,Uitbreidingstraat 390,2023-01-28,02:00:00,12,9,3,FMN 18 Binnensingel Westkant
665,Uitbreidingstraat 390,2023-01-28,03:00:00,20,18,2,FMN 18 Binnensingel Westkant
665,Uitbreidingstraat 390,2023-01-28,04:00:00,15,14,1,FMN 18 Binnensingel Westkant
665,Uitbreidingstraat 390,2023-01-28,05:00:00,8,7,1,FMN 18 Binnensingel Westkant
665,Uitbreidingstraat 390,2023-01-28,06:00:00,24,21,3,FMN 18 Binnensingel Westkant
665,Uitbreidingstraat 390,2023-01-28,07:00:00,20,18,2,FMN 18 Binnensingel Westkant
665,Uitbreidingstraat 390,2023-01-28,08:00:00,45,35,10,FMN 18 Binnensingel Westkant
665,Uitbreidingstraat 390,2023-01-28,09:00:00,115,95,20,FMN 18 Binnensingel Westkant
665,Uitbreidingstraat 390,2023-01-28,10:00:00,71,48,23,FMN 18 Binnensingel Westkant
665,Uitbreidingstraat 390,2023-01-28,11:00:00,114,52,62,FMN 18 Binnensingel Westkant
665,Uitbreidingstraat 390,2023-01-28,12:00:00,138,106,32,FMN 18 Binnensingel Westkant
665,Uitbreidingstraat 390,2023-01-28,13:00:00,109,86,23,FMN 18 Binnensingel Westkant
665,Uitbreidingstraat 390,2023-01-28,14:00:00,97,66,31,FMN 18 Binnensingel Westkant
665,Uitbreidingstraat 390,2023-01-28,15:00:00,109,48,61,FMN 18 Binnensingel Westkant
665,Uitbreidingstraat 390,2023-01-28,16:00:00,86,58,28,FMN 18 Binnensingel Westkant
665,Uitbreidingstraat 390,2023-01-28,17:00:00,70,39,31,FMN 18 Binnensingel Westkant
665,Uitbreidingstraat 390,2023-01-28,18:00:00,69,54,15,FMN 18 Binnensingel Westkant
665,Uitbreidingstraat 390,2023-01-28,19:00:00,75,49,26,FMN 18 Binnensingel Westkant
665,Uitbreidingstraat 390,2023-01-28,20:00:00,51,38,13,FMN 18 Binnensingel Westkant
665,Uitbreidingstraat 390,2023-01-28,21:00:00,42,34,8,FMN 18 Binnensingel Westkant
665,Uitbreidingstraat 390,2023-01-28,22:00:00,33,25,8,FMN 18 Binnensingel Westkant
665,Uitbreidingstraat 390,2023-01-28,23:00:00,32,20,12,FMN 18 Binnensingel Westkant
665,Uitbreidingstraat 390,2023-01-29,00:00:00,25,16,9,FMN 18 Binnensingel Westkant
665,Uitbreidingstraat 390,2023-01-29,01:00:00,14,14,0,FMN 18 Binnensingel Westkant
665,Uitbreidingstraat 390,2023-01-29,02:00:00,8,6,2,FMN 18 Binnensingel Westkant
665,Uitbreidingstraat 390,2023-01-29,03:00:00,12,11,1,FMN 18 Binnensingel Westkant
665,Uitbreidingstraat 390,2023-01-29,04:00:00,7,6,1,FMN 18 Binnensingel Westkant
665,Uitbreidingstraat 390,2023-01-29,05:00:00,7,7,0,FMN 18 Binnensingel Westkant
665,Uitbreidingstraat 390,2023-01-29,06:00:00,17,11,6,FMN 18 Binnensingel Westkant
665,Uitbreidingstraat 390,2023-01-29,07:00:00,5,2,3,FMN 18 Binnensingel Westkant
665,Uitbreidingstraat 390,2023-01-29,08:00:00,22,18,4,FMN 18 Binnensingel Westkant
665,Uitbreidingstraat 390,2023-01-29,09:00:00,37,28,9,FMN 18 Binnensingel Westkant
665,Uitbreidingstraat 390,2023-01-29,10:00:00,50,40,10,FMN 18 Binnensingel Westkant
665,Uitbreidingstraat 390,2023-01-29,11:00:00,58,35,23,FMN 18 Binnensingel Westkant
665,Uitbreidingstraat 390,2023-01-29,12:00:00,62,40,22,FMN 18 Binnensingel Westkant
665,Uitbreidingstraat 390,2023-01-29,13:00:00,50,36,14,FMN 18 Binnensingel Westkant
665,Uitbreidingstraat 390,2023-01-29,14:00:00,64,50,14,FMN 18 Binnensingel Westkant
665,Uitbreidingstraat 390,2023-01-29,15:00:00,50,25,25,FMN 18 Binnensingel Westkant
665,Uitbreidingstraat 390,2023-01-29,16:00:00,65,47,18,FMN 18 Binnensingel Westkant
665,Uitbreidingstraat 390,2023-01-29,17:00:00,50,43,7,FMN 18 Binnensingel Westkant
665,Uitbreidingstraat 390,2023-01-29,18:00:00,55,42,13,FMN 18 Binnensingel Westkant
665,Uitbreidingstraat 390,2023-01-29,19:00:00,38,30,8,FMN 18 Binnensingel Westkant
665,Uitbreidingstraat 390,2023-01-29,20:00:00,33,23,10,FMN 18 Binnensingel Westkant
665,Uitbreidingstraat 390,2023-01-29,21:00:00,27,18,9,FMN 18 Binnensingel Westkant
665,Uitbreidingstraat 390,2023-01-29,22:00:00,23,19,4,FMN 18 Binnensingel Westkant
665,Uitbreidingstraat 390,2023-01-29,23:00:00,9,5,4,FMN 18 Binnensingel Westkant
665,Uitbreidingstraat 390,2023-01-30,00:00:00,3,3,0,FMN 18 Binnensingel Westkant
665,Uitbreidingstraat 390,2023-01-30,01:00:00,5,3,2,FMN 18 Binnensingel Westkant
665,Uitbreidingstraat 390,2023-01-30,02:00:00,1,1,0,FMN 18 Binnensingel Westkant
665,Uitbreidingstraat 390,2023-01-30,03:00:00,2,2,0,FMN 18 Binnensingel Westkant
665,Uitbreidingstraat 390,2023-01-30,04:00:00,9,8,1,FMN 18 Binnensingel Westkant
665,Uitbreidingstraat 390,2023-01-30,05:00:00,17,14,3,FMN 18 Binnensingel Westkant
665,Uitbreidingstraat 390,2023-01-30,06:00:00,62,48,14,FMN 18 Binnensingel Westkant
665,Uitbreidingstraat 390,2023-01-30,07:00:00,218,189,29,FMN 18 Binnensingel Westkant
665,Uitbreidingstraat 390,2023-01-30,08:00:00,372,316,56,FMN 18 Binnensingel Westkant
665,Uitbreidingstraat 390,2023-01-30,09:00:00,136,120,16,FMN 18 Binnensingel Westkant
665,Uitbreidingstraat 390,2023-01-30,10:00:00,65,52,13,FMN 18 Binnensingel Westkant
665,Uitbreidingstraat 390,2023-01-30,11:00:00,66,28,38,FMN 18 Binnensingel Westkant
665,Uitbreidingstraat 390,2023-01-30,12:00:00,216,84,132,FMN 18 Binnensingel Westkant
665,Uitbreidingstraat 390,2023-01-30,13:00:00,93,63,30,FMN 18 Binnensingel Westkant
665,Uitbreidingstraat 390,2023-01-30,14:00:00,85,56,29,FMN 18 Binnensingel Westkant
665,Uitbreidingstraat 390,2023-01-30,15:00:00,121,69,52,FMN 18 Binnensingel Westkant
665,Uitbreidingstraat 390,2023-01-30,16:00:00,199,100,99,FMN 18 Binnensingel Westkant
665,Uitbreidingstraat 390,2023-01-30,17:00:00,227,133,94,FMN 18 Binnensingel Westkant
665,Uitbreidingstraat 390,2023-01-30,18:00:00,194,127,67,FMN 18 Binnensingel Westkant
665,Uitbreidingstraat 390,2023-01-30,19:00:00,101,75,26,FMN 18 Binnensingel Westkant
665,Uitbreidingstraat 390,2023-01-30,20:00:00,57,37,20,FMN 18 Binnensingel Westkant
665,Uitbreidingstraat 390,2023-01-30,21:00:00,50,31,19,FMN 18 Binnensingel Westkant
665,Uitbreidingstraat 390,2023-01-30,22:00:00,33,27,6,FMN 18 Binnensingel Westkant
665,Uitbreidingstraat 390,2023-01-30,23:00:00,14,6,8,FMN 18 Binnensingel Westkant
665,Uitbreidingstraat 390,2023-01-31,00:00:00,3,1,2,FMN 18 Binnensingel Westkant
665,Uitbreidingstraat 390,2023-01-31,01:00:00,4,4,0,FMN 18 Binnensingel Westkant
665,Uitbreidingstraat 390,2023-01-31,02:00:00,3,3,0,FMN 18 Binnensingel Westkant
665,Uitbreidingstraat 390,2023-01-31,03:00:00,5,5,0,FMN 18 Binnensingel Westkant
665,Uitbreidingstraat 390,2023-01-31,04:00:00,8,5,3,FMN 18 Binnensingel Westkant
665,Uitbreidingstraat 390,2023-01-31,05:00:00,26,24,2,FMN 18 Binnensingel Westkant
665,Uitbreidingstraat 390,2023-01-31,06:00:00,61,43,18,FMN 18 Binnensingel Westkant
665,Uitbreidingstraat 390,2023-01-31,07:00:00,220,184,36,FMN 18 Binnensingel Westkant
665,Uitbreidingstraat 390,2023-01-31,08:00:00,389,330,59,FMN 18 Binnensingel Westkant
665,Uitbreidingstraat 390,2023-01-31,09:00:00,125,98,27,FMN 18 Binnensingel Westkant
665,Uitbreidingstraat 390,2023-01-31,10:00:00,71,55,16,FMN 18 Binnensingel Westkant
665,Uitbreidingstraat 390,2023-01-31,11:00:00,70,47,23,FMN 18 Binnensingel Westkant
665,Uitbreidingstraat 390,2023-01-31,12:00:00,121,72,49,FMN 18 Binnensingel Westkant
665,Uitbreidingstraat 390,2023-01-31,13:00:00,105,78,27,FMN 18 Binnensingel Westkant
665,Uitbreidingstraat 390,2023-01-31,14:00:00,69,43,26,FMN 18 Binnensingel Westkant
665,Uitbreidingstraat 390,2023-01-31,15:00:00,159,69,90,FMN 18 Binnensingel Westkant
665,Uitbreidingstraat 390,2023-01-31,16:00:00,284,117,167,FMN 18 Binnensingel Westkant
665,Uitbreidingstraat 390,2023-01-31,17:00:00,276,133,143,FMN 18 Binnensingel Westkant
665,Uitbreidingstraat 390,2023-01-31,18:00:00,186,119,67,FMN 18 Binnensingel Westkant
665,Uitbreidingstraat 390,2023-01-31,19:00:00,90,56,34,FMN 18 Binnensingel Westkant
665,Uitbreidingstraat 390,2023-01-31,20:00:00,88,62,26,FMN 18 Binnensingel Westkant
665,Uitbreidingstraat 390,2023-01-31,21:00:00,70,49,21,FMN 18 Binnensingel Westkant
665,Uitbreidingstraat 390,2023-01-31,22:00:00,51,37,14,FMN 18 Binnensingel Westkant
665,Uitbreidingstraat 390,2023-01-31,23:00:00,25,19,6,FMN 18 Binnensingel Westkant
665,Uitbreidingstraat 390,2023-02-01,00:00:00,16,16,0,FMN 18 Binnensingel Westkant
665,Uitbreidingstraat 390,2023-02-01,01:00:00,3,3,0,FMN 18 Binnensingel Westkant
665,Uitbreidingstraat 390,2023-02-01,02:00:00,2,2,0,FMN 18 Binnensingel Westkant
665,Uitbreidingstraat 390,2023-02-01,03:00:00,15,15,0,FMN 18 Binnensingel Westkant
665,Uitbreidingstraat 390,2023-02-01,04:00:00,8,7,1,FMN 18 Binnensingel Westkant
665,Uitbreidingstraat 390,2023-02-01,05:00:00,20,20,0,FMN 18 Binnensingel Westkant
665,Uitbreidingstraat 390,2023-02-01,06:00:00,63,52,11,FMN 18 Binnensingel Westkant
665,Uitbreidingstraat 390,2023-02-01,07:00:00,177,148,29,FMN 18 Binnensingel Westkant
665,Uitbreidingstraat 390,2023-02-01,08:00:00,329,283,46,FMN 18 Binnensingel Westkant
665,Uitbreidingstraat 390,2023-02-01,09:00:00,128,103,25,FMN 18 Binnensingel Westkant
665,Uitbreidingstraat 390,2023-02-01,10:00:00,81,62,19,FMN 18 Binnensingel Westkant
665,Uitbreidingstraat 390,2023-02-01,11:00:00,97,50,47,FMN 18 Binnensingel Westkant
665,Uitbreidingstraat 390,2023-02-01,12:00:00,204,97,107,FMN 18 Binnensingel Westkant
665,Uitbreidingstraat 390,2023-02-01,13:00:00,144,67,77,FMN 18 Binnensingel Westkant
665,Uitbreidingstraat 390,2023-02-01,14:00:00,103,67,36,FMN 18 Binnensingel Westkant
665,Uitbreidingstraat 390,2023-02-01,15:00:00,117,58,59,FMN 18 Binnensingel Westkant
665,Uitbreidingstraat 390,2023-02-01,16:00:00,171,94,77,FMN 18 Binnensingel Westkant
665,Uitbreidingstraat 390,2023-02-01,17:00:00,240,134,106,FMN 18 Binnensingel Westkant
665,Uitbreidingstraat 390,2023-02-01,18:00:00,163,116,47,FMN 18 Binnensingel Westkant
665,Uitbreidingstraat 390,2023-02-01,19:00:00,95,67,28,FMN 18 Binnensingel Westkant
665,Uitbreidingstraat 390,2023-02-01,20:00:00,50,39,11,FMN 18 Binnensingel Westkant
665,Uitbreidingstraat 390,2023-02-01,21:00:00,50,28,22,FMN 18 Binnensingel Westkant
665,Uitbreidingstraat 390,2023-02-01,22:00:00,46,29,17,FMN 18 Binnensingel Westkant
665,Uitbreidingstraat 390,2023-02-01,23:00:00,18,13,5,FMN 18 Binnensingel Westkant
665,Uitbreidingstraat 390,2023-02-02,00:00:00,15,11,4,FMN 18 Binnensingel Westkant
665,Uitbreidingstraat 390,2023-02-02,01:00:00,4,4,0,FMN 18 Binnensingel Westkant
665,Uitbreidingstraat 390,2023-02-02,02:00:00,2,2,0,FMN 18 Binnensingel Westkant
665,Uitbreidingstraat 390,2023-02-02,03:00:00,7,7,0,FMN 18 Binnensingel Westkant
665,Uitbreidingstraat 390,2023-02-02,04:00:00,14,13,1,FMN 18 Binnensingel Westkant
665,Uitbreidingstraat 390,2023-02-02,05:00:00,25,22,3,FMN 18 Binnensingel Westkant
665,Uitbreidingstraat 390,2023-02-02,06:00:00,59,41,18,FMN 18 Binnensingel Westkant
665,Uitbreidingstraat 390,2023-02-02,07:00:00,200,166,34,FMN 18 Binnensingel Westkant
665,Uitbreidingstraat 390,2023-02-02,08:00:00,410,343,67,FMN 18 Binnensingel Westkant
665,Uitbreidingstraat 390,2023-02-02,09:00:00,150,130,20,FMN 18 Binnensingel Westkant
665,Uitbreidingstraat 390,2023-02-02,10:00:00,72,51,21,FMN 18 Binnensingel Westkant
665,Uitbreidingstraat 390,2023-02-02,11:00:00,65,46,19,FMN 18 Binnensingel Westkant
665,Uitbreidingstraat 390,2023-02-02,12:00:00,141,98,43,FMN 18 Binnensingel Westkant
665,Uitbreidingstraat 390,2023-02-02,13:00:00,114,87,27,FMN 18 Binnensingel Westkant
665,Uitbreidingstraat 390,2023-02-02,14:00:00,92,60,32,FMN 18 Binnensingel Westkant
665,Uitbreidingstraat 390,2023-02-02,15:00:00,166,58,108,FMN 18 Binnensingel Westkant
665,Uitbreidingstraat 390,2023-02-02,16:00:00,244,86,158,FMN 18 Binnensingel Westkant
665,Uitbreidingstraat 390,2023-02-02,17:00:00,254,139,115,FMN 18 Binnensingel Westkant
665,Uitbreidingstraat 390,2023-02-02,18:00:00,206,145,61,FMN 18 Binnensingel Westkant
665,Uitbreidingstraat 390,2023-02-02,19:00:00,99,80,19,FMN 18 Binnensingel Westkant
665,Uitbreidingstraat 390,2023-02-02,20:00:00,69,48,21,FMN 18 Binnensingel Westkant
665,Uitbreidingstraat 390,2023-02-02,21:00:00,59,35,24,FMN 18 Binnensingel Westkant
665,Uitbreidingstraat 390,2023-02-02,22:00:00,56,34,22,FMN 18 Binnensingel Westkant
665,Uitbreidingstraat 390,2023-02-02,23:00:00,42,30,12,FMN 18 Binnensingel Westkant
665,Uitbreidingstraat 390,2023-02-03,00:00:00,17,12,5,FMN 18 Binnensingel Westkant
665,Uitbreidingstraat 390,2023-02-03,01:00:00,6,4,2,FMN 18 Binnensingel Westkant
665,Uitbreidingstraat 390,2023-02-03,02:00:00,0,0,0,FMN 18 Binnensingel Westkant
665,Uitbreidingstraat 390,2023-02-03,03:00:00,7,6,1,FMN 18 Binnensingel Westkant
665,Uitbreidingstraat 390,2023-02-03,04:00:00,9,9,0,FMN 18 Binnensingel Westkant
665,Uitbreidingstraat 390,2023-02-03,05:00:00,23,20,3,FMN 18 Binnensingel Westkant
665,Uitbreidingstraat 390,2023-02-03,06:00:00,52,40,12,FMN 18 Binnensingel Westkant
665,Uitbreidingstraat 390,2023-02-03,07:00:00,145,128,17,FMN 18 Binnensingel Westkant
665,Uitbreidingstraat 390,2023-02-03,08:00:00,327,281,46,FMN 18 Binnensingel Westkant
665,Uitbreidingstraat 390,2023-02-03,09:00:00,92,70,22,FMN 18 Binnensingel Westkant
665,Uitbreidingstraat 390,2023-02-03,10:00:00,66,48,18,FMN 18 Binnensingel Westkant
665,Uitbreidingstraat 390,2023-02-03,11:00:00,81,51,30,FMN 18 Binnensingel Westkant
665,Uitbreidingstraat 390,2023-02-03,12:00:00,135,94,41,FMN 18 Binnensingel Westkant
665,Uitbreidingstraat 390,2023-02-03,13:00:00,143,117,26,FMN 18 Binnensingel Westkant
665,Uitbreidingstraat 390,2023-02-03,14:00:00,94,65,29,FMN 18 Binnensingel Westkant
665,Uitbreidingstraat 390,2023-02-03,15:00:00,106,61,45,FMN 18 Binnensingel Westkant
665,Uitbreidingstraat 390,2023-02-03,16:00:00,250,96,154,FMN 18 Binnensingel Westkant
665,Uitbreidingstraat 390,2023-02-03,17:00:00,211,125,86,FMN 18 Binnensingel Westkant
665,Uitbreidingstraat 390,2023-02-03,18:00:00,164,111,53,FMN 18 Binnensingel Westkant
665,Uitbreidingstraat 390,2023-02-03,19:00:00,103,75,28,FMN 18 Binnensingel Westkant
665,Uitbreidingstraat 390,2023-02-03,20:00:00,84,54,30,FMN 18 Binnensingel Westkant
665,Uitbreidingstraat 390,2023-02-03,21:00:00,40,29,11,FMN 18 Binnensingel Westkant
665,Uitbreidingstraat 390,2023-02-03,22:00:00,41,27,14,FMN 18 Binnensingel Westkant
665,Uitbreidingstraat 390,2023-02-03,23:00:00,39,32,7,FMN 18 Binnensingel Westkant
665,Uitbreidingstraat 390,2023-02-04,00:00:00,43,29,14,FMN 18 Binnensingel Westkant
665,Uitbreidingstraat 390,2023-02-04,01:00:00,33,24,9,FMN 18 Binnensingel Westkant
665,Uitbreidingstraat 390,2023-02-04,02:00:00,25,21,4,FMN 18 Binnensingel Westkant
665,Uitbreidingstraat 390,2023-02-04,03:00:00,21,16,5,FMN 18 Binnensingel Westkant
665,Uitbreidingstraat 390,2023-02-04,04:00:00,13,10,3,FMN 18 Binnensingel Westkant
665,Uitbreidingstraat 390,2023-02-04,05:00:00,17,16,1,FMN 18 Binnensingel Westkant
665,Uitbreidingstraat 390,2023-02-04,06:00:00,19,18,1,FMN 18 Binnensingel Westkant
665,Uitbreidingstraat 390,2023-02-04,07:00:00,16,14,2,FMN 18 Binnensingel Westkant
665,Uitbreidingstraat 390,2023-02-04,08:00:00,29,23,6,FMN 18 Binnensingel Westkant
665,Uitbreidingstraat 390,2023-02-04,09:00:00,74,55,19,FMN 18 Binnensingel Westkant
665,Uitbreidingstraat 390,2023-02-04,10:00:00,68,47,21,FMN 18 Binnensingel Westkant
665,Uitbreidingstraat 390,2023-02-04,11:00:00,50,26,24,FMN 18 Binnensingel Westkant
665,Uitbreidingstraat 390,2023-02-04,12:00:00,70,44,26,FMN 18 Binnensingel Westkant
665,Uitbreidingstraat 390,2023-02-04,13:00:00,86,70,16,FMN 18 Binnensingel Westkant
665,Uitbreidingstraat 390,2023-02-04,14:00:00,73,46,27,FMN 18 Binnensingel Westkant
665,Uitbreidingstraat 390,2023-02-04,15:00:00,75,52,23,FMN 18 Binnensingel Westkant
665,Uitbreidingstraat 390,2023-02-04,16:00:00,72,38,34,FMN 18 Binnensingel Westkant
665,Uitbreidingstraat 390,2023-02-04,17:00:00,92,61,31,FMN 18 Binnensingel Westkant
665,Uitbreidingstraat 390,2023-02-04,18:00:00,72,49,23,FMN 18 Binnensingel Westkant
665,Uitbreidingstraat 390,2023-02-04,19:00:00,95,76,19,FMN 18 Binnensingel Westkant
665,Uitbreidingstraat 390,2023-02-04,20:00:00,46,37,9,FMN 18 Binnensingel Westkant
665,Uitbreidingstraat 390,2023-02-04,21:00:00,38,35,3,FMN 18 Binnensingel Westkant
665,Uitbreidingstraat 390,2023-02-04,22:00:00,23,17,6,FMN 18 Binnensingel Westkant
665,Uitbreidingstraat 390,2023-02-04,23:00:00,48,33,15,FMN 18 Binnensingel Westkant
665,Uitbreidingstraat 390,2023-02-05,00:00:00,46,22,24,FMN 18 Binnensingel Westkant
665,Uitbreidingstraat 390,2023-02-05,01:00:00,16,12,4,FMN 18 Binnensingel Westkant
665,Uitbreidingstraat 390,2023-02-05,02:00:00,25,13,12,FMN 18 Binnensingel Westkant
665,Uitbreidingstraat 390,2023-02-05,03:00:00,21,14,7,FMN 18 Binnensingel Westkant
665,Uitbreidingstraat 390,2023-02-05,04:00:00,17,10,7,FMN 18 Binnensingel Westkant
665,Uitbreidingstraat 390,2023-02-05,05:00:00,10,7,3,FMN 18 Binnensingel Westkant
665,Uitbreidingstraat 390,2023-02-05,06:00:00,17,15,2,FMN 18 Binnensingel Westkant
665,Uitbreidingstraat 390,2023-02-05,07:00:00,16,10,6,FMN 18 Binnensingel Westkant
665,Uitbreidingstraat 390,2023-02-05,08:00:00,30,16,14,FMN 18 Binnensingel Westkant
665,Uitbreidingstraat 390,2023-02-05,09:00:00,37,23,14,FMN 18 Binnensingel Westkant
665,Uitbreidingstraat 390,2023-02-05,10:00:00,46,37,9,FMN 18 Binnensingel Westkant
665,Uitbreidingstraat 390,2023-02-05,11:00:00,76,47,29,FMN 18 Binnensingel Westkant
665,Uitbreidingstraat 390,2023-02-05,12:00:00,83,67,16,FMN 18 Binnensingel Westkant
665,Uitbreidingstraat 390,2023-02-05,13:00:00,72,37,35,FMN 18 Binnensingel Westkant
665,Uitbreidingstraat 390,2023-02-05,14:00:00,62,52,10,FMN 18 Binnensingel Westkant
665,Uitbreidingstraat 390,2023-02-05,15:00:00,55,43,12,FMN 18 Binnensingel Westkant
665,Uitbreidingstraat 390,2023-02-05,16:00:00,57,46,11,FMN 18 Binnensingel Westkant
665,Uitbreidingstraat 390,2023-02-05,17:00:00,61,47,14,FMN 18 Binnensingel Westkant
665,Uitbreidingstraat 390,2023-02-05,18:00:00,67,54,13,FMN 18 Binnensingel Westkant
665,Uitbreidingstraat 390,2023-02-05,19:00:00,54,41,13,FMN 18 Binnensingel Westkant
665,Uitbreidingstraat 390,2023-02-05,20:00:00,42,34,8,FMN 18 Binnensingel Westkant
665,Uitbreidingstraat 390,2023-02-05,21:00:00,35,18,17,FMN 18 Binnensingel Westkant
665,Uitbreidingstraat 390,2023-02-05,22:00:00,25,21,4,FMN 18 Binnensingel Westkant
665,Uitbreidingstraat 390,2023-02-05,23:00:00,10,8,2,FMN 18 Binnensingel Westkant
665,Uitbreidingstraat 390,2023-02-06,00:00:00,11,9,2,FMN 18 Binnensingel Westkant
665,Uitbreidingstraat 390,2023-02-06,01:00:00,6,3,3,FMN 18 Binnensingel Westkant
665,Uitbreidingstraat 390,2023-02-06,02:00:00,2,2,0,FMN 18 Binnensingel Westkant
665,Uitbreidingstraat 390,2023-02-06,03:00:00,1,1,0,FMN 18 Binnensingel Westkant
665,Uitbreidingstraat 390,2023-02-06,04:00:00,5,4,1,FMN 18 Binnensingel Westkant
665,Uitbreidingstraat 390,2023-02-06,05:00:00,25,23,2,FMN 18 Binnensingel Westkant
665,Uitbreidingstraat 390,2023-02-06,06:00:00,58,45,13,FMN 18 Binnensingel Westkant
665,Uitbreidingstraat 390,2023-02-06,07:00:00,189,151,38,FMN 18 Binnensingel Westkant
665,Uitbreidingstraat 390,2023-02-06,08:00:00,353,296,57,FMN 18 Binnensingel Westkant
665,Uitbreidingstraat 390,2023-02-06,09:00:00,143,122,21,FMN 18 Binnensingel Westkant
665,Uitbreidingstraat 390,2023-02-06,10:00:00,62,54,8,FMN 18 Binnensingel Westkant
665,Uitbreidingstraat 390,2023-02-06,11:00:00,62,47,15,FMN 18 Binnensingel Westkant
665,Uitbreidingstraat 390,2023-02-06,12:00:00,120,76,44,FMN 18 Binnensingel Westkant
665,Uitbreidingstraat 390,2023-02-06,13:00:00,104,77,27,FMN 18 Binnensingel Westkant
665,Uitbreidingstraat 390,2023-02-06,14:00:00,77,51,26,FMN 18 Binnensingel Westkant
665,Uitbreidingstraat 390,2023-02-06,15:00:00,159,73,86,FMN 18 Binnensingel Westkant
665,Uitbreidingstraat 390,2023-02-06,16:00:00,265,99,166,FMN 18 Binnensingel Westkant
665,Uitbreidingstraat 390,2023-02-06,17:00:00,247,125,122,FMN 18 Binnensingel Westkant
665,Uitbreidingstraat 390,2023-02-06,18:00:00,210,148,62,FMN 18 Binnensingel Westkant
665,Uitbreidingstraat 390,2023-02-06,19:00:00,102,68,34,FMN 18 Binnensingel Westkant
665,Uitbreidingstraat 390,2023-02-06,20:00:00,62,38,24,FMN 18 Binnensingel Westkant
665,Uitbreidingstraat 390,2023-02-06,21:00:00,45,24,21,FMN 18 Binnensingel Westkant
665,Uitbreidingstraat 390,2023-02-06,22:00:00,48,27,21,FMN 18 Binnensingel Westkant
665,Uitbreidingstraat 390,2023-02-06,23:00:00,15,8,7,FMN 18 Binnensingel Westkant
665,Uitbreidingstraat 390,2023-02-07,00:00:00,7,4,3,FMN 18 Binnensingel Westkant
665,Uitbreidingstraat 390,2023-02-07,01:00:00,3,1,2,FMN 18 Binnensingel Westkant
665,Uitbreidingstraat 390,2023-02-07,02:00:00,0,0,0,FMN 18 Binnensingel Westkant
665,Uitbreidingstraat 390,2023-02-07,03:00:00,4,4,0,FMN 18 Binnensingel Westkant
665,Uitbreidingstraat 390,2023-02-07,04:00:00,6,4,2,FMN 18 Binnensingel Westkant
665,Uitbreidingstraat 390,2023-02-07,05:00:00,23,19,4,FMN 18 Binnensingel Westkant
665,Uitbreidingstraat 390,2023-02-07,06:00:00,54,40,14,FMN 18 Binnensingel Westkant
665,Uitbreidingstraat 390,2023-02-07,07:00:00,198,158,40,FMN 18 Binnensingel Westkant
665,Uitbreidingstraat 390,2023-02-07,08:00:00,379,306,73,FMN 18 Binnensingel Westkant
665,Uitbreidingstraat 390,2023-02-07,09:00:00,146,121,25,FMN 18 Binnensingel Westkant
665,Uitbreidingstraat 390,2023-02-07,10:00:00,67,52,15,FMN 18 Binnensingel Westkant
665,Uitbreidingstraat 390,2023-02-07,11:00:00,71,54,17,FMN 18 Binnensingel Westkant
665,Uitbreidingstraat 390,2023-02-07,12:00:00,111,76,35,FMN 18 Binnensingel Westkant
665,Uitbreidingstraat 390,2023-02-07,13:00:00,89,71,18,FMN 18 Binnensingel Westkant
665,Uitbreidingstraat 390,2023-02-07,14:00:00,82,54,28,FMN 18 Binnensingel Westkant
665,Uitbreidingstraat 390,2023-02-07,15:00:00,150,57,93,FMN 18 Binnensingel Westkant
665,Uitbreidingstraat 390,2023-02-07,16:00:00,327,135,192,FMN 18 Binnensingel Westkant
665,Uitbreidingstraat 390,2023-02-07,17:00:00,286,140,146,FMN 18 Binnensingel Westkant
665,Uitbreidingstraat 390,2023-02-07,18:00:00,196,134,62,FMN 18 Binnensingel Westkant
665,Uitbreidingstraat 390,2023-02-07,19:00:00,100,76,24,FMN 18 Binnensingel Westkant
665,Uitbreidingstraat 390,2023-02-07,20:00:00,69,48,21,FMN 18 Binnensingel Westkant
665,Uitbreidingstraat 390,2023-02-07,21:00:00,50,29,21,FMN 18 Binnensingel Westkant
665,Uitbreidingstraat 390,2023-02-07,22:00:00,45,26,19,FMN 18 Binnensingel Westkant
665,Uitbreidingstraat 390,2023-02-07,23:00:00,28,22,6,FMN 18 Binnensingel Westkant
665,Uitbreidingstraat 390,2023-02-08,00:00:00,15,10,5,FMN 18 Binnensingel Westkant
665,Uitbreidingstraat 390,2023-02-08,01:00:00,2,1,1,FMN 18 Binnensingel Westkant
665,Uitbreidingstraat 390,2023-02-08,02:00:00,2,2,0,FMN 18 Binnensingel Westkant
665,Uitbreidingstraat 390,2023-02-08,03:00:00,3,3,0,FMN 18 Binnensingel Westkant
665,Uitbreidingstraat 390,2023-02-08,04:00:00,5,5,0,FMN 18 Binnensingel Westkant
665,Uitbreidingstraat 390,2023-02-08,05:00:00,22,20,2,FMN 18 Binnensingel Westkant
665,Uitbreidingstraat 390,2023-02-08,06:00:00,46,41,5,FMN 18 Binnensingel Westkant
665,Uitbreidingstraat 390,2023-02-08,07:00:00,160,130,30,FMN 18 Binnensingel Westkant
665,Uitbreidingstraat 390,2023-02-08,08:00:00,318,265,53,FMN 18 Binnensingel Westkant
665,Uitbreidingstraat 390,2023-02-08,09:00:00,129,111,18,FMN 18 Binnensingel Westkant
665,Uitbreidingstraat 390,2023-02-08,10:00:00,80,59,21,FMN 18 Binnensingel Westkant
665,Uitbreidingstraat 390,2023-02-08,11:00:00,72,41,31,FMN 18 Binnensingel Westkant
665,Uitbreidingstraat 390,2023-02-08,12:00:00,214,89,125,FMN 18 Binnensingel Westkant
665,Uitbreidingstraat 390,2023-02-08,13:00:00,186,85,101,FMN 18 Binnensingel Westkant
665,Uitbreidingstraat 390,2023-02-08,14:00:00,103,65,38,FMN 18 Binnensingel Westkant
665,Uitbreidingstraat 390,2023-02-08,15:00:00,121,62,59,FMN 18 Binnensingel Westkant
665,Uitbreidingstraat 390,2023-02-08,16:00:00,183,88,95,FMN 18 Binnensingel Westkant
665,Uitbreidingstraat 390,2023-02-08,17:00:00,226,141,85,FMN 18 Binnensingel Westkant
665,Uitbreidingstraat 390,2023-02-08,18:00:00,200,140,60,FMN 18 Binnensingel Westkant
665,Uitbreidingstraat 390,2023-02-08,19:00:00,94,71,23,FMN 18 Binnensingel Westkant
665,Uitbreidingstraat 390,2023-02-08,20:00:00,62,44,18,FMN 18 Binnensingel Westkant
665,Uitbreidingstraat 390,2023-02-08,21:00:00,57,32,25,FMN 18 Binnensingel Westkant
665,Uitbreidingstraat 390,2023-02-08,22:00:00,54,31,23,FMN 18 Binnensingel Westkant
665,Uitbreidingstraat 390,2023-02-08,23:00:00,33,26,7,FMN 18 Binnensingel Westkant
665,Uitbreidingstraat 390,2023-02-09,00:00:00,10,7,3,FMN 18 Binnensingel Westkant
665,Uitbreidingstraat 390,2023-02-09,01:00:00,5,3,2,FMN 18 Binnensingel Westkant
665,Uitbreidingstraat 390,2023-02-09,02:00:00,1,0,1,FMN 18 Binnensingel Westkant
665,Uitbreidingstraat 390,2023-02-09,03:00:00,3,3,0,FMN 18 Binnensingel Westkant
665,Uitbreidingstraat 390,2023-02-09,04:00:00,6,6,0,FMN 18 Binnensingel Westkant
665,Uitbreidingstraat 390,2023-02-09,05:00:00,26,25,1,FMN 18 Binnensingel Westkant
665,Uitbreidingstraat 390,2023-02-09,06:00:00,56,44,12,FMN 18 Binnensingel Westkant
665,Uitbreidingstraat 390,2023-02-09,07:00:00,176,142,34,FMN 18 Binnensingel Westkant
665,Uitbreidingstraat 390,2023-02-09,08:00:00,348,295,53,FMN 18 Binnensingel Westkant
665,Uitbreidingstraat 390,2023-02-09,09:00:00,128,107,21,FMN 18 Binnensingel Westkant
665,Uitbreidingstraat 390,2023-02-09,10:00:00,65,44,21,FMN 18 Binnensingel Westkant
665,Uitbreidingstraat 390,2023-02-09,11:00:00,53,30,23,FMN 18 Binnensingel Westkant
665,Uitbreidingstraat 390,2023-02-09,12:00:00,105,66,39,FMN 18 Binnensingel Westkant
665,Uitbreidingstraat 390,2023-02-09,13:00:00,85,68,17,FMN 18 Binnensingel Westkant
665,Uitbreidingstraat 390,2023-02-09,14:00:00,90,52,38,FMN 18 Binnensingel Westkant
665,Uitbreidingstraat 390,2023-02-09,15:00:00,142,54,88,FMN 18 Binnensingel Westkant
665,Uitbreidingstraat 390,2023-02-09,16:00:00,276,106,170,FMN 18 Binnensingel Westkant
665,Uitbreidingstraat 390,2023-02-09,17:00:00,238,123,115,FMN 18 Binnensingel Westkant
665,Uitbreidingstraat 390,2023-02-09,18:00:00,176,114,62,FMN 18 Binnensingel Westkant
665,Uitbreidingstraat 390,2023-02-09,19:00:00,104,73,31,FMN 18 Binnensingel Westkant
665,Uitbreidingstraat 390,2023-02-09,20:00:00,58,44,14,FMN 18 Binnensingel Westkant
665,Uitbreidingstraat 390,2023-02-09,21:00:00,51,31,20,FMN 18 Binnensingel Westkant
665,Uitbreidingstraat 390,2023-02-09,22:00:00,46,35,11,FMN 18 Binnensingel Westkant
665,Uitbreidingstraat 390,2023-02-09,23:00:00,37,32,5,FMN 18 Binnensingel Westkant
665,Uitbreidingstraat 390,2023-02-10,00:00:00,19,15,4,FMN 18 Binnensingel Westkant
665,Uitbreidingstraat 390,2023-02-10,01:00:00,10,7,3,FMN 18 Binnensingel Westkant
665,Uitbreidingstraat 390,2023-02-10,02:00:00,0,0,0,FMN 18 Binnensingel Westkant
665,Uitbreidingstraat 390,2023-02-10,03:00:00,3,3,0,FMN 18 Binnensingel Westkant
665,Uitbreidingstraat 390,2023-02-10,04:00:00,6,5,1,FMN 18 Binnensingel Westkant
665,Uitbreidingstraat 390,2023-02-10,05:00:00,31,27,4,FMN 18 Binnensingel Westkant
665,Uitbreidingstraat 390,2023-02-10,06:00:00,56,47,9,FMN 18 Binnensingel Westkant
665,Uitbreidingstraat 390,2023-02-10,07:00:00,155,128,27,FMN 18 Binnensingel Westkant
665,Uitbreidingstraat 390,2023-02-10,08:00:00,326,278,48,FMN 18 Binnensingel Westkant
665,Uitbreidingstraat 390,2023-02-10,09:00:00,117,94,23,FMN 18 Binnensingel Westkant
665,Uitbreidingstraat 390,2023-02-10,10:00:00,70,47,23,FMN 18 Binnensingel Westkant
665,Uitbreidingstraat 390,2023-02-10,11:00:00,64,45,19,FMN 18 Binnensingel Westkant
665,Uitbreidingstraat 390,2023-02-10,12:00:00,96,64,32,FMN 18 Binnensingel Westkant
665,Uitbreidingstraat 390,2023-02-10,13:00:00,84,63,21,FMN 18 Binnensingel Westkant
665,Uitbreidingstraat 390,2023-02-10,14:00:00,95,56,39,FMN 18 Binnensingel Westkant
665,Uitbreidingstraat 390,2023-02-10,15:00:00,154,65,89,FMN 18 Binnensingel Westkant
665,Uitbreidingstraat 390,2023-02-10,16:00:00,278,99,179,FMN 18 Binnensingel Westkant
665,Uitbreidingstraat 390,2023-02-10,17:00:00,175,106,69,FMN 18 Binnensingel Westkant
665,Uitbreidingstraat 390,2023-02-10,18:00:00,126,76,50,FMN 18 Binnensingel Westkant
665,Uitbreidingstraat 390,2023-02-10,19:00:00,96,73,23,FMN 18 Binnensingel Westkant
665,Uitbreidingstraat 390,2023-02-10,20:00:00,71,46,25,FMN 18 Binnensingel Westkant
665,Uitbreidingstraat 390,2023-02-10,21:00:00,41,27,14,FMN 18 Binnensingel Westkant
665,Uitbreidingstraat 390,2023-02-10,22:00:00,49,27,22,FMN 18 Binnensingel Westkant
665,Uitbreidingstraat 390,2023-02-10,23:00:00,37,32,5,FMN 18 Binnensingel Westkant
665,Uitbreidingstraat 390,2023-02-11,00:00:00,37,29,8,FMN 18 Binnensingel Westkant
665,Uitbreidingstraat 390,2023-02-11,01:00:00,41,34,7,FMN 18 Binnensingel Westkant
665,Uitbreidingstraat 390,2023-02-11,02:00:00,25,22,3,FMN 18 Binnensingel Westkant
665,Uitbreidingstraat 390,2023-02-11,03:00:00,19,13,6,FMN 18 Binnensingel Westkant
665,Uitbreidingstraat 390,2023-02-11,04:00:00,16,14,2,FMN 18 Binnensingel Westkant
665,Uitbreidingstraat 390,2023-02-11,05:00:00,23,18,5,FMN 18 Binnensingel Westkant
665,Uitbreidingstraat 390,2023-02-11,06:00:00,27,23,4,FMN 18 Binnensingel Westkant
665,Uitbreidingstraat 390,2023-02-11,07:00:00,11,9,2,FMN 18 Binnensingel Westkant
665,Uitbreidingstraat 390,2023-02-11,08:00:00,41,30,11,FMN 18 Binnensingel Westkant
665,Uitbreidingstraat 390,2023-02-11,09:00:00,81,58,23,FMN 18 Binnensingel Westkant
665,Uitbreidingstraat 390,2023-02-11,10:00:00,71,60,11,FMN 18 Binnensingel Westkant
665,Uitbreidingstraat 390,2023-02-11,11:00:00,78,43,35,FMN 18 Binnensingel Westkant
665,Uitbreidingstraat 390,2023-02-11,12:00:00,88,58,30,FMN 18 Binnensingel Westkant
665,Uitbreidingstraat 390,2023-02-11,13:00:00,77,51,26,FMN 18 Binnensingel Westkant
665,Uitbreidingstraat 390,2023-02-11,14:00:00,78,52,26,FMN 18 Binnensingel Westkant
665,Uitbreidingstraat 390,2023-02-11,15:00:00,73,44,29,FMN 18 Binnensingel Westkant
665,Uitbreidingstraat 390,2023-02-11,16:00:00,90,60,30,FMN 18 Binnensingel Westkant
665,Uitbreidingstraat 390,2023-02-11,17:00:00,78,54,24,FMN 18 Binnensingel Westkant
665,Uitbreidingstraat 390,2023-02-11,18:00:00,83,62,21,FMN 18 Binnensingel Westkant
665,Uitbreidingstraat 390,2023-02-11,19:00:00,64,46,18,FMN 18 Binnensingel Westkant
665,Uitbreidingstraat 390,2023-02-11,20:00:00,58,48,10,FMN 18 Binnensingel Westkant
665,Uitbreidingstraat 390,2023-02-11,21:00:00,31,23,8,FMN 18 Binnensingel Westkant
665,Uitbreidingstraat 390,2023-02-11,22:00:00,33,20,13,FMN 18 Binnensingel Westkant
665,Uitbreidingstraat 390,2023-02-11,23:00:00,31,24,7,FMN 18 Binnensingel Westkant
665,Uitbreidingstraat 390,2023-02-12,00:00:00,39,29,10,FMN 18 Binnensingel Westkant
665,Uitbreidingstraat 390,2023-02-12,01:00:00,29,27,2,FMN 18 Binnensingel Westkant
665,Uitbreidingstraat 390,2023-02-12,02:00:00,26,21,5,FMN 18 Binnensingel Westkant
665,Uitbreidingstraat 390,2023-02-12,03:00:00,20,18,2,FMN 18 Binnensingel Westkant
665,Uitbreidingstraat 390,2023-02-12,04:00:00,15,12,3,FMN 18 Binnensingel Westkant
665,Uitbreidingstraat 390,2023-02-12,05:00:00,7,5,2,FMN 18 Binnensingel Westkant
665,Uitbreidingstraat 390,2023-02-12,06:00:00,16,13,3,FMN 18 Binnensingel Westkant
665,Uitbreidingstraat 390,2023-02-12,07:00:00,13,11,2,FMN 18 Binnensingel Westkant
665,Uitbreidingstraat 390,2023-02-12,08:00:00,16,10,6,FMN 18 Binnensingel Westkant
665,Uitbreidingstraat 390,2023-02-12,09:00:00,44,30,14,FMN 18 Binnensingel Westkant
665,Uitbreidingstraat 390,2023-02-12,10:00:00,61,45,16,FMN 18 Binnensingel Westkant
665,Uitbreidingstraat 390,2023-02-12,11:00:00,56,41,15,FMN 18 Binnensingel Westkant
665,Uitbreidingstraat 390,2023-02-12,12:00:00,76,38,38,FMN 18 Binnensingel Westkant
665,Uitbreidingstraat 390,2023-02-12,13:00:00,59,44,15,FMN 18 Binnensingel Westkant
665,Uitbreidingstraat 390,2023-02-12,14:00:00,69,52,17,FMN 18 Binnensingel Westkant
665,Uitbreidingstraat 390,2023-02-12,15:00:00,65,45,20,FMN 18 Binnensingel Westkant
665,Uitbreidingstraat 390,2023-02-12,16:00:00,39,29,10,FMN 18 Binnensingel Westkant
665,Uitbreidingstraat 390,2023-02-12,17:00:00,64,42,22,FMN 18 Binnensingel Westkant
665,Uitbreidingstraat 390,2023-02-12,18:00:00,77,66,11,FMN 18 Binnensingel Westkant
665,Uitbreidingstraat 390,2023-02-12,19:00:00,52,37,15,FMN 18 Binnensingel Westkant
665,Uitbreidingstraat 390,2023-02-12,20:00:00,44,34,10,FMN 18 Binnensingel Westkant
665,Uitbreidingstraat 390,2023-02-12,21:00:00,53,29,24,FMN 18 Binnensingel Westkant
665,Uitbreidingstraat 390,2023-02-12,22:00:00,28,19,9,FMN 18 Binnensingel Westkant
665,Uitbreidingstraat 390,2023-02-12,23:00:00,12,9,3,FMN 18 Binnensingel Westkant
665,Uitbreidingstraat 390,2023-02-13,00:00:00,6,3,3,FMN 18 Binnensingel Westkant
665,Uitbreidingstraat 390,2023-02-13,01:00:00,1,1,0,FMN 18 Binnensingel Westkant
665,Uitbreidingstraat 390,2023-02-13,02:00:00,4,4,0,FMN 18 Binnensingel Westkant
665,Uitbreidingstraat 390,2023-02-13,03:00:00,1,1,0,FMN 18 Binnensingel Westkant
665,Uitbreidingstraat 390,2023-02-13,04:00:00,6,5,1,FMN 18 Binnensingel Westkant
665,Uitbreidingstraat 390,2023-02-13,05:00:00,29,28,1,FMN 18 Binnensingel Westkant
665,Uitbreidingstraat 390,2023-02-13,06:00:00,68,52,16,FMN 18 Binnensingel Westkant
665,Uitbreidingstraat 390,2023-02-13,07:00:00,217,182,35,FMN 18 Binnensingel Westkant
665,Uitbreidingstraat 390,2023-02-13,08:00:00,431,359,72,FMN 18 Binnensingel Westkant
665,Uitbreidingstraat 390,2023-02-13,09:00:00,162,134,28,FMN 18 Binnensingel Westkant
665,Uitbreidingstraat 390,2023-02-13,10:00:00,74,65,9,FMN 18 Binnensingel Westkant
665,Uitbreidingstraat 390,2023-02-13,11:00:00,65,47,18,FMN 18 Binnensingel Westkant
665,Uitbreidingstraat 390,2023-02-13,12:00:00,130,93,37,FMN 18 Binnensingel Westkant
665,Uitbreidingstraat 390,2023-02-13,13:00:00,130,100,30,FMN 18 Binnensingel Westkant
665,Uitbreidingstraat 390,2023-02-13,14:00:00,134,72,62,FMN 18 Binnensingel Westkant
665,Uitbreidingstraat 390,2023-02-13,15:00:00,199,80,119,FMN 18 Binnensingel Westkant
665,Uitbreidingstraat 390,2023-02-13,16:00:00,236,109,127,FMN 18 Binnensingel Westkant
665,Uitbreidingstraat 390,2023-02-13,17:00:00,262,139,123,FMN 18 Binnensingel Westkant
665,Uitbreidingstraat 390,2023-02-13,18:00:00,215,131,84,FMN 18 Binnensingel Westkant
665,Uitbreidingstraat 390,2023-02-13,19:00:00,100,71,29,FMN 18 Binnensingel Westkant
665,Uitbreidingstraat 390,2023-02-13,20:00:00,72,41,31,FMN 18 Binnensingel Westkant
665,Uitbreidingstraat 390,2023-02-13,21:00:00,50,26,24,FMN 18 Binnensingel Westkant
665,Uitbreidingstraat 390,2023-02-13,22:00:00,47,28,19,FMN 18 Binnensingel Westkant
665,Uitbreidingstraat 390,2023-02-13,23:00:00,15,8,7,FMN 18 Binnensingel Westkant
665,Uitbreidingstraat 390,2023-02-14,00:00:00,6,4,2,FMN 18 Binnensingel Westkant
665,Uitbreidingstraat 390,2023-02-14,01:00:00,6,6,0,FMN 18 Binnensingel Westkant
665,Uitbreidingstraat 390,2023-02-14,02:00:00,4,2,2,FMN 18 Binnensingel Westkant
665,Uitbreidingstraat 390,2023-02-14,03:00:00,2,2,0,FMN 18 Binnensingel Westkant
665,Uitbreidingstraat 390,2023-02-14,04:00:00,6,5,1,FMN 18 Binnensingel Westkant
665,Uitbreidingstraat 390,2023-02-14,05:00:00,34,31,3,FMN 18 Binnensingel Westkant
665,Uitbreidingstraat 390,2023-02-14,06:00:00,65,46,19,FMN 18 Binnensingel Westkant
665,Uitbreidingstraat 390,2023-02-14,07:00:00,268,221,47,FMN 18 Binnensingel Westkant
665,Uitbreidingstraat 390,2023-02-14,08:00:00,493,415,78,FMN 18 Binnensingel Westkant
665,Uitbreidingstraat 390,2023-02-14,09:00:00,170,143,27,FMN 18 Binnensingel Westkant
665,Uitbreidingstraat 390,2023-02-14,10:00:00,118,93,25,FMN 18 Binnensingel Westkant
665,Uitbreidingstraat 390,2023-02-14,11:00:00,69,49,20,FMN 18 Binnensingel Westkant
665,Uitbreidingstraat 390,2023-02-14,12:00:00,146,100,46,FMN 18 Binnensingel Westkant
665,Uitbreidingstraat 390,2023-02-14,13:00:00,167,114,53,FMN 18 Binnensingel Westkant
665,Uitbreidingstraat 390,2023-02-14,14:00:00,123,73,50,FMN 18 Binnensingel Westkant
665,Uitbreidingstraat 390,2023-02-14,15:00:00,200,92,108,FMN 18 Binnensingel Westkant
665,Uitbreidingstraat 390,2023-02-14,16:00:00,336,128,208,FMN 18 Binnensingel Westkant
665,Uitbreidingstraat 390,2023-02-14,17:00:00,306,169,137,FMN 18 Binnensingel Westkant
665,Uitbreidingstraat 390,2023-02-14,18:00:00,234,148,86,FMN 18 Binnensingel Westkant
665,Uitbreidingstraat 390,2023-02-14,19:00:00,115,84,31,FMN 18 Binnensingel Westkant
665,Uitbreidingstraat 390,2023-02-14,20:00:00,76,47,29,FMN 18 Binnensingel Westkant
665,Uitbreidingstraat 390,2023-02-14,21:00:00,65,40,25,FMN 18 Binnensingel Westkant
665,Uitbreidingstraat 390,2023-02-14,22:00:00,63,32,31,FMN 18 Binnensingel Westkant
665,Uitbreidingstraat 390,2023-02-14,23:00:00,36,26,10,FMN 18 Binnensingel Westkant
665,Uitbreidingstraat 390,2023-02-15,00:00:00,5,3,2,FMN 18 Binnensingel Westkant
665,Uitbreidingstraat 390,2023-02-15,01:00:00,6,5,1,FMN 18 Binnensingel Westkant
665,Uitbreidingstraat 390,2023-02-15,02:00:00,2,2,0,FMN 18 Binnensingel Westkant
665,Uitbreidingstraat 390,2023-02-15,03:00:00,9,9,0,FMN 18 Binnensingel Westkant
665,Uitbreidingstraat 390,2023-02-15,04:00:00,6,4,2,FMN 18 Binnensingel Westkant
665,Uitbreidingstraat 390,2023-02-15,05:00:00,40,36,4,FMN 18 Binnensingel Westkant
665,Uitbreidingstraat 390,2023-02-15,06:00:00,60,51,9,FMN 18 Binnensingel Westkant
665,Uitbreidingstraat 390,2023-02-15,07:00:00,203,169,34,FMN 18 Binnensingel Westkant
665,Uitbreidingstraat 390,2023-02-15,08:00:00,422,360,62,FMN 18 Binnensingel Westkant
665,Uitbreidingstraat 390,2023-02-15,09:00:00,152,136,16,FMN 18 Binnensingel Westkant
665,Uitbreidingstraat 390,2023-02-15,10:00:00,102,82,20,FMN 18 Binnensingel Westkant
665,Uitbreidingstraat 390,2023-02-15,11:00:00,73,42,31,FMN 18 Binnensingel Westkant
665,Uitbreidingstraat 390,2023-02-15,12:00:00,244,131,113,FMN 18 Binnensingel Westkant
665,Uitbreidingstraat 390,2023-02-15,13:00:00,149,113,36,FMN 18 Binnensingel Westkant
665,Uitbreidingstraat 390,2023-02-15,14:00:00,117,83,34,FMN 18 Binnensingel Westkant
665,Uitbreidingstraat 390,2023-02-15,15:00:00,141,79,62,FMN 18 Binnensingel Westkant
665,Uitbreidingstraat 390,2023-02-15,16:00:00,205,99,106,FMN 18 Binnensingel Westkant
665,Uitbreidingstraat 390,2023-02-15,17:00:00,274,168,106,FMN 18 Binnensingel Westkant
665,Uitbreidingstraat 390,2023-02-15,18:00:00,213,135,78,FMN 18 Binnensingel Westkant
665,Uitbreidingstraat 390,2023-02-15,19:00:00,120,77,43,FMN 18 Binnensingel Westkant
665,Uitbreidingstraat 390,2023-02-15,20:00:00,78,49,29,FMN 18 Binnensingel Westkant
665,Uitbreidingstraat 390,2023-02-15,21:00:00,58,29,29,FMN 18 Binnensingel Westkant
665,Uitbreidingstraat 390,2023-02-15,22:00:00,81,53,28,FMN 18 Binnensingel Westkant
665,Uitbreidingstraat 390,2023-02-15,23:00:00,37,29,8,FMN 18 Binnensingel Westkant
665,Uitbreidingstraat 390,2023-02-16,00:00:00,17,15,2,FMN 18 Binnensingel Westkant
665,Uitbreidingstraat 390,2023-02-16,01:00:00,3,2,1,FMN 18 Binnensingel Westkant
665,Uitbreidingstraat 390,2023-02-16,02:00:00,1,1,0,FMN 18 Binnensingel Westkant
665,Uitbreidingstraat 390,2023-02-16,03:00:00,1,1,0,FMN 18 Binnensingel Westkant
665,Uitbreidingstraat 390,2023-02-16,04:00:00,6,5,1,FMN 18 Binnensingel Westkant
665,Uitbreidingstraat 390,2023-02-16,05:00:00,39,36,3,FMN 18 Binnensingel Westkant
665,Uitbreidingstraat 390,2023-02-16,06:00:00,55,41,14,FMN 18 Binnensingel Westkant
665,Uitbreidingstraat 390,2023-02-16,07:00:00,226,193,33,FMN 18 Binnensingel Westkant
665,Uitbreidingstraat 390,2023-02-16,08:00:00,438,359,79,FMN 18 Binnensingel Westkant
665,Uitbreidingstraat 390,2023-02-16,09:00:00,171,137,34,FMN 18 Binnensingel Westkant
665,Uitbreidingstraat 390,2023-02-16,10:00:00,81,66,15,FMN 18 Binnensingel Westkant
665,Uitbreidingstraat 390,2023-02-16,11:00:00,62,42,20,FMN 18 Binnensingel Westkant
665,Uitbreidingstraat 390,2023-02-16,12:00:00,106,76,30,FMN 18 Binnensingel Westkant
665,Uitbreidingstraat 390,2023-02-16,13:00:00,116,83,33,FMN 18 Binnensingel Westkant
665,Uitbreidingstraat 390,2023-02-16,14:00:00,89,54,35,FMN 18 Binnensingel Westkant
665,Uitbreidingstraat 390,2023-02-16,15:00:00,172,90,82,FMN 18 Binnensingel Westkant
665,Uitbreidingstraat 390,2023-02-16,16:00:00,280,114,166,FMN 18 Binnensingel Westkant
665,Uitbreidingstraat 390,2023-02-16,17:00:00,259,141,118,FMN 18 Binnensingel Westkant
665,Uitbreidingstraat 390,2023-02-16,18:00:00,224,145,79,FMN 18 Binnensingel Westkant
665,Uitbreidingstraat 390,2023-02-16,19:00:00,134,77,57,FMN 18 Binnensingel Westkant
665,Uitbreidingstraat 390,2023-02-16,20:00:00,81,55,26,FMN 18 Binnensingel Westkant
665,Uitbreidingstraat 390,2023-02-16,21:00:00,63,43,20,FMN 18 Binnensingel Westkant
665,Uitbreidingstraat 390,2023-02-16,22:00:00,46,27,19,FMN 18 Binnensingel Westkant
665,Uitbreidingstraat 390,2023-02-16,23:00:00,44,33,11,FMN 18 Binnensingel Westkant
665,Uitbreidingstraat 390,2023-02-17,00:00:00,20,13,7,FMN 18 Binnensingel Westkant
665,Uitbreidingstraat 390,2023-02-17,01:00:00,13,12,1,FMN 18 Binnensingel Westkant
665,Uitbreidingstraat 390,2023-02-17,02:00:00,4,3,1,FMN 18 Binnensingel Westkant
665,Uitbreidingstraat 390,2023-02-17,03:00:00,7,5,2,FMN 18 Binnensingel Westkant
665,Uitbreidingstraat 390,2023-02-17,04:00:00,9,6,3,FMN 18 Binnensingel Westkant
665,Uitbreidingstraat 390,2023-02-17,05:00:00,27,25,2,FMN 18 Binnensingel Westkant
665,Uitbreidingstraat 390,2023-02-17,06:00:00,50,39,11,FMN 18 Binnensingel Westkant
665,Uitbreidingstraat 390,2023-02-17,07:00:00,202,180,22,FMN 18 Binnensingel Westkant
665,Uitbreidingstraat 390,2023-02-17,08:00:00,374,321,53,FMN 18 Binnensingel Westkant
665,Uitbreidingstraat 390,2023-02-17,09:00:00,136,102,34,FMN 18 Binnensingel Westkant
665,Uitbreidingstraat 390,2023-02-17,10:00:00,112,87,25,FMN 18 Binnensingel Westkant
665,Uitbreidingstraat 390,2023-02-17,11:00:00,74,37,37,FMN 18 Binnensingel Westkant
665,Uitbreidingstraat 390,2023-02-17,12:00:00,108,74,34,FMN 18 Binnensingel Westkant
665,Uitbreidingstraat 390,2023-02-17,13:00:00,124,81,43,FMN 18 Binnensingel Westkant
665,Uitbreidingstraat 390,2023-02-17,14:00:00,101,52,49,FMN 18 Binnensingel Westkant
665,Uitbreidingstraat 390,2023-02-17,15:00:00,192,98,94,FMN 18 Binnensingel Westkant
665,Uitbreidingstraat 390,2023-02-17,16:00:00,266,104,162,FMN 18 Binnensingel Westkant
665,Uitbreidingstraat 390,2023-02-17,17:00:00,194,105,89,FMN 18 Binnensingel Westkant
665,Uitbreidingstraat 390,2023-02-17,18:00:00,150,99,51,FMN 18 Binnensingel Westkant
665,Uitbreidingstraat 390,2023-02-17,19:00:00,89,62,27,FMN 18 Binnensingel Westkant
665,Uitbreidingstraat 390,2023-02-17,20:00:00,54,28,26,FMN 18 Binnensingel Westkant
665,Uitbreidingstraat 390,2023-02-17,21:00:00,66,42,24,FMN 18 Binnensingel Westkant
665,Uitbreidingstraat 390,2023-02-17,22:00:00,50,31,19,FMN 18 Binnensingel Westkant
665,Uitbreidingstraat 390,2023-02-17,23:00:00,54,41,13,FMN 18 Binnensingel Westkant
665,Uitbreidingstraat 390,2023-02-18,00:00:00,35,28,7,FMN 18 Binnensingel Westkant
665,Uitbreidingstraat 390,2023-02-18,01:00:00,23,18,5,FMN 18 Binnensingel Westkant
665,Uitbreidingstraat 390,2023-02-18,02:00:00,20,18,2,FMN 18 Binnensingel Westkant
665,Uitbreidingstraat 390,2023-02-18,03:00:00,23,21,2,FMN 18 Binnensingel Westkant
665,Uitbreidingstraat 390,2023-02-18,04:00:00,13,11,2,FMN 18 Binnensingel Westkant
665,Uitbreidingstraat 390,2023-02-18,05:00:00,8,8,0,FMN 18 Binnensingel Westkant
665,Uitbreidingstraat 390,2023-02-18,06:00:00,16,12,4,FMN 18 Binnensingel Westkant
665,Uitbreidingstraat 390,2023-02-18,07:00:00,15,10,5,FMN 18 Binnensingel Westkant
665,Uitbreidingstraat 390,2023-02-18,08:00:00,35,23,12,FMN 18 Binnensingel Westkant
665,Uitbreidingstraat 390,2023-02-18,09:00:00,62,40,22,FMN 18 Binnensingel Westkant
665,Uitbreidingstraat 390,2023-02-18,10:00:00,56,43,13,FMN 18 Binnensingel Westkant
665,Uitbreidingstraat 390,2023-02-18,11:00:00,52,35,17,FMN 18 Binnensingel Westkant
665,Uitbreidingstraat 390,2023-02-18,12:00:00,91,54,37,FMN 18 Binnensingel Westkant
665,Uitbreidingstraat 390,2023-02-18,13:00:00,74,50,24,FMN 18 Binnensingel Westkant
665,Uitbreidingstraat 390,2023-02-18,14:00:00,73,44,29,FMN 18 Binnensingel Westkant
665,Uitbreidingstraat 390,2023-02-18,15:00:00,65,43,22,FMN 18 Binnensingel Westkant
665,Uitbreidingstraat 390,2023-02-18,16:00:00,64,44,20,FMN 18 Binnensingel Westkant
665,Uitbreidingstraat 390,2023-02-18,17:00:00,79,55,24,FMN 18 Binnensingel Westkant
665,Uitbreidingstraat 390,2023-02-18,18:00:00,84,64,20,FMN 18 Binnensingel Westkant
665,Uitbreidingstraat 390,2023-02-18,19:00:00,74,57,17,FMN 18 Binnensingel Westkant
665,Uitbreidingstraat 390,2023-02-18,20:00:00,51,37,14,FMN 18 Binnensingel Westkant
665,Uitbreidingstraat 390,2023-02-18,21:00:00,38,28,10,FMN 18 Binnensingel Westkant
665,Uitbreidingstraat 390,2023-02-18,22:00:00,38,26,12,FMN 18 Binnensingel Westkant
665,Uitbreidingstraat 390,2023-02-18,23:00:00,35,26,9,FMN 18 Binnensingel Westkant
665,Uitbreidingstraat 390,2023-02-19,00:00:00,28,21,7,FMN 18 Binnensingel Westkant
665,Uitbreidingstraat 390,2023-02-19,01:00:00,25,19,6,FMN 18 Binnensingel Westkant
665,Uitbreidingstraat 390,2023-02-19,02:00:00,14,10,4,FMN 18 Binnensingel Westkant
665,Uitbreidingstraat 390,2023-02-19,03:00:00,14,13,1,FMN 18 Binnensingel Westkant
665,Uitbreidingstraat 390,2023-02-19,04:00:00,6,5,1,FMN 18 Binnensingel Westkant
665,Uitbreidingstraat 390,2023-02-19,05:00:00,4,3,1,FMN 18 Binnensingel Westkant
665,Uitbreidingstraat 390,2023-02-19,06:00:00,22,16,6,FMN 18 Binnensingel Westkant
665,Uitbreidingstraat 390,2023-02-19,07:00:00,15,11,4,FMN 18 Binnensingel Westkant
665,Uitbreidingstraat 390,2023-02-19,08:00:00,20,17,3,FMN 18 Binnensingel Westkant
665,Uitbreidingstraat 390,2023-02-19,09:00:00,47,38,9,FMN 18 Binnensingel Westkant
665,Uitbreidingstraat 390,2023-02-19,10:00:00,45,36,9,FMN 18 Binnensingel Westkant
665,Uitbreidingstraat 390,2023-02-19,11:00:00,75,53,22,FMN 18 Binnensingel Westkant
665,Uitbreidingstraat 390,2023-02-19,12:00:00,73,49,24,FMN 18 Binnensingel Westkant
665,Uitbreidingstraat 390,2023-02-19,13:00:00,56,43,13,FMN 18 Binnensingel Westkant
665,Uitbreidingstraat 390,2023-02-19,14:00:00,87,69,18,FMN 18 Binnensingel Westkant
665,Uitbreidingstraat 390,2023-02-19,15:00:00,66,44,22,FMN 18 Binnensingel Westkant
665,Uitbreidingstraat 390,2023-02-19,16:00:00,67,51,16,FMN 18 Binnensingel Westkant
665,Uitbreidingstraat 390,2023-02-19,17:00:00,70,49,21,FMN 18 Binnensingel Westkant
665,Uitbreidingstraat 390,2023-02-19,18:00:00,79,56,23,FMN 18 Binnensingel Westkant
665,Uitbreidingstraat 390,2023-02-19,19:00:00,56,38,18,FMN 18 Binnensingel Westkant
665,Uitbreidingstraat 390,2023-02-19,20:00:00,57,42,15,FMN 18 Binnensingel Westkant
665,Uitbreidingstraat 390,2023-02-19,21:00:00,39,28,11,FMN 18 Binnensingel Westkant
665,Uitbreidingstraat 390,2023-02-19,22:00:00,43,32,11,FMN 18 Binnensingel Westkant
665,Uitbreidingstraat 390,2023-02-19,23:00:00,22,18,4,FMN 18 Binnensingel Westkant
665,Uitbreidingstraat 390,2023-02-20,00:00:00,9,9,0,FMN 18 Binnensingel Westkant
665,Uitbreidingstraat 390,2023-02-20,01:00:00,3,3,0,FMN 18 Binnensingel Westkant
665,Uitbreidingstraat 390,2023-02-20,02:00:00,3,2,1,FMN 18 Binnensingel Westkant
665,Uitbreidingstraat 390,2023-02-20,03:00:00,3,3,0,FMN 18 Binnensingel Westkant
665,Uitbreidingstraat 390,2023-02-20,04:00:00,11,9,2,FMN 18 Binnensingel Westkant
665,Uitbreidingstraat 390,2023-02-20,05:00:00,28,27,1,FMN 18 Binnensingel Westkant
665,Uitbreidingstraat 390,2023-02-20,06:00:00,56,40,16,FMN 18 Binnensingel Westkant
665,Uitbreidingstraat 390,2023-02-20,07:00:00,176,150,26,FMN 18 Binnensingel Westkant
665,Uitbreidingstraat 390,2023-02-20,08:00:00,269,241,28,FMN 18 Binnensingel Westkant
665,Uitbreidingstraat 390,2023-02-20,09:00:00,107,88,19,FMN 18 Binnensingel Westkant
665,Uitbreidingstraat 390,2023-02-20,10:00:00,78,62,16,FMN 18 Binnensingel Westkant
665,Uitbreidingstraat 390,2023-02-20,11:00:00,61,43,18,FMN 18 Binnensingel Westkant
665,Uitbreidingstraat 390,2023-02-20,12:00:00,74,50,24,FMN 18 Binnensingel Westkant
665,Uitbreidingstraat 390,2023-02-20,13:00:00,103,72,31,FMN 18 Binnensingel Westkant
665,Uitbreidingstraat 390,2023-02-20,14:00:00,83,49,34,FMN 18 Binnensingel Westkant
665,Uitbreidingstraat 390,2023-02-20,15:00:00,103,57,46,FMN 18 Binnensingel Westkant
665,Uitbreidingstraat 390,2023-02-20,16:00:00,164,80,84,FMN 18 Binnensingel Westkant
665,Uitbreidingstraat 390,2023-02-20,17:00:00,233,129,104,FMN 18 Binnensingel Westkant
665,Uitbreidingstraat 390,2023-02-20,18:00:00,188,112,76,FMN 18 Binnensingel Westkant
665,Uitbreidingstraat 390,2023-02-20,19:00:00,92,58,34,FMN 18 Binnensingel Westkant
665,Uitbreidingstraat 390,2023-02-20,20:00:00,49,29,20,FMN 18 Binnensingel Westkant
665,Uitbreidingstraat 390,2023-02-20,21:00:00,42,29,13,FMN 18 Binnensingel Westkant
665,Uitbreidingstraat 390,2023-02-20,22:00:00,28,22,6,FMN 18 Binnensingel Westkant
665,Uitbreidingstraat 390,2023-02-20,23:00:00,17,14,3,FMN 18 Binnensingel Westkant
665,Uitbreidingstraat 390,2023-02-21,00:00:00,8,8,0,FMN 18 Binnensingel Westkant
665,Uitbreidingstraat 390,2023-02-21,01:00:00,9,9,0,FMN 18 Binnensingel Westkant
665,Uitbreidingstraat 390,2023-02-21,02:00:00,0,0,0,FMN 18 Binnensingel Westkant
665,Uitbreidingstraat 390,2023-02-21,03:00:00,5,5,0,FMN 18 Binnensingel Westkant
665,Uitbreidingstraat 390,2023-02-21,04:00:00,3,2,1,FMN 18 Binnensingel Westkant
665,Uitbreidingstraat 390,2023-02-21,05:00:00,26,23,3,FMN 18 Binnensingel Westkant
665,Uitbreidingstraat 390,2023-02-21,06:00:00,53,38,15,FMN 18 Binnensingel Westkant
665,Uitbreidingstraat 390,2023-02-21,07:00:00,184,156,28,FMN 18 Binnensingel Westkant
665,Uitbreidingstraat 390,2023-02-21,08:00:00,307,258,49,FMN 18 Binnensingel Westkant
665,Uitbreidingstraat 390,2023-02-21,09:00:00,117,89,28,FMN 18 Binnensingel Westkant
665,Uitbreidingstraat 390,2023-02-21,10:00:00,79,67,12,FMN 18 Binnensingel Westkant
665,Uitbreidingstraat 390,2023-02-21,11:00:00,79,56,23,FMN 18 Binnensingel Westkant
665,Uitbreidingstraat 390,2023-02-21,12:00:00,94,68,26,FMN 18 Binnensingel Westkant
665,Uitbreidingstraat 390,2023-02-21,13:00:00,116,84,32,FMN 18 Binnensingel Westkant
665,Uitbreidingstraat 390,2023-02-21,14:00:00,89,64,25,FMN 18 Binnensingel Westkant
665,Uitbreidingstraat 390,2023-02-21,15:00:00,107,62,45,FMN 18 Binnensingel Westkant
665,Uitbreidingstraat 390,2023-02-21,16:00:00,173,90,83,FMN 18 Binnensingel Westkant
665,Uitbreidingstraat 390,2023-02-21,17:00:00,235,139,96,FMN 18 Binnensingel Westkant
665,Uitbreidingstraat 390,2023-02-21,18:00:00,182,118,64,FMN 18 Binnensingel Westkant
665,Uitbreidingstraat 390,2023-02-21,19:00:00,101,72,29,FMN 18 Binnensingel Westkant
665,Uitbreidingstraat 390,2023-02-21,20:00:00,65,45,20,FMN 18 Binnensingel Westkant
665,Uitbreidingstraat 390,2023-02-21,21:00:00,35,22,13,FMN 18 Binnensingel Westkant
665,Uitbreidingstraat 390,2023-02-21,22:00:00,44,28,16,FMN 18 Binnensingel Westkant
665,Uitbreidingstraat 390,2023-02-21,23:00:00,23,16,7,FMN 18 Binnensingel Westkant
665,Uitbreidingstraat 390,2023-02-22,00:00:00,10,9,1,FMN 18 Binnensingel Westkant
665,Uitbreidingstraat 390,2023-02-22,01:00:00,7,6,1,FMN 18 Binnensingel Westkant
665,Uitbreidingstraat 390,2023-02-22,02:00:00,3,3,0,FMN 18 Binnensingel Westkant
665,Uitbreidingstraat 390,2023-02-22,03:00:00,1,1,0,FMN 18 Binnensingel Westkant
665,Uitbreidingstraat 390,2023-02-22,04:00:00,9,7,2,FMN 18 Binnensingel Westkant
665,Uitbreidingstraat 390,2023-02-22,05:00:00,25,25,0,FMN 18 Binnensingel Westkant
665,Uitbreidingstraat 390,2023-02-22,06:00:00,43,36,7,FMN 18 Binnensingel Westkant
665,Uitbreidingstraat 390,2023-02-22,07:00:00,149,124,25,FMN 18 Binnensingel Westkant
665,Uitbreidingstraat 390,2023-02-22,08:00:00,236,199,37,FMN 18 Binnensingel Westkant
665,Uitbreidingstraat 390,2023-02-22,09:00:00,113,90,23,FMN 18 Binnensingel Westkant
665,Uitbreidingstraat 390,2023-02-22,10:00:00,84,62,22,FMN 18 Binnensingel Westkant
665,Uitbreidingstraat 390,2023-02-22,11:00:00,55,44,11,FMN 18 Binnensingel Westkant
665,Uitbreidingstraat 390,2023-02-22,12:00:00,89,62,27,FMN 18 Binnensingel Westkant
665,Uitbreidingstraat 390,2023-02-22,13:00:00,95,78,17,FMN 18 Binnensingel Westkant
665,Uitbreidingstraat 390,2023-02-22,14:00:00,71,49,22,FMN 18 Binnensingel Westkant
665,Uitbreidingstraat 390,2023-02-22,15:00:00,94,49,45,FMN 18 Binnensingel Westkant
665,Uitbreidingstraat 390,2023-02-22,16:00:00,153,74,79,FMN 18 Binnensingel Westkant
665,Uitbreidingstraat 390,2023-02-22,17:00:00,213,121,92,FMN 18 Binnensingel Westkant
665,Uitbreidingstraat 390,2023-02-22,18:00:00,133,67,66,FMN 18 Binnensingel Westkant
665,Uitbreidingstraat 390,2023-02-22,19:00:00,83,57,26,FMN 18 Binnensingel Westkant
665,Uitbreidingstraat 390,2023-02-22,20:00:00,54,33,21,FMN 18 Binnensingel Westkant
665,Uitbreidingstraat 390,2023-02-22,21:00:00,30,15,15,FMN 18 Binnensingel Westkant
665,Uitbreidingstraat 390,2023-02-22,22:00:00,57,35,22,FMN 18 Binnensingel Westkant
665,Uitbreidingstraat 390,2023-02-22,23:00:00,19,16,3,FMN 18 Binnensingel Westkant
665,Uitbreidingstraat 390,2023-02-23,00:00:00,12,11,1,FMN 18 Binnensingel Westkant
665,Uitbreidingstraat 390,2023-02-23,01:00:00,5,2,3,FMN 18 Binnensingel Westkant
665,Uitbreidingstraat 390,2023-02-23,02:00:00,1,1,0,FMN 18 Binnensingel Westkant
665,Uitbreidingstraat 390,2023-02-23,03:00:00,4,4,0,FMN 18 Binnensingel Westkant
665,Uitbreidingstraat 390,2023-02-23,04:00:00,3,3,0,FMN 18 Binnensingel Westkant
665,Uitbreidingstraat 390,2023-02-23,05:00:00,35,30,5,FMN 18 Binnensingel Westkant
665,Uitbreidingstraat 390,2023-02-23,06:00:00,51,39,12,FMN 18 Binnensingel Westkant
665,Uitbreidingstraat 390,2023-02-23,07:00:00,166,137,29,FMN 18 Binnensingel Westkant
665,Uitbreidingstraat 390,2023-02-23,08:00:00,251,213,38,FMN 18 Binnensingel Westkant
665,Uitbreidingstraat 390,2023-02-23,09:00:00,131,104,27,FMN 18 Binnensingel Westkant
665,Uitbreidingstraat 390,2023-02-23,10:00:00,87,73,14,FMN 18 Binnensingel Westkant
665,Uitbreidingstraat 390,2023-02-23,11:00:00,61,44,17,FMN 18 Binnensingel Westkant
665,Uitbreidingstraat 390,2023-02-23,12:00:00,91,65,26,FMN 18 Binnensingel Westkant
665,Uitbreidingstraat 390,2023-02-23,13:00:00,109,84,25,FMN 18 Binnensingel Westkant
665,Uitbreidingstraat 390,2023-02-23,14:00:00,78,49,29,FMN 18 Binnensingel Westkant
665,Uitbreidingstraat 390,2023-02-23,15:00:00,130,77,53,FMN 18 Binnensingel Westkant
665,Uitbreidingstraat 390,2023-02-23,16:00:00,162,81,81,FMN 18 Binnensingel Westkant
665,Uitbreidingstraat 390,2023-02-23,17:00:00,193,93,100,FMN 18 Binnensingel Westkant
665,Uitbreidingstraat 390,2023-02-23,18:00:00,186,126,60,FMN 18 Binnensingel Westkant
665,Uitbreidingstraat 390,2023-02-23,19:00:00,136,94,42,FMN 18 Binnensingel Westkant
665,Uitbreidingstraat 390,2023-02-23,20:00:00,68,43,25,FMN 18 Binnensingel Westkant
665,Uitbreidingstraat 390,2023-02-23,21:00:00,61,37,24,FMN 18 Binnensingel Westkant
665,Uitbreidingstraat 390,2023-02-23,22:00:00,71,52,19,FMN 18 Binnensingel Westkant
665,Uitbreidingstraat 390,2023-02-23,23:00:00,36,30,6,FMN 18 Binnensingel Westkant
665,Uitbreidingstraat 390,2023-02-24,00:00:00,28,25,3,FMN 18 Binnensingel Westkant
665,Uitbreidingstraat 390,2023-02-24,01:00:00,10,8,2,FMN 18 Binnensingel Westkant
665,Uitbreidingstraat 390,2023-02-24,02:00:00,7,7,0,FMN 18 Binnensingel Westkant
665,Uitbreidingstraat 390,2023-02-24,03:00:00,4,4,0,FMN 18 Binnensingel Westkant
665,Uitbreidingstraat 390,2023-02-24,04:00:00,5,5,0,FMN 18 Binnensingel Westkant
665,Uitbreidingstraat 390,2023-02-24,05:00:00,32,30,2,FMN 18 Binnensingel Westkant
665,Uitbreidingstraat 390,2023-02-24,06:00:00,48,41,7,FMN 18 Binnensingel Westkant
665,Uitbreidingstraat 390,2023-02-24,07:00:00,141,121,20,FMN 18 Binnensingel Westkant
665,Uitbreidingstraat 390,2023-02-24,08:00:00,205,183,22,FMN 18 Binnensingel Westkant
665,Uitbreidingstraat 390,2023-02-24,09:00:00,115,87,28,FMN 18 Binnensingel Westkant
665,Uitbreidingstraat 390,2023-02-24,10:00:00,103,86,17,FMN 18 Binnensingel Westkant
665,Uitbreidingstraat 390,2023-02-24,11:00:00,53,32,21,FMN 18 Binnensingel Westkant
665,Uitbreidingstraat 390,2023-02-24,12:00:00,79,46,33,FMN 18 Binnensingel Westkant
665,Uitbreidingstraat 390,2023-02-24,13:00:00,110,78,32,FMN 18 Binnensingel Westkant
665,Uitbreidingstraat 390,2023-02-24,14:00:00,78,45,33,FMN 18 Binnensingel Westkant
665,Uitbreidingstraat 390,2023-02-24,15:00:00,114,74,40,FMN 18 Binnensingel Westkant
665,Uitbreidingstraat 390,2023-02-24,16:00:00,140,82,58,FMN 18 Binnensingel Westkant
665,Uitbreidingstraat 390,2023-02-24,17:00:00,150,84,66,FMN 18 Binnensingel Westkant
665,Uitbreidingstraat 390,2023-02-24,18:00:00,120,77,43,FMN 18 Binnensingel Westkant
665,Uitbreidingstraat 390,2023-02-24,19:00:00,99,74,25,FMN 18 Binnensingel Westkant
665,Uitbreidingstraat 390,2023-02-24,20:00:00,58,41,17,FMN 18 Binnensingel Westkant
665,Uitbreidingstraat 390,2023-02-24,21:00:00,47,30,17,FMN 18 Binnensingel Westkant
665,Uitbreidingstraat 390,2023-02-24,22:00:00,44,31,13,FMN 18 Binnensingel Westkant
665,Uitbreidingstraat 390,2023-02-24,23:00:00,57,44,13,FMN 18 Binnensingel Westkant
665,Uitbreidingstraat 390,2023-02-25,00:00:00,29,25,4,FMN 18 Binnensingel Westkant
665,Uitbreidingstraat 390,2023-02-25,01:00:00,18,13,5,FMN 18 Binnensingel Westkant
665,Uitbreidingstraat 390,2023-02-25,02:00:00,27,26,1,FMN 18 Binnensingel Westkant
665,Uitbreidingstraat 390,2023-02-25,03:00:00,18,15,3,FMN 18 Binnensingel Westkant
665,Uitbreidingstraat 390,2023-02-25,04:00:00,11,8,3,FMN 18 Binnensingel Westkant
665,Uitbreidingstraat 390,2023-02-25,05:00:00,14,13,1,FMN 18 Binnensingel Westkant
665,Uitbreidingstraat 390,2023-02-25,06:00:00,20,15,5,FMN 18 Binnensingel Westkant
665,Uitbreidingstraat 390,2023-02-25,07:00:00,22,16,6,FMN 18 Binnensingel Westkant
665,Uitbreidingstraat 390,2023-02-25,08:00:00,36,28,8,FMN 18 Binnensingel Westkant
665,Uitbreidingstraat 390,2023-02-25,09:00:00,54,41,13,FMN 18 Binnensingel Westkant
665,Uitbreidingstraat 390,2023-02-25,10:00:00,50,33,17,FMN 18 Binnensingel Westkant
665,Uitbreidingstraat 390,2023-02-25,11:00:00,65,41,24,FMN 18 Binnensingel Westkant
665,Uitbreidingstraat 390,2023-02-25,12:00:00,57,37,20,FMN 18 Binnensingel Westkant
665,Uitbreidingstraat 390,2023-02-25,13:00:00,70,47,23,FMN 18 Binnensingel Westkant
665,Uitbreidingstraat 390,2023-02-25,14:00:00,67,45,22,FMN 18 Binnensingel Westkant
665,Uitbreidingstraat 390,2023-02-25,15:00:00,83,61,22,FMN 18 Binnensingel Westkant
665,Uitbreidingstraat 390,2023-02-25,16:00:00,63,49,14,FMN 18 Binnensingel Westkant
665,Uitbreidingstraat 390,2023-02-25,17:00:00,92,63,29,FMN 18 Binnensingel Westkant
665,Uitbreidingstraat 390,2023-02-25,18:00:00,78,63,15,FMN 18 Binnensingel Westkant
665,Uitbreidingstraat 390,2023-02-25,19:00:00,61,51,10,FMN 18 Binnensingel Westkant
665,Uitbreidingstraat 390,2023-02-25,20:00:00,64,54,10,FMN 18 Binnensingel Westkant
665,Uitbreidingstraat 390,2023-02-25,21:00:00,31,25,6,FMN 18 Binnensingel Westkant
665,Uitbreidingstraat 390,2023-02-25,22:00:00,35,29,6,FMN 18 Binnensingel Westkant
665,Uitbreidingstraat 390,2023-02-25,23:00:00,37,28,9,FMN 18 Binnensingel Westkant
665,Uitbreidingstraat 390,2023-02-26,00:00:00,35,29,6,FMN 18 Binnensingel Westkant
665,Uitbreidingstraat 390,2023-02-26,01:00:00,21,17,4,FMN 18 Binnensingel Westkant
665,Uitbreidingstraat 390,2023-02-26,02:00:00,14,12,2,FMN 18 Binnensingel Westkant
665,Uitbreidingstraat 390,2023-02-26,03:00:00,15,12,3,FMN 18 Binnensingel Westkant
665,Uitbreidingstraat 390,2023-02-26,04:00:00,11,11,0,FMN 18 Binnensingel Westkant
665,Uitbreidingstraat 390,2023-02-26,05:00:00,15,11,4,FMN 18 Binnensingel Westkant
665,Uitbreidingstraat 390,2023-02-26,06:00:00,16,12,4,FMN 18 Binnensingel Westkant
665,Uitbreidingstraat 390,2023-02-26,07:00:00,6,4,2,FMN 18 Binnensingel Westkant
665,Uitbreidingstraat 390,2023-02-26,08:00:00,18,10,8,FMN 18 Binnensingel Westkant
665,Uitbreidingstraat 390,2023-02-26,09:00:00,40,21,19,FMN 18 Binnensingel Westkant
665,Uitbreidingstraat 390,2023-02-26,10:00:00,56,32,24,FMN 18 Binnensingel Westkant
665,Uitbreidingstraat 390,2023-02-26,11:00:00,67,46,21,FMN 18 Binnensingel Westkant
665,Uitbreidingstraat 390,2023-02-26,12:00:00,66,49,17,FMN 18 Binnensingel Westkant
665,Uitbreidingstraat 390,2023-02-26,13:00:00,62,45,17,FMN 18 Binnensingel Westkant
665,Uitbreidingstraat 390,2023-02-26,14:00:00,73,57,16,FMN 18 Binnensingel Westkant
665,Uitbreidingstraat 390,2023-02-26,15:00:00,66,50,16,FMN 18 Binnensingel Westkant
665,Uitbreidingstraat 390,2023-02-26,16:00:00,62,41,21,FMN 18 Binnensingel Westkant
665,Uitbreidingstraat 390,2023-02-26,17:00:00,59,43,16,FMN 18 Binnensingel Westkant
665,Uitbreidingstraat 390,2023-02-26,18:00:00,66,48,18,FMN 18 Binnensingel Westkant
665,Uitbreidingstraat 390,2023-02-26,19:00:00,46,33,13,FMN 18 Binnensingel Westkant
665,Uitbreidingstraat 390,2023-02-26,20:00:00,52,43,9,FMN 18 Binnensingel Westkant
665,Uitbreidingstraat 390,2023-02-26,21:00:00,29,22,7,FMN 18 Binnensingel Westkant
665,Uitbreidingstraat 390,2023-02-26,22:00:00,27,19,8,FMN 18 Binnensingel Westkant
665,Uitbreidingstraat 390,2023-02-26,23:00:00,12,8,4,FMN 18 Binnensingel Westkant
665,Uitbreidingstraat 390,2023-02-27,00:00:00,11,9,2,FMN 18 Binnensingel Westkant
665,Uitbreidingstraat 390,2023-02-27,01:00:00,1,1,0,FMN 18 Binnensingel Westkant
665,Uitbreidingstraat 390,2023-02-27,02:00:00,1,1,0,FMN 18 Binnensingel Westkant
665,Uitbreidingstraat 390,2023-02-27,03:00:00,3,3,0,FMN 18 Binnensingel Westkant
665,Uitbreidingstraat 390,2023-02-27,04:00:00,5,4,1,FMN 18 Binnensingel Westkant
665,Uitbreidingstraat 390,2023-02-27,05:00:00,26,25,1,FMN 18 Binnensingel Westkant
665,Uitbreidingstraat 390,2023-02-27,06:00:00,63,48,15,FMN 18 Binnensingel Westkant
665,Uitbreidingstraat 390,2023-02-27,07:00:00,239,199,40,FMN 18 Binnensingel Westkant
665,Uitbreidingstraat 390,2023-02-27,08:00:00,376,319,57,FMN 18 Binnensingel Westkant
665,Uitbreidingstraat 390,2023-02-27,09:00:00,141,124,17,FMN 18 Binnensingel Westkant
665,Uitbreidingstraat 390,2023-02-27,10:00:00,82,69,13,FMN 18 Binnensingel Westkant
665,Uitbreidingstraat 390,2023-02-27,11:00:00,61,37,24,FMN 18 Binnensingel Westkant
665,Uitbreidingstraat 390,2023-02-27,12:00:00,122,74,48,FMN 18 Binnensingel Westkant
665,Uitbreidingstraat 390,2023-02-27,13:00:00,129,97,32,FMN 18 Binnensingel Westkant
665,Uitbreidingstraat 390,2023-02-27,14:00:00,81,43,38,FMN 18 Binnensingel Westkant
665,Uitbreidingstraat 390,2023-02-27,15:00:00,173,69,104,FMN 18 Binnensingel Westkant
665,Uitbreidingstraat 390,2023-02-27,16:00:00,283,107,176,FMN 18 Binnensingel Westkant
665,Uitbreidingstraat 390,2023-02-27,17:00:00,308,144,164,FMN 18 Binnensingel Westkant
665,Uitbreidingstraat 390,2023-02-27,18:00:00,220,133,87,FMN 18 Binnensingel Westkant
665,Uitbreidingstraat 390,2023-02-27,19:00:00,98,68,30,FMN 18 Binnensingel Westkant
665,Uitbreidingstraat 390,2023-02-27,20:00:00,53,33,20,FMN 18 Binnensingel Westkant
665,Uitbreidingstraat 390,2023-02-27,21:00:00,42,19,23,FMN 18 Binnensingel Westkant
665,Uitbreidingstraat 390,2023-02-27,22:00:00,43,29,14,FMN 18 Binnensingel Westkant
665,Uitbreidingstraat 390,2023-02-27,23:00:00,18,14,4,FMN 18 Binnensingel Westkant
665,Uitbreidingstraat 390,2023-02-28,00:00:00,4,2,2,FMN 18 Binnensingel Westkant
665,Uitbreidingstraat 390,2023-02-28,01:00:00,6,5,1,FMN 18 Binnensingel Westkant
665,Uitbreidingstraat 390,2023-02-28,02:00:00,2,2,0,FMN 18 Binnensingel Westkant
665,Uitbreidingstraat 390,2023-02-28,03:00:00,5,5,0,FMN 18 Binnensingel Westkant
665,Uitbreidingstraat 390,2023-02-28,04:00:00,5,3,2,FMN 18 Binnensingel Westkant
665,Uitbreidingstraat 390,2023-02-28,05:00:00,33,28,5,FMN 18 Binnensingel Westkant
665,Uitbreidingstraat 390,2023-02-28,06:00:00,53,39,14,FMN 18 Binnensingel Westkant
665,Uitbreidingstraat 390,2023-02-28,07:00:00,250,217,33,FMN 18 Binnensingel Westkant
665,Uitbreidingstraat 390,2023-02-28,08:00:00,490,408,82,FMN 18 Binnensingel Westkant
665,Uitbreidingstraat 390,2023-02-28,09:00:00,146,122,24,FMN 18 Binnensingel Westkant
665,Uitbreidingstraat 390,2023-02-28,10:00:00,94,76,18,FMN 18 Binnensingel Westkant
665,Uitbreidingstraat 390,2023-02-28,11:00:00,95,69,26,FMN 18 Binnensingel Westkant
665,Uitbreidingstraat 390,2023-02-28,12:00:00,120,75,45,FMN 18 Binnensingel Westkant
665,Uitbreidingstraat 390,2023-02-28,13:00:00,120,83,37,FMN 18 Binnensingel Westkant
665,Uitbreidingstraat 390,2023-02-28,14:00:00,96,62,34,FMN 18 Binnensingel Westkant
665,Uitbreidingstraat 390,2023-02-28,15:00:00,164,71,93,FMN 18 Binnensingel Westkant
665,Uitbreidingstraat 390,2023-02-28,16:00:00,341,115,226,FMN 18 Binnensingel Westkant
665,Uitbreidingstraat 390,2023-02-28,17:00:00,290,139,151,FMN 18 Binnensingel Westkant
665,Uitbreidingstraat 390,2023-02-28,18:00:00,232,149,83,FMN 18 Binnensingel Westkant
665,Uitbreidingstraat 390,2023-02-28,19:00:00,119,85,34,FMN 18 Binnensingel Westkant
665,Uitbreidingstraat 390,2023-02-28,20:00:00,77,46,31,FMN 18 Binnensingel Westkant
665,Uitbreidingstraat 390,2023-02-28,21:00:00,53,32,21,FMN 18 Binnensingel Westkant
665,Uitbreidingstraat 390,2023-02-28,22:00:00,53,40,13,FMN 18 Binnensingel Westkant
665,Uitbreidingstraat 390,2023-02-28,23:00:00,41,36,5,FMN 18 Binnensingel Westkant
665,Uitbreidingstraat 390,2023-03-01,00:00:00,13,11,2,FMN 18 Binnensingel Westkant
665,Uitbreidingstraat 390,2023-03-01,01:00:00,4,4,0,FMN 18 Binnensingel Westkant
665,Uitbreidingstraat 390,2023-03-01,02:00:00,0,0,0,FMN 18 Binnensingel Westkant
665,Uitbreidingstraat 390,2023-03-01,03:00:00,3,3,0,FMN 18 Binnensingel Westkant
665,Uitbreidingstraat 390,2023-03-01,04:00:00,5,5,0,FMN 18 Binnensingel Westkant
665,Uitbreidingstraat 390,2023-03-01,05:00:00,28,27,1,FMN 18 Binnensingel Westkant
665,Uitbreidingstraat 390,2023-03-01,06:00:00,55,43,12,FMN 18 Binnensingel Westkant
665,Uitbreidingstraat 390,2023-03-01,07:00:00,207,173,34,FMN 18 Binnensingel Westkant
665,Uitbreidingstraat 390,2023-03-01,08:00:00,371,312,59,FMN 18 Binnensingel Westkant
665,Uitbreidingstraat 390,2023-03-01,09:00:00,127,105,22,FMN 18 Binnensingel Westkant
665,Uitbreidingstraat 390,2023-03-01,10:00:00,94,75,19,FMN 18 Binnensingel Westkant
665,Uitbreidingstraat 390,2023-03-01,11:00:00,94,61,33,FMN 18 Binnensingel Westkant
665,Uitbreidingstraat 390,2023-03-01,12:00:00,238,100,138,FMN 18 Binnensingel Westkant
665,Uitbreidingstraat 390,2023-03-01,13:00:00,219,117,102,FMN 18 Binnensingel Westkant
665,Uitbreidingstraat 390,2023-03-01,14:00:00,121,75,46,FMN 18 Binnensingel Westkant
665,Uitbreidingstraat 390,2023-03-01,15:00:00,136,70,66,FMN 18 Binnensingel Westkant
665,Uitbreidingstraat 390,2023-03-01,16:00:00,168,79,89,FMN 18 Binnensingel Westkant
665,Uitbreidingstraat 390,2023-03-01,17:00:00,239,126,113,FMN 18 Binnensingel Westkant
665,Uitbreidingstraat 390,2023-03-01,18:00:00,190,126,64,FMN 18 Binnensingel Westkant
665,Uitbreidingstraat 390,2023-03-01,19:00:00,95,67,28,FMN 18 Binnensingel Westkant
665,Uitbreidingstraat 390,2023-03-01,20:00:00,93,59,34,FMN 18 Binnensingel Westkant
665,Uitbreidingstraat 390,2023-03-01,21:00:00,48,24,24,FMN 18 Binnensingel Westkant
665,Uitbreidingstraat 390,2023-03-01,22:00:00,51,34,17,FMN 18 Binnensingel Westkant
665,Uitbreidingstraat 390,2023-03-01,23:00:00,25,22,3,FMN 18 Binnensingel Westkant
665,Uitbreidingstraat 390,2023-03-02,00:00:00,11,7,4,FMN 18 Binnensingel Westkant
665,Uitbreidingstraat 390,2023-03-02,01:00:00,2,1,1,FMN 18 Binnensingel Westkant
665,Uitbreidingstraat 390,2023-03-02,02:00:00,0,0,0,FMN 18 Binnensingel Westkant
665,Uitbreidingstraat 390,2023-03-02,03:00:00,3,3,0,FMN 18 Binnensingel Westkant
665,Uitbreidingstraat 390,2023-03-02,04:00:00,5,5,0,FMN 18 Binnensingel Westkant
665,Uitbreidingstraat 390,2023-03-02,05:00:00,27,25,2,FMN 18 Binnensingel Westkant
665,Uitbreidingstraat 390,2023-03-02,06:00:00,50,40,10,FMN 18 Binnensingel Westkant
665,Uitbreidingstraat 390,2023-03-02,07:00:00,208,174,34,FMN 18 Binnensingel Westkant
665,Uitbreidingstraat 390,2023-03-02,08:00:00,394,329,65,FMN 18 Binnensingel Westkant
665,Uitbreidingstraat 390,2023-03-02,09:00:00,152,127,25,FMN 18 Binnensingel Westkant
665,Uitbreidingstraat 390,2023-03-02,10:00:00,92,70,22,FMN 18 Binnensingel Westkant
665,Uitbreidingstraat 390,2023-03-02,11:00:00,83,57,26,FMN 18 Binnensingel Westkant
665,Uitbreidingstraat 390,2023-03-02,12:00:00,144,75,69,FMN 18 Binnensingel Westkant
665,Uitbreidingstraat 390,2023-03-02,13:00:00,124,97,27,FMN 18 Binnensingel Westkant
665,Uitbreidingstraat 390,2023-03-02,14:00:00,99,64,35,FMN 18 Binnensingel Westkant
665,Uitbreidingstraat 390,2023-03-02,15:00:00,197,66,131,FMN 18 Binnensingel Westkant
665,Uitbreidingstraat 390,2023-03-02,16:00:00,318,100,218,FMN 18 Binnensingel Westkant
665,Uitbreidingstraat 390,2023-03-02,17:00:00,260,141,119,FMN 18 Binnensingel Westkant
665,Uitbreidingstraat 390,2023-03-02,18:00:00,215,135,80,FMN 18 Binnensingel Westkant
665,Uitbreidingstraat 390,2023-03-02,19:00:00,123,81,42,FMN 18 Binnensingel Westkant
665,Uitbreidingstraat 390,2023-03-02,20:00:00,82,49,33,FMN 18 Binnensingel Westkant
665,Uitbreidingstraat 390,2023-03-02,21:00:00,63,47,16,FMN 18 Binnensingel Westkant
665,Uitbreidingstraat 390,2023-03-02,22:00:00,50,38,12,FMN 18 Binnensingel Westkant
665,Uitbreidingstraat 390,2023-03-02,23:00:00,46,36,10,FMN 18 Binnensingel Westkant
665,Uitbreidingstraat 390,2023-03-03,00:00:00,40,39,1,FMN 18 Binnensingel Westkant
665,Uitbreidingstraat 390,2023-03-03,01:00:00,14,12,2,FMN 18 Binnensingel Westkant
665,Uitbreidingstraat 390,2023-03-03,02:00:00,3,3,0,FMN 18 Binnensingel Westkant
665,Uitbreidingstraat 390,2023-03-03,03:00:00,3,3,0,FMN 18 Binnensingel Westkant
665,Uitbreidingstraat 390,2023-03-03,04:00:00,5,5,0,FMN 18 Binnensingel Westkant
665,Uitbreidingstraat 390,2023-03-03,05:00:00,26,23,3,FMN 18 Binnensingel Westkant
665,Uitbreidingstraat 390,2023-03-03,06:00:00,52,42,10,FMN 18 Binnensingel Westkant
665,Uitbreidingstraat 390,2023-03-03,07:00:00,196,162,34,FMN 18 Binnensingel Westkant
665,Uitbreidingstraat 390,2023-03-03,08:00:00,398,341,57,FMN 18 Binnensingel Westkant
665,Uitbreidingstraat 390,2023-03-03,09:00:00,145,120,25,FMN 18 Binnensingel Westkant
665,Uitbreidingstraat 390,2023-03-03,10:00:00,106,81,25,FMN 18 Binnensingel Westkant
665,Uitbreidingstraat 390,2023-03-03,11:00:00,69,46,23,FMN 18 Binnensingel Westkant
665,Uitbreidingstraat 390,2023-03-03,12:00:00,112,57,55,FMN 18 Binnensingel Westkant
665,Uitbreidingstraat 390,2023-03-03,13:00:00,111,74,37,FMN 18 Binnensingel Westkant
665,Uitbreidingstraat 390,2023-03-03,14:00:00,99,58,41,FMN 18 Binnensingel Westkant
665,Uitbreidingstraat 390,2023-03-03,15:00:00,162,83,79,FMN 18 Binnensingel Westkant
665,Uitbreidingstraat 390,2023-03-03,16:00:00,293,94,199,FMN 18 Binnensingel Westkant
665,Uitbreidingstraat 390,2023-03-03,17:00:00,210,110,100,FMN 18 Binnensingel Westkant
665,Uitbreidingstraat 390,2023-03-03,18:00:00,138,79,59,FMN 18 Binnensingel Westkant
665,Uitbreidingstraat 390,2023-03-03,19:00:00,134,98,36,FMN 18 Binnensingel Westkant
665,Uitbreidingstraat 390,2023-03-03,20:00:00,65,41,24,FMN 18 Binnensingel Westkant
665,Uitbreidingstraat 390,2023-03-03,21:00:00,60,34,26,FMN 18 Binnensingel Westkant
665,Uitbreidingstraat 390,2023-03-03,22:00:00,32,24,8,FMN 18 Binnensingel Westkant
665,Uitbreidingstraat 390,2023-03-03,23:00:00,57,50,7,FMN 18 Binnensingel Westkant
665,Uitbreidingstraat 390,2023-03-04,00:00:00,34,31,3,FMN 18 Binnensingel Westkant
665,Uitbreidingstraat 390,2023-03-04,01:00:00,24,19,5,FMN 18 Binnensingel Westkant
665,Uitbreidingstraat 390,2023-03-04,02:00:00,10,9,1,FMN 18 Binnensingel Westkant
665,Uitbreidingstraat 390,2023-03-04,03:00:00,10,6,4,FMN 18 Binnensingel Westkant
665,Uitbreidingstraat 390,2023-03-04,04:00:00,18,15,3,FMN 18 Binnensingel Westkant
665,Uitbreidingstraat 390,2023-03-04,05:00:00,7,6,1,FMN 18 Binnensingel Westkant
665,Uitbreidingstraat 390,2023-03-04,06:00:00,13,11,2,FMN 18 Binnensingel Westkant
665,Uitbreidingstraat 390,2023-03-04,07:00:00,25,18,7,FMN 18 Binnensingel Westkant
665,Uitbreidingstraat 390,2023-03-04,08:00:00,34,25,9,FMN 18 Binnensingel Westkant
665,Uitbreidingstraat 390,2023-03-04,09:00:00,62,47,15,FMN 18 Binnensingel Westkant
665,Uitbreidingstraat 390,2023-03-04,10:00:00,64,44,20,FMN 18 Binnensingel Westkant
665,Uitbreidingstraat 390,2023-03-04,11:00:00,91,50,41,FMN 18 Binnensingel Westkant
665,Uitbreidingstraat 390,2023-03-04,12:00:00,78,54,24,FMN 18 Binnensingel Westkant
665,Uitbreidingstraat 390,2023-03-04,13:00:00,83,67,16,FMN 18 Binnensingel Westkant
665,Uitbreidingstraat 390,2023-03-04,14:00:00,84,53,31,FMN 18 Binnensingel Westkant
665,Uitbreidingstraat 390,2023-03-04,15:00:00,87,60,27,FMN 18 Binnensingel Westkant
665,Uitbreidingstraat 390,2023-03-04,16:00:00,73,42,31,FMN 18 Binnensingel Westkant
665,Uitbreidingstraat 390,2023-03-04,17:00:00,74,55,19,FMN 18 Binnensingel Westkant
665,Uitbreidingstraat 390,2023-03-04,18:00:00,69,55,14,FMN 18 Binnensingel Westkant
665,Uitbreidingstraat 390,2023-03-04,19:00:00,76,52,24,FMN 18 Binnensingel Westkant
665,Uitbreidingstraat 390,2023-03-04,20:00:00,66,46,20,FMN 18 Binnensingel Westkant
665,Uitbreidingstraat 390,2023-03-04,21:00:00,48,35,13,FMN 18 Binnensingel Westkant
665,Uitbreidingstraat 390,2023-03-04,22:00:00,56,42,14,FMN 18 Binnensingel Westkant
665,Uitbreidingstraat 390,2023-03-04,23:00:00,65,57,8,FMN 18 Binnensingel Westkant
665,Uitbreidingstraat 390,2023-03-05,00:00:00,46,19,27,FMN 18 Binnensingel Westkant
665,Uitbreidingstraat 390,2023-03-05,01:00:00,20,16,4,FMN 18 Binnensingel Westkant
665,Uitbreidingstraat 390,2023-03-05,02:00:00,10,6,4,FMN 18 Binnensingel Westkant
665,Uitbreidingstraat 390,2023-03-05,03:00:00,10,6,4,FMN 18 Binnensingel Westkant
665,Uitbreidingstraat 390,2023-03-05,04:00:00,6,5,1,FMN 18 Binnensingel Westkant
665,Uitbreidingstraat 390,2023-03-05,05:00:00,14,12,2,FMN 18 Binnensingel Westkant
665,Uitbreidingstraat 390,2023-03-05,06:00:00,12,11,1,FMN 18 Binnensingel Westkant
665,Uitbreidingstraat 390,2023-03-05,07:00:00,17,15,2,FMN 18 Binnensingel Westkant
665,Uitbreidingstraat 390,2023-03-05,08:00:00,15,9,6,FMN 18 Binnensingel Westkant
665,Uitbreidingstraat 390,2023-03-05,09:00:00,40,29,11,FMN 18 Binnensingel Westkant
665,Uitbreidingstraat 390,2023-03-05,10:00:00,50,29,21,FMN 18 Binnensingel Westkant
665,Uitbreidingstraat 390,2023-03-05,11:00:00,59,36,23,FMN 18 Binnensingel Westkant
665,Uitbreidingstraat 390,2023-03-05,12:00:00,66,43,23,FMN 18 Binnensingel Westkant
665,Uitbreidingstraat 390,2023-03-05,13:00:00,49,35,14,FMN 18 Binnensingel Westkant
665,Uitbreidingstraat 390,2023-03-05,14:00:00,68,48,20,FMN 18 Binnensingel Westkant
665,Uitbreidingstraat 390,2023-03-05,15:00:00,57,35,22,FMN 18 Binnensingel Westkant
665,Uitbreidingstraat 390,2023-03-05,16:00:00,44,31,13,FMN 18 Binnensingel Westkant
665,Uitbreidingstraat 390,2023-03-05,17:00:00,61,44,17,FMN 18 Binnensingel Westkant
665,Uitbreidingstraat 390,2023-03-05,18:00:00,66,52,14,FMN 18 Binnensingel Westkant
665,Uitbreidingstraat 390,2023-03-05,19:00:00,53,47,6,FMN 18 Binnensingel Westkant
665,Uitbreidingstraat 390,2023-03-05,20:00:00,52,40,12,FMN 18 Binnensingel Westkant
665,Uitbreidingstraat 390,2023-03-05,21:00:00,36,25,11,FMN 18 Binnensingel Westkant
665,Uitbreidingstraat 390,2023-03-05,22:00:00,18,14,4,FMN 18 Binnensingel Westkant
665,Uitbreidingstraat 390,2023-03-05,23:00:00,12,10,2,FMN 18 Binnensingel Westkant
665,Uitbreidingstraat 390,2023-03-06,00:00:00,6,4,2,FMN 18 Binnensingel Westkant
665,Uitbreidingstraat 390,2023-03-06,01:00:00,5,4,1,FMN 18 Binnensingel Westkant
665,Uitbreidingstraat 390,2023-03-06,02:00:00,0,0,0,FMN 18 Binnensingel Westkant
665,Uitbreidingstraat 390,2023-03-06,03:00:00,4,4,0,FMN 18 Binnensingel Westkant
665,Uitbreidingstraat 390,2023-03-06,04:00:00,3,2,1,FMN 18 Binnensingel Westkant
665,Uitbreidingstraat 390,2023-03-06,05:00:00,21,20,1,FMN 18 Binnensingel Westkant
665,Uitbreidingstraat 390,2023-03-06,06:00:00,60,49,11,FMN 18 Binnensingel Westkant
665,Uitbreidingstraat 390,2023-03-06,07:00:00,233,199,34,FMN 18 Binnensingel Westkant
665,Uitbreidingstraat 390,2023-03-06,08:00:00,460,391,69,FMN 18 Binnensingel Westkant
665,Uitbreidingstraat 390,2023-03-06,09:00:00,130,110,20,FMN 18 Binnensingel Westkant
665,Uitbreidingstraat 390,2023-03-06,10:00:00,80,66,14,FMN 18 Binnensingel Westkant
665,Uitbreidingstraat 390,2023-03-06,11:00:00,62,30,32,FMN 18 Binnensingel Westkant
665,Uitbreidingstraat 390,2023-03-06,12:00:00,111,77,34,FMN 18 Binnensingel Westkant
665,Uitbreidingstraat 390,2023-03-06,13:00:00,111,75,36,FMN 18 Binnensingel Westkant
665,Uitbreidingstraat 390,2023-03-06,14:00:00,94,56,38,FMN 18 Binnensingel Westkant
665,Uitbreidingstraat 390,2023-03-06,15:00:00,187,75,112,FMN 18 Binnensingel Westkant
665,Uitbreidingstraat 390,2023-03-06,16:00:00,261,93,168,FMN 18 Binnensingel Westkant
665,Uitbreidingstraat 390,2023-03-06,17:00:00,261,146,115,FMN 18 Binnensingel Westkant
665,Uitbreidingstraat 390,2023-03-06,18:00:00,196,131,65,FMN 18 Binnensingel Westkant
665,Uitbreidingstraat 390,2023-03-06,19:00:00,77,50,27,FMN 18 Binnensingel Westkant
665,Uitbreidingstraat 390,2023-03-06,20:00:00,64,42,22,FMN 18 Binnensingel Westkant
665,Uitbreidingstraat 390,2023-03-06,21:00:00,53,28,25,FMN 18 Binnensingel Westkant
665,Uitbreidingstraat 390,2023-03-06,22:00:00,32,16,16,FMN 18 Binnensingel Westkant
665,Uitbreidingstraat 390,2023-03-06,23:00:00,6,6,0,FMN 18 Binnensingel Westkant
665,Uitbreidingstraat 390,2023-03-07,00:00:00,8,5,3,FMN 18 Binnensingel Westkant
665,Uitbreidingstraat 390,2023-03-07,01:00:00,6,5,1,FMN 18 Binnensingel Westkant
665,Uitbreidingstraat 390,2023-03-07,02:00:00,1,1,0,FMN 18 Binnensingel Westkant
665,Uitbreidingstraat 390,2023-03-07,03:00:00,2,2,0,FMN 18 Binnensingel Westkant
665,Uitbreidingstraat 390,2023-03-07,04:00:00,4,3,1,FMN 18 Binnensingel Westkant
665,Uitbreidingstraat 390,2023-03-07,05:00:00,25,24,1,FMN 18 Binnensingel Westkant
665,Uitbreidingstraat 390,2023-03-07,06:00:00,51,36,15,FMN 18 Binnensingel Westkant
665,Uitbreidingstraat 390,2023-03-07,07:00:00,220,189,31,FMN 18 Binnensingel Westkant
665,Uitbreidingstraat 390,2023-03-07,08:00:00,378,321,57,FMN 18 Binnensingel Westkant
665,Uitbreidingstraat 390,2023-03-07,09:00:00,122,96,26,FMN 18 Binnensingel Westkant
665,Uitbreidingstraat 390,2023-03-07,10:00:00,57,44,13,FMN 18 Binnensingel Westkant
665,Uitbreidingstraat 390,2023-03-07,11:00:00,61,34,27,FMN 18 Binnensingel Westkant
665,Uitbreidingstraat 390,2023-03-07,12:00:00,106,52,54,FMN 18 Binnensingel Westkant
665,Uitbreidingstraat 390,2023-03-07,13:00:00,106,84,22,FMN 18 Binnensingel Westkant
665,Uitbreidingstraat 390,2023-03-07,14:00:00,89,48,41,FMN 18 Binnensingel Westkant
665,Uitbreidingstraat 390,2023-03-07,15:00:00,137,59,78,FMN 18 Binnensingel Westkant
665,Uitbreidingstraat 390,2023-03-07,16:00:00,251,92,159,FMN 18 Binnensingel Westkant
665,Uitbreidingstraat 390,2023-03-07,17:00:00,260,114,146,FMN 18 Binnensingel Westkant
665,Uitbreidingstraat 390,2023-03-07,18:00:00,174,115,59,FMN 18 Binnensingel Westkant
665,Uitbreidingstraat 390,2023-03-07,19:00:00,90,64,26,FMN 18 Binnensingel Westkant
665,Uitbreidingstraat 390,2023-03-07,20:00:00,57,39,18,FMN 18 Binnensingel Westkant
665,Uitbreidingstraat 390,2023-03-07,21:00:00,67,43,24,FMN 18 Binnensingel Westkant
665,Uitbreidingstraat 390,2023-03-07,22:00:00,51,32,19,FMN 18 Binnensingel Westkant
665,Uitbreidingstraat 390,2023-03-07,23:00:00,25,20,5,FMN 18 Binnensingel Westkant
665,Uitbreidingstraat 390,2023-03-08,00:00:00,7,6,1,FMN 18 Binnensingel Westkant
665,Uitbreidingstraat 390,2023-03-08,01:00:00,4,3,1,FMN 18 Binnensingel Westkant
665,Uitbreidingstraat 390,2023-03-08,02:00:00,0,0,0,FMN 18 Binnensingel Westkant
665,Uitbreidingstraat 390,2023-03-08,03:00:00,4,3,1,FMN 18 Binnensingel Westkant
665,Uitbreidingstraat 390,2023-03-08,04:00:00,5,3,2,FMN 18 Binnensingel Westkant
665,Uitbreidingstraat 390,2023-03-08,05:00:00,24,21,3,FMN 18 Binnensingel Westkant
665,Uitbreidingstraat 390,2023-03-08,06:00:00,46,37,9,FMN 18 Binnensingel Westkant
665,Uitbreidingstraat 390,2023-03-08,07:00:00,123,107,16,FMN 18 Binnensingel Westkant
665,Uitbreidingstraat 390,2023-03-08,08:00:00,238,189,49,FMN 18 Binnensingel Westkant
665,Uitbreidingstraat 390,2023-03-08,09:00:00,126,111,15,FMN 18 Binnensingel Westkant
665,Uitbreidingstraat 390,2023-03-08,10:00:00,54,45,9,FMN 18 Binnensingel Westkant
665,Uitbreidingstraat 390,2023-03-08,11:00:00,64,40,24,FMN 18 Binnensingel Westkant
665,Uitbreidingstraat 390,2023-03-08,12:00:00,169,84,85,FMN 18 Binnensingel Westkant
665,Uitbreidingstraat 390,2023-03-08,13:00:00,134,55,79,FMN 18 Binnensingel Westkant
665,Uitbreidingstraat 390,2023-03-08,14:00:00,63,43,20,FMN 18 Binnensingel Westkant
665,Uitbreidingstraat 390,2023-03-08,15:00:00,89,56,33,FMN 18 Binnensingel Westkant
665,Uitbreidingstraat 390,2023-03-08,16:00:00,131,66,65,FMN 18 Binnensingel Westkant
665,Uitbreidingstraat 390,2023-03-08,17:00:00,152,75,77,FMN 18 Binnensingel Westkant
665,Uitbreidingstraat 390,2023-03-08,18:00:00,111,78,33,FMN 18 Binnensingel Westkant
665,Uitbreidingstraat 390,2023-03-08,19:00:00,53,37,16,FMN 18 Binnensingel Westkant
665,Uitbreidingstraat 390,2023-03-08,20:00:00,44,25,19,FMN 18 Binnensingel Westkant
665,Uitbreidingstraat 390,2023-03-08,21:00:00,42,21,21,FMN 18 Binnensingel Westkant
665,Uitbreidingstraat 390,2023-03-08,22:00:00,41,28,13,FMN 18 Binnensingel Westkant
665,Uitbreidingstraat 390,2023-03-08,23:00:00,19,15,4,FMN 18 Binnensingel Westkant
665,Uitbreidingstraat 390,2023-03-09,00:00:00,8,8,0,FMN 18 Binnensingel Westkant
665,Uitbreidingstraat 390,2023-03-09,01:00:00,2,1,1,FMN 18 Binnensingel Westkant
665,Uitbreidingstraat 390,2023-03-09,02:00:00,2,1,1,FMN 18 Binnensingel Westkant
665,Uitbreidingstraat 390,2023-03-09,03:00:00,2,2,0,FMN 18 Binnensingel Westkant
665,Uitbreidingstraat 390,2023-03-09,04:00:00,8,7,1,FMN 18 Binnensingel Westkant
665,Uitbreidingstraat 390,2023-03-09,05:00:00,20,19,1,FMN 18 Binnensingel Westkant
665,Uitbreidingstraat 390,2023-03-09,06:00:00,54,43,11,FMN 18 Binnensingel Westkant
665,Uitbreidingstraat 390,2023-03-09,07:00:00,203,171,32,FMN 18 Binnensingel Westkant
665,Uitbreidingstraat 390,2023-03-09,08:00:00,331,283,48,FMN 18 Binnensingel Westkant
665,Uitbreidingstraat 390,2023-03-09,09:00:00,112,90,22,FMN 18 Binnensingel Westkant
665,Uitbreidingstraat 390,2023-03-09,10:00:00,84,76,8,FMN 18 Binnensingel Westkant
665,Uitbreidingstraat 390,2023-03-09,11:00:00,61,34,27,FMN 18 Binnensingel Westkant
665,Uitbreidingstraat 390,2023-03-09,12:00:00,97,52,45,FMN 18 Binnensingel Westkant
665,Uitbreidingstraat 390,2023-03-09,13:00:00,101,77,24,FMN 18 Binnensingel Westkant
665,Uitbreidingstraat 390,2023-03-09,14:00:00,75,43,32,FMN 18 Binnensingel Westkant
665,Uitbreidingstraat 390,2023-03-09,15:00:00,150,52,98,FMN 18 Binnensingel Westkant
665,Uitbreidingstraat 390,2023-03-09,16:00:00,272,101,171,FMN 18 Binnensingel Westkant
665,Uitbreidingstraat 390,2023-03-09,17:00:00,209,96,113,FMN 18 Binnensingel Westkant
665,Uitbreidingstraat 390,2023-03-09,18:00:00,180,122,58,FMN 18 Binnensingel Westkant
665,Uitbreidingstraat 390,2023-03-09,19:00:00,75,50,25,FMN 18 Binnensingel Westkant
665,Uitbreidingstraat 390,2023-03-09,20:00:00,65,43,22,FMN 18 Binnensingel Westkant
665,Uitbreidingstraat 390,2023-03-09,21:00:00,51,31,20,FMN 18 Binnensingel Westkant
665,Uitbreidingstraat 390,2023-03-09,22:00:00,41,28,13,FMN 18 Binnensingel Westkant
665,Uitbreidingstraat 390,2023-03-09,23:00:00,19,14,5,FMN 18 Binnensingel Westkant
665,Uitbreidingstraat 390,2023-03-10,00:00:00,16,15,1,FMN 18 Binnensingel Westkant
665,Uitbreidingstraat 390,2023-03-10,01:00:00,5,5,0,FMN 18 Binnensingel Westkant
665,Uitbreidingstraat 390,2023-03-10,02:00:00,0,0,0,FMN 18 Binnensingel Westkant
665,Uitbreidingstraat 390,2023-03-10,03:00:00,5,4,1,FMN 18 Binnensingel Westkant
665,Uitbreidingstraat 390,2023-03-10,04:00:00,3,3,0,FMN 18 Binnensingel Westkant
665,Uitbreidingstraat 390,2023-03-10,05:00:00,25,25,0,FMN 18 Binnensingel Westkant
665,Uitbreidingstraat 390,2023-03-10,06:00:00,43,42,1,FMN 18 Binnensingel Westkant
665,Uitbreidingstraat 390,2023-03-10,07:00:00,146,129,17,FMN 18 Binnensingel Westkant
665,Uitbreidingstraat 390,2023-03-10,08:00:00,335,293,42,FMN 18 Binnensingel Westkant
665,Uitbreidingstraat 390,2023-03-10,09:00:00,94,73,21,FMN 18 Binnensingel Westkant
665,Uitbreidingstraat 390,2023-03-10,10:00:00,59,43,16,FMN 18 Binnensingel Westkant
665,Uitbreidingstraat 390,2023-03-10,11:00:00,57,37,20,FMN 18 Binnensingel Westkant
665,Uitbreidingstraat 390,2023-03-10,12:00:00,104,55,49,FMN 18 Binnensingel Westkant
665,Uitbreidingstraat 390,2023-03-10,13:00:00,100,73,27,FMN 18 Binnensingel Westkant
665,Uitbreidingstraat 390,2023-03-10,14:00:00,84,53,31,FMN 18 Binnensingel Westkant
665,Uitbreidingstraat 390,2023-03-10,15:00:00,122,51,71,FMN 18 Binnensingel Westkant
665,Uitbreidingstraat 390,2023-03-10,16:00:00,227,62,165,FMN 18 Binnensingel Westkant
665,Uitbreidingstraat 390,2023-03-10,17:00:00,139,79,60,FMN 18 Binnensingel Westkant
665,Uitbreidingstraat 390,2023-03-10,18:00:00,120,77,43,FMN 18 Binnensingel Westkant
665,Uitbreidingstraat 390,2023-03-10,19:00:00,89,69,20,FMN 18 Binnensingel Westkant
665,Uitbreidingstraat 390,2023-03-10,20:00:00,76,52,24,FMN 18 Binnensingel Westkant
665,Uitbreidingstraat 390,2023-03-10,21:00:00,37,25,12,FMN 18 Binnensingel Westkant
665,Uitbreidingstraat 390,2023-03-10,22:00:00,43,25,18,FMN 18 Binnensingel Westkant
665,Uitbreidingstraat 390,2023-03-10,23:00:00,48,36,12,FMN 18 Binnensingel Westkant
665,Uitbreidingstraat 390,2023-03-11,00:00:00,35,29,6,FMN 18 Binnensingel Westkant
665,Uitbreidingstraat 390,2023-03-11,01:00:00,32,28,4,FMN 18 Binnensingel Westkant
665,Uitbreidingstraat 390,2023-03-11,02:00:00,17,13,4,FMN 18 Binnensingel Westkant
665,Uitbreidingstraat 390,2023-03-11,03:00:00,10,8,2,FMN 18 Binnensingel Westkant
665,Uitbreidingstraat 390,2023-03-11,04:00:00,12,12,0,FMN 18 Binnensingel Westkant
665,Uitbreidingstraat 390,2023-03-11,05:00:00,11,9,2,FMN 18 Binnensingel Westkant
665,Uitbreidingstraat 390,2023-03-11,06:00:00,22,20,2,FMN 18 Binnensingel Westkant
665,Uitbreidingstraat 390,2023-03-11,07:00:00,19,10,9,FMN 18 Binnensingel Westkant
665,Uitbreidingstraat 390,2023-03-11,08:00:00,46,35,11,FMN 18 Binnensingel Westkant
665,Uitbreidingstraat 390,2023-03-11,09:00:00,71,55,16,FMN 18 Binnensingel Westkant
665,Uitbreidingstraat 390,2023-03-11,10:00:00,74,53,21,FMN 18 Binnensingel Westkant
665,Uitbreidingstraat 390,2023-03-11,11:00:00,84,52,32,FMN 18 Binnensingel Westkant
665,Uitbreidingstraat 390,2023-03-11,12:00:00,116,79,37,FMN 18 Binnensingel Westkant
665,Uitbreidingstraat 390,2023-03-11,13:00:00,93,64,29,FMN 18 Binnensingel Westkant
665,Uitbreidingstraat 390,2023-03-11,14:00:00,86,57,29,FMN 18 Binnensingel Westkant
665,Uitbreidingstraat 390,2023-03-11,15:00:00,81,65,16,FMN 18 Binnensingel Westkant
665,Uitbreidingstraat 390,2023-03-11,16:00:00,78,50,28,FMN 18 Binnensingel Westkant
665,Uitbreidingstraat 390,2023-03-11,17:00:00,66,52,14,FMN 18 Binnensingel Westkant
665,Uitbreidingstraat 390,2023-03-11,18:00:00,93,70,23,FMN 18 Binnensingel Westkant
665,Uitbreidingstraat 390,2023-03-11,19:00:00,70,56,14,FMN 18 Binnensingel Westkant
665,Uitbreidingstraat 390,2023-03-11,20:00:00,63,39,24,FMN 18 Binnensingel Westkant
665,Uitbreidingstraat 390,2023-03-11,21:00:00,30,25,5,FMN 18 Binnensingel Westkant
665,Uitbreidingstraat 390,2023-03-11,22:00:00,41,32,9,FMN 18 Binnensingel Westkant
665,Uitbreidingstraat 390,2023-03-11,23:00:00,51,41,10,FMN 18 Binnensingel Westkant
665,Uitbreidingstraat 390,2023-03-12,00:00:00,45,30,15,FMN 18 Binnensingel Westkant
665,Uitbreidingstraat 390,2023-03-12,01:00:00,35,26,9,FMN 18 Binnensingel Westkant
665,Uitbreidingstraat 390,2023-03-12,02:00:00,15,7,8,FMN 18 Binnensingel Westkant
665,Uitbreidingstraat 390,2023-03-12,03:00:00,13,8,5,FMN 18 Binnensingel Westkant
665,Uitbreidingstraat 390,2023-03-12,04:00:00,30,15,15,FMN 18 Binnensingel Westkant
665,Uitbreidingstraat 390,2023-03-12,05:00:00,11,10,1,FMN 18 Binnensingel Westkant
665,Uitbreidingstraat 390,2023-03-12,06:00:00,30,28,2,FMN 18 Binnensingel Westkant
665,Uitbreidingstraat 390,2023-03-12,07:00:00,13,10,3,FMN 18 Binnensingel Westkant
665,Uitbreidingstraat 390,2023-03-12,08:00:00,16,14,2,FMN 18 Binnensingel Westkant
665,Uitbreidingstraat 390,2023-03-12,09:00:00,42,32,10,FMN 18 Binnensingel Westkant
665,Uitbreidingstraat 390,2023-03-12,10:00:00,49,38,11,FMN 18 Binnensingel Westkant
665,Uitbreidingstraat 390,2023-03-12,11:00:00,49,36,13,FMN 18 Binnensingel Westkant
665,Uitbreidingstraat 390,2023-03-12,12:00:00,78,42,36,FMN 18 Binnensingel Westkant
665,Uitbreidingstraat 390,2023-03-12,13:00:00,75,57,18,FMN 18 Binnensingel Westkant
665,Uitbreidingstraat 390,2023-03-12,14:00:00,64,47,17,FMN 18 Binnensingel Westkant
665,Uitbreidingstraat 390,2023-03-12,15:00:00,59,45,14,FMN 18 Binnensingel Westkant
665,Uitbreidingstraat 390,2023-03-12,16:00:00,50,38,12,FMN 18 Binnensingel Westkant
665,Uitbreidingstraat 390,2023-03-12,17:00:00,45,40,5,FMN 18 Binnensingel Westkant
665,Uitbreidingstraat 390,2023-03-12,18:00:00,61,45,16,FMN 18 Binnensingel Westkant
665,Uitbreidingstraat 390,2023-03-12,19:00:00,55,40,15,FMN 18 Binnensingel Westkant
665,Uitbreidingstraat 390,2023-03-12,20:00:00,37,30,7,FMN 18 Binnensingel Westkant
665,Uitbreidingstraat 390,2023-03-12,21:00:00,45,34,11,FMN 18 Binnensingel Westkant
665,Uitbreidingstraat 390,2023-03-12,22:00:00,15,11,4,FMN 18 Binnensingel Westkant
665,Uitbreidingstraat 390,2023-03-12,23:00:00,11,7,4,FMN 18 Binnensingel Westkant
665,Uitbreidingstraat 390,2023-03-13,00:00:00,13,11,2,FMN 18 Binnensingel Westkant
665,Uitbreidingstraat 390,2023-03-13,01:00:00,2,1,1,FMN 18 Binnensingel Westkant
665,Uitbreidingstraat 390,2023-03-13,02:00:00,3,3,0,FMN 18 Binnensingel Westkant
665,Uitbreidingstraat 390,2023-03-13,03:00:00,2,2,0,FMN 18 Binnensingel Westkant
665,Uitbreidingstraat 390,2023-03-13,04:00:00,2,2,0,FMN 18 Binnensingel Westkant
665,Uitbreidingstraat 390,2023-03-13,05:00:00,34,28,6,FMN 18 Binnensingel Westkant
665,Uitbreidingstraat 390,2023-03-13,06:00:00,52,37,15,FMN 18 Binnensingel Westkant
665,Uitbreidingstraat 390,2023-03-13,07:00:00,226,186,40,FMN 18 Binnensingel Westkant
665,Uitbreidingstraat 390,2023-03-13,08:00:00,401,330,71,FMN 18 Binnensingel Westkant
665,Uitbreidingstraat 390,2023-03-13,09:00:00,123,110,13,FMN 18 Binnensingel Westkant
665,Uitbreidingstraat 390,2023-03-13,10:00:00,76,59,17,FMN 18 Binnensingel Westkant
665,Uitbreidingstraat 390,2023-03-13,11:00:00,47,24,23,FMN 18 Binnensingel Westkant
665,Uitbreidingstraat 390,2023-03-13,12:00:00,113,60,53,FMN 18 Binnensingel Westkant
665,Uitbreidingstraat 390,2023-03-13,13:00:00,86,61,25,FMN 18 Binnensingel Westkant
665,Uitbreidingstraat 390,2023-03-13,14:00:00,97,51,46,FMN 18 Binnensingel Westkant
665,Uitbreidingstraat 390,2023-03-13,15:00:00,160,63,97,FMN 18 Binnensingel Westkant
665,Uitbreidingstraat 390,2023-03-13,16:00:00,286,117,169,FMN 18 Binnensingel Westkant
665,Uitbreidingstraat 390,2023-03-13,17:00:00,259,125,134,FMN 18 Binnensingel Westkant
665,Uitbreidingstraat 390,2023-03-13,18:00:00,203,136,67,FMN 18 Binnensingel Westkant
665,Uitbreidingstraat 390,2023-03-13,19:00:00,109,82,27,FMN 18 Binnensingel Westkant
665,Uitbreidingstraat 390,2023-03-13,20:00:00,67,43,24,FMN 18 Binnensingel Westkant
665,Uitbreidingstraat 390,2023-03-13,21:00:00,54,30,24,FMN 18 Binnensingel Westkant
665,Uitbreidingstraat 390,2023-03-13,22:00:00,63,44,19,FMN 18 Binnensingel Westkant
665,Uitbreidingstraat 390,2023-03-13,23:00:00,26,23,3,FMN 18 Binnensingel Westkant
665,Uitbreidingstraat 390,2023-03-14,00:00:00,7,4,3,FMN 18 Binnensingel Westkant
665,Uitbreidingstraat 390,2023-03-14,01:00:00,5,3,2,FMN 18 Binnensingel Westkant
665,Uitbreidingstraat 390,2023-03-14,02:00:00,2,1,1,FMN 18 Binnensingel Westkant
665,Uitbreidingstraat 390,2023-03-14,03:00:00,1,1,0,FMN 18 Binnensingel Westkant
665,Uitbreidingstraat 390,2023-03-14,04:00:00,4,3,1,FMN 18 Binnensingel Westkant
665,Uitbreidingstraat 390,2023-03-14,05:00:00,25,23,2,FMN 18 Binnensingel Westkant
665,Uitbreidingstraat 390,2023-03-14,06:00:00,58,45,13,FMN 18 Binnensingel Westkant
665,Uitbreidingstraat 390,2023-03-14,07:00:00,230,200,30,FMN 18 Binnensingel Westkant
665,Uitbreidingstraat 390,2023-03-14,08:00:00,387,291,96,FMN 18 Binnensingel Westkant
665,Uitbreidingstraat 390,2023-03-14,09:00:00,164,98,66,FMN 18 Binnensingel Westkant
665,Uitbreidingstraat 390,2023-03-14,10:00:00,75,58,17,FMN 18 Binnensingel Westkant
665,Uitbreidingstraat 390,2023-03-14,11:00:00,51,33,18,FMN 18 Binnensingel Westkant
665,Uitbreidingstraat 390,2023-03-14,12:00:00,136,58,78,FMN 18 Binnensingel Westkant
665,Uitbreidingstraat 390,2023-03-14,13:00:00,91,61,30,FMN 18 Binnensingel Westkant
665,Uitbreidingstraat 390,2023-03-14,14:00:00,97,63,34,FMN 18 Binnensingel Westkant
665,Uitbreidingstraat 390,2023-03-14,15:00:00,147,77,70,FMN 18 Binnensingel Westkant
665,Uitbreidingstraat 390,2023-03-14,16:00:00,236,115,121,FMN 18 Binnensingel Westkant
665,Uitbreidingstraat 390,2023-03-14,17:00:00,243,128,115,FMN 18 Binnensingel Westkant
665,Uitbreidingstraat 390,2023-03-14,18:00:00,206,146,60,FMN 18 Binnensingel Westkant
665,Uitbreidingstraat 390,2023-03-14,19:00:00,98,58,40,FMN 18 Binnensingel Westkant
665,Uitbreidingstraat 390,2023-03-14,20:00:00,58,45,13,FMN 18 Binnensingel Westkant
665,Uitbreidingstraat 390,2023-03-14,21:00:00,49,27,22,FMN 18 Binnensingel Westkant
665,Uitbreidingstraat 390,2023-03-14,22:00:00,40,28,12,FMN 18 Binnensingel Westkant
665,Uitbreidingstraat 390,2023-03-14,23:00:00,29,24,5,FMN 18 Binnensingel Westkant
665,Uitbreidingstraat 390,2023-03-15,00:00:00,5,5,0,FMN 18 Binnensingel Westkant
665,Uitbreidingstraat 390,2023-03-15,01:00:00,8,7,1,FMN 18 Binnensingel Westkant
665,Uitbreidingstraat 390,2023-03-15,02:00:00,0,0,0,FMN 18 Binnensingel Westkant
665,Uitbreidingstraat 390,2023-03-15,03:00:00,3,1,2,FMN 18 Binnensingel Westkant
665,Uitbreidingstraat 390,2023-03-15,04:00:00,6,4,2,FMN 18 Binnensingel Westkant
665,Uitbreidingstraat 390,2023-03-15,05:00:00,29,24,5,FMN 18 Binnensingel Westkant
665,Uitbreidingstraat 390,2023-03-15,06:00:00,58,49,9,FMN 18 Binnensingel Westkant
665,Uitbreidingstraat 390,2023-03-15,07:00:00,200,168,32,FMN 18 Binnensingel Westkant
665,Uitbreidingstraat 390,2023-03-15,08:00:00,399,344,55,FMN 18 Binnensingel Westkant
665,Uitbreidingstraat 390,2023-03-15,09:00:00,140,120,20,FMN 18 Binnensingel Westkant
665,Uitbreidingstraat 390,2023-03-15,10:00:00,84,65,19,FMN 18 Binnensingel Westkant
665,Uitbreidingstraat 390,2023-03-15,11:00:00,75,45,30,FMN 18 Binnensingel Westkant
665,Uitbreidingstraat 390,2023-03-15,12:00:00,207,92,115,FMN 18 Binnensingel Westkant
665,Uitbreidingstraat 390,2023-03-15,13:00:00,146,79,67,FMN 18 Binnensingel Westkant
665,Uitbreidingstraat 390,2023-03-15,14:00:00,118,71,47,FMN 18 Binnensingel Westkant
665,Uitbreidingstraat 390,2023-03-15,15:00:00,138,74,64,FMN 18 Binnensingel Westkant
665,Uitbreidingstraat 390,2023-03-15,16:00:00,175,82,93,FMN 18 Binnensingel Westkant
665,Uitbreidingstraat 390,2023-03-15,17:00:00,224,117,107,FMN 18 Binnensingel Westkant
665,Uitbreidingstraat 390,2023-03-15,18:00:00,182,119,63,FMN 18 Binnensingel Westkant
665,Uitbreidingstraat 390,2023-03-15,19:00:00,114,80,34,FMN 18 Binnensingel Westkant
665,Uitbreidingstraat 390,2023-03-15,20:00:00,64,42,22,FMN 18 Binnensingel Westkant
665,Uitbreidingstraat 390,2023-03-15,21:00:00,70,36,34,FMN 18 Binnensingel Westkant
665,Uitbreidingstraat 390,2023-03-15,22:00:00,49,28,21,FMN 18 Binnensingel Westkant
665,Uitbreidingstraat 390,2023-03-15,23:00:00,30,25,5,FMN 18 Binnensingel Westkant
665,Uitbreidingstraat 390,2023-03-16,00:00:00,12,10,2,FMN 18 Binnensingel Westkant
665,Uitbreidingstraat 390,2023-03-16,01:00:00,0,0,0,FMN 18 Binnensingel Westkant
665,Uitbreidingstraat 390,2023-03-16,02:00:00,3,3,0,FMN 18 Binnensingel Westkant
665,Uitbreidingstraat 390,2023-03-16,03:00:00,3,1,2,FMN 18 Binnensingel Westkant
665,Uitbreidingstraat 390,2023-03-16,04:00:00,5,5,0,FMN 18 Binnensingel Westkant
665,Uitbreidingstraat 390,2023-03-16,05:00:00,27,25,2,FMN 18 Binnensingel Westkant
665,Uitbreidingstraat 390,2023-03-16,06:00:00,50,39,11,FMN 18 Binnensingel Westkant
665,Uitbreidingstraat 390,2023-03-16,07:00:00,220,180,40,FMN 18 Binnensingel Westkant
665,Uitbreidingstraat 390,2023-03-16,08:00:00,395,339,56,FMN 18 Binnensingel Westkant
665,Uitbreidingstraat 390,2023-03-16,09:00:00,154,123,31,FMN 18 Binnensingel Westkant
665,Uitbreidingstraat 390,2023-03-16,10:00:00,94,76,18,FMN 18 Binnensingel Westkant
665,Uitbreidingstraat 390,2023-03-16,11:00:00,91,64,27,FMN 18 Binnensingel Westkant
665,Uitbreidingstraat 390,2023-03-16,12:00:00,127,70,57,FMN 18 Binnensingel Westkant
665,Uitbreidingstraat 390,2023-03-16,13:00:00,111,81,30,FMN 18 Binnensingel Westkant
665,Uitbreidingstraat 390,2023-03-16,14:00:00,90,52,38,FMN 18 Binnensingel Westkant
665,Uitbreidingstraat 390,2023-03-16,15:00:00,228,83,145,FMN 18 Binnensingel Westkant
665,Uitbreidingstraat 390,2023-03-16,16:00:00,264,120,144,FMN 18 Binnensingel Westkant
665,Uitbreidingstraat 390,2023-03-16,17:00:00,231,131,100,FMN 18 Binnensingel Westkant
665,Uitbreidingstraat 390,2023-03-16,18:00:00,189,127,62,FMN 18 Binnensingel Westkant
665,Uitbreidingstraat 390,2023-03-16,19:00:00,130,101,29,FMN 18 Binnensingel Westkant
665,Uitbreidingstraat 390,2023-03-16,20:00:00,67,50,17,FMN 18 Binnensingel Westkant
665,Uitbreidingstraat 390,2023-03-16,21:00:00,60,35,25,FMN 18 Binnensingel Westkant
665,Uitbreidingstraat 390,2023-03-16,22:00:00,59,38,21,FMN 18 Binnensingel Westkant
665,Uitbreidingstraat 390,2023-03-16,23:00:00,32,25,7,FMN 18 Binnensingel Westkant
665,Uitbreidingstraat 390,2023-03-17,00:00:00,12,10,2,FMN 18 Binnensingel Westkant
665,Uitbreidingstraat 390,2023-03-17,01:00:00,3,2,1,FMN 18 Binnensingel Westkant
665,Uitbreidingstraat 390,2023-03-17,02:00:00,7,6,1,FMN 18 Binnensingel Westkant
665,Uitbreidingstraat 390,2023-03-17,03:00:00,3,3,0,FMN 18 Binnensingel Westkant
665,Uitbreidingstraat 390,2023-03-17,04:00:00,8,7,1,FMN 18 Binnensingel Westkant
665,Uitbreidingstraat 390,2023-03-17,05:00:00,33,31,2,FMN 18 Binnensingel Westkant
665,Uitbreidingstraat 390,2023-03-17,06:00:00,47,42,5,FMN 18 Binnensingel Westkant
665,Uitbreidingstraat 390,2023-03-17,07:00:00,202,173,29,FMN 18 Binnensingel Westkant
665,Uitbreidingstraat 390,2023-03-17,08:00:00,389,344,45,FMN 18 Binnensingel Westkant
665,Uitbreidingstraat 390,2023-03-17,09:00:00,145,121,24,FMN 18 Binnensingel Westkant
665,Uitbreidingstraat 390,2023-03-17,10:00:00,97,68,29,FMN 18 Binnensingel Westkant
665,Uitbreidingstraat 390,2023-03-17,11:00:00,88,58,30,FMN 18 Binnensingel Westkant
665,Uitbreidingstraat 390,2023-03-17,12:00:00,131,82,49,FMN 18 Binnensingel Westkant
665,Uitbreidingstraat 390,2023-03-17,13:00:00,145,92,53,FMN 18 Binnensingel Westkant
665,Uitbreidingstraat 390,2023-03-17,14:00:00,124,78,46,FMN 18 Binnensingel Westkant
665,Uitbreidingstraat 390,2023-03-17,15:00:00,196,90,106,FMN 18 Binnensingel Westkant
665,Uitbreidingstraat 390,2023-03-17,16:00:00,257,132,125,FMN 18 Binnensingel Westkant
665,Uitbreidingstraat 390,2023-03-17,17:00:00,246,133,113,FMN 18 Binnensingel Westkant
665,Uitbreidingstraat 390,2023-03-17,18:00:00,171,109,62,FMN 18 Binnensingel Westkant
665,Uitbreidingstraat 390,2023-03-17,19:00:00,143,106,37,FMN 18 Binnensingel Westkant
665,Uitbreidingstraat 390,2023-03-17,20:00:00,78,55,23,FMN 18 Binnensingel Westkant
665,Uitbreidingstraat 390,2023-03-17,21:00:00,66,41,25,FMN 18 Binnensingel Westkant
665,Uitbreidingstraat 390,2023-03-17,22:00:00,48,27,21,FMN 18 Binnensingel Westkant
665,Uitbreidingstraat 390,2023-03-17,23:00:00,64,50,14,FMN 18 Binnensingel Westkant
665,Uitbreidingstraat 390,2023-03-18,00:00:00,48,34,14,FMN 18 Binnensingel Westkant
665,Uitbreidingstraat 390,2023-03-18,01:00:00,44,37,7,FMN 18 Binnensingel Westkant
665,Uitbreidingstraat 390,2023-03-18,02:00:00,10,7,3,FMN 18 Binnensingel Westkant
665,Uitbreidingstraat 390,2023-03-18,03:00:00,18,10,8,FMN 18 Binnensingel Westkant
665,Uitbreidingstraat 390,2023-03-18,04:00:00,11,5,6,FMN 18 Binnensingel Westkant
665,Uitbreidingstraat 390,2023-03-18,05:00:00,15,12,3,FMN 18 Binnensingel Westkant
665,Uitbreidingstraat 390,2023-03-18,06:00:00,20,16,4,FMN 18 Binnensingel Westkant
665,Uitbreidingstraat 390,2023-03-18,07:00:00,26,17,9,FMN 18 Binnensingel Westkant
665,Uitbreidingstraat 390,2023-03-18,08:00:00,47,38,9,FMN 18 Binnensingel Westkant
665,Uitbreidingstraat 390,2023-03-18,09:00:00,72,52,20,FMN 18 Binnensingel Westkant
665,Uitbreidingstraat 390,2023-03-18,10:00:00,73,52,21,FMN 18 Binnensingel Westkant
665,Uitbreidingstraat 390,2023-03-18,11:00:00,80,41,39,FMN 18 Binnensingel Westkant
665,Uitbreidingstraat 390,2023-03-18,12:00:00,102,66,36,FMN 18 Binnensingel Westkant
665,Uitbreidingstraat 390,2023-03-18,13:00:00,95,67,28,FMN 18 Binnensingel Westkant
665,Uitbreidingstraat 390,2023-03-18,14:00:00,89,66,23,FMN 18 Binnensingel Westkant
665,Uitbreidingstraat 390,2023-03-18,15:00:00,84,54,30,FMN 18 Binnensingel Westkant
665,Uitbreidingstraat 390,2023-03-18,16:00:00,94,56,38,FMN 18 Binnensingel Westkant
665,Uitbreidingstraat 390,2023-03-18,17:00:00,94,70,24,FMN 18 Binnensingel Westkant
665,Uitbreidingstraat 390,2023-03-18,18:00:00,79,60,19,FMN 18 Binnensingel Westkant
665,Uitbreidingstraat 390,2023-03-18,19:00:00,57,43,14,FMN 18 Binnensingel Westkant
665,Uitbreidingstraat 390,2023-03-18,20:00:00,66,49,17,FMN 18 Binnensingel Westkant
665,Uitbreidingstraat 390,2023-03-18,21:00:00,40,28,12,FMN 18 Binnensingel Westkant
665,Uitbreidingstraat 390,2023-03-18,22:00:00,40,34,6,FMN 18 Binnensingel Westkant
665,Uitbreidingstraat 390,2023-03-18,23:00:00,44,33,11,FMN 18 Binnensingel Westkant
665,Uitbreidingstraat 390,2023-03-19,00:00:00,30,21,9,FMN 18 Binnensingel Westkant
665,Uitbreidingstraat 390,2023-03-19,01:00:00,27,20,7,FMN 18 Binnensingel Westkant
665,Uitbreidingstraat 390,2023-03-19,02:00:00,12,11,1,FMN 18 Binnensingel Westkant
665,Uitbreidingstraat 390,2023-03-19,03:00:00,10,5,5,FMN 18 Binnensingel Westkant
665,Uitbreidingstraat 390,2023-03-19,04:00:00,6,6,0,FMN 18 Binnensingel Westkant
665,Uitbreidingstraat 390,2023-03-19,05:00:00,12,7,5,FMN 18 Binnensingel Westkant
665,Uitbreidingstraat 390,2023-03-19,06:00:00,17,16,1,FMN 18 Binnensingel Westkant
665,Uitbreidingstraat 390,2023-03-19,07:00:00,12,9,3,FMN 18 Binnensingel Westkant
665,Uitbreidingstraat 390,2023-03-19,08:00:00,19,10,9,FMN 18 Binnensingel Westkant
665,Uitbreidingstraat 390,2023-03-19,09:00:00,48,34,14,FMN 18 Binnensingel Westkant
665,Uitbreidingstraat 390,2023-03-19,10:00:00,63,41,22,FMN 18 Binnensingel Westkant
665,Uitbreidingstraat 390,2023-03-19,11:00:00,70,47,23,FMN 18 Binnensingel Westkant
665,Uitbreidingstraat 390,2023-03-19,12:00:00,64,40,24,FMN 18 Binnensingel Westkant
665,Uitbreidingstraat 390,2023-03-19,13:00:00,55,32,23,FMN 18 Binnensingel Westkant
665,Uitbreidingstraat 390,2023-03-19,14:00:00,54,41,13,FMN 18 Binnensingel Westkant
665,Uitbreidingstraat 390,2023-03-19,15:00:00,68,46,22,FMN 18 Binnensingel Westkant
665,Uitbreidingstraat 390,2023-03-19,16:00:00,80,65,15,FMN 18 Binnensingel Westkant
665,Uitbreidingstraat 390,2023-03-19,17:00:00,70,49,21,FMN 18 Binnensingel Westkant
665,Uitbreidingstraat 390,2023-03-19,18:00:00,57,39,18,FMN 18 Binnensingel Westkant
665,Uitbreidingstraat 390,2023-03-19,19:00:00,56,40,16,FMN 18 Binnensingel Westkant
665,Uitbreidingstraat 390,2023-03-19,20:00:00,48,40,8,FMN 18 Binnensingel Westkant
665,Uitbreidingstraat 390,2023-03-19,21:00:00,38,30,8,FMN 18 Binnensingel Westkant
665,Uitbreidingstraat 390,2023-03-19,22:00:00,37,30,7,FMN 18 Binnensingel Westkant
665,Uitbreidingstraat 390,2023-03-19,23:00:00,35,33,2,FMN 18 Binnensingel Westkant
665,Uitbreidingstraat 390,2023-03-20,00:00:00,6,5,1,FMN 18 Binnensingel Westkant
665,Uitbreidingstraat 390,2023-03-20,01:00:00,4,4,0,FMN 18 Binnensingel Westkant
665,Uitbreidingstraat 390,2023-03-20,02:00:00,0,0,0,FMN 18 Binnensingel Westkant
665,Uitbreidingstraat 390,2023-03-20,03:00:00,1,1,0,FMN 18 Binnensingel Westkant
665,Uitbreidingstraat 390,2023-03-20,04:00:00,7,6,1,FMN 18 Binnensingel Westkant
665,Uitbreidingstraat 390,2023-03-20,05:00:00,28,26,2,FMN 18 Binnensingel Westkant
665,Uitbreidingstraat 390,2023-03-20,06:00:00,66,52,14,FMN 18 Binnensingel Westkant
665,Uitbreidingstraat 390,2023-03-20,07:00:00,273,243,30,FMN 18 Binnensingel Westkant
665,Uitbreidingstraat 390,2023-03-20,08:00:00,421,353,68,FMN 18 Binnensingel Westkant
665,Uitbreidingstraat 390,2023-03-20,09:00:00,150,134,16,FMN 18 Binnensingel Westkant
665,Uitbreidingstraat 390,2023-03-20,10:00:00,80,68,12,FMN 18 Binnensingel Westkant
665,Uitbreidingstraat 390,2023-03-20,11:00:00,58,34,24,FMN 18 Binnensingel Westkant
665,Uitbreidingstraat 390,2023-03-20,12:00:00,121,70,51,FMN 18 Binnensingel Westkant
665,Uitbreidingstraat 390,2023-03-20,13:00:00,112,76,36,FMN 18 Binnensingel Westkant
665,Uitbreidingstraat 390,2023-03-20,14:00:00,90,57,33,FMN 18 Binnensingel Westkant
665,Uitbreidingstraat 390,2023-03-20,15:00:00,168,73,95,FMN 18 Binnensingel Westkant
665,Uitbreidingstraat 390,2023-03-20,16:00:00,272,94,178,FMN 18 Binnensingel Westkant
665,Uitbreidingstraat 390,2023-03-20,17:00:00,292,160,132,FMN 18 Binnensingel Westkant
665,Uitbreidingstraat 390,2023-03-20,18:00:00,207,135,72,FMN 18 Binnensingel Westkant
665,Uitbreidingstraat 390,2023-03-20,19:00:00,104,72,32,FMN 18 Binnensingel Westkant
665,Uitbreidingstraat 390,2023-03-20,20:00:00,68,44,24,FMN 18 Binnensingel Westkant
665,Uitbreidingstraat 390,2023-03-20,21:00:00,64,39,25,FMN 18 Binnensingel Westkant
665,Uitbreidingstraat 390,2023-03-20,22:00:00,52,30,22,FMN 18 Binnensingel Westkant
665,Uitbreidingstraat 390,2023-03-20,23:00:00,17,15,2,FMN 18 Binnensingel Westkant
665,Uitbreidingstraat 390,2023-03-21,00:00:00,9,6,3,FMN 18 Binnensingel Westkant
665,Uitbreidingstraat 390,2023-03-21,01:00:00,7,7,0,FMN 18 Binnensingel Westkant
665,Uitbreidingstraat 390,2023-03-21,02:00:00,1,1,0,FMN 18 Binnensingel Westkant
665,Uitbreidingstraat 390,2023-03-21,03:00:00,2,2,0,FMN 18 Binnensingel Westkant
665,Uitbreidingstraat 390,2023-03-21,04:00:00,7,6,1,FMN 18 Binnensingel Westkant
665,Uitbreidingstraat 390,2023-03-21,05:00:00,35,33,2,FMN 18 Binnensingel Westkant
665,Uitbreidingstraat 390,2023-03-21,06:00:00,62,44,18,FMN 18 Binnensingel Westkant
665,Uitbreidingstraat 390,2023-03-21,07:00:00,257,219,38,FMN 18 Binnensingel Westkant
665,Uitbreidingstraat 390,2023-03-21,08:00:00,428,367,61,FMN 18 Binnensingel Westkant
665,Uitbreidingstraat 390,2023-03-21,09:00:00,155,122,33,FMN 18 Binnensingel Westkant
665,Uitbreidingstraat 390,2023-03-21,10:00:00,81,61,20,FMN 18 Binnensingel Westkant
665,Uitbreidingstraat 390,2023-03-21,11:00:00,74,51,23,FMN 18 Binnensingel Westkant
665,Uitbreidingstraat 390,2023-03-21,12:00:00,178,92,86,FMN 18 Binnensingel Westkant
665,Uitbreidingstraat 390,2023-03-21,13:00:00,123,101,22,FMN 18 Binnensingel Westkant
665,Uitbreidingstraat 390,2023-03-21,14:00:00,93,58,35,FMN 18 Binnensingel Westkant
665,Uitbreidingstraat 390,2023-03-21,15:00:00,174,68,106,FMN 18 Binnensingel Westkant
665,Uitbreidingstraat 390,2023-03-21,16:00:00,262,90,172,FMN 18 Binnensingel Westkant
665,Uitbreidingstraat 390,2023-03-21,17:00:00,273,148,125,FMN 18 Binnensingel Westkant
665,Uitbreidingstraat 390,2023-03-21,18:00:00,194,126,68,FMN 18 Binnensingel Westkant
665,Uitbreidingstraat 390,2023-03-21,19:00:00,132,90,42,FMN 18 Binnensingel Westkant
665,Uitbreidingstraat 390,2023-03-21,20:00:00,65,44,21,FMN 18 Binnensingel Westkant
665,Uitbreidingstraat 390,2023-03-21,21:00:00,58,36,22,FMN 18 Binnensingel Westkant
665,Uitbreidingstraat 390,2023-03-21,22:00:00,54,35,19,FMN 18 Binnensingel Westkant
665,Uitbreidingstraat 390,2023-03-21,23:00:00,38,27,11,FMN 18 Binnensingel Westkant
665,Uitbreidingstraat 390,2023-03-22,00:00:00,10,9,1,FMN 18 Binnensingel Westkant
665,Uitbreidingstraat 390,2023-03-22,01:00:00,5,4,1,FMN 18 Binnensingel Westkant
665,Uitbreidingstraat 390,2023-03-22,02:00:00,3,2,1,FMN 18 Binnensingel Westkant
665,Uitbreidingstraat 390,2023-03-22,03:00:00,0,0,0,FMN 18 Binnensingel Westkant
665,Uitbreidingstraat 390,2023-03-22,04:00:00,8,8,0,FMN 18 Binnensingel Westkant
665,Uitbreidingstraat 390,2023-03-22,05:00:00,25,22,3,FMN 18 Binnensingel Westkant
665,Uitbreidingstraat 390,2023-03-22,06:00:00,67,53,14,FMN 18 Binnensingel Westkant
665,Uitbreidingstraat 390,2023-03-22,07:00:00,191,165,26,FMN 18 Binnensingel Westkant
665,Uitbreidingstraat 390,2023-03-22,08:00:00,413,349,64,FMN 18 Binnensingel Westkant
665,Uitbreidingstraat 390,2023-03-22,09:00:00,169,152,17,FMN 18 Binnensingel Westkant
665,Uitbreidingstraat 390,2023-03-22,10:00:00,91,60,31,FMN 18 Binnensingel Westkant
665,Uitbreidingstraat 390,2023-03-22,11:00:00,78,47,31,FMN 18 Binnensingel Westkant
665,Uitbreidingstraat 390,2023-03-22,12:00:00,226,100,126,FMN 18 Binnensingel Westkant
665,Uitbreidingstraat 390,2023-03-22,13:00:00,185,80,105,FMN 18 Binnensingel Westkant
665,Uitbreidingstraat 390,2023-03-22,14:00:00,102,60,42,FMN 18 Binnensingel Westkant
665,Uitbreidingstraat 390,2023-03-22,15:00:00,141,81,60,FMN 18 Binnensingel Westkant
665,Uitbreidingstraat 390,2023-03-22,16:00:00,174,82,92,FMN 18 Binnensingel Westkant
665,Uitbreidingstraat 390,2023-03-22,17:00:00,228,125,103,FMN 18 Binnensingel Westkant
665,Uitbreidingstraat 390,2023-03-22,18:00:00,156,104,52,FMN 18 Binnensingel Westkant
665,Uitbreidingstraat 390,2023-03-22,19:00:00,95,66,29,FMN 18 Binnensingel Westkant
665,Uitbreidingstraat 390,2023-03-22,20:00:00,69,32,37,FMN 18 Binnensingel Westkant
665,Uitbreidingstraat 390,2023-03-22,21:00:00,47,23,24,FMN 18 Binnensingel Westkant
665,Uitbreidingstraat 390,2023-03-22,22:00:00,59,43,16,FMN 18 Binnensingel Westkant
665,Uitbreidingstraat 390,2023-03-22,23:00:00,41,34,7,FMN 18 Binnensingel Westkant
665,Uitbreidingstraat 390,2023-03-23,00:00:00,15,10,5,FMN 18 Binnensingel Westkant
665,Uitbreidingstraat 390,2023-03-23,01:00:00,5,4,1,FMN 18 Binnensingel Westkant
665,Uitbreidingstraat 390,2023-03-23,02:00:00,2,2,0,FMN 18 Binnensingel Westkant
665,Uitbreidingstraat 390,2023-03-23,03:00:00,6,4,2,FMN 18 Binnensingel Westkant
665,Uitbreidingstraat 390,2023-03-23,04:00:00,3,3,0,FMN 18 Binnensingel Westkant
665,Uitbreidingstraat 390,2023-03-23,05:00:00,31,30,1,FMN 18 Binnensingel Westkant
665,Uitbreidingstraat 390,2023-03-23,06:00:00,59,41,18,FMN 18 Binnensingel Westkant
665,Uitbreidingstraat 390,2023-03-23,07:00:00,194,154,40,FMN 18 Binnensingel Westkant
665,Uitbreidingstraat 390,2023-03-23,08:00:00,366,320,46,FMN 18 Binnensingel Westkant
665,Uitbreidingstraat 390,2023-03-23,09:00:00,128,112,16,FMN 18 Binnensingel Westkant
665,Uitbreidingstraat 390,2023-03-23,10:00:00,88,66,22,FMN 18 Binnensingel Westkant
665,Uitbreidingstraat 390,2023-03-23,11:00:00,69,48,21,FMN 18 Binnensingel Westkant
665,Uitbreidingstraat 390,2023-03-23,12:00:00,136,86,50,FMN 18 Binnensingel Westkant
665,Uitbreidingstraat 390,2023-03-23,13:00:00,116,82,34,FMN 18 Binnensingel Westkant
665,Uitbreidingstraat 390,2023-03-23,14:00:00,79,50,29,FMN 18 Binnensingel Westkant
665,Uitbreidingstraat 390,2023-03-23,15:00:00,174,61,113,FMN 18 Binnensingel Westkant
665,Uitbreidingstraat 390,2023-03-23,16:00:00,250,80,170,FMN 18 Binnensingel Westkant
665,Uitbreidingstraat 390,2023-03-23,17:00:00,213,114,99,FMN 18 Binnensingel Westkant
665,Uitbreidingstraat 390,2023-03-23,18:00:00,226,146,80,FMN 18 Binnensingel Westkant
665,Uitbreidingstraat 390,2023-03-23,19:00:00,156,94,62,FMN 18 Binnensingel Westkant
665,Uitbreidingstraat 390,2023-03-23,20:00:00,87,52,35,FMN 18 Binnensingel Westkant
665,Uitbreidingstraat 390,2023-03-23,21:00:00,64,26,38,FMN 18 Binnensingel Westkant
665,Uitbreidingstraat 390,2023-03-23,22:00:00,55,43,12,FMN 18 Binnensingel Westkant
665,Uitbreidingstraat 390,2023-03-23,23:00:00,36,30,6,FMN 18 Binnensingel Westkant
665,Uitbreidingstraat 390,2023-03-24,00:00:00,16,12,4,FMN 18 Binnensingel Westkant
665,Uitbreidingstraat 390,2023-03-24,01:00:00,18,13,5,FMN 18 Binnensingel Westkant
665,Uitbreidingstraat 390,2023-03-24,02:00:00,4,4,0,FMN 18 Binnensingel Westkant
665,Uitbreidingstraat 390,2023-03-24,03:00:00,1,1,0,FMN 18 Binnensingel Westkant
665,Uitbreidingstraat 390,2023-03-24,04:00:00,5,5,0,FMN 18 Binnensingel Westkant
665,Uitbreidingstraat 390,2023-03-24,05:00:00,24,23,1,FMN 18 Binnensingel Westkant
665,Uitbreidingstraat 390,2023-03-24,06:00:00,55,43,12,FMN 18 Binnensingel Westkant
665,Uitbreidingstraat 390,2023-03-24,07:00:00,185,153,32,FMN 18 Binnensingel Westkant
665,Uitbreidingstraat 390,2023-03-24,08:00:00,366,324,42,FMN 18 Binnensingel Westkant
665,Uitbreidingstraat 390,2023-03-24,09:00:00,130,105,25,FMN 18 Binnensingel Westkant
665,Uitbreidingstraat 390,2023-03-24,10:00:00,92,72,20,FMN 18 Binnensingel Westkant
665,Uitbreidingstraat 390,2023-03-24,11:00:00,60,42,18,FMN 18 Binnensingel Westkant
665,Uitbreidingstraat 390,2023-03-24,12:00:00,115,62,53,FMN 18 Binnensingel Westkant
665,Uitbreidingstraat 390,2023-03-24,13:00:00,116,72,44,FMN 18 Binnensingel Westkant
665,Uitbreidingstraat 390,2023-03-24,14:00:00,103,62,41,FMN 18 Binnensingel Westkant
665,Uitbreidingstraat 390,2023-03-24,15:00:00,156,82,74,FMN 18 Binnensingel Westkant
665,Uitbreidingstraat 390,2023-03-24,16:00:00,293,103,190,FMN 18 Binnensingel Westkant
665,Uitbreidingstraat 390,2023-03-24,17:00:00,188,99,89,FMN 18 Binnensingel Westkant
665,Uitbreidingstraat 390,2023-03-24,18:00:00,150,88,62,FMN 18 Binnensingel Westkant
665,Uitbreidingstraat 390,2023-03-24,19:00:00,117,82,35,FMN 18 Binnensingel Westkant
665,Uitbreidingstraat 390,2023-03-24,20:00:00,75,50,25,FMN 18 Binnensingel Westkant
665,Uitbreidingstraat 390,2023-03-24,21:00:00,54,30,24,FMN 18 Binnensingel Westkant
665,Uitbreidingstraat 390,2023-03-24,22:00:00,44,28,16,FMN 18 Binnensingel Westkant
665,Uitbreidingstraat 390,2023-03-24,23:00:00,74,52,22,FMN 18 Binnensingel Westkant
665,Uitbreidingstraat 390,2023-03-25,00:00:00,34,27,7,FMN 18 Binnensingel Westkant
665,Uitbreidingstraat 390,2023-03-25,01:00:00,22,17,5,FMN 18 Binnensingel Westkant
665,Uitbreidingstraat 390,2023-03-25,02:00:00,31,26,5,FMN 18 Binnensingel Westkant
665,Uitbreidingstraat 390,2023-03-25,03:00:00,21,16,5,FMN 18 Binnensingel Westkant
665,Uitbreidingstraat 390,2023-03-25,04:00:00,10,9,1,FMN 18 Binnensingel Westkant
665,Uitbreidingstraat 390,2023-03-25,05:00:00,19,19,0,FMN 18 Binnensingel Westkant
665,Uitbreidingstraat 390,2023-03-25,06:00:00,22,19,3,FMN 18 Binnensingel Westkant
665,Uitbreidingstraat 390,2023-03-25,07:00:00,15,9,6,FMN 18 Binnensingel Westkant
665,Uitbreidingstraat 390,2023-03-25,08:00:00,42,31,11,FMN 18 Binnensingel Westkant
665,Uitbreidingstraat 390,2023-03-25,09:00:00,49,38,11,FMN 18 Binnensingel Westkant
665,Uitbreidingstraat 390,2023-03-25,10:00:00,56,38,18,FMN 18 Binnensingel Westkant
665,Uitbreidingstraat 390,2023-03-25,11:00:00,52,32,20,FMN 18 Binnensingel Westkant
665,Uitbreidingstraat 390,2023-03-25,12:00:00,61,40,21,FMN 18 Binnensingel Westkant
665,Uitbreidingstraat 390,2023-03-25,13:00:00,70,47,23,FMN 18 Binnensingel Westkant
665,Uitbreidingstraat 390,2023-03-25,14:00:00,64,40,24,FMN 18 Binnensingel Westkant
665,Uitbreidingstraat 390,2023-03-25,15:00:00,72,45,27,FMN 18 Binnensingel Westkant
665,Uitbreidingstraat 390,2023-03-25,16:00:00,62,33,29,FMN 18 Binnensingel Westkant
665,Uitbreidingstraat 390,2023-03-25,17:00:00,72,43,29,FMN 18 Binnensingel Westkant
665,Uitbreidingstraat 390,2023-03-25,18:00:00,71,53,18,FMN 18 Binnensingel Westkant
665,Uitbreidingstraat 390,2023-03-25,19:00:00,46,40,6,FMN 18 Binnensingel Westkant
665,Uitbreidingstraat 390,2023-03-25,20:00:00,50,37,13,FMN 18 Binnensingel Westkant
665,Uitbreidingstraat 390,2023-03-25,21:00:00,39,24,15,FMN 18 Binnensingel Westkant
665,Uitbreidingstraat 390,2023-03-25,22:00:00,48,38,10,FMN 18 Binnensingel Westkant
665,Uitbreidingstraat 390,2023-03-25,23:00:00,36,27,9,FMN 18 Binnensingel Westkant
665,Uitbreidingstraat 390,2023-03-26,00:00:00,38,30,8,FMN 18 Binnensingel Westkant
665,Uitbreidingstraat 390,2023-03-26,01:00:00,37,35,2,FMN 18 Binnensingel Westkant
665,Uitbreidingstraat 390,2023-03-26,02:00:00,0,0,0,FMN 18 Binnensingel Westkant
665,Uitbreidingstraat 390,2023-03-26,03:00:00,27,22,5,FMN 18 Binnensingel Westkant
665,Uitbreidingstraat 390,2023-03-26,04:00:00,16,14,2,FMN 18 Binnensingel Westkant
665,Uitbreidingstraat 390,2023-03-26,05:00:00,10,8,2,FMN 18 Binnensingel Westkant
665,Uitbreidingstraat 390,2023-03-26,06:00:00,25,19,6,FMN 18 Binnensingel Westkant
665,Uitbreidingstraat 390,2023-03-26,07:00:00,8,3,5,FMN 18 Binnensingel Westkant
665,Uitbreidingstraat 390,2023-03-26,08:00:00,15,10,5,FMN 18 Binnensingel Westkant
665,Uitbreidingstraat 390,2023-03-26,09:00:00,31,20,11,FMN 18 Binnensingel Westkant
665,Uitbreidingstraat 390,2023-03-26,10:00:00,25,16,9,FMN 18 Binnensingel Westkant
665,Uitbreidingstraat 390,2023-03-26,11:00:00,31,24,7,FMN 18 Binnensingel Westkant
665,Uitbreidingstraat 390,2023-03-26,12:00:00,56,41,15,FMN 18 Binnensingel Westkant
665,Uitbreidingstraat 390,2023-03-26,13:00:00,46,28,18,FMN 18 Binnensingel Westkant
665,Uitbreidingstraat 390,2023-03-26,14:00:00,38,29,9,FMN 18 Binnensingel Westkant
665,Uitbreidingstraat 390,2023-03-26,15:00:00,50,37,13,FMN 18 Binnensingel Westkant
665,Uitbreidingstraat 390,2023-03-26,16:00:00,33,25,8,FMN 18 Binnensingel Westkant
665,Uitbreidingstraat 390,2023-03-26,17:00:00,55,36,19,FMN 18 Binnensingel Westkant
665,Uitbreidingstraat 390,2023-03-26,18:00:00,48,40,8,FMN 18 Binnensingel Westkant
665,Uitbreidingstraat 390,2023-03-26,19:00:00,52,42,10,FMN 18 Binnensingel Westkant
665,Uitbreidingstraat 390,2023-03-26,20:00:00,39,22,17,FMN 18 Binnensingel Westkant
665,Uitbreidingstraat 390,2023-03-26,21:00:00,30,22,8,FMN 18 Binnensingel Westkant
665,Uitbreidingstraat 390,2023-03-26,22:00:00,20,18,2,FMN 18 Binnensingel Westkant
665,Uitbreidingstraat 390,2023-03-26,23:00:00,29,24,5,FMN 18 Binnensingel Westkant
665,Uitbreidingstraat 390,2023-03-27,00:00:00,10,8,2,FMN 18 Binnensingel Westkant
665,Uitbreidingstraat 390,2023-03-27,01:00:00,5,4,1,FMN 18 Binnensingel Westkant
665,Uitbreidingstraat 390,2023-03-27,02:00:00,2,2,0,FMN 18 Binnensingel Westkant
665,Uitbreidingstraat 390,2023-03-27,03:00:00,0,0,0,FMN 18 Binnensingel Westkant
665,Uitbreidingstraat 390,2023-03-27,04:00:00,5,5,0,FMN 18 Binnensingel Westkant
665,Uitbreidingstraat 390,2023-03-27,05:00:00,33,31,2,FMN 18 Binnensingel Westkant
665,Uitbreidingstraat 390,2023-03-27,06:00:00,59,48,11,FMN 18 Binnensingel Westkant
665,Uitbreidingstraat 390,2023-03-27,07:00:00,222,195,27,FMN 18 Binnensingel Westkant
665,Uitbreidingstraat 390,2023-03-27,08:00:00,391,347,44,FMN 18 Binnensingel Westkant
665,Uitbreidingstraat 390,2023-03-27,09:00:00,130,114,16,FMN 18 Binnensingel Westkant
665,Uitbreidingstraat 390,2023-03-27,10:00:00,89,71,18,FMN 18 Binnensingel Westkant
665,Uitbreidingstraat 390,2023-03-27,11:00:00,47,31,16,FMN 18 Binnensingel Westkant
665,Uitbreidingstraat 390,2023-03-27,12:00:00,116,63,53,FMN 18 Binnensingel Westkant
665,Uitbreidingstraat 390,2023-03-27,13:00:00,125,98,27,FMN 18 Binnensingel Westkant
665,Uitbreidingstraat 390,2023-03-27,14:00:00,109,65,44,FMN 18 Binnensingel Westkant
665,Uitbreidingstraat 390,2023-03-27,15:00:00,170,77,93,FMN 18 Binnensingel Westkant
665,Uitbreidingstraat 390,2023-03-27,16:00:00,281,99,182,FMN 18 Binnensingel Westkant
665,Uitbreidingstraat 390,2023-03-27,17:00:00,289,140,149,FMN 18 Binnensingel Westkant
665,Uitbreidingstraat 390,2023-03-27,18:00:00,180,121,59,FMN 18 Binnensingel Westkant
665,Uitbreidingstraat 390,2023-03-27,19:00:00,98,65,33,FMN 18 Binnensingel Westkant
665,Uitbreidingstraat 390,2023-03-27,20:00:00,66,43,23,FMN 18 Binnensingel Westkant
665,Uitbreidingstraat 390,2023-03-27,21:00:00,52,33,19,FMN 18 Binnensingel Westkant
665,Uitbreidingstraat 390,2023-03-27,22:00:00,52,35,17,FMN 18 Binnensingel Westkant
665,Uitbreidingstraat 390,2023-03-27,23:00:00,23,20,3,FMN 18 Binnensingel Westkant
665,Uitbreidingstraat 390,2023-03-28,00:00:00,11,7,4,FMN 18 Binnensingel Westkant
665,Uitbreidingstraat 390,2023-03-28,01:00:00,4,3,1,FMN 18 Binnensingel Westkant
665,Uitbreidingstraat 390,2023-03-28,02:00:00,2,2,0,FMN 18 Binnensingel Westkant
665,Uitbreidingstraat 390,2023-03-28,03:00:00,3,2,1,FMN 18 Binnensingel Westkant
665,Uitbreidingstraat 390,2023-03-28,04:00:00,6,4,2,FMN 18 Binnensingel Westkant
665,Uitbreidingstraat 390,2023-03-28,05:00:00,27,26,1,FMN 18 Binnensingel Westkant
665,Uitbreidingstraat 390,2023-03-28,06:00:00,53,44,9,FMN 18 Binnensingel Westkant
665,Uitbreidingstraat 390,2023-03-28,07:00:00,202,168,34,FMN 18 Binnensingel Westkant
665,Uitbreidingstraat 390,2023-03-28,08:00:00,420,362,58,FMN 18 Binnensingel Westkant
665,Uitbreidingstraat 390,2023-03-28,09:00:00,167,137,30,FMN 18 Binnensingel Westkant
665,Uitbreidingstraat 390,2023-03-28,10:00:00,81,60,21,FMN 18 Binnensingel Westkant
665,Uitbreidingstraat 390,2023-03-28,11:00:00,85,59,26,FMN 18 Binnensingel Westkant
665,Uitbreidingstraat 390,2023-03-28,12:00:00,140,81,59,FMN 18 Binnensingel Westkant
665,Uitbreidingstraat 390,2023-03-28,13:00:00,110,79,31,FMN 18 Binnensingel Westkant
665,Uitbreidingstraat 390,2023-03-28,14:00:00,75,48,27,FMN 18 Binnensingel Westkant
665,Uitbreidingstraat 390,2023-03-28,15:00:00,202,82,120,FMN 18 Binnensingel Westkant
665,Uitbreidingstraat 390,2023-03-28,16:00:00,299,102,197,FMN 18 Binnensingel Westkant
665,Uitbreidingstraat 390,2023-03-28,17:00:00,278,139,139,FMN 18 Binnensingel Westkant
665,Uitbreidingstraat 390,2023-03-28,18:00:00,194,134,60,FMN 18 Binnensingel Westkant
665,Uitbreidingstraat 390,2023-03-28,19:00:00,99,62,37,FMN 18 Binnensingel Westkant
665,Uitbreidingstraat 390,2023-03-28,20:00:00,77,51,26,FMN 18 Binnensingel Westkant
665,Uitbreidingstraat 390,2023-03-28,21:00:00,54,37,17,FMN 18 Binnensingel Westkant
665,Uitbreidingstraat 390,2023-03-28,22:00:00,51,32,19,FMN 18 Binnensingel Westkant
665,Uitbreidingstraat 390,2023-03-28,23:00:00,48,42,6,FMN 18 Binnensingel Westkant
665,Uitbreidingstraat 390,2023-03-29,00:00:00,11,9,2,FMN 18 Binnensingel Westkant
665,Uitbreidingstraat 390,2023-03-29,01:00:00,4,4,0,FMN 18 Binnensingel Westkant
665,Uitbreidingstraat 390,2023-03-29,02:00:00,2,1,1,FMN 18 Binnensingel Westkant
665,Uitbreidingstraat 390,2023-03-29,03:00:00,5,4,1,FMN 18 Binnensingel Westkant
665,Uitbreidingstraat 390,2023-03-29,04:00:00,5,4,1,FMN 18 Binnensingel Westkant
665,Uitbreidingstraat 390,2023-03-29,05:00:00,29,27,2,FMN 18 Binnensingel Westkant
665,Uitbreidingstraat 390,2023-03-29,06:00:00,58,47,11,FMN 18 Binnensingel Westkant
665,Uitbreidingstraat 390,2023-03-29,07:00:00,191,163,28,FMN 18 Binnensingel Westkant
665,Uitbreidingstraat 390,2023-03-29,08:00:00,364,315,49,FMN 18 Binnensingel Westkant
665,Uitbreidingstraat 390,2023-03-29,09:00:00,131,108,23,FMN 18 Binnensingel Westkant
665,Uitbreidingstraat 390,2023-03-29,10:00:00,89,74,15,FMN 18 Binnensingel Westkant
665,Uitbreidingstraat 390,2023-03-29,11:00:00,88,56,32,FMN 18 Binnensingel Westkant
665,Uitbreidingstraat 390,2023-03-29,12:00:00,221,93,128,FMN 18 Binnensingel Westkant
665,Uitbreidingstraat 390,2023-03-29,13:00:00,202,91,111,FMN 18 Binnensingel Westkant
665,Uitbreidingstraat 390,2023-03-29,14:00:00,102,73,29,FMN 18 Binnensingel Westkant
665,Uitbreidingstraat 390,2023-03-29,15:00:00,133,66,67,FMN 18 Binnensingel Westkant
665,Uitbreidingstraat 390,2023-03-29,16:00:00,185,91,94,FMN 18 Binnensingel Westkant
665,Uitbreidingstraat 390,2023-03-29,17:00:00,261,144,117,FMN 18 Binnensingel Westkant
665,Uitbreidingstraat 390,2023-03-29,18:00:00,211,128,83,FMN 18 Binnensingel Westkant
665,Uitbreidingstraat 390,2023-03-29,19:00:00,109,79,30,FMN 18 Binnensingel Westkant
665,Uitbreidingstraat 390,2023-03-29,20:00:00,80,52,28,FMN 18 Binnensingel Westkant
665,Uitbreidingstraat 390,2023-03-29,21:00:00,71,45,26,FMN 18 Binnensingel Westkant
665,Uitbreidingstraat 390,2023-03-29,22:00:00,65,35,30,FMN 18 Binnensingel Westkant
665,Uitbreidingstraat 390,2023-03-29,23:00:00,49,41,8,FMN 18 Binnensingel Westkant
665,Uitbreidingstraat 390,2023-03-30,00:00:00,23,20,3,FMN 18 Binnensingel Westkant
665,Uitbreidingstraat 390,2023-03-30,01:00:00,8,6,2,FMN 18 Binnensingel Westkant
665,Uitbreidingstraat 390,2023-03-30,02:00:00,6,5,1,FMN 18 Binnensingel Westkant
665,Uitbreidingstraat 390,2023-03-30,03:00:00,9,7,2,FMN 18 Binnensingel Westkant
665,Uitbreidingstraat 390,2023-03-30,04:00:00,6,5,1,FMN 18 Binnensingel Westkant
665,Uitbreidingstraat 390,2023-03-30,05:00:00,27,24,3,FMN 18 Binnensingel Westkant
665,Uitbreidingstraat 390,2023-03-30,06:00:00,68,52,16,FMN 18 Binnensingel Westkant
665,Uitbreidingstraat 390,2023-03-30,07:00:00,148,124,24,FMN 18 Binnensingel Westkant
665,Uitbreidingstraat 390,2023-03-30,08:00:00,421,353,68,FMN 18 Binnensingel Westkant
665,Uitbreidingstraat 390,2023-03-30,09:00:00,169,144,25,FMN 18 Binnensingel Westkant
665,Uitbreidingstraat 390,2023-03-30,10:00:00,88,69,19,FMN 18 Binnensingel Westkant
665,Uitbreidingstraat 390,2023-03-30,11:00:00,70,50,20,FMN 18 Binnensingel Westkant
665,Uitbreidingstraat 390,2023-03-30,12:00:00,95,57,38,FMN 18 Binnensingel Westkant
665,Uitbreidingstraat 390,2023-03-30,13:00:00,130,89,41,FMN 18 Binnensingel Westkant
665,Uitbreidingstraat 390,2023-03-30,14:00:00,104,64,40,FMN 18 Binnensingel Westkant
665,Uitbreidingstraat 390,2023-03-30,15:00:00,173,70,103,FMN 18 Binnensingel Westkant
665,Uitbreidingstraat 390,2023-03-30,16:00:00,244,93,151,FMN 18 Binnensingel Westkant
665,Uitbreidingstraat 390,2023-03-30,17:00:00,245,143,102,FMN 18 Binnensingel Westkant
665,Uitbreidingstraat 390,2023-03-30,18:00:00,183,109,74,FMN 18 Binnensingel Westkant
665,Uitbreidingstraat 390,2023-03-30,19:00:00,117,83,34,FMN 18 Binnensingel Westkant
665,Uitbreidingstraat 390,2023-03-30,20:00:00,97,76,21,FMN 18 Binnensingel Westkant
665,Uitbreidingstraat 390,2023-03-30,21:00:00,69,49,20,FMN 18 Binnensingel Westkant
665,Uitbreidingstraat 390,2023-03-30,22:00:00,67,43,24,FMN 18 Binnensingel Westkant
665,Uitbreidingstraat 390,2023-03-30,23:00:00,57,39,18,FMN 18 Binnensingel Westkant
665,Uitbreidingstraat 390,2023-03-31,00:00:00,21,16,5,FMN 18 Binnensingel Westkant
665,Uitbreidingstraat 390,2023-03-31,01:00:00,9,7,2,FMN 18 Binnensingel Westkant
665,Uitbreidingstraat 390,2023-03-31,02:00:00,9,9,0,FMN 18 Binnensingel Westkant
665,Uitbreidingstraat 390,2023-03-31,03:00:00,5,5,0,FMN 18 Binnensingel Westkant
665,Uitbreidingstraat 390,2023-03-31,04:00:00,7,6,1,FMN 18 Binnensingel Westkant
665,Uitbreidingstraat 390,2023-03-31,05:00:00,21,18,3,FMN 18 Binnensingel Westkant
665,Uitbreidingstraat 390,2023-03-31,06:00:00,36,30,6,FMN 18 Binnensingel Westkant
665,Uitbreidingstraat 390,2023-03-31,07:00:00,120,98,22,FMN 18 Binnensingel Westkant
665,Uitbreidingstraat 390,2023-03-31,08:00:00,266,231,35,FMN 18 Binnensingel Westkant
665,Uitbreidingstraat 390,2023-03-31,09:00:00,118,108,10,FMN 18 Binnensingel Westkant
665,Uitbreidingstraat 390,2023-03-31,10:00:00,55,42,13,FMN 18 Binnensingel Westkant
665,Uitbreidingstraat 390,2023-03-31,11:00:00,51,31,20,FMN 18 Binnensingel Westkant
665,Uitbreidingstraat 390,2023-03-31,12:00:00,97,55,42,FMN 18 Binnensingel Westkant
665,Uitbreidingstraat 390,2023-03-31,13:00:00,107,63,44,FMN 18 Binnensingel Westkant
665,Uitbreidingstraat 390,2023-03-31,14:00:00,89,58,31,FMN 18 Binnensingel Westkant
665,Uitbreidingstraat 390,2023-03-31,15:00:00,120,59,61,FMN 18 Binnensingel Westkant
665,Uitbreidingstraat 390,2023-03-31,16:00:00,219,71,148,FMN 18 Binnensingel Westkant
665,Uitbreidingstraat 390,2023-03-31,17:00:00,166,85,81,FMN 18 Binnensingel Westkant
665,Uitbreidingstraat 390,2023-03-31,18:00:00,123,72,51,FMN 18 Binnensingel Westkant
665,Uitbreidingstraat 390,2023-03-31,19:00:00,82,46,36,FMN 18 Binnensingel Westkant
665,Uitbreidingstraat 390,2023-03-31,20:00:00,64,35,29,FMN 18 Binnensingel Westkant
665,Uitbreidingstraat 390,2023-03-31,21:00:00,63,40,23,FMN 18 Binnensingel Westkant
665,Uitbreidingstraat 390,2023-03-31,22:00:00,40,28,12,FMN 18 Binnensingel Westkant
665,Uitbreidingstraat 390,2023-03-31,23:00:00,48,28,20,FMN 18 Binnensingel Westkant
665,Uitbreidingstraat 390,2023-04-01,00:00:00,31,22,9,FMN 18 Binnensingel Westkant
665,Uitbreidingstraat 390,2023-04-01,01:00:00,60,40,20,FMN 18 Binnensingel Westkant
665,Uitbreidingstraat 390,2023-04-01,02:00:00,29,23,6,FMN 18 Binnensingel Westkant
665,Uitbreidingstraat 390,2023-04-01,03:00:00,18,14,4,FMN 18 Binnensingel Westkant
665,Uitbreidingstraat 390,2023-04-01,04:00:00,13,11,2,FMN 18 Binnensingel Westkant
665,Uitbreidingstraat 390,2023-04-01,05:00:00,19,19,0,FMN 18 Binnensingel Westkant
665,Uitbreidingstraat 390,2023-04-01,06:00:00,18,15,3,FMN 18 Binnensingel Westkant
665,Uitbreidingstraat 390,2023-04-01,07:00:00,14,11,3,FMN 18 Binnensingel Westkant
665,Uitbreidingstraat 390,2023-04-01,08:00:00,22,18,4,FMN 18 Binnensingel Westkant
665,Uitbreidingstraat 390,2023-04-01,09:00:00,36,27,9,FMN 18 Binnensingel Westkant
665,Uitbreidingstraat 390,2023-04-01,10:00:00,36,28,8,FMN 18 Binnensingel Westkant
665,Uitbreidingstraat 390,2023-04-01,11:00:00,44,27,17,FMN 18 Binnensingel Westkant
665,Uitbreidingstraat 390,2023-04-01,12:00:00,44,25,19,FMN 18 Binnensingel Westkant
665,Uitbreidingstraat 390,2023-04-01,13:00:00,48,34,14,FMN 18 Binnensingel Westkant
665,Uitbreidingstraat 390,2023-04-01,14:00:00,34,26,8,FMN 18 Binnensingel Westkant
665,Uitbreidingstraat 390,2023-04-01,15:00:00,52,30,22,FMN 18 Binnensingel Westkant
665,Uitbreidingstraat 390,2023-04-01,16:00:00,47,27,20,FMN 18 Binnensingel Westkant
665,Uitbreidingstraat 390,2023-04-01,17:00:00,54,36,18,FMN 18 Binnensingel Westkant
665,Uitbreidingstraat 390,2023-04-01,18:00:00,49,32,17,FMN 18 Binnensingel Westkant
665,Uitbreidingstraat 390,2023-04-01,19:00:00,51,33,18,FMN 18 Binnensingel Westkant
665,Uitbreidingstraat 390,2023-04-01,20:00:00,31,24,7,FMN 18 Binnensingel Westkant
665,Uitbreidingstraat 390,2023-04-01,21:00:00,47,34,13,FMN 18 Binnensingel Westkant
665,Uitbreidingstraat 390,2023-04-01,22:00:00,29,20,9,FMN 18 Binnensingel Westkant
665,Uitbreidingstraat 390,2023-04-01,23:00:00,37,33,4,FMN 18 Binnensingel Westkant
665,Uitbreidingstraat 390,2023-04-02,00:00:00,30,20,10,FMN 18 Binnensingel Westkant
665,Uitbreidingstraat 390,2023-04-02,01:00:00,21,15,6,FMN 18 Binnensingel Westkant
665,Uitbreidingstraat 390,2023-04-02,02:00:00,12,9,3,FMN 18 Binnensingel Westkant
665,Uitbreidingstraat 390,2023-04-02,03:00:00,13,12,1,FMN 18 Binnensingel Westkant
665,Uitbreidingstraat 390,2023-04-02,04:00:00,10,8,2,FMN 18 Binnensingel Westkant
665,Uitbreidingstraat 390,2023-04-02,05:00:00,6,4,2,FMN 18 Binnensingel Westkant
665,Uitbreidingstraat 390,2023-04-02,06:00:00,15,9,6,FMN 18 Binnensingel Westkant
665,Uitbreidingstraat 390,2023-04-02,07:00:00,9,9,0,FMN 18 Binnensingel Westkant
665,Uitbreidingstraat 390,2023-04-02,08:00:00,11,9,2,FMN 18 Binnensingel Westkant
665,Uitbreidingstraat 390,2023-04-02,09:00:00,56,44,12,FMN 18 Binnensingel Westkant
665,Uitbreidingstraat 390,2023-04-02,10:00:00,52,36,16,FMN 18 Binnensingel Westkant
665,Uitbreidingstraat 390,2023-04-02,11:00:00,59,43,16,FMN 18 Binnensingel Westkant
665,Uitbreidingstraat 390,2023-04-02,12:00:00,54,37,17,FMN 18 Binnensingel Westkant
665,Uitbreidingstraat 390,2023-04-02,13:00:00,56,46,10,FMN 18 Binnensingel Westkant
665,Uitbreidingstraat 390,2023-04-02,14:00:00,64,52,12,FMN 18 Binnensingel Westkant
665,Uitbreidingstraat 390,2023-04-02,15:00:00,60,38,22,FMN 18 Binnensingel Westkant
665,Uitbreidingstraat 390,2023-04-02,16:00:00,51,25,26,FMN 18 Binnensingel Westkant
665,Uitbreidingstraat 390,2023-04-02,17:00:00,54,37,17,FMN 18 Binnensingel Westkant
665,Uitbreidingstraat 390,2023-04-02,18:00:00,77,55,22,FMN 18 Binnensingel Westkant
665,Uitbreidingstraat 390,2023-04-02,19:00:00,62,52,10,FMN 18 Binnensingel Westkant
665,Uitbreidingstraat 390,2023-04-02,20:00:00,55,37,18,FMN 18 Binnensingel Westkant
665,Uitbreidingstraat 390,2023-04-02,21:00:00,40,26,14,FMN 18 Binnensingel Westkant
665,Uitbreidingstraat 390,2023-04-02,22:00:00,31,22,9,FMN 18 Binnensingel Westkant
665,Uitbreidingstraat 390,2023-04-02,23:00:00,29,22,7,FMN 18 Binnensingel Westkant
665,Uitbreidingstraat 390,2023-04-03,00:00:00,12,9,3,FMN 18 Binnensingel Westkant
665,Uitbreidingstraat 390,2023-04-03,01:00:00,5,3,2,FMN 18 Binnensingel Westkant
665,Uitbreidingstraat 390,2023-04-03,02:00:00,3,0,3,FMN 18 Binnensingel Westkant
665,Uitbreidingstraat 390,2023-04-03,03:00:00,0,0,0,FMN 18 Binnensingel Westkant
665,Uitbreidingstraat 390,2023-04-03,04:00:00,5,4,1,FMN 18 Binnensingel Westkant
665,Uitbreidingstraat 390,2023-04-03,05:00:00,25,25,0,FMN 18 Binnensingel Westkant
665,Uitbreidingstraat 390,2023-04-03,06:00:00,52,44,8,FMN 18 Binnensingel Westkant
665,Uitbreidingstraat 390,2023-04-03,07:00:00,121,100,21,FMN 18 Binnensingel Westkant
665,Uitbreidingstraat 390,2023-04-03,08:00:00,233,181,52,FMN 18 Binnensingel Westkant
665,Uitbreidingstraat 390,2023-04-03,09:00:00,140,100,40,FMN 18 Binnensingel Westkant
665,Uitbreidingstraat 390,2023-04-03,10:00:00,65,46,19,FMN 18 Binnensingel Westkant
665,Uitbreidingstraat 390,2023-04-03,11:00:00,69,40,29,FMN 18 Binnensingel Westkant
665,Uitbreidingstraat 390,2023-04-03,12:00:00,80,53,27,FMN 18 Binnensingel Westkant
665,Uitbreidingstraat 390,2023-04-03,13:00:00,88,62,26,FMN 18 Binnensingel Westkant
665,Uitbreidingstraat 390,2023-04-03,14:00:00,78,56,22,FMN 18 Binnensingel Westkant
665,Uitbreidingstraat 390,2023-04-03,15:00:00,110,64,46,FMN 18 Binnensingel Westkant
665,Uitbreidingstraat 390,2023-04-03,16:00:00,181,104,77,FMN 18 Binnensingel Westkant
665,Uitbreidingstraat 390,2023-04-03,17:00:00,216,126,90,FMN 18 Binnensingel Westkant
665,Uitbreidingstraat 390,2023-04-03,18:00:00,143,86,57,FMN 18 Binnensingel Westkant
665,Uitbreidingstraat 390,2023-04-03,19:00:00,97,72,25,FMN 18 Binnensingel Westkant
665,Uitbreidingstraat 390,2023-04-03,20:00:00,67,50,17,FMN 18 Binnensingel Westkant
665,Uitbreidingstraat 390,2023-04-03,21:00:00,44,27,17,FMN 18 Binnensingel Westkant
665,Uitbreidingstraat 390,2023-04-03,22:00:00,34,23,11,FMN 18 Binnensingel Westkant
665,Uitbreidingstraat 390,2023-04-03,23:00:00,28,24,4,FMN 18 Binnensingel Westkant
665,Uitbreidingstraat 390,2023-04-04,00:00:00,13,10,3,FMN 18 Binnensingel Westkant
665,Uitbreidingstraat 390,2023-04-04,01:00:00,8,4,4,FMN 18 Binnensingel Westkant
665,Uitbreidingstraat 390,2023-04-04,02:00:00,6,5,1,FMN 18 Binnensingel Westkant
665,Uitbreidingstraat 390,2023-04-04,03:00:00,4,4,0,FMN 18 Binnensingel Westkant
665,Uitbreidingstraat 390,2023-04-04,04:00:00,10,5,5,FMN 18 Binnensingel Westkant
665,Uitbreidingstraat 390,2023-04-04,05:00:00,27,26,1,FMN 18 Binnensingel Westkant
665,Uitbreidingstraat 390,2023-04-04,06:00:00,48,40,8,FMN 18 Binnensingel Westkant
665,Uitbreidingstraat 390,2023-04-04,07:00:00,130,103,27,FMN 18 Binnensingel Westkant
665,Uitbreidingstraat 390,2023-04-04,08:00:00,253,204,49,FMN 18 Binnensingel Westkant
665,Uitbreidingstraat 390,2023-04-04,09:00:00,109,85,24,FMN 18 Binnensingel Westkant
665,Uitbreidingstraat 390,2023-04-04,10:00:00,61,46,15,FMN 18 Binnensingel Westkant
665,Uitbreidingstraat 390,2023-04-04,11:00:00,68,44,24,FMN 18 Binnensingel Westkant
665,Uitbreidingstraat 390,2023-04-04,12:00:00,100,74,26,FMN 18 Binnensingel Westkant
665,Uitbreidingstraat 390,2023-04-04,13:00:00,99,73,26,FMN 18 Binnensingel Westkant
665,Uitbreidingstraat 390,2023-04-04,14:00:00,90,56,34,FMN 18 Binnensingel Westkant
665,Uitbreidingstraat 390,2023-04-04,15:00:00,103,54,49,FMN 18 Binnensingel Westkant
665,Uitbreidingstraat 390,2023-04-04,16:00:00,200,123,77,FMN 18 Binnensingel Westkant
665,Uitbreidingstraat 390,2023-04-04,17:00:00,222,122,100,FMN 18 Binnensingel Westkant
665,Uitbreidingstraat 390,2023-04-04,18:00:00,176,124,52,FMN 18 Binnensingel Westkant
665,Uitbreidingstraat 390,2023-04-04,19:00:00,97,67,30,FMN 18 Binnensingel Westkant
665,Uitbreidingstraat 390,2023-04-04,20:00:00,64,49,15,FMN 18 Binnensingel Westkant
665,Uitbreidingstraat 390,2023-04-04,21:00:00,49,31,18,FMN 18 Binnensingel Westkant
665,Uitbreidingstraat 390,2023-04-04,22:00:00,57,49,8,FMN 18 Binnensingel Westkant
665,Uitbreidingstraat 390,2023-04-04,23:00:00,28,25,3,FMN 18 Binnensingel Westkant
665,Uitbreidingstraat 390,2023-04-05,00:00:00,17,14,3,FMN 18 Binnensingel Westkant
665,Uitbreidingstraat 390,2023-04-05,01:00:00,8,4,4,FMN 18 Binnensingel Westkant
665,Uitbreidingstraat 390,2023-04-05,02:00:00,0,0,0,FMN 18 Binnensingel Westkant
665,Uitbreidingstraat 390,2023-04-05,03:00:00,5,4,1,FMN 18 Binnensingel Westkant
665,Uitbreidingstraat 390,2023-04-05,04:00:00,8,7,1,FMN 18 Binnensingel Westkant
665,Uitbreidingstraat 390,2023-04-05,05:00:00,31,23,8,FMN 18 Binnensingel Westkant
665,Uitbreidingstraat 390,2023-04-05,06:00:00,74,50,24,FMN 18 Binnensingel Westkant
665,Uitbreidingstraat 390,2023-04-05,07:00:00,156,96,60,FMN 18 Binnensingel Westkant
665,Uitbreidingstraat 390,2023-04-05,08:00:00,306,182,124,FMN 18 Binnensingel Westkant
665,Uitbreidingstraat 390,2023-04-05,09:00:00,137,93,44,FMN 18 Binnensingel Westkant
665,Uitbreidingstraat 390,2023-04-05,10:00:00,82,46,36,FMN 18 Binnensingel Westkant
665,Uitbreidingstraat 390,2023-04-05,11:00:00,78,49,29,FMN 18 Binnensingel Westkant
665,Uitbreidingstraat 390,2023-04-05,12:00:00,138,69,69,FMN 18 Binnensingel Westkant
665,Uitbreidingstraat 390,2023-04-05,13:00:00,132,68,64,FMN 18 Binnensingel Westkant
665,Uitbreidingstraat 390,2023-04-05,14:00:00,102,79,23,FMN 18 Binnensingel Westkant
665,Uitbreidingstraat 390,2023-04-05,15:00:00,118,77,41,FMN 18 Binnensingel Westkant
665,Uitbreidingstraat 390,2023-04-05,16:00:00,155,92,63,FMN 18 Binnensingel Westkant
665,Uitbreidingstraat 390,2023-04-05,17:00:00,144,64,80,FMN 18 Binnensingel Westkant
665,Uitbreidingstraat 390,2023-04-05,18:00:00,63,0,63,FMN 18 Binnensingel Westkant
665,Uitbreidingstraat 390,2023-04-05,19:00:00,33,0,33,FMN 18 Binnensingel Westkant
665,Uitbreidingstraat 390,2023-04-05,20:00:00,24,0,24,FMN 18 Binnensingel Westkant
665,Uitbreidingstraat 390,2023-04-05,21:00:00,15,0,15,FMN 18 Binnensingel Westkant
665,Uitbreidingstraat 390,2023-04-05,22:00:00,18,0,18,FMN 18 Binnensingel Westkant
665,Uitbreidingstraat 390,2023-04-05,23:00:00,18,0,18,FMN 18 Binnensingel Westkant
665,Uitbreidingstraat 390,2023-04-06,00:00:00,0,0,0,FMN 18 Binnensingel Westkant
665,Uitbreidingstraat 390,2023-04-06,01:00:00,3,1,2,FMN 18 Binnensingel Westkant
665,Uitbreidingstraat 390,2023-04-06,02:00:00,6,2,4,FMN 18 Binnensingel Westkant
665,Uitbreidingstraat 390,2023-04-06,03:00:00,2,1,1,FMN 18 Binnensingel Westkant
665,Uitbreidingstraat 390,2023-04-06,04:00:00,8,5,3,FMN 18 Binnensingel Westkant
665,Uitbreidingstraat 390,2023-04-06,05:00:00,15,7,8,FMN 18 Binnensingel Westkant
665,Uitbreidingstraat 390,2023-04-06,06:00:00,48,21,27,FMN 18 Binnensingel Westkant
665,Uitbreidingstraat 390,2023-04-06,07:00:00,155,70,85,FMN 18 Binnensingel Westkant
665,Uitbreidingstraat 390,2023-04-06,08:00:00,284,131,153,FMN 18 Binnensingel Westkant
665,Uitbreidingstraat 390,2023-04-06,09:00:00,127,58,69,FMN 18 Binnensingel Westkant
665,Uitbreidingstraat 390,2023-04-06,10:00:00,77,31,46,FMN 18 Binnensingel Westkant
665,Uitbreidingstraat 390,2023-04-06,11:00:00,68,30,38,FMN 18 Binnensingel Westkant
665,Uitbreidingstraat 390,2023-04-06,12:00:00,85,43,42,FMN 18 Binnensingel Westkant
665,Uitbreidingstraat 390,2023-04-06,13:00:00,92,46,46,FMN 18 Binnensingel Westkant
665,Uitbreidingstraat 390,2023-04-06,14:00:00,67,29,38,FMN 18 Binnensingel Westkant
665,Uitbreidingstraat 390,2023-04-06,15:00:00,124,52,72,FMN 18 Binnensingel Westkant
665,Uitbreidingstraat 390,2023-04-06,16:00:00,194,89,105,FMN 18 Binnensingel Westkant
665,Uitbreidingstraat 390,2023-04-06,17:00:00,182,86,96,FMN 18 Binnensingel Westkant
665,Uitbreidingstraat 390,2023-04-06,18:00:00,157,75,82,FMN 18 Binnensingel Westkant
665,Uitbreidingstraat 390,2023-04-06,19:00:00,94,44,50,FMN 18 Binnensingel Westkant
665,Uitbreidingstraat 390,2023-04-06,20:00:00,56,26,30,FMN 18 Binnensingel Westkant
665,Uitbreidingstraat 390,2023-04-06,21:00:00,52,27,25,FMN 18 Binnensingel Westkant
665,Uitbreidingstraat 390,2023-04-06,22:00:00,47,22,25,FMN 18 Binnensingel Westkant
665,Uitbreidingstraat 390,2023-04-06,23:00:00,36,17,19,FMN 18 Binnensingel Westkant
665,Uitbreidingstraat 390,2023-04-07,00:00:00,0,0,0,FMN 18 Binnensingel Westkant
665,Uitbreidingstraat 390,2023-04-07,01:00:00,9,5,4,FMN 18 Binnensingel Westkant
665,Uitbreidingstraat 390,2023-04-07,02:00:00,4,2,2,FMN 18 Binnensingel Westkant
665,Uitbreidingstraat 390,2023-04-07,03:00:00,4,3,1,FMN 18 Binnensingel Westkant
665,Uitbreidingstraat 390,2023-04-07,04:00:00,12,5,7,FMN 18 Binnensingel Westkant
665,Uitbreidingstraat 390,2023-04-07,05:00:00,23,14,9,FMN 18 Binnensingel Westkant
665,Uitbreidingstraat 390,2023-04-07,06:00:00,43,26,17,FMN 18 Binnensingel Westkant
665,Uitbreidingstraat 390,2023-04-07,07:00:00,134,78,56,FMN 18 Binnensingel Westkant
665,Uitbreidingstraat 390,2023-04-07,08:00:00,272,166,106,FMN 18 Binnensingel Westkant
665,Uitbreidingstraat 390,2023-04-07,09:00:00,110,55,55,FMN 18 Binnensingel Westkant
665,Uitbreidingstraat 390,2023-04-07,10:00:00,80,50,30,FMN 18 Binnensingel Westkant
665,Uitbreidingstraat 390,2023-04-07,11:00:00,67,44,23,FMN 18 Binnensingel Westkant
665,Uitbreidingstraat 390,2023-04-07,12:00:00,96,51,45,FMN 18 Binnensingel Westkant
665,Uitbreidingstraat 390,2023-04-07,13:00:00,96,58,38,FMN 18 Binnensingel Westkant
665,Uitbreidingstraat 390,2023-04-07,14:00:00,74,43,31,FMN 18 Binnensingel Westkant
665,Uitbreidingstraat 390,2023-04-07,15:00:00,121,71,50,FMN 18 Binnensingel Westkant
665,Uitbreidingstraat 390,2023-04-07,16:00:00,179,94,85,FMN 18 Binnensingel Westkant
665,Uitbreidingstraat 390,2023-04-07,17:00:00,150,85,65,FMN 18 Binnensingel Westkant
665,Uitbreidingstraat 390,2023-04-07,18:00:00,124,71,53,FMN 18 Binnensingel Westkant
665,Uitbreidingstraat 390,2023-04-07,19:00:00,85,53,32,FMN 18 Binnensingel Westkant
665,Uitbreidingstraat 390,2023-04-07,20:00:00,52,20,32,FMN 18 Binnensingel Westkant
665,Uitbreidingstraat 390,2023-04-07,21:00:00,37,22,15,FMN 18 Binnensingel Westkant
665,Uitbreidingstraat 390,2023-04-07,22:00:00,50,25,25,FMN 18 Binnensingel Westkant
665,Uitbreidingstraat 390,2023-04-07,23:00:00,30,17,13,FMN 18 Binnensingel Westkant
665,Uitbreidingstraat 390,2023-04-08,00:00:00,0,0,0,FMN 18 Binnensingel Westkant
665,Uitbreidingstraat 390,2023-04-08,01:00:00,37,25,12,FMN 18 Binnensingel Westkant
665,Uitbreidingstraat 390,2023-04-08,02:00:00,24,18,6,FMN 18 Binnensingel Westkant
665,Uitbreidingstraat 390,2023-04-08,03:00:00,21,14,7,FMN 18 Binnensingel Westkant
665,Uitbreidingstraat 390,2023-04-08,04:00:00,17,9,8,FMN 18 Binnensingel Westkant
665,Uitbreidingstraat 390,2023-04-08,05:00:00,18,13,5,FMN 18 Binnensingel Westkant
665,Uitbreidingstraat 390,2023-04-08,06:00:00,29,22,7,FMN 18 Binnensingel Westkant
665,Uitbreidingstraat 390,2023-04-08,07:00:00,16,10,6,FMN 18 Binnensingel Westkant
665,Uitbreidingstraat 390,2023-04-08,08:00:00,36,26,10,FMN 18 Binnensingel Westkant
665,Uitbreidingstraat 390,2023-04-08,09:00:00,64,44,20,FMN 18 Binnensingel Westkant
665,Uitbreidingstraat 390,2023-04-08,10:00:00,70,43,27,FMN 18 Binnensingel Westkant
665,Uitbreidingstraat 390,2023-04-08,11:00:00,84,51,33,FMN 18 Binnensingel Westkant
665,Uitbreidingstraat 390,2023-04-08,12:00:00,91,56,35,FMN 18 Binnensingel Westkant
665,Uitbreidingstraat 390,2023-04-08,13:00:00,93,68,25,FMN 18 Binnensingel Westkant
665,Uitbreidingstraat 390,2023-04-08,14:00:00,89,51,38,FMN 18 Binnensingel Westkant
665,Uitbreidingstraat 390,2023-04-08,15:00:00,80,46,34,FMN 18 Binnensingel Westkant
665,Uitbreidingstraat 390,2023-04-08,16:00:00,90,55,35,FMN 18 Binnensingel Westkant
665,Uitbreidingstraat 390,2023-04-08,17:00:00,93,57,36,FMN 18 Binnensingel Westkant
665,Uitbreidingstraat 390,2023-04-08,18:00:00,92,58,34,FMN 18 Binnensingel Westkant
665,Uitbreidingstraat 390,2023-04-08,19:00:00,83,56,27,FMN 18 Binnensingel Westkant
665,Uitbreidingstraat 390,2023-04-08,20:00:00,57,39,18,FMN 18 Binnensingel Westkant
665,Uitbreidingstraat 390,2023-04-08,21:00:00,50,34,16,FMN 18 Binnensingel Westkant
665,Uitbreidingstraat 390,2023-04-08,22:00:00,47,30,17,FMN 18 Binnensingel Westkant
665,Uitbreidingstraat 390,2023-04-08,23:00:00,54,32,22,FMN 18 Binnensingel Westkant
665,Uitbreidingstraat 390,2023-04-09,00:00:00,0,0,0,FMN 18 Binnensingel Westkant
665,Uitbreidingstraat 390,2023-04-09,01:00:00,30,20,10,FMN 18 Binnensingel Westkant
665,Uitbreidingstraat 390,2023-04-09,02:00:00,21,16,5,FMN 18 Binnensingel Westkant
665,Uitbreidingstraat 390,2023-04-09,03:00:00,17,13,4,FMN 18 Binnensingel Westkant
665,Uitbreidingstraat 390,2023-04-09,04:00:00,18,10,8,FMN 18 Binnensingel Westkant
665,Uitbreidingstraat 390,2023-04-09,05:00:00,15,8,7,FMN 18 Binnensingel Westkant
665,Uitbreidingstraat 390,2023-04-09,06:00:00,24,20,4,FMN 18 Binnensingel Westkant
665,Uitbreidingstraat 390,2023-04-09,07:00:00,13,9,4,FMN 18 Binnensingel Westkant
665,Uitbreidingstraat 390,2023-04-09,08:00:00,20,14,6,FMN 18 Binnensingel Westkant
665,Uitbreidingstraat 390,2023-04-09,09:00:00,54,38,16,FMN 18 Binnensingel Westkant
665,Uitbreidingstraat 390,2023-04-09,10:00:00,57,41,16,FMN 18 Binnensingel Westkant
665,Uitbreidingstraat 390,2023-04-09,11:00:00,67,53,14,FMN 18 Binnensingel Westkant
665,Uitbreidingstraat 390,2023-04-09,12:00:00,90,64,26,FMN 18 Binnensingel Westkant
665,Uitbreidingstraat 390,2023-04-09,13:00:00,76,55,21,FMN 18 Binnensingel Westkant
665,Uitbreidingstraat 390,2023-04-09,14:00:00,78,54,24,FMN 18 Binnensingel Westkant
665,Uitbreidingstraat 390,2023-04-09,15:00:00,62,42,20,FMN 18 Binnensingel Westkant
665,Uitbreidingstraat 390,2023-04-09,16:00:00,72,55,17,FMN 18 Binnensingel Westkant
665,Uitbreidingstraat 390,2023-04-09,17:00:00,69,54,15,FMN 18 Binnensingel Westkant
665,Uitbreidingstraat 390,2023-04-09,18:00:00,65,54,11,FMN 18 Binnensingel Westkant
665,Uitbreidingstraat 390,2023-04-09,19:00:00,75,59,16,FMN 18 Binnensingel Westkant
665,Uitbreidingstraat 390,2023-04-09,20:00:00,56,41,15,FMN 18 Binnensingel Westkant
665,Uitbreidingstraat 390,2023-04-09,21:00:00,44,34,10,FMN 18 Binnensingel Westkant
665,Uitbreidingstraat 390,2023-04-09,22:00:00,26,18,8,FMN 18 Binnensingel Westkant
665,Uitbreidingstraat 390,2023-04-09,23:00:00,19,13,6,FMN 18 Binnensingel Westkant
665,Uitbreidingstraat 390,2023-04-10,00:00:00,0,0,0,FMN 18 Binnensingel Westkant
665,Uitbreidingstraat 390,2023-04-10,01:00:00,1,0,1,FMN 18 Binnensingel Westkant
665,Uitbreidingstraat 390,2023-04-10,02:00:00,0,0,0,FMN 18 Binnensingel Westkant
665,Uitbreidingstraat 390,2023-04-10,03:00:00,0,0,0,FMN 18 Binnensingel Westkant
665,Uitbreidingstraat 390,2023-04-10,04:00:00,3,1,2,FMN 18 Binnensingel Westkant
665,Uitbreidingstraat 390,2023-04-10,05:00:00,17,11,6,FMN 18 Binnensingel Westkant
665,Uitbreidingstraat 390,2023-04-10,06:00:00,34,7,27,FMN 18 Binnensingel Westkant
665,Uitbreidingstraat 390,2023-04-10,07:00:00,128,57,71,FMN 18 Binnensingel Westkant
665,Uitbreidingstraat 390,2023-04-10,08:00:00,206,77,129,FMN 18 Binnensingel Westkant
665,Uitbreidingstraat 390,2023-04-10,09:00:00,80,25,55,FMN 18 Binnensingel Westkant
665,Uitbreidingstraat 390,2023-04-10,10:00:00,51,17,34,FMN 18 Binnensingel Westkant
665,Uitbreidingstraat 390,2023-04-10,11:00:00,44,13,31,FMN 18 Binnensingel Westkant
665,Uitbreidingstraat 390,2023-04-10,12:00:00,82,33,49,FMN 18 Binnensingel Westkant
665,Uitbreidingstraat 390,2023-04-10,13:00:00,54,20,34,FMN 18 Binnensingel Westkant
665,Uitbreidingstraat 390,2023-04-10,14:00:00,53,19,34,FMN 18 Binnensingel Westkant
665,Uitbreidingstraat 390,2023-04-10,15:00:00,90,34,56,FMN 18 Binnensingel Westkant
665,Uitbreidingstraat 390,2023-04-10,16:00:00,149,53,96,FMN 18 Binnensingel Westkant
665,Uitbreidingstraat 390,2023-04-10,17:00:00,142,52,90,FMN 18 Binnensingel Westkant
665,Uitbreidingstraat 390,2023-04-10,18:00:00,100,36,64,FMN 18 Binnensingel Westkant
665,Uitbreidingstraat 390,2023-04-10,19:00:00,59,26,33,FMN 18 Binnensingel Westkant
665,Uitbreidingstraat 390,2023-04-10,20:00:00,32,14,18,FMN 18 Binnensingel Westkant
665,Uitbreidingstraat 390,2023-04-10,21:00:00,37,13,24,FMN 18 Binnensingel Westkant
665,Uitbreidingstraat 390,2023-04-10,22:00:00,25,11,14,FMN 18 Binnensingel Westkant
665,Uitbreidingstraat 390,2023-04-10,23:00:00,12,6,6,FMN 18 Binnensingel Westkant
665,Uitbreidingstraat 390,2023-04-11,00:00:00,0,0,0,FMN 18 Binnensingel Westkant
665,Uitbreidingstraat 390,2023-04-11,01:00:00,5,2,3,FMN 18 Binnensingel Westkant
665,Uitbreidingstraat 390,2023-04-11,02:00:00,0,0,0,FMN 18 Binnensingel Westkant
665,Uitbreidingstraat 390,2023-04-11,03:00:00,4,2,2,FMN 18 Binnensingel Westkant
665,Uitbreidingstraat 390,2023-04-11,04:00:00,9,4,5,FMN 18 Binnensingel Westkant
665,Uitbreidingstraat 390,2023-04-11,05:00:00,27,20,7,FMN 18 Binnensingel Westkant
665,Uitbreidingstraat 390,2023-04-11,06:00:00,57,30,27,FMN 18 Binnensingel Westkant
665,Uitbreidingstraat 390,2023-04-11,07:00:00,184,116,68,FMN 18 Binnensingel Westkant
665,Uitbreidingstraat 390,2023-04-11,08:00:00,349,201,148,FMN 18 Binnensingel Westkant
665,Uitbreidingstraat 390,2023-04-11,09:00:00,139,80,59,FMN 18 Binnensingel Westkant
665,Uitbreidingstraat 390,2023-04-11,10:00:00,78,45,33,FMN 18 Binnensingel Westkant
665,Uitbreidingstraat 390,2023-04-11,11:00:00,74,38,36,FMN 18 Binnensingel Westkant
665,Uitbreidingstraat 390,2023-04-11,12:00:00,118,66,52,FMN 18 Binnensingel Westkant
665,Uitbreidingstraat 390,2023-04-11,13:00:00,113,60,53,FMN 18 Binnensingel Westkant
665,Uitbreidingstraat 390,2023-04-11,14:00:00,76,46,30,FMN 18 Binnensingel Westkant
665,Uitbreidingstraat 390,2023-04-11,15:00:00,151,78,73,FMN 18 Binnensingel Westkant
665,Uitbreidingstraat 390,2023-04-11,16:00:00,245,133,112,FMN 18 Binnensingel Westkant
665,Uitbreidingstraat 390,2023-04-11,17:00:00,253,132,121,FMN 18 Binnensingel Westkant
665,Uitbreidingstraat 390,2023-04-11,18:00:00,195,107,88,FMN 18 Binnensingel Westkant
665,Uitbreidingstraat 390,2023-04-11,19:00:00,104,55,49,FMN 18 Binnensingel Westkant
665,Uitbreidingstraat 390,2023-04-11,20:00:00,54,30,24,FMN 18 Binnensingel Westkant
665,Uitbreidingstraat 390,2023-04-11,21:00:00,45,29,16,FMN 18 Binnensingel Westkant
665,Uitbreidingstraat 390,2023-04-11,22:00:00,38,24,14,FMN 18 Binnensingel Westkant
665,Uitbreidingstraat 390,2023-04-11,23:00:00,27,15,12,FMN 18 Binnensingel Westkant
665,Uitbreidingstraat 390,2023-04-12,00:00:00,0,0,0,FMN 18 Binnensingel Westkant
665,Uitbreidingstraat 390,2023-04-12,01:00:00,3,2,1,FMN 18 Binnensingel Westkant
665,Uitbreidingstraat 390,2023-04-12,02:00:00,1,0,1,FMN 18 Binnensingel Westkant
665,Uitbreidingstraat 390,2023-04-12,03:00:00,5,3,2,FMN 18 Binnensingel Westkant
665,Uitbreidingstraat 390,2023-04-12,04:00:00,4,3,1,FMN 18 Binnensingel Westkant
665,Uitbreidingstraat 390,2023-04-12,05:00:00,22,16,6,FMN 18 Binnensingel Westkant
665,Uitbreidingstraat 390,2023-04-12,06:00:00,44,23,21,FMN 18 Binnensingel Westkant
665,Uitbreidingstraat 390,2023-04-12,07:00:00,142,73,69,FMN 18 Binnensingel Westkant
665,Uitbreidingstraat 390,2023-04-12,08:00:00,261,148,113,FMN 18 Binnensingel Westkant
665,Uitbreidingstraat 390,2023-04-12,09:00:00,104,60,44,FMN 18 Binnensingel Westkant
665,Uitbreidingstraat 390,2023-04-12,10:00:00,80,45,35,FMN 18 Binnensingel Westkant
665,Uitbreidingstraat 390,2023-04-12,11:00:00,59,29,30,FMN 18 Binnensingel Westkant
665,Uitbreidingstraat 390,2023-04-12,12:00:00,148,79,69,FMN 18 Binnensingel Westkant
665,Uitbreidingstraat 390,2023-04-12,13:00:00,120,66,54,FMN 18 Binnensingel Westkant
665,Uitbreidingstraat 390,2023-04-12,14:00:00,91,45,46,FMN 18 Binnensingel Westkant
665,Uitbreidingstraat 390,2023-04-12,15:00:00,117,55,62,FMN 18 Binnensingel Westkant
665,Uitbreidingstraat 390,2023-04-12,16:00:00,145,74,71,FMN 18 Binnensingel Westkant
665,Uitbreidingstraat 390,2023-04-12,17:00:00,193,109,84,FMN 18 Binnensingel Westkant
665,Uitbreidingstraat 390,2023-04-12,18:00:00,119,68,51,FMN 18 Binnensingel Westkant
665,Uitbreidingstraat 390,2023-04-12,19:00:00,85,46,39,FMN 18 Binnensingel Westkant
665,Uitbreidingstraat 390,2023-04-12,20:00:00,54,31,23,FMN 18 Binnensingel Westkant
665,Uitbreidingstraat 390,2023-04-12,21:00:00,40,18,22,FMN 18 Binnensingel Westkant
665,Uitbreidingstraat 390,2023-04-12,22:00:00,45,25,20,FMN 18 Binnensingel Westkant
665,Uitbreidingstraat 390,2023-04-12,23:00:00,30,18,12,FMN 18 Binnensingel Westkant
665,Uitbreidingstraat 390,2023-04-13,00:00:00,0,0,0,FMN 18 Binnensingel Westkant
665,Uitbreidingstraat 390,2023-04-13,01:00:00,6,3,3,FMN 18 Binnensingel Westkant
665,Uitbreidingstraat 390,2023-04-13,02:00:00,3,1,2,FMN 18 Binnensingel Westkant
665,Uitbreidingstraat 390,2023-04-13,03:00:00,8,5,3,FMN 18 Binnensingel Westkant
665,Uitbreidingstraat 390,2023-04-13,04:00:00,6,5,1,FMN 18 Binnensingel Westkant
665,Uitbreidingstraat 390,2023-04-13,05:00:00,22,18,4,FMN 18 Binnensingel Westkant
665,Uitbreidingstraat 390,2023-04-13,06:00:00,53,30,23,FMN 18 Binnensingel Westkant
665,Uitbreidingstraat 390,2023-04-13,07:00:00,177,93,84,FMN 18 Binnensingel Westkant
665,Uitbreidingstraat 390,2023-04-13,08:00:00,348,199,149,FMN 18 Binnensingel Westkant
665,Uitbreidingstraat 390,2023-04-13,09:00:00,139,80,59,FMN 18 Binnensingel Westkant
665,Uitbreidingstraat 390,2023-04-13,10:00:00,96,54,42,FMN 18 Binnensingel Westkant
665,Uitbreidingstraat 390,2023-04-13,11:00:00,67,34,33,FMN 18 Binnensingel Westkant
665,Uitbreidingstraat 390,2023-04-13,12:00:00,124,71,53,FMN 18 Binnensingel Westkant
665,Uitbreidingstraat 390,2023-04-13,13:00:00,101,54,47,FMN 18 Binnensingel Westkant
665,Uitbreidingstraat 390,2023-04-13,14:00:00,93,54,39,FMN 18 Binnensingel Westkant
665,Uitbreidingstraat 390,2023-04-13,15:00:00,139,74,65,FMN 18 Binnensingel Westkant
665,Uitbreidingstraat 390,2023-04-13,16:00:00,220,121,99,FMN 18 Binnensingel Westkant
665,Uitbreidingstraat 390,2023-04-13,17:00:00,227,129,98,FMN 18 Binnensingel Westkant
665,Uitbreidingstraat 390,2023-04-13,18:00:00,180,107,73,FMN 18 Binnensingel Westkant
665,Uitbreidingstraat 390,2023-04-13,19:00:00,111,61,50,FMN 18 Binnensingel Westkant
665,Uitbreidingstraat 390,2023-04-13,20:00:00,64,33,31,FMN 18 Binnensingel Westkant
665,Uitbreidingstraat 390,2023-04-13,21:00:00,58,33,25,FMN 18 Binnensingel Westkant
665,Uitbreidingstraat 390,2023-04-13,22:00:00,53,33,20,FMN 18 Binnensingel Westkant
665,Uitbreidingstraat 390,2023-04-13,23:00:00,41,15,26,FMN 18 Binnensingel Westkant
665,Uitbreidingstraat 390,2023-04-14,00:00:00,0,0,0,FMN 18 Binnensingel Westkant
665,Uitbreidingstraat 390,2023-04-14,01:00:00,7,2,5,FMN 18 Binnensingel Westkant
665,Uitbreidingstraat 390,2023-04-14,02:00:00,6,5,1,FMN 18 Binnensingel Westkant
665,Uitbreidingstraat 390,2023-04-14,03:00:00,7,4,3,FMN 18 Binnensingel Westkant
665,Uitbreidingstraat 390,2023-04-14,04:00:00,9,7,2,FMN 18 Binnensingel Westkant
665,Uitbreidingstraat 390,2023-04-14,05:00:00,23,15,8,FMN 18 Binnensingel Westkant
665,Uitbreidingstraat 390,2023-04-14,06:00:00,51,37,14,FMN 18 Binnensingel Westkant
665,Uitbreidingstraat 390,2023-04-14,07:00:00,158,101,57,FMN 18 Binnensingel Westkant
665,Uitbreidingstraat 390,2023-04-14,08:00:00,300,193,107,FMN 18 Binnensingel Westkant
665,Uitbreidingstraat 390,2023-04-14,09:00:00,111,67,44,FMN 18 Binnensingel Westkant
665,Uitbreidingstraat 390,2023-04-14,10:00:00,107,68,39,FMN 18 Binnensingel Westkant
665,Uitbreidingstraat 390,2023-04-14,11:00:00,83,50,33,FMN 18 Binnensingel Westkant
665,Uitbreidingstraat 390,2023-04-14,12:00:00,105,61,44,FMN 18 Binnensingel Westkant
665,Uitbreidingstraat 390,2023-04-14,13:00:00,109,68,41,FMN 18 Binnensingel Westkant
665,Uitbreidingstraat 390,2023-04-14,14:00:00,101,64,37,FMN 18 Binnensingel Westkant
665,Uitbreidingstraat 390,2023-04-14,15:00:00,143,80,63,FMN 18 Binnensingel Westkant
665,Uitbreidingstraat 390,2023-04-14,16:00:00,219,127,92,FMN 18 Binnensingel Westkant
665,Uitbreidingstraat 390,2023-04-14,17:00:00,174,102,72,FMN 18 Binnensingel Westkant
665,Uitbreidingstraat 390,2023-04-14,18:00:00,135,85,50,FMN 18 Binnensingel Westkant
665,Uitbreidingstraat 390,2023-04-14,19:00:00,99,65,34,FMN 18 Binnensingel Westkant
665,Uitbreidingstraat 390,2023-04-14,20:00:00,54,32,22,FMN 18 Binnensingel Westkant
665,Uitbreidingstraat 390,2023-04-14,21:00:00,44,26,18,FMN 18 Binnensingel Westkant
665,Uitbreidingstraat 390,2023-04-14,22:00:00,53,34,19,FMN 18 Binnensingel Westkant
665,Uitbreidingstraat 390,2023-04-14,23:00:00,54,32,22,FMN 18 Binnensingel Westkant
665,Uitbreidingstraat 390,2023-04-15,00:00:00,0,0,0,FMN 18 Binnensingel Westkant
665,Uitbreidingstraat 390,2023-04-15,01:00:00,37,27,10,FMN 18 Binnensingel Westkant
665,Uitbreidingstraat 390,2023-04-15,02:00:00,30,23,7,FMN 18 Binnensingel Westkant
665,Uitbreidingstraat 390,2023-04-15,03:00:00,27,20,7,FMN 18 Binnensingel Westkant
665,Uitbreidingstraat 390,2023-04-15,04:00:00,18,14,4,FMN 18 Binnensingel Westkant
665,Uitbreidingstraat 390,2023-04-15,05:00:00,24,18,6,FMN 18 Binnensingel Westkant
665,Uitbreidingstraat 390,2023-04-15,06:00:00,21,15,6,FMN 18 Binnensingel Westkant
665,Uitbreidingstraat 390,2023-04-15,07:00:00,24,18,6,FMN 18 Binnensingel Westkant
665,Uitbreidingstraat 390,2023-04-15,08:00:00,54,38,16,FMN 18 Binnensingel Westkant
665,Uitbreidingstraat 390,2023-04-15,09:00:00,84,65,19,FMN 18 Binnensingel Westkant
665,Uitbreidingstraat 390,2023-04-15,10:00:00,88,58,30,FMN 18 Binnensingel Westkant
665,Uitbreidingstraat 390,2023-04-15,11:00:00,105,67,38,FMN 18 Binnensingel Westkant
665,Uitbreidingstraat 390,2023-04-15,12:00:00,110,81,29,FMN 18 Binnensingel Westkant
665,Uitbreidingstraat 390,2023-04-15,13:00:00,108,77,31,FMN 18 Binnensingel Westkant
665,Uitbreidingstraat 390,2023-04-15,14:00:00,89,59,30,FMN 18 Binnensingel Westkant
665,Uitbreidingstraat 390,2023-04-15,15:00:00,94,66,28,FMN 18 Binnensingel Westkant
665,Uitbreidingstraat 390,2023-04-15,16:00:00,93,68,25,FMN 18 Binnensingel Westkant
665,Uitbreidingstraat 390,2023-04-15,17:00:00,118,82,36,FMN 18 Binnensingel Westkant
665,Uitbreidingstraat 390,2023-04-15,18:00:00,103,70,33,FMN 18 Binnensingel Westkant
665,Uitbreidingstraat 390,2023-04-15,19:00:00,97,68,29,FMN 18 Binnensingel Westkant
665,Uitbreidingstraat 390,2023-04-15,20:00:00,83,60,23,FMN 18 Binnensingel Westkant
665,Uitbreidingstraat 390,2023-04-15,21:00:00,59,40,19,FMN 18 Binnensingel Westkant
665,Uitbreidingstraat 390,2023-04-15,22:00:00,48,35,13,FMN 18 Binnensingel Westkant
665,Uitbreidingstraat 390,2023-04-15,23:00:00,59,43,16,FMN 18 Binnensingel Westkant
665,Uitbreidingstraat 390,2023-04-16,00:00:00,0,0,0,FMN 18 Binnensingel Westkant
665,Uitbreidingstraat 390,2023-04-16,01:00:00,38,31,7,FMN 18 Binnensingel Westkant
665,Uitbreidingstraat 390,2023-04-16,02:00:00,22,13,9,FMN 18 Binnensingel Westkant
665,Uitbreidingstraat 390,2023-04-16,03:00:00,17,13,4,FMN 18 Binnensingel Westkant
665,Uitbreidingstraat 390,2023-04-16,04:00:00,14,13,1,FMN 18 Binnensingel Westkant
665,Uitbreidingstraat 390,2023-04-16,05:00:00,10,8,2,FMN 18 Binnensingel Westkant
665,Uitbreidingstraat 390,2023-04-16,06:00:00,15,12,3,FMN 18 Binnensingel Westkant
665,Uitbreidingstraat 390,2023-04-16,07:00:00,14,11,3,FMN 18 Binnensingel Westkant
665,Uitbreidingstraat 390,2023-04-16,08:00:00,10,7,3,FMN 18 Binnensingel Westkant
665,Uitbreidingstraat 390,2023-04-16,09:00:00,45,34,11,FMN 18 Binnensingel Westkant
665,Uitbreidingstraat 390,2023-04-16,10:00:00,49,34,15,FMN 18 Binnensingel Westkant
665,Uitbreidingstraat 390,2023-04-16,11:00:00,72,49,23,FMN 18 Binnensingel Westkant
665,Uitbreidingstraat 390,2023-04-16,12:00:00,79,62,17,FMN 18 Binnensingel Westkant
665,Uitbreidingstraat 390,2023-04-16,13:00:00,72,54,18,FMN 18 Binnensingel Westkant
665,Uitbreidingstraat 390,2023-04-16,14:00:00,67,48,19,FMN 18 Binnensingel Westkant
665,Uitbreidingstraat 390,2023-04-16,15:00:00,56,39,17,FMN 18 Binnensingel Westkant
665,Uitbreidingstraat 390,2023-04-16,16:00:00,62,47,15,FMN 18 Binnensingel Westkant
665,Uitbreidingstraat 390,2023-04-16,17:00:00,72,57,15,FMN 18 Binnensingel Westkant
665,Uitbreidingstraat 390,2023-04-16,18:00:00,74,52,22,FMN 18 Binnensingel Westkant
665,Uitbreidingstraat 390,2023-04-16,19:00:00,53,35,18,FMN 18 Binnensingel Westkant
665,Uitbreidingstraat 390,2023-04-16,20:00:00,48,30,18,FMN 18 Binnensingel Westkant
665,Uitbreidingstraat 390,2023-04-16,21:00:00,39,29,10,FMN 18 Binnensingel Westkant
665,Uitbreidingstraat 390,2023-04-16,22:00:00,23,14,9,FMN 18 Binnensingel Westkant
665,Uitbreidingstraat 390,2023-04-16,23:00:00,22,16,6,FMN 18 Binnensingel Westkant
665,Uitbreidingstraat 390,2023-04-17,00:00:00,0,0,0,FMN 18 Binnensingel Westkant
665,Uitbreidingstraat 390,2023-04-17,01:00:00,4,2,2,FMN 18 Binnensingel Westkant
665,Uitbreidingstraat 390,2023-04-17,02:00:00,1,1,0,FMN 18 Binnensingel Westkant
665,Uitbreidingstraat 390,2023-04-17,03:00:00,3,2,1,FMN 18 Binnensingel Westkant
665,Uitbreidingstraat 390,2023-04-17,04:00:00,7,6,1,FMN 18 Binnensingel Westkant
665,Uitbreidingstraat 390,2023-04-17,05:00:00,31,27,4,FMN 18 Binnensingel Westkant
665,Uitbreidingstraat 390,2023-04-17,06:00:00,59,39,20,FMN 18 Binnensingel Westkant
665,Uitbreidingstraat 390,2023-04-17,07:00:00,250,169,81,FMN 18 Binnensingel Westkant
665,Uitbreidingstraat 390,2023-04-17,08:00:00,442,300,142,FMN 18 Binnensingel Westkant
665,Uitbreidingstraat 390,2023-04-17,09:00:00,170,120,50,FMN 18 Binnensingel Westkant
665,Uitbreidingstraat 390,2023-04-17,10:00:00,111,75,36,FMN 18 Binnensingel Westkant
665,Uitbreidingstraat 390,2023-04-17,11:00:00,76,51,25,FMN 18 Binnensingel Westkant
665,Uitbreidingstraat 390,2023-04-17,12:00:00,149,92,57,FMN 18 Binnensingel Westkant
665,Uitbreidingstraat 390,2023-04-17,13:00:00,128,90,38,FMN 18 Binnensingel Westkant
665,Uitbreidingstraat 390,2023-04-17,14:00:00,119,76,43,FMN 18 Binnensingel Westkant
665,Uitbreidingstraat 390,2023-04-17,15:00:00,171,107,64,FMN 18 Binnensingel Westkant
665,Uitbreidingstraat 390,2023-04-17,16:00:00,281,181,100,FMN 18 Binnensingel Westkant
665,Uitbreidingstraat 390,2023-04-17,17:00:00,280,187,93,FMN 18 Binnensingel Westkant
665,Uitbreidingstraat 390,2023-04-17,18:00:00,218,145,73,FMN 18 Binnensingel Westkant
665,Uitbreidingstraat 390,2023-04-17,19:00:00,110,72,38,FMN 18 Binnensingel Westkant
665,Uitbreidingstraat 390,2023-04-17,20:00:00,76,53,23,FMN 18 Binnensingel Westkant
665,Uitbreidingstraat 390,2023-04-17,21:00:00,66,47,19,FMN 18 Binnensingel Westkant
665,Uitbreidingstraat 390,2023-04-17,22:00:00,47,30,17,FMN 18 Binnensingel Westkant
665,Uitbreidingstraat 390,2023-04-17,23:00:00,21,16,5,FMN 18 Binnensingel Westkant
665,Uitbreidingstraat 390,2023-04-18,00:00:00,0,0,0,FMN 18 Binnensingel Westkant
665,Uitbreidingstraat 390,2023-04-18,01:00:00,7,4,3,FMN 18 Binnensingel Westkant
665,Uitbreidingstraat 390,2023-04-18,02:00:00,2,2,0,FMN 18 Binnensingel Westkant
665,Uitbreidingstraat 390,2023-04-18,03:00:00,7,4,3,FMN 18 Binnensingel Westkant
665,Uitbreidingstraat 390,2023-04-18,04:00:00,8,6,2,FMN 18 Binnensingel Westkant
665,Uitbreidingstraat 390,2023-04-18,05:00:00,44,28,16,FMN 18 Binnensingel Westkant
665,Uitbreidingstraat 390,2023-04-18,06:00:00,68,44,24,FMN 18 Binnensingel Westkant
665,Uitbreidingstraat 390,2023-04-18,07:00:00,288,215,73,FMN 18 Binnensingel Westkant
665,Uitbreidingstraat 390,2023-04-18,08:00:00,476,361,115,FMN 18 Binnensingel Westkant
665,Uitbreidingstraat 390,2023-04-18,09:00:00,171,119,52,FMN 18 Binnensingel Westkant
665,Uitbreidingstraat 390,2023-04-18,10:00:00,114,87,27,FMN 18 Binnensingel Westkant
665,Uitbreidingstraat 390,2023-04-18,11:00:00,93,68,25,FMN 18 Binnensingel Westkant
665,Uitbreidingstraat 390,2023-04-18,12:00:00,164,109,55,FMN 18 Binnensingel Westkant
665,Uitbreidingstraat 390,2023-04-18,13:00:00,141,96,45,FMN 18 Binnensingel Westkant
665,Uitbreidingstraat 390,2023-04-18,14:00:00,115,83,32,FMN 18 Binnensingel Westkant
665,Uitbreidingstraat 390,2023-04-18,15:00:00,212,135,77,FMN 18 Binnensingel Westkant
665,Uitbreidingstraat 390,2023-04-18,16:00:00,307,200,107,FMN 18 Binnensingel Westkant
665,Uitbreidingstraat 390,2023-04-18,17:00:00,318,206,112,FMN 18 Binnensingel Westkant
665,Uitbreidingstraat 390,2023-04-18,18:00:00,251,182,69,FMN 18 Binnensingel Westkant
665,Uitbreidingstraat 390,2023-04-18,19:00:00,134,96,38,FMN 18 Binnensingel Westkant
665,Uitbreidingstraat 390,2023-04-18,20:00:00,83,59,24,FMN 18 Binnensingel Westkant
665,Uitbreidingstraat 390,2023-04-18,21:00:00,70,48,22,FMN 18 Binnensingel Westkant
665,Uitbreidingstraat 390,2023-04-18,22:00:00,66,44,22,FMN 18 Binnensingel Westkant
665,Uitbreidingstraat 390,2023-04-18,23:00:00,37,25,12,FMN 18 Binnensingel Westkant
665,Uitbreidingstraat 390,2023-04-19,00:00:00,0,0,0,FMN 18 Binnensingel Westkant
665,Uitbreidingstraat 390,2023-04-19,01:00:00,6,4,2,FMN 18 Binnensingel Westkant
665,Uitbreidingstraat 390,2023-04-19,02:00:00,3,1,2,FMN 18 Binnensingel Westkant
665,Uitbreidingstraat 390,2023-04-19,03:00:00,7,7,0,FMN 18 Binnensingel Westkant
665,Uitbreidingstraat 390,2023-04-19,04:00:00,6,5,1,FMN 18 Binnensingel Westkant
665,Uitbreidingstraat 390,2023-04-19,05:00:00,36,27,9,FMN 18 Binnensingel Westkant
665,Uitbreidingstraat 390,2023-04-19,06:00:00,71,52,19,FMN 18 Binnensingel Westkant
665,Uitbreidingstraat 390,2023-04-19,07:00:00,251,188,63,FMN 18 Binnensingel Westkant
665,Uitbreidingstraat 390,2023-04-19,08:00:00,480,357,123,FMN 18 Binnensingel Westkant
665,Uitbreidingstraat 390,2023-04-19,09:00:00,190,148,42,FMN 18 Binnensingel Westkant
665,Uitbreidingstraat 390,2023-04-19,10:00:00,129,92,37,FMN 18 Binnensingel Westkant
665,Uitbreidingstraat 390,2023-04-19,11:00:00,119,87,32,FMN 18 Binnensingel Westkant
665,Uitbreidingstraat 390,2023-04-19,12:00:00,280,190,90,FMN 18 Binnensingel Westkant
665,Uitbreidingstraat 390,2023-04-19,13:00:00,211,133,78,FMN 18 Binnensingel Westkant
665,Uitbreidingstraat 390,2023-04-19,14:00:00,132,89,43,FMN 18 Binnensingel Westkant
665,Uitbreidingstraat 390,2023-04-19,15:00:00,165,118,47,FMN 18 Binnensingel Westkant
665,Uitbreidingstraat 390,2023-04-19,16:00:00,226,159,67,FMN 18 Binnensingel Westkant
665,Uitbreidingstraat 390,2023-04-19,17:00:00,309,214,95,FMN 18 Binnensingel Westkant
665,Uitbreidingstraat 390,2023-04-19,18:00:00,229,160,69,FMN 18 Binnensingel Westkant
665,Uitbreidingstraat 390,2023-04-19,19:00:00,133,88,45,FMN 18 Binnensingel Westkant
665,Uitbreidingstraat 390,2023-04-19,20:00:00,88,55,33,FMN 18 Binnensingel Westkant
665,Uitbreidingstraat 390,2023-04-19,21:00:00,73,49,24,FMN 18 Binnensingel Westkant
665,Uitbreidingstraat 390,2023-04-19,22:00:00,61,46,15,FMN 18 Binnensingel Westkant
665,Uitbreidingstraat 390,2023-04-19,23:00:00,50,33,17,FMN 18 Binnensingel Westkant
665,Uitbreidingstraat 390,2023-04-20,00:00:00,28,19,9,FMN 18 Binnensingel Westkant
665,Uitbreidingstraat 390,2023-04-20,01:00:00,9,6,3,FMN 18 Binnensingel Westkant
665,Uitbreidingstraat 390,2023-04-20,02:00:00,1,1,0,FMN 18 Binnensingel Westkant
665,Uitbreidingstraat 390,2023-04-20,03:00:00,3,3,0,FMN 18 Binnensingel Westkant
665,Uitbreidingstraat 390,2023-04-20,04:00:00,8,7,1,FMN 18 Binnensingel Westkant
665,Uitbreidingstraat 390,2023-04-20,05:00:00,29,21,8,FMN 18 Binnensingel Westkant
665,Uitbreidingstraat 390,2023-04-20,06:00:00,65,46,19,FMN 18 Binnensingel Westkant
665,Uitbreidingstraat 390,2023-04-20,07:00:00,236,193,43,FMN 18 Binnensingel Westkant
665,Uitbreidingstraat 390,2023-04-20,08:00:00,394,330,64,FMN 18 Binnensingel Westkant
665,Uitbreidingstraat 390,2023-04-20,09:00:00,150,123,27,FMN 18 Binnensingel Westkant
665,Uitbreidingstraat 390,2023-04-20,10:00:00,94,80,14,FMN 18 Binnensingel Westkant
665,Uitbreidingstraat 390,2023-04-20,11:00:00,66,49,17,FMN 18 Binnensingel Westkant
665,Uitbreidingstraat 390,2023-04-20,12:00:00,125,75,50,FMN 18 Binnensingel Westkant
665,Uitbreidingstraat 390,2023-04-20,13:00:00,128,97,31,FMN 18 Binnensingel Westkant
665,Uitbreidingstraat 390,2023-04-20,14:00:00,96,61,35,FMN 18 Binnensingel Westkant
665,Uitbreidingstraat 390,2023-04-20,15:00:00,157,71,86,FMN 18 Binnensingel Westkant
665,Uitbreidingstraat 390,2023-04-20,16:00:00,278,95,183,FMN 18 Binnensingel Westkant
665,Uitbreidingstraat 390,2023-04-20,17:00:00,222,117,105,FMN 18 Binnensingel Westkant
665,Uitbreidingstraat 390,2023-04-20,18:00:00,185,119,66,FMN 18 Binnensingel Westkant
665,Uitbreidingstraat 390,2023-04-20,19:00:00,110,88,22,FMN 18 Binnensingel Westkant
665,Uitbreidingstraat 390,2023-04-20,20:00:00,73,48,25,FMN 18 Binnensingel Westkant
665,Uitbreidingstraat 390,2023-04-20,21:00:00,65,43,22,FMN 18 Binnensingel Westkant
665,Uitbreidingstraat 390,2023-04-20,22:00:00,60,37,23,FMN 18 Binnensingel Westkant
665,Uitbreidingstraat 390,2023-04-20,23:00:00,45,37,8,FMN 18 Binnensingel Westkant
665,Uitbreidingstraat 390,2023-04-21,00:00:00,22,16,6,FMN 18 Binnensingel Westkant
665,Uitbreidingstraat 390,2023-04-21,01:00:00,12,8,4,FMN 18 Binnensingel Westkant
665,Uitbreidingstraat 390,2023-04-21,02:00:00,6,6,0,FMN 18 Binnensingel Westkant
665,Uitbreidingstraat 390,2023-04-21,03:00:00,8,8,0,FMN 18 Binnensingel Westkant
665,Uitbreidingstraat 390,2023-04-21,04:00:00,9,8,1,FMN 18 Binnensingel Westkant
665,Uitbreidingstraat 390,2023-04-21,05:00:00,19,18,1,FMN 18 Binnensingel Westkant
665,Uitbreidingstraat 390,2023-04-21,06:00:00,45,34,11,FMN 18 Binnensingel Westkant
665,Uitbreidingstraat 390,2023-04-21,07:00:00,189,170,19,FMN 18 Binnensingel Westkant
665,Uitbreidingstraat 390,2023-04-21,08:00:00,346,298,48,FMN 18 Binnensingel Westkant
665,Uitbreidingstraat 390,2023-04-21,09:00:00,141,115,26,FMN 18 Binnensingel Westkant
665,Uitbreidingstraat 390,2023-04-21,10:00:00,108,81,27,FMN 18 Binnensingel Westkant
665,Uitbreidingstraat 390,2023-04-21,11:00:00,96,68,28,FMN 18 Binnensingel Westkant
665,Uitbreidingstraat 390,2023-04-21,12:00:00,135,88,47,FMN 18 Binnensingel Westkant
665,Uitbreidingstraat 390,2023-04-21,13:00:00,117,82,35,FMN 18 Binnensingel Westkant
665,Uitbreidingstraat 390,2023-04-21,14:00:00,123,68,55,FMN 18 Binnensingel Westkant
665,Uitbreidingstraat 390,2023-04-21,15:00:00,186,77,109,FMN 18 Binnensingel Westkant
665,Uitbreidingstraat 390,2023-04-21,16:00:00,257,109,148,FMN 18 Binnensingel Westkant
665,Uitbreidingstraat 390,2023-04-21,17:00:00,231,120,111,FMN 18 Binnensingel Westkant
665,Uitbreidingstraat 390,2023-04-21,18:00:00,191,120,71,FMN 18 Binnensingel Westkant
665,Uitbreidingstraat 390,2023-04-21,19:00:00,116,94,22,FMN 18 Binnensingel Westkant
665,Uitbreidingstraat 390,2023-04-21,20:00:00,96,68,28,FMN 18 Binnensingel Westkant
665,Uitbreidingstraat 390,2023-04-21,21:00:00,56,36,20,FMN 18 Binnensingel Westkant
665,Uitbreidingstraat 390,2023-04-21,22:00:00,71,57,14,FMN 18 Binnensingel Westkant
665,Uitbreidingstraat 390,2023-04-21,23:00:00,71,53,18,FMN 18 Binnensingel Westkant
665,Uitbreidingstraat 390,2023-04-22,00:00:00,44,32,12,FMN 18 Binnensingel Westkant
665,Uitbreidingstraat 390,2023-04-22,01:00:00,32,25,7,FMN 18 Binnensingel Westkant
665,Uitbreidingstraat 390,2023-04-22,02:00:00,19,11,8,FMN 18 Binnensingel Westkant
665,Uitbreidingstraat 390,2023-04-22,03:00:00,13,12,1,FMN 18 Binnensingel Westkant
665,Uitbreidingstraat 390,2023-04-22,04:00:00,15,15,0,FMN 18 Binnensingel Westkant
665,Uitbreidingstraat 390,2023-04-22,05:00:00,6,4,2,FMN 18 Binnensingel Westkant
665,Uitbreidingstraat 390,2023-04-22,06:00:00,24,16,8,FMN 18 Binnensingel Westkant
665,Uitbreidingstraat 390,2023-04-22,07:00:00,14,10,4,FMN 18 Binnensingel Westkant
665,Uitbreidingstraat 390,2023-04-22,08:00:00,49,33,16,FMN 18 Binnensingel Westkant
665,Uitbreidingstraat 390,2023-04-22,09:00:00,88,76,12,FMN 18 Binnensingel Westkant
665,Uitbreidingstraat 390,2023-04-22,10:00:00,70,49,21,FMN 18 Binnensingel Westkant
665,Uitbreidingstraat 390,2023-04-22,11:00:00,87,61,26,FMN 18 Binnensingel Westkant
665,Uitbreidingstraat 390,2023-04-22,12:00:00,59,40,19,FMN 18 Binnensingel Westkant
665,Uitbreidingstraat 390,2023-04-22,13:00:00,63,44,19,FMN 18 Binnensingel Westkant
665,Uitbreidingstraat 390,2023-04-22,14:00:00,50,42,8,FMN 18 Binnensingel Westkant
665,Uitbreidingstraat 390,2023-04-22,15:00:00,64,40,24,FMN 18 Binnensingel Westkant
665,Uitbreidingstraat 390,2023-04-22,16:00:00,60,38,22,FMN 18 Binnensingel Westkant
665,Uitbreidingstraat 390,2023-04-22,17:00:00,64,50,14,FMN 18 Binnensingel Westkant
665,Uitbreidingstraat 390,2023-04-22,18:00:00,72,53,19,FMN 18 Binnensingel Westkant
665,Uitbreidingstraat 390,2023-04-22,19:00:00,75,59,16,FMN 18 Binnensingel Westkant
665,Uitbreidingstraat 390,2023-04-22,20:00:00,46,35,11,FMN 18 Binnensingel Westkant
665,Uitbreidingstraat 390,2023-04-22,21:00:00,39,33,6,FMN 18 Binnensingel Westkant
665,Uitbreidingstraat 390,2023-04-22,22:00:00,45,35,10,FMN 18 Binnensingel Westkant
665,Uitbreidingstraat 390,2023-04-22,23:00:00,39,30,9,FMN 18 Binnensingel Westkant
665,Uitbreidingstraat 390,2023-04-23,00:00:00,39,19,20,FMN 18 Binnensingel Westkant
665,Uitbreidingstraat 390,2023-04-23,01:00:00,28,19,9,FMN 18 Binnensingel Westkant
665,Uitbreidingstraat 390,2023-04-23,02:00:00,23,21,2,FMN 18 Binnensingel Westkant
665,Uitbreidingstraat 390,2023-04-23,03:00:00,8,6,2,FMN 18 Binnensingel Westkant
665,Uitbreidingstraat 390,2023-04-23,04:00:00,6,4,2,FMN 18 Binnensingel Westkant
665,Uitbreidingstraat 390,2023-04-23,05:00:00,8,7,1,FMN 18 Binnensingel Westkant
665,Uitbreidingstraat 390,2023-04-23,06:00:00,16,14,2,FMN 18 Binnensingel Westkant
665,Uitbreidingstraat 390,2023-04-23,07:00:00,10,8,2,FMN 18 Binnensingel Westkant
665,Uitbreidingstraat 390,2023-04-23,08:00:00,19,15,4,FMN 18 Binnensingel Westkant
665,Uitbreidingstraat 390,2023-04-23,09:00:00,59,41,18,FMN 18 Binnensingel Westkant
665,Uitbreidingstraat 390,2023-04-23,10:00:00,74,48,26,FMN 18 Binnensingel Westkant
665,Uitbreidingstraat 390,2023-04-23,11:00:00,85,67,18,FMN 18 Binnensingel Westkant
665,Uitbreidingstraat 390,2023-04-23,12:00:00,96,70,26,FMN 18 Binnensingel Westkant
665,Uitbreidingstraat 390,2023-04-23,13:00:00,87,69,18,FMN 18 Binnensingel Westkant
665,Uitbreidingstraat 390,2023-04-23,14:00:00,71,59,12,FMN 18 Binnensingel Westkant
665,Uitbreidingstraat 390,2023-04-23,15:00:00,50,32,18,FMN 18 Binnensingel Westkant
665,Uitbreidingstraat 390,2023-04-23,16:00:00,37,21,16,FMN 18 Binnensingel Westkant
665,Uitbreidingstraat 390,2023-04-23,17:00:00,63,45,18,FMN 18 Binnensingel Westkant
665,Uitbreidingstraat 390,2023-04-23,18:00:00,64,41,23,FMN 18 Binnensingel Westkant
665,Uitbreidingstraat 390,2023-04-23,19:00:00,54,43,11,FMN 18 Binnensingel Westkant
665,Uitbreidingstraat 390,2023-04-23,20:00:00,43,30,13,FMN 18 Binnensingel Westkant
665,Uitbreidingstraat 390,2023-04-23,21:00:00,37,24,13,FMN 18 Binnensingel Westkant
665,Uitbreidingstraat 390,2023-04-23,22:00:00,30,23,7,FMN 18 Binnensingel Westkant
665,Uitbreidingstraat 390,2023-04-23,23:00:00,18,16,2,FMN 18 Binnensingel Westkant
665,Uitbreidingstraat 390,2023-04-24,00:00:00,6,5,1,FMN 18 Binnensingel Westkant
665,Uitbreidingstraat 390,2023-04-24,01:00:00,7,4,3,FMN 18 Binnensingel Westkant
665,Uitbreidingstraat 390,2023-04-24,02:00:00,4,3,1,FMN 18 Binnensingel Westkant
665,Uitbreidingstraat 390,2023-04-24,03:00:00,1,1,0,FMN 18 Binnensingel Westkant
665,Uitbreidingstraat 390,2023-04-24,04:00:00,10,8,2,FMN 18 Binnensingel Westkant
665,Uitbreidingstraat 390,2023-04-24,05:00:00,15,15,0,FMN 18 Binnensingel Westkant
665,Uitbreidingstraat 390,2023-04-24,06:00:00,48,34,14,FMN 18 Binnensingel Westkant
665,Uitbreidingstraat 390,2023-04-24,07:00:00,169,145,24,FMN 18 Binnensingel Westkant
665,Uitbreidingstraat 390,2023-04-24,08:00:00,373,307,66,FMN 18 Binnensingel Westkant
665,Uitbreidingstraat 390,2023-04-24,09:00:00,142,128,14,FMN 18 Binnensingel Westkant
665,Uitbreidingstraat 390,2023-04-24,10:00:00,94,69,25,FMN 18 Binnensingel Westkant
665,Uitbreidingstraat 390,2023-04-24,11:00:00,44,30,14,FMN 18 Binnensingel Westkant
665,Uitbreidingstraat 390,2023-04-24,12:00:00,123,83,40,FMN 18 Binnensingel Westkant
665,Uitbreidingstraat 390,2023-04-24,13:00:00,100,74,26,FMN 18 Binnensingel Westkant
665,Uitbreidingstraat 390,2023-04-24,14:00:00,86,54,32,FMN 18 Binnensingel Westkant
665,Uitbreidingstraat 390,2023-04-24,15:00:00,160,79,81,FMN 18 Binnensingel Westkant
665,Uitbreidingstraat 390,2023-04-24,16:00:00,264,111,153,FMN 18 Binnensingel Westkant
665,Uitbreidingstraat 390,2023-04-24,17:00:00,250,133,117,FMN 18 Binnensingel Westkant
665,Uitbreidingstraat 390,2023-04-24,18:00:00,216,141,75,FMN 18 Binnensingel Westkant
665,Uitbreidingstraat 390,2023-04-24,19:00:00,94,70,24,FMN 18 Binnensingel Westkant
665,Uitbreidingstraat 390,2023-04-24,20:00:00,65,34,31,FMN 18 Binnensingel Westkant
665,Uitbreidingstraat 390,2023-04-24,21:00:00,58,35,23,FMN 18 Binnensingel Westkant
665,Uitbreidingstraat 390,2023-04-24,22:00:00,46,22,24,FMN 18 Binnensingel Westkant
665,Uitbreidingstraat 390,2023-04-24,23:00:00,30,21,9,FMN 18 Binnensingel Westkant
665,Uitbreidingstraat 390,2023-04-25,00:00:00,7,5,2,FMN 18 Binnensingel Westkant
665,Uitbreidingstraat 390,2023-04-25,01:00:00,6,6,0,FMN 18 Binnensingel Westkant
665,Uitbreidingstraat 390,2023-04-25,02:00:00,2,2,0,FMN 18 Binnensingel Westkant
665,Uitbreidingstraat 390,2023-04-25,03:00:00,4,3,1,FMN 18 Binnensingel Westkant
665,Uitbreidingstraat 390,2023-04-25,04:00:00,9,9,0,FMN 18 Binnensingel Westkant
665,Uitbreidingstraat 390,2023-04-25,05:00:00,30,27,3,FMN 18 Binnensingel Westkant
665,Uitbreidingstraat 390,2023-04-25,06:00:00,53,36,17,FMN 18 Binnensingel Westkant
665,Uitbreidingstraat 390,2023-04-25,07:00:00,235,199,36,FMN 18 Binnensingel Westkant
665,Uitbreidingstraat 390,2023-04-25,08:00:00,434,371,63,FMN 18 Binnensingel Westkant
665,Uitbreidingstraat 390,2023-04-25,09:00:00,161,136,25,FMN 18 Binnensingel Westkant
665,Uitbreidingstraat 390,2023-04-25,10:00:00,94,82,12,FMN 18 Binnensingel Westkant
665,Uitbreidingstraat 390,2023-04-25,11:00:00,72,53,19,FMN 18 Binnensingel Westkant
665,Uitbreidingstraat 390,2023-04-25,12:00:00,153,92,61,FMN 18 Binnensingel Westkant
665,Uitbreidingstraat 390,2023-04-25,13:00:00,114,80,34,FMN 18 Binnensingel Westkant
665,Uitbreidingstraat 390,2023-04-25,14:00:00,122,84,38,FMN 18 Binnensingel Westkant
665,Uitbreidingstraat 390,2023-04-25,15:00:00,190,85,105,FMN 18 Binnensingel Westkant
665,Uitbreidingstraat 390,2023-04-25,16:00:00,346,130,216,FMN 18 Binnensingel Westkant
665,Uitbreidingstraat 390,2023-04-25,17:00:00,335,172,163,FMN 18 Binnensingel Westkant
665,Uitbreidingstraat 390,2023-04-25,18:00:00,231,147,84,FMN 18 Binnensingel Westkant
665,Uitbreidingstraat 390,2023-04-25,19:00:00,148,106,42,FMN 18 Binnensingel Westkant
665,Uitbreidingstraat 390,2023-04-25,20:00:00,80,55,25,FMN 18 Binnensingel Westkant
665,Uitbreidingstraat 390,2023-04-25,21:00:00,78,57,21,FMN 18 Binnensingel Westkant
665,Uitbreidingstraat 390,2023-04-25,22:00:00,73,51,22,FMN 18 Binnensingel Westkant
665,Uitbreidingstraat 390,2023-04-25,23:00:00,53,49,4,FMN 18 Binnensingel Westkant
665,Uitbreidingstraat 390,2023-04-26,00:00:00,12,9,3,FMN 18 Binnensingel Westkant
665,Uitbreidingstraat 390,2023-04-26,01:00:00,4,4,0,FMN 18 Binnensingel Westkant
665,Uitbreidingstraat 390,2023-04-26,02:00:00,2,2,0,FMN 18 Binnensingel Westkant
665,Uitbreidingstraat 390,2023-04-26,03:00:00,1,1,0,FMN 18 Binnensingel Westkant
665,Uitbreidingstraat 390,2023-04-26,04:00:00,11,6,5,FMN 18 Binnensingel Westkant
665,Uitbreidingstraat 390,2023-04-26,05:00:00,29,26,3,FMN 18 Binnensingel Westkant
665,Uitbreidingstraat 390,2023-04-26,06:00:00,66,55,11,FMN 18 Binnensingel Westkant
665,Uitbreidingstraat 390,2023-04-26,07:00:00,201,172,29,FMN 18 Binnensingel Westkant
665,Uitbreidingstraat 390,2023-04-26,08:00:00,400,324,76,FMN 18 Binnensingel Westkant
665,Uitbreidingstraat 390,2023-04-26,09:00:00,142,124,18,FMN 18 Binnensingel Westkant
665,Uitbreidingstraat 390,2023-04-26,10:00:00,98,71,27,FMN 18 Binnensingel Westkant
665,Uitbreidingstraat 390,2023-04-26,11:00:00,99,57,42,FMN 18 Binnensingel Westkant
665,Uitbreidingstraat 390,2023-04-26,12:00:00,238,111,127,FMN 18 Binnensingel Westkant
665,Uitbreidingstraat 390,2023-04-26,13:00:00,209,99,110,FMN 18 Binnensingel Westkant
665,Uitbreidingstraat 390,2023-04-26,14:00:00,109,57,52,FMN 18 Binnensingel Westkant
665,Uitbreidingstraat 390,2023-04-26,15:00:00,142,76,66,FMN 18 Binnensingel Westkant
665,Uitbreidingstraat 390,2023-04-26,16:00:00,180,105,75,FMN 18 Binnensingel Westkant
665,Uitbreidingstraat 390,2023-04-26,17:00:00,268,142,126,FMN 18 Binnensingel Westkant
665,Uitbreidingstraat 390,2023-04-26,18:00:00,216,141,75,FMN 18 Binnensingel Westkant
665,Uitbreidingstraat 390,2023-04-26,19:00:00,116,90,26,FMN 18 Binnensingel Westkant
665,Uitbreidingstraat 390,2023-04-26,20:00:00,84,55,29,FMN 18 Binnensingel Westkant
665,Uitbreidingstraat 390,2023-04-26,21:00:00,69,40,29,FMN 18 Binnensingel Westkant
665,Uitbreidingstraat 390,2023-04-26,22:00:00,62,44,18,FMN 18 Binnensingel Westkant
665,Uitbreidingstraat 390,2023-04-26,23:00:00,28,24,4,FMN 18 Binnensingel Westkant
665,Uitbreidingstraat 390,2023-04-27,00:00:00,17,14,3,FMN 18 Binnensingel Westkant
665,Uitbreidingstraat 390,2023-04-27,01:00:00,3,1,2,FMN 18 Binnensingel Westkant
665,Uitbreidingstraat 390,2023-04-27,02:00:00,2,0,2,FMN 18 Binnensingel Westkant
665,Uitbreidingstraat 390,2023-04-27,03:00:00,2,2,0,FMN 18 Binnensingel Westkant
665,Uitbreidingstraat 390,2023-04-27,04:00:00,12,9,3,FMN 18 Binnensingel Westkant
665,Uitbreidingstraat 390,2023-04-27,05:00:00,23,21,2,FMN 18 Binnensingel Westkant
665,Uitbreidingstraat 390,2023-04-27,06:00:00,53,40,13,FMN 18 Binnensingel Westkant
665,Uitbreidingstraat 390,2023-04-27,07:00:00,226,189,37,FMN 18 Binnensingel Westkant
665,Uitbreidingstraat 390,2023-04-27,08:00:00,412,345,67,FMN 18 Binnensingel Westkant
665,Uitbreidingstraat 390,2023-04-27,09:00:00,176,144,32,FMN 18 Binnensingel Westkant
665,Uitbreidingstraat 390,2023-04-27,10:00:00,95,73,22,FMN 18 Binnensingel Westkant
665,Uitbreidingstraat 390,2023-04-27,11:00:00,95,62,33,FMN 18 Binnensingel Westkant
665,Uitbreidingstraat 390,2023-04-27,12:00:00,159,104,55,FMN 18 Binnensingel Westkant
665,Uitbreidingstraat 390,2023-04-27,13:00:00,143,111,32,FMN 18 Binnensingel Westkant
665,Uitbreidingstraat 390,2023-04-27,14:00:00,137,93,44,FMN 18 Binnensingel Westkant
665,Uitbreidingstraat 390,2023-04-27,15:00:00,209,96,113,FMN 18 Binnensingel Westkant
665,Uitbreidingstraat 390,2023-04-27,16:00:00,326,131,195,FMN 18 Binnensingel Westkant
665,Uitbreidingstraat 390,2023-04-27,17:00:00,254,142,112,FMN 18 Binnensingel Westkant
665,Uitbreidingstraat 390,2023-04-27,18:00:00,226,149,77,FMN 18 Binnensingel Westkant
665,Uitbreidingstraat 390,2023-04-27,19:00:00,121,82,39,FMN 18 Binnensingel Westkant
665,Uitbreidingstraat 390,2023-04-27,20:00:00,83,62,21,FMN 18 Binnensingel Westkant
665,Uitbreidingstraat 390,2023-04-27,21:00:00,56,34,22,FMN 18 Binnensingel Westkant
665,Uitbreidingstraat 390,2023-04-27,22:00:00,78,60,18,FMN 18 Binnensingel Westkant
665,Uitbreidingstraat 390,2023-04-27,23:00:00,38,34,4,FMN 18 Binnensingel Westkant
665,Uitbreidingstraat 390,2023-04-28,00:00:00,20,15,5,FMN 18 Binnensingel Westkant
665,Uitbreidingstraat 390,2023-04-28,01:00:00,9,7,2,FMN 18 Binnensingel Westkant
665,Uitbreidingstraat 390,2023-04-28,02:00:00,3,1,2,FMN 18 Binnensingel Westkant
665,Uitbreidingstraat 390,2023-04-28,03:00:00,4,4,0,FMN 18 Binnensingel Westkant
665,Uitbreidingstraat 390,2023-04-28,04:00:00,9,8,1,FMN 18 Binnensingel Westkant
665,Uitbreidingstraat 390,2023-04-28,05:00:00,21,18,3,FMN 18 Binnensingel Westkant
665,Uitbreidingstraat 390,2023-04-28,06:00:00,50,38,12,FMN 18 Binnensingel Westkant
665,Uitbreidingstraat 390,2023-04-28,07:00:00,178,157,21,FMN 18 Binnensingel Westkant
665,Uitbreidingstraat 390,2023-04-28,08:00:00,364,315,49,FMN 18 Binnensingel Westkant
665,Uitbreidingstraat 390,2023-04-28,09:00:00,134,110,24,FMN 18 Binnensingel Westkant
665,Uitbreidingstraat 390,2023-04-28,10:00:00,85,69,16,FMN 18 Binnensingel Westkant
665,Uitbreidingstraat 390,2023-04-28,11:00:00,107,75,32,FMN 18 Binnensingel Westkant
665,Uitbreidingstraat 390,2023-04-28,12:00:00,142,84,58,FMN 18 Binnensingel Westkant
665,Uitbreidingstraat 390,2023-04-28,13:00:00,112,88,24,FMN 18 Binnensingel Westkant
665,Uitbreidingstraat 390,2023-04-28,14:00:00,83,48,35,FMN 18 Binnensingel Westkant
665,Uitbreidingstraat 390,2023-04-28,15:00:00,182,86,96,FMN 18 Binnensingel Westkant
665,Uitbreidingstraat 390,2023-04-28,16:00:00,300,108,192,FMN 18 Binnensingel Westkant
665,Uitbreidingstraat 390,2023-04-28,17:00:00,192,111,81,FMN 18 Binnensingel Westkant
665,Uitbreidingstraat 390,2023-04-28,18:00:00,169,107,62,FMN 18 Binnensingel Westkant
665,Uitbreidingstraat 390,2023-04-28,19:00:00,114,81,33,FMN 18 Binnensingel Westkant
665,Uitbreidingstraat 390,2023-04-28,20:00:00,76,50,26,FMN 18 Binnensingel Westkant
665,Uitbreidingstraat 390,2023-04-28,21:00:00,54,30,24,FMN 18 Binnensingel Westkant
665,Uitbreidingstraat 390,2023-04-28,22:00:00,67,48,19,FMN 18 Binnensingel Westkant
665,Uitbreidingstraat 390,2023-04-28,23:00:00,58,45,13,FMN 18 Binnensingel Westkant
665,Uitbreidingstraat 390,2023-04-29,00:00:00,56,32,24,FMN 18 Binnensingel Westkant
665,Uitbreidingstraat 390,2023-04-29,01:00:00,51,37,14,FMN 18 Binnensingel Westkant
665,Uitbreidingstraat 390,2023-04-29,02:00:00,18,14,4,FMN 18 Binnensingel Westkant
665,Uitbreidingstraat 390,2023-04-29,03:00:00,15,11,4,FMN 18 Binnensingel Westkant
665,Uitbreidingstraat 390,2023-04-29,04:00:00,16,14,2,FMN 18 Binnensingel Westkant
665,Uitbreidingstraat 390,2023-04-29,05:00:00,12,11,1,FMN 18 Binnensingel Westkant
665,Uitbreidingstraat 390,2023-04-29,06:00:00,18,17,1,FMN 18 Binnensingel Westkant
665,Uitbreidingstraat 390,2023-04-29,07:00:00,20,15,5,FMN 18 Binnensingel Westkant
665,Uitbreidingstraat 390,2023-04-29,08:00:00,32,27,5,FMN 18 Binnensingel Westkant
665,Uitbreidingstraat 390,2023-04-29,09:00:00,66,47,19,FMN 18 Binnensingel Westkant
665,Uitbreidingstraat 390,2023-04-29,10:00:00,62,45,17,FMN 18 Binnensingel Westkant
665,Uitbreidingstraat 390,2023-04-29,11:00:00,75,55,20,FMN 18 Binnensingel Westkant
665,Uitbreidingstraat 390,2023-04-29,12:00:00,96,68,28,FMN 18 Binnensingel Westkant
665,Uitbreidingstraat 390,2023-04-29,13:00:00,95,67,28,FMN 18 Binnensingel Westkant
665,Uitbreidingstraat 390,2023-04-29,14:00:00,93,63,30,FMN 18 Binnensingel Westkant
665,Uitbreidingstraat 390,2023-04-29,15:00:00,105,71,34,FMN 18 Binnensingel Westkant
665,Uitbreidingstraat 390,2023-04-29,16:00:00,75,56,19,FMN 18 Binnensingel Westkant
665,Uitbreidingstraat 390,2023-04-29,17:00:00,83,60,23,FMN 18 Binnensingel Westkant
665,Uitbreidingstraat 390,2023-04-29,18:00:00,74,58,16,FMN 18 Binnensingel Westkant
665,Uitbreidingstraat 390,2023-04-29,19:00:00,71,51,20,FMN 18 Binnensingel Westkant
665,Uitbreidingstraat 390,2023-04-29,20:00:00,56,38,18,FMN 18 Binnensingel Westkant
665,Uitbreidingstraat 390,2023-04-29,21:00:00,56,40,16,FMN 18 Binnensingel Westkant
665,Uitbreidingstraat 390,2023-04-29,22:00:00,52,41,11,FMN 18 Binnensingel Westkant
665,Uitbreidingstraat 390,2023-04-29,23:00:00,46,42,4,FMN 18 Binnensingel Westkant
665,Uitbreidingstraat 390,2023-04-30,00:00:00,37,33,4,FMN 18 Binnensingel Westkant
665,Uitbreidingstraat 390,2023-04-30,01:00:00,21,16,5,FMN 18 Binnensingel Westkant
665,Uitbreidingstraat 390,2023-04-30,02:00:00,18,11,7,FMN 18 Binnensingel Westkant
665,Uitbreidingstraat 390,2023-04-30,03:00:00,5,5,0,FMN 18 Binnensingel Westkant
665,Uitbreidingstraat 390,2023-04-30,04:00:00,10,8,2,FMN 18 Binnensingel Westkant
665,Uitbreidingstraat 390,2023-04-30,05:00:00,14,9,5,FMN 18 Binnensingel Westkant
665,Uitbreidingstraat 390,2023-04-30,06:00:00,11,10,1,FMN 18 Binnensingel Westkant
665,Uitbreidingstraat 390,2023-04-30,07:00:00,17,13,4,FMN 18 Binnensingel Westkant
665,Uitbreidingstraat 390,2023-04-30,08:00:00,27,20,7,FMN 18 Binnensingel Westkant
665,Uitbreidingstraat 390,2023-04-30,09:00:00,59,43,16,FMN 18 Binnensingel Westkant
665,Uitbreidingstraat 390,2023-04-30,10:00:00,97,67,30,FMN 18 Binnensingel Westkant
665,Uitbreidingstraat 390,2023-04-30,11:00:00,69,58,11,FMN 18 Binnensingel Westkant
665,Uitbreidingstraat 390,2023-04-30,12:00:00,100,78,22,FMN 18 Binnensingel Westkant
665,Uitbreidingstraat 390,2023-04-30,13:00:00,95,73,22,FMN 18 Binnensingel Westkant
665,Uitbreidingstraat 390,2023-04-30,14:00:00,85,58,27,FMN 18 Binnensingel Westkant
665,Uitbreidingstraat 390,2023-04-30,15:00:00,75,52,23,FMN 18 Binnensingel Westkant
665,Uitbreidingstraat 390,2023-04-30,16:00:00,76,47,29,FMN 18 Binnensingel Westkant
665,Uitbreidingstraat 390,2023-04-30,17:00:00,97,79,18,FMN 18 Binnensingel Westkant
665,Uitbreidingstraat 390,2023-04-30,18:00:00,111,83,28,FMN 18 Binnensingel Westkant
665,Uitbreidingstraat 390,2023-04-30,19:00:00,87,60,27,FMN 18 Binnensingel Westkant
665,Uitbreidingstraat 390,2023-04-30,20:00:00,69,56,13,FMN 18 Binnensingel Westkant
665,Uitbreidingstraat 390,2023-04-30,21:00:00,53,38,15,FMN 18 Binnensingel Westkant
665,Uitbreidingstraat 390,2023-04-30,22:00:00,49,43,6,FMN 18 Binnensingel Westkant
665,Uitbreidingstraat 390,2023-04-30,23:00:00,47,42,5,FMN 18 Binnensingel Westkant
665,Uitbreidingstraat 390,2023-05-01,00:00:00,45,27,18,FMN 18 Binnensingel Westkant
665,Uitbreidingstraat 390,2023-05-01,01:00:00,10,6,4,FMN 18 Binnensingel Westkant
665,Uitbreidingstraat 390,2023-05-01,02:00:00,8,7,1,FMN 18 Binnensingel Westkant
665,Uitbreidingstraat 390,2023-05-01,03:00:00,11,10,1,FMN 18 Binnensingel Westkant
665,Uitbreidingstraat 390,2023-05-01,04:00:00,12,11,1,FMN 18 Binnensingel Westkant
665,Uitbreidingstraat 390,2023-05-01,05:00:00,12,11,1,FMN 18 Binnensingel Westkant
665,Uitbreidingstraat 390,2023-05-01,06:00:00,22,17,5,FMN 18 Binnensingel Westkant
665,Uitbreidingstraat 390,2023-05-01,07:00:00,11,11,0,FMN 18 Binnensingel Westkant
665,Uitbreidingstraat 390,2023-05-01,08:00:00,64,52,12,FMN 18 Binnensingel Westkant
665,Uitbreidingstraat 390,2023-05-01,09:00:00,94,80,14,FMN 18 Binnensingel Westkant
665,Uitbreidingstraat 390,2023-05-01,10:00:00,141,109,32,FMN 18 Binnensingel Westkant
665,Uitbreidingstraat 390,2023-05-01,11:00:00,131,82,49,FMN 18 Binnensingel Westkant
665,Uitbreidingstraat 390,2023-05-01,12:00:00,117,62,55,FMN 18 Binnensingel Westkant
665,Uitbreidingstraat 390,2023-05-01,13:00:00,117,68,49,FMN 18 Binnensingel Westkant
665,Uitbreidingstraat 390,2023-05-01,14:00:00,119,81,38,FMN 18 Binnensingel Westkant
665,Uitbreidingstraat 390,2023-05-01,15:00:00,114,61,53,FMN 18 Binnensingel Westkant
665,Uitbreidingstraat 390,2023-05-01,16:00:00,106,60,46,FMN 18 Binnensingel Westkant
665,Uitbreidingstraat 390,2023-05-01,17:00:00,111,70,41,FMN 18 Binnensingel Westkant
665,Uitbreidingstraat 390,2023-05-01,18:00:00,93,69,24,FMN 18 Binnensingel Westkant
665,Uitbreidingstraat 390,2023-05-01,19:00:00,82,50,32,FMN 18 Binnensingel Westkant
665,Uitbreidingstraat 390,2023-05-01,20:00:00,66,48,18,FMN 18 Binnensingel Westkant
665,Uitbreidingstraat 390,2023-05-01,21:00:00,47,33,14,FMN 18 Binnensingel Westkant
665,Uitbreidingstraat 390,2023-05-01,22:00:00,40,38,2,FMN 18 Binnensingel Westkant
665,Uitbreidingstraat 390,2023-05-01,23:00:00,31,24,7,FMN 18 Binnensingel Westkant
665,Uitbreidingstraat 390,2023-05-02,00:00:00,11,5,6,FMN 18 Binnensingel Westkant
665,Uitbreidingstraat 390,2023-05-02,01:00:00,8,7,1,FMN 18 Binnensingel Westkant
665,Uitbreidingstraat 390,2023-05-02,02:00:00,2,1,1,FMN 18 Binnensingel Westkant
665,Uitbreidingstraat 390,2023-05-02,03:00:00,3,3,0,FMN 18 Binnensingel Westkant
665,Uitbreidingstraat 390,2023-05-02,04:00:00,7,3,4,FMN 18 Binnensingel Westkant
665,Uitbreidingstraat 390,2023-05-02,05:00:00,29,27,2,FMN 18 Binnensingel Westkant
665,Uitbreidingstraat 390,2023-05-02,06:00:00,65,52,13,FMN 18 Binnensingel Westkant
665,Uitbreidingstraat 390,2023-05-02,07:00:00,259,221,38,FMN 18 Binnensingel Westkant
665,Uitbreidingstraat 390,2023-05-02,08:00:00,477,406,71,FMN 18 Binnensingel Westkant
665,Uitbreidingstraat 390,2023-05-02,09:00:00,206,177,29,FMN 18 Binnensingel Westkant
665,Uitbreidingstraat 390,2023-05-02,10:00:00,98,78,20,FMN 18 Binnensingel Westkant
665,Uitbreidingstraat 390,2023-05-02,11:00:00,89,72,17,FMN 18 Binnensingel Westkant
665,Uitbreidingstraat 390,2023-05-02,12:00:00,161,102,59,FMN 18 Binnensingel Westkant
665,Uitbreidingstraat 390,2023-05-02,13:00:00,139,107,32,FMN 18 Binnensingel Westkant
665,Uitbreidingstraat 390,2023-05-02,14:00:00,86,62,24,FMN 18 Binnensingel Westkant
665,Uitbreidingstraat 390,2023-05-02,15:00:00,204,93,111,FMN 18 Binnensingel Westkant
665,Uitbreidingstraat 390,2023-05-02,16:00:00,354,136,218,FMN 18 Binnensingel Westkant
665,Uitbreidingstraat 390,2023-05-02,17:00:00,318,175,143,FMN 18 Binnensingel Westkant
665,Uitbreidingstraat 390,2023-05-02,18:00:00,225,162,63,FMN 18 Binnensingel Westkant
665,Uitbreidingstraat 390,2023-05-02,19:00:00,137,96,41,FMN 18 Binnensingel Westkant
665,Uitbreidingstraat 390,2023-05-02,20:00:00,72,42,30,FMN 18 Binnensingel Westkant
665,Uitbreidingstraat 390,2023-05-02,21:00:00,67,40,27,FMN 18 Binnensingel Westkant
665,Uitbreidingstraat 390,2023-05-02,22:00:00,69,48,21,FMN 18 Binnensingel Westkant
665,Uitbreidingstraat 390,2023-05-02,23:00:00,34,25,9,FMN 18 Binnensingel Westkant
665,Uitbreidingstraat 390,2023-05-03,00:00:00,9,7,2,FMN 18 Binnensingel Westkant
665,Uitbreidingstraat 390,2023-05-03,01:00:00,6,5,1,FMN 18 Binnensingel Westkant
665,Uitbreidingstraat 390,2023-05-03,02:00:00,3,1,2,FMN 18 Binnensingel Westkant
665,Uitbreidingstraat 390,2023-05-03,03:00:00,5,5,0,FMN 18 Binnensingel Westkant
665,Uitbreidingstraat 390,2023-05-03,04:00:00,4,3,1,FMN 18 Binnensingel Westkant
665,Uitbreidingstraat 390,2023-05-03,05:00:00,32,31,1,FMN 18 Binnensingel Westkant
665,Uitbreidingstraat 390,2023-05-03,06:00:00,70,55,15,FMN 18 Binnensingel Westkant
665,Uitbreidingstraat 390,2023-05-03,07:00:00,233,195,38,FMN 18 Binnensingel Westkant
665,Uitbreidingstraat 390,2023-05-03,08:00:00,440,370,70,FMN 18 Binnensingel Westkant
665,Uitbreidingstraat 390,2023-05-03,09:00:00,158,137,21,FMN 18 Binnensingel Westkant
665,Uitbreidingstraat 390,2023-05-03,10:00:00,115,88,27,FMN 18 Binnensingel Westkant
665,Uitbreidingstraat 390,2023-05-03,11:00:00,102,63,39,FMN 18 Binnensingel Westkant
665,Uitbreidingstraat 390,2023-05-03,12:00:00,234,112,122,FMN 18 Binnensingel Westkant
665,Uitbreidingstraat 390,2023-05-03,13:00:00,219,112,107,FMN 18 Binnensingel Westkant
665,Uitbreidingstraat 390,2023-05-03,14:00:00,138,88,50,FMN 18 Binnensingel Westkant
665,Uitbreidingstraat 390,2023-05-03,15:00:00,151,92,59,FMN 18 Binnensingel Westkant
665,Uitbreidingstraat 390,2023-05-03,16:00:00,217,125,92,FMN 18 Binnensingel Westkant
665,Uitbreidingstraat 390,2023-05-03,17:00:00,267,159,108,FMN 18 Binnensingel Westkant
665,Uitbreidingstraat 390,2023-05-03,18:00:00,259,160,99,FMN 18 Binnensingel Westkant
665,Uitbreidingstraat 390,2023-05-03,19:00:00,135,101,34,FMN 18 Binnensingel Westkant
665,Uitbreidingstraat 390,2023-05-03,20:00:00,102,66,36,FMN 18 Binnensingel Westkant
665,Uitbreidingstraat 390,2023-05-03,21:00:00,67,51,16,FMN 18 Binnensingel Westkant
665,Uitbreidingstraat 390,2023-05-03,22:00:00,62,39,23,FMN 18 Binnensingel Westkant
665,Uitbreidingstraat 390,2023-05-03,23:00:00,45,27,18,FMN 18 Binnensingel Westkant
665,Uitbreidingstraat 390,2023-05-04,00:00:00,14,11,3,FMN 18 Binnensingel Westkant
665,Uitbreidingstraat 390,2023-05-04,01:00:00,7,4,3,FMN 18 Binnensingel Westkant
665,Uitbreidingstraat 390,2023-05-04,02:00:00,2,1,1,FMN 18 Binnensingel Westkant
665,Uitbreidingstraat 390,2023-05-04,03:00:00,5,5,0,FMN 18 Binnensingel Westkant
665,Uitbreidingstraat 390,2023-05-04,04:00:00,7,6,1,FMN 18 Binnensingel Westkant
665,Uitbreidingstraat 390,2023-05-04,05:00:00,27,23,4,FMN 18 Binnensingel Westkant
665,Uitbreidingstraat 390,2023-05-04,06:00:00,70,56,14,FMN 18 Binnensingel Westkant
665,Uitbreidingstraat 390,2023-05-04,07:00:00,233,187,46,FMN 18 Binnensingel Westkant
665,Uitbreidingstraat 390,2023-05-04,08:00:00,493,412,81,FMN 18 Binnensingel Westkant
665,Uitbreidingstraat 390,2023-05-04,09:00:00,197,168,29,FMN 18 Binnensingel Westkant
665,Uitbreidingstraat 390,2023-05-04,10:00:00,112,91,21,FMN 18 Binnensingel Westkant
665,Uitbreidingstraat 390,2023-05-04,11:00:00,87,63,24,FMN 18 Binnensingel Westkant
665,Uitbreidingstraat 390,2023-05-04,12:00:00,169,108,61,FMN 18 Binnensingel Westkant
665,Uitbreidingstraat 390,2023-05-04,13:00:00,146,105,41,FMN 18 Binnensingel Westkant
665,Uitbreidingstraat 390,2023-05-04,14:00:00,136,87,49,FMN 18 Binnensingel Westkant
665,Uitbreidingstraat 390,2023-05-04,15:00:00,221,104,117,FMN 18 Binnensingel Westkant
665,Uitbreidingstraat 390,2023-05-04,16:00:00,322,120,202,FMN 18 Binnensingel Westkant
665,Uitbreidingstraat 390,2023-05-04,17:00:00,337,188,149,FMN 18 Binnensingel Westkant
665,Uitbreidingstraat 390,2023-05-04,18:00:00,245,173,72,FMN 18 Binnensingel Westkant
665,Uitbreidingstraat 390,2023-05-04,19:00:00,159,116,43,FMN 18 Binnensingel Westkant
665,Uitbreidingstraat 390,2023-05-04,20:00:00,103,69,34,FMN 18 Binnensingel Westkant
665,Uitbreidingstraat 390,2023-05-04,21:00:00,91,62,29,FMN 18 Binnensingel Westkant
665,Uitbreidingstraat 390,2023-05-04,22:00:00,86,54,32,FMN 18 Binnensingel Westkant
665,Uitbreidingstraat 390,2023-05-04,23:00:00,67,49,18,FMN 18 Binnensingel Westkant
665,Uitbreidingstraat 390,2023-05-05,00:00:00,33,25,8,FMN 18 Binnensingel Westkant
665,Uitbreidingstraat 390,2023-05-05,01:00:00,12,9,3,FMN 18 Binnensingel Westkant
665,Uitbreidingstraat 390,2023-05-05,02:00:00,2,1,1,FMN 18 Binnensingel Westkant
665,Uitbreidingstraat 390,2023-05-05,03:00:00,9,6,3,FMN 18 Binnensingel Westkant
665,Uitbreidingstraat 390,2023-05-05,04:00:00,6,5,1,FMN 18 Binnensingel Westkant
665,Uitbreidingstraat 390,2023-05-05,05:00:00,26,24,2,FMN 18 Binnensingel Westkant
665,Uitbreidingstraat 390,2023-05-05,06:00:00,65,50,15,FMN 18 Binnensingel Westkant
665,Uitbreidingstraat 390,2023-05-05,07:00:00,222,191,31,FMN 18 Binnensingel Westkant
665,Uitbreidingstraat 390,2023-05-05,08:00:00,388,336,52,FMN 18 Binnensingel Westkant
665,Uitbreidingstraat 390,2023-05-05,09:00:00,141,110,31,FMN 18 Binnensingel Westkant
665,Uitbreidingstraat 390,2023-05-05,10:00:00,136,108,28,FMN 18 Binnensingel Westkant
665,Uitbreidingstraat 390,2023-05-05,11:00:00,58,32,26,FMN 18 Binnensingel Westkant
665,Uitbreidingstraat 390,2023-05-05,12:00:00,121,63,58,FMN 18 Binnensingel Westkant
665,Uitbreidingstraat 390,2023-05-05,13:00:00,112,75,37,FMN 18 Binnensingel Westkant
665,Uitbreidingstraat 390,2023-05-05,14:00:00,146,78,68,FMN 18 Binnensingel Westkant
665,Uitbreidingstraat 390,2023-05-05,15:00:00,192,85,107,FMN 18 Binnensingel Westkant
665,Uitbreidingstraat 390,2023-05-05,16:00:00,291,110,181,FMN 18 Binnensingel Westkant
665,Uitbreidingstraat 390,2023-05-05,17:00:00,221,133,88,FMN 18 Binnensingel Westkant
665,Uitbreidingstraat 390,2023-05-05,18:00:00,191,124,67,FMN 18 Binnensingel Westkant
665,Uitbreidingstraat 390,2023-05-05,19:00:00,143,105,38,FMN 18 Binnensingel Westkant
665,Uitbreidingstraat 390,2023-05-05,20:00:00,75,49,26,FMN 18 Binnensingel Westkant
665,Uitbreidingstraat 390,2023-05-05,21:00:00,68,45,23,FMN 18 Binnensingel Westkant
665,Uitbreidingstraat 390,2023-05-05,22:00:00,64,43,21,FMN 18 Binnensingel Westkant
665,Uitbreidingstraat 390,2023-05-05,23:00:00,50,35,15,FMN 18 Binnensingel Westkant
665,Uitbreidingstraat 390,2023-05-06,00:00:00,45,34,11,FMN 18 Binnensingel Westkant
665,Uitbreidingstraat 390,2023-05-06,01:00:00,37,24,13,FMN 18 Binnensingel Westkant
665,Uitbreidingstraat 390,2023-05-06,02:00:00,19,12,7,FMN 18 Binnensingel Westkant
665,Uitbreidingstraat 390,2023-05-06,03:00:00,16,16,0,FMN 18 Binnensingel Westkant
665,Uitbreidingstraat 390,2023-05-06,04:00:00,18,17,1,FMN 18 Binnensingel Westkant
665,Uitbreidingstraat 390,2023-05-06,05:00:00,16,16,0,FMN 18 Binnensingel Westkant
665,Uitbreidingstraat 390,2023-05-06,06:00:00,26,22,4,FMN 18 Binnensingel Westkant
665,Uitbreidingstraat 390,2023-05-06,07:00:00,24,19,5,FMN 18 Binnensingel Westkant
665,Uitbreidingstraat 390,2023-05-06,08:00:00,50,39,11,FMN 18 Binnensingel Westkant
665,Uitbreidingstraat 390,2023-05-06,09:00:00,75,59,16,FMN 18 Binnensingel Westkant
665,Uitbreidingstraat 390,2023-05-06,10:00:00,92,74,18,FMN 18 Binnensingel Westkant
665,Uitbreidingstraat 390,2023-05-06,11:00:00,88,65,23,FMN 18 Binnensingel Westkant
665,Uitbreidingstraat 390,2023-05-06,12:00:00,101,70,31,FMN 18 Binnensingel Westkant
665,Uitbreidingstraat 390,2023-05-06,13:00:00,106,71,35,FMN 18 Binnensingel Westkant
665,Uitbreidingstraat 390,2023-05-06,14:00:00,100,70,30,FMN 18 Binnensingel Westkant
665,Uitbreidingstraat 390,2023-05-06,15:00:00,103,74,29,FMN 18 Binnensingel Westkant
665,Uitbreidingstraat 390,2023-05-06,16:00:00,109,72,37,FMN 18 Binnensingel Westkant
665,Uitbreidingstraat 390,2023-05-06,17:00:00,112,77,35,FMN 18 Binnensingel Westkant
665,Uitbreidingstraat 390,2023-05-06,18:00:00,84,57,27,FMN 18 Binnensingel Westkant
665,Uitbreidingstraat 390,2023-05-06,19:00:00,104,89,15,FMN 18 Binnensingel Westkant
665,Uitbreidingstraat 390,2023-05-06,20:00:00,60,45,15,FMN 18 Binnensingel Westkant
665,Uitbreidingstraat 390,2023-05-06,21:00:00,50,33,17,FMN 18 Binnensingel Westkant
665,Uitbreidingstraat 390,2023-05-06,22:00:00,57,40,17,FMN 18 Binnensingel Westkant
665,Uitbreidingstraat 390,2023-05-06,23:00:00,44,30,14,FMN 18 Binnensingel Westkant
665,Uitbreidingstraat 390,2023-05-07,00:00:00,41,31,10,FMN 18 Binnensingel Westkant
665,Uitbreidingstraat 390,2023-05-07,01:00:00,27,17,10,FMN 18 Binnensingel Westkant
665,Uitbreidingstraat 390,2023-05-07,02:00:00,29,27,2,FMN 18 Binnensingel Westkant
665,Uitbreidingstraat 390,2023-05-07,03:00:00,29,26,3,FMN 18 Binnensingel Westkant
665,Uitbreidingstraat 390,2023-05-07,04:00:00,15,13,2,FMN 18 Binnensingel Westkant
665,Uitbreidingstraat 390,2023-05-07,05:00:00,10,9,1,FMN 18 Binnensingel Westkant
665,Uitbreidingstraat 390,2023-05-07,06:00:00,18,15,3,FMN 18 Binnensingel Westkant
665,Uitbreidingstraat 390,2023-05-07,07:00:00,10,5,5,FMN 18 Binnensingel Westkant
665,Uitbreidingstraat 390,2023-05-07,08:00:00,29,18,11,FMN 18 Binnensingel Westkant
665,Uitbreidingstraat 390,2023-05-07,09:00:00,50,36,14,FMN 18 Binnensingel Westkant
665,Uitbreidingstraat 390,2023-05-07,10:00:00,71,55,16,FMN 18 Binnensingel Westkant
665,Uitbreidingstraat 390,2023-05-07,11:00:00,72,47,25,FMN 18 Binnensingel Westkant
665,Uitbreidingstraat 390,2023-05-07,12:00:00,78,49,29,FMN 18 Binnensingel Westkant
665,Uitbreidingstraat 390,2023-05-07,13:00:00,68,44,24,FMN 18 Binnensingel Westkant
665,Uitbreidingstraat 390,2023-05-07,14:00:00,54,34,20,FMN 18 Binnensingel Westkant
665,Uitbreidingstraat 390,2023-05-07,15:00:00,62,33,29,FMN 18 Binnensingel Westkant
665,Uitbreidingstraat 390,2023-05-07,16:00:00,64,52,12,FMN 18 Binnensingel Westkant
665,Uitbreidingstraat 390,2023-05-07,17:00:00,94,65,29,FMN 18 Binnensingel Westkant
665,Uitbreidingstraat 390,2023-05-07,18:00:00,77,54,23,FMN 18 Binnensingel Westkant
665,Uitbreidingstraat 390,2023-05-07,19:00:00,65,51,14,FMN 18 Binnensingel Westkant
665,Uitbreidingstraat 390,2023-05-07,20:00:00,51,31,20,FMN 18 Binnensingel Westkant
665,Uitbreidingstraat 390,2023-05-07,21:00:00,55,43,12,FMN 18 Binnensingel Westkant
665,Uitbreidingstraat 390,2023-05-07,22:00:00,35,30,5,FMN 18 Binnensingel Westkant
665,Uitbreidingstraat 390,2023-05-07,23:00:00,36,33,3,FMN 18 Binnensingel Westkant
665,Uitbreidingstraat 390,2023-05-08,00:00:00,10,5,5,FMN 18 Binnensingel Westkant
665,Uitbreidingstraat 390,2023-05-08,01:00:00,4,3,1,FMN 18 Binnensingel Westkant
665,Uitbreidingstraat 390,2023-05-08,02:00:00,2,1,1,FMN 18 Binnensingel Westkant
665,Uitbreidingstraat 390,2023-05-08,03:00:00,3,3,0,FMN 18 Binnensingel Westkant
665,Uitbreidingstraat 390,2023-05-08,04:00:00,14,11,3,FMN 18 Binnensingel Westkant
665,Uitbreidingstraat 390,2023-05-08,05:00:00,31,27,4,FMN 18 Binnensingel Westkant
665,Uitbreidingstraat 390,2023-05-08,06:00:00,66,56,10,FMN 18 Binnensingel Westkant
665,Uitbreidingstraat 390,2023-05-08,07:00:00,231,200,31,FMN 18 Binnensingel Westkant
665,Uitbreidingstraat 390,2023-05-08,08:00:00,430,348,82,FMN 18 Binnensingel Westkant
665,Uitbreidingstraat 390,2023-05-08,09:00:00,162,145,17,FMN 18 Binnensingel Westkant
665,Uitbreidingstraat 390,2023-05-08,10:00:00,119,91,28,FMN 18 Binnensingel Westkant
665,Uitbreidingstraat 390,2023-05-08,11:00:00,69,49,20,FMN 18 Binnensingel Westkant
665,Uitbreidingstraat 390,2023-05-08,12:00:00,125,73,52,FMN 18 Binnensingel Westkant
665,Uitbreidingstraat 390,2023-05-08,13:00:00,132,91,41,FMN 18 Binnensingel Westkant
665,Uitbreidingstraat 390,2023-05-08,14:00:00,127,82,45,FMN 18 Binnensingel Westkant
665,Uitbreidingstraat 390,2023-05-08,15:00:00,196,88,108,FMN 18 Binnensingel Westkant
665,Uitbreidingstraat 390,2023-05-08,16:00:00,334,131,203,FMN 18 Binnensingel Westkant
665,Uitbreidingstraat 390,2023-05-08,17:00:00,305,158,147,FMN 18 Binnensingel Westkant
665,Uitbreidingstraat 390,2023-05-08,18:00:00,213,144,69,FMN 18 Binnensingel Westkant
665,Uitbreidingstraat 390,2023-05-08,19:00:00,128,77,51,FMN 18 Binnensingel Westkant
665,Uitbreidingstraat 390,2023-05-08,20:00:00,81,53,28,FMN 18 Binnensingel Westkant
665,Uitbreidingstraat 390,2023-05-08,21:00:00,62,34,28,FMN 18 Binnensingel Westkant
665,Uitbreidingstraat 390,2023-05-08,22:00:00,50,37,13,FMN 18 Binnensingel Westkant
665,Uitbreidingstraat 390,2023-05-08,23:00:00,16,10,6,FMN 18 Binnensingel Westkant
665,Uitbreidingstraat 390,2023-05-09,00:00:00,9,9,0,FMN 18 Binnensingel Westkant
665,Uitbreidingstraat 390,2023-05-09,01:00:00,7,7,0,FMN 18 Binnensingel Westkant
665,Uitbreidingstraat 390,2023-05-09,02:00:00,4,3,1,FMN 18 Binnensingel Westkant
665,Uitbreidingstraat 390,2023-05-09,03:00:00,4,3,1,FMN 18 Binnensingel Westkant
665,Uitbreidingstraat 390,2023-05-09,04:00:00,11,9,2,FMN 18 Binnensingel Westkant
665,Uitbreidingstraat 390,2023-05-09,05:00:00,30,27,3,FMN 18 Binnensingel Westkant
665,Uitbreidingstraat 390,2023-05-09,06:00:00,72,51,21,FMN 18 Binnensingel Westkant
665,Uitbreidingstraat 390,2023-05-09,07:00:00,252,213,39,FMN 18 Binnensingel Westkant
665,Uitbreidingstraat 390,2023-05-09,08:00:00,344,279,65,FMN 18 Binnensingel Westkant
665,Uitbreidingstraat 390,2023-05-09,09:00:00,125,104,21,FMN 18 Binnensingel Westkant
665,Uitbreidingstraat 390,2023-05-09,10:00:00,88,64,24,FMN 18 Binnensingel Westkant
665,Uitbreidingstraat 390,2023-05-09,11:00:00,60,39,21,FMN 18 Binnensingel Westkant
665,Uitbreidingstraat 390,2023-05-09,12:00:00,73,47,26,FMN 18 Binnensingel Westkant
665,Uitbreidingstraat 390,2023-05-09,13:00:00,73,52,21,FMN 18 Binnensingel Westkant
665,Uitbreidingstraat 390,2023-05-09,14:00:00,74,43,31,FMN 18 Binnensingel Westkant
665,Uitbreidingstraat 390,2023-05-09,15:00:00,126,60,66,FMN 18 Binnensingel Westkant
665,Uitbreidingstraat 390,2023-05-09,16:00:00,234,94,140,FMN 18 Binnensingel Westkant
665,Uitbreidingstraat 390,2023-05-09,17:00:00,209,102,107,FMN 18 Binnensingel Westkant
665,Uitbreidingstraat 390,2023-05-09,18:00:00,162,113,49,FMN 18 Binnensingel Westkant
665,Uitbreidingstraat 390,2023-05-09,19:00:00,100,67,33,FMN 18 Binnensingel Westkant
665,Uitbreidingstraat 390,2023-05-09,20:00:00,56,32,24,FMN 18 Binnensingel Westkant
665,Uitbreidingstraat 390,2023-05-09,21:00:00,54,32,22,FMN 18 Binnensingel Westkant
665,Uitbreidingstraat 390,2023-05-09,22:00:00,38,26,12,FMN 18 Binnensingel Westkant
665,Uitbreidingstraat 390,2023-05-09,23:00:00,33,23,10,FMN 18 Binnensingel Westkant
665,Uitbreidingstraat 390,2023-05-10,00:00:00,10,7,3,FMN 18 Binnensingel Westkant
665,Uitbreidingstraat 390,2023-05-10,01:00:00,4,2,2,FMN 18 Binnensingel Westkant
665,Uitbreidingstraat 390,2023-05-10,02:00:00,0,0,0,FMN 18 Binnensingel Westkant
665,Uitbreidingstraat 390,2023-05-10,03:00:00,9,9,0,FMN 18 Binnensingel Westkant
665,Uitbreidingstraat 390,2023-05-10,04:00:00,11,9,2,FMN 18 Binnensingel Westkant
665,Uitbreidingstraat 390,2023-05-10,05:00:00,24,21,3,FMN 18 Binnensingel Westkant
665,Uitbreidingstraat 390,2023-05-10,06:00:00,70,53,17,FMN 18 Binnensingel Westkant
665,Uitbreidingstraat 390,2023-05-10,07:00:00,178,153,25,FMN 18 Binnensingel Westkant
665,Uitbreidingstraat 390,2023-05-10,08:00:00,384,317,67,FMN 18 Binnensingel Westkant
665,Uitbreidingstraat 390,2023-05-10,09:00:00,138,112,26,FMN 18 Binnensingel Westkant
665,Uitbreidingstraat 390,2023-05-10,10:00:00,113,75,38,FMN 18 Binnensingel Westkant
665,Uitbreidingstraat 390,2023-05-10,11:00:00,102,66,36,FMN 18 Binnensingel Westkant
665,Uitbreidingstraat 390,2023-05-10,12:00:00,235,98,137,FMN 18 Binnensingel Westkant
665,Uitbreidingstraat 390,2023-05-10,13:00:00,139,65,74,FMN 18 Binnensingel Westkant
665,Uitbreidingstraat 390,2023-05-10,14:00:00,106,60,46,FMN 18 Binnensingel Westkant
665,Uitbreidingstraat 390,2023-05-10,15:00:00,144,82,62,FMN 18 Binnensingel Westkant
665,Uitbreidingstraat 390,2023-05-10,16:00:00,152,83,69,FMN 18 Binnensingel Westkant
665,Uitbreidingstraat 390,2023-05-10,17:00:00,204,114,90,FMN 18 Binnensingel Westkant
665,Uitbreidingstraat 390,2023-05-10,18:00:00,157,108,49,FMN 18 Binnensingel Westkant
665,Uitbreidingstraat 390,2023-05-10,19:00:00,85,55,30,FMN 18 Binnensingel Westkant
665,Uitbreidingstraat 390,2023-05-10,20:00:00,76,54,22,FMN 18 Binnensingel Westkant
665,Uitbreidingstraat 390,2023-05-10,21:00:00,46,21,25,FMN 18 Binnensingel Westkant
665,Uitbreidingstraat 390,2023-05-10,22:00:00,44,30,14,FMN 18 Binnensingel Westkant
665,Uitbreidingstraat 390,2023-05-10,23:00:00,24,16,8,FMN 18 Binnensingel Westkant
665,Uitbreidingstraat 390,2023-05-11,00:00:00,8,7,1,FMN 18 Binnensingel Westkant
665,Uitbreidingstraat 390,2023-05-11,01:00:00,7,5,2,FMN 18 Binnensingel Westkant
665,Uitbreidingstraat 390,2023-05-11,02:00:00,1,0,1,FMN 18 Binnensingel Westkant
665,Uitbreidingstraat 390,2023-05-11,03:00:00,5,5,0,FMN 18 Binnensingel Westkant
665,Uitbreidingstraat 390,2023-05-11,04:00:00,11,9,2,FMN 18 Binnensingel Westkant
665,Uitbreidingstraat 390,2023-05-11,05:00:00,25,24,1,FMN 18 Binnensingel Westkant
665,Uitbreidingstraat 390,2023-05-11,06:00:00,70,48,22,FMN 18 Binnensingel Westkant
665,Uitbreidingstraat 390,2023-05-11,07:00:00,206,169,37,FMN 18 Binnensingel Westkant
665,Uitbreidingstraat 390,2023-05-11,08:00:00,418,344,74,FMN 18 Binnensingel Westkant
665,Uitbreidingstraat 390,2023-05-11,09:00:00,183,150,33,FMN 18 Binnensingel Westkant
665,Uitbreidingstraat 390,2023-05-11,10:00:00,107,80,27,FMN 18 Binnensingel Westkant
665,Uitbreidingstraat 390,2023-05-11,11:00:00,111,76,35,FMN 18 Binnensingel Westkant
665,Uitbreidingstraat 390,2023-05-11,12:00:00,134,86,48,FMN 18 Binnensingel Westkant
665,Uitbreidingstraat 390,2023-05-11,13:00:00,133,93,40,FMN 18 Binnensingel Westkant
665,Uitbreidingstraat 390,2023-05-11,14:00:00,109,65,44,FMN 18 Binnensingel Westkant
665,Uitbreidingstraat 390,2023-05-11,15:00:00,202,85,117,FMN 18 Binnensingel Westkant
665,Uitbreidingstraat 390,2023-05-11,16:00:00,270,98,172,FMN 18 Binnensingel Westkant
665,Uitbreidingstraat 390,2023-05-11,17:00:00,268,142,126,FMN 18 Binnensingel Westkant
665,Uitbreidingstraat 390,2023-05-11,18:00:00,196,115,81,FMN 18 Binnensingel Westkant
665,Uitbreidingstraat 390,2023-05-11,19:00:00,126,92,34,FMN 18 Binnensingel Westkant
665,Uitbreidingstraat 390,2023-05-11,20:00:00,92,65,27,FMN 18 Binnensingel Westkant
665,Uitbreidingstraat 390,2023-05-11,21:00:00,64,40,24,FMN 18 Binnensingel Westkant
665,Uitbreidingstraat 390,2023-05-11,22:00:00,52,26,26,FMN 18 Binnensingel Westkant
665,Uitbreidingstraat 390,2023-05-11,23:00:00,43,39,4,FMN 18 Binnensingel Westkant
665,Uitbreidingstraat 390,2023-05-12,00:00:00,21,17,4,FMN 18 Binnensingel Westkant
665,Uitbreidingstraat 390,2023-05-12,01:00:00,16,13,3,FMN 18 Binnensingel Westkant
665,Uitbreidingstraat 390,2023-05-12,02:00:00,2,2,0,FMN 18 Binnensingel Westkant
665,Uitbreidingstraat 390,2023-05-12,03:00:00,7,7,0,FMN 18 Binnensingel Westkant
665,Uitbreidingstraat 390,2023-05-12,04:00:00,10,8,2,FMN 18 Binnensingel Westkant
665,Uitbreidingstraat 390,2023-05-12,05:00:00,28,25,3,FMN 18 Binnensingel Westkant
665,Uitbreidingstraat 390,2023-05-12,06:00:00,40,29,11,FMN 18 Binnensingel Westkant
665,Uitbreidingstraat 390,2023-05-12,07:00:00,141,127,14,FMN 18 Binnensingel Westkant
665,Uitbreidingstraat 390,2023-05-12,08:00:00,301,251,50,FMN 18 Binnensingel Westkant
665,Uitbreidingstraat 390,2023-05-12,09:00:00,123,108,15,FMN 18 Binnensingel Westkant
665,Uitbreidingstraat 390,2023-05-12,10:00:00,88,68,20,FMN 18 Binnensingel Westkant
665,Uitbreidingstraat 390,2023-05-12,11:00:00,60,46,14,FMN 18 Binnensingel Westkant
665,Uitbreidingstraat 390,2023-05-12,12:00:00,143,87,56,FMN 18 Binnensingel Westkant
665,Uitbreidingstraat 390,2023-05-12,13:00:00,113,73,40,FMN 18 Binnensingel Westkant
665,Uitbreidingstraat 390,2023-05-12,14:00:00,117,70,47,FMN 18 Binnensingel Westkant
665,Uitbreidingstraat 390,2023-05-12,15:00:00,172,79,93,FMN 18 Binnensingel Westkant
665,Uitbreidingstraat 390,2023-05-12,16:00:00,277,94,183,FMN 18 Binnensingel Westkant
665,Uitbreidingstraat 390,2023-05-12,17:00:00,238,142,96,FMN 18 Binnensingel Westkant
665,Uitbreidingstraat 390,2023-05-12,18:00:00,163,111,52,FMN 18 Binnensingel Westkant
665,Uitbreidingstraat 390,2023-05-12,19:00:00,116,80,36,FMN 18 Binnensingel Westkant
665,Uitbreidingstraat 390,2023-05-12,20:00:00,80,54,26,FMN 18 Binnensingel Westkant
665,Uitbreidingstraat 390,2023-05-12,21:00:00,84,43,41,FMN 18 Binnensingel Westkant
665,Uitbreidingstraat 390,2023-05-12,22:00:00,74,44,30,FMN 18 Binnensingel Westkant
665,Uitbreidingstraat 390,2023-05-12,23:00:00,75,63,12,FMN 18 Binnensingel Westkant
665,Uitbreidingstraat 390,2023-05-13,00:00:00,47,26,21,FMN 18 Binnensingel Westkant
665,Uitbreidingstraat 390,2023-05-13,01:00:00,46,35,11,FMN 18 Binnensingel Westkant
665,Uitbreidingstraat 390,2023-05-13,02:00:00,26,16,10,FMN 18 Binnensingel Westkant
665,Uitbreidingstraat 390,2023-05-13,03:00:00,21,16,5,FMN 18 Binnensingel Westkant
665,Uitbreidingstraat 390,2023-05-13,04:00:00,17,15,2,FMN 18 Binnensingel Westkant
665,Uitbreidingstraat 390,2023-05-13,05:00:00,11,5,6,FMN 18 Binnensingel Westkant
665,Uitbreidingstraat 390,2023-05-13,06:00:00,26,23,3,FMN 18 Binnensingel Westkant
665,Uitbreidingstraat 390,2023-05-13,07:00:00,19,13,6,FMN 18 Binnensingel Westkant
665,Uitbreidingstraat 390,2023-05-13,08:00:00,53,45,8,FMN 18 Binnensingel Westkant
665,Uitbreidingstraat 390,2023-05-13,09:00:00,105,73,32,FMN 18 Binnensingel Westkant
665,Uitbreidingstraat 390,2023-05-13,10:00:00,74,53,21,FMN 18 Binnensingel Westkant
665,Uitbreidingstraat 390,2023-05-13,11:00:00,98,72,26,FMN 18 Binnensingel Westkant
665,Uitbreidingstraat 390,2023-05-13,12:00:00,112,72,40,FMN 18 Binnensingel Westkant
665,Uitbreidingstraat 390,2023-05-13,13:00:00,113,83,30,FMN 18 Binnensingel Westkant
665,Uitbreidingstraat 390,2023-05-13,14:00:00,120,83,37,FMN 18 Binnensingel Westkant
665,Uitbreidingstraat 390,2023-05-13,15:00:00,117,86,31,FMN 18 Binnensingel Westkant
665,Uitbreidingstraat 390,2023-05-13,16:00:00,92,63,29,FMN 18 Binnensingel Westkant
665,Uitbreidingstraat 390,2023-05-13,17:00:00,124,85,39,FMN 18 Binnensingel Westkant
665,Uitbreidingstraat 390,2023-05-13,18:00:00,95,72,23,FMN 18 Binnensingel Westkant
665,Uitbreidingstraat 390,2023-05-13,19:00:00,107,75,32,FMN 18 Binnensingel Westkant
665,Uitbreidingstraat 390,2023-05-13,20:00:00,58,43,15,FMN 18 Binnensingel Westkant
665,Uitbreidingstraat 390,2023-05-13,21:00:00,71,50,21,FMN 18 Binnensingel Westkant
665,Uitbreidingstraat 390,2023-05-13,22:00:00,50,44,6,FMN 18 Binnensingel Westkant
665,Uitbreidingstraat 390,2023-05-13,23:00:00,65,55,10,FMN 18 Binnensingel Westkant
665,Uitbreidingstraat 390,2023-05-14,00:00:00,51,42,9,FMN 18 Binnensingel Westkant
665,Uitbreidingstraat 390,2023-05-14,01:00:00,49,36,13,FMN 18 Binnensingel Westkant
665,Uitbreidingstraat 390,2023-05-14,02:00:00,37,29,8,FMN 18 Binnensingel Westkant
665,Uitbreidingstraat 390,2023-05-14,03:00:00,19,16,3,FMN 18 Binnensingel Westkant
665,Uitbreidingstraat 390,2023-05-14,04:00:00,15,14,1,FMN 18 Binnensingel Westkant
665,Uitbreidingstraat 390,2023-05-14,05:00:00,5,3,2,FMN 18 Binnensingel Westkant
665,Uitbreidingstraat 390,2023-05-14,06:00:00,17,15,2,FMN 18 Binnensingel Westkant
665,Uitbreidingstraat 390,2023-05-14,07:00:00,6,2,4,FMN 18 Binnensingel Westkant
665,Uitbreidingstraat 390,2023-05-14,08:00:00,21,16,5,FMN 18 Binnensingel Westkant
665,Uitbreidingstraat 390,2023-05-14,09:00:00,72,53,19,FMN 18 Binnensingel Westkant
665,Uitbreidingstraat 390,2023-05-14,10:00:00,57,40,17,FMN 18 Binnensingel Westkant
665,Uitbreidingstraat 390,2023-05-14,11:00:00,66,40,26,FMN 18 Binnensingel Westkant
665,Uitbreidingstraat 390,2023-05-14,12:00:00,98,66,32,FMN 18 Binnensingel Westkant
665,Uitbreidingstraat 390,2023-05-14,13:00:00,85,58,27,FMN 18 Binnensingel Westkant
665,Uitbreidingstraat 390,2023-05-14,14:00:00,91,73,18,FMN 18 Binnensingel Westkant
665,Uitbreidingstraat 390,2023-05-14,15:00:00,95,68,27,FMN 18 Binnensingel Westkant
665,Uitbreidingstraat 390,2023-05-14,16:00:00,109,82,27,FMN 18 Binnensingel Westkant
665,Uitbreidingstraat 390,2023-05-14,17:00:00,116,88,28,FMN 18 Binnensingel Westkant
665,Uitbreidingstraat 390,2023-05-14,18:00:00,93,74,19,FMN 18 Binnensingel Westkant
665,Uitbreidingstraat 390,2023-05-14,19:00:00,71,52,19,FMN 18 Binnensingel Westkant
665,Uitbreidingstraat 390,2023-05-14,20:00:00,71,48,23,FMN 18 Binnensingel Westkant
665,Uitbreidingstraat 390,2023-05-14,21:00:00,75,54,21,FMN 18 Binnensingel Westkant
665,Uitbreidingstraat 390,2023-05-14,22:00:00,38,31,7,FMN 18 Binnensingel Westkant
665,Uitbreidingstraat 390,2023-05-14,23:00:00,48,43,5,FMN 18 Binnensingel Westkant
665,Uitbreidingstraat 390,2023-05-15,00:00:00,15,13,2,FMN 18 Binnensingel Westkant
665,Uitbreidingstraat 390,2023-05-15,01:00:00,12,10,2,FMN 18 Binnensingel Westkant
665,Uitbreidingstraat 390,2023-05-15,02:00:00,1,1,0,FMN 18 Binnensingel Westkant
665,Uitbreidingstraat 390,2023-05-15,03:00:00,2,2,0,FMN 18 Binnensingel Westkant
665,Uitbreidingstraat 390,2023-05-15,04:00:00,7,5,2,FMN 18 Binnensingel Westkant
665,Uitbreidingstraat 390,2023-05-15,05:00:00,28,25,3,FMN 18 Binnensingel Westkant
665,Uitbreidingstraat 390,2023-05-15,06:00:00,66,49,17,FMN 18 Binnensingel Westkant
665,Uitbreidingstraat 390,2023-05-15,07:00:00,209,177,32,FMN 18 Binnensingel Westkant
665,Uitbreidingstraat 390,2023-05-15,08:00:00,407,339,68,FMN 18 Binnensingel Westkant
665,Uitbreidingstraat 390,2023-05-15,09:00:00,151,122,29,FMN 18 Binnensingel Westkant
665,Uitbreidingstraat 390,2023-05-15,10:00:00,112,88,24,FMN 18 Binnensingel Westkant
665,Uitbreidingstraat 390,2023-05-15,11:00:00,65,43,22,FMN 18 Binnensingel Westkant
665,Uitbreidingstraat 390,2023-05-15,12:00:00,123,69,54,FMN 18 Binnensingel Westkant
665,Uitbreidingstraat 390,2023-05-15,13:00:00,108,79,29,FMN 18 Binnensingel Westkant
665,Uitbreidingstraat 390,2023-05-15,14:00:00,82,39,43,FMN 18 Binnensingel Westkant
665,Uitbreidingstraat 390,2023-05-15,15:00:00,176,57,119,FMN 18 Binnensingel Westkant
665,Uitbreidingstraat 390,2023-05-15,16:00:00,261,97,164,FMN 18 Binnensingel Westkant
665,Uitbreidingstraat 390,2023-05-15,17:00:00,241,120,121,FMN 18 Binnensingel Westkant
665,Uitbreidingstraat 390,2023-05-15,18:00:00,189,136,53,FMN 18 Binnensingel Westkant
665,Uitbreidingstraat 390,2023-05-15,19:00:00,77,57,20,FMN 18 Binnensingel Westkant
665,Uitbreidingstraat 390,2023-05-15,20:00:00,48,26,22,FMN 18 Binnensingel Westkant
665,Uitbreidingstraat 390,2023-05-15,21:00:00,40,28,12,FMN 18 Binnensingel Westkant
665,Uitbreidingstraat 390,2023-05-15,22:00:00,45,33,12,FMN 18 Binnensingel Westkant
665,Uitbreidingstraat 390,2023-05-15,23:00:00,17,9,8,FMN 18 Binnensingel Westkant
665,Uitbreidingstraat 390,2023-05-16,00:00:00,10,10,0,FMN 18 Binnensingel Westkant
665,Uitbreidingstraat 390,2023-05-16,01:00:00,4,3,1,FMN 18 Binnensingel Westkant
665,Uitbreidingstraat 390,2023-05-16,02:00:00,2,2,0,FMN 18 Binnensingel Westkant
665,Uitbreidingstraat 390,2023-05-16,03:00:00,5,5,0,FMN 18 Binnensingel Westkant
665,Uitbreidingstraat 390,2023-05-16,04:00:00,9,8,1,FMN 18 Binnensingel Westkant
665,Uitbreidingstraat 390,2023-05-16,05:00:00,28,26,2,FMN 18 Binnensingel Westkant
665,Uitbreidingstraat 390,2023-05-16,06:00:00,71,53,18,FMN 18 Binnensingel Westkant
665,Uitbreidingstraat 390,2023-05-16,07:00:00,232,180,52,FMN 18 Binnensingel Westkant
665,Uitbreidingstraat 390,2023-05-16,08:00:00,445,372,73,FMN 18 Binnensingel Westkant
665,Uitbreidingstraat 390,2023-05-16,09:00:00,178,154,24,FMN 18 Binnensingel Westkant
665,Uitbreidingstraat 390,2023-05-16,10:00:00,111,89,22,FMN 18 Binnensingel Westkant
665,Uitbreidingstraat 390,2023-05-16,11:00:00,85,55,30,FMN 18 Binnensingel Westkant
665,Uitbreidingstraat 390,2023-05-16,12:00:00,123,81,42,FMN 18 Binnensingel Westkant
665,Uitbreidingstraat 390,2023-05-16,13:00:00,114,92,22,FMN 18 Binnensingel Westkant
665,Uitbreidingstraat 390,2023-05-16,14:00:00,88,57,31,FMN 18 Binnensingel Westkant
665,Uitbreidingstraat 390,2023-05-16,15:00:00,173,87,86,FMN 18 Binnensingel Westkant
665,Uitbreidingstraat 390,2023-05-16,16:00:00,321,119,202,FMN 18 Binnensingel Westkant
665,Uitbreidingstraat 390,2023-05-16,17:00:00,326,177,149,FMN 18 Binnensingel Westkant
665,Uitbreidingstraat 390,2023-05-16,18:00:00,223,145,78,FMN 18 Binnensingel Westkant
665,Uitbreidingstraat 390,2023-05-16,19:00:00,135,94,41,FMN 18 Binnensingel Westkant
665,Uitbreidingstraat 390,2023-05-16,20:00:00,97,56,41,FMN 18 Binnensingel Westkant
665,Uitbreidingstraat 390,2023-05-16,21:00:00,70,45,25,FMN 18 Binnensingel Westkant
665,Uitbreidingstraat 390,2023-05-16,22:00:00,61,36,25,FMN 18 Binnensingel Westkant
665,Uitbreidingstraat 390,2023-05-16,23:00:00,30,26,4,FMN 18 Binnensingel Westkant
665,Uitbreidingstraat 390,2023-05-17,00:00:00,17,13,4,FMN 18 Binnensingel Westkant
665,Uitbreidingstraat 390,2023-05-17,01:00:00,15,12,3,FMN 18 Binnensingel Westkant
665,Uitbreidingstraat 390,2023-05-17,02:00:00,3,3,0,FMN 18 Binnensingel Westkant
665,Uitbreidingstraat 390,2023-05-17,03:00:00,5,5,0,FMN 18 Binnensingel Westkant
665,Uitbreidingstraat 390,2023-05-17,04:00:00,9,6,3,FMN 18 Binnensingel Westkant
665,Uitbreidingstraat 390,2023-05-17,05:00:00,30,27,3,FMN 18 Binnensingel Westkant
665,Uitbreidingstraat 390,2023-05-17,06:00:00,63,49,14,FMN 18 Binnensingel Westkant
665,Uitbreidingstraat 390,2023-05-17,07:00:00,167,134,33,FMN 18 Binnensingel Westkant
665,Uitbreidingstraat 390,2023-05-17,08:00:00,369,324,45,FMN 18 Binnensingel Westkant
665,Uitbreidingstraat 390,2023-05-17,09:00:00,156,144,12,FMN 18 Binnensingel Westkant
665,Uitbreidingstraat 390,2023-05-17,10:00:00,112,90,22,FMN 18 Binnensingel Westkant
665,Uitbreidingstraat 390,2023-05-17,11:00:00,92,59,33,FMN 18 Binnensingel Westkant
665,Uitbreidingstraat 390,2023-05-17,12:00:00,253,114,139,FMN 18 Binnensingel Westkant
665,Uitbreidingstraat 390,2023-05-17,13:00:00,173,99,74,FMN 18 Binnensingel Westkant
665,Uitbreidingstraat 390,2023-05-17,14:00:00,111,73,38,FMN 18 Binnensingel Westkant
665,Uitbreidingstraat 390,2023-05-17,15:00:00,135,72,63,FMN 18 Binnensingel Westkant
665,Uitbreidingstraat 390,2023-05-17,16:00:00,200,113,87,FMN 18 Binnensingel Westkant
665,Uitbreidingstraat 390,2023-05-17,17:00:00,269,169,100,FMN 18 Binnensingel Westkant
665,Uitbreidingstraat 390,2023-05-17,18:00:00,195,126,69,FMN 18 Binnensingel Westkant
665,Uitbreidingstraat 390,2023-05-17,19:00:00,144,109,35,FMN 18 Binnensingel Westkant
665,Uitbreidingstraat 390,2023-05-17,20:00:00,96,66,30,FMN 18 Binnensingel Westkant
665,Uitbreidingstraat 390,2023-05-17,21:00:00,56,43,13,FMN 18 Binnensingel Westkant
665,Uitbreidingstraat 390,2023-05-17,22:00:00,64,49,15,FMN 18 Binnensingel Westkant
665,Uitbreidingstraat 390,2023-05-17,23:00:00,62,47,15,FMN 18 Binnensingel Westkant
665,Uitbreidingstraat 390,2023-05-18,00:00:00,46,34,12,FMN 18 Binnensingel Westkant
665,Uitbreidingstraat 390,2023-05-18,01:00:00,23,18,5,FMN 18 Binnensingel Westkant
665,Uitbreidingstraat 390,2023-05-18,02:00:00,23,18,5,FMN 18 Binnensingel Westkant
665,Uitbreidingstraat 390,2023-05-18,03:00:00,11,6,5,FMN 18 Binnensingel Westkant
665,Uitbreidingstraat 390,2023-05-18,04:00:00,8,5,3,FMN 18 Binnensingel Westkant
665,Uitbreidingstraat 390,2023-05-18,05:00:00,14,11,3,FMN 18 Binnensingel Westkant
665,Uitbreidingstraat 390,2023-05-18,06:00:00,17,14,3,FMN 18 Binnensingel Westkant
665,Uitbreidingstraat 390,2023-05-18,07:00:00,7,5,2,FMN 18 Binnensingel Westkant
665,Uitbreidingstraat 390,2023-05-18,08:00:00,25,20,5,FMN 18 Binnensingel Westkant
665,Uitbreidingstraat 390,2023-05-18,09:00:00,34,32,2,FMN 18 Binnensingel Westkant
665,Uitbreidingstraat 390,2023-05-18,10:00:00,56,33,23,FMN 18 Binnensingel Westkant
665,Uitbreidingstraat 390,2023-05-18,11:00:00,56,38,18,FMN 18 Binnensingel Westkant
665,Uitbreidingstraat 390,2023-05-18,12:00:00,84,59,25,FMN 18 Binnensingel Westkant
665,Uitbreidingstraat 390,2023-05-18,13:00:00,94,62,32,FMN 18 Binnensingel Westkant
665,Uitbreidingstraat 390,2023-05-18,14:00:00,106,78,28,FMN 18 Binnensingel Westkant
665,Uitbreidingstraat 390,2023-05-18,15:00:00,101,80,21,FMN 18 Binnensingel Westkant
665,Uitbreidingstraat 390,2023-05-18,16:00:00,82,66,16,FMN 18 Binnensingel Westkant
665,Uitbreidingstraat 390,2023-05-18,17:00:00,92,65,27,FMN 18 Binnensingel Westkant
665,Uitbreidingstraat 390,2023-05-18,18:00:00,85,61,24,FMN 18 Binnensingel Westkant
665,Uitbreidingstraat 390,2023-05-18,19:00:00,65,48,17,FMN 18 Binnensingel Westkant
665,Uitbreidingstraat 390,2023-05-18,20:00:00,69,52,17,FMN 18 Binnensingel Westkant
665,Uitbreidingstraat 390,2023-05-18,21:00:00,47,42,5,FMN 18 Binnensingel Westkant
665,Uitbreidingstraat 390,2023-05-18,22:00:00,45,39,6,FMN 18 Binnensingel Westkant
665,Uitbreidingstraat 390,2023-05-18,23:00:00,60,51,9,FMN 18 Binnensingel Westkant
665,Uitbreidingstraat 390,2023-05-19,00:00:00,29,26,3,FMN 18 Binnensingel Westkant
665,Uitbreidingstraat 390,2023-05-19,01:00:00,28,23,5,FMN 18 Binnensingel Westkant
665,Uitbreidingstraat 390,2023-05-19,02:00:00,4,3,1,FMN 18 Binnensingel Westkant
665,Uitbreidingstraat 390,2023-05-19,03:00:00,5,5,0,FMN 18 Binnensingel Westkant
665,Uitbreidingstraat 390,2023-05-19,04:00:00,18,18,0,FMN 18 Binnensingel Westkant
665,Uitbreidingstraat 390,2023-05-19,05:00:00,23,21,2,FMN 18 Binnensingel Westkant
665,Uitbreidingstraat 390,2023-05-19,06:00:00,33,30,3,FMN 18 Binnensingel Westkant
665,Uitbreidingstraat 390,2023-05-19,07:00:00,53,44,9,FMN 18 Binnensingel Westkant
665,Uitbreidingstraat 390,2023-05-19,08:00:00,72,57,15,FMN 18 Binnensingel Westkant
665,Uitbreidingstraat 390,2023-05-19,09:00:00,65,52,13,FMN 18 Binnensingel Westkant
665,Uitbreidingstraat 390,2023-05-19,10:00:00,64,47,17,FMN 18 Binnensingel Westkant
665,Uitbreidingstraat 390,2023-05-19,11:00:00,83,53,30,FMN 18 Binnensingel Westkant
665,Uitbreidingstraat 390,2023-05-19,12:00:00,98,78,20,FMN 18 Binnensingel Westkant
665,Uitbreidingstraat 390,2023-05-19,13:00:00,79,57,22,FMN 18 Binnensingel Westkant
665,Uitbreidingstraat 390,2023-05-19,14:00:00,107,77,30,FMN 18 Binnensingel Westkant
665,Uitbreidingstraat 390,2023-05-19,15:00:00,121,79,42,FMN 18 Binnensingel Westkant
665,Uitbreidingstraat 390,2023-05-19,16:00:00,79,55,24,FMN 18 Binnensingel Westkant
665,Uitbreidingstraat 390,2023-05-19,17:00:00,150,101,49,FMN 18 Binnensingel Westkant
665,Uitbreidingstraat 390,2023-05-19,18:00:00,125,82,43,FMN 18 Binnensingel Westkant
665,Uitbreidingstraat 390,2023-05-19,19:00:00,112,81,31,FMN 18 Binnensingel Westkant
665,Uitbreidingstraat 390,2023-05-19,20:00:00,88,62,26,FMN 18 Binnensingel Westkant
665,Uitbreidingstraat 390,2023-05-19,21:00:00,52,36,16,FMN 18 Binnensingel Westkant
665,Uitbreidingstraat 390,2023-05-19,22:00:00,56,39,17,FMN 18 Binnensingel Westkant
665,Uitbreidingstraat 390,2023-05-19,23:00:00,58,43,15,FMN 18 Binnensingel Westkant
665,Uitbreidingstraat 390,2023-05-20,00:00:00,41,35,6,FMN 18 Binnensingel Westkant
665,Uitbreidingstraat 390,2023-05-20,01:00:00,29,21,8,FMN 18 Binnensingel Westkant
665,Uitbreidingstraat 390,2023-05-20,02:00:00,17,14,3,FMN 18 Binnensingel Westkant
665,Uitbreidingstraat 390,2023-05-20,03:00:00,11,10,1,FMN 18 Binnensingel Westkant
665,Uitbreidingstraat 390,2023-05-20,04:00:00,13,13,0,FMN 18 Binnensingel Westkant
665,Uitbreidingstraat 390,2023-05-20,05:00:00,13,9,4,FMN 18 Binnensingel Westkant
665,Uitbreidingstraat 390,2023-05-20,06:00:00,28,22,6,FMN 18 Binnensingel Westkant
665,Uitbreidingstraat 390,2023-05-20,07:00:00,19,14,5,FMN 18 Binnensingel Westkant
665,Uitbreidingstraat 390,2023-05-20,08:00:00,36,26,10,FMN 18 Binnensingel Westkant
665,Uitbreidingstraat 390,2023-05-20,09:00:00,71,53,18,FMN 18 Binnensingel Westkant
665,Uitbreidingstraat 390,2023-05-20,10:00:00,74,56,18,FMN 18 Binnensingel Westkant
665,Uitbreidingstraat 390,2023-05-20,11:00:00,100,61,39,FMN 18 Binnensingel Westkant
665,Uitbreidingstraat 390,2023-05-20,12:00:00,91,69,22,FMN 18 Binnensingel Westkant
665,Uitbreidingstraat 390,2023-05-20,13:00:00,77,65,12,FMN 18 Binnensingel Westkant
665,Uitbreidingstraat 390,2023-05-20,14:00:00,103,83,20,FMN 18 Binnensingel Westkant
665,Uitbreidingstraat 390,2023-05-20,15:00:00,84,61,23,FMN 18 Binnensingel Westkant
665,Uitbreidingstraat 390,2023-05-20,16:00:00,107,82,25,FMN 18 Binnensingel Westkant
665,Uitbreidingstraat 390,2023-05-20,17:00:00,94,67,27,FMN 18 Binnensingel Westkant
665,Uitbreidingstraat 390,2023-05-20,18:00:00,86,67,19,FMN 18 Binnensingel Westkant
665,Uitbreidingstraat 390,2023-05-20,19:00:00,74,62,12,FMN 18 Binnensingel Westkant
665,Uitbreidingstraat 390,2023-05-20,20:00:00,70,53,17,FMN 18 Binnensingel Westkant
665,Uitbreidingstraat 390,2023-05-20,21:00:00,48,40,8,FMN 18 Binnensingel Westkant
665,Uitbreidingstraat 390,2023-05-20,22:00:00,55,48,7,FMN 18 Binnensingel Westkant
665,Uitbreidingstraat 390,2023-05-20,23:00:00,65,54,11,FMN 18 Binnensingel Westkant
665,Uitbreidingstraat 390,2023-05-21,00:00:00,53,36,17,FMN 18 Binnensingel Westkant
665,Uitbreidingstraat 390,2023-05-21,01:00:00,27,22,5,FMN 18 Binnensingel Westkant
665,Uitbreidingstraat 390,2023-05-21,02:00:00,19,12,7,FMN 18 Binnensingel Westkant
665,Uitbreidingstraat 390,2023-05-21,03:00:00,13,12,1,FMN 18 Binnensingel Westkant
665,Uitbreidingstraat 390,2023-05-21,04:00:00,24,20,4,FMN 18 Binnensingel Westkant
665,Uitbreidingstraat 390,2023-05-21,05:00:00,14,13,1,FMN 18 Binnensingel Westkant
665,Uitbreidingstraat 390,2023-05-21,06:00:00,21,18,3,FMN 18 Binnensingel Westkant
665,Uitbreidingstraat 390,2023-05-21,07:00:00,15,14,1,FMN 18 Binnensingel Westkant
665,Uitbreidingstraat 390,2023-05-21,08:00:00,24,18,6,FMN 18 Binnensingel Westkant
665,Uitbreidingstraat 390,2023-05-21,09:00:00,55,36,19,FMN 18 Binnensingel Westkant
665,Uitbreidingstraat 390,2023-05-21,10:00:00,67,42,25,FMN 18 Binnensingel Westkant
665,Uitbreidingstraat 390,2023-05-21,11:00:00,75,59,16,FMN 18 Binnensingel Westkant
665,Uitbreidingstraat 390,2023-05-21,12:00:00,76,57,19,FMN 18 Binnensingel Westkant
665,Uitbreidingstraat 390,2023-05-21,13:00:00,107,83,24,FMN 18 Binnensingel Westkant
665,Uitbreidingstraat 390,2023-05-21,14:00:00,95,67,28,FMN 18 Binnensingel Westkant
665,Uitbreidingstraat 390,2023-05-21,15:00:00,92,68,24,FMN 18 Binnensingel Westkant
665,Uitbreidingstraat 390,2023-05-21,16:00:00,96,72,24,FMN 18 Binnensingel Westkant
665,Uitbreidingstraat 390,2023-05-21,17:00:00,97,87,10,FMN 18 Binnensingel Westkant
665,Uitbreidingstraat 390,2023-05-21,18:00:00,104,87,17,FMN 18 Binnensingel Westkant
665,Uitbreidingstraat 390,2023-05-21,19:00:00,75,63,12,FMN 18 Binnensingel Westkant
665,Uitbreidingstraat 390,2023-05-21,20:00:00,72,51,21,FMN 18 Binnensingel Westkant
665,Uitbreidingstraat 390,2023-05-21,21:00:00,74,51,23,FMN 18 Binnensingel Westkant
665,Uitbreidingstraat 390,2023-05-21,22:00:00,39,33,6,FMN 18 Binnensingel Westkant
665,Uitbreidingstraat 390,2023-05-21,23:00:00,22,20,2,FMN 18 Binnensingel Westkant
665,Uitbreidingstraat 390,2023-05-22,00:00:00,11,9,2,FMN 18 Binnensingel Westkant
665,Uitbreidingstraat 390,2023-05-22,01:00:00,10,5,5,FMN 18 Binnensingel Westkant
665,Uitbreidingstraat 390,2023-05-22,02:00:00,4,3,1,FMN 18 Binnensingel Westkant
665,Uitbreidingstraat 390,2023-05-22,03:00:00,3,3,0,FMN 18 Binnensingel Westkant
665,Uitbreidingstraat 390,2023-05-22,04:00:00,12,9,3,FMN 18 Binnensingel Westkant
665,Uitbreidingstraat 390,2023-05-22,05:00:00,30,26,4,FMN 18 Binnensingel Westkant
665,Uitbreidingstraat 390,2023-05-22,06:00:00,72,58,14,FMN 18 Binnensingel Westkant
665,Uitbreidingstraat 390,2023-05-22,07:00:00,242,207,35,FMN 18 Binnensingel Westkant
665,Uitbreidingstraat 390,2023-05-22,08:00:00,424,360,64,FMN 18 Binnensingel Westkant
665,Uitbreidingstraat 390,2023-05-22,09:00:00,161,143,18,FMN 18 Binnensingel Westkant
665,Uitbreidingstraat 390,2023-05-22,10:00:00,107,91,16,FMN 18 Binnensingel Westkant
665,Uitbreidingstraat 390,2023-05-22,11:00:00,64,45,19,FMN 18 Binnensingel Westkant
665,Uitbreidingstraat 390,2023-05-22,12:00:00,132,93,39,FMN 18 Binnensingel Westkant
665,Uitbreidingstraat 390,2023-05-22,13:00:00,121,88,33,FMN 18 Binnensingel Westkant
665,Uitbreidingstraat 390,2023-05-22,14:00:00,114,77,37,FMN 18 Binnensingel Westkant
665,Uitbreidingstraat 390,2023-05-22,15:00:00,211,107,104,FMN 18 Binnensingel Westkant
665,Uitbreidingstraat 390,2023-05-22,16:00:00,329,132,197,FMN 18 Binnensingel Westkant
665,Uitbreidingstraat 390,2023-05-22,17:00:00,310,155,155,FMN 18 Binnensingel Westkant
665,Uitbreidingstraat 390,2023-05-22,18:00:00,219,152,67,FMN 18 Binnensingel Westkant
665,Uitbreidingstraat 390,2023-05-22,19:00:00,105,73,32,FMN 18 Binnensingel Westkant
665,Uitbreidingstraat 390,2023-05-22,20:00:00,99,64,35,FMN 18 Binnensingel Westkant
665,Uitbreidingstraat 390,2023-05-22,21:00:00,61,34,27,FMN 18 Binnensingel Westkant
665,Uitbreidingstraat 390,2023-05-22,22:00:00,53,35,18,FMN 18 Binnensingel Westkant
665,Uitbreidingstraat 390,2023-05-22,23:00:00,28,17,11,FMN 18 Binnensingel Westkant
665,Uitbreidingstraat 390,2023-05-23,00:00:00,12,10,2,FMN 18 Binnensingel Westkant
665,Uitbreidingstraat 390,2023-05-23,01:00:00,7,7,0,FMN 18 Binnensingel Westkant
665,Uitbreidingstraat 390,2023-05-23,02:00:00,3,2,1,FMN 18 Binnensingel Westkant
665,Uitbreidingstraat 390,2023-05-23,03:00:00,3,3,0,FMN 18 Binnensingel Westkant
665,Uitbreidingstraat 390,2023-05-23,04:00:00,15,10,5,FMN 18 Binnensingel Westkant
665,Uitbreidingstraat 390,2023-05-23,05:00:00,34,32,2,FMN 18 Binnensingel Westkant
665,Uitbreidingstraat 390,2023-05-23,06:00:00,63,46,17,FMN 18 Binnensingel Westkant
665,Uitbreidingstraat 390,2023-05-23,07:00:00,216,183,33,FMN 18 Binnensingel Westkant
665,Uitbreidingstraat 390,2023-05-23,08:00:00,474,401,73,FMN 18 Binnensingel Westkant
665,Uitbreidingstraat 390,2023-05-23,09:00:00,191,159,32,FMN 18 Binnensingel Westkant
665,Uitbreidingstraat 390,2023-05-23,10:00:00,111,83,28,FMN 18 Binnensingel Westkant
665,Uitbreidingstraat 390,2023-05-23,11:00:00,76,46,30,FMN 18 Binnensingel Westkant
665,Uitbreidingstraat 390,2023-05-23,12:00:00,126,92,34,FMN 18 Binnensingel Westkant
665,Uitbreidingstraat 390,2023-05-23,13:00:00,126,100,26,FMN 18 Binnensingel Westkant
665,Uitbreidingstraat 390,2023-05-23,14:00:00,111,62,49,FMN 18 Binnensingel Westkant
665,Uitbreidingstraat 390,2023-05-23,15:00:00,184,94,90,FMN 18 Binnensingel Westkant
665,Uitbreidingstraat 390,2023-05-23,16:00:00,334,147,187,FMN 18 Binnensingel Westkant
665,Uitbreidingstraat 390,2023-05-23,17:00:00,329,175,154,FMN 18 Binnensingel Westkant
665,Uitbreidingstraat 390,2023-05-23,18:00:00,210,130,80,FMN 18 Binnensingel Westkant
665,Uitbreidingstraat 390,2023-05-23,19:00:00,118,83,35,FMN 18 Binnensingel Westkant
665,Uitbreidingstraat 390,2023-05-23,20:00:00,58,43,15,FMN 18 Binnensingel Westkant
665,Uitbreidingstraat 390,2023-05-23,21:00:00,91,56,35,FMN 18 Binnensingel Westkant
665,Uitbreidingstraat 390,2023-05-23,22:00:00,57,36,21,FMN 18 Binnensingel Westkant
665,Uitbreidingstraat 390,2023-05-23,23:00:00,27,24,3,FMN 18 Binnensingel Westkant
665,Uitbreidingstraat 390,2023-05-24,00:00:00,10,9,1,FMN 18 Binnensingel Westkant
665,Uitbreidingstraat 390,2023-05-24,01:00:00,5,3,2,FMN 18 Binnensingel Westkant
665,Uitbreidingstraat 390,2023-05-24,02:00:00,2,2,0,FMN 18 Binnensingel Westkant
665,Uitbreidingstraat 390,2023-05-24,03:00:00,4,3,1,FMN 18 Binnensingel Westkant
665,Uitbreidingstraat 390,2023-05-24,04:00:00,12,9,3,FMN 18 Binnensingel Westkant
665,Uitbreidingstraat 390,2023-05-24,05:00:00,27,24,3,FMN 18 Binnensingel Westkant
665,Uitbreidingstraat 390,2023-05-24,06:00:00,63,52,11,FMN 18 Binnensingel Westkant
665,Uitbreidingstraat 390,2023-05-24,07:00:00,193,161,32,FMN 18 Binnensingel Westkant
665,Uitbreidingstraat 390,2023-05-24,08:00:00,402,337,65,FMN 18 Binnensingel Westkant
665,Uitbreidingstraat 390,2023-05-24,09:00:00,138,115,23,FMN 18 Binnensingel Westkant
665,Uitbreidingstraat 390,2023-05-24,10:00:00,86,70,16,FMN 18 Binnensingel Westkant
665,Uitbreidingstraat 390,2023-05-24,11:00:00,81,47,34,FMN 18 Binnensingel Westkant
665,Uitbreidingstraat 390,2023-05-24,12:00:00,237,109,128,FMN 18 Binnensingel Westkant
665,Uitbreidingstraat 390,2023-05-24,13:00:00,210,106,104,FMN 18 Binnensingel Westkant
665,Uitbreidingstraat 390,2023-05-24,14:00:00,99,64,35,FMN 18 Binnensingel Westkant
665,Uitbreidingstraat 390,2023-05-24,15:00:00,157,95,62,FMN 18 Binnensingel Westkant
665,Uitbreidingstraat 390,2023-05-24,16:00:00,190,112,78,FMN 18 Binnensingel Westkant
665,Uitbreidingstraat 390,2023-05-24,17:00:00,248,150,98,FMN 18 Binnensingel Westkant
665,Uitbreidingstraat 390,2023-05-24,18:00:00,207,145,62,FMN 18 Binnensingel Westkant
665,Uitbreidingstraat 390,2023-05-24,19:00:00,112,70,42,FMN 18 Binnensingel Westkant
665,Uitbreidingstraat 390,2023-05-24,20:00:00,91,55,36,FMN 18 Binnensingel Westkant
665,Uitbreidingstraat 390,2023-05-24,21:00:00,62,34,28,FMN 18 Binnensingel Westkant
665,Uitbreidingstraat 390,2023-05-24,22:00:00,84,47,37,FMN 18 Binnensingel Westkant
665,Uitbreidingstraat 390,2023-05-24,23:00:00,42,34,8,FMN 18 Binnensingel Westkant
665,Uitbreidingstraat 390,2023-05-25,00:00:00,19,16,3,FMN 18 Binnensingel Westkant
665,Uitbreidingstraat 390,2023-05-25,01:00:00,6,3,3,FMN 18 Binnensingel Westkant
665,Uitbreidingstraat 390,2023-05-25,02:00:00,1,1,0,FMN 18 Binnensingel Westkant
665,Uitbreidingstraat 390,2023-05-25,03:00:00,2,2,0,FMN 18 Binnensingel Westkant
665,Uitbreidingstraat 390,2023-05-25,04:00:00,11,11,0,FMN 18 Binnensingel Westkant
665,Uitbreidingstraat 390,2023-05-25,05:00:00,24,23,1,FMN 18 Binnensingel Westkant
665,Uitbreidingstraat 390,2023-05-25,06:00:00,59,41,18,FMN 18 Binnensingel Westkant
665,Uitbreidingstraat 390,2023-05-25,07:00:00,223,182,41,FMN 18 Binnensingel Westkant
665,Uitbreidingstraat 390,2023-05-25,08:00:00,412,341,71,FMN 18 Binnensingel Westkant
665,Uitbreidingstraat 390,2023-05-25,09:00:00,172,151,21,FMN 18 Binnensingel Westkant
665,Uitbreidingstraat 390,2023-05-25,10:00:00,113,97,16,FMN 18 Binnensingel Westkant
665,Uitbreidingstraat 390,2023-05-25,11:00:00,95,66,29,FMN 18 Binnensingel Westkant
665,Uitbreidingstraat 390,2023-05-25,12:00:00,139,97,42,FMN 18 Binnensingel Westkant
665,Uitbreidingstraat 390,2023-05-25,13:00:00,140,108,32,FMN 18 Binnensingel Westkant
665,Uitbreidingstraat 390,2023-05-25,14:00:00,94,55,39,FMN 18 Binnensingel Westkant
665,Uitbreidingstraat 390,2023-05-25,15:00:00,203,102,101,FMN 18 Binnensingel Westkant
665,Uitbreidingstraat 390,2023-05-25,16:00:00,353,142,211,FMN 18 Binnensingel Westkant
665,Uitbreidingstraat 390,2023-05-25,17:00:00,288,153,135,FMN 18 Binnensingel Westkant
665,Uitbreidingstraat 390,2023-05-25,18:00:00,210,144,66,FMN 18 Binnensingel Westkant
665,Uitbreidingstraat 390,2023-05-25,19:00:00,160,103,57,FMN 18 Binnensingel Westkant
665,Uitbreidingstraat 390,2023-05-25,20:00:00,109,62,47,FMN 18 Binnensingel Westkant
665,Uitbreidingstraat 390,2023-05-25,21:00:00,75,53,22,FMN 18 Binnensingel Westkant
665,Uitbreidingstraat 390,2023-05-25,22:00:00,60,45,15,FMN 18 Binnensingel Westkant
665,Uitbreidingstraat 390,2023-05-25,23:00:00,60,51,9,FMN 18 Binnensingel Westkant
665,Uitbreidingstraat 390,2023-05-26,00:00:00,16,14,2,FMN 18 Binnensingel Westkant
665,Uitbreidingstraat 390,2023-05-26,01:00:00,12,9,3,FMN 18 Binnensingel Westkant
665,Uitbreidingstraat 390,2023-05-26,02:00:00,4,3,1,FMN 18 Binnensingel Westkant
665,Uitbreidingstraat 390,2023-05-26,03:00:00,5,4,1,FMN 18 Binnensingel Westkant
665,Uitbreidingstraat 390,2023-05-26,04:00:00,14,10,4,FMN 18 Binnensingel Westkant
665,Uitbreidingstraat 390,2023-05-26,05:00:00,22,21,1,FMN 18 Binnensingel Westkant
665,Uitbreidingstraat 390,2023-05-26,06:00:00,48,40,8,FMN 18 Binnensingel Westkant
665,Uitbreidingstraat 390,2023-05-26,07:00:00,171,141,30,FMN 18 Binnensingel Westkant
665,Uitbreidingstraat 390,2023-05-26,08:00:00,346,295,51,FMN 18 Binnensingel Westkant
665,Uitbreidingstraat 390,2023-05-26,09:00:00,127,107,20,FMN 18 Binnensingel Westkant
665,Uitbreidingstraat 390,2023-05-26,10:00:00,128,107,21,FMN 18 Binnensingel Westkant
665,Uitbreidingstraat 390,2023-05-26,11:00:00,77,57,20,FMN 18 Binnensingel Westkant
665,Uitbreidingstraat 390,2023-05-26,12:00:00,141,102,39,FMN 18 Binnensingel Westkant
665,Uitbreidingstraat 390,2023-05-26,13:00:00,129,95,34,FMN 18 Binnensingel Westkant
665,Uitbreidingstraat 390,2023-05-26,14:00:00,143,87,56,FMN 18 Binnensingel Westkant
665,Uitbreidingstraat 390,2023-05-26,15:00:00,203,103,100,FMN 18 Binnensingel Westkant
665,Uitbreidingstraat 390,2023-05-26,16:00:00,300,122,178,FMN 18 Binnensingel Westkant
665,Uitbreidingstraat 390,2023-05-26,17:00:00,238,139,99,FMN 18 Binnensingel Westkant
665,Uitbreidingstraat 390,2023-05-26,18:00:00,202,140,62,FMN 18 Binnensingel Westkant
665,Uitbreidingstraat 390,2023-05-26,19:00:00,109,77,32,FMN 18 Binnensingel Westkant
665,Uitbreidingstraat 390,2023-05-26,20:00:00,100,66,34,FMN 18 Binnensingel Westkant
665,Uitbreidingstraat 390,2023-05-26,21:00:00,67,46,21,FMN 18 Binnensingel Westkant
665,Uitbreidingstraat 390,2023-05-26,22:00:00,67,37,30,FMN 18 Binnensingel Westkant
665,Uitbreidingstraat 390,2023-05-26,23:00:00,69,54,15,FMN 18 Binnensingel Westkant
665,Uitbreidingstraat 390,2023-05-27,00:00:00,42,34,8,FMN 18 Binnensingel Westkant
665,Uitbreidingstraat 390,2023-05-27,01:00:00,26,19,7,FMN 18 Binnensingel Westkant
665,Uitbreidingstraat 390,2023-05-27,02:00:00,15,11,4,FMN 18 Binnensingel Westkant
665,Uitbreidingstraat 390,2023-05-27,03:00:00,10,7,3,FMN 18 Binnensingel Westkant
665,Uitbreidingstraat 390,2023-05-27,04:00:00,9,6,3,FMN 18 Binnensingel Westkant
665,Uitbreidingstraat 390,2023-05-27,05:00:00,16,13,3,FMN 18 Binnensingel Westkant
665,Uitbreidingstraat 390,2023-05-27,06:00:00,24,20,4,FMN 18 Binnensingel Westkant
665,Uitbreidingstraat 390,2023-05-27,07:00:00,22,20,2,FMN 18 Binnensingel Westkant
665,Uitbreidingstraat 390,2023-05-27,08:00:00,45,33,12,FMN 18 Binnensingel Westkant
665,Uitbreidingstraat 390,2023-05-27,09:00:00,89,65,24,FMN 18 Binnensingel Westkant
665,Uitbreidingstraat 390,2023-05-27,10:00:00,107,81,26,FMN 18 Binnensingel Westkant
665,Uitbreidingstraat 390,2023-05-27,11:00:00,98,66,32,FMN 18 Binnensingel Westkant
665,Uitbreidingstraat 390,2023-05-27,12:00:00,112,80,32,FMN 18 Binnensingel Westkant
665,Uitbreidingstraat 390,2023-05-27,13:00:00,128,84,44,FMN 18 Binnensingel Westkant
665,Uitbreidingstraat 390,2023-05-27,14:00:00,122,98,24,FMN 18 Binnensingel Westkant
665,Uitbreidingstraat 390,2023-05-27,15:00:00,105,71,34,FMN 18 Binnensingel Westkant
665,Uitbreidingstraat 390,2023-05-27,16:00:00,111,86,25,FMN 18 Binnensingel Westkant
665,Uitbreidingstraat 390,2023-05-27,17:00:00,138,92,46,FMN 18 Binnensingel Westkant
665,Uitbreidingstraat 390,2023-05-27,18:00:00,105,72,33,FMN 18 Binnensingel Westkant
665,Uitbreidingstraat 390,2023-05-27,19:00:00,105,78,27,FMN 18 Binnensingel Westkant
665,Uitbreidingstraat 390,2023-05-27,20:00:00,70,46,24,FMN 18 Binnensingel Westkant
665,Uitbreidingstraat 390,2023-05-27,21:00:00,66,55,11,FMN 18 Binnensingel Westkant
665,Uitbreidingstraat 390,2023-05-27,22:00:00,81,56,25,FMN 18 Binnensingel Westkant
665,Uitbreidingstraat 390,2023-05-27,23:00:00,80,60,20,FMN 18 Binnensingel Westkant
665,Uitbreidingstraat 390,2023-05-28,00:00:00,65,47,18,FMN 18 Binnensingel Westkant
665,Uitbreidingstraat 390,2023-05-28,01:00:00,42,33,9,FMN 18 Binnensingel Westkant
665,Uitbreidingstraat 390,2023-05-28,02:00:00,16,14,2,FMN 18 Binnensingel Westkant
665,Uitbreidingstraat 390,2023-05-28,03:00:00,9,9,0,FMN 18 Binnensingel Westkant
665,Uitbreidingstraat 390,2023-05-28,04:00:00,5,5,0,FMN 18 Binnensingel Westkant
665,Uitbreidingstraat 390,2023-05-28,05:00:00,4,4,0,FMN 18 Binnensingel Westkant
665,Uitbreidingstraat 390,2023-05-28,06:00:00,17,17,0,FMN 18 Binnensingel Westkant
665,Uitbreidingstraat 390,2023-05-28,07:00:00,20,16,4,FMN 18 Binnensingel Westkant
665,Uitbreidingstraat 390,2023-05-28,08:00:00,32,22,10,FMN 18 Binnensingel Westkant
665,Uitbreidingstraat 390,2023-05-28,09:00:00,68,53,15,FMN 18 Binnensingel Westkant
665,Uitbreidingstraat 390,2023-05-28,10:00:00,58,38,20,FMN 18 Binnensingel Westkant
665,Uitbreidingstraat 390,2023-05-28,11:00:00,83,52,31,FMN 18 Binnensingel Westkant
665,Uitbreidingstraat 390,2023-05-28,12:00:00,100,62,38,FMN 18 Binnensingel Westkant
665,Uitbreidingstraat 390,2023-05-28,13:00:00,91,56,35,FMN 18 Binnensingel Westkant
665,Uitbreidingstraat 390,2023-05-28,14:00:00,102,72,30,FMN 18 Binnensingel Westkant
665,Uitbreidingstraat 390,2023-05-28,15:00:00,114,92,22,FMN 18 Binnensingel Westkant
665,Uitbreidingstraat 390,2023-05-28,16:00:00,136,109,27,FMN 18 Binnensingel Westkant
665,Uitbreidingstraat 390,2023-05-28,17:00:00,134,110,24,FMN 18 Binnensingel Westkant
665,Uitbreidingstraat 390,2023-05-28,18:00:00,99,71,28,FMN 18 Binnensingel Westkant
665,Uitbreidingstraat 390,2023-05-28,19:00:00,83,66,17,FMN 18 Binnensingel Westkant
665,Uitbreidingstraat 390,2023-05-28,20:00:00,88,71,17,FMN 18 Binnensingel Westkant
665,Uitbreidingstraat 390,2023-05-28,21:00:00,72,57,15,FMN 18 Binnensingel Westkant
665,Uitbreidingstraat 390,2023-05-28,22:00:00,88,80,8,FMN 18 Binnensingel Westkant
665,Uitbreidingstraat 390,2023-05-28,23:00:00,69,56,13,FMN 18 Binnensingel Westkant
665,Uitbreidingstraat 390,2023-05-29,00:00:00,43,28,15,FMN 18 Binnensingel Westkant
665,Uitbreidingstraat 390,2023-05-29,01:00:00,24,22,2,FMN 18 Binnensingel Westkant
665,Uitbreidingstraat 390,2023-05-29,02:00:00,8,8,0,FMN 18 Binnensingel Westkant
665,Uitbreidingstraat 390,2023-05-29,03:00:00,7,6,1,FMN 18 Binnensingel Westkant
665,Uitbreidingstraat 390,2023-05-29,04:00:00,5,5,0,FMN 18 Binnensingel Westkant
665,Uitbreidingstraat 390,2023-05-29,05:00:00,10,9,1,FMN 18 Binnensingel Westkant
665,Uitbreidingstraat 390,2023-05-29,06:00:00,20,18,2,FMN 18 Binnensingel Westkant
665,Uitbreidingstraat 390,2023-05-29,07:00:00,12,10,2,FMN 18 Binnensingel Westkant
665,Uitbreidingstraat 390,2023-05-29,08:00:00,26,22,4,FMN 18 Binnensingel Westkant
665,Uitbreidingstraat 390,2023-05-29,09:00:00,32,22,10,FMN 18 Binnensingel Westkant
665,Uitbreidingstraat 390,2023-05-29,10:00:00,53,44,9,FMN 18 Binnensingel Westkant
665,Uitbreidingstraat 390,2023-05-29,11:00:00,73,55,18,FMN 18 Binnensingel Westkant
665,Uitbreidingstraat 390,2023-05-29,12:00:00,66,45,21,FMN 18 Binnensingel Westkant
665,Uitbreidingstraat 390,2023-05-29,13:00:00,109,83,26,FMN 18 Binnensingel Westkant
665,Uitbreidingstraat 390,2023-05-29,14:00:00,123,101,22,FMN 18 Binnensingel Westkant
665,Uitbreidingstraat 390,2023-05-29,15:00:00,95,60,35,FMN 18 Binnensingel Westkant
665,Uitbreidingstraat 390,2023-05-29,16:00:00,101,67,34,FMN 18 Binnensingel Westkant
665,Uitbreidingstraat 390,2023-05-29,17:00:00,127,100,27,FMN 18 Binnensingel Westkant
665,Uitbreidingstraat 390,2023-05-29,18:00:00,99,82,17,FMN 18 Binnensingel Westkant
665,Uitbreidingstraat 390,2023-05-29,19:00:00,100,75,25,FMN 18 Binnensingel Westkant
665,Uitbreidingstraat 390,2023-05-29,20:00:00,72,50,22,FMN 18 Binnensingel Westkant
665,Uitbreidingstraat 390,2023-05-29,21:00:00,74,60,14,FMN 18 Binnensingel Westkant
665,Uitbreidingstraat 390,2023-05-29,22:00:00,48,39,9,FMN 18 Binnensingel Westkant
665,Uitbreidingstraat 390,2023-05-29,23:00:00,46,39,7,FMN 18 Binnensingel Westkant
665,Uitbreidingstraat 390,2023-05-30,00:00:00,12,11,1,FMN 18 Binnensingel Westkant
665,Uitbreidingstraat 390,2023-05-30,01:00:00,4,2,2,FMN 18 Binnensingel Westkant
665,Uitbreidingstraat 390,2023-05-30,02:00:00,3,2,1,FMN 18 Binnensingel Westkant
665,Uitbreidingstraat 390,2023-05-30,03:00:00,5,4,1,FMN 18 Binnensingel Westkant
665,Uitbreidingstraat 390,2023-05-30,04:00:00,10,7,3,FMN 18 Binnensingel Westkant
665,Uitbreidingstraat 390,2023-05-30,05:00:00,30,26,4,FMN 18 Binnensingel Westkant
665,Uitbreidingstraat 390,2023-05-30,06:00:00,64,49,15,FMN 18 Binnensingel Westkant
665,Uitbreidingstraat 390,2023-05-30,07:00:00,220,184,36,FMN 18 Binnensingel Westkant
665,Uitbreidingstraat 390,2023-05-30,08:00:00,401,338,63,FMN 18 Binnensingel Westkant
665,Uitbreidingstraat 390,2023-05-30,09:00:00,197,161,36,FMN 18 Binnensingel Westkant
665,Uitbreidingstraat 390,2023-05-30,10:00:00,89,72,17,FMN 18 Binnensingel Westkant
665,Uitbreidingstraat 390,2023-05-30,11:00:00,98,64,34,FMN 18 Binnensingel Westkant
665,Uitbreidingstraat 390,2023-05-30,12:00:00,127,79,48,FMN 18 Binnensingel Westkant
665,Uitbreidingstraat 390,2023-05-30,13:00:00,111,86,25,FMN 18 Binnensingel Westkant
665,Uitbreidingstraat 390,2023-05-30,14:00:00,116,74,42,FMN 18 Binnensingel Westkant
665,Uitbreidingstraat 390,2023-05-30,15:00:00,196,96,100,FMN 18 Binnensingel Westkant
665,Uitbreidingstraat 390,2023-05-30,16:00:00,316,127,189,FMN 18 Binnensingel Westkant
665,Uitbreidingstraat 390,2023-05-30,17:00:00,283,154,129,FMN 18 Binnensingel Westkant
665,Uitbreidingstraat 390,2023-05-30,18:00:00,241,171,70,FMN 18 Binnensingel Westkant
665,Uitbreidingstraat 390,2023-05-30,19:00:00,128,78,50,FMN 18 Binnensingel Westkant
665,Uitbreidingstraat 390,2023-05-30,20:00:00,97,68,29,FMN 18 Binnensingel Westkant
665,Uitbreidingstraat 390,2023-05-30,21:00:00,81,64,17,FMN 18 Binnensingel Westkant
665,Uitbreidingstraat 390,2023-05-30,22:00:00,74,48,26,FMN 18 Binnensingel Westkant
665,Uitbreidingstraat 390,2023-05-30,23:00:00,36,27,9,FMN 18 Binnensingel Westkant
665,Uitbreidingstraat 390,2023-05-31,00:00:00,11,9,2,FMN 18 Binnensingel Westkant
665,Uitbreidingstraat 390,2023-05-31,01:00:00,10,8,2,FMN 18 Binnensingel Westkant
665,Uitbreidingstraat 390,2023-05-31,02:00:00,3,2,1,FMN 18 Binnensingel Westkant
665,Uitbreidingstraat 390,2023-05-31,03:00:00,3,3,0,FMN 18 Binnensingel Westkant
665,Uitbreidingstraat 390,2023-05-31,04:00:00,8,6,2,FMN 18 Binnensingel Westkant
665,Uitbreidingstraat 390,2023-05-31,05:00:00,30,26,4,FMN 18 Binnensingel Westkant
665,Uitbreidingstraat 390,2023-05-31,06:00:00,72,57,15,FMN 18 Binnensingel Westkant
665,Uitbreidingstraat 390,2023-05-31,07:00:00,205,170,35,FMN 18 Binnensingel Westkant
665,Uitbreidingstraat 390,2023-05-31,08:00:00,387,329,58,FMN 18 Binnensingel Westkant
665,Uitbreidingstraat 390,2023-05-31,09:00:00,143,117,26,FMN 18 Binnensingel Westkant
665,Uitbreidingstraat 390,2023-05-31,10:00:00,105,83,22,FMN 18 Binnensingel Westkant
665,Uitbreidingstraat 390,2023-05-31,11:00:00,106,64,42,FMN 18 Binnensingel Westkant
665,Uitbreidingstraat 390,2023-05-31,12:00:00,257,118,139,FMN 18 Binnensingel Westkant
665,Uitbreidingstraat 390,2023-05-31,13:00:00,189,93,96,FMN 18 Binnensingel Westkant
665,Uitbreidingstraat 390,2023-05-31,14:00:00,136,92,44,FMN 18 Binnensingel Westkant
665,Uitbreidingstraat 390,2023-05-31,15:00:00,140,88,52,FMN 18 Binnensingel Westkant
665,Uitbreidingstraat 390,2023-05-31,16:00:00,197,116,81,FMN 18 Binnensingel Westkant
665,Uitbreidingstraat 390,2023-05-31,17:00:00,261,166,95,FMN 18 Binnensingel Westkant
665,Uitbreidingstraat 390,2023-05-31,18:00:00,232,156,76,FMN 18 Binnensingel Westkant
665,Uitbreidingstraat 390,2023-05-31,19:00:00,156,110,46,FMN 18 Binnensingel Westkant
665,Uitbreidingstraat 390,2023-05-31,20:00:00,116,71,45,FMN 18 Binnensingel Westkant
665,Uitbreidingstraat 390,2023-05-31,21:00:00,102,76,26,FMN 18 Binnensingel Westkant
665,Uitbreidingstraat 390,2023-05-31,22:00:00,71,50,21,FMN 18 Binnensingel Westkant
665,Uitbreidingstraat 390,2023-05-31,23:00:00,62,50,12,FMN 18 Binnensingel Westkant
665,Uitbreidingstraat 390,2023-06-01,00:00:00,23,20,3,FMN 18 Binnensingel Westkant
665,Uitbreidingstraat 390,2023-06-01,01:00:00,7,5,2,FMN 18 Binnensingel Westkant
665,Uitbreidingstraat 390,2023-06-01,02:00:00,1,1,0,FMN 18 Binnensingel Westkant
665,Uitbreidingstraat 390,2023-06-01,03:00:00,3,3,0,FMN 18 Binnensingel Westkant
665,Uitbreidingstraat 390,2023-06-01,04:00:00,5,4,1,FMN 18 Binnensingel Westkant
665,Uitbreidingstraat 390,2023-06-01,05:00:00,28,26,2,FMN 18 Binnensingel Westkant
665,Uitbreidingstraat 390,2023-06-01,06:00:00,60,49,11,FMN 18 Binnensingel Westkant
665,Uitbreidingstraat 390,2023-06-01,07:00:00,232,192,40,FMN 18 Binnensingel Westkant
665,Uitbreidingstraat 390,2023-06-01,08:00:00,408,343,65,FMN 18 Binnensingel Westkant
665,Uitbreidingstraat 390,2023-06-01,09:00:00,180,147,33,FMN 18 Binnensingel Westkant
665,Uitbreidingstraat 390,2023-06-01,10:00:00,91,75,16,FMN 18 Binnensingel Westkant
665,Uitbreidingstraat 390,2023-06-01,11:00:00,90,63,27,FMN 18 Binnensingel Westkant
665,Uitbreidingstraat 390,2023-06-01,12:00:00,134,90,44,FMN 18 Binnensingel Westkant
665,Uitbreidingstraat 390,2023-06-01,13:00:00,137,104,33,FMN 18 Binnensingel Westkant
665,Uitbreidingstraat 390,2023-06-01,14:00:00,119,67,52,FMN 18 Binnensingel Westkant
665,Uitbreidingstraat 390,2023-06-01,15:00:00,218,93,125,FMN 18 Binnensingel Westkant
665,Uitbreidingstraat 390,2023-06-01,16:00:00,298,119,179,FMN 18 Binnensingel Westkant
665,Uitbreidingstraat 390,2023-06-01,17:00:00,293,171,122,FMN 18 Binnensingel Westkant
665,Uitbreidingstraat 390,2023-06-01,18:00:00,225,152,73,FMN 18 Binnensingel Westkant
665,Uitbreidingstraat 390,2023-06-01,19:00:00,154,110,44,FMN 18 Binnensingel Westkant
665,Uitbreidingstraat 390,2023-06-01,20:00:00,96,61,35,FMN 18 Binnensingel Westkant
665,Uitbreidingstraat 390,2023-06-01,21:00:00,64,44,20,FMN 18 Binnensingel Westkant
665,Uitbreidingstraat 390,2023-06-01,22:00:00,79,58,21,FMN 18 Binnensingel Westkant
665,Uitbreidingstraat 390,2023-06-01,23:00:00,55,47,8,FMN 18 Binnensingel Westkant
665,Uitbreidingstraat 390,2023-06-02,00:00:00,17,12,5,FMN 18 Binnensingel Westkant
665,Uitbreidingstraat 390,2023-06-02,01:00:00,17,14,3,FMN 18 Binnensingel Westkant
665,Uitbreidingstraat 390,2023-06-02,02:00:00,0,0,0,FMN 18 Binnensingel Westkant
665,Uitbreidingstraat 390,2023-06-02,03:00:00,9,7,2,FMN 18 Binnensingel Westkant
665,Uitbreidingstraat 390,2023-06-02,04:00:00,6,6,0,FMN 18 Binnensingel Westkant
665,Uitbreidingstraat 390,2023-06-02,05:00:00,35,32,3,FMN 18 Binnensingel Westkant
665,Uitbreidingstraat 390,2023-06-02,06:00:00,53,41,12,FMN 18 Binnensingel Westkant
665,Uitbreidingstraat 390,2023-06-02,07:00:00,171,151,20,FMN 18 Binnensingel Westkant
665,Uitbreidingstraat 390,2023-06-02,08:00:00,354,289,65,FMN 18 Binnensingel Westkant
665,Uitbreidingstraat 390,2023-06-02,09:00:00,145,126,19,FMN 18 Binnensingel Westkant
665,Uitbreidingstraat 390,2023-06-02,10:00:00,96,77,19,FMN 18 Binnensingel Westkant
665,Uitbreidingstraat 390,2023-06-02,11:00:00,76,57,19,FMN 18 Binnensingel Westkant
665,Uitbreidingstraat 390,2023-06-02,12:00:00,132,75,57,FMN 18 Binnensingel Westkant
665,Uitbreidingstraat 390,2023-06-02,13:00:00,106,81,25,FMN 18 Binnensingel Westkant
665,Uitbreidingstraat 390,2023-06-02,14:00:00,140,79,61,FMN 18 Binnensingel Westkant
665,Uitbreidingstraat 390,2023-06-02,15:00:00,166,80,86,FMN 18 Binnensingel Westkant
665,Uitbreidingstraat 390,2023-06-02,16:00:00,345,122,223,FMN 18 Binnensingel Westkant
665,Uitbreidingstraat 390,2023-06-02,17:00:00,230,134,96,FMN 18 Binnensingel Westkant
665,Uitbreidingstraat 390,2023-06-02,18:00:00,260,182,78,FMN 18 Binnensingel Westkant
665,Uitbreidingstraat 390,2023-06-02,19:00:00,174,122,52,FMN 18 Binnensingel Westkant
665,Uitbreidingstraat 390,2023-06-02,20:00:00,102,64,38,FMN 18 Binnensingel Westkant
665,Uitbreidingstraat 390,2023-06-02,21:00:00,89,63,26,FMN 18 Binnensingel Westkant
665,Uitbreidingstraat 390,2023-06-02,22:00:00,78,59,19,FMN 18 Binnensingel Westkant
665,Uitbreidingstraat 390,2023-06-02,23:00:00,72,56,16,FMN 18 Binnensingel Westkant
665,Uitbreidingstraat 390,2023-06-03,00:00:00,58,43,15,FMN 18 Binnensingel Westkant
665,Uitbreidingstraat 390,2023-06-03,01:00:00,36,33,3,FMN 18 Binnensingel Westkant
665,Uitbreidingstraat 390,2023-06-03,02:00:00,11,5,6,FMN 18 Binnensingel Westkant
665,Uitbreidingstraat 390,2023-06-03,03:00:00,11,10,1,FMN 18 Binnensingel Westkant
665,Uitbreidingstraat 390,2023-06-03,04:00:00,16,13,3,FMN 18 Binnensingel Westkant
665,Uitbreidingstraat 390,2023-06-03,05:00:00,16,11,5,FMN 18 Binnensingel Westkant
665,Uitbreidingstraat 390,2023-06-03,06:00:00,36,25,11,FMN 18 Binnensingel Westkant
665,Uitbreidingstraat 390,2023-06-03,07:00:00,31,15,16,FMN 18 Binnensingel Westkant
665,Uitbreidingstraat 390,2023-06-03,08:00:00,60,35,25,FMN 18 Binnensingel Westkant
665,Uitbreidingstraat 390,2023-06-03,09:00:00,117,61,56,FMN 18 Binnensingel Westkant
665,Uitbreidingstraat 390,2023-06-03,10:00:00,134,83,51,FMN 18 Binnensingel Westkant
665,Uitbreidingstraat 390,2023-06-03,11:00:00,150,81,69,FMN 18 Binnensingel Westkant
665,Uitbreidingstraat 390,2023-06-03,12:00:00,155,73,82,FMN 18 Binnensingel Westkant
665,Uitbreidingstraat 390,2023-06-03,13:00:00,139,69,70,FMN 18 Binnensingel Westkant
665,Uitbreidingstraat 390,2023-06-03,14:00:00,172,98,74,FMN 18 Binnensingel Westkant
665,Uitbreidingstraat 390,2023-06-03,15:00:00,169,96,73,FMN 18 Binnensingel Westkant
665,Uitbreidingstraat 390,2023-06-03,16:00:00,178,89,89,FMN 18 Binnensingel Westkant
665,Uitbreidingstraat 390,2023-06-03,17:00:00,157,78,79,FMN 18 Binnensingel Westkant
665,Uitbreidingstraat 390,2023-06-03,18:00:00,150,73,77,FMN 18 Binnensingel Westkant
665,Uitbreidingstraat 390,2023-06-03,19:00:00,157,84,73,FMN 18 Binnensingel Westkant
665,Uitbreidingstraat 390,2023-06-03,20:00:00,111,57,54,FMN 18 Binnensingel Westkant
665,Uitbreidingstraat 390,2023-06-03,21:00:00,102,55,47,FMN 18 Binnensingel Westkant
665,Uitbreidingstraat 390,2023-06-03,22:00:00,119,64,55,FMN 18 Binnensingel Westkant
665,Uitbreidingstraat 390,2023-06-03,23:00:00,101,69,32,FMN 18 Binnensingel Westkant
665,Uitbreidingstraat 390,2023-06-04,00:00:00,83,55,28,FMN 18 Binnensingel Westkant
665,Uitbreidingstraat 390,2023-06-04,01:00:00,41,34,7,FMN 18 Binnensingel Westkant
665,Uitbreidingstraat 390,2023-06-04,02:00:00,32,26,6,FMN 18 Binnensingel Westkant
665,Uitbreidingstraat 390,2023-06-04,03:00:00,24,13,11,FMN 18 Binnensingel Westkant
665,Uitbreidingstraat 390,2023-06-04,04:00:00,8,6,2,FMN 18 Binnensingel Westkant
665,Uitbreidingstraat 390,2023-06-04,05:00:00,15,7,8,FMN 18 Binnensingel Westkant
665,Uitbreidingstraat 390,2023-06-04,06:00:00,22,18,4,FMN 18 Binnensingel Westkant
665,Uitbreidingstraat 390,2023-06-04,07:00:00,24,11,13,FMN 18 Binnensingel Westkant
665,Uitbreidingstraat 390,2023-06-04,08:00:00,39,17,22,FMN 18 Binnensingel Westkant
665,Uitbreidingstraat 390,2023-06-04,09:00:00,94,48,46,FMN 18 Binnensingel Westkant
665,Uitbreidingstraat 390,2023-06-04,10:00:00,106,57,49,FMN 18 Binnensingel Westkant
665,Uitbreidingstraat 390,2023-06-04,11:00:00,92,51,41,FMN 18 Binnensingel Westkant
665,Uitbreidingstraat 390,2023-06-04,12:00:00,178,103,75,FMN 18 Binnensingel Westkant
665,Uitbreidingstraat 390,2023-06-04,13:00:00,181,111,70,FMN 18 Binnensingel Westkant
665,Uitbreidingstraat 390,2023-06-04,14:00:00,188,94,94,FMN 18 Binnensingel Westkant
665,Uitbreidingstraat 390,2023-06-04,15:00:00,181,96,85,FMN 18 Binnensingel Westkant
665,Uitbreidingstraat 390,2023-06-04,16:00:00,183,78,105,FMN 18 Binnensingel Westkant
665,Uitbreidingstraat 390,2023-06-04,17:00:00,195,86,109,FMN 18 Binnensingel Westkant
665,Uitbreidingstraat 390,2023-06-04,18:00:00,158,84,74,FMN 18 Binnensingel Westkant
665,Uitbreidingstraat 390,2023-06-04,19:00:00,121,82,39,FMN 18 Binnensingel Westkant
665,Uitbreidingstraat 390,2023-06-04,20:00:00,117,64,53,FMN 18 Binnensingel Westkant
665,Uitbreidingstraat 390,2023-06-04,21:00:00,105,53,52,FMN 18 Binnensingel Westkant
665,Uitbreidingstraat 390,2023-06-04,22:00:00,75,42,33,FMN 18 Binnensingel Westkant
665,Uitbreidingstraat 390,2023-06-04,23:00:00,39,30,9,FMN 18 Binnensingel Westkant
665,Uitbreidingstraat 390,2023-06-05,00:00:00,69,60,9,FMN 18 Binnensingel Westkant
665,Uitbreidingstraat 390,2023-06-05,01:00:00,30,25,5,FMN 18 Binnensingel Westkant
665,Uitbreidingstraat 390,2023-06-05,02:00:00,18,15,3,FMN 18 Binnensingel Westkant
665,Uitbreidingstraat 390,2023-06-05,03:00:00,13,11,2,FMN 18 Binnensingel Westkant
665,Uitbreidingstraat 390,2023-06-05,04:00:00,13,7,6,FMN 18 Binnensingel Westkant
665,Uitbreidingstraat 390,2023-06-05,05:00:00,48,34,14,FMN 18 Binnensingel Westkant
665,Uitbreidingstraat 390,2023-06-05,06:00:00,95,52,43,FMN 18 Binnensingel Westkant
665,Uitbreidingstraat 390,2023-06-05,07:00:00,289,171,118,FMN 18 Binnensingel Westkant
665,Uitbreidingstraat 390,2023-06-05,08:00:00,541,359,182,FMN 18 Binnensingel Westkant
665,Uitbreidingstraat 390,2023-06-05,09:00:00,198,137,61,FMN 18 Binnensingel Westkant
665,Uitbreidingstraat 390,2023-06-05,10:00:00,142,86,56,FMN 18 Binnensingel Westkant
665,Uitbreidingstraat 390,2023-06-05,11:00:00,138,63,75,FMN 18 Binnensingel Westkant
665,Uitbreidingstraat 390,2023-06-05,12:00:00,172,102,70,FMN 18 Binnensingel Westkant
665,Uitbreidingstraat 390,2023-06-05,13:00:00,169,96,73,FMN 18 Binnensingel Westkant
665,Uitbreidingstraat 390,2023-06-05,14:00:00,210,103,107,FMN 18 Binnensingel Westkant
665,Uitbreidingstraat 390,2023-06-05,15:00:00,296,107,189,FMN 18 Binnensingel Westkant
665,Uitbreidingstraat 390,2023-06-05,16:00:00,448,154,294,FMN 18 Binnensingel Westkant
665,Uitbreidingstraat 390,2023-06-05,17:00:00,426,169,257,FMN 18 Binnensingel Westkant
665,Uitbreidingstraat 390,2023-06-05,18:00:00,328,182,146,FMN 18 Binnensingel Westkant
665,Uitbreidingstraat 390,2023-06-05,19:00:00,182,101,81,FMN 18 Binnensingel Westkant
665,Uitbreidingstraat 390,2023-06-05,20:00:00,142,59,83,FMN 18 Binnensingel Westkant
665,Uitbreidingstraat 390,2023-06-05,21:00:00,115,60,55,FMN 18 Binnensingel Westkant
665,Uitbreidingstraat 390,2023-06-05,22:00:00,96,43,53,FMN 18 Binnensingel Westkant
665,Uitbreidingstraat 390,2023-06-05,23:00:00,46,34,12,FMN 18 Binnensingel Westkant
665,Uitbreidingstraat 390,2023-06-06,00:00:00,27,12,15,FMN 18 Binnensingel Westkant
665,Uitbreidingstraat 390,2023-06-06,01:00:00,10,7,3,FMN 18 Binnensingel Westkant
665,Uitbreidingstraat 390,2023-06-06,02:00:00,4,4,0,FMN 18 Binnensingel Westkant
665,Uitbreidingstraat 390,2023-06-06,03:00:00,6,5,1,FMN 18 Binnensingel Westkant
665,Uitbreidingstraat 390,2023-06-06,04:00:00,20,11,9,FMN 18 Binnensingel Westkant
665,Uitbreidingstraat 390,2023-06-06,05:00:00,43,33,10,FMN 18 Binnensingel Westkant
665,Uitbreidingstraat 390,2023-06-06,06:00:00,104,59,45,FMN 18 Binnensingel Westkant
665,Uitbreidingstraat 390,2023-06-06,07:00:00,374,234,140,FMN 18 Binnensingel Westkant
665,Uitbreidingstraat 390,2023-06-06,08:00:00,631,423,208,FMN 18 Binnensingel Westkant
665,Uitbreidingstraat 390,2023-06-06,09:00:00,227,139,88,FMN 18 Binnensingel Westkant
665,Uitbreidingstraat 390,2023-06-06,10:00:00,117,60,57,FMN 18 Binnensingel Westkant
665,Uitbreidingstraat 390,2023-06-06,11:00:00,162,70,92,FMN 18 Binnensingel Westkant
665,Uitbreidingstraat 390,2023-06-06,12:00:00,227,103,124,FMN 18 Binnensingel Westkant
665,Uitbreidingstraat 390,2023-06-06,13:00:00,167,97,70,FMN 18 Binnensingel Westkant
665,Uitbreidingstraat 390,2023-06-06,14:00:00,170,87,83,FMN 18 Binnensingel Westkant
665,Uitbreidingstraat 390,2023-06-06,15:00:00,258,103,155,FMN 18 Binnensingel Westkant
665,Uitbreidingstraat 390,2023-06-06,16:00:00,478,150,328,FMN 18 Binnensingel Westkant
665,Uitbreidingstraat 390,2023-06-06,17:00:00,483,221,262,FMN 18 Binnensingel Westkant
665,Uitbreidingstraat 390,2023-06-06,18:00:00,322,161,161,FMN 18 Binnensingel Westkant
665,Uitbreidingstraat 390,2023-06-06,19:00:00,230,113,117,FMN 18 Binnensingel Westkant
665,Uitbreidingstraat 390,2023-06-06,20:00:00,152,66,86,FMN 18 Binnensingel Westkant
665,Uitbreidingstraat 390,2023-06-06,21:00:00,120,72,48,FMN 18 Binnensingel Westkant
665,Uitbreidingstraat 390,2023-06-06,22:00:00,118,52,66,FMN 18 Binnensingel Westkant
665,Uitbreidingstraat 390,2023-06-06,23:00:00,86,55,31,FMN 18 Binnensingel Westkant
665,Uitbreidingstraat 390,2023-06-07,00:00:00,21,15,6,FMN 18 Binnensingel Westkant
665,Uitbreidingstraat 390,2023-06-07,01:00:00,9,7,2,FMN 18 Binnensingel Westkant
665,Uitbreidingstraat 390,2023-06-07,02:00:00,3,1,2,FMN 18 Binnensingel Westkant
665,Uitbreidingstraat 390,2023-06-07,03:00:00,6,6,0,FMN 18 Binnensingel Westkant
665,Uitbreidingstraat 390,2023-06-07,04:00:00,14,10,4,FMN 18 Binnensingel Westkant
665,Uitbreidingstraat 390,2023-06-07,05:00:00,52,39,13,FMN 18 Binnensingel Westkant
665,Uitbreidingstraat 390,2023-06-07,06:00:00,119,73,46,FMN 18 Binnensingel Westkant
665,Uitbreidingstraat 390,2023-06-07,07:00:00,332,191,141,FMN 18 Binnensingel Westkant
665,Uitbreidingstraat 390,2023-06-07,08:00:00,516,356,160,FMN 18 Binnensingel Westkant
665,Uitbreidingstraat 390,2023-06-07,09:00:00,202,125,77,FMN 18 Binnensingel Westkant
665,Uitbreidingstraat 390,2023-06-07,10:00:00,149,82,67,FMN 18 Binnensingel Westkant
665,Uitbreidingstraat 390,2023-06-07,11:00:00,161,74,87,FMN 18 Binnensingel Westkant
665,Uitbreidingstraat 390,2023-06-07,12:00:00,386,149,237,FMN 18 Binnensingel Westkant
665,Uitbreidingstraat 390,2023-06-07,13:00:00,243,100,143,FMN 18 Binnensingel Westkant
665,Uitbreidingstraat 390,2023-06-07,14:00:00,179,80,99,FMN 18 Binnensingel Westkant
665,Uitbreidingstraat 390,2023-06-07,15:00:00,190,75,115,FMN 18 Binnensingel Westkant
665,Uitbreidingstraat 390,2023-06-07,16:00:00,294,131,163,FMN 18 Binnensingel Westkant
665,Uitbreidingstraat 390,2023-06-07,17:00:00,404,176,228,FMN 18 Binnensingel Westkant
665,Uitbreidingstraat 390,2023-06-07,18:00:00,331,160,171,FMN 18 Binnensingel Westkant
665,Uitbreidingstraat 390,2023-06-07,19:00:00,222,119,103,FMN 18 Binnensingel Westkant
665,Uitbreidingstraat 390,2023-06-07,20:00:00,146,56,90,FMN 18 Binnensingel Westkant
665,Uitbreidingstraat 390,2023-06-07,21:00:00,100,45,55,FMN 18 Binnensingel Westkant
665,Uitbreidingstraat 390,2023-06-07,22:00:00,116,54,62,FMN 18 Binnensingel Westkant
665,Uitbreidingstraat 390,2023-06-07,23:00:00,76,50,26,FMN 18 Binnensingel Westkant
665,Uitbreidingstraat 390,2023-06-08,00:00:00,37,28,9,FMN 18 Binnensingel Westkant
665,Uitbreidingstraat 390,2023-06-08,01:00:00,8,5,3,FMN 18 Binnensingel Westkant
665,Uitbreidingstraat 390,2023-06-08,02:00:00,7,6,1,FMN 18 Binnensingel Westkant
665,Uitbreidingstraat 390,2023-06-08,03:00:00,7,6,1,FMN 18 Binnensingel Westkant
665,Uitbreidingstraat 390,2023-06-08,04:00:00,19,11,8,FMN 18 Binnensingel Westkant
665,Uitbreidingstraat 390,2023-06-08,05:00:00,43,28,15,FMN 18 Binnensingel Westkant
665,Uitbreidingstraat 390,2023-06-08,06:00:00,119,66,53,FMN 18 Binnensingel Westkant
665,Uitbreidingstraat 390,2023-06-08,07:00:00,338,200,138,FMN 18 Binnensingel Westkant
665,Uitbreidingstraat 390,2023-06-08,08:00:00,619,428,191,FMN 18 Binnensingel Westkant
665,Uitbreidingstraat 390,2023-06-08,09:00:00,231,162,69,FMN 18 Binnensingel Westkant
665,Uitbreidingstraat 390,2023-06-08,10:00:00,148,69,79,FMN 18 Binnensingel Westkant
665,Uitbreidingstraat 390,2023-06-08,11:00:00,126,76,50,FMN 18 Binnensingel Westkant
665,Uitbreidingstraat 390,2023-06-08,12:00:00,195,98,97,FMN 18 Binnensingel Westkant
665,Uitbreidingstraat 390,2023-06-08,13:00:00,167,87,80,FMN 18 Binnensingel Westkant
665,Uitbreidingstraat 390,2023-06-08,14:00:00,171,76,95,FMN 18 Binnensingel Westkant
665,Uitbreidingstraat 390,2023-06-08,15:00:00,287,111,176,FMN 18 Binnensingel Westkant
665,Uitbreidingstraat 390,2023-06-08,16:00:00,462,154,308,FMN 18 Binnensingel Westkant
665,Uitbreidingstraat 390,2023-06-08,17:00:00,441,189,252,FMN 18 Binnensingel Westkant
665,Uitbreidingstraat 390,2023-06-08,18:00:00,351,170,181,FMN 18 Binnensingel Westkant
665,Uitbreidingstraat 390,2023-06-08,19:00:00,221,115,106,FMN 18 Binnensingel Westkant
665,Uitbreidingstraat 390,2023-06-08,20:00:00,150,86,64,FMN 18 Binnensingel Westkant
665,Uitbreidingstraat 390,2023-06-08,21:00:00,123,61,62,FMN 18 Binnensingel Westkant
665,Uitbreidingstraat 390,2023-06-08,22:00:00,160,86,74,FMN 18 Binnensingel Westkant
665,Uitbreidingstraat 390,2023-06-08,23:00:00,101,78,23,FMN 18 Binnensingel Westkant
665,Uitbreidingstraat 390,2023-06-09,00:00:00,49,31,18,FMN 18 Binnensingel Westkant
665,Uitbreidingstraat 390,2023-06-09,01:00:00,18,12,6,FMN 18 Binnensingel Westkant
665,Uitbreidingstraat 390,2023-06-09,02:00:00,4,2,2,FMN 18 Binnensingel Westkant
665,Uitbreidingstraat 390,2023-06-09,03:00:00,13,9,4,FMN 18 Binnensingel Westkant
665,Uitbreidingstraat 390,2023-06-09,04:00:00,24,15,9,FMN 18 Binnensingel Westkant
665,Uitbreidingstraat 390,2023-06-09,05:00:00,43,32,11,FMN 18 Binnensingel Westkant
665,Uitbreidingstraat 390,2023-06-09,06:00:00,98,60,38,FMN 18 Binnensingel Westkant
665,Uitbreidingstraat 390,2023-06-09,07:00:00,310,206,104,FMN 18 Binnensingel Westkant
665,Uitbreidingstraat 390,2023-06-09,08:00:00,496,339,157,FMN 18 Binnensingel Westkant
665,Uitbreidingstraat 390,2023-06-09,09:00:00,202,139,63,FMN 18 Binnensingel Westkant
665,Uitbreidingstraat 390,2023-06-09,10:00:00,144,82,62,FMN 18 Binnensingel Westkant
665,Uitbreidingstraat 390,2023-06-09,11:00:00,147,75,72,FMN 18 Binnensingel Westkant
665,Uitbreidingstraat 390,2023-06-09,12:00:00,208,108,100,FMN 18 Binnensingel Westkant
665,Uitbreidingstraat 390,2023-06-09,13:00:00,154,91,63,FMN 18 Binnensingel Westkant
665,Uitbreidingstraat 390,2023-06-09,14:00:00,171,90,81,FMN 18 Binnensingel Westkant
665,Uitbreidingstraat 390,2023-06-09,15:00:00,264,101,163,FMN 18 Binnensingel Westkant
665,Uitbreidingstraat 390,2023-06-09,16:00:00,458,136,322,FMN 18 Binnensingel Westkant
665,Uitbreidingstraat 390,2023-06-09,17:00:00,331,132,199,FMN 18 Binnensingel Westkant
665,Uitbreidingstraat 390,2023-06-09,18:00:00,253,122,131,FMN 18 Binnensingel Westkant
665,Uitbreidingstraat 390,2023-06-09,19:00:00,221,115,106,FMN 18 Binnensingel Westkant
665,Uitbreidingstraat 390,2023-06-09,20:00:00,128,56,72,FMN 18 Binnensingel Westkant
665,Uitbreidingstraat 390,2023-06-09,21:00:00,101,47,54,FMN 18 Binnensingel Westkant
665,Uitbreidingstraat 390,2023-06-09,22:00:00,111,50,61,FMN 18 Binnensingel Westkant
665,Uitbreidingstraat 390,2023-06-09,23:00:00,110,57,53,FMN 18 Binnensingel Westkant
665,Uitbreidingstraat 390,2023-06-10,00:00:00,90,69,21,FMN 18 Binnensingel Westkant
665,Uitbreidingstraat 390,2023-06-10,01:00:00,70,42,28,FMN 18 Binnensingel Westkant
665,Uitbreidingstraat 390,2023-06-10,02:00:00,35,30,5,FMN 18 Binnensingel Westkant
665,Uitbreidingstraat 390,2023-06-10,03:00:00,16,12,4,FMN 18 Binnensingel Westkant
665,Uitbreidingstraat 390,2023-06-10,04:00:00,17,13,4,FMN 18 Binnensingel Westkant
665,Uitbreidingstraat 390,2023-06-10,05:00:00,21,13,8,FMN 18 Binnensingel Westkant
665,Uitbreidingstraat 390,2023-06-10,06:00:00,28,14,14,FMN 18 Binnensingel Westkant
665,Uitbreidingstraat 390,2023-06-10,07:00:00,40,13,27,FMN 18 Binnensingel Westkant
665,Uitbreidingstraat 390,2023-06-10,08:00:00,81,48,33,FMN 18 Binnensingel Westkant
665,Uitbreidingstraat 390,2023-06-10,09:00:00,96,58,38,FMN 18 Binnensingel Westkant
665,Uitbreidingstraat 390,2023-06-10,10:00:00,155,90,65,FMN 18 Binnensingel Westkant
665,Uitbreidingstraat 390,2023-06-10,11:00:00,143,76,67,FMN 18 Binnensingel Westkant
665,Uitbreidingstraat 390,2023-06-10,12:00:00,134,73,61,FMN 18 Binnensingel Westkant
665,Uitbreidingstraat 390,2023-06-10,13:00:00,155,82,73,FMN 18 Binnensingel Westkant
665,Uitbreidingstraat 390,2023-06-10,14:00:00,141,71,70,FMN 18 Binnensingel Westkant
665,Uitbreidingstraat 390,2023-06-10,15:00:00,113,51,62,FMN 18 Binnensingel Westkant
665,Uitbreidingstraat 390,2023-06-10,16:00:00,146,79,67,FMN 18 Binnensingel Westkant
665,Uitbreidingstraat 390,2023-06-10,17:00:00,137,69,68,FMN 18 Binnensingel Westkant
665,Uitbreidingstraat 390,2023-06-10,18:00:00,167,113,54,FMN 18 Binnensingel Westkant
665,Uitbreidingstraat 390,2023-06-10,19:00:00,135,69,66,FMN 18 Binnensingel Westkant
665,Uitbreidingstraat 390,2023-06-10,20:00:00,117,70,47,FMN 18 Binnensingel Westkant
665,Uitbreidingstraat 390,2023-06-10,21:00:00,116,59,57,FMN 18 Binnensingel Westkant
665,Uitbreidingstraat 390,2023-06-10,22:00:00,115,63,52,FMN 18 Binnensingel Westkant
665,Uitbreidingstraat 390,2023-06-10,23:00:00,112,56,56,FMN 18 Binnensingel Westkant
665,Uitbreidingstraat 390,2023-06-11,00:00:00,77,53,24,FMN 18 Binnensingel Westkant
665,Uitbreidingstraat 390,2023-06-11,01:00:00,74,46,28,FMN 18 Binnensingel Westkant
665,Uitbreidingstraat 390,2023-06-11,02:00:00,44,31,13,FMN 18 Binnensingel Westkant
665,Uitbreidingstraat 390,2023-06-11,03:00:00,12,9,3,FMN 18 Binnensingel Westkant
665,Uitbreidingstraat 390,2023-06-11,04:00:00,17,12,5,FMN 18 Binnensingel Westkant
665,Uitbreidingstraat 390,2023-06-11,05:00:00,17,11,6,FMN 18 Binnensingel Westkant
665,Uitbreidingstraat 390,2023-06-11,06:00:00,21,14,7,FMN 18 Binnensingel Westkant
665,Uitbreidingstraat 390,2023-06-11,07:00:00,32,16,16,FMN 18 Binnensingel Westkant
665,Uitbreidingstraat 390,2023-06-11,08:00:00,34,22,12,FMN 18 Binnensingel Westkant
665,Uitbreidingstraat 390,2023-06-11,09:00:00,86,40,46,FMN 18 Binnensingel Westkant
665,Uitbreidingstraat 390,2023-06-11,10:00:00,94,52,42,FMN 18 Binnensingel Westkant
665,Uitbreidingstraat 390,2023-06-11,11:00:00,117,53,64,FMN 18 Binnensingel Westkant
665,Uitbreidingstraat 390,2023-06-11,12:00:00,112,59,53,FMN 18 Binnensingel Westkant
665,Uitbreidingstraat 390,2023-06-11,13:00:00,139,69,70,FMN 18 Binnensingel Westkant
665,Uitbreidingstraat 390,2023-06-11,14:00:00,142,69,73,FMN 18 Binnensingel Westkant
665,Uitbreidingstraat 390,2023-06-11,15:00:00,136,74,62,FMN 18 Binnensingel Westkant
665,Uitbreidingstraat 390,2023-06-11,16:00:00,112,70,42,FMN 18 Binnensingel Westkant
665,Uitbreidingstraat 390,2023-06-11,17:00:00,125,64,61,FMN 18 Binnensingel Westkant
665,Uitbreidingstraat 390,2023-06-11,18:00:00,142,71,71,FMN 18 Binnensingel Westkant
665,Uitbreidingstraat 390,2023-06-11,19:00:00,109,59,50,FMN 18 Binnensingel Westkant
665,Uitbreidingstraat 390,2023-06-11,20:00:00,99,60,39,FMN 18 Binnensingel Westkant
665,Uitbreidingstraat 390,2023-06-11,21:00:00,93,62,31,FMN 18 Binnensingel Westkant
665,Uitbreidingstraat 390,2023-06-11,22:00:00,78,44,34,FMN 18 Binnensingel Westkant
665,Uitbreidingstraat 390,2023-06-11,23:00:00,46,26,20,FMN 18 Binnensingel Westkant
665,Uitbreidingstraat 390,2023-06-12,00:00:00,25,15,10,FMN 18 Binnensingel Westkant
665,Uitbreidingstraat 390,2023-06-12,01:00:00,11,7,4,FMN 18 Binnensingel Westkant
665,Uitbreidingstraat 390,2023-06-12,02:00:00,5,3,2,FMN 18 Binnensingel Westkant
665,Uitbreidingstraat 390,2023-06-12,03:00:00,7,6,1,FMN 18 Binnensingel Westkant
665,Uitbreidingstraat 390,2023-06-12,04:00:00,23,7,16,FMN 18 Binnensingel Westkant
665,Uitbreidingstraat 390,2023-06-12,05:00:00,50,37,13,FMN 18 Binnensingel Westkant
665,Uitbreidingstraat 390,2023-06-12,06:00:00,112,63,49,FMN 18 Binnensingel Westkant
665,Uitbreidingstraat 390,2023-06-12,07:00:00,344,207,137,FMN 18 Binnensingel Westkant
665,Uitbreidingstraat 390,2023-06-12,08:00:00,604,442,162,FMN 18 Binnensingel Westkant
665,Uitbreidingstraat 390,2023-06-12,09:00:00,216,137,79,FMN 18 Binnensingel Westkant
665,Uitbreidingstraat 390,2023-06-12,10:00:00,156,88,68,FMN 18 Binnensingel Westkant
665,Uitbreidingstraat 390,2023-06-12,11:00:00,165,72,93,FMN 18 Binnensingel Westkant
665,Uitbreidingstraat 390,2023-06-12,12:00:00,203,96,107,FMN 18 Binnensingel Westkant
665,Uitbreidingstraat 390,2023-06-12,13:00:00,175,89,86,FMN 18 Binnensingel Westkant
665,Uitbreidingstraat 390,2023-06-12,14:00:00,164,78,86,FMN 18 Binnensingel Westkant
665,Uitbreidingstraat 390,2023-06-12,15:00:00,300,105,195,FMN 18 Binnensingel Westkant
665,Uitbreidingstraat 390,2023-06-12,16:00:00,405,138,267,FMN 18 Binnensingel Westkant
665,Uitbreidingstraat 390,2023-06-12,17:00:00,386,153,233,FMN 18 Binnensingel Westkant
665,Uitbreidingstraat 390,2023-06-12,18:00:00,316,164,152,FMN 18 Binnensingel Westkant
665,Uitbreidingstraat 390,2023-06-12,19:00:00,177,98,79,FMN 18 Binnensingel Westkant
665,Uitbreidingstraat 390,2023-06-12,20:00:00,126,58,68,FMN 18 Binnensingel Westkant
665,Uitbreidingstraat 390,2023-06-12,21:00:00,126,61,65,FMN 18 Binnensingel Westkant
665,Uitbreidingstraat 390,2023-06-12,22:00:00,99,45,54,FMN 18 Binnensingel Westkant
665,Uitbreidingstraat 390,2023-06-12,23:00:00,57,42,15,FMN 18 Binnensingel Westkant
665,Uitbreidingstraat 390,2023-06-13,00:00:00,22,12,10,FMN 18 Binnensingel Westkant
665,Uitbreidingstraat 390,2023-06-13,01:00:00,13,10,3,FMN 18 Binnensingel Westkant
665,Uitbreidingstraat 390,2023-06-13,02:00:00,5,2,3,FMN 18 Binnensingel Westkant
665,Uitbreidingstraat 390,2023-06-13,03:00:00,9,5,4,FMN 18 Binnensingel Westkant
665,Uitbreidingstraat 390,2023-06-13,04:00:00,17,10,7,FMN 18 Binnensingel Westkant
665,Uitbreidingstraat 390,2023-06-13,05:00:00,67,46,21,FMN 18 Binnensingel Westkant
665,Uitbreidingstraat 390,2023-06-13,06:00:00,114,63,51,FMN 18 Binnensingel Westkant
665,Uitbreidingstraat 390,2023-06-13,07:00:00,384,233,151,FMN 18 Binnensingel Westkant
665,Uitbreidingstraat 390,2023-06-13,08:00:00,643,441,202,FMN 18 Binnensingel Westkant
665,Uitbreidingstraat 390,2023-06-13,09:00:00,220,144,76,FMN 18 Binnensingel Westkant
665,Uitbreidingstraat 390,2023-06-13,10:00:00,146,76,70,FMN 18 Binnensingel Westkant
665,Uitbreidingstraat 390,2023-06-13,11:00:00,179,68,111,FMN 18 Binnensingel Westkant
665,Uitbreidingstraat 390,2023-06-13,12:00:00,254,106,148,FMN 18 Binnensingel Westkant
665,Uitbreidingstraat 390,2023-06-13,13:00:00,183,107,76,FMN 18 Binnensingel Westkant
665,Uitbreidingstraat 390,2023-06-13,14:00:00,187,85,102,FMN 18 Binnensingel Westkant
665,Uitbreidingstraat 390,2023-06-13,15:00:00,249,106,143,FMN 18 Binnensingel Westkant
665,Uitbreidingstraat 390,2023-06-13,16:00:00,384,136,248,FMN 18 Binnensingel Westkant
665,Uitbreidingstraat 390,2023-06-13,17:00:00,425,186,239,FMN 18 Binnensingel Westkant
665,Uitbreidingstraat 390,2023-06-13,18:00:00,328,164,164,FMN 18 Binnensingel Westkant
665,Uitbreidingstraat 390,2023-06-13,19:00:00,221,112,109,FMN 18 Binnensingel Westkant
665,Uitbreidingstraat 390,2023-06-13,20:00:00,149,69,80,FMN 18 Binnensingel Westkant
665,Uitbreidingstraat 390,2023-06-13,21:00:00,148,71,77,FMN 18 Binnensingel Westkant
665,Uitbreidingstraat 390,2023-06-13,22:00:00,106,64,42,FMN 18 Binnensingel Westkant
665,Uitbreidingstraat 390,2023-06-13,23:00:00,75,55,20,FMN 18 Binnensingel Westkant
665,Uitbreidingstraat 390,2023-06-14,00:00:00,41,28,13,FMN 18 Binnensingel Westkant
665,Uitbreidingstraat 390,2023-06-14,01:00:00,17,12,5,FMN 18 Binnensingel Westkant
665,Uitbreidingstraat 390,2023-06-14,02:00:00,12,2,10,FMN 18 Binnensingel Westkant
665,Uitbreidingstraat 390,2023-06-14,03:00:00,10,8,2,FMN 18 Binnensingel Westkant
665,Uitbreidingstraat 390,2023-06-14,04:00:00,25,15,10,FMN 18 Binnensingel Westkant
665,Uitbreidingstraat 390,2023-06-14,05:00:00,60,40,20,FMN 18 Binnensingel Westkant
665,Uitbreidingstraat 390,2023-06-14,06:00:00,97,52,45,FMN 18 Binnensingel Westkant
665,Uitbreidingstraat 390,2023-06-14,07:00:00,321,191,130,FMN 18 Binnensingel Westkant
665,Uitbreidingstraat 390,2023-06-14,08:00:00,533,373,160,FMN 18 Binnensingel Westkant
665,Uitbreidingstraat 390,2023-06-14,09:00:00,230,135,95,FMN 18 Binnensingel Westkant
665,Uitbreidingstraat 390,2023-06-14,10:00:00,172,72,100,FMN 18 Binnensingel Westkant
665,Uitbreidingstraat 390,2023-06-14,11:00:00,184,69,115,FMN 18 Binnensingel Westkant
665,Uitbreidingstraat 390,2023-06-14,12:00:00,303,146,157,FMN 18 Binnensingel Westkant
665,Uitbreidingstraat 390,2023-06-14,13:00:00,240,101,139,FMN 18 Binnensingel Westkant
665,Uitbreidingstraat 390,2023-06-14,14:00:00,167,77,90,FMN 18 Binnensingel Westkant
665,Uitbreidingstraat 390,2023-06-14,15:00:00,218,103,115,FMN 18 Binnensingel Westkant
665,Uitbreidingstraat 390,2023-06-14,16:00:00,293,115,178,FMN 18 Binnensingel Westkant
665,Uitbreidingstraat 390,2023-06-14,17:00:00,397,175,222,FMN 18 Binnensingel Westkant
665,Uitbreidingstraat 390,2023-06-14,18:00:00,316,158,158,FMN 18 Binnensingel Westkant
665,Uitbreidingstraat 390,2023-06-14,19:00:00,212,96,116,FMN 18 Binnensingel Westkant
665,Uitbreidingstraat 390,2023-06-14,20:00:00,141,66,75,FMN 18 Binnensingel Westkant
665,Uitbreidingstraat 390,2023-06-14,21:00:00,134,66,68,FMN 18 Binnensingel Westkant
665,Uitbreidingstraat 390,2023-06-14,22:00:00,118,62,56,FMN 18 Binnensingel Westkant
665,Uitbreidingstraat 390,2023-06-14,23:00:00,77,47,30,FMN 18 Binnensingel Westkant
665,Uitbreidingstraat 390,2023-06-15,00:00:00,35,25,10,FMN 18 Binnensingel Westkant
665,Uitbreidingstraat 390,2023-06-15,01:00:00,15,10,5,FMN 18 Binnensingel Westkant
665,Uitbreidingstraat 390,2023-06-15,02:00:00,4,2,2,FMN 18 Binnensingel Westkant
665,Uitbreidingstraat 390,2023-06-15,03:00:00,6,3,3,FMN 18 Binnensingel Westkant
665,Uitbreidingstraat 390,2023-06-15,04:00:00,23,14,9,FMN 18 Binnensingel Westkant
665,Uitbreidingstraat 390,2023-06-15,05:00:00,63,43,20,FMN 18 Binnensingel Westkant
665,Uitbreidingstraat 390,2023-06-15,06:00:00,102,51,51,FMN 18 Binnensingel Westkant
665,Uitbreidingstraat 390,2023-06-15,07:00:00,370,209,161,FMN 18 Binnensingel Westkant
665,Uitbreidingstraat 390,2023-06-15,08:00:00,594,421,173,FMN 18 Binnensingel Westkant
665,Uitbreidingstraat 390,2023-06-15,09:00:00,228,143,85,FMN 18 Binnensingel Westkant
665,Uitbreidingstraat 390,2023-06-15,10:00:00,211,85,126,FMN 18 Binnensingel Westkant
665,Uitbreidingstraat 390,2023-06-15,11:00:00,195,74,121,FMN 18 Binnensingel Westkant
665,Uitbreidingstraat 390,2023-06-15,12:00:00,231,121,110,FMN 18 Binnensingel Westkant
665,Uitbreidingstraat 390,2023-06-15,13:00:00,185,125,60,FMN 18 Binnensingel Westkant
665,Uitbreidingstraat 390,2023-06-15,14:00:00,156,70,86,FMN 18 Binnensingel Westkant
665,Uitbreidingstraat 390,2023-06-15,15:00:00,254,114,140,FMN 18 Binnensingel Westkant
665,Uitbreidingstraat 390,2023-06-15,16:00:00,392,161,231,FMN 18 Binnensingel Westkant
665,Uitbreidingstraat 390,2023-06-15,17:00:00,406,164,242,FMN 18 Binnensingel Westkant
665,Uitbreidingstraat 390,2023-06-15,18:00:00,354,166,188,FMN 18 Binnensingel Westkant
665,Uitbreidingstraat 390,2023-06-15,19:00:00,229,112,117,FMN 18 Binnensingel Westkant
665,Uitbreidingstraat 390,2023-06-15,20:00:00,147,65,82,FMN 18 Binnensingel Westkant
665,Uitbreidingstraat 390,2023-06-15,21:00:00,140,66,74,FMN 18 Binnensingel Westkant
665,Uitbreidingstraat 390,2023-06-15,22:00:00,124,61,63,FMN 18 Binnensingel Westkant
665,Uitbreidingstraat 390,2023-06-15,23:00:00,101,60,41,FMN 18 Binnensingel Westkant
665,Uitbreidingstraat 390,2023-06-16,00:00:00,31,22,9,FMN 18 Binnensingel Westkant
665,Uitbreidingstraat 390,2023-06-16,01:00:00,22,12,10,FMN 18 Binnensingel Westkant
665,Uitbreidingstraat 390,2023-06-16,02:00:00,6,5,1,FMN 18 Binnensingel Westkant
665,Uitbreidingstraat 390,2023-06-16,03:00:00,12,8,4,FMN 18 Binnensingel Westkant
665,Uitbreidingstraat 390,2023-06-16,04:00:00,21,13,8,FMN 18 Binnensingel Westkant
665,Uitbreidingstraat 390,2023-06-16,05:00:00,48,35,13,FMN 18 Binnensingel Westkant
665,Uitbreidingstraat 390,2023-06-16,06:00:00,99,56,43,FMN 18 Binnensingel Westkant
665,Uitbreidingstraat 390,2023-06-16,07:00:00,290,181,109,FMN 18 Binnensingel Westkant
665,Uitbreidingstraat 390,2023-06-16,08:00:00,483,331,152,FMN 18 Binnensingel Westkant
665,Uitbreidingstraat 390,2023-06-16,09:00:00,199,144,55,FMN 18 Binnensingel Westkant
665,Uitbreidingstraat 390,2023-06-16,10:00:00,190,82,108,FMN 18 Binnensingel Westkant
665,Uitbreidingstraat 390,2023-06-16,11:00:00,179,69,110,FMN 18 Binnensingel Westkant
665,Uitbreidingstraat 390,2023-06-16,12:00:00,251,112,139,FMN 18 Binnensingel Westkant
665,Uitbreidingstraat 390,2023-06-16,13:00:00,202,98,104,FMN 18 Binnensingel Westkant
665,Uitbreidingstraat 390,2023-06-16,14:00:00,188,90,98,FMN 18 Binnensingel Westkant
665,Uitbreidingstraat 390,2023-06-16,15:00:00,272,112,160,FMN 18 Binnensingel Westkant
665,Uitbreidingstraat 390,2023-06-16,16:00:00,379,151,228,FMN 18 Binnensingel Westkant
665,Uitbreidingstraat 390,2023-06-16,17:00:00,328,150,178,FMN 18 Binnensingel Westkant
665,Uitbreidingstraat 390,2023-06-16,18:00:00,300,148,152,FMN 18 Binnensingel Westkant
665,Uitbreidingstraat 390,2023-06-16,19:00:00,254,101,153,FMN 18 Binnensingel Westkant
665,Uitbreidingstraat 390,2023-06-16,20:00:00,192,97,95,FMN 18 Binnensingel Westkant
665,Uitbreidingstraat 390,2023-06-16,21:00:00,119,68,51,FMN 18 Binnensingel Westkant
665,Uitbreidingstraat 390,2023-06-16,22:00:00,124,73,51,FMN 18 Binnensingel Westkant
665,Uitbreidingstraat 390,2023-06-16,23:00:00,170,91,79,FMN 18 Binnensingel Westkant
665,Uitbreidingstraat 390,2023-06-17,00:00:00,110,61,49,FMN 18 Binnensingel Westkant
665,Uitbreidingstraat 390,2023-06-17,01:00:00,72,41,31,FMN 18 Binnensingel Westkant
665,Uitbreidingstraat 390,2023-06-17,02:00:00,43,23,20,FMN 18 Binnensingel Westkant
665,Uitbreidingstraat 390,2023-06-17,03:00:00,19,13,6,FMN 18 Binnensingel Westkant
665,Uitbreidingstraat 390,2023-06-17,04:00:00,22,19,3,FMN 18 Binnensingel Westkant
665,Uitbreidingstraat 390,2023-06-17,05:00:00,25,14,11,FMN 18 Binnensingel Westkant
665,Uitbreidingstraat 390,2023-06-17,06:00:00,37,28,9,FMN 18 Binnensingel Westkant
665,Uitbreidingstraat 390,2023-06-17,07:00:00,39,17,22,FMN 18 Binnensingel Westkant
665,Uitbreidingstraat 390,2023-06-17,08:00:00,68,40,28,FMN 18 Binnensingel Westkant
665,Uitbreidingstraat 390,2023-06-17,09:00:00,119,70,49,FMN 18 Binnensingel Westkant
665,Uitbreidingstraat 390,2023-06-17,10:00:00,175,98,77,FMN 18 Binnensingel Westkant
665,Uitbreidingstraat 390,2023-06-17,11:00:00,115,55,60,FMN 18 Binnensingel Westkant
665,Uitbreidingstraat 390,2023-06-17,12:00:00,140,73,67,FMN 18 Binnensingel Westkant
665,Uitbreidingstraat 390,2023-06-17,13:00:00,147,79,68,FMN 18 Binnensingel Westkant
665,Uitbreidingstraat 390,2023-06-17,14:00:00,151,79,72,FMN 18 Binnensingel Westkant
665,Uitbreidingstraat 390,2023-06-17,15:00:00,166,90,76,FMN 18 Binnensingel Westkant
665,Uitbreidingstraat 390,2023-06-17,16:00:00,145,77,68,FMN 18 Binnensingel Westkant
665,Uitbreidingstraat 390,2023-06-17,17:00:00,159,83,76,FMN 18 Binnensingel Westkant
665,Uitbreidingstraat 390,2023-06-17,18:00:00,193,96,97,FMN 18 Binnensingel Westkant
665,Uitbreidingstraat 390,2023-06-17,19:00:00,162,82,80,FMN 18 Binnensingel Westkant
665,Uitbreidingstraat 390,2023-06-17,20:00:00,108,56,52,FMN 18 Binnensingel Westkant
665,Uitbreidingstraat 390,2023-06-17,21:00:00,121,67,54,FMN 18 Binnensingel Westkant
665,Uitbreidingstraat 390,2023-06-17,22:00:00,89,48,41,FMN 18 Binnensingel Westkant
665,Uitbreidingstraat 390,2023-06-17,23:00:00,90,47,43,FMN 18 Binnensingel Westkant
665,Uitbreidingstraat 390,2023-06-18,00:00:00,80,56,24,FMN 18 Binnensingel Westkant
665,Uitbreidingstraat 390,2023-06-18,01:00:00,49,34,15,FMN 18 Binnensingel Westkant
665,Uitbreidingstraat 390,2023-06-18,02:00:00,40,26,14,FMN 18 Binnensingel Westkant
665,Uitbreidingstraat 390,2023-06-18,03:00:00,32,25,7,FMN 18 Binnensingel Westkant
665,Uitbreidingstraat 390,2023-06-18,04:00:00,13,8,5,FMN 18 Binnensingel Westkant
665,Uitbreidingstraat 390,2023-06-18,05:00:00,22,14,8,FMN 18 Binnensingel Westkant
665,Uitbreidingstraat 390,2023-06-18,06:00:00,25,18,7,FMN 18 Binnensingel Westkant
665,Uitbreidingstraat 390,2023-06-18,07:00:00,20,9,11,FMN 18 Binnensingel Westkant
665,Uitbreidingstraat 390,2023-06-18,08:00:00,46,23,23,FMN 18 Binnensingel Westkant
665,Uitbreidingstraat 390,2023-06-18,09:00:00,67,45,22,FMN 18 Binnensingel Westkant
665,Uitbreidingstraat 390,2023-06-18,10:00:00,67,34,33,FMN 18 Binnensingel Westkant
665,Uitbreidingstraat 390,2023-06-18,11:00:00,61,35,26,FMN 18 Binnensingel Westkant
665,Uitbreidingstraat 390,2023-06-18,12:00:00,102,63,39,FMN 18 Binnensingel Westkant
665,Uitbreidingstraat 390,2023-06-18,13:00:00,90,44,46,FMN 18 Binnensingel Westkant
665,Uitbreidingstraat 390,2023-06-18,14:00:00,129,66,63,FMN 18 Binnensingel Westkant
665,Uitbreidingstraat 390,2023-06-18,15:00:00,97,45,52,FMN 18 Binnensingel Westkant
665,Uitbreidingstraat 390,2023-06-18,16:00:00,111,57,54,FMN 18 Binnensingel Westkant
665,Uitbreidingstraat 390,2023-06-18,17:00:00,119,62,57,FMN 18 Binnensingel Westkant
665,Uitbreidingstraat 390,2023-06-18,18:00:00,125,71,54,FMN 18 Binnensingel Westkant
665,Uitbreidingstraat 390,2023-06-18,19:00:00,109,65,44,FMN 18 Binnensingel Westkant
665,Uitbreidingstraat 390,2023-06-18,20:00:00,115,64,51,FMN 18 Binnensingel Westkant
665,Uitbreidingstraat 390,2023-06-18,21:00:00,81,51,30,FMN 18 Binnensingel Westkant
665,Uitbreidingstraat 390,2023-06-18,22:00:00,64,29,35,FMN 18 Binnensingel Westkant
665,Uitbreidingstraat 390,2023-06-18,23:00:00,51,33,18,FMN 18 Binnensingel Westkant
665,Uitbreidingstraat 390,2023-06-19,00:00:00,18,13,5,FMN 18 Binnensingel Westkant
665,Uitbreidingstraat 390,2023-06-19,01:00:00,8,6,2,FMN 18 Binnensingel Westkant
665,Uitbreidingstraat 390,2023-06-19,02:00:00,7,2,5,FMN 18 Binnensingel Westkant
665,Uitbreidingstraat 390,2023-06-19,03:00:00,14,12,2,FMN 18 Binnensingel Westkant
665,Uitbreidingstraat 390,2023-06-19,04:00:00,27,22,5,FMN 18 Binnensingel Westkant
665,Uitbreidingstraat 390,2023-06-19,05:00:00,46,29,17,FMN 18 Binnensingel Westkant
665,Uitbreidingstraat 390,2023-06-19,06:00:00,100,58,42,FMN 18 Binnensingel Westkant
665,Uitbreidingstraat 390,2023-06-19,07:00:00,329,214,115,FMN 18 Binnensingel Westkant
665,Uitbreidingstraat 390,2023-06-19,08:00:00,531,365,166,FMN 18 Binnensingel Westkant
665,Uitbreidingstraat 390,2023-06-19,09:00:00,189,118,71,FMN 18 Binnensingel Westkant
665,Uitbreidingstraat 390,2023-06-19,10:00:00,203,79,124,FMN 18 Binnensingel Westkant
665,Uitbreidingstraat 390,2023-06-19,11:00:00,175,69,106,FMN 18 Binnensingel Westkant
665,Uitbreidingstraat 390,2023-06-19,12:00:00,205,94,111,FMN 18 Binnensingel Westkant
665,Uitbreidingstraat 390,2023-06-19,13:00:00,179,97,82,FMN 18 Binnensingel Westkant
665,Uitbreidingstraat 390,2023-06-19,14:00:00,192,89,103,FMN 18 Binnensingel Westkant
665,Uitbreidingstraat 390,2023-06-19,15:00:00,257,119,138,FMN 18 Binnensingel Westkant
665,Uitbreidingstraat 390,2023-06-19,16:00:00,314,131,183,FMN 18 Binnensingel Westkant
665,Uitbreidingstraat 390,2023-06-19,17:00:00,402,179,223,FMN 18 Binnensingel Westkant
665,Uitbreidingstraat 390,2023-06-19,18:00:00,323,157,166,FMN 18 Binnensingel Westkant
665,Uitbreidingstraat 390,2023-06-19,19:00:00,210,109,101,FMN 18 Binnensingel Westkant
665,Uitbreidingstraat 390,2023-06-19,20:00:00,134,65,69,FMN 18 Binnensingel Westkant
665,Uitbreidingstraat 390,2023-06-19,21:00:00,112,59,53,FMN 18 Binnensingel Westkant
665,Uitbreidingstraat 390,2023-06-19,22:00:00,94,50,44,FMN 18 Binnensingel Westkant
665,Uitbreidingstraat 390,2023-06-19,23:00:00,56,27,29,FMN 18 Binnensingel Westkant
665,Uitbreidingstraat 390,2023-06-20,00:00:00,27,17,10,FMN 18 Binnensingel Westkant
665,Uitbreidingstraat 390,2023-06-20,01:00:00,10,7,3,FMN 18 Binnensingel Westkant
665,Uitbreidingstraat 390,2023-06-20,02:00:00,7,2,5,FMN 18 Binnensingel Westkant
665,Uitbreidingstraat 390,2023-06-20,03:00:00,7,4,3,FMN 18 Binnensingel Westkant
665,Uitbreidingstraat 390,2023-06-20,04:00:00,25,17,8,FMN 18 Binnensingel Westkant
665,Uitbreidingstraat 390,2023-06-20,05:00:00,50,35,15,FMN 18 Binnensingel Westkant
665,Uitbreidingstraat 390,2023-06-20,06:00:00,104,55,49,FMN 18 Binnensingel Westkant
665,Uitbreidingstraat 390,2023-06-20,07:00:00,342,216,126,FMN 18 Binnensingel Westkant
665,Uitbreidingstraat 390,2023-06-20,08:00:00,539,377,162,FMN 18 Binnensingel Westkant
665,Uitbreidingstraat 390,2023-06-20,09:00:00,273,143,130,FMN 18 Binnensingel Westkant
665,Uitbreidingstraat 390,2023-06-20,10:00:00,228,81,147,FMN 18 Binnensingel Westkant
665,Uitbreidingstraat 390,2023-06-20,11:00:00,162,76,86,FMN 18 Binnensingel Westkant
665,Uitbreidingstraat 390,2023-06-20,12:00:00,196,86,110,FMN 18 Binnensingel Westkant
665,Uitbreidingstraat 390,2023-06-20,13:00:00,177,82,95,FMN 18 Binnensingel Westkant
665,Uitbreidingstraat 390,2023-06-20,14:00:00,170,83,87,FMN 18 Binnensingel Westkant
665,Uitbreidingstraat 390,2023-06-20,15:00:00,224,109,115,FMN 18 Binnensingel Westkant
665,Uitbreidingstraat 390,2023-06-20,16:00:00,373,145,228,FMN 18 Binnensingel Westkant
665,Uitbreidingstraat 390,2023-06-20,17:00:00,384,186,198,FMN 18 Binnensingel Westkant
665,Uitbreidingstraat 390,2023-06-20,18:00:00,240,118,122,FMN 18 Binnensingel Westkant
665,Uitbreidingstraat 390,2023-06-20,19:00:00,119,64,55,FMN 18 Binnensingel Westkant
665,Uitbreidingstraat 390,2023-06-20,20:00:00,99,48,51,FMN 18 Binnensingel Westkant
665,Uitbreidingstraat 390,2023-06-20,21:00:00,59,31,28,FMN 18 Binnensingel Westkant
665,Uitbreidingstraat 390,2023-06-20,22:00:00,64,32,32,FMN 18 Binnensingel Westkant
665,Uitbreidingstraat 390,2023-06-20,23:00:00,48,30,18,FMN 18 Binnensingel Westkant
665,Uitbreidingstraat 390,2023-06-21,00:00:00,18,10,8,FMN 18 Binnensingel Westkant
665,Uitbreidingstraat 390,2023-06-21,01:00:00,8,6,2,FMN 18 Binnensingel Westkant
665,Uitbreidingstraat 390,2023-06-21,02:00:00,5,2,3,FMN 18 Binnensingel Westkant
665,Uitbreidingstraat 390,2023-06-21,03:00:00,8,4,4,FMN 18 Binnensingel Westkant
665,Uitbreidingstraat 390,2023-06-21,04:00:00,19,9,10,FMN 18 Binnensingel Westkant
665,Uitbreidingstraat 390,2023-06-21,05:00:00,50,36,14,FMN 18 Binnensingel Westkant
665,Uitbreidingstraat 390,2023-06-21,06:00:00,104,50,54,FMN 18 Binnensingel Westkant
665,Uitbreidingstraat 390,2023-06-21,07:00:00,316,215,101,FMN 18 Binnensingel Westkant
665,Uitbreidingstraat 390,2023-06-21,08:00:00,505,345,160,FMN 18 Binnensingel Westkant
665,Uitbreidingstraat 390,2023-06-21,09:00:00,222,128,94,FMN 18 Binnensingel Westkant
665,Uitbreidingstraat 390,2023-06-21,10:00:00,183,88,95,FMN 18 Binnensingel Westkant
665,Uitbreidingstraat 390,2023-06-21,11:00:00,247,85,162,FMN 18 Binnensingel Westkant
665,Uitbreidingstraat 390,2023-06-21,12:00:00,310,137,173,FMN 18 Binnensingel Westkant
665,Uitbreidingstraat 390,2023-06-21,13:00:00,205,104,101,FMN 18 Binnensingel Westkant
665,Uitbreidingstraat 390,2023-06-21,14:00:00,174,76,98,FMN 18 Binnensingel Westkant
665,Uitbreidingstraat 390,2023-06-21,15:00:00,249,99,150,FMN 18 Binnensingel Westkant
665,Uitbreidingstraat 390,2023-06-21,16:00:00,314,127,187,FMN 18 Binnensingel Westkant
665,Uitbreidingstraat 390,2023-06-21,17:00:00,395,176,219,FMN 18 Binnensingel Westkant
665,Uitbreidingstraat 390,2023-06-21,18:00:00,360,179,181,FMN 18 Binnensingel Westkant
665,Uitbreidingstraat 390,2023-06-21,19:00:00,232,122,110,FMN 18 Binnensingel Westkant
665,Uitbreidingstraat 390,2023-06-21,20:00:00,171,85,86,FMN 18 Binnensingel Westkant
665,Uitbreidingstraat 390,2023-06-21,21:00:00,160,63,97,FMN 18 Binnensingel Westkant
665,Uitbreidingstraat 390,2023-06-21,22:00:00,125,67,58,FMN 18 Binnensingel Westkant
665,Uitbreidingstraat 390,2023-06-21,23:00:00,111,68,43,FMN 18 Binnensingel Westkant
665,Uitbreidingstraat 390,2023-06-22,00:00:00,55,35,20,FMN 18 Binnensingel Westkant
665,Uitbreidingstraat 390,2023-06-22,01:00:00,18,14,4,FMN 18 Binnensingel Westkant
665,Uitbreidingstraat 390,2023-06-22,02:00:00,8,4,4,FMN 18 Binnensingel Westkant
665,Uitbreidingstraat 390,2023-06-22,03:00:00,12,8,4,FMN 18 Binnensingel Westkant
665,Uitbreidingstraat 390,2023-06-22,04:00:00,18,13,5,FMN 18 Binnensingel Westkant
665,Uitbreidingstraat 390,2023-06-22,05:00:00,45,32,13,FMN 18 Binnensingel Westkant
665,Uitbreidingstraat 390,2023-06-22,06:00:00,98,54,44,FMN 18 Binnensingel Westkant
665,Uitbreidingstraat 390,2023-06-22,07:00:00,307,198,109,FMN 18 Binnensingel Westkant
665,Uitbreidingstraat 390,2023-06-22,08:00:00,503,357,146,FMN 18 Binnensingel Westkant
665,Uitbreidingstraat 390,2023-06-22,09:00:00,251,132,119,FMN 18 Binnensingel Westkant
665,Uitbreidingstraat 390,2023-06-22,10:00:00,204,62,142,FMN 18 Binnensingel Westkant
665,Uitbreidingstraat 390,2023-06-22,11:00:00,183,64,119,FMN 18 Binnensingel Westkant
665,Uitbreidingstraat 390,2023-06-22,12:00:00,173,86,87,FMN 18 Binnensingel Westkant
665,Uitbreidingstraat 390,2023-06-22,13:00:00,104,57,47,FMN 18 Binnensingel Westkant
665,Uitbreidingstraat 390,2023-06-22,14:00:00,97,37,60,FMN 18 Binnensingel Westkant
665,Uitbreidingstraat 390,2023-06-22,15:00:00,163,59,104,FMN 18 Binnensingel Westkant
665,Uitbreidingstraat 390,2023-06-22,16:00:00,222,84,138,FMN 18 Binnensingel Westkant
665,Uitbreidingstraat 390,2023-06-22,17:00:00,269,104,165,FMN 18 Binnensingel Westkant
665,Uitbreidingstraat 390,2023-06-22,18:00:00,196,90,106,FMN 18 Binnensingel Westkant
665,Uitbreidingstraat 390,2023-06-22,19:00:00,121,69,52,FMN 18 Binnensingel Westkant
665,Uitbreidingstraat 390,2023-06-22,20:00:00,116,51,65,FMN 18 Binnensingel Westkant
665,Uitbreidingstraat 390,2023-06-22,21:00:00,83,42,41,FMN 18 Binnensingel Westkant
665,Uitbreidingstraat 390,2023-06-22,22:00:00,97,50,47,FMN 18 Binnensingel Westkant
665,Uitbreidingstraat 390,2023-06-22,23:00:00,82,40,42,FMN 18 Binnensingel Westkant
665,Uitbreidingstraat 390,2023-06-23,00:00:00,29,20,9,FMN 18 Binnensingel Westkant
665,Uitbreidingstraat 390,2023-06-23,01:00:00,18,13,5,FMN 18 Binnensingel Westkant
665,Uitbreidingstraat 390,2023-06-23,02:00:00,7,1,6,FMN 18 Binnensingel Westkant
665,Uitbreidingstraat 390,2023-06-23,03:00:00,9,7,2,FMN 18 Binnensingel Westkant
665,Uitbreidingstraat 390,2023-06-23,04:00:00,21,14,7,FMN 18 Binnensingel Westkant
665,Uitbreidingstraat 390,2023-06-23,05:00:00,43,27,16,FMN 18 Binnensingel Westkant
665,Uitbreidingstraat 390,2023-06-23,06:00:00,108,64,44,FMN 18 Binnensingel Westkant
665,Uitbreidingstraat 390,2023-06-23,07:00:00,222,144,78,FMN 18 Binnensingel Westkant
665,Uitbreidingstraat 390,2023-06-23,08:00:00,444,303,141,FMN 18 Binnensingel Westkant
665,Uitbreidingstraat 390,2023-06-23,09:00:00,231,139,92,FMN 18 Binnensingel Westkant
665,Uitbreidingstraat 390,2023-06-23,10:00:00,189,95,94,FMN 18 Binnensingel Westkant
665,Uitbreidingstraat 390,2023-06-23,11:00:00,190,71,119,FMN 18 Binnensingel Westkant
665,Uitbreidingstraat 390,2023-06-23,12:00:00,241,97,144,FMN 18 Binnensingel Westkant
665,Uitbreidingstraat 390,2023-06-23,13:00:00,189,100,89,FMN 18 Binnensingel Westkant
665,Uitbreidingstraat 390,2023-06-23,14:00:00,202,76,126,FMN 18 Binnensingel Westkant
665,Uitbreidingstraat 390,2023-06-23,15:00:00,298,103,195,FMN 18 Binnensingel Westkant
665,Uitbreidingstraat 390,2023-06-23,16:00:00,349,129,220,FMN 18 Binnensingel Westkant
665,Uitbreidingstraat 390,2023-06-23,17:00:00,347,152,195,FMN 18 Binnensingel Westkant
665,Uitbreidingstraat 390,2023-06-23,18:00:00,285,138,147,FMN 18 Binnensingel Westkant
665,Uitbreidingstraat 390,2023-06-23,19:00:00,250,130,120,FMN 18 Binnensingel Westkant
665,Uitbreidingstraat 390,2023-06-23,20:00:00,188,89,99,FMN 18 Binnensingel Westkant
665,Uitbreidingstraat 390,2023-06-23,21:00:00,143,63,80,FMN 18 Binnensingel Westkant
665,Uitbreidingstraat 390,2023-06-23,22:00:00,155,82,73,FMN 18 Binnensingel Westkant
665,Uitbreidingstraat 390,2023-06-23,23:00:00,133,77,56,FMN 18 Binnensingel Westkant
665,Uitbreidingstraat 390,2023-06-24,00:00:00,72,60,12,FMN 18 Binnensingel Westkant
665,Uitbreidingstraat 390,2023-06-24,01:00:00,55,43,12,FMN 18 Binnensingel Westkant
665,Uitbreidingstraat 390,2023-06-24,02:00:00,32,27,5,FMN 18 Binnensingel Westkant
665,Uitbreidingstraat 390,2023-06-24,03:00:00,31,26,5,FMN 18 Binnensingel Westkant
665,Uitbreidingstraat 390,2023-06-24,04:00:00,29,26,3,FMN 18 Binnensingel Westkant
665,Uitbreidingstraat 390,2023-06-24,05:00:00,25,21,4,FMN 18 Binnensingel Westkant
665,Uitbreidingstraat 390,2023-06-24,06:00:00,36,31,5,FMN 18 Binnensingel Westkant
665,Uitbreidingstraat 390,2023-06-24,07:00:00,28,24,4,FMN 18 Binnensingel Westkant
665,Uitbreidingstraat 390,2023-06-24,08:00:00,62,51,11,FMN 18 Binnensingel Westkant
665,Uitbreidingstraat 390,2023-06-24,09:00:00,118,92,26,FMN 18 Binnensingel Westkant
665,Uitbreidingstraat 390,2023-06-24,10:00:00,139,110,29,FMN 18 Binnensingel Westkant
665,Uitbreidingstraat 390,2023-06-24,11:00:00,133,102,31,FMN 18 Binnensingel Westkant
665,Uitbreidingstraat 390,2023-06-24,12:00:00,164,121,43,FMN 18 Binnensingel Westkant
665,Uitbreidingstraat 390,2023-06-24,13:00:00,140,118,22,FMN 18 Binnensingel Westkant
665,Uitbreidingstraat 390,2023-06-24,14:00:00,152,117,35,FMN 18 Binnensingel Westkant
665,Uitbreidingstraat 390,2023-06-24,15:00:00,138,113,25,FMN 18 Binnensingel Westkant
665,Uitbreidingstraat 390,2023-06-24,16:00:00,143,108,35,FMN 18 Binnensingel Westkant
665,Uitbreidingstraat 390,2023-06-24,17:00:00,162,124,38,FMN 18 Binnensingel Westkant
665,Uitbreidingstraat 390,2023-06-24,18:00:00,157,125,32,FMN 18 Binnensingel Westkant
665,Uitbreidingstraat 390,2023-06-24,19:00:00,132,103,29,FMN 18 Binnensingel Westkant
665,Uitbreidingstraat 390,2023-06-24,20:00:00,106,78,28,FMN 18 Binnensingel Westkant
665,Uitbreidingstraat 390,2023-06-24,21:00:00,95,75,20,FMN 18 Binnensingel Westkant
665,Uitbreidingstraat 390,2023-06-24,22:00:00,89,64,25,FMN 18 Binnensingel Westkant
665,Uitbreidingstraat 390,2023-06-24,23:00:00,96,73,23,FMN 18 Binnensingel Westkant
665,Uitbreidingstraat 390,2023-06-25,00:00:00,0,0,0,FMN 18 Binnensingel Westkant
665,Uitbreidingstraat 390,2023-06-25,01:00:00,45,36,9,FMN 18 Binnensingel Westkant
665,Uitbreidingstraat 390,2023-06-25,02:00:00,23,17,6,FMN 18 Binnensingel Westkant
665,Uitbreidingstraat 390,2023-06-25,03:00:00,35,25,10,FMN 18 Binnensingel Westkant
665,Uitbreidingstraat 390,2023-06-25,04:00:00,21,15,6,FMN 18 Binnensingel Westkant
665,Uitbreidingstraat 390,2023-06-25,05:00:00,20,17,3,FMN 18 Binnensingel Westkant
665,Uitbreidingstraat 390,2023-06-25,06:00:00,26,22,4,FMN 18 Binnensingel Westkant
665,Uitbreidingstraat 390,2023-06-25,07:00:00,27,19,8,FMN 18 Binnensingel Westkant
665,Uitbreidingstraat 390,2023-06-25,08:00:00,36,28,8,FMN 18 Binnensingel Westkant
665,Uitbreidingstraat 390,2023-06-25,09:00:00,71,61,10,FMN 18 Binnensingel Westkant
665,Uitbreidingstraat 390,2023-06-25,10:00:00,88,75,13,FMN 18 Binnensingel Westkant
665,Uitbreidingstraat 390,2023-06-25,11:00:00,98,81,17,FMN 18 Binnensingel Westkant
665,Uitbreidingstraat 390,2023-06-25,12:00:00,119,102,17,FMN 18 Binnensingel Westkant
665,Uitbreidingstraat 390,2023-06-25,13:00:00,105,80,25,FMN 18 Binnensingel Westkant
665,Uitbreidingstraat 390,2023-06-25,14:00:00,121,98,23,FMN 18 Binnensingel Westkant
665,Uitbreidingstraat 390,2023-06-25,15:00:00,106,87,19,FMN 18 Binnensingel Westkant
665,Uitbreidingstraat 390,2023-06-25,16:00:00,122,101,21,FMN 18 Binnensingel Westkant
665,Uitbreidingstraat 390,2023-06-25,17:00:00,123,100,23,FMN 18 Binnensingel Westkant
665,Uitbreidingstraat 390,2023-06-25,18:00:00,115,91,24,FMN 18 Binnensingel Westkant
665,Uitbreidingstraat 390,2023-06-25,19:00:00,100,82,18,FMN 18 Binnensingel Westkant
665,Uitbreidingstraat 390,2023-06-25,20:00:00,91,70,21,FMN 18 Binnensingel Westkant
665,Uitbreidingstraat 390,2023-06-25,21:00:00,79,65,14,FMN 18 Binnensingel Westkant
665,Uitbreidingstraat 390,2023-06-25,22:00:00,62,55,7,FMN 18 Binnensingel Westkant
665,Uitbreidingstraat 390,2023-06-25,23:00:00,48,46,2,FMN 18 Binnensingel Westkant
665,Uitbreidingstraat 390,2023-06-26,00:00:00,0,0,0,FMN 18 Binnensingel Westkant
665,Uitbreidingstraat 390,2023-06-26,01:00:00,7,4,3,FMN 18 Binnensingel Westkant
665,Uitbreidingstraat 390,2023-06-26,02:00:00,2,2,0,FMN 18 Binnensingel Westkant
665,Uitbreidingstraat 390,2023-06-26,03:00:00,4,3,1,FMN 18 Binnensingel Westkant
665,Uitbreidingstraat 390,2023-06-26,04:00:00,15,13,2,FMN 18 Binnensingel Westkant
665,Uitbreidingstraat 390,2023-06-26,05:00:00,35,29,6,FMN 18 Binnensingel Westkant
665,Uitbreidingstraat 390,2023-06-26,06:00:00,72,53,19,FMN 18 Binnensingel Westkant
665,Uitbreidingstraat 390,2023-06-26,07:00:00,249,184,65,FMN 18 Binnensingel Westkant
665,Uitbreidingstraat 390,2023-06-26,08:00:00,460,343,117,FMN 18 Binnensingel Westkant
665,Uitbreidingstraat 390,2023-06-26,09:00:00,190,138,52,FMN 18 Binnensingel Westkant
665,Uitbreidingstraat 390,2023-06-26,10:00:00,131,89,42,FMN 18 Binnensingel Westkant
665,Uitbreidingstraat 390,2023-06-26,11:00:00,87,55,32,FMN 18 Binnensingel Westkant
665,Uitbreidingstraat 390,2023-06-26,12:00:00,158,101,57,FMN 18 Binnensingel Westkant
665,Uitbreidingstraat 390,2023-06-26,13:00:00,131,92,39,FMN 18 Binnensingel Westkant
665,Uitbreidingstraat 390,2023-06-26,14:00:00,125,88,37,FMN 18 Binnensingel Westkant
665,Uitbreidingstraat 390,2023-06-26,15:00:00,192,115,77,FMN 18 Binnensingel Westkant
665,Uitbreidingstraat 390,2023-06-26,16:00:00,286,178,108,FMN 18 Binnensingel Westkant
665,Uitbreidingstraat 390,2023-06-26,17:00:00,303,195,108,FMN 18 Binnensingel Westkant
665,Uitbreidingstraat 390,2023-06-26,18:00:00,233,163,70,FMN 18 Binnensingel Westkant
665,Uitbreidingstraat 390,2023-06-26,19:00:00,133,96,37,FMN 18 Binnensingel Westkant
665,Uitbreidingstraat 390,2023-06-26,20:00:00,78,50,28,FMN 18 Binnensingel Westkant
665,Uitbreidingstraat 390,2023-06-26,21:00:00,66,40,26,FMN 18 Binnensingel Westkant
665,Uitbreidingstraat 390,2023-06-26,22:00:00,60,44,16,FMN 18 Binnensingel Westkant
665,Uitbreidingstraat 390,2023-06-26,23:00:00,33,25,8,FMN 18 Binnensingel Westkant
665,Uitbreidingstraat 390,2023-06-27,00:00:00,0,0,0,FMN 18 Binnensingel Westkant
665,Uitbreidingstraat 390,2023-06-27,01:00:00,6,5,1,FMN 18 Binnensingel Westkant
665,Uitbreidingstraat 390,2023-06-27,02:00:00,3,3,0,FMN 18 Binnensingel Westkant
665,Uitbreidingstraat 390,2023-06-27,03:00:00,7,5,2,FMN 18 Binnensingel Westkant
665,Uitbreidingstraat 390,2023-06-27,04:00:00,10,7,3,FMN 18 Binnensingel Westkant
665,Uitbreidingstraat 390,2023-06-27,05:00:00,43,38,5,FMN 18 Binnensingel Westkant
665,Uitbreidingstraat 390,2023-06-27,06:00:00,72,51,21,FMN 18 Binnensingel Westkant
665,Uitbreidingstraat 390,2023-06-27,07:00:00,272,204,68,FMN 18 Binnensingel Westkant
665,Uitbreidingstraat 390,2023-06-27,08:00:00,498,378,120,FMN 18 Binnensingel Westkant
665,Uitbreidingstraat 390,2023-06-27,09:00:00,200,156,44,FMN 18 Binnensingel Westkant
665,Uitbreidingstraat 390,2023-06-27,10:00:00,115,86,29,FMN 18 Binnensingel Westkant
665,Uitbreidingstraat 390,2023-06-27,11:00:00,110,79,31,FMN 18 Binnensingel Westkant
665,Uitbreidingstraat 390,2023-06-27,12:00:00,152,100,52,FMN 18 Binnensingel Westkant
665,Uitbreidingstraat 390,2023-06-27,13:00:00,136,101,35,FMN 18 Binnensingel Westkant
665,Uitbreidingstraat 390,2023-06-27,14:00:00,106,72,34,FMN 18 Binnensingel Westkant
665,Uitbreidingstraat 390,2023-06-27,15:00:00,190,124,66,FMN 18 Binnensingel Westkant
665,Uitbreidingstraat 390,2023-06-27,16:00:00,315,190,125,FMN 18 Binnensingel Westkant
665,Uitbreidingstraat 390,2023-06-27,17:00:00,318,209,109,FMN 18 Binnensingel Westkant
665,Uitbreidingstraat 390,2023-06-27,18:00:00,235,159,76,FMN 18 Binnensingel Westkant
665,Uitbreidingstraat 390,2023-06-27,19:00:00,135,96,39,FMN 18 Binnensingel Westkant
665,Uitbreidingstraat 390,2023-06-27,20:00:00,96,65,31,FMN 18 Binnensingel Westkant
665,Uitbreidingstraat 390,2023-06-27,21:00:00,71,52,19,FMN 18 Binnensingel Westkant
665,Uitbreidingstraat 390,2023-06-27,22:00:00,79,57,22,FMN 18 Binnensingel Westkant
665,Uitbreidingstraat 390,2023-06-27,23:00:00,51,42,9,FMN 18 Binnensingel Westkant
665,Uitbreidingstraat 390,2023-06-28,00:00:00,22,15,7,FMN 18 Binnensingel Westkant
665,Uitbreidingstraat 390,2023-06-28,01:00:00,6,3,3,FMN 18 Binnensingel Westkant
665,Uitbreidingstraat 390,2023-06-28,02:00:00,5,3,2,FMN 18 Binnensingel Westkant
665,Uitbreidingstraat 390,2023-06-28,03:00:00,5,5,0,FMN 18 Binnensingel Westkant
665,Uitbreidingstraat 390,2023-06-28,04:00:00,11,9,2,FMN 18 Binnensingel Westkant
665,Uitbreidingstraat 390,2023-06-28,05:00:00,42,33,9,FMN 18 Binnensingel Westkant
665,Uitbreidingstraat 390,2023-06-28,06:00:00,86,59,27,FMN 18 Binnensingel Westkant
665,Uitbreidingstraat 390,2023-06-28,07:00:00,231,170,61,FMN 18 Binnensingel Westkant
665,Uitbreidingstraat 390,2023-06-28,08:00:00,444,332,112,FMN 18 Binnensingel Westkant
665,Uitbreidingstraat 390,2023-06-28,09:00:00,176,127,49,FMN 18 Binnensingel Westkant
665,Uitbreidingstraat 390,2023-06-28,10:00:00,132,96,36,FMN 18 Binnensingel Westkant
665,Uitbreidingstraat 390,2023-06-28,11:00:00,99,68,31,FMN 18 Binnensingel Westkant
665,Uitbreidingstraat 390,2023-06-28,12:00:00,249,153,96,FMN 18 Binnensingel Westkant
665,Uitbreidingstraat 390,2023-06-28,13:00:00,200,125,75,FMN 18 Binnensingel Westkant
665,Uitbreidingstraat 390,2023-06-28,14:00:00,116,74,42,FMN 18 Binnensingel Westkant
665,Uitbreidingstraat 390,2023-06-28,15:00:00,162,104,58,FMN 18 Binnensingel Westkant
665,Uitbreidingstraat 390,2023-06-28,16:00:00,207,134,73,FMN 18 Binnensingel Westkant
665,Uitbreidingstraat 390,2023-06-28,17:00:00,294,194,100,FMN 18 Binnensingel Westkant
665,Uitbreidingstraat 390,2023-06-28,18:00:00,217,146,71,FMN 18 Binnensingel Westkant
665,Uitbreidingstraat 390,2023-06-28,19:00:00,136,91,45,FMN 18 Binnensingel Westkant
665,Uitbreidingstraat 390,2023-06-28,20:00:00,93,62,31,FMN 18 Binnensingel Westkant
665,Uitbreidingstraat 390,2023-06-28,21:00:00,75,45,30,FMN 18 Binnensingel Westkant
665,Uitbreidingstraat 390,2023-06-28,22:00:00,65,43,22,FMN 18 Binnensingel Westkant
665,Uitbreidingstraat 390,2023-06-28,23:00:00,55,42,13,FMN 18 Binnensingel Westkant
665,Uitbreidingstraat 390,2023-06-29,00:00:00,0,0,0,FMN 18 Binnensingel Westkant
665,Uitbreidingstraat 390,2023-06-29,01:00:00,8,6,2,FMN 18 Binnensingel Westkant
665,Uitbreidingstraat 390,2023-06-29,02:00:00,2,2,0,FMN 18 Binnensingel Westkant
665,Uitbreidingstraat 390,2023-06-29,03:00:00,4,3,1,FMN 18 Binnensingel Westkant
665,Uitbreidingstraat 390,2023-06-29,04:00:00,9,7,2,FMN 18 Binnensingel Westkant
665,Uitbreidingstraat 390,2023-06-29,05:00:00,38,30,8,FMN 18 Binnensingel Westkant
665,Uitbreidingstraat 390,2023-06-29,06:00:00,55,36,19,FMN 18 Binnensingel Westkant
665,Uitbreidingstraat 390,2023-06-29,07:00:00,238,169,69,FMN 18 Binnensingel Westkant
665,Uitbreidingstraat 390,2023-06-29,08:00:00,421,316,105,FMN 18 Binnensingel Westkant
665,Uitbreidingstraat 390,2023-06-29,09:00:00,169,130,39,FMN 18 Binnensingel Westkant
665,Uitbreidingstraat 390,2023-06-29,10:00:00,130,84,46,FMN 18 Binnensingel Westkant
665,Uitbreidingstraat 390,2023-06-29,11:00:00,90,59,31,FMN 18 Binnensingel Westkant
665,Uitbreidingstraat 390,2023-06-29,12:00:00,131,86,45,FMN 18 Binnensingel Westkant
665,Uitbreidingstraat 390,2023-06-29,13:00:00,131,95,36,FMN 18 Binnensingel Westkant
665,Uitbreidingstraat 390,2023-06-29,14:00:00,108,78,30,FMN 18 Binnensingel Westkant
665,Uitbreidingstraat 390,2023-06-29,15:00:00,188,118,70,FMN 18 Binnensingel Westkant
665,Uitbreidingstraat 390,2023-06-29,16:00:00,274,159,115,FMN 18 Binnensingel Westkant
665,Uitbreidingstraat 390,2023-06-29,17:00:00,269,173,96,FMN 18 Binnensingel Westkant
665,Uitbreidingstraat 390,2023-06-29,18:00:00,234,158,76,FMN 18 Binnensingel Westkant
665,Uitbreidingstraat 390,2023-06-29,19:00:00,144,104,40,FMN 18 Binnensingel Westkant
665,Uitbreidingstraat 390,2023-06-29,20:00:00,99,66,33,FMN 18 Binnensingel Westkant
665,Uitbreidingstraat 390,2023-06-29,21:00:00,76,50,26,FMN 18 Binnensingel Westkant
665,Uitbreidingstraat 390,2023-06-29,22:00:00,78,53,25,FMN 18 Binnensingel Westkant
665,Uitbreidingstraat 390,2023-06-29,23:00:00,55,39,16,FMN 18 Binnensingel Westkant
665,Uitbreidingstraat 390,2023-06-30,00:00:00,0,0,0,FMN 18 Binnensingel Westkant
665,Uitbreidingstraat 390,2023-06-30,01:00:00,27,17,10,FMN 18 Binnensingel Westkant
665,Uitbreidingstraat 390,2023-06-30,02:00:00,8,5,3,FMN 18 Binnensingel Westkant
665,Uitbreidingstraat 390,2023-06-30,03:00:00,11,8,3,FMN 18 Binnensingel Westkant
665,Uitbreidingstraat 390,2023-06-30,04:00:00,21,18,3,FMN 18 Binnensingel Westkant
665,Uitbreidingstraat 390,2023-06-30,05:00:00,44,37,7,FMN 18 Binnensingel Westkant
665,Uitbreidingstraat 390,2023-06-30,06:00:00,75,55,20,FMN 18 Binnensingel Westkant
665,Uitbreidingstraat 390,2023-06-30,07:00:00,225,174,51,FMN 18 Binnensingel Westkant
665,Uitbreidingstraat 390,2023-06-30,08:00:00,440,346,94,FMN 18 Binnensingel Westkant
665,Uitbreidingstraat 390,2023-06-30,09:00:00,164,124,40,FMN 18 Binnensingel Westkant
665,Uitbreidingstraat 390,2023-06-30,10:00:00,130,93,37,FMN 18 Binnensingel Westkant
665,Uitbreidingstraat 390,2023-06-30,11:00:00,110,71,39,FMN 18 Binnensingel Westkant
665,Uitbreidingstraat 390,2023-06-30,12:00:00,160,104,56,FMN 18 Binnensingel Westkant
665,Uitbreidingstraat 390,2023-06-30,13:00:00,144,101,43,FMN 18 Binnensingel Westkant
665,Uitbreidingstraat 390,2023-06-30,14:00:00,149,101,48,FMN 18 Binnensingel Westkant
665,Uitbreidingstraat 390,2023-06-30,15:00:00,200,129,71,FMN 18 Binnensingel Westkant
665,Uitbreidingstraat 390,2023-06-30,16:00:00,294,172,122,FMN 18 Binnensingel Westkant
665,Uitbreidingstraat 390,2023-06-30,17:00:00,252,173,79,FMN 18 Binnensingel Westkant
665,Uitbreidingstraat 390,2023-06-30,18:00:00,197,139,58,FMN 18 Binnensingel Westkant
665,Uitbreidingstraat 390,2023-06-30,19:00:00,148,104,44,FMN 18 Binnensingel Westkant
665,Uitbreidingstraat 390,2023-06-30,20:00:00,96,73,23,FMN 18 Binnensingel Westkant
665,Uitbreidingstraat 390,2023-06-30,21:00:00,79,54,25,FMN 18 Binnensingel Westkant
665,Uitbreidingstraat 390,2023-06-30,22:00:00,82,56,26,FMN 18 Binnensingel Westkant
665,Uitbreidingstraat 390,2023-06-30,23:00:00,81,58,23,FMN 18 Binnensingel Westkant
665,Uitbreidingstraat 390,2023-07-01,00:00:00,58,38,20,FMN 18 Binnensingel Westkant
665,Uitbreidingstraat 390,2023-07-01,01:00:00,37,27,10,FMN 18 Binnensingel Westkant
665,Uitbreidingstraat 390,2023-07-01,02:00:00,24,16,8,FMN 18 Binnensingel Westkant
665,Uitbreidingstraat 390,2023-07-01,03:00:00,12,6,6,FMN 18 Binnensingel Westkant
665,Uitbreidingstraat 390,2023-07-01,04:00:00,8,8,0,FMN 18 Binnensingel Westkant
665,Uitbreidingstraat 390,2023-07-01,05:00:00,22,14,8,FMN 18 Binnensingel Westkant
665,Uitbreidingstraat 390,2023-07-01,06:00:00,27,23,4,FMN 18 Binnensingel Westkant
665,Uitbreidingstraat 390,2023-07-01,07:00:00,24,15,9,FMN 18 Binnensingel Westkant
665,Uitbreidingstraat 390,2023-07-01,08:00:00,36,27,9,FMN 18 Binnensingel Westkant
665,Uitbreidingstraat 390,2023-07-01,09:00:00,68,47,21,FMN 18 Binnensingel Westkant
665,Uitbreidingstraat 390,2023-07-01,10:00:00,80,56,24,FMN 18 Binnensingel Westkant
665,Uitbreidingstraat 390,2023-07-01,11:00:00,75,54,21,FMN 18 Binnensingel Westkant
665,Uitbreidingstraat 390,2023-07-01,12:00:00,100,63,37,FMN 18 Binnensingel Westkant
665,Uitbreidingstraat 390,2023-07-01,13:00:00,93,61,32,FMN 18 Binnensingel Westkant
665,Uitbreidingstraat 390,2023-07-01,14:00:00,93,65,28,FMN 18 Binnensingel Westkant
665,Uitbreidingstraat 390,2023-07-01,15:00:00,92,55,37,FMN 18 Binnensingel Westkant
665,Uitbreidingstraat 390,2023-07-01,16:00:00,85,54,31,FMN 18 Binnensingel Westkant
665,Uitbreidingstraat 390,2023-07-01,17:00:00,94,61,33,FMN 18 Binnensingel Westkant
665,Uitbreidingstraat 390,2023-07-01,18:00:00,84,66,18,FMN 18 Binnensingel Westkant
665,Uitbreidingstraat 390,2023-07-01,19:00:00,94,60,34,FMN 18 Binnensingel Westkant
665,Uitbreidingstraat 390,2023-07-01,20:00:00,72,43,29,FMN 18 Binnensingel Westkant
665,Uitbreidingstraat 390,2023-07-01,21:00:00,43,30,13,FMN 18 Binnensingel Westkant
665,Uitbreidingstraat 390,2023-07-01,22:00:00,47,28,19,FMN 18 Binnensingel Westkant
665,Uitbreidingstraat 390,2023-07-01,23:00:00,48,37,11,FMN 18 Binnensingel Westkant
665,Uitbreidingstraat 390,2023-07-02,00:00:00,0,0,0,FMN 18 Binnensingel Westkant
665,Uitbreidingstraat 390,2023-07-02,01:00:00,48,33,15,FMN 18 Binnensingel Westkant
665,Uitbreidingstraat 390,2023-07-02,02:00:00,28,23,5,FMN 18 Binnensingel Westkant
665,Uitbreidingstraat 390,2023-07-02,03:00:00,21,18,3,FMN 18 Binnensingel Westkant
665,Uitbreidingstraat 390,2023-07-02,04:00:00,20,15,5,FMN 18 Binnensingel Westkant
665,Uitbreidingstraat 390,2023-07-02,05:00:00,12,7,5,FMN 18 Binnensingel Westkant
665,Uitbreidingstraat 390,2023-07-02,06:00:00,31,24,7,FMN 18 Binnensingel Westkant
665,Uitbreidingstraat 390,2023-07-02,07:00:00,18,11,7,FMN 18 Binnensingel Westkant
665,Uitbreidingstraat 390,2023-07-02,08:00:00,35,24,11,FMN 18 Binnensingel Westkant
665,Uitbreidingstraat 390,2023-07-02,09:00:00,63,49,14,FMN 18 Binnensingel Westkant
665,Uitbreidingstraat 390,2023-07-02,10:00:00,82,62,20,FMN 18 Binnensingel Westkant
665,Uitbreidingstraat 390,2023-07-02,11:00:00,76,63,13,FMN 18 Binnensingel Westkant
665,Uitbreidingstraat 390,2023-07-02,12:00:00,108,87,21,FMN 18 Binnensingel Westkant
665,Uitbreidingstraat 390,2023-07-02,13:00:00,105,77,28,FMN 18 Binnensingel Westkant
665,Uitbreidingstraat 390,2023-07-02,14:00:00,113,86,27,FMN 18 Binnensingel Westkant
665,Uitbreidingstraat 390,2023-07-02,15:00:00,97,77,20,FMN 18 Binnensingel Westkant
665,Uitbreidingstraat 390,2023-07-02,16:00:00,103,77,26,FMN 18 Binnensingel Westkant
665,Uitbreidingstraat 390,2023-07-02,17:00:00,112,89,23,FMN 18 Binnensingel Westkant
665,Uitbreidingstraat 390,2023-07-02,18:00:00,89,73,16,FMN 18 Binnensingel Westkant
665,Uitbreidingstraat 390,2023-07-02,19:00:00,83,70,13,FMN 18 Binnensingel Westkant
665,Uitbreidingstraat 390,2023-07-02,20:00:00,75,58,17,FMN 18 Binnensingel Westkant
665,Uitbreidingstraat 390,2023-07-02,21:00:00,75,58,17,FMN 18 Binnensingel Westkant
665,Uitbreidingstraat 390,2023-07-02,22:00:00,48,42,6,FMN 18 Binnensingel Westkant
665,Uitbreidingstraat 390,2023-07-02,23:00:00,36,30,6,FMN 18 Binnensingel Westkant
665,Uitbreidingstraat 390,2023-07-03,00:00:00,13,11,2,FMN 18 Binnensingel Westkant
665,Uitbreidingstraat 390,2023-07-03,01:00:00,9,6,3,FMN 18 Binnensingel Westkant
665,Uitbreidingstraat 390,2023-07-03,02:00:00,6,6,0,FMN 18 Binnensingel Westkant
665,Uitbreidingstraat 390,2023-07-03,03:00:00,6,4,2,FMN 18 Binnensingel Westkant
665,Uitbreidingstraat 390,2023-07-03,04:00:00,9,7,2,FMN 18 Binnensingel Westkant
665,Uitbreidingstraat 390,2023-07-03,05:00:00,33,23,10,FMN 18 Binnensingel Westkant
665,Uitbreidingstraat 390,2023-07-03,06:00:00,47,34,13,FMN 18 Binnensingel Westkant
665,Uitbreidingstraat 390,2023-07-03,07:00:00,184,128,56,FMN 18 Binnensingel Westkant
665,Uitbreidingstraat 390,2023-07-03,08:00:00,367,246,121,FMN 18 Binnensingel Westkant
665,Uitbreidingstraat 390,2023-07-03,09:00:00,119,84,35,FMN 18 Binnensingel Westkant
665,Uitbreidingstraat 390,2023-07-03,10:00:00,91,60,31,FMN 18 Binnensingel Westkant
665,Uitbreidingstraat 390,2023-07-03,11:00:00,66,39,27,FMN 18 Binnensingel Westkant
665,Uitbreidingstraat 390,2023-07-03,12:00:00,118,72,46,FMN 18 Binnensingel Westkant
665,Uitbreidingstraat 390,2023-07-03,13:00:00,103,68,35,FMN 18 Binnensingel Westkant
665,Uitbreidingstraat 390,2023-07-03,14:00:00,106,71,35,FMN 18 Binnensingel Westkant
665,Uitbreidingstraat 390,2023-07-03,15:00:00,169,96,73,FMN 18 Binnensingel Westkant
665,Uitbreidingstraat 390,2023-07-03,16:00:00,221,122,99,FMN 18 Binnensingel Westkant
665,Uitbreidingstraat 390,2023-07-03,17:00:00,256,152,104,FMN 18 Binnensingel Westkant
665,Uitbreidingstraat 390,2023-07-03,18:00:00,169,109,60,FMN 18 Binnensingel Westkant
665,Uitbreidingstraat 390,2023-07-03,19:00:00,112,70,42,FMN 18 Binnensingel Westkant
665,Uitbreidingstraat 390,2023-07-03,20:00:00,69,43,26,FMN 18 Binnensingel Westkant
665,Uitbreidingstraat 390,2023-07-03,21:00:00,45,27,18,FMN 18 Binnensingel Westkant
665,Uitbreidingstraat 390,2023-07-03,22:00:00,48,32,16,FMN 18 Binnensingel Westkant
665,Uitbreidingstraat 390,2023-07-03,23:00:00,28,18,10,FMN 18 Binnensingel Westkant
665,Uitbreidingstraat 390,2023-07-04,00:00:00,0,0,0,FMN 18 Binnensingel Westkant
665,Uitbreidingstraat 390,2023-07-04,01:00:00,0,0,0,FMN 18 Binnensingel Westkant
665,Uitbreidingstraat 390,2023-07-04,02:00:00,0,0,0,FMN 18 Binnensingel Westkant
665,Uitbreidingstraat 390,2023-07-04,03:00:00,0,0,0,FMN 18 Binnensingel Westkant
665,Uitbreidingstraat 390,2023-07-04,04:00:00,0,0,0,FMN 18 Binnensingel Westkant
665,Uitbreidingstraat 390,2023-07-04,05:00:00,0,0,0,FMN 18 Binnensingel Westkant
665,Uitbreidingstraat 390,2023-07-04,06:00:00,0,0,0,FMN 18 Binnensingel Westkant
665,Uitbreidingstraat 390,2023-07-04,07:00:00,0,0,0,FMN 18 Binnensingel Westkant
665,Uitbreidingstraat 390,2023-07-04,08:00:00,0,0,0,FMN 18 Binnensingel Westkant
665,Uitbreidingstraat 390,2023-07-04,09:00:00,6,5,1,FMN 18 Binnensingel Westkant
665,Uitbreidingstraat 390,2023-07-04,10:00:00,92,52,40,FMN 18 Binnensingel Westkant
665,Uitbreidingstraat 390,2023-07-04,11:00:00,88,35,53,FMN 18 Binnensingel Westkant
665,Uitbreidingstraat 390,2023-07-04,12:00:00,102,46,56,FMN 18 Binnensingel Westkant
665,Uitbreidingstraat 390,2023-07-04,13:00:00,81,35,46,FMN 18 Binnensingel Westkant
665,Uitbreidingstraat 390,2023-07-04,14:00:00,79,25,54,FMN 18 Binnensingel Westkant
665,Uitbreidingstraat 390,2023-07-04,15:00:00,110,46,64,FMN 18 Binnensingel Westkant
665,Uitbreidingstraat 390,2023-07-04,16:00:00,228,91,137,FMN 18 Binnensingel Westkant
665,Uitbreidingstraat 390,2023-07-04,17:00:00,219,76,143,FMN 18 Binnensingel Westkant
665,Uitbreidingstraat 390,2023-07-04,18:00:00,161,67,94,FMN 18 Binnensingel Westkant
665,Uitbreidingstraat 390,2023-07-04,19:00:00,79,38,41,FMN 18 Binnensingel Westkant
665,Uitbreidingstraat 390,2023-07-04,20:00:00,58,22,36,FMN 18 Binnensingel Westkant
665,Uitbreidingstraat 390,2023-07-04,21:00:00,34,14,20,FMN 18 Binnensingel Westkant
665,Uitbreidingstraat 390,2023-07-04,22:00:00,44,18,26,FMN 18 Binnensingel Westkant
665,Uitbreidingstraat 390,2023-07-04,23:00:00,30,14,16,FMN 18 Binnensingel Westkant
665,Uitbreidingstraat 390,2023-07-05,00:00:00,7,1,6,FMN 18 Binnensingel Westkant
665,Uitbreidingstraat 390,2023-07-05,01:00:00,5,2,3,FMN 18 Binnensingel Westkant
665,Uitbreidingstraat 390,2023-07-05,02:00:00,4,1,3,FMN 18 Binnensingel Westkant
665,Uitbreidingstraat 390,2023-07-05,03:00:00,2,1,1,FMN 18 Binnensingel Westkant
665,Uitbreidingstraat 390,2023-07-05,04:00:00,9,1,8,FMN 18 Binnensingel Westkant
665,Uitbreidingstraat 390,2023-07-05,05:00:00,23,13,10,FMN 18 Binnensingel Westkant
665,Uitbreidingstraat 390,2023-07-05,06:00:00,28,14,14,FMN 18 Binnensingel Westkant
665,Uitbreidingstraat 390,2023-07-05,07:00:00,62,24,38,FMN 18 Binnensingel Westkant
665,Uitbreidingstraat 390,2023-07-05,08:00:00,86,47,39,FMN 18 Binnensingel Westkant
665,Uitbreidingstraat 390,2023-07-05,09:00:00,72,39,33,FMN 18 Binnensingel Westkant
665,Uitbreidingstraat 390,2023-07-05,10:00:00,58,28,30,FMN 18 Binnensingel Westkant
665,Uitbreidingstraat 390,2023-07-05,11:00:00,39,20,19,FMN 18 Binnensingel Westkant
665,Uitbreidingstraat 390,2023-07-05,12:00:00,60,24,36,FMN 18 Binnensingel Westkant
665,Uitbreidingstraat 390,2023-07-05,13:00:00,45,22,23,FMN 18 Binnensingel Westkant
665,Uitbreidingstraat 390,2023-07-05,14:00:00,66,28,38,FMN 18 Binnensingel Westkant
665,Uitbreidingstraat 390,2023-07-05,15:00:00,61,24,37,FMN 18 Binnensingel Westkant
665,Uitbreidingstraat 390,2023-07-05,16:00:00,102,41,61,FMN 18 Binnensingel Westkant
665,Uitbreidingstraat 390,2023-07-05,17:00:00,150,55,95,FMN 18 Binnensingel Westkant
665,Uitbreidingstraat 390,2023-07-05,18:00:00,69,34,35,FMN 18 Binnensingel Westkant
665,Uitbreidingstraat 390,2023-07-05,19:00:00,62,29,33,FMN 18 Binnensingel Westkant
665,Uitbreidingstraat 390,2023-07-05,20:00:00,40,19,21,FMN 18 Binnensingel Westkant
665,Uitbreidingstraat 390,2023-07-05,21:00:00,33,10,23,FMN 18 Binnensingel Westkant
665,Uitbreidingstraat 390,2023-07-05,22:00:00,42,12,30,FMN 18 Binnensingel Westkant
665,Uitbreidingstraat 390,2023-07-05,23:00:00,25,10,15,FMN 18 Binnensingel Westkant
665,Uitbreidingstraat 390,2023-07-06,00:00:00,20,11,9,FMN 18 Binnensingel Westkant
665,Uitbreidingstraat 390,2023-07-06,01:00:00,1,0,1,FMN 18 Binnensingel Westkant
665,Uitbreidingstraat 390,2023-07-06,02:00:00,2,0,2,FMN 18 Binnensingel Westkant
665,Uitbreidingstraat 390,2023-07-06,03:00:00,6,3,3,FMN 18 Binnensingel Westkant
665,Uitbreidingstraat 390,2023-07-06,04:00:00,8,3,5,FMN 18 Binnensingel Westkant
665,Uitbreidingstraat 390,2023-07-06,05:00:00,18,11,7,FMN 18 Binnensingel Westkant
665,Uitbreidingstraat 390,2023-07-06,06:00:00,31,17,14,FMN 18 Binnensingel Westkant
665,Uitbreidingstraat 390,2023-07-06,07:00:00,64,24,40,FMN 18 Binnensingel Westkant
665,Uitbreidingstraat 390,2023-07-06,08:00:00,147,81,66,FMN 18 Binnensingel Westkant
665,Uitbreidingstraat 390,2023-07-06,09:00:00,59,30,29,FMN 18 Binnensingel Westkant
665,Uitbreidingstraat 390,2023-07-06,10:00:00,45,25,20,FMN 18 Binnensingel Westkant
665,Uitbreidingstraat 390,2023-07-06,11:00:00,67,25,42,FMN 18 Binnensingel Westkant
665,Uitbreidingstraat 390,2023-07-06,12:00:00,54,28,26,FMN 18 Binnensingel Westkant
665,Uitbreidingstraat 390,2023-07-06,13:00:00,49,22,27,FMN 18 Binnensingel Westkant
665,Uitbreidingstraat 390,2023-07-06,14:00:00,64,26,38,FMN 18 Binnensingel Westkant
665,Uitbreidingstraat 390,2023-07-06,15:00:00,63,25,38,FMN 18 Binnensingel Westkant
665,Uitbreidingstraat 390,2023-07-06,16:00:00,125,48,77,FMN 18 Binnensingel Westkant
665,Uitbreidingstraat 390,2023-07-06,17:00:00,146,58,88,FMN 18 Binnensingel Westkant
665,Uitbreidingstraat 390,2023-07-06,18:00:00,120,52,68,FMN 18 Binnensingel Westkant
665,Uitbreidingstraat 390,2023-07-06,19:00:00,88,36,52,FMN 18 Binnensingel Westkant
665,Uitbreidingstraat 390,2023-07-06,20:00:00,70,35,35,FMN 18 Binnensingel Westkant
665,Uitbreidingstraat 390,2023-07-06,21:00:00,48,20,28,FMN 18 Binnensingel Westkant
665,Uitbreidingstraat 390,2023-07-06,22:00:00,39,11,28,FMN 18 Binnensingel Westkant
665,Uitbreidingstraat 390,2023-07-06,23:00:00,35,20,15,FMN 18 Binnensingel Westkant
665,Uitbreidingstraat 390,2023-07-07,00:00:00,20,8,12,FMN 18 Binnensingel Westkant
665,Uitbreidingstraat 390,2023-07-07,01:00:00,11,6,5,FMN 18 Binnensingel Westkant
665,Uitbreidingstraat 390,2023-07-07,02:00:00,5,1,4,FMN 18 Binnensingel Westkant
665,Uitbreidingstraat 390,2023-07-07,03:00:00,6,4,2,FMN 18 Binnensingel Westkant
665,Uitbreidingstraat 390,2023-07-07,04:00:00,12,8,4,FMN 18 Binnensingel Westkant
665,Uitbreidingstraat 390,2023-07-07,05:00:00,29,18,11,FMN 18 Binnensingel Westkant
665,Uitbreidingstraat 390,2023-07-07,06:00:00,41,21,20,FMN 18 Binnensingel Westkant
665,Uitbreidingstraat 390,2023-07-07,07:00:00,84,49,35,FMN 18 Binnensingel Westkant
665,Uitbreidingstraat 390,2023-07-07,08:00:00,171,103,68,FMN 18 Binnensingel Westkant
665,Uitbreidingstraat 390,2023-07-07,09:00:00,86,43,43,FMN 18 Binnensingel Westkant
665,Uitbreidingstraat 390,2023-07-07,10:00:00,50,22,28,FMN 18 Binnensingel Westkant
665,Uitbreidingstraat 390,2023-07-07,11:00:00,85,44,41,FMN 18 Binnensingel Westkant
665,Uitbreidingstraat 390,2023-07-07,12:00:00,84,35,49,FMN 18 Binnensingel Westkant
665,Uitbreidingstraat 390,2023-07-07,13:00:00,67,26,41,FMN 18 Binnensingel Westkant
665,Uitbreidingstraat 390,2023-07-07,14:00:00,59,22,37,FMN 18 Binnensingel Westkant
665,Uitbreidingstraat 390,2023-07-07,15:00:00,64,19,45,FMN 18 Binnensingel Westkant
665,Uitbreidingstraat 390,2023-07-07,16:00:00,91,36,55,FMN 18 Binnensingel Westkant
665,Uitbreidingstraat 390,2023-07-07,17:00:00,139,62,77,FMN 18 Binnensingel Westkant
665,Uitbreidingstraat 390,2023-07-07,18:00:00,115,53,62,FMN 18 Binnensingel Westkant
665,Uitbreidingstraat 390,2023-07-07,19:00:00,88,37,51,FMN 18 Binnensingel Westkant
665,Uitbreidingstraat 390,2023-07-07,20:00:00,63,33,30,FMN 18 Binnensingel Westkant
665,Uitbreidingstraat 390,2023-07-07,21:00:00,44,17,27,FMN 18 Binnensingel Westkant
665,Uitbreidingstraat 390,2023-07-07,22:00:00,43,19,24,FMN 18 Binnensingel Westkant
665,Uitbreidingstraat 390,2023-07-07,23:00:00,60,24,36,FMN 18 Binnensingel Westkant
665,Uitbreidingstraat 390,2023-07-08,00:00:00,50,26,24,FMN 18 Binnensingel Westkant
665,Uitbreidingstraat 390,2023-07-08,01:00:00,15,13,2,FMN 18 Binnensingel Westkant
665,Uitbreidingstraat 390,2023-07-08,02:00:00,14,8,6,FMN 18 Binnensingel Westkant
665,Uitbreidingstraat 390,2023-07-08,03:00:00,16,10,6,FMN 18 Binnensingel Westkant
665,Uitbreidingstraat 390,2023-07-08,04:00:00,9,3,6,FMN 18 Binnensingel Westkant
665,Uitbreidingstraat 390,2023-07-08,05:00:00,17,7,10,FMN 18 Binnensingel Westkant
665,Uitbreidingstraat 390,2023-07-08,06:00:00,19,14,5,FMN 18 Binnensingel Westkant
665,Uitbreidingstraat 390,2023-07-08,07:00:00,14,8,6,FMN 18 Binnensingel Westkant
665,Uitbreidingstraat 390,2023-07-08,08:00:00,28,14,14,FMN 18 Binnensingel Westkant
665,Uitbreidingstraat 390,2023-07-08,09:00:00,33,20,13,FMN 18 Binnensingel Westkant
665,Uitbreidingstraat 390,2023-07-08,10:00:00,47,26,21,FMN 18 Binnensingel Westkant
665,Uitbreidingstraat 390,2023-07-08,11:00:00,51,24,27,FMN 18 Binnensingel Westkant
665,Uitbreidingstraat 390,2023-07-08,12:00:00,63,30,33,FMN 18 Binnensingel Westkant
665,Uitbreidingstraat 390,2023-07-08,13:00:00,46,21,25,FMN 18 Binnensingel Westkant
665,Uitbreidingstraat 390,2023-07-08,14:00:00,32,17,15,FMN 18 Binnensingel Westkant
665,Uitbreidingstraat 390,2023-07-08,15:00:00,48,19,29,FMN 18 Binnensingel Westkant
665,Uitbreidingstraat 390,2023-07-08,16:00:00,46,21,25,FMN 18 Binnensingel Westkant
665,Uitbreidingstraat 390,2023-07-08,17:00:00,54,28,26,FMN 18 Binnensingel Westkant
665,Uitbreidingstraat 390,2023-07-08,18:00:00,66,39,27,FMN 18 Binnensingel Westkant
665,Uitbreidingstraat 390,2023-07-08,19:00:00,55,23,32,FMN 18 Binnensingel Westkant
665,Uitbreidingstraat 390,2023-07-08,20:00:00,58,32,26,FMN 18 Binnensingel Westkant
665,Uitbreidingstraat 390,2023-07-08,21:00:00,59,28,31,FMN 18 Binnensingel Westkant
665,Uitbreidingstraat 390,2023-07-08,22:00:00,29,12,17,FMN 18 Binnensingel Westkant
665,Uitbreidingstraat 390,2023-07-08,23:00:00,56,30,26,FMN 18 Binnensingel Westkant
665,Uitbreidingstraat 390,2023-07-09,00:00:00,37,26,11,FMN 18 Binnensingel Westkant
665,Uitbreidingstraat 390,2023-07-09,01:00:00,30,22,8,FMN 18 Binnensingel Westkant
665,Uitbreidingstraat 390,2023-07-09,02:00:00,16,11,5,FMN 18 Binnensingel Westkant
665,Uitbreidingstraat 390,2023-07-09,03:00:00,8,6,2,FMN 18 Binnensingel Westkant
665,Uitbreidingstraat 390,2023-07-09,04:00:00,7,6,1,FMN 18 Binnensingel Westkant
665,Uitbreidingstraat 390,2023-07-09,05:00:00,9,6,3,FMN 18 Binnensingel Westkant
665,Uitbreidingstraat 390,2023-07-09,06:00:00,11,8,3,FMN 18 Binnensingel Westkant
665,Uitbreidingstraat 390,2023-07-09,07:00:00,17,10,7,FMN 18 Binnensingel Westkant
665,Uitbreidingstraat 390,2023-07-09,08:00:00,19,13,6,FMN 18 Binnensingel Westkant
665,Uitbreidingstraat 390,2023-07-09,09:00:00,44,19,25,FMN 18 Binnensingel Westkant
665,Uitbreidingstraat 390,2023-07-09,10:00:00,63,38,25,FMN 18 Binnensingel Westkant
665,Uitbreidingstraat 390,2023-07-09,11:00:00,40,16,24,FMN 18 Binnensingel Westkant
665,Uitbreidingstraat 390,2023-07-09,12:00:00,50,19,31,FMN 18 Binnensingel Westkant
665,Uitbreidingstraat 390,2023-07-09,13:00:00,71,29,42,FMN 18 Binnensingel Westkant
665,Uitbreidingstraat 390,2023-07-09,14:00:00,49,20,29,FMN 18 Binnensingel Westkant
665,Uitbreidingstraat 390,2023-07-09,15:00:00,18,7,11,FMN 18 Binnensingel Westkant
665,Uitbreidingstraat 390,2023-07-09,16:00:00,28,12,16,FMN 18 Binnensingel Westkant
665,Uitbreidingstraat 390,2023-07-09,17:00:00,35,15,20,FMN 18 Binnensingel Westkant
665,Uitbreidingstraat 390,2023-07-09,18:00:00,55,31,24,FMN 18 Binnensingel Westkant
665,Uitbreidingstraat 390,2023-07-09,19:00:00,43,28,15,FMN 18 Binnensingel Westkant
665,Uitbreidingstraat 390,2023-07-09,20:00:00,42,18,24,FMN 18 Binnensingel Westkant
665,Uitbreidingstraat 390,2023-07-09,21:00:00,32,18,14,FMN 18 Binnensingel Westkant
665,Uitbreidingstraat 390,2023-07-09,22:00:00,26,12,14,FMN 18 Binnensingel Westkant
665,Uitbreidingstraat 390,2023-07-09,23:00:00,15,6,9,FMN 18 Binnensingel Westkant
665,Uitbreidingstraat 390,2023-07-10,00:00:00,13,8,5,FMN 18 Binnensingel Westkant
665,Uitbreidingstraat 390,2023-07-10,01:00:00,7,6,1,FMN 18 Binnensingel Westkant
665,Uitbreidingstraat 390,2023-07-10,02:00:00,9,5,4,FMN 18 Binnensingel Westkant
665,Uitbreidingstraat 390,2023-07-10,03:00:00,1,1,0,FMN 18 Binnensingel Westkant
665,Uitbreidingstraat 390,2023-07-10,04:00:00,12,6,6,FMN 18 Binnensingel Westkant
665,Uitbreidingstraat 390,2023-07-10,05:00:00,23,15,8,FMN 18 Binnensingel Westkant
665,Uitbreidingstraat 390,2023-07-10,06:00:00,53,23,30,FMN 18 Binnensingel Westkant
665,Uitbreidingstraat 390,2023-07-10,07:00:00,133,76,57,FMN 18 Binnensingel Westkant
665,Uitbreidingstraat 390,2023-07-10,08:00:00,171,95,76,FMN 18 Binnensingel Westkant
665,Uitbreidingstraat 390,2023-07-10,09:00:00,83,49,34,FMN 18 Binnensingel Westkant
665,Uitbreidingstraat 390,2023-07-10,10:00:00,58,30,28,FMN 18 Binnensingel Westkant
665,Uitbreidingstraat 390,2023-07-10,11:00:00,55,26,29,FMN 18 Binnensingel Westkant
665,Uitbreidingstraat 390,2023-07-10,12:00:00,69,36,33,FMN 18 Binnensingel Westkant
665,Uitbreidingstraat 390,2023-07-10,13:00:00,72,37,35,FMN 18 Binnensingel Westkant
665,Uitbreidingstraat 390,2023-07-10,14:00:00,60,26,34,FMN 18 Binnensingel Westkant
665,Uitbreidingstraat 390,2023-07-10,15:00:00,66,34,32,FMN 18 Binnensingel Westkant
665,Uitbreidingstraat 390,2023-07-10,16:00:00,125,63,62,FMN 18 Binnensingel Westkant
665,Uitbreidingstraat 390,2023-07-10,17:00:00,198,77,121,FMN 18 Binnensingel Westkant
665,Uitbreidingstraat 390,2023-07-10,18:00:00,134,61,73,FMN 18 Binnensingel Westkant
665,Uitbreidingstraat 390,2023-07-10,19:00:00,97,42,55,FMN 18 Binnensingel Westkant
665,Uitbreidingstraat 390,2023-07-10,20:00:00,71,38,33,FMN 18 Binnensingel Westkant
665,Uitbreidingstraat 390,2023-07-10,21:00:00,44,22,22,FMN 18 Binnensingel Westkant
665,Uitbreidingstraat 390,2023-07-10,22:00:00,75,32,43,FMN 18 Binnensingel Westkant
665,Uitbreidingstraat 390,2023-07-10,23:00:00,50,23,27,FMN 18 Binnensingel Westkant
665,Uitbreidingstraat 390,2023-07-11,00:00:00,16,10,6,FMN 18 Binnensingel Westkant
665,Uitbreidingstraat 390,2023-07-11,01:00:00,12,6,6,FMN 18 Binnensingel Westkant
665,Uitbreidingstraat 390,2023-07-11,02:00:00,6,4,2,FMN 18 Binnensingel Westkant
665,Uitbreidingstraat 390,2023-07-11,03:00:00,5,3,2,FMN 18 Binnensingel Westkant
665,Uitbreidingstraat 390,2023-07-11,04:00:00,15,6,9,FMN 18 Binnensingel Westkant
665,Uitbreidingstraat 390,2023-07-11,05:00:00,22,13,9,FMN 18 Binnensingel Westkant
665,Uitbreidingstraat 390,2023-07-11,06:00:00,57,31,26,FMN 18 Binnensingel Westkant
665,Uitbreidingstraat 390,2023-07-11,07:00:00,117,60,57,FMN 18 Binnensingel Westkant
665,Uitbreidingstraat 390,2023-07-11,08:00:00,194,101,93,FMN 18 Binnensingel Westkant
665,Uitbreidingstraat 390,2023-07-11,09:00:00,92,53,39,FMN 18 Binnensingel Westkant
665,Uitbreidingstraat 390,2023-07-11,10:00:00,58,33,25,FMN 18 Binnensingel Westkant
665,Uitbreidingstraat 390,2023-07-11,11:00:00,55,28,27,FMN 18 Binnensingel Westkant
665,Uitbreidingstraat 390,2023-07-11,12:00:00,71,37,34,FMN 18 Binnensingel Westkant
665,Uitbreidingstraat 390,2023-07-11,13:00:00,56,28,28,FMN 18 Binnensingel Westkant
665,Uitbreidingstraat 390,2023-07-11,14:00:00,63,31,32,FMN 18 Binnensingel Westkant
665,Uitbreidingstraat 390,2023-07-11,15:00:00,94,41,53,FMN 18 Binnensingel Westkant
665,Uitbreidingstraat 390,2023-07-11,16:00:00,161,72,89,FMN 18 Binnensingel Westkant
665,Uitbreidingstraat 390,2023-07-11,17:00:00,182,67,115,FMN 18 Binnensingel Westkant
665,Uitbreidingstraat 390,2023-07-11,18:00:00,98,45,53,FMN 18 Binnensingel Westkant
665,Uitbreidingstraat 390,2023-07-11,19:00:00,110,54,56,FMN 18 Binnensingel Westkant
665,Uitbreidingstraat 390,2023-07-11,20:00:00,69,29,40,FMN 18 Binnensingel Westkant
665,Uitbreidingstraat 390,2023-07-11,21:00:00,58,24,34,FMN 18 Binnensingel Westkant
665,Uitbreidingstraat 390,2023-07-11,22:00:00,50,20,30,FMN 18 Binnensingel Westkant
665,Uitbreidingstraat 390,2023-07-11,23:00:00,31,16,15,FMN 18 Binnensingel Westkant
665,Uitbreidingstraat 390,2023-07-12,00:00:00,24,14,10,FMN 18 Binnensingel Westkant
665,Uitbreidingstraat 390,2023-07-12,01:00:00,12,6,6,FMN 18 Binnensingel Westkant
665,Uitbreidingstraat 390,2023-07-12,02:00:00,5,3,2,FMN 18 Binnensingel Westkant
665,Uitbreidingstraat 390,2023-07-12,03:00:00,3,1,2,FMN 18 Binnensingel Westkant
665,Uitbreidingstraat 390,2023-07-12,04:00:00,10,6,4,FMN 18 Binnensingel Westkant
665,Uitbreidingstraat 390,2023-07-12,05:00:00,22,15,7,FMN 18 Binnensingel Westkant
665,Uitbreidingstraat 390,2023-07-12,06:00:00,49,26,23,FMN 18 Binnensingel Westkant
665,Uitbreidingstraat 390,2023-07-12,07:00:00,101,46,55,FMN 18 Binnensingel Westkant
665,Uitbreidingstraat 390,2023-07-12,08:00:00,155,89,66,FMN 18 Binnensingel Westkant
665,Uitbreidingstraat 390,2023-07-12,09:00:00,98,52,46,FMN 18 Binnensingel Westkant
665,Uitbreidingstraat 390,2023-07-12,10:00:00,58,27,31,FMN 18 Binnensingel Westkant
665,Uitbreidingstraat 390,2023-07-12,11:00:00,65,26,39,FMN 18 Binnensingel Westkant
665,Uitbreidingstraat 390,2023-07-12,12:00:00,85,35,50,FMN 18 Binnensingel Westkant
665,Uitbreidingstraat 390,2023-07-12,13:00:00,80,43,37,FMN 18 Binnensingel Westkant
665,Uitbreidingstraat 390,2023-07-12,14:00:00,82,32,50,FMN 18 Binnensingel Westkant
665,Uitbreidingstraat 390,2023-07-12,15:00:00,86,33,53,FMN 18 Binnensingel Westkant
665,Uitbreidingstraat 390,2023-07-12,16:00:00,156,57,99,FMN 18 Binnensingel Westkant
665,Uitbreidingstraat 390,2023-07-12,17:00:00,197,85,112,FMN 18 Binnensingel Westkant
665,Uitbreidingstraat 390,2023-07-12,18:00:00,150,54,96,FMN 18 Binnensingel Westkant
665,Uitbreidingstraat 390,2023-07-12,19:00:00,91,43,48,FMN 18 Binnensingel Westkant
665,Uitbreidingstraat 390,2023-07-12,20:00:00,65,27,38,FMN 18 Binnensingel Westkant
665,Uitbreidingstraat 390,2023-07-12,21:00:00,59,26,33,FMN 18 Binnensingel Westkant
665,Uitbreidingstraat 390,2023-07-12,22:00:00,63,25,38,FMN 18 Binnensingel Westkant
665,Uitbreidingstraat 390,2023-07-12,23:00:00,35,15,20,FMN 18 Binnensingel Westkant
665,Uitbreidingstraat 390,2023-07-13,00:00:00,19,9,10,FMN 18 Binnensingel Westkant
665,Uitbreidingstraat 390,2023-07-13,01:00:00,19,13,6,FMN 18 Binnensingel Westkant
665,Uitbreidingstraat 390,2023-07-13,02:00:00,5,0,5,FMN 18 Binnensingel Westkant
665,Uitbreidingstraat 390,2023-07-13,03:00:00,3,1,2,FMN 18 Binnensingel Westkant
665,Uitbreidingstraat 390,2023-07-13,04:00:00,7,5,2,FMN 18 Binnensingel Westkant
665,Uitbreidingstraat 390,2023-07-13,05:00:00,26,15,11,FMN 18 Binnensingel Westkant
665,Uitbreidingstraat 390,2023-07-13,06:00:00,51,26,25,FMN 18 Binnensingel Westkant
665,Uitbreidingstraat 390,2023-07-13,07:00:00,120,63,57,FMN 18 Binnensingel Westkant
665,Uitbreidingstraat 390,2023-07-13,08:00:00,169,98,71,FMN 18 Binnensingel Westkant
665,Uitbreidingstraat 390,2023-07-13,09:00:00,121,56,65,FMN 18 Binnensingel Westkant
665,Uitbreidingstraat 390,2023-07-13,10:00:00,77,31,46,FMN 18 Binnensingel Westkant
665,Uitbreidingstraat 390,2023-07-13,11:00:00,74,29,45,FMN 18 Binnensingel Westkant
665,Uitbreidingstraat 390,2023-07-13,12:00:00,77,35,42,FMN 18 Binnensingel Westkant
665,Uitbreidingstraat 390,2023-07-13,13:00:00,68,30,38,FMN 18 Binnensingel Westkant
665,Uitbreidingstraat 390,2023-07-13,14:00:00,79,35,44,FMN 18 Binnensingel Westkant
665,Uitbreidingstraat 390,2023-07-13,15:00:00,100,39,61,FMN 18 Binnensingel Westkant
665,Uitbreidingstraat 390,2023-07-13,16:00:00,167,72,95,FMN 18 Binnensingel Westkant
665,Uitbreidingstraat 390,2023-07-13,17:00:00,232,78,154,FMN 18 Binnensingel Westkant
665,Uitbreidingstraat 390,2023-07-13,18:00:00,158,67,91,FMN 18 Binnensingel Westkant
665,Uitbreidingstraat 390,2023-07-13,19:00:00,136,51,85,FMN 18 Binnensingel Westkant
665,Uitbreidingstraat 390,2023-07-13,20:00:00,91,36,55,FMN 18 Binnensingel Westkant
665,Uitbreidingstraat 390,2023-07-13,21:00:00,55,16,39,FMN 18 Binnensingel Westkant
665,Uitbreidingstraat 390,2023-07-13,22:00:00,61,29,32,FMN 18 Binnensingel Westkant
665,Uitbreidingstraat 390,2023-07-13,23:00:00,66,39,27,FMN 18 Binnensingel Westkant
665,Uitbreidingstraat 390,2023-07-14,00:00:00,22,12,10,FMN 18 Binnensingel Westkant
665,Uitbreidingstraat 390,2023-07-14,01:00:00,9,4,5,FMN 18 Binnensingel Westkant
665,Uitbreidingstraat 390,2023-07-14,02:00:00,9,4,5,FMN 18 Binnensingel Westkant
665,Uitbreidingstraat 390,2023-07-14,03:00:00,5,3,2,FMN 18 Binnensingel Westkant
665,Uitbreidingstraat 390,2023-07-14,04:00:00,14,6,8,FMN 18 Binnensingel Westkant
665,Uitbreidingstraat 390,2023-07-14,05:00:00,29,21,8,FMN 18 Binnensingel Westkant
665,Uitbreidingstraat 390,2023-07-14,06:00:00,43,27,16,FMN 18 Binnensingel Westkant
665,Uitbreidingstraat 390,2023-07-14,07:00:00,89,54,35,FMN 18 Binnensingel Westkant
665,Uitbreidingstraat 390,2023-07-14,08:00:00,151,91,60,FMN 18 Binnensingel Westkant
665,Uitbreidingstraat 390,2023-07-14,09:00:00,91,49,42,FMN 18 Binnensingel Westkant
665,Uitbreidingstraat 390,2023-07-14,10:00:00,73,40,33,FMN 18 Binnensingel Westkant
665,Uitbreidingstraat 390,2023-07-14,11:00:00,69,30,39,FMN 18 Binnensingel Westkant
665,Uitbreidingstraat 390,2023-07-14,12:00:00,96,44,52,FMN 18 Binnensingel Westkant
665,Uitbreidingstraat 390,2023-07-14,13:00:00,73,35,38,FMN 18 Binnensingel Westkant
665,Uitbreidingstraat 390,2023-07-14,14:00:00,102,48,54,FMN 18 Binnensingel Westkant
665,Uitbreidingstraat 390,2023-07-14,15:00:00,129,57,72,FMN 18 Binnensingel Westkant
665,Uitbreidingstraat 390,2023-07-14,16:00:00,156,62,94,FMN 18 Binnensingel Westkant
665,Uitbreidingstraat 390,2023-07-14,17:00:00,172,63,109,FMN 18 Binnensingel Westkant
665,Uitbreidingstraat 390,2023-07-14,18:00:00,144,49,95,FMN 18 Binnensingel Westkant
665,Uitbreidingstraat 390,2023-07-14,19:00:00,107,42,65,FMN 18 Binnensingel Westkant
665,Uitbreidingstraat 390,2023-07-14,20:00:00,87,34,53,FMN 18 Binnensingel Westkant
665,Uitbreidingstraat 390,2023-07-14,21:00:00,72,31,41,FMN 18 Binnensingel Westkant
665,Uitbreidingstraat 390,2023-07-14,22:00:00,65,25,40,FMN 18 Binnensingel Westkant
665,Uitbreidingstraat 390,2023-07-14,23:00:00,64,25,39,FMN 18 Binnensingel Westkant
665,Uitbreidingstraat 390,2023-07-15,00:00:00,44,23,21,FMN 18 Binnensingel Westkant
665,Uitbreidingstraat 390,2023-07-15,01:00:00,40,21,19,FMN 18 Binnensingel Westkant
665,Uitbreidingstraat 390,2023-07-15,02:00:00,17,9,8,FMN 18 Binnensingel Westkant
665,Uitbreidingstraat 390,2023-07-15,03:00:00,11,3,8,FMN 18 Binnensingel Westkant
665,Uitbreidingstraat 390,2023-07-15,04:00:00,14,10,4,FMN 18 Binnensingel Westkant
665,Uitbreidingstraat 390,2023-07-15,05:00:00,13,6,7,FMN 18 Binnensingel Westkant
665,Uitbreidingstraat 390,2023-07-15,06:00:00,22,15,7,FMN 18 Binnensingel Westkant
665,Uitbreidingstraat 390,2023-07-15,07:00:00,21,10,11,FMN 18 Binnensingel Westkant
665,Uitbreidingstraat 390,2023-07-15,08:00:00,31,17,14,FMN 18 Binnensingel Westkant
665,Uitbreidingstraat 390,2023-07-15,09:00:00,60,31,29,FMN 18 Binnensingel Westkant
665,Uitbreidingstraat 390,2023-07-15,10:00:00,75,34,41,FMN 18 Binnensingel Westkant
665,Uitbreidingstraat 390,2023-07-15,11:00:00,69,39,30,FMN 18 Binnensingel Westkant
665,Uitbreidingstraat 390,2023-07-15,12:00:00,78,28,50,FMN 18 Binnensingel Westkant
665,Uitbreidingstraat 390,2023-07-15,13:00:00,60,24,36,FMN 18 Binnensingel Westkant
665,Uitbreidingstraat 390,2023-07-15,14:00:00,70,19,51,FMN 18 Binnensingel Westkant
665,Uitbreidingstraat 390,2023-07-15,15:00:00,75,40,35,FMN 18 Binnensingel Westkant
665,Uitbreidingstraat 390,2023-07-15,16:00:00,83,41,42,FMN 18 Binnensingel Westkant
665,Uitbreidingstraat 390,2023-07-15,17:00:00,63,26,37,FMN 18 Binnensingel Westkant
665,Uitbreidingstraat 390,2023-07-15,18:00:00,65,25,40,FMN 18 Binnensingel Westkant
665,Uitbreidingstraat 390,2023-07-15,19:00:00,72,38,34,FMN 18 Binnensingel Westkant
665,Uitbreidingstraat 390,2023-07-15,20:00:00,78,27,51,FMN 18 Binnensingel Westkant
665,Uitbreidingstraat 390,2023-07-15,21:00:00,44,13,31,FMN 18 Binnensingel Westkant
665,Uitbreidingstraat 390,2023-07-15,22:00:00,48,21,27,FMN 18 Binnensingel Westkant
665,Uitbreidingstraat 390,2023-07-15,23:00:00,42,22,20,FMN 18 Binnensingel Westkant
665,Uitbreidingstraat 390,2023-07-16,00:00:00,50,37,13,FMN 18 Binnensingel Westkant
665,Uitbreidingstraat 390,2023-07-16,01:00:00,34,21,13,FMN 18 Binnensingel Westkant
665,Uitbreidingstraat 390,2023-07-16,02:00:00,23,10,13,FMN 18 Binnensingel Westkant
665,Uitbreidingstraat 390,2023-07-16,03:00:00,12,8,4,FMN 18 Binnensingel Westkant
665,Uitbreidingstraat 390,2023-07-16,04:00:00,8,1,7,FMN 18 Binnensingel Westkant
665,Uitbreidingstraat 390,2023-07-16,05:00:00,14,6,8,FMN 18 Binnensingel Westkant
665,Uitbreidingstraat 390,2023-07-16,06:00:00,14,9,5,FMN 18 Binnensingel Westkant
665,Uitbreidingstraat 390,2023-07-16,07:00:00,10,7,3,FMN 18 Binnensingel Westkant
665,Uitbreidingstraat 390,2023-07-16,08:00:00,25,12,13,FMN 18 Binnensingel Westkant
665,Uitbreidingstraat 390,2023-07-16,09:00:00,41,21,20,FMN 18 Binnensingel Westkant
665,Uitbreidingstraat 390,2023-07-16,10:00:00,38,21,17,FMN 18 Binnensingel Westkant
665,Uitbreidingstraat 390,2023-07-16,11:00:00,37,12,25,FMN 18 Binnensingel Westkant
665,Uitbreidingstraat 390,2023-07-16,12:00:00,57,21,36,FMN 18 Binnensingel Westkant
665,Uitbreidingstraat 390,2023-07-16,13:00:00,43,23,20,FMN 18 Binnensingel Westkant
665,Uitbreidingstraat 390,2023-07-16,14:00:00,57,27,30,FMN 18 Binnensingel Westkant
665,Uitbreidingstraat 390,2023-07-16,15:00:00,64,27,37,FMN 18 Binnensingel Westkant
665,Uitbreidingstraat 390,2023-07-16,16:00:00,56,21,35,FMN 18 Binnensingel Westkant
665,Uitbreidingstraat 390,2023-07-16,17:00:00,66,30,36,FMN 18 Binnensingel Westkant
665,Uitbreidingstraat 390,2023-07-16,18:00:00,51,28,23,FMN 18 Binnensingel Westkant
665,Uitbreidingstraat 390,2023-07-16,19:00:00,57,32,25,FMN 18 Binnensingel Westkant
665,Uitbreidingstraat 390,2023-07-16,20:00:00,60,32,28,FMN 18 Binnensingel Westkant
665,Uitbreidingstraat 390,2023-07-16,21:00:00,43,18,25,FMN 18 Binnensingel Westkant
665,Uitbreidingstraat 390,2023-07-16,22:00:00,50,26,24,FMN 18 Binnensingel Westkant
665,Uitbreidingstraat 390,2023-07-16,23:00:00,25,11,14,FMN 18 Binnensingel Westkant
665,Uitbreidingstraat 390,2023-07-17,00:00:00,15,7,8,FMN 18 Binnensingel Westkant
665,Uitbreidingstraat 390,2023-07-17,01:00:00,11,6,5,FMN 18 Binnensingel Westkant
665,Uitbreidingstraat 390,2023-07-17,02:00:00,3,1,2,FMN 18 Binnensingel Westkant
665,Uitbreidingstraat 390,2023-07-17,03:00:00,3,2,1,FMN 18 Binnensingel Westkant
665,Uitbreidingstraat 390,2023-07-17,04:00:00,11,5,6,FMN 18 Binnensingel Westkant
665,Uitbreidingstraat 390,2023-07-17,05:00:00,33,22,11,FMN 18 Binnensingel Westkant
665,Uitbreidingstraat 390,2023-07-17,06:00:00,46,29,17,FMN 18 Binnensingel Westkant
665,Uitbreidingstraat 390,2023-07-17,07:00:00,106,62,44,FMN 18 Binnensingel Westkant
665,Uitbreidingstraat 390,2023-07-17,08:00:00,173,89,84,FMN 18 Binnensingel Westkant
665,Uitbreidingstraat 390,2023-07-17,09:00:00,73,46,27,FMN 18 Binnensingel Westkant
665,Uitbreidingstraat 390,2023-07-17,10:00:00,60,27,33,FMN 18 Binnensingel Westkant
665,Uitbreidingstraat 390,2023-07-17,11:00:00,71,30,41,FMN 18 Binnensingel Westkant
665,Uitbreidingstraat 390,2023-07-17,12:00:00,78,33,45,FMN 18 Binnensingel Westkant
665,Uitbreidingstraat 390,2023-07-17,13:00:00,67,39,28,FMN 18 Binnensingel Westkant
665,Uitbreidingstraat 390,2023-07-17,14:00:00,82,33,49,FMN 18 Binnensingel Westkant
665,Uitbreidingstraat 390,2023-07-17,15:00:00,86,38,48,FMN 18 Binnensingel Westkant
665,Uitbreidingstraat 390,2023-07-17,16:00:00,142,55,87,FMN 18 Binnensingel Westkant
665,Uitbreidingstraat 390,2023-07-17,17:00:00,211,74,137,FMN 18 Binnensingel Westkant
665,Uitbreidingstraat 390,2023-07-17,18:00:00,148,71,77,FMN 18 Binnensingel Westkant
665,Uitbreidingstraat 390,2023-07-17,19:00:00,80,41,39,FMN 18 Binnensingel Westkant
665,Uitbreidingstraat 390,2023-07-17,20:00:00,69,20,49,FMN 18 Binnensingel Westkant
665,Uitbreidingstraat 390,2023-07-17,21:00:00,45,16,29,FMN 18 Binnensingel Westkant
665,Uitbreidingstraat 390,2023-07-17,22:00:00,50,21,29,FMN 18 Binnensingel Westkant
665,Uitbreidingstraat 390,2023-07-17,23:00:00,29,10,19,FMN 18 Binnensingel Westkant
665,Uitbreidingstraat 390,2023-07-18,00:00:00,23,11,12,FMN 18 Binnensingel Westkant
665,Uitbreidingstraat 390,2023-07-18,01:00:00,9,6,3,FMN 18 Binnensingel Westkant
665,Uitbreidingstraat 390,2023-07-18,02:00:00,3,3,0,FMN 18 Binnensingel Westkant
665,Uitbreidingstraat 390,2023-07-18,03:00:00,2,0,2,FMN 18 Binnensingel Westkant
665,Uitbreidingstraat 390,2023-07-18,04:00:00,16,9,7,FMN 18 Binnensingel Westkant
665,Uitbreidingstraat 390,2023-07-18,05:00:00,34,21,13,FMN 18 Binnensingel Westkant
665,Uitbreidingstraat 390,2023-07-18,06:00:00,60,28,32,FMN 18 Binnensingel Westkant
665,Uitbreidingstraat 390,2023-07-18,07:00:00,125,67,58,FMN 18 Binnensingel Westkant
665,Uitbreidingstraat 390,2023-07-18,08:00:00,191,98,93,FMN 18 Binnensingel Westkant
665,Uitbreidingstraat 390,2023-07-18,09:00:00,108,64,44,FMN 18 Binnensingel Westkant
665,Uitbreidingstraat 390,2023-07-18,10:00:00,66,38,28,FMN 18 Binnensingel Westkant
665,Uitbreidingstraat 390,2023-07-18,11:00:00,65,29,36,FMN 18 Binnensingel Westkant
665,Uitbreidingstraat 390,2023-07-18,12:00:00,85,31,54,FMN 18 Binnensingel Westkant
665,Uitbreidingstraat 390,2023-07-18,13:00:00,78,45,33,FMN 18 Binnensingel Westkant
665,Uitbreidingstraat 390,2023-07-18,14:00:00,88,39,49,FMN 18 Binnensingel Westkant
665,Uitbreidingstraat 390,2023-07-18,15:00:00,76,27,49,FMN 18 Binnensingel Westkant
665,Uitbreidingstraat 390,2023-07-18,16:00:00,138,51,87,FMN 18 Binnensingel Westkant
665,Uitbreidingstraat 390,2023-07-18,17:00:00,243,105,138,FMN 18 Binnensingel Westkant
665,Uitbreidingstraat 390,2023-07-18,18:00:00,160,76,84,FMN 18 Binnensingel Westkant
665,Uitbreidingstraat 390,2023-07-18,19:00:00,102,49,53,FMN 18 Binnensingel Westkant
665,Uitbreidingstraat 390,2023-07-18,20:00:00,104,43,61,FMN 18 Binnensingel Westkant
665,Uitbreidingstraat 390,2023-07-18,21:00:00,72,26,46,FMN 18 Binnensingel Westkant
665,Uitbreidingstraat 390,2023-07-18,22:00:00,70,27,43,FMN 18 Binnensingel Westkant
665,Uitbreidingstraat 390,2023-07-18,23:00:00,38,15,23,FMN 18 Binnensingel Westkant
665,Uitbreidingstraat 390,2023-07-19,00:00:00,25,13,12,FMN 18 Binnensingel Westkant
665,Uitbreidingstraat 390,2023-07-19,01:00:00,5,5,0,FMN 18 Binnensingel Westkant
665,Uitbreidingstraat 390,2023-07-19,02:00:00,5,2,3,FMN 18 Binnensingel Westkant
665,Uitbreidingstraat 390,2023-07-19,03:00:00,3,2,1,FMN 18 Binnensingel Westkant
665,Uitbreidingstraat 390,2023-07-19,04:00:00,17,9,8,FMN 18 Binnensingel Westkant
665,Uitbreidingstraat 390,2023-07-19,05:00:00,34,22,12,FMN 18 Binnensingel Westkant
665,Uitbreidingstraat 390,2023-07-19,06:00:00,58,31,27,FMN 18 Binnensingel Westkant
665,Uitbreidingstraat 390,2023-07-19,07:00:00,105,62,43,FMN 18 Binnensingel Westkant
665,Uitbreidingstraat 390,2023-07-19,08:00:00,165,87,78,FMN 18 Binnensingel Westkant
665,Uitbreidingstraat 390,2023-07-19,09:00:00,95,55,40,FMN 18 Binnensingel Westkant
665,Uitbreidingstraat 390,2023-07-19,10:00:00,80,43,37,FMN 18 Binnensingel Westkant
665,Uitbreidingstraat 390,2023-07-19,11:00:00,77,30,47,FMN 18 Binnensingel Westkant
665,Uitbreidingstraat 390,2023-07-19,12:00:00,80,41,39,FMN 18 Binnensingel Westkant
665,Uitbreidingstraat 390,2023-07-19,13:00:00,97,46,51,FMN 18 Binnensingel Westkant
665,Uitbreidingstraat 390,2023-07-19,14:00:00,103,36,67,FMN 18 Binnensingel Westkant
665,Uitbreidingstraat 390,2023-07-19,15:00:00,110,52,58,FMN 18 Binnensingel Westkant
665,Uitbreidingstraat 390,2023-07-19,16:00:00,166,67,99,FMN 18 Binnensingel Westkant
665,Uitbreidingstraat 390,2023-07-19,17:00:00,176,66,110,FMN 18 Binnensingel Westkant
665,Uitbreidingstraat 390,2023-07-19,18:00:00,133,51,82,FMN 18 Binnensingel Westkant
665,Uitbreidingstraat 390,2023-07-19,19:00:00,107,42,65,FMN 18 Binnensingel Westkant
665,Uitbreidingstraat 390,2023-07-19,20:00:00,113,50,63,FMN 18 Binnensingel Westkant
665,Uitbreidingstraat 390,2023-07-19,21:00:00,61,23,38,FMN 18 Binnensingel Westkant
665,Uitbreidingstraat 390,2023-07-19,22:00:00,59,37,22,FMN 18 Binnensingel Westkant
665,Uitbreidingstraat 390,2023-07-19,23:00:00,43,20,23,FMN 18 Binnensingel Westkant
665,Uitbreidingstraat 390,2023-07-20,00:00:00,27,15,12,FMN 18 Binnensingel Westkant
665,Uitbreidingstraat 390,2023-07-20,01:00:00,18,12,6,FMN 18 Binnensingel Westkant
665,Uitbreidingstraat 390,2023-07-20,02:00:00,7,6,1,FMN 18 Binnensingel Westkant
665,Uitbreidingstraat 390,2023-07-20,03:00:00,6,5,1,FMN 18 Binnensingel Westkant
665,Uitbreidingstraat 390,2023-07-20,04:00:00,14,5,9,FMN 18 Binnensingel Westkant
665,Uitbreidingstraat 390,2023-07-20,05:00:00,39,25,14,FMN 18 Binnensingel Westkant
665,Uitbreidingstraat 390,2023-07-20,06:00:00,64,40,24,FMN 18 Binnensingel Westkant
665,Uitbreidingstraat 390,2023-07-20,07:00:00,124,71,53,FMN 18 Binnensingel Westkant
665,Uitbreidingstraat 390,2023-07-20,08:00:00,179,96,83,FMN 18 Binnensingel Westkant
665,Uitbreidingstraat 390,2023-07-20,09:00:00,107,62,45,FMN 18 Binnensingel Westkant
665,Uitbreidingstraat 390,2023-07-20,10:00:00,84,48,36,FMN 18 Binnensingel Westkant
665,Uitbreidingstraat 390,2023-07-20,11:00:00,77,36,41,FMN 18 Binnensingel Westkant
665,Uitbreidingstraat 390,2023-07-20,12:00:00,112,43,69,FMN 18 Binnensingel Westkant
665,Uitbreidingstraat 390,2023-07-20,13:00:00,95,48,47,FMN 18 Binnensingel Westkant
665,Uitbreidingstraat 390,2023-07-20,14:00:00,102,41,61,FMN 18 Binnensingel Westkant
665,Uitbreidingstraat 390,2023-07-20,15:00:00,124,61,63,FMN 18 Binnensingel Westkant
665,Uitbreidingstraat 390,2023-07-20,16:00:00,204,85,119,FMN 18 Binnensingel Westkant
665,Uitbreidingstraat 390,2023-07-20,17:00:00,222,78,144,FMN 18 Binnensingel Westkant
665,Uitbreidingstraat 390,2023-07-20,18:00:00,149,58,91,FMN 18 Binnensingel Westkant
665,Uitbreidingstraat 390,2023-07-20,19:00:00,97,39,58,FMN 18 Binnensingel Westkant
665,Uitbreidingstraat 390,2023-07-20,20:00:00,76,34,42,FMN 18 Binnensingel Westkant
665,Uitbreidingstraat 390,2023-07-20,21:00:00,79,39,40,FMN 18 Binnensingel Westkant
665,Uitbreidingstraat 390,2023-07-20,22:00:00,64,31,33,FMN 18 Binnensingel Westkant
665,Uitbreidingstraat 390,2023-07-20,23:00:00,61,27,34,FMN 18 Binnensingel Westkant
665,Uitbreidingstraat 390,2023-07-21,00:00:00,34,19,15,FMN 18 Binnensingel Westkant
665,Uitbreidingstraat 390,2023-07-21,01:00:00,21,10,11,FMN 18 Binnensingel Westkant
665,Uitbreidingstraat 390,2023-07-21,02:00:00,21,12,9,FMN 18 Binnensingel Westkant
665,Uitbreidingstraat 390,2023-07-21,03:00:00,14,5,9,FMN 18 Binnensingel Westkant
665,Uitbreidingstraat 390,2023-07-21,04:00:00,8,3,5,FMN 18 Binnensingel Westkant
665,Uitbreidingstraat 390,2023-07-21,05:00:00,20,10,10,FMN 18 Binnensingel Westkant
665,Uitbreidingstraat 390,2023-07-21,06:00:00,25,16,9,FMN 18 Binnensingel Westkant
665,Uitbreidingstraat 390,2023-07-21,07:00:00,28,16,12,FMN 18 Binnensingel Westkant
665,Uitbreidingstraat 390,2023-07-21,08:00:00,29,18,11,FMN 18 Binnensingel Westkant
665,Uitbreidingstraat 390,2023-07-21,09:00:00,50,26,24,FMN 18 Binnensingel Westkant
665,Uitbreidingstraat 390,2023-07-21,10:00:00,49,25,24,FMN 18 Binnensingel Westkant
665,Uitbreidingstraat 390,2023-07-21,11:00:00,67,36,31,FMN 18 Binnensingel Westkant
665,Uitbreidingstraat 390,2023-07-21,12:00:00,28,9,19,FMN 18 Binnensingel Westkant
665,Uitbreidingstraat 390,2023-07-21,13:00:00,50,23,27,FMN 18 Binnensingel Westkant
665,Uitbreidingstraat 390,2023-07-21,14:00:00,74,32,42,FMN 18 Binnensingel Westkant
665,Uitbreidingstraat 390,2023-07-21,15:00:00,61,22,39,FMN 18 Binnensingel Westkant
665,Uitbreidingstraat 390,2023-07-21,16:00:00,87,33,54,FMN 18 Binnensingel Westkant
665,Uitbreidingstraat 390,2023-07-21,17:00:00,76,30,46,FMN 18 Binnensingel Westkant
665,Uitbreidingstraat 390,2023-07-21,18:00:00,81,46,35,FMN 18 Binnensingel Westkant
665,Uitbreidingstraat 390,2023-07-21,19:00:00,72,34,38,FMN 18 Binnensingel Westkant
665,Uitbreidingstraat 390,2023-07-21,20:00:00,69,28,41,FMN 18 Binnensingel Westkant
665,Uitbreidingstraat 390,2023-07-21,21:00:00,53,19,34,FMN 18 Binnensingel Westkant
665,Uitbreidingstraat 390,2023-07-21,22:00:00,53,24,29,FMN 18 Binnensingel Westkant
665,Uitbreidingstraat 390,2023-07-21,23:00:00,43,24,19,FMN 18 Binnensingel Westkant
665,Uitbreidingstraat 390,2023-07-22,00:00:00,43,25,18,FMN 18 Binnensingel Westkant
665,Uitbreidingstraat 390,2023-07-22,01:00:00,14,9,5,FMN 18 Binnensingel Westkant
665,Uitbreidingstraat 390,2023-07-22,02:00:00,8,2,6,FMN 18 Binnensingel Westkant
665,Uitbreidingstraat 390,2023-07-22,03:00:00,12,4,8,FMN 18 Binnensingel Westkant
665,Uitbreidingstraat 390,2023-07-22,04:00:00,14,10,4,FMN 18 Binnensingel Westkant
665,Uitbreidingstraat 390,2023-07-22,05:00:00,14,8,6,FMN 18 Binnensingel Westkant
665,Uitbreidingstraat 390,2023-07-22,06:00:00,27,16,11,FMN 18 Binnensingel Westkant
665,Uitbreidingstraat 390,2023-07-22,07:00:00,26,15,11,FMN 18 Binnensingel Westkant
665,Uitbreidingstraat 390,2023-07-22,08:00:00,35,17,18,FMN 18 Binnensingel Westkant
665,Uitbreidingstraat 390,2023-07-22,09:00:00,57,20,37,FMN 18 Binnensingel Westkant
665,Uitbreidingstraat 390,2023-07-22,10:00:00,72,38,34,FMN 18 Binnensingel Westkant
665,Uitbreidingstraat 390,2023-07-22,11:00:00,63,35,28,FMN 18 Binnensingel Westkant
665,Uitbreidingstraat 390,2023-07-22,12:00:00,67,30,37,FMN 18 Binnensingel Westkant
665,Uitbreidingstraat 390,2023-07-22,13:00:00,67,30,37,FMN 18 Binnensingel Westkant
665,Uitbreidingstraat 390,2023-07-22,14:00:00,90,45,45,FMN 18 Binnensingel Westkant
665,Uitbreidingstraat 390,2023-07-22,15:00:00,95,44,51,FMN 18 Binnensingel Westkant
665,Uitbreidingstraat 390,2023-07-22,16:00:00,87,36,51,FMN 18 Binnensingel Westkant
665,Uitbreidingstraat 390,2023-07-22,17:00:00,87,43,44,FMN 18 Binnensingel Westkant
665,Uitbreidingstraat 390,2023-07-22,18:00:00,71,31,40,FMN 18 Binnensingel Westkant
665,Uitbreidingstraat 390,2023-07-22,19:00:00,72,38,34,FMN 18 Binnensingel Westkant
665,Uitbreidingstraat 390,2023-07-22,20:00:00,59,23,36,FMN 18 Binnensingel Westkant
665,Uitbreidingstraat 390,2023-07-22,21:00:00,60,26,34,FMN 18 Binnensingel Westkant
665,Uitbreidingstraat 390,2023-07-22,22:00:00,49,23,26,FMN 18 Binnensingel Westkant
665,Uitbreidingstraat 390,2023-07-22,23:00:00,37,21,16,FMN 18 Binnensingel Westkant
665,Uitbreidingstraat 390,2023-07-23,00:00:00,32,14,18,FMN 18 Binnensingel Westkant
665,Uitbreidingstraat 390,2023-07-23,01:00:00,14,9,5,FMN 18 Binnensingel Westkant
665,Uitbreidingstraat 390,2023-07-23,02:00:00,21,15,6,FMN 18 Binnensingel Westkant
665,Uitbreidingstraat 390,2023-07-23,03:00:00,13,9,4,FMN 18 Binnensingel Westkant
665,Uitbreidingstraat 390,2023-07-23,04:00:00,5,4,1,FMN 18 Binnensingel Westkant
665,Uitbreidingstraat 390,2023-07-23,05:00:00,12,5,7,FMN 18 Binnensingel Westkant
665,Uitbreidingstraat 390,2023-07-23,06:00:00,12,8,4,FMN 18 Binnensingel Westkant
665,Uitbreidingstraat 390,2023-07-23,07:00:00,17,6,11,FMN 18 Binnensingel Westkant
665,Uitbreidingstraat 390,2023-07-23,08:00:00,14,6,8,FMN 18 Binnensingel Westkant
665,Uitbreidingstraat 390,2023-07-23,09:00:00,22,10,12,FMN 18 Binnensingel Westkant
665,Uitbreidingstraat 390,2023-07-23,10:00:00,41,25,16,FMN 18 Binnensingel Westkant
665,Uitbreidingstraat 390,2023-07-23,11:00:00,25,11,14,FMN 18 Binnensingel Westkant
665,Uitbreidingstraat 390,2023-07-23,12:00:00,51,28,23,FMN 18 Binnensingel Westkant
665,Uitbreidingstraat 390,2023-07-23,13:00:00,61,31,30,FMN 18 Binnensingel Westkant
665,Uitbreidingstraat 390,2023-07-23,14:00:00,65,29,36,FMN 18 Binnensingel Westkant
665,Uitbreidingstraat 390,2023-07-23,15:00:00,52,25,27,FMN 18 Binnensingel Westkant
665,Uitbreidingstraat 390,2023-07-23,16:00:00,53,25,28,FMN 18 Binnensingel Westkant
665,Uitbreidingstraat 390,2023-07-23,17:00:00,49,19,30,FMN 18 Binnensingel Westkant
665,Uitbreidingstraat 390,2023-07-23,18:00:00,50,23,27,FMN 18 Binnensingel Westkant
665,Uitbreidingstraat 390,2023-07-23,19:00:00,42,21,21,FMN 18 Binnensingel Westkant
665,Uitbreidingstraat 390,2023-07-23,20:00:00,35,15,20,FMN 18 Binnensingel Westkant
665,Uitbreidingstraat 390,2023-07-23,21:00:00,39,24,15,FMN 18 Binnensingel Westkant
665,Uitbreidingstraat 390,2023-07-23,22:00:00,35,17,18,FMN 18 Binnensingel Westkant
665,Uitbreidingstraat 390,2023-07-23,23:00:00,26,11,15,FMN 18 Binnensingel Westkant
665,Uitbreidingstraat 390,2023-07-24,00:00:00,10,6,4,FMN 18 Binnensingel Westkant
665,Uitbreidingstraat 390,2023-07-24,01:00:00,6,5,1,FMN 18 Binnensingel Westkant
665,Uitbreidingstraat 390,2023-07-24,02:00:00,6,1,5,FMN 18 Binnensingel Westkant
665,Uitbreidingstraat 390,2023-07-24,03:00:00,2,1,1,FMN 18 Binnensingel Westkant
665,Uitbreidingstraat 390,2023-07-24,04:00:00,10,7,3,FMN 18 Binnensingel Westkant
665,Uitbreidingstraat 390,2023-07-24,05:00:00,26,18,8,FMN 18 Binnensingel Westkant
665,Uitbreidingstraat 390,2023-07-24,06:00:00,50,24,26,FMN 18 Binnensingel Westkant
665,Uitbreidingstraat 390,2023-07-24,07:00:00,87,43,44,FMN 18 Binnensingel Westkant
665,Uitbreidingstraat 390,2023-07-24,08:00:00,168,92,76,FMN 18 Binnensingel Westkant
665,Uitbreidingstraat 390,2023-07-24,09:00:00,70,31,39,FMN 18 Binnensingel Westkant
665,Uitbreidingstraat 390,2023-07-24,10:00:00,63,33,30,FMN 18 Binnensingel Westkant
665,Uitbreidingstraat 390,2023-07-24,11:00:00,60,30,30,FMN 18 Binnensingel Westkant
665,Uitbreidingstraat 390,2023-07-24,12:00:00,74,29,45,FMN 18 Binnensingel Westkant
665,Uitbreidingstraat 390,2023-07-24,13:00:00,63,34,29,FMN 18 Binnensingel Westkant
665,Uitbreidingstraat 390,2023-07-24,14:00:00,93,36,57,FMN 18 Binnensingel Westkant
665,Uitbreidingstraat 390,2023-07-24,15:00:00,80,38,42,FMN 18 Binnensingel Westkant
665,Uitbreidingstraat 390,2023-07-24,16:00:00,132,52,80,FMN 18 Binnensingel Westkant
665,Uitbreidingstraat 390,2023-07-24,17:00:00,146,50,96,FMN 18 Binnensingel Westkant
665,Uitbreidingstraat 390,2023-07-24,18:00:00,118,58,60,FMN 18 Binnensingel Westkant
665,Uitbreidingstraat 390,2023-07-24,19:00:00,75,33,42,FMN 18 Binnensingel Westkant
665,Uitbreidingstraat 390,2023-07-24,20:00:00,64,27,37,FMN 18 Binnensingel Westkant
665,Uitbreidingstraat 390,2023-07-24,21:00:00,51,25,26,FMN 18 Binnensingel Westkant
665,Uitbreidingstraat 390,2023-07-24,22:00:00,51,17,34,FMN 18 Binnensingel Westkant
665,Uitbreidingstraat 390,2023-07-24,23:00:00,27,13,14,FMN 18 Binnensingel Westkant
665,Uitbreidingstraat 390,2023-07-25,00:00:00,14,10,4,FMN 18 Binnensingel Westkant
665,Uitbreidingstraat 390,2023-07-25,01:00:00,8,5,3,FMN 18 Binnensingel Westkant
665,Uitbreidingstraat 390,2023-07-25,02:00:00,8,6,2,FMN 18 Binnensingel Westkant
665,Uitbreidingstraat 390,2023-07-25,03:00:00,5,3,2,FMN 18 Binnensingel Westkant
665,Uitbreidingstraat 390,2023-07-25,04:00:00,12,7,5,FMN 18 Binnensingel Westkant
665,Uitbreidingstraat 390,2023-07-25,05:00:00,36,20,16,FMN 18 Binnensingel Westkant
665,Uitbreidingstraat 390,2023-07-25,06:00:00,63,35,28,FMN 18 Binnensingel Westkant
665,Uitbreidingstraat 390,2023-07-25,07:00:00,111,54,57,FMN 18 Binnensingel Westkant
665,Uitbreidingstraat 390,2023-07-25,08:00:00,176,97,79,FMN 18 Binnensingel Westkant
665,Uitbreidingstraat 390,2023-07-25,09:00:00,90,56,34,FMN 18 Binnensingel Westkant
665,Uitbreidingstraat 390,2023-07-25,10:00:00,65,41,24,FMN 18 Binnensingel Westkant
665,Uitbreidingstraat 390,2023-07-25,11:00:00,83,45,38,FMN 18 Binnensingel Westkant
665,Uitbreidingstraat 390,2023-07-25,12:00:00,120,59,61,FMN 18 Binnensingel Westkant
665,Uitbreidingstraat 390,2023-07-25,13:00:00,96,52,44,FMN 18 Binnensingel Westkant
665,Uitbreidingstraat 390,2023-07-25,14:00:00,99,44,55,FMN 18 Binnensingel Westkant
665,Uitbreidingstraat 390,2023-07-25,15:00:00,94,31,63,FMN 18 Binnensingel Westkant
665,Uitbreidingstraat 390,2023-07-25,16:00:00,156,66,90,FMN 18 Binnensingel Westkant
665,Uitbreidingstraat 390,2023-07-25,17:00:00,265,104,161,FMN 18 Binnensingel Westkant
665,Uitbreidingstraat 390,2023-07-25,18:00:00,194,72,122,FMN 18 Binnensingel Westkant
665,Uitbreidingstraat 390,2023-07-25,19:00:00,115,61,54,FMN 18 Binnensingel Westkant
665,Uitbreidingstraat 390,2023-07-25,20:00:00,83,25,58,FMN 18 Binnensingel Westkant
665,Uitbreidingstraat 390,2023-07-25,21:00:00,78,34,44,FMN 18 Binnensingel Westkant
665,Uitbreidingstraat 390,2023-07-25,22:00:00,81,31,50,FMN 18 Binnensingel Westkant
665,Uitbreidingstraat 390,2023-07-25,23:00:00,45,32,13,FMN 18 Binnensingel Westkant
665,Uitbreidingstraat 390,2023-07-26,00:00:00,33,20,13,FMN 18 Binnensingel Westkant
665,Uitbreidingstraat 390,2023-07-26,01:00:00,16,11,5,FMN 18 Binnensingel Westkant
665,Uitbreidingstraat 390,2023-07-26,02:00:00,5,1,4,FMN 18 Binnensingel Westkant
665,Uitbreidingstraat 390,2023-07-26,03:00:00,6,3,3,FMN 18 Binnensingel Westkant
665,Uitbreidingstraat 390,2023-07-26,04:00:00,15,9,6,FMN 18 Binnensingel Westkant
665,Uitbreidingstraat 390,2023-07-26,05:00:00,37,24,13,FMN 18 Binnensingel Westkant
665,Uitbreidingstraat 390,2023-07-26,06:00:00,61,38,23,FMN 18 Binnensingel Westkant
665,Uitbreidingstraat 390,2023-07-26,07:00:00,95,55,40,FMN 18 Binnensingel Westkant
665,Uitbreidingstraat 390,2023-07-26,08:00:00,178,94,84,FMN 18 Binnensingel Westkant
665,Uitbreidingstraat 390,2023-07-26,09:00:00,111,65,46,FMN 18 Binnensingel Westkant
665,Uitbreidingstraat 390,2023-07-26,10:00:00,76,48,28,FMN 18 Binnensingel Westkant
665,Uitbreidingstraat 390,2023-07-26,11:00:00,96,54,42,FMN 18 Binnensingel Westkant
665,Uitbreidingstraat 390,2023-07-26,12:00:00,106,45,61,FMN 18 Binnensingel Westkant
665,Uitbreidingstraat 390,2023-07-26,13:00:00,93,40,53,FMN 18 Binnensingel Westkant
665,Uitbreidingstraat 390,2023-07-26,14:00:00,118,54,64,FMN 18 Binnensingel Westkant
665,Uitbreidingstraat 390,2023-07-26,15:00:00,122,52,70,FMN 18 Binnensingel Westkant
665,Uitbreidingstraat 390,2023-07-26,16:00:00,181,70,111,FMN 18 Binnensingel Westkant
665,Uitbreidingstraat 390,2023-07-26,17:00:00,271,110,161,FMN 18 Binnensingel Westkant
665,Uitbreidingstraat 390,2023-07-26,18:00:00,162,64,98,FMN 18 Binnensingel Westkant
665,Uitbreidingstraat 390,2023-07-26,19:00:00,113,59,54,FMN 18 Binnensingel Westkant
665,Uitbreidingstraat 390,2023-07-26,20:00:00,91,31,60,FMN 18 Binnensingel Westkant
665,Uitbreidingstraat 390,2023-07-26,21:00:00,72,30,42,FMN 18 Binnensingel Westkant
665,Uitbreidingstraat 390,2023-07-26,22:00:00,99,47,52,FMN 18 Binnensingel Westkant
665,Uitbreidingstraat 390,2023-07-26,23:00:00,52,32,20,FMN 18 Binnensingel Westkant
665,Uitbreidingstraat 390,2023-07-27,00:00:00,20,13,7,FMN 18 Binnensingel Westkant
665,Uitbreidingstraat 390,2023-07-27,01:00:00,11,3,8,FMN 18 Binnensingel Westkant
665,Uitbreidingstraat 390,2023-07-27,02:00:00,4,4,0,FMN 18 Binnensingel Westkant
665,Uitbreidingstraat 390,2023-07-27,03:00:00,4,2,2,FMN 18 Binnensingel Westkant
665,Uitbreidingstraat 390,2023-07-27,04:00:00,10,4,6,FMN 18 Binnensingel Westkant
665,Uitbreidingstraat 390,2023-07-27,05:00:00,27,19,8,FMN 18 Binnensingel Westkant
665,Uitbreidingstraat 390,2023-07-27,06:00:00,57,23,34,FMN 18 Binnensingel Westkant
665,Uitbreidingstraat 390,2023-07-27,07:00:00,87,43,44,FMN 18 Binnensingel Westkant
665,Uitbreidingstraat 390,2023-07-27,08:00:00,134,67,67,FMN 18 Binnensingel Westkant
665,Uitbreidingstraat 390,2023-07-27,09:00:00,73,50,23,FMN 18 Binnensingel Westkant
665,Uitbreidingstraat 390,2023-07-27,10:00:00,57,31,26,FMN 18 Binnensingel Westkant
665,Uitbreidingstraat 390,2023-07-27,11:00:00,62,29,33,FMN 18 Binnensingel Westkant
665,Uitbreidingstraat 390,2023-07-27,12:00:00,54,22,32,FMN 18 Binnensingel Westkant
665,Uitbreidingstraat 390,2023-07-27,13:00:00,62,39,23,FMN 18 Binnensingel Westkant
665,Uitbreidingstraat 390,2023-07-27,14:00:00,67,32,35,FMN 18 Binnensingel Westkant
665,Uitbreidingstraat 390,2023-07-27,15:00:00,80,32,48,FMN 18 Binnensingel Westkant
665,Uitbreidingstraat 390,2023-07-27,16:00:00,123,46,77,FMN 18 Binnensingel Westkant
665,Uitbreidingstraat 390,2023-07-27,17:00:00,149,47,102,FMN 18 Binnensingel Westkant
665,Uitbreidingstraat 390,2023-07-27,18:00:00,105,50,55,FMN 18 Binnensingel Westkant
665,Uitbreidingstraat 390,2023-07-27,19:00:00,75,37,38,FMN 18 Binnensingel Westkant
665,Uitbreidingstraat 390,2023-07-27,20:00:00,62,25,37,FMN 18 Binnensingel Westkant
665,Uitbreidingstraat 390,2023-07-27,21:00:00,53,20,33,FMN 18 Binnensingel Westkant
665,Uitbreidingstraat 390,2023-07-27,22:00:00,52,29,23,FMN 18 Binnensingel Westkant
665,Uitbreidingstraat 390,2023-07-27,23:00:00,36,17,19,FMN 18 Binnensingel Westkant
665,Uitbreidingstraat 390,2023-07-28,00:00:00,18,12,6,FMN 18 Binnensingel Westkant
665,Uitbreidingstraat 390,2023-07-28,01:00:00,17,10,7,FMN 18 Binnensingel Westkant
665,Uitbreidingstraat 390,2023-07-28,02:00:00,7,3,4,FMN 18 Binnensingel Westkant
665,Uitbreidingstraat 390,2023-07-28,03:00:00,4,3,1,FMN 18 Binnensingel Westkant
665,Uitbreidingstraat 390,2023-07-28,04:00:00,12,6,6,FMN 18 Binnensingel Westkant
665,Uitbreidingstraat 390,2023-07-28,05:00:00,30,22,8,FMN 18 Binnensingel Westkant
665,Uitbreidingstraat 390,2023-07-28,06:00:00,63,33,30,FMN 18 Binnensingel Westkant
665,Uitbreidingstraat 390,2023-07-28,07:00:00,102,59,43,FMN 18 Binnensingel Westkant
665,Uitbreidingstraat 390,2023-07-28,08:00:00,133,90,43,FMN 18 Binnensingel Westkant
665,Uitbreidingstraat 390,2023-07-28,09:00:00,87,46,41,FMN 18 Binnensingel Westkant
665,Uitbreidingstraat 390,2023-07-28,10:00:00,72,39,33,FMN 18 Binnensingel Westkant
665,Uitbreidingstraat 390,2023-07-28,11:00:00,79,35,44,FMN 18 Binnensingel Westkant
665,Uitbreidingstraat 390,2023-07-28,12:00:00,103,39,64,FMN 18 Binnensingel Westkant
665,Uitbreidingstraat 390,2023-07-28,13:00:00,80,40,40,FMN 18 Binnensingel Westkant
665,Uitbreidingstraat 390,2023-07-28,14:00:00,94,41,53,FMN 18 Binnensingel Westkant
665,Uitbreidingstraat 390,2023-07-28,15:00:00,111,46,65,FMN 18 Binnensingel Westkant
665,Uitbreidingstraat 390,2023-07-28,16:00:00,180,69,111,FMN 18 Binnensingel Westkant
665,Uitbreidingstraat 390,2023-07-28,17:00:00,166,66,100,FMN 18 Binnensingel Westkant
665,Uitbreidingstraat 390,2023-07-28,18:00:00,156,69,87,FMN 18 Binnensingel Westkant
665,Uitbreidingstraat 390,2023-07-28,19:00:00,112,53,59,FMN 18 Binnensingel Westkant
665,Uitbreidingstraat 390,2023-07-28,20:00:00,83,35,48,FMN 18 Binnensingel Westkant
665,Uitbreidingstraat 390,2023-07-28,21:00:00,75,30,45,FMN 18 Binnensingel Westkant
665,Uitbreidingstraat 390,2023-07-28,22:00:00,61,24,37,FMN 18 Binnensingel Westkant
665,Uitbreidingstraat 390,2023-07-28,23:00:00,48,26,22,FMN 18 Binnensingel Westkant
665,Uitbreidingstraat 390,2023-07-29,00:00:00,43,18,25,FMN 18 Binnensingel Westkant
665,Uitbreidingstraat 390,2023-07-29,01:00:00,31,15,16,FMN 18 Binnensingel Westkant
665,Uitbreidingstraat 390,2023-07-29,02:00:00,15,9,6,FMN 18 Binnensingel Westkant
665,Uitbreidingstraat 390,2023-07-29,03:00:00,22,16,6,FMN 18 Binnensingel Westkant
665,Uitbreidingstraat 390,2023-07-29,04:00:00,13,8,5,FMN 18 Binnensingel Westkant
665,Uitbreidingstraat 390,2023-07-29,05:00:00,18,8,10,FMN 18 Binnensingel Westkant
665,Uitbreidingstraat 390,2023-07-29,06:00:00,23,12,11,FMN 18 Binnensingel Westkant
665,Uitbreidingstraat 390,2023-07-29,07:00:00,32,12,20,FMN 18 Binnensingel Westkant
665,Uitbreidingstraat 390,2023-07-29,08:00:00,29,20,9,FMN 18 Binnensingel Westkant
665,Uitbreidingstraat 390,2023-07-29,09:00:00,55,22,33,FMN 18 Binnensingel Westkant
665,Uitbreidingstraat 390,2023-07-29,10:00:00,70,35,35,FMN 18 Binnensingel Westkant
665,Uitbreidingstraat 390,2023-07-29,11:00:00,82,40,42,FMN 18 Binnensingel Westkant
665,Uitbreidingstraat 390,2023-07-29,12:00:00,74,33,41,FMN 18 Binnensingel Westkant
665,Uitbreidingstraat 390,2023-07-29,13:00:00,44,21,23,FMN 18 Binnensingel Westkant
665,Uitbreidingstraat 390,2023-07-29,14:00:00,84,36,48,FMN 18 Binnensingel Westkant
665,Uitbreidingstraat 390,2023-07-29,15:00:00,92,44,48,FMN 18 Binnensingel Westkant
665,Uitbreidingstraat 390,2023-07-29,16:00:00,83,38,45,FMN 18 Binnensingel Westkant
665,Uitbreidingstraat 390,2023-07-29,17:00:00,87,38,49,FMN 18 Binnensingel Westkant
665,Uitbreidingstraat 390,2023-07-29,18:00:00,94,49,45,FMN 18 Binnensingel Westkant
665,Uitbreidingstraat 390,2023-07-29,19:00:00,71,34,37,FMN 18 Binnensingel Westkant
665,Uitbreidingstraat 390,2023-07-29,20:00:00,71,33,38,FMN 18 Binnensingel Westkant
665,Uitbreidingstraat 390,2023-07-29,21:00:00,45,23,22,FMN 18 Binnensingel Westkant
665,Uitbreidingstraat 390,2023-07-29,22:00:00,50,30,20,FMN 18 Binnensingel Westkant
665,Uitbreidingstraat 390,2023-07-29,23:00:00,53,27,26,FMN 18 Binnensingel Westkant
665,Uitbreidingstraat 390,2023-07-30,00:00:00,42,16,26,FMN 18 Binnensingel Westkant
665,Uitbreidingstraat 390,2023-07-30,01:00:00,29,21,8,FMN 18 Binnensingel Westkant
665,Uitbreidingstraat 390,2023-07-30,02:00:00,15,6,9,FMN 18 Binnensingel Westkant
665,Uitbreidingstraat 390,2023-07-30,03:00:00,18,10,8,FMN 18 Binnensingel Westkant
665,Uitbreidingstraat 390,2023-07-30,04:00:00,13,6,7,FMN 18 Binnensingel Westkant
665,Uitbreidingstraat 390,2023-07-30,05:00:00,19,4,15,FMN 18 Binnensingel Westkant
665,Uitbreidingstraat 390,2023-07-30,06:00:00,12,6,6,FMN 18 Binnensingel Westkant
665,Uitbreidingstraat 390,2023-07-30,07:00:00,12,4,8,FMN 18 Binnensingel Westkant
665,Uitbreidingstraat 390,2023-07-30,08:00:00,11,4,7,FMN 18 Binnensingel Westkant
665,Uitbreidingstraat 390,2023-07-30,09:00:00,29,13,16,FMN 18 Binnensingel Westkant
665,Uitbreidingstraat 390,2023-07-30,10:00:00,51,26,25,FMN 18 Binnensingel Westkant
665,Uitbreidingstraat 390,2023-07-30,11:00:00,75,36,39,FMN 18 Binnensingel Westkant
665,Uitbreidingstraat 390,2023-07-30,12:00:00,98,42,56,FMN 18 Binnensingel Westkant
665,Uitbreidingstraat 390,2023-07-30,13:00:00,94,53,41,FMN 18 Binnensingel Westkant
665,Uitbreidingstraat 390,2023-07-30,14:00:00,88,37,51,FMN 18 Binnensingel Westkant
665,Uitbreidingstraat 390,2023-07-30,15:00:00,72,42,30,FMN 18 Binnensingel Westkant
665,Uitbreidingstraat 390,2023-07-30,16:00:00,95,42,53,FMN 18 Binnensingel Westkant
665,Uitbreidingstraat 390,2023-07-30,17:00:00,72,39,33,FMN 18 Binnensingel Westkant
665,Uitbreidingstraat 390,2023-07-30,18:00:00,63,32,31,FMN 18 Binnensingel Westkant
665,Uitbreidingstraat 390,2023-07-30,19:00:00,33,15,18,FMN 18 Binnensingel Westkant
665,Uitbreidingstraat 390,2023-07-30,20:00:00,54,31,23,FMN 18 Binnensingel Westkant
665,Uitbreidingstraat 390,2023-07-30,21:00:00,33,20,13,FMN 18 Binnensingel Westkant
665,Uitbreidingstraat 390,2023-07-30,22:00:00,27,11,16,FMN 18 Binnensingel Westkant
665,Uitbreidingstraat 390,2023-07-30,23:00:00,18,9,9,FMN 18 Binnensingel Westkant
665,Uitbreidingstraat 390,2023-07-31,00:00:00,14,6,8,FMN 18 Binnensingel Westkant
665,Uitbreidingstraat 390,2023-07-31,01:00:00,15,8,7,FMN 18 Binnensingel Westkant
665,Uitbreidingstraat 390,2023-07-31,02:00:00,17,10,7,FMN 18 Binnensingel Westkant
665,Uitbreidingstraat 390,2023-07-31,03:00:00,7,5,2,FMN 18 Binnensingel Westkant
665,Uitbreidingstraat 390,2023-07-31,04:00:00,19,9,10,FMN 18 Binnensingel Westkant
665,Uitbreidingstraat 390,2023-07-31,05:00:00,31,19,12,FMN 18 Binnensingel Westkant
665,Uitbreidingstraat 390,2023-07-31,06:00:00,47,28,19,FMN 18 Binnensingel Westkant
665,Uitbreidingstraat 390,2023-07-31,07:00:00,100,56,44,FMN 18 Binnensingel Westkant
665,Uitbreidingstraat 390,2023-07-31,08:00:00,125,72,53,FMN 18 Binnensingel Westkant
665,Uitbreidingstraat 390,2023-07-31,09:00:00,69,39,30,FMN 18 Binnensingel Westkant
665,Uitbreidingstraat 390,2023-07-31,10:00:00,55,32,23,FMN 18 Binnensingel Westkant
665,Uitbreidingstraat 390,2023-07-31,11:00:00,64,34,30,FMN 18 Binnensingel Westkant
665,Uitbreidingstraat 390,2023-07-31,12:00:00,67,32,35,FMN 18 Binnensingel Westkant
665,Uitbreidingstraat 390,2023-07-31,13:00:00,81,36,45,FMN 18 Binnensingel Westkant
665,Uitbreidingstraat 390,2023-07-31,14:00:00,66,27,39,FMN 18 Binnensingel Westkant
665,Uitbreidingstraat 390,2023-07-31,15:00:00,100,38,62,FMN 18 Binnensingel Westkant
665,Uitbreidingstraat 390,2023-07-31,16:00:00,120,50,70,FMN 18 Binnensingel Westkant
665,Uitbreidingstraat 390,2023-07-31,17:00:00,151,54,97,FMN 18 Binnensingel Westkant
665,Uitbreidingstraat 390,2023-07-31,18:00:00,102,50,52,FMN 18 Binnensingel Westkant
665,Uitbreidingstraat 390,2023-07-31,19:00:00,33,18,15,FMN 18 Binnensingel Westkant
665,Uitbreidingstraat 390,2023-07-31,20:00:00,44,23,21,FMN 18 Binnensingel Westkant
665,Uitbreidingstraat 390,2023-07-31,21:00:00,23,8,15,FMN 18 Binnensingel Westkant
665,Uitbreidingstraat 390,2023-07-31,22:00:00,33,11,22,FMN 18 Binnensingel Westkant
665,Uitbreidingstraat 390,2023-07-31,23:00:00,22,11,11,FMN 18 Binnensingel Westkant
665,Uitbreidingstraat 390,2023-08-01,00:00:00,12,9,3,FMN 18 Binnensingel Westkant
665,Uitbreidingstraat 390,2023-08-01,01:00:00,7,7,0,FMN 18 Binnensingel Westkant
665,Uitbreidingstraat 390,2023-08-01,02:00:00,1,1,0,FMN 18 Binnensingel Westkant
665,Uitbreidingstraat 390,2023-08-01,03:00:00,4,3,1,FMN 18 Binnensingel Westkant
665,Uitbreidingstraat 390,2023-08-01,04:00:00,14,6,8,FMN 18 Binnensingel Westkant
665,Uitbreidingstraat 390,2023-08-01,05:00:00,31,19,12,FMN 18 Binnensingel Westkant
665,Uitbreidingstraat 390,2023-08-01,06:00:00,58,31,27,FMN 18 Binnensingel Westkant
665,Uitbreidingstraat 390,2023-08-01,07:00:00,158,79,79,FMN 18 Binnensingel Westkant
665,Uitbreidingstraat 390,2023-08-01,08:00:00,180,102,78,FMN 18 Binnensingel Westkant
665,Uitbreidingstraat 390,2023-08-01,09:00:00,99,56,43,FMN 18 Binnensingel Westkant
665,Uitbreidingstraat 390,2023-08-01,10:00:00,54,31,23,FMN 18 Binnensingel Westkant
665,Uitbreidingstraat 390,2023-08-01,11:00:00,61,29,32,FMN 18 Binnensingel Westkant
665,Uitbreidingstraat 390,2023-08-01,12:00:00,100,48,52,FMN 18 Binnensingel Westkant
665,Uitbreidingstraat 390,2023-08-01,13:00:00,122,53,69,FMN 18 Binnensingel Westkant
665,Uitbreidingstraat 390,2023-08-01,14:00:00,93,28,65,FMN 18 Binnensingel Westkant
665,Uitbreidingstraat 390,2023-08-01,15:00:00,124,45,79,FMN 18 Binnensingel Westkant
665,Uitbreidingstraat 390,2023-08-01,16:00:00,194,64,130,FMN 18 Binnensingel Westkant
665,Uitbreidingstraat 390,2023-08-01,17:00:00,241,105,136,FMN 18 Binnensingel Westkant
665,Uitbreidingstraat 390,2023-08-01,18:00:00,193,108,85,FMN 18 Binnensingel Westkant
665,Uitbreidingstraat 390,2023-08-01,19:00:00,102,53,49,FMN 18 Binnensingel Westkant
665,Uitbreidingstraat 390,2023-08-01,20:00:00,81,29,52,FMN 18 Binnensingel Westkant
665,Uitbreidingstraat 390,2023-08-01,21:00:00,69,36,33,FMN 18 Binnensingel Westkant
665,Uitbreidingstraat 390,2023-08-01,22:00:00,67,32,35,FMN 18 Binnensingel Westkant
665,Uitbreidingstraat 390,2023-08-01,23:00:00,40,23,17,FMN 18 Binnensingel Westkant
665,Uitbreidingstraat 390,2023-08-02,00:00:00,24,10,14,FMN 18 Binnensingel Westkant
665,Uitbreidingstraat 390,2023-08-02,01:00:00,15,11,4,FMN 18 Binnensingel Westkant
665,Uitbreidingstraat 390,2023-08-02,02:00:00,7,6,1,FMN 18 Binnensingel Westkant
665,Uitbreidingstraat 390,2023-08-02,03:00:00,5,2,3,FMN 18 Binnensingel Westkant
665,Uitbreidingstraat 390,2023-08-02,04:00:00,17,8,9,FMN 18 Binnensingel Westkant
665,Uitbreidingstraat 390,2023-08-02,05:00:00,28,17,11,FMN 18 Binnensingel Westkant
665,Uitbreidingstraat 390,2023-08-02,06:00:00,54,25,29,FMN 18 Binnensingel Westkant
665,Uitbreidingstraat 390,2023-08-02,07:00:00,100,46,54,FMN 18 Binnensingel Westkant
665,Uitbreidingstraat 390,2023-08-02,08:00:00,128,82,46,FMN 18 Binnensingel Westkant
665,Uitbreidingstraat 390,2023-08-02,09:00:00,65,39,26,FMN 18 Binnensingel Westkant
665,Uitbreidingstraat 390,2023-08-02,10:00:00,68,37,31,FMN 18 Binnensingel Westkant
665,Uitbreidingstraat 390,2023-08-02,11:00:00,63,32,31,FMN 18 Binnensingel Westkant
665,Uitbreidingstraat 390,2023-08-02,12:00:00,71,31,40,FMN 18 Binnensingel Westkant
665,Uitbreidingstraat 390,2023-08-02,13:00:00,59,28,31,FMN 18 Binnensingel Westkant
665,Uitbreidingstraat 390,2023-08-02,14:00:00,100,52,48,FMN 18 Binnensingel Westkant
665,Uitbreidingstraat 390,2023-08-02,15:00:00,88,34,54,FMN 18 Binnensingel Westkant
665,Uitbreidingstraat 390,2023-08-02,16:00:00,140,59,81,FMN 18 Binnensingel Westkant
665,Uitbreidingstraat 390,2023-08-02,17:00:00,209,80,129,FMN 18 Binnensingel Westkant
665,Uitbreidingstraat 390,2023-08-02,18:00:00,126,51,75,FMN 18 Binnensingel Westkant
665,Uitbreidingstraat 390,2023-08-02,19:00:00,82,39,43,FMN 18 Binnensingel Westkant
665,Uitbreidingstraat 390,2023-08-02,20:00:00,51,24,27,FMN 18 Binnensingel Westkant
665,Uitbreidingstraat 390,2023-08-02,21:00:00,43,17,26,FMN 18 Binnensingel Westkant
665,Uitbreidingstraat 390,2023-08-02,22:00:00,44,16,28,FMN 18 Binnensingel Westkant
665,Uitbreidingstraat 390,2023-08-02,23:00:00,24,12,12,FMN 18 Binnensingel Westkant
665,Uitbreidingstraat 390,2023-08-03,00:00:00,14,9,5,FMN 18 Binnensingel Westkant
665,Uitbreidingstraat 390,2023-08-03,01:00:00,5,2,3,FMN 18 Binnensingel Westkant
665,Uitbreidingstraat 390,2023-08-03,02:00:00,4,2,2,FMN 18 Binnensingel Westkant
665,Uitbreidingstraat 390,2023-08-03,03:00:00,5,3,2,FMN 18 Binnensingel Westkant
665,Uitbreidingstraat 390,2023-08-03,04:00:00,6,3,3,FMN 18 Binnensingel Westkant
665,Uitbreidingstraat 390,2023-08-03,05:00:00,29,18,11,FMN 18 Binnensingel Westkant
665,Uitbreidingstraat 390,2023-08-03,06:00:00,52,23,29,FMN 18 Binnensingel Westkant
665,Uitbreidingstraat 390,2023-08-03,07:00:00,110,49,61,FMN 18 Binnensingel Westkant
665,Uitbreidingstraat 390,2023-08-03,08:00:00,176,96,80,FMN 18 Binnensingel Westkant
665,Uitbreidingstraat 390,2023-08-03,09:00:00,79,50,29,FMN 18 Binnensingel Westkant
665,Uitbreidingstraat 390,2023-08-03,10:00:00,43,27,16,FMN 18 Binnensingel Westkant
665,Uitbreidingstraat 390,2023-08-03,11:00:00,58,20,38,FMN 18 Binnensingel Westkant
665,Uitbreidingstraat 390,2023-08-03,12:00:00,66,36,30,FMN 18 Binnensingel Westkant
665,Uitbreidingstraat 390,2023-08-03,13:00:00,47,24,23,FMN 18 Binnensingel Westkant
665,Uitbreidingstraat 390,2023-08-03,14:00:00,64,21,43,FMN 18 Binnensingel Westkant
665,Uitbreidingstraat 390,2023-08-03,15:00:00,92,40,52,FMN 18 Binnensingel Westkant
665,Uitbreidingstraat 390,2023-08-03,16:00:00,154,55,99,FMN 18 Binnensingel Westkant
665,Uitbreidingstraat 390,2023-08-03,17:00:00,206,71,135,FMN 18 Binnensingel Westkant
665,Uitbreidingstraat 390,2023-08-03,18:00:00,146,70,76,FMN 18 Binnensingel Westkant
665,Uitbreidingstraat 390,2023-08-03,19:00:00,109,64,45,FMN 18 Binnensingel Westkant
665,Uitbreidingstraat 390,2023-08-03,20:00:00,91,45,46,FMN 18 Binnensingel Westkant
665,Uitbreidingstraat 390,2023-08-03,21:00:00,64,20,44,FMN 18 Binnensingel Westkant
665,Uitbreidingstraat 390,2023-08-03,22:00:00,52,25,27,FMN 18 Binnensingel Westkant
665,Uitbreidingstraat 390,2023-08-03,23:00:00,44,24,20,FMN 18 Binnensingel Westkant
665,Uitbreidingstraat 390,2023-08-04,00:00:00,25,17,8,FMN 18 Binnensingel Westkant
665,Uitbreidingstraat 390,2023-08-04,01:00:00,17,7,10,FMN 18 Binnensingel Westkant
665,Uitbreidingstraat 390,2023-08-04,02:00:00,4,2,2,FMN 18 Binnensingel Westkant
665,Uitbreidingstraat 390,2023-08-04,03:00:00,7,1,6,FMN 18 Binnensingel Westkant
665,Uitbreidingstraat 390,2023-08-04,04:00:00,11,7,4,FMN 18 Binnensingel Westkant
665,Uitbreidingstraat 390,2023-08-04,05:00:00,39,26,13,FMN 18 Binnensingel Westkant
665,Uitbreidingstraat 390,2023-08-04,06:00:00,64,36,28,FMN 18 Binnensingel Westkant
665,Uitbreidingstraat 390,2023-08-04,07:00:00,92,48,44,FMN 18 Binnensingel Westkant
665,Uitbreidingstraat 390,2023-08-04,08:00:00,145,90,55,FMN 18 Binnensingel Westkant
665,Uitbreidingstraat 390,2023-08-04,09:00:00,60,37,23,FMN 18 Binnensingel Westkant
665,Uitbreidingstraat 390,2023-08-04,10:00:00,58,29,29,FMN 18 Binnensingel Westkant
665,Uitbreidingstraat 390,2023-08-04,11:00:00,59,29,30,FMN 18 Binnensingel Westkant
665,Uitbreidingstraat 390,2023-08-04,12:00:00,105,47,58,FMN 18 Binnensingel Westkant
665,Uitbreidingstraat 390,2023-08-04,13:00:00,90,54,36,FMN 18 Binnensingel Westkant
665,Uitbreidingstraat 390,2023-08-04,14:00:00,102,41,61,FMN 18 Binnensingel Westkant
665,Uitbreidingstraat 390,2023-08-04,15:00:00,123,57,66,FMN 18 Binnensingel Westkant
665,Uitbreidingstraat 390,2023-08-04,16:00:00,175,77,98,FMN 18 Binnensingel Westkant
665,Uitbreidingstraat 390,2023-08-04,17:00:00,220,82,138,FMN 18 Binnensingel Westkant
665,Uitbreidingstraat 390,2023-08-04,18:00:00,145,69,76,FMN 18 Binnensingel Westkant
665,Uitbreidingstraat 390,2023-08-04,19:00:00,95,42,53,FMN 18 Binnensingel Westkant
665,Uitbreidingstraat 390,2023-08-04,20:00:00,87,30,57,FMN 18 Binnensingel Westkant
665,Uitbreidingstraat 390,2023-08-04,21:00:00,76,29,47,FMN 18 Binnensingel Westkant
665,Uitbreidingstraat 390,2023-08-04,22:00:00,65,24,41,FMN 18 Binnensingel Westkant
665,Uitbreidingstraat 390,2023-08-04,23:00:00,42,21,21,FMN 18 Binnensingel Westkant
665,Uitbreidingstraat 390,2023-08-05,00:00:00,34,23,11,FMN 18 Binnensingel Westkant
665,Uitbreidingstraat 390,2023-08-05,01:00:00,26,18,8,FMN 18 Binnensingel Westkant
665,Uitbreidingstraat 390,2023-08-05,02:00:00,19,12,7,FMN 18 Binnensingel Westkant
665,Uitbreidingstraat 390,2023-08-05,03:00:00,21,15,6,FMN 18 Binnensingel Westkant
665,Uitbreidingstraat 390,2023-08-05,04:00:00,11,8,3,FMN 18 Binnensingel Westkant
665,Uitbreidingstraat 390,2023-08-05,05:00:00,15,6,9,FMN 18 Binnensingel Westkant
665,Uitbreidingstraat 390,2023-08-05,06:00:00,31,22,9,FMN 18 Binnensingel Westkant
665,Uitbreidingstraat 390,2023-08-05,07:00:00,23,13,10,FMN 18 Binnensingel Westkant
665,Uitbreidingstraat 390,2023-08-05,08:00:00,35,16,19,FMN 18 Binnensingel Westkant
665,Uitbreidingstraat 390,2023-08-05,09:00:00,52,28,24,FMN 18 Binnensingel Westkant
665,Uitbreidingstraat 390,2023-08-05,10:00:00,82,41,41,FMN 18 Binnensingel Westkant
665,Uitbreidingstraat 390,2023-08-05,11:00:00,55,26,29,FMN 18 Binnensingel Westkant
665,Uitbreidingstraat 390,2023-08-05,12:00:00,66,32,34,FMN 18 Binnensingel Westkant
665,Uitbreidingstraat 390,2023-08-05,13:00:00,56,23,33,FMN 18 Binnensingel Westkant
665,Uitbreidingstraat 390,2023-08-05,14:00:00,59,27,32,FMN 18 Binnensingel Westkant
665,Uitbreidingstraat 390,2023-08-05,15:00:00,64,33,31,FMN 18 Binnensingel Westkant
665,Uitbreidingstraat 390,2023-08-05,16:00:00,47,22,25,FMN 18 Binnensingel Westkant
665,Uitbreidingstraat 390,2023-08-05,17:00:00,61,38,23,FMN 18 Binnensingel Westkant
665,Uitbreidingstraat 390,2023-08-05,18:00:00,56,31,25,FMN 18 Binnensingel Westkant
665,Uitbreidingstraat 390,2023-08-05,19:00:00,52,27,25,FMN 18 Binnensingel Westkant
665,Uitbreidingstraat 390,2023-08-05,20:00:00,61,30,31,FMN 18 Binnensingel Westkant
665,Uitbreidingstraat 390,2023-08-05,21:00:00,28,21,7,FMN 18 Binnensingel Westkant
665,Uitbreidingstraat 390,2023-08-05,22:00:00,39,19,20,FMN 18 Binnensingel Westkant
665,Uitbreidingstraat 390,2023-08-05,23:00:00,20,9,11,FMN 18 Binnensingel Westkant
665,Uitbreidingstraat 390,2023-08-06,00:00:00,22,17,5,FMN 18 Binnensingel Westkant
665,Uitbreidingstraat 390,2023-08-06,01:00:00,23,16,7,FMN 18 Binnensingel Westkant
665,Uitbreidingstraat 390,2023-08-06,02:00:00,14,5,9,FMN 18 Binnensingel Westkant
665,Uitbreidingstraat 390,2023-08-06,03:00:00,11,8,3,FMN 18 Binnensingel Westkant
665,Uitbreidingstraat 390,2023-08-06,04:00:00,2,1,1,FMN 18 Binnensingel Westkant
665,Uitbreidingstraat 390,2023-08-06,05:00:00,8,4,4,FMN 18 Binnensingel Westkant
665,Uitbreidingstraat 390,2023-08-06,06:00:00,11,10,1,FMN 18 Binnensingel Westkant
665,Uitbreidingstraat 390,2023-08-06,07:00:00,13,6,7,FMN 18 Binnensingel Westkant
665,Uitbreidingstraat 390,2023-08-06,08:00:00,9,8,1,FMN 18 Binnensingel Westkant
665,Uitbreidingstraat 390,2023-08-06,09:00:00,27,13,14,FMN 18 Binnensingel Westkant
665,Uitbreidingstraat 390,2023-08-06,10:00:00,28,16,12,FMN 18 Binnensingel Westkant
665,Uitbreidingstraat 390,2023-08-06,11:00:00,35,17,18,FMN 18 Binnensingel Westkant
665,Uitbreidingstraat 390,2023-08-06,12:00:00,44,23,21,FMN 18 Binnensingel Westkant
665,Uitbreidingstraat 390,2023-08-06,13:00:00,30,16,14,FMN 18 Binnensingel Westkant
665,Uitbreidingstraat 390,2023-08-06,14:00:00,37,11,26,FMN 18 Binnensingel Westkant
665,Uitbreidingstraat 390,2023-08-06,15:00:00,30,9,21,FMN 18 Binnensingel Westkant
665,Uitbreidingstraat 390,2023-08-06,16:00:00,31,15,16,FMN 18 Binnensingel Westkant
665,Uitbreidingstraat 390,2023-08-06,17:00:00,29,17,12,FMN 18 Binnensingel Westkant
665,Uitbreidingstraat 390,2023-08-06,18:00:00,55,23,32,FMN 18 Binnensingel Westkant
665,Uitbreidingstraat 390,2023-08-06,19:00:00,40,23,17,FMN 18 Binnensingel Westkant
665,Uitbreidingstraat 390,2023-08-06,20:00:00,48,27,21,FMN 18 Binnensingel Westkant
665,Uitbreidingstraat 390,2023-08-06,21:00:00,30,14,16,FMN 18 Binnensingel Westkant
665,Uitbreidingstraat 390,2023-08-06,22:00:00,31,13,18,FMN 18 Binnensingel Westkant
665,Uitbreidingstraat 390,2023-08-06,23:00:00,31,18,13,FMN 18 Binnensingel Westkant
665,Uitbreidingstraat 390,2023-08-07,00:00:00,16,12,4,FMN 18 Binnensingel Westkant
665,Uitbreidingstraat 390,2023-08-07,01:00:00,6,2,4,FMN 18 Binnensingel Westkant
665,Uitbreidingstraat 390,2023-08-07,02:00:00,2,0,2,FMN 18 Binnensingel Westkant
665,Uitbreidingstraat 390,2023-08-07,03:00:00,5,4,1,FMN 18 Binnensingel Westkant
665,Uitbreidingstraat 390,2023-08-07,04:00:00,13,6,7,FMN 18 Binnensingel Westkant
665,Uitbreidingstraat 390,2023-08-07,05:00:00,30,21,9,FMN 18 Binnensingel Westkant
665,Uitbreidingstraat 390,2023-08-07,06:00:00,61,33,28,FMN 18 Binnensingel Westkant
665,Uitbreidingstraat 390,2023-08-07,07:00:00,131,68,63,FMN 18 Binnensingel Westkant
665,Uitbreidingstraat 390,2023-08-07,08:00:00,204,117,87,FMN 18 Binnensingel Westkant
665,Uitbreidingstraat 390,2023-08-07,09:00:00,93,52,41,FMN 18 Binnensingel Westkant
665,Uitbreidingstraat 390,2023-08-07,10:00:00,56,35,21,FMN 18 Binnensingel Westkant
665,Uitbreidingstraat 390,2023-08-07,11:00:00,76,39,37,FMN 18 Binnensingel Westkant
665,Uitbreidingstraat 390,2023-08-07,12:00:00,93,47,46,FMN 18 Binnensingel Westkant
665,Uitbreidingstraat 390,2023-08-07,13:00:00,87,37,50,FMN 18 Binnensingel Westkant
665,Uitbreidingstraat 390,2023-08-07,14:00:00,118,52,66,FMN 18 Binnensingel Westkant
665,Uitbreidingstraat 390,2023-08-07,15:00:00,128,56,72,FMN 18 Binnensingel Westkant
665,Uitbreidingstraat 390,2023-08-07,16:00:00,194,69,125,FMN 18 Binnensingel Westkant
665,Uitbreidingstraat 390,2023-08-07,17:00:00,265,109,156,FMN 18 Binnensingel Westkant
665,Uitbreidingstraat 390,2023-08-07,18:00:00,172,82,90,FMN 18 Binnensingel Westkant
665,Uitbreidingstraat 390,2023-08-07,19:00:00,98,39,59,FMN 18 Binnensingel Westkant
665,Uitbreidingstraat 390,2023-08-07,20:00:00,92,43,49,FMN 18 Binnensingel Westkant
665,Uitbreidingstraat 390,2023-08-07,21:00:00,62,27,35,FMN 18 Binnensingel Westkant
665,Uitbreidingstraat 390,2023-08-07,22:00:00,74,30,44,FMN 18 Binnensingel Westkant
665,Uitbreidingstraat 390,2023-08-07,23:00:00,33,21,12,FMN 18 Binnensingel Westkant
665,Uitbreidingstraat 390,2023-08-08,00:00:00,29,20,9,FMN 18 Binnensingel Westkant
665,Uitbreidingstraat 390,2023-08-08,01:00:00,12,7,5,FMN 18 Binnensingel Westkant
665,Uitbreidingstraat 390,2023-08-08,02:00:00,2,1,1,FMN 18 Binnensingel Westkant
665,Uitbreidingstraat 390,2023-08-08,03:00:00,11,4,7,FMN 18 Binnensingel Westkant
665,Uitbreidingstraat 390,2023-08-08,04:00:00,12,4,8,FMN 18 Binnensingel Westkant
665,Uitbreidingstraat 390,2023-08-08,05:00:00,34,18,16,FMN 18 Binnensingel Westkant
665,Uitbreidingstraat 390,2023-08-08,06:00:00,78,42,36,FMN 18 Binnensingel Westkant
665,Uitbreidingstraat 390,2023-08-08,07:00:00,150,73,77,FMN 18 Binnensingel Westkant
665,Uitbreidingstraat 390,2023-08-08,08:00:00,229,125,104,FMN 18 Binnensingel Westkant
665,Uitbreidingstraat 390,2023-08-08,09:00:00,123,78,45,FMN 18 Binnensingel Westkant
665,Uitbreidingstraat 390,2023-08-08,10:00:00,73,40,33,FMN 18 Binnensingel Westkant
665,Uitbreidingstraat 390,2023-08-08,11:00:00,61,26,35,FMN 18 Binnensingel Westkant
665,Uitbreidingstraat 390,2023-08-08,12:00:00,101,60,41,FMN 18 Binnensingel Westkant
665,Uitbreidingstraat 390,2023-08-08,13:00:00,95,47,48,FMN 18 Binnensingel Westkant
665,Uitbreidingstraat 390,2023-08-08,14:00:00,111,48,63,FMN 18 Binnensingel Westkant
665,Uitbreidingstraat 390,2023-08-08,15:00:00,121,45,76,FMN 18 Binnensingel Westkant
665,Uitbreidingstraat 390,2023-08-08,16:00:00,208,80,128,FMN 18 Binnensingel Westkant
665,Uitbreidingstraat 390,2023-08-08,17:00:00,279,114,165,FMN 18 Binnensingel Westkant
665,Uitbreidingstraat 390,2023-08-08,18:00:00,154,70,84,FMN 18 Binnensingel Westkant
665,Uitbreidingstraat 390,2023-08-08,19:00:00,83,47,36,FMN 18 Binnensingel Westkant
665,Uitbreidingstraat 390,2023-08-08,20:00:00,63,21,42,FMN 18 Binnensingel Westkant
665,Uitbreidingstraat 390,2023-08-08,21:00:00,42,21,21,FMN 18 Binnensingel Westkant
665,Uitbreidingstraat 390,2023-08-08,22:00:00,73,29,44,FMN 18 Binnensingel Westkant
665,Uitbreidingstraat 390,2023-08-08,23:00:00,22,10,12,FMN 18 Binnensingel Westkant
665,Uitbreidingstraat 390,2023-08-09,00:00:00,22,11,11,FMN 18 Binnensingel Westkant
665,Uitbreidingstraat 390,2023-08-09,01:00:00,7,2,5,FMN 18 Binnensingel Westkant
665,Uitbreidingstraat 390,2023-08-09,02:00:00,3,1,2,FMN 18 Binnensingel Westkant
665,Uitbreidingstraat 390,2023-08-09,03:00:00,3,2,1,FMN 18 Binnensingel Westkant
665,Uitbreidingstraat 390,2023-08-09,04:00:00,16,9,7,FMN 18 Binnensingel Westkant
665,Uitbreidingstraat 390,2023-08-09,05:00:00,30,17,13,FMN 18 Binnensingel Westkant
665,Uitbreidingstraat 390,2023-08-09,06:00:00,61,31,30,FMN 18 Binnensingel Westkant
665,Uitbreidingstraat 390,2023-08-09,07:00:00,135,68,67,FMN 18 Binnensingel Westkant
665,Uitbreidingstraat 390,2023-08-09,08:00:00,186,99,87,FMN 18 Binnensingel Westkant
665,Uitbreidingstraat 390,2023-08-09,09:00:00,101,50,51,FMN 18 Binnensingel Westkant
665,Uitbreidingstraat 390,2023-08-09,10:00:00,74,39,35,FMN 18 Binnensingel Westkant
665,Uitbreidingstraat 390,2023-08-09,11:00:00,86,36,50,FMN 18 Binnensingel Westkant
665,Uitbreidingstraat 390,2023-08-09,12:00:00,104,54,50,FMN 18 Binnensingel Westkant
665,Uitbreidingstraat 390,2023-08-09,13:00:00,102,62,40,FMN 18 Binnensingel Westkant
665,Uitbreidingstraat 390,2023-08-09,14:00:00,112,52,60,FMN 18 Binnensingel Westkant
665,Uitbreidingstraat 390,2023-08-09,15:00:00,156,80,76,FMN 18 Binnensingel Westkant
665,Uitbreidingstraat 390,2023-08-09,16:00:00,191,80,111,FMN 18 Binnensingel Westkant
665,Uitbreidingstraat 390,2023-08-09,17:00:00,277,107,170,FMN 18 Binnensingel Westkant
665,Uitbreidingstraat 390,2023-08-09,18:00:00,226,98,128,FMN 18 Binnensingel Westkant
665,Uitbreidingstraat 390,2023-08-09,19:00:00,135,61,74,FMN 18 Binnensingel Westkant
665,Uitbreidingstraat 390,2023-08-09,20:00:00,117,47,70,FMN 18 Binnensingel Westkant
665,Uitbreidingstraat 390,2023-08-09,21:00:00,88,35,53,FMN 18 Binnensingel Westkant
665,Uitbreidingstraat 390,2023-08-09,22:00:00,92,29,63,FMN 18 Binnensingel Westkant
665,Uitbreidingstraat 390,2023-08-09,23:00:00,52,33,19,FMN 18 Binnensingel Westkant
665,Uitbreidingstraat 390,2023-08-10,00:00:00,28,14,14,FMN 18 Binnensingel Westkant
665,Uitbreidingstraat 390,2023-08-10,01:00:00,10,8,2,FMN 18 Binnensingel Westkant
665,Uitbreidingstraat 390,2023-08-10,02:00:00,9,4,5,FMN 18 Binnensingel Westkant
665,Uitbreidingstraat 390,2023-08-10,03:00:00,9,4,5,FMN 18 Binnensingel Westkant
665,Uitbreidingstraat 390,2023-08-10,04:00:00,21,8,13,FMN 18 Binnensingel Westkant
665,Uitbreidingstraat 390,2023-08-10,05:00:00,39,19,20,FMN 18 Binnensingel Westkant
665,Uitbreidingstraat 390,2023-08-10,06:00:00,66,32,34,FMN 18 Binnensingel Westkant
665,Uitbreidingstraat 390,2023-08-10,07:00:00,154,75,79,FMN 18 Binnensingel Westkant
665,Uitbreidingstraat 390,2023-08-10,08:00:00,237,139,98,FMN 18 Binnensingel Westkant
665,Uitbreidingstraat 390,2023-08-10,09:00:00,143,80,63,FMN 18 Binnensingel Westkant
665,Uitbreidingstraat 390,2023-08-10,10:00:00,93,46,47,FMN 18 Binnensingel Westkant
665,Uitbreidingstraat 390,2023-08-10,11:00:00,96,52,44,FMN 18 Binnensingel Westkant
665,Uitbreidingstraat 390,2023-08-10,12:00:00,113,51,62,FMN 18 Binnensingel Westkant
665,Uitbreidingstraat 390,2023-08-10,13:00:00,109,52,57,FMN 18 Binnensingel Westkant
665,Uitbreidingstraat 390,2023-08-10,14:00:00,121,63,58,FMN 18 Binnensingel Westkant
665,Uitbreidingstraat 390,2023-08-10,15:00:00,137,50,87,FMN 18 Binnensingel Westkant
665,Uitbreidingstraat 390,2023-08-10,16:00:00,211,75,136,FMN 18 Binnensingel Westkant
665,Uitbreidingstraat 390,2023-08-10,17:00:00,296,121,175,FMN 18 Binnensingel Westkant
665,Uitbreidingstraat 390,2023-08-10,18:00:00,224,94,130,FMN 18 Binnensingel Westkant
665,Uitbreidingstraat 390,2023-08-10,19:00:00,175,65,110,FMN 18 Binnensingel Westkant
665,Uitbreidingstraat 390,2023-08-10,20:00:00,158,63,95,FMN 18 Binnensingel Westkant
665,Uitbreidingstraat 390,2023-08-10,21:00:00,110,57,53,FMN 18 Binnensingel Westkant
665,Uitbreidingstraat 390,2023-08-10,22:00:00,121,60,61,FMN 18 Binnensingel Westkant
665,Uitbreidingstraat 390,2023-08-10,23:00:00,65,45,20,FMN 18 Binnensingel Westkant
665,Uitbreidingstraat 390,2023-08-11,00:00:00,52,36,16,FMN 18 Binnensingel Westkant
665,Uitbreidingstraat 390,2023-08-11,01:00:00,35,30,5,FMN 18 Binnensingel Westkant
665,Uitbreidingstraat 390,2023-08-11,02:00:00,22,18,4,FMN 18 Binnensingel Westkant
665,Uitbreidingstraat 390,2023-08-11,03:00:00,9,8,1,FMN 18 Binnensingel Westkant
665,Uitbreidingstraat 390,2023-08-11,04:00:00,24,16,8,FMN 18 Binnensingel Westkant
665,Uitbreidingstraat 390,2023-08-11,05:00:00,49,27,22,FMN 18 Binnensingel Westkant
665,Uitbreidingstraat 390,2023-08-11,06:00:00,69,38,31,FMN 18 Binnensingel Westkant
665,Uitbreidingstraat 390,2023-08-11,07:00:00,141,87,54,FMN 18 Binnensingel Westkant
665,Uitbreidingstraat 390,2023-08-11,08:00:00,194,114,80,FMN 18 Binnensingel Westkant
665,Uitbreidingstraat 390,2023-08-11,09:00:00,128,77,51,FMN 18 Binnensingel Westkant
665,Uitbreidingstraat 390,2023-08-11,10:00:00,89,54,35,FMN 18 Binnensingel Westkant
665,Uitbreidingstraat 390,2023-08-11,11:00:00,117,58,59,FMN 18 Binnensingel Westkant
665,Uitbreidingstraat 390,2023-08-11,12:00:00,128,53,75,FMN 18 Binnensingel Westkant
665,Uitbreidingstraat 390,2023-08-11,13:00:00,137,57,80,FMN 18 Binnensingel Westkant
665,Uitbreidingstraat 390,2023-08-11,14:00:00,136,72,64,FMN 18 Binnensingel Westkant
665,Uitbreidingstraat 390,2023-08-11,15:00:00,159,76,83,FMN 18 Binnensingel Westkant
665,Uitbreidingstraat 390,2023-08-11,16:00:00,241,80,161,FMN 18 Binnensingel Westkant
665,Uitbreidingstraat 390,2023-08-11,17:00:00,240,84,156,FMN 18 Binnensingel Westkant
665,Uitbreidingstraat 390,2023-08-11,18:00:00,206,88,118,FMN 18 Binnensingel Westkant
665,Uitbreidingstraat 390,2023-08-11,19:00:00,118,57,61,FMN 18 Binnensingel Westkant
665,Uitbreidingstraat 390,2023-08-11,20:00:00,117,50,67,FMN 18 Binnensingel Westkant
665,Uitbreidingstraat 390,2023-08-11,21:00:00,63,27,36,FMN 18 Binnensingel Westkant
665,Uitbreidingstraat 390,2023-08-11,22:00:00,74,35,39,FMN 18 Binnensingel Westkant
665,Uitbreidingstraat 390,2023-08-11,23:00:00,51,31,20,FMN 18 Binnensingel Westkant
665,Uitbreidingstraat 390,2023-08-12,00:00:00,62,37,25,FMN 18 Binnensingel Westkant
665,Uitbreidingstraat 390,2023-08-12,01:00:00,35,14,21,FMN 18 Binnensingel Westkant
665,Uitbreidingstraat 390,2023-08-12,02:00:00,18,10,8,FMN 18 Binnensingel Westkant
665,Uitbreidingstraat 390,2023-08-12,03:00:00,8,5,3,FMN 18 Binnensingel Westkant
665,Uitbreidingstraat 390,2023-08-12,04:00:00,19,14,5,FMN 18 Binnensingel Westkant
665,Uitbreidingstraat 390,2023-08-12,05:00:00,11,6,5,FMN 18 Binnensingel Westkant
665,Uitbreidingstraat 390,2023-08-12,06:00:00,19,16,3,FMN 18 Binnensingel Westkant
665,Uitbreidingstraat 390,2023-08-12,07:00:00,18,7,11,FMN 18 Binnensingel Westkant
665,Uitbreidingstraat 390,2023-08-12,08:00:00,25,12,13,FMN 18 Binnensingel Westkant
665,Uitbreidingstraat 390,2023-08-12,09:00:00,49,23,26,FMN 18 Binnensingel Westkant
665,Uitbreidingstraat 390,2023-08-12,10:00:00,54,21,33,FMN 18 Binnensingel Westkant
665,Uitbreidingstraat 390,2023-08-12,11:00:00,68,33,35,FMN 18 Binnensingel Westkant
665,Uitbreidingstraat 390,2023-08-12,12:00:00,104,56,48,FMN 18 Binnensingel Westkant
665,Uitbreidingstraat 390,2023-08-12,13:00:00,86,43,43,FMN 18 Binnensingel Westkant
665,Uitbreidingstraat 390,2023-08-12,14:00:00,92,55,37,FMN 18 Binnensingel Westkant
665,Uitbreidingstraat 390,2023-08-12,15:00:00,86,46,40,FMN 18 Binnensingel Westkant
665,Uitbreidingstraat 390,2023-08-12,16:00:00,85,52,33,FMN 18 Binnensingel Westkant
665,Uitbreidingstraat 390,2023-08-12,17:00:00,94,42,52,FMN 18 Binnensingel Westkant
665,Uitbreidingstraat 390,2023-08-12,18:00:00,98,36,62,FMN 18 Binnensingel Westkant
665,Uitbreidingstraat 390,2023-08-12,19:00:00,99,40,59,FMN 18 Binnensingel Westkant
665,Uitbreidingstraat 390,2023-08-12,20:00:00,80,38,42,FMN 18 Binnensingel Westkant
665,Uitbreidingstraat 390,2023-08-12,21:00:00,68,32,36,FMN 18 Binnensingel Westkant
665,Uitbreidingstraat 390,2023-08-12,22:00:00,68,34,34,FMN 18 Binnensingel Westkant
665,Uitbreidingstraat 390,2023-08-12,23:00:00,68,36,32,FMN 18 Binnensingel Westkant
665,Uitbreidingstraat 390,2023-08-13,00:00:00,48,26,22,FMN 18 Binnensingel Westkant
665,Uitbreidingstraat 390,2023-08-13,01:00:00,26,13,13,FMN 18 Binnensingel Westkant
665,Uitbreidingstraat 390,2023-08-13,02:00:00,22,8,14,FMN 18 Binnensingel Westkant
665,Uitbreidingstraat 390,2023-08-13,03:00:00,16,7,9,FMN 18 Binnensingel Westkant
665,Uitbreidingstraat 390,2023-08-13,04:00:00,19,5,14,FMN 18 Binnensingel Westkant
665,Uitbreidingstraat 390,2023-08-13,05:00:00,18,6,12,FMN 18 Binnensingel Westkant
665,Uitbreidingstraat 390,2023-08-13,06:00:00,18,13,5,FMN 18 Binnensingel Westkant
665,Uitbreidingstraat 390,2023-08-13,07:00:00,12,2,10,FMN 18 Binnensingel Westkant
665,Uitbreidingstraat 390,2023-08-13,08:00:00,42,20,22,FMN 18 Binnensingel Westkant
665,Uitbreidingstraat 390,2023-08-13,09:00:00,47,19,28,FMN 18 Binnensingel Westkant
665,Uitbreidingstraat 390,2023-08-13,10:00:00,58,28,30,FMN 18 Binnensingel Westkant
665,Uitbreidingstraat 390,2023-08-13,11:00:00,75,37,38,FMN 18 Binnensingel Westkant
665,Uitbreidingstraat 390,2023-08-13,12:00:00,78,36,42,FMN 18 Binnensingel Westkant
665,Uitbreidingstraat 390,2023-08-13,13:00:00,99,65,34,FMN 18 Binnensingel Westkant
665,Uitbreidingstraat 390,2023-08-13,14:00:00,89,44,45,FMN 18 Binnensingel Westkant
665,Uitbreidingstraat 390,2023-08-13,15:00:00,99,46,53,FMN 18 Binnensingel Westkant
665,Uitbreidingstraat 390,2023-08-13,16:00:00,71,35,36,FMN 18 Binnensingel Westkant
665,Uitbreidingstraat 390,2023-08-13,17:00:00,88,41,47,FMN 18 Binnensingel Westkant
665,Uitbreidingstraat 390,2023-08-13,18:00:00,96,46,50,FMN 18 Binnensingel Westkant
665,Uitbreidingstraat 390,2023-08-13,19:00:00,85,42,43,FMN 18 Binnensingel Westkant
665,Uitbreidingstraat 390,2023-08-13,20:00:00,87,43,44,FMN 18 Binnensingel Westkant
665,Uitbreidingstraat 390,2023-08-13,21:00:00,87,42,45,FMN 18 Binnensingel Westkant
665,Uitbreidingstraat 390,2023-08-13,22:00:00,55,31,24,FMN 18 Binnensingel Westkant
665,Uitbreidingstraat 390,2023-08-13,23:00:00,36,16,20,FMN 18 Binnensingel Westkant
665,Uitbreidingstraat 390,2023-08-14,00:00:00,19,14,5,FMN 18 Binnensingel Westkant
665,Uitbreidingstraat 390,2023-08-14,01:00:00,18,9,9,FMN 18 Binnensingel Westkant
665,Uitbreidingstraat 390,2023-08-14,02:00:00,6,2,4,FMN 18 Binnensingel Westkant
665,Uitbreidingstraat 390,2023-08-14,03:00:00,9,6,3,FMN 18 Binnensingel Westkant
665,Uitbreidingstraat 390,2023-08-14,04:00:00,14,6,8,FMN 18 Binnensingel Westkant
665,Uitbreidingstraat 390,2023-08-14,05:00:00,33,20,13,FMN 18 Binnensingel Westkant
665,Uitbreidingstraat 390,2023-08-14,06:00:00,51,31,20,FMN 18 Binnensingel Westkant
665,Uitbreidingstraat 390,2023-08-14,07:00:00,83,49,34,FMN 18 Binnensingel Westkant
665,Uitbreidingstraat 390,2023-08-14,08:00:00,112,53,59,FMN 18 Binnensingel Westkant
665,Uitbreidingstraat 390,2023-08-14,09:00:00,89,42,47,FMN 18 Binnensingel Westkant
665,Uitbreidingstraat 390,2023-08-14,10:00:00,79,50,29,FMN 18 Binnensingel Westkant
665,Uitbreidingstraat 390,2023-08-14,11:00:00,70,31,39,FMN 18 Binnensingel Westkant
665,Uitbreidingstraat 390,2023-08-14,12:00:00,89,39,50,FMN 18 Binnensingel Westkant
665,Uitbreidingstraat 390,2023-08-14,13:00:00,91,54,37,FMN 18 Binnensingel Westkant
665,Uitbreidingstraat 390,2023-08-14,14:00:00,129,54,75,FMN 18 Binnensingel Westkant
665,Uitbreidingstraat 390,2023-08-14,15:00:00,101,46,55,FMN 18 Binnensingel Westkant
665,Uitbreidingstraat 390,2023-08-14,16:00:00,164,69,95,FMN 18 Binnensingel Westkant
665,Uitbreidingstraat 390,2023-08-14,17:00:00,160,75,85,FMN 18 Binnensingel Westkant
665,Uitbreidingstraat 390,2023-08-14,18:00:00,165,82,83,FMN 18 Binnensingel Westkant
665,Uitbreidingstraat 390,2023-08-14,19:00:00,134,77,57,FMN 18 Binnensingel Westkant
665,Uitbreidingstraat 390,2023-08-14,20:00:00,127,61,66,FMN 18 Binnensingel Westkant
665,Uitbreidingstraat 390,2023-08-14,21:00:00,74,33,41,FMN 18 Binnensingel Westkant
665,Uitbreidingstraat 390,2023-08-14,22:00:00,84,40,44,FMN 18 Binnensingel Westkant
665,Uitbreidingstraat 390,2023-08-14,23:00:00,55,29,26,FMN 18 Binnensingel Westkant
665,Uitbreidingstraat 390,2023-08-15,00:00:00,42,19,23,FMN 18 Binnensingel Westkant
665,Uitbreidingstraat 390,2023-08-15,01:00:00,24,13,11,FMN 18 Binnensingel Westkant
665,Uitbreidingstraat 390,2023-08-15,02:00:00,26,16,10,FMN 18 Binnensingel Westkant
665,Uitbreidingstraat 390,2023-08-15,03:00:00,18,8,10,FMN 18 Binnensingel Westkant
665,Uitbreidingstraat 390,2023-08-15,04:00:00,6,3,3,FMN 18 Binnensingel Westkant
665,Uitbreidingstraat 390,2023-08-15,05:00:00,15,8,7,FMN 18 Binnensingel Westkant
665,Uitbreidingstraat 390,2023-08-15,06:00:00,22,14,8,FMN 18 Binnensingel Westkant
665,Uitbreidingstraat 390,2023-08-15,07:00:00,35,15,20,FMN 18 Binnensingel Westkant
665,Uitbreidingstraat 390,2023-08-15,08:00:00,28,13,15,FMN 18 Binnensingel Westkant
665,Uitbreidingstraat 390,2023-08-15,09:00:00,49,19,30,FMN 18 Binnensingel Westkant
665,Uitbreidingstraat 390,2023-08-15,10:00:00,71,42,29,FMN 18 Binnensingel Westkant
665,Uitbreidingstraat 390,2023-08-15,11:00:00,81,44,37,FMN 18 Binnensingel Westkant
665,Uitbreidingstraat 390,2023-08-15,12:00:00,72,41,31,FMN 18 Binnensingel Westkant
665,Uitbreidingstraat 390,2023-08-15,13:00:00,110,61,49,FMN 18 Binnensingel Westkant
665,Uitbreidingstraat 390,2023-08-15,14:00:00,98,40,58,FMN 18 Binnensingel Westkant
665,Uitbreidingstraat 390,2023-08-15,15:00:00,131,58,73,FMN 18 Binnensingel Westkant
665,Uitbreidingstraat 390,2023-08-15,16:00:00,92,46,46,FMN 18 Binnensingel Westkant
665,Uitbreidingstraat 390,2023-08-15,17:00:00,113,55,58,FMN 18 Binnensingel Westkant
665,Uitbreidingstraat 390,2023-08-15,18:00:00,106,56,50,FMN 18 Binnensingel Westkant
665,Uitbreidingstraat 390,2023-08-15,19:00:00,95,49,46,FMN 18 Binnensingel Westkant
665,Uitbreidingstraat 390,2023-08-15,20:00:00,99,42,57,FMN 18 Binnensingel Westkant
665,Uitbreidingstraat 390,2023-08-15,21:00:00,66,31,35,FMN 18 Binnensingel Westkant
665,Uitbreidingstraat 390,2023-08-15,22:00:00,60,28,32,FMN 18 Binnensingel Westkant
665,Uitbreidingstraat 390,2023-08-15,23:00:00,37,22,15,FMN 18 Binnensingel Westkant
665,Uitbreidingstraat 390,2023-08-16,00:00:00,29,14,15,FMN 18 Binnensingel Westkant
665,Uitbreidingstraat 390,2023-08-16,01:00:00,12,7,5,FMN 18 Binnensingel Westkant
665,Uitbreidingstraat 390,2023-08-16,02:00:00,15,9,6,FMN 18 Binnensingel Westkant
665,Uitbreidingstraat 390,2023-08-16,03:00:00,8,5,3,FMN 18 Binnensingel Westkant
665,Uitbreidingstraat 390,2023-08-16,04:00:00,26,17,9,FMN 18 Binnensingel Westkant
665,Uitbreidingstraat 390,2023-08-16,05:00:00,41,29,12,FMN 18 Binnensingel Westkant
665,Uitbreidingstraat 390,2023-08-16,06:00:00,79,46,33,FMN 18 Binnensingel Westkant
665,Uitbreidingstraat 390,2023-08-16,07:00:00,158,86,72,FMN 18 Binnensingel Westkant
665,Uitbreidingstraat 390,2023-08-16,08:00:00,202,110,92,FMN 18 Binnensingel Westkant
665,Uitbreidingstraat 390,2023-08-16,09:00:00,132,78,54,FMN 18 Binnensingel Westkant
665,Uitbreidingstraat 390,2023-08-16,10:00:00,101,60,41,FMN 18 Binnensingel Westkant
665,Uitbreidingstraat 390,2023-08-16,11:00:00,89,47,42,FMN 18 Binnensingel Westkant
665,Uitbreidingstraat 390,2023-08-16,12:00:00,118,62,56,FMN 18 Binnensingel Westkant
665,Uitbreidingstraat 390,2023-08-16,13:00:00,93,53,40,FMN 18 Binnensingel Westkant
665,Uitbreidingstraat 390,2023-08-16,14:00:00,135,58,77,FMN 18 Binnensingel Westkant
665,Uitbreidingstraat 390,2023-08-16,15:00:00,145,63,82,FMN 18 Binnensingel Westkant
665,Uitbreidingstraat 390,2023-08-16,16:00:00,235,86,149,FMN 18 Binnensingel Westkant
665,Uitbreidingstraat 390,2023-08-16,17:00:00,292,112,180,FMN 18 Binnensingel Westkant
665,Uitbreidingstraat 390,2023-08-16,18:00:00,230,103,127,FMN 18 Binnensingel Westkant
665,Uitbreidingstraat 390,2023-08-16,19:00:00,139,64,75,FMN 18 Binnensingel Westkant
665,Uitbreidingstraat 390,2023-08-16,20:00:00,118,43,75,FMN 18 Binnensingel Westkant
665,Uitbreidingstraat 390,2023-08-16,21:00:00,81,47,34,FMN 18 Binnensingel Westkant
665,Uitbreidingstraat 390,2023-08-16,22:00:00,101,47,54,FMN 18 Binnensingel Westkant
665,Uitbreidingstraat 390,2023-08-16,23:00:00,56,36,20,FMN 18 Binnensingel Westkant
665,Uitbreidingstraat 390,2023-08-17,00:00:00,28,15,13,FMN 18 Binnensingel Westkant
665,Uitbreidingstraat 390,2023-08-17,01:00:00,11,6,5,FMN 18 Binnensingel Westkant
665,Uitbreidingstraat 390,2023-08-17,02:00:00,6,2,4,FMN 18 Binnensingel Westkant
665,Uitbreidingstraat 390,2023-08-17,03:00:00,8,3,5,FMN 18 Binnensingel Westkant
665,Uitbreidingstraat 390,2023-08-17,04:00:00,19,11,8,FMN 18 Binnensingel Westkant
665,Uitbreidingstraat 390,2023-08-17,05:00:00,49,31,18,FMN 18 Binnensingel Westkant
665,Uitbreidingstraat 390,2023-08-17,06:00:00,84,43,41,FMN 18 Binnensingel Westkant
665,Uitbreidingstraat 390,2023-08-17,07:00:00,179,100,79,FMN 18 Binnensingel Westkant
665,Uitbreidingstraat 390,2023-08-17,08:00:00,262,149,113,FMN 18 Binnensingel Westkant
665,Uitbreidingstraat 390,2023-08-17,09:00:00,123,65,58,FMN 18 Binnensingel Westkant
665,Uitbreidingstraat 390,2023-08-17,10:00:00,80,45,35,FMN 18 Binnensingel Westkant
665,Uitbreidingstraat 390,2023-08-17,11:00:00,87,51,36,FMN 18 Binnensingel Westkant
665,Uitbreidingstraat 390,2023-08-17,12:00:00,103,47,56,FMN 18 Binnensingel Westkant
665,Uitbreidingstraat 390,2023-08-17,13:00:00,105,47,58,FMN 18 Binnensingel Westkant
665,Uitbreidingstraat 390,2023-08-17,14:00:00,131,52,79,FMN 18 Binnensingel Westkant
665,Uitbreidingstraat 390,2023-08-17,15:00:00,138,63,75,FMN 18 Binnensingel Westkant
665,Uitbreidingstraat 390,2023-08-17,16:00:00,220,92,128,FMN 18 Binnensingel Westkant
665,Uitbreidingstraat 390,2023-08-17,17:00:00,291,125,166,FMN 18 Binnensingel Westkant
665,Uitbreidingstraat 390,2023-08-17,18:00:00,230,108,122,FMN 18 Binnensingel Westkant
665,Uitbreidingstraat 390,2023-08-17,19:00:00,124,47,77,FMN 18 Binnensingel Westkant
665,Uitbreidingstraat 390,2023-08-17,20:00:00,115,52,63,FMN 18 Binnensingel Westkant
665,Uitbreidingstraat 390,2023-08-17,21:00:00,97,51,46,FMN 18 Binnensingel Westkant
665,Uitbreidingstraat 390,2023-08-17,22:00:00,86,40,46,FMN 18 Binnensingel Westkant
665,Uitbreidingstraat 390,2023-08-17,23:00:00,48,31,17,FMN 18 Binnensingel Westkant
665,Uitbreidingstraat 390,2023-08-18,00:00:00,37,21,16,FMN 18 Binnensingel Westkant
665,Uitbreidingstraat 390,2023-08-18,01:00:00,10,6,4,FMN 18 Binnensingel Westkant
665,Uitbreidingstraat 390,2023-08-18,02:00:00,8,4,4,FMN 18 Binnensingel Westkant
665,Uitbreidingstraat 390,2023-08-18,03:00:00,13,10,3,FMN 18 Binnensingel Westkant
665,Uitbreidingstraat 390,2023-08-18,04:00:00,15,11,4,FMN 18 Binnensingel Westkant
665,Uitbreidingstraat 390,2023-08-18,05:00:00,39,20,19,FMN 18 Binnensingel Westkant
665,Uitbreidingstraat 390,2023-08-18,06:00:00,77,46,31,FMN 18 Binnensingel Westkant
665,Uitbreidingstraat 390,2023-08-18,07:00:00,113,59,54,FMN 18 Binnensingel Westkant
665,Uitbreidingstraat 390,2023-08-18,08:00:00,204,126,78,FMN 18 Binnensingel Westkant
665,Uitbreidingstraat 390,2023-08-18,09:00:00,108,66,42,FMN 18 Binnensingel Westkant
665,Uitbreidingstraat 390,2023-08-18,10:00:00,92,38,54,FMN 18 Binnensingel Westkant
665,Uitbreidingstraat 390,2023-08-18,11:00:00,95,50,45,FMN 18 Binnensingel Westkant
665,Uitbreidingstraat 390,2023-08-18,12:00:00,128,63,65,FMN 18 Binnensingel Westkant
665,Uitbreidingstraat 390,2023-08-18,13:00:00,120,46,74,FMN 18 Binnensingel Westkant
665,Uitbreidingstraat 390,2023-08-18,14:00:00,148,66,82,FMN 18 Binnensingel Westkant
665,Uitbreidingstraat 390,2023-08-18,15:00:00,156,58,98,FMN 18 Binnensingel Westkant
665,Uitbreidingstraat 390,2023-08-18,16:00:00,206,84,122,FMN 18 Binnensingel Westkant
665,Uitbreidingstraat 390,2023-08-18,17:00:00,253,108,145,FMN 18 Binnensingel Westkant
665,Uitbreidingstraat 390,2023-08-18,18:00:00,173,75,98,FMN 18 Binnensingel Westkant
665,Uitbreidingstraat 390,2023-08-18,19:00:00,118,53,65,FMN 18 Binnensingel Westkant
665,Uitbreidingstraat 390,2023-08-18,20:00:00,110,47,63,FMN 18 Binnensingel Westkant
665,Uitbreidingstraat 390,2023-08-18,21:00:00,82,32,50,FMN 18 Binnensingel Westkant
665,Uitbreidingstraat 390,2023-08-18,22:00:00,73,40,33,FMN 18 Binnensingel Westkant
665,Uitbreidingstraat 390,2023-08-18,23:00:00,65,34,31,FMN 18 Binnensingel Westkant
665,Uitbreidingstraat 390,2023-08-19,00:00:00,59,39,20,FMN 18 Binnensingel Westkant
665,Uitbreidingstraat 390,2023-08-19,01:00:00,32,20,12,FMN 18 Binnensingel Westkant
665,Uitbreidingstraat 390,2023-08-19,02:00:00,27,11,16,FMN 18 Binnensingel Westkant
665,Uitbreidingstraat 390,2023-08-19,03:00:00,22,11,11,FMN 18 Binnensingel Westkant
665,Uitbreidingstraat 390,2023-08-19,04:00:00,12,7,5,FMN 18 Binnensingel Westkant
665,Uitbreidingstraat 390,2023-08-19,05:00:00,15,9,6,FMN 18 Binnensingel Westkant
665,Uitbreidingstraat 390,2023-08-19,06:00:00,40,27,13,FMN 18 Binnensingel Westkant
665,Uitbreidingstraat 390,2023-08-19,07:00:00,23,9,14,FMN 18 Binnensingel Westkant
665,Uitbreidingstraat 390,2023-08-19,08:00:00,43,23,20,FMN 18 Binnensingel Westkant
665,Uitbreidingstraat 390,2023-08-19,09:00:00,77,40,37,FMN 18 Binnensingel Westkant
665,Uitbreidingstraat 390,2023-08-19,10:00:00,79,40,39,FMN 18 Binnensingel Westkant
665,Uitbreidingstraat 390,2023-08-19,11:00:00,98,45,53,FMN 18 Binnensingel Westkant
665,Uitbreidingstraat 390,2023-08-19,12:00:00,106,63,43,FMN 18 Binnensingel Westkant
665,Uitbreidingstraat 390,2023-08-19,13:00:00,103,49,54,FMN 18 Binnensingel Westkant
665,Uitbreidingstraat 390,2023-08-19,14:00:00,129,65,64,FMN 18 Binnensingel Westkant
665,Uitbreidingstraat 390,2023-08-19,15:00:00,122,57,65,FMN 18 Binnensingel Westkant
665,Uitbreidingstraat 390,2023-08-19,16:00:00,93,40,53,FMN 18 Binnensingel Westkant
665,Uitbreidingstraat 390,2023-08-19,17:00:00,125,56,69,FMN 18 Binnensingel Westkant
665,Uitbreidingstraat 390,2023-08-19,18:00:00,137,55,82,FMN 18 Binnensingel Westkant
665,Uitbreidingstraat 390,2023-08-19,19:00:00,113,48,65,FMN 18 Binnensingel Westkant
665,Uitbreidingstraat 390,2023-08-19,20:00:00,100,39,61,FMN 18 Binnensingel Westkant
665,Uitbreidingstraat 390,2023-08-19,21:00:00,93,46,47,FMN 18 Binnensingel Westkant
665,Uitbreidingstraat 390,2023-08-19,22:00:00,93,40,53,FMN 18 Binnensingel Westkant
665,Uitbreidingstraat 390,2023-08-19,23:00:00,66,36,30,FMN 18 Binnensingel Westkant
665,Uitbreidingstraat 390,2023-08-20,00:00:00,54,34,20,FMN 18 Binnensingel Westkant
665,Uitbreidingstraat 390,2023-08-20,01:00:00,40,25,15,FMN 18 Binnensingel Westkant
665,Uitbreidingstraat 390,2023-08-20,02:00:00,41,23,18,FMN 18 Binnensingel Westkant
665,Uitbreidingstraat 390,2023-08-20,03:00:00,25,16,9,FMN 18 Binnensingel Westkant
665,Uitbreidingstraat 390,2023-08-20,04:00:00,18,14,4,FMN 18 Binnensingel Westkant
665,Uitbreidingstraat 390,2023-08-20,05:00:00,14,9,5,FMN 18 Binnensingel Westkant
665,Uitbreidingstraat 390,2023-08-20,06:00:00,26,14,12,FMN 18 Binnensingel Westkant
665,Uitbreidingstraat 390,2023-08-20,07:00:00,16,7,9,FMN 18 Binnensingel Westkant
665,Uitbreidingstraat 390,2023-08-20,08:00:00,28,11,17,FMN 18 Binnensingel Westkant
665,Uitbreidingstraat 390,2023-08-20,09:00:00,75,31,44,FMN 18 Binnensingel Westkant
665,Uitbreidingstraat 390,2023-08-20,10:00:00,82,30,52,FMN 18 Binnensingel Westkant
665,Uitbreidingstraat 390,2023-08-20,11:00:00,118,54,64,FMN 18 Binnensingel Westkant
665,Uitbreidingstraat 390,2023-08-20,12:00:00,94,37,57,FMN 18 Binnensingel Westkant
665,Uitbreidingstraat 390,2023-08-20,13:00:00,100,47,53,FMN 18 Binnensingel Westkant
665,Uitbreidingstraat 390,2023-08-20,14:00:00,118,74,44,FMN 18 Binnensingel Westkant
665,Uitbreidingstraat 390,2023-08-20,15:00:00,115,51,64,FMN 18 Binnensingel Westkant
665,Uitbreidingstraat 390,2023-08-20,16:00:00,116,58,58,FMN 18 Binnensingel Westkant
665,Uitbreidingstraat 390,2023-08-20,17:00:00,115,61,54,FMN 18 Binnensingel Westkant
665,Uitbreidingstraat 390,2023-08-20,18:00:00,105,50,55,FMN 18 Binnensingel Westkant
665,Uitbreidingstraat 390,2023-08-20,19:00:00,104,53,51,FMN 18 Binnensingel Westkant
665,Uitbreidingstraat 390,2023-08-20,20:00:00,85,41,44,FMN 18 Binnensingel Westkant
665,Uitbreidingstraat 390,2023-08-20,21:00:00,79,38,41,FMN 18 Binnensingel Westkant
665,Uitbreidingstraat 390,2023-08-20,22:00:00,74,38,36,FMN 18 Binnensingel Westkant
665,Uitbreidingstraat 390,2023-08-20,23:00:00,41,29,12,FMN 18 Binnensingel Westkant
665,Uitbreidingstraat 390,2023-08-21,00:00:00,23,13,10,FMN 18 Binnensingel Westkant
665,Uitbreidingstraat 390,2023-08-21,01:00:00,19,11,8,FMN 18 Binnensingel Westkant
665,Uitbreidingstraat 390,2023-08-21,02:00:00,7,3,4,FMN 18 Binnensingel Westkant
665,Uitbreidingstraat 390,2023-08-21,03:00:00,5,3,2,FMN 18 Binnensingel Westkant
665,Uitbreidingstraat 390,2023-08-21,04:00:00,19,9,10,FMN 18 Binnensingel Westkant
665,Uitbreidingstraat 390,2023-08-21,05:00:00,39,25,14,FMN 18 Binnensingel Westkant
665,Uitbreidingstraat 390,2023-08-21,06:00:00,77,41,36,FMN 18 Binnensingel Westkant
665,Uitbreidingstraat 390,2023-08-21,07:00:00,165,89,76,FMN 18 Binnensingel Westkant
665,Uitbreidingstraat 390,2023-08-21,08:00:00,283,156,127,FMN 18 Binnensingel Westkant
665,Uitbreidingstraat 390,2023-08-21,09:00:00,127,79,48,FMN 18 Binnensingel Westkant
665,Uitbreidingstraat 390,2023-08-21,10:00:00,104,52,52,FMN 18 Binnensingel Westkant
665,Uitbreidingstraat 390,2023-08-21,11:00:00,106,53,53,FMN 18 Binnensingel Westkant
665,Uitbreidingstraat 390,2023-08-21,12:00:00,141,84,57,FMN 18 Binnensingel Westkant
665,Uitbreidingstraat 390,2023-08-21,13:00:00,134,80,54,FMN 18 Binnensingel Westkant
665,Uitbreidingstraat 390,2023-08-21,14:00:00,110,60,50,FMN 18 Binnensingel Westkant
665,Uitbreidingstraat 390,2023-08-21,15:00:00,153,70,83,FMN 18 Binnensingel Westkant
665,Uitbreidingstraat 390,2023-08-21,16:00:00,229,100,129,FMN 18 Binnensingel Westkant
665,Uitbreidingstraat 390,2023-08-21,17:00:00,312,126,186,FMN 18 Binnensingel Westkant
665,Uitbreidingstraat 390,2023-08-21,18:00:00,203,96,107,FMN 18 Binnensingel Westkant
665,Uitbreidingstraat 390,2023-08-21,19:00:00,142,73,69,FMN 18 Binnensingel Westkant
665,Uitbreidingstraat 390,2023-08-21,20:00:00,122,50,72,FMN 18 Binnensingel Westkant
665,Uitbreidingstraat 390,2023-08-21,21:00:00,79,42,37,FMN 18 Binnensingel Westkant
665,Uitbreidingstraat 390,2023-08-21,22:00:00,79,34,45,FMN 18 Binnensingel Westkant
665,Uitbreidingstraat 390,2023-08-21,23:00:00,42,20,22,FMN 18 Binnensingel Westkant
665,Uitbreidingstraat 390,2023-08-22,00:00:00,15,9,6,FMN 18 Binnensingel Westkant
665,Uitbreidingstraat 390,2023-08-22,01:00:00,11,6,5,FMN 18 Binnensingel Westkant
665,Uitbreidingstraat 390,2023-08-22,02:00:00,5,3,2,FMN 18 Binnensingel Westkant
665,Uitbreidingstraat 390,2023-08-22,03:00:00,8,5,3,FMN 18 Binnensingel Westkant
665,Uitbreidingstraat 390,2023-08-22,04:00:00,16,9,7,FMN 18 Binnensingel Westkant
665,Uitbreidingstraat 390,2023-08-22,05:00:00,45,23,22,FMN 18 Binnensingel Westkant
665,Uitbreidingstraat 390,2023-08-22,06:00:00,97,57,40,FMN 18 Binnensingel Westkant
665,Uitbreidingstraat 390,2023-08-22,07:00:00,222,130,92,FMN 18 Binnensingel Westkant
665,Uitbreidingstraat 390,2023-08-22,08:00:00,357,209,148,FMN 18 Binnensingel Westkant
665,Uitbreidingstraat 390,2023-08-22,09:00:00,176,112,64,FMN 18 Binnensingel Westkant
665,Uitbreidingstraat 390,2023-08-22,10:00:00,95,63,32,FMN 18 Binnensingel Westkant
665,Uitbreidingstraat 390,2023-08-22,11:00:00,105,63,42,FMN 18 Binnensingel Westkant
665,Uitbreidingstraat 390,2023-08-22,12:00:00,132,60,72,FMN 18 Binnensingel Westkant
665,Uitbreidingstraat 390,2023-08-22,13:00:00,143,69,74,FMN 18 Binnensingel Westkant
665,Uitbreidingstraat 390,2023-08-22,14:00:00,182,87,95,FMN 18 Binnensingel Westkant
665,Uitbreidingstraat 390,2023-08-22,15:00:00,172,82,90,FMN 18 Binnensingel Westkant
665,Uitbreidingstraat 390,2023-08-22,16:00:00,311,154,157,FMN 18 Binnensingel Westkant
665,Uitbreidingstraat 390,2023-08-22,17:00:00,344,139,205,FMN 18 Binnensingel Westkant
665,Uitbreidingstraat 390,2023-08-22,18:00:00,295,152,143,FMN 18 Binnensingel Westkant
665,Uitbreidingstraat 390,2023-08-22,19:00:00,199,96,103,FMN 18 Binnensingel Westkant
665,Uitbreidingstraat 390,2023-08-22,20:00:00,112,54,58,FMN 18 Binnensingel Westkant
665,Uitbreidingstraat 390,2023-08-22,21:00:00,97,51,46,FMN 18 Binnensingel Westkant
665,Uitbreidingstraat 390,2023-08-22,22:00:00,109,54,55,FMN 18 Binnensingel Westkant
665,Uitbreidingstraat 390,2023-08-22,23:00:00,83,63,20,FMN 18 Binnensingel Westkant
665,Uitbreidingstraat 390,2023-08-23,00:00:00,35,26,9,FMN 18 Binnensingel Westkant
665,Uitbreidingstraat 390,2023-08-23,01:00:00,22,13,9,FMN 18 Binnensingel Westkant
665,Uitbreidingstraat 390,2023-08-23,02:00:00,8,4,4,FMN 18 Binnensingel Westkant
665,Uitbreidingstraat 390,2023-08-23,03:00:00,9,6,3,FMN 18 Binnensingel Westkant
665,Uitbreidingstraat 390,2023-08-23,04:00:00,16,7,9,FMN 18 Binnensingel Westkant
665,Uitbreidingstraat 390,2023-08-23,05:00:00,39,25,14,FMN 18 Binnensingel Westkant
665,Uitbreidingstraat 390,2023-08-23,06:00:00,88,49,39,FMN 18 Binnensingel Westkant
665,Uitbreidingstraat 390,2023-08-23,07:00:00,198,120,78,FMN 18 Binnensingel Westkant
665,Uitbreidingstraat 390,2023-08-23,08:00:00,305,191,114,FMN 18 Binnensingel Westkant
665,Uitbreidingstraat 390,2023-08-23,09:00:00,144,77,67,FMN 18 Binnensingel Westkant
665,Uitbreidingstraat 390,2023-08-23,10:00:00,105,64,41,FMN 18 Binnensingel Westkant
665,Uitbreidingstraat 390,2023-08-23,11:00:00,128,59,69,FMN 18 Binnensingel Westkant
665,Uitbreidingstraat 390,2023-08-23,12:00:00,169,98,71,FMN 18 Binnensingel Westkant
665,Uitbreidingstraat 390,2023-08-23,13:00:00,130,80,50,FMN 18 Binnensingel Westkant
665,Uitbreidingstraat 390,2023-08-23,14:00:00,142,69,73,FMN 18 Binnensingel Westkant
665,Uitbreidingstraat 390,2023-08-23,15:00:00,180,83,97,FMN 18 Binnensingel Westkant
665,Uitbreidingstraat 390,2023-08-23,16:00:00,249,104,145,FMN 18 Binnensingel Westkant
665,Uitbreidingstraat 390,2023-08-23,17:00:00,337,125,212,FMN 18 Binnensingel Westkant
665,Uitbreidingstraat 390,2023-08-23,18:00:00,236,122,114,FMN 18 Binnensingel Westkant
665,Uitbreidingstraat 390,2023-08-23,19:00:00,147,67,80,FMN 18 Binnensingel Westkant
665,Uitbreidingstraat 390,2023-08-23,20:00:00,168,79,89,FMN 18 Binnensingel Westkant
665,Uitbreidingstraat 390,2023-08-23,21:00:00,99,42,57,FMN 18 Binnensingel Westkant
665,Uitbreidingstraat 390,2023-08-23,22:00:00,92,48,44,FMN 18 Binnensingel Westkant
665,Uitbreidingstraat 390,2023-08-23,23:00:00,75,51,24,FMN 18 Binnensingel Westkant
665,Uitbreidingstraat 390,2023-08-24,00:00:00,30,18,12,FMN 18 Binnensingel Westkant
665,Uitbreidingstraat 390,2023-08-24,01:00:00,29,19,10,FMN 18 Binnensingel Westkant
665,Uitbreidingstraat 390,2023-08-24,02:00:00,15,10,5,FMN 18 Binnensingel Westkant
665,Uitbreidingstraat 390,2023-08-24,03:00:00,7,5,2,FMN 18 Binnensingel Westkant
665,Uitbreidingstraat 390,2023-08-24,04:00:00,16,8,8,FMN 18 Binnensingel Westkant
665,Uitbreidingstraat 390,2023-08-24,05:00:00,39,26,13,FMN 18 Binnensingel Westkant
665,Uitbreidingstraat 390,2023-08-24,06:00:00,86,40,46,FMN 18 Binnensingel Westkant
665,Uitbreidingstraat 390,2023-08-24,07:00:00,198,116,82,FMN 18 Binnensingel Westkant
665,Uitbreidingstraat 390,2023-08-24,08:00:00,318,192,126,FMN 18 Binnensingel Westkant
665,Uitbreidingstraat 390,2023-08-24,09:00:00,158,97,61,FMN 18 Binnensingel Westkant
665,Uitbreidingstraat 390,2023-08-24,10:00:00,112,61,51,FMN 18 Binnensingel Westkant
665,Uitbreidingstraat 390,2023-08-24,11:00:00,97,42,55,FMN 18 Binnensingel Westkant
665,Uitbreidingstraat 390,2023-08-24,12:00:00,90,40,50,FMN 18 Binnensingel Westkant
665,Uitbreidingstraat 390,2023-08-24,13:00:00,105,55,50,FMN 18 Binnensingel Westkant
665,Uitbreidingstraat 390,2023-08-24,14:00:00,109,51,58,FMN 18 Binnensingel Westkant
665,Uitbreidingstraat 390,2023-08-24,15:00:00,128,46,82,FMN 18 Binnensingel Westkant
665,Uitbreidingstraat 390,2023-08-24,16:00:00,241,102,139,FMN 18 Binnensingel Westkant
665,Uitbreidingstraat 390,2023-08-24,17:00:00,317,142,175,FMN 18 Binnensingel Westkant
665,Uitbreidingstraat 390,2023-08-24,18:00:00,215,109,106,FMN 18 Binnensingel Westkant
665,Uitbreidingstraat 390,2023-08-24,19:00:00,144,69,75,FMN 18 Binnensingel Westkant
665,Uitbreidingstraat 390,2023-08-24,20:00:00,113,47,66,FMN 18 Binnensingel Westkant
665,Uitbreidingstraat 390,2023-08-24,21:00:00,88,48,40,FMN 18 Binnensingel Westkant
665,Uitbreidingstraat 390,2023-08-24,22:00:00,87,33,54,FMN 18 Binnensingel Westkant
665,Uitbreidingstraat 390,2023-08-24,23:00:00,52,29,23,FMN 18 Binnensingel Westkant
665,Uitbreidingstraat 390,2023-08-25,00:00:00,37,24,13,FMN 18 Binnensingel Westkant
665,Uitbreidingstraat 390,2023-08-25,01:00:00,15,10,5,FMN 18 Binnensingel Westkant
665,Uitbreidingstraat 390,2023-08-25,02:00:00,6,4,2,FMN 18 Binnensingel Westkant
665,Uitbreidingstraat 390,2023-08-25,03:00:00,9,7,2,FMN 18 Binnensingel Westkant
665,Uitbreidingstraat 390,2023-08-25,04:00:00,16,9,7,FMN 18 Binnensingel Westkant
665,Uitbreidingstraat 390,2023-08-25,05:00:00,33,19,14,FMN 18 Binnensingel Westkant
665,Uitbreidingstraat 390,2023-08-25,06:00:00,87,55,32,FMN 18 Binnensingel Westkant
665,Uitbreidingstraat 390,2023-08-25,07:00:00,148,96,52,FMN 18 Binnensingel Westkant
665,Uitbreidingstraat 390,2023-08-25,08:00:00,184,124,60,FMN 18 Binnensingel Westkant
665,Uitbreidingstraat 390,2023-08-25,09:00:00,134,77,57,FMN 18 Binnensingel Westkant
665,Uitbreidingstraat 390,2023-08-25,10:00:00,76,43,33,FMN 18 Binnensingel Westkant
665,Uitbreidingstraat 390,2023-08-25,11:00:00,119,70,49,FMN 18 Binnensingel Westkant
665,Uitbreidingstraat 390,2023-08-25,12:00:00,132,61,71,FMN 18 Binnensingel Westkant
665,Uitbreidingstraat 390,2023-08-25,13:00:00,113,49,64,FMN 18 Binnensingel Westkant
665,Uitbreidingstraat 390,2023-08-25,14:00:00,134,64,70,FMN 18 Binnensingel Westkant
665,Uitbreidingstraat 390,2023-08-25,15:00:00,172,75,97,FMN 18 Binnensingel Westkant
665,Uitbreidingstraat 390,2023-08-25,16:00:00,191,84,107,FMN 18 Binnensingel Westkant
665,Uitbreidingstraat 390,2023-08-25,17:00:00,193,73,120,FMN 18 Binnensingel Westkant
665,Uitbreidingstraat 390,2023-08-25,18:00:00,188,85,103,FMN 18 Binnensingel Westkant
665,Uitbreidingstraat 390,2023-08-25,19:00:00,127,61,66,FMN 18 Binnensingel Westkant
665,Uitbreidingstraat 390,2023-08-25,20:00:00,118,52,66,FMN 18 Binnensingel Westkant
665,Uitbreidingstraat 390,2023-08-25,21:00:00,111,43,68,FMN 18 Binnensingel Westkant
665,Uitbreidingstraat 390,2023-08-25,22:00:00,65,40,25,FMN 18 Binnensingel Westkant
665,Uitbreidingstraat 390,2023-08-25,23:00:00,56,25,31,FMN 18 Binnensingel Westkant
665,Uitbreidingstraat 390,2023-08-26,00:00:00,43,32,11,FMN 18 Binnensingel Westkant
665,Uitbreidingstraat 390,2023-08-26,01:00:00,27,16,11,FMN 18 Binnensingel Westkant
665,Uitbreidingstraat 390,2023-08-26,02:00:00,25,13,12,FMN 18 Binnensingel Westkant
665,Uitbreidingstraat 390,2023-08-26,03:00:00,18,10,8,FMN 18 Binnensingel Westkant
665,Uitbreidingstraat 390,2023-08-26,04:00:00,21,10,11,FMN 18 Binnensingel Westkant
665,Uitbreidingstraat 390,2023-08-26,05:00:00,12,8,4,FMN 18 Binnensingel Westkant
665,Uitbreidingstraat 390,2023-08-26,06:00:00,32,22,10,FMN 18 Binnensingel Westkant
665,Uitbreidingstraat 390,2023-08-26,07:00:00,31,16,15,FMN 18 Binnensingel Westkant
665,Uitbreidingstraat 390,2023-08-26,08:00:00,44,20,24,FMN 18 Binnensingel Westkant
665,Uitbreidingstraat 390,2023-08-26,09:00:00,74,47,27,FMN 18 Binnensingel Westkant
665,Uitbreidingstraat 390,2023-08-26,10:00:00,97,40,57,FMN 18 Binnensingel Westkant
665,Uitbreidingstraat 390,2023-08-26,11:00:00,118,64,54,FMN 18 Binnensingel Westkant
665,Uitbreidingstraat 390,2023-08-26,12:00:00,109,49,60,FMN 18 Binnensingel Westkant
665,Uitbreidingstraat 390,2023-08-26,13:00:00,107,59,48,FMN 18 Binnensingel Westkant
665,Uitbreidingstraat 390,2023-08-26,14:00:00,119,67,52,FMN 18 Binnensingel Westkant
665,Uitbreidingstraat 390,2023-08-26,15:00:00,99,50,49,FMN 18 Binnensingel Westkant
665,Uitbreidingstraat 390,2023-08-26,16:00:00,111,58,53,FMN 18 Binnensingel Westkant
665,Uitbreidingstraat 390,2023-08-26,17:00:00,117,68,49,FMN 18 Binnensingel Westkant
665,Uitbreidingstraat 390,2023-08-26,18:00:00,108,58,50,FMN 18 Binnensingel Westkant
665,Uitbreidingstraat 390,2023-08-26,19:00:00,102,54,48,FMN 18 Binnensingel Westkant
665,Uitbreidingstraat 390,2023-08-26,20:00:00,108,46,62,FMN 18 Binnensingel Westkant
665,Uitbreidingstraat 390,2023-08-26,21:00:00,64,35,29,FMN 18 Binnensingel Westkant
665,Uitbreidingstraat 390,2023-08-26,22:00:00,71,35,36,FMN 18 Binnensingel Westkant
665,Uitbreidingstraat 390,2023-08-26,23:00:00,68,40,28,FMN 18 Binnensingel Westkant
665,Uitbreidingstraat 390,2023-08-27,00:00:00,61,38,23,FMN 18 Binnensingel Westkant
665,Uitbreidingstraat 390,2023-08-27,01:00:00,76,34,42,FMN 18 Binnensingel Westkant
665,Uitbreidingstraat 390,2023-08-27,02:00:00,28,15,13,FMN 18 Binnensingel Westkant
665,Uitbreidingstraat 390,2023-08-27,03:00:00,17,12,5,FMN 18 Binnensingel Westkant
665,Uitbreidingstraat 390,2023-08-27,04:00:00,7,4,3,FMN 18 Binnensingel Westkant
665,Uitbreidingstraat 390,2023-08-27,05:00:00,11,6,5,FMN 18 Binnensingel Westkant
665,Uitbreidingstraat 390,2023-08-27,06:00:00,27,12,15,FMN 18 Binnensingel Westkant
665,Uitbreidingstraat 390,2023-08-27,07:00:00,17,9,8,FMN 18 Binnensingel Westkant
665,Uitbreidingstraat 390,2023-08-27,08:00:00,26,13,13,FMN 18 Binnensingel Westkant
665,Uitbreidingstraat 390,2023-08-27,09:00:00,99,65,34,FMN 18 Binnensingel Westkant
665,Uitbreidingstraat 390,2023-08-27,10:00:00,93,60,33,FMN 18 Binnensingel Westkant
665,Uitbreidingstraat 390,2023-08-27,11:00:00,85,44,41,FMN 18 Binnensingel Westkant
665,Uitbreidingstraat 390,2023-08-27,12:00:00,120,68,52,FMN 18 Binnensingel Westkant
665,Uitbreidingstraat 390,2023-08-27,13:00:00,91,54,37,FMN 18 Binnensingel Westkant
665,Uitbreidingstraat 390,2023-08-27,14:00:00,111,58,53,FMN 18 Binnensingel Westkant
665,Uitbreidingstraat 390,2023-08-27,15:00:00,69,33,36,FMN 18 Binnensingel Westkant
665,Uitbreidingstraat 390,2023-08-27,16:00:00,124,61,63,FMN 18 Binnensingel Westkant
665,Uitbreidingstraat 390,2023-08-27,17:00:00,138,66,72,FMN 18 Binnensingel Westkant
665,Uitbreidingstraat 390,2023-08-27,18:00:00,110,44,66,FMN 18 Binnensingel Westkant
665,Uitbreidingstraat 390,2023-08-27,19:00:00,97,45,52,FMN 18 Binnensingel Westkant
665,Uitbreidingstraat 390,2023-08-27,20:00:00,78,44,34,FMN 18 Binnensingel Westkant
665,Uitbreidingstraat 390,2023-08-27,21:00:00,73,39,34,FMN 18 Binnensingel Westkant
665,Uitbreidingstraat 390,2023-08-27,22:00:00,50,19,31,FMN 18 Binnensingel Westkant
665,Uitbreidingstraat 390,2023-08-27,23:00:00,51,28,23,FMN 18 Binnensingel Westkant
665,Uitbreidingstraat 390,2023-08-28,00:00:00,20,12,8,FMN 18 Binnensingel Westkant
665,Uitbreidingstraat 390,2023-08-28,01:00:00,12,9,3,FMN 18 Binnensingel Westkant
665,Uitbreidingstraat 390,2023-08-28,02:00:00,6,2,4,FMN 18 Binnensingel Westkant
665,Uitbreidingstraat 390,2023-08-28,03:00:00,8,2,6,FMN 18 Binnensingel Westkant
665,Uitbreidingstraat 390,2023-08-28,04:00:00,20,12,8,FMN 18 Binnensingel Westkant
665,Uitbreidingstraat 390,2023-08-28,05:00:00,39,28,11,FMN 18 Binnensingel Westkant
665,Uitbreidingstraat 390,2023-08-28,06:00:00,96,59,37,FMN 18 Binnensingel Westkant
665,Uitbreidingstraat 390,2023-08-28,07:00:00,178,110,68,FMN 18 Binnensingel Westkant
665,Uitbreidingstraat 390,2023-08-28,08:00:00,237,145,92,FMN 18 Binnensingel Westkant
665,Uitbreidingstraat 390,2023-08-28,09:00:00,145,94,51,FMN 18 Binnensingel Westkant
665,Uitbreidingstraat 390,2023-08-28,10:00:00,105,61,44,FMN 18 Binnensingel Westkant
665,Uitbreidingstraat 390,2023-08-28,11:00:00,96,46,50,FMN 18 Binnensingel Westkant
665,Uitbreidingstraat 390,2023-08-28,12:00:00,143,81,62,FMN 18 Binnensingel Westkant
665,Uitbreidingstraat 390,2023-08-28,13:00:00,146,76,70,FMN 18 Binnensingel Westkant
665,Uitbreidingstraat 390,2023-08-28,14:00:00,133,61,72,FMN 18 Binnensingel Westkant
665,Uitbreidingstraat 390,2023-08-28,15:00:00,162,71,91,FMN 18 Binnensingel Westkant
665,Uitbreidingstraat 390,2023-08-28,16:00:00,233,99,134,FMN 18 Binnensingel Westkant
665,Uitbreidingstraat 390,2023-08-28,17:00:00,279,128,151,FMN 18 Binnensingel Westkant
665,Uitbreidingstraat 390,2023-08-28,18:00:00,190,103,87,FMN 18 Binnensingel Westkant
665,Uitbreidingstraat 390,2023-08-28,19:00:00,108,46,62,FMN 18 Binnensingel Westkant
665,Uitbreidingstraat 390,2023-08-28,20:00:00,85,33,52,FMN 18 Binnensingel Westkant
665,Uitbreidingstraat 390,2023-08-28,21:00:00,77,37,40,FMN 18 Binnensingel Westkant
665,Uitbreidingstraat 390,2023-08-28,22:00:00,73,27,46,FMN 18 Binnensingel Westkant
665,Uitbreidingstraat 390,2023-08-28,23:00:00,48,21,27,FMN 18 Binnensingel Westkant
665,Uitbreidingstraat 390,2023-08-29,00:00:00,22,15,7,FMN 18 Binnensingel Westkant
665,Uitbreidingstraat 390,2023-08-29,01:00:00,5,4,1,FMN 18 Binnensingel Westkant
665,Uitbreidingstraat 390,2023-08-29,02:00:00,9,4,5,FMN 18 Binnensingel Westkant
665,Uitbreidingstraat 390,2023-08-29,03:00:00,6,4,2,FMN 18 Binnensingel Westkant
665,Uitbreidingstraat 390,2023-08-29,04:00:00,17,11,6,FMN 18 Binnensingel Westkant
665,Uitbreidingstraat 390,2023-08-29,05:00:00,46,26,20,FMN 18 Binnensingel Westkant
665,Uitbreidingstraat 390,2023-08-29,06:00:00,93,53,40,FMN 18 Binnensingel Westkant
665,Uitbreidingstraat 390,2023-08-29,07:00:00,207,102,105,FMN 18 Binnensingel Westkant
665,Uitbreidingstraat 390,2023-08-29,08:00:00,317,205,112,FMN 18 Binnensingel Westkant
665,Uitbreidingstraat 390,2023-08-29,09:00:00,187,115,72,FMN 18 Binnensingel Westkant
665,Uitbreidingstraat 390,2023-08-29,10:00:00,115,49,66,FMN 18 Binnensingel Westkant
665,Uitbreidingstraat 390,2023-08-29,11:00:00,113,51,62,FMN 18 Binnensingel Westkant
665,Uitbreidingstraat 390,2023-08-29,12:00:00,164,86,78,FMN 18 Binnensingel Westkant
665,Uitbreidingstraat 390,2023-08-29,13:00:00,123,68,55,FMN 18 Binnensingel Westkant
665,Uitbreidingstraat 390,2023-08-29,14:00:00,174,80,94,FMN 18 Binnensingel Westkant
665,Uitbreidingstraat 390,2023-08-29,15:00:00,216,110,106,FMN 18 Binnensingel Westkant
665,Uitbreidingstraat 390,2023-08-29,16:00:00,264,113,151,FMN 18 Binnensingel Westkant
665,Uitbreidingstraat 390,2023-08-29,17:00:00,367,165,202,FMN 18 Binnensingel Westkant
665,Uitbreidingstraat 390,2023-08-29,18:00:00,218,99,119,FMN 18 Binnensingel Westkant
665,Uitbreidingstraat 390,2023-08-29,19:00:00,137,61,76,FMN 18 Binnensingel Westkant
665,Uitbreidingstraat 390,2023-08-29,20:00:00,99,49,50,FMN 18 Binnensingel Westkant
665,Uitbreidingstraat 390,2023-08-29,21:00:00,85,37,48,FMN 18 Binnensingel Westkant
665,Uitbreidingstraat 390,2023-08-29,22:00:00,92,43,49,FMN 18 Binnensingel Westkant
665,Uitbreidingstraat 390,2023-08-29,23:00:00,41,23,18,FMN 18 Binnensingel Westkant
665,Uitbreidingstraat 390,2023-08-30,00:00:00,23,17,6,FMN 18 Binnensingel Westkant
665,Uitbreidingstraat 390,2023-08-30,01:00:00,10,4,6,FMN 18 Binnensingel Westkant
665,Uitbreidingstraat 390,2023-08-30,02:00:00,6,3,3,FMN 18 Binnensingel Westkant
665,Uitbreidingstraat 390,2023-08-30,03:00:00,11,5,6,FMN 18 Binnensingel Westkant
665,Uitbreidingstraat 390,2023-08-30,04:00:00,13,7,6,FMN 18 Binnensingel Westkant
665,Uitbreidingstraat 390,2023-08-30,05:00:00,46,28,18,FMN 18 Binnensingel Westkant
665,Uitbreidingstraat 390,2023-08-30,06:00:00,85,50,35,FMN 18 Binnensingel Westkant
665,Uitbreidingstraat 390,2023-08-30,07:00:00,141,79,62,FMN 18 Binnensingel Westkant
665,Uitbreidingstraat 390,2023-08-30,08:00:00,171,113,58,FMN 18 Binnensingel Westkant
665,Uitbreidingstraat 390,2023-08-30,09:00:00,115,71,44,FMN 18 Binnensingel Westkant
665,Uitbreidingstraat 390,2023-08-30,10:00:00,101,46,55,FMN 18 Binnensingel Westkant
665,Uitbreidingstraat 390,2023-08-30,11:00:00,118,57,61,FMN 18 Binnensingel Westkant
665,Uitbreidingstraat 390,2023-08-30,12:00:00,158,66,92,FMN 18 Binnensingel Westkant
665,Uitbreidingstraat 390,2023-08-30,13:00:00,137,75,62,FMN 18 Binnensingel Westkant
665,Uitbreidingstraat 390,2023-08-30,14:00:00,149,73,76,FMN 18 Binnensingel Westkant
665,Uitbreidingstraat 390,2023-08-30,15:00:00,160,77,83,FMN 18 Binnensingel Westkant
665,Uitbreidingstraat 390,2023-08-30,16:00:00,220,103,117,FMN 18 Binnensingel Westkant
665,Uitbreidingstraat 390,2023-08-30,17:00:00,270,108,162,FMN 18 Binnensingel Westkant
665,Uitbreidingstraat 390,2023-08-30,18:00:00,200,78,122,FMN 18 Binnensingel Westkant
665,Uitbreidingstraat 390,2023-08-30,19:00:00,152,67,85,FMN 18 Binnensingel Westkant
665,Uitbreidingstraat 390,2023-08-30,20:00:00,122,44,78,FMN 18 Binnensingel Westkant
665,Uitbreidingstraat 390,2023-08-30,21:00:00,73,36,37,FMN 18 Binnensingel Westkant
665,Uitbreidingstraat 390,2023-08-30,22:00:00,73,32,41,FMN 18 Binnensingel Westkant
665,Uitbreidingstraat 390,2023-08-30,23:00:00,41,23,18,FMN 18 Binnensingel Westkant
665,Uitbreidingstraat 390,2023-08-31,00:00:00,27,19,8,FMN 18 Binnensingel Westkant
665,Uitbreidingstraat 390,2023-08-31,01:00:00,8,5,3,FMN 18 Binnensingel Westkant
665,Uitbreidingstraat 390,2023-08-31,02:00:00,6,2,4,FMN 18 Binnensingel Westkant
665,Uitbreidingstraat 390,2023-08-31,03:00:00,7,6,1,FMN 18 Binnensingel Westkant
665,Uitbreidingstraat 390,2023-08-31,04:00:00,18,10,8,FMN 18 Binnensingel Westkant
665,Uitbreidingstraat 390,2023-08-31,05:00:00,47,27,20,FMN 18 Binnensingel Westkant
665,Uitbreidingstraat 390,2023-08-31,06:00:00,86,54,32,FMN 18 Binnensingel Westkant
665,Uitbreidingstraat 390,2023-08-31,07:00:00,190,108,82,FMN 18 Binnensingel Westkant
665,Uitbreidingstraat 390,2023-08-31,08:00:00,278,174,104,FMN 18 Binnensingel Westkant
665,Uitbreidingstraat 390,2023-08-31,09:00:00,173,109,64,FMN 18 Binnensingel Westkant
665,Uitbreidingstraat 390,2023-08-31,10:00:00,101,58,43,FMN 18 Binnensingel Westkant
665,Uitbreidingstraat 390,2023-08-31,11:00:00,133,66,67,FMN 18 Binnensingel Westkant
665,Uitbreidingstraat 390,2023-08-31,12:00:00,154,70,84,FMN 18 Binnensingel Westkant
665,Uitbreidingstraat 390,2023-08-31,13:00:00,150,79,71,FMN 18 Binnensingel Westkant
665,Uitbreidingstraat 390,2023-08-31,14:00:00,154,61,93,FMN 18 Binnensingel Westkant
665,Uitbreidingstraat 390,2023-08-31,15:00:00,174,65,109,FMN 18 Binnensingel Westkant
665,Uitbreidingstraat 390,2023-08-31,16:00:00,238,106,132,FMN 18 Binnensingel Westkant
665,Uitbreidingstraat 390,2023-08-31,17:00:00,298,137,161,FMN 18 Binnensingel Westkant
665,Uitbreidingstraat 390,2023-08-31,18:00:00,253,141,112,FMN 18 Binnensingel Westkant
665,Uitbreidingstraat 390,2023-08-31,19:00:00,158,81,77,FMN 18 Binnensingel Westkant
665,Uitbreidingstraat 390,2023-08-31,20:00:00,122,58,64,FMN 18 Binnensingel Westkant
665,Uitbreidingstraat 390,2023-08-31,21:00:00,85,32,53,FMN 18 Binnensingel Westkant
665,Uitbreidingstraat 390,2023-08-31,22:00:00,82,38,44,FMN 18 Binnensingel Westkant
665,Uitbreidingstraat 390,2023-08-31,23:00:00,60,29,31,FMN 18 Binnensingel Westkant
665,Uitbreidingstraat 390,2023-09-01,00:00:00,29,15,14,FMN 18 Binnensingel Westkant
665,Uitbreidingstraat 390,2023-09-01,01:00:00,22,14,8,FMN 18 Binnensingel Westkant
665,Uitbreidingstraat 390,2023-09-01,02:00:00,6,2,4,FMN 18 Binnensingel Westkant
665,Uitbreidingstraat 390,2023-09-01,03:00:00,9,4,5,FMN 18 Binnensingel Westkant
665,Uitbreidingstraat 390,2023-09-01,04:00:00,14,8,6,FMN 18 Binnensingel Westkant
665,Uitbreidingstraat 390,2023-09-01,05:00:00,33,17,16,FMN 18 Binnensingel Westkant
665,Uitbreidingstraat 390,2023-09-01,06:00:00,71,45,26,FMN 18 Binnensingel Westkant
665,Uitbreidingstraat 390,2023-09-01,07:00:00,150,93,57,FMN 18 Binnensingel Westkant
665,Uitbreidingstraat 390,2023-09-01,08:00:00,268,195,73,FMN 18 Binnensingel Westkant
665,Uitbreidingstraat 390,2023-09-01,09:00:00,127,76,51,FMN 18 Binnensingel Westkant
665,Uitbreidingstraat 390,2023-09-01,10:00:00,84,58,26,FMN 18 Binnensingel Westkant
665,Uitbreidingstraat 390,2023-09-01,11:00:00,66,39,27,FMN 18 Binnensingel Westkant
665,Uitbreidingstraat 390,2023-09-01,12:00:00,175,53,122,FMN 18 Binnensingel Westkant
665,Uitbreidingstraat 390,2023-09-01,13:00:00,110,49,61,FMN 18 Binnensingel Westkant
665,Uitbreidingstraat 390,2023-09-01,14:00:00,142,60,82,FMN 18 Binnensingel Westkant
665,Uitbreidingstraat 390,2023-09-01,15:00:00,220,89,131,FMN 18 Binnensingel Westkant
665,Uitbreidingstraat 390,2023-09-01,16:00:00,199,95,104,FMN 18 Binnensingel Westkant
665,Uitbreidingstraat 390,2023-09-01,17:00:00,194,74,120,FMN 18 Binnensingel Westkant
665,Uitbreidingstraat 390,2023-09-01,18:00:00,179,80,99,FMN 18 Binnensingel Westkant
665,Uitbreidingstraat 390,2023-09-01,19:00:00,120,61,59,FMN 18 Binnensingel Westkant
665,Uitbreidingstraat 390,2023-09-01,20:00:00,97,41,56,FMN 18 Binnensingel Westkant
665,Uitbreidingstraat 390,2023-09-01,21:00:00,102,40,62,FMN 18 Binnensingel Westkant
665,Uitbreidingstraat 390,2023-09-01,22:00:00,80,35,45,FMN 18 Binnensingel Westkant
665,Uitbreidingstraat 390,2023-09-01,23:00:00,51,34,17,FMN 18 Binnensingel Westkant
665,Uitbreidingstraat 390,2023-09-02,00:00:00,38,26,12,FMN 18 Binnensingel Westkant
665,Uitbreidingstraat 390,2023-09-02,01:00:00,44,23,21,FMN 18 Binnensingel Westkant
665,Uitbreidingstraat 390,2023-09-02,02:00:00,24,14,10,FMN 18 Binnensingel Westkant
665,Uitbreidingstraat 390,2023-09-02,03:00:00,20,13,7,FMN 18 Binnensingel Westkant
665,Uitbreidingstraat 390,2023-09-02,04:00:00,15,9,6,FMN 18 Binnensingel Westkant
665,Uitbreidingstraat 390,2023-09-02,05:00:00,23,12,11,FMN 18 Binnensingel Westkant
665,Uitbreidingstraat 390,2023-09-02,06:00:00,25,17,8,FMN 18 Binnensingel Westkant
665,Uitbreidingstraat 390,2023-09-02,07:00:00,25,11,14,FMN 18 Binnensingel Westkant
665,Uitbreidingstraat 390,2023-09-02,08:00:00,60,38,22,FMN 18 Binnensingel Westkant
665,Uitbreidingstraat 390,2023-09-02,09:00:00,83,52,31,FMN 18 Binnensingel Westkant
665,Uitbreidingstraat 390,2023-09-02,10:00:00,107,48,59,FMN 18 Binnensingel Westkant
665,Uitbreidingstraat 390,2023-09-02,11:00:00,128,63,65,FMN 18 Binnensingel Westkant
665,Uitbreidingstraat 390,2023-09-02,12:00:00,141,72,69,FMN 18 Binnensingel Westkant
665,Uitbreidingstraat 390,2023-09-02,13:00:00,135,69,66,FMN 18 Binnensingel Westkant
665,Uitbreidingstraat 390,2023-09-02,14:00:00,133,75,58,FMN 18 Binnensingel Westkant
665,Uitbreidingstraat 390,2023-09-02,15:00:00,130,73,57,FMN 18 Binnensingel Westkant
665,Uitbreidingstraat 390,2023-09-02,16:00:00,128,72,56,FMN 18 Binnensingel Westkant
665,Uitbreidingstraat 390,2023-09-02,17:00:00,140,76,64,FMN 18 Binnensingel Westkant
665,Uitbreidingstraat 390,2023-09-02,18:00:00,144,71,73,FMN 18 Binnensingel Westkant
665,Uitbreidingstraat 390,2023-09-02,19:00:00,134,78,56,FMN 18 Binnensingel Westkant
665,Uitbreidingstraat 390,2023-09-02,20:00:00,85,45,40,FMN 18 Binnensingel Westkant
665,Uitbreidingstraat 390,2023-09-02,21:00:00,85,49,36,FMN 18 Binnensingel Westkant
665,Uitbreidingstraat 390,2023-09-02,22:00:00,102,63,39,FMN 18 Binnensingel Westkant
665,Uitbreidingstraat 390,2023-09-02,23:00:00,69,36,33,FMN 18 Binnensingel Westkant
665,Uitbreidingstraat 390,2023-09-03,00:00:00,78,37,41,FMN 18 Binnensingel Westkant
665,Uitbreidingstraat 390,2023-09-03,01:00:00,53,23,30,FMN 18 Binnensingel Westkant
665,Uitbreidingstraat 390,2023-09-03,02:00:00,28,14,14,FMN 18 Binnensingel Westkant
665,Uitbreidingstraat 390,2023-09-03,03:00:00,19,10,9,FMN 18 Binnensingel Westkant
665,Uitbreidingstraat 390,2023-09-03,04:00:00,6,4,2,FMN 18 Binnensingel Westkant
665,Uitbreidingstraat 390,2023-09-03,05:00:00,25,13,12,FMN 18 Binnensingel Westkant
665,Uitbreidingstraat 390,2023-09-03,06:00:00,27,20,7,FMN 18 Binnensingel Westkant
665,Uitbreidingstraat 390,2023-09-03,07:00:00,29,12,17,FMN 18 Binnensingel Westkant
665,Uitbreidingstraat 390,2023-09-03,08:00:00,27,16,11,FMN 18 Binnensingel Westkant
665,Uitbreidingstraat 390,2023-09-03,09:00:00,66,33,33,FMN 18 Binnensingel Westkant
665,Uitbreidingstraat 390,2023-09-03,10:00:00,83,46,37,FMN 18 Binnensingel Westkant
665,Uitbreidingstraat 390,2023-09-03,11:00:00,108,46,62,FMN 18 Binnensingel Westkant
665,Uitbreidingstraat 390,2023-09-03,12:00:00,121,72,49,FMN 18 Binnensingel Westkant
665,Uitbreidingstraat 390,2023-09-03,13:00:00,130,71,59,FMN 18 Binnensingel Westkant
665,Uitbreidingstraat 390,2023-09-03,14:00:00,128,67,61,FMN 18 Binnensingel Westkant
665,Uitbreidingstraat 390,2023-09-03,15:00:00,125,59,66,FMN 18 Binnensingel Westkant
665,Uitbreidingstraat 390,2023-09-03,16:00:00,102,62,40,FMN 18 Binnensingel Westkant
665,Uitbreidingstraat 390,2023-09-03,17:00:00,106,52,54,FMN 18 Binnensingel Westkant
665,Uitbreidingstraat 390,2023-09-03,18:00:00,136,83,53,FMN 18 Binnensingel Westkant
665,Uitbreidingstraat 390,2023-09-03,19:00:00,101,60,41,FMN 18 Binnensingel Westkant
665,Uitbreidingstraat 390,2023-09-03,20:00:00,89,45,44,FMN 18 Binnensingel Westkant
665,Uitbreidingstraat 390,2023-09-03,21:00:00,79,40,39,FMN 18 Binnensingel Westkant
665,Uitbreidingstraat 390,2023-09-03,22:00:00,48,23,25,FMN 18 Binnensingel Westkant
665,Uitbreidingstraat 390,2023-09-03,23:00:00,32,21,11,FMN 18 Binnensingel Westkant
665,Uitbreidingstraat 390,2023-09-04,00:00:00,21,13,8,FMN 18 Binnensingel Westkant
665,Uitbreidingstraat 390,2023-09-04,01:00:00,12,9,3,FMN 18 Binnensingel Westkant
665,Uitbreidingstraat 390,2023-09-04,02:00:00,4,3,1,FMN 18 Binnensingel Westkant
665,Uitbreidingstraat 390,2023-09-04,03:00:00,5,4,1,FMN 18 Binnensingel Westkant
665,Uitbreidingstraat 390,2023-09-04,04:00:00,15,8,7,FMN 18 Binnensingel Westkant
665,Uitbreidingstraat 390,2023-09-04,05:00:00,34,24,10,FMN 18 Binnensingel Westkant
665,Uitbreidingstraat 390,2023-09-04,06:00:00,80,47,33,FMN 18 Binnensingel Westkant
665,Uitbreidingstraat 390,2023-09-04,07:00:00,242,197,45,FMN 18 Binnensingel Westkant
665,Uitbreidingstraat 390,2023-09-04,08:00:00,498,389,109,FMN 18 Binnensingel Westkant
665,Uitbreidingstraat 390,2023-09-04,09:00:00,145,106,39,FMN 18 Binnensingel Westkant
665,Uitbreidingstraat 390,2023-09-04,10:00:00,84,54,30,FMN 18 Binnensingel Westkant
665,Uitbreidingstraat 390,2023-09-04,11:00:00,91,56,35,FMN 18 Binnensingel Westkant
665,Uitbreidingstraat 390,2023-09-04,12:00:00,133,78,55,FMN 18 Binnensingel Westkant
665,Uitbreidingstraat 390,2023-09-04,13:00:00,120,77,43,FMN 18 Binnensingel Westkant
665,Uitbreidingstraat 390,2023-09-04,14:00:00,125,76,49,FMN 18 Binnensingel Westkant
665,Uitbreidingstraat 390,2023-09-04,15:00:00,193,102,91,FMN 18 Binnensingel Westkant
665,Uitbreidingstraat 390,2023-09-04,16:00:00,356,139,217,FMN 18 Binnensingel Westkant
665,Uitbreidingstraat 390,2023-09-04,17:00:00,315,168,147,FMN 18 Binnensingel Westkant
665,Uitbreidingstraat 390,2023-09-04,18:00:00,224,146,78,FMN 18 Binnensingel Westkant
665,Uitbreidingstraat 390,2023-09-04,19:00:00,117,78,39,FMN 18 Binnensingel Westkant
665,Uitbreidingstraat 390,2023-09-04,20:00:00,106,58,48,FMN 18 Binnensingel Westkant
665,Uitbreidingstraat 390,2023-09-04,21:00:00,80,40,40,FMN 18 Binnensingel Westkant
665,Uitbreidingstraat 390,2023-09-04,22:00:00,76,31,45,FMN 18 Binnensingel Westkant
665,Uitbreidingstraat 390,2023-09-04,23:00:00,36,24,12,FMN 18 Binnensingel Westkant
665,Uitbreidingstraat 390,2023-09-05,00:00:00,9,4,5,FMN 18 Binnensingel Westkant
665,Uitbreidingstraat 390,2023-09-05,01:00:00,12,4,8,FMN 18 Binnensingel Westkant
665,Uitbreidingstraat 390,2023-09-05,02:00:00,2,0,2,FMN 18 Binnensingel Westkant
665,Uitbreidingstraat 390,2023-09-05,03:00:00,8,6,2,FMN 18 Binnensingel Westkant
665,Uitbreidingstraat 390,2023-09-05,04:00:00,18,6,12,FMN 18 Binnensingel Westkant
665,Uitbreidingstraat 390,2023-09-05,05:00:00,33,22,11,FMN 18 Binnensingel Westkant
665,Uitbreidingstraat 390,2023-09-05,06:00:00,71,43,28,FMN 18 Binnensingel Westkant
665,Uitbreidingstraat 390,2023-09-05,07:00:00,253,195,58,FMN 18 Binnensingel Westkant
665,Uitbreidingstraat 390,2023-09-05,08:00:00,505,393,112,FMN 18 Binnensingel Westkant
665,Uitbreidingstraat 390,2023-09-05,09:00:00,193,152,41,FMN 18 Binnensingel Westkant
665,Uitbreidingstraat 390,2023-09-05,10:00:00,110,81,29,FMN 18 Binnensingel Westkant
665,Uitbreidingstraat 390,2023-09-05,11:00:00,106,73,33,FMN 18 Binnensingel Westkant
665,Uitbreidingstraat 390,2023-09-05,12:00:00,150,98,52,FMN 18 Binnensingel Westkant
665,Uitbreidingstraat 390,2023-09-05,13:00:00,134,99,35,FMN 18 Binnensingel Westkant
665,Uitbreidingstraat 390,2023-09-05,14:00:00,123,68,55,FMN 18 Binnensingel Westkant
665,Uitbreidingstraat 390,2023-09-05,15:00:00,199,111,88,FMN 18 Binnensingel Westkant
665,Uitbreidingstraat 390,2023-09-05,16:00:00,368,161,207,FMN 18 Binnensingel Westkant
665,Uitbreidingstraat 390,2023-09-05,17:00:00,350,205,145,FMN 18 Binnensingel Westkant
665,Uitbreidingstraat 390,2023-09-05,18:00:00,270,185,85,FMN 18 Binnensingel Westkant
665,Uitbreidingstraat 390,2023-09-05,19:00:00,186,109,77,FMN 18 Binnensingel Westkant
665,Uitbreidingstraat 390,2023-09-05,20:00:00,118,71,47,FMN 18 Binnensingel Westkant
665,Uitbreidingstraat 390,2023-09-05,21:00:00,97,49,48,FMN 18 Binnensingel Westkant
665,Uitbreidingstraat 390,2023-09-05,22:00:00,87,41,46,FMN 18 Binnensingel Westkant
665,Uitbreidingstraat 390,2023-09-05,23:00:00,50,36,14,FMN 18 Binnensingel Westkant
665,Uitbreidingstraat 390,2023-09-06,00:00:00,21,18,3,FMN 18 Binnensingel Westkant
665,Uitbreidingstraat 390,2023-09-06,01:00:00,8,5,3,FMN 18 Binnensingel Westkant
665,Uitbreidingstraat 390,2023-09-06,02:00:00,7,3,4,FMN 18 Binnensingel Westkant
665,Uitbreidingstraat 390,2023-09-06,03:00:00,4,4,0,FMN 18 Binnensingel Westkant
665,Uitbreidingstraat 390,2023-09-06,04:00:00,19,8,11,FMN 18 Binnensingel Westkant
665,Uitbreidingstraat 390,2023-09-06,05:00:00,31,25,6,FMN 18 Binnensingel Westkant
665,Uitbreidingstraat 390,2023-09-06,06:00:00,76,49,27,FMN 18 Binnensingel Westkant
665,Uitbreidingstraat 390,2023-09-06,07:00:00,201,171,30,FMN 18 Binnensingel Westkant
665,Uitbreidingstraat 390,2023-09-06,08:00:00,413,334,79,FMN 18 Binnensingel Westkant
665,Uitbreidingstraat 390,2023-09-06,09:00:00,138,105,33,FMN 18 Binnensingel Westkant
665,Uitbreidingstraat 390,2023-09-06,10:00:00,106,75,31,FMN 18 Binnensingel Westkant
665,Uitbreidingstraat 390,2023-09-06,11:00:00,99,54,45,FMN 18 Binnensingel Westkant
665,Uitbreidingstraat 390,2023-09-06,12:00:00,255,121,134,FMN 18 Binnensingel Westkant
665,Uitbreidingstraat 390,2023-09-06,13:00:00,178,92,86,FMN 18 Binnensingel Westkant
665,Uitbreidingstraat 390,2023-09-06,14:00:00,112,65,47,FMN 18 Binnensingel Westkant
665,Uitbreidingstraat 390,2023-09-06,15:00:00,150,86,64,FMN 18 Binnensingel Westkant
665,Uitbreidingstraat 390,2023-09-06,16:00:00,212,121,91,FMN 18 Binnensingel Westkant
665,Uitbreidingstraat 390,2023-09-06,17:00:00,286,156,130,FMN 18 Binnensingel Westkant
665,Uitbreidingstraat 390,2023-09-06,18:00:00,220,128,92,FMN 18 Binnensingel Westkant
665,Uitbreidingstraat 390,2023-09-06,19:00:00,127,82,45,FMN 18 Binnensingel Westkant
665,Uitbreidingstraat 390,2023-09-06,20:00:00,101,60,41,FMN 18 Binnensingel Westkant
665,Uitbreidingstraat 390,2023-09-06,21:00:00,99,59,40,FMN 18 Binnensingel Westkant
665,Uitbreidingstraat 390,2023-09-06,22:00:00,85,51,34,FMN 18 Binnensingel Westkant
665,Uitbreidingstraat 390,2023-09-06,23:00:00,50,36,14,FMN 18 Binnensingel Westkant
665,Uitbreidingstraat 390,2023-09-07,00:00:00,24,13,11,FMN 18 Binnensingel Westkant
665,Uitbreidingstraat 390,2023-09-07,01:00:00,17,15,2,FMN 18 Binnensingel Westkant
665,Uitbreidingstraat 390,2023-09-07,02:00:00,6,2,4,FMN 18 Binnensingel Westkant
665,Uitbreidingstraat 390,2023-09-07,03:00:00,8,7,1,FMN 18 Binnensingel Westkant
665,Uitbreidingstraat 390,2023-09-07,04:00:00,11,6,5,FMN 18 Binnensingel Westkant
665,Uitbreidingstraat 390,2023-09-07,05:00:00,37,26,11,FMN 18 Binnensingel Westkant
665,Uitbreidingstraat 390,2023-09-07,06:00:00,62,44,18,FMN 18 Binnensingel Westkant
665,Uitbreidingstraat 390,2023-09-07,07:00:00,208,162,46,FMN 18 Binnensingel Westkant
665,Uitbreidingstraat 390,2023-09-07,08:00:00,406,315,91,FMN 18 Binnensingel Westkant
665,Uitbreidingstraat 390,2023-09-07,09:00:00,132,103,29,FMN 18 Binnensingel Westkant
665,Uitbreidingstraat 390,2023-09-07,10:00:00,90,55,35,FMN 18 Binnensingel Westkant
665,Uitbreidingstraat 390,2023-09-07,11:00:00,80,52,28,FMN 18 Binnensingel Westkant
665,Uitbreidingstraat 390,2023-09-07,12:00:00,121,81,40,FMN 18 Binnensingel Westkant
665,Uitbreidingstraat 390,2023-09-07,13:00:00,118,94,24,FMN 18 Binnensingel Westkant
665,Uitbreidingstraat 390,2023-09-07,14:00:00,99,58,41,FMN 18 Binnensingel Westkant
665,Uitbreidingstraat 390,2023-09-07,15:00:00,159,84,75,FMN 18 Binnensingel Westkant
665,Uitbreidingstraat 390,2023-09-07,16:00:00,242,100,142,FMN 18 Binnensingel Westkant
665,Uitbreidingstraat 390,2023-09-07,17:00:00,261,156,105,FMN 18 Binnensingel Westkant
665,Uitbreidingstraat 390,2023-09-07,18:00:00,237,160,77,FMN 18 Binnensingel Westkant
665,Uitbreidingstraat 390,2023-09-07,19:00:00,143,72,71,FMN 18 Binnensingel Westkant
665,Uitbreidingstraat 390,2023-09-07,20:00:00,110,85,25,FMN 18 Binnensingel Westkant
665,Uitbreidingstraat 390,2023-09-07,21:00:00,96,58,38,FMN 18 Binnensingel Westkant
665,Uitbreidingstraat 390,2023-09-07,22:00:00,91,57,34,FMN 18 Binnensingel Westkant
665,Uitbreidingstraat 390,2023-09-07,23:00:00,62,45,17,FMN 18 Binnensingel Westkant
665,Uitbreidingstraat 390,2023-09-08,00:00:00,34,24,10,FMN 18 Binnensingel Westkant
665,Uitbreidingstraat 390,2023-09-08,01:00:00,19,9,10,FMN 18 Binnensingel Westkant
665,Uitbreidingstraat 390,2023-09-08,02:00:00,5,2,3,FMN 18 Binnensingel Westkant
665,Uitbreidingstraat 390,2023-09-08,03:00:00,4,2,2,FMN 18 Binnensingel Westkant
665,Uitbreidingstraat 390,2023-09-08,04:00:00,16,10,6,FMN 18 Binnensingel Westkant
665,Uitbreidingstraat 390,2023-09-08,05:00:00,32,24,8,FMN 18 Binnensingel Westkant
665,Uitbreidingstraat 390,2023-09-08,06:00:00,59,40,19,FMN 18 Binnensingel Westkant
665,Uitbreidingstraat 390,2023-09-08,07:00:00,149,121,28,FMN 18 Binnensingel Westkant
665,Uitbreidingstraat 390,2023-09-08,08:00:00,353,293,60,FMN 18 Binnensingel Westkant
665,Uitbreidingstraat 390,2023-09-08,09:00:00,105,81,24,FMN 18 Binnensingel Westkant
665,Uitbreidingstraat 390,2023-09-08,10:00:00,88,64,24,FMN 18 Binnensingel Westkant
665,Uitbreidingstraat 390,2023-09-08,11:00:00,104,67,37,FMN 18 Binnensingel Westkant
665,Uitbreidingstraat 390,2023-09-08,12:00:00,117,71,46,FMN 18 Binnensingel Westkant
665,Uitbreidingstraat 390,2023-09-08,13:00:00,136,102,34,FMN 18 Binnensingel Westkant
665,Uitbreidingstraat 390,2023-09-08,14:00:00,95,54,41,FMN 18 Binnensingel Westkant
665,Uitbreidingstraat 390,2023-09-08,15:00:00,145,78,67,FMN 18 Binnensingel Westkant
665,Uitbreidingstraat 390,2023-09-08,16:00:00,226,93,133,FMN 18 Binnensingel Westkant
665,Uitbreidingstraat 390,2023-09-08,17:00:00,194,105,89,FMN 18 Binnensingel Westkant
665,Uitbreidingstraat 390,2023-09-08,18:00:00,174,109,65,FMN 18 Binnensingel Westkant
665,Uitbreidingstraat 390,2023-09-08,19:00:00,130,89,41,FMN 18 Binnensingel Westkant
665,Uitbreidingstraat 390,2023-09-08,20:00:00,114,74,40,FMN 18 Binnensingel Westkant
665,Uitbreidingstraat 390,2023-09-08,21:00:00,87,57,30,FMN 18 Binnensingel Westkant
665,Uitbreidingstraat 390,2023-09-08,22:00:00,74,49,25,FMN 18 Binnensingel Westkant
665,Uitbreidingstraat 390,2023-09-08,23:00:00,74,55,19,FMN 18 Binnensingel Westkant
665,Uitbreidingstraat 390,2023-09-09,00:00:00,46,36,10,FMN 18 Binnensingel Westkant
665,Uitbreidingstraat 390,2023-09-09,01:00:00,41,35,6,FMN 18 Binnensingel Westkant
665,Uitbreidingstraat 390,2023-09-09,02:00:00,12,9,3,FMN 18 Binnensingel Westkant
665,Uitbreidingstraat 390,2023-09-09,03:00:00,18,10,8,FMN 18 Binnensingel Westkant
665,Uitbreidingstraat 390,2023-09-09,04:00:00,10,8,2,FMN 18 Binnensingel Westkant
665,Uitbreidingstraat 390,2023-09-09,05:00:00,11,7,4,FMN 18 Binnensingel Westkant
665,Uitbreidingstraat 390,2023-09-09,06:00:00,24,17,7,FMN 18 Binnensingel Westkant
665,Uitbreidingstraat 390,2023-09-09,07:00:00,19,14,5,FMN 18 Binnensingel Westkant
665,Uitbreidingstraat 390,2023-09-09,08:00:00,45,33,12,FMN 18 Binnensingel Westkant
665,Uitbreidingstraat 390,2023-09-09,09:00:00,59,41,18,FMN 18 Binnensingel Westkant
665,Uitbreidingstraat 390,2023-09-09,10:00:00,69,46,23,FMN 18 Binnensingel Westkant
665,Uitbreidingstraat 390,2023-09-09,11:00:00,112,71,41,FMN 18 Binnensingel Westkant
665,Uitbreidingstraat 390,2023-09-09,12:00:00,98,57,41,FMN 18 Binnensingel Westkant
665,Uitbreidingstraat 390,2023-09-09,13:00:00,73,47,26,FMN 18 Binnensingel Westkant
665,Uitbreidingstraat 390,2023-09-09,14:00:00,84,56,28,FMN 18 Binnensingel Westkant
665,Uitbreidingstraat 390,2023-09-09,15:00:00,73,51,22,FMN 18 Binnensingel Westkant
665,Uitbreidingstraat 390,2023-09-09,16:00:00,86,59,27,FMN 18 Binnensingel Westkant
665,Uitbreidingstraat 390,2023-09-09,17:00:00,104,64,40,FMN 18 Binnensingel Westkant
665,Uitbreidingstraat 390,2023-09-09,18:00:00,87,55,32,FMN 18 Binnensingel Westkant
665,Uitbreidingstraat 390,2023-09-09,19:00:00,86,49,37,FMN 18 Binnensingel Westkant
665,Uitbreidingstraat 390,2023-09-09,20:00:00,79,58,21,FMN 18 Binnensingel Westkant
665,Uitbreidingstraat 390,2023-09-09,21:00:00,56,35,21,FMN 18 Binnensingel Westkant
665,Uitbreidingstraat 390,2023-09-09,22:00:00,58,40,18,FMN 18 Binnensingel Westkant
665,Uitbreidingstraat 390,2023-09-09,23:00:00,41,36,5,FMN 18 Binnensingel Westkant
665,Uitbreidingstraat 390,2023-09-10,00:00:00,38,29,9,FMN 18 Binnensingel Westkant
665,Uitbreidingstraat 390,2023-09-10,01:00:00,34,24,10,FMN 18 Binnensingel Westkant
665,Uitbreidingstraat 390,2023-09-10,02:00:00,17,12,5,FMN 18 Binnensingel Westkant
665,Uitbreidingstraat 390,2023-09-10,03:00:00,21,13,8,FMN 18 Binnensingel Westkant
665,Uitbreidingstraat 390,2023-09-10,04:00:00,6,3,3,FMN 18 Binnensingel Westkant
665,Uitbreidingstraat 390,2023-09-10,05:00:00,12,7,5,FMN 18 Binnensingel Westkant
665,Uitbreidingstraat 390,2023-09-10,06:00:00,19,15,4,FMN 18 Binnensingel Westkant
665,Uitbreidingstraat 390,2023-09-10,07:00:00,20,16,4,FMN 18 Binnensingel Westkant
665,Uitbreidingstraat 390,2023-09-10,08:00:00,33,27,6,FMN 18 Binnensingel Westkant
665,Uitbreidingstraat 390,2023-09-10,09:00:00,64,45,19,FMN 18 Binnensingel Westkant
665,Uitbreidingstraat 390,2023-09-10,10:00:00,85,61,24,FMN 18 Binnensingel Westkant
665,Uitbreidingstraat 390,2023-09-10,11:00:00,109,70,39,FMN 18 Binnensingel Westkant
665,Uitbreidingstraat 390,2023-09-10,12:00:00,102,63,39,FMN 18 Binnensingel Westkant
665,Uitbreidingstraat 390,2023-09-10,13:00:00,102,76,26,FMN 18 Binnensingel Westkant
665,Uitbreidingstraat 390,2023-09-10,14:00:00,87,59,28,FMN 18 Binnensingel Westkant
665,Uitbreidingstraat 390,2023-09-10,15:00:00,79,53,26,FMN 18 Binnensingel Westkant
665,Uitbreidingstraat 390,2023-09-10,16:00:00,94,63,31,FMN 18 Binnensingel Westkant
665,Uitbreidingstraat 390,2023-09-10,17:00:00,96,73,23,FMN 18 Binnensingel Westkant
665,Uitbreidingstraat 390,2023-09-10,18:00:00,93,67,26,FMN 18 Binnensingel Westkant
665,Uitbreidingstraat 390,2023-09-10,19:00:00,90,53,37,FMN 18 Binnensingel Westkant
665,Uitbreidingstraat 390,2023-09-10,20:00:00,87,59,28,FMN 18 Binnensingel Westkant
665,Uitbreidingstraat 390,2023-09-10,21:00:00,72,43,29,FMN 18 Binnensingel Westkant
665,Uitbreidingstraat 390,2023-09-10,22:00:00,37,28,9,FMN 18 Binnensingel Westkant
665,Uitbreidingstraat 390,2023-09-10,23:00:00,21,16,5,FMN 18 Binnensingel Westkant
665,Uitbreidingstraat 390,2023-09-11,00:00:00,15,10,5,FMN 18 Binnensingel Westkant
665,Uitbreidingstraat 390,2023-09-11,01:00:00,7,5,2,FMN 18 Binnensingel Westkant
665,Uitbreidingstraat 390,2023-09-11,02:00:00,5,4,1,FMN 18 Binnensingel Westkant
665,Uitbreidingstraat 390,2023-09-11,03:00:00,5,2,3,FMN 18 Binnensingel Westkant
665,Uitbreidingstraat 390,2023-09-11,04:00:00,6,3,3,FMN 18 Binnensingel Westkant
665,Uitbreidingstraat 390,2023-09-11,05:00:00,37,30,7,FMN 18 Binnensingel Westkant
665,Uitbreidingstraat 390,2023-09-11,06:00:00,64,44,20,FMN 18 Binnensingel Westkant
665,Uitbreidingstraat 390,2023-09-11,07:00:00,185,148,37,FMN 18 Binnensingel Westkant
665,Uitbreidingstraat 390,2023-09-11,08:00:00,434,352,82,FMN 18 Binnensingel Westkant
665,Uitbreidingstraat 390,2023-09-11,09:00:00,115,89,26,FMN 18 Binnensingel Westkant
665,Uitbreidingstraat 390,2023-09-11,10:00:00,67,49,18,FMN 18 Binnensingel Westkant
665,Uitbreidingstraat 390,2023-09-11,11:00:00,77,49,28,FMN 18 Binnensingel Westkant
665,Uitbreidingstraat 390,2023-09-11,12:00:00,115,84,31,FMN 18 Binnensingel Westkant
665,Uitbreidingstraat 390,2023-09-11,13:00:00,80,59,21,FMN 18 Binnensingel Westkant
665,Uitbreidingstraat 390,2023-09-11,14:00:00,79,51,28,FMN 18 Binnensingel Westkant
665,Uitbreidingstraat 390,2023-09-11,15:00:00,123,51,72,FMN 18 Binnensingel Westkant
665,Uitbreidingstraat 390,2023-09-11,16:00:00,278,114,164,FMN 18 Binnensingel Westkant
665,Uitbreidingstraat 390,2023-09-11,17:00:00,248,141,107,FMN 18 Binnensingel Westkant
665,Uitbreidingstraat 390,2023-09-11,18:00:00,180,119,61,FMN 18 Binnensingel Westkant
665,Uitbreidingstraat 390,2023-09-11,19:00:00,92,58,34,FMN 18 Binnensingel Westkant
665,Uitbreidingstraat 390,2023-09-11,20:00:00,75,48,27,FMN 18 Binnensingel Westkant
665,Uitbreidingstraat 390,2023-09-11,21:00:00,64,36,28,FMN 18 Binnensingel Westkant
665,Uitbreidingstraat 390,2023-09-11,22:00:00,64,38,26,FMN 18 Binnensingel Westkant
665,Uitbreidingstraat 390,2023-09-11,23:00:00,28,22,6,FMN 18 Binnensingel Westkant
665,Uitbreidingstraat 390,2023-09-12,00:00:00,10,6,4,FMN 18 Binnensingel Westkant
665,Uitbreidingstraat 390,2023-09-12,01:00:00,11,6,5,FMN 18 Binnensingel Westkant
665,Uitbreidingstraat 390,2023-09-12,02:00:00,4,2,2,FMN 18 Binnensingel Westkant
665,Uitbreidingstraat 390,2023-09-12,03:00:00,4,3,1,FMN 18 Binnensingel Westkant
665,Uitbreidingstraat 390,2023-09-12,04:00:00,10,6,4,FMN 18 Binnensingel Westkant
665,Uitbreidingstraat 390,2023-09-12,05:00:00,33,28,5,FMN 18 Binnensingel Westkant
665,Uitbreidingstraat 390,2023-09-12,06:00:00,59,44,15,FMN 18 Binnensingel Westkant
665,Uitbreidingstraat 390,2023-09-12,07:00:00,176,140,36,FMN 18 Binnensingel Westkant
665,Uitbreidingstraat 390,2023-09-12,08:00:00,371,291,80,FMN 18 Binnensingel Westkant
665,Uitbreidingstraat 390,2023-09-12,09:00:00,107,86,21,FMN 18 Binnensingel Westkant
665,Uitbreidingstraat 390,2023-09-12,10:00:00,64,50,14,FMN 18 Binnensingel Westkant
665,Uitbreidingstraat 390,2023-09-12,11:00:00,81,59,22,FMN 18 Binnensingel Westkant
665,Uitbreidingstraat 390,2023-09-12,12:00:00,115,79,36,FMN 18 Binnensingel Westkant
665,Uitbreidingstraat 390,2023-09-12,13:00:00,82,52,30,FMN 18 Binnensingel Westkant
665,Uitbreidingstraat 390,2023-09-12,14:00:00,90,58,32,FMN 18 Binnensingel Westkant
665,Uitbreidingstraat 390,2023-09-12,15:00:00,167,76,91,FMN 18 Binnensingel Westkant
665,Uitbreidingstraat 390,2023-09-12,16:00:00,296,132,164,FMN 18 Binnensingel Westkant
665,Uitbreidingstraat 390,2023-09-12,17:00:00,244,143,101,FMN 18 Binnensingel Westkant
665,Uitbreidingstraat 390,2023-09-12,18:00:00,192,131,61,FMN 18 Binnensingel Westkant
665,Uitbreidingstraat 390,2023-09-12,19:00:00,87,58,29,FMN 18 Binnensingel Westkant
665,Uitbreidingstraat 390,2023-09-12,20:00:00,80,47,33,FMN 18 Binnensingel Westkant
665,Uitbreidingstraat 390,2023-09-12,21:00:00,64,35,29,FMN 18 Binnensingel Westkant
665,Uitbreidingstraat 390,2023-09-12,22:00:00,47,30,17,FMN 18 Binnensingel Westkant
665,Uitbreidingstraat 390,2023-09-12,23:00:00,39,25,14,FMN 18 Binnensingel Westkant
665,Uitbreidingstraat 390,2023-09-13,00:00:00,9,6,3,FMN 18 Binnensingel Westkant
665,Uitbreidingstraat 390,2023-09-13,01:00:00,3,3,0,FMN 18 Binnensingel Westkant
665,Uitbreidingstraat 390,2023-09-13,02:00:00,0,0,0,FMN 18 Binnensingel Westkant
665,Uitbreidingstraat 390,2023-09-13,03:00:00,4,2,2,FMN 18 Binnensingel Westkant
665,Uitbreidingstraat 390,2023-09-13,04:00:00,10,5,5,FMN 18 Binnensingel Westkant
665,Uitbreidingstraat 390,2023-09-13,05:00:00,36,29,7,FMN 18 Binnensingel Westkant
665,Uitbreidingstraat 390,2023-09-13,06:00:00,64,47,17,FMN 18 Binnensingel Westkant
665,Uitbreidingstraat 390,2023-09-13,07:00:00,152,115,37,FMN 18 Binnensingel Westkant
665,Uitbreidingstraat 390,2023-09-13,08:00:00,340,274,66,FMN 18 Binnensingel Westkant
665,Uitbreidingstraat 390,2023-09-13,09:00:00,87,70,17,FMN 18 Binnensingel Westkant
665,Uitbreidingstraat 390,2023-09-13,10:00:00,52,43,9,FMN 18 Binnensingel Westkant
665,Uitbreidingstraat 390,2023-09-13,11:00:00,75,47,28,FMN 18 Binnensingel Westkant
665,Uitbreidingstraat 390,2023-09-13,12:00:00,187,98,89,FMN 18 Binnensingel Westkant
665,Uitbreidingstraat 390,2023-09-13,13:00:00,157,69,88,FMN 18 Binnensingel Westkant
665,Uitbreidingstraat 390,2023-09-13,14:00:00,114,67,47,FMN 18 Binnensingel Westkant
665,Uitbreidingstraat 390,2023-09-13,15:00:00,130,69,61,FMN 18 Binnensingel Westkant
665,Uitbreidingstraat 390,2023-09-13,16:00:00,164,93,71,FMN 18 Binnensingel Westkant
665,Uitbreidingstraat 390,2023-09-13,17:00:00,227,123,104,FMN 18 Binnensingel Westkant
665,Uitbreidingstraat 390,2023-09-13,18:00:00,169,102,67,FMN 18 Binnensingel Westkant
665,Uitbreidingstraat 390,2023-09-13,19:00:00,84,53,31,FMN 18 Binnensingel Westkant
665,Uitbreidingstraat 390,2023-09-13,20:00:00,81,47,34,FMN 18 Binnensingel Westkant
665,Uitbreidingstraat 390,2023-09-13,21:00:00,83,47,36,FMN 18 Binnensingel Westkant
665,Uitbreidingstraat 390,2023-09-13,22:00:00,56,27,29,FMN 18 Binnensingel Westkant
665,Uitbreidingstraat 390,2023-09-13,23:00:00,42,26,16,FMN 18 Binnensingel Westkant
665,Uitbreidingstraat 390,2023-09-14,00:00:00,12,9,3,FMN 18 Binnensingel Westkant
665,Uitbreidingstraat 390,2023-09-14,01:00:00,9,5,4,FMN 18 Binnensingel Westkant
665,Uitbreidingstraat 390,2023-09-14,02:00:00,3,3,0,FMN 18 Binnensingel Westkant
665,Uitbreidingstraat 390,2023-09-14,03:00:00,6,6,0,FMN 18 Binnensingel Westkant
665,Uitbreidingstraat 390,2023-09-14,04:00:00,10,4,6,FMN 18 Binnensingel Westkant
665,Uitbreidingstraat 390,2023-09-14,05:00:00,29,24,5,FMN 18 Binnensingel Westkant
665,Uitbreidingstraat 390,2023-09-14,06:00:00,59,44,15,FMN 18 Binnensingel Westkant
665,Uitbreidingstraat 390,2023-09-14,07:00:00,153,116,37,FMN 18 Binnensingel Westkant
665,Uitbreidingstraat 390,2023-09-14,08:00:00,369,298,71,FMN 18 Binnensingel Westkant
665,Uitbreidingstraat 390,2023-09-14,09:00:00,116,101,15,FMN 18 Binnensingel Westkant
665,Uitbreidingstraat 390,2023-09-14,10:00:00,68,50,18,FMN 18 Binnensingel Westkant
665,Uitbreidingstraat 390,2023-09-14,11:00:00,77,51,26,FMN 18 Binnensingel Westkant
665,Uitbreidingstraat 390,2023-09-14,12:00:00,108,60,48,FMN 18 Binnensingel Westkant
665,Uitbreidingstraat 390,2023-09-14,13:00:00,101,72,29,FMN 18 Binnensingel Westkant
665,Uitbreidingstraat 390,2023-09-14,14:00:00,101,55,46,FMN 18 Binnensingel Westkant
665,Uitbreidingstraat 390,2023-09-14,15:00:00,140,67,73,FMN 18 Binnensingel Westkant
665,Uitbreidingstraat 390,2023-09-14,16:00:00,268,115,153,FMN 18 Binnensingel Westkant
665,Uitbreidingstraat 390,2023-09-14,17:00:00,262,149,113,FMN 18 Binnensingel Westkant
665,Uitbreidingstraat 390,2023-09-14,18:00:00,211,136,75,FMN 18 Binnensingel Westkant
665,Uitbreidingstraat 390,2023-09-14,19:00:00,133,89,44,FMN 18 Binnensingel Westkant
665,Uitbreidingstraat 390,2023-09-14,20:00:00,95,62,33,FMN 18 Binnensingel Westkant
665,Uitbreidingstraat 390,2023-09-14,21:00:00,81,47,34,FMN 18 Binnensingel Westkant
665,Uitbreidingstraat 390,2023-09-14,22:00:00,60,46,14,FMN 18 Binnensingel Westkant
665,Uitbreidingstraat 390,2023-09-14,23:00:00,28,15,13,FMN 18 Binnensingel Westkant
665,Uitbreidingstraat 390,2023-09-15,00:00:00,20,14,6,FMN 18 Binnensingel Westkant
665,Uitbreidingstraat 390,2023-09-15,01:00:00,9,7,2,FMN 18 Binnensingel Westkant
665,Uitbreidingstraat 390,2023-09-15,02:00:00,4,1,3,FMN 18 Binnensingel Westkant
665,Uitbreidingstraat 390,2023-09-15,03:00:00,3,3,0,FMN 18 Binnensingel Westkant
665,Uitbreidingstraat 390,2023-09-15,04:00:00,6,2,4,FMN 18 Binnensingel Westkant
665,Uitbreidingstraat 390,2023-09-15,05:00:00,29,25,4,FMN 18 Binnensingel Westkant
665,Uitbreidingstraat 390,2023-09-15,06:00:00,47,30,17,FMN 18 Binnensingel Westkant
665,Uitbreidingstraat 390,2023-09-15,07:00:00,144,119,25,FMN 18 Binnensingel Westkant
665,Uitbreidingstraat 390,2023-09-15,08:00:00,308,248,60,FMN 18 Binnensingel Westkant
665,Uitbreidingstraat 390,2023-09-15,09:00:00,150,135,15,FMN 18 Binnensingel Westkant
665,Uitbreidingstraat 390,2023-09-15,10:00:00,83,63,20,FMN 18 Binnensingel Westkant
665,Uitbreidingstraat 390,2023-09-15,11:00:00,91,60,31,FMN 18 Binnensingel Westkant
665,Uitbreidingstraat 390,2023-09-15,12:00:00,124,83,41,FMN 18 Binnensingel Westkant
665,Uitbreidingstraat 390,2023-09-15,13:00:00,101,75,26,FMN 18 Binnensingel Westkant
665,Uitbreidingstraat 390,2023-09-15,14:00:00,98,65,33,FMN 18 Binnensingel Westkant
665,Uitbreidingstraat 390,2023-09-15,15:00:00,155,90,65,FMN 18 Binnensingel Westkant
665,Uitbreidingstraat 390,2023-09-15,16:00:00,276,128,148,FMN 18 Binnensingel Westkant
665,Uitbreidingstraat 390,2023-09-15,17:00:00,218,136,82,FMN 18 Binnensingel Westkant
665,Uitbreidingstraat 390,2023-09-15,18:00:00,162,96,66,FMN 18 Binnensingel Westkant
665,Uitbreidingstraat 390,2023-09-15,19:00:00,136,100,36,FMN 18 Binnensingel Westkant
665,Uitbreidingstraat 390,2023-09-15,20:00:00,113,81,32,FMN 18 Binnensingel Westkant
665,Uitbreidingstraat 390,2023-09-15,21:00:00,66,40,26,FMN 18 Binnensingel Westkant
665,Uitbreidingstraat 390,2023-09-15,22:00:00,56,36,20,FMN 18 Binnensingel Westkant
665,Uitbreidingstraat 390,2023-09-15,23:00:00,75,48,27,FMN 18 Binnensingel Westkant
665,Uitbreidingstraat 390,2023-09-16,00:00:00,38,31,7,FMN 18 Binnensingel Westkant
665,Uitbreidingstraat 390,2023-09-16,01:00:00,27,21,6,FMN 18 Binnensingel Westkant
665,Uitbreidingstraat 390,2023-09-16,02:00:00,17,13,4,FMN 18 Binnensingel Westkant
665,Uitbreidingstraat 390,2023-09-16,03:00:00,5,3,2,FMN 18 Binnensingel Westkant
665,Uitbreidingstraat 390,2023-09-16,04:00:00,7,7,0,FMN 18 Binnensingel Westkant
665,Uitbreidingstraat 390,2023-09-16,05:00:00,13,9,4,FMN 18 Binnensingel Westkant
665,Uitbreidingstraat 390,2023-09-16,06:00:00,14,7,7,FMN 18 Binnensingel Westkant
665,Uitbreidingstraat 390,2023-09-16,07:00:00,12,5,7,FMN 18 Binnensingel Westkant
665,Uitbreidingstraat 390,2023-09-16,08:00:00,32,24,8,FMN 18 Binnensingel Westkant
665,Uitbreidingstraat 390,2023-09-16,09:00:00,55,39,16,FMN 18 Binnensingel Westkant
665,Uitbreidingstraat 390,2023-09-16,10:00:00,83,55,28,FMN 18 Binnensingel Westkant
665,Uitbreidingstraat 390,2023-09-16,11:00:00,72,46,26,FMN 18 Binnensingel Westkant
665,Uitbreidingstraat 390,2023-09-16,12:00:00,106,68,38,FMN 18 Binnensingel Westkant
665,Uitbreidingstraat 390,2023-09-16,13:00:00,78,57,21,FMN 18 Binnensingel Westkant
665,Uitbreidingstraat 390,2023-09-16,14:00:00,91,67,24,FMN 18 Binnensingel Westkant
665,Uitbreidingstraat 390,2023-09-16,15:00:00,103,59,44,FMN 18 Binnensingel Westkant
665,Uitbreidingstraat 390,2023-09-16,16:00:00,96,68,28,FMN 18 Binnensingel Westkant
665,Uitbreidingstraat 390,2023-09-16,17:00:00,106,74,32,FMN 18 Binnensingel Westkant
665,Uitbreidingstraat 390,2023-09-16,18:00:00,94,65,29,FMN 18 Binnensingel Westkant
665,Uitbreidingstraat 390,2023-09-16,19:00:00,85,64,21,FMN 18 Binnensingel Westkant
665,Uitbreidingstraat 390,2023-09-16,20:00:00,57,34,23,FMN 18 Binnensingel Westkant
665,Uitbreidingstraat 390,2023-09-16,21:00:00,44,30,14,FMN 18 Binnensingel Westkant
665,Uitbreidingstraat 390,2023-09-16,22:00:00,51,36,15,FMN 18 Binnensingel Westkant
665,Uitbreidingstraat 390,2023-09-16,23:00:00,53,39,14,FMN 18 Binnensingel Westkant
665,Uitbreidingstraat 390,2023-09-17,00:00:00,36,21,15,FMN 18 Binnensingel Westkant
665,Uitbreidingstraat 390,2023-09-17,01:00:00,26,21,5,FMN 18 Binnensingel Westkant
665,Uitbreidingstraat 390,2023-09-17,02:00:00,22,16,6,FMN 18 Binnensingel Westkant
665,Uitbreidingstraat 390,2023-09-17,03:00:00,20,17,3,FMN 18 Binnensingel Westkant
665,Uitbreidingstraat 390,2023-09-17,04:00:00,6,3,3,FMN 18 Binnensingel Westkant
665,Uitbreidingstraat 390,2023-09-17,05:00:00,9,4,5,FMN 18 Binnensingel Westkant
665,Uitbreidingstraat 390,2023-09-17,06:00:00,19,14,5,FMN 18 Binnensingel Westkant
665,Uitbreidingstraat 390,2023-09-17,07:00:00,10,9,1,FMN 18 Binnensingel Westkant
665,Uitbreidingstraat 390,2023-09-17,08:00:00,20,15,5,FMN 18 Binnensingel Westkant
665,Uitbreidingstraat 390,2023-09-17,09:00:00,44,29,15,FMN 18 Binnensingel Westkant
665,Uitbreidingstraat 390,2023-09-17,10:00:00,66,46,20,FMN 18 Binnensingel Westkant
665,Uitbreidingstraat 390,2023-09-17,11:00:00,70,39,31,FMN 18 Binnensingel Westkant
665,Uitbreidingstraat 390,2023-09-17,12:00:00,97,62,35,FMN 18 Binnensingel Westkant
665,Uitbreidingstraat 390,2023-09-17,13:00:00,85,61,24,FMN 18 Binnensingel Westkant
665,Uitbreidingstraat 390,2023-09-17,14:00:00,83,61,22,FMN 18 Binnensingel Westkant
665,Uitbreidingstraat 390,2023-09-17,15:00:00,76,50,26,FMN 18 Binnensingel Westkant
665,Uitbreidingstraat 390,2023-09-17,16:00:00,77,56,21,FMN 18 Binnensingel Westkant
665,Uitbreidingstraat 390,2023-09-17,17:00:00,91,69,22,FMN 18 Binnensingel Westkant
665,Uitbreidingstraat 390,2023-09-17,18:00:00,95,66,29,FMN 18 Binnensingel Westkant
665,Uitbreidingstraat 390,2023-09-17,19:00:00,84,54,30,FMN 18 Binnensingel Westkant
665,Uitbreidingstraat 390,2023-09-17,20:00:00,66,40,26,FMN 18 Binnensingel Westkant
665,Uitbreidingstraat 390,2023-09-17,21:00:00,58,36,22,FMN 18 Binnensingel Westkant
665,Uitbreidingstraat 390,2023-09-17,22:00:00,30,20,10,FMN 18 Binnensingel Westkant
665,Uitbreidingstraat 390,2023-09-17,23:00:00,34,21,13,FMN 18 Binnensingel Westkant
665,Uitbreidingstraat 390,2023-09-18,00:00:00,6,4,2,FMN 18 Binnensingel Westkant
665,Uitbreidingstraat 390,2023-09-18,01:00:00,8,8,0,FMN 18 Binnensingel Westkant
665,Uitbreidingstraat 390,2023-09-18,02:00:00,2,2,0,FMN 18 Binnensingel Westkant
665,Uitbreidingstraat 390,2023-09-18,03:00:00,6,4,2,FMN 18 Binnensingel Westkant
665,Uitbreidingstraat 390,2023-09-18,04:00:00,10,3,7,FMN 18 Binnensingel Westkant
665,Uitbreidingstraat 390,2023-09-18,05:00:00,29,24,5,FMN 18 Binnensingel Westkant
665,Uitbreidingstraat 390,2023-09-18,06:00:00,60,45,15,FMN 18 Binnensingel Westkant
665,Uitbreidingstraat 390,2023-09-18,07:00:00,173,137,36,FMN 18 Binnensingel Westkant
665,Uitbreidingstraat 390,2023-09-18,08:00:00,386,325,61,FMN 18 Binnensingel Westkant
665,Uitbreidingstraat 390,2023-09-18,09:00:00,137,111,26,FMN 18 Binnensingel Westkant
665,Uitbreidingstraat 390,2023-09-18,10:00:00,84,67,17,FMN 18 Binnensingel Westkant
665,Uitbreidingstraat 390,2023-09-18,11:00:00,63,36,27,FMN 18 Binnensingel Westkant
665,Uitbreidingstraat 390,2023-09-18,12:00:00,86,51,35,FMN 18 Binnensingel Westkant
665,Uitbreidingstraat 390,2023-09-18,13:00:00,91,65,26,FMN 18 Binnensingel Westkant
665,Uitbreidingstraat 390,2023-09-18,14:00:00,95,55,40,FMN 18 Binnensingel Westkant
665,Uitbreidingstraat 390,2023-09-18,15:00:00,153,70,83,FMN 18 Binnensingel Westkant
665,Uitbreidingstraat 390,2023-09-18,16:00:00,262,100,162,FMN 18 Binnensingel Westkant
665,Uitbreidingstraat 390,2023-09-18,17:00:00,221,118,103,FMN 18 Binnensingel Westkant
665,Uitbreidingstraat 390,2023-09-18,18:00:00,214,148,66,FMN 18 Binnensingel Westkant
665,Uitbreidingstraat 390,2023-09-18,19:00:00,115,75,40,FMN 18 Binnensingel Westkant
665,Uitbreidingstraat 390,2023-09-18,20:00:00,78,42,36,FMN 18 Binnensingel Westkant
665,Uitbreidingstraat 390,2023-09-18,21:00:00,88,38,50,FMN 18 Binnensingel Westkant
665,Uitbreidingstraat 390,2023-09-18,22:00:00,45,25,20,FMN 18 Binnensingel Westkant
665,Uitbreidingstraat 390,2023-09-18,23:00:00,18,11,7,FMN 18 Binnensingel Westkant
665,Uitbreidingstraat 390,2023-09-19,00:00:00,13,9,4,FMN 18 Binnensingel Westkant
665,Uitbreidingstraat 390,2023-09-19,01:00:00,10,7,3,FMN 18 Binnensingel Westkant
665,Uitbreidingstraat 390,2023-09-19,02:00:00,4,3,1,FMN 18 Binnensingel Westkant
665,Uitbreidingstraat 390,2023-09-19,03:00:00,1,1,0,FMN 18 Binnensingel Westkant
665,Uitbreidingstraat 390,2023-09-19,04:00:00,10,4,6,FMN 18 Binnensingel Westkant
665,Uitbreidingstraat 390,2023-09-19,05:00:00,22,20,2,FMN 18 Binnensingel Westkant
665,Uitbreidingstraat 390,2023-09-19,06:00:00,72,55,17,FMN 18 Binnensingel Westkant
665,Uitbreidingstraat 390,2023-09-19,07:00:00,187,149,38,FMN 18 Binnensingel Westkant
665,Uitbreidingstraat 390,2023-09-19,08:00:00,347,279,68,FMN 18 Binnensingel Westkant
665,Uitbreidingstraat 390,2023-09-19,09:00:00,160,127,33,FMN 18 Binnensingel Westkant
665,Uitbreidingstraat 390,2023-09-19,10:00:00,65,47,18,FMN 18 Binnensingel Westkant
665,Uitbreidingstraat 390,2023-09-19,11:00:00,69,43,26,FMN 18 Binnensingel Westkant
665,Uitbreidingstraat 390,2023-09-19,12:00:00,105,69,36,FMN 18 Binnensingel Westkant
665,Uitbreidingstraat 390,2023-09-19,13:00:00,112,85,27,FMN 18 Binnensingel Westkant
665,Uitbreidingstraat 390,2023-09-19,14:00:00,94,66,28,FMN 18 Binnensingel Westkant
665,Uitbreidingstraat 390,2023-09-19,15:00:00,155,62,93,FMN 18 Binnensingel Westkant
665,Uitbreidingstraat 390,2023-09-19,16:00:00,258,107,151,FMN 18 Binnensingel Westkant
665,Uitbreidingstraat 390,2023-09-19,17:00:00,275,146,129,FMN 18 Binnensingel Westkant
665,Uitbreidingstraat 390,2023-09-19,18:00:00,185,119,66,FMN 18 Binnensingel Westkant
665,Uitbreidingstraat 390,2023-09-19,19:00:00,104,60,44,FMN 18 Binnensingel Westkant
665,Uitbreidingstraat 390,2023-09-19,20:00:00,90,50,40,FMN 18 Binnensingel Westkant
665,Uitbreidingstraat 390,2023-09-19,21:00:00,76,49,27,FMN 18 Binnensingel Westkant
665,Uitbreidingstraat 390,2023-09-19,22:00:00,59,24,35,FMN 18 Binnensingel Westkant
665,Uitbreidingstraat 390,2023-09-19,23:00:00,29,20,9,FMN 18 Binnensingel Westkant
665,Uitbreidingstraat 390,2023-09-20,00:00:00,12,7,5,FMN 18 Binnensingel Westkant
665,Uitbreidingstraat 390,2023-09-20,01:00:00,4,3,1,FMN 18 Binnensingel Westkant
665,Uitbreidingstraat 390,2023-09-20,02:00:00,5,1,4,FMN 18 Binnensingel Westkant
665,Uitbreidingstraat 390,2023-09-20,03:00:00,4,3,1,FMN 18 Binnensingel Westkant
665,Uitbreidingstraat 390,2023-09-20,04:00:00,16,7,9,FMN 18 Binnensingel Westkant
665,Uitbreidingstraat 390,2023-09-20,05:00:00,29,26,3,FMN 18 Binnensingel Westkant
665,Uitbreidingstraat 390,2023-09-20,06:00:00,52,39,13,FMN 18 Binnensingel Westkant
665,Uitbreidingstraat 390,2023-09-20,07:00:00,161,130,31,FMN 18 Binnensingel Westkant
665,Uitbreidingstraat 390,2023-09-20,08:00:00,302,237,65,FMN 18 Binnensingel Westkant
665,Uitbreidingstraat 390,2023-09-20,09:00:00,126,101,25,FMN 18 Binnensingel Westkant
665,Uitbreidingstraat 390,2023-09-20,10:00:00,83,56,27,FMN 18 Binnensingel Westkant
665,Uitbreidingstraat 390,2023-09-20,11:00:00,78,50,28,FMN 18 Binnensingel Westkant
665,Uitbreidingstraat 390,2023-09-20,12:00:00,171,89,82,FMN 18 Binnensingel Westkant
665,Uitbreidingstraat 390,2023-09-20,13:00:00,175,100,75,FMN 18 Binnensingel Westkant
665,Uitbreidingstraat 390,2023-09-20,14:00:00,85,55,30,FMN 18 Binnensingel Westkant
665,Uitbreidingstraat 390,2023-09-20,15:00:00,116,76,40,FMN 18 Binnensingel Westkant
665,Uitbreidingstraat 390,2023-09-20,16:00:00,175,87,88,FMN 18 Binnensingel Westkant
665,Uitbreidingstraat 390,2023-09-20,17:00:00,222,136,86,FMN 18 Binnensingel Westkant
665,Uitbreidingstraat 390,2023-09-20,18:00:00,173,103,70,FMN 18 Binnensingel Westkant
665,Uitbreidingstraat 390,2023-09-20,19:00:00,100,71,29,FMN 18 Binnensingel Westkant
665,Uitbreidingstraat 390,2023-09-20,20:00:00,69,36,33,FMN 18 Binnensingel Westkant
665,Uitbreidingstraat 390,2023-09-20,21:00:00,70,37,33,FMN 18 Binnensingel Westkant
665,Uitbreidingstraat 390,2023-09-20,22:00:00,63,27,36,FMN 18 Binnensingel Westkant
665,Uitbreidingstraat 390,2023-09-20,23:00:00,30,19,11,FMN 18 Binnensingel Westkant
665,Uitbreidingstraat 390,2023-09-21,00:00:00,8,6,2,FMN 18 Binnensingel Westkant
665,Uitbreidingstraat 390,2023-09-21,01:00:00,11,7,4,FMN 18 Binnensingel Westkant
665,Uitbreidingstraat 390,2023-09-21,02:00:00,9,5,4,FMN 18 Binnensingel Westkant
665,Uitbreidingstraat 390,2023-09-21,03:00:00,8,5,3,FMN 18 Binnensingel Westkant
665,Uitbreidingstraat 390,2023-09-21,04:00:00,13,4,9,FMN 18 Binnensingel Westkant
665,Uitbreidingstraat 390,2023-09-21,05:00:00,14,14,0,FMN 18 Binnensingel Westkant
665,Uitbreidingstraat 390,2023-09-21,06:00:00,57,41,16,FMN 18 Binnensingel Westkant
665,Uitbreidingstraat 390,2023-09-21,07:00:00,147,109,38,FMN 18 Binnensingel Westkant
665,Uitbreidingstraat 390,2023-09-21,08:00:00,313,253,60,FMN 18 Binnensingel Westkant
665,Uitbreidingstraat 390,2023-09-21,09:00:00,111,84,27,FMN 18 Binnensingel Westkant
665,Uitbreidingstraat 390,2023-09-21,10:00:00,61,47,14,FMN 18 Binnensingel Westkant
665,Uitbreidingstraat 390,2023-09-21,11:00:00,39,27,12,FMN 18 Binnensingel Westkant
665,Uitbreidingstraat 390,2023-09-21,12:00:00,74,43,31,FMN 18 Binnensingel Westkant
665,Uitbreidingstraat 390,2023-09-21,13:00:00,45,36,9,FMN 18 Binnensingel Westkant
665,Uitbreidingstraat 390,2023-09-21,14:00:00,61,32,29,FMN 18 Binnensingel Westkant
665,Uitbreidingstraat 390,2023-09-21,15:00:00,111,49,62,FMN 18 Binnensingel Westkant
665,Uitbreidingstraat 390,2023-09-21,16:00:00,195,62,133,FMN 18 Binnensingel Westkant
665,Uitbreidingstraat 390,2023-09-21,17:00:00,155,81,74,FMN 18 Binnensingel Westkant
665,Uitbreidingstraat 390,2023-09-21,18:00:00,131,71,60,FMN 18 Binnensingel Westkant
665,Uitbreidingstraat 390,2023-09-21,19:00:00,81,48,33,FMN 18 Binnensingel Westkant
665,Uitbreidingstraat 390,2023-09-21,20:00:00,67,43,24,FMN 18 Binnensingel Westkant
665,Uitbreidingstraat 390,2023-09-21,21:00:00,40,23,17,FMN 18 Binnensingel Westkant
665,Uitbreidingstraat 390,2023-09-21,22:00:00,47,29,18,FMN 18 Binnensingel Westkant
665,Uitbreidingstraat 390,2023-09-21,23:00:00,34,20,14,FMN 18 Binnensingel Westkant
665,Uitbreidingstraat 390,2023-09-22,00:00:00,14,8,6,FMN 18 Binnensingel Westkant
665,Uitbreidingstraat 390,2023-09-22,01:00:00,6,4,2,FMN 18 Binnensingel Westkant
665,Uitbreidingstraat 390,2023-09-22,02:00:00,4,2,2,FMN 18 Binnensingel Westkant
665,Uitbreidingstraat 390,2023-09-22,03:00:00,2,1,1,FMN 18 Binnensingel Westkant
665,Uitbreidingstraat 390,2023-09-22,04:00:00,10,5,5,FMN 18 Binnensingel Westkant
665,Uitbreidingstraat 390,2023-09-22,05:00:00,17,13,4,FMN 18 Binnensingel Westkant
665,Uitbreidingstraat 390,2023-09-22,06:00:00,39,29,10,FMN 18 Binnensingel Westkant
665,Uitbreidingstraat 390,2023-09-22,07:00:00,132,108,24,FMN 18 Binnensingel Westkant
665,Uitbreidingstraat 390,2023-09-22,08:00:00,281,240,41,FMN 18 Binnensingel Westkant
665,Uitbreidingstraat 390,2023-09-22,09:00:00,120,95,25,FMN 18 Binnensingel Westkant
665,Uitbreidingstraat 390,2023-09-22,10:00:00,54,39,15,FMN 18 Binnensingel Westkant
665,Uitbreidingstraat 390,2023-09-22,11:00:00,72,52,20,FMN 18 Binnensingel Westkant
665,Uitbreidingstraat 390,2023-09-22,12:00:00,125,84,41,FMN 18 Binnensingel Westkant
665,Uitbreidingstraat 390,2023-09-22,13:00:00,90,63,27,FMN 18 Binnensingel Westkant
665,Uitbreidingstraat 390,2023-09-22,14:00:00,79,46,33,FMN 18 Binnensingel Westkant
665,Uitbreidingstraat 390,2023-09-22,15:00:00,139,63,76,FMN 18 Binnensingel Westkant
665,Uitbreidingstraat 390,2023-09-22,16:00:00,231,100,131,FMN 18 Binnensingel Westkant
665,Uitbreidingstraat 390,2023-09-22,17:00:00,126,59,67,FMN 18 Binnensingel Westkant
665,Uitbreidingstraat 390,2023-09-22,18:00:00,103,68,35,FMN 18 Binnensingel Westkant
665,Uitbreidingstraat 390,2023-09-22,19:00:00,100,66,34,FMN 18 Binnensingel Westkant
665,Uitbreidingstraat 390,2023-09-22,20:00:00,61,43,18,FMN 18 Binnensingel Westkant
665,Uitbreidingstraat 390,2023-09-22,21:00:00,47,27,20,FMN 18 Binnensingel Westkant
665,Uitbreidingstraat 390,2023-09-22,22:00:00,38,28,10,FMN 18 Binnensingel Westkant
665,Uitbreidingstraat 390,2023-09-22,23:00:00,32,22,10,FMN 18 Binnensingel Westkant
665,Uitbreidingstraat 390,2023-09-23,00:00:00,43,27,16,FMN 18 Binnensingel Westkant
665,Uitbreidingstraat 390,2023-09-23,01:00:00,19,10,9,FMN 18 Binnensingel Westkant
665,Uitbreidingstraat 390,2023-09-23,02:00:00,8,7,1,FMN 18 Binnensingel Westkant
665,Uitbreidingstraat 390,2023-09-23,03:00:00,16,9,7,FMN 18 Binnensingel Westkant
665,Uitbreidingstraat 390,2023-09-23,04:00:00,7,5,2,FMN 18 Binnensingel Westkant
665,Uitbreidingstraat 390,2023-09-23,05:00:00,10,7,3,FMN 18 Binnensingel Westkant
665,Uitbreidingstraat 390,2023-09-23,06:00:00,28,24,4,FMN 18 Binnensingel Westkant
665,Uitbreidingstraat 390,2023-09-23,07:00:00,13,5,8,FMN 18 Binnensingel Westkant
665,Uitbreidingstraat 390,2023-09-23,08:00:00,43,30,13,FMN 18 Binnensingel Westkant
665,Uitbreidingstraat 390,2023-09-23,09:00:00,51,37,14,FMN 18 Binnensingel Westkant
665,Uitbreidingstraat 390,2023-09-23,10:00:00,94,67,27,FMN 18 Binnensingel Westkant
665,Uitbreidingstraat 390,2023-09-23,11:00:00,76,49,27,FMN 18 Binnensingel Westkant
665,Uitbreidingstraat 390,2023-09-23,12:00:00,89,51,38,FMN 18 Binnensingel Westkant
665,Uitbreidingstraat 390,2023-09-23,13:00:00,94,56,38,FMN 18 Binnensingel Westkant
665,Uitbreidingstraat 390,2023-09-23,14:00:00,86,55,31,FMN 18 Binnensingel Westkant
665,Uitbreidingstraat 390,2023-09-23,15:00:00,73,49,24,FMN 18 Binnensingel Westkant
665,Uitbreidingstraat 390,2023-09-23,16:00:00,85,52,33,FMN 18 Binnensingel Westkant
665,Uitbreidingstraat 390,2023-09-23,17:00:00,84,59,25,FMN 18 Binnensingel Westkant
665,Uitbreidingstraat 390,2023-09-23,18:00:00,103,74,29,FMN 18 Binnensingel Westkant
665,Uitbreidingstraat 390,2023-09-23,19:00:00,103,71,32,FMN 18 Binnensingel Westkant
665,Uitbreidingstraat 390,2023-09-23,20:00:00,71,51,20,FMN 18 Binnensingel Westkant
665,Uitbreidingstraat 390,2023-09-23,21:00:00,49,34,15,FMN 18 Binnensingel Westkant
665,Uitbreidingstraat 390,2023-09-23,22:00:00,55,41,14,FMN 18 Binnensingel Westkant
665,Uitbreidingstraat 390,2023-09-23,23:00:00,50,39,11,FMN 18 Binnensingel Westkant
665,Uitbreidingstraat 390,2023-09-24,00:00:00,42,28,14,FMN 18 Binnensingel Westkant
665,Uitbreidingstraat 390,2023-09-24,01:00:00,31,18,13,FMN 18 Binnensingel Westkant
665,Uitbreidingstraat 390,2023-09-24,02:00:00,17,12,5,FMN 18 Binnensingel Westkant
665,Uitbreidingstraat 390,2023-09-24,03:00:00,12,7,5,FMN 18 Binnensingel Westkant
665,Uitbreidingstraat 390,2023-09-24,04:00:00,11,9,2,FMN 18 Binnensingel Westkant
665,Uitbreidingstraat 390,2023-09-24,05:00:00,13,11,2,FMN 18 Binnensingel Westkant
665,Uitbreidingstraat 390,2023-09-24,06:00:00,33,24,9,FMN 18 Binnensingel Westkant
665,Uitbreidingstraat 390,2023-09-24,07:00:00,18,12,6,FMN 18 Binnensingel Westkant
665,Uitbreidingstraat 390,2023-09-24,08:00:00,21,12,9,FMN 18 Binnensingel Westkant
665,Uitbreidingstraat 390,2023-09-24,09:00:00,49,35,14,FMN 18 Binnensingel Westkant
665,Uitbreidingstraat 390,2023-09-24,10:00:00,59,44,15,FMN 18 Binnensingel Westkant
665,Uitbreidingstraat 390,2023-09-24,11:00:00,74,54,20,FMN 18 Binnensingel Westkant
665,Uitbreidingstraat 390,2023-09-24,12:00:00,94,59,35,FMN 18 Binnensingel Westkant
665,Uitbreidingstraat 390,2023-09-24,13:00:00,79,58,21,FMN 18 Binnensingel Westkant
665,Uitbreidingstraat 390,2023-09-24,14:00:00,84,60,24,FMN 18 Binnensingel Westkant
665,Uitbreidingstraat 390,2023-09-24,15:00:00,78,59,19,FMN 18 Binnensingel Westkant
665,Uitbreidingstraat 390,2023-09-24,16:00:00,78,56,22,FMN 18 Binnensingel Westkant
665,Uitbreidingstraat 390,2023-09-24,17:00:00,93,58,35,FMN 18 Binnensingel Westkant
665,Uitbreidingstraat 390,2023-09-24,18:00:00,100,71,29,FMN 18 Binnensingel Westkant
665,Uitbreidingstraat 390,2023-09-24,19:00:00,52,39,13,FMN 18 Binnensingel Westkant
665,Uitbreidingstraat 390,2023-09-24,20:00:00,52,37,15,FMN 18 Binnensingel Westkant
665,Uitbreidingstraat 390,2023-09-24,21:00:00,40,29,11,FMN 18 Binnensingel Westkant
665,Uitbreidingstraat 390,2023-09-24,22:00:00,28,23,5,FMN 18 Binnensingel Westkant
665,Uitbreidingstraat 390,2023-09-24,23:00:00,17,13,4,FMN 18 Binnensingel Westkant
665,Uitbreidingstraat 390,2023-09-25,00:00:00,15,10,5,FMN 18 Binnensingel Westkant
665,Uitbreidingstraat 390,2023-09-25,01:00:00,7,6,1,FMN 18 Binnensingel Westkant
665,Uitbreidingstraat 390,2023-09-25,02:00:00,0,0,0,FMN 18 Binnensingel Westkant
665,Uitbreidingstraat 390,2023-09-25,03:00:00,4,4,0,FMN 18 Binnensingel Westkant
665,Uitbreidingstraat 390,2023-09-25,04:00:00,7,4,3,FMN 18 Binnensingel Westkant
665,Uitbreidingstraat 390,2023-09-25,05:00:00,25,23,2,FMN 18 Binnensingel Westkant
665,Uitbreidingstraat 390,2023-09-25,06:00:00,55,42,13,FMN 18 Binnensingel Westkant
665,Uitbreidingstraat 390,2023-09-25,07:00:00,157,127,30,FMN 18 Binnensingel Westkant
665,Uitbreidingstraat 390,2023-09-25,08:00:00,334,273,61,FMN 18 Binnensingel Westkant
665,Uitbreidingstraat 390,2023-09-25,09:00:00,161,148,13,FMN 18 Binnensingel Westkant
665,Uitbreidingstraat 390,2023-09-25,10:00:00,111,99,12,FMN 18 Binnensingel Westkant
665,Uitbreidingstraat 390,2023-09-25,11:00:00,90,62,28,FMN 18 Binnensingel Westkant
665,Uitbreidingstraat 390,2023-09-25,12:00:00,130,86,44,FMN 18 Binnensingel Westkant
665,Uitbreidingstraat 390,2023-09-25,13:00:00,100,72,28,FMN 18 Binnensingel Westkant
665,Uitbreidingstraat 390,2023-09-25,14:00:00,96,65,31,FMN 18 Binnensingel Westkant
665,Uitbreidingstraat 390,2023-09-25,15:00:00,181,95,86,FMN 18 Binnensingel Westkant
665,Uitbreidingstraat 390,2023-09-25,16:00:00,296,130,166,FMN 18 Binnensingel Westkant
665,Uitbreidingstraat 390,2023-09-25,17:00:00,274,143,131,FMN 18 Binnensingel Westkant
665,Uitbreidingstraat 390,2023-09-25,18:00:00,204,143,61,FMN 18 Binnensingel Westkant
665,Uitbreidingstraat 390,2023-09-25,19:00:00,125,87,38,FMN 18 Binnensingel Westkant
665,Uitbreidingstraat 390,2023-09-25,20:00:00,76,47,29,FMN 18 Binnensingel Westkant
665,Uitbreidingstraat 390,2023-09-25,21:00:00,59,35,24,FMN 18 Binnensingel Westkant
665,Uitbreidingstraat 390,2023-09-25,22:00:00,52,35,17,FMN 18 Binnensingel Westkant
665,Uitbreidingstraat 390,2023-09-25,23:00:00,21,12,9,FMN 18 Binnensingel Westkant
665,Uitbreidingstraat 390,2023-09-26,00:00:00,11,7,4,FMN 18 Binnensingel Westkant
665,Uitbreidingstraat 390,2023-09-26,01:00:00,8,8,0,FMN 18 Binnensingel Westkant
665,Uitbreidingstraat 390,2023-09-26,02:00:00,2,2,0,FMN 18 Binnensingel Westkant
665,Uitbreidingstraat 390,2023-09-26,03:00:00,7,4,3,FMN 18 Binnensingel Westkant
665,Uitbreidingstraat 390,2023-09-26,04:00:00,10,5,5,FMN 18 Binnensingel Westkant
665,Uitbreidingstraat 390,2023-09-26,05:00:00,41,36,5,FMN 18 Binnensingel Westkant
665,Uitbreidingstraat 390,2023-09-26,06:00:00,66,46,20,FMN 18 Binnensingel Westkant
665,Uitbreidingstraat 390,2023-09-26,07:00:00,228,175,53,FMN 18 Binnensingel Westkant
665,Uitbreidingstraat 390,2023-09-26,08:00:00,435,362,73,FMN 18 Binnensingel Westkant
665,Uitbreidingstraat 390,2023-09-26,09:00:00,149,130,19,FMN 18 Binnensingel Westkant
665,Uitbreidingstraat 390,2023-09-26,10:00:00,100,80,20,FMN 18 Binnensingel Westkant
665,Uitbreidingstraat 390,2023-09-26,11:00:00,70,42,28,FMN 18 Binnensingel Westkant
665,Uitbreidingstraat 390,2023-09-26,12:00:00,133,88,45,FMN 18 Binnensingel Westkant
665,Uitbreidingstraat 390,2023-09-26,13:00:00,113,76,37,FMN 18 Binnensingel Westkant
665,Uitbreidingstraat 390,2023-09-26,14:00:00,118,85,33,FMN 18 Binnensingel Westkant
665,Uitbreidingstraat 390,2023-09-26,15:00:00,168,84,84,FMN 18 Binnensingel Westkant
665,Uitbreidingstraat 390,2023-09-26,16:00:00,301,125,176,FMN 18 Binnensingel Westkant
665,Uitbreidingstraat 390,2023-09-26,17:00:00,316,172,144,FMN 18 Binnensingel Westkant
665,Uitbreidingstraat 390,2023-09-26,18:00:00,228,137,91,FMN 18 Binnensingel Westkant
665,Uitbreidingstraat 390,2023-09-26,19:00:00,136,84,52,FMN 18 Binnensingel Westkant
665,Uitbreidingstraat 390,2023-09-26,20:00:00,71,38,33,FMN 18 Binnensingel Westkant
665,Uitbreidingstraat 390,2023-09-26,21:00:00,63,40,23,FMN 18 Binnensingel Westkant
665,Uitbreidingstraat 390,2023-09-26,22:00:00,70,51,19,FMN 18 Binnensingel Westkant
665,Uitbreidingstraat 390,2023-09-26,23:00:00,34,22,12,FMN 18 Binnensingel Westkant
665,Uitbreidingstraat 390,2023-09-27,00:00:00,12,8,4,FMN 18 Binnensingel Westkant
665,Uitbreidingstraat 390,2023-09-27,01:00:00,7,5,2,FMN 18 Binnensingel Westkant
665,Uitbreidingstraat 390,2023-09-27,02:00:00,1,1,0,FMN 18 Binnensingel Westkant
665,Uitbreidingstraat 390,2023-09-27,03:00:00,2,2,0,FMN 18 Binnensingel Westkant
665,Uitbreidingstraat 390,2023-09-27,04:00:00,9,5,4,FMN 18 Binnensingel Westkant
665,Uitbreidingstraat 390,2023-09-27,05:00:00,31,27,4,FMN 18 Binnensingel Westkant
665,Uitbreidingstraat 390,2023-09-27,06:00:00,71,50,21,FMN 18 Binnensingel Westkant
665,Uitbreidingstraat 390,2023-09-27,07:00:00,229,189,40,FMN 18 Binnensingel Westkant
665,Uitbreidingstraat 390,2023-09-27,08:00:00,359,298,61,FMN 18 Binnensingel Westkant
665,Uitbreidingstraat 390,2023-09-27,09:00:00,130,106,24,FMN 18 Binnensingel Westkant
665,Uitbreidingstraat 390,2023-09-27,10:00:00,105,82,23,FMN 18 Binnensingel Westkant
665,Uitbreidingstraat 390,2023-09-27,11:00:00,85,51,34,FMN 18 Binnensingel Westkant
665,Uitbreidingstraat 390,2023-09-27,12:00:00,173,83,90,FMN 18 Binnensingel Westkant
665,Uitbreidingstraat 390,2023-09-27,13:00:00,195,94,101,FMN 18 Binnensingel Westkant
665,Uitbreidingstraat 390,2023-09-27,14:00:00,115,81,34,FMN 18 Binnensingel Westkant
665,Uitbreidingstraat 390,2023-09-27,15:00:00,171,115,56,FMN 18 Binnensingel Westkant
665,Uitbreidingstraat 390,2023-09-27,16:00:00,242,125,117,FMN 18 Binnensingel Westkant
665,Uitbreidingstraat 390,2023-09-27,17:00:00,243,134,109,FMN 18 Binnensingel Westkant
665,Uitbreidingstraat 390,2023-09-27,18:00:00,227,143,84,FMN 18 Binnensingel Westkant
665,Uitbreidingstraat 390,2023-09-27,19:00:00,133,79,54,FMN 18 Binnensingel Westkant
665,Uitbreidingstraat 390,2023-09-27,20:00:00,79,51,28,FMN 18 Binnensingel Westkant
665,Uitbreidingstraat 390,2023-09-27,21:00:00,80,47,33,FMN 18 Binnensingel Westkant
665,Uitbreidingstraat 390,2023-09-27,22:00:00,67,39,28,FMN 18 Binnensingel Westkant
665,Uitbreidingstraat 390,2023-09-27,23:00:00,64,51,13,FMN 18 Binnensingel Westkant
