Meetpunt surrogate key,Meetpunt locatie,Datum,Tijd,Aantal fietsers,Aantal fietsers van,Aantal fietsers naar,Meetpunt code
676,Noorderlaan,2022-11-10,00:00:00,23,15,8,FMN 16 Noorderlaanbrug
676,Noorderlaan,2022-11-10,01:00:00,30,26,4,FMN 16 Noorderlaanbrug
676,Noorderlaan,2022-11-10,02:00:00,7,2,5,FMN 16 Noorderlaanbrug
676,Noorderlaan,2022-11-10,03:00:00,13,9,4,FMN 16 Noorderlaanbrug
676,Noorderlaan,2022-11-10,04:00:00,25,16,9,FMN 16 Noorderlaanbrug
676,Noorderlaan,2022-11-10,05:00:00,92,42,50,FMN 16 Noorderlaanbrug
676,Noorderlaan,2022-11-10,06:00:00,137,78,59,FMN 16 Noorderlaanbrug
676,Noorderlaan,2022-11-10,07:00:00,372,254,118,FMN 16 Noorderlaanbrug
676,Noorderlaan,2022-11-10,08:00:00,482,338,144,FMN 16 Noorderlaanbrug
676,Noorderlaan,2022-11-10,09:00:00,162,111,51,FMN 16 Noorderlaanbrug
676,Noorderlaan,2022-11-10,10:00:00,118,83,35,FMN 16 Noorderlaanbrug
676,Noorderlaan,2022-11-10,11:00:00,127,85,42,FMN 16 Noorderlaanbrug
676,Noorderlaan,2022-11-10,12:00:00,149,90,59,FMN 16 Noorderlaanbrug
676,Noorderlaan,2022-11-10,13:00:00,170,90,80,FMN 16 Noorderlaanbrug
676,Noorderlaan,2022-11-10,14:00:00,193,116,77,FMN 16 Noorderlaanbrug
676,Noorderlaan,2022-11-10,15:00:00,222,117,105,FMN 16 Noorderlaanbrug
676,Noorderlaan,2022-11-10,16:00:00,377,188,189,FMN 16 Noorderlaanbrug
676,Noorderlaan,2022-11-10,17:00:00,372,169,203,FMN 16 Noorderlaanbrug
676,Noorderlaan,2022-11-10,18:00:00,220,117,103,FMN 16 Noorderlaanbrug
676,Noorderlaan,2022-11-10,19:00:00,122,60,62,FMN 16 Noorderlaanbrug
676,Noorderlaan,2022-11-10,20:00:00,94,52,42,FMN 16 Noorderlaanbrug
676,Noorderlaan,2022-11-10,21:00:00,70,20,50,FMN 16 Noorderlaanbrug
676,Noorderlaan,2022-11-10,22:00:00,96,52,44,FMN 16 Noorderlaanbrug
676,Noorderlaan,2022-11-10,23:00:00,64,30,34,FMN 16 Noorderlaanbrug
676,Noorderlaan,2022-11-11,00:00:00,50,28,22,FMN 16 Noorderlaanbrug
676,Noorderlaan,2022-11-11,01:00:00,38,15,23,FMN 16 Noorderlaanbrug
676,Noorderlaan,2022-11-11,02:00:00,26,17,9,FMN 16 Noorderlaanbrug
676,Noorderlaan,2022-11-11,03:00:00,25,10,15,FMN 16 Noorderlaanbrug
676,Noorderlaan,2022-11-11,04:00:00,30,19,11,FMN 16 Noorderlaanbrug
676,Noorderlaan,2022-11-11,05:00:00,35,14,21,FMN 16 Noorderlaanbrug
676,Noorderlaan,2022-11-11,06:00:00,31,20,11,FMN 16 Noorderlaanbrug
676,Noorderlaan,2022-11-11,07:00:00,34,18,16,FMN 16 Noorderlaanbrug
676,Noorderlaan,2022-11-11,08:00:00,29,19,10,FMN 16 Noorderlaanbrug
676,Noorderlaan,2022-11-11,09:00:00,44,35,9,FMN 16 Noorderlaanbrug
676,Noorderlaan,2022-11-11,10:00:00,58,40,18,FMN 16 Noorderlaanbrug
676,Noorderlaan,2022-11-11,11:00:00,68,46,22,FMN 16 Noorderlaanbrug
676,Noorderlaan,2022-11-11,12:00:00,65,40,25,FMN 16 Noorderlaanbrug
676,Noorderlaan,2022-11-11,13:00:00,99,67,32,FMN 16 Noorderlaanbrug
676,Noorderlaan,2022-11-11,14:00:00,98,59,39,FMN 16 Noorderlaanbrug
676,Noorderlaan,2022-11-11,15:00:00,113,57,56,FMN 16 Noorderlaanbrug
676,Noorderlaan,2022-11-11,16:00:00,108,51,57,FMN 16 Noorderlaanbrug
676,Noorderlaan,2022-11-11,17:00:00,102,56,46,FMN 16 Noorderlaanbrug
676,Noorderlaan,2022-11-11,18:00:00,75,41,34,FMN 16 Noorderlaanbrug
676,Noorderlaan,2022-11-11,19:00:00,65,39,26,FMN 16 Noorderlaanbrug
676,Noorderlaan,2022-11-11,20:00:00,57,30,27,FMN 16 Noorderlaanbrug
676,Noorderlaan,2022-11-11,21:00:00,59,32,27,FMN 16 Noorderlaanbrug
676,Noorderlaan,2022-11-11,22:00:00,50,31,19,FMN 16 Noorderlaanbrug
676,Noorderlaan,2022-11-11,23:00:00,46,22,24,FMN 16 Noorderlaanbrug
676,Noorderlaan,2022-11-12,00:00:00,51,29,22,FMN 16 Noorderlaanbrug
676,Noorderlaan,2022-11-12,01:00:00,40,20,20,FMN 16 Noorderlaanbrug
676,Noorderlaan,2022-11-12,02:00:00,16,6,10,FMN 16 Noorderlaanbrug
676,Noorderlaan,2022-11-12,03:00:00,18,10,8,FMN 16 Noorderlaanbrug
676,Noorderlaan,2022-11-12,04:00:00,21,13,8,FMN 16 Noorderlaanbrug
676,Noorderlaan,2022-11-12,05:00:00,37,11,26,FMN 16 Noorderlaanbrug
676,Noorderlaan,2022-11-12,06:00:00,40,17,23,FMN 16 Noorderlaanbrug
676,Noorderlaan,2022-11-12,07:00:00,30,17,13,FMN 16 Noorderlaanbrug
676,Noorderlaan,2022-11-12,08:00:00,37,25,12,FMN 16 Noorderlaanbrug
676,Noorderlaan,2022-11-12,09:00:00,79,60,19,FMN 16 Noorderlaanbrug
676,Noorderlaan,2022-11-12,10:00:00,85,73,12,FMN 16 Noorderlaanbrug
676,Noorderlaan,2022-11-12,11:00:00,136,87,49,FMN 16 Noorderlaanbrug
676,Noorderlaan,2022-11-12,12:00:00,151,105,46,FMN 16 Noorderlaanbrug
676,Noorderlaan,2022-11-12,13:00:00,189,141,48,FMN 16 Noorderlaanbrug
676,Noorderlaan,2022-11-12,14:00:00,190,137,53,FMN 16 Noorderlaanbrug
676,Noorderlaan,2022-11-12,15:00:00,203,89,114,FMN 16 Noorderlaanbrug
676,Noorderlaan,2022-11-12,16:00:00,182,93,89,FMN 16 Noorderlaanbrug
676,Noorderlaan,2022-11-12,17:00:00,158,93,65,FMN 16 Noorderlaanbrug
676,Noorderlaan,2022-11-12,18:00:00,117,56,61,FMN 16 Noorderlaanbrug
676,Noorderlaan,2022-11-12,19:00:00,112,45,67,FMN 16 Noorderlaanbrug
676,Noorderlaan,2022-11-12,20:00:00,76,44,32,FMN 16 Noorderlaanbrug
676,Noorderlaan,2022-11-12,21:00:00,53,20,33,FMN 16 Noorderlaanbrug
676,Noorderlaan,2022-11-12,22:00:00,61,41,20,FMN 16 Noorderlaanbrug
676,Noorderlaan,2022-11-12,23:00:00,54,30,24,FMN 16 Noorderlaanbrug
676,Noorderlaan,2022-11-13,00:00:00,29,18,11,FMN 16 Noorderlaanbrug
676,Noorderlaan,2022-11-13,01:00:00,37,14,23,FMN 16 Noorderlaanbrug
676,Noorderlaan,2022-11-13,02:00:00,18,11,7,FMN 16 Noorderlaanbrug
676,Noorderlaan,2022-11-13,03:00:00,20,9,11,FMN 16 Noorderlaanbrug
676,Noorderlaan,2022-11-13,04:00:00,18,11,7,FMN 16 Noorderlaanbrug
676,Noorderlaan,2022-11-13,05:00:00,21,7,14,FMN 16 Noorderlaanbrug
676,Noorderlaan,2022-11-13,06:00:00,27,14,13,FMN 16 Noorderlaanbrug
676,Noorderlaan,2022-11-13,07:00:00,21,13,8,FMN 16 Noorderlaanbrug
676,Noorderlaan,2022-11-13,08:00:00,27,17,10,FMN 16 Noorderlaanbrug
676,Noorderlaan,2022-11-13,09:00:00,57,39,18,FMN 16 Noorderlaanbrug
676,Noorderlaan,2022-11-13,10:00:00,74,51,23,FMN 16 Noorderlaanbrug
676,Noorderlaan,2022-11-13,11:00:00,85,58,27,FMN 16 Noorderlaanbrug
676,Noorderlaan,2022-11-13,12:00:00,79,53,26,FMN 16 Noorderlaanbrug
676,Noorderlaan,2022-11-13,13:00:00,100,59,41,FMN 16 Noorderlaanbrug
676,Noorderlaan,2022-11-13,14:00:00,120,85,35,FMN 16 Noorderlaanbrug
676,Noorderlaan,2022-11-13,15:00:00,127,71,56,FMN 16 Noorderlaanbrug
676,Noorderlaan,2022-11-13,16:00:00,119,50,69,FMN 16 Noorderlaanbrug
676,Noorderlaan,2022-11-13,17:00:00,80,30,50,FMN 16 Noorderlaanbrug
676,Noorderlaan,2022-11-13,18:00:00,81,38,43,FMN 16 Noorderlaanbrug
676,Noorderlaan,2022-11-13,19:00:00,55,23,32,FMN 16 Noorderlaanbrug
676,Noorderlaan,2022-11-13,20:00:00,38,19,19,FMN 16 Noorderlaanbrug
676,Noorderlaan,2022-11-13,21:00:00,45,29,16,FMN 16 Noorderlaanbrug
676,Noorderlaan,2022-11-13,22:00:00,21,7,14,FMN 16 Noorderlaanbrug
676,Noorderlaan,2022-11-13,23:00:00,26,17,9,FMN 16 Noorderlaanbrug
676,Noorderlaan,2022-11-14,00:00:00,8,5,3,FMN 16 Noorderlaanbrug
676,Noorderlaan,2022-11-14,01:00:00,8,3,5,FMN 16 Noorderlaanbrug
676,Noorderlaan,2022-11-14,02:00:00,4,3,1,FMN 16 Noorderlaanbrug
676,Noorderlaan,2022-11-14,03:00:00,10,6,4,FMN 16 Noorderlaanbrug
676,Noorderlaan,2022-11-14,04:00:00,22,11,11,FMN 16 Noorderlaanbrug
676,Noorderlaan,2022-11-14,05:00:00,80,32,48,FMN 16 Noorderlaanbrug
676,Noorderlaan,2022-11-14,06:00:00,150,84,66,FMN 16 Noorderlaanbrug
676,Noorderlaan,2022-11-14,07:00:00,316,215,101,FMN 16 Noorderlaanbrug
676,Noorderlaan,2022-11-14,08:00:00,460,317,143,FMN 16 Noorderlaanbrug
676,Noorderlaan,2022-11-14,09:00:00,143,105,38,FMN 16 Noorderlaanbrug
676,Noorderlaan,2022-11-14,10:00:00,117,81,36,FMN 16 Noorderlaanbrug
676,Noorderlaan,2022-11-14,11:00:00,97,62,35,FMN 16 Noorderlaanbrug
676,Noorderlaan,2022-11-14,12:00:00,164,92,72,FMN 16 Noorderlaanbrug
676,Noorderlaan,2022-11-14,13:00:00,192,79,113,FMN 16 Noorderlaanbrug
676,Noorderlaan,2022-11-14,14:00:00,154,93,61,FMN 16 Noorderlaanbrug
676,Noorderlaan,2022-11-14,15:00:00,248,139,109,FMN 16 Noorderlaanbrug
676,Noorderlaan,2022-11-14,16:00:00,368,180,188,FMN 16 Noorderlaanbrug
676,Noorderlaan,2022-11-14,17:00:00,418,184,234,FMN 16 Noorderlaanbrug
676,Noorderlaan,2022-11-14,18:00:00,200,90,110,FMN 16 Noorderlaanbrug
676,Noorderlaan,2022-11-14,19:00:00,74,42,32,FMN 16 Noorderlaanbrug
676,Noorderlaan,2022-11-14,20:00:00,63,30,33,FMN 16 Noorderlaanbrug
676,Noorderlaan,2022-11-14,21:00:00,62,30,32,FMN 16 Noorderlaanbrug
676,Noorderlaan,2022-11-14,22:00:00,72,43,29,FMN 16 Noorderlaanbrug
676,Noorderlaan,2022-11-14,23:00:00,41,22,19,FMN 16 Noorderlaanbrug
676,Noorderlaan,2022-11-15,00:00:00,14,6,8,FMN 16 Noorderlaanbrug
676,Noorderlaan,2022-11-15,01:00:00,1,1,0,FMN 16 Noorderlaanbrug
676,Noorderlaan,2022-11-15,02:00:00,5,2,3,FMN 16 Noorderlaanbrug
676,Noorderlaan,2022-11-15,03:00:00,7,7,0,FMN 16 Noorderlaanbrug
676,Noorderlaan,2022-11-15,04:00:00,25,17,8,FMN 16 Noorderlaanbrug
676,Noorderlaan,2022-11-15,05:00:00,79,35,44,FMN 16 Noorderlaanbrug
676,Noorderlaan,2022-11-15,06:00:00,147,78,69,FMN 16 Noorderlaanbrug
676,Noorderlaan,2022-11-15,07:00:00,361,257,104,FMN 16 Noorderlaanbrug
676,Noorderlaan,2022-11-15,08:00:00,482,371,111,FMN 16 Noorderlaanbrug
676,Noorderlaan,2022-11-15,09:00:00,158,113,45,FMN 16 Noorderlaanbrug
676,Noorderlaan,2022-11-15,10:00:00,113,79,34,FMN 16 Noorderlaanbrug
676,Noorderlaan,2022-11-15,11:00:00,118,78,40,FMN 16 Noorderlaanbrug
676,Noorderlaan,2022-11-15,12:00:00,140,86,54,FMN 16 Noorderlaanbrug
676,Noorderlaan,2022-11-15,13:00:00,159,75,84,FMN 16 Noorderlaanbrug
676,Noorderlaan,2022-11-15,14:00:00,123,75,48,FMN 16 Noorderlaanbrug
676,Noorderlaan,2022-11-15,15:00:00,219,107,112,FMN 16 Noorderlaanbrug
676,Noorderlaan,2022-11-15,16:00:00,363,190,173,FMN 16 Noorderlaanbrug
676,Noorderlaan,2022-11-15,17:00:00,353,152,201,FMN 16 Noorderlaanbrug
676,Noorderlaan,2022-11-15,18:00:00,179,78,101,FMN 16 Noorderlaanbrug
676,Noorderlaan,2022-11-15,19:00:00,77,45,32,FMN 16 Noorderlaanbrug
676,Noorderlaan,2022-11-15,20:00:00,42,21,21,FMN 16 Noorderlaanbrug
676,Noorderlaan,2022-11-15,21:00:00,48,27,21,FMN 16 Noorderlaanbrug
676,Noorderlaan,2022-11-15,22:00:00,77,40,37,FMN 16 Noorderlaanbrug
676,Noorderlaan,2022-11-15,23:00:00,32,20,12,FMN 16 Noorderlaanbrug
676,Noorderlaan,2022-11-16,00:00:00,14,5,9,FMN 16 Noorderlaanbrug
676,Noorderlaan,2022-11-16,01:00:00,8,3,5,FMN 16 Noorderlaanbrug
676,Noorderlaan,2022-11-16,02:00:00,6,3,3,FMN 16 Noorderlaanbrug
676,Noorderlaan,2022-11-16,03:00:00,14,8,6,FMN 16 Noorderlaanbrug
676,Noorderlaan,2022-11-16,04:00:00,26,17,9,FMN 16 Noorderlaanbrug
676,Noorderlaan,2022-11-16,05:00:00,87,34,53,FMN 16 Noorderlaanbrug
676,Noorderlaan,2022-11-16,06:00:00,127,70,57,FMN 16 Noorderlaanbrug
676,Noorderlaan,2022-11-16,07:00:00,322,205,117,FMN 16 Noorderlaanbrug
676,Noorderlaan,2022-11-16,08:00:00,378,261,117,FMN 16 Noorderlaanbrug
676,Noorderlaan,2022-11-16,09:00:00,120,93,27,FMN 16 Noorderlaanbrug
676,Noorderlaan,2022-11-16,10:00:00,101,68,33,FMN 16 Noorderlaanbrug
676,Noorderlaan,2022-11-16,11:00:00,97,55,42,FMN 16 Noorderlaanbrug
676,Noorderlaan,2022-11-16,12:00:00,221,112,109,FMN 16 Noorderlaanbrug
676,Noorderlaan,2022-11-16,13:00:00,183,97,86,FMN 16 Noorderlaanbrug
676,Noorderlaan,2022-11-16,14:00:00,173,107,66,FMN 16 Noorderlaanbrug
676,Noorderlaan,2022-11-16,15:00:00,218,143,75,FMN 16 Noorderlaanbrug
676,Noorderlaan,2022-11-16,16:00:00,287,162,125,FMN 16 Noorderlaanbrug
676,Noorderlaan,2022-11-16,17:00:00,331,171,160,FMN 16 Noorderlaanbrug
676,Noorderlaan,2022-11-16,18:00:00,182,92,90,FMN 16 Noorderlaanbrug
676,Noorderlaan,2022-11-16,19:00:00,146,63,83,FMN 16 Noorderlaanbrug
676,Noorderlaan,2022-11-16,20:00:00,66,35,31,FMN 16 Noorderlaanbrug
676,Noorderlaan,2022-11-16,21:00:00,57,28,29,FMN 16 Noorderlaanbrug
676,Noorderlaan,2022-11-16,22:00:00,73,38,35,FMN 16 Noorderlaanbrug
676,Noorderlaan,2022-11-16,23:00:00,38,17,21,FMN 16 Noorderlaanbrug
676,Noorderlaan,2022-11-17,00:00:00,46,9,37,FMN 16 Noorderlaanbrug
676,Noorderlaan,2022-11-17,01:00:00,24,11,13,FMN 16 Noorderlaanbrug
676,Noorderlaan,2022-11-17,02:00:00,35,30,5,FMN 16 Noorderlaanbrug
676,Noorderlaan,2022-11-17,03:00:00,45,41,4,FMN 16 Noorderlaanbrug
676,Noorderlaan,2022-11-17,04:00:00,52,41,11,FMN 16 Noorderlaanbrug
676,Noorderlaan,2022-11-17,05:00:00,77,37,40,FMN 16 Noorderlaanbrug
676,Noorderlaan,2022-11-17,06:00:00,112,60,52,FMN 16 Noorderlaanbrug
676,Noorderlaan,2022-11-17,07:00:00,277,173,104,FMN 16 Noorderlaanbrug
676,Noorderlaan,2022-11-17,08:00:00,344,249,95,FMN 16 Noorderlaanbrug
676,Noorderlaan,2022-11-17,09:00:00,111,84,27,FMN 16 Noorderlaanbrug
676,Noorderlaan,2022-11-17,10:00:00,67,30,37,FMN 16 Noorderlaanbrug
676,Noorderlaan,2022-11-17,11:00:00,64,39,25,FMN 16 Noorderlaanbrug
676,Noorderlaan,2022-11-17,12:00:00,108,68,40,FMN 16 Noorderlaanbrug
676,Noorderlaan,2022-11-17,13:00:00,116,56,60,FMN 16 Noorderlaanbrug
676,Noorderlaan,2022-11-17,14:00:00,131,72,59,FMN 16 Noorderlaanbrug
676,Noorderlaan,2022-11-17,15:00:00,170,93,77,FMN 16 Noorderlaanbrug
676,Noorderlaan,2022-11-17,16:00:00,291,156,135,FMN 16 Noorderlaanbrug
676,Noorderlaan,2022-11-17,17:00:00,311,154,157,FMN 16 Noorderlaanbrug
676,Noorderlaan,2022-11-17,18:00:00,158,80,78,FMN 16 Noorderlaanbrug
676,Noorderlaan,2022-11-17,19:00:00,108,54,54,FMN 16 Noorderlaanbrug
676,Noorderlaan,2022-11-17,20:00:00,60,27,33,FMN 16 Noorderlaanbrug
676,Noorderlaan,2022-11-17,21:00:00,76,33,43,FMN 16 Noorderlaanbrug
676,Noorderlaan,2022-11-17,22:00:00,70,43,27,FMN 16 Noorderlaanbrug
676,Noorderlaan,2022-11-17,23:00:00,46,23,23,FMN 16 Noorderlaanbrug
676,Noorderlaan,2022-11-18,00:00:00,27,13,14,FMN 16 Noorderlaanbrug
676,Noorderlaan,2022-11-18,01:00:00,7,0,7,FMN 16 Noorderlaanbrug
676,Noorderlaan,2022-11-18,02:00:00,7,1,6,FMN 16 Noorderlaanbrug
676,Noorderlaan,2022-11-18,03:00:00,10,9,1,FMN 16 Noorderlaanbrug
676,Noorderlaan,2022-11-18,04:00:00,23,13,10,FMN 16 Noorderlaanbrug
676,Noorderlaan,2022-11-18,05:00:00,79,35,44,FMN 16 Noorderlaanbrug
676,Noorderlaan,2022-11-18,06:00:00,103,49,54,FMN 16 Noorderlaanbrug
676,Noorderlaan,2022-11-18,07:00:00,301,191,110,FMN 16 Noorderlaanbrug
676,Noorderlaan,2022-11-18,08:00:00,392,274,118,FMN 16 Noorderlaanbrug
676,Noorderlaan,2022-11-18,09:00:00,114,78,36,FMN 16 Noorderlaanbrug
676,Noorderlaan,2022-11-18,10:00:00,88,53,35,FMN 16 Noorderlaanbrug
676,Noorderlaan,2022-11-18,11:00:00,94,55,39,FMN 16 Noorderlaanbrug
676,Noorderlaan,2022-11-18,12:00:00,114,57,57,FMN 16 Noorderlaanbrug
676,Noorderlaan,2022-11-18,13:00:00,129,62,67,FMN 16 Noorderlaanbrug
676,Noorderlaan,2022-11-18,14:00:00,135,76,59,FMN 16 Noorderlaanbrug
676,Noorderlaan,2022-11-18,15:00:00,194,87,107,FMN 16 Noorderlaanbrug
676,Noorderlaan,2022-11-18,16:00:00,328,166,162,FMN 16 Noorderlaanbrug
676,Noorderlaan,2022-11-18,17:00:00,216,102,114,FMN 16 Noorderlaanbrug
676,Noorderlaan,2022-11-18,18:00:00,136,77,59,FMN 16 Noorderlaanbrug
676,Noorderlaan,2022-11-18,19:00:00,73,36,37,FMN 16 Noorderlaanbrug
676,Noorderlaan,2022-11-18,20:00:00,52,28,24,FMN 16 Noorderlaanbrug
676,Noorderlaan,2022-11-18,21:00:00,42,21,21,FMN 16 Noorderlaanbrug
676,Noorderlaan,2022-11-18,22:00:00,57,32,25,FMN 16 Noorderlaanbrug
676,Noorderlaan,2022-11-18,23:00:00,45,17,28,FMN 16 Noorderlaanbrug
676,Noorderlaan,2022-11-19,00:00:00,41,13,28,FMN 16 Noorderlaanbrug
676,Noorderlaan,2022-11-19,01:00:00,47,21,26,FMN 16 Noorderlaanbrug
676,Noorderlaan,2022-11-19,02:00:00,13,7,6,FMN 16 Noorderlaanbrug
676,Noorderlaan,2022-11-19,03:00:00,23,13,10,FMN 16 Noorderlaanbrug
676,Noorderlaan,2022-11-19,04:00:00,13,10,3,FMN 16 Noorderlaanbrug
676,Noorderlaan,2022-11-19,05:00:00,22,11,11,FMN 16 Noorderlaanbrug
676,Noorderlaan,2022-11-19,06:00:00,26,15,11,FMN 16 Noorderlaanbrug
676,Noorderlaan,2022-11-19,07:00:00,26,16,10,FMN 16 Noorderlaanbrug
676,Noorderlaan,2022-11-19,08:00:00,29,20,9,FMN 16 Noorderlaanbrug
676,Noorderlaan,2022-11-19,09:00:00,41,30,11,FMN 16 Noorderlaanbrug
676,Noorderlaan,2022-11-19,10:00:00,34,19,15,FMN 16 Noorderlaanbrug
676,Noorderlaan,2022-11-19,11:00:00,45,26,19,FMN 16 Noorderlaanbrug
676,Noorderlaan,2022-11-19,12:00:00,74,46,28,FMN 16 Noorderlaanbrug
676,Noorderlaan,2022-11-19,13:00:00,81,49,32,FMN 16 Noorderlaanbrug
676,Noorderlaan,2022-11-19,14:00:00,84,48,36,FMN 16 Noorderlaanbrug
676,Noorderlaan,2022-11-19,15:00:00,90,51,39,FMN 16 Noorderlaanbrug
676,Noorderlaan,2022-11-19,16:00:00,76,46,30,FMN 16 Noorderlaanbrug
676,Noorderlaan,2022-11-19,17:00:00,71,36,35,FMN 16 Noorderlaanbrug
676,Noorderlaan,2022-11-19,18:00:00,85,41,44,FMN 16 Noorderlaanbrug
676,Noorderlaan,2022-11-19,19:00:00,62,31,31,FMN 16 Noorderlaanbrug
676,Noorderlaan,2022-11-19,20:00:00,32,23,9,FMN 16 Noorderlaanbrug
676,Noorderlaan,2022-11-19,21:00:00,16,7,9,FMN 16 Noorderlaanbrug
676,Noorderlaan,2022-11-19,22:00:00,36,15,21,FMN 16 Noorderlaanbrug
676,Noorderlaan,2022-11-19,23:00:00,34,21,13,FMN 16 Noorderlaanbrug
676,Noorderlaan,2022-11-20,00:00:00,43,24,19,FMN 16 Noorderlaanbrug
676,Noorderlaan,2022-11-20,01:00:00,33,13,20,FMN 16 Noorderlaanbrug
676,Noorderlaan,2022-11-20,02:00:00,13,4,9,FMN 16 Noorderlaanbrug
676,Noorderlaan,2022-11-20,03:00:00,17,6,11,FMN 16 Noorderlaanbrug
676,Noorderlaan,2022-11-20,04:00:00,14,8,6,FMN 16 Noorderlaanbrug
676,Noorderlaan,2022-11-20,05:00:00,27,13,14,FMN 16 Noorderlaanbrug
676,Noorderlaan,2022-11-20,06:00:00,25,12,13,FMN 16 Noorderlaanbrug
676,Noorderlaan,2022-11-20,07:00:00,19,10,9,FMN 16 Noorderlaanbrug
676,Noorderlaan,2022-11-20,08:00:00,26,20,6,FMN 16 Noorderlaanbrug
676,Noorderlaan,2022-11-20,09:00:00,29,22,7,FMN 16 Noorderlaanbrug
676,Noorderlaan,2022-11-20,10:00:00,26,19,7,FMN 16 Noorderlaanbrug
676,Noorderlaan,2022-11-20,11:00:00,34,14,20,FMN 16 Noorderlaanbrug
676,Noorderlaan,2022-11-20,12:00:00,41,19,22,FMN 16 Noorderlaanbrug
676,Noorderlaan,2022-11-20,13:00:00,47,24,23,FMN 16 Noorderlaanbrug
676,Noorderlaan,2022-11-20,14:00:00,35,19,16,FMN 16 Noorderlaanbrug
676,Noorderlaan,2022-11-20,15:00:00,40,21,19,FMN 16 Noorderlaanbrug
676,Noorderlaan,2022-11-20,16:00:00,36,21,15,FMN 16 Noorderlaanbrug
676,Noorderlaan,2022-11-20,17:00:00,28,15,13,FMN 16 Noorderlaanbrug
676,Noorderlaan,2022-11-20,18:00:00,42,27,15,FMN 16 Noorderlaanbrug
676,Noorderlaan,2022-11-20,19:00:00,42,23,19,FMN 16 Noorderlaanbrug
676,Noorderlaan,2022-11-20,20:00:00,22,12,10,FMN 16 Noorderlaanbrug
676,Noorderlaan,2022-11-20,21:00:00,24,9,15,FMN 16 Noorderlaanbrug
676,Noorderlaan,2022-11-20,22:00:00,27,12,15,FMN 16 Noorderlaanbrug
676,Noorderlaan,2022-11-20,23:00:00,24,9,15,FMN 16 Noorderlaanbrug
676,Noorderlaan,2022-11-21,00:00:00,7,4,3,FMN 16 Noorderlaanbrug
676,Noorderlaan,2022-11-21,01:00:00,7,1,6,FMN 16 Noorderlaanbrug
676,Noorderlaan,2022-11-21,02:00:00,2,1,1,FMN 16 Noorderlaanbrug
676,Noorderlaan,2022-11-21,03:00:00,7,7,0,FMN 16 Noorderlaanbrug
676,Noorderlaan,2022-11-21,04:00:00,27,14,13,FMN 16 Noorderlaanbrug
676,Noorderlaan,2022-11-21,05:00:00,75,33,42,FMN 16 Noorderlaanbrug
676,Noorderlaan,2022-11-21,06:00:00,121,60,61,FMN 16 Noorderlaanbrug
676,Noorderlaan,2022-11-21,07:00:00,272,178,94,FMN 16 Noorderlaanbrug
676,Noorderlaan,2022-11-21,08:00:00,380,275,105,FMN 16 Noorderlaanbrug
676,Noorderlaan,2022-11-21,09:00:00,107,73,34,FMN 16 Noorderlaanbrug
676,Noorderlaan,2022-11-21,10:00:00,93,58,35,FMN 16 Noorderlaanbrug
676,Noorderlaan,2022-11-21,11:00:00,87,54,33,FMN 16 Noorderlaanbrug
676,Noorderlaan,2022-11-21,12:00:00,119,67,52,FMN 16 Noorderlaanbrug
676,Noorderlaan,2022-11-21,13:00:00,112,49,63,FMN 16 Noorderlaanbrug
676,Noorderlaan,2022-11-21,14:00:00,120,69,51,FMN 16 Noorderlaanbrug
676,Noorderlaan,2022-11-21,15:00:00,209,109,100,FMN 16 Noorderlaanbrug
676,Noorderlaan,2022-11-21,16:00:00,326,156,170,FMN 16 Noorderlaanbrug
676,Noorderlaan,2022-11-21,17:00:00,311,161,150,FMN 16 Noorderlaanbrug
676,Noorderlaan,2022-11-21,18:00:00,131,47,84,FMN 16 Noorderlaanbrug
676,Noorderlaan,2022-11-21,19:00:00,60,36,24,FMN 16 Noorderlaanbrug
676,Noorderlaan,2022-11-21,20:00:00,44,27,17,FMN 16 Noorderlaanbrug
676,Noorderlaan,2022-11-21,21:00:00,42,16,26,FMN 16 Noorderlaanbrug
676,Noorderlaan,2022-11-21,22:00:00,54,31,23,FMN 16 Noorderlaanbrug
676,Noorderlaan,2022-11-21,23:00:00,16,12,4,FMN 16 Noorderlaanbrug
676,Noorderlaan,2022-11-22,00:00:00,8,5,3,FMN 16 Noorderlaanbrug
676,Noorderlaan,2022-11-22,01:00:00,12,7,5,FMN 16 Noorderlaanbrug
676,Noorderlaan,2022-11-22,02:00:00,1,1,0,FMN 16 Noorderlaanbrug
676,Noorderlaan,2022-11-22,03:00:00,9,8,1,FMN 16 Noorderlaanbrug
676,Noorderlaan,2022-11-22,04:00:00,29,18,11,FMN 16 Noorderlaanbrug
676,Noorderlaan,2022-11-22,05:00:00,69,28,41,FMN 16 Noorderlaanbrug
676,Noorderlaan,2022-11-22,06:00:00,125,65,60,FMN 16 Noorderlaanbrug
676,Noorderlaan,2022-11-22,07:00:00,308,208,100,FMN 16 Noorderlaanbrug
676,Noorderlaan,2022-11-22,08:00:00,361,275,86,FMN 16 Noorderlaanbrug
676,Noorderlaan,2022-11-22,09:00:00,121,94,27,FMN 16 Noorderlaanbrug
676,Noorderlaan,2022-11-22,10:00:00,86,59,27,FMN 16 Noorderlaanbrug
676,Noorderlaan,2022-11-22,11:00:00,53,30,23,FMN 16 Noorderlaanbrug
676,Noorderlaan,2022-11-22,12:00:00,119,65,54,FMN 16 Noorderlaanbrug
676,Noorderlaan,2022-11-22,13:00:00,88,44,44,FMN 16 Noorderlaanbrug
676,Noorderlaan,2022-11-22,14:00:00,109,67,42,FMN 16 Noorderlaanbrug
676,Noorderlaan,2022-11-22,15:00:00,187,91,96,FMN 16 Noorderlaanbrug
676,Noorderlaan,2022-11-22,16:00:00,336,172,164,FMN 16 Noorderlaanbrug
676,Noorderlaan,2022-11-22,17:00:00,346,172,174,FMN 16 Noorderlaanbrug
676,Noorderlaan,2022-11-22,18:00:00,175,82,93,FMN 16 Noorderlaanbrug
676,Noorderlaan,2022-11-22,19:00:00,107,58,49,FMN 16 Noorderlaanbrug
676,Noorderlaan,2022-11-22,20:00:00,54,33,21,FMN 16 Noorderlaanbrug
676,Noorderlaan,2022-11-22,21:00:00,46,23,23,FMN 16 Noorderlaanbrug
676,Noorderlaan,2022-11-22,22:00:00,67,46,21,FMN 16 Noorderlaanbrug
676,Noorderlaan,2022-11-22,23:00:00,17,10,7,FMN 16 Noorderlaanbrug
676,Noorderlaan,2022-11-23,00:00:00,13,4,9,FMN 16 Noorderlaanbrug
676,Noorderlaan,2022-11-23,01:00:00,7,3,4,FMN 16 Noorderlaanbrug
676,Noorderlaan,2022-11-23,02:00:00,11,5,6,FMN 16 Noorderlaanbrug
676,Noorderlaan,2022-11-23,03:00:00,13,11,2,FMN 16 Noorderlaanbrug
676,Noorderlaan,2022-11-23,04:00:00,23,13,10,FMN 16 Noorderlaanbrug
676,Noorderlaan,2022-11-23,05:00:00,87,25,62,FMN 16 Noorderlaanbrug
676,Noorderlaan,2022-11-23,06:00:00,88,39,49,FMN 16 Noorderlaanbrug
676,Noorderlaan,2022-11-23,07:00:00,266,159,107,FMN 16 Noorderlaanbrug
676,Noorderlaan,2022-11-23,08:00:00,336,225,111,FMN 16 Noorderlaanbrug
676,Noorderlaan,2022-11-23,09:00:00,117,74,43,FMN 16 Noorderlaanbrug
676,Noorderlaan,2022-11-23,10:00:00,99,68,31,FMN 16 Noorderlaanbrug
676,Noorderlaan,2022-11-23,11:00:00,86,43,43,FMN 16 Noorderlaanbrug
676,Noorderlaan,2022-11-23,12:00:00,178,83,95,FMN 16 Noorderlaanbrug
676,Noorderlaan,2022-11-23,13:00:00,142,77,65,FMN 16 Noorderlaanbrug
676,Noorderlaan,2022-11-23,14:00:00,99,65,34,FMN 16 Noorderlaanbrug
676,Noorderlaan,2022-11-23,15:00:00,122,66,56,FMN 16 Noorderlaanbrug
676,Noorderlaan,2022-11-23,16:00:00,231,132,99,FMN 16 Noorderlaanbrug
676,Noorderlaan,2022-11-23,17:00:00,267,141,126,FMN 16 Noorderlaanbrug
676,Noorderlaan,2022-11-23,18:00:00,134,64,70,FMN 16 Noorderlaanbrug
676,Noorderlaan,2022-11-23,19:00:00,74,47,27,FMN 16 Noorderlaanbrug
676,Noorderlaan,2022-11-23,20:00:00,45,27,18,FMN 16 Noorderlaanbrug
676,Noorderlaan,2022-11-23,21:00:00,53,25,28,FMN 16 Noorderlaanbrug
676,Noorderlaan,2022-11-23,22:00:00,66,34,32,FMN 16 Noorderlaanbrug
676,Noorderlaan,2022-11-23,23:00:00,21,9,12,FMN 16 Noorderlaanbrug
676,Noorderlaan,2022-11-24,00:00:00,24,16,8,FMN 16 Noorderlaanbrug
676,Noorderlaan,2022-11-24,01:00:00,10,4,6,FMN 16 Noorderlaanbrug
676,Noorderlaan,2022-11-24,02:00:00,8,5,3,FMN 16 Noorderlaanbrug
676,Noorderlaan,2022-11-24,03:00:00,17,14,3,FMN 16 Noorderlaanbrug
676,Noorderlaan,2022-11-24,04:00:00,26,12,14,FMN 16 Noorderlaanbrug
676,Noorderlaan,2022-11-24,05:00:00,70,27,43,FMN 16 Noorderlaanbrug
676,Noorderlaan,2022-11-24,06:00:00,118,62,56,FMN 16 Noorderlaanbrug
676,Noorderlaan,2022-11-24,07:00:00,307,200,107,FMN 16 Noorderlaanbrug
676,Noorderlaan,2022-11-24,08:00:00,404,288,116,FMN 16 Noorderlaanbrug
676,Noorderlaan,2022-11-24,09:00:00,159,111,48,FMN 16 Noorderlaanbrug
676,Noorderlaan,2022-11-24,10:00:00,122,89,33,FMN 16 Noorderlaanbrug
676,Noorderlaan,2022-11-24,11:00:00,80,52,28,FMN 16 Noorderlaanbrug
676,Noorderlaan,2022-11-24,12:00:00,150,95,55,FMN 16 Noorderlaanbrug
676,Noorderlaan,2022-11-24,13:00:00,144,86,58,FMN 16 Noorderlaanbrug
676,Noorderlaan,2022-11-24,14:00:00,145,77,68,FMN 16 Noorderlaanbrug
676,Noorderlaan,2022-11-24,15:00:00,198,100,98,FMN 16 Noorderlaanbrug
676,Noorderlaan,2022-11-24,16:00:00,396,199,197,FMN 16 Noorderlaanbrug
676,Noorderlaan,2022-11-24,17:00:00,359,166,193,FMN 16 Noorderlaanbrug
676,Noorderlaan,2022-11-24,18:00:00,203,100,103,FMN 16 Noorderlaanbrug
676,Noorderlaan,2022-11-24,19:00:00,86,40,46,FMN 16 Noorderlaanbrug
676,Noorderlaan,2022-11-24,20:00:00,64,27,37,FMN 16 Noorderlaanbrug
676,Noorderlaan,2022-11-24,21:00:00,68,30,38,FMN 16 Noorderlaanbrug
676,Noorderlaan,2022-11-24,22:00:00,69,33,36,FMN 16 Noorderlaanbrug
676,Noorderlaan,2022-11-24,23:00:00,37,19,18,FMN 16 Noorderlaanbrug
676,Noorderlaan,2022-11-25,00:00:00,28,12,16,FMN 16 Noorderlaanbrug
676,Noorderlaan,2022-11-25,01:00:00,8,5,3,FMN 16 Noorderlaanbrug
676,Noorderlaan,2022-11-25,02:00:00,2,1,1,FMN 16 Noorderlaanbrug
676,Noorderlaan,2022-11-25,03:00:00,16,11,5,FMN 16 Noorderlaanbrug
676,Noorderlaan,2022-11-25,04:00:00,25,10,15,FMN 16 Noorderlaanbrug
676,Noorderlaan,2022-11-25,05:00:00,64,23,41,FMN 16 Noorderlaanbrug
676,Noorderlaan,2022-11-25,06:00:00,113,57,56,FMN 16 Noorderlaanbrug
676,Noorderlaan,2022-11-25,07:00:00,271,166,105,FMN 16 Noorderlaanbrug
676,Noorderlaan,2022-11-25,08:00:00,391,274,117,FMN 16 Noorderlaanbrug
676,Noorderlaan,2022-11-25,09:00:00,163,127,36,FMN 16 Noorderlaanbrug
676,Noorderlaan,2022-11-25,10:00:00,111,76,35,FMN 16 Noorderlaanbrug
676,Noorderlaan,2022-11-25,11:00:00,97,61,36,FMN 16 Noorderlaanbrug
676,Noorderlaan,2022-11-25,12:00:00,175,104,71,FMN 16 Noorderlaanbrug
676,Noorderlaan,2022-11-25,13:00:00,169,99,70,FMN 16 Noorderlaanbrug
676,Noorderlaan,2022-11-25,14:00:00,168,91,77,FMN 16 Noorderlaanbrug
676,Noorderlaan,2022-11-25,15:00:00,203,88,115,FMN 16 Noorderlaanbrug
676,Noorderlaan,2022-11-25,16:00:00,347,190,157,FMN 16 Noorderlaanbrug
676,Noorderlaan,2022-11-25,17:00:00,242,107,135,FMN 16 Noorderlaanbrug
676,Noorderlaan,2022-11-25,18:00:00,183,90,93,FMN 16 Noorderlaanbrug
676,Noorderlaan,2022-11-25,19:00:00,111,65,46,FMN 16 Noorderlaanbrug
676,Noorderlaan,2022-11-25,20:00:00,75,42,33,FMN 16 Noorderlaanbrug
676,Noorderlaan,2022-11-25,21:00:00,59,26,33,FMN 16 Noorderlaanbrug
676,Noorderlaan,2022-11-25,22:00:00,61,34,27,FMN 16 Noorderlaanbrug
676,Noorderlaan,2022-11-25,23:00:00,47,28,19,FMN 16 Noorderlaanbrug
676,Noorderlaan,2022-11-26,00:00:00,49,22,27,FMN 16 Noorderlaanbrug
676,Noorderlaan,2022-11-26,01:00:00,26,10,16,FMN 16 Noorderlaanbrug
676,Noorderlaan,2022-11-26,02:00:00,33,18,15,FMN 16 Noorderlaanbrug
676,Noorderlaan,2022-11-26,03:00:00,17,7,10,FMN 16 Noorderlaanbrug
676,Noorderlaan,2022-11-26,04:00:00,18,9,9,FMN 16 Noorderlaanbrug
676,Noorderlaan,2022-11-26,05:00:00,28,6,22,FMN 16 Noorderlaanbrug
676,Noorderlaan,2022-11-26,06:00:00,36,20,16,FMN 16 Noorderlaanbrug
676,Noorderlaan,2022-11-26,07:00:00,33,22,11,FMN 16 Noorderlaanbrug
676,Noorderlaan,2022-11-26,08:00:00,43,29,14,FMN 16 Noorderlaanbrug
676,Noorderlaan,2022-11-26,09:00:00,67,50,17,FMN 16 Noorderlaanbrug
676,Noorderlaan,2022-11-26,10:00:00,82,53,29,FMN 16 Noorderlaanbrug
676,Noorderlaan,2022-11-26,11:00:00,94,65,29,FMN 16 Noorderlaanbrug
676,Noorderlaan,2022-11-26,12:00:00,109,69,40,FMN 16 Noorderlaanbrug
676,Noorderlaan,2022-11-26,13:00:00,134,86,48,FMN 16 Noorderlaanbrug
676,Noorderlaan,2022-11-26,14:00:00,125,65,60,FMN 16 Noorderlaanbrug
676,Noorderlaan,2022-11-26,15:00:00,108,64,44,FMN 16 Noorderlaanbrug
676,Noorderlaan,2022-11-26,16:00:00,119,72,47,FMN 16 Noorderlaanbrug
676,Noorderlaan,2022-11-26,17:00:00,97,46,51,FMN 16 Noorderlaanbrug
676,Noorderlaan,2022-11-26,18:00:00,95,56,39,FMN 16 Noorderlaanbrug
676,Noorderlaan,2022-11-26,19:00:00,65,33,32,FMN 16 Noorderlaanbrug
676,Noorderlaan,2022-11-26,20:00:00,41,30,11,FMN 16 Noorderlaanbrug
676,Noorderlaan,2022-11-26,21:00:00,54,35,19,FMN 16 Noorderlaanbrug
676,Noorderlaan,2022-11-26,22:00:00,46,12,34,FMN 16 Noorderlaanbrug
676,Noorderlaan,2022-11-26,23:00:00,41,13,28,FMN 16 Noorderlaanbrug
676,Noorderlaan,2022-11-27,00:00:00,35,19,16,FMN 16 Noorderlaanbrug
676,Noorderlaan,2022-11-27,01:00:00,21,10,11,FMN 16 Noorderlaanbrug
676,Noorderlaan,2022-11-27,02:00:00,15,2,13,FMN 16 Noorderlaanbrug
676,Noorderlaan,2022-11-27,03:00:00,16,7,9,FMN 16 Noorderlaanbrug
676,Noorderlaan,2022-11-27,04:00:00,16,7,9,FMN 16 Noorderlaanbrug
676,Noorderlaan,2022-11-27,05:00:00,19,9,10,FMN 16 Noorderlaanbrug
676,Noorderlaan,2022-11-27,06:00:00,17,5,12,FMN 16 Noorderlaanbrug
676,Noorderlaan,2022-11-27,07:00:00,13,11,2,FMN 16 Noorderlaanbrug
676,Noorderlaan,2022-11-27,08:00:00,17,14,3,FMN 16 Noorderlaanbrug
676,Noorderlaan,2022-11-27,09:00:00,21,9,12,FMN 16 Noorderlaanbrug
676,Noorderlaan,2022-11-27,10:00:00,32,24,8,FMN 16 Noorderlaanbrug
676,Noorderlaan,2022-11-27,11:00:00,52,40,12,FMN 16 Noorderlaanbrug
676,Noorderlaan,2022-11-27,12:00:00,38,27,11,FMN 16 Noorderlaanbrug
676,Noorderlaan,2022-11-27,13:00:00,58,33,25,FMN 16 Noorderlaanbrug
676,Noorderlaan,2022-11-27,14:00:00,32,22,10,FMN 16 Noorderlaanbrug
676,Noorderlaan,2022-11-27,15:00:00,54,16,38,FMN 16 Noorderlaanbrug
676,Noorderlaan,2022-11-27,16:00:00,51,28,23,FMN 16 Noorderlaanbrug
676,Noorderlaan,2022-11-27,17:00:00,30,11,19,FMN 16 Noorderlaanbrug
676,Noorderlaan,2022-11-27,18:00:00,33,19,14,FMN 16 Noorderlaanbrug
676,Noorderlaan,2022-11-27,19:00:00,20,11,9,FMN 16 Noorderlaanbrug
676,Noorderlaan,2022-11-27,20:00:00,32,19,13,FMN 16 Noorderlaanbrug
676,Noorderlaan,2022-11-27,21:00:00,26,13,13,FMN 16 Noorderlaanbrug
676,Noorderlaan,2022-11-27,22:00:00,25,9,16,FMN 16 Noorderlaanbrug
676,Noorderlaan,2022-11-27,23:00:00,17,9,8,FMN 16 Noorderlaanbrug
676,Noorderlaan,2022-11-28,00:00:00,11,5,6,FMN 16 Noorderlaanbrug
676,Noorderlaan,2022-11-28,01:00:00,4,1,3,FMN 16 Noorderlaanbrug
676,Noorderlaan,2022-11-28,02:00:00,2,2,0,FMN 16 Noorderlaanbrug
676,Noorderlaan,2022-11-28,03:00:00,7,5,2,FMN 16 Noorderlaanbrug
676,Noorderlaan,2022-11-28,04:00:00,21,11,10,FMN 16 Noorderlaanbrug
676,Noorderlaan,2022-11-28,05:00:00,66,30,36,FMN 16 Noorderlaanbrug
676,Noorderlaan,2022-11-28,06:00:00,115,59,56,FMN 16 Noorderlaanbrug
676,Noorderlaan,2022-11-28,07:00:00,306,201,105,FMN 16 Noorderlaanbrug
676,Noorderlaan,2022-11-28,08:00:00,359,259,100,FMN 16 Noorderlaanbrug
676,Noorderlaan,2022-11-28,09:00:00,115,79,36,FMN 16 Noorderlaanbrug
676,Noorderlaan,2022-11-28,10:00:00,93,58,35,FMN 16 Noorderlaanbrug
676,Noorderlaan,2022-11-28,11:00:00,60,37,23,FMN 16 Noorderlaanbrug
676,Noorderlaan,2022-11-28,12:00:00,101,61,40,FMN 16 Noorderlaanbrug
676,Noorderlaan,2022-11-28,13:00:00,123,68,55,FMN 16 Noorderlaanbrug
676,Noorderlaan,2022-11-28,14:00:00,147,88,59,FMN 16 Noorderlaanbrug
676,Noorderlaan,2022-11-28,15:00:00,183,90,93,FMN 16 Noorderlaanbrug
676,Noorderlaan,2022-11-28,16:00:00,315,152,163,FMN 16 Noorderlaanbrug
676,Noorderlaan,2022-11-28,17:00:00,294,123,171,FMN 16 Noorderlaanbrug
676,Noorderlaan,2022-11-28,18:00:00,149,56,93,FMN 16 Noorderlaanbrug
676,Noorderlaan,2022-11-28,19:00:00,78,40,38,FMN 16 Noorderlaanbrug
676,Noorderlaan,2022-11-28,20:00:00,60,33,27,FMN 16 Noorderlaanbrug
676,Noorderlaan,2022-11-28,21:00:00,50,27,23,FMN 16 Noorderlaanbrug
676,Noorderlaan,2022-11-28,22:00:00,56,37,19,FMN 16 Noorderlaanbrug
676,Noorderlaan,2022-11-28,23:00:00,19,11,8,FMN 16 Noorderlaanbrug
676,Noorderlaan,2022-11-29,00:00:00,17,8,9,FMN 16 Noorderlaanbrug
676,Noorderlaan,2022-11-29,01:00:00,8,6,2,FMN 16 Noorderlaanbrug
676,Noorderlaan,2022-11-29,02:00:00,7,4,3,FMN 16 Noorderlaanbrug
676,Noorderlaan,2022-11-29,03:00:00,12,9,3,FMN 16 Noorderlaanbrug
676,Noorderlaan,2022-11-29,04:00:00,25,12,13,FMN 16 Noorderlaanbrug
676,Noorderlaan,2022-11-29,05:00:00,71,27,44,FMN 16 Noorderlaanbrug
676,Noorderlaan,2022-11-29,06:00:00,130,76,54,FMN 16 Noorderlaanbrug
676,Noorderlaan,2022-11-29,07:00:00,348,225,123,FMN 16 Noorderlaanbrug
676,Noorderlaan,2022-11-29,08:00:00,436,297,139,FMN 16 Noorderlaanbrug
676,Noorderlaan,2022-11-29,09:00:00,157,118,39,FMN 16 Noorderlaanbrug
676,Noorderlaan,2022-11-29,10:00:00,95,70,25,FMN 16 Noorderlaanbrug
676,Noorderlaan,2022-11-29,11:00:00,74,40,34,FMN 16 Noorderlaanbrug
676,Noorderlaan,2022-11-29,12:00:00,151,80,71,FMN 16 Noorderlaanbrug
676,Noorderlaan,2022-11-29,13:00:00,134,67,67,FMN 16 Noorderlaanbrug
676,Noorderlaan,2022-11-29,14:00:00,159,95,64,FMN 16 Noorderlaanbrug
676,Noorderlaan,2022-11-29,15:00:00,204,112,92,FMN 16 Noorderlaanbrug
676,Noorderlaan,2022-11-29,16:00:00,392,190,202,FMN 16 Noorderlaanbrug
676,Noorderlaan,2022-11-29,17:00:00,380,179,201,FMN 16 Noorderlaanbrug
676,Noorderlaan,2022-11-29,18:00:00,210,97,113,FMN 16 Noorderlaanbrug
676,Noorderlaan,2022-11-29,19:00:00,80,44,36,FMN 16 Noorderlaanbrug
676,Noorderlaan,2022-11-29,20:00:00,63,32,31,FMN 16 Noorderlaanbrug
676,Noorderlaan,2022-11-29,21:00:00,56,31,25,FMN 16 Noorderlaanbrug
676,Noorderlaan,2022-11-29,22:00:00,81,43,38,FMN 16 Noorderlaanbrug
676,Noorderlaan,2022-11-29,23:00:00,22,15,7,FMN 16 Noorderlaanbrug
676,Noorderlaan,2022-11-30,00:00:00,10,3,7,FMN 16 Noorderlaanbrug
676,Noorderlaan,2022-11-30,01:00:00,4,2,2,FMN 16 Noorderlaanbrug
676,Noorderlaan,2022-11-30,02:00:00,8,6,2,FMN 16 Noorderlaanbrug
676,Noorderlaan,2022-11-30,03:00:00,16,8,8,FMN 16 Noorderlaanbrug
676,Noorderlaan,2022-11-30,04:00:00,23,11,12,FMN 16 Noorderlaanbrug
676,Noorderlaan,2022-11-30,05:00:00,71,27,44,FMN 16 Noorderlaanbrug
676,Noorderlaan,2022-11-30,06:00:00,114,59,55,FMN 16 Noorderlaanbrug
676,Noorderlaan,2022-11-30,07:00:00,286,194,92,FMN 16 Noorderlaanbrug
676,Noorderlaan,2022-11-30,08:00:00,366,250,116,FMN 16 Noorderlaanbrug
676,Noorderlaan,2022-11-30,09:00:00,130,98,32,FMN 16 Noorderlaanbrug
676,Noorderlaan,2022-11-30,10:00:00,83,60,23,FMN 16 Noorderlaanbrug
676,Noorderlaan,2022-11-30,11:00:00,86,47,39,FMN 16 Noorderlaanbrug
676,Noorderlaan,2022-11-30,12:00:00,183,92,91,FMN 16 Noorderlaanbrug
676,Noorderlaan,2022-11-30,13:00:00,175,79,96,FMN 16 Noorderlaanbrug
676,Noorderlaan,2022-11-30,14:00:00,159,97,62,FMN 16 Noorderlaanbrug
676,Noorderlaan,2022-11-30,15:00:00,199,107,92,FMN 16 Noorderlaanbrug
676,Noorderlaan,2022-11-30,16:00:00,296,157,139,FMN 16 Noorderlaanbrug
676,Noorderlaan,2022-11-30,17:00:00,314,146,168,FMN 16 Noorderlaanbrug
676,Noorderlaan,2022-11-30,18:00:00,177,78,99,FMN 16 Noorderlaanbrug
676,Noorderlaan,2022-11-30,19:00:00,84,45,39,FMN 16 Noorderlaanbrug
676,Noorderlaan,2022-11-30,20:00:00,60,34,26,FMN 16 Noorderlaanbrug
676,Noorderlaan,2022-11-30,21:00:00,58,31,27,FMN 16 Noorderlaanbrug
676,Noorderlaan,2022-11-30,22:00:00,54,32,22,FMN 16 Noorderlaanbrug
676,Noorderlaan,2022-11-30,23:00:00,36,17,19,FMN 16 Noorderlaanbrug
676,Noorderlaan,2022-12-01,00:00:00,24,12,12,FMN 16 Noorderlaanbrug
676,Noorderlaan,2022-12-01,01:00:00,10,3,7,FMN 16 Noorderlaanbrug
676,Noorderlaan,2022-12-01,02:00:00,9,7,2,FMN 16 Noorderlaanbrug
676,Noorderlaan,2022-12-01,03:00:00,10,7,3,FMN 16 Noorderlaanbrug
676,Noorderlaan,2022-12-01,04:00:00,27,13,14,FMN 16 Noorderlaanbrug
676,Noorderlaan,2022-12-01,05:00:00,71,28,43,FMN 16 Noorderlaanbrug
676,Noorderlaan,2022-12-01,06:00:00,125,60,65,FMN 16 Noorderlaanbrug
676,Noorderlaan,2022-12-01,07:00:00,315,213,102,FMN 16 Noorderlaanbrug
676,Noorderlaan,2022-12-01,08:00:00,391,280,111,FMN 16 Noorderlaanbrug
676,Noorderlaan,2022-12-01,09:00:00,147,97,50,FMN 16 Noorderlaanbrug
676,Noorderlaan,2022-12-01,10:00:00,104,78,26,FMN 16 Noorderlaanbrug
676,Noorderlaan,2022-12-01,11:00:00,75,47,28,FMN 16 Noorderlaanbrug
676,Noorderlaan,2022-12-01,12:00:00,150,80,70,FMN 16 Noorderlaanbrug
676,Noorderlaan,2022-12-01,13:00:00,106,46,60,FMN 16 Noorderlaanbrug
676,Noorderlaan,2022-12-01,14:00:00,152,92,60,FMN 16 Noorderlaanbrug
676,Noorderlaan,2022-12-01,15:00:00,228,120,108,FMN 16 Noorderlaanbrug
676,Noorderlaan,2022-12-01,16:00:00,282,120,162,FMN 16 Noorderlaanbrug
676,Noorderlaan,2022-12-01,17:00:00,265,127,138,FMN 16 Noorderlaanbrug
676,Noorderlaan,2022-12-01,18:00:00,210,97,113,FMN 16 Noorderlaanbrug
676,Noorderlaan,2022-12-01,19:00:00,78,39,39,FMN 16 Noorderlaanbrug
676,Noorderlaan,2022-12-01,20:00:00,62,33,29,FMN 16 Noorderlaanbrug
676,Noorderlaan,2022-12-01,21:00:00,64,32,32,FMN 16 Noorderlaanbrug
676,Noorderlaan,2022-12-01,22:00:00,67,28,39,FMN 16 Noorderlaanbrug
676,Noorderlaan,2022-12-01,23:00:00,28,14,14,FMN 16 Noorderlaanbrug
676,Noorderlaan,2022-12-02,00:00:00,8,3,5,FMN 16 Noorderlaanbrug
676,Noorderlaan,2022-12-02,01:00:00,16,7,9,FMN 16 Noorderlaanbrug
676,Noorderlaan,2022-12-02,02:00:00,12,6,6,FMN 16 Noorderlaanbrug
676,Noorderlaan,2022-12-02,03:00:00,13,8,5,FMN 16 Noorderlaanbrug
676,Noorderlaan,2022-12-02,04:00:00,20,11,9,FMN 16 Noorderlaanbrug
676,Noorderlaan,2022-12-02,05:00:00,71,27,44,FMN 16 Noorderlaanbrug
676,Noorderlaan,2022-12-02,06:00:00,110,53,57,FMN 16 Noorderlaanbrug
676,Noorderlaan,2022-12-02,07:00:00,221,137,84,FMN 16 Noorderlaanbrug
676,Noorderlaan,2022-12-02,08:00:00,283,197,86,FMN 16 Noorderlaanbrug
676,Noorderlaan,2022-12-02,09:00:00,118,83,35,FMN 16 Noorderlaanbrug
676,Noorderlaan,2022-12-02,10:00:00,72,51,21,FMN 16 Noorderlaanbrug
676,Noorderlaan,2022-12-02,11:00:00,91,54,37,FMN 16 Noorderlaanbrug
676,Noorderlaan,2022-12-02,12:00:00,114,60,54,FMN 16 Noorderlaanbrug
676,Noorderlaan,2022-12-02,13:00:00,103,45,58,FMN 16 Noorderlaanbrug
676,Noorderlaan,2022-12-02,14:00:00,109,61,48,FMN 16 Noorderlaanbrug
676,Noorderlaan,2022-12-02,15:00:00,218,108,110,FMN 16 Noorderlaanbrug
676,Noorderlaan,2022-12-02,16:00:00,212,105,107,FMN 16 Noorderlaanbrug
676,Noorderlaan,2022-12-02,17:00:00,208,88,120,FMN 16 Noorderlaanbrug
676,Noorderlaan,2022-12-02,18:00:00,136,65,71,FMN 16 Noorderlaanbrug
676,Noorderlaan,2022-12-02,19:00:00,84,44,40,FMN 16 Noorderlaanbrug
676,Noorderlaan,2022-12-02,20:00:00,46,28,18,FMN 16 Noorderlaanbrug
676,Noorderlaan,2022-12-02,21:00:00,56,20,36,FMN 16 Noorderlaanbrug
676,Noorderlaan,2022-12-02,22:00:00,43,30,13,FMN 16 Noorderlaanbrug
676,Noorderlaan,2022-12-02,23:00:00,37,19,18,FMN 16 Noorderlaanbrug
676,Noorderlaan,2022-12-03,00:00:00,10,2,8,FMN 16 Noorderlaanbrug
676,Noorderlaan,2022-12-03,01:00:00,8,2,6,FMN 16 Noorderlaanbrug
676,Noorderlaan,2022-12-03,02:00:00,4,1,3,FMN 16 Noorderlaanbrug
676,Noorderlaan,2022-12-03,03:00:00,3,1,2,FMN 16 Noorderlaanbrug
676,Noorderlaan,2022-12-03,04:00:00,3,1,2,FMN 16 Noorderlaanbrug
676,Noorderlaan,2022-12-03,05:00:00,7,1,6,FMN 16 Noorderlaanbrug
676,Noorderlaan,2022-12-03,06:00:00,6,1,5,FMN 16 Noorderlaanbrug
676,Noorderlaan,2022-12-03,07:00:00,5,2,3,FMN 16 Noorderlaanbrug
676,Noorderlaan,2022-12-03,08:00:00,7,3,4,FMN 16 Noorderlaanbrug
676,Noorderlaan,2022-12-03,09:00:00,8,4,4,FMN 16 Noorderlaanbrug
676,Noorderlaan,2022-12-03,10:00:00,11,5,6,FMN 16 Noorderlaanbrug
676,Noorderlaan,2022-12-03,11:00:00,15,6,9,FMN 16 Noorderlaanbrug
676,Noorderlaan,2022-12-03,12:00:00,18,7,11,FMN 16 Noorderlaanbrug
676,Noorderlaan,2022-12-03,13:00:00,22,9,13,FMN 16 Noorderlaanbrug
676,Noorderlaan,2022-12-03,14:00:00,22,8,14,FMN 16 Noorderlaanbrug
676,Noorderlaan,2022-12-03,15:00:00,27,7,20,FMN 16 Noorderlaanbrug
676,Noorderlaan,2022-12-03,16:00:00,23,7,16,FMN 16 Noorderlaanbrug
676,Noorderlaan,2022-12-03,17:00:00,21,6,15,FMN 16 Noorderlaanbrug
676,Noorderlaan,2022-12-03,18:00:00,19,5,14,FMN 16 Noorderlaanbrug
676,Noorderlaan,2022-12-03,19:00:00,15,3,12,FMN 16 Noorderlaanbrug
676,Noorderlaan,2022-12-03,20:00:00,9,4,5,FMN 16 Noorderlaanbrug
676,Noorderlaan,2022-12-03,21:00:00,8,2,6,FMN 16 Noorderlaanbrug
676,Noorderlaan,2022-12-03,22:00:00,10,2,8,FMN 16 Noorderlaanbrug
676,Noorderlaan,2022-12-03,23:00:00,8,2,6,FMN 16 Noorderlaanbrug
676,Noorderlaan,2022-12-04,00:00:00,35,20,15,FMN 16 Noorderlaanbrug
676,Noorderlaan,2022-12-04,01:00:00,30,12,18,FMN 16 Noorderlaanbrug
676,Noorderlaan,2022-12-04,02:00:00,15,6,9,FMN 16 Noorderlaanbrug
676,Noorderlaan,2022-12-04,03:00:00,18,7,11,FMN 16 Noorderlaanbrug
676,Noorderlaan,2022-12-04,04:00:00,15,8,7,FMN 16 Noorderlaanbrug
676,Noorderlaan,2022-12-04,05:00:00,22,10,12,FMN 16 Noorderlaanbrug
676,Noorderlaan,2022-12-04,06:00:00,23,10,13,FMN 16 Noorderlaanbrug
676,Noorderlaan,2022-12-04,07:00:00,17,11,6,FMN 16 Noorderlaanbrug
676,Noorderlaan,2022-12-04,08:00:00,23,17,6,FMN 16 Noorderlaanbrug
676,Noorderlaan,2022-12-04,09:00:00,35,23,12,FMN 16 Noorderlaanbrug
676,Noorderlaan,2022-12-04,10:00:00,44,31,13,FMN 16 Noorderlaanbrug
676,Noorderlaan,2022-12-04,11:00:00,55,36,19,FMN 16 Noorderlaanbrug
676,Noorderlaan,2022-12-04,12:00:00,53,33,20,FMN 16 Noorderlaanbrug
676,Noorderlaan,2022-12-04,13:00:00,67,38,29,FMN 16 Noorderlaanbrug
676,Noorderlaan,2022-12-04,14:00:00,61,41,20,FMN 16 Noorderlaanbrug
676,Noorderlaan,2022-12-04,15:00:00,72,35,37,FMN 16 Noorderlaanbrug
676,Noorderlaan,2022-12-04,16:00:00,68,33,35,FMN 16 Noorderlaanbrug
676,Noorderlaan,2022-12-04,17:00:00,45,18,27,FMN 16 Noorderlaanbrug
676,Noorderlaan,2022-12-04,18:00:00,52,28,24,FMN 16 Noorderlaanbrug
676,Noorderlaan,2022-12-04,19:00:00,37,18,19,FMN 16 Noorderlaanbrug
676,Noorderlaan,2022-12-04,20:00:00,31,17,14,FMN 16 Noorderlaanbrug
676,Noorderlaan,2022-12-04,21:00:00,31,16,15,FMN 16 Noorderlaanbrug
676,Noorderlaan,2022-12-04,22:00:00,24,10,14,FMN 16 Noorderlaanbrug
676,Noorderlaan,2022-12-04,23:00:00,22,11,11,FMN 16 Noorderlaanbrug
676,Noorderlaan,2022-12-05,00:00:00,6,3,3,FMN 16 Noorderlaanbrug
676,Noorderlaan,2022-12-05,01:00:00,5,2,3,FMN 16 Noorderlaanbrug
676,Noorderlaan,2022-12-05,02:00:00,2,1,1,FMN 16 Noorderlaanbrug
676,Noorderlaan,2022-12-05,03:00:00,6,5,1,FMN 16 Noorderlaanbrug
676,Noorderlaan,2022-12-05,04:00:00,16,8,8,FMN 16 Noorderlaanbrug
676,Noorderlaan,2022-12-05,05:00:00,55,24,31,FMN 16 Noorderlaanbrug
676,Noorderlaan,2022-12-05,06:00:00,93,49,44,FMN 16 Noorderlaanbrug
676,Noorderlaan,2022-12-05,07:00:00,218,145,73,FMN 16 Noorderlaanbrug
676,Noorderlaan,2022-12-05,08:00:00,292,208,84,FMN 16 Noorderlaanbrug
676,Noorderlaan,2022-12-05,09:00:00,89,63,26,FMN 16 Noorderlaanbrug
676,Noorderlaan,2022-12-05,10:00:00,74,48,26,FMN 16 Noorderlaanbrug
676,Noorderlaan,2022-12-05,11:00:00,60,38,22,FMN 16 Noorderlaanbrug
676,Noorderlaan,2022-12-05,12:00:00,94,54,40,FMN 16 Noorderlaanbrug
676,Noorderlaan,2022-12-05,13:00:00,104,48,56,FMN 16 Noorderlaanbrug
676,Noorderlaan,2022-12-05,14:00:00,102,61,41,FMN 16 Noorderlaanbrug
676,Noorderlaan,2022-12-05,15:00:00,155,82,73,FMN 16 Noorderlaanbrug
676,Noorderlaan,2022-12-05,16:00:00,246,120,126,FMN 16 Noorderlaanbrug
676,Noorderlaan,2022-12-05,17:00:00,249,114,135,FMN 16 Noorderlaanbrug
676,Noorderlaan,2022-12-05,18:00:00,116,47,69,FMN 16 Noorderlaanbrug
676,Noorderlaan,2022-12-05,19:00:00,52,29,23,FMN 16 Noorderlaanbrug
676,Noorderlaan,2022-12-05,20:00:00,41,22,19,FMN 16 Noorderlaanbrug
676,Noorderlaan,2022-12-05,21:00:00,37,18,19,FMN 16 Noorderlaanbrug
676,Noorderlaan,2022-12-05,22:00:00,44,27,17,FMN 16 Noorderlaanbrug
676,Noorderlaan,2022-12-05,23:00:00,19,11,8,FMN 16 Noorderlaanbrug
676,Noorderlaan,2022-12-06,00:00:00,12,6,6,FMN 16 Noorderlaanbrug
676,Noorderlaan,2022-12-06,01:00:00,7,5,2,FMN 16 Noorderlaanbrug
676,Noorderlaan,2022-12-06,02:00:00,4,2,2,FMN 16 Noorderlaanbrug
676,Noorderlaan,2022-12-06,03:00:00,10,8,2,FMN 16 Noorderlaanbrug
676,Noorderlaan,2022-12-06,04:00:00,25,15,10,FMN 16 Noorderlaanbrug
676,Noorderlaan,2022-12-06,05:00:00,69,29,40,FMN 16 Noorderlaanbrug
676,Noorderlaan,2022-12-06,06:00:00,127,70,57,FMN 16 Noorderlaanbrug
676,Noorderlaan,2022-12-06,07:00:00,325,223,102,FMN 16 Noorderlaanbrug
676,Noorderlaan,2022-12-06,08:00:00,409,304,105,FMN 16 Noorderlaanbrug
676,Noorderlaan,2022-12-06,09:00:00,139,105,34,FMN 16 Noorderlaanbrug
676,Noorderlaan,2022-12-06,10:00:00,94,67,27,FMN 16 Noorderlaanbrug
676,Noorderlaan,2022-12-06,11:00:00,78,48,30,FMN 16 Noorderlaanbrug
676,Noorderlaan,2022-12-06,12:00:00,130,74,56,FMN 16 Noorderlaanbrug
676,Noorderlaan,2022-12-06,13:00:00,121,60,61,FMN 16 Noorderlaanbrug
676,Noorderlaan,2022-12-06,14:00:00,125,77,48,FMN 16 Noorderlaanbrug
676,Noorderlaan,2022-12-06,15:00:00,194,100,94,FMN 16 Noorderlaanbrug
676,Noorderlaan,2022-12-06,16:00:00,346,178,168,FMN 16 Noorderlaanbrug
676,Noorderlaan,2022-12-06,17:00:00,341,162,179,FMN 16 Noorderlaanbrug
676,Noorderlaan,2022-12-06,18:00:00,179,83,96,FMN 16 Noorderlaanbrug
676,Noorderlaan,2022-12-06,19:00:00,84,47,37,FMN 16 Noorderlaanbrug
676,Noorderlaan,2022-12-06,20:00:00,50,28,22,FMN 16 Noorderlaanbrug
676,Noorderlaan,2022-12-06,21:00:00,48,26,22,FMN 16 Noorderlaanbrug
676,Noorderlaan,2022-12-06,22:00:00,71,41,30,FMN 16 Noorderlaanbrug
676,Noorderlaan,2022-12-06,23:00:00,23,15,8,FMN 16 Noorderlaanbrug
676,Noorderlaan,2022-12-07,00:00:00,0,0,0,FMN 16 Noorderlaanbrug
676,Noorderlaan,2022-12-07,01:00:00,0,0,0,FMN 16 Noorderlaanbrug
676,Noorderlaan,2022-12-07,02:00:00,0,0,0,FMN 16 Noorderlaanbrug
676,Noorderlaan,2022-12-07,03:00:00,0,0,0,FMN 16 Noorderlaanbrug
676,Noorderlaan,2022-12-07,04:00:00,0,0,0,FMN 16 Noorderlaanbrug
676,Noorderlaan,2022-12-07,05:00:00,0,0,0,FMN 16 Noorderlaanbrug
676,Noorderlaan,2022-12-07,06:00:00,0,0,0,FMN 16 Noorderlaanbrug
676,Noorderlaan,2022-12-07,07:00:00,0,0,0,FMN 16 Noorderlaanbrug
676,Noorderlaan,2022-12-07,08:00:00,0,0,0,FMN 16 Noorderlaanbrug
676,Noorderlaan,2022-12-07,09:00:00,0,0,0,FMN 16 Noorderlaanbrug
676,Noorderlaan,2022-12-07,10:00:00,0,0,0,FMN 16 Noorderlaanbrug
676,Noorderlaan,2022-12-07,11:00:00,0,0,0,FMN 16 Noorderlaanbrug
676,Noorderlaan,2022-12-07,12:00:00,0,0,0,FMN 16 Noorderlaanbrug
676,Noorderlaan,2022-12-07,13:00:00,0,0,0,FMN 16 Noorderlaanbrug
676,Noorderlaan,2022-12-07,14:00:00,32,20,12,FMN 16 Noorderlaanbrug
676,Noorderlaan,2022-12-07,15:00:00,142,74,68,FMN 16 Noorderlaanbrug
676,Noorderlaan,2022-12-07,16:00:00,226,126,100,FMN 16 Noorderlaanbrug
676,Noorderlaan,2022-12-07,17:00:00,278,151,127,FMN 16 Noorderlaanbrug
676,Noorderlaan,2022-12-07,18:00:00,156,82,74,FMN 16 Noorderlaanbrug
676,Noorderlaan,2022-12-07,19:00:00,66,34,32,FMN 16 Noorderlaanbrug
676,Noorderlaan,2022-12-07,20:00:00,47,30,17,FMN 16 Noorderlaanbrug
676,Noorderlaan,2022-12-07,21:00:00,62,33,29,FMN 16 Noorderlaanbrug
676,Noorderlaan,2022-12-07,22:00:00,53,32,21,FMN 16 Noorderlaanbrug
676,Noorderlaan,2022-12-07,23:00:00,23,10,13,FMN 16 Noorderlaanbrug
676,Noorderlaan,2022-12-08,00:00:00,7,2,5,FMN 16 Noorderlaanbrug
676,Noorderlaan,2022-12-08,01:00:00,7,3,4,FMN 16 Noorderlaanbrug
676,Noorderlaan,2022-12-08,02:00:00,3,1,2,FMN 16 Noorderlaanbrug
676,Noorderlaan,2022-12-08,03:00:00,15,13,2,FMN 16 Noorderlaanbrug
676,Noorderlaan,2022-12-08,04:00:00,17,9,8,FMN 16 Noorderlaanbrug
676,Noorderlaan,2022-12-08,05:00:00,99,32,67,FMN 16 Noorderlaanbrug
676,Noorderlaan,2022-12-08,06:00:00,107,53,54,FMN 16 Noorderlaanbrug
676,Noorderlaan,2022-12-08,07:00:00,267,177,90,FMN 16 Noorderlaanbrug
676,Noorderlaan,2022-12-08,08:00:00,398,315,83,FMN 16 Noorderlaanbrug
676,Noorderlaan,2022-12-08,09:00:00,118,87,31,FMN 16 Noorderlaanbrug
676,Noorderlaan,2022-12-08,10:00:00,86,61,25,FMN 16 Noorderlaanbrug
676,Noorderlaan,2022-12-08,11:00:00,64,41,23,FMN 16 Noorderlaanbrug
676,Noorderlaan,2022-12-08,12:00:00,105,51,54,FMN 16 Noorderlaanbrug
676,Noorderlaan,2022-12-08,13:00:00,85,46,39,FMN 16 Noorderlaanbrug
676,Noorderlaan,2022-12-08,14:00:00,118,71,47,FMN 16 Noorderlaanbrug
676,Noorderlaan,2022-12-08,15:00:00,149,77,72,FMN 16 Noorderlaanbrug
676,Noorderlaan,2022-12-08,16:00:00,262,136,126,FMN 16 Noorderlaanbrug
676,Noorderlaan,2022-12-08,17:00:00,276,149,127,FMN 16 Noorderlaanbrug
676,Noorderlaan,2022-12-08,18:00:00,38,17,21,FMN 16 Noorderlaanbrug
676,Noorderlaan,2022-12-08,19:00:00,0,0,0,FMN 16 Noorderlaanbrug
676,Noorderlaan,2022-12-08,20:00:00,0,0,0,FMN 16 Noorderlaanbrug
676,Noorderlaan,2022-12-08,21:00:00,0,0,0,FMN 16 Noorderlaanbrug
676,Noorderlaan,2022-12-08,22:00:00,0,0,0,FMN 16 Noorderlaanbrug
676,Noorderlaan,2022-12-08,23:00:00,0,0,0,FMN 16 Noorderlaanbrug
676,Noorderlaan,2022-12-09,00:00:00,12,12,0,FMN 16 Noorderlaanbrug
676,Noorderlaan,2022-12-09,01:00:00,7,7,0,FMN 16 Noorderlaanbrug
676,Noorderlaan,2022-12-09,02:00:00,7,5,2,FMN 16 Noorderlaanbrug
676,Noorderlaan,2022-12-09,03:00:00,12,9,3,FMN 16 Noorderlaanbrug
676,Noorderlaan,2022-12-09,04:00:00,20,11,9,FMN 16 Noorderlaanbrug
676,Noorderlaan,2022-12-09,05:00:00,54,22,32,FMN 16 Noorderlaanbrug
676,Noorderlaan,2022-12-09,06:00:00,40,40,0,FMN 16 Noorderlaanbrug
676,Noorderlaan,2022-12-09,07:00:00,115,115,0,FMN 16 Noorderlaanbrug
676,Noorderlaan,2022-12-09,08:00:00,170,170,0,FMN 16 Noorderlaanbrug
676,Noorderlaan,2022-12-09,09:00:00,72,72,0,FMN 16 Noorderlaanbrug
676,Noorderlaan,2022-12-09,10:00:00,49,49,0,FMN 16 Noorderlaanbrug
676,Noorderlaan,2022-12-09,11:00:00,48,48,0,FMN 16 Noorderlaanbrug
676,Noorderlaan,2022-12-09,12:00:00,58,58,0,FMN 16 Noorderlaanbrug
676,Noorderlaan,2022-12-09,13:00:00,61,61,0,FMN 16 Noorderlaanbrug
676,Noorderlaan,2022-12-09,14:00:00,64,64,0,FMN 16 Noorderlaanbrug
676,Noorderlaan,2022-12-09,15:00:00,76,76,0,FMN 16 Noorderlaanbrug
676,Noorderlaan,2022-12-09,16:00:00,114,114,0,FMN 16 Noorderlaanbrug
676,Noorderlaan,2022-12-09,17:00:00,79,79,0,FMN 16 Noorderlaanbrug
676,Noorderlaan,2022-12-09,18:00:00,61,61,0,FMN 16 Noorderlaanbrug
676,Noorderlaan,2022-12-09,19:00:00,41,41,0,FMN 16 Noorderlaanbrug
676,Noorderlaan,2022-12-09,20:00:00,28,28,0,FMN 16 Noorderlaanbrug
676,Noorderlaan,2022-12-09,21:00:00,23,23,0,FMN 16 Noorderlaanbrug
676,Noorderlaan,2022-12-09,22:00:00,28,28,0,FMN 16 Noorderlaanbrug
676,Noorderlaan,2022-12-09,23:00:00,19,19,0,FMN 16 Noorderlaanbrug
676,Noorderlaan,2022-12-10,00:00:00,50,23,27,FMN 16 Noorderlaanbrug
676,Noorderlaan,2022-12-10,01:00:00,40,18,22,FMN 16 Noorderlaanbrug
676,Noorderlaan,2022-12-10,02:00:00,21,11,10,FMN 16 Noorderlaanbrug
676,Noorderlaan,2022-12-10,03:00:00,20,10,10,FMN 16 Noorderlaanbrug
676,Noorderlaan,2022-12-10,04:00:00,19,12,7,FMN 16 Noorderlaanbrug
676,Noorderlaan,2022-12-10,05:00:00,31,10,21,FMN 16 Noorderlaanbrug
676,Noorderlaan,2022-12-10,06:00:00,35,18,17,FMN 16 Noorderlaanbrug
676,Noorderlaan,2022-12-10,07:00:00,32,20,12,FMN 16 Noorderlaanbrug
676,Noorderlaan,2022-12-10,08:00:00,38,26,12,FMN 16 Noorderlaanbrug
676,Noorderlaan,2022-12-10,09:00:00,66,49,17,FMN 16 Noorderlaanbrug
676,Noorderlaan,2022-12-10,10:00:00,71,52,19,FMN 16 Noorderlaanbrug
676,Noorderlaan,2022-12-10,11:00:00,97,63,34,FMN 16 Noorderlaanbrug
676,Noorderlaan,2022-12-10,12:00:00,118,78,40,FMN 16 Noorderlaanbrug
676,Noorderlaan,2022-12-10,13:00:00,142,97,45,FMN 16 Noorderlaanbrug
676,Noorderlaan,2022-12-10,14:00:00,141,89,52,FMN 16 Noorderlaanbrug
676,Noorderlaan,2022-12-10,15:00:00,141,72,69,FMN 16 Noorderlaanbrug
676,Noorderlaan,2022-12-10,16:00:00,133,75,58,FMN 16 Noorderlaanbrug
676,Noorderlaan,2022-12-10,17:00:00,115,62,53,FMN 16 Noorderlaanbrug
676,Noorderlaan,2022-12-10,18:00:00,104,54,50,FMN 16 Noorderlaanbrug
676,Noorderlaan,2022-12-10,19:00:00,85,39,46,FMN 16 Noorderlaanbrug
676,Noorderlaan,2022-12-10,20:00:00,52,34,18,FMN 16 Noorderlaanbrug
676,Noorderlaan,2022-12-10,21:00:00,43,22,21,FMN 16 Noorderlaanbrug
676,Noorderlaan,2022-12-10,22:00:00,50,24,26,FMN 16 Noorderlaanbrug
676,Noorderlaan,2022-12-10,23:00:00,46,23,23,FMN 16 Noorderlaanbrug
676,Noorderlaan,2022-12-11,00:00:00,30,17,13,FMN 16 Noorderlaanbrug
676,Noorderlaan,2022-12-11,01:00:00,27,11,16,FMN 16 Noorderlaanbrug
676,Noorderlaan,2022-12-11,02:00:00,12,4,8,FMN 16 Noorderlaanbrug
676,Noorderlaan,2022-12-11,03:00:00,15,6,9,FMN 16 Noorderlaanbrug
676,Noorderlaan,2022-12-11,04:00:00,15,8,7,FMN 16 Noorderlaanbrug
676,Noorderlaan,2022-12-11,05:00:00,19,8,11,FMN 16 Noorderlaanbrug
676,Noorderlaan,2022-12-11,06:00:00,20,9,11,FMN 16 Noorderlaanbrug
676,Noorderlaan,2022-12-11,07:00:00,14,9,5,FMN 16 Noorderlaanbrug
676,Noorderlaan,2022-12-11,08:00:00,20,14,6,FMN 16 Noorderlaanbrug
676,Noorderlaan,2022-12-11,09:00:00,30,20,10,FMN 16 Noorderlaanbrug
676,Noorderlaan,2022-12-11,10:00:00,37,26,11,FMN 16 Noorderlaanbrug
676,Noorderlaan,2022-12-11,11:00:00,50,32,18,FMN 16 Noorderlaanbrug
676,Noorderlaan,2022-12-11,12:00:00,45,28,17,FMN 16 Noorderlaanbrug
676,Noorderlaan,2022-12-11,13:00:00,57,32,25,FMN 16 Noorderlaanbrug
676,Noorderlaan,2022-12-11,14:00:00,54,36,18,FMN 16 Noorderlaanbrug
676,Noorderlaan,2022-12-11,15:00:00,63,30,33,FMN 16 Noorderlaanbrug
676,Noorderlaan,2022-12-11,16:00:00,59,28,31,FMN 16 Noorderlaanbrug
676,Noorderlaan,2022-12-11,17:00:00,39,15,24,FMN 16 Noorderlaanbrug
676,Noorderlaan,2022-12-11,18:00:00,44,24,20,FMN 16 Noorderlaanbrug
676,Noorderlaan,2022-12-11,19:00:00,34,16,18,FMN 16 Noorderlaanbrug
676,Noorderlaan,2022-12-11,20:00:00,26,14,12,FMN 16 Noorderlaanbrug
676,Noorderlaan,2022-12-11,21:00:00,27,14,13,FMN 16 Noorderlaanbrug
676,Noorderlaan,2022-12-11,22:00:00,21,8,13,FMN 16 Noorderlaanbrug
676,Noorderlaan,2022-12-11,23:00:00,19,10,9,FMN 16 Noorderlaanbrug
676,Noorderlaan,2022-12-12,00:00:00,8,4,4,FMN 16 Noorderlaanbrug
676,Noorderlaan,2022-12-12,01:00:00,6,2,4,FMN 16 Noorderlaanbrug
676,Noorderlaan,2022-12-12,02:00:00,3,2,1,FMN 16 Noorderlaanbrug
676,Noorderlaan,2022-12-12,03:00:00,6,5,1,FMN 16 Noorderlaanbrug
676,Noorderlaan,2022-12-12,04:00:00,22,11,11,FMN 16 Noorderlaanbrug
676,Noorderlaan,2022-12-12,05:00:00,69,30,39,FMN 16 Noorderlaanbrug
676,Noorderlaan,2022-12-12,06:00:00,118,62,56,FMN 16 Noorderlaanbrug
676,Noorderlaan,2022-12-12,07:00:00,275,183,92,FMN 16 Noorderlaanbrug
676,Noorderlaan,2022-12-12,08:00:00,370,263,107,FMN 16 Noorderlaanbrug
676,Noorderlaan,2022-12-12,09:00:00,112,79,33,FMN 16 Noorderlaanbrug
676,Noorderlaan,2022-12-12,10:00:00,94,61,33,FMN 16 Noorderlaanbrug
676,Noorderlaan,2022-12-12,11:00:00,75,47,28,FMN 16 Noorderlaanbrug
676,Noorderlaan,2022-12-12,12:00:00,117,67,50,FMN 16 Noorderlaanbrug
676,Noorderlaan,2022-12-12,13:00:00,132,61,71,FMN 16 Noorderlaanbrug
676,Noorderlaan,2022-12-12,14:00:00,130,77,53,FMN 16 Noorderlaanbrug
676,Noorderlaan,2022-12-12,15:00:00,197,104,93,FMN 16 Noorderlaanbrug
676,Noorderlaan,2022-12-12,16:00:00,311,151,160,FMN 16 Noorderlaanbrug
676,Noorderlaan,2022-12-12,17:00:00,315,144,171,FMN 16 Noorderlaanbrug
676,Noorderlaan,2022-12-12,18:00:00,147,59,88,FMN 16 Noorderlaanbrug
676,Noorderlaan,2022-12-12,19:00:00,66,37,29,FMN 16 Noorderlaanbrug
676,Noorderlaan,2022-12-12,20:00:00,51,27,24,FMN 16 Noorderlaanbrug
676,Noorderlaan,2022-12-12,21:00:00,48,23,25,FMN 16 Noorderlaanbrug
676,Noorderlaan,2022-12-12,22:00:00,55,34,21,FMN 16 Noorderlaanbrug
676,Noorderlaan,2022-12-12,23:00:00,24,14,10,FMN 16 Noorderlaanbrug
676,Noorderlaan,2022-12-13,00:00:00,12,6,6,FMN 16 Noorderlaanbrug
676,Noorderlaan,2022-12-13,01:00:00,6,4,2,FMN 16 Noorderlaanbrug
676,Noorderlaan,2022-12-13,02:00:00,5,3,2,FMN 16 Noorderlaanbrug
676,Noorderlaan,2022-12-13,03:00:00,8,7,1,FMN 16 Noorderlaanbrug
676,Noorderlaan,2022-12-13,04:00:00,25,15,10,FMN 16 Noorderlaanbrug
676,Noorderlaan,2022-12-13,05:00:00,66,28,38,FMN 16 Noorderlaanbrug
676,Noorderlaan,2022-12-13,06:00:00,125,70,55,FMN 16 Noorderlaanbrug
676,Noorderlaan,2022-12-13,07:00:00,314,217,97,FMN 16 Noorderlaanbrug
676,Noorderlaan,2022-12-13,08:00:00,398,298,100,FMN 16 Noorderlaanbrug
676,Noorderlaan,2022-12-13,09:00:00,137,103,34,FMN 16 Noorderlaanbrug
676,Noorderlaan,2022-12-13,10:00:00,91,66,25,FMN 16 Noorderlaanbrug
676,Noorderlaan,2022-12-13,11:00:00,75,46,29,FMN 16 Noorderlaanbrug
676,Noorderlaan,2022-12-13,12:00:00,127,73,54,FMN 16 Noorderlaanbrug
676,Noorderlaan,2022-12-13,13:00:00,117,59,58,FMN 16 Noorderlaanbrug
676,Noorderlaan,2022-12-13,14:00:00,121,75,46,FMN 16 Noorderlaanbrug
676,Noorderlaan,2022-12-13,15:00:00,187,98,89,FMN 16 Noorderlaanbrug
676,Noorderlaan,2022-12-13,16:00:00,335,174,161,FMN 16 Noorderlaanbrug
676,Noorderlaan,2022-12-13,17:00:00,331,159,172,FMN 16 Noorderlaanbrug
676,Noorderlaan,2022-12-13,18:00:00,172,81,91,FMN 16 Noorderlaanbrug
676,Noorderlaan,2022-12-13,19:00:00,81,46,35,FMN 16 Noorderlaanbrug
676,Noorderlaan,2022-12-13,20:00:00,49,27,22,FMN 16 Noorderlaanbrug
676,Noorderlaan,2022-12-13,21:00:00,47,26,21,FMN 16 Noorderlaanbrug
676,Noorderlaan,2022-12-13,22:00:00,69,41,28,FMN 16 Noorderlaanbrug
676,Noorderlaan,2022-12-13,23:00:00,22,14,8,FMN 16 Noorderlaanbrug
676,Noorderlaan,2022-12-14,00:00:00,5,2,3,FMN 16 Noorderlaanbrug
676,Noorderlaan,2022-12-14,01:00:00,3,1,2,FMN 16 Noorderlaanbrug
676,Noorderlaan,2022-12-14,02:00:00,2,1,1,FMN 16 Noorderlaanbrug
676,Noorderlaan,2022-12-14,03:00:00,7,4,3,FMN 16 Noorderlaanbrug
676,Noorderlaan,2022-12-14,04:00:00,9,5,4,FMN 16 Noorderlaanbrug
676,Noorderlaan,2022-12-14,05:00:00,33,12,21,FMN 16 Noorderlaanbrug
676,Noorderlaan,2022-12-14,06:00:00,43,21,22,FMN 16 Noorderlaanbrug
676,Noorderlaan,2022-12-14,07:00:00,116,73,43,FMN 16 Noorderlaanbrug
676,Noorderlaan,2022-12-14,08:00:00,142,96,46,FMN 16 Noorderlaanbrug
676,Noorderlaan,2022-12-14,09:00:00,49,35,14,FMN 16 Noorderlaanbrug
676,Noorderlaan,2022-12-14,10:00:00,37,25,12,FMN 16 Noorderlaanbrug
676,Noorderlaan,2022-12-14,11:00:00,35,19,16,FMN 16 Noorderlaanbrug
676,Noorderlaan,2022-12-14,12:00:00,78,38,40,FMN 16 Noorderlaanbrug
676,Noorderlaan,2022-12-14,13:00:00,66,33,33,FMN 16 Noorderlaanbrug
676,Noorderlaan,2022-12-14,14:00:00,61,37,24,FMN 16 Noorderlaanbrug
676,Noorderlaan,2022-12-14,15:00:00,90,51,39,FMN 16 Noorderlaanbrug
676,Noorderlaan,2022-12-14,16:00:00,138,75,63,FMN 16 Noorderlaanbrug
676,Noorderlaan,2022-12-14,17:00:00,158,80,78,FMN 16 Noorderlaanbrug
676,Noorderlaan,2022-12-14,18:00:00,86,41,45,FMN 16 Noorderlaanbrug
676,Noorderlaan,2022-12-14,19:00:00,50,25,25,FMN 16 Noorderlaanbrug
676,Noorderlaan,2022-12-14,20:00:00,28,16,12,FMN 16 Noorderlaanbrug
676,Noorderlaan,2022-12-14,21:00:00,30,15,15,FMN 16 Noorderlaanbrug
676,Noorderlaan,2022-12-14,22:00:00,33,18,15,FMN 16 Noorderlaanbrug
676,Noorderlaan,2022-12-14,23:00:00,16,7,9,FMN 16 Noorderlaanbrug
676,Noorderlaan,2022-12-15,00:00:00,28,12,16,FMN 16 Noorderlaanbrug
676,Noorderlaan,2022-12-15,01:00:00,18,11,7,FMN 16 Noorderlaanbrug
676,Noorderlaan,2022-12-15,02:00:00,14,10,4,FMN 16 Noorderlaanbrug
676,Noorderlaan,2022-12-15,03:00:00,23,19,4,FMN 16 Noorderlaanbrug
676,Noorderlaan,2022-12-15,04:00:00,32,20,12,FMN 16 Noorderlaanbrug
676,Noorderlaan,2022-12-15,05:00:00,93,38,55,FMN 16 Noorderlaanbrug
676,Noorderlaan,2022-12-15,06:00:00,135,71,64,FMN 16 Noorderlaanbrug
676,Noorderlaan,2022-12-15,07:00:00,345,229,116,FMN 16 Noorderlaanbrug
676,Noorderlaan,2022-12-15,08:00:00,455,332,123,FMN 16 Noorderlaanbrug
676,Noorderlaan,2022-12-15,09:00:00,156,110,46,FMN 16 Noorderlaanbrug
676,Noorderlaan,2022-12-15,10:00:00,112,77,35,FMN 16 Noorderlaanbrug
676,Noorderlaan,2022-12-15,11:00:00,93,60,33,FMN 16 Noorderlaanbrug
676,Noorderlaan,2022-12-15,12:00:00,149,87,62,FMN 16 Noorderlaanbrug
676,Noorderlaan,2022-12-15,13:00:00,139,73,66,FMN 16 Noorderlaanbrug
676,Noorderlaan,2022-12-15,14:00:00,166,96,70,FMN 16 Noorderlaanbrug
676,Noorderlaan,2022-12-15,15:00:00,218,115,103,FMN 16 Noorderlaanbrug
676,Noorderlaan,2022-12-15,16:00:00,361,180,181,FMN 16 Noorderlaanbrug
676,Noorderlaan,2022-12-15,17:00:00,356,173,183,FMN 16 Noorderlaanbrug
676,Noorderlaan,2022-12-15,18:00:00,186,93,93,FMN 16 Noorderlaanbrug
676,Noorderlaan,2022-12-15,19:00:00,88,43,45,FMN 16 Noorderlaanbrug
676,Noorderlaan,2022-12-15,20:00:00,63,31,32,FMN 16 Noorderlaanbrug
676,Noorderlaan,2022-12-15,21:00:00,62,26,36,FMN 16 Noorderlaanbrug
676,Noorderlaan,2022-12-15,22:00:00,69,36,33,FMN 16 Noorderlaanbrug
676,Noorderlaan,2022-12-15,23:00:00,39,19,20,FMN 16 Noorderlaanbrug
676,Noorderlaan,2022-12-16,00:00:00,31,16,15,FMN 16 Noorderlaanbrug
676,Noorderlaan,2022-12-16,01:00:00,18,7,11,FMN 16 Noorderlaanbrug
676,Noorderlaan,2022-12-16,02:00:00,14,8,6,FMN 16 Noorderlaanbrug
676,Noorderlaan,2022-12-16,03:00:00,17,10,7,FMN 16 Noorderlaanbrug
676,Noorderlaan,2022-12-16,04:00:00,29,15,14,FMN 16 Noorderlaanbrug
676,Noorderlaan,2022-12-16,05:00:00,76,28,48,FMN 16 Noorderlaanbrug
676,Noorderlaan,2022-12-16,06:00:00,97,51,46,FMN 16 Noorderlaanbrug
676,Noorderlaan,2022-12-16,07:00:00,226,145,81,FMN 16 Noorderlaanbrug
676,Noorderlaan,2022-12-16,08:00:00,302,216,86,FMN 16 Noorderlaanbrug
676,Noorderlaan,2022-12-16,09:00:00,121,91,30,FMN 16 Noorderlaanbrug
676,Noorderlaan,2022-12-16,10:00:00,90,62,28,FMN 16 Noorderlaanbrug
676,Noorderlaan,2022-12-16,11:00:00,96,61,35,FMN 16 Noorderlaanbrug
676,Noorderlaan,2022-12-16,12:00:00,128,74,54,FMN 16 Noorderlaanbrug
676,Noorderlaan,2022-12-16,13:00:00,135,77,58,FMN 16 Noorderlaanbrug
676,Noorderlaan,2022-12-16,14:00:00,140,82,58,FMN 16 Noorderlaanbrug
676,Noorderlaan,2022-12-16,15:00:00,197,96,101,FMN 16 Noorderlaanbrug
676,Noorderlaan,2022-12-16,16:00:00,270,145,125,FMN 16 Noorderlaanbrug
676,Noorderlaan,2022-12-16,17:00:00,206,99,107,FMN 16 Noorderlaanbrug
676,Noorderlaan,2022-12-16,18:00:00,145,78,67,FMN 16 Noorderlaanbrug
676,Noorderlaan,2022-12-16,19:00:00,90,52,38,FMN 16 Noorderlaanbrug
676,Noorderlaan,2022-12-16,20:00:00,63,36,27,FMN 16 Noorderlaanbrug
676,Noorderlaan,2022-12-16,21:00:00,58,28,30,FMN 16 Noorderlaanbrug
676,Noorderlaan,2022-12-16,22:00:00,58,36,22,FMN 16 Noorderlaanbrug
676,Noorderlaan,2022-12-16,23:00:00,47,24,23,FMN 16 Noorderlaanbrug
676,Noorderlaan,2022-12-18,00:00:00,27,15,12,FMN 16 Noorderlaanbrug
676,Noorderlaan,2022-12-18,01:00:00,23,9,14,FMN 16 Noorderlaanbrug
676,Noorderlaan,2022-12-18,02:00:00,11,4,7,FMN 16 Noorderlaanbrug
676,Noorderlaan,2022-12-18,03:00:00,13,5,8,FMN 16 Noorderlaanbrug
676,Noorderlaan,2022-12-18,04:00:00,13,7,6,FMN 16 Noorderlaanbrug
676,Noorderlaan,2022-12-18,05:00:00,17,7,10,FMN 16 Noorderlaanbrug
676,Noorderlaan,2022-12-18,06:00:00,18,8,10,FMN 16 Noorderlaanbrug
676,Noorderlaan,2022-12-18,07:00:00,13,8,5,FMN 16 Noorderlaanbrug
676,Noorderlaan,2022-12-18,08:00:00,17,12,5,FMN 16 Noorderlaanbrug
676,Noorderlaan,2022-12-18,09:00:00,26,17,9,FMN 16 Noorderlaanbrug
676,Noorderlaan,2022-12-18,10:00:00,33,23,10,FMN 16 Noorderlaanbrug
676,Noorderlaan,2022-12-18,11:00:00,43,28,15,FMN 16 Noorderlaanbrug
676,Noorderlaan,2022-12-18,12:00:00,40,24,16,FMN 16 Noorderlaanbrug
676,Noorderlaan,2022-12-18,13:00:00,51,28,23,FMN 16 Noorderlaanbrug
676,Noorderlaan,2022-12-18,14:00:00,46,31,15,FMN 16 Noorderlaanbrug
676,Noorderlaan,2022-12-18,15:00:00,57,27,30,FMN 16 Noorderlaanbrug
676,Noorderlaan,2022-12-18,16:00:00,51,24,27,FMN 16 Noorderlaanbrug
676,Noorderlaan,2022-12-18,17:00:00,35,13,22,FMN 16 Noorderlaanbrug
676,Noorderlaan,2022-12-18,18:00:00,39,21,18,FMN 16 Noorderlaanbrug
676,Noorderlaan,2022-12-18,19:00:00,30,14,16,FMN 16 Noorderlaanbrug
676,Noorderlaan,2022-12-18,20:00:00,23,12,11,FMN 16 Noorderlaanbrug
676,Noorderlaan,2022-12-18,21:00:00,24,13,11,FMN 16 Noorderlaanbrug
676,Noorderlaan,2022-12-18,22:00:00,18,6,12,FMN 16 Noorderlaanbrug
676,Noorderlaan,2022-12-18,23:00:00,17,9,8,FMN 16 Noorderlaanbrug
676,Noorderlaan,2022-12-19,00:00:00,7,4,3,FMN 16 Noorderlaanbrug
676,Noorderlaan,2022-12-19,01:00:00,5,1,4,FMN 16 Noorderlaanbrug
676,Noorderlaan,2022-12-19,02:00:00,2,2,0,FMN 16 Noorderlaanbrug
676,Noorderlaan,2022-12-19,03:00:00,6,4,2,FMN 16 Noorderlaanbrug
676,Noorderlaan,2022-12-19,04:00:00,19,10,9,FMN 16 Noorderlaanbrug
676,Noorderlaan,2022-12-19,05:00:00,58,25,33,FMN 16 Noorderlaanbrug
676,Noorderlaan,2022-12-19,06:00:00,104,55,49,FMN 16 Noorderlaanbrug
676,Noorderlaan,2022-12-19,07:00:00,237,158,79,FMN 16 Noorderlaanbrug
676,Noorderlaan,2022-12-19,08:00:00,320,227,93,FMN 16 Noorderlaanbrug
676,Noorderlaan,2022-12-19,09:00:00,97,69,28,FMN 16 Noorderlaanbrug
676,Noorderlaan,2022-12-19,10:00:00,82,53,29,FMN 16 Noorderlaanbrug
676,Noorderlaan,2022-12-19,11:00:00,65,41,24,FMN 16 Noorderlaanbrug
676,Noorderlaan,2022-12-19,12:00:00,101,58,43,FMN 16 Noorderlaanbrug
676,Noorderlaan,2022-12-19,13:00:00,114,53,61,FMN 16 Noorderlaanbrug
676,Noorderlaan,2022-12-19,14:00:00,112,66,46,FMN 16 Noorderlaanbrug
676,Noorderlaan,2022-12-19,15:00:00,171,91,80,FMN 16 Noorderlaanbrug
676,Noorderlaan,2022-12-19,16:00:00,268,130,138,FMN 16 Noorderlaanbrug
676,Noorderlaan,2022-12-19,17:00:00,272,125,147,FMN 16 Noorderlaanbrug
676,Noorderlaan,2022-12-19,18:00:00,127,51,76,FMN 16 Noorderlaanbrug
676,Noorderlaan,2022-12-19,19:00:00,57,32,25,FMN 16 Noorderlaanbrug
676,Noorderlaan,2022-12-19,20:00:00,44,24,20,FMN 16 Noorderlaanbrug
676,Noorderlaan,2022-12-19,21:00:00,41,19,22,FMN 16 Noorderlaanbrug
676,Noorderlaan,2022-12-19,22:00:00,49,30,19,FMN 16 Noorderlaanbrug
676,Noorderlaan,2022-12-19,23:00:00,20,12,8,FMN 16 Noorderlaanbrug
676,Noorderlaan,2022-12-20,00:00:00,12,6,6,FMN 16 Noorderlaanbrug
676,Noorderlaan,2022-12-20,01:00:00,7,5,2,FMN 16 Noorderlaanbrug
676,Noorderlaan,2022-12-20,02:00:00,4,2,2,FMN 16 Noorderlaanbrug
676,Noorderlaan,2022-12-20,03:00:00,10,8,2,FMN 16 Noorderlaanbrug
676,Noorderlaan,2022-12-20,04:00:00,25,15,10,FMN 16 Noorderlaanbrug
676,Noorderlaan,2022-12-20,05:00:00,69,29,40,FMN 16 Noorderlaanbrug
676,Noorderlaan,2022-12-20,06:00:00,127,70,57,FMN 16 Noorderlaanbrug
676,Noorderlaan,2022-12-20,07:00:00,325,223,102,FMN 16 Noorderlaanbrug
676,Noorderlaan,2022-12-20,08:00:00,409,304,105,FMN 16 Noorderlaanbrug
676,Noorderlaan,2022-12-20,09:00:00,139,105,34,FMN 16 Noorderlaanbrug
676,Noorderlaan,2022-12-20,10:00:00,94,67,27,FMN 16 Noorderlaanbrug
676,Noorderlaan,2022-12-20,11:00:00,78,48,30,FMN 16 Noorderlaanbrug
676,Noorderlaan,2022-12-20,12:00:00,130,74,56,FMN 16 Noorderlaanbrug
676,Noorderlaan,2022-12-20,13:00:00,121,60,61,FMN 16 Noorderlaanbrug
676,Noorderlaan,2022-12-20,14:00:00,125,77,48,FMN 16 Noorderlaanbrug
676,Noorderlaan,2022-12-20,15:00:00,194,100,94,FMN 16 Noorderlaanbrug
676,Noorderlaan,2022-12-20,16:00:00,346,178,168,FMN 16 Noorderlaanbrug
676,Noorderlaan,2022-12-20,17:00:00,341,162,179,FMN 16 Noorderlaanbrug
676,Noorderlaan,2022-12-20,18:00:00,179,83,96,FMN 16 Noorderlaanbrug
676,Noorderlaan,2022-12-20,19:00:00,84,47,37,FMN 16 Noorderlaanbrug
676,Noorderlaan,2022-12-20,20:00:00,50,28,22,FMN 16 Noorderlaanbrug
676,Noorderlaan,2022-12-20,21:00:00,48,26,22,FMN 16 Noorderlaanbrug
676,Noorderlaan,2022-12-20,22:00:00,71,41,30,FMN 16 Noorderlaanbrug
676,Noorderlaan,2022-12-20,23:00:00,23,15,8,FMN 16 Noorderlaanbrug
676,Noorderlaan,2022-12-21,00:00:00,9,3,6,FMN 16 Noorderlaanbrug
676,Noorderlaan,2022-12-21,01:00:00,4,2,2,FMN 16 Noorderlaanbrug
676,Noorderlaan,2022-12-21,02:00:00,6,3,3,FMN 16 Noorderlaanbrug
676,Noorderlaan,2022-12-21,03:00:00,10,6,4,FMN 16 Noorderlaanbrug
676,Noorderlaan,2022-12-21,04:00:00,16,9,7,FMN 16 Noorderlaanbrug
676,Noorderlaan,2022-12-21,05:00:00,56,20,36,FMN 16 Noorderlaanbrug
676,Noorderlaan,2022-12-21,06:00:00,76,39,37,FMN 16 Noorderlaanbrug
676,Noorderlaan,2022-12-21,07:00:00,201,128,73,FMN 16 Noorderlaanbrug
676,Noorderlaan,2022-12-21,08:00:00,248,169,79,FMN 16 Noorderlaanbrug
676,Noorderlaan,2022-12-21,09:00:00,85,61,24,FMN 16 Noorderlaanbrug
676,Noorderlaan,2022-12-21,10:00:00,65,45,20,FMN 16 Noorderlaanbrug
676,Noorderlaan,2022-12-21,11:00:00,62,33,29,FMN 16 Noorderlaanbrug
676,Noorderlaan,2022-12-21,12:00:00,133,66,67,FMN 16 Noorderlaanbrug
676,Noorderlaan,2022-12-21,13:00:00,115,58,57,FMN 16 Noorderlaanbrug
676,Noorderlaan,2022-12-21,14:00:00,106,66,40,FMN 16 Noorderlaanbrug
676,Noorderlaan,2022-12-21,15:00:00,158,90,68,FMN 16 Noorderlaanbrug
676,Noorderlaan,2022-12-21,16:00:00,238,132,106,FMN 16 Noorderlaanbrug
676,Noorderlaan,2022-12-21,17:00:00,274,140,134,FMN 16 Noorderlaanbrug
676,Noorderlaan,2022-12-21,18:00:00,149,72,77,FMN 16 Noorderlaanbrug
676,Noorderlaan,2022-12-21,19:00:00,85,44,41,FMN 16 Noorderlaanbrug
676,Noorderlaan,2022-12-21,20:00:00,51,29,22,FMN 16 Noorderlaanbrug
676,Noorderlaan,2022-12-21,21:00:00,53,27,26,FMN 16 Noorderlaanbrug
676,Noorderlaan,2022-12-21,22:00:00,56,31,25,FMN 16 Noorderlaanbrug
676,Noorderlaan,2022-12-21,23:00:00,27,12,15,FMN 16 Noorderlaanbrug
676,Noorderlaan,2022-12-22,00:00:00,20,9,11,FMN 16 Noorderlaanbrug
676,Noorderlaan,2022-12-22,01:00:00,13,7,6,FMN 16 Noorderlaanbrug
676,Noorderlaan,2022-12-22,02:00:00,10,7,3,FMN 16 Noorderlaanbrug
676,Noorderlaan,2022-12-22,03:00:00,15,13,2,FMN 16 Noorderlaanbrug
676,Noorderlaan,2022-12-22,04:00:00,24,15,9,FMN 16 Noorderlaanbrug
676,Noorderlaan,2022-12-22,05:00:00,65,26,39,FMN 16 Noorderlaanbrug
676,Noorderlaan,2022-12-22,06:00:00,96,50,46,FMN 16 Noorderlaanbrug
676,Noorderlaan,2022-12-22,07:00:00,244,160,84,FMN 16 Noorderlaanbrug
676,Noorderlaan,2022-12-22,08:00:00,322,233,89,FMN 16 Noorderlaanbrug
676,Noorderlaan,2022-12-22,09:00:00,110,77,33,FMN 16 Noorderlaanbrug
676,Noorderlaan,2022-12-22,10:00:00,79,54,25,FMN 16 Noorderlaanbrug
676,Noorderlaan,2022-12-22,11:00:00,66,42,24,FMN 16 Noorderlaanbrug
676,Noorderlaan,2022-12-22,12:00:00,106,61,45,FMN 16 Noorderlaanbrug
676,Noorderlaan,2022-12-22,13:00:00,99,51,48,FMN 16 Noorderlaanbrug
676,Noorderlaan,2022-12-22,14:00:00,118,68,50,FMN 16 Noorderlaanbrug
676,Noorderlaan,2022-12-22,15:00:00,154,80,74,FMN 16 Noorderlaanbrug
676,Noorderlaan,2022-12-22,16:00:00,256,126,130,FMN 16 Noorderlaanbrug
676,Noorderlaan,2022-12-22,17:00:00,253,121,132,FMN 16 Noorderlaanbrug
676,Noorderlaan,2022-12-22,18:00:00,133,65,68,FMN 16 Noorderlaanbrug
676,Noorderlaan,2022-12-22,19:00:00,63,31,32,FMN 16 Noorderlaanbrug
676,Noorderlaan,2022-12-22,20:00:00,45,22,23,FMN 16 Noorderlaanbrug
676,Noorderlaan,2022-12-22,21:00:00,44,18,26,FMN 16 Noorderlaanbrug
676,Noorderlaan,2022-12-22,22:00:00,48,24,24,FMN 16 Noorderlaanbrug
676,Noorderlaan,2022-12-22,23:00:00,28,14,14,FMN 16 Noorderlaanbrug
676,Noorderlaan,2022-12-23,00:00:00,47,22,25,FMN 16 Noorderlaanbrug
676,Noorderlaan,2022-12-23,01:00:00,29,11,18,FMN 16 Noorderlaanbrug
676,Noorderlaan,2022-12-23,02:00:00,20,10,10,FMN 16 Noorderlaanbrug
676,Noorderlaan,2022-12-23,03:00:00,28,15,13,FMN 16 Noorderlaanbrug
676,Noorderlaan,2022-12-23,04:00:00,45,21,24,FMN 16 Noorderlaanbrug
676,Noorderlaan,2022-12-23,05:00:00,118,39,79,FMN 16 Noorderlaanbrug
676,Noorderlaan,2022-12-23,06:00:00,148,71,77,FMN 16 Noorderlaanbrug
676,Noorderlaan,2022-12-23,07:00:00,340,203,137,FMN 16 Noorderlaanbrug
676,Noorderlaan,2022-12-23,08:00:00,447,303,144,FMN 16 Noorderlaanbrug
676,Noorderlaan,2022-12-23,09:00:00,179,129,50,FMN 16 Noorderlaanbrug
676,Noorderlaan,2022-12-23,10:00:00,135,87,48,FMN 16 Noorderlaanbrug
676,Noorderlaan,2022-12-23,11:00:00,143,85,58,FMN 16 Noorderlaanbrug
676,Noorderlaan,2022-12-23,12:00:00,194,104,90,FMN 16 Noorderlaanbrug
676,Noorderlaan,2022-12-23,13:00:00,207,108,99,FMN 16 Noorderlaanbrug
676,Noorderlaan,2022-12-23,14:00:00,211,114,97,FMN 16 Noorderlaanbrug
676,Noorderlaan,2022-12-23,15:00:00,304,135,169,FMN 16 Noorderlaanbrug
676,Noorderlaan,2022-12-23,16:00:00,413,203,210,FMN 16 Noorderlaanbrug
676,Noorderlaan,2022-12-23,17:00:00,320,140,180,FMN 16 Noorderlaanbrug
676,Noorderlaan,2022-12-23,18:00:00,220,108,112,FMN 16 Noorderlaanbrug
676,Noorderlaan,2022-12-23,19:00:00,138,73,65,FMN 16 Noorderlaanbrug
676,Noorderlaan,2022-12-23,20:00:00,95,51,44,FMN 16 Noorderlaanbrug
676,Noorderlaan,2022-12-23,21:00:00,91,40,51,FMN 16 Noorderlaanbrug
676,Noorderlaan,2022-12-23,22:00:00,86,50,36,FMN 16 Noorderlaanbrug
676,Noorderlaan,2022-12-23,23:00:00,73,34,39,FMN 16 Noorderlaanbrug
676,Noorderlaan,2022-12-24,00:00:00,35,15,20,FMN 16 Noorderlaanbrug
676,Noorderlaan,2022-12-24,01:00:00,27,12,15,FMN 16 Noorderlaanbrug
676,Noorderlaan,2022-12-24,02:00:00,15,7,8,FMN 16 Noorderlaanbrug
676,Noorderlaan,2022-12-24,03:00:00,14,7,7,FMN 16 Noorderlaanbrug
676,Noorderlaan,2022-12-24,04:00:00,12,7,5,FMN 16 Noorderlaanbrug
676,Noorderlaan,2022-12-24,05:00:00,22,7,15,FMN 16 Noorderlaanbrug
676,Noorderlaan,2022-12-24,06:00:00,25,12,13,FMN 16 Noorderlaanbrug
676,Noorderlaan,2022-12-24,07:00:00,22,13,9,FMN 16 Noorderlaanbrug
676,Noorderlaan,2022-12-24,08:00:00,26,17,9,FMN 16 Noorderlaanbrug
676,Noorderlaan,2022-12-24,09:00:00,45,33,12,FMN 16 Noorderlaanbrug
676,Noorderlaan,2022-12-24,10:00:00,47,33,14,FMN 16 Noorderlaanbrug
676,Noorderlaan,2022-12-24,11:00:00,67,42,25,FMN 16 Noorderlaanbrug
676,Noorderlaan,2022-12-24,12:00:00,80,51,29,FMN 16 Noorderlaanbrug
676,Noorderlaan,2022-12-24,13:00:00,96,64,32,FMN 16 Noorderlaanbrug
676,Noorderlaan,2022-12-24,14:00:00,96,58,38,FMN 16 Noorderlaanbrug
676,Noorderlaan,2022-12-24,15:00:00,98,48,50,FMN 16 Noorderlaanbrug
676,Noorderlaan,2022-12-24,16:00:00,91,49,42,FMN 16 Noorderlaanbrug
676,Noorderlaan,2022-12-24,17:00:00,79,40,39,FMN 16 Noorderlaanbrug
676,Noorderlaan,2022-12-24,18:00:00,73,36,37,FMN 16 Noorderlaanbrug
676,Noorderlaan,2022-12-24,19:00:00,58,25,33,FMN 16 Noorderlaanbrug
676,Noorderlaan,2022-12-24,20:00:00,36,23,13,FMN 16 Noorderlaanbrug
676,Noorderlaan,2022-12-24,21:00:00,29,14,15,FMN 16 Noorderlaanbrug
676,Noorderlaan,2022-12-24,22:00:00,35,16,19,FMN 16 Noorderlaanbrug
676,Noorderlaan,2022-12-24,23:00:00,32,15,17,FMN 16 Noorderlaanbrug
676,Noorderlaan,2022-12-25,00:00:00,28,16,12,FMN 16 Noorderlaanbrug
676,Noorderlaan,2022-12-25,01:00:00,24,9,15,FMN 16 Noorderlaanbrug
676,Noorderlaan,2022-12-25,02:00:00,12,4,8,FMN 16 Noorderlaanbrug
676,Noorderlaan,2022-12-25,03:00:00,14,6,8,FMN 16 Noorderlaanbrug
676,Noorderlaan,2022-12-25,04:00:00,13,7,6,FMN 16 Noorderlaanbrug
676,Noorderlaan,2022-12-25,05:00:00,17,7,10,FMN 16 Noorderlaanbrug
676,Noorderlaan,2022-12-25,06:00:00,18,8,10,FMN 16 Noorderlaanbrug
676,Noorderlaan,2022-12-25,07:00:00,14,9,5,FMN 16 Noorderlaanbrug
676,Noorderlaan,2022-12-25,08:00:00,18,13,5,FMN 16 Noorderlaanbrug
676,Noorderlaan,2022-12-25,09:00:00,27,17,10,FMN 16 Noorderlaanbrug
676,Noorderlaan,2022-12-25,10:00:00,34,24,10,FMN 16 Noorderlaanbrug
676,Noorderlaan,2022-12-25,11:00:00,45,29,16,FMN 16 Noorderlaanbrug
676,Noorderlaan,2022-12-25,12:00:00,41,25,16,FMN 16 Noorderlaanbrug
676,Noorderlaan,2022-12-25,13:00:00,54,30,24,FMN 16 Noorderlaanbrug
676,Noorderlaan,2022-12-25,14:00:00,48,32,16,FMN 16 Noorderlaanbrug
676,Noorderlaan,2022-12-25,15:00:00,58,28,30,FMN 16 Noorderlaanbrug
676,Noorderlaan,2022-12-25,16:00:00,54,25,29,FMN 16 Noorderlaanbrug
676,Noorderlaan,2022-12-25,17:00:00,36,14,22,FMN 16 Noorderlaanbrug
676,Noorderlaan,2022-12-25,18:00:00,41,22,19,FMN 16 Noorderlaanbrug
676,Noorderlaan,2022-12-25,19:00:00,30,14,16,FMN 16 Noorderlaanbrug
676,Noorderlaan,2022-12-25,20:00:00,25,13,12,FMN 16 Noorderlaanbrug
676,Noorderlaan,2022-12-25,21:00:00,24,13,11,FMN 16 Noorderlaanbrug
676,Noorderlaan,2022-12-25,22:00:00,19,7,12,FMN 16 Noorderlaanbrug
676,Noorderlaan,2022-12-25,23:00:00,18,9,9,FMN 16 Noorderlaanbrug
676,Noorderlaan,2022-12-26,00:00:00,7,4,3,FMN 16 Noorderlaanbrug
676,Noorderlaan,2022-12-26,01:00:00,5,1,4,FMN 16 Noorderlaanbrug
676,Noorderlaan,2022-12-26,02:00:00,3,2,1,FMN 16 Noorderlaanbrug
676,Noorderlaan,2022-12-26,03:00:00,7,5,2,FMN 16 Noorderlaanbrug
676,Noorderlaan,2022-12-26,04:00:00,20,11,9,FMN 16 Noorderlaanbrug
676,Noorderlaan,2022-12-26,05:00:00,64,27,37,FMN 16 Noorderlaanbrug
676,Noorderlaan,2022-12-26,06:00:00,110,58,52,FMN 16 Noorderlaanbrug
676,Noorderlaan,2022-12-26,07:00:00,257,171,86,FMN 16 Noorderlaanbrug
676,Noorderlaan,2022-12-26,08:00:00,344,245,99,FMN 16 Noorderlaanbrug
676,Noorderlaan,2022-12-26,09:00:00,105,74,31,FMN 16 Noorderlaanbrug
676,Noorderlaan,2022-12-26,10:00:00,88,57,31,FMN 16 Noorderlaanbrug
676,Noorderlaan,2022-12-26,11:00:00,70,44,26,FMN 16 Noorderlaanbrug
676,Noorderlaan,2022-12-26,12:00:00,110,63,47,FMN 16 Noorderlaanbrug
676,Noorderlaan,2022-12-26,13:00:00,123,57,66,FMN 16 Noorderlaanbrug
676,Noorderlaan,2022-12-26,14:00:00,120,71,49,FMN 16 Noorderlaanbrug
676,Noorderlaan,2022-12-26,15:00:00,184,98,86,FMN 16 Noorderlaanbrug
676,Noorderlaan,2022-12-26,16:00:00,290,140,150,FMN 16 Noorderlaanbrug
676,Noorderlaan,2022-12-26,17:00:00,293,135,158,FMN 16 Noorderlaanbrug
676,Noorderlaan,2022-12-26,18:00:00,138,55,83,FMN 16 Noorderlaanbrug
676,Noorderlaan,2022-12-26,19:00:00,61,34,27,FMN 16 Noorderlaanbrug
676,Noorderlaan,2022-12-26,20:00:00,48,26,22,FMN 16 Noorderlaanbrug
676,Noorderlaan,2022-12-26,21:00:00,44,21,23,FMN 16 Noorderlaanbrug
676,Noorderlaan,2022-12-26,22:00:00,52,32,20,FMN 16 Noorderlaanbrug
676,Noorderlaan,2022-12-26,23:00:00,22,13,9,FMN 16 Noorderlaanbrug
676,Noorderlaan,2022-12-27,00:00:00,12,6,6,FMN 16 Noorderlaanbrug
676,Noorderlaan,2022-12-27,01:00:00,7,5,2,FMN 16 Noorderlaanbrug
676,Noorderlaan,2022-12-27,02:00:00,4,2,2,FMN 16 Noorderlaanbrug
676,Noorderlaan,2022-12-27,03:00:00,10,8,2,FMN 16 Noorderlaanbrug
676,Noorderlaan,2022-12-27,04:00:00,25,15,10,FMN 16 Noorderlaanbrug
676,Noorderlaan,2022-12-27,05:00:00,69,29,40,FMN 16 Noorderlaanbrug
676,Noorderlaan,2022-12-27,06:00:00,128,71,57,FMN 16 Noorderlaanbrug
676,Noorderlaan,2022-12-27,07:00:00,326,223,103,FMN 16 Noorderlaanbrug
676,Noorderlaan,2022-12-27,08:00:00,410,305,105,FMN 16 Noorderlaanbrug
676,Noorderlaan,2022-12-27,09:00:00,140,105,35,FMN 16 Noorderlaanbrug
676,Noorderlaan,2022-12-27,10:00:00,94,67,27,FMN 16 Noorderlaanbrug
676,Noorderlaan,2022-12-27,11:00:00,78,48,30,FMN 16 Noorderlaanbrug
676,Noorderlaan,2022-12-27,12:00:00,130,74,56,FMN 16 Noorderlaanbrug
676,Noorderlaan,2022-12-27,13:00:00,121,60,61,FMN 16 Noorderlaanbrug
676,Noorderlaan,2022-12-27,14:00:00,125,77,48,FMN 16 Noorderlaanbrug
676,Noorderlaan,2022-12-27,15:00:00,194,100,94,FMN 16 Noorderlaanbrug
676,Noorderlaan,2022-12-27,16:00:00,348,179,169,FMN 16 Noorderlaanbrug
676,Noorderlaan,2022-12-27,17:00:00,343,162,181,FMN 16 Noorderlaanbrug
676,Noorderlaan,2022-12-27,18:00:00,179,83,96,FMN 16 Noorderlaanbrug
676,Noorderlaan,2022-12-27,19:00:00,84,48,36,FMN 16 Noorderlaanbrug
676,Noorderlaan,2022-12-27,20:00:00,51,28,23,FMN 16 Noorderlaanbrug
676,Noorderlaan,2022-12-27,21:00:00,48,26,22,FMN 16 Noorderlaanbrug
676,Noorderlaan,2022-12-27,22:00:00,71,41,30,FMN 16 Noorderlaanbrug
676,Noorderlaan,2022-12-27,23:00:00,23,15,8,FMN 16 Noorderlaanbrug
676,Noorderlaan,2022-12-28,00:00:00,6,2,4,FMN 16 Noorderlaanbrug
676,Noorderlaan,2022-12-28,01:00:00,3,1,2,FMN 16 Noorderlaanbrug
676,Noorderlaan,2022-12-28,02:00:00,4,2,2,FMN 16 Noorderlaanbrug
676,Noorderlaan,2022-12-28,03:00:00,7,5,2,FMN 16 Noorderlaanbrug
676,Noorderlaan,2022-12-28,04:00:00,11,6,5,FMN 16 Noorderlaanbrug
676,Noorderlaan,2022-12-28,05:00:00,40,14,26,FMN 16 Noorderlaanbrug
676,Noorderlaan,2022-12-28,06:00:00,53,27,26,FMN 16 Noorderlaanbrug
676,Noorderlaan,2022-12-28,07:00:00,140,88,52,FMN 16 Noorderlaanbrug
676,Noorderlaan,2022-12-28,08:00:00,174,118,56,FMN 16 Noorderlaanbrug
676,Noorderlaan,2022-12-28,09:00:00,58,42,16,FMN 16 Noorderlaanbrug
676,Noorderlaan,2022-12-28,10:00:00,45,31,14,FMN 16 Noorderlaanbrug
676,Noorderlaan,2022-12-28,11:00:00,43,23,20,FMN 16 Noorderlaanbrug
676,Noorderlaan,2022-12-28,12:00:00,94,46,48,FMN 16 Noorderlaanbrug
676,Noorderlaan,2022-12-28,13:00:00,80,40,40,FMN 16 Noorderlaanbrug
676,Noorderlaan,2022-12-28,14:00:00,75,46,29,FMN 16 Noorderlaanbrug
676,Noorderlaan,2022-12-28,15:00:00,109,62,47,FMN 16 Noorderlaanbrug
676,Noorderlaan,2022-12-28,16:00:00,167,92,75,FMN 16 Noorderlaanbrug
676,Noorderlaan,2022-12-28,17:00:00,192,97,95,FMN 16 Noorderlaanbrug
676,Noorderlaan,2022-12-28,18:00:00,104,50,54,FMN 16 Noorderlaanbrug
676,Noorderlaan,2022-12-28,19:00:00,59,30,29,FMN 16 Noorderlaanbrug
676,Noorderlaan,2022-12-28,20:00:00,35,20,15,FMN 16 Noorderlaanbrug
676,Noorderlaan,2022-12-28,21:00:00,38,19,19,FMN 16 Noorderlaanbrug
676,Noorderlaan,2022-12-28,22:00:00,39,22,17,FMN 16 Noorderlaanbrug
676,Noorderlaan,2022-12-28,23:00:00,19,8,11,FMN 16 Noorderlaanbrug
676,Noorderlaan,2022-12-29,00:00:00,21,9,12,FMN 16 Noorderlaanbrug
676,Noorderlaan,2022-12-29,01:00:00,14,8,6,FMN 16 Noorderlaanbrug
676,Noorderlaan,2022-12-29,02:00:00,11,8,3,FMN 16 Noorderlaanbrug
676,Noorderlaan,2022-12-29,03:00:00,17,14,3,FMN 16 Noorderlaanbrug
676,Noorderlaan,2022-12-29,04:00:00,24,15,9,FMN 16 Noorderlaanbrug
676,Noorderlaan,2022-12-29,05:00:00,71,29,42,FMN 16 Noorderlaanbrug
676,Noorderlaan,2022-12-29,06:00:00,102,53,49,FMN 16 Noorderlaanbrug
676,Noorderlaan,2022-12-29,07:00:00,262,172,90,FMN 16 Noorderlaanbrug
676,Noorderlaan,2022-12-29,08:00:00,344,250,94,FMN 16 Noorderlaanbrug
676,Noorderlaan,2022-12-29,09:00:00,119,83,36,FMN 16 Noorderlaanbrug
676,Noorderlaan,2022-12-29,10:00:00,85,58,27,FMN 16 Noorderlaanbrug
676,Noorderlaan,2022-12-29,11:00:00,70,45,25,FMN 16 Noorderlaanbrug
676,Noorderlaan,2022-12-29,12:00:00,112,65,47,FMN 16 Noorderlaanbrug
676,Noorderlaan,2022-12-29,13:00:00,107,55,52,FMN 16 Noorderlaanbrug
676,Noorderlaan,2022-12-29,14:00:00,126,73,53,FMN 16 Noorderlaanbrug
676,Noorderlaan,2022-12-29,15:00:00,165,86,79,FMN 16 Noorderlaanbrug
676,Noorderlaan,2022-12-29,16:00:00,274,135,139,FMN 16 Noorderlaanbrug
676,Noorderlaan,2022-12-29,17:00:00,271,130,141,FMN 16 Noorderlaanbrug
676,Noorderlaan,2022-12-29,18:00:00,142,70,72,FMN 16 Noorderlaanbrug
676,Noorderlaan,2022-12-29,19:00:00,67,33,34,FMN 16 Noorderlaanbrug
676,Noorderlaan,2022-12-29,20:00:00,48,23,25,FMN 16 Noorderlaanbrug
676,Noorderlaan,2022-12-29,21:00:00,48,20,28,FMN 16 Noorderlaanbrug
676,Noorderlaan,2022-12-29,22:00:00,51,26,25,FMN 16 Noorderlaanbrug
676,Noorderlaan,2022-12-29,23:00:00,30,15,15,FMN 16 Noorderlaanbrug
676,Noorderlaan,2022-12-30,00:00:00,47,22,25,FMN 16 Noorderlaanbrug
676,Noorderlaan,2022-12-30,01:00:00,30,11,19,FMN 16 Noorderlaanbrug
676,Noorderlaan,2022-12-30,02:00:00,20,10,10,FMN 16 Noorderlaanbrug
676,Noorderlaan,2022-12-30,03:00:00,28,15,13,FMN 16 Noorderlaanbrug
676,Noorderlaan,2022-12-30,04:00:00,46,22,24,FMN 16 Noorderlaanbrug
676,Noorderlaan,2022-12-30,05:00:00,119,39,80,FMN 16 Noorderlaanbrug
676,Noorderlaan,2022-12-30,06:00:00,151,72,79,FMN 16 Noorderlaanbrug
676,Noorderlaan,2022-12-30,07:00:00,343,205,138,FMN 16 Noorderlaanbrug
676,Noorderlaan,2022-12-30,08:00:00,452,306,146,FMN 16 Noorderlaanbrug
676,Noorderlaan,2022-12-30,09:00:00,181,130,51,FMN 16 Noorderlaanbrug
676,Noorderlaan,2022-12-30,10:00:00,137,88,49,FMN 16 Noorderlaanbrug
676,Noorderlaan,2022-12-30,11:00:00,145,86,59,FMN 16 Noorderlaanbrug
676,Noorderlaan,2022-12-30,12:00:00,196,105,91,FMN 16 Noorderlaanbrug
676,Noorderlaan,2022-12-30,13:00:00,209,109,100,FMN 16 Noorderlaanbrug
676,Noorderlaan,2022-12-30,14:00:00,213,115,98,FMN 16 Noorderlaanbrug
676,Noorderlaan,2022-12-30,15:00:00,307,136,171,FMN 16 Noorderlaanbrug
676,Noorderlaan,2022-12-30,16:00:00,418,205,213,FMN 16 Noorderlaanbrug
676,Noorderlaan,2022-12-30,17:00:00,325,142,183,FMN 16 Noorderlaanbrug
676,Noorderlaan,2022-12-30,18:00:00,222,109,113,FMN 16 Noorderlaanbrug
676,Noorderlaan,2022-12-30,19:00:00,140,74,66,FMN 16 Noorderlaanbrug
676,Noorderlaan,2022-12-30,20:00:00,96,51,45,FMN 16 Noorderlaanbrug
676,Noorderlaan,2022-12-30,21:00:00,92,40,52,FMN 16 Noorderlaanbrug
676,Noorderlaan,2022-12-30,22:00:00,88,51,37,FMN 16 Noorderlaanbrug
676,Noorderlaan,2022-12-30,23:00:00,73,34,39,FMN 16 Noorderlaanbrug
676,Noorderlaan,2022-12-31,00:00:00,29,12,17,FMN 16 Noorderlaanbrug
676,Noorderlaan,2022-12-31,01:00:00,24,10,14,FMN 16 Noorderlaanbrug
676,Noorderlaan,2022-12-31,02:00:00,13,6,7,FMN 16 Noorderlaanbrug
676,Noorderlaan,2022-12-31,03:00:00,12,6,6,FMN 16 Noorderlaanbrug
676,Noorderlaan,2022-12-31,04:00:00,10,6,4,FMN 16 Noorderlaanbrug
676,Noorderlaan,2022-12-31,05:00:00,19,5,14,FMN 16 Noorderlaanbrug
676,Noorderlaan,2022-12-31,06:00:00,21,10,11,FMN 16 Noorderlaanbrug
676,Noorderlaan,2022-12-31,07:00:00,18,11,7,FMN 16 Noorderlaanbrug
676,Noorderlaan,2022-12-31,08:00:00,22,14,8,FMN 16 Noorderlaanbrug
676,Noorderlaan,2022-12-31,09:00:00,38,27,11,FMN 16 Noorderlaanbrug
676,Noorderlaan,2022-12-31,10:00:00,40,28,12,FMN 16 Noorderlaanbrug
676,Noorderlaan,2022-12-31,11:00:00,56,34,22,FMN 16 Noorderlaanbrug
676,Noorderlaan,2022-12-31,12:00:00,67,42,25,FMN 16 Noorderlaanbrug
676,Noorderlaan,2022-12-31,13:00:00,81,53,28,FMN 16 Noorderlaanbrug
676,Noorderlaan,2022-12-31,14:00:00,81,48,33,FMN 16 Noorderlaanbrug
676,Noorderlaan,2022-12-31,15:00:00,83,39,44,FMN 16 Noorderlaanbrug
676,Noorderlaan,2022-12-31,16:00:00,77,40,37,FMN 16 Noorderlaanbrug
676,Noorderlaan,2022-12-31,17:00:00,68,34,34,FMN 16 Noorderlaanbrug
676,Noorderlaan,2022-12-31,18:00:00,61,29,32,FMN 16 Noorderlaanbrug
676,Noorderlaan,2022-12-31,19:00:00,50,21,29,FMN 16 Noorderlaanbrug
676,Noorderlaan,2022-12-31,20:00:00,30,19,11,FMN 16 Noorderlaanbrug
676,Noorderlaan,2022-12-31,21:00:00,26,12,14,FMN 16 Noorderlaanbrug
676,Noorderlaan,2022-12-31,22:00:00,30,13,17,FMN 16 Noorderlaanbrug
676,Noorderlaan,2022-12-31,23:00:00,26,12,14,FMN 16 Noorderlaanbrug
676,Noorderlaan,2023-01-01,00:00:00,42,18,24,FMN 16 Noorderlaanbrug
676,Noorderlaan,2023-01-01,01:00:00,64,10,54,FMN 16 Noorderlaanbrug
676,Noorderlaan,2023-01-01,02:00:00,24,5,19,FMN 16 Noorderlaanbrug
676,Noorderlaan,2023-01-01,03:00:00,25,7,18,FMN 16 Noorderlaanbrug
676,Noorderlaan,2023-01-01,04:00:00,16,7,9,FMN 16 Noorderlaanbrug
676,Noorderlaan,2023-01-01,05:00:00,28,8,20,FMN 16 Noorderlaanbrug
676,Noorderlaan,2023-01-01,06:00:00,20,9,11,FMN 16 Noorderlaanbrug
676,Noorderlaan,2023-01-01,07:00:00,16,10,6,FMN 16 Noorderlaanbrug
676,Noorderlaan,2023-01-01,08:00:00,18,15,3,FMN 16 Noorderlaanbrug
676,Noorderlaan,2023-01-01,09:00:00,24,20,4,FMN 16 Noorderlaanbrug
676,Noorderlaan,2023-01-01,10:00:00,33,27,6,FMN 16 Noorderlaanbrug
676,Noorderlaan,2023-01-01,11:00:00,40,33,7,FMN 16 Noorderlaanbrug
676,Noorderlaan,2023-01-01,12:00:00,46,28,18,FMN 16 Noorderlaanbrug
676,Noorderlaan,2023-01-01,13:00:00,50,34,16,FMN 16 Noorderlaanbrug
676,Noorderlaan,2023-01-01,14:00:00,49,36,13,FMN 16 Noorderlaanbrug
676,Noorderlaan,2023-01-01,15:00:00,49,31,18,FMN 16 Noorderlaanbrug
676,Noorderlaan,2023-01-01,16:00:00,38,29,9,FMN 16 Noorderlaanbrug
676,Noorderlaan,2023-01-01,17:00:00,28,16,12,FMN 16 Noorderlaanbrug
676,Noorderlaan,2023-01-01,18:00:00,37,24,13,FMN 16 Noorderlaanbrug
676,Noorderlaan,2023-01-01,19:00:00,29,17,12,FMN 16 Noorderlaanbrug
676,Noorderlaan,2023-01-01,20:00:00,18,14,4,FMN 16 Noorderlaanbrug
676,Noorderlaan,2023-01-01,21:00:00,24,15,9,FMN 16 Noorderlaanbrug
676,Noorderlaan,2023-01-01,22:00:00,14,8,6,FMN 16 Noorderlaanbrug
676,Noorderlaan,2023-01-01,23:00:00,13,10,3,FMN 16 Noorderlaanbrug
676,Noorderlaan,2023-01-02,00:00:00,6,4,2,FMN 16 Noorderlaanbrug
676,Noorderlaan,2023-01-02,01:00:00,4,1,3,FMN 16 Noorderlaanbrug
676,Noorderlaan,2023-01-02,02:00:00,2,2,0,FMN 16 Noorderlaanbrug
676,Noorderlaan,2023-01-02,03:00:00,6,5,1,FMN 16 Noorderlaanbrug
676,Noorderlaan,2023-01-02,04:00:00,12,10,2,FMN 16 Noorderlaanbrug
676,Noorderlaan,2023-01-02,05:00:00,40,26,14,FMN 16 Noorderlaanbrug
676,Noorderlaan,2023-01-02,06:00:00,75,57,18,FMN 16 Noorderlaanbrug
676,Noorderlaan,2023-01-02,07:00:00,189,165,24,FMN 16 Noorderlaanbrug
676,Noorderlaan,2023-01-02,08:00:00,271,237,34,FMN 16 Noorderlaanbrug
676,Noorderlaan,2023-01-02,09:00:00,83,72,11,FMN 16 Noorderlaanbrug
676,Noorderlaan,2023-01-02,10:00:00,71,55,16,FMN 16 Noorderlaanbrug
676,Noorderlaan,2023-01-02,11:00:00,61,42,19,FMN 16 Noorderlaanbrug
676,Noorderlaan,2023-01-02,12:00:00,86,61,25,FMN 16 Noorderlaanbrug
676,Noorderlaan,2023-01-02,13:00:00,107,55,52,FMN 16 Noorderlaanbrug
676,Noorderlaan,2023-01-02,14:00:00,96,69,27,FMN 16 Noorderlaanbrug
676,Noorderlaan,2023-01-02,15:00:00,132,95,37,FMN 16 Noorderlaanbrug
676,Noorderlaan,2023-01-02,16:00:00,176,135,41,FMN 16 Noorderlaanbrug
676,Noorderlaan,2023-01-02,17:00:00,184,131,53,FMN 16 Noorderlaanbrug
676,Noorderlaan,2023-01-02,18:00:00,89,53,36,FMN 16 Noorderlaanbrug
676,Noorderlaan,2023-01-02,19:00:00,48,33,15,FMN 16 Noorderlaanbrug
676,Noorderlaan,2023-01-02,20:00:00,35,25,10,FMN 16 Noorderlaanbrug
676,Noorderlaan,2023-01-02,21:00:00,38,21,17,FMN 16 Noorderlaanbrug
676,Noorderlaan,2023-01-02,22:00:00,44,30,14,FMN 16 Noorderlaanbrug
676,Noorderlaan,2023-01-02,23:00:00,17,13,4,FMN 16 Noorderlaanbrug
676,Noorderlaan,2023-01-03,00:00:00,8,6,2,FMN 16 Noorderlaanbrug
676,Noorderlaan,2023-01-03,01:00:00,8,4,4,FMN 16 Noorderlaanbrug
676,Noorderlaan,2023-01-03,02:00:00,8,3,5,FMN 16 Noorderlaanbrug
676,Noorderlaan,2023-01-03,03:00:00,9,7,2,FMN 16 Noorderlaanbrug
676,Noorderlaan,2023-01-03,04:00:00,26,15,11,FMN 16 Noorderlaanbrug
676,Noorderlaan,2023-01-03,05:00:00,59,29,30,FMN 16 Noorderlaanbrug
676,Noorderlaan,2023-01-03,06:00:00,111,69,42,FMN 16 Noorderlaanbrug
676,Noorderlaan,2023-01-03,07:00:00,286,219,67,FMN 16 Noorderlaanbrug
676,Noorderlaan,2023-01-03,08:00:00,365,299,66,FMN 16 Noorderlaanbrug
676,Noorderlaan,2023-01-03,09:00:00,132,103,29,FMN 16 Noorderlaanbrug
676,Noorderlaan,2023-01-03,10:00:00,78,66,12,FMN 16 Noorderlaanbrug
676,Noorderlaan,2023-01-03,11:00:00,66,47,19,FMN 16 Noorderlaanbrug
676,Noorderlaan,2023-01-03,12:00:00,121,74,47,FMN 16 Noorderlaanbrug
676,Noorderlaan,2023-01-03,13:00:00,92,59,33,FMN 16 Noorderlaanbrug
676,Noorderlaan,2023-01-03,14:00:00,111,75,36,FMN 16 Noorderlaanbrug
676,Noorderlaan,2023-01-03,15:00:00,169,98,71,FMN 16 Noorderlaanbrug
676,Noorderlaan,2023-01-03,16:00:00,269,175,94,FMN 16 Noorderlaanbrug
676,Noorderlaan,2023-01-03,17:00:00,271,160,111,FMN 16 Noorderlaanbrug
676,Noorderlaan,2023-01-03,18:00:00,152,81,71,FMN 16 Noorderlaanbrug
676,Noorderlaan,2023-01-03,19:00:00,95,47,48,FMN 16 Noorderlaanbrug
676,Noorderlaan,2023-01-03,20:00:00,42,27,15,FMN 16 Noorderlaanbrug
676,Noorderlaan,2023-01-03,21:00:00,42,26,16,FMN 16 Noorderlaanbrug
676,Noorderlaan,2023-01-03,22:00:00,60,41,19,FMN 16 Noorderlaanbrug
676,Noorderlaan,2023-01-03,23:00:00,21,14,7,FMN 16 Noorderlaanbrug
676,Noorderlaan,2023-01-04,00:00:00,7,2,5,FMN 16 Noorderlaanbrug
676,Noorderlaan,2023-01-04,01:00:00,5,1,4,FMN 16 Noorderlaanbrug
676,Noorderlaan,2023-01-04,02:00:00,5,2,3,FMN 16 Noorderlaanbrug
676,Noorderlaan,2023-01-04,03:00:00,8,4,4,FMN 16 Noorderlaanbrug
676,Noorderlaan,2023-01-04,04:00:00,22,7,15,FMN 16 Noorderlaanbrug
676,Noorderlaan,2023-01-04,05:00:00,45,13,32,FMN 16 Noorderlaanbrug
676,Noorderlaan,2023-01-04,06:00:00,65,25,40,FMN 16 Noorderlaanbrug
676,Noorderlaan,2023-01-04,07:00:00,138,85,53,FMN 16 Noorderlaanbrug
676,Noorderlaan,2023-01-04,08:00:00,172,113,59,FMN 16 Noorderlaanbrug
676,Noorderlaan,2023-01-04,09:00:00,62,40,22,FMN 16 Noorderlaanbrug
676,Noorderlaan,2023-01-04,10:00:00,39,30,9,FMN 16 Noorderlaanbrug
676,Noorderlaan,2023-01-04,11:00:00,36,22,14,FMN 16 Noorderlaanbrug
676,Noorderlaan,2023-01-04,12:00:00,69,44,25,FMN 16 Noorderlaanbrug
676,Noorderlaan,2023-01-04,13:00:00,64,39,25,FMN 16 Noorderlaanbrug
676,Noorderlaan,2023-01-04,14:00:00,64,44,20,FMN 16 Noorderlaanbrug
676,Noorderlaan,2023-01-04,15:00:00,101,59,42,FMN 16 Noorderlaanbrug
676,Noorderlaan,2023-01-04,16:00:00,142,88,54,FMN 16 Noorderlaanbrug
676,Noorderlaan,2023-01-04,17:00:00,190,93,97,FMN 16 Noorderlaanbrug
676,Noorderlaan,2023-01-04,18:00:00,102,48,54,FMN 16 Noorderlaanbrug
676,Noorderlaan,2023-01-04,19:00:00,49,29,20,FMN 16 Noorderlaanbrug
676,Noorderlaan,2023-01-04,20:00:00,38,19,19,FMN 16 Noorderlaanbrug
676,Noorderlaan,2023-01-04,21:00:00,33,18,15,FMN 16 Noorderlaanbrug
676,Noorderlaan,2023-01-04,22:00:00,34,21,13,FMN 16 Noorderlaanbrug
676,Noorderlaan,2023-01-04,23:00:00,21,8,13,FMN 16 Noorderlaanbrug
676,Noorderlaan,2023-01-05,00:00:00,17,13,4,FMN 16 Noorderlaanbrug
676,Noorderlaan,2023-01-05,01:00:00,9,4,5,FMN 16 Noorderlaanbrug
676,Noorderlaan,2023-01-05,02:00:00,8,6,2,FMN 16 Noorderlaanbrug
676,Noorderlaan,2023-01-05,03:00:00,4,3,1,FMN 16 Noorderlaanbrug
676,Noorderlaan,2023-01-05,04:00:00,23,13,10,FMN 16 Noorderlaanbrug
676,Noorderlaan,2023-01-05,05:00:00,68,24,44,FMN 16 Noorderlaanbrug
676,Noorderlaan,2023-01-05,06:00:00,98,57,41,FMN 16 Noorderlaanbrug
676,Noorderlaan,2023-01-05,07:00:00,185,108,77,FMN 16 Noorderlaanbrug
676,Noorderlaan,2023-01-05,08:00:00,231,152,79,FMN 16 Noorderlaanbrug
676,Noorderlaan,2023-01-05,09:00:00,100,69,31,FMN 16 Noorderlaanbrug
676,Noorderlaan,2023-01-05,10:00:00,70,47,23,FMN 16 Noorderlaanbrug
676,Noorderlaan,2023-01-05,11:00:00,86,59,27,FMN 16 Noorderlaanbrug
676,Noorderlaan,2023-01-05,12:00:00,86,57,29,FMN 16 Noorderlaanbrug
676,Noorderlaan,2023-01-05,13:00:00,95,58,37,FMN 16 Noorderlaanbrug
676,Noorderlaan,2023-01-05,14:00:00,122,77,45,FMN 16 Noorderlaanbrug
676,Noorderlaan,2023-01-05,15:00:00,144,81,63,FMN 16 Noorderlaanbrug
676,Noorderlaan,2023-01-05,16:00:00,203,107,96,FMN 16 Noorderlaanbrug
676,Noorderlaan,2023-01-05,17:00:00,217,124,93,FMN 16 Noorderlaanbrug
676,Noorderlaan,2023-01-05,18:00:00,126,52,74,FMN 16 Noorderlaanbrug
676,Noorderlaan,2023-01-05,19:00:00,68,31,37,FMN 16 Noorderlaanbrug
676,Noorderlaan,2023-01-05,20:00:00,38,24,14,FMN 16 Noorderlaanbrug
676,Noorderlaan,2023-01-05,21:00:00,50,27,23,FMN 16 Noorderlaanbrug
676,Noorderlaan,2023-01-05,22:00:00,55,28,27,FMN 16 Noorderlaanbrug
676,Noorderlaan,2023-01-05,23:00:00,30,20,10,FMN 16 Noorderlaanbrug
676,Noorderlaan,2023-01-06,00:00:00,21,8,13,FMN 16 Noorderlaanbrug
676,Noorderlaan,2023-01-06,01:00:00,12,6,6,FMN 16 Noorderlaanbrug
676,Noorderlaan,2023-01-06,02:00:00,1,0,1,FMN 16 Noorderlaanbrug
676,Noorderlaan,2023-01-06,03:00:00,10,6,4,FMN 16 Noorderlaanbrug
676,Noorderlaan,2023-01-06,04:00:00,25,15,10,FMN 16 Noorderlaanbrug
676,Noorderlaan,2023-01-06,05:00:00,62,22,40,FMN 16 Noorderlaanbrug
676,Noorderlaan,2023-01-06,06:00:00,91,43,48,FMN 16 Noorderlaanbrug
676,Noorderlaan,2023-01-06,07:00:00,141,75,66,FMN 16 Noorderlaanbrug
676,Noorderlaan,2023-01-06,08:00:00,161,101,60,FMN 16 Noorderlaanbrug
676,Noorderlaan,2023-01-06,09:00:00,64,39,25,FMN 16 Noorderlaanbrug
676,Noorderlaan,2023-01-06,10:00:00,53,28,25,FMN 16 Noorderlaanbrug
676,Noorderlaan,2023-01-06,11:00:00,62,35,27,FMN 16 Noorderlaanbrug
676,Noorderlaan,2023-01-06,12:00:00,86,52,34,FMN 16 Noorderlaanbrug
676,Noorderlaan,2023-01-06,13:00:00,83,46,37,FMN 16 Noorderlaanbrug
676,Noorderlaan,2023-01-06,14:00:00,132,95,37,FMN 16 Noorderlaanbrug
676,Noorderlaan,2023-01-06,15:00:00,150,85,65,FMN 16 Noorderlaanbrug
676,Noorderlaan,2023-01-06,16:00:00,211,142,69,FMN 16 Noorderlaanbrug
676,Noorderlaan,2023-01-06,17:00:00,178,94,84,FMN 16 Noorderlaanbrug
676,Noorderlaan,2023-01-06,18:00:00,98,57,41,FMN 16 Noorderlaanbrug
676,Noorderlaan,2023-01-06,19:00:00,63,40,23,FMN 16 Noorderlaanbrug
676,Noorderlaan,2023-01-06,20:00:00,53,36,17,FMN 16 Noorderlaanbrug
676,Noorderlaan,2023-01-06,21:00:00,51,27,24,FMN 16 Noorderlaanbrug
676,Noorderlaan,2023-01-06,22:00:00,56,35,21,FMN 16 Noorderlaanbrug
676,Noorderlaan,2023-01-06,23:00:00,35,14,21,FMN 16 Noorderlaanbrug
676,Noorderlaan,2023-01-07,00:00:00,35,23,12,FMN 16 Noorderlaanbrug
676,Noorderlaan,2023-01-07,01:00:00,33,14,19,FMN 16 Noorderlaanbrug
676,Noorderlaan,2023-01-07,02:00:00,24,15,9,FMN 16 Noorderlaanbrug
676,Noorderlaan,2023-01-07,03:00:00,20,16,4,FMN 16 Noorderlaanbrug
676,Noorderlaan,2023-01-07,04:00:00,6,4,2,FMN 16 Noorderlaanbrug
676,Noorderlaan,2023-01-07,05:00:00,26,10,16,FMN 16 Noorderlaanbrug
676,Noorderlaan,2023-01-07,06:00:00,32,18,14,FMN 16 Noorderlaanbrug
676,Noorderlaan,2023-01-07,07:00:00,28,14,14,FMN 16 Noorderlaanbrug
676,Noorderlaan,2023-01-07,08:00:00,26,18,8,FMN 16 Noorderlaanbrug
676,Noorderlaan,2023-01-07,09:00:00,56,37,19,FMN 16 Noorderlaanbrug
676,Noorderlaan,2023-01-07,10:00:00,72,54,18,FMN 16 Noorderlaanbrug
676,Noorderlaan,2023-01-07,11:00:00,90,50,40,FMN 16 Noorderlaanbrug
676,Noorderlaan,2023-01-07,12:00:00,101,71,30,FMN 16 Noorderlaanbrug
676,Noorderlaan,2023-01-07,13:00:00,90,56,34,FMN 16 Noorderlaanbrug
676,Noorderlaan,2023-01-07,14:00:00,101,63,38,FMN 16 Noorderlaanbrug
676,Noorderlaan,2023-01-07,15:00:00,120,66,54,FMN 16 Noorderlaanbrug
676,Noorderlaan,2023-01-07,16:00:00,101,47,54,FMN 16 Noorderlaanbrug
676,Noorderlaan,2023-01-07,17:00:00,67,40,27,FMN 16 Noorderlaanbrug
676,Noorderlaan,2023-01-07,18:00:00,92,55,37,FMN 16 Noorderlaanbrug
676,Noorderlaan,2023-01-07,19:00:00,54,30,24,FMN 16 Noorderlaanbrug
676,Noorderlaan,2023-01-07,20:00:00,39,23,16,FMN 16 Noorderlaanbrug
676,Noorderlaan,2023-01-07,21:00:00,36,19,17,FMN 16 Noorderlaanbrug
676,Noorderlaan,2023-01-07,22:00:00,39,17,22,FMN 16 Noorderlaanbrug
676,Noorderlaan,2023-01-07,23:00:00,27,16,11,FMN 16 Noorderlaanbrug
676,Noorderlaan,2023-01-08,00:00:00,36,20,16,FMN 16 Noorderlaanbrug
676,Noorderlaan,2023-01-08,01:00:00,22,13,9,FMN 16 Noorderlaanbrug
676,Noorderlaan,2023-01-08,02:00:00,34,18,16,FMN 16 Noorderlaanbrug
676,Noorderlaan,2023-01-08,03:00:00,10,4,6,FMN 16 Noorderlaanbrug
676,Noorderlaan,2023-01-08,04:00:00,19,14,5,FMN 16 Noorderlaanbrug
676,Noorderlaan,2023-01-08,05:00:00,12,5,7,FMN 16 Noorderlaanbrug
676,Noorderlaan,2023-01-08,06:00:00,27,14,13,FMN 16 Noorderlaanbrug
676,Noorderlaan,2023-01-08,07:00:00,12,6,6,FMN 16 Noorderlaanbrug
676,Noorderlaan,2023-01-08,08:00:00,18,13,5,FMN 16 Noorderlaanbrug
676,Noorderlaan,2023-01-08,09:00:00,41,27,14,FMN 16 Noorderlaanbrug
676,Noorderlaan,2023-01-08,10:00:00,49,35,14,FMN 16 Noorderlaanbrug
676,Noorderlaan,2023-01-08,11:00:00,79,50,29,FMN 16 Noorderlaanbrug
676,Noorderlaan,2023-01-08,12:00:00,61,35,26,FMN 16 Noorderlaanbrug
676,Noorderlaan,2023-01-08,13:00:00,72,43,29,FMN 16 Noorderlaanbrug
676,Noorderlaan,2023-01-08,14:00:00,90,53,37,FMN 16 Noorderlaanbrug
676,Noorderlaan,2023-01-08,15:00:00,67,33,34,FMN 16 Noorderlaanbrug
676,Noorderlaan,2023-01-08,16:00:00,84,45,39,FMN 16 Noorderlaanbrug
676,Noorderlaan,2023-01-08,17:00:00,76,39,37,FMN 16 Noorderlaanbrug
676,Noorderlaan,2023-01-08,18:00:00,52,22,30,FMN 16 Noorderlaanbrug
676,Noorderlaan,2023-01-08,19:00:00,48,26,22,FMN 16 Noorderlaanbrug
676,Noorderlaan,2023-01-08,20:00:00,36,28,8,FMN 16 Noorderlaanbrug
676,Noorderlaan,2023-01-08,21:00:00,26,15,11,FMN 16 Noorderlaanbrug
676,Noorderlaan,2023-01-08,22:00:00,24,15,9,FMN 16 Noorderlaanbrug
676,Noorderlaan,2023-01-08,23:00:00,14,9,5,FMN 16 Noorderlaanbrug
676,Noorderlaan,2023-01-09,00:00:00,2,0,2,FMN 16 Noorderlaanbrug
676,Noorderlaan,2023-01-09,01:00:00,8,4,4,FMN 16 Noorderlaanbrug
676,Noorderlaan,2023-01-09,02:00:00,4,1,3,FMN 16 Noorderlaanbrug
676,Noorderlaan,2023-01-09,03:00:00,3,2,1,FMN 16 Noorderlaanbrug
676,Noorderlaan,2023-01-09,04:00:00,26,14,12,FMN 16 Noorderlaanbrug
676,Noorderlaan,2023-01-09,05:00:00,73,35,38,FMN 16 Noorderlaanbrug
676,Noorderlaan,2023-01-09,06:00:00,124,69,55,FMN 16 Noorderlaanbrug
676,Noorderlaan,2023-01-09,07:00:00,338,239,99,FMN 16 Noorderlaanbrug
676,Noorderlaan,2023-01-09,08:00:00,358,274,84,FMN 16 Noorderlaanbrug
676,Noorderlaan,2023-01-09,09:00:00,115,78,37,FMN 16 Noorderlaanbrug
676,Noorderlaan,2023-01-09,10:00:00,54,34,20,FMN 16 Noorderlaanbrug
676,Noorderlaan,2023-01-09,11:00:00,69,53,16,FMN 16 Noorderlaanbrug
676,Noorderlaan,2023-01-09,12:00:00,107,53,54,FMN 16 Noorderlaanbrug
676,Noorderlaan,2023-01-09,13:00:00,130,68,62,FMN 16 Noorderlaanbrug
676,Noorderlaan,2023-01-09,14:00:00,113,58,55,FMN 16 Noorderlaanbrug
676,Noorderlaan,2023-01-09,15:00:00,165,81,84,FMN 16 Noorderlaanbrug
676,Noorderlaan,2023-01-09,16:00:00,306,139,167,FMN 16 Noorderlaanbrug
676,Noorderlaan,2023-01-09,17:00:00,301,149,152,FMN 16 Noorderlaanbrug
676,Noorderlaan,2023-01-09,18:00:00,135,61,74,FMN 16 Noorderlaanbrug
676,Noorderlaan,2023-01-09,19:00:00,63,36,27,FMN 16 Noorderlaanbrug
676,Noorderlaan,2023-01-09,20:00:00,50,30,20,FMN 16 Noorderlaanbrug
676,Noorderlaan,2023-01-09,21:00:00,45,18,27,FMN 16 Noorderlaanbrug
676,Noorderlaan,2023-01-09,22:00:00,49,35,14,FMN 16 Noorderlaanbrug
676,Noorderlaan,2023-01-09,23:00:00,23,15,8,FMN 16 Noorderlaanbrug
676,Noorderlaan,2023-01-10,00:00:00,11,6,5,FMN 16 Noorderlaanbrug
676,Noorderlaan,2023-01-10,01:00:00,5,2,3,FMN 16 Noorderlaanbrug
676,Noorderlaan,2023-01-10,02:00:00,5,3,2,FMN 16 Noorderlaanbrug
676,Noorderlaan,2023-01-10,03:00:00,4,4,0,FMN 16 Noorderlaanbrug
676,Noorderlaan,2023-01-10,04:00:00,22,15,7,FMN 16 Noorderlaanbrug
676,Noorderlaan,2023-01-10,05:00:00,79,34,45,FMN 16 Noorderlaanbrug
676,Noorderlaan,2023-01-10,06:00:00,127,79,48,FMN 16 Noorderlaanbrug
676,Noorderlaan,2023-01-10,07:00:00,334,237,97,FMN 16 Noorderlaanbrug
676,Noorderlaan,2023-01-10,08:00:00,415,319,96,FMN 16 Noorderlaanbrug
676,Noorderlaan,2023-01-10,09:00:00,141,96,45,FMN 16 Noorderlaanbrug
676,Noorderlaan,2023-01-10,10:00:00,65,47,18,FMN 16 Noorderlaanbrug
676,Noorderlaan,2023-01-10,11:00:00,71,33,38,FMN 16 Noorderlaanbrug
676,Noorderlaan,2023-01-10,12:00:00,100,55,45,FMN 16 Noorderlaanbrug
676,Noorderlaan,2023-01-10,13:00:00,97,41,56,FMN 16 Noorderlaanbrug
676,Noorderlaan,2023-01-10,14:00:00,102,60,42,FMN 16 Noorderlaanbrug
676,Noorderlaan,2023-01-10,15:00:00,119,63,56,FMN 16 Noorderlaanbrug
676,Noorderlaan,2023-01-10,16:00:00,279,138,141,FMN 16 Noorderlaanbrug
676,Noorderlaan,2023-01-10,17:00:00,291,136,155,FMN 16 Noorderlaanbrug
676,Noorderlaan,2023-01-10,18:00:00,143,72,71,FMN 16 Noorderlaanbrug
676,Noorderlaan,2023-01-10,19:00:00,62,33,29,FMN 16 Noorderlaanbrug
676,Noorderlaan,2023-01-10,20:00:00,43,26,17,FMN 16 Noorderlaanbrug
676,Noorderlaan,2023-01-10,21:00:00,49,30,19,FMN 16 Noorderlaanbrug
676,Noorderlaan,2023-01-10,22:00:00,43,33,10,FMN 16 Noorderlaanbrug
676,Noorderlaan,2023-01-10,23:00:00,20,13,7,FMN 16 Noorderlaanbrug
676,Noorderlaan,2023-01-11,00:00:00,6,3,3,FMN 16 Noorderlaanbrug
676,Noorderlaan,2023-01-11,01:00:00,10,7,3,FMN 16 Noorderlaanbrug
676,Noorderlaan,2023-01-11,02:00:00,2,0,2,FMN 16 Noorderlaanbrug
676,Noorderlaan,2023-01-11,03:00:00,8,7,1,FMN 16 Noorderlaanbrug
676,Noorderlaan,2023-01-11,04:00:00,18,10,8,FMN 16 Noorderlaanbrug
676,Noorderlaan,2023-01-11,05:00:00,67,29,38,FMN 16 Noorderlaanbrug
676,Noorderlaan,2023-01-11,06:00:00,120,68,52,FMN 16 Noorderlaanbrug
676,Noorderlaan,2023-01-11,07:00:00,312,208,104,FMN 16 Noorderlaanbrug
676,Noorderlaan,2023-01-11,08:00:00,364,264,100,FMN 16 Noorderlaanbrug
676,Noorderlaan,2023-01-11,09:00:00,101,69,32,FMN 16 Noorderlaanbrug
676,Noorderlaan,2023-01-11,10:00:00,90,61,29,FMN 16 Noorderlaanbrug
676,Noorderlaan,2023-01-11,11:00:00,108,71,37,FMN 16 Noorderlaanbrug
676,Noorderlaan,2023-01-11,12:00:00,147,65,82,FMN 16 Noorderlaanbrug
676,Noorderlaan,2023-01-11,13:00:00,143,66,77,FMN 16 Noorderlaanbrug
676,Noorderlaan,2023-01-11,14:00:00,151,84,67,FMN 16 Noorderlaanbrug
676,Noorderlaan,2023-01-11,15:00:00,133,64,69,FMN 16 Noorderlaanbrug
676,Noorderlaan,2023-01-11,16:00:00,251,128,123,FMN 16 Noorderlaanbrug
676,Noorderlaan,2023-01-11,17:00:00,289,145,144,FMN 16 Noorderlaanbrug
676,Noorderlaan,2023-01-11,18:00:00,136,69,67,FMN 16 Noorderlaanbrug
676,Noorderlaan,2023-01-11,19:00:00,57,29,28,FMN 16 Noorderlaanbrug
676,Noorderlaan,2023-01-11,20:00:00,46,27,19,FMN 16 Noorderlaanbrug
676,Noorderlaan,2023-01-11,21:00:00,44,24,20,FMN 16 Noorderlaanbrug
676,Noorderlaan,2023-01-11,22:00:00,54,36,18,FMN 16 Noorderlaanbrug
676,Noorderlaan,2023-01-11,23:00:00,22,11,11,FMN 16 Noorderlaanbrug
676,Noorderlaan,2023-01-12,00:00:00,10,5,5,FMN 16 Noorderlaanbrug
676,Noorderlaan,2023-01-12,01:00:00,9,6,3,FMN 16 Noorderlaanbrug
676,Noorderlaan,2023-01-12,02:00:00,2,0,2,FMN 16 Noorderlaanbrug
676,Noorderlaan,2023-01-12,03:00:00,5,5,0,FMN 16 Noorderlaanbrug
676,Noorderlaan,2023-01-12,04:00:00,14,8,6,FMN 16 Noorderlaanbrug
676,Noorderlaan,2023-01-12,05:00:00,55,21,34,FMN 16 Noorderlaanbrug
676,Noorderlaan,2023-01-12,06:00:00,77,42,35,FMN 16 Noorderlaanbrug
676,Noorderlaan,2023-01-12,07:00:00,182,114,68,FMN 16 Noorderlaanbrug
676,Noorderlaan,2023-01-12,08:00:00,243,184,59,FMN 16 Noorderlaanbrug
676,Noorderlaan,2023-01-12,09:00:00,77,53,24,FMN 16 Noorderlaanbrug
676,Noorderlaan,2023-01-12,10:00:00,51,32,19,FMN 16 Noorderlaanbrug
676,Noorderlaan,2023-01-12,11:00:00,35,23,12,FMN 16 Noorderlaanbrug
676,Noorderlaan,2023-01-12,12:00:00,59,33,26,FMN 16 Noorderlaanbrug
676,Noorderlaan,2023-01-12,13:00:00,54,27,27,FMN 16 Noorderlaanbrug
676,Noorderlaan,2023-01-12,14:00:00,88,59,29,FMN 16 Noorderlaanbrug
676,Noorderlaan,2023-01-12,15:00:00,83,43,40,FMN 16 Noorderlaanbrug
676,Noorderlaan,2023-01-12,16:00:00,169,75,94,FMN 16 Noorderlaanbrug
676,Noorderlaan,2023-01-12,17:00:00,178,89,89,FMN 16 Noorderlaanbrug
676,Noorderlaan,2023-01-12,18:00:00,104,49,55,FMN 16 Noorderlaanbrug
676,Noorderlaan,2023-01-12,19:00:00,42,25,17,FMN 16 Noorderlaanbrug
676,Noorderlaan,2023-01-12,20:00:00,30,18,12,FMN 16 Noorderlaanbrug
676,Noorderlaan,2023-01-12,21:00:00,32,15,17,FMN 16 Noorderlaanbrug
676,Noorderlaan,2023-01-12,22:00:00,31,18,13,FMN 16 Noorderlaanbrug
676,Noorderlaan,2023-01-12,23:00:00,14,7,7,FMN 16 Noorderlaanbrug
676,Noorderlaan,2023-01-13,00:00:00,15,9,6,FMN 16 Noorderlaanbrug
676,Noorderlaan,2023-01-13,01:00:00,5,2,3,FMN 16 Noorderlaanbrug
676,Noorderlaan,2023-01-13,02:00:00,4,0,4,FMN 16 Noorderlaanbrug
676,Noorderlaan,2023-01-13,03:00:00,10,7,3,FMN 16 Noorderlaanbrug
676,Noorderlaan,2023-01-13,04:00:00,16,9,7,FMN 16 Noorderlaanbrug
676,Noorderlaan,2023-01-13,05:00:00,68,26,42,FMN 16 Noorderlaanbrug
676,Noorderlaan,2023-01-13,06:00:00,90,50,40,FMN 16 Noorderlaanbrug
676,Noorderlaan,2023-01-13,07:00:00,245,164,81,FMN 16 Noorderlaanbrug
676,Noorderlaan,2023-01-13,08:00:00,333,247,86,FMN 16 Noorderlaanbrug
676,Noorderlaan,2023-01-13,09:00:00,118,88,30,FMN 16 Noorderlaanbrug
676,Noorderlaan,2023-01-13,10:00:00,70,42,28,FMN 16 Noorderlaanbrug
676,Noorderlaan,2023-01-13,11:00:00,79,44,35,FMN 16 Noorderlaanbrug
676,Noorderlaan,2023-01-13,12:00:00,114,65,49,FMN 16 Noorderlaanbrug
676,Noorderlaan,2023-01-13,13:00:00,109,64,45,FMN 16 Noorderlaanbrug
676,Noorderlaan,2023-01-13,14:00:00,134,82,52,FMN 16 Noorderlaanbrug
676,Noorderlaan,2023-01-13,15:00:00,163,71,92,FMN 16 Noorderlaanbrug
676,Noorderlaan,2023-01-13,16:00:00,273,143,130,FMN 16 Noorderlaanbrug
676,Noorderlaan,2023-01-13,17:00:00,216,103,113,FMN 16 Noorderlaanbrug
676,Noorderlaan,2023-01-13,18:00:00,168,80,88,FMN 16 Noorderlaanbrug
676,Noorderlaan,2023-01-13,19:00:00,96,52,44,FMN 16 Noorderlaanbrug
676,Noorderlaan,2023-01-13,20:00:00,49,28,21,FMN 16 Noorderlaanbrug
676,Noorderlaan,2023-01-13,21:00:00,40,26,14,FMN 16 Noorderlaanbrug
676,Noorderlaan,2023-01-13,22:00:00,47,22,25,FMN 16 Noorderlaanbrug
676,Noorderlaan,2023-01-13,23:00:00,33,23,10,FMN 16 Noorderlaanbrug
676,Noorderlaan,2023-01-14,00:00:00,32,18,14,FMN 16 Noorderlaanbrug
676,Noorderlaan,2023-01-14,01:00:00,36,15,21,FMN 16 Noorderlaanbrug
676,Noorderlaan,2023-01-14,02:00:00,36,20,16,FMN 16 Noorderlaanbrug
676,Noorderlaan,2023-01-14,03:00:00,21,11,10,FMN 16 Noorderlaanbrug
676,Noorderlaan,2023-01-14,04:00:00,15,12,3,FMN 16 Noorderlaanbrug
676,Noorderlaan,2023-01-14,05:00:00,12,8,4,FMN 16 Noorderlaanbrug
676,Noorderlaan,2023-01-14,06:00:00,19,11,8,FMN 16 Noorderlaanbrug
676,Noorderlaan,2023-01-14,07:00:00,17,12,5,FMN 16 Noorderlaanbrug
676,Noorderlaan,2023-01-14,08:00:00,20,15,5,FMN 16 Noorderlaanbrug
676,Noorderlaan,2023-01-14,09:00:00,30,20,10,FMN 16 Noorderlaanbrug
676,Noorderlaan,2023-01-14,10:00:00,27,19,8,FMN 16 Noorderlaanbrug
676,Noorderlaan,2023-01-14,11:00:00,26,11,15,FMN 16 Noorderlaanbrug
676,Noorderlaan,2023-01-14,12:00:00,37,22,15,FMN 16 Noorderlaanbrug
676,Noorderlaan,2023-01-14,13:00:00,30,16,14,FMN 16 Noorderlaanbrug
676,Noorderlaan,2023-01-14,14:00:00,35,23,12,FMN 16 Noorderlaanbrug
676,Noorderlaan,2023-01-14,15:00:00,34,18,16,FMN 16 Noorderlaanbrug
676,Noorderlaan,2023-01-14,16:00:00,40,22,18,FMN 16 Noorderlaanbrug
676,Noorderlaan,2023-01-14,17:00:00,33,17,16,FMN 16 Noorderlaanbrug
676,Noorderlaan,2023-01-14,18:00:00,49,23,26,FMN 16 Noorderlaanbrug
676,Noorderlaan,2023-01-14,19:00:00,46,32,14,FMN 16 Noorderlaanbrug
676,Noorderlaan,2023-01-14,20:00:00,36,19,17,FMN 16 Noorderlaanbrug
676,Noorderlaan,2023-01-14,21:00:00,29,17,12,FMN 16 Noorderlaanbrug
676,Noorderlaan,2023-01-14,22:00:00,38,19,19,FMN 16 Noorderlaanbrug
676,Noorderlaan,2023-01-14,23:00:00,21,8,13,FMN 16 Noorderlaanbrug
676,Noorderlaan,2023-01-15,00:00:00,33,8,25,FMN 16 Noorderlaanbrug
676,Noorderlaan,2023-01-15,01:00:00,26,6,20,FMN 16 Noorderlaanbrug
676,Noorderlaan,2023-01-15,02:00:00,10,5,5,FMN 16 Noorderlaanbrug
676,Noorderlaan,2023-01-15,03:00:00,11,8,3,FMN 16 Noorderlaanbrug
676,Noorderlaan,2023-01-15,04:00:00,17,11,6,FMN 16 Noorderlaanbrug
676,Noorderlaan,2023-01-15,05:00:00,15,11,4,FMN 16 Noorderlaanbrug
676,Noorderlaan,2023-01-15,06:00:00,23,11,12,FMN 16 Noorderlaanbrug
676,Noorderlaan,2023-01-15,07:00:00,10,5,5,FMN 16 Noorderlaanbrug
676,Noorderlaan,2023-01-15,08:00:00,15,9,6,FMN 16 Noorderlaanbrug
676,Noorderlaan,2023-01-15,09:00:00,32,25,7,FMN 16 Noorderlaanbrug
676,Noorderlaan,2023-01-15,10:00:00,35,21,14,FMN 16 Noorderlaanbrug
676,Noorderlaan,2023-01-15,11:00:00,44,23,21,FMN 16 Noorderlaanbrug
676,Noorderlaan,2023-01-15,12:00:00,46,33,13,FMN 16 Noorderlaanbrug
676,Noorderlaan,2023-01-15,13:00:00,38,22,16,FMN 16 Noorderlaanbrug
676,Noorderlaan,2023-01-15,14:00:00,40,23,17,FMN 16 Noorderlaanbrug
676,Noorderlaan,2023-01-15,15:00:00,36,19,17,FMN 16 Noorderlaanbrug
676,Noorderlaan,2023-01-15,16:00:00,47,19,28,FMN 16 Noorderlaanbrug
676,Noorderlaan,2023-01-15,17:00:00,38,25,13,FMN 16 Noorderlaanbrug
676,Noorderlaan,2023-01-15,18:00:00,57,28,29,FMN 16 Noorderlaanbrug
676,Noorderlaan,2023-01-15,19:00:00,36,16,20,FMN 16 Noorderlaanbrug
676,Noorderlaan,2023-01-15,20:00:00,33,25,8,FMN 16 Noorderlaanbrug
676,Noorderlaan,2023-01-15,21:00:00,24,16,8,FMN 16 Noorderlaanbrug
676,Noorderlaan,2023-01-15,22:00:00,14,10,4,FMN 16 Noorderlaanbrug
676,Noorderlaan,2023-01-15,23:00:00,16,10,6,FMN 16 Noorderlaanbrug
676,Noorderlaan,2023-01-16,00:00:00,8,5,3,FMN 16 Noorderlaanbrug
676,Noorderlaan,2023-01-16,01:00:00,5,1,4,FMN 16 Noorderlaanbrug
676,Noorderlaan,2023-01-16,02:00:00,2,2,0,FMN 16 Noorderlaanbrug
676,Noorderlaan,2023-01-16,03:00:00,4,2,2,FMN 16 Noorderlaanbrug
676,Noorderlaan,2023-01-16,04:00:00,23,10,13,FMN 16 Noorderlaanbrug
676,Noorderlaan,2023-01-16,05:00:00,55,19,36,FMN 16 Noorderlaanbrug
676,Noorderlaan,2023-01-16,06:00:00,95,56,39,FMN 16 Noorderlaanbrug
676,Noorderlaan,2023-01-16,07:00:00,218,155,63,FMN 16 Noorderlaanbrug
676,Noorderlaan,2023-01-16,08:00:00,288,231,57,FMN 16 Noorderlaanbrug
676,Noorderlaan,2023-01-16,09:00:00,92,63,29,FMN 16 Noorderlaanbrug
676,Noorderlaan,2023-01-16,10:00:00,57,38,19,FMN 16 Noorderlaanbrug
676,Noorderlaan,2023-01-16,11:00:00,54,32,22,FMN 16 Noorderlaanbrug
676,Noorderlaan,2023-01-16,12:00:00,86,48,38,FMN 16 Noorderlaanbrug
676,Noorderlaan,2023-01-16,13:00:00,68,33,35,FMN 16 Noorderlaanbrug
676,Noorderlaan,2023-01-16,14:00:00,88,57,31,FMN 16 Noorderlaanbrug
676,Noorderlaan,2023-01-16,15:00:00,134,55,79,FMN 16 Noorderlaanbrug
676,Noorderlaan,2023-01-16,16:00:00,196,97,99,FMN 16 Noorderlaanbrug
676,Noorderlaan,2023-01-16,17:00:00,198,97,101,FMN 16 Noorderlaanbrug
676,Noorderlaan,2023-01-16,18:00:00,114,44,70,FMN 16 Noorderlaanbrug
676,Noorderlaan,2023-01-16,19:00:00,47,31,16,FMN 16 Noorderlaanbrug
676,Noorderlaan,2023-01-16,20:00:00,26,14,12,FMN 16 Noorderlaanbrug
676,Noorderlaan,2023-01-16,21:00:00,32,15,17,FMN 16 Noorderlaanbrug
676,Noorderlaan,2023-01-16,22:00:00,37,19,18,FMN 16 Noorderlaanbrug
676,Noorderlaan,2023-01-16,23:00:00,11,7,4,FMN 16 Noorderlaanbrug
676,Noorderlaan,2023-01-17,00:00:00,3,3,0,FMN 16 Noorderlaanbrug
676,Noorderlaan,2023-01-17,01:00:00,10,6,4,FMN 16 Noorderlaanbrug
676,Noorderlaan,2023-01-17,02:00:00,5,2,3,FMN 16 Noorderlaanbrug
676,Noorderlaan,2023-01-17,03:00:00,6,1,5,FMN 16 Noorderlaanbrug
676,Noorderlaan,2023-01-17,04:00:00,6,1,5,FMN 16 Noorderlaanbrug
676,Noorderlaan,2023-01-17,05:00:00,1,1,0,FMN 16 Noorderlaanbrug
676,Noorderlaan,2023-01-17,06:00:00,1,0,1,FMN 16 Noorderlaanbrug
676,Noorderlaan,2023-01-17,07:00:00,0,0,0,FMN 16 Noorderlaanbrug
676,Noorderlaan,2023-01-17,08:00:00,10,5,5,FMN 16 Noorderlaanbrug
676,Noorderlaan,2023-01-17,09:00:00,0,0,0,FMN 16 Noorderlaanbrug
676,Noorderlaan,2023-01-17,10:00:00,69,46,23,FMN 16 Noorderlaanbrug
676,Noorderlaan,2023-01-17,11:00:00,71,45,26,FMN 16 Noorderlaanbrug
676,Noorderlaan,2023-01-17,12:00:00,93,50,43,FMN 16 Noorderlaanbrug
676,Noorderlaan,2023-01-17,13:00:00,83,42,41,FMN 16 Noorderlaanbrug
676,Noorderlaan,2023-01-17,14:00:00,141,91,50,FMN 16 Noorderlaanbrug
676,Noorderlaan,2023-01-17,15:00:00,173,77,96,FMN 16 Noorderlaanbrug
676,Noorderlaan,2023-01-17,16:00:00,277,135,142,FMN 16 Noorderlaanbrug
676,Noorderlaan,2023-01-17,17:00:00,304,137,167,FMN 16 Noorderlaanbrug
676,Noorderlaan,2023-01-17,18:00:00,180,79,101,FMN 16 Noorderlaanbrug
676,Noorderlaan,2023-01-17,19:00:00,65,28,37,FMN 16 Noorderlaanbrug
676,Noorderlaan,2023-01-17,20:00:00,18,15,3,FMN 16 Noorderlaanbrug
676,Noorderlaan,2023-01-17,21:00:00,4,2,2,FMN 16 Noorderlaanbrug
676,Noorderlaan,2023-01-17,22:00:00,10,6,4,FMN 16 Noorderlaanbrug
676,Noorderlaan,2023-01-17,23:00:00,3,1,2,FMN 16 Noorderlaanbrug
676,Noorderlaan,2023-01-18,00:00:00,0,0,0,FMN 16 Noorderlaanbrug
676,Noorderlaan,2023-01-18,01:00:00,0,0,0,FMN 16 Noorderlaanbrug
676,Noorderlaan,2023-01-18,02:00:00,2,1,1,FMN 16 Noorderlaanbrug
676,Noorderlaan,2023-01-18,03:00:00,6,5,1,FMN 16 Noorderlaanbrug
676,Noorderlaan,2023-01-18,04:00:00,26,14,12,FMN 16 Noorderlaanbrug
676,Noorderlaan,2023-01-18,05:00:00,78,36,42,FMN 16 Noorderlaanbrug
676,Noorderlaan,2023-01-18,06:00:00,115,74,41,FMN 16 Noorderlaanbrug
676,Noorderlaan,2023-01-18,07:00:00,165,117,48,FMN 16 Noorderlaanbrug
676,Noorderlaan,2023-01-18,08:00:00,356,248,108,FMN 16 Noorderlaanbrug
676,Noorderlaan,2023-01-18,09:00:00,39,25,14,FMN 16 Noorderlaanbrug
676,Noorderlaan,2023-01-18,10:00:00,89,54,35,FMN 16 Noorderlaanbrug
676,Noorderlaan,2023-01-18,11:00:00,86,51,35,FMN 16 Noorderlaanbrug
676,Noorderlaan,2023-01-18,12:00:00,140,68,72,FMN 16 Noorderlaanbrug
676,Noorderlaan,2023-01-18,13:00:00,149,64,85,FMN 16 Noorderlaanbrug
676,Noorderlaan,2023-01-18,14:00:00,126,86,40,FMN 16 Noorderlaanbrug
676,Noorderlaan,2023-01-18,15:00:00,146,83,63,FMN 16 Noorderlaanbrug
676,Noorderlaan,2023-01-18,16:00:00,234,117,117,FMN 16 Noorderlaanbrug
676,Noorderlaan,2023-01-18,17:00:00,274,155,119,FMN 16 Noorderlaanbrug
676,Noorderlaan,2023-01-18,18:00:00,130,60,70,FMN 16 Noorderlaanbrug
676,Noorderlaan,2023-01-18,19:00:00,55,31,24,FMN 16 Noorderlaanbrug
676,Noorderlaan,2023-01-18,20:00:00,39,22,17,FMN 16 Noorderlaanbrug
676,Noorderlaan,2023-01-18,21:00:00,41,26,15,FMN 16 Noorderlaanbrug
676,Noorderlaan,2023-01-18,22:00:00,51,30,21,FMN 16 Noorderlaanbrug
676,Noorderlaan,2023-01-18,23:00:00,26,12,14,FMN 16 Noorderlaanbrug
676,Noorderlaan,2023-01-19,00:00:00,7,4,3,FMN 16 Noorderlaanbrug
676,Noorderlaan,2023-01-19,01:00:00,6,6,0,FMN 16 Noorderlaanbrug
676,Noorderlaan,2023-01-19,02:00:00,4,1,3,FMN 16 Noorderlaanbrug
676,Noorderlaan,2023-01-19,03:00:00,8,4,4,FMN 16 Noorderlaanbrug
676,Noorderlaan,2023-01-19,04:00:00,27,19,8,FMN 16 Noorderlaanbrug
676,Noorderlaan,2023-01-19,05:00:00,68,26,42,FMN 16 Noorderlaanbrug
676,Noorderlaan,2023-01-19,06:00:00,102,53,49,FMN 16 Noorderlaanbrug
676,Noorderlaan,2023-01-19,07:00:00,318,219,99,FMN 16 Noorderlaanbrug
676,Noorderlaan,2023-01-19,08:00:00,474,349,125,FMN 16 Noorderlaanbrug
676,Noorderlaan,2023-01-19,09:00:00,124,76,48,FMN 16 Noorderlaanbrug
676,Noorderlaan,2023-01-19,10:00:00,63,45,18,FMN 16 Noorderlaanbrug
676,Noorderlaan,2023-01-19,11:00:00,67,45,22,FMN 16 Noorderlaanbrug
676,Noorderlaan,2023-01-19,12:00:00,107,57,50,FMN 16 Noorderlaanbrug
676,Noorderlaan,2023-01-19,13:00:00,98,53,45,FMN 16 Noorderlaanbrug
676,Noorderlaan,2023-01-19,14:00:00,124,83,41,FMN 16 Noorderlaanbrug
676,Noorderlaan,2023-01-19,15:00:00,172,86,86,FMN 16 Noorderlaanbrug
676,Noorderlaan,2023-01-19,16:00:00,255,129,126,FMN 16 Noorderlaanbrug
676,Noorderlaan,2023-01-19,17:00:00,252,120,132,FMN 16 Noorderlaanbrug
676,Noorderlaan,2023-01-19,18:00:00,139,64,75,FMN 16 Noorderlaanbrug
676,Noorderlaan,2023-01-19,19:00:00,70,35,35,FMN 16 Noorderlaanbrug
676,Noorderlaan,2023-01-19,20:00:00,55,39,16,FMN 16 Noorderlaanbrug
676,Noorderlaan,2023-01-19,21:00:00,42,23,19,FMN 16 Noorderlaanbrug
676,Noorderlaan,2023-01-19,22:00:00,47,28,19,FMN 16 Noorderlaanbrug
676,Noorderlaan,2023-01-19,23:00:00,22,10,12,FMN 16 Noorderlaanbrug
676,Noorderlaan,2023-01-20,00:00:00,13,5,8,FMN 16 Noorderlaanbrug
676,Noorderlaan,2023-01-20,01:00:00,6,3,3,FMN 16 Noorderlaanbrug
676,Noorderlaan,2023-01-20,02:00:00,1,1,0,FMN 16 Noorderlaanbrug
676,Noorderlaan,2023-01-20,03:00:00,7,4,3,FMN 16 Noorderlaanbrug
676,Noorderlaan,2023-01-20,04:00:00,11,10,1,FMN 16 Noorderlaanbrug
676,Noorderlaan,2023-01-20,05:00:00,57,22,35,FMN 16 Noorderlaanbrug
676,Noorderlaan,2023-01-20,06:00:00,76,39,37,FMN 16 Noorderlaanbrug
676,Noorderlaan,2023-01-20,07:00:00,210,130,80,FMN 16 Noorderlaanbrug
676,Noorderlaan,2023-01-20,08:00:00,187,116,71,FMN 16 Noorderlaanbrug
676,Noorderlaan,2023-01-20,09:00:00,61,44,17,FMN 16 Noorderlaanbrug
676,Noorderlaan,2023-01-20,10:00:00,50,30,20,FMN 16 Noorderlaanbrug
676,Noorderlaan,2023-01-20,11:00:00,50,29,21,FMN 16 Noorderlaanbrug
676,Noorderlaan,2023-01-20,12:00:00,52,32,20,FMN 16 Noorderlaanbrug
676,Noorderlaan,2023-01-20,13:00:00,50,21,29,FMN 16 Noorderlaanbrug
676,Noorderlaan,2023-01-20,14:00:00,79,47,32,FMN 16 Noorderlaanbrug
676,Noorderlaan,2023-01-20,15:00:00,112,50,62,FMN 16 Noorderlaanbrug
676,Noorderlaan,2023-01-20,16:00:00,148,80,68,FMN 16 Noorderlaanbrug
676,Noorderlaan,2023-01-20,17:00:00,132,78,54,FMN 16 Noorderlaanbrug
676,Noorderlaan,2023-01-20,18:00:00,76,32,44,FMN 16 Noorderlaanbrug
676,Noorderlaan,2023-01-20,19:00:00,66,29,37,FMN 16 Noorderlaanbrug
676,Noorderlaan,2023-01-20,20:00:00,41,27,14,FMN 16 Noorderlaanbrug
676,Noorderlaan,2023-01-20,21:00:00,50,30,20,FMN 16 Noorderlaanbrug
676,Noorderlaan,2023-01-20,22:00:00,37,28,9,FMN 16 Noorderlaanbrug
676,Noorderlaan,2023-01-20,23:00:00,8,2,6,FMN 16 Noorderlaanbrug
676,Noorderlaan,2023-01-21,00:00:00,14,9,5,FMN 16 Noorderlaanbrug
676,Noorderlaan,2023-01-21,01:00:00,4,2,2,FMN 16 Noorderlaanbrug
676,Noorderlaan,2023-01-21,02:00:00,11,8,3,FMN 16 Noorderlaanbrug
676,Noorderlaan,2023-01-21,03:00:00,7,3,4,FMN 16 Noorderlaanbrug
676,Noorderlaan,2023-01-21,04:00:00,2,1,1,FMN 16 Noorderlaanbrug
676,Noorderlaan,2023-01-21,05:00:00,1,0,1,FMN 16 Noorderlaanbrug
676,Noorderlaan,2023-01-21,06:00:00,0,0,0,FMN 16 Noorderlaanbrug
676,Noorderlaan,2023-01-21,07:00:00,0,0,0,FMN 16 Noorderlaanbrug
676,Noorderlaan,2023-01-21,08:00:00,0,0,0,FMN 16 Noorderlaanbrug
676,Noorderlaan,2023-01-21,09:00:00,0,0,0,FMN 16 Noorderlaanbrug
676,Noorderlaan,2023-01-21,10:00:00,49,27,22,FMN 16 Noorderlaanbrug
676,Noorderlaan,2023-01-21,11:00:00,69,31,38,FMN 16 Noorderlaanbrug
676,Noorderlaan,2023-01-21,12:00:00,73,50,23,FMN 16 Noorderlaanbrug
676,Noorderlaan,2023-01-21,13:00:00,70,40,30,FMN 16 Noorderlaanbrug
676,Noorderlaan,2023-01-21,14:00:00,71,43,28,FMN 16 Noorderlaanbrug
676,Noorderlaan,2023-01-21,15:00:00,72,37,35,FMN 16 Noorderlaanbrug
676,Noorderlaan,2023-01-21,16:00:00,70,43,27,FMN 16 Noorderlaanbrug
676,Noorderlaan,2023-01-21,17:00:00,72,41,31,FMN 16 Noorderlaanbrug
676,Noorderlaan,2023-01-21,18:00:00,79,46,33,FMN 16 Noorderlaanbrug
676,Noorderlaan,2023-01-21,19:00:00,19,14,5,FMN 16 Noorderlaanbrug
676,Noorderlaan,2023-01-21,20:00:00,18,10,8,FMN 16 Noorderlaanbrug
676,Noorderlaan,2023-01-21,21:00:00,13,6,7,FMN 16 Noorderlaanbrug
676,Noorderlaan,2023-01-21,22:00:00,7,5,2,FMN 16 Noorderlaanbrug
676,Noorderlaan,2023-01-21,23:00:00,6,4,2,FMN 16 Noorderlaanbrug
676,Noorderlaan,2023-01-22,00:00:00,9,3,6,FMN 16 Noorderlaanbrug
676,Noorderlaan,2023-01-22,01:00:00,6,1,5,FMN 16 Noorderlaanbrug
676,Noorderlaan,2023-01-22,02:00:00,3,0,3,FMN 16 Noorderlaanbrug
676,Noorderlaan,2023-01-22,03:00:00,4,4,0,FMN 16 Noorderlaanbrug
676,Noorderlaan,2023-01-22,04:00:00,0,0,0,FMN 16 Noorderlaanbrug
676,Noorderlaan,2023-01-22,05:00:00,2,1,1,FMN 16 Noorderlaanbrug
676,Noorderlaan,2023-01-22,06:00:00,0,0,0,FMN 16 Noorderlaanbrug
676,Noorderlaan,2023-01-22,07:00:00,2,2,0,FMN 16 Noorderlaanbrug
676,Noorderlaan,2023-01-22,08:00:00,4,2,2,FMN 16 Noorderlaanbrug
676,Noorderlaan,2023-01-22,09:00:00,15,6,9,FMN 16 Noorderlaanbrug
676,Noorderlaan,2023-01-22,10:00:00,11,3,8,FMN 16 Noorderlaanbrug
676,Noorderlaan,2023-01-22,11:00:00,29,16,13,FMN 16 Noorderlaanbrug
676,Noorderlaan,2023-01-22,12:00:00,52,28,24,FMN 16 Noorderlaanbrug
676,Noorderlaan,2023-01-22,13:00:00,38,18,20,FMN 16 Noorderlaanbrug
676,Noorderlaan,2023-01-22,14:00:00,41,20,21,FMN 16 Noorderlaanbrug
676,Noorderlaan,2023-01-22,15:00:00,26,10,16,FMN 16 Noorderlaanbrug
676,Noorderlaan,2023-01-22,16:00:00,46,30,16,FMN 16 Noorderlaanbrug
676,Noorderlaan,2023-01-22,17:00:00,54,32,22,FMN 16 Noorderlaanbrug
676,Noorderlaan,2023-01-22,18:00:00,42,23,19,FMN 16 Noorderlaanbrug
676,Noorderlaan,2023-01-22,19:00:00,23,12,11,FMN 16 Noorderlaanbrug
676,Noorderlaan,2023-01-22,20:00:00,22,9,13,FMN 16 Noorderlaanbrug
676,Noorderlaan,2023-01-22,21:00:00,27,18,9,FMN 16 Noorderlaanbrug
676,Noorderlaan,2023-01-22,22:00:00,15,12,3,FMN 16 Noorderlaanbrug
676,Noorderlaan,2023-01-22,23:00:00,18,12,6,FMN 16 Noorderlaanbrug
676,Noorderlaan,2023-01-23,00:00:00,7,4,3,FMN 16 Noorderlaanbrug
676,Noorderlaan,2023-01-23,01:00:00,4,3,1,FMN 16 Noorderlaanbrug
676,Noorderlaan,2023-01-23,02:00:00,0,0,0,FMN 16 Noorderlaanbrug
676,Noorderlaan,2023-01-23,03:00:00,6,6,0,FMN 16 Noorderlaanbrug
676,Noorderlaan,2023-01-23,04:00:00,14,7,7,FMN 16 Noorderlaanbrug
676,Noorderlaan,2023-01-23,05:00:00,62,24,38,FMN 16 Noorderlaanbrug
676,Noorderlaan,2023-01-23,06:00:00,125,67,58,FMN 16 Noorderlaanbrug
676,Noorderlaan,2023-01-23,07:00:00,309,220,89,FMN 16 Noorderlaanbrug
676,Noorderlaan,2023-01-23,08:00:00,354,274,80,FMN 16 Noorderlaanbrug
676,Noorderlaan,2023-01-23,09:00:00,108,70,38,FMN 16 Noorderlaanbrug
676,Noorderlaan,2023-01-23,10:00:00,84,58,26,FMN 16 Noorderlaanbrug
676,Noorderlaan,2023-01-23,11:00:00,80,52,28,FMN 16 Noorderlaanbrug
676,Noorderlaan,2023-01-23,12:00:00,86,45,41,FMN 16 Noorderlaanbrug
676,Noorderlaan,2023-01-23,13:00:00,100,43,57,FMN 16 Noorderlaanbrug
676,Noorderlaan,2023-01-23,14:00:00,107,68,39,FMN 16 Noorderlaanbrug
676,Noorderlaan,2023-01-23,15:00:00,160,63,97,FMN 16 Noorderlaanbrug
676,Noorderlaan,2023-01-23,16:00:00,278,132,146,FMN 16 Noorderlaanbrug
676,Noorderlaan,2023-01-23,17:00:00,318,146,172,FMN 16 Noorderlaanbrug
676,Noorderlaan,2023-01-23,18:00:00,169,73,96,FMN 16 Noorderlaanbrug
676,Noorderlaan,2023-01-23,19:00:00,70,42,28,FMN 16 Noorderlaanbrug
676,Noorderlaan,2023-01-23,20:00:00,31,16,15,FMN 16 Noorderlaanbrug
676,Noorderlaan,2023-01-23,21:00:00,41,20,21,FMN 16 Noorderlaanbrug
676,Noorderlaan,2023-01-23,22:00:00,59,35,24,FMN 16 Noorderlaanbrug
676,Noorderlaan,2023-01-23,23:00:00,17,13,4,FMN 16 Noorderlaanbrug
676,Noorderlaan,2023-01-24,00:00:00,7,3,4,FMN 16 Noorderlaanbrug
676,Noorderlaan,2023-01-24,01:00:00,5,4,1,FMN 16 Noorderlaanbrug
676,Noorderlaan,2023-01-24,02:00:00,2,1,1,FMN 16 Noorderlaanbrug
676,Noorderlaan,2023-01-24,03:00:00,8,8,0,FMN 16 Noorderlaanbrug
676,Noorderlaan,2023-01-24,04:00:00,24,14,10,FMN 16 Noorderlaanbrug
676,Noorderlaan,2023-01-24,05:00:00,56,24,32,FMN 16 Noorderlaanbrug
676,Noorderlaan,2023-01-24,06:00:00,123,69,54,FMN 16 Noorderlaanbrug
676,Noorderlaan,2023-01-24,07:00:00,333,232,101,FMN 16 Noorderlaanbrug
676,Noorderlaan,2023-01-24,08:00:00,418,322,96,FMN 16 Noorderlaanbrug
676,Noorderlaan,2023-01-24,09:00:00,118,77,41,FMN 16 Noorderlaanbrug
676,Noorderlaan,2023-01-24,10:00:00,70,50,20,FMN 16 Noorderlaanbrug
676,Noorderlaan,2023-01-24,11:00:00,83,51,32,FMN 16 Noorderlaanbrug
676,Noorderlaan,2023-01-24,12:00:00,118,63,55,FMN 16 Noorderlaanbrug
676,Noorderlaan,2023-01-24,13:00:00,98,42,56,FMN 16 Noorderlaanbrug
676,Noorderlaan,2023-01-24,14:00:00,121,74,47,FMN 16 Noorderlaanbrug
676,Noorderlaan,2023-01-24,15:00:00,150,68,82,FMN 16 Noorderlaanbrug
676,Noorderlaan,2023-01-24,16:00:00,301,149,152,FMN 16 Noorderlaanbrug
676,Noorderlaan,2023-01-24,17:00:00,328,155,173,FMN 16 Noorderlaanbrug
676,Noorderlaan,2023-01-24,18:00:00,187,66,121,FMN 16 Noorderlaanbrug
676,Noorderlaan,2023-01-24,19:00:00,76,38,38,FMN 16 Noorderlaanbrug
676,Noorderlaan,2023-01-24,20:00:00,52,37,15,FMN 16 Noorderlaanbrug
676,Noorderlaan,2023-01-24,21:00:00,49,22,27,FMN 16 Noorderlaanbrug
676,Noorderlaan,2023-01-24,22:00:00,54,37,17,FMN 16 Noorderlaanbrug
676,Noorderlaan,2023-01-24,23:00:00,30,17,13,FMN 16 Noorderlaanbrug
676,Noorderlaan,2023-01-25,00:00:00,12,7,5,FMN 16 Noorderlaanbrug
676,Noorderlaan,2023-01-25,01:00:00,5,2,3,FMN 16 Noorderlaanbrug
676,Noorderlaan,2023-01-25,02:00:00,3,1,2,FMN 16 Noorderlaanbrug
676,Noorderlaan,2023-01-25,03:00:00,6,6,0,FMN 16 Noorderlaanbrug
676,Noorderlaan,2023-01-25,04:00:00,28,17,11,FMN 16 Noorderlaanbrug
676,Noorderlaan,2023-01-25,05:00:00,72,33,39,FMN 16 Noorderlaanbrug
676,Noorderlaan,2023-01-25,06:00:00,111,69,42,FMN 16 Noorderlaanbrug
676,Noorderlaan,2023-01-25,07:00:00,322,219,103,FMN 16 Noorderlaanbrug
676,Noorderlaan,2023-01-25,08:00:00,311,213,98,FMN 16 Noorderlaanbrug
676,Noorderlaan,2023-01-25,09:00:00,118,71,47,FMN 16 Noorderlaanbrug
676,Noorderlaan,2023-01-25,10:00:00,68,48,20,FMN 16 Noorderlaanbrug
676,Noorderlaan,2023-01-25,11:00:00,79,38,41,FMN 16 Noorderlaanbrug
676,Noorderlaan,2023-01-25,12:00:00,150,72,78,FMN 16 Noorderlaanbrug
676,Noorderlaan,2023-01-25,13:00:00,160,69,91,FMN 16 Noorderlaanbrug
676,Noorderlaan,2023-01-25,14:00:00,136,89,47,FMN 16 Noorderlaanbrug
676,Noorderlaan,2023-01-25,15:00:00,145,85,60,FMN 16 Noorderlaanbrug
676,Noorderlaan,2023-01-25,16:00:00,45,34,11,FMN 16 Noorderlaanbrug
676,Noorderlaan,2023-01-25,17:00:00,75,43,32,FMN 16 Noorderlaanbrug
676,Noorderlaan,2023-01-25,18:00:00,38,26,12,FMN 16 Noorderlaanbrug
676,Noorderlaan,2023-01-25,19:00:00,19,7,12,FMN 16 Noorderlaanbrug
676,Noorderlaan,2023-01-25,20:00:00,14,5,9,FMN 16 Noorderlaanbrug
676,Noorderlaan,2023-01-25,21:00:00,8,3,5,FMN 16 Noorderlaanbrug
676,Noorderlaan,2023-01-25,22:00:00,12,10,2,FMN 16 Noorderlaanbrug
676,Noorderlaan,2023-01-25,23:00:00,6,5,1,FMN 16 Noorderlaanbrug
676,Noorderlaan,2023-01-26,00:00:00,13,9,4,FMN 16 Noorderlaanbrug
676,Noorderlaan,2023-01-26,01:00:00,7,2,5,FMN 16 Noorderlaanbrug
676,Noorderlaan,2023-01-26,02:00:00,3,2,1,FMN 16 Noorderlaanbrug
676,Noorderlaan,2023-01-26,03:00:00,6,6,0,FMN 16 Noorderlaanbrug
676,Noorderlaan,2023-01-26,04:00:00,23,11,12,FMN 16 Noorderlaanbrug
676,Noorderlaan,2023-01-26,05:00:00,64,22,42,FMN 16 Noorderlaanbrug
676,Noorderlaan,2023-01-26,06:00:00,96,53,43,FMN 16 Noorderlaanbrug
676,Noorderlaan,2023-01-26,07:00:00,270,183,87,FMN 16 Noorderlaanbrug
676,Noorderlaan,2023-01-26,08:00:00,354,272,82,FMN 16 Noorderlaanbrug
676,Noorderlaan,2023-01-26,09:00:00,108,70,38,FMN 16 Noorderlaanbrug
676,Noorderlaan,2023-01-26,10:00:00,65,42,23,FMN 16 Noorderlaanbrug
676,Noorderlaan,2023-01-26,11:00:00,71,56,15,FMN 16 Noorderlaanbrug
676,Noorderlaan,2023-01-26,12:00:00,103,66,37,FMN 16 Noorderlaanbrug
676,Noorderlaan,2023-01-26,13:00:00,82,38,44,FMN 16 Noorderlaanbrug
676,Noorderlaan,2023-01-26,14:00:00,118,70,48,FMN 16 Noorderlaanbrug
676,Noorderlaan,2023-01-26,15:00:00,154,70,84,FMN 16 Noorderlaanbrug
676,Noorderlaan,2023-01-26,16:00:00,281,134,147,FMN 16 Noorderlaanbrug
676,Noorderlaan,2023-01-26,17:00:00,258,131,127,FMN 16 Noorderlaanbrug
676,Noorderlaan,2023-01-26,18:00:00,159,79,80,FMN 16 Noorderlaanbrug
676,Noorderlaan,2023-01-26,19:00:00,63,27,36,FMN 16 Noorderlaanbrug
676,Noorderlaan,2023-01-26,20:00:00,59,32,27,FMN 16 Noorderlaanbrug
676,Noorderlaan,2023-01-26,21:00:00,53,27,26,FMN 16 Noorderlaanbrug
676,Noorderlaan,2023-01-26,22:00:00,51,33,18,FMN 16 Noorderlaanbrug
676,Noorderlaan,2023-01-26,23:00:00,43,26,17,FMN 16 Noorderlaanbrug
676,Noorderlaan,2023-01-27,00:00:00,22,12,10,FMN 16 Noorderlaanbrug
676,Noorderlaan,2023-01-27,01:00:00,9,6,3,FMN 16 Noorderlaanbrug
676,Noorderlaan,2023-01-27,02:00:00,7,2,5,FMN 16 Noorderlaanbrug
676,Noorderlaan,2023-01-27,03:00:00,14,9,5,FMN 16 Noorderlaanbrug
676,Noorderlaan,2023-01-27,04:00:00,24,11,13,FMN 16 Noorderlaanbrug
676,Noorderlaan,2023-01-27,05:00:00,66,29,37,FMN 16 Noorderlaanbrug
676,Noorderlaan,2023-01-27,06:00:00,97,56,41,FMN 16 Noorderlaanbrug
676,Noorderlaan,2023-01-27,07:00:00,250,157,93,FMN 16 Noorderlaanbrug
676,Noorderlaan,2023-01-27,08:00:00,296,223,73,FMN 16 Noorderlaanbrug
676,Noorderlaan,2023-01-27,09:00:00,127,85,42,FMN 16 Noorderlaanbrug
676,Noorderlaan,2023-01-27,10:00:00,81,56,25,FMN 16 Noorderlaanbrug
676,Noorderlaan,2023-01-27,11:00:00,110,70,40,FMN 16 Noorderlaanbrug
676,Noorderlaan,2023-01-27,12:00:00,128,79,49,FMN 16 Noorderlaanbrug
676,Noorderlaan,2023-01-27,13:00:00,113,52,61,FMN 16 Noorderlaanbrug
676,Noorderlaan,2023-01-27,14:00:00,138,78,60,FMN 16 Noorderlaanbrug
676,Noorderlaan,2023-01-27,15:00:00,162,76,86,FMN 16 Noorderlaanbrug
676,Noorderlaan,2023-01-27,16:00:00,262,146,116,FMN 16 Noorderlaanbrug
676,Noorderlaan,2023-01-27,17:00:00,233,122,111,FMN 16 Noorderlaanbrug
676,Noorderlaan,2023-01-27,18:00:00,136,66,70,FMN 16 Noorderlaanbrug
676,Noorderlaan,2023-01-27,19:00:00,79,52,27,FMN 16 Noorderlaanbrug
676,Noorderlaan,2023-01-27,20:00:00,63,43,20,FMN 16 Noorderlaanbrug
676,Noorderlaan,2023-01-27,21:00:00,50,29,21,FMN 16 Noorderlaanbrug
676,Noorderlaan,2023-01-27,22:00:00,54,29,25,FMN 16 Noorderlaanbrug
676,Noorderlaan,2023-01-27,23:00:00,52,17,35,FMN 16 Noorderlaanbrug
676,Noorderlaan,2023-01-28,00:00:00,55,29,26,FMN 16 Noorderlaanbrug
676,Noorderlaan,2023-01-28,01:00:00,32,12,20,FMN 16 Noorderlaanbrug
676,Noorderlaan,2023-01-28,02:00:00,26,10,16,FMN 16 Noorderlaanbrug
676,Noorderlaan,2023-01-28,03:00:00,24,19,5,FMN 16 Noorderlaanbrug
676,Noorderlaan,2023-01-28,04:00:00,20,13,7,FMN 16 Noorderlaanbrug
676,Noorderlaan,2023-01-28,05:00:00,31,15,16,FMN 16 Noorderlaanbrug
676,Noorderlaan,2023-01-28,06:00:00,33,20,13,FMN 16 Noorderlaanbrug
676,Noorderlaan,2023-01-28,07:00:00,45,36,9,FMN 16 Noorderlaanbrug
676,Noorderlaan,2023-01-28,08:00:00,41,31,10,FMN 16 Noorderlaanbrug
676,Noorderlaan,2023-01-28,09:00:00,47,32,15,FMN 16 Noorderlaanbrug
676,Noorderlaan,2023-01-28,10:00:00,91,57,34,FMN 16 Noorderlaanbrug
676,Noorderlaan,2023-01-28,11:00:00,88,54,34,FMN 16 Noorderlaanbrug
676,Noorderlaan,2023-01-28,12:00:00,78,48,30,FMN 16 Noorderlaanbrug
676,Noorderlaan,2023-01-28,13:00:00,108,70,38,FMN 16 Noorderlaanbrug
676,Noorderlaan,2023-01-28,14:00:00,80,50,30,FMN 16 Noorderlaanbrug
676,Noorderlaan,2023-01-28,15:00:00,104,59,45,FMN 16 Noorderlaanbrug
676,Noorderlaan,2023-01-28,16:00:00,106,70,36,FMN 16 Noorderlaanbrug
676,Noorderlaan,2023-01-28,17:00:00,71,32,39,FMN 16 Noorderlaanbrug
676,Noorderlaan,2023-01-28,18:00:00,91,45,46,FMN 16 Noorderlaanbrug
676,Noorderlaan,2023-01-28,19:00:00,78,48,30,FMN 16 Noorderlaanbrug
676,Noorderlaan,2023-01-28,20:00:00,7,3,4,FMN 16 Noorderlaanbrug
676,Noorderlaan,2023-01-28,21:00:00,0,0,0,FMN 16 Noorderlaanbrug
676,Noorderlaan,2023-01-28,22:00:00,0,0,0,FMN 16 Noorderlaanbrug
676,Noorderlaan,2023-01-28,23:00:00,0,0,0,FMN 16 Noorderlaanbrug
676,Noorderlaan,2023-01-29,00:00:00,1,0,1,FMN 16 Noorderlaanbrug
676,Noorderlaan,2023-01-29,01:00:00,0,0,0,FMN 16 Noorderlaanbrug
676,Noorderlaan,2023-01-29,02:00:00,23,11,12,FMN 16 Noorderlaanbrug
676,Noorderlaan,2023-01-29,03:00:00,18,12,6,FMN 16 Noorderlaanbrug
676,Noorderlaan,2023-01-29,04:00:00,4,2,2,FMN 16 Noorderlaanbrug
676,Noorderlaan,2023-01-29,05:00:00,14,9,5,FMN 16 Noorderlaanbrug
676,Noorderlaan,2023-01-29,06:00:00,28,17,11,FMN 16 Noorderlaanbrug
676,Noorderlaan,2023-01-29,07:00:00,25,17,8,FMN 16 Noorderlaanbrug
676,Noorderlaan,2023-01-29,08:00:00,22,13,9,FMN 16 Noorderlaanbrug
676,Noorderlaan,2023-01-29,09:00:00,38,31,7,FMN 16 Noorderlaanbrug
676,Noorderlaan,2023-01-29,10:00:00,24,21,3,FMN 16 Noorderlaanbrug
676,Noorderlaan,2023-01-29,11:00:00,54,33,21,FMN 16 Noorderlaanbrug
676,Noorderlaan,2023-01-29,12:00:00,50,30,20,FMN 16 Noorderlaanbrug
676,Noorderlaan,2023-01-29,13:00:00,68,37,31,FMN 16 Noorderlaanbrug
676,Noorderlaan,2023-01-29,14:00:00,42,24,18,FMN 16 Noorderlaanbrug
676,Noorderlaan,2023-01-29,15:00:00,53,30,23,FMN 16 Noorderlaanbrug
676,Noorderlaan,2023-01-29,16:00:00,39,16,23,FMN 16 Noorderlaanbrug
676,Noorderlaan,2023-01-29,17:00:00,40,23,17,FMN 16 Noorderlaanbrug
676,Noorderlaan,2023-01-29,18:00:00,33,15,18,FMN 16 Noorderlaanbrug
676,Noorderlaan,2023-01-29,19:00:00,35,22,13,FMN 16 Noorderlaanbrug
676,Noorderlaan,2023-01-29,20:00:00,29,17,12,FMN 16 Noorderlaanbrug
676,Noorderlaan,2023-01-29,21:00:00,30,17,13,FMN 16 Noorderlaanbrug
676,Noorderlaan,2023-01-29,22:00:00,17,12,5,FMN 16 Noorderlaanbrug
676,Noorderlaan,2023-01-29,23:00:00,16,11,5,FMN 16 Noorderlaanbrug
676,Noorderlaan,2023-01-30,00:00:00,8,2,6,FMN 16 Noorderlaanbrug
676,Noorderlaan,2023-01-30,01:00:00,6,1,5,FMN 16 Noorderlaanbrug
676,Noorderlaan,2023-01-30,02:00:00,2,1,1,FMN 16 Noorderlaanbrug
676,Noorderlaan,2023-01-30,03:00:00,3,2,1,FMN 16 Noorderlaanbrug
676,Noorderlaan,2023-01-30,04:00:00,26,15,11,FMN 16 Noorderlaanbrug
676,Noorderlaan,2023-01-30,05:00:00,66,22,44,FMN 16 Noorderlaanbrug
676,Noorderlaan,2023-01-30,06:00:00,128,68,60,FMN 16 Noorderlaanbrug
676,Noorderlaan,2023-01-30,07:00:00,288,211,77,FMN 16 Noorderlaanbrug
676,Noorderlaan,2023-01-30,08:00:00,378,281,97,FMN 16 Noorderlaanbrug
676,Noorderlaan,2023-01-30,09:00:00,123,83,40,FMN 16 Noorderlaanbrug
676,Noorderlaan,2023-01-30,10:00:00,74,49,25,FMN 16 Noorderlaanbrug
676,Noorderlaan,2023-01-30,11:00:00,84,46,38,FMN 16 Noorderlaanbrug
676,Noorderlaan,2023-01-30,12:00:00,114,63,51,FMN 16 Noorderlaanbrug
676,Noorderlaan,2023-01-30,13:00:00,97,51,46,FMN 16 Noorderlaanbrug
676,Noorderlaan,2023-01-30,14:00:00,136,84,52,FMN 16 Noorderlaanbrug
676,Noorderlaan,2023-01-30,15:00:00,169,82,87,FMN 16 Noorderlaanbrug
676,Noorderlaan,2023-01-30,16:00:00,286,149,137,FMN 16 Noorderlaanbrug
676,Noorderlaan,2023-01-30,17:00:00,317,142,175,FMN 16 Noorderlaanbrug
676,Noorderlaan,2023-01-30,18:00:00,162,81,81,FMN 16 Noorderlaanbrug
676,Noorderlaan,2023-01-30,19:00:00,59,35,24,FMN 16 Noorderlaanbrug
676,Noorderlaan,2023-01-30,20:00:00,44,25,19,FMN 16 Noorderlaanbrug
676,Noorderlaan,2023-01-30,21:00:00,43,22,21,FMN 16 Noorderlaanbrug
676,Noorderlaan,2023-01-30,22:00:00,43,25,18,FMN 16 Noorderlaanbrug
676,Noorderlaan,2023-01-30,23:00:00,25,12,13,FMN 16 Noorderlaanbrug
676,Noorderlaan,2023-01-31,00:00:00,11,7,4,FMN 16 Noorderlaanbrug
676,Noorderlaan,2023-01-31,01:00:00,9,6,3,FMN 16 Noorderlaanbrug
676,Noorderlaan,2023-01-31,02:00:00,1,0,1,FMN 16 Noorderlaanbrug
676,Noorderlaan,2023-01-31,03:00:00,9,6,3,FMN 16 Noorderlaanbrug
676,Noorderlaan,2023-01-31,04:00:00,20,14,6,FMN 16 Noorderlaanbrug
676,Noorderlaan,2023-01-31,05:00:00,71,23,48,FMN 16 Noorderlaanbrug
676,Noorderlaan,2023-01-31,06:00:00,131,69,62,FMN 16 Noorderlaanbrug
676,Noorderlaan,2023-01-31,07:00:00,326,231,95,FMN 16 Noorderlaanbrug
676,Noorderlaan,2023-01-31,08:00:00,411,323,88,FMN 16 Noorderlaanbrug
676,Noorderlaan,2023-01-31,09:00:00,117,83,34,FMN 16 Noorderlaanbrug
676,Noorderlaan,2023-01-31,10:00:00,66,43,23,FMN 16 Noorderlaanbrug
676,Noorderlaan,2023-01-31,11:00:00,62,28,34,FMN 16 Noorderlaanbrug
676,Noorderlaan,2023-01-31,12:00:00,96,54,42,FMN 16 Noorderlaanbrug
676,Noorderlaan,2023-01-31,13:00:00,121,62,59,FMN 16 Noorderlaanbrug
676,Noorderlaan,2023-01-31,14:00:00,105,69,36,FMN 16 Noorderlaanbrug
676,Noorderlaan,2023-01-31,15:00:00,160,84,76,FMN 16 Noorderlaanbrug
676,Noorderlaan,2023-01-31,16:00:00,314,157,157,FMN 16 Noorderlaanbrug
676,Noorderlaan,2023-01-31,17:00:00,330,167,163,FMN 16 Noorderlaanbrug
676,Noorderlaan,2023-01-31,18:00:00,164,62,102,FMN 16 Noorderlaanbrug
676,Noorderlaan,2023-01-31,19:00:00,72,41,31,FMN 16 Noorderlaanbrug
676,Noorderlaan,2023-01-31,20:00:00,56,35,21,FMN 16 Noorderlaanbrug
676,Noorderlaan,2023-01-31,21:00:00,57,30,27,FMN 16 Noorderlaanbrug
676,Noorderlaan,2023-01-31,22:00:00,56,38,18,FMN 16 Noorderlaanbrug
676,Noorderlaan,2023-01-31,23:00:00,20,13,7,FMN 16 Noorderlaanbrug
676,Noorderlaan,2023-02-01,00:00:00,3,1,2,FMN 16 Noorderlaanbrug
676,Noorderlaan,2023-02-01,01:00:00,10,8,2,FMN 16 Noorderlaanbrug
676,Noorderlaan,2023-02-01,02:00:00,2,1,1,FMN 16 Noorderlaanbrug
676,Noorderlaan,2023-02-01,03:00:00,2,2,0,FMN 16 Noorderlaanbrug
676,Noorderlaan,2023-02-01,04:00:00,25,19,6,FMN 16 Noorderlaanbrug
676,Noorderlaan,2023-02-01,05:00:00,71,27,44,FMN 16 Noorderlaanbrug
676,Noorderlaan,2023-02-01,06:00:00,127,71,56,FMN 16 Noorderlaanbrug
676,Noorderlaan,2023-02-01,07:00:00,300,208,92,FMN 16 Noorderlaanbrug
676,Noorderlaan,2023-02-01,08:00:00,322,226,96,FMN 16 Noorderlaanbrug
676,Noorderlaan,2023-02-01,09:00:00,120,86,34,FMN 16 Noorderlaanbrug
676,Noorderlaan,2023-02-01,10:00:00,81,51,30,FMN 16 Noorderlaanbrug
676,Noorderlaan,2023-02-01,11:00:00,84,56,28,FMN 16 Noorderlaanbrug
676,Noorderlaan,2023-02-01,12:00:00,153,74,79,FMN 16 Noorderlaanbrug
676,Noorderlaan,2023-02-01,13:00:00,131,61,70,FMN 16 Noorderlaanbrug
676,Noorderlaan,2023-02-01,14:00:00,128,71,57,FMN 16 Noorderlaanbrug
676,Noorderlaan,2023-02-01,15:00:00,153,84,69,FMN 16 Noorderlaanbrug
676,Noorderlaan,2023-02-01,16:00:00,245,146,99,FMN 16 Noorderlaanbrug
676,Noorderlaan,2023-02-01,17:00:00,263,128,135,FMN 16 Noorderlaanbrug
676,Noorderlaan,2023-02-01,18:00:00,135,63,72,FMN 16 Noorderlaanbrug
676,Noorderlaan,2023-02-01,19:00:00,51,27,24,FMN 16 Noorderlaanbrug
676,Noorderlaan,2023-02-01,20:00:00,42,26,16,FMN 16 Noorderlaanbrug
676,Noorderlaan,2023-02-01,21:00:00,43,20,23,FMN 16 Noorderlaanbrug
676,Noorderlaan,2023-02-01,22:00:00,39,25,14,FMN 16 Noorderlaanbrug
676,Noorderlaan,2023-02-01,23:00:00,30,9,21,FMN 16 Noorderlaanbrug
676,Noorderlaan,2023-02-02,00:00:00,90,6,84,FMN 16 Noorderlaanbrug
676,Noorderlaan,2023-02-02,01:00:00,32,7,25,FMN 16 Noorderlaanbrug
676,Noorderlaan,2023-02-02,02:00:00,17,7,10,FMN 16 Noorderlaanbrug
676,Noorderlaan,2023-02-02,03:00:00,22,21,1,FMN 16 Noorderlaanbrug
676,Noorderlaan,2023-02-02,04:00:00,68,56,12,FMN 16 Noorderlaanbrug
676,Noorderlaan,2023-02-02,05:00:00,122,74,48,FMN 16 Noorderlaanbrug
676,Noorderlaan,2023-02-02,06:00:00,127,73,54,FMN 16 Noorderlaanbrug
676,Noorderlaan,2023-02-02,07:00:00,304,214,90,FMN 16 Noorderlaanbrug
676,Noorderlaan,2023-02-02,08:00:00,388,287,101,FMN 16 Noorderlaanbrug
676,Noorderlaan,2023-02-02,09:00:00,99,72,27,FMN 16 Noorderlaanbrug
676,Noorderlaan,2023-02-02,10:00:00,60,41,19,FMN 16 Noorderlaanbrug
676,Noorderlaan,2023-02-02,11:00:00,65,35,30,FMN 16 Noorderlaanbrug
676,Noorderlaan,2023-02-02,12:00:00,132,84,48,FMN 16 Noorderlaanbrug
676,Noorderlaan,2023-02-02,13:00:00,92,55,37,FMN 16 Noorderlaanbrug
676,Noorderlaan,2023-02-02,14:00:00,124,83,41,FMN 16 Noorderlaanbrug
676,Noorderlaan,2023-02-02,15:00:00,178,96,82,FMN 16 Noorderlaanbrug
676,Noorderlaan,2023-02-02,16:00:00,288,143,145,FMN 16 Noorderlaanbrug
676,Noorderlaan,2023-02-02,17:00:00,294,146,148,FMN 16 Noorderlaanbrug
676,Noorderlaan,2023-02-02,18:00:00,172,77,95,FMN 16 Noorderlaanbrug
676,Noorderlaan,2023-02-02,19:00:00,64,35,29,FMN 16 Noorderlaanbrug
676,Noorderlaan,2023-02-02,20:00:00,48,29,19,FMN 16 Noorderlaanbrug
676,Noorderlaan,2023-02-02,21:00:00,50,30,20,FMN 16 Noorderlaanbrug
676,Noorderlaan,2023-02-02,22:00:00,48,26,22,FMN 16 Noorderlaanbrug
676,Noorderlaan,2023-02-02,23:00:00,33,23,10,FMN 16 Noorderlaanbrug
676,Noorderlaan,2023-02-03,00:00:00,12,4,8,FMN 16 Noorderlaanbrug
676,Noorderlaan,2023-02-03,01:00:00,6,3,3,FMN 16 Noorderlaanbrug
676,Noorderlaan,2023-02-03,02:00:00,2,0,2,FMN 16 Noorderlaanbrug
676,Noorderlaan,2023-02-03,03:00:00,10,6,4,FMN 16 Noorderlaanbrug
676,Noorderlaan,2023-02-03,04:00:00,23,12,11,FMN 16 Noorderlaanbrug
676,Noorderlaan,2023-02-03,05:00:00,61,18,43,FMN 16 Noorderlaanbrug
676,Noorderlaan,2023-02-03,06:00:00,116,61,55,FMN 16 Noorderlaanbrug
676,Noorderlaan,2023-02-03,07:00:00,228,150,78,FMN 16 Noorderlaanbrug
676,Noorderlaan,2023-02-03,08:00:00,326,230,96,FMN 16 Noorderlaanbrug
676,Noorderlaan,2023-02-03,09:00:00,122,82,40,FMN 16 Noorderlaanbrug
676,Noorderlaan,2023-02-03,10:00:00,90,58,32,FMN 16 Noorderlaanbrug
676,Noorderlaan,2023-02-03,11:00:00,94,51,43,FMN 16 Noorderlaanbrug
676,Noorderlaan,2023-02-03,12:00:00,100,58,42,FMN 16 Noorderlaanbrug
676,Noorderlaan,2023-02-03,13:00:00,109,58,51,FMN 16 Noorderlaanbrug
676,Noorderlaan,2023-02-03,14:00:00,133,75,58,FMN 16 Noorderlaanbrug
676,Noorderlaan,2023-02-03,15:00:00,174,85,89,FMN 16 Noorderlaanbrug
676,Noorderlaan,2023-02-03,16:00:00,271,135,136,FMN 16 Noorderlaanbrug
676,Noorderlaan,2023-02-03,17:00:00,261,137,124,FMN 16 Noorderlaanbrug
676,Noorderlaan,2023-02-03,18:00:00,137,73,64,FMN 16 Noorderlaanbrug
676,Noorderlaan,2023-02-03,19:00:00,90,49,41,FMN 16 Noorderlaanbrug
676,Noorderlaan,2023-02-03,20:00:00,82,38,44,FMN 16 Noorderlaanbrug
676,Noorderlaan,2023-02-03,21:00:00,62,33,29,FMN 16 Noorderlaanbrug
676,Noorderlaan,2023-02-03,22:00:00,65,39,26,FMN 16 Noorderlaanbrug
676,Noorderlaan,2023-02-03,23:00:00,95,21,74,FMN 16 Noorderlaanbrug
676,Noorderlaan,2023-02-04,00:00:00,0,0,0,FMN 16 Noorderlaanbrug
676,Noorderlaan,2023-02-04,01:00:00,42,15,27,FMN 16 Noorderlaanbrug
676,Noorderlaan,2023-02-04,02:00:00,22,13,9,FMN 16 Noorderlaanbrug
676,Noorderlaan,2023-02-04,03:00:00,32,23,9,FMN 16 Noorderlaanbrug
676,Noorderlaan,2023-02-04,04:00:00,22,9,13,FMN 16 Noorderlaanbrug
676,Noorderlaan,2023-02-04,05:00:00,9,8,1,FMN 16 Noorderlaanbrug
676,Noorderlaan,2023-02-04,06:00:00,13,13,0,FMN 16 Noorderlaanbrug
676,Noorderlaan,2023-02-04,07:00:00,15,15,0,FMN 16 Noorderlaanbrug
676,Noorderlaan,2023-02-04,08:00:00,14,14,0,FMN 16 Noorderlaanbrug
676,Noorderlaan,2023-02-04,09:00:00,28,28,0,FMN 16 Noorderlaanbrug
676,Noorderlaan,2023-02-04,10:00:00,43,43,0,FMN 16 Noorderlaanbrug
676,Noorderlaan,2023-02-04,11:00:00,44,44,0,FMN 16 Noorderlaanbrug
676,Noorderlaan,2023-02-04,12:00:00,62,62,0,FMN 16 Noorderlaanbrug
676,Noorderlaan,2023-02-04,13:00:00,53,53,0,FMN 16 Noorderlaanbrug
676,Noorderlaan,2023-02-04,14:00:00,54,54,0,FMN 16 Noorderlaanbrug
676,Noorderlaan,2023-02-04,15:00:00,54,54,0,FMN 16 Noorderlaanbrug
676,Noorderlaan,2023-02-04,16:00:00,90,64,26,FMN 16 Noorderlaanbrug
676,Noorderlaan,2023-02-04,17:00:00,72,47,25,FMN 16 Noorderlaanbrug
676,Noorderlaan,2023-02-04,18:00:00,47,47,0,FMN 16 Noorderlaanbrug
676,Noorderlaan,2023-02-04,19:00:00,33,33,0,FMN 16 Noorderlaanbrug
676,Noorderlaan,2023-02-04,20:00:00,16,16,0,FMN 16 Noorderlaanbrug
676,Noorderlaan,2023-02-04,21:00:00,15,15,0,FMN 16 Noorderlaanbrug
676,Noorderlaan,2023-02-04,22:00:00,21,21,0,FMN 16 Noorderlaanbrug
676,Noorderlaan,2023-02-04,23:00:00,13,13,0,FMN 16 Noorderlaanbrug
676,Noorderlaan,2023-02-05,00:00:00,0,0,0,FMN 16 Noorderlaanbrug
676,Noorderlaan,2023-02-05,01:00:00,24,10,14,FMN 16 Noorderlaanbrug
676,Noorderlaan,2023-02-05,02:00:00,19,6,13,FMN 16 Noorderlaanbrug
676,Noorderlaan,2023-02-05,03:00:00,21,10,11,FMN 16 Noorderlaanbrug
676,Noorderlaan,2023-02-05,04:00:00,12,8,4,FMN 16 Noorderlaanbrug
676,Noorderlaan,2023-02-05,05:00:00,17,9,8,FMN 16 Noorderlaanbrug
676,Noorderlaan,2023-02-05,06:00:00,18,9,9,FMN 16 Noorderlaanbrug
676,Noorderlaan,2023-02-05,07:00:00,16,8,8,FMN 16 Noorderlaanbrug
676,Noorderlaan,2023-02-05,08:00:00,14,7,7,FMN 16 Noorderlaanbrug
676,Noorderlaan,2023-02-05,09:00:00,30,19,11,FMN 16 Noorderlaanbrug
676,Noorderlaan,2023-02-05,10:00:00,40,22,18,FMN 16 Noorderlaanbrug
676,Noorderlaan,2023-02-05,11:00:00,50,31,19,FMN 16 Noorderlaanbrug
676,Noorderlaan,2023-02-05,12:00:00,58,33,25,FMN 16 Noorderlaanbrug
676,Noorderlaan,2023-02-05,13:00:00,59,27,32,FMN 16 Noorderlaanbrug
676,Noorderlaan,2023-02-05,14:00:00,59,32,27,FMN 16 Noorderlaanbrug
676,Noorderlaan,2023-02-05,15:00:00,59,20,39,FMN 16 Noorderlaanbrug
676,Noorderlaan,2023-02-05,16:00:00,57,26,31,FMN 16 Noorderlaanbrug
676,Noorderlaan,2023-02-05,17:00:00,65,29,36,FMN 16 Noorderlaanbrug
676,Noorderlaan,2023-02-05,18:00:00,58,25,33,FMN 16 Noorderlaanbrug
676,Noorderlaan,2023-02-05,19:00:00,40,18,22,FMN 16 Noorderlaanbrug
676,Noorderlaan,2023-02-05,20:00:00,32,17,15,FMN 16 Noorderlaanbrug
676,Noorderlaan,2023-02-05,21:00:00,30,21,9,FMN 16 Noorderlaanbrug
676,Noorderlaan,2023-02-05,22:00:00,26,16,10,FMN 16 Noorderlaanbrug
676,Noorderlaan,2023-02-05,23:00:00,16,7,9,FMN 16 Noorderlaanbrug
676,Noorderlaan,2023-02-06,00:00:00,0,0,0,FMN 16 Noorderlaanbrug
676,Noorderlaan,2023-02-06,01:00:00,4,0,4,FMN 16 Noorderlaanbrug
676,Noorderlaan,2023-02-06,02:00:00,4,1,3,FMN 16 Noorderlaanbrug
676,Noorderlaan,2023-02-06,03:00:00,6,4,2,FMN 16 Noorderlaanbrug
676,Noorderlaan,2023-02-06,04:00:00,17,11,6,FMN 16 Noorderlaanbrug
676,Noorderlaan,2023-02-06,05:00:00,68,23,45,FMN 16 Noorderlaanbrug
676,Noorderlaan,2023-02-06,06:00:00,111,55,56,FMN 16 Noorderlaanbrug
676,Noorderlaan,2023-02-06,07:00:00,248,154,94,FMN 16 Noorderlaanbrug
676,Noorderlaan,2023-02-06,08:00:00,356,246,110,FMN 16 Noorderlaanbrug
676,Noorderlaan,2023-02-06,09:00:00,102,65,37,FMN 16 Noorderlaanbrug
676,Noorderlaan,2023-02-06,10:00:00,86,51,35,FMN 16 Noorderlaanbrug
676,Noorderlaan,2023-02-06,11:00:00,65,41,24,FMN 16 Noorderlaanbrug
676,Noorderlaan,2023-02-06,12:00:00,112,67,45,FMN 16 Noorderlaanbrug
676,Noorderlaan,2023-02-06,13:00:00,106,43,63,FMN 16 Noorderlaanbrug
676,Noorderlaan,2023-02-06,14:00:00,130,64,66,FMN 16 Noorderlaanbrug
676,Noorderlaan,2023-02-06,15:00:00,175,78,97,FMN 16 Noorderlaanbrug
676,Noorderlaan,2023-02-06,16:00:00,311,139,172,FMN 16 Noorderlaanbrug
676,Noorderlaan,2023-02-06,17:00:00,328,130,198,FMN 16 Noorderlaanbrug
676,Noorderlaan,2023-02-06,18:00:00,164,71,93,FMN 16 Noorderlaanbrug
676,Noorderlaan,2023-02-06,19:00:00,61,31,30,FMN 16 Noorderlaanbrug
676,Noorderlaan,2023-02-06,20:00:00,52,22,30,FMN 16 Noorderlaanbrug
676,Noorderlaan,2023-02-06,21:00:00,32,16,16,FMN 16 Noorderlaanbrug
676,Noorderlaan,2023-02-06,22:00:00,36,19,17,FMN 16 Noorderlaanbrug
676,Noorderlaan,2023-02-06,23:00:00,19,9,10,FMN 16 Noorderlaanbrug
676,Noorderlaan,2023-02-07,00:00:00,0,0,0,FMN 16 Noorderlaanbrug
676,Noorderlaan,2023-02-07,01:00:00,5,2,3,FMN 16 Noorderlaanbrug
676,Noorderlaan,2023-02-07,02:00:00,7,3,4,FMN 16 Noorderlaanbrug
676,Noorderlaan,2023-02-07,03:00:00,10,9,1,FMN 16 Noorderlaanbrug
676,Noorderlaan,2023-02-07,04:00:00,19,13,6,FMN 16 Noorderlaanbrug
676,Noorderlaan,2023-02-07,05:00:00,69,40,29,FMN 16 Noorderlaanbrug
676,Noorderlaan,2023-02-07,06:00:00,130,70,60,FMN 16 Noorderlaanbrug
676,Noorderlaan,2023-02-07,07:00:00,290,197,93,FMN 16 Noorderlaanbrug
676,Noorderlaan,2023-02-07,08:00:00,389,267,122,FMN 16 Noorderlaanbrug
676,Noorderlaan,2023-02-07,09:00:00,142,84,58,FMN 16 Noorderlaanbrug
676,Noorderlaan,2023-02-07,10:00:00,85,51,34,FMN 16 Noorderlaanbrug
676,Noorderlaan,2023-02-07,11:00:00,90,56,34,FMN 16 Noorderlaanbrug
676,Noorderlaan,2023-02-07,12:00:00,135,67,68,FMN 16 Noorderlaanbrug
676,Noorderlaan,2023-02-07,13:00:00,128,57,71,FMN 16 Noorderlaanbrug
676,Noorderlaan,2023-02-07,14:00:00,133,77,56,FMN 16 Noorderlaanbrug
676,Noorderlaan,2023-02-07,15:00:00,189,94,95,FMN 16 Noorderlaanbrug
676,Noorderlaan,2023-02-07,16:00:00,354,180,174,FMN 16 Noorderlaanbrug
676,Noorderlaan,2023-02-07,17:00:00,362,160,202,FMN 16 Noorderlaanbrug
676,Noorderlaan,2023-02-07,18:00:00,203,88,115,FMN 16 Noorderlaanbrug
676,Noorderlaan,2023-02-07,19:00:00,86,44,42,FMN 16 Noorderlaanbrug
676,Noorderlaan,2023-02-07,20:00:00,60,32,28,FMN 16 Noorderlaanbrug
676,Noorderlaan,2023-02-07,21:00:00,43,27,16,FMN 16 Noorderlaanbrug
676,Noorderlaan,2023-02-07,22:00:00,55,37,18,FMN 16 Noorderlaanbrug
676,Noorderlaan,2023-02-07,23:00:00,26,13,13,FMN 16 Noorderlaanbrug
676,Noorderlaan,2023-02-08,00:00:00,0,0,0,FMN 16 Noorderlaanbrug
676,Noorderlaan,2023-02-08,01:00:00,7,1,6,FMN 16 Noorderlaanbrug
676,Noorderlaan,2023-02-08,02:00:00,8,5,3,FMN 16 Noorderlaanbrug
676,Noorderlaan,2023-02-08,03:00:00,10,5,5,FMN 16 Noorderlaanbrug
676,Noorderlaan,2023-02-08,04:00:00,19,8,11,FMN 16 Noorderlaanbrug
676,Noorderlaan,2023-02-08,05:00:00,57,19,38,FMN 16 Noorderlaanbrug
676,Noorderlaan,2023-02-08,06:00:00,85,51,34,FMN 16 Noorderlaanbrug
676,Noorderlaan,2023-02-08,07:00:00,200,111,89,FMN 16 Noorderlaanbrug
676,Noorderlaan,2023-02-08,08:00:00,260,143,117,FMN 16 Noorderlaanbrug
676,Noorderlaan,2023-02-08,09:00:00,76,38,38,FMN 16 Noorderlaanbrug
676,Noorderlaan,2023-02-08,10:00:00,73,40,33,FMN 16 Noorderlaanbrug
676,Noorderlaan,2023-02-08,11:00:00,71,34,37,FMN 16 Noorderlaanbrug
676,Noorderlaan,2023-02-08,12:00:00,144,59,85,FMN 16 Noorderlaanbrug
676,Noorderlaan,2023-02-08,13:00:00,125,51,74,FMN 16 Noorderlaanbrug
676,Noorderlaan,2023-02-08,14:00:00,124,57,67,FMN 16 Noorderlaanbrug
676,Noorderlaan,2023-02-08,15:00:00,153,71,82,FMN 16 Noorderlaanbrug
676,Noorderlaan,2023-02-08,16:00:00,229,112,117,FMN 16 Noorderlaanbrug
676,Noorderlaan,2023-02-08,17:00:00,260,118,142,FMN 16 Noorderlaanbrug
676,Noorderlaan,2023-02-08,18:00:00,143,63,80,FMN 16 Noorderlaanbrug
676,Noorderlaan,2023-02-08,19:00:00,79,34,45,FMN 16 Noorderlaanbrug
676,Noorderlaan,2023-02-08,20:00:00,50,29,21,FMN 16 Noorderlaanbrug
676,Noorderlaan,2023-02-08,21:00:00,47,16,31,FMN 16 Noorderlaanbrug
676,Noorderlaan,2023-02-08,22:00:00,58,31,27,FMN 16 Noorderlaanbrug
676,Noorderlaan,2023-02-08,23:00:00,29,14,15,FMN 16 Noorderlaanbrug
676,Noorderlaan,2023-02-09,00:00:00,0,0,0,FMN 16 Noorderlaanbrug
676,Noorderlaan,2023-02-09,01:00:00,17,5,12,FMN 16 Noorderlaanbrug
676,Noorderlaan,2023-02-09,02:00:00,8,4,4,FMN 16 Noorderlaanbrug
676,Noorderlaan,2023-02-09,03:00:00,8,5,3,FMN 16 Noorderlaanbrug
676,Noorderlaan,2023-02-09,04:00:00,25,16,9,FMN 16 Noorderlaanbrug
676,Noorderlaan,2023-02-09,05:00:00,77,29,48,FMN 16 Noorderlaanbrug
676,Noorderlaan,2023-02-09,06:00:00,102,49,53,FMN 16 Noorderlaanbrug
676,Noorderlaan,2023-02-09,07:00:00,289,174,115,FMN 16 Noorderlaanbrug
676,Noorderlaan,2023-02-09,08:00:00,367,237,130,FMN 16 Noorderlaanbrug
676,Noorderlaan,2023-02-09,09:00:00,125,77,48,FMN 16 Noorderlaanbrug
676,Noorderlaan,2023-02-09,10:00:00,71,42,29,FMN 16 Noorderlaanbrug
676,Noorderlaan,2023-02-09,11:00:00,74,42,32,FMN 16 Noorderlaanbrug
676,Noorderlaan,2023-02-09,12:00:00,92,51,41,FMN 16 Noorderlaanbrug
676,Noorderlaan,2023-02-09,13:00:00,104,50,54,FMN 16 Noorderlaanbrug
676,Noorderlaan,2023-02-09,14:00:00,133,70,63,FMN 16 Noorderlaanbrug
676,Noorderlaan,2023-02-09,15:00:00,166,74,92,FMN 16 Noorderlaanbrug
676,Noorderlaan,2023-02-09,16:00:00,295,129,166,FMN 16 Noorderlaanbrug
676,Noorderlaan,2023-02-09,17:00:00,279,129,150,FMN 16 Noorderlaanbrug
676,Noorderlaan,2023-02-09,18:00:00,155,74,81,FMN 16 Noorderlaanbrug
676,Noorderlaan,2023-02-09,19:00:00,78,39,39,FMN 16 Noorderlaanbrug
676,Noorderlaan,2023-02-09,20:00:00,44,21,23,FMN 16 Noorderlaanbrug
676,Noorderlaan,2023-02-09,21:00:00,44,16,28,FMN 16 Noorderlaanbrug
676,Noorderlaan,2023-02-09,22:00:00,62,33,29,FMN 16 Noorderlaanbrug
676,Noorderlaan,2023-02-09,23:00:00,25,5,20,FMN 16 Noorderlaanbrug
676,Noorderlaan,2023-02-10,00:00:00,0,0,0,FMN 16 Noorderlaanbrug
676,Noorderlaan,2023-02-10,01:00:00,13,7,6,FMN 16 Noorderlaanbrug
676,Noorderlaan,2023-02-10,02:00:00,9,4,5,FMN 16 Noorderlaanbrug
676,Noorderlaan,2023-02-10,03:00:00,9,4,5,FMN 16 Noorderlaanbrug
676,Noorderlaan,2023-02-10,04:00:00,17,5,12,FMN 16 Noorderlaanbrug
676,Noorderlaan,2023-02-10,05:00:00,78,32,46,FMN 16 Noorderlaanbrug
676,Noorderlaan,2023-02-10,06:00:00,90,43,47,FMN 16 Noorderlaanbrug
676,Noorderlaan,2023-02-10,07:00:00,219,134,85,FMN 16 Noorderlaanbrug
676,Noorderlaan,2023-02-10,08:00:00,278,168,110,FMN 16 Noorderlaanbrug
676,Noorderlaan,2023-02-10,09:00:00,106,75,31,FMN 16 Noorderlaanbrug
676,Noorderlaan,2023-02-10,10:00:00,66,38,28,FMN 16 Noorderlaanbrug
676,Noorderlaan,2023-02-10,11:00:00,94,57,37,FMN 16 Noorderlaanbrug
676,Noorderlaan,2023-02-10,12:00:00,107,52,55,FMN 16 Noorderlaanbrug
676,Noorderlaan,2023-02-10,13:00:00,123,66,57,FMN 16 Noorderlaanbrug
676,Noorderlaan,2023-02-10,14:00:00,124,58,66,FMN 16 Noorderlaanbrug
676,Noorderlaan,2023-02-10,15:00:00,165,71,94,FMN 16 Noorderlaanbrug
676,Noorderlaan,2023-02-10,16:00:00,254,119,135,FMN 16 Noorderlaanbrug
676,Noorderlaan,2023-02-10,17:00:00,209,92,117,FMN 16 Noorderlaanbrug
676,Noorderlaan,2023-02-10,18:00:00,138,57,81,FMN 16 Noorderlaanbrug
676,Noorderlaan,2023-02-10,19:00:00,78,45,33,FMN 16 Noorderlaanbrug
676,Noorderlaan,2023-02-10,20:00:00,61,37,24,FMN 16 Noorderlaanbrug
676,Noorderlaan,2023-02-10,21:00:00,56,21,35,FMN 16 Noorderlaanbrug
676,Noorderlaan,2023-02-10,22:00:00,59,31,28,FMN 16 Noorderlaanbrug
676,Noorderlaan,2023-02-10,23:00:00,53,21,32,FMN 16 Noorderlaanbrug
676,Noorderlaan,2023-02-11,00:00:00,49,21,28,FMN 16 Noorderlaanbrug
676,Noorderlaan,2023-02-11,01:00:00,21,14,7,FMN 16 Noorderlaanbrug
676,Noorderlaan,2023-02-11,02:00:00,42,25,17,FMN 16 Noorderlaanbrug
676,Noorderlaan,2023-02-11,03:00:00,20,15,5,FMN 16 Noorderlaanbrug
676,Noorderlaan,2023-02-11,04:00:00,23,18,5,FMN 16 Noorderlaanbrug
676,Noorderlaan,2023-02-11,05:00:00,26,19,7,FMN 16 Noorderlaanbrug
676,Noorderlaan,2023-02-11,06:00:00,35,22,13,FMN 16 Noorderlaanbrug
676,Noorderlaan,2023-02-11,07:00:00,32,18,14,FMN 16 Noorderlaanbrug
676,Noorderlaan,2023-02-11,08:00:00,30,22,8,FMN 16 Noorderlaanbrug
676,Noorderlaan,2023-02-11,09:00:00,59,45,14,FMN 16 Noorderlaanbrug
676,Noorderlaan,2023-02-11,10:00:00,72,48,24,FMN 16 Noorderlaanbrug
676,Noorderlaan,2023-02-11,11:00:00,70,39,31,FMN 16 Noorderlaanbrug
676,Noorderlaan,2023-02-11,12:00:00,86,55,31,FMN 16 Noorderlaanbrug
676,Noorderlaan,2023-02-11,13:00:00,85,52,33,FMN 16 Noorderlaanbrug
676,Noorderlaan,2023-02-11,14:00:00,122,70,52,FMN 16 Noorderlaanbrug
676,Noorderlaan,2023-02-11,15:00:00,74,36,38,FMN 16 Noorderlaanbrug
676,Noorderlaan,2023-02-11,16:00:00,104,56,48,FMN 16 Noorderlaanbrug
676,Noorderlaan,2023-02-11,17:00:00,94,64,30,FMN 16 Noorderlaanbrug
676,Noorderlaan,2023-02-11,18:00:00,102,68,34,FMN 16 Noorderlaanbrug
676,Noorderlaan,2023-02-11,19:00:00,67,41,26,FMN 16 Noorderlaanbrug
676,Noorderlaan,2023-02-11,20:00:00,46,25,21,FMN 16 Noorderlaanbrug
676,Noorderlaan,2023-02-11,21:00:00,38,14,24,FMN 16 Noorderlaanbrug
676,Noorderlaan,2023-02-11,22:00:00,33,20,13,FMN 16 Noorderlaanbrug
676,Noorderlaan,2023-02-11,23:00:00,47,24,23,FMN 16 Noorderlaanbrug
676,Noorderlaan,2023-02-12,00:00:00,79,37,42,FMN 16 Noorderlaanbrug
676,Noorderlaan,2023-02-12,01:00:00,27,8,19,FMN 16 Noorderlaanbrug
676,Noorderlaan,2023-02-12,02:00:00,27,11,16,FMN 16 Noorderlaanbrug
676,Noorderlaan,2023-02-12,03:00:00,17,8,9,FMN 16 Noorderlaanbrug
676,Noorderlaan,2023-02-12,04:00:00,25,17,8,FMN 16 Noorderlaanbrug
676,Noorderlaan,2023-02-12,05:00:00,27,18,9,FMN 16 Noorderlaanbrug
676,Noorderlaan,2023-02-12,06:00:00,28,15,13,FMN 16 Noorderlaanbrug
676,Noorderlaan,2023-02-12,07:00:00,12,6,6,FMN 16 Noorderlaanbrug
676,Noorderlaan,2023-02-12,08:00:00,24,15,9,FMN 16 Noorderlaanbrug
676,Noorderlaan,2023-02-12,09:00:00,50,34,16,FMN 16 Noorderlaanbrug
676,Noorderlaan,2023-02-12,10:00:00,60,43,17,FMN 16 Noorderlaanbrug
676,Noorderlaan,2023-02-12,11:00:00,67,46,21,FMN 16 Noorderlaanbrug
676,Noorderlaan,2023-02-12,12:00:00,47,30,17,FMN 16 Noorderlaanbrug
676,Noorderlaan,2023-02-12,13:00:00,69,41,28,FMN 16 Noorderlaanbrug
676,Noorderlaan,2023-02-12,14:00:00,81,48,33,FMN 16 Noorderlaanbrug
676,Noorderlaan,2023-02-12,15:00:00,52,33,19,FMN 16 Noorderlaanbrug
676,Noorderlaan,2023-02-12,16:00:00,65,36,29,FMN 16 Noorderlaanbrug
676,Noorderlaan,2023-02-12,17:00:00,63,33,30,FMN 16 Noorderlaanbrug
676,Noorderlaan,2023-02-12,18:00:00,59,38,21,FMN 16 Noorderlaanbrug
676,Noorderlaan,2023-02-12,19:00:00,59,40,19,FMN 16 Noorderlaanbrug
676,Noorderlaan,2023-02-12,20:00:00,39,20,19,FMN 16 Noorderlaanbrug
676,Noorderlaan,2023-02-12,21:00:00,30,17,13,FMN 16 Noorderlaanbrug
676,Noorderlaan,2023-02-12,22:00:00,32,17,15,FMN 16 Noorderlaanbrug
676,Noorderlaan,2023-02-12,23:00:00,26,13,13,FMN 16 Noorderlaanbrug
676,Noorderlaan,2023-02-13,00:00:00,14,5,9,FMN 16 Noorderlaanbrug
676,Noorderlaan,2023-02-13,01:00:00,8,3,5,FMN 16 Noorderlaanbrug
676,Noorderlaan,2023-02-13,02:00:00,0,0,0,FMN 16 Noorderlaanbrug
676,Noorderlaan,2023-02-13,03:00:00,6,3,3,FMN 16 Noorderlaanbrug
676,Noorderlaan,2023-02-13,04:00:00,25,12,13,FMN 16 Noorderlaanbrug
676,Noorderlaan,2023-02-13,05:00:00,70,25,45,FMN 16 Noorderlaanbrug
676,Noorderlaan,2023-02-13,06:00:00,130,70,60,FMN 16 Noorderlaanbrug
676,Noorderlaan,2023-02-13,07:00:00,261,157,104,FMN 16 Noorderlaanbrug
676,Noorderlaan,2023-02-13,08:00:00,359,234,125,FMN 16 Noorderlaanbrug
676,Noorderlaan,2023-02-13,09:00:00,113,69,44,FMN 16 Noorderlaanbrug
676,Noorderlaan,2023-02-13,10:00:00,89,52,37,FMN 16 Noorderlaanbrug
676,Noorderlaan,2023-02-13,11:00:00,84,48,36,FMN 16 Noorderlaanbrug
676,Noorderlaan,2023-02-13,12:00:00,116,56,60,FMN 16 Noorderlaanbrug
676,Noorderlaan,2023-02-13,13:00:00,115,47,68,FMN 16 Noorderlaanbrug
676,Noorderlaan,2023-02-13,14:00:00,133,70,63,FMN 16 Noorderlaanbrug
676,Noorderlaan,2023-02-13,15:00:00,193,84,109,FMN 16 Noorderlaanbrug
676,Noorderlaan,2023-02-13,16:00:00,324,143,181,FMN 16 Noorderlaanbrug
676,Noorderlaan,2023-02-13,17:00:00,362,137,225,FMN 16 Noorderlaanbrug
676,Noorderlaan,2023-02-13,18:00:00,168,64,104,FMN 16 Noorderlaanbrug
676,Noorderlaan,2023-02-13,19:00:00,64,30,34,FMN 16 Noorderlaanbrug
676,Noorderlaan,2023-02-13,20:00:00,49,21,28,FMN 16 Noorderlaanbrug
676,Noorderlaan,2023-02-13,21:00:00,46,18,28,FMN 16 Noorderlaanbrug
676,Noorderlaan,2023-02-13,22:00:00,58,32,26,FMN 16 Noorderlaanbrug
676,Noorderlaan,2023-02-13,23:00:00,23,11,12,FMN 16 Noorderlaanbrug
676,Noorderlaan,2023-02-14,00:00:00,6,4,2,FMN 16 Noorderlaanbrug
676,Noorderlaan,2023-02-14,01:00:00,7,4,3,FMN 16 Noorderlaanbrug
676,Noorderlaan,2023-02-14,02:00:00,1,0,1,FMN 16 Noorderlaanbrug
676,Noorderlaan,2023-02-14,03:00:00,7,5,2,FMN 16 Noorderlaanbrug
676,Noorderlaan,2023-02-14,04:00:00,27,16,11,FMN 16 Noorderlaanbrug
676,Noorderlaan,2023-02-14,05:00:00,90,36,54,FMN 16 Noorderlaanbrug
676,Noorderlaan,2023-02-14,06:00:00,140,72,68,FMN 16 Noorderlaanbrug
676,Noorderlaan,2023-02-14,07:00:00,327,196,131,FMN 16 Noorderlaanbrug
676,Noorderlaan,2023-02-14,08:00:00,422,278,144,FMN 16 Noorderlaanbrug
676,Noorderlaan,2023-02-14,09:00:00,133,86,47,FMN 16 Noorderlaanbrug
676,Noorderlaan,2023-02-14,10:00:00,91,51,40,FMN 16 Noorderlaanbrug
676,Noorderlaan,2023-02-14,11:00:00,78,40,38,FMN 16 Noorderlaanbrug
676,Noorderlaan,2023-02-14,12:00:00,128,53,75,FMN 16 Noorderlaanbrug
676,Noorderlaan,2023-02-14,13:00:00,132,49,83,FMN 16 Noorderlaanbrug
676,Noorderlaan,2023-02-14,14:00:00,174,88,86,FMN 16 Noorderlaanbrug
676,Noorderlaan,2023-02-14,15:00:00,203,81,122,FMN 16 Noorderlaanbrug
676,Noorderlaan,2023-02-14,16:00:00,384,172,212,FMN 16 Noorderlaanbrug
676,Noorderlaan,2023-02-14,17:00:00,403,165,238,FMN 16 Noorderlaanbrug
676,Noorderlaan,2023-02-14,18:00:00,225,81,144,FMN 16 Noorderlaanbrug
676,Noorderlaan,2023-02-14,19:00:00,107,48,59,FMN 16 Noorderlaanbrug
676,Noorderlaan,2023-02-14,20:00:00,64,26,38,FMN 16 Noorderlaanbrug
676,Noorderlaan,2023-02-14,21:00:00,49,22,27,FMN 16 Noorderlaanbrug
676,Noorderlaan,2023-02-14,22:00:00,59,31,28,FMN 16 Noorderlaanbrug
676,Noorderlaan,2023-02-14,23:00:00,28,16,12,FMN 16 Noorderlaanbrug
676,Noorderlaan,2023-02-15,00:00:00,5,3,2,FMN 16 Noorderlaanbrug
676,Noorderlaan,2023-02-15,01:00:00,10,3,7,FMN 16 Noorderlaanbrug
676,Noorderlaan,2023-02-15,02:00:00,4,0,4,FMN 16 Noorderlaanbrug
676,Noorderlaan,2023-02-15,03:00:00,9,6,3,FMN 16 Noorderlaanbrug
676,Noorderlaan,2023-02-15,04:00:00,23,12,11,FMN 16 Noorderlaanbrug
676,Noorderlaan,2023-02-15,05:00:00,69,23,46,FMN 16 Noorderlaanbrug
676,Noorderlaan,2023-02-15,06:00:00,110,51,59,FMN 16 Noorderlaanbrug
676,Noorderlaan,2023-02-15,07:00:00,212,111,101,FMN 16 Noorderlaanbrug
676,Noorderlaan,2023-02-15,08:00:00,301,162,139,FMN 16 Noorderlaanbrug
676,Noorderlaan,2023-02-15,09:00:00,96,55,41,FMN 16 Noorderlaanbrug
676,Noorderlaan,2023-02-15,10:00:00,54,34,20,FMN 16 Noorderlaanbrug
676,Noorderlaan,2023-02-15,11:00:00,82,37,45,FMN 16 Noorderlaanbrug
676,Noorderlaan,2023-02-15,12:00:00,161,63,98,FMN 16 Noorderlaanbrug
676,Noorderlaan,2023-02-15,13:00:00,140,53,87,FMN 16 Noorderlaanbrug
676,Noorderlaan,2023-02-15,14:00:00,134,59,75,FMN 16 Noorderlaanbrug
676,Noorderlaan,2023-02-15,15:00:00,169,73,96,FMN 16 Noorderlaanbrug
676,Noorderlaan,2023-02-15,16:00:00,256,122,134,FMN 16 Noorderlaanbrug
676,Noorderlaan,2023-02-15,17:00:00,301,115,186,FMN 16 Noorderlaanbrug
676,Noorderlaan,2023-02-15,18:00:00,144,50,94,FMN 16 Noorderlaanbrug
676,Noorderlaan,2023-02-15,19:00:00,82,35,47,FMN 16 Noorderlaanbrug
676,Noorderlaan,2023-02-15,20:00:00,50,21,29,FMN 16 Noorderlaanbrug
676,Noorderlaan,2023-02-15,21:00:00,61,28,33,FMN 16 Noorderlaanbrug
676,Noorderlaan,2023-02-15,22:00:00,61,31,30,FMN 16 Noorderlaanbrug
676,Noorderlaan,2023-02-15,23:00:00,30,7,23,FMN 16 Noorderlaanbrug
676,Noorderlaan,2023-02-16,00:00:00,22,7,15,FMN 16 Noorderlaanbrug
676,Noorderlaan,2023-02-16,01:00:00,14,6,8,FMN 16 Noorderlaanbrug
676,Noorderlaan,2023-02-16,02:00:00,8,5,3,FMN 16 Noorderlaanbrug
676,Noorderlaan,2023-02-16,03:00:00,17,13,4,FMN 16 Noorderlaanbrug
676,Noorderlaan,2023-02-16,04:00:00,31,21,10,FMN 16 Noorderlaanbrug
676,Noorderlaan,2023-02-16,05:00:00,79,39,40,FMN 16 Noorderlaanbrug
676,Noorderlaan,2023-02-16,06:00:00,116,57,59,FMN 16 Noorderlaanbrug
676,Noorderlaan,2023-02-16,07:00:00,310,187,123,FMN 16 Noorderlaanbrug
676,Noorderlaan,2023-02-16,08:00:00,387,263,124,FMN 16 Noorderlaanbrug
676,Noorderlaan,2023-02-16,09:00:00,132,87,45,FMN 16 Noorderlaanbrug
676,Noorderlaan,2023-02-16,10:00:00,79,56,23,FMN 16 Noorderlaanbrug
676,Noorderlaan,2023-02-16,11:00:00,69,39,30,FMN 16 Noorderlaanbrug
676,Noorderlaan,2023-02-16,12:00:00,105,49,56,FMN 16 Noorderlaanbrug
676,Noorderlaan,2023-02-16,13:00:00,111,51,60,FMN 16 Noorderlaanbrug
676,Noorderlaan,2023-02-16,14:00:00,131,66,65,FMN 16 Noorderlaanbrug
676,Noorderlaan,2023-02-16,15:00:00,163,81,82,FMN 16 Noorderlaanbrug
676,Noorderlaan,2023-02-16,16:00:00,298,128,170,FMN 16 Noorderlaanbrug
676,Noorderlaan,2023-02-16,17:00:00,300,139,161,FMN 16 Noorderlaanbrug
676,Noorderlaan,2023-02-16,18:00:00,147,68,79,FMN 16 Noorderlaanbrug
676,Noorderlaan,2023-02-16,19:00:00,72,32,40,FMN 16 Noorderlaanbrug
676,Noorderlaan,2023-02-16,20:00:00,44,22,22,FMN 16 Noorderlaanbrug
676,Noorderlaan,2023-02-16,21:00:00,65,26,39,FMN 16 Noorderlaanbrug
676,Noorderlaan,2023-02-16,22:00:00,48,20,28,FMN 16 Noorderlaanbrug
676,Noorderlaan,2023-02-16,23:00:00,28,11,17,FMN 16 Noorderlaanbrug
676,Noorderlaan,2023-02-17,00:00:00,22,7,15,FMN 16 Noorderlaanbrug
676,Noorderlaan,2023-02-17,01:00:00,10,3,7,FMN 16 Noorderlaanbrug
676,Noorderlaan,2023-02-17,02:00:00,8,4,4,FMN 16 Noorderlaanbrug
676,Noorderlaan,2023-02-17,03:00:00,17,11,6,FMN 16 Noorderlaanbrug
676,Noorderlaan,2023-02-17,04:00:00,16,9,7,FMN 16 Noorderlaanbrug
676,Noorderlaan,2023-02-17,05:00:00,64,23,41,FMN 16 Noorderlaanbrug
676,Noorderlaan,2023-02-17,06:00:00,93,45,48,FMN 16 Noorderlaanbrug
676,Noorderlaan,2023-02-17,07:00:00,196,109,87,FMN 16 Noorderlaanbrug
676,Noorderlaan,2023-02-17,08:00:00,257,152,105,FMN 16 Noorderlaanbrug
676,Noorderlaan,2023-02-17,09:00:00,99,60,39,FMN 16 Noorderlaanbrug
676,Noorderlaan,2023-02-17,10:00:00,75,44,31,FMN 16 Noorderlaanbrug
676,Noorderlaan,2023-02-17,11:00:00,77,40,37,FMN 16 Noorderlaanbrug
676,Noorderlaan,2023-02-17,12:00:00,102,51,51,FMN 16 Noorderlaanbrug
676,Noorderlaan,2023-02-17,13:00:00,122,52,70,FMN 16 Noorderlaanbrug
676,Noorderlaan,2023-02-17,14:00:00,136,66,70,FMN 16 Noorderlaanbrug
676,Noorderlaan,2023-02-17,15:00:00,184,85,99,FMN 16 Noorderlaanbrug
676,Noorderlaan,2023-02-17,16:00:00,276,128,148,FMN 16 Noorderlaanbrug
676,Noorderlaan,2023-02-17,17:00:00,209,86,123,FMN 16 Noorderlaanbrug
676,Noorderlaan,2023-02-17,18:00:00,140,65,75,FMN 16 Noorderlaanbrug
676,Noorderlaan,2023-02-17,19:00:00,89,38,51,FMN 16 Noorderlaanbrug
676,Noorderlaan,2023-02-17,20:00:00,58,23,35,FMN 16 Noorderlaanbrug
676,Noorderlaan,2023-02-17,21:00:00,54,25,29,FMN 16 Noorderlaanbrug
676,Noorderlaan,2023-02-17,22:00:00,54,23,31,FMN 16 Noorderlaanbrug
676,Noorderlaan,2023-02-17,23:00:00,43,13,30,FMN 16 Noorderlaanbrug
676,Noorderlaan,2023-02-18,00:00:00,39,21,18,FMN 16 Noorderlaanbrug
676,Noorderlaan,2023-02-18,01:00:00,27,10,17,FMN 16 Noorderlaanbrug
676,Noorderlaan,2023-02-18,02:00:00,19,13,6,FMN 16 Noorderlaanbrug
676,Noorderlaan,2023-02-18,03:00:00,33,17,16,FMN 16 Noorderlaanbrug
676,Noorderlaan,2023-02-18,04:00:00,17,13,4,FMN 16 Noorderlaanbrug
676,Noorderlaan,2023-02-18,05:00:00,18,8,10,FMN 16 Noorderlaanbrug
676,Noorderlaan,2023-02-18,06:00:00,28,19,9,FMN 16 Noorderlaanbrug
676,Noorderlaan,2023-02-18,07:00:00,21,15,6,FMN 16 Noorderlaanbrug
676,Noorderlaan,2023-02-18,08:00:00,38,27,11,FMN 16 Noorderlaanbrug
676,Noorderlaan,2023-02-18,09:00:00,47,34,13,FMN 16 Noorderlaanbrug
676,Noorderlaan,2023-02-18,10:00:00,72,45,27,FMN 16 Noorderlaanbrug
676,Noorderlaan,2023-02-18,11:00:00,59,35,24,FMN 16 Noorderlaanbrug
676,Noorderlaan,2023-02-18,12:00:00,62,37,25,FMN 16 Noorderlaanbrug
676,Noorderlaan,2023-02-18,13:00:00,84,47,37,FMN 16 Noorderlaanbrug
676,Noorderlaan,2023-02-18,14:00:00,96,61,35,FMN 16 Noorderlaanbrug
676,Noorderlaan,2023-02-18,15:00:00,109,62,47,FMN 16 Noorderlaanbrug
676,Noorderlaan,2023-02-18,16:00:00,76,47,29,FMN 16 Noorderlaanbrug
676,Noorderlaan,2023-02-18,17:00:00,64,34,30,FMN 16 Noorderlaanbrug
676,Noorderlaan,2023-02-18,18:00:00,85,43,42,FMN 16 Noorderlaanbrug
676,Noorderlaan,2023-02-18,19:00:00,58,32,26,FMN 16 Noorderlaanbrug
676,Noorderlaan,2023-02-18,20:00:00,50,31,19,FMN 16 Noorderlaanbrug
676,Noorderlaan,2023-02-18,21:00:00,51,19,32,FMN 16 Noorderlaanbrug
676,Noorderlaan,2023-02-18,22:00:00,39,30,9,FMN 16 Noorderlaanbrug
676,Noorderlaan,2023-02-18,23:00:00,38,15,23,FMN 16 Noorderlaanbrug
676,Noorderlaan,2023-02-19,00:00:00,59,29,30,FMN 16 Noorderlaanbrug
676,Noorderlaan,2023-02-19,01:00:00,31,11,20,FMN 16 Noorderlaanbrug
676,Noorderlaan,2023-02-19,02:00:00,13,4,9,FMN 16 Noorderlaanbrug
676,Noorderlaan,2023-02-19,03:00:00,36,25,11,FMN 16 Noorderlaanbrug
676,Noorderlaan,2023-02-19,04:00:00,28,22,6,FMN 16 Noorderlaanbrug
676,Noorderlaan,2023-02-19,05:00:00,17,8,9,FMN 16 Noorderlaanbrug
676,Noorderlaan,2023-02-19,06:00:00,24,12,12,FMN 16 Noorderlaanbrug
676,Noorderlaan,2023-02-19,07:00:00,14,9,5,FMN 16 Noorderlaanbrug
676,Noorderlaan,2023-02-19,08:00:00,19,15,4,FMN 16 Noorderlaanbrug
676,Noorderlaan,2023-02-19,09:00:00,38,23,15,FMN 16 Noorderlaanbrug
676,Noorderlaan,2023-02-19,10:00:00,38,27,11,FMN 16 Noorderlaanbrug
676,Noorderlaan,2023-02-19,11:00:00,52,32,20,FMN 16 Noorderlaanbrug
676,Noorderlaan,2023-02-19,12:00:00,44,27,17,FMN 16 Noorderlaanbrug
676,Noorderlaan,2023-02-19,13:00:00,85,49,36,FMN 16 Noorderlaanbrug
676,Noorderlaan,2023-02-19,14:00:00,77,47,30,FMN 16 Noorderlaanbrug
676,Noorderlaan,2023-02-19,15:00:00,49,23,26,FMN 16 Noorderlaanbrug
676,Noorderlaan,2023-02-19,16:00:00,49,21,28,FMN 16 Noorderlaanbrug
676,Noorderlaan,2023-02-19,17:00:00,53,20,33,FMN 16 Noorderlaanbrug
676,Noorderlaan,2023-02-19,18:00:00,47,26,21,FMN 16 Noorderlaanbrug
676,Noorderlaan,2023-02-19,19:00:00,68,35,33,FMN 16 Noorderlaanbrug
676,Noorderlaan,2023-02-19,20:00:00,44,25,19,FMN 16 Noorderlaanbrug
676,Noorderlaan,2023-02-19,21:00:00,33,22,11,FMN 16 Noorderlaanbrug
676,Noorderlaan,2023-02-19,22:00:00,38,21,17,FMN 16 Noorderlaanbrug
676,Noorderlaan,2023-02-19,23:00:00,17,10,7,FMN 16 Noorderlaanbrug
676,Noorderlaan,2023-02-20,00:00:00,16,8,8,FMN 16 Noorderlaanbrug
676,Noorderlaan,2023-02-20,01:00:00,7,7,0,FMN 16 Noorderlaanbrug
676,Noorderlaan,2023-02-20,02:00:00,1,1,0,FMN 16 Noorderlaanbrug
676,Noorderlaan,2023-02-20,03:00:00,6,3,3,FMN 16 Noorderlaanbrug
676,Noorderlaan,2023-02-20,04:00:00,17,8,9,FMN 16 Noorderlaanbrug
676,Noorderlaan,2023-02-20,05:00:00,66,24,42,FMN 16 Noorderlaanbrug
676,Noorderlaan,2023-02-20,06:00:00,114,62,52,FMN 16 Noorderlaanbrug
676,Noorderlaan,2023-02-20,07:00:00,230,149,81,FMN 16 Noorderlaanbrug
676,Noorderlaan,2023-02-20,08:00:00,283,183,100,FMN 16 Noorderlaanbrug
676,Noorderlaan,2023-02-20,09:00:00,107,76,31,FMN 16 Noorderlaanbrug
676,Noorderlaan,2023-02-20,10:00:00,64,41,23,FMN 16 Noorderlaanbrug
676,Noorderlaan,2023-02-20,11:00:00,63,39,24,FMN 16 Noorderlaanbrug
676,Noorderlaan,2023-02-20,12:00:00,87,50,37,FMN 16 Noorderlaanbrug
676,Noorderlaan,2023-02-20,13:00:00,101,46,55,FMN 16 Noorderlaanbrug
676,Noorderlaan,2023-02-20,14:00:00,92,55,37,FMN 16 Noorderlaanbrug
676,Noorderlaan,2023-02-20,15:00:00,159,79,80,FMN 16 Noorderlaanbrug
676,Noorderlaan,2023-02-20,16:00:00,255,143,112,FMN 16 Noorderlaanbrug
676,Noorderlaan,2023-02-20,17:00:00,294,171,123,FMN 16 Noorderlaanbrug
676,Noorderlaan,2023-02-20,18:00:00,151,65,86,FMN 16 Noorderlaanbrug
676,Noorderlaan,2023-02-20,19:00:00,67,36,31,FMN 16 Noorderlaanbrug
676,Noorderlaan,2023-02-20,20:00:00,35,22,13,FMN 16 Noorderlaanbrug
676,Noorderlaan,2023-02-20,21:00:00,40,20,20,FMN 16 Noorderlaanbrug
676,Noorderlaan,2023-02-20,22:00:00,49,35,14,FMN 16 Noorderlaanbrug
676,Noorderlaan,2023-02-20,23:00:00,15,9,6,FMN 16 Noorderlaanbrug
676,Noorderlaan,2023-02-21,00:00:00,15,8,7,FMN 16 Noorderlaanbrug
676,Noorderlaan,2023-02-21,01:00:00,7,3,4,FMN 16 Noorderlaanbrug
676,Noorderlaan,2023-02-21,02:00:00,1,0,1,FMN 16 Noorderlaanbrug
676,Noorderlaan,2023-02-21,03:00:00,8,6,2,FMN 16 Noorderlaanbrug
676,Noorderlaan,2023-02-21,04:00:00,25,14,11,FMN 16 Noorderlaanbrug
676,Noorderlaan,2023-02-21,05:00:00,66,24,42,FMN 16 Noorderlaanbrug
676,Noorderlaan,2023-02-21,06:00:00,108,65,43,FMN 16 Noorderlaanbrug
676,Noorderlaan,2023-02-21,07:00:00,254,164,90,FMN 16 Noorderlaanbrug
676,Noorderlaan,2023-02-21,08:00:00,277,179,98,FMN 16 Noorderlaanbrug
676,Noorderlaan,2023-02-21,09:00:00,122,81,41,FMN 16 Noorderlaanbrug
676,Noorderlaan,2023-02-21,10:00:00,63,44,19,FMN 16 Noorderlaanbrug
676,Noorderlaan,2023-02-21,11:00:00,67,46,21,FMN 16 Noorderlaanbrug
676,Noorderlaan,2023-02-21,12:00:00,81,39,42,FMN 16 Noorderlaanbrug
676,Noorderlaan,2023-02-21,13:00:00,137,74,63,FMN 16 Noorderlaanbrug
676,Noorderlaan,2023-02-21,14:00:00,120,77,43,FMN 16 Noorderlaanbrug
676,Noorderlaan,2023-02-21,15:00:00,152,84,68,FMN 16 Noorderlaanbrug
676,Noorderlaan,2023-02-21,16:00:00,271,142,129,FMN 16 Noorderlaanbrug
676,Noorderlaan,2023-02-21,17:00:00,327,167,160,FMN 16 Noorderlaanbrug
676,Noorderlaan,2023-02-21,18:00:00,188,100,88,FMN 16 Noorderlaanbrug
676,Noorderlaan,2023-02-21,19:00:00,90,50,40,FMN 16 Noorderlaanbrug
676,Noorderlaan,2023-02-21,20:00:00,50,29,21,FMN 16 Noorderlaanbrug
676,Noorderlaan,2023-02-21,21:00:00,47,26,21,FMN 16 Noorderlaanbrug
676,Noorderlaan,2023-02-21,22:00:00,50,44,6,FMN 16 Noorderlaanbrug
676,Noorderlaan,2023-02-21,23:00:00,19,7,12,FMN 16 Noorderlaanbrug
676,Noorderlaan,2023-02-22,00:00:00,8,4,4,FMN 16 Noorderlaanbrug
676,Noorderlaan,2023-02-22,01:00:00,13,6,7,FMN 16 Noorderlaanbrug
676,Noorderlaan,2023-02-22,02:00:00,3,0,3,FMN 16 Noorderlaanbrug
676,Noorderlaan,2023-02-22,03:00:00,12,10,2,FMN 16 Noorderlaanbrug
676,Noorderlaan,2023-02-22,04:00:00,22,11,11,FMN 16 Noorderlaanbrug
676,Noorderlaan,2023-02-22,05:00:00,66,29,37,FMN 16 Noorderlaanbrug
676,Noorderlaan,2023-02-22,06:00:00,89,52,37,FMN 16 Noorderlaanbrug
676,Noorderlaan,2023-02-22,07:00:00,192,121,71,FMN 16 Noorderlaanbrug
676,Noorderlaan,2023-02-22,08:00:00,225,128,97,FMN 16 Noorderlaanbrug
676,Noorderlaan,2023-02-22,09:00:00,97,68,29,FMN 16 Noorderlaanbrug
676,Noorderlaan,2023-02-22,10:00:00,80,58,22,FMN 16 Noorderlaanbrug
676,Noorderlaan,2023-02-22,11:00:00,60,41,19,FMN 16 Noorderlaanbrug
676,Noorderlaan,2023-02-22,12:00:00,91,45,46,FMN 16 Noorderlaanbrug
676,Noorderlaan,2023-02-22,13:00:00,97,49,48,FMN 16 Noorderlaanbrug
676,Noorderlaan,2023-02-22,14:00:00,122,72,50,FMN 16 Noorderlaanbrug
676,Noorderlaan,2023-02-22,15:00:00,121,64,57,FMN 16 Noorderlaanbrug
676,Noorderlaan,2023-02-22,16:00:00,238,143,95,FMN 16 Noorderlaanbrug
676,Noorderlaan,2023-02-22,17:00:00,229,129,100,FMN 16 Noorderlaanbrug
676,Noorderlaan,2023-02-22,18:00:00,138,71,67,FMN 16 Noorderlaanbrug
676,Noorderlaan,2023-02-22,19:00:00,83,46,37,FMN 16 Noorderlaanbrug
676,Noorderlaan,2023-02-22,20:00:00,40,23,17,FMN 16 Noorderlaanbrug
676,Noorderlaan,2023-02-22,21:00:00,49,23,26,FMN 16 Noorderlaanbrug
676,Noorderlaan,2023-02-22,22:00:00,66,47,19,FMN 16 Noorderlaanbrug
676,Noorderlaan,2023-02-22,23:00:00,16,11,5,FMN 16 Noorderlaanbrug
676,Noorderlaan,2023-02-23,00:00:00,12,7,5,FMN 16 Noorderlaanbrug
676,Noorderlaan,2023-02-23,01:00:00,9,4,5,FMN 16 Noorderlaanbrug
676,Noorderlaan,2023-02-23,02:00:00,4,2,2,FMN 16 Noorderlaanbrug
676,Noorderlaan,2023-02-23,03:00:00,9,6,3,FMN 16 Noorderlaanbrug
676,Noorderlaan,2023-02-23,04:00:00,23,12,11,FMN 16 Noorderlaanbrug
676,Noorderlaan,2023-02-23,05:00:00,65,23,42,FMN 16 Noorderlaanbrug
676,Noorderlaan,2023-02-23,06:00:00,101,57,44,FMN 16 Noorderlaanbrug
676,Noorderlaan,2023-02-23,07:00:00,201,135,66,FMN 16 Noorderlaanbrug
676,Noorderlaan,2023-02-23,08:00:00,290,194,96,FMN 16 Noorderlaanbrug
676,Noorderlaan,2023-02-23,09:00:00,107,71,36,FMN 16 Noorderlaanbrug
676,Noorderlaan,2023-02-23,10:00:00,74,54,20,FMN 16 Noorderlaanbrug
676,Noorderlaan,2023-02-23,11:00:00,69,50,19,FMN 16 Noorderlaanbrug
676,Noorderlaan,2023-02-23,12:00:00,93,52,41,FMN 16 Noorderlaanbrug
676,Noorderlaan,2023-02-23,13:00:00,119,56,63,FMN 16 Noorderlaanbrug
676,Noorderlaan,2023-02-23,14:00:00,119,70,49,FMN 16 Noorderlaanbrug
676,Noorderlaan,2023-02-23,15:00:00,126,70,56,FMN 16 Noorderlaanbrug
676,Noorderlaan,2023-02-23,16:00:00,252,140,112,FMN 16 Noorderlaanbrug
676,Noorderlaan,2023-02-23,17:00:00,281,154,127,FMN 16 Noorderlaanbrug
676,Noorderlaan,2023-02-23,18:00:00,155,75,80,FMN 16 Noorderlaanbrug
676,Noorderlaan,2023-02-23,19:00:00,82,48,34,FMN 16 Noorderlaanbrug
676,Noorderlaan,2023-02-23,20:00:00,49,21,28,FMN 16 Noorderlaanbrug
676,Noorderlaan,2023-02-23,21:00:00,55,28,27,FMN 16 Noorderlaanbrug
676,Noorderlaan,2023-02-23,22:00:00,55,38,17,FMN 16 Noorderlaanbrug
676,Noorderlaan,2023-02-23,23:00:00,22,13,9,FMN 16 Noorderlaanbrug
676,Noorderlaan,2023-02-24,00:00:00,21,10,11,FMN 16 Noorderlaanbrug
676,Noorderlaan,2023-02-24,01:00:00,14,7,7,FMN 16 Noorderlaanbrug
676,Noorderlaan,2023-02-24,02:00:00,6,1,5,FMN 16 Noorderlaanbrug
676,Noorderlaan,2023-02-24,03:00:00,16,8,8,FMN 16 Noorderlaanbrug
676,Noorderlaan,2023-02-24,04:00:00,12,5,7,FMN 16 Noorderlaanbrug
676,Noorderlaan,2023-02-24,05:00:00,65,25,40,FMN 16 Noorderlaanbrug
676,Noorderlaan,2023-02-24,06:00:00,96,53,43,FMN 16 Noorderlaanbrug
676,Noorderlaan,2023-02-24,07:00:00,171,99,72,FMN 16 Noorderlaanbrug
676,Noorderlaan,2023-02-24,08:00:00,244,154,90,FMN 16 Noorderlaanbrug
676,Noorderlaan,2023-02-24,09:00:00,103,73,30,FMN 16 Noorderlaanbrug
676,Noorderlaan,2023-02-24,10:00:00,61,45,16,FMN 16 Noorderlaanbrug
676,Noorderlaan,2023-02-24,11:00:00,80,45,35,FMN 16 Noorderlaanbrug
676,Noorderlaan,2023-02-24,12:00:00,82,55,27,FMN 16 Noorderlaanbrug
676,Noorderlaan,2023-02-24,13:00:00,101,47,54,FMN 16 Noorderlaanbrug
676,Noorderlaan,2023-02-24,14:00:00,82,55,27,FMN 16 Noorderlaanbrug
676,Noorderlaan,2023-02-24,15:00:00,93,53,40,FMN 16 Noorderlaanbrug
676,Noorderlaan,2023-02-24,16:00:00,206,127,79,FMN 16 Noorderlaanbrug
676,Noorderlaan,2023-02-24,17:00:00,209,99,110,FMN 16 Noorderlaanbrug
676,Noorderlaan,2023-02-24,18:00:00,145,75,70,FMN 16 Noorderlaanbrug
676,Noorderlaan,2023-02-24,19:00:00,80,57,23,FMN 16 Noorderlaanbrug
676,Noorderlaan,2023-02-24,20:00:00,37,26,11,FMN 16 Noorderlaanbrug
676,Noorderlaan,2023-02-24,21:00:00,56,31,25,FMN 16 Noorderlaanbrug
676,Noorderlaan,2023-02-24,22:00:00,44,19,25,FMN 16 Noorderlaanbrug
676,Noorderlaan,2023-02-24,23:00:00,42,17,25,FMN 16 Noorderlaanbrug
676,Noorderlaan,2023-02-25,00:00:00,27,13,14,FMN 16 Noorderlaanbrug
676,Noorderlaan,2023-02-25,01:00:00,29,12,17,FMN 16 Noorderlaanbrug
676,Noorderlaan,2023-02-25,02:00:00,25,11,14,FMN 16 Noorderlaanbrug
676,Noorderlaan,2023-02-25,03:00:00,18,9,9,FMN 16 Noorderlaanbrug
676,Noorderlaan,2023-02-25,04:00:00,12,6,6,FMN 16 Noorderlaanbrug
676,Noorderlaan,2023-02-25,05:00:00,16,10,6,FMN 16 Noorderlaanbrug
676,Noorderlaan,2023-02-25,06:00:00,22,8,14,FMN 16 Noorderlaanbrug
676,Noorderlaan,2023-02-25,07:00:00,33,19,14,FMN 16 Noorderlaanbrug
676,Noorderlaan,2023-02-25,08:00:00,34,27,7,FMN 16 Noorderlaanbrug
676,Noorderlaan,2023-02-25,09:00:00,55,40,15,FMN 16 Noorderlaanbrug
676,Noorderlaan,2023-02-25,10:00:00,85,56,29,FMN 16 Noorderlaanbrug
676,Noorderlaan,2023-02-25,11:00:00,77,46,31,FMN 16 Noorderlaanbrug
676,Noorderlaan,2023-02-25,12:00:00,85,54,31,FMN 16 Noorderlaanbrug
676,Noorderlaan,2023-02-25,13:00:00,98,64,34,FMN 16 Noorderlaanbrug
676,Noorderlaan,2023-02-25,14:00:00,80,52,28,FMN 16 Noorderlaanbrug
676,Noorderlaan,2023-02-25,15:00:00,83,43,40,FMN 16 Noorderlaanbrug
676,Noorderlaan,2023-02-25,16:00:00,96,67,29,FMN 16 Noorderlaanbrug
676,Noorderlaan,2023-02-25,17:00:00,108,55,53,FMN 16 Noorderlaanbrug
676,Noorderlaan,2023-02-25,18:00:00,112,47,65,FMN 16 Noorderlaanbrug
676,Noorderlaan,2023-02-25,19:00:00,83,50,33,FMN 16 Noorderlaanbrug
676,Noorderlaan,2023-02-25,20:00:00,41,33,8,FMN 16 Noorderlaanbrug
676,Noorderlaan,2023-02-25,21:00:00,38,20,18,FMN 16 Noorderlaanbrug
676,Noorderlaan,2023-02-25,22:00:00,55,40,15,FMN 16 Noorderlaanbrug
676,Noorderlaan,2023-02-25,23:00:00,29,21,8,FMN 16 Noorderlaanbrug
676,Noorderlaan,2023-02-26,00:00:00,11,9,2,FMN 16 Noorderlaanbrug
676,Noorderlaan,2023-02-26,01:00:00,5,1,4,FMN 16 Noorderlaanbrug
676,Noorderlaan,2023-02-26,02:00:00,15,7,8,FMN 16 Noorderlaanbrug
676,Noorderlaan,2023-02-26,03:00:00,18,7,11,FMN 16 Noorderlaanbrug
676,Noorderlaan,2023-02-26,04:00:00,7,2,5,FMN 16 Noorderlaanbrug
676,Noorderlaan,2023-02-26,05:00:00,1,1,0,FMN 16 Noorderlaanbrug
676,Noorderlaan,2023-02-26,06:00:00,7,4,3,FMN 16 Noorderlaanbrug
676,Noorderlaan,2023-02-26,07:00:00,0,0,0,FMN 16 Noorderlaanbrug
676,Noorderlaan,2023-02-26,08:00:00,0,0,0,FMN 16 Noorderlaanbrug
676,Noorderlaan,2023-02-26,09:00:00,38,27,11,FMN 16 Noorderlaanbrug
676,Noorderlaan,2023-02-26,10:00:00,49,32,17,FMN 16 Noorderlaanbrug
676,Noorderlaan,2023-02-26,11:00:00,63,47,16,FMN 16 Noorderlaanbrug
676,Noorderlaan,2023-02-26,12:00:00,65,47,18,FMN 16 Noorderlaanbrug
676,Noorderlaan,2023-02-26,13:00:00,73,32,41,FMN 16 Noorderlaanbrug
676,Noorderlaan,2023-02-26,14:00:00,74,44,30,FMN 16 Noorderlaanbrug
676,Noorderlaan,2023-02-26,15:00:00,56,24,32,FMN 16 Noorderlaanbrug
676,Noorderlaan,2023-02-26,16:00:00,65,41,24,FMN 16 Noorderlaanbrug
676,Noorderlaan,2023-02-26,17:00:00,60,28,32,FMN 16 Noorderlaanbrug
676,Noorderlaan,2023-02-26,18:00:00,47,26,21,FMN 16 Noorderlaanbrug
676,Noorderlaan,2023-02-26,19:00:00,44,25,19,FMN 16 Noorderlaanbrug
676,Noorderlaan,2023-02-26,20:00:00,19,10,9,FMN 16 Noorderlaanbrug
676,Noorderlaan,2023-02-26,21:00:00,23,15,8,FMN 16 Noorderlaanbrug
676,Noorderlaan,2023-02-26,22:00:00,25,16,9,FMN 16 Noorderlaanbrug
676,Noorderlaan,2023-02-26,23:00:00,5,1,4,FMN 16 Noorderlaanbrug
676,Noorderlaan,2023-02-27,00:00:00,9,5,4,FMN 16 Noorderlaanbrug
676,Noorderlaan,2023-02-27,01:00:00,2,1,1,FMN 16 Noorderlaanbrug
676,Noorderlaan,2023-02-27,02:00:00,6,2,4,FMN 16 Noorderlaanbrug
676,Noorderlaan,2023-02-27,03:00:00,16,12,4,FMN 16 Noorderlaanbrug
676,Noorderlaan,2023-02-27,04:00:00,8,6,2,FMN 16 Noorderlaanbrug
676,Noorderlaan,2023-02-27,05:00:00,68,27,41,FMN 16 Noorderlaanbrug
676,Noorderlaan,2023-02-27,06:00:00,41,20,21,FMN 16 Noorderlaanbrug
676,Noorderlaan,2023-02-27,07:00:00,6,3,3,FMN 16 Noorderlaanbrug
676,Noorderlaan,2023-02-27,08:00:00,401,270,131,FMN 16 Noorderlaanbrug
676,Noorderlaan,2023-02-27,09:00:00,138,105,33,FMN 16 Noorderlaanbrug
676,Noorderlaan,2023-02-27,10:00:00,76,48,28,FMN 16 Noorderlaanbrug
676,Noorderlaan,2023-02-27,11:00:00,73,42,31,FMN 16 Noorderlaanbrug
676,Noorderlaan,2023-02-27,12:00:00,113,74,39,FMN 16 Noorderlaanbrug
676,Noorderlaan,2023-02-27,13:00:00,108,60,48,FMN 16 Noorderlaanbrug
676,Noorderlaan,2023-02-27,14:00:00,149,82,67,FMN 16 Noorderlaanbrug
676,Noorderlaan,2023-02-27,15:00:00,175,79,96,FMN 16 Noorderlaanbrug
676,Noorderlaan,2023-02-27,16:00:00,319,147,172,FMN 16 Noorderlaanbrug
676,Noorderlaan,2023-02-27,17:00:00,345,146,199,FMN 16 Noorderlaanbrug
676,Noorderlaan,2023-02-27,18:00:00,192,89,103,FMN 16 Noorderlaanbrug
676,Noorderlaan,2023-02-27,19:00:00,53,28,25,FMN 16 Noorderlaanbrug
676,Noorderlaan,2023-02-27,20:00:00,49,25,24,FMN 16 Noorderlaanbrug
676,Noorderlaan,2023-02-27,21:00:00,36,21,15,FMN 16 Noorderlaanbrug
676,Noorderlaan,2023-02-27,22:00:00,48,25,23,FMN 16 Noorderlaanbrug
676,Noorderlaan,2023-02-27,23:00:00,26,10,16,FMN 16 Noorderlaanbrug
676,Noorderlaan,2023-02-28,00:00:00,10,7,3,FMN 16 Noorderlaanbrug
676,Noorderlaan,2023-02-28,01:00:00,6,5,1,FMN 16 Noorderlaanbrug
676,Noorderlaan,2023-02-28,02:00:00,6,3,3,FMN 16 Noorderlaanbrug
676,Noorderlaan,2023-02-28,03:00:00,8,7,1,FMN 16 Noorderlaanbrug
676,Noorderlaan,2023-02-28,04:00:00,40,25,15,FMN 16 Noorderlaanbrug
676,Noorderlaan,2023-02-28,05:00:00,96,48,48,FMN 16 Noorderlaanbrug
676,Noorderlaan,2023-02-28,06:00:00,135,74,61,FMN 16 Noorderlaanbrug
676,Noorderlaan,2023-02-28,07:00:00,364,248,116,FMN 16 Noorderlaanbrug
676,Noorderlaan,2023-02-28,08:00:00,457,324,133,FMN 16 Noorderlaanbrug
676,Noorderlaan,2023-02-28,09:00:00,143,102,41,FMN 16 Noorderlaanbrug
676,Noorderlaan,2023-02-28,10:00:00,83,55,28,FMN 16 Noorderlaanbrug
676,Noorderlaan,2023-02-28,11:00:00,98,62,36,FMN 16 Noorderlaanbrug
676,Noorderlaan,2023-02-28,12:00:00,143,86,57,FMN 16 Noorderlaanbrug
676,Noorderlaan,2023-02-28,13:00:00,116,57,59,FMN 16 Noorderlaanbrug
676,Noorderlaan,2023-02-28,14:00:00,141,85,56,FMN 16 Noorderlaanbrug
676,Noorderlaan,2023-02-28,15:00:00,169,88,81,FMN 16 Noorderlaanbrug
676,Noorderlaan,2023-02-28,16:00:00,359,172,187,FMN 16 Noorderlaanbrug
676,Noorderlaan,2023-02-28,17:00:00,350,145,205,FMN 16 Noorderlaanbrug
676,Noorderlaan,2023-02-28,18:00:00,204,90,114,FMN 16 Noorderlaanbrug
676,Noorderlaan,2023-02-28,19:00:00,94,49,45,FMN 16 Noorderlaanbrug
676,Noorderlaan,2023-02-28,20:00:00,37,26,11,FMN 16 Noorderlaanbrug
676,Noorderlaan,2023-02-28,21:00:00,48,18,30,FMN 16 Noorderlaanbrug
676,Noorderlaan,2023-02-28,22:00:00,64,38,26,FMN 16 Noorderlaanbrug
676,Noorderlaan,2023-02-28,23:00:00,28,17,11,FMN 16 Noorderlaanbrug
676,Noorderlaan,2023-03-01,00:00:00,18,10,8,FMN 16 Noorderlaanbrug
676,Noorderlaan,2023-03-01,01:00:00,10,6,4,FMN 16 Noorderlaanbrug
676,Noorderlaan,2023-03-01,02:00:00,3,1,2,FMN 16 Noorderlaanbrug
676,Noorderlaan,2023-03-01,03:00:00,3,2,1,FMN 16 Noorderlaanbrug
676,Noorderlaan,2023-03-01,04:00:00,20,12,8,FMN 16 Noorderlaanbrug
676,Noorderlaan,2023-03-01,05:00:00,8,2,6,FMN 16 Noorderlaanbrug
676,Noorderlaan,2023-03-01,06:00:00,4,3,1,FMN 16 Noorderlaanbrug
676,Noorderlaan,2023-03-01,07:00:00,0,0,0,FMN 16 Noorderlaanbrug
676,Noorderlaan,2023-03-01,08:00:00,103,64,39,FMN 16 Noorderlaanbrug
676,Noorderlaan,2023-03-01,09:00:00,144,94,50,FMN 16 Noorderlaanbrug
676,Noorderlaan,2023-03-01,10:00:00,83,54,29,FMN 16 Noorderlaanbrug
676,Noorderlaan,2023-03-01,11:00:00,85,54,31,FMN 16 Noorderlaanbrug
676,Noorderlaan,2023-03-01,12:00:00,173,92,81,FMN 16 Noorderlaanbrug
676,Noorderlaan,2023-03-01,13:00:00,160,86,74,FMN 16 Noorderlaanbrug
676,Noorderlaan,2023-03-01,14:00:00,118,75,43,FMN 16 Noorderlaanbrug
676,Noorderlaan,2023-03-01,15:00:00,163,97,66,FMN 16 Noorderlaanbrug
676,Noorderlaan,2023-03-01,16:00:00,295,155,140,FMN 16 Noorderlaanbrug
676,Noorderlaan,2023-03-01,17:00:00,322,158,164,FMN 16 Noorderlaanbrug
676,Noorderlaan,2023-03-01,18:00:00,178,74,104,FMN 16 Noorderlaanbrug
676,Noorderlaan,2023-03-01,19:00:00,86,46,40,FMN 16 Noorderlaanbrug
676,Noorderlaan,2023-03-01,20:00:00,41,19,22,FMN 16 Noorderlaanbrug
676,Noorderlaan,2023-03-01,21:00:00,42,22,20,FMN 16 Noorderlaanbrug
676,Noorderlaan,2023-03-01,22:00:00,57,35,22,FMN 16 Noorderlaanbrug
676,Noorderlaan,2023-03-01,23:00:00,16,7,9,FMN 16 Noorderlaanbrug
676,Noorderlaan,2023-03-02,00:00:00,11,2,9,FMN 16 Noorderlaanbrug
676,Noorderlaan,2023-03-02,01:00:00,4,4,0,FMN 16 Noorderlaanbrug
676,Noorderlaan,2023-03-02,02:00:00,7,3,4,FMN 16 Noorderlaanbrug
676,Noorderlaan,2023-03-02,03:00:00,7,6,1,FMN 16 Noorderlaanbrug
676,Noorderlaan,2023-03-02,04:00:00,45,28,17,FMN 16 Noorderlaanbrug
676,Noorderlaan,2023-03-02,05:00:00,76,39,37,FMN 16 Noorderlaanbrug
676,Noorderlaan,2023-03-02,06:00:00,161,94,67,FMN 16 Noorderlaanbrug
676,Noorderlaan,2023-03-02,07:00:00,512,349,163,FMN 16 Noorderlaanbrug
676,Noorderlaan,2023-03-02,08:00:00,611,417,194,FMN 16 Noorderlaanbrug
676,Noorderlaan,2023-03-02,09:00:00,163,124,39,FMN 16 Noorderlaanbrug
676,Noorderlaan,2023-03-02,10:00:00,107,69,38,FMN 16 Noorderlaanbrug
676,Noorderlaan,2023-03-02,11:00:00,83,47,36,FMN 16 Noorderlaanbrug
676,Noorderlaan,2023-03-02,12:00:00,141,80,61,FMN 16 Noorderlaanbrug
676,Noorderlaan,2023-03-02,13:00:00,135,82,53,FMN 16 Noorderlaanbrug
676,Noorderlaan,2023-03-02,14:00:00,160,99,61,FMN 16 Noorderlaanbrug
676,Noorderlaan,2023-03-02,15:00:00,204,100,104,FMN 16 Noorderlaanbrug
676,Noorderlaan,2023-03-02,16:00:00,376,169,207,FMN 16 Noorderlaanbrug
676,Noorderlaan,2023-03-02,17:00:00,353,157,196,FMN 16 Noorderlaanbrug
676,Noorderlaan,2023-03-02,18:00:00,190,90,100,FMN 16 Noorderlaanbrug
676,Noorderlaan,2023-03-02,19:00:00,88,45,43,FMN 16 Noorderlaanbrug
676,Noorderlaan,2023-03-02,20:00:00,54,39,15,FMN 16 Noorderlaanbrug
676,Noorderlaan,2023-03-02,21:00:00,46,22,24,FMN 16 Noorderlaanbrug
676,Noorderlaan,2023-03-02,22:00:00,69,38,31,FMN 16 Noorderlaanbrug
676,Noorderlaan,2023-03-02,23:00:00,25,9,16,FMN 16 Noorderlaanbrug
676,Noorderlaan,2023-03-03,00:00:00,22,13,9,FMN 16 Noorderlaanbrug
676,Noorderlaan,2023-03-03,01:00:00,5,2,3,FMN 16 Noorderlaanbrug
676,Noorderlaan,2023-03-03,02:00:00,0,0,0,FMN 16 Noorderlaanbrug
676,Noorderlaan,2023-03-03,03:00:00,4,2,2,FMN 16 Noorderlaanbrug
676,Noorderlaan,2023-03-03,04:00:00,0,0,0,FMN 16 Noorderlaanbrug
676,Noorderlaan,2023-03-03,05:00:00,13,8,5,FMN 16 Noorderlaanbrug
676,Noorderlaan,2023-03-03,06:00:00,18,7,11,FMN 16 Noorderlaanbrug
676,Noorderlaan,2023-03-03,07:00:00,47,29,18,FMN 16 Noorderlaanbrug
676,Noorderlaan,2023-03-03,08:00:00,115,72,43,FMN 16 Noorderlaanbrug
676,Noorderlaan,2023-03-03,09:00:00,111,72,39,FMN 16 Noorderlaanbrug
676,Noorderlaan,2023-03-03,10:00:00,78,48,30,FMN 16 Noorderlaanbrug
676,Noorderlaan,2023-03-03,11:00:00,73,40,33,FMN 16 Noorderlaanbrug
676,Noorderlaan,2023-03-03,12:00:00,112,62,50,FMN 16 Noorderlaanbrug
676,Noorderlaan,2023-03-03,13:00:00,136,78,58,FMN 16 Noorderlaanbrug
676,Noorderlaan,2023-03-03,14:00:00,141,84,57,FMN 16 Noorderlaanbrug
676,Noorderlaan,2023-03-03,15:00:00,189,101,88,FMN 16 Noorderlaanbrug
676,Noorderlaan,2023-03-03,16:00:00,309,166,143,FMN 16 Noorderlaanbrug
676,Noorderlaan,2023-03-03,17:00:00,239,114,125,FMN 16 Noorderlaanbrug
676,Noorderlaan,2023-03-03,18:00:00,153,73,80,FMN 16 Noorderlaanbrug
676,Noorderlaan,2023-03-03,19:00:00,92,51,41,FMN 16 Noorderlaanbrug
676,Noorderlaan,2023-03-03,20:00:00,59,38,21,FMN 16 Noorderlaanbrug
676,Noorderlaan,2023-03-03,21:00:00,60,40,20,FMN 16 Noorderlaanbrug
676,Noorderlaan,2023-03-03,22:00:00,74,38,36,FMN 16 Noorderlaanbrug
676,Noorderlaan,2023-03-03,23:00:00,63,21,42,FMN 16 Noorderlaanbrug
676,Noorderlaan,2023-03-04,00:00:00,35,12,23,FMN 16 Noorderlaanbrug
676,Noorderlaan,2023-03-04,01:00:00,28,11,17,FMN 16 Noorderlaanbrug
676,Noorderlaan,2023-03-04,02:00:00,37,25,12,FMN 16 Noorderlaanbrug
676,Noorderlaan,2023-03-04,03:00:00,27,21,6,FMN 16 Noorderlaanbrug
676,Noorderlaan,2023-03-04,04:00:00,17,13,4,FMN 16 Noorderlaanbrug
676,Noorderlaan,2023-03-04,05:00:00,28,13,15,FMN 16 Noorderlaanbrug
676,Noorderlaan,2023-03-04,06:00:00,55,35,20,FMN 16 Noorderlaanbrug
676,Noorderlaan,2023-03-04,07:00:00,28,18,10,FMN 16 Noorderlaanbrug
676,Noorderlaan,2023-03-04,08:00:00,40,28,12,FMN 16 Noorderlaanbrug
676,Noorderlaan,2023-03-04,09:00:00,59,39,20,FMN 16 Noorderlaanbrug
676,Noorderlaan,2023-03-04,10:00:00,75,54,21,FMN 16 Noorderlaanbrug
676,Noorderlaan,2023-03-04,11:00:00,95,52,43,FMN 16 Noorderlaanbrug
676,Noorderlaan,2023-03-04,12:00:00,118,70,48,FMN 16 Noorderlaanbrug
676,Noorderlaan,2023-03-04,13:00:00,97,55,42,FMN 16 Noorderlaanbrug
676,Noorderlaan,2023-03-04,14:00:00,120,70,50,FMN 16 Noorderlaanbrug
676,Noorderlaan,2023-03-04,15:00:00,113,64,49,FMN 16 Noorderlaanbrug
676,Noorderlaan,2023-03-04,16:00:00,96,63,33,FMN 16 Noorderlaanbrug
676,Noorderlaan,2023-03-04,17:00:00,97,49,48,FMN 16 Noorderlaanbrug
676,Noorderlaan,2023-03-04,18:00:00,87,45,42,FMN 16 Noorderlaanbrug
676,Noorderlaan,2023-03-04,19:00:00,55,33,22,FMN 16 Noorderlaanbrug
676,Noorderlaan,2023-03-04,20:00:00,45,27,18,FMN 16 Noorderlaanbrug
676,Noorderlaan,2023-03-04,21:00:00,21,15,6,FMN 16 Noorderlaanbrug
676,Noorderlaan,2023-03-04,22:00:00,56,30,26,FMN 16 Noorderlaanbrug
676,Noorderlaan,2023-03-04,23:00:00,50,23,27,FMN 16 Noorderlaanbrug
676,Noorderlaan,2023-03-05,00:00:00,40,9,31,FMN 16 Noorderlaanbrug
676,Noorderlaan,2023-03-05,01:00:00,32,8,24,FMN 16 Noorderlaanbrug
676,Noorderlaan,2023-03-05,02:00:00,34,21,13,FMN 16 Noorderlaanbrug
676,Noorderlaan,2023-03-05,03:00:00,20,12,8,FMN 16 Noorderlaanbrug
676,Noorderlaan,2023-03-05,04:00:00,18,13,5,FMN 16 Noorderlaanbrug
676,Noorderlaan,2023-03-05,05:00:00,15,10,5,FMN 16 Noorderlaanbrug
676,Noorderlaan,2023-03-05,06:00:00,29,15,14,FMN 16 Noorderlaanbrug
676,Noorderlaan,2023-03-05,07:00:00,9,7,2,FMN 16 Noorderlaanbrug
676,Noorderlaan,2023-03-05,08:00:00,22,18,4,FMN 16 Noorderlaanbrug
676,Noorderlaan,2023-03-05,09:00:00,19,16,3,FMN 16 Noorderlaanbrug
676,Noorderlaan,2023-03-05,10:00:00,47,29,18,FMN 16 Noorderlaanbrug
676,Noorderlaan,2023-03-05,11:00:00,35,23,12,FMN 16 Noorderlaanbrug
676,Noorderlaan,2023-03-05,12:00:00,54,31,23,FMN 16 Noorderlaanbrug
676,Noorderlaan,2023-03-05,13:00:00,68,26,42,FMN 16 Noorderlaanbrug
676,Noorderlaan,2023-03-05,14:00:00,48,26,22,FMN 16 Noorderlaanbrug
676,Noorderlaan,2023-03-05,15:00:00,49,20,29,FMN 16 Noorderlaanbrug
676,Noorderlaan,2023-03-05,16:00:00,43,21,22,FMN 16 Noorderlaanbrug
676,Noorderlaan,2023-03-05,17:00:00,38,21,17,FMN 16 Noorderlaanbrug
676,Noorderlaan,2023-03-05,18:00:00,52,18,34,FMN 16 Noorderlaanbrug
676,Noorderlaan,2023-03-05,19:00:00,53,36,17,FMN 16 Noorderlaanbrug
676,Noorderlaan,2023-03-05,20:00:00,28,17,11,FMN 16 Noorderlaanbrug
676,Noorderlaan,2023-03-05,21:00:00,29,19,10,FMN 16 Noorderlaanbrug
676,Noorderlaan,2023-03-05,22:00:00,27,18,9,FMN 16 Noorderlaanbrug
676,Noorderlaan,2023-03-05,23:00:00,11,7,4,FMN 16 Noorderlaanbrug
676,Noorderlaan,2023-03-06,00:00:00,10,5,5,FMN 16 Noorderlaanbrug
676,Noorderlaan,2023-03-06,01:00:00,6,3,3,FMN 16 Noorderlaanbrug
676,Noorderlaan,2023-03-06,02:00:00,1,1,0,FMN 16 Noorderlaanbrug
676,Noorderlaan,2023-03-06,03:00:00,4,4,0,FMN 16 Noorderlaanbrug
676,Noorderlaan,2023-03-06,04:00:00,18,8,10,FMN 16 Noorderlaanbrug
676,Noorderlaan,2023-03-06,05:00:00,68,33,35,FMN 16 Noorderlaanbrug
676,Noorderlaan,2023-03-06,06:00:00,110,65,45,FMN 16 Noorderlaanbrug
676,Noorderlaan,2023-03-06,07:00:00,195,126,69,FMN 16 Noorderlaanbrug
676,Noorderlaan,2023-03-06,08:00:00,435,316,119,FMN 16 Noorderlaanbrug
676,Noorderlaan,2023-03-06,09:00:00,124,75,49,FMN 16 Noorderlaanbrug
676,Noorderlaan,2023-03-06,10:00:00,69,53,16,FMN 16 Noorderlaanbrug
676,Noorderlaan,2023-03-06,11:00:00,70,45,25,FMN 16 Noorderlaanbrug
676,Noorderlaan,2023-03-06,12:00:00,115,73,42,FMN 16 Noorderlaanbrug
676,Noorderlaan,2023-03-06,13:00:00,121,66,55,FMN 16 Noorderlaanbrug
676,Noorderlaan,2023-03-06,14:00:00,123,72,51,FMN 16 Noorderlaanbrug
676,Noorderlaan,2023-03-06,15:00:00,144,68,76,FMN 16 Noorderlaanbrug
676,Noorderlaan,2023-03-06,16:00:00,349,178,171,FMN 16 Noorderlaanbrug
676,Noorderlaan,2023-03-06,17:00:00,355,167,188,FMN 16 Noorderlaanbrug
676,Noorderlaan,2023-03-06,18:00:00,148,78,70,FMN 16 Noorderlaanbrug
676,Noorderlaan,2023-03-06,19:00:00,61,36,25,FMN 16 Noorderlaanbrug
676,Noorderlaan,2023-03-06,20:00:00,43,23,20,FMN 16 Noorderlaanbrug
676,Noorderlaan,2023-03-06,21:00:00,27,9,18,FMN 16 Noorderlaanbrug
676,Noorderlaan,2023-03-06,22:00:00,40,30,10,FMN 16 Noorderlaanbrug
676,Noorderlaan,2023-03-06,23:00:00,17,10,7,FMN 16 Noorderlaanbrug
676,Noorderlaan,2023-03-07,00:00:00,6,3,3,FMN 16 Noorderlaanbrug
676,Noorderlaan,2023-03-07,01:00:00,3,1,2,FMN 16 Noorderlaanbrug
676,Noorderlaan,2023-03-07,02:00:00,3,2,1,FMN 16 Noorderlaanbrug
676,Noorderlaan,2023-03-07,03:00:00,4,3,1,FMN 16 Noorderlaanbrug
676,Noorderlaan,2023-03-07,04:00:00,18,10,8,FMN 16 Noorderlaanbrug
676,Noorderlaan,2023-03-07,05:00:00,48,22,26,FMN 16 Noorderlaanbrug
676,Noorderlaan,2023-03-07,06:00:00,91,43,48,FMN 16 Noorderlaanbrug
676,Noorderlaan,2023-03-07,07:00:00,233,157,76,FMN 16 Noorderlaanbrug
676,Noorderlaan,2023-03-07,08:00:00,318,230,88,FMN 16 Noorderlaanbrug
676,Noorderlaan,2023-03-07,09:00:00,108,79,29,FMN 16 Noorderlaanbrug
676,Noorderlaan,2023-03-07,10:00:00,36,25,11,FMN 16 Noorderlaanbrug
676,Noorderlaan,2023-03-07,11:00:00,43,27,16,FMN 16 Noorderlaanbrug
676,Noorderlaan,2023-03-07,12:00:00,77,40,37,FMN 16 Noorderlaanbrug
676,Noorderlaan,2023-03-07,13:00:00,76,39,37,FMN 16 Noorderlaanbrug
676,Noorderlaan,2023-03-07,14:00:00,89,53,36,FMN 16 Noorderlaanbrug
676,Noorderlaan,2023-03-07,15:00:00,127,61,66,FMN 16 Noorderlaanbrug
676,Noorderlaan,2023-03-07,16:00:00,233,115,118,FMN 16 Noorderlaanbrug
676,Noorderlaan,2023-03-07,17:00:00,255,119,136,FMN 16 Noorderlaanbrug
676,Noorderlaan,2023-03-07,18:00:00,144,61,83,FMN 16 Noorderlaanbrug
676,Noorderlaan,2023-03-07,19:00:00,78,40,38,FMN 16 Noorderlaanbrug
676,Noorderlaan,2023-03-07,20:00:00,48,28,20,FMN 16 Noorderlaanbrug
676,Noorderlaan,2023-03-07,21:00:00,28,13,15,FMN 16 Noorderlaanbrug
676,Noorderlaan,2023-03-07,22:00:00,23,13,10,FMN 16 Noorderlaanbrug
676,Noorderlaan,2023-03-07,23:00:00,24,20,4,FMN 16 Noorderlaanbrug
676,Noorderlaan,2023-03-08,00:00:00,20,15,5,FMN 16 Noorderlaanbrug
676,Noorderlaan,2023-03-08,01:00:00,6,1,5,FMN 16 Noorderlaanbrug
676,Noorderlaan,2023-03-08,02:00:00,10,4,6,FMN 16 Noorderlaanbrug
676,Noorderlaan,2023-03-08,03:00:00,7,3,4,FMN 16 Noorderlaanbrug
676,Noorderlaan,2023-03-08,04:00:00,12,7,5,FMN 16 Noorderlaanbrug
676,Noorderlaan,2023-03-08,05:00:00,46,22,24,FMN 16 Noorderlaanbrug
676,Noorderlaan,2023-03-08,06:00:00,13,6,7,FMN 16 Noorderlaanbrug
676,Noorderlaan,2023-03-08,07:00:00,24,13,11,FMN 16 Noorderlaanbrug
676,Noorderlaan,2023-03-08,08:00:00,73,40,33,FMN 16 Noorderlaanbrug
676,Noorderlaan,2023-03-08,09:00:00,22,11,11,FMN 16 Noorderlaanbrug
676,Noorderlaan,2023-03-08,10:00:00,4,3,1,FMN 16 Noorderlaanbrug
676,Noorderlaan,2023-03-08,11:00:00,6,3,3,FMN 16 Noorderlaanbrug
676,Noorderlaan,2023-03-08,12:00:00,91,43,48,FMN 16 Noorderlaanbrug
676,Noorderlaan,2023-03-08,13:00:00,88,40,48,FMN 16 Noorderlaanbrug
676,Noorderlaan,2023-03-08,14:00:00,83,61,22,FMN 16 Noorderlaanbrug
676,Noorderlaan,2023-03-08,15:00:00,83,44,39,FMN 16 Noorderlaanbrug
676,Noorderlaan,2023-03-08,16:00:00,165,97,68,FMN 16 Noorderlaanbrug
676,Noorderlaan,2023-03-08,17:00:00,172,89,83,FMN 16 Noorderlaanbrug
676,Noorderlaan,2023-03-08,18:00:00,20,14,6,FMN 16 Noorderlaanbrug
676,Noorderlaan,2023-03-08,19:00:00,14,9,5,FMN 16 Noorderlaanbrug
676,Noorderlaan,2023-03-08,20:00:00,10,7,3,FMN 16 Noorderlaanbrug
676,Noorderlaan,2023-03-08,21:00:00,10,8,2,FMN 16 Noorderlaanbrug
676,Noorderlaan,2023-03-08,22:00:00,15,10,5,FMN 16 Noorderlaanbrug
676,Noorderlaan,2023-03-08,23:00:00,7,4,3,FMN 16 Noorderlaanbrug
676,Noorderlaan,2023-03-09,00:00:00,5,1,4,FMN 16 Noorderlaanbrug
676,Noorderlaan,2023-03-09,01:00:00,6,3,3,FMN 16 Noorderlaanbrug
676,Noorderlaan,2023-03-09,02:00:00,7,2,5,FMN 16 Noorderlaanbrug
676,Noorderlaan,2023-03-09,03:00:00,15,13,2,FMN 16 Noorderlaanbrug
676,Noorderlaan,2023-03-09,04:00:00,17,15,2,FMN 16 Noorderlaanbrug
676,Noorderlaan,2023-03-09,05:00:00,67,36,31,FMN 16 Noorderlaanbrug
676,Noorderlaan,2023-03-09,06:00:00,62,36,26,FMN 16 Noorderlaanbrug
676,Noorderlaan,2023-03-09,07:00:00,219,141,78,FMN 16 Noorderlaanbrug
676,Noorderlaan,2023-03-09,08:00:00,374,269,105,FMN 16 Noorderlaanbrug
676,Noorderlaan,2023-03-09,09:00:00,109,81,28,FMN 16 Noorderlaanbrug
676,Noorderlaan,2023-03-09,10:00:00,56,40,16,FMN 16 Noorderlaanbrug
676,Noorderlaan,2023-03-09,11:00:00,57,31,26,FMN 16 Noorderlaanbrug
676,Noorderlaan,2023-03-09,12:00:00,77,32,45,FMN 16 Noorderlaanbrug
676,Noorderlaan,2023-03-09,13:00:00,69,29,40,FMN 16 Noorderlaanbrug
676,Noorderlaan,2023-03-09,14:00:00,105,56,49,FMN 16 Noorderlaanbrug
676,Noorderlaan,2023-03-09,15:00:00,147,80,67,FMN 16 Noorderlaanbrug
676,Noorderlaan,2023-03-09,16:00:00,253,118,135,FMN 16 Noorderlaanbrug
676,Noorderlaan,2023-03-09,17:00:00,240,115,125,FMN 16 Noorderlaanbrug
676,Noorderlaan,2023-03-09,18:00:00,113,53,60,FMN 16 Noorderlaanbrug
676,Noorderlaan,2023-03-09,19:00:00,56,33,23,FMN 16 Noorderlaanbrug
676,Noorderlaan,2023-03-09,20:00:00,35,19,16,FMN 16 Noorderlaanbrug
676,Noorderlaan,2023-03-09,21:00:00,35,19,16,FMN 16 Noorderlaanbrug
676,Noorderlaan,2023-03-09,22:00:00,43,26,17,FMN 16 Noorderlaanbrug
676,Noorderlaan,2023-03-09,23:00:00,14,7,7,FMN 16 Noorderlaanbrug
676,Noorderlaan,2023-03-10,00:00:00,10,6,4,FMN 16 Noorderlaanbrug
676,Noorderlaan,2023-03-10,01:00:00,8,4,4,FMN 16 Noorderlaanbrug
676,Noorderlaan,2023-03-10,02:00:00,0,0,0,FMN 16 Noorderlaanbrug
676,Noorderlaan,2023-03-10,03:00:00,7,6,1,FMN 16 Noorderlaanbrug
676,Noorderlaan,2023-03-10,04:00:00,10,6,4,FMN 16 Noorderlaanbrug
676,Noorderlaan,2023-03-10,05:00:00,51,22,29,FMN 16 Noorderlaanbrug
676,Noorderlaan,2023-03-10,06:00:00,89,44,45,FMN 16 Noorderlaanbrug
676,Noorderlaan,2023-03-10,07:00:00,247,158,89,FMN 16 Noorderlaanbrug
676,Noorderlaan,2023-03-10,08:00:00,331,242,89,FMN 16 Noorderlaanbrug
676,Noorderlaan,2023-03-10,09:00:00,125,82,43,FMN 16 Noorderlaanbrug
676,Noorderlaan,2023-03-10,10:00:00,59,44,15,FMN 16 Noorderlaanbrug
676,Noorderlaan,2023-03-10,11:00:00,87,50,37,FMN 16 Noorderlaanbrug
676,Noorderlaan,2023-03-10,12:00:00,93,52,41,FMN 16 Noorderlaanbrug
676,Noorderlaan,2023-03-10,13:00:00,120,56,64,FMN 16 Noorderlaanbrug
676,Noorderlaan,2023-03-10,14:00:00,103,54,49,FMN 16 Noorderlaanbrug
676,Noorderlaan,2023-03-10,15:00:00,150,72,78,FMN 16 Noorderlaanbrug
676,Noorderlaan,2023-03-10,16:00:00,296,177,119,FMN 16 Noorderlaanbrug
676,Noorderlaan,2023-03-10,17:00:00,211,101,110,FMN 16 Noorderlaanbrug
676,Noorderlaan,2023-03-10,18:00:00,107,61,46,FMN 16 Noorderlaanbrug
676,Noorderlaan,2023-03-10,19:00:00,77,45,32,FMN 16 Noorderlaanbrug
676,Noorderlaan,2023-03-10,20:00:00,51,28,23,FMN 16 Noorderlaanbrug
676,Noorderlaan,2023-03-10,21:00:00,54,26,28,FMN 16 Noorderlaanbrug
676,Noorderlaan,2023-03-10,22:00:00,74,32,42,FMN 16 Noorderlaanbrug
676,Noorderlaan,2023-03-10,23:00:00,76,29,47,FMN 16 Noorderlaanbrug
676,Noorderlaan,2023-03-11,00:00:00,59,33,26,FMN 16 Noorderlaanbrug
676,Noorderlaan,2023-03-11,01:00:00,45,30,15,FMN 16 Noorderlaanbrug
676,Noorderlaan,2023-03-11,02:00:00,42,23,19,FMN 16 Noorderlaanbrug
676,Noorderlaan,2023-03-11,03:00:00,34,22,12,FMN 16 Noorderlaanbrug
676,Noorderlaan,2023-03-11,04:00:00,29,15,14,FMN 16 Noorderlaanbrug
676,Noorderlaan,2023-03-11,05:00:00,7,4,3,FMN 16 Noorderlaanbrug
676,Noorderlaan,2023-03-11,06:00:00,18,10,8,FMN 16 Noorderlaanbrug
676,Noorderlaan,2023-03-11,07:00:00,7,1,6,FMN 16 Noorderlaanbrug
676,Noorderlaan,2023-03-11,08:00:00,32,25,7,FMN 16 Noorderlaanbrug
676,Noorderlaan,2023-03-11,09:00:00,84,61,23,FMN 16 Noorderlaanbrug
676,Noorderlaan,2023-03-11,10:00:00,94,58,36,FMN 16 Noorderlaanbrug
676,Noorderlaan,2023-03-11,11:00:00,78,52,26,FMN 16 Noorderlaanbrug
676,Noorderlaan,2023-03-11,12:00:00,83,41,42,FMN 16 Noorderlaanbrug
676,Noorderlaan,2023-03-11,13:00:00,100,44,56,FMN 16 Noorderlaanbrug
676,Noorderlaan,2023-03-11,14:00:00,112,58,54,FMN 16 Noorderlaanbrug
676,Noorderlaan,2023-03-11,15:00:00,115,51,64,FMN 16 Noorderlaanbrug
676,Noorderlaan,2023-03-11,16:00:00,84,39,45,FMN 16 Noorderlaanbrug
676,Noorderlaan,2023-03-11,17:00:00,126,65,61,FMN 16 Noorderlaanbrug
676,Noorderlaan,2023-03-11,18:00:00,76,45,31,FMN 16 Noorderlaanbrug
676,Noorderlaan,2023-03-11,19:00:00,47,21,26,FMN 16 Noorderlaanbrug
676,Noorderlaan,2023-03-11,20:00:00,43,21,22,FMN 16 Noorderlaanbrug
676,Noorderlaan,2023-03-11,21:00:00,21,10,11,FMN 16 Noorderlaanbrug
676,Noorderlaan,2023-03-11,22:00:00,40,24,16,FMN 16 Noorderlaanbrug
676,Noorderlaan,2023-03-11,23:00:00,25,10,15,FMN 16 Noorderlaanbrug
676,Noorderlaan,2023-03-12,00:00:00,36,14,22,FMN 16 Noorderlaanbrug
676,Noorderlaan,2023-03-12,01:00:00,18,11,7,FMN 16 Noorderlaanbrug
676,Noorderlaan,2023-03-12,02:00:00,13,8,5,FMN 16 Noorderlaanbrug
676,Noorderlaan,2023-03-12,03:00:00,18,6,12,FMN 16 Noorderlaanbrug
676,Noorderlaan,2023-03-12,04:00:00,22,10,12,FMN 16 Noorderlaanbrug
676,Noorderlaan,2023-03-12,05:00:00,19,14,5,FMN 16 Noorderlaanbrug
676,Noorderlaan,2023-03-12,06:00:00,22,9,13,FMN 16 Noorderlaanbrug
676,Noorderlaan,2023-03-12,07:00:00,17,5,12,FMN 16 Noorderlaanbrug
676,Noorderlaan,2023-03-12,08:00:00,12,5,7,FMN 16 Noorderlaanbrug
676,Noorderlaan,2023-03-12,09:00:00,9,2,7,FMN 16 Noorderlaanbrug
676,Noorderlaan,2023-03-12,10:00:00,10,7,3,FMN 16 Noorderlaanbrug
676,Noorderlaan,2023-03-12,11:00:00,32,7,25,FMN 16 Noorderlaanbrug
676,Noorderlaan,2023-03-12,12:00:00,14,8,6,FMN 16 Noorderlaanbrug
676,Noorderlaan,2023-03-12,13:00:00,37,17,20,FMN 16 Noorderlaanbrug
676,Noorderlaan,2023-03-12,14:00:00,25,15,10,FMN 16 Noorderlaanbrug
676,Noorderlaan,2023-03-12,15:00:00,48,20,28,FMN 16 Noorderlaanbrug
676,Noorderlaan,2023-03-12,16:00:00,43,20,23,FMN 16 Noorderlaanbrug
676,Noorderlaan,2023-03-12,17:00:00,39,8,31,FMN 16 Noorderlaanbrug
676,Noorderlaan,2023-03-12,18:00:00,28,11,17,FMN 16 Noorderlaanbrug
676,Noorderlaan,2023-03-12,19:00:00,16,10,6,FMN 16 Noorderlaanbrug
676,Noorderlaan,2023-03-12,20:00:00,13,6,7,FMN 16 Noorderlaanbrug
676,Noorderlaan,2023-03-12,21:00:00,14,5,9,FMN 16 Noorderlaanbrug
676,Noorderlaan,2023-03-12,22:00:00,15,6,9,FMN 16 Noorderlaanbrug
676,Noorderlaan,2023-03-12,23:00:00,14,6,8,FMN 16 Noorderlaanbrug
676,Noorderlaan,2023-03-13,00:00:00,9,6,3,FMN 16 Noorderlaanbrug
676,Noorderlaan,2023-03-13,01:00:00,4,1,3,FMN 16 Noorderlaanbrug
676,Noorderlaan,2023-03-13,02:00:00,0,0,0,FMN 16 Noorderlaanbrug
676,Noorderlaan,2023-03-13,03:00:00,3,1,2,FMN 16 Noorderlaanbrug
676,Noorderlaan,2023-03-13,04:00:00,10,5,5,FMN 16 Noorderlaanbrug
676,Noorderlaan,2023-03-13,05:00:00,54,24,30,FMN 16 Noorderlaanbrug
676,Noorderlaan,2023-03-13,06:00:00,60,25,35,FMN 16 Noorderlaanbrug
676,Noorderlaan,2023-03-13,07:00:00,145,54,91,FMN 16 Noorderlaanbrug
676,Noorderlaan,2023-03-13,08:00:00,153,74,79,FMN 16 Noorderlaanbrug
676,Noorderlaan,2023-03-13,09:00:00,41,18,23,FMN 16 Noorderlaanbrug
676,Noorderlaan,2023-03-13,10:00:00,46,17,29,FMN 16 Noorderlaanbrug
676,Noorderlaan,2023-03-13,11:00:00,36,18,18,FMN 16 Noorderlaanbrug
676,Noorderlaan,2023-03-13,12:00:00,67,22,45,FMN 16 Noorderlaanbrug
676,Noorderlaan,2023-03-13,13:00:00,102,28,74,FMN 16 Noorderlaanbrug
676,Noorderlaan,2023-03-13,14:00:00,121,20,101,FMN 16 Noorderlaanbrug
676,Noorderlaan,2023-03-13,15:00:00,151,38,113,FMN 16 Noorderlaanbrug
676,Noorderlaan,2023-03-13,16:00:00,310,54,256,FMN 16 Noorderlaanbrug
676,Noorderlaan,2023-03-13,17:00:00,353,44,309,FMN 16 Noorderlaanbrug
676,Noorderlaan,2023-03-13,18:00:00,160,21,139,FMN 16 Noorderlaanbrug
676,Noorderlaan,2023-03-13,19:00:00,57,6,51,FMN 16 Noorderlaanbrug
676,Noorderlaan,2023-03-13,20:00:00,55,5,50,FMN 16 Noorderlaanbrug
676,Noorderlaan,2023-03-13,21:00:00,38,9,29,FMN 16 Noorderlaanbrug
676,Noorderlaan,2023-03-13,22:00:00,35,8,27,FMN 16 Noorderlaanbrug
676,Noorderlaan,2023-03-13,23:00:00,19,5,14,FMN 16 Noorderlaanbrug
676,Noorderlaan,2023-03-14,00:00:00,1,0,1,FMN 16 Noorderlaanbrug
676,Noorderlaan,2023-03-14,01:00:00,6,2,4,FMN 16 Noorderlaanbrug
676,Noorderlaan,2023-03-14,02:00:00,3,1,2,FMN 16 Noorderlaanbrug
676,Noorderlaan,2023-03-14,03:00:00,3,0,3,FMN 16 Noorderlaanbrug
676,Noorderlaan,2023-03-14,04:00:00,21,3,18,FMN 16 Noorderlaanbrug
676,Noorderlaan,2023-03-14,05:00:00,64,12,52,FMN 16 Noorderlaanbrug
676,Noorderlaan,2023-03-14,06:00:00,102,11,91,FMN 16 Noorderlaanbrug
676,Noorderlaan,2023-03-14,07:00:00,170,26,144,FMN 16 Noorderlaanbrug
676,Noorderlaan,2023-03-14,08:00:00,191,32,159,FMN 16 Noorderlaanbrug
676,Noorderlaan,2023-03-14,09:00:00,62,12,50,FMN 16 Noorderlaanbrug
676,Noorderlaan,2023-03-14,10:00:00,68,10,58,FMN 16 Noorderlaanbrug
676,Noorderlaan,2023-03-14,11:00:00,44,9,35,FMN 16 Noorderlaanbrug
676,Noorderlaan,2023-03-14,12:00:00,70,14,56,FMN 16 Noorderlaanbrug
676,Noorderlaan,2023-03-14,13:00:00,100,12,88,FMN 16 Noorderlaanbrug
676,Noorderlaan,2023-03-14,14:00:00,106,16,90,FMN 16 Noorderlaanbrug
676,Noorderlaan,2023-03-14,15:00:00,146,26,120,FMN 16 Noorderlaanbrug
676,Noorderlaan,2023-03-14,16:00:00,209,37,172,FMN 16 Noorderlaanbrug
676,Noorderlaan,2023-03-14,17:00:00,236,47,189,FMN 16 Noorderlaanbrug
676,Noorderlaan,2023-03-14,18:00:00,145,16,129,FMN 16 Noorderlaanbrug
676,Noorderlaan,2023-03-14,19:00:00,45,14,31,FMN 16 Noorderlaanbrug
676,Noorderlaan,2023-03-14,20:00:00,31,12,19,FMN 16 Noorderlaanbrug
676,Noorderlaan,2023-03-14,21:00:00,39,15,24,FMN 16 Noorderlaanbrug
676,Noorderlaan,2023-03-14,22:00:00,27,13,14,FMN 16 Noorderlaanbrug
676,Noorderlaan,2023-03-14,23:00:00,11,4,7,FMN 16 Noorderlaanbrug
676,Noorderlaan,2023-03-15,00:00:00,0,0,0,FMN 16 Noorderlaanbrug
676,Noorderlaan,2023-03-15,01:00:00,2,0,2,FMN 16 Noorderlaanbrug
676,Noorderlaan,2023-03-15,02:00:00,3,0,3,FMN 16 Noorderlaanbrug
676,Noorderlaan,2023-03-15,03:00:00,1,1,0,FMN 16 Noorderlaanbrug
676,Noorderlaan,2023-03-15,04:00:00,19,8,11,FMN 16 Noorderlaanbrug
676,Noorderlaan,2023-03-15,05:00:00,59,10,49,FMN 16 Noorderlaanbrug
676,Noorderlaan,2023-03-15,06:00:00,70,14,56,FMN 16 Noorderlaanbrug
676,Noorderlaan,2023-03-15,07:00:00,160,35,125,FMN 16 Noorderlaanbrug
676,Noorderlaan,2023-03-15,08:00:00,209,53,156,FMN 16 Noorderlaanbrug
676,Noorderlaan,2023-03-15,09:00:00,76,18,58,FMN 16 Noorderlaanbrug
676,Noorderlaan,2023-03-15,10:00:00,50,12,38,FMN 16 Noorderlaanbrug
676,Noorderlaan,2023-03-15,11:00:00,75,15,60,FMN 16 Noorderlaanbrug
676,Noorderlaan,2023-03-15,12:00:00,163,60,103,FMN 16 Noorderlaanbrug
676,Noorderlaan,2023-03-15,13:00:00,108,43,65,FMN 16 Noorderlaanbrug
676,Noorderlaan,2023-03-15,14:00:00,96,65,31,FMN 16 Noorderlaanbrug
676,Noorderlaan,2023-03-15,15:00:00,119,75,44,FMN 16 Noorderlaanbrug
676,Noorderlaan,2023-03-15,16:00:00,235,136,99,FMN 16 Noorderlaanbrug
676,Noorderlaan,2023-03-15,17:00:00,266,129,137,FMN 16 Noorderlaanbrug
676,Noorderlaan,2023-03-15,18:00:00,174,94,80,FMN 16 Noorderlaanbrug
676,Noorderlaan,2023-03-15,19:00:00,84,41,43,FMN 16 Noorderlaanbrug
676,Noorderlaan,2023-03-15,20:00:00,65,27,38,FMN 16 Noorderlaanbrug
676,Noorderlaan,2023-03-15,21:00:00,64,30,34,FMN 16 Noorderlaanbrug
676,Noorderlaan,2023-03-15,22:00:00,74,33,41,FMN 16 Noorderlaanbrug
676,Noorderlaan,2023-03-15,23:00:00,42,20,22,FMN 16 Noorderlaanbrug
676,Noorderlaan,2023-03-16,00:00:00,17,10,7,FMN 16 Noorderlaanbrug
676,Noorderlaan,2023-03-16,01:00:00,5,1,4,FMN 16 Noorderlaanbrug
676,Noorderlaan,2023-03-16,02:00:00,6,3,3,FMN 16 Noorderlaanbrug
676,Noorderlaan,2023-03-16,03:00:00,11,6,5,FMN 16 Noorderlaanbrug
676,Noorderlaan,2023-03-16,04:00:00,35,17,18,FMN 16 Noorderlaanbrug
676,Noorderlaan,2023-03-16,05:00:00,108,51,57,FMN 16 Noorderlaanbrug
676,Noorderlaan,2023-03-16,06:00:00,148,88,60,FMN 16 Noorderlaanbrug
676,Noorderlaan,2023-03-16,07:00:00,388,232,156,FMN 16 Noorderlaanbrug
676,Noorderlaan,2023-03-16,08:00:00,471,281,190,FMN 16 Noorderlaanbrug
676,Noorderlaan,2023-03-16,09:00:00,169,81,88,FMN 16 Noorderlaanbrug
676,Noorderlaan,2023-03-16,10:00:00,85,33,52,FMN 16 Noorderlaanbrug
676,Noorderlaan,2023-03-16,11:00:00,66,21,45,FMN 16 Noorderlaanbrug
676,Noorderlaan,2023-03-16,12:00:00,117,40,77,FMN 16 Noorderlaanbrug
676,Noorderlaan,2023-03-16,13:00:00,114,36,78,FMN 16 Noorderlaanbrug
676,Noorderlaan,2023-03-16,14:00:00,122,50,72,FMN 16 Noorderlaanbrug
676,Noorderlaan,2023-03-16,15:00:00,107,44,63,FMN 16 Noorderlaanbrug
676,Noorderlaan,2023-03-16,16:00:00,166,67,99,FMN 16 Noorderlaanbrug
676,Noorderlaan,2023-03-16,17:00:00,164,102,62,FMN 16 Noorderlaanbrug
676,Noorderlaan,2023-03-16,18:00:00,97,67,30,FMN 16 Noorderlaanbrug
676,Noorderlaan,2023-03-16,19:00:00,48,32,16,FMN 16 Noorderlaanbrug
676,Noorderlaan,2023-03-16,20:00:00,22,13,9,FMN 16 Noorderlaanbrug
676,Noorderlaan,2023-03-16,21:00:00,38,28,10,FMN 16 Noorderlaanbrug
676,Noorderlaan,2023-03-16,22:00:00,36,19,17,FMN 16 Noorderlaanbrug
676,Noorderlaan,2023-03-16,23:00:00,18,11,7,FMN 16 Noorderlaanbrug
676,Noorderlaan,2023-03-17,00:00:00,14,6,8,FMN 16 Noorderlaanbrug
676,Noorderlaan,2023-03-17,01:00:00,7,6,1,FMN 16 Noorderlaanbrug
676,Noorderlaan,2023-03-17,02:00:00,7,5,2,FMN 16 Noorderlaanbrug
676,Noorderlaan,2023-03-17,03:00:00,7,4,3,FMN 16 Noorderlaanbrug
676,Noorderlaan,2023-03-17,04:00:00,16,10,6,FMN 16 Noorderlaanbrug
676,Noorderlaan,2023-03-17,05:00:00,40,28,12,FMN 16 Noorderlaanbrug
676,Noorderlaan,2023-03-17,06:00:00,55,20,35,FMN 16 Noorderlaanbrug
676,Noorderlaan,2023-03-17,07:00:00,129,54,75,FMN 16 Noorderlaanbrug
676,Noorderlaan,2023-03-17,08:00:00,191,67,124,FMN 16 Noorderlaanbrug
676,Noorderlaan,2023-03-17,09:00:00,66,18,48,FMN 16 Noorderlaanbrug
676,Noorderlaan,2023-03-17,10:00:00,50,9,41,FMN 16 Noorderlaanbrug
676,Noorderlaan,2023-03-17,11:00:00,57,23,34,FMN 16 Noorderlaanbrug
676,Noorderlaan,2023-03-17,12:00:00,77,24,53,FMN 16 Noorderlaanbrug
676,Noorderlaan,2023-03-17,13:00:00,82,31,51,FMN 16 Noorderlaanbrug
676,Noorderlaan,2023-03-17,14:00:00,107,26,81,FMN 16 Noorderlaanbrug
676,Noorderlaan,2023-03-17,15:00:00,102,39,63,FMN 16 Noorderlaanbrug
676,Noorderlaan,2023-03-17,16:00:00,159,65,94,FMN 16 Noorderlaanbrug
676,Noorderlaan,2023-03-17,17:00:00,153,43,110,FMN 16 Noorderlaanbrug
676,Noorderlaan,2023-03-17,18:00:00,113,31,82,FMN 16 Noorderlaanbrug
676,Noorderlaan,2023-03-17,19:00:00,47,14,33,FMN 16 Noorderlaanbrug
676,Noorderlaan,2023-03-17,20:00:00,27,3,24,FMN 16 Noorderlaanbrug
676,Noorderlaan,2023-03-17,21:00:00,28,12,16,FMN 16 Noorderlaanbrug
676,Noorderlaan,2023-03-17,22:00:00,40,12,28,FMN 16 Noorderlaanbrug
676,Noorderlaan,2023-03-17,23:00:00,31,8,23,FMN 16 Noorderlaanbrug
676,Noorderlaan,2023-03-18,00:00:00,34,18,16,FMN 16 Noorderlaanbrug
676,Noorderlaan,2023-03-18,01:00:00,33,12,21,FMN 16 Noorderlaanbrug
676,Noorderlaan,2023-03-18,02:00:00,17,6,11,FMN 16 Noorderlaanbrug
676,Noorderlaan,2023-03-18,03:00:00,14,3,11,FMN 16 Noorderlaanbrug
676,Noorderlaan,2023-03-18,04:00:00,10,5,5,FMN 16 Noorderlaanbrug
676,Noorderlaan,2023-03-18,05:00:00,17,6,11,FMN 16 Noorderlaanbrug
676,Noorderlaan,2023-03-18,06:00:00,20,10,10,FMN 16 Noorderlaanbrug
676,Noorderlaan,2023-03-18,07:00:00,22,8,14,FMN 16 Noorderlaanbrug
676,Noorderlaan,2023-03-18,08:00:00,23,7,16,FMN 16 Noorderlaanbrug
676,Noorderlaan,2023-03-18,09:00:00,53,16,37,FMN 16 Noorderlaanbrug
676,Noorderlaan,2023-03-18,10:00:00,56,12,44,FMN 16 Noorderlaanbrug
676,Noorderlaan,2023-03-18,11:00:00,64,30,34,FMN 16 Noorderlaanbrug
676,Noorderlaan,2023-03-18,12:00:00,33,11,22,FMN 16 Noorderlaanbrug
676,Noorderlaan,2023-03-18,13:00:00,59,12,47,FMN 16 Noorderlaanbrug
676,Noorderlaan,2023-03-18,14:00:00,64,11,53,FMN 16 Noorderlaanbrug
676,Noorderlaan,2023-03-18,15:00:00,59,18,41,FMN 16 Noorderlaanbrug
676,Noorderlaan,2023-03-18,16:00:00,60,13,47,FMN 16 Noorderlaanbrug
676,Noorderlaan,2023-03-18,17:00:00,59,12,47,FMN 16 Noorderlaanbrug
676,Noorderlaan,2023-03-18,18:00:00,55,15,40,FMN 16 Noorderlaanbrug
676,Noorderlaan,2023-03-18,19:00:00,34,7,27,FMN 16 Noorderlaanbrug
676,Noorderlaan,2023-03-18,20:00:00,20,6,14,FMN 16 Noorderlaanbrug
676,Noorderlaan,2023-03-18,21:00:00,14,2,12,FMN 16 Noorderlaanbrug
676,Noorderlaan,2023-03-18,22:00:00,20,9,11,FMN 16 Noorderlaanbrug
676,Noorderlaan,2023-03-18,23:00:00,21,6,15,FMN 16 Noorderlaanbrug
676,Noorderlaan,2023-03-19,00:00:00,16,6,10,FMN 16 Noorderlaanbrug
676,Noorderlaan,2023-03-19,01:00:00,9,3,6,FMN 16 Noorderlaanbrug
676,Noorderlaan,2023-03-19,02:00:00,9,4,5,FMN 16 Noorderlaanbrug
676,Noorderlaan,2023-03-19,03:00:00,7,2,5,FMN 16 Noorderlaanbrug
676,Noorderlaan,2023-03-19,04:00:00,2,1,1,FMN 16 Noorderlaanbrug
676,Noorderlaan,2023-03-19,05:00:00,11,3,8,FMN 16 Noorderlaanbrug
676,Noorderlaan,2023-03-19,06:00:00,12,5,7,FMN 16 Noorderlaanbrug
676,Noorderlaan,2023-03-19,07:00:00,12,3,9,FMN 16 Noorderlaanbrug
676,Noorderlaan,2023-03-19,08:00:00,10,2,8,FMN 16 Noorderlaanbrug
676,Noorderlaan,2023-03-19,09:00:00,34,9,25,FMN 16 Noorderlaanbrug
676,Noorderlaan,2023-03-19,10:00:00,24,4,20,FMN 16 Noorderlaanbrug
676,Noorderlaan,2023-03-19,11:00:00,25,6,19,FMN 16 Noorderlaanbrug
676,Noorderlaan,2023-03-19,12:00:00,16,2,14,FMN 16 Noorderlaanbrug
676,Noorderlaan,2023-03-19,13:00:00,46,8,38,FMN 16 Noorderlaanbrug
676,Noorderlaan,2023-03-19,14:00:00,35,5,30,FMN 16 Noorderlaanbrug
676,Noorderlaan,2023-03-19,15:00:00,64,20,44,FMN 16 Noorderlaanbrug
676,Noorderlaan,2023-03-19,16:00:00,31,8,23,FMN 16 Noorderlaanbrug
676,Noorderlaan,2023-03-19,17:00:00,39,9,30,FMN 16 Noorderlaanbrug
676,Noorderlaan,2023-03-19,18:00:00,26,6,20,FMN 16 Noorderlaanbrug
676,Noorderlaan,2023-03-19,19:00:00,17,3,14,FMN 16 Noorderlaanbrug
676,Noorderlaan,2023-03-19,20:00:00,21,7,14,FMN 16 Noorderlaanbrug
676,Noorderlaan,2023-03-19,21:00:00,11,1,10,FMN 16 Noorderlaanbrug
676,Noorderlaan,2023-03-19,22:00:00,22,6,16,FMN 16 Noorderlaanbrug
676,Noorderlaan,2023-03-19,23:00:00,11,2,9,FMN 16 Noorderlaanbrug
676,Noorderlaan,2023-03-20,00:00:00,4,2,2,FMN 16 Noorderlaanbrug
676,Noorderlaan,2023-03-20,01:00:00,4,3,1,FMN 16 Noorderlaanbrug
676,Noorderlaan,2023-03-20,02:00:00,2,1,1,FMN 16 Noorderlaanbrug
676,Noorderlaan,2023-03-20,03:00:00,3,0,3,FMN 16 Noorderlaanbrug
676,Noorderlaan,2023-03-20,04:00:00,15,5,10,FMN 16 Noorderlaanbrug
676,Noorderlaan,2023-03-20,05:00:00,53,20,33,FMN 16 Noorderlaanbrug
676,Noorderlaan,2023-03-20,06:00:00,84,38,46,FMN 16 Noorderlaanbrug
676,Noorderlaan,2023-03-20,07:00:00,144,53,91,FMN 16 Noorderlaanbrug
676,Noorderlaan,2023-03-20,08:00:00,122,43,79,FMN 16 Noorderlaanbrug
676,Noorderlaan,2023-03-20,09:00:00,37,9,28,FMN 16 Noorderlaanbrug
676,Noorderlaan,2023-03-20,10:00:00,24,9,15,FMN 16 Noorderlaanbrug
676,Noorderlaan,2023-03-20,11:00:00,12,4,8,FMN 16 Noorderlaanbrug
676,Noorderlaan,2023-03-20,12:00:00,29,7,22,FMN 16 Noorderlaanbrug
676,Noorderlaan,2023-03-20,13:00:00,44,13,31,FMN 16 Noorderlaanbrug
676,Noorderlaan,2023-03-20,14:00:00,88,47,41,FMN 16 Noorderlaanbrug
676,Noorderlaan,2023-03-20,15:00:00,90,19,71,FMN 16 Noorderlaanbrug
676,Noorderlaan,2023-03-20,16:00:00,189,41,148,FMN 16 Noorderlaanbrug
676,Noorderlaan,2023-03-20,17:00:00,205,60,145,FMN 16 Noorderlaanbrug
676,Noorderlaan,2023-03-20,18:00:00,73,42,31,FMN 16 Noorderlaanbrug
676,Noorderlaan,2023-03-20,19:00:00,18,10,8,FMN 16 Noorderlaanbrug
676,Noorderlaan,2023-03-20,20:00:00,15,10,5,FMN 16 Noorderlaanbrug
676,Noorderlaan,2023-03-20,21:00:00,13,12,1,FMN 16 Noorderlaanbrug
676,Noorderlaan,2023-03-20,22:00:00,12,9,3,FMN 16 Noorderlaanbrug
676,Noorderlaan,2023-03-20,23:00:00,4,3,1,FMN 16 Noorderlaanbrug
676,Noorderlaan,2023-03-21,00:00:00,3,2,1,FMN 16 Noorderlaanbrug
676,Noorderlaan,2023-03-21,01:00:00,3,2,1,FMN 16 Noorderlaanbrug
676,Noorderlaan,2023-03-21,02:00:00,0,0,0,FMN 16 Noorderlaanbrug
676,Noorderlaan,2023-03-21,03:00:00,2,2,0,FMN 16 Noorderlaanbrug
676,Noorderlaan,2023-03-21,04:00:00,11,10,1,FMN 16 Noorderlaanbrug
676,Noorderlaan,2023-03-21,05:00:00,23,19,4,FMN 16 Noorderlaanbrug
676,Noorderlaan,2023-03-21,06:00:00,40,28,12,FMN 16 Noorderlaanbrug
676,Noorderlaan,2023-03-21,07:00:00,70,33,37,FMN 16 Noorderlaanbrug
676,Noorderlaan,2023-03-21,08:00:00,70,38,32,FMN 16 Noorderlaanbrug
676,Noorderlaan,2023-03-21,09:00:00,21,9,12,FMN 16 Noorderlaanbrug
676,Noorderlaan,2023-03-21,10:00:00,19,11,8,FMN 16 Noorderlaanbrug
676,Noorderlaan,2023-03-21,11:00:00,22,19,3,FMN 16 Noorderlaanbrug
676,Noorderlaan,2023-03-21,12:00:00,24,12,12,FMN 16 Noorderlaanbrug
676,Noorderlaan,2023-03-21,13:00:00,43,22,21,FMN 16 Noorderlaanbrug
676,Noorderlaan,2023-03-21,14:00:00,28,15,13,FMN 16 Noorderlaanbrug
676,Noorderlaan,2023-03-21,15:00:00,57,33,24,FMN 16 Noorderlaanbrug
676,Noorderlaan,2023-03-21,16:00:00,90,56,34,FMN 16 Noorderlaanbrug
676,Noorderlaan,2023-03-21,17:00:00,111,51,60,FMN 16 Noorderlaanbrug
676,Noorderlaan,2023-03-21,18:00:00,78,40,38,FMN 16 Noorderlaanbrug
676,Noorderlaan,2023-03-21,19:00:00,42,9,33,FMN 16 Noorderlaanbrug
676,Noorderlaan,2023-03-21,20:00:00,25,5,20,FMN 16 Noorderlaanbrug
676,Noorderlaan,2023-03-21,21:00:00,32,9,23,FMN 16 Noorderlaanbrug
676,Noorderlaan,2023-03-21,22:00:00,49,9,40,FMN 16 Noorderlaanbrug
676,Noorderlaan,2023-03-21,23:00:00,19,2,17,FMN 16 Noorderlaanbrug
676,Noorderlaan,2023-03-22,00:00:00,12,1,11,FMN 16 Noorderlaanbrug
676,Noorderlaan,2023-03-22,01:00:00,5,1,4,FMN 16 Noorderlaanbrug
676,Noorderlaan,2023-03-22,02:00:00,3,3,0,FMN 16 Noorderlaanbrug
676,Noorderlaan,2023-03-22,03:00:00,7,1,6,FMN 16 Noorderlaanbrug
676,Noorderlaan,2023-03-22,04:00:00,16,1,15,FMN 16 Noorderlaanbrug
676,Noorderlaan,2023-03-22,05:00:00,47,5,42,FMN 16 Noorderlaanbrug
676,Noorderlaan,2023-03-22,06:00:00,78,15,63,FMN 16 Noorderlaanbrug
676,Noorderlaan,2023-03-22,07:00:00,160,30,130,FMN 16 Noorderlaanbrug
676,Noorderlaan,2023-03-22,08:00:00,159,35,124,FMN 16 Noorderlaanbrug
676,Noorderlaan,2023-03-22,09:00:00,42,0,42,FMN 16 Noorderlaanbrug
676,Noorderlaan,2023-03-22,10:00:00,25,2,23,FMN 16 Noorderlaanbrug
676,Noorderlaan,2023-03-22,11:00:00,29,8,21,FMN 16 Noorderlaanbrug
676,Noorderlaan,2023-03-22,12:00:00,90,11,79,FMN 16 Noorderlaanbrug
676,Noorderlaan,2023-03-22,13:00:00,68,12,56,FMN 16 Noorderlaanbrug
676,Noorderlaan,2023-03-22,14:00:00,74,7,67,FMN 16 Noorderlaanbrug
676,Noorderlaan,2023-03-22,15:00:00,87,13,74,FMN 16 Noorderlaanbrug
676,Noorderlaan,2023-03-22,16:00:00,137,17,120,FMN 16 Noorderlaanbrug
676,Noorderlaan,2023-03-22,17:00:00,182,17,165,FMN 16 Noorderlaanbrug
676,Noorderlaan,2023-03-22,18:00:00,107,12,95,FMN 16 Noorderlaanbrug
676,Noorderlaan,2023-03-22,19:00:00,52,8,44,FMN 16 Noorderlaanbrug
676,Noorderlaan,2023-03-22,20:00:00,38,2,36,FMN 16 Noorderlaanbrug
676,Noorderlaan,2023-03-22,21:00:00,34,3,31,FMN 16 Noorderlaanbrug
676,Noorderlaan,2023-03-22,22:00:00,36,9,27,FMN 16 Noorderlaanbrug
676,Noorderlaan,2023-03-22,23:00:00,24,4,20,FMN 16 Noorderlaanbrug
676,Noorderlaan,2023-03-23,00:00:00,14,4,10,FMN 16 Noorderlaanbrug
676,Noorderlaan,2023-03-23,01:00:00,11,4,7,FMN 16 Noorderlaanbrug
676,Noorderlaan,2023-03-23,02:00:00,9,5,4,FMN 16 Noorderlaanbrug
676,Noorderlaan,2023-03-23,03:00:00,7,2,5,FMN 16 Noorderlaanbrug
676,Noorderlaan,2023-03-23,04:00:00,14,4,10,FMN 16 Noorderlaanbrug
676,Noorderlaan,2023-03-23,05:00:00,45,22,23,FMN 16 Noorderlaanbrug
676,Noorderlaan,2023-03-23,06:00:00,60,19,41,FMN 16 Noorderlaanbrug
676,Noorderlaan,2023-03-23,07:00:00,130,47,83,FMN 16 Noorderlaanbrug
676,Noorderlaan,2023-03-23,08:00:00,167,54,113,FMN 16 Noorderlaanbrug
676,Noorderlaan,2023-03-23,09:00:00,40,17,23,FMN 16 Noorderlaanbrug
676,Noorderlaan,2023-03-23,10:00:00,27,13,14,FMN 16 Noorderlaanbrug
676,Noorderlaan,2023-03-23,11:00:00,41,6,35,FMN 16 Noorderlaanbrug
676,Noorderlaan,2023-03-23,12:00:00,44,18,26,FMN 16 Noorderlaanbrug
676,Noorderlaan,2023-03-23,13:00:00,49,26,23,FMN 16 Noorderlaanbrug
676,Noorderlaan,2023-03-23,14:00:00,49,15,34,FMN 16 Noorderlaanbrug
676,Noorderlaan,2023-03-23,15:00:00,81,24,57,FMN 16 Noorderlaanbrug
676,Noorderlaan,2023-03-23,16:00:00,151,39,112,FMN 16 Noorderlaanbrug
676,Noorderlaan,2023-03-23,17:00:00,163,49,114,FMN 16 Noorderlaanbrug
676,Noorderlaan,2023-03-23,18:00:00,78,25,53,FMN 16 Noorderlaanbrug
676,Noorderlaan,2023-03-23,19:00:00,34,7,27,FMN 16 Noorderlaanbrug
676,Noorderlaan,2023-03-23,20:00:00,19,3,16,FMN 16 Noorderlaanbrug
676,Noorderlaan,2023-03-23,21:00:00,22,11,11,FMN 16 Noorderlaanbrug
676,Noorderlaan,2023-03-23,22:00:00,24,7,17,FMN 16 Noorderlaanbrug
676,Noorderlaan,2023-03-23,23:00:00,11,3,8,FMN 16 Noorderlaanbrug
676,Noorderlaan,2023-03-24,00:00:00,10,6,4,FMN 16 Noorderlaanbrug
676,Noorderlaan,2023-03-24,01:00:00,9,6,3,FMN 16 Noorderlaanbrug
676,Noorderlaan,2023-03-24,02:00:00,3,1,2,FMN 16 Noorderlaanbrug
676,Noorderlaan,2023-03-24,03:00:00,11,4,7,FMN 16 Noorderlaanbrug
676,Noorderlaan,2023-03-24,04:00:00,10,3,7,FMN 16 Noorderlaanbrug
676,Noorderlaan,2023-03-24,05:00:00,38,17,21,FMN 16 Noorderlaanbrug
676,Noorderlaan,2023-03-24,06:00:00,46,15,31,FMN 16 Noorderlaanbrug
676,Noorderlaan,2023-03-24,07:00:00,116,28,88,FMN 16 Noorderlaanbrug
676,Noorderlaan,2023-03-24,08:00:00,161,33,128,FMN 16 Noorderlaanbrug
676,Noorderlaan,2023-03-24,09:00:00,59,19,40,FMN 16 Noorderlaanbrug
676,Noorderlaan,2023-03-24,10:00:00,29,6,23,FMN 16 Noorderlaanbrug
676,Noorderlaan,2023-03-24,11:00:00,29,4,25,FMN 16 Noorderlaanbrug
676,Noorderlaan,2023-03-24,12:00:00,46,11,35,FMN 16 Noorderlaanbrug
676,Noorderlaan,2023-03-24,13:00:00,47,9,38,FMN 16 Noorderlaanbrug
676,Noorderlaan,2023-03-24,14:00:00,54,10,44,FMN 16 Noorderlaanbrug
676,Noorderlaan,2023-03-24,15:00:00,67,14,53,FMN 16 Noorderlaanbrug
676,Noorderlaan,2023-03-24,16:00:00,152,23,129,FMN 16 Noorderlaanbrug
676,Noorderlaan,2023-03-24,17:00:00,139,49,90,FMN 16 Noorderlaanbrug
676,Noorderlaan,2023-03-24,18:00:00,72,19,53,FMN 16 Noorderlaanbrug
676,Noorderlaan,2023-03-24,19:00:00,52,20,32,FMN 16 Noorderlaanbrug
676,Noorderlaan,2023-03-24,20:00:00,20,4,16,FMN 16 Noorderlaanbrug
676,Noorderlaan,2023-03-24,21:00:00,31,13,18,FMN 16 Noorderlaanbrug
676,Noorderlaan,2023-03-24,22:00:00,26,10,16,FMN 16 Noorderlaanbrug
676,Noorderlaan,2023-03-24,23:00:00,10,6,4,FMN 16 Noorderlaanbrug
676,Noorderlaan,2023-03-25,00:00:00,49,24,25,FMN 16 Noorderlaanbrug
676,Noorderlaan,2023-03-25,01:00:00,14,6,8,FMN 16 Noorderlaanbrug
676,Noorderlaan,2023-03-25,02:00:00,9,1,8,FMN 16 Noorderlaanbrug
676,Noorderlaan,2023-03-25,03:00:00,11,6,5,FMN 16 Noorderlaanbrug
676,Noorderlaan,2023-03-25,04:00:00,0,0,0,FMN 16 Noorderlaanbrug
676,Noorderlaan,2023-03-25,05:00:00,12,2,10,FMN 16 Noorderlaanbrug
676,Noorderlaan,2023-03-25,06:00:00,9,4,5,FMN 16 Noorderlaanbrug
676,Noorderlaan,2023-03-25,07:00:00,19,3,16,FMN 16 Noorderlaanbrug
676,Noorderlaan,2023-03-25,08:00:00,11,3,8,FMN 16 Noorderlaanbrug
676,Noorderlaan,2023-03-25,09:00:00,17,8,9,FMN 16 Noorderlaanbrug
676,Noorderlaan,2023-03-25,10:00:00,17,4,13,FMN 16 Noorderlaanbrug
676,Noorderlaan,2023-03-25,11:00:00,24,13,11,FMN 16 Noorderlaanbrug
676,Noorderlaan,2023-03-25,12:00:00,15,5,10,FMN 16 Noorderlaanbrug
676,Noorderlaan,2023-03-25,13:00:00,23,10,13,FMN 16 Noorderlaanbrug
676,Noorderlaan,2023-03-25,14:00:00,20,8,12,FMN 16 Noorderlaanbrug
676,Noorderlaan,2023-03-25,15:00:00,26,9,17,FMN 16 Noorderlaanbrug
676,Noorderlaan,2023-03-25,16:00:00,36,15,21,FMN 16 Noorderlaanbrug
676,Noorderlaan,2023-03-25,17:00:00,50,19,31,FMN 16 Noorderlaanbrug
676,Noorderlaan,2023-03-25,18:00:00,44,15,29,FMN 16 Noorderlaanbrug
676,Noorderlaan,2023-03-25,19:00:00,14,6,8,FMN 16 Noorderlaanbrug
676,Noorderlaan,2023-03-25,20:00:00,14,5,9,FMN 16 Noorderlaanbrug
676,Noorderlaan,2023-03-25,21:00:00,16,7,9,FMN 16 Noorderlaanbrug
676,Noorderlaan,2023-03-25,22:00:00,17,6,11,FMN 16 Noorderlaanbrug
676,Noorderlaan,2023-03-25,23:00:00,12,5,7,FMN 16 Noorderlaanbrug
676,Noorderlaan,2023-03-26,00:00:00,10,4,6,FMN 16 Noorderlaanbrug
676,Noorderlaan,2023-03-26,01:00:00,10,7,3,FMN 16 Noorderlaanbrug
676,Noorderlaan,2023-03-26,02:00:00,0,0,0,FMN 16 Noorderlaanbrug
676,Noorderlaan,2023-03-26,03:00:00,2,0,2,FMN 16 Noorderlaanbrug
676,Noorderlaan,2023-03-26,04:00:00,10,0,10,FMN 16 Noorderlaanbrug
676,Noorderlaan,2023-03-26,05:00:00,8,2,6,FMN 16 Noorderlaanbrug
676,Noorderlaan,2023-03-26,06:00:00,5,0,5,FMN 16 Noorderlaanbrug
676,Noorderlaan,2023-03-26,07:00:00,5,3,2,FMN 16 Noorderlaanbrug
676,Noorderlaan,2023-03-26,08:00:00,5,0,5,FMN 16 Noorderlaanbrug
676,Noorderlaan,2023-03-26,09:00:00,5,1,4,FMN 16 Noorderlaanbrug
676,Noorderlaan,2023-03-26,10:00:00,9,3,6,FMN 16 Noorderlaanbrug
676,Noorderlaan,2023-03-26,11:00:00,3,1,2,FMN 16 Noorderlaanbrug
676,Noorderlaan,2023-03-26,12:00:00,4,0,4,FMN 16 Noorderlaanbrug
676,Noorderlaan,2023-03-26,13:00:00,13,3,10,FMN 16 Noorderlaanbrug
676,Noorderlaan,2023-03-26,14:00:00,18,7,11,FMN 16 Noorderlaanbrug
676,Noorderlaan,2023-03-26,15:00:00,12,3,9,FMN 16 Noorderlaanbrug
676,Noorderlaan,2023-03-26,16:00:00,8,1,7,FMN 16 Noorderlaanbrug
676,Noorderlaan,2023-03-26,17:00:00,14,6,8,FMN 16 Noorderlaanbrug
676,Noorderlaan,2023-03-26,18:00:00,12,5,7,FMN 16 Noorderlaanbrug
676,Noorderlaan,2023-03-26,19:00:00,15,4,11,FMN 16 Noorderlaanbrug
676,Noorderlaan,2023-03-26,20:00:00,13,8,5,FMN 16 Noorderlaanbrug
676,Noorderlaan,2023-03-26,21:00:00,11,9,2,FMN 16 Noorderlaanbrug
676,Noorderlaan,2023-03-26,22:00:00,4,3,1,FMN 16 Noorderlaanbrug
676,Noorderlaan,2023-03-26,23:00:00,6,2,4,FMN 16 Noorderlaanbrug
676,Noorderlaan,2023-03-27,00:00:00,2,1,1,FMN 16 Noorderlaanbrug
676,Noorderlaan,2023-03-27,01:00:00,1,0,1,FMN 16 Noorderlaanbrug
676,Noorderlaan,2023-03-27,02:00:00,1,0,1,FMN 16 Noorderlaanbrug
676,Noorderlaan,2023-03-27,03:00:00,1,0,1,FMN 16 Noorderlaanbrug
676,Noorderlaan,2023-03-27,04:00:00,5,2,3,FMN 16 Noorderlaanbrug
676,Noorderlaan,2023-03-27,05:00:00,29,20,9,FMN 16 Noorderlaanbrug
676,Noorderlaan,2023-03-27,06:00:00,24,8,16,FMN 16 Noorderlaanbrug
676,Noorderlaan,2023-03-27,07:00:00,101,27,74,FMN 16 Noorderlaanbrug
676,Noorderlaan,2023-03-27,08:00:00,135,36,99,FMN 16 Noorderlaanbrug
676,Noorderlaan,2023-03-27,09:00:00,41,14,27,FMN 16 Noorderlaanbrug
676,Noorderlaan,2023-03-27,10:00:00,33,7,26,FMN 16 Noorderlaanbrug
676,Noorderlaan,2023-03-27,11:00:00,22,3,19,FMN 16 Noorderlaanbrug
676,Noorderlaan,2023-03-27,12:00:00,39,13,26,FMN 16 Noorderlaanbrug
676,Noorderlaan,2023-03-27,13:00:00,40,15,25,FMN 16 Noorderlaanbrug
676,Noorderlaan,2023-03-27,14:00:00,54,12,42,FMN 16 Noorderlaanbrug
676,Noorderlaan,2023-03-27,15:00:00,51,6,45,FMN 16 Noorderlaanbrug
676,Noorderlaan,2023-03-27,16:00:00,110,19,91,FMN 16 Noorderlaanbrug
676,Noorderlaan,2023-03-27,17:00:00,129,25,104,FMN 16 Noorderlaanbrug
676,Noorderlaan,2023-03-27,18:00:00,61,12,49,FMN 16 Noorderlaanbrug
676,Noorderlaan,2023-03-27,19:00:00,23,3,20,FMN 16 Noorderlaanbrug
676,Noorderlaan,2023-03-27,20:00:00,17,6,11,FMN 16 Noorderlaanbrug
676,Noorderlaan,2023-03-27,21:00:00,14,1,13,FMN 16 Noorderlaanbrug
676,Noorderlaan,2023-03-27,22:00:00,26,2,24,FMN 16 Noorderlaanbrug
676,Noorderlaan,2023-03-27,23:00:00,9,2,7,FMN 16 Noorderlaanbrug
676,Noorderlaan,2023-03-28,00:00:00,0,0,0,FMN 16 Noorderlaanbrug
676,Noorderlaan,2023-03-28,01:00:00,5,0,5,FMN 16 Noorderlaanbrug
676,Noorderlaan,2023-03-28,02:00:00,3,0,3,FMN 16 Noorderlaanbrug
676,Noorderlaan,2023-03-28,03:00:00,2,0,2,FMN 16 Noorderlaanbrug
676,Noorderlaan,2023-03-28,04:00:00,7,0,7,FMN 16 Noorderlaanbrug
676,Noorderlaan,2023-03-28,05:00:00,44,12,32,FMN 16 Noorderlaanbrug
676,Noorderlaan,2023-03-28,06:00:00,80,15,65,FMN 16 Noorderlaanbrug
676,Noorderlaan,2023-03-28,07:00:00,115,29,86,FMN 16 Noorderlaanbrug
676,Noorderlaan,2023-03-28,08:00:00,121,45,76,FMN 16 Noorderlaanbrug
676,Noorderlaan,2023-03-28,09:00:00,27,6,21,FMN 16 Noorderlaanbrug
676,Noorderlaan,2023-03-28,10:00:00,28,7,21,FMN 16 Noorderlaanbrug
676,Noorderlaan,2023-03-28,11:00:00,35,2,33,FMN 16 Noorderlaanbrug
676,Noorderlaan,2023-03-28,12:00:00,69,4,65,FMN 16 Noorderlaanbrug
676,Noorderlaan,2023-03-28,13:00:00,57,8,49,FMN 16 Noorderlaanbrug
676,Noorderlaan,2023-03-28,14:00:00,76,33,43,FMN 16 Noorderlaanbrug
676,Noorderlaan,2023-03-28,15:00:00,82,26,56,FMN 16 Noorderlaanbrug
676,Noorderlaan,2023-03-28,16:00:00,157,65,92,FMN 16 Noorderlaanbrug
676,Noorderlaan,2023-03-28,17:00:00,199,66,133,FMN 16 Noorderlaanbrug
676,Noorderlaan,2023-03-28,18:00:00,101,45,56,FMN 16 Noorderlaanbrug
676,Noorderlaan,2023-03-28,19:00:00,34,10,24,FMN 16 Noorderlaanbrug
676,Noorderlaan,2023-03-28,20:00:00,27,8,19,FMN 16 Noorderlaanbrug
676,Noorderlaan,2023-03-28,21:00:00,17,5,12,FMN 16 Noorderlaanbrug
676,Noorderlaan,2023-03-28,22:00:00,25,15,10,FMN 16 Noorderlaanbrug
676,Noorderlaan,2023-03-28,23:00:00,2,1,1,FMN 16 Noorderlaanbrug
676,Noorderlaan,2023-03-29,00:00:00,1,1,0,FMN 16 Noorderlaanbrug
676,Noorderlaan,2023-03-29,01:00:00,4,0,4,FMN 16 Noorderlaanbrug
676,Noorderlaan,2023-03-29,02:00:00,0,0,0,FMN 16 Noorderlaanbrug
676,Noorderlaan,2023-03-29,03:00:00,2,1,1,FMN 16 Noorderlaanbrug
676,Noorderlaan,2023-03-29,04:00:00,5,2,3,FMN 16 Noorderlaanbrug
676,Noorderlaan,2023-03-29,05:00:00,20,13,7,FMN 16 Noorderlaanbrug
676,Noorderlaan,2023-03-29,06:00:00,41,28,13,FMN 16 Noorderlaanbrug
676,Noorderlaan,2023-03-29,07:00:00,116,45,71,FMN 16 Noorderlaanbrug
676,Noorderlaan,2023-03-29,08:00:00,147,45,102,FMN 16 Noorderlaanbrug
676,Noorderlaan,2023-03-29,09:00:00,45,13,32,FMN 16 Noorderlaanbrug
676,Noorderlaan,2023-03-29,10:00:00,32,8,24,FMN 16 Noorderlaanbrug
676,Noorderlaan,2023-03-29,11:00:00,36,11,25,FMN 16 Noorderlaanbrug
676,Noorderlaan,2023-03-29,12:00:00,71,17,54,FMN 16 Noorderlaanbrug
676,Noorderlaan,2023-03-29,13:00:00,72,22,50,FMN 16 Noorderlaanbrug
676,Noorderlaan,2023-03-29,14:00:00,74,13,61,FMN 16 Noorderlaanbrug
676,Noorderlaan,2023-03-29,15:00:00,87,27,60,FMN 16 Noorderlaanbrug
676,Noorderlaan,2023-03-29,16:00:00,162,41,121,FMN 16 Noorderlaanbrug
676,Noorderlaan,2023-03-29,17:00:00,207,58,149,FMN 16 Noorderlaanbrug
676,Noorderlaan,2023-03-29,18:00:00,105,21,84,FMN 16 Noorderlaanbrug
676,Noorderlaan,2023-03-29,19:00:00,77,12,65,FMN 16 Noorderlaanbrug
676,Noorderlaan,2023-03-29,20:00:00,42,9,33,FMN 16 Noorderlaanbrug
676,Noorderlaan,2023-03-29,21:00:00,31,13,18,FMN 16 Noorderlaanbrug
676,Noorderlaan,2023-03-29,22:00:00,42,7,35,FMN 16 Noorderlaanbrug
676,Noorderlaan,2023-03-29,23:00:00,17,4,13,FMN 16 Noorderlaanbrug
676,Noorderlaan,2023-03-30,00:00:00,11,2,9,FMN 16 Noorderlaanbrug
676,Noorderlaan,2023-03-30,01:00:00,6,2,4,FMN 16 Noorderlaanbrug
676,Noorderlaan,2023-03-30,02:00:00,1,1,0,FMN 16 Noorderlaanbrug
676,Noorderlaan,2023-03-30,03:00:00,6,3,3,FMN 16 Noorderlaanbrug
676,Noorderlaan,2023-03-30,04:00:00,8,5,3,FMN 16 Noorderlaanbrug
676,Noorderlaan,2023-03-30,05:00:00,38,19,19,FMN 16 Noorderlaanbrug
676,Noorderlaan,2023-03-30,06:00:00,43,16,27,FMN 16 Noorderlaanbrug
676,Noorderlaan,2023-03-30,07:00:00,115,43,72,FMN 16 Noorderlaanbrug
676,Noorderlaan,2023-03-30,08:00:00,187,47,140,FMN 16 Noorderlaanbrug
676,Noorderlaan,2023-03-30,09:00:00,70,16,54,FMN 16 Noorderlaanbrug
676,Noorderlaan,2023-03-30,10:00:00,46,17,29,FMN 16 Noorderlaanbrug
676,Noorderlaan,2023-03-30,11:00:00,37,12,25,FMN 16 Noorderlaanbrug
676,Noorderlaan,2023-03-30,12:00:00,63,13,50,FMN 16 Noorderlaanbrug
676,Noorderlaan,2023-03-30,13:00:00,49,13,36,FMN 16 Noorderlaanbrug
676,Noorderlaan,2023-03-30,14:00:00,81,20,61,FMN 16 Noorderlaanbrug
676,Noorderlaan,2023-03-30,15:00:00,102,37,65,FMN 16 Noorderlaanbrug
676,Noorderlaan,2023-03-30,16:00:00,147,49,98,FMN 16 Noorderlaanbrug
676,Noorderlaan,2023-03-30,17:00:00,177,66,111,FMN 16 Noorderlaanbrug
676,Noorderlaan,2023-03-30,18:00:00,81,29,52,FMN 16 Noorderlaanbrug
676,Noorderlaan,2023-03-30,19:00:00,57,10,47,FMN 16 Noorderlaanbrug
676,Noorderlaan,2023-03-30,20:00:00,34,12,22,FMN 16 Noorderlaanbrug
676,Noorderlaan,2023-03-30,21:00:00,19,7,12,FMN 16 Noorderlaanbrug
676,Noorderlaan,2023-03-30,22:00:00,24,6,18,FMN 16 Noorderlaanbrug
676,Noorderlaan,2023-03-30,23:00:00,6,3,3,FMN 16 Noorderlaanbrug
676,Noorderlaan,2023-03-31,00:00:00,10,4,6,FMN 16 Noorderlaanbrug
676,Noorderlaan,2023-03-31,01:00:00,3,0,3,FMN 16 Noorderlaanbrug
676,Noorderlaan,2023-03-31,02:00:00,3,1,2,FMN 16 Noorderlaanbrug
676,Noorderlaan,2023-03-31,03:00:00,0,0,0,FMN 16 Noorderlaanbrug
676,Noorderlaan,2023-03-31,04:00:00,6,1,5,FMN 16 Noorderlaanbrug
676,Noorderlaan,2023-03-31,05:00:00,29,15,14,FMN 16 Noorderlaanbrug
676,Noorderlaan,2023-03-31,06:00:00,26,8,18,FMN 16 Noorderlaanbrug
676,Noorderlaan,2023-03-31,07:00:00,56,16,40,FMN 16 Noorderlaanbrug
676,Noorderlaan,2023-03-31,08:00:00,97,34,63,FMN 16 Noorderlaanbrug
676,Noorderlaan,2023-03-31,09:00:00,36,17,19,FMN 16 Noorderlaanbrug
676,Noorderlaan,2023-03-31,10:00:00,21,5,16,FMN 16 Noorderlaanbrug
676,Noorderlaan,2023-03-31,11:00:00,25,10,15,FMN 16 Noorderlaanbrug
676,Noorderlaan,2023-03-31,12:00:00,25,9,16,FMN 16 Noorderlaanbrug
676,Noorderlaan,2023-03-31,13:00:00,36,16,20,FMN 16 Noorderlaanbrug
676,Noorderlaan,2023-03-31,14:00:00,28,8,20,FMN 16 Noorderlaanbrug
676,Noorderlaan,2023-03-31,15:00:00,49,21,28,FMN 16 Noorderlaanbrug
676,Noorderlaan,2023-03-31,16:00:00,115,37,78,FMN 16 Noorderlaanbrug
676,Noorderlaan,2023-03-31,17:00:00,99,33,66,FMN 16 Noorderlaanbrug
676,Noorderlaan,2023-03-31,18:00:00,53,17,36,FMN 16 Noorderlaanbrug
676,Noorderlaan,2023-03-31,19:00:00,23,5,18,FMN 16 Noorderlaanbrug
676,Noorderlaan,2023-03-31,20:00:00,10,2,8,FMN 16 Noorderlaanbrug
676,Noorderlaan,2023-03-31,21:00:00,6,1,5,FMN 16 Noorderlaanbrug
676,Noorderlaan,2023-03-31,22:00:00,11,1,10,FMN 16 Noorderlaanbrug
676,Noorderlaan,2023-03-31,23:00:00,7,4,3,FMN 16 Noorderlaanbrug
676,Noorderlaan,2023-04-01,00:00:00,8,5,3,FMN 16 Noorderlaanbrug
676,Noorderlaan,2023-04-01,01:00:00,5,3,2,FMN 16 Noorderlaanbrug
676,Noorderlaan,2023-04-01,02:00:00,3,1,2,FMN 16 Noorderlaanbrug
676,Noorderlaan,2023-04-01,03:00:00,0,0,0,FMN 16 Noorderlaanbrug
676,Noorderlaan,2023-04-01,04:00:00,1,1,0,FMN 16 Noorderlaanbrug
676,Noorderlaan,2023-04-01,05:00:00,4,4,0,FMN 16 Noorderlaanbrug
676,Noorderlaan,2023-04-01,06:00:00,2,1,1,FMN 16 Noorderlaanbrug
676,Noorderlaan,2023-04-01,07:00:00,2,1,1,FMN 16 Noorderlaanbrug
676,Noorderlaan,2023-04-01,08:00:00,7,3,4,FMN 16 Noorderlaanbrug
676,Noorderlaan,2023-04-01,09:00:00,4,2,2,FMN 16 Noorderlaanbrug
676,Noorderlaan,2023-04-01,10:00:00,10,6,4,FMN 16 Noorderlaanbrug
676,Noorderlaan,2023-04-01,11:00:00,10,9,1,FMN 16 Noorderlaanbrug
676,Noorderlaan,2023-04-01,12:00:00,6,3,3,FMN 16 Noorderlaanbrug
676,Noorderlaan,2023-04-01,13:00:00,3,2,1,FMN 16 Noorderlaanbrug
676,Noorderlaan,2023-04-01,14:00:00,18,12,6,FMN 16 Noorderlaanbrug
676,Noorderlaan,2023-04-01,15:00:00,7,4,3,FMN 16 Noorderlaanbrug
676,Noorderlaan,2023-04-01,16:00:00,15,7,8,FMN 16 Noorderlaanbrug
676,Noorderlaan,2023-04-01,17:00:00,17,8,9,FMN 16 Noorderlaanbrug
676,Noorderlaan,2023-04-01,18:00:00,26,13,13,FMN 16 Noorderlaanbrug
676,Noorderlaan,2023-04-01,19:00:00,5,4,1,FMN 16 Noorderlaanbrug
676,Noorderlaan,2023-04-01,20:00:00,1,0,1,FMN 16 Noorderlaanbrug
676,Noorderlaan,2023-04-01,21:00:00,10,5,5,FMN 16 Noorderlaanbrug
676,Noorderlaan,2023-04-01,22:00:00,8,3,5,FMN 16 Noorderlaanbrug
676,Noorderlaan,2023-04-01,23:00:00,6,2,4,FMN 16 Noorderlaanbrug
676,Noorderlaan,2023-04-02,00:00:00,4,1,3,FMN 16 Noorderlaanbrug
676,Noorderlaan,2023-04-02,01:00:00,5,3,2,FMN 16 Noorderlaanbrug
676,Noorderlaan,2023-04-02,02:00:00,4,3,1,FMN 16 Noorderlaanbrug
676,Noorderlaan,2023-04-02,03:00:00,7,4,3,FMN 16 Noorderlaanbrug
676,Noorderlaan,2023-04-02,04:00:00,6,4,2,FMN 16 Noorderlaanbrug
676,Noorderlaan,2023-04-02,05:00:00,2,1,1,FMN 16 Noorderlaanbrug
676,Noorderlaan,2023-04-02,06:00:00,6,3,3,FMN 16 Noorderlaanbrug
676,Noorderlaan,2023-04-02,07:00:00,3,2,1,FMN 16 Noorderlaanbrug
676,Noorderlaan,2023-04-02,08:00:00,3,1,2,FMN 16 Noorderlaanbrug
676,Noorderlaan,2023-04-02,09:00:00,8,2,6,FMN 16 Noorderlaanbrug
676,Noorderlaan,2023-04-02,10:00:00,11,2,9,FMN 16 Noorderlaanbrug
676,Noorderlaan,2023-04-02,11:00:00,18,12,6,FMN 16 Noorderlaanbrug
676,Noorderlaan,2023-04-02,12:00:00,21,4,17,FMN 16 Noorderlaanbrug
676,Noorderlaan,2023-04-02,13:00:00,24,7,17,FMN 16 Noorderlaanbrug
676,Noorderlaan,2023-04-02,14:00:00,23,12,11,FMN 16 Noorderlaanbrug
676,Noorderlaan,2023-04-02,15:00:00,17,9,8,FMN 16 Noorderlaanbrug
676,Noorderlaan,2023-04-02,16:00:00,26,14,12,FMN 16 Noorderlaanbrug
676,Noorderlaan,2023-04-02,17:00:00,22,9,13,FMN 16 Noorderlaanbrug
676,Noorderlaan,2023-04-02,18:00:00,35,16,19,FMN 16 Noorderlaanbrug
676,Noorderlaan,2023-04-02,19:00:00,24,6,18,FMN 16 Noorderlaanbrug
676,Noorderlaan,2023-04-02,20:00:00,15,6,9,FMN 16 Noorderlaanbrug
676,Noorderlaan,2023-04-02,21:00:00,12,8,4,FMN 16 Noorderlaanbrug
676,Noorderlaan,2023-04-02,22:00:00,9,2,7,FMN 16 Noorderlaanbrug
676,Noorderlaan,2023-04-02,23:00:00,9,6,3,FMN 16 Noorderlaanbrug
676,Noorderlaan,2023-04-03,00:00:00,0,0,0,FMN 16 Noorderlaanbrug
676,Noorderlaan,2023-04-03,01:00:00,2,0,2,FMN 16 Noorderlaanbrug
676,Noorderlaan,2023-04-03,02:00:00,1,0,1,FMN 16 Noorderlaanbrug
676,Noorderlaan,2023-04-03,03:00:00,2,1,1,FMN 16 Noorderlaanbrug
676,Noorderlaan,2023-04-03,04:00:00,11,7,4,FMN 16 Noorderlaanbrug
676,Noorderlaan,2023-04-03,05:00:00,30,20,10,FMN 16 Noorderlaanbrug
676,Noorderlaan,2023-04-03,06:00:00,30,18,12,FMN 16 Noorderlaanbrug
676,Noorderlaan,2023-04-03,07:00:00,62,28,34,FMN 16 Noorderlaanbrug
676,Noorderlaan,2023-04-03,08:00:00,100,29,71,FMN 16 Noorderlaanbrug
676,Noorderlaan,2023-04-03,09:00:00,32,14,18,FMN 16 Noorderlaanbrug
676,Noorderlaan,2023-04-03,10:00:00,35,10,25,FMN 16 Noorderlaanbrug
676,Noorderlaan,2023-04-03,11:00:00,28,11,17,FMN 16 Noorderlaanbrug
676,Noorderlaan,2023-04-03,12:00:00,35,9,26,FMN 16 Noorderlaanbrug
676,Noorderlaan,2023-04-03,13:00:00,29,10,19,FMN 16 Noorderlaanbrug
676,Noorderlaan,2023-04-03,14:00:00,43,16,27,FMN 16 Noorderlaanbrug
676,Noorderlaan,2023-04-03,15:00:00,61,17,44,FMN 16 Noorderlaanbrug
676,Noorderlaan,2023-04-03,16:00:00,72,31,41,FMN 16 Noorderlaanbrug
676,Noorderlaan,2023-04-03,17:00:00,95,32,63,FMN 16 Noorderlaanbrug
676,Noorderlaan,2023-04-03,18:00:00,68,28,40,FMN 16 Noorderlaanbrug
676,Noorderlaan,2023-04-03,19:00:00,37,13,24,FMN 16 Noorderlaanbrug
676,Noorderlaan,2023-04-03,20:00:00,35,7,28,FMN 16 Noorderlaanbrug
676,Noorderlaan,2023-04-03,21:00:00,25,6,19,FMN 16 Noorderlaanbrug
676,Noorderlaan,2023-04-03,22:00:00,24,4,20,FMN 16 Noorderlaanbrug
676,Noorderlaan,2023-04-03,23:00:00,10,3,7,FMN 16 Noorderlaanbrug
676,Noorderlaan,2023-04-04,00:00:00,10,2,8,FMN 16 Noorderlaanbrug
676,Noorderlaan,2023-04-04,01:00:00,5,1,4,FMN 16 Noorderlaanbrug
676,Noorderlaan,2023-04-04,02:00:00,3,2,1,FMN 16 Noorderlaanbrug
676,Noorderlaan,2023-04-04,03:00:00,3,1,2,FMN 16 Noorderlaanbrug
676,Noorderlaan,2023-04-04,04:00:00,15,4,11,FMN 16 Noorderlaanbrug
676,Noorderlaan,2023-04-04,05:00:00,19,10,9,FMN 16 Noorderlaanbrug
676,Noorderlaan,2023-04-04,06:00:00,39,13,26,FMN 16 Noorderlaanbrug
676,Noorderlaan,2023-04-04,07:00:00,36,14,22,FMN 16 Noorderlaanbrug
676,Noorderlaan,2023-04-04,08:00:00,177,23,154,FMN 16 Noorderlaanbrug
676,Noorderlaan,2023-04-04,09:00:00,84,21,63,FMN 16 Noorderlaanbrug
676,Noorderlaan,2023-04-04,10:00:00,39,3,36,FMN 16 Noorderlaanbrug
676,Noorderlaan,2023-04-04,11:00:00,61,13,48,FMN 16 Noorderlaanbrug
676,Noorderlaan,2023-04-04,12:00:00,49,8,41,FMN 16 Noorderlaanbrug
676,Noorderlaan,2023-04-04,13:00:00,89,16,73,FMN 16 Noorderlaanbrug
676,Noorderlaan,2023-04-04,14:00:00,87,17,70,FMN 16 Noorderlaanbrug
676,Noorderlaan,2023-04-04,15:00:00,90,28,62,FMN 16 Noorderlaanbrug
676,Noorderlaan,2023-04-04,16:00:00,144,29,115,FMN 16 Noorderlaanbrug
676,Noorderlaan,2023-04-04,17:00:00,225,35,190,FMN 16 Noorderlaanbrug
676,Noorderlaan,2023-04-04,18:00:00,115,12,103,FMN 16 Noorderlaanbrug
676,Noorderlaan,2023-04-04,19:00:00,64,7,57,FMN 16 Noorderlaanbrug
676,Noorderlaan,2023-04-04,20:00:00,31,5,26,FMN 16 Noorderlaanbrug
676,Noorderlaan,2023-04-04,21:00:00,24,10,14,FMN 16 Noorderlaanbrug
676,Noorderlaan,2023-04-04,22:00:00,38,13,25,FMN 16 Noorderlaanbrug
676,Noorderlaan,2023-04-04,23:00:00,16,4,12,FMN 16 Noorderlaanbrug
676,Noorderlaan,2023-04-05,00:00:00,7,0,7,FMN 16 Noorderlaanbrug
676,Noorderlaan,2023-04-05,01:00:00,10,3,7,FMN 16 Noorderlaanbrug
676,Noorderlaan,2023-04-05,02:00:00,4,1,3,FMN 16 Noorderlaanbrug
676,Noorderlaan,2023-04-05,03:00:00,5,2,3,FMN 16 Noorderlaanbrug
676,Noorderlaan,2023-04-05,04:00:00,17,3,14,FMN 16 Noorderlaanbrug
676,Noorderlaan,2023-04-05,05:00:00,52,20,32,FMN 16 Noorderlaanbrug
676,Noorderlaan,2023-04-05,06:00:00,94,32,62,FMN 16 Noorderlaanbrug
676,Noorderlaan,2023-04-05,07:00:00,140,28,112,FMN 16 Noorderlaanbrug
676,Noorderlaan,2023-04-05,08:00:00,172,14,158,FMN 16 Noorderlaanbrug
676,Noorderlaan,2023-04-05,09:00:00,68,10,58,FMN 16 Noorderlaanbrug
676,Noorderlaan,2023-04-05,10:00:00,39,2,37,FMN 16 Noorderlaanbrug
676,Noorderlaan,2023-04-05,11:00:00,66,11,55,FMN 16 Noorderlaanbrug
676,Noorderlaan,2023-04-05,12:00:00,91,9,82,FMN 16 Noorderlaanbrug
676,Noorderlaan,2023-04-05,13:00:00,95,8,87,FMN 16 Noorderlaanbrug
676,Noorderlaan,2023-04-05,14:00:00,97,17,80,FMN 16 Noorderlaanbrug
676,Noorderlaan,2023-04-05,15:00:00,112,17,95,FMN 16 Noorderlaanbrug
676,Noorderlaan,2023-04-05,16:00:00,187,24,163,FMN 16 Noorderlaanbrug
676,Noorderlaan,2023-04-05,17:00:00,187,27,160,FMN 16 Noorderlaanbrug
676,Noorderlaan,2023-04-05,18:00:00,111,17,94,FMN 16 Noorderlaanbrug
676,Noorderlaan,2023-04-05,19:00:00,92,14,78,FMN 16 Noorderlaanbrug
676,Noorderlaan,2023-04-05,20:00:00,36,6,30,FMN 16 Noorderlaanbrug
676,Noorderlaan,2023-04-05,21:00:00,20,2,18,FMN 16 Noorderlaanbrug
676,Noorderlaan,2023-04-05,22:00:00,40,6,34,FMN 16 Noorderlaanbrug
676,Noorderlaan,2023-04-05,23:00:00,21,5,16,FMN 16 Noorderlaanbrug
676,Noorderlaan,2023-04-06,00:00:00,6,2,4,FMN 16 Noorderlaanbrug
676,Noorderlaan,2023-04-06,01:00:00,9,3,6,FMN 16 Noorderlaanbrug
676,Noorderlaan,2023-04-06,02:00:00,4,1,3,FMN 16 Noorderlaanbrug
676,Noorderlaan,2023-04-06,03:00:00,4,1,3,FMN 16 Noorderlaanbrug
676,Noorderlaan,2023-04-06,04:00:00,13,2,11,FMN 16 Noorderlaanbrug
676,Noorderlaan,2023-04-06,05:00:00,30,4,26,FMN 16 Noorderlaanbrug
676,Noorderlaan,2023-04-06,06:00:00,57,14,43,FMN 16 Noorderlaanbrug
676,Noorderlaan,2023-04-06,07:00:00,88,7,81,FMN 16 Noorderlaanbrug
676,Noorderlaan,2023-04-06,08:00:00,117,14,103,FMN 16 Noorderlaanbrug
676,Noorderlaan,2023-04-06,09:00:00,26,5,21,FMN 16 Noorderlaanbrug
676,Noorderlaan,2023-04-06,10:00:00,22,6,16,FMN 16 Noorderlaanbrug
676,Noorderlaan,2023-04-06,11:00:00,13,2,11,FMN 16 Noorderlaanbrug
676,Noorderlaan,2023-04-06,12:00:00,24,9,15,FMN 16 Noorderlaanbrug
676,Noorderlaan,2023-04-06,13:00:00,44,7,37,FMN 16 Noorderlaanbrug
676,Noorderlaan,2023-04-06,14:00:00,41,11,30,FMN 16 Noorderlaanbrug
676,Noorderlaan,2023-04-06,15:00:00,56,11,45,FMN 16 Noorderlaanbrug
676,Noorderlaan,2023-04-06,16:00:00,104,20,84,FMN 16 Noorderlaanbrug
676,Noorderlaan,2023-04-06,17:00:00,134,27,107,FMN 16 Noorderlaanbrug
676,Noorderlaan,2023-04-06,18:00:00,61,12,49,FMN 16 Noorderlaanbrug
676,Noorderlaan,2023-04-06,19:00:00,32,5,27,FMN 16 Noorderlaanbrug
676,Noorderlaan,2023-04-06,20:00:00,7,0,7,FMN 16 Noorderlaanbrug
676,Noorderlaan,2023-04-06,21:00:00,16,1,15,FMN 16 Noorderlaanbrug
676,Noorderlaan,2023-04-06,22:00:00,26,6,20,FMN 16 Noorderlaanbrug
676,Noorderlaan,2023-04-06,23:00:00,15,3,12,FMN 16 Noorderlaanbrug
676,Noorderlaan,2023-04-07,00:00:00,19,12,7,FMN 16 Noorderlaanbrug
676,Noorderlaan,2023-04-07,01:00:00,10,3,7,FMN 16 Noorderlaanbrug
676,Noorderlaan,2023-04-07,02:00:00,1,1,0,FMN 16 Noorderlaanbrug
676,Noorderlaan,2023-04-07,03:00:00,14,7,7,FMN 16 Noorderlaanbrug
676,Noorderlaan,2023-04-07,04:00:00,19,9,10,FMN 16 Noorderlaanbrug
676,Noorderlaan,2023-04-07,05:00:00,52,16,36,FMN 16 Noorderlaanbrug
676,Noorderlaan,2023-04-07,06:00:00,79,39,40,FMN 16 Noorderlaanbrug
676,Noorderlaan,2023-04-07,07:00:00,160,101,59,FMN 16 Noorderlaanbrug
676,Noorderlaan,2023-04-07,08:00:00,234,147,87,FMN 16 Noorderlaanbrug
676,Noorderlaan,2023-04-07,09:00:00,76,76,0,FMN 16 Noorderlaanbrug
676,Noorderlaan,2023-04-07,10:00:00,38,38,0,FMN 16 Noorderlaanbrug
676,Noorderlaan,2023-04-07,11:00:00,41,41,0,FMN 16 Noorderlaanbrug
676,Noorderlaan,2023-04-07,12:00:00,55,55,0,FMN 16 Noorderlaanbrug
676,Noorderlaan,2023-04-07,13:00:00,46,46,0,FMN 16 Noorderlaanbrug
676,Noorderlaan,2023-04-07,14:00:00,63,63,0,FMN 16 Noorderlaanbrug
676,Noorderlaan,2023-04-07,15:00:00,72,72,0,FMN 16 Noorderlaanbrug
676,Noorderlaan,2023-04-07,16:00:00,123,123,0,FMN 16 Noorderlaanbrug
676,Noorderlaan,2023-04-07,17:00:00,88,88,0,FMN 16 Noorderlaanbrug
676,Noorderlaan,2023-04-07,18:00:00,50,50,0,FMN 16 Noorderlaanbrug
676,Noorderlaan,2023-04-07,19:00:00,46,46,0,FMN 16 Noorderlaanbrug
676,Noorderlaan,2023-04-07,20:00:00,26,26,0,FMN 16 Noorderlaanbrug
676,Noorderlaan,2023-04-07,21:00:00,28,28,0,FMN 16 Noorderlaanbrug
676,Noorderlaan,2023-04-07,22:00:00,26,26,0,FMN 16 Noorderlaanbrug
676,Noorderlaan,2023-04-07,23:00:00,19,19,0,FMN 16 Noorderlaanbrug
676,Noorderlaan,2023-04-08,00:00:00,0,0,0,FMN 16 Noorderlaanbrug
676,Noorderlaan,2023-04-08,01:00:00,47,19,28,FMN 16 Noorderlaanbrug
676,Noorderlaan,2023-04-08,02:00:00,37,21,16,FMN 16 Noorderlaanbrug
676,Noorderlaan,2023-04-08,03:00:00,33,21,12,FMN 16 Noorderlaanbrug
676,Noorderlaan,2023-04-08,04:00:00,22,15,7,FMN 16 Noorderlaanbrug
676,Noorderlaan,2023-04-08,05:00:00,34,15,19,FMN 16 Noorderlaanbrug
676,Noorderlaan,2023-04-08,06:00:00,26,14,12,FMN 16 Noorderlaanbrug
676,Noorderlaan,2023-04-08,07:00:00,29,12,17,FMN 16 Noorderlaanbrug
676,Noorderlaan,2023-04-08,08:00:00,32,20,12,FMN 16 Noorderlaanbrug
676,Noorderlaan,2023-04-08,09:00:00,60,40,20,FMN 16 Noorderlaanbrug
676,Noorderlaan,2023-04-08,10:00:00,87,50,37,FMN 16 Noorderlaanbrug
676,Noorderlaan,2023-04-08,11:00:00,105,58,47,FMN 16 Noorderlaanbrug
676,Noorderlaan,2023-04-08,12:00:00,110,60,50,FMN 16 Noorderlaanbrug
676,Noorderlaan,2023-04-08,13:00:00,119,68,51,FMN 16 Noorderlaanbrug
676,Noorderlaan,2023-04-08,14:00:00,118,63,55,FMN 16 Noorderlaanbrug
676,Noorderlaan,2023-04-08,15:00:00,115,56,59,FMN 16 Noorderlaanbrug
676,Noorderlaan,2023-04-08,16:00:00,110,54,56,FMN 16 Noorderlaanbrug
676,Noorderlaan,2023-04-08,17:00:00,99,49,50,FMN 16 Noorderlaanbrug
676,Noorderlaan,2023-04-08,18:00:00,117,57,60,FMN 16 Noorderlaanbrug
676,Noorderlaan,2023-04-08,19:00:00,85,46,39,FMN 16 Noorderlaanbrug
676,Noorderlaan,2023-04-08,20:00:00,44,25,19,FMN 16 Noorderlaanbrug
676,Noorderlaan,2023-04-08,21:00:00,27,11,16,FMN 16 Noorderlaanbrug
676,Noorderlaan,2023-04-08,22:00:00,51,23,28,FMN 16 Noorderlaanbrug
676,Noorderlaan,2023-04-08,23:00:00,37,14,23,FMN 16 Noorderlaanbrug
676,Noorderlaan,2023-04-09,00:00:00,0,0,0,FMN 16 Noorderlaanbrug
676,Noorderlaan,2023-04-09,01:00:00,30,2,28,FMN 16 Noorderlaanbrug
676,Noorderlaan,2023-04-09,02:00:00,29,5,24,FMN 16 Noorderlaanbrug
676,Noorderlaan,2023-04-09,03:00:00,33,11,22,FMN 16 Noorderlaanbrug
676,Noorderlaan,2023-04-09,04:00:00,19,8,11,FMN 16 Noorderlaanbrug
676,Noorderlaan,2023-04-09,05:00:00,21,7,14,FMN 16 Noorderlaanbrug
676,Noorderlaan,2023-04-09,06:00:00,31,5,26,FMN 16 Noorderlaanbrug
676,Noorderlaan,2023-04-09,07:00:00,24,5,19,FMN 16 Noorderlaanbrug
676,Noorderlaan,2023-04-09,08:00:00,16,7,9,FMN 16 Noorderlaanbrug
676,Noorderlaan,2023-04-09,09:00:00,45,25,20,FMN 16 Noorderlaanbrug
676,Noorderlaan,2023-04-09,10:00:00,62,26,36,FMN 16 Noorderlaanbrug
676,Noorderlaan,2023-04-09,11:00:00,68,33,35,FMN 16 Noorderlaanbrug
676,Noorderlaan,2023-04-09,12:00:00,62,26,36,FMN 16 Noorderlaanbrug
676,Noorderlaan,2023-04-09,13:00:00,82,29,53,FMN 16 Noorderlaanbrug
676,Noorderlaan,2023-04-09,14:00:00,80,32,48,FMN 16 Noorderlaanbrug
676,Noorderlaan,2023-04-09,15:00:00,98,32,66,FMN 16 Noorderlaanbrug
676,Noorderlaan,2023-04-09,16:00:00,68,23,45,FMN 16 Noorderlaanbrug
676,Noorderlaan,2023-04-09,17:00:00,71,22,49,FMN 16 Noorderlaanbrug
676,Noorderlaan,2023-04-09,18:00:00,67,22,45,FMN 16 Noorderlaanbrug
676,Noorderlaan,2023-04-09,19:00:00,59,19,40,FMN 16 Noorderlaanbrug
676,Noorderlaan,2023-04-09,20:00:00,40,17,23,FMN 16 Noorderlaanbrug
676,Noorderlaan,2023-04-09,21:00:00,39,16,23,FMN 16 Noorderlaanbrug
676,Noorderlaan,2023-04-09,22:00:00,36,10,26,FMN 16 Noorderlaanbrug
676,Noorderlaan,2023-04-09,23:00:00,27,11,16,FMN 16 Noorderlaanbrug
676,Noorderlaan,2023-04-10,00:00:00,0,0,0,FMN 16 Noorderlaanbrug
676,Noorderlaan,2023-04-10,01:00:00,4,3,1,FMN 16 Noorderlaanbrug
676,Noorderlaan,2023-04-10,02:00:00,4,3,1,FMN 16 Noorderlaanbrug
676,Noorderlaan,2023-04-10,03:00:00,4,4,0,FMN 16 Noorderlaanbrug
676,Noorderlaan,2023-04-10,04:00:00,16,8,8,FMN 16 Noorderlaanbrug
676,Noorderlaan,2023-04-10,05:00:00,44,32,12,FMN 16 Noorderlaanbrug
676,Noorderlaan,2023-04-10,06:00:00,77,61,16,FMN 16 Noorderlaanbrug
676,Noorderlaan,2023-04-10,07:00:00,182,153,29,FMN 16 Noorderlaanbrug
676,Noorderlaan,2023-04-10,08:00:00,302,256,46,FMN 16 Noorderlaanbrug
676,Noorderlaan,2023-04-10,09:00:00,89,78,11,FMN 16 Noorderlaanbrug
676,Noorderlaan,2023-04-10,10:00:00,56,47,9,FMN 16 Noorderlaanbrug
676,Noorderlaan,2023-04-10,11:00:00,54,40,14,FMN 16 Noorderlaanbrug
676,Noorderlaan,2023-04-10,12:00:00,71,54,17,FMN 16 Noorderlaanbrug
676,Noorderlaan,2023-04-10,13:00:00,71,55,16,FMN 16 Noorderlaanbrug
676,Noorderlaan,2023-04-10,14:00:00,84,72,12,FMN 16 Noorderlaanbrug
676,Noorderlaan,2023-04-10,15:00:00,100,70,30,FMN 16 Noorderlaanbrug
676,Noorderlaan,2023-04-10,16:00:00,193,133,60,FMN 16 Noorderlaanbrug
676,Noorderlaan,2023-04-10,17:00:00,196,138,58,FMN 16 Noorderlaanbrug
676,Noorderlaan,2023-04-10,18:00:00,105,71,34,FMN 16 Noorderlaanbrug
676,Noorderlaan,2023-04-10,19:00:00,41,30,11,FMN 16 Noorderlaanbrug
676,Noorderlaan,2023-04-10,20:00:00,33,27,6,FMN 16 Noorderlaanbrug
676,Noorderlaan,2023-04-10,21:00:00,27,18,9,FMN 16 Noorderlaanbrug
676,Noorderlaan,2023-04-10,22:00:00,41,33,8,FMN 16 Noorderlaanbrug
676,Noorderlaan,2023-04-10,23:00:00,17,14,3,FMN 16 Noorderlaanbrug
676,Noorderlaan,2023-04-11,00:00:00,0,0,0,FMN 16 Noorderlaanbrug
676,Noorderlaan,2023-04-11,01:00:00,7,4,3,FMN 16 Noorderlaanbrug
676,Noorderlaan,2023-04-11,02:00:00,3,3,0,FMN 16 Noorderlaanbrug
676,Noorderlaan,2023-04-11,03:00:00,6,5,1,FMN 16 Noorderlaanbrug
676,Noorderlaan,2023-04-11,04:00:00,23,13,10,FMN 16 Noorderlaanbrug
676,Noorderlaan,2023-04-11,05:00:00,66,28,38,FMN 16 Noorderlaanbrug
676,Noorderlaan,2023-04-11,06:00:00,137,74,63,FMN 16 Noorderlaanbrug
676,Noorderlaan,2023-04-11,07:00:00,269,191,78,FMN 16 Noorderlaanbrug
676,Noorderlaan,2023-04-11,08:00:00,344,265,79,FMN 16 Noorderlaanbrug
676,Noorderlaan,2023-04-11,09:00:00,131,91,40,FMN 16 Noorderlaanbrug
676,Noorderlaan,2023-04-11,10:00:00,76,46,30,FMN 16 Noorderlaanbrug
676,Noorderlaan,2023-04-11,11:00:00,71,51,20,FMN 16 Noorderlaanbrug
676,Noorderlaan,2023-04-11,12:00:00,107,70,37,FMN 16 Noorderlaanbrug
676,Noorderlaan,2023-04-11,13:00:00,103,56,47,FMN 16 Noorderlaanbrug
676,Noorderlaan,2023-04-11,14:00:00,121,71,50,FMN 16 Noorderlaanbrug
676,Noorderlaan,2023-04-11,15:00:00,163,84,79,FMN 16 Noorderlaanbrug
676,Noorderlaan,2023-04-11,16:00:00,288,161,127,FMN 16 Noorderlaanbrug
676,Noorderlaan,2023-04-11,17:00:00,319,165,154,FMN 16 Noorderlaanbrug
676,Noorderlaan,2023-04-11,18:00:00,165,85,80,FMN 16 Noorderlaanbrug
676,Noorderlaan,2023-04-11,19:00:00,77,44,33,FMN 16 Noorderlaanbrug
676,Noorderlaan,2023-04-11,20:00:00,41,25,16,FMN 16 Noorderlaanbrug
676,Noorderlaan,2023-04-11,21:00:00,44,21,23,FMN 16 Noorderlaanbrug
676,Noorderlaan,2023-04-11,22:00:00,52,33,19,FMN 16 Noorderlaanbrug
676,Noorderlaan,2023-04-11,23:00:00,29,18,11,FMN 16 Noorderlaanbrug
676,Noorderlaan,2023-04-12,00:00:00,0,0,0,FMN 16 Noorderlaanbrug
676,Noorderlaan,2023-04-12,01:00:00,3,2,1,FMN 16 Noorderlaanbrug
676,Noorderlaan,2023-04-12,02:00:00,2,1,1,FMN 16 Noorderlaanbrug
676,Noorderlaan,2023-04-12,03:00:00,6,4,2,FMN 16 Noorderlaanbrug
676,Noorderlaan,2023-04-12,04:00:00,21,14,7,FMN 16 Noorderlaanbrug
676,Noorderlaan,2023-04-12,05:00:00,51,30,21,FMN 16 Noorderlaanbrug
676,Noorderlaan,2023-04-12,06:00:00,73,45,28,FMN 16 Noorderlaanbrug
676,Noorderlaan,2023-04-12,07:00:00,163,113,50,FMN 16 Noorderlaanbrug
676,Noorderlaan,2023-04-12,08:00:00,232,164,68,FMN 16 Noorderlaanbrug
676,Noorderlaan,2023-04-12,09:00:00,79,55,24,FMN 16 Noorderlaanbrug
676,Noorderlaan,2023-04-12,10:00:00,57,47,10,FMN 16 Noorderlaanbrug
676,Noorderlaan,2023-04-12,11:00:00,49,27,22,FMN 16 Noorderlaanbrug
676,Noorderlaan,2023-04-12,12:00:00,99,54,45,FMN 16 Noorderlaanbrug
676,Noorderlaan,2023-04-12,13:00:00,96,55,41,FMN 16 Noorderlaanbrug
676,Noorderlaan,2023-04-12,14:00:00,103,64,39,FMN 16 Noorderlaanbrug
676,Noorderlaan,2023-04-12,15:00:00,107,68,39,FMN 16 Noorderlaanbrug
676,Noorderlaan,2023-04-12,16:00:00,183,110,73,FMN 16 Noorderlaanbrug
676,Noorderlaan,2023-04-12,17:00:00,207,123,84,FMN 16 Noorderlaanbrug
676,Noorderlaan,2023-04-12,18:00:00,106,55,51,FMN 16 Noorderlaanbrug
676,Noorderlaan,2023-04-12,19:00:00,73,45,28,FMN 16 Noorderlaanbrug
676,Noorderlaan,2023-04-12,20:00:00,38,24,14,FMN 16 Noorderlaanbrug
676,Noorderlaan,2023-04-12,21:00:00,31,18,13,FMN 16 Noorderlaanbrug
676,Noorderlaan,2023-04-12,22:00:00,47,32,15,FMN 16 Noorderlaanbrug
676,Noorderlaan,2023-04-12,23:00:00,17,11,6,FMN 16 Noorderlaanbrug
676,Noorderlaan,2023-04-13,00:00:00,0,0,0,FMN 16 Noorderlaanbrug
676,Noorderlaan,2023-04-13,01:00:00,13,8,5,FMN 16 Noorderlaanbrug
676,Noorderlaan,2023-04-13,02:00:00,3,2,1,FMN 16 Noorderlaanbrug
676,Noorderlaan,2023-04-13,03:00:00,11,6,5,FMN 16 Noorderlaanbrug
676,Noorderlaan,2023-04-13,04:00:00,22,16,6,FMN 16 Noorderlaanbrug
676,Noorderlaan,2023-04-13,05:00:00,81,37,44,FMN 16 Noorderlaanbrug
676,Noorderlaan,2023-04-13,06:00:00,102,55,47,FMN 16 Noorderlaanbrug
676,Noorderlaan,2023-04-13,07:00:00,266,176,90,FMN 16 Noorderlaanbrug
676,Noorderlaan,2023-04-13,08:00:00,357,260,97,FMN 16 Noorderlaanbrug
676,Noorderlaan,2023-04-13,09:00:00,106,77,29,FMN 16 Noorderlaanbrug
676,Noorderlaan,2023-04-13,10:00:00,68,49,19,FMN 16 Noorderlaanbrug
676,Noorderlaan,2023-04-13,11:00:00,68,45,23,FMN 16 Noorderlaanbrug
676,Noorderlaan,2023-04-13,12:00:00,101,62,39,FMN 16 Noorderlaanbrug
676,Noorderlaan,2023-04-13,13:00:00,106,53,53,FMN 16 Noorderlaanbrug
676,Noorderlaan,2023-04-13,14:00:00,113,71,42,FMN 16 Noorderlaanbrug
676,Noorderlaan,2023-04-13,15:00:00,151,84,67,FMN 16 Noorderlaanbrug
676,Noorderlaan,2023-04-13,16:00:00,240,136,104,FMN 16 Noorderlaanbrug
676,Noorderlaan,2023-04-13,17:00:00,243,131,112,FMN 16 Noorderlaanbrug
676,Noorderlaan,2023-04-13,18:00:00,130,70,60,FMN 16 Noorderlaanbrug
676,Noorderlaan,2023-04-13,19:00:00,58,32,26,FMN 16 Noorderlaanbrug
676,Noorderlaan,2023-04-13,20:00:00,32,18,14,FMN 16 Noorderlaanbrug
676,Noorderlaan,2023-04-13,21:00:00,34,20,14,FMN 16 Noorderlaanbrug
676,Noorderlaan,2023-04-13,22:00:00,61,37,24,FMN 16 Noorderlaanbrug
676,Noorderlaan,2023-04-13,23:00:00,19,7,12,FMN 16 Noorderlaanbrug
676,Noorderlaan,2023-04-14,00:00:00,0,0,0,FMN 16 Noorderlaanbrug
676,Noorderlaan,2023-04-14,01:00:00,12,4,8,FMN 16 Noorderlaanbrug
676,Noorderlaan,2023-04-14,02:00:00,7,3,4,FMN 16 Noorderlaanbrug
676,Noorderlaan,2023-04-14,03:00:00,12,9,3,FMN 16 Noorderlaanbrug
676,Noorderlaan,2023-04-14,04:00:00,16,4,12,FMN 16 Noorderlaanbrug
676,Noorderlaan,2023-04-14,05:00:00,63,27,36,FMN 16 Noorderlaanbrug
676,Noorderlaan,2023-04-14,06:00:00,101,42,59,FMN 16 Noorderlaanbrug
676,Noorderlaan,2023-04-14,07:00:00,185,106,79,FMN 16 Noorderlaanbrug
676,Noorderlaan,2023-04-14,08:00:00,265,164,101,FMN 16 Noorderlaanbrug
676,Noorderlaan,2023-04-14,09:00:00,97,60,37,FMN 16 Noorderlaanbrug
676,Noorderlaan,2023-04-14,10:00:00,66,42,24,FMN 16 Noorderlaanbrug
676,Noorderlaan,2023-04-14,11:00:00,74,47,27,FMN 16 Noorderlaanbrug
676,Noorderlaan,2023-04-14,12:00:00,110,58,52,FMN 16 Noorderlaanbrug
676,Noorderlaan,2023-04-14,13:00:00,119,60,59,FMN 16 Noorderlaanbrug
676,Noorderlaan,2023-04-14,14:00:00,123,63,60,FMN 16 Noorderlaanbrug
676,Noorderlaan,2023-04-14,15:00:00,149,70,79,FMN 16 Noorderlaanbrug
676,Noorderlaan,2023-04-14,16:00:00,245,134,111,FMN 16 Noorderlaanbrug
676,Noorderlaan,2023-04-14,17:00:00,200,86,114,FMN 16 Noorderlaanbrug
676,Noorderlaan,2023-04-14,18:00:00,113,53,60,FMN 16 Noorderlaanbrug
676,Noorderlaan,2023-04-14,19:00:00,82,44,38,FMN 16 Noorderlaanbrug
676,Noorderlaan,2023-04-14,20:00:00,42,21,21,FMN 16 Noorderlaanbrug
676,Noorderlaan,2023-04-14,21:00:00,52,26,26,FMN 16 Noorderlaanbrug
676,Noorderlaan,2023-04-14,22:00:00,43,17,26,FMN 16 Noorderlaanbrug
676,Noorderlaan,2023-04-14,23:00:00,48,20,28,FMN 16 Noorderlaanbrug
676,Noorderlaan,2023-04-15,00:00:00,0,0,0,FMN 16 Noorderlaanbrug
676,Noorderlaan,2023-04-15,01:00:00,40,11,29,FMN 16 Noorderlaanbrug
676,Noorderlaan,2023-04-15,02:00:00,41,23,18,FMN 16 Noorderlaanbrug
676,Noorderlaan,2023-04-15,03:00:00,32,13,19,FMN 16 Noorderlaanbrug
676,Noorderlaan,2023-04-15,04:00:00,21,13,8,FMN 16 Noorderlaanbrug
676,Noorderlaan,2023-04-15,05:00:00,28,9,19,FMN 16 Noorderlaanbrug
676,Noorderlaan,2023-04-15,06:00:00,52,23,29,FMN 16 Noorderlaanbrug
676,Noorderlaan,2023-04-15,07:00:00,25,9,16,FMN 16 Noorderlaanbrug
676,Noorderlaan,2023-04-15,08:00:00,46,24,22,FMN 16 Noorderlaanbrug
676,Noorderlaan,2023-04-15,09:00:00,63,39,24,FMN 16 Noorderlaanbrug
676,Noorderlaan,2023-04-15,10:00:00,96,51,45,FMN 16 Noorderlaanbrug
676,Noorderlaan,2023-04-15,11:00:00,105,52,53,FMN 16 Noorderlaanbrug
676,Noorderlaan,2023-04-15,12:00:00,100,54,46,FMN 16 Noorderlaanbrug
676,Noorderlaan,2023-04-15,13:00:00,140,65,75,FMN 16 Noorderlaanbrug
676,Noorderlaan,2023-04-15,14:00:00,125,64,61,FMN 16 Noorderlaanbrug
676,Noorderlaan,2023-04-15,15:00:00,139,58,81,FMN 16 Noorderlaanbrug
676,Noorderlaan,2023-04-15,16:00:00,128,58,70,FMN 16 Noorderlaanbrug
676,Noorderlaan,2023-04-15,17:00:00,133,53,80,FMN 16 Noorderlaanbrug
676,Noorderlaan,2023-04-15,18:00:00,121,49,72,FMN 16 Noorderlaanbrug
676,Noorderlaan,2023-04-15,19:00:00,92,40,52,FMN 16 Noorderlaanbrug
676,Noorderlaan,2023-04-15,20:00:00,46,17,29,FMN 16 Noorderlaanbrug
676,Noorderlaan,2023-04-15,21:00:00,46,15,31,FMN 16 Noorderlaanbrug
676,Noorderlaan,2023-04-15,22:00:00,55,24,31,FMN 16 Noorderlaanbrug
676,Noorderlaan,2023-04-15,23:00:00,42,18,24,FMN 16 Noorderlaanbrug
676,Noorderlaan,2023-04-16,00:00:00,0,0,0,FMN 16 Noorderlaanbrug
676,Noorderlaan,2023-04-16,01:00:00,28,9,19,FMN 16 Noorderlaanbrug
676,Noorderlaan,2023-04-16,02:00:00,14,4,10,FMN 16 Noorderlaanbrug
676,Noorderlaan,2023-04-16,03:00:00,16,9,7,FMN 16 Noorderlaanbrug
676,Noorderlaan,2023-04-16,04:00:00,13,7,6,FMN 16 Noorderlaanbrug
676,Noorderlaan,2023-04-16,05:00:00,11,2,9,FMN 16 Noorderlaanbrug
676,Noorderlaan,2023-04-16,06:00:00,19,6,13,FMN 16 Noorderlaanbrug
676,Noorderlaan,2023-04-16,07:00:00,16,8,8,FMN 16 Noorderlaanbrug
676,Noorderlaan,2023-04-16,08:00:00,17,7,10,FMN 16 Noorderlaanbrug
676,Noorderlaan,2023-04-16,09:00:00,33,21,12,FMN 16 Noorderlaanbrug
676,Noorderlaan,2023-04-16,10:00:00,41,23,18,FMN 16 Noorderlaanbrug
676,Noorderlaan,2023-04-16,11:00:00,46,25,21,FMN 16 Noorderlaanbrug
676,Noorderlaan,2023-04-16,12:00:00,50,23,27,FMN 16 Noorderlaanbrug
676,Noorderlaan,2023-04-16,13:00:00,78,32,46,FMN 16 Noorderlaanbrug
676,Noorderlaan,2023-04-16,14:00:00,56,23,33,FMN 16 Noorderlaanbrug
676,Noorderlaan,2023-04-16,15:00:00,57,23,34,FMN 16 Noorderlaanbrug
676,Noorderlaan,2023-04-16,16:00:00,69,26,43,FMN 16 Noorderlaanbrug
676,Noorderlaan,2023-04-16,17:00:00,58,22,36,FMN 16 Noorderlaanbrug
676,Noorderlaan,2023-04-16,18:00:00,49,14,35,FMN 16 Noorderlaanbrug
676,Noorderlaan,2023-04-16,19:00:00,47,21,26,FMN 16 Noorderlaanbrug
676,Noorderlaan,2023-04-16,20:00:00,33,20,13,FMN 16 Noorderlaanbrug
676,Noorderlaan,2023-04-16,21:00:00,29,15,14,FMN 16 Noorderlaanbrug
676,Noorderlaan,2023-04-16,22:00:00,32,17,15,FMN 16 Noorderlaanbrug
676,Noorderlaan,2023-04-16,23:00:00,22,9,13,FMN 16 Noorderlaanbrug
676,Noorderlaan,2023-04-17,00:00:00,0,0,0,FMN 16 Noorderlaanbrug
676,Noorderlaan,2023-04-17,01:00:00,8,3,5,FMN 16 Noorderlaanbrug
676,Noorderlaan,2023-04-17,02:00:00,4,2,2,FMN 16 Noorderlaanbrug
676,Noorderlaan,2023-04-17,03:00:00,7,4,3,FMN 16 Noorderlaanbrug
676,Noorderlaan,2023-04-17,04:00:00,23,9,14,FMN 16 Noorderlaanbrug
676,Noorderlaan,2023-04-17,05:00:00,93,43,50,FMN 16 Noorderlaanbrug
676,Noorderlaan,2023-04-17,06:00:00,126,63,63,FMN 16 Noorderlaanbrug
676,Noorderlaan,2023-04-17,07:00:00,283,169,114,FMN 16 Noorderlaanbrug
676,Noorderlaan,2023-04-17,08:00:00,394,257,137,FMN 16 Noorderlaanbrug
676,Noorderlaan,2023-04-17,09:00:00,124,80,44,FMN 16 Noorderlaanbrug
676,Noorderlaan,2023-04-17,10:00:00,94,55,39,FMN 16 Noorderlaanbrug
676,Noorderlaan,2023-04-17,11:00:00,72,41,31,FMN 16 Noorderlaanbrug
676,Noorderlaan,2023-04-17,12:00:00,121,64,57,FMN 16 Noorderlaanbrug
676,Noorderlaan,2023-04-17,13:00:00,143,55,88,FMN 16 Noorderlaanbrug
676,Noorderlaan,2023-04-17,14:00:00,155,80,75,FMN 16 Noorderlaanbrug
676,Noorderlaan,2023-04-17,15:00:00,203,79,124,FMN 16 Noorderlaanbrug
676,Noorderlaan,2023-04-17,16:00:00,347,138,209,FMN 16 Noorderlaanbrug
676,Noorderlaan,2023-04-17,17:00:00,383,155,228,FMN 16 Noorderlaanbrug
676,Noorderlaan,2023-04-17,18:00:00,185,66,119,FMN 16 Noorderlaanbrug
676,Noorderlaan,2023-04-17,19:00:00,77,36,41,FMN 16 Noorderlaanbrug
676,Noorderlaan,2023-04-17,20:00:00,52,23,29,FMN 16 Noorderlaanbrug
676,Noorderlaan,2023-04-17,21:00:00,52,23,29,FMN 16 Noorderlaanbrug
676,Noorderlaan,2023-04-17,22:00:00,71,40,31,FMN 16 Noorderlaanbrug
676,Noorderlaan,2023-04-17,23:00:00,22,14,8,FMN 16 Noorderlaanbrug
676,Noorderlaan,2023-04-18,00:00:00,0,0,0,FMN 16 Noorderlaanbrug
676,Noorderlaan,2023-04-18,01:00:00,12,7,5,FMN 16 Noorderlaanbrug
676,Noorderlaan,2023-04-18,02:00:00,0,0,0,FMN 16 Noorderlaanbrug
676,Noorderlaan,2023-04-18,03:00:00,8,5,3,FMN 16 Noorderlaanbrug
676,Noorderlaan,2023-04-18,04:00:00,28,12,16,FMN 16 Noorderlaanbrug
676,Noorderlaan,2023-04-18,05:00:00,83,27,56,FMN 16 Noorderlaanbrug
676,Noorderlaan,2023-04-18,06:00:00,131,62,69,FMN 16 Noorderlaanbrug
676,Noorderlaan,2023-04-18,07:00:00,302,183,119,FMN 16 Noorderlaanbrug
676,Noorderlaan,2023-04-18,08:00:00,399,240,159,FMN 16 Noorderlaanbrug
676,Noorderlaan,2023-04-18,09:00:00,117,72,45,FMN 16 Noorderlaanbrug
676,Noorderlaan,2023-04-18,10:00:00,83,48,35,FMN 16 Noorderlaanbrug
676,Noorderlaan,2023-04-18,11:00:00,92,42,50,FMN 16 Noorderlaanbrug
676,Noorderlaan,2023-04-18,12:00:00,139,62,77,FMN 16 Noorderlaanbrug
676,Noorderlaan,2023-04-18,13:00:00,140,51,89,FMN 16 Noorderlaanbrug
676,Noorderlaan,2023-04-18,14:00:00,153,80,73,FMN 16 Noorderlaanbrug
676,Noorderlaan,2023-04-18,15:00:00,193,78,115,FMN 16 Noorderlaanbrug
676,Noorderlaan,2023-04-18,16:00:00,370,153,217,FMN 16 Noorderlaanbrug
676,Noorderlaan,2023-04-18,17:00:00,383,141,242,FMN 16 Noorderlaanbrug
676,Noorderlaan,2023-04-18,18:00:00,218,78,140,FMN 16 Noorderlaanbrug
676,Noorderlaan,2023-04-18,19:00:00,89,40,49,FMN 16 Noorderlaanbrug
676,Noorderlaan,2023-04-18,20:00:00,72,32,40,FMN 16 Noorderlaanbrug
676,Noorderlaan,2023-04-18,21:00:00,47,16,31,FMN 16 Noorderlaanbrug
676,Noorderlaan,2023-04-18,22:00:00,83,40,43,FMN 16 Noorderlaanbrug
676,Noorderlaan,2023-04-18,23:00:00,27,21,6,FMN 16 Noorderlaanbrug
676,Noorderlaan,2023-04-19,00:00:00,0,0,0,FMN 16 Noorderlaanbrug
676,Noorderlaan,2023-04-19,01:00:00,13,7,6,FMN 16 Noorderlaanbrug
676,Noorderlaan,2023-04-19,02:00:00,9,2,7,FMN 16 Noorderlaanbrug
676,Noorderlaan,2023-04-19,03:00:00,5,3,2,FMN 16 Noorderlaanbrug
676,Noorderlaan,2023-04-19,04:00:00,35,7,28,FMN 16 Noorderlaanbrug
676,Noorderlaan,2023-04-19,05:00:00,77,26,51,FMN 16 Noorderlaanbrug
676,Noorderlaan,2023-04-19,06:00:00,118,52,66,FMN 16 Noorderlaanbrug
676,Noorderlaan,2023-04-19,07:00:00,235,119,116,FMN 16 Noorderlaanbrug
676,Noorderlaan,2023-04-19,08:00:00,312,158,154,FMN 16 Noorderlaanbrug
676,Noorderlaan,2023-04-19,09:00:00,127,64,63,FMN 16 Noorderlaanbrug
676,Noorderlaan,2023-04-19,10:00:00,72,40,32,FMN 16 Noorderlaanbrug
676,Noorderlaan,2023-04-19,11:00:00,93,45,48,FMN 16 Noorderlaanbrug
676,Noorderlaan,2023-04-19,12:00:00,179,66,113,FMN 16 Noorderlaanbrug
676,Noorderlaan,2023-04-19,13:00:00,166,65,101,FMN 16 Noorderlaanbrug
676,Noorderlaan,2023-04-19,14:00:00,144,71,73,FMN 16 Noorderlaanbrug
676,Noorderlaan,2023-04-19,15:00:00,170,75,95,FMN 16 Noorderlaanbrug
676,Noorderlaan,2023-04-19,16:00:00,283,121,162,FMN 16 Noorderlaanbrug
676,Noorderlaan,2023-04-19,17:00:00,344,127,217,FMN 16 Noorderlaanbrug
676,Noorderlaan,2023-04-19,18:00:00,197,68,129,FMN 16 Noorderlaanbrug
676,Noorderlaan,2023-04-19,19:00:00,119,48,71,FMN 16 Noorderlaanbrug
676,Noorderlaan,2023-04-19,20:00:00,55,26,29,FMN 16 Noorderlaanbrug
676,Noorderlaan,2023-04-19,21:00:00,62,24,38,FMN 16 Noorderlaanbrug
676,Noorderlaan,2023-04-19,22:00:00,66,34,32,FMN 16 Noorderlaanbrug
676,Noorderlaan,2023-04-19,23:00:00,30,7,23,FMN 16 Noorderlaanbrug
676,Noorderlaan,2023-04-20,00:00:00,0,0,0,FMN 16 Noorderlaanbrug
676,Noorderlaan,2023-04-20,01:00:00,11,6,5,FMN 16 Noorderlaanbrug
676,Noorderlaan,2023-04-20,02:00:00,10,3,7,FMN 16 Noorderlaanbrug
676,Noorderlaan,2023-04-20,03:00:00,18,11,7,FMN 16 Noorderlaanbrug
676,Noorderlaan,2023-04-20,04:00:00,22,12,10,FMN 16 Noorderlaanbrug
676,Noorderlaan,2023-04-20,05:00:00,77,33,44,FMN 16 Noorderlaanbrug
676,Noorderlaan,2023-04-20,06:00:00,122,57,65,FMN 16 Noorderlaanbrug
676,Noorderlaan,2023-04-20,07:00:00,287,168,119,FMN 16 Noorderlaanbrug
676,Noorderlaan,2023-04-20,08:00:00,391,246,145,FMN 16 Noorderlaanbrug
676,Noorderlaan,2023-04-20,09:00:00,110,56,54,FMN 16 Noorderlaanbrug
676,Noorderlaan,2023-04-20,10:00:00,81,44,37,FMN 16 Noorderlaanbrug
676,Noorderlaan,2023-04-20,11:00:00,69,31,38,FMN 16 Noorderlaanbrug
676,Noorderlaan,2023-04-20,12:00:00,116,58,58,FMN 16 Noorderlaanbrug
676,Noorderlaan,2023-04-20,13:00:00,113,55,58,FMN 16 Noorderlaanbrug
676,Noorderlaan,2023-04-20,14:00:00,121,64,57,FMN 16 Noorderlaanbrug
676,Noorderlaan,2023-04-20,15:00:00,174,72,102,FMN 16 Noorderlaanbrug
676,Noorderlaan,2023-04-20,16:00:00,293,117,176,FMN 16 Noorderlaanbrug
676,Noorderlaan,2023-04-20,17:00:00,287,129,158,FMN 16 Noorderlaanbrug
676,Noorderlaan,2023-04-20,18:00:00,149,58,91,FMN 16 Noorderlaanbrug
676,Noorderlaan,2023-04-20,19:00:00,73,32,41,FMN 16 Noorderlaanbrug
676,Noorderlaan,2023-04-20,20:00:00,54,24,30,FMN 16 Noorderlaanbrug
676,Noorderlaan,2023-04-20,21:00:00,43,17,26,FMN 16 Noorderlaanbrug
676,Noorderlaan,2023-04-20,22:00:00,52,26,26,FMN 16 Noorderlaanbrug
676,Noorderlaan,2023-04-20,23:00:00,29,17,12,FMN 16 Noorderlaanbrug
676,Noorderlaan,2023-04-21,00:00:00,0,0,0,FMN 16 Noorderlaanbrug
676,Noorderlaan,2023-04-21,01:00:00,12,4,8,FMN 16 Noorderlaanbrug
676,Noorderlaan,2023-04-21,02:00:00,10,4,6,FMN 16 Noorderlaanbrug
676,Noorderlaan,2023-04-21,03:00:00,17,11,6,FMN 16 Noorderlaanbrug
676,Noorderlaan,2023-04-21,04:00:00,19,8,11,FMN 16 Noorderlaanbrug
676,Noorderlaan,2023-04-21,05:00:00,88,32,56,FMN 16 Noorderlaanbrug
676,Noorderlaan,2023-04-21,06:00:00,116,48,68,FMN 16 Noorderlaanbrug
676,Noorderlaan,2023-04-21,07:00:00,219,107,112,FMN 16 Noorderlaanbrug
676,Noorderlaan,2023-04-21,08:00:00,314,179,135,FMN 16 Noorderlaanbrug
676,Noorderlaan,2023-04-21,09:00:00,116,75,41,FMN 16 Noorderlaanbrug
676,Noorderlaan,2023-04-21,10:00:00,103,53,50,FMN 16 Noorderlaanbrug
676,Noorderlaan,2023-04-21,11:00:00,91,44,47,FMN 16 Noorderlaanbrug
676,Noorderlaan,2023-04-21,12:00:00,120,61,59,FMN 16 Noorderlaanbrug
676,Noorderlaan,2023-04-21,13:00:00,133,55,78,FMN 16 Noorderlaanbrug
676,Noorderlaan,2023-04-21,14:00:00,125,58,67,FMN 16 Noorderlaanbrug
676,Noorderlaan,2023-04-21,15:00:00,184,77,107,FMN 16 Noorderlaanbrug
676,Noorderlaan,2023-04-21,16:00:00,305,129,176,FMN 16 Noorderlaanbrug
676,Noorderlaan,2023-04-21,17:00:00,267,110,157,FMN 16 Noorderlaanbrug
676,Noorderlaan,2023-04-21,18:00:00,160,65,95,FMN 16 Noorderlaanbrug
676,Noorderlaan,2023-04-21,19:00:00,96,46,50,FMN 16 Noorderlaanbrug
676,Noorderlaan,2023-04-21,20:00:00,62,29,33,FMN 16 Noorderlaanbrug
676,Noorderlaan,2023-04-21,21:00:00,60,25,35,FMN 16 Noorderlaanbrug
676,Noorderlaan,2023-04-21,22:00:00,73,29,44,FMN 16 Noorderlaanbrug
676,Noorderlaan,2023-04-21,23:00:00,58,20,38,FMN 16 Noorderlaanbrug
676,Noorderlaan,2023-04-22,00:00:00,0,0,0,FMN 16 Noorderlaanbrug
676,Noorderlaan,2023-04-22,01:00:00,38,16,22,FMN 16 Noorderlaanbrug
676,Noorderlaan,2023-04-22,02:00:00,22,11,11,FMN 16 Noorderlaanbrug
676,Noorderlaan,2023-04-22,03:00:00,21,13,8,FMN 16 Noorderlaanbrug
676,Noorderlaan,2023-04-22,04:00:00,21,10,11,FMN 16 Noorderlaanbrug
676,Noorderlaan,2023-04-22,05:00:00,24,10,14,FMN 16 Noorderlaanbrug
676,Noorderlaan,2023-04-22,06:00:00,25,10,15,FMN 16 Noorderlaanbrug
676,Noorderlaan,2023-04-22,07:00:00,16,9,7,FMN 16 Noorderlaanbrug
676,Noorderlaan,2023-04-22,08:00:00,34,22,12,FMN 16 Noorderlaanbrug
676,Noorderlaan,2023-04-22,09:00:00,53,31,22,FMN 16 Noorderlaanbrug
676,Noorderlaan,2023-04-22,10:00:00,67,39,28,FMN 16 Noorderlaanbrug
676,Noorderlaan,2023-04-22,11:00:00,81,51,30,FMN 16 Noorderlaanbrug
676,Noorderlaan,2023-04-22,12:00:00,80,55,25,FMN 16 Noorderlaanbrug
676,Noorderlaan,2023-04-22,13:00:00,95,62,33,FMN 16 Noorderlaanbrug
676,Noorderlaan,2023-04-22,14:00:00,89,49,40,FMN 16 Noorderlaanbrug
676,Noorderlaan,2023-04-22,15:00:00,101,60,41,FMN 16 Noorderlaanbrug
676,Noorderlaan,2023-04-22,16:00:00,90,48,42,FMN 16 Noorderlaanbrug
676,Noorderlaan,2023-04-22,17:00:00,83,41,42,FMN 16 Noorderlaanbrug
676,Noorderlaan,2023-04-22,18:00:00,87,46,41,FMN 16 Noorderlaanbrug
676,Noorderlaan,2023-04-22,19:00:00,54,34,20,FMN 16 Noorderlaanbrug
676,Noorderlaan,2023-04-22,20:00:00,36,24,12,FMN 16 Noorderlaanbrug
676,Noorderlaan,2023-04-22,21:00:00,40,23,17,FMN 16 Noorderlaanbrug
676,Noorderlaan,2023-04-22,22:00:00,38,22,16,FMN 16 Noorderlaanbrug
676,Noorderlaan,2023-04-22,23:00:00,33,25,8,FMN 16 Noorderlaanbrug
676,Noorderlaan,2023-04-23,00:00:00,0,0,0,FMN 16 Noorderlaanbrug
676,Noorderlaan,2023-04-23,01:00:00,46,8,38,FMN 16 Noorderlaanbrug
676,Noorderlaan,2023-04-23,02:00:00,41,14,27,FMN 16 Noorderlaanbrug
676,Noorderlaan,2023-04-23,03:00:00,31,11,20,FMN 16 Noorderlaanbrug
676,Noorderlaan,2023-04-23,04:00:00,23,8,15,FMN 16 Noorderlaanbrug
676,Noorderlaan,2023-04-23,05:00:00,31,13,18,FMN 16 Noorderlaanbrug
676,Noorderlaan,2023-04-23,06:00:00,33,5,28,FMN 16 Noorderlaanbrug
676,Noorderlaan,2023-04-23,07:00:00,23,8,15,FMN 16 Noorderlaanbrug
676,Noorderlaan,2023-04-23,08:00:00,21,10,11,FMN 16 Noorderlaanbrug
676,Noorderlaan,2023-04-23,09:00:00,46,21,25,FMN 16 Noorderlaanbrug
676,Noorderlaan,2023-04-23,10:00:00,47,25,22,FMN 16 Noorderlaanbrug
676,Noorderlaan,2023-04-23,11:00:00,67,29,38,FMN 16 Noorderlaanbrug
676,Noorderlaan,2023-04-23,12:00:00,72,26,46,FMN 16 Noorderlaanbrug
676,Noorderlaan,2023-04-23,13:00:00,102,33,69,FMN 16 Noorderlaanbrug
676,Noorderlaan,2023-04-23,14:00:00,97,38,59,FMN 16 Noorderlaanbrug
676,Noorderlaan,2023-04-23,15:00:00,95,26,69,FMN 16 Noorderlaanbrug
676,Noorderlaan,2023-04-23,16:00:00,81,26,55,FMN 16 Noorderlaanbrug
676,Noorderlaan,2023-04-23,17:00:00,88,25,63,FMN 16 Noorderlaanbrug
676,Noorderlaan,2023-04-23,18:00:00,87,22,65,FMN 16 Noorderlaanbrug
676,Noorderlaan,2023-04-23,19:00:00,73,23,50,FMN 16 Noorderlaanbrug
676,Noorderlaan,2023-04-23,20:00:00,46,16,30,FMN 16 Noorderlaanbrug
676,Noorderlaan,2023-04-23,21:00:00,30,8,22,FMN 16 Noorderlaanbrug
676,Noorderlaan,2023-04-23,22:00:00,28,8,20,FMN 16 Noorderlaanbrug
676,Noorderlaan,2023-04-23,23:00:00,18,5,13,FMN 16 Noorderlaanbrug
676,Noorderlaan,2023-04-24,00:00:00,7,5,2,FMN 16 Noorderlaanbrug
676,Noorderlaan,2023-04-24,01:00:00,4,1,3,FMN 16 Noorderlaanbrug
676,Noorderlaan,2023-04-24,02:00:00,2,0,2,FMN 16 Noorderlaanbrug
676,Noorderlaan,2023-04-24,03:00:00,6,4,2,FMN 16 Noorderlaanbrug
676,Noorderlaan,2023-04-24,04:00:00,12,5,7,FMN 16 Noorderlaanbrug
676,Noorderlaan,2023-04-24,05:00:00,69,27,42,FMN 16 Noorderlaanbrug
676,Noorderlaan,2023-04-24,06:00:00,108,67,41,FMN 16 Noorderlaanbrug
676,Noorderlaan,2023-04-24,07:00:00,236,147,89,FMN 16 Noorderlaanbrug
676,Noorderlaan,2023-04-24,08:00:00,348,247,101,FMN 16 Noorderlaanbrug
676,Noorderlaan,2023-04-24,09:00:00,103,69,34,FMN 16 Noorderlaanbrug
676,Noorderlaan,2023-04-24,10:00:00,84,52,32,FMN 16 Noorderlaanbrug
676,Noorderlaan,2023-04-24,11:00:00,55,35,20,FMN 16 Noorderlaanbrug
676,Noorderlaan,2023-04-24,12:00:00,93,58,35,FMN 16 Noorderlaanbrug
676,Noorderlaan,2023-04-24,13:00:00,125,60,65,FMN 16 Noorderlaanbrug
676,Noorderlaan,2023-04-24,14:00:00,118,71,47,FMN 16 Noorderlaanbrug
676,Noorderlaan,2023-04-24,15:00:00,154,73,81,FMN 16 Noorderlaanbrug
676,Noorderlaan,2023-04-24,16:00:00,276,134,142,FMN 16 Noorderlaanbrug
676,Noorderlaan,2023-04-24,17:00:00,291,132,159,FMN 16 Noorderlaanbrug
676,Noorderlaan,2023-04-24,18:00:00,142,59,83,FMN 16 Noorderlaanbrug
676,Noorderlaan,2023-04-24,19:00:00,56,29,27,FMN 16 Noorderlaanbrug
676,Noorderlaan,2023-04-24,20:00:00,50,26,24,FMN 16 Noorderlaanbrug
676,Noorderlaan,2023-04-24,21:00:00,39,18,21,FMN 16 Noorderlaanbrug
676,Noorderlaan,2023-04-24,22:00:00,46,27,19,FMN 16 Noorderlaanbrug
676,Noorderlaan,2023-04-24,23:00:00,23,12,11,FMN 16 Noorderlaanbrug
676,Noorderlaan,2023-04-25,00:00:00,8,5,3,FMN 16 Noorderlaanbrug
676,Noorderlaan,2023-04-25,01:00:00,6,3,3,FMN 16 Noorderlaanbrug
676,Noorderlaan,2023-04-25,02:00:00,5,1,4,FMN 16 Noorderlaanbrug
676,Noorderlaan,2023-04-25,03:00:00,12,7,5,FMN 16 Noorderlaanbrug
676,Noorderlaan,2023-04-25,04:00:00,30,17,13,FMN 16 Noorderlaanbrug
676,Noorderlaan,2023-04-25,05:00:00,68,27,41,FMN 16 Noorderlaanbrug
676,Noorderlaan,2023-04-25,06:00:00,148,77,71,FMN 16 Noorderlaanbrug
676,Noorderlaan,2023-04-25,07:00:00,320,196,124,FMN 16 Noorderlaanbrug
676,Noorderlaan,2023-04-25,08:00:00,401,267,134,FMN 16 Noorderlaanbrug
676,Noorderlaan,2023-04-25,09:00:00,121,80,41,FMN 16 Noorderlaanbrug
676,Noorderlaan,2023-04-25,10:00:00,85,52,33,FMN 16 Noorderlaanbrug
676,Noorderlaan,2023-04-25,11:00:00,87,42,45,FMN 16 Noorderlaanbrug
676,Noorderlaan,2023-04-25,12:00:00,129,60,69,FMN 16 Noorderlaanbrug
676,Noorderlaan,2023-04-25,13:00:00,134,53,81,FMN 16 Noorderlaanbrug
676,Noorderlaan,2023-04-25,14:00:00,152,79,73,FMN 16 Noorderlaanbrug
676,Noorderlaan,2023-04-25,15:00:00,200,89,111,FMN 16 Noorderlaanbrug
676,Noorderlaan,2023-04-25,16:00:00,363,163,200,FMN 16 Noorderlaanbrug
676,Noorderlaan,2023-04-25,17:00:00,417,181,236,FMN 16 Noorderlaanbrug
676,Noorderlaan,2023-04-25,18:00:00,235,90,145,FMN 16 Noorderlaanbrug
676,Noorderlaan,2023-04-25,19:00:00,98,47,51,FMN 16 Noorderlaanbrug
676,Noorderlaan,2023-04-25,20:00:00,54,30,24,FMN 16 Noorderlaanbrug
676,Noorderlaan,2023-04-25,21:00:00,70,39,31,FMN 16 Noorderlaanbrug
676,Noorderlaan,2023-04-25,22:00:00,62,37,25,FMN 16 Noorderlaanbrug
676,Noorderlaan,2023-04-25,23:00:00,30,14,16,FMN 16 Noorderlaanbrug
676,Noorderlaan,2023-04-26,00:00:00,6,0,6,FMN 16 Noorderlaanbrug
676,Noorderlaan,2023-04-26,01:00:00,9,1,8,FMN 16 Noorderlaanbrug
676,Noorderlaan,2023-04-26,02:00:00,5,4,1,FMN 16 Noorderlaanbrug
676,Noorderlaan,2023-04-26,03:00:00,6,3,3,FMN 16 Noorderlaanbrug
676,Noorderlaan,2023-04-26,04:00:00,28,14,14,FMN 16 Noorderlaanbrug
676,Noorderlaan,2023-04-26,05:00:00,76,31,45,FMN 16 Noorderlaanbrug
676,Noorderlaan,2023-04-26,06:00:00,112,47,65,FMN 16 Noorderlaanbrug
676,Noorderlaan,2023-04-26,07:00:00,225,110,115,FMN 16 Noorderlaanbrug
676,Noorderlaan,2023-04-26,08:00:00,282,144,138,FMN 16 Noorderlaanbrug
676,Noorderlaan,2023-04-26,09:00:00,92,44,48,FMN 16 Noorderlaanbrug
676,Noorderlaan,2023-04-26,10:00:00,77,42,35,FMN 16 Noorderlaanbrug
676,Noorderlaan,2023-04-26,11:00:00,77,33,44,FMN 16 Noorderlaanbrug
676,Noorderlaan,2023-04-26,12:00:00,179,69,110,FMN 16 Noorderlaanbrug
676,Noorderlaan,2023-04-26,13:00:00,164,69,95,FMN 16 Noorderlaanbrug
676,Noorderlaan,2023-04-26,14:00:00,134,65,69,FMN 16 Noorderlaanbrug
676,Noorderlaan,2023-04-26,15:00:00,164,71,93,FMN 16 Noorderlaanbrug
676,Noorderlaan,2023-04-26,16:00:00,268,122,146,FMN 16 Noorderlaanbrug
676,Noorderlaan,2023-04-26,17:00:00,312,115,197,FMN 16 Noorderlaanbrug
676,Noorderlaan,2023-04-26,18:00:00,151,53,98,FMN 16 Noorderlaanbrug
676,Noorderlaan,2023-04-26,19:00:00,90,32,58,FMN 16 Noorderlaanbrug
676,Noorderlaan,2023-04-26,20:00:00,51,15,36,FMN 16 Noorderlaanbrug
676,Noorderlaan,2023-04-26,21:00:00,45,15,30,FMN 16 Noorderlaanbrug
676,Noorderlaan,2023-04-26,22:00:00,55,21,34,FMN 16 Noorderlaanbrug
676,Noorderlaan,2023-04-26,23:00:00,28,7,21,FMN 16 Noorderlaanbrug
676,Noorderlaan,2023-04-27,00:00:00,18,6,12,FMN 16 Noorderlaanbrug
676,Noorderlaan,2023-04-27,01:00:00,18,4,14,FMN 16 Noorderlaanbrug
676,Noorderlaan,2023-04-27,02:00:00,14,6,8,FMN 16 Noorderlaanbrug
676,Noorderlaan,2023-04-27,03:00:00,13,10,3,FMN 16 Noorderlaanbrug
676,Noorderlaan,2023-04-27,04:00:00,34,20,14,FMN 16 Noorderlaanbrug
676,Noorderlaan,2023-04-27,05:00:00,110,40,70,FMN 16 Noorderlaanbrug
676,Noorderlaan,2023-04-27,06:00:00,148,72,76,FMN 16 Noorderlaanbrug
676,Noorderlaan,2023-04-27,07:00:00,309,169,140,FMN 16 Noorderlaanbrug
676,Noorderlaan,2023-04-27,08:00:00,447,269,178,FMN 16 Noorderlaanbrug
676,Noorderlaan,2023-04-27,09:00:00,147,87,60,FMN 16 Noorderlaanbrug
676,Noorderlaan,2023-04-27,10:00:00,82,42,40,FMN 16 Noorderlaanbrug
676,Noorderlaan,2023-04-27,11:00:00,84,43,41,FMN 16 Noorderlaanbrug
676,Noorderlaan,2023-04-27,12:00:00,128,59,69,FMN 16 Noorderlaanbrug
676,Noorderlaan,2023-04-27,13:00:00,135,54,81,FMN 16 Noorderlaanbrug
676,Noorderlaan,2023-04-27,14:00:00,151,70,81,FMN 16 Noorderlaanbrug
676,Noorderlaan,2023-04-27,15:00:00,184,72,112,FMN 16 Noorderlaanbrug
676,Noorderlaan,2023-04-27,16:00:00,336,125,211,FMN 16 Noorderlaanbrug
676,Noorderlaan,2023-04-27,17:00:00,345,139,206,FMN 16 Noorderlaanbrug
676,Noorderlaan,2023-04-27,18:00:00,182,71,111,FMN 16 Noorderlaanbrug
676,Noorderlaan,2023-04-27,19:00:00,94,43,51,FMN 16 Noorderlaanbrug
676,Noorderlaan,2023-04-27,20:00:00,71,29,42,FMN 16 Noorderlaanbrug
676,Noorderlaan,2023-04-27,21:00:00,54,26,28,FMN 16 Noorderlaanbrug
676,Noorderlaan,2023-04-27,22:00:00,63,31,32,FMN 16 Noorderlaanbrug
676,Noorderlaan,2023-04-27,23:00:00,34,18,16,FMN 16 Noorderlaanbrug
676,Noorderlaan,2023-04-28,00:00:00,22,11,11,FMN 16 Noorderlaanbrug
676,Noorderlaan,2023-04-28,01:00:00,15,3,12,FMN 16 Noorderlaanbrug
676,Noorderlaan,2023-04-28,02:00:00,3,1,2,FMN 16 Noorderlaanbrug
676,Noorderlaan,2023-04-28,03:00:00,9,5,4,FMN 16 Noorderlaanbrug
676,Noorderlaan,2023-04-28,04:00:00,22,12,10,FMN 16 Noorderlaanbrug
676,Noorderlaan,2023-04-28,05:00:00,60,17,43,FMN 16 Noorderlaanbrug
676,Noorderlaan,2023-04-28,06:00:00,84,33,51,FMN 16 Noorderlaanbrug
676,Noorderlaan,2023-04-28,07:00:00,220,114,106,FMN 16 Noorderlaanbrug
676,Noorderlaan,2023-04-28,08:00:00,267,154,113,FMN 16 Noorderlaanbrug
676,Noorderlaan,2023-04-28,09:00:00,106,62,44,FMN 16 Noorderlaanbrug
676,Noorderlaan,2023-04-28,10:00:00,67,34,33,FMN 16 Noorderlaanbrug
676,Noorderlaan,2023-04-28,11:00:00,89,46,43,FMN 16 Noorderlaanbrug
676,Noorderlaan,2023-04-28,12:00:00,110,55,55,FMN 16 Noorderlaanbrug
676,Noorderlaan,2023-04-28,13:00:00,116,50,66,FMN 16 Noorderlaanbrug
676,Noorderlaan,2023-04-28,14:00:00,120,52,68,FMN 16 Noorderlaanbrug
676,Noorderlaan,2023-04-28,15:00:00,171,71,100,FMN 16 Noorderlaanbrug
676,Noorderlaan,2023-04-28,16:00:00,265,120,145,FMN 16 Noorderlaanbrug
676,Noorderlaan,2023-04-28,17:00:00,245,97,148,FMN 16 Noorderlaanbrug
676,Noorderlaan,2023-04-28,18:00:00,144,59,85,FMN 16 Noorderlaanbrug
676,Noorderlaan,2023-04-28,19:00:00,86,42,44,FMN 16 Noorderlaanbrug
676,Noorderlaan,2023-04-28,20:00:00,48,24,24,FMN 16 Noorderlaanbrug
676,Noorderlaan,2023-04-28,21:00:00,56,25,31,FMN 16 Noorderlaanbrug
676,Noorderlaan,2023-04-28,22:00:00,64,29,35,FMN 16 Noorderlaanbrug
676,Noorderlaan,2023-04-28,23:00:00,57,19,38,FMN 16 Noorderlaanbrug
676,Noorderlaan,2023-04-29,00:00:00,71,23,48,FMN 16 Noorderlaanbrug
676,Noorderlaan,2023-04-29,01:00:00,39,12,27,FMN 16 Noorderlaanbrug
676,Noorderlaan,2023-04-29,02:00:00,43,18,25,FMN 16 Noorderlaanbrug
676,Noorderlaan,2023-04-29,03:00:00,29,17,12,FMN 16 Noorderlaanbrug
676,Noorderlaan,2023-04-29,04:00:00,20,13,7,FMN 16 Noorderlaanbrug
676,Noorderlaan,2023-04-29,05:00:00,30,9,21,FMN 16 Noorderlaanbrug
676,Noorderlaan,2023-04-29,06:00:00,29,17,12,FMN 16 Noorderlaanbrug
676,Noorderlaan,2023-04-29,07:00:00,45,24,21,FMN 16 Noorderlaanbrug
676,Noorderlaan,2023-04-29,08:00:00,33,18,15,FMN 16 Noorderlaanbrug
676,Noorderlaan,2023-04-29,09:00:00,60,38,22,FMN 16 Noorderlaanbrug
676,Noorderlaan,2023-04-29,10:00:00,77,50,27,FMN 16 Noorderlaanbrug
676,Noorderlaan,2023-04-29,11:00:00,98,51,47,FMN 16 Noorderlaanbrug
676,Noorderlaan,2023-04-29,12:00:00,108,61,47,FMN 16 Noorderlaanbrug
676,Noorderlaan,2023-04-29,13:00:00,126,71,55,FMN 16 Noorderlaanbrug
676,Noorderlaan,2023-04-29,14:00:00,130,74,56,FMN 16 Noorderlaanbrug
676,Noorderlaan,2023-04-29,15:00:00,114,48,66,FMN 16 Noorderlaanbrug
676,Noorderlaan,2023-04-29,16:00:00,123,61,62,FMN 16 Noorderlaanbrug
676,Noorderlaan,2023-04-29,17:00:00,109,51,58,FMN 16 Noorderlaanbrug
676,Noorderlaan,2023-04-29,18:00:00,110,50,60,FMN 16 Noorderlaanbrug
676,Noorderlaan,2023-04-29,19:00:00,72,35,37,FMN 16 Noorderlaanbrug
676,Noorderlaan,2023-04-29,20:00:00,37,21,16,FMN 16 Noorderlaanbrug
676,Noorderlaan,2023-04-29,21:00:00,38,18,20,FMN 16 Noorderlaanbrug
676,Noorderlaan,2023-04-29,22:00:00,52,30,22,FMN 16 Noorderlaanbrug
676,Noorderlaan,2023-04-29,23:00:00,33,15,18,FMN 16 Noorderlaanbrug
676,Noorderlaan,2023-04-30,00:00:00,62,11,51,FMN 16 Noorderlaanbrug
676,Noorderlaan,2023-04-30,01:00:00,43,5,38,FMN 16 Noorderlaanbrug
676,Noorderlaan,2023-04-30,02:00:00,37,7,30,FMN 16 Noorderlaanbrug
676,Noorderlaan,2023-04-30,03:00:00,29,7,22,FMN 16 Noorderlaanbrug
676,Noorderlaan,2023-04-30,04:00:00,21,3,18,FMN 16 Noorderlaanbrug
676,Noorderlaan,2023-04-30,05:00:00,28,9,19,FMN 16 Noorderlaanbrug
676,Noorderlaan,2023-04-30,06:00:00,32,10,22,FMN 16 Noorderlaanbrug
676,Noorderlaan,2023-04-30,07:00:00,17,3,14,FMN 16 Noorderlaanbrug
676,Noorderlaan,2023-04-30,08:00:00,29,12,17,FMN 16 Noorderlaanbrug
676,Noorderlaan,2023-04-30,09:00:00,49,19,30,FMN 16 Noorderlaanbrug
676,Noorderlaan,2023-04-30,10:00:00,57,23,34,FMN 16 Noorderlaanbrug
676,Noorderlaan,2023-04-30,11:00:00,84,26,58,FMN 16 Noorderlaanbrug
676,Noorderlaan,2023-04-30,12:00:00,84,28,56,FMN 16 Noorderlaanbrug
676,Noorderlaan,2023-04-30,13:00:00,112,34,78,FMN 16 Noorderlaanbrug
676,Noorderlaan,2023-04-30,14:00:00,95,27,68,FMN 16 Noorderlaanbrug
676,Noorderlaan,2023-04-30,15:00:00,100,21,79,FMN 16 Noorderlaanbrug
676,Noorderlaan,2023-04-30,16:00:00,101,26,75,FMN 16 Noorderlaanbrug
676,Noorderlaan,2023-04-30,17:00:00,83,18,65,FMN 16 Noorderlaanbrug
676,Noorderlaan,2023-04-30,18:00:00,93,24,69,FMN 16 Noorderlaanbrug
676,Noorderlaan,2023-04-30,19:00:00,65,10,55,FMN 16 Noorderlaanbrug
676,Noorderlaan,2023-04-30,20:00:00,52,16,36,FMN 16 Noorderlaanbrug
676,Noorderlaan,2023-04-30,21:00:00,44,13,31,FMN 16 Noorderlaanbrug
676,Noorderlaan,2023-04-30,22:00:00,44,12,32,FMN 16 Noorderlaanbrug
676,Noorderlaan,2023-04-30,23:00:00,28,7,21,FMN 16 Noorderlaanbrug
676,Noorderlaan,2023-05-01,00:00:00,8,6,2,FMN 16 Noorderlaanbrug
676,Noorderlaan,2023-05-01,01:00:00,2,1,1,FMN 16 Noorderlaanbrug
676,Noorderlaan,2023-05-01,02:00:00,3,3,0,FMN 16 Noorderlaanbrug
676,Noorderlaan,2023-05-01,03:00:00,5,3,2,FMN 16 Noorderlaanbrug
676,Noorderlaan,2023-05-01,04:00:00,20,11,9,FMN 16 Noorderlaanbrug
676,Noorderlaan,2023-05-01,05:00:00,59,35,24,FMN 16 Noorderlaanbrug
676,Noorderlaan,2023-05-01,06:00:00,90,60,30,FMN 16 Noorderlaanbrug
676,Noorderlaan,2023-05-01,07:00:00,218,167,51,FMN 16 Noorderlaanbrug
676,Noorderlaan,2023-05-01,08:00:00,333,268,65,FMN 16 Noorderlaanbrug
676,Noorderlaan,2023-05-01,09:00:00,85,68,17,FMN 16 Noorderlaanbrug
676,Noorderlaan,2023-05-01,10:00:00,74,58,16,FMN 16 Noorderlaanbrug
676,Noorderlaan,2023-05-01,11:00:00,57,38,19,FMN 16 Noorderlaanbrug
676,Noorderlaan,2023-05-01,12:00:00,85,61,24,FMN 16 Noorderlaanbrug
676,Noorderlaan,2023-05-01,13:00:00,102,61,41,FMN 16 Noorderlaanbrug
676,Noorderlaan,2023-05-01,14:00:00,108,72,36,FMN 16 Noorderlaanbrug
676,Noorderlaan,2023-05-01,15:00:00,127,74,53,FMN 16 Noorderlaanbrug
676,Noorderlaan,2023-05-01,16:00:00,261,161,100,FMN 16 Noorderlaanbrug
676,Noorderlaan,2023-05-01,17:00:00,267,153,114,FMN 16 Noorderlaanbrug
676,Noorderlaan,2023-05-01,18:00:00,128,67,61,FMN 16 Noorderlaanbrug
676,Noorderlaan,2023-05-01,19:00:00,49,30,19,FMN 16 Noorderlaanbrug
676,Noorderlaan,2023-05-01,20:00:00,41,26,15,FMN 16 Noorderlaanbrug
676,Noorderlaan,2023-05-01,21:00:00,35,23,12,FMN 16 Noorderlaanbrug
676,Noorderlaan,2023-05-01,22:00:00,38,22,16,FMN 16 Noorderlaanbrug
676,Noorderlaan,2023-05-01,23:00:00,25,18,7,FMN 16 Noorderlaanbrug
676,Noorderlaan,2023-05-02,00:00:00,8,4,4,FMN 16 Noorderlaanbrug
676,Noorderlaan,2023-05-02,01:00:00,6,4,2,FMN 16 Noorderlaanbrug
676,Noorderlaan,2023-05-02,02:00:00,9,3,6,FMN 16 Noorderlaanbrug
676,Noorderlaan,2023-05-02,03:00:00,10,5,5,FMN 16 Noorderlaanbrug
676,Noorderlaan,2023-05-02,04:00:00,26,14,12,FMN 16 Noorderlaanbrug
676,Noorderlaan,2023-05-02,05:00:00,81,32,49,FMN 16 Noorderlaanbrug
676,Noorderlaan,2023-05-02,06:00:00,135,53,82,FMN 16 Noorderlaanbrug
676,Noorderlaan,2023-05-02,07:00:00,315,183,132,FMN 16 Noorderlaanbrug
676,Noorderlaan,2023-05-02,08:00:00,400,242,158,FMN 16 Noorderlaanbrug
676,Noorderlaan,2023-05-02,09:00:00,129,70,59,FMN 16 Noorderlaanbrug
676,Noorderlaan,2023-05-02,10:00:00,87,54,33,FMN 16 Noorderlaanbrug
676,Noorderlaan,2023-05-02,11:00:00,96,42,54,FMN 16 Noorderlaanbrug
676,Noorderlaan,2023-05-02,12:00:00,132,62,70,FMN 16 Noorderlaanbrug
676,Noorderlaan,2023-05-02,13:00:00,132,46,86,FMN 16 Noorderlaanbrug
676,Noorderlaan,2023-05-02,14:00:00,155,78,77,FMN 16 Noorderlaanbrug
676,Noorderlaan,2023-05-02,15:00:00,212,91,121,FMN 16 Noorderlaanbrug
676,Noorderlaan,2023-05-02,16:00:00,380,160,220,FMN 16 Noorderlaanbrug
676,Noorderlaan,2023-05-02,17:00:00,399,148,251,FMN 16 Noorderlaanbrug
676,Noorderlaan,2023-05-02,18:00:00,235,83,152,FMN 16 Noorderlaanbrug
676,Noorderlaan,2023-05-02,19:00:00,111,45,66,FMN 16 Noorderlaanbrug
676,Noorderlaan,2023-05-02,20:00:00,55,27,28,FMN 16 Noorderlaanbrug
676,Noorderlaan,2023-05-02,21:00:00,48,17,31,FMN 16 Noorderlaanbrug
676,Noorderlaan,2023-05-02,22:00:00,62,35,27,FMN 16 Noorderlaanbrug
676,Noorderlaan,2023-05-02,23:00:00,23,12,11,FMN 16 Noorderlaanbrug
676,Noorderlaan,2023-05-03,00:00:00,13,5,8,FMN 16 Noorderlaanbrug
676,Noorderlaan,2023-05-03,01:00:00,17,5,12,FMN 16 Noorderlaanbrug
676,Noorderlaan,2023-05-03,02:00:00,5,1,4,FMN 16 Noorderlaanbrug
676,Noorderlaan,2023-05-03,03:00:00,13,8,5,FMN 16 Noorderlaanbrug
676,Noorderlaan,2023-05-03,04:00:00,23,11,12,FMN 16 Noorderlaanbrug
676,Noorderlaan,2023-05-03,05:00:00,83,23,60,FMN 16 Noorderlaanbrug
676,Noorderlaan,2023-05-03,06:00:00,104,34,70,FMN 16 Noorderlaanbrug
676,Noorderlaan,2023-05-03,07:00:00,257,116,141,FMN 16 Noorderlaanbrug
676,Noorderlaan,2023-05-03,08:00:00,318,157,161,FMN 16 Noorderlaanbrug
676,Noorderlaan,2023-05-03,09:00:00,144,77,67,FMN 16 Noorderlaanbrug
676,Noorderlaan,2023-05-03,10:00:00,88,44,44,FMN 16 Noorderlaanbrug
676,Noorderlaan,2023-05-03,11:00:00,95,37,58,FMN 16 Noorderlaanbrug
676,Noorderlaan,2023-05-03,12:00:00,206,76,130,FMN 16 Noorderlaanbrug
676,Noorderlaan,2023-05-03,13:00:00,178,57,121,FMN 16 Noorderlaanbrug
676,Noorderlaan,2023-05-03,14:00:00,142,68,74,FMN 16 Noorderlaanbrug
676,Noorderlaan,2023-05-03,15:00:00,190,88,102,FMN 16 Noorderlaanbrug
676,Noorderlaan,2023-05-03,16:00:00,309,124,185,FMN 16 Noorderlaanbrug
676,Noorderlaan,2023-05-03,17:00:00,357,121,236,FMN 16 Noorderlaanbrug
676,Noorderlaan,2023-05-03,18:00:00,197,64,133,FMN 16 Noorderlaanbrug
676,Noorderlaan,2023-05-03,19:00:00,106,41,65,FMN 16 Noorderlaanbrug
676,Noorderlaan,2023-05-03,20:00:00,67,26,41,FMN 16 Noorderlaanbrug
676,Noorderlaan,2023-05-03,21:00:00,64,25,39,FMN 16 Noorderlaanbrug
676,Noorderlaan,2023-05-03,22:00:00,63,28,35,FMN 16 Noorderlaanbrug
676,Noorderlaan,2023-05-03,23:00:00,30,8,22,FMN 16 Noorderlaanbrug
676,Noorderlaan,2023-05-04,00:00:00,36,9,27,FMN 16 Noorderlaanbrug
676,Noorderlaan,2023-05-04,01:00:00,19,5,14,FMN 16 Noorderlaanbrug
676,Noorderlaan,2023-05-04,02:00:00,10,4,6,FMN 16 Noorderlaanbrug
676,Noorderlaan,2023-05-04,03:00:00,11,8,3,FMN 16 Noorderlaanbrug
676,Noorderlaan,2023-05-04,04:00:00,34,13,21,FMN 16 Noorderlaanbrug
676,Noorderlaan,2023-05-04,05:00:00,116,38,78,FMN 16 Noorderlaanbrug
676,Noorderlaan,2023-05-04,06:00:00,146,55,91,FMN 16 Noorderlaanbrug
676,Noorderlaan,2023-05-04,07:00:00,356,177,179,FMN 16 Noorderlaanbrug
676,Noorderlaan,2023-05-04,08:00:00,430,238,192,FMN 16 Noorderlaanbrug
676,Noorderlaan,2023-05-04,09:00:00,146,70,76,FMN 16 Noorderlaanbrug
676,Noorderlaan,2023-05-04,10:00:00,91,50,41,FMN 16 Noorderlaanbrug
676,Noorderlaan,2023-05-04,11:00:00,69,30,39,FMN 16 Noorderlaanbrug
676,Noorderlaan,2023-05-04,12:00:00,154,56,98,FMN 16 Noorderlaanbrug
676,Noorderlaan,2023-05-04,13:00:00,127,40,87,FMN 16 Noorderlaanbrug
676,Noorderlaan,2023-05-04,14:00:00,171,74,97,FMN 16 Noorderlaanbrug
676,Noorderlaan,2023-05-04,15:00:00,202,73,129,FMN 16 Noorderlaanbrug
676,Noorderlaan,2023-05-04,16:00:00,359,114,245,FMN 16 Noorderlaanbrug
676,Noorderlaan,2023-05-04,17:00:00,365,131,234,FMN 16 Noorderlaanbrug
676,Noorderlaan,2023-05-04,18:00:00,195,58,137,FMN 16 Noorderlaanbrug
676,Noorderlaan,2023-05-04,19:00:00,96,39,57,FMN 16 Noorderlaanbrug
676,Noorderlaan,2023-05-04,20:00:00,66,26,40,FMN 16 Noorderlaanbrug
676,Noorderlaan,2023-05-04,21:00:00,54,19,35,FMN 16 Noorderlaanbrug
676,Noorderlaan,2023-05-04,22:00:00,55,18,37,FMN 16 Noorderlaanbrug
676,Noorderlaan,2023-05-04,23:00:00,41,16,25,FMN 16 Noorderlaanbrug
676,Noorderlaan,2023-05-05,00:00:00,27,8,19,FMN 16 Noorderlaanbrug
676,Noorderlaan,2023-05-05,01:00:00,15,6,9,FMN 16 Noorderlaanbrug
676,Noorderlaan,2023-05-05,02:00:00,10,3,7,FMN 16 Noorderlaanbrug
676,Noorderlaan,2023-05-05,03:00:00,23,14,9,FMN 16 Noorderlaanbrug
676,Noorderlaan,2023-05-05,04:00:00,31,13,18,FMN 16 Noorderlaanbrug
676,Noorderlaan,2023-05-05,05:00:00,90,32,58,FMN 16 Noorderlaanbrug
676,Noorderlaan,2023-05-05,06:00:00,108,48,60,FMN 16 Noorderlaanbrug
676,Noorderlaan,2023-05-05,07:00:00,225,122,103,FMN 16 Noorderlaanbrug
676,Noorderlaan,2023-05-05,08:00:00,303,176,127,FMN 16 Noorderlaanbrug
676,Noorderlaan,2023-05-05,09:00:00,112,60,52,FMN 16 Noorderlaanbrug
676,Noorderlaan,2023-05-05,10:00:00,82,49,33,FMN 16 Noorderlaanbrug
676,Noorderlaan,2023-05-05,11:00:00,90,50,40,FMN 16 Noorderlaanbrug
676,Noorderlaan,2023-05-05,12:00:00,111,61,50,FMN 16 Noorderlaanbrug
676,Noorderlaan,2023-05-05,13:00:00,124,60,64,FMN 16 Noorderlaanbrug
676,Noorderlaan,2023-05-05,14:00:00,132,71,61,FMN 16 Noorderlaanbrug
676,Noorderlaan,2023-05-05,15:00:00,174,62,112,FMN 16 Noorderlaanbrug
676,Noorderlaan,2023-05-05,16:00:00,309,129,180,FMN 16 Noorderlaanbrug
676,Noorderlaan,2023-05-05,17:00:00,242,99,143,FMN 16 Noorderlaanbrug
676,Noorderlaan,2023-05-05,18:00:00,160,67,93,FMN 16 Noorderlaanbrug
676,Noorderlaan,2023-05-05,19:00:00,78,33,45,FMN 16 Noorderlaanbrug
676,Noorderlaan,2023-05-05,20:00:00,63,29,34,FMN 16 Noorderlaanbrug
676,Noorderlaan,2023-05-05,21:00:00,50,24,26,FMN 16 Noorderlaanbrug
676,Noorderlaan,2023-05-05,22:00:00,61,32,29,FMN 16 Noorderlaanbrug
676,Noorderlaan,2023-05-05,23:00:00,59,16,43,FMN 16 Noorderlaanbrug
676,Noorderlaan,2023-05-06,00:00:00,78,22,56,FMN 16 Noorderlaanbrug
676,Noorderlaan,2023-05-06,01:00:00,40,15,25,FMN 16 Noorderlaanbrug
676,Noorderlaan,2023-05-06,02:00:00,35,13,22,FMN 16 Noorderlaanbrug
676,Noorderlaan,2023-05-06,03:00:00,32,12,20,FMN 16 Noorderlaanbrug
676,Noorderlaan,2023-05-06,04:00:00,20,10,10,FMN 16 Noorderlaanbrug
676,Noorderlaan,2023-05-06,05:00:00,31,10,21,FMN 16 Noorderlaanbrug
676,Noorderlaan,2023-05-06,06:00:00,39,20,19,FMN 16 Noorderlaanbrug
676,Noorderlaan,2023-05-06,07:00:00,36,14,22,FMN 16 Noorderlaanbrug
676,Noorderlaan,2023-05-06,08:00:00,33,19,14,FMN 16 Noorderlaanbrug
676,Noorderlaan,2023-05-06,09:00:00,57,38,19,FMN 16 Noorderlaanbrug
676,Noorderlaan,2023-05-06,10:00:00,102,53,49,FMN 16 Noorderlaanbrug
676,Noorderlaan,2023-05-06,11:00:00,96,47,49,FMN 16 Noorderlaanbrug
676,Noorderlaan,2023-05-06,12:00:00,106,53,53,FMN 16 Noorderlaanbrug
676,Noorderlaan,2023-05-06,13:00:00,116,56,60,FMN 16 Noorderlaanbrug
676,Noorderlaan,2023-05-06,14:00:00,118,57,61,FMN 16 Noorderlaanbrug
676,Noorderlaan,2023-05-06,15:00:00,144,62,82,FMN 16 Noorderlaanbrug
676,Noorderlaan,2023-05-06,16:00:00,110,46,64,FMN 16 Noorderlaanbrug
676,Noorderlaan,2023-05-06,17:00:00,121,53,68,FMN 16 Noorderlaanbrug
676,Noorderlaan,2023-05-06,18:00:00,117,42,75,FMN 16 Noorderlaanbrug
676,Noorderlaan,2023-05-06,19:00:00,80,28,52,FMN 16 Noorderlaanbrug
676,Noorderlaan,2023-05-06,20:00:00,45,20,25,FMN 16 Noorderlaanbrug
676,Noorderlaan,2023-05-06,21:00:00,41,15,26,FMN 16 Noorderlaanbrug
676,Noorderlaan,2023-05-06,22:00:00,46,18,28,FMN 16 Noorderlaanbrug
676,Noorderlaan,2023-05-06,23:00:00,41,16,25,FMN 16 Noorderlaanbrug
676,Noorderlaan,2023-05-07,00:00:00,36,11,25,FMN 16 Noorderlaanbrug
676,Noorderlaan,2023-05-07,01:00:00,38,12,26,FMN 16 Noorderlaanbrug
676,Noorderlaan,2023-05-07,02:00:00,21,6,15,FMN 16 Noorderlaanbrug
676,Noorderlaan,2023-05-07,03:00:00,19,7,12,FMN 16 Noorderlaanbrug
676,Noorderlaan,2023-05-07,04:00:00,20,8,12,FMN 16 Noorderlaanbrug
676,Noorderlaan,2023-05-07,05:00:00,19,9,10,FMN 16 Noorderlaanbrug
676,Noorderlaan,2023-05-07,06:00:00,26,8,18,FMN 16 Noorderlaanbrug
676,Noorderlaan,2023-05-07,07:00:00,10,3,7,FMN 16 Noorderlaanbrug
676,Noorderlaan,2023-05-07,08:00:00,19,7,12,FMN 16 Noorderlaanbrug
676,Noorderlaan,2023-05-07,09:00:00,36,23,13,FMN 16 Noorderlaanbrug
676,Noorderlaan,2023-05-07,10:00:00,51,29,22,FMN 16 Noorderlaanbrug
676,Noorderlaan,2023-05-07,11:00:00,56,31,25,FMN 16 Noorderlaanbrug
676,Noorderlaan,2023-05-07,12:00:00,44,20,24,FMN 16 Noorderlaanbrug
676,Noorderlaan,2023-05-07,13:00:00,62,31,31,FMN 16 Noorderlaanbrug
676,Noorderlaan,2023-05-07,14:00:00,65,27,38,FMN 16 Noorderlaanbrug
676,Noorderlaan,2023-05-07,15:00:00,63,30,33,FMN 16 Noorderlaanbrug
676,Noorderlaan,2023-05-07,16:00:00,65,24,41,FMN 16 Noorderlaanbrug
676,Noorderlaan,2023-05-07,17:00:00,66,31,35,FMN 16 Noorderlaanbrug
676,Noorderlaan,2023-05-07,18:00:00,52,28,24,FMN 16 Noorderlaanbrug
676,Noorderlaan,2023-05-07,19:00:00,49,25,24,FMN 16 Noorderlaanbrug
676,Noorderlaan,2023-05-07,20:00:00,33,14,19,FMN 16 Noorderlaanbrug
676,Noorderlaan,2023-05-07,21:00:00,26,12,14,FMN 16 Noorderlaanbrug
676,Noorderlaan,2023-05-07,22:00:00,26,13,13,FMN 16 Noorderlaanbrug
676,Noorderlaan,2023-05-07,23:00:00,16,7,9,FMN 16 Noorderlaanbrug
676,Noorderlaan,2023-05-08,00:00:00,6,5,1,FMN 16 Noorderlaanbrug
676,Noorderlaan,2023-05-08,01:00:00,9,1,8,FMN 16 Noorderlaanbrug
676,Noorderlaan,2023-05-08,02:00:00,1,0,1,FMN 16 Noorderlaanbrug
676,Noorderlaan,2023-05-08,03:00:00,3,1,2,FMN 16 Noorderlaanbrug
676,Noorderlaan,2023-05-08,04:00:00,28,18,10,FMN 16 Noorderlaanbrug
676,Noorderlaan,2023-05-08,05:00:00,73,21,52,FMN 16 Noorderlaanbrug
676,Noorderlaan,2023-05-08,06:00:00,115,52,63,FMN 16 Noorderlaanbrug
676,Noorderlaan,2023-05-08,07:00:00,268,156,112,FMN 16 Noorderlaanbrug
676,Noorderlaan,2023-05-08,08:00:00,386,243,143,FMN 16 Noorderlaanbrug
676,Noorderlaan,2023-05-08,09:00:00,122,64,58,FMN 16 Noorderlaanbrug
676,Noorderlaan,2023-05-08,10:00:00,79,42,37,FMN 16 Noorderlaanbrug
676,Noorderlaan,2023-05-08,11:00:00,83,47,36,FMN 16 Noorderlaanbrug
676,Noorderlaan,2023-05-08,12:00:00,113,52,61,FMN 16 Noorderlaanbrug
676,Noorderlaan,2023-05-08,13:00:00,135,55,80,FMN 16 Noorderlaanbrug
676,Noorderlaan,2023-05-08,14:00:00,152,76,76,FMN 16 Noorderlaanbrug
676,Noorderlaan,2023-05-08,15:00:00,193,70,123,FMN 16 Noorderlaanbrug
676,Noorderlaan,2023-05-08,16:00:00,379,146,233,FMN 16 Noorderlaanbrug
676,Noorderlaan,2023-05-08,17:00:00,373,133,240,FMN 16 Noorderlaanbrug
676,Noorderlaan,2023-05-08,18:00:00,190,71,119,FMN 16 Noorderlaanbrug
676,Noorderlaan,2023-05-08,19:00:00,69,28,41,FMN 16 Noorderlaanbrug
676,Noorderlaan,2023-05-08,20:00:00,54,26,28,FMN 16 Noorderlaanbrug
676,Noorderlaan,2023-05-08,21:00:00,69,35,34,FMN 16 Noorderlaanbrug
676,Noorderlaan,2023-05-08,22:00:00,55,19,36,FMN 16 Noorderlaanbrug
676,Noorderlaan,2023-05-08,23:00:00,26,13,13,FMN 16 Noorderlaanbrug
676,Noorderlaan,2023-05-09,00:00:00,12,9,3,FMN 16 Noorderlaanbrug
676,Noorderlaan,2023-05-09,01:00:00,6,2,4,FMN 16 Noorderlaanbrug
676,Noorderlaan,2023-05-09,02:00:00,5,2,3,FMN 16 Noorderlaanbrug
676,Noorderlaan,2023-05-09,03:00:00,6,4,2,FMN 16 Noorderlaanbrug
676,Noorderlaan,2023-05-09,04:00:00,24,16,8,FMN 16 Noorderlaanbrug
676,Noorderlaan,2023-05-09,05:00:00,60,24,36,FMN 16 Noorderlaanbrug
676,Noorderlaan,2023-05-09,06:00:00,99,57,42,FMN 16 Noorderlaanbrug
676,Noorderlaan,2023-05-09,07:00:00,293,200,93,FMN 16 Noorderlaanbrug
676,Noorderlaan,2023-05-09,08:00:00,353,262,91,FMN 16 Noorderlaanbrug
676,Noorderlaan,2023-05-09,09:00:00,125,83,42,FMN 16 Noorderlaanbrug
676,Noorderlaan,2023-05-09,10:00:00,68,45,23,FMN 16 Noorderlaanbrug
676,Noorderlaan,2023-05-09,11:00:00,67,41,26,FMN 16 Noorderlaanbrug
676,Noorderlaan,2023-05-09,12:00:00,120,75,45,FMN 16 Noorderlaanbrug
676,Noorderlaan,2023-05-09,13:00:00,110,55,55,FMN 16 Noorderlaanbrug
676,Noorderlaan,2023-05-09,14:00:00,123,81,42,FMN 16 Noorderlaanbrug
676,Noorderlaan,2023-05-09,15:00:00,167,97,70,FMN 16 Noorderlaanbrug
676,Noorderlaan,2023-05-09,16:00:00,298,166,132,FMN 16 Noorderlaanbrug
676,Noorderlaan,2023-05-09,17:00:00,329,170,159,FMN 16 Noorderlaanbrug
676,Noorderlaan,2023-05-09,18:00:00,180,87,93,FMN 16 Noorderlaanbrug
676,Noorderlaan,2023-05-09,19:00:00,93,56,37,FMN 16 Noorderlaanbrug
676,Noorderlaan,2023-05-09,20:00:00,44,27,17,FMN 16 Noorderlaanbrug
676,Noorderlaan,2023-05-09,21:00:00,44,26,18,FMN 16 Noorderlaanbrug
676,Noorderlaan,2023-05-09,22:00:00,61,40,21,FMN 16 Noorderlaanbrug
676,Noorderlaan,2023-05-09,23:00:00,19,13,6,FMN 16 Noorderlaanbrug
676,Noorderlaan,2023-05-10,00:00:00,13,5,8,FMN 16 Noorderlaanbrug
676,Noorderlaan,2023-05-10,01:00:00,8,3,5,FMN 16 Noorderlaanbrug
676,Noorderlaan,2023-05-10,02:00:00,4,2,2,FMN 16 Noorderlaanbrug
676,Noorderlaan,2023-05-10,03:00:00,8,4,4,FMN 16 Noorderlaanbrug
676,Noorderlaan,2023-05-10,04:00:00,24,12,12,FMN 16 Noorderlaanbrug
676,Noorderlaan,2023-05-10,05:00:00,62,23,39,FMN 16 Noorderlaanbrug
676,Noorderlaan,2023-05-10,06:00:00,87,40,47,FMN 16 Noorderlaanbrug
676,Noorderlaan,2023-05-10,07:00:00,205,110,95,FMN 16 Noorderlaanbrug
676,Noorderlaan,2023-05-10,08:00:00,265,150,115,FMN 16 Noorderlaanbrug
676,Noorderlaan,2023-05-10,09:00:00,95,56,39,FMN 16 Noorderlaanbrug
676,Noorderlaan,2023-05-10,10:00:00,52,30,22,FMN 16 Noorderlaanbrug
676,Noorderlaan,2023-05-10,11:00:00,79,39,40,FMN 16 Noorderlaanbrug
676,Noorderlaan,2023-05-10,12:00:00,151,69,82,FMN 16 Noorderlaanbrug
676,Noorderlaan,2023-05-10,13:00:00,133,54,79,FMN 16 Noorderlaanbrug
676,Noorderlaan,2023-05-10,14:00:00,123,67,56,FMN 16 Noorderlaanbrug
676,Noorderlaan,2023-05-10,15:00:00,150,74,76,FMN 16 Noorderlaanbrug
676,Noorderlaan,2023-05-10,16:00:00,239,116,123,FMN 16 Noorderlaanbrug
676,Noorderlaan,2023-05-10,17:00:00,266,122,144,FMN 16 Noorderlaanbrug
676,Noorderlaan,2023-05-10,18:00:00,135,52,83,FMN 16 Noorderlaanbrug
676,Noorderlaan,2023-05-10,19:00:00,75,36,39,FMN 16 Noorderlaanbrug
676,Noorderlaan,2023-05-10,20:00:00,55,20,35,FMN 16 Noorderlaanbrug
676,Noorderlaan,2023-05-10,21:00:00,48,23,25,FMN 16 Noorderlaanbrug
676,Noorderlaan,2023-05-10,22:00:00,49,23,26,FMN 16 Noorderlaanbrug
676,Noorderlaan,2023-05-10,23:00:00,24,10,14,FMN 16 Noorderlaanbrug
676,Noorderlaan,2023-05-11,00:00:00,18,7,11,FMN 16 Noorderlaanbrug
676,Noorderlaan,2023-05-11,01:00:00,16,9,7,FMN 16 Noorderlaanbrug
676,Noorderlaan,2023-05-11,02:00:00,11,8,3,FMN 16 Noorderlaanbrug
676,Noorderlaan,2023-05-11,03:00:00,11,8,3,FMN 16 Noorderlaanbrug
676,Noorderlaan,2023-05-11,04:00:00,31,14,17,FMN 16 Noorderlaanbrug
676,Noorderlaan,2023-05-11,05:00:00,95,38,57,FMN 16 Noorderlaanbrug
676,Noorderlaan,2023-05-11,06:00:00,128,61,67,FMN 16 Noorderlaanbrug
676,Noorderlaan,2023-05-11,07:00:00,311,184,127,FMN 16 Noorderlaanbrug
676,Noorderlaan,2023-05-11,08:00:00,406,256,150,FMN 16 Noorderlaanbrug
676,Noorderlaan,2023-05-11,09:00:00,136,85,51,FMN 16 Noorderlaanbrug
676,Noorderlaan,2023-05-11,10:00:00,83,52,31,FMN 16 Noorderlaanbrug
676,Noorderlaan,2023-05-11,11:00:00,81,43,38,FMN 16 Noorderlaanbrug
676,Noorderlaan,2023-05-11,12:00:00,121,52,69,FMN 16 Noorderlaanbrug
676,Noorderlaan,2023-05-11,13:00:00,110,53,57,FMN 16 Noorderlaanbrug
676,Noorderlaan,2023-05-11,14:00:00,142,77,65,FMN 16 Noorderlaanbrug
676,Noorderlaan,2023-05-11,15:00:00,187,86,101,FMN 16 Noorderlaanbrug
676,Noorderlaan,2023-05-11,16:00:00,316,132,184,FMN 16 Noorderlaanbrug
676,Noorderlaan,2023-05-11,17:00:00,310,134,176,FMN 16 Noorderlaanbrug
676,Noorderlaan,2023-05-11,18:00:00,177,69,108,FMN 16 Noorderlaanbrug
676,Noorderlaan,2023-05-11,19:00:00,68,32,36,FMN 16 Noorderlaanbrug
676,Noorderlaan,2023-05-11,20:00:00,56,23,33,FMN 16 Noorderlaanbrug
676,Noorderlaan,2023-05-11,21:00:00,67,29,38,FMN 16 Noorderlaanbrug
676,Noorderlaan,2023-05-11,22:00:00,58,26,32,FMN 16 Noorderlaanbrug
676,Noorderlaan,2023-05-11,23:00:00,25,11,14,FMN 16 Noorderlaanbrug
676,Noorderlaan,2023-05-12,00:00:00,15,6,9,FMN 16 Noorderlaanbrug
676,Noorderlaan,2023-05-12,01:00:00,12,4,8,FMN 16 Noorderlaanbrug
676,Noorderlaan,2023-05-12,02:00:00,11,2,9,FMN 16 Noorderlaanbrug
676,Noorderlaan,2023-05-12,03:00:00,16,9,7,FMN 16 Noorderlaanbrug
676,Noorderlaan,2023-05-12,04:00:00,15,9,6,FMN 16 Noorderlaanbrug
676,Noorderlaan,2023-05-12,05:00:00,80,23,57,FMN 16 Noorderlaanbrug
676,Noorderlaan,2023-05-12,06:00:00,90,34,56,FMN 16 Noorderlaanbrug
676,Noorderlaan,2023-05-12,07:00:00,187,99,88,FMN 16 Noorderlaanbrug
676,Noorderlaan,2023-05-12,08:00:00,282,170,112,FMN 16 Noorderlaanbrug
676,Noorderlaan,2023-05-12,09:00:00,110,62,48,FMN 16 Noorderlaanbrug
676,Noorderlaan,2023-05-12,10:00:00,74,42,32,FMN 16 Noorderlaanbrug
676,Noorderlaan,2023-05-12,11:00:00,93,46,47,FMN 16 Noorderlaanbrug
676,Noorderlaan,2023-05-12,12:00:00,113,60,53,FMN 16 Noorderlaanbrug
676,Noorderlaan,2023-05-12,13:00:00,121,58,63,FMN 16 Noorderlaanbrug
676,Noorderlaan,2023-05-12,14:00:00,114,59,55,FMN 16 Noorderlaanbrug
676,Noorderlaan,2023-05-12,15:00:00,165,72,93,FMN 16 Noorderlaanbrug
676,Noorderlaan,2023-05-12,16:00:00,262,115,147,FMN 16 Noorderlaanbrug
676,Noorderlaan,2023-05-12,17:00:00,218,92,126,FMN 16 Noorderlaanbrug
676,Noorderlaan,2023-05-12,18:00:00,140,60,80,FMN 16 Noorderlaanbrug
676,Noorderlaan,2023-05-12,19:00:00,71,33,38,FMN 16 Noorderlaanbrug
676,Noorderlaan,2023-05-12,20:00:00,53,26,27,FMN 16 Noorderlaanbrug
676,Noorderlaan,2023-05-12,21:00:00,59,30,29,FMN 16 Noorderlaanbrug
676,Noorderlaan,2023-05-12,22:00:00,49,24,25,FMN 16 Noorderlaanbrug
676,Noorderlaan,2023-05-12,23:00:00,44,14,30,FMN 16 Noorderlaanbrug
676,Noorderlaan,2023-05-13,00:00:00,93,27,66,FMN 16 Noorderlaanbrug
676,Noorderlaan,2023-05-13,01:00:00,46,19,27,FMN 16 Noorderlaanbrug
676,Noorderlaan,2023-05-13,02:00:00,38,21,17,FMN 16 Noorderlaanbrug
676,Noorderlaan,2023-05-13,03:00:00,30,13,17,FMN 16 Noorderlaanbrug
676,Noorderlaan,2023-05-13,04:00:00,20,10,10,FMN 16 Noorderlaanbrug
676,Noorderlaan,2023-05-13,05:00:00,30,10,20,FMN 16 Noorderlaanbrug
676,Noorderlaan,2023-05-13,06:00:00,37,17,20,FMN 16 Noorderlaanbrug
676,Noorderlaan,2023-05-13,07:00:00,40,19,21,FMN 16 Noorderlaanbrug
676,Noorderlaan,2023-05-13,08:00:00,47,29,18,FMN 16 Noorderlaanbrug
676,Noorderlaan,2023-05-13,09:00:00,65,34,31,FMN 16 Noorderlaanbrug
676,Noorderlaan,2023-05-13,10:00:00,92,42,50,FMN 16 Noorderlaanbrug
676,Noorderlaan,2023-05-13,11:00:00,97,49,48,FMN 16 Noorderlaanbrug
676,Noorderlaan,2023-05-13,12:00:00,122,59,63,FMN 16 Noorderlaanbrug
676,Noorderlaan,2023-05-13,13:00:00,132,65,67,FMN 16 Noorderlaanbrug
676,Noorderlaan,2023-05-13,14:00:00,140,69,71,FMN 16 Noorderlaanbrug
676,Noorderlaan,2023-05-13,15:00:00,140,52,88,FMN 16 Noorderlaanbrug
676,Noorderlaan,2023-05-13,16:00:00,140,53,87,FMN 16 Noorderlaanbrug
676,Noorderlaan,2023-05-13,17:00:00,120,48,72,FMN 16 Noorderlaanbrug
676,Noorderlaan,2023-05-13,18:00:00,128,55,73,FMN 16 Noorderlaanbrug
676,Noorderlaan,2023-05-13,19:00:00,72,26,46,FMN 16 Noorderlaanbrug
676,Noorderlaan,2023-05-13,20:00:00,51,26,25,FMN 16 Noorderlaanbrug
676,Noorderlaan,2023-05-13,21:00:00,54,27,27,FMN 16 Noorderlaanbrug
676,Noorderlaan,2023-05-13,22:00:00,58,27,31,FMN 16 Noorderlaanbrug
676,Noorderlaan,2023-05-13,23:00:00,50,19,31,FMN 16 Noorderlaanbrug
676,Noorderlaan,2023-05-14,00:00:00,52,13,39,FMN 16 Noorderlaanbrug
676,Noorderlaan,2023-05-14,01:00:00,40,7,33,FMN 16 Noorderlaanbrug
676,Noorderlaan,2023-05-14,02:00:00,32,8,24,FMN 16 Noorderlaanbrug
676,Noorderlaan,2023-05-14,03:00:00,26,9,17,FMN 16 Noorderlaanbrug
676,Noorderlaan,2023-05-14,04:00:00,26,6,20,FMN 16 Noorderlaanbrug
676,Noorderlaan,2023-05-14,05:00:00,30,8,22,FMN 16 Noorderlaanbrug
676,Noorderlaan,2023-05-14,06:00:00,37,12,25,FMN 16 Noorderlaanbrug
676,Noorderlaan,2023-05-14,07:00:00,19,9,10,FMN 16 Noorderlaanbrug
676,Noorderlaan,2023-05-14,08:00:00,23,10,13,FMN 16 Noorderlaanbrug
676,Noorderlaan,2023-05-14,09:00:00,38,17,21,FMN 16 Noorderlaanbrug
676,Noorderlaan,2023-05-14,10:00:00,46,20,26,FMN 16 Noorderlaanbrug
676,Noorderlaan,2023-05-14,11:00:00,60,28,32,FMN 16 Noorderlaanbrug
676,Noorderlaan,2023-05-14,12:00:00,69,24,45,FMN 16 Noorderlaanbrug
676,Noorderlaan,2023-05-14,13:00:00,99,28,71,FMN 16 Noorderlaanbrug
676,Noorderlaan,2023-05-14,14:00:00,82,28,54,FMN 16 Noorderlaanbrug
676,Noorderlaan,2023-05-14,15:00:00,83,19,64,FMN 16 Noorderlaanbrug
676,Noorderlaan,2023-05-14,16:00:00,78,26,52,FMN 16 Noorderlaanbrug
676,Noorderlaan,2023-05-14,17:00:00,71,22,49,FMN 16 Noorderlaanbrug
676,Noorderlaan,2023-05-14,18:00:00,77,21,56,FMN 16 Noorderlaanbrug
676,Noorderlaan,2023-05-14,19:00:00,55,13,42,FMN 16 Noorderlaanbrug
676,Noorderlaan,2023-05-14,20:00:00,45,14,31,FMN 16 Noorderlaanbrug
676,Noorderlaan,2023-05-14,21:00:00,34,13,21,FMN 16 Noorderlaanbrug
676,Noorderlaan,2023-05-14,22:00:00,35,16,19,FMN 16 Noorderlaanbrug
676,Noorderlaan,2023-05-14,23:00:00,19,4,15,FMN 16 Noorderlaanbrug
676,Noorderlaan,2023-05-15,00:00:00,0,0,0,FMN 16 Noorderlaanbrug
676,Noorderlaan,2023-05-15,01:00:00,7,2,5,FMN 16 Noorderlaanbrug
676,Noorderlaan,2023-05-15,02:00:00,1,1,0,FMN 16 Noorderlaanbrug
676,Noorderlaan,2023-05-15,03:00:00,6,3,3,FMN 16 Noorderlaanbrug
676,Noorderlaan,2023-05-15,04:00:00,21,13,8,FMN 16 Noorderlaanbrug
676,Noorderlaan,2023-05-15,05:00:00,76,33,43,FMN 16 Noorderlaanbrug
676,Noorderlaan,2023-05-15,06:00:00,101,53,48,FMN 16 Noorderlaanbrug
676,Noorderlaan,2023-05-15,07:00:00,255,164,91,FMN 16 Noorderlaanbrug
676,Noorderlaan,2023-05-15,08:00:00,371,264,107,FMN 16 Noorderlaanbrug
676,Noorderlaan,2023-05-15,09:00:00,124,81,43,FMN 16 Noorderlaanbrug
676,Noorderlaan,2023-05-15,10:00:00,73,49,24,FMN 16 Noorderlaanbrug
676,Noorderlaan,2023-05-15,11:00:00,80,48,32,FMN 16 Noorderlaanbrug
676,Noorderlaan,2023-05-15,12:00:00,114,60,54,FMN 16 Noorderlaanbrug
676,Noorderlaan,2023-05-15,13:00:00,127,71,56,FMN 16 Noorderlaanbrug
676,Noorderlaan,2023-05-15,14:00:00,138,83,55,FMN 16 Noorderlaanbrug
676,Noorderlaan,2023-05-15,15:00:00,177,78,99,FMN 16 Noorderlaanbrug
676,Noorderlaan,2023-05-15,16:00:00,326,160,166,FMN 16 Noorderlaanbrug
676,Noorderlaan,2023-05-15,17:00:00,344,156,188,FMN 16 Noorderlaanbrug
676,Noorderlaan,2023-05-15,18:00:00,165,79,86,FMN 16 Noorderlaanbrug
676,Noorderlaan,2023-05-15,19:00:00,62,35,27,FMN 16 Noorderlaanbrug
676,Noorderlaan,2023-05-15,20:00:00,51,26,25,FMN 16 Noorderlaanbrug
676,Noorderlaan,2023-05-15,21:00:00,37,19,18,FMN 16 Noorderlaanbrug
676,Noorderlaan,2023-05-15,22:00:00,52,32,20,FMN 16 Noorderlaanbrug
676,Noorderlaan,2023-05-15,23:00:00,24,14,10,FMN 16 Noorderlaanbrug
676,Noorderlaan,2023-05-16,00:00:00,8,4,4,FMN 16 Noorderlaanbrug
676,Noorderlaan,2023-05-16,01:00:00,10,3,7,FMN 16 Noorderlaanbrug
676,Noorderlaan,2023-05-16,02:00:00,2,1,1,FMN 16 Noorderlaanbrug
676,Noorderlaan,2023-05-16,03:00:00,6,5,1,FMN 16 Noorderlaanbrug
676,Noorderlaan,2023-05-16,04:00:00,31,19,12,FMN 16 Noorderlaanbrug
676,Noorderlaan,2023-05-16,05:00:00,87,37,50,FMN 16 Noorderlaanbrug
676,Noorderlaan,2023-05-16,06:00:00,130,58,72,FMN 16 Noorderlaanbrug
676,Noorderlaan,2023-05-16,07:00:00,272,160,112,FMN 16 Noorderlaanbrug
676,Noorderlaan,2023-05-16,08:00:00,361,236,125,FMN 16 Noorderlaanbrug
676,Noorderlaan,2023-05-16,09:00:00,125,79,46,FMN 16 Noorderlaanbrug
676,Noorderlaan,2023-05-16,10:00:00,82,54,28,FMN 16 Noorderlaanbrug
676,Noorderlaan,2023-05-16,11:00:00,87,40,47,FMN 16 Noorderlaanbrug
676,Noorderlaan,2023-05-16,12:00:00,121,59,62,FMN 16 Noorderlaanbrug
676,Noorderlaan,2023-05-16,13:00:00,117,51,66,FMN 16 Noorderlaanbrug
676,Noorderlaan,2023-05-16,14:00:00,135,71,64,FMN 16 Noorderlaanbrug
676,Noorderlaan,2023-05-16,15:00:00,189,90,99,FMN 16 Noorderlaanbrug
676,Noorderlaan,2023-05-16,16:00:00,320,149,171,FMN 16 Noorderlaanbrug
676,Noorderlaan,2023-05-16,17:00:00,343,146,197,FMN 16 Noorderlaanbrug
676,Noorderlaan,2023-05-16,18:00:00,216,78,138,FMN 16 Noorderlaanbrug
676,Noorderlaan,2023-05-16,19:00:00,90,38,52,FMN 16 Noorderlaanbrug
676,Noorderlaan,2023-05-16,20:00:00,46,23,23,FMN 16 Noorderlaanbrug
676,Noorderlaan,2023-05-16,21:00:00,39,16,23,FMN 16 Noorderlaanbrug
676,Noorderlaan,2023-05-16,22:00:00,56,33,23,FMN 16 Noorderlaanbrug
676,Noorderlaan,2023-05-16,23:00:00,21,12,9,FMN 16 Noorderlaanbrug
676,Noorderlaan,2023-05-17,00:00:00,19,8,11,FMN 16 Noorderlaanbrug
676,Noorderlaan,2023-05-17,01:00:00,7,4,3,FMN 16 Noorderlaanbrug
676,Noorderlaan,2023-05-17,02:00:00,8,4,4,FMN 16 Noorderlaanbrug
676,Noorderlaan,2023-05-17,03:00:00,9,7,2,FMN 16 Noorderlaanbrug
676,Noorderlaan,2023-05-17,04:00:00,23,12,11,FMN 16 Noorderlaanbrug
676,Noorderlaan,2023-05-17,05:00:00,55,17,38,FMN 16 Noorderlaanbrug
676,Noorderlaan,2023-05-17,06:00:00,116,66,50,FMN 16 Noorderlaanbrug
676,Noorderlaan,2023-05-17,07:00:00,296,183,113,FMN 16 Noorderlaanbrug
676,Noorderlaan,2023-05-17,08:00:00,401,260,141,FMN 16 Noorderlaanbrug
676,Noorderlaan,2023-05-17,09:00:00,144,99,45,FMN 16 Noorderlaanbrug
676,Noorderlaan,2023-05-17,10:00:00,123,87,36,FMN 16 Noorderlaanbrug
676,Noorderlaan,2023-05-17,11:00:00,115,68,47,FMN 16 Noorderlaanbrug
676,Noorderlaan,2023-05-17,12:00:00,202,108,94,FMN 16 Noorderlaanbrug
676,Noorderlaan,2023-05-17,13:00:00,210,113,97,FMN 16 Noorderlaanbrug
676,Noorderlaan,2023-05-17,14:00:00,190,115,75,FMN 16 Noorderlaanbrug
676,Noorderlaan,2023-05-17,15:00:00,193,113,80,FMN 16 Noorderlaanbrug
676,Noorderlaan,2023-05-17,16:00:00,302,168,134,FMN 16 Noorderlaanbrug
676,Noorderlaan,2023-05-17,17:00:00,333,198,135,FMN 16 Noorderlaanbrug
676,Noorderlaan,2023-05-17,18:00:00,240,145,95,FMN 16 Noorderlaanbrug
676,Noorderlaan,2023-05-17,19:00:00,118,66,52,FMN 16 Noorderlaanbrug
676,Noorderlaan,2023-05-17,20:00:00,85,48,37,FMN 16 Noorderlaanbrug
676,Noorderlaan,2023-05-17,21:00:00,79,51,28,FMN 16 Noorderlaanbrug
676,Noorderlaan,2023-05-17,22:00:00,86,50,36,FMN 16 Noorderlaanbrug
676,Noorderlaan,2023-05-17,23:00:00,58,21,37,FMN 16 Noorderlaanbrug
676,Noorderlaan,2023-05-18,00:00:00,40,13,27,FMN 16 Noorderlaanbrug
676,Noorderlaan,2023-05-18,01:00:00,39,11,28,FMN 16 Noorderlaanbrug
676,Noorderlaan,2023-05-18,02:00:00,25,10,15,FMN 16 Noorderlaanbrug
676,Noorderlaan,2023-05-18,03:00:00,23,14,9,FMN 16 Noorderlaanbrug
676,Noorderlaan,2023-05-18,04:00:00,22,15,7,FMN 16 Noorderlaanbrug
676,Noorderlaan,2023-05-18,05:00:00,28,12,16,FMN 16 Noorderlaanbrug
676,Noorderlaan,2023-05-18,06:00:00,36,22,14,FMN 16 Noorderlaanbrug
676,Noorderlaan,2023-05-18,07:00:00,34,18,16,FMN 16 Noorderlaanbrug
676,Noorderlaan,2023-05-18,08:00:00,39,28,11,FMN 16 Noorderlaanbrug
676,Noorderlaan,2023-05-18,09:00:00,74,55,19,FMN 16 Noorderlaanbrug
676,Noorderlaan,2023-05-18,10:00:00,88,70,18,FMN 16 Noorderlaanbrug
676,Noorderlaan,2023-05-18,11:00:00,116,74,42,FMN 16 Noorderlaanbrug
676,Noorderlaan,2023-05-18,12:00:00,85,56,29,FMN 16 Noorderlaanbrug
676,Noorderlaan,2023-05-18,13:00:00,160,102,58,FMN 16 Noorderlaanbrug
676,Noorderlaan,2023-05-18,14:00:00,130,87,43,FMN 16 Noorderlaanbrug
676,Noorderlaan,2023-05-18,15:00:00,112,57,55,FMN 16 Noorderlaanbrug
676,Noorderlaan,2023-05-18,16:00:00,93,61,32,FMN 16 Noorderlaanbrug
676,Noorderlaan,2023-05-18,17:00:00,121,71,50,FMN 16 Noorderlaanbrug
676,Noorderlaan,2023-05-18,18:00:00,138,84,54,FMN 16 Noorderlaanbrug
676,Noorderlaan,2023-05-18,19:00:00,124,74,50,FMN 16 Noorderlaanbrug
676,Noorderlaan,2023-05-18,20:00:00,72,31,41,FMN 16 Noorderlaanbrug
676,Noorderlaan,2023-05-18,21:00:00,56,32,24,FMN 16 Noorderlaanbrug
676,Noorderlaan,2023-05-18,22:00:00,67,27,40,FMN 16 Noorderlaanbrug
676,Noorderlaan,2023-05-18,23:00:00,38,19,19,FMN 16 Noorderlaanbrug
676,Noorderlaan,2023-05-19,00:00:00,34,16,18,FMN 16 Noorderlaanbrug
676,Noorderlaan,2023-05-19,01:00:00,21,9,12,FMN 16 Noorderlaanbrug
676,Noorderlaan,2023-05-19,02:00:00,6,4,2,FMN 16 Noorderlaanbrug
676,Noorderlaan,2023-05-19,03:00:00,11,5,6,FMN 16 Noorderlaanbrug
676,Noorderlaan,2023-05-19,04:00:00,18,5,13,FMN 16 Noorderlaanbrug
676,Noorderlaan,2023-05-19,05:00:00,41,17,24,FMN 16 Noorderlaanbrug
676,Noorderlaan,2023-05-19,06:00:00,70,33,37,FMN 16 Noorderlaanbrug
676,Noorderlaan,2023-05-19,07:00:00,120,66,54,FMN 16 Noorderlaanbrug
676,Noorderlaan,2023-05-19,08:00:00,137,78,59,FMN 16 Noorderlaanbrug
676,Noorderlaan,2023-05-19,09:00:00,111,69,42,FMN 16 Noorderlaanbrug
676,Noorderlaan,2023-05-19,10:00:00,129,90,39,FMN 16 Noorderlaanbrug
676,Noorderlaan,2023-05-19,11:00:00,125,69,56,FMN 16 Noorderlaanbrug
676,Noorderlaan,2023-05-19,12:00:00,149,106,43,FMN 16 Noorderlaanbrug
676,Noorderlaan,2023-05-19,13:00:00,191,130,61,FMN 16 Noorderlaanbrug
676,Noorderlaan,2023-05-19,14:00:00,218,143,75,FMN 16 Noorderlaanbrug
676,Noorderlaan,2023-05-19,15:00:00,207,129,78,FMN 16 Noorderlaanbrug
676,Noorderlaan,2023-05-19,16:00:00,230,149,81,FMN 16 Noorderlaanbrug
676,Noorderlaan,2023-05-19,17:00:00,222,130,92,FMN 16 Noorderlaanbrug
676,Noorderlaan,2023-05-19,18:00:00,178,109,69,FMN 16 Noorderlaanbrug
676,Noorderlaan,2023-05-19,19:00:00,130,72,58,FMN 16 Noorderlaanbrug
676,Noorderlaan,2023-05-19,20:00:00,98,55,43,FMN 16 Noorderlaanbrug
676,Noorderlaan,2023-05-19,21:00:00,53,30,23,FMN 16 Noorderlaanbrug
676,Noorderlaan,2023-05-19,22:00:00,99,42,57,FMN 16 Noorderlaanbrug
676,Noorderlaan,2023-05-19,23:00:00,63,35,28,FMN 16 Noorderlaanbrug
676,Noorderlaan,2023-05-20,00:00:00,58,35,23,FMN 16 Noorderlaanbrug
676,Noorderlaan,2023-05-20,01:00:00,31,13,18,FMN 16 Noorderlaanbrug
676,Noorderlaan,2023-05-20,02:00:00,16,8,8,FMN 16 Noorderlaanbrug
676,Noorderlaan,2023-05-20,03:00:00,17,10,7,FMN 16 Noorderlaanbrug
676,Noorderlaan,2023-05-20,04:00:00,12,5,7,FMN 16 Noorderlaanbrug
676,Noorderlaan,2023-05-20,05:00:00,29,11,18,FMN 16 Noorderlaanbrug
676,Noorderlaan,2023-05-20,06:00:00,24,13,11,FMN 16 Noorderlaanbrug
676,Noorderlaan,2023-05-20,07:00:00,33,19,14,FMN 16 Noorderlaanbrug
676,Noorderlaan,2023-05-20,08:00:00,38,27,11,FMN 16 Noorderlaanbrug
676,Noorderlaan,2023-05-20,09:00:00,79,60,19,FMN 16 Noorderlaanbrug
676,Noorderlaan,2023-05-20,10:00:00,103,79,24,FMN 16 Noorderlaanbrug
676,Noorderlaan,2023-05-20,11:00:00,128,89,39,FMN 16 Noorderlaanbrug
676,Noorderlaan,2023-05-20,12:00:00,162,113,49,FMN 16 Noorderlaanbrug
676,Noorderlaan,2023-05-20,13:00:00,187,110,77,FMN 16 Noorderlaanbrug
676,Noorderlaan,2023-05-20,14:00:00,172,102,70,FMN 16 Noorderlaanbrug
676,Noorderlaan,2023-05-20,15:00:00,152,80,72,FMN 16 Noorderlaanbrug
676,Noorderlaan,2023-05-20,16:00:00,166,90,76,FMN 16 Noorderlaanbrug
676,Noorderlaan,2023-05-20,17:00:00,160,91,69,FMN 16 Noorderlaanbrug
676,Noorderlaan,2023-05-20,18:00:00,155,72,83,FMN 16 Noorderlaanbrug
676,Noorderlaan,2023-05-20,19:00:00,93,50,43,FMN 16 Noorderlaanbrug
676,Noorderlaan,2023-05-20,20:00:00,64,43,21,FMN 16 Noorderlaanbrug
676,Noorderlaan,2023-05-20,21:00:00,51,27,24,FMN 16 Noorderlaanbrug
676,Noorderlaan,2023-05-20,22:00:00,84,33,51,FMN 16 Noorderlaanbrug
676,Noorderlaan,2023-05-20,23:00:00,58,34,24,FMN 16 Noorderlaanbrug
676,Noorderlaan,2023-05-21,00:00:00,77,27,50,FMN 16 Noorderlaanbrug
676,Noorderlaan,2023-05-21,01:00:00,35,21,14,FMN 16 Noorderlaanbrug
676,Noorderlaan,2023-05-21,02:00:00,20,8,12,FMN 16 Noorderlaanbrug
676,Noorderlaan,2023-05-21,03:00:00,7,1,6,FMN 16 Noorderlaanbrug
676,Noorderlaan,2023-05-21,04:00:00,11,3,8,FMN 16 Noorderlaanbrug
676,Noorderlaan,2023-05-21,05:00:00,22,10,12,FMN 16 Noorderlaanbrug
676,Noorderlaan,2023-05-21,06:00:00,24,11,13,FMN 16 Noorderlaanbrug
676,Noorderlaan,2023-05-21,07:00:00,29,16,13,FMN 16 Noorderlaanbrug
676,Noorderlaan,2023-05-21,08:00:00,46,31,15,FMN 16 Noorderlaanbrug
676,Noorderlaan,2023-05-21,09:00:00,69,42,27,FMN 16 Noorderlaanbrug
676,Noorderlaan,2023-05-21,10:00:00,79,62,17,FMN 16 Noorderlaanbrug
676,Noorderlaan,2023-05-21,11:00:00,122,93,29,FMN 16 Noorderlaanbrug
676,Noorderlaan,2023-05-21,12:00:00,143,100,43,FMN 16 Noorderlaanbrug
676,Noorderlaan,2023-05-21,13:00:00,122,81,41,FMN 16 Noorderlaanbrug
676,Noorderlaan,2023-05-21,14:00:00,117,85,32,FMN 16 Noorderlaanbrug
676,Noorderlaan,2023-05-21,15:00:00,99,60,39,FMN 16 Noorderlaanbrug
676,Noorderlaan,2023-05-21,16:00:00,102,61,41,FMN 16 Noorderlaanbrug
676,Noorderlaan,2023-05-21,17:00:00,109,58,51,FMN 16 Noorderlaanbrug
676,Noorderlaan,2023-05-21,18:00:00,103,58,45,FMN 16 Noorderlaanbrug
676,Noorderlaan,2023-05-21,19:00:00,74,35,39,FMN 16 Noorderlaanbrug
676,Noorderlaan,2023-05-21,20:00:00,62,26,36,FMN 16 Noorderlaanbrug
676,Noorderlaan,2023-05-21,21:00:00,50,26,24,FMN 16 Noorderlaanbrug
676,Noorderlaan,2023-05-21,22:00:00,61,28,33,FMN 16 Noorderlaanbrug
676,Noorderlaan,2023-05-21,23:00:00,31,18,13,FMN 16 Noorderlaanbrug
676,Noorderlaan,2023-05-22,00:00:00,18,11,7,FMN 16 Noorderlaanbrug
676,Noorderlaan,2023-05-22,01:00:00,10,3,7,FMN 16 Noorderlaanbrug
676,Noorderlaan,2023-05-22,02:00:00,6,3,3,FMN 16 Noorderlaanbrug
676,Noorderlaan,2023-05-22,03:00:00,8,6,2,FMN 16 Noorderlaanbrug
676,Noorderlaan,2023-05-22,04:00:00,29,15,14,FMN 16 Noorderlaanbrug
676,Noorderlaan,2023-05-22,05:00:00,76,36,40,FMN 16 Noorderlaanbrug
676,Noorderlaan,2023-05-22,06:00:00,152,96,56,FMN 16 Noorderlaanbrug
676,Noorderlaan,2023-05-22,07:00:00,393,263,130,FMN 16 Noorderlaanbrug
676,Noorderlaan,2023-05-22,08:00:00,516,380,136,FMN 16 Noorderlaanbrug
676,Noorderlaan,2023-05-22,09:00:00,175,128,47,FMN 16 Noorderlaanbrug
676,Noorderlaan,2023-05-22,10:00:00,115,79,36,FMN 16 Noorderlaanbrug
676,Noorderlaan,2023-05-22,11:00:00,112,64,48,FMN 16 Noorderlaanbrug
676,Noorderlaan,2023-05-22,12:00:00,188,107,81,FMN 16 Noorderlaanbrug
676,Noorderlaan,2023-05-22,13:00:00,148,81,67,FMN 16 Noorderlaanbrug
676,Noorderlaan,2023-05-22,14:00:00,193,110,83,FMN 16 Noorderlaanbrug
676,Noorderlaan,2023-05-22,15:00:00,211,115,96,FMN 16 Noorderlaanbrug
676,Noorderlaan,2023-05-22,16:00:00,436,219,217,FMN 16 Noorderlaanbrug
676,Noorderlaan,2023-05-22,17:00:00,404,188,216,FMN 16 Noorderlaanbrug
676,Noorderlaan,2023-05-22,18:00:00,243,118,125,FMN 16 Noorderlaanbrug
676,Noorderlaan,2023-05-22,19:00:00,118,65,53,FMN 16 Noorderlaanbrug
676,Noorderlaan,2023-05-22,20:00:00,77,38,39,FMN 16 Noorderlaanbrug
676,Noorderlaan,2023-05-22,21:00:00,64,30,34,FMN 16 Noorderlaanbrug
676,Noorderlaan,2023-05-22,22:00:00,67,35,32,FMN 16 Noorderlaanbrug
676,Noorderlaan,2023-05-22,23:00:00,40,17,23,FMN 16 Noorderlaanbrug
676,Noorderlaan,2023-05-23,00:00:00,19,10,9,FMN 16 Noorderlaanbrug
676,Noorderlaan,2023-05-23,01:00:00,6,4,2,FMN 16 Noorderlaanbrug
676,Noorderlaan,2023-05-23,02:00:00,4,3,1,FMN 16 Noorderlaanbrug
676,Noorderlaan,2023-05-23,03:00:00,9,8,1,FMN 16 Noorderlaanbrug
676,Noorderlaan,2023-05-23,04:00:00,31,18,13,FMN 16 Noorderlaanbrug
676,Noorderlaan,2023-05-23,05:00:00,83,28,55,FMN 16 Noorderlaanbrug
676,Noorderlaan,2023-05-23,06:00:00,155,85,70,FMN 16 Noorderlaanbrug
676,Noorderlaan,2023-05-23,07:00:00,395,268,127,FMN 16 Noorderlaanbrug
676,Noorderlaan,2023-05-23,08:00:00,514,358,156,FMN 16 Noorderlaanbrug
676,Noorderlaan,2023-05-23,09:00:00,194,140,54,FMN 16 Noorderlaanbrug
676,Noorderlaan,2023-05-23,10:00:00,93,67,26,FMN 16 Noorderlaanbrug
676,Noorderlaan,2023-05-23,11:00:00,105,73,32,FMN 16 Noorderlaanbrug
676,Noorderlaan,2023-05-23,12:00:00,179,101,78,FMN 16 Noorderlaanbrug
676,Noorderlaan,2023-05-23,13:00:00,156,90,66,FMN 16 Noorderlaanbrug
676,Noorderlaan,2023-05-23,14:00:00,165,103,62,FMN 16 Noorderlaanbrug
676,Noorderlaan,2023-05-23,15:00:00,226,111,115,FMN 16 Noorderlaanbrug
676,Noorderlaan,2023-05-23,16:00:00,407,211,196,FMN 16 Noorderlaanbrug
676,Noorderlaan,2023-05-23,17:00:00,450,209,241,FMN 16 Noorderlaanbrug
676,Noorderlaan,2023-05-23,18:00:00,247,126,121,FMN 16 Noorderlaanbrug
676,Noorderlaan,2023-05-23,19:00:00,129,74,55,FMN 16 Noorderlaanbrug
676,Noorderlaan,2023-05-23,20:00:00,79,46,33,FMN 16 Noorderlaanbrug
676,Noorderlaan,2023-05-23,21:00:00,66,29,37,FMN 16 Noorderlaanbrug
676,Noorderlaan,2023-05-23,22:00:00,92,45,47,FMN 16 Noorderlaanbrug
676,Noorderlaan,2023-05-23,23:00:00,25,14,11,FMN 16 Noorderlaanbrug
676,Noorderlaan,2023-05-24,00:00:00,18,9,9,FMN 16 Noorderlaanbrug
676,Noorderlaan,2023-05-24,01:00:00,8,3,5,FMN 16 Noorderlaanbrug
676,Noorderlaan,2023-05-24,02:00:00,10,5,5,FMN 16 Noorderlaanbrug
676,Noorderlaan,2023-05-24,03:00:00,11,10,1,FMN 16 Noorderlaanbrug
676,Noorderlaan,2023-05-24,04:00:00,28,12,16,FMN 16 Noorderlaanbrug
676,Noorderlaan,2023-05-24,05:00:00,82,33,49,FMN 16 Noorderlaanbrug
676,Noorderlaan,2023-05-24,06:00:00,142,80,62,FMN 16 Noorderlaanbrug
676,Noorderlaan,2023-05-24,07:00:00,368,244,124,FMN 16 Noorderlaanbrug
676,Noorderlaan,2023-05-24,08:00:00,460,327,133,FMN 16 Noorderlaanbrug
676,Noorderlaan,2023-05-24,09:00:00,163,114,49,FMN 16 Noorderlaanbrug
676,Noorderlaan,2023-05-24,10:00:00,94,64,30,FMN 16 Noorderlaanbrug
676,Noorderlaan,2023-05-24,11:00:00,104,54,50,FMN 16 Noorderlaanbrug
676,Noorderlaan,2023-05-24,12:00:00,187,99,88,FMN 16 Noorderlaanbrug
676,Noorderlaan,2023-05-24,13:00:00,179,77,102,FMN 16 Noorderlaanbrug
676,Noorderlaan,2023-05-24,14:00:00,185,125,60,FMN 16 Noorderlaanbrug
676,Noorderlaan,2023-05-24,15:00:00,207,116,91,FMN 16 Noorderlaanbrug
676,Noorderlaan,2023-05-24,16:00:00,320,182,138,FMN 16 Noorderlaanbrug
676,Noorderlaan,2023-05-24,17:00:00,369,191,178,FMN 16 Noorderlaanbrug
676,Noorderlaan,2023-05-24,18:00:00,230,108,122,FMN 16 Noorderlaanbrug
676,Noorderlaan,2023-05-24,19:00:00,105,54,51,FMN 16 Noorderlaanbrug
676,Noorderlaan,2023-05-24,20:00:00,87,48,39,FMN 16 Noorderlaanbrug
676,Noorderlaan,2023-05-24,21:00:00,66,40,26,FMN 16 Noorderlaanbrug
676,Noorderlaan,2023-05-24,22:00:00,87,53,34,FMN 16 Noorderlaanbrug
676,Noorderlaan,2023-05-24,23:00:00,51,27,24,FMN 16 Noorderlaanbrug
676,Noorderlaan,2023-05-25,00:00:00,19,8,11,FMN 16 Noorderlaanbrug
676,Noorderlaan,2023-05-25,01:00:00,10,5,5,FMN 16 Noorderlaanbrug
676,Noorderlaan,2023-05-25,02:00:00,5,3,2,FMN 16 Noorderlaanbrug
676,Noorderlaan,2023-05-25,03:00:00,10,6,4,FMN 16 Noorderlaanbrug
676,Noorderlaan,2023-05-25,04:00:00,29,18,11,FMN 16 Noorderlaanbrug
676,Noorderlaan,2023-05-25,05:00:00,82,27,55,FMN 16 Noorderlaanbrug
676,Noorderlaan,2023-05-25,06:00:00,140,79,61,FMN 16 Noorderlaanbrug
676,Noorderlaan,2023-05-25,07:00:00,394,253,141,FMN 16 Noorderlaanbrug
676,Noorderlaan,2023-05-25,08:00:00,529,390,139,FMN 16 Noorderlaanbrug
676,Noorderlaan,2023-05-25,09:00:00,192,131,61,FMN 16 Noorderlaanbrug
676,Noorderlaan,2023-05-25,10:00:00,130,98,32,FMN 16 Noorderlaanbrug
676,Noorderlaan,2023-05-25,11:00:00,119,71,48,FMN 16 Noorderlaanbrug
676,Noorderlaan,2023-05-25,12:00:00,163,88,75,FMN 16 Noorderlaanbrug
676,Noorderlaan,2023-05-25,13:00:00,168,95,73,FMN 16 Noorderlaanbrug
676,Noorderlaan,2023-05-25,14:00:00,183,111,72,FMN 16 Noorderlaanbrug
676,Noorderlaan,2023-05-25,15:00:00,224,112,112,FMN 16 Noorderlaanbrug
676,Noorderlaan,2023-05-25,16:00:00,419,205,214,FMN 16 Noorderlaanbrug
676,Noorderlaan,2023-05-25,17:00:00,401,194,207,FMN 16 Noorderlaanbrug
676,Noorderlaan,2023-05-25,18:00:00,225,106,119,FMN 16 Noorderlaanbrug
676,Noorderlaan,2023-05-25,19:00:00,122,67,55,FMN 16 Noorderlaanbrug
676,Noorderlaan,2023-05-25,20:00:00,69,32,37,FMN 16 Noorderlaanbrug
676,Noorderlaan,2023-05-25,21:00:00,75,34,41,FMN 16 Noorderlaanbrug
676,Noorderlaan,2023-05-25,22:00:00,108,62,46,FMN 16 Noorderlaanbrug
676,Noorderlaan,2023-05-25,23:00:00,52,23,29,FMN 16 Noorderlaanbrug
676,Noorderlaan,2023-05-26,00:00:00,31,19,12,FMN 16 Noorderlaanbrug
676,Noorderlaan,2023-05-26,01:00:00,13,7,6,FMN 16 Noorderlaanbrug
676,Noorderlaan,2023-05-26,02:00:00,10,5,5,FMN 16 Noorderlaanbrug
676,Noorderlaan,2023-05-26,03:00:00,10,5,5,FMN 16 Noorderlaanbrug
676,Noorderlaan,2023-05-26,04:00:00,32,19,13,FMN 16 Noorderlaanbrug
676,Noorderlaan,2023-05-26,05:00:00,86,35,51,FMN 16 Noorderlaanbrug
676,Noorderlaan,2023-05-26,06:00:00,123,68,55,FMN 16 Noorderlaanbrug
676,Noorderlaan,2023-05-26,07:00:00,301,200,101,FMN 16 Noorderlaanbrug
676,Noorderlaan,2023-05-26,08:00:00,429,298,131,FMN 16 Noorderlaanbrug
676,Noorderlaan,2023-05-26,09:00:00,207,161,46,FMN 16 Noorderlaanbrug
676,Noorderlaan,2023-05-26,10:00:00,134,79,55,FMN 16 Noorderlaanbrug
676,Noorderlaan,2023-05-26,11:00:00,116,63,53,FMN 16 Noorderlaanbrug
676,Noorderlaan,2023-05-26,12:00:00,123,76,47,FMN 16 Noorderlaanbrug
676,Noorderlaan,2023-05-26,13:00:00,169,86,83,FMN 16 Noorderlaanbrug
676,Noorderlaan,2023-05-26,14:00:00,195,113,82,FMN 16 Noorderlaanbrug
676,Noorderlaan,2023-05-26,15:00:00,271,145,126,FMN 16 Noorderlaanbrug
676,Noorderlaan,2023-05-26,16:00:00,391,206,185,FMN 16 Noorderlaanbrug
676,Noorderlaan,2023-05-26,17:00:00,303,157,146,FMN 16 Noorderlaanbrug
676,Noorderlaan,2023-05-26,18:00:00,196,111,85,FMN 16 Noorderlaanbrug
676,Noorderlaan,2023-05-26,19:00:00,124,76,48,FMN 16 Noorderlaanbrug
676,Noorderlaan,2023-05-26,20:00:00,83,58,25,FMN 16 Noorderlaanbrug
676,Noorderlaan,2023-05-26,21:00:00,81,36,45,FMN 16 Noorderlaanbrug
676,Noorderlaan,2023-05-26,22:00:00,84,43,41,FMN 16 Noorderlaanbrug
676,Noorderlaan,2023-05-26,23:00:00,57,22,35,FMN 16 Noorderlaanbrug
676,Noorderlaan,2023-05-27,00:00:00,70,25,45,FMN 16 Noorderlaanbrug
676,Noorderlaan,2023-05-27,01:00:00,47,15,32,FMN 16 Noorderlaanbrug
676,Noorderlaan,2023-05-27,02:00:00,21,10,11,FMN 16 Noorderlaanbrug
676,Noorderlaan,2023-05-27,03:00:00,20,11,9,FMN 16 Noorderlaanbrug
676,Noorderlaan,2023-05-27,04:00:00,21,12,9,FMN 16 Noorderlaanbrug
676,Noorderlaan,2023-05-27,05:00:00,30,18,12,FMN 16 Noorderlaanbrug
676,Noorderlaan,2023-05-27,06:00:00,42,27,15,FMN 16 Noorderlaanbrug
676,Noorderlaan,2023-05-27,07:00:00,26,11,15,FMN 16 Noorderlaanbrug
676,Noorderlaan,2023-05-27,08:00:00,46,30,16,FMN 16 Noorderlaanbrug
676,Noorderlaan,2023-05-27,09:00:00,94,66,28,FMN 16 Noorderlaanbrug
676,Noorderlaan,2023-05-27,10:00:00,92,64,28,FMN 16 Noorderlaanbrug
676,Noorderlaan,2023-05-27,11:00:00,131,82,49,FMN 16 Noorderlaanbrug
676,Noorderlaan,2023-05-27,12:00:00,134,90,44,FMN 16 Noorderlaanbrug
676,Noorderlaan,2023-05-27,13:00:00,194,129,65,FMN 16 Noorderlaanbrug
676,Noorderlaan,2023-05-27,14:00:00,186,121,65,FMN 16 Noorderlaanbrug
676,Noorderlaan,2023-05-27,15:00:00,204,131,73,FMN 16 Noorderlaanbrug
676,Noorderlaan,2023-05-27,16:00:00,193,99,94,FMN 16 Noorderlaanbrug
676,Noorderlaan,2023-05-27,17:00:00,151,81,70,FMN 16 Noorderlaanbrug
676,Noorderlaan,2023-05-27,18:00:00,155,77,78,FMN 16 Noorderlaanbrug
676,Noorderlaan,2023-05-27,19:00:00,127,70,57,FMN 16 Noorderlaanbrug
676,Noorderlaan,2023-05-27,20:00:00,85,41,44,FMN 16 Noorderlaanbrug
676,Noorderlaan,2023-05-27,21:00:00,68,36,32,FMN 16 Noorderlaanbrug
676,Noorderlaan,2023-05-27,22:00:00,101,52,49,FMN 16 Noorderlaanbrug
676,Noorderlaan,2023-05-27,23:00:00,56,20,36,FMN 16 Noorderlaanbrug
676,Noorderlaan,2023-05-28,00:00:00,68,18,50,FMN 16 Noorderlaanbrug
676,Noorderlaan,2023-05-28,01:00:00,40,17,23,FMN 16 Noorderlaanbrug
676,Noorderlaan,2023-05-28,02:00:00,34,19,15,FMN 16 Noorderlaanbrug
676,Noorderlaan,2023-05-28,03:00:00,34,30,4,FMN 16 Noorderlaanbrug
676,Noorderlaan,2023-05-28,04:00:00,30,12,18,FMN 16 Noorderlaanbrug
676,Noorderlaan,2023-05-28,05:00:00,29,17,12,FMN 16 Noorderlaanbrug
676,Noorderlaan,2023-05-28,06:00:00,43,27,16,FMN 16 Noorderlaanbrug
676,Noorderlaan,2023-05-28,07:00:00,20,11,9,FMN 16 Noorderlaanbrug
676,Noorderlaan,2023-05-28,08:00:00,27,16,11,FMN 16 Noorderlaanbrug
676,Noorderlaan,2023-05-28,09:00:00,71,48,23,FMN 16 Noorderlaanbrug
676,Noorderlaan,2023-05-28,10:00:00,93,72,21,FMN 16 Noorderlaanbrug
676,Noorderlaan,2023-05-28,11:00:00,112,87,25,FMN 16 Noorderlaanbrug
676,Noorderlaan,2023-05-28,12:00:00,131,89,42,FMN 16 Noorderlaanbrug
676,Noorderlaan,2023-05-28,13:00:00,135,98,37,FMN 16 Noorderlaanbrug
676,Noorderlaan,2023-05-28,14:00:00,129,94,35,FMN 16 Noorderlaanbrug
676,Noorderlaan,2023-05-28,15:00:00,118,69,49,FMN 16 Noorderlaanbrug
676,Noorderlaan,2023-05-28,16:00:00,133,57,76,FMN 16 Noorderlaanbrug
676,Noorderlaan,2023-05-28,17:00:00,129,69,60,FMN 16 Noorderlaanbrug
676,Noorderlaan,2023-05-28,18:00:00,121,61,60,FMN 16 Noorderlaanbrug
676,Noorderlaan,2023-05-28,19:00:00,84,53,31,FMN 16 Noorderlaanbrug
676,Noorderlaan,2023-05-28,20:00:00,68,32,36,FMN 16 Noorderlaanbrug
676,Noorderlaan,2023-05-28,21:00:00,65,30,35,FMN 16 Noorderlaanbrug
676,Noorderlaan,2023-05-28,22:00:00,82,46,36,FMN 16 Noorderlaanbrug
676,Noorderlaan,2023-05-28,23:00:00,27,14,13,FMN 16 Noorderlaanbrug
676,Noorderlaan,2023-05-29,00:00:00,45,23,22,FMN 16 Noorderlaanbrug
676,Noorderlaan,2023-05-29,01:00:00,24,10,14,FMN 16 Noorderlaanbrug
676,Noorderlaan,2023-05-29,02:00:00,13,5,8,FMN 16 Noorderlaanbrug
676,Noorderlaan,2023-05-29,03:00:00,10,6,4,FMN 16 Noorderlaanbrug
676,Noorderlaan,2023-05-29,04:00:00,20,13,7,FMN 16 Noorderlaanbrug
676,Noorderlaan,2023-05-29,05:00:00,27,14,13,FMN 16 Noorderlaanbrug
676,Noorderlaan,2023-05-29,06:00:00,30,17,13,FMN 16 Noorderlaanbrug
676,Noorderlaan,2023-05-29,07:00:00,29,18,11,FMN 16 Noorderlaanbrug
676,Noorderlaan,2023-05-29,08:00:00,23,15,8,FMN 16 Noorderlaanbrug
676,Noorderlaan,2023-05-29,09:00:00,59,46,13,FMN 16 Noorderlaanbrug
676,Noorderlaan,2023-05-29,10:00:00,60,44,16,FMN 16 Noorderlaanbrug
676,Noorderlaan,2023-05-29,11:00:00,90,54,36,FMN 16 Noorderlaanbrug
676,Noorderlaan,2023-05-29,12:00:00,78,57,21,FMN 16 Noorderlaanbrug
676,Noorderlaan,2023-05-29,13:00:00,130,91,39,FMN 16 Noorderlaanbrug
676,Noorderlaan,2023-05-29,14:00:00,143,85,58,FMN 16 Noorderlaanbrug
676,Noorderlaan,2023-05-29,15:00:00,105,64,41,FMN 16 Noorderlaanbrug
676,Noorderlaan,2023-05-29,16:00:00,98,42,56,FMN 16 Noorderlaanbrug
676,Noorderlaan,2023-05-29,17:00:00,118,59,59,FMN 16 Noorderlaanbrug
676,Noorderlaan,2023-05-29,18:00:00,83,36,47,FMN 16 Noorderlaanbrug
676,Noorderlaan,2023-05-29,19:00:00,65,37,28,FMN 16 Noorderlaanbrug
676,Noorderlaan,2023-05-29,20:00:00,66,26,40,FMN 16 Noorderlaanbrug
676,Noorderlaan,2023-05-29,21:00:00,49,17,32,FMN 16 Noorderlaanbrug
676,Noorderlaan,2023-05-29,22:00:00,52,32,20,FMN 16 Noorderlaanbrug
676,Noorderlaan,2023-05-29,23:00:00,32,18,14,FMN 16 Noorderlaanbrug
676,Noorderlaan,2023-05-30,00:00:00,11,7,4,FMN 16 Noorderlaanbrug
676,Noorderlaan,2023-05-30,01:00:00,6,4,2,FMN 16 Noorderlaanbrug
676,Noorderlaan,2023-05-30,02:00:00,4,2,2,FMN 16 Noorderlaanbrug
676,Noorderlaan,2023-05-30,03:00:00,1,1,0,FMN 16 Noorderlaanbrug
676,Noorderlaan,2023-05-30,04:00:00,19,10,9,FMN 16 Noorderlaanbrug
676,Noorderlaan,2023-05-30,05:00:00,75,30,45,FMN 16 Noorderlaanbrug
676,Noorderlaan,2023-05-30,06:00:00,168,104,64,FMN 16 Noorderlaanbrug
676,Noorderlaan,2023-05-30,07:00:00,410,282,128,FMN 16 Noorderlaanbrug
676,Noorderlaan,2023-05-30,08:00:00,499,363,136,FMN 16 Noorderlaanbrug
676,Noorderlaan,2023-05-30,09:00:00,184,138,46,FMN 16 Noorderlaanbrug
676,Noorderlaan,2023-05-30,10:00:00,130,80,50,FMN 16 Noorderlaanbrug
676,Noorderlaan,2023-05-30,11:00:00,129,91,38,FMN 16 Noorderlaanbrug
676,Noorderlaan,2023-05-30,12:00:00,174,103,71,FMN 16 Noorderlaanbrug
676,Noorderlaan,2023-05-30,13:00:00,177,82,95,FMN 16 Noorderlaanbrug
676,Noorderlaan,2023-05-30,14:00:00,187,113,74,FMN 16 Noorderlaanbrug
676,Noorderlaan,2023-05-30,15:00:00,217,113,104,FMN 16 Noorderlaanbrug
676,Noorderlaan,2023-05-30,16:00:00,435,227,208,FMN 16 Noorderlaanbrug
676,Noorderlaan,2023-05-30,17:00:00,408,193,215,FMN 16 Noorderlaanbrug
676,Noorderlaan,2023-05-30,18:00:00,236,105,131,FMN 16 Noorderlaanbrug
676,Noorderlaan,2023-05-30,19:00:00,123,69,54,FMN 16 Noorderlaanbrug
676,Noorderlaan,2023-05-30,20:00:00,69,40,29,FMN 16 Noorderlaanbrug
676,Noorderlaan,2023-05-30,21:00:00,64,29,35,FMN 16 Noorderlaanbrug
676,Noorderlaan,2023-05-30,22:00:00,88,57,31,FMN 16 Noorderlaanbrug
676,Noorderlaan,2023-05-30,23:00:00,33,17,16,FMN 16 Noorderlaanbrug
676,Noorderlaan,2023-05-31,00:00:00,13,3,10,FMN 16 Noorderlaanbrug
676,Noorderlaan,2023-05-31,01:00:00,9,4,5,FMN 16 Noorderlaanbrug
676,Noorderlaan,2023-05-31,02:00:00,5,4,1,FMN 16 Noorderlaanbrug
676,Noorderlaan,2023-05-31,03:00:00,6,5,1,FMN 16 Noorderlaanbrug
676,Noorderlaan,2023-05-31,04:00:00,27,16,11,FMN 16 Noorderlaanbrug
676,Noorderlaan,2023-05-31,05:00:00,78,25,53,FMN 16 Noorderlaanbrug
676,Noorderlaan,2023-05-31,06:00:00,147,76,71,FMN 16 Noorderlaanbrug
676,Noorderlaan,2023-05-31,07:00:00,429,272,157,FMN 16 Noorderlaanbrug
676,Noorderlaan,2023-05-31,08:00:00,437,309,128,FMN 16 Noorderlaanbrug
676,Noorderlaan,2023-05-31,09:00:00,181,127,54,FMN 16 Noorderlaanbrug
676,Noorderlaan,2023-05-31,10:00:00,117,72,45,FMN 16 Noorderlaanbrug
676,Noorderlaan,2023-05-31,11:00:00,136,62,74,FMN 16 Noorderlaanbrug
676,Noorderlaan,2023-05-31,12:00:00,242,123,119,FMN 16 Noorderlaanbrug
676,Noorderlaan,2023-05-31,13:00:00,206,99,107,FMN 16 Noorderlaanbrug
676,Noorderlaan,2023-05-31,14:00:00,207,125,82,FMN 16 Noorderlaanbrug
676,Noorderlaan,2023-05-31,15:00:00,238,127,111,FMN 16 Noorderlaanbrug
676,Noorderlaan,2023-05-31,16:00:00,356,192,164,FMN 16 Noorderlaanbrug
676,Noorderlaan,2023-05-31,17:00:00,418,225,193,FMN 16 Noorderlaanbrug
676,Noorderlaan,2023-05-31,18:00:00,232,121,111,FMN 16 Noorderlaanbrug
676,Noorderlaan,2023-05-31,19:00:00,147,82,65,FMN 16 Noorderlaanbrug
676,Noorderlaan,2023-05-31,20:00:00,99,59,40,FMN 16 Noorderlaanbrug
676,Noorderlaan,2023-05-31,21:00:00,91,50,41,FMN 16 Noorderlaanbrug
676,Noorderlaan,2023-05-31,22:00:00,123,68,55,FMN 16 Noorderlaanbrug
676,Noorderlaan,2023-05-31,23:00:00,62,24,38,FMN 16 Noorderlaanbrug
676,Noorderlaan,2023-06-01,00:00:00,20,6,14,FMN 16 Noorderlaanbrug
676,Noorderlaan,2023-06-01,01:00:00,14,5,9,FMN 16 Noorderlaanbrug
676,Noorderlaan,2023-06-01,02:00:00,6,3,3,FMN 16 Noorderlaanbrug
676,Noorderlaan,2023-06-01,03:00:00,7,7,0,FMN 16 Noorderlaanbrug
676,Noorderlaan,2023-06-01,04:00:00,32,18,14,FMN 16 Noorderlaanbrug
676,Noorderlaan,2023-06-01,05:00:00,93,38,55,FMN 16 Noorderlaanbrug
676,Noorderlaan,2023-06-01,06:00:00,152,97,55,FMN 16 Noorderlaanbrug
676,Noorderlaan,2023-06-01,07:00:00,394,257,137,FMN 16 Noorderlaanbrug
676,Noorderlaan,2023-06-01,08:00:00,515,372,143,FMN 16 Noorderlaanbrug
676,Noorderlaan,2023-06-01,09:00:00,191,140,51,FMN 16 Noorderlaanbrug
676,Noorderlaan,2023-06-01,10:00:00,110,62,48,FMN 16 Noorderlaanbrug
676,Noorderlaan,2023-06-01,11:00:00,126,78,48,FMN 16 Noorderlaanbrug
676,Noorderlaan,2023-06-01,12:00:00,169,92,77,FMN 16 Noorderlaanbrug
676,Noorderlaan,2023-06-01,13:00:00,163,71,92,FMN 16 Noorderlaanbrug
676,Noorderlaan,2023-06-01,14:00:00,184,103,81,FMN 16 Noorderlaanbrug
676,Noorderlaan,2023-06-01,15:00:00,270,162,108,FMN 16 Noorderlaanbrug
676,Noorderlaan,2023-06-01,16:00:00,437,224,213,FMN 16 Noorderlaanbrug
676,Noorderlaan,2023-06-01,17:00:00,395,203,192,FMN 16 Noorderlaanbrug
676,Noorderlaan,2023-06-01,18:00:00,237,118,119,FMN 16 Noorderlaanbrug
676,Noorderlaan,2023-06-01,19:00:00,129,78,51,FMN 16 Noorderlaanbrug
676,Noorderlaan,2023-06-01,20:00:00,84,45,39,FMN 16 Noorderlaanbrug
676,Noorderlaan,2023-06-01,21:00:00,56,35,21,FMN 16 Noorderlaanbrug
676,Noorderlaan,2023-06-01,22:00:00,81,54,27,FMN 16 Noorderlaanbrug
676,Noorderlaan,2023-06-01,23:00:00,42,19,23,FMN 16 Noorderlaanbrug
676,Noorderlaan,2023-06-02,00:00:00,29,11,18,FMN 16 Noorderlaanbrug
676,Noorderlaan,2023-06-02,01:00:00,18,8,10,FMN 16 Noorderlaanbrug
676,Noorderlaan,2023-06-02,02:00:00,5,3,2,FMN 16 Noorderlaanbrug
676,Noorderlaan,2023-06-02,03:00:00,9,6,3,FMN 16 Noorderlaanbrug
676,Noorderlaan,2023-06-02,04:00:00,23,12,11,FMN 16 Noorderlaanbrug
676,Noorderlaan,2023-06-02,05:00:00,76,31,45,FMN 16 Noorderlaanbrug
676,Noorderlaan,2023-06-02,06:00:00,124,67,57,FMN 16 Noorderlaanbrug
676,Noorderlaan,2023-06-02,07:00:00,321,216,105,FMN 16 Noorderlaanbrug
676,Noorderlaan,2023-06-02,08:00:00,420,300,120,FMN 16 Noorderlaanbrug
676,Noorderlaan,2023-06-02,09:00:00,166,121,45,FMN 16 Noorderlaanbrug
676,Noorderlaan,2023-06-02,10:00:00,140,88,52,FMN 16 Noorderlaanbrug
676,Noorderlaan,2023-06-02,11:00:00,167,119,48,FMN 16 Noorderlaanbrug
676,Noorderlaan,2023-06-02,12:00:00,150,88,62,FMN 16 Noorderlaanbrug
676,Noorderlaan,2023-06-02,13:00:00,165,84,81,FMN 16 Noorderlaanbrug
676,Noorderlaan,2023-06-02,14:00:00,186,114,72,FMN 16 Noorderlaanbrug
676,Noorderlaan,2023-06-02,15:00:00,229,130,99,FMN 16 Noorderlaanbrug
676,Noorderlaan,2023-06-02,16:00:00,393,226,167,FMN 16 Noorderlaanbrug
676,Noorderlaan,2023-06-02,17:00:00,325,162,163,FMN 16 Noorderlaanbrug
676,Noorderlaan,2023-06-02,18:00:00,208,115,93,FMN 16 Noorderlaanbrug
676,Noorderlaan,2023-06-02,19:00:00,133,84,49,FMN 16 Noorderlaanbrug
676,Noorderlaan,2023-06-02,20:00:00,103,52,51,FMN 16 Noorderlaanbrug
676,Noorderlaan,2023-06-02,21:00:00,96,38,58,FMN 16 Noorderlaanbrug
676,Noorderlaan,2023-06-02,22:00:00,111,52,59,FMN 16 Noorderlaanbrug
676,Noorderlaan,2023-06-02,23:00:00,98,42,56,FMN 16 Noorderlaanbrug
676,Noorderlaan,2023-06-03,00:00:00,58,31,27,FMN 16 Noorderlaanbrug
676,Noorderlaan,2023-06-03,01:00:00,35,11,24,FMN 16 Noorderlaanbrug
676,Noorderlaan,2023-06-03,02:00:00,21,5,16,FMN 16 Noorderlaanbrug
676,Noorderlaan,2023-06-03,03:00:00,21,11,10,FMN 16 Noorderlaanbrug
676,Noorderlaan,2023-06-03,04:00:00,19,10,9,FMN 16 Noorderlaanbrug
676,Noorderlaan,2023-06-03,05:00:00,32,16,16,FMN 16 Noorderlaanbrug
676,Noorderlaan,2023-06-03,06:00:00,40,20,20,FMN 16 Noorderlaanbrug
676,Noorderlaan,2023-06-03,07:00:00,40,28,12,FMN 16 Noorderlaanbrug
676,Noorderlaan,2023-06-03,08:00:00,41,25,16,FMN 16 Noorderlaanbrug
676,Noorderlaan,2023-06-03,09:00:00,115,65,50,FMN 16 Noorderlaanbrug
676,Noorderlaan,2023-06-03,10:00:00,117,82,35,FMN 16 Noorderlaanbrug
676,Noorderlaan,2023-06-03,11:00:00,142,87,55,FMN 16 Noorderlaanbrug
676,Noorderlaan,2023-06-03,12:00:00,147,90,57,FMN 16 Noorderlaanbrug
676,Noorderlaan,2023-06-03,13:00:00,209,137,72,FMN 16 Noorderlaanbrug
676,Noorderlaan,2023-06-03,14:00:00,180,123,57,FMN 16 Noorderlaanbrug
676,Noorderlaan,2023-06-03,15:00:00,181,95,86,FMN 16 Noorderlaanbrug
676,Noorderlaan,2023-06-03,16:00:00,165,101,64,FMN 16 Noorderlaanbrug
676,Noorderlaan,2023-06-03,17:00:00,150,84,66,FMN 16 Noorderlaanbrug
676,Noorderlaan,2023-06-03,18:00:00,142,71,71,FMN 16 Noorderlaanbrug
676,Noorderlaan,2023-06-03,19:00:00,138,77,61,FMN 16 Noorderlaanbrug
676,Noorderlaan,2023-06-03,20:00:00,109,63,46,FMN 16 Noorderlaanbrug
676,Noorderlaan,2023-06-03,21:00:00,82,35,47,FMN 16 Noorderlaanbrug
676,Noorderlaan,2023-06-03,22:00:00,72,31,41,FMN 16 Noorderlaanbrug
676,Noorderlaan,2023-06-03,23:00:00,75,44,31,FMN 16 Noorderlaanbrug
676,Noorderlaan,2023-06-04,00:00:00,51,23,28,FMN 16 Noorderlaanbrug
676,Noorderlaan,2023-06-04,01:00:00,61,31,30,FMN 16 Noorderlaanbrug
676,Noorderlaan,2023-06-04,02:00:00,32,17,15,FMN 16 Noorderlaanbrug
676,Noorderlaan,2023-06-04,03:00:00,17,8,9,FMN 16 Noorderlaanbrug
676,Noorderlaan,2023-06-04,04:00:00,9,3,6,FMN 16 Noorderlaanbrug
676,Noorderlaan,2023-06-04,05:00:00,17,6,11,FMN 16 Noorderlaanbrug
676,Noorderlaan,2023-06-04,06:00:00,31,13,18,FMN 16 Noorderlaanbrug
676,Noorderlaan,2023-06-04,07:00:00,29,8,21,FMN 16 Noorderlaanbrug
676,Noorderlaan,2023-06-04,08:00:00,32,20,12,FMN 16 Noorderlaanbrug
676,Noorderlaan,2023-06-04,09:00:00,87,59,28,FMN 16 Noorderlaanbrug
676,Noorderlaan,2023-06-04,10:00:00,102,69,33,FMN 16 Noorderlaanbrug
676,Noorderlaan,2023-06-04,11:00:00,106,76,30,FMN 16 Noorderlaanbrug
676,Noorderlaan,2023-06-04,12:00:00,105,63,42,FMN 16 Noorderlaanbrug
676,Noorderlaan,2023-06-04,13:00:00,123,82,41,FMN 16 Noorderlaanbrug
676,Noorderlaan,2023-06-04,14:00:00,157,99,58,FMN 16 Noorderlaanbrug
676,Noorderlaan,2023-06-04,15:00:00,98,54,44,FMN 16 Noorderlaanbrug
676,Noorderlaan,2023-06-04,16:00:00,131,64,67,FMN 16 Noorderlaanbrug
676,Noorderlaan,2023-06-04,17:00:00,124,58,66,FMN 16 Noorderlaanbrug
676,Noorderlaan,2023-06-04,18:00:00,100,55,45,FMN 16 Noorderlaanbrug
676,Noorderlaan,2023-06-04,19:00:00,77,53,24,FMN 16 Noorderlaanbrug
676,Noorderlaan,2023-06-04,20:00:00,73,49,24,FMN 16 Noorderlaanbrug
676,Noorderlaan,2023-06-04,21:00:00,60,28,32,FMN 16 Noorderlaanbrug
676,Noorderlaan,2023-06-04,22:00:00,48,24,24,FMN 16 Noorderlaanbrug
676,Noorderlaan,2023-06-04,23:00:00,31,15,16,FMN 16 Noorderlaanbrug
676,Noorderlaan,2023-06-05,00:00:00,26,15,11,FMN 16 Noorderlaanbrug
676,Noorderlaan,2023-06-05,01:00:00,9,5,4,FMN 16 Noorderlaanbrug
676,Noorderlaan,2023-06-05,02:00:00,10,5,5,FMN 16 Noorderlaanbrug
676,Noorderlaan,2023-06-05,03:00:00,10,3,7,FMN 16 Noorderlaanbrug
676,Noorderlaan,2023-06-05,04:00:00,40,22,18,FMN 16 Noorderlaanbrug
676,Noorderlaan,2023-06-05,05:00:00,90,35,55,FMN 16 Noorderlaanbrug
676,Noorderlaan,2023-06-05,06:00:00,154,89,65,FMN 16 Noorderlaanbrug
676,Noorderlaan,2023-06-05,07:00:00,389,266,123,FMN 16 Noorderlaanbrug
676,Noorderlaan,2023-06-05,08:00:00,515,391,124,FMN 16 Noorderlaanbrug
676,Noorderlaan,2023-06-05,09:00:00,173,125,48,FMN 16 Noorderlaanbrug
676,Noorderlaan,2023-06-05,10:00:00,111,69,42,FMN 16 Noorderlaanbrug
676,Noorderlaan,2023-06-05,11:00:00,134,93,41,FMN 16 Noorderlaanbrug
676,Noorderlaan,2023-06-05,12:00:00,153,82,71,FMN 16 Noorderlaanbrug
676,Noorderlaan,2023-06-05,13:00:00,160,74,86,FMN 16 Noorderlaanbrug
676,Noorderlaan,2023-06-05,14:00:00,230,126,104,FMN 16 Noorderlaanbrug
676,Noorderlaan,2023-06-05,15:00:00,271,145,126,FMN 16 Noorderlaanbrug
676,Noorderlaan,2023-06-05,16:00:00,467,253,214,FMN 16 Noorderlaanbrug
676,Noorderlaan,2023-06-05,17:00:00,494,305,189,FMN 16 Noorderlaanbrug
676,Noorderlaan,2023-06-05,18:00:00,270,140,130,FMN 16 Noorderlaanbrug
676,Noorderlaan,2023-06-05,19:00:00,138,70,68,FMN 16 Noorderlaanbrug
676,Noorderlaan,2023-06-05,20:00:00,134,43,91,FMN 16 Noorderlaanbrug
676,Noorderlaan,2023-06-05,21:00:00,89,29,60,FMN 16 Noorderlaanbrug
676,Noorderlaan,2023-06-05,22:00:00,100,45,55,FMN 16 Noorderlaanbrug
676,Noorderlaan,2023-06-05,23:00:00,49,22,27,FMN 16 Noorderlaanbrug
676,Noorderlaan,2023-06-06,00:00:00,23,13,10,FMN 16 Noorderlaanbrug
676,Noorderlaan,2023-06-06,01:00:00,10,6,4,FMN 16 Noorderlaanbrug
676,Noorderlaan,2023-06-06,02:00:00,5,4,1,FMN 16 Noorderlaanbrug
676,Noorderlaan,2023-06-06,03:00:00,9,7,2,FMN 16 Noorderlaanbrug
676,Noorderlaan,2023-06-06,04:00:00,32,20,12,FMN 16 Noorderlaanbrug
676,Noorderlaan,2023-06-06,05:00:00,91,32,59,FMN 16 Noorderlaanbrug
676,Noorderlaan,2023-06-06,06:00:00,163,100,63,FMN 16 Noorderlaanbrug
676,Noorderlaan,2023-06-06,07:00:00,410,289,121,FMN 16 Noorderlaanbrug
676,Noorderlaan,2023-06-06,08:00:00,522,372,150,FMN 16 Noorderlaanbrug
676,Noorderlaan,2023-06-06,09:00:00,220,148,72,FMN 16 Noorderlaanbrug
676,Noorderlaan,2023-06-06,10:00:00,140,83,57,FMN 16 Noorderlaanbrug
676,Noorderlaan,2023-06-06,11:00:00,118,72,46,FMN 16 Noorderlaanbrug
676,Noorderlaan,2023-06-06,12:00:00,147,89,58,FMN 16 Noorderlaanbrug
676,Noorderlaan,2023-06-06,13:00:00,187,100,87,FMN 16 Noorderlaanbrug
676,Noorderlaan,2023-06-06,14:00:00,205,127,78,FMN 16 Noorderlaanbrug
676,Noorderlaan,2023-06-06,15:00:00,218,107,111,FMN 16 Noorderlaanbrug
676,Noorderlaan,2023-06-06,16:00:00,456,217,239,FMN 16 Noorderlaanbrug
676,Noorderlaan,2023-06-06,17:00:00,459,214,245,FMN 16 Noorderlaanbrug
676,Noorderlaan,2023-06-06,18:00:00,262,131,131,FMN 16 Noorderlaanbrug
676,Noorderlaan,2023-06-06,19:00:00,117,62,55,FMN 16 Noorderlaanbrug
676,Noorderlaan,2023-06-06,20:00:00,93,50,43,FMN 16 Noorderlaanbrug
676,Noorderlaan,2023-06-06,21:00:00,77,34,43,FMN 16 Noorderlaanbrug
676,Noorderlaan,2023-06-06,22:00:00,103,60,43,FMN 16 Noorderlaanbrug
676,Noorderlaan,2023-06-06,23:00:00,49,29,20,FMN 16 Noorderlaanbrug
676,Noorderlaan,2023-06-07,00:00:00,18,6,12,FMN 16 Noorderlaanbrug
676,Noorderlaan,2023-06-07,01:00:00,10,3,7,FMN 16 Noorderlaanbrug
676,Noorderlaan,2023-06-07,02:00:00,2,1,1,FMN 16 Noorderlaanbrug
676,Noorderlaan,2023-06-07,03:00:00,8,6,2,FMN 16 Noorderlaanbrug
676,Noorderlaan,2023-06-07,04:00:00,34,18,16,FMN 16 Noorderlaanbrug
676,Noorderlaan,2023-06-07,05:00:00,94,33,61,FMN 16 Noorderlaanbrug
676,Noorderlaan,2023-06-07,06:00:00,140,75,65,FMN 16 Noorderlaanbrug
676,Noorderlaan,2023-06-07,07:00:00,375,233,142,FMN 16 Noorderlaanbrug
676,Noorderlaan,2023-06-07,08:00:00,425,297,128,FMN 16 Noorderlaanbrug
676,Noorderlaan,2023-06-07,09:00:00,158,113,45,FMN 16 Noorderlaanbrug
676,Noorderlaan,2023-06-07,10:00:00,118,72,46,FMN 16 Noorderlaanbrug
676,Noorderlaan,2023-06-07,11:00:00,126,80,46,FMN 16 Noorderlaanbrug
676,Noorderlaan,2023-06-07,12:00:00,191,100,91,FMN 16 Noorderlaanbrug
676,Noorderlaan,2023-06-07,13:00:00,212,95,117,FMN 16 Noorderlaanbrug
676,Noorderlaan,2023-06-07,14:00:00,194,127,67,FMN 16 Noorderlaanbrug
676,Noorderlaan,2023-06-07,15:00:00,216,121,95,FMN 16 Noorderlaanbrug
676,Noorderlaan,2023-06-07,16:00:00,350,207,143,FMN 16 Noorderlaanbrug
676,Noorderlaan,2023-06-07,17:00:00,373,196,177,FMN 16 Noorderlaanbrug
676,Noorderlaan,2023-06-07,18:00:00,205,99,106,FMN 16 Noorderlaanbrug
676,Noorderlaan,2023-06-07,19:00:00,143,92,51,FMN 16 Noorderlaanbrug
676,Noorderlaan,2023-06-07,20:00:00,97,54,43,FMN 16 Noorderlaanbrug
676,Noorderlaan,2023-06-07,21:00:00,74,37,37,FMN 16 Noorderlaanbrug
676,Noorderlaan,2023-06-07,22:00:00,107,59,48,FMN 16 Noorderlaanbrug
676,Noorderlaan,2023-06-07,23:00:00,51,17,34,FMN 16 Noorderlaanbrug
676,Noorderlaan,2023-06-08,00:00:00,23,6,17,FMN 16 Noorderlaanbrug
676,Noorderlaan,2023-06-08,01:00:00,6,2,4,FMN 16 Noorderlaanbrug
676,Noorderlaan,2023-06-08,02:00:00,10,5,5,FMN 16 Noorderlaanbrug
676,Noorderlaan,2023-06-08,03:00:00,13,7,6,FMN 16 Noorderlaanbrug
676,Noorderlaan,2023-06-08,04:00:00,32,14,18,FMN 16 Noorderlaanbrug
676,Noorderlaan,2023-06-08,05:00:00,79,26,53,FMN 16 Noorderlaanbrug
676,Noorderlaan,2023-06-08,06:00:00,153,85,68,FMN 16 Noorderlaanbrug
676,Noorderlaan,2023-06-08,07:00:00,424,274,150,FMN 16 Noorderlaanbrug
676,Noorderlaan,2023-06-08,08:00:00,507,351,156,FMN 16 Noorderlaanbrug
676,Noorderlaan,2023-06-08,09:00:00,209,149,60,FMN 16 Noorderlaanbrug
676,Noorderlaan,2023-06-08,10:00:00,140,101,39,FMN 16 Noorderlaanbrug
676,Noorderlaan,2023-06-08,11:00:00,135,75,60,FMN 16 Noorderlaanbrug
676,Noorderlaan,2023-06-08,12:00:00,201,117,84,FMN 16 Noorderlaanbrug
676,Noorderlaan,2023-06-08,13:00:00,209,108,101,FMN 16 Noorderlaanbrug
676,Noorderlaan,2023-06-08,14:00:00,231,134,97,FMN 16 Noorderlaanbrug
676,Noorderlaan,2023-06-08,15:00:00,227,123,104,FMN 16 Noorderlaanbrug
676,Noorderlaan,2023-06-08,16:00:00,422,226,196,FMN 16 Noorderlaanbrug
676,Noorderlaan,2023-06-08,17:00:00,476,244,232,FMN 16 Noorderlaanbrug
676,Noorderlaan,2023-06-08,18:00:00,238,117,121,FMN 16 Noorderlaanbrug
676,Noorderlaan,2023-06-08,19:00:00,150,86,64,FMN 16 Noorderlaanbrug
676,Noorderlaan,2023-06-08,20:00:00,102,58,44,FMN 16 Noorderlaanbrug
676,Noorderlaan,2023-06-08,21:00:00,95,43,52,FMN 16 Noorderlaanbrug
676,Noorderlaan,2023-06-08,22:00:00,112,62,50,FMN 16 Noorderlaanbrug
676,Noorderlaan,2023-06-08,23:00:00,80,39,41,FMN 16 Noorderlaanbrug
676,Noorderlaan,2023-06-09,00:00:00,37,14,23,FMN 16 Noorderlaanbrug
676,Noorderlaan,2023-06-09,01:00:00,14,6,8,FMN 16 Noorderlaanbrug
676,Noorderlaan,2023-06-09,02:00:00,12,5,7,FMN 16 Noorderlaanbrug
676,Noorderlaan,2023-06-09,03:00:00,9,4,5,FMN 16 Noorderlaanbrug
676,Noorderlaan,2023-06-09,04:00:00,30,16,14,FMN 16 Noorderlaanbrug
676,Noorderlaan,2023-06-09,05:00:00,83,25,58,FMN 16 Noorderlaanbrug
676,Noorderlaan,2023-06-09,06:00:00,132,77,55,FMN 16 Noorderlaanbrug
676,Noorderlaan,2023-06-09,07:00:00,324,201,123,FMN 16 Noorderlaanbrug
676,Noorderlaan,2023-06-09,08:00:00,479,330,149,FMN 16 Noorderlaanbrug
676,Noorderlaan,2023-06-09,09:00:00,183,140,43,FMN 16 Noorderlaanbrug
676,Noorderlaan,2023-06-09,10:00:00,145,90,55,FMN 16 Noorderlaanbrug
676,Noorderlaan,2023-06-09,11:00:00,151,109,42,FMN 16 Noorderlaanbrug
676,Noorderlaan,2023-06-09,12:00:00,164,89,75,FMN 16 Noorderlaanbrug
676,Noorderlaan,2023-06-09,13:00:00,191,96,95,FMN 16 Noorderlaanbrug
676,Noorderlaan,2023-06-09,14:00:00,222,126,96,FMN 16 Noorderlaanbrug
676,Noorderlaan,2023-06-09,15:00:00,227,128,99,FMN 16 Noorderlaanbrug
676,Noorderlaan,2023-06-09,16:00:00,412,217,195,FMN 16 Noorderlaanbrug
676,Noorderlaan,2023-06-09,17:00:00,331,179,152,FMN 16 Noorderlaanbrug
676,Noorderlaan,2023-06-09,18:00:00,235,137,98,FMN 16 Noorderlaanbrug
676,Noorderlaan,2023-06-09,19:00:00,161,96,65,FMN 16 Noorderlaanbrug
676,Noorderlaan,2023-06-09,20:00:00,104,57,47,FMN 16 Noorderlaanbrug
676,Noorderlaan,2023-06-09,21:00:00,105,45,60,FMN 16 Noorderlaanbrug
676,Noorderlaan,2023-06-09,22:00:00,113,74,39,FMN 16 Noorderlaanbrug
676,Noorderlaan,2023-06-09,23:00:00,72,35,37,FMN 16 Noorderlaanbrug
676,Noorderlaan,2023-06-10,00:00:00,77,28,49,FMN 16 Noorderlaanbrug
676,Noorderlaan,2023-06-10,01:00:00,40,14,26,FMN 16 Noorderlaanbrug
676,Noorderlaan,2023-06-10,02:00:00,30,10,20,FMN 16 Noorderlaanbrug
676,Noorderlaan,2023-06-10,03:00:00,33,16,17,FMN 16 Noorderlaanbrug
676,Noorderlaan,2023-06-10,04:00:00,20,13,7,FMN 16 Noorderlaanbrug
676,Noorderlaan,2023-06-10,05:00:00,32,10,22,FMN 16 Noorderlaanbrug
676,Noorderlaan,2023-06-10,06:00:00,34,20,14,FMN 16 Noorderlaanbrug
676,Noorderlaan,2023-06-10,07:00:00,42,20,22,FMN 16 Noorderlaanbrug
676,Noorderlaan,2023-06-10,08:00:00,62,32,30,FMN 16 Noorderlaanbrug
676,Noorderlaan,2023-06-10,09:00:00,104,77,27,FMN 16 Noorderlaanbrug
676,Noorderlaan,2023-06-10,10:00:00,145,96,49,FMN 16 Noorderlaanbrug
676,Noorderlaan,2023-06-10,11:00:00,159,108,51,FMN 16 Noorderlaanbrug
676,Noorderlaan,2023-06-10,12:00:00,138,78,60,FMN 16 Noorderlaanbrug
676,Noorderlaan,2023-06-10,13:00:00,141,84,57,FMN 16 Noorderlaanbrug
676,Noorderlaan,2023-06-10,14:00:00,160,95,65,FMN 16 Noorderlaanbrug
676,Noorderlaan,2023-06-10,15:00:00,174,96,78,FMN 16 Noorderlaanbrug
676,Noorderlaan,2023-06-10,16:00:00,146,91,55,FMN 16 Noorderlaanbrug
676,Noorderlaan,2023-06-10,17:00:00,150,93,57,FMN 16 Noorderlaanbrug
676,Noorderlaan,2023-06-10,18:00:00,160,90,70,FMN 16 Noorderlaanbrug
676,Noorderlaan,2023-06-10,19:00:00,125,62,63,FMN 16 Noorderlaanbrug
676,Noorderlaan,2023-06-10,20:00:00,111,67,44,FMN 16 Noorderlaanbrug
676,Noorderlaan,2023-06-10,21:00:00,114,60,54,FMN 16 Noorderlaanbrug
676,Noorderlaan,2023-06-10,22:00:00,84,47,37,FMN 16 Noorderlaanbrug
676,Noorderlaan,2023-06-10,23:00:00,109,54,55,FMN 16 Noorderlaanbrug
676,Noorderlaan,2023-06-11,00:00:00,76,34,42,FMN 16 Noorderlaanbrug
676,Noorderlaan,2023-06-11,01:00:00,39,10,29,FMN 16 Noorderlaanbrug
676,Noorderlaan,2023-06-11,02:00:00,41,24,17,FMN 16 Noorderlaanbrug
676,Noorderlaan,2023-06-11,03:00:00,26,8,18,FMN 16 Noorderlaanbrug
676,Noorderlaan,2023-06-11,04:00:00,11,9,2,FMN 16 Noorderlaanbrug
676,Noorderlaan,2023-06-11,05:00:00,35,17,18,FMN 16 Noorderlaanbrug
676,Noorderlaan,2023-06-11,06:00:00,33,19,14,FMN 16 Noorderlaanbrug
676,Noorderlaan,2023-06-11,07:00:00,27,11,16,FMN 16 Noorderlaanbrug
676,Noorderlaan,2023-06-11,08:00:00,41,29,12,FMN 16 Noorderlaanbrug
676,Noorderlaan,2023-06-11,09:00:00,67,42,25,FMN 16 Noorderlaanbrug
676,Noorderlaan,2023-06-11,10:00:00,71,56,15,FMN 16 Noorderlaanbrug
676,Noorderlaan,2023-06-11,11:00:00,91,57,34,FMN 16 Noorderlaanbrug
676,Noorderlaan,2023-06-11,12:00:00,89,51,38,FMN 16 Noorderlaanbrug
676,Noorderlaan,2023-06-11,13:00:00,118,73,45,FMN 16 Noorderlaanbrug
676,Noorderlaan,2023-06-11,14:00:00,102,62,40,FMN 16 Noorderlaanbrug
676,Noorderlaan,2023-06-11,15:00:00,94,49,45,FMN 16 Noorderlaanbrug
676,Noorderlaan,2023-06-11,16:00:00,96,52,44,FMN 16 Noorderlaanbrug
676,Noorderlaan,2023-06-11,17:00:00,91,45,46,FMN 16 Noorderlaanbrug
676,Noorderlaan,2023-06-11,18:00:00,75,40,35,FMN 16 Noorderlaanbrug
676,Noorderlaan,2023-06-11,19:00:00,82,50,32,FMN 16 Noorderlaanbrug
676,Noorderlaan,2023-06-11,20:00:00,77,45,32,FMN 16 Noorderlaanbrug
676,Noorderlaan,2023-06-11,21:00:00,62,33,29,FMN 16 Noorderlaanbrug
676,Noorderlaan,2023-06-11,22:00:00,61,34,27,FMN 16 Noorderlaanbrug
676,Noorderlaan,2023-06-11,23:00:00,41,24,17,FMN 16 Noorderlaanbrug
676,Noorderlaan,2023-06-12,00:00:00,21,10,11,FMN 16 Noorderlaanbrug
676,Noorderlaan,2023-06-12,01:00:00,4,0,4,FMN 16 Noorderlaanbrug
676,Noorderlaan,2023-06-12,02:00:00,4,1,3,FMN 16 Noorderlaanbrug
676,Noorderlaan,2023-06-12,03:00:00,12,8,4,FMN 16 Noorderlaanbrug
676,Noorderlaan,2023-06-12,04:00:00,31,24,7,FMN 16 Noorderlaanbrug
676,Noorderlaan,2023-06-12,05:00:00,91,38,53,FMN 16 Noorderlaanbrug
676,Noorderlaan,2023-06-12,06:00:00,148,86,62,FMN 16 Noorderlaanbrug
676,Noorderlaan,2023-06-12,07:00:00,420,285,135,FMN 16 Noorderlaanbrug
676,Noorderlaan,2023-06-12,08:00:00,494,374,120,FMN 16 Noorderlaanbrug
676,Noorderlaan,2023-06-12,09:00:00,176,115,61,FMN 16 Noorderlaanbrug
676,Noorderlaan,2023-06-12,10:00:00,120,86,34,FMN 16 Noorderlaanbrug
676,Noorderlaan,2023-06-12,11:00:00,137,93,44,FMN 16 Noorderlaanbrug
676,Noorderlaan,2023-06-12,12:00:00,183,110,73,FMN 16 Noorderlaanbrug
676,Noorderlaan,2023-06-12,13:00:00,186,92,94,FMN 16 Noorderlaanbrug
676,Noorderlaan,2023-06-12,14:00:00,170,92,78,FMN 16 Noorderlaanbrug
676,Noorderlaan,2023-06-12,15:00:00,239,120,119,FMN 16 Noorderlaanbrug
676,Noorderlaan,2023-06-12,16:00:00,433,202,231,FMN 16 Noorderlaanbrug
676,Noorderlaan,2023-06-12,17:00:00,458,216,242,FMN 16 Noorderlaanbrug
676,Noorderlaan,2023-06-12,18:00:00,240,125,115,FMN 16 Noorderlaanbrug
676,Noorderlaan,2023-06-12,19:00:00,139,77,62,FMN 16 Noorderlaanbrug
676,Noorderlaan,2023-06-12,20:00:00,117,66,51,FMN 16 Noorderlaanbrug
676,Noorderlaan,2023-06-12,21:00:00,75,30,45,FMN 16 Noorderlaanbrug
676,Noorderlaan,2023-06-12,22:00:00,115,73,42,FMN 16 Noorderlaanbrug
676,Noorderlaan,2023-06-12,23:00:00,45,16,29,FMN 16 Noorderlaanbrug
676,Noorderlaan,2023-06-13,00:00:00,19,9,10,FMN 16 Noorderlaanbrug
676,Noorderlaan,2023-06-13,01:00:00,17,9,8,FMN 16 Noorderlaanbrug
676,Noorderlaan,2023-06-13,02:00:00,7,3,4,FMN 16 Noorderlaanbrug
676,Noorderlaan,2023-06-13,03:00:00,13,10,3,FMN 16 Noorderlaanbrug
676,Noorderlaan,2023-06-13,04:00:00,28,21,7,FMN 16 Noorderlaanbrug
676,Noorderlaan,2023-06-13,05:00:00,109,40,69,FMN 16 Noorderlaanbrug
676,Noorderlaan,2023-06-13,06:00:00,158,89,69,FMN 16 Noorderlaanbrug
676,Noorderlaan,2023-06-13,07:00:00,457,312,145,FMN 16 Noorderlaanbrug
676,Noorderlaan,2023-06-13,08:00:00,515,367,148,FMN 16 Noorderlaanbrug
676,Noorderlaan,2023-06-13,09:00:00,202,140,62,FMN 16 Noorderlaanbrug
676,Noorderlaan,2023-06-13,10:00:00,120,79,41,FMN 16 Noorderlaanbrug
676,Noorderlaan,2023-06-13,11:00:00,145,87,58,FMN 16 Noorderlaanbrug
676,Noorderlaan,2023-06-13,12:00:00,170,95,75,FMN 16 Noorderlaanbrug
676,Noorderlaan,2023-06-13,13:00:00,194,111,83,FMN 16 Noorderlaanbrug
676,Noorderlaan,2023-06-13,14:00:00,218,122,96,FMN 16 Noorderlaanbrug
676,Noorderlaan,2023-06-13,15:00:00,231,126,105,FMN 16 Noorderlaanbrug
676,Noorderlaan,2023-06-13,16:00:00,390,199,191,FMN 16 Noorderlaanbrug
676,Noorderlaan,2023-06-13,17:00:00,429,223,206,FMN 16 Noorderlaanbrug
676,Noorderlaan,2023-06-13,18:00:00,284,140,144,FMN 16 Noorderlaanbrug
676,Noorderlaan,2023-06-13,19:00:00,122,62,60,FMN 16 Noorderlaanbrug
676,Noorderlaan,2023-06-13,20:00:00,105,52,53,FMN 16 Noorderlaanbrug
676,Noorderlaan,2023-06-13,21:00:00,93,43,50,FMN 16 Noorderlaanbrug
676,Noorderlaan,2023-06-13,22:00:00,124,86,38,FMN 16 Noorderlaanbrug
676,Noorderlaan,2023-06-13,23:00:00,47,17,30,FMN 16 Noorderlaanbrug
676,Noorderlaan,2023-06-14,00:00:00,28,10,18,FMN 16 Noorderlaanbrug
676,Noorderlaan,2023-06-14,01:00:00,6,2,4,FMN 16 Noorderlaanbrug
676,Noorderlaan,2023-06-14,02:00:00,13,6,7,FMN 16 Noorderlaanbrug
676,Noorderlaan,2023-06-14,03:00:00,15,10,5,FMN 16 Noorderlaanbrug
676,Noorderlaan,2023-06-14,04:00:00,32,20,12,FMN 16 Noorderlaanbrug
676,Noorderlaan,2023-06-14,05:00:00,82,27,55,FMN 16 Noorderlaanbrug
676,Noorderlaan,2023-06-14,06:00:00,146,93,53,FMN 16 Noorderlaanbrug
676,Noorderlaan,2023-06-14,07:00:00,385,237,148,FMN 16 Noorderlaanbrug
676,Noorderlaan,2023-06-14,08:00:00,441,302,139,FMN 16 Noorderlaanbrug
676,Noorderlaan,2023-06-14,09:00:00,164,101,63,FMN 16 Noorderlaanbrug
676,Noorderlaan,2023-06-14,10:00:00,132,85,47,FMN 16 Noorderlaanbrug
676,Noorderlaan,2023-06-14,11:00:00,135,79,56,FMN 16 Noorderlaanbrug
676,Noorderlaan,2023-06-14,12:00:00,208,112,96,FMN 16 Noorderlaanbrug
676,Noorderlaan,2023-06-14,13:00:00,228,112,116,FMN 16 Noorderlaanbrug
676,Noorderlaan,2023-06-14,14:00:00,188,110,78,FMN 16 Noorderlaanbrug
676,Noorderlaan,2023-06-14,15:00:00,208,130,78,FMN 16 Noorderlaanbrug
676,Noorderlaan,2023-06-14,16:00:00,347,199,148,FMN 16 Noorderlaanbrug
676,Noorderlaan,2023-06-14,17:00:00,359,196,163,FMN 16 Noorderlaanbrug
676,Noorderlaan,2023-06-14,18:00:00,212,116,96,FMN 16 Noorderlaanbrug
676,Noorderlaan,2023-06-14,19:00:00,131,72,59,FMN 16 Noorderlaanbrug
676,Noorderlaan,2023-06-14,20:00:00,0,0,0,FMN 16 Noorderlaanbrug
676,Noorderlaan,2023-06-14,21:00:00,0,0,0,FMN 16 Noorderlaanbrug
676,Noorderlaan,2023-06-14,22:00:00,0,0,0,FMN 16 Noorderlaanbrug
676,Noorderlaan,2023-06-14,23:00:00,0,0,0,FMN 16 Noorderlaanbrug
676,Noorderlaan,2023-06-15,00:00:00,0,0,0,FMN 16 Noorderlaanbrug
676,Noorderlaan,2023-06-15,01:00:00,22,14,8,FMN 16 Noorderlaanbrug
676,Noorderlaan,2023-06-15,02:00:00,6,4,2,FMN 16 Noorderlaanbrug
676,Noorderlaan,2023-06-15,03:00:00,24,19,5,FMN 16 Noorderlaanbrug
676,Noorderlaan,2023-06-15,04:00:00,45,25,20,FMN 16 Noorderlaanbrug
676,Noorderlaan,2023-06-15,05:00:00,127,72,55,FMN 16 Noorderlaanbrug
676,Noorderlaan,2023-06-15,06:00:00,174,106,68,FMN 16 Noorderlaanbrug
676,Noorderlaan,2023-06-15,07:00:00,489,329,160,FMN 16 Noorderlaanbrug
676,Noorderlaan,2023-06-15,08:00:00,614,442,172,FMN 16 Noorderlaanbrug
676,Noorderlaan,2023-06-15,09:00:00,223,154,69,FMN 16 Noorderlaanbrug
676,Noorderlaan,2023-06-15,10:00:00,159,102,57,FMN 16 Noorderlaanbrug
676,Noorderlaan,2023-06-15,11:00:00,148,96,52,FMN 16 Noorderlaanbrug
676,Noorderlaan,2023-06-15,12:00:00,179,108,71,FMN 16 Noorderlaanbrug
676,Noorderlaan,2023-06-15,13:00:00,199,113,86,FMN 16 Noorderlaanbrug
676,Noorderlaan,2023-06-15,14:00:00,241,138,103,FMN 16 Noorderlaanbrug
676,Noorderlaan,2023-06-15,15:00:00,278,153,125,FMN 16 Noorderlaanbrug
676,Noorderlaan,2023-06-15,16:00:00,471,258,213,FMN 16 Noorderlaanbrug
676,Noorderlaan,2023-06-15,17:00:00,451,245,206,FMN 16 Noorderlaanbrug
676,Noorderlaan,2023-06-15,18:00:00,280,158,122,FMN 16 Noorderlaanbrug
676,Noorderlaan,2023-06-15,19:00:00,161,93,68,FMN 16 Noorderlaanbrug
676,Noorderlaan,2023-06-15,20:00:00,90,50,40,FMN 16 Noorderlaanbrug
676,Noorderlaan,2023-06-15,21:00:00,89,57,32,FMN 16 Noorderlaanbrug
676,Noorderlaan,2023-06-15,22:00:00,118,79,39,FMN 16 Noorderlaanbrug
676,Noorderlaan,2023-06-15,23:00:00,56,28,28,FMN 16 Noorderlaanbrug
676,Noorderlaan,2023-06-16,00:00:00,0,0,0,FMN 16 Noorderlaanbrug
676,Noorderlaan,2023-06-16,01:00:00,20,11,9,FMN 16 Noorderlaanbrug
676,Noorderlaan,2023-06-16,02:00:00,12,6,6,FMN 16 Noorderlaanbrug
676,Noorderlaan,2023-06-16,03:00:00,19,10,9,FMN 16 Noorderlaanbrug
676,Noorderlaan,2023-06-16,04:00:00,33,19,14,FMN 16 Noorderlaanbrug
676,Noorderlaan,2023-06-16,05:00:00,132,66,66,FMN 16 Noorderlaanbrug
676,Noorderlaan,2023-06-16,06:00:00,180,96,84,FMN 16 Noorderlaanbrug
676,Noorderlaan,2023-06-16,07:00:00,399,255,144,FMN 16 Noorderlaanbrug
676,Noorderlaan,2023-06-16,08:00:00,528,358,170,FMN 16 Noorderlaanbrug
676,Noorderlaan,2023-06-16,09:00:00,221,150,71,FMN 16 Noorderlaanbrug
676,Noorderlaan,2023-06-16,10:00:00,158,100,58,FMN 16 Noorderlaanbrug
676,Noorderlaan,2023-06-16,11:00:00,183,125,58,FMN 16 Noorderlaanbrug
676,Noorderlaan,2023-06-16,12:00:00,189,117,72,FMN 16 Noorderlaanbrug
676,Noorderlaan,2023-06-16,13:00:00,237,142,95,FMN 16 Noorderlaanbrug
676,Noorderlaan,2023-06-16,14:00:00,276,166,110,FMN 16 Noorderlaanbrug
676,Noorderlaan,2023-06-16,15:00:00,335,187,148,FMN 16 Noorderlaanbrug
676,Noorderlaan,2023-06-16,16:00:00,512,295,217,FMN 16 Noorderlaanbrug
676,Noorderlaan,2023-06-16,17:00:00,430,227,203,FMN 16 Noorderlaanbrug
676,Noorderlaan,2023-06-16,18:00:00,271,152,119,FMN 16 Noorderlaanbrug
676,Noorderlaan,2023-06-16,19:00:00,175,119,56,FMN 16 Noorderlaanbrug
676,Noorderlaan,2023-06-16,20:00:00,130,73,57,FMN 16 Noorderlaanbrug
676,Noorderlaan,2023-06-16,21:00:00,101,58,43,FMN 16 Noorderlaanbrug
676,Noorderlaan,2023-06-16,22:00:00,115,70,45,FMN 16 Noorderlaanbrug
676,Noorderlaan,2023-06-16,23:00:00,105,48,57,FMN 16 Noorderlaanbrug
676,Noorderlaan,2023-06-17,00:00:00,0,0,0,FMN 16 Noorderlaanbrug
676,Noorderlaan,2023-06-17,01:00:00,79,41,38,FMN 16 Noorderlaanbrug
676,Noorderlaan,2023-06-17,02:00:00,51,24,27,FMN 16 Noorderlaanbrug
676,Noorderlaan,2023-06-17,03:00:00,55,41,14,FMN 16 Noorderlaanbrug
676,Noorderlaan,2023-06-17,04:00:00,36,22,14,FMN 16 Noorderlaanbrug
676,Noorderlaan,2023-06-17,05:00:00,49,25,24,FMN 16 Noorderlaanbrug
676,Noorderlaan,2023-06-17,06:00:00,59,38,21,FMN 16 Noorderlaanbrug
676,Noorderlaan,2023-06-17,07:00:00,64,42,22,FMN 16 Noorderlaanbrug
676,Noorderlaan,2023-06-17,08:00:00,75,60,15,FMN 16 Noorderlaanbrug
676,Noorderlaan,2023-06-17,09:00:00,141,96,45,FMN 16 Noorderlaanbrug
676,Noorderlaan,2023-06-17,10:00:00,185,128,57,FMN 16 Noorderlaanbrug
676,Noorderlaan,2023-06-17,11:00:00,201,129,72,FMN 16 Noorderlaanbrug
676,Noorderlaan,2023-06-17,12:00:00,220,152,68,FMN 16 Noorderlaanbrug
676,Noorderlaan,2023-06-17,13:00:00,249,163,86,FMN 16 Noorderlaanbrug
676,Noorderlaan,2023-06-17,14:00:00,248,167,81,FMN 16 Noorderlaanbrug
676,Noorderlaan,2023-06-17,15:00:00,240,147,93,FMN 16 Noorderlaanbrug
676,Noorderlaan,2023-06-17,16:00:00,246,160,86,FMN 16 Noorderlaanbrug
676,Noorderlaan,2023-06-17,17:00:00,214,128,86,FMN 16 Noorderlaanbrug
676,Noorderlaan,2023-06-17,18:00:00,245,143,102,FMN 16 Noorderlaanbrug
676,Noorderlaan,2023-06-17,19:00:00,171,105,66,FMN 16 Noorderlaanbrug
676,Noorderlaan,2023-06-17,20:00:00,112,71,41,FMN 16 Noorderlaanbrug
676,Noorderlaan,2023-06-17,21:00:00,87,41,46,FMN 16 Noorderlaanbrug
676,Noorderlaan,2023-06-17,22:00:00,115,71,44,FMN 16 Noorderlaanbrug
676,Noorderlaan,2023-06-17,23:00:00,99,53,46,FMN 16 Noorderlaanbrug
676,Noorderlaan,2023-06-18,00:00:00,0,0,0,FMN 16 Noorderlaanbrug
676,Noorderlaan,2023-06-18,01:00:00,41,21,20,FMN 16 Noorderlaanbrug
676,Noorderlaan,2023-06-18,02:00:00,30,15,15,FMN 16 Noorderlaanbrug
676,Noorderlaan,2023-06-18,03:00:00,28,17,11,FMN 16 Noorderlaanbrug
676,Noorderlaan,2023-06-18,04:00:00,21,14,7,FMN 16 Noorderlaanbrug
676,Noorderlaan,2023-06-18,05:00:00,19,8,11,FMN 16 Noorderlaanbrug
676,Noorderlaan,2023-06-18,06:00:00,24,12,12,FMN 16 Noorderlaanbrug
676,Noorderlaan,2023-06-18,07:00:00,30,17,13,FMN 16 Noorderlaanbrug
676,Noorderlaan,2023-06-18,08:00:00,37,27,10,FMN 16 Noorderlaanbrug
676,Noorderlaan,2023-06-18,09:00:00,56,38,18,FMN 16 Noorderlaanbrug
676,Noorderlaan,2023-06-18,10:00:00,85,60,25,FMN 16 Noorderlaanbrug
676,Noorderlaan,2023-06-18,11:00:00,113,72,41,FMN 16 Noorderlaanbrug
676,Noorderlaan,2023-06-18,12:00:00,90,52,38,FMN 16 Noorderlaanbrug
676,Noorderlaan,2023-06-18,13:00:00,123,70,53,FMN 16 Noorderlaanbrug
676,Noorderlaan,2023-06-18,14:00:00,117,66,51,FMN 16 Noorderlaanbrug
676,Noorderlaan,2023-06-18,15:00:00,99,57,42,FMN 16 Noorderlaanbrug
676,Noorderlaan,2023-06-18,16:00:00,117,64,53,FMN 16 Noorderlaanbrug
676,Noorderlaan,2023-06-18,17:00:00,93,48,45,FMN 16 Noorderlaanbrug
676,Noorderlaan,2023-06-18,18:00:00,89,46,43,FMN 16 Noorderlaanbrug
676,Noorderlaan,2023-06-18,19:00:00,76,43,33,FMN 16 Noorderlaanbrug
676,Noorderlaan,2023-06-18,20:00:00,53,31,22,FMN 16 Noorderlaanbrug
676,Noorderlaan,2023-06-18,21:00:00,50,27,23,FMN 16 Noorderlaanbrug
676,Noorderlaan,2023-06-18,22:00:00,50,28,22,FMN 16 Noorderlaanbrug
676,Noorderlaan,2023-06-18,23:00:00,30,16,14,FMN 16 Noorderlaanbrug
676,Noorderlaan,2023-06-19,00:00:00,0,0,0,FMN 16 Noorderlaanbrug
676,Noorderlaan,2023-06-19,01:00:00,16,9,7,FMN 16 Noorderlaanbrug
676,Noorderlaan,2023-06-19,02:00:00,7,7,0,FMN 16 Noorderlaanbrug
676,Noorderlaan,2023-06-19,03:00:00,15,11,4,FMN 16 Noorderlaanbrug
676,Noorderlaan,2023-06-19,04:00:00,39,21,18,FMN 16 Noorderlaanbrug
676,Noorderlaan,2023-06-19,05:00:00,95,48,47,FMN 16 Noorderlaanbrug
676,Noorderlaan,2023-06-19,06:00:00,164,108,56,FMN 16 Noorderlaanbrug
676,Noorderlaan,2023-06-19,07:00:00,388,268,120,FMN 16 Noorderlaanbrug
676,Noorderlaan,2023-06-19,08:00:00,521,383,138,FMN 16 Noorderlaanbrug
676,Noorderlaan,2023-06-19,09:00:00,181,129,52,FMN 16 Noorderlaanbrug
676,Noorderlaan,2023-06-19,10:00:00,135,91,44,FMN 16 Noorderlaanbrug
676,Noorderlaan,2023-06-19,11:00:00,124,77,47,FMN 16 Noorderlaanbrug
676,Noorderlaan,2023-06-19,12:00:00,163,101,62,FMN 16 Noorderlaanbrug
676,Noorderlaan,2023-06-19,13:00:00,172,106,66,FMN 16 Noorderlaanbrug
676,Noorderlaan,2023-06-19,14:00:00,214,124,90,FMN 16 Noorderlaanbrug
676,Noorderlaan,2023-06-19,15:00:00,235,135,100,FMN 16 Noorderlaanbrug
676,Noorderlaan,2023-06-19,16:00:00,402,221,181,FMN 16 Noorderlaanbrug
676,Noorderlaan,2023-06-19,17:00:00,426,232,194,FMN 16 Noorderlaanbrug
676,Noorderlaan,2023-06-19,18:00:00,228,124,104,FMN 16 Noorderlaanbrug
676,Noorderlaan,2023-06-19,19:00:00,101,67,34,FMN 16 Noorderlaanbrug
676,Noorderlaan,2023-06-19,20:00:00,81,38,43,FMN 16 Noorderlaanbrug
676,Noorderlaan,2023-06-19,21:00:00,62,28,34,FMN 16 Noorderlaanbrug
676,Noorderlaan,2023-06-19,22:00:00,83,54,29,FMN 16 Noorderlaanbrug
676,Noorderlaan,2023-06-19,23:00:00,33,19,14,FMN 16 Noorderlaanbrug
676,Noorderlaan,2023-06-20,00:00:00,0,0,0,FMN 16 Noorderlaanbrug
676,Noorderlaan,2023-06-20,01:00:00,14,9,5,FMN 16 Noorderlaanbrug
676,Noorderlaan,2023-06-20,02:00:00,10,3,7,FMN 16 Noorderlaanbrug
676,Noorderlaan,2023-06-20,03:00:00,11,6,5,FMN 16 Noorderlaanbrug
676,Noorderlaan,2023-06-20,04:00:00,28,17,11,FMN 16 Noorderlaanbrug
676,Noorderlaan,2023-06-20,05:00:00,91,36,55,FMN 16 Noorderlaanbrug
676,Noorderlaan,2023-06-20,06:00:00,166,96,70,FMN 16 Noorderlaanbrug
676,Noorderlaan,2023-06-20,07:00:00,376,257,119,FMN 16 Noorderlaanbrug
676,Noorderlaan,2023-06-20,08:00:00,470,344,126,FMN 16 Noorderlaanbrug
676,Noorderlaan,2023-06-20,09:00:00,156,104,52,FMN 16 Noorderlaanbrug
676,Noorderlaan,2023-06-20,10:00:00,113,71,42,FMN 16 Noorderlaanbrug
676,Noorderlaan,2023-06-20,11:00:00,122,77,45,FMN 16 Noorderlaanbrug
676,Noorderlaan,2023-06-20,12:00:00,155,86,69,FMN 16 Noorderlaanbrug
676,Noorderlaan,2023-06-20,13:00:00,163,82,81,FMN 16 Noorderlaanbrug
676,Noorderlaan,2023-06-20,14:00:00,187,120,67,FMN 16 Noorderlaanbrug
676,Noorderlaan,2023-06-20,15:00:00,243,128,115,FMN 16 Noorderlaanbrug
676,Noorderlaan,2023-06-20,16:00:00,408,211,197,FMN 16 Noorderlaanbrug
676,Noorderlaan,2023-06-20,17:00:00,437,213,224,FMN 16 Noorderlaanbrug
676,Noorderlaan,2023-06-20,18:00:00,263,142,121,FMN 16 Noorderlaanbrug
676,Noorderlaan,2023-06-20,19:00:00,121,75,46,FMN 16 Noorderlaanbrug
676,Noorderlaan,2023-06-20,20:00:00,67,38,29,FMN 16 Noorderlaanbrug
676,Noorderlaan,2023-06-20,21:00:00,71,38,33,FMN 16 Noorderlaanbrug
676,Noorderlaan,2023-06-20,22:00:00,74,49,25,FMN 16 Noorderlaanbrug
676,Noorderlaan,2023-06-20,23:00:00,32,21,11,FMN 16 Noorderlaanbrug
676,Noorderlaan,2023-06-21,00:00:00,15,6,9,FMN 16 Noorderlaanbrug
676,Noorderlaan,2023-06-21,01:00:00,16,6,10,FMN 16 Noorderlaanbrug
676,Noorderlaan,2023-06-21,02:00:00,6,4,2,FMN 16 Noorderlaanbrug
676,Noorderlaan,2023-06-21,03:00:00,11,9,2,FMN 16 Noorderlaanbrug
676,Noorderlaan,2023-06-21,04:00:00,45,28,17,FMN 16 Noorderlaanbrug
676,Noorderlaan,2023-06-21,05:00:00,100,46,54,FMN 16 Noorderlaanbrug
676,Noorderlaan,2023-06-21,06:00:00,168,94,74,FMN 16 Noorderlaanbrug
676,Noorderlaan,2023-06-21,07:00:00,398,266,132,FMN 16 Noorderlaanbrug
676,Noorderlaan,2023-06-21,08:00:00,537,356,181,FMN 16 Noorderlaanbrug
676,Noorderlaan,2023-06-21,09:00:00,200,132,68,FMN 16 Noorderlaanbrug
676,Noorderlaan,2023-06-21,10:00:00,127,86,41,FMN 16 Noorderlaanbrug
676,Noorderlaan,2023-06-21,11:00:00,149,91,58,FMN 16 Noorderlaanbrug
676,Noorderlaan,2023-06-21,12:00:00,255,141,114,FMN 16 Noorderlaanbrug
676,Noorderlaan,2023-06-21,13:00:00,238,116,122,FMN 16 Noorderlaanbrug
676,Noorderlaan,2023-06-21,14:00:00,222,140,82,FMN 16 Noorderlaanbrug
676,Noorderlaan,2023-06-21,15:00:00,271,158,113,FMN 16 Noorderlaanbrug
676,Noorderlaan,2023-06-21,16:00:00,436,251,185,FMN 16 Noorderlaanbrug
676,Noorderlaan,2023-06-21,17:00:00,462,251,211,FMN 16 Noorderlaanbrug
676,Noorderlaan,2023-06-21,18:00:00,247,131,116,FMN 16 Noorderlaanbrug
676,Noorderlaan,2023-06-21,19:00:00,125,70,55,FMN 16 Noorderlaanbrug
676,Noorderlaan,2023-06-21,20:00:00,85,43,42,FMN 16 Noorderlaanbrug
676,Noorderlaan,2023-06-21,21:00:00,76,40,36,FMN 16 Noorderlaanbrug
676,Noorderlaan,2023-06-21,22:00:00,118,67,51,FMN 16 Noorderlaanbrug
676,Noorderlaan,2023-06-21,23:00:00,42,16,26,FMN 16 Noorderlaanbrug
676,Noorderlaan,2023-06-22,00:00:00,15,2,13,FMN 16 Noorderlaanbrug
676,Noorderlaan,2023-06-22,01:00:00,6,4,2,FMN 16 Noorderlaanbrug
676,Noorderlaan,2023-06-22,02:00:00,5,0,5,FMN 16 Noorderlaanbrug
676,Noorderlaan,2023-06-22,03:00:00,9,2,7,FMN 16 Noorderlaanbrug
676,Noorderlaan,2023-06-22,04:00:00,16,5,11,FMN 16 Noorderlaanbrug
676,Noorderlaan,2023-06-22,05:00:00,54,11,43,FMN 16 Noorderlaanbrug
676,Noorderlaan,2023-06-22,06:00:00,65,19,46,FMN 16 Noorderlaanbrug
676,Noorderlaan,2023-06-22,07:00:00,157,41,116,FMN 16 Noorderlaanbrug
676,Noorderlaan,2023-06-22,08:00:00,174,62,112,FMN 16 Noorderlaanbrug
676,Noorderlaan,2023-06-22,09:00:00,70,24,46,FMN 16 Noorderlaanbrug
676,Noorderlaan,2023-06-22,10:00:00,45,20,25,FMN 16 Noorderlaanbrug
676,Noorderlaan,2023-06-22,11:00:00,44,6,38,FMN 16 Noorderlaanbrug
676,Noorderlaan,2023-06-22,12:00:00,60,12,48,FMN 16 Noorderlaanbrug
676,Noorderlaan,2023-06-22,13:00:00,76,13,63,FMN 16 Noorderlaanbrug
676,Noorderlaan,2023-06-22,14:00:00,80,22,58,FMN 16 Noorderlaanbrug
676,Noorderlaan,2023-06-22,15:00:00,104,25,79,FMN 16 Noorderlaanbrug
676,Noorderlaan,2023-06-22,16:00:00,171,35,136,FMN 16 Noorderlaanbrug
676,Noorderlaan,2023-06-22,17:00:00,178,37,141,FMN 16 Noorderlaanbrug
676,Noorderlaan,2023-06-22,18:00:00,86,25,61,FMN 16 Noorderlaanbrug
676,Noorderlaan,2023-06-22,19:00:00,53,9,44,FMN 16 Noorderlaanbrug
676,Noorderlaan,2023-06-22,20:00:00,34,9,25,FMN 16 Noorderlaanbrug
676,Noorderlaan,2023-06-22,21:00:00,33,6,27,FMN 16 Noorderlaanbrug
676,Noorderlaan,2023-06-22,22:00:00,39,12,27,FMN 16 Noorderlaanbrug
676,Noorderlaan,2023-06-22,23:00:00,20,8,12,FMN 16 Noorderlaanbrug
676,Noorderlaan,2023-06-23,00:00:00,46,20,26,FMN 16 Noorderlaanbrug
676,Noorderlaan,2023-06-23,01:00:00,22,12,10,FMN 16 Noorderlaanbrug
676,Noorderlaan,2023-06-23,02:00:00,9,7,2,FMN 16 Noorderlaanbrug
676,Noorderlaan,2023-06-23,03:00:00,16,8,8,FMN 16 Noorderlaanbrug
676,Noorderlaan,2023-06-23,04:00:00,35,18,17,FMN 16 Noorderlaanbrug
676,Noorderlaan,2023-06-23,05:00:00,96,42,54,FMN 16 Noorderlaanbrug
676,Noorderlaan,2023-06-23,06:00:00,165,88,77,FMN 16 Noorderlaanbrug
676,Noorderlaan,2023-06-23,07:00:00,368,224,144,FMN 16 Noorderlaanbrug
676,Noorderlaan,2023-06-23,08:00:00,455,285,170,FMN 16 Noorderlaanbrug
676,Noorderlaan,2023-06-23,09:00:00,203,139,64,FMN 16 Noorderlaanbrug
676,Noorderlaan,2023-06-23,10:00:00,157,99,58,FMN 16 Noorderlaanbrug
676,Noorderlaan,2023-06-23,11:00:00,155,90,65,FMN 16 Noorderlaanbrug
676,Noorderlaan,2023-06-23,12:00:00,209,117,92,FMN 16 Noorderlaanbrug
676,Noorderlaan,2023-06-23,13:00:00,202,105,97,FMN 16 Noorderlaanbrug
676,Noorderlaan,2023-06-23,14:00:00,231,118,113,FMN 16 Noorderlaanbrug
676,Noorderlaan,2023-06-23,15:00:00,292,155,137,FMN 16 Noorderlaanbrug
676,Noorderlaan,2023-06-23,16:00:00,440,239,201,FMN 16 Noorderlaanbrug
676,Noorderlaan,2023-06-23,17:00:00,374,189,185,FMN 16 Noorderlaanbrug
676,Noorderlaan,2023-06-23,18:00:00,251,130,121,FMN 16 Noorderlaanbrug
676,Noorderlaan,2023-06-23,19:00:00,159,91,68,FMN 16 Noorderlaanbrug
676,Noorderlaan,2023-06-23,20:00:00,102,56,46,FMN 16 Noorderlaanbrug
676,Noorderlaan,2023-06-23,21:00:00,100,51,49,FMN 16 Noorderlaanbrug
676,Noorderlaan,2023-06-23,22:00:00,113,60,53,FMN 16 Noorderlaanbrug
676,Noorderlaan,2023-06-23,23:00:00,85,35,50,FMN 16 Noorderlaanbrug
676,Noorderlaan,2023-06-24,00:00:00,0,0,0,FMN 16 Noorderlaanbrug
676,Noorderlaan,2023-06-24,01:00:00,78,42,36,FMN 16 Noorderlaanbrug
676,Noorderlaan,2023-06-24,02:00:00,51,31,20,FMN 16 Noorderlaanbrug
676,Noorderlaan,2023-06-24,03:00:00,58,33,25,FMN 16 Noorderlaanbrug
676,Noorderlaan,2023-06-24,04:00:00,44,27,17,FMN 16 Noorderlaanbrug
676,Noorderlaan,2023-06-24,05:00:00,51,31,20,FMN 16 Noorderlaanbrug
676,Noorderlaan,2023-06-24,06:00:00,70,47,23,FMN 16 Noorderlaanbrug
676,Noorderlaan,2023-06-24,07:00:00,59,32,27,FMN 16 Noorderlaanbrug
676,Noorderlaan,2023-06-24,08:00:00,81,57,24,FMN 16 Noorderlaanbrug
676,Noorderlaan,2023-06-24,09:00:00,156,103,53,FMN 16 Noorderlaanbrug
676,Noorderlaan,2023-06-24,10:00:00,176,125,51,FMN 16 Noorderlaanbrug
676,Noorderlaan,2023-06-24,11:00:00,227,144,83,FMN 16 Noorderlaanbrug
676,Noorderlaan,2023-06-24,12:00:00,240,162,78,FMN 16 Noorderlaanbrug
676,Noorderlaan,2023-06-24,13:00:00,263,168,95,FMN 16 Noorderlaanbrug
676,Noorderlaan,2023-06-24,14:00:00,269,173,96,FMN 16 Noorderlaanbrug
676,Noorderlaan,2023-06-24,15:00:00,260,158,102,FMN 16 Noorderlaanbrug
676,Noorderlaan,2023-06-24,16:00:00,252,158,94,FMN 16 Noorderlaanbrug
676,Noorderlaan,2023-06-24,17:00:00,227,137,90,FMN 16 Noorderlaanbrug
676,Noorderlaan,2023-06-24,18:00:00,237,145,92,FMN 16 Noorderlaanbrug
676,Noorderlaan,2023-06-24,19:00:00,179,108,71,FMN 16 Noorderlaanbrug
676,Noorderlaan,2023-06-24,20:00:00,121,71,50,FMN 16 Noorderlaanbrug
676,Noorderlaan,2023-06-24,21:00:00,90,52,38,FMN 16 Noorderlaanbrug
676,Noorderlaan,2023-06-24,22:00:00,111,63,48,FMN 16 Noorderlaanbrug
676,Noorderlaan,2023-06-24,23:00:00,106,64,42,FMN 16 Noorderlaanbrug
676,Noorderlaan,2023-06-25,00:00:00,116,56,60,FMN 16 Noorderlaanbrug
676,Noorderlaan,2023-06-25,01:00:00,70,35,35,FMN 16 Noorderlaanbrug
676,Noorderlaan,2023-06-25,02:00:00,47,23,24,FMN 16 Noorderlaanbrug
676,Noorderlaan,2023-06-25,03:00:00,47,24,23,FMN 16 Noorderlaanbrug
676,Noorderlaan,2023-06-25,04:00:00,40,22,18,FMN 16 Noorderlaanbrug
676,Noorderlaan,2023-06-25,05:00:00,44,25,19,FMN 16 Noorderlaanbrug
676,Noorderlaan,2023-06-25,06:00:00,54,33,21,FMN 16 Noorderlaanbrug
676,Noorderlaan,2023-06-25,07:00:00,46,28,18,FMN 16 Noorderlaanbrug
676,Noorderlaan,2023-06-25,08:00:00,67,46,21,FMN 16 Noorderlaanbrug
676,Noorderlaan,2023-06-25,09:00:00,115,73,42,FMN 16 Noorderlaanbrug
676,Noorderlaan,2023-06-25,10:00:00,134,90,44,FMN 16 Noorderlaanbrug
676,Noorderlaan,2023-06-25,11:00:00,186,117,69,FMN 16 Noorderlaanbrug
676,Noorderlaan,2023-06-25,12:00:00,174,108,66,FMN 16 Noorderlaanbrug
676,Noorderlaan,2023-06-25,13:00:00,236,135,101,FMN 16 Noorderlaanbrug
676,Noorderlaan,2023-06-25,14:00:00,210,128,82,FMN 16 Noorderlaanbrug
676,Noorderlaan,2023-06-25,15:00:00,196,111,85,FMN 16 Noorderlaanbrug
676,Noorderlaan,2023-06-25,16:00:00,200,114,86,FMN 16 Noorderlaanbrug
676,Noorderlaan,2023-06-25,17:00:00,194,101,93,FMN 16 Noorderlaanbrug
676,Noorderlaan,2023-06-25,18:00:00,176,97,79,FMN 16 Noorderlaanbrug
676,Noorderlaan,2023-06-25,19:00:00,148,87,61,FMN 16 Noorderlaanbrug
676,Noorderlaan,2023-06-25,20:00:00,106,60,46,FMN 16 Noorderlaanbrug
676,Noorderlaan,2023-06-25,21:00:00,101,54,47,FMN 16 Noorderlaanbrug
676,Noorderlaan,2023-06-25,22:00:00,100,48,52,FMN 16 Noorderlaanbrug
676,Noorderlaan,2023-06-25,23:00:00,70,43,27,FMN 16 Noorderlaanbrug
676,Noorderlaan,2023-06-26,00:00:00,14,9,5,FMN 16 Noorderlaanbrug
676,Noorderlaan,2023-06-26,01:00:00,14,5,9,FMN 16 Noorderlaanbrug
676,Noorderlaan,2023-06-26,02:00:00,9,2,7,FMN 16 Noorderlaanbrug
676,Noorderlaan,2023-06-26,03:00:00,9,6,3,FMN 16 Noorderlaanbrug
676,Noorderlaan,2023-06-26,04:00:00,43,30,13,FMN 16 Noorderlaanbrug
676,Noorderlaan,2023-06-26,05:00:00,95,46,49,FMN 16 Noorderlaanbrug
676,Noorderlaan,2023-06-26,06:00:00,165,103,62,FMN 16 Noorderlaanbrug
676,Noorderlaan,2023-06-26,07:00:00,371,246,125,FMN 16 Noorderlaanbrug
676,Noorderlaan,2023-06-26,08:00:00,530,383,147,FMN 16 Noorderlaanbrug
676,Noorderlaan,2023-06-26,09:00:00,163,110,53,FMN 16 Noorderlaanbrug
676,Noorderlaan,2023-06-26,10:00:00,118,80,38,FMN 16 Noorderlaanbrug
676,Noorderlaan,2023-06-26,11:00:00,113,76,37,FMN 16 Noorderlaanbrug
676,Noorderlaan,2023-06-26,12:00:00,153,94,59,FMN 16 Noorderlaanbrug
676,Noorderlaan,2023-06-26,13:00:00,172,94,78,FMN 16 Noorderlaanbrug
676,Noorderlaan,2023-06-26,14:00:00,194,115,79,FMN 16 Noorderlaanbrug
676,Noorderlaan,2023-06-26,15:00:00,256,127,129,FMN 16 Noorderlaanbrug
676,Noorderlaan,2023-06-26,16:00:00,410,204,206,FMN 16 Noorderlaanbrug
676,Noorderlaan,2023-06-26,17:00:00,412,219,193,FMN 16 Noorderlaanbrug
676,Noorderlaan,2023-06-26,18:00:00,221,105,116,FMN 16 Noorderlaanbrug
676,Noorderlaan,2023-06-26,19:00:00,97,55,42,FMN 16 Noorderlaanbrug
676,Noorderlaan,2023-06-26,20:00:00,74,35,39,FMN 16 Noorderlaanbrug
676,Noorderlaan,2023-06-26,21:00:00,60,31,29,FMN 16 Noorderlaanbrug
676,Noorderlaan,2023-06-26,22:00:00,65,43,22,FMN 16 Noorderlaanbrug
676,Noorderlaan,2023-06-26,23:00:00,39,20,19,FMN 16 Noorderlaanbrug
676,Noorderlaan,2023-06-28,00:00:00,0,0,0,FMN 16 Noorderlaanbrug
676,Noorderlaan,2023-06-28,01:00:00,0,0,0,FMN 16 Noorderlaanbrug
676,Noorderlaan,2023-06-28,02:00:00,0,0,0,FMN 16 Noorderlaanbrug
676,Noorderlaan,2023-06-28,03:00:00,0,0,0,FMN 16 Noorderlaanbrug
676,Noorderlaan,2023-06-28,04:00:00,0,0,0,FMN 16 Noorderlaanbrug
676,Noorderlaan,2023-06-28,05:00:00,0,0,0,FMN 16 Noorderlaanbrug
676,Noorderlaan,2023-06-28,06:00:00,0,0,0,FMN 16 Noorderlaanbrug
676,Noorderlaan,2023-06-28,07:00:00,0,0,0,FMN 16 Noorderlaanbrug
676,Noorderlaan,2023-06-28,08:00:00,0,0,0,FMN 16 Noorderlaanbrug
676,Noorderlaan,2023-06-28,09:00:00,0,0,0,FMN 16 Noorderlaanbrug
676,Noorderlaan,2023-06-28,10:00:00,0,0,0,FMN 16 Noorderlaanbrug
676,Noorderlaan,2023-06-28,11:00:00,0,0,0,FMN 16 Noorderlaanbrug
676,Noorderlaan,2023-06-28,12:00:00,2,1,1,FMN 16 Noorderlaanbrug
676,Noorderlaan,2023-06-28,13:00:00,51,20,31,FMN 16 Noorderlaanbrug
676,Noorderlaan,2023-06-28,14:00:00,185,61,124,FMN 16 Noorderlaanbrug
676,Noorderlaan,2023-06-28,15:00:00,212,84,128,FMN 16 Noorderlaanbrug
676,Noorderlaan,2023-06-28,16:00:00,330,130,200,FMN 16 Noorderlaanbrug
676,Noorderlaan,2023-06-28,17:00:00,302,133,169,FMN 16 Noorderlaanbrug
676,Noorderlaan,2023-06-28,18:00:00,199,105,94,FMN 16 Noorderlaanbrug
676,Noorderlaan,2023-06-28,19:00:00,117,48,69,FMN 16 Noorderlaanbrug
676,Noorderlaan,2023-06-28,20:00:00,77,35,42,FMN 16 Noorderlaanbrug
676,Noorderlaan,2023-06-28,21:00:00,61,23,38,FMN 16 Noorderlaanbrug
676,Noorderlaan,2023-06-28,22:00:00,101,44,57,FMN 16 Noorderlaanbrug
676,Noorderlaan,2023-06-28,23:00:00,90,56,34,FMN 16 Noorderlaanbrug
676,Noorderlaan,2023-06-29,00:00:00,67,54,13,FMN 16 Noorderlaanbrug
676,Noorderlaan,2023-06-29,01:00:00,58,47,11,FMN 16 Noorderlaanbrug
676,Noorderlaan,2023-06-29,02:00:00,40,20,20,FMN 16 Noorderlaanbrug
676,Noorderlaan,2023-06-29,03:00:00,61,12,49,FMN 16 Noorderlaanbrug
676,Noorderlaan,2023-06-29,04:00:00,49,10,39,FMN 16 Noorderlaanbrug
676,Noorderlaan,2023-06-29,05:00:00,91,49,42,FMN 16 Noorderlaanbrug
676,Noorderlaan,2023-06-29,06:00:00,124,49,75,FMN 16 Noorderlaanbrug
676,Noorderlaan,2023-06-29,07:00:00,325,114,211,FMN 16 Noorderlaanbrug
676,Noorderlaan,2023-06-29,08:00:00,354,103,251,FMN 16 Noorderlaanbrug
676,Noorderlaan,2023-06-29,09:00:00,225,43,182,FMN 16 Noorderlaanbrug
676,Noorderlaan,2023-06-29,10:00:00,132,57,75,FMN 16 Noorderlaanbrug
676,Noorderlaan,2023-06-29,11:00:00,134,62,72,FMN 16 Noorderlaanbrug
676,Noorderlaan,2023-06-29,12:00:00,143,48,95,FMN 16 Noorderlaanbrug
676,Noorderlaan,2023-06-29,13:00:00,219,96,123,FMN 16 Noorderlaanbrug
676,Noorderlaan,2023-06-29,14:00:00,231,87,144,FMN 16 Noorderlaanbrug
676,Noorderlaan,2023-06-29,15:00:00,190,85,105,FMN 16 Noorderlaanbrug
676,Noorderlaan,2023-06-29,16:00:00,300,142,158,FMN 16 Noorderlaanbrug
676,Noorderlaan,2023-06-29,17:00:00,301,164,137,FMN 16 Noorderlaanbrug
676,Noorderlaan,2023-06-29,18:00:00,181,98,83,FMN 16 Noorderlaanbrug
676,Noorderlaan,2023-06-29,19:00:00,125,48,77,FMN 16 Noorderlaanbrug
676,Noorderlaan,2023-06-29,20:00:00,87,42,45,FMN 16 Noorderlaanbrug
676,Noorderlaan,2023-06-29,21:00:00,95,59,36,FMN 16 Noorderlaanbrug
676,Noorderlaan,2023-06-29,22:00:00,84,43,41,FMN 16 Noorderlaanbrug
676,Noorderlaan,2023-06-29,23:00:00,74,39,35,FMN 16 Noorderlaanbrug
676,Noorderlaan,2023-06-30,00:00:00,41,22,19,FMN 16 Noorderlaanbrug
676,Noorderlaan,2023-06-30,01:00:00,25,16,9,FMN 16 Noorderlaanbrug
676,Noorderlaan,2023-06-30,02:00:00,26,8,18,FMN 16 Noorderlaanbrug
676,Noorderlaan,2023-06-30,03:00:00,19,2,17,FMN 16 Noorderlaanbrug
676,Noorderlaan,2023-06-30,04:00:00,38,12,26,FMN 16 Noorderlaanbrug
676,Noorderlaan,2023-06-30,05:00:00,86,52,34,FMN 16 Noorderlaanbrug
676,Noorderlaan,2023-06-30,06:00:00,114,46,68,FMN 16 Noorderlaanbrug
676,Noorderlaan,2023-06-30,07:00:00,258,98,160,FMN 16 Noorderlaanbrug
676,Noorderlaan,2023-06-30,08:00:00,299,87,212,FMN 16 Noorderlaanbrug
676,Noorderlaan,2023-06-30,09:00:00,183,52,131,FMN 16 Noorderlaanbrug
676,Noorderlaan,2023-06-30,10:00:00,139,54,85,FMN 16 Noorderlaanbrug
676,Noorderlaan,2023-06-30,11:00:00,137,56,81,FMN 16 Noorderlaanbrug
676,Noorderlaan,2023-06-30,12:00:00,145,56,89,FMN 16 Noorderlaanbrug
676,Noorderlaan,2023-06-30,13:00:00,185,82,103,FMN 16 Noorderlaanbrug
676,Noorderlaan,2023-06-30,14:00:00,186,68,118,FMN 16 Noorderlaanbrug
676,Noorderlaan,2023-06-30,15:00:00,269,127,142,FMN 16 Noorderlaanbrug
676,Noorderlaan,2023-06-30,16:00:00,350,163,187,FMN 16 Noorderlaanbrug
676,Noorderlaan,2023-06-30,17:00:00,306,147,159,FMN 16 Noorderlaanbrug
676,Noorderlaan,2023-06-30,18:00:00,208,103,105,FMN 16 Noorderlaanbrug
676,Noorderlaan,2023-06-30,19:00:00,125,43,82,FMN 16 Noorderlaanbrug
676,Noorderlaan,2023-06-30,20:00:00,105,50,55,FMN 16 Noorderlaanbrug
676,Noorderlaan,2023-06-30,21:00:00,85,46,39,FMN 16 Noorderlaanbrug
676,Noorderlaan,2023-06-30,22:00:00,102,47,55,FMN 16 Noorderlaanbrug
676,Noorderlaan,2023-06-30,23:00:00,87,40,47,FMN 16 Noorderlaanbrug
676,Noorderlaan,2023-07-01,00:00:00,53,34,19,FMN 16 Noorderlaanbrug
676,Noorderlaan,2023-07-01,01:00:00,38,23,15,FMN 16 Noorderlaanbrug
676,Noorderlaan,2023-07-01,02:00:00,25,10,15,FMN 16 Noorderlaanbrug
676,Noorderlaan,2023-07-01,03:00:00,33,17,16,FMN 16 Noorderlaanbrug
676,Noorderlaan,2023-07-01,04:00:00,27,11,16,FMN 16 Noorderlaanbrug
676,Noorderlaan,2023-07-01,05:00:00,32,15,17,FMN 16 Noorderlaanbrug
676,Noorderlaan,2023-07-01,06:00:00,53,29,24,FMN 16 Noorderlaanbrug
676,Noorderlaan,2023-07-01,07:00:00,28,12,16,FMN 16 Noorderlaanbrug
676,Noorderlaan,2023-07-01,08:00:00,20,8,12,FMN 16 Noorderlaanbrug
676,Noorderlaan,2023-07-01,09:00:00,53,19,34,FMN 16 Noorderlaanbrug
676,Noorderlaan,2023-07-01,10:00:00,42,16,26,FMN 16 Noorderlaanbrug
676,Noorderlaan,2023-07-01,11:00:00,78,32,46,FMN 16 Noorderlaanbrug
676,Noorderlaan,2023-07-01,12:00:00,73,27,46,FMN 16 Noorderlaanbrug
676,Noorderlaan,2023-07-01,13:00:00,79,24,55,FMN 16 Noorderlaanbrug
676,Noorderlaan,2023-07-01,14:00:00,90,38,52,FMN 16 Noorderlaanbrug
676,Noorderlaan,2023-07-01,15:00:00,69,30,39,FMN 16 Noorderlaanbrug
676,Noorderlaan,2023-07-01,16:00:00,98,42,56,FMN 16 Noorderlaanbrug
676,Noorderlaan,2023-07-01,17:00:00,95,35,60,FMN 16 Noorderlaanbrug
676,Noorderlaan,2023-07-01,18:00:00,97,50,47,FMN 16 Noorderlaanbrug
676,Noorderlaan,2023-07-01,19:00:00,72,31,41,FMN 16 Noorderlaanbrug
676,Noorderlaan,2023-07-01,20:00:00,62,24,38,FMN 16 Noorderlaanbrug
676,Noorderlaan,2023-07-01,21:00:00,44,21,23,FMN 16 Noorderlaanbrug
676,Noorderlaan,2023-07-01,22:00:00,56,26,30,FMN 16 Noorderlaanbrug
676,Noorderlaan,2023-07-01,23:00:00,56,29,27,FMN 16 Noorderlaanbrug
676,Noorderlaan,2023-07-02,00:00:00,36,20,16,FMN 16 Noorderlaanbrug
676,Noorderlaan,2023-07-02,01:00:00,34,14,20,FMN 16 Noorderlaanbrug
676,Noorderlaan,2023-07-02,02:00:00,12,6,6,FMN 16 Noorderlaanbrug
676,Noorderlaan,2023-07-02,03:00:00,19,12,7,FMN 16 Noorderlaanbrug
676,Noorderlaan,2023-07-02,04:00:00,11,6,5,FMN 16 Noorderlaanbrug
676,Noorderlaan,2023-07-02,05:00:00,17,7,10,FMN 16 Noorderlaanbrug
676,Noorderlaan,2023-07-02,06:00:00,31,19,12,FMN 16 Noorderlaanbrug
676,Noorderlaan,2023-07-02,07:00:00,22,11,11,FMN 16 Noorderlaanbrug
676,Noorderlaan,2023-07-02,08:00:00,20,11,9,FMN 16 Noorderlaanbrug
676,Noorderlaan,2023-07-02,09:00:00,74,20,54,FMN 16 Noorderlaanbrug
676,Noorderlaan,2023-07-02,10:00:00,95,36,59,FMN 16 Noorderlaanbrug
676,Noorderlaan,2023-07-02,11:00:00,117,34,83,FMN 16 Noorderlaanbrug
676,Noorderlaan,2023-07-02,12:00:00,100,36,64,FMN 16 Noorderlaanbrug
676,Noorderlaan,2023-07-02,13:00:00,115,36,79,FMN 16 Noorderlaanbrug
676,Noorderlaan,2023-07-02,14:00:00,139,41,98,FMN 16 Noorderlaanbrug
676,Noorderlaan,2023-07-02,15:00:00,113,47,66,FMN 16 Noorderlaanbrug
676,Noorderlaan,2023-07-02,16:00:00,111,64,47,FMN 16 Noorderlaanbrug
676,Noorderlaan,2023-07-02,17:00:00,107,58,49,FMN 16 Noorderlaanbrug
676,Noorderlaan,2023-07-02,18:00:00,101,40,61,FMN 16 Noorderlaanbrug
676,Noorderlaan,2023-07-02,19:00:00,104,52,52,FMN 16 Noorderlaanbrug
676,Noorderlaan,2023-07-02,20:00:00,43,21,22,FMN 16 Noorderlaanbrug
676,Noorderlaan,2023-07-02,21:00:00,67,31,36,FMN 16 Noorderlaanbrug
676,Noorderlaan,2023-07-02,22:00:00,49,22,27,FMN 16 Noorderlaanbrug
676,Noorderlaan,2023-07-02,23:00:00,31,11,20,FMN 16 Noorderlaanbrug
676,Noorderlaan,2023-07-03,00:00:00,13,6,7,FMN 16 Noorderlaanbrug
676,Noorderlaan,2023-07-03,01:00:00,17,14,3,FMN 16 Noorderlaanbrug
676,Noorderlaan,2023-07-03,02:00:00,7,5,2,FMN 16 Noorderlaanbrug
676,Noorderlaan,2023-07-03,03:00:00,8,2,6,FMN 16 Noorderlaanbrug
676,Noorderlaan,2023-07-03,04:00:00,30,11,19,FMN 16 Noorderlaanbrug
676,Noorderlaan,2023-07-03,05:00:00,87,58,29,FMN 16 Noorderlaanbrug
676,Noorderlaan,2023-07-03,06:00:00,141,69,72,FMN 16 Noorderlaanbrug
676,Noorderlaan,2023-07-03,07:00:00,294,108,186,FMN 16 Noorderlaanbrug
676,Noorderlaan,2023-07-03,08:00:00,336,91,245,FMN 16 Noorderlaanbrug
676,Noorderlaan,2023-07-03,09:00:00,159,52,107,FMN 16 Noorderlaanbrug
676,Noorderlaan,2023-07-03,10:00:00,99,33,66,FMN 16 Noorderlaanbrug
676,Noorderlaan,2023-07-03,11:00:00,103,36,67,FMN 16 Noorderlaanbrug
676,Noorderlaan,2023-07-03,12:00:00,137,63,74,FMN 16 Noorderlaanbrug
676,Noorderlaan,2023-07-03,13:00:00,128,59,69,FMN 16 Noorderlaanbrug
676,Noorderlaan,2023-07-03,14:00:00,182,61,121,FMN 16 Noorderlaanbrug
676,Noorderlaan,2023-07-03,15:00:00,166,74,92,FMN 16 Noorderlaanbrug
676,Noorderlaan,2023-07-03,16:00:00,310,132,178,FMN 16 Noorderlaanbrug
676,Noorderlaan,2023-07-03,17:00:00,384,193,191,FMN 16 Noorderlaanbrug
676,Noorderlaan,2023-07-03,18:00:00,198,106,92,FMN 16 Noorderlaanbrug
676,Noorderlaan,2023-07-03,19:00:00,100,40,60,FMN 16 Noorderlaanbrug
676,Noorderlaan,2023-07-03,20:00:00,84,29,55,FMN 16 Noorderlaanbrug
676,Noorderlaan,2023-07-03,21:00:00,73,30,43,FMN 16 Noorderlaanbrug
676,Noorderlaan,2023-07-03,22:00:00,84,30,54,FMN 16 Noorderlaanbrug
676,Noorderlaan,2023-07-03,23:00:00,37,14,23,FMN 16 Noorderlaanbrug
676,Noorderlaan,2023-07-04,00:00:00,10,5,5,FMN 16 Noorderlaanbrug
676,Noorderlaan,2023-07-04,01:00:00,11,7,4,FMN 16 Noorderlaanbrug
676,Noorderlaan,2023-07-04,02:00:00,8,5,3,FMN 16 Noorderlaanbrug
676,Noorderlaan,2023-07-04,03:00:00,12,1,11,FMN 16 Noorderlaanbrug
676,Noorderlaan,2023-07-04,04:00:00,31,13,18,FMN 16 Noorderlaanbrug
676,Noorderlaan,2023-07-04,05:00:00,86,59,27,FMN 16 Noorderlaanbrug
676,Noorderlaan,2023-07-04,06:00:00,137,58,79,FMN 16 Noorderlaanbrug
676,Noorderlaan,2023-07-04,07:00:00,274,113,161,FMN 16 Noorderlaanbrug
676,Noorderlaan,2023-07-04,08:00:00,331,105,226,FMN 16 Noorderlaanbrug
676,Noorderlaan,2023-07-04,09:00:00,167,54,113,FMN 16 Noorderlaanbrug
676,Noorderlaan,2023-07-04,10:00:00,79,30,49,FMN 16 Noorderlaanbrug
676,Noorderlaan,2023-07-04,11:00:00,101,27,74,FMN 16 Noorderlaanbrug
676,Noorderlaan,2023-07-04,12:00:00,158,70,88,FMN 16 Noorderlaanbrug
676,Noorderlaan,2023-07-04,13:00:00,152,63,89,FMN 16 Noorderlaanbrug
676,Noorderlaan,2023-07-04,14:00:00,180,72,108,FMN 16 Noorderlaanbrug
676,Noorderlaan,2023-07-04,15:00:00,190,85,105,FMN 16 Noorderlaanbrug
676,Noorderlaan,2023-07-04,16:00:00,358,157,201,FMN 16 Noorderlaanbrug
676,Noorderlaan,2023-07-04,17:00:00,368,173,195,FMN 16 Noorderlaanbrug
676,Noorderlaan,2023-07-04,18:00:00,200,107,93,FMN 16 Noorderlaanbrug
676,Noorderlaan,2023-07-04,19:00:00,108,49,59,FMN 16 Noorderlaanbrug
676,Noorderlaan,2023-07-04,20:00:00,78,21,57,FMN 16 Noorderlaanbrug
676,Noorderlaan,2023-07-04,21:00:00,46,21,25,FMN 16 Noorderlaanbrug
676,Noorderlaan,2023-07-04,22:00:00,71,25,46,FMN 16 Noorderlaanbrug
676,Noorderlaan,2023-07-04,23:00:00,38,24,14,FMN 16 Noorderlaanbrug
676,Noorderlaan,2023-07-05,00:00:00,19,11,8,FMN 16 Noorderlaanbrug
676,Noorderlaan,2023-07-05,01:00:00,8,3,5,FMN 16 Noorderlaanbrug
676,Noorderlaan,2023-07-05,02:00:00,4,2,2,FMN 16 Noorderlaanbrug
676,Noorderlaan,2023-07-05,03:00:00,10,6,4,FMN 16 Noorderlaanbrug
676,Noorderlaan,2023-07-05,04:00:00,27,7,20,FMN 16 Noorderlaanbrug
676,Noorderlaan,2023-07-05,05:00:00,59,44,15,FMN 16 Noorderlaanbrug
676,Noorderlaan,2023-07-05,06:00:00,108,63,45,FMN 16 Noorderlaanbrug
676,Noorderlaan,2023-07-05,07:00:00,182,85,97,FMN 16 Noorderlaanbrug
676,Noorderlaan,2023-07-05,08:00:00,180,69,111,FMN 16 Noorderlaanbrug
676,Noorderlaan,2023-07-05,09:00:00,119,37,82,FMN 16 Noorderlaanbrug
676,Noorderlaan,2023-07-05,10:00:00,52,20,32,FMN 16 Noorderlaanbrug
676,Noorderlaan,2023-07-05,11:00:00,91,48,43,FMN 16 Noorderlaanbrug
676,Noorderlaan,2023-07-05,12:00:00,73,35,38,FMN 16 Noorderlaanbrug
676,Noorderlaan,2023-07-05,13:00:00,110,64,46,FMN 16 Noorderlaanbrug
676,Noorderlaan,2023-07-05,14:00:00,143,46,97,FMN 16 Noorderlaanbrug
676,Noorderlaan,2023-07-05,15:00:00,87,37,50,FMN 16 Noorderlaanbrug
676,Noorderlaan,2023-07-05,16:00:00,0,0,0,FMN 16 Noorderlaanbrug
676,Noorderlaan,2023-07-05,17:00:00,0,0,0,FMN 16 Noorderlaanbrug
676,Noorderlaan,2023-07-05,18:00:00,0,0,0,FMN 16 Noorderlaanbrug
676,Noorderlaan,2023-07-05,19:00:00,0,0,0,FMN 16 Noorderlaanbrug
676,Noorderlaan,2023-07-05,20:00:00,0,0,0,FMN 16 Noorderlaanbrug
676,Noorderlaan,2023-07-05,21:00:00,0,0,0,FMN 16 Noorderlaanbrug
676,Noorderlaan,2023-07-05,22:00:00,0,0,0,FMN 16 Noorderlaanbrug
676,Noorderlaan,2023-07-05,23:00:00,0,0,0,FMN 16 Noorderlaanbrug
676,Noorderlaan,2023-07-06,00:00:00,0,0,0,FMN 16 Noorderlaanbrug
676,Noorderlaan,2023-07-06,01:00:00,21,10,11,FMN 16 Noorderlaanbrug
676,Noorderlaan,2023-07-06,02:00:00,18,9,9,FMN 16 Noorderlaanbrug
676,Noorderlaan,2023-07-06,03:00:00,12,9,3,FMN 16 Noorderlaanbrug
676,Noorderlaan,2023-07-06,04:00:00,36,21,15,FMN 16 Noorderlaanbrug
676,Noorderlaan,2023-07-06,05:00:00,101,53,48,FMN 16 Noorderlaanbrug
676,Noorderlaan,2023-07-06,06:00:00,146,82,64,FMN 16 Noorderlaanbrug
676,Noorderlaan,2023-07-06,07:00:00,391,240,151,FMN 16 Noorderlaanbrug
676,Noorderlaan,2023-07-06,08:00:00,507,337,170,FMN 16 Noorderlaanbrug
676,Noorderlaan,2023-07-06,09:00:00,190,120,70,FMN 16 Noorderlaanbrug
676,Noorderlaan,2023-07-06,10:00:00,117,74,43,FMN 16 Noorderlaanbrug
676,Noorderlaan,2023-07-06,11:00:00,113,66,47,FMN 16 Noorderlaanbrug
676,Noorderlaan,2023-07-06,12:00:00,172,98,74,FMN 16 Noorderlaanbrug
676,Noorderlaan,2023-07-06,13:00:00,175,87,88,FMN 16 Noorderlaanbrug
676,Noorderlaan,2023-07-06,14:00:00,191,109,82,FMN 16 Noorderlaanbrug
676,Noorderlaan,2023-07-06,15:00:00,227,120,107,FMN 16 Noorderlaanbrug
676,Noorderlaan,2023-07-06,16:00:00,389,203,186,FMN 16 Noorderlaanbrug
676,Noorderlaan,2023-07-06,17:00:00,401,198,203,FMN 16 Noorderlaanbrug
676,Noorderlaan,2023-07-06,18:00:00,223,103,120,FMN 16 Noorderlaanbrug
676,Noorderlaan,2023-07-06,19:00:00,113,62,51,FMN 16 Noorderlaanbrug
676,Noorderlaan,2023-07-06,20:00:00,67,32,35,FMN 16 Noorderlaanbrug
676,Noorderlaan,2023-07-06,21:00:00,63,29,34,FMN 16 Noorderlaanbrug
676,Noorderlaan,2023-07-06,22:00:00,104,54,50,FMN 16 Noorderlaanbrug
676,Noorderlaan,2023-07-06,23:00:00,50,22,28,FMN 16 Noorderlaanbrug
676,Noorderlaan,2023-07-07,00:00:00,0,0,0,FMN 16 Noorderlaanbrug
676,Noorderlaan,2023-07-07,01:00:00,11,7,4,FMN 16 Noorderlaanbrug
676,Noorderlaan,2023-07-07,02:00:00,5,1,4,FMN 16 Noorderlaanbrug
676,Noorderlaan,2023-07-07,03:00:00,17,10,7,FMN 16 Noorderlaanbrug
676,Noorderlaan,2023-07-07,04:00:00,19,7,12,FMN 16 Noorderlaanbrug
676,Noorderlaan,2023-07-07,05:00:00,60,30,30,FMN 16 Noorderlaanbrug
676,Noorderlaan,2023-07-07,06:00:00,103,48,55,FMN 16 Noorderlaanbrug
676,Noorderlaan,2023-07-07,07:00:00,221,132,89,FMN 16 Noorderlaanbrug
676,Noorderlaan,2023-07-07,08:00:00,305,195,110,FMN 16 Noorderlaanbrug
676,Noorderlaan,2023-07-07,09:00:00,126,85,41,FMN 16 Noorderlaanbrug
676,Noorderlaan,2023-07-07,10:00:00,107,66,41,FMN 16 Noorderlaanbrug
676,Noorderlaan,2023-07-07,11:00:00,115,65,50,FMN 16 Noorderlaanbrug
676,Noorderlaan,2023-07-07,12:00:00,115,62,53,FMN 16 Noorderlaanbrug
676,Noorderlaan,2023-07-07,13:00:00,150,82,68,FMN 16 Noorderlaanbrug
676,Noorderlaan,2023-07-07,14:00:00,144,81,63,FMN 16 Noorderlaanbrug
676,Noorderlaan,2023-07-07,15:00:00,187,95,92,FMN 16 Noorderlaanbrug
676,Noorderlaan,2023-07-07,16:00:00,309,177,132,FMN 16 Noorderlaanbrug
676,Noorderlaan,2023-07-07,17:00:00,247,134,113,FMN 16 Noorderlaanbrug
676,Noorderlaan,2023-07-07,18:00:00,168,91,77,FMN 16 Noorderlaanbrug
676,Noorderlaan,2023-07-07,19:00:00,107,56,51,FMN 16 Noorderlaanbrug
676,Noorderlaan,2023-07-07,20:00:00,78,41,37,FMN 16 Noorderlaanbrug
676,Noorderlaan,2023-07-07,21:00:00,76,39,37,FMN 16 Noorderlaanbrug
676,Noorderlaan,2023-07-07,22:00:00,67,30,37,FMN 16 Noorderlaanbrug
676,Noorderlaan,2023-07-07,23:00:00,57,22,35,FMN 16 Noorderlaanbrug
676,Noorderlaan,2023-07-08,00:00:00,0,0,0,FMN 16 Noorderlaanbrug
676,Noorderlaan,2023-07-08,01:00:00,36,13,23,FMN 16 Noorderlaanbrug
676,Noorderlaan,2023-07-08,02:00:00,36,15,21,FMN 16 Noorderlaanbrug
676,Noorderlaan,2023-07-08,03:00:00,25,17,8,FMN 16 Noorderlaanbrug
676,Noorderlaan,2023-07-08,04:00:00,27,12,15,FMN 16 Noorderlaanbrug
676,Noorderlaan,2023-07-08,05:00:00,31,10,21,FMN 16 Noorderlaanbrug
676,Noorderlaan,2023-07-08,06:00:00,31,17,14,FMN 16 Noorderlaanbrug
676,Noorderlaan,2023-07-08,07:00:00,31,20,11,FMN 16 Noorderlaanbrug
676,Noorderlaan,2023-07-08,08:00:00,45,29,16,FMN 16 Noorderlaanbrug
676,Noorderlaan,2023-07-08,09:00:00,75,53,22,FMN 16 Noorderlaanbrug
676,Noorderlaan,2023-07-08,10:00:00,93,58,35,FMN 16 Noorderlaanbrug
676,Noorderlaan,2023-07-08,11:00:00,121,75,46,FMN 16 Noorderlaanbrug
676,Noorderlaan,2023-07-08,12:00:00,111,75,36,FMN 16 Noorderlaanbrug
676,Noorderlaan,2023-07-08,13:00:00,149,94,55,FMN 16 Noorderlaanbrug
676,Noorderlaan,2023-07-08,14:00:00,149,87,62,FMN 16 Noorderlaanbrug
676,Noorderlaan,2023-07-08,15:00:00,129,67,62,FMN 16 Noorderlaanbrug
676,Noorderlaan,2023-07-08,16:00:00,134,89,45,FMN 16 Noorderlaanbrug
676,Noorderlaan,2023-07-08,17:00:00,125,69,56,FMN 16 Noorderlaanbrug
676,Noorderlaan,2023-07-08,18:00:00,109,60,49,FMN 16 Noorderlaanbrug
676,Noorderlaan,2023-07-08,19:00:00,93,55,38,FMN 16 Noorderlaanbrug
676,Noorderlaan,2023-07-08,20:00:00,61,34,27,FMN 16 Noorderlaanbrug
676,Noorderlaan,2023-07-08,21:00:00,39,17,22,FMN 16 Noorderlaanbrug
676,Noorderlaan,2023-07-08,22:00:00,57,26,31,FMN 16 Noorderlaanbrug
676,Noorderlaan,2023-07-08,23:00:00,53,32,21,FMN 16 Noorderlaanbrug
676,Noorderlaan,2023-07-09,00:00:00,0,0,0,FMN 16 Noorderlaanbrug
676,Noorderlaan,2023-07-09,01:00:00,41,15,26,FMN 16 Noorderlaanbrug
676,Noorderlaan,2023-07-09,02:00:00,17,7,10,FMN 16 Noorderlaanbrug
676,Noorderlaan,2023-07-09,03:00:00,26,13,13,FMN 16 Noorderlaanbrug
676,Noorderlaan,2023-07-09,04:00:00,17,9,8,FMN 16 Noorderlaanbrug
676,Noorderlaan,2023-07-09,05:00:00,21,12,9,FMN 16 Noorderlaanbrug
676,Noorderlaan,2023-07-09,06:00:00,36,21,15,FMN 16 Noorderlaanbrug
676,Noorderlaan,2023-07-09,07:00:00,12,8,4,FMN 16 Noorderlaanbrug
676,Noorderlaan,2023-07-09,08:00:00,24,18,6,FMN 16 Noorderlaanbrug
676,Noorderlaan,2023-07-09,09:00:00,69,41,28,FMN 16 Noorderlaanbrug
676,Noorderlaan,2023-07-09,10:00:00,52,35,17,FMN 16 Noorderlaanbrug
676,Noorderlaan,2023-07-09,11:00:00,73,48,25,FMN 16 Noorderlaanbrug
676,Noorderlaan,2023-07-09,12:00:00,80,45,35,FMN 16 Noorderlaanbrug
676,Noorderlaan,2023-07-09,13:00:00,96,52,44,FMN 16 Noorderlaanbrug
676,Noorderlaan,2023-07-09,14:00:00,72,42,30,FMN 16 Noorderlaanbrug
676,Noorderlaan,2023-07-09,15:00:00,83,41,42,FMN 16 Noorderlaanbrug
676,Noorderlaan,2023-07-09,16:00:00,70,37,33,FMN 16 Noorderlaanbrug
676,Noorderlaan,2023-07-09,17:00:00,75,35,40,FMN 16 Noorderlaanbrug
676,Noorderlaan,2023-07-09,18:00:00,69,32,37,FMN 16 Noorderlaanbrug
676,Noorderlaan,2023-07-09,19:00:00,58,29,29,FMN 16 Noorderlaanbrug
676,Noorderlaan,2023-07-09,20:00:00,50,28,22,FMN 16 Noorderlaanbrug
676,Noorderlaan,2023-07-09,21:00:00,45,23,22,FMN 16 Noorderlaanbrug
676,Noorderlaan,2023-07-09,22:00:00,38,24,14,FMN 16 Noorderlaanbrug
676,Noorderlaan,2023-07-09,23:00:00,21,12,9,FMN 16 Noorderlaanbrug
676,Noorderlaan,2023-07-10,00:00:00,0,0,0,FMN 16 Noorderlaanbrug
676,Noorderlaan,2023-07-10,01:00:00,16,7,9,FMN 16 Noorderlaanbrug
676,Noorderlaan,2023-07-10,02:00:00,7,3,4,FMN 16 Noorderlaanbrug
676,Noorderlaan,2023-07-10,03:00:00,9,6,3,FMN 16 Noorderlaanbrug
676,Noorderlaan,2023-07-10,04:00:00,27,16,11,FMN 16 Noorderlaanbrug
676,Noorderlaan,2023-07-10,05:00:00,70,30,40,FMN 16 Noorderlaanbrug
676,Noorderlaan,2023-07-10,06:00:00,131,83,48,FMN 16 Noorderlaanbrug
676,Noorderlaan,2023-07-10,07:00:00,273,172,101,FMN 16 Noorderlaanbrug
676,Noorderlaan,2023-07-10,08:00:00,402,269,133,FMN 16 Noorderlaanbrug
676,Noorderlaan,2023-07-10,09:00:00,133,78,55,FMN 16 Noorderlaanbrug
676,Noorderlaan,2023-07-10,10:00:00,83,57,26,FMN 16 Noorderlaanbrug
676,Noorderlaan,2023-07-10,11:00:00,93,60,33,FMN 16 Noorderlaanbrug
676,Noorderlaan,2023-07-10,12:00:00,124,62,62,FMN 16 Noorderlaanbrug
676,Noorderlaan,2023-07-10,13:00:00,150,60,90,FMN 16 Noorderlaanbrug
676,Noorderlaan,2023-07-10,14:00:00,151,81,70,FMN 16 Noorderlaanbrug
676,Noorderlaan,2023-07-10,15:00:00,181,84,97,FMN 16 Noorderlaanbrug
676,Noorderlaan,2023-07-10,16:00:00,322,145,177,FMN 16 Noorderlaanbrug
676,Noorderlaan,2023-07-10,17:00:00,343,151,192,FMN 16 Noorderlaanbrug
676,Noorderlaan,2023-07-10,18:00:00,157,68,89,FMN 16 Noorderlaanbrug
676,Noorderlaan,2023-07-10,19:00:00,82,37,45,FMN 16 Noorderlaanbrug
676,Noorderlaan,2023-07-10,20:00:00,54,22,32,FMN 16 Noorderlaanbrug
676,Noorderlaan,2023-07-10,21:00:00,49,24,25,FMN 16 Noorderlaanbrug
676,Noorderlaan,2023-07-10,22:00:00,69,39,30,FMN 16 Noorderlaanbrug
676,Noorderlaan,2023-07-10,23:00:00,26,17,9,FMN 16 Noorderlaanbrug
676,Noorderlaan,2023-07-11,00:00:00,0,0,0,FMN 16 Noorderlaanbrug
676,Noorderlaan,2023-07-11,01:00:00,0,0,0,FMN 16 Noorderlaanbrug
676,Noorderlaan,2023-07-11,02:00:00,0,0,0,FMN 16 Noorderlaanbrug
676,Noorderlaan,2023-07-11,03:00:00,0,0,0,FMN 16 Noorderlaanbrug
676,Noorderlaan,2023-07-11,04:00:00,0,0,0,FMN 16 Noorderlaanbrug
676,Noorderlaan,2023-07-11,05:00:00,0,0,0,FMN 16 Noorderlaanbrug
676,Noorderlaan,2023-07-11,06:00:00,0,0,0,FMN 16 Noorderlaanbrug
676,Noorderlaan,2023-07-11,07:00:00,0,0,0,FMN 16 Noorderlaanbrug
676,Noorderlaan,2023-07-11,08:00:00,0,0,0,FMN 16 Noorderlaanbrug
676,Noorderlaan,2023-07-11,09:00:00,0,0,0,FMN 16 Noorderlaanbrug
676,Noorderlaan,2023-07-11,10:00:00,0,0,0,FMN 16 Noorderlaanbrug
676,Noorderlaan,2023-07-11,11:00:00,0,0,0,FMN 16 Noorderlaanbrug
676,Noorderlaan,2023-07-11,12:00:00,0,0,0,FMN 16 Noorderlaanbrug
676,Noorderlaan,2023-07-11,13:00:00,0,0,0,FMN 16 Noorderlaanbrug
676,Noorderlaan,2023-07-11,14:00:00,107,40,67,FMN 16 Noorderlaanbrug
676,Noorderlaan,2023-07-11,15:00:00,184,76,108,FMN 16 Noorderlaanbrug
676,Noorderlaan,2023-07-11,16:00:00,261,98,163,FMN 16 Noorderlaanbrug
676,Noorderlaan,2023-07-11,17:00:00,313,114,199,FMN 16 Noorderlaanbrug
676,Noorderlaan,2023-07-11,18:00:00,213,86,127,FMN 16 Noorderlaanbrug
676,Noorderlaan,2023-07-11,19:00:00,134,46,88,FMN 16 Noorderlaanbrug
676,Noorderlaan,2023-07-11,20:00:00,110,40,70,FMN 16 Noorderlaanbrug
676,Noorderlaan,2023-07-11,21:00:00,88,39,49,FMN 16 Noorderlaanbrug
676,Noorderlaan,2023-07-11,22:00:00,89,40,49,FMN 16 Noorderlaanbrug
676,Noorderlaan,2023-07-11,23:00:00,59,36,23,FMN 16 Noorderlaanbrug
676,Noorderlaan,2023-07-12,00:00:00,18,11,7,FMN 16 Noorderlaanbrug
676,Noorderlaan,2023-07-12,01:00:00,17,8,9,FMN 16 Noorderlaanbrug
676,Noorderlaan,2023-07-12,02:00:00,7,6,1,FMN 16 Noorderlaanbrug
676,Noorderlaan,2023-07-12,03:00:00,8,3,5,FMN 16 Noorderlaanbrug
676,Noorderlaan,2023-07-12,04:00:00,36,17,19,FMN 16 Noorderlaanbrug
676,Noorderlaan,2023-07-12,05:00:00,72,46,26,FMN 16 Noorderlaanbrug
676,Noorderlaan,2023-07-12,06:00:00,92,42,50,FMN 16 Noorderlaanbrug
676,Noorderlaan,2023-07-12,07:00:00,250,114,136,FMN 16 Noorderlaanbrug
676,Noorderlaan,2023-07-12,08:00:00,269,90,179,FMN 16 Noorderlaanbrug
676,Noorderlaan,2023-07-12,09:00:00,127,34,93,FMN 16 Noorderlaanbrug
676,Noorderlaan,2023-07-12,10:00:00,93,38,55,FMN 16 Noorderlaanbrug
676,Noorderlaan,2023-07-12,11:00:00,101,36,65,FMN 16 Noorderlaanbrug
676,Noorderlaan,2023-07-12,12:00:00,134,55,79,FMN 16 Noorderlaanbrug
676,Noorderlaan,2023-07-12,13:00:00,143,67,76,FMN 16 Noorderlaanbrug
676,Noorderlaan,2023-07-12,14:00:00,168,45,123,FMN 16 Noorderlaanbrug
676,Noorderlaan,2023-07-12,15:00:00,162,72,90,FMN 16 Noorderlaanbrug
676,Noorderlaan,2023-07-12,16:00:00,311,125,186,FMN 16 Noorderlaanbrug
676,Noorderlaan,2023-07-12,17:00:00,340,159,181,FMN 16 Noorderlaanbrug
676,Noorderlaan,2023-07-12,18:00:00,191,82,109,FMN 16 Noorderlaanbrug
676,Noorderlaan,2023-07-12,19:00:00,122,52,70,FMN 16 Noorderlaanbrug
676,Noorderlaan,2023-07-12,20:00:00,80,33,47,FMN 16 Noorderlaanbrug
676,Noorderlaan,2023-07-12,21:00:00,69,28,41,FMN 16 Noorderlaanbrug
676,Noorderlaan,2023-07-12,22:00:00,84,30,54,FMN 16 Noorderlaanbrug
676,Noorderlaan,2023-07-12,23:00:00,47,24,23,FMN 16 Noorderlaanbrug
676,Noorderlaan,2023-07-13,00:00:00,24,15,9,FMN 16 Noorderlaanbrug
676,Noorderlaan,2023-07-13,01:00:00,24,13,11,FMN 16 Noorderlaanbrug
676,Noorderlaan,2023-07-13,02:00:00,10,8,2,FMN 16 Noorderlaanbrug
676,Noorderlaan,2023-07-13,03:00:00,16,10,6,FMN 16 Noorderlaanbrug
676,Noorderlaan,2023-07-13,04:00:00,31,12,19,FMN 16 Noorderlaanbrug
676,Noorderlaan,2023-07-13,05:00:00,80,52,28,FMN 16 Noorderlaanbrug
676,Noorderlaan,2023-07-13,06:00:00,114,56,58,FMN 16 Noorderlaanbrug
676,Noorderlaan,2023-07-13,07:00:00,283,111,172,FMN 16 Noorderlaanbrug
676,Noorderlaan,2023-07-13,08:00:00,293,98,195,FMN 16 Noorderlaanbrug
676,Noorderlaan,2023-07-13,09:00:00,122,38,84,FMN 16 Noorderlaanbrug
676,Noorderlaan,2023-07-13,10:00:00,99,36,63,FMN 16 Noorderlaanbrug
676,Noorderlaan,2023-07-13,11:00:00,115,34,81,FMN 16 Noorderlaanbrug
676,Noorderlaan,2023-07-13,12:00:00,122,60,62,FMN 16 Noorderlaanbrug
676,Noorderlaan,2023-07-13,13:00:00,90,42,48,FMN 16 Noorderlaanbrug
676,Noorderlaan,2023-07-13,14:00:00,139,49,90,FMN 16 Noorderlaanbrug
676,Noorderlaan,2023-07-13,15:00:00,146,60,86,FMN 16 Noorderlaanbrug
676,Noorderlaan,2023-07-13,16:00:00,273,111,162,FMN 16 Noorderlaanbrug
676,Noorderlaan,2023-07-13,17:00:00,317,142,175,FMN 16 Noorderlaanbrug
676,Noorderlaan,2023-07-13,18:00:00,179,79,100,FMN 16 Noorderlaanbrug
676,Noorderlaan,2023-07-13,19:00:00,123,49,74,FMN 16 Noorderlaanbrug
676,Noorderlaan,2023-07-13,20:00:00,78,34,44,FMN 16 Noorderlaanbrug
676,Noorderlaan,2023-07-13,21:00:00,70,34,36,FMN 16 Noorderlaanbrug
676,Noorderlaan,2023-07-13,22:00:00,71,27,44,FMN 16 Noorderlaanbrug
676,Noorderlaan,2023-07-13,23:00:00,65,38,27,FMN 16 Noorderlaanbrug
676,Noorderlaan,2023-07-14,00:00:00,25,11,14,FMN 16 Noorderlaanbrug
676,Noorderlaan,2023-07-14,01:00:00,17,7,10,FMN 16 Noorderlaanbrug
676,Noorderlaan,2023-07-14,02:00:00,13,8,5,FMN 16 Noorderlaanbrug
676,Noorderlaan,2023-07-14,03:00:00,11,2,9,FMN 16 Noorderlaanbrug
676,Noorderlaan,2023-07-14,04:00:00,28,14,14,FMN 16 Noorderlaanbrug
676,Noorderlaan,2023-07-14,05:00:00,76,51,25,FMN 16 Noorderlaanbrug
676,Noorderlaan,2023-07-14,06:00:00,117,57,60,FMN 16 Noorderlaanbrug
676,Noorderlaan,2023-07-14,07:00:00,204,89,115,FMN 16 Noorderlaanbrug
676,Noorderlaan,2023-07-14,08:00:00,232,77,155,FMN 16 Noorderlaanbrug
676,Noorderlaan,2023-07-14,09:00:00,122,37,85,FMN 16 Noorderlaanbrug
676,Noorderlaan,2023-07-14,10:00:00,120,28,92,FMN 16 Noorderlaanbrug
676,Noorderlaan,2023-07-14,11:00:00,109,45,64,FMN 16 Noorderlaanbrug
676,Noorderlaan,2023-07-14,12:00:00,142,56,86,FMN 16 Noorderlaanbrug
676,Noorderlaan,2023-07-14,13:00:00,186,78,108,FMN 16 Noorderlaanbrug
676,Noorderlaan,2023-07-14,14:00:00,196,58,138,FMN 16 Noorderlaanbrug
676,Noorderlaan,2023-07-14,15:00:00,217,93,124,FMN 16 Noorderlaanbrug
676,Noorderlaan,2023-07-14,16:00:00,304,123,181,FMN 16 Noorderlaanbrug
676,Noorderlaan,2023-07-14,17:00:00,248,114,134,FMN 16 Noorderlaanbrug
676,Noorderlaan,2023-07-14,18:00:00,177,75,102,FMN 16 Noorderlaanbrug
676,Noorderlaan,2023-07-14,19:00:00,120,51,69,FMN 16 Noorderlaanbrug
676,Noorderlaan,2023-07-14,20:00:00,93,35,58,FMN 16 Noorderlaanbrug
676,Noorderlaan,2023-07-14,21:00:00,85,38,47,FMN 16 Noorderlaanbrug
676,Noorderlaan,2023-07-14,22:00:00,77,29,48,FMN 16 Noorderlaanbrug
676,Noorderlaan,2023-07-14,23:00:00,61,36,25,FMN 16 Noorderlaanbrug
676,Noorderlaan,2023-07-15,00:00:00,63,37,26,FMN 16 Noorderlaanbrug
676,Noorderlaan,2023-07-15,01:00:00,27,12,15,FMN 16 Noorderlaanbrug
676,Noorderlaan,2023-07-15,02:00:00,15,10,5,FMN 16 Noorderlaanbrug
676,Noorderlaan,2023-07-15,03:00:00,25,18,7,FMN 16 Noorderlaanbrug
676,Noorderlaan,2023-07-15,04:00:00,10,7,3,FMN 16 Noorderlaanbrug
676,Noorderlaan,2023-07-15,05:00:00,29,15,14,FMN 16 Noorderlaanbrug
676,Noorderlaan,2023-07-15,06:00:00,31,12,19,FMN 16 Noorderlaanbrug
676,Noorderlaan,2023-07-15,07:00:00,32,16,16,FMN 16 Noorderlaanbrug
676,Noorderlaan,2023-07-15,08:00:00,29,6,23,FMN 16 Noorderlaanbrug
676,Noorderlaan,2023-07-15,09:00:00,87,19,68,FMN 16 Noorderlaanbrug
676,Noorderlaan,2023-07-15,10:00:00,112,34,78,FMN 16 Noorderlaanbrug
676,Noorderlaan,2023-07-15,11:00:00,109,42,67,FMN 16 Noorderlaanbrug
676,Noorderlaan,2023-07-15,12:00:00,122,44,78,FMN 16 Noorderlaanbrug
676,Noorderlaan,2023-07-15,13:00:00,127,42,85,FMN 16 Noorderlaanbrug
676,Noorderlaan,2023-07-15,14:00:00,134,44,90,FMN 16 Noorderlaanbrug
676,Noorderlaan,2023-07-15,15:00:00,113,49,64,FMN 16 Noorderlaanbrug
676,Noorderlaan,2023-07-15,16:00:00,135,58,77,FMN 16 Noorderlaanbrug
676,Noorderlaan,2023-07-15,17:00:00,98,46,52,FMN 16 Noorderlaanbrug
676,Noorderlaan,2023-07-15,18:00:00,128,76,52,FMN 16 Noorderlaanbrug
676,Noorderlaan,2023-07-15,19:00:00,105,38,67,FMN 16 Noorderlaanbrug
676,Noorderlaan,2023-07-15,20:00:00,88,40,48,FMN 16 Noorderlaanbrug
676,Noorderlaan,2023-07-15,21:00:00,52,27,25,FMN 16 Noorderlaanbrug
676,Noorderlaan,2023-07-15,22:00:00,44,26,18,FMN 16 Noorderlaanbrug
676,Noorderlaan,2023-07-15,23:00:00,66,34,32,FMN 16 Noorderlaanbrug
676,Noorderlaan,2023-07-16,00:00:00,44,31,13,FMN 16 Noorderlaanbrug
676,Noorderlaan,2023-07-16,01:00:00,44,35,9,FMN 16 Noorderlaanbrug
676,Noorderlaan,2023-07-16,02:00:00,19,13,6,FMN 16 Noorderlaanbrug
676,Noorderlaan,2023-07-16,03:00:00,27,9,18,FMN 16 Noorderlaanbrug
676,Noorderlaan,2023-07-16,04:00:00,11,6,5,FMN 16 Noorderlaanbrug
676,Noorderlaan,2023-07-16,05:00:00,17,11,6,FMN 16 Noorderlaanbrug
676,Noorderlaan,2023-07-16,06:00:00,28,16,12,FMN 16 Noorderlaanbrug
676,Noorderlaan,2023-07-16,07:00:00,23,10,13,FMN 16 Noorderlaanbrug
676,Noorderlaan,2023-07-16,08:00:00,32,8,24,FMN 16 Noorderlaanbrug
676,Noorderlaan,2023-07-16,09:00:00,48,18,30,FMN 16 Noorderlaanbrug
676,Noorderlaan,2023-07-16,10:00:00,96,25,71,FMN 16 Noorderlaanbrug
676,Noorderlaan,2023-07-16,11:00:00,95,40,55,FMN 16 Noorderlaanbrug
676,Noorderlaan,2023-07-16,12:00:00,83,31,52,FMN 16 Noorderlaanbrug
676,Noorderlaan,2023-07-16,13:00:00,69,29,40,FMN 16 Noorderlaanbrug
676,Noorderlaan,2023-07-16,14:00:00,105,36,69,FMN 16 Noorderlaanbrug
676,Noorderlaan,2023-07-16,15:00:00,81,43,38,FMN 16 Noorderlaanbrug
676,Noorderlaan,2023-07-16,16:00:00,81,44,37,FMN 16 Noorderlaanbrug
676,Noorderlaan,2023-07-16,17:00:00,59,29,30,FMN 16 Noorderlaanbrug
676,Noorderlaan,2023-07-16,18:00:00,59,32,27,FMN 16 Noorderlaanbrug
676,Noorderlaan,2023-07-16,19:00:00,69,34,35,FMN 16 Noorderlaanbrug
676,Noorderlaan,2023-07-16,20:00:00,59,27,32,FMN 16 Noorderlaanbrug
676,Noorderlaan,2023-07-16,21:00:00,38,22,16,FMN 16 Noorderlaanbrug
676,Noorderlaan,2023-07-16,22:00:00,39,18,21,FMN 16 Noorderlaanbrug
676,Noorderlaan,2023-07-16,23:00:00,26,8,18,FMN 16 Noorderlaanbrug
676,Noorderlaan,2023-07-17,00:00:00,20,10,10,FMN 16 Noorderlaanbrug
676,Noorderlaan,2023-07-17,01:00:00,13,7,6,FMN 16 Noorderlaanbrug
676,Noorderlaan,2023-07-17,02:00:00,11,3,8,FMN 16 Noorderlaanbrug
676,Noorderlaan,2023-07-17,03:00:00,9,4,5,FMN 16 Noorderlaanbrug
676,Noorderlaan,2023-07-17,04:00:00,30,17,13,FMN 16 Noorderlaanbrug
676,Noorderlaan,2023-07-17,05:00:00,79,51,28,FMN 16 Noorderlaanbrug
676,Noorderlaan,2023-07-17,06:00:00,120,69,51,FMN 16 Noorderlaanbrug
676,Noorderlaan,2023-07-17,07:00:00,225,92,133,FMN 16 Noorderlaanbrug
676,Noorderlaan,2023-07-17,08:00:00,299,92,207,FMN 16 Noorderlaanbrug
676,Noorderlaan,2023-07-17,09:00:00,155,52,103,FMN 16 Noorderlaanbrug
676,Noorderlaan,2023-07-17,10:00:00,105,43,62,FMN 16 Noorderlaanbrug
676,Noorderlaan,2023-07-17,11:00:00,104,37,67,FMN 16 Noorderlaanbrug
676,Noorderlaan,2023-07-17,12:00:00,108,41,67,FMN 16 Noorderlaanbrug
676,Noorderlaan,2023-07-17,13:00:00,107,60,47,FMN 16 Noorderlaanbrug
676,Noorderlaan,2023-07-17,14:00:00,198,55,143,FMN 16 Noorderlaanbrug
676,Noorderlaan,2023-07-17,15:00:00,173,67,106,FMN 16 Noorderlaanbrug
676,Noorderlaan,2023-07-17,16:00:00,284,122,162,FMN 16 Noorderlaanbrug
676,Noorderlaan,2023-07-17,17:00:00,295,146,149,FMN 16 Noorderlaanbrug
676,Noorderlaan,2023-07-17,18:00:00,183,79,104,FMN 16 Noorderlaanbrug
676,Noorderlaan,2023-07-17,19:00:00,118,41,77,FMN 16 Noorderlaanbrug
676,Noorderlaan,2023-07-17,20:00:00,105,53,52,FMN 16 Noorderlaanbrug
676,Noorderlaan,2023-07-17,21:00:00,71,35,36,FMN 16 Noorderlaanbrug
676,Noorderlaan,2023-07-17,22:00:00,84,24,60,FMN 16 Noorderlaanbrug
676,Noorderlaan,2023-07-17,23:00:00,34,9,25,FMN 16 Noorderlaanbrug
676,Noorderlaan,2023-07-18,00:00:00,9,7,2,FMN 16 Noorderlaanbrug
676,Noorderlaan,2023-07-18,01:00:00,13,6,7,FMN 16 Noorderlaanbrug
676,Noorderlaan,2023-07-18,02:00:00,11,5,6,FMN 16 Noorderlaanbrug
676,Noorderlaan,2023-07-18,03:00:00,12,5,7,FMN 16 Noorderlaanbrug
676,Noorderlaan,2023-07-18,04:00:00,33,14,19,FMN 16 Noorderlaanbrug
676,Noorderlaan,2023-07-18,05:00:00,81,47,34,FMN 16 Noorderlaanbrug
676,Noorderlaan,2023-07-18,06:00:00,141,71,70,FMN 16 Noorderlaanbrug
676,Noorderlaan,2023-07-18,07:00:00,278,101,177,FMN 16 Noorderlaanbrug
676,Noorderlaan,2023-07-18,08:00:00,302,103,199,FMN 16 Noorderlaanbrug
676,Noorderlaan,2023-07-18,09:00:00,145,58,87,FMN 16 Noorderlaanbrug
676,Noorderlaan,2023-07-18,10:00:00,100,33,67,FMN 16 Noorderlaanbrug
676,Noorderlaan,2023-07-18,11:00:00,131,37,94,FMN 16 Noorderlaanbrug
676,Noorderlaan,2023-07-18,12:00:00,154,49,105,FMN 16 Noorderlaanbrug
676,Noorderlaan,2023-07-18,13:00:00,156,78,78,FMN 16 Noorderlaanbrug
676,Noorderlaan,2023-07-18,14:00:00,199,60,139,FMN 16 Noorderlaanbrug
676,Noorderlaan,2023-07-18,15:00:00,235,104,131,FMN 16 Noorderlaanbrug
676,Noorderlaan,2023-07-18,16:00:00,383,189,194,FMN 16 Noorderlaanbrug
676,Noorderlaan,2023-07-18,17:00:00,337,153,184,FMN 16 Noorderlaanbrug
676,Noorderlaan,2023-07-18,18:00:00,215,110,105,FMN 16 Noorderlaanbrug
676,Noorderlaan,2023-07-18,19:00:00,135,61,74,FMN 16 Noorderlaanbrug
676,Noorderlaan,2023-07-18,20:00:00,96,40,56,FMN 16 Noorderlaanbrug
676,Noorderlaan,2023-07-18,21:00:00,92,52,40,FMN 16 Noorderlaanbrug
676,Noorderlaan,2023-07-18,22:00:00,100,31,69,FMN 16 Noorderlaanbrug
676,Noorderlaan,2023-07-18,23:00:00,65,31,34,FMN 16 Noorderlaanbrug
676,Noorderlaan,2023-07-19,00:00:00,18,11,7,FMN 16 Noorderlaanbrug
676,Noorderlaan,2023-07-19,01:00:00,12,4,8,FMN 16 Noorderlaanbrug
676,Noorderlaan,2023-07-19,02:00:00,10,6,4,FMN 16 Noorderlaanbrug
676,Noorderlaan,2023-07-19,03:00:00,18,8,10,FMN 16 Noorderlaanbrug
676,Noorderlaan,2023-07-19,04:00:00,38,15,23,FMN 16 Noorderlaanbrug
676,Noorderlaan,2023-07-19,05:00:00,84,57,27,FMN 16 Noorderlaanbrug
676,Noorderlaan,2023-07-19,06:00:00,130,63,67,FMN 16 Noorderlaanbrug
676,Noorderlaan,2023-07-19,07:00:00,223,91,132,FMN 16 Noorderlaanbrug
676,Noorderlaan,2023-07-19,08:00:00,277,98,179,FMN 16 Noorderlaanbrug
676,Noorderlaan,2023-07-19,09:00:00,139,45,94,FMN 16 Noorderlaanbrug
676,Noorderlaan,2023-07-19,10:00:00,96,37,59,FMN 16 Noorderlaanbrug
676,Noorderlaan,2023-07-19,11:00:00,125,38,87,FMN 16 Noorderlaanbrug
676,Noorderlaan,2023-07-19,12:00:00,113,47,66,FMN 16 Noorderlaanbrug
676,Noorderlaan,2023-07-19,13:00:00,138,70,68,FMN 16 Noorderlaanbrug
676,Noorderlaan,2023-07-19,14:00:00,172,65,107,FMN 16 Noorderlaanbrug
676,Noorderlaan,2023-07-19,15:00:00,176,65,111,FMN 16 Noorderlaanbrug
676,Noorderlaan,2023-07-19,16:00:00,276,102,174,FMN 16 Noorderlaanbrug
676,Noorderlaan,2023-07-19,17:00:00,314,135,179,FMN 16 Noorderlaanbrug
676,Noorderlaan,2023-07-19,18:00:00,188,87,101,FMN 16 Noorderlaanbrug
676,Noorderlaan,2023-07-19,19:00:00,130,47,83,FMN 16 Noorderlaanbrug
676,Noorderlaan,2023-07-19,20:00:00,105,58,47,FMN 16 Noorderlaanbrug
676,Noorderlaan,2023-07-19,21:00:00,61,36,25,FMN 16 Noorderlaanbrug
676,Noorderlaan,2023-07-19,22:00:00,105,48,57,FMN 16 Noorderlaanbrug
676,Noorderlaan,2023-07-19,23:00:00,37,16,21,FMN 16 Noorderlaanbrug
676,Noorderlaan,2023-07-20,00:00:00,27,11,16,FMN 16 Noorderlaanbrug
676,Noorderlaan,2023-07-20,01:00:00,28,9,19,FMN 16 Noorderlaanbrug
676,Noorderlaan,2023-07-20,02:00:00,11,7,4,FMN 16 Noorderlaanbrug
676,Noorderlaan,2023-07-20,03:00:00,11,2,9,FMN 16 Noorderlaanbrug
676,Noorderlaan,2023-07-20,04:00:00,27,13,14,FMN 16 Noorderlaanbrug
676,Noorderlaan,2023-07-20,05:00:00,92,61,31,FMN 16 Noorderlaanbrug
676,Noorderlaan,2023-07-20,06:00:00,123,58,65,FMN 16 Noorderlaanbrug
676,Noorderlaan,2023-07-20,07:00:00,245,90,155,FMN 16 Noorderlaanbrug
676,Noorderlaan,2023-07-20,08:00:00,229,83,146,FMN 16 Noorderlaanbrug
676,Noorderlaan,2023-07-20,09:00:00,137,47,90,FMN 16 Noorderlaanbrug
676,Noorderlaan,2023-07-20,10:00:00,86,24,62,FMN 16 Noorderlaanbrug
676,Noorderlaan,2023-07-20,11:00:00,97,35,62,FMN 16 Noorderlaanbrug
676,Noorderlaan,2023-07-20,12:00:00,148,60,88,FMN 16 Noorderlaanbrug
676,Noorderlaan,2023-07-20,13:00:00,186,86,100,FMN 16 Noorderlaanbrug
676,Noorderlaan,2023-07-20,14:00:00,177,69,108,FMN 16 Noorderlaanbrug
676,Noorderlaan,2023-07-20,15:00:00,196,90,106,FMN 16 Noorderlaanbrug
676,Noorderlaan,2023-07-20,16:00:00,283,120,163,FMN 16 Noorderlaanbrug
676,Noorderlaan,2023-07-20,17:00:00,301,116,185,FMN 16 Noorderlaanbrug
676,Noorderlaan,2023-07-20,18:00:00,164,80,84,FMN 16 Noorderlaanbrug
676,Noorderlaan,2023-07-20,19:00:00,121,43,78,FMN 16 Noorderlaanbrug
676,Noorderlaan,2023-07-20,20:00:00,101,55,46,FMN 16 Noorderlaanbrug
676,Noorderlaan,2023-07-20,21:00:00,60,21,39,FMN 16 Noorderlaanbrug
676,Noorderlaan,2023-07-20,22:00:00,77,27,50,FMN 16 Noorderlaanbrug
676,Noorderlaan,2023-07-20,23:00:00,65,21,44,FMN 16 Noorderlaanbrug
676,Noorderlaan,2023-07-21,00:00:00,43,15,28,FMN 16 Noorderlaanbrug
676,Noorderlaan,2023-07-21,01:00:00,25,16,9,FMN 16 Noorderlaanbrug
676,Noorderlaan,2023-07-21,02:00:00,13,7,6,FMN 16 Noorderlaanbrug
676,Noorderlaan,2023-07-21,03:00:00,13,8,5,FMN 16 Noorderlaanbrug
676,Noorderlaan,2023-07-21,04:00:00,18,8,10,FMN 16 Noorderlaanbrug
676,Noorderlaan,2023-07-21,05:00:00,34,22,12,FMN 16 Noorderlaanbrug
676,Noorderlaan,2023-07-21,06:00:00,38,20,18,FMN 16 Noorderlaanbrug
676,Noorderlaan,2023-07-21,07:00:00,31,11,20,FMN 16 Noorderlaanbrug
676,Noorderlaan,2023-07-21,08:00:00,30,13,17,FMN 16 Noorderlaanbrug
676,Noorderlaan,2023-07-21,09:00:00,39,6,33,FMN 16 Noorderlaanbrug
676,Noorderlaan,2023-07-21,10:00:00,67,18,49,FMN 16 Noorderlaanbrug
676,Noorderlaan,2023-07-21,11:00:00,66,26,40,FMN 16 Noorderlaanbrug
676,Noorderlaan,2023-07-21,12:00:00,33,13,20,FMN 16 Noorderlaanbrug
676,Noorderlaan,2023-07-21,13:00:00,94,33,61,FMN 16 Noorderlaanbrug
676,Noorderlaan,2023-07-21,14:00:00,65,23,42,FMN 16 Noorderlaanbrug
676,Noorderlaan,2023-07-21,15:00:00,93,25,68,FMN 16 Noorderlaanbrug
676,Noorderlaan,2023-07-21,16:00:00,104,39,65,FMN 16 Noorderlaanbrug
676,Noorderlaan,2023-07-21,17:00:00,98,46,52,FMN 16 Noorderlaanbrug
676,Noorderlaan,2023-07-21,18:00:00,83,40,43,FMN 16 Noorderlaanbrug
676,Noorderlaan,2023-07-21,19:00:00,92,44,48,FMN 16 Noorderlaanbrug
676,Noorderlaan,2023-07-21,20:00:00,63,32,31,FMN 16 Noorderlaanbrug
676,Noorderlaan,2023-07-21,21:00:00,44,31,13,FMN 16 Noorderlaanbrug
676,Noorderlaan,2023-07-21,22:00:00,84,51,33,FMN 16 Noorderlaanbrug
676,Noorderlaan,2023-07-21,23:00:00,56,20,36,FMN 16 Noorderlaanbrug
676,Noorderlaan,2023-07-22,00:00:00,53,19,34,FMN 16 Noorderlaanbrug
676,Noorderlaan,2023-07-22,01:00:00,38,17,21,FMN 16 Noorderlaanbrug
676,Noorderlaan,2023-07-22,02:00:00,14,11,3,FMN 16 Noorderlaanbrug
676,Noorderlaan,2023-07-22,03:00:00,5,2,3,FMN 16 Noorderlaanbrug
676,Noorderlaan,2023-07-22,04:00:00,18,8,10,FMN 16 Noorderlaanbrug
676,Noorderlaan,2023-07-22,05:00:00,28,11,17,FMN 16 Noorderlaanbrug
676,Noorderlaan,2023-07-22,06:00:00,34,18,16,FMN 16 Noorderlaanbrug
676,Noorderlaan,2023-07-22,07:00:00,27,9,18,FMN 16 Noorderlaanbrug
676,Noorderlaan,2023-07-22,08:00:00,38,14,24,FMN 16 Noorderlaanbrug
676,Noorderlaan,2023-07-22,09:00:00,66,20,46,FMN 16 Noorderlaanbrug
676,Noorderlaan,2023-07-22,10:00:00,101,34,67,FMN 16 Noorderlaanbrug
676,Noorderlaan,2023-07-22,11:00:00,112,30,82,FMN 16 Noorderlaanbrug
676,Noorderlaan,2023-07-22,12:00:00,119,33,86,FMN 16 Noorderlaanbrug
676,Noorderlaan,2023-07-22,13:00:00,143,49,94,FMN 16 Noorderlaanbrug
676,Noorderlaan,2023-07-22,14:00:00,182,73,109,FMN 16 Noorderlaanbrug
676,Noorderlaan,2023-07-22,15:00:00,151,63,88,FMN 16 Noorderlaanbrug
676,Noorderlaan,2023-07-22,16:00:00,137,72,65,FMN 16 Noorderlaanbrug
676,Noorderlaan,2023-07-22,17:00:00,100,38,62,FMN 16 Noorderlaanbrug
676,Noorderlaan,2023-07-22,18:00:00,106,56,50,FMN 16 Noorderlaanbrug
676,Noorderlaan,2023-07-22,19:00:00,97,53,44,FMN 16 Noorderlaanbrug
676,Noorderlaan,2023-07-22,20:00:00,33,11,22,FMN 16 Noorderlaanbrug
676,Noorderlaan,2023-07-22,21:00:00,24,15,9,FMN 16 Noorderlaanbrug
676,Noorderlaan,2023-07-22,22:00:00,48,25,23,FMN 16 Noorderlaanbrug
676,Noorderlaan,2023-07-22,23:00:00,56,17,39,FMN 16 Noorderlaanbrug
676,Noorderlaan,2023-07-23,00:00:00,42,22,20,FMN 16 Noorderlaanbrug
676,Noorderlaan,2023-07-23,01:00:00,23,12,11,FMN 16 Noorderlaanbrug
676,Noorderlaan,2023-07-23,02:00:00,28,12,16,FMN 16 Noorderlaanbrug
676,Noorderlaan,2023-07-23,03:00:00,13,10,3,FMN 16 Noorderlaanbrug
676,Noorderlaan,2023-07-23,04:00:00,11,5,6,FMN 16 Noorderlaanbrug
676,Noorderlaan,2023-07-23,05:00:00,15,10,5,FMN 16 Noorderlaanbrug
676,Noorderlaan,2023-07-23,06:00:00,24,11,13,FMN 16 Noorderlaanbrug
676,Noorderlaan,2023-07-23,07:00:00,23,15,8,FMN 16 Noorderlaanbrug
676,Noorderlaan,2023-07-23,08:00:00,15,2,13,FMN 16 Noorderlaanbrug
676,Noorderlaan,2023-07-23,09:00:00,19,5,14,FMN 16 Noorderlaanbrug
676,Noorderlaan,2023-07-23,10:00:00,15,1,14,FMN 16 Noorderlaanbrug
676,Noorderlaan,2023-07-23,11:00:00,33,9,24,FMN 16 Noorderlaanbrug
676,Noorderlaan,2023-07-23,12:00:00,30,12,18,FMN 16 Noorderlaanbrug
676,Noorderlaan,2023-07-23,13:00:00,62,22,40,FMN 16 Noorderlaanbrug
676,Noorderlaan,2023-07-23,14:00:00,66,18,48,FMN 16 Noorderlaanbrug
676,Noorderlaan,2023-07-23,15:00:00,66,29,37,FMN 16 Noorderlaanbrug
676,Noorderlaan,2023-07-23,16:00:00,49,23,26,FMN 16 Noorderlaanbrug
676,Noorderlaan,2023-07-23,17:00:00,61,27,34,FMN 16 Noorderlaanbrug
676,Noorderlaan,2023-07-23,18:00:00,39,18,21,FMN 16 Noorderlaanbrug
676,Noorderlaan,2023-07-23,19:00:00,39,20,19,FMN 16 Noorderlaanbrug
676,Noorderlaan,2023-07-23,20:00:00,37,18,19,FMN 16 Noorderlaanbrug
676,Noorderlaan,2023-07-23,21:00:00,17,8,9,FMN 16 Noorderlaanbrug
676,Noorderlaan,2023-07-23,22:00:00,30,14,16,FMN 16 Noorderlaanbrug
676,Noorderlaan,2023-07-23,23:00:00,23,11,12,FMN 16 Noorderlaanbrug
676,Noorderlaan,2023-07-24,00:00:00,12,4,8,FMN 16 Noorderlaanbrug
676,Noorderlaan,2023-07-24,01:00:00,6,3,3,FMN 16 Noorderlaanbrug
676,Noorderlaan,2023-07-24,02:00:00,9,5,4,FMN 16 Noorderlaanbrug
676,Noorderlaan,2023-07-24,03:00:00,7,3,4,FMN 16 Noorderlaanbrug
676,Noorderlaan,2023-07-24,04:00:00,21,9,12,FMN 16 Noorderlaanbrug
676,Noorderlaan,2023-07-24,05:00:00,48,37,11,FMN 16 Noorderlaanbrug
676,Noorderlaan,2023-07-24,06:00:00,84,43,41,FMN 16 Noorderlaanbrug
676,Noorderlaan,2023-07-24,07:00:00,175,91,84,FMN 16 Noorderlaanbrug
676,Noorderlaan,2023-07-24,08:00:00,196,59,137,FMN 16 Noorderlaanbrug
676,Noorderlaan,2023-07-24,09:00:00,65,27,38,FMN 16 Noorderlaanbrug
676,Noorderlaan,2023-07-24,10:00:00,60,26,34,FMN 16 Noorderlaanbrug
676,Noorderlaan,2023-07-24,11:00:00,68,26,42,FMN 16 Noorderlaanbrug
676,Noorderlaan,2023-07-24,12:00:00,74,33,41,FMN 16 Noorderlaanbrug
676,Noorderlaan,2023-07-24,13:00:00,107,43,64,FMN 16 Noorderlaanbrug
676,Noorderlaan,2023-07-24,14:00:00,121,39,82,FMN 16 Noorderlaanbrug
676,Noorderlaan,2023-07-24,15:00:00,157,53,104,FMN 16 Noorderlaanbrug
676,Noorderlaan,2023-07-24,16:00:00,187,79,108,FMN 16 Noorderlaanbrug
676,Noorderlaan,2023-07-24,17:00:00,195,86,109,FMN 16 Noorderlaanbrug
676,Noorderlaan,2023-07-24,18:00:00,137,60,77,FMN 16 Noorderlaanbrug
676,Noorderlaan,2023-07-24,19:00:00,79,40,39,FMN 16 Noorderlaanbrug
676,Noorderlaan,2023-07-24,20:00:00,59,28,31,FMN 16 Noorderlaanbrug
676,Noorderlaan,2023-07-24,21:00:00,47,26,21,FMN 16 Noorderlaanbrug
676,Noorderlaan,2023-07-24,22:00:00,60,17,43,FMN 16 Noorderlaanbrug
676,Noorderlaan,2023-07-24,23:00:00,51,17,34,FMN 16 Noorderlaanbrug
676,Noorderlaan,2023-07-25,00:00:00,20,10,10,FMN 16 Noorderlaanbrug
676,Noorderlaan,2023-07-25,01:00:00,7,2,5,FMN 16 Noorderlaanbrug
676,Noorderlaan,2023-07-25,02:00:00,8,4,4,FMN 16 Noorderlaanbrug
676,Noorderlaan,2023-07-25,03:00:00,8,1,7,FMN 16 Noorderlaanbrug
676,Noorderlaan,2023-07-25,04:00:00,25,10,15,FMN 16 Noorderlaanbrug
676,Noorderlaan,2023-07-25,05:00:00,81,55,26,FMN 16 Noorderlaanbrug
676,Noorderlaan,2023-07-25,06:00:00,125,58,67,FMN 16 Noorderlaanbrug
676,Noorderlaan,2023-07-25,07:00:00,232,96,136,FMN 16 Noorderlaanbrug
676,Noorderlaan,2023-07-25,08:00:00,199,60,139,FMN 16 Noorderlaanbrug
676,Noorderlaan,2023-07-25,09:00:00,117,35,82,FMN 16 Noorderlaanbrug
676,Noorderlaan,2023-07-25,10:00:00,100,29,71,FMN 16 Noorderlaanbrug
676,Noorderlaan,2023-07-25,11:00:00,67,24,43,FMN 16 Noorderlaanbrug
676,Noorderlaan,2023-07-25,12:00:00,119,37,82,FMN 16 Noorderlaanbrug
676,Noorderlaan,2023-07-25,13:00:00,166,89,77,FMN 16 Noorderlaanbrug
676,Noorderlaan,2023-07-25,14:00:00,193,54,139,FMN 16 Noorderlaanbrug
676,Noorderlaan,2023-07-25,15:00:00,183,71,112,FMN 16 Noorderlaanbrug
676,Noorderlaan,2023-07-25,16:00:00,261,103,158,FMN 16 Noorderlaanbrug
676,Noorderlaan,2023-07-25,17:00:00,282,119,163,FMN 16 Noorderlaanbrug
676,Noorderlaan,2023-07-25,18:00:00,171,80,91,FMN 16 Noorderlaanbrug
676,Noorderlaan,2023-07-25,19:00:00,113,50,63,FMN 16 Noorderlaanbrug
676,Noorderlaan,2023-07-25,20:00:00,77,34,43,FMN 16 Noorderlaanbrug
676,Noorderlaan,2023-07-25,21:00:00,58,28,30,FMN 16 Noorderlaanbrug
676,Noorderlaan,2023-07-25,22:00:00,85,32,53,FMN 16 Noorderlaanbrug
676,Noorderlaan,2023-07-25,23:00:00,56,18,38,FMN 16 Noorderlaanbrug
676,Noorderlaan,2023-07-26,00:00:00,45,13,32,FMN 16 Noorderlaanbrug
676,Noorderlaan,2023-07-26,01:00:00,18,7,11,FMN 16 Noorderlaanbrug
676,Noorderlaan,2023-07-26,02:00:00,9,6,3,FMN 16 Noorderlaanbrug
676,Noorderlaan,2023-07-26,03:00:00,8,1,7,FMN 16 Noorderlaanbrug
676,Noorderlaan,2023-07-26,04:00:00,29,10,19,FMN 16 Noorderlaanbrug
676,Noorderlaan,2023-07-26,05:00:00,61,42,19,FMN 16 Noorderlaanbrug
676,Noorderlaan,2023-07-26,06:00:00,124,63,61,FMN 16 Noorderlaanbrug
676,Noorderlaan,2023-07-26,07:00:00,202,92,110,FMN 16 Noorderlaanbrug
676,Noorderlaan,2023-07-26,08:00:00,223,72,151,FMN 16 Noorderlaanbrug
676,Noorderlaan,2023-07-26,09:00:00,100,42,58,FMN 16 Noorderlaanbrug
676,Noorderlaan,2023-07-26,10:00:00,97,25,72,FMN 16 Noorderlaanbrug
676,Noorderlaan,2023-07-26,11:00:00,121,48,73,FMN 16 Noorderlaanbrug
676,Noorderlaan,2023-07-26,12:00:00,110,41,69,FMN 16 Noorderlaanbrug
676,Noorderlaan,2023-07-26,13:00:00,155,71,84,FMN 16 Noorderlaanbrug
676,Noorderlaan,2023-07-26,14:00:00,189,62,127,FMN 16 Noorderlaanbrug
676,Noorderlaan,2023-07-26,15:00:00,157,62,95,FMN 16 Noorderlaanbrug
676,Noorderlaan,2023-07-26,16:00:00,282,112,170,FMN 16 Noorderlaanbrug
676,Noorderlaan,2023-07-26,17:00:00,320,130,190,FMN 16 Noorderlaanbrug
676,Noorderlaan,2023-07-26,18:00:00,196,88,108,FMN 16 Noorderlaanbrug
676,Noorderlaan,2023-07-26,19:00:00,120,48,72,FMN 16 Noorderlaanbrug
676,Noorderlaan,2023-07-26,20:00:00,105,44,61,FMN 16 Noorderlaanbrug
676,Noorderlaan,2023-07-26,21:00:00,61,31,30,FMN 16 Noorderlaanbrug
676,Noorderlaan,2023-07-26,22:00:00,106,40,66,FMN 16 Noorderlaanbrug
676,Noorderlaan,2023-07-26,23:00:00,59,25,34,FMN 16 Noorderlaanbrug
676,Noorderlaan,2023-07-27,00:00:00,31,12,19,FMN 16 Noorderlaanbrug
676,Noorderlaan,2023-07-27,01:00:00,12,7,5,FMN 16 Noorderlaanbrug
676,Noorderlaan,2023-07-27,02:00:00,15,11,4,FMN 16 Noorderlaanbrug
676,Noorderlaan,2023-07-27,03:00:00,7,2,5,FMN 16 Noorderlaanbrug
676,Noorderlaan,2023-07-27,04:00:00,27,10,17,FMN 16 Noorderlaanbrug
676,Noorderlaan,2023-07-27,05:00:00,46,31,15,FMN 16 Noorderlaanbrug
676,Noorderlaan,2023-07-27,06:00:00,80,38,42,FMN 16 Noorderlaanbrug
676,Noorderlaan,2023-07-27,07:00:00,131,63,68,FMN 16 Noorderlaanbrug
676,Noorderlaan,2023-07-27,08:00:00,137,52,85,FMN 16 Noorderlaanbrug
676,Noorderlaan,2023-07-27,09:00:00,65,20,45,FMN 16 Noorderlaanbrug
676,Noorderlaan,2023-07-27,10:00:00,48,18,30,FMN 16 Noorderlaanbrug
676,Noorderlaan,2023-07-27,11:00:00,43,12,31,FMN 16 Noorderlaanbrug
676,Noorderlaan,2023-07-27,12:00:00,59,21,38,FMN 16 Noorderlaanbrug
676,Noorderlaan,2023-07-27,13:00:00,80,43,37,FMN 16 Noorderlaanbrug
676,Noorderlaan,2023-07-27,14:00:00,85,23,62,FMN 16 Noorderlaanbrug
676,Noorderlaan,2023-07-27,15:00:00,104,41,63,FMN 16 Noorderlaanbrug
676,Noorderlaan,2023-07-27,16:00:00,167,68,99,FMN 16 Noorderlaanbrug
676,Noorderlaan,2023-07-27,17:00:00,184,61,123,FMN 16 Noorderlaanbrug
676,Noorderlaan,2023-07-27,18:00:00,107,47,60,FMN 16 Noorderlaanbrug
676,Noorderlaan,2023-07-27,19:00:00,65,32,33,FMN 16 Noorderlaanbrug
676,Noorderlaan,2023-07-27,20:00:00,42,17,25,FMN 16 Noorderlaanbrug
676,Noorderlaan,2023-07-27,21:00:00,40,17,23,FMN 16 Noorderlaanbrug
676,Noorderlaan,2023-07-27,22:00:00,59,24,35,FMN 16 Noorderlaanbrug
676,Noorderlaan,2023-07-27,23:00:00,25,11,14,FMN 16 Noorderlaanbrug
676,Noorderlaan,2023-07-28,00:00:00,19,8,11,FMN 16 Noorderlaanbrug
676,Noorderlaan,2023-07-28,01:00:00,13,5,8,FMN 16 Noorderlaanbrug
676,Noorderlaan,2023-07-28,02:00:00,10,4,6,FMN 16 Noorderlaanbrug
676,Noorderlaan,2023-07-28,03:00:00,7,1,6,FMN 16 Noorderlaanbrug
676,Noorderlaan,2023-07-28,04:00:00,25,10,15,FMN 16 Noorderlaanbrug
676,Noorderlaan,2023-07-28,05:00:00,62,47,15,FMN 16 Noorderlaanbrug
676,Noorderlaan,2023-07-28,06:00:00,106,50,56,FMN 16 Noorderlaanbrug
676,Noorderlaan,2023-07-28,07:00:00,149,79,70,FMN 16 Noorderlaanbrug
676,Noorderlaan,2023-07-28,08:00:00,176,77,99,FMN 16 Noorderlaanbrug
676,Noorderlaan,2023-07-28,09:00:00,82,29,53,FMN 16 Noorderlaanbrug
676,Noorderlaan,2023-07-28,10:00:00,101,41,60,FMN 16 Noorderlaanbrug
676,Noorderlaan,2023-07-28,11:00:00,85,31,54,FMN 16 Noorderlaanbrug
676,Noorderlaan,2023-07-28,12:00:00,128,39,89,FMN 16 Noorderlaanbrug
676,Noorderlaan,2023-07-28,13:00:00,148,59,89,FMN 16 Noorderlaanbrug
676,Noorderlaan,2023-07-28,14:00:00,179,58,121,FMN 16 Noorderlaanbrug
676,Noorderlaan,2023-07-28,15:00:00,161,60,101,FMN 16 Noorderlaanbrug
676,Noorderlaan,2023-07-28,16:00:00,235,90,145,FMN 16 Noorderlaanbrug
676,Noorderlaan,2023-07-28,17:00:00,188,74,114,FMN 16 Noorderlaanbrug
676,Noorderlaan,2023-07-28,18:00:00,179,77,102,FMN 16 Noorderlaanbrug
676,Noorderlaan,2023-07-28,19:00:00,121,47,74,FMN 16 Noorderlaanbrug
676,Noorderlaan,2023-07-28,20:00:00,83,38,45,FMN 16 Noorderlaanbrug
676,Noorderlaan,2023-07-28,21:00:00,64,34,30,FMN 16 Noorderlaanbrug
676,Noorderlaan,2023-07-28,22:00:00,66,24,42,FMN 16 Noorderlaanbrug
676,Noorderlaan,2023-07-28,23:00:00,55,26,29,FMN 16 Noorderlaanbrug
676,Noorderlaan,2023-07-29,00:00:00,41,18,23,FMN 16 Noorderlaanbrug
676,Noorderlaan,2023-07-29,01:00:00,34,22,12,FMN 16 Noorderlaanbrug
676,Noorderlaan,2023-07-29,02:00:00,21,16,5,FMN 16 Noorderlaanbrug
676,Noorderlaan,2023-07-29,03:00:00,24,15,9,FMN 16 Noorderlaanbrug
676,Noorderlaan,2023-07-29,04:00:00,12,5,7,FMN 16 Noorderlaanbrug
676,Noorderlaan,2023-07-29,05:00:00,21,12,9,FMN 16 Noorderlaanbrug
676,Noorderlaan,2023-07-29,06:00:00,58,33,25,FMN 16 Noorderlaanbrug
676,Noorderlaan,2023-07-29,07:00:00,30,9,21,FMN 16 Noorderlaanbrug
676,Noorderlaan,2023-07-29,08:00:00,31,10,21,FMN 16 Noorderlaanbrug
676,Noorderlaan,2023-07-29,09:00:00,57,14,43,FMN 16 Noorderlaanbrug
676,Noorderlaan,2023-07-29,10:00:00,118,46,72,FMN 16 Noorderlaanbrug
676,Noorderlaan,2023-07-29,11:00:00,107,36,71,FMN 16 Noorderlaanbrug
676,Noorderlaan,2023-07-29,12:00:00,105,44,61,FMN 16 Noorderlaanbrug
676,Noorderlaan,2023-07-29,13:00:00,39,19,20,FMN 16 Noorderlaanbrug
676,Noorderlaan,2023-07-29,14:00:00,100,29,71,FMN 16 Noorderlaanbrug
676,Noorderlaan,2023-07-29,15:00:00,102,52,50,FMN 16 Noorderlaanbrug
676,Noorderlaan,2023-07-29,16:00:00,92,39,53,FMN 16 Noorderlaanbrug
676,Noorderlaan,2023-07-29,17:00:00,126,56,70,FMN 16 Noorderlaanbrug
676,Noorderlaan,2023-07-29,18:00:00,115,42,73,FMN 16 Noorderlaanbrug
676,Noorderlaan,2023-07-29,19:00:00,99,48,51,FMN 16 Noorderlaanbrug
676,Noorderlaan,2023-07-29,20:00:00,66,29,37,FMN 16 Noorderlaanbrug
676,Noorderlaan,2023-07-29,21:00:00,44,25,19,FMN 16 Noorderlaanbrug
676,Noorderlaan,2023-07-29,22:00:00,53,31,22,FMN 16 Noorderlaanbrug
676,Noorderlaan,2023-07-29,23:00:00,67,21,46,FMN 16 Noorderlaanbrug
676,Noorderlaan,2023-07-30,00:00:00,34,18,16,FMN 16 Noorderlaanbrug
676,Noorderlaan,2023-07-30,01:00:00,23,10,13,FMN 16 Noorderlaanbrug
676,Noorderlaan,2023-07-30,02:00:00,16,9,7,FMN 16 Noorderlaanbrug
676,Noorderlaan,2023-07-30,03:00:00,21,19,2,FMN 16 Noorderlaanbrug
676,Noorderlaan,2023-07-30,04:00:00,8,5,3,FMN 16 Noorderlaanbrug
676,Noorderlaan,2023-07-30,05:00:00,19,13,6,FMN 16 Noorderlaanbrug
676,Noorderlaan,2023-07-30,06:00:00,38,21,17,FMN 16 Noorderlaanbrug
676,Noorderlaan,2023-07-30,07:00:00,19,10,9,FMN 16 Noorderlaanbrug
676,Noorderlaan,2023-07-30,08:00:00,43,15,28,FMN 16 Noorderlaanbrug
676,Noorderlaan,2023-07-30,09:00:00,52,21,31,FMN 16 Noorderlaanbrug
676,Noorderlaan,2023-07-30,10:00:00,37,10,27,FMN 16 Noorderlaanbrug
676,Noorderlaan,2023-07-30,11:00:00,63,15,48,FMN 16 Noorderlaanbrug
676,Noorderlaan,2023-07-30,12:00:00,59,25,34,FMN 16 Noorderlaanbrug
676,Noorderlaan,2023-07-30,13:00:00,72,31,41,FMN 16 Noorderlaanbrug
676,Noorderlaan,2023-07-30,14:00:00,105,42,63,FMN 16 Noorderlaanbrug
676,Noorderlaan,2023-07-30,15:00:00,83,49,34,FMN 16 Noorderlaanbrug
676,Noorderlaan,2023-07-30,16:00:00,76,32,44,FMN 16 Noorderlaanbrug
676,Noorderlaan,2023-07-30,17:00:00,76,37,39,FMN 16 Noorderlaanbrug
676,Noorderlaan,2023-07-30,18:00:00,82,44,38,FMN 16 Noorderlaanbrug
676,Noorderlaan,2023-07-30,19:00:00,37,13,24,FMN 16 Noorderlaanbrug
676,Noorderlaan,2023-07-30,20:00:00,29,14,15,FMN 16 Noorderlaanbrug
676,Noorderlaan,2023-07-30,21:00:00,26,7,19,FMN 16 Noorderlaanbrug
676,Noorderlaan,2023-07-30,22:00:00,19,4,15,FMN 16 Noorderlaanbrug
676,Noorderlaan,2023-07-30,23:00:00,28,7,21,FMN 16 Noorderlaanbrug
676,Noorderlaan,2023-07-31,00:00:00,27,9,18,FMN 16 Noorderlaanbrug
676,Noorderlaan,2023-07-31,01:00:00,8,4,4,FMN 16 Noorderlaanbrug
676,Noorderlaan,2023-07-31,02:00:00,14,8,6,FMN 16 Noorderlaanbrug
676,Noorderlaan,2023-07-31,03:00:00,2,1,1,FMN 16 Noorderlaanbrug
676,Noorderlaan,2023-07-31,04:00:00,23,11,12,FMN 16 Noorderlaanbrug
676,Noorderlaan,2023-07-31,05:00:00,57,36,21,FMN 16 Noorderlaanbrug
676,Noorderlaan,2023-07-31,06:00:00,94,42,52,FMN 16 Noorderlaanbrug
676,Noorderlaan,2023-07-31,07:00:00,129,58,71,FMN 16 Noorderlaanbrug
676,Noorderlaan,2023-07-31,08:00:00,158,59,99,FMN 16 Noorderlaanbrug
676,Noorderlaan,2023-07-31,09:00:00,68,28,40,FMN 16 Noorderlaanbrug
676,Noorderlaan,2023-07-31,10:00:00,72,38,34,FMN 16 Noorderlaanbrug
676,Noorderlaan,2023-07-31,11:00:00,95,31,64,FMN 16 Noorderlaanbrug
676,Noorderlaan,2023-07-31,12:00:00,70,33,37,FMN 16 Noorderlaanbrug
676,Noorderlaan,2023-07-31,13:00:00,87,44,43,FMN 16 Noorderlaanbrug
676,Noorderlaan,2023-07-31,14:00:00,122,48,74,FMN 16 Noorderlaanbrug
676,Noorderlaan,2023-07-31,15:00:00,128,52,76,FMN 16 Noorderlaanbrug
676,Noorderlaan,2023-07-31,16:00:00,146,51,95,FMN 16 Noorderlaanbrug
676,Noorderlaan,2023-07-31,17:00:00,178,72,106,FMN 16 Noorderlaanbrug
676,Noorderlaan,2023-07-31,18:00:00,100,45,55,FMN 16 Noorderlaanbrug
676,Noorderlaan,2023-07-31,19:00:00,61,30,31,FMN 16 Noorderlaanbrug
676,Noorderlaan,2023-07-31,20:00:00,40,12,28,FMN 16 Noorderlaanbrug
676,Noorderlaan,2023-07-31,21:00:00,27,9,18,FMN 16 Noorderlaanbrug
676,Noorderlaan,2023-07-31,22:00:00,36,18,18,FMN 16 Noorderlaanbrug
676,Noorderlaan,2023-07-31,23:00:00,23,7,16,FMN 16 Noorderlaanbrug
676,Noorderlaan,2023-08-01,00:00:00,15,4,11,FMN 16 Noorderlaanbrug
676,Noorderlaan,2023-08-01,01:00:00,10,2,8,FMN 16 Noorderlaanbrug
676,Noorderlaan,2023-08-01,02:00:00,5,4,1,FMN 16 Noorderlaanbrug
676,Noorderlaan,2023-08-01,03:00:00,8,4,4,FMN 16 Noorderlaanbrug
676,Noorderlaan,2023-08-01,04:00:00,23,10,13,FMN 16 Noorderlaanbrug
676,Noorderlaan,2023-08-01,05:00:00,60,37,23,FMN 16 Noorderlaanbrug
676,Noorderlaan,2023-08-01,06:00:00,103,40,63,FMN 16 Noorderlaanbrug
676,Noorderlaan,2023-08-01,07:00:00,215,87,128,FMN 16 Noorderlaanbrug
676,Noorderlaan,2023-08-01,08:00:00,227,80,147,FMN 16 Noorderlaanbrug
676,Noorderlaan,2023-08-01,09:00:00,99,39,60,FMN 16 Noorderlaanbrug
676,Noorderlaan,2023-08-01,10:00:00,69,21,48,FMN 16 Noorderlaanbrug
676,Noorderlaan,2023-08-01,11:00:00,56,20,36,FMN 16 Noorderlaanbrug
676,Noorderlaan,2023-08-01,12:00:00,117,37,80,FMN 16 Noorderlaanbrug
676,Noorderlaan,2023-08-01,13:00:00,94,36,58,FMN 16 Noorderlaanbrug
676,Noorderlaan,2023-08-01,14:00:00,120,40,80,FMN 16 Noorderlaanbrug
676,Noorderlaan,2023-08-01,15:00:00,127,55,72,FMN 16 Noorderlaanbrug
676,Noorderlaan,2023-08-01,16:00:00,272,119,153,FMN 16 Noorderlaanbrug
676,Noorderlaan,2023-08-01,17:00:00,279,104,175,FMN 16 Noorderlaanbrug
676,Noorderlaan,2023-08-01,18:00:00,196,99,97,FMN 16 Noorderlaanbrug
676,Noorderlaan,2023-08-01,19:00:00,96,46,50,FMN 16 Noorderlaanbrug
676,Noorderlaan,2023-08-01,20:00:00,80,31,49,FMN 16 Noorderlaanbrug
676,Noorderlaan,2023-08-01,21:00:00,39,15,24,FMN 16 Noorderlaanbrug
676,Noorderlaan,2023-08-01,22:00:00,63,24,39,FMN 16 Noorderlaanbrug
676,Noorderlaan,2023-08-01,23:00:00,64,25,39,FMN 16 Noorderlaanbrug
676,Noorderlaan,2023-08-02,00:00:00,26,8,18,FMN 16 Noorderlaanbrug
676,Noorderlaan,2023-08-02,01:00:00,12,3,9,FMN 16 Noorderlaanbrug
676,Noorderlaan,2023-08-02,02:00:00,10,5,5,FMN 16 Noorderlaanbrug
676,Noorderlaan,2023-08-02,03:00:00,12,7,5,FMN 16 Noorderlaanbrug
676,Noorderlaan,2023-08-02,04:00:00,22,10,12,FMN 16 Noorderlaanbrug
676,Noorderlaan,2023-08-02,05:00:00,58,35,23,FMN 16 Noorderlaanbrug
676,Noorderlaan,2023-08-02,06:00:00,95,48,47,FMN 16 Noorderlaanbrug
676,Noorderlaan,2023-08-02,07:00:00,135,64,71,FMN 16 Noorderlaanbrug
676,Noorderlaan,2023-08-02,08:00:00,149,67,82,FMN 16 Noorderlaanbrug
676,Noorderlaan,2023-08-02,09:00:00,70,24,46,FMN 16 Noorderlaanbrug
676,Noorderlaan,2023-08-02,10:00:00,41,13,28,FMN 16 Noorderlaanbrug
676,Noorderlaan,2023-08-02,11:00:00,49,17,32,FMN 16 Noorderlaanbrug
676,Noorderlaan,2023-08-02,12:00:00,95,39,56,FMN 16 Noorderlaanbrug
676,Noorderlaan,2023-08-02,13:00:00,67,33,34,FMN 16 Noorderlaanbrug
676,Noorderlaan,2023-08-02,14:00:00,139,42,97,FMN 16 Noorderlaanbrug
676,Noorderlaan,2023-08-02,15:00:00,135,53,82,FMN 16 Noorderlaanbrug
676,Noorderlaan,2023-08-02,16:00:00,199,69,130,FMN 16 Noorderlaanbrug
676,Noorderlaan,2023-08-02,17:00:00,194,76,118,FMN 16 Noorderlaanbrug
676,Noorderlaan,2023-08-02,18:00:00,118,51,67,FMN 16 Noorderlaanbrug
676,Noorderlaan,2023-08-02,19:00:00,65,27,38,FMN 16 Noorderlaanbrug
676,Noorderlaan,2023-08-02,20:00:00,68,18,50,FMN 16 Noorderlaanbrug
676,Noorderlaan,2023-08-02,21:00:00,35,15,20,FMN 16 Noorderlaanbrug
676,Noorderlaan,2023-08-02,22:00:00,30,11,19,FMN 16 Noorderlaanbrug
676,Noorderlaan,2023-08-02,23:00:00,24,13,11,FMN 16 Noorderlaanbrug
676,Noorderlaan,2023-08-03,00:00:00,14,7,7,FMN 16 Noorderlaanbrug
676,Noorderlaan,2023-08-03,01:00:00,15,6,9,FMN 16 Noorderlaanbrug
676,Noorderlaan,2023-08-03,02:00:00,10,6,4,FMN 16 Noorderlaanbrug
676,Noorderlaan,2023-08-03,03:00:00,4,1,3,FMN 16 Noorderlaanbrug
676,Noorderlaan,2023-08-03,04:00:00,18,8,10,FMN 16 Noorderlaanbrug
676,Noorderlaan,2023-08-03,05:00:00,46,32,14,FMN 16 Noorderlaanbrug
676,Noorderlaan,2023-08-03,06:00:00,75,33,42,FMN 16 Noorderlaanbrug
676,Noorderlaan,2023-08-03,07:00:00,150,68,82,FMN 16 Noorderlaanbrug
676,Noorderlaan,2023-08-03,08:00:00,183,70,113,FMN 16 Noorderlaanbrug
676,Noorderlaan,2023-08-03,09:00:00,77,29,48,FMN 16 Noorderlaanbrug
676,Noorderlaan,2023-08-03,10:00:00,73,31,42,FMN 16 Noorderlaanbrug
676,Noorderlaan,2023-08-03,11:00:00,68,12,56,FMN 16 Noorderlaanbrug
676,Noorderlaan,2023-08-03,12:00:00,64,28,36,FMN 16 Noorderlaanbrug
676,Noorderlaan,2023-08-03,13:00:00,61,20,41,FMN 16 Noorderlaanbrug
676,Noorderlaan,2023-08-03,14:00:00,86,30,56,FMN 16 Noorderlaanbrug
676,Noorderlaan,2023-08-03,15:00:00,106,31,75,FMN 16 Noorderlaanbrug
676,Noorderlaan,2023-08-03,16:00:00,186,76,110,FMN 16 Noorderlaanbrug
676,Noorderlaan,2023-08-03,17:00:00,235,86,149,FMN 16 Noorderlaanbrug
676,Noorderlaan,2023-08-03,18:00:00,115,47,68,FMN 16 Noorderlaanbrug
676,Noorderlaan,2023-08-03,19:00:00,85,36,49,FMN 16 Noorderlaanbrug
676,Noorderlaan,2023-08-03,20:00:00,77,37,40,FMN 16 Noorderlaanbrug
676,Noorderlaan,2023-08-03,21:00:00,52,24,28,FMN 16 Noorderlaanbrug
676,Noorderlaan,2023-08-03,22:00:00,45,21,24,FMN 16 Noorderlaanbrug
676,Noorderlaan,2023-08-03,23:00:00,40,15,25,FMN 16 Noorderlaanbrug
676,Noorderlaan,2023-08-04,00:00:00,25,8,17,FMN 16 Noorderlaanbrug
676,Noorderlaan,2023-08-04,01:00:00,13,5,8,FMN 16 Noorderlaanbrug
676,Noorderlaan,2023-08-04,02:00:00,14,9,5,FMN 16 Noorderlaanbrug
676,Noorderlaan,2023-08-04,03:00:00,8,2,6,FMN 16 Noorderlaanbrug
676,Noorderlaan,2023-08-04,04:00:00,17,8,9,FMN 16 Noorderlaanbrug
676,Noorderlaan,2023-08-04,05:00:00,53,34,19,FMN 16 Noorderlaanbrug
676,Noorderlaan,2023-08-04,06:00:00,84,36,48,FMN 16 Noorderlaanbrug
676,Noorderlaan,2023-08-04,07:00:00,155,81,74,FMN 16 Noorderlaanbrug
676,Noorderlaan,2023-08-04,08:00:00,166,71,95,FMN 16 Noorderlaanbrug
676,Noorderlaan,2023-08-04,09:00:00,80,24,56,FMN 16 Noorderlaanbrug
676,Noorderlaan,2023-08-04,10:00:00,58,19,39,FMN 16 Noorderlaanbrug
676,Noorderlaan,2023-08-04,11:00:00,71,31,40,FMN 16 Noorderlaanbrug
676,Noorderlaan,2023-08-04,12:00:00,101,42,59,FMN 16 Noorderlaanbrug
676,Noorderlaan,2023-08-04,13:00:00,116,50,66,FMN 16 Noorderlaanbrug
676,Noorderlaan,2023-08-04,14:00:00,166,52,114,FMN 16 Noorderlaanbrug
676,Noorderlaan,2023-08-04,15:00:00,144,57,87,FMN 16 Noorderlaanbrug
676,Noorderlaan,2023-08-04,16:00:00,238,88,150,FMN 16 Noorderlaanbrug
676,Noorderlaan,2023-08-04,17:00:00,184,84,100,FMN 16 Noorderlaanbrug
676,Noorderlaan,2023-08-04,18:00:00,161,67,94,FMN 16 Noorderlaanbrug
676,Noorderlaan,2023-08-04,19:00:00,108,40,68,FMN 16 Noorderlaanbrug
676,Noorderlaan,2023-08-04,20:00:00,101,53,48,FMN 16 Noorderlaanbrug
676,Noorderlaan,2023-08-04,21:00:00,79,42,37,FMN 16 Noorderlaanbrug
676,Noorderlaan,2023-08-04,22:00:00,82,34,48,FMN 16 Noorderlaanbrug
676,Noorderlaan,2023-08-04,23:00:00,57,31,26,FMN 16 Noorderlaanbrug
676,Noorderlaan,2023-08-05,00:00:00,44,21,23,FMN 16 Noorderlaanbrug
676,Noorderlaan,2023-08-05,01:00:00,42,17,25,FMN 16 Noorderlaanbrug
676,Noorderlaan,2023-08-05,02:00:00,38,31,7,FMN 16 Noorderlaanbrug
676,Noorderlaan,2023-08-05,03:00:00,20,11,9,FMN 16 Noorderlaanbrug
676,Noorderlaan,2023-08-05,04:00:00,24,12,12,FMN 16 Noorderlaanbrug
676,Noorderlaan,2023-08-05,05:00:00,19,7,12,FMN 16 Noorderlaanbrug
676,Noorderlaan,2023-08-05,06:00:00,33,14,19,FMN 16 Noorderlaanbrug
676,Noorderlaan,2023-08-05,07:00:00,32,10,22,FMN 16 Noorderlaanbrug
676,Noorderlaan,2023-08-05,08:00:00,31,15,16,FMN 16 Noorderlaanbrug
676,Noorderlaan,2023-08-05,09:00:00,75,17,58,FMN 16 Noorderlaanbrug
676,Noorderlaan,2023-08-05,10:00:00,85,21,64,FMN 16 Noorderlaanbrug
676,Noorderlaan,2023-08-05,11:00:00,82,27,55,FMN 16 Noorderlaanbrug
676,Noorderlaan,2023-08-05,12:00:00,91,37,54,FMN 16 Noorderlaanbrug
676,Noorderlaan,2023-08-05,13:00:00,101,43,58,FMN 16 Noorderlaanbrug
676,Noorderlaan,2023-08-05,14:00:00,65,22,43,FMN 16 Noorderlaanbrug
676,Noorderlaan,2023-08-05,15:00:00,68,23,45,FMN 16 Noorderlaanbrug
676,Noorderlaan,2023-08-05,16:00:00,75,30,45,FMN 16 Noorderlaanbrug
676,Noorderlaan,2023-08-05,17:00:00,71,31,40,FMN 16 Noorderlaanbrug
676,Noorderlaan,2023-08-05,18:00:00,105,48,57,FMN 16 Noorderlaanbrug
676,Noorderlaan,2023-08-05,19:00:00,68,24,44,FMN 16 Noorderlaanbrug
676,Noorderlaan,2023-08-05,20:00:00,46,15,31,FMN 16 Noorderlaanbrug
676,Noorderlaan,2023-08-05,21:00:00,28,17,11,FMN 16 Noorderlaanbrug
676,Noorderlaan,2023-08-05,22:00:00,36,15,21,FMN 16 Noorderlaanbrug
676,Noorderlaan,2023-08-05,23:00:00,36,18,18,FMN 16 Noorderlaanbrug
676,Noorderlaan,2023-08-06,00:00:00,21,13,8,FMN 16 Noorderlaanbrug
676,Noorderlaan,2023-08-06,01:00:00,24,13,11,FMN 16 Noorderlaanbrug
676,Noorderlaan,2023-08-06,02:00:00,16,13,3,FMN 16 Noorderlaanbrug
676,Noorderlaan,2023-08-06,03:00:00,14,11,3,FMN 16 Noorderlaanbrug
676,Noorderlaan,2023-08-06,04:00:00,14,7,7,FMN 16 Noorderlaanbrug
676,Noorderlaan,2023-08-06,05:00:00,20,7,13,FMN 16 Noorderlaanbrug
676,Noorderlaan,2023-08-06,06:00:00,11,3,8,FMN 16 Noorderlaanbrug
676,Noorderlaan,2023-08-06,07:00:00,13,5,8,FMN 16 Noorderlaanbrug
676,Noorderlaan,2023-08-06,08:00:00,9,4,5,FMN 16 Noorderlaanbrug
676,Noorderlaan,2023-08-06,09:00:00,13,4,9,FMN 16 Noorderlaanbrug
676,Noorderlaan,2023-08-06,10:00:00,18,0,18,FMN 16 Noorderlaanbrug
676,Noorderlaan,2023-08-06,11:00:00,26,8,18,FMN 16 Noorderlaanbrug
676,Noorderlaan,2023-08-06,12:00:00,30,7,23,FMN 16 Noorderlaanbrug
676,Noorderlaan,2023-08-06,13:00:00,33,14,19,FMN 16 Noorderlaanbrug
676,Noorderlaan,2023-08-06,14:00:00,20,13,7,FMN 16 Noorderlaanbrug
676,Noorderlaan,2023-08-06,15:00:00,17,9,8,FMN 16 Noorderlaanbrug
676,Noorderlaan,2023-08-06,16:00:00,33,14,19,FMN 16 Noorderlaanbrug
676,Noorderlaan,2023-08-06,17:00:00,26,12,14,FMN 16 Noorderlaanbrug
676,Noorderlaan,2023-08-06,18:00:00,28,14,14,FMN 16 Noorderlaanbrug
676,Noorderlaan,2023-08-06,19:00:00,28,15,13,FMN 16 Noorderlaanbrug
676,Noorderlaan,2023-08-06,20:00:00,27,19,8,FMN 16 Noorderlaanbrug
676,Noorderlaan,2023-08-06,21:00:00,13,5,8,FMN 16 Noorderlaanbrug
676,Noorderlaan,2023-08-06,22:00:00,24,12,12,FMN 16 Noorderlaanbrug
676,Noorderlaan,2023-08-06,23:00:00,16,7,9,FMN 16 Noorderlaanbrug
676,Noorderlaan,2023-08-07,00:00:00,15,6,9,FMN 16 Noorderlaanbrug
676,Noorderlaan,2023-08-07,01:00:00,15,4,11,FMN 16 Noorderlaanbrug
676,Noorderlaan,2023-08-07,02:00:00,3,3,0,FMN 16 Noorderlaanbrug
676,Noorderlaan,2023-08-07,03:00:00,4,0,4,FMN 16 Noorderlaanbrug
676,Noorderlaan,2023-08-07,04:00:00,28,10,18,FMN 16 Noorderlaanbrug
676,Noorderlaan,2023-08-07,05:00:00,56,30,26,FMN 16 Noorderlaanbrug
676,Noorderlaan,2023-08-07,06:00:00,83,30,53,FMN 16 Noorderlaanbrug
676,Noorderlaan,2023-08-07,07:00:00,189,80,109,FMN 16 Noorderlaanbrug
676,Noorderlaan,2023-08-07,08:00:00,226,90,136,FMN 16 Noorderlaanbrug
676,Noorderlaan,2023-08-07,09:00:00,98,28,70,FMN 16 Noorderlaanbrug
676,Noorderlaan,2023-08-07,10:00:00,74,30,44,FMN 16 Noorderlaanbrug
676,Noorderlaan,2023-08-07,11:00:00,76,26,50,FMN 16 Noorderlaanbrug
676,Noorderlaan,2023-08-07,12:00:00,114,46,68,FMN 16 Noorderlaanbrug
676,Noorderlaan,2023-08-07,13:00:00,109,50,59,FMN 16 Noorderlaanbrug
676,Noorderlaan,2023-08-07,14:00:00,118,42,76,FMN 16 Noorderlaanbrug
676,Noorderlaan,2023-08-07,15:00:00,137,58,79,FMN 16 Noorderlaanbrug
676,Noorderlaan,2023-08-07,16:00:00,250,105,145,FMN 16 Noorderlaanbrug
676,Noorderlaan,2023-08-07,17:00:00,315,152,163,FMN 16 Noorderlaanbrug
676,Noorderlaan,2023-08-07,18:00:00,134,69,65,FMN 16 Noorderlaanbrug
676,Noorderlaan,2023-08-07,19:00:00,106,42,64,FMN 16 Noorderlaanbrug
676,Noorderlaan,2023-08-07,20:00:00,69,30,39,FMN 16 Noorderlaanbrug
676,Noorderlaan,2023-08-07,21:00:00,53,28,25,FMN 16 Noorderlaanbrug
676,Noorderlaan,2023-08-07,22:00:00,55,15,40,FMN 16 Noorderlaanbrug
676,Noorderlaan,2023-08-07,23:00:00,33,13,20,FMN 16 Noorderlaanbrug
676,Noorderlaan,2023-08-08,00:00:00,20,8,12,FMN 16 Noorderlaanbrug
676,Noorderlaan,2023-08-08,01:00:00,18,5,13,FMN 16 Noorderlaanbrug
676,Noorderlaan,2023-08-08,02:00:00,5,2,3,FMN 16 Noorderlaanbrug
676,Noorderlaan,2023-08-08,03:00:00,6,4,2,FMN 16 Noorderlaanbrug
676,Noorderlaan,2023-08-08,04:00:00,27,9,18,FMN 16 Noorderlaanbrug
676,Noorderlaan,2023-08-08,05:00:00,67,36,31,FMN 16 Noorderlaanbrug
676,Noorderlaan,2023-08-08,06:00:00,111,47,64,FMN 16 Noorderlaanbrug
676,Noorderlaan,2023-08-08,07:00:00,253,103,150,FMN 16 Noorderlaanbrug
676,Noorderlaan,2023-08-08,08:00:00,294,109,185,FMN 16 Noorderlaanbrug
676,Noorderlaan,2023-08-08,09:00:00,109,28,81,FMN 16 Noorderlaanbrug
676,Noorderlaan,2023-08-08,10:00:00,93,21,72,FMN 16 Noorderlaanbrug
676,Noorderlaan,2023-08-08,11:00:00,65,27,38,FMN 16 Noorderlaanbrug
676,Noorderlaan,2023-08-08,12:00:00,106,44,62,FMN 16 Noorderlaanbrug
676,Noorderlaan,2023-08-08,13:00:00,97,41,56,FMN 16 Noorderlaanbrug
676,Noorderlaan,2023-08-08,14:00:00,141,54,87,FMN 16 Noorderlaanbrug
676,Noorderlaan,2023-08-08,15:00:00,153,68,85,FMN 16 Noorderlaanbrug
676,Noorderlaan,2023-08-08,16:00:00,289,137,152,FMN 16 Noorderlaanbrug
676,Noorderlaan,2023-08-08,17:00:00,353,163,190,FMN 16 Noorderlaanbrug
676,Noorderlaan,2023-08-08,18:00:00,171,74,97,FMN 16 Noorderlaanbrug
676,Noorderlaan,2023-08-08,19:00:00,86,35,51,FMN 16 Noorderlaanbrug
676,Noorderlaan,2023-08-08,20:00:00,61,25,36,FMN 16 Noorderlaanbrug
676,Noorderlaan,2023-08-08,21:00:00,39,22,17,FMN 16 Noorderlaanbrug
676,Noorderlaan,2023-08-08,22:00:00,38,14,24,FMN 16 Noorderlaanbrug
676,Noorderlaan,2023-08-08,23:00:00,28,12,16,FMN 16 Noorderlaanbrug
676,Noorderlaan,2023-08-09,00:00:00,19,8,11,FMN 16 Noorderlaanbrug
676,Noorderlaan,2023-08-09,01:00:00,12,7,5,FMN 16 Noorderlaanbrug
676,Noorderlaan,2023-08-09,02:00:00,7,3,4,FMN 16 Noorderlaanbrug
676,Noorderlaan,2023-08-09,03:00:00,11,3,8,FMN 16 Noorderlaanbrug
676,Noorderlaan,2023-08-09,04:00:00,29,11,18,FMN 16 Noorderlaanbrug
676,Noorderlaan,2023-08-09,05:00:00,62,33,29,FMN 16 Noorderlaanbrug
676,Noorderlaan,2023-08-09,06:00:00,88,39,49,FMN 16 Noorderlaanbrug
676,Noorderlaan,2023-08-09,07:00:00,228,102,126,FMN 16 Noorderlaanbrug
676,Noorderlaan,2023-08-09,08:00:00,260,107,153,FMN 16 Noorderlaanbrug
676,Noorderlaan,2023-08-09,09:00:00,109,32,77,FMN 16 Noorderlaanbrug
676,Noorderlaan,2023-08-09,10:00:00,85,26,59,FMN 16 Noorderlaanbrug
676,Noorderlaan,2023-08-09,11:00:00,92,32,60,FMN 16 Noorderlaanbrug
676,Noorderlaan,2023-08-09,12:00:00,134,49,85,FMN 16 Noorderlaanbrug
676,Noorderlaan,2023-08-09,13:00:00,145,53,92,FMN 16 Noorderlaanbrug
676,Noorderlaan,2023-08-09,14:00:00,156,49,107,FMN 16 Noorderlaanbrug
676,Noorderlaan,2023-08-09,15:00:00,202,80,122,FMN 16 Noorderlaanbrug
676,Noorderlaan,2023-08-09,16:00:00,262,104,158,FMN 16 Noorderlaanbrug
676,Noorderlaan,2023-08-09,17:00:00,330,141,189,FMN 16 Noorderlaanbrug
676,Noorderlaan,2023-08-09,18:00:00,187,99,88,FMN 16 Noorderlaanbrug
676,Noorderlaan,2023-08-09,19:00:00,155,71,84,FMN 16 Noorderlaanbrug
676,Noorderlaan,2023-08-09,20:00:00,58,25,33,FMN 16 Noorderlaanbrug
676,Noorderlaan,2023-08-09,21:00:00,73,38,35,FMN 16 Noorderlaanbrug
676,Noorderlaan,2023-08-09,22:00:00,84,32,52,FMN 16 Noorderlaanbrug
676,Noorderlaan,2023-08-09,23:00:00,58,23,35,FMN 16 Noorderlaanbrug
676,Noorderlaan,2023-08-10,00:00:00,22,14,8,FMN 16 Noorderlaanbrug
676,Noorderlaan,2023-08-10,01:00:00,13,7,6,FMN 16 Noorderlaanbrug
676,Noorderlaan,2023-08-10,02:00:00,13,9,4,FMN 16 Noorderlaanbrug
676,Noorderlaan,2023-08-10,03:00:00,13,6,7,FMN 16 Noorderlaanbrug
676,Noorderlaan,2023-08-10,04:00:00,29,13,16,FMN 16 Noorderlaanbrug
676,Noorderlaan,2023-08-10,05:00:00,63,40,23,FMN 16 Noorderlaanbrug
676,Noorderlaan,2023-08-10,06:00:00,120,49,71,FMN 16 Noorderlaanbrug
676,Noorderlaan,2023-08-10,07:00:00,255,91,164,FMN 16 Noorderlaanbrug
676,Noorderlaan,2023-08-10,08:00:00,274,101,173,FMN 16 Noorderlaanbrug
676,Noorderlaan,2023-08-10,09:00:00,142,42,100,FMN 16 Noorderlaanbrug
676,Noorderlaan,2023-08-10,10:00:00,94,26,68,FMN 16 Noorderlaanbrug
676,Noorderlaan,2023-08-10,11:00:00,130,35,95,FMN 16 Noorderlaanbrug
676,Noorderlaan,2023-08-10,12:00:00,137,46,91,FMN 16 Noorderlaanbrug
676,Noorderlaan,2023-08-10,13:00:00,140,58,82,FMN 16 Noorderlaanbrug
676,Noorderlaan,2023-08-10,14:00:00,215,82,133,FMN 16 Noorderlaanbrug
676,Noorderlaan,2023-08-10,15:00:00,209,104,105,FMN 16 Noorderlaanbrug
676,Noorderlaan,2023-08-10,16:00:00,318,140,178,FMN 16 Noorderlaanbrug
676,Noorderlaan,2023-08-10,17:00:00,375,161,214,FMN 16 Noorderlaanbrug
676,Noorderlaan,2023-08-10,18:00:00,250,109,141,FMN 16 Noorderlaanbrug
676,Noorderlaan,2023-08-10,19:00:00,151,51,100,FMN 16 Noorderlaanbrug
676,Noorderlaan,2023-08-10,20:00:00,95,53,42,FMN 16 Noorderlaanbrug
676,Noorderlaan,2023-08-10,21:00:00,100,45,55,FMN 16 Noorderlaanbrug
676,Noorderlaan,2023-08-10,22:00:00,83,36,47,FMN 16 Noorderlaanbrug
676,Noorderlaan,2023-08-10,23:00:00,45,19,26,FMN 16 Noorderlaanbrug
676,Noorderlaan,2023-08-11,00:00:00,33,19,14,FMN 16 Noorderlaanbrug
676,Noorderlaan,2023-08-11,01:00:00,18,14,4,FMN 16 Noorderlaanbrug
676,Noorderlaan,2023-08-11,02:00:00,10,7,3,FMN 16 Noorderlaanbrug
676,Noorderlaan,2023-08-11,03:00:00,12,3,9,FMN 16 Noorderlaanbrug
676,Noorderlaan,2023-08-11,04:00:00,31,15,16,FMN 16 Noorderlaanbrug
676,Noorderlaan,2023-08-11,05:00:00,65,34,31,FMN 16 Noorderlaanbrug
676,Noorderlaan,2023-08-11,06:00:00,94,34,60,FMN 16 Noorderlaanbrug
676,Noorderlaan,2023-08-11,07:00:00,201,72,129,FMN 16 Noorderlaanbrug
676,Noorderlaan,2023-08-11,08:00:00,228,87,141,FMN 16 Noorderlaanbrug
676,Noorderlaan,2023-08-11,09:00:00,118,34,84,FMN 16 Noorderlaanbrug
676,Noorderlaan,2023-08-11,10:00:00,132,49,83,FMN 16 Noorderlaanbrug
676,Noorderlaan,2023-08-11,11:00:00,124,44,80,FMN 16 Noorderlaanbrug
676,Noorderlaan,2023-08-11,12:00:00,123,42,81,FMN 16 Noorderlaanbrug
676,Noorderlaan,2023-08-11,13:00:00,172,61,111,FMN 16 Noorderlaanbrug
676,Noorderlaan,2023-08-11,14:00:00,197,81,116,FMN 16 Noorderlaanbrug
676,Noorderlaan,2023-08-11,15:00:00,212,94,118,FMN 16 Noorderlaanbrug
676,Noorderlaan,2023-08-11,16:00:00,273,119,154,FMN 16 Noorderlaanbrug
676,Noorderlaan,2023-08-11,17:00:00,228,104,124,FMN 16 Noorderlaanbrug
676,Noorderlaan,2023-08-11,18:00:00,209,100,109,FMN 16 Noorderlaanbrug
676,Noorderlaan,2023-08-11,19:00:00,104,46,58,FMN 16 Noorderlaanbrug
676,Noorderlaan,2023-08-11,20:00:00,73,29,44,FMN 16 Noorderlaanbrug
676,Noorderlaan,2023-08-11,21:00:00,66,28,38,FMN 16 Noorderlaanbrug
676,Noorderlaan,2023-08-11,22:00:00,73,30,43,FMN 16 Noorderlaanbrug
676,Noorderlaan,2023-08-11,23:00:00,59,26,33,FMN 16 Noorderlaanbrug
676,Noorderlaan,2023-08-12,00:00:00,49,22,27,FMN 16 Noorderlaanbrug
676,Noorderlaan,2023-08-12,01:00:00,50,26,24,FMN 16 Noorderlaanbrug
676,Noorderlaan,2023-08-12,02:00:00,23,13,10,FMN 16 Noorderlaanbrug
676,Noorderlaan,2023-08-12,03:00:00,15,5,10,FMN 16 Noorderlaanbrug
676,Noorderlaan,2023-08-12,04:00:00,18,9,9,FMN 16 Noorderlaanbrug
676,Noorderlaan,2023-08-12,05:00:00,17,4,13,FMN 16 Noorderlaanbrug
676,Noorderlaan,2023-08-12,06:00:00,24,8,16,FMN 16 Noorderlaanbrug
676,Noorderlaan,2023-08-12,07:00:00,32,13,19,FMN 16 Noorderlaanbrug
676,Noorderlaan,2023-08-12,08:00:00,15,5,10,FMN 16 Noorderlaanbrug
676,Noorderlaan,2023-08-12,09:00:00,61,19,42,FMN 16 Noorderlaanbrug
676,Noorderlaan,2023-08-12,10:00:00,58,15,43,FMN 16 Noorderlaanbrug
676,Noorderlaan,2023-08-12,11:00:00,100,44,56,FMN 16 Noorderlaanbrug
676,Noorderlaan,2023-08-12,12:00:00,132,30,102,FMN 16 Noorderlaanbrug
676,Noorderlaan,2023-08-12,13:00:00,148,43,105,FMN 16 Noorderlaanbrug
676,Noorderlaan,2023-08-12,14:00:00,181,52,129,FMN 16 Noorderlaanbrug
676,Noorderlaan,2023-08-12,15:00:00,152,61,91,FMN 16 Noorderlaanbrug
676,Noorderlaan,2023-08-12,16:00:00,162,85,77,FMN 16 Noorderlaanbrug
676,Noorderlaan,2023-08-12,17:00:00,169,81,88,FMN 16 Noorderlaanbrug
676,Noorderlaan,2023-08-12,18:00:00,153,76,77,FMN 16 Noorderlaanbrug
676,Noorderlaan,2023-08-12,19:00:00,118,70,48,FMN 16 Noorderlaanbrug
676,Noorderlaan,2023-08-12,20:00:00,87,48,39,FMN 16 Noorderlaanbrug
676,Noorderlaan,2023-08-12,21:00:00,75,45,30,FMN 16 Noorderlaanbrug
676,Noorderlaan,2023-08-12,22:00:00,75,39,36,FMN 16 Noorderlaanbrug
676,Noorderlaan,2023-08-12,23:00:00,79,43,36,FMN 16 Noorderlaanbrug
676,Noorderlaan,2023-08-13,00:00:00,72,35,37,FMN 16 Noorderlaanbrug
676,Noorderlaan,2023-08-13,01:00:00,61,26,35,FMN 16 Noorderlaanbrug
676,Noorderlaan,2023-08-13,02:00:00,58,15,43,FMN 16 Noorderlaanbrug
676,Noorderlaan,2023-08-13,03:00:00,32,8,24,FMN 16 Noorderlaanbrug
676,Noorderlaan,2023-08-13,04:00:00,20,7,13,FMN 16 Noorderlaanbrug
676,Noorderlaan,2023-08-13,05:00:00,27,10,17,FMN 16 Noorderlaanbrug
676,Noorderlaan,2023-08-13,06:00:00,28,13,15,FMN 16 Noorderlaanbrug
676,Noorderlaan,2023-08-13,07:00:00,36,12,24,FMN 16 Noorderlaanbrug
676,Noorderlaan,2023-08-13,08:00:00,26,11,15,FMN 16 Noorderlaanbrug
676,Noorderlaan,2023-08-13,09:00:00,48,11,37,FMN 16 Noorderlaanbrug
676,Noorderlaan,2023-08-13,10:00:00,96,25,71,FMN 16 Noorderlaanbrug
676,Noorderlaan,2023-08-13,11:00:00,86,27,59,FMN 16 Noorderlaanbrug
676,Noorderlaan,2023-08-13,12:00:00,84,31,53,FMN 16 Noorderlaanbrug
676,Noorderlaan,2023-08-13,13:00:00,98,40,58,FMN 16 Noorderlaanbrug
676,Noorderlaan,2023-08-13,14:00:00,96,30,66,FMN 16 Noorderlaanbrug
676,Noorderlaan,2023-08-13,15:00:00,101,41,60,FMN 16 Noorderlaanbrug
676,Noorderlaan,2023-08-13,16:00:00,97,53,44,FMN 16 Noorderlaanbrug
676,Noorderlaan,2023-08-13,17:00:00,93,33,60,FMN 16 Noorderlaanbrug
676,Noorderlaan,2023-08-13,18:00:00,111,56,55,FMN 16 Noorderlaanbrug
676,Noorderlaan,2023-08-13,19:00:00,108,59,49,FMN 16 Noorderlaanbrug
676,Noorderlaan,2023-08-13,20:00:00,65,31,34,FMN 16 Noorderlaanbrug
676,Noorderlaan,2023-08-13,21:00:00,54,29,25,FMN 16 Noorderlaanbrug
676,Noorderlaan,2023-08-13,22:00:00,54,23,31,FMN 16 Noorderlaanbrug
676,Noorderlaan,2023-08-13,23:00:00,49,22,27,FMN 16 Noorderlaanbrug
676,Noorderlaan,2023-08-14,00:00:00,31,18,13,FMN 16 Noorderlaanbrug
676,Noorderlaan,2023-08-14,01:00:00,16,11,5,FMN 16 Noorderlaanbrug
676,Noorderlaan,2023-08-14,02:00:00,13,8,5,FMN 16 Noorderlaanbrug
676,Noorderlaan,2023-08-14,03:00:00,6,2,4,FMN 16 Noorderlaanbrug
676,Noorderlaan,2023-08-14,04:00:00,21,10,11,FMN 16 Noorderlaanbrug
676,Noorderlaan,2023-08-14,05:00:00,52,27,25,FMN 16 Noorderlaanbrug
676,Noorderlaan,2023-08-14,06:00:00,72,37,35,FMN 16 Noorderlaanbrug
676,Noorderlaan,2023-08-14,07:00:00,130,47,83,FMN 16 Noorderlaanbrug
676,Noorderlaan,2023-08-14,08:00:00,156,68,88,FMN 16 Noorderlaanbrug
676,Noorderlaan,2023-08-14,09:00:00,85,32,53,FMN 16 Noorderlaanbrug
676,Noorderlaan,2023-08-14,10:00:00,92,32,60,FMN 16 Noorderlaanbrug
676,Noorderlaan,2023-08-14,11:00:00,136,48,88,FMN 16 Noorderlaanbrug
676,Noorderlaan,2023-08-14,12:00:00,141,51,90,FMN 16 Noorderlaanbrug
676,Noorderlaan,2023-08-14,13:00:00,150,67,83,FMN 16 Noorderlaanbrug
676,Noorderlaan,2023-08-14,14:00:00,163,47,116,FMN 16 Noorderlaanbrug
676,Noorderlaan,2023-08-14,15:00:00,183,65,118,FMN 16 Noorderlaanbrug
676,Noorderlaan,2023-08-14,16:00:00,245,99,146,FMN 16 Noorderlaanbrug
676,Noorderlaan,2023-08-14,17:00:00,251,111,140,FMN 16 Noorderlaanbrug
676,Noorderlaan,2023-08-14,18:00:00,172,76,96,FMN 16 Noorderlaanbrug
676,Noorderlaan,2023-08-14,19:00:00,152,58,94,FMN 16 Noorderlaanbrug
676,Noorderlaan,2023-08-14,20:00:00,92,34,58,FMN 16 Noorderlaanbrug
676,Noorderlaan,2023-08-14,21:00:00,78,29,49,FMN 16 Noorderlaanbrug
676,Noorderlaan,2023-08-14,22:00:00,84,37,47,FMN 16 Noorderlaanbrug
676,Noorderlaan,2023-08-14,23:00:00,48,20,28,FMN 16 Noorderlaanbrug
676,Noorderlaan,2023-08-15,00:00:00,29,14,15,FMN 16 Noorderlaanbrug
676,Noorderlaan,2023-08-15,01:00:00,22,8,14,FMN 16 Noorderlaanbrug
676,Noorderlaan,2023-08-15,02:00:00,11,8,3,FMN 16 Noorderlaanbrug
676,Noorderlaan,2023-08-15,03:00:00,12,5,7,FMN 16 Noorderlaanbrug
676,Noorderlaan,2023-08-15,04:00:00,11,3,8,FMN 16 Noorderlaanbrug
676,Noorderlaan,2023-08-15,05:00:00,24,14,10,FMN 16 Noorderlaanbrug
676,Noorderlaan,2023-08-15,06:00:00,40,18,22,FMN 16 Noorderlaanbrug
676,Noorderlaan,2023-08-15,07:00:00,24,13,11,FMN 16 Noorderlaanbrug
676,Noorderlaan,2023-08-15,08:00:00,32,11,21,FMN 16 Noorderlaanbrug
676,Noorderlaan,2023-08-15,09:00:00,76,18,58,FMN 16 Noorderlaanbrug
676,Noorderlaan,2023-08-15,10:00:00,116,25,91,FMN 16 Noorderlaanbrug
676,Noorderlaan,2023-08-15,11:00:00,165,26,139,FMN 16 Noorderlaanbrug
676,Noorderlaan,2023-08-15,12:00:00,145,37,108,FMN 16 Noorderlaanbrug
676,Noorderlaan,2023-08-15,13:00:00,190,63,127,FMN 16 Noorderlaanbrug
676,Noorderlaan,2023-08-15,14:00:00,154,62,92,FMN 16 Noorderlaanbrug
676,Noorderlaan,2023-08-15,15:00:00,148,73,75,FMN 16 Noorderlaanbrug
676,Noorderlaan,2023-08-15,16:00:00,153,88,65,FMN 16 Noorderlaanbrug
676,Noorderlaan,2023-08-15,17:00:00,116,63,53,FMN 16 Noorderlaanbrug
676,Noorderlaan,2023-08-15,18:00:00,139,68,71,FMN 16 Noorderlaanbrug
676,Noorderlaan,2023-08-15,19:00:00,108,58,50,FMN 16 Noorderlaanbrug
676,Noorderlaan,2023-08-15,20:00:00,81,43,38,FMN 16 Noorderlaanbrug
676,Noorderlaan,2023-08-15,21:00:00,84,43,41,FMN 16 Noorderlaanbrug
676,Noorderlaan,2023-08-15,22:00:00,71,25,46,FMN 16 Noorderlaanbrug
676,Noorderlaan,2023-08-15,23:00:00,46,19,27,FMN 16 Noorderlaanbrug
676,Noorderlaan,2023-08-16,00:00:00,27,12,15,FMN 16 Noorderlaanbrug
676,Noorderlaan,2023-08-16,01:00:00,11,8,3,FMN 16 Noorderlaanbrug
676,Noorderlaan,2023-08-16,02:00:00,11,5,6,FMN 16 Noorderlaanbrug
676,Noorderlaan,2023-08-16,03:00:00,9,2,7,FMN 16 Noorderlaanbrug
676,Noorderlaan,2023-08-16,04:00:00,30,15,15,FMN 16 Noorderlaanbrug
676,Noorderlaan,2023-08-16,05:00:00,51,29,22,FMN 16 Noorderlaanbrug
676,Noorderlaan,2023-08-16,06:00:00,110,49,61,FMN 16 Noorderlaanbrug
676,Noorderlaan,2023-08-16,07:00:00,270,101,169,FMN 16 Noorderlaanbrug
676,Noorderlaan,2023-08-16,08:00:00,309,104,205,FMN 16 Noorderlaanbrug
676,Noorderlaan,2023-08-16,09:00:00,147,49,98,FMN 16 Noorderlaanbrug
676,Noorderlaan,2023-08-16,10:00:00,107,40,67,FMN 16 Noorderlaanbrug
676,Noorderlaan,2023-08-16,11:00:00,142,49,93,FMN 16 Noorderlaanbrug
676,Noorderlaan,2023-08-16,12:00:00,138,49,89,FMN 16 Noorderlaanbrug
676,Noorderlaan,2023-08-16,13:00:00,155,72,83,FMN 16 Noorderlaanbrug
676,Noorderlaan,2023-08-16,14:00:00,134,57,77,FMN 16 Noorderlaanbrug
676,Noorderlaan,2023-08-16,15:00:00,186,78,108,FMN 16 Noorderlaanbrug
676,Noorderlaan,2023-08-16,16:00:00,334,157,177,FMN 16 Noorderlaanbrug
676,Noorderlaan,2023-08-16,17:00:00,354,149,205,FMN 16 Noorderlaanbrug
676,Noorderlaan,2023-08-16,18:00:00,196,89,107,FMN 16 Noorderlaanbrug
676,Noorderlaan,2023-08-16,19:00:00,118,48,70,FMN 16 Noorderlaanbrug
676,Noorderlaan,2023-08-16,20:00:00,74,35,39,FMN 16 Noorderlaanbrug
676,Noorderlaan,2023-08-16,21:00:00,65,34,31,FMN 16 Noorderlaanbrug
676,Noorderlaan,2023-08-16,22:00:00,86,35,51,FMN 16 Noorderlaanbrug
676,Noorderlaan,2023-08-16,23:00:00,48,19,29,FMN 16 Noorderlaanbrug
676,Noorderlaan,2023-08-17,00:00:00,24,16,8,FMN 16 Noorderlaanbrug
676,Noorderlaan,2023-08-17,01:00:00,15,7,8,FMN 16 Noorderlaanbrug
676,Noorderlaan,2023-08-17,02:00:00,13,4,9,FMN 16 Noorderlaanbrug
676,Noorderlaan,2023-08-17,03:00:00,5,0,5,FMN 16 Noorderlaanbrug
676,Noorderlaan,2023-08-17,04:00:00,31,10,21,FMN 16 Noorderlaanbrug
676,Noorderlaan,2023-08-17,05:00:00,55,30,25,FMN 16 Noorderlaanbrug
676,Noorderlaan,2023-08-17,06:00:00,121,51,70,FMN 16 Noorderlaanbrug
676,Noorderlaan,2023-08-17,07:00:00,263,96,167,FMN 16 Noorderlaanbrug
676,Noorderlaan,2023-08-17,08:00:00,322,104,218,FMN 16 Noorderlaanbrug
676,Noorderlaan,2023-08-17,09:00:00,144,47,97,FMN 16 Noorderlaanbrug
676,Noorderlaan,2023-08-17,10:00:00,111,33,78,FMN 16 Noorderlaanbrug
676,Noorderlaan,2023-08-17,11:00:00,94,35,59,FMN 16 Noorderlaanbrug
676,Noorderlaan,2023-08-17,12:00:00,126,47,79,FMN 16 Noorderlaanbrug
676,Noorderlaan,2023-08-17,13:00:00,150,62,88,FMN 16 Noorderlaanbrug
676,Noorderlaan,2023-08-17,14:00:00,166,64,102,FMN 16 Noorderlaanbrug
676,Noorderlaan,2023-08-17,15:00:00,179,80,99,FMN 16 Noorderlaanbrug
676,Noorderlaan,2023-08-17,16:00:00,301,143,158,FMN 16 Noorderlaanbrug
676,Noorderlaan,2023-08-17,17:00:00,357,164,193,FMN 16 Noorderlaanbrug
676,Noorderlaan,2023-08-17,18:00:00,200,90,110,FMN 16 Noorderlaanbrug
676,Noorderlaan,2023-08-17,19:00:00,134,48,86,FMN 16 Noorderlaanbrug
676,Noorderlaan,2023-08-17,20:00:00,85,44,41,FMN 16 Noorderlaanbrug
676,Noorderlaan,2023-08-17,21:00:00,68,27,41,FMN 16 Noorderlaanbrug
676,Noorderlaan,2023-08-17,22:00:00,62,28,34,FMN 16 Noorderlaanbrug
676,Noorderlaan,2023-08-17,23:00:00,39,13,26,FMN 16 Noorderlaanbrug
676,Noorderlaan,2023-08-18,00:00:00,16,9,7,FMN 16 Noorderlaanbrug
676,Noorderlaan,2023-08-18,01:00:00,10,4,6,FMN 16 Noorderlaanbrug
676,Noorderlaan,2023-08-18,02:00:00,14,7,7,FMN 16 Noorderlaanbrug
676,Noorderlaan,2023-08-18,03:00:00,11,4,7,FMN 16 Noorderlaanbrug
676,Noorderlaan,2023-08-18,04:00:00,28,11,17,FMN 16 Noorderlaanbrug
676,Noorderlaan,2023-08-18,05:00:00,67,38,29,FMN 16 Noorderlaanbrug
676,Noorderlaan,2023-08-18,06:00:00,105,48,57,FMN 16 Noorderlaanbrug
676,Noorderlaan,2023-08-18,07:00:00,201,82,119,FMN 16 Noorderlaanbrug
676,Noorderlaan,2023-08-18,08:00:00,227,84,143,FMN 16 Noorderlaanbrug
676,Noorderlaan,2023-08-18,09:00:00,130,39,91,FMN 16 Noorderlaanbrug
676,Noorderlaan,2023-08-18,10:00:00,90,30,60,FMN 16 Noorderlaanbrug
676,Noorderlaan,2023-08-18,11:00:00,150,53,97,FMN 16 Noorderlaanbrug
676,Noorderlaan,2023-08-18,12:00:00,145,39,106,FMN 16 Noorderlaanbrug
676,Noorderlaan,2023-08-18,13:00:00,127,52,75,FMN 16 Noorderlaanbrug
676,Noorderlaan,2023-08-18,14:00:00,190,57,133,FMN 16 Noorderlaanbrug
676,Noorderlaan,2023-08-18,15:00:00,191,94,97,FMN 16 Noorderlaanbrug
676,Noorderlaan,2023-08-18,16:00:00,268,101,167,FMN 16 Noorderlaanbrug
676,Noorderlaan,2023-08-18,17:00:00,295,124,171,FMN 16 Noorderlaanbrug
676,Noorderlaan,2023-08-18,18:00:00,195,80,115,FMN 16 Noorderlaanbrug
676,Noorderlaan,2023-08-18,19:00:00,155,48,107,FMN 16 Noorderlaanbrug
676,Noorderlaan,2023-08-18,20:00:00,121,43,78,FMN 16 Noorderlaanbrug
676,Noorderlaan,2023-08-18,21:00:00,89,31,58,FMN 16 Noorderlaanbrug
676,Noorderlaan,2023-08-18,22:00:00,69,33,36,FMN 16 Noorderlaanbrug
676,Noorderlaan,2023-08-18,23:00:00,84,52,32,FMN 16 Noorderlaanbrug
676,Noorderlaan,2023-08-19,00:00:00,69,48,21,FMN 16 Noorderlaanbrug
676,Noorderlaan,2023-08-19,01:00:00,58,34,24,FMN 16 Noorderlaanbrug
676,Noorderlaan,2023-08-19,02:00:00,19,17,2,FMN 16 Noorderlaanbrug
676,Noorderlaan,2023-08-19,03:00:00,32,17,15,FMN 16 Noorderlaanbrug
676,Noorderlaan,2023-08-19,04:00:00,24,14,10,FMN 16 Noorderlaanbrug
676,Noorderlaan,2023-08-19,05:00:00,29,15,14,FMN 16 Noorderlaanbrug
676,Noorderlaan,2023-08-19,06:00:00,34,20,14,FMN 16 Noorderlaanbrug
676,Noorderlaan,2023-08-19,07:00:00,24,11,13,FMN 16 Noorderlaanbrug
676,Noorderlaan,2023-08-19,08:00:00,37,14,23,FMN 16 Noorderlaanbrug
676,Noorderlaan,2023-08-19,09:00:00,67,16,51,FMN 16 Noorderlaanbrug
676,Noorderlaan,2023-08-19,10:00:00,94,26,68,FMN 16 Noorderlaanbrug
676,Noorderlaan,2023-08-19,11:00:00,124,35,89,FMN 16 Noorderlaanbrug
676,Noorderlaan,2023-08-19,12:00:00,118,47,71,FMN 16 Noorderlaanbrug
676,Noorderlaan,2023-08-19,13:00:00,168,58,110,FMN 16 Noorderlaanbrug
676,Noorderlaan,2023-08-19,14:00:00,173,56,117,FMN 16 Noorderlaanbrug
676,Noorderlaan,2023-08-19,15:00:00,151,49,102,FMN 16 Noorderlaanbrug
676,Noorderlaan,2023-08-19,16:00:00,184,69,115,FMN 16 Noorderlaanbrug
676,Noorderlaan,2023-08-19,17:00:00,137,56,81,FMN 16 Noorderlaanbrug
676,Noorderlaan,2023-08-19,18:00:00,179,73,106,FMN 16 Noorderlaanbrug
676,Noorderlaan,2023-08-19,19:00:00,140,58,82,FMN 16 Noorderlaanbrug
676,Noorderlaan,2023-08-19,20:00:00,101,39,62,FMN 16 Noorderlaanbrug
676,Noorderlaan,2023-08-19,21:00:00,73,42,31,FMN 16 Noorderlaanbrug
676,Noorderlaan,2023-08-19,22:00:00,96,58,38,FMN 16 Noorderlaanbrug
676,Noorderlaan,2023-08-19,23:00:00,72,36,36,FMN 16 Noorderlaanbrug
676,Noorderlaan,2023-08-20,00:00:00,75,51,24,FMN 16 Noorderlaanbrug
676,Noorderlaan,2023-08-20,01:00:00,49,30,19,FMN 16 Noorderlaanbrug
676,Noorderlaan,2023-08-20,02:00:00,37,26,11,FMN 16 Noorderlaanbrug
676,Noorderlaan,2023-08-20,03:00:00,30,21,9,FMN 16 Noorderlaanbrug
676,Noorderlaan,2023-08-20,04:00:00,13,8,5,FMN 16 Noorderlaanbrug
676,Noorderlaan,2023-08-20,05:00:00,19,9,10,FMN 16 Noorderlaanbrug
676,Noorderlaan,2023-08-20,06:00:00,32,14,18,FMN 16 Noorderlaanbrug
676,Noorderlaan,2023-08-20,07:00:00,22,9,13,FMN 16 Noorderlaanbrug
676,Noorderlaan,2023-08-20,08:00:00,42,16,26,FMN 16 Noorderlaanbrug
676,Noorderlaan,2023-08-20,09:00:00,76,19,57,FMN 16 Noorderlaanbrug
676,Noorderlaan,2023-08-20,10:00:00,93,34,59,FMN 16 Noorderlaanbrug
676,Noorderlaan,2023-08-20,11:00:00,116,49,67,FMN 16 Noorderlaanbrug
676,Noorderlaan,2023-08-20,12:00:00,94,22,72,FMN 16 Noorderlaanbrug
676,Noorderlaan,2023-08-20,13:00:00,147,50,97,FMN 16 Noorderlaanbrug
676,Noorderlaan,2023-08-20,14:00:00,146,51,95,FMN 16 Noorderlaanbrug
676,Noorderlaan,2023-08-20,15:00:00,177,80,97,FMN 16 Noorderlaanbrug
676,Noorderlaan,2023-08-20,16:00:00,156,68,88,FMN 16 Noorderlaanbrug
676,Noorderlaan,2023-08-20,17:00:00,130,59,71,FMN 16 Noorderlaanbrug
676,Noorderlaan,2023-08-20,18:00:00,119,49,70,FMN 16 Noorderlaanbrug
676,Noorderlaan,2023-08-20,19:00:00,105,50,55,FMN 16 Noorderlaanbrug
676,Noorderlaan,2023-08-20,20:00:00,108,68,40,FMN 16 Noorderlaanbrug
676,Noorderlaan,2023-08-20,21:00:00,105,58,47,FMN 16 Noorderlaanbrug
676,Noorderlaan,2023-08-20,22:00:00,63,39,24,FMN 16 Noorderlaanbrug
676,Noorderlaan,2023-08-20,23:00:00,31,19,12,FMN 16 Noorderlaanbrug
676,Noorderlaan,2023-08-21,00:00:00,29,20,9,FMN 16 Noorderlaanbrug
676,Noorderlaan,2023-08-21,01:00:00,13,8,5,FMN 16 Noorderlaanbrug
676,Noorderlaan,2023-08-21,02:00:00,6,4,2,FMN 16 Noorderlaanbrug
676,Noorderlaan,2023-08-21,03:00:00,7,2,5,FMN 16 Noorderlaanbrug
676,Noorderlaan,2023-08-21,04:00:00,32,15,17,FMN 16 Noorderlaanbrug
676,Noorderlaan,2023-08-21,05:00:00,88,56,32,FMN 16 Noorderlaanbrug
676,Noorderlaan,2023-08-21,06:00:00,126,44,82,FMN 16 Noorderlaanbrug
676,Noorderlaan,2023-08-21,07:00:00,299,124,175,FMN 16 Noorderlaanbrug
676,Noorderlaan,2023-08-21,08:00:00,372,110,262,FMN 16 Noorderlaanbrug
676,Noorderlaan,2023-08-21,09:00:00,159,59,100,FMN 16 Noorderlaanbrug
676,Noorderlaan,2023-08-21,10:00:00,115,36,79,FMN 16 Noorderlaanbrug
676,Noorderlaan,2023-08-21,11:00:00,136,38,98,FMN 16 Noorderlaanbrug
676,Noorderlaan,2023-08-21,12:00:00,164,64,100,FMN 16 Noorderlaanbrug
676,Noorderlaan,2023-08-21,13:00:00,163,60,103,FMN 16 Noorderlaanbrug
676,Noorderlaan,2023-08-21,14:00:00,185,61,124,FMN 16 Noorderlaanbrug
676,Noorderlaan,2023-08-21,15:00:00,207,99,108,FMN 16 Noorderlaanbrug
676,Noorderlaan,2023-08-21,16:00:00,369,160,209,FMN 16 Noorderlaanbrug
676,Noorderlaan,2023-08-21,17:00:00,384,183,201,FMN 16 Noorderlaanbrug
676,Noorderlaan,2023-08-21,18:00:00,181,89,92,FMN 16 Noorderlaanbrug
676,Noorderlaan,2023-08-21,19:00:00,115,45,70,FMN 16 Noorderlaanbrug
676,Noorderlaan,2023-08-21,20:00:00,85,47,38,FMN 16 Noorderlaanbrug
676,Noorderlaan,2023-08-21,21:00:00,68,24,44,FMN 16 Noorderlaanbrug
676,Noorderlaan,2023-08-21,22:00:00,88,45,43,FMN 16 Noorderlaanbrug
676,Noorderlaan,2023-08-21,23:00:00,51,26,25,FMN 16 Noorderlaanbrug
676,Noorderlaan,2023-08-22,00:00:00,32,16,16,FMN 16 Noorderlaanbrug
676,Noorderlaan,2023-08-22,01:00:00,11,4,7,FMN 16 Noorderlaanbrug
676,Noorderlaan,2023-08-22,02:00:00,10,6,4,FMN 16 Noorderlaanbrug
676,Noorderlaan,2023-08-22,03:00:00,11,4,7,FMN 16 Noorderlaanbrug
676,Noorderlaan,2023-08-22,04:00:00,29,12,17,FMN 16 Noorderlaanbrug
676,Noorderlaan,2023-08-22,05:00:00,91,61,30,FMN 16 Noorderlaanbrug
676,Noorderlaan,2023-08-22,06:00:00,154,64,90,FMN 16 Noorderlaanbrug
676,Noorderlaan,2023-08-22,07:00:00,329,127,202,FMN 16 Noorderlaanbrug
676,Noorderlaan,2023-08-22,08:00:00,404,123,281,FMN 16 Noorderlaanbrug
676,Noorderlaan,2023-08-22,09:00:00,172,48,124,FMN 16 Noorderlaanbrug
676,Noorderlaan,2023-08-22,10:00:00,121,39,82,FMN 16 Noorderlaanbrug
676,Noorderlaan,2023-08-22,11:00:00,166,62,104,FMN 16 Noorderlaanbrug
676,Noorderlaan,2023-08-22,12:00:00,167,52,115,FMN 16 Noorderlaanbrug
676,Noorderlaan,2023-08-22,13:00:00,195,94,101,FMN 16 Noorderlaanbrug
676,Noorderlaan,2023-08-22,14:00:00,209,65,144,FMN 16 Noorderlaanbrug
676,Noorderlaan,2023-08-22,15:00:00,243,119,124,FMN 16 Noorderlaanbrug
676,Noorderlaan,2023-08-22,16:00:00,410,192,218,FMN 16 Noorderlaanbrug
676,Noorderlaan,2023-08-22,17:00:00,420,200,220,FMN 16 Noorderlaanbrug
676,Noorderlaan,2023-08-22,18:00:00,239,131,108,FMN 16 Noorderlaanbrug
676,Noorderlaan,2023-08-22,19:00:00,155,59,96,FMN 16 Noorderlaanbrug
676,Noorderlaan,2023-08-22,20:00:00,101,46,55,FMN 16 Noorderlaanbrug
676,Noorderlaan,2023-08-22,21:00:00,104,48,56,FMN 16 Noorderlaanbrug
676,Noorderlaan,2023-08-22,22:00:00,87,37,50,FMN 16 Noorderlaanbrug
676,Noorderlaan,2023-08-22,23:00:00,54,36,18,FMN 16 Noorderlaanbrug
676,Noorderlaan,2023-08-23,00:00:00,31,15,16,FMN 16 Noorderlaanbrug
676,Noorderlaan,2023-08-23,01:00:00,17,12,5,FMN 16 Noorderlaanbrug
676,Noorderlaan,2023-08-23,02:00:00,7,4,3,FMN 16 Noorderlaanbrug
676,Noorderlaan,2023-08-23,03:00:00,16,7,9,FMN 16 Noorderlaanbrug
676,Noorderlaan,2023-08-23,04:00:00,37,18,19,FMN 16 Noorderlaanbrug
676,Noorderlaan,2023-08-23,05:00:00,81,56,25,FMN 16 Noorderlaanbrug
676,Noorderlaan,2023-08-23,06:00:00,144,64,80,FMN 16 Noorderlaanbrug
676,Noorderlaan,2023-08-23,07:00:00,254,99,155,FMN 16 Noorderlaanbrug
676,Noorderlaan,2023-08-23,08:00:00,393,124,269,FMN 16 Noorderlaanbrug
676,Noorderlaan,2023-08-23,09:00:00,169,54,115,FMN 16 Noorderlaanbrug
676,Noorderlaan,2023-08-23,10:00:00,132,35,97,FMN 16 Noorderlaanbrug
676,Noorderlaan,2023-08-23,11:00:00,150,57,93,FMN 16 Noorderlaanbrug
676,Noorderlaan,2023-08-23,12:00:00,194,67,127,FMN 16 Noorderlaanbrug
676,Noorderlaan,2023-08-23,13:00:00,176,74,102,FMN 16 Noorderlaanbrug
676,Noorderlaan,2023-08-23,14:00:00,227,76,151,FMN 16 Noorderlaanbrug
676,Noorderlaan,2023-08-23,15:00:00,206,94,112,FMN 16 Noorderlaanbrug
676,Noorderlaan,2023-08-23,16:00:00,347,137,210,FMN 16 Noorderlaanbrug
676,Noorderlaan,2023-08-23,17:00:00,409,200,209,FMN 16 Noorderlaanbrug
676,Noorderlaan,2023-08-23,18:00:00,237,118,119,FMN 16 Noorderlaanbrug
676,Noorderlaan,2023-08-23,19:00:00,123,64,59,FMN 16 Noorderlaanbrug
676,Noorderlaan,2023-08-23,20:00:00,130,68,62,FMN 16 Noorderlaanbrug
676,Noorderlaan,2023-08-23,21:00:00,87,45,42,FMN 16 Noorderlaanbrug
676,Noorderlaan,2023-08-23,22:00:00,99,35,64,FMN 16 Noorderlaanbrug
676,Noorderlaan,2023-08-23,23:00:00,52,32,20,FMN 16 Noorderlaanbrug
676,Noorderlaan,2023-08-24,00:00:00,31,19,12,FMN 16 Noorderlaanbrug
676,Noorderlaan,2023-08-24,01:00:00,17,7,10,FMN 16 Noorderlaanbrug
676,Noorderlaan,2023-08-24,02:00:00,11,7,4,FMN 16 Noorderlaanbrug
676,Noorderlaan,2023-08-24,03:00:00,14,7,7,FMN 16 Noorderlaanbrug
676,Noorderlaan,2023-08-24,04:00:00,31,19,12,FMN 16 Noorderlaanbrug
676,Noorderlaan,2023-08-24,05:00:00,90,58,32,FMN 16 Noorderlaanbrug
676,Noorderlaan,2023-08-24,06:00:00,127,57,70,FMN 16 Noorderlaanbrug
676,Noorderlaan,2023-08-24,07:00:00,283,104,179,FMN 16 Noorderlaanbrug
676,Noorderlaan,2023-08-24,08:00:00,408,129,279,FMN 16 Noorderlaanbrug
676,Noorderlaan,2023-08-24,09:00:00,173,62,111,FMN 16 Noorderlaanbrug
676,Noorderlaan,2023-08-24,10:00:00,110,42,68,FMN 16 Noorderlaanbrug
676,Noorderlaan,2023-08-24,11:00:00,96,37,59,FMN 16 Noorderlaanbrug
676,Noorderlaan,2023-08-24,12:00:00,87,33,54,FMN 16 Noorderlaanbrug
676,Noorderlaan,2023-08-24,13:00:00,126,60,66,FMN 16 Noorderlaanbrug
676,Noorderlaan,2023-08-24,14:00:00,182,62,120,FMN 16 Noorderlaanbrug
676,Noorderlaan,2023-08-24,15:00:00,189,93,96,FMN 16 Noorderlaanbrug
676,Noorderlaan,2023-08-24,16:00:00,324,140,184,FMN 16 Noorderlaanbrug
676,Noorderlaan,2023-08-24,17:00:00,344,143,201,FMN 16 Noorderlaanbrug
676,Noorderlaan,2023-08-24,18:00:00,173,91,82,FMN 16 Noorderlaanbrug
676,Noorderlaan,2023-08-24,19:00:00,110,53,57,FMN 16 Noorderlaanbrug
676,Noorderlaan,2023-08-24,20:00:00,107,51,56,FMN 16 Noorderlaanbrug
676,Noorderlaan,2023-08-24,21:00:00,77,40,37,FMN 16 Noorderlaanbrug
676,Noorderlaan,2023-08-24,22:00:00,71,40,31,FMN 16 Noorderlaanbrug
676,Noorderlaan,2023-08-24,23:00:00,39,13,26,FMN 16 Noorderlaanbrug
676,Noorderlaan,2023-08-25,00:00:00,31,16,15,FMN 16 Noorderlaanbrug
676,Noorderlaan,2023-08-25,01:00:00,23,14,9,FMN 16 Noorderlaanbrug
676,Noorderlaan,2023-08-25,02:00:00,7,3,4,FMN 16 Noorderlaanbrug
676,Noorderlaan,2023-08-25,03:00:00,13,6,7,FMN 16 Noorderlaanbrug
676,Noorderlaan,2023-08-25,04:00:00,27,15,12,FMN 16 Noorderlaanbrug
676,Noorderlaan,2023-08-25,05:00:00,76,50,26,FMN 16 Noorderlaanbrug
676,Noorderlaan,2023-08-25,06:00:00,100,48,52,FMN 16 Noorderlaanbrug
676,Noorderlaan,2023-08-25,07:00:00,200,81,119,FMN 16 Noorderlaanbrug
676,Noorderlaan,2023-08-25,08:00:00,271,90,181,FMN 16 Noorderlaanbrug
676,Noorderlaan,2023-08-25,09:00:00,131,42,89,FMN 16 Noorderlaanbrug
676,Noorderlaan,2023-08-25,10:00:00,116,38,78,FMN 16 Noorderlaanbrug
676,Noorderlaan,2023-08-25,11:00:00,127,35,92,FMN 16 Noorderlaanbrug
676,Noorderlaan,2023-08-25,12:00:00,147,46,101,FMN 16 Noorderlaanbrug
676,Noorderlaan,2023-08-25,13:00:00,172,87,85,FMN 16 Noorderlaanbrug
676,Noorderlaan,2023-08-25,14:00:00,188,59,129,FMN 16 Noorderlaanbrug
676,Noorderlaan,2023-08-25,15:00:00,234,85,149,FMN 16 Noorderlaanbrug
676,Noorderlaan,2023-08-25,16:00:00,331,159,172,FMN 16 Noorderlaanbrug
676,Noorderlaan,2023-08-25,17:00:00,232,96,136,FMN 16 Noorderlaanbrug
676,Noorderlaan,2023-08-25,18:00:00,185,92,93,FMN 16 Noorderlaanbrug
676,Noorderlaan,2023-08-25,19:00:00,124,70,54,FMN 16 Noorderlaanbrug
676,Noorderlaan,2023-08-25,20:00:00,89,36,53,FMN 16 Noorderlaanbrug
676,Noorderlaan,2023-08-25,21:00:00,69,38,31,FMN 16 Noorderlaanbrug
676,Noorderlaan,2023-08-25,22:00:00,70,28,42,FMN 16 Noorderlaanbrug
676,Noorderlaan,2023-08-25,23:00:00,58,27,31,FMN 16 Noorderlaanbrug
676,Noorderlaan,2023-08-26,00:00:00,51,25,26,FMN 16 Noorderlaanbrug
676,Noorderlaan,2023-08-26,01:00:00,40,18,22,FMN 16 Noorderlaanbrug
676,Noorderlaan,2023-08-26,02:00:00,27,13,14,FMN 16 Noorderlaanbrug
676,Noorderlaan,2023-08-26,03:00:00,19,13,6,FMN 16 Noorderlaanbrug
676,Noorderlaan,2023-08-26,04:00:00,13,5,8,FMN 16 Noorderlaanbrug
676,Noorderlaan,2023-08-26,05:00:00,32,20,12,FMN 16 Noorderlaanbrug
676,Noorderlaan,2023-08-26,06:00:00,33,15,18,FMN 16 Noorderlaanbrug
676,Noorderlaan,2023-08-26,07:00:00,40,22,18,FMN 16 Noorderlaanbrug
676,Noorderlaan,2023-08-26,08:00:00,51,15,36,FMN 16 Noorderlaanbrug
676,Noorderlaan,2023-08-26,09:00:00,104,16,88,FMN 16 Noorderlaanbrug
676,Noorderlaan,2023-08-26,10:00:00,184,42,142,FMN 16 Noorderlaanbrug
676,Noorderlaan,2023-08-26,11:00:00,198,68,130,FMN 16 Noorderlaanbrug
676,Noorderlaan,2023-08-26,12:00:00,209,61,148,FMN 16 Noorderlaanbrug
676,Noorderlaan,2023-08-26,13:00:00,251,97,154,FMN 16 Noorderlaanbrug
676,Noorderlaan,2023-08-26,14:00:00,221,73,148,FMN 16 Noorderlaanbrug
676,Noorderlaan,2023-08-26,15:00:00,222,122,100,FMN 16 Noorderlaanbrug
676,Noorderlaan,2023-08-26,16:00:00,134,96,38,FMN 16 Noorderlaanbrug
676,Noorderlaan,2023-08-26,17:00:00,180,113,67,FMN 16 Noorderlaanbrug
676,Noorderlaan,2023-08-26,18:00:00,135,78,57,FMN 16 Noorderlaanbrug
676,Noorderlaan,2023-08-26,19:00:00,86,45,41,FMN 16 Noorderlaanbrug
676,Noorderlaan,2023-08-26,20:00:00,96,34,62,FMN 16 Noorderlaanbrug
676,Noorderlaan,2023-08-26,21:00:00,70,40,30,FMN 16 Noorderlaanbrug
676,Noorderlaan,2023-08-26,22:00:00,66,32,34,FMN 16 Noorderlaanbrug
676,Noorderlaan,2023-08-26,23:00:00,57,35,22,FMN 16 Noorderlaanbrug
676,Noorderlaan,2023-08-27,00:00:00,44,20,24,FMN 16 Noorderlaanbrug
676,Noorderlaan,2023-08-27,01:00:00,32,17,15,FMN 16 Noorderlaanbrug
676,Noorderlaan,2023-08-27,02:00:00,22,10,12,FMN 16 Noorderlaanbrug
676,Noorderlaan,2023-08-27,03:00:00,11,6,5,FMN 16 Noorderlaanbrug
676,Noorderlaan,2023-08-27,04:00:00,25,16,9,FMN 16 Noorderlaanbrug
676,Noorderlaan,2023-08-27,05:00:00,17,7,10,FMN 16 Noorderlaanbrug
676,Noorderlaan,2023-08-27,06:00:00,30,16,14,FMN 16 Noorderlaanbrug
676,Noorderlaan,2023-08-27,07:00:00,23,12,11,FMN 16 Noorderlaanbrug
676,Noorderlaan,2023-08-27,08:00:00,41,16,25,FMN 16 Noorderlaanbrug
676,Noorderlaan,2023-08-27,09:00:00,83,15,68,FMN 16 Noorderlaanbrug
676,Noorderlaan,2023-08-27,10:00:00,101,16,85,FMN 16 Noorderlaanbrug
676,Noorderlaan,2023-08-27,11:00:00,184,72,112,FMN 16 Noorderlaanbrug
676,Noorderlaan,2023-08-27,12:00:00,156,41,115,FMN 16 Noorderlaanbrug
676,Noorderlaan,2023-08-27,13:00:00,144,83,61,FMN 16 Noorderlaanbrug
676,Noorderlaan,2023-08-27,14:00:00,156,45,111,FMN 16 Noorderlaanbrug
676,Noorderlaan,2023-08-27,15:00:00,161,58,103,FMN 16 Noorderlaanbrug
676,Noorderlaan,2023-08-27,16:00:00,150,65,85,FMN 16 Noorderlaanbrug
676,Noorderlaan,2023-08-27,17:00:00,144,111,33,FMN 16 Noorderlaanbrug
676,Noorderlaan,2023-08-27,18:00:00,120,81,39,FMN 16 Noorderlaanbrug
676,Noorderlaan,2023-08-27,19:00:00,80,46,34,FMN 16 Noorderlaanbrug
676,Noorderlaan,2023-08-27,20:00:00,91,57,34,FMN 16 Noorderlaanbrug
676,Noorderlaan,2023-08-27,21:00:00,64,43,21,FMN 16 Noorderlaanbrug
676,Noorderlaan,2023-08-27,22:00:00,41,25,16,FMN 16 Noorderlaanbrug
676,Noorderlaan,2023-08-27,23:00:00,18,11,7,FMN 16 Noorderlaanbrug
676,Noorderlaan,2023-08-28,00:00:00,38,16,22,FMN 16 Noorderlaanbrug
676,Noorderlaan,2023-08-28,01:00:00,11,4,7,FMN 16 Noorderlaanbrug
676,Noorderlaan,2023-08-28,02:00:00,3,2,1,FMN 16 Noorderlaanbrug
676,Noorderlaan,2023-08-28,03:00:00,7,3,4,FMN 16 Noorderlaanbrug
676,Noorderlaan,2023-08-28,04:00:00,30,13,17,FMN 16 Noorderlaanbrug
676,Noorderlaan,2023-08-28,05:00:00,99,58,41,FMN 16 Noorderlaanbrug
676,Noorderlaan,2023-08-28,06:00:00,162,58,104,FMN 16 Noorderlaanbrug
676,Noorderlaan,2023-08-28,07:00:00,336,114,222,FMN 16 Noorderlaanbrug
676,Noorderlaan,2023-08-28,08:00:00,472,117,355,FMN 16 Noorderlaanbrug
676,Noorderlaan,2023-08-28,09:00:00,233,53,180,FMN 16 Noorderlaanbrug
676,Noorderlaan,2023-08-28,10:00:00,126,39,87,FMN 16 Noorderlaanbrug
676,Noorderlaan,2023-08-28,11:00:00,131,48,83,FMN 16 Noorderlaanbrug
676,Noorderlaan,2023-08-28,12:00:00,181,51,130,FMN 16 Noorderlaanbrug
676,Noorderlaan,2023-08-28,13:00:00,177,76,101,FMN 16 Noorderlaanbrug
676,Noorderlaan,2023-08-28,14:00:00,194,72,122,FMN 16 Noorderlaanbrug
676,Noorderlaan,2023-08-28,15:00:00,264,108,156,FMN 16 Noorderlaanbrug
676,Noorderlaan,2023-08-28,16:00:00,414,188,226,FMN 16 Noorderlaanbrug
676,Noorderlaan,2023-08-28,17:00:00,447,233,214,FMN 16 Noorderlaanbrug
676,Noorderlaan,2023-08-28,18:00:00,212,107,105,FMN 16 Noorderlaanbrug
676,Noorderlaan,2023-08-28,19:00:00,125,61,64,FMN 16 Noorderlaanbrug
676,Noorderlaan,2023-08-28,20:00:00,96,37,59,FMN 16 Noorderlaanbrug
676,Noorderlaan,2023-08-28,21:00:00,58,32,26,FMN 16 Noorderlaanbrug
676,Noorderlaan,2023-08-28,22:00:00,89,31,58,FMN 16 Noorderlaanbrug
676,Noorderlaan,2023-08-28,23:00:00,30,22,8,FMN 16 Noorderlaanbrug
676,Noorderlaan,2023-08-29,00:00:00,18,8,10,FMN 16 Noorderlaanbrug
676,Noorderlaan,2023-08-29,01:00:00,14,8,6,FMN 16 Noorderlaanbrug
676,Noorderlaan,2023-08-29,02:00:00,5,2,3,FMN 16 Noorderlaanbrug
676,Noorderlaan,2023-08-29,03:00:00,7,2,5,FMN 16 Noorderlaanbrug
676,Noorderlaan,2023-08-29,04:00:00,29,13,16,FMN 16 Noorderlaanbrug
676,Noorderlaan,2023-08-29,05:00:00,93,52,41,FMN 16 Noorderlaanbrug
676,Noorderlaan,2023-08-29,06:00:00,179,66,113,FMN 16 Noorderlaanbrug
676,Noorderlaan,2023-08-29,07:00:00,373,118,255,FMN 16 Noorderlaanbrug
676,Noorderlaan,2023-08-29,08:00:00,581,144,437,FMN 16 Noorderlaanbrug
676,Noorderlaan,2023-08-29,09:00:00,216,44,172,FMN 16 Noorderlaanbrug
676,Noorderlaan,2023-08-29,10:00:00,150,46,104,FMN 16 Noorderlaanbrug
676,Noorderlaan,2023-08-29,11:00:00,145,53,92,FMN 16 Noorderlaanbrug
676,Noorderlaan,2023-08-29,12:00:00,172,71,101,FMN 16 Noorderlaanbrug
676,Noorderlaan,2023-08-29,13:00:00,234,94,140,FMN 16 Noorderlaanbrug
676,Noorderlaan,2023-08-29,14:00:00,253,94,159,FMN 16 Noorderlaanbrug
676,Noorderlaan,2023-08-29,15:00:00,255,109,146,FMN 16 Noorderlaanbrug
676,Noorderlaan,2023-08-29,16:00:00,441,222,219,FMN 16 Noorderlaanbrug
676,Noorderlaan,2023-08-29,17:00:00,490,265,225,FMN 16 Noorderlaanbrug
676,Noorderlaan,2023-08-29,18:00:00,270,146,124,FMN 16 Noorderlaanbrug
676,Noorderlaan,2023-08-29,19:00:00,145,61,84,FMN 16 Noorderlaanbrug
676,Noorderlaan,2023-08-29,20:00:00,126,58,68,FMN 16 Noorderlaanbrug
676,Noorderlaan,2023-08-29,21:00:00,95,44,51,FMN 16 Noorderlaanbrug
676,Noorderlaan,2023-08-29,22:00:00,94,35,59,FMN 16 Noorderlaanbrug
676,Noorderlaan,2023-08-29,23:00:00,40,18,22,FMN 16 Noorderlaanbrug
676,Noorderlaan,2023-08-30,00:00:00,25,15,10,FMN 16 Noorderlaanbrug
676,Noorderlaan,2023-08-30,01:00:00,20,11,9,FMN 16 Noorderlaanbrug
676,Noorderlaan,2023-08-30,02:00:00,6,2,4,FMN 16 Noorderlaanbrug
676,Noorderlaan,2023-08-30,03:00:00,17,10,7,FMN 16 Noorderlaanbrug
676,Noorderlaan,2023-08-30,04:00:00,31,13,18,FMN 16 Noorderlaanbrug
676,Noorderlaan,2023-08-30,05:00:00,95,56,39,FMN 16 Noorderlaanbrug
676,Noorderlaan,2023-08-30,06:00:00,150,61,89,FMN 16 Noorderlaanbrug
676,Noorderlaan,2023-08-30,07:00:00,268,94,174,FMN 16 Noorderlaanbrug
676,Noorderlaan,2023-08-30,08:00:00,312,69,243,FMN 16 Noorderlaanbrug
676,Noorderlaan,2023-08-30,09:00:00,155,41,114,FMN 16 Noorderlaanbrug
676,Noorderlaan,2023-08-30,10:00:00,98,34,64,FMN 16 Noorderlaanbrug
676,Noorderlaan,2023-08-30,11:00:00,129,53,76,FMN 16 Noorderlaanbrug
676,Noorderlaan,2023-08-30,12:00:00,136,47,89,FMN 16 Noorderlaanbrug
676,Noorderlaan,2023-08-30,13:00:00,188,81,107,FMN 16 Noorderlaanbrug
676,Noorderlaan,2023-08-30,14:00:00,205,61,144,FMN 16 Noorderlaanbrug
676,Noorderlaan,2023-08-30,15:00:00,182,87,95,FMN 16 Noorderlaanbrug
676,Noorderlaan,2023-08-30,16:00:00,367,167,200,FMN 16 Noorderlaanbrug
676,Noorderlaan,2023-08-30,17:00:00,465,179,286,FMN 16 Noorderlaanbrug
676,Noorderlaan,2023-08-30,18:00:00,247,126,121,FMN 16 Noorderlaanbrug
676,Noorderlaan,2023-08-30,19:00:00,127,62,65,FMN 16 Noorderlaanbrug
676,Noorderlaan,2023-08-30,20:00:00,133,43,90,FMN 16 Noorderlaanbrug
676,Noorderlaan,2023-08-30,21:00:00,56,27,29,FMN 16 Noorderlaanbrug
676,Noorderlaan,2023-08-30,22:00:00,99,45,54,FMN 16 Noorderlaanbrug
676,Noorderlaan,2023-08-30,23:00:00,48,19,29,FMN 16 Noorderlaanbrug
676,Noorderlaan,2023-08-31,00:00:00,17,8,9,FMN 16 Noorderlaanbrug
676,Noorderlaan,2023-08-31,01:00:00,23,13,10,FMN 16 Noorderlaanbrug
676,Noorderlaan,2023-08-31,02:00:00,11,9,2,FMN 16 Noorderlaanbrug
676,Noorderlaan,2023-08-31,03:00:00,7,5,2,FMN 16 Noorderlaanbrug
676,Noorderlaan,2023-08-31,04:00:00,31,18,13,FMN 16 Noorderlaanbrug
676,Noorderlaan,2023-08-31,05:00:00,91,47,44,FMN 16 Noorderlaanbrug
676,Noorderlaan,2023-08-31,06:00:00,146,60,86,FMN 16 Noorderlaanbrug
676,Noorderlaan,2023-08-31,07:00:00,341,112,229,FMN 16 Noorderlaanbrug
676,Noorderlaan,2023-08-31,08:00:00,519,110,409,FMN 16 Noorderlaanbrug
676,Noorderlaan,2023-08-31,09:00:00,234,58,176,FMN 16 Noorderlaanbrug
676,Noorderlaan,2023-08-31,10:00:00,181,56,125,FMN 16 Noorderlaanbrug
676,Noorderlaan,2023-08-31,11:00:00,186,65,121,FMN 16 Noorderlaanbrug
676,Noorderlaan,2023-08-31,12:00:00,200,69,131,FMN 16 Noorderlaanbrug
676,Noorderlaan,2023-08-31,13:00:00,227,103,124,FMN 16 Noorderlaanbrug
676,Noorderlaan,2023-08-31,14:00:00,255,101,154,FMN 16 Noorderlaanbrug
676,Noorderlaan,2023-08-31,15:00:00,282,136,146,FMN 16 Noorderlaanbrug
676,Noorderlaan,2023-08-31,16:00:00,432,203,229,FMN 16 Noorderlaanbrug
676,Noorderlaan,2023-08-31,17:00:00,453,250,203,FMN 16 Noorderlaanbrug
676,Noorderlaan,2023-08-31,18:00:00,284,164,120,FMN 16 Noorderlaanbrug
676,Noorderlaan,2023-08-31,19:00:00,144,71,73,FMN 16 Noorderlaanbrug
676,Noorderlaan,2023-08-31,20:00:00,109,56,53,FMN 16 Noorderlaanbrug
676,Noorderlaan,2023-08-31,21:00:00,88,34,54,FMN 16 Noorderlaanbrug
676,Noorderlaan,2023-08-31,22:00:00,95,36,59,FMN 16 Noorderlaanbrug
676,Noorderlaan,2023-08-31,23:00:00,42,23,19,FMN 16 Noorderlaanbrug
676,Noorderlaan,2023-09-01,00:00:00,25,11,14,FMN 16 Noorderlaanbrug
676,Noorderlaan,2023-09-01,01:00:00,19,9,10,FMN 16 Noorderlaanbrug
676,Noorderlaan,2023-09-01,02:00:00,7,4,3,FMN 16 Noorderlaanbrug
676,Noorderlaan,2023-09-01,03:00:00,9,5,4,FMN 16 Noorderlaanbrug
676,Noorderlaan,2023-09-01,04:00:00,31,12,19,FMN 16 Noorderlaanbrug
676,Noorderlaan,2023-09-01,05:00:00,85,57,28,FMN 16 Noorderlaanbrug
676,Noorderlaan,2023-09-01,06:00:00,114,48,66,FMN 16 Noorderlaanbrug
676,Noorderlaan,2023-09-01,07:00:00,282,99,183,FMN 16 Noorderlaanbrug
676,Noorderlaan,2023-09-01,08:00:00,283,67,216,FMN 16 Noorderlaanbrug
676,Noorderlaan,2023-09-01,09:00:00,143,41,102,FMN 16 Noorderlaanbrug
676,Noorderlaan,2023-09-01,10:00:00,51,19,32,FMN 16 Noorderlaanbrug
676,Noorderlaan,2023-09-01,11:00:00,60,21,39,FMN 16 Noorderlaanbrug
676,Noorderlaan,2023-09-01,12:00:00,107,39,68,FMN 16 Noorderlaanbrug
676,Noorderlaan,2023-09-01,13:00:00,141,61,80,FMN 16 Noorderlaanbrug
676,Noorderlaan,2023-09-01,14:00:00,162,52,110,FMN 16 Noorderlaanbrug
676,Noorderlaan,2023-09-01,15:00:00,253,136,117,FMN 16 Noorderlaanbrug
676,Noorderlaan,2023-09-01,16:00:00,324,151,173,FMN 16 Noorderlaanbrug
676,Noorderlaan,2023-09-01,17:00:00,273,132,141,FMN 16 Noorderlaanbrug
676,Noorderlaan,2023-09-01,18:00:00,204,93,111,FMN 16 Noorderlaanbrug
676,Noorderlaan,2023-09-01,19:00:00,160,63,97,FMN 16 Noorderlaanbrug
676,Noorderlaan,2023-09-01,20:00:00,99,36,63,FMN 16 Noorderlaanbrug
676,Noorderlaan,2023-09-01,21:00:00,66,29,37,FMN 16 Noorderlaanbrug
676,Noorderlaan,2023-09-01,22:00:00,111,40,71,FMN 16 Noorderlaanbrug
676,Noorderlaan,2023-09-01,23:00:00,65,41,24,FMN 16 Noorderlaanbrug
676,Noorderlaan,2023-09-02,00:00:00,37,21,16,FMN 16 Noorderlaanbrug
676,Noorderlaan,2023-09-02,01:00:00,27,20,7,FMN 16 Noorderlaanbrug
676,Noorderlaan,2023-09-02,02:00:00,22,18,4,FMN 16 Noorderlaanbrug
676,Noorderlaan,2023-09-02,03:00:00,23,17,6,FMN 16 Noorderlaanbrug
676,Noorderlaan,2023-09-02,04:00:00,22,13,9,FMN 16 Noorderlaanbrug
676,Noorderlaan,2023-09-02,05:00:00,37,19,18,FMN 16 Noorderlaanbrug
676,Noorderlaan,2023-09-02,06:00:00,41,19,22,FMN 16 Noorderlaanbrug
676,Noorderlaan,2023-09-02,07:00:00,41,16,25,FMN 16 Noorderlaanbrug
676,Noorderlaan,2023-09-02,08:00:00,52,21,31,FMN 16 Noorderlaanbrug
676,Noorderlaan,2023-09-02,09:00:00,131,31,100,FMN 16 Noorderlaanbrug
676,Noorderlaan,2023-09-02,10:00:00,145,48,97,FMN 16 Noorderlaanbrug
676,Noorderlaan,2023-09-02,11:00:00,213,57,156,FMN 16 Noorderlaanbrug
676,Noorderlaan,2023-09-02,12:00:00,209,74,135,FMN 16 Noorderlaanbrug
676,Noorderlaan,2023-09-02,13:00:00,254,80,174,FMN 16 Noorderlaanbrug
676,Noorderlaan,2023-09-02,14:00:00,283,107,176,FMN 16 Noorderlaanbrug
676,Noorderlaan,2023-09-02,15:00:00,245,96,149,FMN 16 Noorderlaanbrug
676,Noorderlaan,2023-09-02,16:00:00,215,106,109,FMN 16 Noorderlaanbrug
676,Noorderlaan,2023-09-02,17:00:00,214,96,118,FMN 16 Noorderlaanbrug
676,Noorderlaan,2023-09-02,18:00:00,224,103,121,FMN 16 Noorderlaanbrug
676,Noorderlaan,2023-09-02,19:00:00,166,80,86,FMN 16 Noorderlaanbrug
676,Noorderlaan,2023-09-02,20:00:00,122,58,64,FMN 16 Noorderlaanbrug
676,Noorderlaan,2023-09-02,21:00:00,92,41,51,FMN 16 Noorderlaanbrug
676,Noorderlaan,2023-09-02,22:00:00,93,43,50,FMN 16 Noorderlaanbrug
676,Noorderlaan,2023-09-02,23:00:00,75,40,35,FMN 16 Noorderlaanbrug
676,Noorderlaan,2023-09-03,00:00:00,92,62,30,FMN 16 Noorderlaanbrug
676,Noorderlaan,2023-09-03,01:00:00,57,33,24,FMN 16 Noorderlaanbrug
676,Noorderlaan,2023-09-03,02:00:00,49,28,21,FMN 16 Noorderlaanbrug
676,Noorderlaan,2023-09-03,03:00:00,25,13,12,FMN 16 Noorderlaanbrug
676,Noorderlaan,2023-09-03,04:00:00,29,16,13,FMN 16 Noorderlaanbrug
676,Noorderlaan,2023-09-03,05:00:00,24,12,12,FMN 16 Noorderlaanbrug
676,Noorderlaan,2023-09-03,06:00:00,30,15,15,FMN 16 Noorderlaanbrug
676,Noorderlaan,2023-09-03,07:00:00,27,9,18,FMN 16 Noorderlaanbrug
676,Noorderlaan,2023-09-03,08:00:00,47,18,29,FMN 16 Noorderlaanbrug
676,Noorderlaan,2023-09-03,09:00:00,97,23,74,FMN 16 Noorderlaanbrug
676,Noorderlaan,2023-09-03,10:00:00,146,41,105,FMN 16 Noorderlaanbrug
676,Noorderlaan,2023-09-03,11:00:00,185,49,136,FMN 16 Noorderlaanbrug
676,Noorderlaan,2023-09-03,12:00:00,197,66,131,FMN 16 Noorderlaanbrug
676,Noorderlaan,2023-09-03,13:00:00,227,59,168,FMN 16 Noorderlaanbrug
676,Noorderlaan,2023-09-03,14:00:00,258,100,158,FMN 16 Noorderlaanbrug
676,Noorderlaan,2023-09-03,15:00:00,207,93,114,FMN 16 Noorderlaanbrug
676,Noorderlaan,2023-09-03,16:00:00,214,124,90,FMN 16 Noorderlaanbrug
676,Noorderlaan,2023-09-03,17:00:00,176,77,99,FMN 16 Noorderlaanbrug
676,Noorderlaan,2023-09-03,18:00:00,160,80,80,FMN 16 Noorderlaanbrug
676,Noorderlaan,2023-09-03,19:00:00,110,59,51,FMN 16 Noorderlaanbrug
676,Noorderlaan,2023-09-03,20:00:00,125,87,38,FMN 16 Noorderlaanbrug
676,Noorderlaan,2023-09-03,21:00:00,64,26,38,FMN 16 Noorderlaanbrug
676,Noorderlaan,2023-09-03,22:00:00,63,32,31,FMN 16 Noorderlaanbrug
676,Noorderlaan,2023-09-03,23:00:00,34,21,13,FMN 16 Noorderlaanbrug
676,Noorderlaan,2023-09-04,00:00:00,19,12,7,FMN 16 Noorderlaanbrug
676,Noorderlaan,2023-09-04,01:00:00,20,14,6,FMN 16 Noorderlaanbrug
676,Noorderlaan,2023-09-04,02:00:00,1,1,0,FMN 16 Noorderlaanbrug
676,Noorderlaan,2023-09-04,03:00:00,10,3,7,FMN 16 Noorderlaanbrug
676,Noorderlaan,2023-09-04,04:00:00,29,14,15,FMN 16 Noorderlaanbrug
676,Noorderlaan,2023-09-04,05:00:00,93,51,42,FMN 16 Noorderlaanbrug
676,Noorderlaan,2023-09-04,06:00:00,199,66,133,FMN 16 Noorderlaanbrug
676,Noorderlaan,2023-09-04,07:00:00,563,177,386,FMN 16 Noorderlaanbrug
676,Noorderlaan,2023-09-04,08:00:00,736,170,566,FMN 16 Noorderlaanbrug
676,Noorderlaan,2023-09-04,09:00:00,233,63,170,FMN 16 Noorderlaanbrug
676,Noorderlaan,2023-09-04,10:00:00,172,49,123,FMN 16 Noorderlaanbrug
676,Noorderlaan,2023-09-04,11:00:00,146,44,102,FMN 16 Noorderlaanbrug
676,Noorderlaan,2023-09-04,12:00:00,231,95,136,FMN 16 Noorderlaanbrug
676,Noorderlaan,2023-09-04,13:00:00,243,111,132,FMN 16 Noorderlaanbrug
676,Noorderlaan,2023-09-04,14:00:00,251,110,141,FMN 16 Noorderlaanbrug
676,Noorderlaan,2023-09-04,15:00:00,393,223,170,FMN 16 Noorderlaanbrug
676,Noorderlaan,2023-09-04,16:00:00,610,350,260,FMN 16 Noorderlaanbrug
676,Noorderlaan,2023-09-04,17:00:00,620,360,260,FMN 16 Noorderlaanbrug
676,Noorderlaan,2023-09-04,18:00:00,308,164,144,FMN 16 Noorderlaanbrug
676,Noorderlaan,2023-09-04,19:00:00,153,78,75,FMN 16 Noorderlaanbrug
676,Noorderlaan,2023-09-04,20:00:00,140,58,82,FMN 16 Noorderlaanbrug
676,Noorderlaan,2023-09-04,21:00:00,92,50,42,FMN 16 Noorderlaanbrug
676,Noorderlaan,2023-09-04,22:00:00,100,47,53,FMN 16 Noorderlaanbrug
676,Noorderlaan,2023-09-04,23:00:00,34,16,18,FMN 16 Noorderlaanbrug
676,Noorderlaan,2023-09-05,00:00:00,20,9,11,FMN 16 Noorderlaanbrug
676,Noorderlaan,2023-09-05,01:00:00,12,6,6,FMN 16 Noorderlaanbrug
676,Noorderlaan,2023-09-05,02:00:00,10,6,4,FMN 16 Noorderlaanbrug
676,Noorderlaan,2023-09-05,03:00:00,16,11,5,FMN 16 Noorderlaanbrug
676,Noorderlaan,2023-09-05,04:00:00,37,17,20,FMN 16 Noorderlaanbrug
676,Noorderlaan,2023-09-05,05:00:00,94,45,49,FMN 16 Noorderlaanbrug
676,Noorderlaan,2023-09-05,06:00:00,203,84,119,FMN 16 Noorderlaanbrug
676,Noorderlaan,2023-09-05,07:00:00,585,167,418,FMN 16 Noorderlaanbrug
676,Noorderlaan,2023-09-05,08:00:00,783,177,606,FMN 16 Noorderlaanbrug
676,Noorderlaan,2023-09-05,09:00:00,269,67,202,FMN 16 Noorderlaanbrug
676,Noorderlaan,2023-09-05,10:00:00,163,46,117,FMN 16 Noorderlaanbrug
676,Noorderlaan,2023-09-05,11:00:00,213,84,129,FMN 16 Noorderlaanbrug
676,Noorderlaan,2023-09-05,12:00:00,256,92,164,FMN 16 Noorderlaanbrug
676,Noorderlaan,2023-09-05,13:00:00,283,132,151,FMN 16 Noorderlaanbrug
676,Noorderlaan,2023-09-05,14:00:00,263,108,155,FMN 16 Noorderlaanbrug
676,Noorderlaan,2023-09-05,15:00:00,343,182,161,FMN 16 Noorderlaanbrug
676,Noorderlaan,2023-09-05,16:00:00,648,356,292,FMN 16 Noorderlaanbrug
676,Noorderlaan,2023-09-05,17:00:00,654,365,289,FMN 16 Noorderlaanbrug
676,Noorderlaan,2023-09-05,18:00:00,375,207,168,FMN 16 Noorderlaanbrug
676,Noorderlaan,2023-09-05,19:00:00,204,104,100,FMN 16 Noorderlaanbrug
676,Noorderlaan,2023-09-05,20:00:00,155,73,82,FMN 16 Noorderlaanbrug
676,Noorderlaan,2023-09-05,21:00:00,150,78,72,FMN 16 Noorderlaanbrug
676,Noorderlaan,2023-09-05,22:00:00,101,42,59,FMN 16 Noorderlaanbrug
676,Noorderlaan,2023-09-05,23:00:00,56,33,23,FMN 16 Noorderlaanbrug
676,Noorderlaan,2023-09-06,00:00:00,22,10,12,FMN 16 Noorderlaanbrug
676,Noorderlaan,2023-09-06,01:00:00,18,11,7,FMN 16 Noorderlaanbrug
676,Noorderlaan,2023-09-06,02:00:00,11,6,5,FMN 16 Noorderlaanbrug
676,Noorderlaan,2023-09-06,03:00:00,8,1,7,FMN 16 Noorderlaanbrug
676,Noorderlaan,2023-09-06,04:00:00,43,25,18,FMN 16 Noorderlaanbrug
676,Noorderlaan,2023-09-06,05:00:00,99,58,41,FMN 16 Noorderlaanbrug
676,Noorderlaan,2023-09-06,06:00:00,181,72,109,FMN 16 Noorderlaanbrug
676,Noorderlaan,2023-09-06,07:00:00,525,173,352,FMN 16 Noorderlaanbrug
676,Noorderlaan,2023-09-06,08:00:00,573,156,417,FMN 16 Noorderlaanbrug
676,Noorderlaan,2023-09-06,09:00:00,219,56,163,FMN 16 Noorderlaanbrug
676,Noorderlaan,2023-09-06,10:00:00,173,48,125,FMN 16 Noorderlaanbrug
676,Noorderlaan,2023-09-06,11:00:00,180,67,113,FMN 16 Noorderlaanbrug
676,Noorderlaan,2023-09-06,12:00:00,301,152,149,FMN 16 Noorderlaanbrug
676,Noorderlaan,2023-09-06,13:00:00,282,141,141,FMN 16 Noorderlaanbrug
676,Noorderlaan,2023-09-06,14:00:00,249,106,143,FMN 16 Noorderlaanbrug
676,Noorderlaan,2023-09-06,15:00:00,294,143,151,FMN 16 Noorderlaanbrug
676,Noorderlaan,2023-09-06,16:00:00,480,245,235,FMN 16 Noorderlaanbrug
676,Noorderlaan,2023-09-06,17:00:00,516,275,241,FMN 16 Noorderlaanbrug
676,Noorderlaan,2023-09-06,18:00:00,362,201,161,FMN 16 Noorderlaanbrug
676,Noorderlaan,2023-09-06,19:00:00,203,82,121,FMN 16 Noorderlaanbrug
676,Noorderlaan,2023-09-06,20:00:00,157,58,99,FMN 16 Noorderlaanbrug
676,Noorderlaan,2023-09-06,21:00:00,102,49,53,FMN 16 Noorderlaanbrug
676,Noorderlaan,2023-09-06,22:00:00,112,61,51,FMN 16 Noorderlaanbrug
676,Noorderlaan,2023-09-06,23:00:00,54,29,25,FMN 16 Noorderlaanbrug
676,Noorderlaan,2023-09-07,00:00:00,33,21,12,FMN 16 Noorderlaanbrug
676,Noorderlaan,2023-09-07,01:00:00,33,28,5,FMN 16 Noorderlaanbrug
676,Noorderlaan,2023-09-07,02:00:00,8,2,6,FMN 16 Noorderlaanbrug
676,Noorderlaan,2023-09-07,03:00:00,16,7,9,FMN 16 Noorderlaanbrug
676,Noorderlaan,2023-09-07,04:00:00,40,21,19,FMN 16 Noorderlaanbrug
676,Noorderlaan,2023-09-07,05:00:00,94,46,48,FMN 16 Noorderlaanbrug
676,Noorderlaan,2023-09-07,06:00:00,186,76,110,FMN 16 Noorderlaanbrug
676,Noorderlaan,2023-09-07,07:00:00,567,177,390,FMN 16 Noorderlaanbrug
676,Noorderlaan,2023-09-07,08:00:00,683,169,514,FMN 16 Noorderlaanbrug
676,Noorderlaan,2023-09-07,09:00:00,278,75,203,FMN 16 Noorderlaanbrug
676,Noorderlaan,2023-09-07,10:00:00,161,47,114,FMN 16 Noorderlaanbrug
676,Noorderlaan,2023-09-07,11:00:00,152,58,94,FMN 16 Noorderlaanbrug
676,Noorderlaan,2023-09-07,12:00:00,249,107,142,FMN 16 Noorderlaanbrug
676,Noorderlaan,2023-09-07,13:00:00,255,129,126,FMN 16 Noorderlaanbrug
676,Noorderlaan,2023-09-07,14:00:00,238,97,141,FMN 16 Noorderlaanbrug
676,Noorderlaan,2023-09-07,15:00:00,334,150,184,FMN 16 Noorderlaanbrug
676,Noorderlaan,2023-09-07,16:00:00,618,334,284,FMN 16 Noorderlaanbrug
676,Noorderlaan,2023-09-07,17:00:00,606,355,251,FMN 16 Noorderlaanbrug
676,Noorderlaan,2023-09-07,18:00:00,356,188,168,FMN 16 Noorderlaanbrug
676,Noorderlaan,2023-09-07,19:00:00,194,90,104,FMN 16 Noorderlaanbrug
676,Noorderlaan,2023-09-07,20:00:00,147,67,80,FMN 16 Noorderlaanbrug
676,Noorderlaan,2023-09-07,21:00:00,136,66,70,FMN 16 Noorderlaanbrug
676,Noorderlaan,2023-09-07,22:00:00,153,86,67,FMN 16 Noorderlaanbrug
676,Noorderlaan,2023-09-07,23:00:00,54,28,26,FMN 16 Noorderlaanbrug
676,Noorderlaan,2023-09-08,00:00:00,48,33,15,FMN 16 Noorderlaanbrug
676,Noorderlaan,2023-09-08,01:00:00,26,17,9,FMN 16 Noorderlaanbrug
676,Noorderlaan,2023-09-08,02:00:00,14,10,4,FMN 16 Noorderlaanbrug
676,Noorderlaan,2023-09-08,03:00:00,13,5,8,FMN 16 Noorderlaanbrug
676,Noorderlaan,2023-09-08,04:00:00,47,21,26,FMN 16 Noorderlaanbrug
676,Noorderlaan,2023-09-08,05:00:00,104,63,41,FMN 16 Noorderlaanbrug
676,Noorderlaan,2023-09-08,06:00:00,171,64,107,FMN 16 Noorderlaanbrug
676,Noorderlaan,2023-09-08,07:00:00,460,157,303,FMN 16 Noorderlaanbrug
676,Noorderlaan,2023-09-08,08:00:00,536,139,397,FMN 16 Noorderlaanbrug
676,Noorderlaan,2023-09-08,09:00:00,199,47,152,FMN 16 Noorderlaanbrug
676,Noorderlaan,2023-09-08,10:00:00,136,45,91,FMN 16 Noorderlaanbrug
676,Noorderlaan,2023-09-08,11:00:00,202,66,136,FMN 16 Noorderlaanbrug
676,Noorderlaan,2023-09-08,12:00:00,229,114,115,FMN 16 Noorderlaanbrug
676,Noorderlaan,2023-09-08,13:00:00,229,95,134,FMN 16 Noorderlaanbrug
676,Noorderlaan,2023-09-08,14:00:00,263,106,157,FMN 16 Noorderlaanbrug
676,Noorderlaan,2023-09-08,15:00:00,345,181,164,FMN 16 Noorderlaanbrug
676,Noorderlaan,2023-09-08,16:00:00,492,248,244,FMN 16 Noorderlaanbrug
676,Noorderlaan,2023-09-08,17:00:00,447,232,215,FMN 16 Noorderlaanbrug
676,Noorderlaan,2023-09-08,18:00:00,304,154,150,FMN 16 Noorderlaanbrug
676,Noorderlaan,2023-09-08,19:00:00,207,86,121,FMN 16 Noorderlaanbrug
676,Noorderlaan,2023-09-08,20:00:00,142,68,74,FMN 16 Noorderlaanbrug
676,Noorderlaan,2023-09-08,21:00:00,136,65,71,FMN 16 Noorderlaanbrug
676,Noorderlaan,2023-09-08,22:00:00,135,51,84,FMN 16 Noorderlaanbrug
676,Noorderlaan,2023-09-08,23:00:00,119,71,48,FMN 16 Noorderlaanbrug
676,Noorderlaan,2023-09-09,00:00:00,93,54,39,FMN 16 Noorderlaanbrug
676,Noorderlaan,2023-09-09,01:00:00,56,38,18,FMN 16 Noorderlaanbrug
676,Noorderlaan,2023-09-09,02:00:00,44,24,20,FMN 16 Noorderlaanbrug
676,Noorderlaan,2023-09-09,03:00:00,31,19,12,FMN 16 Noorderlaanbrug
676,Noorderlaan,2023-09-09,04:00:00,21,14,7,FMN 16 Noorderlaanbrug
676,Noorderlaan,2023-09-09,05:00:00,33,20,13,FMN 16 Noorderlaanbrug
676,Noorderlaan,2023-09-09,06:00:00,61,24,37,FMN 16 Noorderlaanbrug
676,Noorderlaan,2023-09-09,07:00:00,45,20,25,FMN 16 Noorderlaanbrug
676,Noorderlaan,2023-09-09,08:00:00,66,20,46,FMN 16 Noorderlaanbrug
676,Noorderlaan,2023-09-09,09:00:00,154,29,125,FMN 16 Noorderlaanbrug
676,Noorderlaan,2023-09-09,10:00:00,181,43,138,FMN 16 Noorderlaanbrug
676,Noorderlaan,2023-09-09,11:00:00,232,84,148,FMN 16 Noorderlaanbrug
676,Noorderlaan,2023-09-09,12:00:00,234,96,138,FMN 16 Noorderlaanbrug
676,Noorderlaan,2023-09-09,13:00:00,255,102,153,FMN 16 Noorderlaanbrug
676,Noorderlaan,2023-09-09,14:00:00,219,106,113,FMN 16 Noorderlaanbrug
676,Noorderlaan,2023-09-09,15:00:00,225,82,143,FMN 16 Noorderlaanbrug
676,Noorderlaan,2023-09-09,16:00:00,219,107,112,FMN 16 Noorderlaanbrug
676,Noorderlaan,2023-09-09,17:00:00,177,81,96,FMN 16 Noorderlaanbrug
676,Noorderlaan,2023-09-09,18:00:00,242,106,136,FMN 16 Noorderlaanbrug
676,Noorderlaan,2023-09-09,19:00:00,183,78,105,FMN 16 Noorderlaanbrug
676,Noorderlaan,2023-09-09,20:00:00,123,56,67,FMN 16 Noorderlaanbrug
676,Noorderlaan,2023-09-09,21:00:00,120,66,54,FMN 16 Noorderlaanbrug
676,Noorderlaan,2023-09-09,22:00:00,99,57,42,FMN 16 Noorderlaanbrug
676,Noorderlaan,2023-09-09,23:00:00,111,66,45,FMN 16 Noorderlaanbrug
676,Noorderlaan,2023-09-10,00:00:00,92,53,39,FMN 16 Noorderlaanbrug
676,Noorderlaan,2023-09-10,01:00:00,68,50,18,FMN 16 Noorderlaanbrug
676,Noorderlaan,2023-09-10,02:00:00,32,25,7,FMN 16 Noorderlaanbrug
676,Noorderlaan,2023-09-10,03:00:00,36,20,16,FMN 16 Noorderlaanbrug
676,Noorderlaan,2023-09-10,04:00:00,32,19,13,FMN 16 Noorderlaanbrug
676,Noorderlaan,2023-09-10,05:00:00,27,18,9,FMN 16 Noorderlaanbrug
676,Noorderlaan,2023-09-10,06:00:00,41,13,28,FMN 16 Noorderlaanbrug
676,Noorderlaan,2023-09-10,07:00:00,44,24,20,FMN 16 Noorderlaanbrug
676,Noorderlaan,2023-09-10,08:00:00,62,25,37,FMN 16 Noorderlaanbrug
676,Noorderlaan,2023-09-10,09:00:00,150,31,119,FMN 16 Noorderlaanbrug
676,Noorderlaan,2023-09-10,10:00:00,193,49,144,FMN 16 Noorderlaanbrug
676,Noorderlaan,2023-09-10,11:00:00,183,59,124,FMN 16 Noorderlaanbrug
676,Noorderlaan,2023-09-10,12:00:00,201,65,136,FMN 16 Noorderlaanbrug
676,Noorderlaan,2023-09-10,13:00:00,212,87,125,FMN 16 Noorderlaanbrug
676,Noorderlaan,2023-09-10,14:00:00,182,58,124,FMN 16 Noorderlaanbrug
676,Noorderlaan,2023-09-10,15:00:00,160,76,84,FMN 16 Noorderlaanbrug
676,Noorderlaan,2023-09-10,16:00:00,180,84,96,FMN 16 Noorderlaanbrug
676,Noorderlaan,2023-09-10,17:00:00,213,118,95,FMN 16 Noorderlaanbrug
676,Noorderlaan,2023-09-10,18:00:00,158,82,76,FMN 16 Noorderlaanbrug
676,Noorderlaan,2023-09-10,19:00:00,147,83,64,FMN 16 Noorderlaanbrug
676,Noorderlaan,2023-09-10,20:00:00,95,53,42,FMN 16 Noorderlaanbrug
676,Noorderlaan,2023-09-10,21:00:00,94,56,38,FMN 16 Noorderlaanbrug
676,Noorderlaan,2023-09-10,22:00:00,61,39,22,FMN 16 Noorderlaanbrug
676,Noorderlaan,2023-09-10,23:00:00,48,28,20,FMN 16 Noorderlaanbrug
676,Noorderlaan,2023-09-11,00:00:00,18,12,6,FMN 16 Noorderlaanbrug
676,Noorderlaan,2023-09-11,01:00:00,14,8,6,FMN 16 Noorderlaanbrug
676,Noorderlaan,2023-09-11,02:00:00,11,7,4,FMN 16 Noorderlaanbrug
676,Noorderlaan,2023-09-11,03:00:00,8,4,4,FMN 16 Noorderlaanbrug
676,Noorderlaan,2023-09-11,04:00:00,35,13,22,FMN 16 Noorderlaanbrug
676,Noorderlaan,2023-09-11,05:00:00,109,66,43,FMN 16 Noorderlaanbrug
676,Noorderlaan,2023-09-11,06:00:00,216,79,137,FMN 16 Noorderlaanbrug
676,Noorderlaan,2023-09-11,07:00:00,521,163,358,FMN 16 Noorderlaanbrug
676,Noorderlaan,2023-09-11,08:00:00,701,162,539,FMN 16 Noorderlaanbrug
676,Noorderlaan,2023-09-11,09:00:00,237,64,173,FMN 16 Noorderlaanbrug
676,Noorderlaan,2023-09-11,10:00:00,142,47,95,FMN 16 Noorderlaanbrug
676,Noorderlaan,2023-09-11,11:00:00,170,74,96,FMN 16 Noorderlaanbrug
676,Noorderlaan,2023-09-11,12:00:00,205,95,110,FMN 16 Noorderlaanbrug
676,Noorderlaan,2023-09-11,13:00:00,206,92,114,FMN 16 Noorderlaanbrug
676,Noorderlaan,2023-09-11,14:00:00,276,108,168,FMN 16 Noorderlaanbrug
676,Noorderlaan,2023-09-11,15:00:00,320,154,166,FMN 16 Noorderlaanbrug
676,Noorderlaan,2023-09-11,16:00:00,622,352,270,FMN 16 Noorderlaanbrug
676,Noorderlaan,2023-09-11,17:00:00,574,344,230,FMN 16 Noorderlaanbrug
676,Noorderlaan,2023-09-11,18:00:00,325,165,160,FMN 16 Noorderlaanbrug
676,Noorderlaan,2023-09-11,19:00:00,153,64,89,FMN 16 Noorderlaanbrug
676,Noorderlaan,2023-09-11,20:00:00,112,56,56,FMN 16 Noorderlaanbrug
676,Noorderlaan,2023-09-11,21:00:00,88,46,42,FMN 16 Noorderlaanbrug
676,Noorderlaan,2023-09-11,22:00:00,98,48,50,FMN 16 Noorderlaanbrug
676,Noorderlaan,2023-09-11,23:00:00,34,15,19,FMN 16 Noorderlaanbrug
676,Noorderlaan,2023-09-12,00:00:00,22,12,10,FMN 16 Noorderlaanbrug
676,Noorderlaan,2023-09-12,01:00:00,11,5,6,FMN 16 Noorderlaanbrug
676,Noorderlaan,2023-09-12,02:00:00,11,6,5,FMN 16 Noorderlaanbrug
676,Noorderlaan,2023-09-12,03:00:00,14,7,7,FMN 16 Noorderlaanbrug
676,Noorderlaan,2023-09-12,04:00:00,35,14,21,FMN 16 Noorderlaanbrug
676,Noorderlaan,2023-09-12,05:00:00,108,63,45,FMN 16 Noorderlaanbrug
676,Noorderlaan,2023-09-12,06:00:00,199,85,114,FMN 16 Noorderlaanbrug
676,Noorderlaan,2023-09-12,07:00:00,464,158,306,FMN 16 Noorderlaanbrug
676,Noorderlaan,2023-09-12,08:00:00,622,136,486,FMN 16 Noorderlaanbrug
676,Noorderlaan,2023-09-12,09:00:00,226,71,155,FMN 16 Noorderlaanbrug
676,Noorderlaan,2023-09-12,10:00:00,131,39,92,FMN 16 Noorderlaanbrug
676,Noorderlaan,2023-09-12,11:00:00,96,30,66,FMN 16 Noorderlaanbrug
676,Noorderlaan,2023-09-12,12:00:00,211,101,110,FMN 16 Noorderlaanbrug
676,Noorderlaan,2023-09-12,13:00:00,168,83,85,FMN 16 Noorderlaanbrug
676,Noorderlaan,2023-09-12,14:00:00,208,87,121,FMN 16 Noorderlaanbrug
676,Noorderlaan,2023-09-12,15:00:00,331,175,156,FMN 16 Noorderlaanbrug
676,Noorderlaan,2023-09-12,16:00:00,547,304,243,FMN 16 Noorderlaanbrug
676,Noorderlaan,2023-09-12,17:00:00,528,292,236,FMN 16 Noorderlaanbrug
676,Noorderlaan,2023-09-12,18:00:00,328,190,138,FMN 16 Noorderlaanbrug
676,Noorderlaan,2023-09-12,19:00:00,153,83,70,FMN 16 Noorderlaanbrug
676,Noorderlaan,2023-09-12,20:00:00,97,40,57,FMN 16 Noorderlaanbrug
676,Noorderlaan,2023-09-12,21:00:00,137,44,93,FMN 16 Noorderlaanbrug
676,Noorderlaan,2023-09-12,22:00:00,108,37,71,FMN 16 Noorderlaanbrug
676,Noorderlaan,2023-09-12,23:00:00,43,31,12,FMN 16 Noorderlaanbrug
676,Noorderlaan,2023-09-13,00:00:00,9,4,5,FMN 16 Noorderlaanbrug
676,Noorderlaan,2023-09-13,01:00:00,12,8,4,FMN 16 Noorderlaanbrug
676,Noorderlaan,2023-09-13,02:00:00,10,6,4,FMN 16 Noorderlaanbrug
676,Noorderlaan,2023-09-13,03:00:00,9,6,3,FMN 16 Noorderlaanbrug
676,Noorderlaan,2023-09-13,04:00:00,37,15,22,FMN 16 Noorderlaanbrug
676,Noorderlaan,2023-09-13,05:00:00,105,61,44,FMN 16 Noorderlaanbrug
676,Noorderlaan,2023-09-13,06:00:00,163,68,95,FMN 16 Noorderlaanbrug
676,Noorderlaan,2023-09-13,07:00:00,420,155,265,FMN 16 Noorderlaanbrug
676,Noorderlaan,2023-09-13,08:00:00,466,137,329,FMN 16 Noorderlaanbrug
676,Noorderlaan,2023-09-13,09:00:00,185,56,129,FMN 16 Noorderlaanbrug
676,Noorderlaan,2023-09-13,10:00:00,86,35,51,FMN 16 Noorderlaanbrug
676,Noorderlaan,2023-09-13,11:00:00,135,63,72,FMN 16 Noorderlaanbrug
676,Noorderlaan,2023-09-13,12:00:00,230,131,99,FMN 16 Noorderlaanbrug
676,Noorderlaan,2023-09-13,13:00:00,204,100,104,FMN 16 Noorderlaanbrug
676,Noorderlaan,2023-09-13,14:00:00,217,70,147,FMN 16 Noorderlaanbrug
676,Noorderlaan,2023-09-13,15:00:00,206,88,118,FMN 16 Noorderlaanbrug
676,Noorderlaan,2023-09-13,16:00:00,382,190,192,FMN 16 Noorderlaanbrug
676,Noorderlaan,2023-09-13,17:00:00,433,232,201,FMN 16 Noorderlaanbrug
676,Noorderlaan,2023-09-13,18:00:00,241,118,123,FMN 16 Noorderlaanbrug
676,Noorderlaan,2023-09-13,19:00:00,165,73,92,FMN 16 Noorderlaanbrug
676,Noorderlaan,2023-09-13,20:00:00,90,38,52,FMN 16 Noorderlaanbrug
676,Noorderlaan,2023-09-13,21:00:00,97,50,47,FMN 16 Noorderlaanbrug
676,Noorderlaan,2023-09-13,22:00:00,112,51,61,FMN 16 Noorderlaanbrug
676,Noorderlaan,2023-09-13,23:00:00,47,17,30,FMN 16 Noorderlaanbrug
676,Noorderlaan,2023-09-14,00:00:00,23,16,7,FMN 16 Noorderlaanbrug
676,Noorderlaan,2023-09-14,01:00:00,14,10,4,FMN 16 Noorderlaanbrug
676,Noorderlaan,2023-09-14,02:00:00,6,2,4,FMN 16 Noorderlaanbrug
676,Noorderlaan,2023-09-14,03:00:00,6,2,4,FMN 16 Noorderlaanbrug
676,Noorderlaan,2023-09-14,04:00:00,31,11,20,FMN 16 Noorderlaanbrug
676,Noorderlaan,2023-09-14,05:00:00,102,69,33,FMN 16 Noorderlaanbrug
676,Noorderlaan,2023-09-14,06:00:00,167,73,94,FMN 16 Noorderlaanbrug
676,Noorderlaan,2023-09-14,07:00:00,464,161,303,FMN 16 Noorderlaanbrug
676,Noorderlaan,2023-09-14,08:00:00,589,157,432,FMN 16 Noorderlaanbrug
676,Noorderlaan,2023-09-14,09:00:00,232,77,155,FMN 16 Noorderlaanbrug
676,Noorderlaan,2023-09-14,10:00:00,140,46,94,FMN 16 Noorderlaanbrug
676,Noorderlaan,2023-09-14,11:00:00,134,50,84,FMN 16 Noorderlaanbrug
676,Noorderlaan,2023-09-14,12:00:00,209,81,128,FMN 16 Noorderlaanbrug
676,Noorderlaan,2023-09-14,13:00:00,168,83,85,FMN 16 Noorderlaanbrug
676,Noorderlaan,2023-09-14,14:00:00,234,100,134,FMN 16 Noorderlaanbrug
676,Noorderlaan,2023-09-14,15:00:00,280,150,130,FMN 16 Noorderlaanbrug
676,Noorderlaan,2023-09-14,16:00:00,500,273,227,FMN 16 Noorderlaanbrug
676,Noorderlaan,2023-09-14,17:00:00,510,297,213,FMN 16 Noorderlaanbrug
676,Noorderlaan,2023-09-14,18:00:00,267,144,123,FMN 16 Noorderlaanbrug
676,Noorderlaan,2023-09-14,19:00:00,188,89,99,FMN 16 Noorderlaanbrug
676,Noorderlaan,2023-09-14,20:00:00,129,59,70,FMN 16 Noorderlaanbrug
676,Noorderlaan,2023-09-14,21:00:00,117,70,47,FMN 16 Noorderlaanbrug
676,Noorderlaan,2023-09-14,22:00:00,121,47,74,FMN 16 Noorderlaanbrug
676,Noorderlaan,2023-09-14,23:00:00,68,26,42,FMN 16 Noorderlaanbrug
676,Noorderlaan,2023-09-15,00:00:00,68,30,38,FMN 16 Noorderlaanbrug
676,Noorderlaan,2023-09-15,01:00:00,28,7,21,FMN 16 Noorderlaanbrug
676,Noorderlaan,2023-09-15,02:00:00,21,5,16,FMN 16 Noorderlaanbrug
676,Noorderlaan,2023-09-15,03:00:00,8,5,3,FMN 16 Noorderlaanbrug
676,Noorderlaan,2023-09-15,04:00:00,40,25,15,FMN 16 Noorderlaanbrug
676,Noorderlaan,2023-09-15,05:00:00,97,63,34,FMN 16 Noorderlaanbrug
676,Noorderlaan,2023-09-15,06:00:00,137,66,71,FMN 16 Noorderlaanbrug
676,Noorderlaan,2023-09-15,07:00:00,356,127,229,FMN 16 Noorderlaanbrug
676,Noorderlaan,2023-09-15,08:00:00,451,112,339,FMN 16 Noorderlaanbrug
676,Noorderlaan,2023-09-15,09:00:00,294,73,221,FMN 16 Noorderlaanbrug
676,Noorderlaan,2023-09-15,10:00:00,115,37,78,FMN 16 Noorderlaanbrug
676,Noorderlaan,2023-09-15,11:00:00,149,49,100,FMN 16 Noorderlaanbrug
676,Noorderlaan,2023-09-15,12:00:00,177,82,95,FMN 16 Noorderlaanbrug
676,Noorderlaan,2023-09-15,13:00:00,198,85,113,FMN 16 Noorderlaanbrug
676,Noorderlaan,2023-09-15,14:00:00,223,90,133,FMN 16 Noorderlaanbrug
676,Noorderlaan,2023-09-15,15:00:00,270,129,141,FMN 16 Noorderlaanbrug
676,Noorderlaan,2023-09-15,16:00:00,482,239,243,FMN 16 Noorderlaanbrug
676,Noorderlaan,2023-09-15,17:00:00,423,223,200,FMN 16 Noorderlaanbrug
676,Noorderlaan,2023-09-15,18:00:00,249,129,120,FMN 16 Noorderlaanbrug
676,Noorderlaan,2023-09-15,19:00:00,190,86,104,FMN 16 Noorderlaanbrug
676,Noorderlaan,2023-09-15,20:00:00,119,57,62,FMN 16 Noorderlaanbrug
676,Noorderlaan,2023-09-15,21:00:00,82,45,37,FMN 16 Noorderlaanbrug
676,Noorderlaan,2023-09-15,22:00:00,118,44,74,FMN 16 Noorderlaanbrug
676,Noorderlaan,2023-09-15,23:00:00,79,40,39,FMN 16 Noorderlaanbrug
676,Noorderlaan,2023-09-16,00:00:00,56,26,30,FMN 16 Noorderlaanbrug
676,Noorderlaan,2023-09-16,01:00:00,45,21,24,FMN 16 Noorderlaanbrug
676,Noorderlaan,2023-09-16,02:00:00,19,13,6,FMN 16 Noorderlaanbrug
676,Noorderlaan,2023-09-16,03:00:00,23,13,10,FMN 16 Noorderlaanbrug
676,Noorderlaan,2023-09-16,04:00:00,25,13,12,FMN 16 Noorderlaanbrug
676,Noorderlaan,2023-09-16,05:00:00,48,25,23,FMN 16 Noorderlaanbrug
676,Noorderlaan,2023-09-16,06:00:00,47,28,19,FMN 16 Noorderlaanbrug
676,Noorderlaan,2023-09-16,07:00:00,44,19,25,FMN 16 Noorderlaanbrug
676,Noorderlaan,2023-09-16,08:00:00,65,21,44,FMN 16 Noorderlaanbrug
676,Noorderlaan,2023-09-16,09:00:00,99,25,74,FMN 16 Noorderlaanbrug
676,Noorderlaan,2023-09-16,10:00:00,142,35,107,FMN 16 Noorderlaanbrug
676,Noorderlaan,2023-09-16,11:00:00,166,72,94,FMN 16 Noorderlaanbrug
676,Noorderlaan,2023-09-16,12:00:00,159,68,91,FMN 16 Noorderlaanbrug
676,Noorderlaan,2023-09-16,13:00:00,221,75,146,FMN 16 Noorderlaanbrug
676,Noorderlaan,2023-09-16,14:00:00,192,64,128,FMN 16 Noorderlaanbrug
676,Noorderlaan,2023-09-16,15:00:00,184,76,108,FMN 16 Noorderlaanbrug
676,Noorderlaan,2023-09-16,16:00:00,206,82,124,FMN 16 Noorderlaanbrug
676,Noorderlaan,2023-09-16,17:00:00,180,86,94,FMN 16 Noorderlaanbrug
676,Noorderlaan,2023-09-16,18:00:00,178,75,103,FMN 16 Noorderlaanbrug
676,Noorderlaan,2023-09-16,19:00:00,162,77,85,FMN 16 Noorderlaanbrug
676,Noorderlaan,2023-09-16,20:00:00,90,51,39,FMN 16 Noorderlaanbrug
676,Noorderlaan,2023-09-16,21:00:00,60,32,28,FMN 16 Noorderlaanbrug
676,Noorderlaan,2023-09-16,22:00:00,85,26,59,FMN 16 Noorderlaanbrug
676,Noorderlaan,2023-09-16,23:00:00,66,29,37,FMN 16 Noorderlaanbrug
676,Noorderlaan,2023-09-17,00:00:00,60,35,25,FMN 16 Noorderlaanbrug
676,Noorderlaan,2023-09-17,01:00:00,24,15,9,FMN 16 Noorderlaanbrug
676,Noorderlaan,2023-09-17,02:00:00,19,11,8,FMN 16 Noorderlaanbrug
676,Noorderlaan,2023-09-17,03:00:00,21,10,11,FMN 16 Noorderlaanbrug
676,Noorderlaan,2023-09-17,04:00:00,20,11,9,FMN 16 Noorderlaanbrug
676,Noorderlaan,2023-09-17,05:00:00,30,15,15,FMN 16 Noorderlaanbrug
676,Noorderlaan,2023-09-17,06:00:00,31,18,13,FMN 16 Noorderlaanbrug
676,Noorderlaan,2023-09-17,07:00:00,20,13,7,FMN 16 Noorderlaanbrug
676,Noorderlaan,2023-09-17,08:00:00,43,15,28,FMN 16 Noorderlaanbrug
676,Noorderlaan,2023-09-17,09:00:00,85,15,70,FMN 16 Noorderlaanbrug
676,Noorderlaan,2023-09-17,10:00:00,98,24,74,FMN 16 Noorderlaanbrug
676,Noorderlaan,2023-09-17,11:00:00,103,33,70,FMN 16 Noorderlaanbrug
676,Noorderlaan,2023-09-17,12:00:00,132,42,90,FMN 16 Noorderlaanbrug
676,Noorderlaan,2023-09-17,13:00:00,196,52,144,FMN 16 Noorderlaanbrug
676,Noorderlaan,2023-09-17,14:00:00,226,78,148,FMN 16 Noorderlaanbrug
676,Noorderlaan,2023-09-17,15:00:00,165,55,110,FMN 16 Noorderlaanbrug
676,Noorderlaan,2023-09-17,16:00:00,158,95,63,FMN 16 Noorderlaanbrug
676,Noorderlaan,2023-09-17,17:00:00,151,86,65,FMN 16 Noorderlaanbrug
676,Noorderlaan,2023-09-17,18:00:00,152,88,64,FMN 16 Noorderlaanbrug
676,Noorderlaan,2023-09-17,19:00:00,139,83,56,FMN 16 Noorderlaanbrug
676,Noorderlaan,2023-09-17,20:00:00,79,46,33,FMN 16 Noorderlaanbrug
676,Noorderlaan,2023-09-17,21:00:00,65,37,28,FMN 16 Noorderlaanbrug
676,Noorderlaan,2023-09-17,22:00:00,54,20,34,FMN 16 Noorderlaanbrug
676,Noorderlaan,2023-09-17,23:00:00,42,18,24,FMN 16 Noorderlaanbrug
676,Noorderlaan,2023-09-18,00:00:00,10,6,4,FMN 16 Noorderlaanbrug
676,Noorderlaan,2023-09-18,01:00:00,7,4,3,FMN 16 Noorderlaanbrug
676,Noorderlaan,2023-09-18,02:00:00,6,3,3,FMN 16 Noorderlaanbrug
676,Noorderlaan,2023-09-18,03:00:00,6,4,2,FMN 16 Noorderlaanbrug
676,Noorderlaan,2023-09-18,04:00:00,35,16,19,FMN 16 Noorderlaanbrug
676,Noorderlaan,2023-09-18,05:00:00,65,37,28,FMN 16 Noorderlaanbrug
676,Noorderlaan,2023-09-18,06:00:00,134,52,82,FMN 16 Noorderlaanbrug
676,Noorderlaan,2023-09-18,07:00:00,385,108,277,FMN 16 Noorderlaanbrug
676,Noorderlaan,2023-09-18,08:00:00,544,136,408,FMN 16 Noorderlaanbrug
676,Noorderlaan,2023-09-18,09:00:00,196,54,142,FMN 16 Noorderlaanbrug
676,Noorderlaan,2023-09-18,10:00:00,130,43,87,FMN 16 Noorderlaanbrug
676,Noorderlaan,2023-09-18,11:00:00,97,40,57,FMN 16 Noorderlaanbrug
676,Noorderlaan,2023-09-18,12:00:00,171,70,101,FMN 16 Noorderlaanbrug
676,Noorderlaan,2023-09-18,13:00:00,184,90,94,FMN 16 Noorderlaanbrug
676,Noorderlaan,2023-09-18,14:00:00,190,89,101,FMN 16 Noorderlaanbrug
676,Noorderlaan,2023-09-18,15:00:00,238,120,118,FMN 16 Noorderlaanbrug
676,Noorderlaan,2023-09-18,16:00:00,390,232,158,FMN 16 Noorderlaanbrug
676,Noorderlaan,2023-09-18,17:00:00,439,245,194,FMN 16 Noorderlaanbrug
676,Noorderlaan,2023-09-18,18:00:00,181,85,96,FMN 16 Noorderlaanbrug
676,Noorderlaan,2023-09-18,19:00:00,110,57,53,FMN 16 Noorderlaanbrug
676,Noorderlaan,2023-09-18,20:00:00,98,39,59,FMN 16 Noorderlaanbrug
676,Noorderlaan,2023-09-18,21:00:00,65,35,30,FMN 16 Noorderlaanbrug
676,Noorderlaan,2023-09-18,22:00:00,88,38,50,FMN 16 Noorderlaanbrug
676,Noorderlaan,2023-09-18,23:00:00,25,12,13,FMN 16 Noorderlaanbrug
676,Noorderlaan,2023-09-19,00:00:00,25,10,15,FMN 16 Noorderlaanbrug
676,Noorderlaan,2023-09-19,01:00:00,13,6,7,FMN 16 Noorderlaanbrug
676,Noorderlaan,2023-09-19,02:00:00,4,1,3,FMN 16 Noorderlaanbrug
676,Noorderlaan,2023-09-19,03:00:00,3,1,2,FMN 16 Noorderlaanbrug
676,Noorderlaan,2023-09-19,04:00:00,30,14,16,FMN 16 Noorderlaanbrug
676,Noorderlaan,2023-09-19,05:00:00,91,49,42,FMN 16 Noorderlaanbrug
676,Noorderlaan,2023-09-19,06:00:00,154,66,88,FMN 16 Noorderlaanbrug
676,Noorderlaan,2023-09-19,07:00:00,474,151,323,FMN 16 Noorderlaanbrug
676,Noorderlaan,2023-09-19,08:00:00,557,118,439,FMN 16 Noorderlaanbrug
676,Noorderlaan,2023-09-19,09:00:00,212,44,168,FMN 16 Noorderlaanbrug
676,Noorderlaan,2023-09-19,10:00:00,101,21,80,FMN 16 Noorderlaanbrug
676,Noorderlaan,2023-09-19,11:00:00,94,37,57,FMN 16 Noorderlaanbrug
676,Noorderlaan,2023-09-19,12:00:00,153,79,74,FMN 16 Noorderlaanbrug
676,Noorderlaan,2023-09-19,13:00:00,165,82,83,FMN 16 Noorderlaanbrug
676,Noorderlaan,2023-09-19,14:00:00,194,85,109,FMN 16 Noorderlaanbrug
676,Noorderlaan,2023-09-19,15:00:00,245,125,120,FMN 16 Noorderlaanbrug
676,Noorderlaan,2023-09-19,16:00:00,477,254,223,FMN 16 Noorderlaanbrug
676,Noorderlaan,2023-09-19,17:00:00,461,237,224,FMN 16 Noorderlaanbrug
676,Noorderlaan,2023-09-19,18:00:00,224,126,98,FMN 16 Noorderlaanbrug
676,Noorderlaan,2023-09-19,19:00:00,100,35,65,FMN 16 Noorderlaanbrug
676,Noorderlaan,2023-09-19,20:00:00,76,27,49,FMN 16 Noorderlaanbrug
676,Noorderlaan,2023-09-19,21:00:00,60,34,26,FMN 16 Noorderlaanbrug
676,Noorderlaan,2023-09-19,22:00:00,82,30,52,FMN 16 Noorderlaanbrug
676,Noorderlaan,2023-09-19,23:00:00,35,19,16,FMN 16 Noorderlaanbrug
676,Noorderlaan,2023-09-20,00:00:00,23,12,11,FMN 16 Noorderlaanbrug
676,Noorderlaan,2023-09-20,01:00:00,9,5,4,FMN 16 Noorderlaanbrug
676,Noorderlaan,2023-09-20,02:00:00,12,7,5,FMN 16 Noorderlaanbrug
676,Noorderlaan,2023-09-20,03:00:00,8,6,2,FMN 16 Noorderlaanbrug
676,Noorderlaan,2023-09-20,04:00:00,44,22,22,FMN 16 Noorderlaanbrug
676,Noorderlaan,2023-09-20,05:00:00,76,40,36,FMN 16 Noorderlaanbrug
676,Noorderlaan,2023-09-20,06:00:00,144,74,70,FMN 16 Noorderlaanbrug
676,Noorderlaan,2023-09-20,07:00:00,419,143,276,FMN 16 Noorderlaanbrug
676,Noorderlaan,2023-09-20,08:00:00,471,113,358,FMN 16 Noorderlaanbrug
676,Noorderlaan,2023-09-20,09:00:00,169,49,120,FMN 16 Noorderlaanbrug
676,Noorderlaan,2023-09-20,10:00:00,145,37,108,FMN 16 Noorderlaanbrug
676,Noorderlaan,2023-09-20,11:00:00,143,67,76,FMN 16 Noorderlaanbrug
676,Noorderlaan,2023-09-20,12:00:00,223,103,120,FMN 16 Noorderlaanbrug
676,Noorderlaan,2023-09-20,13:00:00,224,117,107,FMN 16 Noorderlaanbrug
676,Noorderlaan,2023-09-20,14:00:00,196,83,113,FMN 16 Noorderlaanbrug
676,Noorderlaan,2023-09-20,15:00:00,234,114,120,FMN 16 Noorderlaanbrug
676,Noorderlaan,2023-09-20,16:00:00,348,174,174,FMN 16 Noorderlaanbrug
676,Noorderlaan,2023-09-20,17:00:00,379,185,194,FMN 16 Noorderlaanbrug
676,Noorderlaan,2023-09-20,18:00:00,228,97,131,FMN 16 Noorderlaanbrug
676,Noorderlaan,2023-09-20,19:00:00,140,61,79,FMN 16 Noorderlaanbrug
676,Noorderlaan,2023-09-20,20:00:00,79,33,46,FMN 16 Noorderlaanbrug
676,Noorderlaan,2023-09-20,21:00:00,95,32,63,FMN 16 Noorderlaanbrug
676,Noorderlaan,2023-09-20,22:00:00,103,36,67,FMN 16 Noorderlaanbrug
676,Noorderlaan,2023-09-20,23:00:00,47,21,26,FMN 16 Noorderlaanbrug
676,Noorderlaan,2023-09-21,00:00:00,34,16,18,FMN 16 Noorderlaanbrug
676,Noorderlaan,2023-09-21,01:00:00,17,4,13,FMN 16 Noorderlaanbrug
676,Noorderlaan,2023-09-21,02:00:00,3,2,1,FMN 16 Noorderlaanbrug
676,Noorderlaan,2023-09-21,03:00:00,7,3,4,FMN 16 Noorderlaanbrug
676,Noorderlaan,2023-09-21,04:00:00,26,16,10,FMN 16 Noorderlaanbrug
676,Noorderlaan,2023-09-21,05:00:00,79,45,34,FMN 16 Noorderlaanbrug
676,Noorderlaan,2023-09-21,06:00:00,117,59,58,FMN 16 Noorderlaanbrug
676,Noorderlaan,2023-09-21,07:00:00,315,110,205,FMN 16 Noorderlaanbrug
676,Noorderlaan,2023-09-21,08:00:00,410,98,312,FMN 16 Noorderlaanbrug
676,Noorderlaan,2023-09-21,09:00:00,135,32,103,FMN 16 Noorderlaanbrug
676,Noorderlaan,2023-09-21,10:00:00,68,21,47,FMN 16 Noorderlaanbrug
676,Noorderlaan,2023-09-21,11:00:00,61,23,38,FMN 16 Noorderlaanbrug
676,Noorderlaan,2023-09-21,12:00:00,107,47,60,FMN 16 Noorderlaanbrug
676,Noorderlaan,2023-09-21,13:00:00,147,68,79,FMN 16 Noorderlaanbrug
676,Noorderlaan,2023-09-21,14:00:00,123,40,83,FMN 16 Noorderlaanbrug
676,Noorderlaan,2023-09-21,15:00:00,219,120,99,FMN 16 Noorderlaanbrug
676,Noorderlaan,2023-09-21,16:00:00,270,148,122,FMN 16 Noorderlaanbrug
676,Noorderlaan,2023-09-21,17:00:00,298,143,155,FMN 16 Noorderlaanbrug
676,Noorderlaan,2023-09-21,18:00:00,171,99,72,FMN 16 Noorderlaanbrug
676,Noorderlaan,2023-09-21,19:00:00,115,65,50,FMN 16 Noorderlaanbrug
676,Noorderlaan,2023-09-21,20:00:00,60,26,34,FMN 16 Noorderlaanbrug
676,Noorderlaan,2023-09-21,21:00:00,52,24,28,FMN 16 Noorderlaanbrug
676,Noorderlaan,2023-09-21,22:00:00,85,25,60,FMN 16 Noorderlaanbrug
676,Noorderlaan,2023-09-21,23:00:00,39,22,17,FMN 16 Noorderlaanbrug
676,Noorderlaan,2023-09-22,00:00:00,27,10,17,FMN 16 Noorderlaanbrug
676,Noorderlaan,2023-09-22,01:00:00,29,9,20,FMN 16 Noorderlaanbrug
676,Noorderlaan,2023-09-22,02:00:00,9,5,4,FMN 16 Noorderlaanbrug
676,Noorderlaan,2023-09-22,03:00:00,6,3,3,FMN 16 Noorderlaanbrug
676,Noorderlaan,2023-09-22,04:00:00,22,12,10,FMN 16 Noorderlaanbrug
676,Noorderlaan,2023-09-22,05:00:00,76,47,29,FMN 16 Noorderlaanbrug
676,Noorderlaan,2023-09-22,06:00:00,112,44,68,FMN 16 Noorderlaanbrug
676,Noorderlaan,2023-09-22,07:00:00,323,121,202,FMN 16 Noorderlaanbrug
676,Noorderlaan,2023-09-22,08:00:00,394,85,309,FMN 16 Noorderlaanbrug
676,Noorderlaan,2023-09-22,09:00:00,145,39,106,FMN 16 Noorderlaanbrug
676,Noorderlaan,2023-09-22,10:00:00,116,43,73,FMN 16 Noorderlaanbrug
676,Noorderlaan,2023-09-22,11:00:00,92,34,58,FMN 16 Noorderlaanbrug
676,Noorderlaan,2023-09-22,12:00:00,183,92,91,FMN 16 Noorderlaanbrug
676,Noorderlaan,2023-09-22,13:00:00,154,72,82,FMN 16 Noorderlaanbrug
676,Noorderlaan,2023-09-22,14:00:00,175,96,79,FMN 16 Noorderlaanbrug
676,Noorderlaan,2023-09-22,15:00:00,214,106,108,FMN 16 Noorderlaanbrug
676,Noorderlaan,2023-09-22,16:00:00,327,165,162,FMN 16 Noorderlaanbrug
676,Noorderlaan,2023-09-22,17:00:00,273,143,130,FMN 16 Noorderlaanbrug
676,Noorderlaan,2023-09-22,18:00:00,153,74,79,FMN 16 Noorderlaanbrug
676,Noorderlaan,2023-09-22,19:00:00,125,60,65,FMN 16 Noorderlaanbrug
676,Noorderlaan,2023-09-22,20:00:00,75,28,47,FMN 16 Noorderlaanbrug
676,Noorderlaan,2023-09-22,21:00:00,66,33,33,FMN 16 Noorderlaanbrug
676,Noorderlaan,2023-09-22,22:00:00,93,36,57,FMN 16 Noorderlaanbrug
676,Noorderlaan,2023-09-22,23:00:00,53,34,19,FMN 16 Noorderlaanbrug
676,Noorderlaan,2023-09-23,00:00:00,44,25,19,FMN 16 Noorderlaanbrug
676,Noorderlaan,2023-09-23,01:00:00,31,14,17,FMN 16 Noorderlaanbrug
676,Noorderlaan,2023-09-23,02:00:00,32,16,16,FMN 16 Noorderlaanbrug
676,Noorderlaan,2023-09-23,03:00:00,20,7,13,FMN 16 Noorderlaanbrug
676,Noorderlaan,2023-09-23,04:00:00,23,9,14,FMN 16 Noorderlaanbrug
676,Noorderlaan,2023-09-23,05:00:00,43,26,17,FMN 16 Noorderlaanbrug
676,Noorderlaan,2023-09-23,06:00:00,46,25,21,FMN 16 Noorderlaanbrug
676,Noorderlaan,2023-09-23,07:00:00,41,18,23,FMN 16 Noorderlaanbrug
676,Noorderlaan,2023-09-23,08:00:00,50,19,31,FMN 16 Noorderlaanbrug
676,Noorderlaan,2023-09-23,09:00:00,106,24,82,FMN 16 Noorderlaanbrug
676,Noorderlaan,2023-09-23,10:00:00,85,25,60,FMN 16 Noorderlaanbrug
676,Noorderlaan,2023-09-23,11:00:00,120,44,76,FMN 16 Noorderlaanbrug
676,Noorderlaan,2023-09-23,12:00:00,148,54,94,FMN 16 Noorderlaanbrug
676,Noorderlaan,2023-09-23,13:00:00,179,72,107,FMN 16 Noorderlaanbrug
676,Noorderlaan,2023-09-23,14:00:00,136,50,86,FMN 16 Noorderlaanbrug
676,Noorderlaan,2023-09-23,15:00:00,141,65,76,FMN 16 Noorderlaanbrug
676,Noorderlaan,2023-09-23,16:00:00,170,77,93,FMN 16 Noorderlaanbrug
676,Noorderlaan,2023-09-23,17:00:00,144,67,77,FMN 16 Noorderlaanbrug
676,Noorderlaan,2023-09-23,18:00:00,151,61,90,FMN 16 Noorderlaanbrug
676,Noorderlaan,2023-09-23,19:00:00,101,41,60,FMN 16 Noorderlaanbrug
676,Noorderlaan,2023-09-23,20:00:00,106,34,72,FMN 16 Noorderlaanbrug
676,Noorderlaan,2023-09-23,21:00:00,70,30,40,FMN 16 Noorderlaanbrug
676,Noorderlaan,2023-09-23,22:00:00,75,39,36,FMN 16 Noorderlaanbrug
676,Noorderlaan,2023-09-23,23:00:00,63,33,30,FMN 16 Noorderlaanbrug
676,Noorderlaan,2023-09-24,00:00:00,70,35,35,FMN 16 Noorderlaanbrug
676,Noorderlaan,2023-09-24,01:00:00,25,17,8,FMN 16 Noorderlaanbrug
676,Noorderlaan,2023-09-24,02:00:00,25,16,9,FMN 16 Noorderlaanbrug
676,Noorderlaan,2023-09-24,03:00:00,23,16,7,FMN 16 Noorderlaanbrug
676,Noorderlaan,2023-09-24,04:00:00,16,10,6,FMN 16 Noorderlaanbrug
676,Noorderlaan,2023-09-24,05:00:00,32,18,14,FMN 16 Noorderlaanbrug
676,Noorderlaan,2023-09-24,06:00:00,39,21,18,FMN 16 Noorderlaanbrug
676,Noorderlaan,2023-09-24,07:00:00,19,7,12,FMN 16 Noorderlaanbrug
676,Noorderlaan,2023-09-24,08:00:00,40,10,30,FMN 16 Noorderlaanbrug
676,Noorderlaan,2023-09-24,09:00:00,68,19,49,FMN 16 Noorderlaanbrug
676,Noorderlaan,2023-09-24,10:00:00,94,23,71,FMN 16 Noorderlaanbrug
676,Noorderlaan,2023-09-24,11:00:00,106,42,64,FMN 16 Noorderlaanbrug
676,Noorderlaan,2023-09-24,12:00:00,95,33,62,FMN 16 Noorderlaanbrug
676,Noorderlaan,2023-09-24,13:00:00,151,69,82,FMN 16 Noorderlaanbrug
676,Noorderlaan,2023-09-24,14:00:00,180,64,116,FMN 16 Noorderlaanbrug
676,Noorderlaan,2023-09-24,15:00:00,139,60,79,FMN 16 Noorderlaanbrug
676,Noorderlaan,2023-09-24,16:00:00,146,72,74,FMN 16 Noorderlaanbrug
676,Noorderlaan,2023-09-24,17:00:00,140,59,81,FMN 16 Noorderlaanbrug
676,Noorderlaan,2023-09-24,18:00:00,118,49,69,FMN 16 Noorderlaanbrug
676,Noorderlaan,2023-09-24,19:00:00,101,53,48,FMN 16 Noorderlaanbrug
676,Noorderlaan,2023-09-24,20:00:00,67,32,35,FMN 16 Noorderlaanbrug
676,Noorderlaan,2023-09-24,21:00:00,48,25,23,FMN 16 Noorderlaanbrug
676,Noorderlaan,2023-09-24,22:00:00,58,33,25,FMN 16 Noorderlaanbrug
676,Noorderlaan,2023-09-24,23:00:00,33,14,19,FMN 16 Noorderlaanbrug
676,Noorderlaan,2023-09-25,00:00:00,18,7,11,FMN 16 Noorderlaanbrug
676,Noorderlaan,2023-09-25,01:00:00,5,3,2,FMN 16 Noorderlaanbrug
676,Noorderlaan,2023-09-25,02:00:00,9,5,4,FMN 16 Noorderlaanbrug
676,Noorderlaan,2023-09-25,03:00:00,8,3,5,FMN 16 Noorderlaanbrug
676,Noorderlaan,2023-09-25,04:00:00,32,9,23,FMN 16 Noorderlaanbrug
676,Noorderlaan,2023-09-25,05:00:00,87,53,34,FMN 16 Noorderlaanbrug
676,Noorderlaan,2023-09-25,06:00:00,144,68,76,FMN 16 Noorderlaanbrug
676,Noorderlaan,2023-09-25,07:00:00,440,154,286,FMN 16 Noorderlaanbrug
676,Noorderlaan,2023-09-25,08:00:00,589,133,456,FMN 16 Noorderlaanbrug
676,Noorderlaan,2023-09-25,09:00:00,264,104,160,FMN 16 Noorderlaanbrug
676,Noorderlaan,2023-09-25,10:00:00,159,46,113,FMN 16 Noorderlaanbrug
676,Noorderlaan,2023-09-25,11:00:00,119,39,80,FMN 16 Noorderlaanbrug
676,Noorderlaan,2023-09-25,12:00:00,358,106,252,FMN 16 Noorderlaanbrug
676,Noorderlaan,2023-09-25,13:00:00,224,107,117,FMN 16 Noorderlaanbrug
676,Noorderlaan,2023-09-25,14:00:00,260,117,143,FMN 16 Noorderlaanbrug
676,Noorderlaan,2023-09-25,15:00:00,291,135,156,FMN 16 Noorderlaanbrug
676,Noorderlaan,2023-09-25,16:00:00,561,276,285,FMN 16 Noorderlaanbrug
676,Noorderlaan,2023-09-25,17:00:00,543,274,269,FMN 16 Noorderlaanbrug
676,Noorderlaan,2023-09-25,18:00:00,249,131,118,FMN 16 Noorderlaanbrug
676,Noorderlaan,2023-09-25,19:00:00,135,59,76,FMN 16 Noorderlaanbrug
676,Noorderlaan,2023-09-25,20:00:00,81,32,49,FMN 16 Noorderlaanbrug
676,Noorderlaan,2023-09-25,21:00:00,68,42,26,FMN 16 Noorderlaanbrug
676,Noorderlaan,2023-09-25,22:00:00,75,32,43,FMN 16 Noorderlaanbrug
676,Noorderlaan,2023-09-25,23:00:00,27,12,15,FMN 16 Noorderlaanbrug
676,Noorderlaan,2023-09-26,00:00:00,23,17,6,FMN 16 Noorderlaanbrug
676,Noorderlaan,2023-09-26,01:00:00,18,12,6,FMN 16 Noorderlaanbrug
676,Noorderlaan,2023-09-26,02:00:00,8,5,3,FMN 16 Noorderlaanbrug
676,Noorderlaan,2023-09-26,03:00:00,10,4,6,FMN 16 Noorderlaanbrug
676,Noorderlaan,2023-09-26,04:00:00,29,9,20,FMN 16 Noorderlaanbrug
676,Noorderlaan,2023-09-26,05:00:00,108,70,38,FMN 16 Noorderlaanbrug
676,Noorderlaan,2023-09-26,06:00:00,168,80,88,FMN 16 Noorderlaanbrug
676,Noorderlaan,2023-09-26,07:00:00,500,164,336,FMN 16 Noorderlaanbrug
676,Noorderlaan,2023-09-26,08:00:00,636,159,477,FMN 16 Noorderlaanbrug
676,Noorderlaan,2023-09-26,09:00:00,331,81,250,FMN 16 Noorderlaanbrug
676,Noorderlaan,2023-09-26,10:00:00,174,42,132,FMN 16 Noorderlaanbrug
676,Noorderlaan,2023-09-26,11:00:00,165,74,91,FMN 16 Noorderlaanbrug
676,Noorderlaan,2023-09-26,12:00:00,255,105,150,FMN 16 Noorderlaanbrug
676,Noorderlaan,2023-09-26,13:00:00,222,111,111,FMN 16 Noorderlaanbrug
676,Noorderlaan,2023-09-26,14:00:00,260,91,169,FMN 16 Noorderlaanbrug
676,Noorderlaan,2023-09-26,15:00:00,306,160,146,FMN 16 Noorderlaanbrug
676,Noorderlaan,2023-09-26,16:00:00,578,288,290,FMN 16 Noorderlaanbrug
676,Noorderlaan,2023-09-26,17:00:00,526,263,263,FMN 16 Noorderlaanbrug
676,Noorderlaan,2023-09-26,18:00:00,311,173,138,FMN 16 Noorderlaanbrug
676,Noorderlaan,2023-09-26,19:00:00,182,88,94,FMN 16 Noorderlaanbrug
676,Noorderlaan,2023-09-26,20:00:00,98,38,60,FMN 16 Noorderlaanbrug
676,Noorderlaan,2023-09-26,21:00:00,81,44,37,FMN 16 Noorderlaanbrug
676,Noorderlaan,2023-09-26,22:00:00,96,38,58,FMN 16 Noorderlaanbrug
676,Noorderlaan,2023-09-26,23:00:00,56,32,24,FMN 16 Noorderlaanbrug
676,Noorderlaan,2023-09-27,00:00:00,17,7,10,FMN 16 Noorderlaanbrug
676,Noorderlaan,2023-09-27,01:00:00,26,17,9,FMN 16 Noorderlaanbrug
676,Noorderlaan,2023-09-27,02:00:00,8,4,4,FMN 16 Noorderlaanbrug
676,Noorderlaan,2023-09-27,03:00:00,9,2,7,FMN 16 Noorderlaanbrug
676,Noorderlaan,2023-09-27,04:00:00,28,12,16,FMN 16 Noorderlaanbrug
676,Noorderlaan,2023-09-27,05:00:00,90,53,37,FMN 16 Noorderlaanbrug
676,Noorderlaan,2023-09-27,06:00:00,144,63,81,FMN 16 Noorderlaanbrug
676,Noorderlaan,2023-09-27,07:00:00,427,154,273,FMN 16 Noorderlaanbrug
676,Noorderlaan,2023-09-27,08:00:00,511,135,376,FMN 16 Noorderlaanbrug
676,Noorderlaan,2023-09-27,09:00:00,235,77,158,FMN 16 Noorderlaanbrug
676,Noorderlaan,2023-09-27,10:00:00,183,54,129,FMN 16 Noorderlaanbrug
676,Noorderlaan,2023-09-27,11:00:00,183,76,107,FMN 16 Noorderlaanbrug
676,Noorderlaan,2023-09-27,12:00:00,273,129,144,FMN 16 Noorderlaanbrug
676,Noorderlaan,2023-09-27,13:00:00,278,123,155,FMN 16 Noorderlaanbrug
676,Noorderlaan,2023-09-27,14:00:00,250,94,156,FMN 16 Noorderlaanbrug
676,Noorderlaan,2023-09-27,15:00:00,286,130,156,FMN 16 Noorderlaanbrug
676,Noorderlaan,2023-09-27,16:00:00,456,213,243,FMN 16 Noorderlaanbrug
676,Noorderlaan,2023-09-27,17:00:00,450,217,233,FMN 16 Noorderlaanbrug
676,Noorderlaan,2023-09-27,18:00:00,256,127,129,FMN 16 Noorderlaanbrug
676,Noorderlaan,2023-09-27,19:00:00,133,51,82,FMN 16 Noorderlaanbrug
676,Noorderlaan,2023-09-27,20:00:00,105,50,55,FMN 16 Noorderlaanbrug
676,Noorderlaan,2023-09-27,21:00:00,79,45,34,FMN 16 Noorderlaanbrug
676,Noorderlaan,2023-09-27,22:00:00,119,49,70,FMN 16 Noorderlaanbrug
676,Noorderlaan,2023-09-27,23:00:00,72,44,28,FMN 16 Noorderlaanbrug
