Meetpunt surrogate key,Meetpunt locatie,Datum,Tijd,Aantal fietsers,Aantal fietsers van,Aantal fietsers naar,Meetpunt code
9,Janssenlei 17,2020-10-14,00:00:00,2,0,2,F11SP
9,Janssenlei 17,2020-10-14,01:00:00,0,0,0,F11SP
9,Janssenlei 17,2020-10-14,02:00:00,4,2,2,F11SP
9,Janssenlei 17,2020-10-14,03:00:00,2,2,0,F11SP
9,Janssenlei 17,2020-10-14,04:00:00,10,6,4,F11SP
9,Janssenlei 17,2020-10-14,05:00:00,28,22,6,F11SP
9,Janssenlei 17,2020-10-14,06:00:00,88,64,24,F11SP
9,Janssenlei 17,2020-10-14,07:00:00,368,220,148,F11SP
9,Janssenlei 17,2020-10-14,08:00:00,314,188,126,F11SP
9,Janssenlei 17,2020-10-14,09:00:00,108,48,60,F11SP
9,Janssenlei 17,2020-10-14,10:00:00,152,70,82,F11SP
9,Janssenlei 17,2020-10-14,11:00:00,184,84,100,F11SP
9,Janssenlei 17,2020-10-14,12:00:00,284,166,118,F11SP
9,Janssenlei 17,2020-10-14,13:00:00,248,98,150,F11SP
9,Janssenlei 17,2020-10-14,14:00:00,174,48,126,F11SP
9,Janssenlei 17,2020-10-14,15:00:00,212,76,136,F11SP
9,Janssenlei 17,2020-10-14,16:00:00,298,118,180,F11SP
9,Janssenlei 17,2020-10-14,17:00:00,272,112,160,F11SP
9,Janssenlei 17,2020-10-14,18:00:00,208,106,102,F11SP
9,Janssenlei 17,2020-10-14,19:00:00,118,50,68,F11SP
9,Janssenlei 17,2020-10-14,20:00:00,40,16,24,F11SP
9,Janssenlei 17,2020-10-14,21:00:00,56,30,26,F11SP
9,Janssenlei 17,2020-10-14,22:00:00,30,4,26,F11SP
9,Janssenlei 17,2020-10-14,23:00:00,10,2,8,F11SP
9,Janssenlei 17,2020-10-15,00:00:00,4,0,4,F11SP
9,Janssenlei 17,2020-10-15,01:00:00,6,2,4,F11SP
9,Janssenlei 17,2020-10-15,02:00:00,0,0,0,F11SP
9,Janssenlei 17,2020-10-15,03:00:00,0,0,0,F11SP
9,Janssenlei 17,2020-10-15,04:00:00,8,8,0,F11SP
9,Janssenlei 17,2020-10-15,05:00:00,36,28,8,F11SP
9,Janssenlei 17,2020-10-15,06:00:00,98,62,36,F11SP
9,Janssenlei 17,2020-10-15,07:00:00,366,244,122,F11SP
9,Janssenlei 17,2020-10-15,08:00:00,348,228,120,F11SP
9,Janssenlei 17,2020-10-15,09:00:00,122,56,66,F11SP
9,Janssenlei 17,2020-10-15,10:00:00,68,38,30,F11SP
9,Janssenlei 17,2020-10-15,11:00:00,80,40,40,F11SP
9,Janssenlei 17,2020-10-15,12:00:00,114,62,52,F11SP
9,Janssenlei 17,2020-10-15,13:00:00,190,66,124,F11SP
9,Janssenlei 17,2020-10-15,14:00:00,202,78,124,F11SP
9,Janssenlei 17,2020-10-15,15:00:00,232,80,152,F11SP
9,Janssenlei 17,2020-10-15,16:00:00,382,146,236,F11SP
9,Janssenlei 17,2020-10-15,17:00:00,292,104,188,F11SP
9,Janssenlei 17,2020-10-15,18:00:00,146,48,98,F11SP
9,Janssenlei 17,2020-10-15,19:00:00,84,42,42,F11SP
9,Janssenlei 17,2020-10-15,20:00:00,42,6,36,F11SP
9,Janssenlei 17,2020-10-15,21:00:00,36,22,14,F11SP
9,Janssenlei 17,2020-10-15,22:00:00,32,6,26,F11SP
9,Janssenlei 17,2020-10-15,23:00:00,14,4,10,F11SP
9,Janssenlei 17,2020-10-16,00:00:00,0,0,0,F11SP
9,Janssenlei 17,2020-10-16,01:00:00,0,0,0,F11SP
9,Janssenlei 17,2020-10-16,02:00:00,4,2,2,F11SP
9,Janssenlei 17,2020-10-16,03:00:00,0,0,0,F11SP
9,Janssenlei 17,2020-10-16,04:00:00,6,6,0,F11SP
9,Janssenlei 17,2020-10-16,05:00:00,26,20,6,F11SP
9,Janssenlei 17,2020-10-16,06:00:00,58,38,20,F11SP
9,Janssenlei 17,2020-10-16,07:00:00,306,168,138,F11SP
9,Janssenlei 17,2020-10-16,08:00:00,316,216,100,F11SP
9,Janssenlei 17,2020-10-16,09:00:00,128,86,42,F11SP
9,Janssenlei 17,2020-10-16,10:00:00,132,62,70,F11SP
9,Janssenlei 17,2020-10-16,11:00:00,124,66,58,F11SP
9,Janssenlei 17,2020-10-16,12:00:00,150,62,88,F11SP
9,Janssenlei 17,2020-10-16,13:00:00,166,64,102,F11SP
9,Janssenlei 17,2020-10-16,14:00:00,248,112,136,F11SP
9,Janssenlei 17,2020-10-16,15:00:00,270,104,166,F11SP
9,Janssenlei 17,2020-10-16,16:00:00,402,176,226,F11SP
9,Janssenlei 17,2020-10-16,17:00:00,280,106,174,F11SP
9,Janssenlei 17,2020-10-16,18:00:00,144,60,84,F11SP
9,Janssenlei 17,2020-10-16,19:00:00,102,50,52,F11SP
9,Janssenlei 17,2020-10-16,20:00:00,48,18,30,F11SP
9,Janssenlei 17,2020-10-16,21:00:00,32,14,18,F11SP
9,Janssenlei 17,2020-10-16,22:00:00,26,10,16,F11SP
9,Janssenlei 17,2020-10-16,23:00:00,22,6,16,F11SP
9,Janssenlei 17,2020-10-17,00:00:00,16,6,10,F11SP
9,Janssenlei 17,2020-10-17,01:00:00,20,6,14,F11SP
9,Janssenlei 17,2020-10-17,02:00:00,2,0,2,F11SP
9,Janssenlei 17,2020-10-17,03:00:00,6,4,2,F11SP
9,Janssenlei 17,2020-10-17,04:00:00,2,2,0,F11SP
9,Janssenlei 17,2020-10-17,05:00:00,12,8,4,F11SP
9,Janssenlei 17,2020-10-17,06:00:00,14,12,2,F11SP
9,Janssenlei 17,2020-10-17,07:00:00,24,8,16,F11SP
9,Janssenlei 17,2020-10-17,08:00:00,64,24,40,F11SP
9,Janssenlei 17,2020-10-17,09:00:00,104,40,64,F11SP
9,Janssenlei 17,2020-10-17,10:00:00,106,60,46,F11SP
9,Janssenlei 17,2020-10-17,11:00:00,158,84,74,F11SP
9,Janssenlei 17,2020-10-17,12:00:00,220,116,104,F11SP
9,Janssenlei 17,2020-10-17,13:00:00,258,130,128,F11SP
9,Janssenlei 17,2020-10-17,14:00:00,294,112,182,F11SP
9,Janssenlei 17,2020-10-17,15:00:00,246,110,136,F11SP
9,Janssenlei 17,2020-10-17,16:00:00,268,158,110,F11SP
9,Janssenlei 17,2020-10-17,17:00:00,138,84,54,F11SP
9,Janssenlei 17,2020-10-17,18:00:00,102,64,38,F11SP
9,Janssenlei 17,2020-10-17,19:00:00,38,18,20,F11SP
9,Janssenlei 17,2020-10-17,20:00:00,44,22,22,F11SP
9,Janssenlei 17,2020-10-17,21:00:00,18,12,6,F11SP
9,Janssenlei 17,2020-10-17,22:00:00,12,0,12,F11SP
9,Janssenlei 17,2020-10-17,23:00:00,12,10,2,F11SP
9,Janssenlei 17,2020-10-18,00:00:00,30,2,28,F11SP
9,Janssenlei 17,2020-10-18,01:00:00,2,2,0,F11SP
9,Janssenlei 17,2020-10-18,02:00:00,2,0,2,F11SP
9,Janssenlei 17,2020-10-18,03:00:00,6,6,0,F11SP
9,Janssenlei 17,2020-10-18,04:00:00,2,0,2,F11SP
9,Janssenlei 17,2020-10-18,05:00:00,4,2,2,F11SP
9,Janssenlei 17,2020-10-18,06:00:00,22,14,8,F11SP
9,Janssenlei 17,2020-10-18,07:00:00,16,8,8,F11SP
9,Janssenlei 17,2020-10-18,08:00:00,136,32,104,F11SP
9,Janssenlei 17,2020-10-18,09:00:00,190,80,110,F11SP
9,Janssenlei 17,2020-10-18,10:00:00,222,78,144,F11SP
9,Janssenlei 17,2020-10-18,11:00:00,270,176,94,F11SP
9,Janssenlei 17,2020-10-18,12:00:00,214,124,90,F11SP
9,Janssenlei 17,2020-10-18,13:00:00,204,94,110,F11SP
9,Janssenlei 17,2020-10-18,14:00:00,258,128,130,F11SP
9,Janssenlei 17,2020-10-18,15:00:00,142,48,94,F11SP
9,Janssenlei 17,2020-10-18,16:00:00,136,82,54,F11SP
9,Janssenlei 17,2020-10-18,17:00:00,148,78,70,F11SP
9,Janssenlei 17,2020-10-18,18:00:00,74,34,40,F11SP
9,Janssenlei 17,2020-10-18,19:00:00,50,24,26,F11SP
9,Janssenlei 17,2020-10-18,20:00:00,28,20,8,F11SP
9,Janssenlei 17,2020-10-18,21:00:00,22,12,10,F11SP
9,Janssenlei 17,2020-10-18,22:00:00,22,10,12,F11SP
9,Janssenlei 17,2020-10-18,23:00:00,4,0,4,F11SP
9,Janssenlei 17,2020-10-19,00:00:00,0,0,0,F11SP
9,Janssenlei 17,2020-10-19,01:00:00,6,0,6,F11SP
9,Janssenlei 17,2020-10-19,02:00:00,6,4,2,F11SP
9,Janssenlei 17,2020-10-19,03:00:00,0,0,0,F11SP
9,Janssenlei 17,2020-10-19,04:00:00,4,4,0,F11SP
9,Janssenlei 17,2020-10-19,05:00:00,24,20,4,F11SP
9,Janssenlei 17,2020-10-19,06:00:00,62,44,18,F11SP
9,Janssenlei 17,2020-10-19,07:00:00,246,116,130,F11SP
9,Janssenlei 17,2020-10-19,08:00:00,274,194,80,F11SP
9,Janssenlei 17,2020-10-19,09:00:00,100,52,48,F11SP
9,Janssenlei 17,2020-10-19,10:00:00,106,46,60,F11SP
9,Janssenlei 17,2020-10-19,11:00:00,78,32,46,F11SP
9,Janssenlei 17,2020-10-19,12:00:00,108,46,62,F11SP
9,Janssenlei 17,2020-10-19,13:00:00,180,60,120,F11SP
9,Janssenlei 17,2020-10-19,14:00:00,250,88,162,F11SP
9,Janssenlei 17,2020-10-19,15:00:00,294,124,170,F11SP
9,Janssenlei 17,2020-10-19,16:00:00,376,160,216,F11SP
9,Janssenlei 17,2020-10-19,17:00:00,254,104,150,F11SP
9,Janssenlei 17,2020-10-19,18:00:00,148,48,100,F11SP
9,Janssenlei 17,2020-10-19,19:00:00,72,30,42,F11SP
9,Janssenlei 17,2020-10-19,20:00:00,54,24,30,F11SP
9,Janssenlei 17,2020-10-19,21:00:00,20,12,8,F11SP
9,Janssenlei 17,2020-10-19,22:00:00,24,6,18,F11SP
9,Janssenlei 17,2020-10-19,23:00:00,6,4,2,F11SP
9,Janssenlei 17,2020-10-20,00:00:00,0,0,0,F11SP
9,Janssenlei 17,2020-10-20,01:00:00,0,0,0,F11SP
9,Janssenlei 17,2020-10-20,02:00:00,2,0,2,F11SP
9,Janssenlei 17,2020-10-20,03:00:00,2,2,0,F11SP
9,Janssenlei 17,2020-10-20,04:00:00,4,4,0,F11SP
9,Janssenlei 17,2020-10-20,05:00:00,30,26,4,F11SP
9,Janssenlei 17,2020-10-20,06:00:00,48,32,16,F11SP
9,Janssenlei 17,2020-10-20,07:00:00,256,156,100,F11SP
9,Janssenlei 17,2020-10-20,08:00:00,326,204,122,F11SP
9,Janssenlei 17,2020-10-20,09:00:00,104,74,30,F11SP
9,Janssenlei 17,2020-10-20,10:00:00,46,26,20,F11SP
9,Janssenlei 17,2020-10-20,11:00:00,70,28,42,F11SP
9,Janssenlei 17,2020-10-20,12:00:00,64,28,36,F11SP
9,Janssenlei 17,2020-10-20,13:00:00,108,34,74,F11SP
9,Janssenlei 17,2020-10-20,14:00:00,120,54,66,F11SP
9,Janssenlei 17,2020-10-20,15:00:00,162,62,100,F11SP
9,Janssenlei 17,2020-10-20,16:00:00,278,104,174,F11SP
9,Janssenlei 17,2020-10-20,17:00:00,184,52,132,F11SP
9,Janssenlei 17,2020-10-20,18:00:00,98,30,68,F11SP
9,Janssenlei 17,2020-10-20,19:00:00,32,8,24,F11SP
9,Janssenlei 17,2020-10-20,20:00:00,22,12,10,F11SP
9,Janssenlei 17,2020-10-20,21:00:00,28,10,18,F11SP
9,Janssenlei 17,2020-10-20,22:00:00,20,6,14,F11SP
9,Janssenlei 17,2020-10-20,23:00:00,6,0,6,F11SP
9,Janssenlei 17,2020-10-21,00:00:00,0,0,0,F11SP
9,Janssenlei 17,2020-10-21,01:00:00,0,0,0,F11SP
9,Janssenlei 17,2020-10-21,02:00:00,2,0,2,F11SP
9,Janssenlei 17,2020-10-21,03:00:00,0,0,0,F11SP
9,Janssenlei 17,2020-10-21,04:00:00,2,2,0,F11SP
9,Janssenlei 17,2020-10-21,05:00:00,16,10,6,F11SP
9,Janssenlei 17,2020-10-21,06:00:00,26,20,6,F11SP
9,Janssenlei 17,2020-10-21,07:00:00,154,96,58,F11SP
9,Janssenlei 17,2020-10-21,08:00:00,192,144,48,F11SP
9,Janssenlei 17,2020-10-21,09:00:00,48,32,16,F11SP
9,Janssenlei 17,2020-10-21,10:00:00,34,14,20,F11SP
9,Janssenlei 17,2020-10-21,11:00:00,88,42,46,F11SP
9,Janssenlei 17,2020-10-21,12:00:00,170,64,106,F11SP
9,Janssenlei 17,2020-10-21,13:00:00,146,52,94,F11SP
9,Janssenlei 17,2020-10-21,14:00:00,148,64,84,F11SP
9,Janssenlei 17,2020-10-21,15:00:00,114,36,78,F11SP
9,Janssenlei 17,2020-10-21,16:00:00,162,66,96,F11SP
9,Janssenlei 17,2020-10-21,17:00:00,150,56,94,F11SP
9,Janssenlei 17,2020-10-21,18:00:00,112,50,62,F11SP
9,Janssenlei 17,2020-10-21,19:00:00,66,26,40,F11SP
9,Janssenlei 17,2020-10-21,20:00:00,46,20,26,F11SP
9,Janssenlei 17,2020-10-21,21:00:00,34,28,6,F11SP
9,Janssenlei 17,2020-10-21,22:00:00,30,10,20,F11SP
9,Janssenlei 17,2020-10-21,23:00:00,6,0,6,F11SP
9,Janssenlei 17,2020-10-22,00:00:00,2,0,2,F11SP
9,Janssenlei 17,2020-10-22,01:00:00,0,0,0,F11SP
9,Janssenlei 17,2020-10-22,02:00:00,2,0,2,F11SP
9,Janssenlei 17,2020-10-22,03:00:00,0,0,0,F11SP
9,Janssenlei 17,2020-10-22,04:00:00,2,2,0,F11SP
9,Janssenlei 17,2020-10-22,05:00:00,22,16,6,F11SP
9,Janssenlei 17,2020-10-22,06:00:00,38,30,8,F11SP
9,Janssenlei 17,2020-10-22,07:00:00,268,180,88,F11SP
9,Janssenlei 17,2020-10-22,08:00:00,296,192,104,F11SP
9,Janssenlei 17,2020-10-22,09:00:00,130,70,60,F11SP
9,Janssenlei 17,2020-10-22,10:00:00,112,62,50,F11SP
9,Janssenlei 17,2020-10-22,11:00:00,148,50,98,F11SP
9,Janssenlei 17,2020-10-22,12:00:00,138,72,66,F11SP
9,Janssenlei 17,2020-10-22,13:00:00,130,48,82,F11SP
9,Janssenlei 17,2020-10-22,14:00:00,172,74,98,F11SP
9,Janssenlei 17,2020-10-22,15:00:00,196,70,126,F11SP
9,Janssenlei 17,2020-10-22,16:00:00,322,116,206,F11SP
9,Janssenlei 17,2020-10-22,17:00:00,278,92,186,F11SP
9,Janssenlei 17,2020-10-22,18:00:00,134,74,60,F11SP
9,Janssenlei 17,2020-10-22,19:00:00,72,28,44,F11SP
9,Janssenlei 17,2020-10-22,20:00:00,34,16,18,F11SP
9,Janssenlei 17,2020-10-22,21:00:00,24,8,16,F11SP
9,Janssenlei 17,2020-10-22,22:00:00,28,14,14,F11SP
9,Janssenlei 17,2020-10-22,23:00:00,4,0,4,F11SP
9,Janssenlei 17,2020-10-23,00:00:00,0,0,0,F11SP
9,Janssenlei 17,2020-10-23,01:00:00,0,0,0,F11SP
9,Janssenlei 17,2020-10-23,02:00:00,2,2,0,F11SP
9,Janssenlei 17,2020-10-23,03:00:00,0,0,0,F11SP
9,Janssenlei 17,2020-10-23,04:00:00,0,0,0,F11SP
9,Janssenlei 17,2020-10-23,05:00:00,28,20,8,F11SP
9,Janssenlei 17,2020-10-23,06:00:00,40,28,12,F11SP
9,Janssenlei 17,2020-10-23,07:00:00,256,150,106,F11SP
9,Janssenlei 17,2020-10-23,08:00:00,282,174,108,F11SP
9,Janssenlei 17,2020-10-23,09:00:00,110,64,46,F11SP
9,Janssenlei 17,2020-10-23,10:00:00,108,56,52,F11SP
9,Janssenlei 17,2020-10-23,11:00:00,100,48,52,F11SP
9,Janssenlei 17,2020-10-23,12:00:00,146,58,88,F11SP
9,Janssenlei 17,2020-10-23,13:00:00,178,66,112,F11SP
9,Janssenlei 17,2020-10-23,14:00:00,202,88,114,F11SP
9,Janssenlei 17,2020-10-23,15:00:00,324,114,210,F11SP
9,Janssenlei 17,2020-10-23,16:00:00,384,142,242,F11SP
9,Janssenlei 17,2020-10-23,17:00:00,268,90,178,F11SP
9,Janssenlei 17,2020-10-23,18:00:00,104,46,58,F11SP
9,Janssenlei 17,2020-10-23,19:00:00,94,30,64,F11SP
9,Janssenlei 17,2020-10-23,20:00:00,38,10,28,F11SP
9,Janssenlei 17,2020-10-23,21:00:00,14,4,10,F11SP
9,Janssenlei 17,2020-10-23,22:00:00,28,16,12,F11SP
9,Janssenlei 17,2020-10-23,23:00:00,18,4,14,F11SP
9,Janssenlei 17,2020-10-24,00:00:00,2,0,2,F11SP
9,Janssenlei 17,2020-10-24,01:00:00,0,0,0,F11SP
9,Janssenlei 17,2020-10-24,02:00:00,0,0,0,F11SP
9,Janssenlei 17,2020-10-24,03:00:00,2,2,0,F11SP
9,Janssenlei 17,2020-10-24,04:00:00,2,2,0,F11SP
9,Janssenlei 17,2020-10-24,05:00:00,10,8,2,F11SP
9,Janssenlei 17,2020-10-24,06:00:00,2,2,0,F11SP
9,Janssenlei 17,2020-10-24,07:00:00,26,10,16,F11SP
9,Janssenlei 17,2020-10-24,08:00:00,42,12,30,F11SP
9,Janssenlei 17,2020-10-24,09:00:00,78,36,42,F11SP
9,Janssenlei 17,2020-10-24,10:00:00,150,60,90,F11SP
9,Janssenlei 17,2020-10-24,11:00:00,104,62,42,F11SP
9,Janssenlei 17,2020-10-24,12:00:00,110,48,62,F11SP
9,Janssenlei 17,2020-10-24,13:00:00,182,84,98,F11SP
9,Janssenlei 17,2020-10-24,14:00:00,200,102,98,F11SP
9,Janssenlei 17,2020-10-24,15:00:00,176,88,88,F11SP
9,Janssenlei 17,2020-10-24,16:00:00,142,96,46,F11SP
9,Janssenlei 17,2020-10-24,17:00:00,106,50,56,F11SP
9,Janssenlei 17,2020-10-24,18:00:00,78,52,26,F11SP
9,Janssenlei 17,2020-10-24,19:00:00,40,20,20,F11SP
9,Janssenlei 17,2020-10-24,20:00:00,20,6,14,F11SP
9,Janssenlei 17,2020-10-24,21:00:00,10,6,4,F11SP
9,Janssenlei 17,2020-10-24,22:00:00,12,8,4,F11SP
9,Janssenlei 17,2020-10-24,23:00:00,6,4,2,F11SP
9,Janssenlei 17,2020-10-25,00:00:00,4,4,0,F11SP
9,Janssenlei 17,2020-10-25,01:00:00,0,0,0,F11SP
9,Janssenlei 17,2020-10-25,02:00:00,0,0,0,F11SP
9,Janssenlei 17,2020-10-25,03:00:00,0,0,0,F11SP
9,Janssenlei 17,2020-10-25,04:00:00,2,2,0,F11SP
9,Janssenlei 17,2020-10-25,05:00:00,8,8,0,F11SP
9,Janssenlei 17,2020-10-25,06:00:00,8,6,2,F11SP
9,Janssenlei 17,2020-10-25,07:00:00,24,16,8,F11SP
9,Janssenlei 17,2020-10-25,08:00:00,70,20,50,F11SP
9,Janssenlei 17,2020-10-25,09:00:00,148,38,110,F11SP
9,Janssenlei 17,2020-10-25,10:00:00,130,46,84,F11SP
9,Janssenlei 17,2020-10-25,11:00:00,90,46,44,F11SP
9,Janssenlei 17,2020-10-25,12:00:00,94,64,30,F11SP
9,Janssenlei 17,2020-10-25,13:00:00,100,38,62,F11SP
9,Janssenlei 17,2020-10-25,14:00:00,182,78,104,F11SP
9,Janssenlei 17,2020-10-25,15:00:00,136,64,72,F11SP
9,Janssenlei 17,2020-10-25,16:00:00,112,64,48,F11SP
9,Janssenlei 17,2020-10-25,17:00:00,94,48,46,F11SP
9,Janssenlei 17,2020-10-25,18:00:00,46,30,16,F11SP
9,Janssenlei 17,2020-10-25,19:00:00,30,14,16,F11SP
9,Janssenlei 17,2020-10-25,20:00:00,8,2,6,F11SP
9,Janssenlei 17,2020-10-25,21:00:00,8,4,4,F11SP
9,Janssenlei 17,2020-10-25,22:00:00,6,2,4,F11SP
9,Janssenlei 17,2020-10-25,23:00:00,8,6,2,F11SP
9,Janssenlei 17,2020-10-26,00:00:00,2,2,0,F11SP
9,Janssenlei 17,2020-10-26,01:00:00,0,0,0,F11SP
9,Janssenlei 17,2020-10-26,02:00:00,0,0,0,F11SP
9,Janssenlei 17,2020-10-26,03:00:00,0,0,0,F11SP
9,Janssenlei 17,2020-10-26,04:00:00,6,6,0,F11SP
9,Janssenlei 17,2020-10-26,05:00:00,12,2,10,F11SP
9,Janssenlei 17,2020-10-26,06:00:00,58,34,24,F11SP
9,Janssenlei 17,2020-10-26,07:00:00,274,154,120,F11SP
9,Janssenlei 17,2020-10-26,08:00:00,262,166,96,F11SP
9,Janssenlei 17,2020-10-26,09:00:00,118,68,50,F11SP
9,Janssenlei 17,2020-10-26,10:00:00,94,46,48,F11SP
9,Janssenlei 17,2020-10-26,11:00:00,80,36,44,F11SP
9,Janssenlei 17,2020-10-26,12:00:00,114,62,52,F11SP
9,Janssenlei 17,2020-10-26,13:00:00,126,62,64,F11SP
9,Janssenlei 17,2020-10-26,14:00:00,148,74,74,F11SP
9,Janssenlei 17,2020-10-26,15:00:00,196,66,130,F11SP
9,Janssenlei 17,2020-10-26,16:00:00,318,116,202,F11SP
9,Janssenlei 17,2020-10-26,17:00:00,224,90,134,F11SP
9,Janssenlei 17,2020-10-26,18:00:00,82,32,50,F11SP
9,Janssenlei 17,2020-10-26,19:00:00,52,10,42,F11SP
9,Janssenlei 17,2020-10-26,20:00:00,44,18,26,F11SP
9,Janssenlei 17,2020-10-26,21:00:00,18,6,12,F11SP
9,Janssenlei 17,2020-10-26,22:00:00,16,2,14,F11SP
9,Janssenlei 17,2020-10-26,23:00:00,8,2,6,F11SP
9,Janssenlei 17,2020-10-27,00:00:00,0,0,0,F11SP
9,Janssenlei 17,2020-10-27,01:00:00,0,0,0,F11SP
9,Janssenlei 17,2020-10-27,02:00:00,0,0,0,F11SP
9,Janssenlei 17,2020-10-27,03:00:00,0,0,0,F11SP
9,Janssenlei 17,2020-10-27,04:00:00,2,2,0,F11SP
9,Janssenlei 17,2020-10-27,05:00:00,22,16,6,F11SP
9,Janssenlei 17,2020-10-27,06:00:00,70,42,28,F11SP
9,Janssenlei 17,2020-10-27,07:00:00,258,146,112,F11SP
9,Janssenlei 17,2020-10-27,08:00:00,298,202,96,F11SP
9,Janssenlei 17,2020-10-27,09:00:00,114,62,52,F11SP
9,Janssenlei 17,2020-10-27,10:00:00,90,46,44,F11SP
9,Janssenlei 17,2020-10-27,11:00:00,78,42,36,F11SP
9,Janssenlei 17,2020-10-27,12:00:00,82,38,44,F11SP
9,Janssenlei 17,2020-10-27,13:00:00,118,64,54,F11SP
9,Janssenlei 17,2020-10-27,14:00:00,142,68,74,F11SP
9,Janssenlei 17,2020-10-27,15:00:00,156,52,104,F11SP
9,Janssenlei 17,2020-10-27,16:00:00,316,102,214,F11SP
9,Janssenlei 17,2020-10-27,17:00:00,206,56,150,F11SP
9,Janssenlei 17,2020-10-27,18:00:00,88,30,58,F11SP
9,Janssenlei 17,2020-10-27,19:00:00,32,14,18,F11SP
9,Janssenlei 17,2020-10-27,20:00:00,18,8,10,F11SP
9,Janssenlei 17,2020-10-27,21:00:00,16,12,4,F11SP
9,Janssenlei 17,2020-10-27,22:00:00,20,4,16,F11SP
9,Janssenlei 17,2020-10-27,23:00:00,12,4,8,F11SP
9,Janssenlei 17,2020-10-28,00:00:00,0,0,0,F11SP
9,Janssenlei 17,2020-10-28,01:00:00,2,0,2,F11SP
9,Janssenlei 17,2020-10-28,02:00:00,0,0,0,F11SP
9,Janssenlei 17,2020-10-28,03:00:00,0,0,0,F11SP
9,Janssenlei 17,2020-10-28,04:00:00,6,6,0,F11SP
9,Janssenlei 17,2020-10-28,05:00:00,10,6,4,F11SP
9,Janssenlei 17,2020-10-28,06:00:00,36,26,10,F11SP
9,Janssenlei 17,2020-10-28,07:00:00,250,140,110,F11SP
9,Janssenlei 17,2020-10-28,08:00:00,256,166,90,F11SP
9,Janssenlei 17,2020-10-28,09:00:00,104,58,46,F11SP
9,Janssenlei 17,2020-10-28,10:00:00,110,50,60,F11SP
9,Janssenlei 17,2020-10-28,11:00:00,152,70,82,F11SP
9,Janssenlei 17,2020-10-28,12:00:00,234,114,120,F11SP
9,Janssenlei 17,2020-10-28,13:00:00,148,60,88,F11SP
9,Janssenlei 17,2020-10-28,14:00:00,106,62,44,F11SP
9,Janssenlei 17,2020-10-28,15:00:00,120,44,76,F11SP
9,Janssenlei 17,2020-10-28,16:00:00,154,62,92,F11SP
9,Janssenlei 17,2020-10-28,17:00:00,122,46,76,F11SP
9,Janssenlei 17,2020-10-28,18:00:00,70,32,38,F11SP
9,Janssenlei 17,2020-10-28,19:00:00,28,10,18,F11SP
9,Janssenlei 17,2020-10-28,20:00:00,16,4,12,F11SP
9,Janssenlei 17,2020-10-28,21:00:00,12,8,4,F11SP
9,Janssenlei 17,2020-10-28,22:00:00,12,2,10,F11SP
9,Janssenlei 17,2020-10-28,23:00:00,0,0,0,F11SP
9,Janssenlei 17,2020-10-29,00:00:00,0,0,0,F11SP
9,Janssenlei 17,2020-10-29,01:00:00,0,0,0,F11SP
9,Janssenlei 17,2020-10-29,02:00:00,0,0,0,F11SP
9,Janssenlei 17,2020-10-29,03:00:00,0,0,0,F11SP
9,Janssenlei 17,2020-10-29,04:00:00,6,6,0,F11SP
9,Janssenlei 17,2020-10-29,05:00:00,28,18,10,F11SP
9,Janssenlei 17,2020-10-29,06:00:00,42,32,10,F11SP
9,Janssenlei 17,2020-10-29,07:00:00,212,122,90,F11SP
9,Janssenlei 17,2020-10-29,08:00:00,290,202,88,F11SP
9,Janssenlei 17,2020-10-29,09:00:00,138,74,64,F11SP
9,Janssenlei 17,2020-10-29,10:00:00,90,52,38,F11SP
9,Janssenlei 17,2020-10-29,11:00:00,102,60,42,F11SP
9,Janssenlei 17,2020-10-29,12:00:00,114,48,66,F11SP
9,Janssenlei 17,2020-10-29,13:00:00,104,30,74,F11SP
9,Janssenlei 17,2020-10-29,14:00:00,116,76,40,F11SP
9,Janssenlei 17,2020-10-29,15:00:00,122,38,84,F11SP
9,Janssenlei 17,2020-10-29,16:00:00,230,86,144,F11SP
9,Janssenlei 17,2020-10-29,17:00:00,176,54,122,F11SP
9,Janssenlei 17,2020-10-29,18:00:00,70,30,40,F11SP
9,Janssenlei 17,2020-10-29,19:00:00,32,6,26,F11SP
9,Janssenlei 17,2020-10-29,20:00:00,32,6,26,F11SP
9,Janssenlei 17,2020-10-29,21:00:00,12,10,2,F11SP
9,Janssenlei 17,2020-10-29,22:00:00,8,2,6,F11SP
9,Janssenlei 17,2020-10-29,23:00:00,2,2,0,F11SP
9,Janssenlei 17,2020-10-30,00:00:00,2,0,2,F11SP
9,Janssenlei 17,2020-10-30,01:00:00,4,2,2,F11SP
9,Janssenlei 17,2020-10-30,02:00:00,0,0,0,F11SP
9,Janssenlei 17,2020-10-30,03:00:00,2,2,0,F11SP
9,Janssenlei 17,2020-10-30,04:00:00,6,6,0,F11SP
9,Janssenlei 17,2020-10-30,05:00:00,18,12,6,F11SP
9,Janssenlei 17,2020-10-30,06:00:00,40,30,10,F11SP
9,Janssenlei 17,2020-10-30,07:00:00,214,118,96,F11SP
9,Janssenlei 17,2020-10-30,08:00:00,242,170,72,F11SP
9,Janssenlei 17,2020-10-30,09:00:00,104,72,32,F11SP
9,Janssenlei 17,2020-10-30,10:00:00,102,48,54,F11SP
9,Janssenlei 17,2020-10-30,11:00:00,136,74,62,F11SP
9,Janssenlei 17,2020-10-30,12:00:00,92,38,54,F11SP
9,Janssenlei 17,2020-10-30,13:00:00,130,46,84,F11SP
9,Janssenlei 17,2020-10-30,14:00:00,174,98,76,F11SP
9,Janssenlei 17,2020-10-30,15:00:00,248,88,160,F11SP
9,Janssenlei 17,2020-10-30,16:00:00,266,124,142,F11SP
9,Janssenlei 17,2020-10-30,17:00:00,204,88,116,F11SP
9,Janssenlei 17,2020-10-30,18:00:00,124,64,60,F11SP
9,Janssenlei 17,2020-10-30,19:00:00,46,18,28,F11SP
9,Janssenlei 17,2020-10-30,20:00:00,24,2,22,F11SP
9,Janssenlei 17,2020-10-30,21:00:00,18,12,6,F11SP
9,Janssenlei 17,2020-10-30,22:00:00,16,6,10,F11SP
9,Janssenlei 17,2020-10-30,23:00:00,30,16,14,F11SP
9,Janssenlei 17,2020-10-31,00:00:00,4,4,0,F11SP
9,Janssenlei 17,2020-10-31,01:00:00,2,0,2,F11SP
9,Janssenlei 17,2020-10-31,02:00:00,0,0,0,F11SP
9,Janssenlei 17,2020-10-31,03:00:00,0,0,0,F11SP
9,Janssenlei 17,2020-10-31,04:00:00,8,8,0,F11SP
9,Janssenlei 17,2020-10-31,05:00:00,8,0,8,F11SP
9,Janssenlei 17,2020-10-31,06:00:00,18,12,6,F11SP
9,Janssenlei 17,2020-10-31,07:00:00,20,10,10,F11SP
9,Janssenlei 17,2020-10-31,08:00:00,70,20,50,F11SP
9,Janssenlei 17,2020-10-31,09:00:00,216,78,138,F11SP
9,Janssenlei 17,2020-10-31,10:00:00,272,80,192,F11SP
9,Janssenlei 17,2020-10-31,11:00:00,384,170,214,F11SP
9,Janssenlei 17,2020-10-31,12:00:00,384,208,176,F11SP
9,Janssenlei 17,2020-10-31,13:00:00,364,142,222,F11SP
9,Janssenlei 17,2020-10-31,14:00:00,444,190,254,F11SP
9,Janssenlei 17,2020-10-31,15:00:00,384,196,188,F11SP
9,Janssenlei 17,2020-10-31,16:00:00,322,192,130,F11SP
9,Janssenlei 17,2020-10-31,17:00:00,136,84,52,F11SP
9,Janssenlei 17,2020-10-31,18:00:00,36,20,16,F11SP
9,Janssenlei 17,2020-10-31,19:00:00,18,8,10,F11SP
9,Janssenlei 17,2020-10-31,20:00:00,10,6,4,F11SP
9,Janssenlei 17,2020-10-31,21:00:00,4,0,4,F11SP
9,Janssenlei 17,2020-10-31,22:00:00,10,2,8,F11SP
9,Janssenlei 17,2020-10-31,23:00:00,14,10,4,F11SP
9,Janssenlei 17,2020-11-01,00:00:00,6,0,6,F11SP
9,Janssenlei 17,2020-11-01,01:00:00,0,0,0,F11SP
9,Janssenlei 17,2020-11-01,02:00:00,0,0,0,F11SP
9,Janssenlei 17,2020-11-01,03:00:00,0,0,0,F11SP
9,Janssenlei 17,2020-11-01,04:00:00,0,0,0,F11SP
9,Janssenlei 17,2020-11-01,05:00:00,4,4,0,F11SP
9,Janssenlei 17,2020-11-01,06:00:00,8,4,4,F11SP
9,Janssenlei 17,2020-11-01,07:00:00,22,10,12,F11SP
9,Janssenlei 17,2020-11-01,08:00:00,58,22,36,F11SP
9,Janssenlei 17,2020-11-01,09:00:00,158,72,86,F11SP
9,Janssenlei 17,2020-11-01,10:00:00,180,56,124,F11SP
9,Janssenlei 17,2020-11-01,11:00:00,162,104,58,F11SP
9,Janssenlei 17,2020-11-01,12:00:00,104,72,32,F11SP
9,Janssenlei 17,2020-11-01,13:00:00,66,24,42,F11SP
9,Janssenlei 17,2020-11-01,14:00:00,74,30,44,F11SP
9,Janssenlei 17,2020-11-01,15:00:00,162,68,94,F11SP
9,Janssenlei 17,2020-11-01,16:00:00,130,72,58,F11SP
9,Janssenlei 17,2020-11-01,17:00:00,62,42,20,F11SP
9,Janssenlei 17,2020-11-01,18:00:00,38,24,14,F11SP
9,Janssenlei 17,2020-11-01,19:00:00,10,2,8,F11SP
9,Janssenlei 17,2020-11-01,20:00:00,4,4,0,F11SP
9,Janssenlei 17,2020-11-01,21:00:00,4,0,4,F11SP
9,Janssenlei 17,2020-11-01,22:00:00,12,2,10,F11SP
9,Janssenlei 17,2020-11-01,23:00:00,6,4,2,F11SP
9,Janssenlei 17,2020-11-02,00:00:00,0,0,0,F11SP
9,Janssenlei 17,2020-11-02,01:00:00,0,0,0,F11SP
9,Janssenlei 17,2020-11-02,02:00:00,0,0,0,F11SP
9,Janssenlei 17,2020-11-02,03:00:00,0,0,0,F11SP
9,Janssenlei 17,2020-11-02,04:00:00,0,0,0,F11SP
9,Janssenlei 17,2020-11-02,05:00:00,16,14,2,F11SP
9,Janssenlei 17,2020-11-02,06:00:00,24,14,10,F11SP
9,Janssenlei 17,2020-11-02,07:00:00,74,50,24,F11SP
9,Janssenlei 17,2020-11-02,08:00:00,70,42,28,F11SP
9,Janssenlei 17,2020-11-02,09:00:00,60,28,32,F11SP
9,Janssenlei 17,2020-11-02,10:00:00,172,112,60,F11SP
9,Janssenlei 17,2020-11-02,11:00:00,116,80,36,F11SP
9,Janssenlei 17,2020-11-02,12:00:00,100,58,42,F11SP
9,Janssenlei 17,2020-11-02,13:00:00,76,48,28,F11SP
9,Janssenlei 17,2020-11-02,14:00:00,84,40,44,F11SP
9,Janssenlei 17,2020-11-02,15:00:00,44,16,28,F11SP
9,Janssenlei 17,2020-11-02,16:00:00,112,36,76,F11SP
9,Janssenlei 17,2020-11-02,17:00:00,106,58,48,F11SP
9,Janssenlei 17,2020-11-02,18:00:00,36,6,30,F11SP
9,Janssenlei 17,2020-11-02,19:00:00,34,12,22,F11SP
9,Janssenlei 17,2020-11-02,20:00:00,38,10,28,F11SP
9,Janssenlei 17,2020-11-02,21:00:00,18,10,8,F11SP
9,Janssenlei 17,2020-11-02,22:00:00,20,2,18,F11SP
9,Janssenlei 17,2020-11-02,23:00:00,4,0,4,F11SP
9,Janssenlei 17,2020-11-03,00:00:00,0,0,0,F11SP
9,Janssenlei 17,2020-11-03,01:00:00,0,0,0,F11SP
9,Janssenlei 17,2020-11-03,02:00:00,0,0,0,F11SP
9,Janssenlei 17,2020-11-03,03:00:00,0,0,0,F11SP
9,Janssenlei 17,2020-11-03,04:00:00,0,0,0,F11SP
9,Janssenlei 17,2020-11-03,05:00:00,34,28,6,F11SP
9,Janssenlei 17,2020-11-03,06:00:00,52,38,14,F11SP
9,Janssenlei 17,2020-11-03,07:00:00,146,80,66,F11SP
9,Janssenlei 17,2020-11-03,08:00:00,98,58,40,F11SP
9,Janssenlei 17,2020-11-03,09:00:00,114,38,76,F11SP
9,Janssenlei 17,2020-11-03,10:00:00,150,76,74,F11SP
9,Janssenlei 17,2020-11-03,11:00:00,180,112,68,F11SP
9,Janssenlei 17,2020-11-03,12:00:00,196,108,88,F11SP
9,Janssenlei 17,2020-11-03,13:00:00,196,84,112,F11SP
9,Janssenlei 17,2020-11-03,14:00:00,188,72,116,F11SP
9,Janssenlei 17,2020-11-03,15:00:00,148,72,76,F11SP
9,Janssenlei 17,2020-11-03,16:00:00,238,102,136,F11SP
9,Janssenlei 17,2020-11-03,17:00:00,184,92,92,F11SP
9,Janssenlei 17,2020-11-03,18:00:00,78,38,40,F11SP
9,Janssenlei 17,2020-11-03,19:00:00,32,14,18,F11SP
9,Janssenlei 17,2020-11-03,20:00:00,44,22,22,F11SP
9,Janssenlei 17,2020-11-03,21:00:00,12,8,4,F11SP
9,Janssenlei 17,2020-11-03,22:00:00,22,0,22,F11SP
9,Janssenlei 17,2020-11-03,23:00:00,14,4,10,F11SP
9,Janssenlei 17,2020-11-04,00:00:00,2,0,2,F11SP
9,Janssenlei 17,2020-11-04,01:00:00,0,0,0,F11SP
9,Janssenlei 17,2020-11-04,02:00:00,0,0,0,F11SP
9,Janssenlei 17,2020-11-04,03:00:00,0,0,0,F11SP
9,Janssenlei 17,2020-11-04,04:00:00,2,2,0,F11SP
9,Janssenlei 17,2020-11-04,05:00:00,24,16,8,F11SP
9,Janssenlei 17,2020-11-04,06:00:00,62,44,18,F11SP
9,Janssenlei 17,2020-11-04,07:00:00,150,82,68,F11SP
9,Janssenlei 17,2020-11-04,08:00:00,116,58,58,F11SP
9,Janssenlei 17,2020-11-04,09:00:00,114,74,40,F11SP
9,Janssenlei 17,2020-11-04,10:00:00,224,106,118,F11SP
9,Janssenlei 17,2020-11-04,11:00:00,188,80,108,F11SP
9,Janssenlei 17,2020-11-04,12:00:00,230,124,106,F11SP
9,Janssenlei 17,2020-11-04,13:00:00,322,144,178,F11SP
9,Janssenlei 17,2020-11-04,14:00:00,378,156,222,F11SP
9,Janssenlei 17,2020-11-04,15:00:00,342,178,164,F11SP
9,Janssenlei 17,2020-11-04,16:00:00,290,142,148,F11SP
9,Janssenlei 17,2020-11-04,17:00:00,204,98,106,F11SP
9,Janssenlei 17,2020-11-04,18:00:00,100,46,54,F11SP
9,Janssenlei 17,2020-11-04,19:00:00,52,20,32,F11SP
9,Janssenlei 17,2020-11-04,20:00:00,28,18,10,F11SP
9,Janssenlei 17,2020-11-04,21:00:00,44,28,16,F11SP
9,Janssenlei 17,2020-11-04,22:00:00,12,6,6,F11SP
9,Janssenlei 17,2020-11-04,23:00:00,6,2,4,F11SP
9,Janssenlei 17,2020-11-05,00:00:00,2,0,2,F11SP
9,Janssenlei 17,2020-11-05,01:00:00,2,0,2,F11SP
9,Janssenlei 17,2020-11-05,02:00:00,0,0,0,F11SP
9,Janssenlei 17,2020-11-05,03:00:00,0,0,0,F11SP
9,Janssenlei 17,2020-11-05,04:00:00,2,2,0,F11SP
9,Janssenlei 17,2020-11-05,05:00:00,16,14,2,F11SP
9,Janssenlei 17,2020-11-05,06:00:00,60,44,16,F11SP
9,Janssenlei 17,2020-11-05,07:00:00,138,76,62,F11SP
9,Janssenlei 17,2020-11-05,08:00:00,76,40,36,F11SP
9,Janssenlei 17,2020-11-05,09:00:00,98,48,50,F11SP
9,Janssenlei 17,2020-11-05,10:00:00,134,56,78,F11SP
9,Janssenlei 17,2020-11-05,11:00:00,176,84,92,F11SP
9,Janssenlei 17,2020-11-05,12:00:00,182,94,88,F11SP
9,Janssenlei 17,2020-11-05,13:00:00,250,80,170,F11SP
9,Janssenlei 17,2020-11-05,14:00:00,426,174,252,F11SP
9,Janssenlei 17,2020-11-05,15:00:00,376,186,190,F11SP
9,Janssenlei 17,2020-11-05,16:00:00,338,190,148,F11SP
9,Janssenlei 17,2020-11-05,17:00:00,230,114,116,F11SP
9,Janssenlei 17,2020-11-05,18:00:00,84,44,40,F11SP
9,Janssenlei 17,2020-11-05,19:00:00,50,28,22,F11SP
9,Janssenlei 17,2020-11-05,20:00:00,28,16,12,F11SP
9,Janssenlei 17,2020-11-05,21:00:00,18,6,12,F11SP
9,Janssenlei 17,2020-11-05,22:00:00,12,0,12,F11SP
9,Janssenlei 17,2020-11-05,23:00:00,12,2,10,F11SP
9,Janssenlei 17,2020-11-06,00:00:00,10,8,2,F11SP
9,Janssenlei 17,2020-11-06,01:00:00,0,0,0,F11SP
9,Janssenlei 17,2020-11-06,02:00:00,0,0,0,F11SP
9,Janssenlei 17,2020-11-06,03:00:00,0,0,0,F11SP
9,Janssenlei 17,2020-11-06,04:00:00,2,2,0,F11SP
9,Janssenlei 17,2020-11-06,05:00:00,24,22,2,F11SP
9,Janssenlei 17,2020-11-06,06:00:00,54,36,18,F11SP
9,Janssenlei 17,2020-11-06,07:00:00,114,74,40,F11SP
9,Janssenlei 17,2020-11-06,08:00:00,94,54,40,F11SP
9,Janssenlei 17,2020-11-06,09:00:00,78,44,34,F11SP
9,Janssenlei 17,2020-11-06,10:00:00,118,58,60,F11SP
9,Janssenlei 17,2020-11-06,11:00:00,158,84,74,F11SP
9,Janssenlei 17,2020-11-06,12:00:00,198,92,106,F11SP
9,Janssenlei 17,2020-11-06,13:00:00,302,124,178,F11SP
9,Janssenlei 17,2020-11-06,14:00:00,408,170,238,F11SP
9,Janssenlei 17,2020-11-06,15:00:00,370,188,182,F11SP
9,Janssenlei 17,2020-11-06,16:00:00,314,172,142,F11SP
9,Janssenlei 17,2020-11-06,17:00:00,174,94,80,F11SP
9,Janssenlei 17,2020-11-06,18:00:00,60,38,22,F11SP
9,Janssenlei 17,2020-11-06,19:00:00,44,16,28,F11SP
9,Janssenlei 17,2020-11-06,20:00:00,26,14,12,F11SP
9,Janssenlei 17,2020-11-06,21:00:00,14,4,10,F11SP
9,Janssenlei 17,2020-11-06,22:00:00,8,4,4,F11SP
9,Janssenlei 17,2020-11-06,23:00:00,10,4,6,F11SP
9,Janssenlei 17,2020-11-07,00:00:00,0,0,0,F11SP
9,Janssenlei 17,2020-11-07,01:00:00,0,0,0,F11SP
9,Janssenlei 17,2020-11-07,02:00:00,0,0,0,F11SP
9,Janssenlei 17,2020-11-07,03:00:00,2,0,2,F11SP
9,Janssenlei 17,2020-11-07,04:00:00,4,4,0,F11SP
9,Janssenlei 17,2020-11-07,05:00:00,6,6,0,F11SP
9,Janssenlei 17,2020-11-07,06:00:00,24,12,12,F11SP
9,Janssenlei 17,2020-11-07,07:00:00,26,8,18,F11SP
9,Janssenlei 17,2020-11-07,08:00:00,44,20,24,F11SP
9,Janssenlei 17,2020-11-07,09:00:00,122,42,80,F11SP
9,Janssenlei 17,2020-11-07,10:00:00,252,94,158,F11SP
9,Janssenlei 17,2020-11-07,11:00:00,342,154,188,F11SP
9,Janssenlei 17,2020-11-07,12:00:00,278,122,156,F11SP
9,Janssenlei 17,2020-11-07,13:00:00,488,166,322,F11SP
9,Janssenlei 17,2020-11-07,14:00:00,800,348,452,F11SP
9,Janssenlei 17,2020-11-07,15:00:00,614,342,272,F11SP
9,Janssenlei 17,2020-11-07,16:00:00,340,216,124,F11SP
9,Janssenlei 17,2020-11-07,17:00:00,198,154,44,F11SP
9,Janssenlei 17,2020-11-07,18:00:00,36,18,18,F11SP
9,Janssenlei 17,2020-11-07,19:00:00,22,6,16,F11SP
9,Janssenlei 17,2020-11-07,20:00:00,30,6,24,F11SP
9,Janssenlei 17,2020-11-07,21:00:00,8,2,6,F11SP
9,Janssenlei 17,2020-11-07,22:00:00,26,16,10,F11SP
9,Janssenlei 17,2020-11-07,23:00:00,20,12,8,F11SP
9,Janssenlei 17,2020-11-08,00:00:00,4,2,2,F11SP
9,Janssenlei 17,2020-11-08,01:00:00,0,0,0,F11SP
9,Janssenlei 17,2020-11-08,02:00:00,0,0,0,F11SP
9,Janssenlei 17,2020-11-08,03:00:00,0,0,0,F11SP
9,Janssenlei 17,2020-11-08,04:00:00,4,4,0,F11SP
9,Janssenlei 17,2020-11-08,05:00:00,2,2,0,F11SP
9,Janssenlei 17,2020-11-08,06:00:00,10,6,4,F11SP
9,Janssenlei 17,2020-11-08,07:00:00,32,16,16,F11SP
9,Janssenlei 17,2020-11-08,08:00:00,56,18,38,F11SP
9,Janssenlei 17,2020-11-08,09:00:00,188,68,120,F11SP
9,Janssenlei 17,2020-11-08,10:00:00,288,106,182,F11SP
9,Janssenlei 17,2020-11-08,11:00:00,392,170,222,F11SP
9,Janssenlei 17,2020-11-08,12:00:00,318,158,160,F11SP
9,Janssenlei 17,2020-11-08,13:00:00,460,204,256,F11SP
9,Janssenlei 17,2020-11-08,14:00:00,564,276,288,F11SP
9,Janssenlei 17,2020-11-08,15:00:00,412,234,178,F11SP
9,Janssenlei 17,2020-11-08,16:00:00,352,216,136,F11SP
9,Janssenlei 17,2020-11-08,17:00:00,142,82,60,F11SP
9,Janssenlei 17,2020-11-08,18:00:00,34,14,20,F11SP
9,Janssenlei 17,2020-11-08,19:00:00,18,4,14,F11SP
9,Janssenlei 17,2020-11-08,20:00:00,16,6,10,F11SP
9,Janssenlei 17,2020-11-08,21:00:00,20,12,8,F11SP
9,Janssenlei 17,2020-11-08,22:00:00,12,4,8,F11SP
9,Janssenlei 17,2020-11-08,23:00:00,6,2,4,F11SP
9,Janssenlei 17,2020-11-09,00:00:00,0,0,0,F11SP
9,Janssenlei 17,2020-11-09,01:00:00,0,0,0,F11SP
9,Janssenlei 17,2020-11-09,02:00:00,0,0,0,F11SP
9,Janssenlei 17,2020-11-09,03:00:00,0,0,0,F11SP
9,Janssenlei 17,2020-11-09,04:00:00,4,4,0,F11SP
9,Janssenlei 17,2020-11-09,05:00:00,24,16,8,F11SP
9,Janssenlei 17,2020-11-09,06:00:00,70,46,24,F11SP
9,Janssenlei 17,2020-11-09,07:00:00,150,100,50,F11SP
9,Janssenlei 17,2020-11-09,08:00:00,118,78,40,F11SP
9,Janssenlei 17,2020-11-09,09:00:00,98,48,50,F11SP
9,Janssenlei 17,2020-11-09,10:00:00,100,60,40,F11SP
9,Janssenlei 17,2020-11-09,11:00:00,102,54,48,F11SP
9,Janssenlei 17,2020-11-09,12:00:00,148,60,88,F11SP
9,Janssenlei 17,2020-11-09,13:00:00,258,102,156,F11SP
9,Janssenlei 17,2020-11-09,14:00:00,400,182,218,F11SP
9,Janssenlei 17,2020-11-09,15:00:00,376,178,198,F11SP
9,Janssenlei 17,2020-11-09,16:00:00,328,128,200,F11SP
9,Janssenlei 17,2020-11-09,17:00:00,192,80,112,F11SP
9,Janssenlei 17,2020-11-09,18:00:00,76,38,38,F11SP
9,Janssenlei 17,2020-11-09,19:00:00,46,22,24,F11SP
9,Janssenlei 17,2020-11-09,20:00:00,34,14,20,F11SP
9,Janssenlei 17,2020-11-09,21:00:00,18,2,16,F11SP
9,Janssenlei 17,2020-11-09,22:00:00,24,4,20,F11SP
9,Janssenlei 17,2020-11-09,23:00:00,8,6,2,F11SP
9,Janssenlei 17,2020-11-10,00:00:00,0,0,0,F11SP
9,Janssenlei 17,2020-11-10,01:00:00,0,0,0,F11SP
9,Janssenlei 17,2020-11-10,02:00:00,0,0,0,F11SP
9,Janssenlei 17,2020-11-10,03:00:00,0,0,0,F11SP
9,Janssenlei 17,2020-11-10,04:00:00,8,6,2,F11SP
9,Janssenlei 17,2020-11-10,05:00:00,20,16,4,F11SP
9,Janssenlei 17,2020-11-10,06:00:00,68,48,20,F11SP
9,Janssenlei 17,2020-11-10,07:00:00,124,74,50,F11SP
9,Janssenlei 17,2020-11-10,08:00:00,118,82,36,F11SP
9,Janssenlei 17,2020-11-10,09:00:00,86,38,48,F11SP
9,Janssenlei 17,2020-11-10,10:00:00,100,46,54,F11SP
9,Janssenlei 17,2020-11-10,11:00:00,112,66,46,F11SP
9,Janssenlei 17,2020-11-10,12:00:00,152,68,84,F11SP
9,Janssenlei 17,2020-11-10,13:00:00,232,92,140,F11SP
9,Janssenlei 17,2020-11-10,14:00:00,174,104,70,F11SP
9,Janssenlei 17,2020-11-10,15:00:00,118,68,50,F11SP
9,Janssenlei 17,2020-11-10,16:00:00,90,34,56,F11SP
9,Janssenlei 17,2020-11-10,17:00:00,116,24,92,F11SP
9,Janssenlei 17,2020-11-10,18:00:00,78,30,48,F11SP
9,Janssenlei 17,2020-11-10,19:00:00,30,14,16,F11SP
9,Janssenlei 17,2020-11-10,20:00:00,28,16,12,F11SP
9,Janssenlei 17,2020-11-10,21:00:00,16,10,6,F11SP
9,Janssenlei 17,2020-11-10,22:00:00,18,2,16,F11SP
9,Janssenlei 17,2020-11-10,23:00:00,6,4,2,F11SP
9,Janssenlei 17,2020-11-11,00:00:00,2,0,2,F11SP
9,Janssenlei 17,2020-11-11,01:00:00,0,0,0,F11SP
9,Janssenlei 17,2020-11-11,02:00:00,0,0,0,F11SP
9,Janssenlei 17,2020-11-11,03:00:00,0,0,0,F11SP
9,Janssenlei 17,2020-11-11,04:00:00,2,2,0,F11SP
9,Janssenlei 17,2020-11-11,05:00:00,6,6,0,F11SP
9,Janssenlei 17,2020-11-11,06:00:00,18,10,8,F11SP
9,Janssenlei 17,2020-11-11,07:00:00,14,4,10,F11SP
9,Janssenlei 17,2020-11-11,08:00:00,44,22,22,F11SP
9,Janssenlei 17,2020-11-11,09:00:00,166,54,112,F11SP
9,Janssenlei 17,2020-11-11,10:00:00,224,102,122,F11SP
9,Janssenlei 17,2020-11-11,11:00:00,304,114,190,F11SP
9,Janssenlei 17,2020-11-11,12:00:00,308,128,180,F11SP
9,Janssenlei 17,2020-11-11,13:00:00,292,122,170,F11SP
9,Janssenlei 17,2020-11-11,14:00:00,400,172,228,F11SP
9,Janssenlei 17,2020-11-11,15:00:00,376,202,174,F11SP
9,Janssenlei 17,2020-11-11,16:00:00,324,198,126,F11SP
9,Janssenlei 17,2020-11-11,17:00:00,166,96,70,F11SP
9,Janssenlei 17,2020-11-11,18:00:00,66,34,32,F11SP
9,Janssenlei 17,2020-11-11,19:00:00,38,10,28,F11SP
9,Janssenlei 17,2020-11-11,20:00:00,24,18,6,F11SP
9,Janssenlei 17,2020-11-11,21:00:00,12,6,6,F11SP
9,Janssenlei 17,2020-11-11,22:00:00,10,2,8,F11SP
9,Janssenlei 17,2020-11-11,23:00:00,10,4,6,F11SP
9,Janssenlei 17,2020-11-12,00:00:00,0,0,0,F11SP
9,Janssenlei 17,2020-11-12,01:00:00,0,0,0,F11SP
9,Janssenlei 17,2020-11-12,02:00:00,0,0,0,F11SP
9,Janssenlei 17,2020-11-12,03:00:00,2,2,0,F11SP
9,Janssenlei 17,2020-11-12,04:00:00,6,4,2,F11SP
9,Janssenlei 17,2020-11-12,05:00:00,12,10,2,F11SP
9,Janssenlei 17,2020-11-12,06:00:00,52,32,20,F11SP
9,Janssenlei 17,2020-11-12,07:00:00,134,86,48,F11SP
9,Janssenlei 17,2020-11-12,08:00:00,118,58,60,F11SP
9,Janssenlei 17,2020-11-12,09:00:00,104,56,48,F11SP
9,Janssenlei 17,2020-11-12,10:00:00,132,46,86,F11SP
9,Janssenlei 17,2020-11-12,11:00:00,146,70,76,F11SP
9,Janssenlei 17,2020-11-12,12:00:00,110,56,54,F11SP
9,Janssenlei 17,2020-11-12,13:00:00,192,72,120,F11SP
9,Janssenlei 17,2020-11-12,14:00:00,164,86,78,F11SP
9,Janssenlei 17,2020-11-12,15:00:00,216,114,102,F11SP
9,Janssenlei 17,2020-11-12,16:00:00,182,68,114,F11SP
9,Janssenlei 17,2020-11-12,17:00:00,154,74,80,F11SP
9,Janssenlei 17,2020-11-12,18:00:00,76,28,48,F11SP
9,Janssenlei 17,2020-11-12,19:00:00,44,18,26,F11SP
9,Janssenlei 17,2020-11-12,20:00:00,30,10,20,F11SP
9,Janssenlei 17,2020-11-12,21:00:00,28,26,2,F11SP
9,Janssenlei 17,2020-11-12,22:00:00,28,6,22,F11SP
9,Janssenlei 17,2020-11-12,23:00:00,10,2,8,F11SP
9,Janssenlei 17,2020-11-13,00:00:00,2,0,2,F11SP
9,Janssenlei 17,2020-11-13,01:00:00,0,0,0,F11SP
9,Janssenlei 17,2020-11-13,02:00:00,0,0,0,F11SP
9,Janssenlei 17,2020-11-13,03:00:00,2,2,0,F11SP
9,Janssenlei 17,2020-11-13,04:00:00,2,2,0,F11SP
9,Janssenlei 17,2020-11-13,05:00:00,14,8,6,F11SP
9,Janssenlei 17,2020-11-13,06:00:00,40,36,4,F11SP
9,Janssenlei 17,2020-11-13,07:00:00,108,66,42,F11SP
9,Janssenlei 17,2020-11-13,08:00:00,134,72,62,F11SP
9,Janssenlei 17,2020-11-13,09:00:00,124,60,64,F11SP
9,Janssenlei 17,2020-11-13,10:00:00,196,94,102,F11SP
9,Janssenlei 17,2020-11-13,11:00:00,154,62,92,F11SP
9,Janssenlei 17,2020-11-13,12:00:00,92,68,24,F11SP
9,Janssenlei 17,2020-11-13,13:00:00,130,56,74,F11SP
9,Janssenlei 17,2020-11-13,14:00:00,118,52,66,F11SP
9,Janssenlei 17,2020-11-13,15:00:00,188,80,108,F11SP
9,Janssenlei 17,2020-11-13,16:00:00,192,110,82,F11SP
9,Janssenlei 17,2020-11-13,17:00:00,106,40,66,F11SP
9,Janssenlei 17,2020-11-13,18:00:00,70,24,46,F11SP
9,Janssenlei 17,2020-11-13,19:00:00,42,22,20,F11SP
9,Janssenlei 17,2020-11-13,20:00:00,14,6,8,F11SP
9,Janssenlei 17,2020-11-13,21:00:00,20,6,14,F11SP
9,Janssenlei 17,2020-11-13,22:00:00,4,2,2,F11SP
9,Janssenlei 17,2020-11-13,23:00:00,26,12,14,F11SP
9,Janssenlei 17,2020-11-14,00:00:00,8,8,0,F11SP
9,Janssenlei 17,2020-11-14,01:00:00,0,0,0,F11SP
9,Janssenlei 17,2020-11-14,02:00:00,4,4,0,F11SP
9,Janssenlei 17,2020-11-14,03:00:00,0,0,0,F11SP
9,Janssenlei 17,2020-11-14,04:00:00,0,0,0,F11SP
9,Janssenlei 17,2020-11-14,05:00:00,10,6,4,F11SP
9,Janssenlei 17,2020-11-14,06:00:00,16,10,6,F11SP
9,Janssenlei 17,2020-11-14,07:00:00,28,14,14,F11SP
9,Janssenlei 17,2020-11-14,08:00:00,64,22,42,F11SP
9,Janssenlei 17,2020-11-14,09:00:00,168,68,100,F11SP
9,Janssenlei 17,2020-11-14,10:00:00,266,112,154,F11SP
9,Janssenlei 17,2020-11-14,11:00:00,266,128,138,F11SP
9,Janssenlei 17,2020-11-14,12:00:00,344,170,174,F11SP
9,Janssenlei 17,2020-11-14,13:00:00,334,112,222,F11SP
9,Janssenlei 17,2020-11-14,14:00:00,528,268,260,F11SP
9,Janssenlei 17,2020-11-14,15:00:00,542,288,254,F11SP
9,Janssenlei 17,2020-11-14,16:00:00,344,234,110,F11SP
9,Janssenlei 17,2020-11-14,17:00:00,158,96,62,F11SP
9,Janssenlei 17,2020-11-14,18:00:00,76,42,34,F11SP
9,Janssenlei 17,2020-11-14,19:00:00,30,18,12,F11SP
9,Janssenlei 17,2020-11-14,20:00:00,58,26,32,F11SP
9,Janssenlei 17,2020-11-14,21:00:00,30,20,10,F11SP
9,Janssenlei 17,2020-11-14,22:00:00,12,2,10,F11SP
9,Janssenlei 17,2020-11-14,23:00:00,26,12,14,F11SP
9,Janssenlei 17,2020-11-15,00:00:00,2,2,0,F11SP
9,Janssenlei 17,2020-11-15,01:00:00,2,0,2,F11SP
9,Janssenlei 17,2020-11-15,02:00:00,0,0,0,F11SP
9,Janssenlei 17,2020-11-15,03:00:00,0,0,0,F11SP
9,Janssenlei 17,2020-11-15,04:00:00,0,0,0,F11SP
9,Janssenlei 17,2020-11-15,05:00:00,2,2,0,F11SP
9,Janssenlei 17,2020-11-15,06:00:00,14,6,8,F11SP
9,Janssenlei 17,2020-11-15,07:00:00,18,8,10,F11SP
9,Janssenlei 17,2020-11-15,08:00:00,70,18,52,F11SP
9,Janssenlei 17,2020-11-15,09:00:00,218,80,138,F11SP
9,Janssenlei 17,2020-11-15,10:00:00,290,120,170,F11SP
9,Janssenlei 17,2020-11-15,11:00:00,292,172,120,F11SP
9,Janssenlei 17,2020-11-15,12:00:00,154,102,52,F11SP
9,Janssenlei 17,2020-11-15,13:00:00,34,18,16,F11SP
9,Janssenlei 17,2020-11-15,14:00:00,36,22,14,F11SP
9,Janssenlei 17,2020-11-15,15:00:00,38,18,20,F11SP
9,Janssenlei 17,2020-11-15,16:00:00,34,26,8,F11SP
9,Janssenlei 17,2020-11-15,17:00:00,20,12,8,F11SP
9,Janssenlei 17,2020-11-15,18:00:00,14,4,10,F11SP
9,Janssenlei 17,2020-11-15,19:00:00,10,4,6,F11SP
9,Janssenlei 17,2020-11-15,20:00:00,18,12,6,F11SP
9,Janssenlei 17,2020-11-15,21:00:00,14,6,8,F11SP
9,Janssenlei 17,2020-11-15,22:00:00,10,0,10,F11SP
9,Janssenlei 17,2020-11-15,23:00:00,6,2,4,F11SP
9,Janssenlei 17,2020-11-16,00:00:00,2,2,0,F11SP
9,Janssenlei 17,2020-11-16,01:00:00,0,0,0,F11SP
9,Janssenlei 17,2020-11-16,02:00:00,0,0,0,F11SP
9,Janssenlei 17,2020-11-16,03:00:00,2,2,0,F11SP
9,Janssenlei 17,2020-11-16,04:00:00,4,4,0,F11SP
9,Janssenlei 17,2020-11-16,05:00:00,20,14,6,F11SP
9,Janssenlei 17,2020-11-16,06:00:00,62,50,12,F11SP
9,Janssenlei 17,2020-11-16,07:00:00,306,202,104,F11SP
9,Janssenlei 17,2020-11-16,08:00:00,274,180,94,F11SP
9,Janssenlei 17,2020-11-16,09:00:00,78,38,40,F11SP
9,Janssenlei 17,2020-11-16,10:00:00,100,46,54,F11SP
9,Janssenlei 17,2020-11-16,11:00:00,100,42,58,F11SP
9,Janssenlei 17,2020-11-16,12:00:00,112,54,58,F11SP
9,Janssenlei 17,2020-11-16,13:00:00,124,66,58,F11SP
9,Janssenlei 17,2020-11-16,14:00:00,156,70,86,F11SP
9,Janssenlei 17,2020-11-16,15:00:00,168,58,110,F11SP
9,Janssenlei 17,2020-11-16,16:00:00,280,102,178,F11SP
9,Janssenlei 17,2020-11-16,17:00:00,198,70,128,F11SP
9,Janssenlei 17,2020-11-16,18:00:00,80,30,50,F11SP
9,Janssenlei 17,2020-11-16,19:00:00,46,20,26,F11SP
9,Janssenlei 17,2020-11-16,20:00:00,28,14,14,F11SP
9,Janssenlei 17,2020-11-16,21:00:00,28,12,16,F11SP
9,Janssenlei 17,2020-11-16,22:00:00,42,4,38,F11SP
9,Janssenlei 17,2020-11-16,23:00:00,12,6,6,F11SP
9,Janssenlei 17,2020-11-17,00:00:00,0,0,0,F11SP
9,Janssenlei 17,2020-11-17,01:00:00,0,0,0,F11SP
9,Janssenlei 17,2020-11-17,02:00:00,0,0,0,F11SP
9,Janssenlei 17,2020-11-17,03:00:00,0,0,0,F11SP
9,Janssenlei 17,2020-11-17,04:00:00,6,6,0,F11SP
9,Janssenlei 17,2020-11-17,05:00:00,30,22,8,F11SP
9,Janssenlei 17,2020-11-17,06:00:00,80,58,22,F11SP
9,Janssenlei 17,2020-11-17,07:00:00,306,198,108,F11SP
9,Janssenlei 17,2020-11-17,08:00:00,312,206,106,F11SP
9,Janssenlei 17,2020-11-17,09:00:00,80,28,52,F11SP
9,Janssenlei 17,2020-11-17,10:00:00,92,46,46,F11SP
9,Janssenlei 17,2020-11-17,11:00:00,100,64,36,F11SP
9,Janssenlei 17,2020-11-17,12:00:00,152,76,76,F11SP
9,Janssenlei 17,2020-11-17,13:00:00,150,80,70,F11SP
9,Janssenlei 17,2020-11-17,14:00:00,188,92,96,F11SP
9,Janssenlei 17,2020-11-17,15:00:00,214,98,116,F11SP
9,Janssenlei 17,2020-11-17,16:00:00,366,146,220,F11SP
9,Janssenlei 17,2020-11-17,17:00:00,214,64,150,F11SP
9,Janssenlei 17,2020-11-17,18:00:00,106,42,64,F11SP
9,Janssenlei 17,2020-11-17,19:00:00,74,46,28,F11SP
9,Janssenlei 17,2020-11-17,20:00:00,30,22,8,F11SP
9,Janssenlei 17,2020-11-17,21:00:00,24,10,14,F11SP
9,Janssenlei 17,2020-11-17,22:00:00,48,6,42,F11SP
9,Janssenlei 17,2020-11-17,23:00:00,8,4,4,F11SP
9,Janssenlei 17,2020-11-18,00:00:00,0,0,0,F11SP
9,Janssenlei 17,2020-11-18,01:00:00,0,0,0,F11SP
9,Janssenlei 17,2020-11-18,02:00:00,0,0,0,F11SP
9,Janssenlei 17,2020-11-18,03:00:00,0,0,0,F11SP
9,Janssenlei 17,2020-11-18,04:00:00,6,4,2,F11SP
9,Janssenlei 17,2020-11-18,05:00:00,40,26,14,F11SP
9,Janssenlei 17,2020-11-18,06:00:00,92,62,30,F11SP
9,Janssenlei 17,2020-11-18,07:00:00,320,204,116,F11SP
9,Janssenlei 17,2020-11-18,08:00:00,312,214,98,F11SP
9,Janssenlei 17,2020-11-18,09:00:00,144,80,64,F11SP
9,Janssenlei 17,2020-11-18,10:00:00,188,76,112,F11SP
9,Janssenlei 17,2020-11-18,11:00:00,290,150,140,F11SP
9,Janssenlei 17,2020-11-18,12:00:00,366,126,240,F11SP
9,Janssenlei 17,2020-11-18,13:00:00,436,164,272,F11SP
9,Janssenlei 17,2020-11-18,14:00:00,472,210,262,F11SP
9,Janssenlei 17,2020-11-18,15:00:00,458,260,198,F11SP
9,Janssenlei 17,2020-11-18,16:00:00,444,224,220,F11SP
9,Janssenlei 17,2020-11-18,17:00:00,224,128,96,F11SP
9,Janssenlei 17,2020-11-18,18:00:00,98,32,66,F11SP
9,Janssenlei 17,2020-11-18,19:00:00,86,40,46,F11SP
9,Janssenlei 17,2020-11-18,20:00:00,52,24,28,F11SP
9,Janssenlei 17,2020-11-18,21:00:00,22,16,6,F11SP
9,Janssenlei 17,2020-11-18,22:00:00,38,2,36,F11SP
9,Janssenlei 17,2020-11-18,23:00:00,2,2,0,F11SP
9,Janssenlei 17,2020-11-19,00:00:00,6,0,6,F11SP
9,Janssenlei 17,2020-11-19,01:00:00,0,0,0,F11SP
9,Janssenlei 17,2020-11-19,02:00:00,0,0,0,F11SP
9,Janssenlei 17,2020-11-19,03:00:00,0,0,0,F11SP
9,Janssenlei 17,2020-11-19,04:00:00,10,10,0,F11SP
9,Janssenlei 17,2020-11-19,05:00:00,36,22,14,F11SP
9,Janssenlei 17,2020-11-19,06:00:00,72,44,28,F11SP
9,Janssenlei 17,2020-11-19,07:00:00,268,176,92,F11SP
9,Janssenlei 17,2020-11-19,08:00:00,254,184,70,F11SP
9,Janssenlei 17,2020-11-19,09:00:00,72,32,40,F11SP
9,Janssenlei 17,2020-11-19,10:00:00,88,46,42,F11SP
9,Janssenlei 17,2020-11-19,11:00:00,56,30,26,F11SP
9,Janssenlei 17,2020-11-19,12:00:00,50,14,36,F11SP
9,Janssenlei 17,2020-11-19,13:00:00,80,48,32,F11SP
9,Janssenlei 17,2020-11-19,14:00:00,98,42,56,F11SP
9,Janssenlei 17,2020-11-19,15:00:00,142,62,80,F11SP
9,Janssenlei 17,2020-11-19,16:00:00,294,92,202,F11SP
9,Janssenlei 17,2020-11-19,17:00:00,184,72,112,F11SP
9,Janssenlei 17,2020-11-19,18:00:00,74,18,56,F11SP
9,Janssenlei 17,2020-11-19,19:00:00,46,24,22,F11SP
9,Janssenlei 17,2020-11-19,20:00:00,42,14,28,F11SP
9,Janssenlei 17,2020-11-19,21:00:00,12,10,2,F11SP
9,Janssenlei 17,2020-11-19,22:00:00,24,4,20,F11SP
9,Janssenlei 17,2020-11-19,23:00:00,6,2,4,F11SP
9,Janssenlei 17,2020-11-20,00:00:00,0,0,0,F11SP
9,Janssenlei 17,2020-11-20,01:00:00,0,0,0,F11SP
9,Janssenlei 17,2020-11-20,02:00:00,0,0,0,F11SP
9,Janssenlei 17,2020-11-20,03:00:00,0,0,0,F11SP
9,Janssenlei 17,2020-11-20,04:00:00,8,8,0,F11SP
9,Janssenlei 17,2020-11-20,05:00:00,22,16,6,F11SP
9,Janssenlei 17,2020-11-20,06:00:00,82,50,32,F11SP
9,Janssenlei 17,2020-11-20,07:00:00,246,148,98,F11SP
9,Janssenlei 17,2020-11-20,08:00:00,296,198,98,F11SP
9,Janssenlei 17,2020-11-20,09:00:00,110,56,54,F11SP
9,Janssenlei 17,2020-11-20,10:00:00,94,54,40,F11SP
9,Janssenlei 17,2020-11-20,11:00:00,162,80,82,F11SP
9,Janssenlei 17,2020-11-20,12:00:00,242,102,140,F11SP
9,Janssenlei 17,2020-11-20,13:00:00,312,152,160,F11SP
9,Janssenlei 17,2020-11-20,14:00:00,290,138,152,F11SP
9,Janssenlei 17,2020-11-20,15:00:00,348,170,178,F11SP
9,Janssenlei 17,2020-11-20,16:00:00,356,160,196,F11SP
9,Janssenlei 17,2020-11-20,17:00:00,158,56,102,F11SP
9,Janssenlei 17,2020-11-20,18:00:00,104,30,74,F11SP
9,Janssenlei 17,2020-11-20,19:00:00,52,20,32,F11SP
9,Janssenlei 17,2020-11-20,20:00:00,46,22,24,F11SP
9,Janssenlei 17,2020-11-20,21:00:00,12,8,4,F11SP
9,Janssenlei 17,2020-11-20,22:00:00,30,2,28,F11SP
9,Janssenlei 17,2020-11-20,23:00:00,18,6,12,F11SP
9,Janssenlei 17,2020-11-21,00:00:00,2,2,0,F11SP
9,Janssenlei 17,2020-11-21,01:00:00,6,6,0,F11SP
9,Janssenlei 17,2020-11-21,02:00:00,0,0,0,F11SP
9,Janssenlei 17,2020-11-21,03:00:00,0,0,0,F11SP
9,Janssenlei 17,2020-11-21,04:00:00,0,0,0,F11SP
9,Janssenlei 17,2020-11-21,05:00:00,16,12,4,F11SP
9,Janssenlei 17,2020-11-21,06:00:00,16,6,10,F11SP
9,Janssenlei 17,2020-11-21,07:00:00,30,16,14,F11SP
9,Janssenlei 17,2020-11-21,08:00:00,42,16,26,F11SP
9,Janssenlei 17,2020-11-21,09:00:00,126,44,82,F11SP
9,Janssenlei 17,2020-11-21,10:00:00,198,80,118,F11SP
9,Janssenlei 17,2020-11-21,11:00:00,244,124,120,F11SP
9,Janssenlei 17,2020-11-21,12:00:00,250,134,116,F11SP
9,Janssenlei 17,2020-11-21,13:00:00,270,110,160,F11SP
9,Janssenlei 17,2020-11-21,14:00:00,248,98,150,F11SP
9,Janssenlei 17,2020-11-21,15:00:00,232,136,96,F11SP
9,Janssenlei 17,2020-11-21,16:00:00,216,126,90,F11SP
9,Janssenlei 17,2020-11-21,17:00:00,104,56,48,F11SP
9,Janssenlei 17,2020-11-21,18:00:00,20,6,14,F11SP
9,Janssenlei 17,2020-11-21,19:00:00,44,24,20,F11SP
9,Janssenlei 17,2020-11-21,20:00:00,28,14,14,F11SP
9,Janssenlei 17,2020-11-21,21:00:00,14,12,2,F11SP
9,Janssenlei 17,2020-11-21,22:00:00,24,4,20,F11SP
9,Janssenlei 17,2020-11-21,23:00:00,4,4,0,F11SP
9,Janssenlei 17,2020-11-22,00:00:00,2,0,2,F11SP
9,Janssenlei 17,2020-11-22,01:00:00,0,0,0,F11SP
9,Janssenlei 17,2020-11-22,02:00:00,0,0,0,F11SP
9,Janssenlei 17,2020-11-22,03:00:00,0,0,0,F11SP
9,Janssenlei 17,2020-11-22,04:00:00,2,2,0,F11SP
9,Janssenlei 17,2020-11-22,05:00:00,2,2,0,F11SP
9,Janssenlei 17,2020-11-22,06:00:00,26,12,14,F11SP
9,Janssenlei 17,2020-11-22,07:00:00,26,14,12,F11SP
9,Janssenlei 17,2020-11-22,08:00:00,60,14,46,F11SP
9,Janssenlei 17,2020-11-22,09:00:00,158,52,106,F11SP
9,Janssenlei 17,2020-11-22,10:00:00,150,70,80,F11SP
9,Janssenlei 17,2020-11-22,11:00:00,166,90,76,F11SP
9,Janssenlei 17,2020-11-22,12:00:00,150,94,56,F11SP
9,Janssenlei 17,2020-11-22,13:00:00,46,30,16,F11SP
9,Janssenlei 17,2020-11-22,14:00:00,90,48,42,F11SP
9,Janssenlei 17,2020-11-22,15:00:00,54,36,18,F11SP
9,Janssenlei 17,2020-11-22,16:00:00,78,40,38,F11SP
9,Janssenlei 17,2020-11-22,17:00:00,52,20,32,F11SP
9,Janssenlei 17,2020-11-22,18:00:00,26,12,14,F11SP
9,Janssenlei 17,2020-11-22,19:00:00,12,8,4,F11SP
9,Janssenlei 17,2020-11-22,20:00:00,14,4,10,F11SP
9,Janssenlei 17,2020-11-22,21:00:00,10,8,2,F11SP
9,Janssenlei 17,2020-11-22,22:00:00,20,2,18,F11SP
9,Janssenlei 17,2020-11-22,23:00:00,4,0,4,F11SP
9,Janssenlei 17,2020-11-23,00:00:00,0,0,0,F11SP
9,Janssenlei 17,2020-11-23,01:00:00,0,0,0,F11SP
9,Janssenlei 17,2020-11-23,02:00:00,0,0,0,F11SP
9,Janssenlei 17,2020-11-23,03:00:00,0,0,0,F11SP
9,Janssenlei 17,2020-11-23,04:00:00,2,2,0,F11SP
9,Janssenlei 17,2020-11-23,05:00:00,24,18,6,F11SP
9,Janssenlei 17,2020-11-23,06:00:00,64,40,24,F11SP
9,Janssenlei 17,2020-11-23,07:00:00,312,198,114,F11SP
9,Janssenlei 17,2020-11-23,08:00:00,278,192,86,F11SP
9,Janssenlei 17,2020-11-23,09:00:00,94,42,52,F11SP
9,Janssenlei 17,2020-11-23,10:00:00,114,70,44,F11SP
9,Janssenlei 17,2020-11-23,11:00:00,190,90,100,F11SP
9,Janssenlei 17,2020-11-23,12:00:00,190,92,98,F11SP
9,Janssenlei 17,2020-11-23,13:00:00,242,110,132,F11SP
9,Janssenlei 17,2020-11-23,14:00:00,318,116,202,F11SP
9,Janssenlei 17,2020-11-23,15:00:00,348,170,178,F11SP
9,Janssenlei 17,2020-11-23,16:00:00,402,172,230,F11SP
9,Janssenlei 17,2020-11-23,17:00:00,232,86,146,F11SP
9,Janssenlei 17,2020-11-23,18:00:00,78,34,44,F11SP
9,Janssenlei 17,2020-11-23,19:00:00,42,12,30,F11SP
9,Janssenlei 17,2020-11-23,20:00:00,28,16,12,F11SP
9,Janssenlei 17,2020-11-23,21:00:00,24,8,16,F11SP
9,Janssenlei 17,2020-11-23,22:00:00,32,4,28,F11SP
9,Janssenlei 17,2020-11-23,23:00:00,14,6,8,F11SP
9,Janssenlei 17,2020-11-24,00:00:00,0,0,0,F11SP
9,Janssenlei 17,2020-11-24,01:00:00,0,0,0,F11SP
9,Janssenlei 17,2020-11-24,02:00:00,0,0,0,F11SP
9,Janssenlei 17,2020-11-24,03:00:00,0,0,0,F11SP
9,Janssenlei 17,2020-11-24,04:00:00,6,6,0,F11SP
9,Janssenlei 17,2020-11-24,05:00:00,34,28,6,F11SP
9,Janssenlei 17,2020-11-24,06:00:00,92,60,32,F11SP
9,Janssenlei 17,2020-11-24,07:00:00,308,190,118,F11SP
9,Janssenlei 17,2020-11-24,08:00:00,296,212,84,F11SP
9,Janssenlei 17,2020-11-24,09:00:00,102,52,50,F11SP
9,Janssenlei 17,2020-11-24,10:00:00,124,58,66,F11SP
9,Janssenlei 17,2020-11-24,11:00:00,150,60,90,F11SP
9,Janssenlei 17,2020-11-24,12:00:00,206,92,114,F11SP
9,Janssenlei 17,2020-11-24,13:00:00,242,102,140,F11SP
9,Janssenlei 17,2020-11-24,14:00:00,320,120,200,F11SP
9,Janssenlei 17,2020-11-24,15:00:00,402,206,196,F11SP
9,Janssenlei 17,2020-11-24,16:00:00,396,156,240,F11SP
9,Janssenlei 17,2020-11-24,17:00:00,224,82,142,F11SP
9,Janssenlei 17,2020-11-24,18:00:00,102,44,58,F11SP
9,Janssenlei 17,2020-11-24,19:00:00,44,12,32,F11SP
9,Janssenlei 17,2020-11-24,20:00:00,42,30,12,F11SP
9,Janssenlei 17,2020-11-24,21:00:00,20,6,14,F11SP
9,Janssenlei 17,2020-11-24,22:00:00,32,4,28,F11SP
9,Janssenlei 17,2020-11-24,23:00:00,14,6,8,F11SP
9,Janssenlei 17,2020-11-25,00:00:00,2,2,0,F11SP
9,Janssenlei 17,2020-11-25,01:00:00,0,0,0,F11SP
9,Janssenlei 17,2020-11-25,02:00:00,0,0,0,F11SP
9,Janssenlei 17,2020-11-25,03:00:00,2,2,0,F11SP
9,Janssenlei 17,2020-11-25,04:00:00,2,2,0,F11SP
9,Janssenlei 17,2020-11-25,05:00:00,28,16,12,F11SP
9,Janssenlei 17,2020-11-25,06:00:00,70,46,24,F11SP
9,Janssenlei 17,2020-11-25,07:00:00,314,204,110,F11SP
9,Janssenlei 17,2020-11-25,08:00:00,274,188,86,F11SP
9,Janssenlei 17,2020-11-25,09:00:00,100,54,46,F11SP
9,Janssenlei 17,2020-11-25,10:00:00,150,64,86,F11SP
9,Janssenlei 17,2020-11-25,11:00:00,204,96,108,F11SP
9,Janssenlei 17,2020-11-25,12:00:00,262,110,152,F11SP
9,Janssenlei 17,2020-11-25,13:00:00,280,126,154,F11SP
9,Janssenlei 17,2020-11-25,14:00:00,304,118,186,F11SP
9,Janssenlei 17,2020-11-25,15:00:00,280,150,130,F11SP
9,Janssenlei 17,2020-11-25,16:00:00,266,128,138,F11SP
9,Janssenlei 17,2020-11-25,17:00:00,194,76,118,F11SP
9,Janssenlei 17,2020-11-25,18:00:00,104,52,52,F11SP
9,Janssenlei 17,2020-11-25,19:00:00,50,20,30,F11SP
9,Janssenlei 17,2020-11-25,20:00:00,44,28,16,F11SP
9,Janssenlei 17,2020-11-25,21:00:00,34,14,20,F11SP
9,Janssenlei 17,2020-11-25,22:00:00,32,2,30,F11SP
9,Janssenlei 17,2020-11-25,23:00:00,22,10,12,F11SP
9,Janssenlei 17,2020-11-26,00:00:00,0,0,0,F11SP
9,Janssenlei 17,2020-11-26,01:00:00,2,0,2,F11SP
9,Janssenlei 17,2020-11-26,02:00:00,0,0,0,F11SP
9,Janssenlei 17,2020-11-26,03:00:00,2,2,0,F11SP
9,Janssenlei 17,2020-11-26,04:00:00,6,6,0,F11SP
9,Janssenlei 17,2020-11-26,05:00:00,26,16,10,F11SP
9,Janssenlei 17,2020-11-26,06:00:00,84,56,28,F11SP
9,Janssenlei 17,2020-11-26,07:00:00,310,184,126,F11SP
9,Janssenlei 17,2020-11-26,08:00:00,288,198,90,F11SP
9,Janssenlei 17,2020-11-26,09:00:00,116,64,52,F11SP
9,Janssenlei 17,2020-11-26,10:00:00,108,40,68,F11SP
9,Janssenlei 17,2020-11-26,11:00:00,86,46,40,F11SP
9,Janssenlei 17,2020-11-26,12:00:00,154,70,84,F11SP
9,Janssenlei 17,2020-11-26,13:00:00,228,116,112,F11SP
9,Janssenlei 17,2020-11-26,14:00:00,252,106,146,F11SP
9,Janssenlei 17,2020-11-26,15:00:00,304,124,180,F11SP
9,Janssenlei 17,2020-11-26,16:00:00,426,180,246,F11SP
9,Janssenlei 17,2020-11-26,17:00:00,192,70,122,F11SP
9,Janssenlei 17,2020-11-26,18:00:00,92,34,58,F11SP
9,Janssenlei 17,2020-11-26,19:00:00,60,26,34,F11SP
9,Janssenlei 17,2020-11-26,20:00:00,42,12,30,F11SP
9,Janssenlei 17,2020-11-26,21:00:00,30,16,14,F11SP
9,Janssenlei 17,2020-11-26,22:00:00,30,6,24,F11SP
9,Janssenlei 17,2020-11-26,23:00:00,8,2,6,F11SP
9,Janssenlei 17,2020-11-27,00:00:00,2,0,2,F11SP
9,Janssenlei 17,2020-11-27,01:00:00,0,0,0,F11SP
9,Janssenlei 17,2020-11-27,02:00:00,0,0,0,F11SP
9,Janssenlei 17,2020-11-27,03:00:00,0,0,0,F11SP
9,Janssenlei 17,2020-11-27,04:00:00,4,2,2,F11SP
9,Janssenlei 17,2020-11-27,05:00:00,28,22,6,F11SP
9,Janssenlei 17,2020-11-27,06:00:00,66,42,24,F11SP
9,Janssenlei 17,2020-11-27,07:00:00,250,132,118,F11SP
9,Janssenlei 17,2020-11-27,08:00:00,276,194,82,F11SP
9,Janssenlei 17,2020-11-27,09:00:00,130,68,62,F11SP
9,Janssenlei 17,2020-11-27,10:00:00,90,38,52,F11SP
9,Janssenlei 17,2020-11-27,11:00:00,134,74,60,F11SP
9,Janssenlei 17,2020-11-27,12:00:00,154,80,74,F11SP
9,Janssenlei 17,2020-11-27,13:00:00,176,80,96,F11SP
9,Janssenlei 17,2020-11-27,14:00:00,214,108,106,F11SP
9,Janssenlei 17,2020-11-27,15:00:00,262,100,162,F11SP
9,Janssenlei 17,2020-11-27,16:00:00,316,138,178,F11SP
9,Janssenlei 17,2020-11-27,17:00:00,160,62,98,F11SP
9,Janssenlei 17,2020-11-27,18:00:00,90,36,54,F11SP
9,Janssenlei 17,2020-11-27,19:00:00,58,26,32,F11SP
9,Janssenlei 17,2020-11-27,20:00:00,30,22,8,F11SP
9,Janssenlei 17,2020-11-27,21:00:00,28,10,18,F11SP
9,Janssenlei 17,2020-11-27,22:00:00,14,4,10,F11SP
9,Janssenlei 17,2020-11-27,23:00:00,24,12,12,F11SP
9,Janssenlei 17,2020-11-28,00:00:00,2,2,0,F11SP
9,Janssenlei 17,2020-11-28,01:00:00,0,0,0,F11SP
9,Janssenlei 17,2020-11-28,02:00:00,0,0,0,F11SP
9,Janssenlei 17,2020-11-28,03:00:00,0,0,0,F11SP
9,Janssenlei 17,2020-11-28,04:00:00,2,2,0,F11SP
9,Janssenlei 17,2020-11-28,05:00:00,14,4,10,F11SP
9,Janssenlei 17,2020-11-28,06:00:00,14,8,6,F11SP
9,Janssenlei 17,2020-11-28,07:00:00,30,10,20,F11SP
9,Janssenlei 17,2020-11-28,08:00:00,56,24,32,F11SP
9,Janssenlei 17,2020-11-28,09:00:00,108,46,62,F11SP
9,Janssenlei 17,2020-11-28,10:00:00,184,58,126,F11SP
9,Janssenlei 17,2020-11-28,11:00:00,232,92,140,F11SP
9,Janssenlei 17,2020-11-28,12:00:00,308,164,144,F11SP
9,Janssenlei 17,2020-11-28,13:00:00,348,148,200,F11SP
9,Janssenlei 17,2020-11-28,14:00:00,436,210,226,F11SP
9,Janssenlei 17,2020-11-28,15:00:00,478,260,218,F11SP
9,Janssenlei 17,2020-11-28,16:00:00,304,204,100,F11SP
9,Janssenlei 17,2020-11-28,17:00:00,140,78,62,F11SP
9,Janssenlei 17,2020-11-28,18:00:00,50,28,22,F11SP
9,Janssenlei 17,2020-11-28,19:00:00,26,6,20,F11SP
9,Janssenlei 17,2020-11-28,20:00:00,36,20,16,F11SP
9,Janssenlei 17,2020-11-28,21:00:00,6,4,2,F11SP
9,Janssenlei 17,2020-11-28,22:00:00,26,16,10,F11SP
9,Janssenlei 17,2020-11-28,23:00:00,22,6,16,F11SP
9,Janssenlei 17,2020-11-29,00:00:00,8,2,6,F11SP
9,Janssenlei 17,2020-11-29,01:00:00,0,0,0,F11SP
9,Janssenlei 17,2020-11-29,02:00:00,0,0,0,F11SP
9,Janssenlei 17,2020-11-29,03:00:00,0,0,0,F11SP
9,Janssenlei 17,2020-11-29,04:00:00,0,0,0,F11SP
9,Janssenlei 17,2020-11-29,05:00:00,4,4,0,F11SP
9,Janssenlei 17,2020-11-29,06:00:00,18,10,8,F11SP
9,Janssenlei 17,2020-11-29,07:00:00,30,14,16,F11SP
9,Janssenlei 17,2020-11-29,08:00:00,46,8,38,F11SP
9,Janssenlei 17,2020-11-29,09:00:00,174,60,114,F11SP
9,Janssenlei 17,2020-11-29,10:00:00,158,52,106,F11SP
9,Janssenlei 17,2020-11-29,11:00:00,236,138,98,F11SP
9,Janssenlei 17,2020-11-29,12:00:00,208,130,78,F11SP
9,Janssenlei 17,2020-11-29,13:00:00,188,98,90,F11SP
9,Janssenlei 17,2020-11-29,14:00:00,218,114,104,F11SP
9,Janssenlei 17,2020-11-29,15:00:00,178,82,96,F11SP
9,Janssenlei 17,2020-11-29,16:00:00,166,88,78,F11SP
9,Janssenlei 17,2020-11-29,17:00:00,76,40,36,F11SP
9,Janssenlei 17,2020-11-29,18:00:00,20,10,10,F11SP
9,Janssenlei 17,2020-11-29,19:00:00,14,6,8,F11SP
9,Janssenlei 17,2020-11-29,20:00:00,18,14,4,F11SP
9,Janssenlei 17,2020-11-29,21:00:00,26,14,12,F11SP
9,Janssenlei 17,2020-11-29,22:00:00,10,2,8,F11SP
9,Janssenlei 17,2020-11-29,23:00:00,0,0,0,F11SP
9,Janssenlei 17,2020-11-30,00:00:00,0,0,0,F11SP
9,Janssenlei 17,2020-11-30,01:00:00,0,0,0,F11SP
9,Janssenlei 17,2020-11-30,02:00:00,0,0,0,F11SP
9,Janssenlei 17,2020-11-30,03:00:00,4,2,2,F11SP
9,Janssenlei 17,2020-11-30,04:00:00,6,4,2,F11SP
9,Janssenlei 17,2020-11-30,05:00:00,14,6,8,F11SP
9,Janssenlei 17,2020-11-30,06:00:00,60,40,20,F11SP
9,Janssenlei 17,2020-11-30,07:00:00,220,140,80,F11SP
9,Janssenlei 17,2020-11-30,08:00:00,220,156,64,F11SP
9,Janssenlei 17,2020-11-30,09:00:00,78,42,36,F11SP
9,Janssenlei 17,2020-11-30,10:00:00,52,34,18,F11SP
9,Janssenlei 17,2020-11-30,11:00:00,54,22,32,F11SP
9,Janssenlei 17,2020-11-30,12:00:00,116,52,64,F11SP
9,Janssenlei 17,2020-11-30,13:00:00,106,64,42,F11SP
9,Janssenlei 17,2020-11-30,14:00:00,112,46,66,F11SP
9,Janssenlei 17,2020-11-30,15:00:00,160,56,104,F11SP
9,Janssenlei 17,2020-11-30,16:00:00,226,80,146,F11SP
9,Janssenlei 17,2020-11-30,17:00:00,92,26,66,F11SP
9,Janssenlei 17,2020-11-30,18:00:00,42,12,30,F11SP
9,Janssenlei 17,2020-11-30,19:00:00,24,4,20,F11SP
9,Janssenlei 17,2020-11-30,20:00:00,10,4,6,F11SP
9,Janssenlei 17,2020-11-30,21:00:00,18,10,8,F11SP
9,Janssenlei 17,2020-11-30,22:00:00,22,6,16,F11SP
9,Janssenlei 17,2020-11-30,23:00:00,2,0,2,F11SP
9,Janssenlei 17,2020-12-01,00:00:00,0,0,0,F11SP
9,Janssenlei 17,2020-12-01,01:00:00,0,0,0,F11SP
9,Janssenlei 17,2020-12-01,02:00:00,0,0,0,F11SP
9,Janssenlei 17,2020-12-01,03:00:00,2,2,0,F11SP
9,Janssenlei 17,2020-12-01,04:00:00,4,4,0,F11SP
9,Janssenlei 17,2020-12-01,05:00:00,24,20,4,F11SP
9,Janssenlei 17,2020-12-01,06:00:00,52,34,18,F11SP
9,Janssenlei 17,2020-12-01,07:00:00,180,110,70,F11SP
9,Janssenlei 17,2020-12-01,08:00:00,270,194,76,F11SP
9,Janssenlei 17,2020-12-01,09:00:00,52,28,24,F11SP
9,Janssenlei 17,2020-12-01,10:00:00,56,22,34,F11SP
9,Janssenlei 17,2020-12-01,11:00:00,48,32,16,F11SP
9,Janssenlei 17,2020-12-01,12:00:00,92,36,56,F11SP
9,Janssenlei 17,2020-12-01,13:00:00,122,70,52,F11SP
9,Janssenlei 17,2020-12-01,14:00:00,136,54,82,F11SP
9,Janssenlei 17,2020-12-01,15:00:00,186,62,124,F11SP
9,Janssenlei 17,2020-12-01,16:00:00,238,92,146,F11SP
9,Janssenlei 17,2020-12-01,17:00:00,144,50,94,F11SP
9,Janssenlei 17,2020-12-01,18:00:00,74,38,36,F11SP
9,Janssenlei 17,2020-12-01,19:00:00,46,16,30,F11SP
9,Janssenlei 17,2020-12-01,20:00:00,44,30,14,F11SP
9,Janssenlei 17,2020-12-01,21:00:00,40,20,20,F11SP
9,Janssenlei 17,2020-12-01,22:00:00,30,8,22,F11SP
9,Janssenlei 17,2020-12-01,23:00:00,6,4,2,F11SP
9,Janssenlei 17,2020-12-02,00:00:00,2,0,2,F11SP
9,Janssenlei 17,2020-12-02,01:00:00,0,0,0,F11SP
9,Janssenlei 17,2020-12-02,02:00:00,0,0,0,F11SP
9,Janssenlei 17,2020-12-02,03:00:00,0,0,0,F11SP
9,Janssenlei 17,2020-12-02,04:00:00,8,8,0,F11SP
9,Janssenlei 17,2020-12-02,05:00:00,18,12,6,F11SP
9,Janssenlei 17,2020-12-02,06:00:00,58,34,24,F11SP
9,Janssenlei 17,2020-12-02,07:00:00,288,172,116,F11SP
9,Janssenlei 17,2020-12-02,08:00:00,296,220,76,F11SP
9,Janssenlei 17,2020-12-02,09:00:00,110,56,54,F11SP
9,Janssenlei 17,2020-12-02,10:00:00,142,54,88,F11SP
9,Janssenlei 17,2020-12-02,11:00:00,180,78,102,F11SP
9,Janssenlei 17,2020-12-02,12:00:00,270,88,182,F11SP
9,Janssenlei 17,2020-12-02,13:00:00,192,82,110,F11SP
9,Janssenlei 17,2020-12-02,14:00:00,220,100,120,F11SP
9,Janssenlei 17,2020-12-02,15:00:00,206,102,104,F11SP
9,Janssenlei 17,2020-12-02,16:00:00,216,102,114,F11SP
9,Janssenlei 17,2020-12-02,17:00:00,152,42,110,F11SP
9,Janssenlei 17,2020-12-02,18:00:00,88,34,54,F11SP
9,Janssenlei 17,2020-12-02,19:00:00,62,22,40,F11SP
9,Janssenlei 17,2020-12-02,20:00:00,20,6,14,F11SP
9,Janssenlei 17,2020-12-02,21:00:00,34,22,12,F11SP
9,Janssenlei 17,2020-12-02,22:00:00,34,8,26,F11SP
9,Janssenlei 17,2020-12-02,23:00:00,10,8,2,F11SP
9,Janssenlei 17,2020-12-03,00:00:00,2,0,2,F11SP
9,Janssenlei 17,2020-12-03,01:00:00,0,0,0,F11SP
9,Janssenlei 17,2020-12-03,02:00:00,0,0,0,F11SP
9,Janssenlei 17,2020-12-03,03:00:00,0,0,0,F11SP
9,Janssenlei 17,2020-12-03,04:00:00,8,8,0,F11SP
9,Janssenlei 17,2020-12-03,05:00:00,20,12,8,F11SP
9,Janssenlei 17,2020-12-03,06:00:00,64,44,20,F11SP
9,Janssenlei 17,2020-12-03,07:00:00,200,124,76,F11SP
9,Janssenlei 17,2020-12-03,08:00:00,290,218,72,F11SP
9,Janssenlei 17,2020-12-03,09:00:00,70,34,36,F11SP
9,Janssenlei 17,2020-12-03,10:00:00,100,48,52,F11SP
9,Janssenlei 17,2020-12-03,11:00:00,70,48,22,F11SP
9,Janssenlei 17,2020-12-03,12:00:00,104,38,66,F11SP
9,Janssenlei 17,2020-12-03,13:00:00,66,30,36,F11SP
9,Janssenlei 17,2020-12-03,14:00:00,56,24,32,F11SP
9,Janssenlei 17,2020-12-03,15:00:00,136,58,78,F11SP
9,Janssenlei 17,2020-12-03,16:00:00,180,52,128,F11SP
9,Janssenlei 17,2020-12-03,17:00:00,128,50,78,F11SP
9,Janssenlei 17,2020-12-03,18:00:00,82,20,62,F11SP
9,Janssenlei 17,2020-12-03,19:00:00,30,16,14,F11SP
9,Janssenlei 17,2020-12-03,20:00:00,10,6,4,F11SP
9,Janssenlei 17,2020-12-03,21:00:00,12,10,2,F11SP
9,Janssenlei 17,2020-12-03,22:00:00,14,2,12,F11SP
9,Janssenlei 17,2020-12-03,23:00:00,2,0,2,F11SP
9,Janssenlei 17,2020-12-04,00:00:00,2,0,2,F11SP
9,Janssenlei 17,2020-12-04,01:00:00,0,0,0,F11SP
9,Janssenlei 17,2020-12-04,02:00:00,0,0,0,F11SP
9,Janssenlei 17,2020-12-04,03:00:00,0,0,0,F11SP
9,Janssenlei 17,2020-12-04,04:00:00,2,2,0,F11SP
9,Janssenlei 17,2020-12-04,05:00:00,18,10,8,F11SP
9,Janssenlei 17,2020-12-04,06:00:00,68,44,24,F11SP
9,Janssenlei 17,2020-12-04,07:00:00,172,104,68,F11SP
9,Janssenlei 17,2020-12-04,08:00:00,260,188,72,F11SP
9,Janssenlei 17,2020-12-04,09:00:00,76,40,36,F11SP
9,Janssenlei 17,2020-12-04,10:00:00,102,52,50,F11SP
9,Janssenlei 17,2020-12-04,11:00:00,98,52,46,F11SP
9,Janssenlei 17,2020-12-04,12:00:00,162,74,88,F11SP
9,Janssenlei 17,2020-12-04,13:00:00,106,40,66,F11SP
9,Janssenlei 17,2020-12-04,14:00:00,154,68,86,F11SP
9,Janssenlei 17,2020-12-04,15:00:00,220,94,126,F11SP
9,Janssenlei 17,2020-12-04,16:00:00,252,112,140,F11SP
9,Janssenlei 17,2020-12-04,17:00:00,142,50,92,F11SP
9,Janssenlei 17,2020-12-04,18:00:00,66,28,38,F11SP
9,Janssenlei 17,2020-12-04,19:00:00,60,18,42,F11SP
9,Janssenlei 17,2020-12-04,20:00:00,20,10,10,F11SP
9,Janssenlei 17,2020-12-04,21:00:00,28,14,14,F11SP
9,Janssenlei 17,2020-12-04,22:00:00,18,6,12,F11SP
9,Janssenlei 17,2020-12-04,23:00:00,26,12,14,F11SP
9,Janssenlei 17,2020-12-05,00:00:00,4,2,2,F11SP
9,Janssenlei 17,2020-12-05,01:00:00,0,0,0,F11SP
9,Janssenlei 17,2020-12-05,02:00:00,0,0,0,F11SP
9,Janssenlei 17,2020-12-05,03:00:00,0,0,0,F11SP
9,Janssenlei 17,2020-12-05,04:00:00,4,4,0,F11SP
9,Janssenlei 17,2020-12-05,05:00:00,8,6,2,F11SP
9,Janssenlei 17,2020-12-05,06:00:00,18,4,14,F11SP
9,Janssenlei 17,2020-12-05,07:00:00,30,12,18,F11SP
9,Janssenlei 17,2020-12-05,08:00:00,44,14,30,F11SP
9,Janssenlei 17,2020-12-05,09:00:00,136,50,86,F11SP
9,Janssenlei 17,2020-12-05,10:00:00,144,52,92,F11SP
9,Janssenlei 17,2020-12-05,11:00:00,200,94,106,F11SP
9,Janssenlei 17,2020-12-05,12:00:00,216,108,108,F11SP
9,Janssenlei 17,2020-12-05,13:00:00,226,106,120,F11SP
9,Janssenlei 17,2020-12-05,14:00:00,232,118,114,F11SP
9,Janssenlei 17,2020-12-05,15:00:00,212,124,88,F11SP
9,Janssenlei 17,2020-12-05,16:00:00,164,98,66,F11SP
9,Janssenlei 17,2020-12-05,17:00:00,58,32,26,F11SP
9,Janssenlei 17,2020-12-05,18:00:00,54,26,28,F11SP
9,Janssenlei 17,2020-12-05,19:00:00,28,10,18,F11SP
9,Janssenlei 17,2020-12-05,20:00:00,20,8,12,F11SP
9,Janssenlei 17,2020-12-05,21:00:00,16,12,4,F11SP
9,Janssenlei 17,2020-12-05,22:00:00,20,8,12,F11SP
9,Janssenlei 17,2020-12-05,23:00:00,22,4,18,F11SP
9,Janssenlei 17,2020-12-06,00:00:00,4,4,0,F11SP
9,Janssenlei 17,2020-12-06,01:00:00,0,0,0,F11SP
9,Janssenlei 17,2020-12-06,02:00:00,0,0,0,F11SP
9,Janssenlei 17,2020-12-06,03:00:00,0,0,0,F11SP
9,Janssenlei 17,2020-12-06,04:00:00,4,4,0,F11SP
9,Janssenlei 17,2020-12-06,05:00:00,2,2,0,F11SP
9,Janssenlei 17,2020-12-06,06:00:00,10,2,8,F11SP
9,Janssenlei 17,2020-12-06,07:00:00,16,6,10,F11SP
9,Janssenlei 17,2020-12-06,08:00:00,54,24,30,F11SP
9,Janssenlei 17,2020-12-06,09:00:00,112,16,96,F11SP
9,Janssenlei 17,2020-12-06,10:00:00,198,76,122,F11SP
9,Janssenlei 17,2020-12-06,11:00:00,158,90,68,F11SP
9,Janssenlei 17,2020-12-06,12:00:00,168,90,78,F11SP
9,Janssenlei 17,2020-12-06,13:00:00,152,72,80,F11SP
9,Janssenlei 17,2020-12-06,14:00:00,186,90,96,F11SP
9,Janssenlei 17,2020-12-06,15:00:00,172,104,68,F11SP
9,Janssenlei 17,2020-12-06,16:00:00,110,64,46,F11SP
9,Janssenlei 17,2020-12-06,17:00:00,60,24,36,F11SP
9,Janssenlei 17,2020-12-06,18:00:00,20,12,8,F11SP
9,Janssenlei 17,2020-12-06,19:00:00,16,10,6,F11SP
9,Janssenlei 17,2020-12-06,20:00:00,8,4,4,F11SP
9,Janssenlei 17,2020-12-06,21:00:00,14,8,6,F11SP
9,Janssenlei 17,2020-12-06,22:00:00,12,2,10,F11SP
9,Janssenlei 17,2020-12-06,23:00:00,2,2,0,F11SP
9,Janssenlei 17,2020-12-07,00:00:00,2,0,2,F11SP
9,Janssenlei 17,2020-12-07,01:00:00,0,0,0,F11SP
9,Janssenlei 17,2020-12-07,02:00:00,0,0,0,F11SP
9,Janssenlei 17,2020-12-07,03:00:00,0,0,0,F11SP
9,Janssenlei 17,2020-12-07,04:00:00,10,6,4,F11SP
9,Janssenlei 17,2020-12-07,05:00:00,12,6,6,F11SP
9,Janssenlei 17,2020-12-07,06:00:00,58,38,20,F11SP
9,Janssenlei 17,2020-12-07,07:00:00,190,120,70,F11SP
9,Janssenlei 17,2020-12-07,08:00:00,258,192,66,F11SP
9,Janssenlei 17,2020-12-07,09:00:00,76,36,40,F11SP
9,Janssenlei 17,2020-12-07,10:00:00,64,36,28,F11SP
9,Janssenlei 17,2020-12-07,11:00:00,86,40,46,F11SP
9,Janssenlei 17,2020-12-07,12:00:00,160,40,120,F11SP
9,Janssenlei 17,2020-12-07,13:00:00,72,50,22,F11SP
9,Janssenlei 17,2020-12-07,14:00:00,108,34,74,F11SP
9,Janssenlei 17,2020-12-07,15:00:00,118,50,68,F11SP
9,Janssenlei 17,2020-12-07,16:00:00,196,84,112,F11SP
9,Janssenlei 17,2020-12-07,17:00:00,138,54,84,F11SP
9,Janssenlei 17,2020-12-07,18:00:00,72,30,42,F11SP
9,Janssenlei 17,2020-12-07,19:00:00,42,16,26,F11SP
9,Janssenlei 17,2020-12-07,20:00:00,22,10,12,F11SP
9,Janssenlei 17,2020-12-07,21:00:00,20,14,6,F11SP
9,Janssenlei 17,2020-12-07,22:00:00,20,4,16,F11SP
9,Janssenlei 17,2020-12-07,23:00:00,2,0,2,F11SP
9,Janssenlei 17,2020-12-08,00:00:00,0,0,0,F11SP
9,Janssenlei 17,2020-12-08,01:00:00,0,0,0,F11SP
9,Janssenlei 17,2020-12-08,02:00:00,0,0,0,F11SP
9,Janssenlei 17,2020-12-08,03:00:00,0,0,0,F11SP
9,Janssenlei 17,2020-12-08,04:00:00,8,6,2,F11SP
9,Janssenlei 17,2020-12-08,05:00:00,24,18,6,F11SP
9,Janssenlei 17,2020-12-08,06:00:00,52,38,14,F11SP
9,Janssenlei 17,2020-12-08,07:00:00,280,166,114,F11SP
9,Janssenlei 17,2020-12-08,08:00:00,294,218,76,F11SP
9,Janssenlei 17,2020-12-08,09:00:00,104,52,52,F11SP
9,Janssenlei 17,2020-12-08,10:00:00,106,30,76,F11SP
9,Janssenlei 17,2020-12-08,11:00:00,94,56,38,F11SP
9,Janssenlei 17,2020-12-08,12:00:00,184,86,98,F11SP
9,Janssenlei 17,2020-12-08,13:00:00,186,86,100,F11SP
9,Janssenlei 17,2020-12-08,14:00:00,224,106,118,F11SP
9,Janssenlei 17,2020-12-08,15:00:00,228,100,128,F11SP
9,Janssenlei 17,2020-12-08,16:00:00,216,88,128,F11SP
9,Janssenlei 17,2020-12-08,17:00:00,164,60,104,F11SP
9,Janssenlei 17,2020-12-08,18:00:00,80,32,48,F11SP
9,Janssenlei 17,2020-12-08,19:00:00,44,16,28,F11SP
9,Janssenlei 17,2020-12-08,20:00:00,38,18,20,F11SP
9,Janssenlei 17,2020-12-08,21:00:00,28,14,14,F11SP
9,Janssenlei 17,2020-12-08,22:00:00,30,6,24,F11SP
9,Janssenlei 17,2020-12-08,23:00:00,8,4,4,F11SP
9,Janssenlei 17,2020-12-09,00:00:00,2,0,2,F11SP
9,Janssenlei 17,2020-12-09,01:00:00,0,0,0,F11SP
9,Janssenlei 17,2020-12-09,02:00:00,2,0,2,F11SP
9,Janssenlei 17,2020-12-09,03:00:00,0,0,0,F11SP
9,Janssenlei 17,2020-12-09,04:00:00,10,10,0,F11SP
9,Janssenlei 17,2020-12-09,05:00:00,34,22,12,F11SP
9,Janssenlei 17,2020-12-09,06:00:00,44,32,12,F11SP
9,Janssenlei 17,2020-12-09,07:00:00,270,158,112,F11SP
9,Janssenlei 17,2020-12-09,08:00:00,286,216,70,F11SP
9,Janssenlei 17,2020-12-09,09:00:00,108,64,44,F11SP
9,Janssenlei 17,2020-12-09,10:00:00,134,60,74,F11SP
9,Janssenlei 17,2020-12-09,11:00:00,128,56,72,F11SP
9,Janssenlei 17,2020-12-09,12:00:00,176,52,124,F11SP
9,Janssenlei 17,2020-12-09,13:00:00,156,68,88,F11SP
9,Janssenlei 17,2020-12-09,14:00:00,146,62,84,F11SP
9,Janssenlei 17,2020-12-09,15:00:00,156,64,92,F11SP
9,Janssenlei 17,2020-12-09,16:00:00,158,76,82,F11SP
9,Janssenlei 17,2020-12-09,17:00:00,150,74,76,F11SP
9,Janssenlei 17,2020-12-09,18:00:00,80,32,48,F11SP
9,Janssenlei 17,2020-12-09,19:00:00,32,12,20,F11SP
9,Janssenlei 17,2020-12-09,20:00:00,30,10,20,F11SP
9,Janssenlei 17,2020-12-09,21:00:00,20,12,8,F11SP
9,Janssenlei 17,2020-12-09,22:00:00,38,4,34,F11SP
9,Janssenlei 17,2020-12-09,23:00:00,12,4,8,F11SP
9,Janssenlei 17,2020-12-10,00:00:00,0,0,0,F11SP
9,Janssenlei 17,2020-12-10,01:00:00,0,0,0,F11SP
9,Janssenlei 17,2020-12-10,02:00:00,2,0,2,F11SP
9,Janssenlei 17,2020-12-10,03:00:00,2,2,0,F11SP
9,Janssenlei 17,2020-12-10,04:00:00,6,6,0,F11SP
9,Janssenlei 17,2020-12-10,05:00:00,20,10,10,F11SP
9,Janssenlei 17,2020-12-10,06:00:00,62,42,20,F11SP
9,Janssenlei 17,2020-12-10,07:00:00,282,174,108,F11SP
9,Janssenlei 17,2020-12-10,08:00:00,270,206,64,F11SP
9,Janssenlei 17,2020-12-10,09:00:00,98,54,44,F11SP
9,Janssenlei 17,2020-12-10,10:00:00,174,64,110,F11SP
9,Janssenlei 17,2020-12-10,11:00:00,120,48,72,F11SP
9,Janssenlei 17,2020-12-10,12:00:00,166,84,82,F11SP
9,Janssenlei 17,2020-12-10,13:00:00,172,82,90,F11SP
9,Janssenlei 17,2020-12-10,14:00:00,208,102,106,F11SP
9,Janssenlei 17,2020-12-10,15:00:00,288,144,144,F11SP
9,Janssenlei 17,2020-12-10,16:00:00,220,82,138,F11SP
9,Janssenlei 17,2020-12-10,17:00:00,156,50,106,F11SP
9,Janssenlei 17,2020-12-10,18:00:00,90,40,50,F11SP
9,Janssenlei 17,2020-12-10,19:00:00,40,14,26,F11SP
9,Janssenlei 17,2020-12-10,20:00:00,36,20,16,F11SP
9,Janssenlei 17,2020-12-10,21:00:00,22,10,12,F11SP
9,Janssenlei 17,2020-12-10,22:00:00,24,6,18,F11SP
9,Janssenlei 17,2020-12-10,23:00:00,2,0,2,F11SP
9,Janssenlei 17,2020-12-11,00:00:00,0,0,0,F11SP
9,Janssenlei 17,2020-12-11,01:00:00,0,0,0,F11SP
9,Janssenlei 17,2020-12-11,02:00:00,2,0,2,F11SP
9,Janssenlei 17,2020-12-11,03:00:00,0,0,0,F11SP
9,Janssenlei 17,2020-12-11,04:00:00,8,8,0,F11SP
9,Janssenlei 17,2020-12-11,05:00:00,12,4,8,F11SP
9,Janssenlei 17,2020-12-11,06:00:00,52,34,18,F11SP
9,Janssenlei 17,2020-12-11,07:00:00,182,84,98,F11SP
9,Janssenlei 17,2020-12-11,08:00:00,226,178,48,F11SP
9,Janssenlei 17,2020-12-11,09:00:00,60,28,32,F11SP
9,Janssenlei 17,2020-12-11,10:00:00,102,48,54,F11SP
9,Janssenlei 17,2020-12-11,11:00:00,74,42,32,F11SP
9,Janssenlei 17,2020-12-11,12:00:00,88,30,58,F11SP
9,Janssenlei 17,2020-12-11,13:00:00,58,28,30,F11SP
9,Janssenlei 17,2020-12-11,14:00:00,82,36,46,F11SP
9,Janssenlei 17,2020-12-11,15:00:00,98,30,68,F11SP
9,Janssenlei 17,2020-12-11,16:00:00,100,42,58,F11SP
9,Janssenlei 17,2020-12-11,17:00:00,80,36,44,F11SP
9,Janssenlei 17,2020-12-11,18:00:00,60,18,42,F11SP
9,Janssenlei 17,2020-12-11,19:00:00,44,18,26,F11SP
9,Janssenlei 17,2020-12-11,20:00:00,18,4,14,F11SP
9,Janssenlei 17,2020-12-11,21:00:00,12,10,2,F11SP
9,Janssenlei 17,2020-12-11,22:00:00,14,6,8,F11SP
9,Janssenlei 17,2020-12-11,23:00:00,28,16,12,F11SP
9,Janssenlei 17,2020-12-12,00:00:00,6,2,4,F11SP
9,Janssenlei 17,2020-12-12,01:00:00,6,4,2,F11SP
9,Janssenlei 17,2020-12-12,02:00:00,0,0,0,F11SP
9,Janssenlei 17,2020-12-12,03:00:00,0,0,0,F11SP
9,Janssenlei 17,2020-12-12,04:00:00,6,6,0,F11SP
9,Janssenlei 17,2020-12-12,05:00:00,8,4,4,F11SP
9,Janssenlei 17,2020-12-12,06:00:00,4,4,0,F11SP
9,Janssenlei 17,2020-12-12,07:00:00,12,8,4,F11SP
9,Janssenlei 17,2020-12-12,08:00:00,26,14,12,F11SP
9,Janssenlei 17,2020-12-12,09:00:00,70,38,32,F11SP
9,Janssenlei 17,2020-12-12,10:00:00,84,30,54,F11SP
9,Janssenlei 17,2020-12-12,11:00:00,84,42,42,F11SP
9,Janssenlei 17,2020-12-12,12:00:00,108,64,44,F11SP
9,Janssenlei 17,2020-12-12,13:00:00,124,66,58,F11SP
9,Janssenlei 17,2020-12-12,14:00:00,168,70,98,F11SP
9,Janssenlei 17,2020-12-12,15:00:00,114,42,72,F11SP
9,Janssenlei 17,2020-12-12,16:00:00,88,34,54,F11SP
9,Janssenlei 17,2020-12-12,17:00:00,46,26,20,F11SP
9,Janssenlei 17,2020-12-12,18:00:00,24,4,20,F11SP
9,Janssenlei 17,2020-12-12,19:00:00,24,10,14,F11SP
9,Janssenlei 17,2020-12-12,20:00:00,10,4,6,F11SP
9,Janssenlei 17,2020-12-12,21:00:00,10,6,4,F11SP
9,Janssenlei 17,2020-12-12,22:00:00,10,0,10,F11SP
9,Janssenlei 17,2020-12-12,23:00:00,14,8,6,F11SP
9,Janssenlei 17,2020-12-13,00:00:00,2,0,2,F11SP
9,Janssenlei 17,2020-12-13,01:00:00,2,2,0,F11SP
9,Janssenlei 17,2020-12-13,02:00:00,0,0,0,F11SP
9,Janssenlei 17,2020-12-13,03:00:00,0,0,0,F11SP
9,Janssenlei 17,2020-12-13,04:00:00,2,2,0,F11SP
9,Janssenlei 17,2020-12-13,05:00:00,4,4,0,F11SP
9,Janssenlei 17,2020-12-13,06:00:00,14,10,4,F11SP
9,Janssenlei 17,2020-12-13,07:00:00,12,6,6,F11SP
9,Janssenlei 17,2020-12-13,08:00:00,60,24,36,F11SP
9,Janssenlei 17,2020-12-13,09:00:00,230,68,162,F11SP
9,Janssenlei 17,2020-12-13,10:00:00,376,138,238,F11SP
9,Janssenlei 17,2020-12-13,11:00:00,370,184,186,F11SP
9,Janssenlei 17,2020-12-13,12:00:00,342,204,138,F11SP
9,Janssenlei 17,2020-12-13,13:00:00,278,170,108,F11SP
9,Janssenlei 17,2020-12-13,14:00:00,344,128,216,F11SP
9,Janssenlei 17,2020-12-13,15:00:00,222,124,98,F11SP
9,Janssenlei 17,2020-12-13,16:00:00,142,88,54,F11SP
9,Janssenlei 17,2020-12-13,17:00:00,48,22,26,F11SP
9,Janssenlei 17,2020-12-13,18:00:00,40,28,12,F11SP
9,Janssenlei 17,2020-12-13,19:00:00,4,4,0,F11SP
9,Janssenlei 17,2020-12-13,20:00:00,12,8,4,F11SP
9,Janssenlei 17,2020-12-13,21:00:00,10,4,6,F11SP
9,Janssenlei 17,2020-12-13,22:00:00,8,4,4,F11SP
9,Janssenlei 17,2020-12-13,23:00:00,8,0,8,F11SP
9,Janssenlei 17,2020-12-14,00:00:00,0,0,0,F11SP
9,Janssenlei 17,2020-12-14,01:00:00,0,0,0,F11SP
9,Janssenlei 17,2020-12-14,02:00:00,2,0,2,F11SP
9,Janssenlei 17,2020-12-14,03:00:00,0,0,0,F11SP
9,Janssenlei 17,2020-12-14,04:00:00,2,2,0,F11SP
9,Janssenlei 17,2020-12-14,05:00:00,16,12,4,F11SP
9,Janssenlei 17,2020-12-14,06:00:00,50,38,12,F11SP
9,Janssenlei 17,2020-12-14,07:00:00,204,118,86,F11SP
9,Janssenlei 17,2020-12-14,08:00:00,246,192,54,F11SP
9,Janssenlei 17,2020-12-14,09:00:00,58,34,24,F11SP
9,Janssenlei 17,2020-12-14,10:00:00,160,62,98,F11SP
9,Janssenlei 17,2020-12-14,11:00:00,86,32,54,F11SP
9,Janssenlei 17,2020-12-14,12:00:00,144,64,80,F11SP
9,Janssenlei 17,2020-12-14,13:00:00,144,66,78,F11SP
9,Janssenlei 17,2020-12-14,14:00:00,202,82,120,F11SP
9,Janssenlei 17,2020-12-14,15:00:00,192,86,106,F11SP
9,Janssenlei 17,2020-12-14,16:00:00,206,94,112,F11SP
9,Janssenlei 17,2020-12-14,17:00:00,126,30,96,F11SP
9,Janssenlei 17,2020-12-14,18:00:00,54,20,34,F11SP
9,Janssenlei 17,2020-12-14,19:00:00,16,8,8,F11SP
9,Janssenlei 17,2020-12-14,20:00:00,20,8,12,F11SP
9,Janssenlei 17,2020-12-14,21:00:00,14,4,10,F11SP
9,Janssenlei 17,2020-12-14,22:00:00,20,4,16,F11SP
9,Janssenlei 17,2020-12-14,23:00:00,0,0,0,F11SP
9,Janssenlei 17,2020-12-15,00:00:00,0,0,0,F11SP
9,Janssenlei 17,2020-12-15,01:00:00,0,0,0,F11SP
9,Janssenlei 17,2020-12-15,02:00:00,0,0,0,F11SP
9,Janssenlei 17,2020-12-15,03:00:00,0,0,0,F11SP
9,Janssenlei 17,2020-12-15,04:00:00,6,6,0,F11SP
9,Janssenlei 17,2020-12-15,05:00:00,16,12,4,F11SP
9,Janssenlei 17,2020-12-15,06:00:00,56,38,18,F11SP
9,Janssenlei 17,2020-12-15,07:00:00,212,128,84,F11SP
9,Janssenlei 17,2020-12-15,08:00:00,286,208,78,F11SP
9,Janssenlei 17,2020-12-15,09:00:00,92,38,54,F11SP
9,Janssenlei 17,2020-12-15,10:00:00,128,30,98,F11SP
9,Janssenlei 17,2020-12-15,11:00:00,98,54,44,F11SP
9,Janssenlei 17,2020-12-15,12:00:00,96,60,36,F11SP
9,Janssenlei 17,2020-12-15,13:00:00,76,28,48,F11SP
9,Janssenlei 17,2020-12-15,14:00:00,88,34,54,F11SP
9,Janssenlei 17,2020-12-15,15:00:00,194,82,112,F11SP
9,Janssenlei 17,2020-12-15,16:00:00,184,62,122,F11SP
9,Janssenlei 17,2020-12-15,17:00:00,146,66,80,F11SP
9,Janssenlei 17,2020-12-15,18:00:00,88,40,48,F11SP
9,Janssenlei 17,2020-12-15,19:00:00,46,16,30,F11SP
9,Janssenlei 17,2020-12-15,20:00:00,36,26,10,F11SP
9,Janssenlei 17,2020-12-15,21:00:00,44,28,16,F11SP
9,Janssenlei 17,2020-12-15,22:00:00,28,2,26,F11SP
9,Janssenlei 17,2020-12-15,23:00:00,24,18,6,F11SP
9,Janssenlei 17,2020-12-16,00:00:00,6,0,6,F11SP
9,Janssenlei 17,2020-12-16,01:00:00,0,0,0,F11SP
9,Janssenlei 17,2020-12-16,02:00:00,0,0,0,F11SP
9,Janssenlei 17,2020-12-16,03:00:00,2,2,0,F11SP
9,Janssenlei 17,2020-12-16,04:00:00,8,6,2,F11SP
9,Janssenlei 17,2020-12-16,05:00:00,24,18,6,F11SP
9,Janssenlei 17,2020-12-16,06:00:00,66,44,22,F11SP
9,Janssenlei 17,2020-12-16,07:00:00,220,144,76,F11SP
9,Janssenlei 17,2020-12-16,08:00:00,242,154,88,F11SP
9,Janssenlei 17,2020-12-16,09:00:00,88,32,56,F11SP
9,Janssenlei 17,2020-12-16,10:00:00,176,92,84,F11SP
9,Janssenlei 17,2020-12-16,11:00:00,176,68,108,F11SP
9,Janssenlei 17,2020-12-16,12:00:00,224,90,134,F11SP
9,Janssenlei 17,2020-12-16,13:00:00,352,158,194,F11SP
9,Janssenlei 17,2020-12-16,14:00:00,312,140,172,F11SP
9,Janssenlei 17,2020-12-16,15:00:00,298,144,154,F11SP
9,Janssenlei 17,2020-12-16,16:00:00,216,108,108,F11SP
9,Janssenlei 17,2020-12-16,17:00:00,168,66,102,F11SP
9,Janssenlei 17,2020-12-16,18:00:00,114,32,82,F11SP
9,Janssenlei 17,2020-12-16,19:00:00,56,24,32,F11SP
9,Janssenlei 17,2020-12-16,20:00:00,32,16,16,F11SP
9,Janssenlei 17,2020-12-16,21:00:00,12,6,6,F11SP
9,Janssenlei 17,2020-12-16,22:00:00,32,10,22,F11SP
9,Janssenlei 17,2020-12-16,23:00:00,12,10,2,F11SP
9,Janssenlei 17,2020-12-17,00:00:00,2,0,2,F11SP
9,Janssenlei 17,2020-12-17,01:00:00,0,0,0,F11SP
9,Janssenlei 17,2020-12-17,02:00:00,0,0,0,F11SP
9,Janssenlei 17,2020-12-17,03:00:00,0,0,0,F11SP
9,Janssenlei 17,2020-12-17,04:00:00,4,4,0,F11SP
9,Janssenlei 17,2020-12-17,05:00:00,18,12,6,F11SP
9,Janssenlei 17,2020-12-17,06:00:00,46,28,18,F11SP
9,Janssenlei 17,2020-12-17,07:00:00,186,114,72,F11SP
9,Janssenlei 17,2020-12-17,08:00:00,216,156,60,F11SP
9,Janssenlei 17,2020-12-17,09:00:00,130,58,72,F11SP
9,Janssenlei 17,2020-12-17,10:00:00,98,48,50,F11SP
9,Janssenlei 17,2020-12-17,11:00:00,110,48,62,F11SP
9,Janssenlei 17,2020-12-17,12:00:00,132,72,60,F11SP
9,Janssenlei 17,2020-12-17,13:00:00,192,72,120,F11SP
9,Janssenlei 17,2020-12-17,14:00:00,186,84,102,F11SP
9,Janssenlei 17,2020-12-17,15:00:00,256,108,148,F11SP
9,Janssenlei 17,2020-12-17,16:00:00,234,104,130,F11SP
9,Janssenlei 17,2020-12-17,17:00:00,178,56,122,F11SP
9,Janssenlei 17,2020-12-17,18:00:00,96,42,54,F11SP
9,Janssenlei 17,2020-12-17,19:00:00,46,18,28,F11SP
9,Janssenlei 17,2020-12-17,20:00:00,38,14,24,F11SP
9,Janssenlei 17,2020-12-17,21:00:00,14,4,10,F11SP
9,Janssenlei 17,2020-12-17,22:00:00,32,10,22,F11SP
9,Janssenlei 17,2020-12-17,23:00:00,18,12,6,F11SP
9,Janssenlei 17,2020-12-18,00:00:00,0,0,0,F11SP
9,Janssenlei 17,2020-12-18,01:00:00,0,0,0,F11SP
9,Janssenlei 17,2020-12-18,02:00:00,0,0,0,F11SP
9,Janssenlei 17,2020-12-18,03:00:00,0,0,0,F11SP
9,Janssenlei 17,2020-12-18,04:00:00,0,0,0,F11SP
9,Janssenlei 17,2020-12-18,05:00:00,24,20,4,F11SP
9,Janssenlei 17,2020-12-18,06:00:00,70,42,28,F11SP
9,Janssenlei 17,2020-12-18,07:00:00,180,108,72,F11SP
9,Janssenlei 17,2020-12-18,08:00:00,254,186,68,F11SP
9,Janssenlei 17,2020-12-18,09:00:00,148,70,78,F11SP
9,Janssenlei 17,2020-12-18,10:00:00,204,66,138,F11SP
9,Janssenlei 17,2020-12-18,11:00:00,216,104,112,F11SP
9,Janssenlei 17,2020-12-18,12:00:00,242,122,120,F11SP
9,Janssenlei 17,2020-12-18,13:00:00,256,96,160,F11SP
9,Janssenlei 17,2020-12-18,14:00:00,368,168,200,F11SP
9,Janssenlei 17,2020-12-18,15:00:00,364,178,186,F11SP
9,Janssenlei 17,2020-12-18,16:00:00,216,126,90,F11SP
9,Janssenlei 17,2020-12-18,17:00:00,162,62,100,F11SP
9,Janssenlei 17,2020-12-18,18:00:00,80,48,32,F11SP
9,Janssenlei 17,2020-12-18,19:00:00,62,22,40,F11SP
9,Janssenlei 17,2020-12-18,20:00:00,58,24,34,F11SP
9,Janssenlei 17,2020-12-18,21:00:00,20,8,12,F11SP
9,Janssenlei 17,2020-12-18,22:00:00,44,12,32,F11SP
9,Janssenlei 17,2020-12-18,23:00:00,30,14,16,F11SP
9,Janssenlei 17,2020-12-19,00:00:00,4,2,2,F11SP
9,Janssenlei 17,2020-12-19,01:00:00,0,0,0,F11SP
9,Janssenlei 17,2020-12-19,02:00:00,0,0,0,F11SP
9,Janssenlei 17,2020-12-19,03:00:00,0,0,0,F11SP
9,Janssenlei 17,2020-12-19,04:00:00,2,2,0,F11SP
9,Janssenlei 17,2020-12-19,05:00:00,10,6,4,F11SP
9,Janssenlei 17,2020-12-19,06:00:00,8,2,6,F11SP
9,Janssenlei 17,2020-12-19,07:00:00,24,8,16,F11SP
9,Janssenlei 17,2020-12-19,08:00:00,40,14,26,F11SP
9,Janssenlei 17,2020-12-19,09:00:00,130,54,76,F11SP
9,Janssenlei 17,2020-12-19,10:00:00,152,64,88,F11SP
9,Janssenlei 17,2020-12-19,11:00:00,174,94,80,F11SP
9,Janssenlei 17,2020-12-19,12:00:00,154,96,58,F11SP
9,Janssenlei 17,2020-12-19,13:00:00,172,92,80,F11SP
9,Janssenlei 17,2020-12-19,14:00:00,102,52,50,F11SP
9,Janssenlei 17,2020-12-19,15:00:00,116,50,66,F11SP
9,Janssenlei 17,2020-12-19,16:00:00,132,70,62,F11SP
9,Janssenlei 17,2020-12-19,17:00:00,60,22,38,F11SP
9,Janssenlei 17,2020-12-19,18:00:00,46,26,20,F11SP
9,Janssenlei 17,2020-12-19,19:00:00,24,6,18,F11SP
9,Janssenlei 17,2020-12-19,20:00:00,38,26,12,F11SP
9,Janssenlei 17,2020-12-19,21:00:00,24,12,12,F11SP
9,Janssenlei 17,2020-12-19,22:00:00,14,2,12,F11SP
9,Janssenlei 17,2020-12-19,23:00:00,30,24,6,F11SP
9,Janssenlei 17,2020-12-20,00:00:00,4,2,2,F11SP
9,Janssenlei 17,2020-12-20,01:00:00,0,0,0,F11SP
9,Janssenlei 17,2020-12-20,02:00:00,0,0,0,F11SP
9,Janssenlei 17,2020-12-20,03:00:00,0,0,0,F11SP
9,Janssenlei 17,2020-12-20,04:00:00,2,0,2,F11SP
9,Janssenlei 17,2020-12-20,05:00:00,6,6,0,F11SP
9,Janssenlei 17,2020-12-20,06:00:00,18,10,8,F11SP
9,Janssenlei 17,2020-12-20,07:00:00,24,12,12,F11SP
9,Janssenlei 17,2020-12-20,08:00:00,66,30,36,F11SP
9,Janssenlei 17,2020-12-20,09:00:00,200,52,148,F11SP
9,Janssenlei 17,2020-12-20,10:00:00,274,84,190,F11SP
9,Janssenlei 17,2020-12-20,11:00:00,290,144,146,F11SP
9,Janssenlei 17,2020-12-20,12:00:00,262,164,98,F11SP
9,Janssenlei 17,2020-12-20,13:00:00,254,148,106,F11SP
9,Janssenlei 17,2020-12-20,14:00:00,296,132,164,F11SP
9,Janssenlei 17,2020-12-20,15:00:00,272,148,124,F11SP
9,Janssenlei 17,2020-12-20,16:00:00,152,88,64,F11SP
9,Janssenlei 17,2020-12-20,17:00:00,96,70,26,F11SP
9,Janssenlei 17,2020-12-20,18:00:00,44,16,28,F11SP
9,Janssenlei 17,2020-12-20,19:00:00,62,24,38,F11SP
9,Janssenlei 17,2020-12-20,20:00:00,18,12,6,F11SP
9,Janssenlei 17,2020-12-20,21:00:00,26,22,4,F11SP
9,Janssenlei 17,2020-12-20,22:00:00,12,0,12,F11SP
9,Janssenlei 17,2020-12-20,23:00:00,2,0,2,F11SP
9,Janssenlei 17,2020-12-21,00:00:00,2,0,2,F11SP
9,Janssenlei 17,2020-12-21,01:00:00,0,0,0,F11SP
9,Janssenlei 17,2020-12-21,02:00:00,0,0,0,F11SP
9,Janssenlei 17,2020-12-21,03:00:00,0,0,0,F11SP
9,Janssenlei 17,2020-12-21,04:00:00,6,4,2,F11SP
9,Janssenlei 17,2020-12-21,05:00:00,18,12,6,F11SP
9,Janssenlei 17,2020-12-21,06:00:00,26,14,12,F11SP
9,Janssenlei 17,2020-12-21,07:00:00,96,50,46,F11SP
9,Janssenlei 17,2020-12-21,08:00:00,100,58,42,F11SP
9,Janssenlei 17,2020-12-21,09:00:00,44,26,18,F11SP
9,Janssenlei 17,2020-12-21,10:00:00,50,32,18,F11SP
9,Janssenlei 17,2020-12-21,11:00:00,64,36,28,F11SP
9,Janssenlei 17,2020-12-21,12:00:00,50,22,28,F11SP
9,Janssenlei 17,2020-12-21,13:00:00,48,20,28,F11SP
9,Janssenlei 17,2020-12-21,14:00:00,54,22,32,F11SP
9,Janssenlei 17,2020-12-21,15:00:00,34,16,18,F11SP
9,Janssenlei 17,2020-12-21,16:00:00,72,28,44,F11SP
9,Janssenlei 17,2020-12-21,17:00:00,88,36,52,F11SP
9,Janssenlei 17,2020-12-21,18:00:00,44,26,18,F11SP
9,Janssenlei 17,2020-12-21,19:00:00,18,6,12,F11SP
9,Janssenlei 17,2020-12-21,20:00:00,30,4,26,F11SP
9,Janssenlei 17,2020-12-21,21:00:00,14,6,8,F11SP
9,Janssenlei 17,2020-12-21,22:00:00,22,6,16,F11SP
9,Janssenlei 17,2020-12-21,23:00:00,4,4,0,F11SP
9,Janssenlei 17,2020-12-22,00:00:00,4,0,4,F11SP
9,Janssenlei 17,2020-12-22,01:00:00,0,0,0,F11SP
9,Janssenlei 17,2020-12-22,02:00:00,0,0,0,F11SP
9,Janssenlei 17,2020-12-22,03:00:00,0,0,0,F11SP
9,Janssenlei 17,2020-12-22,04:00:00,2,2,0,F11SP
9,Janssenlei 17,2020-12-22,05:00:00,10,4,6,F11SP
9,Janssenlei 17,2020-12-22,06:00:00,16,10,6,F11SP
9,Janssenlei 17,2020-12-22,07:00:00,88,48,40,F11SP
9,Janssenlei 17,2020-12-22,08:00:00,56,34,22,F11SP
9,Janssenlei 17,2020-12-22,09:00:00,90,38,52,F11SP
9,Janssenlei 17,2020-12-22,10:00:00,88,40,48,F11SP
9,Janssenlei 17,2020-12-22,11:00:00,96,50,46,F11SP
9,Janssenlei 17,2020-12-22,12:00:00,150,76,74,F11SP
9,Janssenlei 17,2020-12-22,13:00:00,172,82,90,F11SP
9,Janssenlei 17,2020-12-22,14:00:00,168,84,84,F11SP
9,Janssenlei 17,2020-12-22,15:00:00,152,78,74,F11SP
9,Janssenlei 17,2020-12-22,16:00:00,120,60,60,F11SP
9,Janssenlei 17,2020-12-22,17:00:00,110,56,54,F11SP
9,Janssenlei 17,2020-12-22,18:00:00,44,18,26,F11SP
9,Janssenlei 17,2020-12-22,19:00:00,28,10,18,F11SP
9,Janssenlei 17,2020-12-22,20:00:00,32,8,24,F11SP
9,Janssenlei 17,2020-12-22,21:00:00,20,12,8,F11SP
9,Janssenlei 17,2020-12-22,22:00:00,18,6,12,F11SP
9,Janssenlei 17,2020-12-22,23:00:00,4,0,4,F11SP
9,Janssenlei 17,2020-12-23,00:00:00,4,2,2,F11SP
9,Janssenlei 17,2020-12-23,01:00:00,0,0,0,F11SP
9,Janssenlei 17,2020-12-23,02:00:00,0,0,0,F11SP
9,Janssenlei 17,2020-12-23,03:00:00,0,0,0,F11SP
9,Janssenlei 17,2020-12-23,04:00:00,10,8,2,F11SP
9,Janssenlei 17,2020-12-23,05:00:00,16,10,6,F11SP
9,Janssenlei 17,2020-12-23,06:00:00,22,12,10,F11SP
9,Janssenlei 17,2020-12-23,07:00:00,86,48,38,F11SP
9,Janssenlei 17,2020-12-23,08:00:00,74,40,34,F11SP
9,Janssenlei 17,2020-12-23,09:00:00,94,38,56,F11SP
9,Janssenlei 17,2020-12-23,10:00:00,42,26,16,F11SP
9,Janssenlei 17,2020-12-23,11:00:00,40,22,18,F11SP
9,Janssenlei 17,2020-12-23,12:00:00,34,16,18,F11SP
9,Janssenlei 17,2020-12-23,13:00:00,50,20,30,F11SP
9,Janssenlei 17,2020-12-23,14:00:00,82,30,52,F11SP
9,Janssenlei 17,2020-12-23,15:00:00,66,32,34,F11SP
9,Janssenlei 17,2020-12-23,16:00:00,92,54,38,F11SP
9,Janssenlei 17,2020-12-23,17:00:00,90,36,54,F11SP
9,Janssenlei 17,2020-12-23,18:00:00,40,18,22,F11SP
9,Janssenlei 17,2020-12-23,19:00:00,36,20,16,F11SP
9,Janssenlei 17,2020-12-23,20:00:00,18,6,12,F11SP
9,Janssenlei 17,2020-12-23,21:00:00,4,2,2,F11SP
9,Janssenlei 17,2020-12-23,22:00:00,14,6,8,F11SP
9,Janssenlei 17,2020-12-23,23:00:00,16,8,8,F11SP
9,Janssenlei 17,2020-12-24,00:00:00,4,0,4,F11SP
9,Janssenlei 17,2020-12-24,01:00:00,0,0,0,F11SP
9,Janssenlei 17,2020-12-24,02:00:00,0,0,0,F11SP
9,Janssenlei 17,2020-12-24,03:00:00,0,0,0,F11SP
9,Janssenlei 17,2020-12-24,04:00:00,4,4,0,F11SP
9,Janssenlei 17,2020-12-24,05:00:00,14,10,4,F11SP
9,Janssenlei 17,2020-12-24,06:00:00,14,8,6,F11SP
9,Janssenlei 17,2020-12-24,07:00:00,34,14,20,F11SP
9,Janssenlei 17,2020-12-24,08:00:00,50,18,32,F11SP
9,Janssenlei 17,2020-12-24,09:00:00,34,18,16,F11SP
9,Janssenlei 17,2020-12-24,10:00:00,92,40,52,F11SP
9,Janssenlei 17,2020-12-24,11:00:00,76,44,32,F11SP
9,Janssenlei 17,2020-12-24,12:00:00,60,24,36,F11SP
9,Janssenlei 17,2020-12-24,13:00:00,84,28,56,F11SP
9,Janssenlei 17,2020-12-24,14:00:00,128,56,72,F11SP
9,Janssenlei 17,2020-12-24,15:00:00,122,50,72,F11SP
9,Janssenlei 17,2020-12-24,16:00:00,84,44,40,F11SP
9,Janssenlei 17,2020-12-24,17:00:00,48,36,12,F11SP
9,Janssenlei 17,2020-12-24,18:00:00,14,2,12,F11SP
9,Janssenlei 17,2020-12-24,19:00:00,20,6,14,F11SP
9,Janssenlei 17,2020-12-24,20:00:00,8,4,4,F11SP
9,Janssenlei 17,2020-12-24,21:00:00,10,8,2,F11SP
9,Janssenlei 17,2020-12-24,22:00:00,8,6,2,F11SP
9,Janssenlei 17,2020-12-24,23:00:00,10,4,6,F11SP
9,Janssenlei 17,2020-12-25,00:00:00,8,2,6,F11SP
9,Janssenlei 17,2020-12-25,01:00:00,0,0,0,F11SP
9,Janssenlei 17,2020-12-25,02:00:00,2,0,2,F11SP
9,Janssenlei 17,2020-12-25,03:00:00,0,0,0,F11SP
9,Janssenlei 17,2020-12-25,04:00:00,0,0,0,F11SP
9,Janssenlei 17,2020-12-25,05:00:00,2,2,0,F11SP
9,Janssenlei 17,2020-12-25,06:00:00,6,4,2,F11SP
9,Janssenlei 17,2020-12-25,07:00:00,12,4,8,F11SP
9,Janssenlei 17,2020-12-25,08:00:00,24,12,12,F11SP
9,Janssenlei 17,2020-12-25,09:00:00,68,34,34,F11SP
9,Janssenlei 17,2020-12-25,10:00:00,148,58,90,F11SP
9,Janssenlei 17,2020-12-25,11:00:00,178,58,120,F11SP
9,Janssenlei 17,2020-12-25,12:00:00,222,118,104,F11SP
9,Janssenlei 17,2020-12-25,13:00:00,202,118,84,F11SP
9,Janssenlei 17,2020-12-25,14:00:00,238,128,110,F11SP
9,Janssenlei 17,2020-12-25,15:00:00,146,86,60,F11SP
9,Janssenlei 17,2020-12-25,16:00:00,140,72,68,F11SP
9,Janssenlei 17,2020-12-25,17:00:00,34,22,12,F11SP
9,Janssenlei 17,2020-12-25,18:00:00,18,4,14,F11SP
9,Janssenlei 17,2020-12-25,19:00:00,10,6,4,F11SP
9,Janssenlei 17,2020-12-25,20:00:00,42,20,22,F11SP
9,Janssenlei 17,2020-12-25,21:00:00,14,2,12,F11SP
9,Janssenlei 17,2020-12-25,22:00:00,12,6,6,F11SP
9,Janssenlei 17,2020-12-25,23:00:00,12,8,4,F11SP
9,Janssenlei 17,2020-12-26,00:00:00,4,2,2,F11SP
9,Janssenlei 17,2020-12-26,01:00:00,0,0,0,F11SP
9,Janssenlei 17,2020-12-26,02:00:00,0,0,0,F11SP
9,Janssenlei 17,2020-12-26,03:00:00,0,0,0,F11SP
9,Janssenlei 17,2020-12-26,04:00:00,2,2,0,F11SP
9,Janssenlei 17,2020-12-26,05:00:00,4,4,0,F11SP
9,Janssenlei 17,2020-12-26,06:00:00,6,4,2,F11SP
9,Janssenlei 17,2020-12-26,07:00:00,22,4,18,F11SP
9,Janssenlei 17,2020-12-26,08:00:00,28,10,18,F11SP
9,Janssenlei 17,2020-12-26,09:00:00,112,38,74,F11SP
9,Janssenlei 17,2020-12-26,10:00:00,146,44,102,F11SP
9,Janssenlei 17,2020-12-26,11:00:00,194,88,106,F11SP
9,Janssenlei 17,2020-12-26,12:00:00,264,162,102,F11SP
9,Janssenlei 17,2020-12-26,13:00:00,146,70,76,F11SP
9,Janssenlei 17,2020-12-26,14:00:00,150,76,74,F11SP
9,Janssenlei 17,2020-12-26,15:00:00,134,58,76,F11SP
9,Janssenlei 17,2020-12-26,16:00:00,156,86,70,F11SP
9,Janssenlei 17,2020-12-26,17:00:00,60,42,18,F11SP
9,Janssenlei 17,2020-12-26,18:00:00,30,16,14,F11SP
9,Janssenlei 17,2020-12-26,19:00:00,30,12,18,F11SP
9,Janssenlei 17,2020-12-26,20:00:00,26,6,20,F11SP
9,Janssenlei 17,2020-12-26,21:00:00,12,4,8,F11SP
9,Janssenlei 17,2020-12-26,22:00:00,12,2,10,F11SP
9,Janssenlei 17,2020-12-26,23:00:00,16,14,2,F11SP
9,Janssenlei 17,2020-12-27,00:00:00,2,0,2,F11SP
9,Janssenlei 17,2020-12-27,01:00:00,0,0,0,F11SP
9,Janssenlei 17,2020-12-27,02:00:00,0,0,0,F11SP
9,Janssenlei 17,2020-12-27,03:00:00,0,0,0,F11SP
9,Janssenlei 17,2020-12-27,04:00:00,0,0,0,F11SP
9,Janssenlei 17,2020-12-27,05:00:00,0,0,0,F11SP
9,Janssenlei 17,2020-12-27,06:00:00,2,2,0,F11SP
9,Janssenlei 17,2020-12-27,07:00:00,8,2,6,F11SP
9,Janssenlei 17,2020-12-27,08:00:00,12,6,6,F11SP
9,Janssenlei 17,2020-12-27,09:00:00,8,2,6,F11SP
9,Janssenlei 17,2020-12-27,10:00:00,24,6,18,F11SP
9,Janssenlei 17,2020-12-27,11:00:00,20,10,10,F11SP
9,Janssenlei 17,2020-12-27,12:00:00,30,16,14,F11SP
9,Janssenlei 17,2020-12-27,13:00:00,12,10,2,F11SP
9,Janssenlei 17,2020-12-27,14:00:00,16,8,8,F11SP
9,Janssenlei 17,2020-12-27,15:00:00,18,8,10,F11SP
9,Janssenlei 17,2020-12-27,16:00:00,8,6,2,F11SP
9,Janssenlei 17,2020-12-27,17:00:00,4,0,4,F11SP
9,Janssenlei 17,2020-12-27,18:00:00,4,4,0,F11SP
9,Janssenlei 17,2020-12-27,19:00:00,24,4,20,F11SP
9,Janssenlei 17,2020-12-27,20:00:00,6,4,2,F11SP
9,Janssenlei 17,2020-12-27,21:00:00,8,2,6,F11SP
9,Janssenlei 17,2020-12-27,22:00:00,6,0,6,F11SP
9,Janssenlei 17,2020-12-27,23:00:00,12,6,6,F11SP
9,Janssenlei 17,2020-12-28,00:00:00,0,0,0,F11SP
9,Janssenlei 17,2020-12-28,01:00:00,0,0,0,F11SP
9,Janssenlei 17,2020-12-28,02:00:00,0,0,0,F11SP
9,Janssenlei 17,2020-12-28,03:00:00,0,0,0,F11SP
9,Janssenlei 17,2020-12-28,04:00:00,6,4,2,F11SP
9,Janssenlei 17,2020-12-28,05:00:00,6,6,0,F11SP
9,Janssenlei 17,2020-12-28,06:00:00,18,14,4,F11SP
9,Janssenlei 17,2020-12-28,07:00:00,54,32,22,F11SP
9,Janssenlei 17,2020-12-28,08:00:00,52,30,22,F11SP
9,Janssenlei 17,2020-12-28,09:00:00,74,32,42,F11SP
9,Janssenlei 17,2020-12-28,10:00:00,128,56,72,F11SP
9,Janssenlei 17,2020-12-28,11:00:00,152,62,90,F11SP
9,Janssenlei 17,2020-12-28,12:00:00,146,84,62,F11SP
9,Janssenlei 17,2020-12-28,13:00:00,94,44,50,F11SP
9,Janssenlei 17,2020-12-28,14:00:00,142,62,80,F11SP
9,Janssenlei 17,2020-12-28,15:00:00,136,82,54,F11SP
9,Janssenlei 17,2020-12-28,16:00:00,146,76,70,F11SP
9,Janssenlei 17,2020-12-28,17:00:00,74,36,38,F11SP
9,Janssenlei 17,2020-12-28,18:00:00,46,18,28,F11SP
9,Janssenlei 17,2020-12-28,19:00:00,8,6,2,F11SP
9,Janssenlei 17,2020-12-28,20:00:00,18,8,10,F11SP
9,Janssenlei 17,2020-12-28,21:00:00,8,2,6,F11SP
9,Janssenlei 17,2020-12-28,22:00:00,16,6,10,F11SP
9,Janssenlei 17,2020-12-28,23:00:00,4,2,2,F11SP
9,Janssenlei 17,2020-12-29,00:00:00,2,0,2,F11SP
9,Janssenlei 17,2020-12-29,01:00:00,0,0,0,F11SP
9,Janssenlei 17,2020-12-29,02:00:00,0,0,0,F11SP
9,Janssenlei 17,2020-12-29,03:00:00,0,0,0,F11SP
9,Janssenlei 17,2020-12-29,04:00:00,4,4,0,F11SP
9,Janssenlei 17,2020-12-29,05:00:00,8,2,6,F11SP
9,Janssenlei 17,2020-12-29,06:00:00,14,8,6,F11SP
9,Janssenlei 17,2020-12-29,07:00:00,54,34,20,F11SP
9,Janssenlei 17,2020-12-29,08:00:00,62,36,26,F11SP
9,Janssenlei 17,2020-12-29,09:00:00,52,22,30,F11SP
9,Janssenlei 17,2020-12-29,10:00:00,108,66,42,F11SP
9,Janssenlei 17,2020-12-29,11:00:00,82,36,46,F11SP
9,Janssenlei 17,2020-12-29,12:00:00,74,40,34,F11SP
9,Janssenlei 17,2020-12-29,13:00:00,110,66,44,F11SP
9,Janssenlei 17,2020-12-29,14:00:00,182,86,96,F11SP
9,Janssenlei 17,2020-12-29,15:00:00,198,88,110,F11SP
9,Janssenlei 17,2020-12-29,16:00:00,176,84,92,F11SP
9,Janssenlei 17,2020-12-29,17:00:00,110,58,52,F11SP
9,Janssenlei 17,2020-12-29,18:00:00,36,20,16,F11SP
9,Janssenlei 17,2020-12-29,19:00:00,28,6,22,F11SP
9,Janssenlei 17,2020-12-29,20:00:00,38,20,18,F11SP
9,Janssenlei 17,2020-12-29,21:00:00,8,2,6,F11SP
9,Janssenlei 17,2020-12-29,22:00:00,20,10,10,F11SP
9,Janssenlei 17,2020-12-29,23:00:00,20,16,4,F11SP
9,Janssenlei 17,2020-12-30,00:00:00,0,0,0,F11SP
9,Janssenlei 17,2020-12-30,01:00:00,0,0,0,F11SP
9,Janssenlei 17,2020-12-30,02:00:00,0,0,0,F11SP
9,Janssenlei 17,2020-12-30,03:00:00,0,0,0,F11SP
9,Janssenlei 17,2020-12-30,04:00:00,2,2,0,F11SP
9,Janssenlei 17,2020-12-30,05:00:00,4,0,4,F11SP
9,Janssenlei 17,2020-12-30,06:00:00,22,18,4,F11SP
9,Janssenlei 17,2020-12-30,07:00:00,66,28,38,F11SP
9,Janssenlei 17,2020-12-30,08:00:00,70,34,36,F11SP
9,Janssenlei 17,2020-12-30,09:00:00,58,20,38,F11SP
9,Janssenlei 17,2020-12-30,10:00:00,94,48,46,F11SP
9,Janssenlei 17,2020-12-30,11:00:00,112,52,60,F11SP
9,Janssenlei 17,2020-12-30,12:00:00,140,62,78,F11SP
9,Janssenlei 17,2020-12-30,13:00:00,114,70,44,F11SP
9,Janssenlei 17,2020-12-30,14:00:00,228,110,118,F11SP
9,Janssenlei 17,2020-12-30,15:00:00,168,72,96,F11SP
9,Janssenlei 17,2020-12-30,16:00:00,156,80,76,F11SP
9,Janssenlei 17,2020-12-30,17:00:00,116,68,48,F11SP
9,Janssenlei 17,2020-12-30,18:00:00,60,30,30,F11SP
9,Janssenlei 17,2020-12-30,19:00:00,28,16,12,F11SP
9,Janssenlei 17,2020-12-30,20:00:00,14,8,6,F11SP
9,Janssenlei 17,2020-12-30,21:00:00,6,2,4,F11SP
9,Janssenlei 17,2020-12-30,22:00:00,14,0,14,F11SP
9,Janssenlei 17,2020-12-30,23:00:00,18,8,10,F11SP
9,Janssenlei 17,2020-12-31,00:00:00,2,0,2,F11SP
9,Janssenlei 17,2020-12-31,01:00:00,0,0,0,F11SP
9,Janssenlei 17,2020-12-31,02:00:00,0,0,0,F11SP
9,Janssenlei 17,2020-12-31,03:00:00,0,0,0,F11SP
9,Janssenlei 17,2020-12-31,04:00:00,2,2,0,F11SP
9,Janssenlei 17,2020-12-31,05:00:00,4,0,4,F11SP
9,Janssenlei 17,2020-12-31,06:00:00,10,10,0,F11SP
9,Janssenlei 17,2020-12-31,07:00:00,26,16,10,F11SP
9,Janssenlei 17,2020-12-31,08:00:00,42,24,18,F11SP
9,Janssenlei 17,2020-12-31,09:00:00,28,12,16,F11SP
9,Janssenlei 17,2020-12-31,10:00:00,66,32,34,F11SP
9,Janssenlei 17,2020-12-31,11:00:00,102,58,44,F11SP
9,Janssenlei 17,2020-12-31,12:00:00,86,40,46,F11SP
9,Janssenlei 17,2020-12-31,13:00:00,136,66,70,F11SP
9,Janssenlei 17,2020-12-31,14:00:00,160,88,72,F11SP
9,Janssenlei 17,2020-12-31,15:00:00,130,70,60,F11SP
9,Janssenlei 17,2020-12-31,16:00:00,82,42,40,F11SP
9,Janssenlei 17,2020-12-31,17:00:00,76,44,32,F11SP
9,Janssenlei 17,2020-12-31,18:00:00,42,18,24,F11SP
9,Janssenlei 17,2020-12-31,19:00:00,20,10,10,F11SP
9,Janssenlei 17,2020-12-31,20:00:00,14,8,6,F11SP
9,Janssenlei 17,2020-12-31,21:00:00,14,6,8,F11SP
9,Janssenlei 17,2020-12-31,22:00:00,14,4,10,F11SP
9,Janssenlei 17,2020-12-31,23:00:00,30,18,12,F11SP
9,Janssenlei 17,2021-01-01,00:00:00,4,0,4,F11SP
9,Janssenlei 17,2021-01-01,01:00:00,4,0,4,F11SP
9,Janssenlei 17,2021-01-01,02:00:00,0,0,0,F11SP
9,Janssenlei 17,2021-01-01,03:00:00,0,0,0,F11SP
9,Janssenlei 17,2021-01-01,04:00:00,0,0,0,F11SP
9,Janssenlei 17,2021-01-01,05:00:00,8,4,4,F11SP
9,Janssenlei 17,2021-01-01,06:00:00,4,2,2,F11SP
9,Janssenlei 17,2021-01-01,07:00:00,8,4,4,F11SP
9,Janssenlei 17,2021-01-01,08:00:00,12,6,6,F11SP
9,Janssenlei 17,2021-01-01,09:00:00,52,24,28,F11SP
9,Janssenlei 17,2021-01-01,10:00:00,62,28,34,F11SP
9,Janssenlei 17,2021-01-01,11:00:00,100,38,62,F11SP
9,Janssenlei 17,2021-01-01,12:00:00,120,54,66,F11SP
9,Janssenlei 17,2021-01-01,13:00:00,154,66,88,F11SP
9,Janssenlei 17,2021-01-01,14:00:00,256,116,140,F11SP
9,Janssenlei 17,2021-01-01,15:00:00,226,104,122,F11SP
9,Janssenlei 17,2021-01-01,16:00:00,136,78,58,F11SP
9,Janssenlei 17,2021-01-01,17:00:00,34,16,18,F11SP
9,Janssenlei 17,2021-01-01,18:00:00,18,4,14,F11SP
9,Janssenlei 17,2021-01-01,19:00:00,24,14,10,F11SP
9,Janssenlei 17,2021-01-01,20:00:00,8,4,4,F11SP
9,Janssenlei 17,2021-01-01,21:00:00,10,2,8,F11SP
9,Janssenlei 17,2021-01-01,22:00:00,4,0,4,F11SP
9,Janssenlei 17,2021-01-01,23:00:00,12,10,2,F11SP
9,Janssenlei 17,2021-01-02,00:00:00,2,2,0,F11SP
9,Janssenlei 17,2021-01-02,01:00:00,0,0,0,F11SP
9,Janssenlei 17,2021-01-02,02:00:00,0,0,0,F11SP
9,Janssenlei 17,2021-01-02,03:00:00,0,0,0,F11SP
9,Janssenlei 17,2021-01-02,04:00:00,2,2,0,F11SP
9,Janssenlei 17,2021-01-02,05:00:00,4,4,0,F11SP
9,Janssenlei 17,2021-01-02,06:00:00,12,8,4,F11SP
9,Janssenlei 17,2021-01-02,07:00:00,18,6,12,F11SP
9,Janssenlei 17,2021-01-02,08:00:00,20,12,8,F11SP
9,Janssenlei 17,2021-01-02,09:00:00,32,14,18,F11SP
9,Janssenlei 17,2021-01-02,10:00:00,116,50,66,F11SP
9,Janssenlei 17,2021-01-02,11:00:00,120,58,62,F11SP
9,Janssenlei 17,2021-01-02,12:00:00,162,92,70,F11SP
9,Janssenlei 17,2021-01-02,13:00:00,132,60,72,F11SP
9,Janssenlei 17,2021-01-02,14:00:00,254,130,124,F11SP
9,Janssenlei 17,2021-01-02,15:00:00,212,118,94,F11SP
9,Janssenlei 17,2021-01-02,16:00:00,114,74,40,F11SP
9,Janssenlei 17,2021-01-02,17:00:00,60,32,28,F11SP
9,Janssenlei 17,2021-01-02,18:00:00,48,20,28,F11SP
9,Janssenlei 17,2021-01-02,19:00:00,18,12,6,F11SP
9,Janssenlei 17,2021-01-02,20:00:00,22,6,16,F11SP
9,Janssenlei 17,2021-01-02,21:00:00,8,2,6,F11SP
9,Janssenlei 17,2021-01-02,22:00:00,8,0,8,F11SP
9,Janssenlei 17,2021-01-02,23:00:00,14,6,8,F11SP
9,Janssenlei 17,2021-01-03,00:00:00,2,2,0,F11SP
9,Janssenlei 17,2021-01-03,01:00:00,0,0,0,F11SP
9,Janssenlei 17,2021-01-03,02:00:00,2,2,0,F11SP
9,Janssenlei 17,2021-01-03,03:00:00,0,0,0,F11SP
9,Janssenlei 17,2021-01-03,04:00:00,2,2,0,F11SP
9,Janssenlei 17,2021-01-03,05:00:00,4,4,0,F11SP
9,Janssenlei 17,2021-01-03,06:00:00,8,2,6,F11SP
9,Janssenlei 17,2021-01-03,07:00:00,20,8,12,F11SP
9,Janssenlei 17,2021-01-03,08:00:00,48,14,34,F11SP
9,Janssenlei 17,2021-01-03,09:00:00,116,40,76,F11SP
9,Janssenlei 17,2021-01-03,10:00:00,152,68,84,F11SP
9,Janssenlei 17,2021-01-03,11:00:00,164,90,74,F11SP
9,Janssenlei 17,2021-01-03,12:00:00,164,114,50,F11SP
9,Janssenlei 17,2021-01-03,13:00:00,128,78,50,F11SP
9,Janssenlei 17,2021-01-03,14:00:00,172,80,92,F11SP
9,Janssenlei 17,2021-01-03,15:00:00,140,76,64,F11SP
9,Janssenlei 17,2021-01-03,16:00:00,82,34,48,F11SP
9,Janssenlei 17,2021-01-03,17:00:00,56,22,34,F11SP
9,Janssenlei 17,2021-01-03,18:00:00,34,14,20,F11SP
9,Janssenlei 17,2021-01-03,19:00:00,22,12,10,F11SP
9,Janssenlei 17,2021-01-03,20:00:00,4,4,0,F11SP
9,Janssenlei 17,2021-01-03,21:00:00,10,6,4,F11SP
9,Janssenlei 17,2021-01-03,22:00:00,6,2,4,F11SP
9,Janssenlei 17,2021-01-03,23:00:00,8,4,4,F11SP
9,Janssenlei 17,2021-01-04,00:00:00,2,2,0,F11SP
9,Janssenlei 17,2021-01-04,01:00:00,0,0,0,F11SP
9,Janssenlei 17,2021-01-04,02:00:00,4,2,2,F11SP
9,Janssenlei 17,2021-01-04,03:00:00,0,0,0,F11SP
9,Janssenlei 17,2021-01-04,04:00:00,4,4,0,F11SP
9,Janssenlei 17,2021-01-04,05:00:00,20,16,4,F11SP
9,Janssenlei 17,2021-01-04,06:00:00,52,34,18,F11SP
9,Janssenlei 17,2021-01-04,07:00:00,232,150,82,F11SP
9,Janssenlei 17,2021-01-04,08:00:00,234,182,52,F11SP
9,Janssenlei 17,2021-01-04,09:00:00,48,26,22,F11SP
9,Janssenlei 17,2021-01-04,10:00:00,66,34,32,F11SP
9,Janssenlei 17,2021-01-04,11:00:00,58,28,30,F11SP
9,Janssenlei 17,2021-01-04,12:00:00,52,26,26,F11SP
9,Janssenlei 17,2021-01-04,13:00:00,76,40,36,F11SP
9,Janssenlei 17,2021-01-04,14:00:00,78,34,44,F11SP
9,Janssenlei 17,2021-01-04,15:00:00,138,46,92,F11SP
9,Janssenlei 17,2021-01-04,16:00:00,246,92,154,F11SP
9,Janssenlei 17,2021-01-04,17:00:00,156,40,116,F11SP
9,Janssenlei 17,2021-01-04,18:00:00,56,22,34,F11SP
9,Janssenlei 17,2021-01-04,19:00:00,26,10,16,F11SP
9,Janssenlei 17,2021-01-04,20:00:00,24,12,12,F11SP
9,Janssenlei 17,2021-01-04,21:00:00,12,2,10,F11SP
9,Janssenlei 17,2021-01-04,22:00:00,18,2,16,F11SP
9,Janssenlei 17,2021-01-04,23:00:00,4,0,4,F11SP
9,Janssenlei 17,2021-01-05,00:00:00,0,0,0,F11SP
9,Janssenlei 17,2021-01-05,01:00:00,0,0,0,F11SP
9,Janssenlei 17,2021-01-05,02:00:00,0,0,0,F11SP
9,Janssenlei 17,2021-01-05,03:00:00,0,0,0,F11SP
9,Janssenlei 17,2021-01-05,04:00:00,2,2,0,F11SP
9,Janssenlei 17,2021-01-05,05:00:00,26,24,2,F11SP
9,Janssenlei 17,2021-01-05,06:00:00,68,42,26,F11SP
9,Janssenlei 17,2021-01-05,07:00:00,246,164,82,F11SP
9,Janssenlei 17,2021-01-05,08:00:00,270,190,80,F11SP
9,Janssenlei 17,2021-01-05,09:00:00,88,50,38,F11SP
9,Janssenlei 17,2021-01-05,10:00:00,86,36,50,F11SP
9,Janssenlei 17,2021-01-05,11:00:00,56,28,28,F11SP
9,Janssenlei 17,2021-01-05,12:00:00,116,64,52,F11SP
9,Janssenlei 17,2021-01-05,13:00:00,140,68,72,F11SP
9,Janssenlei 17,2021-01-05,14:00:00,164,76,88,F11SP
9,Janssenlei 17,2021-01-05,15:00:00,168,52,116,F11SP
9,Janssenlei 17,2021-01-05,16:00:00,312,116,196,F11SP
9,Janssenlei 17,2021-01-05,17:00:00,212,66,146,F11SP
9,Janssenlei 17,2021-01-05,18:00:00,90,40,50,F11SP
9,Janssenlei 17,2021-01-05,19:00:00,38,24,14,F11SP
9,Janssenlei 17,2021-01-05,20:00:00,30,14,16,F11SP
9,Janssenlei 17,2021-01-05,21:00:00,22,18,4,F11SP
9,Janssenlei 17,2021-01-05,22:00:00,26,0,26,F11SP
9,Janssenlei 17,2021-01-05,23:00:00,6,2,4,F11SP
9,Janssenlei 17,2021-01-06,00:00:00,2,0,2,F11SP
9,Janssenlei 17,2021-01-06,01:00:00,0,0,0,F11SP
9,Janssenlei 17,2021-01-06,02:00:00,0,0,0,F11SP
9,Janssenlei 17,2021-01-06,03:00:00,2,2,0,F11SP
9,Janssenlei 17,2021-01-06,04:00:00,8,8,0,F11SP
9,Janssenlei 17,2021-01-06,05:00:00,18,12,6,F11SP
9,Janssenlei 17,2021-01-06,06:00:00,52,32,20,F11SP
9,Janssenlei 17,2021-01-06,07:00:00,204,128,76,F11SP
9,Janssenlei 17,2021-01-06,08:00:00,260,178,82,F11SP
9,Janssenlei 17,2021-01-06,09:00:00,72,38,34,F11SP
9,Janssenlei 17,2021-01-06,10:00:00,104,50,54,F11SP
9,Janssenlei 17,2021-01-06,11:00:00,100,34,66,F11SP
9,Janssenlei 17,2021-01-06,12:00:00,184,76,108,F11SP
9,Janssenlei 17,2021-01-06,13:00:00,146,66,80,F11SP
9,Janssenlei 17,2021-01-06,14:00:00,146,82,64,F11SP
9,Janssenlei 17,2021-01-06,15:00:00,144,52,92,F11SP
9,Janssenlei 17,2021-01-06,16:00:00,154,60,94,F11SP
9,Janssenlei 17,2021-01-06,17:00:00,172,78,94,F11SP
9,Janssenlei 17,2021-01-06,18:00:00,86,30,56,F11SP
9,Janssenlei 17,2021-01-06,19:00:00,50,20,30,F11SP
9,Janssenlei 17,2021-01-06,20:00:00,20,12,8,F11SP
9,Janssenlei 17,2021-01-06,21:00:00,16,8,8,F11SP
9,Janssenlei 17,2021-01-06,22:00:00,26,6,20,F11SP
9,Janssenlei 17,2021-01-06,23:00:00,12,4,8,F11SP
9,Janssenlei 17,2021-01-07,00:00:00,0,0,0,F11SP
9,Janssenlei 17,2021-01-07,01:00:00,0,0,0,F11SP
9,Janssenlei 17,2021-01-07,02:00:00,0,0,0,F11SP
9,Janssenlei 17,2021-01-07,03:00:00,0,0,0,F11SP
9,Janssenlei 17,2021-01-07,04:00:00,2,2,0,F11SP
9,Janssenlei 17,2021-01-07,05:00:00,8,8,0,F11SP
9,Janssenlei 17,2021-01-07,06:00:00,42,26,16,F11SP
9,Janssenlei 17,2021-01-07,07:00:00,184,92,92,F11SP
9,Janssenlei 17,2021-01-07,08:00:00,186,130,56,F11SP
9,Janssenlei 17,2021-01-07,09:00:00,42,24,18,F11SP
9,Janssenlei 17,2021-01-07,10:00:00,28,12,16,F11SP
9,Janssenlei 17,2021-01-07,11:00:00,34,16,18,F11SP
9,Janssenlei 17,2021-01-07,12:00:00,58,32,26,F11SP
9,Janssenlei 17,2021-01-07,13:00:00,112,64,48,F11SP
9,Janssenlei 17,2021-01-07,14:00:00,118,52,66,F11SP
9,Janssenlei 17,2021-01-07,15:00:00,106,36,70,F11SP
9,Janssenlei 17,2021-01-07,16:00:00,204,72,132,F11SP
9,Janssenlei 17,2021-01-07,17:00:00,124,44,80,F11SP
9,Janssenlei 17,2021-01-07,18:00:00,64,32,32,F11SP
9,Janssenlei 17,2021-01-07,19:00:00,24,12,12,F11SP
9,Janssenlei 17,2021-01-07,20:00:00,14,8,6,F11SP
9,Janssenlei 17,2021-01-07,21:00:00,10,6,4,F11SP
9,Janssenlei 17,2021-01-07,22:00:00,22,2,20,F11SP
9,Janssenlei 17,2021-01-07,23:00:00,4,2,2,F11SP
9,Janssenlei 17,2021-01-08,00:00:00,2,0,2,F11SP
9,Janssenlei 17,2021-01-08,01:00:00,0,0,0,F11SP
9,Janssenlei 17,2021-01-08,02:00:00,0,0,0,F11SP
9,Janssenlei 17,2021-01-08,03:00:00,0,0,0,F11SP
9,Janssenlei 17,2021-01-08,04:00:00,0,0,0,F11SP
9,Janssenlei 17,2021-01-08,05:00:00,10,8,2,F11SP
9,Janssenlei 17,2021-01-08,06:00:00,38,20,18,F11SP
9,Janssenlei 17,2021-01-08,07:00:00,158,92,66,F11SP
9,Janssenlei 17,2021-01-08,08:00:00,236,158,78,F11SP
9,Janssenlei 17,2021-01-08,09:00:00,50,28,22,F11SP
9,Janssenlei 17,2021-01-08,10:00:00,42,16,26,F11SP
9,Janssenlei 17,2021-01-08,11:00:00,64,34,30,F11SP
9,Janssenlei 17,2021-01-08,12:00:00,68,34,34,F11SP
9,Janssenlei 17,2021-01-08,13:00:00,106,42,64,F11SP
9,Janssenlei 17,2021-01-08,14:00:00,152,72,80,F11SP
9,Janssenlei 17,2021-01-08,15:00:00,160,56,104,F11SP
9,Janssenlei 17,2021-01-08,16:00:00,232,106,126,F11SP
9,Janssenlei 17,2021-01-08,17:00:00,134,56,78,F11SP
9,Janssenlei 17,2021-01-08,18:00:00,54,22,32,F11SP
9,Janssenlei 17,2021-01-08,19:00:00,28,14,14,F11SP
9,Janssenlei 17,2021-01-08,20:00:00,34,12,22,F11SP
9,Janssenlei 17,2021-01-08,21:00:00,16,8,8,F11SP
9,Janssenlei 17,2021-01-08,22:00:00,26,8,18,F11SP
9,Janssenlei 17,2021-01-08,23:00:00,20,12,8,F11SP
9,Janssenlei 17,2021-01-09,00:00:00,4,4,0,F11SP
9,Janssenlei 17,2021-01-09,01:00:00,0,0,0,F11SP
9,Janssenlei 17,2021-01-09,02:00:00,4,2,2,F11SP
9,Janssenlei 17,2021-01-09,03:00:00,0,0,0,F11SP
9,Janssenlei 17,2021-01-09,04:00:00,4,4,0,F11SP
9,Janssenlei 17,2021-01-09,05:00:00,10,8,2,F11SP
9,Janssenlei 17,2021-01-09,06:00:00,10,2,8,F11SP
9,Janssenlei 17,2021-01-09,07:00:00,14,10,4,F11SP
9,Janssenlei 17,2021-01-09,08:00:00,22,4,18,F11SP
9,Janssenlei 17,2021-01-09,09:00:00,66,26,40,F11SP
9,Janssenlei 17,2021-01-09,10:00:00,74,36,38,F11SP
9,Janssenlei 17,2021-01-09,11:00:00,76,44,32,F11SP
9,Janssenlei 17,2021-01-09,12:00:00,142,74,68,F11SP
9,Janssenlei 17,2021-01-09,13:00:00,214,102,112,F11SP
9,Janssenlei 17,2021-01-09,14:00:00,282,134,148,F11SP
9,Janssenlei 17,2021-01-09,15:00:00,244,130,114,F11SP
9,Janssenlei 17,2021-01-09,16:00:00,166,96,70,F11SP
9,Janssenlei 17,2021-01-09,17:00:00,46,32,14,F11SP
9,Janssenlei 17,2021-01-09,18:00:00,30,22,8,F11SP
9,Janssenlei 17,2021-01-09,19:00:00,14,2,12,F11SP
9,Janssenlei 17,2021-01-09,20:00:00,14,6,8,F11SP
9,Janssenlei 17,2021-01-09,21:00:00,6,6,0,F11SP
9,Janssenlei 17,2021-01-09,22:00:00,6,2,4,F11SP
9,Janssenlei 17,2021-01-09,23:00:00,6,2,4,F11SP
9,Janssenlei 17,2021-01-10,00:00:00,4,4,0,F11SP
9,Janssenlei 17,2021-01-10,01:00:00,0,0,0,F11SP
9,Janssenlei 17,2021-01-10,02:00:00,0,0,0,F11SP
9,Janssenlei 17,2021-01-10,03:00:00,0,0,0,F11SP
9,Janssenlei 17,2021-01-10,04:00:00,0,0,0,F11SP
9,Janssenlei 17,2021-01-10,05:00:00,4,4,0,F11SP
9,Janssenlei 17,2021-01-10,06:00:00,8,2,6,F11SP
9,Janssenlei 17,2021-01-10,07:00:00,6,4,2,F11SP
9,Janssenlei 17,2021-01-10,08:00:00,36,16,20,F11SP
9,Janssenlei 17,2021-01-10,09:00:00,76,22,54,F11SP
9,Janssenlei 17,2021-01-10,10:00:00,96,44,52,F11SP
9,Janssenlei 17,2021-01-10,11:00:00,178,78,100,F11SP
9,Janssenlei 17,2021-01-10,12:00:00,202,102,100,F11SP
9,Janssenlei 17,2021-01-10,13:00:00,250,100,150,F11SP
9,Janssenlei 17,2021-01-10,14:00:00,296,142,154,F11SP
9,Janssenlei 17,2021-01-10,15:00:00,232,134,98,F11SP
9,Janssenlei 17,2021-01-10,16:00:00,172,126,46,F11SP
9,Janssenlei 17,2021-01-10,17:00:00,64,36,28,F11SP
9,Janssenlei 17,2021-01-10,18:00:00,20,12,8,F11SP
9,Janssenlei 17,2021-01-10,19:00:00,8,6,2,F11SP
9,Janssenlei 17,2021-01-10,20:00:00,16,8,8,F11SP
9,Janssenlei 17,2021-01-10,21:00:00,22,14,8,F11SP
9,Janssenlei 17,2021-01-10,22:00:00,4,2,2,F11SP
9,Janssenlei 17,2021-01-10,23:00:00,10,4,6,F11SP
9,Janssenlei 17,2021-01-11,00:00:00,0,0,0,F11SP
9,Janssenlei 17,2021-01-11,01:00:00,0,0,0,F11SP
9,Janssenlei 17,2021-01-11,02:00:00,0,0,0,F11SP
9,Janssenlei 17,2021-01-11,03:00:00,2,2,0,F11SP
9,Janssenlei 17,2021-01-11,04:00:00,4,4,0,F11SP
9,Janssenlei 17,2021-01-11,05:00:00,28,24,4,F11SP
9,Janssenlei 17,2021-01-11,06:00:00,62,46,16,F11SP
9,Janssenlei 17,2021-01-11,07:00:00,252,164,88,F11SP
9,Janssenlei 17,2021-01-11,08:00:00,254,192,62,F11SP
9,Janssenlei 17,2021-01-11,09:00:00,92,44,48,F11SP
9,Janssenlei 17,2021-01-11,10:00:00,100,50,50,F11SP
9,Janssenlei 17,2021-01-11,11:00:00,84,34,50,F11SP
9,Janssenlei 17,2021-01-11,12:00:00,130,58,72,F11SP
9,Janssenlei 17,2021-01-11,13:00:00,102,44,58,F11SP
9,Janssenlei 17,2021-01-11,14:00:00,152,82,70,F11SP
9,Janssenlei 17,2021-01-11,15:00:00,198,68,130,F11SP
9,Janssenlei 17,2021-01-11,16:00:00,276,110,166,F11SP
9,Janssenlei 17,2021-01-11,17:00:00,172,42,130,F11SP
9,Janssenlei 17,2021-01-11,18:00:00,88,30,58,F11SP
9,Janssenlei 17,2021-01-11,19:00:00,34,16,18,F11SP
9,Janssenlei 17,2021-01-11,20:00:00,38,18,20,F11SP
9,Janssenlei 17,2021-01-11,21:00:00,14,8,6,F11SP
9,Janssenlei 17,2021-01-11,22:00:00,32,6,26,F11SP
9,Janssenlei 17,2021-01-11,23:00:00,4,0,4,F11SP
9,Janssenlei 17,2021-01-12,00:00:00,0,0,0,F11SP
9,Janssenlei 17,2021-01-12,01:00:00,0,0,0,F11SP
9,Janssenlei 17,2021-01-12,02:00:00,0,0,0,F11SP
9,Janssenlei 17,2021-01-12,03:00:00,0,0,0,F11SP
9,Janssenlei 17,2021-01-12,04:00:00,6,6,0,F11SP
9,Janssenlei 17,2021-01-12,05:00:00,12,10,2,F11SP
9,Janssenlei 17,2021-01-12,06:00:00,40,20,20,F11SP
9,Janssenlei 17,2021-01-12,07:00:00,132,86,46,F11SP
9,Janssenlei 17,2021-01-12,08:00:00,202,156,46,F11SP
9,Janssenlei 17,2021-01-12,09:00:00,40,24,16,F11SP
9,Janssenlei 17,2021-01-12,10:00:00,22,16,6,F11SP
9,Janssenlei 17,2021-01-12,11:00:00,26,16,10,F11SP
9,Janssenlei 17,2021-01-12,12:00:00,90,42,48,F11SP
9,Janssenlei 17,2021-01-12,13:00:00,106,50,56,F11SP
9,Janssenlei 17,2021-01-12,14:00:00,154,68,86,F11SP
9,Janssenlei 17,2021-01-12,15:00:00,162,70,92,F11SP
9,Janssenlei 17,2021-01-12,16:00:00,232,96,136,F11SP
9,Janssenlei 17,2021-01-12,17:00:00,162,60,102,F11SP
9,Janssenlei 17,2021-01-12,18:00:00,86,40,46,F11SP
9,Janssenlei 17,2021-01-12,19:00:00,24,6,18,F11SP
9,Janssenlei 17,2021-01-12,20:00:00,26,14,12,F11SP
9,Janssenlei 17,2021-01-12,21:00:00,34,28,6,F11SP
9,Janssenlei 17,2021-01-12,22:00:00,36,8,28,F11SP
9,Janssenlei 17,2021-01-12,23:00:00,12,6,6,F11SP
9,Janssenlei 17,2021-01-13,00:00:00,0,0,0,F11SP
9,Janssenlei 17,2021-01-13,01:00:00,0,0,0,F11SP
9,Janssenlei 17,2021-01-13,02:00:00,2,0,2,F11SP
9,Janssenlei 17,2021-01-13,03:00:00,2,2,0,F11SP
9,Janssenlei 17,2021-01-13,04:00:00,8,8,0,F11SP
9,Janssenlei 17,2021-01-13,05:00:00,20,16,4,F11SP
9,Janssenlei 17,2021-01-13,06:00:00,68,42,26,F11SP
9,Janssenlei 17,2021-01-13,07:00:00,240,132,108,F11SP
9,Janssenlei 17,2021-01-13,08:00:00,236,176,60,F11SP
9,Janssenlei 17,2021-01-13,09:00:00,90,48,42,F11SP
9,Janssenlei 17,2021-01-13,10:00:00,68,48,20,F11SP
9,Janssenlei 17,2021-01-13,11:00:00,156,64,92,F11SP
9,Janssenlei 17,2021-01-13,12:00:00,244,102,142,F11SP
9,Janssenlei 17,2021-01-13,13:00:00,208,84,124,F11SP
9,Janssenlei 17,2021-01-13,14:00:00,266,122,144,F11SP
9,Janssenlei 17,2021-01-13,15:00:00,256,138,118,F11SP
9,Janssenlei 17,2021-01-13,16:00:00,212,98,114,F11SP
9,Janssenlei 17,2021-01-13,17:00:00,162,68,94,F11SP
9,Janssenlei 17,2021-01-13,18:00:00,90,44,46,F11SP
9,Janssenlei 17,2021-01-13,19:00:00,72,30,42,F11SP
9,Janssenlei 17,2021-01-13,20:00:00,30,14,16,F11SP
9,Janssenlei 17,2021-01-13,21:00:00,40,20,20,F11SP
9,Janssenlei 17,2021-01-13,22:00:00,36,10,26,F11SP
9,Janssenlei 17,2021-01-13,23:00:00,0,0,0,F11SP
9,Janssenlei 17,2021-01-14,00:00:00,0,0,0,F11SP
9,Janssenlei 17,2021-01-14,01:00:00,2,0,2,F11SP
9,Janssenlei 17,2021-01-14,02:00:00,0,0,0,F11SP
9,Janssenlei 17,2021-01-14,03:00:00,0,0,0,F11SP
9,Janssenlei 17,2021-01-14,04:00:00,4,4,0,F11SP
9,Janssenlei 17,2021-01-14,05:00:00,20,16,4,F11SP
9,Janssenlei 17,2021-01-14,06:00:00,40,20,20,F11SP
9,Janssenlei 17,2021-01-14,07:00:00,140,90,50,F11SP
9,Janssenlei 17,2021-01-14,08:00:00,220,162,58,F11SP
9,Janssenlei 17,2021-01-14,09:00:00,64,22,42,F11SP
9,Janssenlei 17,2021-01-14,10:00:00,38,18,20,F11SP
9,Janssenlei 17,2021-01-14,11:00:00,54,24,30,F11SP
9,Janssenlei 17,2021-01-14,12:00:00,54,28,26,F11SP
9,Janssenlei 17,2021-01-14,13:00:00,60,28,32,F11SP
9,Janssenlei 17,2021-01-14,14:00:00,110,52,58,F11SP
9,Janssenlei 17,2021-01-14,15:00:00,106,42,64,F11SP
9,Janssenlei 17,2021-01-14,16:00:00,174,60,114,F11SP
9,Janssenlei 17,2021-01-14,17:00:00,168,58,110,F11SP
9,Janssenlei 17,2021-01-14,18:00:00,66,36,30,F11SP
9,Janssenlei 17,2021-01-14,19:00:00,30,14,16,F11SP
9,Janssenlei 17,2021-01-14,20:00:00,18,6,12,F11SP
9,Janssenlei 17,2021-01-14,21:00:00,22,14,8,F11SP
9,Janssenlei 17,2021-01-14,22:00:00,26,14,12,F11SP
9,Janssenlei 17,2021-01-14,23:00:00,4,0,4,F11SP
9,Janssenlei 17,2021-01-15,00:00:00,2,2,0,F11SP
9,Janssenlei 17,2021-01-15,01:00:00,0,0,0,F11SP
9,Janssenlei 17,2021-01-15,02:00:00,0,0,0,F11SP
9,Janssenlei 17,2021-01-15,03:00:00,0,0,0,F11SP
9,Janssenlei 17,2021-01-15,04:00:00,6,6,0,F11SP
9,Janssenlei 17,2021-01-15,05:00:00,22,22,0,F11SP
9,Janssenlei 17,2021-01-15,06:00:00,62,38,24,F11SP
9,Janssenlei 17,2021-01-15,07:00:00,168,90,78,F11SP
9,Janssenlei 17,2021-01-15,08:00:00,222,158,64,F11SP
9,Janssenlei 17,2021-01-15,09:00:00,50,22,28,F11SP
9,Janssenlei 17,2021-01-15,10:00:00,74,42,32,F11SP
9,Janssenlei 17,2021-01-15,11:00:00,90,34,56,F11SP
9,Janssenlei 17,2021-01-15,12:00:00,160,86,74,F11SP
9,Janssenlei 17,2021-01-15,13:00:00,108,40,68,F11SP
9,Janssenlei 17,2021-01-15,14:00:00,166,78,88,F11SP
9,Janssenlei 17,2021-01-15,15:00:00,200,92,108,F11SP
9,Janssenlei 17,2021-01-15,16:00:00,240,90,150,F11SP
9,Janssenlei 17,2021-01-15,17:00:00,154,70,84,F11SP
9,Janssenlei 17,2021-01-15,18:00:00,48,20,28,F11SP
9,Janssenlei 17,2021-01-15,19:00:00,46,16,30,F11SP
9,Janssenlei 17,2021-01-15,20:00:00,36,24,12,F11SP
9,Janssenlei 17,2021-01-15,21:00:00,8,6,2,F11SP
9,Janssenlei 17,2021-01-15,22:00:00,26,10,16,F11SP
9,Janssenlei 17,2021-01-15,23:00:00,18,12,6,F11SP
9,Janssenlei 17,2021-01-16,00:00:00,8,4,4,F11SP
9,Janssenlei 17,2021-01-16,01:00:00,0,0,0,F11SP
9,Janssenlei 17,2021-01-16,02:00:00,0,0,0,F11SP
9,Janssenlei 17,2021-01-16,03:00:00,0,0,0,F11SP
9,Janssenlei 17,2021-01-16,04:00:00,6,4,2,F11SP
9,Janssenlei 17,2021-01-16,05:00:00,8,6,2,F11SP
9,Janssenlei 17,2021-01-16,06:00:00,10,0,10,F11SP
9,Janssenlei 17,2021-01-16,07:00:00,18,8,10,F11SP
9,Janssenlei 17,2021-01-16,08:00:00,26,14,12,F11SP
9,Janssenlei 17,2021-01-16,09:00:00,78,28,50,F11SP
9,Janssenlei 17,2021-01-16,10:00:00,114,50,64,F11SP
9,Janssenlei 17,2021-01-16,11:00:00,146,80,66,F11SP
9,Janssenlei 17,2021-01-16,12:00:00,132,86,46,F11SP
9,Janssenlei 17,2021-01-16,13:00:00,92,42,50,F11SP
9,Janssenlei 17,2021-01-16,14:00:00,70,34,36,F11SP
9,Janssenlei 17,2021-01-16,15:00:00,38,24,14,F11SP
9,Janssenlei 17,2021-01-16,16:00:00,22,12,10,F11SP
9,Janssenlei 17,2021-01-16,17:00:00,10,8,2,F11SP
9,Janssenlei 17,2021-01-16,18:00:00,24,12,12,F11SP
9,Janssenlei 17,2021-01-16,19:00:00,12,8,4,F11SP
9,Janssenlei 17,2021-01-16,20:00:00,4,4,0,F11SP
9,Janssenlei 17,2021-01-16,21:00:00,0,0,0,F11SP
9,Janssenlei 17,2021-01-16,22:00:00,10,6,4,F11SP
9,Janssenlei 17,2021-01-16,23:00:00,0,0,0,F11SP
9,Janssenlei 17,2021-01-17,00:00:00,0,0,0,F11SP
9,Janssenlei 17,2021-01-17,01:00:00,0,0,0,F11SP
9,Janssenlei 17,2021-01-17,02:00:00,0,0,0,F11SP
9,Janssenlei 17,2021-01-17,03:00:00,0,0,0,F11SP
9,Janssenlei 17,2021-01-17,04:00:00,0,0,0,F11SP
9,Janssenlei 17,2021-01-17,05:00:00,6,6,0,F11SP
9,Janssenlei 17,2021-01-17,06:00:00,6,4,2,F11SP
9,Janssenlei 17,2021-01-17,07:00:00,10,4,6,F11SP
9,Janssenlei 17,2021-01-17,08:00:00,16,14,2,F11SP
9,Janssenlei 17,2021-01-17,09:00:00,84,32,52,F11SP
9,Janssenlei 17,2021-01-17,10:00:00,114,52,62,F11SP
9,Janssenlei 17,2021-01-17,11:00:00,104,44,60,F11SP
9,Janssenlei 17,2021-01-17,12:00:00,184,88,96,F11SP
9,Janssenlei 17,2021-01-17,13:00:00,160,86,74,F11SP
9,Janssenlei 17,2021-01-17,14:00:00,202,84,118,F11SP
9,Janssenlei 17,2021-01-17,15:00:00,192,90,102,F11SP
9,Janssenlei 17,2021-01-17,16:00:00,120,76,44,F11SP
9,Janssenlei 17,2021-01-17,17:00:00,36,24,12,F11SP
9,Janssenlei 17,2021-01-17,18:00:00,28,26,2,F11SP
9,Janssenlei 17,2021-01-17,19:00:00,12,2,10,F11SP
9,Janssenlei 17,2021-01-17,20:00:00,8,4,4,F11SP
9,Janssenlei 17,2021-01-17,21:00:00,18,8,10,F11SP
9,Janssenlei 17,2021-01-17,22:00:00,8,0,8,F11SP
9,Janssenlei 17,2021-01-17,23:00:00,6,0,6,F11SP
9,Janssenlei 17,2021-01-18,00:00:00,2,0,2,F11SP
9,Janssenlei 17,2021-01-18,01:00:00,0,0,0,F11SP
9,Janssenlei 17,2021-01-18,02:00:00,0,0,0,F11SP
9,Janssenlei 17,2021-01-18,03:00:00,2,2,0,F11SP
9,Janssenlei 17,2021-01-18,04:00:00,6,4,2,F11SP
9,Janssenlei 17,2021-01-18,05:00:00,24,20,4,F11SP
9,Janssenlei 17,2021-01-18,06:00:00,64,50,14,F11SP
9,Janssenlei 17,2021-01-18,07:00:00,244,142,102,F11SP
9,Janssenlei 17,2021-01-18,08:00:00,244,168,76,F11SP
9,Janssenlei 17,2021-01-18,09:00:00,66,32,34,F11SP
9,Janssenlei 17,2021-01-18,10:00:00,86,34,52,F11SP
9,Janssenlei 17,2021-01-18,11:00:00,140,62,78,F11SP
9,Janssenlei 17,2021-01-18,12:00:00,130,60,70,F11SP
9,Janssenlei 17,2021-01-18,13:00:00,162,82,80,F11SP
9,Janssenlei 17,2021-01-18,14:00:00,172,96,76,F11SP
9,Janssenlei 17,2021-01-18,15:00:00,206,72,134,F11SP
9,Janssenlei 17,2021-01-18,16:00:00,350,116,234,F11SP
9,Janssenlei 17,2021-01-18,17:00:00,194,90,104,F11SP
9,Janssenlei 17,2021-01-18,18:00:00,54,20,34,F11SP
9,Janssenlei 17,2021-01-18,19:00:00,40,24,16,F11SP
9,Janssenlei 17,2021-01-18,20:00:00,30,12,18,F11SP
9,Janssenlei 17,2021-01-18,21:00:00,26,18,8,F11SP
9,Janssenlei 17,2021-01-18,22:00:00,34,10,24,F11SP
9,Janssenlei 17,2021-01-18,23:00:00,0,0,0,F11SP
9,Janssenlei 17,2021-01-19,00:00:00,0,0,0,F11SP
9,Janssenlei 17,2021-01-19,01:00:00,0,0,0,F11SP
9,Janssenlei 17,2021-01-19,02:00:00,0,0,0,F11SP
9,Janssenlei 17,2021-01-19,03:00:00,2,2,0,F11SP
9,Janssenlei 17,2021-01-19,04:00:00,6,6,0,F11SP
9,Janssenlei 17,2021-01-19,05:00:00,22,20,2,F11SP
9,Janssenlei 17,2021-01-19,06:00:00,50,28,22,F11SP
9,Janssenlei 17,2021-01-19,07:00:00,118,74,44,F11SP
9,Janssenlei 17,2021-01-19,08:00:00,188,138,50,F11SP
9,Janssenlei 17,2021-01-19,09:00:00,52,24,28,F11SP
9,Janssenlei 17,2021-01-19,10:00:00,26,14,12,F11SP
9,Janssenlei 17,2021-01-19,11:00:00,20,10,10,F11SP
9,Janssenlei 17,2021-01-19,12:00:00,60,30,30,F11SP
9,Janssenlei 17,2021-01-19,13:00:00,60,28,32,F11SP
9,Janssenlei 17,2021-01-19,14:00:00,84,28,56,F11SP
9,Janssenlei 17,2021-01-19,15:00:00,118,40,78,F11SP
9,Janssenlei 17,2021-01-19,16:00:00,192,66,126,F11SP
9,Janssenlei 17,2021-01-19,17:00:00,116,44,72,F11SP
9,Janssenlei 17,2021-01-19,18:00:00,58,34,24,F11SP
9,Janssenlei 17,2021-01-19,19:00:00,26,4,22,F11SP
9,Janssenlei 17,2021-01-19,20:00:00,32,22,10,F11SP
9,Janssenlei 17,2021-01-19,21:00:00,28,20,8,F11SP
9,Janssenlei 17,2021-01-19,22:00:00,18,0,18,F11SP
9,Janssenlei 17,2021-01-19,23:00:00,8,0,8,F11SP
9,Janssenlei 17,2021-01-20,00:00:00,0,0,0,F11SP
9,Janssenlei 17,2021-01-20,01:00:00,0,0,0,F11SP
9,Janssenlei 17,2021-01-20,02:00:00,0,0,0,F11SP
9,Janssenlei 17,2021-01-20,03:00:00,0,0,0,F11SP
9,Janssenlei 17,2021-01-20,04:00:00,8,8,0,F11SP
9,Janssenlei 17,2021-01-20,05:00:00,30,22,8,F11SP
9,Janssenlei 17,2021-01-20,06:00:00,68,38,30,F11SP
9,Janssenlei 17,2021-01-20,07:00:00,200,100,100,F11SP
9,Janssenlei 17,2021-01-20,08:00:00,252,170,82,F11SP
9,Janssenlei 17,2021-01-20,09:00:00,62,32,30,F11SP
9,Janssenlei 17,2021-01-20,10:00:00,86,52,34,F11SP
9,Janssenlei 17,2021-01-20,11:00:00,148,60,88,F11SP
9,Janssenlei 17,2021-01-20,12:00:00,196,86,110,F11SP
9,Janssenlei 17,2021-01-20,13:00:00,108,52,56,F11SP
9,Janssenlei 17,2021-01-20,14:00:00,194,78,116,F11SP
9,Janssenlei 17,2021-01-20,15:00:00,170,74,96,F11SP
9,Janssenlei 17,2021-01-20,16:00:00,208,110,98,F11SP
9,Janssenlei 17,2021-01-20,17:00:00,164,86,78,F11SP
9,Janssenlei 17,2021-01-20,18:00:00,80,44,36,F11SP
9,Janssenlei 17,2021-01-20,19:00:00,34,12,22,F11SP
9,Janssenlei 17,2021-01-20,20:00:00,32,12,20,F11SP
9,Janssenlei 17,2021-01-20,21:00:00,28,24,4,F11SP
9,Janssenlei 17,2021-01-20,22:00:00,26,0,26,F11SP
9,Janssenlei 17,2021-01-20,23:00:00,6,0,6,F11SP
9,Janssenlei 17,2021-01-21,00:00:00,0,0,0,F11SP
9,Janssenlei 17,2021-01-21,01:00:00,0,0,0,F11SP
9,Janssenlei 17,2021-01-21,02:00:00,0,0,0,F11SP
9,Janssenlei 17,2021-01-21,03:00:00,0,0,0,F11SP
9,Janssenlei 17,2021-01-21,04:00:00,6,6,0,F11SP
9,Janssenlei 17,2021-01-21,05:00:00,14,12,2,F11SP
9,Janssenlei 17,2021-01-21,06:00:00,50,30,20,F11SP
9,Janssenlei 17,2021-01-21,07:00:00,194,116,78,F11SP
9,Janssenlei 17,2021-01-21,08:00:00,210,166,44,F11SP
9,Janssenlei 17,2021-01-21,09:00:00,106,56,50,F11SP
9,Janssenlei 17,2021-01-21,10:00:00,120,50,70,F11SP
9,Janssenlei 17,2021-01-21,11:00:00,56,22,34,F11SP
9,Janssenlei 17,2021-01-21,12:00:00,90,44,46,F11SP
9,Janssenlei 17,2021-01-21,13:00:00,148,82,66,F11SP
9,Janssenlei 17,2021-01-21,14:00:00,106,48,58,F11SP
9,Janssenlei 17,2021-01-21,15:00:00,186,68,118,F11SP
9,Janssenlei 17,2021-01-21,16:00:00,236,86,150,F11SP
9,Janssenlei 17,2021-01-21,17:00:00,126,40,86,F11SP
9,Janssenlei 17,2021-01-21,18:00:00,62,22,40,F11SP
9,Janssenlei 17,2021-01-21,19:00:00,18,6,12,F11SP
9,Janssenlei 17,2021-01-21,20:00:00,12,8,4,F11SP
9,Janssenlei 17,2021-01-21,21:00:00,20,14,6,F11SP
9,Janssenlei 17,2021-01-21,22:00:00,22,4,18,F11SP
9,Janssenlei 17,2021-01-21,23:00:00,2,0,2,F11SP
9,Janssenlei 17,2021-01-22,00:00:00,0,0,0,F11SP
9,Janssenlei 17,2021-01-22,01:00:00,2,0,2,F11SP
9,Janssenlei 17,2021-01-22,02:00:00,0,0,0,F11SP
9,Janssenlei 17,2021-01-22,03:00:00,0,0,0,F11SP
9,Janssenlei 17,2021-01-22,04:00:00,6,6,0,F11SP
9,Janssenlei 17,2021-01-22,05:00:00,28,20,8,F11SP
9,Janssenlei 17,2021-01-22,06:00:00,74,50,24,F11SP
9,Janssenlei 17,2021-01-22,07:00:00,212,114,98,F11SP
9,Janssenlei 17,2021-01-22,08:00:00,212,158,54,F11SP
9,Janssenlei 17,2021-01-22,09:00:00,76,30,46,F11SP
9,Janssenlei 17,2021-01-22,10:00:00,82,40,42,F11SP
9,Janssenlei 17,2021-01-22,11:00:00,152,80,72,F11SP
9,Janssenlei 17,2021-01-22,12:00:00,126,68,58,F11SP
9,Janssenlei 17,2021-01-22,13:00:00,192,78,114,F11SP
9,Janssenlei 17,2021-01-22,14:00:00,256,112,144,F11SP
9,Janssenlei 17,2021-01-22,15:00:00,310,122,188,F11SP
9,Janssenlei 17,2021-01-22,16:00:00,302,132,170,F11SP
9,Janssenlei 17,2021-01-22,17:00:00,194,96,98,F11SP
9,Janssenlei 17,2021-01-22,18:00:00,102,44,58,F11SP
9,Janssenlei 17,2021-01-22,19:00:00,48,20,28,F11SP
9,Janssenlei 17,2021-01-22,20:00:00,46,22,24,F11SP
9,Janssenlei 17,2021-01-22,21:00:00,18,8,10,F11SP
9,Janssenlei 17,2021-01-22,22:00:00,32,12,20,F11SP
9,Janssenlei 17,2021-01-22,23:00:00,22,18,4,F11SP
9,Janssenlei 17,2021-01-23,00:00:00,8,8,0,F11SP
9,Janssenlei 17,2021-01-23,01:00:00,0,0,0,F11SP
9,Janssenlei 17,2021-01-23,02:00:00,0,0,0,F11SP
9,Janssenlei 17,2021-01-23,03:00:00,0,0,0,F11SP
9,Janssenlei 17,2021-01-23,04:00:00,0,0,0,F11SP
9,Janssenlei 17,2021-01-23,05:00:00,14,12,2,F11SP
9,Janssenlei 17,2021-01-23,06:00:00,20,8,12,F11SP
9,Janssenlei 17,2021-01-23,07:00:00,28,12,16,F11SP
9,Janssenlei 17,2021-01-23,08:00:00,38,18,20,F11SP
9,Janssenlei 17,2021-01-23,09:00:00,94,28,66,F11SP
9,Janssenlei 17,2021-01-23,10:00:00,132,64,68,F11SP
9,Janssenlei 17,2021-01-23,11:00:00,180,102,78,F11SP
9,Janssenlei 17,2021-01-23,12:00:00,188,98,90,F11SP
9,Janssenlei 17,2021-01-23,13:00:00,198,118,80,F11SP
9,Janssenlei 17,2021-01-23,14:00:00,158,68,90,F11SP
9,Janssenlei 17,2021-01-23,15:00:00,94,48,46,F11SP
9,Janssenlei 17,2021-01-23,16:00:00,90,48,42,F11SP
9,Janssenlei 17,2021-01-23,17:00:00,42,32,10,F11SP
9,Janssenlei 17,2021-01-23,18:00:00,38,22,16,F11SP
9,Janssenlei 17,2021-01-23,19:00:00,22,12,10,F11SP
9,Janssenlei 17,2021-01-23,20:00:00,8,2,6,F11SP
9,Janssenlei 17,2021-01-23,21:00:00,8,6,2,F11SP
9,Janssenlei 17,2021-01-23,22:00:00,8,4,4,F11SP
9,Janssenlei 17,2021-01-23,23:00:00,6,0,6,F11SP
9,Janssenlei 17,2021-01-24,00:00:00,6,0,6,F11SP
9,Janssenlei 17,2021-01-24,01:00:00,0,0,0,F11SP
9,Janssenlei 17,2021-01-24,02:00:00,0,0,0,F11SP
9,Janssenlei 17,2021-01-24,03:00:00,0,0,0,F11SP
9,Janssenlei 17,2021-01-24,04:00:00,0,0,0,F11SP
9,Janssenlei 17,2021-01-24,05:00:00,6,6,0,F11SP
9,Janssenlei 17,2021-01-24,06:00:00,12,6,6,F11SP
9,Janssenlei 17,2021-01-24,07:00:00,10,6,4,F11SP
9,Janssenlei 17,2021-01-24,08:00:00,36,12,24,F11SP
9,Janssenlei 17,2021-01-24,09:00:00,102,32,70,F11SP
9,Janssenlei 17,2021-01-24,10:00:00,252,112,140,F11SP
9,Janssenlei 17,2021-01-24,11:00:00,240,106,134,F11SP
9,Janssenlei 17,2021-01-24,12:00:00,252,132,120,F11SP
9,Janssenlei 17,2021-01-24,13:00:00,200,128,72,F11SP
9,Janssenlei 17,2021-01-24,14:00:00,204,100,104,F11SP
9,Janssenlei 17,2021-01-24,15:00:00,180,84,96,F11SP
9,Janssenlei 17,2021-01-24,16:00:00,108,58,50,F11SP
9,Janssenlei 17,2021-01-24,17:00:00,56,36,20,F11SP
9,Janssenlei 17,2021-01-24,18:00:00,24,12,12,F11SP
9,Janssenlei 17,2021-01-24,19:00:00,16,6,10,F11SP
9,Janssenlei 17,2021-01-24,20:00:00,12,6,6,F11SP
9,Janssenlei 17,2021-01-24,21:00:00,18,10,8,F11SP
9,Janssenlei 17,2021-01-24,22:00:00,6,2,4,F11SP
9,Janssenlei 17,2021-01-24,23:00:00,0,0,0,F11SP
9,Janssenlei 17,2021-01-25,00:00:00,0,0,0,F11SP
9,Janssenlei 17,2021-01-25,01:00:00,0,0,0,F11SP
9,Janssenlei 17,2021-01-25,02:00:00,0,0,0,F11SP
9,Janssenlei 17,2021-01-25,03:00:00,0,0,0,F11SP
9,Janssenlei 17,2021-01-25,04:00:00,2,2,0,F11SP
9,Janssenlei 17,2021-01-25,05:00:00,20,18,2,F11SP
9,Janssenlei 17,2021-01-25,06:00:00,58,46,12,F11SP
9,Janssenlei 17,2021-01-25,07:00:00,196,116,80,F11SP
9,Janssenlei 17,2021-01-25,08:00:00,250,188,62,F11SP
9,Janssenlei 17,2021-01-25,09:00:00,56,32,24,F11SP
9,Janssenlei 17,2021-01-25,10:00:00,66,24,42,F11SP
9,Janssenlei 17,2021-01-25,11:00:00,114,42,72,F11SP
9,Janssenlei 17,2021-01-25,12:00:00,110,48,62,F11SP
9,Janssenlei 17,2021-01-25,13:00:00,138,56,82,F11SP
9,Janssenlei 17,2021-01-25,14:00:00,244,118,126,F11SP
9,Janssenlei 17,2021-01-25,15:00:00,238,118,120,F11SP
9,Janssenlei 17,2021-01-25,16:00:00,272,110,162,F11SP
9,Janssenlei 17,2021-01-25,17:00:00,190,64,126,F11SP
9,Janssenlei 17,2021-01-25,18:00:00,74,34,40,F11SP
9,Janssenlei 17,2021-01-25,19:00:00,38,12,26,F11SP
9,Janssenlei 17,2021-01-25,20:00:00,24,12,12,F11SP
9,Janssenlei 17,2021-01-25,21:00:00,26,12,14,F11SP
9,Janssenlei 17,2021-01-25,22:00:00,28,8,20,F11SP
9,Janssenlei 17,2021-01-25,23:00:00,4,2,2,F11SP
9,Janssenlei 17,2021-01-26,00:00:00,2,0,2,F11SP
9,Janssenlei 17,2021-01-26,01:00:00,0,0,0,F11SP
9,Janssenlei 17,2021-01-26,02:00:00,0,0,0,F11SP
9,Janssenlei 17,2021-01-26,03:00:00,0,0,0,F11SP
9,Janssenlei 17,2021-01-26,04:00:00,4,4,0,F11SP
9,Janssenlei 17,2021-01-26,05:00:00,28,24,4,F11SP
9,Janssenlei 17,2021-01-26,06:00:00,62,38,24,F11SP
9,Janssenlei 17,2021-01-26,07:00:00,230,148,82,F11SP
9,Janssenlei 17,2021-01-26,08:00:00,242,186,56,F11SP
9,Janssenlei 17,2021-01-26,09:00:00,86,32,54,F11SP
9,Janssenlei 17,2021-01-26,10:00:00,86,44,42,F11SP
9,Janssenlei 17,2021-01-26,11:00:00,126,62,64,F11SP
9,Janssenlei 17,2021-01-26,12:00:00,182,82,100,F11SP
9,Janssenlei 17,2021-01-26,13:00:00,228,98,130,F11SP
9,Janssenlei 17,2021-01-26,14:00:00,272,124,148,F11SP
9,Janssenlei 17,2021-01-26,15:00:00,284,132,152,F11SP
9,Janssenlei 17,2021-01-26,16:00:00,312,140,172,F11SP
9,Janssenlei 17,2021-01-26,17:00:00,180,64,116,F11SP
9,Janssenlei 17,2021-01-26,18:00:00,100,46,54,F11SP
9,Janssenlei 17,2021-01-26,19:00:00,48,26,22,F11SP
9,Janssenlei 17,2021-01-26,20:00:00,50,26,24,F11SP
9,Janssenlei 17,2021-01-26,21:00:00,26,12,14,F11SP
9,Janssenlei 17,2021-01-26,22:00:00,34,4,30,F11SP
9,Janssenlei 17,2021-01-26,23:00:00,12,4,8,F11SP
9,Janssenlei 17,2021-01-27,00:00:00,2,0,2,F11SP
9,Janssenlei 17,2021-01-27,01:00:00,0,0,0,F11SP
9,Janssenlei 17,2021-01-27,02:00:00,0,0,0,F11SP
9,Janssenlei 17,2021-01-27,03:00:00,0,0,0,F11SP
9,Janssenlei 17,2021-01-27,04:00:00,2,2,0,F11SP
9,Janssenlei 17,2021-01-27,05:00:00,30,24,6,F11SP
9,Janssenlei 17,2021-01-27,06:00:00,46,30,16,F11SP
9,Janssenlei 17,2021-01-27,07:00:00,194,118,76,F11SP
9,Janssenlei 17,2021-01-27,08:00:00,214,142,72,F11SP
9,Janssenlei 17,2021-01-27,09:00:00,56,22,34,F11SP
9,Janssenlei 17,2021-01-27,10:00:00,70,36,34,F11SP
9,Janssenlei 17,2021-01-27,11:00:00,70,28,42,F11SP
9,Janssenlei 17,2021-01-27,12:00:00,174,68,106,F11SP
9,Janssenlei 17,2021-01-27,13:00:00,126,68,58,F11SP
9,Janssenlei 17,2021-01-27,14:00:00,82,40,42,F11SP
9,Janssenlei 17,2021-01-27,15:00:00,134,38,96,F11SP
9,Janssenlei 17,2021-01-27,16:00:00,174,78,96,F11SP
9,Janssenlei 17,2021-01-27,17:00:00,144,60,84,F11SP
9,Janssenlei 17,2021-01-27,18:00:00,78,42,36,F11SP
9,Janssenlei 17,2021-01-27,19:00:00,52,18,34,F11SP
9,Janssenlei 17,2021-01-27,20:00:00,22,14,8,F11SP
9,Janssenlei 17,2021-01-27,21:00:00,30,24,6,F11SP
9,Janssenlei 17,2021-01-27,22:00:00,26,8,18,F11SP
9,Janssenlei 17,2021-01-27,23:00:00,12,2,10,F11SP
9,Janssenlei 17,2021-01-28,00:00:00,2,0,2,F11SP
9,Janssenlei 17,2021-01-28,01:00:00,0,0,0,F11SP
9,Janssenlei 17,2021-01-28,02:00:00,0,0,0,F11SP
9,Janssenlei 17,2021-01-28,03:00:00,0,0,0,F11SP
9,Janssenlei 17,2021-01-28,04:00:00,0,0,0,F11SP
9,Janssenlei 17,2021-01-28,05:00:00,18,16,2,F11SP
9,Janssenlei 17,2021-01-28,06:00:00,46,28,18,F11SP
9,Janssenlei 17,2021-01-28,07:00:00,122,88,34,F11SP
9,Janssenlei 17,2021-01-28,08:00:00,162,114,48,F11SP
9,Janssenlei 17,2021-01-28,09:00:00,30,18,12,F11SP
9,Janssenlei 17,2021-01-28,10:00:00,34,20,14,F11SP
9,Janssenlei 17,2021-01-28,11:00:00,22,14,8,F11SP
9,Janssenlei 17,2021-01-28,12:00:00,48,12,36,F11SP
9,Janssenlei 17,2021-01-28,13:00:00,76,34,42,F11SP
9,Janssenlei 17,2021-01-28,14:00:00,52,22,30,F11SP
9,Janssenlei 17,2021-01-28,15:00:00,90,32,58,F11SP
9,Janssenlei 17,2021-01-28,16:00:00,126,36,90,F11SP
9,Janssenlei 17,2021-01-28,17:00:00,88,28,60,F11SP
9,Janssenlei 17,2021-01-28,18:00:00,52,18,34,F11SP
9,Janssenlei 17,2021-01-28,19:00:00,34,16,18,F11SP
9,Janssenlei 17,2021-01-28,20:00:00,46,16,30,F11SP
9,Janssenlei 17,2021-01-28,21:00:00,28,16,12,F11SP
9,Janssenlei 17,2021-01-28,22:00:00,18,4,14,F11SP
9,Janssenlei 17,2021-01-28,23:00:00,8,4,4,F11SP
9,Janssenlei 17,2021-01-29,00:00:00,2,2,0,F11SP
9,Janssenlei 17,2021-01-29,01:00:00,0,0,0,F11SP
9,Janssenlei 17,2021-01-29,02:00:00,0,0,0,F11SP
9,Janssenlei 17,2021-01-29,03:00:00,2,2,0,F11SP
9,Janssenlei 17,2021-01-29,04:00:00,4,4,0,F11SP
9,Janssenlei 17,2021-01-29,05:00:00,14,12,2,F11SP
9,Janssenlei 17,2021-01-29,06:00:00,42,22,20,F11SP
9,Janssenlei 17,2021-01-29,07:00:00,122,86,36,F11SP
9,Janssenlei 17,2021-01-29,08:00:00,150,96,54,F11SP
9,Janssenlei 17,2021-01-29,09:00:00,68,28,40,F11SP
9,Janssenlei 17,2021-01-29,10:00:00,94,50,44,F11SP
9,Janssenlei 17,2021-01-29,11:00:00,90,54,36,F11SP
9,Janssenlei 17,2021-01-29,12:00:00,136,66,70,F11SP
9,Janssenlei 17,2021-01-29,13:00:00,96,48,48,F11SP
9,Janssenlei 17,2021-01-29,14:00:00,94,48,46,F11SP
9,Janssenlei 17,2021-01-29,15:00:00,174,70,104,F11SP
9,Janssenlei 17,2021-01-29,16:00:00,136,46,90,F11SP
9,Janssenlei 17,2021-01-29,17:00:00,152,64,88,F11SP
9,Janssenlei 17,2021-01-29,18:00:00,68,34,34,F11SP
9,Janssenlei 17,2021-01-29,19:00:00,48,20,28,F11SP
9,Janssenlei 17,2021-01-29,20:00:00,36,10,26,F11SP
9,Janssenlei 17,2021-01-29,21:00:00,18,6,12,F11SP
9,Janssenlei 17,2021-01-29,22:00:00,32,6,26,F11SP
9,Janssenlei 17,2021-01-29,23:00:00,26,24,2,F11SP
9,Janssenlei 17,2021-01-30,00:00:00,20,8,12,F11SP
9,Janssenlei 17,2021-01-30,01:00:00,0,0,0,F11SP
9,Janssenlei 17,2021-01-30,02:00:00,0,0,0,F11SP
9,Janssenlei 17,2021-01-30,03:00:00,0,0,0,F11SP
9,Janssenlei 17,2021-01-30,04:00:00,2,2,0,F11SP
9,Janssenlei 17,2021-01-30,05:00:00,4,4,0,F11SP
9,Janssenlei 17,2021-01-30,06:00:00,8,2,6,F11SP
9,Janssenlei 17,2021-01-30,07:00:00,24,8,16,F11SP
9,Janssenlei 17,2021-01-30,08:00:00,22,6,16,F11SP
9,Janssenlei 17,2021-01-30,09:00:00,34,18,16,F11SP
9,Janssenlei 17,2021-01-30,10:00:00,18,8,10,F11SP
9,Janssenlei 17,2021-01-30,11:00:00,18,12,6,F11SP
9,Janssenlei 17,2021-01-30,12:00:00,44,34,10,F11SP
9,Janssenlei 17,2021-01-30,13:00:00,36,18,18,F11SP
9,Janssenlei 17,2021-01-30,14:00:00,46,22,24,F11SP
9,Janssenlei 17,2021-01-30,15:00:00,36,18,18,F11SP
9,Janssenlei 17,2021-01-30,16:00:00,42,14,28,F11SP
9,Janssenlei 17,2021-01-30,17:00:00,26,12,14,F11SP
9,Janssenlei 17,2021-01-30,18:00:00,24,18,6,F11SP
9,Janssenlei 17,2021-01-30,19:00:00,12,4,8,F11SP
9,Janssenlei 17,2021-01-30,20:00:00,10,8,2,F11SP
9,Janssenlei 17,2021-01-30,21:00:00,14,8,6,F11SP
9,Janssenlei 17,2021-01-30,22:00:00,12,0,12,F11SP
9,Janssenlei 17,2021-01-30,23:00:00,10,0,10,F11SP
9,Janssenlei 17,2021-01-31,00:00:00,4,0,4,F11SP
9,Janssenlei 17,2021-01-31,01:00:00,4,2,2,F11SP
9,Janssenlei 17,2021-01-31,02:00:00,0,0,0,F11SP
9,Janssenlei 17,2021-01-31,03:00:00,2,2,0,F11SP
9,Janssenlei 17,2021-01-31,04:00:00,6,6,0,F11SP
9,Janssenlei 17,2021-01-31,05:00:00,6,4,2,F11SP
9,Janssenlei 17,2021-01-31,06:00:00,6,0,6,F11SP
9,Janssenlei 17,2021-01-31,07:00:00,12,4,8,F11SP
9,Janssenlei 17,2021-01-31,08:00:00,26,12,14,F11SP
9,Janssenlei 17,2021-01-31,09:00:00,92,44,48,F11SP
9,Janssenlei 17,2021-01-31,10:00:00,136,62,74,F11SP
9,Janssenlei 17,2021-01-31,11:00:00,206,58,148,F11SP
9,Janssenlei 17,2021-01-31,12:00:00,280,148,132,F11SP
9,Janssenlei 17,2021-01-31,13:00:00,260,136,124,F11SP
9,Janssenlei 17,2021-01-31,14:00:00,276,118,158,F11SP
9,Janssenlei 17,2021-01-31,15:00:00,164,78,86,F11SP
9,Janssenlei 17,2021-01-31,16:00:00,78,38,40,F11SP
9,Janssenlei 17,2021-01-31,17:00:00,50,32,18,F11SP
9,Janssenlei 17,2021-01-31,18:00:00,26,16,10,F11SP
9,Janssenlei 17,2021-01-31,19:00:00,12,8,4,F11SP
9,Janssenlei 17,2021-01-31,20:00:00,10,6,4,F11SP
9,Janssenlei 17,2021-01-31,21:00:00,12,8,4,F11SP
9,Janssenlei 17,2021-01-31,22:00:00,14,4,10,F11SP
9,Janssenlei 17,2021-01-31,23:00:00,2,2,0,F11SP
9,Janssenlei 17,2021-02-01,00:00:00,0,0,0,F11SP
9,Janssenlei 17,2021-02-01,01:00:00,0,0,0,F11SP
9,Janssenlei 17,2021-02-01,02:00:00,0,0,0,F11SP
9,Janssenlei 17,2021-02-01,03:00:00,2,2,0,F11SP
9,Janssenlei 17,2021-02-01,04:00:00,6,6,0,F11SP
9,Janssenlei 17,2021-02-01,05:00:00,20,14,6,F11SP
9,Janssenlei 17,2021-02-01,06:00:00,60,36,24,F11SP
9,Janssenlei 17,2021-02-01,07:00:00,218,136,82,F11SP
9,Janssenlei 17,2021-02-01,08:00:00,248,160,88,F11SP
9,Janssenlei 17,2021-02-01,09:00:00,48,34,14,F11SP
9,Janssenlei 17,2021-02-01,10:00:00,92,40,52,F11SP
9,Janssenlei 17,2021-02-01,11:00:00,84,58,26,F11SP
9,Janssenlei 17,2021-02-01,12:00:00,94,36,58,F11SP
9,Janssenlei 17,2021-02-01,13:00:00,102,60,42,F11SP
9,Janssenlei 17,2021-02-01,14:00:00,112,58,54,F11SP
9,Janssenlei 17,2021-02-01,15:00:00,148,56,92,F11SP
9,Janssenlei 17,2021-02-01,16:00:00,296,124,172,F11SP
9,Janssenlei 17,2021-02-01,17:00:00,166,66,100,F11SP
9,Janssenlei 17,2021-02-01,18:00:00,46,18,28,F11SP
9,Janssenlei 17,2021-02-01,19:00:00,34,18,16,F11SP
9,Janssenlei 17,2021-02-01,20:00:00,18,8,10,F11SP
9,Janssenlei 17,2021-02-01,21:00:00,32,12,20,F11SP
9,Janssenlei 17,2021-02-01,22:00:00,34,6,28,F11SP
9,Janssenlei 17,2021-02-01,23:00:00,4,2,2,F11SP
9,Janssenlei 17,2021-02-02,00:00:00,0,0,0,F11SP
9,Janssenlei 17,2021-02-02,01:00:00,2,2,0,F11SP
9,Janssenlei 17,2021-02-02,02:00:00,0,0,0,F11SP
9,Janssenlei 17,2021-02-02,03:00:00,2,2,0,F11SP
9,Janssenlei 17,2021-02-02,04:00:00,6,6,0,F11SP
9,Janssenlei 17,2021-02-02,05:00:00,20,18,2,F11SP
9,Janssenlei 17,2021-02-02,06:00:00,40,28,12,F11SP
9,Janssenlei 17,2021-02-02,07:00:00,170,98,72,F11SP
9,Janssenlei 17,2021-02-02,08:00:00,172,122,50,F11SP
9,Janssenlei 17,2021-02-02,09:00:00,48,30,18,F11SP
9,Janssenlei 17,2021-02-02,10:00:00,26,10,16,F11SP
9,Janssenlei 17,2021-02-02,11:00:00,44,30,14,F11SP
9,Janssenlei 17,2021-02-02,12:00:00,60,26,34,F11SP
9,Janssenlei 17,2021-02-02,13:00:00,76,40,36,F11SP
9,Janssenlei 17,2021-02-02,14:00:00,60,26,34,F11SP
9,Janssenlei 17,2021-02-02,15:00:00,160,62,98,F11SP
9,Janssenlei 17,2021-02-02,16:00:00,266,102,164,F11SP
9,Janssenlei 17,2021-02-02,17:00:00,120,44,76,F11SP
9,Janssenlei 17,2021-02-02,18:00:00,92,42,50,F11SP
9,Janssenlei 17,2021-02-02,19:00:00,30,14,16,F11SP
9,Janssenlei 17,2021-02-02,20:00:00,26,22,4,F11SP
9,Janssenlei 17,2021-02-02,21:00:00,14,8,6,F11SP
9,Janssenlei 17,2021-02-02,22:00:00,32,0,32,F11SP
9,Janssenlei 17,2021-02-02,23:00:00,6,2,4,F11SP
9,Janssenlei 17,2021-02-03,00:00:00,0,0,0,F11SP
9,Janssenlei 17,2021-02-03,01:00:00,0,0,0,F11SP
9,Janssenlei 17,2021-02-03,02:00:00,0,0,0,F11SP
9,Janssenlei 17,2021-02-03,03:00:00,0,0,0,F11SP
9,Janssenlei 17,2021-02-03,04:00:00,2,2,0,F11SP
9,Janssenlei 17,2021-02-03,05:00:00,28,24,4,F11SP
9,Janssenlei 17,2021-02-03,06:00:00,48,30,18,F11SP
9,Janssenlei 17,2021-02-03,07:00:00,158,98,60,F11SP
9,Janssenlei 17,2021-02-03,08:00:00,170,116,54,F11SP
9,Janssenlei 17,2021-02-03,09:00:00,26,14,12,F11SP
9,Janssenlei 17,2021-02-03,10:00:00,26,10,16,F11SP
9,Janssenlei 17,2021-02-03,11:00:00,42,18,24,F11SP
9,Janssenlei 17,2021-02-03,12:00:00,120,54,66,F11SP
9,Janssenlei 17,2021-02-03,13:00:00,54,26,28,F11SP
9,Janssenlei 17,2021-02-03,14:00:00,40,14,26,F11SP
9,Janssenlei 17,2021-02-03,15:00:00,70,20,50,F11SP
9,Janssenlei 17,2021-02-03,16:00:00,94,40,54,F11SP
9,Janssenlei 17,2021-02-03,17:00:00,82,34,48,F11SP
9,Janssenlei 17,2021-02-03,18:00:00,42,20,22,F11SP
9,Janssenlei 17,2021-02-03,19:00:00,24,6,18,F11SP
9,Janssenlei 17,2021-02-03,20:00:00,22,6,16,F11SP
9,Janssenlei 17,2021-02-03,21:00:00,6,6,0,F11SP
9,Janssenlei 17,2021-02-03,22:00:00,30,4,26,F11SP
9,Janssenlei 17,2021-02-03,23:00:00,6,2,4,F11SP
9,Janssenlei 17,2021-02-04,00:00:00,2,0,2,F11SP
9,Janssenlei 17,2021-02-04,01:00:00,0,0,0,F11SP
9,Janssenlei 17,2021-02-04,02:00:00,0,0,0,F11SP
9,Janssenlei 17,2021-02-04,03:00:00,0,0,0,F11SP
9,Janssenlei 17,2021-02-04,04:00:00,4,4,0,F11SP
9,Janssenlei 17,2021-02-04,05:00:00,24,20,4,F11SP
9,Janssenlei 17,2021-02-04,06:00:00,78,54,24,F11SP
9,Janssenlei 17,2021-02-04,07:00:00,236,150,86,F11SP
9,Janssenlei 17,2021-02-04,08:00:00,252,164,88,F11SP
9,Janssenlei 17,2021-02-04,09:00:00,140,66,74,F11SP
9,Janssenlei 17,2021-02-04,10:00:00,192,96,96,F11SP
9,Janssenlei 17,2021-02-04,11:00:00,160,80,80,F11SP
9,Janssenlei 17,2021-02-04,12:00:00,180,80,100,F11SP
9,Janssenlei 17,2021-02-04,13:00:00,290,142,148,F11SP
9,Janssenlei 17,2021-02-04,14:00:00,276,118,158,F11SP
9,Janssenlei 17,2021-02-04,15:00:00,316,156,160,F11SP
9,Janssenlei 17,2021-02-04,16:00:00,374,148,226,F11SP
9,Janssenlei 17,2021-02-04,17:00:00,226,90,136,F11SP
9,Janssenlei 17,2021-02-04,18:00:00,110,32,78,F11SP
9,Janssenlei 17,2021-02-04,19:00:00,42,12,30,F11SP
9,Janssenlei 17,2021-02-04,20:00:00,28,14,14,F11SP
9,Janssenlei 17,2021-02-04,21:00:00,10,10,0,F11SP
9,Janssenlei 17,2021-02-04,22:00:00,32,8,24,F11SP
9,Janssenlei 17,2021-02-04,23:00:00,16,4,12,F11SP
9,Janssenlei 17,2021-02-05,00:00:00,0,0,0,F11SP
9,Janssenlei 17,2021-02-05,01:00:00,0,0,0,F11SP
9,Janssenlei 17,2021-02-05,02:00:00,0,0,0,F11SP
9,Janssenlei 17,2021-02-05,03:00:00,0,0,0,F11SP
9,Janssenlei 17,2021-02-05,04:00:00,10,8,2,F11SP
9,Janssenlei 17,2021-02-05,05:00:00,24,20,4,F11SP
9,Janssenlei 17,2021-02-05,06:00:00,72,52,20,F11SP
9,Janssenlei 17,2021-02-05,07:00:00,210,132,78,F11SP
9,Janssenlei 17,2021-02-05,08:00:00,260,180,80,F11SP
9,Janssenlei 17,2021-02-05,09:00:00,96,48,48,F11SP
9,Janssenlei 17,2021-02-05,10:00:00,112,50,62,F11SP
9,Janssenlei 17,2021-02-05,11:00:00,156,84,72,F11SP
9,Janssenlei 17,2021-02-05,12:00:00,144,68,76,F11SP
9,Janssenlei 17,2021-02-05,13:00:00,252,116,136,F11SP
9,Janssenlei 17,2021-02-05,14:00:00,330,140,190,F11SP
9,Janssenlei 17,2021-02-05,15:00:00,396,178,218,F11SP
9,Janssenlei 17,2021-02-05,16:00:00,332,146,186,F11SP
9,Janssenlei 17,2021-02-05,17:00:00,204,94,110,F11SP
9,Janssenlei 17,2021-02-05,18:00:00,112,60,52,F11SP
9,Janssenlei 17,2021-02-05,19:00:00,68,24,44,F11SP
9,Janssenlei 17,2021-02-05,20:00:00,34,8,26,F11SP
9,Janssenlei 17,2021-02-05,21:00:00,18,10,8,F11SP
9,Janssenlei 17,2021-02-05,22:00:00,156,68,88,F11SP
9,Janssenlei 17,2021-02-05,23:00:00,50,42,8,F11SP
9,Janssenlei 17,2021-02-06,00:00:00,4,0,4,F11SP
9,Janssenlei 17,2021-02-06,01:00:00,2,2,0,F11SP
9,Janssenlei 17,2021-02-06,02:00:00,4,4,0,F11SP
9,Janssenlei 17,2021-02-06,03:00:00,0,0,0,F11SP
9,Janssenlei 17,2021-02-06,04:00:00,2,2,0,F11SP
9,Janssenlei 17,2021-02-06,05:00:00,6,4,2,F11SP
9,Janssenlei 17,2021-02-06,06:00:00,14,6,8,F11SP
9,Janssenlei 17,2021-02-06,07:00:00,24,10,14,F11SP
9,Janssenlei 17,2021-02-06,08:00:00,50,10,40,F11SP
9,Janssenlei 17,2021-02-06,09:00:00,118,44,74,F11SP
9,Janssenlei 17,2021-02-06,10:00:00,154,86,68,F11SP
9,Janssenlei 17,2021-02-06,11:00:00,134,68,66,F11SP
9,Janssenlei 17,2021-02-06,12:00:00,206,128,78,F11SP
9,Janssenlei 17,2021-02-06,13:00:00,128,74,54,F11SP
9,Janssenlei 17,2021-02-06,14:00:00,114,60,54,F11SP
9,Janssenlei 17,2021-02-06,15:00:00,92,34,58,F11SP
9,Janssenlei 17,2021-02-06,16:00:00,118,72,46,F11SP
9,Janssenlei 17,2021-02-06,17:00:00,66,26,40,F11SP
9,Janssenlei 17,2021-02-06,18:00:00,16,10,6,F11SP
9,Janssenlei 17,2021-02-06,19:00:00,22,8,14,F11SP
9,Janssenlei 17,2021-02-06,20:00:00,14,6,8,F11SP
9,Janssenlei 17,2021-02-06,21:00:00,16,12,4,F11SP
9,Janssenlei 17,2021-02-06,22:00:00,18,8,10,F11SP
9,Janssenlei 17,2021-02-06,23:00:00,8,2,6,F11SP
9,Janssenlei 17,2021-12-14,00:00:00,0,0,0,F11SP
9,Janssenlei 17,2021-12-14,01:00:00,0,0,0,F11SP
9,Janssenlei 17,2021-12-14,02:00:00,0,0,0,F11SP
9,Janssenlei 17,2021-12-14,03:00:00,0,0,0,F11SP
9,Janssenlei 17,2021-12-14,04:00:00,0,0,0,F11SP
9,Janssenlei 17,2021-12-14,05:00:00,0,0,0,F11SP
9,Janssenlei 17,2021-12-14,06:00:00,0,0,0,F11SP
9,Janssenlei 17,2021-12-14,07:00:00,0,0,0,F11SP
9,Janssenlei 17,2021-12-14,08:00:00,0,0,0,F11SP
9,Janssenlei 17,2021-12-14,09:00:00,0,0,0,F11SP
9,Janssenlei 17,2021-12-14,10:00:00,0,0,0,F11SP
9,Janssenlei 17,2021-12-14,11:00:00,28,8,20,F11SP
9,Janssenlei 17,2021-12-14,12:00:00,144,66,78,F11SP
9,Janssenlei 17,2021-12-14,13:00:00,168,82,86,F11SP
9,Janssenlei 17,2021-12-14,14:00:00,140,68,72,F11SP
9,Janssenlei 17,2021-12-14,15:00:00,154,48,106,F11SP
9,Janssenlei 17,2021-12-14,16:00:00,206,94,112,F11SP
9,Janssenlei 17,2021-12-14,17:00:00,220,84,136,F11SP
9,Janssenlei 17,2021-12-14,18:00:00,108,36,72,F11SP
9,Janssenlei 17,2021-12-14,19:00:00,58,22,36,F11SP
9,Janssenlei 17,2021-12-14,20:00:00,44,32,12,F11SP
9,Janssenlei 17,2021-12-14,21:00:00,24,16,8,F11SP
9,Janssenlei 17,2021-12-14,22:00:00,24,8,16,F11SP
9,Janssenlei 17,2021-12-14,23:00:00,20,2,18,F11SP
9,Janssenlei 17,2021-12-15,00:00:00,4,2,2,F11SP
9,Janssenlei 17,2021-12-15,01:00:00,0,0,0,F11SP
9,Janssenlei 17,2021-12-15,02:00:00,0,0,0,F11SP
9,Janssenlei 17,2021-12-15,03:00:00,0,0,0,F11SP
9,Janssenlei 17,2021-12-15,04:00:00,8,6,2,F11SP
9,Janssenlei 17,2021-12-15,05:00:00,28,20,8,F11SP
9,Janssenlei 17,2021-12-15,06:00:00,72,46,26,F11SP
9,Janssenlei 17,2021-12-15,07:00:00,224,136,88,F11SP
9,Janssenlei 17,2021-12-15,08:00:00,264,202,62,F11SP
9,Janssenlei 17,2021-12-15,09:00:00,104,56,48,F11SP
9,Janssenlei 17,2021-12-15,10:00:00,172,64,108,F11SP
9,Janssenlei 17,2021-12-15,11:00:00,166,74,92,F11SP
9,Janssenlei 17,2021-12-15,12:00:00,158,66,92,F11SP
9,Janssenlei 17,2021-12-15,13:00:00,140,58,82,F11SP
9,Janssenlei 17,2021-12-15,14:00:00,148,58,90,F11SP
9,Janssenlei 17,2021-12-15,15:00:00,184,86,98,F11SP
9,Janssenlei 17,2021-12-15,16:00:00,206,84,122,F11SP
9,Janssenlei 17,2021-12-15,17:00:00,186,64,122,F11SP
9,Janssenlei 17,2021-12-15,18:00:00,78,40,38,F11SP
9,Janssenlei 17,2021-12-15,19:00:00,54,26,28,F11SP
9,Janssenlei 17,2021-12-15,20:00:00,20,8,12,F11SP
9,Janssenlei 17,2021-12-15,21:00:00,44,20,24,F11SP
9,Janssenlei 17,2021-12-15,22:00:00,34,8,26,F11SP
9,Janssenlei 17,2021-12-15,23:00:00,18,2,16,F11SP
9,Janssenlei 17,2021-12-16,00:00:00,2,0,2,F11SP
9,Janssenlei 17,2021-12-16,01:00:00,2,0,2,F11SP
9,Janssenlei 17,2021-12-16,02:00:00,0,0,0,F11SP
9,Janssenlei 17,2021-12-16,03:00:00,2,0,2,F11SP
9,Janssenlei 17,2021-12-16,04:00:00,8,8,0,F11SP
9,Janssenlei 17,2021-12-16,05:00:00,36,26,10,F11SP
9,Janssenlei 17,2021-12-16,06:00:00,68,46,22,F11SP
9,Janssenlei 17,2021-12-16,07:00:00,254,166,88,F11SP
9,Janssenlei 17,2021-12-16,08:00:00,328,222,106,F11SP
9,Janssenlei 17,2021-12-16,09:00:00,140,74,66,F11SP
9,Janssenlei 17,2021-12-16,10:00:00,150,62,88,F11SP
9,Janssenlei 17,2021-12-16,11:00:00,110,60,50,F11SP
9,Janssenlei 17,2021-12-16,12:00:00,170,76,94,F11SP
9,Janssenlei 17,2021-12-16,13:00:00,174,70,104,F11SP
9,Janssenlei 17,2021-12-16,14:00:00,242,98,144,F11SP
9,Janssenlei 17,2021-12-16,15:00:00,296,124,172,F11SP
9,Janssenlei 17,2021-12-16,16:00:00,294,124,170,F11SP
9,Janssenlei 17,2021-12-16,17:00:00,192,74,118,F11SP
9,Janssenlei 17,2021-12-16,18:00:00,126,54,72,F11SP
9,Janssenlei 17,2021-12-16,19:00:00,64,26,38,F11SP
9,Janssenlei 17,2021-12-16,20:00:00,36,10,26,F11SP
9,Janssenlei 17,2021-12-16,21:00:00,28,12,16,F11SP
9,Janssenlei 17,2021-12-16,22:00:00,36,2,34,F11SP
9,Janssenlei 17,2021-12-16,23:00:00,12,0,12,F11SP
9,Janssenlei 17,2021-12-17,00:00:00,2,2,0,F11SP
9,Janssenlei 17,2021-12-17,01:00:00,2,2,0,F11SP
9,Janssenlei 17,2021-12-17,02:00:00,2,0,2,F11SP
9,Janssenlei 17,2021-12-17,03:00:00,0,0,0,F11SP
9,Janssenlei 17,2021-12-17,04:00:00,6,6,0,F11SP
9,Janssenlei 17,2021-12-17,05:00:00,32,22,10,F11SP
9,Janssenlei 17,2021-12-17,06:00:00,56,38,18,F11SP
9,Janssenlei 17,2021-12-17,07:00:00,212,128,84,F11SP
9,Janssenlei 17,2021-12-17,08:00:00,260,186,74,F11SP
9,Janssenlei 17,2021-12-17,09:00:00,100,48,52,F11SP
9,Janssenlei 17,2021-12-17,10:00:00,156,42,114,F11SP
9,Janssenlei 17,2021-12-17,11:00:00,130,80,50,F11SP
9,Janssenlei 17,2021-12-17,12:00:00,172,82,90,F11SP
9,Janssenlei 17,2021-12-17,13:00:00,90,44,46,F11SP
9,Janssenlei 17,2021-12-17,14:00:00,160,60,100,F11SP
9,Janssenlei 17,2021-12-17,15:00:00,210,90,120,F11SP
9,Janssenlei 17,2021-12-17,16:00:00,160,74,86,F11SP
9,Janssenlei 17,2021-12-17,17:00:00,132,52,80,F11SP
9,Janssenlei 17,2021-12-17,18:00:00,102,44,58,F11SP
9,Janssenlei 17,2021-12-17,19:00:00,44,30,14,F11SP
9,Janssenlei 17,2021-12-17,20:00:00,52,14,38,F11SP
9,Janssenlei 17,2021-12-17,21:00:00,16,6,10,F11SP
9,Janssenlei 17,2021-12-17,22:00:00,24,8,16,F11SP
9,Janssenlei 17,2021-12-17,23:00:00,24,6,18,F11SP
9,Janssenlei 17,2021-12-18,00:00:00,10,4,6,F11SP
9,Janssenlei 17,2021-12-18,01:00:00,12,8,4,F11SP
9,Janssenlei 17,2021-12-18,02:00:00,8,4,4,F11SP
9,Janssenlei 17,2021-12-18,03:00:00,6,0,6,F11SP
9,Janssenlei 17,2021-12-18,04:00:00,6,4,2,F11SP
9,Janssenlei 17,2021-12-18,05:00:00,14,12,2,F11SP
9,Janssenlei 17,2021-12-18,06:00:00,6,4,2,F11SP
9,Janssenlei 17,2021-12-18,07:00:00,14,6,8,F11SP
9,Janssenlei 17,2021-12-18,08:00:00,30,8,22,F11SP
9,Janssenlei 17,2021-12-18,09:00:00,98,44,54,F11SP
9,Janssenlei 17,2021-12-18,10:00:00,96,62,34,F11SP
9,Janssenlei 17,2021-12-18,11:00:00,182,130,52,F11SP
9,Janssenlei 17,2021-12-18,12:00:00,130,50,80,F11SP
9,Janssenlei 17,2021-12-18,13:00:00,102,68,34,F11SP
9,Janssenlei 17,2021-12-18,14:00:00,158,86,72,F11SP
9,Janssenlei 17,2021-12-18,15:00:00,152,94,58,F11SP
9,Janssenlei 17,2021-12-18,16:00:00,130,70,60,F11SP
9,Janssenlei 17,2021-12-18,17:00:00,64,28,36,F11SP
9,Janssenlei 17,2021-12-18,18:00:00,46,22,24,F11SP
9,Janssenlei 17,2021-12-18,19:00:00,34,14,20,F11SP
9,Janssenlei 17,2021-12-18,20:00:00,24,12,12,F11SP
9,Janssenlei 17,2021-12-18,21:00:00,16,2,14,F11SP
9,Janssenlei 17,2021-12-18,22:00:00,12,2,10,F11SP
9,Janssenlei 17,2021-12-18,23:00:00,20,2,18,F11SP
9,Janssenlei 17,2021-12-19,00:00:00,10,4,6,F11SP
9,Janssenlei 17,2021-12-19,01:00:00,4,2,2,F11SP
9,Janssenlei 17,2021-12-19,02:00:00,4,2,2,F11SP
9,Janssenlei 17,2021-12-19,03:00:00,4,0,4,F11SP
9,Janssenlei 17,2021-12-19,04:00:00,0,0,0,F11SP
9,Janssenlei 17,2021-12-19,05:00:00,8,6,2,F11SP
9,Janssenlei 17,2021-12-19,06:00:00,16,10,6,F11SP
9,Janssenlei 17,2021-12-19,07:00:00,12,8,4,F11SP
9,Janssenlei 17,2021-12-19,08:00:00,40,12,28,F11SP
9,Janssenlei 17,2021-12-19,09:00:00,58,12,46,F11SP
9,Janssenlei 17,2021-12-19,10:00:00,168,78,90,F11SP
9,Janssenlei 17,2021-12-19,11:00:00,152,74,78,F11SP
9,Janssenlei 17,2021-12-19,12:00:00,146,82,64,F11SP
9,Janssenlei 17,2021-12-19,13:00:00,106,54,52,F11SP
9,Janssenlei 17,2021-12-19,14:00:00,148,68,80,F11SP
9,Janssenlei 17,2021-12-19,15:00:00,138,66,72,F11SP
9,Janssenlei 17,2021-12-19,16:00:00,68,40,28,F11SP
9,Janssenlei 17,2021-12-19,17:00:00,66,28,38,F11SP
9,Janssenlei 17,2021-12-19,18:00:00,24,12,12,F11SP
9,Janssenlei 17,2021-12-19,19:00:00,4,0,4,F11SP
9,Janssenlei 17,2021-12-19,20:00:00,26,20,6,F11SP
9,Janssenlei 17,2021-12-19,21:00:00,20,6,14,F11SP
9,Janssenlei 17,2021-12-19,22:00:00,18,4,14,F11SP
9,Janssenlei 17,2021-12-19,23:00:00,2,0,2,F11SP
9,Janssenlei 17,2021-12-20,00:00:00,4,2,2,F11SP
9,Janssenlei 17,2021-12-20,01:00:00,6,2,4,F11SP
9,Janssenlei 17,2021-12-20,02:00:00,0,0,0,F11SP
9,Janssenlei 17,2021-12-20,03:00:00,2,2,0,F11SP
9,Janssenlei 17,2021-12-20,04:00:00,2,2,0,F11SP
9,Janssenlei 17,2021-12-20,05:00:00,30,22,8,F11SP
9,Janssenlei 17,2021-12-20,06:00:00,56,42,14,F11SP
9,Janssenlei 17,2021-12-20,07:00:00,198,120,78,F11SP
9,Janssenlei 17,2021-12-20,08:00:00,246,166,80,F11SP
9,Janssenlei 17,2021-12-20,09:00:00,88,46,42,F11SP
9,Janssenlei 17,2021-12-20,10:00:00,144,58,86,F11SP
9,Janssenlei 17,2021-12-20,11:00:00,112,44,68,F11SP
9,Janssenlei 17,2021-12-20,12:00:00,160,90,70,F11SP
9,Janssenlei 17,2021-12-20,13:00:00,110,60,50,F11SP
9,Janssenlei 17,2021-12-20,14:00:00,170,86,84,F11SP
9,Janssenlei 17,2021-12-20,15:00:00,158,68,90,F11SP
9,Janssenlei 17,2021-12-20,16:00:00,154,62,92,F11SP
9,Janssenlei 17,2021-12-20,17:00:00,146,46,100,F11SP
9,Janssenlei 17,2021-12-20,18:00:00,86,42,44,F11SP
9,Janssenlei 17,2021-12-20,19:00:00,44,22,22,F11SP
9,Janssenlei 17,2021-12-20,20:00:00,52,28,24,F11SP
9,Janssenlei 17,2021-12-20,21:00:00,26,16,10,F11SP
9,Janssenlei 17,2021-12-20,22:00:00,20,2,18,F11SP
9,Janssenlei 17,2021-12-20,23:00:00,12,2,10,F11SP
9,Janssenlei 17,2021-12-21,00:00:00,6,2,4,F11SP
9,Janssenlei 17,2021-12-21,01:00:00,0,0,0,F11SP
9,Janssenlei 17,2021-12-21,02:00:00,0,0,0,F11SP
9,Janssenlei 17,2021-12-21,03:00:00,0,0,0,F11SP
9,Janssenlei 17,2021-12-21,04:00:00,10,8,2,F11SP
9,Janssenlei 17,2021-12-21,05:00:00,30,22,8,F11SP
9,Janssenlei 17,2021-12-21,06:00:00,62,42,20,F11SP
9,Janssenlei 17,2021-12-21,07:00:00,174,100,74,F11SP
9,Janssenlei 17,2021-12-21,08:00:00,150,94,56,F11SP
9,Janssenlei 17,2021-12-21,09:00:00,96,42,54,F11SP
9,Janssenlei 17,2021-12-21,10:00:00,68,32,36,F11SP
9,Janssenlei 17,2021-12-21,11:00:00,96,48,48,F11SP
9,Janssenlei 17,2021-12-21,12:00:00,114,56,58,F11SP
9,Janssenlei 17,2021-12-21,13:00:00,152,62,90,F11SP
9,Janssenlei 17,2021-12-21,14:00:00,170,56,114,F11SP
9,Janssenlei 17,2021-12-21,15:00:00,122,46,76,F11SP
9,Janssenlei 17,2021-12-21,16:00:00,172,80,92,F11SP
9,Janssenlei 17,2021-12-21,17:00:00,196,84,112,F11SP
9,Janssenlei 17,2021-12-21,18:00:00,86,26,60,F11SP
9,Janssenlei 17,2021-12-21,19:00:00,46,22,24,F11SP
9,Janssenlei 17,2021-12-21,20:00:00,28,14,14,F11SP
9,Janssenlei 17,2021-12-21,21:00:00,22,12,10,F11SP
9,Janssenlei 17,2021-12-21,22:00:00,22,6,16,F11SP
9,Janssenlei 17,2021-12-21,23:00:00,28,10,18,F11SP
9,Janssenlei 17,2021-12-22,00:00:00,10,6,4,F11SP
9,Janssenlei 17,2021-12-22,01:00:00,2,2,0,F11SP
9,Janssenlei 17,2021-12-22,02:00:00,2,0,2,F11SP
9,Janssenlei 17,2021-12-22,03:00:00,0,0,0,F11SP
9,Janssenlei 17,2021-12-22,04:00:00,6,6,0,F11SP
9,Janssenlei 17,2021-12-22,05:00:00,16,12,4,F11SP
9,Janssenlei 17,2021-12-22,06:00:00,40,26,14,F11SP
9,Janssenlei 17,2021-12-22,07:00:00,122,72,50,F11SP
9,Janssenlei 17,2021-12-22,08:00:00,110,68,42,F11SP
9,Janssenlei 17,2021-12-22,09:00:00,72,42,30,F11SP
9,Janssenlei 17,2021-12-22,10:00:00,78,42,36,F11SP
9,Janssenlei 17,2021-12-22,11:00:00,72,36,36,F11SP
9,Janssenlei 17,2021-12-22,12:00:00,126,68,58,F11SP
9,Janssenlei 17,2021-12-22,13:00:00,96,44,52,F11SP
9,Janssenlei 17,2021-12-22,14:00:00,152,66,86,F11SP
9,Janssenlei 17,2021-12-22,15:00:00,136,50,86,F11SP
9,Janssenlei 17,2021-12-22,16:00:00,136,62,74,F11SP
9,Janssenlei 17,2021-12-22,17:00:00,132,58,74,F11SP
9,Janssenlei 17,2021-12-22,18:00:00,78,32,46,F11SP
9,Janssenlei 17,2021-12-22,19:00:00,32,14,18,F11SP
9,Janssenlei 17,2021-12-22,20:00:00,22,12,10,F11SP
9,Janssenlei 17,2021-12-22,21:00:00,32,14,18,F11SP
9,Janssenlei 17,2021-12-22,22:00:00,22,2,20,F11SP
9,Janssenlei 17,2021-12-22,23:00:00,10,4,6,F11SP
9,Janssenlei 17,2021-12-23,00:00:00,0,0,0,F11SP
9,Janssenlei 17,2021-12-23,01:00:00,0,0,0,F11SP
9,Janssenlei 17,2021-12-23,02:00:00,0,0,0,F11SP
9,Janssenlei 17,2021-12-23,03:00:00,0,0,0,F11SP
9,Janssenlei 17,2021-12-23,04:00:00,4,4,0,F11SP
9,Janssenlei 17,2021-12-23,05:00:00,26,18,8,F11SP
9,Janssenlei 17,2021-12-23,06:00:00,42,30,12,F11SP
9,Janssenlei 17,2021-12-23,07:00:00,126,76,50,F11SP
9,Janssenlei 17,2021-12-23,08:00:00,198,156,42,F11SP
9,Janssenlei 17,2021-12-23,09:00:00,68,36,32,F11SP
9,Janssenlei 17,2021-12-23,10:00:00,132,60,72,F11SP
9,Janssenlei 17,2021-12-23,11:00:00,92,46,46,F11SP
9,Janssenlei 17,2021-12-23,12:00:00,86,30,56,F11SP
9,Janssenlei 17,2021-12-23,13:00:00,116,68,48,F11SP
9,Janssenlei 17,2021-12-23,14:00:00,140,66,74,F11SP
9,Janssenlei 17,2021-12-23,15:00:00,148,66,82,F11SP
9,Janssenlei 17,2021-12-23,16:00:00,130,60,70,F11SP
9,Janssenlei 17,2021-12-23,17:00:00,122,32,90,F11SP
9,Janssenlei 17,2021-12-23,18:00:00,68,18,50,F11SP
9,Janssenlei 17,2021-12-23,19:00:00,50,20,30,F11SP
9,Janssenlei 17,2021-12-23,20:00:00,24,10,14,F11SP
9,Janssenlei 17,2021-12-23,21:00:00,22,12,10,F11SP
9,Janssenlei 17,2021-12-23,22:00:00,22,4,18,F11SP
9,Janssenlei 17,2021-12-23,23:00:00,6,0,6,F11SP
9,Janssenlei 17,2021-12-24,00:00:00,6,2,4,F11SP
9,Janssenlei 17,2021-12-24,01:00:00,4,0,4,F11SP
9,Janssenlei 17,2021-12-24,02:00:00,0,0,0,F11SP
9,Janssenlei 17,2021-12-24,03:00:00,0,0,0,F11SP
9,Janssenlei 17,2021-12-24,04:00:00,6,4,2,F11SP
9,Janssenlei 17,2021-12-24,05:00:00,6,4,2,F11SP
9,Janssenlei 17,2021-12-24,06:00:00,8,8,0,F11SP
9,Janssenlei 17,2021-12-24,07:00:00,66,38,28,F11SP
9,Janssenlei 17,2021-12-24,08:00:00,84,48,36,F11SP
9,Janssenlei 17,2021-12-24,09:00:00,122,56,66,F11SP
9,Janssenlei 17,2021-12-24,10:00:00,116,56,60,F11SP
9,Janssenlei 17,2021-12-24,11:00:00,128,80,48,F11SP
9,Janssenlei 17,2021-12-24,12:00:00,96,40,56,F11SP
9,Janssenlei 17,2021-12-24,13:00:00,116,58,58,F11SP
9,Janssenlei 17,2021-12-24,14:00:00,118,48,70,F11SP
9,Janssenlei 17,2021-12-24,15:00:00,118,64,54,F11SP
9,Janssenlei 17,2021-12-24,16:00:00,110,56,54,F11SP
9,Janssenlei 17,2021-12-24,17:00:00,48,14,34,F11SP
9,Janssenlei 17,2021-12-24,18:00:00,26,10,16,F11SP
9,Janssenlei 17,2021-12-24,19:00:00,8,2,6,F11SP
9,Janssenlei 17,2021-12-24,20:00:00,8,4,4,F11SP
9,Janssenlei 17,2021-12-24,21:00:00,8,4,4,F11SP
9,Janssenlei 17,2021-12-24,22:00:00,2,0,2,F11SP
9,Janssenlei 17,2021-12-24,23:00:00,2,0,2,F11SP
9,Janssenlei 17,2021-12-25,00:00:00,14,0,14,F11SP
9,Janssenlei 17,2021-12-25,01:00:00,12,6,6,F11SP
9,Janssenlei 17,2021-12-25,02:00:00,4,2,2,F11SP
9,Janssenlei 17,2021-12-25,03:00:00,6,6,0,F11SP
9,Janssenlei 17,2021-12-25,04:00:00,0,0,0,F11SP
9,Janssenlei 17,2021-12-25,05:00:00,4,4,0,F11SP
9,Janssenlei 17,2021-12-25,06:00:00,4,4,0,F11SP
9,Janssenlei 17,2021-12-25,07:00:00,6,2,4,F11SP
9,Janssenlei 17,2021-12-25,08:00:00,18,10,8,F11SP
9,Janssenlei 17,2021-12-25,09:00:00,20,6,14,F11SP
9,Janssenlei 17,2021-12-25,10:00:00,30,12,18,F11SP
9,Janssenlei 17,2021-12-25,11:00:00,46,18,28,F11SP
9,Janssenlei 17,2021-12-25,12:00:00,60,26,34,F11SP
9,Janssenlei 17,2021-12-25,13:00:00,46,32,14,F11SP
9,Janssenlei 17,2021-12-25,14:00:00,56,28,28,F11SP
9,Janssenlei 17,2021-12-25,15:00:00,40,22,18,F11SP
9,Janssenlei 17,2021-12-25,16:00:00,34,18,16,F11SP
9,Janssenlei 17,2021-12-25,17:00:00,32,10,22,F11SP
9,Janssenlei 17,2021-12-25,18:00:00,20,8,12,F11SP
9,Janssenlei 17,2021-12-25,19:00:00,10,6,4,F11SP
9,Janssenlei 17,2021-12-25,20:00:00,12,6,6,F11SP
9,Janssenlei 17,2021-12-25,21:00:00,10,6,4,F11SP
9,Janssenlei 17,2021-12-25,22:00:00,16,8,8,F11SP
9,Janssenlei 17,2021-12-25,23:00:00,14,4,10,F11SP
9,Janssenlei 17,2021-12-26,00:00:00,8,8,0,F11SP
9,Janssenlei 17,2021-12-26,01:00:00,2,0,2,F11SP
9,Janssenlei 17,2021-12-26,02:00:00,2,2,0,F11SP
9,Janssenlei 17,2021-12-26,03:00:00,0,0,0,F11SP
9,Janssenlei 17,2021-12-26,04:00:00,0,0,0,F11SP
9,Janssenlei 17,2021-12-26,05:00:00,8,6,2,F11SP
9,Janssenlei 17,2021-12-26,06:00:00,6,4,2,F11SP
9,Janssenlei 17,2021-12-26,07:00:00,8,2,6,F11SP
9,Janssenlei 17,2021-12-26,08:00:00,22,14,8,F11SP
9,Janssenlei 17,2021-12-26,09:00:00,96,26,70,F11SP
9,Janssenlei 17,2021-12-26,10:00:00,130,60,70,F11SP
9,Janssenlei 17,2021-12-26,11:00:00,152,84,68,F11SP
9,Janssenlei 17,2021-12-26,12:00:00,122,68,54,F11SP
9,Janssenlei 17,2021-12-26,13:00:00,130,74,56,F11SP
9,Janssenlei 17,2021-12-26,14:00:00,134,74,60,F11SP
9,Janssenlei 17,2021-12-26,15:00:00,76,28,48,F11SP
9,Janssenlei 17,2021-12-26,16:00:00,28,12,16,F11SP
9,Janssenlei 17,2021-12-26,17:00:00,28,18,10,F11SP
9,Janssenlei 17,2021-12-26,18:00:00,16,6,10,F11SP
9,Janssenlei 17,2021-12-26,19:00:00,20,8,12,F11SP
9,Janssenlei 17,2021-12-26,20:00:00,2,2,0,F11SP
9,Janssenlei 17,2021-12-26,21:00:00,8,4,4,F11SP
9,Janssenlei 17,2021-12-26,22:00:00,2,0,2,F11SP
9,Janssenlei 17,2021-12-26,23:00:00,4,2,2,F11SP
9,Janssenlei 17,2021-12-27,00:00:00,0,0,0,F11SP
9,Janssenlei 17,2021-12-27,01:00:00,2,0,2,F11SP
9,Janssenlei 17,2021-12-27,02:00:00,2,2,0,F11SP
9,Janssenlei 17,2021-12-27,03:00:00,2,0,2,F11SP
9,Janssenlei 17,2021-12-27,04:00:00,4,2,2,F11SP
9,Janssenlei 17,2021-12-27,05:00:00,14,8,6,F11SP
9,Janssenlei 17,2021-12-27,06:00:00,24,22,2,F11SP
9,Janssenlei 17,2021-12-27,07:00:00,56,34,22,F11SP
9,Janssenlei 17,2021-12-27,08:00:00,78,36,42,F11SP
9,Janssenlei 17,2021-12-27,09:00:00,76,40,36,F11SP
9,Janssenlei 17,2021-12-27,10:00:00,142,44,98,F11SP
9,Janssenlei 17,2021-12-27,11:00:00,120,62,58,F11SP
9,Janssenlei 17,2021-12-27,12:00:00,118,70,48,F11SP
9,Janssenlei 17,2021-12-27,13:00:00,106,58,48,F11SP
9,Janssenlei 17,2021-12-27,14:00:00,86,44,42,F11SP
9,Janssenlei 17,2021-12-27,15:00:00,62,30,32,F11SP
9,Janssenlei 17,2021-12-27,16:00:00,64,22,42,F11SP
9,Janssenlei 17,2021-12-27,17:00:00,68,28,40,F11SP
9,Janssenlei 17,2021-12-27,18:00:00,42,18,24,F11SP
9,Janssenlei 17,2021-12-27,19:00:00,28,14,14,F11SP
9,Janssenlei 17,2021-12-27,20:00:00,24,6,18,F11SP
9,Janssenlei 17,2021-12-27,21:00:00,18,6,12,F11SP
9,Janssenlei 17,2021-12-27,22:00:00,14,2,12,F11SP
9,Janssenlei 17,2021-12-27,23:00:00,4,2,2,F11SP
9,Janssenlei 17,2021-12-28,00:00:00,6,4,2,F11SP
9,Janssenlei 17,2021-12-28,01:00:00,4,0,4,F11SP
9,Janssenlei 17,2021-12-28,02:00:00,0,0,0,F11SP
9,Janssenlei 17,2021-12-28,03:00:00,0,0,0,F11SP
9,Janssenlei 17,2021-12-28,04:00:00,2,2,0,F11SP
9,Janssenlei 17,2021-12-28,05:00:00,18,8,10,F11SP
9,Janssenlei 17,2021-12-28,06:00:00,22,12,10,F11SP
9,Janssenlei 17,2021-12-28,07:00:00,44,28,16,F11SP
9,Janssenlei 17,2021-12-28,08:00:00,104,66,38,F11SP
9,Janssenlei 17,2021-12-28,09:00:00,26,12,14,F11SP
9,Janssenlei 17,2021-12-28,10:00:00,84,46,38,F11SP
9,Janssenlei 17,2021-12-28,11:00:00,88,44,44,F11SP
9,Janssenlei 17,2021-12-28,12:00:00,48,24,24,F11SP
9,Janssenlei 17,2021-12-28,13:00:00,70,44,26,F11SP
9,Janssenlei 17,2021-12-28,14:00:00,38,18,20,F11SP
9,Janssenlei 17,2021-12-28,15:00:00,46,14,32,F11SP
9,Janssenlei 17,2021-12-28,16:00:00,60,22,38,F11SP
9,Janssenlei 17,2021-12-28,17:00:00,72,36,36,F11SP
9,Janssenlei 17,2021-12-28,18:00:00,38,18,20,F11SP
9,Janssenlei 17,2021-12-28,19:00:00,30,16,14,F11SP
9,Janssenlei 17,2021-12-28,20:00:00,32,22,10,F11SP
9,Janssenlei 17,2021-12-28,21:00:00,14,8,6,F11SP
9,Janssenlei 17,2021-12-28,22:00:00,16,6,10,F11SP
9,Janssenlei 17,2021-12-28,23:00:00,2,0,2,F11SP
9,Janssenlei 17,2021-12-29,00:00:00,6,2,4,F11SP
9,Janssenlei 17,2021-12-29,01:00:00,4,4,0,F11SP
9,Janssenlei 17,2021-12-29,02:00:00,0,0,0,F11SP
9,Janssenlei 17,2021-12-29,03:00:00,0,0,0,F11SP
9,Janssenlei 17,2021-12-29,04:00:00,2,2,0,F11SP
9,Janssenlei 17,2021-12-29,05:00:00,12,6,6,F11SP
9,Janssenlei 17,2021-12-29,06:00:00,24,14,10,F11SP
9,Janssenlei 17,2021-12-29,07:00:00,40,28,12,F11SP
9,Janssenlei 17,2021-12-29,08:00:00,64,44,20,F11SP
9,Janssenlei 17,2021-12-29,09:00:00,70,42,28,F11SP
9,Janssenlei 17,2021-12-29,10:00:00,122,66,56,F11SP
9,Janssenlei 17,2021-12-29,11:00:00,102,48,54,F11SP
9,Janssenlei 17,2021-12-29,12:00:00,98,44,54,F11SP
9,Janssenlei 17,2021-12-29,13:00:00,108,54,54,F11SP
9,Janssenlei 17,2021-12-29,14:00:00,70,42,28,F11SP
9,Janssenlei 17,2021-12-29,15:00:00,70,20,50,F11SP
9,Janssenlei 17,2021-12-29,16:00:00,48,18,30,F11SP
9,Janssenlei 17,2021-12-29,17:00:00,72,34,38,F11SP
9,Janssenlei 17,2021-12-29,18:00:00,32,16,16,F11SP
9,Janssenlei 17,2021-12-29,19:00:00,26,14,12,F11SP
9,Janssenlei 17,2021-12-29,20:00:00,42,24,18,F11SP
9,Janssenlei 17,2021-12-29,21:00:00,18,8,10,F11SP
9,Janssenlei 17,2021-12-29,22:00:00,18,4,14,F11SP
9,Janssenlei 17,2021-12-29,23:00:00,12,0,12,F11SP
9,Janssenlei 17,2021-12-30,00:00:00,6,0,6,F11SP
9,Janssenlei 17,2021-12-30,01:00:00,0,0,0,F11SP
9,Janssenlei 17,2021-12-30,02:00:00,0,0,0,F11SP
9,Janssenlei 17,2021-12-30,03:00:00,2,0,2,F11SP
9,Janssenlei 17,2021-12-30,04:00:00,4,4,0,F11SP
9,Janssenlei 17,2021-12-30,05:00:00,10,2,8,F11SP
9,Janssenlei 17,2021-12-30,06:00:00,22,16,6,F11SP
9,Janssenlei 17,2021-12-30,07:00:00,46,26,20,F11SP
9,Janssenlei 17,2021-12-30,08:00:00,66,26,40,F11SP
9,Janssenlei 17,2021-12-30,09:00:00,72,36,36,F11SP
9,Janssenlei 17,2021-12-30,10:00:00,114,58,56,F11SP
9,Janssenlei 17,2021-12-30,11:00:00,122,52,70,F11SP
9,Janssenlei 17,2021-12-30,12:00:00,116,48,68,F11SP
9,Janssenlei 17,2021-12-30,13:00:00,178,94,84,F11SP
9,Janssenlei 17,2021-12-30,14:00:00,122,32,90,F11SP
9,Janssenlei 17,2021-12-30,15:00:00,166,88,78,F11SP
9,Janssenlei 17,2021-12-30,16:00:00,114,64,50,F11SP
9,Janssenlei 17,2021-12-30,17:00:00,80,28,52,F11SP
9,Janssenlei 17,2021-12-30,18:00:00,44,20,24,F11SP
9,Janssenlei 17,2021-12-30,19:00:00,36,20,16,F11SP
9,Janssenlei 17,2021-12-30,20:00:00,20,8,12,F11SP
9,Janssenlei 17,2021-12-30,21:00:00,28,8,20,F11SP
9,Janssenlei 17,2021-12-30,22:00:00,22,12,10,F11SP
9,Janssenlei 17,2021-12-30,23:00:00,20,14,6,F11SP
9,Janssenlei 17,2021-12-31,00:00:00,14,8,6,F11SP
9,Janssenlei 17,2021-12-31,01:00:00,2,0,2,F11SP
9,Janssenlei 17,2021-12-31,02:00:00,6,4,2,F11SP
9,Janssenlei 17,2021-12-31,03:00:00,2,2,0,F11SP
9,Janssenlei 17,2021-12-31,04:00:00,2,2,0,F11SP
9,Janssenlei 17,2021-12-31,05:00:00,12,6,6,F11SP
9,Janssenlei 17,2021-12-31,06:00:00,16,14,2,F11SP
9,Janssenlei 17,2021-12-31,07:00:00,26,14,12,F11SP
9,Janssenlei 17,2021-12-31,08:00:00,64,36,28,F11SP
9,Janssenlei 17,2021-12-31,09:00:00,84,32,52,F11SP
9,Janssenlei 17,2021-12-31,10:00:00,140,46,94,F11SP
9,Janssenlei 17,2021-12-31,11:00:00,222,104,118,F11SP
9,Janssenlei 17,2021-12-31,12:00:00,182,108,74,F11SP
9,Janssenlei 17,2021-12-31,13:00:00,216,114,102,F11SP
9,Janssenlei 17,2021-12-31,14:00:00,210,106,104,F11SP
9,Janssenlei 17,2021-12-31,15:00:00,214,126,88,F11SP
9,Janssenlei 17,2021-12-31,16:00:00,100,56,44,F11SP
9,Janssenlei 17,2021-12-31,17:00:00,76,40,36,F11SP
9,Janssenlei 17,2021-12-31,18:00:00,58,28,30,F11SP
9,Janssenlei 17,2021-12-31,19:00:00,30,10,20,F11SP
9,Janssenlei 17,2021-12-31,20:00:00,18,10,8,F11SP
9,Janssenlei 17,2021-12-31,21:00:00,12,4,8,F11SP
9,Janssenlei 17,2021-12-31,22:00:00,2,0,2,F11SP
9,Janssenlei 17,2021-12-31,23:00:00,24,10,14,F11SP
9,Janssenlei 17,2022-01-01,00:00:00,2,0,2,F11SP
9,Janssenlei 17,2022-01-01,01:00:00,30,6,24,F11SP
9,Janssenlei 17,2022-01-01,02:00:00,38,14,24,F11SP
9,Janssenlei 17,2022-01-01,03:00:00,18,6,12,F11SP
9,Janssenlei 17,2022-01-01,04:00:00,38,18,20,F11SP
9,Janssenlei 17,2022-01-01,05:00:00,20,18,2,F11SP
9,Janssenlei 17,2022-01-01,06:00:00,18,10,8,F11SP
9,Janssenlei 17,2022-01-01,07:00:00,22,8,14,F11SP
9,Janssenlei 17,2022-01-01,08:00:00,24,8,16,F11SP
9,Janssenlei 17,2022-01-01,09:00:00,38,12,26,F11SP
9,Janssenlei 17,2022-01-01,10:00:00,76,36,40,F11SP
9,Janssenlei 17,2022-01-01,11:00:00,116,46,70,F11SP
9,Janssenlei 17,2022-01-01,12:00:00,182,76,106,F11SP
9,Janssenlei 17,2022-01-01,13:00:00,320,150,170,F11SP
9,Janssenlei 17,2022-01-01,14:00:00,300,152,148,F11SP
9,Janssenlei 17,2022-01-01,15:00:00,310,190,120,F11SP
9,Janssenlei 17,2022-01-01,16:00:00,166,90,76,F11SP
9,Janssenlei 17,2022-01-01,17:00:00,64,36,28,F11SP
9,Janssenlei 17,2022-01-01,18:00:00,22,10,12,F11SP
9,Janssenlei 17,2022-01-01,19:00:00,24,10,14,F11SP
9,Janssenlei 17,2022-01-01,20:00:00,22,10,12,F11SP
9,Janssenlei 17,2022-01-01,21:00:00,22,12,10,F11SP
9,Janssenlei 17,2022-01-01,22:00:00,6,0,6,F11SP
9,Janssenlei 17,2022-01-01,23:00:00,6,0,6,F11SP
9,Janssenlei 17,2022-01-02,00:00:00,6,0,6,F11SP
9,Janssenlei 17,2022-01-02,01:00:00,0,0,0,F11SP
9,Janssenlei 17,2022-01-02,02:00:00,2,2,0,F11SP
9,Janssenlei 17,2022-01-02,03:00:00,0,0,0,F11SP
9,Janssenlei 17,2022-01-02,04:00:00,4,4,0,F11SP
9,Janssenlei 17,2022-01-02,05:00:00,0,0,0,F11SP
9,Janssenlei 17,2022-01-02,06:00:00,16,8,8,F11SP
9,Janssenlei 17,2022-01-02,07:00:00,14,8,6,F11SP
9,Janssenlei 17,2022-01-02,08:00:00,16,6,10,F11SP
9,Janssenlei 17,2022-01-02,09:00:00,90,38,52,F11SP
9,Janssenlei 17,2022-01-02,10:00:00,136,50,86,F11SP
9,Janssenlei 17,2022-01-02,11:00:00,258,160,98,F11SP
9,Janssenlei 17,2022-01-02,12:00:00,158,80,78,F11SP
9,Janssenlei 17,2022-01-02,13:00:00,196,102,94,F11SP
9,Janssenlei 17,2022-01-02,14:00:00,210,120,90,F11SP
9,Janssenlei 17,2022-01-02,15:00:00,158,100,58,F11SP
9,Janssenlei 17,2022-01-02,16:00:00,120,72,48,F11SP
9,Janssenlei 17,2022-01-02,17:00:00,62,30,32,F11SP
9,Janssenlei 17,2022-01-02,18:00:00,28,16,12,F11SP
9,Janssenlei 17,2022-01-02,19:00:00,16,10,6,F11SP
9,Janssenlei 17,2022-01-02,20:00:00,24,16,8,F11SP
9,Janssenlei 17,2022-01-02,21:00:00,8,2,6,F11SP
9,Janssenlei 17,2022-01-02,22:00:00,12,2,10,F11SP
9,Janssenlei 17,2022-01-02,23:00:00,6,0,6,F11SP
9,Janssenlei 17,2022-01-03,00:00:00,2,0,2,F11SP
9,Janssenlei 17,2022-01-03,01:00:00,4,0,4,F11SP
9,Janssenlei 17,2022-01-03,02:00:00,0,0,0,F11SP
9,Janssenlei 17,2022-01-03,03:00:00,0,0,0,F11SP
9,Janssenlei 17,2022-01-03,04:00:00,6,6,0,F11SP
9,Janssenlei 17,2022-01-03,05:00:00,22,12,10,F11SP
9,Janssenlei 17,2022-01-03,06:00:00,38,26,12,F11SP
9,Janssenlei 17,2022-01-03,07:00:00,92,54,38,F11SP
9,Janssenlei 17,2022-01-03,08:00:00,70,44,26,F11SP
9,Janssenlei 17,2022-01-03,09:00:00,56,26,30,F11SP
9,Janssenlei 17,2022-01-03,10:00:00,112,56,56,F11SP
9,Janssenlei 17,2022-01-03,11:00:00,110,62,48,F11SP
9,Janssenlei 17,2022-01-03,12:00:00,80,44,36,F11SP
9,Janssenlei 17,2022-01-03,13:00:00,62,36,26,F11SP
9,Janssenlei 17,2022-01-03,14:00:00,94,30,64,F11SP
9,Janssenlei 17,2022-01-03,15:00:00,72,28,44,F11SP
9,Janssenlei 17,2022-01-03,16:00:00,120,54,66,F11SP
9,Janssenlei 17,2022-01-03,17:00:00,116,46,70,F11SP
9,Janssenlei 17,2022-01-03,18:00:00,48,26,22,F11SP
9,Janssenlei 17,2022-01-03,19:00:00,26,10,16,F11SP
9,Janssenlei 17,2022-01-03,20:00:00,36,18,18,F11SP
9,Janssenlei 17,2022-01-03,21:00:00,16,8,8,F11SP
9,Janssenlei 17,2022-01-03,22:00:00,14,2,12,F11SP
9,Janssenlei 17,2022-01-03,23:00:00,4,4,0,F11SP
9,Janssenlei 17,2022-01-04,00:00:00,4,0,4,F11SP
9,Janssenlei 17,2022-01-04,01:00:00,0,0,0,F11SP
9,Janssenlei 17,2022-01-04,02:00:00,2,0,2,F11SP
9,Janssenlei 17,2022-01-04,03:00:00,0,0,0,F11SP
9,Janssenlei 17,2022-01-04,04:00:00,4,4,0,F11SP
9,Janssenlei 17,2022-01-04,05:00:00,20,10,10,F11SP
9,Janssenlei 17,2022-01-04,06:00:00,44,32,12,F11SP
9,Janssenlei 17,2022-01-04,07:00:00,106,66,40,F11SP
9,Janssenlei 17,2022-01-04,08:00:00,114,68,46,F11SP
9,Janssenlei 17,2022-01-04,09:00:00,80,40,40,F11SP
9,Janssenlei 17,2022-01-04,10:00:00,86,40,46,F11SP
9,Janssenlei 17,2022-01-04,11:00:00,60,24,36,F11SP
9,Janssenlei 17,2022-01-04,12:00:00,68,44,24,F11SP
9,Janssenlei 17,2022-01-04,13:00:00,100,52,48,F11SP
9,Janssenlei 17,2022-01-04,14:00:00,36,10,26,F11SP
9,Janssenlei 17,2022-01-04,15:00:00,52,20,32,F11SP
9,Janssenlei 17,2022-01-04,16:00:00,154,60,94,F11SP
9,Janssenlei 17,2022-01-04,17:00:00,104,36,68,F11SP
9,Janssenlei 17,2022-01-04,18:00:00,54,24,30,F11SP
9,Janssenlei 17,2022-01-04,19:00:00,24,16,8,F11SP
9,Janssenlei 17,2022-01-04,20:00:00,26,8,18,F11SP
9,Janssenlei 17,2022-01-04,21:00:00,14,10,4,F11SP
9,Janssenlei 17,2022-01-04,22:00:00,20,8,12,F11SP
9,Janssenlei 17,2022-01-04,23:00:00,8,0,8,F11SP
9,Janssenlei 17,2022-01-05,00:00:00,2,0,2,F11SP
9,Janssenlei 17,2022-01-05,01:00:00,0,0,0,F11SP
9,Janssenlei 17,2022-01-05,02:00:00,2,2,0,F11SP
9,Janssenlei 17,2022-01-05,03:00:00,0,0,0,F11SP
9,Janssenlei 17,2022-01-05,04:00:00,4,4,0,F11SP
9,Janssenlei 17,2022-01-05,05:00:00,24,14,10,F11SP
9,Janssenlei 17,2022-01-05,06:00:00,56,32,24,F11SP
9,Janssenlei 17,2022-01-05,07:00:00,110,64,46,F11SP
9,Janssenlei 17,2022-01-05,08:00:00,96,64,32,F11SP
9,Janssenlei 17,2022-01-05,09:00:00,66,40,26,F11SP
9,Janssenlei 17,2022-01-05,10:00:00,90,48,42,F11SP
9,Janssenlei 17,2022-01-05,11:00:00,72,42,30,F11SP
9,Janssenlei 17,2022-01-05,12:00:00,90,52,38,F11SP
9,Janssenlei 17,2022-01-05,13:00:00,92,46,46,F11SP
9,Janssenlei 17,2022-01-05,14:00:00,124,50,74,F11SP
9,Janssenlei 17,2022-01-05,15:00:00,88,36,52,F11SP
9,Janssenlei 17,2022-01-05,16:00:00,162,64,98,F11SP
9,Janssenlei 17,2022-01-05,17:00:00,144,62,82,F11SP
9,Janssenlei 17,2022-01-05,18:00:00,60,30,30,F11SP
9,Janssenlei 17,2022-01-05,19:00:00,40,12,28,F11SP
9,Janssenlei 17,2022-01-05,20:00:00,28,16,12,F11SP
9,Janssenlei 17,2022-01-05,21:00:00,10,4,6,F11SP
9,Janssenlei 17,2022-01-05,22:00:00,16,6,10,F11SP
9,Janssenlei 17,2022-01-05,23:00:00,6,4,2,F11SP
9,Janssenlei 17,2022-01-06,00:00:00,2,0,2,F11SP
9,Janssenlei 17,2022-01-06,01:00:00,0,0,0,F11SP
9,Janssenlei 17,2022-01-06,02:00:00,4,0,4,F11SP
9,Janssenlei 17,2022-01-06,03:00:00,4,4,0,F11SP
9,Janssenlei 17,2022-01-06,04:00:00,6,6,0,F11SP
9,Janssenlei 17,2022-01-06,05:00:00,22,12,10,F11SP
9,Janssenlei 17,2022-01-06,06:00:00,66,42,24,F11SP
9,Janssenlei 17,2022-01-06,07:00:00,134,82,52,F11SP
9,Janssenlei 17,2022-01-06,08:00:00,102,52,50,F11SP
9,Janssenlei 17,2022-01-06,09:00:00,90,50,40,F11SP
9,Janssenlei 17,2022-01-06,10:00:00,112,68,44,F11SP
9,Janssenlei 17,2022-01-06,11:00:00,108,42,66,F11SP
9,Janssenlei 17,2022-01-06,12:00:00,150,70,80,F11SP
9,Janssenlei 17,2022-01-06,13:00:00,194,102,92,F11SP
9,Janssenlei 17,2022-01-06,14:00:00,244,120,124,F11SP
9,Janssenlei 17,2022-01-06,15:00:00,184,76,108,F11SP
9,Janssenlei 17,2022-01-06,16:00:00,242,130,112,F11SP
9,Janssenlei 17,2022-01-06,17:00:00,158,66,92,F11SP
9,Janssenlei 17,2022-01-06,18:00:00,76,16,60,F11SP
9,Janssenlei 17,2022-01-06,19:00:00,40,18,22,F11SP
9,Janssenlei 17,2022-01-06,20:00:00,38,14,24,F11SP
9,Janssenlei 17,2022-01-06,21:00:00,24,16,8,F11SP
9,Janssenlei 17,2022-01-06,22:00:00,32,6,26,F11SP
9,Janssenlei 17,2022-01-06,23:00:00,12,8,4,F11SP
9,Janssenlei 17,2022-01-07,00:00:00,12,4,8,F11SP
9,Janssenlei 17,2022-01-07,01:00:00,6,2,4,F11SP
9,Janssenlei 17,2022-01-07,02:00:00,2,0,2,F11SP
9,Janssenlei 17,2022-01-07,03:00:00,6,6,0,F11SP
9,Janssenlei 17,2022-01-07,04:00:00,6,4,2,F11SP
9,Janssenlei 17,2022-01-07,05:00:00,14,8,6,F11SP
9,Janssenlei 17,2022-01-07,06:00:00,52,36,16,F11SP
9,Janssenlei 17,2022-01-07,07:00:00,92,44,48,F11SP
9,Janssenlei 17,2022-01-07,08:00:00,96,50,46,F11SP
9,Janssenlei 17,2022-01-07,09:00:00,64,40,24,F11SP
9,Janssenlei 17,2022-01-07,10:00:00,60,26,34,F11SP
9,Janssenlei 17,2022-01-07,11:00:00,86,48,38,F11SP
9,Janssenlei 17,2022-01-07,12:00:00,94,52,42,F11SP
9,Janssenlei 17,2022-01-07,13:00:00,80,44,36,F11SP
9,Janssenlei 17,2022-01-07,14:00:00,104,44,60,F11SP
9,Janssenlei 17,2022-01-07,15:00:00,102,40,62,F11SP
9,Janssenlei 17,2022-01-07,16:00:00,146,82,64,F11SP
9,Janssenlei 17,2022-01-07,17:00:00,124,48,76,F11SP
9,Janssenlei 17,2022-01-07,18:00:00,64,26,38,F11SP
9,Janssenlei 17,2022-01-07,19:00:00,32,8,24,F11SP
9,Janssenlei 17,2022-01-07,20:00:00,42,26,16,F11SP
9,Janssenlei 17,2022-01-07,21:00:00,30,16,14,F11SP
9,Janssenlei 17,2022-01-07,22:00:00,18,4,14,F11SP
9,Janssenlei 17,2022-01-07,23:00:00,24,6,18,F11SP
9,Janssenlei 17,2022-01-08,00:00:00,10,4,6,F11SP
9,Janssenlei 17,2022-01-08,01:00:00,8,4,4,F11SP
9,Janssenlei 17,2022-01-08,02:00:00,2,0,2,F11SP
9,Janssenlei 17,2022-01-08,03:00:00,2,2,0,F11SP
9,Janssenlei 17,2022-01-08,04:00:00,2,2,0,F11SP
9,Janssenlei 17,2022-01-08,05:00:00,16,14,2,F11SP
9,Janssenlei 17,2022-01-08,06:00:00,8,2,6,F11SP
9,Janssenlei 17,2022-01-08,07:00:00,8,6,2,F11SP
9,Janssenlei 17,2022-01-08,08:00:00,50,20,30,F11SP
9,Janssenlei 17,2022-01-08,09:00:00,76,32,44,F11SP
9,Janssenlei 17,2022-01-08,10:00:00,124,44,80,F11SP
9,Janssenlei 17,2022-01-08,11:00:00,144,98,46,F11SP
9,Janssenlei 17,2022-01-08,12:00:00,80,36,44,F11SP
9,Janssenlei 17,2022-01-08,13:00:00,66,32,34,F11SP
9,Janssenlei 17,2022-01-08,14:00:00,38,10,28,F11SP
9,Janssenlei 17,2022-01-08,15:00:00,46,22,24,F11SP
9,Janssenlei 17,2022-01-08,16:00:00,16,10,6,F11SP
9,Janssenlei 17,2022-01-08,17:00:00,14,10,4,F11SP
9,Janssenlei 17,2022-01-08,18:00:00,26,14,12,F11SP
9,Janssenlei 17,2022-01-08,19:00:00,16,6,10,F11SP
9,Janssenlei 17,2022-01-08,20:00:00,16,2,14,F11SP
9,Janssenlei 17,2022-01-08,21:00:00,22,14,8,F11SP
9,Janssenlei 17,2022-01-08,22:00:00,10,0,10,F11SP
9,Janssenlei 17,2022-01-08,23:00:00,2,2,0,F11SP
9,Janssenlei 17,2022-01-09,00:00:00,0,0,0,F11SP
9,Janssenlei 17,2022-01-09,01:00:00,8,4,4,F11SP
9,Janssenlei 17,2022-01-09,02:00:00,0,0,0,F11SP
9,Janssenlei 17,2022-01-09,03:00:00,4,0,4,F11SP
9,Janssenlei 17,2022-01-09,04:00:00,2,2,0,F11SP
9,Janssenlei 17,2022-01-09,05:00:00,6,6,0,F11SP
9,Janssenlei 17,2022-01-09,06:00:00,10,8,2,F11SP
9,Janssenlei 17,2022-01-09,07:00:00,6,4,2,F11SP
9,Janssenlei 17,2022-01-09,08:00:00,30,16,14,F11SP
9,Janssenlei 17,2022-01-09,09:00:00,78,38,40,F11SP
9,Janssenlei 17,2022-01-09,10:00:00,166,40,126,F11SP
9,Janssenlei 17,2022-01-09,11:00:00,182,110,72,F11SP
9,Janssenlei 17,2022-01-09,12:00:00,192,114,78,F11SP
9,Janssenlei 17,2022-01-09,13:00:00,176,74,102,F11SP
9,Janssenlei 17,2022-01-09,14:00:00,186,80,106,F11SP
9,Janssenlei 17,2022-01-09,15:00:00,140,76,64,F11SP
9,Janssenlei 17,2022-01-09,16:00:00,128,74,54,F11SP
9,Janssenlei 17,2022-01-09,17:00:00,38,26,12,F11SP
9,Janssenlei 17,2022-01-09,18:00:00,34,16,18,F11SP
9,Janssenlei 17,2022-01-09,19:00:00,26,4,22,F11SP
9,Janssenlei 17,2022-01-09,20:00:00,30,20,10,F11SP
9,Janssenlei 17,2022-01-09,21:00:00,12,4,8,F11SP
9,Janssenlei 17,2022-01-09,22:00:00,8,4,4,F11SP
9,Janssenlei 17,2022-01-09,23:00:00,4,0,4,F11SP
9,Janssenlei 17,2022-01-10,00:00:00,4,2,2,F11SP
9,Janssenlei 17,2022-01-10,01:00:00,0,0,0,F11SP
9,Janssenlei 17,2022-01-10,02:00:00,0,0,0,F11SP
9,Janssenlei 17,2022-01-10,03:00:00,2,2,0,F11SP
9,Janssenlei 17,2022-01-10,04:00:00,6,6,0,F11SP
9,Janssenlei 17,2022-01-10,05:00:00,34,24,10,F11SP
9,Janssenlei 17,2022-01-10,06:00:00,92,68,24,F11SP
9,Janssenlei 17,2022-01-10,07:00:00,304,188,116,F11SP
9,Janssenlei 17,2022-01-10,08:00:00,318,226,92,F11SP
9,Janssenlei 17,2022-01-10,09:00:00,88,50,38,F11SP
9,Janssenlei 17,2022-01-10,10:00:00,60,42,18,F11SP
9,Janssenlei 17,2022-01-10,11:00:00,62,40,22,F11SP
9,Janssenlei 17,2022-01-10,12:00:00,120,74,46,F11SP
9,Janssenlei 17,2022-01-10,13:00:00,132,60,72,F11SP
9,Janssenlei 17,2022-01-10,14:00:00,152,58,94,F11SP
9,Janssenlei 17,2022-01-10,15:00:00,210,70,140,F11SP
9,Janssenlei 17,2022-01-10,16:00:00,358,126,232,F11SP
9,Janssenlei 17,2022-01-10,17:00:00,234,80,154,F11SP
9,Janssenlei 17,2022-01-10,18:00:00,82,18,64,F11SP
9,Janssenlei 17,2022-01-10,19:00:00,52,18,34,F11SP
9,Janssenlei 17,2022-01-10,20:00:00,36,18,18,F11SP
9,Janssenlei 17,2022-01-10,21:00:00,34,18,16,F11SP
9,Janssenlei 17,2022-01-10,22:00:00,20,4,16,F11SP
9,Janssenlei 17,2022-01-10,23:00:00,4,2,2,F11SP
9,Janssenlei 17,2022-01-11,00:00:00,2,2,0,F11SP
9,Janssenlei 17,2022-01-11,01:00:00,2,2,0,F11SP
9,Janssenlei 17,2022-01-11,02:00:00,0,0,0,F11SP
9,Janssenlei 17,2022-01-11,03:00:00,2,2,0,F11SP
9,Janssenlei 17,2022-01-11,04:00:00,6,2,4,F11SP
9,Janssenlei 17,2022-01-11,05:00:00,42,30,12,F11SP
9,Janssenlei 17,2022-01-11,06:00:00,92,64,28,F11SP
9,Janssenlei 17,2022-01-11,07:00:00,290,176,114,F11SP
9,Janssenlei 17,2022-01-11,08:00:00,312,224,88,F11SP
9,Janssenlei 17,2022-01-11,09:00:00,80,42,38,F11SP
9,Janssenlei 17,2022-01-11,10:00:00,76,52,24,F11SP
9,Janssenlei 17,2022-01-11,11:00:00,108,46,62,F11SP
9,Janssenlei 17,2022-01-11,12:00:00,126,70,56,F11SP
9,Janssenlei 17,2022-01-11,13:00:00,202,98,104,F11SP
9,Janssenlei 17,2022-01-11,14:00:00,154,72,82,F11SP
9,Janssenlei 17,2022-01-11,15:00:00,290,144,146,F11SP
9,Janssenlei 17,2022-01-11,16:00:00,342,128,214,F11SP
9,Janssenlei 17,2022-01-11,17:00:00,228,84,144,F11SP
9,Janssenlei 17,2022-01-11,18:00:00,116,32,84,F11SP
9,Janssenlei 17,2022-01-11,19:00:00,42,16,26,F11SP
9,Janssenlei 17,2022-01-11,20:00:00,42,22,20,F11SP
9,Janssenlei 17,2022-01-11,21:00:00,32,18,14,F11SP
9,Janssenlei 17,2022-01-11,22:00:00,34,12,22,F11SP
9,Janssenlei 17,2022-01-11,23:00:00,14,8,6,F11SP
9,Janssenlei 17,2022-01-12,00:00:00,2,0,2,F11SP
9,Janssenlei 17,2022-01-12,01:00:00,0,0,0,F11SP
9,Janssenlei 17,2022-01-12,02:00:00,0,0,0,F11SP
9,Janssenlei 17,2022-01-12,03:00:00,2,2,0,F11SP
9,Janssenlei 17,2022-01-12,04:00:00,8,8,0,F11SP
9,Janssenlei 17,2022-01-12,05:00:00,40,30,10,F11SP
9,Janssenlei 17,2022-01-12,06:00:00,72,50,22,F11SP
9,Janssenlei 17,2022-01-12,07:00:00,232,152,80,F11SP
9,Janssenlei 17,2022-01-12,08:00:00,322,214,108,F11SP
9,Janssenlei 17,2022-01-12,09:00:00,118,70,48,F11SP
9,Janssenlei 17,2022-01-12,10:00:00,66,34,32,F11SP
9,Janssenlei 17,2022-01-12,11:00:00,88,34,54,F11SP
9,Janssenlei 17,2022-01-12,12:00:00,262,114,148,F11SP
9,Janssenlei 17,2022-01-12,13:00:00,154,56,98,F11SP
9,Janssenlei 17,2022-01-12,14:00:00,170,62,108,F11SP
9,Janssenlei 17,2022-01-12,15:00:00,146,66,80,F11SP
9,Janssenlei 17,2022-01-12,16:00:00,198,88,110,F11SP
9,Janssenlei 17,2022-01-12,17:00:00,200,74,126,F11SP
9,Janssenlei 17,2022-01-12,18:00:00,104,52,52,F11SP
9,Janssenlei 17,2022-01-12,19:00:00,82,20,62,F11SP
9,Janssenlei 17,2022-01-12,20:00:00,38,12,26,F11SP
9,Janssenlei 17,2022-01-12,21:00:00,34,22,12,F11SP
9,Janssenlei 17,2022-01-12,22:00:00,24,4,20,F11SP
9,Janssenlei 17,2022-01-12,23:00:00,8,4,4,F11SP
9,Janssenlei 17,2022-01-13,00:00:00,0,0,0,F11SP
9,Janssenlei 17,2022-01-13,01:00:00,0,0,0,F11SP
9,Janssenlei 17,2022-01-13,02:00:00,0,0,0,F11SP
9,Janssenlei 17,2022-01-13,03:00:00,2,2,0,F11SP
9,Janssenlei 17,2022-01-13,04:00:00,6,4,2,F11SP
9,Janssenlei 17,2022-01-13,05:00:00,32,18,14,F11SP
9,Janssenlei 17,2022-01-13,06:00:00,68,42,26,F11SP
9,Janssenlei 17,2022-01-13,07:00:00,256,158,98,F11SP
9,Janssenlei 17,2022-01-13,08:00:00,318,230,88,F11SP
9,Janssenlei 17,2022-01-13,09:00:00,78,46,32,F11SP
9,Janssenlei 17,2022-01-13,10:00:00,50,30,20,F11SP
9,Janssenlei 17,2022-01-13,11:00:00,54,28,26,F11SP
9,Janssenlei 17,2022-01-13,12:00:00,124,56,68,F11SP
9,Janssenlei 17,2022-01-13,13:00:00,124,54,70,F11SP
9,Janssenlei 17,2022-01-13,14:00:00,96,48,48,F11SP
9,Janssenlei 17,2022-01-13,15:00:00,170,64,106,F11SP
9,Janssenlei 17,2022-01-13,16:00:00,288,116,172,F11SP
9,Janssenlei 17,2022-01-13,17:00:00,226,96,130,F11SP
9,Janssenlei 17,2022-01-13,18:00:00,80,26,54,F11SP
9,Janssenlei 17,2022-01-13,19:00:00,36,12,24,F11SP
9,Janssenlei 17,2022-01-13,20:00:00,38,14,24,F11SP
9,Janssenlei 17,2022-01-13,21:00:00,44,22,22,F11SP
9,Janssenlei 17,2022-01-13,22:00:00,32,2,30,F11SP
9,Janssenlei 17,2022-01-13,23:00:00,14,6,8,F11SP
9,Janssenlei 17,2022-01-14,00:00:00,10,4,6,F11SP
9,Janssenlei 17,2022-01-14,01:00:00,2,2,0,F11SP
9,Janssenlei 17,2022-01-14,02:00:00,6,0,6,F11SP
9,Janssenlei 17,2022-01-14,03:00:00,2,2,0,F11SP
9,Janssenlei 17,2022-01-14,04:00:00,2,2,0,F11SP
9,Janssenlei 17,2022-01-14,05:00:00,32,20,12,F11SP
9,Janssenlei 17,2022-01-14,06:00:00,66,42,24,F11SP
9,Janssenlei 17,2022-01-14,07:00:00,226,132,94,F11SP
9,Janssenlei 17,2022-01-14,08:00:00,262,174,88,F11SP
9,Janssenlei 17,2022-01-14,09:00:00,82,36,46,F11SP
9,Janssenlei 17,2022-01-14,10:00:00,74,44,30,F11SP
9,Janssenlei 17,2022-01-14,11:00:00,98,44,54,F11SP
9,Janssenlei 17,2022-01-14,12:00:00,118,52,66,F11SP
9,Janssenlei 17,2022-01-14,13:00:00,174,76,98,F11SP
9,Janssenlei 17,2022-01-14,14:00:00,154,68,86,F11SP
9,Janssenlei 17,2022-01-14,15:00:00,230,92,138,F11SP
9,Janssenlei 17,2022-01-14,16:00:00,308,128,180,F11SP
9,Janssenlei 17,2022-01-14,17:00:00,116,44,72,F11SP
9,Janssenlei 17,2022-01-14,18:00:00,74,28,46,F11SP
9,Janssenlei 17,2022-01-14,19:00:00,48,14,34,F11SP
9,Janssenlei 17,2022-01-14,20:00:00,34,22,12,F11SP
9,Janssenlei 17,2022-01-14,21:00:00,28,18,10,F11SP
9,Janssenlei 17,2022-01-14,22:00:00,44,6,38,F11SP
9,Janssenlei 17,2022-01-14,23:00:00,16,6,10,F11SP
9,Janssenlei 17,2022-01-15,00:00:00,8,4,4,F11SP
9,Janssenlei 17,2022-01-15,01:00:00,6,6,0,F11SP
9,Janssenlei 17,2022-01-15,02:00:00,10,6,4,F11SP
9,Janssenlei 17,2022-01-15,03:00:00,4,2,2,F11SP
9,Janssenlei 17,2022-01-15,04:00:00,6,4,2,F11SP
9,Janssenlei 17,2022-01-15,05:00:00,6,6,0,F11SP
9,Janssenlei 17,2022-01-15,06:00:00,18,8,10,F11SP
9,Janssenlei 17,2022-01-15,07:00:00,14,6,8,F11SP
9,Janssenlei 17,2022-01-15,08:00:00,32,10,22,F11SP
9,Janssenlei 17,2022-01-15,09:00:00,82,32,50,F11SP
9,Janssenlei 17,2022-01-15,10:00:00,140,48,92,F11SP
9,Janssenlei 17,2022-01-15,11:00:00,156,96,60,F11SP
9,Janssenlei 17,2022-01-15,12:00:00,142,80,62,F11SP
9,Janssenlei 17,2022-01-15,13:00:00,222,118,104,F11SP
9,Janssenlei 17,2022-01-15,14:00:00,306,150,156,F11SP
9,Janssenlei 17,2022-01-15,15:00:00,228,118,110,F11SP
9,Janssenlei 17,2022-01-15,16:00:00,164,114,50,F11SP
9,Janssenlei 17,2022-01-15,17:00:00,78,36,42,F11SP
9,Janssenlei 17,2022-01-15,18:00:00,46,20,26,F11SP
9,Janssenlei 17,2022-01-15,19:00:00,32,18,14,F11SP
9,Janssenlei 17,2022-01-15,20:00:00,18,10,8,F11SP
9,Janssenlei 17,2022-01-15,21:00:00,20,12,8,F11SP
9,Janssenlei 17,2022-01-15,22:00:00,8,2,6,F11SP
9,Janssenlei 17,2022-01-15,23:00:00,14,10,4,F11SP
9,Janssenlei 17,2022-01-16,00:00:00,10,2,8,F11SP
9,Janssenlei 17,2022-01-16,01:00:00,12,6,6,F11SP
9,Janssenlei 17,2022-01-16,02:00:00,6,0,6,F11SP
9,Janssenlei 17,2022-01-16,03:00:00,4,0,4,F11SP
9,Janssenlei 17,2022-01-16,04:00:00,0,0,0,F11SP
9,Janssenlei 17,2022-01-16,05:00:00,10,10,0,F11SP
9,Janssenlei 17,2022-01-16,06:00:00,8,6,2,F11SP
9,Janssenlei 17,2022-01-16,07:00:00,4,2,2,F11SP
9,Janssenlei 17,2022-01-16,08:00:00,66,38,28,F11SP
9,Janssenlei 17,2022-01-16,09:00:00,144,36,108,F11SP
9,Janssenlei 17,2022-01-16,10:00:00,140,60,80,F11SP
9,Janssenlei 17,2022-01-16,11:00:00,170,96,74,F11SP
9,Janssenlei 17,2022-01-16,12:00:00,142,96,46,F11SP
9,Janssenlei 17,2022-01-16,13:00:00,82,46,36,F11SP
9,Janssenlei 17,2022-01-16,14:00:00,92,38,54,F11SP
9,Janssenlei 17,2022-01-16,15:00:00,90,56,34,F11SP
9,Janssenlei 17,2022-01-16,16:00:00,92,60,32,F11SP
9,Janssenlei 17,2022-01-16,17:00:00,50,30,20,F11SP
9,Janssenlei 17,2022-01-16,18:00:00,30,18,12,F11SP
9,Janssenlei 17,2022-01-16,19:00:00,20,6,14,F11SP
9,Janssenlei 17,2022-01-16,20:00:00,10,4,6,F11SP
9,Janssenlei 17,2022-01-16,21:00:00,16,8,8,F11SP
9,Janssenlei 17,2022-01-16,22:00:00,6,0,6,F11SP
9,Janssenlei 17,2022-01-16,23:00:00,6,2,4,F11SP
9,Janssenlei 17,2022-01-17,00:00:00,0,0,0,F11SP
9,Janssenlei 17,2022-01-17,01:00:00,2,2,0,F11SP
9,Janssenlei 17,2022-01-17,02:00:00,0,0,0,F11SP
9,Janssenlei 17,2022-01-17,03:00:00,2,2,0,F11SP
9,Janssenlei 17,2022-01-17,04:00:00,4,4,0,F11SP
9,Janssenlei 17,2022-01-17,05:00:00,28,24,4,F11SP
9,Janssenlei 17,2022-01-17,06:00:00,86,52,34,F11SP
9,Janssenlei 17,2022-01-17,07:00:00,264,172,92,F11SP
9,Janssenlei 17,2022-01-17,08:00:00,294,218,76,F11SP
9,Janssenlei 17,2022-01-17,09:00:00,104,58,46,F11SP
9,Janssenlei 17,2022-01-17,10:00:00,68,34,34,F11SP
9,Janssenlei 17,2022-01-17,11:00:00,94,58,36,F11SP
9,Janssenlei 17,2022-01-17,12:00:00,132,62,70,F11SP
9,Janssenlei 17,2022-01-17,13:00:00,154,76,78,F11SP
9,Janssenlei 17,2022-01-17,14:00:00,156,74,82,F11SP
9,Janssenlei 17,2022-01-17,15:00:00,252,112,140,F11SP
9,Janssenlei 17,2022-01-17,16:00:00,346,118,228,F11SP
9,Janssenlei 17,2022-01-17,17:00:00,196,84,112,F11SP
9,Janssenlei 17,2022-01-17,18:00:00,102,38,64,F11SP
9,Janssenlei 17,2022-01-17,19:00:00,64,24,40,F11SP
9,Janssenlei 17,2022-01-17,20:00:00,28,6,22,F11SP
9,Janssenlei 17,2022-01-17,21:00:00,42,24,18,F11SP
9,Janssenlei 17,2022-01-17,22:00:00,40,8,32,F11SP
9,Janssenlei 17,2022-01-17,23:00:00,4,0,4,F11SP
9,Janssenlei 17,2022-01-18,00:00:00,0,0,0,F11SP
9,Janssenlei 17,2022-01-18,01:00:00,0,0,0,F11SP
9,Janssenlei 17,2022-01-18,02:00:00,0,0,0,F11SP
9,Janssenlei 17,2022-01-18,03:00:00,2,2,0,F11SP
9,Janssenlei 17,2022-01-18,04:00:00,10,8,2,F11SP
9,Janssenlei 17,2022-01-18,05:00:00,34,28,6,F11SP
9,Janssenlei 17,2022-01-18,06:00:00,78,48,30,F11SP
9,Janssenlei 17,2022-01-18,07:00:00,282,180,102,F11SP
9,Janssenlei 17,2022-01-18,08:00:00,296,200,96,F11SP
9,Janssenlei 17,2022-01-18,09:00:00,76,46,30,F11SP
9,Janssenlei 17,2022-01-18,10:00:00,74,32,42,F11SP
9,Janssenlei 17,2022-01-18,11:00:00,86,42,44,F11SP
9,Janssenlei 17,2022-01-18,12:00:00,116,52,64,F11SP
9,Janssenlei 17,2022-01-18,13:00:00,160,70,90,F11SP
9,Janssenlei 17,2022-01-18,14:00:00,184,100,84,F11SP
9,Janssenlei 17,2022-01-18,15:00:00,234,88,146,F11SP
9,Janssenlei 17,2022-01-18,16:00:00,338,128,210,F11SP
9,Janssenlei 17,2022-01-18,17:00:00,242,98,144,F11SP
9,Janssenlei 17,2022-01-18,18:00:00,114,28,86,F11SP
9,Janssenlei 17,2022-01-18,19:00:00,54,24,30,F11SP
9,Janssenlei 17,2022-01-18,20:00:00,32,20,12,F11SP
9,Janssenlei 17,2022-01-18,21:00:00,24,16,8,F11SP
9,Janssenlei 17,2022-01-18,22:00:00,32,8,24,F11SP
9,Janssenlei 17,2022-01-18,23:00:00,14,4,10,F11SP
9,Janssenlei 17,2022-01-19,00:00:00,8,2,6,F11SP
9,Janssenlei 17,2022-01-19,01:00:00,0,0,0,F11SP
9,Janssenlei 17,2022-01-19,02:00:00,0,0,0,F11SP
9,Janssenlei 17,2022-01-19,03:00:00,6,6,0,F11SP
9,Janssenlei 17,2022-01-19,04:00:00,8,6,2,F11SP
9,Janssenlei 17,2022-01-19,05:00:00,20,10,10,F11SP
9,Janssenlei 17,2022-01-19,06:00:00,78,48,30,F11SP
9,Janssenlei 17,2022-01-19,07:00:00,210,124,86,F11SP
9,Janssenlei 17,2022-01-19,08:00:00,282,192,90,F11SP
9,Janssenlei 17,2022-01-19,09:00:00,84,52,32,F11SP
9,Janssenlei 17,2022-01-19,10:00:00,102,58,44,F11SP
9,Janssenlei 17,2022-01-19,11:00:00,130,58,72,F11SP
9,Janssenlei 17,2022-01-19,12:00:00,234,84,150,F11SP
9,Janssenlei 17,2022-01-19,13:00:00,130,66,64,F11SP
9,Janssenlei 17,2022-01-19,14:00:00,106,42,64,F11SP
9,Janssenlei 17,2022-01-19,15:00:00,98,48,50,F11SP
9,Janssenlei 17,2022-01-19,16:00:00,188,80,108,F11SP
9,Janssenlei 17,2022-01-19,17:00:00,144,46,98,F11SP
9,Janssenlei 17,2022-01-19,18:00:00,72,36,36,F11SP
9,Janssenlei 17,2022-01-19,19:00:00,44,12,32,F11SP
9,Janssenlei 17,2022-01-19,20:00:00,34,24,10,F11SP
9,Janssenlei 17,2022-01-19,21:00:00,20,18,2,F11SP
9,Janssenlei 17,2022-01-19,22:00:00,36,8,28,F11SP
9,Janssenlei 17,2022-01-19,23:00:00,6,2,4,F11SP
9,Janssenlei 17,2022-01-20,00:00:00,2,0,2,F11SP
9,Janssenlei 17,2022-01-20,01:00:00,0,0,0,F11SP
9,Janssenlei 17,2022-01-20,02:00:00,0,0,0,F11SP
9,Janssenlei 17,2022-01-20,03:00:00,0,0,0,F11SP
9,Janssenlei 17,2022-01-20,04:00:00,8,6,2,F11SP
9,Janssenlei 17,2022-01-20,05:00:00,26,16,10,F11SP
9,Janssenlei 17,2022-01-20,06:00:00,62,34,28,F11SP
9,Janssenlei 17,2022-01-20,07:00:00,200,122,78,F11SP
9,Janssenlei 17,2022-01-20,08:00:00,276,190,86,F11SP
9,Janssenlei 17,2022-01-20,09:00:00,80,50,30,F11SP
9,Janssenlei 17,2022-01-20,10:00:00,92,44,48,F11SP
9,Janssenlei 17,2022-01-20,11:00:00,62,28,34,F11SP
9,Janssenlei 17,2022-01-20,12:00:00,100,40,60,F11SP
9,Janssenlei 17,2022-01-20,13:00:00,126,68,58,F11SP
9,Janssenlei 17,2022-01-20,14:00:00,116,50,66,F11SP
9,Janssenlei 17,2022-01-20,15:00:00,166,64,102,F11SP
9,Janssenlei 17,2022-01-20,16:00:00,252,100,152,F11SP
9,Janssenlei 17,2022-01-20,17:00:00,186,66,120,F11SP
9,Janssenlei 17,2022-01-20,18:00:00,92,40,52,F11SP
9,Janssenlei 17,2022-01-20,19:00:00,26,10,16,F11SP
9,Janssenlei 17,2022-01-20,20:00:00,32,12,20,F11SP
9,Janssenlei 17,2022-01-20,21:00:00,20,10,10,F11SP
9,Janssenlei 17,2022-01-20,22:00:00,30,4,26,F11SP
9,Janssenlei 17,2022-01-20,23:00:00,8,2,6,F11SP
9,Janssenlei 17,2022-01-21,00:00:00,2,0,2,F11SP
9,Janssenlei 17,2022-01-21,01:00:00,6,2,4,F11SP
9,Janssenlei 17,2022-01-21,02:00:00,4,4,0,F11SP
9,Janssenlei 17,2022-01-21,03:00:00,2,2,0,F11SP
9,Janssenlei 17,2022-01-21,04:00:00,8,8,0,F11SP
9,Janssenlei 17,2022-01-21,05:00:00,20,10,10,F11SP
9,Janssenlei 17,2022-01-21,06:00:00,64,38,26,F11SP
9,Janssenlei 17,2022-01-21,07:00:00,180,110,70,F11SP
9,Janssenlei 17,2022-01-21,08:00:00,256,172,84,F11SP
9,Janssenlei 17,2022-01-21,09:00:00,74,44,30,F11SP
9,Janssenlei 17,2022-01-21,10:00:00,64,40,24,F11SP
9,Janssenlei 17,2022-01-21,11:00:00,84,42,42,F11SP
9,Janssenlei 17,2022-01-21,12:00:00,108,36,72,F11SP
9,Janssenlei 17,2022-01-21,13:00:00,94,48,46,F11SP
9,Janssenlei 17,2022-01-21,14:00:00,66,26,40,F11SP
9,Janssenlei 17,2022-01-21,15:00:00,160,50,110,F11SP
9,Janssenlei 17,2022-01-21,16:00:00,236,98,138,F11SP
9,Janssenlei 17,2022-01-21,17:00:00,110,38,72,F11SP
9,Janssenlei 17,2022-01-21,18:00:00,110,50,60,F11SP
9,Janssenlei 17,2022-01-21,19:00:00,38,14,24,F11SP
9,Janssenlei 17,2022-01-21,20:00:00,36,22,14,F11SP
9,Janssenlei 17,2022-01-21,21:00:00,24,8,16,F11SP
9,Janssenlei 17,2022-01-21,22:00:00,24,8,16,F11SP
9,Janssenlei 17,2022-01-21,23:00:00,22,12,10,F11SP
9,Janssenlei 17,2022-01-22,00:00:00,6,2,4,F11SP
9,Janssenlei 17,2022-01-22,01:00:00,4,4,0,F11SP
9,Janssenlei 17,2022-01-22,02:00:00,0,0,0,F11SP
9,Janssenlei 17,2022-01-22,03:00:00,6,2,4,F11SP
9,Janssenlei 17,2022-01-22,04:00:00,2,2,0,F11SP
9,Janssenlei 17,2022-01-22,05:00:00,8,6,2,F11SP
9,Janssenlei 17,2022-01-22,06:00:00,22,10,12,F11SP
9,Janssenlei 17,2022-01-22,07:00:00,10,6,4,F11SP
9,Janssenlei 17,2022-01-22,08:00:00,70,30,40,F11SP
9,Janssenlei 17,2022-01-22,09:00:00,84,34,50,F11SP
9,Janssenlei 17,2022-01-22,10:00:00,114,30,84,F11SP
9,Janssenlei 17,2022-01-22,11:00:00,160,92,68,F11SP
9,Janssenlei 17,2022-01-22,12:00:00,136,76,60,F11SP
9,Janssenlei 17,2022-01-22,13:00:00,160,82,78,F11SP
9,Janssenlei 17,2022-01-22,14:00:00,176,92,84,F11SP
9,Janssenlei 17,2022-01-22,15:00:00,176,90,86,F11SP
9,Janssenlei 17,2022-01-22,16:00:00,110,74,36,F11SP
9,Janssenlei 17,2022-01-22,17:00:00,78,38,40,F11SP
9,Janssenlei 17,2022-01-22,18:00:00,64,42,22,F11SP
9,Janssenlei 17,2022-01-22,19:00:00,44,32,12,F11SP
9,Janssenlei 17,2022-01-22,20:00:00,32,6,26,F11SP
9,Janssenlei 17,2022-01-22,21:00:00,28,14,14,F11SP
9,Janssenlei 17,2022-01-22,22:00:00,22,18,4,F11SP
9,Janssenlei 17,2022-01-22,23:00:00,16,6,10,F11SP
9,Janssenlei 17,2022-01-23,00:00:00,8,2,6,F11SP
9,Janssenlei 17,2022-01-23,01:00:00,6,6,0,F11SP
9,Janssenlei 17,2022-01-23,02:00:00,0,0,0,F11SP
9,Janssenlei 17,2022-01-23,03:00:00,0,0,0,F11SP
9,Janssenlei 17,2022-01-23,04:00:00,6,4,2,F11SP
9,Janssenlei 17,2022-01-23,05:00:00,10,10,0,F11SP
9,Janssenlei 17,2022-01-23,06:00:00,18,10,8,F11SP
9,Janssenlei 17,2022-01-23,07:00:00,30,10,20,F11SP
9,Janssenlei 17,2022-01-23,08:00:00,48,16,32,F11SP
9,Janssenlei 17,2022-01-23,09:00:00,162,40,122,F11SP
9,Janssenlei 17,2022-01-23,10:00:00,198,84,114,F11SP
9,Janssenlei 17,2022-01-23,11:00:00,196,108,88,F11SP
9,Janssenlei 17,2022-01-23,12:00:00,224,132,92,F11SP
9,Janssenlei 17,2022-01-23,13:00:00,184,102,82,F11SP
9,Janssenlei 17,2022-01-23,14:00:00,206,70,136,F11SP
9,Janssenlei 17,2022-01-23,15:00:00,174,108,66,F11SP
9,Janssenlei 17,2022-01-23,16:00:00,128,84,44,F11SP
9,Janssenlei 17,2022-01-23,17:00:00,88,62,26,F11SP
9,Janssenlei 17,2022-01-23,18:00:00,46,24,22,F11SP
9,Janssenlei 17,2022-01-23,19:00:00,20,12,8,F11SP
9,Janssenlei 17,2022-01-23,20:00:00,6,6,0,F11SP
9,Janssenlei 17,2022-01-23,21:00:00,26,14,12,F11SP
9,Janssenlei 17,2022-01-23,22:00:00,12,6,6,F11SP
9,Janssenlei 17,2022-01-23,23:00:00,8,4,4,F11SP
9,Janssenlei 17,2022-01-24,00:00:00,2,2,0,F11SP
9,Janssenlei 17,2022-01-24,01:00:00,4,0,4,F11SP
9,Janssenlei 17,2022-01-24,02:00:00,6,6,0,F11SP
9,Janssenlei 17,2022-01-24,03:00:00,2,2,0,F11SP
9,Janssenlei 17,2022-01-24,04:00:00,8,6,2,F11SP
9,Janssenlei 17,2022-01-24,05:00:00,38,24,14,F11SP
9,Janssenlei 17,2022-01-24,06:00:00,96,68,28,F11SP
9,Janssenlei 17,2022-01-24,07:00:00,268,176,92,F11SP
9,Janssenlei 17,2022-01-24,08:00:00,262,196,66,F11SP
9,Janssenlei 17,2022-01-24,09:00:00,78,40,38,F11SP
9,Janssenlei 17,2022-01-24,10:00:00,64,32,32,F11SP
9,Janssenlei 17,2022-01-24,11:00:00,92,46,46,F11SP
9,Janssenlei 17,2022-01-24,12:00:00,138,64,74,F11SP
9,Janssenlei 17,2022-01-24,13:00:00,162,64,98,F11SP
9,Janssenlei 17,2022-01-24,14:00:00,322,130,192,F11SP
9,Janssenlei 17,2022-01-24,15:00:00,314,122,192,F11SP
9,Janssenlei 17,2022-01-24,16:00:00,384,156,228,F11SP
9,Janssenlei 17,2022-01-24,17:00:00,238,84,154,F11SP
9,Janssenlei 17,2022-01-24,18:00:00,104,42,62,F11SP
9,Janssenlei 17,2022-01-24,19:00:00,42,16,26,F11SP
9,Janssenlei 17,2022-01-24,20:00:00,40,22,18,F11SP
9,Janssenlei 17,2022-01-24,21:00:00,28,16,12,F11SP
9,Janssenlei 17,2022-01-24,22:00:00,28,6,22,F11SP
9,Janssenlei 17,2022-01-24,23:00:00,8,2,6,F11SP
9,Janssenlei 17,2022-01-25,00:00:00,0,0,0,F11SP
9,Janssenlei 17,2022-01-25,01:00:00,0,0,0,F11SP
9,Janssenlei 17,2022-01-25,02:00:00,4,0,4,F11SP
9,Janssenlei 17,2022-01-25,03:00:00,2,2,0,F11SP
9,Janssenlei 17,2022-01-25,04:00:00,12,10,2,F11SP
9,Janssenlei 17,2022-01-25,05:00:00,38,24,14,F11SP
9,Janssenlei 17,2022-01-25,06:00:00,96,56,40,F11SP
9,Janssenlei 17,2022-01-25,07:00:00,200,148,52,F11SP
9,Janssenlei 17,2022-01-25,08:00:00,264,204,60,F11SP
9,Janssenlei 17,2022-01-25,09:00:00,86,40,46,F11SP
9,Janssenlei 17,2022-01-25,10:00:00,70,30,40,F11SP
9,Janssenlei 17,2022-01-25,11:00:00,82,38,44,F11SP
9,Janssenlei 17,2022-01-25,12:00:00,100,58,42,F11SP
9,Janssenlei 17,2022-01-25,13:00:00,122,66,56,F11SP
9,Janssenlei 17,2022-01-25,14:00:00,126,46,80,F11SP
9,Janssenlei 17,2022-01-25,15:00:00,164,68,96,F11SP
9,Janssenlei 17,2022-01-25,16:00:00,258,72,186,F11SP
9,Janssenlei 17,2022-01-25,17:00:00,202,54,148,F11SP
9,Janssenlei 17,2022-01-25,18:00:00,80,18,62,F11SP
9,Janssenlei 17,2022-01-25,19:00:00,22,12,10,F11SP
9,Janssenlei 17,2022-01-25,20:00:00,28,24,4,F11SP
9,Janssenlei 17,2022-01-25,21:00:00,14,10,4,F11SP
9,Janssenlei 17,2022-01-25,22:00:00,20,8,12,F11SP
9,Janssenlei 17,2022-01-25,23:00:00,12,8,4,F11SP
9,Janssenlei 17,2022-01-26,00:00:00,0,0,0,F11SP
9,Janssenlei 17,2022-01-26,01:00:00,0,0,0,F11SP
9,Janssenlei 17,2022-01-26,02:00:00,0,0,0,F11SP
9,Janssenlei 17,2022-01-26,03:00:00,2,2,0,F11SP
9,Janssenlei 17,2022-01-26,04:00:00,12,10,2,F11SP
9,Janssenlei 17,2022-01-26,05:00:00,36,20,16,F11SP
9,Janssenlei 17,2022-01-26,06:00:00,86,48,38,F11SP
9,Janssenlei 17,2022-01-26,07:00:00,196,142,54,F11SP
9,Janssenlei 17,2022-01-26,08:00:00,226,166,60,F11SP
9,Janssenlei 17,2022-01-26,09:00:00,94,58,36,F11SP
9,Janssenlei 17,2022-01-26,10:00:00,58,32,26,F11SP
9,Janssenlei 17,2022-01-26,11:00:00,88,40,48,F11SP
9,Janssenlei 17,2022-01-26,12:00:00,180,50,130,F11SP
9,Janssenlei 17,2022-01-26,13:00:00,124,56,68,F11SP
9,Janssenlei 17,2022-01-26,14:00:00,126,62,64,F11SP
9,Janssenlei 17,2022-01-26,15:00:00,128,64,64,F11SP
9,Janssenlei 17,2022-01-26,16:00:00,172,58,114,F11SP
9,Janssenlei 17,2022-01-26,17:00:00,218,94,124,F11SP
9,Janssenlei 17,2022-01-26,18:00:00,90,32,58,F11SP
9,Janssenlei 17,2022-01-26,19:00:00,62,22,40,F11SP
9,Janssenlei 17,2022-01-26,20:00:00,34,18,16,F11SP
9,Janssenlei 17,2022-01-26,21:00:00,32,22,10,F11SP
9,Janssenlei 17,2022-01-26,22:00:00,40,18,22,F11SP
9,Janssenlei 17,2022-01-26,23:00:00,16,2,14,F11SP
9,Janssenlei 17,2022-01-27,00:00:00,80,10,70,F11SP
9,Janssenlei 17,2022-01-27,01:00:00,18,2,16,F11SP
9,Janssenlei 17,2022-01-27,02:00:00,6,6,0,F11SP
9,Janssenlei 17,2022-01-27,03:00:00,2,2,0,F11SP
9,Janssenlei 17,2022-01-27,04:00:00,10,10,0,F11SP
9,Janssenlei 17,2022-01-27,05:00:00,36,30,6,F11SP
9,Janssenlei 17,2022-01-27,06:00:00,92,58,34,F11SP
9,Janssenlei 17,2022-01-27,07:00:00,204,160,44,F11SP
9,Janssenlei 17,2022-01-27,08:00:00,330,250,80,F11SP
9,Janssenlei 17,2022-01-27,09:00:00,82,50,32,F11SP
9,Janssenlei 17,2022-01-27,10:00:00,40,22,18,F11SP
9,Janssenlei 17,2022-01-27,11:00:00,48,18,30,F11SP
9,Janssenlei 17,2022-01-27,12:00:00,74,22,52,F11SP
9,Janssenlei 17,2022-01-27,13:00:00,92,54,38,F11SP
9,Janssenlei 17,2022-01-27,14:00:00,80,26,54,F11SP
9,Janssenlei 17,2022-01-27,15:00:00,126,32,94,F11SP
9,Janssenlei 17,2022-01-27,16:00:00,202,62,140,F11SP
9,Janssenlei 17,2022-01-27,17:00:00,192,56,136,F11SP
9,Janssenlei 17,2022-01-27,18:00:00,80,22,58,F11SP
9,Janssenlei 17,2022-01-27,19:00:00,38,14,24,F11SP
9,Janssenlei 17,2022-01-27,20:00:00,38,16,22,F11SP
9,Janssenlei 17,2022-01-27,21:00:00,38,28,10,F11SP
9,Janssenlei 17,2022-01-27,22:00:00,34,16,18,F11SP
9,Janssenlei 17,2022-01-27,23:00:00,14,4,10,F11SP
9,Janssenlei 17,2022-01-28,00:00:00,4,2,2,F11SP
9,Janssenlei 17,2022-01-28,01:00:00,10,2,8,F11SP
9,Janssenlei 17,2022-01-28,02:00:00,0,0,0,F11SP
9,Janssenlei 17,2022-01-28,03:00:00,4,2,2,F11SP
9,Janssenlei 17,2022-01-28,04:00:00,6,6,0,F11SP
9,Janssenlei 17,2022-01-28,05:00:00,20,18,2,F11SP
9,Janssenlei 17,2022-01-28,06:00:00,76,46,30,F11SP
9,Janssenlei 17,2022-01-28,07:00:00,166,118,48,F11SP
9,Janssenlei 17,2022-01-28,08:00:00,208,120,88,F11SP
9,Janssenlei 17,2022-01-28,09:00:00,110,50,60,F11SP
9,Janssenlei 17,2022-01-28,10:00:00,96,50,46,F11SP
9,Janssenlei 17,2022-01-28,11:00:00,108,52,56,F11SP
9,Janssenlei 17,2022-01-28,12:00:00,138,62,76,F11SP
9,Janssenlei 17,2022-01-28,13:00:00,196,88,108,F11SP
9,Janssenlei 17,2022-01-28,14:00:00,218,102,116,F11SP
9,Janssenlei 17,2022-01-28,15:00:00,248,84,164,F11SP
9,Janssenlei 17,2022-01-28,16:00:00,254,126,128,F11SP
9,Janssenlei 17,2022-01-28,17:00:00,138,58,80,F11SP
9,Janssenlei 17,2022-01-28,18:00:00,72,30,42,F11SP
9,Janssenlei 17,2022-01-28,19:00:00,50,18,32,F11SP
9,Janssenlei 17,2022-01-28,20:00:00,26,10,16,F11SP
9,Janssenlei 17,2022-01-28,21:00:00,26,18,8,F11SP
9,Janssenlei 17,2022-01-28,22:00:00,28,12,16,F11SP
9,Janssenlei 17,2022-01-28,23:00:00,16,4,12,F11SP
9,Janssenlei 17,2022-01-29,00:00:00,20,10,10,F11SP
9,Janssenlei 17,2022-01-29,01:00:00,14,8,6,F11SP
9,Janssenlei 17,2022-01-29,02:00:00,6,4,2,F11SP
9,Janssenlei 17,2022-01-29,03:00:00,4,2,2,F11SP
9,Janssenlei 17,2022-01-29,04:00:00,2,0,2,F11SP
9,Janssenlei 17,2022-01-29,05:00:00,16,12,4,F11SP
9,Janssenlei 17,2022-01-29,06:00:00,12,6,6,F11SP
9,Janssenlei 17,2022-01-29,07:00:00,28,10,18,F11SP
9,Janssenlei 17,2022-01-29,08:00:00,58,28,30,F11SP
9,Janssenlei 17,2022-01-29,09:00:00,108,28,80,F11SP
9,Janssenlei 17,2022-01-29,10:00:00,104,50,54,F11SP
9,Janssenlei 17,2022-01-29,11:00:00,122,70,52,F11SP
9,Janssenlei 17,2022-01-29,12:00:00,112,54,58,F11SP
9,Janssenlei 17,2022-01-29,13:00:00,140,76,64,F11SP
9,Janssenlei 17,2022-01-29,14:00:00,186,80,106,F11SP
9,Janssenlei 17,2022-01-29,15:00:00,146,82,64,F11SP
9,Janssenlei 17,2022-01-29,16:00:00,106,78,28,F11SP
9,Janssenlei 17,2022-01-29,17:00:00,76,36,40,F11SP
9,Janssenlei 17,2022-01-29,18:00:00,56,36,20,F11SP
9,Janssenlei 17,2022-01-29,19:00:00,28,16,12,F11SP
9,Janssenlei 17,2022-01-29,20:00:00,24,6,18,F11SP
9,Janssenlei 17,2022-01-29,21:00:00,30,12,18,F11SP
9,Janssenlei 17,2022-01-29,22:00:00,38,10,28,F11SP
9,Janssenlei 17,2022-01-29,23:00:00,8,2,6,F11SP
9,Janssenlei 17,2022-01-30,00:00:00,18,4,14,F11SP
9,Janssenlei 17,2022-01-30,01:00:00,12,8,4,F11SP
9,Janssenlei 17,2022-01-30,02:00:00,8,2,6,F11SP
9,Janssenlei 17,2022-01-30,03:00:00,4,2,2,F11SP
9,Janssenlei 17,2022-01-30,04:00:00,2,2,0,F11SP
9,Janssenlei 17,2022-01-30,05:00:00,14,12,2,F11SP
9,Janssenlei 17,2022-01-30,06:00:00,8,4,4,F11SP
9,Janssenlei 17,2022-01-30,07:00:00,22,10,12,F11SP
9,Janssenlei 17,2022-01-30,08:00:00,66,30,36,F11SP
9,Janssenlei 17,2022-01-30,09:00:00,166,74,92,F11SP
9,Janssenlei 17,2022-01-30,10:00:00,268,70,198,F11SP
9,Janssenlei 17,2022-01-30,11:00:00,338,202,136,F11SP
9,Janssenlei 17,2022-01-30,12:00:00,290,166,124,F11SP
9,Janssenlei 17,2022-01-30,13:00:00,278,158,120,F11SP
9,Janssenlei 17,2022-01-30,14:00:00,186,100,86,F11SP
9,Janssenlei 17,2022-01-30,15:00:00,230,112,118,F11SP
9,Janssenlei 17,2022-01-30,16:00:00,138,68,70,F11SP
9,Janssenlei 17,2022-01-30,17:00:00,114,80,34,F11SP
9,Janssenlei 17,2022-01-30,18:00:00,44,28,16,F11SP
9,Janssenlei 17,2022-01-30,19:00:00,34,16,18,F11SP
9,Janssenlei 17,2022-01-30,20:00:00,36,18,18,F11SP
9,Janssenlei 17,2022-01-30,21:00:00,18,6,12,F11SP
9,Janssenlei 17,2022-01-30,22:00:00,20,4,16,F11SP
9,Janssenlei 17,2022-01-30,23:00:00,8,4,4,F11SP
9,Janssenlei 17,2022-01-31,00:00:00,2,0,2,F11SP
9,Janssenlei 17,2022-01-31,01:00:00,2,0,2,F11SP
9,Janssenlei 17,2022-01-31,02:00:00,2,2,0,F11SP
9,Janssenlei 17,2022-01-31,03:00:00,0,0,0,F11SP
9,Janssenlei 17,2022-01-31,04:00:00,0,0,0,F11SP
9,Janssenlei 17,2022-01-31,05:00:00,28,18,10,F11SP
9,Janssenlei 17,2022-01-31,06:00:00,70,46,24,F11SP
9,Janssenlei 17,2022-01-31,07:00:00,188,110,78,F11SP
9,Janssenlei 17,2022-01-31,08:00:00,216,160,56,F11SP
9,Janssenlei 17,2022-01-31,09:00:00,54,34,20,F11SP
9,Janssenlei 17,2022-01-31,10:00:00,40,18,22,F11SP
9,Janssenlei 17,2022-01-31,11:00:00,32,16,16,F11SP
9,Janssenlei 17,2022-01-31,12:00:00,44,18,26,F11SP
9,Janssenlei 17,2022-01-31,13:00:00,82,48,34,F11SP
9,Janssenlei 17,2022-01-31,14:00:00,46,16,30,F11SP
9,Janssenlei 17,2022-01-31,15:00:00,134,38,96,F11SP
9,Janssenlei 17,2022-01-31,16:00:00,214,74,140,F11SP
9,Janssenlei 17,2022-01-31,17:00:00,132,58,74,F11SP
9,Janssenlei 17,2022-01-31,18:00:00,62,12,50,F11SP
9,Janssenlei 17,2022-01-31,19:00:00,32,12,20,F11SP
9,Janssenlei 17,2022-01-31,20:00:00,8,8,0,F11SP
9,Janssenlei 17,2022-01-31,21:00:00,16,6,10,F11SP
9,Janssenlei 17,2022-01-31,22:00:00,22,4,18,F11SP
9,Janssenlei 17,2022-01-31,23:00:00,0,0,0,F11SP
9,Janssenlei 17,2022-02-01,00:00:00,4,2,2,F11SP
9,Janssenlei 17,2022-02-01,01:00:00,0,0,0,F11SP
9,Janssenlei 17,2022-02-01,02:00:00,0,0,0,F11SP
9,Janssenlei 17,2022-02-01,03:00:00,0,0,0,F11SP
9,Janssenlei 17,2022-02-01,04:00:00,6,6,0,F11SP
9,Janssenlei 17,2022-02-01,05:00:00,36,24,12,F11SP
9,Janssenlei 17,2022-02-01,06:00:00,78,54,24,F11SP
9,Janssenlei 17,2022-02-01,07:00:00,220,144,76,F11SP
9,Janssenlei 17,2022-02-01,08:00:00,252,192,60,F11SP
9,Janssenlei 17,2022-02-01,09:00:00,66,32,34,F11SP
9,Janssenlei 17,2022-02-01,10:00:00,30,20,10,F11SP
9,Janssenlei 17,2022-02-01,11:00:00,36,20,16,F11SP
9,Janssenlei 17,2022-02-01,12:00:00,76,42,34,F11SP
9,Janssenlei 17,2022-02-01,13:00:00,108,48,60,F11SP
9,Janssenlei 17,2022-02-01,14:00:00,70,26,44,F11SP
9,Janssenlei 17,2022-02-01,15:00:00,146,44,102,F11SP
9,Janssenlei 17,2022-02-01,16:00:00,264,106,158,F11SP
9,Janssenlei 17,2022-02-01,17:00:00,198,62,136,F11SP
9,Janssenlei 17,2022-02-01,18:00:00,82,30,52,F11SP
9,Janssenlei 17,2022-02-01,19:00:00,62,16,46,F11SP
9,Janssenlei 17,2022-02-01,20:00:00,32,16,16,F11SP
9,Janssenlei 17,2022-02-01,21:00:00,36,24,12,F11SP
9,Janssenlei 17,2022-02-01,22:00:00,38,4,34,F11SP
9,Janssenlei 17,2022-02-01,23:00:00,18,4,14,F11SP
9,Janssenlei 17,2022-02-02,00:00:00,2,2,0,F11SP
9,Janssenlei 17,2022-02-02,01:00:00,0,0,0,F11SP
9,Janssenlei 17,2022-02-02,02:00:00,8,8,0,F11SP
9,Janssenlei 17,2022-02-02,03:00:00,0,0,0,F11SP
9,Janssenlei 17,2022-02-02,04:00:00,12,6,6,F11SP
9,Janssenlei 17,2022-02-02,05:00:00,22,16,6,F11SP
9,Janssenlei 17,2022-02-02,06:00:00,70,54,16,F11SP
9,Janssenlei 17,2022-02-02,07:00:00,238,150,88,F11SP
9,Janssenlei 17,2022-02-02,08:00:00,262,188,74,F11SP
9,Janssenlei 17,2022-02-02,09:00:00,118,66,52,F11SP
9,Janssenlei 17,2022-02-02,10:00:00,84,48,36,F11SP
9,Janssenlei 17,2022-02-02,11:00:00,174,70,104,F11SP
9,Janssenlei 17,2022-02-02,12:00:00,230,100,130,F11SP
9,Janssenlei 17,2022-02-02,13:00:00,152,86,66,F11SP
9,Janssenlei 17,2022-02-02,14:00:00,78,20,58,F11SP
9,Janssenlei 17,2022-02-02,15:00:00,112,54,58,F11SP
9,Janssenlei 17,2022-02-02,16:00:00,154,52,102,F11SP
9,Janssenlei 17,2022-02-02,17:00:00,132,64,68,F11SP
9,Janssenlei 17,2022-02-02,18:00:00,94,40,54,F11SP
9,Janssenlei 17,2022-02-02,19:00:00,54,18,36,F11SP
9,Janssenlei 17,2022-02-02,20:00:00,24,16,8,F11SP
9,Janssenlei 17,2022-02-02,21:00:00,22,8,14,F11SP
9,Janssenlei 17,2022-02-02,22:00:00,22,4,18,F11SP
9,Janssenlei 17,2022-02-02,23:00:00,12,2,10,F11SP
9,Janssenlei 17,2022-02-03,00:00:00,10,4,6,F11SP
9,Janssenlei 17,2022-02-03,01:00:00,0,0,0,F11SP
9,Janssenlei 17,2022-02-03,02:00:00,2,0,2,F11SP
9,Janssenlei 17,2022-02-03,03:00:00,0,0,0,F11SP
9,Janssenlei 17,2022-02-03,04:00:00,10,8,2,F11SP
9,Janssenlei 17,2022-02-03,05:00:00,38,24,14,F11SP
9,Janssenlei 17,2022-02-03,06:00:00,70,46,24,F11SP
9,Janssenlei 17,2022-02-03,07:00:00,220,136,84,F11SP
9,Janssenlei 17,2022-02-03,08:00:00,324,228,96,F11SP
9,Janssenlei 17,2022-02-03,09:00:00,106,52,54,F11SP
9,Janssenlei 17,2022-02-03,10:00:00,60,30,30,F11SP
9,Janssenlei 17,2022-02-03,11:00:00,98,64,34,F11SP
9,Janssenlei 17,2022-02-03,12:00:00,108,50,58,F11SP
9,Janssenlei 17,2022-02-03,13:00:00,140,76,64,F11SP
9,Janssenlei 17,2022-02-03,14:00:00,102,56,46,F11SP
9,Janssenlei 17,2022-02-03,15:00:00,202,92,110,F11SP
9,Janssenlei 17,2022-02-03,16:00:00,322,114,208,F11SP
9,Janssenlei 17,2022-02-03,17:00:00,186,70,116,F11SP
9,Janssenlei 17,2022-02-03,18:00:00,114,36,78,F11SP
9,Janssenlei 17,2022-02-03,19:00:00,48,26,22,F11SP
9,Janssenlei 17,2022-02-03,20:00:00,40,10,30,F11SP
9,Janssenlei 17,2022-02-03,21:00:00,34,16,18,F11SP
9,Janssenlei 17,2022-02-03,22:00:00,44,12,32,F11SP
9,Janssenlei 17,2022-02-03,23:00:00,12,6,6,F11SP
9,Janssenlei 17,2022-02-04,00:00:00,2,2,0,F11SP
9,Janssenlei 17,2022-02-04,01:00:00,0,0,0,F11SP
9,Janssenlei 17,2022-02-04,02:00:00,2,2,0,F11SP
9,Janssenlei 17,2022-02-04,03:00:00,2,2,0,F11SP
9,Janssenlei 17,2022-02-04,04:00:00,14,12,2,F11SP
9,Janssenlei 17,2022-02-04,05:00:00,38,26,12,F11SP
9,Janssenlei 17,2022-02-04,06:00:00,50,32,18,F11SP
9,Janssenlei 17,2022-02-04,07:00:00,184,106,78,F11SP
9,Janssenlei 17,2022-02-04,08:00:00,220,154,66,F11SP
9,Janssenlei 17,2022-02-04,09:00:00,98,60,38,F11SP
9,Janssenlei 17,2022-02-04,10:00:00,76,26,50,F11SP
9,Janssenlei 17,2022-02-04,11:00:00,42,18,24,F11SP
9,Janssenlei 17,2022-02-04,12:00:00,100,50,50,F11SP
9,Janssenlei 17,2022-02-04,13:00:00,90,52,38,F11SP
9,Janssenlei 17,2022-02-04,14:00:00,106,52,54,F11SP
9,Janssenlei 17,2022-02-04,15:00:00,94,34,60,F11SP
9,Janssenlei 17,2022-02-04,16:00:00,214,94,120,F11SP
9,Janssenlei 17,2022-02-04,17:00:00,118,38,80,F11SP
9,Janssenlei 17,2022-02-04,18:00:00,96,44,52,F11SP
9,Janssenlei 17,2022-02-04,19:00:00,40,14,26,F11SP
9,Janssenlei 17,2022-02-04,20:00:00,54,28,26,F11SP
9,Janssenlei 17,2022-02-04,21:00:00,20,10,10,F11SP
9,Janssenlei 17,2022-02-04,22:00:00,20,10,10,F11SP
9,Janssenlei 17,2022-02-04,23:00:00,16,10,6,F11SP
9,Janssenlei 17,2022-02-05,00:00:00,8,2,6,F11SP
9,Janssenlei 17,2022-02-05,01:00:00,20,2,18,F11SP
9,Janssenlei 17,2022-02-05,02:00:00,12,4,8,F11SP
9,Janssenlei 17,2022-02-05,03:00:00,14,12,2,F11SP
9,Janssenlei 17,2022-02-05,04:00:00,4,4,0,F11SP
9,Janssenlei 17,2022-02-05,05:00:00,18,14,4,F11SP
9,Janssenlei 17,2022-02-05,06:00:00,8,6,2,F11SP
9,Janssenlei 17,2022-02-05,07:00:00,26,14,12,F11SP
9,Janssenlei 17,2022-02-05,08:00:00,58,30,28,F11SP
9,Janssenlei 17,2022-02-05,09:00:00,132,20,112,F11SP
9,Janssenlei 17,2022-02-05,10:00:00,168,68,100,F11SP
9,Janssenlei 17,2022-02-05,11:00:00,288,156,132,F11SP
9,Janssenlei 17,2022-02-05,12:00:00,244,128,116,F11SP
9,Janssenlei 17,2022-02-05,13:00:00,322,142,180,F11SP
9,Janssenlei 17,2022-02-05,14:00:00,324,174,150,F11SP
9,Janssenlei 17,2022-02-05,15:00:00,244,156,88,F11SP
9,Janssenlei 17,2022-02-05,16:00:00,174,96,78,F11SP
9,Janssenlei 17,2022-02-05,17:00:00,98,62,36,F11SP
9,Janssenlei 17,2022-02-05,18:00:00,58,42,16,F11SP
9,Janssenlei 17,2022-02-05,19:00:00,32,14,18,F11SP
9,Janssenlei 17,2022-02-05,20:00:00,24,10,14,F11SP
9,Janssenlei 17,2022-02-05,21:00:00,10,4,6,F11SP
9,Janssenlei 17,2022-02-05,22:00:00,22,4,18,F11SP
9,Janssenlei 17,2022-02-05,23:00:00,18,6,12,F11SP
9,Janssenlei 17,2022-02-06,00:00:00,10,4,6,F11SP
9,Janssenlei 17,2022-02-06,01:00:00,12,8,4,F11SP
9,Janssenlei 17,2022-02-06,02:00:00,2,0,2,F11SP
9,Janssenlei 17,2022-02-06,03:00:00,2,0,2,F11SP
9,Janssenlei 17,2022-02-06,04:00:00,0,0,0,F11SP
9,Janssenlei 17,2022-02-06,05:00:00,6,2,4,F11SP
9,Janssenlei 17,2022-02-06,06:00:00,2,2,0,F11SP
9,Janssenlei 17,2022-02-06,07:00:00,2,2,0,F11SP
9,Janssenlei 17,2022-02-06,08:00:00,22,10,12,F11SP
9,Janssenlei 17,2022-02-06,09:00:00,26,6,20,F11SP
9,Janssenlei 17,2022-02-06,10:00:00,20,14,6,F11SP
9,Janssenlei 17,2022-02-06,11:00:00,20,14,6,F11SP
9,Janssenlei 17,2022-02-06,12:00:00,16,4,12,F11SP
9,Janssenlei 17,2022-02-06,13:00:00,6,4,2,F11SP
9,Janssenlei 17,2022-02-06,14:00:00,20,14,6,F11SP
9,Janssenlei 17,2022-02-06,15:00:00,8,6,2,F11SP
9,Janssenlei 17,2022-02-06,16:00:00,26,10,16,F11SP
9,Janssenlei 17,2022-02-06,17:00:00,20,12,8,F11SP
9,Janssenlei 17,2022-02-06,18:00:00,10,6,4,F11SP
9,Janssenlei 17,2022-02-06,19:00:00,12,8,4,F11SP
9,Janssenlei 17,2022-02-06,20:00:00,6,2,4,F11SP
9,Janssenlei 17,2022-02-06,21:00:00,2,2,0,F11SP
9,Janssenlei 17,2022-02-06,22:00:00,4,0,4,F11SP
9,Janssenlei 17,2022-02-06,23:00:00,2,2,0,F11SP
9,Janssenlei 17,2022-02-07,00:00:00,6,2,4,F11SP
9,Janssenlei 17,2022-02-07,01:00:00,2,0,2,F11SP
9,Janssenlei 17,2022-02-07,02:00:00,0,0,0,F11SP
9,Janssenlei 17,2022-02-07,03:00:00,0,0,0,F11SP
9,Janssenlei 17,2022-02-07,04:00:00,8,2,6,F11SP
9,Janssenlei 17,2022-02-07,05:00:00,46,34,12,F11SP
9,Janssenlei 17,2022-02-07,06:00:00,74,58,16,F11SP
9,Janssenlei 17,2022-02-07,07:00:00,206,146,60,F11SP
9,Janssenlei 17,2022-02-07,08:00:00,296,230,66,F11SP
9,Janssenlei 17,2022-02-07,09:00:00,68,48,20,F11SP
9,Janssenlei 17,2022-02-07,10:00:00,56,30,26,F11SP
9,Janssenlei 17,2022-02-07,11:00:00,114,68,46,F11SP
9,Janssenlei 17,2022-02-07,12:00:00,152,86,66,F11SP
9,Janssenlei 17,2022-02-07,13:00:00,192,80,112,F11SP
9,Janssenlei 17,2022-02-07,14:00:00,244,82,162,F11SP
9,Janssenlei 17,2022-02-07,15:00:00,284,120,164,F11SP
9,Janssenlei 17,2022-02-07,16:00:00,350,116,234,F11SP
9,Janssenlei 17,2022-02-07,17:00:00,220,84,136,F11SP
9,Janssenlei 17,2022-02-07,18:00:00,128,46,82,F11SP
9,Janssenlei 17,2022-02-07,19:00:00,50,20,30,F11SP
9,Janssenlei 17,2022-02-07,20:00:00,32,20,12,F11SP
9,Janssenlei 17,2022-02-07,21:00:00,38,30,8,F11SP
9,Janssenlei 17,2022-02-07,22:00:00,40,8,32,F11SP
9,Janssenlei 17,2022-02-07,23:00:00,2,0,2,F11SP
9,Janssenlei 17,2022-02-08,00:00:00,4,0,4,F11SP
9,Janssenlei 17,2022-02-08,01:00:00,0,0,0,F11SP
9,Janssenlei 17,2022-02-08,02:00:00,0,0,0,F11SP
9,Janssenlei 17,2022-02-08,03:00:00,2,2,0,F11SP
9,Janssenlei 17,2022-02-08,04:00:00,4,4,0,F11SP
9,Janssenlei 17,2022-02-08,05:00:00,38,28,10,F11SP
9,Janssenlei 17,2022-02-08,06:00:00,66,40,26,F11SP
9,Janssenlei 17,2022-02-08,07:00:00,306,200,106,F11SP
9,Janssenlei 17,2022-02-08,08:00:00,318,226,92,F11SP
9,Janssenlei 17,2022-02-08,09:00:00,94,54,40,F11SP
9,Janssenlei 17,2022-02-08,10:00:00,60,28,32,F11SP
9,Janssenlei 17,2022-02-08,11:00:00,72,38,34,F11SP
9,Janssenlei 17,2022-02-08,12:00:00,114,56,58,F11SP
9,Janssenlei 17,2022-02-08,13:00:00,152,78,74,F11SP
9,Janssenlei 17,2022-02-08,14:00:00,130,50,80,F11SP
9,Janssenlei 17,2022-02-08,15:00:00,228,82,146,F11SP
9,Janssenlei 17,2022-02-08,16:00:00,354,146,208,F11SP
9,Janssenlei 17,2022-02-08,17:00:00,240,76,164,F11SP
9,Janssenlei 17,2022-02-08,18:00:00,52,30,22,F11SP
9,Janssenlei 17,2022-02-08,19:00:00,72,32,40,F11SP
9,Janssenlei 17,2022-02-08,20:00:00,46,28,18,F11SP
9,Janssenlei 17,2022-02-08,21:00:00,18,12,6,F11SP
9,Janssenlei 17,2022-02-08,22:00:00,40,8,32,F11SP
9,Janssenlei 17,2022-02-08,23:00:00,8,0,8,F11SP
9,Janssenlei 17,2022-02-09,00:00:00,8,0,8,F11SP
9,Janssenlei 17,2022-02-09,01:00:00,0,0,0,F11SP
9,Janssenlei 17,2022-02-09,02:00:00,2,0,2,F11SP
9,Janssenlei 17,2022-02-09,03:00:00,0,0,0,F11SP
9,Janssenlei 17,2022-02-09,04:00:00,10,8,2,F11SP
9,Janssenlei 17,2022-02-09,05:00:00,38,32,6,F11SP
9,Janssenlei 17,2022-02-09,06:00:00,72,46,26,F11SP
9,Janssenlei 17,2022-02-09,07:00:00,284,188,96,F11SP
9,Janssenlei 17,2022-02-09,08:00:00,308,196,112,F11SP
9,Janssenlei 17,2022-02-09,09:00:00,92,50,42,F11SP
9,Janssenlei 17,2022-02-09,10:00:00,114,56,58,F11SP
9,Janssenlei 17,2022-02-09,11:00:00,118,58,60,F11SP
9,Janssenlei 17,2022-02-09,12:00:00,302,120,182,F11SP
9,Janssenlei 17,2022-02-09,13:00:00,256,84,172,F11SP
9,Janssenlei 17,2022-02-09,14:00:00,196,76,120,F11SP
9,Janssenlei 17,2022-02-09,15:00:00,254,108,146,F11SP
9,Janssenlei 17,2022-02-09,16:00:00,236,70,166,F11SP
9,Janssenlei 17,2022-02-09,17:00:00,212,90,122,F11SP
9,Janssenlei 17,2022-02-09,18:00:00,140,68,72,F11SP
9,Janssenlei 17,2022-02-09,19:00:00,88,26,62,F11SP
9,Janssenlei 17,2022-02-09,20:00:00,36,18,18,F11SP
9,Janssenlei 17,2022-02-09,21:00:00,36,20,16,F11SP
9,Janssenlei 17,2022-02-09,22:00:00,42,8,34,F11SP
9,Janssenlei 17,2022-02-09,23:00:00,8,4,4,F11SP
9,Janssenlei 17,2022-02-10,00:00:00,8,0,8,F11SP
9,Janssenlei 17,2022-02-10,01:00:00,0,0,0,F11SP
9,Janssenlei 17,2022-02-10,02:00:00,0,0,0,F11SP
9,Janssenlei 17,2022-02-10,03:00:00,0,0,0,F11SP
9,Janssenlei 17,2022-02-10,04:00:00,8,6,2,F11SP
9,Janssenlei 17,2022-02-10,05:00:00,38,26,12,F11SP
9,Janssenlei 17,2022-02-10,06:00:00,60,32,28,F11SP
9,Janssenlei 17,2022-02-10,07:00:00,228,148,80,F11SP
9,Janssenlei 17,2022-02-10,08:00:00,296,214,82,F11SP
9,Janssenlei 17,2022-02-10,09:00:00,68,34,34,F11SP
9,Janssenlei 17,2022-02-10,10:00:00,32,8,24,F11SP
9,Janssenlei 17,2022-02-10,11:00:00,32,16,16,F11SP
9,Janssenlei 17,2022-02-10,12:00:00,80,38,42,F11SP
9,Janssenlei 17,2022-02-10,13:00:00,74,40,34,F11SP
9,Janssenlei 17,2022-02-10,14:00:00,110,44,66,F11SP
9,Janssenlei 17,2022-02-10,15:00:00,130,36,94,F11SP
9,Janssenlei 17,2022-02-10,16:00:00,230,88,142,F11SP
9,Janssenlei 17,2022-02-10,17:00:00,204,54,150,F11SP
9,Janssenlei 17,2022-02-10,18:00:00,92,36,56,F11SP
9,Janssenlei 17,2022-02-10,19:00:00,52,28,24,F11SP
9,Janssenlei 17,2022-02-10,20:00:00,34,8,26,F11SP
9,Janssenlei 17,2022-02-10,21:00:00,16,10,6,F11SP
9,Janssenlei 17,2022-02-10,22:00:00,50,22,28,F11SP
9,Janssenlei 17,2022-02-10,23:00:00,6,0,6,F11SP
9,Janssenlei 17,2022-02-11,00:00:00,2,0,2,F11SP
9,Janssenlei 17,2022-02-11,01:00:00,0,0,0,F11SP
9,Janssenlei 17,2022-02-11,02:00:00,2,2,0,F11SP
9,Janssenlei 17,2022-02-11,03:00:00,0,0,0,F11SP
9,Janssenlei 17,2022-02-11,04:00:00,10,10,0,F11SP
9,Janssenlei 17,2022-02-11,05:00:00,20,12,8,F11SP
9,Janssenlei 17,2022-02-11,06:00:00,80,54,26,F11SP
9,Janssenlei 17,2022-02-11,07:00:00,202,130,72,F11SP
9,Janssenlei 17,2022-02-11,08:00:00,296,194,102,F11SP
9,Janssenlei 17,2022-02-11,09:00:00,102,48,54,F11SP
9,Janssenlei 17,2022-02-11,10:00:00,86,40,46,F11SP
9,Janssenlei 17,2022-02-11,11:00:00,82,50,32,F11SP
9,Janssenlei 17,2022-02-11,12:00:00,142,60,82,F11SP
9,Janssenlei 17,2022-02-11,13:00:00,150,64,86,F11SP
9,Janssenlei 17,2022-02-11,14:00:00,180,82,98,F11SP
9,Janssenlei 17,2022-02-11,15:00:00,238,96,142,F11SP
9,Janssenlei 17,2022-02-11,16:00:00,320,130,190,F11SP
9,Janssenlei 17,2022-02-11,17:00:00,216,84,132,F11SP
9,Janssenlei 17,2022-02-11,18:00:00,122,54,68,F11SP
9,Janssenlei 17,2022-02-11,19:00:00,70,32,38,F11SP
9,Janssenlei 17,2022-02-11,20:00:00,36,18,18,F11SP
9,Janssenlei 17,2022-02-11,21:00:00,12,4,8,F11SP
9,Janssenlei 17,2022-02-11,22:00:00,34,14,20,F11SP
9,Janssenlei 17,2022-02-11,23:00:00,18,2,16,F11SP
9,Janssenlei 17,2022-02-12,00:00:00,36,22,14,F11SP
9,Janssenlei 17,2022-02-12,01:00:00,12,2,10,F11SP
9,Janssenlei 17,2022-02-12,02:00:00,6,2,4,F11SP
9,Janssenlei 17,2022-02-12,03:00:00,4,2,2,F11SP
9,Janssenlei 17,2022-02-12,04:00:00,0,0,0,F11SP
9,Janssenlei 17,2022-02-12,05:00:00,10,8,2,F11SP
9,Janssenlei 17,2022-02-12,06:00:00,18,12,6,F11SP
9,Janssenlei 17,2022-02-12,07:00:00,10,4,6,F11SP
9,Janssenlei 17,2022-02-12,08:00:00,42,24,18,F11SP
9,Janssenlei 17,2022-02-12,09:00:00,66,20,46,F11SP
9,Janssenlei 17,2022-02-12,10:00:00,174,78,96,F11SP
9,Janssenlei 17,2022-02-12,11:00:00,216,102,114,F11SP
9,Janssenlei 17,2022-02-12,12:00:00,186,94,92,F11SP
9,Janssenlei 17,2022-02-12,13:00:00,284,126,158,F11SP
9,Janssenlei 17,2022-02-12,14:00:00,282,130,152,F11SP
9,Janssenlei 17,2022-02-12,15:00:00,320,186,134,F11SP
9,Janssenlei 17,2022-02-12,16:00:00,192,134,58,F11SP
9,Janssenlei 17,2022-02-12,17:00:00,152,82,70,F11SP
9,Janssenlei 17,2022-02-12,18:00:00,70,52,18,F11SP
9,Janssenlei 17,2022-02-12,19:00:00,48,24,24,F11SP
9,Janssenlei 17,2022-02-12,20:00:00,20,6,14,F11SP
9,Janssenlei 17,2022-02-12,21:00:00,18,4,14,F11SP
9,Janssenlei 17,2022-02-12,22:00:00,16,4,12,F11SP
9,Janssenlei 17,2022-02-12,23:00:00,10,2,8,F11SP
9,Janssenlei 17,2022-02-13,00:00:00,24,4,20,F11SP
9,Janssenlei 17,2022-02-13,01:00:00,8,2,6,F11SP
9,Janssenlei 17,2022-02-13,02:00:00,8,0,8,F11SP
9,Janssenlei 17,2022-02-13,03:00:00,0,0,0,F11SP
9,Janssenlei 17,2022-02-13,04:00:00,6,2,4,F11SP
9,Janssenlei 17,2022-02-13,05:00:00,4,2,2,F11SP
9,Janssenlei 17,2022-02-13,06:00:00,26,16,10,F11SP
9,Janssenlei 17,2022-02-13,07:00:00,20,10,10,F11SP
9,Janssenlei 17,2022-02-13,08:00:00,64,24,40,F11SP
9,Janssenlei 17,2022-02-13,09:00:00,206,64,142,F11SP
9,Janssenlei 17,2022-02-13,10:00:00,250,94,156,F11SP
9,Janssenlei 17,2022-02-13,11:00:00,180,78,102,F11SP
9,Janssenlei 17,2022-02-13,12:00:00,192,122,70,F11SP
9,Janssenlei 17,2022-02-13,13:00:00,226,126,100,F11SP
9,Janssenlei 17,2022-02-13,14:00:00,282,120,162,F11SP
9,Janssenlei 17,2022-02-13,15:00:00,198,98,100,F11SP
9,Janssenlei 17,2022-02-13,16:00:00,156,106,50,F11SP
9,Janssenlei 17,2022-02-13,17:00:00,108,74,34,F11SP
9,Janssenlei 17,2022-02-13,18:00:00,44,22,22,F11SP
9,Janssenlei 17,2022-02-13,19:00:00,40,14,26,F11SP
9,Janssenlei 17,2022-02-13,20:00:00,34,16,18,F11SP
9,Janssenlei 17,2022-02-13,21:00:00,22,8,14,F11SP
9,Janssenlei 17,2022-02-13,22:00:00,10,2,8,F11SP
9,Janssenlei 17,2022-02-13,23:00:00,6,4,2,F11SP
9,Janssenlei 17,2022-02-14,00:00:00,6,0,6,F11SP
9,Janssenlei 17,2022-02-14,01:00:00,0,0,0,F11SP
9,Janssenlei 17,2022-02-14,02:00:00,4,2,2,F11SP
9,Janssenlei 17,2022-02-14,03:00:00,0,0,0,F11SP
9,Janssenlei 17,2022-02-14,04:00:00,4,4,0,F11SP
9,Janssenlei 17,2022-02-14,05:00:00,24,16,8,F11SP
9,Janssenlei 17,2022-02-14,06:00:00,74,54,20,F11SP
9,Janssenlei 17,2022-02-14,07:00:00,224,144,80,F11SP
9,Janssenlei 17,2022-02-14,08:00:00,266,186,80,F11SP
9,Janssenlei 17,2022-02-14,09:00:00,44,26,18,F11SP
9,Janssenlei 17,2022-02-14,10:00:00,36,22,14,F11SP
9,Janssenlei 17,2022-02-14,11:00:00,64,34,30,F11SP
9,Janssenlei 17,2022-02-14,12:00:00,78,50,28,F11SP
9,Janssenlei 17,2022-02-14,13:00:00,78,46,32,F11SP
9,Janssenlei 17,2022-02-14,14:00:00,92,42,50,F11SP
9,Janssenlei 17,2022-02-14,15:00:00,176,60,116,F11SP
9,Janssenlei 17,2022-02-14,16:00:00,308,106,202,F11SP
9,Janssenlei 17,2022-02-14,17:00:00,210,82,128,F11SP
9,Janssenlei 17,2022-02-14,18:00:00,112,52,60,F11SP
9,Janssenlei 17,2022-02-14,19:00:00,60,26,34,F11SP
9,Janssenlei 17,2022-02-14,20:00:00,30,14,16,F11SP
9,Janssenlei 17,2022-02-14,21:00:00,36,20,16,F11SP
9,Janssenlei 17,2022-02-14,22:00:00,34,8,26,F11SP
9,Janssenlei 17,2022-02-14,23:00:00,8,2,6,F11SP
9,Janssenlei 17,2022-02-15,00:00:00,0,0,0,F11SP
9,Janssenlei 17,2022-02-15,01:00:00,0,0,0,F11SP
9,Janssenlei 17,2022-02-15,02:00:00,0,0,0,F11SP
9,Janssenlei 17,2022-02-15,03:00:00,0,0,0,F11SP
9,Janssenlei 17,2022-02-15,04:00:00,10,6,4,F11SP
9,Janssenlei 17,2022-02-15,05:00:00,30,22,8,F11SP
9,Janssenlei 17,2022-02-15,06:00:00,74,50,24,F11SP
9,Janssenlei 17,2022-02-15,07:00:00,244,152,92,F11SP
9,Janssenlei 17,2022-02-15,08:00:00,342,236,106,F11SP
9,Janssenlei 17,2022-02-15,09:00:00,102,50,52,F11SP
9,Janssenlei 17,2022-02-15,10:00:00,110,42,68,F11SP
9,Janssenlei 17,2022-02-15,11:00:00,110,60,50,F11SP
9,Janssenlei 17,2022-02-15,12:00:00,128,58,70,F11SP
9,Janssenlei 17,2022-02-15,13:00:00,136,80,56,F11SP
9,Janssenlei 17,2022-02-15,14:00:00,116,52,64,F11SP
9,Janssenlei 17,2022-02-15,15:00:00,184,86,98,F11SP
9,Janssenlei 17,2022-02-15,16:00:00,302,104,198,F11SP
9,Janssenlei 17,2022-02-15,17:00:00,166,56,110,F11SP
9,Janssenlei 17,2022-02-15,18:00:00,66,16,50,F11SP
9,Janssenlei 17,2022-02-15,19:00:00,36,10,26,F11SP
9,Janssenlei 17,2022-02-15,20:00:00,20,2,18,F11SP
9,Janssenlei 17,2022-02-15,21:00:00,10,2,8,F11SP
9,Janssenlei 17,2022-02-15,22:00:00,38,16,22,F11SP
9,Janssenlei 17,2022-02-15,23:00:00,10,4,6,F11SP
9,Janssenlei 17,2022-02-16,00:00:00,8,4,4,F11SP
9,Janssenlei 17,2022-02-16,01:00:00,0,0,0,F11SP
9,Janssenlei 17,2022-02-16,02:00:00,0,0,0,F11SP
9,Janssenlei 17,2022-02-16,03:00:00,0,0,0,F11SP
9,Janssenlei 17,2022-02-16,04:00:00,10,10,0,F11SP
9,Janssenlei 17,2022-02-16,05:00:00,16,6,10,F11SP
9,Janssenlei 17,2022-02-16,06:00:00,44,30,14,F11SP
9,Janssenlei 17,2022-02-16,07:00:00,226,140,86,F11SP
9,Janssenlei 17,2022-02-16,08:00:00,268,188,80,F11SP
9,Janssenlei 17,2022-02-16,09:00:00,84,42,42,F11SP
9,Janssenlei 17,2022-02-16,10:00:00,64,34,30,F11SP
9,Janssenlei 17,2022-02-16,11:00:00,98,44,54,F11SP
9,Janssenlei 17,2022-02-16,12:00:00,194,76,118,F11SP
9,Janssenlei 17,2022-02-16,13:00:00,144,74,70,F11SP
9,Janssenlei 17,2022-02-16,14:00:00,96,42,54,F11SP
9,Janssenlei 17,2022-02-16,15:00:00,110,58,52,F11SP
9,Janssenlei 17,2022-02-16,16:00:00,148,62,86,F11SP
9,Janssenlei 17,2022-02-16,17:00:00,126,56,70,F11SP
9,Janssenlei 17,2022-02-16,18:00:00,110,56,54,F11SP
9,Janssenlei 17,2022-02-16,19:00:00,54,18,36,F11SP
9,Janssenlei 17,2022-02-16,20:00:00,18,14,4,F11SP
9,Janssenlei 17,2022-02-16,21:00:00,22,8,14,F11SP
9,Janssenlei 17,2022-02-16,22:00:00,38,4,34,F11SP
9,Janssenlei 17,2022-02-16,23:00:00,8,2,6,F11SP
9,Janssenlei 17,2022-02-17,00:00:00,2,0,2,F11SP
9,Janssenlei 17,2022-02-17,01:00:00,0,0,0,F11SP
9,Janssenlei 17,2022-02-17,02:00:00,0,0,0,F11SP
9,Janssenlei 17,2022-02-17,03:00:00,0,0,0,F11SP
9,Janssenlei 17,2022-02-17,04:00:00,6,6,0,F11SP
9,Janssenlei 17,2022-02-17,05:00:00,34,22,12,F11SP
9,Janssenlei 17,2022-02-17,06:00:00,62,42,20,F11SP
9,Janssenlei 17,2022-02-17,07:00:00,234,152,82,F11SP
9,Janssenlei 17,2022-02-17,08:00:00,280,186,94,F11SP
9,Janssenlei 17,2022-02-17,09:00:00,114,52,62,F11SP
9,Janssenlei 17,2022-02-17,10:00:00,82,44,38,F11SP
9,Janssenlei 17,2022-02-17,11:00:00,58,36,22,F11SP
9,Janssenlei 17,2022-02-17,12:00:00,84,42,42,F11SP
9,Janssenlei 17,2022-02-17,13:00:00,122,60,62,F11SP
9,Janssenlei 17,2022-02-17,14:00:00,110,40,70,F11SP
9,Janssenlei 17,2022-02-17,15:00:00,178,72,106,F11SP
9,Janssenlei 17,2022-02-17,16:00:00,308,134,174,F11SP
9,Janssenlei 17,2022-02-17,17:00:00,180,70,110,F11SP
9,Janssenlei 17,2022-02-17,18:00:00,118,44,74,F11SP
9,Janssenlei 17,2022-02-17,19:00:00,64,24,40,F11SP
9,Janssenlei 17,2022-02-17,20:00:00,42,16,26,F11SP
9,Janssenlei 17,2022-02-17,21:00:00,22,18,4,F11SP
9,Janssenlei 17,2022-02-17,22:00:00,68,30,38,F11SP
9,Janssenlei 17,2022-02-17,23:00:00,6,0,6,F11SP
9,Janssenlei 17,2022-02-18,00:00:00,8,2,6,F11SP
9,Janssenlei 17,2022-02-18,01:00:00,4,2,2,F11SP
9,Janssenlei 17,2022-02-18,02:00:00,2,0,2,F11SP
9,Janssenlei 17,2022-02-18,03:00:00,2,2,0,F11SP
9,Janssenlei 17,2022-02-18,04:00:00,6,6,0,F11SP
9,Janssenlei 17,2022-02-18,05:00:00,16,14,2,F11SP
9,Janssenlei 17,2022-02-18,06:00:00,40,20,20,F11SP
9,Janssenlei 17,2022-02-18,07:00:00,148,100,48,F11SP
9,Janssenlei 17,2022-02-18,08:00:00,164,106,58,F11SP
9,Janssenlei 17,2022-02-18,09:00:00,52,40,12,F11SP
9,Janssenlei 17,2022-02-18,10:00:00,38,24,14,F11SP
9,Janssenlei 17,2022-02-18,11:00:00,42,18,24,F11SP
9,Janssenlei 17,2022-02-18,12:00:00,156,38,118,F11SP
9,Janssenlei 17,2022-02-18,13:00:00,86,44,42,F11SP
9,Janssenlei 17,2022-02-18,14:00:00,32,4,28,F11SP
9,Janssenlei 17,2022-02-18,15:00:00,20,8,12,F11SP
9,Janssenlei 17,2022-02-18,16:00:00,20,6,14,F11SP
9,Janssenlei 17,2022-02-18,17:00:00,20,4,16,F11SP
9,Janssenlei 17,2022-02-18,18:00:00,22,6,16,F11SP
9,Janssenlei 17,2022-02-18,19:00:00,16,4,12,F11SP
9,Janssenlei 17,2022-02-18,20:00:00,20,4,16,F11SP
9,Janssenlei 17,2022-02-18,21:00:00,4,0,4,F11SP
9,Janssenlei 17,2022-02-18,22:00:00,8,2,6,F11SP
9,Janssenlei 17,2022-02-18,23:00:00,8,8,0,F11SP
9,Janssenlei 17,2022-02-19,00:00:00,0,0,0,F11SP
9,Janssenlei 17,2022-02-19,01:00:00,2,0,2,F11SP
9,Janssenlei 17,2022-02-19,02:00:00,0,0,0,F11SP
9,Janssenlei 17,2022-02-19,03:00:00,2,0,2,F11SP
9,Janssenlei 17,2022-02-19,04:00:00,8,6,2,F11SP
9,Janssenlei 17,2022-02-19,05:00:00,14,12,2,F11SP
9,Janssenlei 17,2022-02-19,06:00:00,14,8,6,F11SP
9,Janssenlei 17,2022-02-19,07:00:00,22,10,12,F11SP
9,Janssenlei 17,2022-02-19,08:00:00,54,16,38,F11SP
9,Janssenlei 17,2022-02-19,09:00:00,96,24,72,F11SP
9,Janssenlei 17,2022-02-19,10:00:00,130,50,80,F11SP
9,Janssenlei 17,2022-02-19,11:00:00,178,104,74,F11SP
9,Janssenlei 17,2022-02-19,12:00:00,160,92,68,F11SP
9,Janssenlei 17,2022-02-19,13:00:00,130,66,64,F11SP
9,Janssenlei 17,2022-02-19,14:00:00,136,88,48,F11SP
9,Janssenlei 17,2022-02-19,15:00:00,72,42,30,F11SP
9,Janssenlei 17,2022-02-19,16:00:00,54,34,20,F11SP
9,Janssenlei 17,2022-02-19,17:00:00,88,56,32,F11SP
9,Janssenlei 17,2022-02-19,18:00:00,38,18,20,F11SP
9,Janssenlei 17,2022-02-19,19:00:00,12,8,4,F11SP
9,Janssenlei 17,2022-02-19,20:00:00,12,8,4,F11SP
9,Janssenlei 17,2022-02-19,21:00:00,10,6,4,F11SP
9,Janssenlei 17,2022-02-19,22:00:00,18,8,10,F11SP
9,Janssenlei 17,2022-02-19,23:00:00,8,6,2,F11SP
9,Janssenlei 17,2022-02-20,00:00:00,8,2,6,F11SP
9,Janssenlei 17,2022-02-20,01:00:00,6,4,2,F11SP
9,Janssenlei 17,2022-02-20,02:00:00,6,4,2,F11SP
9,Janssenlei 17,2022-02-20,03:00:00,2,0,2,F11SP
9,Janssenlei 17,2022-02-20,04:00:00,0,0,0,F11SP
9,Janssenlei 17,2022-02-20,05:00:00,2,2,0,F11SP
9,Janssenlei 17,2022-02-20,06:00:00,8,6,2,F11SP
9,Janssenlei 17,2022-02-20,07:00:00,8,4,4,F11SP
9,Janssenlei 17,2022-02-20,08:00:00,18,10,8,F11SP
9,Janssenlei 17,2022-02-20,09:00:00,62,20,42,F11SP
9,Janssenlei 17,2022-02-20,10:00:00,84,52,32,F11SP
9,Janssenlei 17,2022-02-20,11:00:00,64,22,42,F11SP
9,Janssenlei 17,2022-02-20,12:00:00,50,28,22,F11SP
9,Janssenlei 17,2022-02-20,13:00:00,36,22,14,F11SP
9,Janssenlei 17,2022-02-20,14:00:00,28,12,16,F11SP
9,Janssenlei 17,2022-02-20,15:00:00,26,10,16,F11SP
9,Janssenlei 17,2022-02-20,16:00:00,20,6,14,F11SP
9,Janssenlei 17,2022-02-20,17:00:00,4,2,2,F11SP
9,Janssenlei 17,2022-02-20,18:00:00,6,4,2,F11SP
9,Janssenlei 17,2022-02-20,19:00:00,6,4,2,F11SP
9,Janssenlei 17,2022-02-20,20:00:00,8,4,4,F11SP
9,Janssenlei 17,2022-02-20,21:00:00,2,0,2,F11SP
9,Janssenlei 17,2022-02-20,22:00:00,4,0,4,F11SP
9,Janssenlei 17,2022-02-20,23:00:00,2,2,0,F11SP
9,Janssenlei 17,2022-02-21,00:00:00,2,0,2,F11SP
9,Janssenlei 17,2022-02-21,01:00:00,0,0,0,F11SP
9,Janssenlei 17,2022-02-21,02:00:00,0,0,0,F11SP
9,Janssenlei 17,2022-02-21,03:00:00,0,0,0,F11SP
9,Janssenlei 17,2022-02-21,04:00:00,2,2,0,F11SP
9,Janssenlei 17,2022-02-21,05:00:00,30,24,6,F11SP
9,Janssenlei 17,2022-02-21,06:00:00,38,28,10,F11SP
9,Janssenlei 17,2022-02-21,07:00:00,172,116,56,F11SP
9,Janssenlei 17,2022-02-21,08:00:00,222,154,68,F11SP
9,Janssenlei 17,2022-02-21,09:00:00,56,30,26,F11SP
9,Janssenlei 17,2022-02-21,10:00:00,28,20,8,F11SP
9,Janssenlei 17,2022-02-21,11:00:00,26,18,8,F11SP
9,Janssenlei 17,2022-02-21,12:00:00,50,26,24,F11SP
9,Janssenlei 17,2022-02-21,13:00:00,38,22,16,F11SP
9,Janssenlei 17,2022-02-21,14:00:00,24,2,22,F11SP
9,Janssenlei 17,2022-02-21,15:00:00,106,24,82,F11SP
9,Janssenlei 17,2022-02-21,16:00:00,182,54,128,F11SP
9,Janssenlei 17,2022-02-21,17:00:00,128,42,86,F11SP
9,Janssenlei 17,2022-02-21,18:00:00,74,24,50,F11SP
9,Janssenlei 17,2022-02-21,19:00:00,62,26,36,F11SP
9,Janssenlei 17,2022-02-21,20:00:00,44,24,20,F11SP
9,Janssenlei 17,2022-02-21,21:00:00,32,26,6,F11SP
9,Janssenlei 17,2022-02-21,22:00:00,20,8,12,F11SP
9,Janssenlei 17,2022-02-21,23:00:00,6,0,6,F11SP
9,Janssenlei 17,2022-02-22,00:00:00,0,0,0,F11SP
9,Janssenlei 17,2022-02-22,01:00:00,2,0,2,F11SP
9,Janssenlei 17,2022-02-22,02:00:00,0,0,0,F11SP
9,Janssenlei 17,2022-02-22,03:00:00,2,2,0,F11SP
9,Janssenlei 17,2022-02-22,04:00:00,10,8,2,F11SP
9,Janssenlei 17,2022-02-22,05:00:00,42,30,12,F11SP
9,Janssenlei 17,2022-02-22,06:00:00,72,54,18,F11SP
9,Janssenlei 17,2022-02-22,07:00:00,230,152,78,F11SP
9,Janssenlei 17,2022-02-22,08:00:00,262,194,68,F11SP
9,Janssenlei 17,2022-02-22,09:00:00,92,46,46,F11SP
9,Janssenlei 17,2022-02-22,10:00:00,64,34,30,F11SP
9,Janssenlei 17,2022-02-22,11:00:00,54,30,24,F11SP
9,Janssenlei 17,2022-02-22,12:00:00,96,48,48,F11SP
9,Janssenlei 17,2022-02-22,13:00:00,64,30,34,F11SP
9,Janssenlei 17,2022-02-22,14:00:00,86,18,68,F11SP
9,Janssenlei 17,2022-02-22,15:00:00,152,62,90,F11SP
9,Janssenlei 17,2022-02-22,16:00:00,252,84,168,F11SP
9,Janssenlei 17,2022-02-22,17:00:00,168,38,130,F11SP
9,Janssenlei 17,2022-02-22,18:00:00,106,32,74,F11SP
9,Janssenlei 17,2022-02-22,19:00:00,32,8,24,F11SP
9,Janssenlei 17,2022-02-22,20:00:00,28,14,14,F11SP
9,Janssenlei 17,2022-02-22,21:00:00,18,12,6,F11SP
9,Janssenlei 17,2022-02-22,22:00:00,30,8,22,F11SP
9,Janssenlei 17,2022-02-22,23:00:00,10,4,6,F11SP
9,Janssenlei 17,2022-02-23,00:00:00,6,2,4,F11SP
9,Janssenlei 17,2022-02-23,01:00:00,10,2,8,F11SP
9,Janssenlei 17,2022-02-23,02:00:00,4,2,2,F11SP
9,Janssenlei 17,2022-02-23,03:00:00,0,0,0,F11SP
9,Janssenlei 17,2022-02-23,04:00:00,4,4,0,F11SP
9,Janssenlei 17,2022-02-23,05:00:00,46,32,14,F11SP
9,Janssenlei 17,2022-02-23,06:00:00,74,50,24,F11SP
9,Janssenlei 17,2022-02-23,07:00:00,294,204,90,F11SP
9,Janssenlei 17,2022-02-23,08:00:00,344,252,92,F11SP
9,Janssenlei 17,2022-02-23,09:00:00,150,68,82,F11SP
9,Janssenlei 17,2022-02-23,10:00:00,140,60,80,F11SP
9,Janssenlei 17,2022-02-23,11:00:00,196,98,98,F11SP
9,Janssenlei 17,2022-02-23,12:00:00,316,134,182,F11SP
9,Janssenlei 17,2022-02-23,13:00:00,384,168,216,F11SP
9,Janssenlei 17,2022-02-23,14:00:00,270,102,168,F11SP
9,Janssenlei 17,2022-02-23,15:00:00,268,138,130,F11SP
9,Janssenlei 17,2022-02-23,16:00:00,342,148,194,F11SP
9,Janssenlei 17,2022-02-23,17:00:00,320,140,180,F11SP
9,Janssenlei 17,2022-02-23,18:00:00,190,98,92,F11SP
9,Janssenlei 17,2022-02-23,19:00:00,60,22,38,F11SP
9,Janssenlei 17,2022-02-23,20:00:00,60,30,30,F11SP
9,Janssenlei 17,2022-02-23,21:00:00,18,4,14,F11SP
9,Janssenlei 17,2022-02-23,22:00:00,38,6,32,F11SP
9,Janssenlei 17,2022-02-23,23:00:00,10,4,6,F11SP
9,Janssenlei 17,2022-02-24,00:00:00,6,6,0,F11SP
9,Janssenlei 17,2022-02-24,01:00:00,4,0,4,F11SP
9,Janssenlei 17,2022-02-24,02:00:00,0,0,0,F11SP
9,Janssenlei 17,2022-02-24,03:00:00,0,0,0,F11SP
9,Janssenlei 17,2022-02-24,04:00:00,8,6,2,F11SP
9,Janssenlei 17,2022-02-24,05:00:00,50,32,18,F11SP
9,Janssenlei 17,2022-02-24,06:00:00,86,66,20,F11SP
9,Janssenlei 17,2022-02-24,07:00:00,260,172,88,F11SP
9,Janssenlei 17,2022-02-24,08:00:00,312,210,102,F11SP
9,Janssenlei 17,2022-02-24,09:00:00,104,56,48,F11SP
9,Janssenlei 17,2022-02-24,10:00:00,98,46,52,F11SP
9,Janssenlei 17,2022-02-24,11:00:00,62,30,32,F11SP
9,Janssenlei 17,2022-02-24,12:00:00,94,54,40,F11SP
9,Janssenlei 17,2022-02-24,13:00:00,80,38,42,F11SP
9,Janssenlei 17,2022-02-24,14:00:00,54,24,30,F11SP
9,Janssenlei 17,2022-02-24,15:00:00,114,38,76,F11SP
9,Janssenlei 17,2022-02-24,16:00:00,302,108,194,F11SP
9,Janssenlei 17,2022-02-24,17:00:00,212,72,140,F11SP
9,Janssenlei 17,2022-02-24,18:00:00,80,34,46,F11SP
9,Janssenlei 17,2022-02-24,19:00:00,62,34,28,F11SP
9,Janssenlei 17,2022-02-24,20:00:00,18,4,14,F11SP
9,Janssenlei 17,2022-02-24,21:00:00,24,10,14,F11SP
9,Janssenlei 17,2022-02-24,22:00:00,26,6,20,F11SP
9,Janssenlei 17,2022-02-24,23:00:00,16,2,14,F11SP
9,Janssenlei 17,2022-02-25,00:00:00,4,0,4,F11SP
9,Janssenlei 17,2022-02-25,01:00:00,2,2,0,F11SP
9,Janssenlei 17,2022-02-25,02:00:00,4,0,4,F11SP
9,Janssenlei 17,2022-02-25,03:00:00,2,0,2,F11SP
9,Janssenlei 17,2022-02-25,04:00:00,8,6,2,F11SP
9,Janssenlei 17,2022-02-25,05:00:00,22,16,6,F11SP
9,Janssenlei 17,2022-02-25,06:00:00,58,44,14,F11SP
9,Janssenlei 17,2022-02-25,07:00:00,180,122,58,F11SP
9,Janssenlei 17,2022-02-25,08:00:00,252,168,84,F11SP
9,Janssenlei 17,2022-02-25,09:00:00,78,48,30,F11SP
9,Janssenlei 17,2022-02-25,10:00:00,66,34,32,F11SP
9,Janssenlei 17,2022-02-25,11:00:00,76,34,42,F11SP
9,Janssenlei 17,2022-02-25,12:00:00,114,48,66,F11SP
9,Janssenlei 17,2022-02-25,13:00:00,90,44,46,F11SP
9,Janssenlei 17,2022-02-25,14:00:00,88,28,60,F11SP
9,Janssenlei 17,2022-02-25,15:00:00,160,52,108,F11SP
9,Janssenlei 17,2022-02-25,16:00:00,248,98,150,F11SP
9,Janssenlei 17,2022-02-25,17:00:00,168,68,100,F11SP
9,Janssenlei 17,2022-02-25,18:00:00,122,50,72,F11SP
9,Janssenlei 17,2022-02-25,19:00:00,62,26,36,F11SP
9,Janssenlei 17,2022-02-25,20:00:00,34,22,12,F11SP
9,Janssenlei 17,2022-02-25,21:00:00,36,16,20,F11SP
9,Janssenlei 17,2022-02-25,22:00:00,26,8,18,F11SP
9,Janssenlei 17,2022-02-25,23:00:00,12,0,12,F11SP
9,Janssenlei 17,2022-02-26,00:00:00,12,4,8,F11SP
9,Janssenlei 17,2022-02-26,01:00:00,12,2,10,F11SP
9,Janssenlei 17,2022-02-26,02:00:00,2,0,2,F11SP
9,Janssenlei 17,2022-02-26,03:00:00,4,2,2,F11SP
9,Janssenlei 17,2022-02-26,04:00:00,6,2,4,F11SP
9,Janssenlei 17,2022-02-26,05:00:00,8,6,2,F11SP
9,Janssenlei 17,2022-02-26,06:00:00,12,2,10,F11SP
9,Janssenlei 17,2022-02-26,07:00:00,12,4,8,F11SP
9,Janssenlei 17,2022-02-26,08:00:00,58,30,28,F11SP
9,Janssenlei 17,2022-02-26,09:00:00,92,36,56,F11SP
9,Janssenlei 17,2022-02-26,10:00:00,204,58,146,F11SP
9,Janssenlei 17,2022-02-26,11:00:00,232,110,122,F11SP
9,Janssenlei 17,2022-02-26,12:00:00,206,122,84,F11SP
9,Janssenlei 17,2022-02-26,13:00:00,268,126,142,F11SP
9,Janssenlei 17,2022-02-26,14:00:00,356,140,216,F11SP
9,Janssenlei 17,2022-02-26,15:00:00,242,146,96,F11SP
9,Janssenlei 17,2022-02-26,16:00:00,188,126,62,F11SP
9,Janssenlei 17,2022-02-26,17:00:00,114,68,46,F11SP
9,Janssenlei 17,2022-02-26,18:00:00,66,52,14,F11SP
9,Janssenlei 17,2022-02-26,19:00:00,42,22,20,F11SP
9,Janssenlei 17,2022-02-26,20:00:00,26,12,14,F11SP
9,Janssenlei 17,2022-02-26,21:00:00,32,16,16,F11SP
9,Janssenlei 17,2022-02-26,22:00:00,32,10,22,F11SP
9,Janssenlei 17,2022-02-26,23:00:00,26,14,12,F11SP
9,Janssenlei 17,2022-02-27,00:00:00,14,2,12,F11SP
9,Janssenlei 17,2022-02-27,01:00:00,12,4,8,F11SP
9,Janssenlei 17,2022-02-27,02:00:00,8,0,8,F11SP
9,Janssenlei 17,2022-02-27,03:00:00,2,0,2,F11SP
9,Janssenlei 17,2022-02-27,04:00:00,2,0,2,F11SP
9,Janssenlei 17,2022-02-27,05:00:00,12,10,2,F11SP
9,Janssenlei 17,2022-02-27,06:00:00,12,6,6,F11SP
9,Janssenlei 17,2022-02-27,07:00:00,34,8,26,F11SP
9,Janssenlei 17,2022-02-27,08:00:00,68,28,40,F11SP
9,Janssenlei 17,2022-02-27,09:00:00,240,62,178,F11SP
9,Janssenlei 17,2022-02-27,10:00:00,264,70,194,F11SP
9,Janssenlei 17,2022-02-27,11:00:00,322,164,158,F11SP
9,Janssenlei 17,2022-02-27,12:00:00,262,156,106,F11SP
9,Janssenlei 17,2022-02-27,13:00:00,332,130,202,F11SP
9,Janssenlei 17,2022-02-27,14:00:00,364,144,220,F11SP
9,Janssenlei 17,2022-02-27,15:00:00,282,166,116,F11SP
9,Janssenlei 17,2022-02-27,16:00:00,226,146,80,F11SP
9,Janssenlei 17,2022-02-27,17:00:00,132,86,46,F11SP
9,Janssenlei 17,2022-02-27,18:00:00,80,40,40,F11SP
9,Janssenlei 17,2022-02-27,19:00:00,26,18,8,F11SP
9,Janssenlei 17,2022-02-27,20:00:00,28,6,22,F11SP
9,Janssenlei 17,2022-02-27,21:00:00,14,6,8,F11SP
9,Janssenlei 17,2022-02-27,22:00:00,34,14,20,F11SP
9,Janssenlei 17,2022-02-27,23:00:00,10,2,8,F11SP
9,Janssenlei 17,2022-02-28,00:00:00,6,2,4,F11SP
9,Janssenlei 17,2022-02-28,01:00:00,6,0,6,F11SP
9,Janssenlei 17,2022-02-28,02:00:00,2,0,2,F11SP
9,Janssenlei 17,2022-02-28,03:00:00,0,0,0,F11SP
9,Janssenlei 17,2022-02-28,04:00:00,6,6,0,F11SP
9,Janssenlei 17,2022-02-28,05:00:00,34,26,8,F11SP
9,Janssenlei 17,2022-02-28,06:00:00,86,54,32,F11SP
9,Janssenlei 17,2022-02-28,07:00:00,178,130,48,F11SP
9,Janssenlei 17,2022-02-28,08:00:00,200,120,80,F11SP
9,Janssenlei 17,2022-02-28,09:00:00,100,56,44,F11SP
9,Janssenlei 17,2022-02-28,10:00:00,106,48,58,F11SP
9,Janssenlei 17,2022-02-28,11:00:00,144,68,76,F11SP
9,Janssenlei 17,2022-02-28,12:00:00,162,80,82,F11SP
9,Janssenlei 17,2022-02-28,13:00:00,220,88,132,F11SP
9,Janssenlei 17,2022-02-28,14:00:00,228,78,150,F11SP
9,Janssenlei 17,2022-02-28,15:00:00,226,100,126,F11SP
9,Janssenlei 17,2022-02-28,16:00:00,298,152,146,F11SP
9,Janssenlei 17,2022-02-28,17:00:00,308,134,174,F11SP
9,Janssenlei 17,2022-02-28,18:00:00,144,54,90,F11SP
9,Janssenlei 17,2022-02-28,19:00:00,60,22,38,F11SP
9,Janssenlei 17,2022-02-28,20:00:00,40,24,16,F11SP
9,Janssenlei 17,2022-02-28,21:00:00,32,18,14,F11SP
9,Janssenlei 17,2022-02-28,22:00:00,36,8,28,F11SP
9,Janssenlei 17,2022-02-28,23:00:00,4,0,4,F11SP
9,Janssenlei 17,2022-03-01,00:00:00,8,4,4,F11SP
9,Janssenlei 17,2022-03-01,01:00:00,0,0,0,F11SP
9,Janssenlei 17,2022-03-01,02:00:00,0,0,0,F11SP
9,Janssenlei 17,2022-03-01,03:00:00,0,0,0,F11SP
9,Janssenlei 17,2022-03-01,04:00:00,6,4,2,F11SP
9,Janssenlei 17,2022-03-01,05:00:00,32,22,10,F11SP
9,Janssenlei 17,2022-03-01,06:00:00,96,66,30,F11SP
9,Janssenlei 17,2022-03-01,07:00:00,186,144,42,F11SP
9,Janssenlei 17,2022-03-01,08:00:00,208,134,74,F11SP
9,Janssenlei 17,2022-03-01,09:00:00,92,52,40,F11SP
9,Janssenlei 17,2022-03-01,10:00:00,68,18,50,F11SP
9,Janssenlei 17,2022-03-01,11:00:00,72,32,40,F11SP
9,Janssenlei 17,2022-03-01,12:00:00,80,42,38,F11SP
9,Janssenlei 17,2022-03-01,13:00:00,108,58,50,F11SP
9,Janssenlei 17,2022-03-01,14:00:00,110,46,64,F11SP
9,Janssenlei 17,2022-03-01,15:00:00,96,40,56,F11SP
9,Janssenlei 17,2022-03-01,16:00:00,230,84,146,F11SP
9,Janssenlei 17,2022-03-01,17:00:00,204,62,142,F11SP
9,Janssenlei 17,2022-03-01,18:00:00,158,42,116,F11SP
9,Janssenlei 17,2022-03-01,19:00:00,58,32,26,F11SP
9,Janssenlei 17,2022-03-01,20:00:00,34,24,10,F11SP
9,Janssenlei 17,2022-03-01,21:00:00,12,4,8,F11SP
9,Janssenlei 17,2022-03-01,22:00:00,42,20,22,F11SP
9,Janssenlei 17,2022-03-01,23:00:00,10,4,6,F11SP
9,Janssenlei 17,2022-03-02,00:00:00,8,0,8,F11SP
9,Janssenlei 17,2022-03-02,01:00:00,4,4,0,F11SP
9,Janssenlei 17,2022-03-02,02:00:00,0,0,0,F11SP
9,Janssenlei 17,2022-03-02,03:00:00,0,0,0,F11SP
9,Janssenlei 17,2022-03-02,04:00:00,6,4,2,F11SP
9,Janssenlei 17,2022-03-02,05:00:00,34,24,10,F11SP
9,Janssenlei 17,2022-03-02,06:00:00,90,54,36,F11SP
9,Janssenlei 17,2022-03-02,07:00:00,200,148,52,F11SP
9,Janssenlei 17,2022-03-02,08:00:00,152,96,56,F11SP
9,Janssenlei 17,2022-03-02,09:00:00,106,62,44,F11SP
9,Janssenlei 17,2022-03-02,10:00:00,122,56,66,F11SP
9,Janssenlei 17,2022-03-02,11:00:00,88,44,44,F11SP
9,Janssenlei 17,2022-03-02,12:00:00,116,48,68,F11SP
9,Janssenlei 17,2022-03-02,13:00:00,176,84,92,F11SP
9,Janssenlei 17,2022-03-02,14:00:00,236,92,144,F11SP
9,Janssenlei 17,2022-03-02,15:00:00,210,96,114,F11SP
9,Janssenlei 17,2022-03-02,16:00:00,292,124,168,F11SP
9,Janssenlei 17,2022-03-02,17:00:00,264,108,156,F11SP
9,Janssenlei 17,2022-03-02,18:00:00,154,66,88,F11SP
9,Janssenlei 17,2022-03-02,19:00:00,54,22,32,F11SP
9,Janssenlei 17,2022-03-02,20:00:00,40,18,22,F11SP
9,Janssenlei 17,2022-03-02,21:00:00,30,10,20,F11SP
9,Janssenlei 17,2022-03-02,22:00:00,40,14,26,F11SP
9,Janssenlei 17,2022-03-02,23:00:00,12,6,6,F11SP
9,Janssenlei 17,2022-03-03,00:00:00,8,2,6,F11SP
9,Janssenlei 17,2022-03-03,01:00:00,0,0,0,F11SP
9,Janssenlei 17,2022-03-03,02:00:00,0,0,0,F11SP
9,Janssenlei 17,2022-03-03,03:00:00,0,0,0,F11SP
9,Janssenlei 17,2022-03-03,04:00:00,2,2,0,F11SP
9,Janssenlei 17,2022-03-03,05:00:00,34,24,10,F11SP
9,Janssenlei 17,2022-03-03,06:00:00,116,84,32,F11SP
9,Janssenlei 17,2022-03-03,07:00:00,168,114,54,F11SP
9,Janssenlei 17,2022-03-03,08:00:00,192,130,62,F11SP
9,Janssenlei 17,2022-03-03,09:00:00,96,54,42,F11SP
9,Janssenlei 17,2022-03-03,10:00:00,82,40,42,F11SP
9,Janssenlei 17,2022-03-03,11:00:00,112,70,42,F11SP
9,Janssenlei 17,2022-03-03,12:00:00,142,72,70,F11SP
9,Janssenlei 17,2022-03-03,13:00:00,222,88,134,F11SP
9,Janssenlei 17,2022-03-03,14:00:00,266,92,174,F11SP
9,Janssenlei 17,2022-03-03,15:00:00,226,108,118,F11SP
9,Janssenlei 17,2022-03-03,16:00:00,356,164,192,F11SP
9,Janssenlei 17,2022-03-03,17:00:00,270,88,182,F11SP
9,Janssenlei 17,2022-03-03,18:00:00,154,46,108,F11SP
9,Janssenlei 17,2022-03-03,19:00:00,76,32,44,F11SP
9,Janssenlei 17,2022-03-03,20:00:00,36,20,16,F11SP
9,Janssenlei 17,2022-03-03,21:00:00,26,10,16,F11SP
9,Janssenlei 17,2022-03-03,22:00:00,68,32,36,F11SP
9,Janssenlei 17,2022-03-03,23:00:00,10,2,8,F11SP
9,Janssenlei 17,2022-03-04,00:00:00,12,8,4,F11SP
9,Janssenlei 17,2022-03-04,01:00:00,14,10,4,F11SP
9,Janssenlei 17,2022-03-04,02:00:00,0,0,0,F11SP
9,Janssenlei 17,2022-03-04,03:00:00,2,0,2,F11SP
9,Janssenlei 17,2022-03-04,04:00:00,6,6,0,F11SP
9,Janssenlei 17,2022-03-04,05:00:00,30,26,4,F11SP
9,Janssenlei 17,2022-03-04,06:00:00,66,38,28,F11SP
9,Janssenlei 17,2022-03-04,07:00:00,142,86,56,F11SP
9,Janssenlei 17,2022-03-04,08:00:00,158,100,58,F11SP
9,Janssenlei 17,2022-03-04,09:00:00,110,62,48,F11SP
9,Janssenlei 17,2022-03-04,10:00:00,108,54,54,F11SP
9,Janssenlei 17,2022-03-04,11:00:00,126,62,64,F11SP
9,Janssenlei 17,2022-03-04,12:00:00,146,68,78,F11SP
9,Janssenlei 17,2022-03-04,13:00:00,238,74,164,F11SP
9,Janssenlei 17,2022-03-04,14:00:00,294,108,186,F11SP
9,Janssenlei 17,2022-03-04,15:00:00,340,174,166,F11SP
9,Janssenlei 17,2022-03-04,16:00:00,330,170,160,F11SP
9,Janssenlei 17,2022-03-04,17:00:00,274,148,126,F11SP
9,Janssenlei 17,2022-03-04,18:00:00,232,78,154,F11SP
9,Janssenlei 17,2022-03-04,19:00:00,52,24,28,F11SP
9,Janssenlei 17,2022-03-04,20:00:00,34,12,22,F11SP
9,Janssenlei 17,2022-03-04,21:00:00,18,8,10,F11SP
9,Janssenlei 17,2022-03-04,22:00:00,30,8,22,F11SP
9,Janssenlei 17,2022-03-04,23:00:00,12,8,4,F11SP
9,Janssenlei 17,2022-03-05,00:00:00,14,0,14,F11SP
9,Janssenlei 17,2022-03-05,01:00:00,12,4,8,F11SP
9,Janssenlei 17,2022-03-05,02:00:00,6,2,4,F11SP
9,Janssenlei 17,2022-03-05,03:00:00,2,2,0,F11SP
9,Janssenlei 17,2022-03-05,04:00:00,8,0,8,F11SP
9,Janssenlei 17,2022-03-05,05:00:00,12,12,0,F11SP
9,Janssenlei 17,2022-03-05,06:00:00,10,8,2,F11SP
9,Janssenlei 17,2022-03-05,07:00:00,36,14,22,F11SP
9,Janssenlei 17,2022-03-05,08:00:00,62,24,38,F11SP
9,Janssenlei 17,2022-03-05,09:00:00,122,32,90,F11SP
9,Janssenlei 17,2022-03-05,10:00:00,168,74,94,F11SP
9,Janssenlei 17,2022-03-05,11:00:00,242,100,142,F11SP
9,Janssenlei 17,2022-03-05,12:00:00,278,126,152,F11SP
9,Janssenlei 17,2022-03-05,13:00:00,290,126,164,F11SP
9,Janssenlei 17,2022-03-05,14:00:00,410,162,248,F11SP
9,Janssenlei 17,2022-03-05,15:00:00,274,150,124,F11SP
9,Janssenlei 17,2022-03-05,16:00:00,262,170,92,F11SP
9,Janssenlei 17,2022-03-05,17:00:00,152,102,50,F11SP
9,Janssenlei 17,2022-03-05,18:00:00,102,62,40,F11SP
9,Janssenlei 17,2022-03-05,19:00:00,28,12,16,F11SP
9,Janssenlei 17,2022-03-05,20:00:00,32,12,20,F11SP
9,Janssenlei 17,2022-03-05,21:00:00,46,22,24,F11SP
9,Janssenlei 17,2022-03-05,22:00:00,32,16,16,F11SP
9,Janssenlei 17,2022-03-05,23:00:00,28,14,14,F11SP
9,Janssenlei 17,2022-03-06,00:00:00,24,12,12,F11SP
9,Janssenlei 17,2022-03-06,01:00:00,18,12,6,F11SP
9,Janssenlei 17,2022-03-06,02:00:00,6,2,4,F11SP
9,Janssenlei 17,2022-03-06,03:00:00,0,0,0,F11SP
9,Janssenlei 17,2022-03-06,04:00:00,2,2,0,F11SP
9,Janssenlei 17,2022-03-06,05:00:00,16,10,6,F11SP
9,Janssenlei 17,2022-03-06,06:00:00,22,12,10,F11SP
9,Janssenlei 17,2022-03-06,07:00:00,36,14,22,F11SP
9,Janssenlei 17,2022-03-06,08:00:00,52,26,26,F11SP
9,Janssenlei 17,2022-03-06,09:00:00,136,30,106,F11SP
9,Janssenlei 17,2022-03-06,10:00:00,208,94,114,F11SP
9,Janssenlei 17,2022-03-06,11:00:00,232,116,116,F11SP
9,Janssenlei 17,2022-03-06,12:00:00,274,166,108,F11SP
9,Janssenlei 17,2022-03-06,13:00:00,234,112,122,F11SP
9,Janssenlei 17,2022-03-06,14:00:00,280,136,144,F11SP
9,Janssenlei 17,2022-03-06,15:00:00,166,82,84,F11SP
9,Janssenlei 17,2022-03-06,16:00:00,134,62,72,F11SP
9,Janssenlei 17,2022-03-06,17:00:00,124,66,58,F11SP
9,Janssenlei 17,2022-03-06,18:00:00,84,52,32,F11SP
9,Janssenlei 17,2022-03-06,19:00:00,34,16,18,F11SP
9,Janssenlei 17,2022-03-06,20:00:00,24,12,12,F11SP
9,Janssenlei 17,2022-03-06,21:00:00,16,12,4,F11SP
9,Janssenlei 17,2022-03-06,22:00:00,22,10,12,F11SP
9,Janssenlei 17,2022-03-06,23:00:00,4,4,0,F11SP
9,Janssenlei 17,2022-03-07,00:00:00,0,0,0,F11SP
9,Janssenlei 17,2022-03-07,01:00:00,6,2,4,F11SP
9,Janssenlei 17,2022-03-07,02:00:00,0,0,0,F11SP
9,Janssenlei 17,2022-03-07,03:00:00,4,4,0,F11SP
9,Janssenlei 17,2022-03-07,04:00:00,8,8,0,F11SP
9,Janssenlei 17,2022-03-07,05:00:00,36,30,6,F11SP
9,Janssenlei 17,2022-03-07,06:00:00,118,78,40,F11SP
9,Janssenlei 17,2022-03-07,07:00:00,312,204,108,F11SP
9,Janssenlei 17,2022-03-07,08:00:00,362,244,118,F11SP
9,Janssenlei 17,2022-03-07,09:00:00,110,68,42,F11SP
9,Janssenlei 17,2022-03-07,10:00:00,54,30,24,F11SP
9,Janssenlei 17,2022-03-07,11:00:00,68,32,36,F11SP
9,Janssenlei 17,2022-03-07,12:00:00,126,78,48,F11SP
9,Janssenlei 17,2022-03-07,13:00:00,134,60,74,F11SP
9,Janssenlei 17,2022-03-07,14:00:00,152,74,78,F11SP
9,Janssenlei 17,2022-03-07,15:00:00,200,104,96,F11SP
9,Janssenlei 17,2022-03-07,16:00:00,458,142,316,F11SP
9,Janssenlei 17,2022-03-07,17:00:00,316,94,222,F11SP
9,Janssenlei 17,2022-03-07,18:00:00,150,46,104,F11SP
9,Janssenlei 17,2022-03-07,19:00:00,76,34,42,F11SP
9,Janssenlei 17,2022-03-07,20:00:00,44,20,24,F11SP
9,Janssenlei 17,2022-03-07,21:00:00,48,40,8,F11SP
9,Janssenlei 17,2022-03-07,22:00:00,42,12,30,F11SP
9,Janssenlei 17,2022-03-07,23:00:00,6,0,6,F11SP
9,Janssenlei 17,2022-03-08,00:00:00,4,4,0,F11SP
9,Janssenlei 17,2022-03-08,01:00:00,0,0,0,F11SP
9,Janssenlei 17,2022-03-08,02:00:00,0,0,0,F11SP
9,Janssenlei 17,2022-03-08,03:00:00,4,2,2,F11SP
9,Janssenlei 17,2022-03-08,04:00:00,12,8,4,F11SP
9,Janssenlei 17,2022-03-08,05:00:00,44,34,10,F11SP
9,Janssenlei 17,2022-03-08,06:00:00,120,80,40,F11SP
9,Janssenlei 17,2022-03-08,07:00:00,352,242,110,F11SP
9,Janssenlei 17,2022-03-08,08:00:00,374,262,112,F11SP
9,Janssenlei 17,2022-03-08,09:00:00,120,58,62,F11SP
9,Janssenlei 17,2022-03-08,10:00:00,86,42,44,F11SP
9,Janssenlei 17,2022-03-08,11:00:00,84,44,40,F11SP
9,Janssenlei 17,2022-03-08,12:00:00,128,64,64,F11SP
9,Janssenlei 17,2022-03-08,13:00:00,176,84,92,F11SP
9,Janssenlei 17,2022-03-08,14:00:00,168,78,90,F11SP
9,Janssenlei 17,2022-03-08,15:00:00,240,110,130,F11SP
9,Janssenlei 17,2022-03-08,16:00:00,398,158,240,F11SP
9,Janssenlei 17,2022-03-08,17:00:00,334,100,234,F11SP
9,Janssenlei 17,2022-03-08,18:00:00,242,108,134,F11SP
9,Janssenlei 17,2022-03-08,19:00:00,84,44,40,F11SP
9,Janssenlei 17,2022-03-08,20:00:00,62,28,34,F11SP
9,Janssenlei 17,2022-03-08,21:00:00,34,14,20,F11SP
9,Janssenlei 17,2022-03-08,22:00:00,32,8,24,F11SP
9,Janssenlei 17,2022-03-08,23:00:00,20,6,14,F11SP
9,Janssenlei 17,2022-03-09,00:00:00,20,2,18,F11SP
9,Janssenlei 17,2022-03-09,01:00:00,4,0,4,F11SP
9,Janssenlei 17,2022-03-09,02:00:00,0,0,0,F11SP
9,Janssenlei 17,2022-03-09,03:00:00,0,0,0,F11SP
9,Janssenlei 17,2022-03-09,04:00:00,12,12,0,F11SP
9,Janssenlei 17,2022-03-09,05:00:00,34,26,8,F11SP
9,Janssenlei 17,2022-03-09,06:00:00,118,80,38,F11SP
9,Janssenlei 17,2022-03-09,07:00:00,364,226,138,F11SP
9,Janssenlei 17,2022-03-09,08:00:00,340,238,102,F11SP
9,Janssenlei 17,2022-03-09,09:00:00,146,74,72,F11SP
9,Janssenlei 17,2022-03-09,10:00:00,126,74,52,F11SP
9,Janssenlei 17,2022-03-09,11:00:00,148,78,70,F11SP
9,Janssenlei 17,2022-03-09,12:00:00,372,154,218,F11SP
9,Janssenlei 17,2022-03-09,13:00:00,240,110,130,F11SP
9,Janssenlei 17,2022-03-09,14:00:00,306,110,196,F11SP
9,Janssenlei 17,2022-03-09,15:00:00,272,112,160,F11SP
9,Janssenlei 17,2022-03-09,16:00:00,384,188,196,F11SP
9,Janssenlei 17,2022-03-09,17:00:00,352,138,214,F11SP
9,Janssenlei 17,2022-03-09,18:00:00,248,132,116,F11SP
9,Janssenlei 17,2022-03-09,19:00:00,114,54,60,F11SP
9,Janssenlei 17,2022-03-09,20:00:00,56,20,36,F11SP
9,Janssenlei 17,2022-03-09,21:00:00,38,24,14,F11SP
9,Janssenlei 17,2022-03-09,22:00:00,50,12,38,F11SP
9,Janssenlei 17,2022-03-09,23:00:00,18,2,16,F11SP
9,Janssenlei 17,2022-03-10,00:00:00,16,8,8,F11SP
9,Janssenlei 17,2022-03-10,01:00:00,0,0,0,F11SP
9,Janssenlei 17,2022-03-10,02:00:00,0,0,0,F11SP
9,Janssenlei 17,2022-03-10,03:00:00,0,0,0,F11SP
9,Janssenlei 17,2022-03-10,04:00:00,8,8,0,F11SP
9,Janssenlei 17,2022-03-10,05:00:00,48,34,14,F11SP
9,Janssenlei 17,2022-03-10,06:00:00,114,78,36,F11SP
9,Janssenlei 17,2022-03-10,07:00:00,406,284,122,F11SP
9,Janssenlei 17,2022-03-10,08:00:00,400,264,136,F11SP
9,Janssenlei 17,2022-03-10,09:00:00,122,70,52,F11SP
9,Janssenlei 17,2022-03-10,10:00:00,88,38,50,F11SP
9,Janssenlei 17,2022-03-10,11:00:00,138,76,62,F11SP
9,Janssenlei 17,2022-03-10,12:00:00,182,88,94,F11SP
9,Janssenlei 17,2022-03-10,13:00:00,290,108,182,F11SP
9,Janssenlei 17,2022-03-10,14:00:00,362,190,172,F11SP
9,Janssenlei 17,2022-03-10,15:00:00,378,150,228,F11SP
9,Janssenlei 17,2022-03-10,16:00:00,580,244,336,F11SP
9,Janssenlei 17,2022-03-10,17:00:00,462,172,290,F11SP
9,Janssenlei 17,2022-03-10,18:00:00,212,104,108,F11SP
9,Janssenlei 17,2022-03-10,19:00:00,112,54,58,F11SP
9,Janssenlei 17,2022-03-10,20:00:00,64,28,36,F11SP
9,Janssenlei 17,2022-03-10,21:00:00,30,16,14,F11SP
9,Janssenlei 17,2022-03-10,22:00:00,62,24,38,F11SP
9,Janssenlei 17,2022-03-10,23:00:00,28,12,16,F11SP
9,Janssenlei 17,2022-03-11,00:00:00,18,10,8,F11SP
9,Janssenlei 17,2022-03-11,01:00:00,6,4,2,F11SP
9,Janssenlei 17,2022-03-11,02:00:00,4,2,2,F11SP
9,Janssenlei 17,2022-03-11,03:00:00,2,2,0,F11SP
9,Janssenlei 17,2022-03-11,04:00:00,12,12,0,F11SP
9,Janssenlei 17,2022-03-11,05:00:00,38,26,12,F11SP
9,Janssenlei 17,2022-03-11,06:00:00,92,60,32,F11SP
9,Janssenlei 17,2022-03-11,07:00:00,324,212,112,F11SP
9,Janssenlei 17,2022-03-11,08:00:00,396,236,160,F11SP
9,Janssenlei 17,2022-03-11,09:00:00,142,80,62,F11SP
9,Janssenlei 17,2022-03-11,10:00:00,146,64,82,F11SP
9,Janssenlei 17,2022-03-11,11:00:00,150,84,66,F11SP
9,Janssenlei 17,2022-03-11,12:00:00,208,118,90,F11SP
9,Janssenlei 17,2022-03-11,13:00:00,190,92,98,F11SP
9,Janssenlei 17,2022-03-11,14:00:00,264,138,126,F11SP
9,Janssenlei 17,2022-03-11,15:00:00,330,154,176,F11SP
9,Janssenlei 17,2022-03-11,16:00:00,440,164,276,F11SP
9,Janssenlei 17,2022-03-11,17:00:00,302,100,202,F11SP
9,Janssenlei 17,2022-03-11,18:00:00,158,64,94,F11SP
9,Janssenlei 17,2022-03-11,19:00:00,88,28,60,F11SP
9,Janssenlei 17,2022-03-11,20:00:00,52,24,28,F11SP
9,Janssenlei 17,2022-03-11,21:00:00,32,12,20,F11SP
9,Janssenlei 17,2022-03-11,22:00:00,34,18,16,F11SP
9,Janssenlei 17,2022-03-11,23:00:00,18,6,12,F11SP
9,Janssenlei 17,2022-03-12,00:00:00,8,4,4,F11SP
9,Janssenlei 17,2022-03-12,01:00:00,12,2,10,F11SP
9,Janssenlei 17,2022-03-12,02:00:00,6,2,4,F11SP
9,Janssenlei 17,2022-03-12,03:00:00,6,4,2,F11SP
9,Janssenlei 17,2022-03-12,04:00:00,12,2,10,F11SP
9,Janssenlei 17,2022-03-12,05:00:00,24,16,8,F11SP
9,Janssenlei 17,2022-03-12,06:00:00,10,2,8,F11SP
9,Janssenlei 17,2022-03-12,07:00:00,24,12,12,F11SP
9,Janssenlei 17,2022-03-12,08:00:00,94,46,48,F11SP
9,Janssenlei 17,2022-03-12,09:00:00,154,60,94,F11SP
9,Janssenlei 17,2022-03-12,10:00:00,210,88,122,F11SP
9,Janssenlei 17,2022-03-12,11:00:00,206,116,90,F11SP
9,Janssenlei 17,2022-03-12,12:00:00,224,104,120,F11SP
9,Janssenlei 17,2022-03-12,13:00:00,226,136,90,F11SP
9,Janssenlei 17,2022-03-12,14:00:00,262,146,116,F11SP
9,Janssenlei 17,2022-03-12,15:00:00,214,98,116,F11SP
9,Janssenlei 17,2022-03-12,16:00:00,206,110,96,F11SP
9,Janssenlei 17,2022-03-12,17:00:00,156,80,76,F11SP
9,Janssenlei 17,2022-03-12,18:00:00,114,64,50,F11SP
9,Janssenlei 17,2022-03-12,19:00:00,50,22,28,F11SP
9,Janssenlei 17,2022-03-12,20:00:00,48,20,28,F11SP
9,Janssenlei 17,2022-03-12,21:00:00,38,20,18,F11SP
9,Janssenlei 17,2022-03-12,22:00:00,30,8,22,F11SP
9,Janssenlei 17,2022-03-12,23:00:00,26,18,8,F11SP
9,Janssenlei 17,2022-03-13,00:00:00,16,2,14,F11SP
9,Janssenlei 17,2022-03-13,01:00:00,12,0,12,F11SP
9,Janssenlei 17,2022-03-13,02:00:00,18,2,16,F11SP
9,Janssenlei 17,2022-03-13,03:00:00,4,2,2,F11SP
9,Janssenlei 17,2022-03-13,04:00:00,2,2,0,F11SP
9,Janssenlei 17,2022-03-13,05:00:00,14,10,4,F11SP
9,Janssenlei 17,2022-03-13,06:00:00,18,12,6,F11SP
9,Janssenlei 17,2022-03-13,07:00:00,54,22,32,F11SP
9,Janssenlei 17,2022-03-13,08:00:00,116,44,72,F11SP
9,Janssenlei 17,2022-03-13,09:00:00,240,66,174,F11SP
9,Janssenlei 17,2022-03-13,10:00:00,330,98,232,F11SP
9,Janssenlei 17,2022-03-13,11:00:00,402,216,186,F11SP
9,Janssenlei 17,2022-03-13,12:00:00,416,226,190,F11SP
9,Janssenlei 17,2022-03-13,13:00:00,388,200,188,F11SP
9,Janssenlei 17,2022-03-13,14:00:00,388,144,244,F11SP
9,Janssenlei 17,2022-03-13,15:00:00,336,170,166,F11SP
9,Janssenlei 17,2022-03-13,16:00:00,244,178,66,F11SP
9,Janssenlei 17,2022-03-13,17:00:00,176,102,74,F11SP
9,Janssenlei 17,2022-03-13,18:00:00,104,82,22,F11SP
9,Janssenlei 17,2022-03-13,19:00:00,34,16,18,F11SP
9,Janssenlei 17,2022-03-13,20:00:00,38,8,30,F11SP
9,Janssenlei 17,2022-03-13,21:00:00,18,6,12,F11SP
9,Janssenlei 17,2022-03-13,22:00:00,20,8,12,F11SP
9,Janssenlei 17,2022-03-13,23:00:00,10,0,10,F11SP
9,Janssenlei 17,2022-03-14,00:00:00,2,2,0,F11SP
9,Janssenlei 17,2022-03-14,01:00:00,6,2,4,F11SP
9,Janssenlei 17,2022-03-14,02:00:00,0,0,0,F11SP
9,Janssenlei 17,2022-03-14,03:00:00,2,0,2,F11SP
9,Janssenlei 17,2022-03-14,04:00:00,10,10,0,F11SP
9,Janssenlei 17,2022-03-14,05:00:00,54,32,22,F11SP
9,Janssenlei 17,2022-03-14,06:00:00,140,102,38,F11SP
9,Janssenlei 17,2022-03-14,07:00:00,384,262,122,F11SP
9,Janssenlei 17,2022-03-14,08:00:00,424,302,122,F11SP
9,Janssenlei 17,2022-03-14,09:00:00,128,64,64,F11SP
9,Janssenlei 17,2022-03-14,10:00:00,74,40,34,F11SP
9,Janssenlei 17,2022-03-14,11:00:00,58,30,28,F11SP
9,Janssenlei 17,2022-03-14,12:00:00,122,70,52,F11SP
9,Janssenlei 17,2022-03-14,13:00:00,124,56,68,F11SP
9,Janssenlei 17,2022-03-14,14:00:00,172,64,108,F11SP
9,Janssenlei 17,2022-03-14,15:00:00,272,94,178,F11SP
9,Janssenlei 17,2022-03-14,16:00:00,452,168,284,F11SP
9,Janssenlei 17,2022-03-14,17:00:00,364,120,244,F11SP
9,Janssenlei 17,2022-03-14,18:00:00,208,84,124,F11SP
9,Janssenlei 17,2022-03-14,19:00:00,78,36,42,F11SP
9,Janssenlei 17,2022-03-14,20:00:00,48,30,18,F11SP
9,Janssenlei 17,2022-03-14,21:00:00,34,10,24,F11SP
9,Janssenlei 17,2022-03-14,22:00:00,48,12,36,F11SP
9,Janssenlei 17,2022-03-14,23:00:00,8,2,6,F11SP
9,Janssenlei 17,2022-03-15,00:00:00,0,0,0,F11SP
9,Janssenlei 17,2022-03-15,01:00:00,0,0,0,F11SP
9,Janssenlei 17,2022-03-15,02:00:00,0,0,0,F11SP
9,Janssenlei 17,2022-03-15,03:00:00,0,0,0,F11SP
9,Janssenlei 17,2022-03-15,04:00:00,12,10,2,F11SP
9,Janssenlei 17,2022-03-15,05:00:00,48,36,12,F11SP
9,Janssenlei 17,2022-03-15,06:00:00,124,86,38,F11SP
9,Janssenlei 17,2022-03-15,07:00:00,360,246,114,F11SP
9,Janssenlei 17,2022-03-15,08:00:00,390,270,120,F11SP
9,Janssenlei 17,2022-03-15,09:00:00,132,72,60,F11SP
9,Janssenlei 17,2022-03-15,10:00:00,80,44,36,F11SP
9,Janssenlei 17,2022-03-15,11:00:00,94,38,56,F11SP
9,Janssenlei 17,2022-03-15,12:00:00,86,48,38,F11SP
9,Janssenlei 17,2022-03-15,13:00:00,134,60,74,F11SP
9,Janssenlei 17,2022-03-15,14:00:00,132,58,74,F11SP
9,Janssenlei 17,2022-03-15,15:00:00,282,108,174,F11SP
9,Janssenlei 17,2022-03-15,16:00:00,376,124,252,F11SP
9,Janssenlei 17,2022-03-15,17:00:00,390,140,250,F11SP
9,Janssenlei 17,2022-03-15,18:00:00,178,62,116,F11SP
9,Janssenlei 17,2022-03-15,19:00:00,72,36,36,F11SP
9,Janssenlei 17,2022-03-15,20:00:00,48,28,20,F11SP
9,Janssenlei 17,2022-03-15,21:00:00,36,24,12,F11SP
9,Janssenlei 17,2022-03-15,22:00:00,58,14,44,F11SP
9,Janssenlei 17,2022-03-15,23:00:00,16,8,8,F11SP
9,Janssenlei 17,2022-03-16,00:00:00,4,2,2,F11SP
9,Janssenlei 17,2022-03-16,01:00:00,8,4,4,F11SP
9,Janssenlei 17,2022-03-16,02:00:00,0,0,0,F11SP
9,Janssenlei 17,2022-03-16,03:00:00,0,0,0,F11SP
9,Janssenlei 17,2022-03-16,04:00:00,10,10,0,F11SP
9,Janssenlei 17,2022-03-16,05:00:00,48,36,12,F11SP
9,Janssenlei 17,2022-03-16,06:00:00,146,94,52,F11SP
9,Janssenlei 17,2022-03-16,07:00:00,414,270,144,F11SP
9,Janssenlei 17,2022-03-16,08:00:00,412,282,130,F11SP
9,Janssenlei 17,2022-03-16,09:00:00,204,132,72,F11SP
9,Janssenlei 17,2022-03-16,10:00:00,204,80,124,F11SP
9,Janssenlei 17,2022-03-16,11:00:00,232,90,142,F11SP
9,Janssenlei 17,2022-03-16,12:00:00,396,170,226,F11SP
9,Janssenlei 17,2022-03-16,13:00:00,296,122,174,F11SP
9,Janssenlei 17,2022-03-16,14:00:00,264,126,138,F11SP
9,Janssenlei 17,2022-03-16,15:00:00,254,112,142,F11SP
9,Janssenlei 17,2022-03-16,16:00:00,390,164,226,F11SP
9,Janssenlei 17,2022-03-16,17:00:00,402,150,252,F11SP
9,Janssenlei 17,2022-03-16,18:00:00,240,110,130,F11SP
9,Janssenlei 17,2022-03-16,19:00:00,82,38,44,F11SP
9,Janssenlei 17,2022-03-16,20:00:00,64,26,38,F11SP
9,Janssenlei 17,2022-03-16,21:00:00,30,12,18,F11SP
9,Janssenlei 17,2022-03-16,22:00:00,64,12,52,F11SP
9,Janssenlei 17,2022-03-16,23:00:00,20,2,18,F11SP
9,Janssenlei 17,2022-03-17,00:00:00,8,0,8,F11SP
9,Janssenlei 17,2022-03-17,01:00:00,6,0,6,F11SP
9,Janssenlei 17,2022-03-17,02:00:00,0,0,0,F11SP
9,Janssenlei 17,2022-03-17,03:00:00,2,2,0,F11SP
9,Janssenlei 17,2022-03-17,04:00:00,14,12,2,F11SP
9,Janssenlei 17,2022-03-17,05:00:00,68,48,20,F11SP
9,Janssenlei 17,2022-03-17,06:00:00,112,70,42,F11SP
9,Janssenlei 17,2022-03-17,07:00:00,372,256,116,F11SP
9,Janssenlei 17,2022-03-17,08:00:00,384,278,106,F11SP
9,Janssenlei 17,2022-03-17,09:00:00,146,88,58,F11SP
9,Janssenlei 17,2022-03-17,10:00:00,82,42,40,F11SP
9,Janssenlei 17,2022-03-17,11:00:00,108,66,42,F11SP
9,Janssenlei 17,2022-03-17,12:00:00,110,60,50,F11SP
9,Janssenlei 17,2022-03-17,13:00:00,154,80,74,F11SP
9,Janssenlei 17,2022-03-17,14:00:00,186,62,124,F11SP
9,Janssenlei 17,2022-03-17,15:00:00,262,76,186,F11SP
9,Janssenlei 17,2022-03-17,16:00:00,502,194,308,F11SP
9,Janssenlei 17,2022-03-17,17:00:00,358,124,234,F11SP
9,Janssenlei 17,2022-03-17,18:00:00,180,66,114,F11SP
9,Janssenlei 17,2022-03-17,19:00:00,102,44,58,F11SP
9,Janssenlei 17,2022-03-17,20:00:00,42,18,24,F11SP
9,Janssenlei 17,2022-03-17,21:00:00,38,18,20,F11SP
9,Janssenlei 17,2022-03-17,22:00:00,86,24,62,F11SP
9,Janssenlei 17,2022-03-17,23:00:00,18,8,10,F11SP
9,Janssenlei 17,2022-03-18,00:00:00,10,8,2,F11SP
9,Janssenlei 17,2022-03-18,01:00:00,6,2,4,F11SP
9,Janssenlei 17,2022-03-18,02:00:00,2,0,2,F11SP
9,Janssenlei 17,2022-03-18,03:00:00,0,0,0,F11SP
9,Janssenlei 17,2022-03-18,04:00:00,8,8,0,F11SP
9,Janssenlei 17,2022-03-18,05:00:00,48,36,12,F11SP
9,Janssenlei 17,2022-03-18,06:00:00,116,80,36,F11SP
9,Janssenlei 17,2022-03-18,07:00:00,282,188,94,F11SP
9,Janssenlei 17,2022-03-18,08:00:00,346,226,120,F11SP
9,Janssenlei 17,2022-03-18,09:00:00,160,84,76,F11SP
9,Janssenlei 17,2022-03-18,10:00:00,142,70,72,F11SP
9,Janssenlei 17,2022-03-18,11:00:00,190,90,100,F11SP
9,Janssenlei 17,2022-03-18,12:00:00,184,82,102,F11SP
9,Janssenlei 17,2022-03-18,13:00:00,234,106,128,F11SP
9,Janssenlei 17,2022-03-18,14:00:00,312,126,186,F11SP
9,Janssenlei 17,2022-03-18,15:00:00,362,158,204,F11SP
9,Janssenlei 17,2022-03-18,16:00:00,494,182,312,F11SP
9,Janssenlei 17,2022-03-18,17:00:00,388,156,232,F11SP
9,Janssenlei 17,2022-03-18,18:00:00,204,98,106,F11SP
9,Janssenlei 17,2022-03-18,19:00:00,80,40,40,F11SP
9,Janssenlei 17,2022-03-18,20:00:00,56,38,18,F11SP
9,Janssenlei 17,2022-03-18,21:00:00,24,12,12,F11SP
9,Janssenlei 17,2022-03-18,22:00:00,58,26,32,F11SP
9,Janssenlei 17,2022-03-18,23:00:00,24,6,18,F11SP
9,Janssenlei 17,2022-03-19,00:00:00,14,2,12,F11SP
9,Janssenlei 17,2022-03-19,01:00:00,16,14,2,F11SP
9,Janssenlei 17,2022-03-19,02:00:00,26,10,16,F11SP
9,Janssenlei 17,2022-03-19,03:00:00,4,0,4,F11SP
9,Janssenlei 17,2022-03-19,04:00:00,8,6,2,F11SP
9,Janssenlei 17,2022-03-19,05:00:00,16,12,4,F11SP
9,Janssenlei 17,2022-03-19,06:00:00,20,6,14,F11SP
9,Janssenlei 17,2022-03-19,07:00:00,44,18,26,F11SP
9,Janssenlei 17,2022-03-19,08:00:00,108,58,50,F11SP
9,Janssenlei 17,2022-03-19,09:00:00,180,52,128,F11SP
9,Janssenlei 17,2022-03-19,10:00:00,282,82,200,F11SP
9,Janssenlei 17,2022-03-19,11:00:00,232,100,132,F11SP
9,Janssenlei 17,2022-03-19,12:00:00,288,140,148,F11SP
9,Janssenlei 17,2022-03-19,13:00:00,312,158,154,F11SP
9,Janssenlei 17,2022-03-19,14:00:00,342,154,188,F11SP
9,Janssenlei 17,2022-03-19,15:00:00,230,120,110,F11SP
9,Janssenlei 17,2022-03-19,16:00:00,214,108,106,F11SP
9,Janssenlei 17,2022-03-19,17:00:00,162,82,80,F11SP
9,Janssenlei 17,2022-03-19,18:00:00,106,64,42,F11SP
9,Janssenlei 17,2022-03-19,19:00:00,50,28,22,F11SP
9,Janssenlei 17,2022-03-19,20:00:00,32,18,14,F11SP
9,Janssenlei 17,2022-03-19,21:00:00,28,10,18,F11SP
9,Janssenlei 17,2022-03-19,22:00:00,24,14,10,F11SP
9,Janssenlei 17,2022-03-19,23:00:00,30,10,20,F11SP
9,Janssenlei 17,2022-03-20,00:00:00,22,12,10,F11SP
9,Janssenlei 17,2022-03-20,01:00:00,12,4,8,F11SP
9,Janssenlei 17,2022-03-20,02:00:00,8,4,4,F11SP
9,Janssenlei 17,2022-03-20,03:00:00,4,4,0,F11SP
9,Janssenlei 17,2022-03-20,04:00:00,4,0,4,F11SP
9,Janssenlei 17,2022-03-20,05:00:00,16,14,2,F11SP
9,Janssenlei 17,2022-03-20,06:00:00,22,12,10,F11SP
9,Janssenlei 17,2022-03-20,07:00:00,36,14,22,F11SP
9,Janssenlei 17,2022-03-20,08:00:00,58,22,36,F11SP
9,Janssenlei 17,2022-03-20,09:00:00,140,42,98,F11SP
9,Janssenlei 17,2022-03-20,10:00:00,142,50,92,F11SP
9,Janssenlei 17,2022-03-20,11:00:00,170,106,64,F11SP
9,Janssenlei 17,2022-03-20,12:00:00,192,106,86,F11SP
9,Janssenlei 17,2022-03-20,13:00:00,168,94,74,F11SP
9,Janssenlei 17,2022-03-20,14:00:00,234,110,124,F11SP
9,Janssenlei 17,2022-03-20,15:00:00,160,100,60,F11SP
9,Janssenlei 17,2022-03-20,16:00:00,132,72,60,F11SP
9,Janssenlei 17,2022-03-20,17:00:00,98,60,38,F11SP
9,Janssenlei 17,2022-03-20,18:00:00,82,52,30,F11SP
9,Janssenlei 17,2022-03-20,19:00:00,38,14,24,F11SP
9,Janssenlei 17,2022-03-20,20:00:00,24,18,6,F11SP
9,Janssenlei 17,2022-03-20,21:00:00,16,6,10,F11SP
9,Janssenlei 17,2022-03-20,22:00:00,14,6,8,F11SP
9,Janssenlei 17,2022-03-20,23:00:00,10,4,6,F11SP
9,Janssenlei 17,2022-03-21,00:00:00,6,4,2,F11SP
9,Janssenlei 17,2022-03-21,01:00:00,2,0,2,F11SP
9,Janssenlei 17,2022-03-21,02:00:00,0,0,0,F11SP
9,Janssenlei 17,2022-03-21,03:00:00,0,0,0,F11SP
9,Janssenlei 17,2022-03-21,04:00:00,10,10,0,F11SP
9,Janssenlei 17,2022-03-21,05:00:00,60,44,16,F11SP
9,Janssenlei 17,2022-03-21,06:00:00,126,86,40,F11SP
9,Janssenlei 17,2022-03-21,07:00:00,380,248,132,F11SP
9,Janssenlei 17,2022-03-21,08:00:00,430,314,116,F11SP
9,Janssenlei 17,2022-03-21,09:00:00,230,76,154,F11SP
9,Janssenlei 17,2022-03-21,10:00:00,116,54,62,F11SP
9,Janssenlei 17,2022-03-21,11:00:00,116,50,66,F11SP
9,Janssenlei 17,2022-03-21,12:00:00,158,96,62,F11SP
9,Janssenlei 17,2022-03-21,13:00:00,246,98,148,F11SP
9,Janssenlei 17,2022-03-21,14:00:00,396,188,208,F11SP
9,Janssenlei 17,2022-03-21,15:00:00,394,156,238,F11SP
9,Janssenlei 17,2022-03-21,16:00:00,482,184,298,F11SP
9,Janssenlei 17,2022-03-21,17:00:00,394,128,266,F11SP
9,Janssenlei 17,2022-03-21,18:00:00,204,80,124,F11SP
9,Janssenlei 17,2022-03-21,19:00:00,94,38,56,F11SP
9,Janssenlei 17,2022-03-21,20:00:00,48,28,20,F11SP
9,Janssenlei 17,2022-03-21,21:00:00,44,18,26,F11SP
9,Janssenlei 17,2022-03-21,22:00:00,58,16,42,F11SP
9,Janssenlei 17,2022-03-21,23:00:00,16,6,10,F11SP
9,Janssenlei 17,2022-03-22,00:00:00,12,2,10,F11SP
9,Janssenlei 17,2022-03-22,01:00:00,4,0,4,F11SP
9,Janssenlei 17,2022-03-22,02:00:00,6,6,0,F11SP
9,Janssenlei 17,2022-03-22,03:00:00,0,0,0,F11SP
9,Janssenlei 17,2022-03-22,04:00:00,12,10,2,F11SP
9,Janssenlei 17,2022-03-22,05:00:00,66,52,14,F11SP
9,Janssenlei 17,2022-03-22,06:00:00,148,98,50,F11SP
9,Janssenlei 17,2022-03-22,07:00:00,418,296,122,F11SP
9,Janssenlei 17,2022-03-22,08:00:00,456,336,120,F11SP
9,Janssenlei 17,2022-03-22,09:00:00,142,64,78,F11SP
9,Janssenlei 17,2022-03-22,10:00:00,134,64,70,F11SP
9,Janssenlei 17,2022-03-22,11:00:00,162,94,68,F11SP
9,Janssenlei 17,2022-03-22,12:00:00,236,118,118,F11SP
9,Janssenlei 17,2022-03-22,13:00:00,272,104,168,F11SP
9,Janssenlei 17,2022-03-22,14:00:00,312,112,200,F11SP
9,Janssenlei 17,2022-03-22,15:00:00,406,190,216,F11SP
9,Janssenlei 17,2022-03-22,16:00:00,580,220,360,F11SP
9,Janssenlei 17,2022-03-22,17:00:00,470,172,298,F11SP
9,Janssenlei 17,2022-03-22,18:00:00,288,126,162,F11SP
9,Janssenlei 17,2022-03-22,19:00:00,88,46,42,F11SP
9,Janssenlei 17,2022-03-22,20:00:00,46,16,30,F11SP
9,Janssenlei 17,2022-03-22,21:00:00,48,22,26,F11SP
9,Janssenlei 17,2022-03-22,22:00:00,40,8,32,F11SP
9,Janssenlei 17,2022-03-22,23:00:00,20,12,8,F11SP
9,Janssenlei 17,2022-03-23,00:00:00,8,2,6,F11SP
9,Janssenlei 17,2022-03-23,01:00:00,6,4,2,F11SP
9,Janssenlei 17,2022-03-23,02:00:00,0,0,0,F11SP
9,Janssenlei 17,2022-03-23,03:00:00,0,0,0,F11SP
9,Janssenlei 17,2022-03-23,04:00:00,10,6,4,F11SP
9,Janssenlei 17,2022-03-23,05:00:00,56,40,16,F11SP
9,Janssenlei 17,2022-03-23,06:00:00,130,82,48,F11SP
9,Janssenlei 17,2022-03-23,07:00:00,388,252,136,F11SP
9,Janssenlei 17,2022-03-23,08:00:00,432,306,126,F11SP
9,Janssenlei 17,2022-03-23,09:00:00,196,112,84,F11SP
9,Janssenlei 17,2022-03-23,10:00:00,182,74,108,F11SP
9,Janssenlei 17,2022-03-23,11:00:00,236,102,134,F11SP
9,Janssenlei 17,2022-03-23,12:00:00,328,142,186,F11SP
9,Janssenlei 17,2022-03-23,13:00:00,366,150,216,F11SP
9,Janssenlei 17,2022-03-23,14:00:00,364,168,196,F11SP
9,Janssenlei 17,2022-03-23,15:00:00,320,158,162,F11SP
9,Janssenlei 17,2022-03-23,16:00:00,434,196,238,F11SP
9,Janssenlei 17,2022-03-23,17:00:00,520,196,324,F11SP
9,Janssenlei 17,2022-03-23,18:00:00,332,144,188,F11SP
9,Janssenlei 17,2022-03-23,19:00:00,150,92,58,F11SP
9,Janssenlei 17,2022-03-23,20:00:00,76,34,42,F11SP
9,Janssenlei 17,2022-03-23,21:00:00,32,10,22,F11SP
9,Janssenlei 17,2022-03-23,22:00:00,54,18,36,F11SP
9,Janssenlei 17,2022-03-23,23:00:00,14,6,8,F11SP
9,Janssenlei 17,2022-03-24,00:00:00,6,2,4,F11SP
9,Janssenlei 17,2022-03-24,01:00:00,8,2,6,F11SP
9,Janssenlei 17,2022-03-24,02:00:00,4,2,2,F11SP
9,Janssenlei 17,2022-03-24,03:00:00,0,0,0,F11SP
9,Janssenlei 17,2022-03-24,04:00:00,12,10,2,F11SP
9,Janssenlei 17,2022-03-24,05:00:00,56,42,14,F11SP
9,Janssenlei 17,2022-03-24,06:00:00,130,88,42,F11SP
9,Janssenlei 17,2022-03-24,07:00:00,420,284,136,F11SP
9,Janssenlei 17,2022-03-24,08:00:00,444,318,126,F11SP
9,Janssenlei 17,2022-03-24,09:00:00,148,80,68,F11SP
9,Janssenlei 17,2022-03-24,10:00:00,222,96,126,F11SP
9,Janssenlei 17,2022-03-24,11:00:00,160,78,82,F11SP
9,Janssenlei 17,2022-03-24,12:00:00,226,106,120,F11SP
9,Janssenlei 17,2022-03-24,13:00:00,244,120,124,F11SP
9,Janssenlei 17,2022-03-24,14:00:00,330,142,188,F11SP
9,Janssenlei 17,2022-03-24,15:00:00,322,130,192,F11SP
9,Janssenlei 17,2022-03-24,16:00:00,504,214,290,F11SP
9,Janssenlei 17,2022-03-24,17:00:00,412,150,262,F11SP
9,Janssenlei 17,2022-03-24,18:00:00,220,112,108,F11SP
9,Janssenlei 17,2022-03-24,19:00:00,110,56,54,F11SP
9,Janssenlei 17,2022-03-24,20:00:00,72,38,34,F11SP
9,Janssenlei 17,2022-03-24,21:00:00,60,22,38,F11SP
9,Janssenlei 17,2022-03-24,22:00:00,66,18,48,F11SP
9,Janssenlei 17,2022-03-24,23:00:00,28,12,16,F11SP
9,Janssenlei 17,2022-03-25,00:00:00,10,2,8,F11SP
9,Janssenlei 17,2022-03-25,01:00:00,4,0,4,F11SP
9,Janssenlei 17,2022-03-25,02:00:00,0,0,0,F11SP
9,Janssenlei 17,2022-03-25,03:00:00,4,2,2,F11SP
9,Janssenlei 17,2022-03-25,04:00:00,12,10,2,F11SP
9,Janssenlei 17,2022-03-25,05:00:00,56,46,10,F11SP
9,Janssenlei 17,2022-03-25,06:00:00,98,68,30,F11SP
9,Janssenlei 17,2022-03-25,07:00:00,358,230,128,F11SP
9,Janssenlei 17,2022-03-25,08:00:00,442,292,150,F11SP
9,Janssenlei 17,2022-03-25,09:00:00,154,78,76,F11SP
9,Janssenlei 17,2022-03-25,10:00:00,182,78,104,F11SP
9,Janssenlei 17,2022-03-25,11:00:00,202,114,88,F11SP
9,Janssenlei 17,2022-03-25,12:00:00,206,88,118,F11SP
9,Janssenlei 17,2022-03-25,13:00:00,230,114,116,F11SP
9,Janssenlei 17,2022-03-25,14:00:00,246,98,148,F11SP
9,Janssenlei 17,2022-03-25,15:00:00,384,154,230,F11SP
9,Janssenlei 17,2022-03-25,16:00:00,446,180,266,F11SP
9,Janssenlei 17,2022-03-25,17:00:00,286,132,154,F11SP
9,Janssenlei 17,2022-03-25,18:00:00,194,86,108,F11SP
9,Janssenlei 17,2022-03-25,19:00:00,134,56,78,F11SP
9,Janssenlei 17,2022-03-25,20:00:00,82,38,44,F11SP
9,Janssenlei 17,2022-03-25,21:00:00,46,16,30,F11SP
9,Janssenlei 17,2022-03-25,22:00:00,44,12,32,F11SP
9,Janssenlei 17,2022-03-25,23:00:00,34,16,18,F11SP
9,Janssenlei 17,2022-03-26,00:00:00,22,16,6,F11SP
9,Janssenlei 17,2022-03-26,01:00:00,18,12,6,F11SP
9,Janssenlei 17,2022-03-26,02:00:00,10,2,8,F11SP
9,Janssenlei 17,2022-03-26,03:00:00,10,8,2,F11SP
9,Janssenlei 17,2022-03-26,04:00:00,8,4,4,F11SP
9,Janssenlei 17,2022-03-26,05:00:00,18,16,2,F11SP
9,Janssenlei 17,2022-03-26,06:00:00,28,12,16,F11SP
9,Janssenlei 17,2022-03-26,07:00:00,38,16,22,F11SP
9,Janssenlei 17,2022-03-26,08:00:00,98,34,64,F11SP
9,Janssenlei 17,2022-03-26,09:00:00,136,58,78,F11SP
9,Janssenlei 17,2022-03-26,10:00:00,258,100,158,F11SP
9,Janssenlei 17,2022-03-26,11:00:00,298,114,184,F11SP
9,Janssenlei 17,2022-03-26,12:00:00,288,134,154,F11SP
9,Janssenlei 17,2022-03-26,13:00:00,382,166,216,F11SP
9,Janssenlei 17,2022-03-26,14:00:00,506,204,302,F11SP
9,Janssenlei 17,2022-03-26,15:00:00,382,218,164,F11SP
9,Janssenlei 17,2022-03-26,16:00:00,354,190,164,F11SP
9,Janssenlei 17,2022-03-26,17:00:00,216,140,76,F11SP
9,Janssenlei 17,2022-03-26,18:00:00,188,126,62,F11SP
9,Janssenlei 17,2022-03-26,19:00:00,66,42,24,F11SP
9,Janssenlei 17,2022-03-26,20:00:00,38,12,26,F11SP
9,Janssenlei 17,2022-03-26,21:00:00,46,18,28,F11SP
9,Janssenlei 17,2022-03-26,22:00:00,36,22,14,F11SP
9,Janssenlei 17,2022-03-26,23:00:00,44,10,34,F11SP
9,Janssenlei 17,2022-03-27,00:00:00,56,26,30,F11SP
9,Janssenlei 17,2022-03-27,01:00:00,22,2,20,F11SP
9,Janssenlei 17,2022-03-27,02:00:00,0,0,0,F11SP
9,Janssenlei 17,2022-03-27,03:00:00,10,0,10,F11SP
9,Janssenlei 17,2022-03-27,04:00:00,10,2,8,F11SP
9,Janssenlei 17,2022-03-27,05:00:00,16,8,8,F11SP
9,Janssenlei 17,2022-03-27,06:00:00,12,4,8,F11SP
9,Janssenlei 17,2022-03-27,07:00:00,30,14,16,F11SP
9,Janssenlei 17,2022-03-27,08:00:00,86,38,48,F11SP
9,Janssenlei 17,2022-03-27,09:00:00,236,110,126,F11SP
9,Janssenlei 17,2022-03-27,10:00:00,216,82,134,F11SP
9,Janssenlei 17,2022-03-27,11:00:00,230,124,106,F11SP
9,Janssenlei 17,2022-03-27,12:00:00,224,134,90,F11SP
9,Janssenlei 17,2022-03-27,13:00:00,248,128,120,F11SP
9,Janssenlei 17,2022-03-27,14:00:00,236,104,132,F11SP
9,Janssenlei 17,2022-03-27,15:00:00,224,106,118,F11SP
9,Janssenlei 17,2022-03-27,16:00:00,258,148,110,F11SP
9,Janssenlei 17,2022-03-27,17:00:00,290,138,152,F11SP
9,Janssenlei 17,2022-03-27,18:00:00,192,136,56,F11SP
9,Janssenlei 17,2022-03-27,19:00:00,88,64,24,F11SP
9,Janssenlei 17,2022-03-27,20:00:00,52,18,34,F11SP
9,Janssenlei 17,2022-03-27,21:00:00,32,22,10,F11SP
9,Janssenlei 17,2022-03-27,22:00:00,28,8,20,F11SP
9,Janssenlei 17,2022-03-27,23:00:00,18,8,10,F11SP
9,Janssenlei 17,2022-03-28,00:00:00,2,0,2,F11SP
9,Janssenlei 17,2022-03-28,01:00:00,0,0,0,F11SP
9,Janssenlei 17,2022-03-28,02:00:00,0,0,0,F11SP
9,Janssenlei 17,2022-03-28,03:00:00,0,0,0,F11SP
9,Janssenlei 17,2022-03-28,04:00:00,8,8,0,F11SP
9,Janssenlei 17,2022-03-28,05:00:00,32,22,10,F11SP
9,Janssenlei 17,2022-03-28,06:00:00,120,90,30,F11SP
9,Janssenlei 17,2022-03-28,07:00:00,378,242,136,F11SP
9,Janssenlei 17,2022-03-28,08:00:00,428,296,132,F11SP
9,Janssenlei 17,2022-03-28,09:00:00,130,64,66,F11SP
9,Janssenlei 17,2022-03-28,10:00:00,122,68,54,F11SP
9,Janssenlei 17,2022-03-28,11:00:00,124,58,66,F11SP
9,Janssenlei 17,2022-03-28,12:00:00,240,118,122,F11SP
9,Janssenlei 17,2022-03-28,13:00:00,246,102,144,F11SP
9,Janssenlei 17,2022-03-28,14:00:00,236,136,100,F11SP
9,Janssenlei 17,2022-03-28,15:00:00,336,130,206,F11SP
9,Janssenlei 17,2022-03-28,16:00:00,462,178,284,F11SP
9,Janssenlei 17,2022-03-28,17:00:00,432,132,300,F11SP
9,Janssenlei 17,2022-03-28,18:00:00,188,68,120,F11SP
9,Janssenlei 17,2022-03-28,19:00:00,102,46,56,F11SP
9,Janssenlei 17,2022-03-28,20:00:00,68,38,30,F11SP
9,Janssenlei 17,2022-03-28,21:00:00,36,10,26,F11SP
9,Janssenlei 17,2022-03-28,22:00:00,60,16,44,F11SP
9,Janssenlei 17,2022-03-28,23:00:00,14,4,10,F11SP
9,Janssenlei 17,2022-03-29,00:00:00,2,2,0,F11SP
9,Janssenlei 17,2022-03-29,01:00:00,2,2,0,F11SP
9,Janssenlei 17,2022-03-29,02:00:00,0,0,0,F11SP
9,Janssenlei 17,2022-03-29,03:00:00,0,0,0,F11SP
9,Janssenlei 17,2022-03-29,04:00:00,10,6,4,F11SP
9,Janssenlei 17,2022-03-29,05:00:00,42,34,8,F11SP
9,Janssenlei 17,2022-03-29,06:00:00,128,88,40,F11SP
9,Janssenlei 17,2022-03-29,07:00:00,306,200,106,F11SP
9,Janssenlei 17,2022-03-29,08:00:00,416,310,106,F11SP
9,Janssenlei 17,2022-03-29,09:00:00,146,72,74,F11SP
9,Janssenlei 17,2022-03-29,10:00:00,120,40,80,F11SP
9,Janssenlei 17,2022-03-29,11:00:00,100,46,54,F11SP
9,Janssenlei 17,2022-03-29,12:00:00,146,66,80,F11SP
9,Janssenlei 17,2022-03-29,13:00:00,158,66,92,F11SP
9,Janssenlei 17,2022-03-29,14:00:00,180,88,92,F11SP
9,Janssenlei 17,2022-03-29,15:00:00,232,82,150,F11SP
9,Janssenlei 17,2022-03-29,16:00:00,370,128,242,F11SP
9,Janssenlei 17,2022-03-29,17:00:00,364,136,228,F11SP
9,Janssenlei 17,2022-03-29,18:00:00,216,90,126,F11SP
9,Janssenlei 17,2022-03-29,19:00:00,102,32,70,F11SP
9,Janssenlei 17,2022-03-29,20:00:00,82,58,24,F11SP
9,Janssenlei 17,2022-03-29,21:00:00,36,24,12,F11SP
9,Janssenlei 17,2022-03-29,22:00:00,52,24,28,F11SP
9,Janssenlei 17,2022-03-29,23:00:00,14,2,12,F11SP
9,Janssenlei 17,2022-03-30,00:00:00,12,0,12,F11SP
9,Janssenlei 17,2022-03-30,01:00:00,2,0,2,F11SP
9,Janssenlei 17,2022-03-30,02:00:00,4,0,4,F11SP
9,Janssenlei 17,2022-03-30,03:00:00,2,0,2,F11SP
9,Janssenlei 17,2022-03-30,04:00:00,8,8,0,F11SP
9,Janssenlei 17,2022-03-30,05:00:00,46,34,12,F11SP
9,Janssenlei 17,2022-03-30,06:00:00,138,98,40,F11SP
9,Janssenlei 17,2022-03-30,07:00:00,324,214,110,F11SP
9,Janssenlei 17,2022-03-30,08:00:00,364,266,98,F11SP
9,Janssenlei 17,2022-03-30,09:00:00,136,82,54,F11SP
9,Janssenlei 17,2022-03-30,10:00:00,128,52,76,F11SP
9,Janssenlei 17,2022-03-30,11:00:00,176,82,94,F11SP
9,Janssenlei 17,2022-03-30,12:00:00,222,72,150,F11SP
9,Janssenlei 17,2022-03-30,13:00:00,260,140,120,F11SP
9,Janssenlei 17,2022-03-30,14:00:00,206,80,126,F11SP
9,Janssenlei 17,2022-03-30,15:00:00,218,86,132,F11SP
9,Janssenlei 17,2022-03-30,16:00:00,340,138,202,F11SP
9,Janssenlei 17,2022-03-30,17:00:00,318,116,202,F11SP
9,Janssenlei 17,2022-03-30,18:00:00,208,100,108,F11SP
9,Janssenlei 17,2022-03-30,19:00:00,100,46,54,F11SP
9,Janssenlei 17,2022-03-30,20:00:00,52,30,22,F11SP
9,Janssenlei 17,2022-03-30,21:00:00,42,18,24,F11SP
9,Janssenlei 17,2022-03-30,22:00:00,54,18,36,F11SP
9,Janssenlei 17,2022-03-30,23:00:00,26,6,20,F11SP
9,Janssenlei 17,2022-03-31,00:00:00,12,2,10,F11SP
9,Janssenlei 17,2022-03-31,01:00:00,4,0,4,F11SP
9,Janssenlei 17,2022-03-31,02:00:00,2,0,2,F11SP
9,Janssenlei 17,2022-03-31,03:00:00,0,0,0,F11SP
9,Janssenlei 17,2022-03-31,04:00:00,4,4,0,F11SP
9,Janssenlei 17,2022-03-31,05:00:00,38,24,14,F11SP
9,Janssenlei 17,2022-03-31,06:00:00,76,46,30,F11SP
9,Janssenlei 17,2022-03-31,07:00:00,206,128,78,F11SP
9,Janssenlei 17,2022-03-31,08:00:00,292,194,98,F11SP
9,Janssenlei 17,2022-03-31,09:00:00,106,58,48,F11SP
9,Janssenlei 17,2022-03-31,10:00:00,46,26,20,F11SP
9,Janssenlei 17,2022-03-31,11:00:00,70,34,36,F11SP
9,Janssenlei 17,2022-03-31,12:00:00,48,24,24,F11SP
9,Janssenlei 17,2022-03-31,13:00:00,98,44,54,F11SP
9,Janssenlei 17,2022-03-31,14:00:00,118,52,66,F11SP
9,Janssenlei 17,2022-03-31,15:00:00,178,74,104,F11SP
9,Janssenlei 17,2022-03-31,16:00:00,256,102,154,F11SP
9,Janssenlei 17,2022-03-31,17:00:00,230,86,144,F11SP
9,Janssenlei 17,2022-03-31,18:00:00,128,66,62,F11SP
9,Janssenlei 17,2022-03-31,19:00:00,40,20,20,F11SP
9,Janssenlei 17,2022-03-31,20:00:00,70,30,40,F11SP
9,Janssenlei 17,2022-03-31,21:00:00,28,14,14,F11SP
9,Janssenlei 17,2022-03-31,22:00:00,36,10,26,F11SP
9,Janssenlei 17,2022-03-31,23:00:00,10,6,4,F11SP
9,Janssenlei 17,2022-04-01,00:00:00,10,2,8,F11SP
9,Janssenlei 17,2022-04-01,01:00:00,22,12,10,F11SP
9,Janssenlei 17,2022-04-01,02:00:00,0,0,0,F11SP
9,Janssenlei 17,2022-04-01,03:00:00,0,0,0,F11SP
9,Janssenlei 17,2022-04-01,04:00:00,4,2,2,F11SP
9,Janssenlei 17,2022-04-01,05:00:00,26,16,10,F11SP
9,Janssenlei 17,2022-04-01,06:00:00,32,20,12,F11SP
9,Janssenlei 17,2022-04-01,07:00:00,116,82,34,F11SP
9,Janssenlei 17,2022-04-01,08:00:00,212,138,74,F11SP
9,Janssenlei 17,2022-04-01,09:00:00,54,26,28,F11SP
9,Janssenlei 17,2022-04-01,10:00:00,78,30,48,F11SP
9,Janssenlei 17,2022-04-01,11:00:00,44,24,20,F11SP
9,Janssenlei 17,2022-04-01,12:00:00,60,36,24,F11SP
9,Janssenlei 17,2022-04-01,13:00:00,62,32,30,F11SP
9,Janssenlei 17,2022-04-01,14:00:00,52,26,26,F11SP
9,Janssenlei 17,2022-04-01,15:00:00,94,26,68,F11SP
9,Janssenlei 17,2022-04-01,16:00:00,104,48,56,F11SP
9,Janssenlei 17,2022-04-01,17:00:00,152,60,92,F11SP
9,Janssenlei 17,2022-04-01,18:00:00,48,16,32,F11SP
9,Janssenlei 17,2022-04-01,19:00:00,60,30,30,F11SP
9,Janssenlei 17,2022-04-01,20:00:00,32,22,10,F11SP
9,Janssenlei 17,2022-04-01,21:00:00,20,8,12,F11SP
9,Janssenlei 17,2022-04-01,22:00:00,24,12,12,F11SP
9,Janssenlei 17,2022-04-01,23:00:00,8,4,4,F11SP
9,Janssenlei 17,2022-04-02,00:00:00,4,0,4,F11SP
9,Janssenlei 17,2022-04-02,01:00:00,20,10,10,F11SP
9,Janssenlei 17,2022-04-02,02:00:00,20,4,16,F11SP
9,Janssenlei 17,2022-04-02,03:00:00,8,2,6,F11SP
9,Janssenlei 17,2022-04-02,04:00:00,8,4,4,F11SP
9,Janssenlei 17,2022-04-02,05:00:00,14,8,6,F11SP
9,Janssenlei 17,2022-04-02,06:00:00,28,20,8,F11SP
9,Janssenlei 17,2022-04-02,07:00:00,14,10,4,F11SP
9,Janssenlei 17,2022-04-02,08:00:00,44,14,30,F11SP
9,Janssenlei 17,2022-04-02,09:00:00,42,12,30,F11SP
9,Janssenlei 17,2022-04-02,10:00:00,92,38,54,F11SP
9,Janssenlei 17,2022-04-02,11:00:00,108,58,50,F11SP
9,Janssenlei 17,2022-04-02,12:00:00,122,62,60,F11SP
9,Janssenlei 17,2022-04-02,13:00:00,118,76,42,F11SP
9,Janssenlei 17,2022-04-02,14:00:00,148,58,90,F11SP
9,Janssenlei 17,2022-04-02,15:00:00,96,46,50,F11SP
9,Janssenlei 17,2022-04-02,16:00:00,64,48,16,F11SP
9,Janssenlei 17,2022-04-02,17:00:00,80,46,34,F11SP
9,Janssenlei 17,2022-04-02,18:00:00,68,40,28,F11SP
9,Janssenlei 17,2022-04-02,19:00:00,38,20,18,F11SP
9,Janssenlei 17,2022-04-02,20:00:00,18,4,14,F11SP
9,Janssenlei 17,2022-04-02,21:00:00,22,10,12,F11SP
9,Janssenlei 17,2022-04-02,22:00:00,10,2,8,F11SP
9,Janssenlei 17,2022-04-02,23:00:00,14,6,8,F11SP
9,Janssenlei 17,2022-04-03,00:00:00,6,2,4,F11SP
9,Janssenlei 17,2022-04-03,01:00:00,12,2,10,F11SP
9,Janssenlei 17,2022-04-03,02:00:00,8,0,8,F11SP
9,Janssenlei 17,2022-04-03,03:00:00,8,0,8,F11SP
9,Janssenlei 17,2022-04-03,04:00:00,4,4,0,F11SP
9,Janssenlei 17,2022-04-03,05:00:00,8,8,0,F11SP
9,Janssenlei 17,2022-04-03,06:00:00,12,10,2,F11SP
9,Janssenlei 17,2022-04-03,07:00:00,28,16,12,F11SP
9,Janssenlei 17,2022-04-03,08:00:00,70,26,44,F11SP
9,Janssenlei 17,2022-04-03,09:00:00,120,34,86,F11SP
9,Janssenlei 17,2022-04-03,10:00:00,188,70,118,F11SP
9,Janssenlei 17,2022-04-03,11:00:00,248,110,138,F11SP
9,Janssenlei 17,2022-04-03,12:00:00,254,144,110,F11SP
9,Janssenlei 17,2022-04-03,13:00:00,194,106,88,F11SP
9,Janssenlei 17,2022-04-03,14:00:00,146,82,64,F11SP
9,Janssenlei 17,2022-04-03,15:00:00,102,54,48,F11SP
9,Janssenlei 17,2022-04-03,16:00:00,58,42,16,F11SP
9,Janssenlei 17,2022-04-03,17:00:00,66,30,36,F11SP
9,Janssenlei 17,2022-04-03,18:00:00,40,18,22,F11SP
9,Janssenlei 17,2022-04-03,19:00:00,20,14,6,F11SP
9,Janssenlei 17,2022-04-03,20:00:00,20,10,10,F11SP
9,Janssenlei 17,2022-04-03,21:00:00,10,6,4,F11SP
9,Janssenlei 17,2022-04-03,22:00:00,8,2,6,F11SP
9,Janssenlei 17,2022-04-03,23:00:00,8,4,4,F11SP
9,Janssenlei 17,2022-04-04,00:00:00,6,2,4,F11SP
9,Janssenlei 17,2022-04-04,01:00:00,2,0,2,F11SP
9,Janssenlei 17,2022-04-04,02:00:00,2,2,0,F11SP
9,Janssenlei 17,2022-04-04,03:00:00,0,0,0,F11SP
9,Janssenlei 17,2022-04-04,04:00:00,2,2,0,F11SP
9,Janssenlei 17,2022-04-04,05:00:00,32,22,10,F11SP
9,Janssenlei 17,2022-04-04,06:00:00,68,48,20,F11SP
9,Janssenlei 17,2022-04-04,07:00:00,128,88,40,F11SP
9,Janssenlei 17,2022-04-04,08:00:00,144,94,50,F11SP
9,Janssenlei 17,2022-04-04,09:00:00,102,54,48,F11SP
9,Janssenlei 17,2022-04-04,10:00:00,56,28,28,F11SP
9,Janssenlei 17,2022-04-04,11:00:00,60,28,32,F11SP
9,Janssenlei 17,2022-04-04,12:00:00,48,30,18,F11SP
9,Janssenlei 17,2022-04-04,13:00:00,32,14,18,F11SP
9,Janssenlei 17,2022-04-04,14:00:00,56,20,36,F11SP
9,Janssenlei 17,2022-04-04,15:00:00,54,20,34,F11SP
9,Janssenlei 17,2022-04-04,16:00:00,114,48,66,F11SP
9,Janssenlei 17,2022-04-04,17:00:00,128,28,100,F11SP
9,Janssenlei 17,2022-04-04,18:00:00,66,16,50,F11SP
9,Janssenlei 17,2022-04-04,19:00:00,20,4,16,F11SP
9,Janssenlei 17,2022-04-04,20:00:00,4,2,2,F11SP
9,Janssenlei 17,2022-04-04,21:00:00,10,2,8,F11SP
9,Janssenlei 17,2022-04-04,22:00:00,22,2,20,F11SP
9,Janssenlei 17,2022-04-04,23:00:00,8,0,8,F11SP
9,Janssenlei 17,2022-04-05,00:00:00,2,0,2,F11SP
9,Janssenlei 17,2022-04-05,01:00:00,0,0,0,F11SP
9,Janssenlei 17,2022-04-05,02:00:00,2,0,2,F11SP
9,Janssenlei 17,2022-04-05,03:00:00,0,0,0,F11SP
9,Janssenlei 17,2022-04-05,04:00:00,2,0,2,F11SP
9,Janssenlei 17,2022-04-05,05:00:00,28,24,4,F11SP
9,Janssenlei 17,2022-04-05,06:00:00,44,28,16,F11SP
9,Janssenlei 17,2022-04-05,07:00:00,104,72,32,F11SP
9,Janssenlei 17,2022-04-05,08:00:00,120,82,38,F11SP
9,Janssenlei 17,2022-04-05,09:00:00,42,20,22,F11SP
9,Janssenlei 17,2022-04-05,10:00:00,52,22,30,F11SP
9,Janssenlei 17,2022-04-05,11:00:00,24,8,16,F11SP
9,Janssenlei 17,2022-04-05,12:00:00,38,30,8,F11SP
9,Janssenlei 17,2022-04-05,13:00:00,56,20,36,F11SP
9,Janssenlei 17,2022-04-05,14:00:00,74,26,48,F11SP
9,Janssenlei 17,2022-04-05,15:00:00,78,28,50,F11SP
9,Janssenlei 17,2022-04-05,16:00:00,124,52,72,F11SP
9,Janssenlei 17,2022-04-05,17:00:00,162,68,94,F11SP
9,Janssenlei 17,2022-04-05,18:00:00,124,48,76,F11SP
9,Janssenlei 17,2022-04-05,19:00:00,50,34,16,F11SP
9,Janssenlei 17,2022-04-05,20:00:00,26,20,6,F11SP
9,Janssenlei 17,2022-04-05,21:00:00,14,6,8,F11SP
9,Janssenlei 17,2022-04-05,22:00:00,34,8,26,F11SP
9,Janssenlei 17,2022-04-05,23:00:00,8,0,8,F11SP
9,Janssenlei 17,2022-04-06,00:00:00,2,0,2,F11SP
9,Janssenlei 17,2022-04-06,01:00:00,0,0,0,F11SP
9,Janssenlei 17,2022-04-06,02:00:00,4,0,4,F11SP
9,Janssenlei 17,2022-04-06,03:00:00,0,0,0,F11SP
9,Janssenlei 17,2022-04-06,04:00:00,8,4,4,F11SP
9,Janssenlei 17,2022-04-06,05:00:00,26,18,8,F11SP
9,Janssenlei 17,2022-04-06,06:00:00,44,28,16,F11SP
9,Janssenlei 17,2022-04-06,07:00:00,124,82,42,F11SP
9,Janssenlei 17,2022-04-06,08:00:00,132,90,42,F11SP
9,Janssenlei 17,2022-04-06,09:00:00,114,60,54,F11SP
9,Janssenlei 17,2022-04-06,10:00:00,92,40,52,F11SP
9,Janssenlei 17,2022-04-06,11:00:00,100,54,46,F11SP
9,Janssenlei 17,2022-04-06,12:00:00,108,62,46,F11SP
9,Janssenlei 17,2022-04-06,13:00:00,86,44,42,F11SP
9,Janssenlei 17,2022-04-06,14:00:00,124,44,80,F11SP
9,Janssenlei 17,2022-04-06,15:00:00,70,34,36,F11SP
9,Janssenlei 17,2022-04-06,16:00:00,116,46,70,F11SP
9,Janssenlei 17,2022-04-06,17:00:00,152,54,98,F11SP
9,Janssenlei 17,2022-04-06,18:00:00,54,16,38,F11SP
9,Janssenlei 17,2022-04-06,19:00:00,42,12,30,F11SP
9,Janssenlei 17,2022-04-06,20:00:00,32,20,12,F11SP
9,Janssenlei 17,2022-04-06,21:00:00,16,6,10,F11SP
9,Janssenlei 17,2022-04-06,22:00:00,22,4,18,F11SP
9,Janssenlei 17,2022-04-06,23:00:00,10,2,8,F11SP
9,Janssenlei 17,2022-04-07,00:00:00,4,0,4,F11SP
9,Janssenlei 17,2022-04-07,01:00:00,2,0,2,F11SP
9,Janssenlei 17,2022-04-07,02:00:00,2,0,2,F11SP
9,Janssenlei 17,2022-04-07,03:00:00,0,0,0,F11SP
9,Janssenlei 17,2022-04-07,04:00:00,0,0,0,F11SP
9,Janssenlei 17,2022-04-07,05:00:00,38,24,14,F11SP
9,Janssenlei 17,2022-04-07,06:00:00,36,20,16,F11SP
9,Janssenlei 17,2022-04-07,07:00:00,88,54,34,F11SP
9,Janssenlei 17,2022-04-07,08:00:00,92,58,34,F11SP
9,Janssenlei 17,2022-04-07,09:00:00,30,16,14,F11SP
9,Janssenlei 17,2022-04-07,10:00:00,26,22,4,F11SP
9,Janssenlei 17,2022-04-07,11:00:00,54,26,28,F11SP
9,Janssenlei 17,2022-04-07,12:00:00,62,34,28,F11SP
9,Janssenlei 17,2022-04-07,13:00:00,76,32,44,F11SP
9,Janssenlei 17,2022-04-07,14:00:00,54,34,20,F11SP
9,Janssenlei 17,2022-04-07,15:00:00,50,20,30,F11SP
9,Janssenlei 17,2022-04-07,16:00:00,128,60,68,F11SP
9,Janssenlei 17,2022-04-07,17:00:00,116,36,80,F11SP
9,Janssenlei 17,2022-04-07,18:00:00,74,28,46,F11SP
9,Janssenlei 17,2022-04-07,19:00:00,38,20,18,F11SP
9,Janssenlei 17,2022-04-07,20:00:00,22,12,10,F11SP
9,Janssenlei 17,2022-04-07,21:00:00,16,6,10,F11SP
9,Janssenlei 17,2022-04-07,22:00:00,32,10,22,F11SP
9,Janssenlei 17,2022-04-07,23:00:00,4,2,2,F11SP
9,Janssenlei 17,2022-04-08,00:00:00,4,0,4,F11SP
9,Janssenlei 17,2022-04-08,01:00:00,4,0,4,F11SP
9,Janssenlei 17,2022-04-08,02:00:00,0,0,0,F11SP
9,Janssenlei 17,2022-04-08,03:00:00,2,2,0,F11SP
9,Janssenlei 17,2022-04-08,04:00:00,12,6,6,F11SP
9,Janssenlei 17,2022-04-08,05:00:00,34,22,12,F11SP
9,Janssenlei 17,2022-04-08,06:00:00,58,40,18,F11SP
9,Janssenlei 17,2022-04-08,07:00:00,108,66,42,F11SP
9,Janssenlei 17,2022-04-08,08:00:00,122,72,50,F11SP
9,Janssenlei 17,2022-04-08,09:00:00,68,34,34,F11SP
9,Janssenlei 17,2022-04-08,10:00:00,84,42,42,F11SP
9,Janssenlei 17,2022-04-08,11:00:00,92,58,34,F11SP
9,Janssenlei 17,2022-04-08,12:00:00,100,48,52,F11SP
9,Janssenlei 17,2022-04-08,13:00:00,94,38,56,F11SP
9,Janssenlei 17,2022-04-08,14:00:00,124,56,68,F11SP
9,Janssenlei 17,2022-04-08,15:00:00,136,56,80,F11SP
9,Janssenlei 17,2022-04-08,16:00:00,170,86,84,F11SP
9,Janssenlei 17,2022-04-08,17:00:00,138,60,78,F11SP
9,Janssenlei 17,2022-04-08,18:00:00,82,36,46,F11SP
9,Janssenlei 17,2022-04-08,19:00:00,42,20,22,F11SP
9,Janssenlei 17,2022-04-08,20:00:00,40,16,24,F11SP
9,Janssenlei 17,2022-04-08,21:00:00,20,12,8,F11SP
9,Janssenlei 17,2022-04-08,22:00:00,22,12,10,F11SP
9,Janssenlei 17,2022-04-08,23:00:00,10,4,6,F11SP
9,Janssenlei 17,2022-04-09,00:00:00,10,2,8,F11SP
9,Janssenlei 17,2022-04-09,01:00:00,0,0,0,F11SP
9,Janssenlei 17,2022-04-09,02:00:00,8,2,6,F11SP
9,Janssenlei 17,2022-04-09,03:00:00,10,2,8,F11SP
9,Janssenlei 17,2022-04-09,04:00:00,10,6,4,F11SP
9,Janssenlei 17,2022-04-09,05:00:00,8,6,2,F11SP
9,Janssenlei 17,2022-04-09,06:00:00,6,4,2,F11SP
9,Janssenlei 17,2022-04-09,07:00:00,26,12,14,F11SP
9,Janssenlei 17,2022-04-09,08:00:00,62,30,32,F11SP
9,Janssenlei 17,2022-04-09,09:00:00,74,18,56,F11SP
9,Janssenlei 17,2022-04-09,10:00:00,114,52,62,F11SP
9,Janssenlei 17,2022-04-09,11:00:00,126,56,70,F11SP
9,Janssenlei 17,2022-04-09,12:00:00,130,68,62,F11SP
9,Janssenlei 17,2022-04-09,13:00:00,182,110,72,F11SP
9,Janssenlei 17,2022-04-09,14:00:00,134,50,84,F11SP
9,Janssenlei 17,2022-04-09,15:00:00,154,84,70,F11SP
9,Janssenlei 17,2022-04-09,16:00:00,148,102,46,F11SP
9,Janssenlei 17,2022-04-09,17:00:00,132,84,48,F11SP
9,Janssenlei 17,2022-04-09,18:00:00,56,34,22,F11SP
9,Janssenlei 17,2022-04-09,19:00:00,32,24,8,F11SP
9,Janssenlei 17,2022-04-09,20:00:00,34,18,16,F11SP
9,Janssenlei 17,2022-04-09,21:00:00,26,12,14,F11SP
9,Janssenlei 17,2022-04-09,22:00:00,10,2,8,F11SP
9,Janssenlei 17,2022-04-09,23:00:00,10,6,4,F11SP
9,Janssenlei 17,2022-04-10,00:00:00,4,2,2,F11SP
9,Janssenlei 17,2022-04-10,01:00:00,10,0,10,F11SP
9,Janssenlei 17,2022-04-10,02:00:00,0,0,0,F11SP
9,Janssenlei 17,2022-04-10,03:00:00,4,2,2,F11SP
9,Janssenlei 17,2022-04-10,04:00:00,6,4,2,F11SP
9,Janssenlei 17,2022-04-10,05:00:00,6,4,2,F11SP
9,Janssenlei 17,2022-04-10,06:00:00,18,10,8,F11SP
9,Janssenlei 17,2022-04-10,07:00:00,22,10,12,F11SP
9,Janssenlei 17,2022-04-10,08:00:00,52,30,22,F11SP
9,Janssenlei 17,2022-04-10,09:00:00,198,68,130,F11SP
9,Janssenlei 17,2022-04-10,10:00:00,262,102,160,F11SP
9,Janssenlei 17,2022-04-10,11:00:00,294,144,150,F11SP
9,Janssenlei 17,2022-04-10,12:00:00,238,136,102,F11SP
9,Janssenlei 17,2022-04-10,13:00:00,224,114,110,F11SP
9,Janssenlei 17,2022-04-10,14:00:00,280,120,160,F11SP
9,Janssenlei 17,2022-04-10,15:00:00,250,96,154,F11SP
9,Janssenlei 17,2022-04-10,16:00:00,218,154,64,F11SP
9,Janssenlei 17,2022-04-10,17:00:00,180,102,78,F11SP
9,Janssenlei 17,2022-04-10,18:00:00,100,44,56,F11SP
9,Janssenlei 17,2022-04-10,19:00:00,54,28,26,F11SP
9,Janssenlei 17,2022-04-10,20:00:00,40,18,22,F11SP
9,Janssenlei 17,2022-04-10,21:00:00,20,8,12,F11SP
9,Janssenlei 17,2022-04-10,22:00:00,26,8,18,F11SP
9,Janssenlei 17,2022-04-10,23:00:00,12,6,6,F11SP
9,Janssenlei 17,2022-04-11,00:00:00,2,0,2,F11SP
9,Janssenlei 17,2022-04-11,01:00:00,4,4,0,F11SP
9,Janssenlei 17,2022-04-11,02:00:00,4,0,4,F11SP
9,Janssenlei 17,2022-04-11,03:00:00,4,2,2,F11SP
9,Janssenlei 17,2022-04-11,04:00:00,4,4,0,F11SP
9,Janssenlei 17,2022-04-11,05:00:00,38,30,8,F11SP
9,Janssenlei 17,2022-04-11,06:00:00,94,66,28,F11SP
9,Janssenlei 17,2022-04-11,07:00:00,174,110,64,F11SP
9,Janssenlei 17,2022-04-11,08:00:00,194,128,66,F11SP
9,Janssenlei 17,2022-04-11,09:00:00,100,46,54,F11SP
9,Janssenlei 17,2022-04-11,10:00:00,98,46,52,F11SP
9,Janssenlei 17,2022-04-11,11:00:00,100,46,54,F11SP
9,Janssenlei 17,2022-04-11,12:00:00,116,72,44,F11SP
9,Janssenlei 17,2022-04-11,13:00:00,214,108,106,F11SP
9,Janssenlei 17,2022-04-11,14:00:00,206,84,122,F11SP
9,Janssenlei 17,2022-04-11,15:00:00,234,102,132,F11SP
9,Janssenlei 17,2022-04-11,16:00:00,282,130,152,F11SP
9,Janssenlei 17,2022-04-11,17:00:00,326,144,182,F11SP
9,Janssenlei 17,2022-04-11,18:00:00,184,54,130,F11SP
9,Janssenlei 17,2022-04-11,19:00:00,114,58,56,F11SP
9,Janssenlei 17,2022-04-11,20:00:00,74,48,26,F11SP
9,Janssenlei 17,2022-04-11,21:00:00,36,22,14,F11SP
9,Janssenlei 17,2022-04-11,22:00:00,42,4,38,F11SP
9,Janssenlei 17,2022-04-11,23:00:00,8,2,6,F11SP
9,Janssenlei 17,2022-04-12,00:00:00,10,4,6,F11SP
9,Janssenlei 17,2022-04-12,01:00:00,4,2,2,F11SP
9,Janssenlei 17,2022-04-12,02:00:00,0,0,0,F11SP
9,Janssenlei 17,2022-04-12,03:00:00,2,0,2,F11SP
9,Janssenlei 17,2022-04-12,04:00:00,8,6,2,F11SP
9,Janssenlei 17,2022-04-12,05:00:00,58,50,8,F11SP
9,Janssenlei 17,2022-04-12,06:00:00,122,82,40,F11SP
9,Janssenlei 17,2022-04-12,07:00:00,206,142,64,F11SP
9,Janssenlei 17,2022-04-12,08:00:00,228,142,86,F11SP
9,Janssenlei 17,2022-04-12,09:00:00,134,66,68,F11SP
9,Janssenlei 17,2022-04-12,10:00:00,142,72,70,F11SP
9,Janssenlei 17,2022-04-12,11:00:00,216,108,108,F11SP
9,Janssenlei 17,2022-04-12,12:00:00,176,74,102,F11SP
9,Janssenlei 17,2022-04-12,13:00:00,270,110,160,F11SP
9,Janssenlei 17,2022-04-12,14:00:00,280,104,176,F11SP
9,Janssenlei 17,2022-04-12,15:00:00,344,158,186,F11SP
9,Janssenlei 17,2022-04-12,16:00:00,448,210,238,F11SP
9,Janssenlei 17,2022-04-12,17:00:00,462,196,266,F11SP
9,Janssenlei 17,2022-04-12,18:00:00,328,136,192,F11SP
9,Janssenlei 17,2022-04-12,19:00:00,248,148,100,F11SP
9,Janssenlei 17,2022-04-12,20:00:00,224,176,48,F11SP
9,Janssenlei 17,2022-04-12,21:00:00,20,10,10,F11SP
9,Janssenlei 17,2022-04-12,22:00:00,34,6,28,F11SP
9,Janssenlei 17,2022-04-12,23:00:00,26,8,18,F11SP
9,Janssenlei 17,2022-04-13,00:00:00,24,14,10,F11SP
9,Janssenlei 17,2022-04-13,01:00:00,8,8,0,F11SP
9,Janssenlei 17,2022-04-13,02:00:00,4,2,2,F11SP
9,Janssenlei 17,2022-04-13,03:00:00,4,0,4,F11SP
9,Janssenlei 17,2022-04-13,04:00:00,12,8,4,F11SP
9,Janssenlei 17,2022-04-13,05:00:00,44,34,10,F11SP
9,Janssenlei 17,2022-04-13,06:00:00,94,56,38,F11SP
9,Janssenlei 17,2022-04-13,07:00:00,178,120,58,F11SP
9,Janssenlei 17,2022-04-13,08:00:00,192,132,60,F11SP
9,Janssenlei 17,2022-04-13,09:00:00,100,62,38,F11SP
9,Janssenlei 17,2022-04-13,10:00:00,164,86,78,F11SP
9,Janssenlei 17,2022-04-13,11:00:00,100,60,40,F11SP
9,Janssenlei 17,2022-04-13,12:00:00,104,42,62,F11SP
9,Janssenlei 17,2022-04-13,13:00:00,110,54,56,F11SP
9,Janssenlei 17,2022-04-13,14:00:00,116,54,62,F11SP
9,Janssenlei 17,2022-04-13,15:00:00,96,32,64,F11SP
9,Janssenlei 17,2022-04-13,16:00:00,164,86,78,F11SP
9,Janssenlei 17,2022-04-13,17:00:00,244,70,174,F11SP
9,Janssenlei 17,2022-04-13,18:00:00,196,54,142,F11SP
9,Janssenlei 17,2022-04-13,19:00:00,100,52,48,F11SP
9,Janssenlei 17,2022-04-13,20:00:00,72,52,20,F11SP
9,Janssenlei 17,2022-04-13,21:00:00,44,28,16,F11SP
9,Janssenlei 17,2022-04-13,22:00:00,24,12,12,F11SP
9,Janssenlei 17,2022-04-13,23:00:00,28,4,24,F11SP
9,Janssenlei 17,2022-04-14,00:00:00,18,6,12,F11SP
9,Janssenlei 17,2022-04-14,01:00:00,4,0,4,F11SP
9,Janssenlei 17,2022-04-14,02:00:00,0,0,0,F11SP
9,Janssenlei 17,2022-04-14,03:00:00,0,0,0,F11SP
9,Janssenlei 17,2022-04-14,04:00:00,12,10,2,F11SP
9,Janssenlei 17,2022-04-14,05:00:00,34,26,8,F11SP
9,Janssenlei 17,2022-04-14,06:00:00,98,64,34,F11SP
9,Janssenlei 17,2022-04-14,07:00:00,152,92,60,F11SP
9,Janssenlei 17,2022-04-14,08:00:00,220,152,68,F11SP
9,Janssenlei 17,2022-04-14,09:00:00,102,48,54,F11SP
9,Janssenlei 17,2022-04-14,10:00:00,150,74,76,F11SP
9,Janssenlei 17,2022-04-14,11:00:00,196,96,100,F11SP
9,Janssenlei 17,2022-04-14,12:00:00,194,86,108,F11SP
9,Janssenlei 17,2022-04-14,13:00:00,252,112,140,F11SP
9,Janssenlei 17,2022-04-14,14:00:00,248,104,144,F11SP
9,Janssenlei 17,2022-04-14,15:00:00,228,108,120,F11SP
9,Janssenlei 17,2022-04-14,16:00:00,346,192,154,F11SP
9,Janssenlei 17,2022-04-14,17:00:00,392,158,234,F11SP
9,Janssenlei 17,2022-04-14,18:00:00,218,84,134,F11SP
9,Janssenlei 17,2022-04-14,19:00:00,174,92,82,F11SP
9,Janssenlei 17,2022-04-14,20:00:00,162,144,18,F11SP
9,Janssenlei 17,2022-04-14,21:00:00,54,28,26,F11SP
9,Janssenlei 17,2022-04-14,22:00:00,38,12,26,F11SP
9,Janssenlei 17,2022-04-14,23:00:00,12,6,6,F11SP
9,Janssenlei 17,2022-04-15,00:00:00,6,0,6,F11SP
9,Janssenlei 17,2022-04-15,01:00:00,6,2,4,F11SP
9,Janssenlei 17,2022-04-15,02:00:00,18,4,14,F11SP
9,Janssenlei 17,2022-04-15,03:00:00,4,0,4,F11SP
9,Janssenlei 17,2022-04-15,04:00:00,12,10,2,F11SP
9,Janssenlei 17,2022-04-15,05:00:00,40,32,8,F11SP
9,Janssenlei 17,2022-04-15,06:00:00,88,56,32,F11SP
9,Janssenlei 17,2022-04-15,07:00:00,130,74,56,F11SP
9,Janssenlei 17,2022-04-15,08:00:00,178,104,74,F11SP
9,Janssenlei 17,2022-04-15,09:00:00,122,52,70,F11SP
9,Janssenlei 17,2022-04-15,10:00:00,132,50,82,F11SP
9,Janssenlei 17,2022-04-15,11:00:00,118,64,54,F11SP
9,Janssenlei 17,2022-04-15,12:00:00,138,58,80,F11SP
9,Janssenlei 17,2022-04-15,13:00:00,224,100,124,F11SP
9,Janssenlei 17,2022-04-15,14:00:00,306,144,162,F11SP
9,Janssenlei 17,2022-04-15,15:00:00,272,120,152,F11SP
9,Janssenlei 17,2022-04-15,16:00:00,316,140,176,F11SP
9,Janssenlei 17,2022-04-15,17:00:00,280,146,134,F11SP
9,Janssenlei 17,2022-04-15,18:00:00,244,130,114,F11SP
9,Janssenlei 17,2022-04-15,19:00:00,136,66,70,F11SP
9,Janssenlei 17,2022-04-15,20:00:00,72,50,22,F11SP
9,Janssenlei 17,2022-04-15,21:00:00,46,28,18,F11SP
9,Janssenlei 17,2022-04-15,22:00:00,48,20,28,F11SP
9,Janssenlei 17,2022-04-15,23:00:00,24,12,12,F11SP
9,Janssenlei 17,2022-04-16,00:00:00,12,6,6,F11SP
9,Janssenlei 17,2022-04-16,01:00:00,8,2,6,F11SP
9,Janssenlei 17,2022-04-16,02:00:00,4,2,2,F11SP
9,Janssenlei 17,2022-04-16,03:00:00,12,2,10,F11SP
9,Janssenlei 17,2022-04-16,04:00:00,12,6,6,F11SP
9,Janssenlei 17,2022-04-16,05:00:00,18,12,6,F11SP
9,Janssenlei 17,2022-04-16,06:00:00,32,10,22,F11SP
9,Janssenlei 17,2022-04-16,07:00:00,34,20,14,F11SP
9,Janssenlei 17,2022-04-16,08:00:00,84,34,50,F11SP
9,Janssenlei 17,2022-04-16,09:00:00,130,60,70,F11SP
9,Janssenlei 17,2022-04-16,10:00:00,216,94,122,F11SP
9,Janssenlei 17,2022-04-16,11:00:00,218,102,116,F11SP
9,Janssenlei 17,2022-04-16,12:00:00,252,140,112,F11SP
9,Janssenlei 17,2022-04-16,13:00:00,302,156,146,F11SP
9,Janssenlei 17,2022-04-16,14:00:00,380,170,210,F11SP
9,Janssenlei 17,2022-04-16,15:00:00,422,186,236,F11SP
9,Janssenlei 17,2022-04-16,16:00:00,322,174,148,F11SP
9,Janssenlei 17,2022-04-16,17:00:00,248,150,98,F11SP
9,Janssenlei 17,2022-04-16,18:00:00,162,84,78,F11SP
9,Janssenlei 17,2022-04-16,19:00:00,100,60,40,F11SP
9,Janssenlei 17,2022-04-16,20:00:00,92,44,48,F11SP
9,Janssenlei 17,2022-04-16,21:00:00,18,8,10,F11SP
9,Janssenlei 17,2022-04-16,22:00:00,44,16,28,F11SP
9,Janssenlei 17,2022-04-16,23:00:00,22,10,12,F11SP
9,Janssenlei 17,2022-04-17,00:00:00,26,18,8,F11SP
9,Janssenlei 17,2022-04-17,01:00:00,14,2,12,F11SP
9,Janssenlei 17,2022-04-17,02:00:00,8,6,2,F11SP
9,Janssenlei 17,2022-04-17,03:00:00,12,8,4,F11SP
9,Janssenlei 17,2022-04-17,04:00:00,8,6,2,F11SP
9,Janssenlei 17,2022-04-17,05:00:00,18,12,6,F11SP
9,Janssenlei 17,2022-04-17,06:00:00,26,14,12,F11SP
9,Janssenlei 17,2022-04-17,07:00:00,28,8,20,F11SP
9,Janssenlei 17,2022-04-17,08:00:00,64,32,32,F11SP
9,Janssenlei 17,2022-04-17,09:00:00,236,92,144,F11SP
9,Janssenlei 17,2022-04-17,10:00:00,324,108,216,F11SP
9,Janssenlei 17,2022-04-17,11:00:00,386,208,178,F11SP
9,Janssenlei 17,2022-04-17,12:00:00,262,118,144,F11SP
9,Janssenlei 17,2022-04-17,13:00:00,360,160,200,F11SP
9,Janssenlei 17,2022-04-17,14:00:00,358,136,222,F11SP
9,Janssenlei 17,2022-04-17,15:00:00,316,142,174,F11SP
9,Janssenlei 17,2022-04-17,16:00:00,320,160,160,F11SP
9,Janssenlei 17,2022-04-17,17:00:00,318,200,118,F11SP
9,Janssenlei 17,2022-04-17,18:00:00,204,134,70,F11SP
9,Janssenlei 17,2022-04-17,19:00:00,124,86,38,F11SP
9,Janssenlei 17,2022-04-17,20:00:00,90,58,32,F11SP
9,Janssenlei 17,2022-04-17,21:00:00,80,56,24,F11SP
9,Janssenlei 17,2022-04-17,22:00:00,26,14,12,F11SP
9,Janssenlei 17,2022-04-17,23:00:00,10,4,6,F11SP
9,Janssenlei 17,2022-04-18,00:00:00,6,2,4,F11SP
9,Janssenlei 17,2022-04-18,01:00:00,12,8,4,F11SP
9,Janssenlei 17,2022-04-18,02:00:00,4,0,4,F11SP
9,Janssenlei 17,2022-04-18,03:00:00,2,0,2,F11SP
9,Janssenlei 17,2022-04-18,04:00:00,6,4,2,F11SP
9,Janssenlei 17,2022-04-18,05:00:00,8,4,4,F11SP
9,Janssenlei 17,2022-04-18,06:00:00,24,18,6,F11SP
9,Janssenlei 17,2022-04-18,07:00:00,44,12,32,F11SP
9,Janssenlei 17,2022-04-18,08:00:00,76,22,54,F11SP
9,Janssenlei 17,2022-04-18,09:00:00,202,62,140,F11SP
9,Janssenlei 17,2022-04-18,10:00:00,370,138,232,F11SP
9,Janssenlei 17,2022-04-18,11:00:00,352,166,186,F11SP
9,Janssenlei 17,2022-04-18,12:00:00,264,118,146,F11SP
9,Janssenlei 17,2022-04-18,13:00:00,476,190,286,F11SP
9,Janssenlei 17,2022-04-18,14:00:00,554,280,274,F11SP
9,Janssenlei 17,2022-04-18,15:00:00,504,280,224,F11SP
9,Janssenlei 17,2022-04-18,16:00:00,422,244,178,F11SP
9,Janssenlei 17,2022-04-18,17:00:00,324,216,108,F11SP
9,Janssenlei 17,2022-04-18,18:00:00,240,158,82,F11SP
9,Janssenlei 17,2022-04-18,19:00:00,172,90,82,F11SP
9,Janssenlei 17,2022-04-18,20:00:00,72,42,30,F11SP
9,Janssenlei 17,2022-04-18,21:00:00,46,12,34,F11SP
9,Janssenlei 17,2022-04-18,22:00:00,34,10,24,F11SP
9,Janssenlei 17,2022-04-18,23:00:00,22,10,12,F11SP
9,Janssenlei 17,2022-04-19,00:00:00,4,0,4,F11SP
9,Janssenlei 17,2022-04-19,01:00:00,0,0,0,F11SP
9,Janssenlei 17,2022-04-19,02:00:00,0,0,0,F11SP
9,Janssenlei 17,2022-04-19,03:00:00,0,0,0,F11SP
9,Janssenlei 17,2022-04-19,04:00:00,8,6,2,F11SP
9,Janssenlei 17,2022-04-19,05:00:00,54,42,12,F11SP
9,Janssenlei 17,2022-04-19,06:00:00,140,96,44,F11SP
9,Janssenlei 17,2022-04-19,07:00:00,450,292,158,F11SP
9,Janssenlei 17,2022-04-19,08:00:00,458,338,120,F11SP
9,Janssenlei 17,2022-04-19,09:00:00,128,50,78,F11SP
9,Janssenlei 17,2022-04-19,10:00:00,120,62,58,F11SP
9,Janssenlei 17,2022-04-19,11:00:00,116,42,74,F11SP
9,Janssenlei 17,2022-04-19,12:00:00,160,84,76,F11SP
9,Janssenlei 17,2022-04-19,13:00:00,172,70,102,F11SP
9,Janssenlei 17,2022-04-19,14:00:00,210,74,136,F11SP
9,Janssenlei 17,2022-04-19,15:00:00,364,182,182,F11SP
9,Janssenlei 17,2022-04-19,16:00:00,488,168,320,F11SP
9,Janssenlei 17,2022-04-19,17:00:00,488,168,320,F11SP
9,Janssenlei 17,2022-04-19,18:00:00,302,122,180,F11SP
9,Janssenlei 17,2022-04-19,19:00:00,206,84,122,F11SP
9,Janssenlei 17,2022-04-19,20:00:00,132,72,60,F11SP
9,Janssenlei 17,2022-04-19,21:00:00,56,30,26,F11SP
9,Janssenlei 17,2022-04-19,22:00:00,62,28,34,F11SP
9,Janssenlei 17,2022-04-19,23:00:00,16,2,14,F11SP
9,Janssenlei 17,2022-04-20,00:00:00,2,2,0,F11SP
9,Janssenlei 17,2022-04-20,01:00:00,2,0,2,F11SP
9,Janssenlei 17,2022-04-20,02:00:00,8,2,6,F11SP
9,Janssenlei 17,2022-04-20,03:00:00,0,0,0,F11SP
9,Janssenlei 17,2022-04-20,04:00:00,10,10,0,F11SP
9,Janssenlei 17,2022-04-20,05:00:00,50,46,4,F11SP
9,Janssenlei 17,2022-04-20,06:00:00,124,76,48,F11SP
9,Janssenlei 17,2022-04-20,07:00:00,448,266,182,F11SP
9,Janssenlei 17,2022-04-20,08:00:00,452,312,140,F11SP
9,Janssenlei 17,2022-04-20,09:00:00,170,96,74,F11SP
9,Janssenlei 17,2022-04-20,10:00:00,122,62,60,F11SP
9,Janssenlei 17,2022-04-20,11:00:00,194,80,114,F11SP
9,Janssenlei 17,2022-04-20,12:00:00,348,160,188,F11SP
9,Janssenlei 17,2022-04-20,13:00:00,280,118,162,F11SP
9,Janssenlei 17,2022-04-20,14:00:00,278,122,156,F11SP
9,Janssenlei 17,2022-04-20,15:00:00,236,96,140,F11SP
9,Janssenlei 17,2022-04-20,16:00:00,406,166,240,F11SP
9,Janssenlei 17,2022-04-20,17:00:00,424,178,246,F11SP
9,Janssenlei 17,2022-04-20,18:00:00,382,128,254,F11SP
9,Janssenlei 17,2022-04-20,19:00:00,246,114,132,F11SP
9,Janssenlei 17,2022-04-20,20:00:00,186,108,78,F11SP
9,Janssenlei 17,2022-04-20,21:00:00,90,46,44,F11SP
9,Janssenlei 17,2022-04-20,22:00:00,80,16,64,F11SP
9,Janssenlei 17,2022-04-20,23:00:00,32,10,22,F11SP
9,Janssenlei 17,2022-04-21,00:00:00,4,2,2,F11SP
9,Janssenlei 17,2022-04-21,01:00:00,6,2,4,F11SP
9,Janssenlei 17,2022-04-21,02:00:00,2,2,0,F11SP
9,Janssenlei 17,2022-04-21,03:00:00,0,0,0,F11SP
9,Janssenlei 17,2022-04-21,04:00:00,12,12,0,F11SP
9,Janssenlei 17,2022-04-21,05:00:00,62,50,12,F11SP
9,Janssenlei 17,2022-04-21,06:00:00,132,90,42,F11SP
9,Janssenlei 17,2022-04-21,07:00:00,462,312,150,F11SP
9,Janssenlei 17,2022-04-21,08:00:00,494,336,158,F11SP
9,Janssenlei 17,2022-04-21,09:00:00,148,68,80,F11SP
9,Janssenlei 17,2022-04-21,10:00:00,124,54,70,F11SP
9,Janssenlei 17,2022-04-21,11:00:00,136,64,72,F11SP
9,Janssenlei 17,2022-04-21,12:00:00,160,86,74,F11SP
9,Janssenlei 17,2022-04-21,13:00:00,190,72,118,F11SP
9,Janssenlei 17,2022-04-21,14:00:00,238,78,160,F11SP
9,Janssenlei 17,2022-04-21,15:00:00,376,150,226,F11SP
9,Janssenlei 17,2022-04-21,16:00:00,594,218,376,F11SP
9,Janssenlei 17,2022-04-21,17:00:00,500,148,352,F11SP
9,Janssenlei 17,2022-04-21,18:00:00,308,128,180,F11SP
9,Janssenlei 17,2022-04-21,19:00:00,248,114,134,F11SP
9,Janssenlei 17,2022-04-21,20:00:00,180,138,42,F11SP
9,Janssenlei 17,2022-04-21,21:00:00,68,24,44,F11SP
9,Janssenlei 17,2022-04-21,22:00:00,48,12,36,F11SP
9,Janssenlei 17,2022-04-21,23:00:00,26,4,22,F11SP
9,Janssenlei 17,2022-04-22,00:00:00,6,0,6,F11SP
9,Janssenlei 17,2022-04-22,01:00:00,2,2,0,F11SP
9,Janssenlei 17,2022-04-22,02:00:00,4,2,2,F11SP
9,Janssenlei 17,2022-04-22,03:00:00,0,0,0,F11SP
9,Janssenlei 17,2022-04-22,04:00:00,12,12,0,F11SP
9,Janssenlei 17,2022-04-22,05:00:00,38,36,2,F11SP
9,Janssenlei 17,2022-04-22,06:00:00,108,74,34,F11SP
9,Janssenlei 17,2022-04-22,07:00:00,354,218,136,F11SP
9,Janssenlei 17,2022-04-22,08:00:00,410,278,132,F11SP
9,Janssenlei 17,2022-04-22,09:00:00,152,82,70,F11SP
9,Janssenlei 17,2022-04-22,10:00:00,106,50,56,F11SP
9,Janssenlei 17,2022-04-22,11:00:00,120,72,48,F11SP
9,Janssenlei 17,2022-04-22,12:00:00,160,70,90,F11SP
9,Janssenlei 17,2022-04-22,13:00:00,112,46,66,F11SP
9,Janssenlei 17,2022-04-22,14:00:00,192,94,98,F11SP
9,Janssenlei 17,2022-04-22,15:00:00,318,118,200,F11SP
9,Janssenlei 17,2022-04-22,16:00:00,400,138,262,F11SP
9,Janssenlei 17,2022-04-22,17:00:00,288,96,192,F11SP
9,Janssenlei 17,2022-04-22,18:00:00,194,76,118,F11SP
9,Janssenlei 17,2022-04-22,19:00:00,118,60,58,F11SP
9,Janssenlei 17,2022-04-22,20:00:00,74,30,44,F11SP
9,Janssenlei 17,2022-04-22,21:00:00,38,18,20,F11SP
9,Janssenlei 17,2022-04-22,22:00:00,66,16,50,F11SP
9,Janssenlei 17,2022-04-22,23:00:00,30,14,16,F11SP
9,Janssenlei 17,2022-04-23,00:00:00,20,6,14,F11SP
9,Janssenlei 17,2022-04-23,01:00:00,14,4,10,F11SP
9,Janssenlei 17,2022-04-23,02:00:00,20,14,6,F11SP
9,Janssenlei 17,2022-04-23,03:00:00,14,2,12,F11SP
9,Janssenlei 17,2022-04-23,04:00:00,8,6,2,F11SP
9,Janssenlei 17,2022-04-23,05:00:00,12,8,4,F11SP
9,Janssenlei 17,2022-04-23,06:00:00,6,2,4,F11SP
9,Janssenlei 17,2022-04-23,07:00:00,40,16,24,F11SP
9,Janssenlei 17,2022-04-23,08:00:00,84,44,40,F11SP
9,Janssenlei 17,2022-04-23,09:00:00,122,60,62,F11SP
9,Janssenlei 17,2022-04-23,10:00:00,220,78,142,F11SP
9,Janssenlei 17,2022-04-23,11:00:00,218,92,126,F11SP
9,Janssenlei 17,2022-04-23,12:00:00,264,122,142,F11SP
9,Janssenlei 17,2022-04-23,13:00:00,270,126,144,F11SP
9,Janssenlei 17,2022-04-23,14:00:00,304,134,170,F11SP
9,Janssenlei 17,2022-04-23,15:00:00,304,120,184,F11SP
9,Janssenlei 17,2022-04-23,16:00:00,266,148,118,F11SP
9,Janssenlei 17,2022-04-23,17:00:00,192,102,90,F11SP
9,Janssenlei 17,2022-04-23,18:00:00,120,74,46,F11SP
9,Janssenlei 17,2022-04-23,19:00:00,88,36,52,F11SP
9,Janssenlei 17,2022-04-23,20:00:00,62,44,18,F11SP
9,Janssenlei 17,2022-04-23,21:00:00,62,34,28,F11SP
9,Janssenlei 17,2022-04-23,22:00:00,24,10,14,F11SP
9,Janssenlei 17,2022-04-23,23:00:00,12,8,4,F11SP
9,Janssenlei 17,2022-04-24,00:00:00,26,6,20,F11SP
9,Janssenlei 17,2022-04-24,01:00:00,22,12,10,F11SP
9,Janssenlei 17,2022-04-24,02:00:00,12,4,8,F11SP
9,Janssenlei 17,2022-04-24,03:00:00,8,8,0,F11SP
9,Janssenlei 17,2022-04-24,04:00:00,10,10,0,F11SP
9,Janssenlei 17,2022-04-24,05:00:00,10,8,2,F11SP
9,Janssenlei 17,2022-04-24,06:00:00,24,16,8,F11SP
9,Janssenlei 17,2022-04-24,07:00:00,44,14,30,F11SP
9,Janssenlei 17,2022-04-24,08:00:00,134,78,56,F11SP
9,Janssenlei 17,2022-04-24,09:00:00,266,98,168,F11SP
9,Janssenlei 17,2022-04-24,10:00:00,322,116,206,F11SP
9,Janssenlei 17,2022-04-24,11:00:00,382,206,176,F11SP
9,Janssenlei 17,2022-04-24,12:00:00,354,188,166,F11SP
9,Janssenlei 17,2022-04-24,13:00:00,336,168,168,F11SP
9,Janssenlei 17,2022-04-24,14:00:00,326,140,186,F11SP
9,Janssenlei 17,2022-04-24,15:00:00,286,126,160,F11SP
9,Janssenlei 17,2022-04-24,16:00:00,264,152,112,F11SP
9,Janssenlei 17,2022-04-24,17:00:00,216,108,108,F11SP
9,Janssenlei 17,2022-04-24,18:00:00,148,64,84,F11SP
9,Janssenlei 17,2022-04-24,19:00:00,94,40,54,F11SP
9,Janssenlei 17,2022-04-24,20:00:00,54,36,18,F11SP
9,Janssenlei 17,2022-04-24,21:00:00,26,14,12,F11SP
9,Janssenlei 17,2022-04-24,22:00:00,38,14,24,F11SP
9,Janssenlei 17,2022-04-24,23:00:00,6,4,2,F11SP
9,Janssenlei 17,2022-04-25,00:00:00,14,4,10,F11SP
9,Janssenlei 17,2022-04-25,01:00:00,8,4,4,F11SP
9,Janssenlei 17,2022-04-25,02:00:00,2,2,0,F11SP
9,Janssenlei 17,2022-04-25,03:00:00,0,0,0,F11SP
9,Janssenlei 17,2022-04-25,04:00:00,10,8,2,F11SP
9,Janssenlei 17,2022-04-25,05:00:00,56,38,18,F11SP
9,Janssenlei 17,2022-04-25,06:00:00,106,76,30,F11SP
9,Janssenlei 17,2022-04-25,07:00:00,346,220,126,F11SP
9,Janssenlei 17,2022-04-25,08:00:00,372,260,112,F11SP
9,Janssenlei 17,2022-04-25,09:00:00,118,78,40,F11SP
9,Janssenlei 17,2022-04-25,10:00:00,126,56,70,F11SP
9,Janssenlei 17,2022-04-25,11:00:00,104,52,52,F11SP
9,Janssenlei 17,2022-04-25,12:00:00,94,54,40,F11SP
9,Janssenlei 17,2022-04-25,13:00:00,114,64,50,F11SP
9,Janssenlei 17,2022-04-25,14:00:00,122,66,56,F11SP
9,Janssenlei 17,2022-04-25,15:00:00,238,78,160,F11SP
9,Janssenlei 17,2022-04-25,16:00:00,412,148,264,F11SP
9,Janssenlei 17,2022-04-25,17:00:00,290,94,196,F11SP
9,Janssenlei 17,2022-04-25,18:00:00,198,86,112,F11SP
9,Janssenlei 17,2022-04-25,19:00:00,94,46,48,F11SP
9,Janssenlei 17,2022-04-25,20:00:00,68,38,30,F11SP
9,Janssenlei 17,2022-04-25,21:00:00,34,20,14,F11SP
9,Janssenlei 17,2022-04-25,22:00:00,66,22,44,F11SP
9,Janssenlei 17,2022-04-25,23:00:00,10,4,6,F11SP
9,Janssenlei 17,2022-04-26,00:00:00,2,0,2,F11SP
9,Janssenlei 17,2022-04-26,01:00:00,6,0,6,F11SP
9,Janssenlei 17,2022-04-26,02:00:00,2,0,2,F11SP
9,Janssenlei 17,2022-04-26,03:00:00,6,6,0,F11SP
9,Janssenlei 17,2022-04-26,04:00:00,18,10,8,F11SP
9,Janssenlei 17,2022-04-26,05:00:00,58,44,14,F11SP
9,Janssenlei 17,2022-04-26,06:00:00,146,106,40,F11SP
9,Janssenlei 17,2022-04-26,07:00:00,412,260,152,F11SP
9,Janssenlei 17,2022-04-26,08:00:00,448,316,132,F11SP
9,Janssenlei 17,2022-04-26,09:00:00,140,70,70,F11SP
9,Janssenlei 17,2022-04-26,10:00:00,90,50,40,F11SP
9,Janssenlei 17,2022-04-26,11:00:00,114,46,68,F11SP
9,Janssenlei 17,2022-04-26,12:00:00,108,56,52,F11SP
9,Janssenlei 17,2022-04-26,13:00:00,112,52,60,F11SP
9,Janssenlei 17,2022-04-26,14:00:00,154,74,80,F11SP
9,Janssenlei 17,2022-04-26,15:00:00,276,104,172,F11SP
9,Janssenlei 17,2022-04-26,16:00:00,488,170,318,F11SP
9,Janssenlei 17,2022-04-26,17:00:00,384,112,272,F11SP
9,Janssenlei 17,2022-04-26,18:00:00,236,74,162,F11SP
9,Janssenlei 17,2022-04-26,19:00:00,184,82,102,F11SP
9,Janssenlei 17,2022-04-26,20:00:00,158,108,50,F11SP
9,Janssenlei 17,2022-04-26,21:00:00,50,30,20,F11SP
9,Janssenlei 17,2022-04-26,22:00:00,44,4,40,F11SP
9,Janssenlei 17,2022-04-26,23:00:00,8,0,8,F11SP
9,Janssenlei 17,2022-04-27,00:00:00,6,2,4,F11SP
9,Janssenlei 17,2022-04-27,01:00:00,2,2,0,F11SP
9,Janssenlei 17,2022-04-27,02:00:00,0,0,0,F11SP
9,Janssenlei 17,2022-04-27,03:00:00,0,0,0,F11SP
9,Janssenlei 17,2022-04-27,04:00:00,14,12,2,F11SP
9,Janssenlei 17,2022-04-27,05:00:00,48,34,14,F11SP
9,Janssenlei 17,2022-04-27,06:00:00,122,80,42,F11SP
9,Janssenlei 17,2022-04-27,07:00:00,406,256,150,F11SP
9,Janssenlei 17,2022-04-27,08:00:00,376,236,140,F11SP
9,Janssenlei 17,2022-04-27,09:00:00,152,70,82,F11SP
9,Janssenlei 17,2022-04-27,10:00:00,154,84,70,F11SP
9,Janssenlei 17,2022-04-27,11:00:00,186,94,92,F11SP
9,Janssenlei 17,2022-04-27,12:00:00,348,160,188,F11SP
9,Janssenlei 17,2022-04-27,13:00:00,254,104,150,F11SP
9,Janssenlei 17,2022-04-27,14:00:00,356,128,228,F11SP
9,Janssenlei 17,2022-04-27,15:00:00,318,142,176,F11SP
9,Janssenlei 17,2022-04-27,16:00:00,360,148,212,F11SP
9,Janssenlei 17,2022-04-27,17:00:00,444,164,280,F11SP
9,Janssenlei 17,2022-04-27,18:00:00,354,132,222,F11SP
9,Janssenlei 17,2022-04-27,19:00:00,238,84,154,F11SP
9,Janssenlei 17,2022-04-27,20:00:00,144,106,38,F11SP
9,Janssenlei 17,2022-04-27,21:00:00,64,22,42,F11SP
9,Janssenlei 17,2022-04-27,22:00:00,70,16,54,F11SP
9,Janssenlei 17,2022-04-27,23:00:00,8,0,8,F11SP
9,Janssenlei 17,2022-04-28,00:00:00,12,8,4,F11SP
9,Janssenlei 17,2022-04-28,01:00:00,4,0,4,F11SP
9,Janssenlei 17,2022-04-28,02:00:00,0,0,0,F11SP
9,Janssenlei 17,2022-04-28,03:00:00,0,0,0,F11SP
9,Janssenlei 17,2022-04-28,04:00:00,14,12,2,F11SP
9,Janssenlei 17,2022-04-28,05:00:00,52,40,12,F11SP
9,Janssenlei 17,2022-04-28,06:00:00,138,96,42,F11SP
9,Janssenlei 17,2022-04-28,07:00:00,410,254,156,F11SP
9,Janssenlei 17,2022-04-28,08:00:00,532,362,170,F11SP
9,Janssenlei 17,2022-04-28,09:00:00,142,74,68,F11SP
9,Janssenlei 17,2022-04-28,10:00:00,142,60,82,F11SP
9,Janssenlei 17,2022-04-28,11:00:00,136,76,60,F11SP
9,Janssenlei 17,2022-04-28,12:00:00,188,96,92,F11SP
9,Janssenlei 17,2022-04-28,13:00:00,244,138,106,F11SP
9,Janssenlei 17,2022-04-28,14:00:00,336,142,194,F11SP
9,Janssenlei 17,2022-04-28,15:00:00,370,174,196,F11SP
9,Janssenlei 17,2022-04-28,16:00:00,630,266,364,F11SP
9,Janssenlei 17,2022-04-28,17:00:00,458,158,300,F11SP
9,Janssenlei 17,2022-04-28,18:00:00,334,132,202,F11SP
9,Janssenlei 17,2022-04-28,19:00:00,200,96,104,F11SP
9,Janssenlei 17,2022-04-28,20:00:00,166,114,52,F11SP
9,Janssenlei 17,2022-04-28,21:00:00,80,38,42,F11SP
9,Janssenlei 17,2022-04-28,22:00:00,68,14,54,F11SP
9,Janssenlei 17,2022-04-28,23:00:00,28,6,22,F11SP
9,Janssenlei 17,2022-04-29,00:00:00,16,6,10,F11SP
9,Janssenlei 17,2022-04-29,01:00:00,4,0,4,F11SP
9,Janssenlei 17,2022-04-29,02:00:00,8,0,8,F11SP
9,Janssenlei 17,2022-04-29,03:00:00,2,2,0,F11SP
9,Janssenlei 17,2022-04-29,04:00:00,20,16,4,F11SP
9,Janssenlei 17,2022-04-29,05:00:00,46,36,10,F11SP
9,Janssenlei 17,2022-04-29,06:00:00,98,70,28,F11SP
9,Janssenlei 17,2022-04-29,07:00:00,368,212,156,F11SP
9,Janssenlei 17,2022-04-29,08:00:00,452,286,166,F11SP
9,Janssenlei 17,2022-04-29,09:00:00,148,80,68,F11SP
9,Janssenlei 17,2022-04-29,10:00:00,130,70,60,F11SP
9,Janssenlei 17,2022-04-29,11:00:00,130,70,60,F11SP
9,Janssenlei 17,2022-04-29,12:00:00,180,90,90,F11SP
9,Janssenlei 17,2022-04-29,13:00:00,210,100,110,F11SP
9,Janssenlei 17,2022-04-29,14:00:00,230,74,156,F11SP
9,Janssenlei 17,2022-04-29,15:00:00,332,130,202,F11SP
9,Janssenlei 17,2022-04-29,16:00:00,430,176,254,F11SP
9,Janssenlei 17,2022-04-29,17:00:00,330,90,240,F11SP
9,Janssenlei 17,2022-04-29,18:00:00,216,90,126,F11SP
9,Janssenlei 17,2022-04-29,19:00:00,100,48,52,F11SP
9,Janssenlei 17,2022-04-29,20:00:00,72,32,40,F11SP
9,Janssenlei 17,2022-04-29,21:00:00,24,10,14,F11SP
9,Janssenlei 17,2022-04-29,22:00:00,46,20,26,F11SP
9,Janssenlei 17,2022-04-29,23:00:00,34,12,22,F11SP
9,Janssenlei 17,2022-04-30,00:00:00,34,14,20,F11SP
9,Janssenlei 17,2022-04-30,01:00:00,18,14,4,F11SP
9,Janssenlei 17,2022-04-30,02:00:00,4,2,2,F11SP
9,Janssenlei 17,2022-04-30,03:00:00,10,4,6,F11SP
9,Janssenlei 17,2022-04-30,04:00:00,8,4,4,F11SP
9,Janssenlei 17,2022-04-30,05:00:00,20,20,0,F11SP
9,Janssenlei 17,2022-04-30,06:00:00,22,12,10,F11SP
9,Janssenlei 17,2022-04-30,07:00:00,26,10,16,F11SP
9,Janssenlei 17,2022-04-30,08:00:00,104,34,70,F11SP
9,Janssenlei 17,2022-04-30,09:00:00,138,46,92,F11SP
9,Janssenlei 17,2022-04-30,10:00:00,200,82,118,F11SP
9,Janssenlei 17,2022-04-30,11:00:00,194,86,108,F11SP
9,Janssenlei 17,2022-04-30,12:00:00,184,98,86,F11SP
9,Janssenlei 17,2022-04-30,13:00:00,230,116,114,F11SP
9,Janssenlei 17,2022-04-30,14:00:00,214,108,106,F11SP
9,Janssenlei 17,2022-04-30,15:00:00,196,84,112,F11SP
9,Janssenlei 17,2022-04-30,16:00:00,156,76,80,F11SP
9,Janssenlei 17,2022-04-30,17:00:00,158,90,68,F11SP
9,Janssenlei 17,2022-04-30,18:00:00,142,82,60,F11SP
9,Janssenlei 17,2022-04-30,19:00:00,92,40,52,F11SP
9,Janssenlei 17,2022-04-30,20:00:00,42,24,18,F11SP
9,Janssenlei 17,2022-04-30,21:00:00,54,22,32,F11SP
9,Janssenlei 17,2022-04-30,22:00:00,30,10,20,F11SP
9,Janssenlei 17,2022-04-30,23:00:00,38,18,20,F11SP
9,Janssenlei 17,2022-05-01,00:00:00,22,12,10,F11SP
9,Janssenlei 17,2022-05-01,01:00:00,16,12,4,F11SP
9,Janssenlei 17,2022-05-01,02:00:00,18,16,2,F11SP
9,Janssenlei 17,2022-05-01,03:00:00,12,8,4,F11SP
9,Janssenlei 17,2022-05-01,04:00:00,0,0,0,F11SP
9,Janssenlei 17,2022-05-01,05:00:00,10,10,0,F11SP
9,Janssenlei 17,2022-05-01,06:00:00,8,4,4,F11SP
9,Janssenlei 17,2022-05-01,07:00:00,36,20,16,F11SP
9,Janssenlei 17,2022-05-01,08:00:00,92,36,56,F11SP
9,Janssenlei 17,2022-05-01,09:00:00,234,72,162,F11SP
9,Janssenlei 17,2022-05-01,10:00:00,276,100,176,F11SP
9,Janssenlei 17,2022-05-01,11:00:00,282,166,116,F11SP
9,Janssenlei 17,2022-05-01,12:00:00,236,138,98,F11SP
9,Janssenlei 17,2022-05-01,13:00:00,268,136,132,F11SP
9,Janssenlei 17,2022-05-01,14:00:00,312,140,172,F11SP
9,Janssenlei 17,2022-05-01,15:00:00,322,154,168,F11SP
9,Janssenlei 17,2022-05-01,16:00:00,272,128,144,F11SP
9,Janssenlei 17,2022-05-01,17:00:00,220,140,80,F11SP
9,Janssenlei 17,2022-05-01,18:00:00,102,58,44,F11SP
9,Janssenlei 17,2022-05-01,19:00:00,70,40,30,F11SP
9,Janssenlei 17,2022-05-01,20:00:00,44,24,20,F11SP
9,Janssenlei 17,2022-05-01,21:00:00,42,30,12,F11SP
9,Janssenlei 17,2022-05-01,22:00:00,28,14,14,F11SP
9,Janssenlei 17,2022-05-01,23:00:00,10,4,6,F11SP
9,Janssenlei 17,2022-05-02,00:00:00,4,2,2,F11SP
9,Janssenlei 17,2022-05-02,01:00:00,2,2,0,F11SP
9,Janssenlei 17,2022-05-02,02:00:00,6,2,4,F11SP
9,Janssenlei 17,2022-05-02,03:00:00,0,0,0,F11SP
9,Janssenlei 17,2022-05-02,04:00:00,6,6,0,F11SP
9,Janssenlei 17,2022-05-02,05:00:00,62,46,16,F11SP
9,Janssenlei 17,2022-05-02,06:00:00,76,56,20,F11SP
9,Janssenlei 17,2022-05-02,07:00:00,392,236,156,F11SP
9,Janssenlei 17,2022-05-02,08:00:00,446,320,126,F11SP
9,Janssenlei 17,2022-05-02,09:00:00,134,78,56,F11SP
9,Janssenlei 17,2022-05-02,10:00:00,132,70,62,F11SP
9,Janssenlei 17,2022-05-02,11:00:00,134,72,62,F11SP
9,Janssenlei 17,2022-05-02,12:00:00,164,76,88,F11SP
9,Janssenlei 17,2022-05-02,13:00:00,186,86,100,F11SP
9,Janssenlei 17,2022-05-02,14:00:00,276,116,160,F11SP
9,Janssenlei 17,2022-05-02,15:00:00,336,136,200,F11SP
9,Janssenlei 17,2022-05-02,16:00:00,486,186,300,F11SP
9,Janssenlei 17,2022-05-02,17:00:00,408,144,264,F11SP
9,Janssenlei 17,2022-05-02,18:00:00,244,104,140,F11SP
9,Janssenlei 17,2022-05-02,19:00:00,200,94,106,F11SP
9,Janssenlei 17,2022-05-02,20:00:00,146,88,58,F11SP
9,Janssenlei 17,2022-05-02,21:00:00,56,22,34,F11SP
9,Janssenlei 17,2022-05-02,22:00:00,70,18,52,F11SP
9,Janssenlei 17,2022-05-02,23:00:00,8,0,8,F11SP
9,Janssenlei 17,2022-05-03,00:00:00,0,0,0,F11SP
9,Janssenlei 17,2022-05-03,01:00:00,0,0,0,F11SP
9,Janssenlei 17,2022-05-03,02:00:00,0,0,0,F11SP
9,Janssenlei 17,2022-05-03,03:00:00,0,0,0,F11SP
9,Janssenlei 17,2022-05-03,04:00:00,8,6,2,F11SP
9,Janssenlei 17,2022-05-03,05:00:00,78,66,12,F11SP
9,Janssenlei 17,2022-05-03,06:00:00,168,116,52,F11SP
9,Janssenlei 17,2022-05-03,07:00:00,474,304,170,F11SP
9,Janssenlei 17,2022-05-03,08:00:00,490,360,130,F11SP
9,Janssenlei 17,2022-05-03,09:00:00,166,100,66,F11SP
9,Janssenlei 17,2022-05-03,10:00:00,142,72,70,F11SP
9,Janssenlei 17,2022-05-03,11:00:00,172,96,76,F11SP
9,Janssenlei 17,2022-05-03,12:00:00,190,102,88,F11SP
9,Janssenlei 17,2022-05-03,13:00:00,204,100,104,F11SP
9,Janssenlei 17,2022-05-03,14:00:00,258,118,140,F11SP
9,Janssenlei 17,2022-05-03,15:00:00,322,120,202,F11SP
9,Janssenlei 17,2022-05-03,16:00:00,522,166,356,F11SP
9,Janssenlei 17,2022-05-03,17:00:00,572,184,388,F11SP
9,Janssenlei 17,2022-05-03,18:00:00,382,142,240,F11SP
9,Janssenlei 17,2022-05-03,19:00:00,192,108,84,F11SP
9,Janssenlei 17,2022-05-03,20:00:00,144,88,56,F11SP
9,Janssenlei 17,2022-05-03,21:00:00,60,38,22,F11SP
9,Janssenlei 17,2022-05-03,22:00:00,54,12,42,F11SP
9,Janssenlei 17,2022-05-03,23:00:00,6,2,4,F11SP
9,Janssenlei 17,2022-05-04,00:00:00,8,2,6,F11SP
9,Janssenlei 17,2022-05-04,01:00:00,10,4,6,F11SP
9,Janssenlei 17,2022-05-04,02:00:00,2,0,2,F11SP
9,Janssenlei 17,2022-05-04,03:00:00,0,0,0,F11SP
9,Janssenlei 17,2022-05-04,04:00:00,14,14,0,F11SP
9,Janssenlei 17,2022-05-04,05:00:00,72,60,12,F11SP
9,Janssenlei 17,2022-05-04,06:00:00,146,104,42,F11SP
9,Janssenlei 17,2022-05-04,07:00:00,448,286,162,F11SP
9,Janssenlei 17,2022-05-04,08:00:00,566,310,256,F11SP
9,Janssenlei 17,2022-05-04,09:00:00,148,84,64,F11SP
9,Janssenlei 17,2022-05-04,10:00:00,152,94,58,F11SP
9,Janssenlei 17,2022-05-04,11:00:00,222,100,122,F11SP
9,Janssenlei 17,2022-05-04,12:00:00,442,226,216,F11SP
9,Janssenlei 17,2022-05-04,13:00:00,334,166,168,F11SP
9,Janssenlei 17,2022-05-04,14:00:00,358,128,230,F11SP
9,Janssenlei 17,2022-05-04,15:00:00,284,138,146,F11SP
9,Janssenlei 17,2022-05-04,16:00:00,460,168,292,F11SP
9,Janssenlei 17,2022-05-04,17:00:00,432,144,288,F11SP
9,Janssenlei 17,2022-05-04,18:00:00,374,142,232,F11SP
9,Janssenlei 17,2022-05-04,19:00:00,260,122,138,F11SP
9,Janssenlei 17,2022-05-04,20:00:00,172,118,54,F11SP
9,Janssenlei 17,2022-05-04,21:00:00,76,48,28,F11SP
9,Janssenlei 17,2022-05-04,22:00:00,64,24,40,F11SP
9,Janssenlei 17,2022-05-04,23:00:00,16,8,8,F11SP
9,Janssenlei 17,2022-05-05,00:00:00,10,10,0,F11SP
9,Janssenlei 17,2022-05-05,01:00:00,6,0,6,F11SP
9,Janssenlei 17,2022-05-05,02:00:00,0,0,0,F11SP
9,Janssenlei 17,2022-05-05,03:00:00,0,0,0,F11SP
9,Janssenlei 17,2022-05-05,04:00:00,8,8,0,F11SP
9,Janssenlei 17,2022-05-05,05:00:00,76,56,20,F11SP
9,Janssenlei 17,2022-05-05,06:00:00,120,82,38,F11SP
9,Janssenlei 17,2022-05-05,07:00:00,446,298,148,F11SP
9,Janssenlei 17,2022-05-05,08:00:00,464,332,132,F11SP
9,Janssenlei 17,2022-05-05,09:00:00,314,92,222,F11SP
9,Janssenlei 17,2022-05-05,10:00:00,140,64,76,F11SP
9,Janssenlei 17,2022-05-05,11:00:00,152,90,62,F11SP
9,Janssenlei 17,2022-05-05,12:00:00,136,76,60,F11SP
9,Janssenlei 17,2022-05-05,13:00:00,236,102,134,F11SP
9,Janssenlei 17,2022-05-05,14:00:00,236,106,130,F11SP
9,Janssenlei 17,2022-05-05,15:00:00,294,106,188,F11SP
9,Janssenlei 17,2022-05-05,16:00:00,624,316,308,F11SP
9,Janssenlei 17,2022-05-05,17:00:00,452,140,312,F11SP
9,Janssenlei 17,2022-05-05,18:00:00,312,122,190,F11SP
9,Janssenlei 17,2022-05-05,19:00:00,194,84,110,F11SP
9,Janssenlei 17,2022-05-05,20:00:00,168,124,44,F11SP
9,Janssenlei 17,2022-05-05,21:00:00,48,26,22,F11SP
9,Janssenlei 17,2022-05-05,22:00:00,50,10,40,F11SP
9,Janssenlei 17,2022-05-05,23:00:00,40,10,30,F11SP
9,Janssenlei 17,2022-05-06,00:00:00,8,2,6,F11SP
9,Janssenlei 17,2022-05-06,01:00:00,2,2,0,F11SP
9,Janssenlei 17,2022-05-06,02:00:00,4,2,2,F11SP
9,Janssenlei 17,2022-05-06,03:00:00,2,2,0,F11SP
9,Janssenlei 17,2022-05-06,04:00:00,10,10,0,F11SP
9,Janssenlei 17,2022-05-06,05:00:00,62,46,16,F11SP
9,Janssenlei 17,2022-05-06,06:00:00,96,64,32,F11SP
9,Janssenlei 17,2022-05-06,07:00:00,388,250,138,F11SP
9,Janssenlei 17,2022-05-06,08:00:00,414,282,132,F11SP
9,Janssenlei 17,2022-05-06,09:00:00,268,92,176,F11SP
9,Janssenlei 17,2022-05-06,10:00:00,116,56,60,F11SP
9,Janssenlei 17,2022-05-06,11:00:00,134,66,68,F11SP
9,Janssenlei 17,2022-05-06,12:00:00,218,106,112,F11SP
9,Janssenlei 17,2022-05-06,13:00:00,216,92,124,F11SP
9,Janssenlei 17,2022-05-06,14:00:00,264,116,148,F11SP
9,Janssenlei 17,2022-05-06,15:00:00,512,292,220,F11SP
9,Janssenlei 17,2022-05-06,16:00:00,474,192,282,F11SP
9,Janssenlei 17,2022-05-06,17:00:00,356,140,216,F11SP
9,Janssenlei 17,2022-05-06,18:00:00,296,142,154,F11SP
9,Janssenlei 17,2022-05-06,19:00:00,168,66,102,F11SP
9,Janssenlei 17,2022-05-06,20:00:00,116,62,54,F11SP
9,Janssenlei 17,2022-05-06,21:00:00,134,76,58,F11SP
9,Janssenlei 17,2022-05-06,22:00:00,66,18,48,F11SP
9,Janssenlei 17,2022-05-06,23:00:00,26,14,12,F11SP
9,Janssenlei 17,2022-05-07,00:00:00,32,10,22,F11SP
9,Janssenlei 17,2022-05-07,01:00:00,34,14,20,F11SP
9,Janssenlei 17,2022-05-07,02:00:00,16,8,8,F11SP
9,Janssenlei 17,2022-05-07,03:00:00,10,2,8,F11SP
9,Janssenlei 17,2022-05-07,04:00:00,14,4,10,F11SP
9,Janssenlei 17,2022-05-07,05:00:00,24,12,12,F11SP
9,Janssenlei 17,2022-05-07,06:00:00,20,10,10,F11SP
9,Janssenlei 17,2022-05-07,07:00:00,56,34,22,F11SP
9,Janssenlei 17,2022-05-07,08:00:00,102,64,38,F11SP
9,Janssenlei 17,2022-05-07,09:00:00,124,52,72,F11SP
9,Janssenlei 17,2022-05-07,10:00:00,176,72,104,F11SP
9,Janssenlei 17,2022-05-07,11:00:00,184,86,98,F11SP
9,Janssenlei 17,2022-05-07,12:00:00,220,108,112,F11SP
9,Janssenlei 17,2022-05-07,13:00:00,214,100,114,F11SP
9,Janssenlei 17,2022-05-07,14:00:00,276,142,134,F11SP
9,Janssenlei 17,2022-05-07,15:00:00,330,164,166,F11SP
9,Janssenlei 17,2022-05-07,16:00:00,264,150,114,F11SP
9,Janssenlei 17,2022-05-07,17:00:00,260,132,128,F11SP
9,Janssenlei 17,2022-05-07,18:00:00,156,86,70,F11SP
9,Janssenlei 17,2022-05-07,19:00:00,90,52,38,F11SP
9,Janssenlei 17,2022-05-07,20:00:00,92,46,46,F11SP
9,Janssenlei 17,2022-05-07,21:00:00,74,22,52,F11SP
9,Janssenlei 17,2022-05-07,22:00:00,34,10,24,F11SP
9,Janssenlei 17,2022-05-07,23:00:00,46,24,22,F11SP
9,Janssenlei 17,2022-05-08,00:00:00,30,10,20,F11SP
9,Janssenlei 17,2022-05-08,01:00:00,30,14,16,F11SP
9,Janssenlei 17,2022-05-08,02:00:00,14,12,2,F11SP
9,Janssenlei 17,2022-05-08,03:00:00,14,12,2,F11SP
9,Janssenlei 17,2022-05-08,04:00:00,8,2,6,F11SP
9,Janssenlei 17,2022-05-08,05:00:00,24,20,4,F11SP
9,Janssenlei 17,2022-05-08,06:00:00,32,18,14,F11SP
9,Janssenlei 17,2022-05-08,07:00:00,46,22,24,F11SP
9,Janssenlei 17,2022-05-08,08:00:00,104,50,54,F11SP
9,Janssenlei 17,2022-05-08,09:00:00,232,82,150,F11SP
9,Janssenlei 17,2022-05-08,10:00:00,366,104,262,F11SP
9,Janssenlei 17,2022-05-08,11:00:00,340,166,174,F11SP
9,Janssenlei 17,2022-05-08,12:00:00,374,236,138,F11SP
9,Janssenlei 17,2022-05-08,13:00:00,394,196,198,F11SP
9,Janssenlei 17,2022-05-08,14:00:00,500,168,332,F11SP
9,Janssenlei 17,2022-05-08,15:00:00,396,176,220,F11SP
9,Janssenlei 17,2022-05-08,16:00:00,396,190,206,F11SP
9,Janssenlei 17,2022-05-08,17:00:00,272,168,104,F11SP
9,Janssenlei 17,2022-05-08,18:00:00,182,130,52,F11SP
9,Janssenlei 17,2022-05-08,19:00:00,160,104,56,F11SP
9,Janssenlei 17,2022-05-08,20:00:00,74,54,20,F11SP
9,Janssenlei 17,2022-05-08,21:00:00,64,30,34,F11SP
9,Janssenlei 17,2022-05-08,22:00:00,26,14,12,F11SP
9,Janssenlei 17,2022-05-08,23:00:00,16,8,8,F11SP
9,Janssenlei 17,2022-05-09,00:00:00,0,0,0,F11SP
9,Janssenlei 17,2022-05-09,01:00:00,2,0,2,F11SP
9,Janssenlei 17,2022-05-09,02:00:00,0,0,0,F11SP
9,Janssenlei 17,2022-05-09,03:00:00,0,0,0,F11SP
9,Janssenlei 17,2022-05-09,04:00:00,14,14,0,F11SP
9,Janssenlei 17,2022-05-09,05:00:00,48,40,8,F11SP
9,Janssenlei 17,2022-05-09,06:00:00,164,116,48,F11SP
9,Janssenlei 17,2022-05-09,07:00:00,472,312,160,F11SP
9,Janssenlei 17,2022-05-09,08:00:00,560,388,172,F11SP
9,Janssenlei 17,2022-05-09,09:00:00,172,104,68,F11SP
9,Janssenlei 17,2022-05-09,10:00:00,152,58,94,F11SP
9,Janssenlei 17,2022-05-09,11:00:00,138,70,68,F11SP
9,Janssenlei 17,2022-05-09,12:00:00,198,86,112,F11SP
9,Janssenlei 17,2022-05-09,13:00:00,268,134,134,F11SP
9,Janssenlei 17,2022-05-09,14:00:00,268,114,154,F11SP
9,Janssenlei 17,2022-05-09,15:00:00,340,114,226,F11SP
9,Janssenlei 17,2022-05-09,16:00:00,642,250,392,F11SP
9,Janssenlei 17,2022-05-09,17:00:00,500,156,344,F11SP
9,Janssenlei 17,2022-05-09,18:00:00,336,148,188,F11SP
9,Janssenlei 17,2022-05-09,19:00:00,216,106,110,F11SP
9,Janssenlei 17,2022-05-09,20:00:00,158,90,68,F11SP
9,Janssenlei 17,2022-05-09,21:00:00,76,38,38,F11SP
9,Janssenlei 17,2022-05-09,22:00:00,80,34,46,F11SP
9,Janssenlei 17,2022-05-09,23:00:00,18,0,18,F11SP
9,Janssenlei 17,2022-05-10,00:00:00,4,2,2,F11SP
9,Janssenlei 17,2022-05-10,01:00:00,0,0,0,F11SP
9,Janssenlei 17,2022-05-10,02:00:00,0,0,0,F11SP
9,Janssenlei 17,2022-05-10,03:00:00,0,0,0,F11SP
9,Janssenlei 17,2022-05-10,04:00:00,10,10,0,F11SP
9,Janssenlei 17,2022-05-10,05:00:00,76,58,18,F11SP
9,Janssenlei 17,2022-05-10,06:00:00,190,134,56,F11SP
9,Janssenlei 17,2022-05-10,07:00:00,512,340,172,F11SP
9,Janssenlei 17,2022-05-10,08:00:00,532,376,156,F11SP
9,Janssenlei 17,2022-05-10,09:00:00,174,92,82,F11SP
9,Janssenlei 17,2022-05-10,10:00:00,150,66,84,F11SP
9,Janssenlei 17,2022-05-10,11:00:00,162,76,86,F11SP
9,Janssenlei 17,2022-05-10,12:00:00,164,100,64,F11SP
9,Janssenlei 17,2022-05-10,13:00:00,216,126,90,F11SP
9,Janssenlei 17,2022-05-10,14:00:00,186,94,92,F11SP
9,Janssenlei 17,2022-05-10,15:00:00,352,132,220,F11SP
9,Janssenlei 17,2022-05-10,16:00:00,582,218,364,F11SP
9,Janssenlei 17,2022-05-10,17:00:00,468,128,340,F11SP
9,Janssenlei 17,2022-05-10,18:00:00,322,124,198,F11SP
9,Janssenlei 17,2022-05-10,19:00:00,252,134,118,F11SP
9,Janssenlei 17,2022-05-10,20:00:00,196,142,54,F11SP
9,Janssenlei 17,2022-05-10,21:00:00,78,50,28,F11SP
9,Janssenlei 17,2022-05-10,22:00:00,82,20,62,F11SP
9,Janssenlei 17,2022-05-10,23:00:00,10,4,6,F11SP
9,Janssenlei 17,2022-05-11,00:00:00,12,2,10,F11SP
9,Janssenlei 17,2022-05-11,01:00:00,12,2,10,F11SP
9,Janssenlei 17,2022-05-11,02:00:00,2,0,2,F11SP
9,Janssenlei 17,2022-05-11,03:00:00,2,0,2,F11SP
9,Janssenlei 17,2022-05-11,04:00:00,14,14,0,F11SP
9,Janssenlei 17,2022-05-11,05:00:00,58,44,14,F11SP
9,Janssenlei 17,2022-05-11,06:00:00,154,104,50,F11SP
9,Janssenlei 17,2022-05-11,07:00:00,458,292,166,F11SP
9,Janssenlei 17,2022-05-11,08:00:00,512,342,170,F11SP
9,Janssenlei 17,2022-05-11,09:00:00,182,96,86,F11SP
9,Janssenlei 17,2022-05-11,10:00:00,232,114,118,F11SP
9,Janssenlei 17,2022-05-11,11:00:00,214,116,98,F11SP
9,Janssenlei 17,2022-05-11,12:00:00,476,158,318,F11SP
9,Janssenlei 17,2022-05-11,13:00:00,282,130,152,F11SP
9,Janssenlei 17,2022-05-11,14:00:00,262,114,148,F11SP
9,Janssenlei 17,2022-05-11,15:00:00,258,128,130,F11SP
9,Janssenlei 17,2022-05-11,16:00:00,400,168,232,F11SP
9,Janssenlei 17,2022-05-11,17:00:00,420,168,252,F11SP
9,Janssenlei 17,2022-05-11,18:00:00,440,156,284,F11SP
9,Janssenlei 17,2022-05-11,19:00:00,332,124,208,F11SP
9,Janssenlei 17,2022-05-11,20:00:00,188,138,50,F11SP
9,Janssenlei 17,2022-05-11,21:00:00,120,82,38,F11SP
9,Janssenlei 17,2022-05-11,22:00:00,90,22,68,F11SP
9,Janssenlei 17,2022-05-11,23:00:00,34,14,20,F11SP
9,Janssenlei 17,2022-05-12,00:00:00,12,4,8,F11SP
9,Janssenlei 17,2022-05-12,01:00:00,2,0,2,F11SP
9,Janssenlei 17,2022-05-12,02:00:00,0,0,0,F11SP
9,Janssenlei 17,2022-05-12,03:00:00,4,2,2,F11SP
9,Janssenlei 17,2022-05-12,04:00:00,12,10,2,F11SP
9,Janssenlei 17,2022-05-12,05:00:00,64,40,24,F11SP
9,Janssenlei 17,2022-05-12,06:00:00,168,120,48,F11SP
9,Janssenlei 17,2022-05-12,07:00:00,460,324,136,F11SP
9,Janssenlei 17,2022-05-12,08:00:00,510,358,152,F11SP
9,Janssenlei 17,2022-05-12,09:00:00,204,106,98,F11SP
9,Janssenlei 17,2022-05-12,10:00:00,154,74,80,F11SP
9,Janssenlei 17,2022-05-12,11:00:00,200,116,84,F11SP
9,Janssenlei 17,2022-05-12,12:00:00,182,104,78,F11SP
9,Janssenlei 17,2022-05-12,13:00:00,208,90,118,F11SP
9,Janssenlei 17,2022-05-12,14:00:00,220,84,136,F11SP
9,Janssenlei 17,2022-05-12,15:00:00,356,152,204,F11SP
9,Janssenlei 17,2022-05-12,16:00:00,634,242,392,F11SP
9,Janssenlei 17,2022-05-12,17:00:00,472,172,300,F11SP
9,Janssenlei 17,2022-05-12,18:00:00,300,106,194,F11SP
9,Janssenlei 17,2022-05-12,19:00:00,244,120,124,F11SP
9,Janssenlei 17,2022-05-12,20:00:00,268,204,64,F11SP
9,Janssenlei 17,2022-05-12,21:00:00,92,48,44,F11SP
9,Janssenlei 17,2022-05-12,22:00:00,72,28,44,F11SP
9,Janssenlei 17,2022-05-12,23:00:00,40,18,22,F11SP
9,Janssenlei 17,2022-05-13,00:00:00,12,2,10,F11SP
9,Janssenlei 17,2022-05-13,01:00:00,2,0,2,F11SP
9,Janssenlei 17,2022-05-13,02:00:00,0,0,0,F11SP
9,Janssenlei 17,2022-05-13,03:00:00,0,0,0,F11SP
9,Janssenlei 17,2022-05-13,04:00:00,12,12,0,F11SP
9,Janssenlei 17,2022-05-13,05:00:00,52,38,14,F11SP
9,Janssenlei 17,2022-05-13,06:00:00,130,84,46,F11SP
9,Janssenlei 17,2022-05-13,07:00:00,400,256,144,F11SP
9,Janssenlei 17,2022-05-13,08:00:00,532,280,252,F11SP
9,Janssenlei 17,2022-05-13,09:00:00,160,80,80,F11SP
9,Janssenlei 17,2022-05-13,10:00:00,122,64,58,F11SP
9,Janssenlei 17,2022-05-13,11:00:00,168,90,78,F11SP
9,Janssenlei 17,2022-05-13,12:00:00,166,78,88,F11SP
9,Janssenlei 17,2022-05-13,13:00:00,186,76,110,F11SP
9,Janssenlei 17,2022-05-13,14:00:00,260,128,132,F11SP
9,Janssenlei 17,2022-05-13,15:00:00,360,140,220,F11SP
9,Janssenlei 17,2022-05-13,16:00:00,450,182,268,F11SP
9,Janssenlei 17,2022-05-13,17:00:00,362,184,178,F11SP
9,Janssenlei 17,2022-05-13,18:00:00,294,120,174,F11SP
9,Janssenlei 17,2022-05-13,19:00:00,196,110,86,F11SP
9,Janssenlei 17,2022-05-13,20:00:00,128,76,52,F11SP
9,Janssenlei 17,2022-05-13,21:00:00,104,40,64,F11SP
9,Janssenlei 17,2022-05-13,22:00:00,78,24,54,F11SP
9,Janssenlei 17,2022-05-13,23:00:00,32,8,24,F11SP
9,Janssenlei 17,2022-05-14,00:00:00,26,4,22,F11SP
9,Janssenlei 17,2022-05-14,01:00:00,16,6,10,F11SP
9,Janssenlei 17,2022-05-14,02:00:00,18,4,14,F11SP
9,Janssenlei 17,2022-05-14,03:00:00,16,10,6,F11SP
9,Janssenlei 17,2022-05-14,04:00:00,12,8,4,F11SP
9,Janssenlei 17,2022-05-14,05:00:00,18,12,6,F11SP
9,Janssenlei 17,2022-05-14,06:00:00,46,16,30,F11SP
9,Janssenlei 17,2022-05-14,07:00:00,38,18,20,F11SP
9,Janssenlei 17,2022-05-14,08:00:00,110,44,66,F11SP
9,Janssenlei 17,2022-05-14,09:00:00,140,72,68,F11SP
9,Janssenlei 17,2022-05-14,10:00:00,282,116,166,F11SP
9,Janssenlei 17,2022-05-14,11:00:00,336,192,144,F11SP
9,Janssenlei 17,2022-05-14,12:00:00,298,152,146,F11SP
9,Janssenlei 17,2022-05-14,13:00:00,362,152,210,F11SP
9,Janssenlei 17,2022-05-14,14:00:00,394,166,228,F11SP
9,Janssenlei 17,2022-05-14,15:00:00,390,158,232,F11SP
9,Janssenlei 17,2022-05-14,16:00:00,348,208,140,F11SP
9,Janssenlei 17,2022-05-14,17:00:00,266,160,106,F11SP
9,Janssenlei 17,2022-05-14,18:00:00,226,140,86,F11SP
9,Janssenlei 17,2022-05-14,19:00:00,116,76,40,F11SP
9,Janssenlei 17,2022-05-14,20:00:00,148,72,76,F11SP
9,Janssenlei 17,2022-05-14,21:00:00,100,38,62,F11SP
9,Janssenlei 17,2022-05-14,22:00:00,46,26,20,F11SP
9,Janssenlei 17,2022-05-14,23:00:00,34,16,18,F11SP
9,Janssenlei 17,2022-05-15,00:00:00,24,8,16,F11SP
9,Janssenlei 17,2022-05-15,01:00:00,10,6,4,F11SP
9,Janssenlei 17,2022-05-15,02:00:00,12,6,6,F11SP
9,Janssenlei 17,2022-05-15,03:00:00,6,4,2,F11SP
9,Janssenlei 17,2022-05-15,04:00:00,8,2,6,F11SP
9,Janssenlei 17,2022-05-15,05:00:00,18,14,4,F11SP
9,Janssenlei 17,2022-05-15,06:00:00,28,8,20,F11SP
9,Janssenlei 17,2022-05-15,07:00:00,52,20,32,F11SP
9,Janssenlei 17,2022-05-15,08:00:00,106,46,60,F11SP
9,Janssenlei 17,2022-05-15,09:00:00,322,102,220,F11SP
9,Janssenlei 17,2022-05-15,10:00:00,414,162,252,F11SP
9,Janssenlei 17,2022-05-15,11:00:00,406,210,196,F11SP
9,Janssenlei 17,2022-05-15,12:00:00,372,188,184,F11SP
9,Janssenlei 17,2022-05-15,13:00:00,462,228,234,F11SP
9,Janssenlei 17,2022-05-15,14:00:00,516,204,312,F11SP
9,Janssenlei 17,2022-05-15,15:00:00,388,184,204,F11SP
9,Janssenlei 17,2022-05-15,16:00:00,370,208,162,F11SP
9,Janssenlei 17,2022-05-15,17:00:00,324,192,132,F11SP
9,Janssenlei 17,2022-05-15,18:00:00,242,106,136,F11SP
9,Janssenlei 17,2022-05-15,19:00:00,206,134,72,F11SP
9,Janssenlei 17,2022-05-15,20:00:00,134,84,50,F11SP
9,Janssenlei 17,2022-05-15,21:00:00,98,54,44,F11SP
9,Janssenlei 17,2022-05-15,22:00:00,48,24,24,F11SP
9,Janssenlei 17,2022-05-15,23:00:00,12,10,2,F11SP
9,Janssenlei 17,2022-05-16,00:00:00,16,6,10,F11SP
9,Janssenlei 17,2022-05-16,01:00:00,4,0,4,F11SP
9,Janssenlei 17,2022-05-16,02:00:00,6,0,6,F11SP
9,Janssenlei 17,2022-05-16,03:00:00,2,2,0,F11SP
9,Janssenlei 17,2022-05-16,04:00:00,12,12,0,F11SP
9,Janssenlei 17,2022-05-16,05:00:00,60,44,16,F11SP
9,Janssenlei 17,2022-05-16,06:00:00,132,98,34,F11SP
9,Janssenlei 17,2022-05-16,07:00:00,424,266,158,F11SP
9,Janssenlei 17,2022-05-16,08:00:00,520,350,170,F11SP
9,Janssenlei 17,2022-05-16,09:00:00,136,76,60,F11SP
9,Janssenlei 17,2022-05-16,10:00:00,110,64,46,F11SP
9,Janssenlei 17,2022-05-16,11:00:00,136,78,58,F11SP
9,Janssenlei 17,2022-05-16,12:00:00,144,82,62,F11SP
9,Janssenlei 17,2022-05-16,13:00:00,142,70,72,F11SP
9,Janssenlei 17,2022-05-16,14:00:00,174,70,104,F11SP
9,Janssenlei 17,2022-05-16,15:00:00,350,124,226,F11SP
9,Janssenlei 17,2022-05-16,16:00:00,508,182,326,F11SP
9,Janssenlei 17,2022-05-16,17:00:00,400,148,252,F11SP
9,Janssenlei 17,2022-05-16,18:00:00,296,114,182,F11SP
9,Janssenlei 17,2022-05-16,19:00:00,154,72,82,F11SP
9,Janssenlei 17,2022-05-16,20:00:00,142,66,76,F11SP
9,Janssenlei 17,2022-05-16,21:00:00,84,40,44,F11SP
9,Janssenlei 17,2022-05-16,22:00:00,78,28,50,F11SP
9,Janssenlei 17,2022-05-16,23:00:00,16,4,12,F11SP
9,Janssenlei 17,2022-05-17,00:00:00,10,0,10,F11SP
9,Janssenlei 17,2022-05-17,01:00:00,8,2,6,F11SP
9,Janssenlei 17,2022-05-17,02:00:00,2,0,2,F11SP
9,Janssenlei 17,2022-05-17,03:00:00,2,2,0,F11SP
9,Janssenlei 17,2022-05-17,04:00:00,12,10,2,F11SP
9,Janssenlei 17,2022-05-17,05:00:00,82,60,22,F11SP
9,Janssenlei 17,2022-05-17,06:00:00,148,96,52,F11SP
9,Janssenlei 17,2022-05-17,07:00:00,464,306,158,F11SP
9,Janssenlei 17,2022-05-17,08:00:00,506,378,128,F11SP
9,Janssenlei 17,2022-05-17,09:00:00,118,70,48,F11SP
9,Janssenlei 17,2022-05-17,10:00:00,96,56,40,F11SP
9,Janssenlei 17,2022-05-17,11:00:00,130,48,82,F11SP
9,Janssenlei 17,2022-05-17,12:00:00,178,104,74,F11SP
9,Janssenlei 17,2022-05-17,13:00:00,192,92,100,F11SP
9,Janssenlei 17,2022-05-17,14:00:00,226,104,122,F11SP
9,Janssenlei 17,2022-05-17,15:00:00,356,132,224,F11SP
9,Janssenlei 17,2022-05-17,16:00:00,526,198,328,F11SP
9,Janssenlei 17,2022-05-17,17:00:00,530,174,356,F11SP
9,Janssenlei 17,2022-05-17,18:00:00,384,136,248,F11SP
9,Janssenlei 17,2022-05-17,19:00:00,300,146,154,F11SP
9,Janssenlei 17,2022-05-17,20:00:00,262,176,86,F11SP
9,Janssenlei 17,2022-05-17,21:00:00,110,70,40,F11SP
9,Janssenlei 17,2022-05-17,22:00:00,104,28,76,F11SP
9,Janssenlei 17,2022-05-17,23:00:00,16,4,12,F11SP
9,Janssenlei 17,2022-05-18,00:00:00,14,0,14,F11SP
9,Janssenlei 17,2022-05-18,01:00:00,6,2,4,F11SP
9,Janssenlei 17,2022-05-18,02:00:00,4,2,2,F11SP
9,Janssenlei 17,2022-05-18,03:00:00,2,2,0,F11SP
9,Janssenlei 17,2022-05-18,04:00:00,16,12,4,F11SP
9,Janssenlei 17,2022-05-18,05:00:00,74,54,20,F11SP
9,Janssenlei 17,2022-05-18,06:00:00,156,98,58,F11SP
9,Janssenlei 17,2022-05-18,07:00:00,434,276,158,F11SP
9,Janssenlei 17,2022-05-18,08:00:00,544,382,162,F11SP
9,Janssenlei 17,2022-05-18,09:00:00,202,110,92,F11SP
9,Janssenlei 17,2022-05-18,10:00:00,198,110,88,F11SP
9,Janssenlei 17,2022-05-18,11:00:00,254,130,124,F11SP
9,Janssenlei 17,2022-05-18,12:00:00,484,200,284,F11SP
9,Janssenlei 17,2022-05-18,13:00:00,320,132,188,F11SP
9,Janssenlei 17,2022-05-18,14:00:00,300,142,158,F11SP
9,Janssenlei 17,2022-05-18,15:00:00,348,140,208,F11SP
9,Janssenlei 17,2022-05-18,16:00:00,398,170,228,F11SP
9,Janssenlei 17,2022-05-18,17:00:00,446,168,278,F11SP
9,Janssenlei 17,2022-05-18,18:00:00,454,162,292,F11SP
9,Janssenlei 17,2022-05-18,19:00:00,324,156,168,F11SP
9,Janssenlei 17,2022-05-18,20:00:00,258,176,82,F11SP
9,Janssenlei 17,2022-05-18,21:00:00,164,106,58,F11SP
9,Janssenlei 17,2022-05-18,22:00:00,102,24,78,F11SP
9,Janssenlei 17,2022-05-18,23:00:00,32,12,20,F11SP
9,Janssenlei 17,2022-05-19,00:00:00,18,8,10,F11SP
9,Janssenlei 17,2022-05-19,01:00:00,8,2,6,F11SP
9,Janssenlei 17,2022-05-19,02:00:00,2,2,0,F11SP
9,Janssenlei 17,2022-05-19,03:00:00,2,0,2,F11SP
9,Janssenlei 17,2022-05-19,04:00:00,12,12,0,F11SP
9,Janssenlei 17,2022-05-19,05:00:00,44,34,10,F11SP
9,Janssenlei 17,2022-05-19,06:00:00,62,38,24,F11SP
9,Janssenlei 17,2022-05-19,07:00:00,286,186,100,F11SP
9,Janssenlei 17,2022-05-19,08:00:00,468,330,138,F11SP
9,Janssenlei 17,2022-05-19,09:00:00,136,70,66,F11SP
9,Janssenlei 17,2022-05-19,10:00:00,112,56,56,F11SP
9,Janssenlei 17,2022-05-19,11:00:00,124,46,78,F11SP
9,Janssenlei 17,2022-05-19,12:00:00,108,70,38,F11SP
9,Janssenlei 17,2022-05-19,13:00:00,66,38,28,F11SP
9,Janssenlei 17,2022-05-19,14:00:00,96,36,60,F11SP
9,Janssenlei 17,2022-05-19,15:00:00,166,64,102,F11SP
9,Janssenlei 17,2022-05-19,16:00:00,328,114,214,F11SP
9,Janssenlei 17,2022-05-19,17:00:00,286,96,190,F11SP
9,Janssenlei 17,2022-05-19,18:00:00,212,78,134,F11SP
9,Janssenlei 17,2022-05-19,19:00:00,148,50,98,F11SP
9,Janssenlei 17,2022-05-19,20:00:00,210,152,58,F11SP
9,Janssenlei 17,2022-05-19,21:00:00,124,88,36,F11SP
9,Janssenlei 17,2022-05-19,22:00:00,44,16,28,F11SP
9,Janssenlei 17,2022-05-19,23:00:00,12,2,10,F11SP
9,Janssenlei 17,2022-05-20,00:00:00,2,0,2,F11SP
9,Janssenlei 17,2022-05-20,01:00:00,2,0,2,F11SP
9,Janssenlei 17,2022-05-20,02:00:00,4,0,4,F11SP
9,Janssenlei 17,2022-05-20,03:00:00,2,0,2,F11SP
9,Janssenlei 17,2022-05-20,04:00:00,6,6,0,F11SP
9,Janssenlei 17,2022-05-20,05:00:00,48,30,18,F11SP
9,Janssenlei 17,2022-05-20,06:00:00,90,60,30,F11SP
9,Janssenlei 17,2022-05-20,07:00:00,282,186,96,F11SP
9,Janssenlei 17,2022-05-20,08:00:00,340,216,124,F11SP
9,Janssenlei 17,2022-05-20,09:00:00,250,74,176,F11SP
9,Janssenlei 17,2022-05-20,10:00:00,116,52,64,F11SP
9,Janssenlei 17,2022-05-20,11:00:00,86,48,38,F11SP
9,Janssenlei 17,2022-05-20,12:00:00,90,38,52,F11SP
9,Janssenlei 17,2022-05-20,13:00:00,60,22,38,F11SP
9,Janssenlei 17,2022-05-20,14:00:00,180,136,44,F11SP
9,Janssenlei 17,2022-05-20,15:00:00,142,46,96,F11SP
9,Janssenlei 17,2022-05-20,16:00:00,268,94,174,F11SP
9,Janssenlei 17,2022-05-20,17:00:00,222,76,146,F11SP
9,Janssenlei 17,2022-05-20,18:00:00,122,36,86,F11SP
9,Janssenlei 17,2022-05-20,19:00:00,82,34,48,F11SP
9,Janssenlei 17,2022-05-20,20:00:00,76,26,50,F11SP
9,Janssenlei 17,2022-05-20,21:00:00,36,14,22,F11SP
9,Janssenlei 17,2022-05-20,22:00:00,42,22,20,F11SP
9,Janssenlei 17,2022-05-20,23:00:00,32,18,14,F11SP
9,Janssenlei 17,2022-05-21,00:00:00,14,10,4,F11SP
9,Janssenlei 17,2022-05-21,01:00:00,8,0,8,F11SP
9,Janssenlei 17,2022-05-21,02:00:00,14,14,0,F11SP
9,Janssenlei 17,2022-05-21,03:00:00,8,0,8,F11SP
9,Janssenlei 17,2022-05-21,04:00:00,2,2,0,F11SP
9,Janssenlei 17,2022-05-21,05:00:00,8,4,4,F11SP
9,Janssenlei 17,2022-05-21,06:00:00,16,10,6,F11SP
9,Janssenlei 17,2022-05-21,07:00:00,32,10,22,F11SP
9,Janssenlei 17,2022-05-21,08:00:00,108,62,46,F11SP
9,Janssenlei 17,2022-05-21,09:00:00,202,104,98,F11SP
9,Janssenlei 17,2022-05-21,10:00:00,174,72,102,F11SP
9,Janssenlei 17,2022-05-21,11:00:00,200,94,106,F11SP
9,Janssenlei 17,2022-05-21,12:00:00,208,136,72,F11SP
9,Janssenlei 17,2022-05-21,13:00:00,222,114,108,F11SP
9,Janssenlei 17,2022-05-21,14:00:00,274,128,146,F11SP
9,Janssenlei 17,2022-05-21,15:00:00,284,144,140,F11SP
9,Janssenlei 17,2022-05-21,16:00:00,212,122,90,F11SP
9,Janssenlei 17,2022-05-21,17:00:00,214,128,86,F11SP
9,Janssenlei 17,2022-05-21,18:00:00,158,76,82,F11SP
9,Janssenlei 17,2022-05-21,19:00:00,102,44,58,F11SP
9,Janssenlei 17,2022-05-21,20:00:00,110,62,48,F11SP
9,Janssenlei 17,2022-05-21,21:00:00,82,42,40,F11SP
9,Janssenlei 17,2022-05-21,22:00:00,62,22,40,F11SP
9,Janssenlei 17,2022-05-21,23:00:00,38,14,24,F11SP
9,Janssenlei 17,2022-05-22,00:00:00,34,22,12,F11SP
9,Janssenlei 17,2022-05-22,01:00:00,42,18,24,F11SP
9,Janssenlei 17,2022-05-22,02:00:00,10,4,6,F11SP
9,Janssenlei 17,2022-05-22,03:00:00,18,4,14,F11SP
9,Janssenlei 17,2022-05-22,04:00:00,8,4,4,F11SP
9,Janssenlei 17,2022-05-22,05:00:00,8,4,4,F11SP
9,Janssenlei 17,2022-05-22,06:00:00,24,16,8,F11SP
9,Janssenlei 17,2022-05-22,07:00:00,38,16,22,F11SP
9,Janssenlei 17,2022-05-22,08:00:00,140,44,96,F11SP
9,Janssenlei 17,2022-05-22,09:00:00,266,96,170,F11SP
9,Janssenlei 17,2022-05-22,10:00:00,404,114,290,F11SP
9,Janssenlei 17,2022-05-22,11:00:00,386,192,194,F11SP
9,Janssenlei 17,2022-05-22,12:00:00,472,238,234,F11SP
9,Janssenlei 17,2022-05-22,13:00:00,488,226,262,F11SP
9,Janssenlei 17,2022-05-22,14:00:00,538,210,328,F11SP
9,Janssenlei 17,2022-05-22,15:00:00,496,290,206,F11SP
9,Janssenlei 17,2022-05-22,16:00:00,478,254,224,F11SP
9,Janssenlei 17,2022-05-22,17:00:00,408,252,156,F11SP
9,Janssenlei 17,2022-05-22,18:00:00,262,128,134,F11SP
9,Janssenlei 17,2022-05-22,19:00:00,176,104,72,F11SP
9,Janssenlei 17,2022-05-22,20:00:00,124,76,48,F11SP
9,Janssenlei 17,2022-05-22,21:00:00,58,44,14,F11SP
9,Janssenlei 17,2022-05-22,22:00:00,44,12,32,F11SP
9,Janssenlei 17,2022-05-22,23:00:00,18,10,8,F11SP
9,Janssenlei 17,2022-05-23,00:00:00,4,2,2,F11SP
9,Janssenlei 17,2022-05-23,01:00:00,0,0,0,F11SP
9,Janssenlei 17,2022-05-23,02:00:00,0,0,0,F11SP
9,Janssenlei 17,2022-05-23,03:00:00,2,2,0,F11SP
9,Janssenlei 17,2022-05-23,04:00:00,12,10,2,F11SP
9,Janssenlei 17,2022-05-23,05:00:00,48,38,10,F11SP
9,Janssenlei 17,2022-05-23,06:00:00,118,88,30,F11SP
9,Janssenlei 17,2022-05-23,07:00:00,364,234,130,F11SP
9,Janssenlei 17,2022-05-23,08:00:00,388,280,108,F11SP
9,Janssenlei 17,2022-05-23,09:00:00,84,58,26,F11SP
9,Janssenlei 17,2022-05-23,10:00:00,62,26,36,F11SP
9,Janssenlei 17,2022-05-23,11:00:00,118,58,60,F11SP
9,Janssenlei 17,2022-05-23,12:00:00,144,66,78,F11SP
9,Janssenlei 17,2022-05-23,13:00:00,102,50,52,F11SP
9,Janssenlei 17,2022-05-23,14:00:00,74,24,50,F11SP
9,Janssenlei 17,2022-05-23,15:00:00,196,60,136,F11SP
9,Janssenlei 17,2022-05-23,16:00:00,328,106,222,F11SP
9,Janssenlei 17,2022-05-23,17:00:00,282,72,210,F11SP
9,Janssenlei 17,2022-05-23,18:00:00,138,44,94,F11SP
9,Janssenlei 17,2022-05-23,19:00:00,72,28,44,F11SP
9,Janssenlei 17,2022-05-23,20:00:00,52,22,30,F11SP
9,Janssenlei 17,2022-05-23,21:00:00,24,8,16,F11SP
9,Janssenlei 17,2022-05-23,22:00:00,40,18,22,F11SP
9,Janssenlei 17,2022-05-23,23:00:00,8,2,6,F11SP
9,Janssenlei 17,2022-05-24,00:00:00,2,2,0,F11SP
9,Janssenlei 17,2022-05-24,01:00:00,6,0,6,F11SP
9,Janssenlei 17,2022-05-24,02:00:00,2,2,0,F11SP
9,Janssenlei 17,2022-05-24,03:00:00,0,0,0,F11SP
9,Janssenlei 17,2022-05-24,04:00:00,6,6,0,F11SP
9,Janssenlei 17,2022-05-24,05:00:00,58,42,16,F11SP
9,Janssenlei 17,2022-05-24,06:00:00,98,68,30,F11SP
9,Janssenlei 17,2022-05-24,07:00:00,382,254,128,F11SP
9,Janssenlei 17,2022-05-24,08:00:00,474,348,126,F11SP
9,Janssenlei 17,2022-05-24,09:00:00,124,70,54,F11SP
9,Janssenlei 17,2022-05-24,10:00:00,96,62,34,F11SP
9,Janssenlei 17,2022-05-24,11:00:00,128,50,78,F11SP
9,Janssenlei 17,2022-05-24,12:00:00,126,70,56,F11SP
9,Janssenlei 17,2022-05-24,13:00:00,122,50,72,F11SP
9,Janssenlei 17,2022-05-24,14:00:00,106,30,76,F11SP
9,Janssenlei 17,2022-05-24,15:00:00,180,74,106,F11SP
9,Janssenlei 17,2022-05-24,16:00:00,356,136,220,F11SP
9,Janssenlei 17,2022-05-24,17:00:00,350,106,244,F11SP
9,Janssenlei 17,2022-05-24,18:00:00,184,52,132,F11SP
9,Janssenlei 17,2022-05-24,19:00:00,98,48,50,F11SP
9,Janssenlei 17,2022-05-24,20:00:00,94,52,42,F11SP
9,Janssenlei 17,2022-05-24,21:00:00,74,46,28,F11SP
9,Janssenlei 17,2022-05-24,22:00:00,62,22,40,F11SP
9,Janssenlei 17,2022-05-24,23:00:00,16,2,14,F11SP
9,Janssenlei 17,2022-05-25,00:00:00,12,4,8,F11SP
9,Janssenlei 17,2022-05-25,01:00:00,14,10,4,F11SP
9,Janssenlei 17,2022-05-25,02:00:00,0,0,0,F11SP
9,Janssenlei 17,2022-05-25,03:00:00,2,2,0,F11SP
9,Janssenlei 17,2022-05-25,04:00:00,4,4,0,F11SP
9,Janssenlei 17,2022-05-25,05:00:00,58,40,18,F11SP
9,Janssenlei 17,2022-05-25,06:00:00,124,96,28,F11SP
9,Janssenlei 17,2022-05-25,07:00:00,356,204,152,F11SP
9,Janssenlei 17,2022-05-25,08:00:00,398,268,130,F11SP
9,Janssenlei 17,2022-05-25,09:00:00,188,120,68,F11SP
9,Janssenlei 17,2022-05-25,10:00:00,152,70,82,F11SP
9,Janssenlei 17,2022-05-25,11:00:00,166,86,80,F11SP
9,Janssenlei 17,2022-05-25,12:00:00,344,164,180,F11SP
9,Janssenlei 17,2022-05-25,13:00:00,238,124,114,F11SP
9,Janssenlei 17,2022-05-25,14:00:00,164,82,82,F11SP
9,Janssenlei 17,2022-05-25,15:00:00,206,84,122,F11SP
9,Janssenlei 17,2022-05-25,16:00:00,276,98,178,F11SP
9,Janssenlei 17,2022-05-25,17:00:00,320,134,186,F11SP
9,Janssenlei 17,2022-05-25,18:00:00,206,84,122,F11SP
9,Janssenlei 17,2022-05-25,19:00:00,146,48,98,F11SP
9,Janssenlei 17,2022-05-25,20:00:00,84,50,34,F11SP
9,Janssenlei 17,2022-05-25,21:00:00,60,48,12,F11SP
9,Janssenlei 17,2022-05-25,22:00:00,60,12,48,F11SP
9,Janssenlei 17,2022-05-25,23:00:00,36,10,26,F11SP
9,Janssenlei 17,2022-05-26,00:00:00,16,4,12,F11SP
9,Janssenlei 17,2022-05-26,01:00:00,34,14,20,F11SP
9,Janssenlei 17,2022-05-26,02:00:00,10,2,8,F11SP
9,Janssenlei 17,2022-05-26,03:00:00,14,10,4,F11SP
9,Janssenlei 17,2022-05-26,04:00:00,2,2,0,F11SP
9,Janssenlei 17,2022-05-26,05:00:00,24,16,8,F11SP
9,Janssenlei 17,2022-05-26,06:00:00,16,12,4,F11SP
9,Janssenlei 17,2022-05-26,07:00:00,24,8,16,F11SP
9,Janssenlei 17,2022-05-26,08:00:00,58,22,36,F11SP
9,Janssenlei 17,2022-05-26,09:00:00,178,66,112,F11SP
9,Janssenlei 17,2022-05-26,10:00:00,202,72,130,F11SP
9,Janssenlei 17,2022-05-26,11:00:00,218,112,106,F11SP
9,Janssenlei 17,2022-05-26,12:00:00,240,154,86,F11SP
9,Janssenlei 17,2022-05-26,13:00:00,312,156,156,F11SP
9,Janssenlei 17,2022-05-26,14:00:00,308,164,144,F11SP
9,Janssenlei 17,2022-05-26,15:00:00,370,188,182,F11SP
9,Janssenlei 17,2022-05-26,16:00:00,314,176,138,F11SP
9,Janssenlei 17,2022-05-26,17:00:00,342,152,190,F11SP
9,Janssenlei 17,2022-05-26,18:00:00,204,106,98,F11SP
9,Janssenlei 17,2022-05-26,19:00:00,208,126,82,F11SP
9,Janssenlei 17,2022-05-26,20:00:00,218,128,90,F11SP
9,Janssenlei 17,2022-05-26,21:00:00,110,58,52,F11SP
9,Janssenlei 17,2022-05-26,22:00:00,104,58,46,F11SP
9,Janssenlei 17,2022-05-26,23:00:00,84,14,70,F11SP
9,Janssenlei 17,2022-05-27,00:00:00,82,18,64,F11SP
9,Janssenlei 17,2022-05-27,01:00:00,36,4,32,F11SP
9,Janssenlei 17,2022-05-27,02:00:00,4,0,4,F11SP
9,Janssenlei 17,2022-05-27,03:00:00,10,2,8,F11SP
9,Janssenlei 17,2022-05-27,04:00:00,8,2,6,F11SP
9,Janssenlei 17,2022-05-27,05:00:00,26,16,10,F11SP
9,Janssenlei 17,2022-05-27,06:00:00,38,24,14,F11SP
9,Janssenlei 17,2022-05-27,07:00:00,62,34,28,F11SP
9,Janssenlei 17,2022-05-27,08:00:00,82,36,46,F11SP
9,Janssenlei 17,2022-05-27,09:00:00,104,60,44,F11SP
9,Janssenlei 17,2022-05-27,10:00:00,132,58,74,F11SP
9,Janssenlei 17,2022-05-27,11:00:00,172,72,100,F11SP
9,Janssenlei 17,2022-05-27,12:00:00,116,64,52,F11SP
9,Janssenlei 17,2022-05-27,13:00:00,150,78,72,F11SP
9,Janssenlei 17,2022-05-27,14:00:00,250,124,126,F11SP
9,Janssenlei 17,2022-05-27,15:00:00,260,110,150,F11SP
9,Janssenlei 17,2022-05-27,16:00:00,216,124,92,F11SP
9,Janssenlei 17,2022-05-27,17:00:00,236,126,110,F11SP
9,Janssenlei 17,2022-05-27,18:00:00,142,68,74,F11SP
9,Janssenlei 17,2022-05-27,19:00:00,116,66,50,F11SP
9,Janssenlei 17,2022-05-27,20:00:00,84,40,44,F11SP
9,Janssenlei 17,2022-05-27,21:00:00,62,38,24,F11SP
9,Janssenlei 17,2022-05-27,22:00:00,34,14,20,F11SP
9,Janssenlei 17,2022-05-27,23:00:00,14,8,6,F11SP
9,Janssenlei 17,2022-05-28,00:00:00,22,6,16,F11SP
9,Janssenlei 17,2022-05-28,01:00:00,20,6,14,F11SP
9,Janssenlei 17,2022-05-28,02:00:00,16,14,2,F11SP
9,Janssenlei 17,2022-05-28,03:00:00,6,6,0,F11SP
9,Janssenlei 17,2022-05-28,04:00:00,4,4,0,F11SP
9,Janssenlei 17,2022-05-28,05:00:00,18,16,2,F11SP
9,Janssenlei 17,2022-05-28,06:00:00,30,16,14,F11SP
9,Janssenlei 17,2022-05-28,07:00:00,24,10,14,F11SP
9,Janssenlei 17,2022-05-28,08:00:00,64,24,40,F11SP
9,Janssenlei 17,2022-05-28,09:00:00,170,56,114,F11SP
9,Janssenlei 17,2022-05-28,10:00:00,196,102,94,F11SP
9,Janssenlei 17,2022-05-28,11:00:00,266,132,134,F11SP
9,Janssenlei 17,2022-05-28,12:00:00,208,92,116,F11SP
9,Janssenlei 17,2022-05-28,13:00:00,228,146,82,F11SP
9,Janssenlei 17,2022-05-28,14:00:00,356,210,146,F11SP
9,Janssenlei 17,2022-05-28,15:00:00,314,184,130,F11SP
9,Janssenlei 17,2022-05-28,16:00:00,304,152,152,F11SP
9,Janssenlei 17,2022-05-28,17:00:00,266,108,158,F11SP
9,Janssenlei 17,2022-05-28,18:00:00,246,130,116,F11SP
9,Janssenlei 17,2022-05-28,19:00:00,192,100,92,F11SP
9,Janssenlei 17,2022-05-28,20:00:00,154,96,58,F11SP
9,Janssenlei 17,2022-05-28,21:00:00,110,54,56,F11SP
9,Janssenlei 17,2022-05-28,22:00:00,86,22,64,F11SP
9,Janssenlei 17,2022-05-28,23:00:00,74,22,52,F11SP
9,Janssenlei 17,2022-05-29,00:00:00,58,10,48,F11SP
9,Janssenlei 17,2022-05-29,01:00:00,36,6,30,F11SP
9,Janssenlei 17,2022-05-29,02:00:00,16,2,14,F11SP
9,Janssenlei 17,2022-05-29,03:00:00,4,0,4,F11SP
9,Janssenlei 17,2022-05-29,04:00:00,6,4,2,F11SP
9,Janssenlei 17,2022-05-29,05:00:00,18,14,4,F11SP
9,Janssenlei 17,2022-05-29,06:00:00,28,16,12,F11SP
9,Janssenlei 17,2022-05-29,07:00:00,24,12,12,F11SP
9,Janssenlei 17,2022-05-29,08:00:00,56,10,46,F11SP
9,Janssenlei 17,2022-05-29,09:00:00,92,40,52,F11SP
9,Janssenlei 17,2022-05-29,10:00:00,146,54,92,F11SP
9,Janssenlei 17,2022-05-29,11:00:00,84,50,34,F11SP
9,Janssenlei 17,2022-05-29,12:00:00,94,56,38,F11SP
9,Janssenlei 17,2022-05-29,13:00:00,84,48,36,F11SP
9,Janssenlei 17,2022-05-29,14:00:00,68,32,36,F11SP
9,Janssenlei 17,2022-05-29,15:00:00,62,26,36,F11SP
9,Janssenlei 17,2022-05-29,16:00:00,78,38,40,F11SP
9,Janssenlei 17,2022-05-29,17:00:00,80,48,32,F11SP
9,Janssenlei 17,2022-05-29,18:00:00,112,54,58,F11SP
9,Janssenlei 17,2022-05-29,19:00:00,72,34,38,F11SP
9,Janssenlei 17,2022-05-29,20:00:00,56,24,32,F11SP
9,Janssenlei 17,2022-05-29,21:00:00,40,20,20,F11SP
9,Janssenlei 17,2022-05-29,22:00:00,18,8,10,F11SP
9,Janssenlei 17,2022-05-29,23:00:00,8,2,6,F11SP
9,Janssenlei 17,2022-05-30,00:00:00,0,0,0,F11SP
9,Janssenlei 17,2022-05-30,01:00:00,0,0,0,F11SP
9,Janssenlei 17,2022-05-30,02:00:00,2,2,0,F11SP
9,Janssenlei 17,2022-05-30,03:00:00,0,0,0,F11SP
9,Janssenlei 17,2022-05-30,04:00:00,8,8,0,F11SP
9,Janssenlei 17,2022-05-30,05:00:00,60,46,14,F11SP
9,Janssenlei 17,2022-05-30,06:00:00,138,106,32,F11SP
9,Janssenlei 17,2022-05-30,07:00:00,372,252,120,F11SP
9,Janssenlei 17,2022-05-30,08:00:00,462,322,140,F11SP
9,Janssenlei 17,2022-05-30,09:00:00,138,98,40,F11SP
9,Janssenlei 17,2022-05-30,10:00:00,114,54,60,F11SP
9,Janssenlei 17,2022-05-30,11:00:00,86,34,52,F11SP
9,Janssenlei 17,2022-05-30,12:00:00,144,56,88,F11SP
9,Janssenlei 17,2022-05-30,13:00:00,146,80,66,F11SP
9,Janssenlei 17,2022-05-30,14:00:00,168,58,110,F11SP
9,Janssenlei 17,2022-05-30,15:00:00,310,136,174,F11SP
9,Janssenlei 17,2022-05-30,16:00:00,480,160,320,F11SP
9,Janssenlei 17,2022-05-30,17:00:00,378,102,276,F11SP
9,Janssenlei 17,2022-05-30,18:00:00,228,78,150,F11SP
9,Janssenlei 17,2022-05-30,19:00:00,130,80,50,F11SP
9,Janssenlei 17,2022-05-30,20:00:00,110,58,52,F11SP
9,Janssenlei 17,2022-05-30,21:00:00,94,48,46,F11SP
9,Janssenlei 17,2022-05-30,22:00:00,72,32,40,F11SP
9,Janssenlei 17,2022-05-30,23:00:00,16,4,12,F11SP
9,Janssenlei 17,2022-05-31,00:00:00,4,2,2,F11SP
9,Janssenlei 17,2022-05-31,01:00:00,0,0,0,F11SP
9,Janssenlei 17,2022-05-31,02:00:00,4,2,2,F11SP
9,Janssenlei 17,2022-05-31,03:00:00,0,0,0,F11SP
9,Janssenlei 17,2022-05-31,04:00:00,8,4,4,F11SP
9,Janssenlei 17,2022-05-31,05:00:00,72,56,16,F11SP
9,Janssenlei 17,2022-05-31,06:00:00,160,110,50,F11SP
9,Janssenlei 17,2022-05-31,07:00:00,482,322,160,F11SP
9,Janssenlei 17,2022-05-31,08:00:00,556,388,168,F11SP
9,Janssenlei 17,2022-05-31,09:00:00,174,84,90,F11SP
9,Janssenlei 17,2022-05-31,10:00:00,124,52,72,F11SP
9,Janssenlei 17,2022-05-31,11:00:00,176,98,78,F11SP
9,Janssenlei 17,2022-05-31,12:00:00,164,76,88,F11SP
9,Janssenlei 17,2022-05-31,13:00:00,288,94,194,F11SP
9,Janssenlei 17,2022-05-31,14:00:00,206,88,118,F11SP
9,Janssenlei 17,2022-05-31,15:00:00,282,88,194,F11SP
9,Janssenlei 17,2022-05-31,16:00:00,572,204,368,F11SP
9,Janssenlei 17,2022-05-31,17:00:00,478,152,326,F11SP
9,Janssenlei 17,2022-05-31,18:00:00,208,62,146,F11SP
9,Janssenlei 17,2022-05-31,19:00:00,108,54,54,F11SP
9,Janssenlei 17,2022-05-31,20:00:00,116,58,58,F11SP
9,Janssenlei 17,2022-05-31,21:00:00,94,76,18,F11SP
9,Janssenlei 17,2022-05-31,22:00:00,76,38,38,F11SP
9,Janssenlei 17,2022-05-31,23:00:00,22,2,20,F11SP
9,Janssenlei 17,2022-06-01,00:00:00,0,0,0,F11SP
9,Janssenlei 17,2022-06-01,01:00:00,8,2,6,F11SP
9,Janssenlei 17,2022-06-01,02:00:00,2,0,2,F11SP
9,Janssenlei 17,2022-06-01,03:00:00,0,0,0,F11SP
9,Janssenlei 17,2022-06-01,04:00:00,16,16,0,F11SP
9,Janssenlei 17,2022-06-01,05:00:00,72,48,24,F11SP
9,Janssenlei 17,2022-06-01,06:00:00,156,106,50,F11SP
9,Janssenlei 17,2022-06-01,07:00:00,414,270,144,F11SP
9,Janssenlei 17,2022-06-01,08:00:00,502,342,160,F11SP
9,Janssenlei 17,2022-06-01,09:00:00,144,84,60,F11SP
9,Janssenlei 17,2022-06-01,10:00:00,116,60,56,F11SP
9,Janssenlei 17,2022-06-01,11:00:00,224,118,106,F11SP
9,Janssenlei 17,2022-06-01,12:00:00,320,128,192,F11SP
9,Janssenlei 17,2022-06-01,13:00:00,184,64,120,F11SP
9,Janssenlei 17,2022-06-01,14:00:00,166,64,102,F11SP
9,Janssenlei 17,2022-06-01,15:00:00,200,88,112,F11SP
9,Janssenlei 17,2022-06-01,16:00:00,298,102,196,F11SP
9,Janssenlei 17,2022-06-01,17:00:00,404,140,264,F11SP
9,Janssenlei 17,2022-06-01,18:00:00,288,100,188,F11SP
9,Janssenlei 17,2022-06-01,19:00:00,176,70,106,F11SP
9,Janssenlei 17,2022-06-01,20:00:00,176,102,74,F11SP
9,Janssenlei 17,2022-06-01,21:00:00,110,78,32,F11SP
9,Janssenlei 17,2022-06-01,22:00:00,68,22,46,F11SP
9,Janssenlei 17,2022-06-01,23:00:00,32,14,18,F11SP
9,Janssenlei 17,2022-06-02,00:00:00,2,0,2,F11SP
9,Janssenlei 17,2022-06-02,01:00:00,2,0,2,F11SP
9,Janssenlei 17,2022-06-02,02:00:00,6,6,0,F11SP
9,Janssenlei 17,2022-06-02,03:00:00,2,2,0,F11SP
9,Janssenlei 17,2022-06-02,04:00:00,14,14,0,F11SP
9,Janssenlei 17,2022-06-02,05:00:00,72,52,20,F11SP
9,Janssenlei 17,2022-06-02,06:00:00,134,94,40,F11SP
9,Janssenlei 17,2022-06-02,07:00:00,460,296,164,F11SP
9,Janssenlei 17,2022-06-02,08:00:00,536,394,142,F11SP
9,Janssenlei 17,2022-06-02,09:00:00,190,106,84,F11SP
9,Janssenlei 17,2022-06-02,10:00:00,168,78,90,F11SP
9,Janssenlei 17,2022-06-02,11:00:00,122,54,68,F11SP
9,Janssenlei 17,2022-06-02,12:00:00,166,72,94,F11SP
9,Janssenlei 17,2022-06-02,13:00:00,226,106,120,F11SP
9,Janssenlei 17,2022-06-02,14:00:00,270,116,154,F11SP
9,Janssenlei 17,2022-06-02,15:00:00,376,166,210,F11SP
9,Janssenlei 17,2022-06-02,16:00:00,608,224,384,F11SP
9,Janssenlei 17,2022-06-02,17:00:00,512,188,324,F11SP
9,Janssenlei 17,2022-06-02,18:00:00,340,132,208,F11SP
9,Janssenlei 17,2022-06-02,19:00:00,278,114,164,F11SP
9,Janssenlei 17,2022-06-02,20:00:00,236,158,78,F11SP
9,Janssenlei 17,2022-06-02,21:00:00,88,56,32,F11SP
9,Janssenlei 17,2022-06-02,22:00:00,66,18,48,F11SP
9,Janssenlei 17,2022-06-02,23:00:00,32,14,18,F11SP
9,Janssenlei 17,2022-06-03,00:00:00,12,6,6,F11SP
9,Janssenlei 17,2022-06-03,01:00:00,8,0,8,F11SP
9,Janssenlei 17,2022-06-03,02:00:00,2,0,2,F11SP
9,Janssenlei 17,2022-06-03,03:00:00,4,2,2,F11SP
9,Janssenlei 17,2022-06-03,04:00:00,10,10,0,F11SP
9,Janssenlei 17,2022-06-03,05:00:00,56,40,16,F11SP
9,Janssenlei 17,2022-06-03,06:00:00,120,86,34,F11SP
9,Janssenlei 17,2022-06-03,07:00:00,370,242,128,F11SP
9,Janssenlei 17,2022-06-03,08:00:00,490,336,154,F11SP
9,Janssenlei 17,2022-06-03,09:00:00,266,88,178,F11SP
9,Janssenlei 17,2022-06-03,10:00:00,176,70,106,F11SP
9,Janssenlei 17,2022-06-03,11:00:00,188,108,80,F11SP
9,Janssenlei 17,2022-06-03,12:00:00,188,88,100,F11SP
9,Janssenlei 17,2022-06-03,13:00:00,248,86,162,F11SP
9,Janssenlei 17,2022-06-03,14:00:00,322,148,174,F11SP
9,Janssenlei 17,2022-06-03,15:00:00,576,350,226,F11SP
9,Janssenlei 17,2022-06-03,16:00:00,592,264,328,F11SP
9,Janssenlei 17,2022-06-03,17:00:00,394,170,224,F11SP
9,Janssenlei 17,2022-06-03,18:00:00,284,116,168,F11SP
9,Janssenlei 17,2022-06-03,19:00:00,222,80,142,F11SP
9,Janssenlei 17,2022-06-03,20:00:00,162,88,74,F11SP
9,Janssenlei 17,2022-06-03,21:00:00,116,64,52,F11SP
9,Janssenlei 17,2022-06-03,22:00:00,70,22,48,F11SP
9,Janssenlei 17,2022-06-03,23:00:00,34,14,20,F11SP
9,Janssenlei 17,2022-06-04,00:00:00,28,10,18,F11SP
9,Janssenlei 17,2022-06-04,01:00:00,10,2,8,F11SP
9,Janssenlei 17,2022-06-04,02:00:00,20,10,10,F11SP
9,Janssenlei 17,2022-06-04,03:00:00,12,10,2,F11SP
9,Janssenlei 17,2022-06-04,04:00:00,10,6,4,F11SP
9,Janssenlei 17,2022-06-04,05:00:00,18,12,6,F11SP
9,Janssenlei 17,2022-06-04,06:00:00,24,6,18,F11SP
9,Janssenlei 17,2022-06-04,07:00:00,38,20,18,F11SP
9,Janssenlei 17,2022-06-04,08:00:00,88,36,52,F11SP
9,Janssenlei 17,2022-06-04,09:00:00,154,68,86,F11SP
9,Janssenlei 17,2022-06-04,10:00:00,228,104,124,F11SP
9,Janssenlei 17,2022-06-04,11:00:00,208,104,104,F11SP
9,Janssenlei 17,2022-06-04,12:00:00,262,146,116,F11SP
9,Janssenlei 17,2022-06-04,13:00:00,296,134,162,F11SP
9,Janssenlei 17,2022-06-04,14:00:00,384,146,238,F11SP
9,Janssenlei 17,2022-06-04,15:00:00,406,190,216,F11SP
9,Janssenlei 17,2022-06-04,16:00:00,352,186,166,F11SP
9,Janssenlei 17,2022-06-04,17:00:00,286,160,126,F11SP
9,Janssenlei 17,2022-06-04,18:00:00,254,154,100,F11SP
9,Janssenlei 17,2022-06-04,19:00:00,178,98,80,F11SP
9,Janssenlei 17,2022-06-04,20:00:00,102,46,56,F11SP
9,Janssenlei 17,2022-06-04,21:00:00,80,44,36,F11SP
9,Janssenlei 17,2022-06-04,22:00:00,60,28,32,F11SP
9,Janssenlei 17,2022-06-04,23:00:00,34,18,16,F11SP
9,Janssenlei 17,2022-06-05,00:00:00,18,4,14,F11SP
9,Janssenlei 17,2022-06-05,01:00:00,14,2,12,F11SP
9,Janssenlei 17,2022-06-05,02:00:00,10,6,4,F11SP
9,Janssenlei 17,2022-06-05,03:00:00,6,4,2,F11SP
9,Janssenlei 17,2022-06-05,04:00:00,2,2,0,F11SP
9,Janssenlei 17,2022-06-05,05:00:00,24,18,6,F11SP
9,Janssenlei 17,2022-06-05,06:00:00,14,4,10,F11SP
9,Janssenlei 17,2022-06-05,07:00:00,14,8,6,F11SP
9,Janssenlei 17,2022-06-05,08:00:00,42,26,16,F11SP
9,Janssenlei 17,2022-06-05,09:00:00,110,50,60,F11SP
9,Janssenlei 17,2022-06-05,10:00:00,240,92,148,F11SP
9,Janssenlei 17,2022-06-05,11:00:00,210,110,100,F11SP
9,Janssenlei 17,2022-06-05,12:00:00,108,74,34,F11SP
9,Janssenlei 17,2022-06-05,13:00:00,38,24,14,F11SP
9,Janssenlei 17,2022-06-05,14:00:00,48,30,18,F11SP
9,Janssenlei 17,2022-06-05,15:00:00,32,16,16,F11SP
9,Janssenlei 17,2022-06-05,16:00:00,16,10,6,F11SP
9,Janssenlei 17,2022-06-05,17:00:00,22,18,4,F11SP
9,Janssenlei 17,2022-06-05,18:00:00,60,26,34,F11SP
9,Janssenlei 17,2022-06-05,19:00:00,58,22,36,F11SP
9,Janssenlei 17,2022-06-05,20:00:00,68,34,34,F11SP
9,Janssenlei 17,2022-06-05,21:00:00,16,6,10,F11SP
9,Janssenlei 17,2022-06-05,22:00:00,22,4,18,F11SP
9,Janssenlei 17,2022-06-05,23:00:00,14,8,6,F11SP
9,Janssenlei 17,2022-06-06,00:00:00,8,4,4,F11SP
9,Janssenlei 17,2022-06-06,01:00:00,4,0,4,F11SP
9,Janssenlei 17,2022-06-06,02:00:00,2,0,2,F11SP
9,Janssenlei 17,2022-06-06,03:00:00,2,2,0,F11SP
9,Janssenlei 17,2022-06-06,04:00:00,2,2,0,F11SP
9,Janssenlei 17,2022-06-06,05:00:00,8,6,2,F11SP
9,Janssenlei 17,2022-06-06,06:00:00,10,6,4,F11SP
9,Janssenlei 17,2022-06-06,07:00:00,34,16,18,F11SP
9,Janssenlei 17,2022-06-06,08:00:00,52,20,32,F11SP
9,Janssenlei 17,2022-06-06,09:00:00,140,72,68,F11SP
9,Janssenlei 17,2022-06-06,10:00:00,202,86,116,F11SP
9,Janssenlei 17,2022-06-06,11:00:00,254,164,90,F11SP
9,Janssenlei 17,2022-06-06,12:00:00,168,118,50,F11SP
9,Janssenlei 17,2022-06-06,13:00:00,134,86,48,F11SP
9,Janssenlei 17,2022-06-06,14:00:00,130,52,78,F11SP
9,Janssenlei 17,2022-06-06,15:00:00,148,72,76,F11SP
9,Janssenlei 17,2022-06-06,16:00:00,120,60,60,F11SP
9,Janssenlei 17,2022-06-06,17:00:00,118,82,36,F11SP
9,Janssenlei 17,2022-06-06,18:00:00,68,28,40,F11SP
9,Janssenlei 17,2022-06-06,19:00:00,52,24,28,F11SP
9,Janssenlei 17,2022-06-06,20:00:00,74,48,26,F11SP
9,Janssenlei 17,2022-06-06,21:00:00,40,24,16,F11SP
9,Janssenlei 17,2022-06-06,22:00:00,26,14,12,F11SP
9,Janssenlei 17,2022-06-06,23:00:00,14,8,6,F11SP
9,Janssenlei 17,2022-06-07,00:00:00,10,4,6,F11SP
9,Janssenlei 17,2022-06-07,01:00:00,0,0,0,F11SP
9,Janssenlei 17,2022-06-07,02:00:00,4,2,2,F11SP
9,Janssenlei 17,2022-06-07,03:00:00,0,0,0,F11SP
9,Janssenlei 17,2022-06-07,04:00:00,14,10,4,F11SP
9,Janssenlei 17,2022-06-07,05:00:00,72,50,22,F11SP
9,Janssenlei 17,2022-06-07,06:00:00,140,100,40,F11SP
9,Janssenlei 17,2022-06-07,07:00:00,486,322,164,F11SP
9,Janssenlei 17,2022-06-07,08:00:00,442,310,132,F11SP
9,Janssenlei 17,2022-06-07,09:00:00,162,102,60,F11SP
9,Janssenlei 17,2022-06-07,10:00:00,174,56,118,F11SP
9,Janssenlei 17,2022-06-07,11:00:00,108,44,64,F11SP
9,Janssenlei 17,2022-06-07,12:00:00,198,130,68,F11SP
9,Janssenlei 17,2022-06-07,13:00:00,144,70,74,F11SP
9,Janssenlei 17,2022-06-07,14:00:00,164,68,96,F11SP
9,Janssenlei 17,2022-06-07,15:00:00,222,108,114,F11SP
9,Janssenlei 17,2022-06-07,16:00:00,492,144,348,F11SP
9,Janssenlei 17,2022-06-07,17:00:00,382,130,252,F11SP
9,Janssenlei 17,2022-06-07,18:00:00,220,90,130,F11SP
9,Janssenlei 17,2022-06-07,19:00:00,166,66,100,F11SP
9,Janssenlei 17,2022-06-07,20:00:00,76,38,38,F11SP
9,Janssenlei 17,2022-06-07,21:00:00,88,60,28,F11SP
9,Janssenlei 17,2022-06-07,22:00:00,54,10,44,F11SP
9,Janssenlei 17,2022-06-07,23:00:00,16,4,12,F11SP
9,Janssenlei 17,2022-06-08,00:00:00,6,0,6,F11SP
9,Janssenlei 17,2022-06-08,01:00:00,0,0,0,F11SP
9,Janssenlei 17,2022-06-08,02:00:00,4,0,4,F11SP
9,Janssenlei 17,2022-06-08,03:00:00,0,0,0,F11SP
9,Janssenlei 17,2022-06-08,04:00:00,14,12,2,F11SP
9,Janssenlei 17,2022-06-08,05:00:00,50,38,12,F11SP
9,Janssenlei 17,2022-06-08,06:00:00,110,76,34,F11SP
9,Janssenlei 17,2022-06-08,07:00:00,296,182,114,F11SP
9,Janssenlei 17,2022-06-08,08:00:00,374,264,110,F11SP
9,Janssenlei 17,2022-06-08,09:00:00,120,66,54,F11SP
9,Janssenlei 17,2022-06-08,10:00:00,70,44,26,F11SP
9,Janssenlei 17,2022-06-08,11:00:00,102,48,54,F11SP
9,Janssenlei 17,2022-06-08,12:00:00,230,74,156,F11SP
9,Janssenlei 17,2022-06-08,13:00:00,86,42,44,F11SP
9,Janssenlei 17,2022-06-08,14:00:00,90,26,64,F11SP
9,Janssenlei 17,2022-06-08,15:00:00,88,36,52,F11SP
9,Janssenlei 17,2022-06-08,16:00:00,152,48,104,F11SP
9,Janssenlei 17,2022-06-08,17:00:00,234,80,154,F11SP
9,Janssenlei 17,2022-06-08,18:00:00,150,70,80,F11SP
9,Janssenlei 17,2022-06-08,19:00:00,162,56,106,F11SP
9,Janssenlei 17,2022-06-08,20:00:00,126,84,42,F11SP
9,Janssenlei 17,2022-06-08,21:00:00,74,34,40,F11SP
9,Janssenlei 17,2022-06-08,22:00:00,62,30,32,F11SP
9,Janssenlei 17,2022-06-08,23:00:00,16,4,12,F11SP
9,Janssenlei 17,2022-06-09,00:00:00,10,0,10,F11SP
9,Janssenlei 17,2022-06-09,01:00:00,4,0,4,F11SP
9,Janssenlei 17,2022-06-09,02:00:00,0,0,0,F11SP
9,Janssenlei 17,2022-06-09,03:00:00,0,0,0,F11SP
9,Janssenlei 17,2022-06-09,04:00:00,12,12,0,F11SP
9,Janssenlei 17,2022-06-09,05:00:00,68,44,24,F11SP
9,Janssenlei 17,2022-06-09,06:00:00,132,98,34,F11SP
9,Janssenlei 17,2022-06-09,07:00:00,396,262,134,F11SP
9,Janssenlei 17,2022-06-09,08:00:00,504,360,144,F11SP
9,Janssenlei 17,2022-06-09,09:00:00,208,96,112,F11SP
9,Janssenlei 17,2022-06-09,10:00:00,106,56,50,F11SP
9,Janssenlei 17,2022-06-09,11:00:00,112,76,36,F11SP
9,Janssenlei 17,2022-06-09,12:00:00,186,104,82,F11SP
9,Janssenlei 17,2022-06-09,13:00:00,158,88,70,F11SP
9,Janssenlei 17,2022-06-09,14:00:00,206,64,142,F11SP
9,Janssenlei 17,2022-06-09,15:00:00,320,122,198,F11SP
9,Janssenlei 17,2022-06-09,16:00:00,438,166,272,F11SP
9,Janssenlei 17,2022-06-09,17:00:00,378,130,248,F11SP
9,Janssenlei 17,2022-06-09,18:00:00,322,100,222,F11SP
9,Janssenlei 17,2022-06-09,19:00:00,202,80,122,F11SP
9,Janssenlei 17,2022-06-09,20:00:00,198,134,64,F11SP
9,Janssenlei 17,2022-06-09,21:00:00,138,106,32,F11SP
9,Janssenlei 17,2022-06-09,22:00:00,100,34,66,F11SP
9,Janssenlei 17,2022-06-09,23:00:00,6,4,2,F11SP
9,Janssenlei 17,2022-06-10,00:00:00,12,6,6,F11SP
9,Janssenlei 17,2022-06-10,01:00:00,2,0,2,F11SP
9,Janssenlei 17,2022-06-10,02:00:00,4,0,4,F11SP
9,Janssenlei 17,2022-06-10,03:00:00,6,4,2,F11SP
9,Janssenlei 17,2022-06-10,04:00:00,22,20,2,F11SP
9,Janssenlei 17,2022-06-10,05:00:00,66,44,22,F11SP
9,Janssenlei 17,2022-06-10,06:00:00,130,98,32,F11SP
9,Janssenlei 17,2022-06-10,07:00:00,394,224,170,F11SP
9,Janssenlei 17,2022-06-10,08:00:00,418,288,130,F11SP
9,Janssenlei 17,2022-06-10,09:00:00,182,100,82,F11SP
9,Janssenlei 17,2022-06-10,10:00:00,140,84,56,F11SP
9,Janssenlei 17,2022-06-10,11:00:00,154,80,74,F11SP
9,Janssenlei 17,2022-06-10,12:00:00,228,106,122,F11SP
9,Janssenlei 17,2022-06-10,13:00:00,240,100,140,F11SP
9,Janssenlei 17,2022-06-10,14:00:00,266,94,172,F11SP
9,Janssenlei 17,2022-06-10,15:00:00,400,154,246,F11SP
9,Janssenlei 17,2022-06-10,16:00:00,392,136,256,F11SP
9,Janssenlei 17,2022-06-10,17:00:00,334,150,184,F11SP
9,Janssenlei 17,2022-06-10,18:00:00,230,80,150,F11SP
9,Janssenlei 17,2022-06-10,19:00:00,156,70,86,F11SP
9,Janssenlei 17,2022-06-10,20:00:00,192,68,124,F11SP
9,Janssenlei 17,2022-06-10,21:00:00,96,38,58,F11SP
9,Janssenlei 17,2022-06-10,22:00:00,102,26,76,F11SP
9,Janssenlei 17,2022-06-10,23:00:00,50,12,38,F11SP
9,Janssenlei 17,2022-06-11,00:00:00,42,16,26,F11SP
9,Janssenlei 17,2022-06-11,01:00:00,50,34,16,F11SP
9,Janssenlei 17,2022-06-11,02:00:00,24,14,10,F11SP
9,Janssenlei 17,2022-06-11,03:00:00,20,12,8,F11SP
9,Janssenlei 17,2022-06-11,04:00:00,12,10,2,F11SP
9,Janssenlei 17,2022-06-11,05:00:00,28,16,12,F11SP
9,Janssenlei 17,2022-06-11,06:00:00,16,4,12,F11SP
9,Janssenlei 17,2022-06-11,07:00:00,36,12,24,F11SP
9,Janssenlei 17,2022-06-11,08:00:00,88,40,48,F11SP
9,Janssenlei 17,2022-06-11,09:00:00,150,68,82,F11SP
9,Janssenlei 17,2022-06-11,10:00:00,202,64,138,F11SP
9,Janssenlei 17,2022-06-11,11:00:00,236,138,98,F11SP
9,Janssenlei 17,2022-06-11,12:00:00,250,130,120,F11SP
9,Janssenlei 17,2022-06-11,13:00:00,366,194,172,F11SP
9,Janssenlei 17,2022-06-11,14:00:00,404,168,236,F11SP
9,Janssenlei 17,2022-06-11,15:00:00,336,162,174,F11SP
9,Janssenlei 17,2022-06-11,16:00:00,306,188,118,F11SP
9,Janssenlei 17,2022-06-11,17:00:00,256,154,102,F11SP
9,Janssenlei 17,2022-06-11,18:00:00,278,118,160,F11SP
9,Janssenlei 17,2022-06-11,19:00:00,266,130,136,F11SP
9,Janssenlei 17,2022-06-11,20:00:00,172,90,82,F11SP
9,Janssenlei 17,2022-06-11,21:00:00,100,52,48,F11SP
9,Janssenlei 17,2022-06-11,22:00:00,46,10,36,F11SP
9,Janssenlei 17,2022-06-11,23:00:00,16,6,10,F11SP
9,Janssenlei 17,2022-06-12,00:00:00,8,6,2,F11SP
9,Janssenlei 17,2022-06-12,01:00:00,18,8,10,F11SP
9,Janssenlei 17,2022-06-12,02:00:00,16,10,6,F11SP
9,Janssenlei 17,2022-06-12,03:00:00,0,0,0,F11SP
9,Janssenlei 17,2022-06-12,04:00:00,12,10,2,F11SP
9,Janssenlei 17,2022-06-12,05:00:00,16,10,6,F11SP
9,Janssenlei 17,2022-06-12,06:00:00,16,14,2,F11SP
9,Janssenlei 17,2022-06-12,07:00:00,58,20,38,F11SP
9,Janssenlei 17,2022-06-12,08:00:00,112,36,76,F11SP
9,Janssenlei 17,2022-06-12,09:00:00,264,86,178,F11SP
9,Janssenlei 17,2022-06-12,10:00:00,360,138,222,F11SP
9,Janssenlei 17,2022-06-12,11:00:00,548,258,290,F11SP
9,Janssenlei 17,2022-06-12,12:00:00,384,204,180,F11SP
9,Janssenlei 17,2022-06-12,13:00:00,548,210,338,F11SP
9,Janssenlei 17,2022-06-12,14:00:00,682,250,432,F11SP
9,Janssenlei 17,2022-06-12,15:00:00,432,188,244,F11SP
9,Janssenlei 17,2022-06-12,16:00:00,446,284,162,F11SP
9,Janssenlei 17,2022-06-12,17:00:00,346,194,152,F11SP
9,Janssenlei 17,2022-06-12,18:00:00,238,156,82,F11SP
9,Janssenlei 17,2022-06-12,19:00:00,162,112,50,F11SP
9,Janssenlei 17,2022-06-12,20:00:00,84,44,40,F11SP
9,Janssenlei 17,2022-06-12,21:00:00,110,66,44,F11SP
9,Janssenlei 17,2022-06-12,22:00:00,58,30,28,F11SP
9,Janssenlei 17,2022-06-12,23:00:00,44,20,24,F11SP
9,Janssenlei 17,2022-06-13,00:00:00,8,6,2,F11SP
9,Janssenlei 17,2022-06-13,01:00:00,8,4,4,F11SP
9,Janssenlei 17,2022-06-13,02:00:00,0,0,0,F11SP
9,Janssenlei 17,2022-06-13,03:00:00,6,6,0,F11SP
9,Janssenlei 17,2022-06-13,04:00:00,8,6,2,F11SP
9,Janssenlei 17,2022-06-13,05:00:00,70,56,14,F11SP
9,Janssenlei 17,2022-06-13,06:00:00,174,120,54,F11SP
9,Janssenlei 17,2022-06-13,07:00:00,546,366,180,F11SP
9,Janssenlei 17,2022-06-13,08:00:00,498,374,124,F11SP
9,Janssenlei 17,2022-06-13,09:00:00,150,80,70,F11SP
9,Janssenlei 17,2022-06-13,10:00:00,108,56,52,F11SP
9,Janssenlei 17,2022-06-13,11:00:00,116,60,56,F11SP
9,Janssenlei 17,2022-06-13,12:00:00,196,78,118,F11SP
9,Janssenlei 17,2022-06-13,13:00:00,146,68,78,F11SP
9,Janssenlei 17,2022-06-13,14:00:00,190,60,130,F11SP
9,Janssenlei 17,2022-06-13,15:00:00,318,92,226,F11SP
9,Janssenlei 17,2022-06-13,16:00:00,488,164,324,F11SP
9,Janssenlei 17,2022-06-13,17:00:00,426,130,296,F11SP
9,Janssenlei 17,2022-06-13,18:00:00,270,90,180,F11SP
9,Janssenlei 17,2022-06-13,19:00:00,204,90,114,F11SP
9,Janssenlei 17,2022-06-13,20:00:00,194,78,116,F11SP
9,Janssenlei 17,2022-06-13,21:00:00,102,62,40,F11SP
9,Janssenlei 17,2022-06-13,22:00:00,64,22,42,F11SP
9,Janssenlei 17,2022-06-13,23:00:00,22,14,8,F11SP
9,Janssenlei 17,2022-06-14,00:00:00,6,4,2,F11SP
9,Janssenlei 17,2022-06-14,01:00:00,0,0,0,F11SP
9,Janssenlei 17,2022-06-14,02:00:00,0,0,0,F11SP
9,Janssenlei 17,2022-06-14,03:00:00,0,0,0,F11SP
9,Janssenlei 17,2022-06-14,04:00:00,12,10,2,F11SP
9,Janssenlei 17,2022-06-14,05:00:00,74,60,14,F11SP
9,Janssenlei 17,2022-06-14,06:00:00,200,146,54,F11SP
9,Janssenlei 17,2022-06-14,07:00:00,552,382,170,F11SP
9,Janssenlei 17,2022-06-14,08:00:00,568,428,140,F11SP
9,Janssenlei 17,2022-06-14,09:00:00,198,108,90,F11SP
9,Janssenlei 17,2022-06-14,10:00:00,196,88,108,F11SP
9,Janssenlei 17,2022-06-14,11:00:00,238,134,104,F11SP
9,Janssenlei 17,2022-06-14,12:00:00,286,128,158,F11SP
9,Janssenlei 17,2022-06-14,13:00:00,296,110,186,F11SP
9,Janssenlei 17,2022-06-14,14:00:00,376,116,260,F11SP
9,Janssenlei 17,2022-06-14,15:00:00,416,140,276,F11SP
9,Janssenlei 17,2022-06-14,16:00:00,602,210,392,F11SP
9,Janssenlei 17,2022-06-14,17:00:00,580,188,392,F11SP
9,Janssenlei 17,2022-06-14,18:00:00,352,112,240,F11SP
9,Janssenlei 17,2022-06-14,19:00:00,256,108,148,F11SP
9,Janssenlei 17,2022-06-14,20:00:00,248,162,86,F11SP
9,Janssenlei 17,2022-06-14,21:00:00,176,122,54,F11SP
9,Janssenlei 17,2022-06-14,22:00:00,92,36,56,F11SP
9,Janssenlei 17,2022-06-14,23:00:00,24,6,18,F11SP
9,Janssenlei 17,2022-06-15,00:00:00,6,0,6,F11SP
9,Janssenlei 17,2022-06-15,01:00:00,6,0,6,F11SP
9,Janssenlei 17,2022-06-15,02:00:00,2,2,0,F11SP
9,Janssenlei 17,2022-06-15,03:00:00,0,0,0,F11SP
9,Janssenlei 17,2022-06-15,04:00:00,22,18,4,F11SP
9,Janssenlei 17,2022-06-15,05:00:00,52,40,12,F11SP
9,Janssenlei 17,2022-06-15,06:00:00,162,104,58,F11SP
9,Janssenlei 17,2022-06-15,07:00:00,524,334,190,F11SP
9,Janssenlei 17,2022-06-15,08:00:00,482,358,124,F11SP
9,Janssenlei 17,2022-06-15,09:00:00,160,90,70,F11SP
9,Janssenlei 17,2022-06-15,10:00:00,338,164,174,F11SP
9,Janssenlei 17,2022-06-15,11:00:00,256,124,132,F11SP
9,Janssenlei 17,2022-06-15,12:00:00,370,150,220,F11SP
9,Janssenlei 17,2022-06-15,13:00:00,286,118,168,F11SP
9,Janssenlei 17,2022-06-15,14:00:00,290,114,176,F11SP
9,Janssenlei 17,2022-06-15,15:00:00,264,114,150,F11SP
9,Janssenlei 17,2022-06-15,16:00:00,396,140,256,F11SP
9,Janssenlei 17,2022-06-15,17:00:00,476,164,312,F11SP
9,Janssenlei 17,2022-06-15,18:00:00,346,126,220,F11SP
9,Janssenlei 17,2022-06-15,19:00:00,314,152,162,F11SP
9,Janssenlei 17,2022-06-15,20:00:00,404,228,176,F11SP
9,Janssenlei 17,2022-06-15,21:00:00,154,98,56,F11SP
9,Janssenlei 17,2022-06-15,22:00:00,124,70,54,F11SP
9,Janssenlei 17,2022-06-15,23:00:00,34,14,20,F11SP
9,Janssenlei 17,2022-06-16,00:00:00,10,4,6,F11SP
9,Janssenlei 17,2022-06-16,01:00:00,6,0,6,F11SP
9,Janssenlei 17,2022-06-16,02:00:00,0,0,0,F11SP
9,Janssenlei 17,2022-06-16,03:00:00,2,2,0,F11SP
9,Janssenlei 17,2022-06-16,04:00:00,14,12,2,F11SP
9,Janssenlei 17,2022-06-16,05:00:00,70,48,22,F11SP
9,Janssenlei 17,2022-06-16,06:00:00,148,100,48,F11SP
9,Janssenlei 17,2022-06-16,07:00:00,568,382,186,F11SP
9,Janssenlei 17,2022-06-16,08:00:00,524,396,128,F11SP
9,Janssenlei 17,2022-06-16,09:00:00,288,116,172,F11SP
9,Janssenlei 17,2022-06-16,10:00:00,274,140,134,F11SP
9,Janssenlei 17,2022-06-16,11:00:00,216,114,102,F11SP
9,Janssenlei 17,2022-06-16,12:00:00,258,120,138,F11SP
9,Janssenlei 17,2022-06-16,13:00:00,206,76,130,F11SP
9,Janssenlei 17,2022-06-16,14:00:00,92,14,78,F11SP
9,Janssenlei 17,2022-06-16,15:00:00,326,112,214,F11SP
9,Janssenlei 17,2022-06-16,16:00:00,544,218,326,F11SP
9,Janssenlei 17,2022-06-16,17:00:00,488,174,314,F11SP
9,Janssenlei 17,2022-06-16,18:00:00,292,98,194,F11SP
9,Janssenlei 17,2022-06-16,19:00:00,246,108,138,F11SP
9,Janssenlei 17,2022-06-16,20:00:00,254,162,92,F11SP
9,Janssenlei 17,2022-06-16,21:00:00,218,140,78,F11SP
9,Janssenlei 17,2022-06-16,22:00:00,102,44,58,F11SP
9,Janssenlei 17,2022-06-16,23:00:00,26,4,22,F11SP
9,Janssenlei 17,2022-06-17,00:00:00,28,12,16,F11SP
9,Janssenlei 17,2022-06-17,01:00:00,4,2,2,F11SP
9,Janssenlei 17,2022-06-17,02:00:00,10,2,8,F11SP
9,Janssenlei 17,2022-06-17,03:00:00,4,2,2,F11SP
9,Janssenlei 17,2022-06-17,04:00:00,18,10,8,F11SP
9,Janssenlei 17,2022-06-17,05:00:00,62,42,20,F11SP
9,Janssenlei 17,2022-06-17,06:00:00,124,96,28,F11SP
9,Janssenlei 17,2022-06-17,07:00:00,410,268,142,F11SP
9,Janssenlei 17,2022-06-17,08:00:00,494,358,136,F11SP
9,Janssenlei 17,2022-06-17,09:00:00,296,94,202,F11SP
9,Janssenlei 17,2022-06-17,10:00:00,262,130,132,F11SP
9,Janssenlei 17,2022-06-17,11:00:00,224,136,88,F11SP
9,Janssenlei 17,2022-06-17,12:00:00,242,102,140,F11SP
9,Janssenlei 17,2022-06-17,13:00:00,200,88,112,F11SP
9,Janssenlei 17,2022-06-17,14:00:00,376,184,192,F11SP
9,Janssenlei 17,2022-06-17,15:00:00,444,220,224,F11SP
9,Janssenlei 17,2022-06-17,16:00:00,398,142,256,F11SP
9,Janssenlei 17,2022-06-17,17:00:00,390,154,236,F11SP
9,Janssenlei 17,2022-06-17,18:00:00,356,126,230,F11SP
9,Janssenlei 17,2022-06-17,19:00:00,240,108,132,F11SP
9,Janssenlei 17,2022-06-17,20:00:00,236,98,138,F11SP
9,Janssenlei 17,2022-06-17,21:00:00,146,74,72,F11SP
9,Janssenlei 17,2022-06-17,22:00:00,128,80,48,F11SP
9,Janssenlei 17,2022-06-17,23:00:00,82,42,40,F11SP
9,Janssenlei 17,2022-06-18,00:00:00,34,20,14,F11SP
9,Janssenlei 17,2022-06-18,01:00:00,32,16,16,F11SP
9,Janssenlei 17,2022-06-18,02:00:00,34,8,26,F11SP
9,Janssenlei 17,2022-06-18,03:00:00,22,12,10,F11SP
9,Janssenlei 17,2022-06-18,04:00:00,14,10,4,F11SP
9,Janssenlei 17,2022-06-18,05:00:00,14,4,10,F11SP
9,Janssenlei 17,2022-06-18,06:00:00,30,14,16,F11SP
9,Janssenlei 17,2022-06-18,07:00:00,66,26,40,F11SP
9,Janssenlei 17,2022-06-18,08:00:00,118,44,74,F11SP
9,Janssenlei 17,2022-06-18,09:00:00,230,94,136,F11SP
9,Janssenlei 17,2022-06-18,10:00:00,312,130,182,F11SP
9,Janssenlei 17,2022-06-18,11:00:00,296,170,126,F11SP
9,Janssenlei 17,2022-06-18,12:00:00,304,178,126,F11SP
9,Janssenlei 17,2022-06-18,13:00:00,202,108,94,F11SP
9,Janssenlei 17,2022-06-18,14:00:00,222,106,116,F11SP
9,Janssenlei 17,2022-06-18,15:00:00,206,112,94,F11SP
9,Janssenlei 17,2022-06-18,16:00:00,176,92,84,F11SP
9,Janssenlei 17,2022-06-18,17:00:00,184,82,102,F11SP
9,Janssenlei 17,2022-06-18,18:00:00,194,124,70,F11SP
9,Janssenlei 17,2022-06-18,19:00:00,164,72,92,F11SP
9,Janssenlei 17,2022-06-18,20:00:00,130,78,52,F11SP
9,Janssenlei 17,2022-06-18,21:00:00,126,60,66,F11SP
9,Janssenlei 17,2022-06-18,22:00:00,96,52,44,F11SP
9,Janssenlei 17,2022-06-18,23:00:00,38,22,16,F11SP
9,Janssenlei 17,2022-06-19,00:00:00,32,8,24,F11SP
9,Janssenlei 17,2022-06-19,01:00:00,16,6,10,F11SP
9,Janssenlei 17,2022-06-19,02:00:00,6,6,0,F11SP
9,Janssenlei 17,2022-06-19,03:00:00,16,12,4,F11SP
9,Janssenlei 17,2022-06-19,04:00:00,6,4,2,F11SP
9,Janssenlei 17,2022-06-19,05:00:00,12,6,6,F11SP
9,Janssenlei 17,2022-06-19,06:00:00,22,6,16,F11SP
9,Janssenlei 17,2022-06-19,07:00:00,38,10,28,F11SP
9,Janssenlei 17,2022-06-19,08:00:00,48,30,18,F11SP
9,Janssenlei 17,2022-06-19,09:00:00,56,20,36,F11SP
9,Janssenlei 17,2022-06-19,10:00:00,108,34,74,F11SP
9,Janssenlei 17,2022-06-19,11:00:00,148,40,108,F11SP
9,Janssenlei 17,2022-06-19,12:00:00,188,92,96,F11SP
9,Janssenlei 17,2022-06-19,13:00:00,164,84,80,F11SP
9,Janssenlei 17,2022-06-19,14:00:00,172,94,78,F11SP
9,Janssenlei 17,2022-06-19,15:00:00,112,66,46,F11SP
9,Janssenlei 17,2022-06-19,16:00:00,130,70,60,F11SP
9,Janssenlei 17,2022-06-19,17:00:00,188,100,88,F11SP
9,Janssenlei 17,2022-06-19,18:00:00,110,68,42,F11SP
9,Janssenlei 17,2022-06-19,19:00:00,84,50,34,F11SP
9,Janssenlei 17,2022-06-19,20:00:00,70,36,34,F11SP
9,Janssenlei 17,2022-06-19,21:00:00,54,26,28,F11SP
9,Janssenlei 17,2022-06-19,22:00:00,32,8,24,F11SP
9,Janssenlei 17,2022-06-19,23:00:00,12,8,4,F11SP
9,Janssenlei 17,2022-06-20,00:00:00,0,0,0,F11SP
9,Janssenlei 17,2022-06-20,01:00:00,2,2,0,F11SP
9,Janssenlei 17,2022-06-20,02:00:00,8,8,0,F11SP
9,Janssenlei 17,2022-06-20,03:00:00,2,0,2,F11SP
9,Janssenlei 17,2022-06-20,04:00:00,10,8,2,F11SP
9,Janssenlei 17,2022-06-20,05:00:00,44,22,22,F11SP
9,Janssenlei 17,2022-06-20,06:00:00,156,120,36,F11SP
9,Janssenlei 17,2022-06-20,07:00:00,532,314,218,F11SP
9,Janssenlei 17,2022-06-20,08:00:00,468,348,120,F11SP
9,Janssenlei 17,2022-06-20,09:00:00,264,92,172,F11SP
9,Janssenlei 17,2022-06-20,10:00:00,206,102,104,F11SP
9,Janssenlei 17,2022-06-20,11:00:00,142,84,58,F11SP
9,Janssenlei 17,2022-06-20,12:00:00,206,114,92,F11SP
9,Janssenlei 17,2022-06-20,13:00:00,230,122,108,F11SP
9,Janssenlei 17,2022-06-20,14:00:00,348,226,122,F11SP
9,Janssenlei 17,2022-06-20,15:00:00,346,144,202,F11SP
9,Janssenlei 17,2022-06-20,16:00:00,466,156,310,F11SP
9,Janssenlei 17,2022-06-20,17:00:00,432,142,290,F11SP
9,Janssenlei 17,2022-06-20,18:00:00,220,98,122,F11SP
9,Janssenlei 17,2022-06-20,19:00:00,218,114,104,F11SP
9,Janssenlei 17,2022-06-20,20:00:00,150,64,86,F11SP
9,Janssenlei 17,2022-06-20,21:00:00,112,82,30,F11SP
9,Janssenlei 17,2022-06-20,22:00:00,60,26,34,F11SP
9,Janssenlei 17,2022-06-20,23:00:00,18,12,6,F11SP
9,Janssenlei 17,2022-06-21,00:00:00,4,2,2,F11SP
9,Janssenlei 17,2022-06-21,01:00:00,2,2,0,F11SP
9,Janssenlei 17,2022-06-21,02:00:00,0,0,0,F11SP
9,Janssenlei 17,2022-06-21,03:00:00,6,2,4,F11SP
9,Janssenlei 17,2022-06-21,04:00:00,14,12,2,F11SP
9,Janssenlei 17,2022-06-21,05:00:00,70,50,20,F11SP
9,Janssenlei 17,2022-06-21,06:00:00,182,130,52,F11SP
9,Janssenlei 17,2022-06-21,07:00:00,540,366,174,F11SP
9,Janssenlei 17,2022-06-21,08:00:00,462,332,130,F11SP
9,Janssenlei 17,2022-06-21,09:00:00,226,108,118,F11SP
9,Janssenlei 17,2022-06-21,10:00:00,252,114,138,F11SP
9,Janssenlei 17,2022-06-21,11:00:00,186,98,88,F11SP
9,Janssenlei 17,2022-06-21,12:00:00,182,106,76,F11SP
9,Janssenlei 17,2022-06-21,13:00:00,202,108,94,F11SP
9,Janssenlei 17,2022-06-21,14:00:00,0,0,0,F11SP
9,Janssenlei 17,2022-06-21,15:00:00,0,0,0,F11SP
9,Janssenlei 17,2022-06-21,16:00:00,0,0,0,F11SP
9,Janssenlei 17,2022-06-21,17:00:00,0,0,0,F11SP
9,Janssenlei 17,2022-06-21,18:00:00,0,0,0,F11SP
9,Janssenlei 17,2022-06-21,19:00:00,0,0,0,F11SP
9,Janssenlei 17,2022-06-21,20:00:00,0,0,0,F11SP
9,Janssenlei 17,2022-06-21,21:00:00,0,0,0,F11SP
9,Janssenlei 17,2022-06-21,22:00:00,0,0,0,F11SP
9,Janssenlei 17,2022-06-21,23:00:00,0,0,0,F11SP
9,Janssenlei 17,2022-08-11,00:00:00,0,0,0,F11SP
9,Janssenlei 17,2022-08-11,01:00:00,0,0,0,F11SP
9,Janssenlei 17,2022-08-11,02:00:00,0,0,0,F11SP
9,Janssenlei 17,2022-08-11,03:00:00,0,0,0,F11SP
9,Janssenlei 17,2022-08-11,04:00:00,0,0,0,F11SP
9,Janssenlei 17,2022-08-11,05:00:00,0,0,0,F11SP
9,Janssenlei 17,2022-08-11,06:00:00,0,0,0,F11SP
9,Janssenlei 17,2022-08-11,07:00:00,0,0,0,F11SP
9,Janssenlei 17,2022-08-11,08:00:00,0,0,0,F11SP
9,Janssenlei 17,2022-08-11,09:00:00,0,0,0,F11SP
9,Janssenlei 17,2022-08-11,10:00:00,0,0,0,F11SP
9,Janssenlei 17,2022-08-11,11:00:00,28,16,12,F11SP
9,Janssenlei 17,2022-08-11,12:00:00,310,186,124,F11SP
9,Janssenlei 17,2022-08-11,13:00:00,262,124,138,F11SP
9,Janssenlei 17,2022-08-11,14:00:00,326,132,194,F11SP
9,Janssenlei 17,2022-08-11,15:00:00,314,154,160,F11SP
9,Janssenlei 17,2022-08-11,16:00:00,548,232,316,F11SP
9,Janssenlei 17,2022-08-11,17:00:00,598,222,376,F11SP
9,Janssenlei 17,2022-08-11,18:00:00,394,146,248,F11SP
9,Janssenlei 17,2022-08-11,19:00:00,280,124,156,F11SP
9,Janssenlei 17,2022-08-11,20:00:00,332,220,112,F11SP
9,Janssenlei 17,2022-08-11,21:00:00,304,186,118,F11SP
9,Janssenlei 17,2022-08-11,22:00:00,132,28,104,F11SP
9,Janssenlei 17,2022-08-11,23:00:00,72,12,60,F11SP
9,Janssenlei 17,2022-08-12,00:00:00,26,12,14,F11SP
9,Janssenlei 17,2022-08-12,01:00:00,18,8,10,F11SP
9,Janssenlei 17,2022-08-12,02:00:00,8,8,0,F11SP
9,Janssenlei 17,2022-08-12,03:00:00,16,6,10,F11SP
9,Janssenlei 17,2022-08-12,04:00:00,18,18,0,F11SP
9,Janssenlei 17,2022-08-12,05:00:00,72,42,30,F11SP
9,Janssenlei 17,2022-08-12,06:00:00,162,100,62,F11SP
9,Janssenlei 17,2022-08-12,07:00:00,430,238,192,F11SP
9,Janssenlei 17,2022-08-12,08:00:00,430,252,178,F11SP
9,Janssenlei 17,2022-08-12,09:00:00,384,174,210,F11SP
9,Janssenlei 17,2022-08-12,10:00:00,388,204,184,F11SP
9,Janssenlei 17,2022-08-12,11:00:00,290,168,122,F11SP
9,Janssenlei 17,2022-08-12,12:00:00,294,128,166,F11SP
9,Janssenlei 17,2022-08-12,13:00:00,294,112,182,F11SP
9,Janssenlei 17,2022-08-12,14:00:00,286,110,176,F11SP
9,Janssenlei 17,2022-08-12,15:00:00,336,192,144,F11SP
9,Janssenlei 17,2022-08-12,16:00:00,416,166,250,F11SP
9,Janssenlei 17,2022-08-12,17:00:00,496,208,288,F11SP
9,Janssenlei 17,2022-08-12,18:00:00,306,110,196,F11SP
9,Janssenlei 17,2022-08-12,19:00:00,224,114,110,F11SP
9,Janssenlei 17,2022-08-12,20:00:00,330,160,170,F11SP
9,Janssenlei 17,2022-08-12,21:00:00,196,132,64,F11SP
9,Janssenlei 17,2022-08-12,22:00:00,186,86,100,F11SP
9,Janssenlei 17,2022-08-12,23:00:00,56,24,32,F11SP
9,Janssenlei 17,2022-08-13,00:00:00,62,14,48,F11SP
9,Janssenlei 17,2022-08-13,01:00:00,46,16,30,F11SP
9,Janssenlei 17,2022-08-13,02:00:00,26,16,10,F11SP
9,Janssenlei 17,2022-08-13,03:00:00,14,4,10,F11SP
9,Janssenlei 17,2022-08-13,04:00:00,16,12,4,F11SP
9,Janssenlei 17,2022-08-13,05:00:00,30,16,14,F11SP
9,Janssenlei 17,2022-08-13,06:00:00,52,12,40,F11SP
9,Janssenlei 17,2022-08-13,07:00:00,160,78,82,F11SP
9,Janssenlei 17,2022-08-13,08:00:00,258,100,158,F11SP
9,Janssenlei 17,2022-08-13,09:00:00,386,156,230,F11SP
9,Janssenlei 17,2022-08-13,10:00:00,522,196,326,F11SP
9,Janssenlei 17,2022-08-13,11:00:00,484,320,164,F11SP
9,Janssenlei 17,2022-08-13,12:00:00,318,214,104,F11SP
9,Janssenlei 17,2022-08-13,13:00:00,374,216,158,F11SP
9,Janssenlei 17,2022-08-13,14:00:00,320,158,162,F11SP
9,Janssenlei 17,2022-08-13,15:00:00,332,168,164,F11SP
9,Janssenlei 17,2022-08-13,16:00:00,298,134,164,F11SP
9,Janssenlei 17,2022-08-13,17:00:00,190,78,112,F11SP
9,Janssenlei 17,2022-08-13,18:00:00,256,146,110,F11SP
9,Janssenlei 17,2022-08-13,19:00:00,156,50,106,F11SP
9,Janssenlei 17,2022-08-13,20:00:00,226,92,134,F11SP
9,Janssenlei 17,2022-08-13,21:00:00,168,98,70,F11SP
9,Janssenlei 17,2022-08-13,22:00:00,130,66,64,F11SP
9,Janssenlei 17,2022-08-13,23:00:00,54,12,42,F11SP
9,Janssenlei 17,2022-08-14,00:00:00,56,30,26,F11SP
9,Janssenlei 17,2022-08-14,01:00:00,50,20,30,F11SP
9,Janssenlei 17,2022-08-14,02:00:00,24,8,16,F11SP
9,Janssenlei 17,2022-08-14,03:00:00,14,0,14,F11SP
9,Janssenlei 17,2022-08-14,04:00:00,10,2,8,F11SP
9,Janssenlei 17,2022-08-14,05:00:00,26,20,6,F11SP
9,Janssenlei 17,2022-08-14,06:00:00,90,34,56,F11SP
9,Janssenlei 17,2022-08-14,07:00:00,178,68,110,F11SP
9,Janssenlei 17,2022-08-14,08:00:00,304,84,220,F11SP
9,Janssenlei 17,2022-08-14,09:00:00,538,212,326,F11SP
9,Janssenlei 17,2022-08-14,10:00:00,626,298,328,F11SP
9,Janssenlei 17,2022-08-14,11:00:00,440,258,182,F11SP
9,Janssenlei 17,2022-08-14,12:00:00,392,244,148,F11SP
9,Janssenlei 17,2022-08-14,13:00:00,352,250,102,F11SP
9,Janssenlei 17,2022-08-14,14:00:00,328,152,176,F11SP
9,Janssenlei 17,2022-08-14,15:00:00,306,136,170,F11SP
9,Janssenlei 17,2022-08-14,16:00:00,254,148,106,F11SP
9,Janssenlei 17,2022-08-14,17:00:00,266,142,124,F11SP
9,Janssenlei 17,2022-08-14,18:00:00,188,82,106,F11SP
9,Janssenlei 17,2022-08-14,19:00:00,232,112,120,F11SP
9,Janssenlei 17,2022-08-14,20:00:00,250,134,116,F11SP
9,Janssenlei 17,2022-08-14,21:00:00,174,100,74,F11SP
9,Janssenlei 17,2022-08-14,22:00:00,124,28,96,F11SP
9,Janssenlei 17,2022-08-14,23:00:00,56,18,38,F11SP
9,Janssenlei 17,2022-08-15,00:00:00,46,22,24,F11SP
9,Janssenlei 17,2022-08-15,01:00:00,28,16,12,F11SP
9,Janssenlei 17,2022-08-15,02:00:00,26,14,12,F11SP
9,Janssenlei 17,2022-08-15,03:00:00,12,8,4,F11SP
9,Janssenlei 17,2022-08-15,04:00:00,18,18,0,F11SP
9,Janssenlei 17,2022-08-15,05:00:00,14,8,6,F11SP
9,Janssenlei 17,2022-08-15,06:00:00,30,4,26,F11SP
9,Janssenlei 17,2022-08-15,07:00:00,58,20,38,F11SP
9,Janssenlei 17,2022-08-15,08:00:00,122,56,66,F11SP
9,Janssenlei 17,2022-08-15,09:00:00,286,126,160,F11SP
9,Janssenlei 17,2022-08-15,10:00:00,370,198,172,F11SP
9,Janssenlei 17,2022-08-15,11:00:00,418,230,188,F11SP
9,Janssenlei 17,2022-08-15,12:00:00,446,256,190,F11SP
9,Janssenlei 17,2022-08-15,13:00:00,422,226,196,F11SP
9,Janssenlei 17,2022-08-15,14:00:00,538,198,340,F11SP
9,Janssenlei 17,2022-08-15,15:00:00,554,276,278,F11SP
9,Janssenlei 17,2022-08-15,16:00:00,338,188,150,F11SP
9,Janssenlei 17,2022-08-15,17:00:00,298,150,148,F11SP
9,Janssenlei 17,2022-08-15,18:00:00,246,108,138,F11SP
9,Janssenlei 17,2022-08-15,19:00:00,190,100,90,F11SP
9,Janssenlei 17,2022-08-15,20:00:00,198,106,92,F11SP
9,Janssenlei 17,2022-08-15,21:00:00,96,54,42,F11SP
9,Janssenlei 17,2022-08-15,22:00:00,88,36,52,F11SP
9,Janssenlei 17,2022-08-15,23:00:00,28,8,20,F11SP
9,Janssenlei 17,2022-08-16,00:00:00,14,4,10,F11SP
9,Janssenlei 17,2022-08-16,01:00:00,16,4,12,F11SP
9,Janssenlei 17,2022-08-16,02:00:00,4,0,4,F11SP
9,Janssenlei 17,2022-08-16,03:00:00,10,4,6,F11SP
9,Janssenlei 17,2022-08-16,04:00:00,36,26,10,F11SP
9,Janssenlei 17,2022-08-16,05:00:00,68,48,20,F11SP
9,Janssenlei 17,2022-08-16,06:00:00,182,118,64,F11SP
9,Janssenlei 17,2022-08-16,07:00:00,468,348,120,F11SP
9,Janssenlei 17,2022-08-16,08:00:00,550,366,184,F11SP
9,Janssenlei 17,2022-08-16,09:00:00,334,178,156,F11SP
9,Janssenlei 17,2022-08-16,10:00:00,392,198,194,F11SP
9,Janssenlei 17,2022-08-16,11:00:00,368,196,172,F11SP
9,Janssenlei 17,2022-08-16,12:00:00,392,192,200,F11SP
9,Janssenlei 17,2022-08-16,13:00:00,370,188,182,F11SP
9,Janssenlei 17,2022-08-16,14:00:00,438,178,260,F11SP
9,Janssenlei 17,2022-08-16,15:00:00,432,204,228,F11SP
9,Janssenlei 17,2022-08-16,16:00:00,564,236,328,F11SP
9,Janssenlei 17,2022-08-16,17:00:00,766,304,462,F11SP
9,Janssenlei 17,2022-08-16,18:00:00,534,160,374,F11SP
9,Janssenlei 17,2022-08-16,19:00:00,358,136,222,F11SP
9,Janssenlei 17,2022-08-16,20:00:00,340,254,86,F11SP
9,Janssenlei 17,2022-08-16,21:00:00,212,124,88,F11SP
9,Janssenlei 17,2022-08-16,22:00:00,130,50,80,F11SP
9,Janssenlei 17,2022-08-16,23:00:00,38,18,20,F11SP
9,Janssenlei 17,2022-08-17,00:00:00,24,16,8,F11SP
9,Janssenlei 17,2022-08-17,01:00:00,22,12,10,F11SP
9,Janssenlei 17,2022-08-17,02:00:00,6,2,4,F11SP
9,Janssenlei 17,2022-08-17,03:00:00,10,8,2,F11SP
9,Janssenlei 17,2022-08-17,04:00:00,12,8,4,F11SP
9,Janssenlei 17,2022-08-17,05:00:00,78,58,20,F11SP
9,Janssenlei 17,2022-08-17,06:00:00,160,124,36,F11SP
9,Janssenlei 17,2022-08-17,07:00:00,362,260,102,F11SP
9,Janssenlei 17,2022-08-17,08:00:00,338,226,112,F11SP
9,Janssenlei 17,2022-08-17,09:00:00,178,98,80,F11SP
9,Janssenlei 17,2022-08-17,10:00:00,124,58,66,F11SP
9,Janssenlei 17,2022-08-17,11:00:00,78,34,44,F11SP
9,Janssenlei 17,2022-08-17,12:00:00,122,44,78,F11SP
9,Janssenlei 17,2022-08-17,13:00:00,186,108,78,F11SP
9,Janssenlei 17,2022-08-17,14:00:00,196,92,104,F11SP
9,Janssenlei 17,2022-08-17,15:00:00,244,92,152,F11SP
9,Janssenlei 17,2022-08-17,16:00:00,312,140,172,F11SP
9,Janssenlei 17,2022-08-17,17:00:00,438,170,268,F11SP
9,Janssenlei 17,2022-08-17,18:00:00,284,134,150,F11SP
9,Janssenlei 17,2022-08-17,19:00:00,174,94,80,F11SP
9,Janssenlei 17,2022-08-17,20:00:00,174,102,72,F11SP
9,Janssenlei 17,2022-08-17,21:00:00,106,56,50,F11SP
9,Janssenlei 17,2022-08-17,22:00:00,40,10,30,F11SP
9,Janssenlei 17,2022-08-17,23:00:00,52,12,40,F11SP
9,Janssenlei 17,2022-08-18,00:00:00,24,16,8,F11SP
9,Janssenlei 17,2022-08-18,01:00:00,8,4,4,F11SP
9,Janssenlei 17,2022-08-18,02:00:00,0,0,0,F11SP
9,Janssenlei 17,2022-08-18,03:00:00,8,4,4,F11SP
9,Janssenlei 17,2022-08-18,04:00:00,20,18,2,F11SP
9,Janssenlei 17,2022-08-18,05:00:00,78,46,32,F11SP
9,Janssenlei 17,2022-08-18,06:00:00,162,110,52,F11SP
9,Janssenlei 17,2022-08-18,07:00:00,506,370,136,F11SP
9,Janssenlei 17,2022-08-18,08:00:00,498,358,140,F11SP
9,Janssenlei 17,2022-08-18,09:00:00,276,156,120,F11SP
9,Janssenlei 17,2022-08-18,10:00:00,272,130,142,F11SP
9,Janssenlei 17,2022-08-18,11:00:00,328,180,148,F11SP
9,Janssenlei 17,2022-08-18,12:00:00,300,152,148,F11SP
9,Janssenlei 17,2022-08-18,13:00:00,400,208,192,F11SP
9,Janssenlei 17,2022-08-18,14:00:00,536,246,290,F11SP
9,Janssenlei 17,2022-08-18,15:00:00,446,162,284,F11SP
9,Janssenlei 17,2022-08-18,16:00:00,756,292,464,F11SP
9,Janssenlei 17,2022-08-18,17:00:00,880,362,518,F11SP
9,Janssenlei 17,2022-08-18,18:00:00,598,236,362,F11SP
9,Janssenlei 17,2022-08-18,19:00:00,426,180,246,F11SP
9,Janssenlei 17,2022-08-18,20:00:00,510,248,262,F11SP
9,Janssenlei 17,2022-08-18,21:00:00,196,118,78,F11SP
9,Janssenlei 17,2022-08-18,22:00:00,134,54,80,F11SP
9,Janssenlei 17,2022-08-18,23:00:00,154,126,28,F11SP
9,Janssenlei 17,2022-08-19,00:00:00,86,76,10,F11SP
9,Janssenlei 17,2022-08-19,01:00:00,30,20,10,F11SP
9,Janssenlei 17,2022-08-19,02:00:00,10,0,10,F11SP
9,Janssenlei 17,2022-08-19,03:00:00,16,4,12,F11SP
9,Janssenlei 17,2022-08-19,04:00:00,8,8,0,F11SP
9,Janssenlei 17,2022-08-19,05:00:00,74,44,30,F11SP
9,Janssenlei 17,2022-08-19,06:00:00,128,86,42,F11SP
9,Janssenlei 17,2022-08-19,07:00:00,312,198,114,F11SP
9,Janssenlei 17,2022-08-19,08:00:00,452,282,170,F11SP
9,Janssenlei 17,2022-08-19,09:00:00,234,132,102,F11SP
9,Janssenlei 17,2022-08-19,10:00:00,206,110,96,F11SP
9,Janssenlei 17,2022-08-19,11:00:00,254,124,130,F11SP
9,Janssenlei 17,2022-08-19,12:00:00,306,162,144,F11SP
9,Janssenlei 17,2022-08-19,13:00:00,206,82,124,F11SP
9,Janssenlei 17,2022-08-19,14:00:00,222,94,128,F11SP
9,Janssenlei 17,2022-08-19,15:00:00,284,118,166,F11SP
9,Janssenlei 17,2022-08-19,16:00:00,444,182,262,F11SP
9,Janssenlei 17,2022-08-19,17:00:00,340,148,192,F11SP
9,Janssenlei 17,2022-08-19,18:00:00,300,140,160,F11SP
9,Janssenlei 17,2022-08-19,19:00:00,122,78,44,F11SP
9,Janssenlei 17,2022-08-19,20:00:00,82,48,34,F11SP
9,Janssenlei 17,2022-08-19,21:00:00,80,38,42,F11SP
9,Janssenlei 17,2022-08-19,22:00:00,38,6,32,F11SP
9,Janssenlei 17,2022-08-19,23:00:00,28,18,10,F11SP
9,Janssenlei 17,2022-08-20,00:00:00,26,8,18,F11SP
9,Janssenlei 17,2022-08-20,01:00:00,24,20,4,F11SP
9,Janssenlei 17,2022-08-20,02:00:00,16,16,0,F11SP
9,Janssenlei 17,2022-08-20,03:00:00,8,8,0,F11SP
9,Janssenlei 17,2022-08-20,04:00:00,4,4,0,F11SP
9,Janssenlei 17,2022-08-20,05:00:00,42,20,22,F11SP
9,Janssenlei 17,2022-08-20,06:00:00,30,26,4,F11SP
9,Janssenlei 17,2022-08-20,07:00:00,56,20,36,F11SP
9,Janssenlei 17,2022-08-20,08:00:00,172,66,106,F11SP
9,Janssenlei 17,2022-08-20,09:00:00,232,100,132,F11SP
9,Janssenlei 17,2022-08-20,10:00:00,432,208,224,F11SP
9,Janssenlei 17,2022-08-20,11:00:00,518,266,252,F11SP
9,Janssenlei 17,2022-08-20,12:00:00,488,284,204,F11SP
9,Janssenlei 17,2022-08-20,13:00:00,524,230,294,F11SP
9,Janssenlei 17,2022-08-20,14:00:00,698,242,456,F11SP
9,Janssenlei 17,2022-08-20,15:00:00,512,264,248,F11SP
9,Janssenlei 17,2022-08-20,16:00:00,574,328,246,F11SP
9,Janssenlei 17,2022-08-20,17:00:00,340,148,192,F11SP
9,Janssenlei 17,2022-08-20,18:00:00,262,176,86,F11SP
9,Janssenlei 17,2022-08-20,19:00:00,222,134,88,F11SP
9,Janssenlei 17,2022-08-20,20:00:00,150,86,64,F11SP
9,Janssenlei 17,2022-08-20,21:00:00,104,74,30,F11SP
9,Janssenlei 17,2022-08-20,22:00:00,76,32,44,F11SP
9,Janssenlei 17,2022-08-20,23:00:00,28,0,28,F11SP
9,Janssenlei 17,2022-08-21,00:00:00,28,10,18,F11SP
9,Janssenlei 17,2022-08-21,01:00:00,22,6,16,F11SP
9,Janssenlei 17,2022-08-21,02:00:00,14,12,2,F11SP
9,Janssenlei 17,2022-08-21,03:00:00,8,0,8,F11SP
9,Janssenlei 17,2022-08-21,04:00:00,12,8,4,F11SP
9,Janssenlei 17,2022-08-21,05:00:00,20,16,4,F11SP
9,Janssenlei 17,2022-08-21,06:00:00,28,16,12,F11SP
9,Janssenlei 17,2022-08-21,07:00:00,110,24,86,F11SP
9,Janssenlei 17,2022-08-21,08:00:00,164,60,104,F11SP
9,Janssenlei 17,2022-08-21,09:00:00,500,210,290,F11SP
9,Janssenlei 17,2022-08-21,10:00:00,564,260,304,F11SP
9,Janssenlei 17,2022-08-21,11:00:00,640,352,288,F11SP
9,Janssenlei 17,2022-08-21,12:00:00,644,412,232,F11SP
9,Janssenlei 17,2022-08-21,13:00:00,698,360,338,F11SP
9,Janssenlei 17,2022-08-21,14:00:00,860,420,440,F11SP
9,Janssenlei 17,2022-08-21,15:00:00,536,270,266,F11SP
9,Janssenlei 17,2022-08-21,16:00:00,650,402,248,F11SP
9,Janssenlei 17,2022-08-21,17:00:00,502,336,166,F11SP
9,Janssenlei 17,2022-08-21,18:00:00,420,236,184,F11SP
9,Janssenlei 17,2022-08-21,19:00:00,240,138,102,F11SP
9,Janssenlei 17,2022-08-21,20:00:00,154,88,66,F11SP
9,Janssenlei 17,2022-08-21,21:00:00,84,30,54,F11SP
9,Janssenlei 17,2022-08-21,22:00:00,48,16,32,F11SP
9,Janssenlei 17,2022-08-21,23:00:00,26,18,8,F11SP
9,Janssenlei 17,2022-08-22,00:00:00,20,14,6,F11SP
9,Janssenlei 17,2022-08-22,01:00:00,8,0,8,F11SP
9,Janssenlei 17,2022-08-22,02:00:00,0,0,0,F11SP
9,Janssenlei 17,2022-08-22,03:00:00,4,4,0,F11SP
9,Janssenlei 17,2022-08-22,04:00:00,20,12,8,F11SP
9,Janssenlei 17,2022-08-22,05:00:00,82,62,20,F11SP
9,Janssenlei 17,2022-08-22,06:00:00,188,112,76,F11SP
9,Janssenlei 17,2022-08-22,07:00:00,528,386,142,F11SP
9,Janssenlei 17,2022-08-22,08:00:00,552,338,214,F11SP
9,Janssenlei 17,2022-08-22,09:00:00,234,122,112,F11SP
9,Janssenlei 17,2022-08-22,10:00:00,174,86,88,F11SP
9,Janssenlei 17,2022-08-22,11:00:00,310,154,156,F11SP
9,Janssenlei 17,2022-08-22,12:00:00,268,100,168,F11SP
9,Janssenlei 17,2022-08-22,13:00:00,394,230,164,F11SP
9,Janssenlei 17,2022-08-22,14:00:00,488,176,312,F11SP
9,Janssenlei 17,2022-08-22,15:00:00,504,192,312,F11SP
9,Janssenlei 17,2022-08-22,16:00:00,794,346,448,F11SP
9,Janssenlei 17,2022-08-22,17:00:00,760,294,466,F11SP
9,Janssenlei 17,2022-08-22,18:00:00,424,190,234,F11SP
9,Janssenlei 17,2022-08-22,19:00:00,336,170,166,F11SP
9,Janssenlei 17,2022-08-22,20:00:00,308,164,144,F11SP
9,Janssenlei 17,2022-08-22,21:00:00,158,92,66,F11SP
9,Janssenlei 17,2022-08-22,22:00:00,98,36,62,F11SP
9,Janssenlei 17,2022-08-22,23:00:00,40,8,32,F11SP
9,Janssenlei 17,2022-08-23,00:00:00,8,2,6,F11SP
9,Janssenlei 17,2022-08-23,01:00:00,8,4,4,F11SP
9,Janssenlei 17,2022-08-23,02:00:00,14,4,10,F11SP
9,Janssenlei 17,2022-08-23,03:00:00,8,8,0,F11SP
9,Janssenlei 17,2022-08-23,04:00:00,22,18,4,F11SP
9,Janssenlei 17,2022-08-23,05:00:00,86,70,16,F11SP
9,Janssenlei 17,2022-08-23,06:00:00,236,154,82,F11SP
9,Janssenlei 17,2022-08-23,07:00:00,582,386,196,F11SP
9,Janssenlei 17,2022-08-23,08:00:00,698,434,264,F11SP
9,Janssenlei 17,2022-08-23,09:00:00,370,180,190,F11SP
9,Janssenlei 17,2022-08-23,10:00:00,266,148,118,F11SP
9,Janssenlei 17,2022-08-23,11:00:00,310,150,160,F11SP
9,Janssenlei 17,2022-08-23,12:00:00,230,98,132,F11SP
9,Janssenlei 17,2022-08-23,13:00:00,352,156,196,F11SP
9,Janssenlei 17,2022-08-23,14:00:00,460,228,232,F11SP
9,Janssenlei 17,2022-08-23,15:00:00,446,200,246,F11SP
9,Janssenlei 17,2022-08-23,16:00:00,742,254,488,F11SP
9,Janssenlei 17,2022-08-23,17:00:00,812,308,504,F11SP
9,Janssenlei 17,2022-08-23,18:00:00,540,216,324,F11SP
9,Janssenlei 17,2022-08-23,19:00:00,412,184,228,F11SP
9,Janssenlei 17,2022-08-23,20:00:00,418,282,136,F11SP
9,Janssenlei 17,2022-08-23,21:00:00,172,134,38,F11SP
9,Janssenlei 17,2022-08-23,22:00:00,86,30,56,F11SP
9,Janssenlei 17,2022-08-23,23:00:00,60,10,50,F11SP
9,Janssenlei 17,2022-08-24,00:00:00,24,4,20,F11SP
9,Janssenlei 17,2022-08-24,01:00:00,8,4,4,F11SP
9,Janssenlei 17,2022-08-24,02:00:00,10,6,4,F11SP
9,Janssenlei 17,2022-08-24,03:00:00,24,12,12,F11SP
9,Janssenlei 17,2022-08-24,04:00:00,28,20,8,F11SP
9,Janssenlei 17,2022-08-24,05:00:00,76,58,18,F11SP
9,Janssenlei 17,2022-08-24,06:00:00,222,152,70,F11SP
9,Janssenlei 17,2022-08-24,07:00:00,548,336,212,F11SP
9,Janssenlei 17,2022-08-24,08:00:00,582,372,210,F11SP
9,Janssenlei 17,2022-08-24,09:00:00,476,288,188,F11SP
9,Janssenlei 17,2022-08-24,10:00:00,394,216,178,F11SP
9,Janssenlei 17,2022-08-24,11:00:00,250,186,64,F11SP
9,Janssenlei 17,2022-08-24,12:00:00,432,172,260,F11SP
9,Janssenlei 17,2022-08-24,13:00:00,320,160,160,F11SP
9,Janssenlei 17,2022-08-24,14:00:00,474,230,244,F11SP
9,Janssenlei 17,2022-08-24,15:00:00,440,180,260,F11SP
9,Janssenlei 17,2022-08-24,16:00:00,574,212,362,F11SP
9,Janssenlei 17,2022-08-24,17:00:00,668,230,438,F11SP
9,Janssenlei 17,2022-08-24,18:00:00,660,300,360,F11SP
9,Janssenlei 17,2022-08-24,19:00:00,470,232,238,F11SP
9,Janssenlei 17,2022-08-24,20:00:00,394,244,150,F11SP
9,Janssenlei 17,2022-08-24,21:00:00,230,148,82,F11SP
9,Janssenlei 17,2022-08-24,22:00:00,114,30,84,F11SP
9,Janssenlei 17,2022-08-24,23:00:00,40,10,30,F11SP
9,Janssenlei 17,2022-08-25,00:00:00,28,12,16,F11SP
9,Janssenlei 17,2022-08-25,01:00:00,18,8,10,F11SP
9,Janssenlei 17,2022-08-25,02:00:00,12,0,12,F11SP
9,Janssenlei 17,2022-08-25,03:00:00,20,10,10,F11SP
9,Janssenlei 17,2022-08-25,04:00:00,24,20,4,F11SP
9,Janssenlei 17,2022-08-25,05:00:00,92,72,20,F11SP
9,Janssenlei 17,2022-08-25,06:00:00,210,136,74,F11SP
9,Janssenlei 17,2022-08-25,07:00:00,600,394,206,F11SP
9,Janssenlei 17,2022-08-25,08:00:00,698,458,240,F11SP
9,Janssenlei 17,2022-08-25,09:00:00,450,246,204,F11SP
9,Janssenlei 17,2022-08-25,10:00:00,344,194,150,F11SP
9,Janssenlei 17,2022-08-25,11:00:00,322,166,156,F11SP
9,Janssenlei 17,2022-08-25,12:00:00,274,156,118,F11SP
9,Janssenlei 17,2022-08-25,13:00:00,156,90,66,F11SP
9,Janssenlei 17,2022-08-25,14:00:00,334,110,224,F11SP
9,Janssenlei 17,2022-08-25,15:00:00,456,166,290,F11SP
9,Janssenlei 17,2022-08-25,16:00:00,596,200,396,F11SP
9,Janssenlei 17,2022-08-25,17:00:00,810,280,530,F11SP
9,Janssenlei 17,2022-08-25,18:00:00,594,260,334,F11SP
9,Janssenlei 17,2022-08-25,19:00:00,310,184,126,F11SP
9,Janssenlei 17,2022-08-25,20:00:00,382,216,166,F11SP
9,Janssenlei 17,2022-08-25,21:00:00,170,98,72,F11SP
9,Janssenlei 17,2022-08-25,22:00:00,86,34,52,F11SP
9,Janssenlei 17,2022-08-25,23:00:00,58,20,38,F11SP
9,Janssenlei 17,2022-08-26,00:00:00,24,12,12,F11SP
9,Janssenlei 17,2022-08-26,01:00:00,28,4,24,F11SP
9,Janssenlei 17,2022-08-26,02:00:00,12,0,12,F11SP
9,Janssenlei 17,2022-08-26,03:00:00,0,0,0,F11SP
9,Janssenlei 17,2022-08-26,04:00:00,32,26,6,F11SP
9,Janssenlei 17,2022-08-26,05:00:00,64,50,14,F11SP
9,Janssenlei 17,2022-08-26,06:00:00,108,76,32,F11SP
9,Janssenlei 17,2022-08-26,07:00:00,350,210,140,F11SP
9,Janssenlei 17,2022-08-26,08:00:00,492,300,192,F11SP
9,Janssenlei 17,2022-08-26,09:00:00,208,102,106,F11SP
9,Janssenlei 17,2022-08-26,10:00:00,214,98,116,F11SP
9,Janssenlei 17,2022-08-26,11:00:00,214,112,102,F11SP
9,Janssenlei 17,2022-08-26,12:00:00,266,110,156,F11SP
9,Janssenlei 17,2022-08-26,13:00:00,232,126,106,F11SP
9,Janssenlei 17,2022-08-26,14:00:00,384,190,194,F11SP
9,Janssenlei 17,2022-08-26,15:00:00,368,156,212,F11SP
9,Janssenlei 17,2022-08-26,16:00:00,628,270,358,F11SP
9,Janssenlei 17,2022-08-26,17:00:00,528,212,316,F11SP
9,Janssenlei 17,2022-08-26,18:00:00,364,142,222,F11SP
9,Janssenlei 17,2022-08-26,19:00:00,278,108,170,F11SP
9,Janssenlei 17,2022-08-26,20:00:00,232,110,122,F11SP
9,Janssenlei 17,2022-08-26,21:00:00,130,56,74,F11SP
9,Janssenlei 17,2022-08-26,22:00:00,90,56,34,F11SP
9,Janssenlei 17,2022-08-26,23:00:00,68,46,22,F11SP
9,Janssenlei 17,2022-08-27,00:00:00,24,6,18,F11SP
9,Janssenlei 17,2022-08-27,01:00:00,4,2,2,F11SP
9,Janssenlei 17,2022-08-27,02:00:00,20,10,10,F11SP
9,Janssenlei 17,2022-08-27,03:00:00,42,18,24,F11SP
9,Janssenlei 17,2022-08-27,04:00:00,8,8,0,F11SP
9,Janssenlei 17,2022-08-27,05:00:00,24,16,8,F11SP
9,Janssenlei 17,2022-08-27,06:00:00,24,20,4,F11SP
9,Janssenlei 17,2022-08-27,07:00:00,74,30,44,F11SP
9,Janssenlei 17,2022-08-27,08:00:00,184,80,104,F11SP
9,Janssenlei 17,2022-08-27,09:00:00,346,116,230,F11SP
9,Janssenlei 17,2022-08-27,10:00:00,402,152,250,F11SP
9,Janssenlei 17,2022-08-27,11:00:00,446,220,226,F11SP
9,Janssenlei 17,2022-08-27,12:00:00,518,216,302,F11SP
9,Janssenlei 17,2022-08-27,13:00:00,506,216,290,F11SP
9,Janssenlei 17,2022-08-27,14:00:00,608,282,326,F11SP
9,Janssenlei 17,2022-08-27,15:00:00,524,254,270,F11SP
9,Janssenlei 17,2022-08-27,16:00:00,412,168,244,F11SP
9,Janssenlei 17,2022-08-27,17:00:00,334,186,148,F11SP
9,Janssenlei 17,2022-08-27,18:00:00,284,132,152,F11SP
9,Janssenlei 17,2022-08-27,19:00:00,210,94,116,F11SP
9,Janssenlei 17,2022-08-27,20:00:00,170,114,56,F11SP
9,Janssenlei 17,2022-08-27,21:00:00,124,80,44,F11SP
9,Janssenlei 17,2022-08-27,22:00:00,52,22,30,F11SP
9,Janssenlei 17,2022-08-27,23:00:00,36,12,24,F11SP
9,Janssenlei 17,2022-08-28,00:00:00,20,6,14,F11SP
9,Janssenlei 17,2022-08-28,01:00:00,18,8,10,F11SP
9,Janssenlei 17,2022-08-28,02:00:00,22,8,14,F11SP
9,Janssenlei 17,2022-08-28,03:00:00,10,4,6,F11SP
9,Janssenlei 17,2022-08-28,04:00:00,4,0,4,F11SP
9,Janssenlei 17,2022-08-28,05:00:00,30,18,12,F11SP
9,Janssenlei 17,2022-08-28,06:00:00,46,28,18,F11SP
9,Janssenlei 17,2022-08-28,07:00:00,92,36,56,F11SP
9,Janssenlei 17,2022-08-28,08:00:00,218,74,144,F11SP
9,Janssenlei 17,2022-08-28,09:00:00,350,116,234,F11SP
9,Janssenlei 17,2022-08-28,10:00:00,534,216,318,F11SP
9,Janssenlei 17,2022-08-28,11:00:00,584,240,344,F11SP
9,Janssenlei 17,2022-08-28,12:00:00,474,264,210,F11SP
9,Janssenlei 17,2022-08-28,13:00:00,594,318,276,F11SP
9,Janssenlei 17,2022-08-28,14:00:00,662,300,362,F11SP
9,Janssenlei 17,2022-08-28,15:00:00,564,246,318,F11SP
9,Janssenlei 17,2022-08-28,16:00:00,516,310,206,F11SP
9,Janssenlei 17,2022-08-28,17:00:00,498,234,264,F11SP
9,Janssenlei 17,2022-08-28,18:00:00,340,154,186,F11SP
9,Janssenlei 17,2022-08-28,19:00:00,226,64,162,F11SP
9,Janssenlei 17,2022-08-28,20:00:00,132,66,66,F11SP
9,Janssenlei 17,2022-08-28,21:00:00,88,40,48,F11SP
9,Janssenlei 17,2022-08-28,22:00:00,40,14,26,F11SP
9,Janssenlei 17,2022-08-28,23:00:00,26,14,12,F11SP
9,Janssenlei 17,2022-08-29,00:00:00,10,0,10,F11SP
9,Janssenlei 17,2022-08-29,01:00:00,0,0,0,F11SP
9,Janssenlei 17,2022-08-29,02:00:00,0,0,0,F11SP
9,Janssenlei 17,2022-08-29,03:00:00,6,6,0,F11SP
9,Janssenlei 17,2022-08-29,04:00:00,14,10,4,F11SP
9,Janssenlei 17,2022-08-29,05:00:00,60,40,20,F11SP
9,Janssenlei 17,2022-08-29,06:00:00,194,144,50,F11SP
9,Janssenlei 17,2022-08-29,07:00:00,484,336,148,F11SP
9,Janssenlei 17,2022-08-29,08:00:00,614,362,252,F11SP
9,Janssenlei 17,2022-08-29,09:00:00,228,146,82,F11SP
9,Janssenlei 17,2022-08-29,10:00:00,272,130,142,F11SP
9,Janssenlei 17,2022-08-29,11:00:00,264,134,130,F11SP
9,Janssenlei 17,2022-08-29,12:00:00,304,112,192,F11SP
9,Janssenlei 17,2022-08-29,13:00:00,320,126,194,F11SP
9,Janssenlei 17,2022-08-29,14:00:00,514,188,326,F11SP
9,Janssenlei 17,2022-08-29,15:00:00,508,200,308,F11SP
9,Janssenlei 17,2022-08-29,16:00:00,764,334,430,F11SP
9,Janssenlei 17,2022-08-29,17:00:00,814,264,550,F11SP
9,Janssenlei 17,2022-08-29,18:00:00,554,228,326,F11SP
9,Janssenlei 17,2022-08-29,19:00:00,274,98,176,F11SP
9,Janssenlei 17,2022-08-29,20:00:00,278,128,150,F11SP
9,Janssenlei 17,2022-08-29,21:00:00,148,56,92,F11SP
9,Janssenlei 17,2022-08-29,22:00:00,76,22,54,F11SP
9,Janssenlei 17,2022-08-29,23:00:00,40,16,24,F11SP
9,Janssenlei 17,2022-08-30,00:00:00,12,4,8,F11SP
9,Janssenlei 17,2022-08-30,01:00:00,10,0,10,F11SP
9,Janssenlei 17,2022-08-30,02:00:00,10,4,6,F11SP
9,Janssenlei 17,2022-08-30,03:00:00,18,18,0,F11SP
9,Janssenlei 17,2022-08-30,04:00:00,20,16,4,F11SP
9,Janssenlei 17,2022-08-30,05:00:00,70,46,24,F11SP
9,Janssenlei 17,2022-08-30,06:00:00,192,130,62,F11SP
9,Janssenlei 17,2022-08-30,07:00:00,524,346,178,F11SP
9,Janssenlei 17,2022-08-30,08:00:00,716,450,266,F11SP
9,Janssenlei 17,2022-08-30,09:00:00,304,170,134,F11SP
9,Janssenlei 17,2022-08-30,10:00:00,242,124,118,F11SP
9,Janssenlei 17,2022-08-30,11:00:00,326,156,170,F11SP
9,Janssenlei 17,2022-08-30,12:00:00,294,142,152,F11SP
9,Janssenlei 17,2022-08-30,13:00:00,498,198,300,F11SP
9,Janssenlei 17,2022-08-30,14:00:00,606,226,380,F11SP
9,Janssenlei 17,2022-08-30,15:00:00,482,144,338,F11SP
9,Janssenlei 17,2022-08-30,16:00:00,780,316,464,F11SP
9,Janssenlei 17,2022-08-30,17:00:00,956,354,602,F11SP
9,Janssenlei 17,2022-08-30,18:00:00,750,268,482,F11SP
9,Janssenlei 17,2022-08-30,19:00:00,446,210,236,F11SP
9,Janssenlei 17,2022-08-30,20:00:00,272,142,130,F11SP
9,Janssenlei 17,2022-08-30,21:00:00,170,80,90,F11SP
9,Janssenlei 17,2022-08-30,22:00:00,106,54,52,F11SP
9,Janssenlei 17,2022-08-30,23:00:00,50,10,40,F11SP
9,Janssenlei 17,2022-08-31,00:00:00,18,14,4,F11SP
9,Janssenlei 17,2022-08-31,01:00:00,22,8,14,F11SP
9,Janssenlei 17,2022-08-31,02:00:00,0,0,0,F11SP
9,Janssenlei 17,2022-08-31,03:00:00,4,4,0,F11SP
9,Janssenlei 17,2022-08-31,04:00:00,24,22,2,F11SP
9,Janssenlei 17,2022-08-31,05:00:00,72,46,26,F11SP
9,Janssenlei 17,2022-08-31,06:00:00,180,116,64,F11SP
9,Janssenlei 17,2022-08-31,07:00:00,460,290,170,F11SP
9,Janssenlei 17,2022-08-31,08:00:00,524,336,188,F11SP
9,Janssenlei 17,2022-08-31,09:00:00,340,158,182,F11SP
9,Janssenlei 17,2022-08-31,10:00:00,428,264,164,F11SP
9,Janssenlei 17,2022-08-31,11:00:00,368,180,188,F11SP
9,Janssenlei 17,2022-08-31,12:00:00,436,130,306,F11SP
9,Janssenlei 17,2022-08-31,13:00:00,486,212,274,F11SP
9,Janssenlei 17,2022-08-31,14:00:00,568,228,340,F11SP
9,Janssenlei 17,2022-08-31,15:00:00,728,302,426,F11SP
9,Janssenlei 17,2022-08-31,16:00:00,610,272,338,F11SP
9,Janssenlei 17,2022-08-31,17:00:00,848,288,560,F11SP
9,Janssenlei 17,2022-08-31,18:00:00,588,248,340,F11SP
9,Janssenlei 17,2022-08-31,19:00:00,386,184,202,F11SP
9,Janssenlei 17,2022-08-31,20:00:00,258,170,88,F11SP
9,Janssenlei 17,2022-08-31,21:00:00,104,56,48,F11SP
9,Janssenlei 17,2022-08-31,22:00:00,106,36,70,F11SP
9,Janssenlei 17,2022-08-31,23:00:00,70,16,54,F11SP
9,Janssenlei 17,2022-09-01,00:00:00,12,0,12,F11SP
9,Janssenlei 17,2022-09-01,01:00:00,18,10,8,F11SP
9,Janssenlei 17,2022-09-01,02:00:00,8,0,8,F11SP
9,Janssenlei 17,2022-09-01,03:00:00,8,6,2,F11SP
9,Janssenlei 17,2022-09-01,04:00:00,20,18,2,F11SP
9,Janssenlei 17,2022-09-01,05:00:00,66,40,26,F11SP
9,Janssenlei 17,2022-09-01,06:00:00,216,142,74,F11SP
9,Janssenlei 17,2022-09-01,07:00:00,720,434,286,F11SP
9,Janssenlei 17,2022-09-01,08:00:00,892,546,346,F11SP
9,Janssenlei 17,2022-09-01,09:00:00,498,232,266,F11SP
9,Janssenlei 17,2022-09-01,10:00:00,306,124,182,F11SP
9,Janssenlei 17,2022-09-01,11:00:00,278,146,132,F11SP
9,Janssenlei 17,2022-09-01,12:00:00,510,256,254,F11SP
9,Janssenlei 17,2022-09-01,13:00:00,368,162,206,F11SP
9,Janssenlei 17,2022-09-01,14:00:00,602,216,386,F11SP
9,Janssenlei 17,2022-09-01,15:00:00,762,322,440,F11SP
9,Janssenlei 17,2022-09-01,16:00:00,888,230,658,F11SP
9,Janssenlei 17,2022-09-01,17:00:00,906,316,590,F11SP
9,Janssenlei 17,2022-09-01,18:00:00,650,232,418,F11SP
9,Janssenlei 17,2022-09-01,19:00:00,346,170,176,F11SP
9,Janssenlei 17,2022-09-01,20:00:00,382,294,88,F11SP
9,Janssenlei 17,2022-09-01,21:00:00,184,112,72,F11SP
9,Janssenlei 17,2022-09-01,22:00:00,106,28,78,F11SP
9,Janssenlei 17,2022-09-01,23:00:00,50,26,24,F11SP
9,Janssenlei 17,2022-09-02,00:00:00,16,2,14,F11SP
9,Janssenlei 17,2022-09-02,01:00:00,14,6,8,F11SP
9,Janssenlei 17,2022-09-02,02:00:00,4,0,4,F11SP
9,Janssenlei 17,2022-09-02,03:00:00,12,10,2,F11SP
9,Janssenlei 17,2022-09-02,04:00:00,26,18,8,F11SP
9,Janssenlei 17,2022-09-02,05:00:00,76,50,26,F11SP
9,Janssenlei 17,2022-09-02,06:00:00,186,132,54,F11SP
9,Janssenlei 17,2022-09-02,07:00:00,774,400,374,F11SP
9,Janssenlei 17,2022-09-02,08:00:00,822,510,312,F11SP
9,Janssenlei 17,2022-09-02,09:00:00,240,116,124,F11SP
9,Janssenlei 17,2022-09-02,10:00:00,304,144,160,F11SP
9,Janssenlei 17,2022-09-02,11:00:00,386,174,212,F11SP
9,Janssenlei 17,2022-09-02,12:00:00,354,140,214,F11SP
9,Janssenlei 17,2022-09-02,13:00:00,376,148,228,F11SP
9,Janssenlei 17,2022-09-02,14:00:00,532,218,314,F11SP
9,Janssenlei 17,2022-09-02,15:00:00,736,270,466,F11SP
9,Janssenlei 17,2022-09-02,16:00:00,1006,398,608,F11SP
9,Janssenlei 17,2022-09-02,17:00:00,786,300,486,F11SP
9,Janssenlei 17,2022-09-02,18:00:00,442,174,268,F11SP
9,Janssenlei 17,2022-09-02,19:00:00,282,150,132,F11SP
9,Janssenlei 17,2022-09-02,20:00:00,222,110,112,F11SP
9,Janssenlei 17,2022-09-02,21:00:00,114,58,56,F11SP
9,Janssenlei 17,2022-09-02,22:00:00,96,34,62,F11SP
9,Janssenlei 17,2022-09-02,23:00:00,108,28,80,F11SP
9,Janssenlei 17,2022-09-03,00:00:00,60,24,36,F11SP
9,Janssenlei 17,2022-09-03,01:00:00,14,4,10,F11SP
9,Janssenlei 17,2022-09-03,02:00:00,16,6,10,F11SP
9,Janssenlei 17,2022-09-03,03:00:00,20,8,12,F11SP
9,Janssenlei 17,2022-09-03,04:00:00,20,16,4,F11SP
9,Janssenlei 17,2022-09-03,05:00:00,12,8,4,F11SP
9,Janssenlei 17,2022-09-03,06:00:00,38,10,28,F11SP
9,Janssenlei 17,2022-09-03,07:00:00,62,24,38,F11SP
9,Janssenlei 17,2022-09-03,08:00:00,104,50,54,F11SP
9,Janssenlei 17,2022-09-03,09:00:00,278,90,188,F11SP
9,Janssenlei 17,2022-09-03,10:00:00,360,182,178,F11SP
9,Janssenlei 17,2022-09-03,11:00:00,346,162,184,F11SP
9,Janssenlei 17,2022-09-03,12:00:00,500,208,292,F11SP
9,Janssenlei 17,2022-09-03,13:00:00,328,172,156,F11SP
9,Janssenlei 17,2022-09-03,14:00:00,486,182,304,F11SP
9,Janssenlei 17,2022-09-03,15:00:00,476,240,236,F11SP
9,Janssenlei 17,2022-09-03,16:00:00,346,160,186,F11SP
9,Janssenlei 17,2022-09-03,17:00:00,370,202,168,F11SP
9,Janssenlei 17,2022-09-03,18:00:00,258,138,120,F11SP
9,Janssenlei 17,2022-09-03,19:00:00,136,62,74,F11SP
9,Janssenlei 17,2022-09-03,20:00:00,152,74,78,F11SP
9,Janssenlei 17,2022-09-03,21:00:00,52,34,18,F11SP
9,Janssenlei 17,2022-09-03,22:00:00,56,24,32,F11SP
9,Janssenlei 17,2022-09-03,23:00:00,12,4,8,F11SP
9,Janssenlei 17,2022-09-04,00:00:00,32,10,22,F11SP
9,Janssenlei 17,2022-09-04,01:00:00,28,18,10,F11SP
9,Janssenlei 17,2022-09-04,02:00:00,58,36,22,F11SP
9,Janssenlei 17,2022-09-04,03:00:00,10,10,0,F11SP
9,Janssenlei 17,2022-09-04,04:00:00,8,2,6,F11SP
9,Janssenlei 17,2022-09-04,05:00:00,12,12,0,F11SP
9,Janssenlei 17,2022-09-04,06:00:00,40,14,26,F11SP
9,Janssenlei 17,2022-09-04,07:00:00,96,28,68,F11SP
9,Janssenlei 17,2022-09-04,08:00:00,250,76,174,F11SP
9,Janssenlei 17,2022-09-04,09:00:00,544,174,370,F11SP
9,Janssenlei 17,2022-09-04,10:00:00,688,288,400,F11SP
9,Janssenlei 17,2022-09-04,11:00:00,660,342,318,F11SP
9,Janssenlei 17,2022-09-04,12:00:00,644,334,310,F11SP
9,Janssenlei 17,2022-09-04,13:00:00,600,264,336,F11SP
9,Janssenlei 17,2022-09-04,14:00:00,738,278,460,F11SP
9,Janssenlei 17,2022-09-04,15:00:00,748,324,424,F11SP
9,Janssenlei 17,2022-09-04,16:00:00,556,316,240,F11SP
9,Janssenlei 17,2022-09-04,17:00:00,486,284,202,F11SP
9,Janssenlei 17,2022-09-04,18:00:00,326,180,146,F11SP
9,Janssenlei 17,2022-09-04,19:00:00,286,146,140,F11SP
9,Janssenlei 17,2022-09-04,20:00:00,224,106,118,F11SP
9,Janssenlei 17,2022-09-04,21:00:00,68,42,26,F11SP
9,Janssenlei 17,2022-09-04,22:00:00,48,16,32,F11SP
9,Janssenlei 17,2022-09-04,23:00:00,40,22,18,F11SP
9,Janssenlei 17,2022-09-05,00:00:00,18,8,10,F11SP
9,Janssenlei 17,2022-09-05,01:00:00,4,4,0,F11SP
9,Janssenlei 17,2022-09-05,02:00:00,0,0,0,F11SP
9,Janssenlei 17,2022-09-05,03:00:00,6,6,0,F11SP
9,Janssenlei 17,2022-09-05,04:00:00,24,16,8,F11SP
9,Janssenlei 17,2022-09-05,05:00:00,92,72,20,F11SP
9,Janssenlei 17,2022-09-05,06:00:00,232,178,54,F11SP
9,Janssenlei 17,2022-09-05,07:00:00,844,512,332,F11SP
9,Janssenlei 17,2022-09-05,08:00:00,872,568,304,F11SP
9,Janssenlei 17,2022-09-05,09:00:00,356,220,136,F11SP
9,Janssenlei 17,2022-09-05,10:00:00,248,94,154,F11SP
9,Janssenlei 17,2022-09-05,11:00:00,322,152,170,F11SP
9,Janssenlei 17,2022-09-05,12:00:00,310,130,180,F11SP
9,Janssenlei 17,2022-09-05,13:00:00,292,104,188,F11SP
9,Janssenlei 17,2022-09-05,14:00:00,406,146,260,F11SP
9,Janssenlei 17,2022-09-05,15:00:00,556,212,344,F11SP
9,Janssenlei 17,2022-09-05,16:00:00,1022,360,662,F11SP
9,Janssenlei 17,2022-09-05,17:00:00,894,270,624,F11SP
9,Janssenlei 17,2022-09-05,18:00:00,322,124,198,F11SP
9,Janssenlei 17,2022-09-05,19:00:00,194,68,126,F11SP
9,Janssenlei 17,2022-09-05,20:00:00,164,54,110,F11SP
9,Janssenlei 17,2022-09-05,21:00:00,52,22,30,F11SP
9,Janssenlei 17,2022-09-05,22:00:00,56,26,30,F11SP
9,Janssenlei 17,2022-09-05,23:00:00,14,0,14,F11SP
9,Janssenlei 17,2022-09-06,00:00:00,8,4,4,F11SP
9,Janssenlei 17,2022-09-06,01:00:00,12,12,0,F11SP
9,Janssenlei 17,2022-09-06,02:00:00,0,0,0,F11SP
9,Janssenlei 17,2022-09-06,03:00:00,8,8,0,F11SP
9,Janssenlei 17,2022-09-06,04:00:00,22,16,6,F11SP
9,Janssenlei 17,2022-09-06,05:00:00,96,78,18,F11SP
9,Janssenlei 17,2022-09-06,06:00:00,218,138,80,F11SP
9,Janssenlei 17,2022-09-06,07:00:00,914,526,388,F11SP
9,Janssenlei 17,2022-09-06,08:00:00,828,592,236,F11SP
9,Janssenlei 17,2022-09-06,09:00:00,288,180,108,F11SP
9,Janssenlei 17,2022-09-06,10:00:00,242,112,130,F11SP
9,Janssenlei 17,2022-09-06,11:00:00,266,108,158,F11SP
9,Janssenlei 17,2022-09-06,12:00:00,384,146,238,F11SP
9,Janssenlei 17,2022-09-06,13:00:00,378,194,184,F11SP
9,Janssenlei 17,2022-09-06,14:00:00,496,198,298,F11SP
9,Janssenlei 17,2022-09-06,15:00:00,638,294,344,F11SP
9,Janssenlei 17,2022-09-06,16:00:00,1074,350,724,F11SP
9,Janssenlei 17,2022-09-06,17:00:00,814,216,598,F11SP
9,Janssenlei 17,2022-09-06,18:00:00,514,230,284,F11SP
9,Janssenlei 17,2022-09-06,19:00:00,316,112,204,F11SP
9,Janssenlei 17,2022-09-06,20:00:00,192,94,98,F11SP
9,Janssenlei 17,2022-09-06,21:00:00,122,50,72,F11SP
9,Janssenlei 17,2022-09-06,22:00:00,78,22,56,F11SP
9,Janssenlei 17,2022-09-06,23:00:00,52,2,50,F11SP
9,Janssenlei 17,2022-09-07,00:00:00,8,0,8,F11SP
9,Janssenlei 17,2022-09-07,01:00:00,8,4,4,F11SP
9,Janssenlei 17,2022-09-07,02:00:00,0,0,0,F11SP
9,Janssenlei 17,2022-09-07,03:00:00,6,2,4,F11SP
9,Janssenlei 17,2022-09-07,04:00:00,8,6,2,F11SP
9,Janssenlei 17,2022-09-07,05:00:00,66,52,14,F11SP
9,Janssenlei 17,2022-09-07,06:00:00,206,124,82,F11SP
9,Janssenlei 17,2022-09-07,07:00:00,778,464,314,F11SP
9,Janssenlei 17,2022-09-07,08:00:00,1100,518,582,F11SP
9,Janssenlei 17,2022-09-07,09:00:00,308,138,170,F11SP
9,Janssenlei 17,2022-09-07,10:00:00,374,154,220,F11SP
9,Janssenlei 17,2022-09-07,11:00:00,462,202,260,F11SP
9,Janssenlei 17,2022-09-07,12:00:00,832,394,438,F11SP
9,Janssenlei 17,2022-09-07,13:00:00,538,166,372,F11SP
9,Janssenlei 17,2022-09-07,14:00:00,358,154,204,F11SP
9,Janssenlei 17,2022-09-07,15:00:00,450,202,248,F11SP
9,Janssenlei 17,2022-09-07,16:00:00,774,316,458,F11SP
9,Janssenlei 17,2022-09-07,17:00:00,696,260,436,F11SP
9,Janssenlei 17,2022-09-07,18:00:00,634,222,412,F11SP
9,Janssenlei 17,2022-09-07,19:00:00,348,202,146,F11SP
9,Janssenlei 17,2022-09-07,20:00:00,276,144,132,F11SP
9,Janssenlei 17,2022-09-07,21:00:00,114,56,58,F11SP
9,Janssenlei 17,2022-09-07,22:00:00,76,24,52,F11SP
9,Janssenlei 17,2022-09-07,23:00:00,22,6,16,F11SP
9,Janssenlei 17,2022-09-08,00:00:00,28,4,24,F11SP
9,Janssenlei 17,2022-09-08,01:00:00,0,0,0,F11SP
9,Janssenlei 17,2022-09-08,02:00:00,6,2,4,F11SP
9,Janssenlei 17,2022-09-08,03:00:00,0,0,0,F11SP
9,Janssenlei 17,2022-09-08,04:00:00,12,6,6,F11SP
9,Janssenlei 17,2022-09-08,05:00:00,54,40,14,F11SP
9,Janssenlei 17,2022-09-08,06:00:00,152,72,80,F11SP
9,Janssenlei 17,2022-09-08,07:00:00,628,366,262,F11SP
9,Janssenlei 17,2022-09-08,08:00:00,748,496,252,F11SP
9,Janssenlei 17,2022-09-08,09:00:00,272,144,128,F11SP
9,Janssenlei 17,2022-09-08,10:00:00,212,118,94,F11SP
9,Janssenlei 17,2022-09-08,11:00:00,190,88,102,F11SP
9,Janssenlei 17,2022-09-08,12:00:00,260,150,110,F11SP
9,Janssenlei 17,2022-09-08,13:00:00,200,74,126,F11SP
9,Janssenlei 17,2022-09-08,14:00:00,262,106,156,F11SP
9,Janssenlei 17,2022-09-08,15:00:00,436,168,268,F11SP
9,Janssenlei 17,2022-09-08,16:00:00,798,232,566,F11SP
9,Janssenlei 17,2022-09-08,17:00:00,508,124,384,F11SP
9,Janssenlei 17,2022-09-08,18:00:00,324,136,188,F11SP
9,Janssenlei 17,2022-09-08,19:00:00,136,56,80,F11SP
9,Janssenlei 17,2022-09-08,20:00:00,104,48,56,F11SP
9,Janssenlei 17,2022-09-08,21:00:00,72,14,58,F11SP
9,Janssenlei 17,2022-09-08,22:00:00,58,12,46,F11SP
9,Janssenlei 17,2022-09-08,23:00:00,28,8,20,F11SP
9,Janssenlei 17,2022-09-09,00:00:00,18,4,14,F11SP
9,Janssenlei 17,2022-09-09,01:00:00,8,8,0,F11SP
9,Janssenlei 17,2022-09-09,02:00:00,0,0,0,F11SP
9,Janssenlei 17,2022-09-09,03:00:00,4,2,2,F11SP
9,Janssenlei 17,2022-09-09,04:00:00,12,8,4,F11SP
9,Janssenlei 17,2022-09-09,05:00:00,58,52,6,F11SP
9,Janssenlei 17,2022-09-09,06:00:00,142,80,62,F11SP
9,Janssenlei 17,2022-09-09,07:00:00,478,254,224,F11SP
9,Janssenlei 17,2022-09-09,08:00:00,628,376,252,F11SP
9,Janssenlei 17,2022-09-09,09:00:00,236,110,126,F11SP
9,Janssenlei 17,2022-09-09,10:00:00,98,52,46,F11SP
9,Janssenlei 17,2022-09-09,11:00:00,76,30,46,F11SP
9,Janssenlei 17,2022-09-09,12:00:00,168,64,104,F11SP
9,Janssenlei 17,2022-09-09,13:00:00,160,60,100,F11SP
9,Janssenlei 17,2022-09-09,14:00:00,184,62,122,F11SP
9,Janssenlei 17,2022-09-09,15:00:00,424,212,212,F11SP
9,Janssenlei 17,2022-09-09,16:00:00,634,188,446,F11SP
9,Janssenlei 17,2022-09-09,17:00:00,356,132,224,F11SP
9,Janssenlei 17,2022-09-09,18:00:00,232,88,144,F11SP
9,Janssenlei 17,2022-09-09,19:00:00,186,96,90,F11SP
9,Janssenlei 17,2022-09-09,20:00:00,86,40,46,F11SP
9,Janssenlei 17,2022-09-09,21:00:00,114,70,44,F11SP
9,Janssenlei 17,2022-09-09,22:00:00,134,100,34,F11SP
9,Janssenlei 17,2022-09-09,23:00:00,58,32,26,F11SP
9,Janssenlei 17,2022-09-10,00:00:00,42,0,42,F11SP
9,Janssenlei 17,2022-09-10,01:00:00,100,14,86,F11SP
9,Janssenlei 17,2022-09-10,02:00:00,66,6,60,F11SP
9,Janssenlei 17,2022-09-10,03:00:00,72,6,66,F11SP
9,Janssenlei 17,2022-09-10,04:00:00,20,12,8,F11SP
9,Janssenlei 17,2022-09-10,05:00:00,16,4,12,F11SP
9,Janssenlei 17,2022-09-10,06:00:00,34,14,20,F11SP
9,Janssenlei 17,2022-09-10,07:00:00,18,12,6,F11SP
9,Janssenlei 17,2022-09-10,08:00:00,46,22,24,F11SP
9,Janssenlei 17,2022-09-10,09:00:00,40,16,24,F11SP
9,Janssenlei 17,2022-09-10,10:00:00,34,14,20,F11SP
9,Janssenlei 17,2022-09-10,11:00:00,60,26,34,F11SP
9,Janssenlei 17,2022-09-10,12:00:00,62,34,28,F11SP
9,Janssenlei 17,2022-09-10,13:00:00,74,40,34,F11SP
9,Janssenlei 17,2022-09-10,14:00:00,120,44,76,F11SP
9,Janssenlei 17,2022-09-10,15:00:00,120,38,82,F11SP
9,Janssenlei 17,2022-09-10,16:00:00,152,66,86,F11SP
9,Janssenlei 17,2022-09-10,17:00:00,172,96,76,F11SP
9,Janssenlei 17,2022-09-10,18:00:00,138,78,60,F11SP
9,Janssenlei 17,2022-09-10,19:00:00,194,110,84,F11SP
9,Janssenlei 17,2022-09-10,20:00:00,124,48,76,F11SP
9,Janssenlei 17,2022-09-10,21:00:00,54,18,36,F11SP
9,Janssenlei 17,2022-09-10,22:00:00,42,20,22,F11SP
9,Janssenlei 17,2022-09-10,23:00:00,42,14,28,F11SP
9,Janssenlei 17,2022-09-11,00:00:00,16,4,12,F11SP
9,Janssenlei 17,2022-09-11,01:00:00,50,12,38,F11SP
9,Janssenlei 17,2022-09-11,02:00:00,16,14,2,F11SP
9,Janssenlei 17,2022-09-11,03:00:00,26,14,12,F11SP
9,Janssenlei 17,2022-09-11,04:00:00,18,14,4,F11SP
9,Janssenlei 17,2022-09-11,05:00:00,24,14,10,F11SP
9,Janssenlei 17,2022-09-11,06:00:00,46,18,28,F11SP
9,Janssenlei 17,2022-09-11,07:00:00,86,30,56,F11SP
9,Janssenlei 17,2022-09-11,08:00:00,162,58,104,F11SP
9,Janssenlei 17,2022-09-11,09:00:00,462,208,254,F11SP
9,Janssenlei 17,2022-09-11,10:00:00,414,188,226,F11SP
9,Janssenlei 17,2022-09-11,11:00:00,508,264,244,F11SP
9,Janssenlei 17,2022-09-11,12:00:00,510,236,274,F11SP
9,Janssenlei 17,2022-09-11,13:00:00,472,218,254,F11SP
9,Janssenlei 17,2022-09-11,14:00:00,788,302,486,F11SP
9,Janssenlei 17,2022-09-11,15:00:00,584,312,272,F11SP
9,Janssenlei 17,2022-09-11,16:00:00,488,262,226,F11SP
9,Janssenlei 17,2022-09-11,17:00:00,456,222,234,F11SP
9,Janssenlei 17,2022-09-11,18:00:00,332,158,174,F11SP
9,Janssenlei 17,2022-09-11,19:00:00,150,68,82,F11SP
9,Janssenlei 17,2022-09-11,20:00:00,106,80,26,F11SP
9,Janssenlei 17,2022-09-11,21:00:00,84,36,48,F11SP
9,Janssenlei 17,2022-09-11,22:00:00,50,16,34,F11SP
9,Janssenlei 17,2022-09-11,23:00:00,14,4,10,F11SP
9,Janssenlei 17,2022-09-12,00:00:00,12,4,8,F11SP
9,Janssenlei 17,2022-09-12,01:00:00,6,0,6,F11SP
9,Janssenlei 17,2022-09-12,02:00:00,0,0,0,F11SP
9,Janssenlei 17,2022-09-12,03:00:00,6,6,0,F11SP
9,Janssenlei 17,2022-09-12,04:00:00,6,6,0,F11SP
9,Janssenlei 17,2022-09-12,05:00:00,68,46,22,F11SP
9,Janssenlei 17,2022-09-12,06:00:00,240,150,90,F11SP
9,Janssenlei 17,2022-09-12,07:00:00,864,528,336,F11SP
9,Janssenlei 17,2022-09-12,08:00:00,842,496,346,F11SP
9,Janssenlei 17,2022-09-12,09:00:00,286,152,134,F11SP
9,Janssenlei 17,2022-09-12,10:00:00,308,144,164,F11SP
9,Janssenlei 17,2022-09-12,11:00:00,260,130,130,F11SP
9,Janssenlei 17,2022-09-12,12:00:00,326,152,174,F11SP
9,Janssenlei 17,2022-09-12,13:00:00,420,178,242,F11SP
9,Janssenlei 17,2022-09-12,14:00:00,544,192,352,F11SP
9,Janssenlei 17,2022-09-12,15:00:00,710,306,404,F11SP
9,Janssenlei 17,2022-09-12,16:00:00,1066,424,642,F11SP
9,Janssenlei 17,2022-09-12,17:00:00,1022,374,648,F11SP
9,Janssenlei 17,2022-09-12,18:00:00,550,182,368,F11SP
9,Janssenlei 17,2022-09-12,19:00:00,358,186,172,F11SP
9,Janssenlei 17,2022-09-12,20:00:00,214,126,88,F11SP
9,Janssenlei 17,2022-09-12,21:00:00,100,56,44,F11SP
9,Janssenlei 17,2022-09-12,22:00:00,150,74,76,F11SP
9,Janssenlei 17,2022-09-12,23:00:00,28,8,20,F11SP
9,Janssenlei 17,2022-09-13,00:00:00,10,10,0,F11SP
9,Janssenlei 17,2022-09-13,01:00:00,6,0,6,F11SP
9,Janssenlei 17,2022-09-13,02:00:00,4,4,0,F11SP
9,Janssenlei 17,2022-09-13,03:00:00,14,8,6,F11SP
9,Janssenlei 17,2022-09-13,04:00:00,10,10,0,F11SP
9,Janssenlei 17,2022-09-13,05:00:00,82,62,20,F11SP
9,Janssenlei 17,2022-09-13,06:00:00,210,142,68,F11SP
9,Janssenlei 17,2022-09-13,07:00:00,690,378,312,F11SP
9,Janssenlei 17,2022-09-13,08:00:00,820,526,294,F11SP
9,Janssenlei 17,2022-09-13,09:00:00,286,164,122,F11SP
9,Janssenlei 17,2022-09-13,10:00:00,160,52,108,F11SP
9,Janssenlei 17,2022-09-13,11:00:00,216,114,102,F11SP
9,Janssenlei 17,2022-09-13,12:00:00,284,142,142,F11SP
9,Janssenlei 17,2022-09-13,13:00:00,384,130,254,F11SP
9,Janssenlei 17,2022-09-13,14:00:00,330,160,170,F11SP
9,Janssenlei 17,2022-09-13,15:00:00,582,326,256,F11SP
9,Janssenlei 17,2022-09-13,16:00:00,758,226,532,F11SP
9,Janssenlei 17,2022-09-13,17:00:00,622,182,440,F11SP
9,Janssenlei 17,2022-09-13,18:00:00,366,98,268,F11SP
9,Janssenlei 17,2022-09-13,19:00:00,130,50,80,F11SP
9,Janssenlei 17,2022-09-13,20:00:00,86,34,52,F11SP
9,Janssenlei 17,2022-09-13,21:00:00,60,16,44,F11SP
9,Janssenlei 17,2022-09-13,22:00:00,72,12,60,F11SP
9,Janssenlei 17,2022-09-13,23:00:00,12,2,10,F11SP
9,Janssenlei 17,2022-09-14,00:00:00,4,4,0,F11SP
9,Janssenlei 17,2022-09-14,01:00:00,14,0,14,F11SP
9,Janssenlei 17,2022-09-14,02:00:00,0,0,0,F11SP
9,Janssenlei 17,2022-09-14,03:00:00,0,0,0,F11SP
9,Janssenlei 17,2022-09-14,04:00:00,2,2,0,F11SP
9,Janssenlei 17,2022-09-14,05:00:00,30,14,16,F11SP
9,Janssenlei 17,2022-09-14,06:00:00,116,74,42,F11SP
9,Janssenlei 17,2022-09-14,07:00:00,376,210,166,F11SP
9,Janssenlei 17,2022-09-14,08:00:00,438,272,166,F11SP
9,Janssenlei 17,2022-09-14,09:00:00,128,80,48,F11SP
9,Janssenlei 17,2022-09-14,10:00:00,50,24,26,F11SP
9,Janssenlei 17,2022-09-14,11:00:00,68,32,36,F11SP
9,Janssenlei 17,2022-09-14,12:00:00,330,92,238,F11SP
9,Janssenlei 17,2022-09-14,13:00:00,150,84,66,F11SP
9,Janssenlei 17,2022-09-14,14:00:00,72,34,38,F11SP
9,Janssenlei 17,2022-09-14,15:00:00,142,54,88,F11SP
9,Janssenlei 17,2022-09-14,16:00:00,204,64,140,F11SP
9,Janssenlei 17,2022-09-14,17:00:00,318,116,202,F11SP
9,Janssenlei 17,2022-09-14,18:00:00,222,72,150,F11SP
9,Janssenlei 17,2022-09-14,19:00:00,94,54,40,F11SP
9,Janssenlei 17,2022-09-14,20:00:00,76,36,40,F11SP
9,Janssenlei 17,2022-09-14,21:00:00,48,28,20,F11SP
9,Janssenlei 17,2022-09-14,22:00:00,58,10,48,F11SP
9,Janssenlei 17,2022-09-14,23:00:00,20,14,6,F11SP
9,Janssenlei 17,2022-09-15,00:00:00,14,6,8,F11SP
9,Janssenlei 17,2022-09-15,01:00:00,4,0,4,F11SP
9,Janssenlei 17,2022-09-15,02:00:00,4,0,4,F11SP
9,Janssenlei 17,2022-09-15,03:00:00,4,4,0,F11SP
9,Janssenlei 17,2022-09-15,04:00:00,4,4,0,F11SP
9,Janssenlei 17,2022-09-15,05:00:00,66,42,24,F11SP
9,Janssenlei 17,2022-09-15,06:00:00,134,82,52,F11SP
9,Janssenlei 17,2022-09-15,07:00:00,584,346,238,F11SP
9,Janssenlei 17,2022-09-15,08:00:00,764,494,270,F11SP
9,Janssenlei 17,2022-09-15,09:00:00,256,100,156,F11SP
9,Janssenlei 17,2022-09-15,10:00:00,232,110,122,F11SP
9,Janssenlei 17,2022-09-15,11:00:00,172,86,86,F11SP
9,Janssenlei 17,2022-09-15,12:00:00,214,116,98,F11SP
9,Janssenlei 17,2022-09-15,13:00:00,80,24,56,F11SP
9,Janssenlei 17,2022-09-15,14:00:00,222,80,142,F11SP
9,Janssenlei 17,2022-09-15,15:00:00,420,182,238,F11SP
9,Janssenlei 17,2022-09-15,16:00:00,780,262,518,F11SP
9,Janssenlei 17,2022-09-15,17:00:00,634,158,476,F11SP
9,Janssenlei 17,2022-09-15,18:00:00,400,118,282,F11SP
9,Janssenlei 17,2022-09-15,19:00:00,288,128,160,F11SP
9,Janssenlei 17,2022-09-15,20:00:00,202,116,86,F11SP
9,Janssenlei 17,2022-09-15,21:00:00,90,46,44,F11SP
9,Janssenlei 17,2022-09-15,22:00:00,112,30,82,F11SP
9,Janssenlei 17,2022-09-15,23:00:00,24,4,20,F11SP
9,Janssenlei 17,2022-09-16,00:00:00,18,0,18,F11SP
9,Janssenlei 17,2022-09-16,01:00:00,4,0,4,F11SP
9,Janssenlei 17,2022-09-16,02:00:00,6,2,4,F11SP
9,Janssenlei 17,2022-09-16,03:00:00,0,0,0,F11SP
9,Janssenlei 17,2022-09-16,04:00:00,6,6,0,F11SP
9,Janssenlei 17,2022-09-16,05:00:00,44,32,12,F11SP
9,Janssenlei 17,2022-09-16,06:00:00,114,70,44,F11SP
9,Janssenlei 17,2022-09-16,07:00:00,414,234,180,F11SP
9,Janssenlei 17,2022-09-16,08:00:00,446,244,202,F11SP
9,Janssenlei 17,2022-09-16,09:00:00,112,78,34,F11SP
9,Janssenlei 17,2022-09-16,10:00:00,136,48,88,F11SP
9,Janssenlei 17,2022-09-16,11:00:00,96,60,36,F11SP
9,Janssenlei 17,2022-09-16,12:00:00,100,44,56,F11SP
9,Janssenlei 17,2022-09-16,13:00:00,118,44,74,F11SP
9,Janssenlei 17,2022-09-16,14:00:00,120,50,70,F11SP
9,Janssenlei 17,2022-09-16,15:00:00,296,90,206,F11SP
9,Janssenlei 17,2022-09-16,16:00:00,504,152,352,F11SP
9,Janssenlei 17,2022-09-16,17:00:00,268,66,202,F11SP
9,Janssenlei 17,2022-09-16,18:00:00,220,96,124,F11SP
9,Janssenlei 17,2022-09-16,19:00:00,76,28,48,F11SP
9,Janssenlei 17,2022-09-16,20:00:00,46,24,22,F11SP
9,Janssenlei 17,2022-09-16,21:00:00,32,0,32,F11SP
9,Janssenlei 17,2022-09-16,22:00:00,52,20,32,F11SP
9,Janssenlei 17,2022-09-16,23:00:00,26,6,20,F11SP
9,Janssenlei 17,2022-09-17,00:00:00,16,8,8,F11SP
9,Janssenlei 17,2022-09-17,01:00:00,22,8,14,F11SP
9,Janssenlei 17,2022-09-17,02:00:00,0,0,0,F11SP
9,Janssenlei 17,2022-09-17,03:00:00,8,0,8,F11SP
9,Janssenlei 17,2022-09-17,04:00:00,14,4,10,F11SP
9,Janssenlei 17,2022-09-17,05:00:00,16,16,0,F11SP
9,Janssenlei 17,2022-09-17,06:00:00,34,8,26,F11SP
9,Janssenlei 17,2022-09-17,07:00:00,28,12,16,F11SP
9,Janssenlei 17,2022-09-17,08:00:00,74,34,40,F11SP
9,Janssenlei 17,2022-09-17,09:00:00,112,48,64,F11SP
9,Janssenlei 17,2022-09-17,10:00:00,152,66,86,F11SP
9,Janssenlei 17,2022-09-17,11:00:00,64,36,28,F11SP
9,Janssenlei 17,2022-09-17,12:00:00,110,42,68,F11SP
9,Janssenlei 17,2022-09-17,13:00:00,120,62,58,F11SP
9,Janssenlei 17,2022-09-17,14:00:00,206,90,116,F11SP
9,Janssenlei 17,2022-09-17,15:00:00,138,56,82,F11SP
9,Janssenlei 17,2022-09-17,16:00:00,130,50,80,F11SP
9,Janssenlei 17,2022-09-17,17:00:00,108,60,48,F11SP
9,Janssenlei 17,2022-09-17,18:00:00,120,62,58,F11SP
9,Janssenlei 17,2022-09-17,19:00:00,76,36,40,F11SP
9,Janssenlei 17,2022-09-17,20:00:00,56,28,28,F11SP
9,Janssenlei 17,2022-09-17,21:00:00,6,2,4,F11SP
9,Janssenlei 17,2022-09-17,22:00:00,20,8,12,F11SP
9,Janssenlei 17,2022-09-17,23:00:00,10,4,6,F11SP
9,Janssenlei 17,2022-09-18,00:00:00,4,0,4,F11SP
9,Janssenlei 17,2022-09-18,01:00:00,4,2,2,F11SP
9,Janssenlei 17,2022-09-18,02:00:00,2,2,0,F11SP
9,Janssenlei 17,2022-09-18,03:00:00,18,2,16,F11SP
9,Janssenlei 17,2022-09-18,04:00:00,0,0,0,F11SP
9,Janssenlei 17,2022-09-18,05:00:00,20,16,4,F11SP
9,Janssenlei 17,2022-09-18,06:00:00,14,8,6,F11SP
9,Janssenlei 17,2022-09-18,07:00:00,26,12,14,F11SP
9,Janssenlei 17,2022-09-18,08:00:00,52,36,16,F11SP
9,Janssenlei 17,2022-09-18,09:00:00,158,66,92,F11SP
9,Janssenlei 17,2022-09-18,10:00:00,202,96,106,F11SP
9,Janssenlei 17,2022-09-18,11:00:00,192,74,118,F11SP
9,Janssenlei 17,2022-09-18,12:00:00,258,128,130,F11SP
9,Janssenlei 17,2022-09-18,13:00:00,158,94,64,F11SP
9,Janssenlei 17,2022-09-18,14:00:00,224,88,136,F11SP
9,Janssenlei 17,2022-09-18,15:00:00,132,68,64,F11SP
9,Janssenlei 17,2022-09-18,16:00:00,136,62,74,F11SP
9,Janssenlei 17,2022-09-18,17:00:00,94,44,50,F11SP
9,Janssenlei 17,2022-09-18,18:00:00,58,18,40,F11SP
9,Janssenlei 17,2022-09-18,19:00:00,22,6,16,F11SP
9,Janssenlei 17,2022-09-18,20:00:00,50,36,14,F11SP
9,Janssenlei 17,2022-09-18,21:00:00,28,4,24,F11SP
9,Janssenlei 17,2022-09-18,22:00:00,28,10,18,F11SP
9,Janssenlei 17,2022-09-18,23:00:00,10,4,6,F11SP
9,Janssenlei 17,2022-09-19,00:00:00,2,0,2,F11SP
9,Janssenlei 17,2022-09-19,01:00:00,0,0,0,F11SP
9,Janssenlei 17,2022-09-19,02:00:00,4,4,0,F11SP
9,Janssenlei 17,2022-09-19,03:00:00,4,4,0,F11SP
9,Janssenlei 17,2022-09-19,04:00:00,6,6,0,F11SP
9,Janssenlei 17,2022-09-19,05:00:00,76,56,20,F11SP
9,Janssenlei 17,2022-09-19,06:00:00,152,112,40,F11SP
9,Janssenlei 17,2022-09-19,07:00:00,636,390,246,F11SP
9,Janssenlei 17,2022-09-19,08:00:00,688,438,250,F11SP
9,Janssenlei 17,2022-09-19,09:00:00,258,128,130,F11SP
9,Janssenlei 17,2022-09-19,10:00:00,140,56,84,F11SP
9,Janssenlei 17,2022-09-19,11:00:00,148,64,84,F11SP
9,Janssenlei 17,2022-09-19,12:00:00,226,122,104,F11SP
9,Janssenlei 17,2022-09-19,13:00:00,236,106,130,F11SP
9,Janssenlei 17,2022-09-19,14:00:00,290,98,192,F11SP
9,Janssenlei 17,2022-09-19,15:00:00,426,136,290,F11SP
9,Janssenlei 17,2022-09-19,16:00:00,736,222,514,F11SP
9,Janssenlei 17,2022-09-19,17:00:00,624,142,482,F11SP
9,Janssenlei 17,2022-09-19,18:00:00,370,118,252,F11SP
9,Janssenlei 17,2022-09-19,19:00:00,204,104,100,F11SP
9,Janssenlei 17,2022-09-19,20:00:00,94,58,36,F11SP
9,Janssenlei 17,2022-09-19,21:00:00,50,14,36,F11SP
9,Janssenlei 17,2022-09-19,22:00:00,92,18,74,F11SP
9,Janssenlei 17,2022-09-19,23:00:00,12,4,8,F11SP
9,Janssenlei 17,2022-09-20,00:00:00,2,2,0,F11SP
9,Janssenlei 17,2022-09-20,01:00:00,4,4,0,F11SP
9,Janssenlei 17,2022-09-20,02:00:00,2,2,0,F11SP
9,Janssenlei 17,2022-09-20,03:00:00,6,2,4,F11SP
9,Janssenlei 17,2022-09-20,04:00:00,12,12,0,F11SP
9,Janssenlei 17,2022-09-20,05:00:00,68,54,14,F11SP
9,Janssenlei 17,2022-09-20,06:00:00,140,112,28,F11SP
9,Janssenlei 17,2022-09-20,07:00:00,670,420,250,F11SP
9,Janssenlei 17,2022-09-20,08:00:00,710,514,196,F11SP
9,Janssenlei 17,2022-09-20,09:00:00,198,130,68,F11SP
9,Janssenlei 17,2022-09-20,10:00:00,122,48,74,F11SP
9,Janssenlei 17,2022-09-20,11:00:00,158,74,84,F11SP
9,Janssenlei 17,2022-09-20,12:00:00,222,112,110,F11SP
9,Janssenlei 17,2022-09-20,13:00:00,302,116,186,F11SP
9,Janssenlei 17,2022-09-20,14:00:00,336,124,212,F11SP
9,Janssenlei 17,2022-09-20,15:00:00,382,128,254,F11SP
9,Janssenlei 17,2022-09-20,16:00:00,782,224,558,F11SP
9,Janssenlei 17,2022-09-20,17:00:00,728,166,562,F11SP
9,Janssenlei 17,2022-09-20,18:00:00,410,154,256,F11SP
9,Janssenlei 17,2022-09-20,19:00:00,240,120,120,F11SP
9,Janssenlei 17,2022-09-20,20:00:00,112,78,34,F11SP
9,Janssenlei 17,2022-09-20,21:00:00,62,20,42,F11SP
9,Janssenlei 17,2022-09-20,22:00:00,112,28,84,F11SP
9,Janssenlei 17,2022-09-20,23:00:00,28,6,22,F11SP
9,Janssenlei 17,2022-09-21,00:00:00,6,0,6,F11SP
9,Janssenlei 17,2022-09-21,01:00:00,10,0,10,F11SP
9,Janssenlei 17,2022-09-21,02:00:00,2,2,0,F11SP
9,Janssenlei 17,2022-09-21,03:00:00,6,6,0,F11SP
9,Janssenlei 17,2022-09-21,04:00:00,6,6,0,F11SP
9,Janssenlei 17,2022-09-21,05:00:00,60,34,26,F11SP
9,Janssenlei 17,2022-09-21,06:00:00,164,108,56,F11SP
9,Janssenlei 17,2022-09-21,07:00:00,638,388,250,F11SP
9,Janssenlei 17,2022-09-21,08:00:00,710,456,254,F11SP
9,Janssenlei 17,2022-09-21,09:00:00,232,108,124,F11SP
9,Janssenlei 17,2022-09-21,10:00:00,244,130,114,F11SP
9,Janssenlei 17,2022-09-21,11:00:00,372,160,212,F11SP
9,Janssenlei 17,2022-09-21,12:00:00,650,224,426,F11SP
9,Janssenlei 17,2022-09-21,13:00:00,414,166,248,F11SP
9,Janssenlei 17,2022-09-21,14:00:00,456,168,288,F11SP
9,Janssenlei 17,2022-09-21,15:00:00,434,168,266,F11SP
9,Janssenlei 17,2022-09-21,16:00:00,604,178,426,F11SP
9,Janssenlei 17,2022-09-21,17:00:00,656,210,446,F11SP
9,Janssenlei 17,2022-09-21,18:00:00,480,150,330,F11SP
9,Janssenlei 17,2022-09-21,19:00:00,242,122,120,F11SP
9,Janssenlei 17,2022-09-21,20:00:00,126,64,62,F11SP
9,Janssenlei 17,2022-09-21,21:00:00,56,36,20,F11SP
9,Janssenlei 17,2022-09-21,22:00:00,110,26,84,F11SP
9,Janssenlei 17,2022-09-21,23:00:00,26,10,16,F11SP
9,Janssenlei 17,2022-09-22,00:00:00,16,0,16,F11SP
9,Janssenlei 17,2022-09-22,01:00:00,8,4,4,F11SP
9,Janssenlei 17,2022-09-22,02:00:00,6,0,6,F11SP
9,Janssenlei 17,2022-09-22,03:00:00,8,8,0,F11SP
9,Janssenlei 17,2022-09-22,04:00:00,14,8,6,F11SP
9,Janssenlei 17,2022-09-22,05:00:00,86,62,24,F11SP
9,Janssenlei 17,2022-09-22,06:00:00,188,128,60,F11SP
9,Janssenlei 17,2022-09-22,07:00:00,662,390,272,F11SP
9,Janssenlei 17,2022-09-22,08:00:00,788,512,276,F11SP
9,Janssenlei 17,2022-09-22,09:00:00,318,176,142,F11SP
9,Janssenlei 17,2022-09-22,10:00:00,200,64,136,F11SP
9,Janssenlei 17,2022-09-22,11:00:00,226,86,140,F11SP
9,Janssenlei 17,2022-09-22,12:00:00,266,92,174,F11SP
9,Janssenlei 17,2022-09-22,13:00:00,478,196,282,F11SP
9,Janssenlei 17,2022-09-22,14:00:00,494,220,274,F11SP
9,Janssenlei 17,2022-09-22,15:00:00,540,216,324,F11SP
9,Janssenlei 17,2022-09-22,16:00:00,870,302,568,F11SP
9,Janssenlei 17,2022-09-22,17:00:00,774,234,540,F11SP
9,Janssenlei 17,2022-09-22,18:00:00,436,134,302,F11SP
9,Janssenlei 17,2022-09-22,19:00:00,194,114,80,F11SP
9,Janssenlei 17,2022-09-22,20:00:00,138,76,62,F11SP
9,Janssenlei 17,2022-09-22,21:00:00,38,12,26,F11SP
9,Janssenlei 17,2022-09-22,22:00:00,76,20,56,F11SP
9,Janssenlei 17,2022-09-22,23:00:00,52,18,34,F11SP
9,Janssenlei 17,2022-09-23,00:00:00,12,6,6,F11SP
9,Janssenlei 17,2022-09-23,01:00:00,8,2,6,F11SP
9,Janssenlei 17,2022-09-23,02:00:00,4,2,2,F11SP
9,Janssenlei 17,2022-09-23,03:00:00,6,6,0,F11SP
9,Janssenlei 17,2022-09-23,04:00:00,12,4,8,F11SP
9,Janssenlei 17,2022-09-23,05:00:00,64,42,22,F11SP
9,Janssenlei 17,2022-09-23,06:00:00,104,68,36,F11SP
9,Janssenlei 17,2022-09-23,07:00:00,472,304,168,F11SP
9,Janssenlei 17,2022-09-23,08:00:00,596,370,226,F11SP
9,Janssenlei 17,2022-09-23,09:00:00,238,120,118,F11SP
9,Janssenlei 17,2022-09-23,10:00:00,290,114,176,F11SP
9,Janssenlei 17,2022-09-23,11:00:00,226,98,128,F11SP
9,Janssenlei 17,2022-09-23,12:00:00,278,124,154,F11SP
9,Janssenlei 17,2022-09-23,13:00:00,260,122,138,F11SP
9,Janssenlei 17,2022-09-23,14:00:00,346,146,200,F11SP
9,Janssenlei 17,2022-09-23,15:00:00,504,178,326,F11SP
9,Janssenlei 17,2022-09-23,16:00:00,612,194,418,F11SP
9,Janssenlei 17,2022-09-23,17:00:00,382,142,240,F11SP
9,Janssenlei 17,2022-09-23,18:00:00,256,90,166,F11SP
9,Janssenlei 17,2022-09-23,19:00:00,118,36,82,F11SP
9,Janssenlei 17,2022-09-23,20:00:00,58,28,30,F11SP
9,Janssenlei 17,2022-09-23,21:00:00,28,8,20,F11SP
9,Janssenlei 17,2022-09-23,22:00:00,64,22,42,F11SP
9,Janssenlei 17,2022-09-23,23:00:00,20,8,12,F11SP
9,Janssenlei 17,2022-09-24,00:00:00,32,10,22,F11SP
9,Janssenlei 17,2022-09-24,01:00:00,32,12,20,F11SP
9,Janssenlei 17,2022-09-24,02:00:00,46,10,36,F11SP
9,Janssenlei 17,2022-09-24,03:00:00,32,2,30,F11SP
9,Janssenlei 17,2022-09-24,04:00:00,26,12,14,F11SP
9,Janssenlei 17,2022-09-24,05:00:00,20,10,10,F11SP
9,Janssenlei 17,2022-09-24,06:00:00,12,2,10,F11SP
9,Janssenlei 17,2022-09-24,07:00:00,24,4,20,F11SP
9,Janssenlei 17,2022-09-24,08:00:00,108,50,58,F11SP
9,Janssenlei 17,2022-09-24,09:00:00,98,54,44,F11SP
9,Janssenlei 17,2022-09-24,10:00:00,100,46,54,F11SP
9,Janssenlei 17,2022-09-24,11:00:00,120,66,54,F11SP
9,Janssenlei 17,2022-09-24,12:00:00,66,36,30,F11SP
9,Janssenlei 17,2022-09-24,13:00:00,78,30,48,F11SP
9,Janssenlei 17,2022-09-24,14:00:00,114,48,66,F11SP
9,Janssenlei 17,2022-09-24,15:00:00,70,14,56,F11SP
9,Janssenlei 17,2022-09-24,16:00:00,112,48,64,F11SP
9,Janssenlei 17,2022-09-24,17:00:00,116,52,64,F11SP
9,Janssenlei 17,2022-09-24,18:00:00,82,34,48,F11SP
9,Janssenlei 17,2022-09-24,19:00:00,60,40,20,F11SP
9,Janssenlei 17,2022-09-24,20:00:00,46,28,18,F11SP
9,Janssenlei 17,2022-09-24,21:00:00,32,4,28,F11SP
9,Janssenlei 17,2022-09-24,22:00:00,24,10,14,F11SP
9,Janssenlei 17,2022-09-24,23:00:00,22,4,18,F11SP
9,Janssenlei 17,2022-09-25,00:00:00,16,4,12,F11SP
9,Janssenlei 17,2022-09-25,01:00:00,12,2,10,F11SP
9,Janssenlei 17,2022-09-25,02:00:00,12,8,4,F11SP
9,Janssenlei 17,2022-09-25,03:00:00,10,4,6,F11SP
9,Janssenlei 17,2022-09-25,04:00:00,10,2,8,F11SP
9,Janssenlei 17,2022-09-25,05:00:00,28,24,4,F11SP
9,Janssenlei 17,2022-09-25,06:00:00,60,48,12,F11SP
9,Janssenlei 17,2022-09-25,07:00:00,38,22,16,F11SP
9,Janssenlei 17,2022-09-25,08:00:00,100,46,54,F11SP
9,Janssenlei 17,2022-09-25,09:00:00,274,84,190,F11SP
9,Janssenlei 17,2022-09-25,10:00:00,444,188,256,F11SP
9,Janssenlei 17,2022-09-25,11:00:00,552,308,244,F11SP
9,Janssenlei 17,2022-09-25,12:00:00,482,220,262,F11SP
9,Janssenlei 17,2022-09-25,13:00:00,436,218,218,F11SP
9,Janssenlei 17,2022-09-25,14:00:00,440,216,224,F11SP
9,Janssenlei 17,2022-09-25,15:00:00,370,182,188,F11SP
9,Janssenlei 17,2022-09-25,16:00:00,286,130,156,F11SP
9,Janssenlei 17,2022-09-25,17:00:00,304,152,152,F11SP
9,Janssenlei 17,2022-09-25,18:00:00,202,124,78,F11SP
9,Janssenlei 17,2022-09-25,19:00:00,106,48,58,F11SP
9,Janssenlei 17,2022-09-25,20:00:00,52,16,36,F11SP
9,Janssenlei 17,2022-09-25,21:00:00,30,18,12,F11SP
9,Janssenlei 17,2022-09-25,22:00:00,40,4,36,F11SP
9,Janssenlei 17,2022-09-25,23:00:00,18,8,10,F11SP
9,Janssenlei 17,2022-09-26,00:00:00,4,0,4,F11SP
9,Janssenlei 17,2022-09-26,01:00:00,6,6,0,F11SP
9,Janssenlei 17,2022-09-26,02:00:00,2,0,2,F11SP
9,Janssenlei 17,2022-09-26,03:00:00,4,2,2,F11SP
9,Janssenlei 17,2022-09-26,04:00:00,14,6,8,F11SP
9,Janssenlei 17,2022-09-26,05:00:00,50,38,12,F11SP
9,Janssenlei 17,2022-09-26,06:00:00,92,58,34,F11SP
9,Janssenlei 17,2022-09-26,07:00:00,472,286,186,F11SP
9,Janssenlei 17,2022-09-26,08:00:00,546,338,208,F11SP
9,Janssenlei 17,2022-09-26,09:00:00,202,72,130,F11SP
9,Janssenlei 17,2022-09-26,10:00:00,84,54,30,F11SP
9,Janssenlei 17,2022-09-26,11:00:00,148,112,36,F11SP
9,Janssenlei 17,2022-09-26,12:00:00,202,56,146,F11SP
9,Janssenlei 17,2022-09-26,13:00:00,92,32,60,F11SP
9,Janssenlei 17,2022-09-26,14:00:00,160,78,82,F11SP
9,Janssenlei 17,2022-09-26,15:00:00,222,60,162,F11SP
9,Janssenlei 17,2022-09-26,16:00:00,432,138,294,F11SP
9,Janssenlei 17,2022-09-26,17:00:00,340,86,254,F11SP
9,Janssenlei 17,2022-09-26,18:00:00,172,32,140,F11SP
9,Janssenlei 17,2022-09-26,19:00:00,52,18,34,F11SP
9,Janssenlei 17,2022-09-26,20:00:00,52,12,40,F11SP
9,Janssenlei 17,2022-09-26,21:00:00,32,14,18,F11SP
9,Janssenlei 17,2022-09-26,22:00:00,20,2,18,F11SP
9,Janssenlei 17,2022-09-26,23:00:00,2,0,2,F11SP
9,Janssenlei 17,2022-09-27,00:00:00,0,0,0,F11SP
9,Janssenlei 17,2022-09-27,01:00:00,2,0,2,F11SP
9,Janssenlei 17,2022-09-27,02:00:00,0,0,0,F11SP
9,Janssenlei 17,2022-09-27,03:00:00,4,4,0,F11SP
9,Janssenlei 17,2022-09-27,04:00:00,0,0,0,F11SP
9,Janssenlei 17,2022-09-27,05:00:00,46,38,8,F11SP
9,Janssenlei 17,2022-09-27,06:00:00,100,56,44,F11SP
9,Janssenlei 17,2022-09-27,07:00:00,340,210,130,F11SP
9,Janssenlei 17,2022-09-27,08:00:00,466,314,152,F11SP
9,Janssenlei 17,2022-09-27,09:00:00,126,70,56,F11SP
9,Janssenlei 17,2022-09-27,10:00:00,78,32,46,F11SP
9,Janssenlei 17,2022-09-27,11:00:00,68,30,38,F11SP
9,Janssenlei 17,2022-09-27,12:00:00,118,54,64,F11SP
9,Janssenlei 17,2022-09-27,13:00:00,106,60,46,F11SP
9,Janssenlei 17,2022-09-27,14:00:00,132,52,80,F11SP
9,Janssenlei 17,2022-09-27,15:00:00,190,72,118,F11SP
9,Janssenlei 17,2022-09-27,16:00:00,422,114,308,F11SP
9,Janssenlei 17,2022-09-27,17:00:00,312,84,228,F11SP
9,Janssenlei 17,2022-09-27,18:00:00,198,26,172,F11SP
9,Janssenlei 17,2022-09-27,19:00:00,122,44,78,F11SP
9,Janssenlei 17,2022-09-27,20:00:00,54,28,26,F11SP
9,Janssenlei 17,2022-09-27,21:00:00,46,22,24,F11SP
9,Janssenlei 17,2022-09-27,22:00:00,62,2,60,F11SP
9,Janssenlei 17,2022-09-27,23:00:00,12,2,10,F11SP
9,Janssenlei 17,2022-09-28,00:00:00,14,4,10,F11SP
9,Janssenlei 17,2022-09-28,01:00:00,0,0,0,F11SP
9,Janssenlei 17,2022-09-28,02:00:00,0,0,0,F11SP
9,Janssenlei 17,2022-09-28,03:00:00,2,2,0,F11SP
9,Janssenlei 17,2022-09-28,04:00:00,6,4,2,F11SP
9,Janssenlei 17,2022-09-28,05:00:00,42,30,12,F11SP
9,Janssenlei 17,2022-09-28,06:00:00,118,66,52,F11SP
9,Janssenlei 17,2022-09-28,07:00:00,366,244,122,F11SP
9,Janssenlei 17,2022-09-28,08:00:00,556,344,212,F11SP
9,Janssenlei 17,2022-09-28,09:00:00,180,90,90,F11SP
9,Janssenlei 17,2022-09-28,10:00:00,190,90,100,F11SP
9,Janssenlei 17,2022-09-28,11:00:00,266,120,146,F11SP
9,Janssenlei 17,2022-09-28,12:00:00,454,148,306,F11SP
9,Janssenlei 17,2022-09-28,13:00:00,234,102,132,F11SP
9,Janssenlei 17,2022-09-28,14:00:00,138,54,84,F11SP
9,Janssenlei 17,2022-09-28,15:00:00,192,44,148,F11SP
9,Janssenlei 17,2022-09-28,16:00:00,346,98,248,F11SP
9,Janssenlei 17,2022-09-28,17:00:00,386,116,270,F11SP
9,Janssenlei 17,2022-09-28,18:00:00,296,92,204,F11SP
9,Janssenlei 17,2022-09-28,19:00:00,140,76,64,F11SP
9,Janssenlei 17,2022-09-28,20:00:00,82,40,42,F11SP
9,Janssenlei 17,2022-09-28,21:00:00,90,42,48,F11SP
9,Janssenlei 17,2022-09-28,22:00:00,56,10,46,F11SP
9,Janssenlei 17,2022-09-28,23:00:00,16,6,10,F11SP
9,Janssenlei 17,2022-09-29,00:00:00,8,0,8,F11SP
9,Janssenlei 17,2022-09-29,01:00:00,2,0,2,F11SP
9,Janssenlei 17,2022-09-29,02:00:00,0,0,0,F11SP
9,Janssenlei 17,2022-09-29,03:00:00,4,4,0,F11SP
9,Janssenlei 17,2022-09-29,04:00:00,12,12,0,F11SP
9,Janssenlei 17,2022-09-29,05:00:00,68,52,16,F11SP
9,Janssenlei 17,2022-09-29,06:00:00,136,84,52,F11SP
9,Janssenlei 17,2022-09-29,07:00:00,466,308,158,F11SP
9,Janssenlei 17,2022-09-29,08:00:00,620,420,200,F11SP
9,Janssenlei 17,2022-09-29,09:00:00,274,72,202,F11SP
9,Janssenlei 17,2022-09-29,10:00:00,210,100,110,F11SP
9,Janssenlei 17,2022-09-29,11:00:00,178,78,100,F11SP
9,Janssenlei 17,2022-09-29,12:00:00,294,128,166,F11SP
9,Janssenlei 17,2022-09-29,13:00:00,274,134,140,F11SP
9,Janssenlei 17,2022-09-29,14:00:00,310,162,148,F11SP
9,Janssenlei 17,2022-09-29,15:00:00,462,170,292,F11SP
9,Janssenlei 17,2022-09-29,16:00:00,650,210,440,F11SP
9,Janssenlei 17,2022-09-29,17:00:00,606,186,420,F11SP
9,Janssenlei 17,2022-09-29,18:00:00,300,104,196,F11SP
9,Janssenlei 17,2022-09-29,19:00:00,150,56,94,F11SP
9,Janssenlei 17,2022-09-29,20:00:00,130,70,60,F11SP
9,Janssenlei 17,2022-09-29,21:00:00,52,24,28,F11SP
9,Janssenlei 17,2022-09-29,22:00:00,84,20,64,F11SP
9,Janssenlei 17,2022-09-29,23:00:00,36,6,30,F11SP
9,Janssenlei 17,2022-09-30,00:00:00,30,6,24,F11SP
9,Janssenlei 17,2022-09-30,01:00:00,0,0,0,F11SP
9,Janssenlei 17,2022-09-30,02:00:00,6,2,4,F11SP
9,Janssenlei 17,2022-09-30,03:00:00,8,4,4,F11SP
9,Janssenlei 17,2022-09-30,04:00:00,8,6,2,F11SP
9,Janssenlei 17,2022-09-30,05:00:00,46,30,16,F11SP
9,Janssenlei 17,2022-09-30,06:00:00,100,58,42,F11SP
9,Janssenlei 17,2022-09-30,07:00:00,428,224,204,F11SP
9,Janssenlei 17,2022-09-30,08:00:00,540,376,164,F11SP
9,Janssenlei 17,2022-09-30,09:00:00,174,100,74,F11SP
9,Janssenlei 17,2022-09-30,10:00:00,226,86,140,F11SP
9,Janssenlei 17,2022-09-30,11:00:00,240,100,140,F11SP
9,Janssenlei 17,2022-09-30,12:00:00,306,126,180,F11SP
9,Janssenlei 17,2022-09-30,13:00:00,358,136,222,F11SP
9,Janssenlei 17,2022-09-30,14:00:00,358,162,196,F11SP
9,Janssenlei 17,2022-09-30,15:00:00,496,180,316,F11SP
9,Janssenlei 17,2022-09-30,16:00:00,666,202,464,F11SP
9,Janssenlei 17,2022-09-30,17:00:00,480,180,300,F11SP
9,Janssenlei 17,2022-09-30,18:00:00,332,116,216,F11SP
9,Janssenlei 17,2022-09-30,19:00:00,218,80,138,F11SP
9,Janssenlei 17,2022-09-30,20:00:00,130,42,88,F11SP
9,Janssenlei 17,2022-09-30,21:00:00,94,38,56,F11SP
9,Janssenlei 17,2022-09-30,22:00:00,72,30,42,F11SP
9,Janssenlei 17,2022-09-30,23:00:00,44,14,30,F11SP
9,Janssenlei 17,2022-10-01,00:00:00,18,10,8,F11SP
9,Janssenlei 17,2022-10-01,01:00:00,38,12,26,F11SP
9,Janssenlei 17,2022-10-01,02:00:00,24,16,8,F11SP
9,Janssenlei 17,2022-10-01,03:00:00,14,6,8,F11SP
9,Janssenlei 17,2022-10-01,04:00:00,20,4,16,F11SP
9,Janssenlei 17,2022-10-01,05:00:00,26,14,12,F11SP
9,Janssenlei 17,2022-10-01,06:00:00,24,14,10,F11SP
9,Janssenlei 17,2022-10-01,07:00:00,20,6,14,F11SP
9,Janssenlei 17,2022-10-01,08:00:00,80,32,48,F11SP
9,Janssenlei 17,2022-10-01,09:00:00,80,30,50,F11SP
9,Janssenlei 17,2022-10-01,10:00:00,168,64,104,F11SP
9,Janssenlei 17,2022-10-01,11:00:00,194,76,118,F11SP
9,Janssenlei 17,2022-10-01,12:00:00,254,114,140,F11SP
9,Janssenlei 17,2022-10-01,13:00:00,526,156,370,F11SP
9,Janssenlei 17,2022-10-01,14:00:00,330,132,198,F11SP
9,Janssenlei 17,2022-10-01,15:00:00,316,186,130,F11SP
9,Janssenlei 17,2022-10-01,16:00:00,362,198,164,F11SP
9,Janssenlei 17,2022-10-01,17:00:00,218,120,98,F11SP
9,Janssenlei 17,2022-10-01,18:00:00,194,92,102,F11SP
9,Janssenlei 17,2022-10-01,19:00:00,110,48,62,F11SP
9,Janssenlei 17,2022-10-01,20:00:00,46,32,14,F11SP
9,Janssenlei 17,2022-10-01,21:00:00,30,16,14,F11SP
9,Janssenlei 17,2022-10-01,22:00:00,30,4,26,F11SP
9,Janssenlei 17,2022-10-01,23:00:00,28,12,16,F11SP
9,Janssenlei 17,2022-10-02,00:00:00,8,2,6,F11SP
9,Janssenlei 17,2022-10-02,01:00:00,30,16,14,F11SP
9,Janssenlei 17,2022-10-02,02:00:00,16,10,6,F11SP
9,Janssenlei 17,2022-10-02,03:00:00,20,6,14,F11SP
9,Janssenlei 17,2022-10-02,04:00:00,10,4,6,F11SP
9,Janssenlei 17,2022-10-02,05:00:00,18,16,2,F11SP
9,Janssenlei 17,2022-10-02,06:00:00,18,8,10,F11SP
9,Janssenlei 17,2022-10-02,07:00:00,28,14,14,F11SP
9,Janssenlei 17,2022-10-02,08:00:00,90,40,50,F11SP
9,Janssenlei 17,2022-10-02,09:00:00,290,88,202,F11SP
9,Janssenlei 17,2022-10-02,10:00:00,288,106,182,F11SP
9,Janssenlei 17,2022-10-02,11:00:00,250,118,132,F11SP
9,Janssenlei 17,2022-10-02,12:00:00,312,130,182,F11SP
9,Janssenlei 17,2022-10-02,13:00:00,340,134,206,F11SP
9,Janssenlei 17,2022-10-02,14:00:00,422,120,302,F11SP
9,Janssenlei 17,2022-10-02,15:00:00,380,174,206,F11SP
9,Janssenlei 17,2022-10-02,16:00:00,416,262,154,F11SP
9,Janssenlei 17,2022-10-02,17:00:00,394,200,194,F11SP
9,Janssenlei 17,2022-10-02,18:00:00,228,126,102,F11SP
9,Janssenlei 17,2022-10-02,19:00:00,158,90,68,F11SP
9,Janssenlei 17,2022-10-02,20:00:00,76,32,44,F11SP
9,Janssenlei 17,2022-10-02,21:00:00,52,32,20,F11SP
9,Janssenlei 17,2022-10-02,22:00:00,46,14,32,F11SP
9,Janssenlei 17,2022-10-02,23:00:00,4,0,4,F11SP
9,Janssenlei 17,2022-10-03,00:00:00,2,0,2,F11SP
9,Janssenlei 17,2022-10-03,01:00:00,6,0,6,F11SP
9,Janssenlei 17,2022-10-03,02:00:00,0,0,0,F11SP
9,Janssenlei 17,2022-10-03,03:00:00,2,2,0,F11SP
9,Janssenlei 17,2022-10-03,04:00:00,6,6,0,F11SP
9,Janssenlei 17,2022-10-03,05:00:00,50,36,14,F11SP
9,Janssenlei 17,2022-10-03,06:00:00,140,92,48,F11SP
9,Janssenlei 17,2022-10-03,07:00:00,530,346,184,F11SP
9,Janssenlei 17,2022-10-03,08:00:00,702,462,240,F11SP
9,Janssenlei 17,2022-10-03,09:00:00,268,128,140,F11SP
9,Janssenlei 17,2022-10-03,10:00:00,188,90,98,F11SP
9,Janssenlei 17,2022-10-03,11:00:00,218,86,132,F11SP
9,Janssenlei 17,2022-10-03,12:00:00,340,134,206,F11SP
9,Janssenlei 17,2022-10-03,13:00:00,382,146,236,F11SP
9,Janssenlei 17,2022-10-03,14:00:00,532,200,332,F11SP
9,Janssenlei 17,2022-10-03,15:00:00,572,232,340,F11SP
9,Janssenlei 17,2022-10-03,16:00:00,776,270,506,F11SP
9,Janssenlei 17,2022-10-03,17:00:00,650,166,484,F11SP
9,Janssenlei 17,2022-10-03,18:00:00,340,82,258,F11SP
9,Janssenlei 17,2022-10-03,19:00:00,190,70,120,F11SP
9,Janssenlei 17,2022-10-03,20:00:00,122,52,70,F11SP
9,Janssenlei 17,2022-10-03,21:00:00,98,46,52,F11SP
9,Janssenlei 17,2022-10-03,22:00:00,86,28,58,F11SP
9,Janssenlei 17,2022-10-03,23:00:00,16,2,14,F11SP
9,Janssenlei 17,2022-10-04,00:00:00,0,0,0,F11SP
9,Janssenlei 17,2022-10-04,01:00:00,10,0,10,F11SP
9,Janssenlei 17,2022-10-04,02:00:00,4,4,0,F11SP
9,Janssenlei 17,2022-10-04,03:00:00,2,2,0,F11SP
9,Janssenlei 17,2022-10-04,04:00:00,2,2,0,F11SP
9,Janssenlei 17,2022-10-04,05:00:00,78,56,22,F11SP
9,Janssenlei 17,2022-10-04,06:00:00,200,126,74,F11SP
9,Janssenlei 17,2022-10-04,07:00:00,556,368,188,F11SP
9,Janssenlei 17,2022-10-04,08:00:00,630,360,270,F11SP
9,Janssenlei 17,2022-10-04,09:00:00,314,160,154,F11SP
9,Janssenlei 17,2022-10-04,10:00:00,414,232,182,F11SP
9,Janssenlei 17,2022-10-04,11:00:00,368,206,162,F11SP
9,Janssenlei 17,2022-10-04,12:00:00,446,186,260,F11SP
9,Janssenlei 17,2022-10-04,13:00:00,616,224,392,F11SP
9,Janssenlei 17,2022-10-04,14:00:00,652,272,380,F11SP
9,Janssenlei 17,2022-10-04,15:00:00,686,218,468,F11SP
9,Janssenlei 17,2022-10-04,16:00:00,916,372,544,F11SP
9,Janssenlei 17,2022-10-04,17:00:00,768,248,520,F11SP
9,Janssenlei 17,2022-10-04,18:00:00,470,150,320,F11SP
9,Janssenlei 17,2022-10-04,19:00:00,332,86,246,F11SP
9,Janssenlei 17,2022-10-04,20:00:00,286,128,158,F11SP
9,Janssenlei 17,2022-10-04,21:00:00,120,48,72,F11SP
9,Janssenlei 17,2022-10-04,22:00:00,104,38,66,F11SP
9,Janssenlei 17,2022-10-04,23:00:00,14,6,8,F11SP
9,Janssenlei 17,2022-10-05,00:00:00,22,10,12,F11SP
9,Janssenlei 17,2022-10-05,01:00:00,12,4,8,F11SP
9,Janssenlei 17,2022-10-05,02:00:00,4,0,4,F11SP
9,Janssenlei 17,2022-10-05,03:00:00,6,6,0,F11SP
9,Janssenlei 17,2022-10-05,04:00:00,12,12,0,F11SP
9,Janssenlei 17,2022-10-05,05:00:00,58,38,20,F11SP
9,Janssenlei 17,2022-10-05,06:00:00,198,124,74,F11SP
9,Janssenlei 17,2022-10-05,07:00:00,642,374,268,F11SP
9,Janssenlei 17,2022-10-05,08:00:00,670,438,232,F11SP
9,Janssenlei 17,2022-10-05,09:00:00,260,140,120,F11SP
9,Janssenlei 17,2022-10-05,10:00:00,238,98,140,F11SP
9,Janssenlei 17,2022-10-05,11:00:00,292,124,168,F11SP
9,Janssenlei 17,2022-10-05,12:00:00,622,282,340,F11SP
9,Janssenlei 17,2022-10-05,13:00:00,456,188,268,F11SP
9,Janssenlei 17,2022-10-05,14:00:00,560,190,370,F11SP
9,Janssenlei 17,2022-10-05,15:00:00,406,130,276,F11SP
9,Janssenlei 17,2022-10-05,16:00:00,600,190,410,F11SP
9,Janssenlei 17,2022-10-05,17:00:00,618,176,442,F11SP
9,Janssenlei 17,2022-10-05,18:00:00,432,136,296,F11SP
9,Janssenlei 17,2022-10-05,19:00:00,224,84,140,F11SP
9,Janssenlei 17,2022-10-05,20:00:00,104,56,48,F11SP
9,Janssenlei 17,2022-10-05,21:00:00,78,32,46,F11SP
9,Janssenlei 17,2022-10-05,22:00:00,104,32,72,F11SP
9,Janssenlei 17,2022-10-05,23:00:00,22,0,22,F11SP
9,Janssenlei 17,2022-10-06,00:00:00,6,0,6,F11SP
9,Janssenlei 17,2022-10-06,01:00:00,0,0,0,F11SP
9,Janssenlei 17,2022-10-06,02:00:00,0,0,0,F11SP
9,Janssenlei 17,2022-10-06,03:00:00,4,4,0,F11SP
9,Janssenlei 17,2022-10-06,04:00:00,14,14,0,F11SP
9,Janssenlei 17,2022-10-06,05:00:00,50,38,12,F11SP
9,Janssenlei 17,2022-10-06,06:00:00,180,118,62,F11SP
9,Janssenlei 17,2022-10-06,07:00:00,562,362,200,F11SP
9,Janssenlei 17,2022-10-06,08:00:00,724,516,208,F11SP
9,Janssenlei 17,2022-10-06,09:00:00,246,112,134,F11SP
9,Janssenlei 17,2022-10-06,10:00:00,206,76,130,F11SP
9,Janssenlei 17,2022-10-06,11:00:00,238,122,116,F11SP
9,Janssenlei 17,2022-10-06,12:00:00,252,96,156,F11SP
9,Janssenlei 17,2022-10-06,13:00:00,528,188,340,F11SP
9,Janssenlei 17,2022-10-06,14:00:00,522,178,344,F11SP
9,Janssenlei 17,2022-10-06,15:00:00,506,174,332,F11SP
9,Janssenlei 17,2022-10-06,16:00:00,884,312,572,F11SP
9,Janssenlei 17,2022-10-06,17:00:00,624,206,418,F11SP
9,Janssenlei 17,2022-10-06,18:00:00,384,128,256,F11SP
9,Janssenlei 17,2022-10-06,19:00:00,216,80,136,F11SP
9,Janssenlei 17,2022-10-06,20:00:00,130,50,80,F11SP
9,Janssenlei 17,2022-10-06,21:00:00,92,58,34,F11SP
9,Janssenlei 17,2022-10-06,22:00:00,164,58,106,F11SP
9,Janssenlei 17,2022-10-06,23:00:00,38,6,32,F11SP
9,Janssenlei 17,2022-10-07,00:00:00,30,2,28,F11SP
9,Janssenlei 17,2022-10-07,01:00:00,6,0,6,F11SP
9,Janssenlei 17,2022-10-07,02:00:00,0,0,0,F11SP
9,Janssenlei 17,2022-10-07,03:00:00,6,2,4,F11SP
9,Janssenlei 17,2022-10-07,04:00:00,16,16,0,F11SP
9,Janssenlei 17,2022-10-07,05:00:00,54,44,10,F11SP
9,Janssenlei 17,2022-10-07,06:00:00,146,80,66,F11SP
9,Janssenlei 17,2022-10-07,07:00:00,452,268,184,F11SP
9,Janssenlei 17,2022-10-07,08:00:00,664,364,300,F11SP
9,Janssenlei 17,2022-10-07,09:00:00,290,104,186,F11SP
9,Janssenlei 17,2022-10-07,10:00:00,222,92,130,F11SP
9,Janssenlei 17,2022-10-07,11:00:00,300,160,140,F11SP
9,Janssenlei 17,2022-10-07,12:00:00,338,128,210,F11SP
9,Janssenlei 17,2022-10-07,13:00:00,362,156,206,F11SP
9,Janssenlei 17,2022-10-07,14:00:00,380,124,256,F11SP
9,Janssenlei 17,2022-10-07,15:00:00,604,266,338,F11SP
9,Janssenlei 17,2022-10-07,16:00:00,840,326,514,F11SP
9,Janssenlei 17,2022-10-07,17:00:00,526,174,352,F11SP
9,Janssenlei 17,2022-10-07,18:00:00,296,104,192,F11SP
9,Janssenlei 17,2022-10-07,19:00:00,158,42,116,F11SP
9,Janssenlei 17,2022-10-07,20:00:00,146,68,78,F11SP
9,Janssenlei 17,2022-10-07,21:00:00,56,38,18,F11SP
9,Janssenlei 17,2022-10-07,22:00:00,78,16,62,F11SP
9,Janssenlei 17,2022-10-07,23:00:00,58,24,34,F11SP
9,Janssenlei 17,2022-10-08,00:00:00,26,4,22,F11SP
9,Janssenlei 17,2022-10-08,01:00:00,34,16,18,F11SP
9,Janssenlei 17,2022-10-08,02:00:00,22,16,6,F11SP
9,Janssenlei 17,2022-10-08,03:00:00,8,2,6,F11SP
9,Janssenlei 17,2022-10-08,04:00:00,14,8,6,F11SP
9,Janssenlei 17,2022-10-08,05:00:00,12,6,6,F11SP
9,Janssenlei 17,2022-10-08,06:00:00,42,8,34,F11SP
9,Janssenlei 17,2022-10-08,07:00:00,40,14,26,F11SP
9,Janssenlei 17,2022-10-08,08:00:00,104,38,66,F11SP
9,Janssenlei 17,2022-10-08,09:00:00,192,66,126,F11SP
9,Janssenlei 17,2022-10-08,10:00:00,246,106,140,F11SP
9,Janssenlei 17,2022-10-08,11:00:00,346,132,214,F11SP
9,Janssenlei 17,2022-10-08,12:00:00,314,178,136,F11SP
9,Janssenlei 17,2022-10-08,13:00:00,374,132,242,F11SP
9,Janssenlei 17,2022-10-08,14:00:00,464,212,252,F11SP
9,Janssenlei 17,2022-10-08,15:00:00,380,160,220,F11SP
9,Janssenlei 17,2022-10-08,16:00:00,382,196,186,F11SP
9,Janssenlei 17,2022-10-08,17:00:00,346,162,184,F11SP
9,Janssenlei 17,2022-10-08,18:00:00,192,86,106,F11SP
9,Janssenlei 17,2022-10-08,19:00:00,72,36,36,F11SP
9,Janssenlei 17,2022-10-08,20:00:00,74,40,34,F11SP
9,Janssenlei 17,2022-10-08,21:00:00,42,30,12,F11SP
9,Janssenlei 17,2022-10-08,22:00:00,44,10,34,F11SP
9,Janssenlei 17,2022-10-08,23:00:00,32,6,26,F11SP
9,Janssenlei 17,2022-10-09,00:00:00,18,6,12,F11SP
9,Janssenlei 17,2022-10-09,01:00:00,20,8,12,F11SP
9,Janssenlei 17,2022-10-09,02:00:00,2,0,2,F11SP
9,Janssenlei 17,2022-10-09,03:00:00,16,8,8,F11SP
9,Janssenlei 17,2022-10-09,04:00:00,4,2,2,F11SP
9,Janssenlei 17,2022-10-09,05:00:00,26,12,14,F11SP
9,Janssenlei 17,2022-10-09,06:00:00,16,10,6,F11SP
9,Janssenlei 17,2022-10-09,07:00:00,24,8,16,F11SP
9,Janssenlei 17,2022-10-09,08:00:00,110,30,80,F11SP
9,Janssenlei 17,2022-10-09,09:00:00,364,138,226,F11SP
9,Janssenlei 17,2022-10-09,10:00:00,326,104,222,F11SP
9,Janssenlei 17,2022-10-09,11:00:00,616,256,360,F11SP
9,Janssenlei 17,2022-10-09,12:00:00,404,198,206,F11SP
9,Janssenlei 17,2022-10-09,13:00:00,782,286,496,F11SP
9,Janssenlei 17,2022-10-09,14:00:00,1020,324,696,F11SP
9,Janssenlei 17,2022-10-09,15:00:00,716,358,358,F11SP
9,Janssenlei 17,2022-10-09,16:00:00,690,372,318,F11SP
9,Janssenlei 17,2022-10-09,17:00:00,498,312,186,F11SP
9,Janssenlei 17,2022-10-09,18:00:00,308,208,100,F11SP
9,Janssenlei 17,2022-10-09,19:00:00,118,56,62,F11SP
9,Janssenlei 17,2022-10-09,20:00:00,68,46,22,F11SP
9,Janssenlei 17,2022-10-09,21:00:00,30,22,8,F11SP
9,Janssenlei 17,2022-10-09,22:00:00,48,12,36,F11SP
9,Janssenlei 17,2022-10-09,23:00:00,6,0,6,F11SP
9,Janssenlei 17,2022-10-10,00:00:00,0,0,0,F11SP
9,Janssenlei 17,2022-10-10,01:00:00,6,2,4,F11SP
9,Janssenlei 17,2022-10-10,02:00:00,0,0,0,F11SP
9,Janssenlei 17,2022-10-10,03:00:00,6,6,0,F11SP
9,Janssenlei 17,2022-10-10,04:00:00,10,10,0,F11SP
9,Janssenlei 17,2022-10-10,05:00:00,52,40,12,F11SP
9,Janssenlei 17,2022-10-10,06:00:00,156,104,52,F11SP
9,Janssenlei 17,2022-10-10,07:00:00,478,350,128,F11SP
9,Janssenlei 17,2022-10-10,08:00:00,604,414,190,F11SP
9,Janssenlei 17,2022-10-10,09:00:00,150,98,52,F11SP
9,Janssenlei 17,2022-10-10,10:00:00,202,100,102,F11SP
9,Janssenlei 17,2022-10-10,11:00:00,198,110,88,F11SP
9,Janssenlei 17,2022-10-10,12:00:00,262,142,120,F11SP
9,Janssenlei 17,2022-10-10,13:00:00,260,88,172,F11SP
9,Janssenlei 17,2022-10-10,14:00:00,260,124,136,F11SP
9,Janssenlei 17,2022-10-10,15:00:00,380,122,258,F11SP
9,Janssenlei 17,2022-10-10,16:00:00,586,164,422,F11SP
9,Janssenlei 17,2022-10-10,17:00:00,480,100,380,F11SP
9,Janssenlei 17,2022-10-10,18:00:00,252,54,198,F11SP
9,Janssenlei 17,2022-10-10,19:00:00,130,48,82,F11SP
9,Janssenlei 17,2022-10-10,20:00:00,76,34,42,F11SP
9,Janssenlei 17,2022-10-10,21:00:00,30,12,18,F11SP
9,Janssenlei 17,2022-10-10,22:00:00,56,10,46,F11SP
9,Janssenlei 17,2022-10-10,23:00:00,8,2,6,F11SP
9,Janssenlei 17,2022-10-11,00:00:00,4,0,4,F11SP
9,Janssenlei 17,2022-10-11,01:00:00,2,0,2,F11SP
9,Janssenlei 17,2022-10-11,02:00:00,4,4,0,F11SP
9,Janssenlei 17,2022-10-11,03:00:00,2,2,0,F11SP
9,Janssenlei 17,2022-10-11,04:00:00,12,6,6,F11SP
9,Janssenlei 17,2022-10-11,05:00:00,76,54,22,F11SP
9,Janssenlei 17,2022-10-11,06:00:00,178,126,52,F11SP
9,Janssenlei 17,2022-10-11,07:00:00,540,370,170,F11SP
9,Janssenlei 17,2022-10-11,08:00:00,686,494,192,F11SP
9,Janssenlei 17,2022-10-11,09:00:00,164,88,76,F11SP
9,Janssenlei 17,2022-10-11,10:00:00,144,56,88,F11SP
9,Janssenlei 17,2022-10-11,11:00:00,172,92,80,F11SP
9,Janssenlei 17,2022-10-11,12:00:00,224,100,124,F11SP
9,Janssenlei 17,2022-10-11,13:00:00,378,166,212,F11SP
9,Janssenlei 17,2022-10-11,14:00:00,424,144,280,F11SP
9,Janssenlei 17,2022-10-11,15:00:00,532,194,338,F11SP
9,Janssenlei 17,2022-10-11,16:00:00,724,222,502,F11SP
9,Janssenlei 17,2022-10-11,17:00:00,758,252,506,F11SP
9,Janssenlei 17,2022-10-11,18:00:00,398,94,304,F11SP
9,Janssenlei 17,2022-10-11,19:00:00,134,38,96,F11SP
9,Janssenlei 17,2022-10-11,20:00:00,118,60,58,F11SP
9,Janssenlei 17,2022-10-11,21:00:00,64,14,50,F11SP
9,Janssenlei 17,2022-10-11,22:00:00,104,34,70,F11SP
9,Janssenlei 17,2022-10-11,23:00:00,16,4,12,F11SP
9,Janssenlei 17,2022-10-12,00:00:00,6,0,6,F11SP
9,Janssenlei 17,2022-10-12,01:00:00,8,6,2,F11SP
9,Janssenlei 17,2022-10-12,02:00:00,10,4,6,F11SP
9,Janssenlei 17,2022-10-12,03:00:00,4,2,2,F11SP
9,Janssenlei 17,2022-10-12,04:00:00,14,12,2,F11SP
9,Janssenlei 17,2022-10-12,05:00:00,52,32,20,F11SP
9,Janssenlei 17,2022-10-12,06:00:00,140,78,62,F11SP
9,Janssenlei 17,2022-10-12,07:00:00,472,264,208,F11SP
9,Janssenlei 17,2022-10-12,08:00:00,632,424,208,F11SP
9,Janssenlei 17,2022-10-12,09:00:00,222,120,102,F11SP
9,Janssenlei 17,2022-10-12,10:00:00,216,114,102,F11SP
9,Janssenlei 17,2022-10-12,11:00:00,214,104,110,F11SP
9,Janssenlei 17,2022-10-12,12:00:00,578,212,366,F11SP
9,Janssenlei 17,2022-10-12,13:00:00,470,140,330,F11SP
9,Janssenlei 17,2022-10-12,14:00:00,474,138,336,F11SP
9,Janssenlei 17,2022-10-12,15:00:00,342,116,226,F11SP
9,Janssenlei 17,2022-10-12,16:00:00,510,178,332,F11SP
9,Janssenlei 17,2022-10-12,17:00:00,516,154,362,F11SP
9,Janssenlei 17,2022-10-12,18:00:00,378,128,250,F11SP
9,Janssenlei 17,2022-10-12,19:00:00,128,58,70,F11SP
9,Janssenlei 17,2022-10-12,20:00:00,124,68,56,F11SP
9,Janssenlei 17,2022-10-12,21:00:00,52,32,20,F11SP
9,Janssenlei 17,2022-10-12,22:00:00,68,8,60,F11SP
9,Janssenlei 17,2022-10-12,23:00:00,12,2,10,F11SP
9,Janssenlei 17,2022-10-13,00:00:00,18,6,12,F11SP
9,Janssenlei 17,2022-10-13,01:00:00,0,0,0,F11SP
9,Janssenlei 17,2022-10-13,02:00:00,6,0,6,F11SP
9,Janssenlei 17,2022-10-13,03:00:00,2,2,0,F11SP
9,Janssenlei 17,2022-10-13,04:00:00,4,4,0,F11SP
9,Janssenlei 17,2022-10-13,05:00:00,46,30,16,F11SP
9,Janssenlei 17,2022-10-13,06:00:00,128,74,54,F11SP
9,Janssenlei 17,2022-10-13,07:00:00,444,278,166,F11SP
9,Janssenlei 17,2022-10-13,08:00:00,668,460,208,F11SP
9,Janssenlei 17,2022-10-13,09:00:00,206,106,100,F11SP
9,Janssenlei 17,2022-10-13,10:00:00,104,38,66,F11SP
9,Janssenlei 17,2022-10-13,11:00:00,98,42,56,F11SP
9,Janssenlei 17,2022-10-13,12:00:00,138,58,80,F11SP
9,Janssenlei 17,2022-10-13,13:00:00,134,52,82,F11SP
9,Janssenlei 17,2022-10-13,14:00:00,172,60,112,F11SP
9,Janssenlei 17,2022-10-13,15:00:00,304,102,202,F11SP
9,Janssenlei 17,2022-10-13,16:00:00,556,166,390,F11SP
9,Janssenlei 17,2022-10-13,17:00:00,476,116,360,F11SP
9,Janssenlei 17,2022-10-13,18:00:00,262,52,210,F11SP
9,Janssenlei 17,2022-10-13,19:00:00,98,36,62,F11SP
9,Janssenlei 17,2022-10-13,20:00:00,88,28,60,F11SP
9,Janssenlei 17,2022-10-13,21:00:00,40,22,18,F11SP
9,Janssenlei 17,2022-10-13,22:00:00,58,18,40,F11SP
9,Janssenlei 17,2022-10-13,23:00:00,22,4,18,F11SP
9,Janssenlei 17,2022-10-14,00:00:00,10,4,6,F11SP
9,Janssenlei 17,2022-10-14,01:00:00,6,6,0,F11SP
9,Janssenlei 17,2022-10-14,02:00:00,6,6,0,F11SP
9,Janssenlei 17,2022-10-14,03:00:00,6,4,2,F11SP
9,Janssenlei 17,2022-10-14,04:00:00,12,10,2,F11SP
9,Janssenlei 17,2022-10-14,05:00:00,50,32,18,F11SP
9,Janssenlei 17,2022-10-14,06:00:00,106,62,44,F11SP
9,Janssenlei 17,2022-10-14,07:00:00,404,242,162,F11SP
9,Janssenlei 17,2022-10-14,08:00:00,782,602,180,F11SP
9,Janssenlei 17,2022-10-14,09:00:00,124,74,50,F11SP
9,Janssenlei 17,2022-10-14,10:00:00,88,40,48,F11SP
9,Janssenlei 17,2022-10-14,11:00:00,112,36,76,F11SP
9,Janssenlei 17,2022-10-14,12:00:00,108,42,66,F11SP
9,Janssenlei 17,2022-10-14,13:00:00,156,60,96,F11SP
9,Janssenlei 17,2022-10-14,14:00:00,150,54,96,F11SP
9,Janssenlei 17,2022-10-14,15:00:00,554,108,446,F11SP
9,Janssenlei 17,2022-10-14,16:00:00,538,160,378,F11SP
9,Janssenlei 17,2022-10-14,17:00:00,322,108,214,F11SP
9,Janssenlei 17,2022-10-14,18:00:00,244,82,162,F11SP
9,Janssenlei 17,2022-10-14,19:00:00,132,40,92,F11SP
9,Janssenlei 17,2022-10-14,20:00:00,86,52,34,F11SP
9,Janssenlei 17,2022-10-14,21:00:00,66,30,36,F11SP
9,Janssenlei 17,2022-10-14,22:00:00,64,22,42,F11SP
9,Janssenlei 17,2022-10-14,23:00:00,36,8,28,F11SP
9,Janssenlei 17,2022-10-15,00:00:00,36,16,20,F11SP
9,Janssenlei 17,2022-10-15,01:00:00,16,0,16,F11SP
9,Janssenlei 17,2022-10-15,02:00:00,24,16,8,F11SP
9,Janssenlei 17,2022-10-15,03:00:00,16,6,10,F11SP
9,Janssenlei 17,2022-10-15,04:00:00,12,8,4,F11SP
9,Janssenlei 17,2022-10-15,05:00:00,36,12,24,F11SP
9,Janssenlei 17,2022-10-15,06:00:00,24,12,12,F11SP
9,Janssenlei 17,2022-10-15,07:00:00,38,18,20,F11SP
9,Janssenlei 17,2022-10-15,08:00:00,84,34,50,F11SP
9,Janssenlei 17,2022-10-15,09:00:00,138,52,86,F11SP
9,Janssenlei 17,2022-10-15,10:00:00,162,64,98,F11SP
9,Janssenlei 17,2022-10-15,11:00:00,230,80,150,F11SP
9,Janssenlei 17,2022-10-15,12:00:00,186,80,106,F11SP
9,Janssenlei 17,2022-10-15,13:00:00,200,102,98,F11SP
9,Janssenlei 17,2022-10-15,14:00:00,220,88,132,F11SP
9,Janssenlei 17,2022-10-15,15:00:00,308,148,160,F11SP
9,Janssenlei 17,2022-10-15,16:00:00,260,126,134,F11SP
9,Janssenlei 17,2022-10-15,17:00:00,258,122,136,F11SP
9,Janssenlei 17,2022-10-15,18:00:00,176,104,72,F11SP
9,Janssenlei 17,2022-10-15,19:00:00,96,40,56,F11SP
9,Janssenlei 17,2022-10-15,20:00:00,54,12,42,F11SP
9,Janssenlei 17,2022-10-15,21:00:00,66,34,32,F11SP
9,Janssenlei 17,2022-10-15,22:00:00,36,12,24,F11SP
9,Janssenlei 17,2022-10-15,23:00:00,38,20,18,F11SP
9,Janssenlei 17,2022-10-16,00:00:00,28,14,14,F11SP
9,Janssenlei 17,2022-10-16,01:00:00,36,18,18,F11SP
9,Janssenlei 17,2022-10-16,02:00:00,24,14,10,F11SP
9,Janssenlei 17,2022-10-16,03:00:00,8,2,6,F11SP
9,Janssenlei 17,2022-10-16,04:00:00,22,14,8,F11SP
9,Janssenlei 17,2022-10-16,05:00:00,16,12,4,F11SP
9,Janssenlei 17,2022-10-16,06:00:00,12,10,2,F11SP
9,Janssenlei 17,2022-10-16,07:00:00,28,10,18,F11SP
9,Janssenlei 17,2022-10-16,08:00:00,104,48,56,F11SP
9,Janssenlei 17,2022-10-16,09:00:00,410,148,262,F11SP
9,Janssenlei 17,2022-10-16,10:00:00,338,102,236,F11SP
9,Janssenlei 17,2022-10-16,11:00:00,434,234,200,F11SP
9,Janssenlei 17,2022-10-16,12:00:00,426,216,210,F11SP
9,Janssenlei 17,2022-10-16,13:00:00,494,234,260,F11SP
9,Janssenlei 17,2022-10-16,14:00:00,634,302,332,F11SP
9,Janssenlei 17,2022-10-16,15:00:00,628,338,290,F11SP
9,Janssenlei 17,2022-10-16,16:00:00,332,152,180,F11SP
9,Janssenlei 17,2022-10-16,17:00:00,208,94,114,F11SP
9,Janssenlei 17,2022-10-16,18:00:00,166,80,86,F11SP
9,Janssenlei 17,2022-10-16,19:00:00,70,44,26,F11SP
9,Janssenlei 17,2022-10-16,20:00:00,38,12,26,F11SP
9,Janssenlei 17,2022-10-16,21:00:00,22,10,12,F11SP
9,Janssenlei 17,2022-10-16,22:00:00,54,14,40,F11SP
9,Janssenlei 17,2022-10-16,23:00:00,16,2,14,F11SP
9,Janssenlei 17,2022-10-17,00:00:00,6,4,2,F11SP
9,Janssenlei 17,2022-10-17,01:00:00,0,0,0,F11SP
9,Janssenlei 17,2022-10-17,02:00:00,4,4,0,F11SP
9,Janssenlei 17,2022-10-17,03:00:00,0,0,0,F11SP
9,Janssenlei 17,2022-10-17,04:00:00,6,4,2,F11SP
9,Janssenlei 17,2022-10-17,05:00:00,72,60,12,F11SP
9,Janssenlei 17,2022-10-17,06:00:00,128,84,44,F11SP
9,Janssenlei 17,2022-10-17,07:00:00,480,326,154,F11SP
9,Janssenlei 17,2022-10-17,08:00:00,530,360,170,F11SP
9,Janssenlei 17,2022-10-17,09:00:00,74,44,30,F11SP
9,Janssenlei 17,2022-10-17,10:00:00,38,14,24,F11SP
9,Janssenlei 17,2022-10-17,11:00:00,56,30,26,F11SP
9,Janssenlei 17,2022-10-17,12:00:00,160,72,88,F11SP
9,Janssenlei 17,2022-10-17,13:00:00,136,54,82,F11SP
9,Janssenlei 17,2022-10-17,14:00:00,122,52,70,F11SP
9,Janssenlei 17,2022-10-17,15:00:00,268,76,192,F11SP
9,Janssenlei 17,2022-10-17,16:00:00,590,150,440,F11SP
9,Janssenlei 17,2022-10-17,17:00:00,398,98,300,F11SP
9,Janssenlei 17,2022-10-17,18:00:00,238,48,190,F11SP
9,Janssenlei 17,2022-10-17,19:00:00,102,38,64,F11SP
9,Janssenlei 17,2022-10-17,20:00:00,60,26,34,F11SP
9,Janssenlei 17,2022-10-17,21:00:00,40,20,20,F11SP
9,Janssenlei 17,2022-10-17,22:00:00,68,22,46,F11SP
9,Janssenlei 17,2022-10-17,23:00:00,16,0,16,F11SP
9,Janssenlei 17,2022-10-18,00:00:00,0,0,0,F11SP
9,Janssenlei 17,2022-10-18,01:00:00,4,4,0,F11SP
9,Janssenlei 17,2022-10-18,02:00:00,0,0,0,F11SP
9,Janssenlei 17,2022-10-18,03:00:00,0,0,0,F11SP
9,Janssenlei 17,2022-10-18,04:00:00,12,10,2,F11SP
9,Janssenlei 17,2022-10-18,05:00:00,76,60,16,F11SP
9,Janssenlei 17,2022-10-18,06:00:00,178,122,56,F11SP
9,Janssenlei 17,2022-10-18,07:00:00,542,362,180,F11SP
9,Janssenlei 17,2022-10-18,08:00:00,648,470,178,F11SP
9,Janssenlei 17,2022-10-18,09:00:00,238,130,108,F11SP
9,Janssenlei 17,2022-10-18,10:00:00,230,100,130,F11SP
9,Janssenlei 17,2022-10-18,11:00:00,176,102,74,F11SP
9,Janssenlei 17,2022-10-18,12:00:00,292,128,164,F11SP
9,Janssenlei 17,2022-10-18,13:00:00,392,116,276,F11SP
9,Janssenlei 17,2022-10-18,14:00:00,572,254,318,F11SP
9,Janssenlei 17,2022-10-18,15:00:00,592,220,372,F11SP
9,Janssenlei 17,2022-10-18,16:00:00,826,266,560,F11SP
9,Janssenlei 17,2022-10-18,17:00:00,698,196,502,F11SP
9,Janssenlei 17,2022-10-18,18:00:00,376,120,256,F11SP
9,Janssenlei 17,2022-10-18,19:00:00,204,76,128,F11SP
9,Janssenlei 17,2022-10-18,20:00:00,112,60,52,F11SP
9,Janssenlei 17,2022-10-18,21:00:00,66,34,32,F11SP
9,Janssenlei 17,2022-10-18,22:00:00,80,26,54,F11SP
9,Janssenlei 17,2022-10-18,23:00:00,20,2,18,F11SP
9,Janssenlei 17,2022-10-19,00:00:00,2,2,0,F11SP
9,Janssenlei 17,2022-10-19,01:00:00,16,6,10,F11SP
9,Janssenlei 17,2022-10-19,02:00:00,2,2,0,F11SP
9,Janssenlei 17,2022-10-19,03:00:00,2,0,2,F11SP
9,Janssenlei 17,2022-10-19,04:00:00,20,16,4,F11SP
9,Janssenlei 17,2022-10-19,05:00:00,56,48,8,F11SP
9,Janssenlei 17,2022-10-19,06:00:00,190,120,70,F11SP
9,Janssenlei 17,2022-10-19,07:00:00,478,286,192,F11SP
9,Janssenlei 17,2022-10-19,08:00:00,636,440,196,F11SP
9,Janssenlei 17,2022-10-19,09:00:00,236,126,110,F11SP
9,Janssenlei 17,2022-10-19,10:00:00,192,98,94,F11SP
9,Janssenlei 17,2022-10-19,11:00:00,358,154,204,F11SP
9,Janssenlei 17,2022-10-19,12:00:00,530,184,346,F11SP
9,Janssenlei 17,2022-10-19,13:00:00,400,136,264,F11SP
9,Janssenlei 17,2022-10-19,14:00:00,576,222,354,F11SP
9,Janssenlei 17,2022-10-19,15:00:00,392,158,234,F11SP
9,Janssenlei 17,2022-10-19,16:00:00,620,224,396,F11SP
9,Janssenlei 17,2022-10-19,17:00:00,536,164,372,F11SP
9,Janssenlei 17,2022-10-19,18:00:00,320,120,200,F11SP
9,Janssenlei 17,2022-10-19,19:00:00,188,80,108,F11SP
9,Janssenlei 17,2022-10-19,20:00:00,96,52,44,F11SP
9,Janssenlei 17,2022-10-19,21:00:00,70,38,32,F11SP
9,Janssenlei 17,2022-10-19,22:00:00,148,40,108,F11SP
9,Janssenlei 17,2022-10-19,23:00:00,28,12,16,F11SP
9,Janssenlei 17,2022-10-20,00:00:00,10,0,10,F11SP
9,Janssenlei 17,2022-10-20,01:00:00,6,0,6,F11SP
9,Janssenlei 17,2022-10-20,02:00:00,2,0,2,F11SP
9,Janssenlei 17,2022-10-20,03:00:00,0,0,0,F11SP
9,Janssenlei 17,2022-10-20,04:00:00,10,10,0,F11SP
9,Janssenlei 17,2022-10-20,05:00:00,48,44,4,F11SP
9,Janssenlei 17,2022-10-20,06:00:00,158,98,60,F11SP
9,Janssenlei 17,2022-10-20,07:00:00,488,304,184,F11SP
9,Janssenlei 17,2022-10-20,08:00:00,650,436,214,F11SP
9,Janssenlei 17,2022-10-20,09:00:00,162,94,68,F11SP
9,Janssenlei 17,2022-10-20,10:00:00,92,50,42,F11SP
9,Janssenlei 17,2022-10-20,11:00:00,58,16,42,F11SP
9,Janssenlei 17,2022-10-20,12:00:00,116,62,54,F11SP
9,Janssenlei 17,2022-10-20,13:00:00,146,50,96,F11SP
9,Janssenlei 17,2022-10-20,14:00:00,214,66,148,F11SP
9,Janssenlei 17,2022-10-20,15:00:00,286,98,188,F11SP
9,Janssenlei 17,2022-10-20,16:00:00,604,180,424,F11SP
9,Janssenlei 17,2022-10-20,17:00:00,564,184,380,F11SP
9,Janssenlei 17,2022-10-20,18:00:00,334,118,216,F11SP
9,Janssenlei 17,2022-10-20,19:00:00,146,42,104,F11SP
9,Janssenlei 17,2022-10-20,20:00:00,108,34,74,F11SP
9,Janssenlei 17,2022-10-20,21:00:00,52,30,22,F11SP
9,Janssenlei 17,2022-10-20,22:00:00,80,26,54,F11SP
9,Janssenlei 17,2022-10-20,23:00:00,14,6,8,F11SP
9,Janssenlei 17,2022-10-21,00:00:00,10,4,6,F11SP
9,Janssenlei 17,2022-10-21,01:00:00,6,2,4,F11SP
9,Janssenlei 17,2022-10-21,02:00:00,12,2,10,F11SP
9,Janssenlei 17,2022-10-21,03:00:00,2,0,2,F11SP
9,Janssenlei 17,2022-10-21,04:00:00,14,10,4,F11SP
9,Janssenlei 17,2022-10-21,05:00:00,52,40,12,F11SP
9,Janssenlei 17,2022-10-21,06:00:00,126,68,58,F11SP
9,Janssenlei 17,2022-10-21,07:00:00,396,246,150,F11SP
9,Janssenlei 17,2022-10-21,08:00:00,534,372,162,F11SP
9,Janssenlei 17,2022-10-21,09:00:00,184,102,82,F11SP
9,Janssenlei 17,2022-10-21,10:00:00,116,54,62,F11SP
9,Janssenlei 17,2022-10-21,11:00:00,124,50,74,F11SP
9,Janssenlei 17,2022-10-21,12:00:00,202,106,96,F11SP
9,Janssenlei 17,2022-10-21,13:00:00,308,100,208,F11SP
9,Janssenlei 17,2022-10-21,14:00:00,322,104,218,F11SP
9,Janssenlei 17,2022-10-21,15:00:00,474,146,328,F11SP
9,Janssenlei 17,2022-10-21,16:00:00,602,218,384,F11SP
9,Janssenlei 17,2022-10-21,17:00:00,402,136,266,F11SP
9,Janssenlei 17,2022-10-21,18:00:00,258,102,156,F11SP
9,Janssenlei 17,2022-10-21,19:00:00,170,62,108,F11SP
9,Janssenlei 17,2022-10-21,20:00:00,96,40,56,F11SP
9,Janssenlei 17,2022-10-21,21:00:00,64,22,42,F11SP
9,Janssenlei 17,2022-10-21,22:00:00,52,26,26,F11SP
9,Janssenlei 17,2022-10-21,23:00:00,64,18,46,F11SP
9,Janssenlei 17,2022-10-22,00:00:00,54,24,30,F11SP
9,Janssenlei 17,2022-10-22,01:00:00,14,4,10,F11SP
9,Janssenlei 17,2022-10-22,02:00:00,18,2,16,F11SP
9,Janssenlei 17,2022-10-22,03:00:00,8,2,6,F11SP
9,Janssenlei 17,2022-10-22,04:00:00,6,2,4,F11SP
9,Janssenlei 17,2022-10-22,05:00:00,20,8,12,F11SP
9,Janssenlei 17,2022-10-22,06:00:00,36,12,24,F11SP
9,Janssenlei 17,2022-10-22,07:00:00,24,14,10,F11SP
9,Janssenlei 17,2022-10-22,08:00:00,94,28,66,F11SP
9,Janssenlei 17,2022-10-22,09:00:00,174,62,112,F11SP
9,Janssenlei 17,2022-10-22,10:00:00,266,114,152,F11SP
9,Janssenlei 17,2022-10-22,11:00:00,288,128,160,F11SP
9,Janssenlei 17,2022-10-22,12:00:00,288,184,104,F11SP
9,Janssenlei 17,2022-10-22,13:00:00,394,194,200,F11SP
9,Janssenlei 17,2022-10-22,14:00:00,424,192,232,F11SP
9,Janssenlei 17,2022-10-22,15:00:00,346,166,180,F11SP
9,Janssenlei 17,2022-10-22,16:00:00,288,144,144,F11SP
9,Janssenlei 17,2022-10-22,17:00:00,302,166,136,F11SP
9,Janssenlei 17,2022-10-22,18:00:00,168,100,68,F11SP
9,Janssenlei 17,2022-10-22,19:00:00,154,78,76,F11SP
9,Janssenlei 17,2022-10-22,20:00:00,58,22,36,F11SP
9,Janssenlei 17,2022-10-22,21:00:00,30,6,24,F11SP
9,Janssenlei 17,2022-10-22,22:00:00,34,4,30,F11SP
9,Janssenlei 17,2022-10-22,23:00:00,36,16,20,F11SP
9,Janssenlei 17,2022-10-23,00:00:00,38,14,24,F11SP
9,Janssenlei 17,2022-10-23,01:00:00,12,4,8,F11SP
9,Janssenlei 17,2022-10-23,02:00:00,10,6,4,F11SP
9,Janssenlei 17,2022-10-23,03:00:00,8,4,4,F11SP
9,Janssenlei 17,2022-10-23,04:00:00,18,18,0,F11SP
9,Janssenlei 17,2022-10-23,05:00:00,10,8,2,F11SP
9,Janssenlei 17,2022-10-23,06:00:00,24,10,14,F11SP
9,Janssenlei 17,2022-10-23,07:00:00,46,26,20,F11SP
9,Janssenlei 17,2022-10-23,08:00:00,124,46,78,F11SP
9,Janssenlei 17,2022-10-23,09:00:00,206,80,126,F11SP
9,Janssenlei 17,2022-10-23,10:00:00,318,136,182,F11SP
9,Janssenlei 17,2022-10-23,11:00:00,364,158,206,F11SP
9,Janssenlei 17,2022-10-23,12:00:00,292,192,100,F11SP
9,Janssenlei 17,2022-10-23,13:00:00,356,178,178,F11SP
9,Janssenlei 17,2022-10-23,14:00:00,324,164,160,F11SP
9,Janssenlei 17,2022-10-23,15:00:00,308,138,170,F11SP
9,Janssenlei 17,2022-10-23,16:00:00,278,120,158,F11SP
9,Janssenlei 17,2022-10-23,17:00:00,250,118,132,F11SP
9,Janssenlei 17,2022-10-23,18:00:00,150,84,66,F11SP
9,Janssenlei 17,2022-10-23,19:00:00,70,26,44,F11SP
9,Janssenlei 17,2022-10-23,20:00:00,46,18,28,F11SP
9,Janssenlei 17,2022-10-23,21:00:00,12,6,6,F11SP
9,Janssenlei 17,2022-10-23,22:00:00,26,6,20,F11SP
9,Janssenlei 17,2022-10-23,23:00:00,6,0,6,F11SP
9,Janssenlei 17,2022-10-24,00:00:00,2,0,2,F11SP
9,Janssenlei 17,2022-10-24,01:00:00,2,2,0,F11SP
9,Janssenlei 17,2022-10-24,02:00:00,4,4,0,F11SP
9,Janssenlei 17,2022-10-24,03:00:00,0,0,0,F11SP
9,Janssenlei 17,2022-10-24,04:00:00,14,12,2,F11SP
9,Janssenlei 17,2022-10-24,05:00:00,44,26,18,F11SP
9,Janssenlei 17,2022-10-24,06:00:00,124,80,44,F11SP
9,Janssenlei 17,2022-10-24,07:00:00,432,294,138,F11SP
9,Janssenlei 17,2022-10-24,08:00:00,486,336,150,F11SP
9,Janssenlei 17,2022-10-24,09:00:00,114,60,54,F11SP
9,Janssenlei 17,2022-10-24,10:00:00,102,64,38,F11SP
9,Janssenlei 17,2022-10-24,11:00:00,94,46,48,F11SP
9,Janssenlei 17,2022-10-24,12:00:00,110,58,52,F11SP
9,Janssenlei 17,2022-10-24,13:00:00,148,56,92,F11SP
9,Janssenlei 17,2022-10-24,14:00:00,190,58,132,F11SP
9,Janssenlei 17,2022-10-24,15:00:00,264,76,188,F11SP
9,Janssenlei 17,2022-10-24,16:00:00,582,180,402,F11SP
9,Janssenlei 17,2022-10-24,17:00:00,458,118,340,F11SP
9,Janssenlei 17,2022-10-24,18:00:00,208,56,152,F11SP
9,Janssenlei 17,2022-10-24,19:00:00,64,22,42,F11SP
9,Janssenlei 17,2022-10-24,20:00:00,52,18,34,F11SP
9,Janssenlei 17,2022-10-24,21:00:00,24,12,12,F11SP
9,Janssenlei 17,2022-10-24,22:00:00,60,16,44,F11SP
9,Janssenlei 17,2022-10-24,23:00:00,16,6,10,F11SP
9,Janssenlei 17,2022-10-25,00:00:00,4,0,4,F11SP
9,Janssenlei 17,2022-10-25,01:00:00,0,0,0,F11SP
9,Janssenlei 17,2022-10-25,02:00:00,0,0,0,F11SP
9,Janssenlei 17,2022-10-25,03:00:00,2,2,0,F11SP
9,Janssenlei 17,2022-10-25,04:00:00,18,16,2,F11SP
9,Janssenlei 17,2022-10-25,05:00:00,66,52,14,F11SP
9,Janssenlei 17,2022-10-25,06:00:00,182,126,56,F11SP
9,Janssenlei 17,2022-10-25,07:00:00,576,376,200,F11SP
9,Janssenlei 17,2022-10-25,08:00:00,638,444,194,F11SP
9,Janssenlei 17,2022-10-25,09:00:00,210,128,82,F11SP
9,Janssenlei 17,2022-10-25,10:00:00,196,74,122,F11SP
9,Janssenlei 17,2022-10-25,11:00:00,140,74,66,F11SP
9,Janssenlei 17,2022-10-25,12:00:00,234,64,170,F11SP
9,Janssenlei 17,2022-10-25,13:00:00,282,128,154,F11SP
9,Janssenlei 17,2022-10-25,14:00:00,296,120,176,F11SP
9,Janssenlei 17,2022-10-25,15:00:00,380,124,256,F11SP
9,Janssenlei 17,2022-10-25,16:00:00,738,194,544,F11SP
9,Janssenlei 17,2022-10-25,17:00:00,620,186,434,F11SP
9,Janssenlei 17,2022-10-25,18:00:00,352,124,228,F11SP
9,Janssenlei 17,2022-10-25,19:00:00,128,28,100,F11SP
9,Janssenlei 17,2022-10-25,20:00:00,126,60,66,F11SP
9,Janssenlei 17,2022-10-25,21:00:00,56,22,34,F11SP
9,Janssenlei 17,2022-10-25,22:00:00,92,28,64,F11SP
9,Janssenlei 17,2022-10-25,23:00:00,16,0,16,F11SP
9,Janssenlei 17,2022-10-26,00:00:00,8,0,8,F11SP
9,Janssenlei 17,2022-10-26,01:00:00,4,0,4,F11SP
9,Janssenlei 17,2022-10-26,02:00:00,0,0,0,F11SP
9,Janssenlei 17,2022-10-26,03:00:00,2,2,0,F11SP
9,Janssenlei 17,2022-10-26,04:00:00,22,22,0,F11SP
9,Janssenlei 17,2022-10-26,05:00:00,50,40,10,F11SP
9,Janssenlei 17,2022-10-26,06:00:00,170,102,68,F11SP
9,Janssenlei 17,2022-10-26,07:00:00,514,322,192,F11SP
9,Janssenlei 17,2022-10-26,08:00:00,554,322,232,F11SP
9,Janssenlei 17,2022-10-26,09:00:00,282,156,126,F11SP
9,Janssenlei 17,2022-10-26,10:00:00,252,140,112,F11SP
9,Janssenlei 17,2022-10-26,11:00:00,388,128,260,F11SP
9,Janssenlei 17,2022-10-26,12:00:00,424,166,258,F11SP
9,Janssenlei 17,2022-10-26,13:00:00,370,118,252,F11SP
9,Janssenlei 17,2022-10-26,14:00:00,438,142,296,F11SP
9,Janssenlei 17,2022-10-26,15:00:00,496,184,312,F11SP
9,Janssenlei 17,2022-10-26,16:00:00,478,240,238,F11SP
9,Janssenlei 17,2022-10-26,17:00:00,480,176,304,F11SP
9,Janssenlei 17,2022-10-26,18:00:00,380,128,252,F11SP
9,Janssenlei 17,2022-10-26,19:00:00,166,66,100,F11SP
9,Janssenlei 17,2022-10-26,20:00:00,104,58,46,F11SP
9,Janssenlei 17,2022-10-26,21:00:00,62,28,34,F11SP
9,Janssenlei 17,2022-10-26,22:00:00,84,26,58,F11SP
9,Janssenlei 17,2022-10-26,23:00:00,38,2,36,F11SP
9,Janssenlei 17,2022-10-27,00:00:00,8,2,6,F11SP
9,Janssenlei 17,2022-10-27,01:00:00,0,0,0,F11SP
9,Janssenlei 17,2022-10-27,02:00:00,0,0,0,F11SP
9,Janssenlei 17,2022-10-27,03:00:00,8,4,4,F11SP
9,Janssenlei 17,2022-10-27,04:00:00,24,16,8,F11SP
9,Janssenlei 17,2022-10-27,05:00:00,70,46,24,F11SP
9,Janssenlei 17,2022-10-27,06:00:00,200,132,68,F11SP
9,Janssenlei 17,2022-10-27,07:00:00,540,342,198,F11SP
9,Janssenlei 17,2022-10-27,08:00:00,692,482,210,F11SP
9,Janssenlei 17,2022-10-27,09:00:00,234,108,126,F11SP
9,Janssenlei 17,2022-10-27,10:00:00,166,96,70,F11SP
9,Janssenlei 17,2022-10-27,11:00:00,220,98,122,F11SP
9,Janssenlei 17,2022-10-27,12:00:00,264,136,128,F11SP
9,Janssenlei 17,2022-10-27,13:00:00,332,138,194,F11SP
9,Janssenlei 17,2022-10-27,14:00:00,316,104,212,F11SP
9,Janssenlei 17,2022-10-27,15:00:00,470,172,298,F11SP
9,Janssenlei 17,2022-10-27,16:00:00,868,268,600,F11SP
9,Janssenlei 17,2022-10-27,17:00:00,654,184,470,F11SP
9,Janssenlei 17,2022-10-27,18:00:00,334,114,220,F11SP
9,Janssenlei 17,2022-10-27,19:00:00,170,66,104,F11SP
9,Janssenlei 17,2022-10-27,20:00:00,98,42,56,F11SP
9,Janssenlei 17,2022-10-27,21:00:00,90,40,50,F11SP
9,Janssenlei 17,2022-10-27,22:00:00,138,26,112,F11SP
9,Janssenlei 17,2022-10-27,23:00:00,34,8,26,F11SP
9,Janssenlei 17,2022-10-28,00:00:00,20,4,16,F11SP
9,Janssenlei 17,2022-10-28,01:00:00,14,2,12,F11SP
9,Janssenlei 17,2022-10-28,02:00:00,0,0,0,F11SP
9,Janssenlei 17,2022-10-28,03:00:00,4,4,0,F11SP
9,Janssenlei 17,2022-10-28,04:00:00,18,14,4,F11SP
9,Janssenlei 17,2022-10-28,05:00:00,66,40,26,F11SP
9,Janssenlei 17,2022-10-28,06:00:00,132,80,52,F11SP
9,Janssenlei 17,2022-10-28,07:00:00,442,282,160,F11SP
9,Janssenlei 17,2022-10-28,08:00:00,566,362,204,F11SP
9,Janssenlei 17,2022-10-28,09:00:00,188,88,100,F11SP
9,Janssenlei 17,2022-10-28,10:00:00,192,74,118,F11SP
9,Janssenlei 17,2022-10-28,11:00:00,224,102,122,F11SP
9,Janssenlei 17,2022-10-28,12:00:00,330,152,178,F11SP
9,Janssenlei 17,2022-10-28,13:00:00,418,178,240,F11SP
9,Janssenlei 17,2022-10-28,14:00:00,444,200,244,F11SP
9,Janssenlei 17,2022-10-28,15:00:00,570,204,366,F11SP
9,Janssenlei 17,2022-10-28,16:00:00,730,278,452,F11SP
9,Janssenlei 17,2022-10-28,17:00:00,452,170,282,F11SP
9,Janssenlei 17,2022-10-28,18:00:00,272,122,150,F11SP
9,Janssenlei 17,2022-10-28,19:00:00,242,38,204,F11SP
9,Janssenlei 17,2022-10-28,20:00:00,94,32,62,F11SP
9,Janssenlei 17,2022-10-28,21:00:00,50,30,20,F11SP
9,Janssenlei 17,2022-10-28,22:00:00,74,32,42,F11SP
9,Janssenlei 17,2022-10-28,23:00:00,74,34,40,F11SP
9,Janssenlei 17,2022-10-29,00:00:00,30,4,26,F11SP
9,Janssenlei 17,2022-10-29,01:00:00,34,8,26,F11SP
9,Janssenlei 17,2022-10-29,02:00:00,50,8,42,F11SP
9,Janssenlei 17,2022-10-29,03:00:00,14,0,14,F11SP
9,Janssenlei 17,2022-10-29,04:00:00,30,14,16,F11SP
9,Janssenlei 17,2022-10-29,05:00:00,22,8,14,F11SP
9,Janssenlei 17,2022-10-29,06:00:00,46,12,34,F11SP
9,Janssenlei 17,2022-10-29,07:00:00,22,14,8,F11SP
9,Janssenlei 17,2022-10-29,08:00:00,66,38,28,F11SP
9,Janssenlei 17,2022-10-29,09:00:00,166,86,80,F11SP
9,Janssenlei 17,2022-10-29,10:00:00,218,96,122,F11SP
9,Janssenlei 17,2022-10-29,11:00:00,270,118,152,F11SP
9,Janssenlei 17,2022-10-29,12:00:00,400,198,202,F11SP
9,Janssenlei 17,2022-10-29,13:00:00,438,170,268,F11SP
9,Janssenlei 17,2022-10-29,14:00:00,706,276,430,F11SP
9,Janssenlei 17,2022-10-29,15:00:00,596,286,310,F11SP
9,Janssenlei 17,2022-10-29,16:00:00,458,264,194,F11SP
9,Janssenlei 17,2022-10-29,17:00:00,332,192,140,F11SP
9,Janssenlei 17,2022-10-29,18:00:00,182,86,96,F11SP
9,Janssenlei 17,2022-10-29,19:00:00,152,58,94,F11SP
9,Janssenlei 17,2022-10-29,20:00:00,98,32,66,F11SP
9,Janssenlei 17,2022-10-29,21:00:00,52,14,38,F11SP
9,Janssenlei 17,2022-10-29,22:00:00,62,14,48,F11SP
9,Janssenlei 17,2022-10-29,23:00:00,84,28,56,F11SP
9,Janssenlei 17,2022-10-30,00:00:00,36,16,20,F11SP
9,Janssenlei 17,2022-10-30,01:00:00,30,12,18,F11SP
9,Janssenlei 17,2022-10-30,02:00:00,28,12,16,F11SP
9,Janssenlei 17,2022-10-30,03:00:00,12,4,8,F11SP
9,Janssenlei 17,2022-10-30,04:00:00,18,6,12,F11SP
9,Janssenlei 17,2022-10-30,05:00:00,14,10,4,F11SP
9,Janssenlei 17,2022-10-30,06:00:00,18,6,12,F11SP
9,Janssenlei 17,2022-10-30,07:00:00,78,30,48,F11SP
9,Janssenlei 17,2022-10-30,08:00:00,150,50,100,F11SP
9,Janssenlei 17,2022-10-30,09:00:00,310,114,196,F11SP
9,Janssenlei 17,2022-10-30,10:00:00,360,162,198,F11SP
9,Janssenlei 17,2022-10-30,11:00:00,518,250,268,F11SP
9,Janssenlei 17,2022-10-30,12:00:00,516,232,284,F11SP
9,Janssenlei 17,2022-10-30,13:00:00,480,242,238,F11SP
9,Janssenlei 17,2022-10-30,14:00:00,650,228,422,F11SP
9,Janssenlei 17,2022-10-30,15:00:00,628,330,298,F11SP
9,Janssenlei 17,2022-10-30,16:00:00,318,198,120,F11SP
9,Janssenlei 17,2022-10-30,17:00:00,254,150,104,F11SP
9,Janssenlei 17,2022-10-30,18:00:00,94,48,46,F11SP
9,Janssenlei 17,2022-10-30,19:00:00,42,24,18,F11SP
9,Janssenlei 17,2022-10-30,20:00:00,42,18,24,F11SP
9,Janssenlei 17,2022-10-30,21:00:00,28,22,6,F11SP
9,Janssenlei 17,2022-10-30,22:00:00,32,6,26,F11SP
9,Janssenlei 17,2022-10-30,23:00:00,14,12,2,F11SP
9,Janssenlei 17,2022-10-31,00:00:00,2,2,0,F11SP
9,Janssenlei 17,2022-10-31,01:00:00,8,0,8,F11SP
9,Janssenlei 17,2022-10-31,02:00:00,4,2,2,F11SP
9,Janssenlei 17,2022-10-31,03:00:00,2,2,0,F11SP
9,Janssenlei 17,2022-10-31,04:00:00,18,16,2,F11SP
9,Janssenlei 17,2022-10-31,05:00:00,22,10,12,F11SP
9,Janssenlei 17,2022-10-31,06:00:00,42,28,14,F11SP
9,Janssenlei 17,2022-10-31,07:00:00,148,90,58,F11SP
9,Janssenlei 17,2022-10-31,08:00:00,146,74,72,F11SP
9,Janssenlei 17,2022-10-31,09:00:00,130,56,74,F11SP
9,Janssenlei 17,2022-10-31,10:00:00,114,46,68,F11SP
9,Janssenlei 17,2022-10-31,11:00:00,124,68,56,F11SP
9,Janssenlei 17,2022-10-31,12:00:00,156,86,70,F11SP
9,Janssenlei 17,2022-10-31,13:00:00,236,88,148,F11SP
9,Janssenlei 17,2022-10-31,14:00:00,316,106,210,F11SP
9,Janssenlei 17,2022-10-31,15:00:00,328,154,174,F11SP
9,Janssenlei 17,2022-10-31,16:00:00,384,154,230,F11SP
9,Janssenlei 17,2022-10-31,17:00:00,266,140,126,F11SP
9,Janssenlei 17,2022-10-31,18:00:00,178,68,110,F11SP
9,Janssenlei 17,2022-10-31,19:00:00,88,28,60,F11SP
9,Janssenlei 17,2022-10-31,20:00:00,44,20,24,F11SP
9,Janssenlei 17,2022-10-31,21:00:00,40,18,22,F11SP
9,Janssenlei 17,2022-10-31,22:00:00,24,0,24,F11SP
9,Janssenlei 17,2022-10-31,23:00:00,14,0,14,F11SP
9,Janssenlei 17,2022-11-01,00:00:00,14,12,2,F11SP
9,Janssenlei 17,2022-11-01,01:00:00,30,8,22,F11SP
9,Janssenlei 17,2022-11-01,02:00:00,12,10,2,F11SP
9,Janssenlei 17,2022-11-01,03:00:00,8,4,4,F11SP
9,Janssenlei 17,2022-11-01,04:00:00,10,6,4,F11SP
9,Janssenlei 17,2022-11-01,05:00:00,8,6,2,F11SP
9,Janssenlei 17,2022-11-01,06:00:00,26,12,14,F11SP
9,Janssenlei 17,2022-11-01,07:00:00,40,12,28,F11SP
9,Janssenlei 17,2022-11-01,08:00:00,62,18,44,F11SP
9,Janssenlei 17,2022-11-01,09:00:00,148,32,116,F11SP
9,Janssenlei 17,2022-11-01,10:00:00,128,72,56,F11SP
9,Janssenlei 17,2022-11-01,11:00:00,214,112,102,F11SP
9,Janssenlei 17,2022-11-01,12:00:00,192,86,106,F11SP
9,Janssenlei 17,2022-11-01,13:00:00,218,88,130,F11SP
9,Janssenlei 17,2022-11-01,14:00:00,312,140,172,F11SP
9,Janssenlei 17,2022-11-01,15:00:00,220,114,106,F11SP
9,Janssenlei 17,2022-11-01,16:00:00,188,104,84,F11SP
9,Janssenlei 17,2022-11-01,17:00:00,142,80,62,F11SP
9,Janssenlei 17,2022-11-01,18:00:00,68,32,36,F11SP
9,Janssenlei 17,2022-11-01,19:00:00,44,20,24,F11SP
9,Janssenlei 17,2022-11-01,20:00:00,54,32,22,F11SP
9,Janssenlei 17,2022-11-01,21:00:00,28,12,16,F11SP
9,Janssenlei 17,2022-11-01,22:00:00,20,2,18,F11SP
9,Janssenlei 17,2022-11-01,23:00:00,22,0,22,F11SP
9,Janssenlei 17,2022-11-02,00:00:00,6,2,4,F11SP
9,Janssenlei 17,2022-11-02,01:00:00,2,0,2,F11SP
9,Janssenlei 17,2022-11-02,02:00:00,6,0,6,F11SP
9,Janssenlei 17,2022-11-02,03:00:00,10,4,6,F11SP
9,Janssenlei 17,2022-11-02,04:00:00,12,10,2,F11SP
9,Janssenlei 17,2022-11-02,05:00:00,58,46,12,F11SP
9,Janssenlei 17,2022-11-02,06:00:00,94,56,38,F11SP
9,Janssenlei 17,2022-11-02,07:00:00,232,134,98,F11SP
9,Janssenlei 17,2022-11-02,08:00:00,258,172,86,F11SP
9,Janssenlei 17,2022-11-02,09:00:00,146,74,72,F11SP
9,Janssenlei 17,2022-11-02,10:00:00,170,84,86,F11SP
9,Janssenlei 17,2022-11-02,11:00:00,220,96,124,F11SP
9,Janssenlei 17,2022-11-02,12:00:00,210,82,128,F11SP
9,Janssenlei 17,2022-11-02,13:00:00,256,96,160,F11SP
9,Janssenlei 17,2022-11-02,14:00:00,330,124,206,F11SP
9,Janssenlei 17,2022-11-02,15:00:00,296,124,172,F11SP
9,Janssenlei 17,2022-11-02,16:00:00,368,128,240,F11SP
9,Janssenlei 17,2022-11-02,17:00:00,376,158,218,F11SP
9,Janssenlei 17,2022-11-02,18:00:00,208,68,140,F11SP
9,Janssenlei 17,2022-11-02,19:00:00,110,48,62,F11SP
9,Janssenlei 17,2022-11-02,20:00:00,44,24,20,F11SP
9,Janssenlei 17,2022-11-02,21:00:00,46,22,24,F11SP
9,Janssenlei 17,2022-11-02,22:00:00,74,18,56,F11SP
9,Janssenlei 17,2022-11-02,23:00:00,14,2,12,F11SP
9,Janssenlei 17,2022-11-03,00:00:00,16,6,10,F11SP
9,Janssenlei 17,2022-11-03,01:00:00,10,2,8,F11SP
9,Janssenlei 17,2022-11-03,02:00:00,0,0,0,F11SP
9,Janssenlei 17,2022-11-03,03:00:00,12,4,8,F11SP
9,Janssenlei 17,2022-11-03,04:00:00,10,8,2,F11SP
9,Janssenlei 17,2022-11-03,05:00:00,44,36,8,F11SP
9,Janssenlei 17,2022-11-03,06:00:00,106,66,40,F11SP
9,Janssenlei 17,2022-11-03,07:00:00,238,170,68,F11SP
9,Janssenlei 17,2022-11-03,08:00:00,204,120,84,F11SP
9,Janssenlei 17,2022-11-03,09:00:00,154,72,82,F11SP
9,Janssenlei 17,2022-11-03,10:00:00,134,56,78,F11SP
9,Janssenlei 17,2022-11-03,11:00:00,100,60,40,F11SP
9,Janssenlei 17,2022-11-03,12:00:00,114,54,60,F11SP
9,Janssenlei 17,2022-11-03,13:00:00,168,58,110,F11SP
9,Janssenlei 17,2022-11-03,14:00:00,178,84,94,F11SP
9,Janssenlei 17,2022-11-03,15:00:00,162,54,108,F11SP
9,Janssenlei 17,2022-11-03,16:00:00,252,86,166,F11SP
9,Janssenlei 17,2022-11-03,17:00:00,252,64,188,F11SP
9,Janssenlei 17,2022-11-03,18:00:00,120,38,82,F11SP
9,Janssenlei 17,2022-11-03,19:00:00,64,12,52,F11SP
9,Janssenlei 17,2022-11-03,20:00:00,52,26,26,F11SP
9,Janssenlei 17,2022-11-03,21:00:00,18,4,14,F11SP
9,Janssenlei 17,2022-11-03,22:00:00,52,18,34,F11SP
9,Janssenlei 17,2022-11-03,23:00:00,12,2,10,F11SP
9,Janssenlei 17,2022-11-04,00:00:00,16,4,12,F11SP
9,Janssenlei 17,2022-11-04,01:00:00,6,0,6,F11SP
9,Janssenlei 17,2022-11-04,02:00:00,2,2,0,F11SP
9,Janssenlei 17,2022-11-04,03:00:00,2,2,0,F11SP
9,Janssenlei 17,2022-11-04,04:00:00,18,10,8,F11SP
9,Janssenlei 17,2022-11-04,05:00:00,32,30,2,F11SP
9,Janssenlei 17,2022-11-04,06:00:00,90,48,42,F11SP
9,Janssenlei 17,2022-11-04,07:00:00,162,90,72,F11SP
9,Janssenlei 17,2022-11-04,08:00:00,160,92,68,F11SP
9,Janssenlei 17,2022-11-04,09:00:00,84,40,44,F11SP
9,Janssenlei 17,2022-11-04,10:00:00,114,46,68,F11SP
9,Janssenlei 17,2022-11-04,11:00:00,114,66,48,F11SP
9,Janssenlei 17,2022-11-04,12:00:00,164,74,90,F11SP
9,Janssenlei 17,2022-11-04,13:00:00,184,74,110,F11SP
9,Janssenlei 17,2022-11-04,14:00:00,174,62,112,F11SP
9,Janssenlei 17,2022-11-04,15:00:00,138,44,94,F11SP
9,Janssenlei 17,2022-11-04,16:00:00,268,144,124,F11SP
9,Janssenlei 17,2022-11-04,17:00:00,234,96,138,F11SP
9,Janssenlei 17,2022-11-04,18:00:00,130,38,92,F11SP
9,Janssenlei 17,2022-11-04,19:00:00,82,26,56,F11SP
9,Janssenlei 17,2022-11-04,20:00:00,84,48,36,F11SP
9,Janssenlei 17,2022-11-04,21:00:00,36,16,20,F11SP
9,Janssenlei 17,2022-11-04,22:00:00,30,10,20,F11SP
9,Janssenlei 17,2022-11-04,23:00:00,14,4,10,F11SP
9,Janssenlei 17,2022-11-05,00:00:00,22,6,16,F11SP
9,Janssenlei 17,2022-11-05,01:00:00,12,2,10,F11SP
9,Janssenlei 17,2022-11-05,02:00:00,52,24,28,F11SP
9,Janssenlei 17,2022-11-05,03:00:00,8,8,0,F11SP
9,Janssenlei 17,2022-11-05,04:00:00,22,14,8,F11SP
9,Janssenlei 17,2022-11-05,05:00:00,2,2,0,F11SP
9,Janssenlei 17,2022-11-05,06:00:00,30,10,20,F11SP
9,Janssenlei 17,2022-11-05,07:00:00,38,8,30,F11SP
9,Janssenlei 17,2022-11-05,08:00:00,104,24,80,F11SP
9,Janssenlei 17,2022-11-05,09:00:00,182,72,110,F11SP
9,Janssenlei 17,2022-11-05,10:00:00,306,84,222,F11SP
9,Janssenlei 17,2022-11-05,11:00:00,274,132,142,F11SP
9,Janssenlei 17,2022-11-05,12:00:00,284,170,114,F11SP
9,Janssenlei 17,2022-11-05,13:00:00,272,130,142,F11SP
9,Janssenlei 17,2022-11-05,14:00:00,330,148,182,F11SP
9,Janssenlei 17,2022-11-05,15:00:00,238,112,126,F11SP
9,Janssenlei 17,2022-11-05,16:00:00,230,116,114,F11SP
9,Janssenlei 17,2022-11-05,17:00:00,132,72,60,F11SP
9,Janssenlei 17,2022-11-05,18:00:00,74,34,40,F11SP
9,Janssenlei 17,2022-11-05,19:00:00,36,10,26,F11SP
9,Janssenlei 17,2022-11-05,20:00:00,54,26,28,F11SP
9,Janssenlei 17,2022-11-05,21:00:00,28,20,8,F11SP
9,Janssenlei 17,2022-11-05,22:00:00,26,6,20,F11SP
9,Janssenlei 17,2022-11-05,23:00:00,24,18,6,F11SP
9,Janssenlei 17,2022-11-06,00:00:00,8,4,4,F11SP
9,Janssenlei 17,2022-11-06,01:00:00,20,6,14,F11SP
9,Janssenlei 17,2022-11-06,02:00:00,2,0,2,F11SP
9,Janssenlei 17,2022-11-06,03:00:00,0,0,0,F11SP
9,Janssenlei 17,2022-11-06,04:00:00,6,6,0,F11SP
9,Janssenlei 17,2022-11-06,05:00:00,8,2,6,F11SP
9,Janssenlei 17,2022-11-06,06:00:00,24,10,14,F11SP
9,Janssenlei 17,2022-11-06,07:00:00,26,14,12,F11SP
9,Janssenlei 17,2022-11-06,08:00:00,114,36,78,F11SP
9,Janssenlei 17,2022-11-06,09:00:00,188,84,104,F11SP
9,Janssenlei 17,2022-11-06,10:00:00,220,94,126,F11SP
9,Janssenlei 17,2022-11-06,11:00:00,194,112,82,F11SP
9,Janssenlei 17,2022-11-06,12:00:00,176,118,58,F11SP
9,Janssenlei 17,2022-11-06,13:00:00,86,46,40,F11SP
9,Janssenlei 17,2022-11-06,14:00:00,66,22,44,F11SP
9,Janssenlei 17,2022-11-06,15:00:00,72,24,48,F11SP
9,Janssenlei 17,2022-11-06,16:00:00,38,24,14,F11SP
9,Janssenlei 17,2022-11-06,17:00:00,36,16,20,F11SP
9,Janssenlei 17,2022-11-06,18:00:00,56,24,32,F11SP
9,Janssenlei 17,2022-11-06,19:00:00,36,10,26,F11SP
9,Janssenlei 17,2022-11-06,20:00:00,34,20,14,F11SP
9,Janssenlei 17,2022-11-06,21:00:00,14,4,10,F11SP
9,Janssenlei 17,2022-11-06,22:00:00,28,4,24,F11SP
9,Janssenlei 17,2022-11-06,23:00:00,8,2,6,F11SP
9,Janssenlei 17,2022-11-07,00:00:00,6,4,2,F11SP
9,Janssenlei 17,2022-11-07,01:00:00,0,0,0,F11SP
9,Janssenlei 17,2022-11-07,02:00:00,4,4,0,F11SP
9,Janssenlei 17,2022-11-07,03:00:00,4,0,4,F11SP
9,Janssenlei 17,2022-11-07,04:00:00,8,6,2,F11SP
9,Janssenlei 17,2022-11-07,05:00:00,52,40,12,F11SP
9,Janssenlei 17,2022-11-07,06:00:00,106,78,28,F11SP
9,Janssenlei 17,2022-11-07,07:00:00,408,270,138,F11SP
9,Janssenlei 17,2022-11-07,08:00:00,480,336,144,F11SP
9,Janssenlei 17,2022-11-07,09:00:00,96,56,40,F11SP
9,Janssenlei 17,2022-11-07,10:00:00,108,62,46,F11SP
9,Janssenlei 17,2022-11-07,11:00:00,108,46,62,F11SP
9,Janssenlei 17,2022-11-07,12:00:00,146,64,82,F11SP
9,Janssenlei 17,2022-11-07,13:00:00,142,72,70,F11SP
9,Janssenlei 17,2022-11-07,14:00:00,168,62,106,F11SP
9,Janssenlei 17,2022-11-07,15:00:00,192,44,148,F11SP
9,Janssenlei 17,2022-11-07,16:00:00,514,148,366,F11SP
9,Janssenlei 17,2022-11-07,17:00:00,380,108,272,F11SP
9,Janssenlei 17,2022-11-07,18:00:00,142,30,112,F11SP
9,Janssenlei 17,2022-11-07,19:00:00,88,30,58,F11SP
9,Janssenlei 17,2022-11-07,20:00:00,66,24,42,F11SP
9,Janssenlei 17,2022-11-07,21:00:00,16,2,14,F11SP
9,Janssenlei 17,2022-11-07,22:00:00,66,20,46,F11SP
9,Janssenlei 17,2022-11-07,23:00:00,10,6,4,F11SP
9,Janssenlei 17,2022-11-08,00:00:00,12,4,8,F11SP
9,Janssenlei 17,2022-11-08,01:00:00,2,0,2,F11SP
9,Janssenlei 17,2022-11-08,02:00:00,0,0,0,F11SP
9,Janssenlei 17,2022-11-08,03:00:00,2,2,0,F11SP
9,Janssenlei 17,2022-11-08,04:00:00,12,10,2,F11SP
9,Janssenlei 17,2022-11-08,05:00:00,66,48,18,F11SP
9,Janssenlei 17,2022-11-08,06:00:00,156,110,46,F11SP
9,Janssenlei 17,2022-11-08,07:00:00,470,332,138,F11SP
9,Janssenlei 17,2022-11-08,08:00:00,604,432,172,F11SP
9,Janssenlei 17,2022-11-08,09:00:00,178,100,78,F11SP
9,Janssenlei 17,2022-11-08,10:00:00,168,58,110,F11SP
9,Janssenlei 17,2022-11-08,11:00:00,124,68,56,F11SP
9,Janssenlei 17,2022-11-08,12:00:00,178,108,70,F11SP
9,Janssenlei 17,2022-11-08,13:00:00,210,78,132,F11SP
9,Janssenlei 17,2022-11-08,14:00:00,258,100,158,F11SP
9,Janssenlei 17,2022-11-08,15:00:00,358,100,258,F11SP
9,Janssenlei 17,2022-11-08,16:00:00,610,182,428,F11SP
9,Janssenlei 17,2022-11-08,17:00:00,512,126,386,F11SP
9,Janssenlei 17,2022-11-08,18:00:00,198,76,122,F11SP
9,Janssenlei 17,2022-11-08,19:00:00,92,28,64,F11SP
9,Janssenlei 17,2022-11-08,20:00:00,86,48,38,F11SP
9,Janssenlei 17,2022-11-08,21:00:00,66,16,50,F11SP
9,Janssenlei 17,2022-11-08,22:00:00,92,30,62,F11SP
9,Janssenlei 17,2022-11-08,23:00:00,16,4,12,F11SP
9,Janssenlei 17,2022-11-09,00:00:00,6,2,4,F11SP
9,Janssenlei 17,2022-11-09,01:00:00,6,4,2,F11SP
9,Janssenlei 17,2022-11-09,02:00:00,6,2,4,F11SP
9,Janssenlei 17,2022-11-09,03:00:00,6,6,0,F11SP
9,Janssenlei 17,2022-11-09,04:00:00,8,8,0,F11SP
9,Janssenlei 17,2022-11-09,05:00:00,42,30,12,F11SP
9,Janssenlei 17,2022-11-09,06:00:00,134,92,42,F11SP
9,Janssenlei 17,2022-11-09,07:00:00,508,310,198,F11SP
9,Janssenlei 17,2022-11-09,08:00:00,608,418,190,F11SP
9,Janssenlei 17,2022-11-09,09:00:00,170,94,76,F11SP
9,Janssenlei 17,2022-11-09,10:00:00,168,74,94,F11SP
9,Janssenlei 17,2022-11-09,11:00:00,202,90,112,F11SP
9,Janssenlei 17,2022-11-09,12:00:00,430,166,264,F11SP
9,Janssenlei 17,2022-11-09,13:00:00,280,116,164,F11SP
9,Janssenlei 17,2022-11-09,14:00:00,228,86,142,F11SP
9,Janssenlei 17,2022-11-09,15:00:00,188,70,118,F11SP
9,Janssenlei 17,2022-11-09,16:00:00,338,100,238,F11SP
9,Janssenlei 17,2022-11-09,17:00:00,428,138,290,F11SP
9,Janssenlei 17,2022-11-09,18:00:00,234,90,144,F11SP
9,Janssenlei 17,2022-11-09,19:00:00,126,60,66,F11SP
9,Janssenlei 17,2022-11-09,20:00:00,76,38,38,F11SP
9,Janssenlei 17,2022-11-09,21:00:00,48,20,28,F11SP
9,Janssenlei 17,2022-11-09,22:00:00,38,16,22,F11SP
9,Janssenlei 17,2022-11-09,23:00:00,24,0,24,F11SP
9,Janssenlei 17,2022-11-10,00:00:00,14,2,12,F11SP
9,Janssenlei 17,2022-11-10,01:00:00,8,4,4,F11SP
9,Janssenlei 17,2022-11-10,02:00:00,0,0,0,F11SP
9,Janssenlei 17,2022-11-10,03:00:00,0,0,0,F11SP
9,Janssenlei 17,2022-11-10,04:00:00,4,4,0,F11SP
9,Janssenlei 17,2022-11-10,05:00:00,48,28,20,F11SP
9,Janssenlei 17,2022-11-10,06:00:00,134,108,26,F11SP
9,Janssenlei 17,2022-11-10,07:00:00,438,282,156,F11SP
9,Janssenlei 17,2022-11-10,08:00:00,564,396,168,F11SP
9,Janssenlei 17,2022-11-10,09:00:00,162,104,58,F11SP
9,Janssenlei 17,2022-11-10,10:00:00,202,114,88,F11SP
9,Janssenlei 17,2022-11-10,11:00:00,158,76,82,F11SP
9,Janssenlei 17,2022-11-10,12:00:00,566,114,452,F11SP
9,Janssenlei 17,2022-11-10,13:00:00,276,108,168,F11SP
9,Janssenlei 17,2022-11-10,14:00:00,396,190,206,F11SP
9,Janssenlei 17,2022-11-10,15:00:00,744,418,326,F11SP
9,Janssenlei 17,2022-11-10,16:00:00,518,176,342,F11SP
9,Janssenlei 17,2022-11-10,17:00:00,494,146,348,F11SP
9,Janssenlei 17,2022-11-10,18:00:00,210,72,138,F11SP
9,Janssenlei 17,2022-11-10,19:00:00,142,42,100,F11SP
9,Janssenlei 17,2022-11-10,20:00:00,92,36,56,F11SP
9,Janssenlei 17,2022-11-10,21:00:00,92,36,56,F11SP
9,Janssenlei 17,2022-11-10,22:00:00,72,28,44,F11SP
9,Janssenlei 17,2022-11-10,23:00:00,34,14,20,F11SP
9,Janssenlei 17,2022-11-11,00:00:00,98,68,30,F11SP
9,Janssenlei 17,2022-11-11,01:00:00,32,16,16,F11SP
9,Janssenlei 17,2022-11-11,02:00:00,26,14,12,F11SP
9,Janssenlei 17,2022-11-11,03:00:00,30,16,14,F11SP
9,Janssenlei 17,2022-11-11,04:00:00,12,6,6,F11SP
9,Janssenlei 17,2022-11-11,05:00:00,14,8,6,F11SP
9,Janssenlei 17,2022-11-11,06:00:00,28,14,14,F11SP
9,Janssenlei 17,2022-11-11,07:00:00,14,6,8,F11SP
9,Janssenlei 17,2022-11-11,08:00:00,62,36,26,F11SP
9,Janssenlei 17,2022-11-11,09:00:00,118,36,82,F11SP
9,Janssenlei 17,2022-11-11,10:00:00,186,80,106,F11SP
9,Janssenlei 17,2022-11-11,11:00:00,234,100,134,F11SP
9,Janssenlei 17,2022-11-11,12:00:00,288,144,144,F11SP
9,Janssenlei 17,2022-11-11,13:00:00,304,114,190,F11SP
9,Janssenlei 17,2022-11-11,14:00:00,438,160,278,F11SP
9,Janssenlei 17,2022-11-11,15:00:00,380,178,202,F11SP
9,Janssenlei 17,2022-11-11,16:00:00,274,178,96,F11SP
9,Janssenlei 17,2022-11-11,17:00:00,116,58,58,F11SP
9,Janssenlei 17,2022-11-11,18:00:00,68,42,26,F11SP
9,Janssenlei 17,2022-11-11,19:00:00,38,20,18,F11SP
9,Janssenlei 17,2022-11-11,20:00:00,52,32,20,F11SP
9,Janssenlei 17,2022-11-11,21:00:00,14,6,8,F11SP
9,Janssenlei 17,2022-11-11,22:00:00,46,12,34,F11SP
9,Janssenlei 17,2022-11-11,23:00:00,22,8,14,F11SP
9,Janssenlei 17,2022-11-12,00:00:00,22,10,12,F11SP
9,Janssenlei 17,2022-11-12,01:00:00,18,4,14,F11SP
9,Janssenlei 17,2022-11-12,02:00:00,4,0,4,F11SP
9,Janssenlei 17,2022-11-12,03:00:00,0,0,0,F11SP
9,Janssenlei 17,2022-11-12,04:00:00,4,2,2,F11SP
9,Janssenlei 17,2022-11-12,05:00:00,28,22,6,F11SP
9,Janssenlei 17,2022-11-12,06:00:00,32,14,18,F11SP
9,Janssenlei 17,2022-11-12,07:00:00,50,22,28,F11SP
9,Janssenlei 17,2022-11-12,08:00:00,78,28,50,F11SP
9,Janssenlei 17,2022-11-12,09:00:00,156,56,100,F11SP
9,Janssenlei 17,2022-11-12,10:00:00,230,100,130,F11SP
9,Janssenlei 17,2022-11-12,11:00:00,264,128,136,F11SP
9,Janssenlei 17,2022-11-12,12:00:00,346,164,182,F11SP
9,Janssenlei 17,2022-11-12,13:00:00,420,174,246,F11SP
9,Janssenlei 17,2022-11-12,14:00:00,572,190,382,F11SP
9,Janssenlei 17,2022-11-12,15:00:00,398,174,224,F11SP
9,Janssenlei 17,2022-11-12,16:00:00,298,172,126,F11SP
9,Janssenlei 17,2022-11-12,17:00:00,168,100,68,F11SP
9,Janssenlei 17,2022-11-12,18:00:00,138,84,54,F11SP
9,Janssenlei 17,2022-11-12,19:00:00,90,36,54,F11SP
9,Janssenlei 17,2022-11-12,20:00:00,42,30,12,F11SP
9,Janssenlei 17,2022-11-12,21:00:00,34,14,20,F11SP
9,Janssenlei 17,2022-11-12,22:00:00,42,4,38,F11SP
9,Janssenlei 17,2022-11-12,23:00:00,42,14,28,F11SP
9,Janssenlei 17,2022-11-13,00:00:00,14,2,12,F11SP
9,Janssenlei 17,2022-11-13,01:00:00,20,8,12,F11SP
9,Janssenlei 17,2022-11-13,02:00:00,14,2,12,F11SP
9,Janssenlei 17,2022-11-13,03:00:00,12,12,0,F11SP
9,Janssenlei 17,2022-11-13,04:00:00,6,6,0,F11SP
9,Janssenlei 17,2022-11-13,05:00:00,10,8,2,F11SP
9,Janssenlei 17,2022-11-13,06:00:00,18,12,6,F11SP
9,Janssenlei 17,2022-11-13,07:00:00,30,14,16,F11SP
9,Janssenlei 17,2022-11-13,08:00:00,72,22,50,F11SP
9,Janssenlei 17,2022-11-13,09:00:00,260,104,156,F11SP
9,Janssenlei 17,2022-11-13,10:00:00,298,122,176,F11SP
9,Janssenlei 17,2022-11-13,11:00:00,372,166,206,F11SP
9,Janssenlei 17,2022-11-13,12:00:00,352,180,172,F11SP
9,Janssenlei 17,2022-11-13,13:00:00,510,196,314,F11SP
9,Janssenlei 17,2022-11-13,14:00:00,442,180,262,F11SP
9,Janssenlei 17,2022-11-13,15:00:00,410,194,216,F11SP
9,Janssenlei 17,2022-11-13,16:00:00,416,214,202,F11SP
9,Janssenlei 17,2022-11-13,17:00:00,140,92,48,F11SP
9,Janssenlei 17,2022-11-13,18:00:00,90,52,38,F11SP
9,Janssenlei 17,2022-11-13,19:00:00,30,20,10,F11SP
9,Janssenlei 17,2022-11-13,20:00:00,50,24,26,F11SP
9,Janssenlei 17,2022-11-13,21:00:00,34,6,28,F11SP
9,Janssenlei 17,2022-11-13,22:00:00,26,2,24,F11SP
9,Janssenlei 17,2022-11-13,23:00:00,52,36,16,F11SP
9,Janssenlei 17,2022-11-14,00:00:00,6,0,6,F11SP
9,Janssenlei 17,2022-11-14,01:00:00,2,0,2,F11SP
9,Janssenlei 17,2022-11-14,02:00:00,0,0,0,F11SP
9,Janssenlei 17,2022-11-14,03:00:00,0,0,0,F11SP
9,Janssenlei 17,2022-11-14,04:00:00,8,8,0,F11SP
9,Janssenlei 17,2022-11-14,05:00:00,32,26,6,F11SP
9,Janssenlei 17,2022-11-14,06:00:00,130,104,26,F11SP
9,Janssenlei 17,2022-11-14,07:00:00,450,308,142,F11SP
9,Janssenlei 17,2022-11-14,08:00:00,546,382,164,F11SP
9,Janssenlei 17,2022-11-14,09:00:00,136,84,52,F11SP
9,Janssenlei 17,2022-11-14,10:00:00,146,82,64,F11SP
9,Janssenlei 17,2022-11-14,11:00:00,136,58,78,F11SP
9,Janssenlei 17,2022-11-14,12:00:00,222,108,114,F11SP
9,Janssenlei 17,2022-11-14,13:00:00,222,102,120,F11SP
9,Janssenlei 17,2022-11-14,14:00:00,210,84,126,F11SP
9,Janssenlei 17,2022-11-14,15:00:00,336,130,206,F11SP
9,Janssenlei 17,2022-11-14,16:00:00,558,146,412,F11SP
9,Janssenlei 17,2022-11-14,17:00:00,438,100,338,F11SP
9,Janssenlei 17,2022-11-14,18:00:00,204,66,138,F11SP
9,Janssenlei 17,2022-11-14,19:00:00,88,30,58,F11SP
9,Janssenlei 17,2022-11-14,20:00:00,64,12,52,F11SP
9,Janssenlei 17,2022-11-14,21:00:00,50,26,24,F11SP
9,Janssenlei 17,2022-11-14,22:00:00,72,22,50,F11SP
9,Janssenlei 17,2022-11-14,23:00:00,14,4,10,F11SP
9,Janssenlei 17,2022-11-15,00:00:00,2,0,2,F11SP
9,Janssenlei 17,2022-11-15,01:00:00,0,0,0,F11SP
9,Janssenlei 17,2022-11-15,02:00:00,0,0,0,F11SP
9,Janssenlei 17,2022-11-15,03:00:00,2,2,0,F11SP
9,Janssenlei 17,2022-11-15,04:00:00,10,6,4,F11SP
9,Janssenlei 17,2022-11-15,05:00:00,34,32,2,F11SP
9,Janssenlei 17,2022-11-15,06:00:00,128,92,36,F11SP
9,Janssenlei 17,2022-11-15,07:00:00,392,262,130,F11SP
9,Janssenlei 17,2022-11-15,08:00:00,506,378,128,F11SP
9,Janssenlei 17,2022-11-15,09:00:00,172,98,74,F11SP
9,Janssenlei 17,2022-11-15,10:00:00,126,78,48,F11SP
9,Janssenlei 17,2022-11-15,11:00:00,110,66,44,F11SP
9,Janssenlei 17,2022-11-15,12:00:00,206,92,114,F11SP
9,Janssenlei 17,2022-11-15,13:00:00,166,78,88,F11SP
9,Janssenlei 17,2022-11-15,14:00:00,164,56,108,F11SP
9,Janssenlei 17,2022-11-15,15:00:00,184,60,124,F11SP
9,Janssenlei 17,2022-11-15,16:00:00,478,118,360,F11SP
9,Janssenlei 17,2022-11-15,17:00:00,354,82,272,F11SP
9,Janssenlei 17,2022-11-15,18:00:00,158,38,120,F11SP
9,Janssenlei 17,2022-11-15,19:00:00,60,20,40,F11SP
9,Janssenlei 17,2022-11-15,20:00:00,58,22,36,F11SP
9,Janssenlei 17,2022-11-15,21:00:00,54,20,34,F11SP
9,Janssenlei 17,2022-11-15,22:00:00,44,12,32,F11SP
9,Janssenlei 17,2022-11-15,23:00:00,24,2,22,F11SP
9,Janssenlei 17,2022-11-16,00:00:00,2,0,2,F11SP
9,Janssenlei 17,2022-11-16,01:00:00,2,2,0,F11SP
9,Janssenlei 17,2022-11-16,02:00:00,0,0,0,F11SP
9,Janssenlei 17,2022-11-16,03:00:00,2,2,0,F11SP
9,Janssenlei 17,2022-11-16,04:00:00,18,16,2,F11SP
9,Janssenlei 17,2022-11-16,05:00:00,22,20,2,F11SP
9,Janssenlei 17,2022-11-16,06:00:00,120,80,40,F11SP
9,Janssenlei 17,2022-11-16,07:00:00,418,262,156,F11SP
9,Janssenlei 17,2022-11-16,08:00:00,446,308,138,F11SP
9,Janssenlei 17,2022-11-16,09:00:00,122,72,50,F11SP
9,Janssenlei 17,2022-11-16,10:00:00,124,56,68,F11SP
9,Janssenlei 17,2022-11-16,11:00:00,158,84,74,F11SP
9,Janssenlei 17,2022-11-16,12:00:00,368,152,216,F11SP
9,Janssenlei 17,2022-11-16,13:00:00,204,92,112,F11SP
9,Janssenlei 17,2022-11-16,14:00:00,124,34,90,F11SP
9,Janssenlei 17,2022-11-16,15:00:00,184,64,120,F11SP
9,Janssenlei 17,2022-11-16,16:00:00,290,96,194,F11SP
9,Janssenlei 17,2022-11-16,17:00:00,294,86,208,F11SP
9,Janssenlei 17,2022-11-16,18:00:00,210,78,132,F11SP
9,Janssenlei 17,2022-11-16,19:00:00,84,34,50,F11SP
9,Janssenlei 17,2022-11-16,20:00:00,68,38,30,F11SP
9,Janssenlei 17,2022-11-16,21:00:00,46,26,20,F11SP
9,Janssenlei 17,2022-11-16,22:00:00,38,14,24,F11SP
9,Janssenlei 17,2022-11-16,23:00:00,16,0,16,F11SP
9,Janssenlei 17,2022-11-17,00:00:00,4,0,4,F11SP
9,Janssenlei 17,2022-11-17,01:00:00,4,0,4,F11SP
9,Janssenlei 17,2022-11-17,02:00:00,4,0,4,F11SP
9,Janssenlei 17,2022-11-17,03:00:00,0,0,0,F11SP
9,Janssenlei 17,2022-11-17,04:00:00,6,6,0,F11SP
9,Janssenlei 17,2022-11-17,05:00:00,18,16,2,F11SP
9,Janssenlei 17,2022-11-17,06:00:00,80,58,22,F11SP
9,Janssenlei 17,2022-11-17,07:00:00,240,158,82,F11SP
9,Janssenlei 17,2022-11-17,08:00:00,380,276,104,F11SP
9,Janssenlei 17,2022-11-17,09:00:00,72,40,32,F11SP
9,Janssenlei 17,2022-11-17,10:00:00,52,28,24,F11SP
9,Janssenlei 17,2022-11-17,11:00:00,50,18,32,F11SP
9,Janssenlei 17,2022-11-17,12:00:00,102,56,46,F11SP
9,Janssenlei 17,2022-11-17,13:00:00,100,50,50,F11SP
9,Janssenlei 17,2022-11-17,14:00:00,104,44,60,F11SP
9,Janssenlei 17,2022-11-17,15:00:00,188,68,120,F11SP
9,Janssenlei 17,2022-11-17,16:00:00,332,90,242,F11SP
9,Janssenlei 17,2022-11-17,17:00:00,288,86,202,F11SP
9,Janssenlei 17,2022-11-17,18:00:00,166,52,114,F11SP
9,Janssenlei 17,2022-11-17,19:00:00,58,22,36,F11SP
9,Janssenlei 17,2022-11-17,20:00:00,60,32,28,F11SP
9,Janssenlei 17,2022-11-17,21:00:00,56,40,16,F11SP
9,Janssenlei 17,2022-11-17,22:00:00,44,18,26,F11SP
9,Janssenlei 17,2022-11-17,23:00:00,20,4,16,F11SP
9,Janssenlei 17,2022-11-18,00:00:00,10,2,8,F11SP
9,Janssenlei 17,2022-11-18,01:00:00,6,2,4,F11SP
9,Janssenlei 17,2022-11-18,02:00:00,0,0,0,F11SP
9,Janssenlei 17,2022-11-18,03:00:00,0,0,0,F11SP
9,Janssenlei 17,2022-11-18,04:00:00,10,8,2,F11SP
9,Janssenlei 17,2022-11-18,05:00:00,30,26,4,F11SP
9,Janssenlei 17,2022-11-18,06:00:00,80,56,24,F11SP
9,Janssenlei 17,2022-11-18,07:00:00,348,208,140,F11SP
9,Janssenlei 17,2022-11-18,08:00:00,414,284,130,F11SP
9,Janssenlei 17,2022-11-18,09:00:00,134,86,48,F11SP
9,Janssenlei 17,2022-11-18,10:00:00,114,56,58,F11SP
9,Janssenlei 17,2022-11-18,11:00:00,124,58,66,F11SP
9,Janssenlei 17,2022-11-18,12:00:00,146,58,88,F11SP
9,Janssenlei 17,2022-11-18,13:00:00,124,52,72,F11SP
9,Janssenlei 17,2022-11-18,14:00:00,114,50,64,F11SP
9,Janssenlei 17,2022-11-18,15:00:00,218,66,152,F11SP
9,Janssenlei 17,2022-11-18,16:00:00,422,116,306,F11SP
9,Janssenlei 17,2022-11-18,17:00:00,208,62,146,F11SP
9,Janssenlei 17,2022-11-18,18:00:00,130,48,82,F11SP
9,Janssenlei 17,2022-11-18,19:00:00,28,10,18,F11SP
9,Janssenlei 17,2022-11-18,20:00:00,44,12,32,F11SP
9,Janssenlei 17,2022-11-18,21:00:00,20,6,14,F11SP
9,Janssenlei 17,2022-11-18,22:00:00,52,22,30,F11SP
9,Janssenlei 17,2022-11-18,23:00:00,20,10,10,F11SP
9,Janssenlei 17,2022-11-19,00:00:00,14,6,8,F11SP
9,Janssenlei 17,2022-11-19,01:00:00,12,6,6,F11SP
9,Janssenlei 17,2022-11-19,02:00:00,16,10,6,F11SP
9,Janssenlei 17,2022-11-19,03:00:00,14,0,14,F11SP
9,Janssenlei 17,2022-11-19,04:00:00,4,2,2,F11SP
9,Janssenlei 17,2022-11-19,05:00:00,8,6,2,F11SP
9,Janssenlei 17,2022-11-19,06:00:00,10,4,6,F11SP
9,Janssenlei 17,2022-11-19,07:00:00,26,10,16,F11SP
9,Janssenlei 17,2022-11-19,08:00:00,60,26,34,F11SP
9,Janssenlei 17,2022-11-19,09:00:00,62,38,24,F11SP
9,Janssenlei 17,2022-11-19,10:00:00,86,32,54,F11SP
9,Janssenlei 17,2022-11-19,11:00:00,68,28,40,F11SP
9,Janssenlei 17,2022-11-19,12:00:00,116,56,60,F11SP
9,Janssenlei 17,2022-11-19,13:00:00,74,38,36,F11SP
9,Janssenlei 17,2022-11-19,14:00:00,86,40,46,F11SP
9,Janssenlei 17,2022-11-19,15:00:00,62,34,28,F11SP
9,Janssenlei 17,2022-11-19,16:00:00,106,52,54,F11SP
9,Janssenlei 17,2022-11-19,17:00:00,86,26,60,F11SP
9,Janssenlei 17,2022-11-19,18:00:00,78,40,38,F11SP
9,Janssenlei 17,2022-11-19,19:00:00,12,6,6,F11SP
9,Janssenlei 17,2022-11-19,20:00:00,46,28,18,F11SP
9,Janssenlei 17,2022-11-19,21:00:00,18,14,4,F11SP
9,Janssenlei 17,2022-11-19,22:00:00,28,16,12,F11SP
9,Janssenlei 17,2022-11-19,23:00:00,14,4,10,F11SP
9,Janssenlei 17,2022-11-20,00:00:00,28,12,16,F11SP
9,Janssenlei 17,2022-11-20,01:00:00,18,8,10,F11SP
9,Janssenlei 17,2022-11-20,02:00:00,12,0,12,F11SP
9,Janssenlei 17,2022-11-20,03:00:00,6,0,6,F11SP
9,Janssenlei 17,2022-11-20,04:00:00,2,2,0,F11SP
9,Janssenlei 17,2022-11-20,05:00:00,10,6,4,F11SP
9,Janssenlei 17,2022-11-20,06:00:00,28,14,14,F11SP
9,Janssenlei 17,2022-11-20,07:00:00,18,8,10,F11SP
9,Janssenlei 17,2022-11-20,08:00:00,58,28,30,F11SP
9,Janssenlei 17,2022-11-20,09:00:00,128,52,76,F11SP
9,Janssenlei 17,2022-11-20,10:00:00,134,58,76,F11SP
9,Janssenlei 17,2022-11-20,11:00:00,170,104,66,F11SP
9,Janssenlei 17,2022-11-20,12:00:00,140,58,82,F11SP
9,Janssenlei 17,2022-11-20,13:00:00,96,58,38,F11SP
9,Janssenlei 17,2022-11-20,14:00:00,56,28,28,F11SP
9,Janssenlei 17,2022-11-20,15:00:00,36,10,26,F11SP
9,Janssenlei 17,2022-11-20,16:00:00,44,18,26,F11SP
9,Janssenlei 17,2022-11-20,17:00:00,46,22,24,F11SP
9,Janssenlei 17,2022-11-20,18:00:00,50,20,30,F11SP
9,Janssenlei 17,2022-11-20,19:00:00,32,18,14,F11SP
9,Janssenlei 17,2022-11-20,20:00:00,26,18,8,F11SP
9,Janssenlei 17,2022-11-20,21:00:00,16,6,10,F11SP
9,Janssenlei 17,2022-11-20,22:00:00,18,6,12,F11SP
9,Janssenlei 17,2022-11-20,23:00:00,4,0,4,F11SP
9,Janssenlei 17,2022-11-21,00:00:00,0,0,0,F11SP
9,Janssenlei 17,2022-11-21,01:00:00,0,0,0,F11SP
9,Janssenlei 17,2022-11-21,02:00:00,2,0,2,F11SP
9,Janssenlei 17,2022-11-21,03:00:00,2,2,0,F11SP
9,Janssenlei 17,2022-11-21,04:00:00,8,6,2,F11SP
9,Janssenlei 17,2022-11-21,05:00:00,40,28,12,F11SP
9,Janssenlei 17,2022-11-21,06:00:00,104,70,34,F11SP
9,Janssenlei 17,2022-11-21,07:00:00,442,310,132,F11SP
9,Janssenlei 17,2022-11-21,08:00:00,466,326,140,F11SP
9,Janssenlei 17,2022-11-21,09:00:00,122,72,50,F11SP
9,Janssenlei 17,2022-11-21,10:00:00,98,58,40,F11SP
9,Janssenlei 17,2022-11-21,11:00:00,146,72,74,F11SP
9,Janssenlei 17,2022-11-21,12:00:00,176,80,96,F11SP
9,Janssenlei 17,2022-11-21,13:00:00,130,50,80,F11SP
9,Janssenlei 17,2022-11-21,14:00:00,148,66,82,F11SP
9,Janssenlei 17,2022-11-21,15:00:00,220,78,142,F11SP
9,Janssenlei 17,2022-11-21,16:00:00,466,146,320,F11SP
9,Janssenlei 17,2022-11-21,17:00:00,346,78,268,F11SP
9,Janssenlei 17,2022-11-21,18:00:00,128,24,104,F11SP
9,Janssenlei 17,2022-11-21,19:00:00,74,14,60,F11SP
9,Janssenlei 17,2022-11-21,20:00:00,26,14,12,F11SP
9,Janssenlei 17,2022-11-21,21:00:00,24,8,16,F11SP
9,Janssenlei 17,2022-11-21,22:00:00,42,12,30,F11SP
9,Janssenlei 17,2022-11-21,23:00:00,4,0,4,F11SP
9,Janssenlei 17,2022-11-22,00:00:00,4,2,2,F11SP
9,Janssenlei 17,2022-11-22,01:00:00,0,0,0,F11SP
9,Janssenlei 17,2022-11-22,02:00:00,0,0,0,F11SP
9,Janssenlei 17,2022-11-22,03:00:00,6,4,2,F11SP
9,Janssenlei 17,2022-11-22,04:00:00,8,6,2,F11SP
9,Janssenlei 17,2022-11-22,05:00:00,54,40,14,F11SP
9,Janssenlei 17,2022-11-22,06:00:00,106,78,28,F11SP
9,Janssenlei 17,2022-11-22,07:00:00,394,300,94,F11SP
9,Janssenlei 17,2022-11-22,08:00:00,444,324,120,F11SP
9,Janssenlei 17,2022-11-22,09:00:00,166,88,78,F11SP
9,Janssenlei 17,2022-11-22,10:00:00,68,38,30,F11SP
9,Janssenlei 17,2022-11-22,11:00:00,68,40,28,F11SP
9,Janssenlei 17,2022-11-22,12:00:00,96,54,42,F11SP
9,Janssenlei 17,2022-11-22,13:00:00,118,50,68,F11SP
9,Janssenlei 17,2022-11-22,14:00:00,108,42,66,F11SP
9,Janssenlei 17,2022-11-22,15:00:00,184,56,128,F11SP
9,Janssenlei 17,2022-11-22,16:00:00,388,118,270,F11SP
9,Janssenlei 17,2022-11-22,17:00:00,354,82,272,F11SP
9,Janssenlei 17,2022-11-22,18:00:00,184,32,152,F11SP
9,Janssenlei 17,2022-11-22,19:00:00,80,22,58,F11SP
9,Janssenlei 17,2022-11-22,20:00:00,60,24,36,F11SP
9,Janssenlei 17,2022-11-22,21:00:00,48,24,24,F11SP
9,Janssenlei 17,2022-11-22,22:00:00,54,12,42,F11SP
9,Janssenlei 17,2022-11-22,23:00:00,24,8,16,F11SP
9,Janssenlei 17,2022-11-23,00:00:00,8,4,4,F11SP
9,Janssenlei 17,2022-11-23,01:00:00,2,0,2,F11SP
9,Janssenlei 17,2022-11-23,02:00:00,4,2,2,F11SP
9,Janssenlei 17,2022-11-23,03:00:00,0,0,0,F11SP
9,Janssenlei 17,2022-11-23,04:00:00,10,6,4,F11SP
9,Janssenlei 17,2022-11-23,05:00:00,52,36,16,F11SP
9,Janssenlei 17,2022-11-23,06:00:00,102,70,32,F11SP
9,Janssenlei 17,2022-11-23,07:00:00,300,204,96,F11SP
9,Janssenlei 17,2022-11-23,08:00:00,426,308,118,F11SP
9,Janssenlei 17,2022-11-23,09:00:00,132,72,60,F11SP
9,Janssenlei 17,2022-11-23,10:00:00,126,50,76,F11SP
9,Janssenlei 17,2022-11-23,11:00:00,126,58,68,F11SP
9,Janssenlei 17,2022-11-23,12:00:00,326,114,212,F11SP
9,Janssenlei 17,2022-11-23,13:00:00,200,84,116,F11SP
9,Janssenlei 17,2022-11-23,14:00:00,88,42,46,F11SP
9,Janssenlei 17,2022-11-23,15:00:00,84,36,48,F11SP
9,Janssenlei 17,2022-11-23,16:00:00,250,88,162,F11SP
9,Janssenlei 17,2022-11-23,17:00:00,224,70,154,F11SP
9,Janssenlei 17,2022-11-23,18:00:00,164,50,114,F11SP
9,Janssenlei 17,2022-11-23,19:00:00,86,34,52,F11SP
9,Janssenlei 17,2022-11-23,20:00:00,26,20,6,F11SP
9,Janssenlei 17,2022-11-23,21:00:00,40,12,28,F11SP
9,Janssenlei 17,2022-11-23,22:00:00,52,14,38,F11SP
9,Janssenlei 17,2022-11-23,23:00:00,12,6,6,F11SP
9,Janssenlei 17,2022-11-24,00:00:00,12,4,8,F11SP
9,Janssenlei 17,2022-11-24,01:00:00,2,2,0,F11SP
9,Janssenlei 17,2022-11-24,02:00:00,0,0,0,F11SP
9,Janssenlei 17,2022-11-24,03:00:00,2,2,0,F11SP
9,Janssenlei 17,2022-11-24,04:00:00,10,10,0,F11SP
9,Janssenlei 17,2022-11-24,05:00:00,30,20,10,F11SP
9,Janssenlei 17,2022-11-24,06:00:00,114,76,38,F11SP
9,Janssenlei 17,2022-11-24,07:00:00,422,304,118,F11SP
9,Janssenlei 17,2022-11-24,08:00:00,546,388,158,F11SP
9,Janssenlei 17,2022-11-24,09:00:00,138,86,52,F11SP
9,Janssenlei 17,2022-11-24,10:00:00,106,54,52,F11SP
9,Janssenlei 17,2022-11-24,11:00:00,148,68,80,F11SP
9,Janssenlei 17,2022-11-24,12:00:00,170,60,110,F11SP
9,Janssenlei 17,2022-11-24,13:00:00,218,84,134,F11SP
9,Janssenlei 17,2022-11-24,14:00:00,212,84,128,F11SP
9,Janssenlei 17,2022-11-24,15:00:00,326,122,204,F11SP
9,Janssenlei 17,2022-11-24,16:00:00,488,174,314,F11SP
9,Janssenlei 17,2022-11-24,17:00:00,390,98,292,F11SP
9,Janssenlei 17,2022-11-24,18:00:00,172,66,106,F11SP
9,Janssenlei 17,2022-11-24,19:00:00,72,18,54,F11SP
9,Janssenlei 17,2022-11-24,20:00:00,48,16,32,F11SP
9,Janssenlei 17,2022-11-24,21:00:00,34,14,20,F11SP
9,Janssenlei 17,2022-11-24,22:00:00,38,8,30,F11SP
9,Janssenlei 17,2022-11-24,23:00:00,22,8,14,F11SP
9,Janssenlei 17,2022-11-25,00:00:00,14,2,12,F11SP
9,Janssenlei 17,2022-11-25,01:00:00,0,0,0,F11SP
9,Janssenlei 17,2022-11-25,02:00:00,2,2,0,F11SP
9,Janssenlei 17,2022-11-25,03:00:00,2,2,0,F11SP
9,Janssenlei 17,2022-11-25,04:00:00,18,18,0,F11SP
9,Janssenlei 17,2022-11-25,05:00:00,36,26,10,F11SP
9,Janssenlei 17,2022-11-25,06:00:00,88,54,34,F11SP
9,Janssenlei 17,2022-11-25,07:00:00,314,204,110,F11SP
9,Janssenlei 17,2022-11-25,08:00:00,462,318,144,F11SP
9,Janssenlei 17,2022-11-25,09:00:00,136,76,60,F11SP
9,Janssenlei 17,2022-11-25,10:00:00,96,56,40,F11SP
9,Janssenlei 17,2022-11-25,11:00:00,146,68,78,F11SP
9,Janssenlei 17,2022-11-25,12:00:00,142,56,86,F11SP
9,Janssenlei 17,2022-11-25,13:00:00,228,80,148,F11SP
9,Janssenlei 17,2022-11-25,14:00:00,254,100,154,F11SP
9,Janssenlei 17,2022-11-25,15:00:00,336,132,204,F11SP
9,Janssenlei 17,2022-11-25,16:00:00,442,120,322,F11SP
9,Janssenlei 17,2022-11-25,17:00:00,266,78,188,F11SP
9,Janssenlei 17,2022-11-25,18:00:00,178,76,102,F11SP
9,Janssenlei 17,2022-11-25,19:00:00,62,20,42,F11SP
9,Janssenlei 17,2022-11-25,20:00:00,58,40,18,F11SP
9,Janssenlei 17,2022-11-25,21:00:00,28,12,16,F11SP
9,Janssenlei 17,2022-11-25,22:00:00,40,10,30,F11SP
9,Janssenlei 17,2022-11-25,23:00:00,22,12,10,F11SP
9,Janssenlei 17,2022-11-26,00:00:00,18,6,12,F11SP
9,Janssenlei 17,2022-11-26,01:00:00,20,6,14,F11SP
9,Janssenlei 17,2022-11-26,02:00:00,6,0,6,F11SP
9,Janssenlei 17,2022-11-26,03:00:00,14,6,8,F11SP
9,Janssenlei 17,2022-11-26,04:00:00,6,4,2,F11SP
9,Janssenlei 17,2022-11-26,05:00:00,16,12,4,F11SP
9,Janssenlei 17,2022-11-26,06:00:00,18,6,12,F11SP
9,Janssenlei 17,2022-11-26,07:00:00,44,24,20,F11SP
9,Janssenlei 17,2022-11-26,08:00:00,90,32,58,F11SP
9,Janssenlei 17,2022-11-26,09:00:00,150,66,84,F11SP
9,Janssenlei 17,2022-11-26,10:00:00,194,78,116,F11SP
9,Janssenlei 17,2022-11-26,11:00:00,254,104,150,F11SP
9,Janssenlei 17,2022-11-26,12:00:00,220,108,112,F11SP
9,Janssenlei 17,2022-11-26,13:00:00,262,146,116,F11SP
9,Janssenlei 17,2022-11-26,14:00:00,240,110,130,F11SP
9,Janssenlei 17,2022-11-26,15:00:00,310,138,172,F11SP
9,Janssenlei 17,2022-11-26,16:00:00,212,108,104,F11SP
9,Janssenlei 17,2022-11-26,17:00:00,110,38,72,F11SP
9,Janssenlei 17,2022-11-26,18:00:00,56,28,28,F11SP
9,Janssenlei 17,2022-11-26,19:00:00,36,20,16,F11SP
9,Janssenlei 17,2022-11-26,20:00:00,50,26,24,F11SP
9,Janssenlei 17,2022-11-26,21:00:00,34,24,10,F11SP
9,Janssenlei 17,2022-11-26,22:00:00,28,8,20,F11SP
9,Janssenlei 17,2022-11-26,23:00:00,24,12,12,F11SP
9,Janssenlei 17,2022-11-27,00:00:00,12,6,6,F11SP
9,Janssenlei 17,2022-11-27,01:00:00,14,6,8,F11SP
9,Janssenlei 17,2022-11-27,02:00:00,8,0,8,F11SP
9,Janssenlei 17,2022-11-27,03:00:00,4,0,4,F11SP
9,Janssenlei 17,2022-11-27,04:00:00,2,2,0,F11SP
9,Janssenlei 17,2022-11-27,05:00:00,4,2,2,F11SP
9,Janssenlei 17,2022-11-27,06:00:00,22,8,14,F11SP
9,Janssenlei 17,2022-11-27,07:00:00,16,6,10,F11SP
9,Janssenlei 17,2022-11-27,08:00:00,36,18,18,F11SP
9,Janssenlei 17,2022-11-27,09:00:00,110,36,74,F11SP
9,Janssenlei 17,2022-11-27,10:00:00,98,46,52,F11SP
9,Janssenlei 17,2022-11-27,11:00:00,62,44,18,F11SP
9,Janssenlei 17,2022-11-27,12:00:00,78,48,30,F11SP
9,Janssenlei 17,2022-11-27,13:00:00,84,46,38,F11SP
9,Janssenlei 17,2022-11-27,14:00:00,60,30,30,F11SP
9,Janssenlei 17,2022-11-27,15:00:00,28,6,22,F11SP
9,Janssenlei 17,2022-11-27,16:00:00,50,26,24,F11SP
9,Janssenlei 17,2022-11-27,17:00:00,54,18,36,F11SP
9,Janssenlei 17,2022-11-27,18:00:00,24,8,16,F11SP
9,Janssenlei 17,2022-11-27,19:00:00,30,14,16,F11SP
9,Janssenlei 17,2022-11-27,20:00:00,12,8,4,F11SP
9,Janssenlei 17,2022-11-27,21:00:00,10,8,2,F11SP
9,Janssenlei 17,2022-11-27,22:00:00,24,6,18,F11SP
9,Janssenlei 17,2022-11-27,23:00:00,2,0,2,F11SP
9,Janssenlei 17,2022-11-28,00:00:00,0,0,0,F11SP
9,Janssenlei 17,2022-11-28,01:00:00,0,0,0,F11SP
9,Janssenlei 17,2022-11-28,02:00:00,0,0,0,F11SP
9,Janssenlei 17,2022-11-28,03:00:00,0,0,0,F11SP
9,Janssenlei 17,2022-11-28,04:00:00,14,14,0,F11SP
9,Janssenlei 17,2022-11-28,05:00:00,42,32,10,F11SP
9,Janssenlei 17,2022-11-28,06:00:00,100,74,26,F11SP
9,Janssenlei 17,2022-11-28,07:00:00,364,240,124,F11SP
9,Janssenlei 17,2022-11-28,08:00:00,450,320,130,F11SP
9,Janssenlei 17,2022-11-28,09:00:00,110,54,56,F11SP
9,Janssenlei 17,2022-11-28,10:00:00,44,24,20,F11SP
9,Janssenlei 17,2022-11-28,11:00:00,74,44,30,F11SP
9,Janssenlei 17,2022-11-28,12:00:00,106,50,56,F11SP
9,Janssenlei 17,2022-11-28,13:00:00,126,64,62,F11SP
9,Janssenlei 17,2022-11-28,14:00:00,140,56,84,F11SP
9,Janssenlei 17,2022-11-28,15:00:00,202,88,114,F11SP
9,Janssenlei 17,2022-11-28,16:00:00,424,122,302,F11SP
9,Janssenlei 17,2022-11-28,17:00:00,336,96,240,F11SP
9,Janssenlei 17,2022-11-28,18:00:00,154,36,118,F11SP
9,Janssenlei 17,2022-11-28,19:00:00,84,32,52,F11SP
9,Janssenlei 17,2022-11-28,20:00:00,44,22,22,F11SP
9,Janssenlei 17,2022-11-28,21:00:00,32,10,22,F11SP
9,Janssenlei 17,2022-11-28,22:00:00,46,18,28,F11SP
9,Janssenlei 17,2022-11-28,23:00:00,10,6,4,F11SP
9,Janssenlei 17,2022-11-29,00:00:00,0,0,0,F11SP
9,Janssenlei 17,2022-11-29,01:00:00,0,0,0,F11SP
9,Janssenlei 17,2022-11-29,02:00:00,0,0,0,F11SP
9,Janssenlei 17,2022-11-29,03:00:00,0,0,0,F11SP
9,Janssenlei 17,2022-11-29,04:00:00,6,6,0,F11SP
9,Janssenlei 17,2022-11-29,05:00:00,50,42,8,F11SP
9,Janssenlei 17,2022-11-29,06:00:00,158,116,42,F11SP
9,Janssenlei 17,2022-11-29,07:00:00,482,334,148,F11SP
9,Janssenlei 17,2022-11-29,08:00:00,586,426,160,F11SP
9,Janssenlei 17,2022-11-29,09:00:00,164,98,66,F11SP
9,Janssenlei 17,2022-11-29,10:00:00,110,56,54,F11SP
9,Janssenlei 17,2022-11-29,11:00:00,96,46,50,F11SP
9,Janssenlei 17,2022-11-29,12:00:00,148,64,84,F11SP
9,Janssenlei 17,2022-11-29,13:00:00,212,96,116,F11SP
9,Janssenlei 17,2022-11-29,14:00:00,182,72,110,F11SP
9,Janssenlei 17,2022-11-29,15:00:00,300,104,196,F11SP
9,Janssenlei 17,2022-11-29,16:00:00,586,148,438,F11SP
9,Janssenlei 17,2022-11-29,17:00:00,480,122,358,F11SP
9,Janssenlei 17,2022-11-29,18:00:00,178,46,132,F11SP
9,Janssenlei 17,2022-11-29,19:00:00,112,38,74,F11SP
9,Janssenlei 17,2022-11-29,20:00:00,38,24,14,F11SP
9,Janssenlei 17,2022-11-29,21:00:00,32,10,22,F11SP
9,Janssenlei 17,2022-11-29,22:00:00,76,14,62,F11SP
9,Janssenlei 17,2022-11-29,23:00:00,14,2,12,F11SP
9,Janssenlei 17,2022-11-30,00:00:00,10,4,6,F11SP
9,Janssenlei 17,2022-11-30,01:00:00,2,0,2,F11SP
9,Janssenlei 17,2022-11-30,02:00:00,0,0,0,F11SP
9,Janssenlei 17,2022-11-30,03:00:00,6,6,0,F11SP
9,Janssenlei 17,2022-11-30,04:00:00,12,10,2,F11SP
9,Janssenlei 17,2022-11-30,05:00:00,50,44,6,F11SP
9,Janssenlei 17,2022-11-30,06:00:00,140,98,42,F11SP
9,Janssenlei 17,2022-11-30,07:00:00,446,282,164,F11SP
9,Janssenlei 17,2022-11-30,08:00:00,508,346,162,F11SP
9,Janssenlei 17,2022-11-30,09:00:00,158,80,78,F11SP
9,Janssenlei 17,2022-11-30,10:00:00,76,30,46,F11SP
9,Janssenlei 17,2022-11-30,11:00:00,130,42,88,F11SP
9,Janssenlei 17,2022-11-30,12:00:00,412,156,256,F11SP
9,Janssenlei 17,2022-11-30,13:00:00,256,108,148,F11SP
9,Janssenlei 17,2022-11-30,14:00:00,166,46,120,F11SP
9,Janssenlei 17,2022-11-30,15:00:00,208,90,118,F11SP
9,Janssenlei 17,2022-11-30,16:00:00,316,98,218,F11SP
9,Janssenlei 17,2022-11-30,17:00:00,314,88,226,F11SP
9,Janssenlei 17,2022-11-30,18:00:00,238,82,156,F11SP
9,Janssenlei 17,2022-11-30,19:00:00,122,36,86,F11SP
9,Janssenlei 17,2022-11-30,20:00:00,46,22,24,F11SP
9,Janssenlei 17,2022-11-30,21:00:00,48,18,30,F11SP
9,Janssenlei 17,2022-11-30,22:00:00,70,24,46,F11SP
9,Janssenlei 17,2022-11-30,23:00:00,16,8,8,F11SP
9,Janssenlei 17,2022-12-01,00:00:00,6,4,2,F11SP
9,Janssenlei 17,2022-12-01,01:00:00,0,0,0,F11SP
9,Janssenlei 17,2022-12-01,02:00:00,0,0,0,F11SP
9,Janssenlei 17,2022-12-01,03:00:00,2,0,2,F11SP
9,Janssenlei 17,2022-12-01,04:00:00,12,10,2,F11SP
9,Janssenlei 17,2022-12-01,05:00:00,44,34,10,F11SP
9,Janssenlei 17,2022-12-01,06:00:00,142,106,36,F11SP
9,Janssenlei 17,2022-12-01,07:00:00,394,254,140,F11SP
9,Janssenlei 17,2022-12-01,08:00:00,568,406,162,F11SP
9,Janssenlei 17,2022-12-01,09:00:00,160,108,52,F11SP
9,Janssenlei 17,2022-12-01,10:00:00,88,46,42,F11SP
9,Janssenlei 17,2022-12-01,11:00:00,120,48,72,F11SP
9,Janssenlei 17,2022-12-01,12:00:00,156,70,86,F11SP
9,Janssenlei 17,2022-12-01,13:00:00,194,82,112,F11SP
9,Janssenlei 17,2022-12-01,14:00:00,208,88,120,F11SP
9,Janssenlei 17,2022-12-01,15:00:00,324,116,208,F11SP
9,Janssenlei 17,2022-12-01,16:00:00,450,122,328,F11SP
9,Janssenlei 17,2022-12-01,17:00:00,288,68,220,F11SP
9,Janssenlei 17,2022-12-01,18:00:00,238,66,172,F11SP
9,Janssenlei 17,2022-12-01,19:00:00,94,28,66,F11SP
9,Janssenlei 17,2022-12-01,20:00:00,76,36,40,F11SP
9,Janssenlei 17,2022-12-01,21:00:00,64,30,34,F11SP
9,Janssenlei 17,2022-12-01,22:00:00,72,24,48,F11SP
9,Janssenlei 17,2022-12-01,23:00:00,14,4,10,F11SP
9,Janssenlei 17,2022-12-02,00:00:00,18,6,12,F11SP
9,Janssenlei 17,2022-12-02,01:00:00,6,0,6,F11SP
9,Janssenlei 17,2022-12-02,02:00:00,6,4,2,F11SP
9,Janssenlei 17,2022-12-02,03:00:00,0,0,0,F11SP
9,Janssenlei 17,2022-12-02,04:00:00,14,14,0,F11SP
9,Janssenlei 17,2022-12-02,05:00:00,38,32,6,F11SP
9,Janssenlei 17,2022-12-02,06:00:00,108,68,40,F11SP
9,Janssenlei 17,2022-12-02,07:00:00,292,192,100,F11SP
9,Janssenlei 17,2022-12-02,08:00:00,444,298,146,F11SP
9,Janssenlei 17,2022-12-02,09:00:00,146,90,56,F11SP
9,Janssenlei 17,2022-12-02,10:00:00,124,74,50,F11SP
9,Janssenlei 17,2022-12-02,11:00:00,70,34,36,F11SP
9,Janssenlei 17,2022-12-02,12:00:00,140,66,74,F11SP
9,Janssenlei 17,2022-12-02,13:00:00,114,32,82,F11SP
9,Janssenlei 17,2022-12-02,14:00:00,136,62,74,F11SP
9,Janssenlei 17,2022-12-02,15:00:00,276,80,196,F11SP
9,Janssenlei 17,2022-12-02,16:00:00,370,102,268,F11SP
9,Janssenlei 17,2022-12-02,17:00:00,224,70,154,F11SP
9,Janssenlei 17,2022-12-02,18:00:00,154,64,90,F11SP
9,Janssenlei 17,2022-12-02,19:00:00,68,24,44,F11SP
9,Janssenlei 17,2022-12-02,20:00:00,52,26,26,F11SP
9,Janssenlei 17,2022-12-02,21:00:00,36,20,16,F11SP
9,Janssenlei 17,2022-12-02,22:00:00,56,8,48,F11SP
9,Janssenlei 17,2022-12-02,23:00:00,22,12,10,F11SP
9,Janssenlei 17,2022-12-03,00:00:00,20,6,14,F11SP
9,Janssenlei 17,2022-12-03,01:00:00,16,2,14,F11SP
9,Janssenlei 17,2022-12-03,02:00:00,26,8,18,F11SP
9,Janssenlei 17,2022-12-03,03:00:00,10,0,10,F11SP
9,Janssenlei 17,2022-12-03,04:00:00,6,4,2,F11SP
9,Janssenlei 17,2022-12-03,05:00:00,8,8,0,F11SP
9,Janssenlei 17,2022-12-03,06:00:00,18,2,16,F11SP
9,Janssenlei 17,2022-12-03,07:00:00,20,14,6,F11SP
9,Janssenlei 17,2022-12-03,08:00:00,56,26,30,F11SP
9,Janssenlei 17,2022-12-03,09:00:00,46,24,22,F11SP
9,Janssenlei 17,2022-12-03,10:00:00,82,40,42,F11SP
9,Janssenlei 17,2022-12-03,11:00:00,110,46,64,F11SP
9,Janssenlei 17,2022-12-03,12:00:00,136,68,68,F11SP
9,Janssenlei 17,2022-12-03,13:00:00,120,62,58,F11SP
9,Janssenlei 17,2022-12-03,14:00:00,140,72,68,F11SP
9,Janssenlei 17,2022-12-03,15:00:00,140,54,86,F11SP
9,Janssenlei 17,2022-12-03,16:00:00,64,46,18,F11SP
9,Janssenlei 17,2022-12-03,17:00:00,70,38,32,F11SP
9,Janssenlei 17,2022-12-03,18:00:00,52,24,28,F11SP
9,Janssenlei 17,2022-12-03,19:00:00,18,10,8,F11SP
9,Janssenlei 17,2022-12-03,20:00:00,32,20,12,F11SP
9,Janssenlei 17,2022-12-03,21:00:00,14,10,4,F11SP
9,Janssenlei 17,2022-12-03,22:00:00,32,6,26,F11SP
9,Janssenlei 17,2022-12-03,23:00:00,24,20,4,F11SP
9,Janssenlei 17,2022-12-04,00:00:00,6,6,0,F11SP
9,Janssenlei 17,2022-12-04,01:00:00,8,0,8,F11SP
9,Janssenlei 17,2022-12-04,02:00:00,16,6,10,F11SP
9,Janssenlei 17,2022-12-04,03:00:00,16,6,10,F11SP
9,Janssenlei 17,2022-12-04,04:00:00,10,8,2,F11SP
9,Janssenlei 17,2022-12-04,05:00:00,8,6,2,F11SP
9,Janssenlei 17,2022-12-04,06:00:00,20,8,12,F11SP
9,Janssenlei 17,2022-12-04,07:00:00,20,8,12,F11SP
9,Janssenlei 17,2022-12-04,08:00:00,36,8,28,F11SP
9,Janssenlei 17,2022-12-04,09:00:00,124,44,80,F11SP
9,Janssenlei 17,2022-12-04,10:00:00,158,90,68,F11SP
9,Janssenlei 17,2022-12-04,11:00:00,132,70,62,F11SP
9,Janssenlei 17,2022-12-04,12:00:00,154,74,80,F11SP
9,Janssenlei 17,2022-12-04,13:00:00,116,58,58,F11SP
9,Janssenlei 17,2022-12-04,14:00:00,76,30,46,F11SP
9,Janssenlei 17,2022-12-04,15:00:00,88,52,36,F11SP
9,Janssenlei 17,2022-12-04,16:00:00,60,32,28,F11SP
9,Janssenlei 17,2022-12-04,17:00:00,50,22,28,F11SP
9,Janssenlei 17,2022-12-04,18:00:00,60,16,44,F11SP
9,Janssenlei 17,2022-12-04,19:00:00,22,14,8,F11SP
9,Janssenlei 17,2022-12-04,20:00:00,18,8,10,F11SP
9,Janssenlei 17,2022-12-04,21:00:00,20,12,8,F11SP
9,Janssenlei 17,2022-12-04,22:00:00,10,0,10,F11SP
9,Janssenlei 17,2022-12-04,23:00:00,6,0,6,F11SP
9,Janssenlei 17,2022-12-05,00:00:00,4,2,2,F11SP
9,Janssenlei 17,2022-12-05,01:00:00,0,0,0,F11SP
9,Janssenlei 17,2022-12-05,02:00:00,6,0,6,F11SP
9,Janssenlei 17,2022-12-05,03:00:00,0,0,0,F11SP
9,Janssenlei 17,2022-12-05,04:00:00,4,4,0,F11SP
9,Janssenlei 17,2022-12-05,05:00:00,28,16,12,F11SP
9,Janssenlei 17,2022-12-05,06:00:00,68,50,18,F11SP
9,Janssenlei 17,2022-12-05,07:00:00,326,236,90,F11SP
9,Janssenlei 17,2022-12-05,08:00:00,424,308,116,F11SP
9,Janssenlei 17,2022-12-05,09:00:00,86,42,44,F11SP
9,Janssenlei 17,2022-12-05,10:00:00,56,38,18,F11SP
9,Janssenlei 17,2022-12-05,11:00:00,52,26,26,F11SP
9,Janssenlei 17,2022-12-05,12:00:00,116,54,62,F11SP
9,Janssenlei 17,2022-12-05,13:00:00,102,36,66,F11SP
9,Janssenlei 17,2022-12-05,14:00:00,78,18,60,F11SP
9,Janssenlei 17,2022-12-05,15:00:00,140,36,104,F11SP
9,Janssenlei 17,2022-12-05,16:00:00,318,94,224,F11SP
9,Janssenlei 17,2022-12-05,17:00:00,242,48,194,F11SP
9,Janssenlei 17,2022-12-05,18:00:00,116,26,90,F11SP
9,Janssenlei 17,2022-12-05,19:00:00,42,18,24,F11SP
9,Janssenlei 17,2022-12-05,20:00:00,52,22,30,F11SP
9,Janssenlei 17,2022-12-05,21:00:00,20,8,12,F11SP
9,Janssenlei 17,2022-12-05,22:00:00,24,8,16,F11SP
9,Janssenlei 17,2022-12-05,23:00:00,6,0,6,F11SP
9,Janssenlei 17,2022-12-06,00:00:00,2,0,2,F11SP
9,Janssenlei 17,2022-12-06,01:00:00,2,0,2,F11SP
9,Janssenlei 17,2022-12-06,02:00:00,0,0,0,F11SP
9,Janssenlei 17,2022-12-06,03:00:00,0,0,0,F11SP
9,Janssenlei 17,2022-12-06,04:00:00,8,8,0,F11SP
9,Janssenlei 17,2022-12-06,05:00:00,44,28,16,F11SP
9,Janssenlei 17,2022-12-06,06:00:00,122,76,46,F11SP
9,Janssenlei 17,2022-12-06,07:00:00,364,270,94,F11SP
9,Janssenlei 17,2022-12-06,08:00:00,498,362,136,F11SP
9,Janssenlei 17,2022-12-06,09:00:00,142,78,64,F11SP
9,Janssenlei 17,2022-12-06,10:00:00,94,40,54,F11SP
9,Janssenlei 17,2022-12-06,11:00:00,136,68,68,F11SP
9,Janssenlei 17,2022-12-06,12:00:00,146,62,84,F11SP
9,Janssenlei 17,2022-12-06,13:00:00,172,78,94,F11SP
9,Janssenlei 17,2022-12-06,14:00:00,172,86,86,F11SP
9,Janssenlei 17,2022-12-06,15:00:00,286,88,198,F11SP
9,Janssenlei 17,2022-12-06,16:00:00,358,92,266,F11SP
9,Janssenlei 17,2022-12-06,17:00:00,352,82,270,F11SP
9,Janssenlei 17,2022-12-06,18:00:00,192,60,132,F11SP
9,Janssenlei 17,2022-12-06,19:00:00,60,16,44,F11SP
9,Janssenlei 17,2022-12-06,20:00:00,68,42,26,F11SP
9,Janssenlei 17,2022-12-06,21:00:00,50,22,28,F11SP
9,Janssenlei 17,2022-12-06,22:00:00,38,4,34,F11SP
9,Janssenlei 17,2022-12-06,23:00:00,10,0,10,F11SP
9,Janssenlei 17,2022-12-07,00:00:00,2,0,2,F11SP
9,Janssenlei 17,2022-12-07,01:00:00,10,2,8,F11SP
9,Janssenlei 17,2022-12-07,02:00:00,6,6,0,F11SP
9,Janssenlei 17,2022-12-07,03:00:00,0,0,0,F11SP
9,Janssenlei 17,2022-12-07,04:00:00,8,6,2,F11SP
9,Janssenlei 17,2022-12-07,05:00:00,30,20,10,F11SP
9,Janssenlei 17,2022-12-07,06:00:00,84,60,24,F11SP
9,Janssenlei 17,2022-12-07,07:00:00,342,216,126,F11SP
9,Janssenlei 17,2022-12-07,08:00:00,386,280,106,F11SP
9,Janssenlei 17,2022-12-07,09:00:00,122,74,48,F11SP
9,Janssenlei 17,2022-12-07,10:00:00,116,48,68,F11SP
9,Janssenlei 17,2022-12-07,11:00:00,114,58,56,F11SP
9,Janssenlei 17,2022-12-07,12:00:00,274,68,206,F11SP
9,Janssenlei 17,2022-12-07,13:00:00,162,78,84,F11SP
9,Janssenlei 17,2022-12-07,14:00:00,102,34,68,F11SP
9,Janssenlei 17,2022-12-07,15:00:00,92,34,58,F11SP
9,Janssenlei 17,2022-12-07,16:00:00,200,70,130,F11SP
9,Janssenlei 17,2022-12-07,17:00:00,250,92,158,F11SP
9,Janssenlei 17,2022-12-07,18:00:00,136,40,96,F11SP
9,Janssenlei 17,2022-12-07,19:00:00,68,24,44,F11SP
9,Janssenlei 17,2022-12-07,20:00:00,46,20,26,F11SP
9,Janssenlei 17,2022-12-07,21:00:00,28,10,18,F11SP
9,Janssenlei 17,2022-12-07,22:00:00,44,10,34,F11SP
9,Janssenlei 17,2022-12-07,23:00:00,12,2,10,F11SP
9,Janssenlei 17,2022-12-08,00:00:00,6,0,6,F11SP
9,Janssenlei 17,2022-12-08,01:00:00,0,0,0,F11SP
9,Janssenlei 17,2022-12-08,02:00:00,0,0,0,F11SP
9,Janssenlei 17,2022-12-08,03:00:00,0,0,0,F11SP
9,Janssenlei 17,2022-12-08,04:00:00,4,4,0,F11SP
9,Janssenlei 17,2022-12-08,05:00:00,26,18,8,F11SP
9,Janssenlei 17,2022-12-08,06:00:00,92,68,24,F11SP
9,Janssenlei 17,2022-12-08,07:00:00,340,234,106,F11SP
9,Janssenlei 17,2022-12-08,08:00:00,402,280,122,F11SP
9,Janssenlei 17,2022-12-08,09:00:00,138,80,58,F11SP
9,Janssenlei 17,2022-12-08,10:00:00,96,54,42,F11SP
9,Janssenlei 17,2022-12-08,11:00:00,130,68,62,F11SP
9,Janssenlei 17,2022-12-08,12:00:00,146,60,86,F11SP
9,Janssenlei 17,2022-12-08,13:00:00,94,50,44,F11SP
9,Janssenlei 17,2022-12-08,14:00:00,48,10,38,F11SP
9,Janssenlei 17,2022-12-08,15:00:00,136,42,94,F11SP
9,Janssenlei 17,2022-12-08,16:00:00,308,82,226,F11SP
9,Janssenlei 17,2022-12-08,17:00:00,250,64,186,F11SP
9,Janssenlei 17,2022-12-08,18:00:00,140,58,82,F11SP
9,Janssenlei 17,2022-12-08,19:00:00,52,20,32,F11SP
9,Janssenlei 17,2022-12-08,20:00:00,52,18,34,F11SP
9,Janssenlei 17,2022-12-08,21:00:00,36,20,16,F11SP
9,Janssenlei 17,2022-12-08,22:00:00,44,10,34,F11SP
9,Janssenlei 17,2022-12-08,23:00:00,24,10,14,F11SP
9,Janssenlei 17,2022-12-09,00:00:00,12,4,8,F11SP
9,Janssenlei 17,2022-12-09,01:00:00,12,6,6,F11SP
9,Janssenlei 17,2022-12-09,02:00:00,4,2,2,F11SP
9,Janssenlei 17,2022-12-09,03:00:00,4,4,0,F11SP
9,Janssenlei 17,2022-12-09,04:00:00,4,4,0,F11SP
9,Janssenlei 17,2022-12-09,05:00:00,32,16,16,F11SP
9,Janssenlei 17,2022-12-09,06:00:00,44,30,14,F11SP
9,Janssenlei 17,2022-12-09,07:00:00,246,168,78,F11SP
9,Janssenlei 17,2022-12-09,08:00:00,336,268,68,F11SP
9,Janssenlei 17,2022-12-09,09:00:00,98,60,38,F11SP
9,Janssenlei 17,2022-12-09,10:00:00,82,50,32,F11SP
9,Janssenlei 17,2022-12-09,11:00:00,130,68,62,F11SP
9,Janssenlei 17,2022-12-09,12:00:00,146,54,92,F11SP
9,Janssenlei 17,2022-12-09,13:00:00,128,54,74,F11SP
9,Janssenlei 17,2022-12-09,14:00:00,136,52,84,F11SP
9,Janssenlei 17,2022-12-09,15:00:00,206,56,150,F11SP
9,Janssenlei 17,2022-12-09,16:00:00,184,52,132,F11SP
9,Janssenlei 17,2022-12-09,17:00:00,158,40,118,F11SP
9,Janssenlei 17,2022-12-09,18:00:00,136,46,90,F11SP
9,Janssenlei 17,2022-12-09,19:00:00,48,18,30,F11SP
9,Janssenlei 17,2022-12-09,20:00:00,40,14,26,F11SP
9,Janssenlei 17,2022-12-09,21:00:00,20,8,12,F11SP
9,Janssenlei 17,2022-12-09,22:00:00,20,6,14,F11SP
9,Janssenlei 17,2022-12-09,23:00:00,30,6,24,F11SP
9,Janssenlei 17,2022-12-10,00:00:00,14,8,6,F11SP
9,Janssenlei 17,2022-12-10,01:00:00,26,6,20,F11SP
9,Janssenlei 17,2022-12-10,02:00:00,4,0,4,F11SP
9,Janssenlei 17,2022-12-10,03:00:00,6,0,6,F11SP
9,Janssenlei 17,2022-12-10,04:00:00,0,0,0,F11SP
9,Janssenlei 17,2022-12-10,05:00:00,18,10,8,F11SP
9,Janssenlei 17,2022-12-10,06:00:00,18,10,8,F11SP
9,Janssenlei 17,2022-12-10,07:00:00,12,10,2,F11SP
9,Janssenlei 17,2022-12-10,08:00:00,42,18,24,F11SP
9,Janssenlei 17,2022-12-10,09:00:00,34,18,16,F11SP
9,Janssenlei 17,2022-12-10,10:00:00,54,24,30,F11SP
9,Janssenlei 17,2022-12-10,11:00:00,80,26,54,F11SP
9,Janssenlei 17,2022-12-10,12:00:00,88,52,36,F11SP
9,Janssenlei 17,2022-12-10,13:00:00,96,46,50,F11SP
9,Janssenlei 17,2022-12-10,14:00:00,100,52,48,F11SP
9,Janssenlei 17,2022-12-10,15:00:00,74,44,30,F11SP
9,Janssenlei 17,2022-12-10,16:00:00,54,26,28,F11SP
9,Janssenlei 17,2022-12-10,17:00:00,46,18,28,F11SP
9,Janssenlei 17,2022-12-10,18:00:00,36,16,20,F11SP
9,Janssenlei 17,2022-12-10,19:00:00,32,18,14,F11SP
9,Janssenlei 17,2022-12-10,20:00:00,20,10,10,F11SP
9,Janssenlei 17,2022-12-10,21:00:00,12,2,10,F11SP
9,Janssenlei 17,2022-12-10,22:00:00,40,14,26,F11SP
9,Janssenlei 17,2022-12-10,23:00:00,20,6,14,F11SP
9,Janssenlei 17,2022-12-11,00:00:00,4,2,2,F11SP
9,Janssenlei 17,2022-12-11,01:00:00,10,4,6,F11SP
9,Janssenlei 17,2022-12-11,02:00:00,8,4,4,F11SP
9,Janssenlei 17,2022-12-11,03:00:00,2,2,0,F11SP
9,Janssenlei 17,2022-12-11,04:00:00,4,0,4,F11SP
9,Janssenlei 17,2022-12-11,05:00:00,4,4,0,F11SP
9,Janssenlei 17,2022-12-11,06:00:00,16,10,6,F11SP
9,Janssenlei 17,2022-12-11,07:00:00,10,4,6,F11SP
9,Janssenlei 17,2022-12-11,08:00:00,32,10,22,F11SP
9,Janssenlei 17,2022-12-11,09:00:00,98,42,56,F11SP
9,Janssenlei 17,2022-12-11,10:00:00,102,48,54,F11SP
9,Janssenlei 17,2022-12-11,11:00:00,82,48,34,F11SP
9,Janssenlei 17,2022-12-11,12:00:00,84,54,30,F11SP
9,Janssenlei 17,2022-12-11,13:00:00,116,62,54,F11SP
9,Janssenlei 17,2022-12-11,14:00:00,76,36,40,F11SP
9,Janssenlei 17,2022-12-11,15:00:00,74,26,48,F11SP
9,Janssenlei 17,2022-12-11,16:00:00,66,36,30,F11SP
9,Janssenlei 17,2022-12-11,17:00:00,54,22,32,F11SP
9,Janssenlei 17,2022-12-11,18:00:00,26,12,14,F11SP
9,Janssenlei 17,2022-12-11,19:00:00,22,18,4,F11SP
9,Janssenlei 17,2022-12-11,20:00:00,8,6,2,F11SP
9,Janssenlei 17,2022-12-11,21:00:00,10,2,8,F11SP
9,Janssenlei 17,2022-12-11,22:00:00,22,2,20,F11SP
9,Janssenlei 17,2022-12-11,23:00:00,6,2,4,F11SP
9,Janssenlei 17,2022-12-12,00:00:00,0,0,0,F11SP
9,Janssenlei 17,2022-12-12,01:00:00,0,0,0,F11SP
9,Janssenlei 17,2022-12-12,02:00:00,2,2,0,F11SP
9,Janssenlei 17,2022-12-12,03:00:00,4,4,0,F11SP
9,Janssenlei 17,2022-12-12,04:00:00,10,6,4,F11SP
9,Janssenlei 17,2022-12-12,05:00:00,32,26,6,F11SP
9,Janssenlei 17,2022-12-12,06:00:00,76,52,24,F11SP
9,Janssenlei 17,2022-12-12,07:00:00,288,202,86,F11SP
9,Janssenlei 17,2022-12-12,08:00:00,360,282,78,F11SP
9,Janssenlei 17,2022-12-12,09:00:00,82,40,42,F11SP
9,Janssenlei 17,2022-12-12,10:00:00,72,42,30,F11SP
9,Janssenlei 17,2022-12-12,11:00:00,76,30,46,F11SP
9,Janssenlei 17,2022-12-12,12:00:00,186,80,106,F11SP
9,Janssenlei 17,2022-12-12,13:00:00,110,58,52,F11SP
9,Janssenlei 17,2022-12-12,14:00:00,144,78,66,F11SP
9,Janssenlei 17,2022-12-12,15:00:00,172,64,108,F11SP
9,Janssenlei 17,2022-12-12,16:00:00,226,70,156,F11SP
9,Janssenlei 17,2022-12-12,17:00:00,216,36,180,F11SP
9,Janssenlei 17,2022-12-12,18:00:00,126,34,92,F11SP
9,Janssenlei 17,2022-12-12,19:00:00,46,18,28,F11SP
9,Janssenlei 17,2022-12-12,20:00:00,34,10,24,F11SP
9,Janssenlei 17,2022-12-12,21:00:00,30,4,26,F11SP
9,Janssenlei 17,2022-12-12,22:00:00,42,14,28,F11SP
9,Janssenlei 17,2022-12-12,23:00:00,2,2,0,F11SP
9,Janssenlei 17,2022-12-13,00:00:00,0,0,0,F11SP
9,Janssenlei 17,2022-12-13,01:00:00,10,4,6,F11SP
9,Janssenlei 17,2022-12-13,02:00:00,0,0,0,F11SP
9,Janssenlei 17,2022-12-13,03:00:00,2,2,0,F11SP
9,Janssenlei 17,2022-12-13,04:00:00,8,6,2,F11SP
9,Janssenlei 17,2022-12-13,05:00:00,26,20,6,F11SP
9,Janssenlei 17,2022-12-13,06:00:00,58,42,16,F11SP
9,Janssenlei 17,2022-12-13,07:00:00,246,174,72,F11SP
9,Janssenlei 17,2022-12-13,08:00:00,356,270,86,F11SP
9,Janssenlei 17,2022-12-13,09:00:00,86,48,38,F11SP
9,Janssenlei 17,2022-12-13,10:00:00,118,54,64,F11SP
9,Janssenlei 17,2022-12-13,11:00:00,78,38,40,F11SP
9,Janssenlei 17,2022-12-13,12:00:00,124,66,58,F11SP
9,Janssenlei 17,2022-12-13,13:00:00,124,64,60,F11SP
9,Janssenlei 17,2022-12-13,14:00:00,80,18,62,F11SP
9,Janssenlei 17,2022-12-13,15:00:00,116,42,74,F11SP
9,Janssenlei 17,2022-12-13,16:00:00,260,76,184,F11SP
9,Janssenlei 17,2022-12-13,17:00:00,242,88,154,F11SP
9,Janssenlei 17,2022-12-13,18:00:00,126,34,92,F11SP
9,Janssenlei 17,2022-12-13,19:00:00,44,14,30,F11SP
9,Janssenlei 17,2022-12-13,20:00:00,46,22,24,F11SP
9,Janssenlei 17,2022-12-13,21:00:00,18,8,10,F11SP
9,Janssenlei 17,2022-12-13,22:00:00,50,8,42,F11SP
9,Janssenlei 17,2022-12-13,23:00:00,10,2,8,F11SP
9,Janssenlei 17,2022-12-14,00:00:00,4,2,2,F11SP
9,Janssenlei 17,2022-12-14,01:00:00,0,0,0,F11SP
9,Janssenlei 17,2022-12-14,02:00:00,0,0,0,F11SP
9,Janssenlei 17,2022-12-14,03:00:00,2,2,0,F11SP
9,Janssenlei 17,2022-12-14,04:00:00,8,6,2,F11SP
9,Janssenlei 17,2022-12-14,05:00:00,26,22,4,F11SP
9,Janssenlei 17,2022-12-14,06:00:00,86,54,32,F11SP
9,Janssenlei 17,2022-12-14,07:00:00,220,148,72,F11SP
9,Janssenlei 17,2022-12-14,08:00:00,304,222,82,F11SP
9,Janssenlei 17,2022-12-14,09:00:00,96,56,40,F11SP
9,Janssenlei 17,2022-12-14,10:00:00,136,60,76,F11SP
9,Janssenlei 17,2022-12-14,11:00:00,126,50,76,F11SP
9,Janssenlei 17,2022-12-14,12:00:00,152,60,92,F11SP
9,Janssenlei 17,2022-12-14,13:00:00,158,86,72,F11SP
9,Janssenlei 17,2022-12-14,14:00:00,134,48,86,F11SP
9,Janssenlei 17,2022-12-14,15:00:00,110,50,60,F11SP
9,Janssenlei 17,2022-12-14,16:00:00,172,60,112,F11SP
9,Janssenlei 17,2022-12-14,17:00:00,148,50,98,F11SP
9,Janssenlei 17,2022-12-14,18:00:00,106,40,66,F11SP
9,Janssenlei 17,2022-12-14,19:00:00,40,6,34,F11SP
9,Janssenlei 17,2022-12-14,20:00:00,24,16,8,F11SP
9,Janssenlei 17,2022-12-14,21:00:00,26,12,14,F11SP
9,Janssenlei 17,2022-12-14,22:00:00,40,10,30,F11SP
9,Janssenlei 17,2022-12-14,23:00:00,8,2,6,F11SP
9,Janssenlei 17,2022-12-15,00:00:00,4,0,4,F11SP
9,Janssenlei 17,2022-12-15,01:00:00,0,0,0,F11SP
9,Janssenlei 17,2022-12-15,02:00:00,0,0,0,F11SP
9,Janssenlei 17,2022-12-15,03:00:00,6,6,0,F11SP
9,Janssenlei 17,2022-12-15,04:00:00,14,14,0,F11SP
9,Janssenlei 17,2022-12-15,05:00:00,22,18,4,F11SP
9,Janssenlei 17,2022-12-15,06:00:00,68,48,20,F11SP
9,Janssenlei 17,2022-12-15,07:00:00,216,142,74,F11SP
9,Janssenlei 17,2022-12-15,08:00:00,308,228,80,F11SP
9,Janssenlei 17,2022-12-15,09:00:00,120,70,50,F11SP
9,Janssenlei 17,2022-12-15,10:00:00,70,22,48,F11SP
9,Janssenlei 17,2022-12-15,11:00:00,116,56,60,F11SP
9,Janssenlei 17,2022-12-15,12:00:00,112,56,56,F11SP
9,Janssenlei 17,2022-12-15,13:00:00,140,74,66,F11SP
9,Janssenlei 17,2022-12-15,14:00:00,94,40,54,F11SP
9,Janssenlei 17,2022-12-15,15:00:00,144,52,92,F11SP
9,Janssenlei 17,2022-12-15,16:00:00,182,74,108,F11SP
9,Janssenlei 17,2022-12-15,17:00:00,192,54,138,F11SP
9,Janssenlei 17,2022-12-15,18:00:00,104,36,68,F11SP
9,Janssenlei 17,2022-12-15,19:00:00,36,14,22,F11SP
9,Janssenlei 17,2022-12-15,20:00:00,38,24,14,F11SP
9,Janssenlei 17,2022-12-15,21:00:00,28,6,22,F11SP
9,Janssenlei 17,2022-12-15,22:00:00,40,8,32,F11SP
9,Janssenlei 17,2022-12-15,23:00:00,12,4,8,F11SP
9,Janssenlei 17,2022-12-16,00:00:00,4,0,4,F11SP
9,Janssenlei 17,2022-12-16,01:00:00,0,0,0,F11SP
9,Janssenlei 17,2022-12-16,02:00:00,4,4,0,F11SP
9,Janssenlei 17,2022-12-16,03:00:00,8,6,2,F11SP
9,Janssenlei 17,2022-12-16,04:00:00,4,4,0,F11SP
9,Janssenlei 17,2022-12-16,05:00:00,22,18,4,F11SP
9,Janssenlei 17,2022-12-16,06:00:00,40,22,18,F11SP
9,Janssenlei 17,2022-12-16,07:00:00,184,118,66,F11SP
9,Janssenlei 17,2022-12-16,08:00:00,310,212,98,F11SP
9,Janssenlei 17,2022-12-16,09:00:00,104,52,52,F11SP
9,Janssenlei 17,2022-12-16,10:00:00,102,42,60,F11SP
9,Janssenlei 17,2022-12-16,11:00:00,96,38,58,F11SP
9,Janssenlei 17,2022-12-16,12:00:00,138,54,84,F11SP
9,Janssenlei 17,2022-12-16,13:00:00,140,62,78,F11SP
9,Janssenlei 17,2022-12-16,14:00:00,130,58,72,F11SP
9,Janssenlei 17,2022-12-16,15:00:00,156,78,78,F11SP
9,Janssenlei 17,2022-12-16,16:00:00,156,68,88,F11SP
9,Janssenlei 17,2022-12-16,17:00:00,140,30,110,F11SP
9,Janssenlei 17,2022-12-16,18:00:00,82,26,56,F11SP
9,Janssenlei 17,2022-12-16,19:00:00,56,18,38,F11SP
9,Janssenlei 17,2022-12-16,20:00:00,38,16,22,F11SP
9,Janssenlei 17,2022-12-16,21:00:00,28,6,22,F11SP
9,Janssenlei 17,2022-12-16,22:00:00,16,6,10,F11SP
9,Janssenlei 17,2022-12-16,23:00:00,14,2,12,F11SP
9,Janssenlei 17,2022-12-17,00:00:00,10,4,6,F11SP
9,Janssenlei 17,2022-12-17,01:00:00,24,12,12,F11SP
9,Janssenlei 17,2022-12-17,02:00:00,16,10,6,F11SP
9,Janssenlei 17,2022-12-17,03:00:00,8,0,8,F11SP
9,Janssenlei 17,2022-12-17,04:00:00,2,2,0,F11SP
9,Janssenlei 17,2022-12-17,05:00:00,6,4,2,F11SP
9,Janssenlei 17,2022-12-17,06:00:00,2,0,2,F11SP
9,Janssenlei 17,2022-12-17,07:00:00,10,6,4,F11SP
9,Janssenlei 17,2022-12-17,08:00:00,28,10,18,F11SP
9,Janssenlei 17,2022-12-17,09:00:00,46,22,24,F11SP
9,Janssenlei 17,2022-12-17,10:00:00,34,16,18,F11SP
9,Janssenlei 17,2022-12-17,11:00:00,66,28,38,F11SP
9,Janssenlei 17,2022-12-17,12:00:00,76,36,40,F11SP
9,Janssenlei 17,2022-12-17,13:00:00,88,28,60,F11SP
9,Janssenlei 17,2022-12-17,14:00:00,76,30,46,F11SP
9,Janssenlei 17,2022-12-17,15:00:00,70,38,32,F11SP
9,Janssenlei 17,2022-12-17,16:00:00,38,24,14,F11SP
9,Janssenlei 17,2022-12-17,17:00:00,64,38,26,F11SP
9,Janssenlei 17,2022-12-17,18:00:00,48,20,28,F11SP
9,Janssenlei 17,2022-12-17,19:00:00,28,14,14,F11SP
9,Janssenlei 17,2022-12-17,20:00:00,32,20,12,F11SP
9,Janssenlei 17,2022-12-17,21:00:00,6,2,4,F11SP
9,Janssenlei 17,2022-12-17,22:00:00,12,6,6,F11SP
9,Janssenlei 17,2022-12-17,23:00:00,14,10,4,F11SP
9,Janssenlei 17,2022-12-18,00:00:00,12,6,6,F11SP
9,Janssenlei 17,2022-12-18,01:00:00,14,2,12,F11SP
9,Janssenlei 17,2022-12-18,02:00:00,4,4,0,F11SP
9,Janssenlei 17,2022-12-18,03:00:00,6,0,6,F11SP
9,Janssenlei 17,2022-12-18,04:00:00,4,2,2,F11SP
9,Janssenlei 17,2022-12-18,05:00:00,10,8,2,F11SP
9,Janssenlei 17,2022-12-18,06:00:00,6,2,4,F11SP
9,Janssenlei 17,2022-12-18,07:00:00,2,0,2,F11SP
9,Janssenlei 17,2022-12-18,08:00:00,18,8,10,F11SP
9,Janssenlei 17,2022-12-18,09:00:00,60,30,30,F11SP
9,Janssenlei 17,2022-12-18,10:00:00,46,14,32,F11SP
9,Janssenlei 17,2022-12-18,11:00:00,60,28,32,F11SP
9,Janssenlei 17,2022-12-18,12:00:00,88,46,42,F11SP
9,Janssenlei 17,2022-12-18,13:00:00,76,42,34,F11SP
9,Janssenlei 17,2022-12-18,14:00:00,46,20,26,F11SP
9,Janssenlei 17,2022-12-18,15:00:00,66,40,26,F11SP
9,Janssenlei 17,2022-12-18,16:00:00,42,18,24,F11SP
9,Janssenlei 17,2022-12-18,17:00:00,26,18,8,F11SP
9,Janssenlei 17,2022-12-18,18:00:00,22,6,16,F11SP
9,Janssenlei 17,2022-12-18,19:00:00,14,4,10,F11SP
9,Janssenlei 17,2022-12-18,20:00:00,6,2,4,F11SP
9,Janssenlei 17,2022-12-18,21:00:00,6,4,2,F11SP
9,Janssenlei 17,2022-12-18,22:00:00,8,4,4,F11SP
9,Janssenlei 17,2022-12-18,23:00:00,12,8,4,F11SP
9,Janssenlei 17,2022-12-23,00:00:00,14,4,10,F11SP
9,Janssenlei 17,2022-12-23,01:00:00,6,2,4,F11SP
9,Janssenlei 17,2022-12-23,02:00:00,4,2,2,F11SP
9,Janssenlei 17,2022-12-23,03:00:00,2,2,0,F11SP
9,Janssenlei 17,2022-12-23,04:00:00,4,2,2,F11SP
9,Janssenlei 17,2022-12-23,05:00:00,26,22,4,F11SP
9,Janssenlei 17,2022-12-23,06:00:00,38,22,16,F11SP
9,Janssenlei 17,2022-12-23,07:00:00,132,82,50,F11SP
9,Janssenlei 17,2022-12-23,08:00:00,274,204,70,F11SP
9,Janssenlei 17,2022-12-23,09:00:00,118,56,62,F11SP
9,Janssenlei 17,2022-12-23,10:00:00,106,34,72,F11SP
9,Janssenlei 17,2022-12-23,11:00:00,90,60,30,F11SP
9,Janssenlei 17,2022-12-23,12:00:00,52,34,18,F11SP
9,Janssenlei 17,2022-12-23,13:00:00,56,24,32,F11SP
9,Janssenlei 17,2022-12-23,14:00:00,86,34,52,F11SP
9,Janssenlei 17,2022-12-23,15:00:00,126,42,84,F11SP
9,Janssenlei 17,2022-12-23,16:00:00,134,36,98,F11SP
9,Janssenlei 17,2022-12-23,17:00:00,108,42,66,F11SP
9,Janssenlei 17,2022-12-23,18:00:00,90,40,50,F11SP
9,Janssenlei 17,2022-12-23,19:00:00,30,8,22,F11SP
9,Janssenlei 17,2022-12-23,20:00:00,14,6,8,F11SP
9,Janssenlei 17,2022-12-23,21:00:00,22,10,12,F11SP
9,Janssenlei 17,2022-12-23,22:00:00,26,8,18,F11SP
9,Janssenlei 17,2022-12-23,23:00:00,16,4,12,F11SP
9,Janssenlei 17,2022-12-24,00:00:00,10,2,8,F11SP
9,Janssenlei 17,2022-12-24,01:00:00,16,10,6,F11SP
9,Janssenlei 17,2022-12-24,02:00:00,12,6,6,F11SP
9,Janssenlei 17,2022-12-24,03:00:00,0,0,0,F11SP
9,Janssenlei 17,2022-12-24,04:00:00,12,6,6,F11SP
9,Janssenlei 17,2022-12-24,05:00:00,2,2,0,F11SP
9,Janssenlei 17,2022-12-24,06:00:00,6,0,6,F11SP
9,Janssenlei 17,2022-12-24,07:00:00,20,12,8,F11SP
9,Janssenlei 17,2022-12-24,08:00:00,48,22,26,F11SP
9,Janssenlei 17,2022-12-24,09:00:00,78,30,48,F11SP
9,Janssenlei 17,2022-12-24,10:00:00,140,44,96,F11SP
9,Janssenlei 17,2022-12-24,11:00:00,140,64,76,F11SP
9,Janssenlei 17,2022-12-24,12:00:00,186,126,60,F11SP
9,Janssenlei 17,2022-12-24,13:00:00,156,104,52,F11SP
9,Janssenlei 17,2022-12-24,14:00:00,140,64,76,F11SP
9,Janssenlei 17,2022-12-24,15:00:00,132,82,50,F11SP
9,Janssenlei 17,2022-12-24,16:00:00,96,42,54,F11SP
9,Janssenlei 17,2022-12-24,17:00:00,54,28,26,F11SP
9,Janssenlei 17,2022-12-24,18:00:00,12,4,8,F11SP
9,Janssenlei 17,2022-12-24,19:00:00,6,2,4,F11SP
9,Janssenlei 17,2022-12-24,20:00:00,6,4,2,F11SP
9,Janssenlei 17,2022-12-24,21:00:00,10,2,8,F11SP
9,Janssenlei 17,2022-12-24,22:00:00,10,6,4,F11SP
9,Janssenlei 17,2022-12-24,23:00:00,16,8,8,F11SP
9,Janssenlei 17,2022-12-25,00:00:00,16,2,14,F11SP
9,Janssenlei 17,2022-12-25,01:00:00,16,4,12,F11SP
9,Janssenlei 17,2022-12-25,02:00:00,4,4,0,F11SP
9,Janssenlei 17,2022-12-25,03:00:00,4,0,4,F11SP
9,Janssenlei 17,2022-12-25,04:00:00,6,4,2,F11SP
9,Janssenlei 17,2022-12-25,05:00:00,8,6,2,F11SP
9,Janssenlei 17,2022-12-25,06:00:00,10,6,4,F11SP
9,Janssenlei 17,2022-12-25,07:00:00,14,6,8,F11SP
9,Janssenlei 17,2022-12-25,08:00:00,22,14,8,F11SP
9,Janssenlei 17,2022-12-25,09:00:00,28,14,14,F11SP
9,Janssenlei 17,2022-12-25,10:00:00,40,20,20,F11SP
9,Janssenlei 17,2022-12-25,11:00:00,56,32,24,F11SP
9,Janssenlei 17,2022-12-25,12:00:00,34,14,20,F11SP
9,Janssenlei 17,2022-12-25,13:00:00,32,14,18,F11SP
9,Janssenlei 17,2022-12-25,14:00:00,30,10,20,F11SP
9,Janssenlei 17,2022-12-25,15:00:00,30,8,22,F11SP
9,Janssenlei 17,2022-12-25,16:00:00,24,16,8,F11SP
9,Janssenlei 17,2022-12-25,17:00:00,6,4,2,F11SP
9,Janssenlei 17,2022-12-25,18:00:00,12,4,8,F11SP
9,Janssenlei 17,2022-12-25,19:00:00,8,6,2,F11SP
9,Janssenlei 17,2022-12-25,20:00:00,6,6,0,F11SP
9,Janssenlei 17,2022-12-25,21:00:00,8,4,4,F11SP
9,Janssenlei 17,2022-12-25,22:00:00,12,6,6,F11SP
9,Janssenlei 17,2022-12-25,23:00:00,18,14,4,F11SP
9,Janssenlei 17,2022-12-26,00:00:00,2,0,2,F11SP
9,Janssenlei 17,2022-12-26,01:00:00,2,2,0,F11SP
9,Janssenlei 17,2022-12-26,02:00:00,2,0,2,F11SP
9,Janssenlei 17,2022-12-26,03:00:00,22,8,14,F11SP
9,Janssenlei 17,2022-12-26,04:00:00,6,4,2,F11SP
9,Janssenlei 17,2022-12-26,05:00:00,4,0,4,F11SP
9,Janssenlei 17,2022-12-26,06:00:00,16,10,6,F11SP
9,Janssenlei 17,2022-12-26,07:00:00,58,38,20,F11SP
9,Janssenlei 17,2022-12-26,08:00:00,46,36,10,F11SP
9,Janssenlei 17,2022-12-26,09:00:00,56,32,24,F11SP
9,Janssenlei 17,2022-12-26,10:00:00,64,30,34,F11SP
9,Janssenlei 17,2022-12-26,11:00:00,62,32,30,F11SP
9,Janssenlei 17,2022-12-26,12:00:00,76,30,46,F11SP
9,Janssenlei 17,2022-12-26,13:00:00,120,76,44,F11SP
9,Janssenlei 17,2022-12-26,14:00:00,100,40,60,F11SP
9,Janssenlei 17,2022-12-26,15:00:00,114,48,66,F11SP
9,Janssenlei 17,2022-12-26,16:00:00,180,98,82,F11SP
9,Janssenlei 17,2022-12-26,17:00:00,72,42,30,F11SP
9,Janssenlei 17,2022-12-26,18:00:00,54,22,32,F11SP
9,Janssenlei 17,2022-12-26,19:00:00,28,14,14,F11SP
9,Janssenlei 17,2022-12-26,20:00:00,18,12,6,F11SP
9,Janssenlei 17,2022-12-26,21:00:00,20,10,10,F11SP
9,Janssenlei 17,2022-12-26,22:00:00,16,2,14,F11SP
9,Janssenlei 17,2022-12-26,23:00:00,10,2,8,F11SP
9,Janssenlei 17,2022-12-27,00:00:00,6,2,4,F11SP
9,Janssenlei 17,2022-12-27,01:00:00,4,4,0,F11SP
9,Janssenlei 17,2022-12-27,02:00:00,2,0,2,F11SP
9,Janssenlei 17,2022-12-27,03:00:00,2,0,2,F11SP
9,Janssenlei 17,2022-12-27,04:00:00,8,6,2,F11SP
9,Janssenlei 17,2022-12-27,05:00:00,10,6,4,F11SP
9,Janssenlei 17,2022-12-27,06:00:00,32,18,14,F11SP
9,Janssenlei 17,2022-12-27,07:00:00,72,44,28,F11SP
9,Janssenlei 17,2022-12-27,08:00:00,82,56,26,F11SP
9,Janssenlei 17,2022-12-27,09:00:00,114,42,72,F11SP
9,Janssenlei 17,2022-12-27,10:00:00,114,52,62,F11SP
9,Janssenlei 17,2022-12-27,11:00:00,176,86,90,F11SP
9,Janssenlei 17,2022-12-27,12:00:00,162,90,72,F11SP
9,Janssenlei 17,2022-12-27,13:00:00,126,58,68,F11SP
9,Janssenlei 17,2022-12-27,14:00:00,172,94,78,F11SP
9,Janssenlei 17,2022-12-27,15:00:00,130,64,66,F11SP
9,Janssenlei 17,2022-12-27,16:00:00,192,104,88,F11SP
9,Janssenlei 17,2022-12-27,17:00:00,120,58,62,F11SP
9,Janssenlei 17,2022-12-27,18:00:00,70,32,38,F11SP
9,Janssenlei 17,2022-12-27,19:00:00,46,16,30,F11SP
9,Janssenlei 17,2022-12-27,20:00:00,24,16,8,F11SP
9,Janssenlei 17,2022-12-27,21:00:00,20,6,14,F11SP
9,Janssenlei 17,2022-12-27,22:00:00,30,4,26,F11SP
9,Janssenlei 17,2022-12-27,23:00:00,14,0,14,F11SP
9,Janssenlei 17,2022-12-28,00:00:00,22,12,10,F11SP
9,Janssenlei 17,2022-12-28,01:00:00,6,0,6,F11SP
9,Janssenlei 17,2022-12-28,02:00:00,8,6,2,F11SP
9,Janssenlei 17,2022-12-28,03:00:00,2,2,0,F11SP
9,Janssenlei 17,2022-12-28,04:00:00,6,6,0,F11SP
9,Janssenlei 17,2022-12-28,05:00:00,18,10,8,F11SP
9,Janssenlei 17,2022-12-28,06:00:00,26,12,14,F11SP
9,Janssenlei 17,2022-12-28,07:00:00,70,42,28,F11SP
9,Janssenlei 17,2022-12-28,08:00:00,66,36,30,F11SP
9,Janssenlei 17,2022-12-28,09:00:00,100,42,58,F11SP
9,Janssenlei 17,2022-12-28,10:00:00,64,38,26,F11SP
9,Janssenlei 17,2022-12-28,11:00:00,66,34,32,F11SP
9,Janssenlei 17,2022-12-28,12:00:00,64,44,20,F11SP
9,Janssenlei 17,2022-12-28,13:00:00,74,48,26,F11SP
9,Janssenlei 17,2022-12-28,14:00:00,54,32,22,F11SP
9,Janssenlei 17,2022-12-28,15:00:00,82,30,52,F11SP
9,Janssenlei 17,2022-12-28,16:00:00,76,24,52,F11SP
9,Janssenlei 17,2022-12-28,17:00:00,68,34,34,F11SP
9,Janssenlei 17,2022-12-28,18:00:00,30,12,18,F11SP
9,Janssenlei 17,2022-12-28,19:00:00,24,4,20,F11SP
9,Janssenlei 17,2022-12-28,20:00:00,20,10,10,F11SP
9,Janssenlei 17,2022-12-28,21:00:00,10,2,8,F11SP
9,Janssenlei 17,2022-12-28,22:00:00,30,10,20,F11SP
9,Janssenlei 17,2022-12-28,23:00:00,12,2,10,F11SP
9,Janssenlei 17,2022-12-29,00:00:00,8,2,6,F11SP
9,Janssenlei 17,2022-12-29,01:00:00,2,0,2,F11SP
9,Janssenlei 17,2022-12-29,02:00:00,0,0,0,F11SP
9,Janssenlei 17,2022-12-29,03:00:00,2,2,0,F11SP
9,Janssenlei 17,2022-12-29,04:00:00,6,6,0,F11SP
9,Janssenlei 17,2022-12-29,05:00:00,10,4,6,F11SP
9,Janssenlei 17,2022-12-29,06:00:00,20,14,6,F11SP
9,Janssenlei 17,2022-12-29,07:00:00,48,28,20,F11SP
9,Janssenlei 17,2022-12-29,08:00:00,76,44,32,F11SP
9,Janssenlei 17,2022-12-29,09:00:00,78,40,38,F11SP
9,Janssenlei 17,2022-12-29,10:00:00,68,36,32,F11SP
9,Janssenlei 17,2022-12-29,11:00:00,60,32,28,F11SP
9,Janssenlei 17,2022-12-29,12:00:00,66,38,28,F11SP
9,Janssenlei 17,2022-12-29,13:00:00,52,20,32,F11SP
9,Janssenlei 17,2022-12-29,14:00:00,40,22,18,F11SP
9,Janssenlei 17,2022-12-29,15:00:00,68,34,34,F11SP
9,Janssenlei 17,2022-12-29,16:00:00,112,46,66,F11SP
9,Janssenlei 17,2022-12-29,17:00:00,94,32,62,F11SP
9,Janssenlei 17,2022-12-29,18:00:00,56,26,30,F11SP
9,Janssenlei 17,2022-12-29,19:00:00,42,22,20,F11SP
9,Janssenlei 17,2022-12-29,20:00:00,24,6,18,F11SP
9,Janssenlei 17,2022-12-29,21:00:00,18,12,6,F11SP
9,Janssenlei 17,2022-12-29,22:00:00,16,6,10,F11SP
9,Janssenlei 17,2022-12-29,23:00:00,20,4,16,F11SP
9,Janssenlei 17,2022-12-30,00:00:00,16,14,2,F11SP
9,Janssenlei 17,2022-12-30,01:00:00,8,0,8,F11SP
9,Janssenlei 17,2022-12-30,02:00:00,2,2,0,F11SP
9,Janssenlei 17,2022-12-30,03:00:00,0,0,0,F11SP
9,Janssenlei 17,2022-12-30,04:00:00,6,6,0,F11SP
9,Janssenlei 17,2022-12-30,05:00:00,12,4,8,F11SP
9,Janssenlei 17,2022-12-30,06:00:00,20,10,10,F11SP
9,Janssenlei 17,2022-12-30,07:00:00,52,32,20,F11SP
9,Janssenlei 17,2022-12-30,08:00:00,58,28,30,F11SP
9,Janssenlei 17,2022-12-30,09:00:00,82,32,50,F11SP
9,Janssenlei 17,2022-12-30,10:00:00,90,44,46,F11SP
9,Janssenlei 17,2022-12-30,11:00:00,110,64,46,F11SP
9,Janssenlei 17,2022-12-30,12:00:00,58,40,18,F11SP
9,Janssenlei 17,2022-12-30,13:00:00,30,16,14,F11SP
9,Janssenlei 17,2022-12-30,14:00:00,32,16,16,F11SP
9,Janssenlei 17,2022-12-30,15:00:00,68,30,38,F11SP
9,Janssenlei 17,2022-12-30,16:00:00,48,24,24,F11SP
9,Janssenlei 17,2022-12-30,17:00:00,46,16,30,F11SP
9,Janssenlei 17,2022-12-30,18:00:00,38,24,14,F11SP
9,Janssenlei 17,2022-12-30,19:00:00,18,8,10,F11SP
9,Janssenlei 17,2022-12-30,20:00:00,26,16,10,F11SP
9,Janssenlei 17,2022-12-30,21:00:00,14,4,10,F11SP
9,Janssenlei 17,2022-12-30,22:00:00,18,8,10,F11SP
9,Janssenlei 17,2022-12-30,23:00:00,10,2,8,F11SP
9,Janssenlei 17,2022-12-31,00:00:00,16,4,12,F11SP
9,Janssenlei 17,2022-12-31,01:00:00,2,2,0,F11SP
9,Janssenlei 17,2022-12-31,02:00:00,2,0,2,F11SP
9,Janssenlei 17,2022-12-31,03:00:00,0,0,0,F11SP
9,Janssenlei 17,2022-12-31,04:00:00,10,8,2,F11SP
9,Janssenlei 17,2022-12-31,05:00:00,4,0,4,F11SP
9,Janssenlei 17,2022-12-31,06:00:00,10,2,8,F11SP
9,Janssenlei 17,2022-12-31,07:00:00,12,6,6,F11SP
9,Janssenlei 17,2022-12-31,08:00:00,26,16,10,F11SP
9,Janssenlei 17,2022-12-31,09:00:00,20,6,14,F11SP
9,Janssenlei 17,2022-12-31,10:00:00,50,22,28,F11SP
9,Janssenlei 17,2022-12-31,11:00:00,34,18,16,F11SP
9,Janssenlei 17,2022-12-31,12:00:00,52,24,28,F11SP
9,Janssenlei 17,2022-12-31,13:00:00,46,34,12,F11SP
9,Janssenlei 17,2022-12-31,14:00:00,72,32,40,F11SP
9,Janssenlei 17,2022-12-31,15:00:00,102,48,54,F11SP
9,Janssenlei 17,2022-12-31,16:00:00,52,28,24,F11SP
9,Janssenlei 17,2022-12-31,17:00:00,56,32,24,F11SP
9,Janssenlei 17,2022-12-31,18:00:00,64,42,22,F11SP
9,Janssenlei 17,2022-12-31,19:00:00,34,6,28,F11SP
9,Janssenlei 17,2022-12-31,20:00:00,14,10,4,F11SP
9,Janssenlei 17,2022-12-31,21:00:00,8,6,2,F11SP
9,Janssenlei 17,2022-12-31,22:00:00,16,12,4,F11SP
9,Janssenlei 17,2022-12-31,23:00:00,42,12,30,F11SP
9,Janssenlei 17,2023-01-01,00:00:00,44,32,12,F11SP
9,Janssenlei 17,2023-01-01,01:00:00,44,24,20,F11SP
9,Janssenlei 17,2023-01-01,02:00:00,28,16,12,F11SP
9,Janssenlei 17,2023-01-01,03:00:00,24,10,14,F11SP
9,Janssenlei 17,2023-01-01,04:00:00,14,8,6,F11SP
9,Janssenlei 17,2023-01-01,05:00:00,2,0,2,F11SP
9,Janssenlei 17,2023-01-01,06:00:00,20,0,20,F11SP
9,Janssenlei 17,2023-01-01,07:00:00,6,2,4,F11SP
9,Janssenlei 17,2023-01-01,08:00:00,28,16,12,F11SP
9,Janssenlei 17,2023-01-01,09:00:00,22,6,16,F11SP
9,Janssenlei 17,2023-01-01,10:00:00,78,26,52,F11SP
9,Janssenlei 17,2023-01-01,11:00:00,86,36,50,F11SP
9,Janssenlei 17,2023-01-01,12:00:00,130,50,80,F11SP
9,Janssenlei 17,2023-01-01,13:00:00,130,60,70,F11SP
9,Janssenlei 17,2023-01-01,14:00:00,154,78,76,F11SP
9,Janssenlei 17,2023-01-01,15:00:00,72,36,36,F11SP
9,Janssenlei 17,2023-01-01,16:00:00,66,34,32,F11SP
9,Janssenlei 17,2023-01-01,17:00:00,30,16,14,F11SP
9,Janssenlei 17,2023-01-01,18:00:00,20,12,8,F11SP
9,Janssenlei 17,2023-01-01,19:00:00,6,2,4,F11SP
9,Janssenlei 17,2023-01-01,20:00:00,18,8,10,F11SP
9,Janssenlei 17,2023-01-01,21:00:00,4,0,4,F11SP
9,Janssenlei 17,2023-01-01,22:00:00,12,10,2,F11SP
9,Janssenlei 17,2023-01-01,23:00:00,0,0,0,F11SP
9,Janssenlei 17,2023-01-02,00:00:00,6,2,4,F11SP
9,Janssenlei 17,2023-01-02,01:00:00,0,0,0,F11SP
9,Janssenlei 17,2023-01-02,02:00:00,0,0,0,F11SP
9,Janssenlei 17,2023-01-02,03:00:00,0,0,0,F11SP
9,Janssenlei 17,2023-01-02,04:00:00,6,6,0,F11SP
9,Janssenlei 17,2023-01-02,05:00:00,12,8,4,F11SP
9,Janssenlei 17,2023-01-02,06:00:00,16,14,2,F11SP
9,Janssenlei 17,2023-01-02,07:00:00,66,50,16,F11SP
9,Janssenlei 17,2023-01-02,08:00:00,76,46,30,F11SP
9,Janssenlei 17,2023-01-02,09:00:00,22,8,14,F11SP
9,Janssenlei 17,2023-01-02,10:00:00,40,18,22,F11SP
9,Janssenlei 17,2023-01-02,11:00:00,60,36,24,F11SP
9,Janssenlei 17,2023-01-02,12:00:00,60,26,34,F11SP
9,Janssenlei 17,2023-01-02,13:00:00,78,34,44,F11SP
9,Janssenlei 17,2023-01-02,14:00:00,72,34,38,F11SP
9,Janssenlei 17,2023-01-02,15:00:00,74,34,40,F11SP
9,Janssenlei 17,2023-01-02,16:00:00,90,30,60,F11SP
9,Janssenlei 17,2023-01-02,17:00:00,12,0,12,F11SP
9,Janssenlei 17,2023-01-02,18:00:00,2,0,2,F11SP
9,Janssenlei 17,2023-01-02,19:00:00,2,0,2,F11SP
9,Janssenlei 17,2023-01-02,20:00:00,0,0,0,F11SP
9,Janssenlei 17,2023-01-02,21:00:00,4,2,2,F11SP
9,Janssenlei 17,2023-01-02,22:00:00,2,0,2,F11SP
9,Janssenlei 17,2023-01-02,23:00:00,0,0,0,F11SP
9,Janssenlei 17,2023-01-03,00:00:00,0,0,0,F11SP
9,Janssenlei 17,2023-01-03,01:00:00,0,0,0,F11SP
9,Janssenlei 17,2023-01-03,02:00:00,0,0,0,F11SP
9,Janssenlei 17,2023-01-03,03:00:00,0,0,0,F11SP
9,Janssenlei 17,2023-01-03,04:00:00,0,0,0,F11SP
9,Janssenlei 17,2023-01-03,05:00:00,2,0,2,F11SP
9,Janssenlei 17,2023-01-03,06:00:00,2,0,2,F11SP
9,Janssenlei 17,2023-01-03,07:00:00,4,2,2,F11SP
9,Janssenlei 17,2023-01-03,08:00:00,6,2,4,F11SP
9,Janssenlei 17,2023-01-03,09:00:00,2,0,2,F11SP
9,Janssenlei 17,2023-01-03,10:00:00,6,4,2,F11SP
9,Janssenlei 17,2023-01-03,11:00:00,10,6,4,F11SP
9,Janssenlei 17,2023-01-03,12:00:00,6,2,4,F11SP
9,Janssenlei 17,2023-01-03,13:00:00,4,2,2,F11SP
9,Janssenlei 17,2023-01-03,14:00:00,10,4,6,F11SP
9,Janssenlei 17,2023-01-03,15:00:00,4,4,0,F11SP
9,Janssenlei 17,2023-01-03,16:00:00,10,6,4,F11SP
9,Janssenlei 17,2023-01-03,17:00:00,6,0,6,F11SP
9,Janssenlei 17,2023-01-03,18:00:00,2,0,2,F11SP
9,Janssenlei 17,2023-01-03,19:00:00,2,0,2,F11SP
9,Janssenlei 17,2023-01-03,20:00:00,0,0,0,F11SP
9,Janssenlei 17,2023-01-03,21:00:00,2,0,2,F11SP
9,Janssenlei 17,2023-01-03,22:00:00,0,0,0,F11SP
9,Janssenlei 17,2023-01-03,23:00:00,0,0,0,F11SP
9,Janssenlei 17,2023-01-04,00:00:00,0,0,0,F11SP
9,Janssenlei 17,2023-01-04,01:00:00,0,0,0,F11SP
9,Janssenlei 17,2023-01-04,02:00:00,0,0,0,F11SP
9,Janssenlei 17,2023-01-04,03:00:00,0,0,0,F11SP
9,Janssenlei 17,2023-01-04,04:00:00,0,0,0,F11SP
9,Janssenlei 17,2023-01-04,05:00:00,4,0,4,F11SP
9,Janssenlei 17,2023-01-04,06:00:00,0,0,0,F11SP
9,Janssenlei 17,2023-01-04,07:00:00,10,6,4,F11SP
9,Janssenlei 17,2023-01-04,08:00:00,6,2,4,F11SP
9,Janssenlei 17,2023-01-04,09:00:00,0,0,0,F11SP
9,Janssenlei 17,2023-01-04,10:00:00,2,0,2,F11SP
9,Janssenlei 17,2023-01-04,11:00:00,2,0,2,F11SP
9,Janssenlei 17,2023-01-04,12:00:00,2,0,2,F11SP
9,Janssenlei 17,2023-01-04,13:00:00,0,0,0,F11SP
9,Janssenlei 17,2023-01-04,14:00:00,10,4,6,F11SP
9,Janssenlei 17,2023-01-04,15:00:00,2,0,2,F11SP
9,Janssenlei 17,2023-01-04,16:00:00,4,2,2,F11SP
9,Janssenlei 17,2023-01-04,17:00:00,4,0,4,F11SP
9,Janssenlei 17,2023-01-04,18:00:00,4,0,4,F11SP
9,Janssenlei 17,2023-01-04,19:00:00,0,0,0,F11SP
9,Janssenlei 17,2023-01-04,20:00:00,2,0,2,F11SP
9,Janssenlei 17,2023-01-04,21:00:00,2,2,0,F11SP
9,Janssenlei 17,2023-01-04,22:00:00,0,0,0,F11SP
9,Janssenlei 17,2023-01-04,23:00:00,0,0,0,F11SP
9,Janssenlei 17,2023-01-05,00:00:00,0,0,0,F11SP
9,Janssenlei 17,2023-01-05,01:00:00,0,0,0,F11SP
9,Janssenlei 17,2023-01-05,02:00:00,0,0,0,F11SP
9,Janssenlei 17,2023-01-05,03:00:00,0,0,0,F11SP
9,Janssenlei 17,2023-01-05,04:00:00,0,0,0,F11SP
9,Janssenlei 17,2023-01-05,05:00:00,4,0,4,F11SP
9,Janssenlei 17,2023-01-05,06:00:00,0,0,0,F11SP
9,Janssenlei 17,2023-01-05,07:00:00,0,0,0,F11SP
9,Janssenlei 17,2023-01-05,08:00:00,2,2,0,F11SP
9,Janssenlei 17,2023-01-05,09:00:00,2,0,2,F11SP
9,Janssenlei 17,2023-01-05,10:00:00,0,0,0,F11SP
9,Janssenlei 17,2023-01-05,11:00:00,2,2,0,F11SP
9,Janssenlei 17,2023-01-05,12:00:00,6,4,2,F11SP
9,Janssenlei 17,2023-01-05,13:00:00,2,0,2,F11SP
9,Janssenlei 17,2023-01-05,14:00:00,2,2,0,F11SP
9,Janssenlei 17,2023-01-05,15:00:00,4,0,4,F11SP
9,Janssenlei 17,2023-01-05,16:00:00,4,0,4,F11SP
9,Janssenlei 17,2023-01-05,17:00:00,2,0,2,F11SP
9,Janssenlei 17,2023-01-05,18:00:00,2,0,2,F11SP
9,Janssenlei 17,2023-01-05,19:00:00,0,0,0,F11SP
9,Janssenlei 17,2023-01-05,20:00:00,6,2,4,F11SP
9,Janssenlei 17,2023-01-05,21:00:00,0,0,0,F11SP
9,Janssenlei 17,2023-01-05,22:00:00,4,2,2,F11SP
9,Janssenlei 17,2023-01-05,23:00:00,0,0,0,F11SP
9,Janssenlei 17,2023-01-06,00:00:00,2,2,0,F11SP
9,Janssenlei 17,2023-01-06,01:00:00,0,0,0,F11SP
9,Janssenlei 17,2023-01-06,02:00:00,0,0,0,F11SP
9,Janssenlei 17,2023-01-06,03:00:00,0,0,0,F11SP
9,Janssenlei 17,2023-01-06,04:00:00,0,0,0,F11SP
9,Janssenlei 17,2023-01-06,05:00:00,2,0,2,F11SP
9,Janssenlei 17,2023-01-06,06:00:00,2,0,2,F11SP
9,Janssenlei 17,2023-01-06,07:00:00,2,0,2,F11SP
9,Janssenlei 17,2023-01-06,08:00:00,0,0,0,F11SP
9,Janssenlei 17,2023-01-06,09:00:00,0,0,0,F11SP
9,Janssenlei 17,2023-01-06,10:00:00,4,2,2,F11SP
9,Janssenlei 17,2023-01-06,11:00:00,8,4,4,F11SP
9,Janssenlei 17,2023-01-06,12:00:00,56,30,26,F11SP
9,Janssenlei 17,2023-01-06,13:00:00,148,76,72,F11SP
9,Janssenlei 17,2023-01-06,14:00:00,148,46,102,F11SP
9,Janssenlei 17,2023-01-06,15:00:00,138,56,82,F11SP
9,Janssenlei 17,2023-01-06,16:00:00,192,98,94,F11SP
9,Janssenlei 17,2023-01-06,17:00:00,184,78,106,F11SP
9,Janssenlei 17,2023-01-06,18:00:00,82,40,42,F11SP
9,Janssenlei 17,2023-01-06,19:00:00,36,18,18,F11SP
9,Janssenlei 17,2023-01-06,20:00:00,42,22,20,F11SP
9,Janssenlei 17,2023-01-06,21:00:00,6,0,6,F11SP
9,Janssenlei 17,2023-01-06,22:00:00,24,4,20,F11SP
9,Janssenlei 17,2023-01-06,23:00:00,16,4,12,F11SP
9,Janssenlei 17,2023-01-07,00:00:00,12,0,12,F11SP
9,Janssenlei 17,2023-01-07,01:00:00,20,10,10,F11SP
9,Janssenlei 17,2023-01-07,02:00:00,14,4,10,F11SP
9,Janssenlei 17,2023-01-07,03:00:00,8,0,8,F11SP
9,Janssenlei 17,2023-01-07,04:00:00,6,6,0,F11SP
9,Janssenlei 17,2023-01-07,05:00:00,10,8,2,F11SP
9,Janssenlei 17,2023-01-07,06:00:00,12,4,8,F11SP
9,Janssenlei 17,2023-01-07,07:00:00,18,12,6,F11SP
9,Janssenlei 17,2023-01-07,08:00:00,36,18,18,F11SP
9,Janssenlei 17,2023-01-07,09:00:00,74,20,54,F11SP
9,Janssenlei 17,2023-01-07,10:00:00,198,54,144,F11SP
9,Janssenlei 17,2023-01-07,11:00:00,190,100,90,F11SP
9,Janssenlei 17,2023-01-07,12:00:00,240,152,88,F11SP
9,Janssenlei 17,2023-01-07,13:00:00,164,92,72,F11SP
9,Janssenlei 17,2023-01-07,14:00:00,200,94,106,F11SP
9,Janssenlei 17,2023-01-07,15:00:00,124,78,46,F11SP
9,Janssenlei 17,2023-01-07,16:00:00,98,60,38,F11SP
9,Janssenlei 17,2023-01-07,17:00:00,48,26,22,F11SP
9,Janssenlei 17,2023-01-07,18:00:00,48,22,26,F11SP
9,Janssenlei 17,2023-01-07,19:00:00,30,16,14,F11SP
9,Janssenlei 17,2023-01-07,20:00:00,30,16,14,F11SP
9,Janssenlei 17,2023-01-07,21:00:00,14,6,8,F11SP
9,Janssenlei 17,2023-01-07,22:00:00,12,0,12,F11SP
9,Janssenlei 17,2023-01-07,23:00:00,8,6,2,F11SP
9,Janssenlei 17,2023-01-08,00:00:00,8,6,2,F11SP
9,Janssenlei 17,2023-01-08,01:00:00,18,14,4,F11SP
9,Janssenlei 17,2023-01-08,02:00:00,18,6,12,F11SP
9,Janssenlei 17,2023-01-08,03:00:00,4,0,4,F11SP
9,Janssenlei 17,2023-01-08,04:00:00,12,4,8,F11SP
9,Janssenlei 17,2023-01-08,05:00:00,8,4,4,F11SP
9,Janssenlei 17,2023-01-08,06:00:00,4,4,0,F11SP
9,Janssenlei 17,2023-01-08,07:00:00,22,12,10,F11SP
9,Janssenlei 17,2023-01-08,08:00:00,34,12,22,F11SP
9,Janssenlei 17,2023-01-08,09:00:00,128,36,92,F11SP
9,Janssenlei 17,2023-01-08,10:00:00,200,90,110,F11SP
9,Janssenlei 17,2023-01-08,11:00:00,272,134,138,F11SP
9,Janssenlei 17,2023-01-08,12:00:00,232,130,102,F11SP
9,Janssenlei 17,2023-01-08,13:00:00,234,132,102,F11SP
9,Janssenlei 17,2023-01-08,14:00:00,228,104,124,F11SP
9,Janssenlei 17,2023-01-08,15:00:00,184,90,94,F11SP
9,Janssenlei 17,2023-01-08,16:00:00,156,112,44,F11SP
9,Janssenlei 17,2023-01-08,17:00:00,68,50,18,F11SP
9,Janssenlei 17,2023-01-08,18:00:00,44,16,28,F11SP
9,Janssenlei 17,2023-01-08,19:00:00,14,8,6,F11SP
9,Janssenlei 17,2023-01-08,20:00:00,24,10,14,F11SP
9,Janssenlei 17,2023-01-08,21:00:00,10,4,6,F11SP
9,Janssenlei 17,2023-01-08,22:00:00,6,0,6,F11SP
9,Janssenlei 17,2023-01-08,23:00:00,4,0,4,F11SP
9,Janssenlei 17,2023-01-09,00:00:00,0,0,0,F11SP
9,Janssenlei 17,2023-01-09,01:00:00,2,2,0,F11SP
9,Janssenlei 17,2023-01-09,02:00:00,0,0,0,F11SP
9,Janssenlei 17,2023-01-09,03:00:00,0,0,0,F11SP
9,Janssenlei 17,2023-01-09,04:00:00,18,16,2,F11SP
9,Janssenlei 17,2023-01-09,05:00:00,52,40,12,F11SP
9,Janssenlei 17,2023-01-09,06:00:00,94,74,20,F11SP
9,Janssenlei 17,2023-01-09,07:00:00,346,246,100,F11SP
9,Janssenlei 17,2023-01-09,08:00:00,426,334,92,F11SP
9,Janssenlei 17,2023-01-09,09:00:00,118,66,52,F11SP
9,Janssenlei 17,2023-01-09,10:00:00,76,44,32,F11SP
9,Janssenlei 17,2023-01-09,11:00:00,76,26,50,F11SP
9,Janssenlei 17,2023-01-09,12:00:00,92,54,38,F11SP
9,Janssenlei 17,2023-01-09,13:00:00,108,54,54,F11SP
9,Janssenlei 17,2023-01-09,14:00:00,156,56,100,F11SP
9,Janssenlei 17,2023-01-09,15:00:00,156,54,102,F11SP
9,Janssenlei 17,2023-01-09,16:00:00,404,132,272,F11SP
9,Janssenlei 17,2023-01-09,17:00:00,274,72,202,F11SP
9,Janssenlei 17,2023-01-09,18:00:00,106,28,78,F11SP
9,Janssenlei 17,2023-01-09,19:00:00,36,8,28,F11SP
9,Janssenlei 17,2023-01-09,20:00:00,30,8,22,F11SP
9,Janssenlei 17,2023-01-09,21:00:00,42,20,22,F11SP
9,Janssenlei 17,2023-01-09,22:00:00,40,14,26,F11SP
9,Janssenlei 17,2023-01-09,23:00:00,4,0,4,F11SP
9,Janssenlei 17,2023-01-10,00:00:00,4,0,4,F11SP
9,Janssenlei 17,2023-01-10,01:00:00,0,0,0,F11SP
9,Janssenlei 17,2023-01-10,02:00:00,0,0,0,F11SP
9,Janssenlei 17,2023-01-10,03:00:00,0,0,0,F11SP
9,Janssenlei 17,2023-01-10,04:00:00,10,6,4,F11SP
9,Janssenlei 17,2023-01-10,05:00:00,60,54,6,F11SP
9,Janssenlei 17,2023-01-10,06:00:00,98,68,30,F11SP
9,Janssenlei 17,2023-01-10,07:00:00,368,294,74,F11SP
9,Janssenlei 17,2023-01-10,08:00:00,412,298,114,F11SP
9,Janssenlei 17,2023-01-10,09:00:00,114,56,58,F11SP
9,Janssenlei 17,2023-01-10,10:00:00,76,42,34,F11SP
9,Janssenlei 17,2023-01-10,11:00:00,96,56,40,F11SP
9,Janssenlei 17,2023-01-10,12:00:00,112,56,56,F11SP
9,Janssenlei 17,2023-01-10,13:00:00,86,40,46,F11SP
9,Janssenlei 17,2023-01-10,14:00:00,86,20,66,F11SP
9,Janssenlei 17,2023-01-10,15:00:00,120,36,84,F11SP
9,Janssenlei 17,2023-01-10,16:00:00,326,96,230,F11SP
9,Janssenlei 17,2023-01-10,17:00:00,264,68,196,F11SP
9,Janssenlei 17,2023-01-10,18:00:00,122,28,94,F11SP
9,Janssenlei 17,2023-01-10,19:00:00,50,24,26,F11SP
9,Janssenlei 17,2023-01-10,20:00:00,34,18,16,F11SP
9,Janssenlei 17,2023-01-10,21:00:00,34,12,22,F11SP
9,Janssenlei 17,2023-01-10,22:00:00,48,8,40,F11SP
9,Janssenlei 17,2023-01-10,23:00:00,8,4,4,F11SP
9,Janssenlei 17,2023-01-11,00:00:00,6,2,4,F11SP
9,Janssenlei 17,2023-01-11,01:00:00,2,0,2,F11SP
9,Janssenlei 17,2023-01-11,02:00:00,0,0,0,F11SP
9,Janssenlei 17,2023-01-11,03:00:00,0,0,0,F11SP
9,Janssenlei 17,2023-01-11,04:00:00,8,8,0,F11SP
9,Janssenlei 17,2023-01-11,05:00:00,36,32,4,F11SP
9,Janssenlei 17,2023-01-11,06:00:00,86,54,32,F11SP
9,Janssenlei 17,2023-01-11,07:00:00,300,202,98,F11SP
9,Janssenlei 17,2023-01-11,08:00:00,370,280,90,F11SP
9,Janssenlei 17,2023-01-11,09:00:00,138,76,62,F11SP
9,Janssenlei 17,2023-01-11,10:00:00,108,58,50,F11SP
9,Janssenlei 17,2023-01-11,11:00:00,162,68,94,F11SP
9,Janssenlei 17,2023-01-11,12:00:00,302,108,194,F11SP
9,Janssenlei 17,2023-01-11,13:00:00,266,104,162,F11SP
9,Janssenlei 17,2023-01-11,14:00:00,206,72,134,F11SP
9,Janssenlei 17,2023-01-11,15:00:00,196,90,106,F11SP
9,Janssenlei 17,2023-01-11,16:00:00,218,80,138,F11SP
9,Janssenlei 17,2023-01-11,17:00:00,250,80,170,F11SP
9,Janssenlei 17,2023-01-11,18:00:00,146,50,96,F11SP
9,Janssenlei 17,2023-01-11,19:00:00,60,28,32,F11SP
9,Janssenlei 17,2023-01-11,20:00:00,40,30,10,F11SP
9,Janssenlei 17,2023-01-11,21:00:00,14,6,8,F11SP
9,Janssenlei 17,2023-01-11,22:00:00,26,10,16,F11SP
9,Janssenlei 17,2023-01-11,23:00:00,12,2,10,F11SP
9,Janssenlei 17,2023-01-12,00:00:00,4,0,4,F11SP
9,Janssenlei 17,2023-01-12,01:00:00,0,0,0,F11SP
9,Janssenlei 17,2023-01-12,02:00:00,0,0,0,F11SP
9,Janssenlei 17,2023-01-12,03:00:00,0,0,0,F11SP
9,Janssenlei 17,2023-01-12,04:00:00,4,2,2,F11SP
9,Janssenlei 17,2023-01-12,05:00:00,24,22,2,F11SP
9,Janssenlei 17,2023-01-12,06:00:00,44,26,18,F11SP
9,Janssenlei 17,2023-01-12,07:00:00,144,100,44,F11SP
9,Janssenlei 17,2023-01-12,08:00:00,266,204,62,F11SP
9,Janssenlei 17,2023-01-12,09:00:00,52,38,14,F11SP
9,Janssenlei 17,2023-01-12,10:00:00,16,10,6,F11SP
9,Janssenlei 17,2023-01-12,11:00:00,16,10,6,F11SP
9,Janssenlei 17,2023-01-12,12:00:00,22,16,6,F11SP
9,Janssenlei 17,2023-01-12,13:00:00,28,14,14,F11SP
9,Janssenlei 17,2023-01-12,14:00:00,36,12,24,F11SP
9,Janssenlei 17,2023-01-12,15:00:00,76,22,54,F11SP
9,Janssenlei 17,2023-01-12,16:00:00,160,52,108,F11SP
9,Janssenlei 17,2023-01-12,17:00:00,150,36,114,F11SP
9,Janssenlei 17,2023-01-12,18:00:00,80,32,48,F11SP
9,Janssenlei 17,2023-01-12,19:00:00,32,10,22,F11SP
9,Janssenlei 17,2023-01-12,20:00:00,22,10,12,F11SP
9,Janssenlei 17,2023-01-12,21:00:00,28,16,12,F11SP
9,Janssenlei 17,2023-01-12,22:00:00,28,12,16,F11SP
9,Janssenlei 17,2023-01-12,23:00:00,8,2,6,F11SP
9,Janssenlei 17,2023-01-13,00:00:00,6,2,4,F11SP
9,Janssenlei 17,2023-01-13,01:00:00,4,2,2,F11SP
9,Janssenlei 17,2023-01-13,02:00:00,2,2,0,F11SP
9,Janssenlei 17,2023-01-13,03:00:00,2,2,0,F11SP
9,Janssenlei 17,2023-01-13,04:00:00,8,6,2,F11SP
9,Janssenlei 17,2023-01-13,05:00:00,44,40,4,F11SP
9,Janssenlei 17,2023-01-13,06:00:00,76,52,24,F11SP
9,Janssenlei 17,2023-01-13,07:00:00,242,196,46,F11SP
9,Janssenlei 17,2023-01-13,08:00:00,398,218,180,F11SP
9,Janssenlei 17,2023-01-13,09:00:00,132,74,58,F11SP
9,Janssenlei 17,2023-01-13,10:00:00,68,30,38,F11SP
9,Janssenlei 17,2023-01-13,11:00:00,102,56,46,F11SP
9,Janssenlei 17,2023-01-13,12:00:00,126,60,66,F11SP
9,Janssenlei 17,2023-01-13,13:00:00,166,108,58,F11SP
9,Janssenlei 17,2023-01-13,14:00:00,96,32,64,F11SP
9,Janssenlei 17,2023-01-13,15:00:00,210,74,136,F11SP
9,Janssenlei 17,2023-01-13,16:00:00,342,140,202,F11SP
9,Janssenlei 17,2023-01-13,17:00:00,212,58,154,F11SP
9,Janssenlei 17,2023-01-13,18:00:00,118,36,82,F11SP
9,Janssenlei 17,2023-01-13,19:00:00,56,26,30,F11SP
9,Janssenlei 17,2023-01-13,20:00:00,50,24,26,F11SP
9,Janssenlei 17,2023-01-13,21:00:00,18,14,4,F11SP
9,Janssenlei 17,2023-01-13,22:00:00,54,28,26,F11SP
9,Janssenlei 17,2023-01-13,23:00:00,32,10,22,F11SP
9,Janssenlei 17,2023-01-14,00:00:00,20,8,12,F11SP
9,Janssenlei 17,2023-01-14,01:00:00,26,14,12,F11SP
9,Janssenlei 17,2023-01-14,02:00:00,12,2,10,F11SP
9,Janssenlei 17,2023-01-14,03:00:00,6,2,4,F11SP
9,Janssenlei 17,2023-01-14,04:00:00,6,2,4,F11SP
9,Janssenlei 17,2023-01-14,05:00:00,10,8,2,F11SP
9,Janssenlei 17,2023-01-14,06:00:00,14,4,10,F11SP
9,Janssenlei 17,2023-01-14,07:00:00,12,6,6,F11SP
9,Janssenlei 17,2023-01-14,08:00:00,20,8,12,F11SP
9,Janssenlei 17,2023-01-14,09:00:00,22,18,4,F11SP
9,Janssenlei 17,2023-01-14,10:00:00,46,26,20,F11SP
9,Janssenlei 17,2023-01-14,11:00:00,34,20,14,F11SP
9,Janssenlei 17,2023-01-14,12:00:00,30,22,8,F11SP
9,Janssenlei 17,2023-01-14,13:00:00,20,14,6,F11SP
9,Janssenlei 17,2023-01-14,14:00:00,32,16,16,F11SP
9,Janssenlei 17,2023-01-14,15:00:00,36,18,18,F11SP
9,Janssenlei 17,2023-01-14,16:00:00,34,18,16,F11SP
9,Janssenlei 17,2023-01-14,17:00:00,20,14,6,F11SP
9,Janssenlei 17,2023-01-14,18:00:00,40,24,16,F11SP
9,Janssenlei 17,2023-01-14,19:00:00,26,16,10,F11SP
9,Janssenlei 17,2023-01-14,20:00:00,30,16,14,F11SP
9,Janssenlei 17,2023-01-14,21:00:00,36,16,20,F11SP
9,Janssenlei 17,2023-01-14,22:00:00,18,8,10,F11SP
9,Janssenlei 17,2023-01-14,23:00:00,8,6,2,F11SP
9,Janssenlei 17,2023-01-15,00:00:00,6,2,4,F11SP
9,Janssenlei 17,2023-01-15,01:00:00,2,0,2,F11SP
9,Janssenlei 17,2023-01-15,02:00:00,2,0,2,F11SP
9,Janssenlei 17,2023-01-15,03:00:00,10,0,10,F11SP
9,Janssenlei 17,2023-01-15,04:00:00,4,4,0,F11SP
9,Janssenlei 17,2023-01-15,05:00:00,18,14,4,F11SP
9,Janssenlei 17,2023-01-15,06:00:00,12,8,4,F11SP
9,Janssenlei 17,2023-01-15,07:00:00,14,8,6,F11SP
9,Janssenlei 17,2023-01-15,08:00:00,38,16,22,F11SP
9,Janssenlei 17,2023-01-15,09:00:00,154,50,104,F11SP
9,Janssenlei 17,2023-01-15,10:00:00,206,94,112,F11SP
9,Janssenlei 17,2023-01-15,11:00:00,250,158,92,F11SP
9,Janssenlei 17,2023-01-15,12:00:00,206,154,52,F11SP
9,Janssenlei 17,2023-01-15,13:00:00,118,74,44,F11SP
9,Janssenlei 17,2023-01-15,14:00:00,90,48,42,F11SP
9,Janssenlei 17,2023-01-15,15:00:00,66,26,40,F11SP
9,Janssenlei 17,2023-01-15,16:00:00,60,24,36,F11SP
9,Janssenlei 17,2023-01-15,17:00:00,54,28,26,F11SP
9,Janssenlei 17,2023-01-15,18:00:00,32,20,12,F11SP
9,Janssenlei 17,2023-01-15,19:00:00,26,14,12,F11SP
9,Janssenlei 17,2023-01-15,20:00:00,12,6,6,F11SP
9,Janssenlei 17,2023-01-15,21:00:00,18,10,8,F11SP
9,Janssenlei 17,2023-01-15,22:00:00,12,2,10,F11SP
9,Janssenlei 17,2023-01-15,23:00:00,2,0,2,F11SP
9,Janssenlei 17,2023-01-16,00:00:00,2,2,0,F11SP
9,Janssenlei 17,2023-01-16,01:00:00,0,0,0,F11SP
9,Janssenlei 17,2023-01-16,02:00:00,0,0,0,F11SP
9,Janssenlei 17,2023-01-16,03:00:00,0,0,0,F11SP
9,Janssenlei 17,2023-01-16,04:00:00,4,2,2,F11SP
9,Janssenlei 17,2023-01-16,05:00:00,40,32,8,F11SP
9,Janssenlei 17,2023-01-16,06:00:00,66,54,12,F11SP
9,Janssenlei 17,2023-01-16,07:00:00,232,156,76,F11SP
9,Janssenlei 17,2023-01-16,08:00:00,256,202,54,F11SP
9,Janssenlei 17,2023-01-16,09:00:00,44,22,22,F11SP
9,Janssenlei 17,2023-01-16,10:00:00,50,30,20,F11SP
9,Janssenlei 17,2023-01-16,11:00:00,30,20,10,F11SP
9,Janssenlei 17,2023-01-16,12:00:00,36,24,12,F11SP
9,Janssenlei 17,2023-01-16,13:00:00,34,18,16,F11SP
9,Janssenlei 17,2023-01-16,14:00:00,58,22,36,F11SP
9,Janssenlei 17,2023-01-16,15:00:00,100,24,76,F11SP
9,Janssenlei 17,2023-01-16,16:00:00,238,74,164,F11SP
9,Janssenlei 17,2023-01-16,17:00:00,182,48,134,F11SP
9,Janssenlei 17,2023-01-16,18:00:00,68,18,50,F11SP
9,Janssenlei 17,2023-01-16,19:00:00,30,4,26,F11SP
9,Janssenlei 17,2023-01-16,20:00:00,26,12,14,F11SP
9,Janssenlei 17,2023-01-16,21:00:00,32,10,22,F11SP
9,Janssenlei 17,2023-01-16,22:00:00,32,8,24,F11SP
9,Janssenlei 17,2023-01-16,23:00:00,4,2,2,F11SP
9,Janssenlei 17,2023-01-17,00:00:00,4,0,4,F11SP
9,Janssenlei 17,2023-01-17,01:00:00,4,2,2,F11SP
9,Janssenlei 17,2023-01-17,02:00:00,0,0,0,F11SP
9,Janssenlei 17,2023-01-17,03:00:00,2,2,0,F11SP
9,Janssenlei 17,2023-01-17,04:00:00,12,10,2,F11SP
9,Janssenlei 17,2023-01-17,05:00:00,40,32,8,F11SP
9,Janssenlei 17,2023-01-17,06:00:00,70,56,14,F11SP
9,Janssenlei 17,2023-01-17,07:00:00,292,212,80,F11SP
9,Janssenlei 17,2023-01-17,08:00:00,394,306,88,F11SP
9,Janssenlei 17,2023-01-17,09:00:00,114,66,48,F11SP
9,Janssenlei 17,2023-01-17,10:00:00,62,38,24,F11SP
9,Janssenlei 17,2023-01-17,11:00:00,50,22,28,F11SP
9,Janssenlei 17,2023-01-17,12:00:00,116,62,54,F11SP
9,Janssenlei 17,2023-01-17,13:00:00,138,62,76,F11SP
9,Janssenlei 17,2023-01-17,14:00:00,140,52,88,F11SP
9,Janssenlei 17,2023-01-17,15:00:00,192,62,130,F11SP
9,Janssenlei 17,2023-01-17,16:00:00,352,102,250,F11SP
9,Janssenlei 17,2023-01-17,17:00:00,290,110,180,F11SP
9,Janssenlei 17,2023-01-17,18:00:00,142,48,94,F11SP
9,Janssenlei 17,2023-01-17,19:00:00,56,26,30,F11SP
9,Janssenlei 17,2023-01-17,20:00:00,22,10,12,F11SP
9,Janssenlei 17,2023-01-17,21:00:00,32,14,18,F11SP
9,Janssenlei 17,2023-01-17,22:00:00,44,10,34,F11SP
9,Janssenlei 17,2023-01-17,23:00:00,10,0,10,F11SP
9,Janssenlei 17,2023-01-18,00:00:00,12,2,10,F11SP
9,Janssenlei 17,2023-01-18,01:00:00,4,0,4,F11SP
9,Janssenlei 17,2023-01-18,02:00:00,0,0,0,F11SP
9,Janssenlei 17,2023-01-18,03:00:00,2,2,0,F11SP
9,Janssenlei 17,2023-01-18,04:00:00,10,6,4,F11SP
9,Janssenlei 17,2023-01-18,05:00:00,38,30,8,F11SP
9,Janssenlei 17,2023-01-18,06:00:00,94,68,26,F11SP
9,Janssenlei 17,2023-01-18,07:00:00,276,180,96,F11SP
9,Janssenlei 17,2023-01-18,08:00:00,320,240,80,F11SP
9,Janssenlei 17,2023-01-18,09:00:00,80,36,44,F11SP
9,Janssenlei 17,2023-01-18,10:00:00,64,32,32,F11SP
9,Janssenlei 17,2023-01-18,11:00:00,90,32,58,F11SP
9,Janssenlei 17,2023-01-18,12:00:00,236,68,168,F11SP
9,Janssenlei 17,2023-01-18,13:00:00,132,56,76,F11SP
9,Janssenlei 17,2023-01-18,14:00:00,194,88,106,F11SP
9,Janssenlei 17,2023-01-18,15:00:00,188,86,102,F11SP
9,Janssenlei 17,2023-01-18,16:00:00,216,98,118,F11SP
9,Janssenlei 17,2023-01-18,17:00:00,198,76,122,F11SP
9,Janssenlei 17,2023-01-18,18:00:00,156,70,86,F11SP
9,Janssenlei 17,2023-01-18,19:00:00,66,24,42,F11SP
9,Janssenlei 17,2023-01-18,20:00:00,36,26,10,F11SP
9,Janssenlei 17,2023-01-18,21:00:00,28,14,14,F11SP
9,Janssenlei 17,2023-01-18,22:00:00,30,4,26,F11SP
9,Janssenlei 17,2023-01-18,23:00:00,8,0,8,F11SP
